MClusterID,XClusterID,MClusterSize,XClusterSize,OverlapSize,OverlapMembers,MOnlySize,MOnlyMembers,XOnlySize,XOnlyMembers,CombinedSize,CombinedMembers
1,40,249,244,242,"['hkoh', 'kae771', 'yli640', 'Raychang', 'sagarwal', 'gepstein', 'jrixe', 'gwilner', 'jyoung', 'msafdari', 'liuan', 'singebrand', 'rzhang', 'wehoyt', 'hetalsheth', 'avi697', 'jroth', 'YLI640', 'ssolomon', 'ykoh', 'jbuchheit', 'lsoliz', 'seilers77', 'wfan', 'kmarotta', 'carolagross', 'aliu', 'aqureshi', 'afast', 'jdonofrio', 'iwong', 'rfarrell', 'nhk780', 'tybaum', 'nbafna', 'skini', 'adwivedi', 'asocianu', 'gae375', 'ghajost', 'AndrewPottebaum', 'lhelmstetter', 'jkim', 'MegaSR660', 'hthaker', 'tzhang', 'hetalsheth88', 'acdavis', 'mmounier', 'ekao', 'LSOLIZ', 'ahymen', 'bdunnington', 'epervos', 'mth448', 'yjang', 'cdougherty', 'lpolepeddi', 'dhahn', 'kstuewer', 'Mezzopiano314', 'achuang', 'shireen5786', 'cvanswearingen', 'scheng', 'acampbell', 'anamika', 'allisonp87', 'ssong', 'acs225', 'mkharouta', 'hhudson', 'eradler', 'jhuang', 'alex111', 'gonyeneho', 'dhenning', 'scoppola', 'mscoptur', 'whoyt1', 'dbolmer', 'RayChang', 'mkelner149', 'sigross', 'forceofgreed', 'rmehta', 'nse577', 'dleander', 'mep869', 'gdm734', 'fahmad', 'ryoo', 'etrivedi', 'ppark', 'laurenkeeley', 'scorbridge', 'agassifeng', 'danderson', 'cstengel', 'msc939', 'mjohnson', 'jhoffmann', 'glu', 'jpeng', 'emross', 'nmalik', 'elizabethab', 'ajf447', 'hlee', 'ngp444', 'pdawson', 'JOrnatowski', 'aaguado', 'nshah', 'cgoldschmidt', 'wcsande', 'orlando', 'pchang1', 'lwaters', 'bstenson', 'w_wang', 'pbhagat', 'kvernon', 'nishamehta', 'yeehoong', 'andrewpottebaum', 'srichman', 'jliu', 'ylu589', 'whoyt', 'zman51088', 'kcl507', 'arthsri', 'knosbisch', 'gmm371', 'jkunke', 'eding', 'bcheng', 'greg1388', 'yqin', 'rgr237', 'mjs983', 'pkiessling', 'agreiman', 'narekapudi', 'jgellis', 'ccscore2', 'megoss', 'agoyal', 'smcaleese', 'rciechowski', 'jornatowski', 'kmarrero', 'ssukert', 'gschmidt', 'qcai', 'ronakvashi', 'mmarshall', 'acbhatt', 'normanwang02', 'cboland', 'tasvatanakul', 'yha332', 'umoka', 'Jornatowski', 'mgeorge', 'raychang', 'rmcdonnell', 'dsidelko', 'huisunp', 'bbrunner', 'thevikman', 'kenanmir', 'ngupta', 'CMBRINER', 'hde520', 'sjyhee', 'asierakowski', 'csbisa', 'jscheineson', 'dackerman', 'apbubba13', 'amj139', 'sramakrishna', 'eri1092783', 'jreynolds', 'EKao', 'djh294', 'ACDavis', 'lea164', 'nancyfru', 'ngp2323', 'nivinporwal', 'mpertierra', 'mthazin', 'vkuznetsov', 'john873', 'mfaierman', 'sumeetjain', 'dwozniczka', 'maltman', 'panchal', 'rhalloran', 'cmbriner', 'roshnibarot22', 'pstibbe', 'tcooper', 'tsprinkel', 'mmiller', 'rbd584', 'JustinO', 'jcm979', 'sahai17', 'ktiwari1', 'helabut', 'nsb756', 'ims469', 'kgupta723', 'bchong3', 'zizix28', 'cchow', 'scottar', 'slm465', 'nehaagarwal', 'zzhang', 'egabrielov', 'DDDHHH', 'tkennedy', 'mchow', 'ylee', 'dstehura', 'toga221', 'woodisgood37', 'dwolinsky', 'bmiko06', 'djw610', 'mlin', 'kcooper', 'awchang', 'gregthesped', 'dtrain580', 'akeeley']",7,"['AngelAguirre', 'chshaara', 'rryskin', 'jensen', 'nsingh', 'choel', 'amuehlbauer']",2,"['nwong', 'jroden']",251,"['hkoh', 'yli640', 'Raychang', 'sagarwal', 'gwilner', 'jyoung', 'msafdari', 'choel', 'singebrand', 'hetalsheth', 'rryskin', 'ykoh', 'lsoliz', 'wfan', 'aliu', 'carolagross', 'aqureshi', 'jdonofrio', 'nhk780', 'nbafna', 'gae375', 'AndrewPottebaum', 'jkim', 'hthaker', 'tzhang', 'acdavis', 'ekao', 'yjang', 'chshaara', 'kstuewer', 'achuang', 'shireen5786', 'cvanswearingen', 'scheng', 'allisonp87', 'ssong', 'hhudson', 'eradler', 'dhenning', 'scoppola', 'whoyt1', 'mkelner149', 'forceofgreed', 'rmehta', 'nse577', 'dleander', 'mep869', 'gdm734', 'scorbridge', 'agassifeng', 'mjohnson', 'nmalik', 'jpeng', 'hlee', 'nshah', 'aaguado', 'cgoldschmidt', 'pchang1', 'orlando', 'bstenson', 'andrewpottebaum', 'yeehoong', 'nishamehta', 'srichman', 'jliu', 'ylu589', 'whoyt', 'zman51088', 'gmm371', 'jkunke', 'eding', 'yqin', 'bcheng', 'rgr237', 'mjs983', 'agreiman', 'narekapudi', 'jgellis', 'ccscore2', 'megoss', 'rciechowski', 'jornatowski', 'kmarrero', 'qcai', 'ronakvashi', 'normanwang02', 'acbhatt', 'raychang', 'thevikman', 'bbrunner', 'ngupta', 'sjyhee', 'asierakowski', 'jscheineson', 'jreynolds', 'amj139', 'eri1092783', 'lea164', 'mpertierra', 'mthazin', 'john873', 'mfaierman', 'dwozniczka', 'maltman', 'panchal', 'rhalloran', 'cmbriner', 'tsprinkel', 'mmiller', 'rbd584', 'nsb756', 'jroden', 'scottar', 'bchong3', 'zizix28', 'kgupta723', 'nehaagarwal', 'tkennedy', 'ylee', 'dwolinsky', 'bmiko06', 'djw610', 'kcooper', 'awchang', 'dtrain580', 'akeeley', 'gepstein', 'jrixe', 'liuan', 'rzhang', 'wehoyt', 'avi697', 'jroth', 'YLI640', 'ssolomon', 'jbuchheit', 'seilers77', 'kmarotta', 'afast', 'iwong', 'rfarrell', 'tybaum', 'skini', 'adwivedi', 'asocianu', 'ghajost', 'lhelmstetter', 'MegaSR660', 'hetalsheth88', 'mmounier', 'LSOLIZ', 'ahymen', 'bdunnington', 'epervos', 'mth448', 'cdougherty', 'lpolepeddi', 'dhahn', 'Mezzopiano314', 'nsingh', 'acampbell', 'anamika', 'acs225', 'mkharouta', 'jhuang', 'alex111', 'gonyeneho', 'mscoptur', 'dbolmer', 'RayChang', 'sigross', 'fahmad', 'ryoo', 'etrivedi', 'nwong', 'ppark', 'laurenkeeley', 'danderson', 'cstengel', 'msc939', 'jhoffmann', 'glu', 'emross', 'elizabethab', 'ajf447', 'ngp444', 'pdawson', 'wcsande', 'JOrnatowski', 'lwaters', 'w_wang', 'pbhagat', 'jensen', 'kvernon', 'kcl507', 'knosbisch', 'arthsri', 'greg1388', 'pkiessling', 'agoyal', 'smcaleese', 'ssukert', 'gschmidt', 'mmarshall', 'cboland', 'tasvatanakul', 'yha332', 'umoka', 'Jornatowski', 'mgeorge', 'rmcdonnell', 'dsidelko', 'kenanmir', 'huisunp', 'CMBRINER', 'hde520', 'csbisa', 'dackerman', 'apbubba13', 'sramakrishna', 'EKao', 'djh294', 'ACDavis', 'nancyfru', 'ngp2323', 'nivinporwal', 'vkuznetsov', 'sumeetjain', 'roshnibarot22', 'pstibbe', 'tcooper', 'JustinO', 'jcm979', 'sahai17', 'ktiwari1', 'helabut', 'ims469', 'cchow', 'slm465', 'zzhang', 'egabrielov', 'amuehlbauer', 'AngelAguirre', 'DDDHHH', 'mchow', 'toga221', 'dstehura', 'woodisgood37', 'mlin', 'gregthesped', 'kae771']"
1,21,249,210,200,"['hkoh', 'kae771', 'yli640', 'sagarwal', 'gepstein', 'jrixe', 'gwilner', 'jyoung', 'msafdari', 'liuan', 'singebrand', 'rzhang', 'avi697', 'jroth', 'rryskin', 'ssolomon', 'ykoh', 'seilers77', 'kmarotta', 'aliu', 'afast', 'wfan', 'carolagross', 'aqureshi', 'iwong', 'rfarrell', 'nhk780', 'nbafna', 'tybaum', 'skini', 'adwivedi', 'asocianu', 'gae375', 'ghajost', 'lhelmstetter', 'jkim', 'hthaker', 'hetalsheth88', 'MegaSR660', 'tzhang', 'acdavis', 'mmounier', 'LSOLIZ', 'ahymen', 'bdunnington', 'epervos', 'mth448', 'cdougherty', 'lpolepeddi', 'dhahn', 'kstuewer', 'Mezzopiano314', 'achuang', 'shireen5786', 'cvanswearingen', 'scheng', 'acampbell', 'allisonp87', 'ssong', 'mkharouta', 'hhudson', 'eradler', 'jhuang', 'alex111', 'gonyeneho', 'dhenning', 'scoppola', 'mscoptur', 'whoyt1', 'RayChang', 'mkelner149', 'sigross', 'forceofgreed', 'rmehta', 'nse577', 'dleander', 'mep869', 'gdm734', 'fahmad', 'ryoo', 'laurenkeeley', 'scorbridge', 'danderson', 'cstengel', 'msc939', 'mjohnson', 'jhoffmann', 'nmalik', 'jpeng', 'glu', 'elizabethab', 'ajf447', 'hlee', 'pdawson', 'JOrnatowski', 'nshah', 'aaguado', 'cgoldschmidt', 'pchang1', 'orlando', 'bstenson', 'lwaters', 'w_wang', 'nishamehta', 'yeehoong', 'kvernon', 'andrewpottebaum', 'srichman', 'jliu', 'ylu589', 'whoyt', 'zman51088', 'knosbisch', 'arthsri', 'kcl507', 'jkunke', 'eding', 'bcheng', 'greg1388', 'rgr237', 'pkiessling', 'mjs983', 'agreiman', 'narekapudi', 'jgellis', 'ccscore2', 'megoss', 'agoyal', 'smcaleese', 'rciechowski', 'kmarrero', 'ssukert', 'gschmidt', 'qcai', 'ronakvashi', 'mmarshall', 'acbhatt', 'cboland', 'yha332', 'umoka', 'mgeorge', 'dsidelko', 'bbrunner', 'thevikman', 'ngupta', 'hde520', 'sjyhee', 'asierakowski', 'csbisa', 'dackerman', 'apbubba13', 'amj139', 'sramakrishna', 'eri1092783', 'jreynolds', 'jscheineson', 'EKao', 'lea164', 'nancyfru', 'mthazin', 'mpertierra', 'vkuznetsov', 'mfaierman', 'sumeetjain', 'dwozniczka', 'maltman', 'panchal', 'rhalloran', 'cmbriner', 'roshnibarot22', 'pstibbe', 'tcooper', 'tsprinkel', 'mmiller', 'rbd584', 'jcm979', 'helabut', 'nsb756', 'ims469', 'bchong3', 'zizix28', 'cchow', 'scottar', 'nehaagarwal', 'slm465', 'egabrielov', 'amuehlbauer', 'DDDHHH', 'tkennedy', 'mchow', 'ylee', 'toga221', 'dstehura', 'dwolinsky', 'bmiko06', 'mlin', 'kcooper', 'awchang', 'dtrain580', 'akeeley']",49,"['chshaara', 'pbhagat', 'Raychang', 'jensen', 'CMBRINER', 'nsingh', 'choel', 'anamika', 'djh294', 'gmm371', 'ACDavis', 'ngp2323', 'hetalsheth', 'wehoyt', 'acs225', 'nivinporwal', 'yqin', 'YLI640', 'john873', 'jbuchheit', 'lsoliz', 'huisunp', 'jdonofrio', 'dbolmer', 'JustinO', 'rmcdonnell', 'sahai17', 'ktiwari1', 'kgupta723', 'jornatowski', 'AndrewPottebaum', 'zzhang', 'etrivedi', 'ppark', 'AngelAguirre', 'normanwang02', 'agassifeng', 'tasvatanakul', 'ekao', 'emross', 'woodisgood37', 'Jornatowski', 'djw610', 'raychang', 'gregthesped', 'ngp444', 'yjang', 'wcsande', 'kenanmir']",10,"['jcamden', 'ForceofGreed', 'nwong', 'aap459', 'dani0278', 'jroden', 'slhatch', 'avarrenti', 'megasr660', None]",259,"['hkoh', 'yli640', 'Raychang', 'sagarwal', 'gwilner', 'jyoung', 'msafdari', 'choel', 'singebrand', 'hetalsheth', 'rryskin', 'ykoh', 'lsoliz', 'wfan', 'aliu', 'carolagross', 'aqureshi', 'jdonofrio', 'nhk780', 'nbafna', 'gae375', 'AndrewPottebaum', 'jkim', 'hthaker', 'tzhang', 'acdavis', 'ekao', 'yjang', 'chshaara', 'kstuewer', 'achuang', 'shireen5786', 'cvanswearingen', 'scheng', 'allisonp87', 'ssong', 'hhudson', 'eradler', 'slhatch', 'dhenning', 'scoppola', 'whoyt1', 'mkelner149', 'dani0278', 'forceofgreed', 'rmehta', 'nse577', 'dleander', 'mep869', 'gdm734', None, 'scorbridge', 'agassifeng', 'mjohnson', 'nmalik', 'jpeng', 'hlee', 'nshah', 'aaguado', 'cgoldschmidt', 'pchang1', 'orlando', 'bstenson', 'aap459', 'andrewpottebaum', 'yeehoong', 'nishamehta', 'srichman', 'jliu', 'ylu589', 'whoyt', 'zman51088', 'gmm371', 'jkunke', 'eding', 'yqin', 'bcheng', 'rgr237', 'mjs983', 'agreiman', 'narekapudi', 'jgellis', 'ccscore2', 'megoss', 'rciechowski', 'avarrenti', 'jornatowski', 'kmarrero', 'qcai', 'ronakvashi', 'normanwang02', 'acbhatt', 'raychang', 'thevikman', 'bbrunner', 'ngupta', 'sjyhee', 'asierakowski', 'jscheineson', 'jreynolds', 'amj139', 'eri1092783', 'lea164', 'mpertierra', 'mthazin', 'john873', 'mfaierman', 'dwozniczka', 'maltman', 'panchal', 'rhalloran', 'cmbriner', 'tsprinkel', 'mmiller', 'rbd584', 'nsb756', 'jroden', 'scottar', 'bchong3', 'zizix28', 'kgupta723', 'nehaagarwal', 'megasr660', 'ForceofGreed', 'tkennedy', 'ylee', 'dwolinsky', 'bmiko06', 'djw610', 'kcooper', 'awchang', 'dtrain580', 'akeeley', 'gepstein', 'jrixe', 'liuan', 'rzhang', 'wehoyt', 'avi697', 'jroth', 'YLI640', 'ssolomon', 'jbuchheit', 'seilers77', 'kmarotta', 'afast', 'iwong', 'rfarrell', 'tybaum', 'skini', 'adwivedi', 'asocianu', 'ghajost', 'lhelmstetter', 'MegaSR660', 'hetalsheth88', 'mmounier', 'LSOLIZ', 'ahymen', 'bdunnington', 'epervos', 'mth448', 'cdougherty', 'lpolepeddi', 'dhahn', 'Mezzopiano314', 'nsingh', 'acampbell', 'anamika', 'acs225', 'mkharouta', 'jhuang', 'alex111', 'gonyeneho', 'mscoptur', 'dbolmer', 'RayChang', 'sigross', 'fahmad', 'ryoo', 'etrivedi', 'nwong', 'ppark', 'laurenkeeley', 'jcamden', 'danderson', 'cstengel', 'msc939', 'jhoffmann', 'glu', 'emross', 'elizabethab', 'ajf447', 'ngp444', 'pdawson', 'wcsande', 'JOrnatowski', 'lwaters', 'w_wang', 'pbhagat', 'jensen', 'kvernon', 'kcl507', 'knosbisch', 'arthsri', 'greg1388', 'pkiessling', 'agoyal', 'smcaleese', 'ssukert', 'gschmidt', 'mmarshall', 'cboland', 'tasvatanakul', 'yha332', 'umoka', 'Jornatowski', 'mgeorge', 'rmcdonnell', 'dsidelko', 'kenanmir', 'huisunp', 'CMBRINER', 'hde520', 'csbisa', 'dackerman', 'apbubba13', 'sramakrishna', 'EKao', 'djh294', 'ACDavis', 'nancyfru', 'ngp2323', 'nivinporwal', 'vkuznetsov', 'sumeetjain', 'roshnibarot22', 'pstibbe', 'tcooper', 'JustinO', 'jcm979', 'sahai17', 'ktiwari1', 'helabut', 'ims469', 'cchow', 'slm465', 'zzhang', 'egabrielov', 'amuehlbauer', 'AngelAguirre', 'DDDHHH', 'mchow', 'toga221', 'dstehura', 'woodisgood37', 'mlin', 'gregthesped', 'kae771']"
1,20,249,8,7,"['mthazin', 'mkharouta', 'jyoung', 'kenanmir', 'cmbriner', 'ghajost', 'dbolmer']",242,"['hkoh', 'yli640', 'Raychang', 'sagarwal', 'gepstein', 'gwilner', 'jrixe', 'msafdari', 'choel', 'liuan', 'singebrand', 'rzhang', 'hetalsheth', 'wehoyt', 'avi697', 'jroth', 'rryskin', 'YLI640', 'ssolomon', 'ykoh', 'jbuchheit', 'lsoliz', 'seilers77', 'kmarotta', 'wfan', 'carolagross', 'afast', 'aliu', 'aqureshi', 'jdonofrio', 'iwong', 'rfarrell', 'nhk780', 'tybaum', 'nbafna', 'skini', 'adwivedi', 'asocianu', 'gae375', 'AndrewPottebaum', 'lhelmstetter', 'jkim', 'MegaSR660', 'hthaker', 'hetalsheth88', 'tzhang', 'acdavis', 'ekao', 'mmounier', 'LSOLIZ', 'ahymen', 'bdunnington', 'epervos', 'mth448', 'yjang', 'cdougherty', 'lpolepeddi', 'chshaara', 'dhahn', 'kstuewer', 'Mezzopiano314', 'achuang', 'nsingh', 'shireen5786', 'cvanswearingen', 'scheng', 'acampbell', 'anamika', 'allisonp87', 'ssong', 'acs225', 'hhudson', 'eradler', 'jhuang', 'alex111', 'gonyeneho', 'dhenning', 'scoppola', 'mscoptur', 'whoyt1', 'RayChang', 'mkelner149', 'sigross', 'forceofgreed', 'rmehta', 'nse577', 'fahmad', 'mep869', 'dleander', 'gdm734', 'ryoo', 'dtrain580', 'etrivedi', 'ppark', 'laurenkeeley', 'scorbridge', 'agassifeng', 'danderson', 'cstengel', 'mjohnson', 'msc939', 'jhoffmann', 'nmalik', 'jpeng', 'glu', 'emross', 'elizabethab', 'ajf447', 'hlee', 'ngp444', 'pdawson', 'wcsande', 'JOrnatowski', 'nshah', 'cgoldschmidt', 'pchang1', 'orlando', 'aaguado', 'bstenson', 'lwaters', 'w_wang', 'pbhagat', 'jensen', 'yeehoong', 'andrewpottebaum', 'nishamehta', 'srichman', 'jliu', 'kvernon', 'ylu589', 'whoyt', 'zman51088', 'kcl507', 'knosbisch', 'arthsri', 'gmm371', 'jkunke', 'eding', 'yqin', 'greg1388', 'bcheng', 'rgr237', 'mjs983', 'pkiessling', 'agreiman', 'narekapudi', 'jgellis', 'ccscore2', 'megoss', 'agoyal', 'smcaleese', 'rciechowski', 'jornatowski', 'ssukert', 'kmarrero', 'gschmidt', 'qcai', 'mmarshall', 'normanwang02', 'acbhatt', 'ronakvashi', 'cboland', 'tasvatanakul', 'yha332', 'umoka', 'Jornatowski', 'raychang', 'mgeorge', 'rmcdonnell', 'dsidelko', 'thevikman', 'bbrunner', 'huisunp', 'ngupta', 'CMBRINER', 'hde520', 'sjyhee', 'asierakowski', 'csbisa', 'jscheineson', 'dackerman', 'apbubba13', 'amj139', 'jreynolds', 'sramakrishna', 'eri1092783', 'EKao', 'djh294', 'ACDavis', 'lea164', 'nancyfru', 'ngp2323', 'nivinporwal', 'mpertierra', 'vkuznetsov', 'john873', 'mfaierman', 'sumeetjain', 'dwozniczka', 'maltman', 'panchal', 'rhalloran', 'roshnibarot22', 'pstibbe', 'tcooper', 'tsprinkel', 'mmiller', 'rbd584', 'JustinO', 'jcm979', 'sahai17', 'ktiwari1', 'helabut', 'nsb756', 'ims469', 'bchong3', 'zizix28', 'cchow', 'kgupta723', 'nehaagarwal', 'scottar', 'slm465', 'zzhang', 'egabrielov', 'amuehlbauer', 'AngelAguirre', 'DDDHHH', 'tkennedy', 'mchow', 'toga221', 'dwolinsky', 'dstehura', 'woodisgood37', 'ylee', 'bmiko06', 'djw610', 'mlin', 'kcooper', 'awchang', 'gregthesped', 'kae771', 'akeeley']",1,[None],250,"['hkoh', 'yli640', 'Raychang', 'sagarwal', 'gepstein', 'gwilner', 'jrixe', 'jyoung', 'msafdari', 'choel', 'liuan', 'singebrand', 'rzhang', 'hetalsheth', 'wehoyt', 'avi697', 'jroth', 'rryskin', 'YLI640', 'ssolomon', 'ykoh', 'jbuchheit', 'lsoliz', 'seilers77', 'kmarotta', 'wfan', 'carolagross', 'afast', 'aliu', 'aqureshi', 'jdonofrio', 'iwong', 'rfarrell', 'nhk780', 'tybaum', 'nbafna', 'skini', 'adwivedi', 'asocianu', 'gae375', 'ghajost', 'AndrewPottebaum', 'lhelmstetter', 'jkim', 'MegaSR660', 'hthaker', 'hetalsheth88', 'tzhang', 'acdavis', 'ekao', 'mmounier', 'LSOLIZ', 'ahymen', 'bdunnington', 'epervos', 'mth448', 'yjang', 'cdougherty', 'lpolepeddi', 'chshaara', 'dhahn', 'kstuewer', 'Mezzopiano314', 'achuang', 'nsingh', 'shireen5786', 'cvanswearingen', 'scheng', 'acampbell', 'anamika', 'allisonp87', 'ssong', 'acs225', 'mkharouta', 'hhudson', 'eradler', 'jhuang', 'alex111', 'gonyeneho', 'dhenning', 'scoppola', 'mscoptur', 'whoyt1', 'dbolmer', 'RayChang', 'mkelner149', 'sigross', 'forceofgreed', 'rmehta', 'nse577', 'fahmad', 'mep869', 'dleander', 'gdm734', 'ryoo', 'dtrain580', 'etrivedi', None, 'ppark', 'laurenkeeley', 'scorbridge', 'agassifeng', 'danderson', 'cstengel', 'mjohnson', 'msc939', 'jhoffmann', 'nmalik', 'jpeng', 'glu', 'emross', 'elizabethab', 'ajf447', 'hlee', 'ngp444', 'pdawson', 'wcsande', 'JOrnatowski', 'nshah', 'cgoldschmidt', 'pchang1', 'orlando', 'aaguado', 'bstenson', 'lwaters', 'w_wang', 'pbhagat', 'jensen', 'yeehoong', 'andrewpottebaum', 'nishamehta', 'srichman', 'jliu', 'kvernon', 'ylu589', 'whoyt', 'zman51088', 'kcl507', 'knosbisch', 'arthsri', 'gmm371', 'jkunke', 'eding', 'yqin', 'greg1388', 'bcheng', 'rgr237', 'mjs983', 'pkiessling', 'agreiman', 'narekapudi', 'jgellis', 'ccscore2', 'megoss', 'agoyal', 'smcaleese', 'rciechowski', 'jornatowski', 'ssukert', 'kmarrero', 'gschmidt', 'qcai', 'mmarshall', 'normanwang02', 'acbhatt', 'ronakvashi', 'cboland', 'tasvatanakul', 'yha332', 'umoka', 'Jornatowski', 'raychang', 'mgeorge', 'rmcdonnell', 'dsidelko', 'kenanmir', 'thevikman', 'bbrunner', 'huisunp', 'ngupta', 'CMBRINER', 'hde520', 'sjyhee', 'asierakowski', 'csbisa', 'jscheineson', 'dackerman', 'apbubba13', 'amj139', 'jreynolds', 'sramakrishna', 'eri1092783', 'EKao', 'djh294', 'ACDavis', 'lea164', 'nancyfru', 'ngp2323', 'nivinporwal', 'mpertierra', 'mthazin', 'vkuznetsov', 'john873', 'mfaierman', 'sumeetjain', 'dwozniczka', 'maltman', 'panchal', 'rhalloran', 'cmbriner', 'roshnibarot22', 'pstibbe', 'tcooper', 'tsprinkel', 'mmiller', 'rbd584', 'JustinO', 'jcm979', 'sahai17', 'ktiwari1', 'helabut', 'nsb756', 'ims469', 'bchong3', 'zizix28', 'cchow', 'kgupta723', 'nehaagarwal', 'scottar', 'slm465', 'zzhang', 'egabrielov', 'amuehlbauer', 'AngelAguirre', 'DDDHHH', 'tkennedy', 'mchow', 'toga221', 'dwolinsky', 'dstehura', 'woodisgood37', 'ylee', 'bmiko06', 'djw610', 'mlin', 'kcooper', 'awchang', 'gregthesped', 'kae771', 'akeeley']"
2,33,96,103,87,"['binwu', 'weirdo71', 'mmessana', 'Derrex', 'hobbes13180', 'joongsun', 'dalyx', 'jwshibing', 'jkuan', 'chenying119', 'zbrand', 'kmla1', 'jprao', 'chuixian', 'b88504120', 'papajim', 'Kartik', 'chya', 'ryw', 'cindyc', 'apettes', 'aadlakha', 'bensky', 'dstoler', 'pollini', 'bilee', 'marianam', 'dj028', 'huangzb', 'tritrial', 'andrewgoo', 'techiou', 'narii', 'karthik1024', 'bavaroi', 'veraz', 'lyrox', 'cherryt', 'hsieh', 'kaye128', 'bbeatty', 'firouzeh', 'vikgarg', 'jongyonkim', 'goldtho', 'daims', 'shacham', 'chp3742', 'kelemvor5', 'bluefrue', 'twkt03', 'herbma', 'cphillips', 'tahirma', 'whitejs', 'hyungkyu', 'sarahr', 'shayakb', 'gunjim', 'ernesho', 'ystyeoh', 'sarves', 'wmar', 'mrlin', 'avkearne', 'pisuts', 'galena', 'maslee', 'daniellwu', 'kjayanti', 'wwsky', 'spangrle', 'sylvijove', 'ski4ever', 'nhuiyan', 'ehindman', 'rdchambers', 'wangss', 'halamdar', 'rschaevitz', 'yoonjin', 'jjeong1', 'jl1mortym', 'slchen', 'kimkeon', 'slcheng', 'sgchong']",8,"['cottier', 'xuanwu', 'iliu', 'jschauer', 'davidchen', 'mikedx42', 'cschung', 'meghung']",16,"['hassanchafi', 'kupferma', 'serene', 'cloudies', 'vicsta', 'minghui', 'twoon', 'keiichimcguire', 'bluebrypi', 'josephrg', 'vcyw', 'yangliu1', 'rostam', 'kartik', 'sqcao', None]",111,"['binwu', 'weirdo71', 'mmessana', 'Derrex', 'vcyw', 'hobbes13180', 'joongsun', 'dalyx', 'xuanwu', 'vicsta', 'jwshibing', 'jkuan', 'chenying119', 'zbrand', 'kmla1', 'jprao', 'chuixian', 'serene', 'jschauer', 'b88504120', 'papajim', 'cschung', 'yangliu1', 'chya', 'Kartik', 'ryw', 'cindyc', 'twoon', 'apettes', 'aadlakha', 'bensky', 'dstoler', 'pollini', 'bilee', 'marianam', 'dj028', 'huangzb', 'tritrial', 'andrewgoo', 'keiichimcguire', 'techiou', 'narii', 'cottier', 'hassanchafi', 'karthik1024', 'bavaroi', 'veraz', 'lyrox', 'cherryt', None, 'hsieh', 'kaye128', 'bbeatty', 'bluebrypi', 'firouzeh', 'vikgarg', 'jongyonkim', 'goldtho', 'kupferma', 'daims', 'shacham', 'chp3742', 'kelemvor5', 'mikedx42', 'bluefrue', 'twkt03', 'herbma', 'cphillips', 'tahirma', 'whitejs', 'meghung', 'hyungkyu', 'sarahr', 'cloudies', 'iliu', 'shayakb', 'davidchen', 'gunjim', 'ernesho', 'minghui', 'ystyeoh', 'sarves', 'wmar', 'avkearne', 'mrlin', 'pisuts', 'galena', 'maslee', 'daniellwu', 'kjayanti', 'wwsky', 'spangrle', 'sylvijove', 'josephrg', 'rostam', 'ski4ever', 'sqcao', 'nhuiyan', 'ehindman', 'rdchambers', 'wangss', 'halamdar', 'rschaevitz', 'yoonjin', 'jjeong1', 'jl1mortym', 'slchen', 'kartik', 'kimkeon', 'slcheng', 'sgchong']"
2,30,96,90,78,"['binwu', 'weirdo71', 'Derrex', 'joongsun', 'dalyx', 'jwshibing', 'jkuan', 'chenying119', 'zbrand', 'kmla1', 'jprao', 'chuixian', 'b88504120', 'papajim', 'chya', 'Kartik', 'ryw', 'cindyc', 'apettes', 'aadlakha', 'bensky', 'dstoler', 'pollini', 'bilee', 'marianam', 'dj028', 'huangzb', 'tritrial', 'andrewgoo', 'techiou', 'narii', 'karthik1024', 'bavaroi', 'veraz', 'lyrox', 'hsieh', 'kaye128', 'bbeatty', 'vikgarg', 'jongyonkim', 'goldtho', 'daims', 'chp3742', 'shacham', 'kelemvor5', 'mikedx42', 'twkt03', 'herbma', 'cphillips', 'tahirma', 'hyungkyu', 'sarahr', 'shayakb', 'ystyeoh', 'sarves', 'wmar', 'avkearne', 'mrlin', 'pisuts', 'galena', 'maslee', 'daniellwu', 'kjayanti', 'spangrle', 'wwsky', 'sylvijove', 'ski4ever', 'nhuiyan', 'ehindman', 'rdchambers', 'wangss', 'rschaevitz', 'yoonjin', 'jl1mortym', 'slchen', 'kimkeon', 'slcheng', 'sgchong']",17,"['cottier', 'xuanwu', 'ernesho', 'iliu', 'jschauer', 'jjeong1', 'davidchen', 'gunjim', 'firouzeh', 'mmessana', 'halamdar', 'whitejs', 'cschung', 'bluefrue', 'meghung', 'hobbes13180', 'cherryt']",12,"['hassanchafi', 'kupferma', 'serene', 'cloudies', 'vicsta', 'keiichimcguire', 'bluebrypi', 'vcyw', 'pierre', 'rostam', 'sqcao', None]",107,"['binwu', 'weirdo71', 'mmessana', 'Derrex', 'vcyw', 'hobbes13180', 'joongsun', 'dalyx', 'xuanwu', 'vicsta', 'jwshibing', 'jkuan', 'chenying119', 'zbrand', 'kmla1', 'jprao', 'chuixian', 'serene', 'jschauer', 'b88504120', 'papajim', 'cschung', 'chya', 'Kartik', 'ryw', 'cindyc', 'apettes', 'aadlakha', 'bensky', 'dstoler', 'pollini', 'bilee', 'marianam', 'dj028', 'huangzb', 'tritrial', 'andrewgoo', 'keiichimcguire', 'techiou', 'narii', 'cottier', 'hassanchafi', 'karthik1024', 'bavaroi', 'veraz', 'lyrox', 'cherryt', None, 'hsieh', 'kaye128', 'bbeatty', 'bluebrypi', 'firouzeh', 'vikgarg', 'jongyonkim', 'goldtho', 'kupferma', 'daims', 'shacham', 'chp3742', 'kelemvor5', 'mikedx42', 'bluefrue', 'twkt03', 'herbma', 'cphillips', 'tahirma', 'whitejs', 'meghung', 'hyungkyu', 'sarahr', 'cloudies', 'iliu', 'shayakb', 'davidchen', 'gunjim', 'ernesho', 'ystyeoh', 'sarves', 'wmar', 'avkearne', 'mrlin', 'pisuts', 'galena', 'maslee', 'daniellwu', 'kjayanti', 'wwsky', 'spangrle', 'sylvijove', 'rostam', 'ski4ever', 'sqcao', 'nhuiyan', 'ehindman', 'rdchambers', 'pierre', 'wangss', 'halamdar', 'rschaevitz', 'yoonjin', 'jjeong1', 'jl1mortym', 'slchen', 'kimkeon', 'slcheng', 'sgchong']"
2,36,96,85,77,"['binwu', 'weirdo71', 'mmessana', 'Derrex', 'hobbes13180', 'joongsun', 'dalyx', 'jwshibing', 'chenying119', 'zbrand', 'kmla1', 'jprao', 'chuixian', 'b88504120', 'papajim', 'Kartik', 'chya', 'ryw', 'cindyc', 'apettes', 'aadlakha', 'bensky', 'pollini', 'bilee', 'marianam', 'dj028', 'huangzb', 'tritrial', 'andrewgoo', 'techiou', 'narii', 'karthik1024', 'bavaroi', 'veraz', 'lyrox', 'hsieh', 'kaye128', 'bbeatty', 'vikgarg', 'jongyonkim', 'goldtho', 'daims', 'chp3742', 'kelemvor5', 'twkt03', 'herbma', 'cphillips', 'tahirma', 'whitejs', 'hyungkyu', 'sarahr', 'shayakb', 'ystyeoh', 'sarves', 'mrlin', 'avkearne', 'pisuts', 'galena', 'maslee', 'daniellwu', 'kjayanti', 'wwsky', 'sylvijove', 'ski4ever', 'nhuiyan', 'ehindman', 'rdchambers', 'halamdar', 'wangss', 'rschaevitz', 'yoonjin', 'jjeong1', 'jl1mortym', 'slchen', 'kimkeon', 'slcheng', 'sgchong']",18,"['cottier', 'xuanwu', 'iliu', 'jschauer', 'jkuan', 'davidchen', 'shacham', 'firouzeh', 'gunjim', 'spangrle', 'mikedx42', 'wmar', 'cschung', 'bluefrue', 'meghung', 'ernesho', 'cherryt', 'dstoler']",8,"['serene', 'cloudies', 'keiichimcguire', 'josephrg', 'vcyw', 'yangliu1', 'sqcao', None]",103,"['binwu', 'weirdo71', 'mmessana', 'Derrex', 'vcyw', 'hobbes13180', 'joongsun', 'dalyx', 'xuanwu', 'jwshibing', 'jkuan', 'chenying119', 'zbrand', 'kmla1', 'jprao', 'chuixian', 'serene', 'jschauer', 'b88504120', 'papajim', 'cschung', 'yangliu1', 'chya', 'Kartik', 'ryw', 'cindyc', 'apettes', 'aadlakha', 'bensky', 'dstoler', 'pollini', 'bilee', 'marianam', 'dj028', 'huangzb', 'tritrial', 'andrewgoo', 'keiichimcguire', 'techiou', 'narii', 'cottier', 'karthik1024', 'bavaroi', 'veraz', 'lyrox', 'cherryt', None, 'hsieh', 'kaye128', 'bbeatty', 'firouzeh', 'vikgarg', 'jongyonkim', 'goldtho', 'daims', 'shacham', 'chp3742', 'kelemvor5', 'mikedx42', 'bluefrue', 'twkt03', 'herbma', 'cphillips', 'tahirma', 'whitejs', 'meghung', 'hyungkyu', 'sarahr', 'cloudies', 'iliu', 'shayakb', 'davidchen', 'gunjim', 'ernesho', 'ystyeoh', 'sarves', 'wmar', 'avkearne', 'mrlin', 'pisuts', 'galena', 'maslee', 'daniellwu', 'kjayanti', 'wwsky', 'spangrle', 'sylvijove', 'josephrg', 'ski4ever', 'sqcao', 'nhuiyan', 'ehindman', 'rdchambers', 'wangss', 'halamdar', 'rschaevitz', 'yoonjin', 'jjeong1', 'jl1mortym', 'slchen', 'kimkeon', 'slcheng', 'sgchong']"
2,32,96,34,30,"['daniellwu', 'pollini', 'kjayanti', 'shacham', 'chp3742', 'sylvijove', 'Derrex', 'twkt03', 'cphillips', 'marianam', 'huangzb', 'tritrial', 'techiou', 'narii', 'jprao', 'bavaroi', 'jjeong1', 'veraz', 'b88504120', 'papajim', 'chya', 'Kartik', 'hsieh', 'kaye128', 'ryw', 'bbeatty', 'sarves', 'vikgarg', 'avkearne', 'sgchong']",65,"['galena', 'binwu', 'maslee', 'weirdo71', 'daims', 'bilee', 'kelemvor5', 'wwsky', 'mmessana', 'mikedx42', 'spangrle', 'bluefrue', 'ski4ever', 'hobbes13180', 'herbma', 'joongsun', 'nhuiyan', 'tahirma', 'dalyx', 'xuanwu', 'dj028', 'ehindman', 'jwshibing', 'andrewgoo', 'jkuan', 'chenying119', 'rdchambers', 'zbrand', 'whitejs', 'meghung', 'hyungkyu', 'sarahr', 'kmla1', 'wangss', 'halamdar', 'rschaevitz', 'chuixian', 'cottier', 'karthik1024', 'yoonjin', 'iliu', 'jschauer', 'shayakb', 'davidchen', 'jl1mortym', 'gunjim', 'slchen', 'lyrox', 'cschung', 'ernesho', 'kimkeon', 'cherryt', 'cindyc', 'apettes', 'firouzeh', 'ystyeoh', 'aadlakha', 'slcheng', 'jongyonkim', 'bensky', 'goldtho', 'wmar', 'mrlin', 'dstoler', 'pisuts']",4,"['kupferma', 'sqcao', 'serene', None]",99,"['kupferma', 'binwu', 'weirdo71', 'daims', 'shacham', 'chp3742', 'kelemvor5', 'mmessana', 'Derrex', 'mikedx42', 'bluefrue', 'hobbes13180', 'twkt03', 'joongsun', 'herbma', 'cphillips', 'tahirma', 'dalyx', 'xuanwu', 'jwshibing', 'jkuan', 'chenying119', 'zbrand', 'whitejs', 'meghung', 'hyungkyu', 'sarahr', 'kmla1', 'jprao', 'chuixian', 'serene', 'iliu', 'jschauer', 'shayakb', 'davidchen', 'gunjim', 'b88504120', 'papajim', 'cschung', 'ernesho', 'chya', 'Kartik', 'ryw', 'cindyc', 'apettes', 'ystyeoh', 'sarves', 'aadlakha', 'bensky', 'wmar', 'avkearne', 'mrlin', 'dstoler', 'pisuts', 'galena', 'maslee', 'daniellwu', 'pollini', 'kjayanti', 'bilee', 'wwsky', 'spangrle', 'sylvijove', 'ski4ever', 'sqcao', 'nhuiyan', 'marianam', 'dj028', 'huangzb', 'tritrial', 'ehindman', 'andrewgoo', 'techiou', 'rdchambers', 'wangss', 'narii', 'halamdar', 'rschaevitz', 'cottier', 'karthik1024', 'yoonjin', 'bavaroi', 'jjeong1', 'jl1mortym', 'veraz', 'slchen', 'lyrox', 'kimkeon', 'cherryt', None, 'hsieh', 'kaye128', 'bbeatty', 'firouzeh', 'slcheng', 'vikgarg', 'jongyonkim', 'goldtho', 'sgchong']"
2,34,96,15,13,"['cottier', 'xuanwu', 'cindyc', 'jkuan', 'veraz', 'firouzeh', 'mmessana', 'mikedx42', 'cschung', 'meghung', 'hobbes13180', 'dstoler', 'tahirma']",82,"['binwu', 'weirdo71', 'daims', 'shacham', 'chp3742', 'kelemvor5', 'Derrex', 'bluefrue', 'twkt03', 'joongsun', 'herbma', 'cphillips', 'dalyx', 'jwshibing', 'chenying119', 'zbrand', 'whitejs', 'hyungkyu', 'sarahr', 'kmla1', 'jprao', 'chuixian', 'iliu', 'jschauer', 'shayakb', 'davidchen', 'gunjim', 'b88504120', 'papajim', 'ernesho', 'chya', 'Kartik', 'ryw', 'apettes', 'ystyeoh', 'sarves', 'aadlakha', 'bensky', 'wmar', 'avkearne', 'mrlin', 'pisuts', 'galena', 'maslee', 'daniellwu', 'pollini', 'kjayanti', 'bilee', 'wwsky', 'spangrle', 'sylvijove', 'ski4ever', 'nhuiyan', 'marianam', 'dj028', 'huangzb', 'tritrial', 'ehindman', 'andrewgoo', 'techiou', 'rdchambers', 'wangss', 'narii', 'halamdar', 'rschaevitz', 'karthik1024', 'yoonjin', 'bavaroi', 'jjeong1', 'jl1mortym', 'slchen', 'lyrox', 'kimkeon', 'cherryt', 'hsieh', 'kaye128', 'bbeatty', 'slcheng', 'vikgarg', 'jongyonkim', 'goldtho', 'sgchong']",2,"['bluebrypi', None]",97,"['binwu', 'weirdo71', 'daims', 'shacham', 'chp3742', 'kelemvor5', 'mmessana', 'Derrex', 'mikedx42', 'bluefrue', 'hobbes13180', 'twkt03', 'joongsun', 'herbma', 'cphillips', 'tahirma', 'dalyx', 'xuanwu', 'jwshibing', 'jkuan', 'chenying119', 'zbrand', 'whitejs', 'meghung', 'hyungkyu', 'sarahr', 'kmla1', 'jprao', 'chuixian', 'iliu', 'jschauer', 'shayakb', 'davidchen', 'gunjim', 'b88504120', 'papajim', 'cschung', 'ernesho', 'chya', 'Kartik', 'ryw', 'cindyc', 'apettes', 'ystyeoh', 'sarves', 'aadlakha', 'bensky', 'wmar', 'avkearne', 'mrlin', 'dstoler', 'pisuts', 'galena', 'maslee', 'daniellwu', 'pollini', 'kjayanti', 'bilee', 'wwsky', 'spangrle', 'sylvijove', 'ski4ever', 'nhuiyan', 'marianam', 'dj028', 'huangzb', 'tritrial', 'ehindman', 'andrewgoo', 'techiou', 'rdchambers', 'wangss', 'narii', 'halamdar', 'rschaevitz', 'cottier', 'karthik1024', 'yoonjin', 'bavaroi', 'jjeong1', 'jl1mortym', 'veraz', 'slchen', 'lyrox', 'kimkeon', 'cherryt', None, 'hsieh', 'kaye128', 'bbeatty', 'bluebrypi', 'firouzeh', 'slcheng', 'vikgarg', 'jongyonkim', 'goldtho', 'sgchong']"
2,31,96,12,10,"['cottier', 'xuanwu', 'jkuan', 'davidchen', 'firouzeh', 'mikedx42', 'cschung', 'meghung', 'dstoler', 'tahirma']",85,"['binwu', 'weirdo71', 'daims', 'shacham', 'chp3742', 'kelemvor5', 'mmessana', 'Derrex', 'bluefrue', 'hobbes13180', 'twkt03', 'joongsun', 'herbma', 'cphillips', 'dalyx', 'jwshibing', 'chenying119', 'zbrand', 'whitejs', 'hyungkyu', 'sarahr', 'kmla1', 'jprao', 'chuixian', 'iliu', 'jschauer', 'shayakb', 'gunjim', 'b88504120', 'papajim', 'ernesho', 'chya', 'Kartik', 'ryw', 'cindyc', 'apettes', 'ystyeoh', 'sarves', 'aadlakha', 'bensky', 'wmar', 'avkearne', 'mrlin', 'pisuts', 'galena', 'maslee', 'daniellwu', 'pollini', 'kjayanti', 'bilee', 'wwsky', 'spangrle', 'sylvijove', 'ski4ever', 'nhuiyan', 'marianam', 'dj028', 'huangzb', 'tritrial', 'ehindman', 'andrewgoo', 'techiou', 'rdchambers', 'wangss', 'narii', 'halamdar', 'rschaevitz', 'karthik1024', 'yoonjin', 'bavaroi', 'jjeong1', 'jl1mortym', 'veraz', 'slchen', 'lyrox', 'kimkeon', 'cherryt', 'hsieh', 'kaye128', 'bbeatty', 'slcheng', 'vikgarg', 'jongyonkim', 'goldtho', 'sgchong']",2,"[None, 'twoon']",97,"['binwu', 'weirdo71', 'daims', 'shacham', 'chp3742', 'kelemvor5', 'mmessana', 'Derrex', 'mikedx42', 'bluefrue', 'hobbes13180', 'twkt03', 'joongsun', 'herbma', 'cphillips', 'tahirma', 'dalyx', 'xuanwu', 'jwshibing', 'jkuan', 'chenying119', 'zbrand', 'whitejs', 'meghung', 'hyungkyu', 'sarahr', 'kmla1', 'jprao', 'chuixian', 'iliu', 'jschauer', 'shayakb', 'davidchen', 'gunjim', 'b88504120', 'papajim', 'cschung', 'ernesho', 'chya', 'Kartik', 'ryw', 'cindyc', 'twoon', 'apettes', 'ystyeoh', 'sarves', 'aadlakha', 'bensky', 'wmar', 'avkearne', 'mrlin', 'dstoler', 'pisuts', 'galena', 'maslee', 'daniellwu', 'pollini', 'kjayanti', 'bilee', 'wwsky', 'spangrle', 'sylvijove', 'ski4ever', 'nhuiyan', 'marianam', 'dj028', 'huangzb', 'tritrial', 'ehindman', 'andrewgoo', 'techiou', 'rdchambers', 'wangss', 'narii', 'halamdar', 'rschaevitz', 'cottier', 'karthik1024', 'yoonjin', 'bavaroi', 'jjeong1', 'jl1mortym', 'veraz', 'slchen', 'lyrox', 'kimkeon', 'cherryt', None, 'hsieh', 'kaye128', 'bbeatty', 'firouzeh', 'slcheng', 'vikgarg', 'jongyonkim', 'goldtho', 'sgchong']"
2,35,96,10,6,"['huangzb', 'bavaroi', 'techiou', 'wangss', 'sarahr', 'rschaevitz']",89,"['binwu', 'weirdo71', 'daims', 'shacham', 'chp3742', 'kelemvor5', 'mmessana', 'Derrex', 'mikedx42', 'bluefrue', 'hobbes13180', 'twkt03', 'joongsun', 'herbma', 'cphillips', 'tahirma', 'dalyx', 'xuanwu', 'jwshibing', 'jkuan', 'chenying119', 'zbrand', 'whitejs', 'meghung', 'hyungkyu', 'kmla1', 'jprao', 'chuixian', 'iliu', 'jschauer', 'shayakb', 'davidchen', 'gunjim', 'b88504120', 'papajim', 'cschung', 'ernesho', 'chya', 'Kartik', 'ryw', 'cindyc', 'apettes', 'ystyeoh', 'sarves', 'aadlakha', 'bensky', 'wmar', 'avkearne', 'mrlin', 'dstoler', 'pisuts', 'galena', 'maslee', 'daniellwu', 'pollini', 'kjayanti', 'bilee', 'wwsky', 'spangrle', 'sylvijove', 'ski4ever', 'nhuiyan', 'marianam', 'dj028', 'tritrial', 'ehindman', 'andrewgoo', 'rdchambers', 'narii', 'halamdar', 'cottier', 'karthik1024', 'yoonjin', 'jjeong1', 'jl1mortym', 'veraz', 'slchen', 'lyrox', 'kimkeon', 'cherryt', 'hsieh', 'kaye128', 'bbeatty', 'firouzeh', 'slcheng', 'vikgarg', 'jongyonkim', 'goldtho', 'sgchong']",4,"['sqcao', 'serene', None, 'yangliu1']",99,"['binwu', 'weirdo71', 'daims', 'shacham', 'chp3742', 'kelemvor5', 'mmessana', 'Derrex', 'mikedx42', 'bluefrue', 'hobbes13180', 'twkt03', 'joongsun', 'herbma', 'cphillips', 'tahirma', 'dalyx', 'xuanwu', 'jwshibing', 'jkuan', 'chenying119', 'zbrand', 'whitejs', 'meghung', 'hyungkyu', 'sarahr', 'kmla1', 'jprao', 'chuixian', 'serene', 'iliu', 'jschauer', 'shayakb', 'davidchen', 'gunjim', 'b88504120', 'papajim', 'cschung', 'yangliu1', 'ernesho', 'chya', 'Kartik', 'ryw', 'cindyc', 'apettes', 'ystyeoh', 'sarves', 'aadlakha', 'bensky', 'wmar', 'avkearne', 'mrlin', 'dstoler', 'pisuts', 'galena', 'maslee', 'daniellwu', 'pollini', 'kjayanti', 'bilee', 'wwsky', 'spangrle', 'sylvijove', 'ski4ever', 'sqcao', 'nhuiyan', 'marianam', 'dj028', 'huangzb', 'tritrial', 'ehindman', 'andrewgoo', 'techiou', 'rdchambers', 'wangss', 'narii', 'halamdar', 'rschaevitz', 'cottier', 'karthik1024', 'yoonjin', 'bavaroi', 'jjeong1', 'jl1mortym', 'veraz', 'slchen', 'lyrox', 'kimkeon', 'cherryt', None, 'hsieh', 'kaye128', 'bbeatty', 'firouzeh', 'slcheng', 'vikgarg', 'jongyonkim', 'goldtho', 'sgchong']"
2,38,96,10,9,"['xuanwu', 'cindyc', 'jkuan', 'firouzeh', 'mikedx42', 'cschung', 'meghung', 'dstoler', 'tahirma']",86,"['binwu', 'weirdo71', 'daims', 'shacham', 'chp3742', 'kelemvor5', 'mmessana', 'Derrex', 'bluefrue', 'hobbes13180', 'twkt03', 'joongsun', 'herbma', 'cphillips', 'dalyx', 'jwshibing', 'chenying119', 'zbrand', 'whitejs', 'hyungkyu', 'sarahr', 'kmla1', 'jprao', 'chuixian', 'iliu', 'jschauer', 'shayakb', 'davidchen', 'gunjim', 'b88504120', 'papajim', 'ernesho', 'chya', 'Kartik', 'ryw', 'apettes', 'ystyeoh', 'sarves', 'aadlakha', 'bensky', 'wmar', 'avkearne', 'mrlin', 'pisuts', 'galena', 'maslee', 'daniellwu', 'pollini', 'kjayanti', 'bilee', 'wwsky', 'spangrle', 'sylvijove', 'ski4ever', 'nhuiyan', 'marianam', 'dj028', 'huangzb', 'tritrial', 'ehindman', 'andrewgoo', 'techiou', 'rdchambers', 'wangss', 'narii', 'halamdar', 'rschaevitz', 'cottier', 'karthik1024', 'yoonjin', 'bavaroi', 'jjeong1', 'jl1mortym', 'veraz', 'slchen', 'lyrox', 'kimkeon', 'cherryt', 'hsieh', 'kaye128', 'bbeatty', 'slcheng', 'vikgarg', 'jongyonkim', 'goldtho', 'sgchong']",1,[None],96,"['binwu', 'weirdo71', 'daims', 'shacham', 'chp3742', 'kelemvor5', 'mmessana', 'Derrex', 'mikedx42', 'bluefrue', 'hobbes13180', 'twkt03', 'joongsun', 'herbma', 'cphillips', 'tahirma', 'dalyx', 'xuanwu', 'jwshibing', 'jkuan', 'chenying119', 'zbrand', 'whitejs', 'meghung', 'hyungkyu', 'sarahr', 'kmla1', 'jprao', 'chuixian', 'iliu', 'jschauer', 'shayakb', 'davidchen', 'gunjim', 'b88504120', 'papajim', 'cschung', 'ernesho', 'chya', 'Kartik', 'ryw', 'cindyc', 'apettes', 'ystyeoh', 'sarves', 'aadlakha', 'bensky', 'wmar', 'avkearne', 'mrlin', 'dstoler', 'pisuts', 'galena', 'maslee', 'daniellwu', 'pollini', 'kjayanti', 'bilee', 'wwsky', 'spangrle', 'sylvijove', 'ski4ever', 'nhuiyan', 'marianam', 'dj028', 'huangzb', 'tritrial', 'ehindman', 'andrewgoo', 'techiou', 'rdchambers', 'wangss', 'narii', 'halamdar', 'rschaevitz', 'cottier', 'karthik1024', 'yoonjin', 'bavaroi', 'jjeong1', 'jl1mortym', 'veraz', 'slchen', 'lyrox', 'kimkeon', 'cherryt', None, 'hsieh', 'kaye128', 'bbeatty', 'firouzeh', 'slcheng', 'vikgarg', 'jongyonkim', 'goldtho', 'sgchong']"
2,37,96,7,5,"['gunjim', 'firouzeh', 'spangrle', 'ernesho', 'cherryt']",90,"['binwu', 'weirdo71', 'daims', 'shacham', 'chp3742', 'kelemvor5', 'mmessana', 'Derrex', 'mikedx42', 'bluefrue', 'hobbes13180', 'twkt03', 'joongsun', 'herbma', 'cphillips', 'tahirma', 'dalyx', 'xuanwu', 'jwshibing', 'jkuan', 'chenying119', 'zbrand', 'whitejs', 'meghung', 'hyungkyu', 'sarahr', 'kmla1', 'jprao', 'chuixian', 'iliu', 'jschauer', 'shayakb', 'davidchen', 'b88504120', 'papajim', 'cschung', 'chya', 'Kartik', 'ryw', 'cindyc', 'apettes', 'ystyeoh', 'sarves', 'aadlakha', 'bensky', 'wmar', 'avkearne', 'mrlin', 'dstoler', 'pisuts', 'galena', 'maslee', 'daniellwu', 'pollini', 'kjayanti', 'bilee', 'wwsky', 'sylvijove', 'ski4ever', 'nhuiyan', 'marianam', 'dj028', 'huangzb', 'tritrial', 'ehindman', 'andrewgoo', 'techiou', 'rdchambers', 'wangss', 'narii', 'halamdar', 'rschaevitz', 'cottier', 'karthik1024', 'yoonjin', 'bavaroi', 'jjeong1', 'jl1mortym', 'veraz', 'slchen', 'lyrox', 'kimkeon', 'hsieh', 'kaye128', 'bbeatty', 'slcheng', 'vikgarg', 'jongyonkim', 'goldtho', 'sgchong']",2,"['sqcao', None]",97,"['binwu', 'weirdo71', 'daims', 'shacham', 'chp3742', 'kelemvor5', 'mmessana', 'Derrex', 'mikedx42', 'bluefrue', 'hobbes13180', 'twkt03', 'joongsun', 'herbma', 'cphillips', 'tahirma', 'dalyx', 'xuanwu', 'jwshibing', 'jkuan', 'chenying119', 'zbrand', 'whitejs', 'meghung', 'hyungkyu', 'sarahr', 'kmla1', 'jprao', 'chuixian', 'iliu', 'jschauer', 'shayakb', 'davidchen', 'gunjim', 'b88504120', 'papajim', 'cschung', 'ernesho', 'chya', 'Kartik', 'ryw', 'cindyc', 'apettes', 'ystyeoh', 'sarves', 'aadlakha', 'bensky', 'wmar', 'avkearne', 'mrlin', 'dstoler', 'pisuts', 'galena', 'maslee', 'daniellwu', 'pollini', 'kjayanti', 'bilee', 'wwsky', 'spangrle', 'sylvijove', 'ski4ever', 'sqcao', 'nhuiyan', 'marianam', 'dj028', 'huangzb', 'tritrial', 'ehindman', 'andrewgoo', 'techiou', 'rdchambers', 'wangss', 'narii', 'halamdar', 'rschaevitz', 'cottier', 'karthik1024', 'yoonjin', 'bavaroi', 'jjeong1', 'jl1mortym', 'veraz', 'slchen', 'lyrox', 'kimkeon', 'cherryt', None, 'hsieh', 'kaye128', 'bbeatty', 'firouzeh', 'slcheng', 'vikgarg', 'jongyonkim', 'goldtho', 'sgchong']"
3,47,93,143,91,"['p1mrx', 'zer0xxx', 'greengosling', 'arteliad', 'sohil', 'tchiujan', 'cchong', 'jtill04', 'nishant007', 'yalkusai', '99GrandAmSE', 'pmavery', 'hazix007', 'bmroozia', 'mvalle', 'aahuja', 'kahopkin', '99grandamse', 'johns349', 'jshahid', 'bayalew', 'umityoruk', 'jcleong', 'rachitbiyani', 'kthudi', 'mcwalker', 'agprasad', 'jniekamp', 'nearnhar', 'singapaul', 'cg49me', 'guruLaur', 'yparsak', 'johns180', 'bchrastil', 'nchirla', 'hougary', 'Eroberer', 'aforkner', 'crosis', 'americanpiet', 'mickcrowley', 'athershb', 'jzuleger', 'nrrojas', 'somacroy', 'kumar29', 'colors41', 'dmachay', 'danvesh', 'kaufybeans', 'beneintray', 'condo', 'cabault', 'cujo668', 'aritter', 'ntjohn', 'ateixeir', 'jmhumphr', 'huang27', 'myohe', 'cluzik', 'dhum', 'm1a1abr', 'dwchapma', 'mdoherty', 'joywith', 'uptowngurl02', 'zer0xXx', 'tritter', 'EvLer', 'ashayat', 'pmongkol', 'nnovosel', 'theck', 'mreeder', 'tubby', 'clangenb', 'OsRitmos', 'singh8', 'jheim', 'tgunarto', 'sjogleka', 'nebron', 'kfoertsc', 'aquarelle', 'whitejt', 'jaconcha', 'Uptowngurl02', 'jidthekid', 'bfweber']",1,['dopkick'],52,"['dstockwe', 'cfulton', 'spgreen', 'iivan', 'gauravpatel', 'sbahl2', 'lit', 'jlouie', 'ht15000', 'flandre', 'ronaldming22', 'hatemelmatbouly', 'ttho', '02paiks', 'dmahajan', 'ctasato', 'wehlhard', 'sydelko', 'vharotoo', 'chang61', 'cjkim', 'sumeetkumargupta', 'adhaneku', 'dneedham', 'zreese', 'dannavs', 'Bozar', 'neudeck', 'anraj', 'wham217', 'anascimejr', 'dsutherl', 'zxliu2006', 'kgumiela', 'tsurma', 'sdhuang', 'mahajan86', None, 'bretb10067', 'lionel87', 'dhumble', 'osritmos', 'Evler', 'bgoldste', 'Americanpiet', 'kim131', 'ajplaymaker', 'chadhag', 'cksto', 'zhudongchun', 'Zer0xXx', 'rrlahiji']",144,"['spgreen', 'gauravpatel', 'p1mrx', 'sbahl2', 'zer0xxx', 'greengosling', 'arteliad', 'flandre', 'ronaldming22', 'sohil', 'hatemelmatbouly', 'tchiujan', 'cchong', 'jtill04', 'nishant007', 'yalkusai', '99GrandAmSE', 'pmavery', 'hazix007', 'bmroozia', 'mvalle', 'aahuja', 'zreese', 'dannavs', 'Bozar', 'neudeck', 'wham217', 'kahopkin', 'sdhuang', 'mahajan86', '99grandamse', 'dhumble', 'johns349', 'jshahid', 'bayalew', 'umityoruk', 'jcleong', 'ajplaymaker', 'chadhag', 'rachitbiyani', 'kthudi', 'mcwalker', 'agprasad', 'jniekamp', 'nearnhar', 'singapaul', 'cg49me', 'dmahajan', 'wehlhard', 'guruLaur', 'yparsak', 'johns180', 'sumeetkumargupta', 'cjkim', 'bchrastil', 'dneedham', 'nchirla', 'hougary', 'Eroberer', 'anascimejr', 'dsutherl', 'aforkner', 'crosis', None, 'americanpiet', 'lionel87', 'mickcrowley', 'athershb', 'jzuleger', 'osritmos', 'nrrojas', 'kim131', 'somacroy', 'kumar29', 'colors41', 'dmachay', 'danvesh', 'cfulton', 'lit', 'kaufybeans', 'beneintray', 'jlouie', 'ht15000', 'condo', 'cabault', 'cujo668', 'aritter', 'ntjohn', 'ateixeir', 'chang61', 'dopkick', 'jmhumphr', 'huang27', 'myohe', 'cluzik', 'dhum', 'm1a1abr', 'dwchapma', 'mdoherty', 'bretb10067', 'bgoldste', 'Zer0xXx', 'rrlahiji', 'joywith', 'dstockwe', 'iivan', 'uptowngurl02', 'zer0xXx', 'tritter', 'EvLer', 'ttho', '02paiks', 'ashayat', 'ctasato', 'sydelko', 'pmongkol', 'vharotoo', 'adhaneku', 'nnovosel', 'theck', 'mreeder', 'tubby', 'clangenb', 'OsRitmos', 'singh8', 'jheim', 'tgunarto', 'anraj', 'zxliu2006', 'sjogleka', 'kgumiela', 'tsurma', 'nebron', 'kfoertsc', 'aquarelle', 'whitejt', 'Evler', 'Americanpiet', 'jaconcha', 'Uptowngurl02', 'jidthekid', 'cksto', 'bfweber', 'zhudongchun']"
3,56,93,87,73,"['mcwalker', 'joywith', 'danvesh', 'agprasad', 'p1mrx', 'zer0xxx', 'greengosling', 'kaufybeans', 'nearnhar', 'jniekamp', 'condo', 'sohil', 'singapaul', 'cg49me', 'tchiujan', 'zer0xXx', 'cchong', 'tritter', 'EvLer', 'jtill04', 'ashayat', 'nishant007', 'guruLaur', 'yalkusai', 'yparsak', 'cabault', 'pmavery', 'ateixeir', 'aritter', 'ntjohn', 'cujo668', 'bmroozia', 'pmongkol', 'nnovosel', 'bchrastil', 'mvalle', 'theck', 'aahuja', 'nchirla', 'mreeder', 'clangenb', 'OsRitmos', 'hougary', 'huang27', 'Eroberer', 'singh8', 'cluzik', 'jheim', 'tgunarto', 'm1a1abr', 'dwchapma', 'sjogleka', 'kumar29', 'kahopkin', 'aforkner', 'kfoertsc', 'crosis', 'nebron', 'americanpiet', 'mdoherty', 'aquarelle', 'athershb', 'jzuleger', 'nrrojas', 'jshahid', 'bayalew', 'umityoruk', 'somacroy', 'Uptowngurl02', 'jidthekid', 'rachitbiyani', 'kthudi', 'dmachay']",19,"['uptowngurl02', 'beneintray', 'arteliad', '99GrandAmSE', 'johns180', 'hazix007', 'dopkick', 'tubby', 'jmhumphr', 'myohe', 'dhum', 'whitejt', '99grandamse', 'mickcrowley', 'johns349', 'jaconcha', 'jcleong', 'bfweber', 'colors41']",14,"['parsak', 'ttho', 'neudeck', 'dmahajan', 'leotrong', 'lionel87', 'Ogochi', 'lijingsjtu', 'dsutherl', 'wham', 'dneedham', None, 'lionel_lee', 'zreese']",106,"['p1mrx', 'zer0xxx', 'greengosling', 'arteliad', 'sohil', 'tchiujan', 'cchong', 'jtill04', 'nishant007', 'yalkusai', '99GrandAmSE', 'pmavery', 'hazix007', 'bmroozia', 'mvalle', 'aahuja', 'zreese', 'neudeck', 'leotrong', 'kahopkin', '99grandamse', 'johns349', 'jshahid', 'bayalew', 'umityoruk', 'jcleong', 'rachitbiyani', 'kthudi', 'mcwalker', 'agprasad', 'jniekamp', 'nearnhar', 'singapaul', 'cg49me', 'dmahajan', 'guruLaur', 'yparsak', 'johns180', 'bchrastil', 'dneedham', 'nchirla', 'hougary', 'Eroberer', 'dsutherl', 'aforkner', 'crosis', None, 'americanpiet', 'parsak', 'lionel87', 'mickcrowley', 'athershb', 'jzuleger', 'nrrojas', 'somacroy', 'kumar29', 'colors41', 'dmachay', 'danvesh', 'kaufybeans', 'beneintray', 'lionel_lee', 'condo', 'cabault', 'cujo668', 'aritter', 'ntjohn', 'ateixeir', 'dopkick', 'jmhumphr', 'huang27', 'myohe', 'cluzik', 'dhum', 'm1a1abr', 'dwchapma', 'mdoherty', 'Ogochi', 'wham', 'joywith', 'uptowngurl02', 'zer0xXx', 'tritter', 'EvLer', 'ttho', 'ashayat', 'pmongkol', 'nnovosel', 'theck', 'mreeder', 'tubby', 'clangenb', 'OsRitmos', 'singh8', 'jheim', 'tgunarto', 'sjogleka', 'nebron', 'kfoertsc', 'aquarelle', 'whitejt', 'lijingsjtu', 'jaconcha', 'Uptowngurl02', 'jidthekid', 'bfweber']"
3,62,93,71,57,"['joywith', 'mcwalker', 'danvesh', 'uptowngurl02', 'agprasad', 'p1mrx', 'greengosling', 'kaufybeans', 'nearnhar', 'condo', 'sohil', 'tritter', 'singapaul', 'tchiujan', 'EvLer', 'cchong', 'ashayat', 'nishant007', 'cabault', 'yalkusai', 'aritter', 'ateixeir', 'cujo668', 'yparsak', 'nnovosel', 'bmroozia', 'bchrastil', 'mvalle', 'mreeder', 'tubby', 'OsRitmos', 'hougary', 'huang27', 'myohe', 'Eroberer', 'cluzik', 'tgunarto', 'm1a1abr', 'dwchapma', 'sjogleka', 'kumar29', 'kahopkin', 'aforkner', 'kfoertsc', 'nebron', 'aquarelle', '99grandamse', 'athershb', 'jzuleger', 'jshahid', 'bayalew', 'umityoruk', 'jcleong', 'Uptowngurl02', 'somacroy', 'rachitbiyani', 'colors41']",35,"['zer0xxx', 'beneintray', 'arteliad', 'jniekamp', 'zer0xXx', 'cg49me', 'jtill04', 'guruLaur', 'pmongkol', '99GrandAmSE', 'pmavery', 'ntjohn', 'johns180', 'hazix007', 'theck', 'aahuja', 'nchirla', 'dopkick', 'jmhumphr', 'clangenb', 'singh8', 'dhum', 'jheim', 'crosis', 'americanpiet', 'mdoherty', 'whitejt', 'mickcrowley', 'johns349', 'nrrojas', 'jaconcha', 'jidthekid', 'bfweber', 'kthudi', 'dmachay']",14,"['ogochi', 'Ogochi', 'dmahajan', 'cfulton', 'iivan', 'rlacy', 'akhajah', 'vharotoo', 'allen28', 'adhaneku', 'dsutherl', 'cksto', None, 'estrehlo']",106,"['p1mrx', 'zer0xxx', 'greengosling', 'arteliad', 'sohil', 'tchiujan', 'cchong', 'jtill04', 'nishant007', 'yalkusai', '99GrandAmSE', 'pmavery', 'hazix007', 'bmroozia', 'mvalle', 'aahuja', 'kahopkin', '99grandamse', 'johns349', 'jshahid', 'bayalew', 'umityoruk', 'jcleong', 'rachitbiyani', 'kthudi', 'mcwalker', 'agprasad', 'jniekamp', 'nearnhar', 'singapaul', 'cg49me', 'dmahajan', 'guruLaur', 'akhajah', 'yparsak', 'johns180', 'bchrastil', 'nchirla', 'hougary', 'Eroberer', 'allen28', 'dsutherl', 'aforkner', 'crosis', None, 'americanpiet', 'mickcrowley', 'athershb', 'jzuleger', 'nrrojas', 'somacroy', 'kumar29', 'colors41', 'dmachay', 'ogochi', 'danvesh', 'cfulton', 'kaufybeans', 'beneintray', 'condo', 'rlacy', 'cabault', 'cujo668', 'aritter', 'ntjohn', 'ateixeir', 'dopkick', 'jmhumphr', 'huang27', 'myohe', 'cluzik', 'dhum', 'm1a1abr', 'dwchapma', 'estrehlo', 'mdoherty', 'Ogochi', 'joywith', 'iivan', 'uptowngurl02', 'zer0xXx', 'tritter', 'EvLer', 'ashayat', 'pmongkol', 'vharotoo', 'adhaneku', 'nnovosel', 'theck', 'mreeder', 'tubby', 'clangenb', 'OsRitmos', 'singh8', 'jheim', 'tgunarto', 'sjogleka', 'nebron', 'kfoertsc', 'aquarelle', 'whitejt', 'jaconcha', 'Uptowngurl02', 'jidthekid', 'cksto', 'bfweber']"
3,53,93,51,46,"['joywith', 'danvesh', 'uptowngurl02', 'agprasad', 'p1mrx', 'greengosling', 'kaufybeans', 'nearnhar', 'zer0xXx', 'condo', 'tritter', 'sohil', 'EvLer', 'tchiujan', 'cchong', 'jtill04', 'nishant007', 'guruLaur', 'yalkusai', 'cabault', 'aritter', 'ateixeir', 'cujo668', 'nnovosel', 'mvalle', 'tubby', 'clangenb', 'OsRitmos', 'huang27', 'cluzik', 'jheim', 'tgunarto', 'sjogleka', 'kahopkin', 'kfoertsc', 'nebron', 'crosis', 'aquarelle', '99grandamse', 'johns349', 'jzuleger', 'bayalew', 'umityoruk', 'colors41', 'rachitbiyani', 'kumar29']",46,"['mcwalker', 'zer0xxx', 'beneintray', 'arteliad', 'jniekamp', 'singapaul', 'cg49me', 'ashayat', 'pmongkol', 'yparsak', '99GrandAmSE', 'pmavery', 'ntjohn', 'johns180', 'hazix007', 'bmroozia', 'bchrastil', 'theck', 'aahuja', 'nchirla', 'dopkick', 'mreeder', 'jmhumphr', 'hougary', 'myohe', 'Eroberer', 'singh8', 'dhum', 'm1a1abr', 'dwchapma', 'aforkner', 'americanpiet', 'mdoherty', 'whitejt', 'mickcrowley', 'athershb', 'nrrojas', 'jshahid', 'jaconcha', 'somacroy', 'jcleong', 'Uptowngurl02', 'jidthekid', 'bfweber', 'kthudi', 'dmachay']",5,"['revan_m', 'dmahajan', 'sundad0212', 'dsutherl', None]",97,"['revan_m', 'danvesh', 'p1mrx', 'zer0xxx', 'greengosling', 'kaufybeans', 'beneintray', 'arteliad', 'condo', 'sohil', 'tchiujan', 'cchong', 'jtill04', 'nishant007', 'yalkusai', 'cabault', 'cujo668', '99GrandAmSE', 'pmavery', 'aritter', 'ntjohn', 'hazix007', 'bmroozia', 'ateixeir', 'sundad0212', 'mvalle', 'aahuja', 'dopkick', 'jmhumphr', 'huang27', 'myohe', 'cluzik', 'dhum', 'm1a1abr', 'dwchapma', 'kahopkin', 'mdoherty', '99grandamse', 'johns349', 'jshahid', 'bayalew', 'umityoruk', 'jcleong', 'rachitbiyani', 'kthudi', 'mcwalker', 'joywith', 'uptowngurl02', 'agprasad', 'jniekamp', 'nearnhar', 'zer0xXx', 'tritter', 'singapaul', 'cg49me', 'EvLer', 'dmahajan', 'ashayat', 'guruLaur', 'pmongkol', 'yparsak', 'johns180', 'nnovosel', 'bchrastil', 'theck', 'nchirla', 'mreeder', 'tubby', 'clangenb', 'OsRitmos', 'hougary', 'Eroberer', 'singh8', 'jheim', 'tgunarto', 'sjogleka', 'kumar29', 'dsutherl', 'aforkner', 'nebron', 'kfoertsc', 'crosis', None, 'americanpiet', 'aquarelle', 'whitejt', 'mickcrowley', 'athershb', 'jzuleger', 'nrrojas', 'jaconcha', 'somacroy', 'Uptowngurl02', 'jidthekid', 'bfweber', 'colors41', 'dmachay']"
3,48,93,19,15,"['jmhumphr', 'theck', 'jzuleger', 'dhum', 'aritter', 'jshahid', 'zer0xxx', 'jaconcha', 'somacroy', 'hazix007', 'bmroozia', 'rachitbiyani', 'kumar29', 'arteliad', 'americanpiet']",77,"['danvesh', 'p1mrx', 'greengosling', 'kaufybeans', 'beneintray', 'condo', 'sohil', 'tchiujan', 'cchong', 'jtill04', 'nishant007', 'yalkusai', 'cabault', 'cujo668', '99GrandAmSE', 'pmavery', 'ntjohn', 'ateixeir', 'mvalle', 'aahuja', 'dopkick', 'huang27', 'myohe', 'cluzik', 'm1a1abr', 'dwchapma', 'kahopkin', 'mdoherty', '99grandamse', 'johns349', 'bayalew', 'umityoruk', 'jcleong', 'kthudi', 'mcwalker', 'joywith', 'uptowngurl02', 'agprasad', 'jniekamp', 'nearnhar', 'zer0xXx', 'tritter', 'singapaul', 'cg49me', 'EvLer', 'ashayat', 'guruLaur', 'pmongkol', 'yparsak', 'johns180', 'nnovosel', 'bchrastil', 'nchirla', 'mreeder', 'tubby', 'clangenb', 'OsRitmos', 'hougary', 'Eroberer', 'singh8', 'jheim', 'tgunarto', 'sjogleka', 'aforkner', 'nebron', 'kfoertsc', 'crosis', 'aquarelle', 'whitejt', 'mickcrowley', 'athershb', 'nrrojas', 'Uptowngurl02', 'jidthekid', 'bfweber', 'colors41', 'dmachay']",4,"['clangenb08', 'spgreen', 'gauravpatel', None]",96,"['danvesh', 'spgreen', 'gauravpatel', 'p1mrx', 'zer0xxx', 'greengosling', 'kaufybeans', 'beneintray', 'arteliad', 'condo', 'sohil', 'tchiujan', 'cchong', 'jtill04', 'nishant007', 'yalkusai', 'cabault', 'cujo668', '99GrandAmSE', 'pmavery', 'aritter', 'ntjohn', 'hazix007', 'bmroozia', 'ateixeir', 'mvalle', 'aahuja', 'dopkick', 'jmhumphr', 'huang27', 'myohe', 'cluzik', 'dhum', 'm1a1abr', 'dwchapma', 'kahopkin', 'mdoherty', '99grandamse', 'johns349', 'jshahid', 'bayalew', 'umityoruk', 'jcleong', 'rachitbiyani', 'kthudi', 'clangenb08', 'mcwalker', 'joywith', 'uptowngurl02', 'agprasad', 'jniekamp', 'nearnhar', 'zer0xXx', 'tritter', 'singapaul', 'cg49me', 'EvLer', 'ashayat', 'guruLaur', 'pmongkol', 'yparsak', 'johns180', 'nnovosel', 'bchrastil', 'theck', 'nchirla', 'mreeder', 'tubby', 'clangenb', 'OsRitmos', 'hougary', 'Eroberer', 'singh8', 'jheim', 'tgunarto', 'sjogleka', 'kumar29', 'aforkner', 'nebron', 'kfoertsc', 'crosis', None, 'americanpiet', 'aquarelle', 'whitejt', 'mickcrowley', 'athershb', 'jzuleger', 'nrrojas', 'jaconcha', 'somacroy', 'Uptowngurl02', 'jidthekid', 'bfweber', 'colors41', 'dmachay']"
3,49,93,17,12,"['tubby', 'OsRitmos', 'mcwalker', 'nebron', 'yalkusai', 'm1a1abr', 'jcleong', 'kaufybeans', 'johns180', 'nnovosel', 'bchrastil', 'condo']",80,"['danvesh', 'p1mrx', 'zer0xxx', 'greengosling', 'beneintray', 'arteliad', 'sohil', 'tchiujan', 'cchong', 'jtill04', 'nishant007', 'cabault', 'cujo668', '99GrandAmSE', 'pmavery', 'aritter', 'ntjohn', 'hazix007', 'bmroozia', 'ateixeir', 'mvalle', 'aahuja', 'dopkick', 'jmhumphr', 'huang27', 'myohe', 'cluzik', 'dhum', 'dwchapma', 'kahopkin', 'mdoherty', '99grandamse', 'johns349', 'jshahid', 'bayalew', 'umityoruk', 'rachitbiyani', 'kthudi', 'joywith', 'uptowngurl02', 'agprasad', 'jniekamp', 'nearnhar', 'zer0xXx', 'tritter', 'singapaul', 'cg49me', 'EvLer', 'ashayat', 'guruLaur', 'pmongkol', 'yparsak', 'theck', 'nchirla', 'mreeder', 'clangenb', 'hougary', 'Eroberer', 'singh8', 'jheim', 'tgunarto', 'sjogleka', 'kumar29', 'aforkner', 'kfoertsc', 'crosis', 'americanpiet', 'aquarelle', 'whitejt', 'mickcrowley', 'athershb', 'jzuleger', 'nrrojas', 'jaconcha', 'somacroy', 'Uptowngurl02', 'jidthekid', 'bfweber', 'colors41', 'dmachay']",5,"['ronaldming22', 'jsommer', 'gbalmer', 'mahajan86', None]",97,"['danvesh', 'p1mrx', 'zer0xxx', 'greengosling', 'kaufybeans', 'beneintray', 'arteliad', 'condo', 'ronaldming22', 'sohil', 'tchiujan', 'cchong', 'jtill04', 'nishant007', 'yalkusai', 'cabault', 'cujo668', '99GrandAmSE', 'pmavery', 'aritter', 'ntjohn', 'hazix007', 'bmroozia', 'ateixeir', 'mvalle', 'aahuja', 'dopkick', 'jmhumphr', 'huang27', 'myohe', 'cluzik', 'dhum', 'm1a1abr', 'gbalmer', 'dwchapma', 'kahopkin', 'mahajan86', 'mdoherty', '99grandamse', 'johns349', 'jshahid', 'bayalew', 'umityoruk', 'jcleong', 'rachitbiyani', 'kthudi', 'mcwalker', 'joywith', 'uptowngurl02', 'agprasad', 'jniekamp', 'nearnhar', 'zer0xXx', 'tritter', 'singapaul', 'cg49me', 'EvLer', 'ashayat', 'guruLaur', 'pmongkol', 'yparsak', 'johns180', 'nnovosel', 'bchrastil', 'theck', 'nchirla', 'mreeder', 'tubby', 'clangenb', 'OsRitmos', 'hougary', 'Eroberer', 'singh8', 'jsommer', 'jheim', 'tgunarto', 'sjogleka', 'kumar29', 'aforkner', 'nebron', 'kfoertsc', 'crosis', None, 'americanpiet', 'aquarelle', 'whitejt', 'mickcrowley', 'athershb', 'jzuleger', 'nrrojas', 'jaconcha', 'somacroy', 'Uptowngurl02', 'jidthekid', 'bfweber', 'colors41', 'dmachay']"
3,54,93,11,9,"['aquarelle', 'cluzik', 'jheim', 'aritter', 'bayalew', 'hazix007', 'bmroozia', 'aforkner', 'americanpiet']",83,"['danvesh', 'p1mrx', 'zer0xxx', 'greengosling', 'kaufybeans', 'beneintray', 'arteliad', 'condo', 'sohil', 'tchiujan', 'cchong', 'jtill04', 'nishant007', 'yalkusai', 'cabault', 'cujo668', '99GrandAmSE', 'pmavery', 'ntjohn', 'ateixeir', 'mvalle', 'aahuja', 'dopkick', 'jmhumphr', 'huang27', 'myohe', 'dhum', 'm1a1abr', 'dwchapma', 'kahopkin', 'mdoherty', '99grandamse', 'johns349', 'jshahid', 'umityoruk', 'jcleong', 'rachitbiyani', 'kthudi', 'mcwalker', 'joywith', 'uptowngurl02', 'agprasad', 'jniekamp', 'nearnhar', 'zer0xXx', 'tritter', 'singapaul', 'cg49me', 'EvLer', 'ashayat', 'guruLaur', 'pmongkol', 'yparsak', 'johns180', 'nnovosel', 'bchrastil', 'theck', 'nchirla', 'mreeder', 'tubby', 'clangenb', 'OsRitmos', 'hougary', 'Eroberer', 'singh8', 'tgunarto', 'sjogleka', 'kumar29', 'nebron', 'kfoertsc', 'crosis', 'whitejt', 'mickcrowley', 'athershb', 'jzuleger', 'nrrojas', 'jaconcha', 'somacroy', 'Uptowngurl02', 'jidthekid', 'bfweber', 'colors41', 'dmachay']",2,"[None, 'Zer0xXx']",94,"['danvesh', 'p1mrx', 'zer0xxx', 'greengosling', 'kaufybeans', 'beneintray', 'arteliad', 'condo', 'sohil', 'tchiujan', 'cchong', 'jtill04', 'nishant007', 'yalkusai', 'cabault', 'cujo668', '99GrandAmSE', 'pmavery', 'aritter', 'ntjohn', 'hazix007', 'bmroozia', 'ateixeir', 'mvalle', 'aahuja', 'dopkick', 'jmhumphr', 'huang27', 'myohe', 'cluzik', 'dhum', 'm1a1abr', 'dwchapma', 'kahopkin', 'mdoherty', '99grandamse', 'johns349', 'jshahid', 'bayalew', 'umityoruk', 'jcleong', 'rachitbiyani', 'kthudi', 'Zer0xXx', 'mcwalker', 'joywith', 'uptowngurl02', 'agprasad', 'jniekamp', 'nearnhar', 'zer0xXx', 'tritter', 'singapaul', 'cg49me', 'EvLer', 'ashayat', 'guruLaur', 'pmongkol', 'yparsak', 'johns180', 'nnovosel', 'bchrastil', 'theck', 'nchirla', 'mreeder', 'tubby', 'clangenb', 'OsRitmos', 'hougary', 'Eroberer', 'singh8', 'jheim', 'tgunarto', 'sjogleka', 'kumar29', 'aforkner', 'nebron', 'kfoertsc', 'crosis', None, 'americanpiet', 'aquarelle', 'whitejt', 'mickcrowley', 'athershb', 'jzuleger', 'nrrojas', 'jaconcha', 'somacroy', 'Uptowngurl02', 'jidthekid', 'bfweber', 'colors41', 'dmachay']"
3,58,93,11,10,"['sohil', 'aquarelle', 'cluzik', 'tgunarto', 'aritter', 'jshahid', 'jaconcha', 'somacroy', 'hazix007', 'aforkner']",82,"['danvesh', 'p1mrx', 'zer0xxx', 'greengosling', 'kaufybeans', 'beneintray', 'arteliad', 'condo', 'tchiujan', 'cchong', 'jtill04', 'nishant007', 'yalkusai', 'cabault', 'cujo668', '99GrandAmSE', 'pmavery', 'ntjohn', 'bmroozia', 'ateixeir', 'mvalle', 'aahuja', 'dopkick', 'jmhumphr', 'huang27', 'myohe', 'dhum', 'm1a1abr', 'dwchapma', 'kahopkin', 'mdoherty', '99grandamse', 'johns349', 'bayalew', 'umityoruk', 'jcleong', 'rachitbiyani', 'kthudi', 'mcwalker', 'joywith', 'uptowngurl02', 'agprasad', 'jniekamp', 'nearnhar', 'zer0xXx', 'tritter', 'singapaul', 'cg49me', 'EvLer', 'ashayat', 'guruLaur', 'pmongkol', 'yparsak', 'johns180', 'nnovosel', 'bchrastil', 'theck', 'nchirla', 'mreeder', 'tubby', 'clangenb', 'OsRitmos', 'hougary', 'Eroberer', 'singh8', 'jheim', 'sjogleka', 'kumar29', 'nebron', 'kfoertsc', 'crosis', 'americanpiet', 'whitejt', 'mickcrowley', 'athershb', 'jzuleger', 'nrrojas', 'Uptowngurl02', 'jidthekid', 'bfweber', 'colors41', 'dmachay']",1,[None],93,"['danvesh', 'p1mrx', 'zer0xxx', 'greengosling', 'kaufybeans', 'beneintray', 'arteliad', 'condo', 'sohil', 'tchiujan', 'cchong', 'jtill04', 'nishant007', 'yalkusai', 'cabault', 'cujo668', '99GrandAmSE', 'pmavery', 'aritter', 'ntjohn', 'hazix007', 'bmroozia', 'ateixeir', 'mvalle', 'aahuja', 'dopkick', 'jmhumphr', 'huang27', 'myohe', 'cluzik', 'dhum', 'm1a1abr', 'dwchapma', 'kahopkin', 'mdoherty', '99grandamse', 'johns349', 'jshahid', 'bayalew', 'umityoruk', 'jcleong', 'rachitbiyani', 'kthudi', 'mcwalker', 'joywith', 'uptowngurl02', 'agprasad', 'jniekamp', 'nearnhar', 'zer0xXx', 'tritter', 'singapaul', 'cg49me', 'EvLer', 'ashayat', 'guruLaur', 'pmongkol', 'yparsak', 'johns180', 'nnovosel', 'bchrastil', 'theck', 'nchirla', 'mreeder', 'tubby', 'clangenb', 'OsRitmos', 'hougary', 'Eroberer', 'singh8', 'jheim', 'tgunarto', 'sjogleka', 'kumar29', 'aforkner', 'nebron', 'kfoertsc', 'crosis', None, 'americanpiet', 'aquarelle', 'whitejt', 'mickcrowley', 'athershb', 'jzuleger', 'nrrojas', 'jaconcha', 'somacroy', 'Uptowngurl02', 'jidthekid', 'bfweber', 'colors41', 'dmachay']"
3,59,93,11,6,"['cg49me', 'dhum', 'pmongkol', 'Uptowngurl02', 'jcleong', 'arteliad']",86,"['danvesh', 'p1mrx', 'zer0xxx', 'greengosling', 'kaufybeans', 'beneintray', 'condo', 'sohil', 'tchiujan', 'cchong', 'jtill04', 'nishant007', 'yalkusai', 'cabault', 'cujo668', '99GrandAmSE', 'pmavery', 'aritter', 'ntjohn', 'hazix007', 'bmroozia', 'ateixeir', 'mvalle', 'aahuja', 'dopkick', 'jmhumphr', 'huang27', 'myohe', 'cluzik', 'm1a1abr', 'dwchapma', 'kahopkin', 'mdoherty', '99grandamse', 'johns349', 'jshahid', 'bayalew', 'umityoruk', 'rachitbiyani', 'kthudi', 'mcwalker', 'joywith', 'uptowngurl02', 'agprasad', 'jniekamp', 'nearnhar', 'zer0xXx', 'tritter', 'singapaul', 'EvLer', 'ashayat', 'guruLaur', 'yparsak', 'johns180', 'nnovosel', 'bchrastil', 'theck', 'nchirla', 'mreeder', 'tubby', 'clangenb', 'OsRitmos', 'hougary', 'Eroberer', 'singh8', 'jheim', 'tgunarto', 'sjogleka', 'kumar29', 'aforkner', 'nebron', 'kfoertsc', 'crosis', 'americanpiet', 'aquarelle', 'whitejt', 'mickcrowley', 'athershb', 'jzuleger', 'nrrojas', 'jaconcha', 'somacroy', 'jidthekid', 'bfweber', 'colors41', 'dmachay']",5,"['neudeck', 'lionel87', 'singhs', None, 'lionel_lee']",97,"['danvesh', 'p1mrx', 'zer0xxx', 'greengosling', 'kaufybeans', 'beneintray', 'arteliad', 'lionel_lee', 'condo', 'sohil', 'tchiujan', 'cchong', 'jtill04', 'singhs', 'nishant007', 'yalkusai', 'cabault', 'cujo668', '99GrandAmSE', 'pmavery', 'aritter', 'ntjohn', 'hazix007', 'bmroozia', 'ateixeir', 'mvalle', 'aahuja', 'dopkick', 'jmhumphr', 'neudeck', 'huang27', 'myohe', 'cluzik', 'dhum', 'm1a1abr', 'dwchapma', 'kahopkin', 'mdoherty', '99grandamse', 'johns349', 'jshahid', 'bayalew', 'umityoruk', 'jcleong', 'rachitbiyani', 'kthudi', 'mcwalker', 'joywith', 'uptowngurl02', 'agprasad', 'jniekamp', 'nearnhar', 'zer0xXx', 'tritter', 'singapaul', 'cg49me', 'EvLer', 'ashayat', 'guruLaur', 'pmongkol', 'yparsak', 'johns180', 'nnovosel', 'bchrastil', 'theck', 'nchirla', 'mreeder', 'tubby', 'clangenb', 'OsRitmos', 'hougary', 'Eroberer', 'singh8', 'jheim', 'tgunarto', 'sjogleka', 'kumar29', 'aforkner', 'nebron', 'kfoertsc', 'crosis', None, 'americanpiet', 'aquarelle', 'whitejt', 'lionel87', 'mickcrowley', 'athershb', 'jzuleger', 'nrrojas', 'jaconcha', 'somacroy', 'Uptowngurl02', 'jidthekid', 'bfweber', 'colors41', 'dmachay']"
3,57,93,10,8,"['tubby', 'myohe', 'm1a1abr', 'Uptowngurl02', 'jcleong', 'nnovosel', 'kaufybeans', 'dmachay']",84,"['danvesh', 'p1mrx', 'zer0xxx', 'greengosling', 'beneintray', 'arteliad', 'condo', 'sohil', 'tchiujan', 'cchong', 'jtill04', 'nishant007', 'yalkusai', 'cabault', 'cujo668', '99GrandAmSE', 'pmavery', 'aritter', 'ntjohn', 'hazix007', 'bmroozia', 'ateixeir', 'mvalle', 'aahuja', 'dopkick', 'jmhumphr', 'huang27', 'cluzik', 'dhum', 'dwchapma', 'kahopkin', 'mdoherty', '99grandamse', 'johns349', 'jshahid', 'bayalew', 'umityoruk', 'rachitbiyani', 'kthudi', 'mcwalker', 'joywith', 'uptowngurl02', 'agprasad', 'jniekamp', 'nearnhar', 'zer0xXx', 'tritter', 'singapaul', 'cg49me', 'EvLer', 'ashayat', 'guruLaur', 'pmongkol', 'yparsak', 'johns180', 'bchrastil', 'theck', 'nchirla', 'mreeder', 'clangenb', 'OsRitmos', 'hougary', 'Eroberer', 'singh8', 'jheim', 'tgunarto', 'sjogleka', 'kumar29', 'aforkner', 'nebron', 'kfoertsc', 'crosis', 'americanpiet', 'aquarelle', 'whitejt', 'mickcrowley', 'athershb', 'jzuleger', 'nrrojas', 'jaconcha', 'somacroy', 'jidthekid', 'bfweber', 'colors41']",2,"[None, 'jhub908']",94,"['danvesh', 'p1mrx', 'zer0xxx', 'greengosling', 'kaufybeans', 'beneintray', 'arteliad', 'condo', 'sohil', 'tchiujan', 'cchong', 'jtill04', 'nishant007', 'yalkusai', 'cabault', 'cujo668', '99GrandAmSE', 'pmavery', 'aritter', 'ntjohn', 'hazix007', 'bmroozia', 'ateixeir', 'mvalle', 'aahuja', 'dopkick', 'jmhumphr', 'huang27', 'myohe', 'cluzik', 'dhum', 'm1a1abr', 'dwchapma', 'kahopkin', 'mdoherty', '99grandamse', 'johns349', 'jshahid', 'bayalew', 'umityoruk', 'jcleong', 'rachitbiyani', 'kthudi', 'mcwalker', 'joywith', 'uptowngurl02', 'agprasad', 'jhub908', 'jniekamp', 'nearnhar', 'zer0xXx', 'tritter', 'singapaul', 'cg49me', 'EvLer', 'ashayat', 'guruLaur', 'pmongkol', 'yparsak', 'johns180', 'nnovosel', 'bchrastil', 'theck', 'nchirla', 'mreeder', 'tubby', 'clangenb', 'OsRitmos', 'hougary', 'Eroberer', 'singh8', 'jheim', 'tgunarto', 'sjogleka', 'kumar29', 'aforkner', 'nebron', 'kfoertsc', 'crosis', None, 'americanpiet', 'aquarelle', 'whitejt', 'mickcrowley', 'athershb', 'jzuleger', 'nrrojas', 'jaconcha', 'somacroy', 'Uptowngurl02', 'jidthekid', 'bfweber', 'colors41', 'dmachay']"
3,51,93,9,7,"['singapaul', 'sjogleka', 'beneintray', 'bfweber', 'colors41', 'dmachay', 'jniekamp']",85,"['danvesh', 'p1mrx', 'zer0xxx', 'greengosling', 'kaufybeans', 'arteliad', 'condo', 'sohil', 'tchiujan', 'cchong', 'jtill04', 'nishant007', 'yalkusai', 'cabault', 'cujo668', '99GrandAmSE', 'pmavery', 'aritter', 'ntjohn', 'hazix007', 'bmroozia', 'ateixeir', 'mvalle', 'aahuja', 'dopkick', 'jmhumphr', 'huang27', 'myohe', 'cluzik', 'dhum', 'm1a1abr', 'dwchapma', 'kahopkin', 'mdoherty', '99grandamse', 'johns349', 'jshahid', 'bayalew', 'umityoruk', 'jcleong', 'rachitbiyani', 'kthudi', 'mcwalker', 'joywith', 'uptowngurl02', 'agprasad', 'nearnhar', 'zer0xXx', 'tritter', 'cg49me', 'EvLer', 'ashayat', 'guruLaur', 'pmongkol', 'yparsak', 'johns180', 'nnovosel', 'bchrastil', 'theck', 'nchirla', 'mreeder', 'tubby', 'clangenb', 'OsRitmos', 'hougary', 'Eroberer', 'singh8', 'jheim', 'tgunarto', 'kumar29', 'aforkner', 'nebron', 'kfoertsc', 'crosis', 'americanpiet', 'aquarelle', 'whitejt', 'mickcrowley', 'athershb', 'jzuleger', 'nrrojas', 'jaconcha', 'somacroy', 'Uptowngurl02', 'jidthekid']",2,"['cjkim', None]",94,"['danvesh', 'p1mrx', 'zer0xxx', 'greengosling', 'kaufybeans', 'beneintray', 'arteliad', 'condo', 'sohil', 'tchiujan', 'cchong', 'jtill04', 'nishant007', 'yalkusai', 'cabault', 'cujo668', '99GrandAmSE', 'pmavery', 'aritter', 'ntjohn', 'hazix007', 'bmroozia', 'ateixeir', 'mvalle', 'aahuja', 'dopkick', 'jmhumphr', 'huang27', 'myohe', 'cluzik', 'dhum', 'm1a1abr', 'dwchapma', 'kahopkin', 'mdoherty', '99grandamse', 'johns349', 'jshahid', 'bayalew', 'umityoruk', 'jcleong', 'rachitbiyani', 'kthudi', 'mcwalker', 'joywith', 'uptowngurl02', 'agprasad', 'jniekamp', 'nearnhar', 'zer0xXx', 'tritter', 'singapaul', 'cg49me', 'EvLer', 'ashayat', 'guruLaur', 'pmongkol', 'yparsak', 'johns180', 'nnovosel', 'cjkim', 'bchrastil', 'theck', 'nchirla', 'mreeder', 'tubby', 'clangenb', 'OsRitmos', 'hougary', 'Eroberer', 'singh8', 'jheim', 'tgunarto', 'sjogleka', 'kumar29', 'aforkner', 'nebron', 'kfoertsc', 'crosis', None, 'americanpiet', 'aquarelle', 'whitejt', 'mickcrowley', 'athershb', 'jzuleger', 'nrrojas', 'jaconcha', 'somacroy', 'Uptowngurl02', 'jidthekid', 'bfweber', 'colors41', 'dmachay']"
3,55,93,9,7,"['tubby', 'myohe', 'm1a1abr', 'jcleong', 'nnovosel', 'bchrastil', 'dmachay']",85,"['danvesh', 'p1mrx', 'zer0xxx', 'greengosling', 'kaufybeans', 'beneintray', 'arteliad', 'condo', 'sohil', 'tchiujan', 'cchong', 'jtill04', 'nishant007', 'yalkusai', 'cabault', 'cujo668', '99GrandAmSE', 'pmavery', 'aritter', 'ntjohn', 'hazix007', 'bmroozia', 'ateixeir', 'mvalle', 'aahuja', 'dopkick', 'jmhumphr', 'huang27', 'cluzik', 'dhum', 'dwchapma', 'kahopkin', 'mdoherty', '99grandamse', 'johns349', 'jshahid', 'bayalew', 'umityoruk', 'rachitbiyani', 'kthudi', 'mcwalker', 'joywith', 'uptowngurl02', 'agprasad', 'jniekamp', 'nearnhar', 'zer0xXx', 'tritter', 'singapaul', 'cg49me', 'EvLer', 'ashayat', 'guruLaur', 'pmongkol', 'yparsak', 'johns180', 'theck', 'nchirla', 'mreeder', 'clangenb', 'OsRitmos', 'hougary', 'Eroberer', 'singh8', 'jheim', 'tgunarto', 'sjogleka', 'kumar29', 'aforkner', 'nebron', 'kfoertsc', 'crosis', 'americanpiet', 'aquarelle', 'whitejt', 'mickcrowley', 'athershb', 'jzuleger', 'nrrojas', 'jaconcha', 'somacroy', 'Uptowngurl02', 'jidthekid', 'bfweber', 'colors41']",2,"[None, 'amberfrancis']",94,"['danvesh', 'p1mrx', 'zer0xxx', 'greengosling', 'kaufybeans', 'beneintray', 'arteliad', 'condo', 'sohil', 'tchiujan', 'cchong', 'jtill04', 'nishant007', 'yalkusai', 'cabault', 'cujo668', '99GrandAmSE', 'pmavery', 'aritter', 'ntjohn', 'hazix007', 'bmroozia', 'ateixeir', 'mvalle', 'aahuja', 'dopkick', 'jmhumphr', 'huang27', 'myohe', 'cluzik', 'dhum', 'm1a1abr', 'dwchapma', 'kahopkin', 'mdoherty', '99grandamse', 'johns349', 'jshahid', 'bayalew', 'umityoruk', 'jcleong', 'rachitbiyani', 'kthudi', 'mcwalker', 'joywith', 'uptowngurl02', 'agprasad', 'jniekamp', 'nearnhar', 'zer0xXx', 'tritter', 'singapaul', 'cg49me', 'EvLer', 'ashayat', 'guruLaur', 'pmongkol', 'yparsak', 'johns180', 'nnovosel', 'bchrastil', 'theck', 'nchirla', 'mreeder', 'tubby', 'clangenb', 'OsRitmos', 'hougary', 'Eroberer', 'singh8', 'jheim', 'amberfrancis', 'tgunarto', 'sjogleka', 'kumar29', 'aforkner', 'nebron', 'kfoertsc', 'crosis', None, 'americanpiet', 'aquarelle', 'whitejt', 'mickcrowley', 'athershb', 'jzuleger', 'nrrojas', 'jaconcha', 'somacroy', 'Uptowngurl02', 'jidthekid', 'bfweber', 'colors41', 'dmachay']"
3,64,93,9,6,"['aquarelle', 'cluzik', 'dhum', 'tgunarto', 'bayalew', 'jaconcha']",86,"['danvesh', 'p1mrx', 'zer0xxx', 'greengosling', 'kaufybeans', 'beneintray', 'arteliad', 'condo', 'sohil', 'tchiujan', 'cchong', 'jtill04', 'nishant007', 'yalkusai', 'cabault', 'cujo668', '99GrandAmSE', 'pmavery', 'aritter', 'ntjohn', 'hazix007', 'bmroozia', 'ateixeir', 'mvalle', 'aahuja', 'dopkick', 'jmhumphr', 'huang27', 'myohe', 'm1a1abr', 'dwchapma', 'kahopkin', 'mdoherty', '99grandamse', 'johns349', 'jshahid', 'umityoruk', 'jcleong', 'rachitbiyani', 'kthudi', 'mcwalker', 'joywith', 'uptowngurl02', 'agprasad', 'jniekamp', 'nearnhar', 'zer0xXx', 'tritter', 'singapaul', 'cg49me', 'EvLer', 'ashayat', 'guruLaur', 'pmongkol', 'yparsak', 'johns180', 'nnovosel', 'bchrastil', 'theck', 'nchirla', 'mreeder', 'tubby', 'clangenb', 'OsRitmos', 'hougary', 'Eroberer', 'singh8', 'jheim', 'sjogleka', 'kumar29', 'aforkner', 'nebron', 'kfoertsc', 'crosis', 'americanpiet', 'whitejt', 'mickcrowley', 'athershb', 'jzuleger', 'nrrojas', 'somacroy', 'Uptowngurl02', 'jidthekid', 'bfweber', 'colors41', 'dmachay']",3,"['NEUDECK', None, 'neudeck']",95,"['danvesh', 'p1mrx', 'zer0xxx', 'greengosling', 'kaufybeans', 'beneintray', 'arteliad', 'condo', 'sohil', 'tchiujan', 'cchong', 'jtill04', 'nishant007', 'yalkusai', 'cabault', 'cujo668', '99GrandAmSE', 'pmavery', 'aritter', 'ntjohn', 'hazix007', 'bmroozia', 'ateixeir', 'mvalle', 'aahuja', 'dopkick', 'jmhumphr', 'neudeck', 'huang27', 'myohe', 'cluzik', 'dhum', 'm1a1abr', 'dwchapma', 'kahopkin', 'mdoherty', '99grandamse', 'johns349', 'jshahid', 'bayalew', 'umityoruk', 'jcleong', 'rachitbiyani', 'kthudi', 'mcwalker', 'joywith', 'uptowngurl02', 'agprasad', 'jniekamp', 'nearnhar', 'zer0xXx', 'tritter', 'singapaul', 'cg49me', 'EvLer', 'ashayat', 'guruLaur', 'pmongkol', 'yparsak', 'johns180', 'nnovosel', 'bchrastil', 'theck', 'nchirla', 'mreeder', 'tubby', 'clangenb', 'OsRitmos', 'hougary', 'Eroberer', 'singh8', 'jheim', 'tgunarto', 'sjogleka', 'kumar29', 'aforkner', 'nebron', 'kfoertsc', 'crosis', None, 'americanpiet', 'NEUDECK', 'aquarelle', 'whitejt', 'mickcrowley', 'athershb', 'jzuleger', 'nrrojas', 'jaconcha', 'somacroy', 'Uptowngurl02', 'jidthekid', 'bfweber', 'colors41', 'dmachay']"
3,50,93,8,2,"['Uptowngurl02', 'mcwalker']",90,"['danvesh', 'p1mrx', 'zer0xxx', 'greengosling', 'kaufybeans', 'beneintray', 'arteliad', 'condo', 'sohil', 'tchiujan', 'cchong', 'jtill04', 'nishant007', 'yalkusai', 'cabault', 'cujo668', '99GrandAmSE', 'pmavery', 'aritter', 'ntjohn', 'hazix007', 'bmroozia', 'ateixeir', 'mvalle', 'aahuja', 'dopkick', 'jmhumphr', 'huang27', 'myohe', 'cluzik', 'dhum', 'm1a1abr', 'dwchapma', 'kahopkin', 'mdoherty', '99grandamse', 'johns349', 'jshahid', 'bayalew', 'umityoruk', 'jcleong', 'rachitbiyani', 'kthudi', 'joywith', 'uptowngurl02', 'agprasad', 'jniekamp', 'nearnhar', 'zer0xXx', 'tritter', 'singapaul', 'cg49me', 'EvLer', 'ashayat', 'guruLaur', 'pmongkol', 'yparsak', 'johns180', 'nnovosel', 'bchrastil', 'theck', 'nchirla', 'mreeder', 'tubby', 'clangenb', 'OsRitmos', 'hougary', 'Eroberer', 'singh8', 'jheim', 'tgunarto', 'sjogleka', 'kumar29', 'aforkner', 'nebron', 'kfoertsc', 'crosis', 'americanpiet', 'aquarelle', 'whitejt', 'mickcrowley', 'athershb', 'jzuleger', 'nrrojas', 'jaconcha', 'somacroy', 'jidthekid', 'bfweber', 'colors41', 'dmachay']",6,"['trs4ece', 'ajplaymaker', 'jwildey', 'tsurma', 'weehan85', None]",98,"['danvesh', 'p1mrx', 'zer0xxx', 'greengosling', 'kaufybeans', 'beneintray', 'arteliad', 'condo', 'sohil', 'tchiujan', 'cchong', 'jtill04', 'nishant007', 'yalkusai', 'cabault', 'cujo668', '99GrandAmSE', 'pmavery', 'aritter', 'ntjohn', 'hazix007', 'bmroozia', 'ateixeir', 'trs4ece', 'mvalle', 'aahuja', 'dopkick', 'jmhumphr', 'huang27', 'myohe', 'cluzik', 'dhum', 'm1a1abr', 'dwchapma', 'kahopkin', 'mdoherty', '99grandamse', 'johns349', 'jshahid', 'bayalew', 'umityoruk', 'jcleong', 'ajplaymaker', 'rachitbiyani', 'kthudi', 'mcwalker', 'joywith', 'uptowngurl02', 'agprasad', 'jwildey', 'jniekamp', 'nearnhar', 'zer0xXx', 'tritter', 'singapaul', 'cg49me', 'EvLer', 'ashayat', 'guruLaur', 'pmongkol', 'yparsak', 'johns180', 'nnovosel', 'bchrastil', 'theck', 'nchirla', 'mreeder', 'tubby', 'clangenb', 'OsRitmos', 'hougary', 'Eroberer', 'singh8', 'jheim', 'tgunarto', 'sjogleka', 'kumar29', 'tsurma', 'weehan85', 'aforkner', 'nebron', 'kfoertsc', 'crosis', None, 'americanpiet', 'aquarelle', 'whitejt', 'mickcrowley', 'athershb', 'jzuleger', 'nrrojas', 'jaconcha', 'somacroy', 'Uptowngurl02', 'jidthekid', 'bfweber', 'colors41', 'dmachay']"
3,60,93,8,6,"['tubby', 'myohe', 'm1a1abr', 'jcleong', 'nnovosel', 'dmachay']",86,"['danvesh', 'p1mrx', 'zer0xxx', 'greengosling', 'kaufybeans', 'beneintray', 'arteliad', 'condo', 'sohil', 'tchiujan', 'cchong', 'jtill04', 'nishant007', 'yalkusai', 'cabault', 'cujo668', '99GrandAmSE', 'pmavery', 'aritter', 'ntjohn', 'hazix007', 'bmroozia', 'ateixeir', 'mvalle', 'aahuja', 'dopkick', 'jmhumphr', 'huang27', 'cluzik', 'dhum', 'dwchapma', 'kahopkin', 'mdoherty', '99grandamse', 'johns349', 'jshahid', 'bayalew', 'umityoruk', 'rachitbiyani', 'kthudi', 'mcwalker', 'joywith', 'uptowngurl02', 'agprasad', 'jniekamp', 'nearnhar', 'zer0xXx', 'tritter', 'singapaul', 'cg49me', 'EvLer', 'ashayat', 'guruLaur', 'pmongkol', 'yparsak', 'johns180', 'bchrastil', 'theck', 'nchirla', 'mreeder', 'clangenb', 'OsRitmos', 'hougary', 'Eroberer', 'singh8', 'jheim', 'tgunarto', 'sjogleka', 'kumar29', 'aforkner', 'nebron', 'kfoertsc', 'crosis', 'americanpiet', 'aquarelle', 'whitejt', 'mickcrowley', 'athershb', 'jzuleger', 'nrrojas', 'jaconcha', 'somacroy', 'Uptowngurl02', 'jidthekid', 'bfweber', 'colors41']",2,"[None, 'jhub908']",94,"['danvesh', 'p1mrx', 'zer0xxx', 'greengosling', 'kaufybeans', 'beneintray', 'arteliad', 'condo', 'sohil', 'tchiujan', 'cchong', 'jtill04', 'nishant007', 'yalkusai', 'cabault', 'cujo668', '99GrandAmSE', 'pmavery', 'aritter', 'ntjohn', 'hazix007', 'bmroozia', 'ateixeir', 'mvalle', 'aahuja', 'dopkick', 'jmhumphr', 'huang27', 'myohe', 'cluzik', 'dhum', 'm1a1abr', 'dwchapma', 'kahopkin', 'mdoherty', '99grandamse', 'johns349', 'jshahid', 'bayalew', 'umityoruk', 'jcleong', 'rachitbiyani', 'kthudi', 'mcwalker', 'joywith', 'uptowngurl02', 'agprasad', 'jhub908', 'jniekamp', 'nearnhar', 'zer0xXx', 'tritter', 'singapaul', 'cg49me', 'EvLer', 'ashayat', 'guruLaur', 'pmongkol', 'yparsak', 'johns180', 'nnovosel', 'bchrastil', 'theck', 'nchirla', 'mreeder', 'tubby', 'clangenb', 'OsRitmos', 'hougary', 'Eroberer', 'singh8', 'jheim', 'tgunarto', 'sjogleka', 'kumar29', 'aforkner', 'nebron', 'kfoertsc', 'crosis', None, 'americanpiet', 'aquarelle', 'whitejt', 'mickcrowley', 'athershb', 'jzuleger', 'nrrojas', 'jaconcha', 'somacroy', 'Uptowngurl02', 'jidthekid', 'bfweber', 'colors41', 'dmachay']"
3,61,93,8,6,"['tritter', 'EvLer', 'cchong', 'nishant007', 'aritter', 'sjogleka']",86,"['danvesh', 'p1mrx', 'zer0xxx', 'greengosling', 'kaufybeans', 'beneintray', 'arteliad', 'condo', 'sohil', 'tchiujan', 'jtill04', 'yalkusai', 'cabault', 'cujo668', '99GrandAmSE', 'pmavery', 'ntjohn', 'hazix007', 'bmroozia', 'ateixeir', 'mvalle', 'aahuja', 'dopkick', 'jmhumphr', 'huang27', 'myohe', 'cluzik', 'dhum', 'm1a1abr', 'dwchapma', 'kahopkin', 'mdoherty', '99grandamse', 'johns349', 'jshahid', 'bayalew', 'umityoruk', 'jcleong', 'rachitbiyani', 'kthudi', 'mcwalker', 'joywith', 'uptowngurl02', 'agprasad', 'jniekamp', 'nearnhar', 'zer0xXx', 'singapaul', 'cg49me', 'ashayat', 'guruLaur', 'pmongkol', 'yparsak', 'johns180', 'nnovosel', 'bchrastil', 'theck', 'nchirla', 'mreeder', 'tubby', 'clangenb', 'OsRitmos', 'hougary', 'Eroberer', 'singh8', 'jheim', 'tgunarto', 'kumar29', 'aforkner', 'nebron', 'kfoertsc', 'crosis', 'americanpiet', 'aquarelle', 'whitejt', 'mickcrowley', 'athershb', 'jzuleger', 'nrrojas', 'jaconcha', 'somacroy', 'Uptowngurl02', 'jidthekid', 'bfweber', 'colors41', 'dmachay']",2,"[None, 'dsutherl']",94,"['danvesh', 'p1mrx', 'zer0xxx', 'greengosling', 'kaufybeans', 'beneintray', 'arteliad', 'condo', 'sohil', 'tchiujan', 'cchong', 'jtill04', 'nishant007', 'yalkusai', 'cabault', 'cujo668', '99GrandAmSE', 'pmavery', 'aritter', 'ntjohn', 'hazix007', 'bmroozia', 'ateixeir', 'mvalle', 'aahuja', 'dopkick', 'jmhumphr', 'huang27', 'myohe', 'cluzik', 'dhum', 'm1a1abr', 'dwchapma', 'kahopkin', 'mdoherty', '99grandamse', 'johns349', 'jshahid', 'bayalew', 'umityoruk', 'jcleong', 'rachitbiyani', 'kthudi', 'mcwalker', 'joywith', 'uptowngurl02', 'agprasad', 'jniekamp', 'nearnhar', 'zer0xXx', 'tritter', 'singapaul', 'cg49me', 'EvLer', 'ashayat', 'guruLaur', 'pmongkol', 'yparsak', 'johns180', 'nnovosel', 'bchrastil', 'theck', 'nchirla', 'mreeder', 'tubby', 'clangenb', 'OsRitmos', 'hougary', 'Eroberer', 'singh8', 'jheim', 'tgunarto', 'sjogleka', 'kumar29', 'dsutherl', 'aforkner', 'nebron', 'kfoertsc', 'crosis', None, 'americanpiet', 'aquarelle', 'whitejt', 'mickcrowley', 'athershb', 'jzuleger', 'nrrojas', 'jaconcha', 'somacroy', 'Uptowngurl02', 'jidthekid', 'bfweber', 'colors41', 'dmachay']"
3,63,93,7,6,"['tubby', 'myohe', 'm1a1abr', 'jcleong', 'nnovosel', 'condo']",86,"['danvesh', 'p1mrx', 'zer0xxx', 'greengosling', 'kaufybeans', 'beneintray', 'arteliad', 'sohil', 'tchiujan', 'cchong', 'jtill04', 'nishant007', 'yalkusai', 'cabault', 'cujo668', '99GrandAmSE', 'pmavery', 'aritter', 'ntjohn', 'hazix007', 'bmroozia', 'ateixeir', 'mvalle', 'aahuja', 'dopkick', 'jmhumphr', 'huang27', 'cluzik', 'dhum', 'dwchapma', 'kahopkin', 'mdoherty', '99grandamse', 'johns349', 'jshahid', 'bayalew', 'umityoruk', 'rachitbiyani', 'kthudi', 'mcwalker', 'joywith', 'uptowngurl02', 'agprasad', 'jniekamp', 'nearnhar', 'zer0xXx', 'tritter', 'singapaul', 'cg49me', 'EvLer', 'ashayat', 'guruLaur', 'pmongkol', 'yparsak', 'johns180', 'bchrastil', 'theck', 'nchirla', 'mreeder', 'clangenb', 'OsRitmos', 'hougary', 'Eroberer', 'singh8', 'jheim', 'tgunarto', 'sjogleka', 'kumar29', 'aforkner', 'nebron', 'kfoertsc', 'crosis', 'americanpiet', 'aquarelle', 'whitejt', 'mickcrowley', 'athershb', 'jzuleger', 'nrrojas', 'jaconcha', 'somacroy', 'Uptowngurl02', 'jidthekid', 'bfweber', 'colors41', 'dmachay']",1,[None],93,"['danvesh', 'p1mrx', 'zer0xxx', 'greengosling', 'kaufybeans', 'beneintray', 'arteliad', 'condo', 'sohil', 'tchiujan', 'cchong', 'jtill04', 'nishant007', 'yalkusai', 'cabault', 'cujo668', '99GrandAmSE', 'pmavery', 'aritter', 'ntjohn', 'hazix007', 'bmroozia', 'ateixeir', 'mvalle', 'aahuja', 'dopkick', 'jmhumphr', 'huang27', 'myohe', 'cluzik', 'dhum', 'm1a1abr', 'dwchapma', 'kahopkin', 'mdoherty', '99grandamse', 'johns349', 'jshahid', 'bayalew', 'umityoruk', 'jcleong', 'rachitbiyani', 'kthudi', 'mcwalker', 'joywith', 'uptowngurl02', 'agprasad', 'jniekamp', 'nearnhar', 'zer0xXx', 'tritter', 'singapaul', 'cg49me', 'EvLer', 'ashayat', 'guruLaur', 'pmongkol', 'yparsak', 'johns180', 'nnovosel', 'bchrastil', 'theck', 'nchirla', 'mreeder', 'tubby', 'clangenb', 'OsRitmos', 'hougary', 'Eroberer', 'singh8', 'jheim', 'tgunarto', 'sjogleka', 'kumar29', 'aforkner', 'nebron', 'kfoertsc', 'crosis', None, 'americanpiet', 'aquarelle', 'whitejt', 'mickcrowley', 'athershb', 'jzuleger', 'nrrojas', 'jaconcha', 'somacroy', 'Uptowngurl02', 'jidthekid', 'bfweber', 'colors41', 'dmachay']"
3,52,93,6,1,['mcwalker'],91,"['danvesh', 'p1mrx', 'zer0xxx', 'greengosling', 'kaufybeans', 'beneintray', 'arteliad', 'condo', 'sohil', 'tchiujan', 'cchong', 'jtill04', 'nishant007', 'yalkusai', 'cabault', 'cujo668', '99GrandAmSE', 'pmavery', 'aritter', 'ntjohn', 'hazix007', 'bmroozia', 'ateixeir', 'mvalle', 'aahuja', 'dopkick', 'jmhumphr', 'huang27', 'myohe', 'cluzik', 'dhum', 'm1a1abr', 'dwchapma', 'kahopkin', 'mdoherty', '99grandamse', 'johns349', 'jshahid', 'bayalew', 'umityoruk', 'jcleong', 'rachitbiyani', 'kthudi', 'joywith', 'uptowngurl02', 'agprasad', 'jniekamp', 'nearnhar', 'zer0xXx', 'tritter', 'singapaul', 'cg49me', 'EvLer', 'ashayat', 'guruLaur', 'pmongkol', 'yparsak', 'johns180', 'nnovosel', 'bchrastil', 'theck', 'nchirla', 'mreeder', 'tubby', 'clangenb', 'OsRitmos', 'hougary', 'Eroberer', 'singh8', 'jheim', 'tgunarto', 'sjogleka', 'kumar29', 'aforkner', 'nebron', 'kfoertsc', 'crosis', 'americanpiet', 'aquarelle', 'whitejt', 'mickcrowley', 'athershb', 'jzuleger', 'nrrojas', 'jaconcha', 'somacroy', 'Uptowngurl02', 'jidthekid', 'bfweber', 'colors41', 'dmachay']",5,"['neudeck', 'ajplaymaker', 'jwildey', 'tsurma', None]",97,"['danvesh', 'p1mrx', 'zer0xxx', 'greengosling', 'kaufybeans', 'beneintray', 'arteliad', 'condo', 'sohil', 'tchiujan', 'cchong', 'jtill04', 'nishant007', 'yalkusai', 'cabault', 'cujo668', '99GrandAmSE', 'pmavery', 'aritter', 'ntjohn', 'hazix007', 'bmroozia', 'ateixeir', 'mvalle', 'aahuja', 'dopkick', 'jmhumphr', 'neudeck', 'huang27', 'myohe', 'cluzik', 'dhum', 'm1a1abr', 'dwchapma', 'kahopkin', 'mdoherty', '99grandamse', 'johns349', 'jshahid', 'bayalew', 'umityoruk', 'jcleong', 'ajplaymaker', 'rachitbiyani', 'kthudi', 'mcwalker', 'joywith', 'uptowngurl02', 'agprasad', 'jwildey', 'jniekamp', 'nearnhar', 'zer0xXx', 'tritter', 'singapaul', 'cg49me', 'EvLer', 'ashayat', 'guruLaur', 'pmongkol', 'yparsak', 'johns180', 'nnovosel', 'bchrastil', 'theck', 'nchirla', 'mreeder', 'tubby', 'clangenb', 'OsRitmos', 'hougary', 'Eroberer', 'singh8', 'jheim', 'tgunarto', 'sjogleka', 'kumar29', 'tsurma', 'aforkner', 'nebron', 'kfoertsc', 'crosis', None, 'americanpiet', 'aquarelle', 'whitejt', 'mickcrowley', 'athershb', 'jzuleger', 'nrrojas', 'jaconcha', 'somacroy', 'Uptowngurl02', 'jidthekid', 'bfweber', 'colors41', 'dmachay']"
4,12,56,61,53,"['mljohnst', 'akremmel', 'johnsoms', 'jpcolem', 'nwenning', 'cbloink', 'pjdowns', 'ajmartin', 'wrightjc', 'ergustaf', 'gkaste', 'mpfromme', 'wvazquez', 'bruchte', 'ghempel', 'haskil73', 'cszumski', 'aolp', 'Kunami', 'jstang', 'mtada', 'william1', 'apkirk', 'millerbm', 'lrettber', 'Crouse', 'jtuberge', 'blutz', 'blangham', 'clietwil', 'ecoyle', 'tenzingj', 'drquinn198', 'tuvarish', 'amemeric', 'winnie', 'rugbycurry', 'jldaily', 'gharring', 'sollila', 'sbook', 'Zermanas', 'pburke2112', 'jefoster', 'kuo1', 'crouse', 'mlaberta', 'ewan', 'kjcheste', 'jjaworsk', 'trwilkin', 'djabaay', 'jasanche']",2,"['ppalutsi', 'natesmith']",8,"['jljennin', 'bscollin', 'yalanz', 'akerner', 'french', 'santoshkumar', 'jawebste', None]",63,"['mljohnst', 'jpcolem', 'nwenning', 'cbloink', 'pjdowns', 'ajmartin', 'wrightjc', 'mpfromme', 'wvazquez', 'bruchte', 'aolp', 'jstang', 'mtada', 'jawebste', 'william1', 'jljennin', 'apkirk', 'bscollin', 'Crouse', 'ecoyle', 'tuvarish', 'amemeric', 'winnie', 'akerner', 'rugbycurry', 'sbook', 'pburke2112', 'crouse', 'mlaberta', 'natesmith', 'trwilkin', 'jasanche', 'french', 'johnsoms', 'akremmel', 'ergustaf', 'gkaste', 'ghempel', 'haskil73', 'cszumski', 'Kunami', 'millerbm', 'yalanz', 'lrettber', 'ppalutsi', 'jtuberge', 'blutz', 'blangham', 'santoshkumar', 'clietwil', 'tenzingj', 'drquinn198', 'jldaily', 'gharring', 'sollila', 'Zermanas', None, 'jefoster', 'kuo1', 'ewan', 'kjcheste', 'jjaworsk', 'djabaay']"
5,47,40,143,3,"['dhumble', 'bgoldste', 'flandre']",36,"['operageist', 'fadelmaraqa81', 'aamphawa', 'mbirdwel', 'rfield', 'shriram', 'afaulsti', 'mrblips', 'brank0', 'anubhav', 'shalley', 'mattmakowski', 'Travis6984', 'pfuhs', 'legenux', 'pacerfan31', 'cr1084', 'kfindley', 'rao_aditya', 'vicb', 'bpitta', 'paulpabst', 'rqaseem21', 'georgetrad', 'moxo0127', 'maxmill00', 'evila', 'melloch', 'gaurav___gontiya', 'smilhem', 'amehrotr', 'iveygman', 'kholtzman', 'vincez', 'jbuttelm', 'niu_hu']",140,"['spgreen', 'gauravpatel', 'p1mrx', 'sbahl2', 'zer0xxx', 'greengosling', 'arteliad', 'ronaldming22', 'sohil', 'hatemelmatbouly', 'tchiujan', 'cchong', 'jtill04', 'nishant007', 'yalkusai', 'pmavery', '99GrandAmSE', 'hazix007', 'bmroozia', 'mvalle', 'aahuja', 'zreese', 'dannavs', 'Bozar', 'neudeck', 'wham217', 'kahopkin', 'sdhuang', 'mahajan86', '99grandamse', 'johns349', 'jshahid', 'ajplaymaker', 'chadhag', 'bayalew', 'jcleong', 'umityoruk', 'rachitbiyani', 'kthudi', 'mcwalker', 'agprasad', 'nearnhar', 'jniekamp', 'cg49me', 'singapaul', 'dmahajan', 'wehlhard', 'guruLaur', 'yparsak', 'johns180', 'sumeetkumargupta', 'cjkim', 'bchrastil', 'dneedham', 'nchirla', 'hougary', 'Eroberer', 'anascimejr', 'dsutherl', 'aforkner', 'crosis', None, 'americanpiet', 'lionel87', 'athershb', 'mickcrowley', 'jzuleger', 'osritmos', 'nrrojas', 'kim131', 'somacroy', 'kumar29', 'colors41', 'dmachay', 'cfulton', 'danvesh', 'lit', 'kaufybeans', 'beneintray', 'jlouie', 'ht15000', 'condo', 'cujo668', 'cabault', 'chang61', 'ntjohn', 'aritter', 'ateixeir', 'jmhumphr', 'huang27', 'myohe', 'cluzik', 'dhum', 'm1a1abr', 'dwchapma', 'mdoherty', 'bretb10067', 'Zer0xXx', 'rrlahiji', 'joywith', 'dstockwe', 'iivan', 'uptowngurl02', 'zer0xXx', 'tritter', 'EvLer', 'ttho', '02paiks', 'ashayat', 'ctasato', 'sydelko', 'pmongkol', 'vharotoo', 'adhaneku', 'nnovosel', 'theck', 'mreeder', 'tubby', 'clangenb', 'OsRitmos', 'singh8', 'jheim', 'tgunarto', 'anraj', 'zxliu2006', 'kgumiela', 'tsurma', 'sjogleka', 'kfoertsc', 'nebron', 'whitejt', 'aquarelle', 'Evler', 'Americanpiet', 'Uptowngurl02', 'jaconcha', 'jidthekid', 'cksto', 'bfweber', 'zhudongchun']",179,"['aamphawa', 'spgreen', 'gauravpatel', 'rfield', 'p1mrx', 'sbahl2', 'zer0xxx', 'greengosling', 'arteliad', 'flandre', 'ronaldming22', 'sohil', 'hatemelmatbouly', 'tchiujan', 'cchong', 'jtill04', 'nishant007', 'yalkusai', 'pmavery', '99GrandAmSE', 'hazix007', 'bmroozia', 'mvalle', 'cr1084', 'aahuja', 'zreese', 'dannavs', 'Bozar', 'neudeck', 'rqaseem21', 'wham217', 'moxo0127', 'kahopkin', 'sdhuang', 'mahajan86', '99grandamse', 'dhumble', 'johns349', 'jshahid', 'ajplaymaker', 'chadhag', 'bayalew', 'jcleong', 'umityoruk', 'rachitbiyani', 'kthudi', 'mcwalker', 'mbirdwel', 'agprasad', 'nearnhar', 'jniekamp', 'shalley', 'cg49me', 'singapaul', 'dmahajan', 'wehlhard', 'guruLaur', 'yparsak', 'johns180', 'sumeetkumargupta', 'cjkim', 'bchrastil', 'dneedham', 'rao_aditya', 'nchirla', 'hougary', 'vicb', 'Eroberer', 'bpitta', 'georgetrad', 'anascimejr', 'dsutherl', 'aforkner', 'crosis', None, 'americanpiet', 'lionel87', 'athershb', 'mickcrowley', 'jzuleger', 'osritmos', 'smilhem', 'nrrojas', 'kim131', 'kholtzman', 'somacroy', 'kumar29', 'colors41', 'dmachay', 'operageist', 'fadelmaraqa81', 'cfulton', 'danvesh', 'shriram', 'lit', 'kaufybeans', 'beneintray', 'jlouie', 'mrblips', 'brank0', 'ht15000', 'condo', 'cujo668', 'cabault', 'chang61', 'ntjohn', 'aritter', 'ateixeir', 'legenux', 'jmhumphr', 'huang27', 'myohe', 'cluzik', 'dhum', 'm1a1abr', 'dwchapma', 'zhudongchun', 'mdoherty', 'bretb10067', 'bgoldste', 'iveygman', 'vincez', 'Zer0xXx', 'rrlahiji', 'joywith', 'dstockwe', 'iivan', 'uptowngurl02', 'afaulsti', 'anubhav', 'zer0xXx', 'tritter', 'EvLer', 'ttho', '02paiks', 'ashayat', 'ctasato', 'mattmakowski', 'sydelko', 'Travis6984', 'pfuhs', 'pmongkol', 'vharotoo', 'adhaneku', 'nnovosel', 'pacerfan31', 'theck', 'kfindley', 'mreeder', 'tubby', 'clangenb', 'OsRitmos', 'singh8', 'jheim', 'tgunarto', 'paulpabst', 'anraj', 'zxliu2006', 'kgumiela', 'tsurma', 'sjogleka', 'kfoertsc', 'nebron', 'maxmill00', 'evila', 'melloch', 'whitejt', 'aquarelle', 'gaurav___gontiya', 'amehrotr', 'Evler', 'Americanpiet', 'Uptowngurl02', 'jaconcha', 'jidthekid', 'cksto', 'bfweber', 'jbuttelm', 'niu_hu']"
5,25,40,29,2,"['evila', 'niu_hu']",37,"['operageist', 'fadelmaraqa81', 'aamphawa', 'mbirdwel', 'rfield', 'shriram', 'afaulsti', 'mrblips', 'brank0', 'anubhav', 'flandre', 'shalley', 'mattmakowski', 'Travis6984', 'pfuhs', 'legenux', 'pacerfan31', 'cr1084', 'kfindley', 'rao_aditya', 'vicb', 'bpitta', 'paulpabst', 'rqaseem21', 'georgetrad', 'moxo0127', 'maxmill00', 'melloch', 'gaurav___gontiya', 'dhumble', 'smilhem', 'amehrotr', 'bgoldste', 'iveygman', 'kholtzman', 'vincez', 'jbuttelm']",27,"['ogara', 'kimmer2k', 'royicus', 'Nethril', 'cuongngd', 'hy_huynh', 'swchan', 'failau', 'Congdinh', 'brock8503', 'mpanah', 'shotime84', 'acejes', 'crom', 'danmeier1', 'sethv81', 'katn22', 'Subdued', 'njv81784', 'ahseo', None, 'tokki', 'vh71886', 'aeriq', 'mleung28', 'supanova', 'pmclark']",66,"['operageist', 'ogara', 'fadelmaraqa81', 'kimmer2k', 'aamphawa', 'mbirdwel', 'rfield', 'royicus', 'Nethril', 'shriram', 'afaulsti', 'cuongngd', 'swchan', 'hy_huynh', 'failau', 'mrblips', 'brank0', 'anubhav', 'flandre', 'shalley', 'Congdinh', 'mattmakowski', 'brock8503', 'Travis6984', 'pfuhs', 'mpanah', 'legenux', 'pacerfan31', 'cr1084', 'kfindley', 'rao_aditya', 'shotime84', 'acejes', 'pmclark', 'crom', 'danmeier1', 'vicb', 'sethv81', 'bpitta', 'paulpabst', 'rqaseem21', 'katn22', 'georgetrad', 'Subdued', 'njv81784', 'moxo0127', 'ahseo', None, 'maxmill00', 'evila', 'melloch', 'gaurav___gontiya', 'dhumble', 'smilhem', 'amehrotr', 'bgoldste', 'tokki', 'iveygman', 'vh71886', 'kholtzman', 'aeriq', 'mleung28', 'supanova', 'vincez', 'jbuttelm', 'niu_hu']"
5,28,40,15,14,"['melloch', 'dhumble', 'aamphawa', 'mattmakowski', 'amehrotr', 'bgoldste', 'Travis6984', 'pfuhs', 'rqaseem21', 'afaulsti', 'jbuttelm', 'cr1084', 'anubhav', 'flandre']",25,"['operageist', 'fadelmaraqa81', 'mbirdwel', 'rfield', 'shriram', 'mrblips', 'brank0', 'shalley', 'legenux', 'pacerfan31', 'kfindley', 'rao_aditya', 'vicb', 'bpitta', 'paulpabst', 'georgetrad', 'moxo0127', 'maxmill00', 'evila', 'gaurav___gontiya', 'smilhem', 'iveygman', 'kholtzman', 'vincez', 'niu_hu']",1,[None],40,"['operageist', 'fadelmaraqa81', 'aamphawa', 'mbirdwel', 'rfield', 'shriram', 'afaulsti', 'mrblips', 'brank0', 'anubhav', 'flandre', 'shalley', 'mattmakowski', 'Travis6984', 'pfuhs', 'legenux', 'pacerfan31', 'cr1084', 'kfindley', 'rao_aditya', 'vicb', 'bpitta', 'paulpabst', 'rqaseem21', 'georgetrad', 'moxo0127', None, 'maxmill00', 'evila', 'melloch', 'gaurav___gontiya', 'dhumble', 'smilhem', 'amehrotr', 'bgoldste', 'iveygman', 'kholtzman', 'vincez', 'jbuttelm', 'niu_hu']"
5,26,40,13,8,"['vicb', 'smilhem', 'bpitta', 'rfield', 'legenux', 'pacerfan31', 'mrblips', 'maxmill00']",31,"['operageist', 'fadelmaraqa81', 'aamphawa', 'mbirdwel', 'shriram', 'afaulsti', 'brank0', 'anubhav', 'flandre', 'shalley', 'mattmakowski', 'Travis6984', 'pfuhs', 'cr1084', 'kfindley', 'rao_aditya', 'paulpabst', 'rqaseem21', 'georgetrad', 'moxo0127', 'evila', 'melloch', 'gaurav___gontiya', 'dhumble', 'amehrotr', 'bgoldste', 'iveygman', 'kholtzman', 'vincez', 'jbuttelm', 'niu_hu']",5,"['philk', 'alaaawad', 'ngupta85', 'annaswan', None]",44,"['operageist', 'fadelmaraqa81', 'aamphawa', 'mbirdwel', 'rfield', 'shriram', 'afaulsti', 'mrblips', 'brank0', 'anubhav', 'flandre', 'shalley', 'mattmakowski', 'Travis6984', 'pfuhs', 'legenux', 'pacerfan31', 'cr1084', 'kfindley', 'rao_aditya', 'vicb', 'annaswan', 'bpitta', 'paulpabst', 'rqaseem21', 'philk', 'georgetrad', 'alaaawad', 'ngupta85', 'moxo0127', None, 'maxmill00', 'evila', 'melloch', 'gaurav___gontiya', 'dhumble', 'smilhem', 'amehrotr', 'bgoldste', 'iveygman', 'kholtzman', 'vincez', 'jbuttelm', 'niu_hu']"
5,27,40,6,2,"['moxo0127', 'operageist']",37,"['fadelmaraqa81', 'aamphawa', 'mbirdwel', 'rfield', 'shriram', 'afaulsti', 'mrblips', 'brank0', 'anubhav', 'flandre', 'shalley', 'mattmakowski', 'Travis6984', 'pfuhs', 'legenux', 'pacerfan31', 'cr1084', 'kfindley', 'rao_aditya', 'vicb', 'bpitta', 'paulpabst', 'rqaseem21', 'georgetrad', 'maxmill00', 'evila', 'melloch', 'gaurav___gontiya', 'dhumble', 'smilhem', 'amehrotr', 'bgoldste', 'iveygman', 'kholtzman', 'vincez', 'jbuttelm', 'niu_hu']",4,"['eekevin', None, 'aarony44', 'jschrode']",43,"['operageist', 'fadelmaraqa81', 'aamphawa', 'mbirdwel', 'rfield', 'shriram', 'afaulsti', 'mrblips', 'brank0', 'anubhav', 'flandre', 'shalley', 'eekevin', 'jschrode', 'mattmakowski', 'Travis6984', 'pfuhs', 'legenux', 'pacerfan31', 'cr1084', 'kfindley', 'rao_aditya', 'vicb', 'bpitta', 'paulpabst', 'rqaseem21', 'georgetrad', 'moxo0127', None, 'maxmill00', 'evila', 'melloch', 'gaurav___gontiya', 'dhumble', 'smilhem', 'amehrotr', 'bgoldste', 'iveygman', 'kholtzman', 'aarony44', 'vincez', 'jbuttelm', 'niu_hu']"
5,29,40,6,5,"['mbirdwel', 'paulpabst', 'iveygman', 'kholtzman', 'anubhav']",34,"['operageist', 'fadelmaraqa81', 'aamphawa', 'rfield', 'shriram', 'afaulsti', 'mrblips', 'brank0', 'flandre', 'shalley', 'mattmakowski', 'Travis6984', 'pfuhs', 'legenux', 'pacerfan31', 'cr1084', 'kfindley', 'rao_aditya', 'vicb', 'bpitta', 'rqaseem21', 'georgetrad', 'moxo0127', 'maxmill00', 'evila', 'melloch', 'gaurav___gontiya', 'dhumble', 'smilhem', 'amehrotr', 'bgoldste', 'vincez', 'jbuttelm', 'niu_hu']",1,[None],40,"['operageist', 'fadelmaraqa81', 'aamphawa', 'mbirdwel', 'rfield', 'shriram', 'afaulsti', 'mrblips', 'brank0', 'anubhav', 'flandre', 'shalley', 'mattmakowski', 'Travis6984', 'pfuhs', 'legenux', 'pacerfan31', 'cr1084', 'kfindley', 'rao_aditya', 'vicb', 'bpitta', 'paulpabst', 'rqaseem21', 'georgetrad', 'moxo0127', None, 'maxmill00', 'evila', 'melloch', 'gaurav___gontiya', 'dhumble', 'smilhem', 'amehrotr', 'bgoldste', 'iveygman', 'kholtzman', 'vincez', 'jbuttelm', 'niu_hu']"
6,25,37,29,24,"['ogara', 'kimmer2k', 'royicus', 'Nethril', 'cuongngd', 'hy_huynh', 'swchan', 'failau', 'brock8503', 'mpanah', 'shotime84', 'acejes', 'crom', 'sethv81', 'katn22', 'Subdued', 'njv81784', 'ahseo', 'tokki', 'vh71886', 'aeriq', 'mleung28', 'supanova', 'pmclark']",12,"['eekevin', 'shyenuganti', 'jschrode', 'verdancy', 'noevil', 'philk', 'leirain', 'alaaawad', 'shwetadeora', 'aarony44', 'ngupta85', 'vytla']",5,"['evila', 'Congdinh', 'danmeier1', None, 'niu_hu']",41,"['ogara', 'kimmer2k', 'verdancy', 'royicus', 'noevil', 'Nethril', 'cuongngd', 'swchan', 'hy_huynh', 'failau', 'eekevin', 'Congdinh', 'jschrode', 'shyenuganti', 'brock8503', 'mpanah', 'leirain', 'shotime84', 'acejes', 'crom', 'danmeier1', 'sethv81', 'katn22', 'Subdued', 'philk', 'alaaawad', 'ngupta85', 'njv81784', 'ahseo', None, 'evila', 'vh71886', 'tokki', 'shwetadeora', 'mleung28', 'aarony44', 'aeriq', 'supanova', 'niu_hu', 'vytla', 'pmclark']"
6,26,37,13,3,"['philk', 'alaaawad', 'ngupta85']",33,"['ogara', 'kimmer2k', 'verdancy', 'royicus', 'noevil', 'Nethril', 'cuongngd', 'hy_huynh', 'swchan', 'failau', 'eekevin', 'jschrode', 'shyenuganti', 'brock8503', 'mpanah', 'leirain', 'shotime84', 'acejes', 'crom', 'sethv81', 'katn22', 'Subdued', 'njv81784', 'ahseo', 'vh71886', 'tokki', 'shwetadeora', 'mleung28', 'aarony44', 'aeriq', 'supanova', 'vytla', 'pmclark']",10,"['vicb', 'smilhem', 'bpitta', 'rfield', 'legenux', 'pacerfan31', 'annaswan', 'mrblips', None, 'maxmill00']",46,"['ogara', 'kimmer2k', 'verdancy', 'royicus', 'noevil', 'Nethril', 'rfield', 'cuongngd', 'swchan', 'hy_huynh', 'failau', 'mrblips', 'eekevin', 'jschrode', 'shyenuganti', 'brock8503', 'mpanah', 'leirain', 'legenux', 'pacerfan31', 'shotime84', 'acejes', 'crom', 'vicb', 'sethv81', 'katn22', 'Subdued', 'philk', 'alaaawad', 'bpitta', 'ngupta85', 'njv81784', 'ahseo', None, 'maxmill00', 'smilhem', 'vh71886', 'tokki', 'shwetadeora', 'mleung28', 'aarony44', 'aeriq', 'supanova', 'annaswan', 'vytla', 'pmclark']"
6,27,37,6,3,"['eekevin', 'aarony44', 'jschrode']",33,"['ogara', 'kimmer2k', 'verdancy', 'royicus', 'noevil', 'Nethril', 'cuongngd', 'swchan', 'hy_huynh', 'failau', 'shyenuganti', 'brock8503', 'mpanah', 'leirain', 'shotime84', 'acejes', 'crom', 'sethv81', 'katn22', 'Subdued', 'philk', 'alaaawad', 'ngupta85', 'njv81784', 'ahseo', 'vh71886', 'tokki', 'shwetadeora', 'mleung28', 'aeriq', 'supanova', 'vytla', 'pmclark']",3,"['moxo0127', 'operageist', None]",39,"['ogara', 'operageist', 'kimmer2k', 'verdancy', 'royicus', 'noevil', 'Nethril', 'cuongngd', 'swchan', 'hy_huynh', 'failau', 'eekevin', 'jschrode', 'shyenuganti', 'brock8503', 'mpanah', 'leirain', 'shotime84', 'acejes', 'crom', 'sethv81', 'katn22', 'Subdued', 'philk', 'alaaawad', 'ngupta85', 'njv81784', 'moxo0127', 'ahseo', None, 'vh71886', 'tokki', 'shwetadeora', 'mleung28', 'aarony44', 'aeriq', 'supanova', 'vytla', 'pmclark']"
7,45,24,19,18,"['aeromage', 'anthony_calm', 'feng', 'saturn', 'wilson1690', 'LINWEI1002', 'shiyao9898', 'yoyo', 'clshiau', 'insp710', 'cj_liang', 'mikelin', 'm84992345', 'klhuang', 'flaghsu', 'skyan', 'benchuang', 'jy77054']",5,"['vincent_0715', 'enface', 'BIGIC', 'vitalmember', 'mudanai']",1,[None],24,"['enface', 'insp710', 'mikelin', 'klhuang', 'mudanai', 'benchuang', 'vitalmember', 'clshiau', 'shiyao9898', 'skyan', 'vincent_0715', 'anthony_calm', 'saturn', 'wilson1690', 'BIGIC', 'cj_liang', None, 'jy77054', 'aeromage', 'LINWEI1002', 'yoyo', 'm84992345', 'flaghsu', 'feng']"
8,22,23,13,10,"['zzangbbae', 'purepass', 'zeousky', 'kyb2595', 'jwcap3', 'duck7k', 'truballer', 'dba0024', 'gohee0', 'jinookips']",12,"['yoonjh79', 'imagedb', 'mareks', 'goska777', 'starhouseh', 'cjnolja', 'pireuz', 'Darth', 'shrey', 'didtjd', 'msepys', 'l2h2j2']",3,"['gardenbell', None, 'donglee11']",25,"['yoonjh79', 'gardenbell', 'zzangbbae', 'purepass', 'zeousky', 'cjnolja', 'truballer', 'gohee0', 'jinookips', None, 'l2h2j2', 'imagedb', 'mareks', 'goska777', 'donglee11', 'starhouseh', 'kyb2595', 'jwcap3', 'duck7k', 'pireuz', 'Darth', 'shrey', 'didtjd', 'dba0024', 'msepys']"
8,23,23,12,10,"['yoonjh79', 'imagedb', 'starhouseh', 'cjnolja', 'truballer', 'didtjd', 'pireuz', 'msepys', 'gohee0', 'l2h2j2']",12,"['mareks', 'zzangbbae', 'goska777', 'purepass', 'zeousky', 'kyb2595', 'jwcap3', 'duck7k', 'Darth', 'shrey', 'dba0024', 'jinookips']",2,"['gardenbell', None]",24,"['yoonjh79', 'gardenbell', 'zzangbbae', 'purepass', 'zeousky', 'cjnolja', 'truballer', 'gohee0', 'jinookips', None, 'l2h2j2', 'imagedb', 'mareks', 'goska777', 'starhouseh', 'kyb2595', 'jwcap3', 'duck7k', 'pireuz', 'Darth', 'shrey', 'didtjd', 'dba0024', 'msepys']"
9,10,21,21,17,"['sara78', 'cosmoswu', 'andreim', 'yjiang', 'punwong', 'kefalidi', 'carlotto', 'ahamemnon', 'zwang6', 'rdauria', 'avanderg', 'dhermith', 'wswhy', 'jaymq', 'ischapir', 'minghsun', 'tianshu']",3,"['caterpillars', 'nanosun', 'chchang']",4,"[None, 'strachan', 'apalaria', 'sridevi']",24,"['sara78', 'cosmoswu', 'apalaria', 'carlotto', 'zwang6', 'rdauria', 'wswhy', 'caterpillars', 'andreim', 'yjiang', 'ahamemnon', 'dhermith', 'sridevi', 'ischapir', 'tianshu', 'jaymq', 'punwong', None, 'nanosun', 'kefalidi', 'strachan', 'chchang', 'avanderg', 'minghsun']"
10,7,18,18,15,"['skmuneer_786', 'rdoddaveeregowda', 'koooldude', 'vaman_reddys', 'aditya_app', 'choudari_raki', 'rahulprk4', 'moin49', 'rpm501', 'satjaguar', 'aliuddin', 'shazib44', 'rnandavanam', 'anusha', 'aditya_App']",2,"['dabbate', 'scapala']",3,"[None, 'moinul95', 'boddapati']",20,"['skmuneer_786', 'rdoddaveeregowda', 'moinul95', 'choudari_raki', 'shazib44', 'rnandavanam', None, 'aditya_App', 'koooldude', 'vaman_reddys', 'scapala', 'aditya_app', 'rahulprk4', 'boddapati', 'moin49', 'rpm501', 'satjaguar', 'aliuddin', 'dabbate', 'anusha']"
12,42,16,17,2,"['chlwogh3', 'lhy1125']",13,"['leslievogt', 'moh_atef2000', 'winkkk85', 'jasonotterstrom', 'luwang', 'nihavd', 'samarthjain', 'cuitino', 'jdw11', 'jbrkeith', 'reuster986', 'chem242', 'jay0647']",15,"['yoonsung12', 'phs8338', 'apranibita', 'm4500', 'dotage86', 'yh1kim', 'Swani', 'innomie', 'rivercycle', 'chocgm', 'bonoyam', 'sysyb', 'kwr0118', None, 'usilian']",30,"['yoonsung12', 'apranibita', 'samarthjain', 'yh1kim', 'Swani', 'rivercycle', 'bonoyam', 'sysyb', 'jbrkeith', 'chem242', 'moh_atef2000', 'phs8338', 'jasonotterstrom', 'dotage86', 'jdw11', 'lhy1125', 'reuster986', 'usilian', 'winkkk85', 'luwang', 'nihavd', 'm4500', 'chlwogh3', 'chocgm', 'kwr0118', None, 'jay0647', 'leslievogt', 'cuitino', 'innomie']"
12,44,16,7,5,"['leslievogt', 'jasonotterstrom', 'luwang', 'chem242', 'jay0647']",10,"['moh_atef2000', 'winkkk85', 'nihavd', 'cuitino', 'samarthjain', 'chlwogh3', 'jdw11', 'jbrkeith', 'lhy1125', 'reuster986']",2,"['tabaker', None]",17,"['tabaker', 'winkkk85', 'luwang', 'nihavd', 'samarthjain', 'chlwogh3', 'jbrkeith', 'chem242', None, 'jay0647', 'leslievogt', 'moh_atef2000', 'jasonotterstrom', 'cuitino', 'jdw11', 'lhy1125', 'reuster986']"
13,47,15,143,8,"['kim131', 'anraj', 'wham217', 'cjkim', 'kgumiela', 'tsurma', 'zhudongchun', 'rrlahiji']",6,"['jsommer', 'trs4ece', 'gbalmer', 'jwildey', 'weehan85', 'clangenb08']",135,"['spgreen', 'gauravpatel', 'p1mrx', 'sbahl2', 'zer0xxx', 'greengosling', 'arteliad', 'flandre', 'ronaldming22', 'sohil', 'hatemelmatbouly', 'tchiujan', 'cchong', 'jtill04', 'nishant007', 'yalkusai', 'pmavery', '99GrandAmSE', 'hazix007', 'bmroozia', 'mvalle', 'aahuja', 'zreese', 'dannavs', 'Bozar', 'neudeck', 'kahopkin', 'sdhuang', 'mahajan86', '99grandamse', 'dhumble', 'johns349', 'jshahid', 'ajplaymaker', 'chadhag', 'bayalew', 'jcleong', 'umityoruk', 'rachitbiyani', 'kthudi', 'mcwalker', 'agprasad', 'nearnhar', 'jniekamp', 'cg49me', 'singapaul', 'dmahajan', 'wehlhard', 'guruLaur', 'yparsak', 'johns180', 'sumeetkumargupta', 'bchrastil', 'dneedham', 'nchirla', 'hougary', 'Eroberer', 'anascimejr', 'dsutherl', 'aforkner', 'crosis', None, 'americanpiet', 'lionel87', 'athershb', 'mickcrowley', 'jzuleger', 'osritmos', 'nrrojas', 'somacroy', 'kumar29', 'colors41', 'dmachay', 'cfulton', 'danvesh', 'lit', 'kaufybeans', 'beneintray', 'jlouie', 'ht15000', 'condo', 'cujo668', 'cabault', 'chang61', 'ntjohn', 'aritter', 'ateixeir', 'jmhumphr', 'huang27', 'myohe', 'cluzik', 'dhum', 'm1a1abr', 'dwchapma', 'mdoherty', 'bretb10067', 'bgoldste', 'Zer0xXx', 'joywith', 'dstockwe', 'iivan', 'uptowngurl02', 'zer0xXx', 'tritter', 'EvLer', 'ttho', '02paiks', 'ashayat', 'ctasato', 'sydelko', 'pmongkol', 'vharotoo', 'adhaneku', 'nnovosel', 'theck', 'mreeder', 'tubby', 'clangenb', 'OsRitmos', 'singh8', 'jheim', 'tgunarto', 'zxliu2006', 'sjogleka', 'kfoertsc', 'nebron', 'whitejt', 'aquarelle', 'Evler', 'Americanpiet', 'Uptowngurl02', 'jaconcha', 'jidthekid', 'cksto', 'bfweber']",149,"['spgreen', 'gauravpatel', 'p1mrx', 'sbahl2', 'zer0xxx', 'greengosling', 'arteliad', 'flandre', 'ronaldming22', 'sohil', 'hatemelmatbouly', 'tchiujan', 'cchong', 'jtill04', 'nishant007', 'yalkusai', 'trs4ece', 'pmavery', '99GrandAmSE', 'hazix007', 'bmroozia', 'mvalle', 'aahuja', 'zreese', 'dannavs', 'Bozar', 'neudeck', 'gbalmer', 'wham217', 'kahopkin', 'sdhuang', 'mahajan86', '99grandamse', 'dhumble', 'johns349', 'jshahid', 'ajplaymaker', 'chadhag', 'bayalew', 'jcleong', 'umityoruk', 'clangenb08', 'rachitbiyani', 'kthudi', 'mcwalker', 'agprasad', 'nearnhar', 'jniekamp', 'cg49me', 'singapaul', 'dmahajan', 'wehlhard', 'guruLaur', 'yparsak', 'cjkim', 'johns180', 'sumeetkumargupta', 'bchrastil', 'dneedham', 'nchirla', 'hougary', 'Eroberer', 'anascimejr', 'dsutherl', 'aforkner', 'crosis', None, 'americanpiet', 'lionel87', 'athershb', 'mickcrowley', 'jzuleger', 'osritmos', 'kim131', 'nrrojas', 'somacroy', 'kumar29', 'colors41', 'dmachay', 'cfulton', 'danvesh', 'lit', 'kaufybeans', 'beneintray', 'jlouie', 'ht15000', 'condo', 'cujo668', 'cabault', 'chang61', 'ntjohn', 'aritter', 'ateixeir', 'jmhumphr', 'huang27', 'myohe', 'cluzik', 'dhum', 'm1a1abr', 'dwchapma', 'mdoherty', 'bretb10067', 'bgoldste', 'Zer0xXx', 'rrlahiji', 'joywith', 'dstockwe', 'iivan', 'uptowngurl02', 'jwildey', 'zer0xXx', 'tritter', 'EvLer', 'ttho', '02paiks', 'ashayat', 'ctasato', 'sydelko', 'pmongkol', 'vharotoo', 'adhaneku', 'nnovosel', 'theck', 'mreeder', 'tubby', 'clangenb', 'OsRitmos', 'singh8', 'jsommer', 'jheim', 'tgunarto', 'anraj', 'zxliu2006', 'kgumiela', 'tsurma', 'weehan85', 'sjogleka', 'kfoertsc', 'nebron', 'whitejt', 'aquarelle', 'Evler', 'Americanpiet', 'Uptowngurl02', 'jaconcha', 'jidthekid', 'cksto', 'bfweber', 'zhudongchun']"
13,48,15,19,1,['clangenb08'],13,"['jsommer', 'trs4ece', 'gbalmer', 'anraj', 'kim131', 'jwildey', 'cjkim', 'kgumiela', 'wham217', 'weehan85', 'tsurma', 'zhudongchun', 'rrlahiji']",18,"['jmhumphr', 'theck', 'spgreen', 'jzuleger', 'gauravpatel', 'dhum', 'aritter', 'jshahid', 'zer0xxx', 'jaconcha', 'somacroy', 'hazix007', 'bmroozia', 'rachitbiyani', 'kumar29', 'arteliad', None, 'americanpiet']",32,"['spgreen', 'gauravpatel', 'zer0xxx', 'jwildey', 'arteliad', 'rachitbiyani', 'trs4ece', 'aritter', 'cjkim', 'hazix007', 'bmroozia', 'theck', 'jmhumphr', 'jsommer', 'dhum', 'gbalmer', 'anraj', 'wham217', 'kgumiela', 'tsurma', 'weehan85', None, 'americanpiet', 'jzuleger', 'kim131', 'jshahid', 'jaconcha', 'somacroy', 'clangenb08', 'kumar29', 'zhudongchun', 'rrlahiji']"
13,49,15,17,2,"['gbalmer', 'jsommer']",12,"['trs4ece', 'anraj', 'kim131', 'jwildey', 'cjkim', 'kgumiela', 'wham217', 'weehan85', 'tsurma', 'clangenb08', 'zhudongchun', 'rrlahiji']",15,"['ronaldming22', 'tubby', 'OsRitmos', 'mcwalker', 'nebron', 'yalkusai', 'm1a1abr', 'jcleong', 'kaufybeans', 'johns180', 'nnovosel', 'bchrastil', 'mahajan86', None, 'condo']",29,"['tubby', 'OsRitmos', 'mcwalker', 'jsommer', 'gbalmer', 'anraj', 'jwildey', 'wham217', 'kgumiela', 'tsurma', 'weehan85', 'm1a1abr', 'kaufybeans', 'nebron', 'mahajan86', None, 'condo', 'ronaldming22', 'yalkusai', 'kim131', 'trs4ece', 'cjkim', 'jcleong', 'johns180', 'nnovosel', 'clangenb08', 'bchrastil', 'zhudongchun', 'rrlahiji']"
13,51,15,9,1,['cjkim'],13,"['jsommer', 'kim131', 'gbalmer', 'anraj', 'trs4ece', 'jwildey', 'kgumiela', 'wham217', 'weehan85', 'tsurma', 'clangenb08', 'zhudongchun', 'rrlahiji']",8,"['singapaul', None, 'sjogleka', 'beneintray', 'bfweber', 'colors41', 'dmachay', 'jniekamp']",22,"['bfweber', 'jsommer', 'gbalmer', 'anraj', 'jwildey', 'wham217', 'kgumiela', 'tsurma', 'weehan85', 'sjogleka', 'beneintray', None, 'jniekamp', 'singapaul', 'kim131', 'trs4ece', 'cjkim', 'clangenb08', 'colors41', 'zhudongchun', 'dmachay', 'rrlahiji']"
13,50,15,8,4,"['jwildey', 'tsurma', 'weehan85', 'trs4ece']",10,"['jsommer', 'kim131', 'gbalmer', 'anraj', 'wham217', 'cjkim', 'kgumiela', 'clangenb08', 'zhudongchun', 'rrlahiji']",4,"['ajplaymaker', 'Uptowngurl02', None, 'mcwalker']",18,"['mcwalker', 'jsommer', 'gbalmer', 'anraj', 'jwildey', 'wham217', 'kgumiela', 'tsurma', 'weehan85', None, 'kim131', 'trs4ece', 'ajplaymaker', 'Uptowngurl02', 'cjkim', 'clangenb08', 'zhudongchun', 'rrlahiji']"
13,52,15,6,2,"['jwildey', 'tsurma']",12,"['jsommer', 'kim131', 'gbalmer', 'anraj', 'trs4ece', 'cjkim', 'kgumiela', 'wham217', 'weehan85', 'clangenb08', 'zhudongchun', 'rrlahiji']",4,"['ajplaymaker', None, 'neudeck', 'mcwalker']",18,"['neudeck', 'mcwalker', 'jsommer', 'gbalmer', 'anraj', 'jwildey', 'wham217', 'kgumiela', 'tsurma', 'weehan85', None, 'kim131', 'trs4ece', 'ajplaymaker', 'cjkim', 'clangenb08', 'zhudongchun', 'rrlahiji']"
14,12,14,61,2,"['yalanz', 'akerner']",11,"['sshekhar', 'kgrosskl', 'sjmen', 'wang180', 'iyums', 'kim319', 'marajhowell', 'arvind_nanohub', 'vvcshekhar', 'dely', 'keyamamo']",59,"['jpcolem', 'akremmel', 'johnsoms', 'mljohnst', 'nwenning', 'cbloink', 'pjdowns', 'ajmartin', 'wrightjc', 'ergustaf', 'mpfromme', 'gkaste', 'wvazquez', 'bruchte', 'ghempel', 'aolp', 'cszumski', 'haskil73', 'Kunami', 'jstang', 'mtada', 'jawebste', 'william1', 'jljennin', 'apkirk', 'millerbm', 'bscollin', 'lrettber', 'Crouse', 'jtuberge', 'blutz', 'blangham', 'santoshkumar', 'clietwil', 'ecoyle', 'tenzingj', 'drquinn198', 'tuvarish', 'amemeric', 'winnie', 'rugbycurry', 'jldaily', 'gharring', 'sollila', 'sbook', 'Zermanas', 'pburke2112', None, 'jasanche', 'jefoster', 'kuo1', 'crouse', 'mlaberta', 'ewan', 'kjcheste', 'jjaworsk', 'trwilkin', 'djabaay', 'french']",72,"['jpcolem', 'mljohnst', 'nwenning', 'cbloink', 'pjdowns', 'sjmen', 'ajmartin', 'iyums', 'wrightjc', 'mpfromme', 'wvazquez', 'bruchte', 'aolp', 'jstang', 'mtada', 'jawebste', 'william1', 'jljennin', 'apkirk', 'bscollin', 'wang180', 'Crouse', 'ecoyle', 'tuvarish', 'amemeric', 'winnie', 'akerner', 'kgrosskl', 'rugbycurry', 'sbook', 'pburke2112', 'crouse', 'sshekhar', 'mlaberta', 'vvcshekhar', 'trwilkin', 'keyamamo', 'jasanche', 'french', 'johnsoms', 'akremmel', 'ergustaf', 'gkaste', 'kim319', 'ghempel', 'cszumski', 'haskil73', 'Kunami', 'yalanz', 'millerbm', 'lrettber', 'jtuberge', 'blutz', 'blangham', 'santoshkumar', 'clietwil', 'tenzingj', 'drquinn198', 'jldaily', 'gharring', 'marajhowell', 'dely', 'sollila', 'Zermanas', None, 'jefoster', 'kuo1', 'arvind_nanohub', 'ewan', 'kjcheste', 'jjaworsk', 'djabaay']"
14,11,14,18,11,"['yalanz', 'sshekhar', 'akerner', 'kgrosskl', 'wang180', 'iyums', 'kim319', 'marajhowell', 'arvind_nanohub', 'dely', 'keyamamo']",2,"['sjmen', 'vvcshekhar']",7,"['liangz', 'hunt77', 'strachan', 'lynewman', 'lzalamea', 'tdatta', None]",20,"['akerner', 'kgrosskl', 'sjmen', 'iyums', 'kim319', 'marajhowell', 'dely', None, 'yalanz', 'sshekhar', 'liangz', 'hunt77', 'wang180', 'strachan', 'lynewman', 'arvind_nanohub', 'vvcshekhar', 'lzalamea', 'tdatta', 'keyamamo']"
14,13,14,17,12,"['yalanz', 'sshekhar', 'kgrosskl', 'sjmen', 'wang180', 'iyums', 'kim319', 'marajhowell', 'arvind_nanohub', 'vvcshekhar', 'dely', 'keyamamo']",1,['akerner'],5,"['liangz', 'lynewman', 'lzalamea', 'hunter1', None]",18,"['akerner', 'kgrosskl', 'sjmen', 'iyums', 'kim319', 'marajhowell', 'dely', None, 'yalanz', 'sshekhar', 'liangz', 'wang180', 'lynewman', 'arvind_nanohub', 'vvcshekhar', 'lzalamea', 'hunter1', 'keyamamo']"
15,17,12,32,10,"['pbatra', 'cson', 'skumar33', 'benafsha', 'ramith', 'zding', 'dlekshma', '0214moon', 'kainlulow', 'michi']",1,['khagner'],22,"['sayeef', 'pdcarpen', 'sgangwal', 'yqwu', 'raseong', 'lutfe_siddiqui', 'lundstro', 'odawodu', 'park35', 'himadri', 'sumeetkumargupta', 'dvarghe', 'jaydeep', 'tokyo2000', 'kcantley', 'aeislam', None, 'mengz', 'ghost9804', 'lynewman', 'usman', 'elec1020']",33,"['pbatra', 'cson', 'sayeef', 'zding', 'pdcarpen', 'sgangwal', 'yqwu', 'raseong', 'lutfe_siddiqui', 'lundstro', 'odawodu', 'ramith', 'dlekshma', 'park35', 'kainlulow', 'himadri', 'sumeetkumargupta', 'khagner', 'dvarghe', 'jaydeep', 'tokyo2000', 'benafsha', 'kcantley', 'aeislam', 'michi', None, 'mengz', 'skumar33', 'ghost9804', 'lynewman', '0214moon', 'usman', 'elec1020']"
15,16,12,31,8,"['pbatra', 'cson', 'skumar33', 'zding', 'dlekshma', '0214moon', 'kainlulow', 'michi']",3,"['benafsha', 'ramith', 'khagner']",23,"['sayeef', 'pdcarpen', 'sgangwal', 'qikaichen', 'zainu', 'yqwu', 'behinaein', 'raseong', 'lutfe_siddiqui', 'odawodu', 'park35', 'himadri', 'nnwatkin', 'paul_nano_tran', 'dvarghe', 'jaydeep', 'judith2006', 'yishao', None, 'vivihaha', 'ghost9804', 'lynewman', 'elec1020']",34,"['pbatra', 'cson', 'sayeef', 'zding', 'pdcarpen', 'sgangwal', 'qikaichen', 'zainu', 'yqwu', 'behinaein', 'raseong', 'lutfe_siddiqui', 'odawodu', 'ramith', 'dlekshma', 'park35', 'kainlulow', 'himadri', 'nnwatkin', 'khagner', 'paul_nano_tran', 'dvarghe', 'jaydeep', 'judith2006', 'benafsha', 'michi', 'yishao', None, 'vivihaha', 'skumar33', 'ghost9804', 'lynewman', '0214moon', 'elec1020']"
15,46,12,31,10,"['pbatra', 'cson', 'skumar33', 'benafsha', 'ramith', 'zding', 'dlekshma', '0214moon', 'kainlulow', 'michi']",1,['khagner'],21,"['sayeef', 'pdcarpen', 'sgangwal', 'yqwu', 'behinaein', 'raseong', 'lutfe_siddiqui', 'odawodu', 'park35', 'himadri', 'MICHI', 'dvarghe', 'jaydeep', 'judith2006', 'kcantley', 'aeislam', None, 'mengz', 'ghost9804', 'lynewman', 'usman']",32,"['pbatra', 'cson', 'sayeef', 'zding', 'pdcarpen', 'sgangwal', 'yqwu', 'behinaein', 'raseong', 'lutfe_siddiqui', 'odawodu', 'ramith', 'dlekshma', 'park35', 'kainlulow', 'MICHI', 'himadri', 'khagner', 'dvarghe', 'jaydeep', 'judith2006', 'benafsha', 'kcantley', 'aeislam', 'michi', None, 'mengz', 'skumar33', 'ghost9804', 'lynewman', '0214moon', 'usman']"
15,15,12,29,9,"['pbatra', 'cson', 'skumar33', 'benafsha', 'zding', 'dlekshma', '0214moon', 'kainlulow', 'michi']",2,"['ramith', 'khagner']",20,"['sayeef', 'pdcarpen', 'sgangwal', 'yqwu', 'behinaein', 'raseong', 'lutfe_siddiqui', 'lundstro', 'odawodu', 'park35', 'himadri', 'paul_nano_tran', 'dvarghe', 'jaydeep', 'judith2006', None, 'kim398', 'ghost9804', 'lynewman', 'usman']",31,"['pbatra', 'cson', 'sayeef', 'zding', 'pdcarpen', 'sgangwal', 'yqwu', 'behinaein', 'raseong', 'lutfe_siddiqui', 'lundstro', 'odawodu', 'ramith', 'dlekshma', 'park35', 'kainlulow', 'himadri', 'khagner', 'paul_nano_tran', 'dvarghe', 'jaydeep', 'judith2006', 'benafsha', 'michi', None, 'kim398', 'skumar33', 'ghost9804', 'lynewman', '0214moon', 'usman']"
15,18,12,7,3,"['ramith', 'zding', 'cson']",8,"['khagner', 'pbatra', 'skumar33', 'benafsha', 'dlekshma', '0214moon', 'kainlulow', 'michi']",4,"[None, 'ghost9804', 'mengz', 'kcantley']",15,"['khagner', 'pbatra', 'mengz', 'cson', 'skumar33', 'benafsha', 'ramith', 'ghost9804', 'zding', 'dlekshma', 'kcantley', '0214moon', 'kainlulow', 'michi', None]"
15,69,12,6,1,['kainlulow'],10,"['khagner', 'pbatra', 'cson', 'skumar33', 'benafsha', 'ramith', 'zding', 'dlekshma', '0214moon', 'michi']",5,"['samarthagarwal', 'svadivel', 'hasanm', None, 'ssahmed']",16,"['samarthagarwal', 'khagner', 'pbatra', 'cson', 'skumar33', 'benafsha', 'ramith', 'svadivel', 'zding', 'dlekshma', '0214moon', 'hasanm', 'kainlulow', 'michi', None, 'ssahmed']"
16,19,11,12,9,"['hyu', 'justine', 'asenesi', 'stacilaci56', 'mfrancisco', 'mgkim', 'jmertz', 'sgirard', 'mgr522']",1,['blithe'],3,"['jcamden', None, 'mjb99']",13,"['hyu', 'blithe', 'jmertz', 'mgr522', 'mfrancisco', None, 'jcamden', 'justine', 'asenesi', 'stacilaci56', 'mjb99', 'mgkim', 'sgirard']"
17,47,11,143,9,"['02paiks', 'dstockwe', 'ctasato', 'Zer0xXx', 'sbahl2', 'lit', 'jlouie', 'sdhuang', 'ht15000']",1,['zineeddine'],134,"['spgreen', 'gauravpatel', 'p1mrx', 'zer0xxx', 'greengosling', 'arteliad', 'flandre', 'ronaldming22', 'sohil', 'hatemelmatbouly', 'tchiujan', 'cchong', 'jtill04', 'nishant007', 'yalkusai', 'pmavery', '99GrandAmSE', 'hazix007', 'bmroozia', 'mvalle', 'aahuja', 'zreese', 'dannavs', 'Bozar', 'neudeck', 'wham217', 'kahopkin', 'mahajan86', '99grandamse', 'dhumble', 'johns349', 'jshahid', 'ajplaymaker', 'chadhag', 'bayalew', 'jcleong', 'umityoruk', 'rachitbiyani', 'kthudi', 'mcwalker', 'agprasad', 'nearnhar', 'jniekamp', 'cg49me', 'singapaul', 'dmahajan', 'wehlhard', 'guruLaur', 'yparsak', 'johns180', 'sumeetkumargupta', 'cjkim', 'bchrastil', 'dneedham', 'nchirla', 'hougary', 'Eroberer', 'anascimejr', 'dsutherl', 'aforkner', 'crosis', None, 'americanpiet', 'lionel87', 'athershb', 'mickcrowley', 'jzuleger', 'osritmos', 'nrrojas', 'kim131', 'somacroy', 'kumar29', 'colors41', 'dmachay', 'cfulton', 'danvesh', 'kaufybeans', 'beneintray', 'condo', 'cujo668', 'cabault', 'chang61', 'ntjohn', 'aritter', 'ateixeir', 'jmhumphr', 'huang27', 'myohe', 'cluzik', 'dhum', 'm1a1abr', 'dwchapma', 'mdoherty', 'bretb10067', 'bgoldste', 'rrlahiji', 'joywith', 'iivan', 'uptowngurl02', 'zer0xXx', 'tritter', 'EvLer', 'ttho', 'ashayat', 'sydelko', 'pmongkol', 'vharotoo', 'adhaneku', 'nnovosel', 'theck', 'mreeder', 'tubby', 'clangenb', 'OsRitmos', 'singh8', 'jheim', 'tgunarto', 'anraj', 'zxliu2006', 'kgumiela', 'tsurma', 'sjogleka', 'kfoertsc', 'nebron', 'whitejt', 'aquarelle', 'Evler', 'Americanpiet', 'Uptowngurl02', 'jaconcha', 'jidthekid', 'cksto', 'bfweber', 'zhudongchun']",144,"['spgreen', 'gauravpatel', 'p1mrx', 'sbahl2', 'zer0xxx', 'greengosling', 'arteliad', 'flandre', 'ronaldming22', 'sohil', 'hatemelmatbouly', 'tchiujan', 'cchong', 'jtill04', 'nishant007', 'yalkusai', 'pmavery', '99GrandAmSE', 'hazix007', 'bmroozia', 'mvalle', 'aahuja', 'zreese', 'dannavs', 'Bozar', 'neudeck', 'wham217', 'kahopkin', 'sdhuang', 'mahajan86', '99grandamse', 'dhumble', 'johns349', 'jshahid', 'ajplaymaker', 'chadhag', 'bayalew', 'jcleong', 'umityoruk', 'rachitbiyani', 'kthudi', 'mcwalker', 'agprasad', 'nearnhar', 'jniekamp', 'cg49me', 'singapaul', 'dmahajan', 'wehlhard', 'guruLaur', 'yparsak', 'johns180', 'sumeetkumargupta', 'cjkim', 'bchrastil', 'dneedham', 'nchirla', 'hougary', 'Eroberer', 'anascimejr', 'dsutherl', 'aforkner', 'crosis', None, 'americanpiet', 'lionel87', 'athershb', 'mickcrowley', 'jzuleger', 'osritmos', 'nrrojas', 'kim131', 'somacroy', 'kumar29', 'colors41', 'dmachay', 'cfulton', 'danvesh', 'lit', 'jlouie', 'kaufybeans', 'beneintray', 'ht15000', 'condo', 'cujo668', 'cabault', 'chang61', 'ntjohn', 'aritter', 'ateixeir', 'zineeddine', 'jmhumphr', 'huang27', 'myohe', 'cluzik', 'dhum', 'm1a1abr', 'dwchapma', 'mdoherty', 'bretb10067', 'bgoldste', 'Zer0xXx', 'rrlahiji', 'joywith', 'dstockwe', 'iivan', 'uptowngurl02', 'zer0xXx', 'tritter', 'EvLer', 'ttho', '02paiks', 'ashayat', 'ctasato', 'sydelko', 'pmongkol', 'vharotoo', 'adhaneku', 'nnovosel', 'theck', 'mreeder', 'tubby', 'clangenb', 'OsRitmos', 'singh8', 'jheim', 'tgunarto', 'anraj', 'zxliu2006', 'kgumiela', 'tsurma', 'sjogleka', 'kfoertsc', 'nebron', 'whitejt', 'aquarelle', 'Evler', 'Americanpiet', 'Uptowngurl02', 'jaconcha', 'jidthekid', 'cksto', 'bfweber', 'zhudongchun']"
17,54,11,11,1,['Zer0xXx'],9,"['02paiks', 'dstockwe', 'ctasato', 'sbahl2', 'sdhuang', 'lit', 'jlouie', 'zineeddine', 'ht15000']",10,"['aquarelle', 'cluzik', 'jheim', 'aritter', 'bayalew', 'hazix007', 'bmroozia', 'aforkner', None, 'americanpiet']",20,"['dstockwe', 'cluzik', 'jheim', 'sbahl2', 'lit', 'jlouie', 'aforkner', 'sdhuang', 'ht15000', None, 'americanpiet', 'aquarelle', '02paiks', 'ctasato', 'aritter', 'bayalew', 'hazix007', 'bmroozia', 'zineeddine', 'Zer0xXx']"
19,42,10,17,5,"['yoonsung12', 'apranibita', 'dotage86', 'rivercycle', 'kwr0118']",4,"['aurona', 'lulu', 'mitchel', 'moh_atef']",12,"['phs8338', 'm4500', 'chlwogh3', 'yh1kim', 'Swani', 'innomie', 'chocgm', 'bonoyam', 'lhy1125', 'sysyb', None, 'usilian']",21,"['yoonsung12', 'apranibita', 'mitchel', 'm4500', 'chlwogh3', 'yh1kim', 'Swani', 'rivercycle', 'chocgm', 'bonoyam', 'sysyb', 'kwr0118', None, 'aurona', 'phs8338', 'moh_atef', 'dotage86', 'innomie', 'lhy1125', 'lulu', 'usilian']"
20,5,9,9,8,"['DHW3', 'julaunica01', 'neg515', 'dancertg', 'mescher', 'CarolynNSU', 'ceciliawashington', 'lrwaller22']",0,[],1,[None],9,"['DHW3', 'julaunica01', 'neg515', 'dancertg', 'mescher', 'CarolynNSU', 'ceciliawashington', 'lrwaller22', None]"
20,43,9,9,8,"['DHW3', 'julaunica01', 'neg515', 'dancertg', 'mescher', 'CarolynNSU', 'ceciliawashington', 'lrwaller22']",0,[],1,[None],9,"['DHW3', 'julaunica01', 'neg515', 'dancertg', 'mescher', 'CarolynNSU', 'ceciliawashington', 'lrwaller22', None]"
21,4,9,6,2,"['hanji3208', 'skarlfah']",6,"['nguyenvanchuc', 'dpuldon', 'al2325', 'kjaelee', 'mjcarney', 'jacky']",4,"['ykj3946', None, 'lkj0312', 'calmysi']",12,"['nguyenvanchuc', 'dpuldon', 'al2325', 'skarlfah', 'calmysi', 'hanji3208', 'lkj0312', 'ykj3946', 'kjaelee', 'mjcarney', None, 'jacky']"
22,21,9,210,5,"['ForceofGreed', 'aap459', 'dani0278', 'slhatch', 'megasr660']",3,"['shejun', 'navneet_soin', 'rserrano4']",205,"['hkoh', 'yli640', 'sagarwal', 'gepstein', 'jrixe', 'gwilner', 'jyoung', 'msafdari', 'liuan', 'singebrand', 'rzhang', 'avi697', 'jroth', 'rryskin', 'ssolomon', 'ykoh', 'seilers77', 'kmarotta', 'aliu', 'afast', 'wfan', 'carolagross', 'aqureshi', 'iwong', 'rfarrell', 'nhk780', 'nbafna', 'tybaum', 'skini', 'adwivedi', 'asocianu', 'gae375', 'ghajost', 'lhelmstetter', 'jkim', 'hthaker', 'hetalsheth88', 'MegaSR660', 'tzhang', 'acdavis', 'mmounier', 'LSOLIZ', 'ahymen', 'bdunnington', 'epervos', 'mth448', 'lpolepeddi', 'cdougherty', 'dhahn', 'kstuewer', 'Mezzopiano314', 'achuang', 'shireen5786', 'cvanswearingen', 'scheng', 'acampbell', 'allisonp87', 'ssong', 'mkharouta', 'hhudson', 'eradler', 'jhuang', 'alex111', 'gonyeneho', 'scoppola', 'dhenning', 'mscoptur', 'whoyt1', 'RayChang', 'mkelner149', 'sigross', 'forceofgreed', 'rmehta', 'nse577', 'dleander', 'mep869', 'gdm734', 'fahmad', 'ryoo', 'dtrain580', 'nwong', None, 'jcamden', 'laurenkeeley', 'scorbridge', 'danderson', 'cstengel', 'msc939', 'mjohnson', 'jhoffmann', 'nmalik', 'jpeng', 'glu', 'elizabethab', 'ajf447', 'hlee', 'pdawson', 'JOrnatowski', 'nshah', 'aaguado', 'cgoldschmidt', 'pchang1', 'orlando', 'bstenson', 'lwaters', 'w_wang', 'nishamehta', 'yeehoong', 'kvernon', 'andrewpottebaum', 'srichman', 'jliu', 'ylu589', 'whoyt', 'zman51088', 'knosbisch', 'arthsri', 'kcl507', 'jkunke', 'eding', 'bcheng', 'greg1388', 'rgr237', 'pkiessling', 'mjs983', 'agreiman', 'narekapudi', 'jgellis', 'ccscore2', 'megoss', 'agoyal', 'smcaleese', 'rciechowski', 'avarrenti', 'kmarrero', 'ssukert', 'gschmidt', 'qcai', 'ronakvashi', 'mmarshall', 'acbhatt', 'cboland', 'yha332', 'umoka', 'mgeorge', 'dsidelko', 'bbrunner', 'thevikman', 'ngupta', 'hde520', 'sjyhee', 'asierakowski', 'csbisa', 'dackerman', 'apbubba13', 'amj139', 'sramakrishna', 'eri1092783', 'jreynolds', 'jscheineson', 'EKao', 'lea164', 'nancyfru', 'mthazin', 'mpertierra', 'vkuznetsov', 'mfaierman', 'sumeetjain', 'dwozniczka', 'maltman', 'panchal', 'rhalloran', 'cmbriner', 'roshnibarot22', 'pstibbe', 'tcooper', 'tsprinkel', 'mmiller', 'rbd584', 'jcm979', 'helabut', 'nsb756', 'jroden', 'ims469', 'bchong3', 'zizix28', 'cchow', 'scottar', 'nehaagarwal', 'slm465', 'egabrielov', 'amuehlbauer', 'DDDHHH', 'tkennedy', 'mchow', 'ylee', 'toga221', 'dstehura', 'dwolinsky', 'bmiko06', 'mlin', 'kcooper', 'awchang', 'kae771', 'akeeley']",213,"['hkoh', 'kae771', 'yli640', 'sagarwal', 'gepstein', 'jrixe', 'gwilner', 'jyoung', 'msafdari', 'liuan', 'singebrand', 'rzhang', 'avi697', 'jroth', 'rryskin', 'ssolomon', 'ykoh', 'seilers77', 'kmarotta', 'aliu', 'afast', 'wfan', 'carolagross', 'aqureshi', 'iwong', 'rfarrell', 'nhk780', 'nbafna', 'tybaum', 'skini', 'adwivedi', 'asocianu', 'gae375', 'ghajost', 'lhelmstetter', 'jkim', 'hthaker', 'hetalsheth88', 'MegaSR660', 'tzhang', 'acdavis', 'mmounier', 'LSOLIZ', 'ahymen', 'bdunnington', 'epervos', 'mth448', 'lpolepeddi', 'cdougherty', 'dhahn', 'kstuewer', 'Mezzopiano314', 'achuang', 'shireen5786', 'cvanswearingen', 'scheng', 'acampbell', 'allisonp87', 'ssong', 'mkharouta', 'hhudson', 'eradler', 'jhuang', 'alex111', 'slhatch', 'gonyeneho', 'scoppola', 'dhenning', 'mscoptur', 'whoyt1', 'RayChang', 'mkelner149', 'dani0278', 'sigross', 'forceofgreed', 'rmehta', 'nse577', 'dleander', 'mep869', 'gdm734', 'fahmad', 'ryoo', 'dtrain580', 'nwong', None, 'shejun', 'jcamden', 'laurenkeeley', 'scorbridge', 'danderson', 'cstengel', 'msc939', 'mjohnson', 'jhoffmann', 'nmalik', 'jpeng', 'glu', 'elizabethab', 'ajf447', 'hlee', 'pdawson', 'JOrnatowski', 'nshah', 'aaguado', 'cgoldschmidt', 'pchang1', 'orlando', 'aap459', 'bstenson', 'lwaters', 'w_wang', 'nishamehta', 'yeehoong', 'kvernon', 'andrewpottebaum', 'srichman', 'jliu', 'ylu589', 'whoyt', 'zman51088', 'knosbisch', 'arthsri', 'kcl507', 'jkunke', 'eding', 'bcheng', 'greg1388', 'rgr237', 'pkiessling', 'mjs983', 'agreiman', 'narekapudi', 'jgellis', 'ccscore2', 'megoss', 'agoyal', 'smcaleese', 'rciechowski', 'avarrenti', 'kmarrero', 'ssukert', 'gschmidt', 'qcai', 'ronakvashi', 'mmarshall', 'acbhatt', 'cboland', 'yha332', 'umoka', 'mgeorge', 'dsidelko', 'bbrunner', 'thevikman', 'ngupta', 'hde520', 'sjyhee', 'asierakowski', 'csbisa', 'dackerman', 'apbubba13', 'amj139', 'sramakrishna', 'eri1092783', 'jreynolds', 'jscheineson', 'EKao', 'lea164', 'nancyfru', 'mthazin', 'mpertierra', 'vkuznetsov', 'mfaierman', 'sumeetjain', 'dwozniczka', 'maltman', 'panchal', 'rhalloran', 'cmbriner', 'roshnibarot22', 'pstibbe', 'tcooper', 'tsprinkel', 'mmiller', 'rbd584', 'jcm979', 'helabut', 'nsb756', 'rserrano4', 'jroden', 'ims469', 'bchong3', 'zizix28', 'cchow', 'scottar', 'nehaagarwal', 'slm465', 'megasr660', 'egabrielov', 'amuehlbauer', 'ForceofGreed', 'DDDHHH', 'tkennedy', 'mchow', 'ylee', 'toga221', 'dstehura', 'dwolinsky', 'bmiko06', 'mlin', 'kcooper', 'awchang', 'navneet_soin', 'akeeley']"
23,1,7,7,5,"['ezarco', 'carguello', 'gu_argue', 'ortizalarcon', 'smilenacb']",1,['kelum'],2,"['egondo84', None]",8,"['egondo84', 'ezarco', 'carguello', 'gu_argue', 'ortizalarcon', 'smilenacb', 'kelum', None]"
23,8,7,7,5,"['ezarco', 'carguello', 'gu_argue', 'ortizalarcon', 'smilenacb']",1,['kelum'],2,"['egondo84', None]",8,"['egondo84', 'ezarco', 'carguello', 'gu_argue', 'ortizalarcon', 'smilenacb', 'kelum', None]"
24,16,7,31,2,"['yishao', 'vivihaha']",4,"['iorasforever', 'orit234', 'moufaq', 'meteorologist1']",29,"['paul_nano_tran', 'pbatra', 'dvarghe', 'sayeef', 'cson', 'jaydeep', 'judith2006', 'zding', 'pdcarpen', 'sgangwal', 'qikaichen', 'zainu', 'yqwu', 'behinaein', 'michi', None, 'raseong', 'lutfe_siddiqui', 'odawodu', 'skumar33', 'ghost9804', 'dlekshma', 'lynewman', '0214moon', 'park35', 'kainlulow', 'himadri', 'elec1020', 'nnwatkin']",35,"['pbatra', 'sayeef', 'cson', 'zding', 'pdcarpen', 'sgangwal', 'qikaichen', 'zainu', 'yqwu', 'behinaein', 'raseong', 'lutfe_siddiqui', 'moufaq', 'meteorologist1', 'odawodu', 'dlekshma', 'park35', 'kainlulow', 'himadri', 'nnwatkin', 'paul_nano_tran', 'dvarghe', 'jaydeep', 'judith2006', 'michi', 'yishao', None, 'vivihaha', 'skumar33', 'iorasforever', 'ghost9804', 'lynewman', '0214moon', 'orit234', 'elec1020']"
