MClusterID,XClusterID,MClusterSize,XClusterSize,OverlapSize,OverlapMembers,MOnlySize,MOnlyMembers,XOnlySize,XOnlyMembers,CombinedSize,CombinedMembers
1,38,113,105,88,"['tshuang', 'jwildey', 'lgarby', 'johns349', 'krlane', 'sbiddand', 'wcastrod', 'lala123', 'ece255instructor', 'firebrands_007', 'agarwal2', 'ruchik_oasis', 'bhermsen', 'guptaa', 'pmongold', 'Milllzzz', 'kylerboyd', 'sdhuang', 'clangenb', 'marmbrus', 'rfontana', 'msharif', 'johnydonny', 'aishak', 'twroblew', 'wilkins2', 'hsieh0', 'mkassim', 'oversky', 'dshukla', 'kamon', 'zolikara', 'Ligoc', '255hw', 'aamphawa', 'BlackMako85', 'spades85', 'ddicio', 'zbeechle', 'ThEdge304', 'wabdulkh', 'pgoreham', 'rpweaver1', 'mille172', 'millerge', 'rberanek', 'akpaul', 'yodel711', 'saundarya', 'vlakhwan', 'Zergassassin', 'jcarron', 'aprithvi', 'purdueEE', 'tshipe', 'mqasim', 'ykubo', 'sagadi', 'dgshah', 'purdueee', 'zachdicklin', 'jgries', 'whitejt', 'BigVik', 'rsimpson', 'beneintray', 'azreenibrahim', 'cforesma', 'schmitaj', 'dmahajan', 'ckloiber', 'bebolebowski', 'brager', 'malipitan', 'dselby', 'dgfv65c', 'tdwarner', 'akhilb', 'dgazanfa', 'acmix66', 'bprickel', 'TallSlick', 'inerowim', 'rlacy', 'zgreenaw', 'jisca', 'WeeSenNg', 'mothman']",25,"['bix_20002000', 'aszytec', 'dannavs', 'nelson11', 'jbuttelm', 'rpweaver', 'aaalsaff', 'iveygman', 'ishakm', 'theck', 'royousz01', 'allen28', 'mattriba', 'xfong', 'fmacino', 'plind', 'rpchrist', 'chang13', 'perez4', 'dhur', 'boilerbrando', 'dwchapma', 'bollobiLL612', 'skalafut', 'bretb10067']",17,"['gugu', 'thedge304', 'dmshah', 'arteliad', 'monguin61', 'wtzeng', 'ricktest', 'milllzzz', 'bhur2001', 'jonpurdue', 'WABDULKH', 'leotrong', 'spillow', 'dpshelle', 'yellasrichand', 'linad', 'yang20']",130,"['tshuang', 'aszytec', 'jwildey', 'lgarby', 'johns349', 'krlane', 'sbiddand', 'yellasrichand', 'wcastrod', 'ishakm', 'ece255instructor', 'lala123', 'royousz01', 'firebrands_007', 'theck', 'allen28', 'xfong', 'fmacino', 'agarwal2', 'ruchik_oasis', 'bhermsen', 'dhur', 'guptaa', 'pmongold', 'Milllzzz', 'kylerboyd', 'sdhuang', 'clangenb', 'marmbrus', 'rfontana', 'msharif', 'dwchapma', 'johnydonny', 'bollobiLL612', 'aishak', 'twroblew', 'wilkins2', 'hsieh0', 'mkassim', 'oversky', 'WABDULKH', 'dshukla', 'leotrong', 'aaalsaff', 'kamon', 'zolikara', '255hw', 'Ligoc', 'aamphawa', 'jonpurdue', 'BlackMako85', 'spades85', 'ddicio', 'rpchrist', 'chang13', 'gugu', 'thedge304', 'perez4', 'zbeechle', 'ricktest', 'dpshelle', 'linad', 'ThEdge304', 'wabdulkh', 'pgoreham', 'rpweaver1', 'mille172', 'millerge', 'yang20', 'bretb10067', 'dannavs', 'nelson11', 'akpaul', 'rberanek', 'jbuttelm', 'rpweaver', 'arteliad', 'yodel711', 'saundarya', 'vlakhwan', 'Zergassassin', 'jcarron', 'aprithvi', 'purdueEE', 'tshipe', 'mqasim', 'ykubo', 'dmshah', 'monguin61', 'sagadi', 'dgshah', 'purdueee', 'zachdicklin', 'bix_20002000', 'wtzeng', 'jgries', 'whitejt', 'BigVik', 'rsimpson', 'beneintray', 'azreenibrahim', 'cforesma', 'schmitaj', 'spillow', 'iveygman', 'dmahajan', 'ckloiber', 'mattriba', 'bebolebowski', 'brager', 'plind', 'malipitan', 'dgfv65c', 'dselby', 'tdwarner', 'milllzzz', 'akhilb', 'dgazanfa', 'acmix66', 'bprickel', 'TallSlick', 'inerowim', 'boilerbrando', 'rlacy', 'zgreenaw', 'skalafut', 'jisca', 'WeeSenNg', 'bhur2001', 'mothman']"
1,42,113,67,53,"['bix_20002000', 'tshuang', 'mkassim', 'dannavs', 'jwildey', 'jgries', 'akpaul', 'azreenibrahim', 'schmitaj', 'krlane', 'jbuttelm', 'dshukla', 'wcastrod', 'aaalsaff', 'kamon', 'dmahajan', 'theck', 'lala123', 'wilkins2', 'yodel711', 'aamphawa', 'vlakhwan', 'mattriba', 'BlackMako85', 'bebolebowski', 'fmacino', 'dselby', 'dgfv65c', 'agarwal2', 'tdwarner', 'zbeechle', 'dhur', 'aprithvi', 'akhilb', 'mqasim', 'dgazanfa', 'sdhuang', 'acmix66', 'clangenb', 'ThEdge304', 'marmbrus', 'wabdulkh', 'bprickel', 'msharif', 'dwchapma', 'rlacy', 'sagadi', 'johnydonny', 'skalafut', 'mothman', 'millerge', 'purdueee', 'bretb10067']",60,"['zachdicklin', 'aszytec', 'lgarby', 'johns349', 'nelson11', 'whitejt', 'BigVik', 'rsimpson', 'rberanek', 'beneintray', 'oversky', 'cforesma', 'sbiddand', 'rpweaver', 'zolikara', 'iveygman', '255hw', 'ishakm', 'ece255instructor', 'firebrands_007', 'royousz01', 'allen28', 'Ligoc', 'saundarya', 'ckloiber', 'xfong', 'spades85', 'brager', 'plind', 'ddicio', 'rpchrist', 'chang13', 'Zergassassin', 'jcarron', 'malipitan', 'ruchik_oasis', 'bhermsen', 'perez4', 'purdueEE', 'guptaa', 'pmongold', 'tshipe', 'Milllzzz', 'kylerboyd', 'ykubo', 'rfontana', 'TallSlick', 'inerowim', 'pgoreham', 'rpweaver1', 'boilerbrando', 'zgreenaw', 'mille172', 'bollobiLL612', 'dgshah', 'jisca', 'WeeSenNg', 'aishak', 'twroblew', 'hsieh0']",14,"['anshsri', 'monguin61', 'milllzzz', 'nraghuna', 'anchany2001', 'boilergoldrush', 'webpatrol', 'bsaini', 'kriti09', 'leotrong', 'spillow', 'dpshelle', None, 'chungc']",127,"['tshuang', 'aszytec', 'jwildey', 'lgarby', 'johns349', 'krlane', 'sbiddand', 'wcastrod', 'ishakm', 'ece255instructor', 'lala123', 'royousz01', 'firebrands_007', 'theck', 'allen28', 'xfong', 'fmacino', 'chungc', 'agarwal2', 'ruchik_oasis', 'bhermsen', 'dhur', 'guptaa', 'pmongold', 'Milllzzz', 'kylerboyd', 'sdhuang', 'clangenb', 'marmbrus', 'rfontana', 'msharif', 'dwchapma', 'johnydonny', 'bollobiLL612', 'aishak', 'bsaini', 'twroblew', 'wilkins2', 'hsieh0', 'mkassim', 'oversky', 'dshukla', 'leotrong', 'aaalsaff', 'kamon', 'zolikara', '255hw', 'Ligoc', 'aamphawa', 'BlackMako85', 'spades85', 'ddicio', 'rpchrist', 'chang13', 'perez4', 'zbeechle', 'anchany2001', 'dpshelle', None, 'ThEdge304', 'wabdulkh', 'pgoreham', 'rpweaver1', 'mille172', 'millerge', 'bretb10067', 'anshsri', 'dannavs', 'nelson11', 'akpaul', 'rberanek', 'jbuttelm', 'rpweaver', 'yodel711', 'saundarya', 'vlakhwan', 'Zergassassin', 'jcarron', 'aprithvi', 'purdueEE', 'tshipe', 'mqasim', 'ykubo', 'monguin61', 'sagadi', 'dgshah', 'webpatrol', 'kriti09', 'purdueee', 'zachdicklin', 'bix_20002000', 'jgries', 'whitejt', 'BigVik', 'rsimpson', 'beneintray', 'azreenibrahim', 'cforesma', 'schmitaj', 'spillow', 'iveygman', 'dmahajan', 'nraghuna', 'ckloiber', 'mattriba', 'bebolebowski', 'brager', 'plind', 'malipitan', 'dgfv65c', 'dselby', 'tdwarner', 'milllzzz', 'akhilb', 'boilergoldrush', 'dgazanfa', 'acmix66', 'bprickel', 'TallSlick', 'inerowim', 'boilerbrando', 'rlacy', 'zgreenaw', 'skalafut', 'jisca', 'WeeSenNg', 'mothman']"
1,39,113,20,18,"['Zergassassin', 'zachdicklin', 'dmahajan', 'aszytec', 'ishakm', 'boilerbrando', 'jgries', 'nelson11', 'allen28', 'mothman', 'xfong', 'mqasim', 'rpchrist', 'dgazanfa', 'Milllzzz', 'brager', 'plind', 'wcastrod']",95,"['tshuang', 'jwildey', 'lgarby', 'dannavs', 'johns349', 'akpaul', 'rberanek', 'krlane', 'sbiddand', 'jbuttelm', 'rpweaver', 'ece255instructor', 'lala123', 'royousz01', 'firebrands_007', 'theck', 'yodel711', 'saundarya', 'vlakhwan', 'fmacino', 'agarwal2', 'jcarron', 'ruchik_oasis', 'bhermsen', 'dhur', 'aprithvi', 'purdueEE', 'guptaa', 'pmongold', 'tshipe', 'kylerboyd', 'sdhuang', 'clangenb', 'marmbrus', 'ykubo', 'rfontana', 'msharif', 'dwchapma', 'sagadi', 'johnydonny', 'bollobiLL612', 'dgshah', 'aishak', 'twroblew', 'purdueee', 'wilkins2', 'hsieh0', 'bix_20002000', 'mkassim', 'whitejt', 'BigVik', 'rsimpson', 'beneintray', 'azreenibrahim', 'cforesma', 'oversky', 'schmitaj', 'dshukla', 'aaalsaff', 'kamon', 'zolikara', 'iveygman', '255hw', 'Ligoc', 'aamphawa', 'ckloiber', 'mattriba', 'BlackMako85', 'bebolebowski', 'spades85', 'ddicio', 'chang13', 'malipitan', 'dgfv65c', 'dselby', 'tdwarner', 'perez4', 'zbeechle', 'akhilb', 'acmix66', 'ThEdge304', 'wabdulkh', 'bprickel', 'TallSlick', 'inerowim', 'pgoreham', 'rpweaver1', 'rlacy', 'zgreenaw', 'mille172', 'skalafut', 'jisca', 'WeeSenNg', 'millerge', 'bretb10067']",2,"['yang20', None]",115,"['tshuang', 'aszytec', 'jwildey', 'lgarby', 'dannavs', 'johns349', 'nelson11', 'akpaul', 'rberanek', 'krlane', 'sbiddand', 'jbuttelm', 'rpweaver', 'wcastrod', 'ishakm', 'ece255instructor', 'lala123', 'royousz01', 'firebrands_007', 'theck', 'allen28', 'yodel711', 'saundarya', 'vlakhwan', 'xfong', 'fmacino', 'Zergassassin', 'agarwal2', 'jcarron', 'ruchik_oasis', 'bhermsen', 'dhur', 'aprithvi', 'purdueEE', 'guptaa', 'pmongold', 'tshipe', 'mqasim', 'Milllzzz', 'kylerboyd', 'sdhuang', 'clangenb', 'marmbrus', 'ykubo', 'rfontana', 'msharif', 'dwchapma', 'sagadi', 'johnydonny', 'bollobiLL612', 'dgshah', 'aishak', 'twroblew', 'purdueee', 'wilkins2', 'hsieh0', 'zachdicklin', 'bix_20002000', 'mkassim', 'jgries', 'whitejt', 'BigVik', 'rsimpson', 'beneintray', 'azreenibrahim', 'cforesma', 'oversky', 'schmitaj', 'dshukla', 'aaalsaff', 'kamon', 'zolikara', 'iveygman', '255hw', 'Ligoc', 'dmahajan', 'aamphawa', 'ckloiber', 'mattriba', 'BlackMako85', 'bebolebowski', 'spades85', 'brager', 'plind', 'ddicio', 'rpchrist', 'chang13', 'malipitan', 'dgfv65c', 'dselby', 'tdwarner', 'perez4', 'zbeechle', 'akhilb', 'dgazanfa', 'acmix66', None, 'ThEdge304', 'wabdulkh', 'bprickel', 'TallSlick', 'inerowim', 'pgoreham', 'rpweaver1', 'boilerbrando', 'rlacy', 'zgreenaw', 'mille172', 'skalafut', 'jisca', 'WeeSenNg', 'mothman', 'millerge', 'yang20', 'bretb10067']"
1,41,113,15,9,"['mkassim', 'jgries', 'purdueEE', 'yodel711', 'azreenibrahim', 'schmitaj', 'bebolebowski', 'purdueee', 'bretb10067']",104,"['tshuang', 'aszytec', 'jwildey', 'lgarby', 'dannavs', 'johns349', 'nelson11', 'akpaul', 'rberanek', 'krlane', 'sbiddand', 'jbuttelm', 'rpweaver', 'wcastrod', 'ishakm', 'ece255instructor', 'lala123', 'royousz01', 'firebrands_007', 'theck', 'allen28', 'saundarya', 'vlakhwan', 'xfong', 'fmacino', 'Zergassassin', 'agarwal2', 'jcarron', 'ruchik_oasis', 'bhermsen', 'dhur', 'aprithvi', 'guptaa', 'pmongold', 'tshipe', 'mqasim', 'Milllzzz', 'kylerboyd', 'sdhuang', 'clangenb', 'marmbrus', 'ykubo', 'rfontana', 'msharif', 'dwchapma', 'sagadi', 'johnydonny', 'bollobiLL612', 'dgshah', 'aishak', 'twroblew', 'wilkins2', 'hsieh0', 'zachdicklin', 'bix_20002000', 'whitejt', 'BigVik', 'rsimpson', 'beneintray', 'cforesma', 'oversky', 'dshukla', 'aaalsaff', 'kamon', 'zolikara', 'iveygman', '255hw', 'Ligoc', 'dmahajan', 'aamphawa', 'ckloiber', 'mattriba', 'BlackMako85', 'spades85', 'brager', 'plind', 'ddicio', 'rpchrist', 'chang13', 'malipitan', 'dgfv65c', 'dselby', 'tdwarner', 'perez4', 'zbeechle', 'akhilb', 'dgazanfa', 'acmix66', 'ThEdge304', 'wabdulkh', 'bprickel', 'TallSlick', 'inerowim', 'pgoreham', 'rpweaver1', 'boilerbrando', 'rlacy', 'zgreenaw', 'mille172', 'skalafut', 'jisca', 'WeeSenNg', 'mothman', 'millerge']",6,"['monguin61', 'topkara', 'leotrong', 'spillow', 'dpshelle', None]",119,"['tshuang', 'aszytec', 'jwildey', 'lgarby', 'dannavs', 'johns349', 'nelson11', 'akpaul', 'rberanek', 'krlane', 'sbiddand', 'jbuttelm', 'rpweaver', 'wcastrod', 'ishakm', 'ece255instructor', 'lala123', 'royousz01', 'firebrands_007', 'theck', 'allen28', 'yodel711', 'saundarya', 'vlakhwan', 'xfong', 'topkara', 'fmacino', 'Zergassassin', 'agarwal2', 'jcarron', 'ruchik_oasis', 'bhermsen', 'dhur', 'aprithvi', 'purdueEE', 'guptaa', 'pmongold', 'tshipe', 'mqasim', 'Milllzzz', 'kylerboyd', 'sdhuang', 'clangenb', 'marmbrus', 'ykubo', 'rfontana', 'msharif', 'dwchapma', 'monguin61', 'sagadi', 'johnydonny', 'bollobiLL612', 'dgshah', 'aishak', 'twroblew', 'purdueee', 'wilkins2', 'hsieh0', 'zachdicklin', 'bix_20002000', 'mkassim', 'jgries', 'whitejt', 'BigVik', 'rsimpson', 'beneintray', 'azreenibrahim', 'cforesma', 'oversky', 'schmitaj', 'dshukla', 'leotrong', 'spillow', 'aaalsaff', 'kamon', 'zolikara', 'iveygman', '255hw', 'Ligoc', 'dmahajan', 'aamphawa', 'ckloiber', 'mattriba', 'BlackMako85', 'bebolebowski', 'spades85', 'brager', 'plind', 'ddicio', 'rpchrist', 'chang13', 'malipitan', 'dgfv65c', 'dselby', 'tdwarner', 'perez4', 'zbeechle', 'akhilb', 'dgazanfa', 'dpshelle', 'acmix66', None, 'ThEdge304', 'wabdulkh', 'bprickel', 'TallSlick', 'inerowim', 'pgoreham', 'rpweaver1', 'boilerbrando', 'rlacy', 'zgreenaw', 'mille172', 'skalafut', 'jisca', 'WeeSenNg', 'mothman', 'millerge', 'bretb10067']"
1,40,113,14,11,"['marmbrus', 'agarwal2', 'tshuang', 'aprithvi', 'purdueEE', 'azreenibrahim', 'krlane', 'purdueee', 'bebolebowski', 'acmix66', 'ThEdge304']",102,"['aszytec', 'jwildey', 'lgarby', 'dannavs', 'johns349', 'nelson11', 'akpaul', 'rberanek', 'sbiddand', 'jbuttelm', 'rpweaver', 'wcastrod', 'ishakm', 'ece255instructor', 'lala123', 'royousz01', 'firebrands_007', 'theck', 'allen28', 'yodel711', 'saundarya', 'vlakhwan', 'xfong', 'fmacino', 'Zergassassin', 'jcarron', 'ruchik_oasis', 'bhermsen', 'dhur', 'guptaa', 'pmongold', 'tshipe', 'mqasim', 'Milllzzz', 'kylerboyd', 'sdhuang', 'clangenb', 'ykubo', 'rfontana', 'msharif', 'dwchapma', 'sagadi', 'johnydonny', 'bollobiLL612', 'dgshah', 'aishak', 'twroblew', 'wilkins2', 'hsieh0', 'zachdicklin', 'bix_20002000', 'mkassim', 'jgries', 'whitejt', 'BigVik', 'rsimpson', 'beneintray', 'cforesma', 'oversky', 'schmitaj', 'dshukla', 'aaalsaff', 'kamon', 'zolikara', 'iveygman', '255hw', 'Ligoc', 'dmahajan', 'aamphawa', 'ckloiber', 'mattriba', 'BlackMako85', 'spades85', 'brager', 'plind', 'ddicio', 'rpchrist', 'chang13', 'malipitan', 'dgfv65c', 'dselby', 'tdwarner', 'perez4', 'zbeechle', 'akhilb', 'dgazanfa', 'wabdulkh', 'bprickel', 'TallSlick', 'inerowim', 'pgoreham', 'rpweaver1', 'boilerbrando', 'rlacy', 'zgreenaw', 'mille172', 'skalafut', 'jisca', 'WeeSenNg', 'mothman', 'millerge', 'bretb10067']",3,"['monguin61', 'dpshelle', None]",116,"['tshuang', 'aszytec', 'jwildey', 'lgarby', 'dannavs', 'johns349', 'nelson11', 'akpaul', 'rberanek', 'krlane', 'sbiddand', 'jbuttelm', 'rpweaver', 'wcastrod', 'ishakm', 'ece255instructor', 'lala123', 'royousz01', 'firebrands_007', 'theck', 'allen28', 'yodel711', 'saundarya', 'vlakhwan', 'xfong', 'fmacino', 'Zergassassin', 'agarwal2', 'jcarron', 'ruchik_oasis', 'bhermsen', 'dhur', 'aprithvi', 'purdueEE', 'guptaa', 'pmongold', 'tshipe', 'mqasim', 'Milllzzz', 'kylerboyd', 'sdhuang', 'clangenb', 'marmbrus', 'ykubo', 'rfontana', 'msharif', 'dwchapma', 'monguin61', 'sagadi', 'johnydonny', 'bollobiLL612', 'dgshah', 'aishak', 'twroblew', 'purdueee', 'wilkins2', 'hsieh0', 'zachdicklin', 'bix_20002000', 'mkassim', 'jgries', 'whitejt', 'BigVik', 'rsimpson', 'beneintray', 'azreenibrahim', 'cforesma', 'oversky', 'schmitaj', 'dshukla', 'aaalsaff', 'kamon', 'zolikara', 'iveygman', '255hw', 'Ligoc', 'dmahajan', 'aamphawa', 'ckloiber', 'mattriba', 'BlackMako85', 'bebolebowski', 'spades85', 'brager', 'plind', 'ddicio', 'rpchrist', 'chang13', 'malipitan', 'dgfv65c', 'dselby', 'tdwarner', 'perez4', 'zbeechle', 'akhilb', 'dgazanfa', 'dpshelle', 'acmix66', None, 'ThEdge304', 'wabdulkh', 'bprickel', 'TallSlick', 'inerowim', 'pgoreham', 'rpweaver1', 'boilerbrando', 'rlacy', 'zgreenaw', 'mille172', 'skalafut', 'jisca', 'WeeSenNg', 'mothman', 'millerge', 'bretb10067']"
1,37,113,10,6,"['jcarron', 'dmahajan', 'lala123', 'fmacino', 'acmix66', 'wcastrod']",107,"['tshuang', 'aszytec', 'jwildey', 'lgarby', 'dannavs', 'johns349', 'nelson11', 'akpaul', 'rberanek', 'krlane', 'sbiddand', 'jbuttelm', 'rpweaver', 'ishakm', 'ece255instructor', 'royousz01', 'firebrands_007', 'theck', 'allen28', 'yodel711', 'saundarya', 'vlakhwan', 'xfong', 'Zergassassin', 'agarwal2', 'ruchik_oasis', 'bhermsen', 'dhur', 'aprithvi', 'purdueEE', 'guptaa', 'pmongold', 'tshipe', 'mqasim', 'Milllzzz', 'kylerboyd', 'sdhuang', 'clangenb', 'marmbrus', 'ykubo', 'rfontana', 'msharif', 'dwchapma', 'sagadi', 'johnydonny', 'bollobiLL612', 'dgshah', 'aishak', 'twroblew', 'purdueee', 'wilkins2', 'hsieh0', 'zachdicklin', 'bix_20002000', 'mkassim', 'jgries', 'whitejt', 'BigVik', 'rsimpson', 'beneintray', 'azreenibrahim', 'cforesma', 'oversky', 'schmitaj', 'dshukla', 'aaalsaff', 'kamon', 'zolikara', 'iveygman', '255hw', 'Ligoc', 'aamphawa', 'ckloiber', 'mattriba', 'BlackMako85', 'bebolebowski', 'spades85', 'brager', 'plind', 'ddicio', 'rpchrist', 'chang13', 'malipitan', 'dgfv65c', 'dselby', 'tdwarner', 'perez4', 'zbeechle', 'akhilb', 'dgazanfa', 'ThEdge304', 'wabdulkh', 'bprickel', 'TallSlick', 'inerowim', 'pgoreham', 'rpweaver1', 'boilerbrando', 'rlacy', 'zgreenaw', 'mille172', 'skalafut', 'jisca', 'WeeSenNg', 'mothman', 'millerge', 'bretb10067']",4,"['monguin61', 'dpshelle', None, 'mpaolicc']",117,"['tshuang', 'aszytec', 'jwildey', 'lgarby', 'dannavs', 'johns349', 'nelson11', 'akpaul', 'rberanek', 'krlane', 'sbiddand', 'jbuttelm', 'rpweaver', 'wcastrod', 'ishakm', 'ece255instructor', 'lala123', 'royousz01', 'firebrands_007', 'theck', 'allen28', 'yodel711', 'saundarya', 'vlakhwan', 'xfong', 'fmacino', 'Zergassassin', 'agarwal2', 'jcarron', 'ruchik_oasis', 'bhermsen', 'dhur', 'aprithvi', 'purdueEE', 'guptaa', 'pmongold', 'tshipe', 'mqasim', 'Milllzzz', 'kylerboyd', 'sdhuang', 'clangenb', 'marmbrus', 'ykubo', 'rfontana', 'msharif', 'dwchapma', 'monguin61', 'sagadi', 'johnydonny', 'bollobiLL612', 'dgshah', 'aishak', 'twroblew', 'purdueee', 'wilkins2', 'hsieh0', 'zachdicklin', 'bix_20002000', 'mkassim', 'jgries', 'whitejt', 'BigVik', 'rsimpson', 'beneintray', 'azreenibrahim', 'cforesma', 'oversky', 'schmitaj', 'mpaolicc', 'dshukla', 'aaalsaff', 'kamon', 'zolikara', 'iveygman', '255hw', 'Ligoc', 'dmahajan', 'aamphawa', 'ckloiber', 'mattriba', 'BlackMako85', 'bebolebowski', 'spades85', 'brager', 'plind', 'ddicio', 'rpchrist', 'chang13', 'malipitan', 'dgfv65c', 'dselby', 'tdwarner', 'perez4', 'zbeechle', 'akhilb', 'dgazanfa', 'dpshelle', 'acmix66', None, 'ThEdge304', 'wabdulkh', 'bprickel', 'TallSlick', 'inerowim', 'pgoreham', 'rpweaver1', 'boilerbrando', 'rlacy', 'zgreenaw', 'mille172', 'skalafut', 'jisca', 'WeeSenNg', 'mothman', 'millerge', 'bretb10067']"
1,43,113,6,3,"['dhur', 'yodel711', 'brager']",110,"['tshuang', 'aszytec', 'jwildey', 'lgarby', 'dannavs', 'johns349', 'nelson11', 'akpaul', 'rberanek', 'krlane', 'sbiddand', 'jbuttelm', 'rpweaver', 'wcastrod', 'ishakm', 'ece255instructor', 'lala123', 'royousz01', 'firebrands_007', 'theck', 'allen28', 'saundarya', 'vlakhwan', 'xfong', 'fmacino', 'Zergassassin', 'agarwal2', 'jcarron', 'ruchik_oasis', 'bhermsen', 'aprithvi', 'purdueEE', 'guptaa', 'pmongold', 'tshipe', 'mqasim', 'Milllzzz', 'kylerboyd', 'sdhuang', 'clangenb', 'marmbrus', 'ykubo', 'rfontana', 'msharif', 'dwchapma', 'sagadi', 'johnydonny', 'bollobiLL612', 'dgshah', 'aishak', 'twroblew', 'purdueee', 'wilkins2', 'hsieh0', 'zachdicklin', 'bix_20002000', 'mkassim', 'jgries', 'whitejt', 'BigVik', 'rsimpson', 'beneintray', 'azreenibrahim', 'cforesma', 'oversky', 'schmitaj', 'dshukla', 'aaalsaff', 'kamon', 'zolikara', 'iveygman', '255hw', 'Ligoc', 'dmahajan', 'aamphawa', 'ckloiber', 'mattriba', 'BlackMako85', 'bebolebowski', 'spades85', 'plind', 'ddicio', 'rpchrist', 'chang13', 'malipitan', 'dgfv65c', 'dselby', 'tdwarner', 'perez4', 'zbeechle', 'akhilb', 'dgazanfa', 'acmix66', 'ThEdge304', 'wabdulkh', 'bprickel', 'TallSlick', 'inerowim', 'pgoreham', 'rpweaver1', 'boilerbrando', 'rlacy', 'zgreenaw', 'mille172', 'skalafut', 'jisca', 'WeeSenNg', 'mothman', 'millerge', 'bretb10067']",3,"['anshsri', 'yang20', None]",116,"['anshsri', 'tshuang', 'aszytec', 'jwildey', 'lgarby', 'dannavs', 'johns349', 'nelson11', 'akpaul', 'rberanek', 'krlane', 'sbiddand', 'jbuttelm', 'rpweaver', 'wcastrod', 'ishakm', 'ece255instructor', 'lala123', 'royousz01', 'firebrands_007', 'theck', 'allen28', 'yodel711', 'saundarya', 'vlakhwan', 'xfong', 'fmacino', 'Zergassassin', 'agarwal2', 'jcarron', 'ruchik_oasis', 'bhermsen', 'dhur', 'aprithvi', 'purdueEE', 'guptaa', 'pmongold', 'tshipe', 'mqasim', 'Milllzzz', 'kylerboyd', 'sdhuang', 'clangenb', 'marmbrus', 'ykubo', 'rfontana', 'msharif', 'dwchapma', 'sagadi', 'johnydonny', 'bollobiLL612', 'dgshah', 'aishak', 'twroblew', 'purdueee', 'wilkins2', 'hsieh0', 'zachdicklin', 'bix_20002000', 'mkassim', 'jgries', 'whitejt', 'BigVik', 'rsimpson', 'beneintray', 'azreenibrahim', 'cforesma', 'oversky', 'schmitaj', 'dshukla', 'aaalsaff', 'kamon', 'zolikara', 'iveygman', '255hw', 'Ligoc', 'dmahajan', 'aamphawa', 'ckloiber', 'mattriba', 'BlackMako85', 'bebolebowski', 'spades85', 'brager', 'plind', 'ddicio', 'rpchrist', 'chang13', 'malipitan', 'dgfv65c', 'dselby', 'tdwarner', 'perez4', 'zbeechle', 'akhilb', 'dgazanfa', 'acmix66', None, 'ThEdge304', 'wabdulkh', 'bprickel', 'TallSlick', 'inerowim', 'pgoreham', 'rpweaver1', 'boilerbrando', 'rlacy', 'zgreenaw', 'mille172', 'skalafut', 'jisca', 'WeeSenNg', 'mothman', 'millerge', 'yang20', 'bretb10067']"
2,23,54,24,2,"['mitak', 'Smoke_rs']",51,"['magneton5', 'kindyangyang', 'cson', 'bbtgn', 'chautap', 'bowei', 'KTobin', 'jszefer2', 'akovacs', 'ds10484', 'cvreddy', 'wessamelbaz', 'marajhowell', 'iblock2', 'hyunboo', 'panglijen', 'iodice', 'jonathanoh84', 'taobao', 'nanofizik', 'jbrysoni', 'stevenl01', 'ckeasler', 'shynnh', 'jyang2', 'himpec', 'dsangam', 'berrigan', 'zsheikh', 'akaraarslan', 'mistisizzim', 'drennedr', 'ccliao', 'samz', 'cjchoi', 'soul_elec3fy', 'jonasta', 'tapajna', 'retroreflector', 'sucessgirl1', 'mathieu_marin', 'zhuimeng2004', 'jhcole2', 'dbputts211', 'sbarot', 'cwang19', 'tmaleki', 'mmohile', 'kooonsty', 'markgries', 'jnormal34']",22,"['ivanek', 'xchvat03', 'kokoanada', 'majkl', 'xparac01', 'ufo1212', 'xbarta07', 'kopecky', 'fotyipeter', 'pele', 'xpacvo00', 'xpospi31', None, 'tommi_82', 'xjachy00', 'xbinde00', 'xbedna20', 'xotris00', 'metryx', 'xkalaj00', 'dvafid', 'xdraho05']",75,"['magneton5', 'ivanek', 'cson', 'bbtgn', 'chautap', 'bowei', 'majkl', 'cvreddy', 'hyunboo', 'xparac01', 'taobao', 'ufo1212', 'nanofizik', 'shynnh', 'kopecky', 'himpec', 'mistisizzim', 'drennedr', 'ccliao', 'pele', 'cjchoi', 'xpacvo00', 'sucessgirl1', 'retroreflector', 'zhuimeng2004', 'jhcole2', 'xjachy00', 'xbinde00', 'xbedna20', 'sbarot', 'xdraho05', 'mitak', 'dvafid', 'kooonsty', 'jnormal34', 'kindyangyang', 'xchvat03', 'KTobin', 'akovacs', 'jszefer2', 'kokoanada', 'ds10484', 'wessamelbaz', 'marajhowell', 'iblock2', 'panglijen', 'iodice', 'jonathanoh84', 'jbrysoni', 'stevenl01', 'ckeasler', 'jyang2', 'xbarta07', 'dsangam', 'berrigan', 'zsheikh', 'akaraarslan', 'samz', 'fotyipeter', 'soul_elec3fy', 'jonasta', 'xpospi31', 'tapajna', None, 'mathieu_marin', 'tommi_82', 'dbputts211', 'Smoke_rs', 'xotris00', 'cwang19', 'metryx', 'tmaleki', 'xkalaj00', 'mmohile', 'markgries']"
2,32,54,22,1,['Smoke_rs'],52,"['magneton5', 'kindyangyang', 'cson', 'bbtgn', 'chautap', 'mitak', 'bowei', 'KTobin', 'jszefer2', 'akovacs', 'ds10484', 'cvreddy', 'wessamelbaz', 'marajhowell', 'iblock2', 'hyunboo', 'panglijen', 'iodice', 'jonathanoh84', 'taobao', 'nanofizik', 'jbrysoni', 'stevenl01', 'ckeasler', 'shynnh', 'jyang2', 'himpec', 'dsangam', 'berrigan', 'zsheikh', 'akaraarslan', 'mistisizzim', 'drennedr', 'ccliao', 'samz', 'cjchoi', 'soul_elec3fy', 'jonasta', 'tapajna', 'retroreflector', 'sucessgirl1', 'mathieu_marin', 'zhuimeng2004', 'jhcole2', 'dbputts211', 'sbarot', 'cwang19', 'tmaleki', 'mmohile', 'kooonsty', 'markgries', 'jnormal34']",21,"['ivanek', 'xchvat03', 'majkl', 'xparac01', 'ufo1212', 'xbarta07', 'tie', 'fotyipeter', 'pele', None, 'tommi_82', 'xjachy00', 'xbinde00', 'xbedna20', 'xotris00', 'dvafid', 'metryx', 'xpospi32', 'xkalaj00', 'lulinda', 'xdraho05']",74,"['magneton5', 'ivanek', 'kindyangyang', 'xchvat03', 'cson', 'bbtgn', 'chautap', 'bowei', 'KTobin', 'akovacs', 'jszefer2', 'ds10484', 'majkl', 'cvreddy', 'wessamelbaz', 'marajhowell', 'iblock2', 'hyunboo', 'xparac01', 'panglijen', 'iodice', 'jonathanoh84', 'taobao', 'ufo1212', 'nanofizik', 'jbrysoni', 'stevenl01', 'ckeasler', 'shynnh', 'jyang2', 'xbarta07', 'mmohile', 'tie', 'himpec', 'dsangam', 'berrigan', 'zsheikh', 'akaraarslan', 'mistisizzim', 'drennedr', 'ccliao', 'samz', 'fotyipeter', 'pele', 'cjchoi', 'soul_elec3fy', 'jonasta', 'tapajna', 'retroreflector', 'sucessgirl1', 'mathieu_marin', None, 'zhuimeng2004', 'jhcole2', 'tommi_82', 'xjachy00', 'xbinde00', 'xbedna20', 'dbputts211', 'Smoke_rs', 'xotris00', 'dvafid', 'sbarot', 'xdraho05', 'cwang19', 'metryx', 'tmaleki', 'xpospi32', 'xkalaj00', 'mitak', 'lulinda', 'kooonsty', 'markgries', 'jnormal34']"
2,21,54,18,12,"['cvreddy', 'zsheikh', 'dbputts211', 'hyunboo', 'mistisizzim', 'sbarot', 'jonathanoh84', 'cjchoi', 'ckeasler', 'KTobin', 'jszefer2', 'jnormal34']",41,"['magneton5', 'kindyangyang', 'cson', 'bbtgn', 'chautap', 'mitak', 'bowei', 'akovacs', 'ds10484', 'wessamelbaz', 'marajhowell', 'iblock2', 'panglijen', 'iodice', 'taobao', 'nanofizik', 'jbrysoni', 'stevenl01', 'jyang2', 'shynnh', 'himpec', 'dsangam', 'berrigan', 'akaraarslan', 'drennedr', 'ccliao', 'samz', 'soul_elec3fy', 'jonasta', 'tapajna', 'retroreflector', 'sucessgirl1', 'mathieu_marin', 'zhuimeng2004', 'jhcole2', 'Smoke_rs', 'cwang19', 'tmaleki', 'mmohile', 'kooonsty', 'markgries']",6,"['hoons96', 'tayebi', 'adamkrez', 'anilkumar', 'soul_elec3fy_ECE441', None]",59,"['magneton5', 'kindyangyang', 'cson', 'bbtgn', 'chautap', 'anilkumar', 'bowei', 'KTobin', 'akovacs', 'jszefer2', 'ds10484', 'cvreddy', 'wessamelbaz', 'marajhowell', 'iblock2', 'hoons96', 'hyunboo', 'panglijen', 'iodice', 'jonathanoh84', 'taobao', 'nanofizik', 'jbrysoni', 'stevenl01', 'ckeasler', 'shynnh', 'jyang2', 'mmohile', 'himpec', 'dsangam', 'berrigan', 'zsheikh', 'akaraarslan', 'mistisizzim', 'tayebi', 'drennedr', 'adamkrez', 'ccliao', 'samz', 'cjchoi', 'soul_elec3fy', 'jonasta', 'tapajna', 'retroreflector', 'sucessgirl1', 'mathieu_marin', None, 'zhuimeng2004', 'jhcole2', 'dbputts211', 'Smoke_rs', 'sbarot', 'cwang19', 'tmaleki', 'soul_elec3fy_ECE441', 'mitak', 'kooonsty', 'markgries', 'jnormal34']"
2,24,54,16,9,"['jhcole2', 'dsangam', 'marajhowell', 'cson', 'tmaleki', 'jbrysoni', 'mmohile', 'sucessgirl1', 'markgries']",44,"['magneton5', 'kindyangyang', 'bbtgn', 'chautap', 'bowei', 'KTobin', 'jszefer2', 'akovacs', 'ds10484', 'cvreddy', 'wessamelbaz', 'iblock2', 'hyunboo', 'panglijen', 'iodice', 'jonathanoh84', 'taobao', 'nanofizik', 'stevenl01', 'ckeasler', 'shynnh', 'jyang2', 'himpec', 'berrigan', 'zsheikh', 'akaraarslan', 'mistisizzim', 'drennedr', 'ccliao', 'samz', 'cjchoi', 'soul_elec3fy', 'jonasta', 'tapajna', 'retroreflector', 'mathieu_marin', 'zhuimeng2004', 'dbputts211', 'Smoke_rs', 'sbarot', 'cwang19', 'mitak', 'kooonsty', 'jnormal34']",7,"['dmohapat', 'sgangwal', 'kim87', 'ehamidi', 'aeislam', None, 'kainlulow']",60,"['magneton5', 'kindyangyang', 'cson', 'bbtgn', 'chautap', 'ehamidi', 'bowei', 'KTobin', 'akovacs', 'jszefer2', 'ds10484', 'cvreddy', 'wessamelbaz', 'marajhowell', 'iblock2', 'hyunboo', 'panglijen', 'iodice', 'jonathanoh84', 'kim87', 'taobao', 'nanofizik', 'jbrysoni', 'stevenl01', 'ckeasler', 'shynnh', 'jyang2', 'mmohile', 'himpec', 'dsangam', 'berrigan', 'zsheikh', 'akaraarslan', 'mistisizzim', 'aeislam', 'drennedr', 'ccliao', 'samz', 'sgangwal', 'cjchoi', 'soul_elec3fy', 'jonasta', 'tapajna', 'retroreflector', 'sucessgirl1', 'mathieu_marin', None, 'zhuimeng2004', 'jhcole2', 'kainlulow', 'dmohapat', 'dbputts211', 'Smoke_rs', 'sbarot', 'cwang19', 'tmaleki', 'mitak', 'kooonsty', 'markgries', 'jnormal34']"
2,28,54,16,14,"['cvreddy', 'iblock2', 'dbputts211', 'hyunboo', 'mistisizzim', 'sbarot', 'jonathanoh84', 'cjchoi', 'taobao', 'soul_elec3fy', 'ckeasler', 'kooonsty', 'jszefer2', 'jnormal34']",39,"['magneton5', 'kindyangyang', 'cson', 'bbtgn', 'chautap', 'mitak', 'bowei', 'KTobin', 'akovacs', 'ds10484', 'wessamelbaz', 'marajhowell', 'panglijen', 'iodice', 'nanofizik', 'jbrysoni', 'stevenl01', 'jyang2', 'shynnh', 'himpec', 'dsangam', 'berrigan', 'zsheikh', 'akaraarslan', 'drennedr', 'ccliao', 'samz', 'jonasta', 'tapajna', 'retroreflector', 'sucessgirl1', 'mathieu_marin', 'zhuimeng2004', 'jhcole2', 'Smoke_rs', 'cwang19', 'tmaleki', 'mmohile', 'markgries']",2,"['tmpeun10', None]",55,"['magneton5', 'kindyangyang', 'cson', 'bbtgn', 'chautap', 'bowei', 'KTobin', 'akovacs', 'jszefer2', 'ds10484', 'cvreddy', 'wessamelbaz', 'marajhowell', 'iblock2', 'hyunboo', 'panglijen', 'iodice', 'jonathanoh84', 'taobao', 'nanofizik', 'jbrysoni', 'stevenl01', 'ckeasler', 'shynnh', 'jyang2', 'mmohile', 'himpec', 'dsangam', 'berrigan', 'zsheikh', 'akaraarslan', 'mistisizzim', 'drennedr', 'ccliao', 'samz', 'cjchoi', 'soul_elec3fy', 'jonasta', 'tapajna', 'retroreflector', 'sucessgirl1', 'mathieu_marin', None, 'zhuimeng2004', 'jhcole2', 'dbputts211', 'Smoke_rs', 'sbarot', 'cwang19', 'tmaleki', 'tmpeun10', 'mitak', 'kooonsty', 'markgries', 'jnormal34']"
2,29,54,9,8,"['cvreddy', 'berrigan', 'zsheikh', 'iblock2', 'samz', 'soul_elec3fy', 'jyang2', 'jnormal34']",45,"['magneton5', 'kindyangyang', 'cson', 'bbtgn', 'chautap', 'bowei', 'KTobin', 'akovacs', 'jszefer2', 'ds10484', 'wessamelbaz', 'marajhowell', 'hyunboo', 'panglijen', 'iodice', 'jonathanoh84', 'taobao', 'nanofizik', 'jbrysoni', 'stevenl01', 'ckeasler', 'shynnh', 'mmohile', 'himpec', 'dsangam', 'akaraarslan', 'mistisizzim', 'drennedr', 'ccliao', 'cjchoi', 'jonasta', 'tapajna', 'retroreflector', 'sucessgirl1', 'mathieu_marin', 'zhuimeng2004', 'jhcole2', 'dbputts211', 'Smoke_rs', 'sbarot', 'cwang19', 'tmaleki', 'mitak', 'kooonsty', 'markgries']",1,[None],54,"['magneton5', 'kindyangyang', 'cson', 'bbtgn', 'chautap', 'bowei', 'KTobin', 'akovacs', 'jszefer2', 'ds10484', 'cvreddy', 'wessamelbaz', 'marajhowell', 'iblock2', 'hyunboo', 'panglijen', 'iodice', 'jonathanoh84', 'taobao', 'nanofizik', 'jbrysoni', 'stevenl01', 'ckeasler', 'shynnh', 'jyang2', 'mmohile', 'himpec', 'dsangam', 'berrigan', 'zsheikh', 'akaraarslan', 'mistisizzim', 'drennedr', 'ccliao', 'samz', 'cjchoi', 'soul_elec3fy', 'jonasta', 'tapajna', 'retroreflector', 'sucessgirl1', 'mathieu_marin', None, 'zhuimeng2004', 'jhcole2', 'dbputts211', 'Smoke_rs', 'sbarot', 'cwang19', 'tmaleki', 'mitak', 'kooonsty', 'markgries', 'jnormal34']"
2,22,54,7,5,"['berrigan', 'iblock2', 'ccliao', 'jyang2', 'jnormal34']",48,"['magneton5', 'kindyangyang', 'cson', 'bbtgn', 'chautap', 'bowei', 'KTobin', 'akovacs', 'jszefer2', 'ds10484', 'cvreddy', 'wessamelbaz', 'marajhowell', 'hyunboo', 'panglijen', 'iodice', 'jonathanoh84', 'taobao', 'nanofizik', 'jbrysoni', 'stevenl01', 'ckeasler', 'shynnh', 'mmohile', 'himpec', 'dsangam', 'zsheikh', 'akaraarslan', 'mistisizzim', 'drennedr', 'samz', 'cjchoi', 'soul_elec3fy', 'jonasta', 'tapajna', 'retroreflector', 'sucessgirl1', 'mathieu_marin', 'zhuimeng2004', 'jhcole2', 'dbputts211', 'Smoke_rs', 'sbarot', 'cwang19', 'tmaleki', 'mitak', 'kooonsty', 'markgries']",2,"['adamkrez', None]",55,"['magneton5', 'kindyangyang', 'cson', 'bbtgn', 'chautap', 'bowei', 'KTobin', 'akovacs', 'jszefer2', 'ds10484', 'cvreddy', 'wessamelbaz', 'marajhowell', 'iblock2', 'hyunboo', 'panglijen', 'iodice', 'jonathanoh84', 'taobao', 'nanofizik', 'jbrysoni', 'stevenl01', 'ckeasler', 'shynnh', 'jyang2', 'mmohile', 'himpec', 'dsangam', 'berrigan', 'zsheikh', 'akaraarslan', 'mistisizzim', 'drennedr', 'adamkrez', 'ccliao', 'samz', 'cjchoi', 'soul_elec3fy', 'jonasta', 'tapajna', 'retroreflector', 'sucessgirl1', 'mathieu_marin', None, 'zhuimeng2004', 'jhcole2', 'dbputts211', 'Smoke_rs', 'sbarot', 'cwang19', 'tmaleki', 'mitak', 'kooonsty', 'markgries', 'jnormal34']"
3,19,53,38,34,"['cael', 'brchco12', 'taffer4', 'poolej', '331crap', 'fanghl', 'ricchr', 'vivianye830219', 'jesusbots', 'thebiz', 'vstepin', 'sky2004', 'railt', 'slc25', 'alieness', 'JimJackson03', 'wardog', 'demon1', 'swovc', 'msong', 'phung02', 'cjanz', 'volkmanm', 'ludwip', 'mikemes', 'rattyandfatty', 'chinaman206', 'masfawm2', 'waltw', 'shyuchip', 'lmgrupp', 'dizzywrx', 'rkosai', 'djhamster']",18,"['prosales', 'playachoi', 'bradhughes314', 'fisher_OSU', 'tleong65uwpleasework', 'guai0001', 'nethiril', 'wschoenfeld', 'chef084', 'mihir37', 'TheBiz', 'songliyang', 'kkarrancsu', 'dumarida', 'billlinux', 'skuhns', 'valkyarie', 'spaulj']",4,"['bb46thor', 'radal', None, 'jmetvoice']",56,"['taffer4', 'wschoenfeld', '331crap', 'dumarida', 'fanghl', 'ricchr', 'bradhughes314', 'vivianye830219', 'thebiz', 'skuhns', 'sky2004', 'mihir37', 'slc25', 'alieness', 'kkarrancsu', 'wardog', 'demon1', 'swovc', 'msong', 'phung02', 'prosales', 'mikemes', 'rattyandfatty', 'bb46thor', 'chinaman206', 'waltw', 'guai0001', 'nethiril', 'songliyang', 'dizzywrx', 'rkosai', 'djhamster', 'cael', 'fisher_OSU', 'tleong65uwpleasework', 'brchco12', 'poolej', 'valkyarie', 'playachoi', 'jesusbots', 'vstepin', 'chef084', 'railt', 'TheBiz', 'JimJackson03', 'billlinux', None, 'cjanz', 'spaulj', 'volkmanm', 'ludwip', 'jmetvoice', 'masfawm2', 'shyuchip', 'lmgrupp', 'radal']"
3,20,53,11,10,"['ludwip', 'playachoi', 'tleong65uwpleasework', 'guai0001', 'mihir37', 'TheBiz', 'jesusbots', 'demon1', 'valkyarie', 'spaulj']",42,"['cael', 'fisher_OSU', 'brchco12', 'taffer4', 'wschoenfeld', 'poolej', '331crap', 'dumarida', 'fanghl', 'ricchr', 'bradhughes314', 'vivianye830219', 'thebiz', 'vstepin', 'skuhns', 'chef084', 'sky2004', 'railt', 'slc25', 'alieness', 'kkarrancsu', 'JimJackson03', 'wardog', 'billlinux', 'swovc', 'phung02', 'msong', 'cjanz', 'prosales', 'mikemes', 'volkmanm', 'rattyandfatty', 'chinaman206', 'waltw', 'masfawm2', 'songliyang', 'nethiril', 'shyuchip', 'lmgrupp', 'dizzywrx', 'rkosai', 'djhamster']",1,[None],53,"['cael', 'fisher_OSU', 'tleong65uwpleasework', 'brchco12', 'taffer4', 'wschoenfeld', 'poolej', '331crap', 'dumarida', 'fanghl', 'valkyarie', 'ricchr', 'playachoi', 'bradhughes314', 'vivianye830219', 'jesusbots', 'thebiz', 'vstepin', 'skuhns', 'chef084', 'sky2004', 'railt', 'mihir37', 'slc25', 'TheBiz', 'alieness', 'kkarrancsu', 'JimJackson03', 'wardog', 'billlinux', 'swovc', 'demon1', 'phung02', 'msong', None, 'cjanz', 'spaulj', 'prosales', 'mikemes', 'ludwip', 'volkmanm', 'rattyandfatty', 'chinaman206', 'waltw', 'guai0001', 'masfawm2', 'songliyang', 'nethiril', 'shyuchip', 'lmgrupp', 'dizzywrx', 'rkosai', 'djhamster']"
4,31,38,40,34,"['sixstrdave', 'mfr800', 'cjv284', 'mrh482', 'mgr854', 'danggi', 'ecarralt', 'mdg984', 'DaraDowlatshahi', 'jnoferi', 'galvincj', 'dainakm', 'drewski', 'sac192', 'ksaetia', 'claisen', 'WennyNg', 'speedy', 'tihor415', 'bcj229', 'lyandres', 'cxt560', 'ema154', 'quantumex', 'matthewcas', 'rssarathi', 'cnc327', 'amaina', 'ttravis', 'ccv908', 'davehoward', 'ahertog', 'dnb651', 'ncs973']",3,"['liuht127', 'suzhoudanny', 'fparnold']",6,"['daradowlatshahi', 'schatz', 'cmaikens', 'tejerina', 'wennyng', None]",43,"['sixstrdave', 'cjv284', 'tejerina', 'ecarralt', 'DaraDowlatshahi', 'jnoferi', 'dainakm', 'drewski', 'ksaetia', 'claisen', 'WennyNg', 'speedy', 'tihor415', 'matthewcas', 'cnc327', 'ttravis', 'ccv908', 'ncs973', 'mfr800', 'mrh482', 'mgr854', 'danggi', 'mdg984', 'daradowlatshahi', 'galvincj', 'sac192', 'cmaikens', 'liuht127', 'bcj229', 'lyandres', 'suzhoudanny', 'cxt560', 'ema154', 'quantumex', 'rssarathi', 'amaina', 'wennyng', None, 'davehoward', 'ahertog', 'schatz', 'dnb651', 'fparnold']"
5,3,29,41,23,"['choose', 'ivanek', 'xchvat03', 'Vasis', 'xpriby09', 'majkl', 'xparac01', 'xbarta07', 'tie', 'yoogurt', 'xsirok00', 'fotyipeter', 'pele', 'pvking', 'tommi_82', 'xbedna20', 'sabro', 'metryx', 'xjerab08', 'skopa', 'ruka', 'stejskalt', 'xdraho05']",5,"['stepantrefil', 'xzamec04', 'xotris00', 'dvafid', 'kopecky']",18,"['xjachy00', 'vyoral', 'saly', 'xbinde00', 'Nowass', 'xcichy00', 'lukasp', 'petulinda', 'xvylam00', 'xtcal01', 'macher', 'vasis', 'xkalaj00', 'Plesa', 'okacz', None, 'xpacvo00', 'hani3376']",46,"['ivanek', 'xzamec04', 'xpriby09', 'majkl', 'saly', 'xparac01', 'Plesa', 'kopecky', 'yoogurt', 'hani3376', 'xsirok00', 'xcichy00', 'pele', 'xpacvo00', 'pvking', 'xjachy00', 'xbedna20', 'xbinde00', 'sabro', 'skopa', 'vasis', 'dvafid', 'lukasp', 'okacz', 'choose', 'xchvat03', 'xvylam00', 'xtcal01', 'Vasis', 'vyoral', 'stepantrefil', 'xbarta07', 'tie', 'Nowass', 'fotyipeter', 'macher', None, 'tommi_82', 'xotris00', 'petulinda', 'metryx', 'xjerab08', 'ruka', 'xkalaj00', 'stejskalt', 'xdraho05']"
5,25,29,29,17,"['choose', 'ivanek', 'stepantrefil', 'xsirok00', 'sabro', 'xzamec04', 'xjerab08', 'skopa', 'Vasis', 'ruka', 'xpriby09', 'pvking', 'stejskalt', 'tie', 'tommi_82', 'xdraho05', 'yoogurt']",11,"['xbedna20', 'xparac01', 'xotris00', 'xchvat03', 'fotyipeter', 'pele', 'metryx', 'xbarta07', 'dvafid', 'kopecky', 'majkl']",12,"['xjachy00', 'saly', 'Nowass', 'xcichy00', 'lukasp', 'xvylam00', 'xkalaj00', 'Plesa', 'okacz', None, 'xpacvo00', 'hani3376']",40,"['choose', 'ivanek', 'xzamec04', 'xchvat03', 'xvylam00', 'Vasis', 'xpriby09', 'majkl', 'saly', 'stepantrefil', 'xparac01', 'xbarta07', 'Plesa', 'kopecky', 'tie', 'yoogurt', 'hani3376', 'xsirok00', 'Nowass', 'xcichy00', 'fotyipeter', 'pele', 'xpacvo00', 'pvking', None, 'tommi_82', 'xjachy00', 'xbedna20', 'sabro', 'xotris00', 'lukasp', 'metryx', 'xjerab08', 'skopa', 'ruka', 'xkalaj00', 'dvafid', 'okacz', 'stejskalt', 'xdraho05']"
5,23,29,24,14,"['ivanek', 'xbedna20', 'xparac01', 'xotris00', 'xchvat03', 'fotyipeter', 'pele', 'metryx', 'xbarta07', 'dvafid', 'kopecky', 'tommi_82', 'xdraho05', 'majkl']",14,"['choose', 'stepantrefil', 'xsirok00', 'sabro', 'xzamec04', 'xjerab08', 'skopa', 'Vasis', 'ruka', 'xpriby09', 'pvking', 'stejskalt', 'tie', 'yoogurt']",10,"['xjachy00', 'xbinde00', 'Smoke_rs', 'mitak', 'ufo1212', 'xkalaj00', 'xpospi31', 'kokoanada', None, 'xpacvo00']",38,"['choose', 'ivanek', 'xzamec04', 'xchvat03', 'Vasis', 'xpriby09', 'kokoanada', 'majkl', 'stepantrefil', 'xparac01', 'ufo1212', 'xbarta07', 'kopecky', 'tie', 'yoogurt', 'xsirok00', 'fotyipeter', 'pele', 'xpacvo00', 'pvking', 'xpospi31', None, 'tommi_82', 'xjachy00', 'xbedna20', 'xbinde00', 'sabro', 'Smoke_rs', 'xotris00', 'metryx', 'xjerab08', 'skopa', 'ruka', 'xkalaj00', 'mitak', 'dvafid', 'stejskalt', 'xdraho05']"
5,32,29,22,14,"['ivanek', 'xbedna20', 'xparac01', 'xotris00', 'xchvat03', 'fotyipeter', 'pele', 'metryx', 'xbarta07', 'dvafid', 'tie', 'tommi_82', 'xdraho05', 'majkl']",14,"['choose', 'stepantrefil', 'xsirok00', 'sabro', 'xzamec04', 'xjerab08', 'skopa', 'Vasis', 'ruka', 'xpriby09', 'stejskalt', 'pvking', 'kopecky', 'yoogurt']",8,"['xjachy00', 'xbinde00', 'Smoke_rs', 'ufo1212', 'xpospi32', 'xkalaj00', 'lulinda', None]",36,"['choose', 'ivanek', 'xzamec04', 'xchvat03', 'Vasis', 'xpriby09', 'majkl', 'stepantrefil', 'xparac01', 'ufo1212', 'xbarta07', 'kopecky', 'tie', 'yoogurt', 'xsirok00', 'fotyipeter', 'pele', 'pvking', None, 'tommi_82', 'xjachy00', 'xbedna20', 'xbinde00', 'sabro', 'Smoke_rs', 'xotris00', 'lulinda', 'metryx', 'xjerab08', 'skopa', 'xpospi32', 'ruka', 'xkalaj00', 'dvafid', 'stejskalt', 'xdraho05']"
5,2,29,20,12,"['xparac01', 'xotris00', 'xchvat03', 'xdraho05', 'pele', 'metryx', 'xbarta07', 'dvafid', 'kopecky', 'tommi_82', 'pvking', 'majkl']",16,"['choose', 'ivanek', 'stepantrefil', 'xsirok00', 'xbedna20', 'sabro', 'xzamec04', 'fotyipeter', 'xjerab08', 'skopa', 'Vasis', 'ruka', 'xpriby09', 'stejskalt', 'tie', 'yoogurt']",8,"['xjachy00', 'tomanek', 'xkalaj00', 'xpospi31', 'Plesa', 'kokoanada', None, 'xpacvo00']",36,"['choose', 'ivanek', 'xzamec04', 'xchvat03', 'Vasis', 'xpriby09', 'kokoanada', 'majkl', 'stepantrefil', 'xparac01', 'xbarta07', 'Plesa', 'kopecky', 'tie', 'yoogurt', 'xsirok00', 'fotyipeter', 'pele', 'xpacvo00', 'pvking', 'xpospi31', None, 'tommi_82', 'tomanek', 'xjachy00', 'xbedna20', 'sabro', 'xotris00', 'metryx', 'xjerab08', 'skopa', 'ruka', 'xkalaj00', 'dvafid', 'stejskalt', 'xdraho05']"
5,26,29,18,13,"['choose', 'ivanek', 'xbedna20', 'xparac01', 'xchvat03', 'fotyipeter', 'pele', 'metryx', 'pvking', 'dvafid', 'xbarta07', 'xdraho05', 'majkl']",15,"['stepantrefil', 'xsirok00', 'sabro', 'xzamec04', 'xotris00', 'xjerab08', 'skopa', 'Vasis', 'ruka', 'xpriby09', 'stejskalt', 'kopecky', 'tie', 'tommi_82', 'yoogurt']",5,"['xjachy00', 'xbinde00', 'xpospi31', 'lulinda', None]",33,"['choose', 'ivanek', 'xzamec04', 'xchvat03', 'Vasis', 'xpriby09', 'majkl', 'stepantrefil', 'xparac01', 'xbarta07', 'kopecky', 'tie', 'yoogurt', 'xsirok00', 'fotyipeter', 'pele', 'pvking', 'xpospi31', None, 'tommi_82', 'xjachy00', 'xbedna20', 'xbinde00', 'sabro', 'lulinda', 'xotris00', 'metryx', 'xjerab08', 'skopa', 'ruka', 'dvafid', 'stejskalt', 'xdraho05']"
5,33,29,18,11,"['choose', 'stepantrefil', 'sabro', 'xjerab08', 'skopa', 'Vasis', 'ruka', 'xpriby09', 'pvking', 'stejskalt', 'yoogurt']",17,"['ivanek', 'xsirok00', 'xbedna20', 'xparac01', 'xzamec04', 'xotris00', 'xchvat03', 'fotyipeter', 'pele', 'metryx', 'xbarta07', 'dvafid', 'kopecky', 'tie', 'tommi_82', 'xdraho05', 'majkl']",7,"['saly', 'xcichy00', 'plesa', 'xvylam00', 'lukasp', None, 'hani3376']",35,"['choose', 'ivanek', 'xzamec04', 'xchvat03', 'xvylam00', 'Vasis', 'xpriby09', 'majkl', 'saly', 'stepantrefil', 'xparac01', 'xbarta07', 'kopecky', 'tie', 'yoogurt', 'hani3376', 'xsirok00', 'xcichy00', 'fotyipeter', 'pele', 'pvking', None, 'tommi_82', 'xbedna20', 'sabro', 'xotris00', 'plesa', 'lukasp', 'metryx', 'xjerab08', 'skopa', 'ruka', 'dvafid', 'stejskalt', 'xdraho05']"
5,30,29,16,9,"['choose', 'stepantrefil', 'sabro', 'xjerab08', 'Vasis', 'ruka', 'xpriby09', 'pvking', 'stejskalt']",19,"['ivanek', 'xzamec04', 'xchvat03', 'majkl', 'xparac01', 'xbarta07', 'kopecky', 'tie', 'yoogurt', 'xsirok00', 'fotyipeter', 'pele', 'tommi_82', 'xbedna20', 'xotris00', 'metryx', 'skopa', 'dvafid', 'xdraho05']",7,"['saly', 'xcichy00', 'plesa', 'xvylam00', 'okacz', None, 'hani3376']",35,"['choose', 'ivanek', 'xzamec04', 'xchvat03', 'xvylam00', 'Vasis', 'xpriby09', 'majkl', 'saly', 'stepantrefil', 'xparac01', 'xbarta07', 'kopecky', 'tie', 'yoogurt', 'hani3376', 'xsirok00', 'xcichy00', 'fotyipeter', 'pele', 'pvking', None, 'tommi_82', 'xbedna20', 'sabro', 'xotris00', 'plesa', 'metryx', 'xjerab08', 'skopa', 'ruka', 'dvafid', 'okacz', 'stejskalt', 'xdraho05']"
5,5,29,8,4,"['xbarta07', 'ivanek', 'xchvat03', 'metryx']",24,"['choose', 'xzamec04', 'Vasis', 'xpriby09', 'majkl', 'stepantrefil', 'xparac01', 'kopecky', 'tie', 'yoogurt', 'xsirok00', 'fotyipeter', 'pele', 'pvking', 'tommi_82', 'xbedna20', 'sabro', 'xotris00', 'xjerab08', 'skopa', 'ruka', 'dvafid', 'stejskalt', 'xdraho05']",4,"['lulinda', 'xcichy00', None, 'xpospi31']",32,"['choose', 'ivanek', 'xsirok00', 'xzamec04', 'xcichy00', 'xchvat03', 'fotyipeter', 'pele', 'Vasis', 'xpriby09', 'pvking', 'xpospi31', None, 'tommi_82', 'majkl', 'stepantrefil', 'xbedna20', 'xparac01', 'sabro', 'xotris00', 'lulinda', 'metryx', 'xjerab08', 'skopa', 'stejskalt', 'ruka', 'xbarta07', 'dvafid', 'kopecky', 'tie', 'xdraho05', 'yoogurt']"
5,27,29,6,3,"['xotris00', 'skopa', 'tie']",25,"['choose', 'ivanek', 'xsirok00', 'xzamec04', 'xchvat03', 'fotyipeter', 'pele', 'Vasis', 'xpriby09', 'pvking', 'tommi_82', 'majkl', 'stepantrefil', 'xbedna20', 'xparac01', 'sabro', 'metryx', 'xjerab08', 'stejskalt', 'ruka', 'xbarta07', 'dvafid', 'kopecky', 'xdraho05', 'yoogurt']",3,"['xpospi32', None, 'xpospi31']",31,"['choose', 'ivanek', 'xsirok00', 'xzamec04', 'xchvat03', 'fotyipeter', 'pele', 'Vasis', 'xpriby09', 'pvking', 'xpospi31', None, 'tommi_82', 'majkl', 'stepantrefil', 'xbedna20', 'xparac01', 'sabro', 'xotris00', 'metryx', 'xjerab08', 'skopa', 'stejskalt', 'ruka', 'xpospi32', 'xbarta07', 'dvafid', 'kopecky', 'tie', 'xdraho05', 'yoogurt']"
6,12,24,24,17,"['dongha', 'acw510', 'Dick', 'nidhim', 'pmx22', 'chumin1', 'native', 'DiXie', 'lesleswu', 'uma', 'jeffl', 'younsung', 'abehnam', 'DickXie', 'jimmy', 'vivekanandan', 'zhewang']",6,"['yulong', 'smeu', 'michele', 'yongjiehu', 'rizlon', 'StefanoPoli']",7,"['masum111bd', 'kangmh79', 'swamp', 'guoj', 'hongzhisun', 'vcsel2004', None]",30,"['dongha', 'masum111bd', 'yulong', 'kangmh79', 'lesleswu', 'michele', 'rizlon', 'abehnam', 'guoj', 'hongzhisun', 'vcsel2004', 'zhewang', 'chumin1', 'DiXie', 'uma', 'DickXie', 'StefanoPoli', 'vivekanandan', 'acw510', 'Dick', 'nidhim', 'smeu', 'swamp', None, 'pmx22', 'native', 'jeffl', 'yongjiehu', 'younsung', 'jimmy']"
7,11,18,10,7,"['oscarguzman', 'KMILO', 'vivianaguio', 'leottau', 'kmilo', 'victortico', 'tropypato']",10,"['mcgruer', 'charisse', 'jeffpoly', 'pregaldiny', 'donetti', 'kcwu', 'gudda', 'harsh2312', 'lifengd', 'ccv76290']",3,"['LeidyF', None, 'lombo']",20,"['oscarguzman', 'KMILO', 'vivianaguio', 'pregaldiny', 'ccv76290', 'leottau', 'LeidyF', 'harsh2312', 'lifengd', 'victortico', None, 'lombo', 'mcgruer', 'charisse', 'jeffpoly', 'donetti', 'kcwu', 'gudda', 'kmilo', 'tropypato']"
8,18,15,10,7,"['fuchyi', 'jasonliu', 'agawarikar', 'gzoji', 'choix215', 'yunusbd', 'smartmac']",7,"['robog5', 'yuxxx065umnedu', 'purekth73', 'stur0067', 'sharrel3', 'pauls411', 'travishebig']",3,"[None, 'vivekkalihari', 'train001']",17,"['robog5', 'jasonliu', 'gzoji', 'sharrel3', 'smartmac', 'fuchyi', 'pauls411', None, 'train001', 'yuxxx065umnedu', 'purekth73', 'agawarikar', 'stur0067', 'choix215', 'yunusbd', 'vivekkalihari', 'travishebig']"
8,17,15,8,6,"['purekth73', 'jasonliu', 'agawarikar', 'smartmac', 'sharrel3', 'fuchyi']",8,"['robog5', 'yuxxx065umnedu', 'stur0067', 'gzoji', 'choix215', 'yunusbd', 'pauls411', 'travishebig']",2,"['KiehlGroup', None]",16,"['robog5', 'jasonliu', 'gzoji', 'sharrel3', 'smartmac', 'fuchyi', 'pauls411', None, 'yuxxx065umnedu', 'KiehlGroup', 'purekth73', 'agawarikar', 'stur0067', 'choix215', 'yunusbd', 'travishebig']"
9,15,15,24,6,"['jr83', 'mjay310', 'skrishna', 'karthikdamoor', 'stalw001', 'wsiu001']",8,"['sclin', 'ddolpary', 'akoswari', 'redpriest', 'rez', 'navidp', 'michelequinto', 'mmdesai']",18,"['jstclownin', 'dchan007', None, 'jtrujill', 'kennycbchan', 'ltnguyen', 'nit407', 'ws0211', 'majolne', 'MNEMS', 'ajaw001', 'kpate004', 'pd83', 'belza', 'maliucr', 'gsehm001', 'zhuyansandy', 'petera12003']",32,"['jtrujill', 'kennycbchan', 'akoswari', 'kpate004', 'skrishna', 'stalw001', 'belza', 'mmdesai', 'wsiu001', 'zhuyansandy', 'majolne', 'redpriest', 'rez', 'karthikdamoor', 'gsehm001', 'jr83', 'jstclownin', 'ltnguyen', 'MNEMS', 'mjay310', 'ajaw001', 'michelequinto', None, 'petera12003', 'sclin', 'dchan007', 'ddolpary', 'nit407', 'ws0211', 'navidp', 'pd83', 'maliucr']"
9,14,15,9,4,"['mmdesai', 'wsiu001', 'stalw001', 'karthikdamoor']",10,"['jr83', 'sclin', 'ddolpary', 'mjay310', 'akoswari', 'redpriest', 'rez', 'navidp', 'michelequinto', 'skrishna']",5,"['jtrujill', 'kpate004', 'maliucr', 'gsehm001', None]",19,"['jr83', 'jtrujill', 'mjay310', 'akoswari', 'kpate004', 'skrishna', 'stalw001', 'michelequinto', 'mmdesai', 'wsiu001', None, 'sclin', 'ddolpary', 'redpriest', 'rez', 'karthikdamoor', 'navidp', 'maliucr', 'gsehm001']"
12,3,14,41,5,"['vyoral', 'petulinda', 'xtcal01', 'macher', 'vasis']",8,"['psobansk', 'Joon2324', 'slvrshadowblue', 'arifjahangir', 'blacksoil', 'won2', 'kristenkamath', 'prasadsumant']",36,"['choose', 'ivanek', 'xchvat03', 'xvylam00', 'Vasis', 'xpriby09', 'majkl', 'saly', 'xparac01', 'xbarta07', 'Plesa', 'tie', 'hani3376', 'yoogurt', 'xsirok00', 'Nowass', 'xcichy00', 'fotyipeter', 'pele', 'xpacvo00', 'pvking', None, 'tommi_82', 'xjachy00', 'xbinde00', 'xbedna20', 'sabro', 'metryx', 'skopa', 'xjerab08', 'ruka', 'xkalaj00', 'lukasp', 'okacz', 'stejskalt', 'xdraho05']",49,"['choose', 'ivanek', 'psobansk', 'slvrshadowblue', 'xchvat03', 'xtcal01', 'xvylam00', 'Vasis', 'xpriby09', 'prasadsumant', 'majkl', 'vyoral', 'saly', 'xparac01', 'arifjahangir', 'blacksoil', 'xbarta07', 'Plesa', 'tie', 'hani3376', 'yoogurt', 'xsirok00', 'Joon2324', 'Nowass', 'xcichy00', 'fotyipeter', 'pele', 'macher', 'xpacvo00', 'pvking', 'kristenkamath', None, 'tommi_82', 'xjachy00', 'xbinde00', 'xbedna20', 'sabro', 'petulinda', 'metryx', 'skopa', 'xjerab08', 'vasis', 'won2', 'ruka', 'xkalaj00', 'lukasp', 'okacz', 'stejskalt', 'xdraho05']"
12,4,14,10,5,"['psobansk', 'Joon2324', 'won2', 'kristenkamath', 'prasadsumant']",8,"['vyoral', 'slvrshadowblue', 'arifjahangir', 'petulinda', 'blacksoil', 'xtcal01', 'macher', 'vasis']",5,"['yangxu', 'gangli', 'nagarwl1', None, 'hzhao4']",18,"['psobansk', 'Joon2324', 'slvrshadowblue', 'xtcal01', 'macher', 'nagarwl1', 'kristenkamath', 'prasadsumant', None, 'hzhao4', 'vyoral', 'yangxu', 'gangli', 'arifjahangir', 'blacksoil', 'petulinda', 'vasis', 'won2']"
13,34,11,10,8,"['schroder', 'rsshishir', 'megamomo', 'marinella', 'tafreen', 'acumming16', 'gibees21', 'xjiechen']",2,"['ishtiaqcricket', 'kadoka']",2,"['teday21', None]",12,"['kadoka', 'tafreen', 'acumming16', 'gibees21', None, 'xjiechen', 'ishtiaqcricket', 'schroder', 'rsshishir', 'megamomo', 'marinella', 'teday21']"
17,21,10,18,2,"['hoons96', 'anilkumar']",7,"['alsager', 'Josh550', 'neelsamshah', 'nikhilparkash', 'vipink1981', 'tlangdo', 'hansw320b']",16,"['cvreddy', 'zsheikh', None, 'dbputts211', 'mistisizzim', 'tayebi', 'hyunboo', 'adamkrez', 'sbarot', 'jonathanoh84', 'cjchoi', 'soul_elec3fy_ECE441', 'ckeasler', 'KTobin', 'jszefer2', 'jnormal34']",25,"['zsheikh', 'mistisizzim', 'tayebi', 'alsager', 'Josh550', 'adamkrez', 'vipink1981', 'anilkumar', 'cjchoi', 'KTobin', 'jszefer2', None, 'cvreddy', 'hoons96', 'hyunboo', 'dbputts211', 'neelsamshah', 'nikhilparkash', 'sbarot', 'jonathanoh84', 'tlangdo', 'soul_elec3fy_ECE441', 'ckeasler', 'hansw320b', 'jnormal34']"
18,35,10,9,5,"['chengwen', 'ericericeric', 'HYLo', 'ytkuo', 'heng0827']",4,"['djconnel', 'anilkg', 'mmchy', 'lihui']",4,"[None, 'miguellok', 'faihou', 'tyliu']",13,"['chengwen', 'ericericeric', 'djconnel', None, 'HYLo', 'anilkg', 'lihui', 'mmchy', 'miguellok', 'ytkuo', 'tyliu', 'heng0827', 'faihou']"
26,42,7,67,3,"['anshsri', 'bsaini', 'chungc']",3,"['leuzen', 'bubuyat', 'planarian']",64,"['tshuang', 'dannavs', 'jwildey', 'akpaul', 'krlane', 'jbuttelm', 'wcastrod', 'theck', 'lala123', 'yodel711', 'vlakhwan', 'fmacino', 'agarwal2', 'dhur', 'aprithvi', 'mqasim', 'sdhuang', 'clangenb', 'marmbrus', 'msharif', 'monguin61', 'dwchapma', 'sagadi', 'johnydonny', 'webpatrol', 'kriti09', 'purdueee', 'wilkins2', 'bix_20002000', 'mkassim', 'jgries', 'azreenibrahim', 'schmitaj', 'dshukla', 'leotrong', 'spillow', 'aaalsaff', 'kamon', 'dmahajan', 'nraghuna', 'aamphawa', 'mattriba', 'BlackMako85', 'bebolebowski', 'dselby', 'dgfv65c', 'tdwarner', 'zbeechle', 'milllzzz', 'akhilb', 'anchany2001', 'boilergoldrush', 'dgazanfa', 'dpshelle', 'acmix66', None, 'ThEdge304', 'wabdulkh', 'bprickel', 'rlacy', 'skalafut', 'mothman', 'millerge', 'bretb10067']",70,"['anshsri', 'tshuang', 'dannavs', 'jwildey', 'akpaul', 'krlane', 'jbuttelm', 'wcastrod', 'theck', 'leuzen', 'lala123', 'yodel711', 'vlakhwan', 'fmacino', 'chungc', 'agarwal2', 'dhur', 'aprithvi', 'mqasim', 'sdhuang', 'clangenb', 'marmbrus', 'msharif', 'monguin61', 'dwchapma', 'sagadi', 'johnydonny', 'webpatrol', 'bsaini', 'kriti09', 'purdueee', 'bubuyat', 'wilkins2', 'bix_20002000', 'mkassim', 'jgries', 'azreenibrahim', 'schmitaj', 'dshukla', 'leotrong', 'spillow', 'aaalsaff', 'kamon', 'dmahajan', 'nraghuna', 'aamphawa', 'mattriba', 'BlackMako85', 'bebolebowski', 'dselby', 'dgfv65c', 'tdwarner', 'planarian', 'zbeechle', 'milllzzz', 'akhilb', 'anchany2001', 'boilergoldrush', 'dgazanfa', 'dpshelle', 'acmix66', None, 'ThEdge304', 'wabdulkh', 'bprickel', 'rlacy', 'skalafut', 'mothman', 'millerge', 'bretb10067']"
26,43,7,6,1,['anshsri'],5,"['planarian', 'leuzen', 'chungc', 'bsaini', 'bubuyat']",5,"['dhur', 'yodel711', 'brager', None, 'yang20']",11,"['anshsri', 'planarian', 'leuzen', 'dhur', 'yodel711', 'chungc', 'bsaini', 'brager', None, 'bubuyat', 'yang20']"
32,28,7,16,1,['tmpeun10'],5,"['francolab', 'vytla', 'prawirad', 'padun', 'olivia']",15,"['cvreddy', 'jszefer2', 'iblock2', 'dbputts211', 'mistisizzim', 'hyunboo', 'sbarot', 'jonathanoh84', 'cjchoi', 'taobao', 'soul_elec3fy', 'ckeasler', 'kooonsty', None, 'jnormal34']",21,"['mistisizzim', 'vytla', 'cjchoi', 'soul_elec3fy', None, 'jszefer2', 'jnormal34', 'cvreddy', 'francolab', 'iblock2', 'dbputts211', 'hyunboo', 'sbarot', 'jonathanoh84', 'tmpeun10', 'taobao', 'ckeasler', 'kooonsty', 'prawirad', 'padun', 'olivia']"
37,31,6,40,1,['wennyng'],4,"['snrarueh', 'kschanze', 'EMA154', 'solimo']",39,"['sixstrdave', 'mfr800', 'cjv284', 'mrh482', 'mgr854', 'tejerina', 'danggi', 'ecarralt', 'mdg984', 'DaraDowlatshahi', 'jnoferi', 'daradowlatshahi', 'dainakm', 'galvincj', 'sac192', 'drewski', 'ksaetia', 'claisen', 'cmaikens', 'WennyNg', 'tihor415', 'speedy', 'bcj229', 'lyandres', 'cxt560', 'ema154', 'quantumex', 'matthewcas', 'rssarathi', 'cnc327', 'amaina', None, 'ttravis', 'ccv908', 'davehoward', 'ahertog', 'schatz', 'dnb651', 'ncs973']",44,"['sixstrdave', 'mfr800', 'cjv284', 'mrh482', 'snrarueh', 'mgr854', 'tejerina', 'danggi', 'ecarralt', 'mdg984', 'DaraDowlatshahi', 'jnoferi', 'daradowlatshahi', 'dainakm', 'galvincj', 'sac192', 'drewski', 'ksaetia', 'claisen', 'cmaikens', 'WennyNg', 'tihor415', 'speedy', 'bcj229', 'lyandres', 'solimo', 'cxt560', 'ema154', 'quantumex', 'matthewcas', 'rssarathi', 'cnc327', 'amaina', 'wennyng', None, 'ttravis', 'ccv908', 'davehoward', 'ahertog', 'EMA154', 'schatz', 'dnb651', 'kschanze', 'ncs973']"
39,3,6,41,4,"['Plesa', 'okacz', 'Nowass', 'xpacvo00']",1,['kokoanada'],37,"['choose', 'ivanek', 'xchvat03', 'xvylam00', 'xtcal01', 'Vasis', 'xpriby09', 'majkl', 'vyoral', 'saly', 'xparac01', 'xbarta07', 'tie', 'hani3376', 'yoogurt', 'xsirok00', 'xcichy00', 'fotyipeter', 'pele', 'macher', 'pvking', None, 'tommi_82', 'xjachy00', 'xbinde00', 'xbedna20', 'sabro', 'petulinda', 'metryx', 'xdraho05', 'skopa', 'xjerab08', 'vasis', 'ruka', 'xkalaj00', 'lukasp', 'stejskalt']",42,"['choose', 'ivanek', 'xchvat03', 'xvylam00', 'xtcal01', 'Vasis', 'xpriby09', 'kokoanada', 'majkl', 'vyoral', 'saly', 'xparac01', 'xbarta07', 'Plesa', 'tie', 'hani3376', 'yoogurt', 'xsirok00', 'Nowass', 'xcichy00', 'fotyipeter', 'pele', 'macher', 'pvking', None, 'tommi_82', 'xjachy00', 'xbinde00', 'xbedna20', 'sabro', 'petulinda', 'metryx', 'xdraho05', 'skopa', 'xjerab08', 'vasis', 'ruka', 'xkalaj00', 'lukasp', 'okacz', 'stejskalt', 'xpacvo00']"
39,25,6,29,4,"['Plesa', 'okacz', 'Nowass', 'xpacvo00']",1,['kokoanada'],25,"['choose', 'ivanek', 'xsirok00', 'hani3376', 'xzamec04', 'xcichy00', 'xvylam00', 'Vasis', 'xpriby09', 'pvking', None, 'tommi_82', 'xjachy00', 'saly', 'stepantrefil', 'sabro', 'lukasp', 'xdraho05', 'skopa', 'xjerab08', 'ruka', 'xkalaj00', 'stejskalt', 'tie', 'yoogurt']",30,"['choose', 'ivanek', 'xzamec04', 'xvylam00', 'Vasis', 'xpriby09', 'kokoanada', 'saly', 'stepantrefil', 'Plesa', 'tie', 'yoogurt', 'hani3376', 'xsirok00', 'Nowass', 'xcichy00', 'pvking', None, 'tommi_82', 'xjachy00', 'sabro', 'xdraho05', 'skopa', 'xjerab08', 'ruka', 'xkalaj00', 'lukasp', 'okacz', 'stejskalt', 'xpacvo00']"
39,23,6,24,2,"['kokoanada', 'xpacvo00']",3,"['Plesa', 'okacz', 'Nowass']",22,"['ivanek', 'xchvat03', 'fotyipeter', 'pele', 'mitak', 'xpospi31', None, 'tommi_82', 'majkl', 'xjachy00', 'xbinde00', 'xbedna20', 'xparac01', 'Smoke_rs', 'xotris00', 'metryx', 'ufo1212', 'xkalaj00', 'xbarta07', 'dvafid', 'kopecky', 'xdraho05']",27,"['ivanek', 'Nowass', 'xchvat03', 'fotyipeter', 'pele', 'mitak', 'xpospi31', 'kokoanada', None, 'tommi_82', 'majkl', 'xjachy00', 'xbinde00', 'xbedna20', 'xparac01', 'Smoke_rs', 'xotris00', 'dvafid', 'xdraho05', 'metryx', 'ufo1212', 'xkalaj00', 'xbarta07', 'Plesa', 'okacz', 'kopecky', 'xpacvo00']"
39,2,6,20,3,"['Plesa', 'kokoanada', 'xpacvo00']",2,"['okacz', 'Nowass']",17,"['xjachy00', 'xparac01', 'tomanek', 'xpospi31', 'xchvat03', 'xotris00', 'xdraho05', 'pele', 'metryx', 'xkalaj00', 'xbarta07', 'dvafid', 'kopecky', None, 'tommi_82', 'pvking', 'majkl']",22,"['Nowass', 'xchvat03', 'pele', 'xpospi31', 'pvking', 'kokoanada', None, 'tommi_82', 'tomanek', 'majkl', 'xjachy00', 'xparac01', 'xotris00', 'dvafid', 'xdraho05', 'metryx', 'xkalaj00', 'xbarta07', 'Plesa', 'okacz', 'kopecky', 'xpacvo00']"
39,30,6,16,1,['okacz'],4,"['Plesa', 'kokoanada', 'Nowass', 'xpacvo00']",15,"['choose', 'saly', 'stepantrefil', 'sabro', 'xcichy00', 'plesa', 'xvylam00', 'xjerab08', 'Vasis', 'ruka', 'xpriby09', 'pvking', 'stejskalt', None, 'hani3376']",20,"['choose', 'Nowass', 'xcichy00', 'xvylam00', 'Vasis', 'xpriby09', 'pvking', 'kokoanada', None, 'saly', 'stepantrefil', 'sabro', 'plesa', 'xjerab08', 'ruka', 'Plesa', 'okacz', 'stejskalt', 'xpacvo00', 'hani3376']"
