MClusterID,XClusterID,MClusterSize,XClusterSize,OverlapSize,OverlapMembers,MOnlySize,MOnlyMembers,XOnlySize,XOnlyMembers,CombinedSize,CombinedMembers
1,37,449,371,360,"['aepstein', 'chem10107', 'ganderson', 'jdavid', 'sburrill', 'scrow', 'amorales', 'rlee', 'rkhazai', 'bschaefer', 'gbanner', 'bweisse', 'jlopez', 'bvu', 'kkovatch', 'nperkins', 'mfrancisco', 'stacilaci56', 'hknai', 'seankim', 'slhatch', 'Shaolinquan', 'cvega', 'jbeltran', 'igemp', 'mlowes', 'smoffett', 'JuliaDesChenes', 'msood', 'als753', 'damaranto', 'jcarson', 'kmorgan', 'mshah22', 'adhar2', 'swahab', 'mbykowski', 'jordanduval', 'jaq945', 'mkahle', 'lwelke', 'bwalker423', 'zsersland', 'klandry', 'aechevarria', 'bsummersgill', 'kcebrian', 'rpickering', 'churley', 'vmanko', 'robbrown', 'kbatra', 'bdemurihaeberle', 'ldelaney', 'rmetzler', 'wpearse', 'jobremski', 'evelyncarter', 'dufford', 'ktommerdahl', 'kgspears', 'jguliap', 'mgilmour', 'ckwan', 'mphilben', 'dblumenthal', 'ymanibog', 'cclark', 'dliu', 'clu', 'mkubiak', 'mmotiani', 'awhittington', 'dfang', 'asantamarina', 'jlt453', 'rkatz', 'hschroeder', 'nkraska', 'LWELKE', 'soconnell', 'mchen', 'smoy', 'eunterbrink', 'ohkwon', 'jkircher', 'emurphy', 'jlemaster', 'kmp423', 'eschaefer', 'dyao', 'aroybal', 'ASiddiqui', 'cliu', 'rtsang', 'jdarby', 'sfarley', 'csouthard', 'cgrandau', 'crush', 'awellman', 'amahajan', 'astrick', 'cpai', 'ksampson', 'aelmy', 'ealtman', 'psampath', 'asiddiqui', 'mkalina', 'ccarhart', 'ccl356', 'frankzhang', 'ebader', 'wsun', 'nmsingh', 'alopez', 'jlye', 'tsn821', 'arahman', 'KTietjen', 'cwhite', 'aka220', 'cmcgourty', 'ashutton', 'lkarvelis', 'dwang', 'dburk', 'slim', 'jswanson', 'amelnyk', 'jcummins', 'laybar', 'jdeschenes', 'bfrett', 'msarkulova', 'kmortensen', 'hwolfman', 'dsiegal', 'mrahman23', 'hdurschlag', 'ekatz', 'gschultz', 'del982', 'jneilsson', 'mpsorkin', 'xyin', 'vleung', 'pszalwinski', 'jroig1', 'brwass', 'bfu109', 'lkingsbury', 'nfrench', 'aschattner', 'cfrench', 'mroebuck', 'kparekh', 'noodles5', 'tcouri', 'bpk122', 'rgopal', 'slu', 'ameyers', 'sdaudi', 'tgonzales', 'mhoffmann', 'jhan', 'jbastiaens', 'prettynpink221', 'chaimann', 'ndhawan', 'rferraro', 'jpineda', 'asisodia', 'grebesco', 'kalbertine', 'asarwark', 'clin', 'sarnold', 'dwg482', 'abruzek', 'jschulze', 'jweishaar', 'cpark', 'dbaik', 'csherman', 'aaronbenjamin', 'zharb', 'jswenson', 'athaler', 'ndvora', 'skramer', 'darosner', 'lweiss', 'psteptoe', 'dflint', 'gescobar', 'pkalkat', 'rwinnegar', 'jdawson', 'jdattilo', 'sstrong', 'jbragg', 'erobinson', 'jstroup', 'jchowaniec', 'mfederspiel', 'SLIM', 'smo596', 'dspade', 'dcooperberg', 'geieea', 'bschnedl', 'jesnyder', 'dnebel', 'pcoleman', 'lfoulke', 'asprague', 'cpowersmaher', 'ktietjen', 'aocchiuti', 'cblack', 'ikornblau', 'smiller', 'g3styx', 'cconrad', 'aasthana', 'bmattson', 'kschuette', 'chaselhorst', 'swalchuk', 'calfonso', 'mamofa', 'swilson', 'spark', 'mfenstermaker', 'mtapkowski', 'ikos', 'dshafir', 'mradadia', 'erausch', 'msivasubramaniam', 'ysalah', 'laurahchoi', 'jmeissner', 'pbaranwal', 'cvenatta', 'claireboland', 'npentelovitch', 'bmanojlovic', 'acm', 'treber', 'bnielsen', 'uchidas', 'dshabeeb', 'atalai', 'sflores', 'barlas', 'tchou', 'swundrow', 'jzona', 'jsnyder', 'mfenech', 'kstoddart', 'jteno', 'jilliann2', 'Mehwish916', 'awagner', 'ebell', 'sdixit', 'jgavil', 'jallen', 'osostan', 'xbasko', 'cdipompeo', 'nchu', 'mzou', 'sdang', 'kkao', 'ehaug', 'jmarrone', 'ahurd', 'abarr', 'dwu', 'lbrengman', 'smui', 'ktakahashi', 'gdasovich', 'jjaume', 'lowen', 'Juliadeschenes', 'jsneed', 'aahmad', 'jramsley', 'jps939', 'sfriedman', 'shanks53', 'dmenon', 'khiggins', 'leochild2005', 'kfreer', 'vrivas', 'vvalenzuela', 'rsmith', 'jmehra', 'skim', 'tpoole', 'bniklinska', 'fuckme', 'dtorres', 'kshedd', 'mja276', 'lstene', 'eskim', 'cmiksis', 'jdrake', 'slasselle', 'kbg813', 'srao', 'elliottwallace', 'pliu', 'rgribben', 'wuttarapatriyakul', 'jlee', 'jsavitsky', 'agoodman', 'fzhang', 'ksulzer', 'ewest', 'Aaronbenjamin', 'aloon', 'suchida', 'dculhane', 'nshultz', 'abeswick', 'kkang', 'wstokely', 'yixak', 'marthachang', 'SHaolinquan', 'mhyre', 'djwhack03', 'sju', 'elemasters', 'ecunningham', 'yongjoo87', 'bbrochu', 'rkaringada', 'jyoung88', 'eohira', 'jaltenhofen', 'kroderer', 'cchristianson', 'WUTTARAPATRIYAKUL', 'fome', 'jdinneen', 'roub0008', 'pnolan', 'jmenkin']",89,"['jsteinberg', 'Dangel', 'cnh872', 'tofinesse333', 'jonaltenhofen', 'Asprague', 'mehwish916', 'nash73', 'Akhan', 'toconnell', 'mfederspiel1', 'bigkrezca32', 'pdziedzic', 'lfs919', 'mickey', 'Ikornblau', 'edawson', 'agast', 'petarvidak', 'jwang10', 'JMeissner', 'JSavitsky', 'LauraK', 'dsy389', 'kjs901', 'AWellman', 'jschulze1', 'sindhu108', 'rmb907', 'dsturgeon', 'vivekanandbhardwaj', 'akim', 'heisenman', 'querner', 'fkhan', 'apumm', 'dchoi', 'chicah444', 'therrmann', 'choel', 'mbarrett', 'alang', 'lawchang88', 'kstoerzinger', 'jmehrotra', 'shaolinquan', 'evedgebah', 'prabath', 'mickey_g3', 'jhl326', 'pmodi', 'aim512', 'MChen', 'parker9', 'jerickson', 'jdshank44', 'cboland', 'jroig', 'ckilic', 'ktaylor', 'vladmanko', 'Edawson', 'zes975', 'dal767', 'agassifeng', 'zeidlab', 'SSINGH', 'akhan', 'jjones', 'LKINGSBURY', 'kcysewski', 'acarroll', 'lgerkowicz', 'rbaroch', 'wheat_thin636', 'danielbaik', 'rickyp999', 'mnovacanes', 'smw823', 'cpa475', 'aji536', 'jessicag', 'chastings', 'jshabosky', 'kvb507', 'KKessler', 'clifford', 'asuresh', 'mis130']",11,"['achin', 'balenwhi', 'tejerina', 'mfa713', 'jroden', 'alondanon', 'Preets15', 'vgunderson', 'dcao', 'justineshaw', 'ausmanlk']",460,"['aepstein', 'chem10107', 'sburrill', 'jdavid', 'ganderson', 'vgunderson', 'scrow', 'amorales', 'rlee', 'rkhazai', 'mehwish916', 'nash73', 'bschaefer', 'gbanner', 'Akhan', 'bweisse', 'jlopez', 'bvu', 'kkovatch', 'nperkins', 'Ikornblau', 'agast', 'mfrancisco', 'jwang10', 'stacilaci56', 'hknai', 'seankim', 'ausmanlk', 'balenwhi', 'LauraK', 'slhatch', 'Shaolinquan', 'cvega', 'jbeltran', 'AWellman', 'igemp', 'jschulze1', 'mlowes', 'JuliaDesChenes', 'smoffett', 'msood', 'als753', 'jcarson', 'damaranto', 'dsturgeon', 'kmorgan', 'mshah22', 'adhar2', 'swahab', 'mbykowski', 'jordanduval', 'mfa713', 'jaq945', 'kstoerzinger', 'mkahle', 'lwelke', 'jmehrotra', 'bwalker423', 'zsersland', 'klandry', 'aechevarria', 'bsummersgill', 'kcebrian', 'rpickering', 'churley', 'vmanko', 'robbrown', 'kbatra', 'bdemurihaeberle', 'ldelaney', 'ckilic', 'rmetzler', 'wpearse', 'jobremski', 'Edawson', 'evelyncarter', 'dufford', 'ktommerdahl', 'kgspears', 'dal767', 'jguliap', 'akhan', 'SSINGH', 'mgilmour', 'ckwan', 'mphilben', 'dblumenthal', 'kcysewski', 'ymanibog', 'jroden', 'cclark', 'dliu', 'clu', 'rbaroch', 'mkubiak', 'mmotiani', 'awhittington', 'dfang', 'jlt453', 'asantamarina', 'rkatz', 'hschroeder', 'smw823', 'nkraska', 'aji536', 'LWELKE', 'soconnell', 'mchen', 'smoy', 'kvb507', 'eunterbrink', 'ohkwon', 'jkircher', 'emurphy', 'mis130', 'jlemaster', 'kmp423', 'eschaefer', 'dyao', 'cnh872', 'aroybal', 'ASiddiqui', 'cliu', 'rtsang', 'Asprague', 'jdarby', 'toconnell', 'mfederspiel1', 'csouthard', 'sfarley', 'cgrandau', 'justineshaw', 'crush', 'awellman', 'amahajan', 'astrick', 'cpai', 'ksampson', 'aelmy', 'petarvidak', 'psampath', 'ealtman', 'JMeissner', 'asiddiqui', 'mkalina', 'ccarhart', 'ccl356', 'kjs901', 'frankzhang', 'ebader', 'wsun', 'sindhu108', 'alopez', 'nmsingh', 'jlye', 'tejerina', 'tsn821', 'dcao', 'aka220', 'arahman', 'KTietjen', 'cwhite', 'cmcgourty', 'chicah444', 'ashutton', 'lkarvelis', 'dwang', 'dburk', 'jswanson', 'slim', 'mbarrett', 'amelnyk', 'mickey_g3', 'jcummins', 'jerickson', 'jdeschenes', 'laybar', 'bfrett', 'msarkulova', 'kmortensen', 'cboland', 'hwolfman', 'dsiegal', 'mrahman23', 'hdurschlag', 'ekatz', 'gschultz', 'del982', 'ktaylor', 'jneilsson', 'mpsorkin', 'xyin', 'vladmanko', 'vleung', 'zes975', 'pszalwinski', 'jroig1', 'brwass', 'bfu109', 'lkingsbury', 'nfrench', 'aschattner', 'mroebuck', 'cfrench', 'kparekh', 'noodles5', 'tcouri', 'bpk122', 'rgopal', 'slu', 'ameyers', 'sdaudi', 'tgonzales', 'mhoffmann', 'jhan', 'mnovacanes', 'jbastiaens', 'prettynpink221', 'chaimann', 'ndhawan', 'rferraro', 'cpa475', 'jpineda', 'asisodia', 'grebesco', 'kalbertine', 'asarwark', 'jshabosky', 'clin', 'sarnold', 'dwg482', 'abruzek', 'jschulze', 'jweishaar', 'alondanon', 'cpark', 'jsteinberg', 'Dangel', 'dbaik', 'csherman', 'aaronbenjamin', 'zharb', 'tofinesse333', 'jonaltenhofen', 'jswenson', 'athaler', 'ndvora', 'bigkrezca32', 'skramer', 'darosner', 'lweiss', 'pdziedzic', 'psteptoe', 'lfs919', 'mickey', 'dflint', 'gescobar', 'pkalkat', 'edawson', 'rwinnegar', 'jdawson', 'jdattilo', 'sstrong', 'jbragg', 'dsy389', 'erobinson', 'jstroup', 'vivekanandbhardwaj', 'heisenman', 'mfederspiel', 'jchowaniec', 'SLIM', 'smo596', 'fkhan', 'apumm', 'dchoi', 'dspade', 'therrmann', 'dcooperberg', 'geieea', 'bschnedl', 'jesnyder', 'dnebel', 'alang', 'lawchang88', 'pcoleman', 'lfoulke', 'asprague', 'shaolinquan', 'evedgebah', 'prabath', 'jhl326', 'cpowersmaher', 'ktietjen', 'pmodi', 'aim512', 'MChen', 'aocchiuti', 'cblack', 'parker9', 'ikornblau', 'jdshank44', 'smiller', 'g3styx', 'cconrad', 'aasthana', 'jroig', 'bmattson', 'kschuette', 'chaselhorst', 'swalchuk', 'calfonso', 'mamofa', 'swilson', 'agassifeng', 'spark', 'mfenstermaker', 'mtapkowski', 'ikos', 'dshafir', 'mradadia', 'lgerkowicz', 'erausch', 'msivasubramaniam', 'wheat_thin636', 'ysalah', 'laurahchoi', 'jmeissner', 'pbaranwal', 'cvenatta', 'claireboland', 'rickyp999', 'npentelovitch', 'bmanojlovic', 'acm', 'treber', 'bnielsen', 'uchidas', 'dshabeeb', 'atalai', 'sflores', 'barlas', 'tchou', 'swundrow', 'jzona', 'jsnyder', 'jteno', 'kstoddart', 'mfenech', 'clifford', 'asuresh', 'jilliann2', 'Mehwish916', 'ebell', 'awagner', 'sdixit', 'jgavil', 'jallen', 'osostan', 'xbasko', 'cdipompeo', 'nchu', 'mzou', 'sdang', 'kkao', 'ehaug', 'jmarrone', 'ahurd', 'abarr', 'dwu', 'lbrengman', 'ktakahashi', 'smui', 'gdasovich', 'jjaume', 'lowen', 'Juliadeschenes', 'jsneed', 'aahmad', 'JSavitsky', 'jramsley', 'jps939', 'sfriedman', 'shanks53', 'Preets15', 'rmb907', 'dmenon', 'akim', 'khiggins', 'querner', 'leochild2005', 'kfreer', 'vrivas', 'choel', 'vvalenzuela', 'rsmith', 'jmehra', 'skim', 'tpoole', 'bniklinska', 'dtorres', 'fuckme', 'kshedd', 'mja276', 'lstene', 'eskim', 'cmiksis', 'jdrake', 'achin', 'slasselle', 'elliottwallace', 'kbg813', 'srao', 'pliu', 'wuttarapatriyakul', 'rgribben', 'jlee', 'jsavitsky', 'agoodman', 'fzhang', 'ksulzer', 'ewest', 'zeidlab', 'Aaronbenjamin', 'aloon', 'jjones', 'LKINGSBURY', 'suchida', 'acarroll', 'dculhane', 'nshultz', 'abeswick', 'kkang', 'yixak', 'wstokely', 'marthachang', 'danielbaik', 'SHaolinquan', 'mhyre', 'djwhack03', 'sju', 'elemasters', 'ecunningham', 'yongjoo87', 'bbrochu', 'rkaringada', 'jyoung88', 'eohira', 'jaltenhofen', 'jessicag', 'kroderer', 'chastings', 'cchristianson', 'fome', 'WUTTARAPATRIYAKUL', 'KKessler', 'jdinneen', 'roub0008', 'pnolan', 'jmenkin']"
1,21,449,312,306,"['Dangel', 'eschaefer', 'csherman', 'cnh872', 'aepstein', 'awagner', 'ebell', 'ganderson', 'sburrill', 'cpark', 'sdixit', 'tofinesse333', 'jgavil', 'aroybal', 'scrow', 'amorales', 'jonaltenhofen', 'jswenson', 'rlee', 'xbasko', 'rtsang', 'Asprague', 'rkhazai', 'jdarby', 'mehwish916', 'bschaefer', 'gbanner', 'Akhan', 'toconnell', 'mfederspiel1', 'ndvora', 'nchu', 'mzou', 'bigkrezca32', 'sdang', 'kkao', 'skramer', 'ehaug', 'bweisse', 'darosner', 'pdziedzic', 'jmarrone', 'ahurd', 'amahajan', 'lfs919', 'abarr', 'nperkins', 'lbrengman', 'dflint', 'gescobar', 'gdasovich', 'Ikornblau', 'pkalkat', 'ksampson', 'lowen', 'agast', 'jdattilo', 'mfrancisco', 'jwang10', 'stacilaci56', 'ealtman', 'psampath', 'sstrong', 'jbragg', 'hknai', 'seankim', 'JMeissner', 'JSavitsky', 'jramsley', 'LauraK', 'ccarhart', 'jps939', 'dsy389', 'erobinson', 'jbeltran', 'AWellman', 'igemp', 'frankzhang', 'shanks53', 'wsun', 'mlowes', 'jstroup', 'sindhu108', 'JuliaDesChenes', 'jcarson', 'als753', 'alopez', 'rmb907', 'dsturgeon', 'dmenon', 'jlye', 'akim', 'khiggins', 'heisenman', 'jchowaniec', 'kmorgan', 'tsn821', 'mshah22', 'smo596', 'kfreer', 'vrivas', 'arahman', 'KTietjen', 'adhar2', 'cwhite', 'aka220', 'cmcgourty', 'fkhan', 'apumm', 'mbykowski', 'chicah444', 'ashutton', 'dchoi', 'dspade', 'therrmann', 'dcooperberg', 'dwang', 'bschnedl', 'choel', 'jesnyder', 'dburk', 'jswanson', 'dnebel', 'mbarrett', 'alang', 'jaq945', 'lawchang88', 'kstoerzinger', 'pcoleman', 'jmehrotra', 'shaolinquan', 'vvalenzuela', 'rsmith', 'evedgebah', 'zsersland', 'jmehra', 'skim', 'jhl326', 'ktietjen', 'cpowersmaher', 'pmodi', 'MChen', 'aim512', 'bniklinska', 'aechevarria', 'dtorres', 'kshedd', 'aocchiuti', 'mja276', 'cblack', 'bsummersgill', 'kcebrian', 'rpickering', 'eskim', 'ikornblau', 'jdshank44', 'robbrown', 'kbatra', 'msarkulova', 'bdemurihaeberle', 'ldelaney', 'jdrake', 'kmortensen', 'cboland', 'g3styx', 'slasselle', 'dsiegal', 'aasthana', 'bmattson', 'hdurschlag', 'kbg813', 'ekatz', 'srao', 'gschultz', 'del982', 'rmetzler', 'wpearse', 'ktaylor', 'jlee', 'vladmanko', 'jobremski', 'xyin', 'rgribben', 'wuttarapatriyakul', 'evelyncarter', 'dufford', 'jsavitsky', 'agoodman', 'vleung', 'ktommerdahl', 'zes975', 'fzhang', 'pszalwinski', 'swalchuk', 'calfonso', 'brwass', 'mamofa', 'dal767', 'swilson', 'bfu109', 'ksulzer', 'agassifeng', 'ewest', 'spark', 'nfrench', 'akhan', 'zeidlab', 'mgilmour', 'aschattner', 'cfrench', 'ckwan', 'mroebuck', 'LKINGSBURY', 'dblumenthal', 'kcysewski', 'kparekh', 'noodles5', 'ymanibog', 'mfenstermaker', 'suchida', 'cclark', 'tcouri', 'dculhane', 'rgopal', 'acarroll', 'nshultz', 'dliu', 'abeswick', 'slu', 'clu', 'lgerkowicz', 'erausch', 'kkang', 'wstokely', 'yixak', 'msivasubramaniam', 'rbaroch', 'wheat_thin636', 'ysalah', 'tgonzales', 'danielbaik', 'mkubiak', 'mmotiani', 'laurahchoi', 'jmeissner', 'pbaranwal', 'mhoffmann', 'jhan', 'claireboland', 'SHaolinquan', 'mhyre', 'rickyp999', 'npentelovitch', 'awhittington', 'djwhack03', 'dfang', 'mnovacanes', 'jbastiaens', 'asantamarina', 'jlt453', 'prettynpink221', 'acm', 'ecunningham', 'ndhawan', 'hschroeder', 'smw823', 'rferraro', 'treber', 'nkraska', 'cpa475', 'jpineda', 'yongjoo87', 'aji536', 'asisodia', 'dshabeeb', 'LWELKE', 'jyoung88', 'soconnell', 'atalai', 'sflores', 'eohira', 'tchou', 'kalbertine', 'jessicag', 'kroderer', 'chastings', 'jshabosky', 'fome', 'clin', 'sarnold', 'kvb507', 'jzona', 'dwg482', 'jdinneen', 'abruzek', 'jschulze', 'pnolan', 'jweishaar', 'jmenkin', 'mfenech', 'kstoddart', 'jteno', 'clifford', 'asuresh', 'mis130', 'kmp423']",143,"['jsteinberg', 'dbaik', 'dyao', 'Mehwish916', 'aaronbenjamin', 'chem10107', 'jdavid', 'zharb', 'jallen', 'osostan', 'cdipompeo', 'ASiddiqui', 'cliu', 'athaler', 'nash73', 'sfarley', 'csouthard', 'cgrandau', 'lweiss', 'jlopez', 'bvu', 'crush', 'awellman', 'psteptoe', 'kkovatch', 'mickey', 'dwu', 'astrick', 'ktakahashi', 'smui', 'cpai', 'jjaume', 'edawson', 'rwinnegar', 'jdawson', 'aelmy', 'petarvidak', 'Juliadeschenes', 'asiddiqui', 'jsneed', 'aahmad', 'slhatch', 'Shaolinquan', 'mkalina', 'ccl356', 'sfriedman', 'cvega', 'kjs901', 'ebader', 'jschulze1', 'smoffett', 'msood', 'nmsingh', 'damaranto', 'vivekanandbhardwaj', 'querner', 'mfederspiel', 'SLIM', 'leochild2005', 'swahab', 'geieea', 'lkarvelis', 'jordanduval', 'slim', 'lfoulke', 'mkahle', 'lwelke', 'asprague', 'bwalker423', 'amelnyk', 'prabath', 'mickey_g3', 'tpoole', 'fuckme', 'jcummins', 'klandry', 'lstene', 'parker9', 'jerickson', 'jdeschenes', 'laybar', 'cmiksis', 'churley', 'vmanko', 'bfrett', 'smiller', 'cconrad', 'hwolfman', 'mrahman23', 'jroig', 'elliottwallace', 'pliu', 'ckilic', 'jneilsson', 'mpsorkin', 'Edawson', 'kschuette', 'chaselhorst', 'jroig1', 'kgspears', 'lkingsbury', 'jguliap', 'SSINGH', 'Aaronbenjamin', 'aloon', 'jjones', 'mphilben', 'mtapkowski', 'ikos', 'bpk122', 'dshafir', 'mradadia', 'ameyers', 'sdaudi', 'marthachang', 'cvenatta', 'bmanojlovic', 'sju', 'elemasters', 'chaimann', 'rkatz', 'bnielsen', 'uchidas', 'grebesco', 'bbrochu', 'rkaringada', 'barlas', 'jaltenhofen', 'mchen', 'asarwark', 'swundrow', 'cchristianson', 'WUTTARAPATRIYAKUL', 'smoy', 'KKessler', 'eunterbrink', 'roub0008', 'jsnyder', 'ohkwon', 'jkircher', 'emurphy', 'jlemaster', 'jilliann2']",6,"['ajm105', 'mfa713', 'vgunderson', 'alondanon', 'dcao', None]",455,"['aepstein', 'chem10107', 'sburrill', 'jdavid', 'ganderson', 'vgunderson', 'scrow', 'amorales', 'rlee', 'rkhazai', 'mehwish916', 'nash73', 'bschaefer', 'gbanner', 'Akhan', 'bweisse', 'jlopez', 'bvu', 'kkovatch', 'nperkins', 'Ikornblau', 'agast', 'mfrancisco', 'jwang10', 'stacilaci56', 'hknai', 'seankim', 'LauraK', 'slhatch', 'Shaolinquan', 'cvega', 'jbeltran', 'AWellman', 'igemp', 'jschulze1', 'mlowes', 'JuliaDesChenes', 'smoffett', 'msood', 'als753', 'jcarson', 'damaranto', 'dsturgeon', 'kmorgan', 'mshah22', 'adhar2', 'swahab', 'mbykowski', 'jordanduval', 'mfa713', 'jaq945', 'kstoerzinger', 'mkahle', 'lwelke', 'jmehrotra', 'bwalker423', 'zsersland', 'klandry', 'aechevarria', 'bsummersgill', 'kcebrian', 'rpickering', 'churley', 'vmanko', 'robbrown', 'kbatra', 'bdemurihaeberle', 'ldelaney', 'ckilic', 'rmetzler', 'wpearse', 'jobremski', 'Edawson', 'evelyncarter', 'dufford', 'ktommerdahl', 'kgspears', 'dal767', 'jguliap', 'akhan', 'SSINGH', 'mgilmour', 'ckwan', 'mphilben', 'dblumenthal', 'kcysewski', 'ymanibog', 'cclark', 'dliu', 'clu', 'rbaroch', 'mkubiak', 'mmotiani', 'awhittington', 'dfang', 'jlt453', 'asantamarina', 'rkatz', 'hschroeder', 'smw823', 'nkraska', 'aji536', 'LWELKE', 'soconnell', 'mchen', None, 'smoy', 'kvb507', 'eunterbrink', 'ohkwon', 'jkircher', 'emurphy', 'mis130', 'jlemaster', 'kmp423', 'eschaefer', 'dyao', 'cnh872', 'aroybal', 'ASiddiqui', 'cliu', 'rtsang', 'Asprague', 'jdarby', 'toconnell', 'mfederspiel1', 'csouthard', 'sfarley', 'cgrandau', 'crush', 'awellman', 'amahajan', 'astrick', 'cpai', 'ksampson', 'aelmy', 'petarvidak', 'psampath', 'ealtman', 'JMeissner', 'asiddiqui', 'mkalina', 'ccarhart', 'ccl356', 'kjs901', 'frankzhang', 'ebader', 'wsun', 'sindhu108', 'alopez', 'nmsingh', 'jlye', 'tsn821', 'dcao', 'aka220', 'arahman', 'KTietjen', 'cwhite', 'cmcgourty', 'chicah444', 'ashutton', 'lkarvelis', 'dwang', 'dburk', 'jswanson', 'slim', 'mbarrett', 'amelnyk', 'mickey_g3', 'jcummins', 'jerickson', 'jdeschenes', 'laybar', 'bfrett', 'msarkulova', 'kmortensen', 'cboland', 'hwolfman', 'dsiegal', 'mrahman23', 'hdurschlag', 'ekatz', 'gschultz', 'del982', 'ktaylor', 'jneilsson', 'mpsorkin', 'xyin', 'vladmanko', 'vleung', 'zes975', 'pszalwinski', 'jroig1', 'brwass', 'bfu109', 'lkingsbury', 'nfrench', 'aschattner', 'mroebuck', 'cfrench', 'kparekh', 'noodles5', 'tcouri', 'bpk122', 'rgopal', 'slu', 'ameyers', 'sdaudi', 'tgonzales', 'mhoffmann', 'jhan', 'mnovacanes', 'jbastiaens', 'prettynpink221', 'chaimann', 'ndhawan', 'rferraro', 'cpa475', 'jpineda', 'asisodia', 'grebesco', 'kalbertine', 'asarwark', 'jshabosky', 'clin', 'sarnold', 'dwg482', 'abruzek', 'jschulze', 'jweishaar', 'alondanon', 'cpark', 'jsteinberg', 'Dangel', 'dbaik', 'csherman', 'aaronbenjamin', 'zharb', 'tofinesse333', 'jonaltenhofen', 'jswenson', 'athaler', 'ndvora', 'bigkrezca32', 'skramer', 'darosner', 'lweiss', 'pdziedzic', 'psteptoe', 'lfs919', 'mickey', 'dflint', 'gescobar', 'pkalkat', 'edawson', 'rwinnegar', 'jdawson', 'jdattilo', 'sstrong', 'jbragg', 'dsy389', 'erobinson', 'jstroup', 'vivekanandbhardwaj', 'heisenman', 'mfederspiel', 'jchowaniec', 'SLIM', 'smo596', 'fkhan', 'apumm', 'dchoi', 'dspade', 'therrmann', 'dcooperberg', 'geieea', 'bschnedl', 'jesnyder', 'dnebel', 'alang', 'lawchang88', 'pcoleman', 'lfoulke', 'asprague', 'shaolinquan', 'evedgebah', 'prabath', 'jhl326', 'cpowersmaher', 'ktietjen', 'pmodi', 'aim512', 'MChen', 'aocchiuti', 'cblack', 'parker9', 'ikornblau', 'jdshank44', 'smiller', 'g3styx', 'cconrad', 'aasthana', 'jroig', 'bmattson', 'kschuette', 'chaselhorst', 'swalchuk', 'calfonso', 'mamofa', 'swilson', 'agassifeng', 'spark', 'mfenstermaker', 'mtapkowski', 'ikos', 'dshafir', 'mradadia', 'lgerkowicz', 'erausch', 'msivasubramaniam', 'wheat_thin636', 'ysalah', 'laurahchoi', 'jmeissner', 'pbaranwal', 'cvenatta', 'claireboland', 'rickyp999', 'npentelovitch', 'bmanojlovic', 'acm', 'treber', 'bnielsen', 'uchidas', 'dshabeeb', 'atalai', 'sflores', 'barlas', 'tchou', 'swundrow', 'jzona', 'jsnyder', 'jteno', 'kstoddart', 'mfenech', 'clifford', 'asuresh', 'jilliann2', 'Mehwish916', 'ebell', 'awagner', 'sdixit', 'jgavil', 'jallen', 'osostan', 'xbasko', 'cdipompeo', 'nchu', 'ajm105', 'mzou', 'sdang', 'kkao', 'ehaug', 'jmarrone', 'ahurd', 'abarr', 'dwu', 'lbrengman', 'ktakahashi', 'smui', 'gdasovich', 'jjaume', 'lowen', 'Juliadeschenes', 'jsneed', 'aahmad', 'JSavitsky', 'jramsley', 'jps939', 'sfriedman', 'shanks53', 'rmb907', 'dmenon', 'akim', 'khiggins', 'querner', 'leochild2005', 'kfreer', 'vrivas', 'choel', 'vvalenzuela', 'rsmith', 'jmehra', 'skim', 'tpoole', 'bniklinska', 'dtorres', 'fuckme', 'kshedd', 'mja276', 'lstene', 'eskim', 'cmiksis', 'jdrake', 'slasselle', 'elliottwallace', 'kbg813', 'srao', 'pliu', 'wuttarapatriyakul', 'rgribben', 'jlee', 'jsavitsky', 'agoodman', 'fzhang', 'ksulzer', 'ewest', 'zeidlab', 'Aaronbenjamin', 'aloon', 'jjones', 'LKINGSBURY', 'suchida', 'acarroll', 'dculhane', 'nshultz', 'abeswick', 'kkang', 'yixak', 'wstokely', 'marthachang', 'danielbaik', 'SHaolinquan', 'mhyre', 'djwhack03', 'sju', 'elemasters', 'ecunningham', 'yongjoo87', 'bbrochu', 'rkaringada', 'jyoung88', 'eohira', 'jaltenhofen', 'jessicag', 'kroderer', 'chastings', 'cchristianson', 'fome', 'WUTTARAPATRIYAKUL', 'KKessler', 'jdinneen', 'roub0008', 'pnolan', 'jmenkin']"
1,38,449,20,17,"['jsteinberg', 'jjaume', 'rtsang', 'pdziedzic', 'jjones', 'cfrench', 'eunterbrink', 'psteptoe', 'geieea', 'mickey_g3', 'jroig', 'jordanduval', 'mickey', 'jcummins', 'ckilic', 'sburrill', 'ktakahashi']",432,"['Dangel', 'dbaik', 'csherman', 'aepstein', 'aaronbenjamin', 'chem10107', 'jdavid', 'ganderson', 'zharb', 'tofinesse333', 'jonaltenhofen', 'scrow', 'amorales', 'jswenson', 'rlee', 'rkhazai', 'athaler', 'mehwish916', 'nash73', 'bschaefer', 'gbanner', 'Akhan', 'ndvora', 'bigkrezca32', 'skramer', 'bweisse', 'darosner', 'lweiss', 'jlopez', 'bvu', 'kkovatch', 'lfs919', 'nperkins', 'dflint', 'gescobar', 'Ikornblau', 'pkalkat', 'edawson', 'agast', 'rwinnegar', 'jdawson', 'jdattilo', 'mfrancisco', 'jwang10', 'stacilaci56', 'sstrong', 'jbragg', 'hknai', 'seankim', 'LauraK', 'slhatch', 'Shaolinquan', 'dsy389', 'cvega', 'erobinson', 'jbeltran', 'AWellman', 'igemp', 'jschulze1', 'mlowes', 'jstroup', 'JuliaDesChenes', 'smoffett', 'msood', 'als753', 'jcarson', 'damaranto', 'dsturgeon', 'vivekanandbhardwaj', 'heisenman', 'mfederspiel', 'jchowaniec', 'SLIM', 'kmorgan', 'mshah22', 'smo596', 'fkhan', 'adhar2', 'apumm', 'swahab', 'dchoi', 'dspade', 'mbykowski', 'therrmann', 'dcooperberg', 'bschnedl', 'jesnyder', 'dnebel', 'alang', 'lawchang88', 'jaq945', 'pcoleman', 'kstoerzinger', 'mkahle', 'lwelke', 'jmehrotra', 'lfoulke', 'asprague', 'shaolinquan', 'bwalker423', 'evedgebah', 'zsersland', 'prabath', 'jhl326', 'cpowersmaher', 'ktietjen', 'pmodi', 'aim512', 'MChen', 'klandry', 'aechevarria', 'aocchiuti', 'cblack', 'bsummersgill', 'kcebrian', 'parker9', 'rpickering', 'churley', 'ikornblau', 'jdshank44', 'vmanko', 'robbrown', 'kbatra', 'bdemurihaeberle', 'ldelaney', 'smiller', 'g3styx', 'cconrad', 'aasthana', 'bmattson', 'rmetzler', 'wpearse', 'jobremski', 'Edawson', 'evelyncarter', 'dufford', 'kschuette', 'ktommerdahl', 'chaselhorst', 'swalchuk', 'calfonso', 'kgspears', 'mamofa', 'dal767', 'swilson', 'agassifeng', 'spark', 'jguliap', 'akhan', 'SSINGH', 'mgilmour', 'ckwan', 'mphilben', 'dblumenthal', 'kcysewski', 'ymanibog', 'mfenstermaker', 'mtapkowski', 'ikos', 'cclark', 'dshafir', 'dliu', 'mradadia', 'clu', 'lgerkowicz', 'erausch', 'msivasubramaniam', 'rbaroch', 'wheat_thin636', 'ysalah', 'mkubiak', 'mmotiani', 'laurahchoi', 'jmeissner', 'pbaranwal', 'cvenatta', 'claireboland', 'rickyp999', 'npentelovitch', 'awhittington', 'bmanojlovic', 'dfang', 'jlt453', 'asantamarina', 'acm', 'rkatz', 'treber', 'hschroeder', 'smw823', 'nkraska', 'bnielsen', 'uchidas', 'aji536', 'dshabeeb', 'LWELKE', 'soconnell', 'atalai', 'sflores', 'barlas', 'tchou', 'mchen', 'swundrow', 'smoy', 'kvb507', 'jzona', 'jsnyder', 'ohkwon', 'jteno', 'kstoddart', 'mfenech', 'clifford', 'asuresh', 'jkircher', 'emurphy', 'mis130', 'jlemaster', 'kmp423', 'jilliann2', 'eschaefer', 'dyao', 'cnh872', 'Mehwish916', 'ebell', 'awagner', 'sdixit', 'jgavil', 'jallen', 'aroybal', 'osostan', 'xbasko', 'cdipompeo', 'ASiddiqui', 'cliu', 'Asprague', 'jdarby', 'toconnell', 'mfederspiel1', 'csouthard', 'sfarley', 'nchu', 'cgrandau', 'mzou', 'sdang', 'kkao', 'ehaug', 'jmarrone', 'crush', 'awellman', 'ahurd', 'amahajan', 'abarr', 'dwu', 'astrick', 'lbrengman', 'smui', 'gdasovich', 'cpai', 'ksampson', 'lowen', 'aelmy', 'petarvidak', 'psampath', 'ealtman', 'Juliadeschenes', 'JMeissner', 'asiddiqui', 'jsneed', 'aahmad', 'JSavitsky', 'jramsley', 'mkalina', 'ccarhart', 'jps939', 'ccl356', 'sfriedman', 'kjs901', 'frankzhang', 'shanks53', 'ebader', 'wsun', 'sindhu108', 'alopez', 'nmsingh', 'rmb907', 'dmenon', 'jlye', 'akim', 'khiggins', 'querner', 'tsn821', 'leochild2005', 'kfreer', 'vrivas', 'aka220', 'arahman', 'KTietjen', 'cwhite', 'cmcgourty', 'chicah444', 'ashutton', 'lkarvelis', 'dwang', 'choel', 'dburk', 'jswanson', 'slim', 'mbarrett', 'vvalenzuela', 'rsmith', 'amelnyk', 'jmehra', 'skim', 'tpoole', 'bniklinska', 'dtorres', 'fuckme', 'kshedd', 'mja276', 'lstene', 'eskim', 'jerickson', 'jdeschenes', 'laybar', 'cmiksis', 'bfrett', 'msarkulova', 'jdrake', 'kmortensen', 'cboland', 'hwolfman', 'dsiegal', 'mrahman23', 'slasselle', 'hdurschlag', 'elliottwallace', 'ekatz', 'kbg813', 'gschultz', 'del982', 'srao', 'pliu', 'ktaylor', 'jneilsson', 'mpsorkin', 'xyin', 'vladmanko', 'wuttarapatriyakul', 'rgribben', 'jsavitsky', 'agoodman', 'vleung', 'zes975', 'fzhang', 'pszalwinski', 'jroig1', 'brwass', 'ksulzer', 'bfu109', 'lkingsbury', 'ewest', 'zeidlab', 'nfrench', 'aschattner', 'Aaronbenjamin', 'aloon', 'mroebuck', 'LKINGSBURY', 'kparekh', 'noodles5', 'suchida', 'tcouri', 'bpk122', 'acarroll', 'rgopal', 'dculhane', 'nshultz', 'abeswick', 'slu', 'kkang', 'ameyers', 'yixak', 'wstokely', 'sdaudi', 'tgonzales', 'marthachang', 'danielbaik', 'mhoffmann', 'jhan', 'SHaolinquan', 'mhyre', 'djwhack03', 'sju', 'mnovacanes', 'jbastiaens', 'elemasters', 'prettynpink221', 'chaimann', 'ecunningham', 'ndhawan', 'rferraro', 'yongjoo87', 'cpa475', 'jpineda', 'asisodia', 'grebesco', 'bbrochu', 'rkaringada', 'jyoung88', 'eohira', 'jaltenhofen', 'kalbertine', 'jessicag', 'asarwark', 'kroderer', 'chastings', 'jshabosky', 'cchristianson', 'fome', 'clin', 'sarnold', 'WUTTARAPATRIYAKUL', 'KKessler', 'dwg482', 'jdinneen', 'abruzek', 'jschulze', 'roub0008', 'pnolan', 'jweishaar', 'jmenkin', 'jlee', 'cpark']",3,"['achin', None, 'alondanon']",452,"['jsteinberg', 'Dangel', 'dbaik', 'csherman', 'aepstein', 'aaronbenjamin', 'chem10107', 'sburrill', 'jdavid', 'ganderson', 'zharb', 'tofinesse333', 'jonaltenhofen', 'scrow', 'amorales', 'jswenson', 'rlee', 'rkhazai', 'athaler', 'mehwish916', 'nash73', 'bschaefer', 'gbanner', 'Akhan', 'ndvora', 'bigkrezca32', 'skramer', 'bweisse', 'darosner', 'lweiss', 'jlopez', 'bvu', 'pdziedzic', 'psteptoe', 'kkovatch', 'lfs919', 'mickey', 'nperkins', 'dflint', 'gescobar', 'Ikornblau', 'pkalkat', 'edawson', 'agast', 'rwinnegar', 'jdawson', 'jdattilo', 'mfrancisco', 'jwang10', 'stacilaci56', 'sstrong', 'jbragg', 'hknai', 'seankim', 'LauraK', 'slhatch', 'Shaolinquan', 'dsy389', 'cvega', 'erobinson', 'jbeltran', 'AWellman', 'igemp', 'jschulze1', 'mlowes', 'jstroup', 'JuliaDesChenes', 'smoffett', 'msood', 'als753', 'jcarson', 'damaranto', 'dsturgeon', 'vivekanandbhardwaj', 'heisenman', 'mfederspiel', 'jchowaniec', 'SLIM', 'kmorgan', 'mshah22', 'smo596', 'fkhan', 'adhar2', 'apumm', 'swahab', 'dchoi', 'dspade', 'mbykowski', 'therrmann', 'dcooperberg', 'geieea', 'jordanduval', 'bschnedl', 'jesnyder', 'dnebel', 'alang', 'lawchang88', 'jaq945', 'pcoleman', 'kstoerzinger', 'mkahle', 'lwelke', 'jmehrotra', 'lfoulke', 'asprague', 'shaolinquan', 'bwalker423', 'evedgebah', 'zsersland', 'prabath', 'jhl326', 'cpowersmaher', 'ktietjen', 'pmodi', 'aim512', 'MChen', 'klandry', 'aechevarria', 'aocchiuti', 'cblack', 'bsummersgill', 'kcebrian', 'parker9', 'rpickering', 'churley', 'ikornblau', 'jdshank44', 'vmanko', 'robbrown', 'kbatra', 'bdemurihaeberle', 'ldelaney', 'smiller', 'g3styx', 'cconrad', 'aasthana', 'jroig', 'bmattson', 'ckilic', 'rmetzler', 'wpearse', 'jobremski', 'Edawson', 'evelyncarter', 'dufford', 'kschuette', 'ktommerdahl', 'chaselhorst', 'swalchuk', 'calfonso', 'kgspears', 'mamofa', 'dal767', 'swilson', 'agassifeng', 'spark', 'jguliap', 'akhan', 'SSINGH', 'mgilmour', 'ckwan', 'mphilben', 'dblumenthal', 'kcysewski', 'ymanibog', 'mfenstermaker', 'mtapkowski', 'ikos', 'cclark', 'dshafir', 'dliu', 'mradadia', 'clu', 'lgerkowicz', 'erausch', 'msivasubramaniam', 'rbaroch', 'wheat_thin636', 'ysalah', 'mkubiak', 'mmotiani', 'laurahchoi', 'jmeissner', 'pbaranwal', 'cvenatta', 'claireboland', 'rickyp999', 'npentelovitch', 'awhittington', 'bmanojlovic', 'dfang', 'jlt453', 'asantamarina', 'acm', 'rkatz', 'treber', 'hschroeder', 'smw823', 'nkraska', 'bnielsen', 'uchidas', 'aji536', 'dshabeeb', 'LWELKE', 'soconnell', 'atalai', 'sflores', 'barlas', 'tchou', 'mchen', None, 'swundrow', 'smoy', 'kvb507', 'jzona', 'eunterbrink', 'jsnyder', 'ohkwon', 'jteno', 'kstoddart', 'mfenech', 'clifford', 'asuresh', 'jkircher', 'emurphy', 'mis130', 'jlemaster', 'kmp423', 'jilliann2', 'eschaefer', 'dyao', 'cnh872', 'Mehwish916', 'ebell', 'awagner', 'sdixit', 'jgavil', 'jallen', 'aroybal', 'osostan', 'xbasko', 'cdipompeo', 'ASiddiqui', 'cliu', 'rtsang', 'Asprague', 'jdarby', 'toconnell', 'mfederspiel1', 'csouthard', 'sfarley', 'nchu', 'cgrandau', 'mzou', 'sdang', 'kkao', 'ehaug', 'jmarrone', 'crush', 'awellman', 'ahurd', 'amahajan', 'abarr', 'dwu', 'astrick', 'lbrengman', 'ktakahashi', 'smui', 'gdasovich', 'cpai', 'ksampson', 'jjaume', 'lowen', 'aelmy', 'petarvidak', 'psampath', 'ealtman', 'Juliadeschenes', 'JMeissner', 'asiddiqui', 'jsneed', 'aahmad', 'JSavitsky', 'jramsley', 'mkalina', 'ccarhart', 'jps939', 'ccl356', 'sfriedman', 'kjs901', 'frankzhang', 'shanks53', 'ebader', 'wsun', 'sindhu108', 'alopez', 'nmsingh', 'rmb907', 'dmenon', 'jlye', 'akim', 'khiggins', 'querner', 'tsn821', 'leochild2005', 'kfreer', 'vrivas', 'aka220', 'arahman', 'KTietjen', 'cwhite', 'cmcgourty', 'chicah444', 'ashutton', 'lkarvelis', 'dwang', 'choel', 'dburk', 'jswanson', 'slim', 'mbarrett', 'vvalenzuela', 'rsmith', 'amelnyk', 'jmehra', 'skim', 'mickey_g3', 'tpoole', 'bniklinska', 'jcummins', 'dtorres', 'fuckme', 'kshedd', 'mja276', 'lstene', 'eskim', 'jerickson', 'jdeschenes', 'laybar', 'cmiksis', 'bfrett', 'msarkulova', 'jdrake', 'achin', 'kmortensen', 'cboland', 'hwolfman', 'dsiegal', 'mrahman23', 'slasselle', 'hdurschlag', 'elliottwallace', 'ekatz', 'kbg813', 'gschultz', 'del982', 'srao', 'pliu', 'ktaylor', 'jneilsson', 'mpsorkin', 'xyin', 'vladmanko', 'wuttarapatriyakul', 'rgribben', 'jsavitsky', 'agoodman', 'vleung', 'zes975', 'fzhang', 'pszalwinski', 'jroig1', 'brwass', 'ksulzer', 'bfu109', 'lkingsbury', 'ewest', 'zeidlab', 'nfrench', 'aschattner', 'Aaronbenjamin', 'aloon', 'mroebuck', 'cfrench', 'jjones', 'LKINGSBURY', 'kparekh', 'noodles5', 'suchida', 'tcouri', 'bpk122', 'acarroll', 'rgopal', 'dculhane', 'nshultz', 'abeswick', 'slu', 'kkang', 'ameyers', 'yixak', 'wstokely', 'sdaudi', 'tgonzales', 'marthachang', 'danielbaik', 'mhoffmann', 'jhan', 'SHaolinquan', 'mhyre', 'djwhack03', 'sju', 'mnovacanes', 'jbastiaens', 'elemasters', 'prettynpink221', 'chaimann', 'ecunningham', 'ndhawan', 'rferraro', 'yongjoo87', 'cpa475', 'jpineda', 'asisodia', 'grebesco', 'bbrochu', 'rkaringada', 'jyoung88', 'eohira', 'jaltenhofen', 'kalbertine', 'jessicag', 'asarwark', 'kroderer', 'chastings', 'jshabosky', 'cchristianson', 'fome', 'clin', 'sarnold', 'WUTTARAPATRIYAKUL', 'KKessler', 'dwg482', 'jdinneen', 'abruzek', 'jschulze', 'roub0008', 'pnolan', 'jweishaar', 'jmenkin', 'jlee', 'alondanon', 'cpark']"
1,15,449,14,12,"['jmarrone', 'slasselle', 'therrmann', 'mehwish916', 'jwang10', 'lbrengman', 'mfenech', 'wpearse', 'tofinesse333', 'mzou', 'cblack', 'robbrown']",437,"['jsteinberg', 'Dangel', 'dbaik', 'csherman', 'aepstein', 'aaronbenjamin', 'chem10107', 'sburrill', 'jdavid', 'ganderson', 'zharb', 'jonaltenhofen', 'scrow', 'amorales', 'jswenson', 'rlee', 'rkhazai', 'athaler', 'nash73', 'bschaefer', 'gbanner', 'Akhan', 'ndvora', 'bigkrezca32', 'skramer', 'bweisse', 'darosner', 'lweiss', 'jlopez', 'bvu', 'pdziedzic', 'psteptoe', 'kkovatch', 'lfs919', 'mickey', 'nperkins', 'dflint', 'gescobar', 'Ikornblau', 'pkalkat', 'edawson', 'agast', 'rwinnegar', 'jdawson', 'jdattilo', 'mfrancisco', 'stacilaci56', 'sstrong', 'jbragg', 'hknai', 'seankim', 'LauraK', 'slhatch', 'Shaolinquan', 'dsy389', 'cvega', 'erobinson', 'jbeltran', 'AWellman', 'igemp', 'jschulze1', 'mlowes', 'jstroup', 'JuliaDesChenes', 'smoffett', 'msood', 'als753', 'jcarson', 'damaranto', 'dsturgeon', 'vivekanandbhardwaj', 'heisenman', 'mfederspiel', 'jchowaniec', 'SLIM', 'kmorgan', 'mshah22', 'smo596', 'fkhan', 'adhar2', 'apumm', 'swahab', 'dchoi', 'dspade', 'mbykowski', 'dcooperberg', 'geieea', 'jordanduval', 'bschnedl', 'jesnyder', 'dnebel', 'alang', 'lawchang88', 'jaq945', 'pcoleman', 'kstoerzinger', 'mkahle', 'lwelke', 'jmehrotra', 'lfoulke', 'asprague', 'shaolinquan', 'bwalker423', 'evedgebah', 'zsersland', 'prabath', 'jhl326', 'cpowersmaher', 'ktietjen', 'pmodi', 'aim512', 'MChen', 'klandry', 'aechevarria', 'aocchiuti', 'bsummersgill', 'kcebrian', 'parker9', 'rpickering', 'churley', 'ikornblau', 'jdshank44', 'vmanko', 'kbatra', 'bdemurihaeberle', 'ldelaney', 'smiller', 'g3styx', 'cconrad', 'aasthana', 'jroig', 'bmattson', 'ckilic', 'rmetzler', 'jobremski', 'Edawson', 'evelyncarter', 'dufford', 'kschuette', 'ktommerdahl', 'chaselhorst', 'swalchuk', 'calfonso', 'kgspears', 'mamofa', 'dal767', 'swilson', 'agassifeng', 'spark', 'jguliap', 'akhan', 'SSINGH', 'mgilmour', 'ckwan', 'mphilben', 'dblumenthal', 'kcysewski', 'ymanibog', 'mfenstermaker', 'mtapkowski', 'ikos', 'cclark', 'dshafir', 'dliu', 'mradadia', 'clu', 'lgerkowicz', 'erausch', 'msivasubramaniam', 'rbaroch', 'wheat_thin636', 'ysalah', 'mkubiak', 'mmotiani', 'laurahchoi', 'jmeissner', 'pbaranwal', 'cvenatta', 'claireboland', 'rickyp999', 'npentelovitch', 'awhittington', 'bmanojlovic', 'dfang', 'jlt453', 'asantamarina', 'acm', 'rkatz', 'treber', 'hschroeder', 'smw823', 'nkraska', 'bnielsen', 'uchidas', 'aji536', 'dshabeeb', 'LWELKE', 'soconnell', 'atalai', 'sflores', 'barlas', 'tchou', 'mchen', 'swundrow', 'smoy', 'kvb507', 'jzona', 'eunterbrink', 'jsnyder', 'ohkwon', 'jteno', 'kstoddart', 'clifford', 'asuresh', 'jkircher', 'emurphy', 'mis130', 'jlemaster', 'kmp423', 'jilliann2', 'eschaefer', 'dyao', 'cnh872', 'Mehwish916', 'ebell', 'awagner', 'sdixit', 'jgavil', 'jallen', 'aroybal', 'osostan', 'xbasko', 'cdipompeo', 'ASiddiqui', 'cliu', 'rtsang', 'Asprague', 'jdarby', 'toconnell', 'mfederspiel1', 'csouthard', 'sfarley', 'nchu', 'cgrandau', 'sdang', 'kkao', 'ehaug', 'crush', 'awellman', 'ahurd', 'amahajan', 'abarr', 'dwu', 'astrick', 'ktakahashi', 'smui', 'gdasovich', 'cpai', 'ksampson', 'jjaume', 'lowen', 'aelmy', 'petarvidak', 'psampath', 'ealtman', 'Juliadeschenes', 'JMeissner', 'asiddiqui', 'jsneed', 'aahmad', 'JSavitsky', 'jramsley', 'mkalina', 'ccarhart', 'jps939', 'ccl356', 'sfriedman', 'kjs901', 'frankzhang', 'shanks53', 'ebader', 'wsun', 'sindhu108', 'alopez', 'nmsingh', 'rmb907', 'dmenon', 'jlye', 'akim', 'khiggins', 'querner', 'tsn821', 'leochild2005', 'kfreer', 'vrivas', 'aka220', 'arahman', 'KTietjen', 'cwhite', 'cmcgourty', 'chicah444', 'ashutton', 'lkarvelis', 'dwang', 'choel', 'dburk', 'jswanson', 'slim', 'mbarrett', 'vvalenzuela', 'rsmith', 'amelnyk', 'jmehra', 'skim', 'mickey_g3', 'tpoole', 'bniklinska', 'jcummins', 'dtorres', 'fuckme', 'kshedd', 'mja276', 'lstene', 'eskim', 'jerickson', 'jdeschenes', 'laybar', 'cmiksis', 'bfrett', 'msarkulova', 'jdrake', 'kmortensen', 'cboland', 'hwolfman', 'dsiegal', 'mrahman23', 'hdurschlag', 'elliottwallace', 'ekatz', 'kbg813', 'gschultz', 'del982', 'srao', 'pliu', 'ktaylor', 'jneilsson', 'mpsorkin', 'xyin', 'vladmanko', 'wuttarapatriyakul', 'rgribben', 'jsavitsky', 'agoodman', 'vleung', 'zes975', 'fzhang', 'pszalwinski', 'jroig1', 'brwass', 'ksulzer', 'bfu109', 'lkingsbury', 'ewest', 'zeidlab', 'nfrench', 'aschattner', 'Aaronbenjamin', 'aloon', 'mroebuck', 'cfrench', 'jjones', 'LKINGSBURY', 'kparekh', 'noodles5', 'suchida', 'tcouri', 'bpk122', 'acarroll', 'rgopal', 'dculhane', 'nshultz', 'abeswick', 'slu', 'kkang', 'ameyers', 'yixak', 'wstokely', 'sdaudi', 'tgonzales', 'marthachang', 'danielbaik', 'mhoffmann', 'jhan', 'SHaolinquan', 'mhyre', 'djwhack03', 'sju', 'mnovacanes', 'jbastiaens', 'elemasters', 'prettynpink221', 'chaimann', 'ecunningham', 'ndhawan', 'rferraro', 'yongjoo87', 'cpa475', 'jpineda', 'asisodia', 'grebesco', 'bbrochu', 'rkaringada', 'jyoung88', 'eohira', 'jaltenhofen', 'kalbertine', 'jessicag', 'asarwark', 'kroderer', 'chastings', 'jshabosky', 'cchristianson', 'fome', 'clin', 'sarnold', 'WUTTARAPATRIYAKUL', 'KKessler', 'dwg482', 'jdinneen', 'abruzek', 'jschulze', 'roub0008', 'pnolan', 'jweishaar', 'jmenkin', 'jlee', 'cpark']",2,"['dcao', None]",451,"['jsteinberg', 'Dangel', 'dbaik', 'csherman', 'aepstein', 'aaronbenjamin', 'chem10107', 'sburrill', 'jdavid', 'ganderson', 'zharb', 'tofinesse333', 'jonaltenhofen', 'scrow', 'amorales', 'jswenson', 'rlee', 'rkhazai', 'athaler', 'mehwish916', 'nash73', 'bschaefer', 'gbanner', 'Akhan', 'ndvora', 'bigkrezca32', 'skramer', 'bweisse', 'darosner', 'lweiss', 'jlopez', 'bvu', 'pdziedzic', 'psteptoe', 'kkovatch', 'lfs919', 'mickey', 'nperkins', 'dflint', 'gescobar', 'Ikornblau', 'pkalkat', 'edawson', 'agast', 'rwinnegar', 'jdawson', 'jdattilo', 'mfrancisco', 'jwang10', 'stacilaci56', 'sstrong', 'jbragg', 'hknai', 'seankim', 'LauraK', 'slhatch', 'Shaolinquan', 'dsy389', 'cvega', 'erobinson', 'jbeltran', 'AWellman', 'igemp', 'jschulze1', 'mlowes', 'jstroup', 'JuliaDesChenes', 'smoffett', 'msood', 'als753', 'jcarson', 'damaranto', 'dsturgeon', 'vivekanandbhardwaj', 'heisenman', 'mfederspiel', 'jchowaniec', 'SLIM', 'kmorgan', 'mshah22', 'smo596', 'fkhan', 'adhar2', 'apumm', 'swahab', 'dchoi', 'dspade', 'mbykowski', 'therrmann', 'dcooperberg', 'geieea', 'jordanduval', 'bschnedl', 'jesnyder', 'dnebel', 'alang', 'lawchang88', 'jaq945', 'pcoleman', 'kstoerzinger', 'mkahle', 'lwelke', 'jmehrotra', 'lfoulke', 'asprague', 'shaolinquan', 'bwalker423', 'evedgebah', 'zsersland', 'prabath', 'jhl326', 'cpowersmaher', 'ktietjen', 'pmodi', 'aim512', 'MChen', 'klandry', 'aechevarria', 'aocchiuti', 'cblack', 'bsummersgill', 'kcebrian', 'parker9', 'rpickering', 'churley', 'ikornblau', 'jdshank44', 'vmanko', 'robbrown', 'kbatra', 'bdemurihaeberle', 'ldelaney', 'smiller', 'g3styx', 'cconrad', 'aasthana', 'jroig', 'bmattson', 'ckilic', 'rmetzler', 'wpearse', 'jobremski', 'Edawson', 'evelyncarter', 'dufford', 'kschuette', 'ktommerdahl', 'chaselhorst', 'swalchuk', 'calfonso', 'kgspears', 'mamofa', 'dal767', 'swilson', 'agassifeng', 'spark', 'jguliap', 'akhan', 'SSINGH', 'mgilmour', 'ckwan', 'mphilben', 'dblumenthal', 'kcysewski', 'ymanibog', 'mfenstermaker', 'mtapkowski', 'ikos', 'cclark', 'dshafir', 'dliu', 'mradadia', 'clu', 'lgerkowicz', 'erausch', 'msivasubramaniam', 'rbaroch', 'wheat_thin636', 'ysalah', 'mkubiak', 'mmotiani', 'laurahchoi', 'jmeissner', 'pbaranwal', 'cvenatta', 'claireboland', 'rickyp999', 'npentelovitch', 'awhittington', 'bmanojlovic', 'dfang', 'jlt453', 'asantamarina', 'acm', 'rkatz', 'treber', 'hschroeder', 'smw823', 'nkraska', 'bnielsen', 'uchidas', 'aji536', 'dshabeeb', 'LWELKE', 'soconnell', 'atalai', 'sflores', 'barlas', 'tchou', 'mchen', None, 'swundrow', 'smoy', 'kvb507', 'jzona', 'eunterbrink', 'jsnyder', 'ohkwon', 'jteno', 'kstoddart', 'mfenech', 'clifford', 'asuresh', 'jkircher', 'emurphy', 'mis130', 'jlemaster', 'kmp423', 'jilliann2', 'eschaefer', 'dyao', 'cnh872', 'Mehwish916', 'ebell', 'awagner', 'sdixit', 'jgavil', 'jallen', 'aroybal', 'osostan', 'xbasko', 'cdipompeo', 'ASiddiqui', 'cliu', 'rtsang', 'Asprague', 'jdarby', 'toconnell', 'mfederspiel1', 'csouthard', 'sfarley', 'nchu', 'cgrandau', 'mzou', 'sdang', 'kkao', 'ehaug', 'jmarrone', 'crush', 'awellman', 'ahurd', 'amahajan', 'abarr', 'dwu', 'astrick', 'lbrengman', 'ktakahashi', 'smui', 'gdasovich', 'cpai', 'ksampson', 'jjaume', 'lowen', 'aelmy', 'petarvidak', 'psampath', 'ealtman', 'Juliadeschenes', 'JMeissner', 'asiddiqui', 'jsneed', 'aahmad', 'JSavitsky', 'jramsley', 'mkalina', 'ccarhart', 'jps939', 'ccl356', 'sfriedman', 'kjs901', 'frankzhang', 'shanks53', 'ebader', 'wsun', 'sindhu108', 'alopez', 'nmsingh', 'rmb907', 'dmenon', 'jlye', 'akim', 'khiggins', 'querner', 'tsn821', 'leochild2005', 'dcao', 'kfreer', 'vrivas', 'aka220', 'arahman', 'KTietjen', 'cwhite', 'cmcgourty', 'chicah444', 'ashutton', 'lkarvelis', 'dwang', 'choel', 'dburk', 'jswanson', 'slim', 'mbarrett', 'vvalenzuela', 'rsmith', 'amelnyk', 'jmehra', 'skim', 'mickey_g3', 'tpoole', 'bniklinska', 'jcummins', 'dtorres', 'fuckme', 'kshedd', 'mja276', 'lstene', 'eskim', 'jerickson', 'jdeschenes', 'laybar', 'cmiksis', 'bfrett', 'msarkulova', 'jdrake', 'kmortensen', 'cboland', 'hwolfman', 'dsiegal', 'mrahman23', 'slasselle', 'hdurschlag', 'elliottwallace', 'ekatz', 'kbg813', 'gschultz', 'del982', 'srao', 'pliu', 'ktaylor', 'jneilsson', 'mpsorkin', 'xyin', 'vladmanko', 'wuttarapatriyakul', 'rgribben', 'jsavitsky', 'agoodman', 'vleung', 'zes975', 'fzhang', 'pszalwinski', 'jroig1', 'brwass', 'ksulzer', 'bfu109', 'lkingsbury', 'ewest', 'zeidlab', 'nfrench', 'aschattner', 'Aaronbenjamin', 'aloon', 'mroebuck', 'cfrench', 'jjones', 'LKINGSBURY', 'kparekh', 'noodles5', 'suchida', 'tcouri', 'bpk122', 'acarroll', 'rgopal', 'dculhane', 'nshultz', 'abeswick', 'slu', 'kkang', 'ameyers', 'yixak', 'wstokely', 'sdaudi', 'tgonzales', 'marthachang', 'danielbaik', 'mhoffmann', 'jhan', 'SHaolinquan', 'mhyre', 'djwhack03', 'sju', 'mnovacanes', 'jbastiaens', 'elemasters', 'prettynpink221', 'chaimann', 'ecunningham', 'ndhawan', 'rferraro', 'yongjoo87', 'cpa475', 'jpineda', 'asisodia', 'grebesco', 'bbrochu', 'rkaringada', 'jyoung88', 'eohira', 'jaltenhofen', 'kalbertine', 'jessicag', 'asarwark', 'kroderer', 'chastings', 'jshabosky', 'cchristianson', 'fome', 'clin', 'sarnold', 'WUTTARAPATRIYAKUL', 'KKessler', 'dwg482', 'jdinneen', 'abruzek', 'jschulze', 'roub0008', 'pnolan', 'jweishaar', 'jmenkin', 'jlee', 'cpark']"
1,20,449,13,11,"['jmarrone', 'dcooperberg', 'pszalwinski', 'swilson', 'erobinson', 'stacilaci56', 'kalbertine', 'nchu', 'seankim', 'emurphy', 'hknai']",438,"['jsteinberg', 'Dangel', 'dbaik', 'csherman', 'aepstein', 'aaronbenjamin', 'chem10107', 'sburrill', 'jdavid', 'ganderson', 'zharb', 'tofinesse333', 'jonaltenhofen', 'scrow', 'amorales', 'jswenson', 'rlee', 'rkhazai', 'athaler', 'mehwish916', 'nash73', 'bschaefer', 'gbanner', 'Akhan', 'ndvora', 'bigkrezca32', 'skramer', 'bweisse', 'darosner', 'lweiss', 'jlopez', 'bvu', 'pdziedzic', 'psteptoe', 'kkovatch', 'lfs919', 'mickey', 'nperkins', 'dflint', 'gescobar', 'Ikornblau', 'pkalkat', 'edawson', 'agast', 'rwinnegar', 'jdawson', 'jdattilo', 'mfrancisco', 'jwang10', 'sstrong', 'jbragg', 'LauraK', 'slhatch', 'Shaolinquan', 'dsy389', 'cvega', 'jbeltran', 'AWellman', 'igemp', 'jschulze1', 'mlowes', 'jstroup', 'JuliaDesChenes', 'smoffett', 'msood', 'als753', 'jcarson', 'damaranto', 'dsturgeon', 'vivekanandbhardwaj', 'heisenman', 'mfederspiel', 'jchowaniec', 'SLIM', 'kmorgan', 'mshah22', 'smo596', 'fkhan', 'adhar2', 'apumm', 'swahab', 'dchoi', 'dspade', 'mbykowski', 'therrmann', 'geieea', 'jordanduval', 'bschnedl', 'jesnyder', 'dnebel', 'alang', 'lawchang88', 'jaq945', 'pcoleman', 'kstoerzinger', 'mkahle', 'lwelke', 'jmehrotra', 'lfoulke', 'asprague', 'shaolinquan', 'bwalker423', 'evedgebah', 'zsersland', 'prabath', 'jhl326', 'cpowersmaher', 'ktietjen', 'pmodi', 'aim512', 'MChen', 'klandry', 'aechevarria', 'aocchiuti', 'cblack', 'bsummersgill', 'kcebrian', 'parker9', 'rpickering', 'churley', 'ikornblau', 'jdshank44', 'vmanko', 'robbrown', 'kbatra', 'bdemurihaeberle', 'ldelaney', 'smiller', 'g3styx', 'cconrad', 'aasthana', 'jroig', 'bmattson', 'ckilic', 'rmetzler', 'wpearse', 'jobremski', 'Edawson', 'evelyncarter', 'dufford', 'kschuette', 'ktommerdahl', 'chaselhorst', 'swalchuk', 'calfonso', 'kgspears', 'mamofa', 'dal767', 'agassifeng', 'spark', 'jguliap', 'akhan', 'SSINGH', 'mgilmour', 'ckwan', 'mphilben', 'dblumenthal', 'kcysewski', 'ymanibog', 'mfenstermaker', 'mtapkowski', 'ikos', 'cclark', 'dshafir', 'dliu', 'mradadia', 'clu', 'lgerkowicz', 'erausch', 'msivasubramaniam', 'rbaroch', 'wheat_thin636', 'ysalah', 'mkubiak', 'mmotiani', 'laurahchoi', 'jmeissner', 'pbaranwal', 'cvenatta', 'claireboland', 'rickyp999', 'npentelovitch', 'awhittington', 'bmanojlovic', 'dfang', 'jlt453', 'asantamarina', 'acm', 'rkatz', 'treber', 'hschroeder', 'smw823', 'nkraska', 'bnielsen', 'uchidas', 'aji536', 'dshabeeb', 'LWELKE', 'soconnell', 'atalai', 'sflores', 'barlas', 'tchou', 'mchen', 'swundrow', 'smoy', 'kvb507', 'jzona', 'eunterbrink', 'jsnyder', 'ohkwon', 'jteno', 'kstoddart', 'mfenech', 'clifford', 'asuresh', 'jkircher', 'mis130', 'jlemaster', 'kmp423', 'jilliann2', 'eschaefer', 'dyao', 'cnh872', 'Mehwish916', 'ebell', 'awagner', 'sdixit', 'jgavil', 'jallen', 'aroybal', 'osostan', 'xbasko', 'cdipompeo', 'ASiddiqui', 'cliu', 'rtsang', 'Asprague', 'jdarby', 'toconnell', 'mfederspiel1', 'csouthard', 'sfarley', 'cgrandau', 'mzou', 'sdang', 'kkao', 'ehaug', 'crush', 'awellman', 'ahurd', 'amahajan', 'abarr', 'dwu', 'astrick', 'lbrengman', 'ktakahashi', 'smui', 'gdasovich', 'cpai', 'ksampson', 'jjaume', 'lowen', 'aelmy', 'petarvidak', 'psampath', 'ealtman', 'Juliadeschenes', 'JMeissner', 'asiddiqui', 'jsneed', 'aahmad', 'JSavitsky', 'jramsley', 'mkalina', 'ccarhart', 'jps939', 'ccl356', 'sfriedman', 'kjs901', 'frankzhang', 'shanks53', 'ebader', 'wsun', 'sindhu108', 'alopez', 'nmsingh', 'rmb907', 'dmenon', 'jlye', 'akim', 'khiggins', 'querner', 'tsn821', 'leochild2005', 'kfreer', 'vrivas', 'aka220', 'arahman', 'KTietjen', 'cwhite', 'cmcgourty', 'chicah444', 'ashutton', 'lkarvelis', 'dwang', 'choel', 'dburk', 'jswanson', 'slim', 'mbarrett', 'vvalenzuela', 'rsmith', 'amelnyk', 'jmehra', 'skim', 'mickey_g3', 'tpoole', 'bniklinska', 'jcummins', 'dtorres', 'fuckme', 'kshedd', 'mja276', 'lstene', 'eskim', 'jerickson', 'jdeschenes', 'laybar', 'cmiksis', 'bfrett', 'msarkulova', 'jdrake', 'kmortensen', 'cboland', 'hwolfman', 'dsiegal', 'mrahman23', 'slasselle', 'hdurschlag', 'elliottwallace', 'ekatz', 'kbg813', 'gschultz', 'del982', 'srao', 'pliu', 'ktaylor', 'jneilsson', 'mpsorkin', 'xyin', 'vladmanko', 'wuttarapatriyakul', 'rgribben', 'jsavitsky', 'agoodman', 'vleung', 'zes975', 'fzhang', 'jroig1', 'brwass', 'ksulzer', 'bfu109', 'lkingsbury', 'ewest', 'zeidlab', 'nfrench', 'aschattner', 'Aaronbenjamin', 'aloon', 'mroebuck', 'cfrench', 'jjones', 'LKINGSBURY', 'kparekh', 'noodles5', 'suchida', 'tcouri', 'bpk122', 'acarroll', 'rgopal', 'dculhane', 'nshultz', 'abeswick', 'slu', 'kkang', 'ameyers', 'yixak', 'wstokely', 'sdaudi', 'tgonzales', 'marthachang', 'danielbaik', 'mhoffmann', 'jhan', 'SHaolinquan', 'mhyre', 'djwhack03', 'sju', 'mnovacanes', 'jbastiaens', 'elemasters', 'prettynpink221', 'chaimann', 'ecunningham', 'ndhawan', 'rferraro', 'yongjoo87', 'cpa475', 'jpineda', 'asisodia', 'grebesco', 'bbrochu', 'rkaringada', 'jyoung88', 'eohira', 'jaltenhofen', 'jessicag', 'asarwark', 'kroderer', 'chastings', 'jshabosky', 'cchristianson', 'fome', 'clin', 'sarnold', 'WUTTARAPATRIYAKUL', 'KKessler', 'dwg482', 'jdinneen', 'abruzek', 'jschulze', 'roub0008', 'pnolan', 'jweishaar', 'jmenkin', 'jlee', 'cpark']",2,"['jroden', None]",451,"['jsteinberg', 'Dangel', 'dbaik', 'csherman', 'aepstein', 'aaronbenjamin', 'chem10107', 'sburrill', 'jdavid', 'ganderson', 'zharb', 'tofinesse333', 'jonaltenhofen', 'scrow', 'amorales', 'jswenson', 'rlee', 'rkhazai', 'athaler', 'mehwish916', 'nash73', 'bschaefer', 'gbanner', 'Akhan', 'ndvora', 'bigkrezca32', 'skramer', 'bweisse', 'darosner', 'lweiss', 'jlopez', 'bvu', 'pdziedzic', 'psteptoe', 'kkovatch', 'lfs919', 'mickey', 'nperkins', 'dflint', 'gescobar', 'Ikornblau', 'pkalkat', 'edawson', 'agast', 'rwinnegar', 'jdawson', 'jdattilo', 'mfrancisco', 'jwang10', 'stacilaci56', 'sstrong', 'jbragg', 'hknai', 'seankim', 'LauraK', 'slhatch', 'Shaolinquan', 'dsy389', 'cvega', 'erobinson', 'jbeltran', 'AWellman', 'igemp', 'jschulze1', 'mlowes', 'jstroup', 'JuliaDesChenes', 'smoffett', 'msood', 'als753', 'jcarson', 'damaranto', 'dsturgeon', 'vivekanandbhardwaj', 'heisenman', 'mfederspiel', 'jchowaniec', 'SLIM', 'kmorgan', 'mshah22', 'smo596', 'fkhan', 'adhar2', 'apumm', 'swahab', 'dchoi', 'dspade', 'mbykowski', 'therrmann', 'dcooperberg', 'geieea', 'jordanduval', 'bschnedl', 'jesnyder', 'dnebel', 'alang', 'lawchang88', 'jaq945', 'pcoleman', 'kstoerzinger', 'mkahle', 'lwelke', 'jmehrotra', 'lfoulke', 'asprague', 'shaolinquan', 'bwalker423', 'evedgebah', 'zsersland', 'prabath', 'jhl326', 'cpowersmaher', 'ktietjen', 'pmodi', 'aim512', 'MChen', 'klandry', 'aechevarria', 'aocchiuti', 'cblack', 'bsummersgill', 'kcebrian', 'parker9', 'rpickering', 'churley', 'ikornblau', 'jdshank44', 'vmanko', 'robbrown', 'kbatra', 'bdemurihaeberle', 'ldelaney', 'smiller', 'g3styx', 'cconrad', 'aasthana', 'jroig', 'bmattson', 'ckilic', 'rmetzler', 'wpearse', 'jobremski', 'Edawson', 'evelyncarter', 'dufford', 'kschuette', 'ktommerdahl', 'chaselhorst', 'swalchuk', 'calfonso', 'kgspears', 'mamofa', 'dal767', 'swilson', 'agassifeng', 'spark', 'jguliap', 'akhan', 'SSINGH', 'mgilmour', 'ckwan', 'mphilben', 'dblumenthal', 'kcysewski', 'ymanibog', 'mfenstermaker', 'mtapkowski', 'ikos', 'jroden', 'cclark', 'dshafir', 'dliu', 'mradadia', 'clu', 'lgerkowicz', 'erausch', 'msivasubramaniam', 'rbaroch', 'wheat_thin636', 'ysalah', 'mkubiak', 'mmotiani', 'laurahchoi', 'jmeissner', 'pbaranwal', 'cvenatta', 'claireboland', 'rickyp999', 'npentelovitch', 'awhittington', 'bmanojlovic', 'dfang', 'jlt453', 'asantamarina', 'acm', 'rkatz', 'treber', 'hschroeder', 'smw823', 'nkraska', 'bnielsen', 'uchidas', 'aji536', 'dshabeeb', 'LWELKE', 'soconnell', 'atalai', 'sflores', 'barlas', 'tchou', 'mchen', None, 'swundrow', 'smoy', 'kvb507', 'jzona', 'eunterbrink', 'jsnyder', 'ohkwon', 'jteno', 'kstoddart', 'mfenech', 'clifford', 'asuresh', 'jkircher', 'emurphy', 'mis130', 'jlemaster', 'kmp423', 'jilliann2', 'eschaefer', 'dyao', 'cnh872', 'Mehwish916', 'ebell', 'awagner', 'sdixit', 'jgavil', 'jallen', 'aroybal', 'osostan', 'xbasko', 'cdipompeo', 'ASiddiqui', 'cliu', 'rtsang', 'Asprague', 'jdarby', 'toconnell', 'mfederspiel1', 'csouthard', 'sfarley', 'nchu', 'cgrandau', 'mzou', 'sdang', 'kkao', 'ehaug', 'jmarrone', 'crush', 'awellman', 'ahurd', 'amahajan', 'abarr', 'dwu', 'astrick', 'lbrengman', 'ktakahashi', 'smui', 'gdasovich', 'cpai', 'ksampson', 'jjaume', 'lowen', 'aelmy', 'petarvidak', 'psampath', 'ealtman', 'Juliadeschenes', 'JMeissner', 'asiddiqui', 'jsneed', 'aahmad', 'JSavitsky', 'jramsley', 'mkalina', 'ccarhart', 'jps939', 'ccl356', 'sfriedman', 'kjs901', 'frankzhang', 'shanks53', 'ebader', 'wsun', 'sindhu108', 'alopez', 'nmsingh', 'rmb907', 'dmenon', 'jlye', 'akim', 'khiggins', 'querner', 'tsn821', 'leochild2005', 'kfreer', 'vrivas', 'aka220', 'arahman', 'KTietjen', 'cwhite', 'cmcgourty', 'chicah444', 'ashutton', 'lkarvelis', 'dwang', 'choel', 'dburk', 'jswanson', 'slim', 'mbarrett', 'vvalenzuela', 'rsmith', 'amelnyk', 'jmehra', 'skim', 'mickey_g3', 'tpoole', 'bniklinska', 'jcummins', 'dtorres', 'fuckme', 'kshedd', 'mja276', 'lstene', 'eskim', 'jerickson', 'jdeschenes', 'laybar', 'cmiksis', 'bfrett', 'msarkulova', 'jdrake', 'kmortensen', 'cboland', 'hwolfman', 'dsiegal', 'mrahman23', 'slasselle', 'hdurschlag', 'elliottwallace', 'ekatz', 'kbg813', 'gschultz', 'del982', 'srao', 'pliu', 'ktaylor', 'jneilsson', 'mpsorkin', 'xyin', 'vladmanko', 'wuttarapatriyakul', 'rgribben', 'jsavitsky', 'agoodman', 'vleung', 'zes975', 'fzhang', 'pszalwinski', 'jroig1', 'brwass', 'ksulzer', 'bfu109', 'lkingsbury', 'ewest', 'zeidlab', 'nfrench', 'aschattner', 'Aaronbenjamin', 'aloon', 'mroebuck', 'cfrench', 'jjones', 'LKINGSBURY', 'kparekh', 'noodles5', 'suchida', 'tcouri', 'bpk122', 'acarroll', 'rgopal', 'dculhane', 'nshultz', 'abeswick', 'slu', 'kkang', 'ameyers', 'yixak', 'wstokely', 'sdaudi', 'tgonzales', 'marthachang', 'danielbaik', 'mhoffmann', 'jhan', 'SHaolinquan', 'mhyre', 'djwhack03', 'sju', 'mnovacanes', 'jbastiaens', 'elemasters', 'prettynpink221', 'chaimann', 'ecunningham', 'ndhawan', 'rferraro', 'yongjoo87', 'cpa475', 'jpineda', 'asisodia', 'grebesco', 'bbrochu', 'rkaringada', 'jyoung88', 'eohira', 'jaltenhofen', 'kalbertine', 'jessicag', 'asarwark', 'kroderer', 'chastings', 'jshabosky', 'cchristianson', 'fome', 'clin', 'sarnold', 'WUTTARAPATRIYAKUL', 'KKessler', 'dwg482', 'jdinneen', 'abruzek', 'jschulze', 'roub0008', 'pnolan', 'jweishaar', 'jmenkin', 'jlee', 'cpark']"
2,56,181,146,134,"['taylorcl', 'spgreene', 'jostendo', 'sstreete', 'babaumga', 'ahermann', 'griffinm', 'nlabianc', 'obernada', 'jskim', 'irony59', 'rtrusty', 'dplamber', 'pateldm', 'nchirla', 'docdaa008', 'rahoward', 'mtummala', 'seshaw', 'ashayat', 'wizdh', 'csrockerzero', 'aashi', 'kelkwa11', 'lmertes', 'Bache', 'brunner2112', 'jkalbfle', 'kklacik', 'czahner', 'danielac', 'zarastra', 'sprashan', 'kim130', 'Jabzg', 'ebuysse', 'mhain', 'bache', 'rparisi', 'ttho', 'jgries', 'terran010', 'sbach', 'werman691', 'asudibyo', 'ftanjono', 'deetman', 'jkurasz', 'stoneagelove', 'nmisiuna', 'rkv0000', 'sundeepvem', 'alayi', 'johns180', 'skovich', 'npanitch', 'freedomjustice', 'chermawi', 'atruesde', 'aforkner', 'fuzzy_maraca77', 'dtruax', 'jshahid', 'han45', 'lpeterus', 'jaycrayz', 'pbayuart', 'rachitbiyani', 'wow676', 'tmoffitt', 'nannachh', 'elric22', 'anraj', 'jidthekid', 'tdjanoko', 'jwetheri', 'JoeBlu', 'rsherloc', 'mrmillz', 'kassovic', 'jackfrost9p', 'sdidla', 'tcollopy', 'bsarlitt', 'ahartnet', 'sageorge', 'mtanoto', 'jgu', 'et279', 'mdsnyder', 'smith571', 'lai', 'john3636', 'mrhee', 'vinsma', 'xmzhang', 'dulmes', 'apuri', 'ajplaymaker', 'singapaul', 'millies', 'jsterlin', 'dgrothe', 'gzarse', 'mille177', 'dsutherl', 'bskorupa', 'gpajot', 'cabault', 'bsyoder', 'dvanclev', 'dube0', 'mwarsco', 'wang209', 'zeich', 'akhilesh', 'wnoh', 'jtill04', 'kyangchul', 'bdannan', 'chang61', 'longja', 'kim131', 'gustaf89', 'bmroozia', 'bashir', 'samkothari79', 'mharger', 'astacy', 'zer0xxx', 'pranaynanda', 'Zarastra', 'smchaudh', 'wehlhard']",46,"['gbalmer', 'arorar', 'chaines', 'hsvasi', 'mamitche', 'joeblu', 'swethy', 'trs4ece', 'Fisher', 'bsparson', 'jdickers', 'dhum', 'gjross', 'jsommer', 'kbussmann', 'lpuglisi', 'jones105', 'nanohueb', 'zconvers', 'lcowsert', 'hiddendecoy', 'nrrojas', 'MurphyAKL', 'spamilton1', 'kdaiya', 'somacroy', 'mickcrowley', 'gutierjm', 'zer0xXx', 'sonicalflair', 'acallawa', 'ormgi', 'pmongkol', 'dergan', 'ezarowny', 'wangyangboy', 'dmmitche', 'camyers', 'gshaw', 'ajrobiso', 'spank_fusion', 'srettber', 'judoma', 'romanchd', 'parimal', 'dopkick']",12,"['ongt', 'jfawcett', 'wildkid256', 'mswallow', 'yi0', 'sumeetkumargupta', 'jcwirth', 'neudeck', 'dmsnell', 'priyam', None, 'scyther314159']",192,"['taylorcl', 'jostendo', 'hsvasi', 'jfawcett', 'babaumga', 'sumeetkumargupta', 'griffinm', 'trs4ece', 'nlabianc', 'jskim', 'irony59', 'rtrusty', 'zconvers', 'lcowsert', 'dplamber', 'pateldm', 'jcwirth', 'nchirla', 'docdaa008', 'rahoward', 'ormgi', 'kklacik', 'camyers', 'kim130', 'ebuysse', 'mamitche', 'ftanjono', 'jkurasz', 'stoneagelove', 'sundeepvem', 'lpuglisi', 'alayi', 'johns180', 'npanitch', 'chermawi', 'freedomjustice', 'atruesde', 'aforkner', 'fuzzy_maraca77', 'han45', 'lpeterus', 'pmongkol', 'dmmitche', 'rachitbiyani', 'yi0', 'neudeck', 'romanchd', 'dopkick', 'jwetheri', 'rsherloc', 'swethy', 'kassovic', 'jackfrost9p', 'sdidla', 'tcollopy', 'bsarlitt', 'kbussmann', 'jones105', 'nanohueb', 'mtanoto', 'wildkid256', 'lai', 'john3636', 'xmzhang', 'ezarowny', 'gshaw', 'dulmes', 'apuri', 'millies', 'dgrothe', 'bskorupa', 'gpajot', 'bsparson', 'dube0', 'akhilesh', 'scyther314159', 'MurphyAKL', 'kyangchul', 'bdannan', 'zer0xXx', 'acallawa', None, 'bmroozia', 'gustaf89', 'bashir', 'samkothari79', 'astacy', 'judoma', 'smchaudh', 'wehlhard', 'vinsma', 'asudibyo', 'spgreene', 'sstreete', 'ahermann', 'dhum', 'obernada', 'hiddendecoy', 'ashayat', 'mtummala', 'seshaw', 'nrrojas', 'wizdh', 'csrockerzero', 'aashi', 'kelkwa11', 'lmertes', 'Bache', 'brunner2112', 'czahner', 'jkalbfle', 'danielac', 'dergan', 'zarastra', 'sprashan', 'Jabzg', 'mhain', 'srettber', 'bache', 'rparisi', 'dmsnell', 'ttho', 'jgries', 'gbalmer', 'terran010', 'sbach', 'werman691', 'deetman', 'nmisiuna', 'rkv0000', 'ongt', 'skovich', 'dtruax', 'somacroy', 'mickcrowley', 'jshahid', 'gutierjm', 'jaycrayz', 'wangyangboy', 'pbayuart', 'wow676', 'tmoffitt', 'nannachh', 'elric22', 'anraj', 'priyam', 'jidthekid', 'parimal', 'tdjanoko', 'JoeBlu', 'mrmillz', 'jdickers', 'ahartnet', 'sageorge', 'jgu', 'spamilton1', 'et279', 'kdaiya', 'smith571', 'mdsnyder', 'mrhee', 'ajplaymaker', 'singapaul', 'jsterlin', 'gzarse', 'arorar', 'mille177', 'chaines', 'dsutherl', 'joeblu', 'Fisher', 'cabault', 'bsyoder', 'gjross', 'jsommer', 'dvanclev', 'mwarsco', 'wang209', 'zeich', 'wnoh', 'jtill04', 'sonicalflair', 'chang61', 'longja', 'kim131', 'ajrobiso', 'spank_fusion', 'mharger', 'zer0xxx', 'pranaynanda', 'Zarastra', 'mswallow']"
2,62,181,124,100,"['spgreene', 'jostendo', 'hsvasi', 'sstreete', 'ahermann', 'griffinm', 'nlabianc', 'obernada', 'jskim', 'irony59', 'rtrusty', 'zconvers', 'lcowsert', 'dplamber', 'pateldm', 'nchirla', 'docdaa008', 'hiddendecoy', 'rahoward', 'mtummala', 'seshaw', 'nrrojas', 'wizdh', 'csrockerzero', 'kelkwa11', 'brunner2112', 'czahner', 'kklacik', 'dergan', 'kim130', 'Jabzg', 'mhain', 'rparisi', 'terran010', 'mamitche', 'sbach', 'werman691', 'ftanjono', 'jkurasz', 'nmisiuna', 'lpuglisi', 'johns180', 'npanitch', 'chermawi', 'atruesde', 'fuzzy_maraca77', 'somacroy', 'gutierjm', 'han45', 'pmongkol', 'jaycrayz', 'wangyangboy', 'dmmitche', 'pbayuart', 'wow676', 'tmoffitt', 'jidthekid', 'tdjanoko', 'jwetheri', 'rsherloc', 'swethy', 'mrmillz', 'tcollopy', 'jones105', 'sageorge', 'mtanoto', 'jgu', 'spamilton1', 'kdaiya', 'john3636', 'mrhee', 'vinsma', 'dulmes', 'singapaul', 'dgrothe', 'gzarse', 'arorar', 'chaines', 'dsutherl', 'joeblu', 'Fisher', 'bsparson', 'bsyoder', 'dube0', 'mwarsco', 'zeich', 'akhilesh', 'bdannan', 'sonicalflair', 'chang61', 'acallawa', 'longja', 'kim131', 'gustaf89', 'astacy', 'judoma', 'zer0xxx', 'pranaynanda', 'Zarastra', 'asudibyo']",80,"['taylorcl', 'babaumga', 'trs4ece', 'dhum', 'ashayat', 'aashi', 'lmertes', 'Bache', 'ormgi', 'jkalbfle', 'danielac', 'zarastra', 'sprashan', 'camyers', 'ebuysse', 'srettber', 'bache', 'ttho', 'jgries', 'gbalmer', 'deetman', 'stoneagelove', 'rkv0000', 'sundeepvem', 'alayi', 'skovich', 'freedomjustice', 'aforkner', 'dtruax', 'jshahid', 'mickcrowley', 'lpeterus', 'rachitbiyani', 'nannachh', 'elric22', 'anraj', 'romanchd', 'parimal', 'dopkick', 'JoeBlu', 'jdickers', 'kassovic', 'jackfrost9p', 'sdidla', 'bsarlitt', 'ahartnet', 'kbussmann', 'nanohueb', 'et279', 'mdsnyder', 'smith571', 'lai', 'xmzhang', 'ezarowny', 'gshaw', 'apuri', 'ajplaymaker', 'millies', 'jsterlin', 'mille177', 'bskorupa', 'gpajot', 'cabault', 'gjross', 'jsommer', 'dvanclev', 'wang209', 'wnoh', 'jtill04', 'MurphyAKL', 'kyangchul', 'zer0xXx', 'ajrobiso', 'bmroozia', 'bashir', 'samkothari79', 'spank_fusion', 'mharger', 'smchaudh', 'wehlhard']",24,"['stucky', 'nee_a87', 'babauman', 'jcromer', 'sumeetkumargupta', 'SonicalFlair', 'jcleong', 'ongt', 'jenkinsalexp', 'jcwirth', 'plaird', 'pjyoti', 'wildkid256', 'priyamtrivedi', 'aashi21', 'mattsbai', None, 'garg', 'axavier', 'aozero', 'gsinghal', 'nutomo', 'fisher', 'dmsnell']",204,"['taylorcl', 'spgreene', 'jostendo', 'hsvasi', 'sstreete', 'babaumga', 'ahermann', 'jcromer', 'sumeetkumargupta', 'griffinm', 'trs4ece', 'dhum', 'nlabianc', 'obernada', 'jskim', 'irony59', 'rtrusty', 'zconvers', 'lcowsert', 'dplamber', 'pateldm', 'jcwirth', 'nchirla', 'docdaa008', 'wehlhard', 'hiddendecoy', 'rahoward', 'ashayat', 'mtummala', 'seshaw', 'nrrojas', 'wizdh', 'csrockerzero', 'aashi', 'kelkwa11', 'lmertes', 'Bache', 'ormgi', 'brunner2112', 'czahner', 'jkalbfle', 'danielac', 'kklacik', 'dergan', 'zarastra', 'axavier', 'sprashan', 'camyers', 'kim130', 'Jabzg', 'ebuysse', 'mhain', 'srettber', 'bache', 'rparisi', 'dmsnell', 'ttho', 'jgries', 'gbalmer', 'terran010', 'mamitche', 'sbach', 'werman691', 'deetman', 'ftanjono', 'jkurasz', 'jcleong', 'stoneagelove', 'nmisiuna', 'rkv0000', 'ongt', 'sundeepvem', 'lpuglisi', 'alayi', 'johns180', 'npanitch', 'skovich', 'chermawi', 'freedomjustice', 'atruesde', 'aforkner', 'fuzzy_maraca77', 'dtruax', 'somacroy', 'mickcrowley', 'jshahid', 'gutierjm', 'han45', 'lpeterus', 'pmongkol', 'garg', 'jaycrayz', 'wangyangboy', 'dmmitche', 'pbayuart', 'rachitbiyani', 'aozero', 'wow676', 'tmoffitt', 'gsinghal', 'nannachh', 'elric22', 'anraj', 'fisher', 'romanchd', 'jidthekid', 'parimal', 'dopkick', 'tdjanoko', 'jwetheri', 'JoeBlu', 'stucky', 'rsherloc', 'swethy', 'babauman', 'mrmillz', 'jdickers', 'kassovic', 'jackfrost9p', 'sdidla', 'tcollopy', 'bsarlitt', 'ahartnet', 'jones105', 'kbussmann', 'nanohueb', 'jenkinsalexp', 'sageorge', 'plaird', 'mtanoto', 'jgu', 'spamilton1', 'et279', 'kdaiya', 'smith571', 'mdsnyder', 'wildkid256', 'priyamtrivedi', 'lai', 'john3636', 'mattsbai', 'mrhee', 'vinsma', 'xmzhang', 'ezarowny', 'gshaw', 'dulmes', 'apuri', 'ajplaymaker', 'singapaul', 'millies', 'jsterlin', 'dgrothe', 'gzarse', 'arorar', 'mille177', 'chaines', 'dsutherl', 'nee_a87', 'joeblu', 'bskorupa', 'Fisher', 'bsparson', 'gpajot', 'cabault', 'SonicalFlair', 'bsyoder', 'gjross', 'jsommer', 'dvanclev', 'mwarsco', 'dube0', 'wang209', 'zeich', 'akhilesh', 'wnoh', 'jtill04', 'MurphyAKL', 'kyangchul', 'bdannan', 'pjyoti', 'zer0xXx', 'sonicalflair', 'chang61', 'aashi21', 'acallawa', 'longja', 'kim131', None, 'ajrobiso', 'bmroozia', 'gustaf89', 'bashir', 'samkothari79', 'spank_fusion', 'mharger', 'astacy', 'judoma', 'zer0xxx', 'pranaynanda', 'nutomo', 'Zarastra', 'smchaudh', 'asudibyo']"
2,71,181,113,98,"['spgreene', 'jostendo', 'hsvasi', 'sstreete', 'babaumga', 'ahermann', 'nlabianc', 'obernada', 'jskim', 'rtrusty', 'zconvers', 'lcowsert', 'dplamber', 'pateldm', 'docdaa008', 'wehlhard', 'hiddendecoy', 'rahoward', 'mtummala', 'seshaw', 'nrrojas', 'kelkwa11', 'Bache', 'brunner2112', 'czahner', 'kklacik', 'sprashan', 'kim130', 'Jabzg', 'mhain', 'srettber', 'rparisi', 'ttho', 'terran010', 'sbach', 'werman691', 'ftanjono', 'jkurasz', 'nmisiuna', 'johns180', 'npanitch', 'freedomjustice', 'chermawi', 'atruesde', 'jshahid', 'gutierjm', 'han45', 'lpeterus', 'pmongkol', 'jaycrayz', 'wangyangboy', 'dmmitche', 'pbayuart', 'wow676', 'anraj', 'jidthekid', 'tdjanoko', 'jwetheri', 'rsherloc', 'swethy', 'mrmillz', 'kassovic', 'jones105', 'mtanoto', 'jgu', 'spamilton1', 'kdaiya', 'john3636', 'vinsma', 'gshaw', 'dulmes', 'singapaul', 'dgrothe', 'gzarse', 'arorar', 'joeblu', 'Fisher', 'bsparson', 'bsyoder', 'gjross', 'dube0', 'mwarsco', 'akhilesh', 'wnoh', 'jtill04', 'MurphyAKL', 'bdannan', 'zer0xXx', 'chang61', 'acallawa', 'longja', 'kim131', 'gustaf89', 'astacy', 'pranaynanda', 'Zarastra', 'smchaudh', 'asudibyo']",82,"['taylorcl', 'trs4ece', 'griffinm', 'dhum', 'irony59', 'nchirla', 'ashayat', 'wizdh', 'csrockerzero', 'aashi', 'lmertes', 'ormgi', 'jkalbfle', 'danielac', 'zarastra', 'dergan', 'camyers', 'ebuysse', 'bache', 'jgries', 'gbalmer', 'mamitche', 'deetman', 'stoneagelove', 'rkv0000', 'sundeepvem', 'lpuglisi', 'alayi', 'skovich', 'aforkner', 'fuzzy_maraca77', 'dtruax', 'somacroy', 'mickcrowley', 'rachitbiyani', 'tmoffitt', 'nannachh', 'elric22', 'romanchd', 'parimal', 'dopkick', 'JoeBlu', 'jdickers', 'jackfrost9p', 'sdidla', 'tcollopy', 'bsarlitt', 'ahartnet', 'kbussmann', 'nanohueb', 'sageorge', 'et279', 'mdsnyder', 'smith571', 'lai', 'mrhee', 'xmzhang', 'ezarowny', 'apuri', 'ajplaymaker', 'millies', 'jsterlin', 'chaines', 'mille177', 'dsutherl', 'bskorupa', 'gpajot', 'cabault', 'jsommer', 'dvanclev', 'wang209', 'zeich', 'kyangchul', 'sonicalflair', 'ajrobiso', 'bmroozia', 'bashir', 'samkothari79', 'spank_fusion', 'mharger', 'judoma', 'zer0xxx']",15,"['lonestar', 'crosis', 'sen2904', 'pjyoti', 'rkv000', 'nsapra', 'garg', 'wildkid256', 'smillies', 'jcwirth', 'mattsbai', 'sagadi', None, 'justinsyk', 'junghanlee']",195,"['taylorcl', 'crosis', 'spgreene', 'jostendo', 'hsvasi', 'sstreete', 'babaumga', 'rkv000', 'ahermann', 'griffinm', 'trs4ece', 'dhum', 'nlabianc', 'obernada', 'jskim', 'irony59', 'rtrusty', 'zconvers', 'lcowsert', 'dplamber', 'pateldm', 'jcwirth', 'nchirla', 'docdaa008', 'wehlhard', 'hiddendecoy', 'rahoward', 'ashayat', 'mtummala', 'seshaw', 'nrrojas', 'wizdh', 'csrockerzero', 'aashi', 'kelkwa11', 'lmertes', 'Bache', 'ormgi', 'brunner2112', 'czahner', 'jkalbfle', 'danielac', 'kklacik', 'dergan', 'zarastra', 'sprashan', 'camyers', 'kim130', 'Jabzg', 'sen2904', 'ebuysse', 'mhain', 'srettber', 'bache', 'rparisi', 'ttho', 'jgries', 'gbalmer', 'terran010', 'mamitche', 'smillies', 'sbach', 'werman691', 'deetman', 'ftanjono', 'jkurasz', 'sagadi', 'stoneagelove', 'lonestar', 'nmisiuna', 'rkv0000', 'sundeepvem', 'lpuglisi', 'nsapra', 'alayi', 'johns180', 'npanitch', 'skovich', 'chermawi', 'freedomjustice', 'atruesde', 'aforkner', 'fuzzy_maraca77', 'dtruax', 'somacroy', 'mickcrowley', 'jshahid', 'gutierjm', 'han45', 'lpeterus', 'pmongkol', 'justinsyk', 'jaycrayz', 'wangyangboy', 'dmmitche', 'garg', 'pbayuart', 'rachitbiyani', 'wow676', 'tmoffitt', 'nannachh', 'elric22', 'anraj', 'romanchd', 'jidthekid', 'parimal', 'dopkick', 'tdjanoko', 'jwetheri', 'JoeBlu', 'rsherloc', 'swethy', 'mrmillz', 'jdickers', 'kassovic', 'jackfrost9p', 'sdidla', 'tcollopy', 'bsarlitt', 'ahartnet', 'jones105', 'kbussmann', 'nanohueb', 'sageorge', 'mtanoto', 'jgu', 'spamilton1', 'et279', 'kdaiya', 'smith571', 'mdsnyder', 'wildkid256', 'lai', 'john3636', 'mattsbai', 'mrhee', 'vinsma', 'xmzhang', 'ezarowny', 'gshaw', 'dulmes', 'junghanlee', 'apuri', 'ajplaymaker', 'singapaul', 'millies', 'jsterlin', 'dgrothe', 'gzarse', 'arorar', 'mille177', 'chaines', 'dsutherl', 'joeblu', 'bskorupa', 'Fisher', 'bsparson', 'gpajot', 'cabault', 'bsyoder', 'gjross', 'jsommer', 'dvanclev', 'mwarsco', 'dube0', 'wang209', 'zeich', 'akhilesh', 'wnoh', 'jtill04', 'MurphyAKL', 'kyangchul', 'bdannan', 'pjyoti', 'zer0xXx', 'sonicalflair', 'chang61', 'acallawa', 'longja', 'kim131', None, 'ajrobiso', 'bmroozia', 'gustaf89', 'bashir', 'samkothari79', 'spank_fusion', 'mharger', 'astacy', 'judoma', 'zer0xxx', 'pranaynanda', 'Zarastra', 'smchaudh', 'asudibyo']"
2,67,181,69,64,"['jwetheri', 'arorar', 'gbalmer', 'jostendo', 'hsvasi', 'sstreete', 'babaumga', 'rsherloc', 'terran010', 'swethy', 'werman691', 'Fisher', 'mrmillz', 'ftanjono', 'nlabianc', 'kassovic', 'tcollopy', 'obernada', 'jskim', 'irony59', 'rtrusty', 'dvanclev', 'lpuglisi', 'dube0', 'johns180', 'dplamber', 'akhilesh', 'chermawi', 'nchirla', 'docdaa008', 'atruesde', 'aforkner', 'gzarse', 'rahoward', 'jgu', 'jtill04', 'nrrojas', 'spamilton1', 'kdaiya', 'et279', 'bdannan', 'gutierjm', 'sonicalflair', 'zer0xXx', 'kelkwa11', 'acallawa', 'brunner2112', 'lpeterus', 'kklacik', 'pmongkol', 'dergan', 'gustaf89', 'gshaw', 'dulmes', 'sprashan', 'jaycrayz', 'wangyangboy', 'Jabzg', 'pbayuart', 'wow676', 'astacy', 'pranaynanda', 'jsterlin', 'tdjanoko']",116,"['taylorcl', 'spgreene', 'ahermann', 'griffinm', 'trs4ece', 'dhum', 'zconvers', 'lcowsert', 'pateldm', 'hiddendecoy', 'mtummala', 'seshaw', 'ashayat', 'wizdh', 'csrockerzero', 'aashi', 'lmertes', 'Bache', 'ormgi', 'czahner', 'jkalbfle', 'danielac', 'zarastra', 'camyers', 'kim130', 'ebuysse', 'mhain', 'srettber', 'bache', 'rparisi', 'ttho', 'jgries', 'mamitche', 'sbach', 'asudibyo', 'deetman', 'jkurasz', 'stoneagelove', 'nmisiuna', 'rkv0000', 'sundeepvem', 'alayi', 'npanitch', 'skovich', 'freedomjustice', 'fuzzy_maraca77', 'dtruax', 'somacroy', 'mickcrowley', 'jshahid', 'han45', 'dmmitche', 'rachitbiyani', 'tmoffitt', 'nannachh', 'elric22', 'anraj', 'romanchd', 'jidthekid', 'parimal', 'dopkick', 'JoeBlu', 'jdickers', 'jackfrost9p', 'sdidla', 'bsarlitt', 'ahartnet', 'jones105', 'kbussmann', 'nanohueb', 'sageorge', 'mtanoto', 'mdsnyder', 'smith571', 'lai', 'john3636', 'mrhee', 'vinsma', 'xmzhang', 'ezarowny', 'apuri', 'ajplaymaker', 'singapaul', 'millies', 'dgrothe', 'chaines', 'mille177', 'dsutherl', 'joeblu', 'bskorupa', 'gpajot', 'bsparson', 'cabault', 'bsyoder', 'gjross', 'jsommer', 'mwarsco', 'wang209', 'zeich', 'wnoh', 'MurphyAKL', 'kyangchul', 'chang61', 'longja', 'kim131', 'ajrobiso', 'bmroozia', 'bashir', 'samkothari79', 'spank_fusion', 'mharger', 'judoma', 'zer0xxx', 'Zarastra', 'smchaudh', 'wehlhard']",5,"['gsinghal', 'jcwirth', 'mattsbai', 'dmsnell', None]",185,"['taylorcl', 'spgreene', 'jostendo', 'hsvasi', 'sstreete', 'babaumga', 'ahermann', 'griffinm', 'trs4ece', 'dhum', 'nlabianc', 'obernada', 'jskim', 'irony59', 'rtrusty', 'zconvers', 'lcowsert', 'dplamber', 'pateldm', 'jcwirth', 'nchirla', 'docdaa008', 'wehlhard', 'hiddendecoy', 'rahoward', 'ashayat', 'mtummala', 'seshaw', 'nrrojas', 'wizdh', 'csrockerzero', 'aashi', 'kelkwa11', 'lmertes', 'Bache', 'ormgi', 'brunner2112', 'czahner', 'jkalbfle', 'danielac', 'kklacik', 'dergan', 'zarastra', 'sprashan', 'camyers', 'kim130', 'Jabzg', 'ebuysse', 'mhain', 'srettber', 'bache', 'rparisi', 'dmsnell', 'ttho', 'jgries', 'gbalmer', 'terran010', 'mamitche', 'sbach', 'werman691', 'deetman', 'ftanjono', 'jkurasz', 'stoneagelove', 'nmisiuna', 'rkv0000', 'sundeepvem', 'lpuglisi', 'alayi', 'johns180', 'npanitch', 'skovich', 'chermawi', 'freedomjustice', 'atruesde', 'aforkner', 'fuzzy_maraca77', 'dtruax', 'somacroy', 'mickcrowley', 'jshahid', 'gutierjm', 'han45', 'lpeterus', 'pmongkol', 'jaycrayz', 'wangyangboy', 'dmmitche', 'pbayuart', 'rachitbiyani', 'wow676', 'tmoffitt', 'gsinghal', 'nannachh', 'elric22', 'anraj', 'romanchd', 'jidthekid', 'parimal', 'dopkick', 'tdjanoko', 'jwetheri', 'JoeBlu', 'rsherloc', 'swethy', 'mrmillz', 'jdickers', 'kassovic', 'jackfrost9p', 'sdidla', 'tcollopy', 'bsarlitt', 'ahartnet', 'jones105', 'kbussmann', 'nanohueb', 'sageorge', 'mtanoto', 'jgu', 'spamilton1', 'et279', 'kdaiya', 'smith571', 'mdsnyder', 'lai', 'john3636', 'mattsbai', 'mrhee', 'vinsma', 'xmzhang', 'ezarowny', 'gshaw', 'dulmes', 'apuri', 'ajplaymaker', 'singapaul', 'millies', 'jsterlin', 'dgrothe', 'gzarse', 'arorar', 'mille177', 'chaines', 'dsutherl', 'joeblu', 'bskorupa', 'Fisher', 'bsparson', 'gpajot', 'cabault', 'bsyoder', 'gjross', 'jsommer', 'dvanclev', 'mwarsco', 'dube0', 'wang209', 'zeich', 'akhilesh', 'wnoh', 'jtill04', 'MurphyAKL', 'kyangchul', 'bdannan', 'zer0xXx', 'sonicalflair', 'chang61', 'acallawa', 'longja', 'kim131', None, 'ajrobiso', 'bmroozia', 'gustaf89', 'bashir', 'samkothari79', 'spank_fusion', 'mharger', 'astacy', 'judoma', 'zer0xxx', 'pranaynanda', 'Zarastra', 'smchaudh', 'asudibyo']"
2,61,181,31,26,"['spgreene', 'JoeBlu', 'terran010', 'griffinm', 'ftanjono', 'jkurasz', 'kassovic', 'tcollopy', 'nmisiuna', 'johns180', 'chermawi', 'docdaa008', 'rahoward', 'kdaiya', 'kklacik', 'pmongkol', 'zarastra', 'gustaf89', 'dmmitche', 'pbayuart', 'mharger', 'astacy', 'tmoffitt', 'ebuysse', 'singapaul', 'smchaudh']",154,"['taylorcl', 'jostendo', 'hsvasi', 'sstreete', 'babaumga', 'ahermann', 'trs4ece', 'dhum', 'nlabianc', 'obernada', 'jskim', 'irony59', 'rtrusty', 'zconvers', 'lcowsert', 'dplamber', 'pateldm', 'nchirla', 'wehlhard', 'hiddendecoy', 'ashayat', 'mtummala', 'seshaw', 'nrrojas', 'wizdh', 'csrockerzero', 'aashi', 'kelkwa11', 'lmertes', 'Bache', 'ormgi', 'brunner2112', 'czahner', 'jkalbfle', 'danielac', 'dergan', 'sprashan', 'camyers', 'kim130', 'Jabzg', 'mhain', 'srettber', 'bache', 'rparisi', 'ttho', 'jgries', 'gbalmer', 'mamitche', 'sbach', 'werman691', 'deetman', 'stoneagelove', 'rkv0000', 'sundeepvem', 'lpuglisi', 'alayi', 'npanitch', 'skovich', 'freedomjustice', 'atruesde', 'aforkner', 'fuzzy_maraca77', 'dtruax', 'somacroy', 'mickcrowley', 'jshahid', 'gutierjm', 'han45', 'lpeterus', 'jaycrayz', 'wangyangboy', 'rachitbiyani', 'wow676', 'nannachh', 'elric22', 'anraj', 'romanchd', 'jidthekid', 'parimal', 'dopkick', 'tdjanoko', 'jwetheri', 'rsherloc', 'swethy', 'mrmillz', 'jdickers', 'jackfrost9p', 'sdidla', 'bsarlitt', 'ahartnet', 'jones105', 'kbussmann', 'nanohueb', 'sageorge', 'mtanoto', 'jgu', 'spamilton1', 'et279', 'smith571', 'mdsnyder', 'lai', 'john3636', 'mrhee', 'vinsma', 'xmzhang', 'ezarowny', 'gshaw', 'dulmes', 'apuri', 'ajplaymaker', 'millies', 'jsterlin', 'dgrothe', 'gzarse', 'arorar', 'mille177', 'chaines', 'dsutherl', 'joeblu', 'bskorupa', 'Fisher', 'bsparson', 'gpajot', 'cabault', 'bsyoder', 'gjross', 'jsommer', 'dvanclev', 'mwarsco', 'dube0', 'wang209', 'zeich', 'akhilesh', 'wnoh', 'jtill04', 'MurphyAKL', 'kyangchul', 'bdannan', 'zer0xXx', 'sonicalflair', 'chang61', 'acallawa', 'longja', 'kim131', 'ajrobiso', 'bmroozia', 'bashir', 'samkothari79', 'spank_fusion', 'judoma', 'zer0xxx', 'pranaynanda', 'Zarastra', 'asudibyo']",5,"['ongt', 'vivihaha', 'sumeetkumargupta', 'dmsnell', None]",185,"['taylorcl', 'spgreene', 'jostendo', 'hsvasi', 'sstreete', 'babaumga', 'ahermann', 'sumeetkumargupta', 'griffinm', 'trs4ece', 'dhum', 'nlabianc', 'obernada', 'jskim', 'irony59', 'rtrusty', 'zconvers', 'lcowsert', 'dplamber', 'pateldm', 'nchirla', 'docdaa008', 'wehlhard', 'hiddendecoy', 'rahoward', 'ashayat', 'mtummala', 'seshaw', 'nrrojas', 'wizdh', 'csrockerzero', 'aashi', 'kelkwa11', 'lmertes', 'vivihaha', 'Bache', 'ormgi', 'brunner2112', 'czahner', 'jkalbfle', 'danielac', 'kklacik', 'dergan', 'zarastra', 'sprashan', 'camyers', 'kim130', 'Jabzg', 'ebuysse', 'mhain', 'srettber', 'bache', 'rparisi', 'dmsnell', 'ttho', 'jgries', 'gbalmer', 'terran010', 'mamitche', 'sbach', 'werman691', 'deetman', 'ftanjono', 'jkurasz', 'stoneagelove', 'nmisiuna', 'rkv0000', 'ongt', 'sundeepvem', 'lpuglisi', 'alayi', 'johns180', 'npanitch', 'skovich', 'chermawi', 'freedomjustice', 'atruesde', 'aforkner', 'fuzzy_maraca77', 'dtruax', 'somacroy', 'mickcrowley', 'jshahid', 'gutierjm', 'han45', 'lpeterus', 'pmongkol', 'jaycrayz', 'wangyangboy', 'dmmitche', 'pbayuart', 'rachitbiyani', 'wow676', 'tmoffitt', 'nannachh', 'elric22', 'anraj', 'romanchd', 'jidthekid', 'parimal', 'dopkick', 'tdjanoko', 'jwetheri', 'JoeBlu', 'rsherloc', 'swethy', 'mrmillz', 'jdickers', 'kassovic', 'jackfrost9p', 'sdidla', 'tcollopy', 'bsarlitt', 'ahartnet', 'jones105', 'kbussmann', 'nanohueb', 'sageorge', 'mtanoto', 'jgu', 'spamilton1', 'et279', 'kdaiya', 'smith571', 'mdsnyder', 'lai', 'john3636', 'mrhee', 'vinsma', 'xmzhang', 'ezarowny', 'gshaw', 'dulmes', 'apuri', 'ajplaymaker', 'singapaul', 'millies', 'jsterlin', 'dgrothe', 'gzarse', 'arorar', 'mille177', 'chaines', 'dsutherl', 'joeblu', 'bskorupa', 'Fisher', 'bsparson', 'gpajot', 'cabault', 'bsyoder', 'gjross', 'jsommer', 'dvanclev', 'mwarsco', 'dube0', 'wang209', 'zeich', 'akhilesh', 'wnoh', 'jtill04', 'MurphyAKL', 'kyangchul', 'bdannan', 'zer0xXx', 'sonicalflair', 'chang61', 'acallawa', 'longja', 'kim131', None, 'ajrobiso', 'bmroozia', 'gustaf89', 'bashir', 'samkothari79', 'spank_fusion', 'mharger', 'astacy', 'judoma', 'zer0xxx', 'pranaynanda', 'Zarastra', 'smchaudh', 'asudibyo']"
2,57,181,22,21,"['arorar', 'JoeBlu', 'babaumga', 'mamitche', 'trs4ece', 'jkurasz', 'kassovic', 'sdidla', 'dvanclev', 'et279', 'kdaiya', 'wizdh', 'somacroy', 'jshahid', 'pmongkol', 'dergan', 'ezarowny', 'spank_fusion', 'kim130', 'ebuysse', 'astacy']",159,"['taylorcl', 'spgreene', 'jostendo', 'hsvasi', 'sstreete', 'ahermann', 'griffinm', 'dhum', 'nlabianc', 'obernada', 'jskim', 'irony59', 'rtrusty', 'zconvers', 'lcowsert', 'dplamber', 'pateldm', 'nchirla', 'docdaa008', 'wehlhard', 'hiddendecoy', 'rahoward', 'ashayat', 'mtummala', 'seshaw', 'nrrojas', 'csrockerzero', 'aashi', 'kelkwa11', 'lmertes', 'Bache', 'ormgi', 'brunner2112', 'czahner', 'jkalbfle', 'danielac', 'kklacik', 'zarastra', 'sprashan', 'camyers', 'Jabzg', 'mhain', 'srettber', 'bache', 'rparisi', 'ttho', 'jgries', 'gbalmer', 'terran010', 'sbach', 'werman691', 'deetman', 'ftanjono', 'stoneagelove', 'nmisiuna', 'rkv0000', 'sundeepvem', 'lpuglisi', 'alayi', 'johns180', 'npanitch', 'skovich', 'chermawi', 'freedomjustice', 'atruesde', 'aforkner', 'fuzzy_maraca77', 'dtruax', 'mickcrowley', 'gutierjm', 'han45', 'lpeterus', 'jaycrayz', 'wangyangboy', 'dmmitche', 'pbayuart', 'rachitbiyani', 'wow676', 'tmoffitt', 'nannachh', 'elric22', 'anraj', 'romanchd', 'jidthekid', 'parimal', 'dopkick', 'tdjanoko', 'jwetheri', 'rsherloc', 'swethy', 'mrmillz', 'jdickers', 'jackfrost9p', 'tcollopy', 'bsarlitt', 'ahartnet', 'jones105', 'kbussmann', 'nanohueb', 'sageorge', 'mtanoto', 'jgu', 'spamilton1', 'smith571', 'mdsnyder', 'lai', 'john3636', 'mrhee', 'vinsma', 'xmzhang', 'gshaw', 'dulmes', 'apuri', 'ajplaymaker', 'singapaul', 'millies', 'jsterlin', 'dgrothe', 'gzarse', 'mille177', 'chaines', 'dsutherl', 'joeblu', 'bskorupa', 'Fisher', 'bsparson', 'gpajot', 'cabault', 'bsyoder', 'gjross', 'jsommer', 'mwarsco', 'dube0', 'wang209', 'zeich', 'akhilesh', 'wnoh', 'jtill04', 'MurphyAKL', 'kyangchul', 'bdannan', 'zer0xXx', 'sonicalflair', 'chang61', 'acallawa', 'longja', 'kim131', 'ajrobiso', 'bmroozia', 'gustaf89', 'bashir', 'samkothari79', 'mharger', 'judoma', 'zer0xxx', 'pranaynanda', 'Zarastra', 'smchaudh', 'asudibyo']",1,[None],181,"['taylorcl', 'spgreene', 'jostendo', 'hsvasi', 'sstreete', 'babaumga', 'ahermann', 'griffinm', 'trs4ece', 'dhum', 'nlabianc', 'obernada', 'jskim', 'irony59', 'rtrusty', 'zconvers', 'lcowsert', 'dplamber', 'pateldm', 'nchirla', 'docdaa008', 'wehlhard', 'hiddendecoy', 'rahoward', 'ashayat', 'mtummala', 'seshaw', 'nrrojas', 'wizdh', 'csrockerzero', 'aashi', 'kelkwa11', 'lmertes', 'Bache', 'ormgi', 'brunner2112', 'czahner', 'jkalbfle', 'danielac', 'kklacik', 'dergan', 'zarastra', 'sprashan', 'camyers', 'kim130', 'Jabzg', 'ebuysse', 'mhain', 'srettber', 'bache', 'rparisi', 'ttho', 'jgries', 'gbalmer', 'terran010', 'mamitche', 'sbach', 'werman691', 'deetman', 'ftanjono', 'jkurasz', 'stoneagelove', 'nmisiuna', 'rkv0000', 'sundeepvem', 'lpuglisi', 'alayi', 'johns180', 'npanitch', 'skovich', 'chermawi', 'freedomjustice', 'atruesde', 'aforkner', 'fuzzy_maraca77', 'dtruax', 'somacroy', 'mickcrowley', 'jshahid', 'gutierjm', 'han45', 'lpeterus', 'pmongkol', 'jaycrayz', 'wangyangboy', 'dmmitche', 'pbayuart', 'rachitbiyani', 'wow676', 'tmoffitt', 'nannachh', 'elric22', 'anraj', 'romanchd', 'jidthekid', 'parimal', 'dopkick', 'tdjanoko', 'jwetheri', 'JoeBlu', 'rsherloc', 'swethy', 'mrmillz', 'jdickers', 'kassovic', 'jackfrost9p', 'sdidla', 'tcollopy', 'bsarlitt', 'ahartnet', 'jones105', 'kbussmann', 'nanohueb', 'sageorge', 'mtanoto', 'jgu', 'spamilton1', 'et279', 'kdaiya', 'smith571', 'mdsnyder', 'lai', 'john3636', 'mrhee', 'vinsma', 'xmzhang', 'ezarowny', 'gshaw', 'dulmes', 'apuri', 'ajplaymaker', 'singapaul', 'millies', 'jsterlin', 'dgrothe', 'gzarse', 'arorar', 'mille177', 'chaines', 'dsutherl', 'joeblu', 'bskorupa', 'Fisher', 'bsparson', 'gpajot', 'cabault', 'bsyoder', 'gjross', 'jsommer', 'dvanclev', 'mwarsco', 'dube0', 'wang209', 'zeich', 'akhilesh', 'wnoh', 'jtill04', 'MurphyAKL', 'kyangchul', 'bdannan', 'zer0xXx', 'sonicalflair', 'chang61', 'acallawa', 'longja', 'kim131', None, 'ajrobiso', 'bmroozia', 'gustaf89', 'bashir', 'samkothari79', 'spank_fusion', 'mharger', 'astacy', 'judoma', 'zer0xxx', 'pranaynanda', 'Zarastra', 'smchaudh', 'asudibyo']"
2,58,181,14,10,"['jtill04', 'nmisiuna', 'ajplaymaker', 'smith571', 'ahermann', 'jkalbfle', 'lcowsert', 'jdickers', 'dhum', 'dopkick']",170,"['taylorcl', 'spgreene', 'jostendo', 'hsvasi', 'sstreete', 'babaumga', 'griffinm', 'trs4ece', 'nlabianc', 'obernada', 'jskim', 'irony59', 'rtrusty', 'zconvers', 'dplamber', 'pateldm', 'nchirla', 'docdaa008', 'wehlhard', 'hiddendecoy', 'rahoward', 'ashayat', 'mtummala', 'seshaw', 'nrrojas', 'wizdh', 'csrockerzero', 'aashi', 'kelkwa11', 'lmertes', 'Bache', 'ormgi', 'brunner2112', 'czahner', 'danielac', 'kklacik', 'dergan', 'zarastra', 'sprashan', 'camyers', 'kim130', 'Jabzg', 'ebuysse', 'mhain', 'srettber', 'bache', 'rparisi', 'ttho', 'jgries', 'gbalmer', 'terran010', 'mamitche', 'sbach', 'werman691', 'deetman', 'ftanjono', 'jkurasz', 'stoneagelove', 'rkv0000', 'sundeepvem', 'lpuglisi', 'alayi', 'johns180', 'npanitch', 'skovich', 'chermawi', 'freedomjustice', 'atruesde', 'aforkner', 'fuzzy_maraca77', 'dtruax', 'somacroy', 'mickcrowley', 'jshahid', 'gutierjm', 'han45', 'lpeterus', 'pmongkol', 'jaycrayz', 'wangyangboy', 'dmmitche', 'pbayuart', 'rachitbiyani', 'wow676', 'tmoffitt', 'nannachh', 'elric22', 'anraj', 'romanchd', 'jidthekid', 'parimal', 'tdjanoko', 'jwetheri', 'JoeBlu', 'rsherloc', 'swethy', 'mrmillz', 'kassovic', 'jackfrost9p', 'sdidla', 'tcollopy', 'bsarlitt', 'ahartnet', 'jones105', 'kbussmann', 'nanohueb', 'sageorge', 'mtanoto', 'jgu', 'spamilton1', 'et279', 'kdaiya', 'mdsnyder', 'lai', 'john3636', 'mrhee', 'vinsma', 'xmzhang', 'ezarowny', 'gshaw', 'dulmes', 'apuri', 'singapaul', 'millies', 'jsterlin', 'dgrothe', 'gzarse', 'arorar', 'mille177', 'chaines', 'dsutherl', 'joeblu', 'bskorupa', 'Fisher', 'bsparson', 'gpajot', 'cabault', 'bsyoder', 'gjross', 'jsommer', 'dvanclev', 'mwarsco', 'dube0', 'wang209', 'zeich', 'akhilesh', 'wnoh', 'MurphyAKL', 'kyangchul', 'bdannan', 'zer0xXx', 'sonicalflair', 'chang61', 'acallawa', 'longja', 'kim131', 'ajrobiso', 'bmroozia', 'gustaf89', 'bashir', 'samkothari79', 'spank_fusion', 'mharger', 'astacy', 'judoma', 'zer0xxx', 'pranaynanda', 'Zarastra', 'smchaudh', 'asudibyo']",4,"['neudeck', None, 'mswallow', 'dmsnell']",184,"['taylorcl', 'spgreene', 'jostendo', 'hsvasi', 'sstreete', 'babaumga', 'ahermann', 'griffinm', 'trs4ece', 'dhum', 'nlabianc', 'obernada', 'jskim', 'irony59', 'rtrusty', 'zconvers', 'lcowsert', 'dplamber', 'pateldm', 'nchirla', 'docdaa008', 'wehlhard', 'hiddendecoy', 'rahoward', 'ashayat', 'mtummala', 'seshaw', 'nrrojas', 'wizdh', 'csrockerzero', 'aashi', 'kelkwa11', 'lmertes', 'Bache', 'ormgi', 'brunner2112', 'czahner', 'jkalbfle', 'danielac', 'kklacik', 'dergan', 'zarastra', 'sprashan', 'camyers', 'kim130', 'Jabzg', 'ebuysse', 'mhain', 'srettber', 'bache', 'rparisi', 'dmsnell', 'ttho', 'jgries', 'gbalmer', 'terran010', 'mamitche', 'sbach', 'werman691', 'deetman', 'ftanjono', 'jkurasz', 'stoneagelove', 'nmisiuna', 'rkv0000', 'sundeepvem', 'lpuglisi', 'alayi', 'johns180', 'npanitch', 'skovich', 'chermawi', 'freedomjustice', 'atruesde', 'aforkner', 'fuzzy_maraca77', 'dtruax', 'somacroy', 'mickcrowley', 'jshahid', 'gutierjm', 'han45', 'lpeterus', 'pmongkol', 'jaycrayz', 'wangyangboy', 'dmmitche', 'pbayuart', 'rachitbiyani', 'wow676', 'tmoffitt', 'neudeck', 'nannachh', 'elric22', 'anraj', 'romanchd', 'jidthekid', 'parimal', 'dopkick', 'tdjanoko', 'jwetheri', 'JoeBlu', 'rsherloc', 'swethy', 'mrmillz', 'jdickers', 'kassovic', 'jackfrost9p', 'sdidla', 'tcollopy', 'bsarlitt', 'ahartnet', 'jones105', 'kbussmann', 'nanohueb', 'sageorge', 'mtanoto', 'jgu', 'spamilton1', 'et279', 'kdaiya', 'smith571', 'mdsnyder', 'lai', 'john3636', 'mrhee', 'vinsma', 'xmzhang', 'ezarowny', 'gshaw', 'dulmes', 'apuri', 'ajplaymaker', 'singapaul', 'millies', 'jsterlin', 'dgrothe', 'gzarse', 'arorar', 'mille177', 'chaines', 'dsutherl', 'joeblu', 'bskorupa', 'Fisher', 'bsparson', 'gpajot', 'cabault', 'bsyoder', 'gjross', 'jsommer', 'dvanclev', 'mwarsco', 'dube0', 'wang209', 'zeich', 'akhilesh', 'wnoh', 'jtill04', 'MurphyAKL', 'kyangchul', 'bdannan', 'zer0xXx', 'sonicalflair', 'chang61', 'acallawa', 'longja', 'kim131', None, 'ajrobiso', 'bmroozia', 'gustaf89', 'bashir', 'samkothari79', 'spank_fusion', 'mharger', 'astacy', 'judoma', 'zer0xxx', 'pranaynanda', 'Zarastra', 'smchaudh', 'asudibyo', 'mswallow']"
2,66,181,14,12,"['camyers', 'MurphyAKL', 'spamilton1', 'gbalmer', 'jsommer', 'somacroy', 'ebuysse', 'sageorge', 'bsparson', 'ftanjono', 'romanchd', 'ajrobiso']",168,"['taylorcl', 'spgreene', 'jostendo', 'hsvasi', 'sstreete', 'babaumga', 'ahermann', 'griffinm', 'trs4ece', 'dhum', 'nlabianc', 'obernada', 'jskim', 'irony59', 'rtrusty', 'zconvers', 'lcowsert', 'dplamber', 'pateldm', 'nchirla', 'docdaa008', 'wehlhard', 'hiddendecoy', 'rahoward', 'ashayat', 'mtummala', 'seshaw', 'nrrojas', 'wizdh', 'csrockerzero', 'aashi', 'kelkwa11', 'lmertes', 'Bache', 'ormgi', 'brunner2112', 'czahner', 'jkalbfle', 'danielac', 'kklacik', 'dergan', 'zarastra', 'sprashan', 'kim130', 'Jabzg', 'mhain', 'srettber', 'bache', 'rparisi', 'ttho', 'jgries', 'terran010', 'mamitche', 'sbach', 'werman691', 'deetman', 'jkurasz', 'stoneagelove', 'nmisiuna', 'rkv0000', 'sundeepvem', 'lpuglisi', 'alayi', 'johns180', 'npanitch', 'skovich', 'chermawi', 'freedomjustice', 'atruesde', 'aforkner', 'fuzzy_maraca77', 'dtruax', 'mickcrowley', 'jshahid', 'gutierjm', 'han45', 'lpeterus', 'pmongkol', 'jaycrayz', 'wangyangboy', 'dmmitche', 'pbayuart', 'rachitbiyani', 'wow676', 'tmoffitt', 'nannachh', 'elric22', 'anraj', 'jidthekid', 'parimal', 'dopkick', 'tdjanoko', 'jwetheri', 'JoeBlu', 'rsherloc', 'swethy', 'mrmillz', 'jdickers', 'kassovic', 'jackfrost9p', 'sdidla', 'tcollopy', 'bsarlitt', 'ahartnet', 'jones105', 'kbussmann', 'nanohueb', 'mtanoto', 'jgu', 'et279', 'kdaiya', 'smith571', 'mdsnyder', 'lai', 'john3636', 'mrhee', 'vinsma', 'xmzhang', 'ezarowny', 'gshaw', 'dulmes', 'apuri', 'ajplaymaker', 'singapaul', 'millies', 'jsterlin', 'dgrothe', 'gzarse', 'arorar', 'mille177', 'chaines', 'dsutherl', 'joeblu', 'bskorupa', 'Fisher', 'gpajot', 'cabault', 'bsyoder', 'gjross', 'dvanclev', 'mwarsco', 'dube0', 'wang209', 'zeich', 'akhilesh', 'wnoh', 'jtill04', 'kyangchul', 'bdannan', 'zer0xXx', 'sonicalflair', 'chang61', 'acallawa', 'longja', 'kim131', 'bmroozia', 'gustaf89', 'bashir', 'samkothari79', 'spank_fusion', 'mharger', 'astacy', 'judoma', 'zer0xxx', 'pranaynanda', 'Zarastra', 'smchaudh', 'asudibyo']",2,"['acgautam', None]",182,"['taylorcl', 'spgreene', 'jostendo', 'hsvasi', 'sstreete', 'babaumga', 'ahermann', 'griffinm', 'trs4ece', 'dhum', 'nlabianc', 'obernada', 'jskim', 'irony59', 'rtrusty', 'zconvers', 'lcowsert', 'dplamber', 'pateldm', 'nchirla', 'docdaa008', 'wehlhard', 'hiddendecoy', 'rahoward', 'ashayat', 'mtummala', 'seshaw', 'nrrojas', 'wizdh', 'csrockerzero', 'aashi', 'kelkwa11', 'lmertes', 'Bache', 'ormgi', 'brunner2112', 'czahner', 'jkalbfle', 'danielac', 'kklacik', 'dergan', 'zarastra', 'sprashan', 'camyers', 'kim130', 'Jabzg', 'ebuysse', 'mhain', 'srettber', 'acgautam', 'bache', 'rparisi', 'ttho', 'jgries', 'gbalmer', 'terran010', 'mamitche', 'sbach', 'werman691', 'deetman', 'ftanjono', 'jkurasz', 'stoneagelove', 'nmisiuna', 'rkv0000', 'sundeepvem', 'lpuglisi', 'alayi', 'johns180', 'npanitch', 'skovich', 'chermawi', 'freedomjustice', 'atruesde', 'aforkner', 'fuzzy_maraca77', 'dtruax', 'somacroy', 'mickcrowley', 'jshahid', 'gutierjm', 'han45', 'lpeterus', 'pmongkol', 'jaycrayz', 'wangyangboy', 'dmmitche', 'pbayuart', 'rachitbiyani', 'wow676', 'tmoffitt', 'nannachh', 'elric22', 'anraj', 'romanchd', 'jidthekid', 'parimal', 'dopkick', 'tdjanoko', 'jwetheri', 'JoeBlu', 'rsherloc', 'swethy', 'mrmillz', 'jdickers', 'kassovic', 'jackfrost9p', 'sdidla', 'tcollopy', 'bsarlitt', 'ahartnet', 'jones105', 'kbussmann', 'nanohueb', 'sageorge', 'mtanoto', 'jgu', 'spamilton1', 'et279', 'kdaiya', 'smith571', 'mdsnyder', 'lai', 'john3636', 'mrhee', 'vinsma', 'xmzhang', 'ezarowny', 'gshaw', 'dulmes', 'apuri', 'ajplaymaker', 'singapaul', 'millies', 'jsterlin', 'dgrothe', 'gzarse', 'arorar', 'mille177', 'chaines', 'dsutherl', 'joeblu', 'bskorupa', 'Fisher', 'bsparson', 'gpajot', 'cabault', 'bsyoder', 'gjross', 'jsommer', 'dvanclev', 'mwarsco', 'dube0', 'wang209', 'zeich', 'akhilesh', 'wnoh', 'jtill04', 'MurphyAKL', 'kyangchul', 'bdannan', 'zer0xXx', 'sonicalflair', 'chang61', 'acallawa', 'longja', 'kim131', None, 'ajrobiso', 'bmroozia', 'gustaf89', 'bashir', 'samkothari79', 'spank_fusion', 'mharger', 'astacy', 'judoma', 'zer0xxx', 'pranaynanda', 'Zarastra', 'smchaudh', 'asudibyo']"
2,72,181,14,10,"['jkurasz', 'et279', 'wizdh', 'somacroy', 'ebuysse', 'mamitche', 'sonicalflair', 'chermawi', 'aforkner', 'dergan']",170,"['taylorcl', 'spgreene', 'jostendo', 'hsvasi', 'sstreete', 'babaumga', 'ahermann', 'griffinm', 'trs4ece', 'dhum', 'nlabianc', 'obernada', 'jskim', 'irony59', 'rtrusty', 'zconvers', 'lcowsert', 'dplamber', 'pateldm', 'nchirla', 'docdaa008', 'wehlhard', 'hiddendecoy', 'rahoward', 'ashayat', 'mtummala', 'seshaw', 'nrrojas', 'csrockerzero', 'aashi', 'kelkwa11', 'lmertes', 'Bache', 'ormgi', 'brunner2112', 'czahner', 'jkalbfle', 'danielac', 'kklacik', 'zarastra', 'sprashan', 'camyers', 'kim130', 'Jabzg', 'mhain', 'srettber', 'bache', 'rparisi', 'ttho', 'jgries', 'gbalmer', 'terran010', 'sbach', 'werman691', 'deetman', 'ftanjono', 'stoneagelove', 'nmisiuna', 'rkv0000', 'sundeepvem', 'lpuglisi', 'alayi', 'johns180', 'npanitch', 'skovich', 'freedomjustice', 'atruesde', 'fuzzy_maraca77', 'dtruax', 'mickcrowley', 'jshahid', 'gutierjm', 'han45', 'lpeterus', 'pmongkol', 'jaycrayz', 'wangyangboy', 'dmmitche', 'pbayuart', 'rachitbiyani', 'wow676', 'tmoffitt', 'nannachh', 'elric22', 'anraj', 'romanchd', 'jidthekid', 'parimal', 'dopkick', 'tdjanoko', 'jwetheri', 'JoeBlu', 'rsherloc', 'swethy', 'mrmillz', 'jdickers', 'kassovic', 'jackfrost9p', 'sdidla', 'tcollopy', 'bsarlitt', 'ahartnet', 'jones105', 'kbussmann', 'nanohueb', 'sageorge', 'mtanoto', 'jgu', 'spamilton1', 'kdaiya', 'smith571', 'mdsnyder', 'lai', 'john3636', 'mrhee', 'vinsma', 'xmzhang', 'ezarowny', 'gshaw', 'dulmes', 'apuri', 'ajplaymaker', 'singapaul', 'millies', 'jsterlin', 'dgrothe', 'gzarse', 'arorar', 'mille177', 'chaines', 'dsutherl', 'joeblu', 'bskorupa', 'Fisher', 'bsparson', 'gpajot', 'cabault', 'bsyoder', 'gjross', 'jsommer', 'dvanclev', 'mwarsco', 'dube0', 'wang209', 'zeich', 'akhilesh', 'wnoh', 'jtill04', 'MurphyAKL', 'kyangchul', 'bdannan', 'zer0xXx', 'chang61', 'acallawa', 'longja', 'kim131', 'ajrobiso', 'bmroozia', 'gustaf89', 'bashir', 'samkothari79', 'spank_fusion', 'mharger', 'astacy', 'judoma', 'zer0xxx', 'pranaynanda', 'Zarastra', 'smchaudh', 'asudibyo']",4,"['thatmushroom', None, 'smillies', 'pjyoti']",184,"['taylorcl', 'spgreene', 'jostendo', 'hsvasi', 'sstreete', 'babaumga', 'ahermann', 'griffinm', 'trs4ece', 'dhum', 'nlabianc', 'obernada', 'jskim', 'irony59', 'rtrusty', 'zconvers', 'lcowsert', 'dplamber', 'pateldm', 'nchirla', 'docdaa008', 'wehlhard', 'hiddendecoy', 'rahoward', 'ashayat', 'mtummala', 'seshaw', 'nrrojas', 'wizdh', 'csrockerzero', 'aashi', 'kelkwa11', 'lmertes', 'Bache', 'ormgi', 'brunner2112', 'czahner', 'jkalbfle', 'danielac', 'kklacik', 'dergan', 'zarastra', 'sprashan', 'camyers', 'kim130', 'Jabzg', 'ebuysse', 'mhain', 'srettber', 'bache', 'rparisi', 'ttho', 'jgries', 'gbalmer', 'terran010', 'mamitche', 'smillies', 'sbach', 'werman691', 'deetman', 'ftanjono', 'jkurasz', 'stoneagelove', 'nmisiuna', 'rkv0000', 'sundeepvem', 'lpuglisi', 'alayi', 'johns180', 'npanitch', 'skovich', 'chermawi', 'freedomjustice', 'atruesde', 'aforkner', 'fuzzy_maraca77', 'dtruax', 'somacroy', 'mickcrowley', 'jshahid', 'gutierjm', 'han45', 'lpeterus', 'pmongkol', 'jaycrayz', 'wangyangboy', 'dmmitche', 'pbayuart', 'rachitbiyani', 'wow676', 'tmoffitt', 'nannachh', 'elric22', 'anraj', 'romanchd', 'jidthekid', 'parimal', 'dopkick', 'tdjanoko', 'jwetheri', 'JoeBlu', 'rsherloc', 'swethy', 'mrmillz', 'jdickers', 'kassovic', 'jackfrost9p', 'sdidla', 'tcollopy', 'bsarlitt', 'ahartnet', 'jones105', 'kbussmann', 'nanohueb', 'sageorge', 'mtanoto', 'jgu', 'spamilton1', 'et279', 'kdaiya', 'smith571', 'mdsnyder', 'lai', 'john3636', 'mrhee', 'vinsma', 'xmzhang', 'ezarowny', 'gshaw', 'dulmes', 'apuri', 'ajplaymaker', 'singapaul', 'millies', 'jsterlin', 'dgrothe', 'gzarse', 'thatmushroom', 'arorar', 'mille177', 'chaines', 'dsutherl', 'joeblu', 'bskorupa', 'Fisher', 'bsparson', 'gpajot', 'cabault', 'bsyoder', 'gjross', 'jsommer', 'dvanclev', 'mwarsco', 'dube0', 'wang209', 'zeich', 'akhilesh', 'wnoh', 'jtill04', 'MurphyAKL', 'kyangchul', 'bdannan', 'pjyoti', 'zer0xXx', 'sonicalflair', 'chang61', 'acallawa', 'longja', 'kim131', None, 'ajrobiso', 'bmroozia', 'gustaf89', 'bashir', 'samkothari79', 'spank_fusion', 'mharger', 'astacy', 'judoma', 'zer0xxx', 'pranaynanda', 'Zarastra', 'smchaudh', 'asudibyo']"
2,63,181,13,10,"['gjross', 'sprashan', 'chaines', 'dvanclev', 'smith571', 'astacy', 'lcowsert', 'han45', 'smchaudh', 'dopkick']",170,"['taylorcl', 'spgreene', 'jostendo', 'hsvasi', 'sstreete', 'babaumga', 'ahermann', 'griffinm', 'trs4ece', 'dhum', 'nlabianc', 'obernada', 'jskim', 'irony59', 'rtrusty', 'zconvers', 'dplamber', 'pateldm', 'nchirla', 'docdaa008', 'wehlhard', 'hiddendecoy', 'rahoward', 'ashayat', 'mtummala', 'seshaw', 'nrrojas', 'wizdh', 'csrockerzero', 'aashi', 'kelkwa11', 'lmertes', 'Bache', 'ormgi', 'brunner2112', 'czahner', 'jkalbfle', 'danielac', 'kklacik', 'dergan', 'zarastra', 'camyers', 'kim130', 'Jabzg', 'ebuysse', 'mhain', 'srettber', 'bache', 'rparisi', 'ttho', 'jgries', 'gbalmer', 'terran010', 'mamitche', 'sbach', 'werman691', 'deetman', 'ftanjono', 'jkurasz', 'stoneagelove', 'nmisiuna', 'rkv0000', 'sundeepvem', 'lpuglisi', 'alayi', 'johns180', 'npanitch', 'skovich', 'chermawi', 'freedomjustice', 'atruesde', 'aforkner', 'fuzzy_maraca77', 'dtruax', 'somacroy', 'mickcrowley', 'jshahid', 'gutierjm', 'lpeterus', 'pmongkol', 'jaycrayz', 'wangyangboy', 'dmmitche', 'pbayuart', 'rachitbiyani', 'wow676', 'tmoffitt', 'nannachh', 'elric22', 'anraj', 'romanchd', 'jidthekid', 'parimal', 'tdjanoko', 'jwetheri', 'JoeBlu', 'rsherloc', 'swethy', 'mrmillz', 'jdickers', 'kassovic', 'jackfrost9p', 'sdidla', 'tcollopy', 'bsarlitt', 'ahartnet', 'jones105', 'kbussmann', 'nanohueb', 'sageorge', 'mtanoto', 'jgu', 'spamilton1', 'et279', 'kdaiya', 'mdsnyder', 'lai', 'john3636', 'mrhee', 'vinsma', 'xmzhang', 'ezarowny', 'gshaw', 'dulmes', 'apuri', 'ajplaymaker', 'singapaul', 'millies', 'jsterlin', 'dgrothe', 'gzarse', 'arorar', 'mille177', 'dsutherl', 'joeblu', 'bskorupa', 'Fisher', 'bsparson', 'gpajot', 'cabault', 'bsyoder', 'jsommer', 'mwarsco', 'dube0', 'wang209', 'zeich', 'akhilesh', 'wnoh', 'jtill04', 'MurphyAKL', 'kyangchul', 'bdannan', 'zer0xXx', 'sonicalflair', 'chang61', 'acallawa', 'longja', 'kim131', 'ajrobiso', 'bmroozia', 'gustaf89', 'bashir', 'samkothari79', 'spank_fusion', 'mharger', 'judoma', 'zer0xxx', 'pranaynanda', 'Zarastra', 'asudibyo']",3,"['adarmans', None, 'neudeck']",183,"['taylorcl', 'spgreene', 'jostendo', 'hsvasi', 'sstreete', 'babaumga', 'ahermann', 'griffinm', 'trs4ece', 'dhum', 'nlabianc', 'obernada', 'jskim', 'irony59', 'rtrusty', 'zconvers', 'lcowsert', 'dplamber', 'pateldm', 'nchirla', 'docdaa008', 'wehlhard', 'hiddendecoy', 'rahoward', 'ashayat', 'mtummala', 'seshaw', 'nrrojas', 'wizdh', 'csrockerzero', 'aashi', 'kelkwa11', 'lmertes', 'Bache', 'ormgi', 'brunner2112', 'czahner', 'jkalbfle', 'danielac', 'kklacik', 'dergan', 'zarastra', 'sprashan', 'camyers', 'kim130', 'Jabzg', 'ebuysse', 'mhain', 'srettber', 'bache', 'rparisi', 'ttho', 'jgries', 'gbalmer', 'terran010', 'mamitche', 'sbach', 'werman691', 'deetman', 'ftanjono', 'jkurasz', 'stoneagelove', 'nmisiuna', 'rkv0000', 'sundeepvem', 'lpuglisi', 'alayi', 'johns180', 'npanitch', 'skovich', 'chermawi', 'freedomjustice', 'atruesde', 'aforkner', 'fuzzy_maraca77', 'dtruax', 'somacroy', 'mickcrowley', 'jshahid', 'gutierjm', 'han45', 'lpeterus', 'pmongkol', 'jaycrayz', 'wangyangboy', 'dmmitche', 'pbayuart', 'rachitbiyani', 'wow676', 'tmoffitt', 'neudeck', 'nannachh', 'elric22', 'anraj', 'romanchd', 'jidthekid', 'parimal', 'dopkick', 'tdjanoko', 'jwetheri', 'JoeBlu', 'rsherloc', 'swethy', 'mrmillz', 'jdickers', 'kassovic', 'jackfrost9p', 'sdidla', 'tcollopy', 'bsarlitt', 'ahartnet', 'jones105', 'kbussmann', 'nanohueb', 'sageorge', 'mtanoto', 'jgu', 'spamilton1', 'et279', 'kdaiya', 'smith571', 'mdsnyder', 'lai', 'john3636', 'mrhee', 'vinsma', 'xmzhang', 'ezarowny', 'gshaw', 'dulmes', 'adarmans', 'apuri', 'ajplaymaker', 'singapaul', 'millies', 'jsterlin', 'dgrothe', 'gzarse', 'arorar', 'mille177', 'chaines', 'dsutherl', 'joeblu', 'bskorupa', 'Fisher', 'bsparson', 'gpajot', 'cabault', 'bsyoder', 'gjross', 'jsommer', 'dvanclev', 'mwarsco', 'dube0', 'wang209', 'zeich', 'akhilesh', 'wnoh', 'jtill04', 'MurphyAKL', 'kyangchul', 'bdannan', 'zer0xXx', 'sonicalflair', 'chang61', 'acallawa', 'longja', 'kim131', None, 'ajrobiso', 'bmroozia', 'gustaf89', 'bashir', 'samkothari79', 'spank_fusion', 'mharger', 'astacy', 'judoma', 'zer0xxx', 'pranaynanda', 'Zarastra', 'smchaudh', 'asudibyo']"
2,59,181,12,11,"['camyers', 'MurphyAKL', 'spamilton1', 'judoma', 'alayi', 'rparisi', 'docdaa008', 'bsparson', 'sageorge', 'nlabianc', 'ajrobiso']",169,"['taylorcl', 'spgreene', 'jostendo', 'hsvasi', 'sstreete', 'babaumga', 'ahermann', 'griffinm', 'trs4ece', 'dhum', 'obernada', 'jskim', 'irony59', 'rtrusty', 'zconvers', 'lcowsert', 'dplamber', 'pateldm', 'nchirla', 'wehlhard', 'hiddendecoy', 'rahoward', 'ashayat', 'mtummala', 'seshaw', 'nrrojas', 'wizdh', 'csrockerzero', 'aashi', 'kelkwa11', 'lmertes', 'Bache', 'ormgi', 'brunner2112', 'czahner', 'jkalbfle', 'danielac', 'kklacik', 'dergan', 'zarastra', 'sprashan', 'kim130', 'Jabzg', 'ebuysse', 'mhain', 'srettber', 'bache', 'ttho', 'jgries', 'gbalmer', 'terran010', 'mamitche', 'sbach', 'werman691', 'deetman', 'ftanjono', 'jkurasz', 'stoneagelove', 'nmisiuna', 'rkv0000', 'sundeepvem', 'lpuglisi', 'johns180', 'npanitch', 'skovich', 'chermawi', 'freedomjustice', 'atruesde', 'aforkner', 'fuzzy_maraca77', 'dtruax', 'somacroy', 'mickcrowley', 'jshahid', 'gutierjm', 'han45', 'lpeterus', 'pmongkol', 'jaycrayz', 'wangyangboy', 'dmmitche', 'pbayuart', 'rachitbiyani', 'wow676', 'tmoffitt', 'nannachh', 'elric22', 'anraj', 'romanchd', 'jidthekid', 'parimal', 'dopkick', 'tdjanoko', 'jwetheri', 'JoeBlu', 'rsherloc', 'swethy', 'mrmillz', 'jdickers', 'kassovic', 'jackfrost9p', 'sdidla', 'tcollopy', 'bsarlitt', 'ahartnet', 'jones105', 'kbussmann', 'nanohueb', 'mtanoto', 'jgu', 'et279', 'kdaiya', 'smith571', 'mdsnyder', 'lai', 'john3636', 'mrhee', 'vinsma', 'xmzhang', 'ezarowny', 'gshaw', 'dulmes', 'apuri', 'ajplaymaker', 'singapaul', 'millies', 'jsterlin', 'dgrothe', 'gzarse', 'arorar', 'mille177', 'chaines', 'dsutherl', 'joeblu', 'bskorupa', 'Fisher', 'gpajot', 'cabault', 'bsyoder', 'gjross', 'jsommer', 'dvanclev', 'mwarsco', 'dube0', 'wang209', 'zeich', 'akhilesh', 'wnoh', 'jtill04', 'kyangchul', 'bdannan', 'zer0xXx', 'sonicalflair', 'chang61', 'acallawa', 'longja', 'kim131', 'bmroozia', 'gustaf89', 'bashir', 'samkothari79', 'spank_fusion', 'mharger', 'astacy', 'zer0xxx', 'pranaynanda', 'Zarastra', 'smchaudh', 'asudibyo']",1,[None],181,"['taylorcl', 'spgreene', 'jostendo', 'hsvasi', 'sstreete', 'babaumga', 'ahermann', 'griffinm', 'trs4ece', 'dhum', 'nlabianc', 'obernada', 'jskim', 'irony59', 'rtrusty', 'zconvers', 'lcowsert', 'dplamber', 'pateldm', 'nchirla', 'docdaa008', 'wehlhard', 'hiddendecoy', 'rahoward', 'ashayat', 'mtummala', 'seshaw', 'nrrojas', 'wizdh', 'csrockerzero', 'aashi', 'kelkwa11', 'lmertes', 'Bache', 'ormgi', 'brunner2112', 'czahner', 'jkalbfle', 'danielac', 'kklacik', 'dergan', 'zarastra', 'sprashan', 'camyers', 'kim130', 'Jabzg', 'ebuysse', 'mhain', 'srettber', 'bache', 'rparisi', 'ttho', 'jgries', 'gbalmer', 'terran010', 'mamitche', 'sbach', 'werman691', 'deetman', 'ftanjono', 'jkurasz', 'stoneagelove', 'nmisiuna', 'rkv0000', 'sundeepvem', 'lpuglisi', 'alayi', 'johns180', 'npanitch', 'skovich', 'chermawi', 'freedomjustice', 'atruesde', 'aforkner', 'fuzzy_maraca77', 'dtruax', 'somacroy', 'mickcrowley', 'jshahid', 'gutierjm', 'han45', 'lpeterus', 'pmongkol', 'jaycrayz', 'wangyangboy', 'dmmitche', 'pbayuart', 'rachitbiyani', 'wow676', 'tmoffitt', 'nannachh', 'elric22', 'anraj', 'romanchd', 'jidthekid', 'parimal', 'dopkick', 'tdjanoko', 'jwetheri', 'JoeBlu', 'rsherloc', 'swethy', 'mrmillz', 'jdickers', 'kassovic', 'jackfrost9p', 'sdidla', 'tcollopy', 'bsarlitt', 'ahartnet', 'jones105', 'kbussmann', 'nanohueb', 'sageorge', 'mtanoto', 'jgu', 'spamilton1', 'et279', 'kdaiya', 'smith571', 'mdsnyder', 'lai', 'john3636', 'mrhee', 'vinsma', 'xmzhang', 'ezarowny', 'gshaw', 'dulmes', 'apuri', 'ajplaymaker', 'singapaul', 'millies', 'jsterlin', 'dgrothe', 'gzarse', 'arorar', 'mille177', 'chaines', 'dsutherl', 'joeblu', 'bskorupa', 'Fisher', 'bsparson', 'gpajot', 'cabault', 'bsyoder', 'gjross', 'jsommer', 'dvanclev', 'mwarsco', 'dube0', 'wang209', 'zeich', 'akhilesh', 'wnoh', 'jtill04', 'MurphyAKL', 'kyangchul', 'bdannan', 'zer0xXx', 'sonicalflair', 'chang61', 'acallawa', 'longja', 'kim131', None, 'ajrobiso', 'bmroozia', 'gustaf89', 'bashir', 'samkothari79', 'spank_fusion', 'mharger', 'astacy', 'judoma', 'zer0xxx', 'pranaynanda', 'Zarastra', 'smchaudh', 'asudibyo']"
2,65,181,10,9,"['et279', 'wizdh', 'somacroy', 'ebuysse', 'mamitche', 'babaumga', 'lpeterus', 'aforkner', 'kassovic']",171,"['taylorcl', 'spgreene', 'jostendo', 'hsvasi', 'sstreete', 'ahermann', 'griffinm', 'trs4ece', 'dhum', 'nlabianc', 'obernada', 'jskim', 'irony59', 'rtrusty', 'zconvers', 'lcowsert', 'dplamber', 'pateldm', 'nchirla', 'docdaa008', 'wehlhard', 'hiddendecoy', 'rahoward', 'ashayat', 'mtummala', 'seshaw', 'nrrojas', 'csrockerzero', 'aashi', 'kelkwa11', 'lmertes', 'Bache', 'ormgi', 'brunner2112', 'czahner', 'jkalbfle', 'danielac', 'kklacik', 'dergan', 'zarastra', 'sprashan', 'camyers', 'kim130', 'Jabzg', 'mhain', 'srettber', 'bache', 'rparisi', 'ttho', 'jgries', 'gbalmer', 'terran010', 'sbach', 'werman691', 'deetman', 'ftanjono', 'jkurasz', 'stoneagelove', 'nmisiuna', 'rkv0000', 'sundeepvem', 'lpuglisi', 'alayi', 'johns180', 'npanitch', 'skovich', 'chermawi', 'freedomjustice', 'atruesde', 'fuzzy_maraca77', 'dtruax', 'mickcrowley', 'jshahid', 'gutierjm', 'han45', 'pmongkol', 'jaycrayz', 'wangyangboy', 'dmmitche', 'pbayuart', 'rachitbiyani', 'wow676', 'tmoffitt', 'nannachh', 'elric22', 'anraj', 'romanchd', 'jidthekid', 'parimal', 'dopkick', 'tdjanoko', 'jwetheri', 'JoeBlu', 'rsherloc', 'swethy', 'mrmillz', 'jdickers', 'jackfrost9p', 'sdidla', 'tcollopy', 'bsarlitt', 'ahartnet', 'jones105', 'kbussmann', 'nanohueb', 'sageorge', 'mtanoto', 'jgu', 'spamilton1', 'kdaiya', 'smith571', 'mdsnyder', 'lai', 'john3636', 'mrhee', 'vinsma', 'xmzhang', 'ezarowny', 'gshaw', 'dulmes', 'apuri', 'ajplaymaker', 'singapaul', 'millies', 'jsterlin', 'dgrothe', 'gzarse', 'arorar', 'mille177', 'chaines', 'dsutherl', 'joeblu', 'bskorupa', 'Fisher', 'bsparson', 'gpajot', 'cabault', 'bsyoder', 'gjross', 'jsommer', 'dvanclev', 'mwarsco', 'dube0', 'wang209', 'zeich', 'akhilesh', 'wnoh', 'jtill04', 'MurphyAKL', 'kyangchul', 'bdannan', 'zer0xXx', 'sonicalflair', 'chang61', 'acallawa', 'longja', 'kim131', 'ajrobiso', 'bmroozia', 'gustaf89', 'bashir', 'samkothari79', 'spank_fusion', 'mharger', 'astacy', 'judoma', 'zer0xxx', 'pranaynanda', 'Zarastra', 'smchaudh', 'asudibyo']",1,[None],181,"['taylorcl', 'spgreene', 'jostendo', 'hsvasi', 'sstreete', 'babaumga', 'ahermann', 'griffinm', 'trs4ece', 'dhum', 'nlabianc', 'obernada', 'jskim', 'irony59', 'rtrusty', 'zconvers', 'lcowsert', 'dplamber', 'pateldm', 'nchirla', 'docdaa008', 'wehlhard', 'hiddendecoy', 'rahoward', 'ashayat', 'mtummala', 'seshaw', 'nrrojas', 'wizdh', 'csrockerzero', 'aashi', 'kelkwa11', 'lmertes', 'Bache', 'ormgi', 'brunner2112', 'czahner', 'jkalbfle', 'danielac', 'kklacik', 'dergan', 'zarastra', 'sprashan', 'camyers', 'kim130', 'Jabzg', 'ebuysse', 'mhain', 'srettber', 'bache', 'rparisi', 'ttho', 'jgries', 'gbalmer', 'terran010', 'mamitche', 'sbach', 'werman691', 'deetman', 'ftanjono', 'jkurasz', 'stoneagelove', 'nmisiuna', 'rkv0000', 'sundeepvem', 'lpuglisi', 'alayi', 'johns180', 'npanitch', 'skovich', 'chermawi', 'freedomjustice', 'atruesde', 'aforkner', 'fuzzy_maraca77', 'dtruax', 'somacroy', 'mickcrowley', 'jshahid', 'gutierjm', 'han45', 'lpeterus', 'pmongkol', 'jaycrayz', 'wangyangboy', 'dmmitche', 'pbayuart', 'rachitbiyani', 'wow676', 'tmoffitt', 'nannachh', 'elric22', 'anraj', 'romanchd', 'jidthekid', 'parimal', 'dopkick', 'tdjanoko', 'jwetheri', 'JoeBlu', 'rsherloc', 'swethy', 'mrmillz', 'jdickers', 'kassovic', 'jackfrost9p', 'sdidla', 'tcollopy', 'bsarlitt', 'ahartnet', 'jones105', 'kbussmann', 'nanohueb', 'sageorge', 'mtanoto', 'jgu', 'spamilton1', 'et279', 'kdaiya', 'smith571', 'mdsnyder', 'lai', 'john3636', 'mrhee', 'vinsma', 'xmzhang', 'ezarowny', 'gshaw', 'dulmes', 'apuri', 'ajplaymaker', 'singapaul', 'millies', 'jsterlin', 'dgrothe', 'gzarse', 'arorar', 'mille177', 'chaines', 'dsutherl', 'joeblu', 'bskorupa', 'Fisher', 'bsparson', 'gpajot', 'cabault', 'bsyoder', 'gjross', 'jsommer', 'dvanclev', 'mwarsco', 'dube0', 'wang209', 'zeich', 'akhilesh', 'wnoh', 'jtill04', 'MurphyAKL', 'kyangchul', 'bdannan', 'zer0xXx', 'sonicalflair', 'chang61', 'acallawa', 'longja', 'kim131', None, 'ajrobiso', 'bmroozia', 'gustaf89', 'bashir', 'samkothari79', 'spank_fusion', 'mharger', 'astacy', 'judoma', 'zer0xxx', 'pranaynanda', 'Zarastra', 'smchaudh', 'asudibyo']"
2,69,181,10,8,"['kdaiya', 'et279', 'wizdh', 'JoeBlu', 'mamitche', 'joeblu', 'aforkner', 'dergan']",172,"['taylorcl', 'spgreene', 'jostendo', 'hsvasi', 'sstreete', 'babaumga', 'ahermann', 'griffinm', 'trs4ece', 'dhum', 'nlabianc', 'obernada', 'jskim', 'irony59', 'rtrusty', 'zconvers', 'lcowsert', 'dplamber', 'pateldm', 'nchirla', 'docdaa008', 'wehlhard', 'hiddendecoy', 'rahoward', 'ashayat', 'mtummala', 'seshaw', 'nrrojas', 'csrockerzero', 'aashi', 'kelkwa11', 'lmertes', 'Bache', 'ormgi', 'brunner2112', 'czahner', 'jkalbfle', 'danielac', 'kklacik', 'zarastra', 'sprashan', 'camyers', 'kim130', 'Jabzg', 'ebuysse', 'mhain', 'srettber', 'bache', 'rparisi', 'ttho', 'jgries', 'gbalmer', 'terran010', 'sbach', 'werman691', 'deetman', 'ftanjono', 'jkurasz', 'stoneagelove', 'nmisiuna', 'rkv0000', 'sundeepvem', 'lpuglisi', 'alayi', 'johns180', 'npanitch', 'skovich', 'chermawi', 'freedomjustice', 'atruesde', 'fuzzy_maraca77', 'dtruax', 'somacroy', 'mickcrowley', 'jshahid', 'gutierjm', 'han45', 'lpeterus', 'pmongkol', 'jaycrayz', 'wangyangboy', 'dmmitche', 'pbayuart', 'rachitbiyani', 'wow676', 'tmoffitt', 'nannachh', 'elric22', 'anraj', 'romanchd', 'jidthekid', 'parimal', 'dopkick', 'tdjanoko', 'jwetheri', 'rsherloc', 'swethy', 'mrmillz', 'jdickers', 'kassovic', 'jackfrost9p', 'sdidla', 'tcollopy', 'bsarlitt', 'ahartnet', 'jones105', 'kbussmann', 'nanohueb', 'sageorge', 'mtanoto', 'jgu', 'spamilton1', 'smith571', 'mdsnyder', 'lai', 'john3636', 'mrhee', 'vinsma', 'xmzhang', 'ezarowny', 'gshaw', 'dulmes', 'apuri', 'ajplaymaker', 'singapaul', 'millies', 'jsterlin', 'dgrothe', 'gzarse', 'arorar', 'mille177', 'chaines', 'dsutherl', 'bskorupa', 'Fisher', 'bsparson', 'gpajot', 'cabault', 'bsyoder', 'gjross', 'jsommer', 'dvanclev', 'mwarsco', 'dube0', 'wang209', 'zeich', 'akhilesh', 'wnoh', 'jtill04', 'MurphyAKL', 'kyangchul', 'bdannan', 'zer0xXx', 'sonicalflair', 'chang61', 'acallawa', 'longja', 'kim131', 'ajrobiso', 'bmroozia', 'gustaf89', 'bashir', 'samkothari79', 'spank_fusion', 'mharger', 'astacy', 'judoma', 'zer0xxx', 'pranaynanda', 'Zarastra', 'smchaudh', 'asudibyo']",2,"[None, 'pjyoti']",182,"['taylorcl', 'spgreene', 'jostendo', 'hsvasi', 'sstreete', 'babaumga', 'ahermann', 'griffinm', 'trs4ece', 'dhum', 'nlabianc', 'obernada', 'jskim', 'irony59', 'rtrusty', 'zconvers', 'lcowsert', 'dplamber', 'pateldm', 'nchirla', 'docdaa008', 'wehlhard', 'hiddendecoy', 'rahoward', 'ashayat', 'mtummala', 'seshaw', 'nrrojas', 'wizdh', 'csrockerzero', 'aashi', 'kelkwa11', 'lmertes', 'Bache', 'ormgi', 'brunner2112', 'czahner', 'jkalbfle', 'danielac', 'kklacik', 'dergan', 'zarastra', 'sprashan', 'camyers', 'kim130', 'Jabzg', 'ebuysse', 'mhain', 'srettber', 'bache', 'rparisi', 'ttho', 'jgries', 'gbalmer', 'terran010', 'mamitche', 'sbach', 'werman691', 'deetman', 'ftanjono', 'jkurasz', 'stoneagelove', 'nmisiuna', 'rkv0000', 'sundeepvem', 'lpuglisi', 'alayi', 'johns180', 'npanitch', 'skovich', 'chermawi', 'freedomjustice', 'atruesde', 'aforkner', 'fuzzy_maraca77', 'dtruax', 'somacroy', 'mickcrowley', 'jshahid', 'gutierjm', 'han45', 'lpeterus', 'pmongkol', 'jaycrayz', 'wangyangboy', 'dmmitche', 'pbayuart', 'rachitbiyani', 'wow676', 'tmoffitt', 'nannachh', 'elric22', 'anraj', 'romanchd', 'jidthekid', 'parimal', 'dopkick', 'tdjanoko', 'jwetheri', 'JoeBlu', 'rsherloc', 'swethy', 'mrmillz', 'jdickers', 'kassovic', 'jackfrost9p', 'sdidla', 'tcollopy', 'bsarlitt', 'ahartnet', 'jones105', 'kbussmann', 'nanohueb', 'sageorge', 'mtanoto', 'jgu', 'spamilton1', 'et279', 'kdaiya', 'smith571', 'mdsnyder', 'lai', 'john3636', 'mrhee', 'vinsma', 'xmzhang', 'ezarowny', 'gshaw', 'dulmes', 'apuri', 'ajplaymaker', 'singapaul', 'millies', 'jsterlin', 'dgrothe', 'gzarse', 'arorar', 'mille177', 'chaines', 'dsutherl', 'joeblu', 'bskorupa', 'Fisher', 'bsparson', 'gpajot', 'cabault', 'bsyoder', 'gjross', 'jsommer', 'dvanclev', 'mwarsco', 'dube0', 'wang209', 'zeich', 'akhilesh', 'wnoh', 'jtill04', 'MurphyAKL', 'kyangchul', 'bdannan', 'pjyoti', 'zer0xXx', 'sonicalflair', 'chang61', 'acallawa', 'longja', 'kim131', None, 'ajrobiso', 'bmroozia', 'gustaf89', 'bashir', 'samkothari79', 'spank_fusion', 'mharger', 'astacy', 'judoma', 'zer0xxx', 'pranaynanda', 'Zarastra', 'smchaudh', 'asudibyo']"
2,70,181,9,5,"['nmisiuna', 'rtrusty', 'johns180', 'werman691', 'nlabianc']",175,"['taylorcl', 'spgreene', 'jostendo', 'hsvasi', 'sstreete', 'babaumga', 'ahermann', 'griffinm', 'trs4ece', 'dhum', 'obernada', 'jskim', 'irony59', 'zconvers', 'lcowsert', 'dplamber', 'pateldm', 'nchirla', 'docdaa008', 'wehlhard', 'hiddendecoy', 'rahoward', 'ashayat', 'mtummala', 'seshaw', 'nrrojas', 'wizdh', 'csrockerzero', 'aashi', 'kelkwa11', 'lmertes', 'Bache', 'ormgi', 'brunner2112', 'czahner', 'jkalbfle', 'danielac', 'kklacik', 'dergan', 'zarastra', 'sprashan', 'camyers', 'kim130', 'Jabzg', 'ebuysse', 'mhain', 'srettber', 'bache', 'rparisi', 'ttho', 'jgries', 'gbalmer', 'terran010', 'mamitche', 'sbach', 'deetman', 'ftanjono', 'jkurasz', 'stoneagelove', 'rkv0000', 'sundeepvem', 'lpuglisi', 'alayi', 'npanitch', 'skovich', 'chermawi', 'freedomjustice', 'atruesde', 'aforkner', 'fuzzy_maraca77', 'dtruax', 'somacroy', 'mickcrowley', 'jshahid', 'gutierjm', 'han45', 'lpeterus', 'pmongkol', 'jaycrayz', 'wangyangboy', 'dmmitche', 'pbayuart', 'rachitbiyani', 'wow676', 'tmoffitt', 'nannachh', 'elric22', 'anraj', 'romanchd', 'jidthekid', 'parimal', 'dopkick', 'tdjanoko', 'jwetheri', 'JoeBlu', 'rsherloc', 'swethy', 'mrmillz', 'jdickers', 'kassovic', 'jackfrost9p', 'sdidla', 'tcollopy', 'bsarlitt', 'ahartnet', 'jones105', 'kbussmann', 'nanohueb', 'sageorge', 'mtanoto', 'jgu', 'spamilton1', 'et279', 'kdaiya', 'smith571', 'mdsnyder', 'lai', 'john3636', 'mrhee', 'vinsma', 'xmzhang', 'ezarowny', 'gshaw', 'dulmes', 'apuri', 'ajplaymaker', 'singapaul', 'millies', 'jsterlin', 'dgrothe', 'gzarse', 'arorar', 'mille177', 'chaines', 'dsutherl', 'joeblu', 'bskorupa', 'Fisher', 'bsparson', 'gpajot', 'cabault', 'bsyoder', 'gjross', 'jsommer', 'dvanclev', 'mwarsco', 'dube0', 'wang209', 'zeich', 'akhilesh', 'wnoh', 'jtill04', 'MurphyAKL', 'kyangchul', 'bdannan', 'zer0xXx', 'sonicalflair', 'chang61', 'acallawa', 'longja', 'kim131', 'ajrobiso', 'bmroozia', 'gustaf89', 'bashir', 'samkothari79', 'spank_fusion', 'mharger', 'astacy', 'judoma', 'zer0xxx', 'pranaynanda', 'Zarastra', 'smchaudh', 'asudibyo']",4,"['nsapra', 'ateixeir', None, 'spaik']",184,"['taylorcl', 'spgreene', 'jostendo', 'hsvasi', 'sstreete', 'babaumga', 'ahermann', 'griffinm', 'trs4ece', 'spaik', 'dhum', 'nlabianc', 'obernada', 'jskim', 'irony59', 'rtrusty', 'zconvers', 'lcowsert', 'dplamber', 'pateldm', 'nchirla', 'docdaa008', 'wehlhard', 'hiddendecoy', 'rahoward', 'ashayat', 'mtummala', 'seshaw', 'nrrojas', 'wizdh', 'csrockerzero', 'aashi', 'kelkwa11', 'lmertes', 'Bache', 'ormgi', 'brunner2112', 'czahner', 'jkalbfle', 'danielac', 'kklacik', 'dergan', 'zarastra', 'sprashan', 'camyers', 'kim130', 'Jabzg', 'ebuysse', 'mhain', 'srettber', 'bache', 'rparisi', 'ttho', 'jgries', 'gbalmer', 'terran010', 'mamitche', 'sbach', 'werman691', 'deetman', 'ftanjono', 'jkurasz', 'stoneagelove', 'nmisiuna', 'rkv0000', 'sundeepvem', 'lpuglisi', 'nsapra', 'alayi', 'johns180', 'npanitch', 'skovich', 'chermawi', 'freedomjustice', 'atruesde', 'aforkner', 'fuzzy_maraca77', 'dtruax', 'somacroy', 'mickcrowley', 'jshahid', 'gutierjm', 'han45', 'lpeterus', 'pmongkol', 'jaycrayz', 'wangyangboy', 'dmmitche', 'pbayuart', 'rachitbiyani', 'wow676', 'tmoffitt', 'nannachh', 'elric22', 'anraj', 'romanchd', 'jidthekid', 'parimal', 'dopkick', 'tdjanoko', 'jwetheri', 'JoeBlu', 'rsherloc', 'swethy', 'mrmillz', 'jdickers', 'kassovic', 'jackfrost9p', 'sdidla', 'tcollopy', 'bsarlitt', 'ahartnet', 'jones105', 'kbussmann', 'nanohueb', 'sageorge', 'mtanoto', 'jgu', 'spamilton1', 'et279', 'kdaiya', 'smith571', 'mdsnyder', 'lai', 'john3636', 'mrhee', 'vinsma', 'xmzhang', 'ezarowny', 'gshaw', 'dulmes', 'apuri', 'ajplaymaker', 'singapaul', 'millies', 'jsterlin', 'dgrothe', 'gzarse', 'arorar', 'mille177', 'chaines', 'dsutherl', 'joeblu', 'bskorupa', 'Fisher', 'bsparson', 'gpajot', 'cabault', 'bsyoder', 'gjross', 'jsommer', 'dvanclev', 'mwarsco', 'dube0', 'wang209', 'zeich', 'akhilesh', 'wnoh', 'jtill04', 'MurphyAKL', 'kyangchul', 'bdannan', 'zer0xXx', 'sonicalflair', 'chang61', 'acallawa', 'ateixeir', 'longja', 'kim131', None, 'ajrobiso', 'bmroozia', 'gustaf89', 'bashir', 'samkothari79', 'spank_fusion', 'mharger', 'astacy', 'judoma', 'zer0xxx', 'pranaynanda', 'Zarastra', 'smchaudh', 'asudibyo']"
2,64,181,8,4,"['csrockerzero', 'nanohueb', 'mtanoto', 'han45']",176,"['taylorcl', 'spgreene', 'jostendo', 'hsvasi', 'sstreete', 'babaumga', 'ahermann', 'griffinm', 'trs4ece', 'dhum', 'nlabianc', 'obernada', 'jskim', 'irony59', 'rtrusty', 'zconvers', 'lcowsert', 'dplamber', 'pateldm', 'nchirla', 'docdaa008', 'wehlhard', 'hiddendecoy', 'rahoward', 'ashayat', 'mtummala', 'seshaw', 'nrrojas', 'wizdh', 'aashi', 'kelkwa11', 'lmertes', 'Bache', 'ormgi', 'brunner2112', 'czahner', 'jkalbfle', 'danielac', 'kklacik', 'dergan', 'zarastra', 'sprashan', 'camyers', 'kim130', 'Jabzg', 'ebuysse', 'mhain', 'srettber', 'bache', 'rparisi', 'ttho', 'jgries', 'gbalmer', 'terran010', 'mamitche', 'sbach', 'werman691', 'deetman', 'ftanjono', 'jkurasz', 'stoneagelove', 'nmisiuna', 'rkv0000', 'sundeepvem', 'lpuglisi', 'alayi', 'johns180', 'npanitch', 'skovich', 'chermawi', 'freedomjustice', 'atruesde', 'aforkner', 'fuzzy_maraca77', 'dtruax', 'somacroy', 'mickcrowley', 'jshahid', 'gutierjm', 'lpeterus', 'pmongkol', 'jaycrayz', 'wangyangboy', 'dmmitche', 'pbayuart', 'rachitbiyani', 'wow676', 'tmoffitt', 'nannachh', 'elric22', 'anraj', 'romanchd', 'jidthekid', 'parimal', 'dopkick', 'tdjanoko', 'jwetheri', 'JoeBlu', 'rsherloc', 'swethy', 'mrmillz', 'jdickers', 'kassovic', 'jackfrost9p', 'sdidla', 'tcollopy', 'bsarlitt', 'ahartnet', 'jones105', 'kbussmann', 'sageorge', 'jgu', 'spamilton1', 'et279', 'kdaiya', 'smith571', 'mdsnyder', 'lai', 'john3636', 'mrhee', 'vinsma', 'xmzhang', 'ezarowny', 'gshaw', 'dulmes', 'apuri', 'ajplaymaker', 'singapaul', 'millies', 'jsterlin', 'dgrothe', 'gzarse', 'arorar', 'mille177', 'chaines', 'dsutherl', 'joeblu', 'bskorupa', 'Fisher', 'bsparson', 'gpajot', 'cabault', 'bsyoder', 'gjross', 'jsommer', 'dvanclev', 'mwarsco', 'dube0', 'wang209', 'zeich', 'akhilesh', 'wnoh', 'jtill04', 'MurphyAKL', 'kyangchul', 'bdannan', 'zer0xXx', 'sonicalflair', 'chang61', 'acallawa', 'longja', 'kim131', 'ajrobiso', 'bmroozia', 'gustaf89', 'bashir', 'samkothari79', 'spank_fusion', 'mharger', 'astacy', 'judoma', 'zer0xxx', 'pranaynanda', 'Zarastra', 'smchaudh', 'asudibyo']",4,"['singhs', 'nee_a87', 'blee292513', None]",184,"['taylorcl', 'spgreene', 'jostendo', 'hsvasi', 'sstreete', 'babaumga', 'ahermann', 'griffinm', 'trs4ece', 'dhum', 'nlabianc', 'obernada', 'jskim', 'irony59', 'rtrusty', 'zconvers', 'lcowsert', 'dplamber', 'pateldm', 'nchirla', 'docdaa008', 'wehlhard', 'hiddendecoy', 'rahoward', 'ashayat', 'mtummala', 'seshaw', 'nrrojas', 'wizdh', 'csrockerzero', 'aashi', 'kelkwa11', 'lmertes', 'Bache', 'ormgi', 'brunner2112', 'czahner', 'jkalbfle', 'danielac', 'kklacik', 'dergan', 'zarastra', 'sprashan', 'camyers', 'kim130', 'Jabzg', 'ebuysse', 'mhain', 'srettber', 'bache', 'rparisi', 'ttho', 'jgries', 'gbalmer', 'terran010', 'mamitche', 'sbach', 'werman691', 'deetman', 'ftanjono', 'jkurasz', 'stoneagelove', 'nmisiuna', 'rkv0000', 'sundeepvem', 'lpuglisi', 'alayi', 'johns180', 'npanitch', 'skovich', 'chermawi', 'freedomjustice', 'atruesde', 'aforkner', 'fuzzy_maraca77', 'dtruax', 'somacroy', 'mickcrowley', 'jshahid', 'gutierjm', 'han45', 'lpeterus', 'pmongkol', 'jaycrayz', 'wangyangboy', 'dmmitche', 'pbayuart', 'rachitbiyani', 'wow676', 'tmoffitt', 'nannachh', 'elric22', 'anraj', 'romanchd', 'jidthekid', 'parimal', 'dopkick', 'tdjanoko', 'jwetheri', 'JoeBlu', 'rsherloc', 'swethy', 'mrmillz', 'jdickers', 'kassovic', 'jackfrost9p', 'sdidla', 'tcollopy', 'bsarlitt', 'ahartnet', 'jones105', 'kbussmann', 'nanohueb', 'sageorge', 'mtanoto', 'jgu', 'spamilton1', 'et279', 'kdaiya', 'smith571', 'mdsnyder', 'singhs', 'lai', 'john3636', 'mrhee', 'vinsma', 'xmzhang', 'ezarowny', 'gshaw', 'dulmes', 'apuri', 'ajplaymaker', 'singapaul', 'millies', 'jsterlin', 'dgrothe', 'blee292513', 'gzarse', 'arorar', 'mille177', 'chaines', 'dsutherl', 'nee_a87', 'joeblu', 'bskorupa', 'Fisher', 'bsparson', 'gpajot', 'cabault', 'bsyoder', 'gjross', 'jsommer', 'dvanclev', 'mwarsco', 'dube0', 'wang209', 'zeich', 'akhilesh', 'wnoh', 'jtill04', 'MurphyAKL', 'kyangchul', 'bdannan', 'zer0xXx', 'sonicalflair', 'chang61', 'acallawa', 'longja', 'kim131', None, 'ajrobiso', 'bmroozia', 'gustaf89', 'bashir', 'samkothari79', 'spank_fusion', 'mharger', 'astacy', 'judoma', 'zer0xxx', 'pranaynanda', 'Zarastra', 'smchaudh', 'asudibyo']"
2,60,181,7,5,"['dmmitche', 'samkothari79', 'spgreene', 'dube0', 'gustaf89']",175,"['taylorcl', 'jostendo', 'hsvasi', 'sstreete', 'babaumga', 'ahermann', 'griffinm', 'trs4ece', 'dhum', 'nlabianc', 'obernada', 'jskim', 'irony59', 'rtrusty', 'zconvers', 'lcowsert', 'dplamber', 'pateldm', 'nchirla', 'docdaa008', 'wehlhard', 'hiddendecoy', 'rahoward', 'ashayat', 'mtummala', 'seshaw', 'nrrojas', 'wizdh', 'csrockerzero', 'aashi', 'kelkwa11', 'lmertes', 'Bache', 'ormgi', 'brunner2112', 'czahner', 'jkalbfle', 'danielac', 'kklacik', 'dergan', 'zarastra', 'sprashan', 'camyers', 'kim130', 'Jabzg', 'ebuysse', 'mhain', 'srettber', 'bache', 'rparisi', 'ttho', 'jgries', 'gbalmer', 'terran010', 'mamitche', 'sbach', 'werman691', 'deetman', 'ftanjono', 'jkurasz', 'stoneagelove', 'nmisiuna', 'rkv0000', 'sundeepvem', 'lpuglisi', 'alayi', 'johns180', 'npanitch', 'skovich', 'chermawi', 'freedomjustice', 'atruesde', 'aforkner', 'fuzzy_maraca77', 'dtruax', 'somacroy', 'mickcrowley', 'jshahid', 'gutierjm', 'han45', 'lpeterus', 'pmongkol', 'jaycrayz', 'wangyangboy', 'pbayuart', 'rachitbiyani', 'wow676', 'tmoffitt', 'nannachh', 'elric22', 'anraj', 'romanchd', 'jidthekid', 'parimal', 'dopkick', 'tdjanoko', 'jwetheri', 'JoeBlu', 'rsherloc', 'swethy', 'mrmillz', 'jdickers', 'kassovic', 'jackfrost9p', 'sdidla', 'tcollopy', 'bsarlitt', 'ahartnet', 'jones105', 'kbussmann', 'nanohueb', 'sageorge', 'mtanoto', 'jgu', 'spamilton1', 'et279', 'kdaiya', 'smith571', 'mdsnyder', 'lai', 'john3636', 'mrhee', 'vinsma', 'xmzhang', 'ezarowny', 'gshaw', 'dulmes', 'apuri', 'ajplaymaker', 'singapaul', 'millies', 'jsterlin', 'dgrothe', 'gzarse', 'arorar', 'mille177', 'chaines', 'dsutherl', 'joeblu', 'bskorupa', 'Fisher', 'bsparson', 'gpajot', 'cabault', 'bsyoder', 'gjross', 'jsommer', 'dvanclev', 'mwarsco', 'wang209', 'zeich', 'akhilesh', 'wnoh', 'jtill04', 'MurphyAKL', 'kyangchul', 'bdannan', 'zer0xXx', 'sonicalflair', 'chang61', 'acallawa', 'longja', 'kim131', 'ajrobiso', 'bmroozia', 'bashir', 'spank_fusion', 'mharger', 'astacy', 'judoma', 'zer0xxx', 'pranaynanda', 'Zarastra', 'smchaudh', 'asudibyo']",2,"[None, 'scyther314159']",182,"['taylorcl', 'spgreene', 'jostendo', 'hsvasi', 'sstreete', 'babaumga', 'ahermann', 'griffinm', 'trs4ece', 'dhum', 'nlabianc', 'obernada', 'jskim', 'irony59', 'rtrusty', 'zconvers', 'lcowsert', 'dplamber', 'pateldm', 'nchirla', 'docdaa008', 'wehlhard', 'hiddendecoy', 'rahoward', 'ashayat', 'mtummala', 'seshaw', 'nrrojas', 'wizdh', 'csrockerzero', 'aashi', 'kelkwa11', 'lmertes', 'Bache', 'ormgi', 'brunner2112', 'czahner', 'jkalbfle', 'danielac', 'kklacik', 'dergan', 'zarastra', 'sprashan', 'camyers', 'kim130', 'Jabzg', 'ebuysse', 'mhain', 'srettber', 'bache', 'rparisi', 'ttho', 'jgries', 'gbalmer', 'terran010', 'mamitche', 'sbach', 'werman691', 'deetman', 'ftanjono', 'jkurasz', 'stoneagelove', 'nmisiuna', 'rkv0000', 'sundeepvem', 'lpuglisi', 'alayi', 'johns180', 'npanitch', 'skovich', 'chermawi', 'freedomjustice', 'atruesde', 'aforkner', 'fuzzy_maraca77', 'dtruax', 'somacroy', 'mickcrowley', 'jshahid', 'gutierjm', 'han45', 'lpeterus', 'pmongkol', 'jaycrayz', 'wangyangboy', 'dmmitche', 'pbayuart', 'rachitbiyani', 'wow676', 'tmoffitt', 'nannachh', 'elric22', 'anraj', 'romanchd', 'jidthekid', 'parimal', 'dopkick', 'tdjanoko', 'jwetheri', 'JoeBlu', 'rsherloc', 'swethy', 'mrmillz', 'jdickers', 'kassovic', 'jackfrost9p', 'sdidla', 'tcollopy', 'bsarlitt', 'ahartnet', 'jones105', 'kbussmann', 'nanohueb', 'sageorge', 'mtanoto', 'jgu', 'spamilton1', 'et279', 'kdaiya', 'smith571', 'mdsnyder', 'lai', 'john3636', 'mrhee', 'vinsma', 'xmzhang', 'ezarowny', 'gshaw', 'dulmes', 'apuri', 'ajplaymaker', 'singapaul', 'millies', 'jsterlin', 'dgrothe', 'gzarse', 'arorar', 'mille177', 'chaines', 'dsutherl', 'joeblu', 'bskorupa', 'Fisher', 'bsparson', 'gpajot', 'cabault', 'bsyoder', 'gjross', 'jsommer', 'dvanclev', 'mwarsco', 'dube0', 'wang209', 'zeich', 'akhilesh', 'wnoh', 'scyther314159', 'jtill04', 'MurphyAKL', 'kyangchul', 'bdannan', 'zer0xXx', 'sonicalflair', 'chang61', 'acallawa', 'longja', 'kim131', None, 'ajrobiso', 'bmroozia', 'gustaf89', 'bashir', 'samkothari79', 'spank_fusion', 'mharger', 'astacy', 'judoma', 'zer0xxx', 'pranaynanda', 'Zarastra', 'smchaudh', 'asudibyo']"
2,68,181,7,6,"['MurphyAKL', 'spamilton1', 'judoma', 'alayi', 'rparisi', 'ftanjono']",174,"['taylorcl', 'spgreene', 'jostendo', 'hsvasi', 'sstreete', 'babaumga', 'ahermann', 'griffinm', 'trs4ece', 'dhum', 'nlabianc', 'obernada', 'jskim', 'irony59', 'rtrusty', 'zconvers', 'lcowsert', 'dplamber', 'pateldm', 'nchirla', 'docdaa008', 'wehlhard', 'hiddendecoy', 'rahoward', 'ashayat', 'mtummala', 'seshaw', 'nrrojas', 'wizdh', 'csrockerzero', 'aashi', 'kelkwa11', 'lmertes', 'Bache', 'ormgi', 'brunner2112', 'czahner', 'jkalbfle', 'danielac', 'kklacik', 'dergan', 'zarastra', 'sprashan', 'camyers', 'kim130', 'Jabzg', 'ebuysse', 'mhain', 'srettber', 'bache', 'ttho', 'jgries', 'gbalmer', 'terran010', 'mamitche', 'sbach', 'werman691', 'deetman', 'jkurasz', 'stoneagelove', 'nmisiuna', 'rkv0000', 'sundeepvem', 'lpuglisi', 'johns180', 'npanitch', 'skovich', 'chermawi', 'freedomjustice', 'atruesde', 'aforkner', 'fuzzy_maraca77', 'dtruax', 'somacroy', 'mickcrowley', 'jshahid', 'gutierjm', 'han45', 'lpeterus', 'pmongkol', 'jaycrayz', 'wangyangboy', 'dmmitche', 'pbayuart', 'rachitbiyani', 'wow676', 'tmoffitt', 'nannachh', 'elric22', 'anraj', 'romanchd', 'jidthekid', 'parimal', 'dopkick', 'tdjanoko', 'jwetheri', 'JoeBlu', 'rsherloc', 'swethy', 'mrmillz', 'jdickers', 'kassovic', 'jackfrost9p', 'sdidla', 'tcollopy', 'bsarlitt', 'ahartnet', 'jones105', 'kbussmann', 'nanohueb', 'sageorge', 'mtanoto', 'jgu', 'et279', 'kdaiya', 'smith571', 'mdsnyder', 'lai', 'john3636', 'mrhee', 'vinsma', 'xmzhang', 'ezarowny', 'gshaw', 'dulmes', 'apuri', 'ajplaymaker', 'singapaul', 'millies', 'jsterlin', 'dgrothe', 'gzarse', 'arorar', 'mille177', 'chaines', 'dsutherl', 'joeblu', 'bskorupa', 'Fisher', 'bsparson', 'gpajot', 'cabault', 'bsyoder', 'gjross', 'jsommer', 'dvanclev', 'mwarsco', 'dube0', 'wang209', 'zeich', 'akhilesh', 'wnoh', 'jtill04', 'kyangchul', 'bdannan', 'zer0xXx', 'sonicalflair', 'chang61', 'acallawa', 'longja', 'kim131', 'ajrobiso', 'bmroozia', 'gustaf89', 'bashir', 'samkothari79', 'spank_fusion', 'mharger', 'astacy', 'zer0xxx', 'pranaynanda', 'Zarastra', 'smchaudh', 'asudibyo']",1,[None],181,"['taylorcl', 'spgreene', 'jostendo', 'hsvasi', 'sstreete', 'babaumga', 'ahermann', 'griffinm', 'trs4ece', 'dhum', 'nlabianc', 'obernada', 'jskim', 'irony59', 'rtrusty', 'zconvers', 'lcowsert', 'dplamber', 'pateldm', 'nchirla', 'docdaa008', 'wehlhard', 'hiddendecoy', 'rahoward', 'ashayat', 'mtummala', 'seshaw', 'nrrojas', 'wizdh', 'csrockerzero', 'aashi', 'kelkwa11', 'lmertes', 'Bache', 'ormgi', 'brunner2112', 'czahner', 'jkalbfle', 'danielac', 'kklacik', 'dergan', 'zarastra', 'sprashan', 'camyers', 'kim130', 'Jabzg', 'ebuysse', 'mhain', 'srettber', 'bache', 'rparisi', 'ttho', 'jgries', 'gbalmer', 'terran010', 'mamitche', 'sbach', 'werman691', 'deetman', 'ftanjono', 'jkurasz', 'stoneagelove', 'nmisiuna', 'rkv0000', 'sundeepvem', 'lpuglisi', 'alayi', 'johns180', 'npanitch', 'skovich', 'chermawi', 'freedomjustice', 'atruesde', 'aforkner', 'fuzzy_maraca77', 'dtruax', 'somacroy', 'mickcrowley', 'jshahid', 'gutierjm', 'han45', 'lpeterus', 'pmongkol', 'jaycrayz', 'wangyangboy', 'dmmitche', 'pbayuart', 'rachitbiyani', 'wow676', 'tmoffitt', 'nannachh', 'elric22', 'anraj', 'romanchd', 'jidthekid', 'parimal', 'dopkick', 'tdjanoko', 'jwetheri', 'JoeBlu', 'rsherloc', 'swethy', 'mrmillz', 'jdickers', 'kassovic', 'jackfrost9p', 'sdidla', 'tcollopy', 'bsarlitt', 'ahartnet', 'jones105', 'kbussmann', 'nanohueb', 'sageorge', 'mtanoto', 'jgu', 'spamilton1', 'et279', 'kdaiya', 'smith571', 'mdsnyder', 'lai', 'john3636', 'mrhee', 'vinsma', 'xmzhang', 'ezarowny', 'gshaw', 'dulmes', 'apuri', 'ajplaymaker', 'singapaul', 'millies', 'jsterlin', 'dgrothe', 'gzarse', 'arorar', 'mille177', 'chaines', 'dsutherl', 'joeblu', 'bskorupa', 'Fisher', 'bsparson', 'gpajot', 'cabault', 'bsyoder', 'gjross', 'jsommer', 'dvanclev', 'mwarsco', 'dube0', 'wang209', 'zeich', 'akhilesh', 'wnoh', 'jtill04', 'MurphyAKL', 'kyangchul', 'bdannan', 'zer0xXx', 'sonicalflair', 'chang61', 'acallawa', 'longja', 'kim131', None, 'ajrobiso', 'bmroozia', 'gustaf89', 'bashir', 'samkothari79', 'spank_fusion', 'mharger', 'astacy', 'judoma', 'zer0xxx', 'pranaynanda', 'Zarastra', 'smchaudh', 'asudibyo']"
2,73,181,7,5,"['wizdh', 'csrockerzero', 'nanohueb', 'pmongkol', 'mtanoto']",175,"['taylorcl', 'spgreene', 'jostendo', 'hsvasi', 'sstreete', 'babaumga', 'ahermann', 'griffinm', 'trs4ece', 'dhum', 'nlabianc', 'obernada', 'jskim', 'irony59', 'rtrusty', 'zconvers', 'lcowsert', 'dplamber', 'pateldm', 'nchirla', 'docdaa008', 'wehlhard', 'hiddendecoy', 'rahoward', 'ashayat', 'mtummala', 'seshaw', 'nrrojas', 'aashi', 'kelkwa11', 'lmertes', 'Bache', 'ormgi', 'brunner2112', 'czahner', 'jkalbfle', 'danielac', 'kklacik', 'dergan', 'zarastra', 'sprashan', 'camyers', 'kim130', 'Jabzg', 'ebuysse', 'mhain', 'srettber', 'bache', 'rparisi', 'ttho', 'jgries', 'gbalmer', 'terran010', 'mamitche', 'sbach', 'werman691', 'deetman', 'ftanjono', 'jkurasz', 'stoneagelove', 'nmisiuna', 'rkv0000', 'sundeepvem', 'lpuglisi', 'alayi', 'johns180', 'npanitch', 'skovich', 'chermawi', 'freedomjustice', 'atruesde', 'aforkner', 'fuzzy_maraca77', 'dtruax', 'somacroy', 'mickcrowley', 'jshahid', 'gutierjm', 'han45', 'lpeterus', 'jaycrayz', 'wangyangboy', 'dmmitche', 'pbayuart', 'rachitbiyani', 'wow676', 'tmoffitt', 'nannachh', 'elric22', 'anraj', 'romanchd', 'jidthekid', 'parimal', 'dopkick', 'tdjanoko', 'jwetheri', 'JoeBlu', 'rsherloc', 'swethy', 'mrmillz', 'jdickers', 'kassovic', 'jackfrost9p', 'sdidla', 'tcollopy', 'bsarlitt', 'ahartnet', 'jones105', 'kbussmann', 'sageorge', 'jgu', 'spamilton1', 'et279', 'kdaiya', 'smith571', 'mdsnyder', 'lai', 'john3636', 'mrhee', 'vinsma', 'xmzhang', 'ezarowny', 'gshaw', 'dulmes', 'apuri', 'ajplaymaker', 'singapaul', 'millies', 'jsterlin', 'dgrothe', 'gzarse', 'arorar', 'mille177', 'chaines', 'dsutherl', 'joeblu', 'bskorupa', 'Fisher', 'bsparson', 'gpajot', 'cabault', 'bsyoder', 'gjross', 'jsommer', 'dvanclev', 'mwarsco', 'dube0', 'wang209', 'zeich', 'akhilesh', 'wnoh', 'jtill04', 'MurphyAKL', 'kyangchul', 'bdannan', 'zer0xXx', 'sonicalflair', 'chang61', 'acallawa', 'longja', 'kim131', 'ajrobiso', 'bmroozia', 'gustaf89', 'bashir', 'samkothari79', 'spank_fusion', 'mharger', 'astacy', 'judoma', 'zer0xxx', 'pranaynanda', 'Zarastra', 'smchaudh', 'asudibyo']",2,"[None, 'davydotcom']",182,"['taylorcl', 'spgreene', 'jostendo', 'hsvasi', 'sstreete', 'babaumga', 'ahermann', 'griffinm', 'trs4ece', 'dhum', 'nlabianc', 'obernada', 'jskim', 'irony59', 'rtrusty', 'zconvers', 'lcowsert', 'dplamber', 'pateldm', 'nchirla', 'docdaa008', 'wehlhard', 'hiddendecoy', 'rahoward', 'ashayat', 'mtummala', 'seshaw', 'nrrojas', 'wizdh', 'csrockerzero', 'aashi', 'kelkwa11', 'lmertes', 'Bache', 'ormgi', 'brunner2112', 'czahner', 'jkalbfle', 'danielac', 'kklacik', 'dergan', 'zarastra', 'sprashan', 'camyers', 'kim130', 'Jabzg', 'ebuysse', 'mhain', 'srettber', 'bache', 'rparisi', 'ttho', 'jgries', 'gbalmer', 'terran010', 'mamitche', 'sbach', 'werman691', 'deetman', 'ftanjono', 'jkurasz', 'stoneagelove', 'nmisiuna', 'rkv0000', 'sundeepvem', 'lpuglisi', 'alayi', 'johns180', 'npanitch', 'skovich', 'chermawi', 'freedomjustice', 'atruesde', 'aforkner', 'fuzzy_maraca77', 'dtruax', 'somacroy', 'mickcrowley', 'jshahid', 'gutierjm', 'han45', 'lpeterus', 'pmongkol', 'jaycrayz', 'wangyangboy', 'dmmitche', 'pbayuart', 'rachitbiyani', 'wow676', 'tmoffitt', 'nannachh', 'elric22', 'anraj', 'romanchd', 'jidthekid', 'parimal', 'dopkick', 'tdjanoko', 'jwetheri', 'JoeBlu', 'rsherloc', 'swethy', 'mrmillz', 'jdickers', 'kassovic', 'jackfrost9p', 'sdidla', 'tcollopy', 'bsarlitt', 'ahartnet', 'jones105', 'kbussmann', 'nanohueb', 'sageorge', 'mtanoto', 'jgu', 'spamilton1', 'et279', 'kdaiya', 'smith571', 'mdsnyder', 'lai', 'john3636', 'davydotcom', 'mrhee', 'vinsma', 'xmzhang', 'ezarowny', 'gshaw', 'dulmes', 'apuri', 'ajplaymaker', 'singapaul', 'millies', 'jsterlin', 'dgrothe', 'gzarse', 'arorar', 'mille177', 'chaines', 'dsutherl', 'joeblu', 'bskorupa', 'Fisher', 'bsparson', 'gpajot', 'cabault', 'bsyoder', 'gjross', 'jsommer', 'dvanclev', 'mwarsco', 'dube0', 'wang209', 'zeich', 'akhilesh', 'wnoh', 'jtill04', 'MurphyAKL', 'kyangchul', 'bdannan', 'zer0xXx', 'sonicalflair', 'chang61', 'acallawa', 'longja', 'kim131', None, 'ajrobiso', 'bmroozia', 'gustaf89', 'bashir', 'samkothari79', 'spank_fusion', 'mharger', 'astacy', 'judoma', 'zer0xxx', 'pranaynanda', 'Zarastra', 'smchaudh', 'asudibyo']"
3,23,41,28,26,"['battmanz', 'madmax', 'bendmart', 'lexe', 'meghannsmit', 'dmauchley', 'jrwells', 'lsross5', 'SlackerZero', 'ijhuggins', 'dstle', 'kigen', 'bclayton2003', 'tmleynek', 'empire3k', 'natemccaughey', 'kurt_retzloff', 'ellingsito', 'rusteng', 'catcall', 'ilya1987', 'extrasmoodious', 'xiaoguo', 'ochukhrai', 'efillerup', 'wbmckean']",14,"['sickchick', 'jmwilso1', 'u0244603', 'dkbags', 'williamcarlquist', 'sonchu', 'nparker', 'chunderbutt', 'u0356611', 'sandros1', 'BenDMart', 'sharna', 'blacksun7x', 'jeweed']",2,"['l84119', None]",42,"['battmanz', 'madmax', 'bendmart', 'u0356611', 'lexe', 'meghannsmit', 'sharna', 'dmauchley', 'jrwells', 'lsross5', 'jeweed', 'u0244603', 'dkbags', 'williamcarlquist', 'SlackerZero', 'ijhuggins', 'chunderbutt', 'dstle', 'l84119', 'kigen', 'bclayton2003', 'BenDMart', 'tmleynek', 'blacksun7x', 'sickchick', 'empire3k', 'sonchu', 'nparker', 'natemccaughey', 'kurt_retzloff', 'ellingsito', 'rusteng', None, 'catcall', 'jmwilso1', 'ilya1987', 'extrasmoodious', 'xiaoguo', 'ochukhrai', 'sandros1', 'efillerup', 'wbmckean']"
3,22,41,7,1,['catcall'],39,"['battmanz', 'madmax', 'bendmart', 'u0356611', 'lexe', 'meghannsmit', 'sharna', 'dmauchley', 'jrwells', 'lsross5', 'jeweed', 'u0244603', 'dkbags', 'williamcarlquist', 'SlackerZero', 'ijhuggins', 'chunderbutt', 'dstle', 'kigen', 'bclayton2003', 'BenDMart', 'tmleynek', 'blacksun7x', 'sickchick', 'empire3k', 'sonchu', 'nparker', 'natemccaughey', 'kurt_retzloff', 'ellingsito', 'rusteng', 'jmwilso1', 'ilya1987', 'extrasmoodious', 'xiaoguo', 'ochukhrai', 'sandros1', 'efillerup', 'wbmckean']",6,"['retzloff', 'harald84', 'ben19q', 'l84119', 'jshumaker', None]",46,"['battmanz', 'harald84', 'madmax', 'bendmart', 'u0356611', 'lexe', 'meghannsmit', 'sharna', 'dmauchley', 'jrwells', 'lsross5', 'jeweed', 'retzloff', 'u0244603', 'dkbags', 'williamcarlquist', 'SlackerZero', 'ijhuggins', 'chunderbutt', 'dstle', 'l84119', 'kigen', 'bclayton2003', 'BenDMart', 'tmleynek', 'blacksun7x', 'sickchick', 'empire3k', 'ben19q', 'sonchu', 'nparker', 'natemccaughey', 'kurt_retzloff', 'jshumaker', 'ellingsito', 'rusteng', None, 'catcall', 'jmwilso1', 'ilya1987', 'extrasmoodious', 'xiaoguo', 'ochukhrai', 'sandros1', 'efillerup', 'wbmckean']"
3,24,41,7,6,"['dkbags', 'williamcarlquist', 'nparker', 'chunderbutt', 'blacksun7x', 'jeweed']",34,"['battmanz', 'madmax', 'bendmart', 'u0356611', 'lexe', 'meghannsmit', 'sharna', 'dmauchley', 'jrwells', 'lsross5', 'u0244603', 'SlackerZero', 'ijhuggins', 'dstle', 'kigen', 'bclayton2003', 'BenDMart', 'tmleynek', 'sickchick', 'empire3k', 'sonchu', 'natemccaughey', 'kurt_retzloff', 'ellingsito', 'rusteng', 'catcall', 'jmwilso1', 'ilya1987', 'extrasmoodious', 'xiaoguo', 'ochukhrai', 'sandros1', 'efillerup', 'wbmckean']",1,[None],41,"['battmanz', 'madmax', 'bendmart', 'u0356611', 'lexe', 'meghannsmit', 'sharna', 'dmauchley', 'jrwells', 'lsross5', 'jeweed', 'u0244603', 'dkbags', 'williamcarlquist', 'SlackerZero', 'ijhuggins', 'chunderbutt', 'dstle', 'kigen', 'bclayton2003', 'BenDMart', 'tmleynek', 'blacksun7x', 'sickchick', 'empire3k', 'sonchu', 'nparker', 'natemccaughey', 'kurt_retzloff', 'ellingsito', 'rusteng', None, 'catcall', 'jmwilso1', 'ilya1987', 'extrasmoodious', 'xiaoguo', 'ochukhrai', 'sandros1', 'efillerup', 'wbmckean']"
4,39,38,49,35,"['northlild85', 'thuynh86', 'epd800', 'crip1163', 'Nutmeg0440', 'shehanfernando', 'NutMeg0440', 'blkhawk005', 'jojonelli', 'tvc310', 'pootietang', 'kohnes86', 'nulongsnapper86', 'grm154', 'danfullin', 'nahmadi', 'allisonchoing', 'ecarter', 'jspark', 'present2010', 'thatkidandy', 'albertlui', 'kjv526', 'nutmeg0440', 'chrismeetsparis', 'tgillard', 'dwillnu', 'rizalph', 'jsp255', 'kevinl85', 'vac781', 'methompson86', 'downin24', 'sianmei', 'AllisonChoing']",2,"['sarnold935', 'zzhu']",14,"['achin', 'schatz', 'Downin24', 'weichiwong', 'spilewski', 'jrw580', 'ndk510', 'tejerina', 'mmapodaca', 'srv901', 'cmaikens', 'kwoodward', None, 'ausmanlk']",51,"['thuynh86', 'epd800', 'Downin24', 'shehanfernando', 'ndk510', 'blkhawk005', 'pootietang', 'kohnes86', 'achin', 'schatz', 'nahmadi', 'present2010', 'thatkidandy', 'sarnold935', 'tgillard', 'rizalph', 'vac781', 'downin24', 'sianmei', 'cmaikens', 'ausmanlk', 'northlild85', 'crip1163', 'Nutmeg0440', 'weichiwong', 'NutMeg0440', 'jojonelli', 'tvc310', 'srv901', 'kwoodward', 'nulongsnapper86', 'grm154', 'danfullin', 'allisonchoing', 'ecarter', 'jspark', 'tejerina', 'albertlui', 'zzhu', 'kjv526', 'nutmeg0440', 'chrismeetsparis', 'spilewski', 'dwillnu', 'jsp255', 'kevinl85', 'methompson86', None, 'jrw580', 'mmapodaca', 'AllisonChoing']"
5,16,32,31,26,"['sbook', 'hjaganat', 'mkittle', 'lachlanbadger', 'jptucker', 'tmlowe', 'abartow', 'sollila', 'sfairfie', 'jbernhar', 'boersenn', 'smithmc', 'bturk', 'prrussel', 'mbosley', 'awibawa', 'mjwaters', 'amalling', 'rflynn', 'skyaw', 'ehalsey', 'banglin', 'andrewotte', 'ebarriba', 'klfrank', 'abreisin']",5,"['mbelcher', 'attn007', 'lee297', 'psajor', 'Ainshi']",5,"['tis0lamp', 'mtmannin', None, 'dcorbitt', 'strachan']",36,"['sbook', 'hjaganat', 'mkittle', 'mbelcher', 'lachlanbadger', 'jptucker', 'tmlowe', 'abartow', 'attn007', 'sollila', 'psajor', 'sfairfie', 'jbernhar', 'boersenn', 'mtmannin', 'tis0lamp', 'prrussel', 'bturk', 'smithmc', 'mbosley', 'awibawa', 'mjwaters', 'amalling', 'rflynn', 'skyaw', None, 'dcorbitt', 'strachan', 'banglin', 'ehalsey', 'lee297', 'andrewotte', 'ebarriba', 'Ainshi', 'klfrank', 'abreisin']"
5,12,32,25,21,"['sbook', 'lachlanbadger', 'tmlowe', 'abartow', 'sfairfie', 'jbernhar', 'boersenn', 'smithmc', 'bturk', 'prrussel', 'mbosley', 'awibawa', 'mjwaters', 'skyaw', 'ehalsey', 'banglin', 'andrewotte', 'ebarriba', 'Ainshi', 'klfrank', 'abreisin']",10,"['hjaganat', 'mbelcher', 'mkittle', 'attn007', 'lee297', 'jptucker', 'sollila', 'psajor', 'amalling', 'rflynn']",4,"['strachan', None, 'tisolamp', 'jrcalver']",35,"['sbook', 'hjaganat', 'mkittle', 'mbelcher', 'lachlanbadger', 'jptucker', 'tmlowe', 'abartow', 'attn007', 'sollila', 'psajor', 'sfairfie', 'jbernhar', 'tisolamp', 'boersenn', 'prrussel', 'bturk', 'smithmc', 'mbosley', 'awibawa', 'mjwaters', 'amalling', 'rflynn', 'skyaw', None, 'strachan', 'banglin', 'ehalsey', 'lee297', 'andrewotte', 'ebarriba', 'Ainshi', 'klfrank', 'abreisin', 'jrcalver']"
5,13,32,10,7,"['mkittle', 'attn007', 'sollila', 'Ainshi', 'mjwaters', 'amalling', 'abreisin']",24,"['sbook', 'hjaganat', 'mbelcher', 'lachlanbadger', 'jptucker', 'tmlowe', 'abartow', 'psajor', 'sfairfie', 'jbernhar', 'boersenn', 'prrussel', 'bturk', 'smithmc', 'mbosley', 'awibawa', 'rflynn', 'skyaw', 'banglin', 'ehalsey', 'lee297', 'andrewotte', 'ebarriba', 'klfrank']",3,"['vskhadka', None, 'yanyao']",34,"['sbook', 'hjaganat', 'mkittle', 'mbelcher', 'lachlanbadger', 'jptucker', 'tmlowe', 'abartow', 'attn007', 'sollila', 'psajor', 'vskhadka', 'sfairfie', 'jbernhar', 'boersenn', 'prrussel', 'bturk', 'smithmc', 'mbosley', 'awibawa', 'mjwaters', 'amalling', 'rflynn', 'skyaw', None, 'banglin', 'ehalsey', 'lee297', 'andrewotte', 'ebarriba', 'Ainshi', 'klfrank', 'yanyao', 'abreisin']"
5,14,32,7,5,"['bturk', 'mbelcher', 'awibawa', 'jptucker', 'rflynn']",26,"['sbook', 'hjaganat', 'mkittle', 'lachlanbadger', 'tmlowe', 'abartow', 'attn007', 'sollila', 'psajor', 'sfairfie', 'jbernhar', 'boersenn', 'prrussel', 'smithmc', 'mbosley', 'mjwaters', 'amalling', 'skyaw', 'banglin', 'ehalsey', 'lee297', 'andrewotte', 'ebarriba', 'Ainshi', 'klfrank', 'abreisin']",2,"['awinston', None]",33,"['sbook', 'hjaganat', 'mkittle', 'mbelcher', 'lachlanbadger', 'jptucker', 'awinston', 'tmlowe', 'abartow', 'attn007', 'sollila', 'psajor', 'sfairfie', 'jbernhar', 'boersenn', 'prrussel', 'bturk', 'smithmc', 'mbosley', 'awibawa', 'mjwaters', 'amalling', 'rflynn', 'skyaw', None, 'banglin', 'ehalsey', 'lee297', 'andrewotte', 'ebarriba', 'Ainshi', 'klfrank', 'abreisin']"
6,29,30,35,4,"['kuzdaso', 'xzimek01', 'majlow', 'ZdenekNo']",25,"['bupolin77', 'shorif', 'nugraha', 'grock', 'zenock', 'kaz830', 'bajones', 'junezhu', 'sbc4897', 'Zenock', 'fsheng', 'zhudongchun', 'rno310', 'cbburger', 'john1248', 'cinedemian', 'newmin', 'kim70', 'LINCSTAR182', 'jegonzal', 'masud001', 'boki', 'jhenrie', 'ssalamat', 'jasonpeterson']",31,"['xnavra28', 'xhakto00', 'hugotek', 'susen', 'ufyzguest', 'xkubin08', 'lumpikur', 'majlos', 'xbartu', 'berzby', 'benda', 'Dallda', 'Havlicek', 'loutocky', 'xlazni05', 'jirkami', 'czkiller', 'xjanos07', 'cendar', 'reznicekm', 'xhrube00', 'jiri_novosad', 'xjaros24', None, 'mikkiste', 'xbetla00', 'lordraia', 'sedlakp', 'xsedam00', 'poloop', 'xkroli00']",60,"['xnavra28', 'susen', 'nugraha', 'ufyzguest', 'zenock', 'bajones', 'lumpikur', 'Zenock', 'fsheng', 'majlow', 'majlos', 'berzby', 'benda', 'john1248', 'Havlicek', 'loutocky', 'cinedemian', 'czkiller', 'xjanos07', 'cendar', 'jiri_novosad', 'LINCSTAR182', 'jegonzal', 'xjaros24', 'xzimek01', 'boki', 'jasonpeterson', 'sedlakp', 'xsedam00', 'poloop', 'xkroli00', 'bupolin77', 'shorif', 'xhakto00', 'hugotek', 'xkubin08', 'grock', 'kaz830', 'junezhu', 'sbc4897', 'ZdenekNo', 'zhudongchun', 'rno310', 'xbartu', 'cbburger', 'Dallda', 'xlazni05', 'jirkami', 'newmin', 'reznicekm', 'xhrube00', 'kuzdaso', 'kim70', 'masud001', None, 'jhenrie', 'mikkiste', 'ssalamat', 'xbetla00', 'lordraia']"
6,30,30,18,11,"['zhudongchun', 'bupolin77', 'newmin', 'shorif', 'ssalamat', 'kim70', 'cbburger', 'masud001', 'junezhu', 'jhenrie', 'cinedemian']",18,"['fsheng', 'majlow', 'rno310', 'nugraha', 'kuzdaso', 'jasonpeterson', 'ZdenekNo', 'grock', 'zenock', 'LINCSTAR182', 'jegonzal', 'john1248', 'kaz830', 'bajones', 'xzimek01', 'boki', 'sbc4897', 'Zenock']",7,"['gkarakon', 'pgururaj', 'zainu', 'vidnari', 'tjandran', None, 'turkstra']",36,"['bupolin77', 'shorif', 'gkarakon', 'nugraha', 'grock', 'zenock', 'kaz830', 'bajones', 'junezhu', 'sbc4897', 'Zenock', 'ZdenekNo', 'fsheng', 'zhudongchun', 'majlow', 'rno310', 'cbburger', 'vidnari', 'john1248', 'tjandran', 'cinedemian', 'turkstra', 'newmin', 'kuzdaso', 'pgururaj', 'kim70', 'LINCSTAR182', 'jegonzal', 'masud001', 'xzimek01', 'boki', 'jhenrie', None, 'ssalamat', 'jasonpeterson', 'zainu']"
6,28,30,17,1,['grock'],28,"['bupolin77', 'shorif', 'nugraha', 'zenock', 'kaz830', 'bajones', 'junezhu', 'sbc4897', 'ZdenekNo', 'Zenock', 'fsheng', 'zhudongchun', 'majlow', 'rno310', 'cbburger', 'john1248', 'cinedemian', 'newmin', 'kuzdaso', 'kim70', 'LINCSTAR182', 'jegonzal', 'masud001', 'xzimek01', 'boki', 'jhenrie', 'ssalamat', 'jasonpeterson']",16,"['aaronwozniak', 'jvalmanza', 'sahar', 'stewartsoda', 'lincstar182', 'justinbutterfield', 'dency_daniel', 'otrejo', 'DarrinReed', 'ssessi', 'kriscampbell', 'victorkelley', 'hbui', 'davidknight', None, 'chrisraymes']",45,"['jvalmanza', 'bupolin77', 'shorif', 'DarrinReed', 'nugraha', 'grock', 'zenock', 'kaz830', 'bajones', 'junezhu', 'sbc4897', 'Zenock', 'ZdenekNo', 'fsheng', 'zhudongchun', 'majlow', 'stewartsoda', 'rno310', 'lincstar182', 'dency_daniel', 'ssessi', 'cbburger', 'john1248', 'cinedemian', 'newmin', 'justinbutterfield', 'kuzdaso', 'kim70', 'victorkelley', 'LINCSTAR182', 'jegonzal', 'kriscampbell', 'masud001', 'xzimek01', 'boki', 'jhenrie', None, 'aaronwozniak', 'sahar', 'ssalamat', 'otrejo', 'jasonpeterson', 'hbui', 'davidknight', 'chrisraymes']"
7,62,24,124,15,"['aozero', 'stucky', 'nee_a87', 'jenkinsalexp', 'babauman', 'jcromer', 'aashi21', 'priyamtrivedi', 'gsinghal', 'axavier', 'nutomo', 'fisher', 'SonicalFlair', 'plaird', 'jcleong']",8,"['adarmans', 'adamskelton', 'singhs', 'blee292513', 'acgautam', 'mjbarger', 'skalafut', 'misko9']",109,"['jwetheri', 'spgreene', 'jostendo', 'hsvasi', 'sstreete', 'rsherloc', 'ahermann', 'swethy', 'sumeetkumargupta', 'griffinm', 'mrmillz', 'nlabianc', 'tcollopy', 'obernada', 'jskim', 'irony59', 'rtrusty', 'jones105', 'zconvers', 'lcowsert', 'dplamber', 'pateldm', 'jcwirth', 'nchirla', 'docdaa008', 'sageorge', 'hiddendecoy', 'mtanoto', 'rahoward', 'mtummala', 'seshaw', 'jgu', 'nrrojas', 'spamilton1', 'wizdh', 'kdaiya', 'csrockerzero', 'wildkid256', 'kelkwa11', 'john3636', 'brunner2112', 'mattsbai', 'mrhee', 'vinsma', 'czahner', 'kklacik', 'dergan', 'dulmes', 'kim130', 'Jabzg', 'mhain', 'singapaul', 'rparisi', 'dmsnell', 'dgrothe', 'gzarse', 'arorar', 'chaines', 'terran010', 'mamitche', 'dsutherl', 'joeblu', 'sbach', 'werman691', 'Fisher', 'ftanjono', 'jkurasz', 'bsparson', 'bsyoder', 'nmisiuna', 'ongt', 'lpuglisi', 'dube0', 'mwarsco', 'johns180', 'npanitch', 'zeich', 'chermawi', 'akhilesh', 'atruesde', 'fuzzy_maraca77', 'pjyoti', 'somacroy', 'bdannan', 'gutierjm', 'sonicalflair', 'chang61', 'acallawa', 'han45', 'longja', 'kim131', 'pmongkol', 'garg', 'jaycrayz', 'wangyangboy', 'dmmitche', None, 'gustaf89', 'pbayuart', 'wow676', 'astacy', 'tmoffitt', 'judoma', 'zer0xxx', 'pranaynanda', 'Zarastra', 'asudibyo', 'jidthekid', 'tdjanoko']",132,"['adamskelton', 'spgreene', 'jostendo', 'hsvasi', 'sstreete', 'ahermann', 'jcromer', 'sumeetkumargupta', 'griffinm', 'nlabianc', 'obernada', 'jskim', 'irony59', 'rtrusty', 'zconvers', 'lcowsert', 'dplamber', 'pateldm', 'jcwirth', 'nchirla', 'docdaa008', 'hiddendecoy', 'rahoward', 'mtummala', 'seshaw', 'nrrojas', 'wizdh', 'csrockerzero', 'kelkwa11', 'brunner2112', 'czahner', 'kklacik', 'axavier', 'dergan', 'kim130', 'Jabzg', 'mhain', 'acgautam', 'rparisi', 'dmsnell', 'terran010', 'mamitche', 'sbach', 'werman691', 'ftanjono', 'jkurasz', 'jcleong', 'nmisiuna', 'ongt', 'lpuglisi', 'johns180', 'npanitch', 'chermawi', 'atruesde', 'fuzzy_maraca77', 'somacroy', 'gutierjm', 'han45', 'pmongkol', 'garg', 'jaycrayz', 'wangyangboy', 'dmmitche', 'pbayuart', 'aozero', 'wow676', 'tmoffitt', 'gsinghal', 'fisher', 'jidthekid', 'tdjanoko', 'jwetheri', 'stucky', 'rsherloc', 'babauman', 'swethy', 'mrmillz', 'skalafut', 'tcollopy', 'jones105', 'jenkinsalexp', 'sageorge', 'plaird', 'mtanoto', 'jgu', 'spamilton1', 'kdaiya', 'singhs', 'wildkid256', 'priyamtrivedi', 'john3636', 'mattsbai', 'mrhee', 'vinsma', 'adarmans', 'dulmes', 'singapaul', 'dgrothe', 'blee292513', 'gzarse', 'arorar', 'chaines', 'nee_a87', 'dsutherl', 'joeblu', 'Fisher', 'SonicalFlair', 'bsparson', 'bsyoder', 'dube0', 'mwarsco', 'zeich', 'akhilesh', 'mjbarger', 'pjyoti', 'bdannan', 'sonicalflair', 'chang61', 'aashi21', 'acallawa', 'longja', 'kim131', None, 'gustaf89', 'misko9', 'astacy', 'judoma', 'zer0xxx', 'pranaynanda', 'nutomo', 'Zarastra', 'asudibyo']"
7,67,24,69,1,['gsinghal'],22,"['adamskelton', 'stucky', 'nee_a87', 'babauman', 'jcromer', 'SonicalFlair', 'skalafut', 'jcleong', 'jenkinsalexp', 'mjbarger', 'plaird', 'singhs', 'aashi21', 'priyamtrivedi', 'axavier', 'misko9', 'adarmans', 'aozero', 'nutomo', 'acgautam', 'fisher', 'blee292513']",68,"['jwetheri', 'arorar', 'gbalmer', 'jostendo', 'hsvasi', 'sstreete', 'babaumga', 'rsherloc', 'terran010', 'swethy', 'werman691', 'Fisher', 'mrmillz', 'ftanjono', 'nlabianc', 'kassovic', 'tcollopy', 'obernada', 'jskim', 'irony59', 'rtrusty', 'dvanclev', 'lpuglisi', 'dube0', 'johns180', 'dplamber', 'jcwirth', 'akhilesh', 'nchirla', 'docdaa008', 'chermawi', 'atruesde', 'aforkner', 'gzarse', 'rahoward', 'jgu', 'jtill04', 'nrrojas', 'spamilton1', 'kdaiya', 'et279', 'bdannan', 'gutierjm', 'sonicalflair', 'zer0xXx', 'kelkwa11', 'acallawa', 'brunner2112', 'mattsbai', 'lpeterus', 'kklacik', 'pmongkol', 'dergan', None, 'gshaw', 'dulmes', 'sprashan', 'gustaf89', 'jaycrayz', 'wangyangboy', 'Jabzg', 'pbayuart', 'wow676', 'astacy', 'pranaynanda', 'jsterlin', 'dmsnell', 'tdjanoko']",91,"['jwetheri', 'adamskelton', 'jostendo', 'stucky', 'hsvasi', 'sstreete', 'babaumga', 'rsherloc', 'babauman', 'jcromer', 'swethy', 'mrmillz', 'kassovic', 'skalafut', 'nlabianc', 'tcollopy', 'obernada', 'jskim', 'irony59', 'rtrusty', 'jenkinsalexp', 'dplamber', 'jcwirth', 'nchirla', 'docdaa008', 'plaird', 'rahoward', 'jgu', 'nrrojas', 'spamilton1', 'kdaiya', 'et279', 'singhs', 'kelkwa11', 'priyamtrivedi', 'brunner2112', 'mattsbai', 'kklacik', 'axavier', 'dergan', 'gshaw', 'adarmans', 'dulmes', 'sprashan', 'Jabzg', 'acgautam', 'jsterlin', 'dmsnell', 'blee292513', 'gzarse', 'arorar', 'gbalmer', 'terran010', 'nee_a87', 'werman691', 'Fisher', 'SonicalFlair', 'ftanjono', 'jcleong', 'dvanclev', 'lpuglisi', 'dube0', 'johns180', 'akhilesh', 'chermawi', 'atruesde', 'mjbarger', 'aforkner', 'jtill04', 'bdannan', 'gutierjm', 'sonicalflair', 'zer0xXx', 'aashi21', 'acallawa', 'lpeterus', 'pmongkol', None, 'gustaf89', 'misko9', 'jaycrayz', 'wangyangboy', 'pbayuart', 'aozero', 'wow676', 'astacy', 'gsinghal', 'pranaynanda', 'nutomo', 'fisher', 'tdjanoko']"
7,66,24,14,1,['acgautam'],22,"['adamskelton', 'stucky', 'nee_a87', 'babauman', 'jcromer', 'SonicalFlair', 'skalafut', 'jcleong', 'jenkinsalexp', 'mjbarger', 'plaird', 'singhs', 'aashi21', 'priyamtrivedi', 'axavier', 'misko9', 'adarmans', 'aozero', 'gsinghal', 'nutomo', 'fisher', 'blee292513']",13,"['camyers', 'MurphyAKL', 'spamilton1', 'gbalmer', 'jsommer', 'somacroy', 'ebuysse', 'sageorge', 'bsparson', 'ftanjono', 'romanchd', None, 'ajrobiso']",36,"['MurphyAKL', 'adamskelton', 'spamilton1', 'gbalmer', 'singhs', 'stucky', 'blee292513', 'nee_a87', 'somacroy', 'babauman', 'jcromer', 'aashi21', 'priyamtrivedi', 'SonicalFlair', 'ftanjono', 'bsparson', 'skalafut', 'jcleong', 'axavier', 'misko9', 'adarmans', 'camyers', None, 'ajrobiso', 'jsommer', 'aozero', 'ebuysse', 'jenkinsalexp', 'gsinghal', 'nutomo', 'acgautam', 'fisher', 'sageorge', 'mjbarger', 'romanchd', 'plaird']"
7,63,24,13,1,['adarmans'],22,"['adamskelton', 'stucky', 'nee_a87', 'babauman', 'jcromer', 'SonicalFlair', 'skalafut', 'jcleong', 'jenkinsalexp', 'mjbarger', 'plaird', 'singhs', 'aashi21', 'priyamtrivedi', 'axavier', 'misko9', 'aozero', 'gsinghal', 'nutomo', 'acgautam', 'fisher', 'blee292513']",12,"['gjross', 'sprashan', 'chaines', 'dvanclev', 'smith571', 'astacy', 'lcowsert', 'han45', 'neudeck', 'smchaudh', None, 'dopkick']",35,"['adamskelton', 'chaines', 'singhs', 'stucky', 'blee292513', 'nee_a87', 'smith571', 'babauman', 'jcromer', 'aashi21', 'priyamtrivedi', 'han45', 'SonicalFlair', 'skalafut', 'jcleong', 'axavier', 'misko9', 'adarmans', 'gjross', 'sprashan', None, 'aozero', 'dvanclev', 'astacy', 'jenkinsalexp', 'gsinghal', 'nutomo', 'acgautam', 'lcowsert', 'neudeck', 'fisher', 'smchaudh', 'mjbarger', 'plaird', 'dopkick']"
7,64,24,8,3,"['singhs', 'nee_a87', 'blee292513']",20,"['adamskelton', 'stucky', 'babauman', 'jcromer', 'SonicalFlair', 'skalafut', 'jcleong', 'jenkinsalexp', 'mjbarger', 'plaird', 'aashi21', 'priyamtrivedi', 'axavier', 'misko9', 'adarmans', 'aozero', 'gsinghal', 'nutomo', 'acgautam', 'fisher']",5,"['csrockerzero', 'nanohueb', 'han45', None, 'mtanoto']",28,"['adamskelton', 'singhs', 'stucky', 'blee292513', 'nee_a87', 'csrockerzero', 'babauman', 'jcromer', 'aashi21', 'priyamtrivedi', 'han45', 'SonicalFlair', 'skalafut', 'jcleong', 'axavier', 'misko9', 'adarmans', None, 'aozero', 'nanohueb', 'jenkinsalexp', 'gsinghal', 'nutomo', 'acgautam', 'fisher', 'mjbarger', 'plaird', 'mtanoto']"
8,10,21,24,14,"['CyberSnoopy', 'orsonlo', 'jkdavid', 'radiation', 'leeckung', 'sayid', 'exlove', 'braganza_michael', 'shannonlew', 'dharma135', 'candle120', 'greatjw', 'hhuang', 'cybersnoopy']",6,"['fountain', 'rajatg', 'slipson', 'JForejtek', 'sonchoy', 'okinjo']",10,"['ddrum2000', 'pradeepranjal', 'femto', 'mer99tigers', 'lettertohyo', 'harip1985', 'jamil', 'dipanjan', None, 'enshaoliu']",30,"['orsonlo', 'radiation', 'sayid', 'pradeepranjal', 'mer99tigers', 'exlove', 'jamil', 'slipson', 'enshaoliu', 'fountain', 'braganza_michael', 'candle120', 'hhuang', 'greatjw', 'cybersnoopy', 'sonchoy', 'okinjo', 'jkdavid', 'leeckung', 'femto', 'shannonlew', 'dharma135', 'dipanjan', 'CyberSnoopy', 'rajatg', None, 'ddrum2000', 'lettertohyo', 'harip1985', 'JForejtek']"
8,7,21,8,2,"['CyberSnoopy', 'cybersnoopy']",18,"['orsonlo', 'JForejtek', 'jkdavid', 'fountain', 'radiation', 'leeckung', 'sayid', 'exlove', 'greatjw', 'braganza_michael', 'shannonlew', 'dharma135', 'candle120', 'rajatg', 'slipson', 'hhuang', 'sonchoy', 'okinjo']",6,"['ddrum2000', 'lettertohyo', 'ferdousi', 'jamil', None, 'enshaoliu']",26,"['orsonlo', 'jkdavid', 'radiation', 'leeckung', 'sayid', 'exlove', 'shannonlew', 'dharma135', 'jamil', 'slipson', 'CyberSnoopy', 'rajatg', None, 'enshaoliu', 'cybersnoopy', 'fountain', 'ddrum2000', 'lettertohyo', 'braganza_michael', 'ferdousi', 'candle120', 'JForejtek', 'greatjw', 'hhuang', 'sonchoy', 'okinjo']"
8,9,21,7,1,['JForejtek'],19,"['orsonlo', 'radiation', 'sayid', 'exlove', 'slipson', 'fountain', 'braganza_michael', 'candle120', 'greatjw', 'cybersnoopy', 'sonchoy', 'okinjo', 'jkdavid', 'leeckung', 'shannonlew', 'dharma135', 'CyberSnoopy', 'rajatg', 'hhuang']",6,"['xnavra28', 'xjanos07', 'xbartu', 'xjaros24', 'xsedam00', None]",26,"['xnavra28', 'orsonlo', 'jkdavid', 'xjanos07', 'radiation', 'leeckung', 'sayid', 'exlove', 'shannonlew', 'dharma135', 'slipson', 'CyberSnoopy', 'rajatg', None, 'xjaros24', 'cybersnoopy', 'fountain', 'xbartu', 'braganza_michael', 'candle120', 'JForejtek', 'greatjw', 'xsedam00', 'hhuang', 'sonchoy', 'okinjo']"
9,35,17,37,2,"['sulcj', 'jchmelik']",14,"['xnavra28', 'jirkami', 'czkiller', 'hugotek', 'xkroli00', 'xbartu', 'xhrube00', 'lordraia', 'berzby', 'benda', 'xjaros24', 'xsedam00', 'loutocky', 'mikkiste']",35,"['ufyzguest', 'martingt110', 'xpavlo04', 'mirek', 'jardakn', 'magellan', 'xjanic06', 'vidan', 'xzaple12', 'roman', 'jmacak', 'xuhlar00', 'Havlicek', 'xhenzl00', 'clovek', 'thorXL', 'nano_xtalav00', 'cendar', 'zeron', 'Pau16', 'clown', 'mage', 'vinecko', None, 'jarek', 'xkrahu03', 'jiriholubcik', 'xbotko00', 'xpapez00', 'immortal', 'jendelin1', 'sedlakp', 'poloop', 'poolee', 'kubb']",51,"['xnavra28', 'hugotek', 'ufyzguest', 'martingt110', 'xpavlo04', 'jardakn', 'mirek', 'magellan', 'xjanic06', 'vidan', 'xzaple12', 'roman', 'xbartu', 'jchmelik', 'jmacak', 'xuhlar00', 'berzby', 'benda', 'Havlicek', 'xhenzl00', 'loutocky', 'clovek', 'poolee', 'thorXL', 'jirkami', 'czkiller', 'nano_xtalav00', 'cendar', 'xhrube00', 'zeron', 'Pau16', 'clown', 'mage', 'vinecko', 'xjaros24', 'sulcj', None, 'jarek', 'mikkiste', 'xkrahu03', 'jiriholubcik', 'xbotko00', 'xpapez00', 'immortal', 'lordraia', 'jendelin1', 'sedlakp', 'xsedam00', 'poloop', 'xkroli00', 'kubb']"
9,27,17,36,2,"['sulcj', 'jchmelik']",14,"['xnavra28', 'jirkami', 'czkiller', 'hugotek', 'xkroli00', 'xbartu', 'xhrube00', 'lordraia', 'berzby', 'benda', 'xjaros24', 'xsedam00', 'loutocky', 'mikkiste']",34,"['xsvabf00', 'xpavlo04', 'callos', 'mirek', 'jardakn', 'magellan', 'vidan', 'xjanic06', 'xzaple12', 'haldy', 'xuhlar00', 'Havlicek', 'thorXL', 'nano_xtalav00', 'zeron', 'jiri_novosad', 'wing', 'Pau16', 'clown', 'Roman', 'mage', 'vinecko', None, 'jarek', 'xkrahu03', 'jiriholubcik', 'xbotko00', 'xpapez00', 'KliBall', 'immortal', 'xmisek00', 'jendelin1', 'sedlakp', 'kubb']",50,"['xnavra28', 'hugotek', 'xsvabf00', 'xpavlo04', 'callos', 'jardakn', 'mirek', 'magellan', 'vidan', 'xjanic06', 'xzaple12', 'haldy', 'xbartu', 'jchmelik', 'xuhlar00', 'berzby', 'benda', 'Havlicek', 'loutocky', 'thorXL', 'jirkami', 'czkiller', 'nano_xtalav00', 'xhrube00', 'zeron', 'jiri_novosad', 'wing', 'Pau16', 'clown', 'Roman', 'mage', 'vinecko', 'xjaros24', 'sulcj', None, 'jarek', 'mikkiste', 'xkrahu03', 'jiriholubcik', 'xbotko00', 'xpapez00', 'KliBall', 'immortal', 'lordraia', 'xmisek00', 'jendelin1', 'sedlakp', 'xsedam00', 'xkroli00', 'kubb']"
9,29,17,35,14,"['xnavra28', 'jirkami', 'czkiller', 'hugotek', 'xkroli00', 'xbartu', 'xhrube00', 'lordraia', 'berzby', 'benda', 'xjaros24', 'xsedam00', 'loutocky', 'mikkiste']",2,"['sulcj', 'jchmelik']",21,"['xhakto00', 'susen', 'ufyzguest', 'xkubin08', 'lumpikur', 'ZdenekNo', 'majlow', 'majlos', 'Dallda', 'Havlicek', 'xlazni05', 'xjanos07', 'cendar', 'reznicekm', 'kuzdaso', 'jiri_novosad', None, 'xzimek01', 'xbetla00', 'sedlakp', 'poloop']",37,"['xnavra28', 'xhakto00', 'hugotek', 'susen', 'ufyzguest', 'xkubin08', 'lumpikur', 'ZdenekNo', 'majlow', 'majlos', 'xbartu', 'jchmelik', 'berzby', 'benda', 'Dallda', 'Havlicek', 'loutocky', 'xlazni05', 'jirkami', 'czkiller', 'xjanos07', 'cendar', 'xhrube00', 'reznicekm', 'kuzdaso', 'jiri_novosad', 'xjaros24', 'sulcj', 'xzimek01', None, 'mikkiste', 'xbetla00', 'lordraia', 'sedlakp', 'xsedam00', 'poloop', 'xkroli00']"
9,44,17,33,2,"['sulcj', 'jchmelik']",14,"['xnavra28', 'jirkami', 'czkiller', 'hugotek', 'xkroli00', 'xbartu', 'xhrube00', 'lordraia', 'berzby', 'benda', 'xjaros24', 'xsedam00', 'loutocky', 'mikkiste']",31,"['ufyzguest', 'haldy123', 'xpavlo04', 'kliball', 'callos', 'mirek', 'xjanic06', 'xzaple12', 'roman', 'xstava05', 'djnavr', 'xuhlar00', 'Havlicek', 'thorXL', 'cendar', 'zeron', 'jiri_novosad', 'Pau16', 'clown', 'vinecko', None, 'hajny', 'xkrahu03', 'jiriholubcik', 'xpapez00', 'immortal', 'xmisek00', 'jendelin1', 'sedlakp', 'poolee', 'kubb']",47,"['xnavra28', 'hugotek', 'ufyzguest', 'haldy123', 'xpavlo04', 'kliball', 'callos', 'mirek', 'xjanic06', 'xzaple12', 'roman', 'xstava05', 'xbartu', 'djnavr', 'jchmelik', 'xuhlar00', 'berzby', 'benda', 'Havlicek', 'loutocky', 'poolee', 'thorXL', 'jirkami', 'czkiller', 'cendar', 'xhrube00', 'zeron', 'jiri_novosad', 'Pau16', 'clown', 'vinecko', 'xjaros24', 'sulcj', None, 'mikkiste', 'hajny', 'xkrahu03', 'jiriholubcik', 'xpapez00', 'immortal', 'lordraia', 'xmisek00', 'jendelin1', 'sedlakp', 'xsedam00', 'xkroli00', 'kubb']"
9,36,17,32,13,"['xnavra28', 'jirkami', 'czkiller', 'hugotek', 'xkroli00', 'xbartu', 'xhrube00', 'lordraia', 'berzby', 'benda', 'xjaros24', 'xsedam00', 'loutocky']",3,"['sulcj', 'jchmelik', 'mikkiste']",19,"['dallda', 'koren', 'xhakto00', 'susen', 'ufyzguest', 'kliball', 'lumpikur', 'Ladas_M', 'solda', 'oti', 'majlos', 'reznicekm', 'rasiel', 'pekosek23', 'NosekZ', None, 'xbetla00', 'xmisek00', 'sedlakp']",35,"['dallda', 'xnavra28', 'koren', 'hugotek', 'susen', 'xhakto00', 'ufyzguest', 'kliball', 'lumpikur', 'Ladas_M', 'solda', 'oti', 'majlos', 'xbartu', 'jchmelik', 'berzby', 'benda', 'loutocky', 'jirkami', 'czkiller', 'xhrube00', 'reznicekm', 'rasiel', 'pekosek23', 'NosekZ', 'xjaros24', 'sulcj', None, 'mikkiste', 'xbetla00', 'lordraia', 'xmisek00', 'sedlakp', 'xsedam00', 'xkroli00']"
9,45,17,31,14,"['xnavra28', 'jirkami', 'czkiller', 'hugotek', 'xkroli00', 'xbartu', 'xhrube00', 'lordraia', 'berzby', 'benda', 'xjaros24', 'xsedam00', 'loutocky', 'mikkiste']",2,"['sulcj', 'jchmelik']",17,"['dallda', 'xlazni05', 'Nosekz', 'Solda', 'majlos', 'krivak', 'xjanos07', 'pekosek23', 'xbetla00', 'xkubin08', 'xholik00', 'mage', 'lumir', 'jardakn', None, 'Ladas_M', 'oti']",33,"['dallda', 'xnavra28', 'hugotek', 'xkubin08', 'lumir', 'krivak', 'jardakn', 'Ladas_M', 'oti', 'majlos', 'xbartu', 'jchmelik', 'berzby', 'benda', 'loutocky', 'xlazni05', 'Nosekz', 'jirkami', 'czkiller', 'xjanos07', 'xhrube00', 'pekosek23', 'mage', 'xjaros24', 'sulcj', None, 'mikkiste', 'Solda', 'xbetla00', 'lordraia', 'xholik00', 'xsedam00', 'xkroli00']"
9,5,17,27,2,"['sulcj', 'loutocky']",14,"['xnavra28', 'jirkami', 'czkiller', 'hugotek', 'xbartu', 'xhrube00', 'jchmelik', 'lordraia', 'berzby', 'benda', 'xjaros24', 'xsedam00', 'xkroli00', 'mikkiste']",25,"['xhakto00', 'ufyzguest', 'xpavlo04', 'kliball', 'callos', 'xjanic06', 'xzaple12', 'roman', 'jmacak', 'xuhlar00', 'Havlicek', 'xhenzl00', 'thorXL', 'nano_xtalav00', 'cendar', 'rasiel', 'clown', 'mage', 'vinecko', None, 'xbotko00', 'pospa83', 'immortal', 'xmisek00', 'jendelin1']",41,"['xnavra28', 'xhakto00', 'hugotek', 'ufyzguest', 'xpavlo04', 'kliball', 'callos', 'xjanic06', 'xzaple12', 'roman', 'xbartu', 'jchmelik', 'jmacak', 'xuhlar00', 'berzby', 'benda', 'Havlicek', 'xhenzl00', 'loutocky', 'thorXL', 'jirkami', 'czkiller', 'nano_xtalav00', 'cendar', 'xhrube00', 'rasiel', 'clown', 'mage', 'vinecko', 'xjaros24', 'sulcj', None, 'mikkiste', 'xbotko00', 'pospa83', 'immortal', 'lordraia', 'xmisek00', 'jendelin1', 'xsedam00', 'xkroli00']"
9,2,17,24,1,['loutocky'],15,"['xnavra28', 'jirkami', 'czkiller', 'hugotek', 'xbartu', 'xhrube00', 'jchmelik', 'lordraia', 'berzby', 'sulcj', 'benda', 'xjaros24', 'xsedam00', 'xkroli00', 'mikkiste']",23,"['xhakto00', 'ufyzguest', 'xpavlo04', 'kliball', 'callos', 'xzaple12', 'roman', 'jmacak', 'xuhlar00', 'Havlicek', 'xhenzl00', 'thorXL', 'nano_xtalav00', 'rasiel', 'clown', 'mage', 'vinecko', None, 'xbotko00', 'pospa83', 'immortal', 'xmisek00', 'jendelin1']",39,"['xnavra28', 'xhakto00', 'hugotek', 'ufyzguest', 'xpavlo04', 'kliball', 'callos', 'xzaple12', 'roman', 'xbartu', 'jchmelik', 'jmacak', 'xuhlar00', 'berzby', 'benda', 'Havlicek', 'xhenzl00', 'loutocky', 'thorXL', 'jirkami', 'czkiller', 'nano_xtalav00', 'xhrube00', 'rasiel', 'clown', 'mage', 'vinecko', 'xjaros24', 'sulcj', None, 'mikkiste', 'xbotko00', 'pospa83', 'immortal', 'lordraia', 'xmisek00', 'jendelin1', 'xsedam00', 'xkroli00']"
9,3,17,19,9,"['jirkami', 'hugotek', 'xhrube00', 'jchmelik', 'lordraia', 'berzby', 'benda', 'xkroli00', 'mikkiste']",7,"['xnavra28', 'czkiller', 'xbartu', 'sulcj', 'xjaros24', 'xsedam00', 'loutocky']",10,"['majlos', 'susen', 'poloop', 'jiri_novosad', 'xkubin08', 'Dallda', 'xholik00', 'krivak', None, 'magellan']",26,"['xnavra28', 'jirkami', 'czkiller', 'hugotek', 'susen', 'xhrube00', 'jiri_novosad', 'xkubin08', 'krivak', 'xjaros24', 'sulcj', None, 'magellan', 'mikkiste', 'xkroli00', 'majlos', 'xbartu', 'jchmelik', 'lordraia', 'berzby', 'benda', 'Dallda', 'xholik00', 'xsedam00', 'poloop', 'loutocky']"
9,8,17,19,9,"['jirkami', 'hugotek', 'xhrube00', 'jchmelik', 'lordraia', 'berzby', 'benda', 'xkroli00', 'mikkiste']",7,"['xnavra28', 'czkiller', 'xbartu', 'sulcj', 'xjaros24', 'xsedam00', 'loutocky']",10,"['majlos', 'susen', 'poloop', 'jiri_novosad', 'xkubin08', 'Dallda', 'xholik00', 'krivak', None, 'magellan']",26,"['xnavra28', 'jirkami', 'czkiller', 'hugotek', 'susen', 'xhrube00', 'jiri_novosad', 'xkubin08', 'krivak', 'xjaros24', 'sulcj', None, 'magellan', 'mikkiste', 'xkroli00', 'majlos', 'xbartu', 'jchmelik', 'lordraia', 'berzby', 'benda', 'Dallda', 'xholik00', 'xsedam00', 'poloop', 'loutocky']"
9,9,17,7,4,"['xbartu', 'xnavra28', 'xjaros24', 'xsedam00']",12,"['jirkami', 'czkiller', 'hugotek', 'xkroli00', 'xhrube00', 'jchmelik', 'lordraia', 'berzby', 'benda', 'sulcj', 'loutocky', 'mikkiste']",3,"['JForejtek', None, 'xjanos07']",19,"['xnavra28', 'jirkami', 'czkiller', 'hugotek', 'xjanos07', 'xhrube00', 'xjaros24', 'sulcj', None, 'mikkiste', 'xkroli00', 'xbartu', 'jchmelik', 'lordraia', 'berzby', 'benda', 'xsedam00', 'JForejtek', 'loutocky']"
10,33,17,13,8,"['javiii87', 'dgilham', 'djcook', 'ghandi32', 'betog', 'nyan84', 'oshekari', 'cushenj']",8,"['abhishekiin', 'cstringe', 'guirreri', 'zohebmunshi', 'dditzler', 'bdgordon', 'norflekr', 'chunkysoup']",5,"['vklall', 'abhisheKiin', 'vespasianvs', None, 'noondduh']",21,"['abhishekiin', 'vklall', 'djcook', 'betog', 'guirreri', 'zohebmunshi', 'dditzler', 'nyan84', 'oshekari', 'cushenj', 'vespasianvs', 'norflekr', None, 'chunkysoup', 'noondduh', 'javiii87', 'cstringe', 'ghandi32', 'abhisheKiin', 'dgilham', 'bdgordon']"
10,31,17,11,7,"['javiii87', 'ghandi32', 'dditzler', 'nyan84', 'dgilham', 'cushenj', 'oshekari']",9,"['abhishekiin', 'cstringe', 'djcook', 'betog', 'guirreri', 'zohebmunshi', 'bdgordon', 'norflekr', 'chunkysoup']",4,"['agah', 'vklall', 'da400king', None]",20,"['abhishekiin', 'agah', 'vklall', 'da400king', 'djcook', 'betog', 'guirreri', 'zohebmunshi', 'dditzler', 'nyan84', 'oshekari', 'cushenj', 'norflekr', None, 'chunkysoup', 'javiii87', 'cstringe', 'ghandi32', 'dgilham', 'bdgordon']"
10,32,17,8,3,"['bdgordon', 'ghandi32', 'cstringe']",13,"['abhishekiin', 'javiii87', 'djcook', 'betog', 'guirreri', 'zohebmunshi', 'dditzler', 'nyan84', 'dgilham', 'cushenj', 'norflekr', 'chunkysoup', 'oshekari']",5,"['JasminaJazic', 'jenneg19', 'nyrhokie', None, 'chuckdeez810']",21,"['abhishekiin', 'JasminaJazic', 'djcook', 'betog', 'guirreri', 'zohebmunshi', 'dditzler', 'nyan84', 'oshekari', 'cushenj', 'nyrhokie', 'norflekr', None, 'chunkysoup', 'javiii87', 'cstringe', 'ghandi32', 'jenneg19', 'dgilham', 'bdgordon', 'chuckdeez810']"
10,34,17,6,3,"['bdgordon', 'chunkysoup', 'cstringe']",13,"['abhishekiin', 'javiii87', 'djcook', 'ghandi32', 'betog', 'guirreri', 'zohebmunshi', 'dditzler', 'nyan84', 'dgilham', 'cushenj', 'norflekr', 'oshekari']",3,"['NYRHokie', None, 'ykim']",19,"['abhishekiin', 'ykim', 'djcook', 'betog', 'guirreri', 'zohebmunshi', 'dditzler', 'nyan84', 'oshekari', 'cushenj', 'norflekr', None, 'chunkysoup', 'javiii87', 'cstringe', 'ghandi32', 'NYRHokie', 'dgilham', 'bdgordon']"
11,30,16,18,1,['vidnari'],14,"['knuttz45', 'jvalmanza', 'ben_anderson1', 'sahar', 'stewartsoda', 'brianmeek', 'omarbenitez', 'justinbutterfield', 'lincstar182', 'dency_daniel', 'DarrinReed', 'otrejo', 'ssessi', 'davidknight']",17,"['turkstra', 'zhudongchun', 'bupolin77', 'newmin', 'shorif', 'gkarakon', 'ssalamat', 'pgururaj', 'zainu', 'kim70', 'cbburger', 'tjandran', 'masud001', None, 'junezhu', 'jhenrie', 'cinedemian']",32,"['jvalmanza', 'bupolin77', 'brianmeek', 'shorif', 'gkarakon', 'DarrinReed', 'junezhu', 'zhudongchun', 'stewartsoda', 'lincstar182', 'dency_daniel', 'ssessi', 'cbburger', 'vidnari', 'tjandran', 'cinedemian', 'turkstra', 'ben_anderson1', 'newmin', 'omarbenitez', 'justinbutterfield', 'pgururaj', 'kim70', 'masud001', None, 'jhenrie', 'knuttz45', 'sahar', 'otrejo', 'ssalamat', 'zainu', 'davidknight']"
11,17,16,17,10,"['jvalmanza', 'sahar', 'stewartsoda', 'lincstar182', 'justinbutterfield', 'dency_daniel', 'otrejo', 'DarrinReed', 'ssessi', 'davidknight']",5,"['knuttz45', 'ben_anderson1', 'brianmeek', 'omarbenitez', 'vidnari']",7,"['aaronwozniak', 'darrinreed', 'petersonidaho', 'hbui', 'zencharren', None, 'chrisraymes']",22,"['jvalmanza', 'brianmeek', 'DarrinReed', 'darrinreed', 'petersonidaho', 'stewartsoda', 'lincstar182', 'dency_daniel', 'ssessi', 'vidnari', 'ben_anderson1', 'omarbenitez', 'justinbutterfield', None, 'knuttz45', 'sahar', 'aaronwozniak', 'zencharren', 'otrejo', 'hbui', 'davidknight', 'chrisraymes']"
11,28,16,17,10,"['jvalmanza', 'sahar', 'stewartsoda', 'lincstar182', 'justinbutterfield', 'dency_daniel', 'otrejo', 'DarrinReed', 'ssessi', 'davidknight']",5,"['knuttz45', 'ben_anderson1', 'brianmeek', 'omarbenitez', 'vidnari']",7,"['aaronwozniak', 'victorkelley', 'grock', 'hbui', 'kriscampbell', None, 'chrisraymes']",22,"['jvalmanza', 'brianmeek', 'DarrinReed', 'grock', 'stewartsoda', 'lincstar182', 'dency_daniel', 'ssessi', 'vidnari', 'ben_anderson1', 'omarbenitez', 'justinbutterfield', 'victorkelley', 'kriscampbell', None, 'knuttz45', 'sahar', 'aaronwozniak', 'otrejo', 'hbui', 'davidknight', 'chrisraymes']"
13,35,16,37,14,"['roman', 'xbotko00', 'nano_xtalav00', 'zeron', 'ufyzguest', 'Pau16', 'jmacak', 'immortal', 'xpavlo04', 'Havlicek', 'mage', 'jarek', 'poloop', 'kubb']",1,['callos'],23,"['martingt110', 'mirek', 'jardakn', 'magellan', 'xjanic06', 'vidan', 'xzaple12', 'jchmelik', 'xuhlar00', 'xhenzl00', 'clovek', 'thorXL', 'cendar', 'clown', 'vinecko', 'sulcj', None, 'xkrahu03', 'jiriholubcik', 'xpapez00', 'jendelin1', 'sedlakp', 'poolee']",38,"['ufyzguest', 'martingt110', 'xpavlo04', 'callos', 'jardakn', 'mirek', 'magellan', 'xjanic06', 'vidan', 'xzaple12', 'roman', 'jchmelik', 'jmacak', 'xuhlar00', 'Havlicek', 'xhenzl00', 'clovek', 'thorXL', 'nano_xtalav00', 'cendar', 'zeron', 'Pau16', 'clown', 'mage', 'vinecko', 'sulcj', None, 'jarek', 'xkrahu03', 'jiriholubcik', 'xbotko00', 'xpapez00', 'immortal', 'jendelin1', 'sedlakp', 'poloop', 'poolee', 'kubb']"
13,27,16,36,11,"['jarek', 'xbotko00', 'nano_xtalav00', 'zeron', 'Pau16', 'immortal', 'xpavlo04', 'Havlicek', 'mage', 'callos', 'kubb']",4,"['poloop', 'roman', 'ufyzguest', 'jmacak']",25,"['xsvabf00', 'mirek', 'jardakn', 'magellan', 'vidan', 'xjanic06', 'xzaple12', 'haldy', 'jchmelik', 'xuhlar00', 'thorXL', 'wing', 'jiri_novosad', 'clown', 'Roman', 'vinecko', 'sulcj', None, 'xkrahu03', 'jiriholubcik', 'xpapez00', 'KliBall', 'xmisek00', 'jendelin1', 'sedlakp']",40,"['xsvabf00', 'ufyzguest', 'xpavlo04', 'callos', 'jardakn', 'mirek', 'magellan', 'vidan', 'xjanic06', 'xzaple12', 'roman', 'haldy', 'jchmelik', 'jmacak', 'xuhlar00', 'Havlicek', 'thorXL', 'nano_xtalav00', 'zeron', 'jiri_novosad', 'wing', 'Pau16', 'clown', 'Roman', 'mage', 'vinecko', 'sulcj', None, 'jarek', 'xkrahu03', 'jiriholubcik', 'xbotko00', 'xpapez00', 'KliBall', 'immortal', 'xmisek00', 'jendelin1', 'sedlakp', 'poloop', 'kubb']"
13,29,16,35,3,"['poloop', 'ufyzguest', 'Havlicek']",12,"['jarek', 'roman', 'xbotko00', 'nano_xtalav00', 'zeron', 'Pau16', 'jmacak', 'immortal', 'xpavlo04', 'mage', 'callos', 'kubb']",32,"['xnavra28', 'xhakto00', 'hugotek', 'susen', 'xkubin08', 'lumpikur', 'ZdenekNo', 'majlow', 'majlos', 'xbartu', 'berzby', 'benda', 'Dallda', 'loutocky', 'xlazni05', 'jirkami', 'czkiller', 'xjanos07', 'cendar', 'reznicekm', 'xhrube00', 'kuzdaso', 'jiri_novosad', 'xjaros24', 'xzimek01', None, 'mikkiste', 'xbetla00', 'lordraia', 'sedlakp', 'xsedam00', 'xkroli00']",47,"['xnavra28', 'xhakto00', 'hugotek', 'susen', 'ufyzguest', 'xkubin08', 'xpavlo04', 'callos', 'lumpikur', 'ZdenekNo', 'roman', 'majlow', 'majlos', 'xbartu', 'jmacak', 'berzby', 'benda', 'Havlicek', 'Dallda', 'loutocky', 'xlazni05', 'jirkami', 'nano_xtalav00', 'czkiller', 'xjanos07', 'cendar', 'reznicekm', 'xhrube00', 'zeron', 'kuzdaso', 'jiri_novosad', 'Pau16', 'mage', 'xjaros24', 'xzimek01', None, 'jarek', 'mikkiste', 'xbotko00', 'xbetla00', 'immortal', 'lordraia', 'sedlakp', 'xsedam00', 'poloop', 'xkroli00', 'kubb']"
13,44,16,33,9,"['roman', 'zeron', 'ufyzguest', 'Pau16', 'immortal', 'xpavlo04', 'Havlicek', 'callos', 'kubb']",6,"['xbotko00', 'nano_xtalav00', 'jmacak', 'mage', 'poloop', 'jarek']",24,"['haldy123', 'kliball', 'mirek', 'xjanic06', 'xzaple12', 'xstava05', 'djnavr', 'jchmelik', 'xuhlar00', 'thorXL', 'cendar', 'jiri_novosad', 'clown', 'vinecko', 'sulcj', None, 'hajny', 'xkrahu03', 'jiriholubcik', 'xpapez00', 'xmisek00', 'jendelin1', 'sedlakp', 'poolee']",39,"['ufyzguest', 'haldy123', 'xpavlo04', 'kliball', 'callos', 'mirek', 'xjanic06', 'xzaple12', 'roman', 'xstava05', 'djnavr', 'jchmelik', 'jmacak', 'xuhlar00', 'Havlicek', 'thorXL', 'nano_xtalav00', 'cendar', 'zeron', 'jiri_novosad', 'Pau16', 'clown', 'mage', 'vinecko', 'sulcj', None, 'jarek', 'hajny', 'xkrahu03', 'jiriholubcik', 'xbotko00', 'xpapez00', 'immortal', 'xmisek00', 'jendelin1', 'sedlakp', 'poloop', 'poolee', 'kubb']"
13,36,16,32,1,['ufyzguest'],14,"['jarek', 'roman', 'xbotko00', 'nano_xtalav00', 'zeron', 'Pau16', 'jmacak', 'immortal', 'xpavlo04', 'Havlicek', 'mage', 'callos', 'poloop', 'kubb']",31,"['dallda', 'xnavra28', 'koren', 'hugotek', 'susen', 'xhakto00', 'kliball', 'lumpikur', 'Ladas_M', 'solda', 'oti', 'majlos', 'xbartu', 'berzby', 'benda', 'loutocky', 'jirkami', 'czkiller', 'reznicekm', 'rasiel', 'pekosek23', 'xhrube00', 'NosekZ', 'xjaros24', None, 'xbetla00', 'xmisek00', 'lordraia', 'sedlakp', 'xsedam00', 'xkroli00']",46,"['dallda', 'xnavra28', 'koren', 'hugotek', 'susen', 'xhakto00', 'ufyzguest', 'xpavlo04', 'kliball', 'callos', 'lumpikur', 'Ladas_M', 'solda', 'oti', 'roman', 'majlos', 'xbartu', 'jmacak', 'berzby', 'benda', 'Havlicek', 'loutocky', 'jirkami', 'nano_xtalav00', 'czkiller', 'reznicekm', 'rasiel', 'zeron', 'pekosek23', 'xhrube00', 'Pau16', 'NosekZ', 'mage', 'xjaros24', None, 'jarek', 'xbotko00', 'xbetla00', 'immortal', 'xmisek00', 'lordraia', 'sedlakp', 'xsedam00', 'poloop', 'xkroli00', 'kubb']"
13,45,16,31,1,['mage'],14,"['jarek', 'roman', 'xbotko00', 'nano_xtalav00', 'zeron', 'ufyzguest', 'Pau16', 'jmacak', 'immortal', 'xpavlo04', 'Havlicek', 'callos', 'poloop', 'kubb']",30,"['dallda', 'xnavra28', 'hugotek', 'xkubin08', 'krivak', 'lumir', 'jardakn', 'Ladas_M', 'oti', 'majlos', 'xbartu', 'berzby', 'benda', 'loutocky', 'xlazni05', 'Nosekz', 'jirkami', 'czkiller', 'xjanos07', 'pekosek23', 'xhrube00', 'xjaros24', None, 'mikkiste', 'Solda', 'xbetla00', 'lordraia', 'xholik00', 'xsedam00', 'xkroli00']",45,"['dallda', 'xnavra28', 'hugotek', 'ufyzguest', 'xkubin08', 'xpavlo04', 'callos', 'lumir', 'krivak', 'jardakn', 'Ladas_M', 'oti', 'roman', 'majlos', 'xbartu', 'jmacak', 'berzby', 'benda', 'Havlicek', 'loutocky', 'xlazni05', 'Nosekz', 'jirkami', 'nano_xtalav00', 'czkiller', 'xjanos07', 'pekosek23', 'xhrube00', 'zeron', 'Pau16', 'mage', 'xjaros24', None, 'jarek', 'mikkiste', 'Solda', 'xbotko00', 'xbetla00', 'immortal', 'lordraia', 'xholik00', 'xsedam00', 'poloop', 'xkroli00', 'kubb']"
13,5,16,27,10,"['roman', 'xbotko00', 'nano_xtalav00', 'ufyzguest', 'jmacak', 'immortal', 'xpavlo04', 'Havlicek', 'mage', 'callos']",5,"['zeron', 'Pau16', 'kubb', 'poloop', 'jarek']",17,"['xjanic06', 'thorXL', 'xzaple12', 'xhakto00', 'cendar', 'rasiel', 'pospa83', 'xuhlar00', 'xmisek00', 'jendelin1', 'clown', 'kliball', 'vinecko', 'xhenzl00', 'sulcj', None, 'loutocky']",32,"['xhakto00', 'ufyzguest', 'xpavlo04', 'kliball', 'callos', 'xjanic06', 'xzaple12', 'roman', 'jmacak', 'xuhlar00', 'Havlicek', 'xhenzl00', 'loutocky', 'thorXL', 'nano_xtalav00', 'cendar', 'rasiel', 'zeron', 'Pau16', 'clown', 'mage', 'vinecko', 'sulcj', None, 'jarek', 'xbotko00', 'pospa83', 'immortal', 'xmisek00', 'jendelin1', 'poloop', 'kubb']"
13,49,16,27,11,"['roman', 'xbotko00', 'nano_xtalav00', 'Pau16', 'jmacak', 'immortal', 'xpavlo04', 'Havlicek', 'callos', 'poloop', 'jarek']",4,"['zeron', 'ufyzguest', 'kubb', 'mage']",16,"['hajny', 'xjanic06', 'thorXL', 'xzaple12', 'xkrahu03', 'jiriholubcik', 'xstava05', 'cendar', 'jiri_novosad', 'sedlakp', 'vinecko', 'xhenzl00', 'mirek', 'tomasbzonek', None, 'poolee']",31,"['ufyzguest', 'xpavlo04', 'callos', 'mirek', 'xjanic06', 'xzaple12', 'roman', 'xstava05', 'jmacak', 'Havlicek', 'xhenzl00', 'thorXL', 'nano_xtalav00', 'cendar', 'zeron', 'jiri_novosad', 'Pau16', 'mage', 'vinecko', 'tomasbzonek', None, 'jarek', 'hajny', 'xkrahu03', 'jiriholubcik', 'xbotko00', 'immortal', 'sedlakp', 'poloop', 'poolee', 'kubb']"
13,2,16,24,10,"['roman', 'xbotko00', 'nano_xtalav00', 'ufyzguest', 'jmacak', 'immortal', 'xpavlo04', 'Havlicek', 'mage', 'callos']",5,"['zeron', 'Pau16', 'kubb', 'poloop', 'jarek']",14,"['thorXL', 'xzaple12', 'xhakto00', 'rasiel', 'pospa83', 'xuhlar00', 'xmisek00', 'jendelin1', 'clown', 'kliball', 'vinecko', 'xhenzl00', None, 'loutocky']",29,"['xhakto00', 'ufyzguest', 'xpavlo04', 'kliball', 'callos', 'xzaple12', 'roman', 'jmacak', 'xuhlar00', 'Havlicek', 'xhenzl00', 'loutocky', 'thorXL', 'nano_xtalav00', 'rasiel', 'zeron', 'Pau16', 'clown', 'mage', 'vinecko', None, 'jarek', 'xbotko00', 'pospa83', 'immortal', 'xmisek00', 'jendelin1', 'poloop', 'kubb']"
13,3,16,19,1,['poloop'],14,"['jarek', 'roman', 'xbotko00', 'nano_xtalav00', 'zeron', 'ufyzguest', 'Pau16', 'jmacak', 'immortal', 'xpavlo04', 'Havlicek', 'mage', 'callos', 'kubb']",18,"['jirkami', 'majlos', 'hugotek', 'susen', 'xkroli00', 'xhrube00', 'jchmelik', 'jiri_novosad', 'xkubin08', 'lordraia', 'berzby', 'benda', 'Dallda', 'xholik00', 'krivak', None, 'magellan', 'mikkiste']",33,"['hugotek', 'susen', 'ufyzguest', 'xkubin08', 'xpavlo04', 'callos', 'krivak', 'magellan', 'roman', 'majlos', 'jchmelik', 'jmacak', 'berzby', 'benda', 'Havlicek', 'Dallda', 'jirkami', 'nano_xtalav00', 'xhrube00', 'zeron', 'jiri_novosad', 'Pau16', 'mage', None, 'jarek', 'mikkiste', 'xbotko00', 'immortal', 'lordraia', 'xholik00', 'poloop', 'xkroli00', 'kubb']"
13,8,16,19,1,['poloop'],14,"['jarek', 'roman', 'xbotko00', 'nano_xtalav00', 'zeron', 'ufyzguest', 'Pau16', 'jmacak', 'immortal', 'xpavlo04', 'Havlicek', 'mage', 'callos', 'kubb']",18,"['jirkami', 'majlos', 'hugotek', 'susen', 'xkroli00', 'xhrube00', 'jchmelik', 'jiri_novosad', 'xkubin08', 'lordraia', 'berzby', 'benda', 'Dallda', 'xholik00', 'krivak', None, 'magellan', 'mikkiste']",33,"['hugotek', 'susen', 'ufyzguest', 'xkubin08', 'xpavlo04', 'callos', 'krivak', 'magellan', 'roman', 'majlos', 'jchmelik', 'jmacak', 'berzby', 'benda', 'Havlicek', 'Dallda', 'jirkami', 'nano_xtalav00', 'xhrube00', 'zeron', 'jiri_novosad', 'Pau16', 'mage', None, 'jarek', 'mikkiste', 'xbotko00', 'immortal', 'lordraia', 'xholik00', 'poloop', 'xkroli00', 'kubb']"
14,50,12,24,11,"['twoon', 'mistyblue122', 'twkt03', 'djacobs7', 'branetr', 'jrileyEE218', 'jaehlee', 'chenying119', 'ling84', 'dmg131', 'xuanwu']",0,[],13,"['crkenney', 'youngy', 'dejia', 'jia_sfo', 'elvislin', 'jayparker', 'changw', 'hspwong', 'rparsa', 'millaniow', 'letswin16', None, 'mrlin']",24,"['twoon', 'branetr', 'changw', 'rparsa', 'millaniow', 'twkt03', 'jayparker', 'jrileyEE218', 'mrlin', 'crkenney', 'youngy', 'dejia', 'djacobs7', 'jia_sfo', 'hspwong', 'ling84', 'letswin16', None, 'xuanwu', 'mistyblue122', 'elvislin', 'jaehlee', 'chenying119', 'dmg131']"
14,52,12,16,8,"['mistyblue122', 'twkt03', 'djacobs7', 'branetr', 'jrileyEE218', 'chenying119', 'ling84', 'dmg131']",3,"['twoon', 'jaehlee', 'xuanwu']",8,"['crkenney', 'peichen', 'youngy', 'jia_sfo', 'elvislin', 'oliviawei', None, 'millaniow']",19,"['twoon', 'crkenney', 'peichen', 'youngy', 'jia_sfo', 'djacobs7', 'oliviawei', 'branetr', 'ling84', None, 'xuanwu', 'millaniow', 'mistyblue122', 'twkt03', 'elvislin', 'jrileyEE218', 'jaehlee', 'chenying119', 'dmg131']"
14,51,12,11,6,"['mistyblue122', 'twkt03', 'branetr', 'jrileyEE218', 'ling84', 'djacobs7']",5,"['twoon', 'jaehlee', 'chenying119', 'dmg131', 'xuanwu']",5,"['crkenney', 'youngy', 'elvislin', 'rparsa', None]",16,"['twoon', 'crkenney', 'youngy', 'djacobs7', 'branetr', 'ling84', 'rparsa', None, 'xuanwu', 'mistyblue122', 'twkt03', 'elvislin', 'jrileyEE218', 'jaehlee', 'chenying119', 'dmg131']"
15,47,12,15,9,"['xiexienin', 'kathrynday', 'Amazonense', 'Sylex', 'student', 'kevinsmith2', 'mmalmrose', 'amywebster', 'Beldallan']",2,"['gelfling', 'drewcasselberry']",6,"['jmkluthe', 'timdavis', 'cinglefield', 'joehammer79', None, 'chulopackers']",17,"['xiexienin', 'Amazonense', 'Sylex', 'kevinsmith2', 'joehammer79', 'drewcasselberry', None, 'chulopackers', 'kathrynday', 'jmkluthe', 'student', 'timdavis', 'cinglefield', 'mmalmrose', 'gelfling', 'amywebster', 'Beldallan']"
15,42,12,11,8,"['kathrynday', 'Amazonense', 'Sylex', 'student', 'kevinsmith2', 'mmalmrose', 'gelfling', 'amywebster']",3,"['xiexienin', 'drewcasselberry', 'Beldallan']",3,"[None, 'timdavis', 'cinglefield']",14,"['xiexienin', 'Amazonense', 'Sylex', 'kevinsmith2', 'drewcasselberry', None, 'kathrynday', 'student', 'timdavis', 'cinglefield', 'mmalmrose', 'gelfling', 'amywebster', 'Beldallan']"
15,48,12,11,9,"['kathrynday', 'Amazonense', 'drewcasselberry', 'Sylex', 'student', 'kevinsmith2', 'mmalmrose', 'gelfling', 'amywebster']",2,"['xiexienin', 'Beldallan']",2,"[None, 'timdavis']",13,"['xiexienin', 'Amazonense', 'Sylex', 'kevinsmith2', 'drewcasselberry', None, 'kathrynday', 'student', 'timdavis', 'mmalmrose', 'gelfling', 'amywebster', 'Beldallan']"
16,19,12,13,3,"['bsg721', 'littlegu5', 'arbitro']",8,"['duranta23', 'lxb1111', 'BMONEY', 'arunp', 'asicliu', 'kanturalihan', 'Kanturalihan', 'askiahill']",10,"['faroughp', 'dtewe001', 'sgu001', 'kcarp001', 'moccamse', 'jcabi001', 'aagar001', 'mpenchev', None, 'yimingis']",21,"['bsg721', 'dtewe001', 'littlegu5', 'jcabi001', 'aagar001', 'Kanturalihan', None, 'askiahill', 'faroughp', 'duranta23', 'lxb1111', 'sgu001', 'BMONEY', 'arunp', 'kcarp001', 'moccamse', 'arbitro', 'kanturalihan', 'mpenchev', 'yimingis', 'asicliu']"
17,71,11,113,9,"['lonestar', 'crosis', 'sen2904', 'rkv000', 'nsapra', 'smillies', 'sagadi', 'justinsyk', 'junghanlee']",1,['davydotcom'],104,"['jwetheri', 'spgreene', 'jostendo', 'sstreete', 'babaumga', 'hsvasi', 'rsherloc', 'ahermann', 'swethy', 'mrmillz', 'nlabianc', 'kassovic', 'obernada', 'jskim', 'rtrusty', 'jones105', 'zconvers', 'lcowsert', 'dplamber', 'pateldm', 'jcwirth', 'docdaa008', 'hiddendecoy', 'mtanoto', 'rahoward', 'mtummala', 'seshaw', 'jgu', 'nrrojas', 'spamilton1', 'kdaiya', 'wildkid256', 'kelkwa11', 'Bache', 'john3636', 'brunner2112', 'mattsbai', 'vinsma', 'czahner', 'kklacik', 'gshaw', 'sprashan', 'dulmes', 'kim130', 'Jabzg', 'mhain', 'srettber', 'singapaul', 'rparisi', 'dgrothe', 'ttho', 'gzarse', 'arorar', 'terran010', 'joeblu', 'sbach', 'werman691', 'Fisher', 'asudibyo', 'ftanjono', 'jkurasz', 'bsparson', 'bsyoder', 'gjross', 'nmisiuna', 'dube0', 'mwarsco', 'johns180', 'npanitch', 'freedomjustice', 'chermawi', 'akhilesh', 'atruesde', 'wnoh', 'jtill04', 'MurphyAKL', 'bdannan', 'jshahid', 'pjyoti', 'gutierjm', 'zer0xXx', 'chang61', 'acallawa', 'han45', 'longja', 'lpeterus', 'kim131', 'pmongkol', 'garg', 'jaycrayz', 'wangyangboy', 'dmmitche', None, 'gustaf89', 'pbayuart', 'wow676', 'astacy', 'pranaynanda', 'Zarastra', 'smchaudh', 'anraj', 'wehlhard', 'jidthekid', 'tdjanoko']",114,"['jwetheri', 'crosis', 'spgreene', 'rkv000', 'jostendo', 'sstreete', 'babaumga', 'hsvasi', 'rsherloc', 'ahermann', 'swethy', 'mrmillz', 'nlabianc', 'kassovic', 'obernada', 'jskim', 'rtrusty', 'jones105', 'zconvers', 'lcowsert', 'dplamber', 'pateldm', 'jcwirth', 'docdaa008', 'hiddendecoy', 'mtanoto', 'rahoward', 'mtummala', 'seshaw', 'jgu', 'nrrojas', 'spamilton1', 'kdaiya', 'wildkid256', 'kelkwa11', 'Bache', 'john3636', 'davydotcom', 'brunner2112', 'mattsbai', 'vinsma', 'czahner', 'kklacik', 'junghanlee', 'gshaw', 'sprashan', 'dulmes', 'kim130', 'Jabzg', 'sen2904', 'mhain', 'srettber', 'singapaul', 'rparisi', 'dgrothe', 'ttho', 'gzarse', 'arorar', 'terran010', 'smillies', 'joeblu', 'sbach', 'werman691', 'Fisher', 'asudibyo', 'ftanjono', 'sagadi', 'jkurasz', 'bsparson', 'bsyoder', 'lonestar', 'gjross', 'nmisiuna', 'dube0', 'nsapra', 'mwarsco', 'johns180', 'npanitch', 'freedomjustice', 'chermawi', 'akhilesh', 'atruesde', 'wnoh', 'jtill04', 'MurphyAKL', 'bdannan', 'jshahid', 'pjyoti', 'gutierjm', 'zer0xXx', 'chang61', 'acallawa', 'han45', 'longja', 'lpeterus', 'kim131', 'pmongkol', 'justinsyk', 'garg', 'jaycrayz', 'wangyangboy', 'dmmitche', None, 'gustaf89', 'pbayuart', 'wow676', 'astacy', 'pranaynanda', 'Zarastra', 'smchaudh', 'anraj', 'wehlhard', 'jidthekid', 'tdjanoko']"
17,72,11,14,1,['smillies'],9,"['lonestar', 'crosis', 'sen2904', 'rkv000', 'nsapra', 'davydotcom', 'sagadi', 'justinsyk', 'junghanlee']",13,"['thatmushroom', 'jkurasz', 'et279', 'wizdh', 'pjyoti', 'somacroy', 'ebuysse', 'mamitche', 'sonicalflair', 'chermawi', 'aforkner', None, 'dergan']",23,"['thatmushroom', 'crosis', 'et279', 'wizdh', 'pjyoti', 'rkv000', 'somacroy', 'mamitche', 'sonicalflair', 'smillies', 'davydotcom', 'sagadi', 'jkurasz', None, 'justinsyk', 'junghanlee', 'dergan', 'lonestar', 'sen2904', 'nsapra', 'ebuysse', 'chermawi', 'aforkner']"
17,70,11,9,1,['nsapra'],9,"['lonestar', 'crosis', 'sen2904', 'rkv000', 'smillies', 'davydotcom', 'sagadi', 'justinsyk', 'junghanlee']",8,"['nmisiuna', 'rtrusty', 'johns180', 'ateixeir', 'werman691', 'spaik', 'nlabianc', None]",18,"['crosis', 'rkv000', 'smillies', 'ateixeir', 'werman691', 'davydotcom', 'spaik', 'sagadi', 'nlabianc', None, 'justinsyk', 'junghanlee', 'lonestar', 'nmisiuna', 'sen2904', 'rtrusty', 'nsapra', 'johns180']"
17,73,11,7,1,['davydotcom'],9,"['lonestar', 'crosis', 'sen2904', 'rkv000', 'nsapra', 'smillies', 'sagadi', 'justinsyk', 'junghanlee']",6,"['wizdh', 'csrockerzero', 'nanohueb', 'pmongkol', None, 'mtanoto']",16,"['lonestar', 'crosis', 'sen2904', 'wizdh', 'rkv000', 'nsapra', 'csrockerzero', 'nanohueb', 'smillies', 'pmongkol', 'davydotcom', 'sagadi', 'mtanoto', None, 'justinsyk', 'junghanlee']"
19,18,11,13,3,"['jayps2005', 'watermir', 'ecewy']",7,"['vasili', 'kyban', 'kolodzey', 'lxshry', 'Vertumno', 'hauserm', 'xlong']",10,"['lyalex', 'siliconsolar', 'ningshao', 'murat83', 'colin_shaw2003', 'kunalghosh', 'easong', 'nupur', 'cpthomp', None]",20,"['kolodzey', 'ningshao', 'Vertumno', 'hauserm', 'easong', 'nupur', 'murat83', None, 'vasili', 'lyalex', 'kyban', 'ecewy', 'siliconsolar', 'jayps2005', 'lxshry', 'watermir', 'colin_shaw2003', 'kunalghosh', 'xlong', 'cpthomp']"
20,43,10,16,6,"['dubu00', 'kwos001', 'ezclub', 'bunnoi21', 'myandante1', 'dkttk4']",3,"['qdled', 'irinel_casian', 'yunliu']",10,"['kykk4', 'ytw4246', 'beahn87', 'cihee08', 'gidwldl86', 'cretalugo', 'sjsik25', 'salem', 'skku34', None]",19,"['kwos001', 'ytw4246', 'yunliu', 'ezclub', 'cihee08', 'beahn87', 'cretalugo', 'dkttk4', 'qdled', None, 'kykk4', 'dubu00', 'irinel_casian', 'gidwldl86', 'bunnoi21', 'myandante1', 'sjsik25', 'salem', 'skku34']"
21,12,10,25,2,"['tisolamp', 'jrcalver']",7,"['cbasu', 'vskhadka', 'yanyao', 'jstanislawczyk', 'razvan28', 'naty', 'awinston']",23,"['sbook', 'lachlanbadger', 'tmlowe', 'abartow', 'sfairfie', 'jbernhar', 'boersenn', 'smithmc', 'bturk', 'prrussel', 'mbosley', 'awibawa', 'mjwaters', 'skyaw', None, 'strachan', 'ehalsey', 'banglin', 'andrewotte', 'ebarriba', 'Ainshi', 'klfrank', 'abreisin']",32,"['sbook', 'lachlanbadger', 'awinston', 'tmlowe', 'abartow', 'cbasu', 'vskhadka', 'sfairfie', 'jstanislawczyk', 'jbernhar', 'tisolamp', 'naty', 'boersenn', 'smithmc', 'bturk', 'prrussel', 'mbosley', 'awibawa', 'mjwaters', 'skyaw', None, 'strachan', 'ehalsey', 'banglin', 'andrewotte', 'ebarriba', 'Ainshi', 'razvan28', 'klfrank', 'yanyao', 'abreisin', 'jrcalver']"
21,13,10,10,2,"['vskhadka', 'yanyao']",7,"['cbasu', 'jstanislawczyk', 'razvan28', 'tisolamp', 'naty', 'awinston', 'jrcalver']",8,"['mkittle', 'attn007', 'sollila', 'Ainshi', 'mjwaters', 'amalling', None, 'abreisin']",17,"['mkittle', 'mjwaters', 'amalling', 'awinston', None, 'attn007', 'cbasu', 'vskhadka', 'sollila', 'Ainshi', 'jstanislawczyk', 'razvan28', 'tisolamp', 'naty', 'yanyao', 'abreisin', 'jrcalver']"
21,14,10,7,1,['awinston'],8,"['cbasu', 'vskhadka', 'jstanislawczyk', 'razvan28', 'tisolamp', 'naty', 'yanyao', 'jrcalver']",6,"['bturk', 'mbelcher', 'awibawa', 'jptucker', 'rflynn', None]",15,"['bturk', 'mbelcher', 'cbasu', 'awibawa', 'vskhadka', 'jptucker', 'awinston', 'jstanislawczyk', 'razvan28', 'tisolamp', 'naty', 'rflynn', 'yanyao', None, 'jrcalver']"
22,43,9,16,6,"['kykk4', 'ytw4246', 'gidwldl86', 'cihee08', 'sjsik25', 'cretalugo']",2,"['gangneng82', 'meteor1024']",10,"['dubu00', 'kwos001', 'ezclub', 'bunnoi21', 'beahn87', 'myandante1', 'salem', 'dkttk4', 'skku34', None]",18,"['meteor1024', 'ytw4246', 'kwos001', 'ezclub', 'cihee08', 'beahn87', 'cretalugo', 'dkttk4', 'gangneng82', None, 'kykk4', 'dubu00', 'gidwldl86', 'bunnoi21', 'myandante1', 'sjsik25', 'salem', 'skku34']"
22,46,9,14,8,"['kykk4', 'meteor1024', 'ytw4246', 'gidwldl86', 'cihee08', 'sjsik25', 'cretalugo', 'gangneng82']",0,[],6,"['hyperlky', 'jackassman', 'salem', 'skku34', None, 'tpwlsdh']",14,"['meteor1024', 'ytw4246', 'cihee08', 'cretalugo', 'gangneng82', None, 'kykk4', 'gidwldl86', 'hyperlky', 'jackassman', 'sjsik25', 'salem', 'skku34', 'tpwlsdh']"
25,17,7,17,3,"['darrinreed', 'zencharren', 'petersonidaho']",3,"['kirkhofeling', 'Zenonas', 'angada']",14,"['aaronwozniak', 'jvalmanza', 'sahar', 'stewartsoda', 'lincstar182', 'justinbutterfield', 'dency_daniel', 'otrejo', 'DarrinReed', 'ssessi', 'hbui', 'davidknight', None, 'chrisraymes']",20,"['jvalmanza', 'angada', 'justinbutterfield', 'DarrinReed', 'darrinreed', 'petersonidaho', None, 'aaronwozniak', 'sahar', 'chrisraymes', 'stewartsoda', 'Zenonas', 'lincstar182', 'dency_daniel', 'otrejo', 'ssessi', 'hbui', 'kirkhofeling', 'zencharren', 'davidknight']"
27,1,7,9,4,"['acperkins', 'akschmitt101', 'agilmore', 'gcdecker']",2,"['booker', 'gnggu']",5,"['gkpolston', 'CWllms', 'faroseh', 'poltera2', None]",11,"['acperkins', 'agilmore', 'gcdecker', 'gkpolston', 'akschmitt101', 'booker', 'poltera2', 'faroseh', 'CWllms', 'gnggu', None]"
28,18,7,13,6,"['ningshao', 'colin_shaw2003', 'murat83', 'kunalghosh', 'nupur', 'cpthomp']",0,[],7,"['lyalex', 'ecewy', 'siliconsolar', 'jayps2005', 'watermir', 'easong', None]",13,"['ningshao', 'easong', 'nupur', 'murat83', None, 'lyalex', 'ecewy', 'siliconsolar', 'jayps2005', 'watermir', 'colin_shaw2003', 'kunalghosh', 'cpthomp']"
32,53,6,12,1,['morvaridd'],4,"['fluff', 'noriosadachika', 'iskory', 'seminente']",11,"['royj', 'grek23', 'netonim', 'anujasu', 'myztical7', 'mmellor10', 'tjgraf', 'garrettschlenvogt', 'ryanbeavers', 'moe', None]",16,"['fluff', 'anujasu', 'mmellor10', 'tjgraf', 'iskory', 'garrettschlenvogt', 'morvaridd', 'ryanbeavers', None, 'seminente', 'royj', 'grek23', 'netonim', 'myztical7', 'moe', 'noriosadachika']"
34,27,6,36,5,"['haldy', 'xsvabf00', 'KliBall', 'wing', 'Roman']",0,[],31,"['xpavlo04', 'callos', 'jardakn', 'mirek', 'magellan', 'vidan', 'xjanic06', 'xzaple12', 'jchmelik', 'xuhlar00', 'Havlicek', 'thorXL', 'nano_xtalav00', 'zeron', 'jiri_novosad', 'Pau16', 'clown', 'mage', 'vinecko', 'sulcj', None, 'jarek', 'xkrahu03', 'jiriholubcik', 'xbotko00', 'xpapez00', 'immortal', 'xmisek00', 'jendelin1', 'sedlakp', 'kubb']",36,"['xsvabf00', 'xpavlo04', 'callos', 'jardakn', 'mirek', 'magellan', 'vidan', 'xjanic06', 'xzaple12', 'haldy', 'jchmelik', 'xuhlar00', 'Havlicek', 'thorXL', 'nano_xtalav00', 'wing', 'zeron', 'jiri_novosad', 'Pau16', 'clown', 'Roman', 'mage', 'vinecko', 'sulcj', None, 'jarek', 'xkrahu03', 'jiriholubcik', 'xbotko00', 'xpapez00', 'KliBall', 'immortal', 'xmisek00', 'jendelin1', 'sedlakp', 'kubb']"
35,54,6,7,2,"['tcyeh', 'huiwen']",3,"['baudrand', 'panjoan', 'chaisant']",5,"['bhsu', 'doncr', 'hmhuang', None, 'cchl']",10,"['baudrand', 'tcyeh', 'doncr', 'bhsu', 'hmhuang', 'chaisant', 'huiwen', 'panjoan', None, 'cchl']"
36,46,6,14,3,"['tpwlsdh', 'hyperlky', 'jackassman']",2,"['padala', 'mikeohale']",11,"['kykk4', 'meteor1024', 'ytw4246', 'gidwldl86', 'cihee08', 'sjsik25', 'salem', 'cretalugo', 'skku34', 'gangneng82', None]",16,"['meteor1024', 'ytw4246', 'cihee08', 'padala', 'cretalugo', 'gangneng82', None, 'kykk4', 'mikeohale', 'gidwldl86', 'hyperlky', 'jackassman', 'sjsik25', 'salem', 'skku34', 'tpwlsdh']"
38,35,6,37,4,"['xkrahu03', 'jardakn', 'mirek', 'poolee']",1,['lumpikur'],33,"['ufyzguest', 'martingt110', 'xpavlo04', 'magellan', 'xjanic06', 'vidan', 'xzaple12', 'roman', 'jchmelik', 'jmacak', 'xuhlar00', 'Havlicek', 'xhenzl00', 'clovek', 'thorXL', 'nano_xtalav00', 'cendar', 'zeron', 'Pau16', 'clown', 'mage', 'vinecko', 'sulcj', None, 'jarek', 'jiriholubcik', 'xbotko00', 'xpapez00', 'immortal', 'jendelin1', 'sedlakp', 'poloop', 'kubb']",38,"['ufyzguest', 'martingt110', 'xpavlo04', 'jardakn', 'mirek', 'lumpikur', 'magellan', 'xjanic06', 'vidan', 'xzaple12', 'roman', 'jchmelik', 'jmacak', 'xuhlar00', 'Havlicek', 'xhenzl00', 'clovek', 'thorXL', 'nano_xtalav00', 'cendar', 'zeron', 'Pau16', 'clown', 'mage', 'vinecko', 'sulcj', None, 'jarek', 'xkrahu03', 'jiriholubcik', 'xbotko00', 'xpapez00', 'immortal', 'jendelin1', 'sedlakp', 'poloop', 'poolee', 'kubb']"
38,27,6,36,3,"['xkrahu03', 'jardakn', 'mirek']",2,"['lumpikur', 'poolee']",33,"['xsvabf00', 'xpavlo04', 'callos', 'magellan', 'vidan', 'xjanic06', 'xzaple12', 'haldy', 'jchmelik', 'xuhlar00', 'Havlicek', 'thorXL', 'nano_xtalav00', 'zeron', 'jiri_novosad', 'wing', 'Pau16', 'clown', 'Roman', 'mage', 'vinecko', 'sulcj', None, 'jarek', 'jiriholubcik', 'xbotko00', 'xpapez00', 'KliBall', 'immortal', 'xmisek00', 'jendelin1', 'sedlakp', 'kubb']",38,"['xsvabf00', 'xpavlo04', 'callos', 'jardakn', 'mirek', 'lumpikur', 'magellan', 'vidan', 'xjanic06', 'xzaple12', 'haldy', 'jchmelik', 'xuhlar00', 'Havlicek', 'thorXL', 'nano_xtalav00', 'zeron', 'jiri_novosad', 'wing', 'Pau16', 'clown', 'Roman', 'mage', 'vinecko', 'sulcj', None, 'jarek', 'xkrahu03', 'jiriholubcik', 'xbotko00', 'xpapez00', 'KliBall', 'immortal', 'xmisek00', 'jendelin1', 'sedlakp', 'poolee', 'kubb']"
38,29,6,35,1,['lumpikur'],4,"['xkrahu03', 'jardakn', 'mirek', 'poolee']",34,"['xnavra28', 'xhakto00', 'hugotek', 'susen', 'ufyzguest', 'xkubin08', 'ZdenekNo', 'majlow', 'majlos', 'xbartu', 'berzby', 'benda', 'Dallda', 'Havlicek', 'loutocky', 'xlazni05', 'jirkami', 'czkiller', 'xjanos07', 'cendar', 'reznicekm', 'xhrube00', 'kuzdaso', 'jiri_novosad', 'xjaros24', 'xzimek01', None, 'mikkiste', 'xbetla00', 'lordraia', 'sedlakp', 'xsedam00', 'poloop', 'xkroli00']",39,"['xnavra28', 'xhakto00', 'hugotek', 'susen', 'ufyzguest', 'xkubin08', 'jardakn', 'mirek', 'lumpikur', 'ZdenekNo', 'majlow', 'majlos', 'xkroli00', 'xbartu', 'berzby', 'benda', 'Dallda', 'Havlicek', 'loutocky', 'xlazni05', 'jirkami', 'czkiller', 'xjanos07', 'cendar', 'reznicekm', 'xhrube00', 'kuzdaso', 'jiri_novosad', 'xjaros24', 'xzimek01', None, 'mikkiste', 'xkrahu03', 'xbetla00', 'lordraia', 'sedlakp', 'xsedam00', 'poloop', 'poolee']"
38,44,6,33,3,"['xkrahu03', 'mirek', 'poolee']",2,"['lumpikur', 'jardakn']",30,"['ufyzguest', 'haldy123', 'xpavlo04', 'kliball', 'callos', 'xjanic06', 'xzaple12', 'roman', 'xstava05', 'djnavr', 'jchmelik', 'xuhlar00', 'Havlicek', 'thorXL', 'cendar', 'zeron', 'jiri_novosad', 'Pau16', 'clown', 'vinecko', 'sulcj', None, 'hajny', 'jiriholubcik', 'xpapez00', 'immortal', 'xmisek00', 'jendelin1', 'sedlakp', 'kubb']",35,"['ufyzguest', 'haldy123', 'xpavlo04', 'kliball', 'callos', 'jardakn', 'mirek', 'lumpikur', 'xjanic06', 'xzaple12', 'roman', 'xstava05', 'djnavr', 'jchmelik', 'xuhlar00', 'Havlicek', 'thorXL', 'cendar', 'zeron', 'jiri_novosad', 'Pau16', 'clown', 'vinecko', 'sulcj', None, 'xkrahu03', 'hajny', 'jiriholubcik', 'xpapez00', 'immortal', 'xmisek00', 'jendelin1', 'sedlakp', 'poolee', 'kubb']"
38,36,6,32,1,['lumpikur'],4,"['xkrahu03', 'jardakn', 'mirek', 'poolee']",31,"['dallda', 'xnavra28', 'koren', 'hugotek', 'susen', 'xhakto00', 'ufyzguest', 'kliball', 'Ladas_M', 'solda', 'oti', 'majlos', 'xbartu', 'berzby', 'benda', 'loutocky', 'jirkami', 'czkiller', 'reznicekm', 'rasiel', 'pekosek23', 'xhrube00', 'NosekZ', 'xjaros24', None, 'xbetla00', 'xmisek00', 'lordraia', 'sedlakp', 'xsedam00', 'xkroli00']",36,"['dallda', 'xnavra28', 'koren', 'hugotek', 'susen', 'xhakto00', 'ufyzguest', 'kliball', 'jardakn', 'mirek', 'lumpikur', 'Ladas_M', 'solda', 'oti', 'majlos', 'xkroli00', 'xbartu', 'berzby', 'benda', 'loutocky', 'jirkami', 'czkiller', 'reznicekm', 'rasiel', 'pekosek23', 'xhrube00', 'NosekZ', 'xjaros24', None, 'xkrahu03', 'xbetla00', 'xmisek00', 'lordraia', 'sedlakp', 'xsedam00', 'poolee']"
38,45,6,31,1,['jardakn'],4,"['xkrahu03', 'lumpikur', 'mirek', 'poolee']",30,"['dallda', 'xnavra28', 'xlazni05', 'Nosekz', 'jirkami', 'czkiller', 'hugotek', 'xjanos07', 'pekosek23', 'xhrube00', 'xkubin08', 'mage', 'lumir', 'krivak', 'Ladas_M', 'xjaros24', 'oti', None, 'mikkiste', 'Solda', 'majlos', 'xkroli00', 'xbartu', 'xbetla00', 'lordraia', 'berzby', 'benda', 'xholik00', 'xsedam00', 'loutocky']",35,"['dallda', 'xnavra28', 'hugotek', 'xkubin08', 'lumir', 'jardakn', 'mirek', 'lumpikur', 'krivak', 'Ladas_M', 'oti', 'majlos', 'xkroli00', 'xbartu', 'berzby', 'benda', 'loutocky', 'xlazni05', 'Nosekz', 'jirkami', 'czkiller', 'xjanos07', 'pekosek23', 'xhrube00', 'mage', 'xjaros24', None, 'mikkiste', 'xkrahu03', 'Solda', 'xbetla00', 'lordraia', 'xholik00', 'xsedam00', 'poolee']"
38,49,6,27,3,"['xkrahu03', 'mirek', 'poolee']",2,"['lumpikur', 'jardakn']",24,"['thorXL', 'nano_xtalav00', 'cendar', 'jiri_novosad', 'Pau16', 'xpavlo04', 'vinecko', 'callos', 'tomasbzonek', None, 'jarek', 'hajny', 'xjanic06', 'xzaple12', 'roman', 'jiriholubcik', 'xbotko00', 'xstava05', 'jmacak', 'immortal', 'Havlicek', 'sedlakp', 'xhenzl00', 'poloop']",29,"['xpavlo04', 'callos', 'jardakn', 'mirek', 'lumpikur', 'xjanic06', 'xzaple12', 'roman', 'xstava05', 'jmacak', 'Havlicek', 'xhenzl00', 'thorXL', 'nano_xtalav00', 'cendar', 'jiri_novosad', 'Pau16', 'vinecko', 'tomasbzonek', None, 'jarek', 'xkrahu03', 'hajny', 'jiriholubcik', 'xbotko00', 'immortal', 'sedlakp', 'poloop', 'poolee']"
