MClusterID,XClusterID,MClusterSize,XClusterSize,OverlapSize,OverlapMembers,MOnlySize,MOnlyMembers,XOnlySize,XOnlyMembers,CombinedSize,CombinedMembers
1,11,200,205,198,"['svadner', 'anderpants', 'athompsonharvey', 'mayabhardwaj', 'lixinxin', 'npetlakh', 'jtrop', 'cyarka', 'thegeoffmeister', 'dannyboy8m', 'sgrindy', 'kwang11', 'svs470', 'mbenner', 'jle703', 'jjund', 'brianchang', 'bsh319', 'matosziuk', 'kwd761', 'dcpearsall', 'cmpark', 'eklebanov', 'krich55', 'maroon_09', 'ammerocks', 'rchen', 'swolff', 'ndavidson', 'mshen2012', 'abc897', 'ddkim', 'jglass', 'omnelson', 'yleong', 'dianemok', 'mdawg777', 'alcinalidder', 'pagrawal10', 'mellis', 'bveldk06', 'irenezhanglin', 'tsa309', 'dbasco', 'tkl821', 'iezzoni21', 'ywang', 's3suggs', 'kjoshi91', 'jsharp', 'nlomotan', 'nicholas', 'cmd366', 'prajeetreddy', 'alex_625', 'dchun', 'ymalina', 'ashah', 'jtao', 'mlangille', 'ngm654', 'tsaraiya', 'dtchen', 'tzack25', 'jcasady', 'gpedrick', 'chinkmama', 'mgroner', 'phirbreethr', 'hpatel11', 'wtong', 'martabme', 'rpatel', 'shp279', 'fch308', 'athompson', 'shk2990', 'txu', 'fculver', 'aconroy', 'hyehan', 'tstanis', 'ceck', 'kmobilia', 'achadha', 'kgovindaraju', 'craak', 'jennie', 'relwood', 'eko', 'athuluvath', 'ahuang', 'emj321', 'hstafford', 'annab', 'kperkins', 'spokala', 'maffi', 'avinokur', 'mannamalai', 'mchen2012', 'mongoosehuman', 'alee', 'jkastan', 'skrilov', 'alberthong', 'nseetharaman1', 'mwise', 'asklar', 'ejen', 'emilywirtz', 'mwang', 'myu', 'shaikal', 'blindbard393', 'dpetracovici', 'rkay', 'pcarlson', 'dbtice', 'karlind', 'jschiaffino', 'camila8', 'ilin', 'kshepherd', 'mbourgeois', 'xxu', 'bmaganti', 'ltsai', 'tslayman', 'ktp618', 'noheneadu', 'acoates', 'jchu90', 'ngg760', 'mme118', 'wchang', 'luichanco', 'mpineda', 'lnur', 'devish', 'sfedorikhina', 'amalik', 'mhuff', 'past10', 'kgrimestad', 'jsoohoo', 'sarahhhong', 'msimms', 'jacquelinehwang', 'amwang', 'khaghighi', 'lywang', 'jerrylin12', 'jkrupp', 'allegramount', 'rachelrosen', 'astockdale', 'laurennelson07', 'ktsang', 'kbandi', 'nashida', 'mcee2374', 'falcon36', 'apeterson', 'jfang', 'ecadoff', 'dwalco', 'mkk749', 'aogonek', 'yxu', 'strikex2', 'cnoble', 'dmorris', 'thebombboi123', 'schirumamilla', 'dramadurai', 'hkawashima', 'ajl131', 'jkaplan', 'ltong', 'zschlieder', 'callee', 'carlherndon2011', 'bambielli', 'cberg', 'njohnson463', 'tejmotiwala', 'sshaaban', 'jshepherd', 'gthippeswamy', 'acolletti', 'mkramer', 'skang', 'dkiebala1', 'msriram', 'runfree909', 'bsegal', 'gwm166']",2,"['ahassan515', 'mwalimujim']",7,"['slhatch', 'pandagrl90', 'darora7', 'fka560', 'kblake', 'lpurcell', 'hpvbs']",207,"['npetlakh', 'jtrop', 'cyarka', 'dannyboy8m', 'kwang11', 'jle703', 'matosziuk', 'dcpearsall', 'cmpark', 'eklebanov', 'maroon_09', 'mshen2012', 'swolff', 'abc897', 'jglass', 'omnelson', 'mdawg777', 'alcinalidder', 'pagrawal10', 'lpurcell', 'mellis', 'bveldk06', 'tsa309', 'dbasco', 'tkl821', 'iezzoni21', 'ywang', 'kjoshi91', 'nlomotan', 'nicholas', 'cmd366', 'jtao', 'mlangille', 'tsaraiya', 'dtchen', 'gpedrick', 'chinkmama', 'wtong', 'martabme', 'rpatel', 'shp279', 'fch308', 'athompson', 'txu', 'hyehan', 'tstanis', 'craak', 'kmobilia', 'mwalimujim', 'jennie', 'relwood', 'athuluvath', 'ahuang', 'emj321', 'hstafford', 'annab', 'spokala', 'avinokur', 'mchen2012', 'jkastan', 'skrilov', 'rkay', 'jschiaffino', 'kshepherd', 'mbourgeois', 'xxu', 'noheneadu', 'jchu90', 'ngg760', 'mme118', 'wchang', 'devish', 'jsoohoo', 'msimms', 'jkrupp', 'allegramount', 'rachelrosen', 'astockdale', 'ktsang', 'kbandi', 'nashida', 'falcon36', 'slhatch', 'apeterson', 'ecadoff', 'dwalco', 'mkk749', 'aogonek', 'strikex2', 'thebombboi123', 'dramadurai', 'hkawashima', 'jkaplan', 'ltong', 'zschlieder', 'carlherndon2011', 'bambielli', 'cberg', 'njohnson463', 'tejmotiwala', 'pandagrl90', 'skang', 'gthippeswamy', 'mkramer', 'msriram', 'runfree909', 'bsegal', 'svadner', 'anderpants', 'athompsonharvey', 'mayabhardwaj', 'lixinxin', 'thegeoffmeister', 'sgrindy', 'svs470', 'brianchang', 'mbenner', 'jjund', 'bsh319', 'kwd761', 'krich55', 'ammerocks', 'rchen', 'ndavidson', 'ddkim', 'yleong', 'dianemok', 'irenezhanglin', 's3suggs', 'jsharp', 'prajeetreddy', 'ymalina', 'alex_625', 'dchun', 'darora7', 'kblake', 'ashah', 'ngm654', 'tzack25', 'jcasady', 'mgroner', 'phirbreethr', 'hpatel11', 'shk2990', 'fculver', 'aconroy', 'kgovindaraju', 'ceck', 'achadha', 'eko', 'kperkins', 'maffi', 'mannamalai', 'mongoosehuman', 'alee', 'alberthong', 'nseetharaman1', 'mwise', 'asklar', 'ejen', 'emilywirtz', 'mwang', 'myu', 'shaikal', 'blindbard393', 'dpetracovici', 'pcarlson', 'dbtice', 'karlind', 'hpvbs', 'camila8', 'ilin', 'bmaganti', 'ltsai', 'tslayman', 'ktp618', 'acoates', 'luichanco', 'ahassan515', 'lnur', 'sfedorikhina', 'mpineda', 'amalik', 'mhuff', 'past10', 'kgrimestad', 'sarahhhong', 'jacquelinehwang', 'amwang', 'khaghighi', 'lywang', 'jerrylin12', 'fka560', 'laurennelson07', 'mcee2374', 'jfang', 'yxu', 'cnoble', 'dmorris', 'schirumamilla', 'ajl131', 'callee', 'sshaaban', 'jshepherd', 'acolletti', 'dkiebala1', 'gwm166']"
1,69,200,204,187,"['svadner', 'anderpants', 'athompsonharvey', 'mayabhardwaj', 'lixinxin', 'npetlakh', 'jtrop', 'cyarka', 'thegeoffmeister', 'dannyboy8m', 'sgrindy', 'kwang11', 'svs470', 'mbenner', 'jle703', 'jjund', 'brianchang', 'bsh319', 'matosziuk', 'kwd761', 'dcpearsall', 'cmpark', 'eklebanov', 'krich55', 'maroon_09', 'ammerocks', 'rchen', 'swolff', 'ndavidson', 'mshen2012', 'abc897', 'ddkim', 'jglass', 'yleong', 'dianemok', 'mdawg777', 'alcinalidder', 'pagrawal10', 'mellis', 'bveldk06', 'tsa309', 'dbasco', 'tkl821', 'iezzoni21', 'ywang', 's3suggs', 'kjoshi91', 'jsharp', 'nlomotan', 'nicholas', 'cmd366', 'prajeetreddy', 'alex_625', 'dchun', 'ymalina', 'ashah', 'jtao', 'mlangille', 'ngm654', 'tsaraiya', 'dtchen', 'tzack25', 'jcasady', 'gpedrick', 'mgroner', 'phirbreethr', 'hpatel11', 'wtong', 'martabme', 'rpatel', 'shp279', 'fch308', 'athompson', 'shk2990', 'txu', 'fculver', 'aconroy', 'hyehan', 'tstanis', 'ceck', 'kmobilia', 'achadha', 'kgovindaraju', 'craak', 'jennie', 'relwood', 'eko', 'athuluvath', 'ahuang', 'emj321', 'hstafford', 'annab', 'kperkins', 'spokala', 'maffi', 'avinokur', 'mannamalai', 'mchen2012', 'alee', 'jkastan', 'alberthong', 'nseetharaman1', 'mwise', 'asklar', 'ejen', 'emilywirtz', 'mwang', 'myu', 'blindbard393', 'dpetracovici', 'rkay', 'pcarlson', 'dbtice', 'karlind', 'jschiaffino', 'camila8', 'ilin', 'kshepherd', 'mbourgeois', 'xxu', 'bmaganti', 'ltsai', 'tslayman', 'ktp618', 'noheneadu', 'acoates', 'jchu90', 'ngg760', 'mme118', 'wchang', 'luichanco', 'mpineda', 'lnur', 'devish', 'sfedorikhina', 'amalik', 'mhuff', 'past10', 'kgrimestad', 'jsoohoo', 'sarahhhong', 'msimms', 'jacquelinehwang', 'amwang', 'jerrylin12', 'lywang', 'jkrupp', 'allegramount', 'rachelrosen', 'astockdale', 'laurennelson07', 'ktsang', 'kbandi', 'nashida', 'mcee2374', 'falcon36', 'jfang', 'ecadoff', 'dwalco', 'mkk749', 'aogonek', 'yxu', 'strikex2', 'cnoble', 'thebombboi123', 'schirumamilla', 'dramadurai', 'hkawashima', 'ajl131', 'jkaplan', 'ltong', 'zschlieder', 'callee', 'carlherndon2011', 'bambielli', 'cberg', 'njohnson463', 'tejmotiwala', 'sshaaban', 'jshepherd', 'gthippeswamy', 'acolletti', 'skang', 'msriram', 'runfree909', 'bsegal', 'gwm166']",13,"['khaghighi', 'apeterson', 'mkramer', 'mongoosehuman', 'shaikal', 'skrilov', 'chinkmama', 'omnelson', 'dkiebala1', 'dmorris', 'mwalimujim', 'irenezhanglin', 'ahassan515']",17,"['ktrocin', 'mattfred', 'mkim', 'kevinhaghighi2012', 'justineshaw', 'sshah7', 'jwalters', 'mdmurray', 'kcbandi', 'jlipari', 'pantocrator', 'dcho0132', 'sbajaj', None, 'mmara', 'xwang308', 'schatz']",217,"['npetlakh', 'jtrop', 'cyarka', 'dannyboy8m', 'kwang11', 'jle703', 'matosziuk', 'dcpearsall', 'kevinhaghighi2012', 'cmpark', 'eklebanov', 'maroon_09', 'mshen2012', 'swolff', 'abc897', 'jglass', 'omnelson', 'mdawg777', 'alcinalidder', 'pagrawal10', 'mellis', 'bveldk06', 'tsa309', 'dbasco', 'tkl821', 'iezzoni21', 'ywang', 'kjoshi91', 'nlomotan', 'nicholas', 'cmd366', 'jtao', 'mlangille', 'tsaraiya', 'kcbandi', 'dtchen', 'xwang308', 'gpedrick', 'chinkmama', 'wtong', 'martabme', 'rpatel', 'shp279', 'fch308', 'athompson', 'txu', 'hyehan', 'tstanis', 'craak', 'kmobilia', 'mwalimujim', 'jennie', None, 'relwood', 'ktrocin', 'athuluvath', 'ahuang', 'emj321', 'sshah7', 'hstafford', 'pantocrator', 'annab', 'mmara', 'spokala', 'avinokur', 'mchen2012', 'jkastan', 'skrilov', 'mattfred', 'rkay', 'jschiaffino', 'kshepherd', 'mbourgeois', 'xxu', 'noheneadu', 'jchu90', 'ngg760', 'mme118', 'wchang', 'devish', 'jsoohoo', 'msimms', 'jkrupp', 'allegramount', 'rachelrosen', 'astockdale', 'ktsang', 'kbandi', 'nashida', 'falcon36', 'apeterson', 'ecadoff', 'dwalco', 'mkk749', 'aogonek', 'strikex2', 'thebombboi123', 'dramadurai', 'hkawashima', 'jkaplan', 'ltong', 'zschlieder', 'carlherndon2011', 'bambielli', 'cberg', 'njohnson463', 'tejmotiwala', 'skang', 'gthippeswamy', 'mkramer', 'mkim', 'msriram', 'runfree909', 'bsegal', 'schatz', 'svadner', 'anderpants', 'athompsonharvey', 'mayabhardwaj', 'lixinxin', 'mdmurray', 'thegeoffmeister', 'sgrindy', 'svs470', 'brianchang', 'mbenner', 'jjund', 'bsh319', 'kwd761', 'krich55', 'ammerocks', 'rchen', 'ndavidson', 'ddkim', 'yleong', 'dianemok', 'dcho0132', 'irenezhanglin', 's3suggs', 'jsharp', 'prajeetreddy', 'ymalina', 'alex_625', 'dchun', 'ashah', 'ngm654', 'tzack25', 'jcasady', 'mgroner', 'phirbreethr', 'hpatel11', 'shk2990', 'fculver', 'aconroy', 'kgovindaraju', 'ceck', 'achadha', 'eko', 'kperkins', 'maffi', 'mannamalai', 'mongoosehuman', 'alee', 'alberthong', 'nseetharaman1', 'mwise', 'asklar', 'ejen', 'emilywirtz', 'mwang', 'myu', 'shaikal', 'blindbard393', 'dpetracovici', 'pcarlson', 'dbtice', 'karlind', 'camila8', 'ilin', 'bmaganti', 'ltsai', 'tslayman', 'ktp618', 'acoates', 'luichanco', 'ahassan515', 'lnur', 'sfedorikhina', 'mpineda', 'amalik', 'mhuff', 'justineshaw', 'past10', 'kgrimestad', 'sarahhhong', 'jacquelinehwang', 'amwang', 'khaghighi', 'lywang', 'jerrylin12', 'laurennelson07', 'mcee2374', 'jfang', 'yxu', 'jlipari', 'cnoble', 'dmorris', 'schirumamilla', 'ajl131', 'callee', 'jwalters', 'sshaaban', 'jshepherd', 'acolletti', 'dkiebala1', 'sbajaj', 'gwm166']"
1,53,200,189,183,"['svadner', 'anderpants', 'athompsonharvey', 'mayabhardwaj', 'lixinxin', 'npetlakh', 'jtrop', 'cyarka', 'thegeoffmeister', 'dannyboy8m', 'sgrindy', 'kwang11', 'svs470', 'brianchang', 'jle703', 'jjund', 'mbenner', 'bsh319', 'matosziuk', 'kwd761', 'dcpearsall', 'cmpark', 'krich55', 'eklebanov', 'maroon_09', 'ammerocks', 'mshen2012', 'swolff', 'rchen', 'abc897', 'ddkim', 'jglass', 'dianemok', 'yleong', 'mdawg777', 'alcinalidder', 'pagrawal10', 'mellis', 'tsa309', 'irenezhanglin', 'dbasco', 'tkl821', 'iezzoni21', 'ywang', 's3suggs', 'kjoshi91', 'jsharp', 'nlomotan', 'nicholas', 'prajeetreddy', 'cmd366', 'dchun', 'alex_625', 'jtao', 'mlangille', 'tsaraiya', 'ngm654', 'dtchen', 'tzack25', 'jcasady', 'gpedrick', 'chinkmama', 'wtong', 'hpatel11', 'phirbreethr', 'martabme', 'shp279', 'fch308', 'athompson', 'shk2990', 'txu', 'fculver', 'aconroy', 'kgovindaraju', 'tstanis', 'achadha', 'kmobilia', 'ceck', 'mwalimujim', 'craak', 'jennie', 'relwood', 'eko', 'athuluvath', 'ahuang', 'emj321', 'hstafford', 'annab', 'kperkins', 'spokala', 'avinokur', 'mannamalai', 'maffi', 'mchen2012', 'mongoosehuman', 'jkastan', 'alee', 'skrilov', 'alberthong', 'asklar', 'mwise', 'nseetharaman1', 'ejen', 'mwang', 'myu', 'emilywirtz', 'shaikal', 'blindbard393', 'dpetracovici', 'rkay', 'pcarlson', 'karlind', 'jschiaffino', 'ilin', 'kshepherd', 'mbourgeois', 'xxu', 'bmaganti', 'ltsai', 'tslayman', 'ktp618', 'noheneadu', 'acoates', 'jchu90', 'ngg760', 'wchang', 'mme118', 'luichanco', 'mpineda', 'devish', 'amalik', 'mhuff', 'past10', 'kgrimestad', 'jsoohoo', 'sarahhhong', 'msimms', 'jacquelinehwang', 'khaghighi', 'jerrylin12', 'lywang', 'amwang', 'jkrupp', 'allegramount', 'rachelrosen', 'astockdale', 'laurennelson07', 'ktsang', 'kbandi', 'nashida', 'mcee2374', 'falcon36', 'apeterson', 'jfang', 'dwalco', 'aogonek', 'yxu', 'strikex2', 'cnoble', 'dmorris', 'thebombboi123', 'schirumamilla', 'dramadurai', 'hkawashima', 'ajl131', 'jkaplan', 'ltong', 'zschlieder', 'callee', 'carlherndon2011', 'bambielli', 'cberg', 'njohnson463', 'sshaaban', 'skang', 'mkramer', 'jshepherd', 'gthippeswamy', 'acolletti', 'msriram', 'runfree909', 'bsegal', 'gwm166']",17,"['lnur', 'ndavidson', 'sfedorikhina', 'ymalina', 'ecadoff', 'mkk749', 'omnelson', 'ashah', 'mgroner', 'hyehan', 'dkiebala1', 'dbtice', 'tejmotiwala', 'ahassan515', 'camila8', 'bveldk06', 'rpatel']",6,"['mattfred', 'mkim', 'jlipari', 'pantocrator', 'sbajaj', None]",206,"['npetlakh', 'jtrop', 'cyarka', 'dannyboy8m', 'kwang11', 'jle703', 'matosziuk', 'dcpearsall', 'cmpark', 'eklebanov', 'maroon_09', 'mshen2012', 'swolff', 'abc897', 'jglass', 'omnelson', 'mdawg777', 'alcinalidder', 'pagrawal10', 'mellis', 'bveldk06', 'tsa309', 'dbasco', 'tkl821', 'iezzoni21', 'ywang', 'kjoshi91', 'nlomotan', 'nicholas', 'cmd366', 'jtao', 'mlangille', 'tsaraiya', 'dtchen', 'gpedrick', 'chinkmama', 'wtong', 'martabme', 'rpatel', 'shp279', 'fch308', 'athompson', 'txu', 'hyehan', 'tstanis', 'craak', 'kmobilia', 'mwalimujim', 'jennie', None, 'relwood', 'athuluvath', 'ahuang', 'emj321', 'hstafford', 'pantocrator', 'annab', 'spokala', 'avinokur', 'mchen2012', 'jkastan', 'skrilov', 'mattfred', 'rkay', 'jschiaffino', 'kshepherd', 'mbourgeois', 'xxu', 'noheneadu', 'jchu90', 'ngg760', 'mme118', 'wchang', 'devish', 'jsoohoo', 'msimms', 'jkrupp', 'allegramount', 'rachelrosen', 'astockdale', 'ktsang', 'kbandi', 'nashida', 'falcon36', 'apeterson', 'ecadoff', 'dwalco', 'mkk749', 'aogonek', 'strikex2', 'thebombboi123', 'dramadurai', 'hkawashima', 'jkaplan', 'ltong', 'zschlieder', 'carlherndon2011', 'bambielli', 'cberg', 'njohnson463', 'tejmotiwala', 'skang', 'gthippeswamy', 'mkramer', 'mkim', 'msriram', 'runfree909', 'bsegal', 'svadner', 'anderpants', 'athompsonharvey', 'mayabhardwaj', 'lixinxin', 'thegeoffmeister', 'sgrindy', 'svs470', 'brianchang', 'mbenner', 'jjund', 'bsh319', 'kwd761', 'krich55', 'ammerocks', 'rchen', 'ndavidson', 'ddkim', 'yleong', 'dianemok', 'irenezhanglin', 's3suggs', 'jsharp', 'prajeetreddy', 'ymalina', 'alex_625', 'dchun', 'ashah', 'ngm654', 'tzack25', 'jcasady', 'mgroner', 'phirbreethr', 'hpatel11', 'shk2990', 'fculver', 'aconroy', 'kgovindaraju', 'ceck', 'achadha', 'eko', 'kperkins', 'maffi', 'mannamalai', 'mongoosehuman', 'alee', 'alberthong', 'nseetharaman1', 'mwise', 'asklar', 'ejen', 'emilywirtz', 'mwang', 'myu', 'shaikal', 'blindbard393', 'dpetracovici', 'pcarlson', 'dbtice', 'karlind', 'camila8', 'ilin', 'bmaganti', 'ltsai', 'tslayman', 'ktp618', 'acoates', 'luichanco', 'ahassan515', 'lnur', 'sfedorikhina', 'mpineda', 'amalik', 'mhuff', 'past10', 'kgrimestad', 'sarahhhong', 'jacquelinehwang', 'amwang', 'khaghighi', 'lywang', 'jerrylin12', 'laurennelson07', 'mcee2374', 'jfang', 'yxu', 'jlipari', 'cnoble', 'dmorris', 'schirumamilla', 'ajl131', 'callee', 'sshaaban', 'jshepherd', 'acolletti', 'dkiebala1', 'sbajaj', 'gwm166']"
1,52,200,10,3,"['dbtice', 'bveldk06', 'matosziuk']",197,"['svadner', 'anderpants', 'athompsonharvey', 'mayabhardwaj', 'lixinxin', 'npetlakh', 'jtrop', 'cyarka', 'thegeoffmeister', 'dannyboy8m', 'sgrindy', 'kwang11', 'svs470', 'brianchang', 'jle703', 'jjund', 'mbenner', 'bsh319', 'kwd761', 'dcpearsall', 'cmpark', 'eklebanov', 'krich55', 'maroon_09', 'ammerocks', 'rchen', 'swolff', 'ndavidson', 'mshen2012', 'abc897', 'ddkim', 'jglass', 'omnelson', 'yleong', 'dianemok', 'mdawg777', 'alcinalidder', 'pagrawal10', 'mellis', 'irenezhanglin', 'tsa309', 'dbasco', 'tkl821', 'iezzoni21', 'ywang', 's3suggs', 'kjoshi91', 'jsharp', 'nlomotan', 'nicholas', 'cmd366', 'prajeetreddy', 'alex_625', 'dchun', 'ymalina', 'ashah', 'jtao', 'mlangille', 'ngm654', 'tsaraiya', 'dtchen', 'tzack25', 'jcasady', 'gpedrick', 'chinkmama', 'mgroner', 'phirbreethr', 'hpatel11', 'wtong', 'martabme', 'rpatel', 'shp279', 'fch308', 'athompson', 'shk2990', 'txu', 'fculver', 'aconroy', 'hyehan', 'tstanis', 'ceck', 'kmobilia', 'achadha', 'mwalimujim', 'kgovindaraju', 'craak', 'jennie', 'relwood', 'eko', 'athuluvath', 'ahuang', 'emj321', 'hstafford', 'annab', 'kperkins', 'spokala', 'maffi', 'avinokur', 'mannamalai', 'mchen2012', 'mongoosehuman', 'alee', 'jkastan', 'skrilov', 'alberthong', 'nseetharaman1', 'mwise', 'asklar', 'ejen', 'emilywirtz', 'mwang', 'myu', 'shaikal', 'blindbard393', 'dpetracovici', 'rkay', 'pcarlson', 'karlind', 'jschiaffino', 'camila8', 'ilin', 'kshepherd', 'mbourgeois', 'xxu', 'bmaganti', 'ltsai', 'tslayman', 'ktp618', 'noheneadu', 'acoates', 'jchu90', 'ngg760', 'mme118', 'wchang', 'luichanco', 'ahassan515', 'lnur', 'devish', 'sfedorikhina', 'mpineda', 'amalik', 'mhuff', 'past10', 'kgrimestad', 'jsoohoo', 'sarahhhong', 'msimms', 'jacquelinehwang', 'amwang', 'khaghighi', 'lywang', 'jerrylin12', 'jkrupp', 'allegramount', 'rachelrosen', 'astockdale', 'laurennelson07', 'ktsang', 'kbandi', 'nashida', 'mcee2374', 'falcon36', 'apeterson', 'jfang', 'ecadoff', 'dwalco', 'mkk749', 'aogonek', 'yxu', 'strikex2', 'cnoble', 'dmorris', 'thebombboi123', 'schirumamilla', 'dramadurai', 'hkawashima', 'ajl131', 'jkaplan', 'ltong', 'zschlieder', 'callee', 'carlherndon2011', 'bambielli', 'cberg', 'njohnson463', 'tejmotiwala', 'sshaaban', 'jshepherd', 'gthippeswamy', 'acolletti', 'mkramer', 'skang', 'dkiebala1', 'msriram', 'runfree909', 'bsegal', 'gwm166']",7,"['pretenderjl', 'mattfred', 'emilieringe', 'jklemp', 'sml257', 'jdicke', None]",207,"['svadner', 'anderpants', 'athompsonharvey', 'mayabhardwaj', 'lixinxin', 'npetlakh', 'jtrop', 'cyarka', 'thegeoffmeister', 'dannyboy8m', 'sgrindy', 'kwang11', 'svs470', 'brianchang', 'jle703', 'jjund', 'mbenner', 'bsh319', 'matosziuk', 'kwd761', 'dcpearsall', 'cmpark', 'eklebanov', 'krich55', 'maroon_09', 'ammerocks', 'rchen', 'swolff', 'ndavidson', 'mshen2012', 'abc897', 'ddkim', 'jglass', 'omnelson', 'yleong', 'dianemok', 'mdawg777', 'alcinalidder', 'pagrawal10', 'mellis', 'bveldk06', 'irenezhanglin', 'tsa309', 'dbasco', 'tkl821', 'iezzoni21', 'ywang', 's3suggs', 'kjoshi91', 'jsharp', 'nlomotan', 'nicholas', 'cmd366', 'prajeetreddy', 'alex_625', 'dchun', 'ymalina', 'ashah', 'jtao', 'mlangille', 'ngm654', 'tsaraiya', 'dtchen', 'tzack25', 'jcasady', 'emilieringe', 'gpedrick', 'chinkmama', 'mgroner', 'jklemp', 'jdicke', 'phirbreethr', 'hpatel11', 'wtong', 'martabme', 'rpatel', 'shp279', 'fch308', 'athompson', 'shk2990', 'txu', 'fculver', 'aconroy', 'hyehan', 'tstanis', 'ceck', 'kmobilia', 'achadha', 'mwalimujim', 'kgovindaraju', 'craak', 'jennie', None, 'relwood', 'eko', 'athuluvath', 'ahuang', 'emj321', 'hstafford', 'annab', 'kperkins', 'spokala', 'maffi', 'avinokur', 'mannamalai', 'mchen2012', 'mongoosehuman', 'alee', 'jkastan', 'skrilov', 'alberthong', 'nseetharaman1', 'mwise', 'asklar', 'ejen', 'emilywirtz', 'mwang', 'myu', 'shaikal', 'mattfred', 'blindbard393', 'dpetracovici', 'rkay', 'pcarlson', 'dbtice', 'karlind', 'jschiaffino', 'camila8', 'ilin', 'kshepherd', 'mbourgeois', 'xxu', 'bmaganti', 'ltsai', 'tslayman', 'ktp618', 'sml257', 'noheneadu', 'acoates', 'jchu90', 'ngg760', 'mme118', 'wchang', 'luichanco', 'ahassan515', 'lnur', 'devish', 'sfedorikhina', 'mpineda', 'amalik', 'mhuff', 'past10', 'kgrimestad', 'jsoohoo', 'sarahhhong', 'msimms', 'jacquelinehwang', 'amwang', 'khaghighi', 'lywang', 'jerrylin12', 'jkrupp', 'allegramount', 'rachelrosen', 'astockdale', 'laurennelson07', 'ktsang', 'kbandi', 'nashida', 'mcee2374', 'falcon36', 'apeterson', 'jfang', 'ecadoff', 'dwalco', 'mkk749', 'aogonek', 'yxu', 'strikex2', 'cnoble', 'dmorris', 'thebombboi123', 'schirumamilla', 'dramadurai', 'hkawashima', 'ajl131', 'jkaplan', 'pretenderjl', 'ltong', 'zschlieder', 'callee', 'carlherndon2011', 'bambielli', 'cberg', 'njohnson463', 'tejmotiwala', 'sshaaban', 'jshepherd', 'gthippeswamy', 'acolletti', 'mkramer', 'skang', 'dkiebala1', 'msriram', 'runfree909', 'bsegal', 'gwm166']"
1,70,200,10,9,"['ndavidson', 'acolletti', 'allegramount', 'nicholas', 'kmobilia', 'thegeoffmeister', 'asklar', 'mcee2374', 'ahassan515']",191,"['svadner', 'anderpants', 'athompsonharvey', 'mayabhardwaj', 'lixinxin', 'npetlakh', 'jtrop', 'cyarka', 'dannyboy8m', 'sgrindy', 'kwang11', 'svs470', 'brianchang', 'jle703', 'jjund', 'mbenner', 'bsh319', 'matosziuk', 'kwd761', 'dcpearsall', 'cmpark', 'eklebanov', 'krich55', 'maroon_09', 'ammerocks', 'rchen', 'swolff', 'mshen2012', 'abc897', 'ddkim', 'jglass', 'omnelson', 'yleong', 'dianemok', 'mdawg777', 'alcinalidder', 'pagrawal10', 'mellis', 'bveldk06', 'irenezhanglin', 'tsa309', 'dbasco', 'tkl821', 'iezzoni21', 'ywang', 's3suggs', 'kjoshi91', 'jsharp', 'nlomotan', 'cmd366', 'prajeetreddy', 'alex_625', 'dchun', 'ymalina', 'ashah', 'jtao', 'mlangille', 'ngm654', 'tsaraiya', 'dtchen', 'tzack25', 'jcasady', 'gpedrick', 'chinkmama', 'mgroner', 'phirbreethr', 'hpatel11', 'wtong', 'martabme', 'rpatel', 'shp279', 'fch308', 'athompson', 'shk2990', 'txu', 'fculver', 'aconroy', 'hyehan', 'tstanis', 'ceck', 'achadha', 'mwalimujim', 'kgovindaraju', 'craak', 'jennie', 'relwood', 'eko', 'athuluvath', 'ahuang', 'emj321', 'hstafford', 'annab', 'kperkins', 'spokala', 'maffi', 'avinokur', 'mannamalai', 'mchen2012', 'mongoosehuman', 'alee', 'jkastan', 'skrilov', 'alberthong', 'nseetharaman1', 'mwise', 'ejen', 'emilywirtz', 'mwang', 'myu', 'shaikal', 'blindbard393', 'dpetracovici', 'rkay', 'pcarlson', 'dbtice', 'karlind', 'jschiaffino', 'camila8', 'ilin', 'kshepherd', 'mbourgeois', 'xxu', 'bmaganti', 'ltsai', 'tslayman', 'ktp618', 'noheneadu', 'acoates', 'jchu90', 'ngg760', 'mme118', 'wchang', 'luichanco', 'lnur', 'devish', 'sfedorikhina', 'mpineda', 'amalik', 'mhuff', 'past10', 'kgrimestad', 'jsoohoo', 'sarahhhong', 'msimms', 'jacquelinehwang', 'amwang', 'khaghighi', 'lywang', 'jerrylin12', 'jkrupp', 'rachelrosen', 'astockdale', 'laurennelson07', 'ktsang', 'kbandi', 'nashida', 'falcon36', 'apeterson', 'jfang', 'ecadoff', 'dwalco', 'mkk749', 'aogonek', 'yxu', 'strikex2', 'cnoble', 'dmorris', 'thebombboi123', 'schirumamilla', 'dramadurai', 'hkawashima', 'ajl131', 'jkaplan', 'ltong', 'zschlieder', 'callee', 'carlherndon2011', 'bambielli', 'cberg', 'njohnson463', 'tejmotiwala', 'sshaaban', 'jshepherd', 'gthippeswamy', 'mkramer', 'skang', 'dkiebala1', 'msriram', 'runfree909', 'bsegal', 'gwm166']",1,[None],201,"['svadner', 'anderpants', 'athompsonharvey', 'mayabhardwaj', 'lixinxin', 'npetlakh', 'jtrop', 'cyarka', 'thegeoffmeister', 'dannyboy8m', 'sgrindy', 'kwang11', 'svs470', 'brianchang', 'jle703', 'jjund', 'mbenner', 'bsh319', 'matosziuk', 'kwd761', 'dcpearsall', 'cmpark', 'eklebanov', 'krich55', 'maroon_09', 'ammerocks', 'rchen', 'swolff', 'ndavidson', 'mshen2012', 'abc897', 'ddkim', 'jglass', 'omnelson', 'yleong', 'dianemok', 'mdawg777', 'alcinalidder', 'pagrawal10', 'mellis', 'bveldk06', 'irenezhanglin', 'tsa309', 'dbasco', 'tkl821', 'iezzoni21', 'ywang', 's3suggs', 'kjoshi91', 'jsharp', 'nlomotan', 'nicholas', 'cmd366', 'prajeetreddy', 'alex_625', 'dchun', 'ymalina', 'ashah', 'jtao', 'mlangille', 'ngm654', 'tsaraiya', 'dtchen', 'tzack25', 'jcasady', 'gpedrick', 'chinkmama', 'mgroner', 'phirbreethr', 'hpatel11', 'wtong', 'martabme', 'rpatel', 'shp279', 'fch308', 'athompson', 'shk2990', 'txu', 'fculver', 'aconroy', 'hyehan', 'tstanis', 'ceck', 'kmobilia', 'achadha', 'mwalimujim', 'kgovindaraju', 'craak', 'jennie', None, 'relwood', 'eko', 'athuluvath', 'ahuang', 'emj321', 'hstafford', 'annab', 'kperkins', 'spokala', 'maffi', 'avinokur', 'mannamalai', 'mchen2012', 'mongoosehuman', 'alee', 'jkastan', 'skrilov', 'alberthong', 'nseetharaman1', 'mwise', 'asklar', 'ejen', 'emilywirtz', 'mwang', 'myu', 'shaikal', 'blindbard393', 'dpetracovici', 'rkay', 'pcarlson', 'dbtice', 'karlind', 'jschiaffino', 'camila8', 'ilin', 'kshepherd', 'mbourgeois', 'xxu', 'bmaganti', 'ltsai', 'tslayman', 'ktp618', 'noheneadu', 'acoates', 'jchu90', 'ngg760', 'mme118', 'wchang', 'luichanco', 'ahassan515', 'lnur', 'devish', 'sfedorikhina', 'mpineda', 'amalik', 'mhuff', 'past10', 'kgrimestad', 'jsoohoo', 'sarahhhong', 'msimms', 'jacquelinehwang', 'amwang', 'khaghighi', 'lywang', 'jerrylin12', 'jkrupp', 'allegramount', 'rachelrosen', 'astockdale', 'laurennelson07', 'ktsang', 'kbandi', 'nashida', 'mcee2374', 'falcon36', 'apeterson', 'jfang', 'ecadoff', 'dwalco', 'mkk749', 'aogonek', 'yxu', 'strikex2', 'cnoble', 'dmorris', 'thebombboi123', 'schirumamilla', 'dramadurai', 'hkawashima', 'ajl131', 'jkaplan', 'ltong', 'zschlieder', 'callee', 'carlherndon2011', 'bambielli', 'cberg', 'njohnson463', 'tejmotiwala', 'sshaaban', 'jshepherd', 'gthippeswamy', 'acolletti', 'mkramer', 'skang', 'dkiebala1', 'msriram', 'runfree909', 'bsegal', 'gwm166']"
2,28,60,51,45,"['mokomi89', 'coxcj', 'drgrove', 'fashnicked87', 'swan12', 'kirst', 'wilsonn', 'tepowers', 'jfbrenna', 'jmknowle', 'bishopad', 'hsale', 'jones118', 'jroush', 'jquinlan', 'bmschult', 'mduffey', 'asankar', 'mjablons', 'akremer', 'rlass1', 'alentner12', 'lbehrens', 'floydm', 'dchung88', 'alimiadi', 'mcwatty', 'sjnichol', 'svpeders', 'jjconnol', 'rfkoehle', 'holta', 'ssehr', 'sajordan', 'acimarol', 'bphester1', 'jswarner', 'mbenadum', 'tfigg', 'nheymer', 'ipayne', 'duktaip26', 'torstenmschreiber89', 'jthancoc', 'mwjensen']",14,"['boiler19', 'cmcclear982', 'efohl', 'christaj', 'mtoomey', 'griffijl', 'mille273', 'zrgeorge', 'bluegreentwo', 'heginator16', 'bcnewman', 'clyons', 'meg5994', 'brennanm']",6,"['eelpers', 'strachan', 'goyalp', 'gbechtol', 'apalaria', None]",65,"['boiler19', 'mokomi89', 'efohl', 'coxcj', 'christaj', 'wilsonn', 'goyalp', 'jfbrenna', 'jmknowle', 'bishopad', 'hsale', 'eelpers', 'jones118', 'jroush', 'jquinlan', 'mduffey', 'asankar', 'zrgeorge', 'dchung88', 'sjnichol', 'svpeders', 'holta', 'rfkoehle', 'clyons', 'mbenadum', 'tfigg', 'strachan', 'duktaip26', 'torstenmschreiber89', 'drgrove', 'fashnicked87', 'swan12', 'kirst', 'mtoomey', 'mille273', 'tepowers', 'apalaria', 'brennanm', 'cmcclear982', 'bmschult', 'mjablons', 'rlass1', 'akremer', 'alentner12', 'bluegreentwo', 'lbehrens', 'floydm', 'alimiadi', 'mcwatty', 'jjconnol', 'ssehr', 'sajordan', 'bcnewman', 'acimarol', 'bphester1', None, 'jswarner', 'nheymer', 'ipayne', 'gbechtol', 'griffijl', 'heginator16', 'meg5994', 'jthancoc', 'mwjensen']"
2,27,60,6,3,"['mille273', 'christaj', 'brennanm']",56,"['boiler19', 'mokomi89', 'efohl', 'coxcj', 'drgrove', 'fashnicked87', 'swan12', 'kirst', 'wilsonn', 'mtoomey', 'tepowers', 'jfbrenna', 'jmknowle', 'bishopad', 'hsale', 'cmcclear982', 'jones118', 'jroush', 'jquinlan', 'mduffey', 'asankar', 'bmschult', 'mjablons', 'rlass1', 'akremer', 'alentner12', 'zrgeorge', 'bluegreentwo', 'lbehrens', 'floydm', 'dchung88', 'alimiadi', 'mcwatty', 'sjnichol', 'svpeders', 'jjconnol', 'rfkoehle', 'holta', 'ssehr', 'sajordan', 'bcnewman', 'acimarol', 'clyons', 'bphester1', 'jswarner', 'mbenadum', 'tfigg', 'nheymer', 'duktaip26', 'ipayne', 'torstenmschreiber89', 'griffijl', 'heginator16', 'meg5994', 'jthancoc', 'mwjensen']",3,"[None, 'nlanders', 'shcheng']",62,"['boiler19', 'mokomi89', 'efohl', 'coxcj', 'drgrove', 'fashnicked87', 'swan12', 'kirst', 'christaj', 'wilsonn', 'mtoomey', 'mille273', 'tepowers', 'jfbrenna', 'jmknowle', 'bishopad', 'brennanm', 'hsale', 'cmcclear982', 'jones118', 'jroush', 'jquinlan', 'mduffey', 'asankar', 'bmschult', 'mjablons', 'rlass1', 'akremer', 'alentner12', 'zrgeorge', 'bluegreentwo', 'lbehrens', 'floydm', 'dchung88', 'alimiadi', 'mcwatty', 'sjnichol', 'svpeders', 'jjconnol', 'rfkoehle', 'holta', 'nlanders', 'ssehr', 'sajordan', 'bcnewman', 'acimarol', 'clyons', 'bphester1', None, 'jswarner', 'mbenadum', 'tfigg', 'shcheng', 'nheymer', 'duktaip26', 'ipayne', 'torstenmschreiber89', 'griffijl', 'heginator16', 'meg5994', 'jthancoc', 'mwjensen']"
3,60,48,30,26,"['nhamer2', 'vauger2', 'shossei2', 'aknecht', 'rsteinm2', 'bigperm247', 'esunny2', 'hrao3', 'nrivera2', 'twei2', 'sramin3', 'msachtl2', 'rbalik', 'hrshah2', 'akeene3', 'twicken2', 'chenchen', 'ssharma7', 'witriew', 'jlee207', 'akale', 'bridgwater', 'jmayen2', 'nvaccar2', 'ee21yin', 'png2']",21,"['ajschoch', 'acallawa', 'pwitkow2', 'dsherid3', 'mstephe2', 'jookalook', 'rykothari', 'zchng2', 'nosonwan', 'kwing', 'mlao2', 'crtaylor', 'cui4', 'spencemitch05', 'tesler2', 'desimmon', 'swong', 'dapeters', 'towster2', 'abhiahuja', 'jamorale']",4,"['okushad2', 'cbrauwe2', None, 'clong1']",51,"['nhamer2', 'ajschoch', 'shossei2', 'acallawa', 'rsteinm2', 'clong1', 'esunny2', 'hrao3', 'twei2', 'jookalook', 'rbalik', 'hrshah2', 'cbrauwe2', 'twicken2', 'nosonwan', 'chenchen', 'crtaylor', 'cui4', 'bridgwater', 'ee21yin', 'abhiahuja', 'vauger2', 'aknecht', 'pwitkow2', 'dsherid3', 'mstephe2', 'bigperm247', 'nrivera2', 'sramin3', 'okushad2', 'msachtl2', 'rykothari', 'akeene3', 'zchng2', 'kwing', 'ssharma7', 'witriew', 'jlee207', 'akale', 'mlao2', None, 'spencemitch05', 'desimmon', 'swong', 'tesler2', 'dapeters', 'jmayen2', 'nvaccar2', 'towster2', 'png2', 'jamorale']"
3,16,48,26,22,"['nhamer2', 'aknecht', 'dsherid3', 'rsteinm2', 'bigperm247', 'nrivera2', 'hrao3', 'twei2', 'msachtl2', 'hrshah2', 'akeene3', 'twicken2', 'zchng2', 'chenchen', 'ssharma7', 'jlee207', 'bridgwater', 'tesler2', 'jmayen2', 'towster2', 'ee21yin', 'png2']",25,"['vauger2', 'ajschoch', 'shossei2', 'acallawa', 'pwitkow2', 'mstephe2', 'esunny2', 'sramin3', 'jookalook', 'rykothari', 'rbalik', 'nosonwan', 'kwing', 'witriew', 'akale', 'mlao2', 'crtaylor', 'cui4', 'spencemitch05', 'swong', 'desimmon', 'dapeters', 'nvaccar2', 'abhiahuja', 'jamorale']",4,"['cbrauwe2', 'jrlange2', None, 'choquette']",51,"['nhamer2', 'vauger2', 'ajschoch', 'jrlange2', 'shossei2', 'acallawa', 'aknecht', 'pwitkow2', 'dsherid3', 'choquette', 'rsteinm2', 'mstephe2', 'bigperm247', 'esunny2', 'nrivera2', 'hrao3', 'twei2', 'sramin3', 'jookalook', 'msachtl2', 'rykothari', 'rbalik', 'hrshah2', 'akeene3', 'cbrauwe2', 'twicken2', 'zchng2', 'nosonwan', 'chenchen', 'kwing', 'ssharma7', 'witriew', 'jlee207', 'akale', 'mlao2', 'crtaylor', 'spencemitch05', 'cui4', 'swong', 'bridgwater', 'tesler2', 'desimmon', None, 'dapeters', 'jmayen2', 'nvaccar2', 'towster2', 'ee21yin', 'png2', 'abhiahuja', 'jamorale']"
3,15,48,20,9,"['ajschoch', 'cui4', 'nosonwan', 'dapeters', 'acallawa', 'kwing', 'abhiahuja', 'spencemitch05', 'jamorale']",38,"['nhamer2', 'vauger2', 'shossei2', 'pwitkow2', 'aknecht', 'dsherid3', 'rsteinm2', 'mstephe2', 'bigperm247', 'esunny2', 'nrivera2', 'hrao3', 'twei2', 'sramin3', 'jookalook', 'msachtl2', 'rykothari', 'rbalik', 'hrshah2', 'akeene3', 'twicken2', 'zchng2', 'chenchen', 'ssharma7', 'witriew', 'jlee207', 'akale', 'mlao2', 'crtaylor', 'desimmon', 'swong', 'bridgwater', 'tesler2', 'jmayen2', 'nvaccar2', 'towster2', 'ee21yin', 'png2']",11,"['crisley', 'cloeffle', 'kim130', 'mrockey', 'warz00', 'mjbarton', 'winnie', 'yunjinmail2', 'psavkar', None, 'datrain1010']",58,"['nhamer2', 'vauger2', 'ajschoch', 'crisley', 'shossei2', 'acallawa', 'aknecht', 'pwitkow2', 'mrockey', 'dsherid3', 'rsteinm2', 'mstephe2', 'yunjinmail2', 'psavkar', 'bigperm247', 'esunny2', 'nrivera2', 'hrao3', 'twei2', 'sramin3', 'jookalook', 'msachtl2', 'rykothari', 'mjbarton', 'rbalik', 'hrshah2', 'akeene3', 'datrain1010', 'cloeffle', 'twicken2', 'zchng2', 'nosonwan', 'chenchen', 'kwing', 'ssharma7', 'warz00', 'witriew', 'jlee207', 'winnie', 'akale', 'mlao2', 'crtaylor', 'spencemitch05', 'cui4', 'swong', 'bridgwater', 'tesler2', 'desimmon', None, 'kim130', 'dapeters', 'jmayen2', 'nvaccar2', 'towster2', 'ee21yin', 'png2', 'abhiahuja', 'jamorale']"
3,17,48,17,13,"['nhamer2', 'vauger2', 'nrivera2', 'esunny2', 'zchng2', 'sramin3', 'rykothari', 'witriew', 'jlee207', 'akale', 'png2', 'mlao2', 'tesler2']",34,"['ajschoch', 'shossei2', 'acallawa', 'aknecht', 'pwitkow2', 'dsherid3', 'rsteinm2', 'mstephe2', 'bigperm247', 'hrao3', 'twei2', 'jookalook', 'msachtl2', 'rbalik', 'hrshah2', 'akeene3', 'twicken2', 'nosonwan', 'chenchen', 'kwing', 'ssharma7', 'crtaylor', 'spencemitch05', 'cui4', 'swong', 'bridgwater', 'desimmon', 'dapeters', 'jmayen2', 'nvaccar2', 'towster2', 'ee21yin', 'abhiahuja', 'jamorale']",4,"['szuster2', 'powguma', 'jrlange2', None]",51,"['nhamer2', 'vauger2', 'ajschoch', 'jrlange2', 'shossei2', 'acallawa', 'aknecht', 'pwitkow2', 'dsherid3', 'rsteinm2', 'mstephe2', 'bigperm247', 'szuster2', 'esunny2', 'nrivera2', 'hrao3', 'twei2', 'sramin3', 'jookalook', 'msachtl2', 'rykothari', 'rbalik', 'hrshah2', 'akeene3', 'twicken2', 'zchng2', 'nosonwan', 'chenchen', 'kwing', 'ssharma7', 'witriew', 'jlee207', 'akale', 'mlao2', 'crtaylor', 'spencemitch05', 'cui4', 'swong', 'bridgwater', 'tesler2', 'desimmon', None, 'dapeters', 'jmayen2', 'powguma', 'nvaccar2', 'towster2', 'ee21yin', 'png2', 'abhiahuja', 'jamorale']"
3,61,48,16,10,"['vauger2', 'esunny2', 'zchng2', 'sramin3', 'jmayen2', 'swong', 'rykothari', 'akale', 'hrshah2', 'tesler2']",37,"['nhamer2', 'ajschoch', 'shossei2', 'acallawa', 'aknecht', 'pwitkow2', 'dsherid3', 'rsteinm2', 'mstephe2', 'bigperm247', 'nrivera2', 'hrao3', 'twei2', 'jookalook', 'msachtl2', 'rbalik', 'akeene3', 'twicken2', 'nosonwan', 'chenchen', 'kwing', 'ssharma7', 'witriew', 'jlee207', 'mlao2', 'crtaylor', 'spencemitch05', 'cui4', 'bridgwater', 'desimmon', 'dapeters', 'nvaccar2', 'towster2', 'ee21yin', 'png2', 'abhiahuja', 'jamorale']",6,"['szuster2', 'ekavurma', 'powguma', 'eradiri2', None, 'crallen']",53,"['nhamer2', 'vauger2', 'ajschoch', 'shossei2', 'acallawa', 'aknecht', 'pwitkow2', 'dsherid3', 'rsteinm2', 'mstephe2', 'bigperm247', 'szuster2', 'esunny2', 'nrivera2', 'hrao3', 'twei2', 'sramin3', 'jookalook', 'msachtl2', 'rykothari', 'rbalik', 'hrshah2', 'akeene3', 'twicken2', 'zchng2', 'nosonwan', 'ekavurma', 'chenchen', 'kwing', 'ssharma7', 'witriew', 'jlee207', 'akale', 'mlao2', 'eradiri2', 'crtaylor', 'spencemitch05', 'cui4', 'swong', 'bridgwater', 'tesler2', 'desimmon', None, 'crallen', 'dapeters', 'jmayen2', 'powguma', 'nvaccar2', 'towster2', 'ee21yin', 'png2', 'abhiahuja', 'jamorale']"
3,59,48,13,9,"['ajschoch', 'cui4', 'nosonwan', 'dapeters', 'acallawa', 'kwing', 'abhiahuja', 'spencemitch05', 'jamorale']",38,"['nhamer2', 'vauger2', 'shossei2', 'pwitkow2', 'aknecht', 'dsherid3', 'rsteinm2', 'mstephe2', 'bigperm247', 'esunny2', 'nrivera2', 'hrao3', 'twei2', 'sramin3', 'jookalook', 'msachtl2', 'rykothari', 'rbalik', 'hrshah2', 'akeene3', 'twicken2', 'zchng2', 'chenchen', 'ssharma7', 'witriew', 'jlee207', 'akale', 'mlao2', 'crtaylor', 'desimmon', 'swong', 'bridgwater', 'tesler2', 'jmayen2', 'nvaccar2', 'towster2', 'ee21yin', 'png2']",4,"['smohapat', 'miltownboiler', 'jwetheri', None]",51,"['nhamer2', 'vauger2', 'ajschoch', 'shossei2', 'acallawa', 'aknecht', 'pwitkow2', 'miltownboiler', 'dsherid3', 'rsteinm2', 'mstephe2', 'bigperm247', 'esunny2', 'nrivera2', 'hrao3', 'twei2', 'sramin3', 'jookalook', 'msachtl2', 'rykothari', 'jwetheri', 'rbalik', 'hrshah2', 'akeene3', 'twicken2', 'zchng2', 'nosonwan', 'chenchen', 'kwing', 'ssharma7', 'witriew', 'jlee207', 'smohapat', 'akale', 'mlao2', 'crtaylor', 'spencemitch05', 'cui4', 'swong', 'bridgwater', 'tesler2', 'desimmon', None, 'dapeters', 'jmayen2', 'nvaccar2', 'towster2', 'ee21yin', 'png2', 'abhiahuja', 'jamorale']"
3,62,48,12,9,"['nhamer2', 'jookalook', 'shossei2', 'pwitkow2', 'rykothari', 'dsherid3', 'towster2', 'mlao2', 'bridgwater']",38,"['vauger2', 'ajschoch', 'acallawa', 'aknecht', 'rsteinm2', 'mstephe2', 'bigperm247', 'esunny2', 'nrivera2', 'hrao3', 'twei2', 'sramin3', 'msachtl2', 'rbalik', 'hrshah2', 'akeene3', 'twicken2', 'zchng2', 'nosonwan', 'chenchen', 'kwing', 'ssharma7', 'witriew', 'jlee207', 'akale', 'crtaylor', 'spencemitch05', 'cui4', 'swong', 'tesler2', 'desimmon', 'dapeters', 'jmayen2', 'nvaccar2', 'ee21yin', 'png2', 'abhiahuja', 'jamorale']",3,"['singleelectron', None, 'tbublik']",50,"['nhamer2', 'vauger2', 'ajschoch', 'shossei2', 'acallawa', 'aknecht', 'pwitkow2', 'dsherid3', 'rsteinm2', 'mstephe2', 'bigperm247', 'esunny2', 'nrivera2', 'hrao3', 'twei2', 'sramin3', 'jookalook', 'msachtl2', 'rykothari', 'rbalik', 'hrshah2', 'akeene3', 'twicken2', 'zchng2', 'nosonwan', 'chenchen', 'kwing', 'ssharma7', 'witriew', 'jlee207', 'akale', 'mlao2', 'crtaylor', 'spencemitch05', 'cui4', 'swong', 'bridgwater', 'tesler2', 'desimmon', 'singleelectron', None, 'tbublik', 'dapeters', 'jmayen2', 'nvaccar2', 'towster2', 'ee21yin', 'png2', 'abhiahuja', 'jamorale']"
3,63,48,12,9,"['ajschoch', 'cui4', 'dapeters', 'acallawa', 'kwing', 'abhiahuja', 'crtaylor', 'spencemitch05', 'jamorale']",38,"['nhamer2', 'vauger2', 'shossei2', 'pwitkow2', 'aknecht', 'dsherid3', 'rsteinm2', 'mstephe2', 'bigperm247', 'esunny2', 'nrivera2', 'hrao3', 'twei2', 'sramin3', 'jookalook', 'msachtl2', 'rykothari', 'rbalik', 'hrshah2', 'akeene3', 'twicken2', 'zchng2', 'nosonwan', 'chenchen', 'ssharma7', 'witriew', 'jlee207', 'akale', 'mlao2', 'desimmon', 'swong', 'bridgwater', 'tesler2', 'jmayen2', 'nvaccar2', 'towster2', 'ee21yin', 'png2']",3,"['dvanclev', None, 'zhang265']",50,"['nhamer2', 'vauger2', 'ajschoch', 'zhang265', 'shossei2', 'acallawa', 'aknecht', 'pwitkow2', 'dsherid3', 'rsteinm2', 'mstephe2', 'bigperm247', 'esunny2', 'nrivera2', 'hrao3', 'twei2', 'sramin3', 'jookalook', 'msachtl2', 'rykothari', 'rbalik', 'hrshah2', 'akeene3', 'twicken2', 'zchng2', 'nosonwan', 'chenchen', 'kwing', 'ssharma7', 'witriew', 'jlee207', 'dvanclev', 'akale', 'mlao2', 'crtaylor', 'spencemitch05', 'cui4', 'swong', 'bridgwater', 'tesler2', 'desimmon', None, 'dapeters', 'jmayen2', 'nvaccar2', 'towster2', 'ee21yin', 'png2', 'abhiahuja', 'jamorale']"
3,66,48,10,8,"['nhamer2', 'jmayen2', 'msachtl2', 'dsherid3', 'rsteinm2', 'towster2', 'hrshah2', 'bigperm247']",39,"['vauger2', 'ajschoch', 'shossei2', 'acallawa', 'aknecht', 'pwitkow2', 'mstephe2', 'esunny2', 'nrivera2', 'hrao3', 'twei2', 'sramin3', 'jookalook', 'rykothari', 'rbalik', 'akeene3', 'twicken2', 'zchng2', 'nosonwan', 'chenchen', 'kwing', 'ssharma7', 'witriew', 'jlee207', 'akale', 'mlao2', 'crtaylor', 'spencemitch05', 'cui4', 'swong', 'bridgwater', 'tesler2', 'desimmon', 'dapeters', 'nvaccar2', 'ee21yin', 'png2', 'abhiahuja', 'jamorale']",2,"['cbrauwe2', None]",49,"['nhamer2', 'vauger2', 'ajschoch', 'shossei2', 'acallawa', 'aknecht', 'pwitkow2', 'dsherid3', 'rsteinm2', 'mstephe2', 'bigperm247', 'esunny2', 'nrivera2', 'hrao3', 'twei2', 'sramin3', 'jookalook', 'msachtl2', 'rykothari', 'rbalik', 'hrshah2', 'akeene3', 'cbrauwe2', 'twicken2', 'zchng2', 'nosonwan', 'chenchen', 'kwing', 'ssharma7', 'witriew', 'jlee207', 'akale', 'mlao2', 'crtaylor', 'spencemitch05', 'cui4', 'swong', 'bridgwater', 'tesler2', 'desimmon', None, 'dapeters', 'jmayen2', 'nvaccar2', 'towster2', 'ee21yin', 'png2', 'abhiahuja', 'jamorale']"
3,18,48,7,6,"['jookalook', 'shossei2', 'pwitkow2', 'towster2', 'rbalik', 'bridgwater']",41,"['nhamer2', 'vauger2', 'ajschoch', 'acallawa', 'aknecht', 'dsherid3', 'rsteinm2', 'mstephe2', 'bigperm247', 'esunny2', 'nrivera2', 'hrao3', 'twei2', 'sramin3', 'msachtl2', 'rykothari', 'hrshah2', 'akeene3', 'twicken2', 'zchng2', 'nosonwan', 'chenchen', 'kwing', 'ssharma7', 'witriew', 'jlee207', 'akale', 'mlao2', 'crtaylor', 'spencemitch05', 'cui4', 'swong', 'tesler2', 'desimmon', 'dapeters', 'jmayen2', 'nvaccar2', 'ee21yin', 'png2', 'abhiahuja', 'jamorale']",1,[None],48,"['nhamer2', 'vauger2', 'ajschoch', 'shossei2', 'acallawa', 'aknecht', 'pwitkow2', 'dsherid3', 'rsteinm2', 'mstephe2', 'bigperm247', 'esunny2', 'nrivera2', 'hrao3', 'twei2', 'sramin3', 'jookalook', 'msachtl2', 'rykothari', 'rbalik', 'hrshah2', 'akeene3', 'twicken2', 'zchng2', 'nosonwan', 'chenchen', 'kwing', 'ssharma7', 'witriew', 'jlee207', 'akale', 'mlao2', 'crtaylor', 'spencemitch05', 'cui4', 'swong', 'bridgwater', 'tesler2', 'desimmon', None, 'dapeters', 'jmayen2', 'nvaccar2', 'towster2', 'ee21yin', 'png2', 'abhiahuja', 'jamorale']"
3,64,48,7,6,"['twicken2', 'nrivera2', 'jmayen2', 'aknecht', 'ee21yin', 'hrshah2']",41,"['nhamer2', 'vauger2', 'ajschoch', 'shossei2', 'acallawa', 'pwitkow2', 'dsherid3', 'rsteinm2', 'mstephe2', 'bigperm247', 'esunny2', 'hrao3', 'twei2', 'sramin3', 'jookalook', 'msachtl2', 'rykothari', 'rbalik', 'akeene3', 'zchng2', 'nosonwan', 'chenchen', 'kwing', 'ssharma7', 'witriew', 'jlee207', 'akale', 'mlao2', 'crtaylor', 'spencemitch05', 'cui4', 'swong', 'bridgwater', 'tesler2', 'desimmon', 'dapeters', 'nvaccar2', 'towster2', 'png2', 'abhiahuja', 'jamorale']",1,[None],48,"['nhamer2', 'vauger2', 'ajschoch', 'shossei2', 'acallawa', 'aknecht', 'pwitkow2', 'dsherid3', 'rsteinm2', 'mstephe2', 'bigperm247', 'esunny2', 'nrivera2', 'hrao3', 'twei2', 'sramin3', 'jookalook', 'msachtl2', 'rykothari', 'rbalik', 'hrshah2', 'akeene3', 'twicken2', 'zchng2', 'nosonwan', 'chenchen', 'kwing', 'ssharma7', 'witriew', 'jlee207', 'akale', 'mlao2', 'crtaylor', 'spencemitch05', 'cui4', 'swong', 'bridgwater', 'tesler2', 'desimmon', None, 'dapeters', 'jmayen2', 'nvaccar2', 'towster2', 'ee21yin', 'png2', 'abhiahuja', 'jamorale']"
4,67,43,31,29,"['gsantacruz', 'mfranco', 'jelopez2', 'isgovea', 'jstroud', 'ruls_7', 'atsolem', 'yvette', 'rhernandez20', 'rromero', 'mgsassenfeld', 'flopez', 'gnkoslan', 'dilydog25', 'daesparza3', 'smoctezuma', 'rcordero', 'amiramontes', 'eburton', 'jdelacruz', 'manaya', 'arturocontreras', 'rsilvas', 'dmuse', 'hseetao', 'deavila', 'ejimenez', 'vmanane', 'stella']",13,"['doubleac', 'jmmontes2', 'champinhon', 'jmmoreno2', 'miltownboiler', 'asalas', 'aelgkorv', 'jmgutierrez', 'rquinn', 'danishr', 'bpadman1', 'african_twin1', 'dibrovdo']",2,"['iacoronado', None]",44,"['gsantacruz', 'jmmoreno2', 'mfranco', 'miltownboiler', 'jelopez2', 'isgovea', 'aelgkorv', 'rquinn', 'jmgutierrez', 'jstroud', 'ruls_7', 'atsolem', 'yvette', 'rhernandez20', 'rromero', 'dibrovdo', 'mgsassenfeld', 'flopez', 'doubleac', 'dilydog25', 'gnkoslan', 'champinhon', 'daesparza3', 'smoctezuma', 'rcordero', 'amiramontes', 'african_twin1', 'eburton', 'danishr', None, 'jdelacruz', 'jmmontes2', 'manaya', 'arturocontreras', 'rsilvas', 'iacoronado', 'dmuse', 'asalas', 'hseetao', 'deavila', 'ejimenez', 'vmanane', 'bpadman1', 'stella']"
4,65,43,28,2,"['danishr', 'dibrovdo']",40,"['mfranco', 'jmmoreno2', 'gsantacruz', 'miltownboiler', 'jelopez2', 'isgovea', 'aelgkorv', 'rquinn', 'jmgutierrez', 'jstroud', 'ruls_7', 'atsolem', 'yvette', 'rhernandez20', 'rromero', 'mgsassenfeld', 'flopez', 'doubleac', 'dilydog25', 'gnkoslan', 'champinhon', 'daesparza3', 'smoctezuma', 'rcordero', 'amiramontes', 'african_twin1', 'eburton', 'jdelacruz', 'jmmontes2', 'manaya', 'arturocontreras', 'rsilvas', 'dmuse', 'asalas', 'hseetao', 'deavila', 'ejimenez', 'vmanane', 'bpadman1', 'stella']",26,"['silverjbj', 'alexkravchenko', 'wtm', 'bellmanz', 'bjoern83', 'hafizbilalnaveed', 'bumjin', 'jtli3', 'tigranb', 'mewael', 'manuilov', 'ahbhatti', 'jazzphysicist', 'benny7', 'musman6', 'fatihertinaz', 'yxiang', 'sheng', None, 'sansar31', 'rizwan', 'evary', 'sohailabbas', 'fudankth', 'm_maziar', 'vincentv']",68,"['gsantacruz', 'jmmoreno2', 'mfranco', 'silverjbj', 'miltownboiler', 'alexkravchenko', 'wtm', 'bellmanz', 'bjoern83', 'jelopez2', 'hafizbilalnaveed', 'isgovea', 'aelgkorv', 'rquinn', 'jmgutierrez', 'jstroud', 'bumjin', 'jtli3', 'tigranb', 'mewael', 'ruls_7', 'manuilov', 'atsolem', 'ahbhatti', 'yvette', 'rhernandez20', 'rromero', 'jazzphysicist', 'dibrovdo', 'mgsassenfeld', 'flopez', 'benny7', 'doubleac', 'dilydog25', 'gnkoslan', 'champinhon', 'daesparza3', 'musman6', 'smoctezuma', 'fatihertinaz', 'yxiang', 'rcordero', 'amiramontes', 'african_twin1', 'eburton', 'danishr', 'sheng', None, 'jdelacruz', 'jmmontes2', 'sansar31', 'manaya', 'rizwan', 'evary', 'arturocontreras', 'rsilvas', 'sohailabbas', 'dmuse', 'asalas', 'hseetao', 'deavila', 'ejimenez', 'fudankth', 'm_maziar', 'vmanane', 'bpadman1', 'vincentv', 'stella']"
4,59,43,13,1,['miltownboiler'],41,"['mfranco', 'jmmoreno2', 'gsantacruz', 'jelopez2', 'isgovea', 'aelgkorv', 'rquinn', 'jmgutierrez', 'jstroud', 'ruls_7', 'atsolem', 'yvette', 'rhernandez20', 'rromero', 'mgsassenfeld', 'dibrovdo', 'flopez', 'doubleac', 'dilydog25', 'gnkoslan', 'champinhon', 'daesparza3', 'smoctezuma', 'rcordero', 'amiramontes', 'african_twin1', 'eburton', 'danishr', 'jdelacruz', 'jmmontes2', 'manaya', 'arturocontreras', 'rsilvas', 'dmuse', 'asalas', 'hseetao', 'deavila', 'ejimenez', 'vmanane', 'bpadman1', 'stella']",12,"['ajschoch', 'cui4', 'nosonwan', 'dapeters', 'acallawa', 'jwetheri', 'kwing', 'smohapat', 'abhiahuja', None, 'spencemitch05', 'jamorale']",54,"['ajschoch', 'gsantacruz', 'jmmoreno2', 'mfranco', 'acallawa', 'miltownboiler', 'jelopez2', 'isgovea', 'aelgkorv', 'rquinn', 'jmgutierrez', 'jstroud', 'ruls_7', 'jwetheri', 'atsolem', 'yvette', 'rhernandez20', 'rromero', 'dibrovdo', 'mgsassenfeld', 'flopez', 'doubleac', 'dilydog25', 'gnkoslan', 'champinhon', 'nosonwan', 'daesparza3', 'smoctezuma', 'kwing', 'smohapat', 'rcordero', 'amiramontes', 'african_twin1', 'eburton', 'danishr', None, 'spencemitch05', 'jdelacruz', 'cui4', 'jmmontes2', 'abhiahuja', 'manaya', 'dapeters', 'arturocontreras', 'rsilvas', 'dmuse', 'asalas', 'hseetao', 'deavila', 'ejimenez', 'vmanane', 'bpadman1', 'jamorale', 'stella']"
5,23,36,47,29,"['nihaoya', 'rvedula', 'ptewari', 'sourdon', 'wangjian404', 'pkoswatt', 'megaton7', 'thenoblewoodsman', 'rmccarth', 'szelong', 'ishsman', 'nju2sjtu', 'zzongbum', 'mhossai', 'microefan', 'awegener', 'pree2cool', 'kjs1000', 'gu0', 'ketaki', 'tshuang', 'argupta15115', 'dmoonshi', 'ebaytok', 'bniu', 'vchipp', 'sminhyup', 'ssuslov', 'mathew']",6,"['dhc529', 'genexk', 'laplaceiitkgp', 'cchong', 'dberdy', 'seharris']",18,"['lgupta', 'itismyworld', 'yuitan87', 'lee640', 'ankitdhawan', 'kuntalroy', 'cooperj', 'sganguly', 'jhchen', 'pc350128', 'yusung33', 'wang381', 'sanvampire74', 'rwu', 'ejdawley', 'spalit', None, 'yoster84']",53,"['nihaoya', 'dberdy', 'ankitdhawan', 'rvedula', 'ptewari', 'pkoswatt', 'laplaceiitkgp', 'sanvampire74', 'seharris', 'zzongbum', 'genexk', 'pc350128', 'gu0', 'ebaytok', 'itismyworld', 'vchipp', 'sganguly', 'rwu', 'dhc529', 'cchong', 'wang381', 'sourdon', 'wangjian404', 'lgupta', 'megaton7', 'thenoblewoodsman', 'cooperj', 'rmccarth', 'szelong', 'ishsman', 'ejdawley', 'nju2sjtu', 'spalit', 'mhossai', 'yuitan87', 'microefan', 'awegener', 'pree2cool', 'kjs1000', 'tshuang', 'ketaki', 'argupta15115', 'yoster84', None, 'dmoonshi', 'bniu', 'lee640', 'kuntalroy', 'jhchen', 'sminhyup', 'yusung33', 'ssuslov', 'mathew']"
5,14,36,34,27,"['nihaoya', 'rvedula', 'ptewari', 'sourdon', 'wangjian404', 'pkoswatt', 'megaton7', 'thenoblewoodsman', 'ishsman', 'nju2sjtu', 'mhossai', 'zzongbum', 'microefan', 'awegener', 'pree2cool', 'kjs1000', 'tshuang', 'ketaki', 'argupta15115', 'gu0', 'dmoonshi', 'ebaytok', 'bniu', 'vchipp', 'sminhyup', 'ssuslov', 'mathew']",8,"['dhc529', 'genexk', 'laplaceiitkgp', 'cchong', 'dberdy', 'rmccarth', 'szelong', 'seharris']",7,"['lgupta', 'itismyworld', 'yuitan87', 'cooperj', 'sganguly', 'pc350128', None]",42,"['dhc529', 'nihaoya', 'cchong', 'dberdy', 'rvedula', 'ptewari', 'sourdon', 'wangjian404', 'pkoswatt', 'lgupta', 'laplaceiitkgp', 'megaton7', 'thenoblewoodsman', 'cooperj', 'rmccarth', 'szelong', 'ishsman', 'seharris', 'nju2sjtu', 'mhossai', 'zzongbum', 'genexk', 'yuitan87', 'microefan', 'awegener', 'pree2cool', 'kjs1000', 'pc350128', 'gu0', 'ketaki', 'tshuang', 'argupta15115', None, 'dmoonshi', 'ebaytok', 'itismyworld', 'bniu', 'vchipp', 'sganguly', 'sminhyup', 'ssuslov', 'mathew']"
5,25,36,11,7,"['dhc529', 'laplaceiitkgp', 'cchong', 'ptewari', 'sourdon', 'seharris', 'szelong']",28,"['nihaoya', 'dberdy', 'rvedula', 'wangjian404', 'pkoswatt', 'megaton7', 'thenoblewoodsman', 'rmccarth', 'ishsman', 'nju2sjtu', 'zzongbum', 'mhossai', 'genexk', 'microefan', 'awegener', 'pree2cool', 'kjs1000', 'gu0', 'ketaki', 'tshuang', 'argupta15115', 'dmoonshi', 'ebaytok', 'bniu', 'vchipp', 'sminhyup', 'ssuslov', 'mathew']",4,"['bugmenotagain', 'yuitan87', None, 'bugmenot']",39,"['dhc529', 'nihaoya', 'cchong', 'dberdy', 'rvedula', 'ptewari', 'sourdon', 'wangjian404', 'pkoswatt', 'laplaceiitkgp', 'megaton7', 'thenoblewoodsman', 'rmccarth', 'bugmenot', 'szelong', 'ishsman', 'seharris', 'nju2sjtu', 'mhossai', 'zzongbum', 'genexk', 'yuitan87', 'microefan', 'awegener', 'pree2cool', 'kjs1000', 'bugmenotagain', 'gu0', 'ketaki', 'tshuang', 'argupta15115', None, 'dmoonshi', 'ebaytok', 'bniu', 'vchipp', 'sminhyup', 'ssuslov', 'mathew']"
6,83,34,23,22,"['tsvika', 'atrash', 'guy23', 'tamtam', 'shayjo', 'sduppleganger', 'porvunah', 'shogun', 'smariadu', 'hila', 'merav_m', 'hkb', 'gilcohn', 'smeagul', 'lironilb', 'Tal', 'Hila', 'morritter', 'cheburashka', 'erabkin', 'itaikam', 'izlot']",11,"['Keren1', 'podesta', 'baraklit', 'Luks', 'nizan123', 'haika', 'Orit', 'drezner', 'spaniagu', 'zuzvang', 'orit']",1,[None],34,"['tsvika', 'atrash', 'Keren1', 'podesta', 'guy23', 'tamtam', 'zuzvang', 'shayjo', 'orit', 'sduppleganger', 'porvunah', 'shogun', 'smariadu', 'Luks', 'haika', 'merav_m', 'hila', 'hkb', 'gilcohn', 'baraklit', 'nizan123', 'drezner', 'smeagul', 'lironilb', 'Tal', 'spaniagu', None, 'Hila', 'morritter', 'cheburashka', 'erabkin', 'Orit', 'izlot', 'itaikam']"
6,84,34,8,7,"['sduppleganger', 'tsvika', 'shogun', 'haika', 'smeagul', 'zuzvang', 'orit']",26,"['atrash', 'Keren1', 'podesta', 'guy23', 'tamtam', 'shayjo', 'porvunah', 'smariadu', 'Luks', 'merav_m', 'hila', 'hkb', 'gilcohn', 'baraklit', 'nizan123', 'drezner', 'lironilb', 'spaniagu', 'Tal', 'Hila', 'morritter', 'cheburashka', 'erabkin', 'Orit', 'izlot', 'itaikam']",1,[None],34,"['tsvika', 'atrash', 'Keren1', 'podesta', 'guy23', 'tamtam', 'zuzvang', 'shayjo', 'orit', 'sduppleganger', 'porvunah', 'shogun', 'smariadu', 'Luks', 'haika', 'merav_m', 'hila', 'hkb', 'gilcohn', 'baraklit', 'nizan123', 'drezner', 'smeagul', 'lironilb', 'Tal', 'spaniagu', None, 'Hila', 'morritter', 'cheburashka', 'erabkin', 'Orit', 'izlot', 'itaikam']"
7,76,32,28,26,"['flashpane', 'hagsted', 's052274', 'nori86', 'simonbrodersen', 'simon_toft', 'bjarkemalm', 'torbentage', 's052528', 'lisa_k_t', 'peturgordon', 'napanil', 'mhca', 'peterjp', 'laur', 's052280', 'nesk', 'flexnezz', 'marsmand', 'bilsten', 'anderssig', 'robertpennington', 'echovolution', 's042191', 's042357', 's052429']",5,"['kilroy85', 'tnleite', 'jnunez', 'merunner42', 'aplzrj']",2,"[None, 'anttinanohub']",33,"['flashpane', 'hagsted', 'kilroy85', 'tnleite', 's052274', 'nori86', 'merunner42', 'simonbrodersen', 'simon_toft', 'bjarkemalm', 'torbentage', 'lisa_k_t', 's052528', 'peturgordon', 'napanil', 'mhca', 'jnunez', 'peterjp', 'laur', 's052280', 'nesk', 'flexnezz', 'marsmand', 'bilsten', None, 'aplzrj', 'anttinanohub', 'anderssig', 'robertpennington', 'echovolution', 's042191', 's042357', 's052429']"
8,19,22,17,15,"['nanotechnology530', 'sreekanthg2005', 'khan530', 'mahi2234', 'raghunathgadi', 'mushtaq0455', 'salah_asad', 'praveen33', 'radikareddykota', 'shwethakuruganti', 'shiva1060', 'desidudes', 'subbu', 'swetha443', 'reddy242']",6,"['ep4', 'spulli', 'jayak', 'mohan', 'arrola', 'jaejoon']",2,"[None, 'harsha_jammula']",23,"['ep4', 'spulli', 'raghunathgadi', 'salah_asad', 'praveen33', 'shwethakuruganti', 'swetha443', 'mohan', 'reddy242', 'sreekanthg2005', 'khan530', 'jayak', 'harsha_jammula', 'radikareddykota', 'arrola', 'shiva1060', 'subbu', None, 'desidudes', 'nanotechnology530', 'mahi2234', 'mushtaq0455', 'jaejoon']"
8,20,22,9,6,"['spulli', 'sreekanthg2005', 'jayak', 'mohan', 'subbu', 'reddy242']",15,"['ep4', 'nanotechnology530', 'khan530', 'mahi2234', 'raghunathgadi', 'jaejoon', 'mushtaq0455', 'salah_asad', 'shwethakuruganti', 'praveen33', 'radikareddykota', 'arrola', 'shiva1060', 'swetha443', 'desidudes']",3,"['kajapanisrikanth', None, 'harsha_jammula']",24,"['kajapanisrikanth', 'ep4', 'spulli', 'sreekanthg2005', 'khan530', 'raghunathgadi', 'jayak', 'harsha_jammula', 'salah_asad', 'praveen33', 'shwethakuruganti', 'radikareddykota', 'arrola', 'shiva1060', 'subbu', 'swetha443', 'jaejoon', None, 'desidudes', 'nanotechnology530', 'mahi2234', 'mushtaq0455', 'mohan', 'reddy242']"
9,6,22,11,8,"['craz', 'sienar', 'igor', 'thommy', 'mwidera', 'ch_klar', 'leysan', 'fk2burns']",13,"['steveengels', 'tg07', 'martinschucj', 'philippschaefers', 'mkes1982', 'vkemper', 'schallundrauch', 'zaradras', 'alleinherrscher', 'khalsa', 'sergethompson', 'chucknorris', 'masa']",3,"['rwth', None, 'zaldenp']",24,"['steveengels', 'rwth', 'martinschucj', 'igor', 'mkes1982', 'vkemper', 'schallundrauch', 'zaradras', 'alleinherrscher', 'leysan', 'khalsa', 'chucknorris', 'masa', None, 'tg07', 'craz', 'sienar', 'philippschaefers', 'zaldenp', 'thommy', 'mwidera', 'ch_klar', 'fk2burns', 'sergethompson']"
10,71,21,16,9,"['omarteoriam123', 'jusecas', 'lilicita', 'tauorus', 'squall_jotc', 'oriaj', 'sajor', 'dianap1986', 'loreurbano']",11,"['romainwacquez', 'safreyle', 'basilio', 'karen', 'jhon_arias', 'agcr3', 'zhangxi1982', 'ikoz56', 'rdw', 'danybaret', 'pacho']",7,"['alombo', 'jairosaavedra', 'nanolombo2008', 'edilma_becerra', 'carloshidalgo', 'juandako', None]",27,"['romainwacquez', 'alombo', 'omarteoriam123', 'jairosaavedra', 'lilicita', 'karen', 'nanolombo2008', 'agcr3', 'rdw', 'dianap1986', 'danybaret', 'loreurbano', None, 'safreyle', 'basilio', 'jusecas', 'tauorus', 'squall_jotc', 'jhon_arias', 'oriaj', 'edilma_becerra', 'zhangxi1982', 'ikoz56', 'sajor', 'carloshidalgo', 'juandako', 'pacho']"
10,72,21,9,8,"['jusecas', 'lilicita', 'tauorus', 'jhon_arias', 'oriaj', 'agcr3', 'sajor', 'loreurbano']",12,"['romainwacquez', 'safreyle', 'omarteoriam123', 'basilio', 'squall_jotc', 'karen', 'zhangxi1982', 'ikoz56', 'rdw', 'dianap1986', 'danybaret', 'pacho']",1,[None],21,"['romainwacquez', 'omarteoriam123', 'lilicita', 'karen', 'agcr3', 'rdw', 'dianap1986', 'danybaret', 'loreurbano', None, 'safreyle', 'basilio', 'jusecas', 'tauorus', 'squall_jotc', 'jhon_arias', 'oriaj', 'zhangxi1982', 'ikoz56', 'sajor', 'pacho']"
10,74,21,6,1,['rdw'],19,"['lilicita', 'agcr3', 'dianap1986', 'danybaret', 'basilio', 'squall_jotc', 'oriaj', 'ikoz56', 'sajor', 'romainwacquez', 'omarteoriam123', 'karen', 'loreurbano', 'safreyle', 'jusecas', 'tauorus', 'jhon_arias', 'zhangxi1982', 'pacho']",5,"['bdahnke', 'waranatha', 'btprice', 'hmosman', None]",25,"['romainwacquez', 'omarteoriam123', 'lilicita', 'karen', 'agcr3', 'rdw', 'btprice', 'dianap1986', 'danybaret', 'loreurbano', None, 'safreyle', 'bdahnke', 'waranatha', 'basilio', 'jusecas', 'tauorus', 'squall_jotc', 'jhon_arias', 'oriaj', 'zhangxi1982', 'ikoz56', 'sajor', 'hmosman', 'pacho']"
11,51,18,19,17,"['juliehan', 'lpung', 'IceForge13', 'jschoenfeldt', 'mdtipping', 'ejmiller', 'dmei', 's3rj', 'jchen', 'mkmk2009', 'nmeftah', 'jsiegler', 'krayner', 'ohalv', 'rtiwari', 'rkurtzman', 'amannan']",0,[],2,"['jklemp', None]",19,"['IceForge13', 'mdtipping', 'ejmiller', 'dmei', 's3rj', 'jchen', 'nmeftah', 'rtiwari', 'rkurtzman', None, 'amannan', 'juliehan', 'lpung', 'jschoenfeldt', 'jklemp', 'mkmk2009', 'jsiegler', 'krayner', 'ohalv']"
12,34,16,16,12,"['modave', 'houniaolu', 'clouds_city', 'redorange1984', 'chaojixin', 'lst123', 'sinbad', 'haipengf', 'huawenmei', 'liushaoteng', 'xpchen', 'ecolejun']",3,"['heavenblue', 'zfj', 'djgangan']",4,"['elevenlyw', 'shanghai', None, 'xuhaifeng']",19,"['modave', 'lst123', 'sinbad', 'haipengf', 'xuhaifeng', 'huawenmei', 'heavenblue', 'liushaoteng', 'houniaolu', None, 'shanghai', 'chaojixin', 'redorange1984', 'clouds_city', 'djgangan', 'zfj', 'elevenlyw', 'xpchen', 'ecolejun']"
12,56,16,13,11,"['modave', 'houniaolu', 'chaojixin', 'redorange1984', 'haipengf', 'sinbad', 'huawenmei', 'heavenblue', 'liushaoteng', 'xpchen', 'ecolejun']",4,"['lst123', 'zfj', 'djgangan', 'clouds_city']",2,"[None, 'xuhaifeng']",17,"['modave', 'lst123', 'sinbad', 'haipengf', 'xuhaifeng', 'huawenmei', 'heavenblue', 'liushaoteng', 'houniaolu', None, 'chaojixin', 'redorange1984', 'clouds_city', 'djgangan', 'zfj', 'xpchen', 'ecolejun']"
12,47,16,10,9,"['clouds_city', 'redorange1984', 'chaojixin', 'sinbad', 'huawenmei', 'heavenblue', 'liushaoteng', 'xpchen', 'ecolejun']",6,"['modave', 'lst123', 'haipengf', 'zfj', 'djgangan', 'houniaolu']",1,[None],16,"['modave', 'lst123', 'sinbad', 'haipengf', 'huawenmei', 'heavenblue', 'liushaoteng', 'houniaolu', None, 'chaojixin', 'redorange1984', 'clouds_city', 'djgangan', 'zfj', 'xpchen', 'ecolejun']"
13,65,16,28,12,"['tigranb', 'sansar31', 'mewael', 'silverjbj', 'alexkravchenko', 'evary', 'sohailabbas', 'bjoern83', 'fudankth', 'jtli3', 'jazzphysicist', 'benny7']",3,"['pythias', 'armankian', 'kingya']",16,"['rizwan', 'musman6', 'fatihertinaz', 'wtm', 'bellmanz', 'manuilov', 'yxiang', None, 'bumjin', 'hafizbilalnaveed', 'ahbhatti', 'm_maziar', 'danishr', 'sheng', 'dibrovdo', 'vincentv']",31,"['pythias', 'silverjbj', 'alexkravchenko', 'wtm', 'bellmanz', 'kingya', 'bjoern83', 'hafizbilalnaveed', 'bumjin', 'jtli3', 'vincentv', 'tigranb', 'mewael', 'manuilov', 'ahbhatti', 'jazzphysicist', 'benny7', 'dibrovdo', 'musman6', 'fatihertinaz', 'yxiang', 'danishr', 'sheng', None, 'sansar31', 'evary', 'rizwan', 'sohailabbas', 'fudankth', 'm_maziar', 'armankian']"
13,37,16,25,12,"['tigranb', 'mewael', 'silverjbj', 'alexkravchenko', 'evary', 'sohailabbas', 'kingya', 'bjoern83', 'fudankth', 'jtli3', 'jazzphysicist', 'benny7']",3,"['pythias', 'sansar31', 'armankian']",13,"['linhog', 'rizwan', 'musman6', 'fatihertinaz', 'wtm', 'kthfudan', 'bumjin', 'hafizbilalnaveed', 'karlwr', 'm_maziar', 'sheng', None, 'vincentv']",28,"['pythias', 'linhog', 'silverjbj', 'alexkravchenko', 'wtm', 'kingya', 'bjoern83', 'hafizbilalnaveed', 'bumjin', 'jtli3', 'karlwr', 'vincentv', 'tigranb', 'mewael', 'jazzphysicist', 'benny7', 'musman6', 'fatihertinaz', 'sheng', None, 'sansar31', 'evary', 'rizwan', 'sohailabbas', 'kthfudan', 'fudankth', 'm_maziar', 'armankian']"
13,48,16,22,13,"['tigranb', 'sansar31', 'mewael', 'silverjbj', 'alexkravchenko', 'evary', 'sohailabbas', 'kingya', 'bjoern83', 'fudankth', 'jtli3', 'jazzphysicist', 'benny7']",2,"['pythias', 'armankian']",9,"['flyingpig', 'musman6', 'wtm', 'bellmanz', 'kthfudan', 'yxiang', 'm_maziar', 'vincentv', None]",24,"['pythias', 'silverjbj', 'alexkravchenko', 'wtm', 'bellmanz', 'kingya', 'bjoern83', 'jtli3', 'vincentv', 'tigranb', 'mewael', 'jazzphysicist', 'benny7', 'flyingpig', 'musman6', 'yxiang', None, 'sansar31', 'evary', 'sohailabbas', 'kthfudan', 'fudankth', 'm_maziar', 'armankian']"
13,22,16,15,8,"['tigranb', 'mewael', 'alexkravchenko', 'sohailabbas', 'kingya', 'jtli3', 'jazzphysicist', 'benny7']",7,"['pythias', 'sansar31', 'evary', 'silverjbj', 'bjoern83', 'fudankth', 'armankian']",7,"['flyingpig', 'ifstrom', 'wtm', 'yxiang', 'hafizbilalnaveed', 'm_maziar', None]",22,"['pythias', 'flyingpig', 'silverjbj', 'alexkravchenko', 'wtm', 'kingya', 'bjoern83', 'yxiang', 'hafizbilalnaveed', 'jtli3', None, 'tigranb', 'sansar31', 'armankian', 'ifstrom', 'mewael', 'evary', 'sohailabbas', 'fudankth', 'm_maziar', 'jazzphysicist', 'benny7']"
15,15,12,20,8,"['cloeffle', 'kim130', 'crisley', 'mrockey', 'warz00', 'yunjinmail2', 'psavkar', 'datrain1010']",3,"['pbierer', 'hmichl', 'alfredkoh']",12,"['ajschoch', 'cui4', 'nosonwan', 'dapeters', 'acallawa', 'kwing', 'mjbarton', 'winnie', 'abhiahuja', None, 'spencemitch05', 'jamorale']",23,"['cloeffle', 'crisley', 'ajschoch', 'nosonwan', 'jamorale', 'acallawa', 'mrockey', 'warz00', 'kwing', 'winnie', 'yunjinmail2', 'psavkar', 'pbierer', None, 'spencemitch05', 'cui4', 'kim130', 'dapeters', 'mjbarton', 'alfredkoh', 'abhiahuja', 'datrain1010', 'hmichl']"
17,65,11,28,6,"['rizwan', 'fatihertinaz', 'hafizbilalnaveed', 'bumjin', 'sheng', 'vincentv']",4,"['pythais', 'kristas', 'spiderweb432', 'karlwr']",22,"['silverjbj', 'alexkravchenko', 'wtm', 'bellmanz', 'bjoern83', 'jtli3', 'tigranb', 'mewael', 'manuilov', 'ahbhatti', 'jazzphysicist', 'benny7', 'dibrovdo', 'musman6', 'yxiang', 'danishr', None, 'sansar31', 'evary', 'sohailabbas', 'fudankth', 'm_maziar']",32,"['silverjbj', 'alexkravchenko', 'wtm', 'bellmanz', 'bjoern83', 'hafizbilalnaveed', 'bumjin', 'karlwr', 'jtli3', 'tigranb', 'mewael', 'manuilov', 'ahbhatti', 'jazzphysicist', 'benny7', 'dibrovdo', 'pythais', 'musman6', 'fatihertinaz', 'yxiang', 'danishr', 'sheng', None, 'sansar31', 'rizwan', 'evary', 'sohailabbas', 'kristas', 'fudankth', 'm_maziar', 'spiderweb432', 'vincentv']"
17,37,11,25,7,"['rizwan', 'fatihertinaz', 'hafizbilalnaveed', 'bumjin', 'karlwr', 'sheng', 'vincentv']",3,"['pythais', 'kristas', 'spiderweb432']",18,"['linhog', 'tigranb', 'mewael', 'silverjbj', 'alexkravchenko', 'musman6', 'wtm', 'evary', 'sohailabbas', 'kingya', 'bjoern83', 'kthfudan', 'fudankth', 'm_maziar', 'jtli3', 'jazzphysicist', 'benny7', None]",28,"['linhog', 'silverjbj', 'alexkravchenko', 'wtm', 'kingya', 'bjoern83', 'hafizbilalnaveed', 'bumjin', 'karlwr', 'jtli3', 'tigranb', 'mewael', 'jazzphysicist', 'benny7', 'pythais', 'musman6', 'fatihertinaz', 'sheng', None, 'rizwan', 'evary', 'sohailabbas', 'kristas', 'kthfudan', 'fudankth', 'm_maziar', 'spiderweb432', 'vincentv']"
17,48,11,22,1,['vincentv'],9,"['pythais', 'rizwan', 'fatihertinaz', 'kristas', 'hafizbilalnaveed', 'bumjin', 'spiderweb432', 'karlwr', 'sheng']",21,"['silverjbj', 'alexkravchenko', 'wtm', 'bellmanz', 'kingya', 'bjoern83', 'jtli3', 'tigranb', 'mewael', 'jazzphysicist', 'benny7', 'flyingpig', 'musman6', 'yxiang', None, 'sansar31', 'evary', 'sohailabbas', 'kthfudan', 'fudankth', 'm_maziar']",31,"['silverjbj', 'alexkravchenko', 'wtm', 'bellmanz', 'kingya', 'bjoern83', 'hafizbilalnaveed', 'bumjin', 'karlwr', 'jtli3', 'tigranb', 'mewael', 'jazzphysicist', 'benny7', 'flyingpig', 'pythais', 'musman6', 'fatihertinaz', 'yxiang', 'sheng', None, 'sansar31', 'rizwan', 'evary', 'sohailabbas', 'kristas', 'kthfudan', 'fudankth', 'm_maziar', 'spiderweb432', 'vincentv']"
17,22,11,15,1,['hafizbilalnaveed'],9,"['pythais', 'rizwan', 'fatihertinaz', 'kristas', 'bumjin', 'spiderweb432', 'karlwr', 'sheng', 'vincentv']",14,"['flyingpig', 'tigranb', 'ifstrom', 'mewael', 'alexkravchenko', 'wtm', 'sohailabbas', 'kingya', 'yxiang', 'm_maziar', 'jtli3', 'jazzphysicist', 'benny7', None]",24,"['flyingpig', 'pythais', 'benny7', 'alexkravchenko', 'fatihertinaz', 'wtm', 'kingya', 'yxiang', 'hafizbilalnaveed', 'bumjin', 'karlwr', 'jtli3', 'sheng', None, 'tigranb', 'ifstrom', 'mewael', 'rizwan', 'sohailabbas', 'kristas', 'm_maziar', 'spiderweb432', 'jazzphysicist', 'vincentv']"
18,69,10,204,9,"['ktrocin', 'kevinhaghighi2012', 'justineshaw', 'jwalters', 'mdmurray', 'kcbandi', 'dcho0132', 'mmara', 'xwang308']",0,[],195,"['svadner', 'anderpants', 'athompsonharvey', 'mayabhardwaj', 'lixinxin', 'npetlakh', 'jtrop', 'cyarka', 'thegeoffmeister', 'dannyboy8m', 'sgrindy', 'kwang11', 'svs470', 'mbenner', 'jle703', 'jjund', 'brianchang', 'bsh319', 'matosziuk', 'kwd761', 'dcpearsall', 'cmpark', 'krich55', 'eklebanov', 'maroon_09', 'ammerocks', 'ndavidson', 'swolff', 'mshen2012', 'rchen', 'abc897', 'ddkim', 'jglass', 'dianemok', 'yleong', 'mdawg777', 'alcinalidder', 'pagrawal10', 'mellis', 'bveldk06', 'tsa309', 'dbasco', 'tkl821', 'iezzoni21', 'ywang', 's3suggs', 'kjoshi91', 'jsharp', 'nlomotan', 'nicholas', 'ymalina', 'prajeetreddy', 'dchun', 'alex_625', 'cmd366', 'ashah', 'jtao', 'tsaraiya', 'ngm654', 'mlangille', 'dtchen', 'tzack25', 'jcasady', 'gpedrick', 'mgroner', 'wtong', 'hpatel11', 'phirbreethr', 'martabme', 'rpatel', 'shp279', 'fch308', 'athompson', 'shk2990', 'txu', 'fculver', 'aconroy', 'kgovindaraju', 'tstanis', 'achadha', 'kmobilia', 'ceck', 'hyehan', 'craak', 'jennie', None, 'relwood', 'eko', 'athuluvath', 'ahuang', 'emj321', 'sshah7', 'pantocrator', 'hstafford', 'annab', 'kperkins', 'spokala', 'avinokur', 'mannamalai', 'maffi', 'mchen2012', 'jkastan', 'alee', 'alberthong', 'asklar', 'mwise', 'nseetharaman1', 'ejen', 'mwang', 'myu', 'emilywirtz', 'mattfred', 'blindbard393', 'dpetracovici', 'rkay', 'pcarlson', 'dbtice', 'karlind', 'jschiaffino', 'camila8', 'ilin', 'kshepherd', 'mbourgeois', 'xxu', 'bmaganti', 'ltsai', 'tslayman', 'ktp618', 'noheneadu', 'acoates', 'jchu90', 'ngg760', 'wchang', 'mme118', 'luichanco', 'mpineda', 'lnur', 'devish', 'sfedorikhina', 'amalik', 'mhuff', 'past10', 'kgrimestad', 'jsoohoo', 'sarahhhong', 'msimms', 'jacquelinehwang', 'amwang', 'jerrylin12', 'lywang', 'jkrupp', 'allegramount', 'rachelrosen', 'astockdale', 'laurennelson07', 'ktsang', 'kbandi', 'nashida', 'mcee2374', 'falcon36', 'jfang', 'dwalco', 'ecadoff', 'mkk749', 'aogonek', 'yxu', 'strikex2', 'jlipari', 'cnoble', 'thebombboi123', 'schirumamilla', 'dramadurai', 'hkawashima', 'ajl131', 'jkaplan', 'ltong', 'zschlieder', 'callee', 'carlherndon2011', 'bambielli', 'tejmotiwala', 'cberg', 'njohnson463', 'sshaaban', 'skang', 'jshepherd', 'gthippeswamy', 'acolletti', 'mkim', 'msriram', 'runfree909', 'sbajaj', 'bsegal', 'gwm166', 'schatz']",204,"['svadner', 'anderpants', 'athompsonharvey', 'mayabhardwaj', 'lixinxin', 'npetlakh', 'mdmurray', 'jtrop', 'cyarka', 'thegeoffmeister', 'dannyboy8m', 'sgrindy', 'kwang11', 'svs470', 'mbenner', 'jle703', 'jjund', 'brianchang', 'bsh319', 'matosziuk', 'kwd761', 'kevinhaghighi2012', 'dcpearsall', 'cmpark', 'krich55', 'eklebanov', 'maroon_09', 'ammerocks', 'ndavidson', 'swolff', 'mshen2012', 'rchen', 'abc897', 'ddkim', 'jglass', 'dianemok', 'yleong', 'mdawg777', 'alcinalidder', 'pagrawal10', 'dcho0132', 'mellis', 'bveldk06', 'tsa309', 'dbasco', 'tkl821', 'iezzoni21', 'ywang', 's3suggs', 'kjoshi91', 'jsharp', 'nlomotan', 'nicholas', 'ymalina', 'prajeetreddy', 'dchun', 'alex_625', 'cmd366', 'ashah', 'jtao', 'kcbandi', 'tsaraiya', 'ngm654', 'mlangille', 'dtchen', 'xwang308', 'tzack25', 'jcasady', 'gpedrick', 'mgroner', 'wtong', 'hpatel11', 'phirbreethr', 'martabme', 'rpatel', 'shp279', 'fch308', 'athompson', 'shk2990', 'txu', 'fculver', 'aconroy', 'kgovindaraju', 'tstanis', 'achadha', 'kmobilia', 'ceck', 'hyehan', 'craak', 'jennie', None, 'relwood', 'eko', 'ktrocin', 'athuluvath', 'ahuang', 'emj321', 'sshah7', 'pantocrator', 'hstafford', 'annab', 'kperkins', 'mmara', 'spokala', 'avinokur', 'mannamalai', 'maffi', 'mchen2012', 'jkastan', 'alee', 'alberthong', 'asklar', 'mwise', 'nseetharaman1', 'ejen', 'mwang', 'myu', 'emilywirtz', 'mattfred', 'blindbard393', 'dpetracovici', 'rkay', 'pcarlson', 'dbtice', 'karlind', 'jschiaffino', 'camila8', 'ilin', 'kshepherd', 'mbourgeois', 'xxu', 'bmaganti', 'ltsai', 'tslayman', 'ktp618', 'noheneadu', 'acoates', 'jchu90', 'ngg760', 'wchang', 'mme118', 'luichanco', 'mpineda', 'lnur', 'devish', 'sfedorikhina', 'amalik', 'mhuff', 'justineshaw', 'past10', 'kgrimestad', 'jsoohoo', 'sarahhhong', 'msimms', 'jacquelinehwang', 'amwang', 'jerrylin12', 'lywang', 'jkrupp', 'allegramount', 'rachelrosen', 'astockdale', 'laurennelson07', 'ktsang', 'kbandi', 'nashida', 'mcee2374', 'falcon36', 'jfang', 'dwalco', 'ecadoff', 'mkk749', 'aogonek', 'yxu', 'strikex2', 'jlipari', 'cnoble', 'thebombboi123', 'schirumamilla', 'dramadurai', 'hkawashima', 'ajl131', 'jkaplan', 'ltong', 'zschlieder', 'callee', 'carlherndon2011', 'jwalters', 'bambielli', 'tejmotiwala', 'cberg', 'njohnson463', 'sshaaban', 'skang', 'jshepherd', 'gthippeswamy', 'acolletti', 'mkim', 'msriram', 'runfree909', 'sbajaj', 'bsegal', 'gwm166', 'schatz']"
19,81,9,25,5,"['jperrin', 'yessoddahc05', 'swtcandie', 'sdidla', 'AllWires']",3,"['lpeterus', 'linnjr', 'neuen']",20,"['OsRitmos', 'kahuja', 'ashir23bom', 'akidarsa', 'jcleong', 'psadtler', 'singh15', 'ericlisheng', 'wildkid256', 'dmshah', 'sprashan', 'ageggles', None, 'priyam', 'himnshu2', 'jvk', 'ykubo', 'alayi', 'pmavery', 'clarjj01']",28,"['jperrin', 'OsRitmos', 'kahuja', 'ashir23bom', 'akidarsa', 'lpeterus', 'jcleong', 'psadtler', 'AllWires', 'neuen', 'singh15', 'ericlisheng', 'yessoddahc05', 'wildkid256', 'dmshah', 'linnjr', 'sprashan', 'ageggles', None, 'priyam', 'himnshu2', 'jvk', 'swtcandie', 'ykubo', 'sdidla', 'alayi', 'pmavery', 'clarjj01']"
20,43,9,8,7,"['gangadharan', 'savi', 'deepthi', 'vikram', 'supreeya', 'divsnvik', 'divya']",1,['geojtgeojtgeojt'],1,[None],9,"['gangadharan', 'savi', 'deepthi', 'vikram', 'geojtgeojtgeojt', 'supreeya', None, 'divsnvik', 'divya']"
20,44,9,8,7,"['gangadharan', 'savi', 'deepthi', 'vikram', 'supreeya', 'divsnvik', 'divya']",1,['geojtgeojtgeojt'],1,[None],9,"['gangadharan', 'savi', 'deepthi', 'vikram', 'geojtgeojtgeojt', 'supreeya', None, 'divsnvik', 'divya']"
20,45,9,8,7,"['gangadharan', 'savi', 'deepthi', 'vikram', 'supreeya', 'divsnvik', 'divya']",1,['geojtgeojtgeojt'],1,[None],9,"['gangadharan', 'savi', 'deepthi', 'vikram', 'geojtgeojtgeojt', 'supreeya', None, 'divsnvik', 'divya']"
23,79,8,18,4,"['abinavcs', 'hemanthaithal', 'rohit', 'krishnan_badri']",3,"['siri45', 'narsimha', 'gaoyueran']",14,"['shrutig', 'odysseus22', 'karthikec999', 'divyamnnv', 'delta1', 'supriya1', 'dlima', 'ganeshms', 'kanala', 'kedarked', None, 'sagargowda', 'geopete', 'ssahmed']",21,"['hemanthaithal', 'rohit', 'karthikec999', 'divyamnnv', 'siri45', 'ganeshms', 'kedarked', 'sagargowda', 'narsimha', 'ssahmed', None, 'abinavcs', 'shrutig', 'gaoyueran', 'krishnan_badri', 'odysseus22', 'delta1', 'supriya1', 'dlima', 'kanala', 'geopete']"
23,75,8,13,3,"['abinavcs', 'siri45', 'hemanthaithal']",4,"['narsimha', 'rohit', 'gaoyueran', 'krishnan_badri']",10,"['karthikec999', 'odysseus22', 'supriya1', 'delta1', 'dlima', None, 'kanala', 'sagargowda', 'kedarked', 'ssahmed']",17,"['hemanthaithal', 'rohit', 'karthikec999', 'siri45', 'sagargowda', 'narsimha', 'ssahmed', None, 'abinavcs', 'gaoyueran', 'krishnan_badri', 'odysseus22', 'delta1', 'supriya1', 'dlima', 'kanala', 'kedarked']"
23,9,8,10,3,"['hemanthaithal', 'rohit', 'krishnan_badri']",4,"['abinavcs', 'siri45', 'narsimha', 'gaoyueran']",7,"['sasi', 'karthikec999', 'divyamnnv', 'aravindmc', 'geopete', None, 'ursrikanth']",14,"['hemanthaithal', 'rohit', 'karthikec999', 'divyamnnv', 'siri45', 'ursrikanth', 'narsimha', None, 'abinavcs', 'sasi', 'gaoyueran', 'krishnan_badri', 'aravindmc', 'geopete']"
23,80,8,7,1,['siri45'],6,"['abinavcs', 'hemanthaithal', 'rohit', 'gaoyueran', 'krishnan_badri', 'narsimha']",6,"['divyamnnv', 'mluisier', 'koganti', 'davidmacak', 'kedarked', None]",13,"['abinavcs', 'hemanthaithal', 'rohit', 'gaoyueran', 'krishnan_badri', 'divyamnnv', 'mluisier', 'siri45', 'koganti', None, 'davidmacak', 'kedarked', 'narsimha']"
24,23,8,47,5,"['lee640', 'ankitdhawan', 'wang381', 'sanvampire74', 'rwu']",2,"['askiahill', 'nyakubchak']",42,"['nihaoya', 'rvedula', 'ptewari', 'sourdon', 'wangjian404', 'pkoswatt', 'lgupta', 'megaton7', 'thenoblewoodsman', 'cooperj', 'rmccarth', 'szelong', 'ishsman', 'ejdawley', 'nju2sjtu', 'spalit', 'zzongbum', 'mhossai', 'yuitan87', 'microefan', 'awegener', 'pree2cool', 'kjs1000', 'pc350128', 'tshuang', 'ketaki', 'argupta15115', 'gu0', 'yoster84', None, 'dmoonshi', 'ebaytok', 'itismyworld', 'bniu', 'vchipp', 'kuntalroy', 'sganguly', 'jhchen', 'sminhyup', 'yusung33', 'ssuslov', 'mathew']",49,"['nihaoya', 'ankitdhawan', 'rvedula', 'wang381', 'ptewari', 'sourdon', 'wangjian404', 'pkoswatt', 'lgupta', 'megaton7', 'thenoblewoodsman', 'cooperj', 'rmccarth', 'sanvampire74', 'szelong', 'ishsman', 'ejdawley', 'nju2sjtu', 'spalit', 'zzongbum', 'mhossai', 'yuitan87', 'microefan', 'awegener', 'pree2cool', 'kjs1000', 'pc350128', 'tshuang', 'ketaki', 'argupta15115', 'gu0', 'yoster84', None, 'dmoonshi', 'askiahill', 'ebaytok', 'itismyworld', 'bniu', 'lee640', 'vchipp', 'kuntalroy', 'nyakubchak', 'sganguly', 'jhchen', 'sminhyup', 'yusung33', 'rwu', 'ssuslov', 'mathew']"
24,24,8,9,1,['nyakubchak'],6,"['askiahill', 'lee640', 'ankitdhawan', 'wang381', 'sanvampire74', 'rwu']",8,"['johnsochacki', 'ryang9', 'gng', 'pnayak1', 'onurates', 'gokul2008', None, 'esteenbe']",15,"['johnsochacki', 'ankitdhawan', 'ryang9', 'wang381', 'onurates', None, 'askiahill', 'lee640', 'nyakubchak', 'gng', 'pnayak1', 'sanvampire74', 'rwu', 'gokul2008', 'esteenbe']"
25,33,7,8,4,"['davide', 'kingbeppe', 'triky', 'paola']",2,"['ashay88', 'cinzia_nanna']",4,"['mbraccioli', 'francescogreggi', None, 'michelerossi']",10,"['michelerossi', 'paola', 'kingbeppe', 'francescogreggi', 'davide', 'cinzia_nanna', 'mbraccioli', 'ashay88', None, 'triky']"
26,69,7,204,6,"['mattfred', 'mkim', 'sshah7', 'jlipari', 'pantocrator', 'sbajaj']",0,[],198,"['svadner', 'anderpants', 'athompsonharvey', 'mayabhardwaj', 'lixinxin', 'npetlakh', 'mdmurray', 'jtrop', 'cyarka', 'thegeoffmeister', 'dannyboy8m', 'sgrindy', 'kwang11', 'svs470', 'mbenner', 'jle703', 'jjund', 'brianchang', 'bsh319', 'matosziuk', 'kwd761', 'kevinhaghighi2012', 'dcpearsall', 'cmpark', 'krich55', 'eklebanov', 'maroon_09', 'ammerocks', 'ndavidson', 'swolff', 'mshen2012', 'rchen', 'abc897', 'ddkim', 'jglass', 'dianemok', 'yleong', 'mdawg777', 'alcinalidder', 'pagrawal10', 'dcho0132', 'mellis', 'bveldk06', 'tsa309', 'dbasco', 'tkl821', 'iezzoni21', 'ywang', 's3suggs', 'kjoshi91', 'jsharp', 'nlomotan', 'nicholas', 'ymalina', 'prajeetreddy', 'dchun', 'alex_625', 'cmd366', 'ashah', 'jtao', 'kcbandi', 'tsaraiya', 'ngm654', 'mlangille', 'dtchen', 'xwang308', 'tzack25', 'jcasady', 'gpedrick', 'mgroner', 'wtong', 'hpatel11', 'phirbreethr', 'martabme', 'rpatel', 'shp279', 'fch308', 'athompson', 'shk2990', 'txu', 'fculver', 'aconroy', 'kgovindaraju', 'tstanis', 'achadha', 'kmobilia', 'ceck', 'hyehan', 'craak', 'jennie', None, 'relwood', 'eko', 'ktrocin', 'athuluvath', 'ahuang', 'emj321', 'hstafford', 'annab', 'kperkins', 'mmara', 'spokala', 'avinokur', 'mannamalai', 'maffi', 'mchen2012', 'jkastan', 'alee', 'alberthong', 'asklar', 'mwise', 'nseetharaman1', 'ejen', 'mwang', 'myu', 'emilywirtz', 'blindbard393', 'dpetracovici', 'rkay', 'pcarlson', 'dbtice', 'karlind', 'jschiaffino', 'camila8', 'ilin', 'kshepherd', 'mbourgeois', 'xxu', 'bmaganti', 'ltsai', 'tslayman', 'ktp618', 'noheneadu', 'acoates', 'jchu90', 'ngg760', 'wchang', 'mme118', 'luichanco', 'mpineda', 'lnur', 'devish', 'sfedorikhina', 'amalik', 'mhuff', 'justineshaw', 'past10', 'kgrimestad', 'jsoohoo', 'sarahhhong', 'msimms', 'jacquelinehwang', 'amwang', 'jerrylin12', 'lywang', 'jkrupp', 'allegramount', 'rachelrosen', 'astockdale', 'laurennelson07', 'ktsang', 'kbandi', 'nashida', 'mcee2374', 'falcon36', 'jfang', 'dwalco', 'ecadoff', 'mkk749', 'aogonek', 'yxu', 'strikex2', 'cnoble', 'thebombboi123', 'schirumamilla', 'dramadurai', 'hkawashima', 'ajl131', 'jkaplan', 'ltong', 'zschlieder', 'callee', 'carlherndon2011', 'jwalters', 'bambielli', 'tejmotiwala', 'cberg', 'njohnson463', 'sshaaban', 'skang', 'jshepherd', 'gthippeswamy', 'acolletti', 'msriram', 'runfree909', 'bsegal', 'gwm166', 'schatz']",204,"['svadner', 'anderpants', 'athompsonharvey', 'mayabhardwaj', 'lixinxin', 'npetlakh', 'mdmurray', 'jtrop', 'cyarka', 'thegeoffmeister', 'dannyboy8m', 'sgrindy', 'kwang11', 'svs470', 'mbenner', 'jle703', 'jjund', 'brianchang', 'bsh319', 'matosziuk', 'kwd761', 'kevinhaghighi2012', 'dcpearsall', 'cmpark', 'krich55', 'eklebanov', 'maroon_09', 'ammerocks', 'ndavidson', 'swolff', 'mshen2012', 'rchen', 'abc897', 'ddkim', 'jglass', 'dianemok', 'yleong', 'mdawg777', 'alcinalidder', 'pagrawal10', 'dcho0132', 'mellis', 'bveldk06', 'tsa309', 'dbasco', 'tkl821', 'iezzoni21', 'ywang', 's3suggs', 'kjoshi91', 'jsharp', 'nlomotan', 'nicholas', 'ymalina', 'prajeetreddy', 'dchun', 'alex_625', 'cmd366', 'ashah', 'jtao', 'kcbandi', 'tsaraiya', 'ngm654', 'mlangille', 'dtchen', 'xwang308', 'tzack25', 'jcasady', 'gpedrick', 'mgroner', 'wtong', 'hpatel11', 'phirbreethr', 'martabme', 'rpatel', 'shp279', 'fch308', 'athompson', 'shk2990', 'txu', 'fculver', 'aconroy', 'kgovindaraju', 'tstanis', 'achadha', 'kmobilia', 'ceck', 'hyehan', 'craak', 'jennie', None, 'relwood', 'eko', 'ktrocin', 'athuluvath', 'ahuang', 'emj321', 'sshah7', 'pantocrator', 'hstafford', 'annab', 'kperkins', 'mmara', 'spokala', 'avinokur', 'mannamalai', 'maffi', 'mchen2012', 'jkastan', 'alee', 'alberthong', 'asklar', 'mwise', 'nseetharaman1', 'ejen', 'mwang', 'myu', 'emilywirtz', 'mattfred', 'blindbard393', 'dpetracovici', 'rkay', 'pcarlson', 'dbtice', 'karlind', 'jschiaffino', 'camila8', 'ilin', 'kshepherd', 'mbourgeois', 'xxu', 'bmaganti', 'ltsai', 'tslayman', 'ktp618', 'noheneadu', 'acoates', 'jchu90', 'ngg760', 'wchang', 'mme118', 'luichanco', 'mpineda', 'lnur', 'devish', 'sfedorikhina', 'amalik', 'mhuff', 'justineshaw', 'past10', 'kgrimestad', 'jsoohoo', 'sarahhhong', 'msimms', 'jacquelinehwang', 'amwang', 'jerrylin12', 'lywang', 'jkrupp', 'allegramount', 'rachelrosen', 'astockdale', 'laurennelson07', 'ktsang', 'kbandi', 'nashida', 'mcee2374', 'falcon36', 'jfang', 'dwalco', 'ecadoff', 'mkk749', 'aogonek', 'yxu', 'strikex2', 'jlipari', 'cnoble', 'thebombboi123', 'schirumamilla', 'dramadurai', 'hkawashima', 'ajl131', 'jkaplan', 'ltong', 'zschlieder', 'callee', 'carlherndon2011', 'jwalters', 'bambielli', 'tejmotiwala', 'cberg', 'njohnson463', 'sshaaban', 'skang', 'jshepherd', 'gthippeswamy', 'acolletti', 'mkim', 'msriram', 'runfree909', 'sbajaj', 'bsegal', 'gwm166', 'schatz']"
26,53,7,189,5,"['mattfred', 'mkim', 'jlipari', 'pantocrator', 'sbajaj']",1,['sshah7'],184,"['svadner', 'anderpants', 'athompsonharvey', 'mayabhardwaj', 'lixinxin', 'npetlakh', 'jtrop', 'cyarka', 'thegeoffmeister', 'dannyboy8m', 'sgrindy', 'kwang11', 'svs470', 'mbenner', 'jle703', 'jjund', 'brianchang', 'bsh319', 'matosziuk', 'kwd761', 'dcpearsall', 'cmpark', 'krich55', 'eklebanov', 'maroon_09', 'ammerocks', 'mshen2012', 'swolff', 'rchen', 'abc897', 'ddkim', 'jglass', 'dianemok', 'yleong', 'mdawg777', 'alcinalidder', 'pagrawal10', 'mellis', 'tsa309', 'irenezhanglin', 'dbasco', 'tkl821', 'iezzoni21', 'ywang', 's3suggs', 'kjoshi91', 'jsharp', 'nlomotan', 'nicholas', 'prajeetreddy', 'cmd366', 'dchun', 'alex_625', 'jtao', 'mlangille', 'tsaraiya', 'ngm654', 'dtchen', 'tzack25', 'jcasady', 'gpedrick', 'chinkmama', 'wtong', 'hpatel11', 'phirbreethr', 'martabme', 'shp279', 'fch308', 'athompson', 'shk2990', 'txu', 'fculver', 'aconroy', 'kgovindaraju', 'tstanis', 'achadha', 'kmobilia', 'ceck', 'mwalimujim', 'craak', 'jennie', None, 'relwood', 'eko', 'athuluvath', 'ahuang', 'emj321', 'hstafford', 'annab', 'kperkins', 'spokala', 'avinokur', 'mannamalai', 'maffi', 'mchen2012', 'mongoosehuman', 'jkastan', 'alee', 'skrilov', 'alberthong', 'asklar', 'mwise', 'nseetharaman1', 'ejen', 'mwang', 'myu', 'emilywirtz', 'shaikal', 'blindbard393', 'dpetracovici', 'rkay', 'pcarlson', 'karlind', 'jschiaffino', 'ilin', 'kshepherd', 'mbourgeois', 'xxu', 'bmaganti', 'ltsai', 'tslayman', 'ktp618', 'noheneadu', 'acoates', 'jchu90', 'ngg760', 'wchang', 'mme118', 'luichanco', 'mpineda', 'devish', 'amalik', 'mhuff', 'past10', 'kgrimestad', 'jsoohoo', 'sarahhhong', 'msimms', 'jacquelinehwang', 'khaghighi', 'jerrylin12', 'lywang', 'amwang', 'jkrupp', 'allegramount', 'rachelrosen', 'astockdale', 'laurennelson07', 'ktsang', 'kbandi', 'nashida', 'mcee2374', 'falcon36', 'apeterson', 'jfang', 'dwalco', 'aogonek', 'yxu', 'strikex2', 'cnoble', 'dmorris', 'thebombboi123', 'schirumamilla', 'dramadurai', 'hkawashima', 'ajl131', 'jkaplan', 'ltong', 'zschlieder', 'callee', 'carlherndon2011', 'bambielli', 'cberg', 'njohnson463', 'sshaaban', 'skang', 'mkramer', 'jshepherd', 'gthippeswamy', 'acolletti', 'msriram', 'runfree909', 'bsegal', 'gwm166']",190,"['svadner', 'anderpants', 'athompsonharvey', 'mayabhardwaj', 'lixinxin', 'npetlakh', 'jtrop', 'cyarka', 'thegeoffmeister', 'dannyboy8m', 'sgrindy', 'kwang11', 'svs470', 'mbenner', 'jle703', 'jjund', 'brianchang', 'bsh319', 'matosziuk', 'kwd761', 'dcpearsall', 'cmpark', 'krich55', 'eklebanov', 'maroon_09', 'ammerocks', 'mshen2012', 'swolff', 'rchen', 'abc897', 'ddkim', 'jglass', 'dianemok', 'yleong', 'mdawg777', 'alcinalidder', 'pagrawal10', 'mellis', 'tsa309', 'irenezhanglin', 'dbasco', 'tkl821', 'iezzoni21', 'ywang', 's3suggs', 'kjoshi91', 'jsharp', 'nlomotan', 'nicholas', 'prajeetreddy', 'cmd366', 'dchun', 'alex_625', 'jtao', 'mlangille', 'tsaraiya', 'ngm654', 'dtchen', 'tzack25', 'jcasady', 'gpedrick', 'chinkmama', 'wtong', 'hpatel11', 'phirbreethr', 'martabme', 'shp279', 'fch308', 'athompson', 'shk2990', 'txu', 'fculver', 'aconroy', 'kgovindaraju', 'tstanis', 'achadha', 'kmobilia', 'ceck', 'mwalimujim', 'craak', 'jennie', None, 'relwood', 'eko', 'athuluvath', 'ahuang', 'emj321', 'sshah7', 'pantocrator', 'hstafford', 'annab', 'kperkins', 'spokala', 'avinokur', 'mannamalai', 'maffi', 'mchen2012', 'mongoosehuman', 'jkastan', 'alee', 'skrilov', 'alberthong', 'asklar', 'mwise', 'nseetharaman1', 'ejen', 'mwang', 'myu', 'emilywirtz', 'mattfred', 'shaikal', 'blindbard393', 'dpetracovici', 'rkay', 'pcarlson', 'karlind', 'jschiaffino', 'ilin', 'kshepherd', 'mbourgeois', 'xxu', 'bmaganti', 'ltsai', 'tslayman', 'ktp618', 'noheneadu', 'acoates', 'jchu90', 'ngg760', 'wchang', 'mme118', 'luichanco', 'mpineda', 'devish', 'amalik', 'mhuff', 'past10', 'kgrimestad', 'jsoohoo', 'sarahhhong', 'msimms', 'jacquelinehwang', 'khaghighi', 'jerrylin12', 'lywang', 'amwang', 'jkrupp', 'allegramount', 'rachelrosen', 'astockdale', 'laurennelson07', 'ktsang', 'kbandi', 'nashida', 'mcee2374', 'falcon36', 'apeterson', 'jfang', 'dwalco', 'aogonek', 'yxu', 'strikex2', 'jlipari', 'cnoble', 'dmorris', 'thebombboi123', 'schirumamilla', 'dramadurai', 'hkawashima', 'ajl131', 'jkaplan', 'ltong', 'zschlieder', 'callee', 'carlherndon2011', 'bambielli', 'cberg', 'njohnson463', 'sshaaban', 'skang', 'mkramer', 'jshepherd', 'gthippeswamy', 'mkim', 'acolletti', 'msriram', 'runfree909', 'sbajaj', 'bsegal', 'gwm166']"
26,52,7,10,1,['mattfred'],5,"['mkim', 'sshah7', 'jlipari', 'pantocrator', 'sbajaj']",9,"['pretenderjl', 'matosziuk', 'emilieringe', 'jklemp', 'dbtice', 'sml257', 'jdicke', None, 'bveldk06']",15,"['pretenderjl', 'sml257', None, 'bveldk06', 'mattfred', 'mkim', 'matosziuk', 'emilieringe', 'sshah7', 'jlipari', 'jklemp', 'dbtice', 'pantocrator', 'jdicke', 'sbajaj']"
28,71,7,16,5,"['jairosaavedra', 'nanolombo2008', 'edilma_becerra', 'carloshidalgo', 'juandako']",1,['kurstjen'],11,"['alombo', 'omarteoriam123', 'jusecas', 'lilicita', 'tauorus', 'squall_jotc', 'oriaj', 'sajor', 'dianap1986', 'loreurbano', None]",17,"['alombo', 'jairosaavedra', 'omarteoriam123', 'lilicita', 'nanolombo2008', 'dianap1986', 'kurstjen', 'loreurbano', None, 'jusecas', 'tauorus', 'squall_jotc', 'oriaj', 'edilma_becerra', 'sajor', 'carloshidalgo', 'juandako']"
29,81,7,25,6,"['OsRitmos', 'kahuja', 'ashir23bom', 'ericlisheng', 'ykubo', 'ageggles']",0,[],19,"['jperrin', 'akidarsa', 'jcleong', 'psadtler', 'AllWires', 'singh15', 'yessoddahc05', 'clarjj01', 'dmshah', 'sprashan', None, 'priyam', 'himnshu2', 'jvk', 'swtcandie', 'sdidla', 'alayi', 'pmavery', 'wildkid256']",25,"['jperrin', 'OsRitmos', 'kahuja', 'ashir23bom', 'akidarsa', 'sprashan', 'jcleong', 'ageggles', 'psadtler', None, 'AllWires', 'priyam', 'himnshu2', 'singh15', 'ericlisheng', 'yessoddahc05', 'jvk', 'swtcandie', 'ykubo', 'wildkid256', 'dmshah', 'sdidla', 'alayi', 'pmavery', 'clarjj01']"
30,31,7,7,5,"['jdustin01', 'amberlei', 'devachan', 'potax', 'ydeshmuk']",1,['msnow'],2,"['sramarap', None]",8,"['jdustin01', 'amberlei', 'devachan', 'msnow', 'potax', 'sramarap', None, 'ydeshmuk']"
31,11,7,205,6,"['pandagrl90', 'darora7', 'fka560', 'kblake', 'lpurcell', 'hpvbs']",0,[],199,"['svadner', 'anderpants', 'athompsonharvey', 'mayabhardwaj', 'lixinxin', 'npetlakh', 'jtrop', 'cyarka', 'thegeoffmeister', 'dannyboy8m', 'sgrindy', 'kwang11', 'svs470', 'mbenner', 'jle703', 'jjund', 'brianchang', 'bsh319', 'matosziuk', 'kwd761', 'dcpearsall', 'cmpark', 'krich55', 'eklebanov', 'maroon_09', 'ammerocks', 'ndavidson', 'rchen', 'swolff', 'mshen2012', 'abc897', 'ddkim', 'jglass', 'omnelson', 'dianemok', 'yleong', 'mdawg777', 'alcinalidder', 'pagrawal10', 'mellis', 'irenezhanglin', 'bveldk06', 'tsa309', 'dbasco', 'tkl821', 'iezzoni21', 'ywang', 's3suggs', 'kjoshi91', 'jsharp', 'nlomotan', 'nicholas', 'ymalina', 'prajeetreddy', 'dchun', 'alex_625', 'cmd366', 'ashah', 'jtao', 'mlangille', 'tsaraiya', 'ngm654', 'dtchen', 'tzack25', 'jcasady', 'gpedrick', 'chinkmama', 'mgroner', 'wtong', 'hpatel11', 'phirbreethr', 'martabme', 'rpatel', 'shp279', 'fch308', 'athompson', 'shk2990', 'txu', 'fculver', 'aconroy', 'kgovindaraju', 'ceck', 'tstanis', 'kmobilia', 'achadha', 'hyehan', 'craak', 'jennie', 'relwood', 'eko', 'athuluvath', 'ahuang', 'emj321', 'hstafford', 'annab', 'kperkins', 'spokala', 'avinokur', 'mannamalai', 'maffi', 'mchen2012', 'mongoosehuman', 'jkastan', 'alee', 'skrilov', 'alberthong', 'asklar', 'mwise', 'nseetharaman1', 'ejen', 'myu', 'emilywirtz', 'mwang', 'shaikal', 'blindbard393', 'dpetracovici', 'pcarlson', 'rkay', 'dbtice', 'karlind', 'jschiaffino', 'camila8', 'ilin', 'kshepherd', 'mbourgeois', 'xxu', 'bmaganti', 'ltsai', 'tslayman', 'ktp618', 'noheneadu', 'acoates', 'jchu90', 'wchang', 'ngg760', 'mme118', 'luichanco', 'mpineda', 'lnur', 'devish', 'sfedorikhina', 'amalik', 'mhuff', 'past10', 'kgrimestad', 'jsoohoo', 'sarahhhong', 'msimms', 'jacquelinehwang', 'amwang', 'jerrylin12', 'lywang', 'khaghighi', 'jkrupp', 'allegramount', 'rachelrosen', 'astockdale', 'laurennelson07', 'ktsang', 'kbandi', 'nashida', 'mcee2374', 'falcon36', 'slhatch', 'apeterson', 'jfang', 'dwalco', 'ecadoff', 'mkk749', 'aogonek', 'yxu', 'strikex2', 'cnoble', 'dmorris', 'thebombboi123', 'schirumamilla', 'dramadurai', 'hkawashima', 'ajl131', 'jkaplan', 'ltong', 'zschlieder', 'callee', 'carlherndon2011', 'bambielli', 'tejmotiwala', 'cberg', 'njohnson463', 'sshaaban', 'skang', 'jshepherd', 'gthippeswamy', 'acolletti', 'mkramer', 'dkiebala1', 'msriram', 'runfree909', 'bsegal', 'gwm166']",205,"['svadner', 'anderpants', 'athompsonharvey', 'mayabhardwaj', 'lixinxin', 'npetlakh', 'jtrop', 'cyarka', 'thegeoffmeister', 'dannyboy8m', 'sgrindy', 'kwang11', 'svs470', 'mbenner', 'jle703', 'jjund', 'brianchang', 'bsh319', 'matosziuk', 'kwd761', 'dcpearsall', 'cmpark', 'krich55', 'eklebanov', 'maroon_09', 'ammerocks', 'ndavidson', 'rchen', 'swolff', 'mshen2012', 'abc897', 'ddkim', 'jglass', 'omnelson', 'dianemok', 'yleong', 'mdawg777', 'lpurcell', 'alcinalidder', 'pagrawal10', 'mellis', 'irenezhanglin', 'bveldk06', 'tsa309', 'dbasco', 'tkl821', 'iezzoni21', 'ywang', 's3suggs', 'kjoshi91', 'jsharp', 'nlomotan', 'nicholas', 'ymalina', 'darora7', 'prajeetreddy', 'dchun', 'alex_625', 'cmd366', 'kblake', 'ashah', 'jtao', 'mlangille', 'tsaraiya', 'ngm654', 'dtchen', 'tzack25', 'jcasady', 'gpedrick', 'chinkmama', 'mgroner', 'wtong', 'hpatel11', 'phirbreethr', 'martabme', 'rpatel', 'shp279', 'fch308', 'athompson', 'shk2990', 'txu', 'fculver', 'aconroy', 'kgovindaraju', 'ceck', 'tstanis', 'kmobilia', 'achadha', 'hyehan', 'craak', 'jennie', 'relwood', 'eko', 'athuluvath', 'ahuang', 'emj321', 'hstafford', 'annab', 'kperkins', 'spokala', 'avinokur', 'mannamalai', 'maffi', 'mchen2012', 'mongoosehuman', 'jkastan', 'alee', 'skrilov', 'alberthong', 'asklar', 'mwise', 'nseetharaman1', 'ejen', 'myu', 'emilywirtz', 'mwang', 'shaikal', 'blindbard393', 'dpetracovici', 'pcarlson', 'rkay', 'dbtice', 'karlind', 'jschiaffino', 'hpvbs', 'camila8', 'ilin', 'kshepherd', 'mbourgeois', 'xxu', 'bmaganti', 'ltsai', 'tslayman', 'ktp618', 'noheneadu', 'acoates', 'jchu90', 'wchang', 'ngg760', 'mme118', 'luichanco', 'mpineda', 'lnur', 'devish', 'sfedorikhina', 'amalik', 'mhuff', 'past10', 'kgrimestad', 'jsoohoo', 'sarahhhong', 'msimms', 'jacquelinehwang', 'amwang', 'jerrylin12', 'lywang', 'khaghighi', 'jkrupp', 'allegramount', 'rachelrosen', 'fka560', 'astockdale', 'laurennelson07', 'ktsang', 'kbandi', 'nashida', 'mcee2374', 'falcon36', 'slhatch', 'apeterson', 'jfang', 'dwalco', 'ecadoff', 'mkk749', 'aogonek', 'yxu', 'strikex2', 'cnoble', 'dmorris', 'thebombboi123', 'schirumamilla', 'dramadurai', 'hkawashima', 'ajl131', 'jkaplan', 'ltong', 'zschlieder', 'callee', 'carlherndon2011', 'bambielli', 'tejmotiwala', 'cberg', 'njohnson463', 'sshaaban', 'pandagrl90', 'skang', 'jshepherd', 'gthippeswamy', 'acolletti', 'mkramer', 'dkiebala1', 'msriram', 'runfree909', 'bsegal', 'gwm166']"
33,82,7,8,4,"['allwires', 'kim265', 'axavier', 'redfalconf35']",2,"['rileyjm', 'clintone']",4,"['tbarzso', None, 'mniksa', 'jaconcha']",10,"['allwires', 'tbarzso', 'axavier', 'redfalconf35', 'jaconcha', 'mniksa', 'clintone', 'kim265', None, 'rileyjm']"
35,81,6,25,5,"['jvk', 'sprashan', 'dmshah', 'alayi', 'psadtler']",0,[],20,"['jperrin', 'OsRitmos', 'kahuja', 'ashir23bom', 'akidarsa', 'jcleong', 'ageggles', None, 'AllWires', 'priyam', 'himnshu2', 'singh15', 'ericlisheng', 'yessoddahc05', 'swtcandie', 'ykubo', 'wildkid256', 'sdidla', 'pmavery', 'clarjj01']",25,"['jperrin', 'OsRitmos', 'kahuja', 'ashir23bom', 'akidarsa', 'sprashan', 'jcleong', 'ageggles', 'psadtler', None, 'AllWires', 'priyam', 'himnshu2', 'singh15', 'ericlisheng', 'jvk', 'yessoddahc05', 'swtcandie', 'ykubo', 'wildkid256', 'dmshah', 'sdidla', 'alayi', 'pmavery', 'clarjj01']"
41,59,6,13,1,['jwetheri'],4,"['sathyans', 'cwfishy', 'tbublik', 'jkmgiit']",12,"['ajschoch', 'cui4', 'nosonwan', 'dapeters', 'acallawa', 'miltownboiler', 'kwing', 'smohapat', 'abhiahuja', None, 'spencemitch05', 'jamorale']",17,"['ajschoch', 'nosonwan', 'acallawa', 'miltownboiler', 'kwing', 'jkmgiit', 'smohapat', 'cwfishy', None, 'spencemitch05', 'cui4', 'tbublik', 'dapeters', 'jwetheri', 'abhiahuja', 'sathyans', 'jamorale']"
41,62,6,12,1,['tbublik'],4,"['jwetheri', 'cwfishy', 'sathyans', 'jkmgiit']",11,"['singleelectron', 'nhamer2', 'jookalook', 'shossei2', 'pwitkow2', 'rykothari', 'dsherid3', 'towster2', 'mlao2', None, 'bridgwater']",16,"['nhamer2', 'shossei2', 'pwitkow2', 'jkmgiit', 'dsherid3', 'cwfishy', 'mlao2', None, 'bridgwater', 'singleelectron', 'tbublik', 'jookalook', 'rykothari', 'jwetheri', 'towster2', 'sathyans']"
42,12,6,8,5,"['jlbaker4', 'dramatt', 'iwto2000', 'rcosby', 'dndabler']",0,[],3,"['cawhittern', None, 'necoleman']",8,"['jlbaker4', 'dramatt', 'iwto2000', 'rcosby', 'cawhittern', 'dndabler', 'necoleman', None]"
42,68,6,8,5,"['jlbaker4', 'dramatt', 'iwto2000', 'rcosby', 'dndabler']",0,[],3,"['cawhittern', None, 'necoleman']",8,"['jlbaker4', 'dramatt', 'iwto2000', 'rcosby', 'cawhittern', 'dndabler', 'necoleman', None]"
44,39,6,11,4,"['ddickjr', 'xnlepro', 'ndngoc1010', 'jxx071000']",1,['aradja'],7,"['skparkle', 'nourn', 'archana1v', 'ttamtong', 'termini_qin', None, 'bryan_crockett']",12,"['xnlepro', 'ddickjr', 'termini_qin', None, 'ndngoc1010', 'aradja', 'skparkle', 'nourn', 'archana1v', 'jxx071000', 'ttamtong', 'bryan_crockett']"
44,10,6,7,4,"['aradja', 'ddickjr', 'jxx071000', 'ndngoc1010']",1,['xnlepro'],3,"[None, 'archana1v', 'sd2008']",8,"['xnlepro', 'sd2008', 'archana1v', 'jxx071000', 'ddickjr', 'aradja', None, 'ndngoc1010']"
44,13,6,7,4,"['ddickjr', 'xnlepro', 'ndngoc1010', 'jxx071000']",1,['aradja'],3,"['nourn', None, 'archana1v']",8,"['xnlepro', 'nourn', 'archana1v', 'jxx071000', 'ddickjr', 'aradja', None, 'ndngoc1010']"
44,38,6,7,1,['xnlepro'],4,"['aradja', 'ddickjr', 'jxx071000', 'ndngoc1010']",6,"['skparkle', 'nourn', 'archana1v', 'ttamtong', None, 'bryan_crockett']",11,"['xnlepro', 'skparkle', 'nourn', 'archana1v', 'jxx071000', 'ttamtong', 'ddickjr', 'aradja', None, 'ndngoc1010', 'bryan_crockett']"
