MClusterID,XClusterID,MClusterSize,XClusterSize,OverlapSize,OverlapMembers,MOnlySize,MOnlyMembers,XOnlySize,XOnlyMembers,CombinedSize,CombinedMembers
1,146,191,189,180,"['jlee1', 'spahwa', 'rbarbera', 'jlou', 'kvercauteren', 'yyangtony', 'ablood', 'mkonanur', 'wgrimes', 'jlw553', 'lmao', 'jminuzzo', 'ragarwal', 'ssaha', 'kshih', 'msimon', 'vraghunathan', 'askim', 'mdoerfler', 'mrs392', 'qprtx', 'mwe', 'hrayala', 'sprasad09', 'tcheong', 'apetersel', 'kbailey', 'mlee', 'eaguirre', 'dabramov1', 'kleinweber99', 'gkim', 'bchester', 'lmiller', 'tkim1113', 'jsl685', 'benglish013', 'achoi', 'nrk959', 'mco274', 'gwheaton', 'xli', 'hbang', 'jjkim', 'jhutcheson', 'mdalzell', 'jhoover22', 'njs310', 'acaneva', 'jsy256', 'eyousif', 'ctimpon', 'hlee2013', 'tnasr', 'emoore', 'connieyang', 'pmehta', 'lyu', 'acipiti', 'lsabih', 'kchadha', 'rgrohman', 'coryj', 'haalac', 'nleon', 'jhoover', 'agunn', 'jtownsend', 'bschmidt', 'ycl481', 'omu863', 'wmccabe', 'amukherjee', 'mread', 'nvasilottos', 'cclu', 'rgoettelman', 'nnemon', 'rsingh24', 'ukkathawalla', 'slhatch', 'acm119', 'hlu', 'jlamano', 'enick', 'btiano', 'mootwo17', 'ujain', 'cmosier', 'jmcknight', 'mofallor', 'kbhatt', 'azheng', 'fhuang', 'gpeal', 'pjethwani', 'cburghard', 'yeseongkim', 'anamath', 'jprindle', 'pscalise', 'bminer', 'kschmidt', 'jfriedman', 'fallensail', 'ktausk', 'myang', 'ysaxena', 'jbrewster', 'mtellakat', 'dlin', 'esegre', 'the', 'jwu', 'jnugent', 'soohoahn322', 'ysiddhartha', 'rparikh', 'mgoldberg', 'asampson', 'sgoel', 'vch204', 'danieloh', 'ali436', 'msladek', 'afox', 'rajatverma1', 'mong', 'lyung', 'okusoro', 'nmosberg', 'bcacioppo', 'krr401', 'tjk1991', 'jluo', 'gursimransingh', 'kaziz', 'gsheldon', 'fchow', 'nkansara', 'kcarson', 'djin', 'syk', 'dshore', 'apraiss', 'ask788', 'abrugman', 'qianfz', 'iabbott', 'w00tm0ng3r', 'okamber', 'rsurrey09', 'jschwarzbauer', 'rlad', 'sferdous', 'dladic', 'ptoth', 'ltran88', 'frichter91', 'evanthunt6', 'dsloan', 'edubois', 'ekesler', 'brao', 'arepucci', 'mbohorquez', 'jwarlick', 'rsubramanian', 'fcummins', 'randywaymire', 'benjaminceaser2013', 'mfischer', 'bchao', 'sbailey', 'jli1', 'ase548', 'hjeon', 'kashif', 'jchurchill', 'aiglesias']",11,"['cschnaith', 'tjeong', 'hlevine', 'lknapp', 'theinhibitor', 'eappelt', 'hvanvalkenburgh', 'ksuchun0822', 'nrddt', 'cebben', 'ltang21']",9,"['lcheng', 'earanderson', 'kang1120', 'mlodriguito', 'anmura', 'tomekiasimeon', 'zhian', 'lfriesen', 'nkatz2013']",200,"['jlee1', 'spahwa', 'rbarbera', 'jlou', 'kvercauteren', 'yyangtony', 'ablood', 'mkonanur', 'jlw553', 'lmao', 'ragarwal', 'kshih', 'vraghunathan', 'mdoerfler', 'hrayala', 'tcheong', 'kbailey', 'mlee', 'eaguirre', 'dabramov1', 'kleinweber99', 'lmiller', 'gkim', 'tkim1113', 'jsl685', 'lknapp', 'achoi', 'mco274', 'xli', 'hbang', 'jjkim', 'jhutcheson', 'njs310', 'jsy256', 'ctimpon', 'hlee2013', 'tnasr', 'emoore', 'connieyang', 'lsabih', 'kchadha', 'rgrohman', 'haalac', 'jhoover', 'agunn', 'jtownsend', 'omu863', 'wmccabe', 'amukherjee', 'cclu', 'rgoettelman', 'ukkathawalla', 'slhatch', 'mootwo17', 'cmosier', 'kbhatt', 'azheng', 'fhuang', 'gpeal', 'cburghard', 'yeseongkim', 'earanderson', 'bminer', 'jfriedman', 'ktausk', 'nkatz2013', 'myang', 'ysaxena', 'dlin', 'esegre', 'ysiddhartha', 'mgoldberg', 'vch204', 'afox', 'rajatverma1', 'lyung', 'okusoro', 'nmosberg', 'bcacioppo', 'jluo', 'gursimransingh', 'gsheldon', 'fchow', 'kcarson', 'djin', 'ask788', 'qianfz', 'nrddt', 'anmura', 'zhian', 'rlad', 'dladic', 'ptoth', 'arepucci', 'theinhibitor', 'sbailey', 'jli1', 'hjeon', 'aiglesias', 'wgrimes', 'jminuzzo', 'ssaha', 'msimon', 'askim', 'mrs392', 'qprtx', 'tjeong', 'mwe', 'sprasad09', 'apetersel', 'bchester', 'benglish013', 'mlodriguito', 'gwheaton', 'nrk959', 'cschnaith', 'mdalzell', 'eappelt', 'jhoover22', 'acaneva', 'eyousif', 'lfriesen', 'pmehta', 'lyu', 'acipiti', 'coryj', 'nleon', 'cebben', 'bschmidt', 'ycl481', 'lcheng', 'mread', 'nvasilottos', 'nnemon', 'rsingh24', 'acm119', 'enick', 'hlu', 'btiano', 'jlamano', 'ujain', 'kang1120', 'jmcknight', 'mofallor', 'hvanvalkenburgh', 'pjethwani', 'anamath', 'jprindle', 'pscalise', 'hlevine', 'kschmidt', 'fallensail', 'mtellakat', 'jbrewster', 'the', 'jnugent', 'jwu', 'soohoahn322', 'rparikh', 'asampson', 'sgoel', 'danieloh', 'ali436', 'msladek', 'mong', 'krr401', 'tjk1991', 'kaziz', 'nkansara', 'tomekiasimeon', 'syk', 'dshore', 'ltang21', 'apraiss', 'abrugman', 'iabbott', 'w00tm0ng3r', 'okamber', 'jschwarzbauer', 'rsurrey09', 'sferdous', 'frichter91', 'ltran88', 'evanthunt6', 'dsloan', 'edubois', 'ekesler', 'ksuchun0822', 'brao', 'mbohorquez', 'jwarlick', 'rsubramanian', 'fcummins', 'randywaymire', 'benjaminceaser2013', 'mfischer', 'bchao', 'ase548', 'kashif', 'jchurchill']"
1,109,191,187,179,"['jlee1', 'spahwa', 'rbarbera', 'jlou', 'kvercauteren', 'yyangtony', 'ablood', 'mkonanur', 'wgrimes', 'jlw553', 'lmao', 'jminuzzo', 'ragarwal', 'ssaha', 'kshih', 'msimon', 'vraghunathan', 'askim', 'mdoerfler', 'mrs392', 'mwe', 'tjeong', 'hrayala', 'sprasad09', 'tcheong', 'apetersel', 'kbailey', 'mlee', 'eaguirre', 'dabramov1', 'kleinweber99', 'gkim', 'lmiller', 'tkim1113', 'jsl685', 'benglish013', 'lknapp', 'achoi', 'nrk959', 'mco274', 'gwheaton', 'xli', 'hbang', 'cschnaith', 'jjkim', 'jhutcheson', 'mdalzell', 'eappelt', 'jhoover22', 'njs310', 'acaneva', 'jsy256', 'eyousif', 'ctimpon', 'hlee2013', 'tnasr', 'connieyang', 'pmehta', 'lyu', 'acipiti', 'lsabih', 'kchadha', 'rgrohman', 'coryj', 'haalac', 'nleon', 'jhoover', 'agunn', 'cebben', 'jtownsend', 'bschmidt', 'omu863', 'wmccabe', 'amukherjee', 'mread', 'nvasilottos', 'cclu', 'rgoettelman', 'nnemon', 'rsingh24', 'ukkathawalla', 'slhatch', 'acm119', 'hlu', 'jlamano', 'enick', 'btiano', 'mootwo17', 'ujain', 'cmosier', 'jmcknight', 'kbhatt', 'hvanvalkenburgh', 'azheng', 'fhuang', 'gpeal', 'pjethwani', 'cburghard', 'yeseongkim', 'anamath', 'jprindle', 'pscalise', 'bminer', 'hlevine', 'kschmidt', 'jfriedman', 'fallensail', 'ktausk', 'myang', 'ysaxena', 'mtellakat', 'dlin', 'esegre', 'the', 'jwu', 'jnugent', 'soohoahn322', 'ysiddhartha', 'rparikh', 'mgoldberg', 'asampson', 'sgoel', 'danieloh', 'ali436', 'msladek', 'afox', 'rajatverma1', 'mong', 'lyung', 'okusoro', 'nmosberg', 'bcacioppo', 'tjk1991', 'jluo', 'gursimransingh', 'kaziz', 'gsheldon', 'fchow', 'nkansara', 'kcarson', 'djin', 'syk', 'dshore', 'ltang21', 'ask788', 'qianfz', 'iabbott', 'w00tm0ng3r', 'nrddt', 'okamber', 'rsurrey09', 'jschwarzbauer', 'rlad', 'sferdous', 'dladic', 'ptoth', 'ltran88', 'frichter91', 'dsloan', 'edubois', 'ekesler', 'ksuchun0822', 'arepucci', 'mbohorquez', 'jwarlick', 'rsubramanian', 'fcummins', 'randywaymire', 'benjaminceaser2013', 'theinhibitor', 'mfischer', 'bchao', 'sbailey', 'jli1', 'ase548', 'hjeon', 'kashif', 'jchurchill', 'aiglesias']",12,"['apraiss', 'qprtx', 'krr401', 'abrugman', 'jbrewster', 'evanthunt6', 'emoore', 'mofallor', 'vch204', 'brao', 'bchester', 'ycl481']",8,"['jzh576', 'smparker', 'kinzele', 'anmura', 'nkatz', 'zhian', 'tjl715', None]",199,"['jlee1', 'spahwa', 'rbarbera', 'jlou', 'kvercauteren', 'yyangtony', 'ablood', 'mkonanur', 'jlw553', 'lmao', 'ragarwal', 'kshih', 'vraghunathan', 'mdoerfler', 'hrayala', 'tcheong', 'kbailey', 'mlee', 'eaguirre', 'dabramov1', 'kleinweber99', 'lmiller', 'gkim', 'tkim1113', 'jsl685', 'lknapp', 'achoi', 'mco274', 'xli', 'hbang', 'jjkim', 'jhutcheson', 'njs310', 'jsy256', 'ctimpon', 'hlee2013', 'tnasr', 'emoore', 'connieyang', 'lsabih', 'kchadha', 'rgrohman', 'haalac', 'jhoover', 'agunn', 'jtownsend', None, 'omu863', 'wmccabe', 'amukherjee', 'cclu', 'rgoettelman', 'ukkathawalla', 'slhatch', 'mootwo17', 'cmosier', 'kbhatt', 'azheng', 'fhuang', 'gpeal', 'cburghard', 'yeseongkim', 'bminer', 'jfriedman', 'ktausk', 'myang', 'ysaxena', 'dlin', 'esegre', 'ysiddhartha', 'mgoldberg', 'vch204', 'afox', 'rajatverma1', 'lyung', 'okusoro', 'nmosberg', 'bcacioppo', 'jzh576', 'jluo', 'gursimransingh', 'gsheldon', 'fchow', 'kcarson', 'djin', 'ask788', 'qianfz', 'nrddt', 'anmura', 'zhian', 'tjl715', 'rlad', 'dladic', 'ptoth', 'arepucci', 'theinhibitor', 'sbailey', 'jli1', 'hjeon', 'aiglesias', 'wgrimes', 'jminuzzo', 'ssaha', 'kinzele', 'msimon', 'askim', 'nkatz', 'mrs392', 'qprtx', 'tjeong', 'mwe', 'sprasad09', 'apetersel', 'bchester', 'benglish013', 'gwheaton', 'nrk959', 'cschnaith', 'mdalzell', 'eappelt', 'jhoover22', 'acaneva', 'eyousif', 'pmehta', 'lyu', 'acipiti', 'coryj', 'nleon', 'cebben', 'bschmidt', 'ycl481', 'mread', 'nvasilottos', 'nnemon', 'rsingh24', 'acm119', 'enick', 'hlu', 'btiano', 'jlamano', 'ujain', 'jmcknight', 'mofallor', 'hvanvalkenburgh', 'pjethwani', 'anamath', 'jprindle', 'pscalise', 'hlevine', 'kschmidt', 'fallensail', 'mtellakat', 'jbrewster', 'the', 'jnugent', 'jwu', 'soohoahn322', 'rparikh', 'asampson', 'sgoel', 'danieloh', 'ali436', 'msladek', 'mong', 'krr401', 'tjk1991', 'kaziz', 'nkansara', 'syk', 'dshore', 'ltang21', 'apraiss', 'abrugman', 'iabbott', 'w00tm0ng3r', 'okamber', 'jschwarzbauer', 'rsurrey09', 'sferdous', 'frichter91', 'ltran88', 'evanthunt6', 'dsloan', 'edubois', 'ekesler', 'ksuchun0822', 'brao', 'mbohorquez', 'jwarlick', 'rsubramanian', 'fcummins', 'randywaymire', 'benjaminceaser2013', 'mfischer', 'bchao', 'ase548', 'kashif', 'smparker', 'jchurchill']"
1,46,191,182,174,"['jlee1', 'spahwa', 'rbarbera', 'jlou', 'kvercauteren', 'yyangtony', 'ablood', 'mkonanur', 'wgrimes', 'jlw553', 'lmao', 'jminuzzo', 'ragarwal', 'ssaha', 'kshih', 'msimon', 'vraghunathan', 'askim', 'mdoerfler', 'mrs392', 'qprtx', 'mwe', 'tjeong', 'hrayala', 'sprasad09', 'tcheong', 'apetersel', 'kbailey', 'eaguirre', 'dabramov1', 'bchester', 'gkim', 'lmiller', 'tkim1113', 'jsl685', 'benglish013', 'lknapp', 'achoi', 'nrk959', 'gwheaton', 'xli', 'jjkim', 'cschnaith', 'hbang', 'jhutcheson', 'mdalzell', 'eappelt', 'njs310', 'acaneva', 'eyousif', 'ctimpon', 'hlee2013', 'tnasr', 'emoore', 'connieyang', 'pmehta', 'lyu', 'acipiti', 'lsabih', 'kchadha', 'rgrohman', 'coryj', 'nleon', 'jhoover', 'agunn', 'cebben', 'jtownsend', 'bschmidt', 'omu863', 'ycl481', 'wmccabe', 'amukherjee', 'mread', 'nvasilottos', 'cclu', 'rgoettelman', 'nnemon', 'rsingh24', 'ukkathawalla', 'acm119', 'jlamano', 'hlu', 'enick', 'btiano', 'mootwo17', 'cmosier', 'jmcknight', 'mofallor', 'kbhatt', 'hvanvalkenburgh', 'azheng', 'fhuang', 'gpeal', 'pjethwani', 'cburghard', 'anamath', 'jprindle', 'pscalise', 'bminer', 'hlevine', 'kschmidt', 'jfriedman', 'fallensail', 'ktausk', 'myang', 'jbrewster', 'mtellakat', 'dlin', 'the', 'jwu', 'jnugent', 'soohoahn322', 'ysiddhartha', 'mgoldberg', 'asampson', 'sgoel', 'vch204', 'danieloh', 'ali436', 'msladek', 'afox', 'rajatverma1', 'mong', 'lyung', 'okusoro', 'nmosberg', 'bcacioppo', 'jluo', 'gursimransingh', 'kaziz', 'gsheldon', 'fchow', 'kcarson', 'djin', 'syk', 'dshore', 'ltang21', 'ask788', 'abrugman', 'qianfz', 'w00tm0ng3r', 'nrddt', 'okamber', 'rsurrey09', 'jschwarzbauer', 'rlad', 'sferdous', 'dladic', 'ptoth', 'ltran88', 'frichter91', 'evanthunt6', 'dsloan', 'edubois', 'ekesler', 'ksuchun0822', 'brao', 'arepucci', 'mbohorquez', 'jwarlick', 'rsubramanian', 'fcummins', 'randywaymire', 'benjaminceaser2013', 'theinhibitor', 'mfischer', 'bchao', 'sbailey', 'jli1', 'ase548', 'hjeon', 'kashif', 'jchurchill', 'aiglesias']",17,"['ujain', 'apraiss', 'krr401', 'ysaxena', 'tjk1991', 'haalac', 'iabbott', 'esegre', 'nkansara', 'jhoover22', 'mco274', 'slhatch', 'mlee', 'jsy256', 'kleinweber99', 'rparikh', 'yeseongkim']",8,"['ctlin', 'kennedyr', 'smparker', 'achangelian', 'anmura', 'tomekiasimeon', 'zhian', None]",199,"['jlee1', 'spahwa', 'rbarbera', 'jlou', 'kvercauteren', 'yyangtony', 'ablood', 'mkonanur', 'jlw553', 'lmao', 'ragarwal', 'kshih', 'vraghunathan', 'mdoerfler', 'hrayala', 'tcheong', 'kbailey', 'mlee', 'eaguirre', 'dabramov1', 'kleinweber99', 'lmiller', 'gkim', 'tkim1113', 'jsl685', 'lknapp', 'achoi', 'mco274', 'xli', 'hbang', 'jjkim', 'jhutcheson', 'njs310', 'jsy256', 'ctimpon', 'hlee2013', 'tnasr', 'emoore', 'connieyang', 'lsabih', 'kchadha', 'rgrohman', 'haalac', 'jhoover', 'agunn', 'jtownsend', None, 'omu863', 'wmccabe', 'amukherjee', 'cclu', 'rgoettelman', 'ukkathawalla', 'slhatch', 'mootwo17', 'cmosier', 'kbhatt', 'azheng', 'fhuang', 'gpeal', 'cburghard', 'yeseongkim', 'bminer', 'jfriedman', 'ktausk', 'myang', 'ysaxena', 'kennedyr', 'dlin', 'esegre', 'ysiddhartha', 'mgoldberg', 'vch204', 'afox', 'rajatverma1', 'lyung', 'okusoro', 'nmosberg', 'bcacioppo', 'jluo', 'gursimransingh', 'gsheldon', 'fchow', 'kcarson', 'djin', 'ask788', 'qianfz', 'nrddt', 'anmura', 'zhian', 'rlad', 'dladic', 'ptoth', 'arepucci', 'theinhibitor', 'sbailey', 'jli1', 'hjeon', 'aiglesias', 'wgrimes', 'jminuzzo', 'ssaha', 'msimon', 'askim', 'mrs392', 'qprtx', 'tjeong', 'mwe', 'sprasad09', 'apetersel', 'bchester', 'benglish013', 'gwheaton', 'nrk959', 'cschnaith', 'mdalzell', 'eappelt', 'jhoover22', 'acaneva', 'eyousif', 'pmehta', 'lyu', 'acipiti', 'coryj', 'nleon', 'achangelian', 'cebben', 'bschmidt', 'ycl481', 'mread', 'nvasilottos', 'nnemon', 'rsingh24', 'acm119', 'enick', 'hlu', 'btiano', 'jlamano', 'ujain', 'ctlin', 'jmcknight', 'mofallor', 'hvanvalkenburgh', 'pjethwani', 'anamath', 'jprindle', 'pscalise', 'hlevine', 'kschmidt', 'fallensail', 'mtellakat', 'jbrewster', 'the', 'jnugent', 'jwu', 'soohoahn322', 'rparikh', 'asampson', 'sgoel', 'danieloh', 'ali436', 'msladek', 'mong', 'krr401', 'tjk1991', 'kaziz', 'nkansara', 'tomekiasimeon', 'syk', 'dshore', 'ltang21', 'apraiss', 'abrugman', 'iabbott', 'w00tm0ng3r', 'okamber', 'jschwarzbauer', 'rsurrey09', 'sferdous', 'frichter91', 'ltran88', 'evanthunt6', 'dsloan', 'edubois', 'ekesler', 'ksuchun0822', 'brao', 'mbohorquez', 'jwarlick', 'rsubramanian', 'fcummins', 'randywaymire', 'benjaminceaser2013', 'mfischer', 'bchao', 'ase548', 'kashif', 'smparker', 'jchurchill']"
1,145,191,35,29,"['yyangtony', 'ablood', 'kbhatt', 'gpeal', 'eyousif', 'ragarwal', 'tnasr', 'mdoerfler', 'rgrohman', 'sferdous', 'mtellakat', 'apetersel', 'mbohorquez', 'gkim', 'omu863', 'jwarlick', 'asampson', 'nvasilottos', 'danieloh', 'mfischer', 'rsingh24', 'nnemon', 'jli1', 'mco274', 'slhatch', 'afox', 'rajatverma1', 'jlamano', 'hbang']",162,"['jlee1', 'spahwa', 'rbarbera', 'jlou', 'kvercauteren', 'wgrimes', 'mkonanur', 'jlw553', 'lmao', 'jminuzzo', 'ssaha', 'kshih', 'msimon', 'vraghunathan', 'askim', 'mrs392', 'qprtx', 'tjeong', 'mwe', 'sprasad09', 'hrayala', 'tcheong', 'kbailey', 'mlee', 'eaguirre', 'dabramov1', 'kleinweber99', 'bchester', 'lmiller', 'tkim1113', 'jsl685', 'benglish013', 'lknapp', 'achoi', 'gwheaton', 'nrk959', 'xli', 'cschnaith', 'jjkim', 'jhutcheson', 'mdalzell', 'eappelt', 'jhoover22', 'njs310', 'acaneva', 'jsy256', 'ctimpon', 'hlee2013', 'emoore', 'connieyang', 'pmehta', 'lyu', 'acipiti', 'lsabih', 'kchadha', 'coryj', 'haalac', 'nleon', 'jhoover', 'agunn', 'cebben', 'jtownsend', 'bschmidt', 'ycl481', 'wmccabe', 'amukherjee', 'mread', 'cclu', 'rgoettelman', 'ukkathawalla', 'acm119', 'enick', 'mootwo17', 'btiano', 'hlu', 'ujain', 'cmosier', 'jmcknight', 'mofallor', 'hvanvalkenburgh', 'azheng', 'fhuang', 'pjethwani', 'cburghard', 'anamath', 'yeseongkim', 'jprindle', 'pscalise', 'bminer', 'hlevine', 'jfriedman', 'kschmidt', 'fallensail', 'ktausk', 'myang', 'ysaxena', 'jbrewster', 'dlin', 'esegre', 'the', 'jnugent', 'jwu', 'soohoahn322', 'ysiddhartha', 'rparikh', 'mgoldberg', 'sgoel', 'vch204', 'ali436', 'msladek', 'mong', 'lyung', 'okusoro', 'nmosberg', 'bcacioppo', 'krr401', 'jluo', 'tjk1991', 'gursimransingh', 'kaziz', 'gsheldon', 'fchow', 'nkansara', 'kcarson', 'djin', 'syk', 'dshore', 'ltang21', 'apraiss', 'abrugman', 'ask788', 'qianfz', 'iabbott', 'w00tm0ng3r', 'nrddt', 'okamber', 'jschwarzbauer', 'rsurrey09', 'rlad', 'dladic', 'ptoth', 'ltran88', 'frichter91', 'evanthunt6', 'dsloan', 'edubois', 'ekesler', 'ksuchun0822', 'brao', 'arepucci', 'rsubramanian', 'fcummins', 'randywaymire', 'benjaminceaser2013', 'theinhibitor', 'bchao', 'sbailey', 'ase548', 'hjeon', 'kashif', 'jchurchill', 'aiglesias']",6,"['kang1120', 'kennedyr', 'anmura', None, 'ttownsend', 'smparker']",197,"['jlee1', 'spahwa', 'rbarbera', 'jlou', 'kvercauteren', 'yyangtony', 'wgrimes', 'mkonanur', 'ablood', 'jlw553', 'lmao', 'jminuzzo', 'ragarwal', 'ssaha', 'kshih', 'msimon', 'vraghunathan', 'askim', 'mdoerfler', 'mrs392', 'qprtx', 'tjeong', 'mwe', 'sprasad09', 'hrayala', 'tcheong', 'apetersel', 'kbailey', 'mlee', 'eaguirre', 'dabramov1', 'kleinweber99', 'bchester', 'lmiller', 'gkim', 'tkim1113', 'jsl685', 'benglish013', 'lknapp', 'achoi', 'gwheaton', 'mco274', 'nrk959', 'xli', 'ttownsend', 'hbang', 'cschnaith', 'jjkim', 'jhutcheson', 'mdalzell', 'eappelt', 'jhoover22', 'njs310', 'acaneva', 'jsy256', 'ctimpon', 'eyousif', 'hlee2013', 'tnasr', 'emoore', 'connieyang', 'pmehta', 'lyu', 'acipiti', 'lsabih', 'kchadha', 'rgrohman', 'coryj', 'haalac', 'nleon', 'jhoover', 'agunn', 'cebben', 'jtownsend', 'bschmidt', None, 'omu863', 'ycl481', 'wmccabe', 'amukherjee', 'mread', 'nvasilottos', 'cclu', 'rgoettelman', 'nnemon', 'rsingh24', 'ukkathawalla', 'acm119', 'slhatch', 'enick', 'mootwo17', 'btiano', 'hlu', 'ujain', 'jlamano', 'cmosier', 'kang1120', 'jmcknight', 'mofallor', 'kbhatt', 'hvanvalkenburgh', 'azheng', 'fhuang', 'gpeal', 'pjethwani', 'cburghard', 'anamath', 'yeseongkim', 'jprindle', 'pscalise', 'bminer', 'hlevine', 'jfriedman', 'kschmidt', 'fallensail', 'ktausk', 'myang', 'ysaxena', 'kennedyr', 'mtellakat', 'jbrewster', 'dlin', 'esegre', 'the', 'jnugent', 'jwu', 'soohoahn322', 'ysiddhartha', 'rparikh', 'mgoldberg', 'asampson', 'sgoel', 'vch204', 'ali436', 'danieloh', 'msladek', 'afox', 'rajatverma1', 'mong', 'lyung', 'okusoro', 'nmosberg', 'bcacioppo', 'krr401', 'jluo', 'tjk1991', 'gursimransingh', 'kaziz', 'gsheldon', 'fchow', 'nkansara', 'kcarson', 'djin', 'syk', 'dshore', 'ltang21', 'apraiss', 'abrugman', 'ask788', 'qianfz', 'iabbott', 'w00tm0ng3r', 'nrddt', 'anmura', 'okamber', 'jschwarzbauer', 'rsurrey09', 'rlad', 'sferdous', 'dladic', 'ptoth', 'ltran88', 'frichter91', 'evanthunt6', 'dsloan', 'edubois', 'ekesler', 'ksuchun0822', 'brao', 'arepucci', 'mbohorquez', 'jwarlick', 'rsubramanian', 'fcummins', 'randywaymire', 'benjaminceaser2013', 'theinhibitor', 'mfischer', 'bchao', 'sbailey', 'jli1', 'ase548', 'hjeon', 'kashif', 'smparker', 'jchurchill', 'aiglesias']"
1,111,191,22,20,"['mkonanur', 'gsheldon', 'djin', 'jlw553', 'gpeal', 'apraiss', 'jfriedman', 'qianfz', 'mdoerfler', 'lsabih', 'rgrohman', 'apetersel', 'brao', 'jnugent', 'rgoettelman', 'btiano', 'ali436', 'xli', 'aiglesias', 'nmosberg']",171,"['jlee1', 'spahwa', 'rbarbera', 'jlou', 'kvercauteren', 'yyangtony', 'wgrimes', 'ablood', 'lmao', 'jminuzzo', 'ragarwal', 'ssaha', 'kshih', 'msimon', 'vraghunathan', 'askim', 'mrs392', 'qprtx', 'tjeong', 'mwe', 'sprasad09', 'hrayala', 'tcheong', 'kbailey', 'mlee', 'eaguirre', 'dabramov1', 'kleinweber99', 'bchester', 'lmiller', 'gkim', 'tkim1113', 'jsl685', 'benglish013', 'lknapp', 'achoi', 'gwheaton', 'mco274', 'nrk959', 'hbang', 'cschnaith', 'jjkim', 'jhutcheson', 'mdalzell', 'eappelt', 'jhoover22', 'njs310', 'acaneva', 'jsy256', 'ctimpon', 'eyousif', 'hlee2013', 'tnasr', 'emoore', 'connieyang', 'pmehta', 'lyu', 'acipiti', 'kchadha', 'coryj', 'haalac', 'nleon', 'jhoover', 'agunn', 'cebben', 'jtownsend', 'bschmidt', 'omu863', 'ycl481', 'wmccabe', 'amukherjee', 'mread', 'nvasilottos', 'cclu', 'nnemon', 'rsingh24', 'ukkathawalla', 'acm119', 'slhatch', 'enick', 'mootwo17', 'hlu', 'ujain', 'jlamano', 'cmosier', 'jmcknight', 'mofallor', 'kbhatt', 'hvanvalkenburgh', 'azheng', 'fhuang', 'pjethwani', 'cburghard', 'anamath', 'yeseongkim', 'jprindle', 'pscalise', 'bminer', 'hlevine', 'kschmidt', 'fallensail', 'ktausk', 'myang', 'ysaxena', 'mtellakat', 'jbrewster', 'dlin', 'esegre', 'the', 'jwu', 'soohoahn322', 'ysiddhartha', 'rparikh', 'mgoldberg', 'asampson', 'sgoel', 'vch204', 'danieloh', 'msladek', 'afox', 'rajatverma1', 'mong', 'lyung', 'okusoro', 'bcacioppo', 'krr401', 'jluo', 'tjk1991', 'gursimransingh', 'kaziz', 'fchow', 'nkansara', 'kcarson', 'syk', 'dshore', 'ltang21', 'abrugman', 'ask788', 'iabbott', 'w00tm0ng3r', 'nrddt', 'okamber', 'jschwarzbauer', 'rsurrey09', 'rlad', 'sferdous', 'dladic', 'ptoth', 'ltran88', 'frichter91', 'evanthunt6', 'dsloan', 'edubois', 'ekesler', 'ksuchun0822', 'arepucci', 'mbohorquez', 'jwarlick', 'rsubramanian', 'fcummins', 'randywaymire', 'benjaminceaser2013', 'theinhibitor', 'mfischer', 'bchao', 'sbailey', 'jli1', 'ase548', 'hjeon', 'kashif', 'jchurchill']",2,"[None, 'kinzele']",193,"['jlee1', 'spahwa', 'rbarbera', 'jlou', 'kvercauteren', 'yyangtony', 'wgrimes', 'mkonanur', 'ablood', 'jlw553', 'lmao', 'jminuzzo', 'ragarwal', 'ssaha', 'kinzele', 'kshih', 'msimon', 'vraghunathan', 'askim', 'mdoerfler', 'mrs392', 'qprtx', 'tjeong', 'mwe', 'sprasad09', 'hrayala', 'tcheong', 'apetersel', 'kbailey', 'mlee', 'eaguirre', 'dabramov1', 'kleinweber99', 'bchester', 'lmiller', 'gkim', 'tkim1113', 'jsl685', 'benglish013', 'lknapp', 'achoi', 'gwheaton', 'mco274', 'nrk959', 'xli', 'hbang', 'cschnaith', 'jjkim', 'jhutcheson', 'mdalzell', 'eappelt', 'jhoover22', 'njs310', 'acaneva', 'jsy256', 'ctimpon', 'eyousif', 'hlee2013', 'tnasr', 'emoore', 'connieyang', 'pmehta', 'lyu', 'acipiti', 'lsabih', 'kchadha', 'rgrohman', 'coryj', 'haalac', 'nleon', 'jhoover', 'agunn', 'cebben', 'jtownsend', 'bschmidt', None, 'omu863', 'ycl481', 'wmccabe', 'amukherjee', 'mread', 'nvasilottos', 'cclu', 'rgoettelman', 'nnemon', 'rsingh24', 'ukkathawalla', 'acm119', 'slhatch', 'enick', 'mootwo17', 'btiano', 'hlu', 'ujain', 'jlamano', 'cmosier', 'jmcknight', 'mofallor', 'kbhatt', 'hvanvalkenburgh', 'azheng', 'fhuang', 'gpeal', 'pjethwani', 'cburghard', 'anamath', 'yeseongkim', 'jprindle', 'pscalise', 'bminer', 'hlevine', 'jfriedman', 'kschmidt', 'fallensail', 'ktausk', 'myang', 'ysaxena', 'mtellakat', 'jbrewster', 'dlin', 'esegre', 'the', 'jnugent', 'jwu', 'soohoahn322', 'ysiddhartha', 'rparikh', 'mgoldberg', 'asampson', 'sgoel', 'vch204', 'ali436', 'danieloh', 'msladek', 'afox', 'rajatverma1', 'mong', 'lyung', 'okusoro', 'nmosberg', 'bcacioppo', 'krr401', 'jluo', 'tjk1991', 'gursimransingh', 'kaziz', 'gsheldon', 'fchow', 'nkansara', 'kcarson', 'djin', 'syk', 'dshore', 'ltang21', 'apraiss', 'abrugman', 'ask788', 'qianfz', 'iabbott', 'w00tm0ng3r', 'nrddt', 'okamber', 'jschwarzbauer', 'rsurrey09', 'rlad', 'sferdous', 'dladic', 'ptoth', 'ltran88', 'frichter91', 'evanthunt6', 'dsloan', 'edubois', 'ekesler', 'ksuchun0822', 'brao', 'arepucci', 'mbohorquez', 'jwarlick', 'rsubramanian', 'fcummins', 'randywaymire', 'benjaminceaser2013', 'theinhibitor', 'mfischer', 'bchao', 'sbailey', 'jli1', 'ase548', 'hjeon', 'kashif', 'jchurchill', 'aiglesias']"
1,110,191,8,6,"['ysaxena', 'pscalise', 'coryj', 'eyousif', 'syk', 'mgoldberg']",185,"['jlee1', 'spahwa', 'rbarbera', 'jlou', 'kvercauteren', 'yyangtony', 'wgrimes', 'mkonanur', 'ablood', 'jlw553', 'lmao', 'jminuzzo', 'ragarwal', 'ssaha', 'kshih', 'msimon', 'vraghunathan', 'askim', 'mdoerfler', 'mrs392', 'qprtx', 'tjeong', 'mwe', 'sprasad09', 'hrayala', 'tcheong', 'apetersel', 'kbailey', 'mlee', 'eaguirre', 'dabramov1', 'kleinweber99', 'bchester', 'lmiller', 'gkim', 'tkim1113', 'jsl685', 'benglish013', 'lknapp', 'achoi', 'gwheaton', 'mco274', 'nrk959', 'xli', 'hbang', 'cschnaith', 'jjkim', 'jhutcheson', 'mdalzell', 'eappelt', 'jhoover22', 'njs310', 'acaneva', 'jsy256', 'ctimpon', 'hlee2013', 'tnasr', 'emoore', 'connieyang', 'pmehta', 'lyu', 'acipiti', 'lsabih', 'kchadha', 'rgrohman', 'haalac', 'nleon', 'jhoover', 'agunn', 'cebben', 'jtownsend', 'bschmidt', 'omu863', 'ycl481', 'wmccabe', 'amukherjee', 'mread', 'nvasilottos', 'cclu', 'rgoettelman', 'nnemon', 'rsingh24', 'ukkathawalla', 'acm119', 'slhatch', 'enick', 'mootwo17', 'btiano', 'hlu', 'ujain', 'jlamano', 'cmosier', 'jmcknight', 'mofallor', 'kbhatt', 'hvanvalkenburgh', 'azheng', 'fhuang', 'gpeal', 'pjethwani', 'cburghard', 'anamath', 'yeseongkim', 'jprindle', 'bminer', 'hlevine', 'jfriedman', 'kschmidt', 'fallensail', 'ktausk', 'myang', 'mtellakat', 'jbrewster', 'dlin', 'esegre', 'the', 'jnugent', 'jwu', 'soohoahn322', 'ysiddhartha', 'rparikh', 'asampson', 'sgoel', 'vch204', 'ali436', 'danieloh', 'msladek', 'afox', 'rajatverma1', 'mong', 'lyung', 'okusoro', 'nmosberg', 'bcacioppo', 'krr401', 'jluo', 'tjk1991', 'gursimransingh', 'kaziz', 'gsheldon', 'fchow', 'nkansara', 'kcarson', 'djin', 'dshore', 'ltang21', 'apraiss', 'abrugman', 'ask788', 'qianfz', 'iabbott', 'w00tm0ng3r', 'nrddt', 'okamber', 'jschwarzbauer', 'rsurrey09', 'rlad', 'sferdous', 'dladic', 'ptoth', 'ltran88', 'frichter91', 'evanthunt6', 'dsloan', 'edubois', 'ekesler', 'ksuchun0822', 'brao', 'arepucci', 'mbohorquez', 'jwarlick', 'rsubramanian', 'fcummins', 'randywaymire', 'benjaminceaser2013', 'theinhibitor', 'mfischer', 'bchao', 'sbailey', 'jli1', 'ase548', 'hjeon', 'kashif', 'jchurchill', 'aiglesias']",2,"[None, 'kang1120']",193,"['jlee1', 'spahwa', 'rbarbera', 'jlou', 'kvercauteren', 'yyangtony', 'wgrimes', 'mkonanur', 'ablood', 'jlw553', 'lmao', 'jminuzzo', 'ragarwal', 'ssaha', 'kshih', 'msimon', 'vraghunathan', 'askim', 'mdoerfler', 'mrs392', 'qprtx', 'tjeong', 'mwe', 'sprasad09', 'hrayala', 'tcheong', 'apetersel', 'kbailey', 'mlee', 'eaguirre', 'dabramov1', 'kleinweber99', 'bchester', 'lmiller', 'gkim', 'tkim1113', 'jsl685', 'benglish013', 'lknapp', 'achoi', 'gwheaton', 'mco274', 'nrk959', 'xli', 'hbang', 'cschnaith', 'jjkim', 'jhutcheson', 'mdalzell', 'eappelt', 'jhoover22', 'njs310', 'acaneva', 'jsy256', 'ctimpon', 'eyousif', 'hlee2013', 'tnasr', 'emoore', 'connieyang', 'pmehta', 'lyu', 'acipiti', 'lsabih', 'kchadha', 'rgrohman', 'coryj', 'haalac', 'nleon', 'jhoover', 'agunn', 'cebben', 'jtownsend', 'bschmidt', None, 'omu863', 'ycl481', 'wmccabe', 'amukherjee', 'mread', 'nvasilottos', 'cclu', 'rgoettelman', 'nnemon', 'rsingh24', 'ukkathawalla', 'acm119', 'slhatch', 'enick', 'mootwo17', 'btiano', 'hlu', 'ujain', 'jlamano', 'cmosier', 'kang1120', 'jmcknight', 'mofallor', 'kbhatt', 'hvanvalkenburgh', 'azheng', 'fhuang', 'gpeal', 'pjethwani', 'cburghard', 'anamath', 'yeseongkim', 'jprindle', 'pscalise', 'bminer', 'hlevine', 'jfriedman', 'kschmidt', 'fallensail', 'ktausk', 'myang', 'ysaxena', 'mtellakat', 'jbrewster', 'dlin', 'esegre', 'the', 'jnugent', 'jwu', 'soohoahn322', 'ysiddhartha', 'rparikh', 'mgoldberg', 'asampson', 'sgoel', 'vch204', 'ali436', 'danieloh', 'msladek', 'afox', 'rajatverma1', 'mong', 'lyung', 'okusoro', 'nmosberg', 'bcacioppo', 'krr401', 'jluo', 'tjk1991', 'gursimransingh', 'kaziz', 'gsheldon', 'fchow', 'nkansara', 'kcarson', 'djin', 'syk', 'dshore', 'ltang21', 'apraiss', 'abrugman', 'ask788', 'qianfz', 'iabbott', 'w00tm0ng3r', 'nrddt', 'okamber', 'jschwarzbauer', 'rsurrey09', 'rlad', 'sferdous', 'dladic', 'ptoth', 'ltran88', 'frichter91', 'evanthunt6', 'dsloan', 'edubois', 'ekesler', 'ksuchun0822', 'brao', 'arepucci', 'mbohorquez', 'jwarlick', 'rsubramanian', 'fcummins', 'randywaymire', 'benjaminceaser2013', 'theinhibitor', 'mfischer', 'bchao', 'sbailey', 'jli1', 'ase548', 'hjeon', 'kashif', 'jchurchill', 'aiglesias']"
1,148,191,6,3,"['ukkathawalla', 'nrk959', 'aiglesias']",188,"['jlee1', 'spahwa', 'rbarbera', 'jlou', 'kvercauteren', 'yyangtony', 'wgrimes', 'mkonanur', 'ablood', 'jlw553', 'lmao', 'jminuzzo', 'ragarwal', 'ssaha', 'kshih', 'msimon', 'vraghunathan', 'askim', 'mdoerfler', 'mrs392', 'qprtx', 'tjeong', 'mwe', 'sprasad09', 'hrayala', 'tcheong', 'apetersel', 'kbailey', 'mlee', 'eaguirre', 'dabramov1', 'kleinweber99', 'bchester', 'lmiller', 'gkim', 'tkim1113', 'jsl685', 'benglish013', 'lknapp', 'achoi', 'gwheaton', 'mco274', 'xli', 'hbang', 'cschnaith', 'jjkim', 'jhutcheson', 'mdalzell', 'eappelt', 'jhoover22', 'njs310', 'acaneva', 'jsy256', 'ctimpon', 'eyousif', 'hlee2013', 'tnasr', 'emoore', 'connieyang', 'pmehta', 'lyu', 'acipiti', 'lsabih', 'kchadha', 'rgrohman', 'coryj', 'haalac', 'nleon', 'jhoover', 'agunn', 'cebben', 'jtownsend', 'bschmidt', 'omu863', 'ycl481', 'wmccabe', 'amukherjee', 'mread', 'nvasilottos', 'cclu', 'rgoettelman', 'nnemon', 'rsingh24', 'acm119', 'slhatch', 'enick', 'mootwo17', 'btiano', 'hlu', 'ujain', 'jlamano', 'cmosier', 'jmcknight', 'mofallor', 'kbhatt', 'hvanvalkenburgh', 'azheng', 'fhuang', 'gpeal', 'pjethwani', 'cburghard', 'anamath', 'yeseongkim', 'jprindle', 'pscalise', 'bminer', 'hlevine', 'jfriedman', 'kschmidt', 'fallensail', 'ktausk', 'myang', 'ysaxena', 'mtellakat', 'jbrewster', 'dlin', 'esegre', 'the', 'jnugent', 'jwu', 'soohoahn322', 'ysiddhartha', 'rparikh', 'mgoldberg', 'asampson', 'sgoel', 'vch204', 'ali436', 'danieloh', 'msladek', 'afox', 'rajatverma1', 'mong', 'lyung', 'okusoro', 'nmosberg', 'bcacioppo', 'krr401', 'jluo', 'tjk1991', 'gursimransingh', 'kaziz', 'gsheldon', 'fchow', 'nkansara', 'kcarson', 'djin', 'syk', 'dshore', 'ltang21', 'apraiss', 'abrugman', 'ask788', 'qianfz', 'iabbott', 'w00tm0ng3r', 'nrddt', 'okamber', 'jschwarzbauer', 'rsurrey09', 'rlad', 'sferdous', 'dladic', 'ptoth', 'ltran88', 'frichter91', 'evanthunt6', 'dsloan', 'edubois', 'ekesler', 'ksuchun0822', 'brao', 'arepucci', 'mbohorquez', 'jwarlick', 'rsubramanian', 'fcummins', 'randywaymire', 'benjaminceaser2013', 'theinhibitor', 'mfischer', 'bchao', 'sbailey', 'jli1', 'ase548', 'hjeon', 'kashif', 'jchurchill']",3,"[None, 'smparker', 'kennedyr']",194,"['jlee1', 'spahwa', 'rbarbera', 'jlou', 'kvercauteren', 'yyangtony', 'wgrimes', 'mkonanur', 'ablood', 'jlw553', 'lmao', 'jminuzzo', 'ragarwal', 'ssaha', 'kshih', 'msimon', 'vraghunathan', 'askim', 'mdoerfler', 'mrs392', 'qprtx', 'tjeong', 'mwe', 'sprasad09', 'hrayala', 'tcheong', 'apetersel', 'kbailey', 'mlee', 'eaguirre', 'dabramov1', 'kleinweber99', 'bchester', 'lmiller', 'gkim', 'tkim1113', 'jsl685', 'benglish013', 'lknapp', 'achoi', 'gwheaton', 'mco274', 'nrk959', 'xli', 'hbang', 'cschnaith', 'jjkim', 'jhutcheson', 'mdalzell', 'eappelt', 'jhoover22', 'njs310', 'acaneva', 'jsy256', 'ctimpon', 'eyousif', 'hlee2013', 'tnasr', 'emoore', 'connieyang', 'pmehta', 'lyu', 'acipiti', 'lsabih', 'kchadha', 'rgrohman', 'coryj', 'haalac', 'nleon', 'jhoover', 'agunn', 'cebben', 'jtownsend', 'bschmidt', None, 'omu863', 'ycl481', 'wmccabe', 'amukherjee', 'mread', 'nvasilottos', 'cclu', 'rgoettelman', 'nnemon', 'rsingh24', 'ukkathawalla', 'acm119', 'slhatch', 'enick', 'mootwo17', 'btiano', 'hlu', 'ujain', 'jlamano', 'cmosier', 'jmcknight', 'mofallor', 'kbhatt', 'hvanvalkenburgh', 'azheng', 'fhuang', 'gpeal', 'pjethwani', 'cburghard', 'anamath', 'yeseongkim', 'jprindle', 'pscalise', 'bminer', 'hlevine', 'jfriedman', 'kschmidt', 'fallensail', 'ktausk', 'myang', 'ysaxena', 'kennedyr', 'mtellakat', 'jbrewster', 'dlin', 'esegre', 'the', 'jnugent', 'jwu', 'soohoahn322', 'ysiddhartha', 'rparikh', 'mgoldberg', 'asampson', 'sgoel', 'vch204', 'ali436', 'danieloh', 'msladek', 'afox', 'rajatverma1', 'mong', 'lyung', 'okusoro', 'nmosberg', 'bcacioppo', 'krr401', 'jluo', 'tjk1991', 'gursimransingh', 'kaziz', 'gsheldon', 'fchow', 'nkansara', 'kcarson', 'djin', 'syk', 'dshore', 'ltang21', 'apraiss', 'abrugman', 'ask788', 'qianfz', 'iabbott', 'w00tm0ng3r', 'nrddt', 'okamber', 'jschwarzbauer', 'rsurrey09', 'rlad', 'sferdous', 'dladic', 'ptoth', 'ltran88', 'frichter91', 'evanthunt6', 'dsloan', 'edubois', 'ekesler', 'ksuchun0822', 'brao', 'arepucci', 'mbohorquez', 'jwarlick', 'rsubramanian', 'fcummins', 'randywaymire', 'benjaminceaser2013', 'theinhibitor', 'mfischer', 'bchao', 'sbailey', 'jli1', 'ase548', 'hjeon', 'kashif', 'smparker', 'jchurchill', 'aiglesias']"
2,176,144,162,143,"['bvoon', 'crkidwel', 'brangara', 'ychao', 'prabhu_m', 'reaper117', 'jschortg', 'mpanzare', 'gmusyj', 'mlababid', 'whess', 'sdevoe', 'nrkeen', 'patricklin', 'cdewes229', 'djvarnau', 'oghaisas', 'gmcnamer', 'ahaberlein', 'cykim', 'mbroski', 'bkhandag', 'brperry', 'fiqbal91', 'hsanghvi', 'sdang90', 'jiang31', 'mjbuechl', 'steind', 'tpour3491', 'adhirots', 'nrobison', 'asahni', 'mwalders', 'mihir14', 'twinget', 'doegerle', 'akiran', 'pg1646', 'twildb00', 'mpenderg', 'tschreib', 'upandey', 'tydiercks', 'nkwolek', 'pmoses', 'amwhitne', 'mnharris', 'jason89s', 'slaurids', 'askumar', 'kpetrucc', 'cho72', 'rschuman', 'lillylovebug', 'white73', 'jengelbe', 'lee291', 'bsobecki', 'aphanse', 'cscripp', 'wright46', 'pan3', 'mlovell', 'jphunter', 'reckel', 'ryokubaka', 'mdeschne', 'jon3153', 'tstrzele', 'ltaylor', 'alagneau', 'dlopez', 'petermathias', 'dhancock', 'jaesungyoun', 'jjyoun', 'khaver', 'kperrin', 'yamisamo', 'baharman', 'tmbutler', 'jpatmast', 'myokem', 'awlayton', 'jcmccorm', 'shicheng', 'sufimazli90', 'kakashow', 'djrobles', 'jgrivera', 'wtso', 'jgiron', 'mchuff', 'jasonholmes89', 'mjacobso', 'shreyan', 'rjgarman', 'rdpritch', 'dhanahan', 'jhuffaker', 'wdu', 'yue0', 'phillijn', 'lee439', 'spensing', 'haydenlee', 'mplankey', 'msathak', 'ceverhar', 'cdoty', 'sbogensc', 'mboudas', 'bmccool', 'cpmalone', 'waseemkhoury', 'rsthomps', 'chang71', 'ahmed11', 'bshutt', 'kskidmor', 'jvclark', 'smyrick', 'sfedro', 'tscheidl', 'owensec', 'matt_parker', 'jmulvain', 'gjware', 'dsabo', 'jmlindle', 'dougmoney', 'ctimko', 'spudster', 'nhammel', 'kvogler', 'robertra', 'cmottaz', 'colorfula', 'mzwach', 'stkerr', 'wang391', 'erkendall']",0,[],19,"['ctaub', 'zesmith', 'derialstrazus', 'clarksm', 'nbaker', 'pbyers', 'mgwillia', 'rbpeders', 'lee607', 'pmarepal', 'areinhar9', 'mhunold', 'clarksnano', 'bwbrown', None, 'vchiguru', 'hungc', 'awarsana', 'jlyeung']",162,"['bvoon', 'crkidwel', 'ctaub', 'brangara', 'ychao', 'prabhu_m', 'reaper117', 'jschortg', 'mpanzare', 'gmusyj', 'nbaker', 'mlababid', 'whess', 'sdevoe', 'nrkeen', 'patricklin', 'cdewes229', 'pmarepal', 'djvarnau', 'oghaisas', 'gmcnamer', 'ahaberlein', 'cykim', 'mbroski', 'bkhandag', 'brperry', 'fiqbal91', 'hsanghvi', 'sdang90', 'jiang31', 'mjbuechl', 'steind', 'tpour3491', 'adhirots', 'nrobison', 'asahni', 'mwalders', 'awarsana', 'mihir14', 'twinget', 'doegerle', 'akiran', 'pg1646', 'twildb00', 'derialstrazus', 'mgwillia', 'mpenderg', 'lee607', 'tschreib', 'upandey', 'tydiercks', 'nkwolek', 'pmoses', 'amwhitne', 'mnharris', 'jason89s', 'slaurids', 'askumar', 'kpetrucc', 'cho72', 'rschuman', 'lillylovebug', 'white73', 'jengelbe', 'lee291', 'bsobecki', 'aphanse', 'cscripp', 'wright46', 'pan3', None, 'mlovell', 'jphunter', 'vchiguru', 'reckel', 'ryokubaka', 'mdeschne', 'jon3153', 'tstrzele', 'ltaylor', 'alagneau', 'dlopez', 'petermathias', 'dhancock', 'jaesungyoun', 'jjyoun', 'khaver', 'kperrin', 'yamisamo', 'baharman', 'tmbutler', 'jpatmast', 'myokem', 'areinhar9', 'awlayton', 'jcmccorm', 'shicheng', 'sufimazli90', 'kakashow', 'djrobles', 'jgrivera', 'wtso', 'jgiron', 'bwbrown', 'mchuff', 'jasonholmes89', 'mjacobso', 'shreyan', 'rjgarman', 'rdpritch', 'hungc', 'dhanahan', 'jhuffaker', 'wdu', 'yue0', 'phillijn', 'lee439', 'spensing', 'haydenlee', 'mplankey', 'msathak', 'ceverhar', 'cdoty', 'sbogensc', 'mboudas', 'bmccool', 'cpmalone', 'zesmith', 'clarksm', 'waseemkhoury', 'rsthomps', 'pbyers', 'chang71', 'ahmed11', 'rbpeders', 'bshutt', 'kskidmor', 'jvclark', 'smyrick', 'sfedro', 'tscheidl', 'owensec', 'matt_parker', 'jmulvain', 'gjware', 'dsabo', 'mhunold', 'jmlindle', 'clarksnano', 'dougmoney', 'ctimko', 'spudster', 'nhammel', 'kvogler', 'robertra', 'cmottaz', 'colorfula', 'mzwach', 'stkerr', 'wang391', 'erkendall', 'jlyeung']"
2,175,144,37,32,"['crkidwel', 'akiran', 'ceverhar', 'khaver', 'gmusyj', 'waseemkhoury', 'sdevoe', 'nrkeen', 'upandey', 'tschreib', 'amwhitne', 'matt_parker', 'jmulvain', 'shicheng', 'kakashow', 'jgrivera', 'askumar', 'kpetrucc', 'nhammel', 'cscripp', 'robertra', 'pan3', 'mlovell', 'mzwach', 'shreyan', 'wang391', 'jphunter', 'tpour3491', 'mdeschne', 'tstrzele', 'mwalders', 'phillijn']",111,"['bvoon', 'brangara', 'ychao', 'prabhu_m', 'reaper117', 'jschortg', 'mpanzare', 'mlababid', 'whess', 'patricklin', 'cdewes229', 'djvarnau', 'oghaisas', 'gmcnamer', 'ahaberlein', 'cykim', 'bkhandag', 'mbroski', 'brperry', 'fiqbal91', 'hsanghvi', 'sdang90', 'jiang31', 'mjbuechl', 'steind', 'adhirots', 'nrobison', 'asahni', 'mihir14', 'twinget', 'doegerle', 'pg1646', 'twildb00', 'mpenderg', 'tydiercks', 'nkwolek', 'pmoses', 'mnharris', 'jason89s', 'slaurids', 'cho72', 'rschuman', 'lillylovebug', 'white73', 'jengelbe', 'lee291', 'bsobecki', 'aphanse', 'wright46', 'reckel', 'ryokubaka', 'jon3153', 'ltaylor', 'alagneau', 'dlopez', 'petermathias', 'dhancock', 'jaesungyoun', 'jjyoun', 'kperrin', 'yamisamo', 'baharman', 'tmbutler', 'jpatmast', 'myokem', 'awlayton', 'jcmccorm', 'sufimazli90', 'djrobles', 'wtso', 'jgiron', 'mchuff', 'jasonholmes89', 'mjacobso', 'rjgarman', 'rdpritch', 'dhanahan', 'jhuffaker', 'wdu', 'yue0', 'lee439', 'spensing', 'haydenlee', 'mplankey', 'msathak', 'cdoty', 'sbogensc', 'mboudas', 'bmccool', 'cpmalone', 'rsthomps', 'chang71', 'ahmed11', 'bshutt', 'kskidmor', 'jvclark', 'smyrick', 'sfedro', 'tscheidl', 'owensec', 'gjware', 'dsabo', 'jmlindle', 'dougmoney', 'ctimko', 'spudster', 'kvogler', 'cmottaz', 'colorfula', 'stkerr', 'erkendall']",5,"['jvnane', 'areinhar9', 'jlyeung', None, 'pbyers']",148,"['bvoon', 'crkidwel', 'brangara', 'ychao', 'prabhu_m', 'reaper117', 'jschortg', 'mpanzare', 'gmusyj', 'mlababid', 'whess', 'sdevoe', 'nrkeen', 'patricklin', 'cdewes229', 'djvarnau', 'oghaisas', 'gmcnamer', 'ahaberlein', 'cykim', 'mbroski', 'bkhandag', 'brperry', 'fiqbal91', 'hsanghvi', 'sdang90', 'jiang31', 'mjbuechl', 'steind', 'tpour3491', 'adhirots', 'nrobison', 'asahni', 'mwalders', 'mihir14', 'twinget', 'doegerle', 'akiran', 'pg1646', 'twildb00', 'mpenderg', 'tschreib', 'upandey', 'tydiercks', 'nkwolek', 'pmoses', 'amwhitne', 'mnharris', 'jason89s', 'slaurids', 'askumar', 'kpetrucc', 'cho72', 'rschuman', 'lillylovebug', 'white73', 'jengelbe', 'lee291', 'bsobecki', 'aphanse', 'cscripp', 'wright46', 'pan3', None, 'mlovell', 'jphunter', 'reckel', 'ryokubaka', 'mdeschne', 'jon3153', 'tstrzele', 'ltaylor', 'alagneau', 'dlopez', 'petermathias', 'dhancock', 'jaesungyoun', 'jjyoun', 'khaver', 'kperrin', 'yamisamo', 'baharman', 'tmbutler', 'jpatmast', 'myokem', 'areinhar9', 'awlayton', 'jcmccorm', 'shicheng', 'sufimazli90', 'kakashow', 'djrobles', 'jgrivera', 'wtso', 'jgiron', 'mchuff', 'jasonholmes89', 'mjacobso', 'shreyan', 'jvnane', 'rjgarman', 'rdpritch', 'dhanahan', 'jhuffaker', 'wdu', 'yue0', 'phillijn', 'lee439', 'spensing', 'haydenlee', 'mplankey', 'msathak', 'ceverhar', 'cdoty', 'sbogensc', 'mboudas', 'bmccool', 'cpmalone', 'waseemkhoury', 'rsthomps', 'pbyers', 'chang71', 'ahmed11', 'bshutt', 'kskidmor', 'jvclark', 'smyrick', 'sfedro', 'tscheidl', 'owensec', 'matt_parker', 'jmulvain', 'gjware', 'dsabo', 'jmlindle', 'dougmoney', 'ctimko', 'spudster', 'nhammel', 'kvogler', 'robertra', 'cmottaz', 'colorfula', 'mzwach', 'stkerr', 'wang391', 'erkendall', 'jlyeung']"
2,173,144,24,14,"['ahmed11', 'adhirots', 'petermathias', 'cho72', 'rdpritch', 'tschreib', 'reaper117', 'tydiercks', 'mwalders', 'ahaberlein', 'pmoses', 'wright46', 'yamisamo', 'fiqbal91']",129,"['bvoon', 'crkidwel', 'brangara', 'ychao', 'prabhu_m', 'jschortg', 'mpanzare', 'gmusyj', 'mlababid', 'whess', 'sdevoe', 'nrkeen', 'patricklin', 'cdewes229', 'djvarnau', 'oghaisas', 'gmcnamer', 'cykim', 'mbroski', 'bkhandag', 'brperry', 'hsanghvi', 'sdang90', 'jiang31', 'mjbuechl', 'steind', 'tpour3491', 'nrobison', 'asahni', 'mihir14', 'twinget', 'doegerle', 'akiran', 'pg1646', 'twildb00', 'mpenderg', 'upandey', 'nkwolek', 'amwhitne', 'mnharris', 'jason89s', 'slaurids', 'askumar', 'kpetrucc', 'rschuman', 'lillylovebug', 'white73', 'jengelbe', 'lee291', 'bsobecki', 'aphanse', 'cscripp', 'pan3', 'mlovell', 'jphunter', 'reckel', 'ryokubaka', 'mdeschne', 'jon3153', 'tstrzele', 'ltaylor', 'alagneau', 'dlopez', 'dhancock', 'jaesungyoun', 'jjyoun', 'khaver', 'kperrin', 'baharman', 'tmbutler', 'jpatmast', 'myokem', 'awlayton', 'jcmccorm', 'shicheng', 'sufimazli90', 'kakashow', 'djrobles', 'jgrivera', 'wtso', 'jgiron', 'mchuff', 'jasonholmes89', 'mjacobso', 'shreyan', 'rjgarman', 'dhanahan', 'jhuffaker', 'wdu', 'yue0', 'phillijn', 'lee439', 'spensing', 'haydenlee', 'mplankey', 'msathak', 'ceverhar', 'cdoty', 'sbogensc', 'mboudas', 'bmccool', 'cpmalone', 'waseemkhoury', 'rsthomps', 'chang71', 'bshutt', 'kskidmor', 'jvclark', 'smyrick', 'sfedro', 'tscheidl', 'owensec', 'matt_parker', 'jmulvain', 'gjware', 'dsabo', 'jmlindle', 'dougmoney', 'ctimko', 'spudster', 'nhammel', 'kvogler', 'robertra', 'cmottaz', 'colorfula', 'mzwach', 'stkerr', 'wang391', 'erkendall']",10,"['rbpeders', 'vchiguru', 'lee607', 'derialstrazus', 'areinhar9', 'awarsana', 'nbaker', 'jlyeung', None, 'mhunold']",153,"['bvoon', 'crkidwel', 'brangara', 'ychao', 'prabhu_m', 'reaper117', 'jschortg', 'mpanzare', 'gmusyj', 'nbaker', 'mlababid', 'whess', 'sdevoe', 'nrkeen', 'patricklin', 'cdewes229', 'djvarnau', 'oghaisas', 'gmcnamer', 'ahaberlein', 'cykim', 'mbroski', 'bkhandag', 'brperry', 'fiqbal91', 'hsanghvi', 'sdang90', 'jiang31', 'mjbuechl', 'steind', 'tpour3491', 'adhirots', 'nrobison', 'asahni', 'mwalders', 'awarsana', 'mihir14', 'twinget', 'doegerle', 'akiran', 'pg1646', 'twildb00', 'derialstrazus', 'mpenderg', 'lee607', 'tschreib', 'upandey', 'tydiercks', 'nkwolek', 'pmoses', 'amwhitne', 'mnharris', 'jason89s', 'slaurids', 'askumar', 'kpetrucc', 'cho72', 'rschuman', 'lillylovebug', 'white73', 'jengelbe', 'lee291', 'bsobecki', 'aphanse', 'cscripp', 'wright46', 'pan3', None, 'mlovell', 'jphunter', 'vchiguru', 'reckel', 'ryokubaka', 'mdeschne', 'jon3153', 'tstrzele', 'ltaylor', 'alagneau', 'dlopez', 'petermathias', 'dhancock', 'jaesungyoun', 'jjyoun', 'khaver', 'kperrin', 'yamisamo', 'baharman', 'tmbutler', 'jpatmast', 'myokem', 'areinhar9', 'awlayton', 'jcmccorm', 'shicheng', 'sufimazli90', 'kakashow', 'djrobles', 'jgrivera', 'wtso', 'jgiron', 'mchuff', 'jasonholmes89', 'mjacobso', 'shreyan', 'rjgarman', 'rdpritch', 'dhanahan', 'jhuffaker', 'wdu', 'yue0', 'phillijn', 'lee439', 'spensing', 'haydenlee', 'mplankey', 'msathak', 'ceverhar', 'cdoty', 'sbogensc', 'mboudas', 'bmccool', 'cpmalone', 'waseemkhoury', 'rsthomps', 'chang71', 'ahmed11', 'rbpeders', 'bshutt', 'kskidmor', 'jvclark', 'smyrick', 'sfedro', 'tscheidl', 'owensec', 'matt_parker', 'jmulvain', 'gjware', 'dsabo', 'mhunold', 'jmlindle', 'dougmoney', 'ctimko', 'spudster', 'nhammel', 'kvogler', 'robertra', 'cmottaz', 'colorfula', 'mzwach', 'stkerr', 'wang391', 'erkendall', 'jlyeung']"
2,174,144,21,18,"['wang391', 'jgrivera', 'shicheng', 'ceverhar', 'askumar', 'sdevoe', 'kpetrucc', 'nrkeen', 'mdeschne', 'upandey', 'tschreib', 'khaver', 'mwalders', 'amwhitne', 'robertra', 'jmulvain', 'gmusyj', 'phillijn']",125,"['bvoon', 'crkidwel', 'brangara', 'ychao', 'prabhu_m', 'reaper117', 'jschortg', 'mpanzare', 'mlababid', 'whess', 'patricklin', 'cdewes229', 'djvarnau', 'oghaisas', 'gmcnamer', 'ahaberlein', 'cykim', 'mbroski', 'bkhandag', 'brperry', 'fiqbal91', 'hsanghvi', 'sdang90', 'jiang31', 'mjbuechl', 'steind', 'tpour3491', 'adhirots', 'nrobison', 'asahni', 'mihir14', 'twinget', 'doegerle', 'akiran', 'pg1646', 'twildb00', 'mpenderg', 'tydiercks', 'nkwolek', 'pmoses', 'mnharris', 'jason89s', 'slaurids', 'cho72', 'rschuman', 'lillylovebug', 'white73', 'jengelbe', 'lee291', 'bsobecki', 'aphanse', 'cscripp', 'wright46', 'pan3', 'mlovell', 'jphunter', 'reckel', 'ryokubaka', 'jon3153', 'tstrzele', 'ltaylor', 'alagneau', 'dlopez', 'petermathias', 'dhancock', 'jaesungyoun', 'jjyoun', 'kperrin', 'yamisamo', 'baharman', 'tmbutler', 'jpatmast', 'myokem', 'awlayton', 'jcmccorm', 'sufimazli90', 'kakashow', 'djrobles', 'wtso', 'jgiron', 'mchuff', 'jasonholmes89', 'mjacobso', 'shreyan', 'rjgarman', 'rdpritch', 'dhanahan', 'jhuffaker', 'wdu', 'yue0', 'lee439', 'spensing', 'haydenlee', 'mplankey', 'msathak', 'cdoty', 'sbogensc', 'mboudas', 'bmccool', 'cpmalone', 'waseemkhoury', 'rsthomps', 'chang71', 'ahmed11', 'bshutt', 'kskidmor', 'jvclark', 'smyrick', 'sfedro', 'tscheidl', 'owensec', 'matt_parker', 'gjware', 'dsabo', 'jmlindle', 'dougmoney', 'ctimko', 'spudster', 'nhammel', 'kvogler', 'cmottaz', 'colorfula', 'mzwach', 'stkerr', 'erkendall']",3,"['jlyeung', None, 'pbyers']",146,"['bvoon', 'crkidwel', 'brangara', 'ychao', 'prabhu_m', 'reaper117', 'jschortg', 'mpanzare', 'gmusyj', 'mlababid', 'whess', 'sdevoe', 'nrkeen', 'patricklin', 'cdewes229', 'djvarnau', 'oghaisas', 'gmcnamer', 'ahaberlein', 'cykim', 'mbroski', 'bkhandag', 'brperry', 'fiqbal91', 'hsanghvi', 'sdang90', 'jiang31', 'mjbuechl', 'steind', 'tpour3491', 'adhirots', 'nrobison', 'asahni', 'mwalders', 'mihir14', 'twinget', 'doegerle', 'akiran', 'pg1646', 'twildb00', 'mpenderg', 'tschreib', 'upandey', 'tydiercks', 'nkwolek', 'pmoses', 'amwhitne', 'mnharris', 'jason89s', 'slaurids', 'askumar', 'kpetrucc', 'cho72', 'rschuman', 'lillylovebug', 'white73', 'jengelbe', 'lee291', 'bsobecki', 'aphanse', 'cscripp', 'wright46', 'pan3', None, 'mlovell', 'jphunter', 'reckel', 'ryokubaka', 'mdeschne', 'jon3153', 'tstrzele', 'ltaylor', 'alagneau', 'dlopez', 'petermathias', 'dhancock', 'jaesungyoun', 'jjyoun', 'khaver', 'kperrin', 'yamisamo', 'baharman', 'tmbutler', 'jpatmast', 'myokem', 'awlayton', 'jcmccorm', 'shicheng', 'sufimazli90', 'kakashow', 'djrobles', 'jgrivera', 'wtso', 'jgiron', 'mchuff', 'jasonholmes89', 'mjacobso', 'shreyan', 'rjgarman', 'rdpritch', 'dhanahan', 'jhuffaker', 'wdu', 'yue0', 'phillijn', 'lee439', 'spensing', 'haydenlee', 'mplankey', 'msathak', 'ceverhar', 'cdoty', 'sbogensc', 'mboudas', 'bmccool', 'cpmalone', 'waseemkhoury', 'rsthomps', 'pbyers', 'chang71', 'ahmed11', 'bshutt', 'kskidmor', 'jvclark', 'smyrick', 'sfedro', 'tscheidl', 'owensec', 'matt_parker', 'jmulvain', 'gjware', 'dsabo', 'jmlindle', 'dougmoney', 'ctimko', 'spudster', 'nhammel', 'kvogler', 'robertra', 'cmottaz', 'colorfula', 'mzwach', 'stkerr', 'wang391', 'erkendall', 'jlyeung']"
2,178,144,15,13,"['ahmed11', 'doegerle', 'sdang90', 'msathak', 'jiang31', 'mboudas', 'ychao', 'smyrick', 'prabhu_m', 'lillylovebug', 'mpanzare', 'mihir14', 'mlababid']",130,"['bvoon', 'crkidwel', 'brangara', 'reaper117', 'jschortg', 'gmusyj', 'whess', 'sdevoe', 'nrkeen', 'patricklin', 'cdewes229', 'djvarnau', 'oghaisas', 'gmcnamer', 'ahaberlein', 'cykim', 'mbroski', 'bkhandag', 'brperry', 'fiqbal91', 'hsanghvi', 'mjbuechl', 'steind', 'tpour3491', 'adhirots', 'nrobison', 'asahni', 'mwalders', 'twinget', 'akiran', 'pg1646', 'twildb00', 'mpenderg', 'tschreib', 'upandey', 'tydiercks', 'nkwolek', 'pmoses', 'amwhitne', 'mnharris', 'jason89s', 'slaurids', 'askumar', 'kpetrucc', 'cho72', 'rschuman', 'white73', 'jengelbe', 'lee291', 'bsobecki', 'aphanse', 'cscripp', 'wright46', 'pan3', 'mlovell', 'jphunter', 'reckel', 'ryokubaka', 'mdeschne', 'jon3153', 'tstrzele', 'ltaylor', 'alagneau', 'dlopez', 'petermathias', 'dhancock', 'jaesungyoun', 'jjyoun', 'khaver', 'kperrin', 'yamisamo', 'baharman', 'tmbutler', 'jpatmast', 'myokem', 'awlayton', 'jcmccorm', 'shicheng', 'sufimazli90', 'kakashow', 'djrobles', 'jgrivera', 'wtso', 'jgiron', 'mchuff', 'jasonholmes89', 'mjacobso', 'shreyan', 'rjgarman', 'rdpritch', 'dhanahan', 'jhuffaker', 'wdu', 'yue0', 'phillijn', 'lee439', 'spensing', 'haydenlee', 'mplankey', 'ceverhar', 'cdoty', 'sbogensc', 'bmccool', 'cpmalone', 'waseemkhoury', 'rsthomps', 'chang71', 'bshutt', 'kskidmor', 'jvclark', 'sfedro', 'tscheidl', 'owensec', 'matt_parker', 'jmulvain', 'gjware', 'dsabo', 'jmlindle', 'dougmoney', 'ctimko', 'spudster', 'nhammel', 'kvogler', 'robertra', 'cmottaz', 'colorfula', 'mzwach', 'stkerr', 'wang391', 'erkendall']",2,"['ctaub', None]",145,"['bvoon', 'crkidwel', 'ctaub', 'brangara', 'ychao', 'prabhu_m', 'reaper117', 'jschortg', 'mpanzare', 'gmusyj', 'mlababid', 'whess', 'sdevoe', 'nrkeen', 'patricklin', 'cdewes229', 'djvarnau', 'oghaisas', 'gmcnamer', 'ahaberlein', 'cykim', 'mbroski', 'bkhandag', 'brperry', 'fiqbal91', 'hsanghvi', 'sdang90', 'jiang31', 'mjbuechl', 'steind', 'tpour3491', 'adhirots', 'nrobison', 'asahni', 'mwalders', 'mihir14', 'twinget', 'doegerle', 'akiran', 'pg1646', 'twildb00', 'mpenderg', 'tschreib', 'upandey', 'tydiercks', 'nkwolek', 'pmoses', 'amwhitne', 'mnharris', 'jason89s', 'slaurids', 'askumar', 'kpetrucc', 'cho72', 'rschuman', 'lillylovebug', 'white73', 'jengelbe', 'lee291', 'bsobecki', 'aphanse', 'cscripp', 'wright46', 'pan3', None, 'mlovell', 'jphunter', 'reckel', 'ryokubaka', 'mdeschne', 'jon3153', 'tstrzele', 'ltaylor', 'alagneau', 'dlopez', 'petermathias', 'dhancock', 'jaesungyoun', 'jjyoun', 'khaver', 'kperrin', 'yamisamo', 'baharman', 'tmbutler', 'jpatmast', 'myokem', 'awlayton', 'jcmccorm', 'shicheng', 'sufimazli90', 'kakashow', 'djrobles', 'jgrivera', 'wtso', 'jgiron', 'mchuff', 'jasonholmes89', 'mjacobso', 'shreyan', 'rjgarman', 'rdpritch', 'dhanahan', 'jhuffaker', 'wdu', 'yue0', 'phillijn', 'lee439', 'spensing', 'haydenlee', 'mplankey', 'msathak', 'ceverhar', 'cdoty', 'sbogensc', 'mboudas', 'bmccool', 'cpmalone', 'waseemkhoury', 'rsthomps', 'chang71', 'ahmed11', 'bshutt', 'kskidmor', 'jvclark', 'smyrick', 'sfedro', 'tscheidl', 'owensec', 'matt_parker', 'jmulvain', 'gjware', 'dsabo', 'jmlindle', 'dougmoney', 'ctimko', 'spudster', 'nhammel', 'kvogler', 'robertra', 'cmottaz', 'colorfula', 'mzwach', 'stkerr', 'wang391', 'erkendall']"
2,179,144,10,9,"['shreyan', 'jphunter', 'jgrivera', 'akiran', 'askumar', 'phillijn', 'shicheng', 'waseemkhoury', 'kakashow']",134,"['bvoon', 'crkidwel', 'brangara', 'ychao', 'prabhu_m', 'reaper117', 'jschortg', 'mpanzare', 'gmusyj', 'mlababid', 'whess', 'sdevoe', 'nrkeen', 'patricklin', 'cdewes229', 'djvarnau', 'oghaisas', 'gmcnamer', 'ahaberlein', 'cykim', 'mbroski', 'bkhandag', 'brperry', 'fiqbal91', 'hsanghvi', 'sdang90', 'jiang31', 'mjbuechl', 'steind', 'tpour3491', 'adhirots', 'nrobison', 'asahni', 'mwalders', 'mihir14', 'twinget', 'doegerle', 'pg1646', 'twildb00', 'mpenderg', 'tschreib', 'upandey', 'tydiercks', 'nkwolek', 'pmoses', 'amwhitne', 'mnharris', 'jason89s', 'slaurids', 'kpetrucc', 'cho72', 'rschuman', 'lillylovebug', 'white73', 'jengelbe', 'lee291', 'bsobecki', 'aphanse', 'cscripp', 'wright46', 'pan3', 'mlovell', 'reckel', 'ryokubaka', 'mdeschne', 'jon3153', 'tstrzele', 'ltaylor', 'alagneau', 'dlopez', 'petermathias', 'dhancock', 'jaesungyoun', 'jjyoun', 'khaver', 'kperrin', 'yamisamo', 'baharman', 'tmbutler', 'jpatmast', 'myokem', 'awlayton', 'jcmccorm', 'sufimazli90', 'djrobles', 'wtso', 'jgiron', 'mchuff', 'jasonholmes89', 'mjacobso', 'rjgarman', 'rdpritch', 'dhanahan', 'jhuffaker', 'wdu', 'yue0', 'lee439', 'spensing', 'haydenlee', 'mplankey', 'msathak', 'ceverhar', 'cdoty', 'sbogensc', 'mboudas', 'bmccool', 'cpmalone', 'rsthomps', 'chang71', 'ahmed11', 'bshutt', 'kskidmor', 'jvclark', 'smyrick', 'sfedro', 'tscheidl', 'owensec', 'matt_parker', 'jmulvain', 'gjware', 'dsabo', 'jmlindle', 'dougmoney', 'ctimko', 'spudster', 'nhammel', 'kvogler', 'robertra', 'cmottaz', 'colorfula', 'mzwach', 'stkerr', 'wang391', 'erkendall']",1,[None],144,"['bvoon', 'crkidwel', 'brangara', 'ychao', 'prabhu_m', 'reaper117', 'jschortg', 'mpanzare', 'gmusyj', 'mlababid', 'whess', 'sdevoe', 'nrkeen', 'patricklin', 'cdewes229', 'djvarnau', 'oghaisas', 'gmcnamer', 'ahaberlein', 'cykim', 'mbroski', 'bkhandag', 'brperry', 'fiqbal91', 'hsanghvi', 'sdang90', 'jiang31', 'mjbuechl', 'steind', 'tpour3491', 'adhirots', 'nrobison', 'asahni', 'mwalders', 'mihir14', 'twinget', 'doegerle', 'akiran', 'pg1646', 'twildb00', 'mpenderg', 'tschreib', 'upandey', 'tydiercks', 'nkwolek', 'pmoses', 'amwhitne', 'mnharris', 'jason89s', 'slaurids', 'askumar', 'kpetrucc', 'cho72', 'rschuman', 'lillylovebug', 'white73', 'jengelbe', 'lee291', 'bsobecki', 'aphanse', 'cscripp', 'wright46', 'pan3', None, 'mlovell', 'jphunter', 'reckel', 'ryokubaka', 'mdeschne', 'jon3153', 'tstrzele', 'ltaylor', 'alagneau', 'dlopez', 'petermathias', 'dhancock', 'jaesungyoun', 'jjyoun', 'khaver', 'kperrin', 'yamisamo', 'baharman', 'tmbutler', 'jpatmast', 'myokem', 'awlayton', 'jcmccorm', 'shicheng', 'sufimazli90', 'kakashow', 'djrobles', 'jgrivera', 'wtso', 'jgiron', 'mchuff', 'jasonholmes89', 'mjacobso', 'shreyan', 'rjgarman', 'rdpritch', 'dhanahan', 'jhuffaker', 'wdu', 'yue0', 'phillijn', 'lee439', 'spensing', 'haydenlee', 'mplankey', 'msathak', 'ceverhar', 'cdoty', 'sbogensc', 'mboudas', 'bmccool', 'cpmalone', 'waseemkhoury', 'rsthomps', 'chang71', 'ahmed11', 'bshutt', 'kskidmor', 'jvclark', 'smyrick', 'sfedro', 'tscheidl', 'owensec', 'matt_parker', 'jmulvain', 'gjware', 'dsabo', 'jmlindle', 'dougmoney', 'ctimko', 'spudster', 'nhammel', 'kvogler', 'robertra', 'cmottaz', 'colorfula', 'mzwach', 'stkerr', 'wang391', 'erkendall']"
2,177,144,8,6,"['jgrivera', 'jvclark', 'nrobison', 'spudster', 'phillijn', 'colorfula']",137,"['bvoon', 'crkidwel', 'brangara', 'ychao', 'prabhu_m', 'reaper117', 'jschortg', 'mpanzare', 'gmusyj', 'mlababid', 'whess', 'sdevoe', 'nrkeen', 'patricklin', 'cdewes229', 'djvarnau', 'oghaisas', 'gmcnamer', 'ahaberlein', 'cykim', 'mbroski', 'bkhandag', 'brperry', 'fiqbal91', 'hsanghvi', 'sdang90', 'jiang31', 'mjbuechl', 'steind', 'tpour3491', 'adhirots', 'asahni', 'mwalders', 'mihir14', 'twinget', 'doegerle', 'akiran', 'pg1646', 'twildb00', 'mpenderg', 'tschreib', 'upandey', 'tydiercks', 'nkwolek', 'pmoses', 'amwhitne', 'mnharris', 'jason89s', 'slaurids', 'askumar', 'kpetrucc', 'cho72', 'rschuman', 'lillylovebug', 'white73', 'jengelbe', 'lee291', 'bsobecki', 'aphanse', 'cscripp', 'wright46', 'pan3', 'mlovell', 'jphunter', 'reckel', 'ryokubaka', 'mdeschne', 'jon3153', 'tstrzele', 'ltaylor', 'alagneau', 'dlopez', 'petermathias', 'dhancock', 'jaesungyoun', 'jjyoun', 'khaver', 'kperrin', 'yamisamo', 'baharman', 'tmbutler', 'jpatmast', 'myokem', 'awlayton', 'jcmccorm', 'shicheng', 'sufimazli90', 'kakashow', 'djrobles', 'wtso', 'jgiron', 'mchuff', 'jasonholmes89', 'mjacobso', 'shreyan', 'rjgarman', 'rdpritch', 'dhanahan', 'jhuffaker', 'wdu', 'yue0', 'lee439', 'spensing', 'haydenlee', 'mplankey', 'msathak', 'ceverhar', 'cdoty', 'sbogensc', 'mboudas', 'bmccool', 'cpmalone', 'waseemkhoury', 'rsthomps', 'chang71', 'ahmed11', 'bshutt', 'kskidmor', 'smyrick', 'sfedro', 'tscheidl', 'owensec', 'matt_parker', 'jmulvain', 'gjware', 'dsabo', 'jmlindle', 'dougmoney', 'ctimko', 'nhammel', 'kvogler', 'robertra', 'cmottaz', 'mzwach', 'stkerr', 'wang391', 'erkendall']",2,"[None, 'awarsana']",145,"['bvoon', 'crkidwel', 'brangara', 'ychao', 'prabhu_m', 'reaper117', 'jschortg', 'mpanzare', 'gmusyj', 'mlababid', 'whess', 'sdevoe', 'nrkeen', 'patricklin', 'cdewes229', 'djvarnau', 'oghaisas', 'gmcnamer', 'ahaberlein', 'cykim', 'mbroski', 'bkhandag', 'brperry', 'fiqbal91', 'hsanghvi', 'sdang90', 'jiang31', 'mjbuechl', 'steind', 'tpour3491', 'adhirots', 'nrobison', 'asahni', 'mwalders', 'awarsana', 'mihir14', 'twinget', 'doegerle', 'akiran', 'pg1646', 'twildb00', 'mpenderg', 'tschreib', 'upandey', 'tydiercks', 'nkwolek', 'pmoses', 'amwhitne', 'mnharris', 'jason89s', 'slaurids', 'askumar', 'kpetrucc', 'cho72', 'rschuman', 'lillylovebug', 'white73', 'jengelbe', 'lee291', 'bsobecki', 'aphanse', 'cscripp', 'wright46', 'pan3', None, 'mlovell', 'jphunter', 'reckel', 'ryokubaka', 'mdeschne', 'jon3153', 'tstrzele', 'ltaylor', 'alagneau', 'dlopez', 'petermathias', 'dhancock', 'jaesungyoun', 'jjyoun', 'khaver', 'kperrin', 'yamisamo', 'baharman', 'tmbutler', 'jpatmast', 'myokem', 'awlayton', 'jcmccorm', 'shicheng', 'sufimazli90', 'kakashow', 'djrobles', 'jgrivera', 'wtso', 'jgiron', 'mchuff', 'jasonholmes89', 'mjacobso', 'shreyan', 'rjgarman', 'rdpritch', 'dhanahan', 'jhuffaker', 'wdu', 'yue0', 'phillijn', 'lee439', 'spensing', 'haydenlee', 'mplankey', 'msathak', 'ceverhar', 'cdoty', 'sbogensc', 'mboudas', 'bmccool', 'cpmalone', 'waseemkhoury', 'rsthomps', 'chang71', 'ahmed11', 'bshutt', 'kskidmor', 'jvclark', 'smyrick', 'sfedro', 'tscheidl', 'owensec', 'matt_parker', 'jmulvain', 'gjware', 'dsabo', 'jmlindle', 'dougmoney', 'ctimko', 'spudster', 'nhammel', 'kvogler', 'robertra', 'cmottaz', 'colorfula', 'mzwach', 'stkerr', 'wang391', 'erkendall']"
2,180,144,8,3,"['adhirots', 'fiqbal91', 'wright46']",140,"['bvoon', 'crkidwel', 'brangara', 'ychao', 'prabhu_m', 'reaper117', 'jschortg', 'mpanzare', 'gmusyj', 'mlababid', 'whess', 'sdevoe', 'nrkeen', 'patricklin', 'cdewes229', 'djvarnau', 'oghaisas', 'gmcnamer', 'ahaberlein', 'cykim', 'mbroski', 'bkhandag', 'brperry', 'hsanghvi', 'sdang90', 'jiang31', 'mjbuechl', 'steind', 'tpour3491', 'nrobison', 'asahni', 'mwalders', 'mihir14', 'twinget', 'doegerle', 'akiran', 'pg1646', 'twildb00', 'mpenderg', 'tschreib', 'upandey', 'tydiercks', 'nkwolek', 'pmoses', 'amwhitne', 'mnharris', 'jason89s', 'slaurids', 'askumar', 'kpetrucc', 'cho72', 'rschuman', 'lillylovebug', 'white73', 'jengelbe', 'lee291', 'bsobecki', 'aphanse', 'cscripp', 'pan3', 'mlovell', 'jphunter', 'reckel', 'ryokubaka', 'mdeschne', 'jon3153', 'tstrzele', 'ltaylor', 'alagneau', 'dlopez', 'petermathias', 'dhancock', 'jaesungyoun', 'jjyoun', 'khaver', 'kperrin', 'yamisamo', 'baharman', 'tmbutler', 'jpatmast', 'myokem', 'awlayton', 'jcmccorm', 'shicheng', 'sufimazli90', 'kakashow', 'djrobles', 'jgrivera', 'wtso', 'jgiron', 'mchuff', 'jasonholmes89', 'mjacobso', 'shreyan', 'rjgarman', 'rdpritch', 'dhanahan', 'jhuffaker', 'wdu', 'yue0', 'phillijn', 'lee439', 'spensing', 'haydenlee', 'mplankey', 'msathak', 'ceverhar', 'cdoty', 'sbogensc', 'mboudas', 'bmccool', 'cpmalone', 'waseemkhoury', 'rsthomps', 'chang71', 'ahmed11', 'bshutt', 'kskidmor', 'jvclark', 'smyrick', 'sfedro', 'tscheidl', 'owensec', 'matt_parker', 'jmulvain', 'gjware', 'dsabo', 'jmlindle', 'dougmoney', 'ctimko', 'spudster', 'nhammel', 'kvogler', 'robertra', 'cmottaz', 'colorfula', 'mzwach', 'stkerr', 'wang391', 'erkendall']",5,"['pmarepal', 'derialstrazus', 'awarsana', 'jlyeung', None]",148,"['bvoon', 'crkidwel', 'brangara', 'ychao', 'prabhu_m', 'reaper117', 'jschortg', 'mpanzare', 'gmusyj', 'mlababid', 'whess', 'sdevoe', 'nrkeen', 'patricklin', 'cdewes229', 'pmarepal', 'djvarnau', 'oghaisas', 'gmcnamer', 'ahaberlein', 'cykim', 'mbroski', 'bkhandag', 'brperry', 'fiqbal91', 'hsanghvi', 'sdang90', 'jiang31', 'mjbuechl', 'steind', 'tpour3491', 'adhirots', 'nrobison', 'asahni', 'mwalders', 'awarsana', 'mihir14', 'twinget', 'doegerle', 'akiran', 'pg1646', 'twildb00', 'derialstrazus', 'mpenderg', 'tschreib', 'upandey', 'tydiercks', 'nkwolek', 'pmoses', 'amwhitne', 'mnharris', 'jason89s', 'slaurids', 'askumar', 'kpetrucc', 'cho72', 'rschuman', 'lillylovebug', 'white73', 'jengelbe', 'lee291', 'bsobecki', 'aphanse', 'cscripp', 'wright46', 'pan3', None, 'mlovell', 'jphunter', 'reckel', 'ryokubaka', 'mdeschne', 'jon3153', 'tstrzele', 'ltaylor', 'alagneau', 'dlopez', 'petermathias', 'dhancock', 'jaesungyoun', 'jjyoun', 'khaver', 'kperrin', 'yamisamo', 'baharman', 'tmbutler', 'jpatmast', 'myokem', 'awlayton', 'jcmccorm', 'shicheng', 'sufimazli90', 'kakashow', 'djrobles', 'jgrivera', 'wtso', 'jgiron', 'mchuff', 'jasonholmes89', 'mjacobso', 'shreyan', 'rjgarman', 'rdpritch', 'dhanahan', 'jhuffaker', 'wdu', 'yue0', 'phillijn', 'lee439', 'spensing', 'haydenlee', 'mplankey', 'msathak', 'ceverhar', 'cdoty', 'sbogensc', 'mboudas', 'bmccool', 'cpmalone', 'waseemkhoury', 'rsthomps', 'chang71', 'ahmed11', 'bshutt', 'kskidmor', 'jvclark', 'smyrick', 'sfedro', 'tscheidl', 'owensec', 'matt_parker', 'jmulvain', 'gjware', 'dsabo', 'jmlindle', 'dougmoney', 'ctimko', 'spudster', 'nhammel', 'kvogler', 'robertra', 'cmottaz', 'colorfula', 'mzwach', 'stkerr', 'wang391', 'erkendall', 'jlyeung']"
3,56,122,113,96,"['sskim20', 'ddaza2', 'cgarner3', 'dharmaturtle', 'hochan5', 'acedamace', 'fonkafno', 'juan1', 'japheth', 'rusev1', 'choi129', 'wangwei420', 'shaofu88', 'spadoni2', 'jruzic2', 'cming2', 'grillz58', 'anwen', 'rskirby2', 'mrbrightside695', 'timespectrum', 'ebecker', 'nayak2', 'niemerg1', 'lsomeel41', 'dnshah2', 'xhuang25', 'meliu2', 'limpgopher88', 'chang87', 'gsvenni2', 'zumbahl1', 'jbae5', 's0undfl0w', 'sgopal4', 'mbianchi', 'canandagdeviren', 'liu181', 'nbisby2', 'capmaster', 'echavez3', 'hfederm2', 'mkoh', 'ewood8806', 'nitramzero', 'ctribout', 'earlgrey', 'kodark', 'crptone', 'pifactorial', 'khapp', 'tdburks2', 'mmccorm3', 'chau5', 'mjermann', 'tehmonk', 'tianhu2', 'wu14', 'kboger2', 'aldirin1', 'gmeyer3', 'swieren1', 'cloud1', 'rusiana2', 'smustaf2', 'hchoi32', 'ass1085', 'freddycheu', 'han23', 'mlee71', 'bcerier2', 'burgner2', 'resquiv', 'jiangj001', 'jtolar', 'resquiv2', 'sbhaler2', 'mtrower2', 'johnseo2', 'akong2', 'liao27', 'vali0227', 'joejsheehan', 'charishma', 'mstrom', 'lionelmoh', 'panoramarts', 'sjhseraph', 'motoki1', 'intrimind', 'kkroege2', 'sshiffe2', 'rbhojwa2', 'afromaniac', 'xliu34', 'yeunkim2']",25,"['xunjian', 'manasgartia', 'agibson', 'wkelleh2', 'thunghan', 'yichenusa', 'klinga88', 'driscoll42', 'dlowry2', 'bfogel2', 'dstamat2', 'lanhuo1986', 'pmartin8', 'mmadeja2', 'kdearnl2', 'johan1', 'amedske2', 'edward31', 'nbhagat2', 'swimjade', 'tstilz', 'atseng3', 'jwester3', 'jstrack2', 'slhertz']",17,"['larsgtb', 'skysky333333', 'wfergus2', 'flian2', 'rasilva2', 'nikhrmn', 'mkurows2', 'yangzhao', 'ucabraal', 'yhuang38', 'dhabes2', 'kgrosse2', 'ntweidman', 'nawaz', 'fox6606', 'liuximeng25', None]",138,"['skysky333333', 'sskim20', 'ddaza2', 'cgarner3', 'dharmaturtle', 'hochan5', 'acedamace', 'thunghan', 'fonkafno', 'juan1', 'rusev1', 'japheth', 'choi129', 'wangwei420', 'jruzic2', 'cming2', 'spadoni2', 'lanhuo1986', 'shaofu88', 'grillz58', 'johan1', 'anwen', 'mrbrightside695', 'rskirby2', 'ebecker', 'timespectrum', 'swimjade', 'tstilz', 'atseng3', 'nayak2', 'niemerg1', 'lsomeel41', 'dnshah2', 'xhuang25', 'slhertz', 'meliu2', 'limpgopher88', 'chang87', 'flian2', 'yangzhao', 'gsvenni2', 'nawaz', 'zumbahl1', 'klinga88', 'driscoll42', 'jbae5', 'mbianchi', 'dstamat2', 'sgopal4', 's0undfl0w', 'canandagdeviren', 'liu181', 'edward31', 'nbisby2', None, 'echavez3', 'capmaster', 'nbhagat2', 'hfederm2', 'mkoh', 'ewood8806', 'rasilva2', 'nitramzero', 'ctribout', 'dhabes2', 'earlgrey', 'kodark', 'jstrack2', 'ntweidman', 'crptone', 'pifactorial', 'xunjian', 'khapp', 'nikhrmn', 'tdburks2', 'manasgartia', 'mmccorm3', 'agibson', 'wkelleh2', 'chau5', 'mjermann', 'tehmonk', 'wfergus2', 'yichenusa', 'ucabraal', 'tianhu2', 'bfogel2', 'kboger2', 'wu14', 'yhuang38', 'aldirin1', 'gmeyer3', 'pmartin8', 'swieren1', 'mmadeja2', 'mkurows2', 'cloud1', 'rusiana2', 'smustaf2', 'hchoi32', 'liuximeng25', 'ass1085', 'freddycheu', 'han23', 'mlee71', 'bcerier2', 'burgner2', 'kgrosse2', 'resquiv', 'jiangj001', 'jtolar', 'sbhaler2', 'resquiv2', 'larsgtb', 'mtrower2', 'johnseo2', 'akong2', 'liao27', 'dlowry2', 'vali0227', 'joejsheehan', 'charishma', 'mstrom', 'kdearnl2', 'amedske2', 'lionelmoh', 'fox6606', 'panoramarts', 'sjhseraph', 'jwester3', 'motoki1', 'intrimind', 'kkroege2', 'sshiffe2', 'rbhojwa2', 'afromaniac', 'xliu34', 'yeunkim2']"
3,80,122,96,84,"['sskim20', 'ddaza2', 'cgarner3', 'dharmaturtle', 'hochan5', 'juan1', 'japheth', 'rusev1', 'choi129', 'wangwei420', 'spadoni2', 'cming2', 'johan1', 'rskirby2', 'mrbrightside695', 'ebecker', 'timespectrum', 'tstilz', 'atseng3', 'nayak2', 'niemerg1', 'dnshah2', 'xhuang25', 'meliu2', 'chang87', 'gsvenni2', 'zumbahl1', 'klinga88', 'jbae5', 'sgopal4', 'dstamat2', 'canandagdeviren', 'liu181', 'edward31', 'nbisby2', 'echavez3', 'capmaster', 'hfederm2', 'mkoh', 'ewood8806', 'jstrack2', 'earlgrey', 'kodark', 'crptone', 'xunjian', 'khapp', 'manasgartia', 'agibson', 'chau5', 'mjermann', 'tehmonk', 'yichenusa', 'tianhu2', 'wu14', 'kboger2', 'swieren1', 'mmadeja2', 'cloud1', 'rusiana2', 'smustaf2', 'hchoi32', 'ass1085', 'mlee71', 'bcerier2', 'burgner2', 'resquiv', 'jiangj001', 'jtolar', 'resquiv2', 'sbhaler2', 'mtrower2', 'johnseo2', 'akong2', 'liao27', 'joejsheehan', 'mstrom', 'kdearnl2', 'panoramarts', 'motoki1', 'intrimind', 'sshiffe2', 'rbhojwa2', 'afromaniac', 'yeunkim2']",37,"['pifactorial', 'tdburks2', 'mmccorm3', 'wkelleh2', 'acedamace', 'fonkafno', 'thunghan', 'driscoll42', 'dlowry2', 'vali0227', 'bfogel2', 'mbianchi', 's0undfl0w', 'aldirin1', 'shaofu88', 'jruzic2', 'gmeyer3', 'lanhuo1986', 'pmartin8', 'charishma', 'grillz58', 'anwen', 'amedske2', 'lionelmoh', 'nbhagat2', 'swimjade', 'sjhseraph', 'freddycheu', 'han23', 'jwester3', 'lsomeel41', 'nitramzero', 'ctribout', 'kkroege2', 'slhertz', 'xliu34', 'limpgopher88']",12,"['larsgtb', 'skysky333333', 'flian2', 'rasilva2', 'caromu', 'beminor2', 'dhabes2', 'nawaz', 'fox6606', 'kgrosse2', None, 'mohamed']",133,"['skysky333333', 'sskim20', 'ddaza2', 'cgarner3', 'dharmaturtle', 'hochan5', 'acedamace', 'thunghan', 'fonkafno', 'juan1', 'rusev1', 'japheth', 'choi129', 'wangwei420', 'jruzic2', 'cming2', 'spadoni2', 'lanhuo1986', 'shaofu88', 'grillz58', 'johan1', 'anwen', 'mrbrightside695', 'rskirby2', 'ebecker', 'timespectrum', 'swimjade', 'tstilz', 'atseng3', 'nayak2', 'niemerg1', 'lsomeel41', 'dnshah2', 'xhuang25', 'slhertz', 'meliu2', 'limpgopher88', 'chang87', 'flian2', 'gsvenni2', 'nawaz', 'zumbahl1', 'klinga88', 'driscoll42', 'jbae5', 'mbianchi', 'dstamat2', 'sgopal4', 's0undfl0w', 'canandagdeviren', 'liu181', 'edward31', 'nbisby2', None, 'echavez3', 'capmaster', 'nbhagat2', 'hfederm2', 'mkoh', 'ewood8806', 'rasilva2', 'nitramzero', 'ctribout', 'dhabes2', 'earlgrey', 'kodark', 'jstrack2', 'mohamed', 'crptone', 'pifactorial', 'xunjian', 'khapp', 'tdburks2', 'manasgartia', 'mmccorm3', 'agibson', 'wkelleh2', 'chau5', 'mjermann', 'tehmonk', 'yichenusa', 'caromu', 'tianhu2', 'bfogel2', 'kboger2', 'wu14', 'aldirin1', 'gmeyer3', 'pmartin8', 'swieren1', 'mmadeja2', 'cloud1', 'rusiana2', 'smustaf2', 'hchoi32', 'ass1085', 'freddycheu', 'han23', 'mlee71', 'bcerier2', 'burgner2', 'kgrosse2', 'resquiv', 'jiangj001', 'jtolar', 'sbhaler2', 'resquiv2', 'larsgtb', 'mtrower2', 'johnseo2', 'akong2', 'liao27', 'dlowry2', 'vali0227', 'joejsheehan', 'charishma', 'mstrom', 'kdearnl2', 'amedske2', 'lionelmoh', 'fox6606', 'panoramarts', 'sjhseraph', 'jwester3', 'motoki1', 'beminor2', 'intrimind', 'kkroege2', 'sshiffe2', 'rbhojwa2', 'afromaniac', 'xliu34', 'yeunkim2']"
3,159,122,87,77,"['ddaza2', 'dharmaturtle', 'hochan5', 'thunghan', 'juan1', 'japheth', 'rusev1', 'choi129', 'wangwei420', 'jruzic2', 'spadoni2', 'lanhuo1986', 'grillz58', 'anwen', 'mrbrightside695', 'ebecker', 'nayak2', 'niemerg1', 'dnshah2', 'xhuang25', 'chang87', 'gsvenni2', 'zumbahl1', 'klinga88', 'jbae5', 'sgopal4', 'canandagdeviren', 'liu181', 'edward31', 'nbisby2', 'capmaster', 'nbhagat2', 'mkoh', 'ewood8806', 'jstrack2', 'kodark', 'crptone', 'pifactorial', 'xunjian', 'manasgartia', 'tdburks2', 'mmccorm3', 'agibson', 'chau5', 'mjermann', 'tehmonk', 'yichenusa', 'tianhu2', 'wu14', 'kboger2', 'mmadeja2', 'cloud1', 'rusiana2', 'smustaf2', 'hchoi32', 'ass1085', 'mlee71', 'jiangj001', 'resquiv2', 'sbhaler2', 'johnseo2', 'akong2', 'liao27', 'vali0227', 'joejsheehan', 'charishma', 'mstrom', 'kdearnl2', 'lionelmoh', 'panoramarts', 'sjhseraph', 'motoki1', 'intrimind', 'kkroege2', 'sshiffe2', 'rbhojwa2', 'yeunkim2']",44,"['resquiv', 'sskim20', 'khapp', 'jtolar', 'cgarner3', 'wkelleh2', 'acedamace', 'fonkafno', 'mtrower2', 'xliu34', 'driscoll42', 'dlowry2', 'bfogel2', 'mbianchi', 'dstamat2', 's0undfl0w', 'aldirin1', 'shaofu88', 'cming2', 'gmeyer3', 'pmartin8', 'swieren1', 'johan1', 'amedske2', 'rskirby2', 'timespectrum', 'echavez3', 'swimjade', 'hfederm2', 'tstilz', 'atseng3', 'freddycheu', 'han23', 'jwester3', 'bcerier2', 'lsomeel41', 'nitramzero', 'ctribout', 'burgner2', 'earlgrey', 'slhertz', 'afromaniac', 'meliu2', 'limpgopher88']",10,"['larsgtb', 'kkoeste2', 'flian2', 'jain10', 'ucabraal', 'enzelu1', 'lebann', None, 'mohamed', 'gupta40']",131,"['sskim20', 'ddaza2', 'cgarner3', 'dharmaturtle', 'hochan5', 'acedamace', 'thunghan', 'fonkafno', 'juan1', 'rusev1', 'japheth', 'choi129', 'wangwei420', 'jruzic2', 'cming2', 'spadoni2', 'lanhuo1986', 'shaofu88', 'grillz58', 'johan1', 'anwen', 'mrbrightside695', 'rskirby2', 'ebecker', 'timespectrum', 'swimjade', 'tstilz', 'atseng3', 'nayak2', 'niemerg1', 'lsomeel41', 'dnshah2', 'xhuang25', 'slhertz', 'meliu2', 'limpgopher88', 'chang87', 'flian2', 'gsvenni2', 'zumbahl1', 'klinga88', 'driscoll42', 'jbae5', 'mbianchi', 'dstamat2', 'sgopal4', 's0undfl0w', 'enzelu1', 'canandagdeviren', 'liu181', 'kkoeste2', 'edward31', 'nbisby2', None, 'echavez3', 'capmaster', 'nbhagat2', 'hfederm2', 'mkoh', 'ewood8806', 'nitramzero', 'ctribout', 'earlgrey', 'kodark', 'jstrack2', 'mohamed', 'crptone', 'pifactorial', 'xunjian', 'khapp', 'tdburks2', 'manasgartia', 'mmccorm3', 'agibson', 'wkelleh2', 'chau5', 'mjermann', 'tehmonk', 'yichenusa', 'ucabraal', 'tianhu2', 'bfogel2', 'kboger2', 'wu14', 'aldirin1', 'gmeyer3', 'pmartin8', 'swieren1', 'mmadeja2', 'cloud1', 'rusiana2', 'smustaf2', 'hchoi32', 'ass1085', 'freddycheu', 'han23', 'mlee71', 'bcerier2', 'burgner2', 'resquiv', 'jiangj001', 'jain10', 'jtolar', 'sbhaler2', 'resquiv2', 'larsgtb', 'mtrower2', 'johnseo2', 'akong2', 'liao27', 'dlowry2', 'vali0227', 'joejsheehan', 'lebann', 'gupta40', 'charishma', 'mstrom', 'kdearnl2', 'amedske2', 'lionelmoh', 'panoramarts', 'sjhseraph', 'jwester3', 'motoki1', 'intrimind', 'kkroege2', 'sshiffe2', 'rbhojwa2', 'afromaniac', 'xliu34', 'yeunkim2']"
3,166,122,79,70,"['resquiv', 'sskim20', 'jiangj001', 'ddaza2', 'mmccorm3', 'gsvenni2', 'cgarner3', 'dharmaturtle', 'zumbahl1', 'wkelleh2', 'hochan5', 'chau5', 'juan1', 'mjermann', 'japheth', 'rusev1', 'johnseo2', 'akong2', 'liao27', 'crptone', 'jbae5', 'vali0227', 'joejsheehan', 'kboger2', 'wu14', 'wangwei420', 'jruzic2', 'spadoni2', 'cming2', 'canandagdeviren', 'gmeyer3', 'mmadeja2', 'charishma', 'liu181', 'mstrom', 'cloud1', 'kdearnl2', 'johan1', 'amedske2', 'edward31', 'rskirby2', 'mrbrightside695', 'nbisby2', 'lionelmoh', 'ebecker', 'capmaster', 'echavez3', 'hfederm2', 'ass1085', 'freddycheu', 'mkoh', 'han23', 'panoramarts', 'ewood8806', 'mlee71', 'sjhseraph', 'motoki1', 'bcerier2', 'nayak2', 'niemerg1', 'intrimind', 'nitramzero', 'burgner2', 'kkroege2', 'xhuang25', 'sshiffe2', 'kodark', 'meliu2', 'yeunkim2', 'chang87']",51,"['pifactorial', 'xunjian', 'khapp', 'tdburks2', 'manasgartia', 'jtolar', 'agibson', 'sbhaler2', 'resquiv2', 'acedamace', 'fonkafno', 'thunghan', 'mtrower2', 'tehmonk', 'yichenusa', 'klinga88', 'driscoll42', 'tianhu2', 'dlowry2', 'bfogel2', 'choi129', 'mbianchi', 'dstamat2', 'sgopal4', 's0undfl0w', 'afromaniac', 'aldirin1', 'shaofu88', 'lanhuo1986', 'pmartin8', 'swieren1', 'grillz58', 'anwen', 'rusiana2', 'smustaf2', 'hchoi32', 'timespectrum', 'swimjade', 'nbhagat2', 'tstilz', 'atseng3', 'jwester3', 'lsomeel41', 'ctribout', 'dnshah2', 'earlgrey', 'slhertz', 'jstrack2', 'rbhojwa2', 'xliu34', 'limpgopher88']",9,"['larsgtb', 'skysky333333', 'ahnkang2', 'kkoeste2', 'flian2', 'ucabraal', 'nawaz', 'kgrosse2', None]",130,"['skysky333333', 'sskim20', 'ddaza2', 'cgarner3', 'dharmaturtle', 'hochan5', 'acedamace', 'thunghan', 'fonkafno', 'juan1', 'rusev1', 'japheth', 'choi129', 'wangwei420', 'jruzic2', 'cming2', 'spadoni2', 'lanhuo1986', 'shaofu88', 'grillz58', 'johan1', 'anwen', 'mrbrightside695', 'rskirby2', 'ebecker', 'timespectrum', 'swimjade', 'tstilz', 'atseng3', 'nayak2', 'niemerg1', 'lsomeel41', 'dnshah2', 'xhuang25', 'slhertz', 'meliu2', 'limpgopher88', 'chang87', 'flian2', 'gsvenni2', 'nawaz', 'zumbahl1', 'ahnkang2', 'klinga88', 'driscoll42', 'jbae5', 'mbianchi', 'dstamat2', 'sgopal4', 's0undfl0w', 'canandagdeviren', 'liu181', 'kkoeste2', 'edward31', 'nbisby2', None, 'echavez3', 'capmaster', 'nbhagat2', 'hfederm2', 'mkoh', 'ewood8806', 'nitramzero', 'ctribout', 'earlgrey', 'kodark', 'jstrack2', 'crptone', 'pifactorial', 'xunjian', 'khapp', 'tdburks2', 'manasgartia', 'mmccorm3', 'agibson', 'wkelleh2', 'chau5', 'mjermann', 'tehmonk', 'yichenusa', 'ucabraal', 'tianhu2', 'bfogel2', 'kboger2', 'wu14', 'aldirin1', 'gmeyer3', 'pmartin8', 'swieren1', 'mmadeja2', 'cloud1', 'rusiana2', 'smustaf2', 'hchoi32', 'ass1085', 'freddycheu', 'han23', 'mlee71', 'bcerier2', 'burgner2', 'kgrosse2', 'resquiv', 'jiangj001', 'jtolar', 'sbhaler2', 'resquiv2', 'larsgtb', 'mtrower2', 'johnseo2', 'akong2', 'liao27', 'dlowry2', 'vali0227', 'joejsheehan', 'charishma', 'mstrom', 'kdearnl2', 'amedske2', 'lionelmoh', 'panoramarts', 'sjhseraph', 'jwester3', 'motoki1', 'intrimind', 'kkroege2', 'sshiffe2', 'rbhojwa2', 'afromaniac', 'xliu34', 'yeunkim2']"
3,51,122,75,60,"['jiangj001', 'chang87', 'tdburks2', 'ddaza2', 'mmccorm3', 'agibson', 'resquiv2', 'dharmaturtle', 'zumbahl1', 'hochan5', 'thunghan', 'juan1', 'mtrower2', 'japheth', 'tehmonk', 'johnseo2', 'akong2', 'liao27', 'klinga88', 'jbae5', 'choi129', 'kboger2', 'wu14', 'sgopal4', 'aldirin1', 'wangwei420', 'jruzic2', 'gmeyer3', 'spadoni2', 'canandagdeviren', 'swieren1', 'mmadeja2', 'charishma', 'liu181', 'mstrom', 'cloud1', 'johan1', 'anwen', 'smustaf2', 'rskirby2', 'hchoi32', 'nbisby2', 'ebecker', 'ass1085', 'panoramarts', 'freddycheu', 'han23', 'mlee71', 'ewood8806', 'motoki1', 'nayak2', 'niemerg1', 'xhuang25', 'sshiffe2', 'jstrack2', 'slhertz', 'rbhojwa2', 'afromaniac', 'yeunkim2', 'crptone']",61,"['resquiv', 'pifactorial', 'xunjian', 'sskim20', 'khapp', 'manasgartia', 'jtolar', 'gsvenni2', 'sbhaler2', 'cgarner3', 'wkelleh2', 'chau5', 'acedamace', 'fonkafno', 'mjermann', 'rusev1', 'yichenusa', 'xliu34', 'driscoll42', 'tianhu2', 'dlowry2', 'vali0227', 'bfogel2', 'joejsheehan', 'mbianchi', 'dstamat2', 's0undfl0w', 'shaofu88', 'cming2', 'lanhuo1986', 'pmartin8', 'grillz58', 'kdearnl2', 'amedske2', 'edward31', 'rusiana2', 'mrbrightside695', 'lionelmoh', 'timespectrum', 'echavez3', 'swimjade', 'capmaster', 'tstilz', 'atseng3', 'nbhagat2', 'hfederm2', 'mkoh', 'sjhseraph', 'jwester3', 'bcerier2', 'intrimind', 'lsomeel41', 'nitramzero', 'ctribout', 'burgner2', 'dnshah2', 'kkroege2', 'earlgrey', 'kodark', 'meliu2', 'limpgopher88']",15,"['larsgtb', 'wfergus2', 'trieuvu1', 'jain10', 'caromu', 'rasilva2', 'loganliu1', 'ucabraal', None, 'yapjiun1', 'yhuang38', 'enzelu1', 'fox6606', 'frankzheng329', 'gupta40']",136,"['sskim20', 'ddaza2', 'cgarner3', 'dharmaturtle', 'hochan5', 'acedamace', 'thunghan', 'fonkafno', 'juan1', 'rusev1', 'japheth', 'choi129', 'wangwei420', 'jruzic2', 'cming2', 'spadoni2', 'lanhuo1986', 'shaofu88', 'grillz58', 'johan1', 'anwen', 'mrbrightside695', 'rskirby2', 'ebecker', 'timespectrum', 'swimjade', 'tstilz', 'atseng3', 'loganliu1', 'nayak2', 'niemerg1', 'lsomeel41', 'dnshah2', 'xhuang25', 'slhertz', 'meliu2', 'limpgopher88', 'chang87', 'gsvenni2', 'zumbahl1', 'trieuvu1', 'klinga88', 'driscoll42', 'jbae5', 'mbianchi', 'dstamat2', 'sgopal4', 's0undfl0w', 'enzelu1', 'frankzheng329', 'canandagdeviren', 'liu181', 'edward31', 'nbisby2', None, 'echavez3', 'capmaster', 'nbhagat2', 'hfederm2', 'mkoh', 'ewood8806', 'rasilva2', 'nitramzero', 'ctribout', 'earlgrey', 'kodark', 'jstrack2', 'crptone', 'pifactorial', 'xunjian', 'khapp', 'tdburks2', 'manasgartia', 'mmccorm3', 'agibson', 'wkelleh2', 'chau5', 'mjermann', 'tehmonk', 'wfergus2', 'yichenusa', 'caromu', 'ucabraal', 'tianhu2', 'bfogel2', 'kboger2', 'wu14', 'yhuang38', 'aldirin1', 'gmeyer3', 'pmartin8', 'swieren1', 'mmadeja2', 'cloud1', 'rusiana2', 'smustaf2', 'hchoi32', 'ass1085', 'freddycheu', 'han23', 'mlee71', 'bcerier2', 'burgner2', 'yapjiun1', 'resquiv', 'jiangj001', 'jain10', 'jtolar', 'sbhaler2', 'resquiv2', 'larsgtb', 'mtrower2', 'johnseo2', 'akong2', 'liao27', 'dlowry2', 'vali0227', 'joejsheehan', 'gupta40', 'charishma', 'mstrom', 'kdearnl2', 'amedske2', 'lionelmoh', 'fox6606', 'panoramarts', 'sjhseraph', 'jwester3', 'motoki1', 'intrimind', 'kkroege2', 'sshiffe2', 'rbhojwa2', 'afromaniac', 'xliu34', 'yeunkim2']"
3,87,122,72,64,"['resquiv', 'khapp', 'chang87', 'manasgartia', 'ddaza2', 'tdburks2', 'mmccorm3', 'gsvenni2', 'resquiv2', 'sbhaler2', 'dharmaturtle', 'zumbahl1', 'chau5', 'thunghan', 'juan1', 'mjermann', 'japheth', 'rusev1', 'johnseo2', 'yichenusa', 'akong2', 'liao27', 'driscoll42', 'tianhu2', 'choi129', 'joejsheehan', 'wu14', 'mbianchi', 'aldirin1', 'wangwei420', 'spadoni2', 'cming2', 'canandagdeviren', 'swieren1', 'mmadeja2', 'liu181', 'mstrom', 'grillz58', 'johan1', 'anwen', 'rusiana2', 'edward31', 'nbisby2', 'ebecker', 'capmaster', 'echavez3', 'panoramarts', 'tstilz', 'han23', 'mkoh', 'mlee71', 'ewood8806', 'motoki1', 'bcerier2', 'nayak2', 'niemerg1', 'intrimind', 'burgner2', 'dnshah2', 'xhuang25', 'sshiffe2', 'kodark', 'afromaniac', 'crptone']",57,"['pifactorial', 'xunjian', 'sskim20', 'jiangj001', 'jtolar', 'agibson', 'cgarner3', 'wkelleh2', 'hochan5', 'acedamace', 'fonkafno', 'mtrower2', 'tehmonk', 'xliu34', 'klinga88', 'dlowry2', 'jbae5', 'vali0227', 'bfogel2', 's0undfl0w', 'dstamat2', 'sgopal4', 'kboger2', 'shaofu88', 'jruzic2', 'gmeyer3', 'lanhuo1986', 'pmartin8', 'charishma', 'cloud1', 'kdearnl2', 'amedske2', 'smustaf2', 'rskirby2', 'mrbrightside695', 'hchoi32', 'lionelmoh', 'timespectrum', 'ass1085', 'swimjade', 'nbhagat2', 'hfederm2', 'atseng3', 'freddycheu', 'sjhseraph', 'jwester3', 'lsomeel41', 'nitramzero', 'ctribout', 'kkroege2', 'earlgrey', 'slhertz', 'jstrack2', 'rbhojwa2', 'meliu2', 'limpgopher88', 'yeunkim2']",8,"['larsgtb', 'flian2', 'rasilva2', 'kgrosse2', 'yhuang38', 'fox6606', 'liuximeng25', None]",129,"['sskim20', 'ddaza2', 'cgarner3', 'dharmaturtle', 'hochan5', 'acedamace', 'thunghan', 'fonkafno', 'juan1', 'rusev1', 'japheth', 'choi129', 'wangwei420', 'jruzic2', 'cming2', 'spadoni2', 'lanhuo1986', 'shaofu88', 'grillz58', 'johan1', 'anwen', 'mrbrightside695', 'rskirby2', 'ebecker', 'timespectrum', 'swimjade', 'tstilz', 'atseng3', 'nayak2', 'niemerg1', 'lsomeel41', 'dnshah2', 'xhuang25', 'slhertz', 'meliu2', 'limpgopher88', 'chang87', 'flian2', 'gsvenni2', 'zumbahl1', 'klinga88', 'driscoll42', 'jbae5', 'mbianchi', 'dstamat2', 'sgopal4', 's0undfl0w', 'canandagdeviren', 'liu181', 'edward31', 'nbisby2', None, 'echavez3', 'capmaster', 'nbhagat2', 'hfederm2', 'mkoh', 'ewood8806', 'rasilva2', 'nitramzero', 'ctribout', 'earlgrey', 'kodark', 'jstrack2', 'crptone', 'pifactorial', 'xunjian', 'khapp', 'tdburks2', 'manasgartia', 'mmccorm3', 'agibson', 'wkelleh2', 'chau5', 'mjermann', 'tehmonk', 'yichenusa', 'tianhu2', 'bfogel2', 'kboger2', 'wu14', 'yhuang38', 'aldirin1', 'gmeyer3', 'pmartin8', 'swieren1', 'mmadeja2', 'cloud1', 'rusiana2', 'smustaf2', 'hchoi32', 'liuximeng25', 'ass1085', 'freddycheu', 'han23', 'mlee71', 'bcerier2', 'burgner2', 'kgrosse2', 'resquiv', 'jiangj001', 'jtolar', 'sbhaler2', 'resquiv2', 'larsgtb', 'mtrower2', 'johnseo2', 'akong2', 'liao27', 'dlowry2', 'vali0227', 'joejsheehan', 'charishma', 'mstrom', 'kdearnl2', 'amedske2', 'lionelmoh', 'fox6606', 'panoramarts', 'sjhseraph', 'jwester3', 'motoki1', 'intrimind', 'kkroege2', 'sshiffe2', 'rbhojwa2', 'afromaniac', 'xliu34', 'yeunkim2']"
3,57,122,50,43,"['pifactorial', 'ddaza2', 'mmccorm3', 'jtolar', 'sbhaler2', 'resquiv2', 'wkelleh2', 'thunghan', 'acedamace', 'mjermann', 'dlowry2', 'bfogel2', 'choi129', 'mbianchi', 'dstamat2', 'jruzic2', 'gmeyer3', 'lanhuo1986', 'charishma', 'grillz58', 'kdearnl2', 'johan1', 'lionelmoh', 'nbisby2', 'timespectrum', 'nbhagat2', 'swimjade', 'jwester3', 'freddycheu', 'tstilz', 'intrimind', 'lsomeel41', 'nitramzero', 'burgner2', 'kkroege2', 'ctribout', 'dnshah2', 'jstrack2', 'slhertz', 'earlgrey', 'afromaniac', 'xliu34', 'yeunkim2']",78,"['sskim20', 'cgarner3', 'dharmaturtle', 'hochan5', 'fonkafno', 'juan1', 'rusev1', 'japheth', 'wangwei420', 'shaofu88', 'spadoni2', 'cming2', 'anwen', 'mrbrightside695', 'rskirby2', 'ebecker', 'atseng3', 'nayak2', 'niemerg1', 'xhuang25', 'meliu2', 'limpgopher88', 'chang87', 'gsvenni2', 'zumbahl1', 'klinga88', 'driscoll42', 'jbae5', 's0undfl0w', 'sgopal4', 'canandagdeviren', 'liu181', 'edward31', 'echavez3', 'capmaster', 'hfederm2', 'mkoh', 'ewood8806', 'kodark', 'crptone', 'xunjian', 'khapp', 'tdburks2', 'manasgartia', 'agibson', 'chau5', 'tehmonk', 'yichenusa', 'tianhu2', 'kboger2', 'wu14', 'aldirin1', 'pmartin8', 'swieren1', 'mmadeja2', 'cloud1', 'rusiana2', 'smustaf2', 'hchoi32', 'ass1085', 'han23', 'mlee71', 'bcerier2', 'resquiv', 'jiangj001', 'mtrower2', 'johnseo2', 'akong2', 'liao27', 'vali0227', 'joejsheehan', 'mstrom', 'amedske2', 'panoramarts', 'sjhseraph', 'motoki1', 'sshiffe2', 'rbhojwa2']",7,"['wfergus2', 'kkoeste2', 'flian2', 'nikhrmn', 'mkurows2', 'eluminite', None]",128,"['sskim20', 'ddaza2', 'cgarner3', 'dharmaturtle', 'hochan5', 'acedamace', 'thunghan', 'fonkafno', 'juan1', 'rusev1', 'japheth', 'choi129', 'wangwei420', 'jruzic2', 'cming2', 'spadoni2', 'lanhuo1986', 'shaofu88', 'grillz58', 'johan1', 'anwen', 'mrbrightside695', 'rskirby2', 'ebecker', 'timespectrum', 'swimjade', 'tstilz', 'atseng3', 'nayak2', 'niemerg1', 'lsomeel41', 'dnshah2', 'xhuang25', 'slhertz', 'meliu2', 'limpgopher88', 'chang87', 'flian2', 'gsvenni2', 'zumbahl1', 'klinga88', 'driscoll42', 'jbae5', 'mbianchi', 'dstamat2', 'sgopal4', 's0undfl0w', 'canandagdeviren', 'liu181', 'kkoeste2', 'eluminite', 'edward31', 'nbisby2', None, 'echavez3', 'capmaster', 'nbhagat2', 'hfederm2', 'mkoh', 'ewood8806', 'nitramzero', 'ctribout', 'earlgrey', 'kodark', 'jstrack2', 'crptone', 'pifactorial', 'xunjian', 'khapp', 'nikhrmn', 'tdburks2', 'manasgartia', 'mmccorm3', 'agibson', 'wkelleh2', 'chau5', 'mjermann', 'tehmonk', 'wfergus2', 'yichenusa', 'tianhu2', 'bfogel2', 'kboger2', 'wu14', 'aldirin1', 'gmeyer3', 'pmartin8', 'swieren1', 'mmadeja2', 'mkurows2', 'cloud1', 'rusiana2', 'smustaf2', 'hchoi32', 'ass1085', 'freddycheu', 'han23', 'mlee71', 'bcerier2', 'burgner2', 'resquiv', 'jiangj001', 'jtolar', 'sbhaler2', 'resquiv2', 'mtrower2', 'johnseo2', 'akong2', 'liao27', 'dlowry2', 'vali0227', 'joejsheehan', 'charishma', 'mstrom', 'kdearnl2', 'amedske2', 'lionelmoh', 'panoramarts', 'sjhseraph', 'jwester3', 'motoki1', 'intrimind', 'kkroege2', 'sshiffe2', 'rbhojwa2', 'afromaniac', 'xliu34', 'yeunkim2']"
3,50,122,47,33,"['sskim20', 'sbhaler2', 'resquiv2', 'wkelleh2', 'acedamace', 'thunghan', 'xliu34', 'dlowry2', 'driscoll42', 'vali0227', 'bfogel2', 'choi129', 'dstamat2', 'gmeyer3', 'lanhuo1986', 'grillz58', 'kdearnl2', 'lionelmoh', 'echavez3', 'timespectrum', 'nbhagat2', 'hfederm2', 'jwester3', 'tstilz', 'mkoh', 'swimjade', 'intrimind', 'nitramzero', 'burgner2', 'kkroege2', 'dnshah2', 'jstrack2', 'meliu2']",88,"['ddaza2', 'cgarner3', 'dharmaturtle', 'hochan5', 'fonkafno', 'juan1', 'rusev1', 'japheth', 'wangwei420', 'shaofu88', 'spadoni2', 'jruzic2', 'cming2', 'johan1', 'anwen', 'rskirby2', 'mrbrightside695', 'ebecker', 'atseng3', 'nayak2', 'niemerg1', 'lsomeel41', 'xhuang25', 'slhertz', 'limpgopher88', 'chang87', 'gsvenni2', 'zumbahl1', 'klinga88', 'jbae5', 'mbianchi', 'sgopal4', 's0undfl0w', 'canandagdeviren', 'liu181', 'edward31', 'nbisby2', 'capmaster', 'ewood8806', 'ctribout', 'earlgrey', 'kodark', 'crptone', 'pifactorial', 'xunjian', 'khapp', 'tdburks2', 'manasgartia', 'mmccorm3', 'agibson', 'chau5', 'mjermann', 'tehmonk', 'yichenusa', 'tianhu2', 'kboger2', 'wu14', 'aldirin1', 'pmartin8', 'swieren1', 'mmadeja2', 'cloud1', 'rusiana2', 'smustaf2', 'hchoi32', 'ass1085', 'freddycheu', 'han23', 'mlee71', 'bcerier2', 'resquiv', 'jiangj001', 'jtolar', 'mtrower2', 'johnseo2', 'akong2', 'liao27', 'joejsheehan', 'charishma', 'mstrom', 'amedske2', 'panoramarts', 'sjhseraph', 'motoki1', 'sshiffe2', 'rbhojwa2', 'afromaniac', 'yeunkim2']",14,"['greenpurdue', 'green16', 'kylerupp87', 'wfergus2', 'carter6', 'ttapers', 'taliaho', 'dhabes2', 'luyichen', 'yang28', 'pi_factorial', 'nmahend2', None, 'jlorenz3']",135,"['sskim20', 'ddaza2', 'cgarner3', 'dharmaturtle', 'hochan5', 'acedamace', 'thunghan', 'fonkafno', 'juan1', 'rusev1', 'japheth', 'green16', 'choi129', 'wangwei420', 'jruzic2', 'cming2', 'spadoni2', 'lanhuo1986', 'shaofu88', 'grillz58', 'johan1', 'anwen', 'mrbrightside695', 'rskirby2', 'ebecker', 'timespectrum', 'swimjade', 'tstilz', 'atseng3', 'ttapers', 'nayak2', 'niemerg1', 'lsomeel41', 'dnshah2', 'xhuang25', 'slhertz', 'meliu2', 'limpgopher88', 'chang87', 'gsvenni2', 'zumbahl1', 'klinga88', 'driscoll42', 'jbae5', 'mbianchi', 'dstamat2', 'sgopal4', 's0undfl0w', 'canandagdeviren', 'kylerupp87', 'liu181', 'edward31', 'nmahend2', 'nbisby2', None, 'echavez3', 'capmaster', 'nbhagat2', 'hfederm2', 'mkoh', 'ewood8806', 'nitramzero', 'ctribout', 'dhabes2', 'earlgrey', 'kodark', 'jstrack2', 'crptone', 'pifactorial', 'xunjian', 'khapp', 'tdburks2', 'manasgartia', 'mmccorm3', 'agibson', 'wkelleh2', 'chau5', 'mjermann', 'tehmonk', 'wfergus2', 'yichenusa', 'tianhu2', 'bfogel2', 'kboger2', 'wu14', 'aldirin1', 'gmeyer3', 'pmartin8', 'swieren1', 'mmadeja2', 'cloud1', 'rusiana2', 'smustaf2', 'hchoi32', 'ass1085', 'greenpurdue', 'freddycheu', 'han23', 'mlee71', 'bcerier2', 'burgner2', 'resquiv', 'jiangj001', 'jtolar', 'sbhaler2', 'resquiv2', 'pi_factorial', 'mtrower2', 'johnseo2', 'akong2', 'carter6', 'liao27', 'dlowry2', 'vali0227', 'joejsheehan', 'charishma', 'mstrom', 'kdearnl2', 'amedske2', 'luyichen', 'lionelmoh', 'panoramarts', 'sjhseraph', 'jwester3', 'motoki1', 'taliaho', 'intrimind', 'kkroege2', 'sshiffe2', 'yang28', 'rbhojwa2', 'afromaniac', 'xliu34', 'yeunkim2', 'jlorenz3']"
3,160,122,40,33,"['pifactorial', 'sskim20', 'sbhaler2', 'acedamace', 'thunghan', 'xliu34', 'dlowry2', 'bfogel2', 'kboger2', 'dstamat2', 'jruzic2', 'gmeyer3', 'cming2', 'lanhuo1986', 'mmadeja2', 'grillz58', 'kdearnl2', 'lionelmoh', 'echavez3', 'timespectrum', 'swimjade', 'hfederm2', 'jwester3', 'freddycheu', 'tstilz', 'lsomeel41', 'nitramzero', 'burgner2', 'kkroege2', 'earlgrey', 'slhertz', 'afromaniac', 'meliu2']",88,"['ddaza2', 'cgarner3', 'dharmaturtle', 'hochan5', 'fonkafno', 'juan1', 'rusev1', 'japheth', 'choi129', 'wangwei420', 'shaofu88', 'spadoni2', 'johan1', 'anwen', 'mrbrightside695', 'rskirby2', 'ebecker', 'atseng3', 'nayak2', 'niemerg1', 'dnshah2', 'xhuang25', 'limpgopher88', 'chang87', 'gsvenni2', 'zumbahl1', 'klinga88', 'driscoll42', 'jbae5', 'mbianchi', 'sgopal4', 's0undfl0w', 'canandagdeviren', 'liu181', 'edward31', 'nbisby2', 'capmaster', 'nbhagat2', 'mkoh', 'ewood8806', 'ctribout', 'jstrack2', 'kodark', 'crptone', 'xunjian', 'khapp', 'tdburks2', 'manasgartia', 'mmccorm3', 'agibson', 'wkelleh2', 'chau5', 'mjermann', 'tehmonk', 'yichenusa', 'tianhu2', 'wu14', 'aldirin1', 'pmartin8', 'swieren1', 'cloud1', 'rusiana2', 'smustaf2', 'hchoi32', 'ass1085', 'han23', 'mlee71', 'bcerier2', 'resquiv', 'jiangj001', 'jtolar', 'resquiv2', 'mtrower2', 'johnseo2', 'akong2', 'liao27', 'vali0227', 'joejsheehan', 'charishma', 'mstrom', 'amedske2', 'panoramarts', 'sjhseraph', 'motoki1', 'intrimind', 'sshiffe2', 'rbhojwa2', 'yeunkim2']",7,"['mohamed', 'eluminite', None, 'nawaz', 'nmahend2', 'frankzheng329', 'puneet2905']",128,"['sskim20', 'ddaza2', 'cgarner3', 'dharmaturtle', 'hochan5', 'acedamace', 'thunghan', 'fonkafno', 'juan1', 'rusev1', 'japheth', 'choi129', 'wangwei420', 'jruzic2', 'cming2', 'spadoni2', 'lanhuo1986', 'shaofu88', 'puneet2905', 'grillz58', 'johan1', 'anwen', 'mrbrightside695', 'rskirby2', 'ebecker', 'timespectrum', 'swimjade', 'tstilz', 'atseng3', 'nayak2', 'niemerg1', 'lsomeel41', 'dnshah2', 'xhuang25', 'slhertz', 'meliu2', 'limpgopher88', 'chang87', 'gsvenni2', 'nawaz', 'zumbahl1', 'klinga88', 'driscoll42', 'jbae5', 'mbianchi', 'dstamat2', 'sgopal4', 's0undfl0w', 'frankzheng329', 'canandagdeviren', 'liu181', 'eluminite', 'edward31', 'nmahend2', 'nbisby2', None, 'echavez3', 'capmaster', 'nbhagat2', 'hfederm2', 'mkoh', 'ewood8806', 'nitramzero', 'ctribout', 'earlgrey', 'kodark', 'jstrack2', 'mohamed', 'crptone', 'pifactorial', 'xunjian', 'khapp', 'tdburks2', 'manasgartia', 'mmccorm3', 'agibson', 'wkelleh2', 'chau5', 'mjermann', 'tehmonk', 'yichenusa', 'tianhu2', 'bfogel2', 'kboger2', 'wu14', 'aldirin1', 'gmeyer3', 'pmartin8', 'swieren1', 'mmadeja2', 'cloud1', 'rusiana2', 'smustaf2', 'hchoi32', 'ass1085', 'freddycheu', 'han23', 'mlee71', 'bcerier2', 'burgner2', 'resquiv', 'jiangj001', 'jtolar', 'sbhaler2', 'resquiv2', 'mtrower2', 'johnseo2', 'akong2', 'liao27', 'dlowry2', 'vali0227', 'joejsheehan', 'charishma', 'mstrom', 'kdearnl2', 'amedske2', 'lionelmoh', 'panoramarts', 'sjhseraph', 'jwester3', 'motoki1', 'intrimind', 'kkroege2', 'sshiffe2', 'rbhojwa2', 'afromaniac', 'xliu34', 'yeunkim2']"
3,81,122,30,27,"['pifactorial', 'sskim20', 'mmccorm3', 'agibson', 'thunghan', 'acedamace', 'mjermann', 'dlowry2', 'vali0227', 'bfogel2', 'choi129', 'jruzic2', 'gmeyer3', 'lanhuo1986', 'kdearnl2', 'lionelmoh', 'timespectrum', 'swimjade', 'jwester3', 'lsomeel41', 'nitramzero', 'burgner2', 'kkroege2', 'dnshah2', 'slhertz', 'afromaniac', 'xliu34']",94,"['ddaza2', 'cgarner3', 'dharmaturtle', 'hochan5', 'fonkafno', 'juan1', 'rusev1', 'japheth', 'wangwei420', 'shaofu88', 'spadoni2', 'cming2', 'grillz58', 'johan1', 'anwen', 'mrbrightside695', 'rskirby2', 'ebecker', 'tstilz', 'atseng3', 'nayak2', 'niemerg1', 'xhuang25', 'meliu2', 'limpgopher88', 'chang87', 'gsvenni2', 'zumbahl1', 'klinga88', 'driscoll42', 'jbae5', 'mbianchi', 'dstamat2', 'sgopal4', 's0undfl0w', 'canandagdeviren', 'liu181', 'edward31', 'nbisby2', 'echavez3', 'capmaster', 'nbhagat2', 'hfederm2', 'mkoh', 'ewood8806', 'ctribout', 'earlgrey', 'kodark', 'jstrack2', 'crptone', 'xunjian', 'khapp', 'tdburks2', 'manasgartia', 'wkelleh2', 'chau5', 'tehmonk', 'yichenusa', 'tianhu2', 'kboger2', 'wu14', 'aldirin1', 'pmartin8', 'swieren1', 'mmadeja2', 'cloud1', 'rusiana2', 'smustaf2', 'hchoi32', 'ass1085', 'freddycheu', 'han23', 'mlee71', 'bcerier2', 'resquiv', 'jiangj001', 'jtolar', 'sbhaler2', 'resquiv2', 'mtrower2', 'johnseo2', 'akong2', 'liao27', 'joejsheehan', 'charishma', 'mstrom', 'amedske2', 'panoramarts', 'sjhseraph', 'motoki1', 'intrimind', 'sshiffe2', 'rbhojwa2', 'yeunkim2']",3,"[None, 'mohamed', 'ucabraal']",124,"['pifactorial', 'xunjian', 'sskim20', 'khapp', 'tdburks2', 'ddaza2', 'manasgartia', 'mmccorm3', 'agibson', 'cgarner3', 'dharmaturtle', 'wkelleh2', 'hochan5', 'chau5', 'acedamace', 'thunghan', 'fonkafno', 'juan1', 'rusev1', 'japheth', 'mjermann', 'tehmonk', 'yichenusa', 'ucabraal', 'tianhu2', 'bfogel2', 'choi129', 'kboger2', 'wu14', 'afromaniac', 'aldirin1', 'wangwei420', 'jruzic2', 'cming2', 'spadoni2', 'lanhuo1986', 'shaofu88', 'gmeyer3', 'pmartin8', 'swieren1', 'mmadeja2', 'grillz58', 'cloud1', 'johan1', 'anwen', 'rusiana2', 'smustaf2', 'mrbrightside695', 'rskirby2', 'hchoi32', 'ebecker', 'timespectrum', 'swimjade', 'ass1085', 'tstilz', 'atseng3', 'freddycheu', 'han23', 'mlee71', 'bcerier2', 'nayak2', 'niemerg1', 'lsomeel41', 'burgner2', 'dnshah2', 'xhuang25', 'slhertz', 'mohamed', 'meliu2', 'limpgopher88', 'chang87', 'resquiv', 'jiangj001', 'jtolar', 'gsvenni2', 'sbhaler2', 'resquiv2', 'zumbahl1', 'mtrower2', 'johnseo2', 'akong2', 'liao27', 'klinga88', 'driscoll42', 'jbae5', 'dlowry2', 'vali0227', 'joejsheehan', 'mbianchi', 'dstamat2', 'sgopal4', 's0undfl0w', 'canandagdeviren', 'charishma', 'liu181', 'mstrom', 'kdearnl2', 'amedske2', 'edward31', 'lionelmoh', 'nbisby2', None, 'echavez3', 'capmaster', 'nbhagat2', 'hfederm2', 'panoramarts', 'sjhseraph', 'mkoh', 'jwester3', 'ewood8806', 'motoki1', 'intrimind', 'nitramzero', 'ctribout', 'kkroege2', 'sshiffe2', 'earlgrey', 'kodark', 'jstrack2', 'rbhojwa2', 'xliu34', 'yeunkim2', 'crptone']"
3,88,122,29,26,"['pifactorial', 'meliu2', 'wkelleh2', 'thunghan', 'acedamace', 'dlowry2', 'bfogel2', 'choi129', 'dstamat2', 'jruzic2', 'gmeyer3', 'lanhuo1986', 'grillz58', 'kdearnl2', 'lionelmoh', 'timespectrum', 'nbhagat2', 'swimjade', 'jwester3', 'nitramzero', 'kkroege2', 'dnshah2', 'jstrack2', 'earlgrey', 'afromaniac', 'xliu34']",95,"['xunjian', 'sskim20', 'khapp', 'tdburks2', 'ddaza2', 'manasgartia', 'mmccorm3', 'agibson', 'cgarner3', 'dharmaturtle', 'hochan5', 'chau5', 'fonkafno', 'juan1', 'rusev1', 'japheth', 'mjermann', 'tehmonk', 'yichenusa', 'tianhu2', 'kboger2', 'wu14', 'aldirin1', 'wangwei420', 'cming2', 'spadoni2', 'shaofu88', 'pmartin8', 'swieren1', 'mmadeja2', 'cloud1', 'johan1', 'anwen', 'rusiana2', 'smustaf2', 'mrbrightside695', 'rskirby2', 'hchoi32', 'ebecker', 'ass1085', 'tstilz', 'atseng3', 'freddycheu', 'han23', 'mlee71', 'bcerier2', 'nayak2', 'niemerg1', 'lsomeel41', 'burgner2', 'xhuang25', 'slhertz', 'limpgopher88', 'chang87', 'resquiv', 'jiangj001', 'jtolar', 'gsvenni2', 'sbhaler2', 'resquiv2', 'zumbahl1', 'mtrower2', 'johnseo2', 'akong2', 'liao27', 'klinga88', 'driscoll42', 'jbae5', 'vali0227', 'joejsheehan', 'mbianchi', 'sgopal4', 's0undfl0w', 'canandagdeviren', 'charishma', 'liu181', 'mstrom', 'amedske2', 'edward31', 'nbisby2', 'echavez3', 'capmaster', 'hfederm2', 'panoramarts', 'sjhseraph', 'mkoh', 'ewood8806', 'motoki1', 'intrimind', 'ctribout', 'sshiffe2', 'kodark', 'rbhojwa2', 'yeunkim2', 'crptone']",3,"['mkurows2', None, 'wfergus2']",124,"['pifactorial', 'xunjian', 'sskim20', 'khapp', 'tdburks2', 'ddaza2', 'manasgartia', 'mmccorm3', 'agibson', 'cgarner3', 'dharmaturtle', 'wkelleh2', 'hochan5', 'chau5', 'acedamace', 'thunghan', 'fonkafno', 'juan1', 'rusev1', 'japheth', 'mjermann', 'tehmonk', 'yichenusa', 'wfergus2', 'tianhu2', 'bfogel2', 'choi129', 'kboger2', 'wu14', 'afromaniac', 'aldirin1', 'wangwei420', 'jruzic2', 'cming2', 'spadoni2', 'lanhuo1986', 'shaofu88', 'gmeyer3', 'pmartin8', 'swieren1', 'mmadeja2', 'grillz58', 'mkurows2', 'cloud1', 'johan1', 'anwen', 'rusiana2', 'smustaf2', 'mrbrightside695', 'rskirby2', 'hchoi32', 'ebecker', 'timespectrum', 'swimjade', 'ass1085', 'tstilz', 'atseng3', 'freddycheu', 'han23', 'mlee71', 'bcerier2', 'nayak2', 'niemerg1', 'lsomeel41', 'burgner2', 'dnshah2', 'xhuang25', 'slhertz', 'meliu2', 'limpgopher88', 'chang87', 'resquiv', 'jiangj001', 'jtolar', 'gsvenni2', 'sbhaler2', 'resquiv2', 'zumbahl1', 'mtrower2', 'johnseo2', 'akong2', 'liao27', 'klinga88', 'driscoll42', 'jbae5', 'dlowry2', 'vali0227', 'joejsheehan', 'mbianchi', 'dstamat2', 'sgopal4', 's0undfl0w', 'canandagdeviren', 'charishma', 'liu181', 'mstrom', 'kdearnl2', 'amedske2', 'edward31', 'lionelmoh', 'nbisby2', None, 'echavez3', 'capmaster', 'nbhagat2', 'hfederm2', 'panoramarts', 'sjhseraph', 'mkoh', 'jwester3', 'ewood8806', 'motoki1', 'intrimind', 'nitramzero', 'ctribout', 'kkroege2', 'sshiffe2', 'earlgrey', 'kodark', 'jstrack2', 'rbhojwa2', 'xliu34', 'yeunkim2', 'crptone']"
3,84,122,28,25,"['meliu2', 'mmccorm3', 'agibson', 'sbhaler2', 'thunghan', 'acedamace', 'dlowry2', 'vali0227', 'bfogel2', 'choi129', 'dstamat2', 'jruzic2', 'gmeyer3', 'lanhuo1986', 'kdearnl2', 'lionelmoh', 'swimjade', 'jwester3', 'burgner2', 'kkroege2', 'dnshah2', 'earlgrey', 'slhertz', 'afromaniac', 'xliu34']",96,"['pifactorial', 'xunjian', 'sskim20', 'khapp', 'tdburks2', 'ddaza2', 'manasgartia', 'cgarner3', 'dharmaturtle', 'wkelleh2', 'hochan5', 'chau5', 'fonkafno', 'juan1', 'rusev1', 'japheth', 'mjermann', 'tehmonk', 'yichenusa', 'tianhu2', 'kboger2', 'wu14', 'aldirin1', 'wangwei420', 'cming2', 'spadoni2', 'shaofu88', 'pmartin8', 'swieren1', 'mmadeja2', 'grillz58', 'cloud1', 'johan1', 'anwen', 'rusiana2', 'smustaf2', 'mrbrightside695', 'rskirby2', 'hchoi32', 'ebecker', 'timespectrum', 'ass1085', 'tstilz', 'atseng3', 'freddycheu', 'han23', 'mlee71', 'bcerier2', 'nayak2', 'niemerg1', 'lsomeel41', 'xhuang25', 'limpgopher88', 'chang87', 'resquiv', 'jiangj001', 'jtolar', 'gsvenni2', 'resquiv2', 'zumbahl1', 'mtrower2', 'johnseo2', 'akong2', 'liao27', 'klinga88', 'driscoll42', 'jbae5', 'joejsheehan', 'mbianchi', 'sgopal4', 's0undfl0w', 'canandagdeviren', 'charishma', 'liu181', 'mstrom', 'amedske2', 'edward31', 'nbisby2', 'echavez3', 'capmaster', 'nbhagat2', 'hfederm2', 'panoramarts', 'sjhseraph', 'mkoh', 'ewood8806', 'motoki1', 'intrimind', 'nitramzero', 'ctribout', 'sshiffe2', 'kodark', 'jstrack2', 'rbhojwa2', 'yeunkim2', 'crptone']",3,"['nawaz', None, 'mohamed']",124,"['pifactorial', 'xunjian', 'sskim20', 'khapp', 'tdburks2', 'ddaza2', 'manasgartia', 'mmccorm3', 'agibson', 'cgarner3', 'dharmaturtle', 'wkelleh2', 'hochan5', 'chau5', 'acedamace', 'thunghan', 'fonkafno', 'juan1', 'rusev1', 'japheth', 'mjermann', 'tehmonk', 'yichenusa', 'tianhu2', 'bfogel2', 'choi129', 'kboger2', 'wu14', 'afromaniac', 'aldirin1', 'wangwei420', 'jruzic2', 'cming2', 'spadoni2', 'lanhuo1986', 'shaofu88', 'gmeyer3', 'pmartin8', 'swieren1', 'mmadeja2', 'grillz58', 'cloud1', 'johan1', 'anwen', 'rusiana2', 'smustaf2', 'mrbrightside695', 'rskirby2', 'hchoi32', 'ebecker', 'timespectrum', 'swimjade', 'ass1085', 'tstilz', 'atseng3', 'freddycheu', 'han23', 'mlee71', 'bcerier2', 'nayak2', 'niemerg1', 'lsomeel41', 'burgner2', 'dnshah2', 'xhuang25', 'slhertz', 'mohamed', 'meliu2', 'limpgopher88', 'chang87', 'resquiv', 'jiangj001', 'jtolar', 'gsvenni2', 'sbhaler2', 'resquiv2', 'nawaz', 'zumbahl1', 'mtrower2', 'johnseo2', 'akong2', 'liao27', 'klinga88', 'driscoll42', 'jbae5', 'dlowry2', 'vali0227', 'joejsheehan', 'mbianchi', 'dstamat2', 'sgopal4', 's0undfl0w', 'canandagdeviren', 'charishma', 'liu181', 'mstrom', 'kdearnl2', 'amedske2', 'edward31', 'lionelmoh', 'nbisby2', None, 'echavez3', 'capmaster', 'nbhagat2', 'hfederm2', 'panoramarts', 'sjhseraph', 'mkoh', 'jwester3', 'ewood8806', 'motoki1', 'intrimind', 'nitramzero', 'ctribout', 'kkroege2', 'sshiffe2', 'earlgrey', 'kodark', 'jstrack2', 'rbhojwa2', 'xliu34', 'yeunkim2', 'crptone']"
3,52,122,24,15,"['pmartin8', 'swieren1', 'atseng3', 'xunjian', 'khapp', 'grillz58', 'bcerier2', 'manasgartia', 'joejsheehan', 'cgarner3', 'capmaster', 'aldirin1', 'wu14', 'shaofu88', 'cming2']",106,"['pifactorial', 'sskim20', 'tdburks2', 'ddaza2', 'mmccorm3', 'agibson', 'dharmaturtle', 'wkelleh2', 'hochan5', 'chau5', 'acedamace', 'thunghan', 'fonkafno', 'juan1', 'rusev1', 'japheth', 'mjermann', 'tehmonk', 'yichenusa', 'tianhu2', 'bfogel2', 'choi129', 'kboger2', 'afromaniac', 'wangwei420', 'jruzic2', 'spadoni2', 'lanhuo1986', 'gmeyer3', 'mmadeja2', 'cloud1', 'johan1', 'anwen', 'rusiana2', 'smustaf2', 'mrbrightside695', 'rskirby2', 'hchoi32', 'ebecker', 'timespectrum', 'swimjade', 'ass1085', 'tstilz', 'freddycheu', 'han23', 'mlee71', 'nayak2', 'niemerg1', 'lsomeel41', 'burgner2', 'dnshah2', 'xhuang25', 'slhertz', 'meliu2', 'limpgopher88', 'chang87', 'resquiv', 'jiangj001', 'jtolar', 'gsvenni2', 'sbhaler2', 'resquiv2', 'zumbahl1', 'mtrower2', 'johnseo2', 'akong2', 'liao27', 'klinga88', 'driscoll42', 'jbae5', 'dlowry2', 'vali0227', 'mbianchi', 'dstamat2', 'sgopal4', 's0undfl0w', 'canandagdeviren', 'charishma', 'liu181', 'mstrom', 'kdearnl2', 'amedske2', 'edward31', 'lionelmoh', 'nbisby2', 'echavez3', 'nbhagat2', 'hfederm2', 'panoramarts', 'sjhseraph', 'mkoh', 'jwester3', 'ewood8806', 'motoki1', 'intrimind', 'nitramzero', 'ctribout', 'kkroege2', 'sshiffe2', 'earlgrey', 'kodark', 'jstrack2', 'rbhojwa2', 'xliu34', 'yeunkim2', 'crptone']",9,"['eva_chi', 'tim8241', 'gmayhew', 'tonysweet', 'flian2', 'egh1fw', 'momer', 'rchavali', None]",130,"['pifactorial', 'xunjian', 'sskim20', 'khapp', 'gmayhew', 'tdburks2', 'ddaza2', 'manasgartia', 'mmccorm3', 'agibson', 'cgarner3', 'dharmaturtle', 'wkelleh2', 'hochan5', 'chau5', 'acedamace', 'thunghan', 'fonkafno', 'juan1', 'rusev1', 'japheth', 'mjermann', 'tehmonk', 'yichenusa', 'tianhu2', 'bfogel2', 'choi129', 'kboger2', 'wu14', 'afromaniac', 'aldirin1', 'wangwei420', 'jruzic2', 'cming2', 'spadoni2', 'lanhuo1986', 'shaofu88', 'gmeyer3', 'pmartin8', 'swieren1', 'mmadeja2', 'grillz58', 'cloud1', 'rchavali', 'johan1', 'anwen', 'rusiana2', 'smustaf2', 'mrbrightside695', 'rskirby2', 'hchoi32', 'ebecker', 'timespectrum', 'swimjade', 'ass1085', 'tstilz', 'atseng3', 'freddycheu', 'han23', 'mlee71', 'tonysweet', 'bcerier2', 'nayak2', 'niemerg1', 'lsomeel41', 'burgner2', 'dnshah2', 'xhuang25', 'slhertz', 'meliu2', 'limpgopher88', 'chang87', 'resquiv', 'eva_chi', 'flian2', 'jiangj001', 'jtolar', 'gsvenni2', 'sbhaler2', 'resquiv2', 'zumbahl1', 'mtrower2', 'johnseo2', 'akong2', 'liao27', 'klinga88', 'driscoll42', 'jbae5', 'dlowry2', 'vali0227', 'joejsheehan', 'mbianchi', 'dstamat2', 'sgopal4', 's0undfl0w', 'canandagdeviren', 'charishma', 'liu181', 'mstrom', 'egh1fw', 'momer', 'kdearnl2', 'amedske2', 'edward31', 'lionelmoh', 'nbisby2', None, 'echavez3', 'capmaster', 'nbhagat2', 'hfederm2', 'panoramarts', 'sjhseraph', 'mkoh', 'jwester3', 'tim8241', 'ewood8806', 'motoki1', 'intrimind', 'nitramzero', 'ctribout', 'kkroege2', 'sshiffe2', 'earlgrey', 'kodark', 'jstrack2', 'rbhojwa2', 'xliu34', 'yeunkim2', 'crptone']"
3,167,122,24,20,"['sbhaler2', 'thunghan', 'acedamace', 'dlowry2', 'bfogel2', 'choi129', 'dstamat2', 'lanhuo1986', 'lionelmoh', 'timespectrum', 'swimjade', 'jwester3', 'tstilz', 'lsomeel41', 'nitramzero', 'dnshah2', 'earlgrey', 'slhertz', 'afromaniac', 'xliu34']",101,"['pifactorial', 'xunjian', 'sskim20', 'khapp', 'tdburks2', 'ddaza2', 'manasgartia', 'mmccorm3', 'agibson', 'cgarner3', 'dharmaturtle', 'wkelleh2', 'hochan5', 'chau5', 'fonkafno', 'juan1', 'rusev1', 'japheth', 'mjermann', 'tehmonk', 'yichenusa', 'tianhu2', 'kboger2', 'wu14', 'aldirin1', 'wangwei420', 'jruzic2', 'cming2', 'spadoni2', 'shaofu88', 'gmeyer3', 'pmartin8', 'swieren1', 'mmadeja2', 'grillz58', 'cloud1', 'johan1', 'anwen', 'rusiana2', 'smustaf2', 'mrbrightside695', 'rskirby2', 'hchoi32', 'ebecker', 'ass1085', 'atseng3', 'freddycheu', 'han23', 'mlee71', 'bcerier2', 'nayak2', 'niemerg1', 'burgner2', 'xhuang25', 'meliu2', 'limpgopher88', 'chang87', 'resquiv', 'jiangj001', 'jtolar', 'gsvenni2', 'resquiv2', 'zumbahl1', 'mtrower2', 'johnseo2', 'akong2', 'liao27', 'klinga88', 'driscoll42', 'jbae5', 'vali0227', 'joejsheehan', 'mbianchi', 'sgopal4', 's0undfl0w', 'canandagdeviren', 'charishma', 'liu181', 'mstrom', 'kdearnl2', 'amedske2', 'edward31', 'nbisby2', 'echavez3', 'capmaster', 'nbhagat2', 'hfederm2', 'panoramarts', 'sjhseraph', 'mkoh', 'ewood8806', 'motoki1', 'intrimind', 'ctribout', 'kkroege2', 'sshiffe2', 'kodark', 'jstrack2', 'rbhojwa2', 'yeunkim2', 'crptone']",4,"['flian2', 'mkurows2', None, 'wfergus2']",125,"['pifactorial', 'xunjian', 'sskim20', 'khapp', 'tdburks2', 'ddaza2', 'manasgartia', 'mmccorm3', 'agibson', 'cgarner3', 'dharmaturtle', 'wkelleh2', 'hochan5', 'chau5', 'acedamace', 'thunghan', 'fonkafno', 'juan1', 'rusev1', 'japheth', 'mjermann', 'tehmonk', 'yichenusa', 'wfergus2', 'tianhu2', 'bfogel2', 'choi129', 'kboger2', 'wu14', 'afromaniac', 'aldirin1', 'wangwei420', 'jruzic2', 'cming2', 'spadoni2', 'lanhuo1986', 'shaofu88', 'gmeyer3', 'pmartin8', 'swieren1', 'mmadeja2', 'grillz58', 'mkurows2', 'cloud1', 'johan1', 'anwen', 'rusiana2', 'smustaf2', 'mrbrightside695', 'rskirby2', 'hchoi32', 'ebecker', 'timespectrum', 'swimjade', 'ass1085', 'tstilz', 'atseng3', 'freddycheu', 'han23', 'mlee71', 'bcerier2', 'nayak2', 'niemerg1', 'lsomeel41', 'burgner2', 'dnshah2', 'xhuang25', 'slhertz', 'meliu2', 'limpgopher88', 'chang87', 'resquiv', 'flian2', 'jiangj001', 'jtolar', 'gsvenni2', 'sbhaler2', 'resquiv2', 'zumbahl1', 'mtrower2', 'johnseo2', 'akong2', 'liao27', 'klinga88', 'driscoll42', 'jbae5', 'dlowry2', 'vali0227', 'joejsheehan', 'mbianchi', 'dstamat2', 'sgopal4', 's0undfl0w', 'canandagdeviren', 'charishma', 'liu181', 'mstrom', 'kdearnl2', 'amedske2', 'edward31', 'lionelmoh', 'nbisby2', None, 'echavez3', 'capmaster', 'nbhagat2', 'hfederm2', 'panoramarts', 'sjhseraph', 'mkoh', 'jwester3', 'ewood8806', 'motoki1', 'intrimind', 'nitramzero', 'ctribout', 'kkroege2', 'sshiffe2', 'earlgrey', 'kodark', 'jstrack2', 'rbhojwa2', 'xliu34', 'yeunkim2', 'crptone']"
3,161,122,20,16,"['atseng3', 'mtrower2', 'swieren1', 'han23', 'khapp', 'bcerier2', 'chang87', 'manasgartia', 'vali0227', 'cgarner3', 'dharmaturtle', 'capmaster', 'aldirin1', 'hochan5', 'shaofu88', 'cming2']",105,"['pifactorial', 'xunjian', 'sskim20', 'tdburks2', 'ddaza2', 'mmccorm3', 'agibson', 'wkelleh2', 'chau5', 'acedamace', 'thunghan', 'fonkafno', 'juan1', 'rusev1', 'japheth', 'mjermann', 'tehmonk', 'yichenusa', 'tianhu2', 'bfogel2', 'choi129', 'kboger2', 'wu14', 'afromaniac', 'wangwei420', 'jruzic2', 'spadoni2', 'lanhuo1986', 'gmeyer3', 'pmartin8', 'mmadeja2', 'grillz58', 'cloud1', 'johan1', 'anwen', 'rusiana2', 'smustaf2', 'mrbrightside695', 'rskirby2', 'hchoi32', 'ebecker', 'timespectrum', 'swimjade', 'ass1085', 'tstilz', 'freddycheu', 'mlee71', 'nayak2', 'niemerg1', 'lsomeel41', 'burgner2', 'dnshah2', 'xhuang25', 'slhertz', 'meliu2', 'limpgopher88', 'resquiv', 'jiangj001', 'jtolar', 'gsvenni2', 'sbhaler2', 'resquiv2', 'zumbahl1', 'johnseo2', 'akong2', 'liao27', 'klinga88', 'driscoll42', 'jbae5', 'dlowry2', 'joejsheehan', 'mbianchi', 'dstamat2', 'sgopal4', 's0undfl0w', 'canandagdeviren', 'charishma', 'liu181', 'mstrom', 'kdearnl2', 'amedske2', 'edward31', 'lionelmoh', 'nbisby2', 'echavez3', 'nbhagat2', 'hfederm2', 'panoramarts', 'sjhseraph', 'mkoh', 'jwester3', 'ewood8806', 'motoki1', 'intrimind', 'nitramzero', 'ctribout', 'kkroege2', 'sshiffe2', 'earlgrey', 'kodark', 'jstrack2', 'rbhojwa2', 'xliu34', 'yeunkim2', 'crptone']",4,"['ares_xlz', 'flian2', 'larsgtb', None]",125,"['pifactorial', 'xunjian', 'sskim20', 'khapp', 'tdburks2', 'ddaza2', 'manasgartia', 'mmccorm3', 'agibson', 'cgarner3', 'dharmaturtle', 'wkelleh2', 'hochan5', 'chau5', 'acedamace', 'thunghan', 'fonkafno', 'juan1', 'rusev1', 'japheth', 'mjermann', 'tehmonk', 'yichenusa', 'tianhu2', 'bfogel2', 'choi129', 'kboger2', 'wu14', 'afromaniac', 'aldirin1', 'wangwei420', 'jruzic2', 'cming2', 'spadoni2', 'lanhuo1986', 'shaofu88', 'gmeyer3', 'pmartin8', 'swieren1', 'mmadeja2', 'grillz58', 'cloud1', 'johan1', 'anwen', 'rusiana2', 'smustaf2', 'mrbrightside695', 'rskirby2', 'hchoi32', 'ebecker', 'timespectrum', 'swimjade', 'ass1085', 'tstilz', 'atseng3', 'freddycheu', 'han23', 'mlee71', 'bcerier2', 'nayak2', 'niemerg1', 'lsomeel41', 'burgner2', 'dnshah2', 'xhuang25', 'slhertz', 'meliu2', 'limpgopher88', 'chang87', 'resquiv', 'flian2', 'jiangj001', 'jtolar', 'gsvenni2', 'sbhaler2', 'resquiv2', 'zumbahl1', 'larsgtb', 'mtrower2', 'johnseo2', 'akong2', 'liao27', 'ares_xlz', 'klinga88', 'driscoll42', 'jbae5', 'dlowry2', 'vali0227', 'joejsheehan', 'mbianchi', 'dstamat2', 'sgopal4', 's0undfl0w', 'canandagdeviren', 'charishma', 'liu181', 'mstrom', 'kdearnl2', 'amedske2', 'edward31', 'lionelmoh', 'nbisby2', None, 'echavez3', 'capmaster', 'nbhagat2', 'hfederm2', 'panoramarts', 'sjhseraph', 'mkoh', 'jwester3', 'ewood8806', 'motoki1', 'intrimind', 'nitramzero', 'ctribout', 'kkroege2', 'sshiffe2', 'earlgrey', 'kodark', 'jstrack2', 'rbhojwa2', 'xliu34', 'yeunkim2', 'crptone']"
3,58,122,18,14,"['jwester3', 'swieren1', 'khapp', 'bcerier2', 'chau5', 'intrimind', 'lsomeel41', 'cgarner3', 'dharmaturtle', 'capmaster', 'joejsheehan', 'hochan5', 'shaofu88', 'cming2']",107,"['pifactorial', 'xunjian', 'sskim20', 'tdburks2', 'ddaza2', 'manasgartia', 'mmccorm3', 'agibson', 'wkelleh2', 'acedamace', 'thunghan', 'fonkafno', 'juan1', 'rusev1', 'japheth', 'mjermann', 'tehmonk', 'yichenusa', 'tianhu2', 'bfogel2', 'choi129', 'kboger2', 'wu14', 'afromaniac', 'aldirin1', 'wangwei420', 'jruzic2', 'spadoni2', 'lanhuo1986', 'gmeyer3', 'pmartin8', 'mmadeja2', 'grillz58', 'cloud1', 'johan1', 'anwen', 'rusiana2', 'smustaf2', 'mrbrightside695', 'rskirby2', 'hchoi32', 'ebecker', 'timespectrum', 'swimjade', 'ass1085', 'tstilz', 'atseng3', 'freddycheu', 'han23', 'mlee71', 'nayak2', 'niemerg1', 'burgner2', 'dnshah2', 'xhuang25', 'slhertz', 'meliu2', 'limpgopher88', 'chang87', 'resquiv', 'jiangj001', 'jtolar', 'gsvenni2', 'sbhaler2', 'resquiv2', 'zumbahl1', 'mtrower2', 'johnseo2', 'akong2', 'liao27', 'klinga88', 'driscoll42', 'jbae5', 'dlowry2', 'vali0227', 'mbianchi', 'dstamat2', 'sgopal4', 's0undfl0w', 'canandagdeviren', 'charishma', 'liu181', 'mstrom', 'kdearnl2', 'amedske2', 'edward31', 'lionelmoh', 'nbisby2', 'echavez3', 'nbhagat2', 'hfederm2', 'panoramarts', 'sjhseraph', 'mkoh', 'ewood8806', 'motoki1', 'nitramzero', 'ctribout', 'kkroege2', 'sshiffe2', 'earlgrey', 'kodark', 'jstrack2', 'rbhojwa2', 'xliu34', 'yeunkim2', 'crptone']",4,"['flian2', 'trieuvu1', 'beminor2', None]",125,"['pifactorial', 'xunjian', 'sskim20', 'khapp', 'tdburks2', 'ddaza2', 'manasgartia', 'mmccorm3', 'agibson', 'cgarner3', 'dharmaturtle', 'wkelleh2', 'hochan5', 'chau5', 'acedamace', 'thunghan', 'fonkafno', 'juan1', 'rusev1', 'japheth', 'mjermann', 'tehmonk', 'yichenusa', 'tianhu2', 'bfogel2', 'choi129', 'kboger2', 'wu14', 'afromaniac', 'aldirin1', 'wangwei420', 'jruzic2', 'cming2', 'spadoni2', 'lanhuo1986', 'shaofu88', 'gmeyer3', 'pmartin8', 'swieren1', 'mmadeja2', 'grillz58', 'cloud1', 'johan1', 'anwen', 'rusiana2', 'smustaf2', 'mrbrightside695', 'rskirby2', 'hchoi32', 'ebecker', 'timespectrum', 'swimjade', 'ass1085', 'tstilz', 'atseng3', 'freddycheu', 'han23', 'mlee71', 'bcerier2', 'nayak2', 'niemerg1', 'lsomeel41', 'burgner2', 'dnshah2', 'xhuang25', 'slhertz', 'meliu2', 'limpgopher88', 'chang87', 'resquiv', 'flian2', 'jiangj001', 'jtolar', 'gsvenni2', 'sbhaler2', 'resquiv2', 'zumbahl1', 'mtrower2', 'johnseo2', 'akong2', 'liao27', 'trieuvu1', 'klinga88', 'driscoll42', 'jbae5', 'dlowry2', 'vali0227', 'joejsheehan', 'mbianchi', 'dstamat2', 'sgopal4', 's0undfl0w', 'canandagdeviren', 'charishma', 'liu181', 'mstrom', 'kdearnl2', 'amedske2', 'edward31', 'lionelmoh', 'nbisby2', None, 'echavez3', 'capmaster', 'nbhagat2', 'hfederm2', 'panoramarts', 'sjhseraph', 'mkoh', 'jwester3', 'ewood8806', 'motoki1', 'beminor2', 'intrimind', 'nitramzero', 'ctribout', 'kkroege2', 'sshiffe2', 'earlgrey', 'kodark', 'jstrack2', 'rbhojwa2', 'xliu34', 'yeunkim2', 'crptone']"
3,82,122,13,9,"['swieren1', 'mtrower2', 'han23', 'xunjian', 'bcerier2', 'cgarner3', 'dharmaturtle', 'sgopal4', 'cming2']",112,"['pifactorial', 'sskim20', 'khapp', 'tdburks2', 'ddaza2', 'manasgartia', 'mmccorm3', 'agibson', 'wkelleh2', 'hochan5', 'chau5', 'acedamace', 'thunghan', 'fonkafno', 'juan1', 'rusev1', 'japheth', 'mjermann', 'tehmonk', 'yichenusa', 'tianhu2', 'bfogel2', 'choi129', 'kboger2', 'wu14', 'afromaniac', 'aldirin1', 'wangwei420', 'jruzic2', 'spadoni2', 'lanhuo1986', 'shaofu88', 'gmeyer3', 'pmartin8', 'mmadeja2', 'grillz58', 'cloud1', 'johan1', 'anwen', 'rusiana2', 'smustaf2', 'mrbrightside695', 'rskirby2', 'hchoi32', 'ebecker', 'timespectrum', 'swimjade', 'ass1085', 'tstilz', 'atseng3', 'freddycheu', 'mlee71', 'nayak2', 'niemerg1', 'lsomeel41', 'burgner2', 'dnshah2', 'xhuang25', 'slhertz', 'meliu2', 'limpgopher88', 'chang87', 'resquiv', 'jiangj001', 'jtolar', 'gsvenni2', 'sbhaler2', 'resquiv2', 'zumbahl1', 'johnseo2', 'akong2', 'liao27', 'klinga88', 'driscoll42', 'jbae5', 'dlowry2', 'vali0227', 'joejsheehan', 'mbianchi', 'dstamat2', 's0undfl0w', 'canandagdeviren', 'charishma', 'liu181', 'mstrom', 'kdearnl2', 'amedske2', 'edward31', 'lionelmoh', 'nbisby2', 'echavez3', 'capmaster', 'nbhagat2', 'hfederm2', 'panoramarts', 'sjhseraph', 'mkoh', 'jwester3', 'ewood8806', 'motoki1', 'intrimind', 'nitramzero', 'ctribout', 'kkroege2', 'sshiffe2', 'earlgrey', 'kodark', 'jstrack2', 'rbhojwa2', 'xliu34', 'yeunkim2', 'crptone']",4,"['flian2', 'larsgtb', 'miteecs', None]",125,"['pifactorial', 'xunjian', 'sskim20', 'khapp', 'tdburks2', 'ddaza2', 'manasgartia', 'mmccorm3', 'agibson', 'cgarner3', 'dharmaturtle', 'wkelleh2', 'hochan5', 'chau5', 'acedamace', 'thunghan', 'fonkafno', 'juan1', 'rusev1', 'japheth', 'mjermann', 'tehmonk', 'yichenusa', 'tianhu2', 'bfogel2', 'choi129', 'kboger2', 'wu14', 'afromaniac', 'aldirin1', 'wangwei420', 'jruzic2', 'cming2', 'spadoni2', 'lanhuo1986', 'shaofu88', 'gmeyer3', 'pmartin8', 'swieren1', 'mmadeja2', 'grillz58', 'cloud1', 'johan1', 'anwen', 'rusiana2', 'smustaf2', 'mrbrightside695', 'rskirby2', 'hchoi32', 'ebecker', 'timespectrum', 'swimjade', 'ass1085', 'tstilz', 'atseng3', 'freddycheu', 'han23', 'mlee71', 'bcerier2', 'nayak2', 'niemerg1', 'lsomeel41', 'burgner2', 'dnshah2', 'xhuang25', 'slhertz', 'meliu2', 'limpgopher88', 'chang87', 'resquiv', 'flian2', 'jiangj001', 'jtolar', 'gsvenni2', 'sbhaler2', 'resquiv2', 'zumbahl1', 'larsgtb', 'mtrower2', 'johnseo2', 'akong2', 'liao27', 'klinga88', 'driscoll42', 'jbae5', 'dlowry2', 'vali0227', 'joejsheehan', 'mbianchi', 'dstamat2', 'sgopal4', 's0undfl0w', 'canandagdeviren', 'charishma', 'liu181', 'mstrom', 'kdearnl2', 'amedske2', 'edward31', 'lionelmoh', 'nbisby2', None, 'echavez3', 'capmaster', 'nbhagat2', 'hfederm2', 'panoramarts', 'sjhseraph', 'mkoh', 'jwester3', 'ewood8806', 'motoki1', 'miteecs', 'intrimind', 'nitramzero', 'ctribout', 'kkroege2', 'sshiffe2', 'earlgrey', 'kodark', 'jstrack2', 'rbhojwa2', 'xliu34', 'yeunkim2', 'crptone']"
3,89,122,11,8,"['mtrower2', 'vali0227', 'joejsheehan', 'dharmaturtle', 'sgopal4', 'aldirin1', 'shaofu88', 'cming2']",113,"['pifactorial', 'xunjian', 'sskim20', 'khapp', 'tdburks2', 'ddaza2', 'manasgartia', 'mmccorm3', 'agibson', 'cgarner3', 'wkelleh2', 'hochan5', 'chau5', 'acedamace', 'thunghan', 'fonkafno', 'juan1', 'rusev1', 'japheth', 'mjermann', 'tehmonk', 'yichenusa', 'tianhu2', 'bfogel2', 'choi129', 'kboger2', 'wu14', 'afromaniac', 'wangwei420', 'jruzic2', 'spadoni2', 'lanhuo1986', 'gmeyer3', 'pmartin8', 'swieren1', 'mmadeja2', 'grillz58', 'cloud1', 'johan1', 'anwen', 'rusiana2', 'smustaf2', 'mrbrightside695', 'rskirby2', 'hchoi32', 'ebecker', 'timespectrum', 'swimjade', 'ass1085', 'tstilz', 'atseng3', 'freddycheu', 'han23', 'mlee71', 'bcerier2', 'nayak2', 'niemerg1', 'lsomeel41', 'burgner2', 'dnshah2', 'xhuang25', 'slhertz', 'meliu2', 'limpgopher88', 'chang87', 'resquiv', 'jiangj001', 'jtolar', 'gsvenni2', 'sbhaler2', 'resquiv2', 'zumbahl1', 'johnseo2', 'akong2', 'liao27', 'klinga88', 'driscoll42', 'jbae5', 'dlowry2', 'mbianchi', 'dstamat2', 's0undfl0w', 'canandagdeviren', 'charishma', 'liu181', 'mstrom', 'kdearnl2', 'amedske2', 'edward31', 'lionelmoh', 'nbisby2', 'echavez3', 'capmaster', 'nbhagat2', 'hfederm2', 'panoramarts', 'sjhseraph', 'mkoh', 'jwester3', 'ewood8806', 'motoki1', 'intrimind', 'nitramzero', 'ctribout', 'kkroege2', 'sshiffe2', 'earlgrey', 'kodark', 'jstrack2', 'rbhojwa2', 'xliu34', 'yeunkim2', 'crptone']",3,"['flian2', None, 'beminor2']",124,"['pifactorial', 'xunjian', 'sskim20', 'khapp', 'tdburks2', 'ddaza2', 'manasgartia', 'mmccorm3', 'agibson', 'cgarner3', 'dharmaturtle', 'wkelleh2', 'hochan5', 'chau5', 'acedamace', 'thunghan', 'fonkafno', 'juan1', 'rusev1', 'japheth', 'mjermann', 'tehmonk', 'yichenusa', 'tianhu2', 'bfogel2', 'choi129', 'kboger2', 'wu14', 'afromaniac', 'aldirin1', 'wangwei420', 'jruzic2', 'cming2', 'spadoni2', 'lanhuo1986', 'shaofu88', 'gmeyer3', 'pmartin8', 'swieren1', 'mmadeja2', 'grillz58', 'cloud1', 'johan1', 'anwen', 'rusiana2', 'smustaf2', 'mrbrightside695', 'rskirby2', 'hchoi32', 'ebecker', 'timespectrum', 'swimjade', 'ass1085', 'tstilz', 'atseng3', 'freddycheu', 'han23', 'mlee71', 'bcerier2', 'nayak2', 'niemerg1', 'lsomeel41', 'burgner2', 'dnshah2', 'xhuang25', 'slhertz', 'meliu2', 'limpgopher88', 'chang87', 'resquiv', 'flian2', 'jiangj001', 'jtolar', 'gsvenni2', 'sbhaler2', 'resquiv2', 'zumbahl1', 'mtrower2', 'johnseo2', 'akong2', 'liao27', 'klinga88', 'driscoll42', 'jbae5', 'dlowry2', 'vali0227', 'joejsheehan', 'mbianchi', 'dstamat2', 'sgopal4', 's0undfl0w', 'canandagdeviren', 'charishma', 'liu181', 'mstrom', 'kdearnl2', 'amedske2', 'edward31', 'lionelmoh', 'nbisby2', None, 'echavez3', 'capmaster', 'nbhagat2', 'hfederm2', 'panoramarts', 'sjhseraph', 'mkoh', 'jwester3', 'ewood8806', 'motoki1', 'beminor2', 'intrimind', 'nitramzero', 'ctribout', 'kkroege2', 'sshiffe2', 'earlgrey', 'kodark', 'jstrack2', 'rbhojwa2', 'xliu34', 'yeunkim2', 'crptone']"
3,162,122,9,7,"['fonkafno', 'mjermann', 'tdburks2', 'ddaza2', 'ctribout', 'johan1', 's0undfl0w']",114,"['pifactorial', 'xunjian', 'sskim20', 'khapp', 'manasgartia', 'mmccorm3', 'agibson', 'cgarner3', 'dharmaturtle', 'wkelleh2', 'hochan5', 'chau5', 'acedamace', 'thunghan', 'juan1', 'rusev1', 'japheth', 'tehmonk', 'yichenusa', 'tianhu2', 'bfogel2', 'choi129', 'kboger2', 'wu14', 'afromaniac', 'aldirin1', 'wangwei420', 'jruzic2', 'cming2', 'spadoni2', 'lanhuo1986', 'shaofu88', 'gmeyer3', 'pmartin8', 'swieren1', 'mmadeja2', 'grillz58', 'cloud1', 'anwen', 'rusiana2', 'smustaf2', 'mrbrightside695', 'rskirby2', 'hchoi32', 'ebecker', 'timespectrum', 'swimjade', 'ass1085', 'tstilz', 'atseng3', 'freddycheu', 'han23', 'mlee71', 'bcerier2', 'nayak2', 'niemerg1', 'lsomeel41', 'burgner2', 'dnshah2', 'xhuang25', 'slhertz', 'meliu2', 'limpgopher88', 'chang87', 'resquiv', 'jiangj001', 'jtolar', 'gsvenni2', 'sbhaler2', 'resquiv2', 'zumbahl1', 'mtrower2', 'johnseo2', 'akong2', 'liao27', 'klinga88', 'driscoll42', 'jbae5', 'dlowry2', 'vali0227', 'joejsheehan', 'mbianchi', 'dstamat2', 'sgopal4', 'canandagdeviren', 'charishma', 'liu181', 'mstrom', 'kdearnl2', 'amedske2', 'edward31', 'lionelmoh', 'nbisby2', 'echavez3', 'capmaster', 'nbhagat2', 'hfederm2', 'panoramarts', 'sjhseraph', 'mkoh', 'jwester3', 'ewood8806', 'motoki1', 'intrimind', 'nitramzero', 'kkroege2', 'sshiffe2', 'earlgrey', 'kodark', 'jstrack2', 'rbhojwa2', 'xliu34', 'yeunkim2', 'crptone']",2,"['fox6606', None]",123,"['pifactorial', 'xunjian', 'sskim20', 'khapp', 'tdburks2', 'ddaza2', 'manasgartia', 'mmccorm3', 'agibson', 'cgarner3', 'dharmaturtle', 'wkelleh2', 'hochan5', 'chau5', 'acedamace', 'thunghan', 'fonkafno', 'juan1', 'rusev1', 'japheth', 'mjermann', 'tehmonk', 'yichenusa', 'tianhu2', 'bfogel2', 'choi129', 'kboger2', 'wu14', 'afromaniac', 'aldirin1', 'wangwei420', 'jruzic2', 'cming2', 'spadoni2', 'lanhuo1986', 'shaofu88', 'gmeyer3', 'pmartin8', 'swieren1', 'mmadeja2', 'grillz58', 'cloud1', 'johan1', 'anwen', 'rusiana2', 'smustaf2', 'mrbrightside695', 'rskirby2', 'hchoi32', 'ebecker', 'timespectrum', 'swimjade', 'ass1085', 'tstilz', 'atseng3', 'freddycheu', 'han23', 'mlee71', 'bcerier2', 'nayak2', 'niemerg1', 'lsomeel41', 'burgner2', 'dnshah2', 'xhuang25', 'slhertz', 'meliu2', 'limpgopher88', 'chang87', 'resquiv', 'jiangj001', 'jtolar', 'gsvenni2', 'sbhaler2', 'resquiv2', 'zumbahl1', 'mtrower2', 'johnseo2', 'akong2', 'liao27', 'klinga88', 'driscoll42', 'jbae5', 'dlowry2', 'vali0227', 'joejsheehan', 'mbianchi', 'dstamat2', 'sgopal4', 's0undfl0w', 'canandagdeviren', 'charishma', 'liu181', 'mstrom', 'kdearnl2', 'amedske2', 'edward31', 'lionelmoh', 'fox6606', 'nbisby2', None, 'echavez3', 'capmaster', 'nbhagat2', 'hfederm2', 'panoramarts', 'sjhseraph', 'mkoh', 'jwester3', 'ewood8806', 'motoki1', 'intrimind', 'nitramzero', 'ctribout', 'kkroege2', 'sshiffe2', 'earlgrey', 'kodark', 'jstrack2', 'rbhojwa2', 'xliu34', 'yeunkim2', 'crptone']"
3,168,122,9,7,"['swieren1', 'mtrower2', 'khapp', 'dharmaturtle', 'aldirin1', 'wu14', 'cming2']",114,"['pifactorial', 'xunjian', 'sskim20', 'tdburks2', 'ddaza2', 'manasgartia', 'mmccorm3', 'agibson', 'cgarner3', 'wkelleh2', 'hochan5', 'chau5', 'acedamace', 'thunghan', 'fonkafno', 'juan1', 'rusev1', 'japheth', 'mjermann', 'tehmonk', 'yichenusa', 'tianhu2', 'bfogel2', 'choi129', 'kboger2', 'afromaniac', 'wangwei420', 'jruzic2', 'spadoni2', 'lanhuo1986', 'shaofu88', 'gmeyer3', 'pmartin8', 'mmadeja2', 'grillz58', 'cloud1', 'johan1', 'anwen', 'rusiana2', 'smustaf2', 'mrbrightside695', 'rskirby2', 'hchoi32', 'ebecker', 'timespectrum', 'swimjade', 'ass1085', 'tstilz', 'atseng3', 'freddycheu', 'han23', 'mlee71', 'bcerier2', 'nayak2', 'niemerg1', 'lsomeel41', 'burgner2', 'dnshah2', 'xhuang25', 'slhertz', 'meliu2', 'limpgopher88', 'chang87', 'resquiv', 'jiangj001', 'jtolar', 'gsvenni2', 'sbhaler2', 'resquiv2', 'zumbahl1', 'johnseo2', 'akong2', 'liao27', 'klinga88', 'driscoll42', 'jbae5', 'dlowry2', 'vali0227', 'joejsheehan', 'mbianchi', 'dstamat2', 'sgopal4', 's0undfl0w', 'canandagdeviren', 'charishma', 'liu181', 'mstrom', 'kdearnl2', 'amedske2', 'edward31', 'lionelmoh', 'nbisby2', 'echavez3', 'capmaster', 'nbhagat2', 'hfederm2', 'panoramarts', 'sjhseraph', 'mkoh', 'jwester3', 'ewood8806', 'motoki1', 'intrimind', 'nitramzero', 'ctribout', 'kkroege2', 'sshiffe2', 'earlgrey', 'kodark', 'jstrack2', 'rbhojwa2', 'xliu34', 'yeunkim2', 'crptone']",2,"['flian2', None]",123,"['pifactorial', 'xunjian', 'sskim20', 'khapp', 'tdburks2', 'ddaza2', 'manasgartia', 'mmccorm3', 'agibson', 'cgarner3', 'dharmaturtle', 'wkelleh2', 'hochan5', 'chau5', 'acedamace', 'thunghan', 'fonkafno', 'juan1', 'rusev1', 'japheth', 'mjermann', 'tehmonk', 'yichenusa', 'tianhu2', 'bfogel2', 'choi129', 'kboger2', 'wu14', 'afromaniac', 'aldirin1', 'wangwei420', 'jruzic2', 'cming2', 'spadoni2', 'lanhuo1986', 'shaofu88', 'gmeyer3', 'pmartin8', 'swieren1', 'mmadeja2', 'grillz58', 'cloud1', 'johan1', 'anwen', 'rusiana2', 'smustaf2', 'mrbrightside695', 'rskirby2', 'hchoi32', 'ebecker', 'timespectrum', 'swimjade', 'ass1085', 'tstilz', 'atseng3', 'freddycheu', 'han23', 'mlee71', 'bcerier2', 'nayak2', 'niemerg1', 'lsomeel41', 'burgner2', 'dnshah2', 'xhuang25', 'slhertz', 'meliu2', 'limpgopher88', 'chang87', 'resquiv', 'flian2', 'jiangj001', 'jtolar', 'gsvenni2', 'sbhaler2', 'resquiv2', 'zumbahl1', 'mtrower2', 'johnseo2', 'akong2', 'liao27', 'klinga88', 'driscoll42', 'jbae5', 'dlowry2', 'vali0227', 'joejsheehan', 'mbianchi', 'dstamat2', 'sgopal4', 's0undfl0w', 'canandagdeviren', 'charishma', 'liu181', 'mstrom', 'kdearnl2', 'amedske2', 'edward31', 'lionelmoh', 'nbisby2', None, 'echavez3', 'capmaster', 'nbhagat2', 'hfederm2', 'panoramarts', 'sjhseraph', 'mkoh', 'jwester3', 'ewood8806', 'motoki1', 'intrimind', 'nitramzero', 'ctribout', 'kkroege2', 'sshiffe2', 'earlgrey', 'kodark', 'jstrack2', 'rbhojwa2', 'xliu34', 'yeunkim2', 'crptone']"
3,53,122,7,3,"['fonkafno', 'mjermann', 's0undfl0w']",118,"['pifactorial', 'xunjian', 'sskim20', 'khapp', 'tdburks2', 'ddaza2', 'manasgartia', 'mmccorm3', 'agibson', 'cgarner3', 'dharmaturtle', 'wkelleh2', 'hochan5', 'chau5', 'acedamace', 'thunghan', 'juan1', 'rusev1', 'japheth', 'tehmonk', 'yichenusa', 'tianhu2', 'bfogel2', 'choi129', 'kboger2', 'wu14', 'afromaniac', 'aldirin1', 'wangwei420', 'jruzic2', 'cming2', 'spadoni2', 'lanhuo1986', 'shaofu88', 'gmeyer3', 'pmartin8', 'swieren1', 'mmadeja2', 'grillz58', 'cloud1', 'johan1', 'anwen', 'rusiana2', 'smustaf2', 'mrbrightside695', 'rskirby2', 'hchoi32', 'ebecker', 'timespectrum', 'swimjade', 'ass1085', 'tstilz', 'atseng3', 'freddycheu', 'han23', 'mlee71', 'bcerier2', 'nayak2', 'niemerg1', 'lsomeel41', 'burgner2', 'dnshah2', 'xhuang25', 'slhertz', 'meliu2', 'limpgopher88', 'chang87', 'resquiv', 'jiangj001', 'jtolar', 'gsvenni2', 'sbhaler2', 'resquiv2', 'zumbahl1', 'mtrower2', 'johnseo2', 'akong2', 'liao27', 'klinga88', 'driscoll42', 'jbae5', 'dlowry2', 'vali0227', 'joejsheehan', 'mbianchi', 'dstamat2', 'sgopal4', 'canandagdeviren', 'charishma', 'liu181', 'mstrom', 'kdearnl2', 'amedske2', 'edward31', 'lionelmoh', 'nbisby2', 'echavez3', 'capmaster', 'nbhagat2', 'hfederm2', 'panoramarts', 'sjhseraph', 'mkoh', 'jwester3', 'ewood8806', 'motoki1', 'intrimind', 'nitramzero', 'ctribout', 'kkroege2', 'sshiffe2', 'earlgrey', 'kodark', 'jstrack2', 'rbhojwa2', 'xliu34', 'yeunkim2', 'crptone']",4,"['yhuang38', 'fox6606', 'kylemore04', None]",125,"['pifactorial', 'xunjian', 'sskim20', 'khapp', 'tdburks2', 'ddaza2', 'manasgartia', 'mmccorm3', 'agibson', 'cgarner3', 'dharmaturtle', 'wkelleh2', 'hochan5', 'chau5', 'acedamace', 'thunghan', 'fonkafno', 'juan1', 'rusev1', 'japheth', 'mjermann', 'tehmonk', 'yichenusa', 'tianhu2', 'bfogel2', 'choi129', 'kboger2', 'wu14', 'afromaniac', 'yhuang38', 'aldirin1', 'wangwei420', 'jruzic2', 'cming2', 'spadoni2', 'lanhuo1986', 'shaofu88', 'gmeyer3', 'pmartin8', 'swieren1', 'mmadeja2', 'grillz58', 'cloud1', 'johan1', 'anwen', 'rusiana2', 'smustaf2', 'mrbrightside695', 'rskirby2', 'hchoi32', 'ebecker', 'timespectrum', 'swimjade', 'ass1085', 'tstilz', 'atseng3', 'freddycheu', 'han23', 'mlee71', 'bcerier2', 'nayak2', 'niemerg1', 'lsomeel41', 'burgner2', 'dnshah2', 'xhuang25', 'slhertz', 'meliu2', 'limpgopher88', 'chang87', 'resquiv', 'jiangj001', 'jtolar', 'gsvenni2', 'sbhaler2', 'resquiv2', 'zumbahl1', 'mtrower2', 'johnseo2', 'akong2', 'liao27', 'klinga88', 'driscoll42', 'jbae5', 'dlowry2', 'vali0227', 'joejsheehan', 'mbianchi', 'dstamat2', 'sgopal4', 's0undfl0w', 'canandagdeviren', 'charishma', 'liu181', 'mstrom', 'kylemore04', 'kdearnl2', 'amedske2', 'edward31', 'lionelmoh', 'fox6606', 'nbisby2', None, 'echavez3', 'capmaster', 'nbhagat2', 'hfederm2', 'panoramarts', 'sjhseraph', 'mkoh', 'jwester3', 'ewood8806', 'motoki1', 'intrimind', 'nitramzero', 'ctribout', 'kkroege2', 'sshiffe2', 'earlgrey', 'kodark', 'jstrack2', 'rbhojwa2', 'xliu34', 'yeunkim2', 'crptone']"
3,59,122,7,6,"['jwester3', 'ddaza2', 'intrimind', 'lsomeel41', 'johan1', 's0undfl0w']",115,"['pifactorial', 'xunjian', 'sskim20', 'khapp', 'tdburks2', 'manasgartia', 'mmccorm3', 'agibson', 'cgarner3', 'dharmaturtle', 'wkelleh2', 'hochan5', 'chau5', 'acedamace', 'thunghan', 'fonkafno', 'juan1', 'rusev1', 'japheth', 'mjermann', 'tehmonk', 'yichenusa', 'tianhu2', 'bfogel2', 'choi129', 'kboger2', 'wu14', 'afromaniac', 'aldirin1', 'wangwei420', 'jruzic2', 'cming2', 'spadoni2', 'lanhuo1986', 'shaofu88', 'gmeyer3', 'pmartin8', 'swieren1', 'mmadeja2', 'grillz58', 'cloud1', 'anwen', 'rusiana2', 'smustaf2', 'mrbrightside695', 'rskirby2', 'hchoi32', 'ebecker', 'timespectrum', 'swimjade', 'ass1085', 'tstilz', 'atseng3', 'freddycheu', 'han23', 'mlee71', 'bcerier2', 'nayak2', 'niemerg1', 'burgner2', 'dnshah2', 'xhuang25', 'slhertz', 'meliu2', 'limpgopher88', 'chang87', 'resquiv', 'jiangj001', 'jtolar', 'gsvenni2', 'sbhaler2', 'resquiv2', 'zumbahl1', 'mtrower2', 'johnseo2', 'akong2', 'liao27', 'klinga88', 'driscoll42', 'jbae5', 'dlowry2', 'vali0227', 'joejsheehan', 'mbianchi', 'dstamat2', 'sgopal4', 'canandagdeviren', 'charishma', 'liu181', 'mstrom', 'kdearnl2', 'amedske2', 'edward31', 'lionelmoh', 'nbisby2', 'echavez3', 'capmaster', 'nbhagat2', 'hfederm2', 'panoramarts', 'sjhseraph', 'mkoh', 'ewood8806', 'motoki1', 'nitramzero', 'ctribout', 'kkroege2', 'sshiffe2', 'earlgrey', 'kodark', 'jstrack2', 'rbhojwa2', 'xliu34', 'yeunkim2', 'crptone']",1,[None],122,"['pifactorial', 'xunjian', 'sskim20', 'khapp', 'tdburks2', 'ddaza2', 'manasgartia', 'mmccorm3', 'agibson', 'cgarner3', 'dharmaturtle', 'wkelleh2', 'hochan5', 'chau5', 'acedamace', 'thunghan', 'fonkafno', 'juan1', 'rusev1', 'japheth', 'mjermann', 'tehmonk', 'yichenusa', 'tianhu2', 'bfogel2', 'choi129', 'kboger2', 'wu14', 'afromaniac', 'aldirin1', 'wangwei420', 'jruzic2', 'cming2', 'spadoni2', 'lanhuo1986', 'shaofu88', 'gmeyer3', 'pmartin8', 'swieren1', 'mmadeja2', 'grillz58', 'cloud1', 'johan1', 'anwen', 'rusiana2', 'smustaf2', 'mrbrightside695', 'rskirby2', 'hchoi32', 'ebecker', 'timespectrum', 'swimjade', 'ass1085', 'tstilz', 'atseng3', 'freddycheu', 'han23', 'mlee71', 'bcerier2', 'nayak2', 'niemerg1', 'lsomeel41', 'burgner2', 'dnshah2', 'xhuang25', 'slhertz', 'meliu2', 'limpgopher88', 'chang87', 'resquiv', 'jiangj001', 'jtolar', 'gsvenni2', 'sbhaler2', 'resquiv2', 'zumbahl1', 'mtrower2', 'johnseo2', 'akong2', 'liao27', 'klinga88', 'driscoll42', 'jbae5', 'dlowry2', 'vali0227', 'joejsheehan', 'mbianchi', 'dstamat2', 'sgopal4', 's0undfl0w', 'canandagdeviren', 'charishma', 'liu181', 'mstrom', 'kdearnl2', 'amedske2', 'edward31', 'lionelmoh', 'nbisby2', None, 'echavez3', 'capmaster', 'nbhagat2', 'hfederm2', 'panoramarts', 'sjhseraph', 'mkoh', 'jwester3', 'ewood8806', 'motoki1', 'intrimind', 'nitramzero', 'ctribout', 'kkroege2', 'sshiffe2', 'earlgrey', 'kodark', 'jstrack2', 'rbhojwa2', 'xliu34', 'yeunkim2', 'crptone']"
3,83,122,7,5,"['fonkafno', 'mmadeja2', 'tdburks2', 'johan1', 's0undfl0w']",116,"['pifactorial', 'xunjian', 'sskim20', 'khapp', 'ddaza2', 'manasgartia', 'mmccorm3', 'agibson', 'cgarner3', 'dharmaturtle', 'wkelleh2', 'hochan5', 'chau5', 'acedamace', 'thunghan', 'juan1', 'rusev1', 'japheth', 'mjermann', 'tehmonk', 'yichenusa', 'tianhu2', 'bfogel2', 'choi129', 'kboger2', 'wu14', 'afromaniac', 'aldirin1', 'wangwei420', 'jruzic2', 'cming2', 'spadoni2', 'lanhuo1986', 'shaofu88', 'gmeyer3', 'pmartin8', 'swieren1', 'grillz58', 'cloud1', 'anwen', 'rusiana2', 'smustaf2', 'mrbrightside695', 'rskirby2', 'hchoi32', 'ebecker', 'timespectrum', 'swimjade', 'ass1085', 'tstilz', 'atseng3', 'freddycheu', 'han23', 'mlee71', 'bcerier2', 'nayak2', 'niemerg1', 'lsomeel41', 'burgner2', 'dnshah2', 'xhuang25', 'slhertz', 'meliu2', 'limpgopher88', 'chang87', 'resquiv', 'jiangj001', 'jtolar', 'gsvenni2', 'sbhaler2', 'resquiv2', 'zumbahl1', 'mtrower2', 'johnseo2', 'akong2', 'liao27', 'klinga88', 'driscoll42', 'jbae5', 'dlowry2', 'vali0227', 'joejsheehan', 'mbianchi', 'dstamat2', 'sgopal4', 'canandagdeviren', 'charishma', 'liu181', 'mstrom', 'kdearnl2', 'amedske2', 'edward31', 'lionelmoh', 'nbisby2', 'echavez3', 'capmaster', 'nbhagat2', 'hfederm2', 'panoramarts', 'sjhseraph', 'mkoh', 'jwester3', 'ewood8806', 'motoki1', 'intrimind', 'nitramzero', 'ctribout', 'kkroege2', 'sshiffe2', 'earlgrey', 'kodark', 'jstrack2', 'rbhojwa2', 'xliu34', 'yeunkim2', 'crptone']",2,"['yhuang38', None]",123,"['pifactorial', 'xunjian', 'sskim20', 'khapp', 'tdburks2', 'ddaza2', 'manasgartia', 'mmccorm3', 'agibson', 'cgarner3', 'dharmaturtle', 'wkelleh2', 'hochan5', 'chau5', 'acedamace', 'thunghan', 'fonkafno', 'juan1', 'rusev1', 'japheth', 'mjermann', 'tehmonk', 'yichenusa', 'tianhu2', 'bfogel2', 'choi129', 'kboger2', 'wu14', 'afromaniac', 'yhuang38', 'aldirin1', 'wangwei420', 'jruzic2', 'cming2', 'spadoni2', 'lanhuo1986', 'shaofu88', 'gmeyer3', 'pmartin8', 'swieren1', 'mmadeja2', 'grillz58', 'cloud1', 'johan1', 'anwen', 'rusiana2', 'smustaf2', 'mrbrightside695', 'rskirby2', 'hchoi32', 'ebecker', 'timespectrum', 'swimjade', 'ass1085', 'tstilz', 'atseng3', 'freddycheu', 'han23', 'mlee71', 'bcerier2', 'nayak2', 'niemerg1', 'lsomeel41', 'burgner2', 'dnshah2', 'xhuang25', 'slhertz', 'meliu2', 'limpgopher88', 'chang87', 'resquiv', 'jiangj001', 'jtolar', 'gsvenni2', 'sbhaler2', 'resquiv2', 'zumbahl1', 'mtrower2', 'johnseo2', 'akong2', 'liao27', 'klinga88', 'driscoll42', 'jbae5', 'dlowry2', 'vali0227', 'joejsheehan', 'mbianchi', 'dstamat2', 'sgopal4', 's0undfl0w', 'canandagdeviren', 'charishma', 'liu181', 'mstrom', 'kdearnl2', 'amedske2', 'edward31', 'lionelmoh', 'nbisby2', None, 'echavez3', 'capmaster', 'nbhagat2', 'hfederm2', 'panoramarts', 'sjhseraph', 'mkoh', 'jwester3', 'ewood8806', 'motoki1', 'intrimind', 'nitramzero', 'ctribout', 'kkroege2', 'sshiffe2', 'earlgrey', 'kodark', 'jstrack2', 'rbhojwa2', 'xliu34', 'yeunkim2', 'crptone']"
4,142,117,54,51,"['garyhou', 'shano2', 'scott7', 'apazukha', 'mwdordor', 'rholyk', 'kosorji', 'jritch', 'cnguyen8', 'manraj09', 'shawnm01', 'hbkim89', 'mmaqian', 'narnaut', 'riteshb', 'tamermoh', 'enforce', 'ebryden', 'btonner', 'leonlian007', 'crgbys', 'timtim1065', 'cameo24', 'eietmo', 'phyzzle', 'jas1988', 'kimberlyma', 'far1989', 'derek003', 'aloha', 'jason04', 'leonhart', 'karmue', 'jackyc11', 'melody00', 'cyboy', 'jameswan', 'hin41189', 'felixpoon', 'jscchou', 'cowsgomur', 'alexhung', 'lucyli89', 'jiening', 'dexteritty', 'bawagsk', 'iori', 'blake', 'john14', 'jingcong', 'elviajero']",65,"['dollyddyy', 'allentrue', 'chain1987', 'mtnguyen', 'sarutd', 'amekstrand', 'sandy', 'acarus', 'mtandon', 'lphunh', 'gssalloum', 'tomas', 'dscassid', 'garrett3', 'tjdwls0510', 'gsferrer', 'egaytan', 'yk210', 'mncuatico', 'mlucas', 'sumeetg', 'jaruiz3', 'amininio', 'anushaborra', 'jrenos', 'ashwinganesh', 'orange7', 'tiffco12', 'kapiado', 'jmpm', 'titusl', 'nguyenhtran', 'dskieu', 'jdejesus', 'mqcastillo', 'aacordon', 'bolormaa', 'evalenzuela', 'soto1231', 'maearley', 'chicks', 'darthandy', 'sfalmeida', 'arinb', 'alopez1', 'jflores', 'rpmaskill', 'crs', 'tbermea', 'caumsted', 'majaurrieta', 'taz67rs', 'isanchez', 'cemontalvo', 'towelieee', 'erodriguez', 'aw38', 'jacardenas4', 'bleethat', 'varsha16', 'benster0', 'ohernandez', 'bdsalas', 'sthyan87', 'ealmeda']",3,"['axion6', None, 'yasyas']",119,"['dollyddyy', 'sandy', 'lphunh', 'shawnm01', 'gsferrer', 'yasyas', 'amininio', 'leonlian007', 'ashwinganesh', 'orange7', 'nguyenhtran', 'jdejesus', 'kimberlyma', 'derek003', 'jason04', 'leonhart', 'alexhung', 'caumsted', 'benster0', 'ohernandez', 'mtnguyen', 'amekstrand', 'apazukha', 'rholyk', 'jritch', 'gssalloum', 'tomas', 'hbkim89', 'mmaqian', 'narnaut', 'enforce', 'mncuatico', 'jaruiz3', 'ebryden', 'crgbys', 'tiffco12', 'kapiado', 'phyzzle', 'aacordon', 'karmue', 'cyboy', 'chicks', 'jameswan', 'arinb', None, 'felixpoon', 'jscchou', 'rpmaskill', 'crs', 'tbermea', 'majaurrieta', 'towelieee', 'aw38', 'bleethat', 'blake', 'bawagsk', 'bdsalas', 'garyhou', 'sarutd', 'acarus', 'mtandon', 'kosorji', 'dscassid', 'garrett3', 'manraj09', 'tjdwls0510', 'egaytan', 'yk210', 'mlucas', 'anushaborra', 'timtim1065', 'jrenos', 'eietmo', 'titusl', 'dskieu', 'jas1988', 'far1989', 'mqcastillo', 'maearley', 'alopez1', 'jflores', 'cowsgomur', 'taz67rs', 'lucyli89', 'axion6', 'iori', 'varsha16', 'john14', 'sthyan87', 'elviajero', 'allentrue', 'chain1987', 'shano2', 'scott7', 'mwdordor', 'cnguyen8', 'tamermoh', 'sumeetg', 'riteshb', 'btonner', 'cameo24', 'jmpm', 'aloha', 'bolormaa', 'evalenzuela', 'soto1231', 'jackyc11', 'melody00', 'darthandy', 'sfalmeida', 'hin41189', 'isanchez', 'cemontalvo', 'jiening', 'dexteritty', 'erodriguez', 'jacardenas4', 'jingcong', 'ealmeda']"
4,136,117,25,19,"['sandy', 'acarus', 'egaytan', 'jaruiz3', 'jdejesus', 'evalenzuela', 'soto1231', 'maearley', 'chicks', 'alopez1', 'jflores', 'rpmaskill', 'taz67rs', 'tbermea', 'cemontalvo', 'majaurrieta', 'erodriguez', 'jacardenas4', 'ealmeda']",97,"['dollyddyy', 'garyhou', 'sarutd', 'mtandon', 'lphunh', 'kosorji', 'dscassid', 'garrett3', 'manraj09', 'tjdwls0510', 'shawnm01', 'gsferrer', 'yk210', 'mlucas', 'amininio', 'leonlian007', 'anushaborra', 'timtim1065', 'jrenos', 'ashwinganesh', 'orange7', 'eietmo', 'titusl', 'nguyenhtran', 'dskieu', 'jas1988', 'kimberlyma', 'derek003', 'far1989', 'mqcastillo', 'jason04', 'leonhart', 'cowsgomur', 'alexhung', 'caumsted', 'lucyli89', 'iori', 'varsha16', 'benster0', 'john14', 'ohernandez', 'sthyan87', 'elviajero', 'allentrue', 'chain1987', 'mtnguyen', 'shano2', 'scott7', 'amekstrand', 'apazukha', 'mwdordor', 'rholyk', 'jritch', 'gssalloum', 'tomas', 'cnguyen8', 'hbkim89', 'mmaqian', 'narnaut', 'enforce', 'mncuatico', 'ebryden', 'tamermoh', 'sumeetg', 'riteshb', 'crgbys', 'btonner', 'tiffco12', 'cameo24', 'kapiado', 'jmpm', 'phyzzle', 'aacordon', 'aloha', 'bolormaa', 'karmue', 'cyboy', 'jackyc11', 'melody00', 'jameswan', 'darthandy', 'sfalmeida', 'arinb', 'hin41189', 'felixpoon', 'jscchou', 'crs', 'isanchez', 'jiening', 'dexteritty', 'towelieee', 'aw38', 'bleethat', 'blake', 'bawagsk', 'bdsalas', 'jingcong']",6,"['stella', 'iacoronado', 'mpacheco', 'valdez4', 'omachado', None]",122,"['dollyddyy', 'garyhou', 'sarutd', 'sandy', 'acarus', 'mtandon', 'lphunh', 'kosorji', 'dscassid', 'garrett3', 'manraj09', 'tjdwls0510', 'shawnm01', 'gsferrer', 'egaytan', 'yk210', 'mlucas', 'amininio', 'leonlian007', 'anushaborra', 'timtim1065', 'jrenos', 'ashwinganesh', 'orange7', 'eietmo', 'titusl', 'nguyenhtran', 'dskieu', 'jas1988', 'jdejesus', 'kimberlyma', 'derek003', 'far1989', 'mqcastillo', 'jason04', 'leonhart', 'maearley', 'alopez1', 'jflores', 'cowsgomur', 'alexhung', 'taz67rs', 'caumsted', 'lucyli89', 'iori', 'varsha16', 'benster0', 'john14', 'ohernandez', 'sthyan87', 'elviajero', 'stella', 'allentrue', 'chain1987', 'mtnguyen', 'shano2', 'scott7', 'amekstrand', 'apazukha', 'mwdordor', 'rholyk', 'jritch', 'gssalloum', 'valdez4', 'tomas', 'cnguyen8', 'hbkim89', 'mmaqian', 'narnaut', 'enforce', 'mncuatico', 'jaruiz3', 'ebryden', 'tamermoh', 'sumeetg', 'riteshb', 'crgbys', 'btonner', 'tiffco12', 'cameo24', 'kapiado', 'jmpm', 'mpacheco', 'phyzzle', 'aacordon', 'aloha', 'bolormaa', 'evalenzuela', 'soto1231', 'karmue', 'cyboy', 'jackyc11', 'chicks', 'melody00', 'jameswan', 'darthandy', 'sfalmeida', 'arinb', 'hin41189', 'omachado', None, 'felixpoon', 'jscchou', 'rpmaskill', 'iacoronado', 'crs', 'tbermea', 'majaurrieta', 'isanchez', 'cemontalvo', 'jiening', 'dexteritty', 'towelieee', 'erodriguez', 'aw38', 'jacardenas4', 'bleethat', 'blake', 'bawagsk', 'bdsalas', 'jingcong', 'ealmeda']"
4,92,117,23,1,['jmpm'],115,"['dollyddyy', 'garyhou', 'sarutd', 'sandy', 'acarus', 'mtandon', 'lphunh', 'kosorji', 'dscassid', 'garrett3', 'manraj09', 'tjdwls0510', 'shawnm01', 'gsferrer', 'egaytan', 'yk210', 'mlucas', 'amininio', 'leonlian007', 'anushaborra', 'timtim1065', 'jrenos', 'ashwinganesh', 'orange7', 'eietmo', 'titusl', 'nguyenhtran', 'dskieu', 'jas1988', 'jdejesus', 'kimberlyma', 'derek003', 'far1989', 'mqcastillo', 'jason04', 'leonhart', 'maearley', 'alopez1', 'jflores', 'cowsgomur', 'alexhung', 'taz67rs', 'caumsted', 'lucyli89', 'iori', 'varsha16', 'benster0', 'john14', 'ohernandez', 'sthyan87', 'elviajero', 'allentrue', 'chain1987', 'mtnguyen', 'shano2', 'scott7', 'amekstrand', 'apazukha', 'mwdordor', 'rholyk', 'jritch', 'gssalloum', 'tomas', 'cnguyen8', 'hbkim89', 'mmaqian', 'narnaut', 'enforce', 'mncuatico', 'jaruiz3', 'ebryden', 'tamermoh', 'sumeetg', 'riteshb', 'crgbys', 'btonner', 'tiffco12', 'cameo24', 'kapiado', 'phyzzle', 'aacordon', 'aloha', 'bolormaa', 'evalenzuela', 'soto1231', 'karmue', 'cyboy', 'jackyc11', 'chicks', 'melody00', 'jameswan', 'darthandy', 'sfalmeida', 'arinb', 'hin41189', 'felixpoon', 'jscchou', 'rpmaskill', 'crs', 'tbermea', 'majaurrieta', 'isanchez', 'cemontalvo', 'jiening', 'dexteritty', 'towelieee', 'erodriguez', 'aw38', 'jacardenas4', 'bleethat', 'blake', 'bawagsk', 'bdsalas', 'jingcong', 'ealmeda']",22,"['yuxingangzju', 'fiammengo', 'mariaana', 'stahel', 'hchhide', 'srinivasan1984', 'sreramanm', 'olyaei', 'm_maziar', 'zhiying', 'mohammad_shayeste', 'nanosolar', 'jmpm2', 'vivi6', 'aminkhan', 'tiboy', 'zhohuo', 'moeen84', 'rok1986', 'meixian82', None, 'ull124']",138,"['yuxingangzju', 'dollyddyy', 'garyhou', 'fiammengo', 'sarutd', 'sandy', 'acarus', 'mtandon', 'lphunh', 'kosorji', 'stahel', 'srinivasan1984', 'dscassid', 'garrett3', 'manraj09', 'tjdwls0510', 'shawnm01', 'gsferrer', 'olyaei', 'm_maziar', 'egaytan', 'yk210', 'mlucas', 'zhiying', 'amininio', 'leonlian007', 'anushaborra', 'mohammad_shayeste', 'timtim1065', 'jrenos', 'ashwinganesh', 'orange7', 'eietmo', 'titusl', 'vivi6', 'nguyenhtran', 'dskieu', 'jas1988', 'jdejesus', 'kimberlyma', 'derek003', 'far1989', 'mqcastillo', 'jason04', 'tiboy', 'zhohuo', 'moeen84', 'leonhart', 'maearley', 'alopez1', 'jflores', 'cowsgomur', 'alexhung', 'taz67rs', 'caumsted', 'lucyli89', 'iori', 'varsha16', 'benster0', 'john14', 'ohernandez', 'sthyan87', 'elviajero', 'allentrue', 'chain1987', 'mtnguyen', 'shano2', 'scott7', 'amekstrand', 'apazukha', 'mwdordor', 'mariaana', 'rholyk', 'jritch', 'gssalloum', 'hchhide', 'tomas', 'cnguyen8', 'sreramanm', 'hbkim89', 'mmaqian', 'narnaut', 'enforce', 'mncuatico', 'jaruiz3', 'ebryden', 'tamermoh', 'sumeetg', 'riteshb', 'crgbys', 'btonner', 'nanosolar', 'jmpm2', 'tiffco12', 'cameo24', 'kapiado', 'jmpm', 'phyzzle', 'aminkhan', 'aacordon', 'aloha', 'bolormaa', 'evalenzuela', 'soto1231', 'karmue', 'cyboy', 'jackyc11', 'chicks', 'melody00', 'rok1986', 'meixian82', 'jameswan', 'darthandy', 'sfalmeida', 'arinb', 'hin41189', None, 'felixpoon', 'jscchou', 'rpmaskill', 'crs', 'tbermea', 'majaurrieta', 'isanchez', 'cemontalvo', 'jiening', 'dexteritty', 'towelieee', 'erodriguez', 'ull124', 'aw38', 'jacardenas4', 'bleethat', 'blake', 'bawagsk', 'bdsalas', 'jingcong', 'ealmeda']"
4,139,117,19,2,"['allentrue', 'jmpm']",114,"['dollyddyy', 'garyhou', 'sarutd', 'sandy', 'acarus', 'mtandon', 'lphunh', 'kosorji', 'dscassid', 'garrett3', 'manraj09', 'tjdwls0510', 'shawnm01', 'gsferrer', 'egaytan', 'yk210', 'mlucas', 'amininio', 'leonlian007', 'anushaborra', 'timtim1065', 'jrenos', 'ashwinganesh', 'orange7', 'eietmo', 'titusl', 'nguyenhtran', 'dskieu', 'jas1988', 'jdejesus', 'kimberlyma', 'derek003', 'far1989', 'mqcastillo', 'jason04', 'leonhart', 'maearley', 'alopez1', 'jflores', 'cowsgomur', 'alexhung', 'taz67rs', 'caumsted', 'lucyli89', 'iori', 'varsha16', 'benster0', 'john14', 'ohernandez', 'sthyan87', 'elviajero', 'chain1987', 'mtnguyen', 'shano2', 'scott7', 'amekstrand', 'apazukha', 'mwdordor', 'rholyk', 'jritch', 'gssalloum', 'tomas', 'cnguyen8', 'hbkim89', 'mmaqian', 'narnaut', 'enforce', 'mncuatico', 'jaruiz3', 'ebryden', 'tamermoh', 'sumeetg', 'riteshb', 'crgbys', 'btonner', 'tiffco12', 'cameo24', 'kapiado', 'phyzzle', 'aacordon', 'aloha', 'bolormaa', 'evalenzuela', 'soto1231', 'karmue', 'cyboy', 'jackyc11', 'chicks', 'melody00', 'jameswan', 'darthandy', 'sfalmeida', 'arinb', 'hin41189', 'felixpoon', 'jscchou', 'rpmaskill', 'crs', 'tbermea', 'majaurrieta', 'isanchez', 'cemontalvo', 'jiening', 'dexteritty', 'towelieee', 'erodriguez', 'aw38', 'jacardenas4', 'bleethat', 'blake', 'bawagsk', 'bdsalas', 'jingcong', 'ealmeda']",17,"['yuxingangzju', 'zhiying', 'pankaj_kvhld', 'mikkni', 'holmeschow052310', 'emibac', 'mariaana', 'nanosolar', 'stahel', 'ull124', None, 'hchhide', 'meixian82', 'vivi6', 'exampleoma', 'littlemooncake', 'sreramanm']",133,"['yuxingangzju', 'dollyddyy', 'garyhou', 'sarutd', 'sandy', 'mikkni', 'acarus', 'mtandon', 'lphunh', 'kosorji', 'stahel', 'exampleoma', 'dscassid', 'garrett3', 'manraj09', 'tjdwls0510', 'shawnm01', 'gsferrer', 'egaytan', 'yk210', 'mlucas', 'zhiying', 'amininio', 'leonlian007', 'anushaborra', 'timtim1065', 'jrenos', 'ashwinganesh', 'orange7', 'eietmo', 'titusl', 'vivi6', 'nguyenhtran', 'dskieu', 'jas1988', 'jdejesus', 'kimberlyma', 'derek003', 'far1989', 'mqcastillo', 'pankaj_kvhld', 'jason04', 'leonhart', 'maearley', 'alopez1', 'jflores', 'cowsgomur', 'alexhung', 'taz67rs', 'caumsted', 'lucyli89', 'iori', 'varsha16', 'benster0', 'john14', 'ohernandez', 'sthyan87', 'elviajero', 'allentrue', 'chain1987', 'mtnguyen', 'shano2', 'scott7', 'amekstrand', 'apazukha', 'mwdordor', 'mariaana', 'rholyk', 'emibac', 'jritch', 'gssalloum', 'hchhide', 'tomas', 'cnguyen8', 'sreramanm', 'hbkim89', 'mmaqian', 'narnaut', 'enforce', 'mncuatico', 'jaruiz3', 'ebryden', 'tamermoh', 'sumeetg', 'riteshb', 'crgbys', 'btonner', 'nanosolar', 'tiffco12', 'cameo24', 'kapiado', 'jmpm', 'phyzzle', 'aacordon', 'aloha', 'bolormaa', 'evalenzuela', 'soto1231', 'karmue', 'cyboy', 'jackyc11', 'chicks', 'melody00', 'meixian82', 'jameswan', 'darthandy', 'sfalmeida', 'arinb', 'hin41189', 'littlemooncake', None, 'felixpoon', 'jscchou', 'rpmaskill', 'crs', 'tbermea', 'majaurrieta', 'isanchez', 'cemontalvo', 'jiening', 'dexteritty', 'towelieee', 'erodriguez', 'holmeschow052310', 'aw38', 'jacardenas4', 'ull124', 'bleethat', 'blake', 'bawagsk', 'bdsalas', 'jingcong', 'ealmeda']"
4,140,117,16,14,"['aacordon', 'rpmaskill', 'mtnguyen', 'alopez1', 'amekstrand', 'sandy', 'jrenos', 'lphunh', 'kapiado', 'tomas', 'ohernandez', 'bdsalas', 'jdejesus', 'gsferrer']",102,"['dollyddyy', 'garyhou', 'sarutd', 'acarus', 'mtandon', 'kosorji', 'dscassid', 'garrett3', 'manraj09', 'tjdwls0510', 'shawnm01', 'egaytan', 'yk210', 'mlucas', 'amininio', 'leonlian007', 'anushaborra', 'timtim1065', 'ashwinganesh', 'orange7', 'eietmo', 'titusl', 'nguyenhtran', 'dskieu', 'jas1988', 'kimberlyma', 'derek003', 'far1989', 'mqcastillo', 'jason04', 'leonhart', 'maearley', 'jflores', 'cowsgomur', 'alexhung', 'taz67rs', 'caumsted', 'lucyli89', 'iori', 'varsha16', 'benster0', 'john14', 'sthyan87', 'elviajero', 'allentrue', 'chain1987', 'shano2', 'scott7', 'apazukha', 'mwdordor', 'rholyk', 'jritch', 'gssalloum', 'cnguyen8', 'hbkim89', 'mmaqian', 'narnaut', 'enforce', 'mncuatico', 'jaruiz3', 'ebryden', 'tamermoh', 'sumeetg', 'riteshb', 'crgbys', 'btonner', 'tiffco12', 'cameo24', 'jmpm', 'phyzzle', 'aloha', 'bolormaa', 'evalenzuela', 'soto1231', 'karmue', 'cyboy', 'jackyc11', 'chicks', 'melody00', 'jameswan', 'darthandy', 'sfalmeida', 'arinb', 'hin41189', 'felixpoon', 'jscchou', 'crs', 'tbermea', 'majaurrieta', 'isanchez', 'cemontalvo', 'jiening', 'dexteritty', 'towelieee', 'erodriguez', 'aw38', 'jacardenas4', 'bleethat', 'blake', 'bawagsk', 'jingcong', 'ealmeda']",2,"[None, 'ebaytok']",118,"['dollyddyy', 'garyhou', 'sarutd', 'sandy', 'acarus', 'mtandon', 'lphunh', 'kosorji', 'dscassid', 'garrett3', 'manraj09', 'tjdwls0510', 'shawnm01', 'gsferrer', 'egaytan', 'yk210', 'mlucas', 'ebaytok', 'amininio', 'leonlian007', 'anushaborra', 'timtim1065', 'jrenos', 'ashwinganesh', 'orange7', 'eietmo', 'titusl', 'nguyenhtran', 'dskieu', 'jas1988', 'jdejesus', 'kimberlyma', 'derek003', 'far1989', 'mqcastillo', 'jason04', 'leonhart', 'maearley', 'alopez1', 'jflores', 'cowsgomur', 'alexhung', 'taz67rs', 'caumsted', 'lucyli89', 'iori', 'varsha16', 'benster0', 'john14', 'ohernandez', 'sthyan87', 'elviajero', 'allentrue', 'chain1987', 'mtnguyen', 'shano2', 'scott7', 'amekstrand', 'apazukha', 'mwdordor', 'rholyk', 'jritch', 'gssalloum', 'tomas', 'cnguyen8', 'hbkim89', 'mmaqian', 'narnaut', 'enforce', 'mncuatico', 'jaruiz3', 'ebryden', 'tamermoh', 'sumeetg', 'riteshb', 'crgbys', 'btonner', 'tiffco12', 'cameo24', 'kapiado', 'jmpm', 'phyzzle', 'aacordon', 'aloha', 'bolormaa', 'evalenzuela', 'soto1231', 'karmue', 'cyboy', 'jackyc11', 'chicks', 'melody00', 'jameswan', 'darthandy', 'sfalmeida', 'arinb', 'hin41189', None, 'felixpoon', 'jscchou', 'rpmaskill', 'crs', 'tbermea', 'majaurrieta', 'isanchez', 'cemontalvo', 'jiening', 'dexteritty', 'towelieee', 'erodriguez', 'aw38', 'jacardenas4', 'bleethat', 'blake', 'bawagsk', 'bdsalas', 'jingcong', 'ealmeda']"
4,143,117,12,10,"['mlucas', 'chain1987', 'apazukha', 'mtandon', 'orange7', 'jritch', 'benster0', 'titusl', 'darthandy', 'dscassid']",106,"['dollyddyy', 'garyhou', 'sarutd', 'sandy', 'acarus', 'lphunh', 'kosorji', 'garrett3', 'manraj09', 'tjdwls0510', 'shawnm01', 'gsferrer', 'egaytan', 'yk210', 'amininio', 'leonlian007', 'anushaborra', 'timtim1065', 'jrenos', 'ashwinganesh', 'eietmo', 'nguyenhtran', 'dskieu', 'jas1988', 'jdejesus', 'kimberlyma', 'derek003', 'far1989', 'mqcastillo', 'jason04', 'leonhart', 'maearley', 'alopez1', 'jflores', 'cowsgomur', 'alexhung', 'taz67rs', 'caumsted', 'lucyli89', 'iori', 'varsha16', 'john14', 'ohernandez', 'sthyan87', 'elviajero', 'allentrue', 'mtnguyen', 'shano2', 'scott7', 'amekstrand', 'mwdordor', 'rholyk', 'gssalloum', 'tomas', 'cnguyen8', 'hbkim89', 'mmaqian', 'narnaut', 'enforce', 'mncuatico', 'jaruiz3', 'ebryden', 'tamermoh', 'sumeetg', 'riteshb', 'crgbys', 'btonner', 'tiffco12', 'cameo24', 'kapiado', 'jmpm', 'phyzzle', 'aacordon', 'aloha', 'bolormaa', 'evalenzuela', 'soto1231', 'karmue', 'cyboy', 'jackyc11', 'chicks', 'melody00', 'jameswan', 'sfalmeida', 'arinb', 'hin41189', 'felixpoon', 'jscchou', 'rpmaskill', 'crs', 'tbermea', 'majaurrieta', 'isanchez', 'cemontalvo', 'jiening', 'dexteritty', 'towelieee', 'erodriguez', 'aw38', 'jacardenas4', 'bleethat', 'blake', 'bawagsk', 'bdsalas', 'jingcong', 'ealmeda']",2,"[None, 'yasyas']",118,"['dollyddyy', 'garyhou', 'sarutd', 'sandy', 'acarus', 'mtandon', 'lphunh', 'kosorji', 'dscassid', 'garrett3', 'manraj09', 'tjdwls0510', 'shawnm01', 'gsferrer', 'egaytan', 'yk210', 'mlucas', 'yasyas', 'amininio', 'leonlian007', 'anushaborra', 'timtim1065', 'jrenos', 'ashwinganesh', 'orange7', 'eietmo', 'titusl', 'nguyenhtran', 'dskieu', 'jas1988', 'jdejesus', 'kimberlyma', 'derek003', 'far1989', 'mqcastillo', 'jason04', 'leonhart', 'maearley', 'alopez1', 'jflores', 'cowsgomur', 'alexhung', 'taz67rs', 'caumsted', 'lucyli89', 'iori', 'varsha16', 'benster0', 'john14', 'ohernandez', 'sthyan87', 'elviajero', 'allentrue', 'chain1987', 'mtnguyen', 'shano2', 'scott7', 'amekstrand', 'apazukha', 'mwdordor', 'rholyk', 'jritch', 'gssalloum', 'tomas', 'cnguyen8', 'hbkim89', 'mmaqian', 'narnaut', 'enforce', 'mncuatico', 'jaruiz3', 'ebryden', 'tamermoh', 'sumeetg', 'riteshb', 'crgbys', 'btonner', 'tiffco12', 'cameo24', 'kapiado', 'jmpm', 'phyzzle', 'aacordon', 'aloha', 'bolormaa', 'evalenzuela', 'soto1231', 'karmue', 'cyboy', 'jackyc11', 'chicks', 'melody00', 'jameswan', 'darthandy', 'sfalmeida', 'arinb', 'hin41189', None, 'felixpoon', 'jscchou', 'rpmaskill', 'crs', 'tbermea', 'majaurrieta', 'isanchez', 'cemontalvo', 'jiening', 'dexteritty', 'towelieee', 'erodriguez', 'aw38', 'jacardenas4', 'bleethat', 'blake', 'bawagsk', 'bdsalas', 'jingcong', 'ealmeda']"
4,138,117,9,8,"['rpmaskill', 'isanchez', 'alopez1', 'sandy', 'chicks', 'ohernandez', 'bdsalas', 'jdejesus']",108,"['dollyddyy', 'garyhou', 'sarutd', 'acarus', 'mtandon', 'lphunh', 'kosorji', 'dscassid', 'garrett3', 'manraj09', 'tjdwls0510', 'shawnm01', 'gsferrer', 'egaytan', 'yk210', 'mlucas', 'amininio', 'leonlian007', 'anushaborra', 'timtim1065', 'jrenos', 'ashwinganesh', 'orange7', 'eietmo', 'titusl', 'nguyenhtran', 'dskieu', 'jas1988', 'kimberlyma', 'derek003', 'far1989', 'mqcastillo', 'jason04', 'leonhart', 'maearley', 'jflores', 'cowsgomur', 'alexhung', 'taz67rs', 'caumsted', 'lucyli89', 'iori', 'varsha16', 'benster0', 'john14', 'sthyan87', 'elviajero', 'allentrue', 'chain1987', 'mtnguyen', 'shano2', 'scott7', 'amekstrand', 'apazukha', 'mwdordor', 'rholyk', 'jritch', 'gssalloum', 'tomas', 'cnguyen8', 'hbkim89', 'mmaqian', 'narnaut', 'enforce', 'mncuatico', 'jaruiz3', 'ebryden', 'tamermoh', 'sumeetg', 'riteshb', 'crgbys', 'btonner', 'tiffco12', 'cameo24', 'kapiado', 'jmpm', 'phyzzle', 'aacordon', 'aloha', 'bolormaa', 'evalenzuela', 'soto1231', 'karmue', 'cyboy', 'jackyc11', 'melody00', 'jameswan', 'darthandy', 'sfalmeida', 'arinb', 'hin41189', 'felixpoon', 'jscchou', 'crs', 'tbermea', 'majaurrieta', 'cemontalvo', 'jiening', 'dexteritty', 'towelieee', 'erodriguez', 'aw38', 'jacardenas4', 'bleethat', 'blake', 'bawagsk', 'jingcong', 'ealmeda']",1,[None],117,"['dollyddyy', 'garyhou', 'sarutd', 'sandy', 'acarus', 'mtandon', 'lphunh', 'kosorji', 'dscassid', 'garrett3', 'manraj09', 'tjdwls0510', 'shawnm01', 'gsferrer', 'egaytan', 'yk210', 'mlucas', 'amininio', 'leonlian007', 'anushaborra', 'timtim1065', 'jrenos', 'ashwinganesh', 'orange7', 'eietmo', 'titusl', 'nguyenhtran', 'dskieu', 'jas1988', 'jdejesus', 'kimberlyma', 'derek003', 'far1989', 'mqcastillo', 'jason04', 'leonhart', 'maearley', 'alopez1', 'jflores', 'cowsgomur', 'alexhung', 'taz67rs', 'caumsted', 'lucyli89', 'iori', 'varsha16', 'benster0', 'john14', 'ohernandez', 'sthyan87', 'elviajero', 'allentrue', 'chain1987', 'mtnguyen', 'shano2', 'scott7', 'amekstrand', 'apazukha', 'mwdordor', 'rholyk', 'jritch', 'gssalloum', 'tomas', 'cnguyen8', 'hbkim89', 'mmaqian', 'narnaut', 'enforce', 'mncuatico', 'jaruiz3', 'ebryden', 'tamermoh', 'sumeetg', 'riteshb', 'crgbys', 'btonner', 'tiffco12', 'cameo24', 'kapiado', 'jmpm', 'phyzzle', 'aacordon', 'aloha', 'bolormaa', 'evalenzuela', 'soto1231', 'karmue', 'cyboy', 'jackyc11', 'chicks', 'melody00', 'jameswan', 'darthandy', 'sfalmeida', 'arinb', 'hin41189', None, 'felixpoon', 'jscchou', 'rpmaskill', 'crs', 'tbermea', 'majaurrieta', 'isanchez', 'cemontalvo', 'jiening', 'dexteritty', 'towelieee', 'erodriguez', 'aw38', 'jacardenas4', 'bleethat', 'blake', 'bawagsk', 'bdsalas', 'jingcong', 'ealmeda']"
4,141,117,6,5,"['mncuatico', 'caumsted', 'lphunh', 'nguyenhtran', 'mqcastillo']",111,"['dollyddyy', 'garyhou', 'sarutd', 'sandy', 'acarus', 'mtandon', 'kosorji', 'dscassid', 'garrett3', 'manraj09', 'tjdwls0510', 'shawnm01', 'gsferrer', 'egaytan', 'yk210', 'mlucas', 'amininio', 'leonlian007', 'anushaborra', 'timtim1065', 'jrenos', 'ashwinganesh', 'orange7', 'eietmo', 'titusl', 'dskieu', 'jas1988', 'jdejesus', 'kimberlyma', 'derek003', 'far1989', 'jason04', 'leonhart', 'maearley', 'alopez1', 'jflores', 'cowsgomur', 'alexhung', 'taz67rs', 'lucyli89', 'iori', 'varsha16', 'benster0', 'john14', 'ohernandez', 'sthyan87', 'elviajero', 'allentrue', 'chain1987', 'mtnguyen', 'shano2', 'scott7', 'amekstrand', 'apazukha', 'mwdordor', 'rholyk', 'jritch', 'gssalloum', 'tomas', 'cnguyen8', 'hbkim89', 'mmaqian', 'narnaut', 'enforce', 'jaruiz3', 'ebryden', 'tamermoh', 'sumeetg', 'riteshb', 'crgbys', 'btonner', 'tiffco12', 'cameo24', 'kapiado', 'jmpm', 'phyzzle', 'aacordon', 'aloha', 'bolormaa', 'evalenzuela', 'soto1231', 'karmue', 'cyboy', 'jackyc11', 'chicks', 'melody00', 'jameswan', 'darthandy', 'sfalmeida', 'arinb', 'hin41189', 'felixpoon', 'jscchou', 'rpmaskill', 'crs', 'tbermea', 'majaurrieta', 'isanchez', 'cemontalvo', 'jiening', 'dexteritty', 'towelieee', 'erodriguez', 'aw38', 'jacardenas4', 'bleethat', 'blake', 'bawagsk', 'bdsalas', 'jingcong', 'ealmeda']",1,[None],117,"['dollyddyy', 'garyhou', 'sarutd', 'sandy', 'acarus', 'mtandon', 'lphunh', 'kosorji', 'dscassid', 'garrett3', 'manraj09', 'tjdwls0510', 'shawnm01', 'gsferrer', 'egaytan', 'yk210', 'mlucas', 'amininio', 'leonlian007', 'anushaborra', 'timtim1065', 'jrenos', 'ashwinganesh', 'orange7', 'eietmo', 'titusl', 'nguyenhtran', 'dskieu', 'jas1988', 'jdejesus', 'kimberlyma', 'derek003', 'far1989', 'mqcastillo', 'jason04', 'leonhart', 'maearley', 'alopez1', 'jflores', 'cowsgomur', 'alexhung', 'taz67rs', 'caumsted', 'lucyli89', 'iori', 'varsha16', 'benster0', 'john14', 'ohernandez', 'sthyan87', 'elviajero', 'allentrue', 'chain1987', 'mtnguyen', 'shano2', 'scott7', 'amekstrand', 'apazukha', 'mwdordor', 'rholyk', 'jritch', 'gssalloum', 'tomas', 'cnguyen8', 'hbkim89', 'mmaqian', 'narnaut', 'enforce', 'mncuatico', 'jaruiz3', 'ebryden', 'tamermoh', 'sumeetg', 'riteshb', 'crgbys', 'btonner', 'tiffco12', 'cameo24', 'kapiado', 'jmpm', 'phyzzle', 'aacordon', 'aloha', 'bolormaa', 'evalenzuela', 'soto1231', 'karmue', 'cyboy', 'jackyc11', 'chicks', 'melody00', 'jameswan', 'darthandy', 'sfalmeida', 'arinb', 'hin41189', None, 'felixpoon', 'jscchou', 'rpmaskill', 'crs', 'tbermea', 'majaurrieta', 'isanchez', 'cemontalvo', 'jiening', 'dexteritty', 'towelieee', 'erodriguez', 'aw38', 'jacardenas4', 'bleethat', 'blake', 'bawagsk', 'bdsalas', 'jingcong', 'ealmeda']"
5,78,51,59,49,"['jcthomas', 'cbcooper', 'ddkelly', 'kjpatter', 'cjwagner', 'jcflanag', 'sglynn', 'nghadial', 'kccox', 'adavros', 'rmcgrail', 'cbrinton07', 'asaski', 'jjcho', 'aavincen', 'rkusuma', 'jburdesk', 'akraman', 'skunplin', 'gnave', 'wpmyers', 'kdbrown', 'zbo', 'bowensbo', 'weichang', 'li146', 'ander107', 'aecooper', 'jbeaulieu', 'sesulliv', 'winnie', 'wgeary', 'gyoways', 'behaley', 'wnaville', 'knights2715', 'gmendis', 'scschrei', 'wrucker', 'xueh', 'cgshanno', 'monsterd5', 'takinfe', 'agmarche', 'lkearney', 'acroson', 'kspano', 'jshennin', 'kfouch']",1,['schust'],10,"['zermanas', 'bharath88', 'dseely', 'psajor', 'jfbrenna', 'ssaber', 'strachan', 'bharath89', None, 'reffwang']",60,"['cbcooper', 'ddkelly', 'kjpatter', 'cjwagner', 'sglynn', 'kccox', 'adavros', 'rmcgrail', 'bharath88', 'cbrinton07', 'psajor', 'jfbrenna', 'akraman', 'rkusuma', 'skunplin', 'zbo', 'bowensbo', 'weichang', 'li146', 'reffwang', 'sesulliv', 'wgeary', 'gyoways', 'behaley', 'wnaville', 'schust', 'ssaber', 'cgshanno', 'monsterd5', 'takinfe', 'agmarche', 'lkearney', 'bharath89', 'jshennin', 'jcthomas', 'dseely', 'jcflanag', 'nghadial', 'asaski', 'jjcho', 'aavincen', 'jburdesk', 'gnave', 'kdbrown', 'zermanas', 'ander107', 'aecooper', 'jbeaulieu', 'winnie', 'knights2715', 'strachan', None, 'gmendis', 'scschrei', 'wrucker', 'xueh', 'acroson', 'kspano', 'wpmyers', 'kfouch']"
6,144,45,51,41,"['dkim2', 'heatherhelledge', 'claybrengman', 'edsmith13', 'aeng', 'laurendavis2010', 'schia', 'sflood', 'afrancescatti', 'cbarrett', 'scombs', 'awong42', 'smurcko', 'laherro', 'ecuares', 'dkargman', 'erinanncook', 'smazo', 'ckonfirst', 'clau', 'jsainte', '8u9i0o', 'bclegg56', 'mkamradt1', 'tlw893', 'mczech', 'wendyjo410', 'sthottathil', 'phue', 'nickkm7', 'smorris', 'sflorczak', 'jchertow', 'dwu417', 'jasanchez', 'evitt', 'mez377', 'raznaahmad', 'choward28', 'svillalpando', 'lauralep']",3,"['katia', 'virusctm', 'trp786']",10,"['kbernard', 'jcagadas', 'nisha89', 'amodtimalsina', 'bferdinand', None, 'agdoutou', 'aku108', 'fka560', 'sjd345']",54,"['dkim2', 'heatherhelledge', 'claybrengman', 'nisha89', 'laurendavis2010', 'schia', 'smurcko', 'laherro', 'katia', 'erinanncook', 'smazo', 'ckonfirst', 'jsainte', 'bclegg56', 'bferdinand', 'tlw893', 'mczech', 'wendyjo410', 'sthottathil', 'nickkm7', 'smorris', 'sflorczak', 'dwu417', 'trp786', 'jasanchez', 'evitt', 'kbernard', 'jcagadas', 'fka560', 'choward28', 'svillalpando', 'sjd345', 'lauralep', 'edsmith13', 'aeng', 'sflood', 'afrancescatti', 'cbarrett', 'scombs', 'awong42', 'ecuares', 'dkargman', 'clau', 'agdoutou', '8u9i0o', 'mkamradt1', 'phue', 'jchertow', None, 'mez377', 'amodtimalsina', 'raznaahmad', 'aku108', 'virusctm']"
6,106,45,45,42,"['dkim2', 'heatherhelledge', 'claybrengman', 'edsmith13', 'aeng', 'laurendavis2010', 'schia', 'sflood', 'afrancescatti', 'cbarrett', 'scombs', 'awong42', 'smurcko', 'laherro', 'ecuares', 'katia', 'dkargman', 'erinanncook', 'smazo', 'ckonfirst', 'clau', 'jsainte', '8u9i0o', 'bclegg56', 'mkamradt1', 'tlw893', 'mczech', 'sthottathil', 'nickkm7', 'smorris', 'sflorczak', 'jchertow', 'dwu417', 'trp786', 'jasanchez', 'choward28', 'evitt', 'mez377', 'raznaahmad', 'virusctm', 'svillalpando', 'lauralep']",2,"['phue', 'wendyjo410']",3,"['pstrybel', None, 'amunre']",47,"['dkim2', 'heatherhelledge', 'amunre', 'claybrengman', 'laurendavis2010', 'schia', 'smurcko', 'laherro', 'katia', 'erinanncook', 'smazo', 'ckonfirst', 'jsainte', 'bclegg56', 'tlw893', 'mczech', 'wendyjo410', 'pstrybel', 'sthottathil', 'nickkm7', 'smorris', 'sflorczak', 'dwu417', 'trp786', 'jasanchez', 'evitt', 'choward28', 'svillalpando', 'lauralep', 'edsmith13', 'aeng', 'sflood', 'afrancescatti', 'cbarrett', 'scombs', 'awong42', 'ecuares', 'dkargman', 'clau', '8u9i0o', 'mkamradt1', 'phue', 'jchertow', None, 'mez377', 'raznaahmad', 'virusctm']"
6,45,45,31,29,"['dkim2', 'edsmith13', 'laurendavis2010', 'schia', 'aeng', 'sflood', 'cbarrett', 'scombs', 'ecuares', 'dkargman', 'laherro', 'erinanncook', 'smazo', 'ckonfirst', 'clau', 'jsainte', '8u9i0o', 'bclegg56', 'tlw893', 'mczech', 'wendyjo410', 'sthottathil', 'nickkm7', 'jchertow', 'dwu417', 'jasanchez', 'raznaahmad', 'choward28', 'lauralep']",15,"['trp786', 'afrancescatti', 'awong42', 'heatherhelledge', 'smurcko', 'claybrengman', 'evitt', 'katia', 'mez377', 'phue', 'sflorczak', 'mkamradt1', 'smorris', 'virusctm', 'svillalpando']",2,"['ekourakos', None]",46,"['dkim2', 'heatherhelledge', 'claybrengman', 'virusctm', 'edsmith13', 'aeng', 'laurendavis2010', 'schia', 'sflood', 'afrancescatti', 'cbarrett', 'scombs', 'awong42', 'smurcko', 'laherro', 'ecuares', 'katia', 'dkargman', 'erinanncook', 'smazo', 'ckonfirst', 'clau', 'jsainte', '8u9i0o', 'bclegg56', 'mkamradt1', 'tlw893', 'mczech', 'wendyjo410', 'sthottathil', 'phue', 'nickkm7', 'smorris', 'sflorczak', 'jchertow', None, 'dwu417', 'trp786', 'jasanchez', 'evitt', 'mez377', 'ekourakos', 'raznaahmad', 'choward28', 'svillalpando', 'lauralep']"
7,93,37,26,22,"['javiercastillo', 'eleggo', 'melody1007', 'mattdit9', 'cnunezc', 'ybai', 'eriosc2', 'pavanjasti', 'xt3rmin8', 'jsanchezy23', 'drodriguezz4', 'linaalvarez', 'harlingenkid06', 'aaviles25', 'relizondozy', 'rriosz18', 'arod923', 'kumadbindu', 'swathipriya', 'agarciagr', 'ssingam', 'arloedx']",14,"['dokkaebij', 'iquintanilz1', 'mheraldz', 'indigoclay', 'csexton', 'leewoonzae', 'rok75', 'jatorres', 'a06tb011', 'jmpm2', 'jatorres4', 'tamalika123', 'eloyolivo', 'carlos00']",4,"['isamini', 'hhuq', None, 'faraon956']",40,"['javiercastillo', 'eleggo', 'faraon956', 'melody1007', 'mattdit9', 'a06tb011', 'cnunezc', 'hhuq', 'tamalika123', 'ybai', 'eriosc2', 'pavanjasti', 'carlos00', 'iquintanilz1', 'indigoclay', 'rok75', 'xt3rmin8', 'jmpm2', 'jsanchezy23', 'drodriguezz4', 'dokkaebij', 'linaalvarez', 'isamini', 'harlingenkid06', 'mheraldz', 'leewoonzae', 'eloyolivo', 'aaviles25', 'relizondozy', None, 'rriosz18', 'arod923', 'csexton', 'kumadbindu', 'swathipriya', 'jatorres4', 'jatorres', 'agarciagr', 'ssingam', 'arloedx']"
7,92,37,23,1,['jmpm2'],35,"['javiercastillo', 'eleggo', 'melody1007', 'mattdit9', 'a06tb011', 'cnunezc', 'tamalika123', 'ybai', 'eriosc2', 'carlos00', 'pavanjasti', 'iquintanilz1', 'indigoclay', 'rok75', 'xt3rmin8', 'jsanchezy23', 'drodriguezz4', 'dokkaebij', 'linaalvarez', 'harlingenkid06', 'mheraldz', 'leewoonzae', 'eloyolivo', 'aaviles25', 'relizondozy', 'rriosz18', 'arod923', 'csexton', 'kumadbindu', 'swathipriya', 'jatorres4', 'jatorres', 'agarciagr', 'ssingam', 'arloedx']",22,"['yuxingangzju', 'fiammengo', 'mariaana', 'stahel', 'hchhide', 'srinivasan1984', 'sreramanm', 'olyaei', 'm_maziar', 'zhiying', 'mohammad_shayeste', 'nanosolar', 'jmpm', 'vivi6', 'aminkhan', 'tiboy', 'zhohuo', 'moeen84', 'rok1986', 'meixian82', None, 'ull124']",58,"['yuxingangzju', 'javiercastillo', 'eleggo', 'fiammengo', 'melody1007', 'mariaana', 'mattdit9', 'a06tb011', 'cnunezc', 'stahel', 'tamalika123', 'ybai', 'hchhide', 'eriosc2', 'srinivasan1984', 'pavanjasti', 'carlos00', 'sreramanm', 'olyaei', 'm_maziar', 'zhiying', 'iquintanilz1', 'indigoclay', 'mohammad_shayeste', 'rok75', 'xt3rmin8', 'nanosolar', 'jmpm2', 'jmpm', 'vivi6', 'aminkhan', 'jsanchezy23', 'drodriguezz4', 'dokkaebij', 'linaalvarez', 'tiboy', 'harlingenkid06', 'zhohuo', 'mheraldz', 'moeen84', 'leewoonzae', 'rok1986', 'meixian82', 'eloyolivo', 'aaviles25', 'relizondozy', None, 'rriosz18', 'arod923', 'csexton', 'ull124', 'kumadbindu', 'swathipriya', 'jatorres4', 'jatorres', 'agarciagr', 'ssingam', 'arloedx']"
8,121,36,37,28,"['eauchy', 'mmatda1976', 'kiridode', 'anhr_nti', 'hattem', 'amr_elmasry', 'ahmed_3anter', 'mmoftah', 'marwa', 'mhussein', 'moro', 'anhrnti', 'shereef_23', 'abdulaleem', 'h_maksoud', 'amr_elzidy', 'hanoy73', 'm_fouly', 'ahmd_sadk', 'zema_gouchy', 'fayezelsisy', 'kymera', 'mmoftah0602', 'manar', 'shadygamel', 'aymanmahgoub', 'basma_sha3lan', 'ahmed_elabyad']",7,"['aryawww', 'negm', 'essam_samir', 'togauravsaxena', 'morgan_3', 'eng_hoda', 'salehov']",9,"['zoweil', 'heba_sadek', 'amrzahir', 'ahmedgad2007', 'just4mido', 'serag', 'moataz', None, 'abdulaziz80']",44,"['negm', 'eauchy', 'mmatda1976', 'kiridode', 'anhr_nti', 'hattem', 'amr_elmasry', 'ahmed_3anter', 'eng_hoda', 'ahmedgad2007', 'mmoftah', 'marwa', 'zoweil', 'mhussein', 'amrzahir', 'moro', 'anhrnti', 'morgan_3', 'shereef_23', 'just4mido', 'abdulaleem', 'serag', 'abdulaziz80', 'h_maksoud', 'aryawww', 'amr_elzidy', 'hanoy73', 'essam_samir', 'm_fouly', 'ahmd_sadk', 'togauravsaxena', 'zema_gouchy', 'fayezelsisy', 'kymera', 'salehov', 'mmoftah0602', 'manar', None, 'heba_sadek', 'shadygamel', 'aymanmahgoub', 'moataz', 'basma_sha3lan', 'ahmed_elabyad']"
9,131,31,33,22,"['omerfaruk', 'ufukyaman', 'citoglu', 'mhmtmtl', 'hfirat86', 'basakd', 'ardaonder', 'bugrabalaban', 'kurch', 'utkuse', 'mtzng', 'yalcine', 'inanc', 'ergin', 'denizceliktas', 'gulesn', 'feze', 'ahmetoz', 'm_aras', 'prankieee', 'chinar', 'shoke']",8,"['erdi', 'snbelenli', 'orkunarican', 'torabora', 'bozbey00', 'aysegul', 'alper', 'kmgzn']",11,"['ardak8', 'gorgon', 'm_peker', 'karabeyli', 'oaktas', 'buraksener', 'burakbaskin', 'asli_esin', None, 'sivas', 'hsumer']",41,"['omerfaruk', 'ufukyaman', 'ardak8', 'citoglu', 'mhmtmtl', 'bozbey00', 'burakbaskin', 'hfirat86', 'aysegul', 'snbelenli', 'basakd', 'orkunarican', 'ardaonder', 'torabora', 'bugrabalaban', 'kurch', 'utkuse', 'sivas', 'alper', 'erdi', 'mtzng', 'gorgon', 'yalcine', 'inanc', 'oaktas', 'buraksener', 'asli_esin', 'ergin', None, 'kmgzn', 'denizceliktas', 'hsumer', 'gulesn', 'feze', 'ahmetoz', 'm_peker', 'karabeyli', 'm_aras', 'prankieee', 'chinar', 'shoke']"
9,164,31,32,21,"['omerfaruk', 'ufukyaman', 'citoglu', 'mhmtmtl', 'bozbey00', 'hfirat86', 'basakd', 'ardaonder', 'bugrabalaban', 'kurch', 'utkuse', 'mtzng', 'yalcine', 'inanc', 'gulesn', 'feze', 'ahmetoz', 'm_aras', 'prankieee', 'chinar', 'shoke']",9,"['erdi', 'denizceliktas', 'snbelenli', 'orkunarican', 'torabora', 'aysegul', 'ergin', 'alper', 'kmgzn']",11,"['ardak8', 'gorgon', 'm_peker', 'karabeyli', 'oaktas', 'oguzhanatak', 'buraksener', None, 'asli_esin', 'mertm', 'hsumer']",41,"['omerfaruk', 'ufukyaman', 'ardak8', 'citoglu', 'mhmtmtl', 'oguzhanatak', 'bozbey00', 'hfirat86', 'aysegul', 'mertm', 'snbelenli', 'basakd', 'orkunarican', 'ardaonder', 'torabora', 'bugrabalaban', 'kurch', 'utkuse', 'alper', 'erdi', 'mtzng', 'gorgon', 'yalcine', 'inanc', 'oaktas', 'buraksener', 'asli_esin', 'ergin', None, 'kmgzn', 'denizceliktas', 'hsumer', 'gulesn', 'feze', 'ahmetoz', 'm_peker', 'karabeyli', 'm_aras', 'prankieee', 'chinar', 'shoke']"
9,85,31,30,18,"['omerfaruk', 'ufukyaman', 'basakd', 'mtzng', 'feze', 'gulesn', 'ahmetoz', 'citoglu', 'yalcine', 'bugrabalaban', 'inanc', 'mhmtmtl', 'm_aras', 'chinar', 'bozbey00', 'kurch', 'utkuse', 'shoke']",12,"['erdi', 'denizceliktas', 'snbelenli', 'ardaonder', 'orkunarican', 'torabora', 'prankieee', 'hfirat86', 'aysegul', 'ergin', 'alper', 'kmgzn']",12,"['ardak8', 'tostostos', 'hasipekserhat', 'hakancu01', 'oaktas', 'irmakcomert', 'xilmarillon', 'fevzi', 'cagripeker2', None, 'erdem', 'hsumer']",42,"['omerfaruk', 'ufukyaman', 'ardak8', 'citoglu', 'mhmtmtl', 'hakancu01', 'bozbey00', 'irmakcomert', 'hfirat86', 'aysegul', 'snbelenli', 'basakd', 'orkunarican', 'ardaonder', 'torabora', 'bugrabalaban', 'hasipekserhat', 'kurch', 'utkuse', 'alper', 'erdi', 'mtzng', 'yalcine', 'inanc', 'oaktas', 'xilmarillon', 'fevzi', 'ergin', None, 'kmgzn', 'denizceliktas', 'hsumer', 'gulesn', 'feze', 'ahmetoz', 'tostostos', 'm_aras', 'prankieee', 'chinar', 'cagripeker2', 'erdem', 'shoke']"
9,165,31,13,7,"['omerfaruk', 'erdi', 'torabora', 'chinar', 'bozbey00', 'aysegul', 'kmgzn']",23,"['ufukyaman', 'citoglu', 'mhmtmtl', 'hfirat86', 'snbelenli', 'basakd', 'orkunarican', 'ardaonder', 'bugrabalaban', 'kurch', 'utkuse', 'alper', 'mtzng', 'yalcine', 'inanc', 'ergin', 'denizceliktas', 'gulesn', 'feze', 'ahmetoz', 'm_aras', 'prankieee', 'shoke']",6,"['ardak8', 'terd', 'hakancu01', 'xilmarillon', 'tostos87', None]",36,"['omerfaruk', 'ufukyaman', 'ardak8', 'citoglu', 'mhmtmtl', 'hakancu01', 'bozbey00', 'hfirat86', 'aysegul', 'snbelenli', 'basakd', 'orkunarican', 'ardaonder', 'torabora', 'bugrabalaban', 'terd', 'kurch', 'utkuse', 'tostos87', 'alper', 'erdi', 'mtzng', 'yalcine', 'inanc', 'xilmarillon', 'ergin', None, 'kmgzn', 'denizceliktas', 'gulesn', 'feze', 'ahmetoz', 'm_aras', 'prankieee', 'chinar', 'shoke']"
9,86,31,12,8,"['omerfaruk', 'erdi', 'snbelenli', 'citoglu', 'prankieee', 'aysegul', 'ergin', 'kmgzn']",22,"['ufukyaman', 'mhmtmtl', 'bozbey00', 'hfirat86', 'basakd', 'ardaonder', 'orkunarican', 'torabora', 'bugrabalaban', 'kurch', 'utkuse', 'alper', 'mtzng', 'yalcine', 'inanc', 'denizceliktas', 'gulesn', 'feze', 'ahmetoz', 'm_aras', 'chinar', 'shoke']",4,"[None, 'hakancu01', 'esin', 'hsumer']",34,"['omerfaruk', 'ufukyaman', 'citoglu', 'mhmtmtl', 'hakancu01', 'bozbey00', 'esin', 'hfirat86', 'aysegul', 'snbelenli', 'basakd', 'orkunarican', 'ardaonder', 'torabora', 'bugrabalaban', 'kurch', 'utkuse', 'alper', 'erdi', 'mtzng', 'yalcine', 'inanc', 'ergin', None, 'kmgzn', 'denizceliktas', 'hsumer', 'gulesn', 'feze', 'ahmetoz', 'm_aras', 'prankieee', 'chinar', 'shoke']"
9,128,31,12,7,"['denizceliktas', 'ufukyaman', 'feze', 'mtzng', 'ahmetoz', 'bugrabalaban', 'kurch']",23,"['omerfaruk', 'citoglu', 'mhmtmtl', 'bozbey00', 'hfirat86', 'aysegul', 'snbelenli', 'basakd', 'orkunarican', 'ardaonder', 'torabora', 'utkuse', 'alper', 'erdi', 'yalcine', 'inanc', 'ergin', 'kmgzn', 'gulesn', 'm_aras', 'prankieee', 'chinar', 'shoke']",5,"['karabeyli', 'oaktas', 'bilican', None, 'hsumer']",35,"['omerfaruk', 'ufukyaman', 'citoglu', 'mhmtmtl', 'bozbey00', 'hfirat86', 'aysegul', 'bilican', 'snbelenli', 'basakd', 'orkunarican', 'ardaonder', 'torabora', 'bugrabalaban', 'kurch', 'utkuse', 'alper', 'erdi', 'mtzng', 'yalcine', 'inanc', 'oaktas', 'ergin', None, 'kmgzn', 'denizceliktas', 'hsumer', 'gulesn', 'feze', 'ahmetoz', 'karabeyli', 'm_aras', 'prankieee', 'chinar', 'shoke']"
9,133,31,9,5,"['erdi', 'chinar', 'bozbey00', 'aysegul', 'kmgzn']",25,"['omerfaruk', 'ufukyaman', 'citoglu', 'mhmtmtl', 'hfirat86', 'snbelenli', 'basakd', 'orkunarican', 'ardaonder', 'torabora', 'bugrabalaban', 'kurch', 'utkuse', 'alper', 'mtzng', 'yalcine', 'inanc', 'ergin', 'denizceliktas', 'gulesn', 'feze', 'ahmetoz', 'm_aras', 'prankieee', 'shoke']",4,"['ardak8', None, 'hakancu01', 'tostos87']",34,"['omerfaruk', 'ufukyaman', 'ardak8', 'citoglu', 'mhmtmtl', 'hakancu01', 'bozbey00', 'hfirat86', 'aysegul', 'snbelenli', 'basakd', 'orkunarican', 'ardaonder', 'torabora', 'bugrabalaban', 'kurch', 'utkuse', 'tostos87', 'alper', 'erdi', 'mtzng', 'yalcine', 'inanc', 'ergin', None, 'kmgzn', 'denizceliktas', 'gulesn', 'feze', 'ahmetoz', 'm_aras', 'prankieee', 'chinar', 'shoke']"
9,127,31,7,4,"['erdi', 'aysegul', 'hfirat86', 'chinar']",26,"['omerfaruk', 'ufukyaman', 'citoglu', 'mhmtmtl', 'bozbey00', 'snbelenli', 'basakd', 'orkunarican', 'ardaonder', 'torabora', 'bugrabalaban', 'kurch', 'utkuse', 'alper', 'mtzng', 'yalcine', 'inanc', 'ergin', 'kmgzn', 'denizceliktas', 'gulesn', 'feze', 'ahmetoz', 'm_aras', 'prankieee', 'shoke']",3,"['xilmarillon', None, 'hakancu01']",33,"['omerfaruk', 'ufukyaman', 'erdi', 'mtzng', 'citoglu', 'yalcine', 'inanc', 'mhmtmtl', 'hakancu01', 'bozbey00', 'xilmarillon', 'hfirat86', 'aysegul', 'ergin', None, 'kmgzn', 'denizceliktas', 'snbelenli', 'basakd', 'orkunarican', 'ardaonder', 'torabora', 'gulesn', 'feze', 'ahmetoz', 'bugrabalaban', 'm_aras', 'prankieee', 'chinar', 'kurch', 'utkuse', 'shoke', 'alper']"
10,63,22,15,13,"['yumingliu', 'bigmadde06', 'jweaver', 'qpho', 'egasencalada', 'drmercado', 'eakosalka', 'wfarah', 'jmendoza', 'hotingliu', 'jaetcheverry', 'nwjohnson', 'jasonr']",8,"['eapolinario', 'zshishkoyan', 'mepinto', 'mzalam', 'lancelopez', 'sjtolan', 'nkyirga', 'jsleblanc']",2,"[None, 'faltens']",23,"['jweaver', 'bigmadde06', 'egasencalada', 'drmercado', 'eakosalka', 'mepinto', 'lancelopez', 'nwjohnson', 'sjtolan', 'hotingliu', 'wfarah', None, 'yumingliu', 'qpho', 'eapolinario', 'zshishkoyan', 'jmendoza', 'mzalam', 'jaetcheverry', 'nkyirga', 'jasonr', 'jsleblanc', 'faltens']"
10,64,22,8,7,"['eapolinario', 'mepinto', 'mzalam', 'lancelopez', 'nkyirga', 'jasonr', 'jsleblanc']",14,"['yumingliu', 'jweaver', 'qpho', 'bigmadde06', 'egasencalada', 'drmercado', 'eakosalka', 'zshishkoyan', 'wfarah', 'jmendoza', 'jaetcheverry', 'nwjohnson', 'hotingliu', 'sjtolan']",1,[None],22,"['jweaver', 'bigmadde06', 'egasencalada', 'drmercado', 'eakosalka', 'mepinto', 'lancelopez', 'nwjohnson', 'sjtolan', 'hotingliu', 'wfarah', None, 'yumingliu', 'qpho', 'eapolinario', 'zshishkoyan', 'jmendoza', 'mzalam', 'jaetcheverry', 'nkyirga', 'jasonr', 'jsleblanc']"
11,78,21,59,1,['zermanas'],19,"['jwilli12', 'inex04', 'ticalone', 'ccluhrs', 'mooner', 'mcraw', 'askachen369', 'meem', 'cbanh', 'smilanos', 'jbyrne1', 'wilsonn', 'timaroo', 'cbolton', 'nlanders', 'trevino3', 'benrael', 'e0311371', 'portamigra']",58,"['jcthomas', 'ddkelly', 'cbcooper', 'dseely', 'kjpatter', 'cjwagner', 'jcflanag', 'acroson', 'kspano', 'nghadial', 'sglynn', 'adavros', 'kccox', 'rmcgrail', 'bharath88', 'cbrinton07', 'psajor', 'jjcho', 'asaski', 'jfbrenna', 'akraman', 'rkusuma', 'jburdesk', 'aavincen', 'gnave', 'kdbrown', 'zbo', 'bowensbo', 'weichang', 'li146', 'reffwang', 'ander107', 'aecooper', 'sesulliv', 'jbeaulieu', 'winnie', 'wgeary', 'gyoways', 'behaley', 'knights2715', 'strachan', 'wnaville', 'jshennin', None, 'ssaber', 'gmendis', 'scschrei', 'wrucker', 'xueh', 'monsterd5', 'cgshanno', 'takinfe', 'agmarche', 'lkearney', 'skunplin', 'bharath89', 'wpmyers', 'kfouch']",78,"['ddkelly', 'cbcooper', 'jwilli12', 'kjpatter', 'cjwagner', 'sglynn', 'adavros', 'kccox', 'mcraw', 'rmcgrail', 'askachen369', 'bharath88', 'cbrinton07', 'psajor', 'jfbrenna', 'cbanh', 'smilanos', 'akraman', 'rkusuma', 'zbo', 'bowensbo', 'weichang', 'li146', 'reffwang', 'jbyrne1', 'wilsonn', 'timaroo', 'sesulliv', 'wgeary', 'cbolton', 'gyoways', 'behaley', 'wnaville', 'ssaber', 'monsterd5', 'cgshanno', 'e0311371', 'takinfe', 'agmarche', 'lkearney', 'bharath89', 'jshennin', 'portamigra', 'jcthomas', 'dseely', 'jcflanag', 'inex04', 'acroson', 'ticalone', 'nghadial', 'ccluhrs', 'mooner', 'meem', 'jjcho', 'asaski', 'aavincen', 'jburdesk', 'gnave', 'kdbrown', 'zermanas', 'ander107', 'aecooper', 'jbeaulieu', 'winnie', 'knights2715', 'strachan', None, 'nlanders', 'gmendis', 'trevino3', 'scschrei', 'wrucker', 'xueh', 'benrael', 'skunplin', 'kspano', 'wpmyers', 'kfouch']"
11,14,21,20,4,"['smilanos', 'zermanas', 'wilsonn', 'askachen369']",16,"['jbyrne1', 'trevino3', 'jwilli12', 'timaroo', 'meem', 'benrael', 'inex04', 'cbanh', 'ticalone', 'e0311371', 'ccluhrs', 'cbolton', 'mooner', 'mcraw', 'portamigra', 'nlanders']",16,"['bharath88', 'dseely', 'okeles', 'dannyguo', 'psajor', 'kcunzema', 'liveletlive', 'jfbrenna', 'gbechtol', 'rvedula', 'linkenghua', 'rpithadi', 'strachan', 'bharath89', None, 'ssaber']",36,"['jwilli12', 'dseely', 'inex04', 'liveletlive', 'ticalone', 'ccluhrs', 'mooner', 'mcraw', 'askachen369', 'bharath88', 'meem', 'dannyguo', 'psajor', 'kcunzema', 'jfbrenna', 'cbanh', 'smilanos', 'rpithadi', 'jbyrne1', 'zermanas', 'wilsonn', 'timaroo', 'okeles', 'gbechtol', 'cbolton', 'strachan', None, 'nlanders', 'ssaber', 'trevino3', 'benrael', 'e0311371', 'linkenghua', 'bharath89', 'portamigra', 'rvedula']"
11,77,21,12,11,"['jwilli12', 'timaroo', 'benrael', 'inex04', 'e0311371', 'ticalone', 'cbanh', 'cbolton', 'ccluhrs', 'mcraw', 'portamigra']",9,"['jbyrne1', 'trevino3', 'zermanas', 'wilsonn', 'meem', 'smilanos', 'mooner', 'nlanders', 'askachen369']",1,[None],21,"['jbyrne1', 'zermanas', 'jwilli12', 'wilsonn', 'timaroo', 'inex04', 'ticalone', 'cbolton', 'ccluhrs', 'mooner', 'mcraw', None, 'nlanders', 'askachen369', 'trevino3', 'meem', 'benrael', 'cbanh', 'smilanos', 'e0311371', 'portamigra']"
11,76,21,9,4,"['zermanas', 'wilsonn', 'smilanos', 'askachen369']",16,"['jbyrne1', 'trevino3', 'jwilli12', 'timaroo', 'meem', 'benrael', 'inex04', 'cbanh', 'ticalone', 'e0311371', 'ccluhrs', 'cbolton', 'mooner', 'mcraw', 'portamigra', 'nlanders']",5,"['kcunzema', 'liveletlive', 'jfbrenna', None, 'ssaber']",25,"['jbyrne1', 'zermanas', 'jwilli12', 'wilsonn', 'timaroo', 'inex04', 'liveletlive', 'ticalone', 'cbolton', 'ccluhrs', 'mooner', 'mcraw', None, 'nlanders', 'askachen369', 'ssaber', 'trevino3', 'meem', 'benrael', 'kcunzema', 'jfbrenna', 'cbanh', 'smilanos', 'e0311371', 'portamigra']"
11,38,21,6,1,['wilsonn'],19,"['jwilli12', 'inex04', 'ticalone', 'ccluhrs', 'mooner', 'mcraw', 'askachen369', 'meem', 'cbanh', 'smilanos', 'jbyrne1', 'zermanas', 'timaroo', 'cbolton', 'nlanders', 'trevino3', 'benrael', 'e0311371', 'portamigra']",5,"['elec1020', 'liveletlive', 'iwto2000', 'rpithadi', None]",25,"['jbyrne1', 'zermanas', 'jwilli12', 'wilsonn', 'timaroo', 'inex04', 'liveletlive', 'ticalone', 'cbolton', 'ccluhrs', 'mooner', 'mcraw', None, 'nlanders', 'askachen369', 'trevino3', 'elec1020', 'meem', 'benrael', 'cbanh', 'smilanos', 'e0311371', 'iwto2000', 'rpithadi', 'portamigra']"
12,163,21,50,18,"['manakaw', 'hirawan', 'petey27', 'panren2006', 'tkazokas', 'wtowens', 'eenginerd', 'afrierso', 'pasera', 'kbyun', 'mhlebask', 'ratanrego', 'cbean', 'weim', 'abishmalik', 'arthurfacon', 'purukhandue', 'mconaboy']",2,"['vgokhale', 'ejasinsk']",32,"['chen145', 'pjcannon', 'jamescui', 'ajfunche', 'john3636', 'choi1', 'deguzouw', 'jackfrost9p', 'zhang205', 'rpithadi', 'jainrajat11', 'yangliqun', 'khuh', 'kmmaurer', 'kylerupp87', 'dwilkes', 'vqnguyen', 'dtracy', 'kmsj2', 'pandey', 'aaronmudd', 'obernada', None, 'greenpurdue', 'vahuja', 'taliaho', 'pxu', 'zhang118', 'lee251', 'mazad', 'thartman', 'tdougan']",52,"['chen145', 'pjcannon', 'john3636', 'afrierso', 'jackfrost9p', 'cbean', 'zhang205', 'rpithadi', 'yangliqun', 'jainrajat11', 'kmmaurer', 'wtowens', 'dwilkes', 'weim', 'obernada', 'greenpurdue', 'vahuja', 'zhang118', 'lee251', 'abishmalik', 'manakaw', 'hirawan', 'vgokhale', 'eenginerd', 'ejasinsk', 'arthurfacon', 'purukhandue', 'mconaboy', 'jamescui', 'ajfunche', 'petey27', 'choi1', 'deguzouw', 'khuh', 'mhlebask', 'kylerupp87', 'panren2006', 'tkazokas', 'ratanrego', 'vqnguyen', 'dtracy', 'kmsj2', 'pandey', 'aaronmudd', None, 'pasera', 'taliaho', 'pxu', 'mazad', 'thartman', 'kbyun', 'tdougan']"
12,3,21,38,18,"['manakaw', 'hirawan', 'petey27', 'panren2006', 'tkazokas', 'wtowens', 'vgokhale', 'eenginerd', 'afrierso', 'pasera', 'kbyun', 'ratanrego', 'cbean', 'weim', 'abishmalik', 'arthurfacon', 'purukhandue', 'mconaboy']",2,"['mhlebask', 'ejasinsk']",20,"['jakho', 'kbaciaus', 'mshen', 'john3636', 'wlpierret', 'janam', 'choi1', 'deguzouw', 'tgregg', 'rpithadi', 'chen272', 'wapayne', 'dwilkes', 'dtracy', 'mhmalik', 'aaronmudd', None, 'rallyemenz', 'monil2912', 'naman']",40,"['manakaw', 'hirawan', 'vgokhale', 'eenginerd', 'jakho', 'ejasinsk', 'arthurfacon', 'purukhandue', 'mconaboy', 'kbaciaus', 'petey27', 'mshen', 'john3636', 'wlpierret', 'janam', 'afrierso', 'choi1', 'deguzouw', 'cbean', 'tgregg', 'rpithadi', 'chen272', 'wapayne', 'mhlebask', 'panren2006', 'tkazokas', 'wtowens', 'ratanrego', 'dwilkes', 'weim', 'dtracy', 'mhmalik', 'aaronmudd', 'rallyemenz', None, 'pasera', 'monil2912', 'naman', 'abishmalik', 'kbyun']"
12,62,21,28,3,"['manakaw', 'eenginerd', 'arthurfacon']",17,"['hirawan', 'petey27', 'panren2006', 'tkazokas', 'wtowens', 'vgokhale', 'afrierso', 'pasera', 'mhlebask', 'ejasinsk', 'ratanrego', 'cbean', 'weim', 'abishmalik', 'kbyun', 'purukhandue', 'mconaboy']",25,"['chen145', 'bcorbett', 'mwkhan', 'pjcannon', 'ajfunche', 'wlpierret', 'jackfrost9p', 'zhang205', 'dandry', 'jainrajat11', 'dwilkes', 'vqnguyen', 'dtracy', 'kmsj2', 'pandey', 'luyichen', None, 'taliaho', 'pxu', 'zhang118', 'lee251', 'thartman', 'yang28', 'shin29', 'tdougan']",45,"['manakaw', 'hirawan', 'chen145', 'mwkhan', 'bcorbett', 'vgokhale', 'eenginerd', 'pjcannon', 'ejasinsk', 'arthurfacon', 'purukhandue', 'mconaboy', 'ajfunche', 'petey27', 'wlpierret', 'afrierso', 'jackfrost9p', 'cbean', 'zhang205', 'jainrajat11', 'dandry', 'mhlebask', 'panren2006', 'tkazokas', 'wtowens', 'ratanrego', 'dwilkes', 'vqnguyen', 'weim', 'dtracy', 'kmsj2', 'pandey', 'luyichen', None, 'pasera', 'taliaho', 'pxu', 'zhang118', 'lee251', 'thartman', 'abishmalik', 'yang28', 'shin29', 'kbyun', 'tdougan']"
12,130,21,22,5,"['manakaw', 'hirawan', 'eenginerd', 'pasera', 'arthurfacon']",15,"['petey27', 'panren2006', 'tkazokas', 'wtowens', 'vgokhale', 'afrierso', 'mhlebask', 'ejasinsk', 'ratanrego', 'cbean', 'weim', 'abishmalik', 'kbyun', 'purukhandue', 'mconaboy']",17,"['greenpurdue', 'chen145', 'kylerupp87', 'mbrigham', 'pjcannon', 'rallyemenz', 'jackfrost9p', 'zhang118', 'vqnguyen', 'thartman', 'dtracy', 'luyichen', 'jainrajat11', 'obernada', None, 'tdougan', 'ajfunche']",37,"['manakaw', 'hirawan', 'chen145', 'mbrigham', 'vgokhale', 'eenginerd', 'pjcannon', 'ejasinsk', 'arthurfacon', 'purukhandue', 'mconaboy', 'ajfunche', 'petey27', 'afrierso', 'jackfrost9p', 'cbean', 'jainrajat11', 'mhlebask', 'kylerupp87', 'panren2006', 'tkazokas', 'wtowens', 'ratanrego', 'vqnguyen', 'weim', 'dtracy', 'luyichen', 'obernada', None, 'rallyemenz', 'greenpurdue', 'pasera', 'zhang118', 'thartman', 'abishmalik', 'kbyun', 'tdougan']"
12,129,21,16,4,"['petey27', 'kbyun', 'panren2006', 'ratanrego']",16,"['manakaw', 'hirawan', 'tkazokas', 'wtowens', 'vgokhale', 'eenginerd', 'afrierso', 'pasera', 'mhlebask', 'ejasinsk', 'cbean', 'weim', 'abishmalik', 'arthurfacon', 'purukhandue', 'mconaboy']",12,"['kmmaurer', 'greenpurdue', 'jhaveri', 'zhang118', 'naman', 'vqnguyen', 'jdickers', 'rpithadi', 'yangliqun', None, 'kbaciaus', 'nstorey']",32,"['manakaw', 'hirawan', 'kmmaurer', 'jhaveri', 'panren2006', 'tkazokas', 'wtowens', 'vgokhale', 'eenginerd', 'ejasinsk', 'ratanrego', 'vqnguyen', 'jdickers', 'weim', 'arthurfacon', 'purukhandue', None, 'mconaboy', 'kbaciaus', 'petey27', 'greenpurdue', 'afrierso', 'pasera', 'zhang118', 'naman', 'cbean', 'abishmalik', 'rpithadi', 'yangliqun', 'kbyun', 'mhlebask', 'nstorey']"
12,4,21,8,2,"['mhlebask', 'mconaboy']",18,"['manakaw', 'hirawan', 'petey27', 'panren2006', 'tkazokas', 'wtowens', 'vgokhale', 'eenginerd', 'afrierso', 'pasera', 'kbyun', 'ejasinsk', 'ratanrego', 'cbean', 'weim', 'abishmalik', 'arthurfacon', 'purukhandue']",6,"['choi1', 'rslosser', 'monil2912', 'tgreenhi', 'serekson', None]",26,"['manakaw', 'hirawan', 'panren2006', 'tkazokas', 'wtowens', 'vgokhale', 'eenginerd', 'rslosser', 'ejasinsk', 'ratanrego', 'weim', 'serekson', 'arthurfacon', 'purukhandue', None, 'mconaboy', 'petey27', 'afrierso', 'pasera', 'choi1', 'monil2912', 'cbean', 'tgreenhi', 'abishmalik', 'kbyun', 'mhlebask']"
13,67,19,28,1,['venkey'],17,"['jagdeshkas', 'ysantoshreddy86', 'sujan24', 'khan530', 'gadderamakrishna', 'leelakishen', 'bkishore207', 'surendra207', 'ashok408', 'adityayottastar', 'bharanimallipeddi', 'sudheergajari', 'hamed', 'aravinda', 'madhuadavelli15', 'rajgopal74', 'handsomepraveen']",27,"['yuxingangzju', 'osso', 'neo781017', 'spritelala', 'mariaana', 'stahel', 'hchhide', 'bellmanz', 'srinivasan1984', 'exampleoma', 'sreramanm', 'olyaei', 'm_maziar', 'zhiying', 'mohammad_shayeste', 'nanosolar', 'vivi6', 'behnambanan', 'pankaj_kvhld', 'moeen84', 'mitrasomak', 'rok1986', 'littlemooncake', None, 'athom', 'tiabilly', 'ull124']",45,"['yuxingangzju', 'sujan24', 'ysantoshreddy86', 'osso', 'neo781017', 'spritelala', 'mariaana', 'stahel', 'hchhide', 'bellmanz', 'srinivasan1984', 'exampleoma', 'surendra207', 'venkey', 'sreramanm', 'olyaei', 'm_maziar', 'jagdeshkas', 'zhiying', 'leelakishen', 'ashok408', 'mohammad_shayeste', 'bharanimallipeddi', 'nanosolar', 'aravinda', 'vivi6', 'rajgopal74', 'behnambanan', 'pankaj_kvhld', 'khan530', 'moeen84', 'mitrasomak', 'adityayottastar', 'rok1986', 'sudheergajari', 'hamed', 'madhuadavelli15', 'littlemooncake', None, 'athom', 'tiabilly', 'gadderamakrishna', 'bkishore207', 'ull124', 'handsomepraveen']"
13,65,19,18,14,"['jagdeshkas', 'ysantoshreddy86', 'gadderamakrishna', 'sujan24', 'leelakishen', 'surendra207', 'bkishore207', 'ashok408', 'adityayottastar', 'bharanimallipeddi', 'sudheergajari', 'aravinda', 'madhuadavelli15', 'rajgopal74']",4,"['venkey', 'hamed', 'khan530', 'handsomepraveen']",4,"[None, 'phani221984', 'lbyrne123', 'nallavelli']",22,"['sujan24', 'ysantoshreddy86', 'khan530', 'lbyrne123', 'nallavelli', 'adityayottastar', 'sudheergajari', 'hamed', 'madhuadavelli15', 'surendra207', 'venkey', None, 'jagdeshkas', 'gadderamakrishna', 'leelakishen', 'bkishore207', 'ashok408', 'bharanimallipeddi', 'phani221984', 'aravinda', 'rajgopal74', 'handsomepraveen']"
13,66,19,9,6,"['sujan24', 'gadderamakrishna', 'ashok408', 'sudheergajari', 'madhuadavelli15', 'surendra207']",12,"['jagdeshkas', 'ysantoshreddy86', 'khan530', 'leelakishen', 'bkishore207', 'adityayottastar', 'bharanimallipeddi', 'hamed', 'aravinda', 'rajgopal74', 'venkey', 'handsomepraveen']",3,"[None, 'lbyrne123', 'phani221984']",21,"['sujan24', 'ysantoshreddy86', 'khan530', 'lbyrne123', 'adityayottastar', 'sudheergajari', 'hamed', 'madhuadavelli15', 'surendra207', 'venkey', None, 'jagdeshkas', 'gadderamakrishna', 'leelakishen', 'bkishore207', 'ashok408', 'bharanimallipeddi', 'phani221984', 'aravinda', 'rajgopal74', 'handsomepraveen']"
14,48,17,16,8,"['olesyasun', 'agrieco', 'timbow', 'gpinkel', 'vishniakou', 'camellog', 'jliu86', 'heavenward79']",8,"['hosuklee78', 'haoziyanwo', 'kaidu', 'pgrutz', 'j5ong', 'japflieg', 'vijayen', 'nakata']",8,"['sunke', 'vcl', 'aohoka', 'ericson168', 'derfnofred', 'luweizju', None, 'aggiemuchuan']",24,"['hosuklee78', 'vcl', 'vishniakou', 'j5ong', 'aohoka', 'japflieg', 'derfnofred', 'heavenward79', 'luweizju', None, 'aggiemuchuan', 'olesyasun', 'agrieco', 'timbow', 'gpinkel', 'haoziyanwo', 'sunke', 'kaidu', 'pgrutz', 'camellog', 'jliu86', 'ericson168', 'vijayen', 'nakata']"
14,47,17,6,2,"['pgrutz', 'japflieg']",14,"['olesyasun', 'hosuklee78', 'agrieco', 'timbow', 'gpinkel', 'haoziyanwo', 'kaidu', 'vishniakou', 'j5ong', 'camellog', 'jliu86', 'heavenward79', 'vijayen', 'nakata']",4,"['tpblume87', 'splyman', None, 'cheese1']",20,"['hosuklee78', 'tpblume87', 'vishniakou', 'j5ong', 'japflieg', 'heavenward79', 'splyman', None, 'olesyasun', 'agrieco', 'timbow', 'gpinkel', 'haoziyanwo', 'kaidu', 'pgrutz', 'camellog', 'jliu86', 'cheese1', 'vijayen', 'nakata']"
15,159,17,87,2,"['enzelu1', 'jain10']",14,"['vrangel', 'john3636', 'hector0785', 'dbhatn2', 'ares_xlz', 'choi1', 'khuh', 'deguzouw', 'zhang205', 'marsmoon', 'nmahend2', 'aaronmudd', 'frankzheng329', 'xinhai']",85,"['pifactorial', 'xunjian', 'manasgartia', 'ddaza2', 'tdburks2', 'mmccorm3', 'agibson', 'dharmaturtle', 'hochan5', 'chau5', 'thunghan', 'juan1', 'mjermann', 'yeunkim2', 'japheth', 'rusev1', 'tehmonk', 'yichenusa', 'ucabraal', 'tianhu2', 'choi129', 'wu14', 'kboger2', 'wangwei420', 'jruzic2', 'spadoni2', 'lanhuo1986', 'mmadeja2', 'grillz58', 'cloud1', 'anwen', 'rusiana2', 'smustaf2', 'mrbrightside695', 'hchoi32', 'ebecker', 'ass1085', 'mlee71', 'nayak2', 'niemerg1', 'dnshah2', 'xhuang25', 'chang87', 'flian2', 'jiangj001', 'gsvenni2', 'resquiv2', 'sbhaler2', 'zumbahl1', 'larsgtb', 'johnseo2', 'akong2', 'liao27', 'klinga88', 'jbae5', 'vali0227', 'joejsheehan', 'sgopal4', 'lebann', 'gupta40', 'canandagdeviren', 'charishma', 'liu181', 'mstrom', 'kkoeste2', 'kdearnl2', 'edward31', 'lionelmoh', 'nbisby2', None, 'capmaster', 'panoramarts', 'nbhagat2', 'sjhseraph', 'mkoh', 'ewood8806', 'motoki1', 'intrimind', 'kkroege2', 'sshiffe2', 'jstrack2', 'kodark', 'rbhojwa2', 'mohamed', 'crptone']",101,"['pifactorial', 'dbhatn2', 'xunjian', 'manasgartia', 'ddaza2', 'tdburks2', 'mmccorm3', 'agibson', 'dharmaturtle', 'hochan5', 'chau5', 'thunghan', 'juan1', 'john3636', 'mjermann', 'japheth', 'rusev1', 'tehmonk', 'yichenusa', 'yeunkim2', 'ucabraal', 'tianhu2', 'zhang205', 'choi129', 'wu14', 'kboger2', 'wangwei420', 'jruzic2', 'spadoni2', 'lanhuo1986', 'hector0785', 'mmadeja2', 'grillz58', 'cloud1', 'marsmoon', 'anwen', 'rusiana2', 'smustaf2', 'mrbrightside695', 'hchoi32', 'ebecker', 'ass1085', 'mlee71', 'nayak2', 'niemerg1', 'dnshah2', 'xhuang25', 'mohamed', 'chang87', 'vrangel', 'flian2', 'jain10', 'jiangj001', 'gsvenni2', 'resquiv2', 'sbhaler2', 'zumbahl1', 'larsgtb', 'johnseo2', 'akong2', 'liao27', 'ares_xlz', 'choi1', 'klinga88', 'deguzouw', 'jbae5', 'vali0227', 'joejsheehan', 'sgopal4', 'khuh', 'enzelu1', 'lebann', 'frankzheng329', 'gupta40', 'canandagdeviren', 'charishma', 'liu181', 'mstrom', 'kkoeste2', 'kdearnl2', 'edward31', 'lionelmoh', 'nmahend2', 'aaronmudd', 'nbisby2', None, 'capmaster', 'panoramarts', 'nbhagat2', 'sjhseraph', 'mkoh', 'ewood8806', 'motoki1', 'intrimind', 'kkroege2', 'sshiffe2', 'jstrack2', 'kodark', 'rbhojwa2', 'xinhai', 'crptone']"
15,51,17,75,3,"['enzelu1', 'jain10', 'frankzheng329']",13,"['vrangel', 'john3636', 'hector0785', 'dbhatn2', 'ares_xlz', 'choi1', 'khuh', 'deguzouw', 'zhang205', 'marsmoon', 'nmahend2', 'aaronmudd', 'xinhai']",72,"['tdburks2', 'ddaza2', 'mmccorm3', 'agibson', 'dharmaturtle', 'hochan5', 'thunghan', 'juan1', 'japheth', 'tehmonk', 'wfergus2', 'caromu', 'ucabraal', 'choi129', 'kboger2', 'wu14', 'yhuang38', 'aldirin1', 'wangwei420', 'jruzic2', 'gmeyer3', 'spadoni2', 'swieren1', 'mmadeja2', 'cloud1', 'johan1', 'anwen', 'smustaf2', 'rskirby2', 'hchoi32', 'ebecker', 'ass1085', 'freddycheu', 'han23', 'mlee71', 'loganliu1', 'nayak2', 'niemerg1', 'xhuang25', 'yapjiun1', 'slhertz', 'chang87', 'jiangj001', 'resquiv2', 'zumbahl1', 'larsgtb', 'mtrower2', 'johnseo2', 'akong2', 'liao27', 'trieuvu1', 'klinga88', 'jbae5', 'sgopal4', 'gupta40', 'canandagdeviren', 'charishma', 'liu181', 'mstrom', 'fox6606', 'nbisby2', None, 'panoramarts', 'ewood8806', 'motoki1', 'rasilva2', 'sshiffe2', 'jstrack2', 'rbhojwa2', 'afromaniac', 'yeunkim2', 'crptone']",88,"['dbhatn2', 'tdburks2', 'ddaza2', 'mmccorm3', 'agibson', 'dharmaturtle', 'hochan5', 'thunghan', 'juan1', 'john3636', 'yeunkim2', 'japheth', 'tehmonk', 'wfergus2', 'caromu', 'ucabraal', 'zhang205', 'choi129', 'kboger2', 'wu14', 'yhuang38', 'aldirin1', 'wangwei420', 'jruzic2', 'gmeyer3', 'spadoni2', 'hector0785', 'swieren1', 'mmadeja2', 'cloud1', 'johan1', 'marsmoon', 'anwen', 'smustaf2', 'rskirby2', 'hchoi32', 'ebecker', 'ass1085', 'freddycheu', 'han23', 'mlee71', 'loganliu1', 'nayak2', 'niemerg1', 'xhuang25', 'yapjiun1', 'slhertz', 'chang87', 'vrangel', 'jain10', 'jiangj001', 'resquiv2', 'zumbahl1', 'larsgtb', 'mtrower2', 'johnseo2', 'akong2', 'liao27', 'trieuvu1', 'ares_xlz', 'choi1', 'klinga88', 'deguzouw', 'jbae5', 'sgopal4', 'khuh', 'enzelu1', 'frankzheng329', 'gupta40', 'canandagdeviren', 'charishma', 'liu181', 'mstrom', 'nmahend2', 'aaronmudd', 'fox6606', 'nbisby2', None, 'panoramarts', 'ewood8806', 'motoki1', 'rasilva2', 'sshiffe2', 'jstrack2', 'rbhojwa2', 'afromaniac', 'xinhai', 'crptone']"
15,163,17,50,6,"['john3636', 'choi1', 'deguzouw', 'zhang205', 'khuh', 'aaronmudd']",10,"['vrangel', 'hector0785', 'enzelu1', 'dbhatn2', 'jain10', 'ares_xlz', 'marsmoon', 'nmahend2', 'frankzheng329', 'xinhai']",44,"['manakaw', 'hirawan', 'chen145', 'eenginerd', 'pjcannon', 'arthurfacon', 'purukhandue', 'jamescui', 'mconaboy', 'ajfunche', 'petey27', 'afrierso', 'jackfrost9p', 'cbean', 'rpithadi', 'jainrajat11', 'yangliqun', 'mhlebask', 'kmmaurer', 'kylerupp87', 'panren2006', 'wtowens', 'tkazokas', 'ratanrego', 'dwilkes', 'vqnguyen', 'dtracy', 'kmsj2', 'weim', 'pandey', 'obernada', None, 'greenpurdue', 'pasera', 'vahuja', 'taliaho', 'pxu', 'zhang118', 'lee251', 'mazad', 'thartman', 'abishmalik', 'kbyun', 'tdougan']",60,"['chen145', 'dbhatn2', 'pjcannon', 'john3636', 'afrierso', 'jackfrost9p', 'cbean', 'zhang205', 'rpithadi', 'yangliqun', 'jainrajat11', 'kmmaurer', 'hector0785', 'wtowens', 'dwilkes', 'marsmoon', 'weim', 'obernada', 'greenpurdue', 'vahuja', 'zhang118', 'lee251', 'abishmalik', 'manakaw', 'vrangel', 'hirawan', 'eenginerd', 'jain10', 'arthurfacon', 'purukhandue', 'jamescui', 'mconaboy', 'ajfunche', 'petey27', 'ares_xlz', 'choi1', 'deguzouw', 'khuh', 'enzelu1', 'mhlebask', 'frankzheng329', 'kylerupp87', 'panren2006', 'tkazokas', 'ratanrego', 'vqnguyen', 'dtracy', 'kmsj2', 'pandey', 'nmahend2', 'aaronmudd', None, 'pasera', 'taliaho', 'pxu', 'mazad', 'thartman', 'kbyun', 'xinhai', 'tdougan']"
15,50,17,47,1,['nmahend2'],15,"['vrangel', 'john3636', 'hector0785', 'dbhatn2', 'jain10', 'ares_xlz', 'choi1', 'khuh', 'deguzouw', 'zhang205', 'marsmoon', 'enzelu1', 'aaronmudd', 'frankzheng329', 'xinhai']",46,"['sskim20', 'sbhaler2', 'resquiv2', 'pi_factorial', 'wkelleh2', 'acedamace', 'thunghan', 'green16', 'wfergus2', 'carter6', 'xliu34', 'dlowry2', 'driscoll42', 'vali0227', 'bfogel2', 'choi129', 'dstamat2', 'gmeyer3', 'lanhuo1986', 'kylerupp87', 'grillz58', 'kdearnl2', 'luyichen', 'lionelmoh', None, 'echavez3', 'timespectrum', 'nbhagat2', 'hfederm2', 'jwester3', 'greenpurdue', 'mkoh', 'tstilz', 'swimjade', 'ttapers', 'taliaho', 'intrimind', 'nitramzero', 'burgner2', 'kkroege2', 'dnshah2', 'dhabes2', 'jstrack2', 'yang28', 'meliu2', 'jlorenz3']",62,"['vrangel', 'dbhatn2', 'sskim20', 'jain10', 'sbhaler2', 'resquiv2', 'pi_factorial', 'wkelleh2', 'acedamace', 'thunghan', 'john3636', 'green16', 'wfergus2', 'carter6', 'xliu34', 'ares_xlz', 'choi1', 'deguzouw', 'dlowry2', 'driscoll42', 'zhang205', 'vali0227', 'bfogel2', 'choi129', 'dstamat2', 'khuh', 'enzelu1', 'frankzheng329', 'gmeyer3', 'lanhuo1986', 'hector0785', 'kylerupp87', 'grillz58', 'kdearnl2', 'marsmoon', 'luyichen', 'lionelmoh', 'nmahend2', 'aaronmudd', None, 'echavez3', 'timespectrum', 'nbhagat2', 'hfederm2', 'jwester3', 'greenpurdue', 'mkoh', 'tstilz', 'swimjade', 'ttapers', 'taliaho', 'intrimind', 'nitramzero', 'burgner2', 'kkroege2', 'dnshah2', 'dhabes2', 'jstrack2', 'yang28', 'meliu2', 'xinhai', 'jlorenz3']"
15,160,17,40,2,"['nmahend2', 'frankzheng329']",14,"['vrangel', 'john3636', 'hector0785', 'dbhatn2', 'jain10', 'ares_xlz', 'choi1', 'khuh', 'deguzouw', 'zhang205', 'marsmoon', 'enzelu1', 'aaronmudd', 'xinhai']",38,"['pifactorial', 'sskim20', 'sbhaler2', 'nawaz', 'acedamace', 'thunghan', 'xliu34', 'dlowry2', 'bfogel2', 'kboger2', 'dstamat2', 'puneet2905', 'jruzic2', 'gmeyer3', 'cming2', 'lanhuo1986', 'mmadeja2', 'grillz58', 'kdearnl2', 'eluminite', 'lionelmoh', None, 'echavez3', 'timespectrum', 'swimjade', 'hfederm2', 'jwester3', 'freddycheu', 'tstilz', 'lsomeel41', 'nitramzero', 'burgner2', 'kkroege2', 'earlgrey', 'slhertz', 'afromaniac', 'meliu2', 'mohamed']",54,"['vrangel', 'pifactorial', 'dbhatn2', 'sskim20', 'jain10', 'sbhaler2', 'nawaz', 'acedamace', 'thunghan', 'john3636', 'xliu34', 'ares_xlz', 'choi1', 'deguzouw', 'dlowry2', 'zhang205', 'bfogel2', 'kboger2', 'dstamat2', 'khuh', 'enzelu1', 'frankzheng329', 'puneet2905', 'jruzic2', 'cming2', 'gmeyer3', 'lanhuo1986', 'hector0785', 'mmadeja2', 'grillz58', 'kdearnl2', 'marsmoon', 'eluminite', 'lionelmoh', 'nmahend2', 'aaronmudd', None, 'echavez3', 'timespectrum', 'swimjade', 'hfederm2', 'jwester3', 'freddycheu', 'tstilz', 'lsomeel41', 'nitramzero', 'burgner2', 'kkroege2', 'earlgrey', 'slhertz', 'afromaniac', 'mohamed', 'meliu2', 'xinhai']"
15,3,17,38,4,"['choi1', 'aaronmudd', 'john3636', 'deguzouw']",12,"['vrangel', 'hector0785', 'enzelu1', 'dbhatn2', 'jain10', 'ares_xlz', 'khuh', 'zhang205', 'marsmoon', 'nmahend2', 'frankzheng329', 'xinhai']",34,"['manakaw', 'hirawan', 'vgokhale', 'eenginerd', 'jakho', 'arthurfacon', 'purukhandue', 'mconaboy', 'kbaciaus', 'petey27', 'mshen', 'wlpierret', 'janam', 'afrierso', 'cbean', 'tgregg', 'rpithadi', 'wapayne', 'chen272', 'panren2006', 'wtowens', 'tkazokas', 'ratanrego', 'dwilkes', 'dtracy', 'weim', 'mhmalik', 'rallyemenz', None, 'pasera', 'monil2912', 'naman', 'abishmalik', 'kbyun']",50,"['manakaw', 'vrangel', 'hirawan', 'dbhatn2', 'vgokhale', 'eenginerd', 'jain10', 'jakho', 'arthurfacon', 'purukhandue', 'mconaboy', 'kbaciaus', 'petey27', 'john3636', 'mshen', 'wlpierret', 'janam', 'afrierso', 'ares_xlz', 'choi1', 'deguzouw', 'cbean', 'zhang205', 'tgregg', 'rpithadi', 'chen272', 'khuh', 'enzelu1', 'wapayne', 'frankzheng329', 'hector0785', 'panren2006', 'wtowens', 'tkazokas', 'ratanrego', 'dwilkes', 'marsmoon', 'dtracy', 'weim', 'nmahend2', 'aaronmudd', 'mhmalik', 'rallyemenz', None, 'pasera', 'monil2912', 'naman', 'abishmalik', 'kbyun', 'xinhai']"
15,49,17,29,1,['khuh'],15,"['vrangel', 'john3636', 'hector0785', 'enzelu1', 'dbhatn2', 'jain10', 'ares_xlz', 'choi1', 'deguzouw', 'zhang205', 'marsmoon', 'nmahend2', 'aaronmudd', 'frankzheng329', 'xinhai']",28,"['chen145', 'bcorbett', 'mwkhan', 'ajfunche', 'ashokv', 'jackfrost9p', 'mochoa', 'dandry', 'shelmi', 'jeem9', 'kylerupp87', 'rgoble', 'nmustaff', 'svanderl', 'vqnguyen', 'luyichen', 'dhc529', 'pandey', None, 'zebov', 'tim8241', 'pxu', 'zhang118', 'lee251', 'mazad', 'mmakowsk', 'jshehade', 'nstorey']",44,"['vrangel', 'chen145', 'mwkhan', 'bcorbett', 'dbhatn2', 'jain10', 'ajfunche', 'john3636', 'ares_xlz', 'choi1', 'deguzouw', 'ashokv', 'jackfrost9p', 'zhang205', 'mochoa', 'dandry', 'khuh', 'enzelu1', 'frankzheng329', 'shelmi', 'jeem9', 'hector0785', 'kylerupp87', 'rgoble', 'nmustaff', 'svanderl', 'vqnguyen', 'marsmoon', 'luyichen', 'dhc529', 'pandey', 'nmahend2', 'aaronmudd', None, 'zebov', 'tim8241', 'pxu', 'zhang118', 'lee251', 'mazad', 'mmakowsk', 'jshehade', 'xinhai', 'nstorey']"
15,62,17,28,1,['zhang205'],15,"['vrangel', 'john3636', 'hector0785', 'enzelu1', 'dbhatn2', 'jain10', 'ares_xlz', 'choi1', 'khuh', 'deguzouw', 'marsmoon', 'nmahend2', 'aaronmudd', 'frankzheng329', 'xinhai']",27,"['manakaw', 'chen145', 'mwkhan', 'bcorbett', 'eenginerd', 'pjcannon', 'arthurfacon', 'ajfunche', 'wlpierret', 'jackfrost9p', 'dandry', 'jainrajat11', 'dwilkes', 'vqnguyen', 'dtracy', 'kmsj2', 'pandey', 'luyichen', None, 'taliaho', 'pxu', 'zhang118', 'lee251', 'thartman', 'yang28', 'shin29', 'tdougan']",43,"['manakaw', 'vrangel', 'chen145', 'mwkhan', 'bcorbett', 'dbhatn2', 'eenginerd', 'jain10', 'pjcannon', 'arthurfacon', 'ajfunche', 'john3636', 'wlpierret', 'ares_xlz', 'choi1', 'deguzouw', 'jackfrost9p', 'zhang205', 'jainrajat11', 'dandry', 'khuh', 'enzelu1', 'frankzheng329', 'hector0785', 'dwilkes', 'vqnguyen', 'marsmoon', 'dtracy', 'kmsj2', 'pandey', 'luyichen', 'nmahend2', 'aaronmudd', None, 'taliaho', 'pxu', 'zhang118', 'lee251', 'thartman', 'yang28', 'shin29', 'xinhai', 'tdougan']"
15,161,17,20,1,['ares_xlz'],15,"['vrangel', 'john3636', 'hector0785', 'enzelu1', 'dbhatn2', 'jain10', 'choi1', 'khuh', 'deguzouw', 'zhang205', 'marsmoon', 'nmahend2', 'aaronmudd', 'frankzheng329', 'xinhai']",19,"['khapp', 'flian2', 'manasgartia', 'cgarner3', 'dharmaturtle', 'hochan5', 'larsgtb', 'mtrower2', 'vali0227', 'aldirin1', 'shaofu88', 'cming2', 'swieren1', None, 'capmaster', 'atseng3', 'han23', 'bcerier2', 'chang87']",35,"['vrangel', 'hector0785', 'swieren1', 'dbhatn2', 'khapp', 'flian2', 'jain10', 'khuh', 'manasgartia', 'chang87', 'marsmoon', 'cgarner3', 'dharmaturtle', 'nmahend2', 'aaronmudd', None, 'hochan5', 'capmaster', 'john3636', 'larsgtb', 'mtrower2', 'atseng3', 'han23', 'ares_xlz', 'choi1', 'bcerier2', 'deguzouw', 'zhang205', 'vali0227', 'aldirin1', 'enzelu1', 'frankzheng329', 'xinhai', 'shaofu88', 'cming2']"
15,4,17,8,1,['choi1'],15,"['vrangel', 'john3636', 'hector0785', 'enzelu1', 'dbhatn2', 'jain10', 'ares_xlz', 'khuh', 'deguzouw', 'zhang205', 'marsmoon', 'nmahend2', 'aaronmudd', 'frankzheng329', 'xinhai']",7,"['rslosser', 'monil2912', 'tgreenhi', 'serekson', 'mhlebask', None, 'mconaboy']",23,"['vrangel', 'hector0785', 'dbhatn2', 'jain10', 'khuh', 'rslosser', 'marsmoon', 'serekson', 'nmahend2', 'aaronmudd', None, 'mconaboy', 'john3636', 'ares_xlz', 'choi1', 'monil2912', 'deguzouw', 'zhang205', 'tgreenhi', 'enzelu1', 'mhlebask', 'frankzheng329', 'xinhai']"
16,102,17,32,15,"['pankaj_kvhld', 'osso', 'tiboy', 'neo781017', 'zhohuo', 'spritelala', 'mitrasomak', 'moeen84', 'rouget', 'rok1986', 'srinivasan1984', 'aminkhan', 'littlemooncake', 'athom', 'behnambanan']",1,['tiabilly'],17,"['yuxingangzju', 'zhiying', 'gbal', 'emibac', 'mohammad_shayeste', 'nanosolar', 'stahel', 'ogus', None, 'hchhide', 'meixian82', 'bellmanz', 'vivi6', 'exampleoma', 'ull124', 'sreramanm', 'olyaei']",33,"['yuxingangzju', 'osso', 'neo781017', 'spritelala', 'gbal', 'emibac', 'stahel', 'hchhide', 'bellmanz', 'srinivasan1984', 'exampleoma', 'sreramanm', 'olyaei', 'zhiying', 'rouget', 'mohammad_shayeste', 'nanosolar', 'vivi6', 'aminkhan', 'behnambanan', 'pankaj_kvhld', 'tiboy', 'zhohuo', 'mitrasomak', 'moeen84', 'rok1986', 'ogus', 'meixian82', 'littlemooncake', None, 'athom', 'tiabilly', 'ull124']"
16,67,17,28,12,"['pankaj_kvhld', 'tiabilly', 'osso', 'neo781017', 'spritelala', 'mitrasomak', 'moeen84', 'rok1986', 'srinivasan1984', 'littlemooncake', 'athom', 'behnambanan']",4,"['aminkhan', 'zhohuo', 'rouget', 'tiboy']",16,"['yuxingangzju', 'm_maziar', 'zhiying', 'venkey', 'mariaana', 'mohammad_shayeste', 'nanosolar', 'stahel', 'ull124', None, 'hchhide', 'bellmanz', 'vivi6', 'exampleoma', 'sreramanm', 'olyaei']",32,"['yuxingangzju', 'osso', 'neo781017', 'spritelala', 'mariaana', 'stahel', 'hchhide', 'bellmanz', 'srinivasan1984', 'exampleoma', 'sreramanm', 'venkey', 'olyaei', 'm_maziar', 'zhiying', 'rouget', 'mohammad_shayeste', 'nanosolar', 'vivi6', 'aminkhan', 'behnambanan', 'pankaj_kvhld', 'tiboy', 'zhohuo', 'mitrasomak', 'moeen84', 'rok1986', 'littlemooncake', None, 'athom', 'tiabilly', 'ull124']"
16,11,17,27,15,"['pankaj_kvhld', 'tiabilly', 'osso', 'tiboy', 'neo781017', 'zhohuo', 'spritelala', 'mitrasomak', 'moeen84', 'rouget', 'rok1986', 'aminkhan', 'littlemooncake', 'athom', 'behnambanan']",1,['srinivasan1984'],12,"['fiammengo', 'gbal', 'mikkni', 'emibac', 'stahel', 'ogus', 'chensi', 'vivi6', 'exampleoma', 'mingyu', None, 'cmalric']",28,"['osso', 'fiammengo', 'neo781017', 'spritelala', 'gbal', 'mikkni', 'emibac', 'stahel', 'srinivasan1984', 'exampleoma', 'rouget', 'chensi', 'vivi6', 'aminkhan', 'behnambanan', 'pankaj_kvhld', 'tiboy', 'zhohuo', 'mitrasomak', 'moeen84', 'rok1986', 'ogus', 'littlemooncake', None, 'athom', 'tiabilly', 'mingyu', 'cmalric']"
16,10,17,25,15,"['pankaj_kvhld', 'tiabilly', 'osso', 'tiboy', 'neo781017', 'zhohuo', 'spritelala', 'mitrasomak', 'rouget', 'rok1986', 'srinivasan1984', 'aminkhan', 'littlemooncake', 'athom', 'behnambanan']",1,['moeen84'],10,"['fiammengo', 'mikkni', 'mariaana', 'stahel', 'ogus', 'chensi', 'vivi6', None, 'cmalric', 'olyaei']",26,"['osso', 'fiammengo', 'neo781017', 'spritelala', 'mikkni', 'mariaana', 'stahel', 'srinivasan1984', 'olyaei', 'rouget', 'chensi', 'vivi6', 'aminkhan', 'behnambanan', 'pankaj_kvhld', 'tiboy', 'zhohuo', 'mitrasomak', 'moeen84', 'rok1986', 'ogus', 'littlemooncake', None, 'athom', 'tiabilly', 'cmalric']"
16,92,17,23,6,"['tiboy', 'zhohuo', 'moeen84', 'rok1986', 'srinivasan1984', 'aminkhan']",10,"['pankaj_kvhld', 'tiabilly', 'osso', 'neo781017', 'rouget', 'spritelala', 'mitrasomak', 'littlemooncake', 'athom', 'behnambanan']",17,"['yuxingangzju', 'm_maziar', 'zhiying', 'fiammengo', 'mariaana', 'mohammad_shayeste', 'nanosolar', 'stahel', 'jmpm2', None, 'hchhide', 'meixian82', 'jmpm', 'vivi6', 'ull124', 'sreramanm', 'olyaei']",33,"['yuxingangzju', 'osso', 'fiammengo', 'neo781017', 'spritelala', 'mariaana', 'stahel', 'hchhide', 'srinivasan1984', 'sreramanm', 'olyaei', 'm_maziar', 'zhiying', 'rouget', 'mohammad_shayeste', 'nanosolar', 'jmpm2', 'jmpm', 'vivi6', 'aminkhan', 'behnambanan', 'pankaj_kvhld', 'tiboy', 'zhohuo', 'mitrasomak', 'moeen84', 'rok1986', 'meixian82', 'littlemooncake', None, 'athom', 'tiabilly', 'ull124']"
16,139,17,19,2,"['littlemooncake', 'pankaj_kvhld']",14,"['tiabilly', 'osso', 'tiboy', 'neo781017', 'zhohuo', 'spritelala', 'mitrasomak', 'moeen84', 'rouget', 'rok1986', 'srinivasan1984', 'aminkhan', 'athom', 'behnambanan']",17,"['yuxingangzju', 'allentrue', 'zhiying', 'mikkni', 'holmeschow052310', 'emibac', 'mariaana', 'nanosolar', 'stahel', 'ull124', None, 'hchhide', 'meixian82', 'jmpm', 'vivi6', 'exampleoma', 'sreramanm']",33,"['yuxingangzju', 'pankaj_kvhld', 'allentrue', 'tiboy', 'osso', 'neo781017', 'zhohuo', 'spritelala', 'mitrasomak', 'moeen84', 'mikkni', 'rok1986', 'mariaana', 'emibac', 'stahel', 'hchhide', 'meixian82', 'srinivasan1984', 'exampleoma', 'littlemooncake', 'sreramanm', 'athom', None, 'tiabilly', 'zhiying', 'rouget', 'holmeschow052310', 'ull124', 'nanosolar', 'jmpm', 'vivi6', 'aminkhan', 'behnambanan']"
17,147,16,10,5,"['nicfang', 'somnath2', 'mail2na', 'graf4', 'crazedcatatonic5']",10,"['bailey99999', 'sthomps9', 'cho119', 'caorduno', 'chrismy', 'arbiter007', 'sontran', 'pinkfrida', 'singulani', 'sbboyd2']",5,"['sobh', 'kim857', 'fmflake', None, 'douglasy']",20,"['bailey99999', 'cho119', 'caorduno', 'chrismy', 'kim857', 'arbiter007', 'sontran', 'pinkfrida', 'mail2na', 'somnath2', None, 'crazedcatatonic5', 'sobh', 'sthomps9', 'nicfang', 'fmflake', 'singulani', 'sbboyd2', 'graf4', 'douglasy']"
18,73,16,17,1,['garrettschlenvogt'],14,"['yamini', 'ylu6', 'ganesh_kanumilli', 'raoy', 'sanjay007', 'susma', 'vamsi007', 'arsenal', 'cabreraw1', 'kanneganti', 'vijayak', 'vinay_2010', 'chenjiezhi', 'thalaiva29']",16,"['johnd', 'ferry', 'feiqi', 'vedhas', 'suavecito', 'zlmsailor', 'skyoo', 'ewchung', 'isparku', 'tonnytang8', 'msriniv5', None, 'hung1987', 'sherasim', 'yohaikal', 'joebutler9']",31,"['yamini', 'zlmsailor', 'arsenal', 'vijayak', 'chenjiezhi', 'isparku', 'ganesh_kanumilli', 'vedhas', 'cabreraw1', 'skyoo', 'tonnytang8', 'msriniv5', 'thalaiva29', 'hung1987', 'sherasim', 'yohaikal', 'raoy', 'feiqi', 'sanjay007', 'susma', 'vamsi007', 'ewchung', 'vinay_2010', None, 'joebutler9', 'garrettschlenvogt', 'ylu6', 'ferry', 'johnd', 'suavecito', 'kanneganti']"
18,95,16,15,1,['cabreraw1'],14,"['garrettschlenvogt', 'yamini', 'ylu6', 'ganesh_kanumilli', 'raoy', 'sanjay007', 'susma', 'vamsi007', 'arsenal', 'kanneganti', 'vijayak', 'vinay_2010', 'chenjiezhi', 'thalaiva29']",14,"['zhj123xp', 'hschoi07', 'xnlepro', 'termini_qin', 'alucero', 'ddd071000', 'eshoko', 'julbyk', 'ddickjr', 'gongchenghust', 'wcwang', 'juliushorvath', 'srikar85', None]",29,"['yamini', 'hschoi07', 'xnlepro', 'raoy', 'sanjay007', 'alucero', 'susma', 'vamsi007', 'arsenal', 'eshoko', 'ddickjr', 'vijayak', 'wcwang', 'vinay_2010', 'chenjiezhi', None, 'zhj123xp', 'garrettschlenvogt', 'ylu6', 'ganesh_kanumilli', 'termini_qin', 'ddd071000', 'cabreraw1', 'julbyk', 'kanneganti', 'gongchenghust', 'thalaiva29', 'juliushorvath', 'srikar85']"
18,33,16,14,8,"['yamini', 'ganesh_kanumilli', 'sanjay007', 'susma', 'vamsi007', 'kanneganti', 'vijayak', 'vinay_2010']",7,"['garrettschlenvogt', 'ylu6', 'raoy', 'arsenal', 'cabreraw1', 'chenjiezhi', 'thalaiva29']",6,"['ddavidson7', 'ssahmed', 'bhaley', None, 'yalavarthi', 'vamsi']",21,"['yamini', 'ddavidson7', 'raoy', 'sanjay007', 'susma', 'vamsi007', 'arsenal', 'vijayak', 'vinay_2010', 'chenjiezhi', None, 'yalavarthi', 'garrettschlenvogt', 'ylu6', 'ganesh_kanumilli', 'cabreraw1', 'kanneganti', 'ssahmed', 'thalaiva29', 'bhaley', 'vamsi']"
18,34,16,13,1,['garrettschlenvogt'],14,"['yamini', 'ylu6', 'ganesh_kanumilli', 'raoy', 'sanjay007', 'susma', 'vamsi007', 'arsenal', 'cabreraw1', 'kanneganti', 'vijayak', 'vinay_2010', 'chenjiezhi', 'thalaiva29']",12,"['feiqi', 'vedhas', 'skyoo', 'ewchung', 'tonnytang8', 'msriniv5', None, 'isparku', 'hung1987', 'sherasim', 'yohaikal', 'flg34200']",27,"['yamini', 'raoy', 'feiqi', 'sanjay007', 'susma', 'vamsi007', 'arsenal', 'ewchung', 'vijayak', 'vinay_2010', 'chenjiezhi', None, 'isparku', 'garrettschlenvogt', 'ylu6', 'ganesh_kanumilli', 'vedhas', 'cabreraw1', 'skyoo', 'kanneganti', 'tonnytang8', 'msriniv5', 'thalaiva29', 'hung1987', 'sherasim', 'yohaikal', 'flg34200']"
18,70,16,9,1,['garrettschlenvogt'],14,"['yamini', 'ylu6', 'ganesh_kanumilli', 'raoy', 'sanjay007', 'susma', 'vamsi007', 'arsenal', 'cabreraw1', 'kanneganti', 'vijayak', 'vinay_2010', 'chenjiezhi', 'thalaiva29']",8,"['vedhas', 'skyoo', 'tonnytang8', 'ewchung', 'isparku', None, 'sherasim', 'yohaikal']",23,"['yamini', 'raoy', 'sanjay007', 'susma', 'vamsi007', 'arsenal', 'ewchung', 'vijayak', 'vinay_2010', 'chenjiezhi', None, 'isparku', 'garrettschlenvogt', 'ylu6', 'ganesh_kanumilli', 'vedhas', 'cabreraw1', 'skyoo', 'kanneganti', 'tonnytang8', 'thalaiva29', 'sherasim', 'yohaikal']"
18,31,16,8,1,['cabreraw1'],14,"['garrettschlenvogt', 'yamini', 'ylu6', 'ganesh_kanumilli', 'raoy', 'sanjay007', 'susma', 'vamsi007', 'arsenal', 'kanneganti', 'vijayak', 'vinay_2010', 'chenjiezhi', 'thalaiva29']",7,"['termini_qin', 'eshoko', 'julbyk', 'ddickjr', 'juliushorvath', 'srikar85', None]",22,"['yamini', 'raoy', 'sanjay007', 'susma', 'vamsi007', 'arsenal', 'eshoko', 'ddickjr', 'vijayak', 'vinay_2010', 'chenjiezhi', None, 'garrettschlenvogt', 'ylu6', 'ganesh_kanumilli', 'termini_qin', 'cabreraw1', 'julbyk', 'kanneganti', 'thalaiva29', 'juliushorvath', 'srikar85']"
18,32,16,8,1,['garrettschlenvogt'],14,"['yamini', 'ylu6', 'ganesh_kanumilli', 'raoy', 'sanjay007', 'susma', 'vamsi007', 'arsenal', 'cabreraw1', 'kanneganti', 'vijayak', 'vinay_2010', 'chenjiezhi', 'thalaiva29']",7,"['vedhas', 'skyoo', 'tonnytang8', 'ewchung', 'msriniv5', None, 'isparku']",22,"['yamini', 'raoy', 'sanjay007', 'susma', 'vamsi007', 'arsenal', 'ewchung', 'vijayak', 'vinay_2010', 'chenjiezhi', 'isparku', None, 'garrettschlenvogt', 'ylu6', 'ganesh_kanumilli', 'vedhas', 'cabreraw1', 'skyoo', 'kanneganti', 'tonnytang8', 'msriniv5', 'thalaiva29']"
18,96,16,8,1,['cabreraw1'],14,"['garrettschlenvogt', 'yamini', 'ylu6', 'ganesh_kanumilli', 'raoy', 'sanjay007', 'susma', 'vamsi007', 'arsenal', 'kanneganti', 'vijayak', 'vinay_2010', 'chenjiezhi', 'thalaiva29']",7,"['termini_qin', 'eshoko', 'julbyk', 'ddickjr', 'juliushorvath', 'srikar85', None]",22,"['yamini', 'raoy', 'sanjay007', 'susma', 'vamsi007', 'arsenal', 'eshoko', 'ddickjr', 'vijayak', 'vinay_2010', 'chenjiezhi', None, 'garrettschlenvogt', 'ylu6', 'ganesh_kanumilli', 'termini_qin', 'cabreraw1', 'julbyk', 'kanneganti', 'thalaiva29', 'juliushorvath', 'srikar85']"
19,74,15,28,12,"['nkchen', 'johnd', 'ngovi', 'yyuan', 'cacurtis', 'fallya', 'suavecito', 'lixinlixinn', 'gregoriospencer', 'donpablo', 'dganger', 'joebutler9']",2,"['jngkd', 'mdnb2']",16,"['eryoung', 'patrick1988', 'adubasu', 'ssaraki', 'bstamand', 'realmofreals', 'dongsong_1', 'ccassels', 'vuongh1', None, 'sabbasiy', 'sensisounds', 'god123456789', 'tunjisamuel', 'fjlatona', 'yohaikal']",30,"['cacurtis', 'ssaraki', 'ccassels', 'vuongh1', 'tunjisamuel', 'mdnb2', 'patrick1988', 'ngovi', 'dongsong_1', 'gregoriospencer', 'donpablo', 'sabbasiy', 'yohaikal', 'eryoung', 'adubasu', 'fallya', 'jngkd', 'realmofreals', 'sensisounds', None, 'joebutler9', 'nkchen', 'johnd', 'yyuan', 'suavecito', 'bstamand', 'lixinlixinn', 'god123456789', 'fjlatona', 'dganger']"
19,44,15,21,11,"['nkchen', 'johnd', 'ngovi', 'yyuan', 'cacurtis', 'fallya', 'suavecito', 'lixinlixinn', 'gregoriospencer', 'donpablo', 'dganger']",3,"['jngkd', 'joebutler9', 'mdnb2']",10,"['eryoung', 'ferry', 'ssaraki', 'realmofreals', 'sk8rvideo', 'cr0c', 'vuongh1', 'tunjisamuel', None, 'calcousin55']",24,"['cacurtis', 'ssaraki', 'cr0c', 'vuongh1', 'tunjisamuel', 'mdnb2', 'calcousin55', 'ngovi', 'gregoriospencer', 'donpablo', 'eryoung', 'fallya', 'jngkd', 'realmofreals', 'sk8rvideo', None, 'joebutler9', 'nkchen', 'johnd', 'ferry', 'yyuan', 'suavecito', 'lixinlixinn', 'dganger']"
19,73,15,17,3,"['suavecito', 'johnd', 'joebutler9']",11,"['nkchen', 'ngovi', 'yyuan', 'cacurtis', 'fallya', 'jngkd', 'lixinlixinn', 'gregoriospencer', 'donpablo', 'dganger', 'mdnb2']",14,"['garrettschlenvogt', 'ferry', 'feiqi', 'vedhas', 'zlmsailor', 'skyoo', 'ewchung', 'isparku', 'tonnytang8', 'msriniv5', None, 'hung1987', 'sherasim', 'yohaikal']",28,"['cacurtis', 'feiqi', 'fallya', 'jngkd', 'zlmsailor', 'ewchung', 'yohaikal', 'isparku', 'joebutler9', 'mdnb2', None, 'garrettschlenvogt', 'nkchen', 'johnd', 'ferry', 'yyuan', 'ngovi', 'suavecito', 'vedhas', 'skyoo', 'lixinlixinn', 'tonnytang8', 'gregoriospencer', 'donpablo', 'msriniv5', 'hung1987', 'sherasim', 'dganger']"
19,61,15,12,4,"['suavecito', 'lixinlixinn', 'mdnb2', 'yyuan']",10,"['nkchen', 'johnd', 'ngovi', 'cacurtis', 'fallya', 'jngkd', 'gregoriospencer', 'donpablo', 'dganger', 'joebutler9']",8,"['eryoung', 'patrick1988', 'ssaraki', 'realmofreals', 'sabbasiy', 'god123456789', 'tunjisamuel', None]",22,"['eryoung', 'cacurtis', 'ssaraki', 'fallya', 'jngkd', 'realmofreals', 'tunjisamuel', None, 'joebutler9', 'mdnb2', 'nkchen', 'johnd', 'patrick1988', 'yyuan', 'ngovi', 'suavecito', 'lixinlixinn', 'gregoriospencer', 'donpablo', 'sabbasiy', 'god123456789', 'dganger']"
20,79,14,13,11,"['faraztehrani', 'tdare', 'bdleonar', 'ajmendoz', 'mrakita', 'spidermonkey', 'sim', 'weinzapf', 'harshayejju', 'mharvazi', 'wsvandyk']",2,"['zigeun', 'samdin8084']",2,"[None, 'mazhar398']",15,"['bdleonar', 'ajmendoz', 'spidermonkey', 'sim', 'mazhar398', 'mharvazi', 'zigeun', None, 'faraztehrani', 'tdare', 'mrakita', 'weinzapf', 'harshayejju', 'samdin8084', 'wsvandyk']"
21,51,14,75,2,"['loganliu1', 'yapjiun1']",11,"['ljleon', 'rgoble', 'eva_chi', 'ttapers', 'kylemore04', 'tsaucer', 'hess8', 'pi_factorial', 'apung', 'jlorenz3', 'lieberae']",73,"['tdburks2', 'ddaza2', 'mmccorm3', 'agibson', 'dharmaturtle', 'hochan5', 'thunghan', 'juan1', 'japheth', 'tehmonk', 'wfergus2', 'caromu', 'ucabraal', 'choi129', 'kboger2', 'wu14', 'yhuang38', 'aldirin1', 'wangwei420', 'jruzic2', 'gmeyer3', 'spadoni2', 'swieren1', 'mmadeja2', 'cloud1', 'johan1', 'anwen', 'smustaf2', 'rskirby2', 'hchoi32', 'ebecker', 'ass1085', 'freddycheu', 'han23', 'mlee71', 'nayak2', 'niemerg1', 'xhuang25', 'slhertz', 'chang87', 'jain10', 'jiangj001', 'resquiv2', 'zumbahl1', 'larsgtb', 'mtrower2', 'johnseo2', 'akong2', 'liao27', 'trieuvu1', 'klinga88', 'jbae5', 'sgopal4', 'enzelu1', 'frankzheng329', 'gupta40', 'canandagdeviren', 'charishma', 'liu181', 'mstrom', 'fox6606', 'nbisby2', None, 'panoramarts', 'ewood8806', 'motoki1', 'rasilva2', 'sshiffe2', 'jstrack2', 'rbhojwa2', 'afromaniac', 'yeunkim2', 'crptone']",86,"['tdburks2', 'ddaza2', 'mmccorm3', 'agibson', 'dharmaturtle', 'hochan5', 'thunghan', 'juan1', 'ljleon', 'japheth', 'tehmonk', 'wfergus2', 'tsaucer', 'caromu', 'ucabraal', 'choi129', 'hess8', 'kboger2', 'wu14', 'yhuang38', 'aldirin1', 'wangwei420', 'jruzic2', 'gmeyer3', 'spadoni2', 'rgoble', 'swieren1', 'mmadeja2', 'cloud1', 'johan1', 'anwen', 'smustaf2', 'rskirby2', 'hchoi32', 'ebecker', 'ass1085', 'freddycheu', 'han23', 'mlee71', 'ttapers', 'loganliu1', 'nayak2', 'niemerg1', 'xhuang25', 'yapjiun1', 'slhertz', 'crptone', 'chang87', 'eva_chi', 'jain10', 'jiangj001', 'resquiv2', 'pi_factorial', 'zumbahl1', 'larsgtb', 'mtrower2', 'johnseo2', 'akong2', 'liao27', 'trieuvu1', 'klinga88', 'jbae5', 'sgopal4', 'enzelu1', 'apung', 'frankzheng329', 'gupta40', 'canandagdeviren', 'charishma', 'liu181', 'mstrom', 'kylemore04', 'lieberae', 'fox6606', 'nbisby2', None, 'panoramarts', 'ewood8806', 'motoki1', 'rasilva2', 'sshiffe2', 'jstrack2', 'rbhojwa2', 'afromaniac', 'yeunkim2', 'jlorenz3']"
21,50,14,47,3,"['ttapers', 'pi_factorial', 'jlorenz3']",10,"['ljleon', 'rgoble', 'eva_chi', 'kylemore04', 'loganliu1', 'tsaucer', 'yapjiun1', 'hess8', 'lieberae', 'apung']",44,"['sskim20', 'sbhaler2', 'resquiv2', 'wkelleh2', 'acedamace', 'thunghan', 'green16', 'wfergus2', 'carter6', 'xliu34', 'dlowry2', 'driscoll42', 'vali0227', 'bfogel2', 'choi129', 'dstamat2', 'gmeyer3', 'lanhuo1986', 'kylerupp87', 'grillz58', 'kdearnl2', 'luyichen', 'lionelmoh', 'nmahend2', None, 'echavez3', 'timespectrum', 'nbhagat2', 'hfederm2', 'jwester3', 'greenpurdue', 'mkoh', 'tstilz', 'swimjade', 'taliaho', 'intrimind', 'nitramzero', 'burgner2', 'kkroege2', 'dnshah2', 'dhabes2', 'jstrack2', 'yang28', 'meliu2']",57,"['eva_chi', 'sskim20', 'sbhaler2', 'resquiv2', 'pi_factorial', 'wkelleh2', 'acedamace', 'thunghan', 'green16', 'ljleon', 'wfergus2', 'carter6', 'xliu34', 'tsaucer', 'dlowry2', 'driscoll42', 'vali0227', 'bfogel2', 'choi129', 'hess8', 'dstamat2', 'apung', 'gmeyer3', 'lanhuo1986', 'rgoble', 'kylerupp87', 'grillz58', 'kylemore04', 'kdearnl2', 'luyichen', 'lieberae', 'lionelmoh', 'nmahend2', None, 'echavez3', 'timespectrum', 'nbhagat2', 'hfederm2', 'jwester3', 'greenpurdue', 'mkoh', 'tstilz', 'swimjade', 'ttapers', 'loganliu1', 'taliaho', 'intrimind', 'nitramzero', 'burgner2', 'kkroege2', 'dnshah2', 'dhabes2', 'yapjiun1', 'jstrack2', 'yang28', 'meliu2', 'jlorenz3']"
21,49,14,29,1,['rgoble'],12,"['ljleon', 'eva_chi', 'ttapers', 'kylemore04', 'loganliu1', 'tsaucer', 'yapjiun1', 'hess8', 'pi_factorial', 'apung', 'jlorenz3', 'lieberae']",28,"['chen145', 'bcorbett', 'mwkhan', 'ajfunche', 'ashokv', 'jackfrost9p', 'mochoa', 'dandry', 'khuh', 'shelmi', 'jeem9', 'kylerupp87', 'nmustaff', 'svanderl', 'vqnguyen', 'luyichen', 'dhc529', 'pandey', None, 'zebov', 'tim8241', 'pxu', 'zhang118', 'lee251', 'mazad', 'mmakowsk', 'jshehade', 'nstorey']",41,"['chen145', 'mwkhan', 'eva_chi', 'bcorbett', 'pi_factorial', 'ajfunche', 'ljleon', 'tsaucer', 'ashokv', 'jackfrost9p', 'mochoa', 'hess8', 'dandry', 'khuh', 'apung', 'shelmi', 'jeem9', 'rgoble', 'kylerupp87', 'kylemore04', 'nmustaff', 'svanderl', 'vqnguyen', 'luyichen', 'dhc529', 'lieberae', 'pandey', None, 'zebov', 'tim8241', 'ttapers', 'loganliu1', 'pxu', 'zhang118', 'lee251', 'mazad', 'mmakowsk', 'yapjiun1', 'jshehade', 'jlorenz3', 'nstorey']"
21,52,14,24,1,['eva_chi'],12,"['ljleon', 'rgoble', 'ttapers', 'kylemore04', 'loganliu1', 'tsaucer', 'yapjiun1', 'hess8', 'pi_factorial', 'apung', 'jlorenz3', 'lieberae']",23,"['xunjian', 'khapp', 'gmayhew', 'flian2', 'manasgartia', 'cgarner3', 'joejsheehan', 'wu14', 'aldirin1', 'shaofu88', 'cming2', 'pmartin8', 'swieren1', 'grillz58', 'egh1fw', 'momer', 'rchavali', None, 'capmaster', 'atseng3', 'tim8241', 'tonysweet', 'bcerier2']",36,"['eva_chi', 'xunjian', 'gmayhew', 'khapp', 'flian2', 'manasgartia', 'cgarner3', 'pi_factorial', 'ljleon', 'tsaucer', 'hess8', 'joejsheehan', 'wu14', 'apung', 'aldirin1', 'shaofu88', 'cming2', 'pmartin8', 'rgoble', 'swieren1', 'grillz58', 'kylemore04', 'egh1fw', 'momer', 'rchavali', 'lieberae', None, 'capmaster', 'atseng3', 'tim8241', 'ttapers', 'tonysweet', 'bcerier2', 'loganliu1', 'yapjiun1', 'jlorenz3']"
21,53,14,7,1,['kylemore04'],12,"['ljleon', 'rgoble', 'eva_chi', 'ttapers', 'tsaucer', 'loganliu1', 'yapjiun1', 'hess8', 'pi_factorial', 'apung', 'jlorenz3', 'lieberae']",6,"['fonkafno', 'mjermann', 's0undfl0w', 'yhuang38', 'fox6606', None]",19,"['rgoble', 'eva_chi', 'kylemore04', 'pi_factorial', 'lieberae', 'fox6606', None, 'fonkafno', 'mjermann', 'ljleon', 'ttapers', 'tsaucer', 'loganliu1', 'yapjiun1', 'hess8', 's0undfl0w', 'yhuang38', 'apung', 'jlorenz3']"
22,156,13,19,12,"['fortissimo', 'shizukuse', 'waterydan', 'huiwen', 'cyyiu', 'leoplct', 'ttk', 'bhsu_tw', 'franky', 'ssai52', 'zcsu', 'player727']",0,[],7,"['vsk', 'kflee2008', 'tmhsieh', 'chestnut', 'mhhan', None, 'samuel2008']",19,"['fortissimo', 'kflee2008', 'waterydan', 'leoplct', 'tmhsieh', 'ttk', 'chestnut', 'franky', 'mhhan', 'ssai52', 'zcsu', None, 'samuel2008', 'vsk', 'shizukuse', 'huiwen', 'cyyiu', 'bhsu_tw', 'player727']"
23,69,13,36,7,"['spaceel', 'jcwirth', 'beneintray', 'jzeng', 'tseyulin', 'park249', 'kmcmulle']",5,"['joywith', 'dswood', 'ykubo', 'alolita', 'neala']",29,"['hjscow0421', 'ramon', 'mchaffee', 'alexandercartagena', 'amberlei', 'ashokv', 'mochoa', 'apenumat', 'mfoxe', 'shelmi', 'smilingdonglin', 'jeem9', 'rchavali', 'nyahzarate', 'nmustaff', 'svanderl', 'gu0', 'qiub', 'yanhuostar', None, 'rohitv16', 'zebov', 'tim8241', 'ziyunlong', 'schoday', 'mmakowsk', 'mpalenik', 'jshehade', 'xiongg']",41,"['hjscow0421', 'dswood', 'ykubo', 'ramon', 'park249', 'mchaffee', 'alexandercartagena', 'joywith', 'amberlei', 'ashokv', 'mochoa', 'kmcmulle', 'apenumat', 'mfoxe', 'shelmi', 'smilingdonglin', 'jeem9', 'jcwirth', 'beneintray', 'jzeng', 'rchavali', 'tseyulin', 'nyahzarate', 'nmustaff', 'alolita', 'gu0', 'svanderl', 'qiub', 'yanhuostar', None, 'rohitv16', 'zebov', 'spaceel', 'tim8241', 'ziyunlong', 'schoday', 'mmakowsk', 'neala', 'mpalenik', 'jshehade', 'xiongg']"
23,7,13,19,8,"['joywith', 'spaceel', 'jcwirth', 'ykubo', 'jzeng', 'tseyulin', 'park249', 'kmcmulle']",4,"['alolita', 'beneintray', 'dswood', 'neala']",11,"['hjscow0421', 'tim8241', 'deseal', 'rchavali', 'ashokv', 'mmakowsk', 'mochoa', None, 'mfoxe', 'shelmi', 'xiongg']",23,"['hjscow0421', 'dswood', 'jcwirth', 'beneintray', 'ykubo', 'jzeng', 'rchavali', 'tseyulin', 'park249', 'alolita', None, 'joywith', 'spaceel', 'tim8241', 'deseal', 'ashokv', 'mmakowsk', 'mochoa', 'neala', 'kmcmulle', 'mfoxe', 'shelmi', 'xiongg']"
23,12,13,19,4,"['tseyulin', 'park249', 'kmcmulle', 'dswood']",8,"['joywith', 'spaceel', 'jcwirth', 'beneintray', 'ykubo', 'jzeng', 'neala', 'alolita']",15,"['jeem9', 'wlpierret', 'schoday', 'saxep01', 'jakho', 'deseal', 'ashokv', 'mmakowsk', None, 'cocker867', 'jainrajat11', 'obernada', 'mfoxe', 'shelmi', 'cdelker']",27,"['jeem9', 'dswood', 'jakho', 'jcwirth', 'beneintray', 'ykubo', 'jzeng', 'tseyulin', 'park249', 'alolita', 'cocker867', 'obernada', None, 'joywith', 'spaceel', 'wlpierret', 'schoday', 'saxep01', 'deseal', 'ashokv', 'mmakowsk', 'neala', 'kmcmulle', 'jainrajat11', 'mfoxe', 'shelmi', 'cdelker']"
23,135,13,13,2,"['kmcmulle', 'jzeng']",10,"['joywith', 'spaceel', 'dswood', 'jcwirth', 'beneintray', 'ykubo', 'tseyulin', 'park249', 'neala', 'alolita']",11,"['amitagarwal', 'jeem9', 'jshehade', 'jakho', 'ramon', 'nmustaff', 'dhc529', 'apenumat', 'qiub', None, 'xiongg']",23,"['jeem9', 'dswood', 'jakho', 'jcwirth', 'beneintray', 'ykubo', 'jzeng', 'tseyulin', 'ramon', 'park249', 'alolita', 'nmustaff', 'dhc529', 'qiub', None, 'amitagarwal', 'joywith', 'spaceel', 'neala', 'kmcmulle', 'apenumat', 'jshehade', 'xiongg']"
23,72,13,9,4,"['spaceel', 'ykubo', 'dswood', 'beneintray']",8,"['joywith', 'jcwirth', 'jzeng', 'tseyulin', 'park249', 'neala', 'kmcmulle', 'alolita']",5,"['donkey20040469', 'smith172', 'mpalenik', 'mqlion01', None]",17,"['donkey20040469', 'dswood', 'jcwirth', 'beneintray', 'ykubo', 'jzeng', 'tseyulin', 'park249', 'alolita', 'smith172', 'mqlion01', None, 'joywith', 'spaceel', 'neala', 'kmcmulle', 'mpalenik']"
24,99,13,17,10,"['kcollins6', 'fsparverius2', 'kcollins5', 'kcollins4', 'kcollins3', 'fsparverius4', 'nanohubmd', 'kcollins2', 'fsparverius3', 'andymuto2']",2,"['bivas', 'baijingwei']",7,"['gojones', 'dceresoli', None, 'fsparverius', 'kcollins', 'yihenano', 'andymuto']",19,"['kcollins6', 'kcollins3', 'fsparverius4', 'dceresoli', 'nanohubmd', 'fsparverius', 'bivas', 'baijingwei', 'fsparverius3', 'yihenano', 'andymuto2', None, 'andymuto', 'fsparverius2', 'kcollins5', 'kcollins4', 'kcollins', 'kcollins2', 'gojones']"
24,100,13,15,6,"['fsparverius2', 'fsparverius4', 'nanohubmd', 'kcollins2', 'fsparverius3', 'andymuto2']",6,"['kcollins6', 'kcollins5', 'kcollins4', 'kcollins3', 'bivas', 'baijingwei']",9,"['alenert', 'lkwagner', 'jeongyun', 'jgrossman', None, 'fsparverius', 'kcollins', 'yihenano', 'andymuto']",21,"['kcollins6', 'kcollins3', 'fsparverius4', 'nanohubmd', 'fsparverius', 'bivas', 'baijingwei', 'fsparverius3', 'jgrossman', 'yihenano', 'andymuto2', None, 'andymuto', 'alenert', 'fsparverius2', 'kcollins5', 'kcollins4', 'lkwagner', 'jeongyun', 'kcollins2', 'kcollins']"
25,93,12,26,1,['isamini'],10,"['hosummo', 'jmbernie', 'brain2331', 'zbode05', 'cheerfulshiva', 'jmlisenb', 'jestout', 'jhart1988', 'dchowe', 'nkhatri50']",25,"['javiercastillo', 'eleggo', 'faraon956', 'melody1007', 'mattdit9', 'cnunezc', 'hhuq', 'ybai', 'eriosc2', 'pavanjasti', 'xt3rmin8', 'jsanchezy23', 'drodriguezz4', 'linaalvarez', 'harlingenkid06', 'aaviles25', 'relizondozy', None, 'rriosz18', 'arod923', 'kumadbindu', 'swathipriya', 'agarciagr', 'ssingam', 'arloedx']",36,"['javiercastillo', 'eleggo', 'faraon956', 'melody1007', 'zbode05', 'mattdit9', 'cnunezc', 'hhuq', 'jmlisenb', 'ybai', 'eriosc2', 'pavanjasti', 'ssingam', 'hosummo', 'jmbernie', 'brain2331', 'xt3rmin8', 'jsanchezy23', 'drodriguezz4', 'linaalvarez', 'isamini', 'harlingenkid06', 'aaviles25', 'relizondozy', None, 'rriosz18', 'arod923', 'cheerfulshiva', 'kumadbindu', 'swathipriya', 'jestout', 'jhart1988', 'dchowe', 'agarciagr', 'nkhatri50', 'arloedx']"
25,150,12,11,8,"['hosummo', 'zbode05', 'brain2331', 'jmbernie', 'jestout', 'jmlisenb', 'jhart1988', 'nkhatri50']",3,"['dchowe', 'cheerfulshiva', 'isamini']",3,"['hredahegn', 'hauptjaeger', None]",14,"['isamini', 'zbode05', 'jmlisenb', None, 'hauptjaeger', 'hosummo', 'hredahegn', 'jmbernie', 'brain2331', 'cheerfulshiva', 'jestout', 'jhart1988', 'dchowe', 'nkhatri50']"
25,91,12,10,7,"['hosummo', 'zbode05', 'brain2331', 'jmbernie', 'jestout', 'jhart1988', 'nkhatri50']",4,"['dchowe', 'jmlisenb', 'cheerfulshiva', 'isamini']",3,"['hredahegn', None, 'minorthreat']",14,"['isamini', 'zbode05', 'minorthreat', 'jmlisenb', None, 'hosummo', 'hredahegn', 'jmbernie', 'brain2331', 'cheerfulshiva', 'jestout', 'jhart1988', 'dchowe', 'nkhatri50']"
26,181,11,20,6,"['wjchoi', 'liuyichem', 'mukul', 'topquark', 'dkraemer', 'helasrag']",4,"['tewers', 'jdedrick', 'michellepaquette', 'ezzeldin']",14,"['alenert', 'gojones', 'hse0305', 'keten', 'dceresoli', 'brynwaldwick', 'shengxingstars', 'jgrossman', None, 'shchlin', 'fsparverius', 'kcollins', 'yihenano', 'andymuto']",24,"['wjchoi', 'gojones', 'ezzeldin', 'dceresoli', 'dkraemer', 'jdedrick', 'fsparverius', 'jgrossman', 'helasrag', 'yihenano', None, 'andymuto', 'alenert', 'hse0305', 'keten', 'tewers', 'liuyichem', 'michellepaquette', 'mukul', 'topquark', 'brynwaldwick', 'shengxingstars', 'shchlin', 'kcollins']"
26,184,11,14,1,['dkraemer'],9,"['wjchoi', 'ezzeldin', 'tewers', 'liuyichem', 'michellepaquette', 'mukul', 'topquark', 'jdedrick', 'helasrag']",13,"['alenert', 'gojones', 'dceresoli', 'elifleaf', 'brynwaldwick', 'yihenano', 'shengxingstars', 'xuzhiping', 'nanoe', 'fsparverius', 'kcollins', None, 'andymuto']",23,"['wjchoi', 'gojones', 'ezzeldin', 'dceresoli', 'dkraemer', 'jdedrick', 'nanoe', 'fsparverius', 'helasrag', None, 'xuzhiping', 'yihenano', 'andymuto', 'alenert', 'tewers', 'liuyichem', 'michellepaquette', 'mukul', 'topquark', 'brynwaldwick', 'shengxingstars', 'elifleaf', 'kcollins']"
26,182,11,8,1,['michellepaquette'],9,"['wjchoi', 'ezzeldin', 'tewers', 'liuyichem', 'mukul', 'topquark', 'dkraemer', 'jdedrick', 'helasrag']",7,"['taianap', 'crowan', 'chapmanc', 'iasirom', 'kdaze', None, 'yinanshi']",17,"['wjchoi', 'ezzeldin', 'tewers', 'liuyichem', 'michellepaquette', 'taianap', 'mukul', 'topquark', 'kdaze', 'dkraemer', 'jdedrick', 'crowan', 'chapmanc', 'iasirom', 'helasrag', None, 'yinanshi']"
28,163,10,50,8,"['chen145', 'kylerupp87', 'pjcannon', 'taliaho', 'pxu', 'zhang118', 'lee251', 'vqnguyen']",1,['green16'],42,"['manakaw', 'hirawan', 'eenginerd', 'arthurfacon', 'purukhandue', 'jamescui', 'mconaboy', 'ajfunche', 'petey27', 'john3636', 'afrierso', 'choi1', 'deguzouw', 'jackfrost9p', 'cbean', 'zhang205', 'rpithadi', 'yangliqun', 'jainrajat11', 'khuh', 'mhlebask', 'kmmaurer', 'panren2006', 'wtowens', 'tkazokas', 'ratanrego', 'dwilkes', 'dtracy', 'kmsj2', 'weim', 'pandey', 'aaronmudd', 'obernada', None, 'greenpurdue', 'pasera', 'vahuja', 'mazad', 'thartman', 'abishmalik', 'kbyun', 'tdougan']",51,"['manakaw', 'hirawan', 'chen145', 'eenginerd', 'pjcannon', 'arthurfacon', 'purukhandue', 'jamescui', 'mconaboy', 'ajfunche', 'petey27', 'green16', 'john3636', 'afrierso', 'choi1', 'deguzouw', 'jackfrost9p', 'cbean', 'zhang205', 'rpithadi', 'yangliqun', 'jainrajat11', 'khuh', 'mhlebask', 'kmmaurer', 'kylerupp87', 'panren2006', 'wtowens', 'tkazokas', 'ratanrego', 'dwilkes', 'vqnguyen', 'dtracy', 'kmsj2', 'weim', 'pandey', 'aaronmudd', 'obernada', None, 'greenpurdue', 'pasera', 'vahuja', 'taliaho', 'pxu', 'zhang118', 'lee251', 'mazad', 'thartman', 'abishmalik', 'kbyun', 'tdougan']"
28,50,10,47,3,"['green16', 'kylerupp87', 'taliaho']",6,"['chen145', 'pjcannon', 'pxu', 'zhang118', 'lee251', 'vqnguyen']",44,"['sskim20', 'meliu2', 'sbhaler2', 'resquiv2', 'pi_factorial', 'wkelleh2', 'acedamace', 'thunghan', 'wfergus2', 'carter6', 'dlowry2', 'driscoll42', 'vali0227', 'bfogel2', 'choi129', 'dstamat2', 'gmeyer3', 'lanhuo1986', 'grillz58', 'kdearnl2', 'luyichen', 'lionelmoh', 'nmahend2', None, 'echavez3', 'timespectrum', 'nbhagat2', 'hfederm2', 'jwester3', 'greenpurdue', 'mkoh', 'tstilz', 'swimjade', 'ttapers', 'intrimind', 'nitramzero', 'burgner2', 'kkroege2', 'dnshah2', 'dhabes2', 'jstrack2', 'yang28', 'xliu34', 'jlorenz3']",53,"['chen145', 'sskim20', 'pjcannon', 'sbhaler2', 'resquiv2', 'pi_factorial', 'wkelleh2', 'acedamace', 'thunghan', 'green16', 'wfergus2', 'carter6', 'xliu34', 'dlowry2', 'driscoll42', 'vali0227', 'bfogel2', 'choi129', 'dstamat2', 'gmeyer3', 'lanhuo1986', 'kylerupp87', 'grillz58', 'kdearnl2', 'vqnguyen', 'luyichen', 'lionelmoh', 'nmahend2', None, 'echavez3', 'timespectrum', 'nbhagat2', 'hfederm2', 'jwester3', 'greenpurdue', 'mkoh', 'tstilz', 'swimjade', 'ttapers', 'taliaho', 'intrimind', 'pxu', 'zhang118', 'lee251', 'nitramzero', 'burgner2', 'kkroege2', 'dnshah2', 'dhabes2', 'jstrack2', 'yang28', 'meliu2', 'jlorenz3']"
28,49,10,29,6,"['chen145', 'kylerupp87', 'pxu', 'zhang118', 'lee251', 'vqnguyen']",3,"['green16', 'pjcannon', 'taliaho']",23,"['bcorbett', 'mwkhan', 'ajfunche', 'ashokv', 'jackfrost9p', 'mochoa', 'dandry', 'khuh', 'shelmi', 'jeem9', 'rgoble', 'nmustaff', 'svanderl', 'luyichen', 'dhc529', 'pandey', None, 'zebov', 'tim8241', 'mmakowsk', 'mazad', 'jshehade', 'nstorey']",32,"['chen145', 'mwkhan', 'bcorbett', 'pjcannon', 'ajfunche', 'green16', 'ashokv', 'jackfrost9p', 'mochoa', 'dandry', 'khuh', 'shelmi', 'jeem9', 'kylerupp87', 'rgoble', 'nmustaff', 'svanderl', 'vqnguyen', 'luyichen', 'dhc529', 'pandey', None, 'zebov', 'tim8241', 'taliaho', 'pxu', 'zhang118', 'lee251', 'mazad', 'mmakowsk', 'jshehade', 'nstorey']"
28,62,10,28,7,"['chen145', 'pjcannon', 'taliaho', 'pxu', 'zhang118', 'lee251', 'vqnguyen']",2,"['green16', 'kylerupp87']",21,"['manakaw', 'mwkhan', 'bcorbett', 'eenginerd', 'arthurfacon', 'ajfunche', 'wlpierret', 'jackfrost9p', 'zhang205', 'dandry', 'jainrajat11', 'dwilkes', 'dtracy', 'kmsj2', 'pandey', 'luyichen', None, 'thartman', 'yang28', 'shin29', 'tdougan']",30,"['manakaw', 'chen145', 'mwkhan', 'bcorbett', 'eenginerd', 'pjcannon', 'arthurfacon', 'ajfunche', 'green16', 'wlpierret', 'jackfrost9p', 'zhang205', 'jainrajat11', 'dandry', 'kylerupp87', 'dwilkes', 'vqnguyen', 'dtracy', 'kmsj2', 'pandey', 'luyichen', None, 'taliaho', 'pxu', 'zhang118', 'lee251', 'thartman', 'yang28', 'shin29', 'tdougan']"
28,130,10,22,5,"['chen145', 'kylerupp87', 'pjcannon', 'zhang118', 'vqnguyen']",4,"['lee251', 'green16', 'taliaho', 'pxu']",17,"['manakaw', 'hirawan', 'greenpurdue', 'mbrigham', 'eenginerd', 'pasera', 'rallyemenz', 'jackfrost9p', 'thartman', 'dtracy', 'luyichen', 'jainrajat11', 'arthurfacon', 'obernada', None, 'tdougan', 'ajfunche']",26,"['manakaw', 'hirawan', 'chen145', 'kylerupp87', 'mbrigham', 'eenginerd', 'pjcannon', 'vqnguyen', 'dtracy', 'luyichen', 'arthurfacon', 'obernada', None, 'rallyemenz', 'ajfunche', 'greenpurdue', 'green16', 'pasera', 'taliaho', 'pxu', 'zhang118', 'lee251', 'jackfrost9p', 'thartman', 'jainrajat11', 'tdougan']"
28,129,10,16,2,"['vqnguyen', 'zhang118']",7,"['chen145', 'kylerupp87', 'green16', 'pjcannon', 'taliaho', 'pxu', 'lee251']",14,"['petey27', 'kmmaurer', 'greenpurdue', 'jhaveri', 'panren2006', 'ratanrego', 'naman', 'jdickers', 'rpithadi', 'yangliqun', 'kbyun', None, 'kbaciaus', 'nstorey']",23,"['kmmaurer', 'chen145', 'kylerupp87', 'jhaveri', 'panren2006', 'pjcannon', 'ratanrego', 'vqnguyen', 'jdickers', None, 'kbaciaus', 'petey27', 'greenpurdue', 'green16', 'taliaho', 'pxu', 'zhang118', 'lee251', 'naman', 'rpithadi', 'yangliqun', 'kbyun', 'nstorey']"
28,13,10,7,1,['lee251'],8,"['chen145', 'kylerupp87', 'green16', 'pjcannon', 'taliaho', 'pxu', 'zhang118', 'vqnguyen']",6,"['mwkhan', 'mmakowsk', 'cocker867', 'serekson', 'obernada', None]",15,"['chen145', 'kylerupp87', 'green16', 'mwkhan', 'pjcannon', 'taliaho', 'pxu', 'zhang118', 'lee251', 'mmakowsk', 'vqnguyen', 'cocker867', 'serekson', 'obernada', None]"
29,109,10,187,1,['tjl715'],8,"['moniqueospinal', 'dunny505', 'renoona', 'jtanumihardja', 'moriab', 'bthayer', 'marinen', 'peggywidjaja']",186,"['jlee1', 'spahwa', 'rbarbera', 'jlou', 'kvercauteren', 'yyangtony', 'ablood', 'mkonanur', 'wgrimes', 'jlw553', 'lmao', 'jminuzzo', 'ragarwal', 'ssaha', 'kinzele', 'kshih', 'nkatz', 'vraghunathan', 'askim', 'mdoerfler', 'msimon', 'mrs392', 'mwe', 'tjeong', 'hrayala', 'sprasad09', 'tcheong', 'apetersel', 'kbailey', 'mlee', 'eaguirre', 'dabramov1', 'kleinweber99', 'gkim', 'lmiller', 'tkim1113', 'jsl685', 'benglish013', 'lknapp', 'achoi', 'nrk959', 'mco274', 'gwheaton', 'xli', 'jjkim', 'cschnaith', 'hbang', 'jhutcheson', 'mdalzell', 'eappelt', 'jhoover22', 'njs310', 'acaneva', 'jsy256', 'eyousif', 'ctimpon', 'hlee2013', 'tnasr', 'connieyang', 'pmehta', 'lyu', 'acipiti', 'lsabih', 'kchadha', 'rgrohman', 'coryj', 'haalac', 'nleon', 'jhoover', 'agunn', 'cebben', 'jtownsend', 'bschmidt', None, 'omu863', 'wmccabe', 'amukherjee', 'mread', 'nvasilottos', 'cclu', 'rgoettelman', 'nnemon', 'rsingh24', 'ukkathawalla', 'slhatch', 'acm119', 'hlu', 'jlamano', 'enick', 'btiano', 'mootwo17', 'ujain', 'cmosier', 'jmcknight', 'kbhatt', 'hvanvalkenburgh', 'azheng', 'fhuang', 'gpeal', 'pjethwani', 'cburghard', 'yeseongkim', 'anamath', 'jprindle', 'pscalise', 'bminer', 'hlevine', 'kschmidt', 'jfriedman', 'fallensail', 'ktausk', 'myang', 'ysaxena', 'mtellakat', 'dlin', 'esegre', 'the', 'jwu', 'jnugent', 'soohoahn322', 'ysiddhartha', 'rparikh', 'mgoldberg', 'asampson', 'sgoel', 'danieloh', 'ali436', 'msladek', 'afox', 'rajatverma1', 'mong', 'lyung', 'okusoro', 'nmosberg', 'bcacioppo', 'jzh576', 'tjk1991', 'jluo', 'gursimransingh', 'kaziz', 'gsheldon', 'fchow', 'nkansara', 'kcarson', 'djin', 'syk', 'dshore', 'ltang21', 'ask788', 'qianfz', 'iabbott', 'w00tm0ng3r', 'nrddt', 'anmura', 'zhian', 'okamber', 'rsurrey09', 'jschwarzbauer', 'rlad', 'sferdous', 'dladic', 'ptoth', 'ltran88', 'frichter91', 'dsloan', 'edubois', 'ekesler', 'ksuchun0822', 'arepucci', 'mbohorquez', 'jwarlick', 'rsubramanian', 'fcummins', 'randywaymire', 'benjaminceaser2013', 'theinhibitor', 'mfischer', 'bchao', 'sbailey', 'jli1', 'ase548', 'hjeon', 'kashif', 'smparker', 'jchurchill', 'aiglesias']",195,"['jlee1', 'spahwa', 'rbarbera', 'jlou', 'kvercauteren', 'yyangtony', 'ablood', 'mkonanur', 'wgrimes', 'jlw553', 'lmao', 'jminuzzo', 'ragarwal', 'ssaha', 'jtanumihardja', 'kinzele', 'kshih', 'nkatz', 'vraghunathan', 'askim', 'mdoerfler', 'msimon', 'mrs392', 'mwe', 'tjeong', 'hrayala', 'sprasad09', 'tcheong', 'apetersel', 'kbailey', 'mlee', 'eaguirre', 'dabramov1', 'kleinweber99', 'gkim', 'lmiller', 'tkim1113', 'jsl685', 'benglish013', 'lknapp', 'achoi', 'marinen', 'nrk959', 'mco274', 'gwheaton', 'peggywidjaja', 'xli', 'jjkim', 'cschnaith', 'hbang', 'dunny505', 'jhutcheson', 'mdalzell', 'eappelt', 'jhoover22', 'njs310', 'acaneva', 'jsy256', 'eyousif', 'ctimpon', 'hlee2013', 'tnasr', 'connieyang', 'bthayer', 'pmehta', 'lyu', 'acipiti', 'lsabih', 'kchadha', 'rgrohman', 'coryj', 'haalac', 'nleon', 'jhoover', 'agunn', 'cebben', 'jtownsend', 'bschmidt', None, 'omu863', 'wmccabe', 'amukherjee', 'mread', 'nvasilottos', 'cclu', 'rgoettelman', 'nnemon', 'rsingh24', 'ukkathawalla', 'slhatch', 'acm119', 'hlu', 'jlamano', 'enick', 'btiano', 'mootwo17', 'ujain', 'cmosier', 'jmcknight', 'kbhatt', 'hvanvalkenburgh', 'azheng', 'fhuang', 'gpeal', 'pjethwani', 'cburghard', 'yeseongkim', 'anamath', 'jprindle', 'pscalise', 'bminer', 'hlevine', 'kschmidt', 'jfriedman', 'fallensail', 'ktausk', 'myang', 'ysaxena', 'mtellakat', 'dlin', 'esegre', 'the', 'jwu', 'jnugent', 'soohoahn322', 'ysiddhartha', 'rparikh', 'mgoldberg', 'asampson', 'sgoel', 'danieloh', 'ali436', 'msladek', 'afox', 'rajatverma1', 'mong', 'lyung', 'okusoro', 'nmosberg', 'bcacioppo', 'jzh576', 'tjk1991', 'jluo', 'gursimransingh', 'kaziz', 'gsheldon', 'fchow', 'nkansara', 'kcarson', 'djin', 'syk', 'dshore', 'ltang21', 'ask788', 'renoona', 'qianfz', 'iabbott', 'w00tm0ng3r', 'nrddt', 'anmura', 'zhian', 'okamber', 'tjl715', 'rsurrey09', 'jschwarzbauer', 'rlad', 'moniqueospinal', 'sferdous', 'dladic', 'ptoth', 'ltran88', 'frichter91', 'dsloan', 'edubois', 'moriab', 'ekesler', 'ksuchun0822', 'arepucci', 'mbohorquez', 'jwarlick', 'rsubramanian', 'fcummins', 'randywaymire', 'benjaminceaser2013', 'theinhibitor', 'mfischer', 'bchao', 'sbailey', 'jli1', 'ase548', 'hjeon', 'kashif', 'smparker', 'jchurchill', 'aiglesias']"
29,108,10,8,6,"['moniqueospinal', 'renoona', 'dunny505', 'jtanumihardja', 'moriab', 'peggywidjaja']",3,"['tjl715', 'bthayer', 'marinen']",2,"[None, 'melissad']",11,"['moniqueospinal', 'melissad', 'renoona', 'dunny505', 'jtanumihardja', 'moriab', 'bthayer', 'marinen', 'peggywidjaja', 'tjl715', None]"
30,102,10,32,9,"['yuxingangzju', 'zhiying', 'mohammad_shayeste', 'ull124', 'nanosolar', 'hchhide', 'meixian82', 'vivi6', 'sreramanm']",0,[],23,"['osso', 'neo781017', 'spritelala', 'gbal', 'emibac', 'stahel', 'bellmanz', 'srinivasan1984', 'exampleoma', 'olyaei', 'rouget', 'aminkhan', 'behnambanan', 'pankaj_kvhld', 'tiboy', 'zhohuo', 'mitrasomak', 'moeen84', 'rok1986', 'ogus', 'littlemooncake', None, 'athom']",32,"['yuxingangzju', 'osso', 'neo781017', 'spritelala', 'gbal', 'emibac', 'stahel', 'hchhide', 'bellmanz', 'srinivasan1984', 'exampleoma', 'sreramanm', 'olyaei', 'zhiying', 'rouget', 'mohammad_shayeste', 'nanosolar', 'vivi6', 'aminkhan', 'behnambanan', 'pankaj_kvhld', 'tiboy', 'zhohuo', 'mitrasomak', 'moeen84', 'rok1986', 'ogus', 'meixian82', 'littlemooncake', None, 'athom', 'ull124']"
30,67,10,28,8,"['yuxingangzju', 'zhiying', 'mohammad_shayeste', 'ull124', 'nanosolar', 'hchhide', 'vivi6', 'sreramanm']",1,['meixian82'],20,"['osso', 'neo781017', 'spritelala', 'mariaana', 'stahel', 'bellmanz', 'srinivasan1984', 'exampleoma', 'venkey', 'olyaei', 'm_maziar', 'behnambanan', 'pankaj_kvhld', 'moeen84', 'mitrasomak', 'rok1986', 'littlemooncake', None, 'athom', 'tiabilly']",29,"['yuxingangzju', 'osso', 'neo781017', 'spritelala', 'mariaana', 'stahel', 'hchhide', 'bellmanz', 'srinivasan1984', 'exampleoma', 'sreramanm', 'venkey', 'olyaei', 'm_maziar', 'zhiying', 'mohammad_shayeste', 'nanosolar', 'vivi6', 'behnambanan', 'pankaj_kvhld', 'moeen84', 'mitrasomak', 'rok1986', 'meixian82', 'littlemooncake', None, 'athom', 'tiabilly', 'ull124']"
30,11,10,27,1,['vivi6'],8,"['yuxingangzju', 'zhiying', 'mohammad_shayeste', 'ull124', 'nanosolar', 'hchhide', 'meixian82', 'sreramanm']",26,"['osso', 'fiammengo', 'neo781017', 'spritelala', 'gbal', 'mikkni', 'emibac', 'stahel', 'exampleoma', 'rouget', 'chensi', 'aminkhan', 'behnambanan', 'pankaj_kvhld', 'tiboy', 'zhohuo', 'mitrasomak', 'moeen84', 'rok1986', 'ogus', 'littlemooncake', None, 'athom', 'tiabilly', 'mingyu', 'cmalric']",35,"['yuxingangzju', 'fiammengo', 'osso', 'neo781017', 'spritelala', 'gbal', 'mikkni', 'emibac', 'stahel', 'hchhide', 'exampleoma', 'sreramanm', 'zhiying', 'rouget', 'mohammad_shayeste', 'nanosolar', 'chensi', 'vivi6', 'aminkhan', 'behnambanan', 'pankaj_kvhld', 'tiboy', 'zhohuo', 'mitrasomak', 'moeen84', 'rok1986', 'ogus', 'meixian82', 'littlemooncake', None, 'athom', 'tiabilly', 'ull124', 'mingyu', 'cmalric']"
30,10,10,25,1,['vivi6'],8,"['yuxingangzju', 'zhiying', 'mohammad_shayeste', 'ull124', 'nanosolar', 'hchhide', 'meixian82', 'sreramanm']",24,"['osso', 'fiammengo', 'neo781017', 'spritelala', 'mikkni', 'mariaana', 'stahel', 'srinivasan1984', 'olyaei', 'rouget', 'chensi', 'aminkhan', 'behnambanan', 'pankaj_kvhld', 'tiboy', 'zhohuo', 'mitrasomak', 'rok1986', 'ogus', 'littlemooncake', None, 'athom', 'tiabilly', 'cmalric']",33,"['yuxingangzju', 'fiammengo', 'osso', 'neo781017', 'spritelala', 'mikkni', 'mariaana', 'stahel', 'hchhide', 'srinivasan1984', 'sreramanm', 'olyaei', 'zhiying', 'rouget', 'mohammad_shayeste', 'nanosolar', 'chensi', 'vivi6', 'aminkhan', 'behnambanan', 'pankaj_kvhld', 'tiboy', 'zhohuo', 'mitrasomak', 'rok1986', 'ogus', 'meixian82', 'littlemooncake', None, 'athom', 'tiabilly', 'ull124', 'cmalric']"
30,92,10,23,9,"['yuxingangzju', 'zhiying', 'mohammad_shayeste', 'ull124', 'nanosolar', 'hchhide', 'meixian82', 'vivi6', 'sreramanm']",0,[],14,"['m_maziar', 'fiammengo', 'tiboy', 'zhohuo', 'moeen84', 'mariaana', 'rok1986', 'stahel', 'jmpm2', 'jmpm', 'srinivasan1984', 'aminkhan', None, 'olyaei']",23,"['yuxingangzju', 'fiammengo', 'mariaana', 'stahel', 'hchhide', 'srinivasan1984', 'sreramanm', 'olyaei', 'm_maziar', 'zhiying', 'mohammad_shayeste', 'nanosolar', 'jmpm2', 'jmpm', 'vivi6', 'aminkhan', 'tiboy', 'zhohuo', 'moeen84', 'rok1986', 'meixian82', None, 'ull124']"
30,139,10,19,8,"['yuxingangzju', 'zhiying', 'ull124', 'nanosolar', 'hchhide', 'meixian82', 'vivi6', 'sreramanm']",1,['mohammad_shayeste'],11,"['allentrue', 'pankaj_kvhld', 'mikkni', 'holmeschow052310', 'emibac', 'mariaana', 'stahel', 'jmpm', 'exampleoma', 'littlemooncake', None]",20,"['yuxingangzju', 'allentrue', 'pankaj_kvhld', 'mikkni', 'mariaana', 'emibac', 'stahel', 'hchhide', 'meixian82', 'exampleoma', 'littlemooncake', 'sreramanm', None, 'zhiying', 'holmeschow052310', 'ull124', 'mohammad_shayeste', 'nanosolar', 'jmpm', 'vivi6']"
30,103,10,8,6,"['yuxingangzju', 'zhiying', 'ull124', 'nanosolar', 'hchhide', 'vivi6']",3,"['sreramanm', 'meixian82', 'mohammad_shayeste']",2,"[None, 'olyaei']",11,"['yuxingangzju', 'zhiying', 'ull124', 'mohammad_shayeste', 'nanosolar', None, 'hchhide', 'meixian82', 'vivi6', 'sreramanm', 'olyaei']"
31,85,9,30,5,"['tostostos', 'irmakcomert', 'fevzi', 'cagripeker2', 'erdem']",3,"['ankur', 'gauravcemk', 'esin']",25,"['omerfaruk', 'ufukyaman', 'ardak8', 'citoglu', 'mhmtmtl', 'hakancu01', 'bozbey00', 'basakd', 'bugrabalaban', 'hasipekserhat', 'kurch', 'utkuse', 'mtzng', 'yalcine', 'inanc', 'oaktas', 'xilmarillon', None, 'hsumer', 'feze', 'gulesn', 'ahmetoz', 'm_aras', 'chinar', 'shoke']",33,"['omerfaruk', 'ufukyaman', 'ardak8', 'gauravcemk', 'citoglu', 'mhmtmtl', 'hakancu01', 'bozbey00', 'irmakcomert', 'esin', 'basakd', 'bugrabalaban', 'hasipekserhat', 'ankur', 'kurch', 'utkuse', 'mtzng', 'yalcine', 'inanc', 'oaktas', 'xilmarillon', 'fevzi', None, 'hsumer', 'feze', 'gulesn', 'ahmetoz', 'tostostos', 'm_aras', 'chinar', 'cagripeker2', 'erdem', 'shoke']"
31,86,9,12,1,['esin'],7,"['gauravcemk', 'tostostos', 'irmakcomert', 'ankur', 'fevzi', 'cagripeker2', 'erdem']",11,"['omerfaruk', 'erdi', 'snbelenli', 'hsumer', 'citoglu', 'hakancu01', 'prankieee', None, 'aysegul', 'ergin', 'kmgzn']",19,"['omerfaruk', 'erdi', 'gauravcemk', 'citoglu', 'hakancu01', 'irmakcomert', 'esin', 'fevzi', 'aysegul', 'ergin', None, 'kmgzn', 'hsumer', 'snbelenli', 'tostostos', 'prankieee', 'ankur', 'cagripeker2', 'erdem']"
32,60,8,13,6,"['tela', 'aminnich', 'nvs9', 'novakovic', 'thanatoswang', 'ikukokitamura']",1,['amoham2'],7,"['pschakraborty', 'vihar79', 'mikeggibson', 'jwood1985', 'githin', 'surajsubash', None]",14,"['amoham2', 'aminnich', 'mikeggibson', 'pschakraborty', 'githin', None, 'vihar79', 'tela', 'jwood1985', 'nvs9', 'novakovic', 'surajsubash', 'thanatoswang', 'ikukokitamura']"
32,104,8,13,6,"['tela', 'aminnich', 'nvs9', 'novakovic', 'thanatoswang', 'ikukokitamura']",1,['amoham2'],7,"['pschakraborty', 'vihar79', 'mikeggibson', 'jwood1985', 'githin', 'surajsubash', None]",14,"['amoham2', 'aminnich', 'mikeggibson', 'pschakraborty', 'githin', None, 'vihar79', 'tela', 'jwood1985', 'nvs9', 'novakovic', 'surajsubash', 'thanatoswang', 'ikukokitamura']"
32,169,8,13,6,"['tela', 'aminnich', 'nvs9', 'novakovic', 'thanatoswang', 'ikukokitamura']",1,['amoham2'],7,"['pschakraborty', 'vihar79', 'mikeggibson', 'jwood1985', 'githin', 'surajsubash', None]",14,"['amoham2', 'aminnich', 'mikeggibson', 'pschakraborty', 'githin', None, 'vihar79', 'tela', 'jwood1985', 'nvs9', 'novakovic', 'surajsubash', 'thanatoswang', 'ikukokitamura']"
33,144,8,51,7,"['kbernard', 'jcagadas', 'nisha89', 'amodtimalsina', 'agdoutou', 'aku108', 'sjd345']",0,[],44,"['dkim2', 'heatherhelledge', 'claybrengman', 'edsmith13', 'laurendavis2010', 'aeng', 'schia', 'sflood', 'afrancescatti', 'cbarrett', 'awong42', 'scombs', 'smurcko', 'laherro', 'ecuares', 'dkargman', 'erinanncook', 'smazo', 'ckonfirst', 'clau', 'jsainte', '8u9i0o', 'bclegg56', 'mkamradt1', 'bferdinand', 'tlw893', 'mczech', 'wendyjo410', 'sthottathil', 'phue', 'nickkm7', 'sflorczak', 'smorris', 'jchertow', None, 'dwu417', 'jasanchez', 'evitt', 'mez377', 'raznaahmad', 'fka560', 'choward28', 'svillalpando', 'lauralep']",51,"['dkim2', 'heatherhelledge', 'claybrengman', 'nisha89', 'edsmith13', 'laurendavis2010', 'aeng', 'schia', 'svillalpando', 'sflood', 'afrancescatti', 'cbarrett', 'awong42', 'scombs', 'smurcko', 'laherro', 'ecuares', 'dkargman', 'erinanncook', 'smazo', 'ckonfirst', 'clau', 'jsainte', 'agdoutou', '8u9i0o', 'bclegg56', 'mkamradt1', 'bferdinand', 'tlw893', 'mczech', 'wendyjo410', 'sthottathil', 'phue', 'nickkm7', 'sflorczak', 'smorris', 'jchertow', None, 'dwu417', 'jasanchez', 'evitt', 'kbernard', 'jcagadas', 'mez377', 'amodtimalsina', 'raznaahmad', 'aku108', 'fka560', 'choward28', 'sjd345', 'lauralep']"
34,107,8,12,7,"['awesometa2014', 'jharris', 'mimilou78', 'mpersoni', 'vharrison', 'mblalonde', 'tashadrake2014']",0,[],5,"['kang1120', 'anmura', None, 'zhian', 'smparker']",12,"['kang1120', 'jharris', 'vharrison', None, 'awesometa2014', 'mimilou78', 'mpersoni', 'anmura', 'mblalonde', 'zhian', 'smparker', 'tashadrake2014']"
36,154,7,7,1,['max1030'],5,"['ppatel', 'kianchang', 'ppp134', 'somaia_sylvia', 'kite']",6,"['alfredolee', 'sedusedu', 'omh2125', 'pandori79', 'min1905', None]",12,"['ppatel', 'alfredolee', 'sedusedu', 'max1030', 'kianchang', 'min1905', 'ppp134', 'somaia_sylvia', 'kite', 'omh2125', 'pandori79', None]"
39,118,7,10,5,"['djva', 'lucanadaletto', 'baldo', 'benzo', 'fpga']",1,['smodis85'],5,"['mbraccioli', 'loris', 'ferrino', None, 'newhouse']",11,"['djva', 'lucanadaletto', 'ferrino', None, 'newhouse', 'mbraccioli', 'loris', 'baldo', 'smodis85', 'benzo', 'fpga']"
39,120,7,8,4,"['djva', 'smodis85', 'benzo', 'fpga']",2,"['lucanadaletto', 'baldo']",4,"['cberti', 'jfonta', None, 'newhouse']",10,"['djva', 'lucanadaletto', 'cberti', 'baldo', 'smodis85', 'benzo', 'jfonta', None, 'fpga', 'newhouse']"
39,137,7,7,5,"['djva', 'lucanadaletto', 'smodis85', 'benzo', 'fpga']",1,['baldo'],2,"[None, 'cberti']",8,"['djva', 'lucanadaletto', 'cberti', 'baldo', 'smodis85', 'benzo', None, 'fpga']"
40,6,7,8,1,['anishv'],5,"['jancely', 'll2bf', 'jmikulak', 'sachindubey', 'gbp1984']",7,"['ashraf', 'wlpierret', 'monil2912', 'serekson', 'cocker867', 'chen272', None]",13,"['ashraf', 'jancely', 'll2bf', 'wlpierret', 'monil2912', 'jmikulak', 'sachindubey', 'serekson', 'gbp1984', 'cocker867', 'chen272', 'anishv', None]"
41,116,7,22,6,"['jscibett', 'yecongwang', 'davidliu', 'dinascraz01', 'pmccallu', 'alimiadi']",0,[],16,"['biswajit025', 'bharath88', 'dannyguo', 'hessks', 'redwing', 'atambat', 'rohitv16', 'sjmen', 'cheng22', 'linkenghua', 'dotorres', 'reid', 'aritchey', None, 'smilingdonglin', 'potax']",22,"['biswajit025', 'jscibett', 'hessks', 'atambat', 'dinascraz01', 'dotorres', None, 'rohitv16', 'pmccallu', 'alimiadi', 'bharath88', 'yecongwang', 'dannyguo', 'redwing', 'davidliu', 'sjmen', 'cheng22', 'linkenghua', 'reid', 'aritchey', 'smilingdonglin', 'potax']"
41,189,7,19,5,"['jscibett', 'davidliu', 'alimiadi', 'dinascraz01', 'pmccallu']",1,['yecongwang'],14,"['biswajit025', 'tomcool420', 'okeles', 'dannyguo', 'hessks', 'redwing', 'dkearney', 'clarksm', 'cheng22', 'linkenghua', 'alexb2539', 'aritchey', None, 'potax']",20,"['biswajit025', 'tomcool420', 'okeles', 'jscibett', 'hessks', 'dkearney', 'clarksm', 'dinascraz01', 'alexb2539', None, 'pmccallu', 'alimiadi', 'yecongwang', 'dannyguo', 'redwing', 'davidliu', 'cheng22', 'linkenghua', 'aritchey', 'potax']"
41,113,7,16,5,"['yecongwang', 'davidliu', 'alimiadi', 'dinascraz01', 'pmccallu']",1,['jscibett'],11,"['biswajit025', 'okeles', 'rcolby', 'dannyguo', 'hessks', 'redwing', 'sjmen', 'cheng22', 'linkenghua', None, 'potax']",17,"['biswajit025', 'okeles', 'jscibett', 'rcolby', 'hessks', 'dinascraz01', None, 'pmccallu', 'alimiadi', 'yecongwang', 'dannyguo', 'redwing', 'davidliu', 'sjmen', 'cheng22', 'linkenghua', 'potax']"
41,114,7,16,6,"['jscibett', 'yecongwang', 'davidliu', 'dinascraz01', 'pmccallu', 'alimiadi']",0,[],10,"['biswajit025', 'hessks', 'redwing', 'rohitv16', 'sjmen', 'yjing', 'cheng22', 'linkenghua', None, 'smilingdonglin']",16,"['biswajit025', 'jscibett', 'hessks', 'dinascraz01', None, 'rohitv16', 'pmccallu', 'alimiadi', 'yecongwang', 'redwing', 'davidliu', 'sjmen', 'yjing', 'cheng22', 'linkenghua', 'smilingdonglin']"
41,115,7,16,6,"['jscibett', 'yecongwang', 'davidliu', 'dinascraz01', 'pmccallu', 'alimiadi']",0,[],10,"['biswajit025', 'hessks', 'redwing', 'rohitv16', 'sjmen', 'yjing', 'cheng22', None, 'smilingdonglin', 'potax']",16,"['biswajit025', 'jscibett', 'hessks', 'dinascraz01', None, 'rohitv16', 'pmccallu', 'alimiadi', 'yecongwang', 'redwing', 'davidliu', 'sjmen', 'yjing', 'cheng22', 'smilingdonglin', 'potax']"
41,117,7,10,6,"['jscibett', 'yecongwang', 'davidliu', 'dinascraz01', 'pmccallu', 'alimiadi']",0,[],4,"['general_9th', None, 'rohitv16', 'helloyc']",10,"['jscibett', 'general_9th', 'dinascraz01', None, 'rohitv16', 'pmccallu', 'alimiadi', 'yecongwang', 'davidliu', 'helloyc']"
42,105,6,13,5,"['jiwonchang', 'liuxin', 'panfeng1018', 'dvarghe', 'franktank']",0,[],8,"['priyamvada', 'go', 'gongchenghust', 'gkartik', 'arazavie', 'archana1v', None, 'amroy']",13,"['go', 'priyamvada', 'jiwonchang', 'dvarghe', 'franktank', None, 'amroy', 'gongchenghust', 'gkartik', 'arazavie', 'liuxin', 'archana1v', 'panfeng1018']"
42,170,6,10,3,"['liuxin', 'panfeng1018', 'jiwonchang']",2,"['dvarghe', 'franktank']",7,"['go', 'priyamvada', 'gongchenghust', 'gkartik', 'archana1v', None, 'amroy']",12,"['priyamvada', 'go', 'gongchenghust', 'amroy', None, 'gkartik', 'jiwonchang', 'liuxin', 'archana1v', 'panfeng1018', 'dvarghe', 'franktank']"
45,153,6,9,4,"['martina82', 'alessandrobetti', 'giuseppepasetti', 'valentina']",1,['dasteuerman'],5,"['whulanza01', 'jwalczak', 'yabin', 'gekco', None]",10,"['dasteuerman', 'alessandrobetti', 'whulanza01', 'martina82', 'giuseppepasetti', 'yabin', 'jwalczak', 'valentina', 'gekco', None]"
45,123,6,8,4,"['martina82', 'alessandrobetti', 'giuseppepasetti', 'valentina']",1,['dasteuerman'],4,"['yabin', None, 'jwalczak', 'whulanza01']",9,"['dasteuerman', 'alessandrobetti', 'whulanza01', 'martina82', 'giuseppepasetti', 'yabin', 'jwalczak', 'valentina', None]"
48,3,6,38,2,"['mhmalik', 'tgregg']",3,"['bnowak1287', 'rslosser', 'drestes']",36,"['manakaw', 'hirawan', 'vgokhale', 'eenginerd', 'jakho', 'arthurfacon', 'purukhandue', 'mconaboy', 'kbaciaus', 'petey27', 'mshen', 'john3636', 'wlpierret', 'janam', 'afrierso', 'choi1', 'deguzouw', 'cbean', 'rpithadi', 'chen272', 'wapayne', 'panren2006', 'wtowens', 'tkazokas', 'ratanrego', 'dwilkes', 'dtracy', 'weim', 'aaronmudd', 'rallyemenz', None, 'pasera', 'monil2912', 'naman', 'abishmalik', 'kbyun']",41,"['manakaw', 'hirawan', 'vgokhale', 'eenginerd', 'jakho', 'bnowak1287', 'arthurfacon', 'purukhandue', 'mconaboy', 'kbaciaus', 'petey27', 'mshen', 'drestes', 'john3636', 'wlpierret', 'janam', 'afrierso', 'choi1', 'deguzouw', 'cbean', 'tgregg', 'rpithadi', 'chen272', 'wapayne', 'panren2006', 'wtowens', 'tkazokas', 'rslosser', 'ratanrego', 'dwilkes', 'dtracy', 'weim', 'mhmalik', 'aaronmudd', 'rallyemenz', None, 'pasera', 'monil2912', 'naman', 'abishmalik', 'kbyun']"
48,4,6,8,1,['rslosser'],4,"['bnowak1287', 'tgregg', 'drestes', 'mhmalik']",7,"['choi1', 'monil2912', 'tgreenhi', 'serekson', 'mhlebask', None, 'mconaboy']",12,"['drestes', 'rslosser', 'choi1', 'monil2912', 'bnowak1287', 'tgreenhi', 'tgregg', 'serekson', 'mhmalik', 'mhlebask', None, 'mconaboy']"
49,154,6,7,3,"['omh2125', 'pandori79', 'min1905']",2,"['steve01903', 'dorun113']",4,"['alfredolee', 'sedusedu', None, 'max1030']",9,"['alfredolee', 'steve01903', 'sedusedu', 'max1030', 'dorun113', 'omh2125', 'pandori79', 'min1905', None]"
