MClusterID,XClusterID,MClusterSize,XClusterSize,OverlapSize,OverlapMembers,MOnlySize,MOnlyMembers,XOnlySize,XOnlyMembers,CombinedSize,CombinedMembers
1,163,244,259,241,"['aweinstein', 'sdesai', 'sitknee', 'jsyu', 'jchang', 'eausenbaugh', 'jcastro', 'abc138', 'mcr728', 'mkeith', 'car942', 'mbzeitz', 'lmehmeti', 'ehorcher', 'swilliams', 'bbak', 'mtk160', 'nmiller', 'scs771', 'pjang', 'sashpatel81', 'jaimiepark', 'alexholterman', 'daniellefong92', 'nlahner', 'slipov', 'cquinn17', 'psharma', 'tpark', 'suttal', 'kbrohkahn', 'dcheah', 'sjeon', 'jfranke', 'kgeraghty', 'stvrdik', 'blach', 'mlb923', 'nisadesai', 'huwang', 'bmerkle', 'ahb978', 'purpleyuan', 'cchang92', 'prishah', 'charleslin', 'cleclerq', 'ykhwang', 'eys582', 'bgibbons', 'elleanzhang', 'afreedman', 'khuynh', 'asutton', 'hfleming', 'britt518', 'mfmorel', 'tjc797', 'ekwak', 'astaples', 'pknapp', 'kds543', 'mcp349', 'jcd265', 'ppatel7499', 'jmueller', 'mshetty', 'narouzier', 'lhsu', 'szaveri', 'ezaruba', 'skim2010', 'jzhong', 'nsteimel', 'danielnfls', 'pgarg', 'guerrero1', 'nigelng91', 'angcal3', 'yzermeno', 'npyle', 'choiboi68', 'hzhou', 'chahn', 'rterada', 'yuanshi', 'jaj343', 'acortes', 'chrispitler', 'aweatherly1', 'ktaskin', 'kah703', 'prl176', 'paarasmodi', 'bcastle', 'shetzler', 'galexander', 'clockwork', 'dangerousdan', 'jcordes', 'lzhou', 'esmith', 'jyw902', 'kki227', 'htennant', 'brandonalba', 'brianraychen', 'schoi3', 'glee530', 'sre306', 'eklosowiak', 'skadakia', 'kjl432', 'asimon', 'ekaht', 'lmaliakal', 'hreilly', 'lrg923', 'exw190', 'khjoon0502', 'sda387', 'lav127', 'michaelmilazzo', 'lizzo427', 'nrichter', 'jsachg', 'clee2014', 'jaguilar', 'chiggins', 'balegbeleye', 'mattsullivan725', 'cfuentes60618', 'nna341', 'dslaughter', 'nxiao', 'dvenkat', 'agh612', 'aaggarwal', 'tln941', 'jsandler', 'ntorosin', 'lontiveros', 'rem455', 'aawwad', 'jhi551', 'jhalpern', 'ahiggins', 'snandamuri', 'chintanaphol', 'xwen', 'peter8737', 'mso', 'gbudzon', 'dsh278', 'tyu1992', 'williamgross2014', 'alo869', 'rkawashima', 'nreimold', 'amelingercohen', 'rdesai', 'kelly382', 'zrachlin', 'sjiao', 'jalam', 'yfa874', 'cyu13', 'cqin', 'mankenman', 'mjskwarczek1', 'rku147', 'smoon', 'tkukushliev', 'hae201', 'pwzorek', 'ewp790', 'dschuleman', 'jpark17', 'lauren20', 'krc863', 'msc494', 'mtyksinski', 'ryanmcafee', 'jeshicaa', 'khkim', 'ldk310', 'acook', 'sagarwal1', 'sandeepjain', 'jkernes', 'ceb570', 'missalice', 'patman16', 'mcorpuz', 'jmontyiii', 'asong', 'kirstynbesch', 'reb712', 'ychung', 'pka421', 'jjozefiak', 'akansha21', 'hab477', 'dmorrison7778', 'mdm833', 'sreinke', 'aws491', 'ajw873', 'amurray', 'sbagnola', 'tyuan', 'msmith', 'jxamplas', 'mtu', 'mchoi', 'jjain1', 'dylanhirshkowitz', 'dkoo', 'iikene', 'recook', 'emilyf131', 'ejizba', 'ryandeblock', 'lucialee', 'rquan', 'apankaj', 'pkaralis', 'eukoha', 'sshakin', 'tjeppson', 'awl111', 'gracechan715', 'mgomaa', 'swang', 'joannajaros', 'akozminski', 'hmu909', 'jjs439', 'amfrank26', 'vgupta2792', 'vprakash']",3,"['jzhang', 'lshekhtman', 'annas890']",18,"['nrouzier', 'ndesai', 'bashwell', 'stn147', 'jbryman', 'irc506', 'kgo', 'rgd606', 'eza135', 'ani197', 'crowland', 'camora', 'ahristakos', 'joeg', 'bmaldonado', 'ejen', 'aychang', 'veskit2k']",262,"['sdesai', 'jchang', 'jsyu', 'eausenbaugh', 'jcastro', 'mcr728', 'ehorcher', 'scs771', 'bbak', 'mtk160', 'jaimiepark', 'alexholterman', 'daniellefong92', 'nlahner', 'cquinn17', 'psharma', 'tpark', 'dcheah', 'sjeon', 'jfranke', 'irc506', 'bmerkle', 'ahb978', 'prishah', 'eys582', 'bgibbons', 'elleanzhang', 'khuynh', 'asutton', 'hfleming', 'tjc797', 'ekwak', 'kds543', 'mcp349', 'jcd265', 'ndesai', 'jmueller', 'narouzier', 'ezaruba', 'ahristakos', 'jzhong', 'pgarg', 'nigelng91', 'npyle', 'choiboi68', 'rterada', 'jaj343', 'acortes', 'chrispitler', 'galexander', 'dangerousdan', 'jcordes', 'esmith', 'schoi3', 'glee530', 'sre306', 'kjl432', 'ekaht', 'lrg923', 'exw190', 'khjoon0502', 'lav127', 'clee2014', 'jaguilar', 'kgo', 'chiggins', 'mattsullivan725', 'nxiao', 'dvenkat', 'tln941', 'jsandler', 'ahiggins', 'mso', 'gbudzon', 'dsh278', 'bashwell', 'williamgross2014', 'alo869', 'rkawashima', 'rdesai', 'kelly382', 'zrachlin', 'mankenman', 'smoon', 'ewp790', 'dschuleman', 'jpark17', 'lauren20', 'krc863', 'khkim', 'jeshicaa', 'ldk310', 'jkernes', 'missalice', 'ceb570', 'jmontyiii', 'asong', 'kirstynbesch', 'ychung', 'stn147', 'jjozefiak', 'dmorrison7778', 'mdm833', 'aws491', 'ejen', 'amurray', 'sbagnola', 'jxamplas', 'mchoi', 'jjain1', 'dylanhirshkowitz', 'dkoo', 'iikene', 'camora', 'ryandeblock', 'joeg', 'apankaj', 'gracechan715', 'mgomaa', 'swang', 'jjs439', 'vgupta2792', 'vprakash', 'aweinstein', 'sitknee', 'abc138', 'mkeith', 'car942', 'mbzeitz', 'lmehmeti', 'swilliams', 'pjang', 'nmiller', 'sashpatel81', 'nrouzier', 'eza135', 'slipov', 'suttal', 'annas890', 'kbrohkahn', 'kgeraghty', 'stvrdik', 'blach', 'mlb923', 'nisadesai', 'huwang', 'jbryman', 'purpleyuan', 'cchang92', 'cleclerq', 'charleslin', 'ykhwang', 'afreedman', 'britt518', 'mfmorel', 'astaples', 'pknapp', 'ppatel7499', 'mshetty', 'lhsu', 'szaveri', 'skim2010', 'nsteimel', 'danielnfls', 'guerrero1', 'angcal3', 'yzermeno', 'jzhang', 'chahn', 'hzhou', 'yuanshi', 'aweatherly1', 'ktaskin', 'kah703', 'prl176', 'paarasmodi', 'bcastle', 'shetzler', 'clockwork', 'lzhou', 'jyw902', 'kki227', 'htennant', 'brandonalba', 'brianraychen', 'eklosowiak', 'skadakia', 'asimon', 'lmaliakal', 'hreilly', 'sda387', 'veskit2k', 'michaelmilazzo', 'lizzo427', 'nrichter', 'jsachg', 'balegbeleye', 'cfuentes60618', 'nna341', 'dslaughter', 'bmaldonado', 'agh612', 'aaggarwal', 'crowland', 'ntorosin', 'lontiveros', 'rem455', 'aawwad', 'jhi551', 'jhalpern', 'snandamuri', 'chintanaphol', 'xwen', 'peter8737', 'tyu1992', 'nreimold', 'amelingercohen', 'sjiao', 'jalam', 'yfa874', 'aychang', 'cyu13', 'cqin', 'rku147', 'tkukushliev', 'hae201', 'pwzorek', 'msc494', 'mtyksinski', 'ryanmcafee', 'acook', 'sagarwal1', 'sandeepjain', 'patman16', 'mcorpuz', 'reb712', 'pka421', 'akansha21', 'hab477', 'sreinke', 'ajw873', 'tyuan', 'msmith', 'mtu', 'ani197', 'recook', 'ejizba', 'emilyf131', 'lucialee', 'rquan', 'pkaralis', 'eukoha', 'sshakin', 'tjeppson', 'awl111', 'lshekhtman', 'rgd606', 'joannajaros', 'akozminski', 'hmu909', 'amfrank26', 'mjskwarczek1']"
1,48,244,219,214,"['aweinstein', 'sitknee', 'jchang', 'jsyu', 'eausenbaugh', 'jcastro', 'abc138', 'mcr728', 'mbzeitz', 'car942', 'lmehmeti', 'scs771', 'ehorcher', 'bbak', 'pjang', 'nmiller', 'mtk160', 'sashpatel81', 'alexholterman', 'jaimiepark', 'daniellefong92', 'nlahner', 'slipov', 'cquinn17', 'psharma', 'tpark', 'suttal', 'annas890', 'kbrohkahn', 'dcheah', 'sjeon', 'jfranke', 'kgeraghty', 'blach', 'huwang', 'nisadesai', 'bmerkle', 'purpleyuan', 'ahb978', 'cchang92', 'prishah', 'charleslin', 'ykhwang', 'eys582', 'bgibbons', 'elleanzhang', 'afreedman', 'hfleming', 'britt518', 'mfmorel', 'tjc797', 'ekwak', 'pknapp', 'mcp349', 'jcd265', 'ppatel7499', 'jmueller', 'mshetty', 'narouzier', 'lhsu', 'szaveri', 'ezaruba', 'jzhong', 'nsteimel', 'danielnfls', 'guerrero1', 'nigelng91', 'angcal3', 'npyle', 'yzermeno', 'choiboi68', 'jzhang', 'rterada', 'chahn', 'jaj343', 'acortes', 'hzhou', 'yuanshi', 'chrispitler', 'aweatherly1', 'ktaskin', 'kah703', 'prl176', 'bcastle', 'paarasmodi', 'shetzler', 'galexander', 'clockwork', 'jcordes', 'lzhou', 'esmith', 'jyw902', 'htennant', 'brandonalba', 'brianraychen', 'glee530', 'schoi3', 'sre306', 'eklosowiak', 'skadakia', 'kjl432', 'asimon', 'ekaht', 'lmaliakal', 'hreilly', 'exw190', 'khjoon0502', 'lrg923', 'sda387', 'lav127', 'michaelmilazzo', 'lizzo427', 'nrichter', 'jsachg', 'clee2014', 'jaguilar', 'chiggins', 'balegbeleye', 'mattsullivan725', 'cfuentes60618', 'nna341', 'dslaughter', 'nxiao', 'dvenkat', 'agh612', 'aaggarwal', 'tln941', 'jsandler', 'ntorosin', 'lontiveros', 'rem455', 'aawwad', 'jhalpern', 'jhi551', 'ahiggins', 'snandamuri', 'xwen', 'peter8737', 'gbudzon', 'mso', 'dsh278', 'tyu1992', 'williamgross2014', 'alo869', 'rkawashima', 'nreimold', 'rdesai', 'kelly382', 'zrachlin', 'jalam', 'yfa874', 'cyu13', 'cqin', 'mankenman', 'mjskwarczek1', 'smoon', 'rku147', 'tkukushliev', 'dschuleman', 'ewp790', 'jpark17', 'krc863', 'msc494', 'mtyksinski', 'ryanmcafee', 'jeshicaa', 'ldk310', 'sagarwal1', 'missalice', 'jkernes', 'ceb570', 'patman16', 'mcorpuz', 'jmontyiii', 'asong', 'kirstynbesch', 'reb712', 'ychung', 'pka421', 'jjozefiak', 'akansha21', 'hab477', 'mdm833', 'sreinke', 'aws491', 'ajw873', 'amurray', 'sbagnola', 'tyuan', 'msmith', 'jxamplas', 'mtu', 'mchoi', 'dylanhirshkowitz', 'dkoo', 'recook', 'ejizba', 'emilyf131', 'ryandeblock', 'apankaj', 'eukoha', 'pkaralis', 'sshakin', 'tjeppson', 'awl111', 'lshekhtman', 'mgomaa', 'hmu909', 'akozminski', 'joannajaros', 'jjs439', 'amfrank26', 'vgupta2792', 'vprakash']",30,"['khkim', 'sdesai', 'acook', 'sandeepjain', 'mkeith', 'swilliams', 'skim2010', 'pgarg', 'dmorrison7778', 'chintanaphol', 'mlb923', 'stvrdik', 'jjain1', 'iikene', 'amelingercohen', 'cleclerq', 'sjiao', 'dangerousdan', 'lucialee', 'rquan', 'kki227', 'khuynh', 'asutton', 'gracechan715', 'astaples', 'kds543', 'pwzorek', 'hae201', 'swang', 'lauren20']",5,"['ryanlegraw', 'siddarthdatla2014', 'unrealchamp', 'camora', None]",249,"['sdesai', 'jchang', 'jsyu', 'eausenbaugh', 'siddarthdatla2014', 'jcastro', 'mcr728', 'ehorcher', 'scs771', 'bbak', 'mtk160', 'unrealchamp', 'jaimiepark', 'alexholterman', 'daniellefong92', 'nlahner', 'cquinn17', 'psharma', 'tpark', 'dcheah', 'sjeon', 'jfranke', 'bmerkle', 'ahb978', 'prishah', 'eys582', 'bgibbons', 'elleanzhang', 'khuynh', 'asutton', 'hfleming', 'tjc797', 'ekwak', 'kds543', 'mcp349', 'jcd265', 'jmueller', 'narouzier', 'ezaruba', 'jzhong', 'pgarg', 'nigelng91', 'npyle', 'choiboi68', 'rterada', 'jaj343', 'acortes', 'chrispitler', 'galexander', 'dangerousdan', 'jcordes', 'esmith', 'schoi3', 'glee530', 'sre306', 'ryanlegraw', 'kjl432', 'ekaht', 'lrg923', 'exw190', 'khjoon0502', 'lav127', 'clee2014', 'jaguilar', 'chiggins', 'mattsullivan725', 'nxiao', 'dvenkat', 'tln941', 'jsandler', 'ahiggins', 'mso', 'gbudzon', 'dsh278', 'williamgross2014', 'alo869', 'rkawashima', 'rdesai', 'kelly382', 'zrachlin', 'mankenman', 'smoon', 'ewp790', 'dschuleman', 'jpark17', 'lauren20', 'krc863', 'khkim', 'jeshicaa', 'ldk310', 'jkernes', 'missalice', 'ceb570', 'jmontyiii', 'asong', 'kirstynbesch', 'ychung', 'jjozefiak', 'dmorrison7778', 'mdm833', 'aws491', 'amurray', 'sbagnola', 'jxamplas', 'mchoi', 'jjain1', 'dylanhirshkowitz', 'dkoo', 'iikene', 'camora', 'ryandeblock', 'apankaj', 'gracechan715', 'mgomaa', 'swang', 'jjs439', 'vgupta2792', 'vprakash', 'aweinstein', 'sitknee', 'abc138', 'mkeith', 'car942', 'mbzeitz', 'lmehmeti', 'swilliams', 'pjang', 'nmiller', 'sashpatel81', 'slipov', 'suttal', 'annas890', 'kbrohkahn', 'kgeraghty', 'stvrdik', 'blach', 'mlb923', 'nisadesai', 'huwang', 'purpleyuan', 'cchang92', 'cleclerq', 'charleslin', 'ykhwang', 'afreedman', 'britt518', 'mfmorel', 'astaples', 'pknapp', 'ppatel7499', 'mshetty', 'lhsu', 'szaveri', 'skim2010', 'nsteimel', 'danielnfls', 'guerrero1', 'angcal3', 'yzermeno', 'jzhang', 'chahn', 'hzhou', 'yuanshi', 'aweatherly1', 'ktaskin', 'kah703', 'prl176', 'paarasmodi', 'bcastle', 'shetzler', 'clockwork', 'lzhou', 'jyw902', 'kki227', 'htennant', 'brandonalba', 'brianraychen', 'eklosowiak', 'skadakia', 'asimon', 'lmaliakal', 'hreilly', 'sda387', 'michaelmilazzo', 'lizzo427', 'nrichter', 'jsachg', 'balegbeleye', 'cfuentes60618', 'nna341', 'dslaughter', 'agh612', 'aaggarwal', 'ntorosin', 'lontiveros', 'rem455', 'aawwad', 'jhi551', 'jhalpern', 'snandamuri', 'chintanaphol', 'xwen', 'peter8737', 'tyu1992', 'nreimold', 'amelingercohen', 'sjiao', 'jalam', 'yfa874', 'cyu13', 'cqin', 'rku147', 'tkukushliev', 'hae201', 'pwzorek', 'msc494', 'mtyksinski', 'ryanmcafee', 'acook', 'sagarwal1', 'sandeepjain', 'patman16', 'mcorpuz', 'reb712', 'pka421', 'akansha21', 'hab477', 'sreinke', 'ajw873', 'tyuan', 'msmith', 'mtu', 'recook', 'ejizba', 'emilyf131', 'lucialee', 'rquan', None, 'pkaralis', 'eukoha', 'sshakin', 'tjeppson', 'awl111', 'lshekhtman', 'joannajaros', 'akozminski', 'hmu909', 'amfrank26', 'mjskwarczek1']"
1,132,244,209,202,"['aweinstein', 'sdesai', 'jsyu', 'eausenbaugh', 'jcastro', 'abc138', 'mcr728', 'mkeith', 'car942', 'mbzeitz', 'scs771', 'swilliams', 'bbak', 'pjang', 'nmiller', 'ehorcher', 'mtk160', 'sashpatel81', 'alexholterman', 'jaimiepark', 'daniellefong92', 'nlahner', 'slipov', 'psharma', 'tpark', 'suttal', 'kbrohkahn', 'dcheah', 'kgeraghty', 'mlb923', 'stvrdik', 'blach', 'huwang', 'bmerkle', 'purpleyuan', 'ahb978', 'cchang92', 'cleclerq', 'prishah', 'charleslin', 'ykhwang', 'bgibbons', 'elleanzhang', 'asutton', 'khuynh', 'britt518', 'mfmorel', 'ekwak', 'astaples', 'pknapp', 'kds543', 'jcd265', 'jmueller', 'mshetty', 'narouzier', 'szaveri', 'ezaruba', 'skim2010', 'jzhong', 'nsteimel', 'danielnfls', 'pgarg', 'guerrero1', 'nigelng91', 'angcal3', 'npyle', 'yzermeno', 'choiboi68', 'hzhou', 'rterada', 'chahn', 'jaj343', 'acortes', 'yuanshi', 'chrispitler', 'aweatherly1', 'ktaskin', 'kah703', 'prl176', 'paarasmodi', 'shetzler', 'galexander', 'clockwork', 'dangerousdan', 'esmith', 'jyw902', 'kki227', 'htennant', 'brianraychen', 'schoi3', 'sre306', 'eklosowiak', 'skadakia', 'asimon', 'ekaht', 'lmaliakal', 'hreilly', 'exw190', 'khjoon0502', 'sda387', 'lav127', 'michaelmilazzo', 'lizzo427', 'nrichter', 'jsachg', 'jaguilar', 'balegbeleye', 'cfuentes60618', 'nna341', 'dslaughter', 'nxiao', 'dvenkat', 'agh612', 'tln941', 'jsandler', 'ntorosin', 'lontiveros', 'rem455', 'aawwad', 'jhi551', 'ahiggins', 'chintanaphol', 'xwen', 'peter8737', 'gbudzon', 'dsh278', 'tyu1992', 'williamgross2014', 'alo869', 'rkawashima', 'nreimold', 'amelingercohen', 'rdesai', 'kelly382', 'zrachlin', 'sjiao', 'jalam', 'cyu13', 'cqin', 'mankenman', 'mjskwarczek1', 'smoon', 'rku147', 'hae201', 'pwzorek', 'ewp790', 'lauren20', 'krc863', 'msc494', 'mtyksinski', 'ryanmcafee', 'khkim', 'jeshicaa', 'ldk310', 'acook', 'sagarwal1', 'sandeepjain', 'missalice', 'jkernes', 'patman16', 'mcorpuz', 'asong', 'kirstynbesch', 'reb712', 'ychung', 'pka421', 'akansha21', 'hab477', 'mdm833', 'dmorrison7778', 'sreinke', 'aws491', 'ajw873', 'amurray', 'sbagnola', 'tyuan', 'msmith', 'mtu', 'jjain1', 'mchoi', 'dylanhirshkowitz', 'dkoo', 'iikene', 'ejizba', 'emilyf131', 'recook', 'lucialee', 'rquan', 'apankaj', 'eukoha', 'pkaralis', 'sshakin', 'tjeppson', 'awl111', 'gracechan715', 'mgomaa', 'swang', 'akozminski', 'joannajaros', 'amfrank26', 'vgupta2792', 'vprakash']",42,"['ppatel7499', 'sitknee', 'clee2014', 'jchang', 'lhsu', 'chiggins', 'ceb570', 'mattsullivan725', 'lmehmeti', 'jmontyiii', 'aaggarwal', 'jjozefiak', 'jhalpern', 'cquinn17', 'snandamuri', 'annas890', 'jzhang', 'sjeon', 'mso', 'jfranke', 'jxamplas', 'nisadesai', 'bcastle', 'ryandeblock', 'jcordes', 'lzhou', 'eys582', 'yfa874', 'brandonalba', 'afreedman', 'glee530', 'hfleming', 'lshekhtman', 'tjc797', 'kjl432', 'jjs439', 'tkukushliev', 'hmu909', 'lrg923', 'dschuleman', 'jpark17', 'mcp349']",7,"['kellyrae', 'ryanlegraw', 'dle649', 'cengel126', 'ajs833', 'camora', None]",251,"['sdesai', 'jchang', 'jsyu', 'eausenbaugh', 'jcastro', 'mcr728', 'ehorcher', 'scs771', 'bbak', 'mtk160', 'jaimiepark', 'alexholterman', 'daniellefong92', 'nlahner', 'cquinn17', 'psharma', 'tpark', 'dcheah', 'sjeon', 'jfranke', 'bmerkle', 'ahb978', 'prishah', 'eys582', 'bgibbons', 'elleanzhang', 'khuynh', 'asutton', 'hfleming', 'tjc797', 'ekwak', 'kds543', 'mcp349', 'jcd265', 'jmueller', 'narouzier', 'ezaruba', 'jzhong', 'pgarg', 'nigelng91', 'npyle', 'choiboi68', 'rterada', 'jaj343', 'acortes', 'chrispitler', 'galexander', 'dangerousdan', 'jcordes', 'esmith', 'schoi3', 'glee530', 'sre306', 'ryanlegraw', 'kjl432', 'ekaht', 'lrg923', 'exw190', 'khjoon0502', 'lav127', 'clee2014', 'jaguilar', 'chiggins', 'mattsullivan725', 'nxiao', 'dvenkat', 'tln941', 'jsandler', 'ahiggins', 'mso', 'gbudzon', 'dsh278', 'williamgross2014', 'alo869', 'rkawashima', 'cengel126', 'rdesai', 'kelly382', 'zrachlin', 'mankenman', 'smoon', 'ewp790', 'dschuleman', 'jpark17', 'lauren20', 'krc863', 'khkim', 'jeshicaa', 'ldk310', 'dle649', 'jkernes', 'missalice', 'ceb570', 'jmontyiii', 'asong', 'kirstynbesch', 'ychung', 'jjozefiak', 'dmorrison7778', 'mdm833', 'aws491', 'ajs833', 'amurray', 'sbagnola', 'jxamplas', 'mchoi', 'jjain1', 'dylanhirshkowitz', 'dkoo', 'iikene', 'camora', 'ryandeblock', 'apankaj', 'gracechan715', 'mgomaa', 'swang', 'jjs439', 'vgupta2792', 'vprakash', 'aweinstein', 'sitknee', 'abc138', 'mkeith', 'car942', 'mbzeitz', 'lmehmeti', 'swilliams', 'pjang', 'nmiller', 'sashpatel81', 'slipov', 'suttal', 'annas890', 'kbrohkahn', 'kgeraghty', 'stvrdik', 'blach', 'mlb923', 'nisadesai', 'huwang', 'purpleyuan', 'cchang92', 'cleclerq', 'charleslin', 'ykhwang', 'afreedman', 'britt518', 'mfmorel', 'astaples', 'pknapp', 'ppatel7499', 'mshetty', 'lhsu', 'szaveri', 'skim2010', 'nsteimel', 'danielnfls', 'guerrero1', 'angcal3', 'yzermeno', 'jzhang', 'chahn', 'hzhou', 'yuanshi', 'aweatherly1', 'ktaskin', 'kah703', 'prl176', 'paarasmodi', 'bcastle', 'shetzler', 'clockwork', 'lzhou', 'jyw902', 'kki227', 'htennant', 'brandonalba', 'brianraychen', 'eklosowiak', 'skadakia', 'asimon', 'lmaliakal', 'hreilly', 'sda387', 'michaelmilazzo', 'lizzo427', 'nrichter', 'jsachg', 'balegbeleye', 'cfuentes60618', 'nna341', 'dslaughter', 'agh612', 'aaggarwal', 'ntorosin', 'lontiveros', 'rem455', 'aawwad', 'jhi551', 'jhalpern', 'snandamuri', 'chintanaphol', 'xwen', 'peter8737', 'tyu1992', 'kellyrae', 'nreimold', 'amelingercohen', 'sjiao', 'jalam', 'yfa874', 'cyu13', 'cqin', 'rku147', 'tkukushliev', 'hae201', 'pwzorek', 'msc494', 'mtyksinski', 'ryanmcafee', 'acook', 'sagarwal1', 'sandeepjain', 'patman16', 'mcorpuz', 'reb712', 'pka421', 'akansha21', 'hab477', 'sreinke', 'ajw873', 'tyuan', 'msmith', 'mtu', 'recook', 'ejizba', 'emilyf131', 'lucialee', 'rquan', None, 'pkaralis', 'eukoha', 'sshakin', 'tjeppson', 'awl111', 'lshekhtman', 'joannajaros', 'akozminski', 'hmu909', 'amfrank26', 'mjskwarczek1']"
1,131,244,14,1,['mso'],243,"['aweinstein', 'sdesai', 'sitknee', 'jchang', 'jsyu', 'eausenbaugh', 'jcastro', 'abc138', 'mcr728', 'mkeith', 'car942', 'mbzeitz', 'lmehmeti', 'ehorcher', 'swilliams', 'bbak', 'mtk160', 'nmiller', 'scs771', 'pjang', 'sashpatel81', 'jaimiepark', 'alexholterman', 'daniellefong92', 'nlahner', 'slipov', 'cquinn17', 'psharma', 'tpark', 'suttal', 'annas890', 'kbrohkahn', 'dcheah', 'sjeon', 'jfranke', 'kgeraghty', 'stvrdik', 'blach', 'mlb923', 'nisadesai', 'huwang', 'ahb978', 'purpleyuan', 'cchang92', 'prishah', 'charleslin', 'cleclerq', 'ykhwang', 'eys582', 'bgibbons', 'elleanzhang', 'afreedman', 'khuynh', 'asutton', 'hfleming', 'britt518', 'mfmorel', 'tjc797', 'ekwak', 'astaples', 'pknapp', 'kds543', 'mcp349', 'jcd265', 'ppatel7499', 'jmueller', 'mshetty', 'narouzier', 'lhsu', 'szaveri', 'ezaruba', 'skim2010', 'jzhong', 'nsteimel', 'danielnfls', 'pgarg', 'guerrero1', 'nigelng91', 'angcal3', 'yzermeno', 'npyle', 'choiboi68', 'jzhang', 'chahn', 'hzhou', 'yuanshi', 'jaj343', 'acortes', 'rterada', 'chrispitler', 'aweatherly1', 'ktaskin', 'kah703', 'prl176', 'paarasmodi', 'bcastle', 'shetzler', 'galexander', 'clockwork', 'dangerousdan', 'jcordes', 'lzhou', 'esmith', 'jyw902', 'vgupta2792', 'kki227', 'htennant', 'brandonalba', 'brianraychen', 'schoi3', 'glee530', 'sre306', 'eklosowiak', 'skadakia', 'kjl432', 'asimon', 'ekaht', 'lmaliakal', 'hreilly', 'lrg923', 'exw190', 'khjoon0502', 'sda387', 'lav127', 'michaelmilazzo', 'lizzo427', 'nrichter', 'jsachg', 'clee2014', 'jaguilar', 'chiggins', 'balegbeleye', 'mattsullivan725', 'cfuentes60618', 'nna341', 'dslaughter', 'nxiao', 'dvenkat', 'agh612', 'aaggarwal', 'tln941', 'jsandler', 'ntorosin', 'lontiveros', 'rem455', 'aawwad', 'jhi551', 'jhalpern', 'ahiggins', 'snandamuri', 'chintanaphol', 'xwen', 'peter8737', 'gbudzon', 'dsh278', 'tyu1992', 'williamgross2014', 'alo869', 'rkawashima', 'nreimold', 'amelingercohen', 'rdesai', 'kelly382', 'zrachlin', 'sjiao', 'jalam', 'yfa874', 'cyu13', 'cqin', 'mankenman', 'mjskwarczek1', 'rku147', 'smoon', 'tkukushliev', 'hae201', 'pwzorek', 'ewp790', 'dschuleman', 'jpark17', 'lauren20', 'krc863', 'msc494', 'mtyksinski', 'ryanmcafee', 'jeshicaa', 'khkim', 'ldk310', 'acook', 'sagarwal1', 'sandeepjain', 'jkernes', 'ceb570', 'missalice', 'patman16', 'mcorpuz', 'jmontyiii', 'asong', 'kirstynbesch', 'reb712', 'ychung', 'pka421', 'jjozefiak', 'akansha21', 'hab477', 'dmorrison7778', 'mdm833', 'sreinke', 'aws491', 'ajw873', 'amurray', 'sbagnola', 'tyuan', 'msmith', 'jxamplas', 'mtu', 'mchoi', 'jjain1', 'dylanhirshkowitz', 'dkoo', 'iikene', 'recook', 'emilyf131', 'ejizba', 'ryandeblock', 'lucialee', 'rquan', 'apankaj', 'pkaralis', 'eukoha', 'sshakin', 'tjeppson', 'awl111', 'lshekhtman', 'gracechan715', 'mgomaa', 'swang', 'joannajaros', 'akozminski', 'hmu909', 'jjs439', 'amfrank26', 'bmerkle', 'vprakash']",13,"['ncalta', 'sicelo', 'lindseymadison2015', 'cengel126', 'def790', 'mshrestha', 'mshelby', 'ngruenke', 'she', 'amberdavis2014', None, 'rjh779', 'gcutsail']",257,"['aweinstein', 'sdesai', 'sitknee', 'jchang', 'jsyu', 'eausenbaugh', 'jcastro', 'abc138', 'mcr728', 'mkeith', 'car942', 'mbzeitz', 'lmehmeti', 'ehorcher', 'swilliams', 'bbak', 'mtk160', 'nmiller', 'scs771', 'pjang', 'sashpatel81', 'jaimiepark', 'alexholterman', 'ncalta', 'daniellefong92', 'nlahner', 'slipov', 'lindseymadison2015', 'cquinn17', 'psharma', 'tpark', 'suttal', 'annas890', 'she', 'kbrohkahn', 'dcheah', 'sjeon', 'jfranke', 'kgeraghty', 'stvrdik', 'blach', 'mlb923', 'nisadesai', 'huwang', 'ahb978', 'purpleyuan', 'cchang92', 'prishah', 'charleslin', 'cleclerq', 'ykhwang', 'eys582', 'bgibbons', 'elleanzhang', 'afreedman', 'khuynh', 'asutton', 'hfleming', 'britt518', 'mfmorel', 'tjc797', 'ekwak', 'mshelby', 'astaples', 'pknapp', 'kds543', 'mcp349', 'gcutsail', 'jcd265', 'ppatel7499', 'jmueller', 'mshetty', 'narouzier', 'lhsu', 'szaveri', 'ezaruba', 'skim2010', 'jzhong', 'nsteimel', 'amberdavis2014', 'danielnfls', 'pgarg', 'guerrero1', 'nigelng91', 'angcal3', 'yzermeno', 'npyle', 'choiboi68', 'jzhang', 'chahn', 'hzhou', 'yuanshi', 'jaj343', 'acortes', 'rterada', 'chrispitler', 'aweatherly1', 'ktaskin', 'kah703', 'prl176', 'paarasmodi', 'bcastle', 'shetzler', 'galexander', 'clockwork', 'dangerousdan', 'jcordes', 'lzhou', 'esmith', 'jyw902', 'vgupta2792', 'kki227', 'htennant', 'brandonalba', 'brianraychen', 'schoi3', 'glee530', 'sre306', 'eklosowiak', 'skadakia', 'kjl432', 'asimon', 'def790', 'ekaht', 'lmaliakal', 'hreilly', 'lrg923', 'exw190', 'khjoon0502', 'sda387', 'lav127', 'michaelmilazzo', 'lizzo427', 'nrichter', 'jsachg', 'clee2014', 'jaguilar', 'chiggins', 'balegbeleye', 'mattsullivan725', 'cfuentes60618', 'nna341', 'dslaughter', 'nxiao', 'dvenkat', 'agh612', 'aaggarwal', 'tln941', 'jsandler', 'ntorosin', 'lontiveros', 'rem455', 'aawwad', 'jhi551', 'jhalpern', 'ahiggins', 'snandamuri', 'chintanaphol', 'xwen', 'peter8737', 'mso', 'gbudzon', 'dsh278', 'tyu1992', 'williamgross2014', 'alo869', 'rkawashima', 'nreimold', 'cengel126', 'amelingercohen', 'rdesai', 'kelly382', 'zrachlin', 'sjiao', 'jalam', 'yfa874', 'cyu13', 'cqin', 'mankenman', 'sicelo', 'mjskwarczek1', 'rku147', 'smoon', 'mshrestha', 'tkukushliev', 'hae201', 'pwzorek', 'ewp790', 'dschuleman', 'jpark17', 'lauren20', 'krc863', 'msc494', 'mtyksinski', 'ryanmcafee', 'jeshicaa', 'khkim', 'ldk310', 'acook', 'sagarwal1', 'sandeepjain', 'jkernes', 'ceb570', 'missalice', 'patman16', 'mcorpuz', 'jmontyiii', 'asong', 'kirstynbesch', 'reb712', 'ychung', 'pka421', 'jjozefiak', 'akansha21', 'hab477', 'dmorrison7778', 'mdm833', 'sreinke', 'aws491', 'ajw873', 'ngruenke', 'amurray', 'sbagnola', 'tyuan', 'msmith', 'jxamplas', 'mtu', 'mchoi', 'jjain1', 'dylanhirshkowitz', 'dkoo', 'iikene', 'recook', 'emilyf131', 'ejizba', 'ryandeblock', 'lucialee', 'rquan', None, 'apankaj', 'pkaralis', 'eukoha', 'rjh779', 'sshakin', 'tjeppson', 'awl111', 'lshekhtman', 'gracechan715', 'mgomaa', 'swang', 'joannajaros', 'akozminski', 'hmu909', 'jjs439', 'amfrank26', 'bmerkle', 'vprakash']"
1,135,244,11,10,"['michaelmilazzo', 'jcd265', 'alexholterman', 'dcheah', 'awl111', 'mshetty', 'cqin', 'aweatherly1', 'esmith', 'sashpatel81']",234,"['aweinstein', 'sdesai', 'sitknee', 'jchang', 'jsyu', 'eausenbaugh', 'jcastro', 'abc138', 'mcr728', 'mkeith', 'car942', 'mbzeitz', 'lmehmeti', 'ehorcher', 'swilliams', 'bbak', 'mtk160', 'nmiller', 'scs771', 'pjang', 'jaimiepark', 'daniellefong92', 'nlahner', 'slipov', 'cquinn17', 'psharma', 'tpark', 'suttal', 'annas890', 'kbrohkahn', 'sjeon', 'jfranke', 'kgeraghty', 'stvrdik', 'blach', 'mlb923', 'nisadesai', 'huwang', 'ahb978', 'purpleyuan', 'cchang92', 'prishah', 'charleslin', 'cleclerq', 'ykhwang', 'eys582', 'bgibbons', 'elleanzhang', 'afreedman', 'khuynh', 'asutton', 'hfleming', 'britt518', 'mfmorel', 'tjc797', 'ekwak', 'astaples', 'pknapp', 'kds543', 'mcp349', 'ppatel7499', 'jmueller', 'narouzier', 'lhsu', 'szaveri', 'ezaruba', 'skim2010', 'jzhong', 'nsteimel', 'danielnfls', 'pgarg', 'guerrero1', 'nigelng91', 'angcal3', 'yzermeno', 'npyle', 'choiboi68', 'jzhang', 'chahn', 'hzhou', 'yuanshi', 'jaj343', 'acortes', 'rterada', 'chrispitler', 'ktaskin', 'kah703', 'prl176', 'paarasmodi', 'bcastle', 'shetzler', 'galexander', 'clockwork', 'dangerousdan', 'jcordes', 'lzhou', 'jyw902', 'vgupta2792', 'kki227', 'htennant', 'brandonalba', 'brianraychen', 'schoi3', 'glee530', 'sre306', 'eklosowiak', 'skadakia', 'kjl432', 'asimon', 'ekaht', 'lmaliakal', 'hreilly', 'lrg923', 'exw190', 'khjoon0502', 'sda387', 'lav127', 'lizzo427', 'nrichter', 'jsachg', 'clee2014', 'jaguilar', 'chiggins', 'balegbeleye', 'mattsullivan725', 'cfuentes60618', 'nna341', 'dslaughter', 'nxiao', 'dvenkat', 'agh612', 'aaggarwal', 'tln941', 'jsandler', 'ntorosin', 'lontiveros', 'rem455', 'aawwad', 'jhi551', 'jhalpern', 'ahiggins', 'snandamuri', 'chintanaphol', 'xwen', 'peter8737', 'mso', 'gbudzon', 'dsh278', 'tyu1992', 'williamgross2014', 'alo869', 'rkawashima', 'nreimold', 'amelingercohen', 'rdesai', 'kelly382', 'zrachlin', 'sjiao', 'jalam', 'yfa874', 'cyu13', 'mankenman', 'mjskwarczek1', 'rku147', 'smoon', 'tkukushliev', 'hae201', 'pwzorek', 'ewp790', 'dschuleman', 'jpark17', 'lauren20', 'krc863', 'msc494', 'mtyksinski', 'ryanmcafee', 'jeshicaa', 'khkim', 'ldk310', 'acook', 'sagarwal1', 'sandeepjain', 'jkernes', 'ceb570', 'missalice', 'patman16', 'mcorpuz', 'jmontyiii', 'asong', 'kirstynbesch', 'reb712', 'ychung', 'pka421', 'jjozefiak', 'akansha21', 'hab477', 'dmorrison7778', 'mdm833', 'sreinke', 'aws491', 'ajw873', 'amurray', 'sbagnola', 'tyuan', 'msmith', 'jxamplas', 'mtu', 'mchoi', 'jjain1', 'dylanhirshkowitz', 'dkoo', 'iikene', 'recook', 'emilyf131', 'ejizba', 'ryandeblock', 'lucialee', 'rquan', 'apankaj', 'pkaralis', 'eukoha', 'sshakin', 'tjeppson', 'lshekhtman', 'gracechan715', 'mgomaa', 'swang', 'joannajaros', 'akozminski', 'hmu909', 'jjs439', 'amfrank26', 'bmerkle', 'vprakash']",1,[None],245,"['aweinstein', 'sdesai', 'sitknee', 'jchang', 'jsyu', 'eausenbaugh', 'jcastro', 'abc138', 'mcr728', 'mkeith', 'car942', 'mbzeitz', 'lmehmeti', 'ehorcher', 'swilliams', 'bbak', 'mtk160', 'nmiller', 'scs771', 'pjang', 'sashpatel81', 'jaimiepark', 'alexholterman', 'daniellefong92', 'nlahner', 'slipov', 'cquinn17', 'psharma', 'tpark', 'suttal', 'annas890', 'kbrohkahn', 'dcheah', 'sjeon', 'jfranke', 'kgeraghty', 'stvrdik', 'blach', 'mlb923', 'nisadesai', 'huwang', 'ahb978', 'purpleyuan', 'cchang92', 'prishah', 'charleslin', 'cleclerq', 'ykhwang', 'eys582', 'bgibbons', 'elleanzhang', 'afreedman', 'khuynh', 'asutton', 'hfleming', 'britt518', 'mfmorel', 'tjc797', 'ekwak', 'astaples', 'pknapp', 'kds543', 'mcp349', 'jcd265', 'ppatel7499', 'jmueller', 'mshetty', 'narouzier', 'lhsu', 'szaveri', 'ezaruba', 'skim2010', 'jzhong', 'nsteimel', 'danielnfls', 'pgarg', 'guerrero1', 'nigelng91', 'angcal3', 'yzermeno', 'npyle', 'choiboi68', 'jzhang', 'chahn', 'hzhou', 'yuanshi', 'jaj343', 'acortes', 'rterada', 'chrispitler', 'aweatherly1', 'ktaskin', 'kah703', 'prl176', 'paarasmodi', 'bcastle', 'shetzler', 'galexander', 'clockwork', 'dangerousdan', 'jcordes', 'lzhou', 'esmith', 'jyw902', 'vgupta2792', 'kki227', 'htennant', 'brandonalba', 'brianraychen', 'schoi3', 'glee530', 'sre306', 'eklosowiak', 'skadakia', 'kjl432', 'asimon', 'ekaht', 'lmaliakal', 'hreilly', 'lrg923', 'exw190', 'khjoon0502', 'sda387', 'lav127', 'michaelmilazzo', 'lizzo427', 'nrichter', 'jsachg', 'clee2014', 'jaguilar', 'chiggins', 'balegbeleye', 'mattsullivan725', 'cfuentes60618', 'nna341', 'dslaughter', 'nxiao', 'dvenkat', 'agh612', 'aaggarwal', 'tln941', 'jsandler', 'ntorosin', 'lontiveros', 'rem455', 'aawwad', 'jhi551', 'jhalpern', 'ahiggins', 'snandamuri', 'chintanaphol', 'xwen', 'peter8737', 'mso', 'gbudzon', 'dsh278', 'tyu1992', 'williamgross2014', 'alo869', 'rkawashima', 'nreimold', 'amelingercohen', 'rdesai', 'kelly382', 'zrachlin', 'sjiao', 'jalam', 'yfa874', 'cyu13', 'cqin', 'mankenman', 'mjskwarczek1', 'rku147', 'smoon', 'tkukushliev', 'hae201', 'pwzorek', 'ewp790', 'dschuleman', 'jpark17', 'lauren20', 'krc863', 'msc494', 'mtyksinski', 'ryanmcafee', 'jeshicaa', 'khkim', 'ldk310', 'acook', 'sagarwal1', 'sandeepjain', 'jkernes', 'ceb570', 'missalice', 'patman16', 'mcorpuz', 'jmontyiii', 'asong', 'kirstynbesch', 'reb712', 'ychung', 'pka421', 'jjozefiak', 'akansha21', 'hab477', 'dmorrison7778', 'mdm833', 'sreinke', 'aws491', 'ajw873', 'amurray', 'sbagnola', 'tyuan', 'msmith', 'jxamplas', 'mtu', 'mchoi', 'jjain1', 'dylanhirshkowitz', 'dkoo', 'iikene', 'recook', 'emilyf131', 'ejizba', 'ryandeblock', 'lucialee', 'rquan', None, 'apankaj', 'pkaralis', 'eukoha', 'sshakin', 'tjeppson', 'awl111', 'lshekhtman', 'gracechan715', 'mgomaa', 'swang', 'joannajaros', 'akozminski', 'hmu909', 'jjs439', 'amfrank26', 'bmerkle', 'vprakash']"
2,76,110,123,76,"['likpok', 'jchyan2', 'chengxu1', 'hipaulshi', 'malhotr3', 'wu10', 'jeredgre', 'fliu96', 'ng21', 'crazedcatatonic5', 'alikation', 'ligao1', 'luyun198993', 'megarza2', 'tkim28', 'midnightblade', 'dusty493', 'ddeutsc2', 'marshal2', 'bracon', 'asrinat2', 'kang92', 'maemble', 'arappep2', 'bikrambhatia', 'abstrkt', 'fangwan2', 'diablopbc', 'xihan1', 'kim417', 'd98521', 'chen282', 'willtk0113', 'leiyang1', 'bongen2', 'jack_ftw', 'tchurch2', 'se210', 'weller1', 'dawei1', 'tkim31', 'dlgudwns11', 'tao7', 'tarvitz', 'schrock3', 'kim857', 'jiyichenqi', 'collapse', 'supercowking', 'luisccruz', 'cjohns78', 'dradefx', 'pessin', 'dbero2', 'jfelts', 'boegy3', 'wmjdgla', 'ma3xiao1', 'sparklingway', 'ryanskim', 'efilli2', 'black_chip21', 'chijiazuo', 'aggarwa3', 'rlew2', 'dbarnes2', 'joo4ny', 'snowpd', 'aditchhabra', 'idesis1', 'chrisjryu', 'kejriwa1', 'weichunan', 'ragunat1', 'wldavis', 'lee489']",33,"['chrismy', 'ttli2', 'pitrak1', 'caldero1', 'huanggeng0726', 'paraclas', 'hur6', 'hbeberma', 'balistic2', 'nanocarbon', 'nanohub99', 'namanmehta', 'seanlee14', 'novitalmotive', 'ani3989', 'vliang88', 'jglauber', 'aamin9', 'hcho12', 'hwnano', 'madikaz', 'lindqui1', 'qwerasdf', 'wicky', 'asteriskzero', 'mahoney6', 'bmrice', 'wisechengyi', 'uribe2', 'lgarava2', 'tonywinoto', 'gbergsc2', 'xili1']",47,"['ericcj21', 'this1', 'kartiksanghi', 'meliu2', 'kdearnl2', 'bparajul', 'chongvi1', 'dhandle2', 'boruichen', 'lebedow1', 'yuqiao1', 'ageorges', 'atseng3', 'rosboro1', 'banker2', 'berndbhuber', 'gmonroy2', 'ramaith1', 'hochan5', 'mkhanna', 'ztrata2', 'acorral2', 'hnandagopal', 'roylee3', 'gomez14', 'rohansingh28', 'pandey3', 'artonis7', None, 'cjhughes17', 'boogajamooga', 'kumar28', 'daguri87', 'gravityplanx', 'l37', 'zhu22', 'ymoon4', 'choquett', 'sehrawa1', 'tongcheng', 'agarwa19', 'shin44', 'charishma', 'faorlando', 'nivero', 'deedarhuq', 'jlee4689']",156,"['ericcj21', 'kartiksanghi', 'meliu2', 'jchyan2', 'pitrak1', 'hipaulshi', 'malhotr3', 'fliu96', 'crazedcatatonic5', 'midnightblade', 'ddeutsc2', 'hur6', 'marshal2', 'bracon', 'asrinat2', 'kang92', 'hbeberma', 'nanocarbon', 'arappep2', 'abstrkt', 'fangwan2', 'xihan1', 'vliang88', 'hcho12', 'hwnano', 'kim857', 'roylee3', 'supercowking', 'wicky', 'luisccruz', 'rohansingh28', 'pessin', 'mahoney6', 'asteriskzero', 'bmrice', 'daguri87', 'sparklingway', 'ryanskim', 'lgarava2', 'tongcheng', 'chrisjryu', 'gbergsc2', 'xili1', 'deedarhuq', 'jlee4689', 'kdearnl2', 'alikation', 'yuqiao1', 'balistic2', 'atseng3', 'banker2', 'willtk0113', 'leiyang1', 'nanohub99', 'gmonroy2', 'jack_ftw', 'weller1', 'aamin9', 'gomez14', 'cjohns78', 'qwerasdf', 'pandey3', 'ma3xiao1', 'l37', 'chijiazuo', 'aggarwa3', 'rlew2', 'dbarnes2', 'joo4ny', 'snowpd', 'sehrawa1', 'choquett', 'idesis1', 'tkim28', 'agarwa19', 'weichunan', 'nivero', 'boogajamooga', 'wldavis', 'chrismy', 'ttli2', 'chongvi1', 'dhandle2', 'wu10', 'jeredgre', 'ligao1', 'lebedow1', 'ageorges', 'maemble', 'bikrambhatia', 'chen282', 'namanmehta', 'tchurch2', 'novitalmotive', 'ani3989', 'ramaith1', 'hochan5', 'tkim31', 'mkhanna', 'tarvitz', 'ztrata2', 'madikaz', 'jiyichenqi', 'collapse', 'dradefx', 'dbero2', 'jfelts', 'boegy3', 'wmjdgla', 'kumar28', 'efilli2', 'uribe2', 'tonywinoto', 'gravityplanx', 'black_chip21', 'ymoon4', 'kejriwa1', 'faorlando', 'ragunat1', 'lee489', 'this1', 'likpok', 'chengxu1', 'bparajul', 'ng21', 'luyun198993', 'boruichen', 'caldero1', 'megarza2', 'huanggeng0726', 'dusty493', 'paraclas', 'rosboro1', 'diablopbc', 'kim417', 'd98521', 'bongen2', 'berndbhuber', 'seanlee14', 'se210', 'dawei1', 'jglauber', 'dlgudwns11', 'tao7', 'schrock3', 'acorral2', 'hnandagopal', 'lindqui1', 'artonis7', None, 'cjhughes17', 'wisechengyi', 'aditchhabra', 'shin44', 'charishma', 'zhu22']"
2,62,110,92,74,"['likpok', 'ttli2', 'chengxu1', 'hipaulshi', 'malhotr3', 'wu10', 'jeredgre', 'fliu96', 'luyun198993', 'crazedcatatonic5', 'alikation', 'ligao1', 'megarza2', 'huanggeng0726', 'midnightblade', 'dusty493', 'ddeutsc2', 'marshal2', 'bracon', 'maemble', 'kang92', 'arappep2', 'bikrambhatia', 'fangwan2', 'abstrkt', 'diablopbc', 'xihan1', 'd98521', 'chen282', 'willtk0113', 'leiyang1', 'seanlee14', 'jack_ftw', 'tchurch2', 'se210', 'weller1', 'vliang88', 'tkim31', 'dlgudwns11', 'tarvitz', 'tao7', 'hcho12', 'schrock3', 'kim857', 'collapse', 'lindqui1', 'supercowking', 'luisccruz', 'qwerasdf', 'dradefx', 'dbero2', 'mahoney6', 'jfelts', 'wmjdgla', 'boegy3', 'wisechengyi', 'sparklingway', 'ryanskim', 'wldavis', 'efilli2', 'uribe2', 'chijiazuo', 'aggarwa3', 'dbarnes2', 'snowpd', 'joo4ny', 'aditchhabra', 'idesis1', 'chrisjryu', 'kejriwa1', 'weichunan', 'ragunat1', 'xili1', 'lee489']",35,"['chrismy', 'pitrak1', 'jchyan2', 'ng21', 'caldero1', 'paraclas', 'hur6', 'hbeberma', 'balistic2', 'asrinat2', 'nanocarbon', 'kim417', 'bongen2', 'nanohub99', 'namanmehta', 'novitalmotive', 'dawei1', 'ani3989', 'jglauber', 'aamin9', 'hwnano', 'madikaz', 'jiyichenqi', 'cjohns78', 'wicky', 'asteriskzero', 'pessin', 'bmrice', 'ma3xiao1', 'tonywinoto', 'lgarava2', 'black_chip21', 'rlew2', 'tkim28', 'gbergsc2']",18,"['kdko2', 'ramaith1', 'kumar28', 'rishabagarwal1', 'faorlando', 'banker2', 'l37', 'neumann9', 'pathak1', 'hnandag2', 'bparajul', None, 'shin65', 'shin44', 'gmonroy2', 'nivero', 'yuqiao1', 'deedarhuq']",127,"['jchyan2', 'pitrak1', 'hipaulshi', 'malhotr3', 'fliu96', 'crazedcatatonic5', 'midnightblade', 'ddeutsc2', 'hur6', 'marshal2', 'bracon', 'asrinat2', 'kang92', 'hbeberma', 'nanocarbon', 'arappep2', 'abstrkt', 'fangwan2', 'xihan1', 'vliang88', 'hcho12', 'hwnano', 'kim857', 'pathak1', 'supercowking', 'wicky', 'luisccruz', 'pessin', 'mahoney6', 'asteriskzero', 'bmrice', 'sparklingway', 'ryanskim', 'lgarava2', 'neumann9', 'chrisjryu', 'gbergsc2', 'xili1', 'deedarhuq', 'alikation', 'yuqiao1', 'balistic2', 'banker2', 'willtk0113', 'leiyang1', 'nanohub99', 'gmonroy2', 'jack_ftw', 'weller1', 'rishabagarwal1', 'aamin9', 'cjohns78', 'qwerasdf', 'ma3xiao1', 'l37', 'hnandag2', 'chijiazuo', 'aggarwa3', 'rlew2', 'dbarnes2', 'joo4ny', 'snowpd', 'idesis1', 'tkim28', 'weichunan', 'nivero', 'wldavis', 'chrismy', 'ttli2', 'wu10', 'jeredgre', 'ligao1', 'maemble', 'bikrambhatia', 'chen282', 'namanmehta', 'tchurch2', 'novitalmotive', 'kdko2', 'ani3989', 'ramaith1', 'tkim31', 'tarvitz', 'madikaz', 'jiyichenqi', 'collapse', 'dradefx', 'dbero2', 'jfelts', 'boegy3', 'wmjdgla', 'kumar28', 'efilli2', 'uribe2', 'tonywinoto', 'black_chip21', 'shin65', 'kejriwa1', 'faorlando', 'ragunat1', 'lee489', 'likpok', 'chengxu1', 'bparajul', 'ng21', 'luyun198993', 'caldero1', 'megarza2', 'huanggeng0726', 'dusty493', 'paraclas', 'diablopbc', 'kim417', 'd98521', 'bongen2', 'seanlee14', 'se210', 'dawei1', 'jglauber', 'dlgudwns11', 'tao7', 'schrock3', 'lindqui1', None, 'wisechengyi', 'aditchhabra', 'shin44']"
2,179,110,92,75,"['likpok', 'ttli2', 'chengxu1', 'hipaulshi', 'malhotr3', 'wu10', 'jeredgre', 'fliu96', 'luyun198993', 'crazedcatatonic5', 'alikation', 'ligao1', 'caldero1', 'megarza2', 'tkim28', 'huanggeng0726', 'midnightblade', 'dusty493', 'ddeutsc2', 'marshal2', 'balistic2', 'bracon', 'asrinat2', 'kang92', 'maemble', 'arappep2', 'bikrambhatia', 'paraclas', 'fangwan2', 'abstrkt', 'diablopbc', 'xihan1', 'kim417', 'd98521', 'chen282', 'willtk0113', 'leiyang1', 'bongen2', 'nanohub99', 'seanlee14', 'jack_ftw', 'tchurch2', 'se210', 'weller1', 'vliang88', 'tkim31', 'dlgudwns11', 'tao7', 'hcho12', 'schrock3', 'kim857', 'jiyichenqi', 'collapse', 'lindqui1', 'supercowking', 'luisccruz', 'cjohns78', 'qwerasdf', 'dradefx', 'dbero2', 'jfelts', 'wmjdgla', 'sparklingway', 'efilli2', 'uribe2', 'chijiazuo', 'aggarwa3', 'dbarnes2', 'joo4ny', 'idesis1', 'chrisjryu', 'kejriwa1', 'weichunan', 'ragunat1', 'wldavis']",34,"['chrismy', 'pitrak1', 'jchyan2', 'ng21', 'hur6', 'hbeberma', 'nanocarbon', 'namanmehta', 'novitalmotive', 'dawei1', 'ani3989', 'jglauber', 'tarvitz', 'aamin9', 'hwnano', 'madikaz', 'wicky', 'asteriskzero', 'pessin', 'mahoney6', 'boegy3', 'bmrice', 'ma3xiao1', 'wisechengyi', 'ryanskim', 'lgarava2', 'tonywinoto', 'black_chip21', 'rlew2', 'snowpd', 'aditchhabra', 'gbergsc2', 'xili1', 'lee489']",17,"['ramaith1', 'lenovo1709', 'rishabagarwal1', 'banker2', 'kabaran2', 'neumann9', 'pathak1', 'l37', 'hnandag2', 'chongvi1', 'bparajul', None, 'shin44', 'zhu22', 'rohansingh28', 'nivero', 'deedarhuq']",126,"['jchyan2', 'pitrak1', 'hipaulshi', 'malhotr3', 'fliu96', 'crazedcatatonic5', 'midnightblade', 'ddeutsc2', 'hur6', 'marshal2', 'bracon', 'asrinat2', 'kang92', 'hbeberma', 'nanocarbon', 'arappep2', 'abstrkt', 'fangwan2', 'xihan1', 'vliang88', 'hcho12', 'hwnano', 'kim857', 'pathak1', 'supercowking', 'wicky', 'luisccruz', 'rohansingh28', 'pessin', 'mahoney6', 'asteriskzero', 'bmrice', 'sparklingway', 'ryanskim', 'lgarava2', 'neumann9', 'chrisjryu', 'gbergsc2', 'xili1', 'deedarhuq', 'lenovo1709', 'alikation', 'balistic2', 'banker2', 'willtk0113', 'leiyang1', 'nanohub99', 'jack_ftw', 'weller1', 'rishabagarwal1', 'aamin9', 'kabaran2', 'cjohns78', 'qwerasdf', 'ma3xiao1', 'l37', 'hnandag2', 'chijiazuo', 'aggarwa3', 'rlew2', 'dbarnes2', 'joo4ny', 'snowpd', 'idesis1', 'tkim28', 'weichunan', 'nivero', 'wldavis', 'chrismy', 'ttli2', 'chongvi1', 'wu10', 'jeredgre', 'ligao1', 'maemble', 'bikrambhatia', 'chen282', 'namanmehta', 'tchurch2', 'novitalmotive', 'ani3989', 'ramaith1', 'tkim31', 'tarvitz', 'madikaz', 'jiyichenqi', 'collapse', 'dradefx', 'dbero2', 'jfelts', 'boegy3', 'wmjdgla', 'efilli2', 'uribe2', 'tonywinoto', 'black_chip21', 'kejriwa1', 'ragunat1', 'lee489', 'likpok', 'chengxu1', 'bparajul', 'ng21', 'luyun198993', 'caldero1', 'megarza2', 'huanggeng0726', 'dusty493', 'paraclas', 'diablopbc', 'kim417', 'd98521', 'bongen2', 'seanlee14', 'se210', 'dawei1', 'jglauber', 'dlgudwns11', 'tao7', 'schrock3', 'lindqui1', None, 'wisechengyi', 'aditchhabra', 'shin44', 'zhu22']"
2,37,110,78,58,"['chrismy', 'likpok', 'ttli2', 'pitrak1', 'chengxu1', 'hipaulshi', 'malhotr3', 'wu10', 'jeredgre', 'fliu96', 'ng21', 'crazedcatatonic5', 'alikation', 'ligao1', 'huanggeng0726', 'dusty493', 'balistic2', 'bracon', 'asrinat2', 'bikrambhatia', 'fangwan2', 'abstrkt', 'kim417', 'bongen2', 'nanohub99', 'jack_ftw', 'ani3989', 'vliang88', 'tkim31', 'tao7', 'tarvitz', 'aamin9', 'hcho12', 'schrock3', 'kim857', 'jiyichenqi', 'collapse', 'supercowking', 'qwerasdf', 'dradefx', 'dbero2', 'wmjdgla', 'boegy3', 'ma3xiao1', 'sparklingway', 'ryanskim', 'efilli2', 'chijiazuo', 'aggarwa3', 'dbarnes2', 'snowpd', 'joo4ny', 'aditchhabra', 'kejriwa1', 'weichunan', 'ragunat1', 'wldavis', 'lee489']",51,"['jchyan2', 'luyun198993', 'caldero1', 'megarza2', 'tkim28', 'midnightblade', 'ddeutsc2', 'hur6', 'marshal2', 'hbeberma', 'maemble', 'kang92', 'nanocarbon', 'arappep2', 'paraclas', 'diablopbc', 'xihan1', 'd98521', 'chen282', 'willtk0113', 'leiyang1', 'namanmehta', 'seanlee14', 'tchurch2', 'novitalmotive', 'se210', 'weller1', 'dawei1', 'jglauber', 'dlgudwns11', 'hwnano', 'madikaz', 'lindqui1', 'cjohns78', 'wicky', 'luisccruz', 'asteriskzero', 'pessin', 'mahoney6', 'jfelts', 'bmrice', 'wisechengyi', 'uribe2', 'lgarava2', 'tonywinoto', 'black_chip21', 'rlew2', 'idesis1', 'chrisjryu', 'gbergsc2', 'xili1']",20,"['this1', 'lenovo1709', 'bparajul', 'chongvi1', 'drmeyer87', 'gu1', 'dejarld2', 'banker2', 'gmonroy2', 'ramaith1', 'rishabagarwal1', 'pathak1', 'pandey3', 'rohansingh28', None, 'l37', 'neumann9', 'shin44', 'nivero', 'zhu22']",129,"['jchyan2', 'pitrak1', 'hipaulshi', 'malhotr3', 'fliu96', 'crazedcatatonic5', 'midnightblade', 'ddeutsc2', 'hur6', 'marshal2', 'bracon', 'asrinat2', 'kang92', 'hbeberma', 'nanocarbon', 'arappep2', 'abstrkt', 'fangwan2', 'xihan1', 'vliang88', 'hcho12', 'hwnano', 'kim857', 'pathak1', 'supercowking', 'wicky', 'luisccruz', 'rohansingh28', 'pessin', 'mahoney6', 'asteriskzero', 'bmrice', 'sparklingway', 'ryanskim', 'lgarava2', 'neumann9', 'chrisjryu', 'gbergsc2', 'xili1', 'lenovo1709', 'drmeyer87', 'alikation', 'dejarld2', 'balistic2', 'banker2', 'willtk0113', 'leiyang1', 'nanohub99', 'gmonroy2', 'jack_ftw', 'weller1', 'rishabagarwal1', 'aamin9', 'cjohns78', 'qwerasdf', 'pandey3', 'ma3xiao1', 'l37', 'chijiazuo', 'aggarwa3', 'rlew2', 'dbarnes2', 'joo4ny', 'snowpd', 'idesis1', 'tkim28', 'weichunan', 'nivero', 'wldavis', 'chrismy', 'ttli2', 'chongvi1', 'wu10', 'jeredgre', 'ligao1', 'gu1', 'maemble', 'bikrambhatia', 'chen282', 'namanmehta', 'tchurch2', 'novitalmotive', 'ani3989', 'ramaith1', 'tkim31', 'tarvitz', 'madikaz', 'jiyichenqi', 'collapse', 'dradefx', 'dbero2', 'jfelts', 'boegy3', 'wmjdgla', 'efilli2', 'uribe2', 'tonywinoto', 'black_chip21', 'kejriwa1', 'ragunat1', 'lee489', 'this1', 'likpok', 'chengxu1', 'bparajul', 'ng21', 'luyun198993', 'caldero1', 'megarza2', 'huanggeng0726', 'dusty493', 'paraclas', 'diablopbc', 'kim417', 'd98521', 'bongen2', 'seanlee14', 'se210', 'dawei1', 'jglauber', 'dlgudwns11', 'tao7', 'schrock3', 'lindqui1', None, 'wisechengyi', 'aditchhabra', 'shin44', 'zhu22']"
2,102,110,74,61,"['likpok', 'chengxu1', 'chrisjryu', 'malhotr3', 'ng21', 'jeredgre', 'fliu96', 'luyun198993', 'crazedcatatonic5', 'ligao1', 'alikation', 'caldero1', 'huanggeng0726', 'dusty493', 'marshal2', 'balistic2', 'maemble', 'asrinat2', 'arappep2', 'bikrambhatia', 'fangwan2', 'abstrkt', 'kim417', 'xihan1', 'bongen2', 'willtk0113', 'nanohub99', 'namanmehta', 'tchurch2', 'jack_ftw', 'se210', 'weller1', 'tkim31', 'tao7', 'tarvitz', 'aamin9', 'hcho12', 'schrock3', 'kim857', 'jiyichenqi', 'collapse', 'lindqui1', 'luisccruz', 'wicky', 'dradefx', 'dbero2', 'wmjdgla', 'boegy3', 'ma3xiao1', 'sparklingway', 'uribe2', 'efilli2', 'ryanskim', 'chijiazuo', 'aggarwa3', 'snowpd', 'aditchhabra', 'joo4ny', 'kejriwa1', 'tkim28', 'weichunan']",48,"['chrismy', 'ttli2', 'pitrak1', 'jchyan2', 'hipaulshi', 'wu10', 'megarza2', 'midnightblade', 'ddeutsc2', 'hur6', 'hbeberma', 'bracon', 'paraclas', 'kang92', 'nanocarbon', 'diablopbc', 'd98521', 'chen282', 'leiyang1', 'seanlee14', 'novitalmotive', 'dawei1', 'ani3989', 'vliang88', 'jglauber', 'dlgudwns11', 'hwnano', 'madikaz', 'supercowking', 'cjohns78', 'qwerasdf', 'ragunat1', 'asteriskzero', 'pessin', 'mahoney6', 'jfelts', 'bmrice', 'wisechengyi', 'wldavis', 'lgarava2', 'tonywinoto', 'black_chip21', 'rlew2', 'dbarnes2', 'idesis1', 'gbergsc2', 'xili1', 'lee489']",13,"['ramaith1', 'this1', 'kartiksanghi', 'bruete', 'bparajul', 'chongvi1', 'banker2', 'shin44', 'tongcheng', 'pandey3', 'gmonroy2', 'yuqiao1', None]",122,"['kartiksanghi', 'jchyan2', 'pitrak1', 'hipaulshi', 'malhotr3', 'fliu96', 'crazedcatatonic5', 'midnightblade', 'ddeutsc2', 'hur6', 'marshal2', 'bracon', 'asrinat2', 'kang92', 'hbeberma', 'nanocarbon', 'arappep2', 'abstrkt', 'fangwan2', 'xihan1', 'vliang88', 'hcho12', 'hwnano', 'kim857', 'supercowking', 'wicky', 'luisccruz', 'pessin', 'mahoney6', 'asteriskzero', 'bruete', 'bmrice', 'sparklingway', 'ryanskim', 'lgarava2', 'tongcheng', 'chrisjryu', 'gbergsc2', 'xili1', 'alikation', 'yuqiao1', 'balistic2', 'banker2', 'willtk0113', 'leiyang1', 'nanohub99', 'gmonroy2', 'jack_ftw', 'weller1', 'aamin9', 'cjohns78', 'qwerasdf', 'pandey3', 'ma3xiao1', 'chijiazuo', 'aggarwa3', 'rlew2', 'dbarnes2', 'joo4ny', 'snowpd', 'idesis1', 'tkim28', 'weichunan', 'wldavis', 'chrismy', 'ttli2', 'chongvi1', 'wu10', 'jeredgre', 'ligao1', 'maemble', 'bikrambhatia', 'chen282', 'namanmehta', 'tchurch2', 'novitalmotive', 'ani3989', 'ramaith1', 'tkim31', 'tarvitz', 'madikaz', 'jiyichenqi', 'collapse', 'dradefx', 'dbero2', 'jfelts', 'boegy3', 'wmjdgla', 'efilli2', 'uribe2', 'tonywinoto', 'black_chip21', 'kejriwa1', 'ragunat1', 'lee489', 'this1', 'likpok', 'chengxu1', 'bparajul', 'ng21', 'luyun198993', 'caldero1', 'megarza2', 'huanggeng0726', 'dusty493', 'paraclas', 'diablopbc', 'kim417', 'd98521', 'bongen2', 'seanlee14', 'se210', 'dawei1', 'jglauber', 'dlgudwns11', 'tao7', 'schrock3', 'lindqui1', None, 'wisechengyi', 'aditchhabra', 'shin44']"
2,180,110,20,15,"['hbeberma', 'nanocarbon', 'jchyan2', 'pitrak1', 'ma3xiao1', 'hwnano', 'madikaz', 'jeredgre', 'willtk0113', 'snowpd', 'lindqui1', 'alikation', 'cjohns78', 'idesis1', 'ragunat1']",94,"['chrismy', 'ttli2', 'hipaulshi', 'malhotr3', 'wu10', 'fliu96', 'crazedcatatonic5', 'ligao1', 'midnightblade', 'ddeutsc2', 'hur6', 'marshal2', 'bracon', 'asrinat2', 'kang92', 'arappep2', 'maemble', 'abstrkt', 'fangwan2', 'bikrambhatia', 'xihan1', 'chen282', 'namanmehta', 'tchurch2', 'novitalmotive', 'ani3989', 'vliang88', 'tkim31', 'tarvitz', 'hcho12', 'kim857', 'jiyichenqi', 'collapse', 'supercowking', 'wicky', 'luisccruz', 'dradefx', 'pessin', 'mahoney6', 'asteriskzero', 'dbero2', 'jfelts', 'boegy3', 'wmjdgla', 'bmrice', 'sparklingway', 'ryanskim', 'lgarava2', 'efilli2', 'uribe2', 'tonywinoto', 'black_chip21', 'kejriwa1', 'chrisjryu', 'gbergsc2', 'xili1', 'lee489', 'likpok', 'chengxu1', 'ng21', 'luyun198993', 'caldero1', 'megarza2', 'huanggeng0726', 'dusty493', 'paraclas', 'balistic2', 'diablopbc', 'kim417', 'd98521', 'bongen2', 'leiyang1', 'nanohub99', 'seanlee14', 'jack_ftw', 'se210', 'weller1', 'dawei1', 'jglauber', 'dlgudwns11', 'tao7', 'aamin9', 'schrock3', 'qwerasdf', 'wisechengyi', 'chijiazuo', 'aggarwa3', 'rlew2', 'dbarnes2', 'joo4ny', 'aditchhabra', 'tkim28', 'weichunan', 'wldavis']",5,"['ramaith1', 'lenovo1709', 'chongvi1', 'pathak1', None]",114,"['chrismy', 'ttli2', 'jchyan2', 'pitrak1', 'chongvi1', 'hipaulshi', 'malhotr3', 'wu10', 'jeredgre', 'fliu96', 'crazedcatatonic5', 'ligao1', 'midnightblade', 'ddeutsc2', 'hur6', 'marshal2', 'bracon', 'asrinat2', 'kang92', 'hbeberma', 'nanocarbon', 'arappep2', 'maemble', 'abstrkt', 'fangwan2', 'bikrambhatia', 'xihan1', 'chen282', 'namanmehta', 'tchurch2', 'novitalmotive', 'ani3989', 'ramaith1', 'vliang88', 'tkim31', 'tarvitz', 'hcho12', 'hwnano', 'kim857', 'madikaz', 'pathak1', 'jiyichenqi', 'collapse', 'supercowking', 'wicky', 'luisccruz', 'dradefx', 'pessin', 'mahoney6', 'asteriskzero', 'dbero2', 'jfelts', 'boegy3', 'wmjdgla', 'bmrice', 'sparklingway', 'ryanskim', 'lgarava2', 'efilli2', 'uribe2', 'tonywinoto', 'black_chip21', 'kejriwa1', 'chrisjryu', 'gbergsc2', 'xili1', 'ragunat1', 'lee489', 'likpok', 'lenovo1709', 'chengxu1', 'ng21', 'luyun198993', 'alikation', 'caldero1', 'megarza2', 'huanggeng0726', 'dusty493', 'paraclas', 'balistic2', 'diablopbc', 'kim417', 'd98521', 'bongen2', 'willtk0113', 'leiyang1', 'nanohub99', 'seanlee14', 'jack_ftw', 'se210', 'weller1', 'dawei1', 'jglauber', 'dlgudwns11', 'tao7', 'aamin9', 'schrock3', 'lindqui1', 'cjohns78', 'qwerasdf', None, 'ma3xiao1', 'wisechengyi', 'chijiazuo', 'aggarwa3', 'rlew2', 'dbarnes2', 'joo4ny', 'snowpd', 'aditchhabra', 'idesis1', 'tkim28', 'weichunan', 'wldavis']"
2,39,110,17,13,"['weller1', 'chrismy', 'hur6', 'dawei1', 'kang92', 'wisechengyi', 'tonywinoto', 'black_chip21', 'xihan1', 'jack_ftw', 'se210', 'pessin', 'mahoney6']",96,"['ttli2', 'jchyan2', 'pitrak1', 'hipaulshi', 'malhotr3', 'wu10', 'jeredgre', 'fliu96', 'crazedcatatonic5', 'ligao1', 'midnightblade', 'ddeutsc2', 'marshal2', 'bracon', 'asrinat2', 'hbeberma', 'nanocarbon', 'arappep2', 'maemble', 'abstrkt', 'fangwan2', 'bikrambhatia', 'chen282', 'namanmehta', 'tchurch2', 'novitalmotive', 'ani3989', 'vliang88', 'tkim31', 'tarvitz', 'hcho12', 'hwnano', 'kim857', 'madikaz', 'jiyichenqi', 'collapse', 'supercowking', 'wicky', 'luisccruz', 'dradefx', 'asteriskzero', 'dbero2', 'jfelts', 'boegy3', 'wmjdgla', 'bmrice', 'sparklingway', 'ryanskim', 'lgarava2', 'efilli2', 'uribe2', 'kejriwa1', 'chrisjryu', 'gbergsc2', 'xili1', 'ragunat1', 'lee489', 'likpok', 'chengxu1', 'ng21', 'luyun198993', 'alikation', 'caldero1', 'megarza2', 'huanggeng0726', 'dusty493', 'paraclas', 'balistic2', 'diablopbc', 'kim417', 'd98521', 'bongen2', 'willtk0113', 'leiyang1', 'nanohub99', 'seanlee14', 'jglauber', 'dlgudwns11', 'tao7', 'aamin9', 'schrock3', 'lindqui1', 'cjohns78', 'qwerasdf', 'ma3xiao1', 'chijiazuo', 'aggarwa3', 'rlew2', 'dbarnes2', 'joo4ny', 'snowpd', 'aditchhabra', 'idesis1', 'tkim28', 'weichunan', 'wldavis']",4,"['bruete', None, 'zhu22', 'gu1']",113,"['chrismy', 'ttli2', 'jchyan2', 'pitrak1', 'hipaulshi', 'malhotr3', 'wu10', 'jeredgre', 'fliu96', 'crazedcatatonic5', 'ligao1', 'midnightblade', 'gu1', 'ddeutsc2', 'hur6', 'marshal2', 'bracon', 'asrinat2', 'kang92', 'hbeberma', 'nanocarbon', 'arappep2', 'maemble', 'abstrkt', 'fangwan2', 'bikrambhatia', 'xihan1', 'chen282', 'namanmehta', 'tchurch2', 'novitalmotive', 'ani3989', 'vliang88', 'tkim31', 'tarvitz', 'hcho12', 'hwnano', 'kim857', 'madikaz', 'jiyichenqi', 'collapse', 'supercowking', 'wicky', 'luisccruz', 'dradefx', 'pessin', 'mahoney6', 'asteriskzero', 'dbero2', 'jfelts', 'bruete', 'boegy3', 'wmjdgla', 'bmrice', 'sparklingway', 'ryanskim', 'lgarava2', 'efilli2', 'uribe2', 'tonywinoto', 'black_chip21', 'kejriwa1', 'chrisjryu', 'gbergsc2', 'xili1', 'ragunat1', 'lee489', 'likpok', 'chengxu1', 'ng21', 'luyun198993', 'alikation', 'caldero1', 'megarza2', 'huanggeng0726', 'dusty493', 'paraclas', 'balistic2', 'diablopbc', 'kim417', 'd98521', 'bongen2', 'willtk0113', 'leiyang1', 'nanohub99', 'seanlee14', 'jack_ftw', 'se210', 'weller1', 'dawei1', 'jglauber', 'dlgudwns11', 'tao7', 'aamin9', 'schrock3', 'lindqui1', 'cjohns78', 'qwerasdf', None, 'ma3xiao1', 'wisechengyi', 'chijiazuo', 'aggarwa3', 'rlew2', 'dbarnes2', 'joo4ny', 'snowpd', 'aditchhabra', 'idesis1', 'tkim28', 'weichunan', 'zhu22', 'wldavis']"
2,65,110,17,13,"['weller1', 'chrismy', 'hur6', 'ani3989', 'dawei1', 'tonywinoto', 'black_chip21', 'xihan1', 'fliu96', 'lindqui1', 'kejriwa1', 'se210', 'pessin']",96,"['ttli2', 'jchyan2', 'pitrak1', 'hipaulshi', 'malhotr3', 'wu10', 'jeredgre', 'crazedcatatonic5', 'ligao1', 'midnightblade', 'ddeutsc2', 'marshal2', 'bracon', 'asrinat2', 'kang92', 'hbeberma', 'nanocarbon', 'arappep2', 'maemble', 'abstrkt', 'fangwan2', 'bikrambhatia', 'chen282', 'namanmehta', 'tchurch2', 'novitalmotive', 'vliang88', 'tkim31', 'tarvitz', 'hcho12', 'hwnano', 'kim857', 'madikaz', 'jiyichenqi', 'collapse', 'supercowking', 'wicky', 'luisccruz', 'dradefx', 'mahoney6', 'asteriskzero', 'dbero2', 'jfelts', 'boegy3', 'wmjdgla', 'bmrice', 'sparklingway', 'ryanskim', 'lgarava2', 'efilli2', 'uribe2', 'chrisjryu', 'gbergsc2', 'xili1', 'ragunat1', 'lee489', 'likpok', 'chengxu1', 'ng21', 'luyun198993', 'alikation', 'caldero1', 'megarza2', 'huanggeng0726', 'dusty493', 'paraclas', 'balistic2', 'diablopbc', 'kim417', 'd98521', 'bongen2', 'willtk0113', 'leiyang1', 'nanohub99', 'seanlee14', 'jack_ftw', 'jglauber', 'dlgudwns11', 'tao7', 'aamin9', 'schrock3', 'cjohns78', 'qwerasdf', 'ma3xiao1', 'wisechengyi', 'chijiazuo', 'aggarwa3', 'rlew2', 'dbarnes2', 'joo4ny', 'snowpd', 'aditchhabra', 'idesis1', 'tkim28', 'weichunan', 'wldavis']",4,"['gmonroy2', 'gavin_campbell', None, 'gu1']",113,"['chrismy', 'ttli2', 'jchyan2', 'pitrak1', 'hipaulshi', 'malhotr3', 'wu10', 'jeredgre', 'fliu96', 'crazedcatatonic5', 'ligao1', 'midnightblade', 'gu1', 'ddeutsc2', 'hur6', 'marshal2', 'bracon', 'asrinat2', 'kang92', 'hbeberma', 'nanocarbon', 'arappep2', 'maemble', 'abstrkt', 'fangwan2', 'bikrambhatia', 'xihan1', 'chen282', 'namanmehta', 'tchurch2', 'novitalmotive', 'ani3989', 'vliang88', 'tkim31', 'tarvitz', 'hcho12', 'hwnano', 'kim857', 'madikaz', 'jiyichenqi', 'collapse', 'supercowking', 'wicky', 'luisccruz', 'dradefx', 'pessin', 'mahoney6', 'asteriskzero', 'dbero2', 'jfelts', 'gavin_campbell', 'boegy3', 'wmjdgla', 'bmrice', 'sparklingway', 'ryanskim', 'lgarava2', 'efilli2', 'uribe2', 'tonywinoto', 'black_chip21', 'kejriwa1', 'chrisjryu', 'gbergsc2', 'xili1', 'ragunat1', 'lee489', 'likpok', 'chengxu1', 'ng21', 'luyun198993', 'alikation', 'caldero1', 'megarza2', 'huanggeng0726', 'dusty493', 'paraclas', 'balistic2', 'diablopbc', 'kim417', 'd98521', 'bongen2', 'willtk0113', 'leiyang1', 'nanohub99', 'gmonroy2', 'seanlee14', 'jack_ftw', 'se210', 'weller1', 'dawei1', 'jglauber', 'dlgudwns11', 'tao7', 'aamin9', 'schrock3', 'lindqui1', 'cjohns78', 'qwerasdf', None, 'ma3xiao1', 'wisechengyi', 'chijiazuo', 'aggarwa3', 'rlew2', 'dbarnes2', 'joo4ny', 'snowpd', 'aditchhabra', 'idesis1', 'tkim28', 'weichunan', 'wldavis']"
2,77,110,17,11,"['likpok', 'pitrak1', 'arappep2', 'efilli2', 'madikaz', 'cjohns78', 'snowpd', 'caldero1', 'namanmehta', 'seanlee14', 'gbergsc2']",98,"['chrismy', 'ttli2', 'jchyan2', 'hipaulshi', 'malhotr3', 'wu10', 'jeredgre', 'fliu96', 'crazedcatatonic5', 'ligao1', 'midnightblade', 'ddeutsc2', 'hur6', 'marshal2', 'bracon', 'asrinat2', 'kang92', 'hbeberma', 'nanocarbon', 'maemble', 'abstrkt', 'fangwan2', 'bikrambhatia', 'xihan1', 'chen282', 'tchurch2', 'novitalmotive', 'ani3989', 'vliang88', 'tkim31', 'tarvitz', 'hcho12', 'hwnano', 'kim857', 'jiyichenqi', 'collapse', 'supercowking', 'wicky', 'luisccruz', 'dradefx', 'pessin', 'mahoney6', 'asteriskzero', 'dbero2', 'jfelts', 'boegy3', 'wmjdgla', 'bmrice', 'sparklingway', 'ryanskim', 'lgarava2', 'uribe2', 'tonywinoto', 'black_chip21', 'kejriwa1', 'chrisjryu', 'xili1', 'ragunat1', 'lee489', 'chengxu1', 'ng21', 'luyun198993', 'alikation', 'megarza2', 'huanggeng0726', 'dusty493', 'paraclas', 'balistic2', 'diablopbc', 'kim417', 'd98521', 'bongen2', 'willtk0113', 'leiyang1', 'nanohub99', 'jack_ftw', 'se210', 'weller1', 'dawei1', 'jglauber', 'dlgudwns11', 'tao7', 'aamin9', 'schrock3', 'lindqui1', 'qwerasdf', 'ma3xiao1', 'wisechengyi', 'chijiazuo', 'aggarwa3', 'rlew2', 'dbarnes2', 'joo4ny', 'aditchhabra', 'idesis1', 'tkim28', 'weichunan', 'wldavis']",6,"['kartiksanghi', 'kknapp', 'drmalkovich', 'tongcheng', 'kdko2', None]",115,"['chrismy', 'kartiksanghi', 'ttli2', 'jchyan2', 'pitrak1', 'hipaulshi', 'malhotr3', 'wu10', 'jeredgre', 'fliu96', 'crazedcatatonic5', 'ligao1', 'midnightblade', 'ddeutsc2', 'hur6', 'marshal2', 'bracon', 'asrinat2', 'kang92', 'hbeberma', 'nanocarbon', 'arappep2', 'maemble', 'abstrkt', 'fangwan2', 'bikrambhatia', 'xihan1', 'chen282', 'namanmehta', 'tchurch2', 'novitalmotive', 'kdko2', 'ani3989', 'vliang88', 'tkim31', 'tarvitz', 'hcho12', 'hwnano', 'kim857', 'madikaz', 'jiyichenqi', 'drmalkovich', 'collapse', 'supercowking', 'wicky', 'luisccruz', 'dradefx', 'pessin', 'mahoney6', 'asteriskzero', 'dbero2', 'jfelts', 'boegy3', 'wmjdgla', 'bmrice', 'sparklingway', 'ryanskim', 'lgarava2', 'efilli2', 'uribe2', 'tonywinoto', 'black_chip21', 'tongcheng', 'kejriwa1', 'chrisjryu', 'gbergsc2', 'xili1', 'ragunat1', 'lee489', 'likpok', 'chengxu1', 'kknapp', 'ng21', 'luyun198993', 'alikation', 'caldero1', 'megarza2', 'huanggeng0726', 'dusty493', 'paraclas', 'balistic2', 'diablopbc', 'kim417', 'd98521', 'bongen2', 'willtk0113', 'leiyang1', 'nanohub99', 'seanlee14', 'jack_ftw', 'se210', 'weller1', 'dawei1', 'jglauber', 'dlgudwns11', 'tao7', 'aamin9', 'schrock3', 'lindqui1', 'cjohns78', 'qwerasdf', None, 'ma3xiao1', 'wisechengyi', 'chijiazuo', 'aggarwa3', 'rlew2', 'dbarnes2', 'joo4ny', 'snowpd', 'aditchhabra', 'idesis1', 'tkim28', 'weichunan', 'wldavis']"
2,44,110,15,10,"['jfelts', 'tonywinoto', 'bikrambhatia', 'xihan1', 'jiyichenqi', 'bongen2', 'snowpd', 'chrisjryu', 'se210', 'lee489']",99,"['chrismy', 'ttli2', 'jchyan2', 'pitrak1', 'hipaulshi', 'malhotr3', 'wu10', 'jeredgre', 'fliu96', 'crazedcatatonic5', 'ligao1', 'midnightblade', 'ddeutsc2', 'hur6', 'marshal2', 'bracon', 'asrinat2', 'kang92', 'hbeberma', 'nanocarbon', 'arappep2', 'maemble', 'abstrkt', 'fangwan2', 'chen282', 'namanmehta', 'tchurch2', 'novitalmotive', 'ani3989', 'vliang88', 'tkim31', 'tarvitz', 'hcho12', 'hwnano', 'kim857', 'madikaz', 'collapse', 'supercowking', 'wicky', 'luisccruz', 'dradefx', 'pessin', 'mahoney6', 'asteriskzero', 'dbero2', 'boegy3', 'wmjdgla', 'bmrice', 'sparklingway', 'ryanskim', 'lgarava2', 'efilli2', 'uribe2', 'black_chip21', 'kejriwa1', 'gbergsc2', 'xili1', 'ragunat1', 'likpok', 'chengxu1', 'ng21', 'luyun198993', 'alikation', 'caldero1', 'megarza2', 'huanggeng0726', 'dusty493', 'paraclas', 'balistic2', 'diablopbc', 'kim417', 'd98521', 'willtk0113', 'leiyang1', 'nanohub99', 'seanlee14', 'jack_ftw', 'weller1', 'dawei1', 'jglauber', 'dlgudwns11', 'tao7', 'aamin9', 'schrock3', 'lindqui1', 'cjohns78', 'qwerasdf', 'ma3xiao1', 'wisechengyi', 'chijiazuo', 'aggarwa3', 'rlew2', 'dbarnes2', 'joo4ny', 'aditchhabra', 'idesis1', 'tkim28', 'weichunan', 'wldavis']",5,"['sjmckeown', None, 'gmonroy2', 'kdko2', 'zhu22']",114,"['chrismy', 'ttli2', 'jchyan2', 'pitrak1', 'hipaulshi', 'malhotr3', 'wu10', 'jeredgre', 'fliu96', 'crazedcatatonic5', 'ligao1', 'midnightblade', 'ddeutsc2', 'hur6', 'marshal2', 'bracon', 'asrinat2', 'kang92', 'hbeberma', 'nanocarbon', 'arappep2', 'maemble', 'abstrkt', 'fangwan2', 'bikrambhatia', 'xihan1', 'chen282', 'namanmehta', 'tchurch2', 'novitalmotive', 'kdko2', 'ani3989', 'vliang88', 'tkim31', 'tarvitz', 'hcho12', 'hwnano', 'kim857', 'madikaz', 'jiyichenqi', 'collapse', 'supercowking', 'wicky', 'luisccruz', 'dradefx', 'pessin', 'mahoney6', 'asteriskzero', 'dbero2', 'jfelts', 'boegy3', 'wmjdgla', 'bmrice', 'sparklingway', 'ryanskim', 'lgarava2', 'efilli2', 'uribe2', 'tonywinoto', 'black_chip21', 'kejriwa1', 'chrisjryu', 'gbergsc2', 'xili1', 'ragunat1', 'lee489', 'likpok', 'chengxu1', 'ng21', 'luyun198993', 'alikation', 'caldero1', 'megarza2', 'sjmckeown', 'huanggeng0726', 'dusty493', 'paraclas', 'balistic2', 'diablopbc', 'kim417', 'd98521', 'bongen2', 'willtk0113', 'leiyang1', 'nanohub99', 'gmonroy2', 'seanlee14', 'jack_ftw', 'se210', 'weller1', 'dawei1', 'jglauber', 'dlgudwns11', 'tao7', 'aamin9', 'schrock3', 'lindqui1', 'cjohns78', 'qwerasdf', None, 'ma3xiao1', 'wisechengyi', 'chijiazuo', 'aggarwa3', 'rlew2', 'dbarnes2', 'joo4ny', 'snowpd', 'aditchhabra', 'idesis1', 'tkim28', 'weichunan', 'zhu22', 'wldavis']"
2,78,110,15,9,"['weller1', 'ani3989', 'hur6', 'wisechengyi', 'black_chip21', 'xihan1', 'lindqui1', 'kejriwa1', 'mahoney6']",100,"['chrismy', 'ttli2', 'jchyan2', 'pitrak1', 'hipaulshi', 'malhotr3', 'wu10', 'jeredgre', 'fliu96', 'crazedcatatonic5', 'ligao1', 'midnightblade', 'ddeutsc2', 'marshal2', 'bracon', 'asrinat2', 'kang92', 'hbeberma', 'nanocarbon', 'arappep2', 'maemble', 'abstrkt', 'fangwan2', 'bikrambhatia', 'chen282', 'namanmehta', 'tchurch2', 'novitalmotive', 'vliang88', 'tkim31', 'tarvitz', 'hcho12', 'hwnano', 'kim857', 'madikaz', 'jiyichenqi', 'collapse', 'supercowking', 'wicky', 'luisccruz', 'dradefx', 'pessin', 'asteriskzero', 'dbero2', 'jfelts', 'boegy3', 'wmjdgla', 'bmrice', 'sparklingway', 'ryanskim', 'lgarava2', 'efilli2', 'uribe2', 'tonywinoto', 'chrisjryu', 'gbergsc2', 'xili1', 'ragunat1', 'lee489', 'likpok', 'chengxu1', 'ng21', 'luyun198993', 'alikation', 'caldero1', 'megarza2', 'huanggeng0726', 'dusty493', 'paraclas', 'balistic2', 'diablopbc', 'kim417', 'd98521', 'bongen2', 'willtk0113', 'leiyang1', 'nanohub99', 'seanlee14', 'jack_ftw', 'se210', 'dawei1', 'jglauber', 'dlgudwns11', 'tao7', 'aamin9', 'schrock3', 'cjohns78', 'qwerasdf', 'ma3xiao1', 'chijiazuo', 'aggarwa3', 'rlew2', 'dbarnes2', 'joo4ny', 'snowpd', 'aditchhabra', 'idesis1', 'tkim28', 'weichunan', 'wldavis']",6,"['gavin_campbell', 'gravityplanx', 'gmonroy2', 'williamhn', None, 'gu1']",115,"['chrismy', 'ttli2', 'jchyan2', 'pitrak1', 'hipaulshi', 'malhotr3', 'wu10', 'jeredgre', 'fliu96', 'crazedcatatonic5', 'ligao1', 'midnightblade', 'gu1', 'ddeutsc2', 'hur6', 'marshal2', 'bracon', 'asrinat2', 'kang92', 'hbeberma', 'nanocarbon', 'arappep2', 'maemble', 'abstrkt', 'fangwan2', 'bikrambhatia', 'xihan1', 'chen282', 'namanmehta', 'tchurch2', 'novitalmotive', 'ani3989', 'vliang88', 'tkim31', 'tarvitz', 'hcho12', 'hwnano', 'kim857', 'madikaz', 'jiyichenqi', 'collapse', 'supercowking', 'wicky', 'luisccruz', 'dradefx', 'pessin', 'mahoney6', 'asteriskzero', 'dbero2', 'jfelts', 'gavin_campbell', 'boegy3', 'wmjdgla', 'bmrice', 'sparklingway', 'ryanskim', 'lgarava2', 'efilli2', 'uribe2', 'tonywinoto', 'black_chip21', 'gravityplanx', 'kejriwa1', 'chrisjryu', 'gbergsc2', 'xili1', 'ragunat1', 'lee489', 'likpok', 'chengxu1', 'ng21', 'luyun198993', 'alikation', 'caldero1', 'megarza2', 'huanggeng0726', 'dusty493', 'paraclas', 'balistic2', 'diablopbc', 'kim417', 'd98521', 'bongen2', 'willtk0113', 'leiyang1', 'nanohub99', 'gmonroy2', 'seanlee14', 'jack_ftw', 'williamhn', 'se210', 'weller1', 'dawei1', 'jglauber', 'dlgudwns11', 'tao7', 'aamin9', 'schrock3', 'lindqui1', 'cjohns78', 'qwerasdf', None, 'ma3xiao1', 'wisechengyi', 'chijiazuo', 'aggarwa3', 'rlew2', 'dbarnes2', 'joo4ny', 'snowpd', 'aditchhabra', 'idesis1', 'tkim28', 'weichunan', 'wldavis']"
2,103,110,15,13,"['weller1', 'chrismy', 'hur6', 'dawei1', 'dlgudwns11', 'kang92', 'wisechengyi', 'sparklingway', 'ma3xiao1', 'tonywinoto', 'black_chip21', 'xihan1', 'mahoney6']",96,"['ttli2', 'jchyan2', 'pitrak1', 'hipaulshi', 'malhotr3', 'wu10', 'jeredgre', 'fliu96', 'crazedcatatonic5', 'ligao1', 'midnightblade', 'ddeutsc2', 'marshal2', 'bracon', 'asrinat2', 'hbeberma', 'nanocarbon', 'arappep2', 'maemble', 'abstrkt', 'fangwan2', 'bikrambhatia', 'chen282', 'namanmehta', 'tchurch2', 'novitalmotive', 'ani3989', 'vliang88', 'tkim31', 'tarvitz', 'hcho12', 'hwnano', 'kim857', 'madikaz', 'jiyichenqi', 'collapse', 'supercowking', 'wicky', 'luisccruz', 'dradefx', 'pessin', 'asteriskzero', 'dbero2', 'jfelts', 'boegy3', 'wmjdgla', 'bmrice', 'ryanskim', 'lgarava2', 'efilli2', 'uribe2', 'kejriwa1', 'chrisjryu', 'gbergsc2', 'xili1', 'ragunat1', 'lee489', 'likpok', 'chengxu1', 'ng21', 'luyun198993', 'alikation', 'caldero1', 'megarza2', 'huanggeng0726', 'dusty493', 'paraclas', 'balistic2', 'diablopbc', 'kim417', 'd98521', 'bongen2', 'willtk0113', 'leiyang1', 'nanohub99', 'seanlee14', 'jack_ftw', 'se210', 'jglauber', 'tao7', 'aamin9', 'schrock3', 'lindqui1', 'cjohns78', 'qwerasdf', 'chijiazuo', 'aggarwa3', 'rlew2', 'dbarnes2', 'joo4ny', 'snowpd', 'aditchhabra', 'idesis1', 'tkim28', 'weichunan', 'wldavis']",2,"['gavin_campbell', None]",111,"['chrismy', 'ttli2', 'jchyan2', 'pitrak1', 'hipaulshi', 'malhotr3', 'wu10', 'jeredgre', 'fliu96', 'crazedcatatonic5', 'ligao1', 'midnightblade', 'ddeutsc2', 'hur6', 'marshal2', 'bracon', 'asrinat2', 'kang92', 'hbeberma', 'nanocarbon', 'arappep2', 'maemble', 'abstrkt', 'fangwan2', 'bikrambhatia', 'xihan1', 'chen282', 'namanmehta', 'tchurch2', 'novitalmotive', 'ani3989', 'vliang88', 'tkim31', 'tarvitz', 'hcho12', 'hwnano', 'kim857', 'madikaz', 'jiyichenqi', 'collapse', 'supercowking', 'wicky', 'luisccruz', 'dradefx', 'pessin', 'mahoney6', 'asteriskzero', 'dbero2', 'jfelts', 'gavin_campbell', 'boegy3', 'wmjdgla', 'bmrice', 'sparklingway', 'ryanskim', 'lgarava2', 'efilli2', 'uribe2', 'tonywinoto', 'black_chip21', 'kejriwa1', 'chrisjryu', 'gbergsc2', 'xili1', 'ragunat1', 'lee489', 'likpok', 'chengxu1', 'ng21', 'luyun198993', 'alikation', 'caldero1', 'megarza2', 'huanggeng0726', 'dusty493', 'paraclas', 'balistic2', 'diablopbc', 'kim417', 'd98521', 'bongen2', 'willtk0113', 'leiyang1', 'nanohub99', 'seanlee14', 'jack_ftw', 'se210', 'weller1', 'dawei1', 'jglauber', 'dlgudwns11', 'tao7', 'aamin9', 'schrock3', 'lindqui1', 'cjohns78', 'qwerasdf', None, 'ma3xiao1', 'wisechengyi', 'chijiazuo', 'aggarwa3', 'rlew2', 'dbarnes2', 'joo4ny', 'snowpd', 'aditchhabra', 'idesis1', 'tkim28', 'weichunan', 'wldavis']"
2,181,110,15,13,"['weller1', 'chrismy', 'hur6', 'ani3989', 'dawei1', 'wisechengyi', 'tonywinoto', 'black_chip21', 'xihan1', 'kejriwa1', 'se210', 'pessin', 'mahoney6']",96,"['ttli2', 'jchyan2', 'pitrak1', 'hipaulshi', 'malhotr3', 'wu10', 'jeredgre', 'fliu96', 'crazedcatatonic5', 'ligao1', 'midnightblade', 'ddeutsc2', 'marshal2', 'bracon', 'asrinat2', 'kang92', 'hbeberma', 'nanocarbon', 'arappep2', 'maemble', 'abstrkt', 'fangwan2', 'bikrambhatia', 'chen282', 'namanmehta', 'tchurch2', 'novitalmotive', 'vliang88', 'tkim31', 'tarvitz', 'hcho12', 'hwnano', 'kim857', 'madikaz', 'jiyichenqi', 'collapse', 'supercowking', 'wicky', 'luisccruz', 'dradefx', 'asteriskzero', 'dbero2', 'jfelts', 'boegy3', 'wmjdgla', 'bmrice', 'sparklingway', 'ryanskim', 'lgarava2', 'efilli2', 'uribe2', 'chrisjryu', 'gbergsc2', 'xili1', 'ragunat1', 'lee489', 'likpok', 'chengxu1', 'ng21', 'luyun198993', 'alikation', 'caldero1', 'megarza2', 'huanggeng0726', 'dusty493', 'paraclas', 'balistic2', 'diablopbc', 'kim417', 'd98521', 'bongen2', 'willtk0113', 'leiyang1', 'nanohub99', 'seanlee14', 'jack_ftw', 'jglauber', 'dlgudwns11', 'tao7', 'aamin9', 'schrock3', 'lindqui1', 'cjohns78', 'qwerasdf', 'ma3xiao1', 'chijiazuo', 'aggarwa3', 'rlew2', 'dbarnes2', 'joo4ny', 'snowpd', 'aditchhabra', 'idesis1', 'tkim28', 'weichunan', 'wldavis']",2,"['gmonroy2', None]",111,"['chrismy', 'ttli2', 'jchyan2', 'pitrak1', 'hipaulshi', 'malhotr3', 'wu10', 'jeredgre', 'fliu96', 'crazedcatatonic5', 'ligao1', 'midnightblade', 'ddeutsc2', 'hur6', 'marshal2', 'bracon', 'asrinat2', 'kang92', 'hbeberma', 'nanocarbon', 'arappep2', 'maemble', 'abstrkt', 'fangwan2', 'bikrambhatia', 'xihan1', 'chen282', 'namanmehta', 'tchurch2', 'novitalmotive', 'ani3989', 'vliang88', 'tkim31', 'tarvitz', 'hcho12', 'hwnano', 'kim857', 'madikaz', 'jiyichenqi', 'collapse', 'supercowking', 'wicky', 'luisccruz', 'dradefx', 'pessin', 'mahoney6', 'asteriskzero', 'dbero2', 'jfelts', 'boegy3', 'wmjdgla', 'bmrice', 'sparklingway', 'ryanskim', 'lgarava2', 'efilli2', 'uribe2', 'tonywinoto', 'black_chip21', 'kejriwa1', 'chrisjryu', 'gbergsc2', 'xili1', 'ragunat1', 'lee489', 'likpok', 'chengxu1', 'ng21', 'luyun198993', 'alikation', 'caldero1', 'megarza2', 'huanggeng0726', 'dusty493', 'paraclas', 'balistic2', 'diablopbc', 'kim417', 'd98521', 'bongen2', 'willtk0113', 'leiyang1', 'nanohub99', 'gmonroy2', 'seanlee14', 'jack_ftw', 'se210', 'weller1', 'dawei1', 'jglauber', 'dlgudwns11', 'tao7', 'aamin9', 'schrock3', 'lindqui1', 'cjohns78', 'qwerasdf', None, 'ma3xiao1', 'wisechengyi', 'chijiazuo', 'aggarwa3', 'rlew2', 'dbarnes2', 'joo4ny', 'snowpd', 'aditchhabra', 'idesis1', 'tkim28', 'weichunan', 'wldavis']"
2,79,110,12,9,"['hbeberma', 'boegy3', 'ttli2', 'tarvitz', 'jchyan2', 'hwnano', 'jeredgre', 'idesis1', 'tkim28']",100,"['chrismy', 'pitrak1', 'hipaulshi', 'malhotr3', 'wu10', 'fliu96', 'crazedcatatonic5', 'ligao1', 'midnightblade', 'ddeutsc2', 'hur6', 'marshal2', 'bracon', 'asrinat2', 'kang92', 'nanocarbon', 'arappep2', 'maemble', 'abstrkt', 'fangwan2', 'bikrambhatia', 'xihan1', 'chen282', 'namanmehta', 'tchurch2', 'novitalmotive', 'ani3989', 'vliang88', 'tkim31', 'hcho12', 'kim857', 'madikaz', 'jiyichenqi', 'collapse', 'supercowking', 'wicky', 'luisccruz', 'dradefx', 'pessin', 'mahoney6', 'asteriskzero', 'dbero2', 'jfelts', 'wmjdgla', 'bmrice', 'sparklingway', 'ryanskim', 'lgarava2', 'efilli2', 'uribe2', 'tonywinoto', 'black_chip21', 'kejriwa1', 'chrisjryu', 'gbergsc2', 'xili1', 'ragunat1', 'lee489', 'likpok', 'chengxu1', 'ng21', 'luyun198993', 'alikation', 'caldero1', 'megarza2', 'huanggeng0726', 'dusty493', 'paraclas', 'balistic2', 'diablopbc', 'kim417', 'd98521', 'bongen2', 'willtk0113', 'leiyang1', 'nanohub99', 'seanlee14', 'jack_ftw', 'se210', 'weller1', 'dawei1', 'jglauber', 'dlgudwns11', 'tao7', 'aamin9', 'schrock3', 'lindqui1', 'cjohns78', 'qwerasdf', 'ma3xiao1', 'wisechengyi', 'chijiazuo', 'aggarwa3', 'rlew2', 'dbarnes2', 'joo4ny', 'snowpd', 'aditchhabra', 'weichunan', 'wldavis']",3,"['cjhughes17', None, 'mcarney2']",112,"['chrismy', 'ttli2', 'jchyan2', 'pitrak1', 'mcarney2', 'hipaulshi', 'malhotr3', 'wu10', 'jeredgre', 'fliu96', 'crazedcatatonic5', 'ligao1', 'midnightblade', 'ddeutsc2', 'hur6', 'marshal2', 'bracon', 'asrinat2', 'kang92', 'hbeberma', 'nanocarbon', 'arappep2', 'maemble', 'abstrkt', 'fangwan2', 'bikrambhatia', 'xihan1', 'chen282', 'namanmehta', 'tchurch2', 'novitalmotive', 'ani3989', 'vliang88', 'tkim31', 'tarvitz', 'hcho12', 'hwnano', 'kim857', 'madikaz', 'jiyichenqi', 'collapse', 'supercowking', 'wicky', 'luisccruz', 'dradefx', 'pessin', 'mahoney6', 'asteriskzero', 'dbero2', 'jfelts', 'boegy3', 'wmjdgla', 'bmrice', 'sparklingway', 'ryanskim', 'lgarava2', 'efilli2', 'uribe2', 'tonywinoto', 'black_chip21', 'kejriwa1', 'chrisjryu', 'gbergsc2', 'xili1', 'ragunat1', 'lee489', 'likpok', 'chengxu1', 'ng21', 'luyun198993', 'alikation', 'caldero1', 'megarza2', 'huanggeng0726', 'dusty493', 'paraclas', 'balistic2', 'diablopbc', 'kim417', 'd98521', 'bongen2', 'willtk0113', 'leiyang1', 'nanohub99', 'seanlee14', 'jack_ftw', 'se210', 'weller1', 'dawei1', 'jglauber', 'dlgudwns11', 'tao7', 'aamin9', 'schrock3', 'lindqui1', 'cjohns78', 'qwerasdf', None, 'cjhughes17', 'ma3xiao1', 'wisechengyi', 'chijiazuo', 'aggarwa3', 'rlew2', 'dbarnes2', 'joo4ny', 'snowpd', 'aditchhabra', 'idesis1', 'tkim28', 'weichunan', 'wldavis']"
2,64,110,11,9,"['hbeberma', 'jglauber', 'ma3xiao1', 'jchyan2', 'hwnano', 'd98521', 'jiyichenqi', 'willtk0113', 'alikation']",100,"['chrismy', 'ttli2', 'pitrak1', 'hipaulshi', 'malhotr3', 'wu10', 'jeredgre', 'fliu96', 'crazedcatatonic5', 'ligao1', 'midnightblade', 'ddeutsc2', 'hur6', 'marshal2', 'bracon', 'asrinat2', 'kang92', 'nanocarbon', 'arappep2', 'maemble', 'abstrkt', 'fangwan2', 'bikrambhatia', 'xihan1', 'chen282', 'namanmehta', 'tchurch2', 'novitalmotive', 'ani3989', 'vliang88', 'tkim31', 'tarvitz', 'hcho12', 'kim857', 'madikaz', 'collapse', 'supercowking', 'wicky', 'luisccruz', 'dradefx', 'pessin', 'mahoney6', 'asteriskzero', 'dbero2', 'jfelts', 'boegy3', 'wmjdgla', 'bmrice', 'sparklingway', 'ryanskim', 'lgarava2', 'efilli2', 'uribe2', 'tonywinoto', 'black_chip21', 'kejriwa1', 'chrisjryu', 'gbergsc2', 'xili1', 'ragunat1', 'lee489', 'likpok', 'chengxu1', 'ng21', 'luyun198993', 'caldero1', 'megarza2', 'huanggeng0726', 'dusty493', 'paraclas', 'balistic2', 'diablopbc', 'kim417', 'bongen2', 'leiyang1', 'nanohub99', 'seanlee14', 'jack_ftw', 'se210', 'weller1', 'dawei1', 'dlgudwns11', 'tao7', 'aamin9', 'schrock3', 'lindqui1', 'cjohns78', 'qwerasdf', 'wisechengyi', 'chijiazuo', 'aggarwa3', 'rlew2', 'dbarnes2', 'joo4ny', 'snowpd', 'aditchhabra', 'idesis1', 'tkim28', 'weichunan', 'wldavis']",2,"[None, 'chongvi1']",111,"['chrismy', 'ttli2', 'jchyan2', 'pitrak1', 'chongvi1', 'hipaulshi', 'malhotr3', 'wu10', 'jeredgre', 'fliu96', 'crazedcatatonic5', 'ligao1', 'midnightblade', 'ddeutsc2', 'hur6', 'marshal2', 'bracon', 'asrinat2', 'kang92', 'hbeberma', 'nanocarbon', 'arappep2', 'maemble', 'abstrkt', 'fangwan2', 'bikrambhatia', 'xihan1', 'chen282', 'namanmehta', 'tchurch2', 'novitalmotive', 'ani3989', 'vliang88', 'tkim31', 'tarvitz', 'hcho12', 'hwnano', 'kim857', 'madikaz', 'jiyichenqi', 'collapse', 'supercowking', 'wicky', 'luisccruz', 'dradefx', 'pessin', 'mahoney6', 'asteriskzero', 'dbero2', 'jfelts', 'boegy3', 'wmjdgla', 'bmrice', 'sparklingway', 'ryanskim', 'lgarava2', 'efilli2', 'uribe2', 'tonywinoto', 'black_chip21', 'kejriwa1', 'chrisjryu', 'gbergsc2', 'xili1', 'ragunat1', 'lee489', 'likpok', 'chengxu1', 'ng21', 'luyun198993', 'alikation', 'caldero1', 'megarza2', 'huanggeng0726', 'dusty493', 'paraclas', 'balistic2', 'diablopbc', 'kim417', 'd98521', 'bongen2', 'willtk0113', 'leiyang1', 'nanohub99', 'seanlee14', 'jack_ftw', 'se210', 'weller1', 'dawei1', 'jglauber', 'dlgudwns11', 'tao7', 'aamin9', 'schrock3', 'lindqui1', 'cjohns78', 'qwerasdf', None, 'ma3xiao1', 'wisechengyi', 'chijiazuo', 'aggarwa3', 'rlew2', 'dbarnes2', 'joo4ny', 'snowpd', 'aditchhabra', 'idesis1', 'tkim28', 'weichunan', 'wldavis']"
2,38,110,10,8,"['ddeutsc2', 'hbeberma', 'jchyan2', 'arappep2', 'hwnano', 'd98521', 'cjohns78', 'tkim28']",101,"['chrismy', 'ttli2', 'pitrak1', 'hipaulshi', 'malhotr3', 'wu10', 'jeredgre', 'fliu96', 'crazedcatatonic5', 'ligao1', 'midnightblade', 'hur6', 'marshal2', 'bracon', 'asrinat2', 'kang92', 'nanocarbon', 'maemble', 'abstrkt', 'fangwan2', 'bikrambhatia', 'xihan1', 'chen282', 'namanmehta', 'tchurch2', 'novitalmotive', 'ani3989', 'vliang88', 'tkim31', 'tarvitz', 'hcho12', 'kim857', 'madikaz', 'jiyichenqi', 'collapse', 'supercowking', 'wicky', 'luisccruz', 'dradefx', 'pessin', 'mahoney6', 'asteriskzero', 'dbero2', 'jfelts', 'boegy3', 'wmjdgla', 'bmrice', 'sparklingway', 'ryanskim', 'lgarava2', 'efilli2', 'uribe2', 'tonywinoto', 'black_chip21', 'kejriwa1', 'chrisjryu', 'gbergsc2', 'xili1', 'ragunat1', 'lee489', 'likpok', 'chengxu1', 'ng21', 'luyun198993', 'alikation', 'caldero1', 'megarza2', 'huanggeng0726', 'dusty493', 'paraclas', 'balistic2', 'diablopbc', 'kim417', 'bongen2', 'willtk0113', 'leiyang1', 'nanohub99', 'seanlee14', 'jack_ftw', 'se210', 'weller1', 'dawei1', 'jglauber', 'dlgudwns11', 'tao7', 'aamin9', 'schrock3', 'lindqui1', 'qwerasdf', 'ma3xiao1', 'wisechengyi', 'chijiazuo', 'aggarwa3', 'rlew2', 'dbarnes2', 'joo4ny', 'snowpd', 'aditchhabra', 'idesis1', 'weichunan', 'wldavis']",2,"[None, 'pathak1']",111,"['chrismy', 'ttli2', 'jchyan2', 'pitrak1', 'hipaulshi', 'malhotr3', 'wu10', 'jeredgre', 'fliu96', 'crazedcatatonic5', 'ligao1', 'midnightblade', 'ddeutsc2', 'hur6', 'marshal2', 'bracon', 'asrinat2', 'kang92', 'hbeberma', 'nanocarbon', 'arappep2', 'maemble', 'abstrkt', 'fangwan2', 'bikrambhatia', 'xihan1', 'chen282', 'namanmehta', 'tchurch2', 'novitalmotive', 'ani3989', 'vliang88', 'tkim31', 'tarvitz', 'hcho12', 'hwnano', 'kim857', 'madikaz', 'pathak1', 'jiyichenqi', 'collapse', 'supercowking', 'wicky', 'luisccruz', 'dradefx', 'pessin', 'mahoney6', 'asteriskzero', 'dbero2', 'jfelts', 'boegy3', 'wmjdgla', 'bmrice', 'sparklingway', 'ryanskim', 'lgarava2', 'efilli2', 'uribe2', 'tonywinoto', 'black_chip21', 'kejriwa1', 'chrisjryu', 'gbergsc2', 'xili1', 'ragunat1', 'lee489', 'likpok', 'chengxu1', 'ng21', 'luyun198993', 'alikation', 'caldero1', 'megarza2', 'huanggeng0726', 'dusty493', 'paraclas', 'balistic2', 'diablopbc', 'kim417', 'd98521', 'bongen2', 'willtk0113', 'leiyang1', 'nanohub99', 'seanlee14', 'jack_ftw', 'se210', 'weller1', 'dawei1', 'jglauber', 'dlgudwns11', 'tao7', 'aamin9', 'schrock3', 'lindqui1', 'cjohns78', 'qwerasdf', None, 'ma3xiao1', 'wisechengyi', 'chijiazuo', 'aggarwa3', 'rlew2', 'dbarnes2', 'joo4ny', 'snowpd', 'aditchhabra', 'idesis1', 'tkim28', 'weichunan', 'wldavis']"
2,67,110,10,6,"['marshal2', 'bracon', 'maemble', 'malhotr3', 'jiyichenqi', 'jeredgre']",103,"['chrismy', 'ttli2', 'jchyan2', 'pitrak1', 'hipaulshi', 'wu10', 'fliu96', 'crazedcatatonic5', 'ligao1', 'midnightblade', 'ddeutsc2', 'hur6', 'asrinat2', 'kang92', 'hbeberma', 'nanocarbon', 'arappep2', 'abstrkt', 'fangwan2', 'bikrambhatia', 'xihan1', 'chen282', 'namanmehta', 'tchurch2', 'novitalmotive', 'ani3989', 'vliang88', 'tkim31', 'tarvitz', 'hcho12', 'hwnano', 'kim857', 'madikaz', 'collapse', 'supercowking', 'wicky', 'luisccruz', 'dradefx', 'pessin', 'mahoney6', 'asteriskzero', 'dbero2', 'jfelts', 'boegy3', 'wmjdgla', 'bmrice', 'sparklingway', 'ryanskim', 'lgarava2', 'efilli2', 'uribe2', 'tonywinoto', 'black_chip21', 'kejriwa1', 'chrisjryu', 'gbergsc2', 'xili1', 'ragunat1', 'lee489', 'likpok', 'chengxu1', 'ng21', 'luyun198993', 'alikation', 'caldero1', 'megarza2', 'huanggeng0726', 'dusty493', 'paraclas', 'balistic2', 'diablopbc', 'kim417', 'd98521', 'bongen2', 'willtk0113', 'leiyang1', 'nanohub99', 'seanlee14', 'jack_ftw', 'se210', 'weller1', 'dawei1', 'jglauber', 'dlgudwns11', 'tao7', 'aamin9', 'schrock3', 'lindqui1', 'cjohns78', 'qwerasdf', 'ma3xiao1', 'wisechengyi', 'chijiazuo', 'aggarwa3', 'rlew2', 'dbarnes2', 'joo4ny', 'snowpd', 'aditchhabra', 'idesis1', 'tkim28', 'weichunan', 'wldavis']",4,"['hochan5', None, 'mohamed', 'rishabagarwal1']",113,"['chrismy', 'ttli2', 'jchyan2', 'pitrak1', 'hipaulshi', 'malhotr3', 'wu10', 'jeredgre', 'fliu96', 'crazedcatatonic5', 'ligao1', 'midnightblade', 'ddeutsc2', 'hur6', 'marshal2', 'bracon', 'asrinat2', 'kang92', 'hbeberma', 'nanocarbon', 'arappep2', 'maemble', 'abstrkt', 'fangwan2', 'bikrambhatia', 'xihan1', 'chen282', 'namanmehta', 'tchurch2', 'novitalmotive', 'ani3989', 'hochan5', 'vliang88', 'tkim31', 'tarvitz', 'hcho12', 'hwnano', 'kim857', 'madikaz', 'jiyichenqi', 'collapse', 'supercowking', 'wicky', 'luisccruz', 'dradefx', 'pessin', 'mahoney6', 'asteriskzero', 'dbero2', 'jfelts', 'boegy3', 'wmjdgla', 'bmrice', 'sparklingway', 'ryanskim', 'lgarava2', 'efilli2', 'uribe2', 'tonywinoto', 'black_chip21', 'kejriwa1', 'chrisjryu', 'gbergsc2', 'xili1', 'ragunat1', 'lee489', 'likpok', 'chengxu1', 'ng21', 'luyun198993', 'alikation', 'caldero1', 'megarza2', 'huanggeng0726', 'dusty493', 'paraclas', 'balistic2', 'diablopbc', 'kim417', 'd98521', 'bongen2', 'willtk0113', 'leiyang1', 'nanohub99', 'seanlee14', 'jack_ftw', 'se210', 'weller1', 'dawei1', 'jglauber', 'dlgudwns11', 'tao7', 'rishabagarwal1', 'aamin9', 'schrock3', 'mohamed', 'lindqui1', 'cjohns78', 'qwerasdf', None, 'ma3xiao1', 'wisechengyi', 'chijiazuo', 'aggarwa3', 'rlew2', 'dbarnes2', 'joo4ny', 'snowpd', 'aditchhabra', 'idesis1', 'tkim28', 'weichunan', 'wldavis']"
2,80,110,10,6,"['balistic2', 'asrinat2', 'rlew2', 'willtk0113', 'nanohub99', 'novitalmotive']",103,"['chrismy', 'ttli2', 'jchyan2', 'pitrak1', 'hipaulshi', 'malhotr3', 'wu10', 'jeredgre', 'fliu96', 'crazedcatatonic5', 'ligao1', 'midnightblade', 'ddeutsc2', 'hur6', 'marshal2', 'bracon', 'kang92', 'hbeberma', 'nanocarbon', 'arappep2', 'maemble', 'abstrkt', 'fangwan2', 'bikrambhatia', 'xihan1', 'chen282', 'namanmehta', 'tchurch2', 'ani3989', 'vliang88', 'tkim31', 'tarvitz', 'hcho12', 'hwnano', 'kim857', 'madikaz', 'jiyichenqi', 'collapse', 'supercowking', 'wicky', 'luisccruz', 'dradefx', 'pessin', 'mahoney6', 'asteriskzero', 'dbero2', 'jfelts', 'boegy3', 'wmjdgla', 'bmrice', 'sparklingway', 'ryanskim', 'lgarava2', 'efilli2', 'uribe2', 'tonywinoto', 'black_chip21', 'kejriwa1', 'chrisjryu', 'gbergsc2', 'xili1', 'ragunat1', 'lee489', 'likpok', 'chengxu1', 'ng21', 'luyun198993', 'alikation', 'caldero1', 'megarza2', 'huanggeng0726', 'dusty493', 'paraclas', 'diablopbc', 'kim417', 'd98521', 'bongen2', 'leiyang1', 'seanlee14', 'jack_ftw', 'se210', 'weller1', 'dawei1', 'jglauber', 'dlgudwns11', 'tao7', 'aamin9', 'schrock3', 'lindqui1', 'cjohns78', 'qwerasdf', 'ma3xiao1', 'wisechengyi', 'chijiazuo', 'aggarwa3', 'dbarnes2', 'joo4ny', 'snowpd', 'aditchhabra', 'idesis1', 'tkim28', 'weichunan', 'wldavis']",4,"['joliu2', 'ryanmancl', 'mkhanna', None]",113,"['chrismy', 'ttli2', 'jchyan2', 'pitrak1', 'ryanmancl', 'hipaulshi', 'malhotr3', 'wu10', 'jeredgre', 'fliu96', 'crazedcatatonic5', 'ligao1', 'midnightblade', 'ddeutsc2', 'hur6', 'marshal2', 'bracon', 'asrinat2', 'kang92', 'hbeberma', 'nanocarbon', 'arappep2', 'maemble', 'abstrkt', 'fangwan2', 'bikrambhatia', 'xihan1', 'chen282', 'namanmehta', 'tchurch2', 'novitalmotive', 'ani3989', 'mkhanna', 'vliang88', 'tkim31', 'tarvitz', 'hcho12', 'hwnano', 'kim857', 'madikaz', 'jiyichenqi', 'collapse', 'supercowking', 'wicky', 'luisccruz', 'dradefx', 'pessin', 'mahoney6', 'asteriskzero', 'dbero2', 'jfelts', 'boegy3', 'wmjdgla', 'bmrice', 'sparklingway', 'ryanskim', 'lgarava2', 'efilli2', 'uribe2', 'tonywinoto', 'black_chip21', 'kejriwa1', 'chrisjryu', 'gbergsc2', 'xili1', 'ragunat1', 'lee489', 'likpok', 'chengxu1', 'ng21', 'luyun198993', 'alikation', 'caldero1', 'megarza2', 'huanggeng0726', 'dusty493', 'paraclas', 'balistic2', 'diablopbc', 'kim417', 'd98521', 'bongen2', 'willtk0113', 'leiyang1', 'nanohub99', 'seanlee14', 'jack_ftw', 'se210', 'weller1', 'dawei1', 'jglauber', 'dlgudwns11', 'tao7', 'joliu2', 'aamin9', 'schrock3', 'lindqui1', 'cjohns78', 'qwerasdf', None, 'ma3xiao1', 'wisechengyi', 'chijiazuo', 'aggarwa3', 'rlew2', 'dbarnes2', 'joo4ny', 'snowpd', 'aditchhabra', 'idesis1', 'tkim28', 'weichunan', 'wldavis']"
2,45,110,9,6,"['tkim31', 'kang92', 'arappep2', 'snowpd', 'joo4ny', 'cjohns78']",103,"['chrismy', 'ttli2', 'jchyan2', 'pitrak1', 'hipaulshi', 'malhotr3', 'wu10', 'jeredgre', 'fliu96', 'crazedcatatonic5', 'ligao1', 'midnightblade', 'ddeutsc2', 'hur6', 'marshal2', 'bracon', 'asrinat2', 'hbeberma', 'nanocarbon', 'maemble', 'abstrkt', 'fangwan2', 'bikrambhatia', 'xihan1', 'chen282', 'namanmehta', 'tchurch2', 'novitalmotive', 'ani3989', 'vliang88', 'tarvitz', 'hcho12', 'hwnano', 'kim857', 'madikaz', 'jiyichenqi', 'collapse', 'supercowking', 'wicky', 'luisccruz', 'dradefx', 'pessin', 'mahoney6', 'asteriskzero', 'dbero2', 'jfelts', 'boegy3', 'wmjdgla', 'bmrice', 'sparklingway', 'ryanskim', 'lgarava2', 'efilli2', 'uribe2', 'tonywinoto', 'black_chip21', 'kejriwa1', 'chrisjryu', 'gbergsc2', 'xili1', 'ragunat1', 'lee489', 'likpok', 'chengxu1', 'ng21', 'luyun198993', 'alikation', 'caldero1', 'megarza2', 'huanggeng0726', 'dusty493', 'paraclas', 'balistic2', 'diablopbc', 'kim417', 'd98521', 'bongen2', 'willtk0113', 'leiyang1', 'nanohub99', 'seanlee14', 'jack_ftw', 'se210', 'weller1', 'dawei1', 'jglauber', 'dlgudwns11', 'tao7', 'aamin9', 'schrock3', 'lindqui1', 'qwerasdf', 'ma3xiao1', 'wisechengyi', 'chijiazuo', 'aggarwa3', 'rlew2', 'dbarnes2', 'aditchhabra', 'idesis1', 'tkim28', 'weichunan', 'wldavis']",3,"[None, 'banker2', 'chongvi1']",112,"['chrismy', 'ttli2', 'jchyan2', 'pitrak1', 'chongvi1', 'hipaulshi', 'malhotr3', 'wu10', 'jeredgre', 'fliu96', 'crazedcatatonic5', 'ligao1', 'midnightblade', 'ddeutsc2', 'hur6', 'marshal2', 'bracon', 'asrinat2', 'kang92', 'hbeberma', 'nanocarbon', 'arappep2', 'maemble', 'abstrkt', 'fangwan2', 'bikrambhatia', 'xihan1', 'chen282', 'namanmehta', 'tchurch2', 'novitalmotive', 'ani3989', 'vliang88', 'tkim31', 'tarvitz', 'hcho12', 'hwnano', 'kim857', 'madikaz', 'jiyichenqi', 'collapse', 'supercowking', 'wicky', 'luisccruz', 'dradefx', 'pessin', 'mahoney6', 'asteriskzero', 'dbero2', 'jfelts', 'boegy3', 'wmjdgla', 'bmrice', 'sparklingway', 'ryanskim', 'lgarava2', 'efilli2', 'uribe2', 'tonywinoto', 'black_chip21', 'kejriwa1', 'chrisjryu', 'gbergsc2', 'xili1', 'ragunat1', 'lee489', 'likpok', 'chengxu1', 'ng21', 'luyun198993', 'alikation', 'caldero1', 'megarza2', 'huanggeng0726', 'dusty493', 'paraclas', 'balistic2', 'diablopbc', 'kim417', 'banker2', 'd98521', 'bongen2', 'willtk0113', 'leiyang1', 'nanohub99', 'seanlee14', 'jack_ftw', 'se210', 'weller1', 'dawei1', 'jglauber', 'dlgudwns11', 'tao7', 'aamin9', 'schrock3', 'lindqui1', 'cjohns78', 'qwerasdf', None, 'ma3xiao1', 'wisechengyi', 'chijiazuo', 'aggarwa3', 'rlew2', 'dbarnes2', 'joo4ny', 'snowpd', 'aditchhabra', 'idesis1', 'tkim28', 'weichunan', 'wldavis']"
2,183,110,9,5,"['wu10', 'bongen2', 'alikation', 'weichunan', 'tchurch2']",104,"['chrismy', 'ttli2', 'jchyan2', 'pitrak1', 'hipaulshi', 'malhotr3', 'jeredgre', 'fliu96', 'crazedcatatonic5', 'ligao1', 'midnightblade', 'ddeutsc2', 'hur6', 'marshal2', 'bracon', 'asrinat2', 'kang92', 'hbeberma', 'nanocarbon', 'arappep2', 'maemble', 'abstrkt', 'fangwan2', 'bikrambhatia', 'xihan1', 'chen282', 'namanmehta', 'novitalmotive', 'ani3989', 'vliang88', 'tkim31', 'tarvitz', 'hcho12', 'hwnano', 'kim857', 'madikaz', 'jiyichenqi', 'collapse', 'supercowking', 'wicky', 'luisccruz', 'dradefx', 'pessin', 'mahoney6', 'asteriskzero', 'dbero2', 'jfelts', 'boegy3', 'wmjdgla', 'bmrice', 'sparklingway', 'ryanskim', 'lgarava2', 'efilli2', 'uribe2', 'tonywinoto', 'black_chip21', 'kejriwa1', 'chrisjryu', 'gbergsc2', 'xili1', 'ragunat1', 'lee489', 'likpok', 'chengxu1', 'ng21', 'luyun198993', 'caldero1', 'megarza2', 'huanggeng0726', 'dusty493', 'paraclas', 'balistic2', 'diablopbc', 'kim417', 'd98521', 'willtk0113', 'leiyang1', 'nanohub99', 'seanlee14', 'jack_ftw', 'se210', 'weller1', 'dawei1', 'jglauber', 'dlgudwns11', 'tao7', 'aamin9', 'schrock3', 'lindqui1', 'cjohns78', 'qwerasdf', 'ma3xiao1', 'wisechengyi', 'chijiazuo', 'aggarwa3', 'rlew2', 'dbarnes2', 'joo4ny', 'snowpd', 'aditchhabra', 'idesis1', 'tkim28', 'wldavis']",4,"['this1', None, 'shin44', 'lenovo1709']",113,"['chrismy', 'ttli2', 'jchyan2', 'pitrak1', 'hipaulshi', 'malhotr3', 'wu10', 'jeredgre', 'fliu96', 'crazedcatatonic5', 'ligao1', 'midnightblade', 'ddeutsc2', 'hur6', 'marshal2', 'bracon', 'asrinat2', 'kang92', 'hbeberma', 'nanocarbon', 'arappep2', 'maemble', 'abstrkt', 'fangwan2', 'bikrambhatia', 'xihan1', 'chen282', 'namanmehta', 'tchurch2', 'novitalmotive', 'ani3989', 'vliang88', 'tkim31', 'tarvitz', 'hcho12', 'hwnano', 'kim857', 'madikaz', 'jiyichenqi', 'collapse', 'supercowking', 'wicky', 'luisccruz', 'dradefx', 'pessin', 'mahoney6', 'asteriskzero', 'dbero2', 'jfelts', 'boegy3', 'wmjdgla', 'bmrice', 'sparklingway', 'ryanskim', 'lgarava2', 'efilli2', 'uribe2', 'tonywinoto', 'black_chip21', 'kejriwa1', 'chrisjryu', 'gbergsc2', 'xili1', 'ragunat1', 'lee489', 'this1', 'likpok', 'lenovo1709', 'chengxu1', 'ng21', 'luyun198993', 'alikation', 'caldero1', 'megarza2', 'huanggeng0726', 'dusty493', 'paraclas', 'balistic2', 'diablopbc', 'kim417', 'd98521', 'bongen2', 'willtk0113', 'leiyang1', 'nanohub99', 'seanlee14', 'jack_ftw', 'se210', 'weller1', 'dawei1', 'jglauber', 'dlgudwns11', 'tao7', 'aamin9', 'schrock3', 'lindqui1', 'cjohns78', 'qwerasdf', None, 'ma3xiao1', 'wisechengyi', 'chijiazuo', 'aggarwa3', 'rlew2', 'dbarnes2', 'joo4ny', 'snowpd', 'aditchhabra', 'shin44', 'idesis1', 'tkim28', 'weichunan', 'wldavis']"
2,40,110,8,6,"['arappep2', 'efilli2', 'madikaz', 'caldero1', 'cjohns78', 'gbergsc2']",103,"['chrismy', 'ttli2', 'jchyan2', 'pitrak1', 'hipaulshi', 'malhotr3', 'wu10', 'jeredgre', 'fliu96', 'crazedcatatonic5', 'ligao1', 'midnightblade', 'ddeutsc2', 'hur6', 'marshal2', 'bracon', 'asrinat2', 'kang92', 'hbeberma', 'nanocarbon', 'maemble', 'abstrkt', 'fangwan2', 'bikrambhatia', 'xihan1', 'chen282', 'namanmehta', 'tchurch2', 'novitalmotive', 'ani3989', 'vliang88', 'tkim31', 'tarvitz', 'hcho12', 'hwnano', 'kim857', 'jiyichenqi', 'collapse', 'supercowking', 'wicky', 'luisccruz', 'dradefx', 'pessin', 'mahoney6', 'asteriskzero', 'dbero2', 'jfelts', 'boegy3', 'wmjdgla', 'bmrice', 'sparklingway', 'ryanskim', 'lgarava2', 'uribe2', 'tonywinoto', 'black_chip21', 'kejriwa1', 'chrisjryu', 'xili1', 'ragunat1', 'lee489', 'likpok', 'chengxu1', 'ng21', 'luyun198993', 'alikation', 'megarza2', 'huanggeng0726', 'dusty493', 'paraclas', 'balistic2', 'diablopbc', 'kim417', 'd98521', 'bongen2', 'willtk0113', 'leiyang1', 'nanohub99', 'seanlee14', 'jack_ftw', 'se210', 'weller1', 'dawei1', 'jglauber', 'dlgudwns11', 'tao7', 'aamin9', 'schrock3', 'lindqui1', 'qwerasdf', 'ma3xiao1', 'wisechengyi', 'chijiazuo', 'aggarwa3', 'rlew2', 'dbarnes2', 'joo4ny', 'snowpd', 'aditchhabra', 'idesis1', 'tkim28', 'weichunan', 'wldavis']",2,"['nivero', None]",111,"['chrismy', 'ttli2', 'jchyan2', 'pitrak1', 'hipaulshi', 'malhotr3', 'wu10', 'jeredgre', 'fliu96', 'crazedcatatonic5', 'ligao1', 'midnightblade', 'ddeutsc2', 'hur6', 'marshal2', 'bracon', 'asrinat2', 'kang92', 'hbeberma', 'nanocarbon', 'arappep2', 'maemble', 'abstrkt', 'fangwan2', 'bikrambhatia', 'xihan1', 'chen282', 'namanmehta', 'tchurch2', 'novitalmotive', 'ani3989', 'vliang88', 'tkim31', 'tarvitz', 'hcho12', 'hwnano', 'kim857', 'madikaz', 'jiyichenqi', 'collapse', 'supercowking', 'wicky', 'luisccruz', 'dradefx', 'pessin', 'mahoney6', 'asteriskzero', 'dbero2', 'jfelts', 'boegy3', 'wmjdgla', 'bmrice', 'sparklingway', 'ryanskim', 'lgarava2', 'efilli2', 'uribe2', 'tonywinoto', 'black_chip21', 'kejriwa1', 'chrisjryu', 'gbergsc2', 'xili1', 'ragunat1', 'lee489', 'likpok', 'chengxu1', 'ng21', 'luyun198993', 'alikation', 'caldero1', 'megarza2', 'huanggeng0726', 'dusty493', 'paraclas', 'balistic2', 'diablopbc', 'kim417', 'd98521', 'bongen2', 'willtk0113', 'leiyang1', 'nanohub99', 'seanlee14', 'jack_ftw', 'se210', 'weller1', 'dawei1', 'jglauber', 'dlgudwns11', 'tao7', 'aamin9', 'schrock3', 'lindqui1', 'cjohns78', 'qwerasdf', None, 'ma3xiao1', 'wisechengyi', 'chijiazuo', 'aggarwa3', 'rlew2', 'dbarnes2', 'joo4ny', 'snowpd', 'aditchhabra', 'idesis1', 'tkim28', 'weichunan', 'nivero', 'wldavis']"
2,104,110,8,7,"['nanocarbon', 'madikaz', 'idesis1', 'cjohns78', 'namanmehta', 'gbergsc2', 'wldavis']",102,"['chrismy', 'ttli2', 'jchyan2', 'pitrak1', 'hipaulshi', 'malhotr3', 'wu10', 'jeredgre', 'fliu96', 'crazedcatatonic5', 'ligao1', 'midnightblade', 'ddeutsc2', 'hur6', 'marshal2', 'bracon', 'asrinat2', 'kang92', 'hbeberma', 'arappep2', 'maemble', 'abstrkt', 'fangwan2', 'bikrambhatia', 'xihan1', 'chen282', 'tchurch2', 'novitalmotive', 'ani3989', 'vliang88', 'tkim31', 'tarvitz', 'hcho12', 'hwnano', 'kim857', 'jiyichenqi', 'collapse', 'supercowking', 'wicky', 'luisccruz', 'dradefx', 'pessin', 'mahoney6', 'asteriskzero', 'dbero2', 'jfelts', 'boegy3', 'wmjdgla', 'bmrice', 'sparklingway', 'ryanskim', 'lgarava2', 'efilli2', 'uribe2', 'tonywinoto', 'black_chip21', 'kejriwa1', 'chrisjryu', 'xili1', 'ragunat1', 'lee489', 'likpok', 'chengxu1', 'ng21', 'luyun198993', 'alikation', 'caldero1', 'megarza2', 'huanggeng0726', 'dusty493', 'paraclas', 'balistic2', 'diablopbc', 'kim417', 'd98521', 'bongen2', 'willtk0113', 'leiyang1', 'nanohub99', 'seanlee14', 'jack_ftw', 'se210', 'weller1', 'dawei1', 'jglauber', 'dlgudwns11', 'tao7', 'aamin9', 'schrock3', 'lindqui1', 'qwerasdf', 'ma3xiao1', 'wisechengyi', 'chijiazuo', 'aggarwa3', 'rlew2', 'dbarnes2', 'joo4ny', 'snowpd', 'aditchhabra', 'tkim28', 'weichunan']",1,[None],110,"['chrismy', 'ttli2', 'jchyan2', 'pitrak1', 'hipaulshi', 'malhotr3', 'wu10', 'jeredgre', 'fliu96', 'crazedcatatonic5', 'ligao1', 'midnightblade', 'ddeutsc2', 'hur6', 'marshal2', 'bracon', 'asrinat2', 'kang92', 'hbeberma', 'nanocarbon', 'arappep2', 'maemble', 'abstrkt', 'fangwan2', 'bikrambhatia', 'xihan1', 'chen282', 'namanmehta', 'tchurch2', 'novitalmotive', 'ani3989', 'vliang88', 'tkim31', 'tarvitz', 'hcho12', 'hwnano', 'kim857', 'madikaz', 'jiyichenqi', 'collapse', 'supercowking', 'wicky', 'luisccruz', 'dradefx', 'pessin', 'mahoney6', 'asteriskzero', 'dbero2', 'jfelts', 'boegy3', 'wmjdgla', 'bmrice', 'sparklingway', 'ryanskim', 'lgarava2', 'efilli2', 'uribe2', 'tonywinoto', 'black_chip21', 'kejriwa1', 'chrisjryu', 'gbergsc2', 'xili1', 'ragunat1', 'lee489', 'likpok', 'chengxu1', 'ng21', 'luyun198993', 'alikation', 'caldero1', 'megarza2', 'huanggeng0726', 'dusty493', 'paraclas', 'balistic2', 'diablopbc', 'kim417', 'd98521', 'bongen2', 'willtk0113', 'leiyang1', 'nanohub99', 'seanlee14', 'jack_ftw', 'se210', 'weller1', 'dawei1', 'jglauber', 'dlgudwns11', 'tao7', 'aamin9', 'schrock3', 'lindqui1', 'cjohns78', 'qwerasdf', None, 'ma3xiao1', 'wisechengyi', 'chijiazuo', 'aggarwa3', 'rlew2', 'dbarnes2', 'joo4ny', 'snowpd', 'aditchhabra', 'idesis1', 'tkim28', 'weichunan', 'wldavis']"
2,63,110,7,6,"['pitrak1', 'efilli2', 'madikaz', 'caldero1', 'cjohns78', 'gbergsc2']",103,"['chrismy', 'ttli2', 'jchyan2', 'hipaulshi', 'malhotr3', 'wu10', 'jeredgre', 'fliu96', 'crazedcatatonic5', 'ligao1', 'midnightblade', 'ddeutsc2', 'hur6', 'marshal2', 'bracon', 'asrinat2', 'kang92', 'hbeberma', 'nanocarbon', 'arappep2', 'maemble', 'abstrkt', 'fangwan2', 'bikrambhatia', 'xihan1', 'chen282', 'namanmehta', 'tchurch2', 'novitalmotive', 'ani3989', 'vliang88', 'tkim31', 'tarvitz', 'hcho12', 'hwnano', 'kim857', 'jiyichenqi', 'collapse', 'supercowking', 'wicky', 'luisccruz', 'dradefx', 'pessin', 'mahoney6', 'asteriskzero', 'dbero2', 'jfelts', 'boegy3', 'wmjdgla', 'bmrice', 'sparklingway', 'ryanskim', 'lgarava2', 'uribe2', 'tonywinoto', 'black_chip21', 'kejriwa1', 'chrisjryu', 'xili1', 'ragunat1', 'lee489', 'likpok', 'chengxu1', 'ng21', 'luyun198993', 'alikation', 'megarza2', 'huanggeng0726', 'dusty493', 'paraclas', 'balistic2', 'diablopbc', 'kim417', 'd98521', 'bongen2', 'willtk0113', 'leiyang1', 'nanohub99', 'seanlee14', 'jack_ftw', 'se210', 'weller1', 'dawei1', 'jglauber', 'dlgudwns11', 'tao7', 'aamin9', 'schrock3', 'lindqui1', 'qwerasdf', 'ma3xiao1', 'wisechengyi', 'chijiazuo', 'aggarwa3', 'rlew2', 'dbarnes2', 'joo4ny', 'snowpd', 'aditchhabra', 'idesis1', 'tkim28', 'weichunan', 'wldavis']",1,[None],110,"['chrismy', 'ttli2', 'jchyan2', 'pitrak1', 'hipaulshi', 'malhotr3', 'wu10', 'jeredgre', 'fliu96', 'crazedcatatonic5', 'ligao1', 'midnightblade', 'ddeutsc2', 'hur6', 'marshal2', 'bracon', 'asrinat2', 'kang92', 'hbeberma', 'nanocarbon', 'arappep2', 'maemble', 'abstrkt', 'fangwan2', 'bikrambhatia', 'xihan1', 'chen282', 'namanmehta', 'tchurch2', 'novitalmotive', 'ani3989', 'vliang88', 'tkim31', 'tarvitz', 'hcho12', 'hwnano', 'kim857', 'madikaz', 'jiyichenqi', 'collapse', 'supercowking', 'wicky', 'luisccruz', 'dradefx', 'pessin', 'mahoney6', 'asteriskzero', 'dbero2', 'jfelts', 'boegy3', 'wmjdgla', 'bmrice', 'sparklingway', 'ryanskim', 'lgarava2', 'efilli2', 'uribe2', 'tonywinoto', 'black_chip21', 'kejriwa1', 'chrisjryu', 'gbergsc2', 'xili1', 'ragunat1', 'lee489', 'likpok', 'chengxu1', 'ng21', 'luyun198993', 'alikation', 'caldero1', 'megarza2', 'huanggeng0726', 'dusty493', 'paraclas', 'balistic2', 'diablopbc', 'kim417', 'd98521', 'bongen2', 'willtk0113', 'leiyang1', 'nanohub99', 'seanlee14', 'jack_ftw', 'se210', 'weller1', 'dawei1', 'jglauber', 'dlgudwns11', 'tao7', 'aamin9', 'schrock3', 'lindqui1', 'cjohns78', 'qwerasdf', None, 'ma3xiao1', 'wisechengyi', 'chijiazuo', 'aggarwa3', 'rlew2', 'dbarnes2', 'joo4ny', 'snowpd', 'aditchhabra', 'idesis1', 'tkim28', 'weichunan', 'wldavis']"
2,66,110,7,6,"['balistic2', 'boegy3', 'rlew2', 'nanohub99', 'qwerasdf', 'novitalmotive']",103,"['chrismy', 'ttli2', 'jchyan2', 'pitrak1', 'hipaulshi', 'malhotr3', 'wu10', 'jeredgre', 'fliu96', 'crazedcatatonic5', 'ligao1', 'midnightblade', 'ddeutsc2', 'hur6', 'marshal2', 'bracon', 'asrinat2', 'kang92', 'hbeberma', 'nanocarbon', 'arappep2', 'maemble', 'abstrkt', 'fangwan2', 'bikrambhatia', 'xihan1', 'chen282', 'namanmehta', 'tchurch2', 'ani3989', 'vliang88', 'tkim31', 'tarvitz', 'hcho12', 'hwnano', 'kim857', 'madikaz', 'jiyichenqi', 'collapse', 'supercowking', 'wicky', 'luisccruz', 'dradefx', 'pessin', 'mahoney6', 'asteriskzero', 'dbero2', 'jfelts', 'wmjdgla', 'bmrice', 'sparklingway', 'ryanskim', 'lgarava2', 'efilli2', 'uribe2', 'tonywinoto', 'black_chip21', 'kejriwa1', 'chrisjryu', 'gbergsc2', 'xili1', 'ragunat1', 'lee489', 'likpok', 'chengxu1', 'ng21', 'luyun198993', 'alikation', 'caldero1', 'megarza2', 'huanggeng0726', 'dusty493', 'paraclas', 'diablopbc', 'kim417', 'd98521', 'bongen2', 'willtk0113', 'leiyang1', 'seanlee14', 'jack_ftw', 'se210', 'weller1', 'dawei1', 'jglauber', 'dlgudwns11', 'tao7', 'aamin9', 'schrock3', 'lindqui1', 'cjohns78', 'ma3xiao1', 'wisechengyi', 'chijiazuo', 'aggarwa3', 'dbarnes2', 'joo4ny', 'snowpd', 'aditchhabra', 'idesis1', 'tkim28', 'weichunan', 'wldavis']",1,[None],110,"['chrismy', 'ttli2', 'jchyan2', 'pitrak1', 'hipaulshi', 'malhotr3', 'wu10', 'jeredgre', 'fliu96', 'crazedcatatonic5', 'ligao1', 'midnightblade', 'ddeutsc2', 'hur6', 'marshal2', 'bracon', 'asrinat2', 'kang92', 'hbeberma', 'nanocarbon', 'arappep2', 'maemble', 'abstrkt', 'fangwan2', 'bikrambhatia', 'xihan1', 'chen282', 'namanmehta', 'tchurch2', 'novitalmotive', 'ani3989', 'vliang88', 'tkim31', 'tarvitz', 'hcho12', 'hwnano', 'kim857', 'madikaz', 'jiyichenqi', 'collapse', 'supercowking', 'wicky', 'luisccruz', 'dradefx', 'pessin', 'mahoney6', 'asteriskzero', 'dbero2', 'jfelts', 'boegy3', 'wmjdgla', 'bmrice', 'sparklingway', 'ryanskim', 'lgarava2', 'efilli2', 'uribe2', 'tonywinoto', 'black_chip21', 'kejriwa1', 'chrisjryu', 'gbergsc2', 'xili1', 'ragunat1', 'lee489', 'likpok', 'chengxu1', 'ng21', 'luyun198993', 'alikation', 'caldero1', 'megarza2', 'huanggeng0726', 'dusty493', 'paraclas', 'balistic2', 'diablopbc', 'kim417', 'd98521', 'bongen2', 'willtk0113', 'leiyang1', 'nanohub99', 'seanlee14', 'jack_ftw', 'se210', 'weller1', 'dawei1', 'jglauber', 'dlgudwns11', 'tao7', 'aamin9', 'schrock3', 'lindqui1', 'cjohns78', 'qwerasdf', None, 'ma3xiao1', 'wisechengyi', 'chijiazuo', 'aggarwa3', 'rlew2', 'dbarnes2', 'joo4ny', 'snowpd', 'aditchhabra', 'idesis1', 'tkim28', 'weichunan', 'wldavis']"
2,68,110,7,1,['wmjdgla'],108,"['chrismy', 'ttli2', 'jchyan2', 'pitrak1', 'hipaulshi', 'malhotr3', 'wu10', 'jeredgre', 'fliu96', 'crazedcatatonic5', 'ligao1', 'midnightblade', 'ddeutsc2', 'hur6', 'marshal2', 'bracon', 'asrinat2', 'kang92', 'hbeberma', 'nanocarbon', 'arappep2', 'maemble', 'abstrkt', 'fangwan2', 'bikrambhatia', 'xihan1', 'chen282', 'namanmehta', 'tchurch2', 'novitalmotive', 'ani3989', 'vliang88', 'tkim31', 'tarvitz', 'hcho12', 'hwnano', 'kim857', 'madikaz', 'jiyichenqi', 'collapse', 'supercowking', 'wicky', 'luisccruz', 'dradefx', 'pessin', 'mahoney6', 'asteriskzero', 'dbero2', 'jfelts', 'boegy3', 'bmrice', 'sparklingway', 'ryanskim', 'lgarava2', 'efilli2', 'uribe2', 'tonywinoto', 'black_chip21', 'kejriwa1', 'chrisjryu', 'gbergsc2', 'xili1', 'ragunat1', 'lee489', 'likpok', 'chengxu1', 'ng21', 'luyun198993', 'alikation', 'caldero1', 'megarza2', 'huanggeng0726', 'dusty493', 'paraclas', 'balistic2', 'diablopbc', 'kim417', 'd98521', 'bongen2', 'willtk0113', 'leiyang1', 'nanohub99', 'seanlee14', 'jack_ftw', 'se210', 'weller1', 'dawei1', 'jglauber', 'dlgudwns11', 'tao7', 'aamin9', 'schrock3', 'lindqui1', 'cjohns78', 'qwerasdf', 'ma3xiao1', 'wisechengyi', 'chijiazuo', 'aggarwa3', 'rlew2', 'dbarnes2', 'joo4ny', 'snowpd', 'aditchhabra', 'idesis1', 'tkim28', 'weichunan', 'wldavis']",6,"['mmkfc', 'hochan5', 'meliu2', 'mohamed', 'roylee3', None]",115,"['chrismy', 'mmkfc', 'meliu2', 'ttli2', 'jchyan2', 'pitrak1', 'hipaulshi', 'malhotr3', 'wu10', 'jeredgre', 'fliu96', 'crazedcatatonic5', 'ligao1', 'midnightblade', 'ddeutsc2', 'hur6', 'marshal2', 'bracon', 'asrinat2', 'kang92', 'hbeberma', 'nanocarbon', 'arappep2', 'maemble', 'abstrkt', 'fangwan2', 'bikrambhatia', 'xihan1', 'chen282', 'namanmehta', 'tchurch2', 'novitalmotive', 'ani3989', 'hochan5', 'vliang88', 'tkim31', 'tarvitz', 'hcho12', 'hwnano', 'kim857', 'madikaz', 'jiyichenqi', 'collapse', 'roylee3', 'supercowking', 'wicky', 'luisccruz', 'dradefx', 'pessin', 'mahoney6', 'asteriskzero', 'dbero2', 'jfelts', 'boegy3', 'wmjdgla', 'bmrice', 'sparklingway', 'ryanskim', 'lgarava2', 'efilli2', 'uribe2', 'tonywinoto', 'black_chip21', 'kejriwa1', 'chrisjryu', 'gbergsc2', 'xili1', 'ragunat1', 'lee489', 'likpok', 'chengxu1', 'ng21', 'luyun198993', 'alikation', 'caldero1', 'megarza2', 'huanggeng0726', 'dusty493', 'paraclas', 'balistic2', 'diablopbc', 'kim417', 'd98521', 'bongen2', 'willtk0113', 'leiyang1', 'nanohub99', 'seanlee14', 'jack_ftw', 'se210', 'weller1', 'dawei1', 'jglauber', 'dlgudwns11', 'tao7', 'aamin9', 'schrock3', 'mohamed', 'lindqui1', 'cjohns78', 'qwerasdf', None, 'ma3xiao1', 'wisechengyi', 'chijiazuo', 'aggarwa3', 'rlew2', 'dbarnes2', 'joo4ny', 'snowpd', 'aditchhabra', 'idesis1', 'tkim28', 'weichunan', 'wldavis']"
2,69,110,6,4,"['dusty493', 'weichunan', 'wmjdgla', 'se210']",105,"['chrismy', 'ttli2', 'jchyan2', 'pitrak1', 'hipaulshi', 'malhotr3', 'wu10', 'jeredgre', 'fliu96', 'crazedcatatonic5', 'ligao1', 'midnightblade', 'ddeutsc2', 'hur6', 'marshal2', 'bracon', 'asrinat2', 'kang92', 'hbeberma', 'nanocarbon', 'arappep2', 'maemble', 'abstrkt', 'fangwan2', 'bikrambhatia', 'xihan1', 'chen282', 'namanmehta', 'tchurch2', 'novitalmotive', 'ani3989', 'vliang88', 'tkim31', 'tarvitz', 'hcho12', 'hwnano', 'kim857', 'madikaz', 'jiyichenqi', 'collapse', 'supercowking', 'wicky', 'luisccruz', 'dradefx', 'pessin', 'mahoney6', 'asteriskzero', 'dbero2', 'jfelts', 'boegy3', 'bmrice', 'sparklingway', 'ryanskim', 'lgarava2', 'efilli2', 'uribe2', 'tonywinoto', 'black_chip21', 'kejriwa1', 'chrisjryu', 'gbergsc2', 'xili1', 'ragunat1', 'lee489', 'likpok', 'chengxu1', 'ng21', 'luyun198993', 'alikation', 'caldero1', 'megarza2', 'huanggeng0726', 'paraclas', 'balistic2', 'diablopbc', 'kim417', 'd98521', 'bongen2', 'willtk0113', 'leiyang1', 'nanohub99', 'seanlee14', 'jack_ftw', 'weller1', 'dawei1', 'jglauber', 'dlgudwns11', 'tao7', 'aamin9', 'schrock3', 'lindqui1', 'cjohns78', 'qwerasdf', 'ma3xiao1', 'wisechengyi', 'chijiazuo', 'aggarwa3', 'rlew2', 'dbarnes2', 'joo4ny', 'snowpd', 'aditchhabra', 'idesis1', 'tkim28', 'wldavis']",2,"[None, 'lenovo1709']",111,"['chrismy', 'ttli2', 'jchyan2', 'pitrak1', 'hipaulshi', 'malhotr3', 'wu10', 'jeredgre', 'fliu96', 'crazedcatatonic5', 'ligao1', 'midnightblade', 'ddeutsc2', 'hur6', 'marshal2', 'bracon', 'asrinat2', 'kang92', 'hbeberma', 'nanocarbon', 'arappep2', 'maemble', 'abstrkt', 'fangwan2', 'bikrambhatia', 'xihan1', 'chen282', 'namanmehta', 'tchurch2', 'novitalmotive', 'ani3989', 'vliang88', 'tkim31', 'tarvitz', 'hcho12', 'hwnano', 'kim857', 'madikaz', 'jiyichenqi', 'collapse', 'supercowking', 'wicky', 'luisccruz', 'dradefx', 'pessin', 'mahoney6', 'asteriskzero', 'dbero2', 'jfelts', 'boegy3', 'wmjdgla', 'bmrice', 'sparklingway', 'ryanskim', 'lgarava2', 'efilli2', 'uribe2', 'tonywinoto', 'black_chip21', 'kejriwa1', 'chrisjryu', 'gbergsc2', 'xili1', 'ragunat1', 'lee489', 'likpok', 'lenovo1709', 'chengxu1', 'ng21', 'luyun198993', 'alikation', 'caldero1', 'megarza2', 'huanggeng0726', 'dusty493', 'paraclas', 'balistic2', 'diablopbc', 'kim417', 'd98521', 'bongen2', 'willtk0113', 'leiyang1', 'nanohub99', 'seanlee14', 'jack_ftw', 'se210', 'weller1', 'dawei1', 'jglauber', 'dlgudwns11', 'tao7', 'aamin9', 'schrock3', 'lindqui1', 'cjohns78', 'qwerasdf', None, 'ma3xiao1', 'wisechengyi', 'chijiazuo', 'aggarwa3', 'rlew2', 'dbarnes2', 'joo4ny', 'snowpd', 'aditchhabra', 'idesis1', 'tkim28', 'weichunan', 'wldavis']"
2,70,110,6,3,"['schrock3', 'tkim31', 'hipaulshi']",106,"['chrismy', 'ttli2', 'jchyan2', 'pitrak1', 'malhotr3', 'wu10', 'jeredgre', 'fliu96', 'crazedcatatonic5', 'ligao1', 'midnightblade', 'ddeutsc2', 'hur6', 'marshal2', 'bracon', 'asrinat2', 'kang92', 'hbeberma', 'nanocarbon', 'arappep2', 'maemble', 'abstrkt', 'fangwan2', 'bikrambhatia', 'xihan1', 'chen282', 'namanmehta', 'tchurch2', 'novitalmotive', 'ani3989', 'vliang88', 'tarvitz', 'hcho12', 'hwnano', 'kim857', 'madikaz', 'jiyichenqi', 'collapse', 'supercowking', 'wicky', 'luisccruz', 'dradefx', 'pessin', 'mahoney6', 'asteriskzero', 'dbero2', 'jfelts', 'boegy3', 'wmjdgla', 'bmrice', 'sparklingway', 'ryanskim', 'lgarava2', 'efilli2', 'uribe2', 'tonywinoto', 'black_chip21', 'kejriwa1', 'chrisjryu', 'gbergsc2', 'xili1', 'ragunat1', 'lee489', 'likpok', 'chengxu1', 'ng21', 'luyun198993', 'alikation', 'caldero1', 'megarza2', 'huanggeng0726', 'dusty493', 'paraclas', 'balistic2', 'diablopbc', 'kim417', 'd98521', 'bongen2', 'willtk0113', 'leiyang1', 'nanohub99', 'seanlee14', 'jack_ftw', 'se210', 'weller1', 'dawei1', 'jglauber', 'dlgudwns11', 'tao7', 'aamin9', 'lindqui1', 'cjohns78', 'qwerasdf', 'ma3xiao1', 'wisechengyi', 'chijiazuo', 'aggarwa3', 'rlew2', 'dbarnes2', 'joo4ny', 'snowpd', 'aditchhabra', 'idesis1', 'tkim28', 'weichunan', 'wldavis']",3,"[None, 'chongvi1', 'rishabagarwal1']",112,"['chrismy', 'ttli2', 'jchyan2', 'pitrak1', 'chongvi1', 'hipaulshi', 'malhotr3', 'wu10', 'jeredgre', 'fliu96', 'crazedcatatonic5', 'ligao1', 'midnightblade', 'ddeutsc2', 'hur6', 'marshal2', 'bracon', 'asrinat2', 'kang92', 'hbeberma', 'nanocarbon', 'arappep2', 'maemble', 'abstrkt', 'fangwan2', 'bikrambhatia', 'xihan1', 'chen282', 'namanmehta', 'tchurch2', 'novitalmotive', 'ani3989', 'vliang88', 'tkim31', 'tarvitz', 'hcho12', 'hwnano', 'kim857', 'madikaz', 'jiyichenqi', 'collapse', 'supercowking', 'wicky', 'luisccruz', 'dradefx', 'pessin', 'mahoney6', 'asteriskzero', 'dbero2', 'jfelts', 'boegy3', 'wmjdgla', 'bmrice', 'sparklingway', 'ryanskim', 'lgarava2', 'efilli2', 'uribe2', 'tonywinoto', 'black_chip21', 'kejriwa1', 'chrisjryu', 'gbergsc2', 'xili1', 'ragunat1', 'lee489', 'likpok', 'chengxu1', 'ng21', 'luyun198993', 'alikation', 'caldero1', 'megarza2', 'huanggeng0726', 'dusty493', 'paraclas', 'balistic2', 'diablopbc', 'kim417', 'd98521', 'bongen2', 'willtk0113', 'leiyang1', 'nanohub99', 'seanlee14', 'jack_ftw', 'se210', 'weller1', 'dawei1', 'jglauber', 'dlgudwns11', 'tao7', 'rishabagarwal1', 'aamin9', 'schrock3', 'lindqui1', 'cjohns78', 'qwerasdf', None, 'ma3xiao1', 'wisechengyi', 'chijiazuo', 'aggarwa3', 'rlew2', 'dbarnes2', 'joo4ny', 'snowpd', 'aditchhabra', 'idesis1', 'tkim28', 'weichunan', 'wldavis']"
3,157,108,66,59,"['ajwk', 'xyq078087', 'jenniebharaj', 'jeffr04', 'prajeet', 'pcclnicholas', 'xolax', 'pservati', 'e1ement', 'dsim89', 'jefferson', 'jonomon', 'jackyuhaic', 'nndcici', 'darylrp', 'viny3n', 'skeety', 'aylin_azmin', 'david_thompson13', 'gouedi', 'what1what2', 'richardh', 'edigou', 'ditullio', 'djova', 'bennyccy', 'seraphjkkim', 'amramin', 'charfire', 'd2night', 'voonqian', 'lbarrios', 'rayzrick', 'muhammad_usman90', 'wheetnee', 'whlxm3', 'ian781203', 'bmterry', 'xksilver', 'mnejatali', 'peterwu', 'yynumi', 't1e7', 'farhad_n_16', 'wqutub90', 'perpetualacorn', 'shensmobile', 'joshshelley', 'mengy46', 'anneliesvera', 'chamith', 'brooks99', 'pjsingh', 'zeusdios888', 'kyz_352', 'maan1989', 'megansun', 'celban', 'billyu07']",48,"['kibum84', 'vincenzozambianchi', 'kagren', 'schaef', 'rafaelgcpp', 'biondo', 'vaka85', 'precisiontech001', 'jmudd', 'visakh', 'han1106', 'sreekanthnarayan', 'asmus', 'foia87', 'epsilon2100', 'john123', 'bugmenot', 'jzheng6s', 'ainge', 'ctsimpson50', 'winewind', 'twiske', 'makhija1', 'luillo', 'mcalter', 'sam88', 'katrrot', 'iackzh', 'mpacheco', 'angf', 'grandidier', 'dydrhkdudmlw', 'leonlian007', 'sangyeoplee', 'jori', 'zq00001', 'rpagano', 'yaluen', 'shayanf4613', 'nmaxwell', 'jping', 'yulong', 'alile', 'bnisheeth', 'skshah6', 'seven', 'goga10', 'pflammer']",7,"['tbomb007', 'jamesye90', 'changcs', None, 'dm89', 'songci', 'melvinlim']",114,"['ajwk', 'xolax', 'dsim89', 'tbomb007', 'jzheng6s', 'changcs', 'ctsimpson50', 'edigou', 'makhija1', 'jamesye90', 'lbarrios', 'iackzh', 'leonlian007', 'bmterry', 'xksilver', 'jori', 'yynumi', 'shayanf4613', 'perpetualacorn', 'anneliesvera', 'bnisheeth', 'd2night', 'billyu07', 'xyq078087', 'kagren', 'rafaelgcpp', 'biondo', 'vaka85', 'prajeet', 'jmudd', 'visakh', 'han1106', 'jefferson', 'asmus', 'ainge', 'winewind', 'mcalter', 'amramin', 'voonqian', 'whlxm3', 'ian781203', 'sangyeoplee', 't1e7', 'zq00001', 'wqutub90', 'shensmobile', 'mengy46', 'chamith', 'nmaxwell', 'jping', 'yulong', 'maan1989', 'skshah6', 'seven', 'goga10', 'kibum84', 'jeffr04', 'nndcici', 'bugmenot', 'viny3n', 'skeety', 'aylin_azmin', 'david_thompson13', 'gouedi', 'ditullio', 'djova', 'sam88', 'charfire', 'mpacheco', 'muhammad_usman90', 'angf', 'grandidier', 'peterwu', 'mnejatali', 'rpagano', 'yaluen', 'brooks99', 'pjsingh', 'alile', 'kyz_352', 'megansun', 'celban', 'melvinlim', 'vincenzozambianchi', 'jenniebharaj', 'schaef', 'pcclnicholas', 'precisiontech001', 'pservati', 'e1ement', 'sreekanthnarayan', 'dm89', 'jonomon', 'jackyuhaic', 'foia87', 'john123', 'darylrp', 'richardh', 'what1what2', 'twiske', 'luillo', 'bennyccy', 'seraphjkkim', 'katrrot', 'rayzrick', 'wheetnee', 'dydrhkdudmlw', None, 'farhad_n_16', 'joshshelley', 'zeusdios888', 'epsilon2100', 'songci', 'pflammer']"
3,151,108,25,1,['skshah6'],106,"['kibum84', 'ajwk', 'jeffr04', 'xolax', 'dsim89', 'nndcici', 'bugmenot', 'jzheng6s', 'ctsimpson50', 'viny3n', 'skeety', 'aylin_azmin', 'david_thompson13', 'gouedi', 'edigou', 'makhija1', 'ditullio', 'djova', 'sam88', 'charfire', 'lbarrios', 'iackzh', 'mpacheco', 'muhammad_usman90', 'angf', 'grandidier', 'leonlian007', 'bmterry', 'xksilver', 'jori', 'peterwu', 'yynumi', 'mnejatali', 'rpagano', 'shayanf4613', 'perpetualacorn', 'yaluen', 'anneliesvera', 'brooks99', 'pjsingh', 'alile', 'kyz_352', 'bnisheeth', 'd2night', 'megansun', 'celban', 'billyu07', 'xyq078087', 'kagren', 'vincenzozambianchi', 'jenniebharaj', 'schaef', 'rafaelgcpp', 'biondo', 'vaka85', 'prajeet', 'pcclnicholas', 'precisiontech001', 'jmudd', 'visakh', 'pservati', 'e1ement', 'han1106', 'sreekanthnarayan', 'jefferson', 'jonomon', 'jackyuhaic', 'asmus', 'foia87', 'epsilon2100', 'john123', 'darylrp', 'ainge', 'richardh', 'what1what2', 'winewind', 'twiske', 'luillo', 'bennyccy', 'seraphjkkim', 'mcalter', 'amramin', 'voonqian', 'katrrot', 'rayzrick', 'wheetnee', 'dydrhkdudmlw', 'whlxm3', 'ian781203', 'sangyeoplee', 't1e7', 'zq00001', 'wqutub90', 'farhad_n_16', 'shensmobile', 'mengy46', 'joshshelley', 'chamith', 'nmaxwell', 'jping', 'zeusdios888', 'yulong', 'maan1989', 'seven', 'goga10', 'pflammer']",24,"['rvemuri8', 'mmusisin', 'mdinezza', 'aayelauw', 'raghuraj', 'anni_sgt', 'drshah', 'gajanan', 'pzzqly', 'physicslandman', 'jvelamal', 'haowu', 'dingkang', 'iniyanse', 'derekc153', 'anmuydarp', None, 'skalluri', 'kunalghosh', 'baileya6', 'whgdettlaff', 'jrollins', 'swaroopa', 'zhicheng']",131,"['kibum84', 'ajwk', 'mmusisin', 'jeffr04', 'mdinezza', 'aayelauw', 'xolax', 'dsim89', 'drshah', 'nndcici', 'bugmenot', 'pzzqly', 'jzheng6s', 'physicslandman', 'ctsimpson50', 'viny3n', 'skeety', 'aylin_azmin', 'jvelamal', 'david_thompson13', 'dingkang', 'gouedi', 'edigou', 'makhija1', 'ditullio', 'djova', 'sam88', 'charfire', 'lbarrios', 'iackzh', 'mpacheco', 'muhammad_usman90', 'angf', 'grandidier', 'leonlian007', 'bmterry', 'xksilver', 'jori', 'peterwu', 'yynumi', 'mnejatali', 'rpagano', 'shayanf4613', 'perpetualacorn', 'yaluen', 'anneliesvera', 'kunalghosh', 'brooks99', 'pjsingh', 'baileya6', 'alile', 'kyz_352', 'bnisheeth', 'd2night', 'megansun', 'celban', 'jrollins', 'billyu07', 'xyq078087', 'kagren', 'vincenzozambianchi', 'jenniebharaj', 'schaef', 'rafaelgcpp', 'biondo', 'vaka85', 'prajeet', 'rvemuri8', 'pcclnicholas', 'precisiontech001', 'jmudd', 'visakh', 'pservati', 'e1ement', 'han1106', 'raghuraj', 'anni_sgt', 'sreekanthnarayan', 'jefferson', 'jonomon', 'jackyuhaic', 'asmus', 'gajanan', 'foia87', 'epsilon2100', 'john123', 'darylrp', 'ainge', 'haowu', 'richardh', 'what1what2', 'iniyanse', 'winewind', 'twiske', 'derekc153', 'luillo', 'bennyccy', 'seraphjkkim', 'anmuydarp', 'mcalter', 'amramin', 'voonqian', 'katrrot', 'rayzrick', 'wheetnee', 'dydrhkdudmlw', 'whlxm3', 'ian781203', 'sangyeoplee', 't1e7', 'zq00001', 'wqutub90', 'farhad_n_16', None, 'shensmobile', 'mengy46', 'joshshelley', 'chamith', 'nmaxwell', 'skalluri', 'jping', 'zeusdios888', 'yulong', 'whgdettlaff', 'maan1989', 'skshah6', 'seven', 'swaroopa', 'goga10', 'zhicheng', 'pflammer']"
3,158,108,17,12,"['yynumi', 'yaluen', 'john123', 'jzheng6s', 'pservati', 'e1ement', 'iackzh', 'han1106', 'richardh', 'leonlian007', 'jackyuhaic', 'billyu07']",95,"['kibum84', 'ajwk', 'jeffr04', 'xolax', 'dsim89', 'nndcici', 'bugmenot', 'ctsimpson50', 'viny3n', 'skeety', 'aylin_azmin', 'david_thompson13', 'gouedi', 'edigou', 'makhija1', 'ditullio', 'djova', 'sam88', 'charfire', 'lbarrios', 'mpacheco', 'muhammad_usman90', 'angf', 'grandidier', 'bmterry', 'xksilver', 'jori', 'peterwu', 'mnejatali', 'rpagano', 'shayanf4613', 'perpetualacorn', 'anneliesvera', 'brooks99', 'pjsingh', 'alile', 'kyz_352', 'bnisheeth', 'd2night', 'megansun', 'celban', 'xyq078087', 'kagren', 'vincenzozambianchi', 'jenniebharaj', 'schaef', 'rafaelgcpp', 'biondo', 'vaka85', 'prajeet', 'pcclnicholas', 'precisiontech001', 'jmudd', 'visakh', 'sreekanthnarayan', 'jefferson', 'jonomon', 'asmus', 'foia87', 'epsilon2100', 'darylrp', 'ainge', 'what1what2', 'winewind', 'twiske', 'luillo', 'bennyccy', 'seraphjkkim', 'mcalter', 'amramin', 'voonqian', 'katrrot', 'rayzrick', 'wheetnee', 'dydrhkdudmlw', 'whlxm3', 'ian781203', 'sangyeoplee', 't1e7', 'zq00001', 'wqutub90', 'farhad_n_16', 'shensmobile', 'mengy46', 'joshshelley', 'chamith', 'nmaxwell', 'jping', 'zeusdios888', 'yulong', 'maan1989', 'skshah6', 'seven', 'goga10', 'pflammer']",5,"['tbomb007', 'jamesye90', 'y2w6', 'jackzhf', None]",112,"['kibum84', 'ajwk', 'jeffr04', 'xolax', 'dsim89', 'nndcici', 'tbomb007', 'bugmenot', 'jzheng6s', 'ctsimpson50', 'viny3n', 'skeety', 'aylin_azmin', 'david_thompson13', 'gouedi', 'edigou', 'makhija1', 'ditullio', 'djova', 'jamesye90', 'sam88', 'charfire', 'lbarrios', 'iackzh', 'mpacheco', 'muhammad_usman90', 'angf', 'grandidier', 'jackzhf', 'leonlian007', 'bmterry', 'xksilver', 'jori', 'peterwu', 'yynumi', 'mnejatali', 'rpagano', 'shayanf4613', 'perpetualacorn', 'yaluen', 'anneliesvera', 'brooks99', 'pjsingh', 'alile', 'kyz_352', 'bnisheeth', 'd2night', 'megansun', 'celban', 'billyu07', 'xyq078087', 'kagren', 'vincenzozambianchi', 'jenniebharaj', 'schaef', 'rafaelgcpp', 'biondo', 'vaka85', 'prajeet', 'pcclnicholas', 'precisiontech001', 'jmudd', 'visakh', 'pservati', 'e1ement', 'han1106', 'sreekanthnarayan', 'jefferson', 'jonomon', 'jackyuhaic', 'asmus', 'foia87', 'epsilon2100', 'john123', 'darylrp', 'ainge', 'richardh', 'what1what2', 'winewind', 'twiske', 'luillo', 'bennyccy', 'seraphjkkim', 'y2w6', 'mcalter', 'amramin', 'voonqian', 'katrrot', 'rayzrick', 'wheetnee', 'dydrhkdudmlw', 'whlxm3', 'ian781203', 'sangyeoplee', 't1e7', 'zq00001', 'wqutub90', 'farhad_n_16', None, 'shensmobile', 'mengy46', 'joshshelley', 'chamith', 'nmaxwell', 'jping', 'zeusdios888', 'yulong', 'maan1989', 'skshah6', 'seven', 'goga10', 'pflammer']"
3,140,108,8,2,"['vaka85', 'foia87']",105,"['kibum84', 'ajwk', 'jeffr04', 'xolax', 'dsim89', 'nndcici', 'bugmenot', 'jzheng6s', 'ctsimpson50', 'viny3n', 'skeety', 'aylin_azmin', 'david_thompson13', 'gouedi', 'edigou', 'makhija1', 'ditullio', 'djova', 'sam88', 'charfire', 'lbarrios', 'iackzh', 'mpacheco', 'muhammad_usman90', 'angf', 'grandidier', 'leonlian007', 'bmterry', 'xksilver', 'jori', 'peterwu', 'yynumi', 'mnejatali', 'rpagano', 'shayanf4613', 'perpetualacorn', 'yaluen', 'anneliesvera', 'brooks99', 'pjsingh', 'alile', 'kyz_352', 'bnisheeth', 'd2night', 'megansun', 'celban', 'billyu07', 'xyq078087', 'kagren', 'vincenzozambianchi', 'jenniebharaj', 'schaef', 'rafaelgcpp', 'biondo', 'prajeet', 'pcclnicholas', 'precisiontech001', 'jmudd', 'visakh', 'pservati', 'e1ement', 'han1106', 'sreekanthnarayan', 'jefferson', 'jonomon', 'jackyuhaic', 'asmus', 'epsilon2100', 'john123', 'darylrp', 'ainge', 'richardh', 'what1what2', 'winewind', 'twiske', 'luillo', 'bennyccy', 'seraphjkkim', 'mcalter', 'amramin', 'voonqian', 'katrrot', 'rayzrick', 'wheetnee', 'dydrhkdudmlw', 'whlxm3', 'ian781203', 'sangyeoplee', 't1e7', 'zq00001', 'wqutub90', 'farhad_n_16', 'shensmobile', 'mengy46', 'joshshelley', 'chamith', 'nmaxwell', 'jping', 'zeusdios888', 'yulong', 'maan1989', 'skshah6', 'seven', 'goga10', 'pflammer']",6,"['zannoni_luca', 'dariomagnani', 'sergiocontino', 'rafder', None, 'paolofiorini']",113,"['kibum84', 'ajwk', 'jeffr04', 'xolax', 'dsim89', 'nndcici', 'bugmenot', 'jzheng6s', 'ctsimpson50', 'viny3n', 'skeety', 'aylin_azmin', 'david_thompson13', 'gouedi', 'edigou', 'makhija1', 'ditullio', 'djova', 'sam88', 'charfire', 'lbarrios', 'iackzh', 'mpacheco', 'muhammad_usman90', 'angf', 'grandidier', 'leonlian007', 'bmterry', 'xksilver', 'jori', 'peterwu', 'yynumi', 'mnejatali', 'rpagano', 'shayanf4613', 'perpetualacorn', 'yaluen', 'anneliesvera', 'brooks99', 'pjsingh', 'alile', 'kyz_352', 'bnisheeth', 'd2night', 'megansun', 'celban', 'billyu07', 'xyq078087', 'kagren', 'vincenzozambianchi', 'jenniebharaj', 'schaef', 'rafaelgcpp', 'biondo', 'vaka85', 'prajeet', 'zannoni_luca', 'pcclnicholas', 'precisiontech001', 'jmudd', 'visakh', 'pservati', 'e1ement', 'han1106', 'sreekanthnarayan', 'jefferson', 'jonomon', 'jackyuhaic', 'asmus', 'foia87', 'epsilon2100', 'john123', 'darylrp', 'ainge', 'richardh', 'what1what2', 'winewind', 'twiske', 'luillo', 'bennyccy', 'seraphjkkim', 'mcalter', 'amramin', 'voonqian', 'katrrot', 'rayzrick', 'sergiocontino', 'rafder', 'wheetnee', 'dydrhkdudmlw', 'whlxm3', 'ian781203', 'sangyeoplee', 't1e7', 'zq00001', 'wqutub90', 'farhad_n_16', None, 'shensmobile', 'mengy46', 'joshshelley', 'chamith', 'nmaxwell', 'jping', 'zeusdios888', 'yulong', 'dariomagnani', 'maan1989', 'skshah6', 'seven', 'paolofiorini', 'goga10', 'pflammer']"
3,141,108,8,2,"['vincenzozambianchi', 'biondo']",105,"['kibum84', 'ajwk', 'jeffr04', 'xolax', 'dsim89', 'nndcici', 'bugmenot', 'jzheng6s', 'ctsimpson50', 'viny3n', 'skeety', 'aylin_azmin', 'david_thompson13', 'gouedi', 'edigou', 'makhija1', 'ditullio', 'djova', 'sam88', 'charfire', 'lbarrios', 'iackzh', 'mpacheco', 'muhammad_usman90', 'angf', 'grandidier', 'leonlian007', 'bmterry', 'xksilver', 'jori', 'peterwu', 'yynumi', 'mnejatali', 'rpagano', 'shayanf4613', 'perpetualacorn', 'yaluen', 'anneliesvera', 'brooks99', 'pjsingh', 'alile', 'kyz_352', 'bnisheeth', 'd2night', 'megansun', 'celban', 'billyu07', 'xyq078087', 'kagren', 'jenniebharaj', 'schaef', 'rafaelgcpp', 'vaka85', 'prajeet', 'pcclnicholas', 'precisiontech001', 'jmudd', 'visakh', 'pservati', 'e1ement', 'han1106', 'sreekanthnarayan', 'jefferson', 'jonomon', 'jackyuhaic', 'asmus', 'foia87', 'epsilon2100', 'john123', 'darylrp', 'ainge', 'richardh', 'what1what2', 'winewind', 'twiske', 'luillo', 'bennyccy', 'seraphjkkim', 'mcalter', 'amramin', 'voonqian', 'katrrot', 'rayzrick', 'wheetnee', 'dydrhkdudmlw', 'whlxm3', 'ian781203', 'sangyeoplee', 't1e7', 'zq00001', 'wqutub90', 'farhad_n_16', 'shensmobile', 'mengy46', 'joshshelley', 'chamith', 'nmaxwell', 'jping', 'zeusdios888', 'yulong', 'maan1989', 'skshah6', 'seven', 'goga10', 'pflammer']",6,"['triky', 'philip', None, 'simone', 'lodeloray', 'mattiap']",113,"['kibum84', 'ajwk', 'philip', 'jeffr04', 'xolax', 'dsim89', 'nndcici', 'bugmenot', 'jzheng6s', 'ctsimpson50', 'viny3n', 'skeety', 'aylin_azmin', 'david_thompson13', 'gouedi', 'edigou', 'makhija1', 'ditullio', 'djova', 'sam88', 'charfire', 'lbarrios', 'iackzh', 'mpacheco', 'muhammad_usman90', 'angf', 'grandidier', 'leonlian007', 'bmterry', 'xksilver', 'jori', 'peterwu', 'yynumi', 'mnejatali', 'rpagano', 'shayanf4613', 'perpetualacorn', 'yaluen', 'anneliesvera', 'brooks99', 'pjsingh', 'alile', 'kyz_352', 'bnisheeth', 'd2night', 'megansun', 'celban', 'lodeloray', 'billyu07', 'mattiap', 'xyq078087', 'kagren', 'vincenzozambianchi', 'jenniebharaj', 'schaef', 'rafaelgcpp', 'biondo', 'vaka85', 'prajeet', 'pcclnicholas', 'precisiontech001', 'jmudd', 'visakh', 'pservati', 'e1ement', 'han1106', 'sreekanthnarayan', 'jefferson', 'jonomon', 'jackyuhaic', 'asmus', 'foia87', 'epsilon2100', 'john123', 'darylrp', 'ainge', 'richardh', 'what1what2', 'winewind', 'twiske', 'luillo', 'bennyccy', 'seraphjkkim', 'triky', 'mcalter', 'amramin', 'voonqian', 'katrrot', 'rayzrick', 'simone', 'wheetnee', 'dydrhkdudmlw', 'whlxm3', 'ian781203', 'sangyeoplee', 't1e7', 'zq00001', 'wqutub90', 'farhad_n_16', None, 'shensmobile', 'mengy46', 'joshshelley', 'chamith', 'nmaxwell', 'jping', 'zeusdios888', 'yulong', 'maan1989', 'skshah6', 'seven', 'goga10', 'pflammer']"
3,159,108,8,2,"['vaka85', 'foia87']",105,"['kibum84', 'ajwk', 'jeffr04', 'xolax', 'dsim89', 'nndcici', 'bugmenot', 'jzheng6s', 'ctsimpson50', 'viny3n', 'skeety', 'aylin_azmin', 'david_thompson13', 'gouedi', 'edigou', 'makhija1', 'ditullio', 'djova', 'sam88', 'charfire', 'lbarrios', 'iackzh', 'mpacheco', 'muhammad_usman90', 'angf', 'grandidier', 'leonlian007', 'bmterry', 'xksilver', 'jori', 'peterwu', 'yynumi', 'mnejatali', 'rpagano', 'shayanf4613', 'perpetualacorn', 'yaluen', 'anneliesvera', 'brooks99', 'pjsingh', 'alile', 'kyz_352', 'bnisheeth', 'd2night', 'megansun', 'celban', 'billyu07', 'xyq078087', 'kagren', 'vincenzozambianchi', 'jenniebharaj', 'schaef', 'rafaelgcpp', 'biondo', 'prajeet', 'pcclnicholas', 'precisiontech001', 'jmudd', 'visakh', 'pservati', 'e1ement', 'han1106', 'sreekanthnarayan', 'jefferson', 'jonomon', 'jackyuhaic', 'asmus', 'epsilon2100', 'john123', 'darylrp', 'ainge', 'richardh', 'what1what2', 'winewind', 'twiske', 'luillo', 'bennyccy', 'seraphjkkim', 'mcalter', 'amramin', 'voonqian', 'katrrot', 'rayzrick', 'wheetnee', 'dydrhkdudmlw', 'whlxm3', 'ian781203', 'sangyeoplee', 't1e7', 'zq00001', 'wqutub90', 'farhad_n_16', 'shensmobile', 'mengy46', 'joshshelley', 'chamith', 'nmaxwell', 'jping', 'zeusdios888', 'yulong', 'maan1989', 'skshah6', 'seven', 'goga10', 'pflammer']",6,"['zannoni_luca', 'dariomagnani', 'sergiocontino', 'rafder', None, 'paolofiorini']",113,"['kibum84', 'ajwk', 'jeffr04', 'xolax', 'dsim89', 'nndcici', 'bugmenot', 'jzheng6s', 'ctsimpson50', 'viny3n', 'skeety', 'aylin_azmin', 'david_thompson13', 'gouedi', 'edigou', 'makhija1', 'ditullio', 'djova', 'sam88', 'charfire', 'lbarrios', 'iackzh', 'mpacheco', 'muhammad_usman90', 'angf', 'grandidier', 'leonlian007', 'bmterry', 'xksilver', 'jori', 'peterwu', 'yynumi', 'mnejatali', 'rpagano', 'shayanf4613', 'perpetualacorn', 'yaluen', 'anneliesvera', 'brooks99', 'pjsingh', 'alile', 'kyz_352', 'bnisheeth', 'd2night', 'megansun', 'celban', 'billyu07', 'xyq078087', 'kagren', 'vincenzozambianchi', 'jenniebharaj', 'schaef', 'rafaelgcpp', 'biondo', 'vaka85', 'prajeet', 'zannoni_luca', 'pcclnicholas', 'precisiontech001', 'jmudd', 'visakh', 'pservati', 'e1ement', 'han1106', 'sreekanthnarayan', 'jefferson', 'jonomon', 'jackyuhaic', 'asmus', 'foia87', 'epsilon2100', 'john123', 'darylrp', 'ainge', 'richardh', 'what1what2', 'winewind', 'twiske', 'luillo', 'bennyccy', 'seraphjkkim', 'mcalter', 'amramin', 'voonqian', 'katrrot', 'rayzrick', 'sergiocontino', 'rafder', 'wheetnee', 'dydrhkdudmlw', 'whlxm3', 'ian781203', 'sangyeoplee', 't1e7', 'zq00001', 'wqutub90', 'farhad_n_16', None, 'shensmobile', 'mengy46', 'joshshelley', 'chamith', 'nmaxwell', 'jping', 'zeusdios888', 'yulong', 'dariomagnani', 'maan1989', 'skshah6', 'seven', 'paolofiorini', 'goga10', 'pflammer']"
3,160,108,8,2,"['vincenzozambianchi', 'biondo']",105,"['kibum84', 'ajwk', 'jeffr04', 'xolax', 'dsim89', 'nndcici', 'bugmenot', 'jzheng6s', 'ctsimpson50', 'viny3n', 'skeety', 'aylin_azmin', 'david_thompson13', 'gouedi', 'edigou', 'makhija1', 'ditullio', 'djova', 'sam88', 'charfire', 'lbarrios', 'iackzh', 'mpacheco', 'muhammad_usman90', 'angf', 'grandidier', 'leonlian007', 'bmterry', 'xksilver', 'jori', 'peterwu', 'yynumi', 'mnejatali', 'rpagano', 'shayanf4613', 'perpetualacorn', 'yaluen', 'anneliesvera', 'brooks99', 'pjsingh', 'alile', 'kyz_352', 'bnisheeth', 'd2night', 'megansun', 'celban', 'billyu07', 'xyq078087', 'kagren', 'jenniebharaj', 'schaef', 'rafaelgcpp', 'vaka85', 'prajeet', 'pcclnicholas', 'precisiontech001', 'jmudd', 'visakh', 'pservati', 'e1ement', 'han1106', 'sreekanthnarayan', 'jefferson', 'jonomon', 'jackyuhaic', 'asmus', 'foia87', 'epsilon2100', 'john123', 'darylrp', 'ainge', 'richardh', 'what1what2', 'winewind', 'twiske', 'luillo', 'bennyccy', 'seraphjkkim', 'mcalter', 'amramin', 'voonqian', 'katrrot', 'rayzrick', 'wheetnee', 'dydrhkdudmlw', 'whlxm3', 'ian781203', 'sangyeoplee', 't1e7', 'zq00001', 'wqutub90', 'farhad_n_16', 'shensmobile', 'mengy46', 'joshshelley', 'chamith', 'nmaxwell', 'jping', 'zeusdios888', 'yulong', 'maan1989', 'skshah6', 'seven', 'goga10', 'pflammer']",6,"['triky', 'philip', None, 'simone', 'lodeloray', 'mattiap']",113,"['kibum84', 'ajwk', 'philip', 'jeffr04', 'xolax', 'dsim89', 'nndcici', 'bugmenot', 'jzheng6s', 'ctsimpson50', 'viny3n', 'skeety', 'aylin_azmin', 'david_thompson13', 'gouedi', 'edigou', 'makhija1', 'ditullio', 'djova', 'sam88', 'charfire', 'lbarrios', 'iackzh', 'mpacheco', 'muhammad_usman90', 'angf', 'grandidier', 'leonlian007', 'bmterry', 'xksilver', 'jori', 'peterwu', 'yynumi', 'mnejatali', 'rpagano', 'shayanf4613', 'perpetualacorn', 'yaluen', 'anneliesvera', 'brooks99', 'pjsingh', 'alile', 'kyz_352', 'bnisheeth', 'd2night', 'megansun', 'celban', 'lodeloray', 'billyu07', 'mattiap', 'xyq078087', 'kagren', 'vincenzozambianchi', 'jenniebharaj', 'schaef', 'rafaelgcpp', 'biondo', 'vaka85', 'prajeet', 'pcclnicholas', 'precisiontech001', 'jmudd', 'visakh', 'pservati', 'e1ement', 'han1106', 'sreekanthnarayan', 'jefferson', 'jonomon', 'jackyuhaic', 'asmus', 'foia87', 'epsilon2100', 'john123', 'darylrp', 'ainge', 'richardh', 'what1what2', 'winewind', 'twiske', 'luillo', 'bennyccy', 'seraphjkkim', 'triky', 'mcalter', 'amramin', 'voonqian', 'katrrot', 'rayzrick', 'simone', 'wheetnee', 'dydrhkdudmlw', 'whlxm3', 'ian781203', 'sangyeoplee', 't1e7', 'zq00001', 'wqutub90', 'farhad_n_16', None, 'shensmobile', 'mengy46', 'joshshelley', 'chamith', 'nmaxwell', 'jping', 'zeusdios888', 'yulong', 'maan1989', 'skshah6', 'seven', 'goga10', 'pflammer']"
4,94,53,54,52,"['bae4', 'dadrin2026', 'chen399', 'egabbard', 'ecummin', 'hao90408', 'ppacey', 'dklenosk', 'li319', 'wandrbeck', 'sfrissel', 'rambs', 'zhu51', 'eanthon', 'dschalle', 'bowensbo', 'georger', 'j3holaday', 'jblackw', 'thir098', 'dfswartz', 'kchaput', 'rstauber', 'lu52', 'lingj', 'mzolnows', 'tqiu', 'lmarroni', 'csun', 'svaselan', 'ahinsh00', 'md1032', 'zfarrell', 'zeastman', 'mchuber', 'xie10', 'li365', 'zhang625', 'fengk', 'kharry', 'mbrant102', 'edeutsch90', 'terrye', 'akraman', 'bosecki', 'dquickel', 'jgarves', 'ccurti00', 'ckopf', 'lancaste', 'shihh', 'lnichol']",0,[],2,"['strachan', None]",54,"['dadrin2026', 'strachan', 'ecummin', 'dklenosk', 'rambs', 'zhu51', 'eanthon', 'dschalle', 'j3holaday', 'thir098', 'kchaput', 'lu52', 'tqiu', 'csun', 'svaselan', 'md1032', 'zfarrell', 'mchuber', 'kharry', 'terrye', 'jgarves', 'ckopf', 'shihh', 'bae4', 'chen399', 'egabbard', 'hao90408', 'ppacey', 'wandrbeck', 'li319', 'sfrissel', 'bowensbo', 'georger', 'jblackw', 'dfswartz', 'rstauber', 'lingj', 'mzolnows', 'lmarroni', 'ahinsh00', 'zeastman', 'xie10', 'li365', None, 'zhang625', 'fengk', 'mbrant102', 'edeutsch90', 'akraman', 'bosecki', 'dquickel', 'ccurti00', 'lancaste', 'lnichol']"
5,170,52,49,35,"['alsghand', 'hwang406', 'kyu461', 'soulesque', 'unsooman', 'ngan', 'usang2v', 'cbj1988', 'againwns007', 'john_88', 'lkylove23', 'cwc9908', 'saram1823', 'hsa90', 'jeongyoon', 'cjt5528', 'donghwa', 'ayoprious', 'aindelf', 'imingan', 'hunbaksa', 'ssooji555', 'micallis', 'kinkin88', 'sould628', 'jjongho85', 'lhgwin', 'kimhs324', 'lbmin1352', 'westkllr', 'bertpark', 'born0907', 'wheeiz', 'garam7749', 'jwshin01']",16,"['qjohnnyp', 'trackgirl49', 'turktest', 'humberto', 'chionatan', 'jeremydelater', 'theboss4', 'henryb12', 'rrestre', 'bkietz', 'jseto', 'thejunkbox', 'nhaddock', 'sohrab', 'vaideeshl', 'opbal']",14,"['sharp1988', 'ham4406', 'kmann000', 'terodactyl', 'ggap', 'tnalse', 'lonelymoon', 'hongjae', 'oopsbaby', 'seokju88', 'kangsudat', None, 'hyunuk1987', 'krase988']",65,"['alsghand', 'ham4406', 'terodactyl', 'kyu461', 'usang2v', 'thejunkbox', 'vaideeshl', 'seokju88', 'kangsudat', 'chionatan', 'jeremydelater', 'tnalse', 'saram1823', 'jeongyoon', 'sohrab', 'cjt5528', 'turktest', 'donghwa', 'ayoprious', 'hunbaksa', 'ssooji555', 'hongjae', 'rrestre', 'kinkin88', 'sould628', 'jjongho85', 'krase988', 'kimhs324', 'lbmin1352', 'westkllr', 'jseto', 'wheeiz', 'garam7749', 'unsooman', 'hwang406', 'humberto', 'soulesque', 'ngan', 'nhaddock', 'cbj1988', 'hyunuk1987', 'againwns007', 'qjohnnyp', 'john_88', 'lkylove23', 'kmann000', 'cwc9908', 'hsa90', 'imingan', 'aindelf', 'bkietz', 'micallis', None, 'opbal', 'trackgirl49', 'lhgwin', 'sharp1988', 'henryb12', 'ggap', 'lonelymoon', 'oopsbaby', 'bertpark', 'born0907', 'theboss4', 'jwshin01']"
5,56,52,14,1,['kyu461'],50,"['hwang406', 'alsghand', 'humberto', 'soulesque', 'ngan', 'usang2v', 'thejunkbox', 'nhaddock', 'vaideeshl', 'cbj1988', 'againwns007', 'qjohnnyp', 'john_88', 'lkylove23', 'chionatan', 'jeremydelater', 'cwc9908', 'saram1823', 'hsa90', 'jeongyoon', 'sohrab', 'cjt5528', 'garam7749', 'turktest', 'donghwa', 'aindelf', 'imingan', 'ayoprious', 'bkietz', 'ssooji555', 'hunbaksa', 'rrestre', 'micallis', 'kinkin88', 'sould628', 'jwshin01', 'opbal', 'jjongho85', 'trackgirl49', 'lhgwin', 'kimhs324', 'lbmin1352', 'henryb12', 'westkllr', 'jseto', 'bertpark', 'born0907', 'wheeiz', 'theboss4', 'unsooman']",13,"['leoseo321', 'yjhhjy', 'ham4406', 'terodactyl', 'jysohn1108', 'hjh9016', 'subibler', 'lonelymoon', 'oopsbaby', 'feelingdp', 'sam2858', None, 'dewrains']",64,"['hwang406', 'alsghand', 'leoseo321', 'humberto', 'ham4406', 'terodactyl', 'kyu461', 'soulesque', 'unsooman', 'ngan', 'usang2v', 'thejunkbox', 'nhaddock', 'vaideeshl', 'cbj1988', 'againwns007', 'qjohnnyp', 'john_88', 'lkylove23', 'chionatan', 'jeremydelater', 'jysohn1108', 'cwc9908', 'hjh9016', 'subibler', 'saram1823', 'sam2858', 'hsa90', 'jeongyoon', 'sohrab', 'cjt5528', 'yjhhjy', 'turktest', 'donghwa', 'aindelf', 'imingan', 'ayoprious', 'bkietz', 'ssooji555', 'hunbaksa', 'feelingdp', 'rrestre', 'micallis', 'kinkin88', 'sould628', None, 'opbal', 'jjongho85', 'dewrains', 'trackgirl49', 'lhgwin', 'theboss4', 'kimhs324', 'lbmin1352', 'henryb12', 'westkllr', 'lonelymoon', 'jseto', 'oopsbaby', 'bertpark', 'born0907', 'wheeiz', 'garam7749', 'jwshin01']"
6,157,44,66,1,['melvinlim'],42,"['lionking', 'eng_nona', 'tarekameen', 'kymera', 'shadygamel', 'mohamedgsh', 's2taha', 'engmai88', 'kamal12', 'islam_sayd31', 'ibrahemmetwally77', 'mmatda1976', 'mzaghloul', 'heba_sabri', 'noora_elgarhy', 'ek4m2005', 'a4atmel', 'moatazhegab', 'shady', 'abd_allah', 'waled', 'shaymaa', 'himahmoud', 'skoester2010', 'msaleh', 'eng_noha', 'ibra_candle', 'mai', 'second', 'eauchy', 'maya', 'engshimaa', 'salehov', 'baraka', 'mnahmed', 'posy', 'kemo0o2010', 'samozeid', 'marwa1', 'ahmed_92', 'h_maksoud', 'moataz']",65,"['ajwk', 'xyq078087', 'jenniebharaj', 'jeffr04', 'prajeet', 'pcclnicholas', 'xolax', 'pservati', 'e1ement', 'dsim89', 'jefferson', 'dm89', 'jonomon', 'jackyuhaic', 'celban', 'nndcici', 'tbomb007', 'darylrp', 'changcs', 'viny3n', 'skeety', 'aylin_azmin', 'david_thompson13', 'gouedi', 'what1what2', 'richardh', 'edigou', 'ditullio', 'jamesye90', 'djova', 'bennyccy', 'seraphjkkim', 'amramin', 'charfire', 'd2night', 'voonqian', 'lbarrios', 'rayzrick', 'muhammad_usman90', 'wheetnee', 'whlxm3', 'ian781203', 'bmterry', 'xksilver', 'mnejatali', 'peterwu', 'yynumi', None, 't1e7', 'farhad_n_16', 'perpetualacorn', 'wqutub90', 'shensmobile', 'joshshelley', 'anneliesvera', 'mengy46', 'chamith', 'brooks99', 'pjsingh', 'zeusdios888', 'kyz_352', 'maan1989', 'megansun', 'songci', 'billyu07']",108,"['lionking', 'ajwk', 'kymera', 'shadygamel', 'jeffr04', 'xolax', 'dsim89', 'ibrahemmetwally77', 'ek4m2005', 'heba_sabri', 'mzaghloul', 'nndcici', 'tbomb007', 'changcs', 'viny3n', 'skeety', 'aylin_azmin', 'moatazhegab', 'david_thompson13', 'gouedi', 'edigou', 'shady', 'waled', 'ditullio', 'jamesye90', 'djova', 'himahmoud', 'skoester2010', 'charfire', 'lbarrios', 'msaleh', 'ibra_candle', 'mai', 'muhammad_usman90', 'second', 'bmterry', 'xksilver', 'maya', 'mnejatali', 'peterwu', 'yynumi', 'perpetualacorn', 'mnahmed', 'anneliesvera', 'posy', 'kemo0o2010', 'brooks99', 'pjsingh', 'samozeid', 'kyz_352', 'ahmed_92', 'megansun', 'd2night', 'celban', 'melvinlim', 'moataz', 'billyu07', 'eng_nona', 'xyq078087', 'jenniebharaj', 'tarekameen', 'prajeet', 'mohamedgsh', 's2taha', 'pcclnicholas', 'engmai88', 'pservati', 'e1ement', 'kamal12', 'islam_sayd31', 'jefferson', 'dm89', 'jackyuhaic', 'jonomon', 'mmatda1976', 'noora_elgarhy', 'darylrp', 'a4atmel', 'what1what2', 'richardh', 'abd_allah', 'shaymaa', 'bennyccy', 'seraphjkkim', 'amramin', 'voonqian', 'eng_noha', 'rayzrick', 'wheetnee', 'whlxm3', 'ian781203', None, 't1e7', 'eauchy', 'farhad_n_16', 'wqutub90', 'engshimaa', 'shensmobile', 'salehov', 'joshshelley', 'mengy46', 'baraka', 'chamith', 'zeusdios888', 'marwa1', 'maan1989', 'h_maksoud', 'songci']"
6,139,44,51,36,"['lionking', 'eng_nona', 'tarekameen', 'kymera', 'shadygamel', 'mohamedgsh', 's2taha', 'engmai88', 'kamal12', 'ibrahemmetwally77', 'mzaghloul', 'heba_sabri', 'noora_elgarhy', 'ek4m2005', 'a4atmel', 'moatazhegab', 'shady', 'abd_allah', 'shaymaa', 'himahmoud', 'eng_noha', 'ibra_candle', 'mai', 'second', 'eauchy', 'maya', 'engshimaa', 'salehov', 'baraka', 'posy', 'kemo0o2010', 'samozeid', 'marwa1', 'ahmed_92', 'h_maksoud', 'moataz']",7,"['waled', 'mnahmed', 'skoester2010', 'msaleh', 'islam_sayd31', 'melvinlim', 'mmatda1976']",15,"['anadrol', 'heba_sadek', 'khalidmohamed', 'ratshih', 'serag', 'fayzabs', 'mohamedamin2010', 'shaker', 'basma_shaalan', 'marwa', 'ahmd_sadk', 'omarmonem', 'eng_hassan', 'sgam', None]",58,"['lionking', 'heba_sadek', 'anadrol', 'kymera', 'shadygamel', 'shaker', 'basma_shaalan', 'ibrahemmetwally77', 'ek4m2005', 'heba_sabri', 'mzaghloul', 'moatazhegab', 'ahmd_sadk', 'shady', 'waled', 'himahmoud', 'skoester2010', 'msaleh', 'ibra_candle', 'mai', 'sgam', 'second', 'maya', 'khalidmohamed', 'serag', 'mnahmed', 'posy', 'kemo0o2010', 'samozeid', 'ahmed_92', 'melvinlim', 'moataz', 'eng_nona', 'tarekameen', 'mohamedgsh', 's2taha', 'engmai88', 'marwa', 'kamal12', 'islam_sayd31', 'mmatda1976', 'noora_elgarhy', 'ratshih', 'mohamedamin2010', 'a4atmel', 'abd_allah', 'shaymaa', 'eng_noha', None, 'eauchy', 'engshimaa', 'salehov', 'fayzabs', 'baraka', 'marwa1', 'omarmonem', 'eng_hassan', 'h_maksoud']"
6,156,44,14,4,"['a4atmel', 'salehov', 'kamal12', 'baraka']",39,"['lionking', 'eng_nona', 'tarekameen', 'kymera', 'shadygamel', 'mohamedgsh', 's2taha', 'engmai88', 'islam_sayd31', 'ibrahemmetwally77', 'mmatda1976', 'mzaghloul', 'heba_sabri', 'noora_elgarhy', 'ek4m2005', 'moatazhegab', 'shady', 'abd_allah', 'waled', 'shaymaa', 'himahmoud', 'skoester2010', 'msaleh', 'eng_noha', 'ibra_candle', 'mai', 'second', 'eauchy', 'maya', 'engshimaa', 'mnahmed', 'posy', 'kemo0o2010', 'samozeid', 'marwa1', 'moataz', 'ahmed_92', 'h_maksoud', 'melvinlim']",10,"['anadrol', 'khalidmohamed', 'serag', 'fayzabs', 'mohamedamin2010', 'shaker', 'basma_shaalan', 'omarmonem', 'sgam', None]",53,"['lionking', 'eng_nona', 'anadrol', 'tarekameen', 'kymera', 'shadygamel', 'mohamedgsh', 's2taha', 'shaker', 'basma_shaalan', 'engmai88', 'kamal12', 'islam_sayd31', 'ibrahemmetwally77', 'mmatda1976', 'ek4m2005', 'heba_sabri', 'noora_elgarhy', 'mzaghloul', 'mohamedamin2010', 'melvinlim', 'a4atmel', 'moatazhegab', 'shady', 'abd_allah', 'waled', 'shaymaa', 'himahmoud', 'skoester2010', 'msaleh', 'eng_noha', 'ibra_candle', 'mai', 'sgam', 'second', None, 'eauchy', 'maya', 'engshimaa', 'salehov', 'khalidmohamed', 'serag', 'fayzabs', 'baraka', 'mnahmed', 'posy', 'kemo0o2010', 'samozeid', 'marwa1', 'omarmonem', 'ahmed_92', 'h_maksoud', 'moataz']"
6,138,44,7,3,"['eng_noha', 'mzaghloul', 'heba_sabri']",40,"['lionking', 'eng_nona', 'tarekameen', 'kymera', 'shadygamel', 'mohamedgsh', 's2taha', 'engmai88', 'kamal12', 'islam_sayd31', 'ibrahemmetwally77', 'mmatda1976', 'ek4m2005', 'noora_elgarhy', 'melvinlim', 'a4atmel', 'moatazhegab', 'shady', 'abd_allah', 'waled', 'shaymaa', 'himahmoud', 'skoester2010', 'msaleh', 'ibra_candle', 'mai', 'second', 'eauchy', 'maya', 'engshimaa', 'salehov', 'baraka', 'mnahmed', 'posy', 'kemo0o2010', 'samozeid', 'marwa1', 'ahmed_92', 'h_maksoud', 'moataz']",4,"[None, 'serag', 'fayzabs', 'es']",47,"['lionking', 'eng_nona', 'tarekameen', 'kymera', 'shadygamel', 'mohamedgsh', 's2taha', 'engmai88', 'kamal12', 'islam_sayd31', 'ibrahemmetwally77', 'mmatda1976', 'ek4m2005', 'heba_sabri', 'noora_elgarhy', 'mzaghloul', 'melvinlim', 'a4atmel', 'moatazhegab', 'shady', 'abd_allah', 'waled', 'shaymaa', 'himahmoud', 'skoester2010', 'msaleh', 'eng_noha', 'ibra_candle', 'mai', 'second', None, 'eauchy', 'maya', 'engshimaa', 'salehov', 'serag', 'fayzabs', 'baraka', 'mnahmed', 'posy', 'kemo0o2010', 'es', 'samozeid', 'marwa1', 'ahmed_92', 'h_maksoud', 'moataz']"
7,99,33,36,23,"['raizada1', 'dshih2', 'alaimo1', 'logiconcepts819', 'jaredlesicko', 'rgalvan2', 'sembel1', 'amryan2', 'taegonoh', 'dbostwi2', 'alllaw', 'computerwiz0911', 'vivoli1', 'rohanbali', 'stevenjin2137', 'cliu35', 'ercetera', 'apandya3', 'beminor2', 'jhandz2', 'somnath2', 'wbarnes2', 'yvonneeven']",9,"['lee142', 'kim413', 'djung31', 'codenum273', 'dn21493234', 'bconnaghan', 'missinglink41', 'rredeno2', 'gomez19']",13,"['mikedaley5', 'ran1363', 'rosboro1', 'setiawa2', 'franc21', 'wilwizard', 'ymoon4', 'justintconroy', 'boruichen', 'roylee3', 'mczarny', None, 'cpoon2']",45,"['lee142', 'raizada1', 'dshih2', 'dn21493234', 'missinglink41', 'alaimo1', 'boruichen', 'logiconcepts819', 'kim413', 'jaredlesicko', 'djung31', 'rosboro1', 'rgalvan2', 'sembel1', 'justintconroy', 'amryan2', 'taegonoh', 'dbostwi2', 'alllaw', 'franc21', 'wilwizard', 'rredeno2', 'computerwiz0911', 'roylee3', 'vivoli1', 'bconnaghan', 'rohanbali', 'mczarny', None, 'mikedaley5', 'stevenjin2137', 'cliu35', 'ran1363', 'setiawa2', 'ercetera', 'codenum273', 'apandya3', 'ymoon4', 'beminor2', 'jhandz2', 'somnath2', 'wbarnes2', 'cpoon2', 'yvonneeven', 'gomez19']"
7,59,33,31,18,"['kim413', 'raizada1', 'jaredlesicko', 'dbostwi2', 'alllaw', 'cliu35', 'dn21493234', 'bconnaghan', 'yvonneeven', 'alaimo1', 'rredeno2', 'logiconcepts819', 'jhandz2', 'somnath2', 'vivoli1', 'wbarnes2', 'rohanbali', 'taegonoh']",14,"['lee142', 'stevenjin2137', 'djung31', 'ercetera', 'rgalvan2', 'dshih2', 'codenum273', 'apandya3', 'beminor2', 'missinglink41', 'computerwiz0911', 'sembel1', 'amryan2', 'gomez19']",13,"['maddhatter', 'ran1363', 'barmstr3', 'ankitchandak', 'bagaria2', 'ymoon4', 'boruichen', 'roylee3', 'lebedow1', 'cuceu1', 'nivero', 'haiquans', None]",45,"['lee142', 'raizada1', 'dshih2', 'dn21493234', 'missinglink41', 'alaimo1', 'boruichen', 'logiconcepts819', 'lebedow1', 'cuceu1', 'kim413', 'jaredlesicko', 'maddhatter', 'djung31', 'rgalvan2', 'bagaria2', 'sembel1', 'barmstr3', 'haiquans', 'amryan2', 'taegonoh', 'dbostwi2', 'alllaw', 'rredeno2', 'computerwiz0911', 'roylee3', 'vivoli1', 'bconnaghan', 'rohanbali', None, 'stevenjin2137', 'cliu35', 'ankitchandak', 'ran1363', 'ercetera', 'codenum273', 'apandya3', 'ymoon4', 'beminor2', 'jhandz2', 'somnath2', 'wbarnes2', 'nivero', 'yvonneeven', 'gomez19']"
7,60,33,15,10,"['lee142', 'stevenjin2137', 'apandya3', 'rgalvan2', 'codenum273', 'dshih2', 'missinglink41', 'rredeno2', 'wbarnes2', 'gomez19']",22,"['raizada1', 'dn21493234', 'alaimo1', 'logiconcepts819', 'kim413', 'jaredlesicko', 'djung31', 'sembel1', 'amryan2', 'taegonoh', 'dbostwi2', 'alllaw', 'computerwiz0911', 'vivoli1', 'bconnaghan', 'rohanbali', 'cliu35', 'ercetera', 'beminor2', 'jhandz2', 'somnath2', 'yvonneeven']",5,"['maddhatter', 'dabbelt1', None, 'cpoon2', 'nmahend2']",37,"['lee142', 'raizada1', 'dshih2', 'dn21493234', 'missinglink41', 'alaimo1', 'logiconcepts819', 'kim413', 'jaredlesicko', 'maddhatter', 'djung31', 'rgalvan2', 'sembel1', 'amryan2', 'taegonoh', 'nmahend2', 'dbostwi2', 'alllaw', 'rredeno2', 'computerwiz0911', 'vivoli1', 'bconnaghan', 'rohanbali', 'dabbelt1', None, 'stevenjin2137', 'cliu35', 'ercetera', 'codenum273', 'apandya3', 'beminor2', 'jhandz2', 'somnath2', 'wbarnes2', 'cpoon2', 'yvonneeven', 'gomez19']"
7,100,33,8,7,"['lee142', 'codenum273', 'dshih2', 'dn21493234', 'missinglink41', 'bconnaghan', 'gomez19']",25,"['raizada1', 'alaimo1', 'logiconcepts819', 'kim413', 'jaredlesicko', 'djung31', 'rgalvan2', 'sembel1', 'amryan2', 'taegonoh', 'dbostwi2', 'alllaw', 'wbarnes2', 'computerwiz0911', 'vivoli1', 'rohanbali', 'stevenjin2137', 'cliu35', 'ercetera', 'apandya3', 'beminor2', 'jhandz2', 'somnath2', 'rredeno2', 'yvonneeven']",1,[None],33,"['lee142', 'raizada1', 'dshih2', 'dn21493234', 'missinglink41', 'alaimo1', 'logiconcepts819', 'kim413', 'jaredlesicko', 'djung31', 'rgalvan2', 'sembel1', 'amryan2', 'taegonoh', 'dbostwi2', 'alllaw', 'rredeno2', 'computerwiz0911', 'vivoli1', 'bconnaghan', 'rohanbali', None, 'stevenjin2137', 'cliu35', 'ercetera', 'codenum273', 'apandya3', 'beminor2', 'jhandz2', 'somnath2', 'wbarnes2', 'yvonneeven', 'gomez19']"
8,109,33,29,24,"['gltapia31', 'nemijares', 'masalomon', 'erodriguez', 'meescudero', 'atorres', 'demartinez4', 'crkleinz', 'carlosdistefano1', 'jjchavez5', 'rushphile', 'lfierro2', 'chassenk', 'vcruz5', 'c915', 'agarcia14', 'slfuller2', 'hdiesel9', 'uberlinoline', 'israelp', 'alejandro', 'omachado', 'chassen', 'cmamaya2']",8,"['psx2gaming', 'guox0008', 'derajan', 'omorales3', 'yichiachiu', 'djvidurkis', 'jiangying530', 'chienhong']",5,"['stella', 'davidalbertosv', 'valdez4', 'chorizo', None]",37,"['gltapia31', 'nemijares', 'yichiachiu', 'masalomon', 'erodriguez', 'meescudero', 'atorres', 'derajan', 'davidalbertosv', 'valdez4', 'demartinez4', 'djvidurkis', 'jiangying530', 'chienhong', 'psx2gaming', 'crkleinz', 'guox0008', 'carlosdistefano1', 'jjchavez5', 'rushphile', 'lfierro2', 'chassenk', 'chorizo', None, 'vcruz5', 'c915', 'agarcia14', 'slfuller2', 'hdiesel9', 'uberlinoline', 'stella', 'israelp', 'alejandro', 'omorales3', 'omachado', 'chassen', 'cmamaya2']"
8,110,33,25,1,['chienhong'],31,"['gltapia31', 'nemijares', 'yichiachiu', 'masalomon', 'erodriguez', 'meescudero', 'atorres', 'derajan', 'demartinez4', 'djvidurkis', 'jiangying530', 'guox0008', 'psx2gaming', 'crkleinz', 'carlosdistefano1', 'jjchavez5', 'rushphile', 'lfierro2', 'chassenk', 'vcruz5', 'c915', 'agarcia14', 'slfuller2', 'hdiesel9', 'uberlinoline', 'israelp', 'alejandro', 'omorales3', 'omachado', 'chassen', 'cmamaya2']",24,"['shabnamm', 'mbalaban', 'afshan', 'rafaelap', 'aminahen', 'wenderness', 'mmsa', 'frassess', 'adeline_lanterne', 'm_maziar', 'valurg', 'eugenio', 'zytung', 'aksaray', 'araz', 'asahmed', 'cat123', None, 'qinfei', 'mamata', 'zhihuichen', 'ashish1', 'aamirmujtaba', 'sinanag']",56,"['shabnamm', 'mbalaban', 'afshan', 'gltapia31', 'rafaelap', 'nemijares', 'aminahen', 'yichiachiu', 'masalomon', 'erodriguez', 'wenderness', 'mmsa', 'meescudero', 'atorres', 'derajan', 'frassess', 'demartinez4', 'djvidurkis', 'm_maziar', 'jiangying530', 'chienhong', 'psx2gaming', 'crkleinz', 'guox0008', 'adeline_lanterne', 'carlosdistefano1', 'valurg', 'eugenio', 'zytung', 'jjchavez5', 'aksaray', 'araz', 'sinanag', 'rushphile', 'lfierro2', 'asahmed', 'chassenk', 'cat123', None, 'vcruz5', 'qinfei', 'c915', 'agarcia14', 'mamata', 'zhihuichen', 'slfuller2', 'ashish1', 'aamirmujtaba', 'hdiesel9', 'uberlinoline', 'israelp', 'alejandro', 'omorales3', 'omachado', 'chassen', 'cmamaya2']"
8,13,33,15,1,['chienhong'],31,"['gltapia31', 'nemijares', 'yichiachiu', 'masalomon', 'erodriguez', 'meescudero', 'atorres', 'derajan', 'demartinez4', 'djvidurkis', 'jiangying530', 'guox0008', 'psx2gaming', 'crkleinz', 'carlosdistefano1', 'jjchavez5', 'rushphile', 'lfierro2', 'chassenk', 'vcruz5', 'c915', 'agarcia14', 'slfuller2', 'hdiesel9', 'uberlinoline', 'israelp', 'alejandro', 'omorales3', 'omachado', 'chassen', 'cmamaya2']",14,"['gahoi', 'shabnamm', 'mksharma', 'apesathi', 'canderle', 'angotd', 'ycnayan', 'eugenio', 'zytung', 'bellmanz', 'frassess', 'akinwummy', None, 'adeline_lanterne']",46,"['shabnamm', 'apesathi', 'canderle', 'ycnayan', 'gltapia31', 'nemijares', 'angotd', 'yichiachiu', 'masalomon', 'erodriguez', 'meescudero', 'atorres', 'derajan', 'frassess', 'demartinez4', 'djvidurkis', 'adeline_lanterne', 'jiangying530', 'chienhong', 'psx2gaming', 'crkleinz', 'guox0008', 'gahoi', 'carlosdistefano1', 'eugenio', 'zytung', 'jjchavez5', 'rushphile', 'lfierro2', 'chassenk', None, 'vcruz5', 'c915', 'agarcia14', 'mksharma', 'slfuller2', 'hdiesel9', 'bellmanz', 'uberlinoline', 'israelp', 'alejandro', 'omorales3', 'akinwummy', 'omachado', 'chassen', 'cmamaya2']"
9,82,31,29,22,"['zjhein', 'anhvnguyen', 'balind', 'jvsanchezmte', 'rgng', 'erwang', 'rusitadesai', 'eaderawish', 'nbwilkins', 'ntchow', 'qnluu1', 'jorgeg', 'dadesantiago', 'luiszehang', 'klgatchalian', 'pedrochavez', 'armagat', 'mchuynh', 'dkkoch', 'earuballos', 'oesandoval', 'hoangdtran']",8,"['cadolan', 'jcharper', 'pkhsu', 'cykwok', 'avg', 'hoannnguyen', 'lennon', 'tqwang']",7,"['maguirao', 'eeanker', 'whuynh', 'kmhicks', 'michaelreyes', None, 'rramoudeh']",37,"['cadolan', 'zjhein', 'anhvnguyen', 'maguirao', 'balind', 'jvsanchezmte', 'rgng', 'rramoudeh', 'jcharper', 'oesandoval', 'erwang', 'rusitadesai', 'eaderawish', 'nbwilkins', 'eeanker', 'ntchow', 'kmhicks', 'michaelreyes', None, 'qnluu1', 'jorgeg', 'dadesantiago', 'luiszehang', 'klgatchalian', 'pedrochavez', 'pkhsu', 'cykwok', 'mchuynh', 'armagat', 'whuynh', 'avg', 'dkkoch', 'hoannnguyen', 'lennon', 'earuballos', 'tqwang', 'hoangdtran']"
9,83,31,11,9,"['jcharper', 'pedrochavez', 'cykwok', 'pkhsu', 'mchuynh', 'dkkoch', 'hoannnguyen', 'earuballos', 'tqwang']",21,"['cadolan', 'zjhein', 'anhvnguyen', 'balind', 'jvsanchezmte', 'rgng', 'erwang', 'rusitadesai', 'eaderawish', 'nbwilkins', 'ntchow', 'qnluu1', 'jorgeg', 'dadesantiago', 'luiszehang', 'klgatchalian', 'armagat', 'avg', 'lennon', 'oesandoval', 'hoangdtran']",2,"[None, 'michaelreyes']",32,"['cadolan', 'zjhein', 'anhvnguyen', 'balind', 'jvsanchezmte', 'rgng', 'jcharper', 'oesandoval', 'erwang', 'rusitadesai', 'eaderawish', 'nbwilkins', 'ntchow', 'michaelreyes', None, 'qnluu1', 'jorgeg', 'dadesantiago', 'luiszehang', 'klgatchalian', 'pedrochavez', 'pkhsu', 'cykwok', 'mchuynh', 'armagat', 'avg', 'dkkoch', 'hoannnguyen', 'lennon', 'earuballos', 'tqwang', 'hoangdtran']"
10,190,28,47,23,"['jcanan', 'ryokubaka', 'asenetar', 'asmagulo', 'ekhall', 'macman314', 'alexwany', 'ahaberlein', 'mzwach', 'wangyix', 'dpbrocke', 'ebinkerd', 'ccange', 'goel5', 'minduka', 'khaver', 'apedroza', 'eekeen17', 'daedalus_v2', 'kjhajari', 'mille557', 'heckhoff', 'malsoray']",4,"['jkohnert', 'oadeniji', 'dfang7', 'kalqubai']",24,"['hungc', 'lsirui', 'baharman', 'mmilosci', 'oghaisas', 'mattflash', 'jjyoun', 'johns175', 'harri115', 'asharifu', 'wang67', 'sjia', 'snowmanam2', 'zhangpurdue', 'lzentner', None, 'chang71', 'cho72', 'sbogensc', 'kuos', 'cykim', 'mwalders', 'prabhu_m', 'pmarepal']",51,"['lsirui', 'jcanan', 'kalqubai', 'asmagulo', 'ryokubaka', 'baharman', 'ekhall', 'oghaisas', 'ahaberlein', 'wangyix', 'mattflash', 'dpbrocke', 'asharifu', 'ccange', 'snowmanam2', 'khaver', 'eekeen17', 'zhangpurdue', 'oadeniji', 'cho72', 'cykim', 'jkohnert', 'prabhu_m', 'malsoray', 'hungc', 'asenetar', 'macman314', 'alexwany', 'mmilosci', 'mzwach', 'jjyoun', 'ebinkerd', 'johns175', 'harri115', 'wang67', 'goel5', 'minduka', 'sjia', 'dfang7', 'apedroza', 'daedalus_v2', 'lzentner', 'chang71', None, 'sbogensc', 'kuos', 'kjhajari', 'mwalders', 'mille557', 'heckhoff', 'pmarepal']"
10,194,28,25,15,"['macman314', 'ahaberlein', 'mzwach', 'jcanan', 'ryokubaka', 'wangyix', 'apedroza', 'eekeen17', 'daedalus_v2', 'ebinkerd', 'mille557', 'heckhoff', 'ekhall', 'ccange', 'malsoray']",12,"['oadeniji', 'alexwany', 'dfang7', 'khaver', 'kalqubai', 'asenetar', 'asmagulo', 'jkohnert', 'kjhajari', 'dpbrocke', 'goel5', 'minduka']",10,"['mmilosci', 'oghaisas', 'fstamme', 'snowmanam2', 'chang71', 'cykim', 'jjyoun', 'asharifu', 'pmarepal', None]",37,"['jcanan', 'kalqubai', 'asenetar', 'asmagulo', 'ryokubaka', 'ekhall', 'macman314', 'alexwany', 'mmilosci', 'oghaisas', 'ahaberlein', 'mzwach', 'fstamme', 'wangyix', 'jjyoun', 'dpbrocke', 'ebinkerd', 'asharifu', 'ccange', 'goel5', 'minduka', 'snowmanam2', 'dfang7', 'khaver', 'apedroza', 'eekeen17', 'daedalus_v2', None, 'chang71', 'oadeniji', 'cykim', 'jkohnert', 'kjhajari', 'mille557', 'heckhoff', 'pmarepal', 'malsoray']"
10,189,28,18,11,"['oadeniji', 'ahaberlein', 'dfang7', 'khaver', 'jkohnert', 'apedroza', 'kjhajari', 'mille557', 'dpbrocke', 'ebinkerd', 'minduka']",16,"['macman314', 'alexwany', 'mzwach', 'jcanan', 'kalqubai', 'ryokubaka', 'asenetar', 'asmagulo', 'wangyix', 'eekeen17', 'daedalus_v2', 'heckhoff', 'ekhall', 'ccange', 'goel5', 'malsoray']",7,"['hungc', 'dpeffers', 'mmilosci', 'lsirui', 'kuos', 'kpetrucc', None]",34,"['hungc', 'lsirui', 'jcanan', 'kalqubai', 'asenetar', 'asmagulo', 'ryokubaka', 'ekhall', 'macman314', 'alexwany', 'dpeffers', 'mmilosci', 'ahaberlein', 'mzwach', 'wangyix', 'dpbrocke', 'ebinkerd', 'kpetrucc', 'ccange', 'goel5', 'minduka', 'dfang7', 'khaver', 'apedroza', 'eekeen17', 'daedalus_v2', None, 'oadeniji', 'kuos', 'jkohnert', 'kjhajari', 'mille557', 'heckhoff', 'malsoray']"
10,193,28,12,7,"['oadeniji', 'alexwany', 'apedroza', 'ryokubaka', 'wangyix', 'ebinkerd', 'ccange']",20,"['jcanan', 'kalqubai', 'asenetar', 'asmagulo', 'ekhall', 'macman314', 'ahaberlein', 'mzwach', 'dpbrocke', 'goel5', 'minduka', 'dfang7', 'khaver', 'eekeen17', 'daedalus_v2', 'jkohnert', 'kjhajari', 'mille557', 'heckhoff', 'malsoray']",5,"['snowmanam2', 'prabhu_m', 'jjyoun', 'asharifu', None]",32,"['jcanan', 'kalqubai', 'asenetar', 'asmagulo', 'ryokubaka', 'ekhall', 'macman314', 'alexwany', 'ahaberlein', 'mzwach', 'wangyix', 'jjyoun', 'dpbrocke', 'ebinkerd', 'asharifu', 'ccange', 'goel5', 'minduka', 'snowmanam2', 'dfang7', 'khaver', 'apedroza', 'eekeen17', 'daedalus_v2', None, 'oadeniji', 'jkohnert', 'kjhajari', 'prabhu_m', 'mille557', 'heckhoff', 'malsoray']"
10,191,28,10,2,"['alexwany', 'goel5']",25,"['jcanan', 'kalqubai', 'ryokubaka', 'asenetar', 'asmagulo', 'ekhall', 'macman314', 'ahaberlein', 'mzwach', 'wangyix', 'dpbrocke', 'ebinkerd', 'ccange', 'minduka', 'dfang7', 'khaver', 'apedroza', 'eekeen17', 'daedalus_v2', 'oadeniji', 'jkohnert', 'kjhajari', 'mille557', 'heckhoff', 'malsoray']",8,"['amelanic', 'mboudas', 'mmilosci', 'snowmanam2', 'jjyoun', 'johns175', 'asharifu', None]",35,"['amelanic', 'snowmanam2', 'dfang7', 'jcanan', 'kalqubai', 'asenetar', 'asmagulo', 'ryokubaka', 'khaver', 'apedroza', 'eekeen17', 'daedalus_v2', 'ekhall', None, 'oadeniji', 'macman314', 'alexwany', 'mboudas', 'mmilosci', 'ahaberlein', 'mzwach', 'jkohnert', 'kjhajari', 'wangyix', 'jjyoun', 'mille557', 'dpbrocke', 'ebinkerd', 'heckhoff', 'johns175', 'asharifu', 'ccange', 'goel5', 'minduka', 'malsoray']"
10,192,28,10,4,"['ccange', 'alexwany', 'goel5', 'heckhoff']",23,"['jcanan', 'kalqubai', 'ryokubaka', 'asenetar', 'asmagulo', 'ekhall', 'macman314', 'ahaberlein', 'mzwach', 'wangyix', 'dpbrocke', 'ebinkerd', 'minduka', 'dfang7', 'khaver', 'apedroza', 'eekeen17', 'daedalus_v2', 'oadeniji', 'jkohnert', 'kjhajari', 'mille557', 'malsoray']",6,"['kpetrucc', 'oghaisas', 'snowmanam2', 'gregm12', 'asharifu', None]",33,"['kpetrucc', 'snowmanam2', 'dfang7', 'jcanan', 'kalqubai', 'asenetar', 'asmagulo', 'ryokubaka', 'khaver', 'apedroza', 'eekeen17', 'daedalus_v2', 'ekhall', None, 'oadeniji', 'macman314', 'alexwany', 'oghaisas', 'ahaberlein', 'mzwach', 'gregm12', 'jkohnert', 'kjhajari', 'wangyix', 'mille557', 'dpbrocke', 'ebinkerd', 'heckhoff', 'asharifu', 'ccange', 'goel5', 'minduka', 'malsoray']"
10,195,28,7,6,"['jkohnert', 'apedroza', 'mille557', 'dpbrocke', 'ebinkerd', 'minduka']",21,"['jcanan', 'kalqubai', 'ryokubaka', 'asenetar', 'asmagulo', 'ekhall', 'macman314', 'alexwany', 'ahaberlein', 'mzwach', 'wangyix', 'ccange', 'goel5', 'dfang7', 'khaver', 'eekeen17', 'daedalus_v2', 'oadeniji', 'kjhajari', 'heckhoff', 'malsoray']",1,[None],28,"['dfang7', 'jcanan', 'kalqubai', 'asenetar', 'asmagulo', 'ryokubaka', 'khaver', 'apedroza', 'eekeen17', 'daedalus_v2', 'ekhall', None, 'oadeniji', 'macman314', 'alexwany', 'ahaberlein', 'mzwach', 'jkohnert', 'kjhajari', 'wangyix', 'mille557', 'dpbrocke', 'ebinkerd', 'heckhoff', 'ccange', 'goel5', 'minduka', 'malsoray']"
11,170,27,49,10,"['sharp1988', 'ham4406', 'ggap', 'tnalse', 'lonelymoon', 'oopsbaby', 'seokju88', 'kangsudat', 'hyunuk1987', 'krase988']",16,"['ykj4545', 'yjhhjy', 'spleeyh', 'whdlsgh00', 'hjh9016', 'subibler', 'knoghby', 'changjun0605', 'sam2858', 'feelingdp', 'kyg321678', 'yeoheeim', 'pgonha', 'dewrains', 'tran2010', 'selesua']",39,"['alsghand', 'hwang406', 'terodactyl', 'kyu461', 'soulesque', 'unsooman', 'ngan', 'usang2v', 'cbj1988', 'againwns007', 'john_88', 'lkylove23', 'kmann000', 'cwc9908', 'saram1823', 'hsa90', 'jeongyoon', 'cjt5528', 'donghwa', 'ayoprious', 'aindelf', 'imingan', 'hunbaksa', 'ssooji555', 'hongjae', 'micallis', 'kinkin88', 'sould628', None, 'jjongho85', 'lhgwin', 'kimhs324', 'lbmin1352', 'westkllr', 'bertpark', 'born0907', 'wheeiz', 'garam7749', 'jwshin01']",65,"['alsghand', 'ham4406', 'terodactyl', 'kyu461', 'usang2v', 'seokju88', 'kangsudat', 'knoghby', 'tnalse', 'saram1823', 'jeongyoon', 'pgonha', 'cjt5528', 'donghwa', 'ayoprious', 'hunbaksa', 'ssooji555', 'hongjae', 'feelingdp', 'kinkin88', 'sould628', 'jjongho85', 'krase988', 'spleeyh', 'kimhs324', 'lbmin1352', 'westkllr', 'wheeiz', 'garam7749', 'unsooman', 'hwang406', 'soulesque', 'ngan', 'kyg321678', 'cbj1988', 'selesua', 'againwns007', 'ykj4545', 'john_88', 'lkylove23', 'kmann000', 'whdlsgh00', 'hjh9016', 'subibler', 'cwc9908', 'changjun0605', 'sam2858', 'hsa90', 'yeoheeim', 'tran2010', 'yjhhjy', 'imingan', 'aindelf', 'micallis', None, 'dewrains', 'sharp1988', 'lhgwin', 'ggap', 'lonelymoon', 'oopsbaby', 'bertpark', 'born0907', 'hyunuk1987', 'jwshin01']"
11,56,27,14,9,"['yjhhjy', 'ham4406', 'hjh9016', 'subibler', 'lonelymoon', 'oopsbaby', 'feelingdp', 'sam2858', 'dewrains']",17,"['ykj4545', 'krase988', 'sharp1988', 'hyunuk1987', 'spleeyh', 'pgonha', 'whdlsgh00', 'knoghby', 'yeoheeim', 'tnalse', 'ggap', 'changjun0605', 'kyg321678', 'seokju88', 'kangsudat', 'tran2010', 'selesua']",5,"['leoseo321', 'terodactyl', 'kyu461', 'jysohn1108', None]",31,"['leoseo321', 'ham4406', 'terodactyl', 'kyu461', 'kyg321678', 'seokju88', 'kangsudat', 'selesua', 'ykj4545', 'jysohn1108', 'whdlsgh00', 'hjh9016', 'subibler', 'tnalse', 'knoghby', 'changjun0605', 'sam2858', 'yeoheeim', 'pgonha', 'tran2010', 'yjhhjy', 'feelingdp', None, 'dewrains', 'krase988', 'spleeyh', 'sharp1988', 'ggap', 'lonelymoon', 'oopsbaby', 'hyunuk1987']"
11,161,27,10,6,"['ykj4545', 'subibler', 'changjun0605', 'kyg321678', 'yeoheeim', 'tran2010']",20,"['ham4406', 'seokju88', 'kangsudat', 'selesua', 'whdlsgh00', 'hjh9016', 'knoghby', 'tnalse', 'sam2858', 'pgonha', 'yjhhjy', 'feelingdp', 'dewrains', 'krase988', 'spleeyh', 'sharp1988', 'ggap', 'lonelymoon', 'oopsbaby', 'hyunuk1987']",4,"[None, 'thefelix', 'sonjh91', 'mint91']",30,"['yjhhjy', 'ham4406', 'feelingdp', 'sonjh91', 'mint91', 'kyg321678', 'seokju88', 'kangsudat', 'thefelix', None, 'dewrains', 'selesua', 'krase988', 'spleeyh', 'ykj4545', 'hyunuk1987', 'sharp1988', 'whdlsgh00', 'hjh9016', 'subibler', 'tnalse', 'knoghby', 'ggap', 'lonelymoon', 'changjun0605', 'sam2858', 'oopsbaby', 'yeoheeim', 'pgonha', 'tran2010']"
11,186,27,10,8,"['yjhhjy', 'ham4406', 'hjh9016', 'subibler', 'feelingdp', 'sam2858', 'kyg321678', 'dewrains']",18,"['ykj4545', 'krase988', 'sharp1988', 'hyunuk1987', 'spleeyh', 'pgonha', 'whdlsgh00', 'knoghby', 'yeoheeim', 'tnalse', 'ggap', 'lonelymoon', 'changjun0605', 'oopsbaby', 'seokju88', 'kangsudat', 'tran2010', 'selesua']",2,"['terodactyl', None]",28,"['yjhhjy', 'ham4406', 'terodactyl', 'feelingdp', 'kyg321678', 'seokju88', 'kangsudat', None, 'dewrains', 'selesua', 'krase988', 'spleeyh', 'ykj4545', 'hyunuk1987', 'sharp1988', 'whdlsgh00', 'hjh9016', 'subibler', 'tnalse', 'knoghby', 'ggap', 'lonelymoon', 'changjun0605', 'sam2858', 'oopsbaby', 'yeoheeim', 'pgonha', 'tran2010']"
11,57,27,9,6,"['ykj4545', 'ggap', 'changjun0605', 'seokju88', 'tran2010', 'selesua']",20,"['ham4406', 'kyg321678', 'kangsudat', 'whdlsgh00', 'hjh9016', 'subibler', 'tnalse', 'knoghby', 'sam2858', 'yeoheeim', 'pgonha', 'yjhhjy', 'feelingdp', 'dewrains', 'spleeyh', 'krase988', 'sharp1988', 'lonelymoon', 'oopsbaby', 'hyunuk1987']",3,"[None, 'youngju', 'thefelix']",29,"['youngju', 'yjhhjy', 'ham4406', 'feelingdp', 'kyg321678', 'seokju88', 'kangsudat', 'thefelix', None, 'dewrains', 'selesua', 'krase988', 'spleeyh', 'ykj4545', 'hyunuk1987', 'sharp1988', 'whdlsgh00', 'hjh9016', 'subibler', 'tnalse', 'knoghby', 'ggap', 'lonelymoon', 'changjun0605', 'sam2858', 'oopsbaby', 'yeoheeim', 'pgonha', 'tran2010']"
11,162,27,9,7,"['yjhhjy', 'hjh9016', 'feelingdp', 'sam2858', 'kyg321678', 'dewrains', 'selesua']",19,"['ham4406', 'seokju88', 'kangsudat', 'ykj4545', 'whdlsgh00', 'subibler', 'knoghby', 'tnalse', 'changjun0605', 'yeoheeim', 'pgonha', 'tran2010', 'spleeyh', 'krase988', 'sharp1988', 'ggap', 'lonelymoon', 'oopsbaby', 'hyunuk1987']",2,"['jysohn1108', None]",28,"['yjhhjy', 'ham4406', 'feelingdp', 'kyg321678', 'seokju88', 'kangsudat', None, 'dewrains', 'selesua', 'krase988', 'spleeyh', 'ykj4545', 'hyunuk1987', 'sharp1988', 'jysohn1108', 'whdlsgh00', 'hjh9016', 'subibler', 'tnalse', 'knoghby', 'ggap', 'lonelymoon', 'changjun0605', 'sam2858', 'oopsbaby', 'yeoheeim', 'pgonha', 'tran2010']"
11,185,27,9,7,"['ykj4545', 'yeoheeim', 'changjun0605', 'kyg321678', 'seokju88', 'tran2010', 'selesua']",19,"['ham4406', 'kangsudat', 'whdlsgh00', 'hjh9016', 'subibler', 'tnalse', 'knoghby', 'sam2858', 'pgonha', 'yjhhjy', 'feelingdp', 'dewrains', 'spleeyh', 'krase988', 'sharp1988', 'ggap', 'lonelymoon', 'oopsbaby', 'hyunuk1987']",2,"[None, 'mint91']",28,"['yjhhjy', 'ham4406', 'feelingdp', 'mint91', 'kyg321678', 'seokju88', 'kangsudat', None, 'dewrains', 'selesua', 'krase988', 'spleeyh', 'ykj4545', 'hyunuk1987', 'sharp1988', 'whdlsgh00', 'hjh9016', 'subibler', 'tnalse', 'knoghby', 'ggap', 'lonelymoon', 'changjun0605', 'sam2858', 'oopsbaby', 'yeoheeim', 'pgonha', 'tran2010']"
11,55,27,8,5,"['knoghby', 'yeoheeim', 'changjun0605', 'seokju88', 'selesua']",21,"['ham4406', 'kyg321678', 'kangsudat', 'ykj4545', 'whdlsgh00', 'hjh9016', 'subibler', 'tnalse', 'sam2858', 'pgonha', 'tran2010', 'yjhhjy', 'feelingdp', 'dewrains', 'spleeyh', 'krase988', 'sharp1988', 'ggap', 'lonelymoon', 'oopsbaby', 'hyunuk1987']",3,"[None, 'thefelix', 'ksyu']",29,"['yjhhjy', 'ham4406', 'feelingdp', 'kyg321678', 'seokju88', 'kangsudat', 'thefelix', None, 'dewrains', 'selesua', 'krase988', 'spleeyh', 'ykj4545', 'hyunuk1987', 'sharp1988', 'whdlsgh00', 'hjh9016', 'subibler', 'tnalse', 'knoghby', 'ggap', 'lonelymoon', 'changjun0605', 'sam2858', 'oopsbaby', 'yeoheeim', 'pgonha', 'ksyu', 'tran2010']"
11,58,27,8,6,"['sharp1988', 'whdlsgh00', 'tnalse', 'lonelymoon', 'pgonha', 'spleeyh']",20,"['ham4406', 'kyg321678', 'seokju88', 'kangsudat', 'selesua', 'ykj4545', 'hjh9016', 'subibler', 'knoghby', 'changjun0605', 'sam2858', 'yeoheeim', 'tran2010', 'yjhhjy', 'feelingdp', 'dewrains', 'krase988', 'ggap', 'oopsbaby', 'hyunuk1987']",2,"['kindvoice', None]",28,"['yjhhjy', 'ham4406', 'feelingdp', 'kyg321678', 'seokju88', 'kangsudat', None, 'dewrains', 'selesua', 'krase988', 'spleeyh', 'ykj4545', 'hyunuk1987', 'sharp1988', 'whdlsgh00', 'hjh9016', 'subibler', 'tnalse', 'knoghby', 'ggap', 'lonelymoon', 'changjun0605', 'sam2858', 'oopsbaby', 'yeoheeim', 'kindvoice', 'pgonha', 'tran2010']"
11,184,27,8,6,"['sharp1988', 'kangsudat', 'whdlsgh00', 'tnalse', 'pgonha', 'spleeyh']",20,"['ham4406', 'kyg321678', 'seokju88', 'selesua', 'ykj4545', 'hjh9016', 'subibler', 'knoghby', 'changjun0605', 'sam2858', 'yeoheeim', 'tran2010', 'yjhhjy', 'feelingdp', 'dewrains', 'krase988', 'ggap', 'lonelymoon', 'oopsbaby', 'hyunuk1987']",2,"['scopild', None]",28,"['yjhhjy', 'ham4406', 'feelingdp', 'kyg321678', 'seokju88', 'scopild', 'kangsudat', None, 'dewrains', 'selesua', 'krase988', 'spleeyh', 'ykj4545', 'hyunuk1987', 'sharp1988', 'whdlsgh00', 'hjh9016', 'subibler', 'tnalse', 'knoghby', 'ggap', 'lonelymoon', 'changjun0605', 'sam2858', 'oopsbaby', 'yeoheeim', 'pgonha', 'tran2010']"
13,74,24,21,16,"['umutkar', 'gozdeozcan19', 'berkcan', 'berk_y', 'furkan', 'bozbey00', 'manilkocak', 'damla_dogan', 'ahcika', 'gokcheturan', 'tidin', 'curan', 'okancalikoglu', 'tanzi', 'umutaradag', 'burch']",7,"['dedes', 'seratr', 'cyagbasan', 'cemre', 'melismirza', 'agrbz', 'pinarakyol']",5,"['sukreth', 'caner_odabas', 'fatihbilge', 'frtotr', None]",28,"['sukreth', 'berkcan', 'curan', 'bozbey00', 'manilkocak', 'fatihbilge', 'tanzi', 'burch', 'dedes', 'gozdeozcan19', 'seratr', 'ahcika', 'cemre', 'okancalikoglu', 'frtotr', 'agrbz', 'furkan', 'berk_y', 'gokcheturan', 'cyagbasan', 'tidin', None, 'umutaradag', 'damla_dogan', 'caner_odabas', 'melismirza', 'umutkar', 'pinarakyol']"
13,75,24,6,4,"['cemre', 'gozdeozcan19', 'pinarakyol', 'ahcika']",19,"['berkcan', 'curan', 'bozbey00', 'manilkocak', 'tanzi', 'burch', 'dedes', 'seratr', 'okancalikoglu', 'agrbz', 'furkan', 'berk_y', 'gokcheturan', 'cyagbasan', 'tidin', 'umutaradag', 'damla_dogan', 'melismirza', 'umutkar']",2,"[None, 'kokellisekiz']",25,"['kokellisekiz', 'berkcan', 'furkan', 'berk_y', 'bozbey00', 'manilkocak', 'gokcheturan', 'cyagbasan', 'tidin', None, 'tanzi', 'burch', 'umutaradag', 'dedes', 'umutkar', 'gozdeozcan19', 'melismirza', 'seratr', 'damla_dogan', 'ahcika', 'cemre', 'curan', 'okancalikoglu', 'agrbz', 'pinarakyol']"
14,146,21,19,17,"['importjunjun', 'mrhanguoren', 'mrosca', 'timespan', 'ghstough', 'mattwalli', 'phy344', 'deadhunter22', 'araa', 'byrdmanranger', 'robynne', 'ecatig', 'gmlabriola', 'cwwaters', 'golferguy88', 'ewrueckert', 'fibnumb']",3,"['kaseyrussell', 'lazyong', 'mdlanoye']",2,"[None, 'arsmall']",22,"['mrhanguoren', 'arsmall', 'timespan', 'ghstough', 'kaseyrussell', 'golferguy88', 'ewrueckert', 'importjunjun', 'deadhunter22', 'araa', 'mdlanoye', 'lazyong', 'mrosca', 'phy344', 'byrdmanranger', 'robynne', 'cwwaters', None, 'mattwalli', 'ecatig', 'gmlabriola', 'fibnumb']"
16,2,20,32,15,"['pbyers', 'cxsmith', 'pagejl', 'safavih', 'mlroby', 'jhunsber', 'kjkang11', 'zhenghuili', 'jeresonshen', 'zchia', 'shicheng', 'dlopez', 'kmbaumga', 'slarew', 'adye20']",4,"['lu116', 'hpetersen', 'mbuckenm', 'pattnaik']",17,"['wjbennet88', 'agurram', 'hankh825', 'ssaeedas', 'lzentner', 'huang162', 'kakashow', None, 'ruzz311', 'bbommai', 'akiran', 'ashraf', 'myokem', 'jyeoh', 'jpurao', 'chang71', 'owensec']",36,"['agurram', 'kjkang11', 'jeresonshen', 'zchia', 'jyeoh', 'slarew', 'owensec', 'lu116', 'wjbennet88', 'mbuckenm', 'safavih', 'ruzz311', 'akiran', 'dlopez', 'kmbaumga', 'jpurao', 'hankh825', 'cxsmith', 'hpetersen', 'zhenghuili', 'ashraf', 'shicheng', 'lzentner', 'chang71', None, 'myokem', 'pbyers', 'ssaeedas', 'pagejl', 'mlroby', 'jhunsber', 'kakashow', 'huang162', 'bbommai', 'pattnaik', 'adye20']"
16,3,20,28,7,"['pbyers', 'lu116', 'cxsmith', 'safavih', 'jhunsber', 'zhenghuili', 'dlopez']",12,"['mbuckenm', 'pagejl', 'mlroby', 'hpetersen', 'kjkang11', 'pattnaik', 'jeresonshen', 'zchia', 'shicheng', 'adye20', 'kmbaumga', 'slarew']",21,"['agurram', 'gu0', 'ziyunlong', 'bcurrie', 'avalluru', 'owensec', 'chut', 'ruzz311', 'ashir23bom', 'ishsman', 'hankh825', 'msalmani', 'rataniitm', 'jain28', 'svanderl', 'lzentner', None, 'inkatech', 'myokem', 'huang162', 'kim660']",40,"['agurram', 'kjkang11', 'jeresonshen', 'zchia', 'ziyunlong', 'gu0', 'bcurrie', 'slarew', 'avalluru', 'owensec', 'lu116', 'chut', 'mbuckenm', 'safavih', 'ruzz311', 'dlopez', 'kmbaumga', 'ashir23bom', 'ishsman', 'hankh825', 'cxsmith', 'msalmani', 'rataniitm', 'hpetersen', 'jain28', 'zhenghuili', 'shicheng', 'svanderl', 'lzentner', None, 'inkatech', 'myokem', 'pbyers', 'pagejl', 'mlroby', 'jhunsber', 'huang162', 'pattnaik', 'kim660', 'adye20']"
16,152,20,19,15,"['pbyers', 'lu116', 'cxsmith', 'pagejl', 'safavih', 'mlroby', 'jhunsber', 'hpetersen', 'kjkang11', 'zhenghuili', 'jeresonshen', 'zchia', 'dlopez', 'kmbaumga', 'adye20']",4,"['slarew', 'mbuckenm', 'shicheng', 'pattnaik']",4,"[None, 'dandry', 'roconnel', 'vsavikhi']",23,"['dandry', 'kjkang11', 'jeresonshen', 'zchia', 'slarew', 'lu116', 'mbuckenm', 'safavih', 'dlopez', 'kmbaumga', 'cxsmith', 'hpetersen', 'zhenghuili', 'roconnel', 'shicheng', None, 'vsavikhi', 'pbyers', 'pagejl', 'mlroby', 'jhunsber', 'pattnaik', 'adye20']"
17,188,20,11,9,"['wang241', 'jwkuntzm', 'merdbrue', 'prosenbe', 'yao14', 'jomeara', 'ogottlie', 'yuanbo139', 'fandi514']",10,"['aelman', 'frog020531', 'pg1646', 'dehrman', 'cromanof', 'darichar', 'zackee12', 'dernst87', 'smite77', 'mjveld']",2,"['mboudas', None]",21,"['wang241', 'jwkuntzm', 'dehrman', 'cromanof', 'prosenbe', 'yao14', 'darichar', 'dernst87', 'jomeara', 'smite77', None, 'mjveld', 'mboudas', 'aelman', 'frog020531', 'pg1646', 'merdbrue', 'zackee12', 'ogottlie', 'yuanbo139', 'fandi514']"
17,187,20,9,7,"['wang241', 'dehrman', 'merdbrue', 'prosenbe', 'yuanbo139', 'smite77', 'fandi514']",12,"['jwkuntzm', 'aelman', 'frog020531', 'pg1646', 'cromanof', 'yao14', 'zackee12', 'darichar', 'dernst87', 'jomeara', 'ogottlie', 'mjveld']",2,"['lundstro', None]",21,"['wang241', 'jwkuntzm', 'dehrman', 'cromanof', 'prosenbe', 'yao14', 'darichar', 'dernst87', 'jomeara', 'smite77', None, 'mjveld', 'aelman', 'frog020531', 'lundstro', 'pg1646', 'merdbrue', 'zackee12', 'ogottlie', 'yuanbo139', 'fandi514']"
18,84,20,17,14,"['hemacpm', 'kunupark', 'xmou', 'eekhkim', 'kayoung', 'yevoc', 'smitasa87', 'physlab', 'nhd2357', 'sonic113', 'alchemist127', 'heracles0613', 'urmimala', 'mrchoi']",5,"['danielodili', 'noelprashant', 'faihou', 'khalilha', 'bdmangum']",3,"['chaochen88', None, 'mrlonghorn']",22,"['kunupark', 'eekhkim', 'xmou', 'kayoung', 'noelprashant', 'yevoc', 'mrlonghorn', 'physlab', 'sonic113', 'heracles0613', 'alchemist127', None, 'bdmangum', 'urmimala', 'hemacpm', 'danielodili', 'smitasa87', 'faihou', 'nhd2357', 'chaochen88', 'khalilha', 'mrchoi']"
19,164,19,13,12,"['tdill88', 'xwang74', 'tapan89', 'dwrosenow', 'mlebrun2', 'jeongbw', 'nitishsanghi', 'tkmaxwell', 'ungnapa1', 'garvin2', 'nicfang', 'atevans2']",6,"['jonathanscholl', 'emergence', 'adlevin', 'yangwang0327', 'lseraval', 'mrosenb5']",1,[None],19,"['jonathanscholl', 'tdill88', 'mlebrun2', 'dwrosenow', 'emergence', 'garvin2', 'lseraval', 'yangwang0327', 'mrosenb5', None, 'tapan89', 'xwang74', 'jeongbw', 'nitishsanghi', 'tkmaxwell', 'ungnapa1', 'adlevin', 'nicfang', 'atevans2']"
20,52,19,9,1,['mikeguericke'],17,"['alexsch', 'hachuly', 'fmartine', 'desensitizer', 'christianwiese', 'kelvinkwan88', 'johnnynt', 'tate', 'jecho419', 'miano', 'thaiomega', 'soree', 'hjh48', 'anasbsoul', 'marlenegut', 'andypf', 'limitedo']",8,"['luyy1987', 'jcpoler', 'lifeofmg', 'janderson64', 'bhbesb', 'spatil9', None, 'mguerick']",26,"['alexsch', 'hachuly', 'fmartine', 'desensitizer', 'kelvinkwan88', 'johnnynt', 'tate', 'jecho419', 'miano', 'mikeguericke', 'soree', 'hjh48', 'thaiomega', 'bhbesb', 'spatil9', None, 'mguerick', 'luyy1987', 'jcpoler', 'christianwiese', 'anasbsoul', 'lifeofmg', 'andypf', 'janderson64', 'marlenegut', 'limitedo']"
21,56,19,14,1,['leoseo321'],17,"['youngju', 'renata22', 'chbskraju', 'guyolivier', 'dsevans', 'pettand', 'scienceproject', 'satsuke', 'agcattaneo', 'mrcananbalun', 'ejdawley', 'muddin2', 'rmendey', 'jmalvarezy4', 'dark9light', 'llasion', 'stklink']",13,"['yjhhjy', 'ham4406', 'terodactyl', 'kyu461', 'jysohn1108', 'hjh9016', 'subibler', 'lonelymoon', 'oopsbaby', 'feelingdp', 'sam2858', None, 'dewrains']",31,"['leoseo321', 'youngju', 'yjhhjy', 'ham4406', 'terodactyl', 'guyolivier', 'dsevans', 'kyu461', 'agcattaneo', 'ejdawley', 'muddin2', 'feelingdp', 'jmalvarezy4', 'stklink', 'scienceproject', None, 'dewrains', 'renata22', 'chbskraju', 'jysohn1108', 'pettand', 'hjh9016', 'subibler', 'satsuke', 'mrcananbalun', 'lonelymoon', 'oopsbaby', 'rmendey', 'sam2858', 'dark9light', 'llasion']"
21,54,19,13,1,['rmendey'],17,"['leoseo321', 'renata22', 'youngju', 'chbskraju', 'guyolivier', 'dsevans', 'pettand', 'scienceproject', 'satsuke', 'agcattaneo', 'mrcananbalun', 'ejdawley', 'muddin2', 'jmalvarezy4', 'dark9light', 'llasion', 'stklink']",12,"['nlespinoza2', 'hhuq', 'etorresz12', 'faespinoza', 'scmullapudi', 'pchivukula', 'deepu424', 'eriosc2', 'navee3', 'jhescobar', None, 'nepuente']",30,"['leoseo321', 'youngju', 'hhuq', 'guyolivier', 'dsevans', 'pchivukula', 'agcattaneo', 'deepu424', 'ejdawley', 'eriosc2', 'muddin2', 'jmalvarezy4', 'navee3', 'jhescobar', 'stklink', 'scienceproject', None, 'nlespinoza2', 'renata22', 'chbskraju', 'etorresz12', 'pettand', 'faespinoza', 'satsuke', 'mrcananbalun', 'scmullapudi', 'rmendey', 'dark9light', 'llasion', 'nepuente']"
21,57,19,9,1,['youngju'],17,"['leoseo321', 'renata22', 'chbskraju', 'guyolivier', 'dsevans', 'pettand', 'scienceproject', 'satsuke', 'agcattaneo', 'mrcananbalun', 'ejdawley', 'muddin2', 'rmendey', 'jmalvarezy4', 'dark9light', 'llasion', 'stklink']",8,"['ykj4545', 'ggap', None, 'changjun0605', 'seokju88', 'thefelix', 'tran2010', 'selesua']",26,"['leoseo321', 'youngju', 'guyolivier', 'dsevans', 'agcattaneo', 'ejdawley', 'muddin2', 'jmalvarezy4', 'seokju88', 'stklink', 'scienceproject', 'thefelix', None, 'selesua', 'ykj4545', 'renata22', 'chbskraju', 'ggap', 'pettand', 'satsuke', 'mrcananbalun', 'changjun0605', 'rmendey', 'dark9light', 'llasion', 'tran2010']"
22,130,18,28,17,"['csprick', 'mollyhermiller', 'gduprat', 'dalcorn', 'jondrey', 'rlarrison', 'mma517', 'sgoeppinger', 'pso824', 'jch399', 'glenej3', 'melissalincoln', 'ashapiro', 'cengelke', 'wsutton', 'jbrownell', 'ajohnson']",0,[],11,"['annedisabato', 'edonnelly', 'alexshap1', 'msh114', 'sanaebryson1', 'rrussell', 'camora', 'jgodlewska', 'jgobrial', None, 'sbhogal']",28,"['csprick', 'mollyhermiller', 'jondrey', 'mma517', 'cengelke', 'jgobrial', 'wsutton', 'rlarrison', 'sbhogal', 'jch399', 'melissalincoln', 'edonnelly', 'alexshap1', 'sanaebryson1', 'pso824', 'glenej3', 'camora', 'jgodlewska', None, 'jbrownell', 'annedisabato', 'gduprat', 'msh114', 'dalcorn', 'rrussell', 'sgoeppinger', 'ashapiro', 'ajohnson']"
22,46,18,19,17,"['csprick', 'mollyhermiller', 'gduprat', 'dalcorn', 'jondrey', 'rlarrison', 'mma517', 'sgoeppinger', 'pso824', 'jch399', 'glenej3', 'melissalincoln', 'ashapiro', 'cengelke', 'wsutton', 'jbrownell', 'ajohnson']",0,[],2,"[None, 'camora']",19,"['csprick', 'mollyhermiller', 'jondrey', 'mma517', 'pso824', 'glenej3', 'camora', 'cengelke', 'wsutton', 'rlarrison', None, 'jbrownell', 'gduprat', 'dalcorn', 'sgoeppinger', 'jch399', 'melissalincoln', 'ashapiro', 'ajohnson']"
23,163,17,259,16,"['ndesai', 'stn147', 'nrouzier', 'jbryman', 'irc506', 'kgo', 'rgd606', 'eza135', 'ani197', 'crowland', 'ahristakos', 'joeg', 'bmaldonado', 'ejen', 'aychang', 'veskit2k']",0,[],243,"['sdesai', 'jchang', 'jsyu', 'eausenbaugh', 'jcastro', 'mcr728', 'scs771', 'ehorcher', 'bbak', 'mtk160', 'alexholterman', 'jaimiepark', 'daniellefong92', 'nlahner', 'cquinn17', 'psharma', 'tpark', 'dcheah', 'sjeon', 'jfranke', 'ahb978', 'prishah', 'eys582', 'bgibbons', 'elleanzhang', 'asutton', 'khuynh', 'hfleming', 'tjc797', 'ekwak', 'kds543', 'mcp349', 'jcd265', 'jmueller', 'narouzier', 'ezaruba', 'jzhong', 'pgarg', 'nigelng91', 'npyle', 'choiboi68', 'rterada', 'jaj343', 'acortes', 'chrispitler', 'galexander', 'dangerousdan', 'jcordes', 'esmith', 'glee530', 'schoi3', 'sre306', 'kjl432', 'ekaht', 'lrg923', 'exw190', 'khjoon0502', 'lav127', 'clee2014', 'jaguilar', 'chiggins', 'mattsullivan725', 'nxiao', 'dvenkat', 'tln941', 'jsandler', 'ahiggins', 'gbudzon', 'mso', 'dsh278', 'bashwell', 'williamgross2014', 'alo869', 'rkawashima', 'rdesai', 'kelly382', 'zrachlin', 'mankenman', 'smoon', 'dschuleman', 'ewp790', 'jpark17', 'lauren20', 'krc863', 'khkim', 'jeshicaa', 'ldk310', 'missalice', 'jkernes', 'ceb570', 'jmontyiii', 'asong', 'kirstynbesch', 'ychung', 'jjozefiak', 'mdm833', 'dmorrison7778', 'aws491', 'amurray', 'sbagnola', 'jxamplas', 'jjain1', 'mchoi', 'dylanhirshkowitz', 'dkoo', 'iikene', 'camora', 'ryandeblock', 'apankaj', 'gracechan715', 'mgomaa', 'swang', 'jjs439', 'vgupta2792', 'vprakash', 'aweinstein', 'sitknee', 'abc138', 'mkeith', 'car942', 'mbzeitz', 'lmehmeti', 'swilliams', 'pjang', 'nmiller', 'sashpatel81', 'slipov', 'suttal', 'kbrohkahn', 'kgeraghty', 'mlb923', 'stvrdik', 'blach', 'huwang', 'nisadesai', 'purpleyuan', 'cchang92', 'cleclerq', 'charleslin', 'ykhwang', 'afreedman', 'britt518', 'mfmorel', 'astaples', 'pknapp', 'ppatel7499', 'mshetty', 'lhsu', 'szaveri', 'skim2010', 'nsteimel', 'danielnfls', 'guerrero1', 'angcal3', 'yzermeno', 'hzhou', 'chahn', 'yuanshi', 'aweatherly1', 'ktaskin', 'kah703', 'prl176', 'bcastle', 'paarasmodi', 'shetzler', 'clockwork', 'lzhou', 'jyw902', 'kki227', 'htennant', 'brandonalba', 'brianraychen', 'eklosowiak', 'skadakia', 'asimon', 'lmaliakal', 'hreilly', 'sda387', 'michaelmilazzo', 'lizzo427', 'nrichter', 'jsachg', 'balegbeleye', 'cfuentes60618', 'nna341', 'dslaughter', 'agh612', 'aaggarwal', 'ntorosin', 'lontiveros', 'rem455', 'aawwad', 'jhalpern', 'jhi551', 'snandamuri', 'chintanaphol', 'xwen', 'peter8737', 'tyu1992', 'nreimold', 'amelingercohen', 'sjiao', 'jalam', 'yfa874', 'cyu13', 'cqin', 'mjskwarczek1', 'rku147', 'tkukushliev', 'hae201', 'pwzorek', 'msc494', 'mtyksinski', 'ryanmcafee', 'acook', 'sagarwal1', 'sandeepjain', 'patman16', 'mcorpuz', 'reb712', 'pka421', 'akansha21', 'hab477', 'sreinke', 'ajw873', 'tyuan', 'msmith', 'mtu', 'recook', 'ejizba', 'emilyf131', 'lucialee', 'rquan', 'eukoha', 'pkaralis', 'sshakin', 'tjeppson', 'awl111', 'hmu909', 'akozminski', 'joannajaros', 'amfrank26', 'bmerkle']",259,"['sdesai', 'jchang', 'jsyu', 'eausenbaugh', 'jcastro', 'mcr728', 'scs771', 'ehorcher', 'bbak', 'mtk160', 'alexholterman', 'jaimiepark', 'daniellefong92', 'nlahner', 'cquinn17', 'psharma', 'tpark', 'dcheah', 'sjeon', 'jfranke', 'irc506', 'ahb978', 'prishah', 'eys582', 'bgibbons', 'elleanzhang', 'asutton', 'khuynh', 'hfleming', 'tjc797', 'ekwak', 'kds543', 'mcp349', 'ndesai', 'jcd265', 'jmueller', 'narouzier', 'ezaruba', 'ahristakos', 'jzhong', 'pgarg', 'nigelng91', 'npyle', 'choiboi68', 'rterada', 'jaj343', 'acortes', 'chrispitler', 'galexander', 'dangerousdan', 'jcordes', 'esmith', 'glee530', 'schoi3', 'sre306', 'kjl432', 'ekaht', 'lrg923', 'exw190', 'khjoon0502', 'lav127', 'clee2014', 'kgo', 'jaguilar', 'chiggins', 'mattsullivan725', 'nxiao', 'dvenkat', 'tln941', 'jsandler', 'ahiggins', 'gbudzon', 'mso', 'dsh278', 'bashwell', 'williamgross2014', 'alo869', 'rkawashima', 'rdesai', 'kelly382', 'zrachlin', 'mankenman', 'smoon', 'dschuleman', 'ewp790', 'jpark17', 'lauren20', 'krc863', 'khkim', 'jeshicaa', 'ldk310', 'missalice', 'jkernes', 'ceb570', 'jmontyiii', 'asong', 'kirstynbesch', 'stn147', 'ychung', 'jjozefiak', 'mdm833', 'dmorrison7778', 'aws491', 'ejen', 'amurray', 'sbagnola', 'jxamplas', 'jjain1', 'mchoi', 'dylanhirshkowitz', 'dkoo', 'iikene', 'camora', 'ryandeblock', 'joeg', 'apankaj', 'gracechan715', 'mgomaa', 'swang', 'jjs439', 'vgupta2792', 'vprakash', 'aweinstein', 'sitknee', 'abc138', 'mkeith', 'car942', 'mbzeitz', 'lmehmeti', 'swilliams', 'pjang', 'nmiller', 'sashpatel81', 'nrouzier', 'eza135', 'slipov', 'suttal', 'kbrohkahn', 'kgeraghty', 'mlb923', 'stvrdik', 'jbryman', 'blach', 'huwang', 'nisadesai', 'purpleyuan', 'cchang92', 'cleclerq', 'charleslin', 'ykhwang', 'afreedman', 'britt518', 'mfmorel', 'astaples', 'pknapp', 'ppatel7499', 'mshetty', 'lhsu', 'szaveri', 'skim2010', 'nsteimel', 'danielnfls', 'guerrero1', 'angcal3', 'yzermeno', 'hzhou', 'chahn', 'yuanshi', 'aweatherly1', 'ktaskin', 'kah703', 'prl176', 'bcastle', 'paarasmodi', 'shetzler', 'clockwork', 'lzhou', 'jyw902', 'kki227', 'htennant', 'brandonalba', 'brianraychen', 'eklosowiak', 'skadakia', 'asimon', 'lmaliakal', 'hreilly', 'sda387', 'veskit2k', 'michaelmilazzo', 'lizzo427', 'nrichter', 'jsachg', 'balegbeleye', 'cfuentes60618', 'nna341', 'dslaughter', 'bmaldonado', 'agh612', 'aaggarwal', 'crowland', 'ntorosin', 'lontiveros', 'rem455', 'aawwad', 'jhalpern', 'jhi551', 'snandamuri', 'chintanaphol', 'xwen', 'peter8737', 'tyu1992', 'nreimold', 'amelingercohen', 'sjiao', 'jalam', 'yfa874', 'aychang', 'cyu13', 'cqin', 'mjskwarczek1', 'rku147', 'tkukushliev', 'hae201', 'pwzorek', 'msc494', 'mtyksinski', 'ryanmcafee', 'acook', 'sagarwal1', 'sandeepjain', 'patman16', 'mcorpuz', 'reb712', 'pka421', 'akansha21', 'hab477', 'sreinke', 'ajw873', 'tyuan', 'msmith', 'mtu', 'ani197', 'recook', 'ejizba', 'emilyf131', 'lucialee', 'rquan', 'eukoha', 'pkaralis', 'sshakin', 'tjeppson', 'awl111', 'rgd606', 'hmu909', 'akozminski', 'joannajaros', 'amfrank26', 'bmerkle']"
24,76,16,123,10,"['ericcj21', 'mkhanna', 'gravityplanx', 'ztrata2', 'hnandagopal', 'acorral2', 'sehrawa1', 'gomez14', 'artonis7', 'jlee4689']",5,"['mcarney2', 'joliu2', 'ryanmancl', 'kknapp', 'brauliodantas']",113,"['kartiksanghi', 'meliu2', 'jchyan2', 'chongvi1', 'hipaulshi', 'dhandle2', 'malhotr3', 'wu10', 'jeredgre', 'fliu96', 'crazedcatatonic5', 'ligao1', 'lebedow1', 'midnightblade', 'ageorges', 'ddeutsc2', 'marshal2', 'bracon', 'asrinat2', 'kang92', 'maemble', 'arappep2', 'bikrambhatia', 'fangwan2', 'abstrkt', 'xihan1', 'chen282', 'tchurch2', 'ramaith1', 'hochan5', 'tkim31', 'tarvitz', 'kim857', 'jiyichenqi', 'collapse', 'roylee3', 'supercowking', 'rohansingh28', 'luisccruz', 'dradefx', 'pessin', 'dbero2', 'jfelts', 'kumar28', 'wmjdgla', 'boegy3', 'daguri87', 'sparklingway', 'ryanskim', 'efilli2', 'black_chip21', 'ymoon4', 'shin44', 'tongcheng', 'kejriwa1', 'chrisjryu', 'faorlando', 'deedarhuq', 'ragunat1', 'lee489', 'this1', 'kdearnl2', 'likpok', 'chengxu1', 'bparajul', 'ng21', 'luyun198993', 'boruichen', 'alikation', 'megarza2', 'yuqiao1', 'dusty493', 'atseng3', 'rosboro1', 'charishma', 'banker2', 'diablopbc', 'kim417', 'd98521', 'bongen2', 'willtk0113', 'leiyang1', 'berndbhuber', 'gmonroy2', 'jack_ftw', 'se210', 'weller1', 'dawei1', 'dlgudwns11', 'tao7', 'schrock3', 'cjohns78', 'pandey3', None, 'cjhughes17', 'ma3xiao1', 'l37', 'zhu22', 'chijiazuo', 'aggarwa3', 'rlew2', 'dbarnes2', 'snowpd', 'joo4ny', 'choquett', 'idesis1', 'tkim28', 'agarwa19', 'weichunan', 'nivero', 'aditchhabra', 'boogajamooga', 'wldavis']",128,"['ericcj21', 'kartiksanghi', 'meliu2', 'jchyan2', 'hipaulshi', 'malhotr3', 'fliu96', 'crazedcatatonic5', 'midnightblade', 'ddeutsc2', 'marshal2', 'bracon', 'asrinat2', 'kang92', 'arappep2', 'fangwan2', 'abstrkt', 'xihan1', 'kim857', 'roylee3', 'supercowking', 'rohansingh28', 'luisccruz', 'pessin', 'daguri87', 'sparklingway', 'ryanskim', 'tongcheng', 'chrisjryu', 'deedarhuq', 'jlee4689', 'kdearnl2', 'kknapp', 'alikation', 'yuqiao1', 'atseng3', 'banker2', 'willtk0113', 'leiyang1', 'gmonroy2', 'jack_ftw', 'weller1', 'joliu2', 'gomez14', 'cjohns78', 'pandey3', 'ma3xiao1', 'l37', 'chijiazuo', 'aggarwa3', 'rlew2', 'dbarnes2', 'snowpd', 'joo4ny', 'sehrawa1', 'choquett', 'idesis1', 'tkim28', 'agarwa19', 'weichunan', 'nivero', 'boogajamooga', 'wldavis', 'mcarney2', 'ryanmancl', 'chongvi1', 'dhandle2', 'wu10', 'jeredgre', 'ligao1', 'lebedow1', 'ageorges', 'maemble', 'bikrambhatia', 'chen282', 'tchurch2', 'ramaith1', 'mkhanna', 'hochan5', 'tkim31', 'tarvitz', 'ztrata2', 'jiyichenqi', 'collapse', 'brauliodantas', 'dradefx', 'dbero2', 'jfelts', 'kumar28', 'wmjdgla', 'boegy3', 'efilli2', 'gravityplanx', 'black_chip21', 'ymoon4', 'kejriwa1', 'faorlando', 'ragunat1', 'lee489', 'this1', 'likpok', 'chengxu1', 'bparajul', 'ng21', 'luyun198993', 'boruichen', 'megarza2', 'dusty493', 'rosboro1', 'diablopbc', 'kim417', 'd98521', 'bongen2', 'berndbhuber', 'se210', 'dawei1', 'dlgudwns11', 'tao7', 'schrock3', 'hnandagopal', 'acorral2', 'artonis7', None, 'cjhughes17', 'aditchhabra', 'shin44', 'charishma', 'zhu22']"
24,77,16,17,1,['kknapp'],14,"['ericcj21', 'mkhanna', 'mcarney2', 'joliu2', 'gravityplanx', 'ryanmancl', 'ztrata2', 'hnandagopal', 'acorral2', 'sehrawa1', 'gomez14', 'artonis7', 'brauliodantas', 'jlee4689']",16,"['kartiksanghi', 'likpok', 'pitrak1', 'arappep2', 'efilli2', None, 'madikaz', 'cjohns78', 'drmalkovich', 'snowpd', 'tongcheng', 'caldero1', 'namanmehta', 'seanlee14', 'kdko2', 'gbergsc2']",31,"['ericcj21', 'kartiksanghi', 'likpok', 'mcarney2', 'pitrak1', 'ryanmancl', 'kknapp', 'caldero1', 'arappep2', 'namanmehta', 'seanlee14', 'kdko2', 'mkhanna', 'joliu2', 'ztrata2', 'madikaz', 'drmalkovich', 'hnandagopal', 'acorral2', 'gomez14', 'artonis7', 'cjohns78', 'brauliodantas', None, 'efilli2', 'gravityplanx', 'snowpd', 'sehrawa1', 'tongcheng', 'gbergsc2', 'jlee4689']"
24,78,16,15,1,['gravityplanx'],14,"['ericcj21', 'mkhanna', 'mcarney2', 'joliu2', 'ryanmancl', 'ztrata2', 'kknapp', 'hnandagopal', 'acorral2', 'sehrawa1', 'gomez14', 'artonis7', 'brauliodantas', 'jlee4689']",14,"['weller1', 'ani3989', 'gavin_campbell', 'hur6', 'wisechengyi', 'black_chip21', 'xihan1', 'lindqui1', 'kejriwa1', 'gmonroy2', 'williamhn', None, 'gu1', 'mahoney6']",29,"['weller1', 'ericcj21', 'ani3989', 'mkhanna', 'mcarney2', 'joliu2', 'ryanmancl', 'ztrata2', 'kknapp', 'hnandagopal', 'acorral2', 'lindqui1', 'gomez14', 'artonis7', 'brauliodantas', None, 'gu1', 'mahoney6', 'gavin_campbell', 'hur6', 'wisechengyi', 'gravityplanx', 'black_chip21', 'xihan1', 'sehrawa1', 'kejriwa1', 'gmonroy2', 'williamhn', 'jlee4689']"
24,79,16,12,1,['mcarney2'],14,"['ericcj21', 'mkhanna', 'joliu2', 'gravityplanx', 'ryanmancl', 'ztrata2', 'kknapp', 'hnandagopal', 'acorral2', 'sehrawa1', 'gomez14', 'artonis7', 'brauliodantas', 'jlee4689']",11,"['hbeberma', 'cjhughes17', 'boegy3', 'ttli2', 'jchyan2', 'tarvitz', 'hwnano', 'jeredgre', 'idesis1', 'tkim28', None]",26,"['ericcj21', 'mkhanna', 'ttli2', 'mcarney2', 'joliu2', 'jchyan2', 'tarvitz', 'ryanmancl', 'hwnano', 'ztrata2', 'kknapp', 'hnandagopal', 'acorral2', 'jeredgre', 'gomez14', 'artonis7', 'brauliodantas', None, 'hbeberma', 'cjhughes17', 'boegy3', 'gravityplanx', 'sehrawa1', 'idesis1', 'tkim28', 'jlee4689']"
24,80,16,10,3,"['joliu2', 'ryanmancl', 'mkhanna']",12,"['ericcj21', 'mcarney2', 'gravityplanx', 'ztrata2', 'kknapp', 'hnandagopal', 'acorral2', 'sehrawa1', 'gomez14', 'artonis7', 'brauliodantas', 'jlee4689']",7,"['balistic2', 'asrinat2', None, 'rlew2', 'willtk0113', 'nanohub99', 'novitalmotive']",22,"['ericcj21', 'mkhanna', 'mcarney2', 'joliu2', 'ryanmancl', 'ztrata2', 'kknapp', 'hnandagopal', 'acorral2', 'gomez14', 'artonis7', 'brauliodantas', None, 'balistic2', 'asrinat2', 'gravityplanx', 'rlew2', 'willtk0113', 'sehrawa1', 'nanohub99', 'novitalmotive', 'jlee4689']"
25,14,16,16,12,"['rcrisp', 'quantumisme', 'heisenberg', 'a_ebn', 'einstruments', 'rohanchaukulkar', 'aallende', 'cavewyrm', 'lpatters', 'bgallowa', 'emieritz', 'durangotang']",3,"['marcuslay', 'dabernalm', 'ug_user']",4,"[None, 'sjmoore987', 'neddy', 'tohno']",19,"['rcrisp', 'quantumisme', 'a_ebn', 'heisenberg', 'dabernalm', 'marcuslay', 'tohno', 'rohanchaukulkar', 'aallende', 'cavewyrm', 'neddy', 'lpatters', 'bgallowa', None, 'ug_user', 'sjmoore987', 'einstruments', 'emieritz', 'durangotang']"
25,17,16,14,12,"['rcrisp', 'quantumisme', 'heisenberg', 'a_ebn', 'einstruments', 'aallende', 'rohanchaukulkar', 'cavewyrm', 'lpatters', 'bgallowa', 'emieritz', 'durangotang']",3,"['marcuslay', 'dabernalm', 'ug_user']",2,"['sjmoore987', None]",17,"['rcrisp', 'quantumisme', 'a_ebn', 'heisenberg', 'dabernalm', 'marcuslay', 'rohanchaukulkar', 'aallende', 'cavewyrm', 'lpatters', 'bgallowa', None, 'ug_user', 'sjmoore987', 'einstruments', 'emieritz', 'durangotang']"
25,16,16,8,1,['dabernalm'],14,"['rcrisp', 'ug_user', 'quantumisme', 'heisenberg', 'a_ebn', 'einstruments', 'marcuslay', 'rohanchaukulkar', 'aallende', 'cavewyrm', 'lpatters', 'bgallowa', 'emieritz', 'durangotang']",7,"['carlosparra', 'dagutierrezp', 'forerca', 'jaacevedo', 'caquinones', 'jecortesc', None]",22,"['rcrisp', 'carlosparra', 'quantumisme', 'forerca', 'a_ebn', 'heisenberg', 'dabernalm', 'marcuslay', 'rohanchaukulkar', 'aallende', 'cavewyrm', 'caquinones', 'jecortesc', 'lpatters', 'bgallowa', None, 'ug_user', 'dagutierrezp', 'einstruments', 'jaacevedo', 'emieritz', 'durangotang']"
25,9,16,6,1,['dabernalm'],14,"['rcrisp', 'ug_user', 'quantumisme', 'heisenberg', 'a_ebn', 'einstruments', 'marcuslay', 'rohanchaukulkar', 'aallende', 'cavewyrm', 'lpatters', 'bgallowa', 'emieritz', 'durangotang']",5,"['forerca', 'moisoro', 'caquinones', 'clau_perez', None]",20,"['rcrisp', 'quantumisme', 'forerca', 'a_ebn', 'heisenberg', 'dabernalm', 'marcuslay', 'rohanchaukulkar', 'aallende', 'cavewyrm', 'caquinones', 'lpatters', 'bgallowa', None, 'ug_user', 'moisoro', 'einstruments', 'clau_perez', 'emieritz', 'durangotang']"
26,134,15,13,10,"['patelsu5', 'polonila', 'wernerchao', 'yingying2122', 'hutengch', 'cheneric0206', 'chengke9', 'kevin955217', 'elnaazz', 'peterchien911']",4,"['dreon', 'fwx', 'nzb109', 'nilou123']",3,"['kulong', 'miklasja', None]",17,"['miklasja', 'fwx', 'wernerchao', 'hutengch', 'polonila', 'kevin955217', None, 'patelsu5', 'elnaazz', 'nzb109', 'peterchien911', 'kulong', 'dreon', 'nilou123', 'yingying2122', 'cheneric0206', 'chengke9']"
26,133,15,8,5,"['fwx', 'wernerchao', 'polonila', 'kevin955217', 'peterchien911']",9,"['patelsu5', 'nzb109', 'nilou123', 'dreon', 'yingying2122', 'hutengch', 'cheneric0206', 'chengke9', 'elnaazz']",3,"['linchuck', 'jksaha', None]",17,"['linchuck', 'jksaha', 'fwx', 'wernerchao', 'hutengch', 'polonila', 'kevin955217', None, 'patelsu5', 'elnaazz', 'nzb109', 'peterchien911', 'dreon', 'nilou123', 'yingying2122', 'cheneric0206', 'chengke9']"
27,96,15,11,9,"['ankurashtekar', 'thetung', 'helloyc', 'gou', 'awarhadp', 'hender10', 'raphir', 'polka', 'jbomidi']",5,"['ebreedlo', 'rbwagner', 'sanginnwoo', 'jmarin', 'dblair']",2,"[None, 'aritchey']",16,"['ankurashtekar', 'thetung', 'sanginnwoo', 'ebreedlo', 'hender10', 'raphir', 'jbomidi', None, 'rbwagner', 'helloyc', 'gou', 'awarhadp', 'aritchey', 'jmarin', 'polka', 'dblair']"
28,51,15,9,5,"['uditdhawan', 'wildkid256', 'eshitamarwah', 'guojia7', 'pandalover']",9,"['deityggbbt', 'nurch111', 'driscoll85', 'shobin', 'hambro', 'byavoich', 'fspeetjens', 'benpercy', 'vincer']",4,"['kuicao', 'vinatakoppal', None, 'tingchw']",18,"['deityggbbt', 'driscoll85', 'shobin', 'tingchw', 'wildkid256', 'byavoich', 'eshitamarwah', 'guojia7', 'pandalover', 'benpercy', None, 'nurch111', 'uditdhawan', 'kuicao', 'hambro', 'vinatakoppal', 'fspeetjens', 'vincer']"
29,2,14,32,5,"['wjbennet88', 'ssaeedas', 'akiran', 'jyeoh', 'jpurao']",8,"['thenu_cc', 'souvikmatsc', 'jcooper2008', 'daryoosh', 'eschmidgall', 'aabraham', 'banatoski', 'jmgaines']",27,"['agurram', 'kjkang11', 'jeresonshen', 'zchia', 'slarew', 'owensec', 'safavih', 'ruzz311', 'dlopez', 'kmbaumga', 'hankh825', 'cxsmith', 'zhenghuili', 'ashraf', 'shicheng', 'lzentner', None, 'chang71', 'myokem', 'pbyers', 'pagejl', 'mlroby', 'jhunsber', 'kakashow', 'huang162', 'bbommai', 'adye20']",40,"['agurram', 'kjkang11', 'souvikmatsc', 'jeresonshen', 'jcooper2008', 'eschmidgall', 'zchia', 'jyeoh', 'banatoski', 'slarew', 'owensec', 'wjbennet88', 'safavih', 'ruzz311', 'akiran', 'dlopez', 'kmbaumga', 'jpurao', 'hankh825', 'cxsmith', 'zhenghuili', 'daryoosh', 'ashraf', 'shicheng', 'aabraham', 'lzentner', 'chang71', None, 'myokem', 'pbyers', 'ssaeedas', 'pagejl', 'mlroby', 'jhunsber', 'kakashow', 'huang162', 'bbommai', 'thenu_cc', 'adye20', 'jmgaines']"
30,149,14,13,2,"['fernandoa1', 'yanezerick']",11,"['ccescott', 'jrjain', 'kpgan', 'sindhuramaswamy', 'raghcharash', 'aajunqueira', 'joeywong', 'frankp', 'ppahner', 'jmendoz2', 'dju']",11,"['lava4', 'felipedea10', 'almeida915', 'vmgonzalez4', 'acano363', 'laszlo', 'rubenmtzq', 'mjde2', 'dcanaba', 'chemil', None]",24,"['ccescott', 'felipedea10', 'jrjain', 'chemil', 'sindhuramaswamy', 'aajunqueira', 'mjde2', 'dcanaba', 'yanezerick', 'ppahner', 'jmendoz2', None, 'dju', 'lava4', 'almeida915', 'kpgan', 'vmgonzalez4', 'acano363', 'raghcharash', 'laszlo', 'fernandoa1', 'rubenmtzq', 'frankp', 'joeywong']"
31,122,14,28,9,"['apesathi', 'canderle', 'mksharma', 'araz', 'ab9', 'amitgahoi143', 'frassess', 'beklof', 'adeline_lanterne']",4,"['akinwummy', 'shabnamm', 'angotd', 'ycnayan']",19,"['mbalaban', 'afshan', 'rafaelap', 'aminahen', 'wenderness', 'mmsa', 'valurg', 'eugenio', 'zytung', 'aksaray', 'xjshang', 'cat123', None, 'mamata', 'zhihuichen', 'ashish1', 'aamirmujtaba', 'adeel76', 'canuckflyboy']",32,"['shabnamm', 'apesathi', 'canderle', 'mbalaban', 'afshan', 'ycnayan', 'ab9', 'rafaelap', 'amitgahoi143', 'aminahen', 'angotd', 'wenderness', 'mmsa', 'frassess', 'beklof', 'adeline_lanterne', 'valurg', 'eugenio', 'zytung', 'aksaray', 'araz', 'xjshang', 'cat123', None, 'mamata', 'mksharma', 'zhihuichen', 'ashish1', 'aamirmujtaba', 'adeel76', 'akinwummy', 'canuckflyboy']"
31,110,14,25,4,"['shabnamm', 'adeline_lanterne', 'araz', 'frassess']",9,"['apesathi', 'canderle', 'mksharma', 'angotd', 'ycnayan', 'ab9', 'amitgahoi143', 'akinwummy', 'beklof']",21,"['mbalaban', 'afshan', 'rafaelap', 'aminahen', 'wenderness', 'mmsa', 'm_maziar', 'chienhong', 'valurg', 'eugenio', 'zytung', 'aksaray', 'asahmed', 'cat123', None, 'qinfei', 'mamata', 'zhihuichen', 'ashish1', 'aamirmujtaba', 'sinanag']",34,"['shabnamm', 'apesathi', 'canderle', 'mbalaban', 'afshan', 'ycnayan', 'ab9', 'rafaelap', 'amitgahoi143', 'aminahen', 'angotd', 'wenderness', 'mmsa', 'frassess', 'beklof', 'adeline_lanterne', 'm_maziar', 'chienhong', 'valurg', 'eugenio', 'zytung', 'aksaray', 'araz', 'asahmed', 'cat123', None, 'qinfei', 'mamata', 'mksharma', 'zhihuichen', 'ashish1', 'aamirmujtaba', 'sinanag', 'akinwummy']"
31,155,14,23,3,"['beklof', 'ab9', 'amitgahoi143']",10,"['shabnamm', 'apesathi', 'canderle', 'mksharma', 'angotd', 'ycnayan', 'araz', 'frassess', 'akinwummy', 'adeline_lanterne']",20,"['mbalaban', 'aismail05', 'afshan', 'rafaelap', 'aminahen', 'wenderness', 'mmsa', 'm_maziar', 'catnys123', 'valurg', 'joanne', 'asahmed', None, 'qinfei', 'mamata', 'zhihuichen', 'ashish1', 'aamirmujtaba', 'adeel76', 'sinanag']",33,"['shabnamm', 'apesathi', 'canderle', 'mbalaban', 'aismail05', 'afshan', 'ycnayan', 'ab9', 'rafaelap', 'amitgahoi143', 'aminahen', 'angotd', 'wenderness', 'mmsa', 'frassess', 'beklof', 'adeline_lanterne', 'm_maziar', 'catnys123', 'valurg', 'araz', 'joanne', 'asahmed', None, 'qinfei', 'mamata', 'mksharma', 'zhihuichen', 'ashish1', 'aamirmujtaba', 'adeel76', 'sinanag', 'akinwummy']"
31,13,14,15,9,"['shabnamm', 'apesathi', 'canderle', 'mksharma', 'angotd', 'ycnayan', 'frassess', 'akinwummy', 'adeline_lanterne']",4,"['araz', 'beklof', 'ab9', 'amitgahoi143']",6,"['gahoi', 'eugenio', 'zytung', 'bellmanz', None, 'chienhong']",19,"['gahoi', 'shabnamm', 'apesathi', 'canderle', 'ycnayan', 'eugenio', 'zytung', 'ab9', 'araz', 'amitgahoi143', 'angotd', None, 'mksharma', 'bellmanz', 'frassess', 'akinwummy', 'beklof', 'adeline_lanterne', 'chienhong']"
31,15,14,13,6,"['apesathi', 'canderle', 'mksharma', 'ycnayan', 'amitgahoi143', 'angotd']",7,"['shabnamm', 'araz', 'ab9', 'frassess', 'akinwummy', 'beklof', 'adeline_lanterne']",7,"['gahoi', 'christopherborsa', 'bellmanz', 'stahel', 'xjshang', 'canuckflyboy', None]",20,"['gahoi', 'shabnamm', 'apesathi', 'canderle', 'christopherborsa', 'ycnayan', 'ab9', 'araz', 'stahel', 'xjshang', 'amitgahoi143', 'angotd', None, 'mksharma', 'bellmanz', 'frassess', 'akinwummy', 'beklof', 'canuckflyboy', 'adeline_lanterne']"
31,112,14,10,1,['araz'],12,"['shabnamm', 'apesathi', 'canderle', 'mksharma', 'angotd', 'ycnayan', 'ab9', 'amitgahoi143', 'frassess', 'akinwummy', 'beklof', 'adeline_lanterne']",9,"['mamata', 'afshan', 'aamirmujtaba', 'adeel76', 'rafaelap', 'aminahen', 'cat123', 'canuckflyboy', None]",22,"['shabnamm', 'apesathi', 'canderle', 'afshan', 'ycnayan', 'ab9', 'araz', 'rafaelap', 'amitgahoi143', 'aminahen', 'angotd', 'cat123', None, 'mamata', 'mksharma', 'aamirmujtaba', 'adeel76', 'frassess', 'akinwummy', 'beklof', 'canuckflyboy', 'adeline_lanterne']"
31,123,14,10,6,"['apesathi', 'canderle', 'ycnayan', 'ab9', 'angotd', 'beklof']",7,"['shabnamm', 'mksharma', 'araz', 'amitgahoi143', 'frassess', 'akinwummy', 'adeline_lanterne']",4,"['garidisk', None, 'xjshang', 'canuckflyboy']",17,"['shabnamm', 'apesathi', 'canderle', 'ycnayan', 'ab9', 'araz', 'xjshang', 'amitgahoi143', 'angotd', None, 'mksharma', 'garidisk', 'frassess', 'akinwummy', 'beklof', 'canuckflyboy', 'adeline_lanterne']"
31,113,14,7,1,['araz'],12,"['shabnamm', 'apesathi', 'canderle', 'mksharma', 'angotd', 'ycnayan', 'ab9', 'amitgahoi143', 'frassess', 'akinwummy', 'beklof', 'adeline_lanterne']",6,"['afshan', 'aamirmujtaba', 'adeel76', 'aminahen', 'canuckflyboy', None]",19,"['shabnamm', 'apesathi', 'canderle', 'afshan', 'ycnayan', 'ab9', 'araz', 'amitgahoi143', 'aminahen', 'angotd', None, 'mksharma', 'aamirmujtaba', 'adeel76', 'frassess', 'akinwummy', 'beklof', 'canuckflyboy', 'adeline_lanterne']"
32,131,13,14,11,"['ncalta', 'sicelo', 'mshrestha', 'lindseymadison2015', 'def790', 'mshelby', 'ngruenke', 'she', 'amberdavis2014', 'rjh779', 'gcutsail']",1,['lukealanjohnson'],3,"[None, 'mso', 'cengel126']",15,"['cengel126', 'amberdavis2014', None, 'rjh779', 'ncalta', 'sicelo', 'lindseymadison2015', 'mshrestha', 'def790', 'mshelby', 'ngruenke', 'lukealanjohnson', 'she', 'mso', 'gcutsail']"
33,87,13,15,7,"['leojohnw', 'ayprasad', 'ajrose', 'esther', 'jvelazquez', 'acelayas', 'gofas']",5,"['hirokoa111', 'sourav90', 'munkhbaatar', 'azizjiwani123', 'pmassy']",8,"['jlofgren', 'jdfarme2', 'fmoraila3', 'kqchen', 'lion2012', None, 'charles1112', 'urbieta']",20,"['ajrose', 'acelayas', 'sourav90', 'gofas', 'lion2012', None, 'munkhbaatar', 'urbieta', 'leojohnw', 'ayprasad', 'esther', 'jlofgren', 'jvelazquez', 'fmoraila3', 'jdfarme2', 'charles1112', 'kqchen', 'hirokoa111', 'azizjiwani123', 'pmassy']"
33,88,13,12,1,['azizjiwani123'],11,"['leojohnw', 'ayprasad', 'ajrose', 'esther', 'jvelazquez', 'acelayas', 'hirokoa111', 'sourav90', 'gofas', 'munkhbaatar', 'pmassy']",11,"['ramya86', 'yashvanth86', 'jogden12', 'sagarjcec78', None, 'glarose', 'preethit', 'gladysh', 'scotos', 'mahanth_nani', 'abhilashb7']",23,"['ramya86', 'ajrose', 'acelayas', 'sourav90', 'gofas', 'mahanth_nani', 'jogden12', 'munkhbaatar', 'abhilashb7', None, 'leojohnw', 'ayprasad', 'esther', 'sagarjcec78', 'jvelazquez', 'glarose', 'preethit', 'gladysh', 'scotos', 'hirokoa111', 'yashvanth86', 'azizjiwani123', 'pmassy']"
34,130,12,28,9,"['annedisabato', 'edonnelly', 'alexshap1', 'msh114', 'sanaebryson1', 'rrussell', 'jgodlewska', 'jgobrial', 'sbhogal']",2,"['blarsen', 'bschutte']",19,"['csprick', 'mollyhermiller', 'jondrey', 'mma517', 'cengelke', 'rlarrison', 'wsutton', 'jch399', 'melissalincoln', 'pso824', 'glenej3', 'camora', None, 'jbrownell', 'gduprat', 'dalcorn', 'sgoeppinger', 'ashapiro', 'ajohnson']",30,"['csprick', 'mollyhermiller', 'jondrey', 'mma517', 'cengelke', 'jgobrial', 'wsutton', 'rlarrison', 'bschutte', 'sbhogal', 'blarsen', 'jch399', 'melissalincoln', 'edonnelly', 'alexshap1', 'sanaebryson1', 'pso824', 'glenej3', 'camora', 'jgodlewska', None, 'jbrownell', 'annedisabato', 'gduprat', 'msh114', 'dalcorn', 'rrussell', 'sgoeppinger', 'ashapiro', 'ajohnson']"
35,122,12,28,8,"['mamata', 'mbalaban', 'zhihuichen', 'ashish1', 'adeel76', 'mmsa', 'rafaelap', 'cat123']",3,"['joanne', 'asahmed', 'sinanag']",20,"['apesathi', 'canderle', 'afshan', 'ab9', 'aminahen', 'amitgahoi143', 'wenderness', 'frassess', 'beklof', 'adeline_lanterne', 'valurg', 'eugenio', 'zytung', 'aksaray', 'araz', 'xjshang', None, 'mksharma', 'aamirmujtaba', 'canuckflyboy']",31,"['apesathi', 'mbalaban', 'canderle', 'afshan', 'ab9', 'rafaelap', 'aminahen', 'amitgahoi143', 'wenderness', 'mmsa', 'frassess', 'beklof', 'adeline_lanterne', 'valurg', 'eugenio', 'zytung', 'aksaray', 'araz', 'xjshang', 'joanne', 'asahmed', 'cat123', None, 'mamata', 'mksharma', 'zhihuichen', 'ashish1', 'aamirmujtaba', 'adeel76', 'sinanag', 'canuckflyboy']"
35,110,12,25,9,"['mamata', 'mbalaban', 'zhihuichen', 'ashish1', 'mmsa', 'rafaelap', 'sinanag', 'cat123', 'asahmed']",2,"['adeel76', 'joanne']",16,"['shabnamm', 'afshan', 'wenderness', 'adeline_lanterne', 'valurg', 'eugenio', 'zytung', 'aksaray', 'araz', 'aamirmujtaba', 'aminahen', 'frassess', None, 'm_maziar', 'qinfei', 'chienhong']",27,"['shabnamm', 'mbalaban', 'afshan', 'rafaelap', 'aminahen', 'wenderness', 'mmsa', 'frassess', 'm_maziar', 'adeline_lanterne', 'chienhong', 'valurg', 'eugenio', 'zytung', 'aksaray', 'araz', 'joanne', 'asahmed', 'cat123', None, 'qinfei', 'mamata', 'zhihuichen', 'ashish1', 'aamirmujtaba', 'adeel76', 'sinanag']"
35,155,12,23,10,"['mamata', 'joanne', 'mbalaban', 'zhihuichen', 'ashish1', 'adeel76', 'mmsa', 'rafaelap', 'sinanag', 'asahmed']",1,['cat123'],13,"['catnys123', 'aismail05', 'afshan', 'wenderness', 'valurg', 'aamirmujtaba', 'ab9', 'amitgahoi143', 'aminahen', 'beklof', None, 'm_maziar', 'qinfei']",24,"['mbalaban', 'aismail05', 'afshan', 'ab9', 'rafaelap', 'aminahen', 'amitgahoi143', 'wenderness', 'mmsa', 'beklof', 'm_maziar', 'catnys123', 'valurg', 'joanne', 'asahmed', 'cat123', None, 'qinfei', 'mamata', 'zhihuichen', 'ashish1', 'aamirmujtaba', 'adeel76', 'sinanag']"
35,112,12,10,4,"['mamata', 'adeel76', 'cat123', 'rafaelap']",7,"['joanne', 'mbalaban', 'zhihuichen', 'ashish1', 'mmsa', 'sinanag', 'asahmed']",6,"['afshan', 'aamirmujtaba', 'araz', 'aminahen', 'canuckflyboy', None]",17,"['mbalaban', 'afshan', 'araz', 'rafaelap', 'aminahen', 'joanne', 'asahmed', 'cat123', None, 'mamata', 'zhihuichen', 'ashish1', 'aamirmujtaba', 'adeel76', 'mmsa', 'sinanag', 'canuckflyboy']"
35,113,12,7,1,['adeel76'],10,"['mamata', 'joanne', 'mbalaban', 'zhihuichen', 'ashish1', 'mmsa', 'rafaelap', 'sinanag', 'cat123', 'asahmed']",6,"['afshan', 'aamirmujtaba', 'araz', 'aminahen', 'canuckflyboy', None]",17,"['mamata', 'mbalaban', 'zhihuichen', 'afshan', 'ashish1', 'aamirmujtaba', 'adeel76', 'sinanag', 'araz', 'mmsa', 'rafaelap', 'aminahen', 'joanne', 'cat123', 'canuckflyboy', None, 'asahmed']"
36,118,11,16,9,"['abraham_dantes', 'etorresz12', 'faespinoza', 'scmullapudi', 'deepu424', 'eriosc2', 'navee3', 'jhescobar', 'nepuente']",1,['nlespinoza2'],7,"['jmalvarezy19', 'jhescobar05', 'pradeep424', 'navee5', 'eloyolivo', 'jgvillalon', None]",17,"['jmalvarezy19', 'pradeep424', 'abraham_dantes', 'eloyolivo', 'deepu424', 'eriosc2', 'navee3', 'jhescobar', None, 'jhescobar05', 'nlespinoza2', 'etorresz12', 'navee5', 'faespinoza', 'scmullapudi', 'jgvillalon', 'nepuente']"
36,114,11,14,8,"['abraham_dantes', 'etorresz12', 'scmullapudi', 'deepu424', 'eriosc2', 'navee3', 'jhescobar', 'nepuente']",2,"['nlespinoza2', 'faespinoza']",6,"['jhescobar05', 'pradeep424', 'navee5', 'eloyolivo', 'jgvillalon', None]",16,"['pradeep424', 'abraham_dantes', 'eloyolivo', 'deepu424', 'eriosc2', 'navee3', 'jhescobar', None, 'jhescobar05', 'nlespinoza2', 'etorresz12', 'navee5', 'faespinoza', 'scmullapudi', 'jgvillalon', 'nepuente']"
36,54,11,13,9,"['nlespinoza2', 'etorresz12', 'faespinoza', 'scmullapudi', 'deepu424', 'eriosc2', 'navee3', 'jhescobar', 'nepuente']",1,['abraham_dantes'],4,"[None, 'hhuq', 'rmendey', 'pchivukula']",14,"['hhuq', 'abraham_dantes', 'pchivukula', 'deepu424', 'eriosc2', 'navee3', 'jhescobar', None, 'nlespinoza2', 'etorresz12', 'faespinoza', 'scmullapudi', 'rmendey', 'nepuente']"
36,124,11,10,6,"['scmullapudi', 'deepu424', 'eriosc2', 'navee3', 'jhescobar', 'nepuente']",4,"['etorresz12', 'nlespinoza2', 'faespinoza', 'abraham_dantes']",4,"['jgvillalon', 'jmalvarezy19', None, 'jhescobar05']",14,"['jmalvarezy19', 'abraham_dantes', 'deepu424', 'eriosc2', 'navee3', 'jhescobar', None, 'jhescobar05', 'nlespinoza2', 'etorresz12', 'faespinoza', 'scmullapudi', 'jgvillalon', 'nepuente']"
37,14,11,16,1,['neddy'],9,"['gahoi', 'carlosparra', 'dagutierrezp', 'stahel', 'rain2air', 'jaacevedo', 'slaakso', 'carlospolitte', 'jecortesc']",15,"['rcrisp', 'quantumisme', 'heisenberg', 'a_ebn', 'sjmoore987', 'tohno', 'einstruments', 'aallende', 'rohanchaukulkar', 'cavewyrm', 'lpatters', 'bgallowa', None, 'emieritz', 'durangotang']",25,"['gahoi', 'rcrisp', 'carlosparra', 'quantumisme', 'a_ebn', 'heisenberg', 'stahel', 'tohno', 'aallende', 'neddy', 'rohanchaukulkar', 'jecortesc', 'cavewyrm', 'lpatters', 'bgallowa', None, 'dagutierrezp', 'sjmoore987', 'einstruments', 'rain2air', 'jaacevedo', 'slaakso', 'carlospolitte', 'emieritz', 'durangotang']"
37,13,11,15,1,['gahoi'],9,"['carlosparra', 'dagutierrezp', 'stahel', 'rain2air', 'jaacevedo', 'slaakso', 'neddy', 'carlospolitte', 'jecortesc']",14,"['shabnamm', 'mksharma', 'apesathi', 'canderle', 'angotd', 'ycnayan', 'eugenio', 'zytung', 'bellmanz', 'frassess', 'akinwummy', None, 'adeline_lanterne', 'chienhong']",24,"['gahoi', 'shabnamm', 'apesathi', 'carlosparra', 'canderle', 'ycnayan', 'eugenio', 'zytung', 'stahel', 'neddy', 'jecortesc', 'angotd', None, 'mksharma', 'dagutierrezp', 'bellmanz', 'rain2air', 'jaacevedo', 'slaakso', 'carlospolitte', 'frassess', 'akinwummy', 'adeline_lanterne', 'chienhong']"
37,15,11,13,2,"['gahoi', 'stahel']",8,"['carlosparra', 'dagutierrezp', 'rain2air', 'jaacevedo', 'slaakso', 'neddy', 'carlospolitte', 'jecortesc']",11,"['apesathi', 'canderle', 'mksharma', 'christopherborsa', 'ycnayan', 'bellmanz', 'xjshang', 'amitgahoi143', 'angotd', 'canuckflyboy', None]",21,"['gahoi', 'apesathi', 'carlosparra', 'canderle', 'christopherborsa', 'ycnayan', 'stahel', 'neddy', 'jecortesc', 'xjshang', 'amitgahoi143', 'angotd', None, 'mksharma', 'dagutierrezp', 'bellmanz', 'rain2air', 'jaacevedo', 'slaakso', 'carlospolitte', 'canuckflyboy']"
37,16,11,8,4,"['dagutierrezp', 'jecortesc', 'carlosparra', 'jaacevedo']",6,"['gahoi', 'stahel', 'rain2air', 'slaakso', 'neddy', 'carlospolitte']",4,"['caquinones', 'forerca', None, 'dabernalm']",14,"['gahoi', 'carlosparra', 'dagutierrezp', 'forerca', 'dabernalm', 'stahel', 'rain2air', 'jaacevedo', 'slaakso', 'neddy', 'carlospolitte', 'jecortesc', 'caquinones', None]"
38,173,10,22,9,"['fshah', 'vachan_kumar', 'mazad', 'davalenciah', 'tfang', 'prabhu_balasg', 'helenxu', 'satyakiganguly', 'iayoung']",0,[],13,"['ongzy1979', 'xfiles', None, 'raelyn', 'rjana1', 'abhinavsinha', 'rgrassi', 'wizjeong', 'hqucsb', 'narendra', 'valdez4', 'bivas', 'linkenghua']",22,"['xfiles', 'prabhu_balasg', 'raelyn', 'helenxu', 'rgrassi', 'iayoung', 'mazad', 'bivas', None, 'linkenghua', 'hqucsb', 'fshah', 'vachan_kumar', 'rjana1', 'ongzy1979', 'tfang', 'davalenciah', 'abhinavsinha', 'satyakiganguly', 'narendra', 'wizjeong', 'valdez4']"
38,143,10,21,9,"['fshah', 'vachan_kumar', 'mazad', 'davalenciah', 'tfang', 'prabhu_balasg', 'helenxu', 'satyakiganguly', 'iayoung']",0,[],12,"['redwansajjad', 'ongzy1979', 'xfiles', 'raelyn', 'rjana1', 'rgrassi', 'wizjeong', 'hqucsb', 'narendra', 'valdez4', None, 'linkenghua']",21,"['xfiles', 'prabhu_balasg', 'raelyn', 'helenxu', 'rgrassi', 'wizjeong', 'iayoung', 'mazad', None, 'linkenghua', 'hqucsb', 'rjana1', 'fshah', 'vachan_kumar', 'ongzy1979', 'tfang', 'davalenciah', 'satyakiganguly', 'narendra', 'redwansajjad', 'valdez4']"
38,73,10,20,9,"['fshah', 'vachan_kumar', 'mazad', 'davalenciah', 'tfang', 'prabhu_balasg', 'helenxu', 'satyakiganguly', 'iayoung']",0,[],11,"['redwansajjad', 'ongzy1979', 'xfiles', None, 'raelyn', 'rjana1', 'rgrassi', 'hqucsb', 'narendra', 'bivas', 'linkenghua']",20,"['xfiles', 'prabhu_balasg', 'raelyn', 'helenxu', 'rgrassi', 'iayoung', 'mazad', 'bivas', None, 'linkenghua', 'hqucsb', 'fshah', 'vachan_kumar', 'rjana1', 'ongzy1979', 'tfang', 'davalenciah', 'satyakiganguly', 'narendra', 'redwansajjad']"
39,97,10,10,9,"['johan_as', 'chuckeddychuck', 'steinmann', 'jacolj_kbh', 'mar889', 'rasmusbrogaard', 'januseriksen', 'jonaselm', 'hanna']",0,[],1,[None],10,"['chuckeddychuck', 'jacolj_kbh', 'steinmann', 'mar889', 'rasmusbrogaard', 'jonaselm', 'hanna', None, 'johan_as', 'januseriksen']"
40,98,10,11,9,"['johnsonm11', 'abrotherston', 'nandrews', 'genalmcy', 'jamie', 'bp808', 'donahoo11', 'ray11', 'figuly11']",0,[],2,"['osterberg', None]",11,"['johnsonm11', 'abrotherston', 'nandrews', 'genalmcy', 'donahoo11', 'ray11', 'figuly11', None, 'osterberg', 'bp808', 'jamie']"
42,21,9,7,1,['mehernando'],7,"['bettyelsm', 'kimtaeyun', 'alexwirz', 'havg', 'mpdesanto', 'justair', 'mluna']",6,"['alexandercartagena', 'drkiraco', 'nurulhuda', 'hthomps', 'htasdemi', None]",14,"['bettyelsm', 'kimtaeyun', 'havg', 'alexwirz', 'mpdesanto', 'alexandercartagena', 'justair', 'drkiraco', 'nurulhuda', 'mluna', 'hthomps', 'htasdemi', None, 'mehernando']"
42,22,9,7,1,['mehernando'],7,"['bettyelsm', 'kimtaeyun', 'alexwirz', 'havg', 'mpdesanto', 'justair', 'mluna']",6,"['alexandercartagena', 'drkiraco', 'nurulhuda', 'lyamin', 'htasdemi', None]",14,"['bettyelsm', 'kimtaeyun', 'havg', 'alexwirz', 'mpdesanto', 'alexandercartagena', 'justair', 'drkiraco', 'nurulhuda', 'mluna', 'lyamin', 'htasdemi', None, 'mehernando']"
43,9,9,6,2,"['clau_perez', 'moisoro']",6,"['carolina_amaya', 'raisavec', 'mahar', 'alichaparro', 'amalpradeep', 'rgnanadavid']",4,"['caquinones', 'forerca', None, 'dabernalm']",12,"['carolina_amaya', 'raisavec', 'forerca', 'mahar', 'moisoro', 'dabernalm', None, 'alichaparro', 'amalpradeep', 'caquinones', 'clau_perez', 'rgnanadavid']"
43,11,9,6,3,"['carolina_amaya', 'clau_perez', 'moisoro']",5,"['raisavec', 'mahar', 'alichaparro', 'amalpradeep', 'rgnanadavid']",3,"['forerca', None, 'caquinones']",11,"['carolina_amaya', 'raisavec', 'forerca', 'mahar', 'moisoro', None, 'alichaparro', 'amalpradeep', 'caquinones', 'clau_perez', 'rgnanadavid']"
44,169,8,22,7,"['lava4', 'felipedea10', 'vmgonzalez4', 'acano363', 'rubenmtzq', 'dcanaba', 'chemil']",0,[],15,"['mdmeraz', 'vyc8zcg', 'gvelasco', 'almeida915', 'laszlo', 'mmoreno13', 'arodriguez45', 'mjde2', 'jlflores5', 'oblivion007', 'jgrivas', 'tirante_s', None, 'jrmartinez9', 'heduran']",22,"['felipedea10', 'gvelasco', 'arodriguez45', 'mjde2', 'jlflores5', 'oblivion007', 'dcanaba', 'tirante_s', None, 'jgrivas', 'lava4', 'mdmeraz', 'vyc8zcg', 'almeida915', 'vmgonzalez4', 'acano363', 'laszlo', 'mmoreno13', 'rubenmtzq', 'chemil', 'jrmartinez9', 'heduran']"
44,174,8,21,7,"['lava4', 'felipedea10', 'vmgonzalez4', 'acano363', 'rubenmtzq', 'dcanaba', 'chemil']",0,[],14,"['vyc8zcg', 'gvelasco', 'almeida915', 'laszlo', 'mmoreno13', 'arodriguez45', 'mjde2', 'jlflores5', 'oblivion007', 'jgrivas', 'tirante_s', None, 'jrmartinez9', 'heduran']",21,"['felipedea10', 'gvelasco', 'arodriguez45', 'mjde2', 'jlflores5', 'oblivion007', 'dcanaba', 'tirante_s', None, 'jgrivas', 'lava4', 'vyc8zcg', 'almeida915', 'vmgonzalez4', 'acano363', 'laszlo', 'mmoreno13', 'rubenmtzq', 'chemil', 'jrmartinez9', 'heduran']"
44,149,8,13,7,"['lava4', 'felipedea10', 'vmgonzalez4', 'acano363', 'rubenmtzq', 'dcanaba', 'chemil']",0,[],6,"['almeida915', 'laszlo', 'fernandoa1', 'mjde2', 'yanezerick', None]",13,"['felipedea10', 'mjde2', 'dcanaba', 'yanezerick', None, 'lava4', 'almeida915', 'vmgonzalez4', 'acano363', 'laszlo', 'fernandoa1', 'rubenmtzq', 'chemil']"
46,59,8,31,5,"['ankitchandak', 'barmstr3', 'bagaria2', 'cuceu1', 'haiquans']",2,"['dabbelt1', 'nmahend2']",26,"['raizada1', 'dn21493234', 'alaimo1', 'boruichen', 'logiconcepts819', 'lebedow1', 'kim413', 'jaredlesicko', 'maddhatter', 'taegonoh', 'dbostwi2', 'alllaw', 'rredeno2', 'roylee3', 'vivoli1', 'bconnaghan', 'rohanbali', None, 'cliu35', 'ran1363', 'ymoon4', 'jhandz2', 'somnath2', 'wbarnes2', 'nivero', 'yvonneeven']",33,"['raizada1', 'dn21493234', 'alaimo1', 'boruichen', 'logiconcepts819', 'lebedow1', 'cuceu1', 'kim413', 'jaredlesicko', 'maddhatter', 'bagaria2', 'barmstr3', 'haiquans', 'nmahend2', 'taegonoh', 'dbostwi2', 'alllaw', 'rredeno2', 'roylee3', 'vivoli1', 'bconnaghan', 'dabbelt1', 'rohanbali', None, 'cliu35', 'ankitchandak', 'ran1363', 'ymoon4', 'jhandz2', 'somnath2', 'wbarnes2', 'nivero', 'yvonneeven']"
46,60,8,15,2,"['dabbelt1', 'nmahend2']",5,"['ankitchandak', 'barmstr3', 'bagaria2', 'cuceu1', 'haiquans']",13,"['lee142', 'stevenjin2137', 'maddhatter', 'apandya3', 'codenum273', 'rgalvan2', 'dshih2', 'missinglink41', 'rredeno2', 'wbarnes2', None, 'cpoon2', 'gomez19']",20,"['lee142', 'dshih2', 'missinglink41', 'rredeno2', 'cuceu1', 'dabbelt1', None, 'stevenjin2137', 'maddhatter', 'ankitchandak', 'apandya3', 'bagaria2', 'codenum273', 'rgalvan2', 'wbarnes2', 'barmstr3', 'haiquans', 'cpoon2', 'nmahend2', 'gomez19']"
47,47,8,8,6,"['vlyons', 'andreakim', 'avasquez', 'rkrasaeath', 'rdahlberg', 'tashadrake2014']",1,['rkorkosz'],2,"['tejerina', None]",9,"['vlyons', 'andreakim', 'avasquez', 'tejerina', 'rkrasaeath', 'rkorkosz', None, 'rdahlberg', 'tashadrake2014']"
50,190,8,47,5,"['cho72', 'sbogensc', 'kuos', 'lsirui', 'mattflash']",2,"['dfetter88', 'dpeffers']",42,"['hungc', 'jcanan', 'asmagulo', 'asenetar', 'ryokubaka', 'baharman', 'ekhall', 'macman314', 'alexwany', 'mmilosci', 'oghaisas', 'ahaberlein', 'mzwach', 'wangyix', 'jjyoun', 'dpbrocke', 'johns175', 'ebinkerd', 'harri115', 'wang67', 'ccange', 'asharifu', 'goel5', 'minduka', 'sjia', 'snowmanam2', 'khaver', 'apedroza', 'eekeen17', 'daedalus_v2', 'zhangpurdue', 'lzentner', 'chang71', None, 'cykim', 'kjhajari', 'mwalders', 'prabhu_m', 'mille557', 'heckhoff', 'pmarepal', 'malsoray']",49,"['hungc', 'lsirui', 'dfetter88', 'jcanan', 'asmagulo', 'asenetar', 'ryokubaka', 'baharman', 'ekhall', 'macman314', 'alexwany', 'dpeffers', 'mmilosci', 'oghaisas', 'ahaberlein', 'mzwach', 'mattflash', 'wangyix', 'jjyoun', 'dpbrocke', 'johns175', 'ebinkerd', 'harri115', 'wang67', 'ccange', 'asharifu', 'goel5', 'minduka', 'sjia', 'snowmanam2', 'khaver', 'apedroza', 'eekeen17', 'daedalus_v2', 'zhangpurdue', 'lzentner', 'chang71', None, 'cho72', 'sbogensc', 'kuos', 'cykim', 'kjhajari', 'mwalders', 'prabhu_m', 'mille557', 'heckhoff', 'pmarepal', 'malsoray']"
50,189,8,18,3,"['kuos', 'dpeffers', 'lsirui']",4,"['dfetter88', 'mattflash', 'cho72', 'sbogensc']",15,"['oadeniji', 'hungc', 'mmilosci', 'ahaberlein', 'dfang7', 'khaver', 'jkohnert', 'apedroza', 'kjhajari', 'mille557', 'dpbrocke', 'ebinkerd', 'kpetrucc', None, 'minduka']",22,"['hungc', 'lsirui', 'dfetter88', 'dfang7', 'khaver', 'apedroza', None, 'oadeniji', 'dpeffers', 'cho72', 'sbogensc', 'kuos', 'mmilosci', 'ahaberlein', 'jkohnert', 'kjhajari', 'mattflash', 'mille557', 'dpbrocke', 'ebinkerd', 'kpetrucc', 'minduka']"
51,53,7,13,6,"['cmliu222', 'arkargar', 'jmaparic', 'mortech', 'ckdoran88', 'yjhgentle']",0,[],7,"['chl002', 'xfiles', None, 'andylo', 'jackpot', 'ece212an', 'samianawar']",13,"['arkargar', 'jmaparic', 'chl002', 'xfiles', 'ckdoran88', 'jackpot', 'ece212an', None, 'yjhgentle', 'cmliu222', 'mortech', 'andylo', 'samianawar']"
51,35,7,10,5,"['cmliu222', 'arkargar', 'jmaparic', 'mortech', 'yjhgentle']",1,['ckdoran88'],5,"['hasanfaraby', 'ece212an', 'nanotube80', 'kgarton', None]",11,"['arkargar', 'jmaparic', 'hasanfaraby', 'ckdoran88', 'ece212an', None, 'yjhgentle', 'cmliu222', 'mortech', 'nanotube80', 'kgarton']"
51,34,7,8,5,"['arkargar', 'jmaparic', 'mortech', 'ckdoran88', 'yjhgentle']",1,['cmliu222'],3,"['nanotube80', 'jespm', None]",9,"['cmliu222', 'arkargar', 'jmaparic', 'mortech', 'ckdoran88', 'jespm', 'nanotube80', None, 'yjhgentle']"
52,87,7,15,6,"['jlofgren', 'fmoraila3', 'jdfarme2', 'kqchen', 'lion2012', 'charles1112']",0,[],9,"['leojohnw', 'ayprasad', 'ajrose', 'esther', 'jvelazquez', 'acelayas', 'gofas', None, 'urbieta']",15,"['ajrose', 'acelayas', 'gofas', 'lion2012', None, 'urbieta', 'leojohnw', 'ayprasad', 'esther', 'jlofgren', 'jvelazquez', 'fmoraila3', 'jdfarme2', 'kqchen', 'charles1112']"
52,145,7,7,6,"['jlofgren', 'fmoraila3', 'jdfarme2', 'kqchen', 'lion2012', 'charles1112']",0,[],1,[None],7,"['jlofgren', 'fmoraila3', 'jdfarme2', 'kqchen', 'lion2012', None, 'charles1112']"
54,137,7,21,2,"['ehmke', 'gnave']",4,"['leachs', 'nickersost', 'piyush_2k6', 'glassbreaker']",19,"['scolbert', 'gbechtol', 'wrightjc', 'bivas', 'redwing', 'askachen369', 'ryyan', 'ryyan2', 'fantico', None, 'linkenghua', 'dstanto', 'jquinlan', 'kim758', 'cmisiego', 'coxcj', 'ajmendoz', 'kyooho', 'fcordisc']",25,"['scolbert', 'gbechtol', 'nickersost', 'piyush_2k6', 'ryyan', 'gnave', 'wrightjc', 'ryyan2', 'leachs', 'bivas', 'fantico', None, 'linkenghua', 'dstanto', 'jquinlan', 'kim758', 'cmisiego', 'ehmke', 'coxcj', 'ajmendoz', 'redwing', 'glassbreaker', 'kyooho', 'askachen369', 'fcordisc']"
54,136,7,16,2,"['ehmke', 'gnave']",4,"['leachs', 'nickersost', 'piyush_2k6', 'glassbreaker']",14,"['gbechtol', 'jquinlan', 'kim758', 'ryyan', 'cmisiego', None, 'wrightjc', 'coxcj', 'ajmendoz', 'redwing', 'fantico', 'bivas', 'cmathewjoseph', 'dstanto']",20,"['gbechtol', 'nickersost', 'piyush_2k6', 'ryyan', 'gnave', 'wrightjc', 'leachs', 'bivas', 'fantico', None, 'dstanto', 'jquinlan', 'kim758', 'cmisiego', 'ehmke', 'coxcj', 'ajmendoz', 'redwing', 'glassbreaker', 'cmathewjoseph']"
55,99,7,36,4,"['mikedaley5', 'wilwizard', 'setiawa2', 'mczarny']",2,"['twc5x', 'piyas']",32,"['raizada1', 'dshih2', 'alaimo1', 'boruichen', 'logiconcepts819', 'jaredlesicko', 'rosboro1', 'rgalvan2', 'sembel1', 'justintconroy', 'amryan2', 'taegonoh', 'dbostwi2', 'alllaw', 'franc21', 'computerwiz0911', 'roylee3', 'vivoli1', 'rohanbali', None, 'stevenjin2137', 'cliu35', 'ran1363', 'ercetera', 'apandya3', 'ymoon4', 'beminor2', 'jhandz2', 'somnath2', 'wbarnes2', 'cpoon2', 'yvonneeven']",38,"['raizada1', 'dshih2', 'piyas', 'alaimo1', 'boruichen', 'logiconcepts819', 'jaredlesicko', 'rosboro1', 'rgalvan2', 'twc5x', 'sembel1', 'justintconroy', 'amryan2', 'taegonoh', 'dbostwi2', 'alllaw', 'franc21', 'wilwizard', 'computerwiz0911', 'roylee3', 'vivoli1', 'rohanbali', 'mczarny', None, 'mikedaley5', 'stevenjin2137', 'setiawa2', 'cliu35', 'ran1363', 'ercetera', 'apandya3', 'ymoon4', 'beminor2', 'jhandz2', 'somnath2', 'wbarnes2', 'cpoon2', 'yvonneeven']"
59,169,7,22,6,"['vyc8zcg', 'arodriguez45', 'jlflores5', 'jgrivas', 'jrmartinez9', 'heduran']",0,[],16,"['lava4', 'mdmeraz', 'felipedea10', 'gvelasco', 'almeida915', 'vmgonzalez4', 'laszlo', 'acano363', 'mmoreno13', 'rubenmtzq', 'mjde2', 'dcanaba', 'tirante_s', 'chemil', None, 'oblivion007']",22,"['felipedea10', 'gvelasco', 'arodriguez45', 'mjde2', 'jlflores5', 'oblivion007', 'dcanaba', 'tirante_s', 'jgrivas', None, 'lava4', 'mdmeraz', 'vyc8zcg', 'almeida915', 'vmgonzalez4', 'laszlo', 'acano363', 'mmoreno13', 'rubenmtzq', 'chemil', 'jrmartinez9', 'heduran']"
59,174,7,21,6,"['vyc8zcg', 'arodriguez45', 'jlflores5', 'jgrivas', 'jrmartinez9', 'heduran']",0,[],15,"['lava4', 'felipedea10', 'gvelasco', 'almeida915', 'vmgonzalez4', 'laszlo', 'acano363', 'mmoreno13', 'rubenmtzq', 'mjde2', 'dcanaba', 'tirante_s', 'chemil', None, 'oblivion007']",21,"['felipedea10', 'gvelasco', 'arodriguez45', 'mjde2', 'jlflores5', 'oblivion007', 'dcanaba', 'tirante_s', 'jgrivas', None, 'lava4', 'vyc8zcg', 'almeida915', 'vmgonzalez4', 'laszlo', 'acano363', 'mmoreno13', 'rubenmtzq', 'chemil', 'jrmartinez9', 'heduran']"
60,76,7,123,5,"['atseng3', 'kumar28', 'kdearnl2', 'dhandle2', 'faorlando']",1,['drmalkovich'],118,"['ericcj21', 'kartiksanghi', 'meliu2', 'jchyan2', 'chongvi1', 'hipaulshi', 'malhotr3', 'wu10', 'jeredgre', 'fliu96', 'crazedcatatonic5', 'ligao1', 'lebedow1', 'midnightblade', 'ageorges', 'ddeutsc2', 'marshal2', 'bracon', 'asrinat2', 'kang92', 'maemble', 'arappep2', 'bikrambhatia', 'fangwan2', 'abstrkt', 'xihan1', 'chen282', 'tchurch2', 'ramaith1', 'hochan5', 'tkim31', 'mkhanna', 'tarvitz', 'kim857', 'ztrata2', 'jiyichenqi', 'collapse', 'roylee3', 'supercowking', 'rohansingh28', 'luisccruz', 'dradefx', 'pessin', 'dbero2', 'jfelts', 'wmjdgla', 'boegy3', 'daguri87', 'sparklingway', 'ryanskim', 'efilli2', 'gravityplanx', 'black_chip21', 'ymoon4', 'shin44', 'tongcheng', 'kejriwa1', 'chrisjryu', 'deedarhuq', 'jlee4689', 'ragunat1', 'lee489', 'this1', 'likpok', 'chengxu1', 'bparajul', 'ng21', 'luyun198993', 'boruichen', 'alikation', 'megarza2', 'yuqiao1', 'dusty493', 'rosboro1', 'charishma', 'banker2', 'diablopbc', 'kim417', 'd98521', 'bongen2', 'willtk0113', 'leiyang1', 'berndbhuber', 'gmonroy2', 'jack_ftw', 'se210', 'weller1', 'dawei1', 'dlgudwns11', 'tao7', 'schrock3', 'acorral2', 'hnandagopal', 'gomez14', 'cjohns78', 'pandey3', 'artonis7', None, 'cjhughes17', 'ma3xiao1', 'l37', 'zhu22', 'chijiazuo', 'aggarwa3', 'rlew2', 'dbarnes2', 'snowpd', 'joo4ny', 'sehrawa1', 'choquett', 'idesis1', 'tkim28', 'agarwa19', 'weichunan', 'nivero', 'aditchhabra', 'boogajamooga', 'wldavis']",124,"['ericcj21', 'kartiksanghi', 'meliu2', 'jchyan2', 'hipaulshi', 'malhotr3', 'fliu96', 'crazedcatatonic5', 'midnightblade', 'ddeutsc2', 'marshal2', 'bracon', 'asrinat2', 'kang92', 'arappep2', 'fangwan2', 'abstrkt', 'xihan1', 'kim857', 'drmalkovich', 'roylee3', 'supercowking', 'rohansingh28', 'luisccruz', 'pessin', 'daguri87', 'sparklingway', 'ryanskim', 'tongcheng', 'chrisjryu', 'deedarhuq', 'jlee4689', 'kdearnl2', 'alikation', 'yuqiao1', 'atseng3', 'banker2', 'willtk0113', 'leiyang1', 'gmonroy2', 'jack_ftw', 'weller1', 'gomez14', 'cjohns78', 'pandey3', 'ma3xiao1', 'l37', 'chijiazuo', 'aggarwa3', 'rlew2', 'dbarnes2', 'snowpd', 'joo4ny', 'sehrawa1', 'choquett', 'idesis1', 'tkim28', 'agarwa19', 'weichunan', 'nivero', 'boogajamooga', 'wldavis', 'chongvi1', 'dhandle2', 'wu10', 'jeredgre', 'ligao1', 'lebedow1', 'ageorges', 'maemble', 'bikrambhatia', 'chen282', 'tchurch2', 'ramaith1', 'hochan5', 'tkim31', 'mkhanna', 'tarvitz', 'ztrata2', 'jiyichenqi', 'collapse', 'dradefx', 'dbero2', 'jfelts', 'kumar28', 'wmjdgla', 'boegy3', 'efilli2', 'gravityplanx', 'black_chip21', 'ymoon4', 'kejriwa1', 'faorlando', 'ragunat1', 'lee489', 'this1', 'likpok', 'chengxu1', 'bparajul', 'ng21', 'luyun198993', 'boruichen', 'megarza2', 'dusty493', 'rosboro1', 'diablopbc', 'kim417', 'd98521', 'bongen2', 'berndbhuber', 'se210', 'dawei1', 'dlgudwns11', 'tao7', 'schrock3', 'acorral2', 'hnandagopal', 'artonis7', None, 'cjhughes17', 'aditchhabra', 'shin44', 'charishma', 'zhu22']"
60,62,7,92,2,"['faorlando', 'kumar28']",4,"['drmalkovich', 'atseng3', 'kdearnl2', 'dhandle2']",90,"['ttli2', 'hipaulshi', 'malhotr3', 'wu10', 'jeredgre', 'fliu96', 'crazedcatatonic5', 'ligao1', 'midnightblade', 'ddeutsc2', 'marshal2', 'bracon', 'maemble', 'kang92', 'arappep2', 'bikrambhatia', 'fangwan2', 'abstrkt', 'xihan1', 'chen282', 'kdko2', 'tchurch2', 'ramaith1', 'vliang88', 'tkim31', 'tarvitz', 'hcho12', 'pathak1', 'kim857', 'collapse', 'supercowking', 'luisccruz', 'dradefx', 'dbero2', 'mahoney6', 'jfelts', 'wmjdgla', 'boegy3', 'sparklingway', 'ryanskim', 'efilli2', 'uribe2', 'neumann9', 'shin65', 'kejriwa1', 'chrisjryu', 'deedarhuq', 'xili1', 'ragunat1', 'lee489', 'likpok', 'chengxu1', 'bparajul', 'luyun198993', 'alikation', 'megarza2', 'yuqiao1', 'huanggeng0726', 'dusty493', 'banker2', 'diablopbc', 'd98521', 'willtk0113', 'leiyang1', 'gmonroy2', 'seanlee14', 'jack_ftw', 'se210', 'weller1', 'dlgudwns11', 'tao7', 'rishabagarwal1', 'schrock3', 'lindqui1', 'qwerasdf', None, 'wisechengyi', 'l37', 'hnandag2', 'chijiazuo', 'aggarwa3', 'dbarnes2', 'snowpd', 'joo4ny', 'aditchhabra', 'shin44', 'idesis1', 'weichunan', 'nivero', 'wldavis']",96,"['ttli2', 'hipaulshi', 'dhandle2', 'malhotr3', 'wu10', 'jeredgre', 'fliu96', 'crazedcatatonic5', 'ligao1', 'midnightblade', 'ddeutsc2', 'marshal2', 'bracon', 'maemble', 'kang92', 'arappep2', 'bikrambhatia', 'fangwan2', 'abstrkt', 'xihan1', 'chen282', 'kdko2', 'tchurch2', 'ramaith1', 'vliang88', 'tkim31', 'tarvitz', 'hcho12', 'pathak1', 'kim857', 'drmalkovich', 'collapse', 'supercowking', 'luisccruz', 'dradefx', 'dbero2', 'mahoney6', 'jfelts', 'kumar28', 'wmjdgla', 'boegy3', 'sparklingway', 'ryanskim', 'efilli2', 'uribe2', 'neumann9', 'shin65', 'kejriwa1', 'chrisjryu', 'faorlando', 'deedarhuq', 'xili1', 'ragunat1', 'lee489', 'kdearnl2', 'likpok', 'chengxu1', 'bparajul', 'luyun198993', 'alikation', 'megarza2', 'yuqiao1', 'huanggeng0726', 'dusty493', 'atseng3', 'banker2', 'diablopbc', 'd98521', 'willtk0113', 'leiyang1', 'gmonroy2', 'seanlee14', 'jack_ftw', 'se210', 'weller1', 'dlgudwns11', 'tao7', 'rishabagarwal1', 'schrock3', 'lindqui1', 'qwerasdf', None, 'wisechengyi', 'l37', 'hnandag2', 'chijiazuo', 'aggarwa3', 'dbarnes2', 'snowpd', 'joo4ny', 'aditchhabra', 'shin44', 'idesis1', 'weichunan', 'nivero', 'wldavis']"
60,77,7,17,1,['drmalkovich'],5,"['atseng3', 'kumar28', 'kdearnl2', 'dhandle2', 'faorlando']",16,"['kartiksanghi', 'likpok', 'pitrak1', 'arappep2', 'efilli2', None, 'madikaz', 'kknapp', 'cjohns78', 'snowpd', 'tongcheng', 'caldero1', 'namanmehta', 'seanlee14', 'kdko2', 'gbergsc2']",22,"['kdearnl2', 'kartiksanghi', 'likpok', 'pitrak1', 'madikaz', 'dhandle2', 'kknapp', 'drmalkovich', 'caldero1', 'namanmehta', 'cjohns78', None, 'atseng3', 'kumar28', 'arappep2', 'efilli2', 'snowpd', 'tongcheng', 'faorlando', 'seanlee14', 'kdko2', 'gbergsc2']"
60,61,7,15,3,"['atseng3', 'kdearnl2', 'dhandle2']",3,"['drmalkovich', 'faorlando', 'kumar28']",12,"['ageorges', 'hochan5', 'meliu2', 'rosboro1', 'daguri87', 'charishma', 'ymoon4', 'boruichen', 'roylee3', 'berndbhuber', 'lebedow1', None]",18,"['kdearnl2', 'hochan5', 'meliu2', 'dhandle2', 'drmalkovich', 'boruichen', 'roylee3', 'lebedow1', None, 'ageorges', 'atseng3', 'kumar28', 'rosboro1', 'daguri87', 'ymoon4', 'berndbhuber', 'charishma', 'faorlando']"
61,140,7,8,2,"['dariomagnani', 'sergiocontino']",4,"['lodeloray', 'simone', 'mattiap', 'triky']",6,"['foia87', 'zannoni_luca', 'vaka85', 'rafder', None, 'paolofiorini']",12,"['foia87', 'zannoni_luca', 'triky', 'vaka85', None, 'dariomagnani', 'simone', 'sergiocontino', 'rafder', 'lodeloray', 'mattiap', 'paolofiorini']"
61,141,7,8,4,"['lodeloray', 'simone', 'mattiap', 'triky']",2,"['dariomagnani', 'sergiocontino']",4,"['vincenzozambianchi', None, 'philip', 'biondo']",10,"['vincenzozambianchi', 'triky', 'biondo', 'philip', None, 'dariomagnani', 'simone', 'sergiocontino', 'lodeloray', 'mattiap']"
61,159,7,8,2,"['dariomagnani', 'sergiocontino']",4,"['lodeloray', 'simone', 'mattiap', 'triky']",6,"['foia87', 'zannoni_luca', 'vaka85', 'rafder', None, 'paolofiorini']",12,"['foia87', 'zannoni_luca', 'triky', 'vaka85', None, 'dariomagnani', 'simone', 'sergiocontino', 'rafder', 'lodeloray', 'mattiap', 'paolofiorini']"
61,160,7,8,4,"['lodeloray', 'simone', 'mattiap', 'triky']",2,"['dariomagnani', 'sergiocontino']",4,"['vincenzozambianchi', None, 'philip', 'biondo']",10,"['vincenzozambianchi', 'triky', 'biondo', 'philip', None, 'dariomagnani', 'simone', 'sergiocontino', 'lodeloray', 'mattiap']"
62,3,7,28,1,['avalluru'],5,"['nomissimon', 'smarjeet', 'ankithatalkar', 'naidu123', 'theagape']",27,"['ishsman', 'hankh825', 'agurram', 'msalmani', 'rataniitm', 'cxsmith', 'jain28', 'zhenghuili', 'ziyunlong', 'gu0', 'bcurrie', 'svanderl', 'lzentner', None, 'inkatech', 'owensec', 'myokem', 'chut', 'lu116', 'pbyers', 'safavih', 'jhunsber', 'huang162', 'ruzz311', 'kim660', 'dlopez', 'ashir23bom']",33,"['agurram', 'ziyunlong', 'gu0', 'bcurrie', 'avalluru', 'theagape', 'owensec', 'nomissimon', 'chut', 'lu116', 'safavih', 'smarjeet', 'ruzz311', 'dlopez', 'naidu123', 'ashir23bom', 'ishsman', 'hankh825', 'msalmani', 'rataniitm', 'cxsmith', 'jain28', 'zhenghuili', 'svanderl', 'lzentner', None, 'inkatech', 'myokem', 'pbyers', 'jhunsber', 'huang162', 'ankithatalkar', 'kim660']"
63,36,7,13,6,"['yuyaowang', 'sagarjcec78', 'tjgareg', 'gladysh', 'abhilashb7', 'jogden12']",0,[],7,"['ssahmed', 'yashvanth86', 'preethit', 'abdmen163', 'mathnerd29', None, 'vamsi']",13,"['yuyaowang', 'tjgareg', 'abdmen163', 'mathnerd29', 'abhilashb7', 'jogden12', None, 'vamsi', 'yashvanth86', 'sagarjcec78', 'gladysh', 'preethit', 'ssahmed']"
63,88,7,12,4,"['sagarjcec78', 'abhilashb7', 'jogden12', 'gladysh']",2,"['tjgareg', 'yuyaowang']",8,"['ramya86', None, 'glarose', 'preethit', 'scotos', 'mahanth_nani', 'yashvanth86', 'azizjiwani123']",14,"['yuyaowang', 'ramya86', 'tjgareg', 'mahanth_nani', 'abhilashb7', 'jogden12', None, 'sagarjcec78', 'gladysh', 'glarose', 'preethit', 'scotos', 'yashvanth86', 'azizjiwani123']"
63,111,7,11,4,"['sagarjcec78', 'abhilashb7', 'jogden12', 'gladysh']",2,"['tjgareg', 'yuyaowang']",7,"['yashvanth86', None, 'salsibiani', 'ky619', 'mathnerd29', 'tjmomoh1186', 'ssahmed']",13,"['yuyaowang', 'tjgareg', 'mathnerd29', 'abhilashb7', 'jogden12', None, 'yashvanth86', 'sagarjcec78', 'gladysh', 'salsibiani', 'ky619', 'tjmomoh1186', 'ssahmed']"
63,171,7,11,5,"['sagarjcec78', 'tjgareg', 'gladysh', 'abhilashb7', 'jogden12']",1,['yuyaowang'],6,"['yashvanth86', 'aziz_jivani', 'preethit', 'mathnerd29', 'mahanth_nani', None]",12,"['yuyaowang', 'tjgareg', 'mathnerd29', 'mahanth_nani', 'abhilashb7', 'jogden12', None, 'sagarjcec78', 'aziz_jivani', 'gladysh', 'preethit', 'yashvanth86']"
63,177,7,11,6,"['yuyaowang', 'sagarjcec78', 'tjgareg', 'gladysh', 'abhilashb7', 'jogden12']",0,[],5,"['salsibiani', 'preethit', 'tjmomoh1186', 'mahanth_nani', None]",11,"['yuyaowang', 'tjgareg', 'mahanth_nani', 'abhilashb7', 'jogden12', None, 'sagarjcec78', 'gladysh', 'preethit', 'salsibiani', 'tjmomoh1186']"
71,49,6,6,2,"['loroger1', 'dradclif']",3,"['konung', 'josephroberts', 'fabriciort']",4,"['gba', None, 'cm', 'wrichardchung']",9,"['josephroberts', 'cm', 'loroger1', 'dradclif', 'konung', 'gba', 'fabriciort', 'wrichardchung', None]"
72,121,6,7,3,"['chaiyun31', 'xiucheng1988', 'mandy']",2,"['scsso', 'peongkimseong']",4,"['adrianfooutar', None, 'john5369', 'solo012']",9,"['chaiyun31', 'xiucheng1988', 'peongkimseong', 'scsso', 'solo012', 'adrianfooutar', 'john5369', None, 'mandy']"
73,52,6,9,5,"['luyy1987', 'lifeofmg', 'janderson64', 'spatil9', 'mguerick']",0,[],4,"[None, 'jcpoler', 'mikeguericke', 'bhbesb']",9,"['luyy1987', 'jcpoler', 'lifeofmg', 'janderson64', 'mikeguericke', 'bhbesb', 'spatil9', None, 'mguerick']"
77,105,6,8,4,"['raul_chipana', 'fsmarranghello', 'awjunior', 'filipeaguiar']",1,['burenkov'],4,"[None, 'tiagoreimann', 'guilherme_09', 'gabrielborges']",9,"['fsmarranghello', 'tiagoreimann', 'guilherme_09', 'gabrielborges', 'raul_chipana', 'awjunior', 'filipeaguiar', 'burenkov', None]"
80,2,6,32,2,"['kakashow', 'hankh825']",3,"['rjbl', 'tanoue', 'hugooj2004']",30,"['agurram', 'kjkang11', 'jeresonshen', 'zchia', 'jyeoh', 'slarew', 'owensec', 'wjbennet88', 'safavih', 'ruzz311', 'akiran', 'dlopez', 'kmbaumga', 'jpurao', 'cxsmith', 'zhenghuili', 'ashraf', 'shicheng', 'lzentner', 'chang71', None, 'myokem', 'pbyers', 'ssaeedas', 'pagejl', 'mlroby', 'jhunsber', 'huang162', 'bbommai', 'adye20']",35,"['agurram', 'tanoue', 'kjkang11', 'jeresonshen', 'zchia', 'jyeoh', 'slarew', 'owensec', 'rjbl', 'wjbennet88', 'safavih', 'ruzz311', 'akiran', 'dlopez', 'kmbaumga', 'jpurao', 'hankh825', 'cxsmith', 'zhenghuili', 'ashraf', 'shicheng', 'lzentner', 'chang71', None, 'myokem', 'pbyers', 'ssaeedas', 'pagejl', 'mlroby', 'jhunsber', 'kakashow', 'huang162', 'bbommai', 'hugooj2004', 'adye20']"
80,3,6,28,1,['hankh825'],4,"['rjbl', 'tanoue', 'kakashow', 'hugooj2004']",27,"['ishsman', 'agurram', 'msalmani', 'rataniitm', 'cxsmith', 'jain28', 'zhenghuili', 'ziyunlong', 'gu0', 'bcurrie', 'svanderl', 'lzentner', None, 'avalluru', 'inkatech', 'owensec', 'myokem', 'chut', 'lu116', 'pbyers', 'safavih', 'jhunsber', 'huang162', 'ruzz311', 'kim660', 'dlopez', 'ashir23bom']",32,"['agurram', 'tanoue', 'ziyunlong', 'gu0', 'bcurrie', 'avalluru', 'owensec', 'rjbl', 'chut', 'lu116', 'safavih', 'ruzz311', 'dlopez', 'ashir23bom', 'ishsman', 'hankh825', 'msalmani', 'rataniitm', 'cxsmith', 'jain28', 'zhenghuili', 'svanderl', 'lzentner', None, 'inkatech', 'myokem', 'pbyers', 'jhunsber', 'kakashow', 'huang162', 'kim660', 'hugooj2004']"
81,15,6,13,1,['christopherborsa'],4,"['fazal', 'kevin00002', 'rock28', 'nayab']",12,"['gahoi', 'apesathi', 'canderle', 'mksharma', 'ycnayan', 'bellmanz', 'stahel', 'xjshang', 'amitgahoi143', 'angotd', 'canuckflyboy', None]",17,"['gahoi', 'apesathi', 'canderle', 'christopherborsa', 'ycnayan', 'rock28', 'stahel', 'fazal', 'xjshang', 'amitgahoi143', 'angotd', None, 'mksharma', 'bellmanz', 'nayab', 'kevin00002', 'canuckflyboy']"
