MClusterID,XClusterID,MClusterSize,XClusterSize,OverlapSize,OverlapMembers,MOnlySize,MOnlyMembers,XOnlySize,XOnlyMembers,CombinedSize,CombinedMembers
1,166,188,216,188,"['yyuchen', 'lnk645', 'nehapatel', 'achatrathi', 'eramos', 'nsp483', 'pranavspatel', 'kguo92', 'austinhunter21', 'rbattisfore', 'etran27', 'lms878', 'dis821', 'brandonstaunton', 'tywon35', 'jarnold93', 'aelliott', 'bcaldwell7', 'kerutila', 'ezuehlke322', 'dteplov', 'hvw198', 'krd450', 'johnplaxco', 'yuanxi', 'lpatel', 'ckh9393', 'clarahofeldt', 'cap292', 'cli', 'musicdude202', 'epae962', 'jbeck3r', 'lmw880', 'sakim1', 'tkp337', 'kpanchal2015', 'jrjeevarajan', 'aca821', 'courtneyam324', 'mshi', 'slabrador', 'kas617', 'clayton', 'arjunbalakumar1', 'abronder', 'asanz', 'mattfasa', 'praju1', 'drsmith93', 'cynthias361', 'rchowdhury', 'rscholes', 'yslee', 'pamurphy1', 'wdd017', 'scasteel13', 'victorquan', 'jcm112', 'cchung', 'cearap123', 'sabughnaim', 'mab729', 'kam470', 'julitroi', 'epa148', 'rgradone', 'aarohi1993', 'ckc043', 'all701', 'dchang', 'sibarra', 'jdrapekin', 'mrpika284', 'schoo', 'seungyeonseo2015', 'avyfain', 'ksz858', 'mph62293', 'kjohnson07', 'sjk423', 'eschonher', 'ajishiotaro', 'hjk342', 'karishang', 'bohanxing', 'fungerer', 'rkd406', 'cjn341', 'sab982', 'katherinekrupinski2015', 'van229', 'tnchang', 'sabinas', 'joonzzz', 'lakintilo', 'pioneer825', 'shreder2b', 'rld391', 'smd622', 'prasanth92', 'yunkatherine', 'psb481', 'jsprice23', 'skim049', 'lolitschen', 'pchenji', 'jpadgen', 'bschmitz', 'jefrandolig228', 'ka23te', 'adonaldson', 'aorwasher', 'sep285', 'smortensen', 'ashaff993', 'mnathal', 'ta101', 'tkaltenecker', 'jackmo1993', 'jrr998', 'hgr752', 'akcarlson420', 'nwalia', 'clehman', 'jennadiaz', 'drc716', 'msazo', 'cac559', 'sverma', 'devoraisseroff2015', 'vrc965', 'udesai93', 'vincericola44', 'youjinlee2015', 'dls977', 'mattzhou', 'shishuyao', 'erinkirton', 'gracek', 'cbh364', 'jmad593', 'sdz149', 'tmckinney', 'ethanritz2015', 'fillangrady', 'blakekidd2015', 'nzaporski', 'palakpatel2015', 'kgreenberg360', 'violaplayer75', 'bherrick', 'dhuang333', 'mantzouj', 'nanohub88', 'bdt015', 'asipher', 'nitestars', 'sirseven', 'alorenzaucentre', 'cbinkley1', 'jcg786', 'jooi', 'kristil93', 'oopascual2', 'rat815', 'kikkaviki', 'noahnuta', 'henrikwesterkam', 'vincentkenny', 'bretth444', 'mdk016', 'tslater13', 'sotirioskarathanasis', 'shussaini', 'rjackson', 'okeowoolatunde', 'jli7', 'dianaleatha', 's2rach', 'spencerjsaldana', 'jcy197', 'mab497', 'maraikar', 'frandolig268', 'haddenklima', 'jtizzelfoshizzel', 'dmarks']",0,[],28,"['abchinen', 'achalasani11', 'kkm195', 'anvarelas', 'dlf575', 'laurenk', 'robertbarnes', 'nym3t5fan', 'achalasani', 'mnobrien', 'wbao2', 'leonardiszekely', 'aznchristian', 'kgancedo', 'ali.falouji', 'prarthana.dalal', 'kcwikla', 'trekkiegus', 'cto324', 'al.johri', 'bugmenot', 'fergusma', 'jnb385', 'mgm54', 'slhatch', 'nickpic90', 'mkim1025', 'rparrillo']",216,"['yyuchen', 'lnk645', 'nehapatel', 'achatrathi', 'eramos', 'nsp483', 'pranavspatel', 'rbattisfore', 'etran27', 'dis821', 'brandonstaunton', 'kerutila', 'johnplaxco', 'ckh9393', 'clarahofeldt', 'cto324', 'lmw880', 'sakim1', 'tkp337', 'kpanchal2015', 'jnb385', 'mshi', 'slabrador', 'kas617', 'rparrillo', 'mattfasa', 'drsmith93', 'scasteel13', 'robertbarnes', 'cchung', 'cearap123', 'julitroi', 'wbao2', 'rgradone', 'all701', 'aznchristian', 'dchang', 'jdrapekin', 'avyfain', 'sjk423', 'karishang', 'bohanxing', 'fungerer', 'rkd406', 'cjn341', 'katherinekrupinski2015', 'van229', 'tnchang', 'lakintilo', 'pioneer825', 'shreder2b', 'smd622', 'prasanth92', 'psb481', 'jsprice23', 'lolitschen', 'bschmitz', 'jefrandolig228', 'ka23te', 'dlf575', 'adonaldson', 'smortensen', 'mnathal', 'tkaltenecker', 'achalasani', 'mnobrien', 'hgr752', 'akcarlson420', 'ali.falouji', 'nwalia', 'jennadiaz', 'drc716', 'msazo', 'sverma', 'udesai93', 'vincericola44', 'mattzhou', 'shishuyao', 'gracek', 'mgm54', 'cbh364', 'sdz149', 'abchinen', 'nzaporski', 'bherrick', 'kgreenberg360', 'violaplayer75', 'asipher', 'cbinkley1', 'jcg786', 'jooi', 'kristil93', 'oopascual2', 'leonardiszekely', 'kgancedo', 'kikkaviki', 'noahnuta', 'henrikwesterkam', 'bretth444', 'okeowoolatunde', 'jli7', 'dianaleatha', 's2rach', 'fergusma', 'slhatch', 'nickpic90', 'haddenklima', 'jtizzelfoshizzel', 'kguo92', 'austinhunter21', 'lms878', 'nym3t5fan', 'tywon35', 'jarnold93', 'aelliott', 'bcaldwell7', 'ezuehlke322', 'dteplov', 'hvw198', 'krd450', 'yuanxi', 'kcwikla', 'lpatel', 'cap292', 'cli', 'musicdude202', 'epae962', 'jbeck3r', 'jrjeevarajan', 'aca821', 'courtneyam324', 'clayton', 'arjunbalakumar1', 'abronder', 'asanz', 'praju1', 'kkm195', 'cynthias361', 'rchowdhury', 'rscholes', 'yslee', 'pamurphy1', 'wdd017', 'laurenk', 'victorquan', 'jcm112', 'sabughnaim', 'mab729', 'kam470', 'epa148', 'aarohi1993', 'ckc043', 'sibarra', 'mrpika284', 'schoo', 'seungyeonseo2015', 'ksz858', 'kjohnson07', 'mph62293', 'eschonher', 'ajishiotaro', 'hjk342', 'trekkiegus', 'sab982', 'sabinas', 'joonzzz', 'rld391', 'yunkatherine', 'skim049', 'pchenji', 'jpadgen', 'aorwasher', 'sep285', 'ashaff993', 'ta101', 'jackmo1993', 'jrr998', 'clehman', 'prarthana.dalal', 'cac559', 'devoraisseroff2015', 'vrc965', 'youjinlee2015', 'dls977', 'al.johri', 'bugmenot', 'erinkirton', 'jmad593', 'tmckinney', 'ethanritz2015', 'achalasani11', 'fillangrady', 'blakekidd2015', 'palakpatel2015', 'dhuang333', 'anvarelas', 'mantzouj', 'nanohub88', 'bdt015', 'nitestars', 'sirseven', 'alorenzaucentre', 'rat815', 'vincentkenny', 'mdk016', 'tslater13', 'sotirioskarathanasis', 'shussaini', 'rjackson', 'spencerjsaldana', 'jcy197', 'mab497', 'mkim1025', 'maraikar', 'frandolig268', 'dmarks']"
1,118,188,177,170,"['lnk645', 'yyuchen', 'nehapatel', 'achatrathi', 'eramos', 'nsp483', 'pranavspatel', 'kguo92', 'austinhunter21', 'rbattisfore', 'etran27', 'lms878', 'dis821', 'brandonstaunton', 'tywon35', 'jarnold93', 'aelliott', 'bcaldwell7', 'ezuehlke322', 'kerutila', 'dteplov', 'hvw198', 'krd450', 'johnplaxco', 'yuanxi', 'ckh9393', 'clarahofeldt', 'cap292', 'cli', 'epae962', 'musicdude202', 'jbeck3r', 'lmw880', 'sakim1', 'kpanchal2015', 'jrjeevarajan', 'courtneyam324', 'mshi', 'slabrador', 'kas617', 'clayton', 'arjunbalakumar1', 'abronder', 'mattfasa', 'asanz', 'praju1', 'drsmith93', 'cynthias361', 'rchowdhury', 'rscholes', 'yslee', 'pamurphy1', 'wdd017', 'scasteel13', 'victorquan', 'jcm112', 'cearap123', 'cchung', 'sabughnaim', 'mab729', 'kam470', 'epa148', 'rgradone', 'aarohi1993', 'ckc043', 'all701', 'dchang', 'sibarra', 'jdrapekin', 'mrpika284', 'schoo', 'seungyeonseo2015', 'avyfain', 'ksz858', 'kjohnson07', 'mph62293', 'sjk423', 'eschonher', 'ajishiotaro', 'hjk342', 'karishang', 'bohanxing', 'rkd406', 'cjn341', 'sab982', 'katherinekrupinski2015', 'van229', 'tnchang', 'joonzzz', 'sabinas', 'lakintilo', 'pioneer825', 'shreder2b', 'smd622', 'prasanth92', 'yunkatherine', 'jsprice23', 'skim049', 'lolitschen', 'pchenji', 'jpadgen', 'bschmitz', 'jefrandolig228', 'ka23te', 'adonaldson', 'aorwasher', 'sep285', 'smortensen', 'mnathal', 'tkaltenecker', 'jrr998', 'akcarlson420', 'hgr752', 'nwalia', 'msazo', 'cac559', 'sverma', 'devoraisseroff2015', 'vrc965', 'udesai93', 'vincericola44', 'youjinlee2015', 'dls977', 'shishuyao', 'mattzhou', 'erinkirton', 'gracek', 'cbh364', 'jmad593', 'sdz149', 'tmckinney', 'ethanritz2015', 'blakekidd2015', 'bherrick', 'nzaporski', 'palakpatel2015', 'violaplayer75', 'dhuang333', 'kgreenberg360', 'mantzouj', 'nanohub88', 'bdt015', 'asipher', 'nitestars', 'sirseven', 'alorenzaucentre', 'jcg786', 'jooi', 'kristil93', 'oopascual2', 'rat815', 'kikkaviki', 'henrikwesterkam', 'bretth444', 'mdk016', 'tslater13', 'sotirioskarathanasis', 'shussaini', 'rjackson', 'okeowoolatunde', 'jli7', 's2rach', 'dianaleatha', 'spencerjsaldana', 'jcy197', 'mab497', 'maraikar', 'haddenklima', 'jtizzelfoshizzel', 'dmarks']",18,"['ashaff993', 'psb481', 'fillangrady', 'jennadiaz', 'drc716', 'lpatel', 'julitroi', 'ta101', 'rld391', 'cbinkley1', 'tkp337', 'frandolig268', 'jackmo1993', 'fungerer', 'aca821', 'noahnuta', 'vincentkenny', 'clehman']",7,"['bugmenot', 'xzong', 'hmannam', None, 'melissa', 'ssy387', 'rdb040']",195,"['yyuchen', 'lnk645', 'nehapatel', 'achatrathi', 'eramos', 'nsp483', 'pranavspatel', 'rbattisfore', 'etran27', 'dis821', 'brandonstaunton', 'kerutila', 'ssy387', 'johnplaxco', 'ckh9393', 'clarahofeldt', 'lmw880', 'sakim1', 'tkp337', 'kpanchal2015', 'mshi', 'slabrador', 'kas617', 'mattfasa', 'drsmith93', 'scasteel13', 'cchung', 'cearap123', 'julitroi', 'rgradone', 'all701', 'dchang', 'jdrapekin', 'avyfain', 'sjk423', 'karishang', 'bohanxing', 'fungerer', 'rkd406', 'cjn341', 'katherinekrupinski2015', 'van229', 'tnchang', 'lakintilo', 'pioneer825', 'shreder2b', 'smd622', 'rdb040', 'prasanth92', 'psb481', 'jsprice23', 'lolitschen', 'bschmitz', 'jefrandolig228', 'ka23te', 'adonaldson', 'smortensen', 'mnathal', 'tkaltenecker', 'hgr752', 'akcarlson420', 'nwalia', 'jennadiaz', 'drc716', 'msazo', 'sverma', 'udesai93', 'vincericola44', 'mattzhou', 'shishuyao', 'gracek', 'cbh364', 'sdz149', 'nzaporski', 'bherrick', 'kgreenberg360', 'violaplayer75', 'asipher', 'cbinkley1', 'jcg786', 'jooi', 'kristil93', 'oopascual2', 'kikkaviki', 'noahnuta', 'henrikwesterkam', 'bretth444', 'okeowoolatunde', None, 'jli7', 'dianaleatha', 's2rach', 'haddenklima', 'jtizzelfoshizzel', 'kguo92', 'austinhunter21', 'lms878', 'tywon35', 'jarnold93', 'aelliott', 'bcaldwell7', 'ezuehlke322', 'melissa', 'dteplov', 'hvw198', 'krd450', 'yuanxi', 'lpatel', 'cap292', 'cli', 'musicdude202', 'epae962', 'jbeck3r', 'jrjeevarajan', 'aca821', 'courtneyam324', 'clayton', 'arjunbalakumar1', 'abronder', 'asanz', 'praju1', 'cynthias361', 'rchowdhury', 'rscholes', 'yslee', 'pamurphy1', 'wdd017', 'victorquan', 'jcm112', 'sabughnaim', 'mab729', 'kam470', 'epa148', 'aarohi1993', 'ckc043', 'sibarra', 'mrpika284', 'schoo', 'seungyeonseo2015', 'ksz858', 'kjohnson07', 'mph62293', 'eschonher', 'ajishiotaro', 'hjk342', 'sab982', 'sabinas', 'joonzzz', 'rld391', 'yunkatherine', 'skim049', 'pchenji', 'jpadgen', 'aorwasher', 'sep285', 'ashaff993', 'ta101', 'jackmo1993', 'jrr998', 'clehman', 'cac559', 'devoraisseroff2015', 'vrc965', 'youjinlee2015', 'dls977', 'bugmenot', 'erinkirton', 'jmad593', 'tmckinney', 'ethanritz2015', 'fillangrady', 'blakekidd2015', 'palakpatel2015', 'dhuang333', 'mantzouj', 'nanohub88', 'bdt015', 'nitestars', 'sirseven', 'alorenzaucentre', 'rat815', 'vincentkenny', 'mdk016', 'tslater13', 'sotirioskarathanasis', 'shussaini', 'rjackson', 'xzong', 'spencerjsaldana', 'jcy197', 'mab497', 'maraikar', 'frandolig268', 'hmannam', 'dmarks']"
1,46,188,161,149,"['yyuchen', 'nehapatel', 'achatrathi', 'eramos', 'nsp483', 'pranavspatel', 'kguo92', 'austinhunter21', 'rbattisfore', 'etran27', 'lms878', 'brandonstaunton', 'tywon35', 'jarnold93', 'aelliott', 'bcaldwell7', 'ezuehlke322', 'kerutila', 'dteplov', 'hvw198', 'krd450', 'yuanxi', 'ckh9393', 'lpatel', 'clarahofeldt', 'cap292', 'epae962', 'musicdude202', 'tkp337', 'kpanchal2015', 'aca821', 'courtneyam324', 'mshi', 'kas617', 'clayton', 'abronder', 'drsmith93', 'cynthias361', 'rchowdhury', 'rscholes', 'yslee', 'pamurphy1', 'wdd017', 'scasteel13', 'victorquan', 'cchung', 'mab729', 'kam470', 'julitroi', 'epa148', 'rgradone', 'aarohi1993', 'ckc043', 'all701', 'dchang', 'sibarra', 'jdrapekin', 'seungyeonseo2015', 'avyfain', 'ksz858', 'mph62293', 'sjk423', 'eschonher', 'ajishiotaro', 'hjk342', 'karishang', 'bohanxing', 'fungerer', 'rkd406', 'cjn341', 'sab982', 'van229', 'tnchang', 'sabinas', 'lakintilo', 'pioneer825', 'rld391', 'smd622', 'prasanth92', 'yunkatherine', 'jsprice23', 'psb481', 'lolitschen', 'pchenji', 'jpadgen', 'bschmitz', 'jefrandolig228', 'ka23te', 'adonaldson', 'aorwasher', 'sep285', 'smortensen', 'ashaff993', 'mnathal', 'jackmo1993', 'jrr998', 'akcarlson420', 'hgr752', 'nwalia', 'clehman', 'jennadiaz', 'drc716', 'msazo', 'cac559', 'sverma', 'udesai93', 'vincericola44', 'mattzhou', 'cbh364', 'sdz149', 'tmckinney', 'ethanritz2015', 'fillangrady', 'blakekidd2015', 'bherrick', 'nzaporski', 'palakpatel2015', 'violaplayer75', 'kgreenberg360', 'mantzouj', 'nanohub88', 'bdt015', 'asipher', 'nitestars', 'sirseven', 'alorenzaucentre', 'cbinkley1', 'jcg786', 'jooi', 'oopascual2', 'rat815', 'kikkaviki', 'noahnuta', 'henrikwesterkam', 'vincentkenny', 'bretth444', 'tslater13', 'sotirioskarathanasis', 'shussaini', 'okeowoolatunde', 'jli7', 'dianaleatha', 'spencerjsaldana', 'jcy197', 'mab497', 'maraikar', 'frandolig268', 'jtizzelfoshizzel', 'dmarks']",39,"['lnk645', 'arjunbalakumar1', 'skim049', 'asanz', 'mattfasa', 'praju1', 'dhuang333', 'jcm112', 'cearap123', 'sabughnaim', 'kristil93', 'ta101', 'tkaltenecker', 'dis821', 'mrpika284', 'schoo', 'kjohnson07', 'johnplaxco', 'mdk016', 'cli', 'rjackson', 'devoraisseroff2015', 'vrc965', 'jbeck3r', 'katherinekrupinski2015', 'youjinlee2015', 'dls977', 'lmw880', 's2rach', 'sakim1', 'shishuyao', 'erinkirton', 'joonzzz', 'gracek', 'shreder2b', 'jmad593', 'jrjeevarajan', 'haddenklima', 'slabrador']",12,"['omalleys4', 'bugmenot', 'adarsh172', 'hmannam', 'xzong', 'gretskyw', None, 'alexesanz', 'bcan14', 'melissa', 'ssy387', 'rdb040']",200,"['yyuchen', 'lnk645', 'nehapatel', 'achatrathi', 'eramos', 'nsp483', 'pranavspatel', 'rbattisfore', 'etran27', 'dis821', 'brandonstaunton', 'kerutila', 'ssy387', 'johnplaxco', 'ckh9393', 'clarahofeldt', 'lmw880', 'sakim1', 'tkp337', 'kpanchal2015', 'mshi', 'slabrador', 'kas617', 'mattfasa', 'drsmith93', 'scasteel13', 'cchung', 'cearap123', 'julitroi', 'rgradone', 'all701', 'dchang', 'jdrapekin', 'avyfain', 'sjk423', 'karishang', 'bohanxing', 'fungerer', 'rkd406', 'cjn341', 'bcan14', 'katherinekrupinski2015', 'van229', 'tnchang', 'lakintilo', 'pioneer825', 'shreder2b', 'smd622', 'rdb040', 'prasanth92', 'psb481', 'jsprice23', 'lolitschen', 'bschmitz', 'jefrandolig228', 'ka23te', 'adonaldson', 'smortensen', 'mnathal', 'tkaltenecker', 'hgr752', 'akcarlson420', 'nwalia', 'jennadiaz', 'drc716', 'msazo', 'sverma', 'udesai93', 'vincericola44', 'mattzhou', 'shishuyao', 'gracek', 'cbh364', 'sdz149', 'nzaporski', 'bherrick', 'kgreenberg360', 'violaplayer75', 'asipher', 'cbinkley1', 'jcg786', 'jooi', 'kristil93', 'oopascual2', 'gretskyw', 'kikkaviki', 'noahnuta', 'henrikwesterkam', 'bretth444', 'okeowoolatunde', None, 'jli7', 'dianaleatha', 's2rach', 'haddenklima', 'jtizzelfoshizzel', 'kguo92', 'austinhunter21', 'lms878', 'tywon35', 'jarnold93', 'aelliott', 'bcaldwell7', 'ezuehlke322', 'melissa', 'dteplov', 'hvw198', 'krd450', 'yuanxi', 'lpatel', 'cap292', 'cli', 'musicdude202', 'epae962', 'jbeck3r', 'jrjeevarajan', 'aca821', 'courtneyam324', 'clayton', 'arjunbalakumar1', 'abronder', 'asanz', 'praju1', 'cynthias361', 'rchowdhury', 'rscholes', 'yslee', 'pamurphy1', 'wdd017', 'victorquan', 'jcm112', 'sabughnaim', 'mab729', 'kam470', 'epa148', 'aarohi1993', 'ckc043', 'sibarra', 'mrpika284', 'schoo', 'seungyeonseo2015', 'ksz858', 'kjohnson07', 'mph62293', 'adarsh172', 'eschonher', 'ajishiotaro', 'hjk342', 'sab982', 'sabinas', 'joonzzz', 'rld391', 'yunkatherine', 'skim049', 'pchenji', 'jpadgen', 'aorwasher', 'sep285', 'ashaff993', 'ta101', 'jackmo1993', 'jrr998', 'clehman', 'cac559', 'devoraisseroff2015', 'vrc965', 'youjinlee2015', 'dls977', 'bugmenot', 'erinkirton', 'jmad593', 'tmckinney', 'ethanritz2015', 'fillangrady', 'blakekidd2015', 'palakpatel2015', 'dhuang333', 'mantzouj', 'nanohub88', 'bdt015', 'alexesanz', 'nitestars', 'sirseven', 'alorenzaucentre', 'omalleys4', 'rat815', 'vincentkenny', 'mdk016', 'tslater13', 'sotirioskarathanasis', 'shussaini', 'rjackson', 'xzong', 'spencerjsaldana', 'jcy197', 'mab497', 'maraikar', 'frandolig268', 'hmannam', 'dmarks']"
1,116,188,13,3,"['ta101', 'julitroi', 'noahnuta']",185,"['yyuchen', 'lnk645', 'nehapatel', 'achatrathi', 'eramos', 'nsp483', 'pranavspatel', 'kguo92', 'austinhunter21', 'rbattisfore', 'lms878', 'etran27', 'dis821', 'brandonstaunton', 'tywon35', 'jarnold93', 'aelliott', 'bcaldwell7', 'kerutila', 'ezuehlke322', 'dteplov', 'hvw198', 'krd450', 'johnplaxco', 'yuanxi', 'lpatel', 'ckh9393', 'clarahofeldt', 'cap292', 'cli', 'musicdude202', 'epae962', 'jbeck3r', 'lmw880', 'sakim1', 'tkp337', 'kpanchal2015', 'jrjeevarajan', 'aca821', 'courtneyam324', 'mshi', 'slabrador', 'kas617', 'clayton', 'arjunbalakumar1', 'abronder', 'asanz', 'mattfasa', 'praju1', 'drsmith93', 'cynthias361', 'rchowdhury', 'rscholes', 'yslee', 'pamurphy1', 'wdd017', 'scasteel13', 'victorquan', 'jcm112', 'cchung', 'cearap123', 'sabughnaim', 'mab729', 'kam470', 'epa148', 'rgradone', 'aarohi1993', 'ckc043', 'all701', 'dchang', 'sibarra', 'jdrapekin', 'mrpika284', 'schoo', 'seungyeonseo2015', 'avyfain', 'ksz858', 'mph62293', 'kjohnson07', 'sjk423', 'eschonher', 'ajishiotaro', 'hjk342', 'karishang', 'bohanxing', 'fungerer', 'rkd406', 'cjn341', 'sab982', 'katherinekrupinski2015', 'van229', 'tnchang', 'sabinas', 'joonzzz', 'lakintilo', 'pioneer825', 'shreder2b', 'rld391', 'smd622', 'prasanth92', 'yunkatherine', 'psb481', 'jsprice23', 'skim049', 'lolitschen', 'pchenji', 'jpadgen', 'bschmitz', 'jefrandolig228', 'ka23te', 'adonaldson', 'aorwasher', 'sep285', 'smortensen', 'ashaff993', 'mnathal', 'tkaltenecker', 'jackmo1993', 'jrr998', 'hgr752', 'akcarlson420', 'nwalia', 'clehman', 'jennadiaz', 'drc716', 'msazo', 'cac559', 'sverma', 'devoraisseroff2015', 'vrc965', 'udesai93', 'vincericola44', 'youjinlee2015', 'dls977', 'mattzhou', 'shishuyao', 'erinkirton', 'gracek', 'cbh364', 'jmad593', 'sdz149', 'tmckinney', 'ethanritz2015', 'fillangrady', 'blakekidd2015', 'nzaporski', 'palakpatel2015', 'kgreenberg360', 'violaplayer75', 'bherrick', 'dhuang333', 'mantzouj', 'nanohub88', 'bdt015', 'asipher', 'nitestars', 'sirseven', 'alorenzaucentre', 'cbinkley1', 'jcg786', 'jooi', 'kristil93', 'oopascual2', 'rat815', 'kikkaviki', 'henrikwesterkam', 'vincentkenny', 'bretth444', 'mdk016', 'tslater13', 'sotirioskarathanasis', 'shussaini', 'rjackson', 'okeowoolatunde', 'jli7', 'dianaleatha', 's2rach', 'spencerjsaldana', 'jcy197', 'mab497', 'maraikar', 'frandolig268', 'haddenklima', 'jtizzelfoshizzel', 'dmarks']",10,"['cgeorge1', 'twilightdream37', 'bspoka', 'zrimsekab', 'lysslyss11', 'draconian144', 'mnobrien', 'leonardiszekely', 'butler464', None]",198,"['yyuchen', 'lnk645', 'nehapatel', 'achatrathi', 'lysslyss11', 'eramos', 'nsp483', 'pranavspatel', 'kguo92', 'butler464', 'austinhunter21', 'rbattisfore', 'lms878', 'etran27', 'dis821', 'brandonstaunton', 'tywon35', 'jarnold93', 'aelliott', 'bcaldwell7', 'kerutila', 'ezuehlke322', 'dteplov', 'hvw198', 'krd450', 'johnplaxco', 'yuanxi', 'twilightdream37', 'lpatel', 'ckh9393', 'clarahofeldt', 'cap292', 'cli', 'musicdude202', 'epae962', 'jbeck3r', 'lmw880', 'sakim1', 'tkp337', 'kpanchal2015', 'jrjeevarajan', 'aca821', 'courtneyam324', 'mshi', 'slabrador', 'kas617', 'clayton', 'arjunbalakumar1', 'abronder', 'asanz', 'mattfasa', 'praju1', 'drsmith93', 'cynthias361', 'rchowdhury', 'rscholes', 'yslee', 'pamurphy1', 'wdd017', 'scasteel13', 'victorquan', 'jcm112', 'cchung', 'cearap123', 'sabughnaim', 'mab729', 'kam470', 'julitroi', 'epa148', 'rgradone', 'aarohi1993', 'ckc043', 'all701', 'dchang', 'sibarra', 'jdrapekin', 'mrpika284', 'schoo', 'seungyeonseo2015', 'avyfain', 'ksz858', 'mph62293', 'kjohnson07', 'sjk423', 'eschonher', 'ajishiotaro', 'hjk342', 'karishang', 'bohanxing', 'fungerer', 'rkd406', 'cjn341', 'sab982', 'katherinekrupinski2015', 'van229', 'tnchang', 'sabinas', 'joonzzz', 'lakintilo', 'pioneer825', 'shreder2b', 'rld391', 'smd622', 'cgeorge1', 'prasanth92', 'yunkatherine', 'psb481', 'jsprice23', 'skim049', 'lolitschen', 'pchenji', 'jpadgen', 'bschmitz', 'jefrandolig228', 'ka23te', 'adonaldson', 'aorwasher', 'sep285', 'smortensen', 'ashaff993', 'mnathal', 'ta101', 'tkaltenecker', 'draconian144', 'mnobrien', 'jackmo1993', 'jrr998', 'hgr752', 'akcarlson420', 'nwalia', 'clehman', 'jennadiaz', 'drc716', 'msazo', 'cac559', 'sverma', 'devoraisseroff2015', 'vrc965', 'udesai93', 'vincericola44', 'youjinlee2015', 'dls977', 'mattzhou', 'shishuyao', 'erinkirton', 'gracek', 'cbh364', 'jmad593', 'sdz149', 'tmckinney', 'ethanritz2015', 'fillangrady', 'blakekidd2015', 'nzaporski', 'palakpatel2015', 'kgreenberg360', 'violaplayer75', 'bherrick', 'dhuang333', 'mantzouj', 'nanohub88', 'bdt015', 'asipher', 'nitestars', 'sirseven', 'alorenzaucentre', 'cbinkley1', 'jcg786', 'bspoka', 'jooi', 'kristil93', 'zrimsekab', 'oopascual2', 'rat815', 'leonardiszekely', 'kikkaviki', 'noahnuta', 'henrikwesterkam', 'vincentkenny', 'bretth444', 'mdk016', 'tslater13', 'sotirioskarathanasis', 'shussaini', 'rjackson', 'okeowoolatunde', None, 'jli7', 'dianaleatha', 's2rach', 'spencerjsaldana', 'jcy197', 'mab497', 'maraikar', 'frandolig268', 'haddenklima', 'jtizzelfoshizzel', 'dmarks']"
2,53,146,122,86,"['adamwright08', 'wells8', 'sonicbro', 'landin', 'onay91', 'jashari1', 'lawrenceli', 'tom69sawyer', 'mwang53', 'ahasija2', 'lmendez2', 'khaostehnoob', 'scarlett', 'wheele11', 'godofdeath', 'mccann4', 'fluxayh', 'azure3t', 'kim325', 'profballack', 'dinger104', 'yuan10', 'ededens', 'shah19', 'wolf13', 'takagi1', 'assem2', 'young10', 'kantner1', 'garcias1', 'zstone2', 'rturner', 'chanj45', 'choquet1', 'kylekalk', 'shah4u19', 'kong7', 'awesly2', 'leijin3', 'danyangzhuo', 'searuff', 'digitalmouse12', 'lincoln5', 'v3lox', 'dtoome2', 'jacobs25', 'yuqili1', 'predatorhunter51', 'cfranc20', 'hanbacca', 'yurilee2', 'pniemer2', 'wang212', 'adoboluver', 'josephxu', 'stanzzang', 'zhuxh529', 'zson2', 'sundstr2', 'bredemer', 'b3nny312', 'zhang155', 'isankar21', 'yohanko322', 'rose4', 'rooney5', 'maninpat', 'roybell', 'cbarth2', 'chanda2', 'alee13', 'dmoonxp5', 'hansanderson', 'chitten1', 'kadakiy1', 'drtesla90', 'keramat1', 'kevinlooby', 'tumblesoup', 'jifeixu', 'seanyen1', 'ysun12', 'cialdel1', 'wang217', 'sungbea89', 'lylo']",59,"['gravityplanx', 'campbel3', 'convolution', 'ammario', 'caz1429', 'rkuryl2', 'anim007', 'zhu52', 'ckhuang999', 'leech060191', 'demint1', 'sebasti2', 'bilalgabula', 'mikeudelhofen', 'creepdeadly', 'dou1', 'kane11', 'seanlee14', 'frisbie1', 'chorvat2', 'jpack91', 'yan16', 'mtzcardfan08', 'jang34', 'osarenk1', 'scalise1', 'dmgo17', 'murray18', 'yinghe3', 'crisci1', 'drejmeisterdrej', 'columbine', 'bradzab', 'mkandel', 'enyuluo', 'rccarca', 'elachman', 'nicozorro31', 'brinlee2', 'rschmid2', 'bettenh1', 'andrewgrieve1', 'mattycat9000', 'lim89', 'toan52', 'fanwu1', 'vsalovnh', 'sulas2', 'sc21cn', 'mmcdow4', 'savysaville', 'pokemeng', 'yening9063', 'juliusqueezer', 'ehgma0821', 'fahmad6', 'tmalone3', 'sherlaby25', 'alee60']",36,"['ericwoo1', 'liyd', 'txia', 'sharma16', 'bae7', 'nithinreddyc', 'xiwang4', 'huang133', 'wtkarcher', 'ericwei1', 'matamor1', 'hunter_136', 'lee643', 'jacobgruber', 'tovarbr2', 'willwang0737', 'hong64', 'kulkarn3', 'conley3', 'theyubo', 'dabigpig', 'philip', 'turnbll2', 'draydenlin', 'rohanbambery', 'adammodig', 'jasperli', None, 'cfok3', 'bdlftth2', 'wang227', 'huddles1', 'mohamed', 'szazeski', 'singh29', 'ren6']",181,"['ericwoo1', 'adamwright08', 'txia', 'convolution', 'wells8', 'sonicbro', 'landin', 'singh29', 'onay91', 'wtkarcher', 'ericwei1', 'matamor1', 'mikeudelhofen', 'creepdeadly', 'kane11', 'jashari1', 'chorvat2', 'mtzcardfan08', 'lawrenceli', 'tom69sawyer', 'dmgo17', 'mwang53', 'ahasija2', 'lmendez2', 'dabigpig', 'philip', 'khaostehnoob', 'bradzab', 'scarlett', 'elachman', 'rohanbambery', 'bettenh1', 'andrewgrieve1', 'wheele11', 'cfok3', 'godofdeath', 'mccann4', 'wang227', 'fluxayh', 'azure3t', 'kim325', 'profballack', 'dinger104', 'yening9063', 'yuan10', 'pokemeng', 'fahmad6', 'ededens', 'sherlaby25', 'mohamed', 'alee60', 'szazeski', 'ren6', 'gravityplanx', 'shah19', 'wolf13', 'takagi1', 'ammario', 'bae7', 'assem2', 'kantner1', 'young10', 'garcias1', 'ckhuang999', 'zstone2', 'lee643', 'jacobgruber', 'rturner', 'tovarbr2', 'hong64', 'chanj45', 'choquet1', 'scalise1', 'kylekalk', 'shah4u19', 'kong7', 'crisci1', 'awesly2', 'leijin3', 'danyangzhuo', 'searuff', 'mkandel', 'enyuluo', 'digitalmouse12', 'rschmid2', 'lincoln5', 'v3lox', 'vsalovnh', 'dtoome2', 'mmcdow4', 'savysaville', 'jacobs25', 'tmalone3', 'yuqili1', 'predatorhunter51', 'liyd', 'caz1429', 'nithinreddyc', 'xiwang4', 'huang133', 'anim007', 'zhu52', 'cfranc20', 'leech060191', 'hanbacca', 'yurilee2', 'pniemer2', 'wang212', 'adoboluver', 'josephxu', 'dou1', 'stanzzang', 'jang34', 'conley3', 'zhuxh529', 'zson2', 'yinghe3', 'drejmeisterdrej', 'bredemer', 'sundstr2', 'columbine', 'b3nny312', 'zhang155', 'draydenlin', 'adammodig', 'isankar21', 'jasperli', 'yohanko322', 'mattycat9000', 'lim89', 'rose4', 'rooney5', 'maninpat', 'juliusqueezer', 'roybell', 'cbarth2', 'bilalgabula', 'chanda2', 'sharma16', 'alee13', 'campbel3', 'dmoonxp5', 'hansanderson', 'rkuryl2', 'demint1', 'sebasti2', 'hunter_136', 'chitten1', 'kadakiy1', 'seanlee14', 'willwang0737', 'frisbie1', 'drtesla90', 'jpack91', 'yan16', 'kulkarn3', 'osarenk1', 'keramat1', 'kevinlooby', 'theyubo', 'murray18', 'tumblesoup', 'jifeixu', 'seanyen1', 'turnbll2', 'rccarca', 'nicozorro31', 'brinlee2', 'ysun12', None, 'cialdel1', 'wang217', 'sungbea89', 'toan52', 'sulas2', 'sc21cn', 'bdlftth2', 'lylo', 'huddles1', 'ehgma0821', 'fanwu1']"
2,63,146,114,84,"['adamwright08', 'wells8', 'sonicbro', 'landin', 'onay91', 'mikeudelhofen', 'kane11', 'jashari1', 'tom69sawyer', 'dmgo17', 'ahasija2', 'lmendez2', 'khaostehnoob', 'scarlett', 'elachman', 'wheele11', 'godofdeath', 'fluxayh', 'azure3t', 'kim325', 'profballack', 'dinger104', 'ededens', 'sherlaby25', 'shah19', 'wolf13', 'takagi1', 'ammario', 'kantner1', 'young10', 'garcias1', 'rturner', 'chanj45', 'choquet1', 'scalise1', 'kylekalk', 'shah4u19', 'kong7', 'crisci1', 'leijin3', 'danyangzhuo', 'digitalmouse12', 'lincoln5', 'v3lox', 'dtoome2', 'savysaville', 'yuqili1', 'predatorhunter51', 'cfranc20', 'hanbacca', 'yurilee2', 'adoboluver', 'jang34', 'zhuxh529', 'zson2', 'bredemer', 'sundstr2', 'b3nny312', 'zhang155', 'isankar21', 'yohanko322', 'rooney5', 'maninpat', 'roybell', 'bilalgabula', 'alee13', 'dmoonxp5', 'hansanderson', 'sebasti2', 'chitten1', 'kadakiy1', 'drtesla90', 'keramat1', 'kevinlooby', 'murray18', 'tumblesoup', 'seanyen1', 'rccarca', 'ysun12', 'cialdel1', 'sungbea89', 'sulas2', 'lylo', 'ehgma0821']",61,"['chanda2', 'gravityplanx', 'campbel3', 'convolution', 'caz1429', 'assem2', 'rkuryl2', 'anim007', 'zhu52', 'ckhuang999', 'zstone2', 'leech060191', 'demint1', 'cbarth2', 'pniemer2', 'wang212', 'josephxu', 'creepdeadly', 'dou1', 'seanlee14', 'frisbie1', 'chorvat2', 'jpack91', 'yan16', 'mtzcardfan08', 'lawrenceli', 'stanzzang', 'osarenk1', 'mwang53', 'jifeixu', 'yinghe3', 'awesly2', 'drejmeisterdrej', 'columbine', 'bradzab', 'searuff', 'mkandel', 'enyuluo', 'nicozorro31', 'brinlee2', 'rschmid2', 'bettenh1', 'andrewgrieve1', 'wang217', 'mattycat9000', 'lim89', 'rose4', 'toan52', 'vsalovnh', 'fanwu1', 'mccann4', 'sc21cn', 'mmcdow4', 'pokemeng', 'yening9063', 'yuan10', 'jacobs25', 'fahmad6', 'tmalone3', 'juliusqueezer', 'alee60']",30,"['huanghewill', 'ucapssong', 'hjsong2', 'bae7', 'nithinreddyc', 'cvendi2', 'zyf7284563', 'shiou2', 'kazi1', 'shook2', 'lobert124', 'cabraal', 'ryanschuster', 'chang112', 'yin9', 'chivukula3', 'munjal2', 'sfoolgenius', 'oper321', 'smedber2', 'theyubo', 'bhuiya1', 'stewart9', None, 'wrubrec2', 'bdlftth2', 'rhein1', 'mohamed', 'vik579', 'ren6']",175,"['adamwright08', 'convolution', 'hjsong2', 'wells8', 'sonicbro', 'landin', 'zyf7284563', 'shiou2', 'onay91', 'mikeudelhofen', 'creepdeadly', 'kane11', 'jashari1', 'chorvat2', 'mtzcardfan08', 'lawrenceli', 'munjal2', 'tom69sawyer', 'dmgo17', 'mwang53', 'ahasija2', 'lmendez2', 'khaostehnoob', 'bradzab', 'scarlett', 'bhuiya1', 'elachman', 'bettenh1', 'andrewgrieve1', 'wheele11', 'godofdeath', 'mccann4', 'fluxayh', 'azure3t', 'kim325', 'profballack', 'dinger104', 'yening9063', 'yuan10', 'pokemeng', 'fahmad6', 'ededens', 'sherlaby25', 'mohamed', 'alee60', 'vik579', 'ren6', 'gravityplanx', 'shah19', 'wolf13', 'takagi1', 'ammario', 'bae7', 'assem2', 'kantner1', 'young10', 'garcias1', 'ckhuang999', 'zstone2', 'rturner', 'chanj45', 'choquet1', 'scalise1', 'kylekalk', 'sfoolgenius', 'shah4u19', 'kong7', 'crisci1', 'awesly2', 'leijin3', 'danyangzhuo', 'searuff', 'mkandel', 'enyuluo', 'digitalmouse12', 'rschmid2', 'lincoln5', 'stewart9', 'v3lox', 'wrubrec2', 'vsalovnh', 'dtoome2', 'mmcdow4', 'savysaville', 'jacobs25', 'tmalone3', 'yuqili1', 'predatorhunter51', 'huanghewill', 'ucapssong', 'caz1429', 'nithinreddyc', 'anim007', 'kazi1', 'zhu52', 'cfranc20', 'leech060191', 'hanbacca', 'yurilee2', 'pniemer2', 'lobert124', 'wang212', 'adoboluver', 'josephxu', 'cabraal', 'dou1', 'ryanschuster', 'stanzzang', 'jang34', 'zhuxh529', 'zson2', 'smedber2', 'yinghe3', 'drejmeisterdrej', 'bredemer', 'sundstr2', 'columbine', 'b3nny312', 'zhang155', 'isankar21', 'yohanko322', 'mattycat9000', 'lim89', 'rose4', 'rooney5', 'maninpat', 'juliusqueezer', 'roybell', 'cbarth2', 'bilalgabula', 'chanda2', 'alee13', 'campbel3', 'dmoonxp5', 'hansanderson', 'cvendi2', 'rkuryl2', 'demint1', 'sebasti2', 'shook2', 'chitten1', 'kadakiy1', 'seanlee14', 'frisbie1', 'drtesla90', 'jpack91', 'yan16', 'chang112', 'yin9', 'chivukula3', 'osarenk1', 'keramat1', 'kevinlooby', 'oper321', 'murray18', 'tumblesoup', 'theyubo', 'jifeixu', 'seanyen1', 'rccarca', 'nicozorro31', 'brinlee2', 'ysun12', None, 'cialdel1', 'wang217', 'sungbea89', 'toan52', 'sulas2', 'sc21cn', 'bdlftth2', 'rhein1', 'lylo', 'ehgma0821', 'fanwu1']"
2,97,146,74,63,"['predatorhunter51', 'shah19', 'campbel3', 'takagi1', 'ammario', 'wells8', 'hansanderson', 'sonicbro', 'landin', 'young10', 'kantner1', 'garcias1', 'zstone2', 'hanbacca', 'pniemer2', 'adoboluver', 'josephxu', 'chitten1', 'kane11', 'jashari1', 'rturner', 'drtesla90', 'chanj45', 'jang34', 'keramat1', 'zhuxh529', 'dmgo17', 'shah4u19', 'murray18', 'tumblesoup', 'mwang53', 'yinghe3', 'sundstr2', 'bredemer', 'b3nny312', 'awesly2', 'seanyen1', 'leijin3', 'danyangzhuo', 'searuff', 'mkandel', 'digitalmouse12', 'isankar21', 'lincoln5', 'yohanko322', 'cialdel1', 'wheele11', 'v3lox', 'vsalovnh', 'mccann4', 'rooney5', 'sulas2', 'fluxayh', 'maninpat', 'azure3t', 'lylo', 'kim325', 'profballack', 'pokemeng', 'jacobs25', 'roybell', 'ededens', 'bilalgabula']",82,"['adamwright08', 'convolution', 'onay91', 'mikeudelhofen', 'creepdeadly', 'chorvat2', 'mtzcardfan08', 'lawrenceli', 'tom69sawyer', 'ahasija2', 'lmendez2', 'khaostehnoob', 'bradzab', 'scarlett', 'elachman', 'bettenh1', 'andrewgrieve1', 'godofdeath', 'dinger104', 'yening9063', 'yuan10', 'fahmad6', 'sherlaby25', 'alee60', 'gravityplanx', 'wolf13', 'assem2', 'ckhuang999', 'choquet1', 'scalise1', 'kylekalk', 'kong7', 'crisci1', 'enyuluo', 'rschmid2', 'dtoome2', 'mmcdow4', 'savysaville', 'tmalone3', 'yuqili1', 'caz1429', 'anim007', 'zhu52', 'cfranc20', 'leech060191', 'yurilee2', 'wang212', 'dou1', 'stanzzang', 'zson2', 'drejmeisterdrej', 'columbine', 'zhang155', 'mattycat9000', 'lim89', 'rose4', 'juliusqueezer', 'cbarth2', 'chanda2', 'alee13', 'dmoonxp5', 'rkuryl2', 'demint1', 'sebasti2', 'kadakiy1', 'seanlee14', 'frisbie1', 'jpack91', 'yan16', 'osarenk1', 'kevinlooby', 'jifeixu', 'rccarca', 'nicozorro31', 'brinlee2', 'ysun12', 'wang217', 'sungbea89', 'toan52', 'sc21cn', 'ehgma0821', 'fanwu1']",11,"['gruber1', 'bae7', 'philip', 'willwang0737', 'xingli1', 'shiou2', 'jasperli', None, 'munjal2', 'ren6', 'theyubo']",156,"['adamwright08', 'convolution', 'wells8', 'sonicbro', 'landin', 'shiou2', 'onay91', 'gruber1', 'mikeudelhofen', 'creepdeadly', 'kane11', 'jashari1', 'chorvat2', 'mtzcardfan08', 'lawrenceli', 'munjal2', 'tom69sawyer', 'dmgo17', 'mwang53', 'ahasija2', 'lmendez2', 'philip', 'khaostehnoob', 'bradzab', 'scarlett', 'elachman', 'bettenh1', 'andrewgrieve1', 'wheele11', 'godofdeath', 'mccann4', 'fluxayh', 'xingli1', 'azure3t', 'kim325', 'profballack', 'dinger104', 'yening9063', 'yuan10', 'pokemeng', 'fahmad6', 'ededens', 'sherlaby25', 'alee60', 'ren6', 'gravityplanx', 'shah19', 'wolf13', 'takagi1', 'ammario', 'bae7', 'assem2', 'kantner1', 'young10', 'garcias1', 'ckhuang999', 'zstone2', 'rturner', 'chanj45', 'choquet1', 'scalise1', 'kylekalk', 'shah4u19', 'kong7', 'crisci1', 'awesly2', 'leijin3', 'danyangzhuo', 'searuff', 'mkandel', 'enyuluo', 'digitalmouse12', 'rschmid2', 'lincoln5', 'v3lox', 'vsalovnh', 'dtoome2', 'mmcdow4', 'savysaville', 'jacobs25', 'tmalone3', 'yuqili1', 'predatorhunter51', 'caz1429', 'anim007', 'zhu52', 'cfranc20', 'leech060191', 'hanbacca', 'yurilee2', 'pniemer2', 'wang212', 'adoboluver', 'josephxu', 'dou1', 'stanzzang', 'jang34', 'zhuxh529', 'zson2', 'yinghe3', 'drejmeisterdrej', 'bredemer', 'sundstr2', 'columbine', 'b3nny312', 'zhang155', 'jasperli', 'isankar21', 'yohanko322', 'mattycat9000', 'lim89', 'rose4', 'rooney5', 'maninpat', 'juliusqueezer', 'roybell', 'cbarth2', 'bilalgabula', 'chanda2', 'alee13', 'campbel3', 'dmoonxp5', 'hansanderson', 'rkuryl2', 'demint1', 'sebasti2', 'chitten1', 'kadakiy1', 'seanlee14', 'willwang0737', 'frisbie1', 'drtesla90', 'jpack91', 'yan16', 'osarenk1', 'keramat1', 'kevinlooby', 'theyubo', 'murray18', 'tumblesoup', 'jifeixu', 'seanyen1', 'rccarca', 'nicozorro31', 'brinlee2', 'ysun12', None, 'cialdel1', 'wang217', 'sungbea89', 'toan52', 'sulas2', 'sc21cn', 'lylo', 'ehgma0821', 'fanwu1']"
2,62,146,53,38,"['gravityplanx', 'caz1429', 'assem2', 'hansanderson', 'sonicbro', 'rkuryl2', 'onay91', 'demint1', 'zhu52', 'ckhuang999', 'wang212', 'mikeudelhofen', 'seanlee14', 'frisbie1', 'chorvat2', 'jpack91', 'chanj45', 'mtzcardfan08', 'dmgo17', 'kong7', 'sundstr2', 'drejmeisterdrej', 'khaostehnoob', 'columbine', 'digitalmouse12', 'brinlee2', 'bettenh1', 'wang217', 'rose4', 'mattycat9000', 'v3lox', 'mmcdow4', 'maninpat', 'azure3t', 'ehgma0821', 'yening9063', 'fahmad6', 'tmalone3']",107,"['adamwright08', 'convolution', 'wells8', 'landin', 'creepdeadly', 'kane11', 'jashari1', 'lawrenceli', 'tom69sawyer', 'mwang53', 'ahasija2', 'lmendez2', 'bradzab', 'scarlett', 'elachman', 'andrewgrieve1', 'wheele11', 'godofdeath', 'mccann4', 'fluxayh', 'kim325', 'profballack', 'dinger104', 'pokemeng', 'yuan10', 'ededens', 'sherlaby25', 'alee60', 'shah19', 'wolf13', 'takagi1', 'ammario', 'kantner1', 'young10', 'garcias1', 'zstone2', 'rturner', 'choquet1', 'scalise1', 'kylekalk', 'shah4u19', 'crisci1', 'awesly2', 'leijin3', 'danyangzhuo', 'searuff', 'mkandel', 'enyuluo', 'rschmid2', 'lincoln5', 'vsalovnh', 'dtoome2', 'savysaville', 'jacobs25', 'yuqili1', 'predatorhunter51', 'anim007', 'cfranc20', 'leech060191', 'hanbacca', 'yurilee2', 'pniemer2', 'adoboluver', 'josephxu', 'dou1', 'stanzzang', 'jang34', 'zhuxh529', 'zson2', 'yinghe3', 'bredemer', 'b3nny312', 'zhang155', 'isankar21', 'yohanko322', 'lim89', 'rooney5', 'juliusqueezer', 'roybell', 'cbarth2', 'bilalgabula', 'chanda2', 'alee13', 'campbel3', 'dmoonxp5', 'sebasti2', 'chitten1', 'kadakiy1', 'drtesla90', 'yan16', 'osarenk1', 'keramat1', 'kevinlooby', 'murray18', 'tumblesoup', 'jifeixu', 'seanyen1', 'rccarca', 'nicozorro31', 'ysun12', 'cialdel1', 'sungbea89', 'toan52', 'sulas2', 'sc21cn', 'lylo', 'fanwu1']",15,"['nikhrmn', 'ragunat1', 'nullaa', 'ryanschuster', 'hjsong2', 'philip', 'vik579', 'huddles1', 'rohanamin', 'luyun198993', None, 'cardena2', 'djung31', 'ericwei1', 'stewart9']",160,"['adamwright08', 'convolution', 'hjsong2', 'wells8', 'sonicbro', 'landin', 'onay91', 'cardena2', 'ericwei1', 'mikeudelhofen', 'creepdeadly', 'kane11', 'jashari1', 'chorvat2', 'mtzcardfan08', 'lawrenceli', 'tom69sawyer', 'dmgo17', 'mwang53', 'ahasija2', 'lmendez2', 'philip', 'khaostehnoob', 'bradzab', 'scarlett', 'elachman', 'bettenh1', 'andrewgrieve1', 'wheele11', 'godofdeath', 'ragunat1', 'mccann4', 'fluxayh', 'azure3t', 'kim325', 'profballack', 'dinger104', 'yening9063', 'yuan10', 'pokemeng', 'fahmad6', 'ededens', 'sherlaby25', 'vik579', 'alee60', 'gravityplanx', 'shah19', 'wolf13', 'takagi1', 'ammario', 'assem2', 'kantner1', 'young10', 'garcias1', 'ckhuang999', 'zstone2', 'rturner', 'chanj45', 'choquet1', 'scalise1', 'kylekalk', 'shah4u19', 'kong7', 'crisci1', 'awesly2', 'leijin3', 'danyangzhuo', 'searuff', 'mkandel', 'enyuluo', 'digitalmouse12', 'rschmid2', 'lincoln5', 'stewart9', 'v3lox', 'vsalovnh', 'dtoome2', 'mmcdow4', 'savysaville', 'jacobs25', 'tmalone3', 'yuqili1', 'predatorhunter51', 'caz1429', 'anim007', 'zhu52', 'cfranc20', 'leech060191', 'hanbacca', 'yurilee2', 'pniemer2', 'wang212', 'adoboluver', 'josephxu', 'dou1', 'ryanschuster', 'rohanamin', 'stanzzang', 'jang34', 'zhuxh529', 'zson2', 'yinghe3', 'drejmeisterdrej', 'bredemer', 'sundstr2', 'columbine', 'b3nny312', 'zhang155', 'isankar21', 'yohanko322', 'mattycat9000', 'lim89', 'rose4', 'rooney5', 'maninpat', 'juliusqueezer', 'roybell', 'djung31', 'cbarth2', 'bilalgabula', 'chanda2', 'alee13', 'campbel3', 'dmoonxp5', 'hansanderson', 'rkuryl2', 'demint1', 'sebasti2', 'chitten1', 'kadakiy1', 'seanlee14', 'frisbie1', 'drtesla90', 'jpack91', 'yan16', 'osarenk1', 'keramat1', 'kevinlooby', 'murray18', 'tumblesoup', 'jifeixu', 'seanyen1', 'rccarca', 'nicozorro31', 'luyun198993', 'brinlee2', 'ysun12', None, 'cialdel1', 'wang217', 'sungbea89', 'toan52', 'nikhrmn', 'nullaa', 'sulas2', 'sc21cn', 'lylo', 'huddles1', 'ehgma0821', 'fanwu1']"
2,55,146,44,32,"['gravityplanx', 'demint1', 'zhu52', 'ckhuang999', 'wang212', 'mikeudelhofen', 'kane11', 'seanlee14', 'frisbie1', 'chorvat2', 'jpack91', 'chanj45', 'mtzcardfan08', 'osarenk1', 'dmgo17', 'murray18', 'drejmeisterdrej', 'columbine', 'rccarca', 'brinlee2', 'bettenh1', 'andrewgrieve1', 'wang217', 'toan52', 'mattycat9000', 'vsalovnh', 'mmcdow4', 'jacobs25', 'juliusqueezer', 'ehgma0821', 'fahmad6', 'bilalgabula']",113,"['adamwright08', 'convolution', 'wells8', 'sonicbro', 'landin', 'onay91', 'creepdeadly', 'jashari1', 'lawrenceli', 'tom69sawyer', 'mwang53', 'ahasija2', 'lmendez2', 'khaostehnoob', 'bradzab', 'scarlett', 'elachman', 'wheele11', 'godofdeath', 'mccann4', 'fluxayh', 'azure3t', 'kim325', 'profballack', 'dinger104', 'yening9063', 'yuan10', 'pokemeng', 'ededens', 'sherlaby25', 'alee60', 'shah19', 'wolf13', 'takagi1', 'ammario', 'assem2', 'kantner1', 'young10', 'garcias1', 'zstone2', 'rturner', 'choquet1', 'scalise1', 'kylekalk', 'shah4u19', 'kong7', 'crisci1', 'awesly2', 'leijin3', 'danyangzhuo', 'searuff', 'mkandel', 'enyuluo', 'digitalmouse12', 'rschmid2', 'lincoln5', 'v3lox', 'dtoome2', 'savysaville', 'tmalone3', 'yuqili1', 'predatorhunter51', 'caz1429', 'anim007', 'cfranc20', 'leech060191', 'hanbacca', 'yurilee2', 'pniemer2', 'adoboluver', 'josephxu', 'dou1', 'stanzzang', 'jang34', 'zhuxh529', 'zson2', 'yinghe3', 'bredemer', 'sundstr2', 'b3nny312', 'zhang155', 'isankar21', 'yohanko322', 'rose4', 'lim89', 'rooney5', 'maninpat', 'roybell', 'cbarth2', 'chanda2', 'alee13', 'campbel3', 'dmoonxp5', 'hansanderson', 'rkuryl2', 'sebasti2', 'chitten1', 'kadakiy1', 'drtesla90', 'yan16', 'keramat1', 'kevinlooby', 'tumblesoup', 'jifeixu', 'seanyen1', 'nicozorro31', 'ysun12', 'cialdel1', 'sungbea89', 'sulas2', 'sc21cn', 'lylo', 'fanwu1']",12,"['cuddihy1', 'nullaa', 'philip', 'pixton1', 'cagyanx', 'sabio0', 'lzentner', 'ultranerd71', 'nbikos', None, 'greatnorman1102', 'cfok3']",157,"['adamwright08', 'convolution', 'wells8', 'sonicbro', 'landin', 'onay91', 'mikeudelhofen', 'creepdeadly', 'kane11', 'jashari1', 'chorvat2', 'mtzcardfan08', 'lawrenceli', 'tom69sawyer', 'dmgo17', 'mwang53', 'ahasija2', 'lmendez2', 'philip', 'khaostehnoob', 'bradzab', 'scarlett', 'elachman', 'bettenh1', 'andrewgrieve1', 'wheele11', 'cfok3', 'godofdeath', 'mccann4', 'fluxayh', 'azure3t', 'kim325', 'profballack', 'dinger104', 'yening9063', 'yuan10', 'pokemeng', 'fahmad6', 'ededens', 'sherlaby25', 'nbikos', 'alee60', 'pixton1', 'gravityplanx', 'shah19', 'wolf13', 'takagi1', 'ammario', 'assem2', 'kantner1', 'young10', 'garcias1', 'ultranerd71', 'ckhuang999', 'zstone2', 'rturner', 'chanj45', 'choquet1', 'scalise1', 'kylekalk', 'shah4u19', 'kong7', 'crisci1', 'awesly2', 'leijin3', 'danyangzhuo', 'searuff', 'mkandel', 'enyuluo', 'digitalmouse12', 'rschmid2', 'lincoln5', 'v3lox', 'vsalovnh', 'dtoome2', 'mmcdow4', 'savysaville', 'jacobs25', 'tmalone3', 'greatnorman1102', 'yuqili1', 'predatorhunter51', 'caz1429', 'anim007', 'zhu52', 'cfranc20', 'leech060191', 'hanbacca', 'yurilee2', 'pniemer2', 'wang212', 'adoboluver', 'josephxu', 'dou1', 'lzentner', 'stanzzang', 'jang34', 'zhuxh529', 'zson2', 'yinghe3', 'drejmeisterdrej', 'bredemer', 'sundstr2', 'columbine', 'b3nny312', 'zhang155', 'cagyanx', 'sabio0', 'isankar21', 'yohanko322', 'mattycat9000', 'lim89', 'rose4', 'rooney5', 'maninpat', 'juliusqueezer', 'roybell', 'cbarth2', 'bilalgabula', 'chanda2', 'cuddihy1', 'alee13', 'campbel3', 'dmoonxp5', 'hansanderson', 'rkuryl2', 'demint1', 'sebasti2', 'chitten1', 'kadakiy1', 'seanlee14', 'frisbie1', 'drtesla90', 'jpack91', 'yan16', 'osarenk1', 'keramat1', 'kevinlooby', 'murray18', 'tumblesoup', 'jifeixu', 'seanyen1', 'rccarca', 'nicozorro31', 'brinlee2', 'ysun12', None, 'cialdel1', 'wang217', 'sungbea89', 'toan52', 'nullaa', 'sulas2', 'sc21cn', 'lylo', 'ehgma0821', 'fanwu1']"
2,64,146,28,18,"['toan52', 'rschmid2', 'josephxu', 'jifeixu', 'mwang53', 'mccann4', 'takagi1', 'dou1', 'creepdeadly', 'rooney5', 'bradzab', 'enyuluo', 'searuff', 'jacobs25', 'yuan10', 'stanzzang', 'lawrenceli', 'cbarth2']",127,"['adamwright08', 'convolution', 'wells8', 'sonicbro', 'landin', 'onay91', 'mikeudelhofen', 'kane11', 'jashari1', 'chorvat2', 'mtzcardfan08', 'tom69sawyer', 'dmgo17', 'ahasija2', 'lmendez2', 'khaostehnoob', 'scarlett', 'elachman', 'bettenh1', 'andrewgrieve1', 'wheele11', 'godofdeath', 'fluxayh', 'azure3t', 'kim325', 'profballack', 'dinger104', 'yening9063', 'pokemeng', 'fahmad6', 'ededens', 'sherlaby25', 'alee60', 'gravityplanx', 'shah19', 'wolf13', 'ammario', 'assem2', 'kantner1', 'young10', 'garcias1', 'ckhuang999', 'zstone2', 'rturner', 'chanj45', 'choquet1', 'scalise1', 'kylekalk', 'shah4u19', 'kong7', 'crisci1', 'awesly2', 'leijin3', 'danyangzhuo', 'mkandel', 'digitalmouse12', 'lincoln5', 'v3lox', 'vsalovnh', 'dtoome2', 'mmcdow4', 'savysaville', 'tmalone3', 'yuqili1', 'predatorhunter51', 'caz1429', 'anim007', 'zhu52', 'cfranc20', 'leech060191', 'hanbacca', 'yurilee2', 'pniemer2', 'wang212', 'adoboluver', 'jang34', 'zhuxh529', 'zson2', 'yinghe3', 'drejmeisterdrej', 'bredemer', 'sundstr2', 'columbine', 'b3nny312', 'zhang155', 'isankar21', 'yohanko322', 'mattycat9000', 'lim89', 'rose4', 'maninpat', 'juliusqueezer', 'roybell', 'bilalgabula', 'chanda2', 'alee13', 'campbel3', 'dmoonxp5', 'hansanderson', 'rkuryl2', 'demint1', 'sebasti2', 'chitten1', 'kadakiy1', 'seanlee14', 'frisbie1', 'drtesla90', 'jpack91', 'yan16', 'osarenk1', 'keramat1', 'kevinlooby', 'murray18', 'tumblesoup', 'seanyen1', 'rccarca', 'nicozorro31', 'brinlee2', 'ysun12', 'cialdel1', 'wang217', 'sungbea89', 'sulas2', 'sc21cn', 'lylo', 'ehgma0821', 'fanwu1']",10,"['shook2', 'eteran7', 'ucapssong', 'rasinsk1', 'oper951', 'icfmi90', 'qliu9', 'red6290', None, 'matamor1']",155,"['adamwright08', 'convolution', 'wells8', 'sonicbro', 'landin', 'onay91', 'qliu9', 'matamor1', 'red6290', 'mikeudelhofen', 'oper951', 'creepdeadly', 'kane11', 'jashari1', 'chorvat2', 'mtzcardfan08', 'lawrenceli', 'tom69sawyer', 'dmgo17', 'mwang53', 'ahasija2', 'lmendez2', 'khaostehnoob', 'bradzab', 'scarlett', 'elachman', 'bettenh1', 'andrewgrieve1', 'wheele11', 'godofdeath', 'rasinsk1', 'mccann4', 'fluxayh', 'azure3t', 'kim325', 'profballack', 'dinger104', 'yening9063', 'yuan10', 'pokemeng', 'fahmad6', 'ededens', 'sherlaby25', 'alee60', 'gravityplanx', 'shah19', 'wolf13', 'takagi1', 'ammario', 'assem2', 'kantner1', 'young10', 'garcias1', 'ckhuang999', 'zstone2', 'rturner', 'chanj45', 'choquet1', 'scalise1', 'kylekalk', 'shah4u19', 'kong7', 'crisci1', 'awesly2', 'leijin3', 'danyangzhuo', 'searuff', 'mkandel', 'enyuluo', 'digitalmouse12', 'rschmid2', 'lincoln5', 'eteran7', 'v3lox', 'vsalovnh', 'dtoome2', 'mmcdow4', 'savysaville', 'jacobs25', 'tmalone3', 'yuqili1', 'predatorhunter51', 'ucapssong', 'caz1429', 'icfmi90', 'anim007', 'zhu52', 'cfranc20', 'leech060191', 'hanbacca', 'yurilee2', 'pniemer2', 'wang212', 'adoboluver', 'josephxu', 'dou1', 'stanzzang', 'jang34', 'zhuxh529', 'zson2', 'yinghe3', 'drejmeisterdrej', 'bredemer', 'sundstr2', 'columbine', 'b3nny312', 'zhang155', 'isankar21', 'yohanko322', 'mattycat9000', 'lim89', 'rose4', 'rooney5', 'maninpat', 'juliusqueezer', 'roybell', 'cbarth2', 'bilalgabula', 'chanda2', 'alee13', 'campbel3', 'dmoonxp5', 'hansanderson', 'rkuryl2', 'demint1', 'sebasti2', 'shook2', 'chitten1', 'kadakiy1', 'seanlee14', 'frisbie1', 'drtesla90', 'jpack91', 'yan16', 'osarenk1', 'keramat1', 'kevinlooby', 'murray18', 'tumblesoup', 'jifeixu', 'seanyen1', 'rccarca', 'nicozorro31', 'brinlee2', 'ysun12', None, 'cialdel1', 'wang217', 'sungbea89', 'toan52', 'sulas2', 'sc21cn', 'lylo', 'ehgma0821', 'fanwu1']"
2,99,146,28,23,"['gravityplanx', 'shah19', 'caz1429', 'assem2', 'hansanderson', 'onay91', 'demint1', 'ckhuang999', 'jpack91', 'jifeixu', 'kong7', 'drejmeisterdrej', 'rccarca', 'bettenh1', 'wang217', 'rose4', 'v3lox', 'mmcdow4', 'savysaville', 'ehgma0821', 'yening9063', 'yuan10', 'tmalone3']",122,"['adamwright08', 'convolution', 'wells8', 'sonicbro', 'landin', 'mikeudelhofen', 'creepdeadly', 'kane11', 'jashari1', 'chorvat2', 'mtzcardfan08', 'lawrenceli', 'tom69sawyer', 'dmgo17', 'mwang53', 'ahasija2', 'lmendez2', 'khaostehnoob', 'bradzab', 'scarlett', 'elachman', 'andrewgrieve1', 'wheele11', 'godofdeath', 'mccann4', 'fluxayh', 'azure3t', 'kim325', 'profballack', 'dinger104', 'pokemeng', 'fahmad6', 'ededens', 'sherlaby25', 'alee60', 'wolf13', 'takagi1', 'ammario', 'kantner1', 'young10', 'garcias1', 'zstone2', 'rturner', 'chanj45', 'choquet1', 'scalise1', 'kylekalk', 'shah4u19', 'crisci1', 'awesly2', 'leijin3', 'danyangzhuo', 'searuff', 'mkandel', 'enyuluo', 'digitalmouse12', 'rschmid2', 'lincoln5', 'vsalovnh', 'dtoome2', 'jacobs25', 'yuqili1', 'predatorhunter51', 'anim007', 'zhu52', 'cfranc20', 'leech060191', 'hanbacca', 'yurilee2', 'pniemer2', 'wang212', 'adoboluver', 'josephxu', 'dou1', 'stanzzang', 'jang34', 'zhuxh529', 'zson2', 'yinghe3', 'bredemer', 'sundstr2', 'columbine', 'b3nny312', 'zhang155', 'isankar21', 'yohanko322', 'mattycat9000', 'lim89', 'rooney5', 'maninpat', 'juliusqueezer', 'roybell', 'cbarth2', 'bilalgabula', 'chanda2', 'alee13', 'campbel3', 'dmoonxp5', 'rkuryl2', 'sebasti2', 'chitten1', 'kadakiy1', 'seanlee14', 'frisbie1', 'drtesla90', 'yan16', 'osarenk1', 'keramat1', 'kevinlooby', 'murray18', 'tumblesoup', 'seanyen1', 'nicozorro31', 'brinlee2', 'ysun12', 'cialdel1', 'sungbea89', 'toan52', 'sulas2', 'sc21cn', 'lylo', 'fanwu1']",5,"['ljbaker2', 'hong64', None, 'ericwei1', 'pixton1']",150,"['adamwright08', 'convolution', 'wells8', 'sonicbro', 'landin', 'onay91', 'ericwei1', 'mikeudelhofen', 'creepdeadly', 'kane11', 'jashari1', 'chorvat2', 'mtzcardfan08', 'lawrenceli', 'tom69sawyer', 'dmgo17', 'mwang53', 'ahasija2', 'lmendez2', 'khaostehnoob', 'bradzab', 'scarlett', 'elachman', 'bettenh1', 'andrewgrieve1', 'wheele11', 'godofdeath', 'ljbaker2', 'mccann4', 'fluxayh', 'azure3t', 'kim325', 'profballack', 'dinger104', 'yening9063', 'yuan10', 'pokemeng', 'fahmad6', 'ededens', 'sherlaby25', 'pixton1', 'alee60', 'gravityplanx', 'shah19', 'wolf13', 'takagi1', 'ammario', 'assem2', 'kantner1', 'young10', 'garcias1', 'ckhuang999', 'zstone2', 'rturner', 'hong64', 'chanj45', 'choquet1', 'scalise1', 'kylekalk', 'shah4u19', 'kong7', 'crisci1', 'awesly2', 'leijin3', 'danyangzhuo', 'searuff', 'mkandel', 'enyuluo', 'digitalmouse12', 'rschmid2', 'lincoln5', 'v3lox', 'vsalovnh', 'dtoome2', 'mmcdow4', 'savysaville', 'jacobs25', 'tmalone3', 'yuqili1', 'predatorhunter51', 'caz1429', 'anim007', 'zhu52', 'cfranc20', 'leech060191', 'hanbacca', 'yurilee2', 'pniemer2', 'wang212', 'adoboluver', 'josephxu', 'dou1', 'stanzzang', 'jang34', 'zhuxh529', 'zson2', 'yinghe3', 'drejmeisterdrej', 'bredemer', 'sundstr2', 'columbine', 'b3nny312', 'zhang155', 'isankar21', 'yohanko322', 'mattycat9000', 'lim89', 'rose4', 'rooney5', 'maninpat', 'juliusqueezer', 'roybell', 'cbarth2', 'bilalgabula', 'chanda2', 'alee13', 'campbel3', 'dmoonxp5', 'hansanderson', 'rkuryl2', 'demint1', 'sebasti2', 'chitten1', 'kadakiy1', 'seanlee14', 'frisbie1', 'drtesla90', 'jpack91', 'yan16', 'osarenk1', 'keramat1', 'kevinlooby', 'murray18', 'tumblesoup', 'jifeixu', 'seanyen1', 'rccarca', 'nicozorro31', 'brinlee2', 'ysun12', None, 'cialdel1', 'wang217', 'sungbea89', 'toan52', 'sulas2', 'sc21cn', 'lylo', 'ehgma0821', 'fanwu1']"
2,125,146,28,1,['sulas2'],144,"['adamwright08', 'convolution', 'wells8', 'sonicbro', 'landin', 'onay91', 'mikeudelhofen', 'creepdeadly', 'kane11', 'jashari1', 'chorvat2', 'mtzcardfan08', 'lawrenceli', 'tom69sawyer', 'dmgo17', 'mwang53', 'ahasija2', 'lmendez2', 'khaostehnoob', 'bradzab', 'scarlett', 'elachman', 'bettenh1', 'andrewgrieve1', 'wheele11', 'godofdeath', 'mccann4', 'fluxayh', 'azure3t', 'kim325', 'profballack', 'dinger104', 'yening9063', 'yuan10', 'pokemeng', 'fahmad6', 'ededens', 'sherlaby25', 'alee60', 'gravityplanx', 'shah19', 'wolf13', 'takagi1', 'ammario', 'assem2', 'kantner1', 'young10', 'garcias1', 'ckhuang999', 'zstone2', 'rturner', 'chanj45', 'choquet1', 'scalise1', 'kylekalk', 'shah4u19', 'kong7', 'crisci1', 'awesly2', 'leijin3', 'danyangzhuo', 'searuff', 'mkandel', 'enyuluo', 'digitalmouse12', 'rschmid2', 'lincoln5', 'v3lox', 'vsalovnh', 'dtoome2', 'mmcdow4', 'savysaville', 'jacobs25', 'tmalone3', 'yuqili1', 'predatorhunter51', 'caz1429', 'anim007', 'zhu52', 'cfranc20', 'leech060191', 'hanbacca', 'yurilee2', 'pniemer2', 'wang212', 'adoboluver', 'josephxu', 'dou1', 'stanzzang', 'jang34', 'zhuxh529', 'zson2', 'yinghe3', 'drejmeisterdrej', 'bredemer', 'sundstr2', 'columbine', 'b3nny312', 'zhang155', 'isankar21', 'yohanko322', 'mattycat9000', 'lim89', 'rose4', 'rooney5', 'maninpat', 'juliusqueezer', 'roybell', 'cbarth2', 'bilalgabula', 'chanda2', 'alee13', 'campbel3', 'dmoonxp5', 'hansanderson', 'rkuryl2', 'demint1', 'sebasti2', 'chitten1', 'kadakiy1', 'seanlee14', 'frisbie1', 'drtesla90', 'jpack91', 'yan16', 'osarenk1', 'keramat1', 'kevinlooby', 'murray18', 'tumblesoup', 'jifeixu', 'seanyen1', 'rccarca', 'nicozorro31', 'brinlee2', 'ysun12', 'cialdel1', 'wang217', 'sungbea89', 'toan52', 'sc21cn', 'lylo', 'ehgma0821', 'fanwu1']",27,"['bruk1', 'lancor1', 'handley1', 'dahlke2', 'kylecaddigan', 'vdersar1', 'tylerarl', 'yagoda1', 'a2140416', 'tanaikjun', 'mayfield', 'munjal2', 'epping2', 'buncher01', 'pelizaga', 'wenyang1', 'dtrinkle', 'simpson5', 'fredhdx', 'chavez4', None, 'menghuang', 'faraday2000', 'photoyub', 'mufeiyu2', 'griffi21', 'nunuwang']",172,"['bruk1', 'adamwright08', 'convolution', 'lancor1', 'wells8', 'sonicbro', 'landin', 'kylecaddigan', 'onay91', 'tylerarl', 'mikeudelhofen', 'creepdeadly', 'kane11', 'jashari1', 'chorvat2', 'mtzcardfan08', 'lawrenceli', 'munjal2', 'epping2', 'tom69sawyer', 'dmgo17', 'mwang53', 'ahasija2', 'lmendez2', 'khaostehnoob', 'bradzab', 'scarlett', 'elachman', 'fredhdx', 'chavez4', 'bettenh1', 'andrewgrieve1', 'wheele11', 'godofdeath', 'faraday2000', 'mccann4', 'fluxayh', 'griffi21', 'azure3t', 'kim325', 'profballack', 'dinger104', 'yening9063', 'yuan10', 'pokemeng', 'fahmad6', 'ededens', 'sherlaby25', 'alee60', 'gravityplanx', 'shah19', 'wolf13', 'takagi1', 'ammario', 'assem2', 'kantner1', 'young10', 'garcias1', 'ckhuang999', 'zstone2', 'rturner', 'tanaikjun', 'chanj45', 'choquet1', 'scalise1', 'kylekalk', 'shah4u19', 'kong7', 'crisci1', 'awesly2', 'leijin3', 'danyangzhuo', 'dtrinkle', 'searuff', 'mkandel', 'enyuluo', 'digitalmouse12', 'rschmid2', 'lincoln5', 'v3lox', 'vsalovnh', 'photoyub', 'mufeiyu2', 'dtoome2', 'mmcdow4', 'savysaville', 'jacobs25', 'tmalone3', 'yuqili1', 'predatorhunter51', 'caz1429', 'dahlke2', 'anim007', 'zhu52', 'cfranc20', 'leech060191', 'vdersar1', 'hanbacca', 'yurilee2', 'pniemer2', 'wang212', 'adoboluver', 'josephxu', 'dou1', 'mayfield', 'stanzzang', 'jang34', 'zhuxh529', 'zson2', 'pelizaga', 'wenyang1', 'yinghe3', 'drejmeisterdrej', 'bredemer', 'sundstr2', 'columbine', 'b3nny312', 'zhang155', 'isankar21', 'yohanko322', 'mattycat9000', 'lim89', 'rose4', 'rooney5', 'maninpat', 'juliusqueezer', 'roybell', 'cbarth2', 'bilalgabula', 'nunuwang', 'chanda2', 'alee13', 'campbel3', 'dmoonxp5', 'hansanderson', 'handley1', 'rkuryl2', 'demint1', 'sebasti2', 'yagoda1', 'chitten1', 'kadakiy1', 'seanlee14', 'a2140416', 'frisbie1', 'drtesla90', 'jpack91', 'yan16', 'osarenk1', 'keramat1', 'kevinlooby', 'murray18', 'tumblesoup', 'buncher01', 'jifeixu', 'seanyen1', 'rccarca', 'nicozorro31', 'brinlee2', 'ysun12', 'simpson5', None, 'cialdel1', 'wang217', 'sungbea89', 'toan52', 'menghuang', 'sulas2', 'sc21cn', 'lylo', 'ehgma0821', 'fanwu1']"
2,54,146,24,11,"['toan52', 'takagi1', 'dou1', 'creepdeadly', 'enyuluo', 'bradzab', 'rkuryl2', 'elachman', 'yuan10', 'rschmid2', 'cbarth2']",134,"['adamwright08', 'convolution', 'wells8', 'sonicbro', 'landin', 'onay91', 'mikeudelhofen', 'kane11', 'jashari1', 'chorvat2', 'mtzcardfan08', 'lawrenceli', 'tom69sawyer', 'dmgo17', 'mwang53', 'ahasija2', 'lmendez2', 'khaostehnoob', 'scarlett', 'bettenh1', 'andrewgrieve1', 'wheele11', 'godofdeath', 'mccann4', 'fluxayh', 'azure3t', 'kim325', 'profballack', 'dinger104', 'yening9063', 'pokemeng', 'fahmad6', 'ededens', 'sherlaby25', 'alee60', 'gravityplanx', 'shah19', 'wolf13', 'ammario', 'assem2', 'kantner1', 'young10', 'garcias1', 'ckhuang999', 'zstone2', 'rturner', 'chanj45', 'choquet1', 'scalise1', 'kylekalk', 'shah4u19', 'kong7', 'crisci1', 'awesly2', 'leijin3', 'danyangzhuo', 'searuff', 'mkandel', 'digitalmouse12', 'lincoln5', 'v3lox', 'vsalovnh', 'dtoome2', 'mmcdow4', 'savysaville', 'jacobs25', 'tmalone3', 'yuqili1', 'predatorhunter51', 'caz1429', 'anim007', 'zhu52', 'cfranc20', 'leech060191', 'hanbacca', 'yurilee2', 'pniemer2', 'wang212', 'adoboluver', 'josephxu', 'stanzzang', 'jang34', 'zhuxh529', 'zson2', 'yinghe3', 'drejmeisterdrej', 'bredemer', 'sundstr2', 'columbine', 'b3nny312', 'zhang155', 'isankar21', 'yohanko322', 'mattycat9000', 'lim89', 'rose4', 'rooney5', 'maninpat', 'juliusqueezer', 'roybell', 'bilalgabula', 'chanda2', 'alee13', 'campbel3', 'dmoonxp5', 'hansanderson', 'demint1', 'sebasti2', 'chitten1', 'kadakiy1', 'seanlee14', 'frisbie1', 'drtesla90', 'jpack91', 'yan16', 'osarenk1', 'keramat1', 'kevinlooby', 'murray18', 'tumblesoup', 'jifeixu', 'seanyen1', 'rccarca', 'nicozorro31', 'brinlee2', 'ysun12', 'cialdel1', 'wang217', 'sungbea89', 'sulas2', 'sc21cn', 'lylo', 'ehgma0821', 'fanwu1']",13,"['dchoux2', 'hamed22m', 'roy18', 'dchoux1', 'novawater', 'pmartin8', 'chen282', 'kulkarn3', 'dbmcguir', None, 'koz', 'nkingw', 'matamor1']",158,"['adamwright08', 'convolution', 'wells8', 'sonicbro', 'landin', 'onay91', 'matamor1', 'mikeudelhofen', 'creepdeadly', 'kane11', 'jashari1', 'chorvat2', 'mtzcardfan08', 'lawrenceli', 'tom69sawyer', 'dmgo17', 'mwang53', 'ahasija2', 'lmendez2', 'khaostehnoob', 'bradzab', 'scarlett', 'elachman', 'bettenh1', 'andrewgrieve1', 'wheele11', 'godofdeath', 'hamed22m', 'mccann4', 'fluxayh', 'azure3t', 'kim325', 'profballack', 'dinger104', 'yening9063', 'yuan10', 'pokemeng', 'fahmad6', 'ededens', 'sherlaby25', 'alee60', 'gravityplanx', 'dchoux2', 'shah19', 'wolf13', 'takagi1', 'ammario', 'assem2', 'kantner1', 'young10', 'garcias1', 'ckhuang999', 'zstone2', 'rturner', 'dbmcguir', 'chanj45', 'choquet1', 'scalise1', 'kylekalk', 'shah4u19', 'kong7', 'crisci1', 'awesly2', 'leijin3', 'danyangzhuo', 'searuff', 'mkandel', 'enyuluo', 'digitalmouse12', 'rschmid2', 'lincoln5', 'v3lox', 'vsalovnh', 'dtoome2', 'mmcdow4', 'savysaville', 'pmartin8', 'jacobs25', 'koz', 'tmalone3', 'yuqili1', 'predatorhunter51', 'caz1429', 'anim007', 'chen282', 'zhu52', 'cfranc20', 'leech060191', 'hanbacca', 'yurilee2', 'pniemer2', 'wang212', 'adoboluver', 'josephxu', 'dou1', 'dchoux1', 'stanzzang', 'jang34', 'zhuxh529', 'zson2', 'yinghe3', 'drejmeisterdrej', 'bredemer', 'sundstr2', 'columbine', 'b3nny312', 'zhang155', 'isankar21', 'yohanko322', 'mattycat9000', 'lim89', 'rose4', 'rooney5', 'maninpat', 'juliusqueezer', 'roybell', 'cbarth2', 'bilalgabula', 'chanda2', 'alee13', 'campbel3', 'dmoonxp5', 'hansanderson', 'rkuryl2', 'demint1', 'sebasti2', 'chitten1', 'kadakiy1', 'seanlee14', 'frisbie1', 'drtesla90', 'jpack91', 'yan16', 'kulkarn3', 'nkingw', 'osarenk1', 'keramat1', 'kevinlooby', 'murray18', 'tumblesoup', 'jifeixu', 'seanyen1', 'novawater', 'rccarca', 'nicozorro31', 'brinlee2', 'ysun12', None, 'cialdel1', 'wang217', 'sungbea89', 'toan52', 'sulas2', 'sc21cn', 'roy18', 'lylo', 'ehgma0821', 'fanwu1']"
2,77,146,21,1,['b3nny312'],144,"['adamwright08', 'convolution', 'wells8', 'sonicbro', 'landin', 'onay91', 'mikeudelhofen', 'creepdeadly', 'kane11', 'jashari1', 'chorvat2', 'mtzcardfan08', 'lawrenceli', 'tom69sawyer', 'dmgo17', 'mwang53', 'ahasija2', 'lmendez2', 'khaostehnoob', 'bradzab', 'scarlett', 'elachman', 'bettenh1', 'andrewgrieve1', 'wheele11', 'godofdeath', 'mccann4', 'fluxayh', 'azure3t', 'kim325', 'profballack', 'dinger104', 'yening9063', 'yuan10', 'pokemeng', 'fahmad6', 'ededens', 'sherlaby25', 'alee60', 'gravityplanx', 'shah19', 'wolf13', 'takagi1', 'ammario', 'assem2', 'kantner1', 'young10', 'garcias1', 'ckhuang999', 'zstone2', 'rturner', 'chanj45', 'choquet1', 'scalise1', 'kylekalk', 'shah4u19', 'kong7', 'crisci1', 'awesly2', 'leijin3', 'danyangzhuo', 'searuff', 'mkandel', 'enyuluo', 'digitalmouse12', 'rschmid2', 'lincoln5', 'v3lox', 'vsalovnh', 'dtoome2', 'mmcdow4', 'savysaville', 'jacobs25', 'tmalone3', 'yuqili1', 'predatorhunter51', 'caz1429', 'anim007', 'zhu52', 'cfranc20', 'leech060191', 'hanbacca', 'yurilee2', 'pniemer2', 'wang212', 'adoboluver', 'josephxu', 'dou1', 'stanzzang', 'jang34', 'zhuxh529', 'zson2', 'yinghe3', 'drejmeisterdrej', 'bredemer', 'sundstr2', 'columbine', 'zhang155', 'isankar21', 'yohanko322', 'mattycat9000', 'lim89', 'rose4', 'rooney5', 'maninpat', 'juliusqueezer', 'roybell', 'cbarth2', 'bilalgabula', 'chanda2', 'alee13', 'campbel3', 'dmoonxp5', 'hansanderson', 'rkuryl2', 'demint1', 'sebasti2', 'chitten1', 'kadakiy1', 'seanlee14', 'frisbie1', 'drtesla90', 'jpack91', 'yan16', 'osarenk1', 'keramat1', 'kevinlooby', 'murray18', 'tumblesoup', 'jifeixu', 'seanyen1', 'rccarca', 'nicozorro31', 'brinlee2', 'ysun12', 'cialdel1', 'wang217', 'sungbea89', 'toan52', 'sulas2', 'sc21cn', 'lylo', 'ehgma0821', 'fanwu1']",20,"['ucapssong', 'bae7', 'nithinreddyc', 'cvendi2', 'zyf7284563', 'crosscounter87', 'cardena2', 'kazi1', 'shook2', 'lobert124', 'cabraal', 'leo19890725', 'oper951', 'rohanamin', 'bhuiya1', 'luyun198993', 'lee142', None, 'wrubrec2', 'red6290']",165,"['adamwright08', 'convolution', 'wells8', 'sonicbro', 'landin', 'zyf7284563', 'crosscounter87', 'onay91', 'cardena2', 'red6290', 'mikeudelhofen', 'leo19890725', 'oper951', 'creepdeadly', 'kane11', 'jashari1', 'chorvat2', 'mtzcardfan08', 'lawrenceli', 'tom69sawyer', 'dmgo17', 'mwang53', 'ahasija2', 'lmendez2', 'khaostehnoob', 'bradzab', 'scarlett', 'bhuiya1', 'elachman', 'bettenh1', 'andrewgrieve1', 'wheele11', 'godofdeath', 'mccann4', 'fluxayh', 'azure3t', 'kim325', 'profballack', 'dinger104', 'yening9063', 'yuan10', 'pokemeng', 'fahmad6', 'ededens', 'sherlaby25', 'alee60', 'gravityplanx', 'shah19', 'wolf13', 'takagi1', 'ammario', 'bae7', 'assem2', 'kantner1', 'young10', 'garcias1', 'ckhuang999', 'zstone2', 'rturner', 'chanj45', 'choquet1', 'scalise1', 'kylekalk', 'shah4u19', 'kong7', 'crisci1', 'awesly2', 'leijin3', 'danyangzhuo', 'searuff', 'mkandel', 'enyuluo', 'digitalmouse12', 'rschmid2', 'lincoln5', 'lee142', 'v3lox', 'wrubrec2', 'vsalovnh', 'dtoome2', 'mmcdow4', 'savysaville', 'jacobs25', 'tmalone3', 'yuqili1', 'predatorhunter51', 'ucapssong', 'caz1429', 'nithinreddyc', 'anim007', 'kazi1', 'zhu52', 'cfranc20', 'leech060191', 'hanbacca', 'yurilee2', 'pniemer2', 'lobert124', 'wang212', 'adoboluver', 'josephxu', 'cabraal', 'dou1', 'rohanamin', 'stanzzang', 'jang34', 'zhuxh529', 'zson2', 'yinghe3', 'drejmeisterdrej', 'bredemer', 'sundstr2', 'columbine', 'b3nny312', 'zhang155', 'isankar21', 'yohanko322', 'mattycat9000', 'lim89', 'rose4', 'rooney5', 'maninpat', 'juliusqueezer', 'roybell', 'cbarth2', 'bilalgabula', 'chanda2', 'alee13', 'campbel3', 'dmoonxp5', 'hansanderson', 'cvendi2', 'rkuryl2', 'demint1', 'sebasti2', 'shook2', 'chitten1', 'kadakiy1', 'seanlee14', 'frisbie1', 'drtesla90', 'jpack91', 'yan16', 'osarenk1', 'keramat1', 'kevinlooby', 'murray18', 'tumblesoup', 'jifeixu', 'seanyen1', 'rccarca', 'nicozorro31', 'luyun198993', 'brinlee2', 'ysun12', None, 'cialdel1', 'wang217', 'sungbea89', 'toan52', 'sulas2', 'sc21cn', 'lylo', 'ehgma0821', 'fanwu1']"
2,98,146,20,15,"['toan52', 'josephxu', 'rooney5', 'takagi1', 'creepdeadly', 'khaostehnoob', 'enyuluo', 'bradzab', 'searuff', 'choquet1', 'rschmid2', 'cbarth2', 'sebasti2', 'scalise1', 'kevinlooby']",130,"['adamwright08', 'convolution', 'wells8', 'sonicbro', 'landin', 'onay91', 'mikeudelhofen', 'kane11', 'jashari1', 'chorvat2', 'mtzcardfan08', 'lawrenceli', 'tom69sawyer', 'dmgo17', 'mwang53', 'ahasija2', 'lmendez2', 'scarlett', 'elachman', 'bettenh1', 'andrewgrieve1', 'wheele11', 'godofdeath', 'mccann4', 'fluxayh', 'azure3t', 'kim325', 'profballack', 'dinger104', 'yening9063', 'yuan10', 'pokemeng', 'fahmad6', 'ededens', 'sherlaby25', 'alee60', 'gravityplanx', 'shah19', 'wolf13', 'ammario', 'assem2', 'kantner1', 'young10', 'garcias1', 'ckhuang999', 'zstone2', 'rturner', 'chanj45', 'kylekalk', 'shah4u19', 'kong7', 'crisci1', 'awesly2', 'leijin3', 'danyangzhuo', 'mkandel', 'digitalmouse12', 'lincoln5', 'v3lox', 'vsalovnh', 'dtoome2', 'mmcdow4', 'savysaville', 'jacobs25', 'tmalone3', 'yuqili1', 'predatorhunter51', 'caz1429', 'anim007', 'zhu52', 'cfranc20', 'leech060191', 'hanbacca', 'yurilee2', 'pniemer2', 'wang212', 'adoboluver', 'dou1', 'stanzzang', 'jang34', 'zhuxh529', 'zson2', 'yinghe3', 'drejmeisterdrej', 'bredemer', 'sundstr2', 'columbine', 'b3nny312', 'zhang155', 'isankar21', 'yohanko322', 'mattycat9000', 'lim89', 'rose4', 'maninpat', 'juliusqueezer', 'roybell', 'bilalgabula', 'chanda2', 'alee13', 'campbel3', 'dmoonxp5', 'hansanderson', 'rkuryl2', 'demint1', 'chitten1', 'kadakiy1', 'seanlee14', 'frisbie1', 'drtesla90', 'jpack91', 'yan16', 'osarenk1', 'keramat1', 'murray18', 'tumblesoup', 'jifeixu', 'seanyen1', 'rccarca', 'nicozorro31', 'brinlee2', 'ysun12', 'cialdel1', 'wang217', 'sungbea89', 'sulas2', 'sc21cn', 'lylo', 'ehgma0821', 'fanwu1']",5,"['roseshaw', 'roy18', 'matamor1', 'cigarsnob', None]",150,"['adamwright08', 'convolution', 'wells8', 'sonicbro', 'landin', 'onay91', 'matamor1', 'mikeudelhofen', 'creepdeadly', 'kane11', 'jashari1', 'chorvat2', 'mtzcardfan08', 'lawrenceli', 'tom69sawyer', 'dmgo17', 'mwang53', 'ahasija2', 'lmendez2', 'khaostehnoob', 'bradzab', 'scarlett', 'elachman', 'bettenh1', 'andrewgrieve1', 'wheele11', 'godofdeath', 'mccann4', 'fluxayh', 'azure3t', 'kim325', 'profballack', 'dinger104', 'yening9063', 'yuan10', 'pokemeng', 'fahmad6', 'ededens', 'sherlaby25', 'alee60', 'gravityplanx', 'shah19', 'wolf13', 'takagi1', 'ammario', 'assem2', 'kantner1', 'young10', 'garcias1', 'ckhuang999', 'zstone2', 'rturner', 'chanj45', 'choquet1', 'scalise1', 'kylekalk', 'shah4u19', 'kong7', 'roseshaw', 'crisci1', 'awesly2', 'leijin3', 'danyangzhuo', 'searuff', 'mkandel', 'enyuluo', 'digitalmouse12', 'rschmid2', 'lincoln5', 'v3lox', 'vsalovnh', 'dtoome2', 'mmcdow4', 'savysaville', 'jacobs25', 'tmalone3', 'yuqili1', 'predatorhunter51', 'caz1429', 'anim007', 'zhu52', 'cfranc20', 'leech060191', 'hanbacca', 'yurilee2', 'pniemer2', 'wang212', 'adoboluver', 'josephxu', 'dou1', 'stanzzang', 'jang34', 'zhuxh529', 'zson2', 'yinghe3', 'drejmeisterdrej', 'bredemer', 'sundstr2', 'columbine', 'b3nny312', 'zhang155', 'isankar21', 'yohanko322', 'mattycat9000', 'lim89', 'rose4', 'rooney5', 'maninpat', 'juliusqueezer', 'roybell', 'cbarth2', 'bilalgabula', 'chanda2', 'alee13', 'campbel3', 'dmoonxp5', 'hansanderson', 'cigarsnob', 'rkuryl2', 'demint1', 'sebasti2', 'chitten1', 'kadakiy1', 'seanlee14', 'frisbie1', 'drtesla90', 'jpack91', 'yan16', 'osarenk1', 'keramat1', 'kevinlooby', 'murray18', 'tumblesoup', 'jifeixu', 'seanyen1', 'rccarca', 'nicozorro31', 'brinlee2', 'ysun12', None, 'cialdel1', 'wang217', 'sungbea89', 'toan52', 'sulas2', 'sc21cn', 'roy18', 'lylo', 'ehgma0821', 'fanwu1']"
2,65,146,8,7,"['campbel3', 'yinghe3', 'sc21cn', 'mkandel', 'pokemeng', 'fanwu1', 'andrewgrieve1']",138,"['adamwright08', 'convolution', 'wells8', 'sonicbro', 'landin', 'onay91', 'mikeudelhofen', 'creepdeadly', 'kane11', 'jashari1', 'chorvat2', 'mtzcardfan08', 'lawrenceli', 'tom69sawyer', 'dmgo17', 'mwang53', 'ahasija2', 'lmendez2', 'khaostehnoob', 'bradzab', 'scarlett', 'elachman', 'bettenh1', 'wheele11', 'godofdeath', 'mccann4', 'fluxayh', 'azure3t', 'kim325', 'profballack', 'dinger104', 'yening9063', 'yuan10', 'fahmad6', 'ededens', 'sherlaby25', 'alee60', 'gravityplanx', 'shah19', 'wolf13', 'takagi1', 'ammario', 'assem2', 'kantner1', 'young10', 'garcias1', 'ckhuang999', 'zstone2', 'rturner', 'chanj45', 'choquet1', 'scalise1', 'kylekalk', 'shah4u19', 'kong7', 'crisci1', 'awesly2', 'leijin3', 'danyangzhuo', 'searuff', 'enyuluo', 'digitalmouse12', 'rschmid2', 'lincoln5', 'v3lox', 'vsalovnh', 'dtoome2', 'mmcdow4', 'savysaville', 'jacobs25', 'tmalone3', 'yuqili1', 'predatorhunter51', 'caz1429', 'anim007', 'zhu52', 'cfranc20', 'leech060191', 'hanbacca', 'yurilee2', 'pniemer2', 'wang212', 'adoboluver', 'josephxu', 'dou1', 'stanzzang', 'jang34', 'zhuxh529', 'zson2', 'drejmeisterdrej', 'bredemer', 'sundstr2', 'columbine', 'b3nny312', 'zhang155', 'isankar21', 'yohanko322', 'mattycat9000', 'lim89', 'rose4', 'rooney5', 'maninpat', 'juliusqueezer', 'roybell', 'cbarth2', 'bilalgabula', 'chanda2', 'alee13', 'dmoonxp5', 'hansanderson', 'rkuryl2', 'demint1', 'sebasti2', 'chitten1', 'kadakiy1', 'seanlee14', 'frisbie1', 'drtesla90', 'jpack91', 'yan16', 'osarenk1', 'keramat1', 'kevinlooby', 'murray18', 'tumblesoup', 'jifeixu', 'seanyen1', 'rccarca', 'nicozorro31', 'brinlee2', 'ysun12', 'cialdel1', 'wang217', 'sungbea89', 'toan52', 'sulas2', 'lylo', 'ehgma0821']",1,[None],146,"['adamwright08', 'convolution', 'wells8', 'sonicbro', 'landin', 'onay91', 'mikeudelhofen', 'creepdeadly', 'kane11', 'jashari1', 'chorvat2', 'mtzcardfan08', 'lawrenceli', 'tom69sawyer', 'dmgo17', 'mwang53', 'ahasija2', 'lmendez2', 'khaostehnoob', 'bradzab', 'scarlett', 'elachman', 'bettenh1', 'andrewgrieve1', 'wheele11', 'godofdeath', 'mccann4', 'fluxayh', 'azure3t', 'kim325', 'profballack', 'dinger104', 'yening9063', 'yuan10', 'pokemeng', 'fahmad6', 'ededens', 'sherlaby25', 'alee60', 'gravityplanx', 'shah19', 'wolf13', 'takagi1', 'ammario', 'assem2', 'kantner1', 'young10', 'garcias1', 'ckhuang999', 'zstone2', 'rturner', 'chanj45', 'choquet1', 'scalise1', 'kylekalk', 'shah4u19', 'kong7', 'crisci1', 'awesly2', 'leijin3', 'danyangzhuo', 'searuff', 'mkandel', 'enyuluo', 'digitalmouse12', 'rschmid2', 'lincoln5', 'v3lox', 'vsalovnh', 'dtoome2', 'mmcdow4', 'savysaville', 'jacobs25', 'tmalone3', 'yuqili1', 'predatorhunter51', 'caz1429', 'anim007', 'zhu52', 'cfranc20', 'leech060191', 'hanbacca', 'yurilee2', 'pniemer2', 'wang212', 'adoboluver', 'josephxu', 'dou1', 'stanzzang', 'jang34', 'zhuxh529', 'zson2', 'yinghe3', 'drejmeisterdrej', 'bredemer', 'sundstr2', 'columbine', 'b3nny312', 'zhang155', 'isankar21', 'yohanko322', 'mattycat9000', 'lim89', 'rose4', 'rooney5', 'maninpat', 'juliusqueezer', 'roybell', 'cbarth2', 'bilalgabula', 'chanda2', 'alee13', 'campbel3', 'dmoonxp5', 'hansanderson', 'rkuryl2', 'demint1', 'sebasti2', 'chitten1', 'kadakiy1', 'seanlee14', 'frisbie1', 'drtesla90', 'jpack91', 'yan16', 'osarenk1', 'keramat1', 'kevinlooby', 'murray18', 'tumblesoup', 'jifeixu', 'seanyen1', 'rccarca', 'nicozorro31', 'brinlee2', 'ysun12', None, 'cialdel1', 'wang217', 'sungbea89', 'toan52', 'sulas2', 'sc21cn', 'lylo', 'ehgma0821', 'fanwu1']"
2,66,146,7,5,"['wheele11', 'crisci1', 'rturner', 'lylo', 'drtesla90']",140,"['adamwright08', 'convolution', 'wells8', 'sonicbro', 'landin', 'onay91', 'mikeudelhofen', 'creepdeadly', 'kane11', 'jashari1', 'chorvat2', 'mtzcardfan08', 'lawrenceli', 'tom69sawyer', 'dmgo17', 'mwang53', 'ahasija2', 'lmendez2', 'khaostehnoob', 'bradzab', 'scarlett', 'elachman', 'bettenh1', 'andrewgrieve1', 'godofdeath', 'mccann4', 'fluxayh', 'azure3t', 'kim325', 'profballack', 'dinger104', 'yening9063', 'yuan10', 'pokemeng', 'fahmad6', 'ededens', 'sherlaby25', 'alee60', 'gravityplanx', 'shah19', 'wolf13', 'takagi1', 'ammario', 'assem2', 'kantner1', 'young10', 'garcias1', 'ckhuang999', 'zstone2', 'chanj45', 'choquet1', 'scalise1', 'kylekalk', 'shah4u19', 'kong7', 'awesly2', 'leijin3', 'danyangzhuo', 'searuff', 'mkandel', 'enyuluo', 'digitalmouse12', 'rschmid2', 'lincoln5', 'v3lox', 'vsalovnh', 'dtoome2', 'mmcdow4', 'savysaville', 'jacobs25', 'tmalone3', 'yuqili1', 'predatorhunter51', 'caz1429', 'anim007', 'zhu52', 'cfranc20', 'leech060191', 'hanbacca', 'yurilee2', 'pniemer2', 'wang212', 'adoboluver', 'josephxu', 'dou1', 'stanzzang', 'jang34', 'zhuxh529', 'zson2', 'yinghe3', 'drejmeisterdrej', 'bredemer', 'sundstr2', 'columbine', 'b3nny312', 'zhang155', 'isankar21', 'yohanko322', 'mattycat9000', 'lim89', 'rose4', 'rooney5', 'maninpat', 'juliusqueezer', 'roybell', 'cbarth2', 'bilalgabula', 'chanda2', 'alee13', 'campbel3', 'dmoonxp5', 'hansanderson', 'rkuryl2', 'demint1', 'sebasti2', 'chitten1', 'kadakiy1', 'seanlee14', 'frisbie1', 'jpack91', 'yan16', 'osarenk1', 'keramat1', 'kevinlooby', 'murray18', 'tumblesoup', 'jifeixu', 'seanyen1', 'rccarca', 'nicozorro31', 'brinlee2', 'ysun12', 'cialdel1', 'wang217', 'sungbea89', 'toan52', 'sulas2', 'sc21cn', 'ehgma0821', 'fanwu1']",2,"[None, 'tovarbr2']",147,"['adamwright08', 'convolution', 'wells8', 'sonicbro', 'landin', 'onay91', 'mikeudelhofen', 'creepdeadly', 'kane11', 'jashari1', 'chorvat2', 'mtzcardfan08', 'lawrenceli', 'tom69sawyer', 'dmgo17', 'mwang53', 'ahasija2', 'lmendez2', 'khaostehnoob', 'bradzab', 'scarlett', 'elachman', 'bettenh1', 'andrewgrieve1', 'wheele11', 'godofdeath', 'mccann4', 'fluxayh', 'azure3t', 'kim325', 'profballack', 'dinger104', 'yening9063', 'yuan10', 'pokemeng', 'fahmad6', 'ededens', 'sherlaby25', 'alee60', 'gravityplanx', 'shah19', 'wolf13', 'takagi1', 'ammario', 'assem2', 'kantner1', 'young10', 'garcias1', 'ckhuang999', 'zstone2', 'rturner', 'tovarbr2', 'chanj45', 'choquet1', 'scalise1', 'kylekalk', 'shah4u19', 'kong7', 'crisci1', 'awesly2', 'leijin3', 'danyangzhuo', 'searuff', 'mkandel', 'enyuluo', 'digitalmouse12', 'rschmid2', 'lincoln5', 'v3lox', 'vsalovnh', 'dtoome2', 'mmcdow4', 'savysaville', 'jacobs25', 'tmalone3', 'yuqili1', 'predatorhunter51', 'caz1429', 'anim007', 'zhu52', 'cfranc20', 'leech060191', 'hanbacca', 'yurilee2', 'pniemer2', 'wang212', 'adoboluver', 'josephxu', 'dou1', 'stanzzang', 'jang34', 'zhuxh529', 'zson2', 'yinghe3', 'drejmeisterdrej', 'bredemer', 'sundstr2', 'columbine', 'b3nny312', 'zhang155', 'isankar21', 'yohanko322', 'mattycat9000', 'lim89', 'rose4', 'rooney5', 'maninpat', 'juliusqueezer', 'roybell', 'cbarth2', 'bilalgabula', 'chanda2', 'alee13', 'campbel3', 'dmoonxp5', 'hansanderson', 'rkuryl2', 'demint1', 'sebasti2', 'chitten1', 'kadakiy1', 'seanlee14', 'frisbie1', 'drtesla90', 'jpack91', 'yan16', 'osarenk1', 'keramat1', 'kevinlooby', 'murray18', 'tumblesoup', 'jifeixu', 'seanyen1', 'rccarca', 'nicozorro31', 'brinlee2', 'ysun12', None, 'cialdel1', 'wang217', 'sungbea89', 'toan52', 'sulas2', 'sc21cn', 'lylo', 'ehgma0821', 'fanwu1']"
3,156,141,101,85,"['charunima', 'kirtidahiya', 'arpitnano', 'suchismitanaik15', 'sriks218', 'paanini', 'singhalananya', 'sugandha179', 'kanu', 'aviral0301', 'rahul108', 'arjunnarang09', 'taijasmalpani91', 'supriyask07', 'nimbus1789', 'devavrata', 'premsarit', 'f2009033', 'chithra', 'akshaypb', 'litta127', 'dhruva', 'milim_3011', 'kavya_bobba', 'nitisha9', 'fatimadilruba', 'the_dark_druid', 'raviteja2504', 'jinalnshah', 'ronkapres', 'djdylan2000', 'sudhachocky', 'akansha_suneria', 'adi23jan', 'vaibhavuppal', 'sarthakpranit', 'g00se', 'ashingeorge', 'f2009349', 'venkateshkadimi', 'f2009a8ps275g', 'ender024', 'akriti_1', 'krishnamurthy5111', 'sidhartha57', 'ramanladda', 'sahainitin9795', 'jaykhattar9', 'hemuviru319', 'surya210892', 'kasturibhardwaj', 'sameer2190', 'varadg', 'meghachat', 'bharathbr', 'amandushivakrishna', 'aksbelbi', 'xerios', 'nehamohanty12', 'apurvamudgal', 'aakashsrivastava', 'destinyindia123', 'disha_gujar', 'glaze', 'anpsys', 'satyadeepakav', 'timtim', 'benthomas', 'mnk319', 'isha8', '2008b1a3689g', 'aak', 'mudit', 'f2009336', 'svrbasky', 'rahul_ch', 'kavya', 'sunket001', 'tulsidaskhan20', 'desh1tanuj', 'ashwin15990', 'vignesh', 'tsathwik063', 'rhljn100', 'vijaykrishn']",55,"['smkohen', 'sergiu_ducoci', 'daniel_doros', 'bijay2011', 'stefanovenica', 'mtoledo', 'roodabeh', 'zjy63562688', 'kevinlewis', 'jstubbs2', 'maljar', 'athomas9', 'vinhle1984', 'chiming', 'jadcockee2401', 'sqesy', 'b2daj16', 'aadebayo', 'sandokan80', 'akerin17', 'jhobbs3', 'oasoro', 'anmuydarp', 'hspuneet', 'manojchaulagain', 'f2008373', 'jaguiler', 'plambert', 'mgentile', 'rickmanbl', 'deinemutter', 'abenton1', 'petarap', 'spencebot', 'rowyche', 'koneill', 'ankitamahapatra', 'tookie', 'ksteele', 'echike', 'pietp', 'ddrake', 'ameseret2011', 'anushadudi', 'g_leonidas', 'baer123', 'bari_fs', 'johnorlando14', 'pcousins', 'nickbob00', 'drhodges', 'jrod091', 'adijatu', 'allanxiao', 'zanibakat']",16,"['rishabhkeshari', 'ragalasya', 'ajmal123', 'sauravkrsrivastav', 'akash721', 'preyas3359', 'suhassuraj', 'karnatichethana', 'vamsik', 'damit92', 'maanitm', 'nikhil2612', None, 'barkhabits', 'shabbarboy1991', 'neethubal']",156,"['smkohen', 'charunima', 'kirtidahiya', 'arpitnano', 'suchismitanaik15', 'stefanovenica', 'mtoledo', 'zjy63562688', 'sriks218', 'paanini', 'vamsik', 'vinhle1984', 'ragalasya', 'singhalananya', 'jadcockee2401', 'suhassuraj', 'maanitm', 'oasoro', 'manojchaulagain', 'mgentile', 'sugandha179', 'rishabhkeshari', 'petarap', 'aviral0301', 'kanu', 'spencebot', 'ksteele', 'rahul108', 'echike', 'arjunnarang09', 'nimbus1789', 'taijasmalpani91', 'supriyask07', 'ameseret2011', 'barkhabits', 'shabbarboy1991', 'pcousins', 'devavrata', 'premsarit', 'f2009033', 'nickbob00', 'jrod091', 'chithra', 'akshaypb', 'litta127', 'dhruva', 'sergiu_ducoci', 'daniel_doros', 'milim_3011', 'kevinlewis', 'nitisha9', 'kavya_bobba', 'jstubbs2', 'fatimadilruba', 'raviteja2504', 'the_dark_druid', 'jinalnshah', 'ronkapres', 'djdylan2000', 'sqesy', 'b2daj16', 'sudhachocky', 'aadebayo', 'akerin17', 'jhobbs3', 'akansha_suneria', 'plambert', 'deinemutter', 'abenton1', 'adi23jan', 'vaibhavuppal', 'ankitamahapatra', 'sarthakpranit', 'g00se', 'ashingeorge', 'anushadudi', 'f2009349', 'venkateshkadimi', 'f2009a8ps275g', 'johnorlando14', 'akash721', 'ender024', 'akriti_1', 'nikhil2612', 'krishnamurthy5111', 'sahainitin9795', 'ramanladda', 'sidhartha57', 'jaykhattar9', 'bijay2011', 'preyas3359', 'roodabeh', 'hemuviru319', 'maljar', 'kasturibhardwaj', 'surya210892', 'chiming', 'sameer2190', 'sandokan80', 'varadg', 'meghachat', 'anmuydarp', 'jaguiler', 'bharathbr', 'amandushivakrishna', 'rowyche', 'tookie', 'aksbelbi', 'pietp', 'ddrake', 'xerios', 'nehamohanty12', 'apurvamudgal', 'baer123', 'aakashsrivastava', 'destinyindia123', 'disha_gujar', 'neethubal', 'glaze', 'anpsys', 'satyadeepakav', 'timtim', 'benthomas', 'mnk319', 'isha8', '2008b1a3689g', 'sauravkrsrivastav', 'aak', 'mudit', 'f2009336', 'athomas9', 'svrbasky', 'ajmal123', 'rahul_ch', 'kavya', 'damit92', 'sunket001', 'hspuneet', 'f2008373', 'tulsidaskhan20', 'rickmanbl', 'desh1tanuj', 'koneill', 'ashwin15990', 'vignesh', 'tsathwik063', None, 'g_leonidas', 'rhljn100', 'bari_fs', 'karnatichethana', 'drhodges', 'adijatu', 'allanxiao', 'zanibakat', 'vijaykrishn']"
3,158,141,25,23,"['sergiu_ducoci', 'maljar', 'jstubbs2', 'jadcockee2401', 'b2daj16', 'sandokan80', 'aadebayo', 'oasoro', 'manojchaulagain', 'jaguiler', 'mgentile', 'rowyche', 'ksteele', 'echike', 'ddrake', 'ameseret2011', 'g_leonidas', 'johnorlando14', 'pcousins', 'drhodges', 'jrod091', 'adijatu', 'zanibakat']",117,"['smkohen', 'charunima', 'kirtidahiya', 'arpitnano', 'suchismitanaik15', 'stefanovenica', 'mtoledo', 'zjy63562688', 'sriks218', 'paanini', 'vinhle1984', 'singhalananya', 'sugandha179', 'petarap', 'aviral0301', 'kanu', 'spencebot', 'rahul108', 'arjunnarang09', 'nimbus1789', 'taijasmalpani91', 'supriyask07', 'devavrata', 'premsarit', 'f2009033', 'nickbob00', 'chithra', 'akshaypb', 'litta127', 'dhruva', 'daniel_doros', 'milim_3011', 'kevinlewis', 'nitisha9', 'kavya_bobba', 'fatimadilruba', 'raviteja2504', 'the_dark_druid', 'jinalnshah', 'ronkapres', 'djdylan2000', 'sqesy', 'sudhachocky', 'akerin17', 'jhobbs3', 'akansha_suneria', 'plambert', 'deinemutter', 'abenton1', 'adi23jan', 'vaibhavuppal', 'ankitamahapatra', 'sarthakpranit', 'g00se', 'ashingeorge', 'anushadudi', 'f2009349', 'venkateshkadimi', 'f2009a8ps275g', 'ender024', 'akriti_1', 'krishnamurthy5111', 'sahainitin9795', 'ramanladda', 'sidhartha57', 'jaykhattar9', 'bijay2011', 'roodabeh', 'hemuviru319', 'kasturibhardwaj', 'surya210892', 'chiming', 'sameer2190', 'varadg', 'meghachat', 'anmuydarp', 'bharathbr', 'amandushivakrishna', 'tookie', 'aksbelbi', 'pietp', 'xerios', 'nehamohanty12', 'apurvamudgal', 'baer123', 'aakashsrivastava', 'destinyindia123', 'disha_gujar', 'glaze', 'anpsys', 'satyadeepakav', 'timtim', 'benthomas', 'mnk319', 'isha8', '2008b1a3689g', 'aak', 'mudit', 'f2009336', 'athomas9', 'svrbasky', 'rahul_ch', 'kavya', 'sunket001', 'hspuneet', 'f2008373', 'tulsidaskhan20', 'rickmanbl', 'desh1tanuj', 'koneill', 'ashwin15990', 'vignesh', 'tsathwik063', 'rhljn100', 'bari_fs', 'allanxiao', 'vijaykrishn']",2,"['jgopel', None]",142,"['smkohen', 'charunima', 'kirtidahiya', 'arpitnano', 'suchismitanaik15', 'stefanovenica', 'mtoledo', 'zjy63562688', 'sriks218', 'paanini', 'vinhle1984', 'singhalananya', 'jadcockee2401', 'oasoro', 'manojchaulagain', 'mgentile', 'sugandha179', 'petarap', 'aviral0301', 'kanu', 'spencebot', 'ksteele', 'rahul108', 'echike', 'arjunnarang09', 'nimbus1789', 'taijasmalpani91', 'supriyask07', 'ameseret2011', 'pcousins', 'devavrata', 'premsarit', 'f2009033', 'nickbob00', 'jrod091', 'chithra', 'akshaypb', 'litta127', 'dhruva', 'sergiu_ducoci', 'daniel_doros', 'milim_3011', 'kevinlewis', 'nitisha9', 'kavya_bobba', 'jstubbs2', 'fatimadilruba', 'raviteja2504', 'the_dark_druid', 'jinalnshah', 'ronkapres', 'djdylan2000', 'sqesy', 'b2daj16', 'sudhachocky', 'aadebayo', 'akerin17', 'jhobbs3', 'akansha_suneria', 'plambert', 'deinemutter', 'abenton1', 'adi23jan', 'vaibhavuppal', 'ankitamahapatra', 'sarthakpranit', 'g00se', 'ashingeorge', 'anushadudi', 'f2009349', 'venkateshkadimi', 'f2009a8ps275g', 'johnorlando14', 'ender024', 'akriti_1', 'krishnamurthy5111', 'jgopel', 'sahainitin9795', 'ramanladda', 'sidhartha57', 'jaykhattar9', 'bijay2011', 'roodabeh', 'hemuviru319', 'maljar', 'kasturibhardwaj', 'surya210892', 'chiming', 'sameer2190', 'sandokan80', 'varadg', 'meghachat', 'anmuydarp', 'jaguiler', 'bharathbr', 'amandushivakrishna', 'rowyche', 'tookie', 'aksbelbi', 'pietp', 'ddrake', 'xerios', 'nehamohanty12', 'apurvamudgal', 'baer123', 'aakashsrivastava', 'destinyindia123', 'disha_gujar', 'glaze', 'anpsys', 'satyadeepakav', 'timtim', 'benthomas', 'mnk319', 'isha8', '2008b1a3689g', 'aak', 'mudit', 'f2009336', 'athomas9', 'svrbasky', 'rahul_ch', 'kavya', 'sunket001', 'hspuneet', 'f2008373', 'tulsidaskhan20', 'rickmanbl', 'desh1tanuj', 'koneill', 'ashwin15990', 'vignesh', 'tsathwik063', None, 'g_leonidas', 'rhljn100', 'bari_fs', 'drhodges', 'adijatu', 'allanxiao', 'zanibakat', 'vijaykrishn']"
3,15,141,19,3,"['suchismitanaik15', 'benthomas', 'kasturibhardwaj']",137,"['smkohen', 'charunima', 'kirtidahiya', 'arpitnano', 'stefanovenica', 'mtoledo', 'zjy63562688', 'sriks218', 'paanini', 'vinhle1984', 'singhalananya', 'jadcockee2401', 'oasoro', 'manojchaulagain', 'mgentile', 'sugandha179', 'petarap', 'aviral0301', 'kanu', 'spencebot', 'ksteele', 'rahul108', 'echike', 'arjunnarang09', 'nimbus1789', 'taijasmalpani91', 'supriyask07', 'ameseret2011', 'pcousins', 'devavrata', 'premsarit', 'f2009033', 'nickbob00', 'jrod091', 'chithra', 'akshaypb', 'litta127', 'dhruva', 'sergiu_ducoci', 'daniel_doros', 'milim_3011', 'kevinlewis', 'nitisha9', 'kavya_bobba', 'jstubbs2', 'fatimadilruba', 'raviteja2504', 'the_dark_druid', 'jinalnshah', 'ronkapres', 'djdylan2000', 'sqesy', 'b2daj16', 'sudhachocky', 'aadebayo', 'akerin17', 'jhobbs3', 'akansha_suneria', 'plambert', 'deinemutter', 'abenton1', 'adi23jan', 'vaibhavuppal', 'ankitamahapatra', 'sarthakpranit', 'g00se', 'ashingeorge', 'anushadudi', 'f2009349', 'venkateshkadimi', 'f2009a8ps275g', 'johnorlando14', 'ender024', 'akriti_1', 'krishnamurthy5111', 'sahainitin9795', 'ramanladda', 'sidhartha57', 'jaykhattar9', 'bijay2011', 'roodabeh', 'hemuviru319', 'maljar', 'surya210892', 'chiming', 'sameer2190', 'sandokan80', 'varadg', 'meghachat', 'anmuydarp', 'jaguiler', 'bharathbr', 'amandushivakrishna', 'rowyche', 'tookie', 'aksbelbi', 'pietp', 'ddrake', 'xerios', 'nehamohanty12', 'apurvamudgal', 'baer123', 'aakashsrivastava', 'destinyindia123', 'disha_gujar', 'glaze', 'anpsys', 'satyadeepakav', 'timtim', 'mnk319', 'isha8', '2008b1a3689g', 'aak', 'mudit', 'f2009336', 'athomas9', 'svrbasky', 'rahul_ch', 'kavya', 'sunket001', 'hspuneet', 'f2008373', 'tulsidaskhan20', 'rickmanbl', 'desh1tanuj', 'koneill', 'ashwin15990', 'vignesh', 'tsathwik063', 'g_leonidas', 'rhljn100', 'bari_fs', 'drhodges', 'adijatu', 'allanxiao', 'zanibakat', 'vijaykrishn']",16,"['gauravmisra', 'gandhikunjan', 'gvenkatesh', 'sreedevi', 'rockinraghavan', 'sakshambhatla', 'vibhutiawasthi', 'mihir1190', 'suhassuraj', None, 'pavankumar', 'govindam', 'anandsatya', 'vakul319', 'shishirsalvatore', 'neethubal']",156,"['smkohen', 'charunima', 'kirtidahiya', 'arpitnano', 'suchismitanaik15', 'stefanovenica', 'mtoledo', 'zjy63562688', 'sriks218', 'paanini', 'vinhle1984', 'singhalananya', 'jadcockee2401', 'suhassuraj', 'oasoro', 'manojchaulagain', 'mgentile', 'sugandha179', 'petarap', 'aviral0301', 'kanu', 'spencebot', 'vibhutiawasthi', 'ksteele', 'rahul108', 'echike', 'arjunnarang09', 'nimbus1789', 'taijasmalpani91', 'supriyask07', 'ameseret2011', 'rockinraghavan', 'sreedevi', 'pcousins', 'devavrata', 'premsarit', 'f2009033', 'nickbob00', 'jrod091', 'chithra', 'akshaypb', 'litta127', 'dhruva', 'gandhikunjan', 'sergiu_ducoci', 'daniel_doros', 'milim_3011', 'kevinlewis', 'nitisha9', 'kavya_bobba', 'jstubbs2', 'fatimadilruba', 'raviteja2504', 'the_dark_druid', 'jinalnshah', 'ronkapres', 'djdylan2000', 'sqesy', 'b2daj16', 'sudhachocky', 'aadebayo', 'akerin17', 'jhobbs3', 'shishirsalvatore', 'akansha_suneria', 'plambert', 'deinemutter', 'abenton1', 'adi23jan', 'vaibhavuppal', 'ankitamahapatra', 'sarthakpranit', 'g00se', 'ashingeorge', 'anushadudi', 'gauravmisra', 'f2009349', 'venkateshkadimi', 'f2009a8ps275g', 'johnorlando14', 'ender024', 'akriti_1', 'krishnamurthy5111', 'sahainitin9795', 'ramanladda', 'sidhartha57', 'jaykhattar9', 'bijay2011', 'roodabeh', 'hemuviru319', 'maljar', 'kasturibhardwaj', 'surya210892', 'chiming', 'sameer2190', 'sandokan80', 'varadg', 'meghachat', 'anmuydarp', 'jaguiler', 'bharathbr', 'amandushivakrishna', 'rowyche', 'sakshambhatla', 'tookie', 'aksbelbi', 'pietp', 'ddrake', 'pavankumar', 'xerios', 'nehamohanty12', 'apurvamudgal', 'baer123', 'gvenkatesh', 'aakashsrivastava', 'destinyindia123', 'disha_gujar', 'neethubal', 'glaze', 'anpsys', 'satyadeepakav', 'timtim', 'benthomas', 'mnk319', 'isha8', '2008b1a3689g', 'mihir1190', 'aak', 'mudit', 'f2009336', 'govindam', 'anandsatya', 'athomas9', 'svrbasky', 'rahul_ch', 'kavya', 'sunket001', 'hspuneet', 'f2008373', 'vakul319', 'tulsidaskhan20', 'rickmanbl', 'desh1tanuj', 'koneill', 'ashwin15990', 'vignesh', 'tsathwik063', None, 'g_leonidas', 'rhljn100', 'bari_fs', 'drhodges', 'adijatu', 'allanxiao', 'zanibakat', 'vijaykrishn']"
3,155,141,18,1,['zjy63562688'],139,"['smkohen', 'charunima', 'kirtidahiya', 'arpitnano', 'suchismitanaik15', 'stefanovenica', 'mtoledo', 'sriks218', 'paanini', 'vinhle1984', 'singhalananya', 'jadcockee2401', 'oasoro', 'manojchaulagain', 'mgentile', 'sugandha179', 'petarap', 'aviral0301', 'kanu', 'spencebot', 'ksteele', 'rahul108', 'echike', 'arjunnarang09', 'nimbus1789', 'taijasmalpani91', 'supriyask07', 'ameseret2011', 'pcousins', 'devavrata', 'premsarit', 'f2009033', 'nickbob00', 'jrod091', 'chithra', 'akshaypb', 'litta127', 'dhruva', 'sergiu_ducoci', 'daniel_doros', 'milim_3011', 'kevinlewis', 'nitisha9', 'kavya_bobba', 'jstubbs2', 'fatimadilruba', 'raviteja2504', 'the_dark_druid', 'jinalnshah', 'ronkapres', 'djdylan2000', 'sqesy', 'b2daj16', 'sudhachocky', 'aadebayo', 'akerin17', 'jhobbs3', 'akansha_suneria', 'plambert', 'deinemutter', 'abenton1', 'adi23jan', 'vaibhavuppal', 'ankitamahapatra', 'sarthakpranit', 'g00se', 'ashingeorge', 'anushadudi', 'f2009349', 'venkateshkadimi', 'f2009a8ps275g', 'johnorlando14', 'ender024', 'akriti_1', 'krishnamurthy5111', 'sahainitin9795', 'ramanladda', 'sidhartha57', 'jaykhattar9', 'bijay2011', 'roodabeh', 'hemuviru319', 'maljar', 'kasturibhardwaj', 'surya210892', 'chiming', 'sameer2190', 'sandokan80', 'varadg', 'meghachat', 'anmuydarp', 'jaguiler', 'bharathbr', 'amandushivakrishna', 'rowyche', 'tookie', 'aksbelbi', 'pietp', 'ddrake', 'xerios', 'nehamohanty12', 'apurvamudgal', 'baer123', 'aakashsrivastava', 'destinyindia123', 'disha_gujar', 'glaze', 'anpsys', 'satyadeepakav', 'timtim', 'benthomas', 'mnk319', 'isha8', '2008b1a3689g', 'aak', 'mudit', 'f2009336', 'athomas9', 'svrbasky', 'rahul_ch', 'kavya', 'sunket001', 'hspuneet', 'f2008373', 'tulsidaskhan20', 'rickmanbl', 'desh1tanuj', 'koneill', 'ashwin15990', 'vignesh', 'tsathwik063', 'g_leonidas', 'rhljn100', 'bari_fs', 'drhodges', 'adijatu', 'allanxiao', 'zanibakat', 'vijaykrishn']",17,"['ccccccccat', 'aabedin', 'pevere', 'amonge', 'hoda', 'sunil221', 'amjadiq', 'himanshuk', 'mdcmunoz', 'reyhaneh_soltan', 'sarahri', 'kunli', 'parnimi', 'fgeenen', 'mikekeee', 'arashsalemi1976', None]",157,"['smkohen', 'charunima', 'kirtidahiya', 'arpitnano', 'suchismitanaik15', 'stefanovenica', 'mtoledo', 'zjy63562688', 'sriks218', 'paanini', 'vinhle1984', 'singhalananya', 'amjadiq', 'jadcockee2401', 'oasoro', 'manojchaulagain', 'mgentile', 'sugandha179', 'petarap', 'pevere', 'aviral0301', 'kanu', 'spencebot', 'reyhaneh_soltan', 'sarahri', 'ksteele', 'rahul108', 'echike', 'arjunnarang09', 'nimbus1789', 'taijasmalpani91', 'supriyask07', 'ameseret2011', 'pcousins', 'devavrata', 'mdcmunoz', 'premsarit', 'f2009033', 'nickbob00', 'parnimi', 'jrod091', 'chithra', 'akshaypb', 'litta127', 'arashsalemi1976', 'dhruva', 'sergiu_ducoci', 'daniel_doros', 'milim_3011', 'kevinlewis', 'nitisha9', 'kavya_bobba', 'jstubbs2', 'fatimadilruba', 'raviteja2504', 'the_dark_druid', 'jinalnshah', 'ronkapres', 'djdylan2000', 'sqesy', 'b2daj16', 'sudhachocky', 'aadebayo', 'akerin17', 'jhobbs3', 'akansha_suneria', 'plambert', 'deinemutter', 'abenton1', 'adi23jan', 'vaibhavuppal', 'ankitamahapatra', 'sarthakpranit', 'g00se', 'ashingeorge', 'anushadudi', 'f2009349', 'venkateshkadimi', 'f2009a8ps275g', 'johnorlando14', 'ender024', 'akriti_1', 'krishnamurthy5111', 'aabedin', 'sahainitin9795', 'ramanladda', 'sidhartha57', 'jaykhattar9', 'bijay2011', 'roodabeh', 'kunli', 'hemuviru319', 'maljar', 'kasturibhardwaj', 'surya210892', 'chiming', 'sameer2190', 'sandokan80', 'varadg', 'meghachat', 'anmuydarp', 'jaguiler', 'ccccccccat', 'bharathbr', 'hoda', 'amandushivakrishna', 'rowyche', 'tookie', 'aksbelbi', 'pietp', 'ddrake', 'xerios', 'nehamohanty12', 'apurvamudgal', 'baer123', 'aakashsrivastava', 'destinyindia123', 'disha_gujar', 'glaze', 'anpsys', 'satyadeepakav', 'timtim', 'benthomas', 'mnk319', 'isha8', '2008b1a3689g', 'sunil221', 'aak', 'mudit', 'f2009336', 'mikekeee', 'athomas9', 'svrbasky', 'rahul_ch', 'himanshuk', 'kavya', 'fgeenen', 'sunket001', 'hspuneet', 'f2008373', 'tulsidaskhan20', 'rickmanbl', 'desh1tanuj', 'amonge', 'koneill', 'ashwin15990', 'vignesh', 'tsathwik063', None, 'g_leonidas', 'rhljn100', 'bari_fs', 'drhodges', 'adijatu', 'allanxiao', 'zanibakat', 'vijaykrishn']"
3,74,141,15,8,"['charunima', 'kanu', 'aviral0301', 'sahainitin9795', 'djdylan2000', 'ramanladda', 'raviteja2504', 'dhruva']",132,"['smkohen', 'kirtidahiya', 'arpitnano', 'suchismitanaik15', 'stefanovenica', 'mtoledo', 'zjy63562688', 'sriks218', 'paanini', 'vinhle1984', 'singhalananya', 'jadcockee2401', 'oasoro', 'manojchaulagain', 'mgentile', 'sugandha179', 'petarap', 'spencebot', 'ksteele', 'rahul108', 'echike', 'arjunnarang09', 'nimbus1789', 'taijasmalpani91', 'supriyask07', 'ameseret2011', 'pcousins', 'devavrata', 'premsarit', 'f2009033', 'nickbob00', 'jrod091', 'chithra', 'akshaypb', 'litta127', 'sergiu_ducoci', 'daniel_doros', 'milim_3011', 'kevinlewis', 'nitisha9', 'kavya_bobba', 'jstubbs2', 'fatimadilruba', 'the_dark_druid', 'jinalnshah', 'ronkapres', 'sqesy', 'b2daj16', 'sudhachocky', 'aadebayo', 'akerin17', 'jhobbs3', 'akansha_suneria', 'plambert', 'deinemutter', 'abenton1', 'adi23jan', 'vaibhavuppal', 'ankitamahapatra', 'sarthakpranit', 'g00se', 'ashingeorge', 'anushadudi', 'f2009349', 'venkateshkadimi', 'f2009a8ps275g', 'johnorlando14', 'ender024', 'akriti_1', 'krishnamurthy5111', 'sidhartha57', 'jaykhattar9', 'bijay2011', 'roodabeh', 'hemuviru319', 'maljar', 'kasturibhardwaj', 'surya210892', 'chiming', 'sameer2190', 'sandokan80', 'varadg', 'meghachat', 'anmuydarp', 'jaguiler', 'bharathbr', 'amandushivakrishna', 'rowyche', 'tookie', 'aksbelbi', 'pietp', 'ddrake', 'xerios', 'nehamohanty12', 'apurvamudgal', 'baer123', 'aakashsrivastava', 'destinyindia123', 'disha_gujar', 'glaze', 'anpsys', 'satyadeepakav', 'timtim', 'benthomas', 'mnk319', 'isha8', '2008b1a3689g', 'aak', 'mudit', 'f2009336', 'athomas9', 'svrbasky', 'rahul_ch', 'kavya', 'sunket001', 'hspuneet', 'f2008373', 'tulsidaskhan20', 'rickmanbl', 'desh1tanuj', 'koneill', 'ashwin15990', 'vignesh', 'tsathwik063', 'g_leonidas', 'rhljn100', 'bari_fs', 'drhodges', 'adijatu', 'allanxiao', 'zanibakat', 'vijaykrishn']",7,"['ragalasya', 'akash721', 'karnatichethana', 'niharika', 'sucheta', None, 'barkhabits']",147,"['smkohen', 'charunima', 'kirtidahiya', 'arpitnano', 'suchismitanaik15', 'stefanovenica', 'mtoledo', 'zjy63562688', 'sriks218', 'paanini', 'vinhle1984', 'ragalasya', 'singhalananya', 'jadcockee2401', 'oasoro', 'manojchaulagain', 'mgentile', 'sugandha179', 'petarap', 'aviral0301', 'kanu', 'spencebot', 'ksteele', 'rahul108', 'echike', 'arjunnarang09', 'nimbus1789', 'taijasmalpani91', 'supriyask07', 'ameseret2011', 'barkhabits', 'pcousins', 'devavrata', 'premsarit', 'f2009033', 'nickbob00', 'jrod091', 'chithra', 'akshaypb', 'litta127', 'dhruva', 'sergiu_ducoci', 'daniel_doros', 'milim_3011', 'kevinlewis', 'nitisha9', 'kavya_bobba', 'jstubbs2', 'fatimadilruba', 'raviteja2504', 'the_dark_druid', 'jinalnshah', 'ronkapres', 'djdylan2000', 'sqesy', 'b2daj16', 'sudhachocky', 'aadebayo', 'akerin17', 'jhobbs3', 'akansha_suneria', 'plambert', 'deinemutter', 'abenton1', 'adi23jan', 'vaibhavuppal', 'ankitamahapatra', 'sarthakpranit', 'g00se', 'ashingeorge', 'anushadudi', 'f2009349', 'venkateshkadimi', 'f2009a8ps275g', 'johnorlando14', 'akash721', 'ender024', 'akriti_1', 'krishnamurthy5111', 'sahainitin9795', 'ramanladda', 'sidhartha57', 'jaykhattar9', 'bijay2011', 'roodabeh', 'hemuviru319', 'maljar', 'kasturibhardwaj', 'surya210892', 'chiming', 'sameer2190', 'sandokan80', 'varadg', 'meghachat', 'anmuydarp', 'jaguiler', 'bharathbr', 'amandushivakrishna', 'rowyche', 'tookie', 'aksbelbi', 'pietp', 'ddrake', 'xerios', 'nehamohanty12', 'apurvamudgal', 'baer123', 'aakashsrivastava', 'destinyindia123', 'disha_gujar', 'sucheta', 'glaze', 'anpsys', 'satyadeepakav', 'timtim', 'benthomas', 'mnk319', 'isha8', '2008b1a3689g', 'aak', 'mudit', 'f2009336', 'athomas9', 'svrbasky', 'rahul_ch', 'kavya', 'sunket001', 'hspuneet', 'f2008373', 'tulsidaskhan20', 'rickmanbl', 'desh1tanuj', 'koneill', 'ashwin15990', 'vignesh', 'tsathwik063', None, 'g_leonidas', 'rhljn100', 'bari_fs', 'karnatichethana', 'drhodges', 'adijatu', 'niharika', 'allanxiao', 'zanibakat', 'vijaykrishn']"
3,148,141,13,8,"['rhljn100', 'venkateshkadimi', 'ronkapres', 'kavya', 'chithra', 'kavya_bobba', 'raviteja2504', 'surya210892']",132,"['smkohen', 'charunima', 'kirtidahiya', 'arpitnano', 'suchismitanaik15', 'stefanovenica', 'mtoledo', 'zjy63562688', 'sriks218', 'paanini', 'vinhle1984', 'singhalananya', 'jadcockee2401', 'oasoro', 'manojchaulagain', 'mgentile', 'sugandha179', 'petarap', 'aviral0301', 'kanu', 'spencebot', 'ksteele', 'rahul108', 'echike', 'arjunnarang09', 'nimbus1789', 'taijasmalpani91', 'supriyask07', 'ameseret2011', 'pcousins', 'devavrata', 'premsarit', 'f2009033', 'nickbob00', 'jrod091', 'akshaypb', 'litta127', 'dhruva', 'sergiu_ducoci', 'daniel_doros', 'milim_3011', 'kevinlewis', 'nitisha9', 'jstubbs2', 'fatimadilruba', 'the_dark_druid', 'jinalnshah', 'djdylan2000', 'sqesy', 'b2daj16', 'sudhachocky', 'aadebayo', 'akerin17', 'jhobbs3', 'akansha_suneria', 'plambert', 'deinemutter', 'abenton1', 'adi23jan', 'vaibhavuppal', 'ankitamahapatra', 'sarthakpranit', 'g00se', 'ashingeorge', 'anushadudi', 'f2009349', 'f2009a8ps275g', 'johnorlando14', 'ender024', 'akriti_1', 'krishnamurthy5111', 'sahainitin9795', 'ramanladda', 'sidhartha57', 'jaykhattar9', 'bijay2011', 'roodabeh', 'hemuviru319', 'maljar', 'kasturibhardwaj', 'chiming', 'sameer2190', 'sandokan80', 'varadg', 'meghachat', 'anmuydarp', 'jaguiler', 'bharathbr', 'amandushivakrishna', 'rowyche', 'tookie', 'aksbelbi', 'pietp', 'ddrake', 'xerios', 'nehamohanty12', 'apurvamudgal', 'baer123', 'aakashsrivastava', 'destinyindia123', 'disha_gujar', 'glaze', 'anpsys', 'satyadeepakav', 'timtim', 'benthomas', 'mnk319', 'isha8', '2008b1a3689g', 'aak', 'mudit', 'f2009336', 'athomas9', 'svrbasky', 'rahul_ch', 'sunket001', 'hspuneet', 'f2008373', 'tulsidaskhan20', 'rickmanbl', 'desh1tanuj', 'koneill', 'ashwin15990', 'vignesh', 'tsathwik063', 'g_leonidas', 'bari_fs', 'drhodges', 'adijatu', 'allanxiao', 'zanibakat', 'vijaykrishn']",5,"['sauravkrsrivastav', 'karnatichethana', 'neethubal', 'nikhil2612', None]",145,"['smkohen', 'charunima', 'kirtidahiya', 'arpitnano', 'suchismitanaik15', 'stefanovenica', 'mtoledo', 'zjy63562688', 'sriks218', 'paanini', 'vinhle1984', 'singhalananya', 'jadcockee2401', 'oasoro', 'manojchaulagain', 'mgentile', 'sugandha179', 'petarap', 'aviral0301', 'kanu', 'spencebot', 'ksteele', 'rahul108', 'echike', 'arjunnarang09', 'nimbus1789', 'taijasmalpani91', 'supriyask07', 'ameseret2011', 'pcousins', 'devavrata', 'premsarit', 'f2009033', 'nickbob00', 'jrod091', 'chithra', 'akshaypb', 'litta127', 'dhruva', 'sergiu_ducoci', 'daniel_doros', 'milim_3011', 'kevinlewis', 'nitisha9', 'kavya_bobba', 'jstubbs2', 'fatimadilruba', 'raviteja2504', 'the_dark_druid', 'jinalnshah', 'ronkapres', 'djdylan2000', 'sqesy', 'b2daj16', 'sudhachocky', 'aadebayo', 'akerin17', 'jhobbs3', 'akansha_suneria', 'plambert', 'deinemutter', 'abenton1', 'adi23jan', 'vaibhavuppal', 'ankitamahapatra', 'sarthakpranit', 'g00se', 'ashingeorge', 'anushadudi', 'f2009349', 'venkateshkadimi', 'f2009a8ps275g', 'johnorlando14', 'ender024', 'akriti_1', 'nikhil2612', 'krishnamurthy5111', 'sahainitin9795', 'ramanladda', 'sidhartha57', 'jaykhattar9', 'bijay2011', 'roodabeh', 'hemuviru319', 'maljar', 'kasturibhardwaj', 'surya210892', 'chiming', 'sameer2190', 'sandokan80', 'varadg', 'meghachat', 'anmuydarp', 'jaguiler', 'bharathbr', 'amandushivakrishna', 'rowyche', 'tookie', 'aksbelbi', 'pietp', 'ddrake', 'xerios', 'nehamohanty12', 'apurvamudgal', 'baer123', 'aakashsrivastava', 'destinyindia123', 'disha_gujar', 'neethubal', 'glaze', 'anpsys', 'satyadeepakav', 'timtim', 'benthomas', 'mnk319', 'isha8', '2008b1a3689g', 'sauravkrsrivastav', 'aak', 'mudit', 'f2009336', 'athomas9', 'svrbasky', 'rahul_ch', 'kavya', 'sunket001', 'hspuneet', 'f2008373', 'tulsidaskhan20', 'rickmanbl', 'desh1tanuj', 'koneill', 'ashwin15990', 'vignesh', 'tsathwik063', None, 'g_leonidas', 'rhljn100', 'bari_fs', 'karnatichethana', 'drhodges', 'adijatu', 'allanxiao', 'zanibakat', 'vijaykrishn']"
3,149,141,11,3,"['arpitnano', 'xerios', 'dhruva']",137,"['smkohen', 'charunima', 'kirtidahiya', 'suchismitanaik15', 'stefanovenica', 'mtoledo', 'zjy63562688', 'sriks218', 'paanini', 'vinhle1984', 'singhalananya', 'jadcockee2401', 'oasoro', 'manojchaulagain', 'mgentile', 'sugandha179', 'petarap', 'aviral0301', 'kanu', 'spencebot', 'ksteele', 'rahul108', 'echike', 'arjunnarang09', 'nimbus1789', 'taijasmalpani91', 'supriyask07', 'ameseret2011', 'pcousins', 'devavrata', 'premsarit', 'f2009033', 'nickbob00', 'jrod091', 'chithra', 'akshaypb', 'litta127', 'sergiu_ducoci', 'daniel_doros', 'milim_3011', 'kevinlewis', 'nitisha9', 'kavya_bobba', 'jstubbs2', 'fatimadilruba', 'raviteja2504', 'the_dark_druid', 'jinalnshah', 'ronkapres', 'djdylan2000', 'sqesy', 'b2daj16', 'sudhachocky', 'aadebayo', 'akerin17', 'jhobbs3', 'akansha_suneria', 'plambert', 'deinemutter', 'abenton1', 'adi23jan', 'vaibhavuppal', 'ankitamahapatra', 'sarthakpranit', 'g00se', 'ashingeorge', 'anushadudi', 'f2009349', 'venkateshkadimi', 'f2009a8ps275g', 'johnorlando14', 'ender024', 'akriti_1', 'krishnamurthy5111', 'sahainitin9795', 'ramanladda', 'sidhartha57', 'jaykhattar9', 'bijay2011', 'roodabeh', 'hemuviru319', 'maljar', 'kasturibhardwaj', 'surya210892', 'chiming', 'sameer2190', 'sandokan80', 'varadg', 'meghachat', 'anmuydarp', 'jaguiler', 'bharathbr', 'amandushivakrishna', 'rowyche', 'tookie', 'aksbelbi', 'pietp', 'ddrake', 'nehamohanty12', 'apurvamudgal', 'baer123', 'aakashsrivastava', 'destinyindia123', 'disha_gujar', 'glaze', 'anpsys', 'satyadeepakav', 'timtim', 'benthomas', 'mnk319', 'isha8', '2008b1a3689g', 'aak', 'mudit', 'f2009336', 'athomas9', 'svrbasky', 'rahul_ch', 'kavya', 'sunket001', 'hspuneet', 'f2008373', 'tulsidaskhan20', 'rickmanbl', 'desh1tanuj', 'koneill', 'ashwin15990', 'vignesh', 'tsathwik063', 'g_leonidas', 'rhljn100', 'bari_fs', 'drhodges', 'adijatu', 'allanxiao', 'zanibakat', 'vijaykrishn']",8,"['ragalasya', 'barkhabits', 'f2009123', 'sauravkrsrivastav', 'karnatichethana', 'nikhil2612', None, 'dheeraj']",148,"['smkohen', 'charunima', 'kirtidahiya', 'arpitnano', 'suchismitanaik15', 'stefanovenica', 'mtoledo', 'zjy63562688', 'sriks218', 'paanini', 'vinhle1984', 'ragalasya', 'singhalananya', 'jadcockee2401', 'oasoro', 'manojchaulagain', 'dheeraj', 'mgentile', 'sugandha179', 'petarap', 'aviral0301', 'kanu', 'spencebot', 'ksteele', 'rahul108', 'echike', 'arjunnarang09', 'nimbus1789', 'taijasmalpani91', 'supriyask07', 'ameseret2011', 'barkhabits', 'pcousins', 'devavrata', 'premsarit', 'f2009033', 'nickbob00', 'jrod091', 'chithra', 'akshaypb', 'litta127', 'dhruva', 'sergiu_ducoci', 'daniel_doros', 'milim_3011', 'kevinlewis', 'nitisha9', 'kavya_bobba', 'jstubbs2', 'fatimadilruba', 'raviteja2504', 'the_dark_druid', 'jinalnshah', 'ronkapres', 'djdylan2000', 'sqesy', 'b2daj16', 'sudhachocky', 'aadebayo', 'akerin17', 'jhobbs3', 'akansha_suneria', 'plambert', 'deinemutter', 'abenton1', 'adi23jan', 'vaibhavuppal', 'ankitamahapatra', 'sarthakpranit', 'g00se', 'ashingeorge', 'anushadudi', 'f2009349', 'venkateshkadimi', 'f2009a8ps275g', 'johnorlando14', 'ender024', 'akriti_1', 'nikhil2612', 'krishnamurthy5111', 'sahainitin9795', 'ramanladda', 'sidhartha57', 'jaykhattar9', 'bijay2011', 'roodabeh', 'hemuviru319', 'maljar', 'kasturibhardwaj', 'surya210892', 'chiming', 'sameer2190', 'sandokan80', 'varadg', 'meghachat', 'anmuydarp', 'jaguiler', 'bharathbr', 'amandushivakrishna', 'rowyche', 'tookie', 'aksbelbi', 'pietp', 'ddrake', 'xerios', 'nehamohanty12', 'apurvamudgal', 'baer123', 'aakashsrivastava', 'destinyindia123', 'disha_gujar', 'glaze', 'anpsys', 'satyadeepakav', 'timtim', 'benthomas', 'mnk319', 'isha8', '2008b1a3689g', 'sauravkrsrivastav', 'aak', 'mudit', 'f2009336', 'athomas9', 'svrbasky', 'rahul_ch', 'kavya', 'sunket001', 'hspuneet', 'f2008373', 'tulsidaskhan20', 'rickmanbl', 'desh1tanuj', 'koneill', 'ashwin15990', 'vignesh', 'tsathwik063', None, 'g_leonidas', 'rhljn100', 'bari_fs', 'f2009123', 'karnatichethana', 'drhodges', 'adijatu', 'allanxiao', 'zanibakat', 'vijaykrishn']"
3,157,141,9,8,"['johnorlando14', 'pcousins', 'b2daj16', 'sandokan80', 'drhodges', 'maljar', 'jstubbs2', 'manojchaulagain']",132,"['smkohen', 'charunima', 'kirtidahiya', 'arpitnano', 'suchismitanaik15', 'stefanovenica', 'mtoledo', 'zjy63562688', 'sriks218', 'paanini', 'vinhle1984', 'singhalananya', 'jadcockee2401', 'oasoro', 'mgentile', 'sugandha179', 'petarap', 'aviral0301', 'kanu', 'spencebot', 'ksteele', 'rahul108', 'echike', 'arjunnarang09', 'nimbus1789', 'taijasmalpani91', 'supriyask07', 'ameseret2011', 'devavrata', 'premsarit', 'f2009033', 'nickbob00', 'jrod091', 'chithra', 'akshaypb', 'litta127', 'dhruva', 'sergiu_ducoci', 'daniel_doros', 'milim_3011', 'kevinlewis', 'nitisha9', 'kavya_bobba', 'fatimadilruba', 'raviteja2504', 'the_dark_druid', 'jinalnshah', 'ronkapres', 'djdylan2000', 'sqesy', 'sudhachocky', 'aadebayo', 'akerin17', 'jhobbs3', 'akansha_suneria', 'plambert', 'deinemutter', 'abenton1', 'adi23jan', 'vaibhavuppal', 'ankitamahapatra', 'sarthakpranit', 'g00se', 'ashingeorge', 'anushadudi', 'f2009349', 'venkateshkadimi', 'f2009a8ps275g', 'ender024', 'akriti_1', 'krishnamurthy5111', 'sahainitin9795', 'ramanladda', 'sidhartha57', 'jaykhattar9', 'bijay2011', 'roodabeh', 'hemuviru319', 'kasturibhardwaj', 'surya210892', 'chiming', 'sameer2190', 'varadg', 'meghachat', 'anmuydarp', 'jaguiler', 'bharathbr', 'amandushivakrishna', 'rowyche', 'tookie', 'aksbelbi', 'pietp', 'ddrake', 'xerios', 'nehamohanty12', 'apurvamudgal', 'baer123', 'aakashsrivastava', 'destinyindia123', 'disha_gujar', 'glaze', 'anpsys', 'satyadeepakav', 'timtim', 'benthomas', 'mnk319', 'isha8', '2008b1a3689g', 'aak', 'mudit', 'f2009336', 'athomas9', 'svrbasky', 'rahul_ch', 'kavya', 'sunket001', 'hspuneet', 'f2008373', 'tulsidaskhan20', 'rickmanbl', 'desh1tanuj', 'koneill', 'ashwin15990', 'vignesh', 'tsathwik063', 'g_leonidas', 'rhljn100', 'bari_fs', 'adijatu', 'allanxiao', 'zanibakat', 'vijaykrishn']",1,[None],141,"['smkohen', 'charunima', 'kirtidahiya', 'arpitnano', 'suchismitanaik15', 'stefanovenica', 'mtoledo', 'zjy63562688', 'sriks218', 'paanini', 'vinhle1984', 'singhalananya', 'jadcockee2401', 'oasoro', 'manojchaulagain', 'mgentile', 'sugandha179', 'petarap', 'aviral0301', 'kanu', 'spencebot', 'ksteele', 'rahul108', 'echike', 'arjunnarang09', 'nimbus1789', 'taijasmalpani91', 'supriyask07', 'ameseret2011', 'pcousins', 'devavrata', 'premsarit', 'f2009033', 'nickbob00', 'jrod091', 'chithra', 'akshaypb', 'litta127', 'dhruva', 'sergiu_ducoci', 'daniel_doros', 'milim_3011', 'kevinlewis', 'nitisha9', 'kavya_bobba', 'jstubbs2', 'fatimadilruba', 'raviteja2504', 'the_dark_druid', 'jinalnshah', 'ronkapres', 'djdylan2000', 'sqesy', 'b2daj16', 'sudhachocky', 'aadebayo', 'akerin17', 'jhobbs3', 'akansha_suneria', 'plambert', 'deinemutter', 'abenton1', 'adi23jan', 'vaibhavuppal', 'ankitamahapatra', 'sarthakpranit', 'g00se', 'ashingeorge', 'anushadudi', 'f2009349', 'venkateshkadimi', 'f2009a8ps275g', 'johnorlando14', 'ender024', 'akriti_1', 'krishnamurthy5111', 'sahainitin9795', 'ramanladda', 'sidhartha57', 'jaykhattar9', 'bijay2011', 'roodabeh', 'hemuviru319', 'maljar', 'kasturibhardwaj', 'surya210892', 'chiming', 'sameer2190', 'sandokan80', 'varadg', 'meghachat', 'anmuydarp', 'jaguiler', 'bharathbr', 'amandushivakrishna', 'rowyche', 'tookie', 'aksbelbi', 'pietp', 'ddrake', 'xerios', 'nehamohanty12', 'apurvamudgal', 'baer123', 'aakashsrivastava', 'destinyindia123', 'disha_gujar', 'glaze', 'anpsys', 'satyadeepakav', 'timtim', 'benthomas', 'mnk319', 'isha8', '2008b1a3689g', 'aak', 'mudit', 'f2009336', 'athomas9', 'svrbasky', 'rahul_ch', 'kavya', 'sunket001', 'hspuneet', 'f2008373', 'tulsidaskhan20', 'rickmanbl', 'desh1tanuj', 'koneill', 'ashwin15990', 'vignesh', 'tsathwik063', None, 'g_leonidas', 'rhljn100', 'bari_fs', 'drhodges', 'adijatu', 'allanxiao', 'zanibakat', 'vijaykrishn']"
3,154,141,8,7,"['pcousins', 'b2daj16', 'sandokan80', 'drhodges', 'maljar', 'manojchaulagain', 'plambert']",133,"['smkohen', 'charunima', 'kirtidahiya', 'arpitnano', 'suchismitanaik15', 'stefanovenica', 'mtoledo', 'zjy63562688', 'sriks218', 'paanini', 'vinhle1984', 'singhalananya', 'jadcockee2401', 'oasoro', 'mgentile', 'sugandha179', 'petarap', 'aviral0301', 'kanu', 'spencebot', 'ksteele', 'rahul108', 'echike', 'arjunnarang09', 'nimbus1789', 'taijasmalpani91', 'supriyask07', 'ameseret2011', 'devavrata', 'premsarit', 'f2009033', 'nickbob00', 'jrod091', 'chithra', 'akshaypb', 'litta127', 'dhruva', 'sergiu_ducoci', 'daniel_doros', 'milim_3011', 'kevinlewis', 'nitisha9', 'kavya_bobba', 'jstubbs2', 'fatimadilruba', 'raviteja2504', 'the_dark_druid', 'jinalnshah', 'ronkapres', 'djdylan2000', 'sqesy', 'sudhachocky', 'aadebayo', 'akerin17', 'jhobbs3', 'akansha_suneria', 'deinemutter', 'abenton1', 'adi23jan', 'vaibhavuppal', 'ankitamahapatra', 'sarthakpranit', 'g00se', 'ashingeorge', 'anushadudi', 'f2009349', 'venkateshkadimi', 'f2009a8ps275g', 'johnorlando14', 'ender024', 'akriti_1', 'krishnamurthy5111', 'sahainitin9795', 'ramanladda', 'sidhartha57', 'jaykhattar9', 'bijay2011', 'roodabeh', 'hemuviru319', 'kasturibhardwaj', 'surya210892', 'chiming', 'sameer2190', 'varadg', 'meghachat', 'anmuydarp', 'jaguiler', 'bharathbr', 'amandushivakrishna', 'rowyche', 'tookie', 'aksbelbi', 'pietp', 'ddrake', 'xerios', 'nehamohanty12', 'apurvamudgal', 'baer123', 'aakashsrivastava', 'destinyindia123', 'disha_gujar', 'glaze', 'anpsys', 'satyadeepakav', 'timtim', 'benthomas', 'mnk319', 'isha8', '2008b1a3689g', 'aak', 'mudit', 'f2009336', 'athomas9', 'svrbasky', 'rahul_ch', 'kavya', 'sunket001', 'hspuneet', 'f2008373', 'tulsidaskhan20', 'rickmanbl', 'desh1tanuj', 'koneill', 'ashwin15990', 'vignesh', 'tsathwik063', 'g_leonidas', 'rhljn100', 'bari_fs', 'adijatu', 'allanxiao', 'zanibakat', 'vijaykrishn']",1,[None],141,"['smkohen', 'charunima', 'kirtidahiya', 'arpitnano', 'suchismitanaik15', 'stefanovenica', 'mtoledo', 'zjy63562688', 'sriks218', 'paanini', 'vinhle1984', 'singhalananya', 'jadcockee2401', 'oasoro', 'manojchaulagain', 'mgentile', 'sugandha179', 'petarap', 'aviral0301', 'kanu', 'spencebot', 'ksteele', 'rahul108', 'echike', 'arjunnarang09', 'nimbus1789', 'taijasmalpani91', 'supriyask07', 'ameseret2011', 'pcousins', 'devavrata', 'premsarit', 'f2009033', 'nickbob00', 'jrod091', 'chithra', 'akshaypb', 'litta127', 'dhruva', 'sergiu_ducoci', 'daniel_doros', 'milim_3011', 'kevinlewis', 'nitisha9', 'kavya_bobba', 'jstubbs2', 'fatimadilruba', 'raviteja2504', 'the_dark_druid', 'jinalnshah', 'ronkapres', 'djdylan2000', 'sqesy', 'b2daj16', 'sudhachocky', 'aadebayo', 'akerin17', 'jhobbs3', 'akansha_suneria', 'plambert', 'deinemutter', 'abenton1', 'adi23jan', 'vaibhavuppal', 'ankitamahapatra', 'sarthakpranit', 'g00se', 'ashingeorge', 'anushadudi', 'f2009349', 'venkateshkadimi', 'f2009a8ps275g', 'johnorlando14', 'ender024', 'akriti_1', 'krishnamurthy5111', 'sahainitin9795', 'ramanladda', 'sidhartha57', 'jaykhattar9', 'bijay2011', 'roodabeh', 'hemuviru319', 'maljar', 'kasturibhardwaj', 'surya210892', 'chiming', 'sameer2190', 'sandokan80', 'varadg', 'meghachat', 'anmuydarp', 'jaguiler', 'bharathbr', 'amandushivakrishna', 'rowyche', 'tookie', 'aksbelbi', 'pietp', 'ddrake', 'xerios', 'nehamohanty12', 'apurvamudgal', 'baer123', 'aakashsrivastava', 'destinyindia123', 'disha_gujar', 'glaze', 'anpsys', 'satyadeepakav', 'timtim', 'benthomas', 'mnk319', 'isha8', '2008b1a3689g', 'aak', 'mudit', 'f2009336', 'athomas9', 'svrbasky', 'rahul_ch', 'kavya', 'sunket001', 'hspuneet', 'f2008373', 'tulsidaskhan20', 'rickmanbl', 'desh1tanuj', 'koneill', 'ashwin15990', 'vignesh', 'tsathwik063', None, 'g_leonidas', 'rhljn100', 'bari_fs', 'drhodges', 'adijatu', 'allanxiao', 'zanibakat', 'vijaykrishn']"
3,73,141,6,1,['sunket001'],139,"['smkohen', 'charunima', 'kirtidahiya', 'arpitnano', 'suchismitanaik15', 'stefanovenica', 'mtoledo', 'zjy63562688', 'sriks218', 'paanini', 'vinhle1984', 'singhalananya', 'jadcockee2401', 'oasoro', 'manojchaulagain', 'mgentile', 'sugandha179', 'petarap', 'aviral0301', 'kanu', 'spencebot', 'ksteele', 'rahul108', 'echike', 'arjunnarang09', 'nimbus1789', 'taijasmalpani91', 'supriyask07', 'ameseret2011', 'pcousins', 'devavrata', 'premsarit', 'f2009033', 'nickbob00', 'jrod091', 'chithra', 'akshaypb', 'litta127', 'dhruva', 'sergiu_ducoci', 'daniel_doros', 'milim_3011', 'kevinlewis', 'nitisha9', 'kavya_bobba', 'jstubbs2', 'fatimadilruba', 'raviteja2504', 'the_dark_druid', 'jinalnshah', 'ronkapres', 'djdylan2000', 'sqesy', 'b2daj16', 'sudhachocky', 'aadebayo', 'akerin17', 'jhobbs3', 'akansha_suneria', 'plambert', 'deinemutter', 'abenton1', 'adi23jan', 'vaibhavuppal', 'ankitamahapatra', 'sarthakpranit', 'g00se', 'ashingeorge', 'anushadudi', 'f2009349', 'venkateshkadimi', 'f2009a8ps275g', 'johnorlando14', 'ender024', 'akriti_1', 'krishnamurthy5111', 'sahainitin9795', 'ramanladda', 'sidhartha57', 'jaykhattar9', 'bijay2011', 'roodabeh', 'hemuviru319', 'maljar', 'kasturibhardwaj', 'surya210892', 'chiming', 'sameer2190', 'sandokan80', 'varadg', 'meghachat', 'anmuydarp', 'jaguiler', 'bharathbr', 'amandushivakrishna', 'rowyche', 'tookie', 'aksbelbi', 'pietp', 'ddrake', 'xerios', 'nehamohanty12', 'apurvamudgal', 'baer123', 'aakashsrivastava', 'destinyindia123', 'disha_gujar', 'glaze', 'anpsys', 'satyadeepakav', 'timtim', 'benthomas', 'mnk319', 'isha8', '2008b1a3689g', 'aak', 'mudit', 'f2009336', 'athomas9', 'svrbasky', 'rahul_ch', 'kavya', 'hspuneet', 'f2008373', 'tulsidaskhan20', 'rickmanbl', 'desh1tanuj', 'koneill', 'ashwin15990', 'vignesh', 'tsathwik063', 'g_leonidas', 'rhljn100', 'bari_fs', 'drhodges', 'adijatu', 'allanxiao', 'zanibakat', 'vijaykrishn']",5,"['vnramkrishnan2005', 'abhi1991', 'varadgunjal', 'karnatichethana', None]",145,"['smkohen', 'charunima', 'kirtidahiya', 'arpitnano', 'suchismitanaik15', 'stefanovenica', 'mtoledo', 'zjy63562688', 'sriks218', 'paanini', 'vinhle1984', 'singhalananya', 'jadcockee2401', 'varadgunjal', 'oasoro', 'manojchaulagain', 'mgentile', 'sugandha179', 'petarap', 'aviral0301', 'kanu', 'spencebot', 'ksteele', 'rahul108', 'echike', 'arjunnarang09', 'nimbus1789', 'taijasmalpani91', 'supriyask07', 'ameseret2011', 'vnramkrishnan2005', 'pcousins', 'devavrata', 'premsarit', 'f2009033', 'nickbob00', 'jrod091', 'chithra', 'akshaypb', 'litta127', 'dhruva', 'sergiu_ducoci', 'daniel_doros', 'milim_3011', 'kevinlewis', 'nitisha9', 'kavya_bobba', 'jstubbs2', 'fatimadilruba', 'raviteja2504', 'the_dark_druid', 'jinalnshah', 'ronkapres', 'djdylan2000', 'sqesy', 'b2daj16', 'sudhachocky', 'aadebayo', 'akerin17', 'jhobbs3', 'akansha_suneria', 'plambert', 'deinemutter', 'abenton1', 'adi23jan', 'abhi1991', 'vaibhavuppal', 'ankitamahapatra', 'sarthakpranit', 'g00se', 'ashingeorge', 'anushadudi', 'f2009349', 'venkateshkadimi', 'f2009a8ps275g', 'johnorlando14', 'ender024', 'akriti_1', 'krishnamurthy5111', 'sahainitin9795', 'ramanladda', 'sidhartha57', 'jaykhattar9', 'bijay2011', 'roodabeh', 'hemuviru319', 'maljar', 'kasturibhardwaj', 'surya210892', 'chiming', 'sameer2190', 'sandokan80', 'varadg', 'meghachat', 'anmuydarp', 'jaguiler', 'bharathbr', 'amandushivakrishna', 'rowyche', 'tookie', 'aksbelbi', 'pietp', 'ddrake', 'xerios', 'nehamohanty12', 'apurvamudgal', 'baer123', 'aakashsrivastava', 'destinyindia123', 'disha_gujar', 'glaze', 'anpsys', 'satyadeepakav', 'timtim', 'benthomas', 'mnk319', 'isha8', '2008b1a3689g', 'aak', 'mudit', 'f2009336', 'athomas9', 'svrbasky', 'rahul_ch', 'kavya', 'sunket001', 'hspuneet', 'f2008373', 'tulsidaskhan20', 'rickmanbl', 'desh1tanuj', 'koneill', 'ashwin15990', 'vignesh', 'tsathwik063', None, 'g_leonidas', 'rhljn100', 'bari_fs', 'karnatichethana', 'drhodges', 'adijatu', 'allanxiao', 'zanibakat', 'vijaykrishn']"
4,35,75,56,53,"['kcp88', 'niloofar', 'shawnbenedict', 'kingslytan', 'applekyee1', 'wei_ocw', 'jonsin88', 'devilbw', 'wengseng1989', 'crysys', 'shoofeer1', 'maynilan', 'seeham1', 'tedng88', 'efantasy', 'mikedd', 'cyl', 'ban3n3', 'choonbeng89', 'applekyee', 'nafeez', 'yewkenwee11432055', 'algernon', 'advfab', 'aykie_rush', 'siyien', 'cts2707', 'hazel20', 'garymp', 'jervinwong', 'milad_h6', 'khosro', 'sam_tan4589', 'wailing02', 'sohmw36', 'tancs_82', 'holylight', 'yeng521', 'thongchin', 'powerkid', 'ryo25', 'evilst4r', 'ken5555', 'wing89', 'ericllk', 'lzchuan', 'wailing_02', 'chesslike_123', 'amz_e1', 's3raph', 'rustemkz', 'xelcius89', 'miney']",21,"['purusrini', 'hilako89', 'ehsanm21', 'cloo11', 'jeff1071114545', 'marcus', 'syahrul83', 'tioh', '1071114545jeff', 'engrzani', 'hoangnguyen177', 'musmansiddiqui', 'anai1411', 'rambell', 'othieno', 'mhs10', 'jovian', 'ranamuzic', 'tkott', 'prototaip', 'asel']",3,"['gohsl', 'khalidmarbou', None]",77,"['niloofar', 'kingslytan', 'applekyee1', 'wei_ocw', 'hilako89', 'devilbw', 'wengseng1989', 'shoofeer1', 'maynilan', 'seeham1', 'mikedd', 'ban3n3', 'yewkenwee11432055', 'jeff1071114545', 'advfab', 'aykie_rush', 'syahrul83', 'tioh', 'engrzani', 'hoangnguyen177', 'khosro', 'gohsl', 'othieno', 'wailing02', 'mhs10', 'holylight', 'powerkid', 'thongchin', 'ranamuzic', 'ken5555', 'evilst4r', 'tkott', 'ericllk', 'asel', 'xelcius89', 'miney', 'kcp88', 'purusrini', 'shawnbenedict', 'jonsin88', 'crysys', 'tedng88', 'efantasy', 'ehsanm21', 'cyl', 'choonbeng89', 'applekyee', 'nafeez', 'khalidmarbou', 'cloo11', 'algernon', 'marcus', 'cts2707', '1071114545jeff', 'hazel20', 'garymp', 'jervinwong', 'milad_h6', 'musmansiddiqui', 'sam_tan4589', 'anai1411', 'rambell', None, 'jovian', 'sohmw36', 'tancs_82', 'yeng521', 'ryo25', 'wing89', 'prototaip', 'lzchuan', 'wailing_02', 'chesslike_123', 'amz_e1', 's3raph', 'rustemkz', 'siyien']"
4,36,75,9,8,"['yeng521', 'jeff1071114545', 'hilako89', 'devilbw', 'anai1411', 'mikedd', 'garymp', 'jervinwong']",66,"['niloofar', 'kingslytan', 'applekyee1', 'wei_ocw', 'wengseng1989', 'shoofeer1', 'maynilan', 'seeham1', 'ban3n3', 'yewkenwee11432055', 'advfab', 'aykie_rush', 'syahrul83', 'tioh', 'engrzani', 'hoangnguyen177', 'khosro', 'othieno', 'wailing02', 'mhs10', 'holylight', 'powerkid', 'thongchin', 'ranamuzic', 'ken5555', 'evilst4r', 'tkott', 'ericllk', 'asel', 'xelcius89', 'miney', 'kcp88', 'purusrini', 'shawnbenedict', 'jonsin88', 'crysys', 'tedng88', 'efantasy', 'ehsanm21', 'cyl', 'choonbeng89', 'applekyee', 'nafeez', 'cloo11', 'algernon', 'marcus', 'cts2707', '1071114545jeff', 'hazel20', 'milad_h6', 'musmansiddiqui', 'sam_tan4589', 'rambell', 'jovian', 'sohmw36', 'tancs_82', 'ryo25', 'wing89', 'prototaip', 'lzchuan', 'wailing_02', 'chesslike_123', 'amz_e1', 's3raph', 'rustemkz', 'siyien']",1,[None],75,"['niloofar', 'kingslytan', 'applekyee1', 'wei_ocw', 'hilako89', 'devilbw', 'wengseng1989', 'shoofeer1', 'maynilan', 'seeham1', 'mikedd', 'ban3n3', 'yewkenwee11432055', 'jeff1071114545', 'advfab', 'aykie_rush', 'syahrul83', 'tioh', 'engrzani', 'hoangnguyen177', 'khosro', 'othieno', 'wailing02', 'mhs10', 'holylight', 'powerkid', 'thongchin', 'ranamuzic', 'ken5555', 'evilst4r', 'tkott', 'ericllk', 'asel', 'xelcius89', 'miney', 'kcp88', 'purusrini', 'shawnbenedict', 'jonsin88', 'crysys', 'tedng88', 'efantasy', 'ehsanm21', 'cyl', 'choonbeng89', 'applekyee', 'nafeez', 'cloo11', 'algernon', 'marcus', 'cts2707', '1071114545jeff', 'hazel20', 'garymp', 'jervinwong', 'milad_h6', 'musmansiddiqui', 'sam_tan4589', 'anai1411', 'rambell', None, 'jovian', 'sohmw36', 'tancs_82', 'yeng521', 'ryo25', 'wing89', 'prototaip', 'lzchuan', 'wailing_02', 'chesslike_123', 'amz_e1', 's3raph', 'rustemkz', 'siyien']"
4,34,75,7,1,['engrzani'],73,"['niloofar', 'kingslytan', 'applekyee1', 'wei_ocw', 'hilako89', 'devilbw', 'wengseng1989', 'shoofeer1', 'maynilan', 'seeham1', 'mikedd', 'ban3n3', 'yewkenwee11432055', 'jeff1071114545', 'advfab', 'aykie_rush', 'syahrul83', 'tioh', 'hoangnguyen177', 'khosro', 'othieno', 'wailing02', 'mhs10', 'holylight', 'powerkid', 'thongchin', 'ranamuzic', 'ken5555', 'evilst4r', 'tkott', 'ericllk', 'asel', 'xelcius89', 'miney', 'kcp88', 'purusrini', 'shawnbenedict', 'jonsin88', 'crysys', 'tedng88', 'efantasy', 'ehsanm21', 'cyl', 'choonbeng89', 'applekyee', 'nafeez', 'cloo11', 'algernon', 'marcus', 'cts2707', '1071114545jeff', 'hazel20', 'garymp', 'jervinwong', 'milad_h6', 'musmansiddiqui', 'sam_tan4589', 'anai1411', 'rambell', 'jovian', 'sohmw36', 'tancs_82', 'yeng521', 'ryo25', 'wing89', 'prototaip', 'lzchuan', 'wailing_02', 'chesslike_123', 'amz_e1', 's3raph', 'rustemkz', 'siyien']",6,"['madeeha_sadia', 'mirza.rashid', 'fmzakai', 'saleha', 'arsalananwer', None]",80,"['niloofar', 'kingslytan', 'fmzakai', 'applekyee1', 'wei_ocw', 'hilako89', 'devilbw', 'wengseng1989', 'shoofeer1', 'maynilan', 'seeham1', 'mikedd', 'ban3n3', 'yewkenwee11432055', 'jeff1071114545', 'advfab', 'aykie_rush', 'syahrul83', 'tioh', 'engrzani', 'hoangnguyen177', 'khosro', 'othieno', 'wailing02', 'mhs10', 'holylight', 'mirza.rashid', 'powerkid', 'thongchin', 'ranamuzic', 'ken5555', 'evilst4r', 'tkott', 'arsalananwer', 'ericllk', 'asel', 'xelcius89', 'saleha', 'miney', 'kcp88', 'purusrini', 'shawnbenedict', 'jonsin88', 'crysys', 'tedng88', 'efantasy', 'ehsanm21', 'cyl', 'choonbeng89', 'applekyee', 'nafeez', 'cloo11', 'algernon', 'marcus', 'cts2707', '1071114545jeff', 'hazel20', 'garymp', 'jervinwong', 'milad_h6', 'musmansiddiqui', 'sam_tan4589', 'anai1411', 'rambell', None, 'madeeha_sadia', 'jovian', 'sohmw36', 'tancs_82', 'yeng521', 'ryo25', 'wing89', 'prototaip', 'lzchuan', 'wailing_02', 'chesslike_123', 'amz_e1', 's3raph', 'rustemkz', 'siyien']"
5,63,64,114,1,['rhein1'],62,"['bruk1', 'sriram2hi', 'j2220373', 'metorerain', 'sbrinckm', 'gsparks', 'lancor1', 'dahlke2', 'handley1', 'qarte', 'aortona', 'vdersar1', 'calvinized', 'helloyc', 'martinfagerstrom', 'pkoul2', 'tylerarl', 'yagoda1', 'salijos', 'mouche1', 'bli36', 'a2140416', 'tanaikjun', 'mayfield', 'jagirhussan', 'dvmaxim', 'djdude007', 'epping2', 'congshan', 'materialsareawesome', 'jafar', 'buncher01', 'pelizaga', 'wenyang1', 'jk010891', 'dtrinkle', 'boertew1', 'nrbmse406', 'wang183', 'simpson5', 'fredhdx', 'myin1', 'chavez4', 'lu30', 'menghuang', 'sfalk1', 'xxu29', 'nmrazovic', 'faraday2000', 'scantonw', 'chensongchem', 'satishshekhawat', 'photoyub', 'mufeiyu2', 'ljustina', 'mhuang17', 'efrebes', 'griffi21', 'donner1', 'xiaoyr068', 'kineric', 'nunuwang']",113,"['adamwright08', 'hjsong2', 'wells8', 'sonicbro', 'landin', 'zyf7284563', 'shiou2', 'onay91', 'mikeudelhofen', 'kane11', 'jashari1', 'munjal2', 'tom69sawyer', 'dmgo17', 'ahasija2', 'lmendez2', 'khaostehnoob', 'scarlett', 'bhuiya1', 'elachman', 'wheele11', 'godofdeath', 'fluxayh', 'azure3t', 'kim325', 'profballack', 'dinger104', 'mohamed', 'ededens', 'sherlaby25', 'vik579', 'ren6', 'shah19', 'wolf13', 'takagi1', 'ammario', 'bae7', 'kantner1', 'young10', 'garcias1', 'rturner', 'chanj45', 'choquet1', 'scalise1', 'sfoolgenius', 'kylekalk', 'shah4u19', 'kong7', 'crisci1', 'leijin3', 'danyangzhuo', 'digitalmouse12', 'lincoln5', 'stewart9', 'wrubrec2', 'v3lox', 'dtoome2', 'savysaville', 'yuqili1', 'predatorhunter51', 'huanghewill', 'ucapssong', 'nithinreddyc', 'kazi1', 'cfranc20', 'hanbacca', 'yurilee2', 'lobert124', 'adoboluver', 'cabraal', 'ryanschuster', 'jang34', 'zhuxh529', 'zson2', 'smedber2', 'bredemer', 'sundstr2', 'b3nny312', 'zhang155', 'isankar21', 'yohanko322', 'rooney5', 'maninpat', 'roybell', 'bilalgabula', 'alee13', 'dmoonxp5', 'hansanderson', 'cvendi2', 'sebasti2', 'shook2', 'chitten1', 'kadakiy1', 'drtesla90', 'chang112', 'yin9', 'chivukula3', 'keramat1', 'kevinlooby', 'oper321', 'murray18', 'tumblesoup', 'theyubo', 'seanyen1', 'rccarca', 'ysun12', None, 'cialdel1', 'sungbea89', 'sulas2', 'bdlftth2', 'lylo', 'ehgma0821']",176,"['bruk1', 'adamwright08', 'sbrinckm', 'gsparks', 'hjsong2', 'lancor1', 'wells8', 'sonicbro', 'landin', 'zyf7284563', 'qarte', 'shiou2', 'onay91', 'tylerarl', 'mikeudelhofen', 'salijos', 'kane11', 'jashari1', 'munjal2', 'epping2', 'materialsareawesome', 'dmgo17', 'tom69sawyer', 'ahasija2', 'lmendez2', 'boertew1', 'khaostehnoob', 'scarlett', 'bhuiya1', 'elachman', 'fredhdx', 'chavez4', 'lu30', 'wheele11', 'sfalk1', 'godofdeath', 'xxu29', 'faraday2000', 'satishshekhawat', 'griffi21', 'fluxayh', 'azure3t', 'kim325', 'profballack', 'dinger104', 'mohamed', 'xiaoyr068', 'ededens', 'vik579', 'sherlaby25', 'ren6', 'sriram2hi', 'shah19', 'j2220373', 'metorerain', 'wolf13', 'takagi1', 'ammario', 'bae7', 'kantner1', 'young10', 'garcias1', 'martinfagerstrom', 'rturner', 'tanaikjun', 'dvmaxim', 'chanj45', 'choquet1', 'congshan', 'scalise1', 'sfoolgenius', 'jafar', 'kylekalk', 'shah4u19', 'kong7', 'dtrinkle', 'crisci1', 'leijin3', 'danyangzhuo', 'wang183', 'digitalmouse12', 'lincoln5', 'stewart9', 'wrubrec2', 'v3lox', 'ljustina', 'photoyub', 'mufeiyu2', 'dtoome2', 'mhuang17', 'efrebes', 'savysaville', 'yuqili1', 'predatorhunter51', 'huanghewill', 'ucapssong', 'nithinreddyc', 'dahlke2', 'kazi1', 'cfranc20', 'vdersar1', 'calvinized', 'helloyc', 'hanbacca', 'yurilee2', 'lobert124', 'adoboluver', 'cabraal', 'mouche1', 'ryanschuster', 'mayfield', 'jang34', 'zhuxh529', 'zson2', 'smedber2', 'pelizaga', 'wenyang1', 'bredemer', 'sundstr2', 'b3nny312', 'zhang155', 'nrbmse406', 'isankar21', 'yohanko322', 'scantonw', 'rooney5', 'maninpat', 'roybell', 'kineric', 'bilalgabula', 'nunuwang', 'alee13', 'dmoonxp5', 'handley1', 'hansanderson', 'cvendi2', 'aortona', 'pkoul2', 'sebasti2', 'shook2', 'yagoda1', 'chitten1', 'kadakiy1', 'bli36', 'a2140416', 'drtesla90', 'jagirhussan', 'chang112', 'yin9', 'djdude007', 'chivukula3', 'keramat1', 'kevinlooby', 'oper321', 'murray18', 'buncher01', 'tumblesoup', 'theyubo', 'jk010891', 'seanyen1', 'rccarca', 'simpson5', 'ysun12', 'myin1', None, 'cialdel1', 'menghuang', 'sungbea89', 'nmrazovic', 'chensongchem', 'sulas2', 'bdlftth2', 'donner1', 'rhein1', 'lylo', 'ehgma0821']"
5,125,64,28,24,"['bruk1', 'lancor1', 'handley1', 'dahlke2', 'vdersar1', 'tylerarl', 'yagoda1', 'a2140416', 'tanaikjun', 'mayfield', 'epping2', 'buncher01', 'pelizaga', 'wenyang1', 'dtrinkle', 'simpson5', 'fredhdx', 'chavez4', 'menghuang', 'faraday2000', 'photoyub', 'mufeiyu2', 'griffi21', 'nunuwang']",39,"['sriram2hi', 'j2220373', 'metorerain', 'sbrinckm', 'gsparks', 'qarte', 'aortona', 'calvinized', 'helloyc', 'martinfagerstrom', 'pkoul2', 'salijos', 'mouche1', 'bli36', 'jagirhussan', 'dvmaxim', 'djdude007', 'congshan', 'materialsareawesome', 'jafar', 'jk010891', 'boertew1', 'nrbmse406', 'wang183', 'myin1', 'lu30', 'sfalk1', 'xxu29', 'nmrazovic', 'scantonw', 'chensongchem', 'ljustina', 'satishshekhawat', 'mhuang17', 'efrebes', 'donner1', 'rhein1', 'xiaoyr068', 'kineric']",4,"['kylecaddigan', None, 'munjal2', 'sulas2']",67,"['bruk1', 'sbrinckm', 'gsparks', 'lancor1', 'dahlke2', 'kylecaddigan', 'qarte', 'vdersar1', 'calvinized', 'helloyc', 'tylerarl', 'salijos', 'mouche1', 'mayfield', 'munjal2', 'epping2', 'materialsareawesome', 'pelizaga', 'wenyang1', 'boertew1', 'nrbmse406', 'fredhdx', 'chavez4', 'lu30', 'sfalk1', 'xxu29', 'faraday2000', 'scantonw', 'satishshekhawat', 'griffi21', 'xiaoyr068', 'kineric', 'nunuwang', 'sriram2hi', 'j2220373', 'metorerain', 'handley1', 'aortona', 'pkoul2', 'martinfagerstrom', 'yagoda1', 'bli36', 'a2140416', 'tanaikjun', 'jagirhussan', 'dvmaxim', 'djdude007', 'congshan', 'jafar', 'buncher01', 'jk010891', 'dtrinkle', 'wang183', 'simpson5', 'myin1', None, 'menghuang', 'nmrazovic', 'chensongchem', 'photoyub', 'mufeiyu2', 'ljustina', 'sulas2', 'mhuang17', 'efrebes', 'donner1', 'rhein1']"
5,127,64,23,19,"['bruk1', 'handley1', 'dahlke2', 'tylerarl', 'yagoda1', 'a2140416', 'pelizaga', 'wenyang1', 'jk010891', 'dtrinkle', 'wang183', 'chavez4', 'lu30', 'menghuang', 'photoyub', 'mufeiyu2', 'griffi21', 'rhein1', 'nunuwang']",44,"['sriram2hi', 'j2220373', 'metorerain', 'sbrinckm', 'gsparks', 'lancor1', 'qarte', 'aortona', 'vdersar1', 'calvinized', 'helloyc', 'martinfagerstrom', 'pkoul2', 'salijos', 'mouche1', 'bli36', 'tanaikjun', 'mayfield', 'jagirhussan', 'dvmaxim', 'djdude007', 'epping2', 'congshan', 'materialsareawesome', 'jafar', 'buncher01', 'boertew1', 'nrbmse406', 'simpson5', 'fredhdx', 'myin1', 'sfalk1', 'xxu29', 'nmrazovic', 'faraday2000', 'scantonw', 'chensongchem', 'satishshekhawat', 'ljustina', 'mhuang17', 'efrebes', 'donner1', 'xiaoyr068', 'kineric']",4,"['kylecaddigan', None, 'munjal2', 'schiavo1']",67,"['bruk1', 'sbrinckm', 'gsparks', 'lancor1', 'dahlke2', 'kylecaddigan', 'qarte', 'vdersar1', 'calvinized', 'helloyc', 'tylerarl', 'salijos', 'mouche1', 'mayfield', 'munjal2', 'epping2', 'materialsareawesome', 'pelizaga', 'wenyang1', 'boertew1', 'nrbmse406', 'fredhdx', 'chavez4', 'lu30', 'sfalk1', 'xxu29', 'faraday2000', 'scantonw', 'satishshekhawat', 'griffi21', 'schiavo1', 'xiaoyr068', 'kineric', 'nunuwang', 'sriram2hi', 'j2220373', 'metorerain', 'handley1', 'aortona', 'pkoul2', 'martinfagerstrom', 'yagoda1', 'bli36', 'a2140416', 'tanaikjun', 'jagirhussan', 'dvmaxim', 'djdude007', 'congshan', 'jafar', 'buncher01', 'jk010891', 'dtrinkle', 'wang183', 'simpson5', 'myin1', None, 'menghuang', 'nmrazovic', 'chensongchem', 'photoyub', 'mufeiyu2', 'ljustina', 'mhuang17', 'efrebes', 'donner1', 'rhein1']"
5,124,64,20,17,"['sfalk1', 'xxu29', 'chensongchem', 'salijos', 'metorerain', 'gsparks', 'scantonw', 'mhuang17', 'efrebes', 'griffi21', 'kineric', 'qarte', 'wang183', 'myin1', 'xiaoyr068', 'djdude007', 'materialsareawesome']",46,"['bruk1', 'sriram2hi', 'j2220373', 'sbrinckm', 'lancor1', 'dahlke2', 'handley1', 'aortona', 'vdersar1', 'calvinized', 'helloyc', 'martinfagerstrom', 'pkoul2', 'tylerarl', 'yagoda1', 'mouche1', 'bli36', 'a2140416', 'tanaikjun', 'mayfield', 'jagirhussan', 'dvmaxim', 'epping2', 'congshan', 'jafar', 'buncher01', 'pelizaga', 'wenyang1', 'jk010891', 'dtrinkle', 'boertew1', 'nrbmse406', 'simpson5', 'fredhdx', 'chavez4', 'lu30', 'menghuang', 'nmrazovic', 'faraday2000', 'photoyub', 'mufeiyu2', 'satishshekhawat', 'ljustina', 'donner1', 'rhein1', 'nunuwang']",3,"[None, 'superalloy16', 'johnsm6']",66,"['bruk1', 'sbrinckm', 'gsparks', 'lancor1', 'dahlke2', 'qarte', 'vdersar1', 'calvinized', 'helloyc', 'tylerarl', 'salijos', 'mouche1', 'mayfield', 'epping2', 'materialsareawesome', 'pelizaga', 'wenyang1', 'boertew1', 'nrbmse406', 'fredhdx', 'chavez4', 'lu30', 'sfalk1', 'xxu29', 'faraday2000', 'scantonw', 'satishshekhawat', 'griffi21', 'xiaoyr068', 'kineric', 'nunuwang', 'sriram2hi', 'j2220373', 'metorerain', 'johnsm6', 'handley1', 'aortona', 'superalloy16', 'pkoul2', 'martinfagerstrom', 'yagoda1', 'bli36', 'a2140416', 'tanaikjun', 'jagirhussan', 'dvmaxim', 'djdude007', 'congshan', 'jafar', 'buncher01', 'jk010891', 'dtrinkle', 'wang183', 'simpson5', 'myin1', None, 'menghuang', 'nmrazovic', 'chensongchem', 'photoyub', 'mufeiyu2', 'ljustina', 'mhuang17', 'efrebes', 'donner1', 'rhein1']"
5,130,64,13,1,['helloyc'],62,"['bruk1', 'sriram2hi', 'j2220373', 'sbrinckm', 'metorerain', 'gsparks', 'lancor1', 'dahlke2', 'handley1', 'qarte', 'aortona', 'vdersar1', 'calvinized', 'pkoul2', 'martinfagerstrom', 'tylerarl', 'yagoda1', 'salijos', 'mouche1', 'bli36', 'a2140416', 'tanaikjun', 'mayfield', 'jagirhussan', 'dvmaxim', 'djdude007', 'epping2', 'congshan', 'materialsareawesome', 'jafar', 'buncher01', 'pelizaga', 'wenyang1', 'jk010891', 'dtrinkle', 'boertew1', 'nrbmse406', 'wang183', 'simpson5', 'fredhdx', 'myin1', 'chavez4', 'lu30', 'menghuang', 'sfalk1', 'xxu29', 'nmrazovic', 'faraday2000', 'scantonw', 'chensongchem', 'satishshekhawat', 'photoyub', 'mufeiyu2', 'ljustina', 'mhuang17', 'efrebes', 'griffi21', 'donner1', 'rhein1', 'xiaoyr068', 'kineric', 'nunuwang']",12,"['wood67', 'wandrews', 'wnaville', 'zbo', 'chen549', 'ahtippma', 'heginator16', 'bhfredman', 'redwing', 'gyoways', 'borkisze', None]",75,"['bruk1', 'sriram2hi', 'j2220373', 'sbrinckm', 'metorerain', 'gsparks', 'wandrews', 'lancor1', 'dahlke2', 'handley1', 'ahtippma', 'heginator16', 'qarte', 'bhfredman', 'aortona', 'vdersar1', 'calvinized', 'helloyc', 'pkoul2', 'martinfagerstrom', 'tylerarl', 'yagoda1', 'salijos', 'mouche1', 'wood67', 'zbo', 'bli36', 'a2140416', 'tanaikjun', 'mayfield', 'gyoways', 'jagirhussan', 'dvmaxim', 'djdude007', 'epping2', 'congshan', 'materialsareawesome', 'jafar', 'buncher01', 'pelizaga', 'wenyang1', 'jk010891', 'dtrinkle', 'wnaville', 'boertew1', 'chen549', 'nrbmse406', 'redwing', 'wang183', 'simpson5', 'borkisze', 'fredhdx', 'myin1', 'chavez4', None, 'lu30', 'menghuang', 'sfalk1', 'xxu29', 'nmrazovic', 'faraday2000', 'scantonw', 'chensongchem', 'satishshekhawat', 'photoyub', 'mufeiyu2', 'ljustina', 'mhuang17', 'efrebes', 'griffi21', 'donner1', 'rhein1', 'xiaoyr068', 'kineric', 'nunuwang']"
5,128,64,7,4,"['pkoul2', 'boertew1', 'bli36', 'donner1']",59,"['bruk1', 'sriram2hi', 'j2220373', 'sbrinckm', 'metorerain', 'gsparks', 'lancor1', 'dahlke2', 'handley1', 'qarte', 'aortona', 'vdersar1', 'calvinized', 'helloyc', 'martinfagerstrom', 'tylerarl', 'yagoda1', 'salijos', 'mouche1', 'a2140416', 'tanaikjun', 'mayfield', 'jagirhussan', 'dvmaxim', 'djdude007', 'epping2', 'congshan', 'materialsareawesome', 'jafar', 'buncher01', 'pelizaga', 'wenyang1', 'jk010891', 'dtrinkle', 'nrbmse406', 'wang183', 'simpson5', 'fredhdx', 'myin1', 'chavez4', 'lu30', 'menghuang', 'sfalk1', 'xxu29', 'nmrazovic', 'faraday2000', 'scantonw', 'chensongchem', 'satishshekhawat', 'photoyub', 'mufeiyu2', 'ljustina', 'mhuang17', 'efrebes', 'griffi21', 'rhein1', 'xiaoyr068', 'kineric', 'nunuwang']",3,"['gelate', None, 'johnsm6']",66,"['bruk1', 'sriram2hi', 'j2220373', 'sbrinckm', 'metorerain', 'gsparks', 'johnsm6', 'lancor1', 'dahlke2', 'handley1', 'qarte', 'aortona', 'vdersar1', 'calvinized', 'helloyc', 'pkoul2', 'martinfagerstrom', 'tylerarl', 'yagoda1', 'salijos', 'mouche1', 'bli36', 'a2140416', 'tanaikjun', 'mayfield', 'jagirhussan', 'dvmaxim', 'djdude007', 'epping2', 'congshan', 'materialsareawesome', 'jafar', 'buncher01', 'pelizaga', 'wenyang1', 'jk010891', 'dtrinkle', 'boertew1', 'nrbmse406', 'wang183', 'simpson5', 'fredhdx', 'myin1', 'chavez4', None, 'lu30', 'menghuang', 'sfalk1', 'gelate', 'xxu29', 'nmrazovic', 'faraday2000', 'scantonw', 'chensongchem', 'satishshekhawat', 'photoyub', 'mufeiyu2', 'ljustina', 'mhuang17', 'efrebes', 'griffi21', 'donner1', 'rhein1', 'xiaoyr068', 'kineric', 'nunuwang']"
6,53,56,122,19,"['ericwoo1', 'liyd', 'txia', 'sharma16', 'huang133', 'wtkarcher', 'hunter_136', 'lee643', 'jacobgruber', 'kulkarn3', 'conley3', 'dabigpig', 'turnbll2', 'draydenlin', 'adammodig', 'rohanbambery', 'cfok3', 'wang227', 'singh29']",36,"['raginin', 'cuddihy1', 'lolman', 'daipayan8', 'chen282', 'kryptonites', 'jlgibb', 'tang25', 'mrawaw', 'dchoux1', 'bhgarcia', 'nkingw', 'vparasu', 'shyamm1987', 'harshatall', 'vinayvashishtha', 'raobaru', 'novawater', 'chadleo', 'sabio0', 'cagyanx', 'dahebuni31', 'hamed22m', 'shrihari1989', 'slansley', 'scottgoguen', 'sabarish09', 'harrilip', 'pmartin8', 'lion2012', 'jestout', 'koz', 'kamil', 'nbikos', 'greatnorman1102', 'kandel3']",103,"['adamwright08', 'wells8', 'sonicbro', 'landin', 'onay91', 'ericwei1', 'matamor1', 'jashari1', 'lawrenceli', 'tom69sawyer', 'mwang53', 'ahasija2', 'lmendez2', 'philip', 'khaostehnoob', 'scarlett', 'wheele11', 'godofdeath', 'mccann4', 'fluxayh', 'azure3t', 'mohamed', 'profballack', 'kim325', 'dinger104', 'yuan10', 'szazeski', 'ededens', 'ren6', 'shah19', 'wolf13', 'takagi1', 'bae7', 'assem2', 'young10', 'kantner1', 'garcias1', 'zstone2', 'tovarbr2', 'rturner', 'hong64', 'chanj45', 'choquet1', 'kylekalk', 'shah4u19', 'kong7', 'awesly2', 'leijin3', 'danyangzhuo', 'searuff', 'digitalmouse12', 'lincoln5', 'v3lox', 'dtoome2', 'jacobs25', 'yuqili1', 'predatorhunter51', 'nithinreddyc', 'xiwang4', 'cfranc20', 'hanbacca', 'yurilee2', 'pniemer2', 'wang212', 'adoboluver', 'josephxu', 'stanzzang', 'zhuxh529', 'zson2', 'sundstr2', 'bredemer', 'b3nny312', 'zhang155', 'jasperli', 'isankar21', 'yohanko322', 'rose4', 'rooney5', 'maninpat', 'roybell', 'cbarth2', 'chanda2', 'alee13', 'dmoonxp5', 'hansanderson', 'chitten1', 'kadakiy1', 'willwang0737', 'drtesla90', 'keramat1', 'theyubo', 'kevinlooby', 'tumblesoup', 'jifeixu', 'seanyen1', 'ysun12', None, 'cialdel1', 'wang217', 'sungbea89', 'bdlftth2', 'huddles1', 'lylo']",158,"['ericwoo1', 'txia', 'adamwright08', 'wells8', 'sonicbro', 'landin', 'wtkarcher', 'onay91', 'ericwei1', 'matamor1', 'jashari1', 'lawrenceli', 'tom69sawyer', 'mwang53', 'ahasija2', 'lmendez2', 'dabigpig', 'philip', 'khaostehnoob', 'scarlett', 'raobaru', 'rohanbambery', 'cfok3', 'dahebuni31', 'wheele11', 'hamed22m', 'godofdeath', 'slansley', 'sabarish09', 'mccann4', 'wang227', 'harrilip', 'fluxayh', 'azure3t', 'mohamed', 'profballack', 'lion2012', 'kim325', 'dinger104', 'yuan10', 'szazeski', 'nbikos', 'ededens', 'kandel3', 'ren6', 'shah19', 'wolf13', 'takagi1', 'bae7', 'assem2', 'young10', 'kantner1', 'jlgibb', 'garcias1', 'zstone2', 'mrawaw', 'lee643', 'jacobgruber', 'tovarbr2', 'rturner', 'hong64', 'chanj45', 'choquet1', 'shyamm1987', 'kylekalk', 'shah4u19', 'kong7', 'awesly2', 'leijin3', 'danyangzhuo', 'searuff', 'digitalmouse12', 'lincoln5', 'v3lox', 'shrihari1989', 'dtoome2', 'pmartin8', 'jacobs25', 'koz', 'greatnorman1102', 'yuqili1', 'raginin', 'liyd', 'predatorhunter51', 'nithinreddyc', 'xiwang4', 'huang133', 'chen282', 'kryptonites', 'cfranc20', 'hanbacca', 'yurilee2', 'pniemer2', 'wang212', 'adoboluver', 'josephxu', 'dchoux1', 'stanzzang', 'vparasu', 'conley3', 'zhuxh529', 'zson2', 'harshatall', 'vinayvashishtha', 'sundstr2', 'bredemer', 'b3nny312', 'zhang155', 'sabio0', 'draydenlin', 'cagyanx', 'adammodig', 'isankar21', 'jasperli', 'yohanko322', 'rose4', 'scottgoguen', 'rooney5', 'maninpat', 'roybell', 'cbarth2', 'chanda2', 'cuddihy1', 'sharma16', 'alee13', 'lolman', 'dmoonxp5', 'daipayan8', 'hansanderson', 'tang25', 'hunter_136', 'chitten1', 'kadakiy1', 'willwang0737', 'kulkarn3', 'bhgarcia', 'drtesla90', 'nkingw', 'keramat1', 'theyubo', 'kevinlooby', 'tumblesoup', 'jifeixu', 'seanyen1', 'turnbll2', 'novawater', 'chadleo', 'ysun12', None, 'cialdel1', 'wang217', 'sungbea89', 'bdlftth2', 'huddles1', 'lylo', 'jestout', 'kamil', 'singh29']"
6,55,56,44,6,"['cuddihy1', 'cagyanx', 'sabio0', 'nbikos', 'greatnorman1102', 'cfok3']",49,"['ericwoo1', 'raginin', 'liyd', 'txia', 'sharma16', 'lolman', 'daipayan8', 'huang133', 'chen282', 'kryptonites', 'jlgibb', 'tang25', 'wtkarcher', 'hunter_136', 'mrawaw', 'lee643', 'jacobgruber', 'dchoux1', 'kulkarn3', 'bhgarcia', 'nkingw', 'shyamm1987', 'conley3', 'vparasu', 'harshatall', 'vinayvashishtha', 'dabigpig', 'turnbll2', 'raobaru', 'novawater', 'chadleo', 'draydenlin', 'rohanbambery', 'adammodig', 'dahebuni31', 'hamed22m', 'shrihari1989', 'slansley', 'scottgoguen', 'sabarish09', 'wang227', 'harrilip', 'pmartin8', 'lion2012', 'jestout', 'koz', 'kamil', 'singh29', 'kandel3']",38,"['gravityplanx', 'demint1', 'zhu52', 'ckhuang999', 'ultranerd71', 'wang212', 'mikeudelhofen', 'kane11', 'seanlee14', 'frisbie1', 'chorvat2', 'lzentner', 'chanj45', 'jpack91', 'mtzcardfan08', 'osarenk1', 'dmgo17', 'murray18', 'drejmeisterdrej', 'philip', 'columbine', 'rccarca', 'brinlee2', 'bettenh1', None, 'andrewgrieve1', 'wang217', 'toan52', 'mattycat9000', 'nullaa', 'vsalovnh', 'mmcdow4', 'jacobs25', 'juliusqueezer', 'ehgma0821', 'fahmad6', 'bilalgabula', 'pixton1']",93,"['ericwoo1', 'raginin', 'liyd', 'txia', 'huang133', 'chen282', 'kryptonites', 'wtkarcher', 'zhu52', 'wang212', 'mikeudelhofen', 'dchoux1', 'kane11', 'chorvat2', 'lzentner', 'mtzcardfan08', 'vparasu', 'conley3', 'dmgo17', 'harshatall', 'vinayvashishtha', 'drejmeisterdrej', 'dabigpig', 'philip', 'columbine', 'raobaru', 'sabio0', 'draydenlin', 'cagyanx', 'rohanbambery', 'adammodig', 'bettenh1', 'cfok3', 'dahebuni31', 'andrewgrieve1', 'mattycat9000', 'hamed22m', 'slansley', 'scottgoguen', 'sabarish09', 'wang227', 'harrilip', 'lion2012', 'juliusqueezer', 'fahmad6', 'nbikos', 'bilalgabula', 'pixton1', 'kandel3', 'gravityplanx', 'cuddihy1', 'sharma16', 'lolman', 'daipayan8', 'jlgibb', 'tang25', 'demint1', 'ckhuang999', 'ultranerd71', 'hunter_136', 'mrawaw', 'lee643', 'jacobgruber', 'seanlee14', 'frisbie1', 'kulkarn3', 'bhgarcia', 'chanj45', 'jpack91', 'nkingw', 'osarenk1', 'shyamm1987', 'murray18', 'turnbll2', 'novawater', 'chadleo', 'rccarca', 'brinlee2', None, 'wang217', 'toan52', 'shrihari1989', 'nullaa', 'vsalovnh', 'mmcdow4', 'pmartin8', 'jestout', 'jacobs25', 'ehgma0821', 'koz', 'kamil', 'singh29', 'greatnorman1102']"
6,52,56,37,9,"['raginin', 'harshatall', 'shrihari1989', 'scottgoguen', 'daipayan8', 'lion2012', 'jlgibb', 'kryptonites', 'shyamm1987']",46,"['ericwoo1', 'liyd', 'cuddihy1', 'txia', 'sharma16', 'lolman', 'huang133', 'chen282', 'wtkarcher', 'tang25', 'hunter_136', 'mrawaw', 'lee643', 'jacobgruber', 'dchoux1', 'kulkarn3', 'bhgarcia', 'nbikos', 'nkingw', 'vparasu', 'conley3', 'vinayvashishtha', 'dabigpig', 'turnbll2', 'raobaru', 'novawater', 'chadleo', 'sabio0', 'draydenlin', 'cagyanx', 'rohanbambery', 'adammodig', 'cfok3', 'dahebuni31', 'hamed22m', 'slansley', 'sabarish09', 'wang227', 'harrilip', 'pmartin8', 'jestout', 'koz', 'kamil', 'singh29', 'greatnorman1102', 'kandel3']",28,"['bmgall', 'dchoux2', 'klone99', 'elcollin', 'jclittle', 'disaac', 'kbeaudet', 'mccobos', 'jfarrand', 'ferry', 'wroggent', 'hasin986', 'swinthu', 'anieves2', 'dbmcguir', 'kbriglia', 'arator', 'dzwu1', 'njpowell', 'duggan2423', None, 'diseasedmonkey', 'cbramjet', 'soursoup', 'mfmarti6', 'rgnavarr', 'markstoker', 'jakepage']",83,"['ericwoo1', 'raginin', 'liyd', 'txia', 'bmgall', 'klone99', 'elcollin', 'huang133', 'chen282', 'disaac', 'kryptonites', 'wtkarcher', 'mccobos', 'jfarrand', 'ferry', 'wroggent', 'swinthu', 'dchoux1', 'anieves2', 'kbriglia', 'vparasu', 'conley3', 'harshatall', 'vinayvashishtha', 'arator', 'dabigpig', 'raobaru', 'sabio0', 'draydenlin', 'cagyanx', 'njpowell', 'rohanbambery', 'adammodig', 'cfok3', 'dahebuni31', 'cbramjet', 'hamed22m', 'slansley', 'scottgoguen', 'sabarish09', 'soursoup', 'wang227', 'harrilip', 'markstoker', 'lion2012', 'nbikos', 'kandel3', 'cuddihy1', 'sharma16', 'dchoux2', 'lolman', 'jclittle', 'daipayan8', 'kbeaudet', 'jlgibb', 'tang25', 'hasin986', 'hunter_136', 'mrawaw', 'lee643', 'jacobgruber', 'kulkarn3', 'bhgarcia', 'dbmcguir', 'nkingw', 'shyamm1987', 'turnbll2', 'dzwu1', 'novawater', 'chadleo', 'duggan2423', None, 'diseasedmonkey', 'shrihari1989', 'mfmarti6', 'rgnavarr', 'pmartin8', 'jestout', 'koz', 'kamil', 'singh29', 'greatnorman1102', 'jakepage']"
6,54,56,24,8,"['hamed22m', 'dchoux1', 'novawater', 'pmartin8', 'chen282', 'kulkarn3', 'koz', 'nkingw']",47,"['ericwoo1', 'raginin', 'liyd', 'cuddihy1', 'txia', 'sharma16', 'lolman', 'daipayan8', 'huang133', 'kryptonites', 'jlgibb', 'tang25', 'wtkarcher', 'hunter_136', 'mrawaw', 'lee643', 'jacobgruber', 'bhgarcia', 'nbikos', 'shyamm1987', 'conley3', 'vparasu', 'harshatall', 'vinayvashishtha', 'dabigpig', 'turnbll2', 'raobaru', 'chadleo', 'sabio0', 'draydenlin', 'cagyanx', 'rohanbambery', 'adammodig', 'cfok3', 'dahebuni31', 'shrihari1989', 'slansley', 'scottgoguen', 'sabarish09', 'wang227', 'harrilip', 'lion2012', 'jestout', 'kamil', 'singh29', 'greatnorman1102', 'kandel3']",16,"['toan52', 'dchoux2', 'creepdeadly', 'takagi1', 'dou1', 'roy18', 'enyuluo', 'bradzab', 'rkuryl2', 'elachman', 'dbmcguir', 'yuan10', 'rschmid2', 'cbarth2', None, 'matamor1']",71,"['ericwoo1', 'raginin', 'liyd', 'txia', 'huang133', 'chen282', 'kryptonites', 'wtkarcher', 'matamor1', 'creepdeadly', 'dou1', 'dchoux1', 'vparasu', 'conley3', 'harshatall', 'vinayvashishtha', 'dabigpig', 'bradzab', 'raobaru', 'sabio0', 'draydenlin', 'cagyanx', 'elachman', 'rohanbambery', 'adammodig', 'cfok3', 'dahebuni31', 'hamed22m', 'slansley', 'scottgoguen', 'sabarish09', 'wang227', 'harrilip', 'lion2012', 'yuan10', 'nbikos', 'cbarth2', 'kandel3', 'cuddihy1', 'sharma16', 'dchoux2', 'lolman', 'takagi1', 'daipayan8', 'rkuryl2', 'jlgibb', 'tang25', 'hunter_136', 'mrawaw', 'lee643', 'jacobgruber', 'kulkarn3', 'bhgarcia', 'dbmcguir', 'nkingw', 'shyamm1987', 'turnbll2', 'enyuluo', 'novawater', 'chadleo', 'rschmid2', None, 'toan52', 'shrihari1989', 'roy18', 'pmartin8', 'jestout', 'koz', 'kamil', 'singh29', 'greatnorman1102']"
6,57,56,7,4,"['jlgibb', 'daipayan8', 'lion2012', 'sabarish09']",51,"['ericwoo1', 'raginin', 'liyd', 'cuddihy1', 'txia', 'sharma16', 'lolman', 'singh29', 'huang133', 'chen282', 'kryptonites', 'tang25', 'wtkarcher', 'hunter_136', 'mrawaw', 'lee643', 'jacobgruber', 'dchoux1', 'kulkarn3', 'bhgarcia', 'nkingw', 'shyamm1987', 'conley3', 'vparasu', 'harshatall', 'vinayvashishtha', 'dabigpig', 'turnbll2', 'raobaru', 'novawater', 'chadleo', 'sabio0', 'draydenlin', 'cagyanx', 'rohanbambery', 'adammodig', 'cfok3', 'dahebuni31', 'hamed22m', 'shrihari1989', 'slansley', 'scottgoguen', 'wang227', 'harrilip', 'pmartin8', 'jestout', 'koz', 'kamil', 'nbikos', 'greatnorman1102', 'kandel3']",3,"['duggan2423', 'hasin986', None]",58,"['ericwoo1', 'raginin', 'liyd', 'cuddihy1', 'txia', 'sharma16', 'lolman', 'daipayan8', 'singh29', 'huang133', 'chen282', 'kryptonites', 'jlgibb', 'tang25', 'wtkarcher', 'hasin986', 'hunter_136', 'mrawaw', 'lee643', 'jacobgruber', 'dchoux1', 'kulkarn3', 'bhgarcia', 'nkingw', 'shyamm1987', 'conley3', 'vparasu', 'harshatall', 'vinayvashishtha', 'dabigpig', 'turnbll2', 'raobaru', 'novawater', 'chadleo', 'sabio0', 'draydenlin', 'cagyanx', 'rohanbambery', 'adammodig', 'duggan2423', None, 'cfok3', 'dahebuni31', 'hamed22m', 'shrihari1989', 'slansley', 'scottgoguen', 'sabarish09', 'wang227', 'harrilip', 'pmartin8', 'lion2012', 'jestout', 'koz', 'kamil', 'nbikos', 'greatnorman1102', 'kandel3']"
7,80,48,39,38,"['jjpangilinan', 'mnsabsook', 'erickim83', 'davidj814', 'mpcuaresma', 'relavis', 'arbatac', 'alterantive65', 'dukedup83', 'rjlopez', 'arabo', 'r_borden45', 'msavilo', 'ilhoffman', 'dhahm', 'gmcervantes', 'facruz', 'ajselfridge', 'tmoy', 'jhoffman', 'mpvlad', 'hezhangquan', 'kaichunng', 'blanger120', 'kebenner', 'lolcat', 'lwong', 'ldmiller', 'juliamohr1', 'patricktrinh', 'mgcarrillo89', 'claypursselley', 'sjaugustine', 'ojjones', 'acsacco', 'ace694', 'mljohnson', 'ianreef7']",9,"['amcapili', 'atnguyen1', 'lvaldez', 'chriscolome', 'cacena', 'dhuynh', 'freyes1', 'lavalenzuela', 'mtjenkins']",1,[None],48,"['erickim83', 'davidj814', 'relavis', 'chriscolome', 'r_borden45', 'msavilo', 'ilhoffman', 'gmcervantes', 'cacena', 'ajselfridge', 'mpvlad', 'kebenner', 'lvaldez', 'lolcat', 'lwong', 'ldmiller', 'dhuynh', 'freyes1', 'patricktrinh', 'atnguyen1', 'mgcarrillo89', 'sjaugustine', 'acsacco', 'ace694', 'mljohnson', 'ianreef7', 'mtjenkins', 'jjpangilinan', 'mnsabsook', 'mpcuaresma', 'arbatac', 'alterantive65', 'dukedup83', 'rjlopez', 'arabo', 'dhahm', 'facruz', 'tmoy', 'jhoffman', 'hezhangquan', 'kaichunng', 'blanger120', 'juliamohr1', 'amcapili', None, 'claypursselley', 'ojjones', 'lavalenzuela']"
7,81,48,10,9,"['acsacco', 'ace694', 'davidj814', 'patricktrinh', 'ldmiller', 'chriscolome', 'amcapili', 'freyes1', 'lavalenzuela']",38,"['jjpangilinan', 'mnsabsook', 'erickim83', 'mpcuaresma', 'relavis', 'arbatac', 'alterantive65', 'dukedup83', 'rjlopez', 'r_borden45', 'arabo', 'msavilo', 'ilhoffman', 'dhahm', 'facruz', 'gmcervantes', 'cacena', 'ajselfridge', 'tmoy', 'jhoffman', 'mpvlad', 'hezhangquan', 'kaichunng', 'blanger120', 'kebenner', 'lvaldez', 'lolcat', 'lwong', 'juliamohr1', 'dhuynh', 'atnguyen1', 'mgcarrillo89', 'claypursselley', 'sjaugustine', 'ojjones', 'mljohnson', 'ianreef7', 'mtjenkins']",1,[None],48,"['jjpangilinan', 'mnsabsook', 'erickim83', 'davidj814', 'mpcuaresma', 'relavis', 'arbatac', 'chriscolome', 'alterantive65', 'dukedup83', 'rjlopez', 'r_borden45', 'arabo', 'msavilo', 'ilhoffman', 'dhahm', 'facruz', 'gmcervantes', 'cacena', 'ajselfridge', 'tmoy', 'jhoffman', 'mpvlad', 'hezhangquan', 'kaichunng', 'blanger120', 'kebenner', 'lvaldez', 'lolcat', 'lwong', 'ldmiller', 'juliamohr1', 'dhuynh', 'freyes1', 'patricktrinh', 'atnguyen1', 'amcapili', 'mgcarrillo89', None, 'claypursselley', 'sjaugustine', 'ojjones', 'acsacco', 'ace694', 'mljohnson', 'ianreef7', 'lavalenzuela', 'mtjenkins']"
8,187,44,46,42,"['abhik2', 'hangbbq', 'monica1', 'lyli1', 'sajaygouri', 'yanjituo', 'raina2', 'g1101089h', 'zhaodinglong', 'shethpratik', 'adayan', 'johnangela', 'tham87', 'nge1', 'ruofengsha', 'hakleong2002', 'jessie', 'e110066', 'sunandry', 'bh07', 'zhl0834', 'andyterry', 'kokll', 'ericngch', 'noahperfect', 'bliu3', 'wssoh', 'mylzc', 'samsilver', 'skt3227370', 'ramakanetkar', 'vat2k1', 'gocy36', 'zhou0181', 'winterfrog', 'gaoy0022', 'khin0053', 'chenxuefeng', 'ngeric', 'taobing', 'taik0007', 'lgoh3833']",1,['dragonsea_gu'],4,"['ericng', 'tkswong', None, 'deepu']",47,"['abhik2', 'raina2', 'zhaodinglong', 'tham87', 'nge1', 'e110066', 'kokll', 'ericngch', 'noahperfect', 'skt3227370', 'gocy36', 'zhou0181', 'winterfrog', 'ericng', 'chenxuefeng', 'ngeric', 'taobing', 'taik0007', 'deepu', 'hangbbq', 'monica1', 'lyli1', 'sajaygouri', 'yanjituo', 'shethpratik', 'g1101089h', 'adayan', 'johnangela', 'ruofengsha', 'hakleong2002', 'jessie', 'dragonsea_gu', 'sunandry', 'bh07', 'zhl0834', 'andyterry', 'bliu3', 'wssoh', 'mylzc', 'samsilver', 'ramakanetkar', 'vat2k1', None, 'gaoy0022', 'khin0053', 'tkswong', 'lgoh3833']"
8,38,44,12,10,"['andyterry', 'kokll', 'gaoy0022', 'bliu3', 'taobing', 'samsilver', 'ramakanetkar', 'jessie', 'raina2', 'lgoh3833']",33,"['abhik2', 'hangbbq', 'monica1', 'lyli1', 'sajaygouri', 'yanjituo', 'g1101089h', 'zhaodinglong', 'shethpratik', 'adayan', 'johnangela', 'tham87', 'nge1', 'ruofengsha', 'hakleong2002', 'e110066', 'dragonsea_gu', 'sunandry', 'bh07', 'zhl0834', 'ericngch', 'noahperfect', 'wssoh', 'mylzc', 'skt3227370', 'vat2k1', 'gocy36', 'zhou0181', 'winterfrog', 'khin0053', 'chenxuefeng', 'ngeric', 'taik0007']",2,"['sdfzzyf', None]",45,"['abhik2', 'hangbbq', 'monica1', 'lyli1', 'sajaygouri', 'yanjituo', 'raina2', 'shethpratik', 'zhaodinglong', 'g1101089h', 'adayan', 'johnangela', 'tham87', 'nge1', 'ruofengsha', 'hakleong2002', 'sdfzzyf', 'jessie', 'e110066', 'dragonsea_gu', 'sunandry', 'bh07', 'zhl0834', 'andyterry', 'kokll', 'ericngch', 'noahperfect', 'bliu3', 'wssoh', 'mylzc', 'samsilver', 'skt3227370', 'ramakanetkar', 'vat2k1', 'gocy36', None, 'zhou0181', 'winterfrog', 'gaoy0022', 'khin0053', 'chenxuefeng', 'ngeric', 'taobing', 'taik0007', 'lgoh3833']"
9,138,41,39,25,"['testing123', 'ahmed88', 'nourahmed', 'mastermw', 'mohmmad_mahusin', 'serag', 'msawaby', 'ahmedsaad', 'bishoyid', 'aktkira', 'moamen', 'ahussein', 'kymera', 'mohamed2011', 'shaymaa', 'ahmedrashied', 'asoltan', 'michael2011', 'himahmoud', 'nahlaelazab', 'zema_1', 'mazen_soliman', 'ibrahemmetwally77', 'tamer1221', 'manar']",15,"['allcallo', 'lorymingus', 'magnone', 'nicolas88', 'ibra_candle', 'maclaura', 'arnaldo87', 'validopm', 'delvec', 'spax', 'bigu', 'fonz', 'francesco87', 'mcgarner', 'tai86']",14,"['fatmakh', 'auchy', 'shaker', 'samozeid', 'ratshih', 'amropto', 'mahmoud', 'shaimaanmohamed', 'fayezelsisy', 'helionpower', 'mariaaaa', 'mmatda1976', None, 'ranya_samy']",54,"['fatmakh', 'testing123', 'ahmed88', 'shaker', 'samozeid', 'mastermw', 'mohmmad_mahusin', 'msawaby', 'ranya_samy', 'ahmedsaad', 'nicolas88', 'amropto', 'shaimaanmohamed', 'francesco87', 'auchy', 'shaymaa', 'ahmedrashied', 'asoltan', 'michael2011', 'mahmoud', 'himahmoud', 'tai86', 'magnone', 'zema_1', 'mazen_soliman', 'fonz', 'manar', 'nourahmed', 'serag', 'helionpower', 'mariaaaa', 'allcallo', 'lorymingus', 'bishoyid', 'maclaura', 'validopm', 'aktkira', 'moamen', 'ahussein', 'kymera', 'mohamed2011', 'bigu', 'mcgarner', None, 'nahlaelazab', 'ibra_candle', 'arnaldo87', 'delvec', 'spax', 'ratshih', 'fayezelsisy', 'ibrahemmetwally77', 'tamer1221', 'mmatda1976']"
9,141,41,22,13,"['nahlaelazab', 'ahmed88', 'ahussein', 'kymera', 'mohamed2011', 'ibra_candle', 'ahmedrashied', 'asoltan', 'aktkira', 'mohmmad_mahusin', 'himahmoud', 'ibrahemmetwally77', 'msawaby']",27,"['testing123', 'nourahmed', 'mastermw', 'serag', 'ahmedsaad', 'allcallo', 'lorymingus', 'nicolas88', 'bishoyid', 'maclaura', 'validopm', 'moamen', 'francesco87', 'shaymaa', 'michael2011', 'bigu', 'mcgarner', 'tai86', 'magnone', 'zema_1', 'arnaldo87', 'delvec', 'spax', 'mazen_soliman', 'fonz', 'tamer1221', 'manar']",9,"['auchy', 'samozeid', 'ratshih', 'mariaaaa', 'fayezelsisy', 'helionpower', 'ahmed55', 'mmatda1976', None]",49,"['testing123', 'ahmed88', 'samozeid', 'nourahmed', 'mastermw', 'mohmmad_mahusin', 'serag', 'msawaby', 'helionpower', 'mariaaaa', 'ahmedsaad', 'allcallo', 'lorymingus', 'nicolas88', 'bishoyid', 'maclaura', 'validopm', 'aktkira', 'moamen', 'francesco87', 'auchy', 'ahussein', 'kymera', 'mohamed2011', 'shaymaa', 'ahmedrashied', 'asoltan', 'michael2011', 'himahmoud', 'bigu', 'ahmed55', 'mcgarner', None, 'tai86', 'nahlaelazab', 'magnone', 'ibra_candle', 'arnaldo87', 'zema_1', 'delvec', 'spax', 'ratshih', 'mazen_soliman', 'fonz', 'fayezelsisy', 'ibrahemmetwally77', 'tamer1221', 'mmatda1976', 'manar']"
9,139,41,11,10,"['lorymingus', 'magnone', 'nicolas88', 'spax', 'maclaura', 'arnaldo87', 'validopm', 'bigu', 'fonz', 'francesco87']",30,"['testing123', 'ahmed88', 'nourahmed', 'mastermw', 'mohmmad_mahusin', 'serag', 'msawaby', 'ahmedsaad', 'allcallo', 'bishoyid', 'aktkira', 'moamen', 'ahussein', 'kymera', 'mohamed2011', 'shaymaa', 'ahmedrashied', 'asoltan', 'michael2011', 'himahmoud', 'mcgarner', 'tai86', 'nahlaelazab', 'ibra_candle', 'zema_1', 'delvec', 'mazen_soliman', 'ibrahemmetwally77', 'tamer1221', 'manar']",1,[None],41,"['testing123', 'ahmed88', 'nourahmed', 'mastermw', 'mohmmad_mahusin', 'serag', 'msawaby', 'ahmedsaad', 'allcallo', 'lorymingus', 'nicolas88', 'bishoyid', 'maclaura', 'validopm', 'aktkira', 'moamen', 'francesco87', 'ahussein', 'kymera', 'mohamed2011', 'shaymaa', 'ahmedrashied', 'asoltan', 'michael2011', 'himahmoud', 'bigu', 'mcgarner', None, 'tai86', 'nahlaelazab', 'magnone', 'ibra_candle', 'arnaldo87', 'zema_1', 'delvec', 'spax', 'mazen_soliman', 'fonz', 'ibrahemmetwally77', 'tamer1221', 'manar']"
9,159,41,8,1,['msawaby'],39,"['testing123', 'ahmed88', 'nourahmed', 'mastermw', 'mohmmad_mahusin', 'serag', 'ahmedsaad', 'allcallo', 'lorymingus', 'nicolas88', 'bishoyid', 'maclaura', 'validopm', 'aktkira', 'moamen', 'francesco87', 'ahussein', 'kymera', 'mohamed2011', 'shaymaa', 'ahmedrashied', 'asoltan', 'michael2011', 'himahmoud', 'bigu', 'mcgarner', 'tai86', 'nahlaelazab', 'magnone', 'ibra_candle', 'arnaldo87', 'zema_1', 'delvec', 'spax', 'mazen_soliman', 'fonz', 'ibrahemmetwally77', 'tamer1221', 'manar']",7,"['fatmakh', 'ratshih', 'helionpower', 'fayezelsisy', 'mariaaaa', None, 'ranya_samy']",47,"['fatmakh', 'testing123', 'ahmed88', 'nourahmed', 'mastermw', 'mohmmad_mahusin', 'serag', 'msawaby', 'mariaaaa', 'helionpower', 'ranya_samy', 'ahmedsaad', 'allcallo', 'lorymingus', 'nicolas88', 'bishoyid', 'maclaura', 'validopm', 'aktkira', 'moamen', 'francesco87', 'ahussein', 'kymera', 'mohamed2011', 'shaymaa', 'ahmedrashied', 'asoltan', 'michael2011', 'himahmoud', 'bigu', 'mcgarner', None, 'tai86', 'nahlaelazab', 'magnone', 'ibra_candle', 'arnaldo87', 'zema_1', 'delvec', 'spax', 'ratshih', 'mazen_soliman', 'fonz', 'fayezelsisy', 'ibrahemmetwally77', 'tamer1221', 'manar']"
9,136,41,7,4,"['nahlaelazab', 'serag', 'ibrahemmetwally77', 'michael2011']",36,"['testing123', 'ahmed88', 'nourahmed', 'mastermw', 'mohmmad_mahusin', 'msawaby', 'ahmedsaad', 'allcallo', 'lorymingus', 'nicolas88', 'bishoyid', 'maclaura', 'validopm', 'aktkira', 'moamen', 'francesco87', 'ahussein', 'kymera', 'mohamed2011', 'shaymaa', 'ahmedrashied', 'asoltan', 'himahmoud', 'bigu', 'mcgarner', 'tai86', 'magnone', 'ibra_candle', 'arnaldo87', 'zema_1', 'delvec', 'spax', 'mazen_soliman', 'fonz', 'tamer1221', 'manar']",3,"['fayezelsisy', None, 'abdo504']",43,"['testing123', 'ahmed88', 'abdo504', 'nourahmed', 'mastermw', 'mohmmad_mahusin', 'serag', 'msawaby', 'ahmedsaad', 'allcallo', 'lorymingus', 'nicolas88', 'bishoyid', 'maclaura', 'validopm', 'aktkira', 'moamen', 'francesco87', 'ahussein', 'kymera', 'mohamed2011', 'shaymaa', 'ahmedrashied', 'asoltan', 'michael2011', 'himahmoud', 'bigu', 'mcgarner', None, 'tai86', 'nahlaelazab', 'magnone', 'ibra_candle', 'arnaldo87', 'zema_1', 'delvec', 'spax', 'mazen_soliman', 'fonz', 'fayezelsisy', 'ibrahemmetwally77', 'tamer1221', 'manar']"
9,137,41,6,5,"['nahlaelazab', 'ahussein', 'michael2011', 'ibrahemmetwally77', 'msawaby']",35,"['testing123', 'ahmed88', 'nourahmed', 'mastermw', 'mohmmad_mahusin', 'serag', 'ahmedsaad', 'allcallo', 'lorymingus', 'nicolas88', 'bishoyid', 'maclaura', 'validopm', 'aktkira', 'moamen', 'francesco87', 'kymera', 'mohamed2011', 'shaymaa', 'ahmedrashied', 'asoltan', 'himahmoud', 'bigu', 'mcgarner', 'tai86', 'magnone', 'ibra_candle', 'arnaldo87', 'zema_1', 'delvec', 'spax', 'mazen_soliman', 'fonz', 'tamer1221', 'manar']",1,[None],41,"['testing123', 'ahmed88', 'nourahmed', 'mastermw', 'mohmmad_mahusin', 'serag', 'msawaby', 'ahmedsaad', 'allcallo', 'lorymingus', 'nicolas88', 'bishoyid', 'maclaura', 'validopm', 'aktkira', 'moamen', 'francesco87', 'ahussein', 'kymera', 'mohamed2011', 'shaymaa', 'ahmedrashied', 'asoltan', 'michael2011', 'himahmoud', 'bigu', 'mcgarner', None, 'tai86', 'nahlaelazab', 'magnone', 'ibra_candle', 'arnaldo87', 'zema_1', 'delvec', 'spax', 'mazen_soliman', 'fonz', 'ibrahemmetwally77', 'tamer1221', 'manar']"
9,140,41,6,5,"['ahmed88', 'ibra_candle', 'ahmedrashied', 'nourahmed', 'serag']",35,"['testing123', 'mastermw', 'mohmmad_mahusin', 'msawaby', 'ahmedsaad', 'allcallo', 'lorymingus', 'nicolas88', 'bishoyid', 'maclaura', 'validopm', 'aktkira', 'moamen', 'francesco87', 'ahussein', 'kymera', 'mohamed2011', 'shaymaa', 'asoltan', 'michael2011', 'himahmoud', 'bigu', 'mcgarner', 'tai86', 'nahlaelazab', 'magnone', 'arnaldo87', 'zema_1', 'delvec', 'spax', 'mazen_soliman', 'fonz', 'ibrahemmetwally77', 'tamer1221', 'manar']",1,[None],41,"['testing123', 'ahmed88', 'nourahmed', 'mastermw', 'mohmmad_mahusin', 'serag', 'msawaby', 'ahmedsaad', 'allcallo', 'lorymingus', 'nicolas88', 'bishoyid', 'maclaura', 'validopm', 'aktkira', 'moamen', 'francesco87', 'ahussein', 'kymera', 'mohamed2011', 'shaymaa', 'ahmedrashied', 'asoltan', 'michael2011', 'himahmoud', 'bigu', 'mcgarner', None, 'tai86', 'nahlaelazab', 'magnone', 'ibra_candle', 'arnaldo87', 'zema_1', 'delvec', 'spax', 'mazen_soliman', 'fonz', 'ibrahemmetwally77', 'tamer1221', 'manar']"
10,172,36,29,27,"['clickiu', 'pkh5310', 'changjun0605', 'kmy8823', 'sykim1008', 'teias', 'stjns', 'kdw2104', 'bine77', 'solji0329', 'yesiamtoo', 'jsb0731', 'johou5325', 'yeoheeim', 'poteito', 'wnghks3201', 'shuni', 'sam2858', 'feedback50', 'ursus33', 'mint91', 'spower', 'dlehdwls01', 'kms4105', 'nswhsh12', 'sc1010', 'wannyk']",8,"['phenke', 'zastorius', 'qdotman', 'hellerkopf', 'agcattaneo', 'arunkumarcr', 'mosh', 'mcnallyh']",2,"['james301', None]",37,"['phenke', 'clickiu', 'james301', 'pkh5310', 'kmy8823', 'sykim1008', 'teias', 'stjns', 'zastorius', 'qdotman', 'kdw2104', 'bine77', 'wannyk', 'solji0329', 'mosh', 'yesiamtoo', 'mcnallyh', 'jsb0731', 'johou5325', 'yeoheeim', 'poteito', 'hellerkopf', 'wnghks3201', 'shuni', 'sam2858', 'arunkumarcr', 'feedback50', 'ursus33', None, 'mint91', 'agcattaneo', 'spower', 'dlehdwls01', 'kms4105', 'nswhsh12', 'sc1010', 'changjun0605']"
10,173,36,16,15,"['clickiu', 'mint91', 'pkh5310', 'changjun0605', 'kdw2104', 'dlehdwls01', 'shuni', 'sam2858', 'feedback50', 'ursus33', 'solji0329', 'yesiamtoo', 'johou5325', 'stjns', 'wannyk']",20,"['phenke', 'kmy8823', 'sykim1008', 'teias', 'zastorius', 'qdotman', 'bine77', 'mosh', 'mcnallyh', 'jsb0731', 'yeoheeim', 'poteito', 'hellerkopf', 'wnghks3201', 'arunkumarcr', 'agcattaneo', 'spower', 'kms4105', 'nswhsh12', 'sc1010']",1,[None],36,"['phenke', 'clickiu', 'pkh5310', 'kmy8823', 'sykim1008', 'teias', 'stjns', 'zastorius', 'qdotman', 'kdw2104', 'bine77', 'wannyk', 'solji0329', 'mosh', 'yesiamtoo', 'mcnallyh', 'jsb0731', 'johou5325', 'yeoheeim', 'poteito', 'hellerkopf', 'wnghks3201', 'shuni', 'sam2858', 'arunkumarcr', 'feedback50', 'ursus33', None, 'mint91', 'agcattaneo', 'spower', 'dlehdwls01', 'kms4105', 'nswhsh12', 'sc1010', 'changjun0605']"
11,162,30,29,27,"['markhettick', 'alexlee_gk', 'wakahiu', 'kevin98757', 'someonefromtc', 'ecardona', 'bnlunt1', 'esheu', 'juliean420', 'nnarevsky', 'ee143dj', 'saffordl', 'clochner', 'atoor', 'erintjahjono', 'punitmishra', 'normwen', 'cellery', 'rosalanta', 'grau', 'cczztt', 'kthompson88', 'demontea', 'spiralout11235', 'joediont', 'ee143cd', 'igorizyumin']",2,"['moogra', 'asmodeuus']",2,"['lettertohyo', None]",31,"['moogra', 'markhettick', 'alexlee_gk', 'wakahiu', 'kevin98757', 'someonefromtc', 'bnlunt1', 'juliean420', 'esheu', 'ecardona', 'nnarevsky', 'ee143dj', 'saffordl', 'clochner', 'atoor', 'lettertohyo', 'erintjahjono', 'punitmishra', 'asmodeuus', 'normwen', 'cellery', 'rosalanta', 'grau', 'cczztt', 'kthompson88', 'demontea', 'spiralout11235', None, 'joediont', 'ee143cd', 'igorizyumin']"
12,83,29,24,21,"['tarring', 'kp', 'asoudegi', 'szisman', 'swk1230', 'galimdor', 'zzhang18', 'lizhy14', 'mdh266', 'willsix', 'lixiaojuventus', 'phsu', 'u9120009', 'melamala', 'amithrajv88', 'dbaniya', 'nst46', 'matibabenco', 'dsalta', 'art', 'ccorbet']",7,"['zver4ik', 'renatostrain', 'arinigo', 'etutuc', 'vihar79', 'jstolle779', 'barbie1980']",3,"['slobodyan', 'tbharvey', None]",31,"['zver4ik', 'renatostrain', 'tarring', 'arinigo', 'tbharvey', 'kp', 'asoudegi', 'vihar79', 'swk1230', 'galimdor', 'barbie1980', 'zzhang18', 'lizhy14', 'mdh266', 'willsix', 'lixiaojuventus', 'phsu', 'melamala', 'u9120009', 'amithrajv88', 'dbaniya', 'etutuc', 'nst46', 'slobodyan', 'matibabenco', 'dsalta', None, 'art', 'ccorbet', 'jstolle779', 'szisman']"
13,168,29,14,11,"['bwiesner', 'rjohns03', 'ahamil79', 'jfitch_32', 'raymer88', 'cvillanu', 'mgraus', 'jpillars', 'charriso', 'pappas.harry', 'aelmaoued']",17,"['wing2', 'mchabalk', 'nirbu', 'jonasantosilva', 'gracielyelias', 'ragnhild', 'sinobad', 'labutler', 'amroalkhatib', 'simonsun07', 'gshen', 's4195896', 'kaje83', 'jamhub', 'morg', 'malloy', 'soner']",3,"[None, 'yuna', 'jdroybal']",31,"['rjohns03', 'nirbu', 'simonsun07', 'gshen', 'cvillanu', 'raymer88', 'pappas.harry', 'mchabalk', 'yuna', 'jfitch_32', 'jamhub', 'charriso', 'aelmaoued', 'soner', 'bwiesner', 'jonasantosilva', 'gracielyelias', 'ragnhild', 'amroalkhatib', 'jdroybal', 'kaje83', 'mgraus', 'morg', 'malloy', None, 'ahamil79', 'sinobad', 's4195896', 'labutler', 'wing2', 'jpillars']"
14,103,26,17,16,"['bjezell', 'timkratzke', 'ctsui', 'bobbyhonez', 'tdillin', 'kfcook', 'jgpowel2', 'kvburke', 'mdarwic', 'bennieficial', 'llan103', 'kjmedero', 'cjgrice', 'jakeip1', 'aagbade', 'cc8160']",9,"['kpkreddy_99', 'cwrightc33', 'khairulbashar', 'jasilver', 'jheung', 'pamizell', 'jrmoody', 'pariram', 'ajgarre2']",1,[None],26,"['cwrightc33', 'bjezell', 'tdillin', 'khairulbashar', 'jheung', 'cjgrice', 'ajgarre2', 'jgpowel2', 'llan103', 'kjmedero', 'jrmoody', 'kpkreddy_99', 'ctsui', 'bobbyhonez', 'mdarwic', 'pamizell', 'jakeip1', 'aagbade', None, 'cc8160', 'timkratzke', 'kvburke', 'kfcook', 'jasilver', 'bennieficial', 'pariram']"
15,166,24,216,21,"['achalasani11', 'kkm195', 'anvarelas', 'dlf575', 'robertbarnes', 'nym3t5fan', 'achalasani', 'wbao2', 'kgancedo', 'aznchristian', 'ali.falouji', 'prarthana.dalal', 'kcwikla', 'trekkiegus', 'cto324', 'al.johri', 'fergusma', 'jnb385', 'mgm54', 'mkim1025', 'rparrillo']",2,"['realblackwisen', 'jkd792']",195,"['lnk645', 'yyuchen', 'nehapatel', 'achatrathi', 'eramos', 'nsp483', 'pranavspatel', 'kguo92', 'austinhunter21', 'rbattisfore', 'lms878', 'etran27', 'dis821', 'brandonstaunton', 'tywon35', 'jarnold93', 'aelliott', 'bcaldwell7', 'kerutila', 'ezuehlke322', 'dteplov', 'hvw198', 'krd450', 'johnplaxco', 'yuanxi', 'ckh9393', 'lpatel', 'clarahofeldt', 'cap292', 'cli', 'epae962', 'musicdude202', 'jbeck3r', 'lmw880', 'sakim1', 'tkp337', 'kpanchal2015', 'jrjeevarajan', 'aca821', 'courtneyam324', 'mshi', 'slabrador', 'kas617', 'clayton', 'arjunbalakumar1', 'abronder', 'mattfasa', 'asanz', 'praju1', 'drsmith93', 'cynthias361', 'rchowdhury', 'rscholes', 'yslee', 'pamurphy1', 'laurenk', 'wdd017', 'scasteel13', 'victorquan', 'jcm112', 'cearap123', 'cchung', 'sabughnaim', 'mab729', 'kam470', 'julitroi', 'epa148', 'rgradone', 'aarohi1993', 'ckc043', 'all701', 'dchang', 'sibarra', 'jdrapekin', 'mrpika284', 'schoo', 'seungyeonseo2015', 'avyfain', 'ksz858', 'kjohnson07', 'mph62293', 'sjk423', 'eschonher', 'ajishiotaro', 'hjk342', 'karishang', 'bohanxing', 'rkd406', 'fungerer', 'cjn341', 'sab982', 'katherinekrupinski2015', 'van229', 'tnchang', 'joonzzz', 'sabinas', 'lakintilo', 'pioneer825', 'shreder2b', 'rld391', 'smd622', 'prasanth92', 'yunkatherine', 'jsprice23', 'psb481', 'skim049', 'lolitschen', 'pchenji', 'jpadgen', 'bschmitz', 'jefrandolig228', 'ka23te', 'adonaldson', 'aorwasher', 'sep285', 'smortensen', 'ashaff993', 'mnathal', 'ta101', 'tkaltenecker', 'mnobrien', 'jackmo1993', 'jrr998', 'hgr752', 'akcarlson420', 'nwalia', 'clehman', 'jennadiaz', 'drc716', 'msazo', 'cac559', 'sverma', 'devoraisseroff2015', 'vrc965', 'udesai93', 'vincericola44', 'youjinlee2015', 'dls977', 'bugmenot', 'shishuyao', 'erinkirton', 'mattzhou', 'gracek', 'cbh364', 'jmad593', 'sdz149', 'tmckinney', 'ethanritz2015', 'abchinen', 'fillangrady', 'blakekidd2015', 'nzaporski', 'palakpatel2015', 'bherrick', 'violaplayer75', 'dhuang333', 'kgreenberg360', 'nanohub88', 'mantzouj', 'bdt015', 'asipher', 'nitestars', 'sirseven', 'alorenzaucentre', 'cbinkley1', 'jcg786', 'jooi', 'kristil93', 'oopascual2', 'leonardiszekely', 'rat815', 'noahnuta', 'kikkaviki', 'henrikwesterkam', 'vincentkenny', 'bretth444', 'mdk016', 'tslater13', 'sotirioskarathanasis', 'shussaini', 'rjackson', 'okeowoolatunde', 'jli7', 'dianaleatha', 's2rach', 'spencerjsaldana', 'mab497', 'slhatch', 'nickpic90', 'maraikar', 'jcy197', 'frandolig268', 'haddenklima', 'jtizzelfoshizzel', 'dmarks']",218,"['lnk645', 'yyuchen', 'nehapatel', 'achatrathi', 'eramos', 'nsp483', 'pranavspatel', 'kguo92', 'austinhunter21', 'rbattisfore', 'lms878', 'etran27', 'nym3t5fan', 'dis821', 'brandonstaunton', 'tywon35', 'jarnold93', 'aelliott', 'bcaldwell7', 'kerutila', 'ezuehlke322', 'dteplov', 'hvw198', 'krd450', 'kcwikla', 'johnplaxco', 'yuanxi', 'ckh9393', 'lpatel', 'clarahofeldt', 'cap292', 'cli', 'epae962', 'musicdude202', 'cto324', 'jbeck3r', 'realblackwisen', 'lmw880', 'sakim1', 'jnb385', 'tkp337', 'kpanchal2015', 'jrjeevarajan', 'aca821', 'courtneyam324', 'mshi', 'slabrador', 'kas617', 'clayton', 'rparrillo', 'arjunbalakumar1', 'abronder', 'mattfasa', 'asanz', 'praju1', 'drsmith93', 'kkm195', 'cynthias361', 'rchowdhury', 'rscholes', 'yslee', 'pamurphy1', 'laurenk', 'wdd017', 'scasteel13', 'victorquan', 'robertbarnes', 'jcm112', 'cearap123', 'cchung', 'sabughnaim', 'mab729', 'kam470', 'julitroi', 'epa148', 'wbao2', 'rgradone', 'aarohi1993', 'ckc043', 'all701', 'aznchristian', 'dchang', 'sibarra', 'jkd792', 'jdrapekin', 'mrpika284', 'schoo', 'seungyeonseo2015', 'avyfain', 'ksz858', 'kjohnson07', 'mph62293', 'sjk423', 'eschonher', 'ajishiotaro', 'hjk342', 'karishang', 'bohanxing', 'trekkiegus', 'rkd406', 'fungerer', 'cjn341', 'sab982', 'katherinekrupinski2015', 'van229', 'tnchang', 'joonzzz', 'sabinas', 'lakintilo', 'pioneer825', 'shreder2b', 'rld391', 'smd622', 'prasanth92', 'yunkatherine', 'jsprice23', 'psb481', 'skim049', 'lolitschen', 'pchenji', 'jpadgen', 'bschmitz', 'jefrandolig228', 'ka23te', 'dlf575', 'adonaldson', 'aorwasher', 'sep285', 'smortensen', 'ashaff993', 'mnathal', 'ta101', 'tkaltenecker', 'achalasani', 'mnobrien', 'jackmo1993', 'jrr998', 'hgr752', 'akcarlson420', 'ali.falouji', 'nwalia', 'prarthana.dalal', 'clehman', 'jennadiaz', 'drc716', 'msazo', 'cac559', 'sverma', 'devoraisseroff2015', 'vrc965', 'udesai93', 'vincericola44', 'youjinlee2015', 'al.johri', 'dls977', 'bugmenot', 'shishuyao', 'erinkirton', 'mattzhou', 'gracek', 'mgm54', 'cbh364', 'jmad593', 'sdz149', 'tmckinney', 'ethanritz2015', 'abchinen', 'achalasani11', 'fillangrady', 'blakekidd2015', 'nzaporski', 'palakpatel2015', 'bherrick', 'violaplayer75', 'dhuang333', 'anvarelas', 'kgreenberg360', 'nanohub88', 'mantzouj', 'bdt015', 'asipher', 'nitestars', 'sirseven', 'alorenzaucentre', 'cbinkley1', 'jcg786', 'jooi', 'kristil93', 'oopascual2', 'leonardiszekely', 'kgancedo', 'rat815', 'noahnuta', 'kikkaviki', 'henrikwesterkam', 'vincentkenny', 'bretth444', 'mdk016', 'tslater13', 'sotirioskarathanasis', 'shussaini', 'rjackson', 'okeowoolatunde', 'jli7', 'dianaleatha', 's2rach', 'fergusma', 'spencerjsaldana', 'mab497', 'slhatch', 'nickpic90', 'mkim1025', 'maraikar', 'jcy197', 'frandolig268', 'haddenklima', 'jtizzelfoshizzel', 'dmarks']"
16,119,24,19,18,"['franklinv7', 'kenlee', 'elvinl', 'obha', 'fobbywillie', 'jasonhsu2003', 'chenhaot', 'mattandloli', 'suyiwen', 'hutengch', 'hanjae2', 'kmurray', 'medic035', 'stevenyeh', 'leechun6', 'sharminr', 'vraj.shah', 'zjl']",5,"['jamin', 'malaniller', 'xujie2', 'jsnc3366', 'ajujug']",1,[None],24,"['franklinv7', 'fobbywillie', 'kmurray', 'jamin', 'vraj.shah', 'stevenyeh', 'xujie2', 'ajujug', 'obha', 'jsnc3366', 'hutengch', 'hanjae2', 'medic035', 'malaniller', None, 'zjl', 'kenlee', 'elvinl', 'jasonhsu2003', 'chenhaot', 'mattandloli', 'suyiwen', 'leechun6', 'sharminr']"
17,27,24,10,6,"['apiwowar', 'jngunjiri', 'blakegirl2', 'elrack', 'abadami', 'mpacholski']",17,"['bihter', 'aykutlu', 'ptoren', 'quyong', 'waranatha', 'mtao', 'arzensekd', 'ggomila', 'yazgantuna', 'almae', 'ongun', 'ge979', 'glhardin', 'pinarbeyazkilic', 'pjbracke', 'ewatocha', 'contera']",4,"['gfmeyers', 'balasus', None, 'drkiraco']",27,"['bihter', 'aykutlu', 'quyong', 'jngunjiri', 'mtao', 'ggomila', 'yazgantuna', 'almae', 'ongun', 'ge979', 'glhardin', 'contera', 'mpacholski', None, 'drkiraco', 'apiwowar', 'gfmeyers', 'ptoren', 'blakegirl2', 'waranatha', 'elrack', 'balasus', 'pinarbeyazkilic', 'arzensekd', 'abadami', 'pjbracke', 'ewatocha']"
18,147,22,16,15,"['jctaylor', 'dunkman23', 'bavila', 'arsmall', 'skylindrftr', 'deborahw', 'pmdoran', 'tony3945', '295jjang', '475tek', 'jazeeman', 'trncell', 'xenzensen', 'zex46656', 'oliver951']",6,"['jlivenere', 'ronanwarrior', 'cwong788', 'sakil21', 'jathomas1', 'kfukushima']",1,[None],22,"['ronanwarrior', 'zex46656', 'sakil21', 'jathomas1', 'deborahw', 'pmdoran', 'tony3945', '295jjang', 'trncell', 'kfukushima', 'xenzensen', 'oliver951', None, 'jlivenere', 'jctaylor', 'dunkman23', 'bavila', 'arsmall', 'skylindrftr', '475tek', 'jazeeman', 'cwong788']"
19,53,22,122,2,"['ericwei1', 'nithinreddyc']",19,"['ucapssong', 'cvendi2', 'icfmi90', 'zyf7284563', 'cardena2', 'lumiao88', 'kazi1', 'shook2', 'lobert124', 'cabraal', 'oper951', 'rohanamin', 'luyun198993', 'ray4', 'wrubrec2', 'ragunat1', 'choquett', 'djung31', 'red6290']",120,"['yuqili1', 'ericwoo1', 'predatorhunter51', 'liyd', 'adamwright08', 'txia', 'wells8', 'sonicbro', 'landin', 'xiwang4', 'huang133', 'wtkarcher', 'onay91', 'cfranc20', 'matamor1', 'hanbacca', 'yurilee2', 'pniemer2', 'wang212', 'adoboluver', 'josephxu', 'jashari1', 'stanzzang', 'lawrenceli', 'conley3', 'tom69sawyer', 'zhuxh529', 'zson2', 'mwang53', 'ahasija2', 'lmendez2', 'sundstr2', 'dabigpig', 'philip', 'khaostehnoob', 'scarlett', 'bredemer', 'b3nny312', 'zhang155', 'draydenlin', 'rohanbambery', 'adammodig', 'isankar21', 'jasperli', 'yohanko322', 'cfok3', 'wheele11', 'rose4', 'godofdeath', 'mccann4', 'rooney5', 'wang227', 'fluxayh', 'maninpat', 'azure3t', 'mohamed', 'profballack', 'kim325', 'dinger104', 'yuan10', 'szazeski', 'ededens', 'roybell', 'cbarth2', 'ren6', 'chanda2', 'sharma16', 'alee13', 'shah19', 'wolf13', 'takagi1', 'bae7', 'dmoonxp5', 'assem2', 'hansanderson', 'young10', 'kantner1', 'garcias1', 'zstone2', 'hunter_136', 'lee643', 'jacobgruber', 'chitten1', 'kadakiy1', 'tovarbr2', 'rturner', 'willwang0737', 'hong64', 'drtesla90', 'kulkarn3', 'chanj45', 'choquet1', 'keramat1', 'kylekalk', 'theyubo', 'shah4u19', 'kevinlooby', 'tumblesoup', 'jifeixu', 'kong7', 'awesly2', 'leijin3', 'danyangzhuo', 'seanyen1', 'searuff', 'turnbll2', 'digitalmouse12', 'ysun12', 'lincoln5', None, 'cialdel1', 'wang217', 'sungbea89', 'v3lox', 'bdlftth2', 'dtoome2', 'huddles1', 'lylo', 'jacobs25', 'singh29']",141,"['ericwoo1', 'adamwright08', 'txia', 'wells8', 'sonicbro', 'landin', 'zyf7284563', 'singh29', 'wtkarcher', 'cardena2', 'onay91', 'ericwei1', 'matamor1', 'oper951', 'jashari1', 'lawrenceli', 'tom69sawyer', 'mwang53', 'ahasija2', 'lmendez2', 'dabigpig', 'philip', 'khaostehnoob', 'scarlett', 'rohanbambery', 'cfok3', 'wheele11', 'ragunat1', 'godofdeath', 'mccann4', 'wang227', 'fluxayh', 'azure3t', 'mohamed', 'profballack', 'kim325', 'dinger104', 'yuan10', 'szazeski', 'ededens', 'ren6', 'shah19', 'wolf13', 'takagi1', 'bae7', 'assem2', 'young10', 'kantner1', 'garcias1', 'zstone2', 'lee643', 'jacobgruber', 'tovarbr2', 'rturner', 'hong64', 'chanj45', 'choquet1', 'kylekalk', 'shah4u19', 'kong7', 'awesly2', 'leijin3', 'danyangzhuo', 'searuff', 'digitalmouse12', 'lincoln5', 'ray4', 'wrubrec2', 'v3lox', 'dtoome2', 'choquett', 'jacobs25', 'yuqili1', 'predatorhunter51', 'ucapssong', 'liyd', 'nithinreddyc', 'icfmi90', 'xiwang4', 'huang133', 'kazi1', 'cfranc20', 'hanbacca', 'yurilee2', 'pniemer2', 'lobert124', 'wang212', 'cabraal', 'adoboluver', 'josephxu', 'rohanamin', 'stanzzang', 'conley3', 'zhuxh529', 'zson2', 'sundstr2', 'bredemer', 'b3nny312', 'zhang155', 'draydenlin', 'adammodig', 'isankar21', 'jasperli', 'yohanko322', 'rose4', 'rooney5', 'maninpat', 'roybell', 'djung31', 'cbarth2', 'chanda2', 'sharma16', 'alee13', 'dmoonxp5', 'hansanderson', 'cvendi2', 'lumiao88', 'shook2', 'hunter_136', 'chitten1', 'kadakiy1', 'willwang0737', 'drtesla90', 'kulkarn3', 'keramat1', 'theyubo', 'kevinlooby', 'tumblesoup', 'jifeixu', 'seanyen1', 'turnbll2', 'luyun198993', 'ysun12', None, 'cialdel1', 'wang217', 'sungbea89', 'bdlftth2', 'huddles1', 'lylo', 'red6290']"
19,63,22,114,9,"['shook2', 'wrubrec2', 'ucapssong', 'lobert124', 'cabraal', 'nithinreddyc', 'cvendi2', 'zyf7284563', 'kazi1']",12,"['ragunat1', 'oper951', 'choquett', 'icfmi90', 'rohanamin', 'luyun198993', 'cardena2', 'lumiao88', 'djung31', 'red6290', 'ericwei1', 'ray4']",105,"['yuqili1', 'predatorhunter51', 'huanghewill', 'adamwright08', 'hjsong2', 'wells8', 'sonicbro', 'landin', 'shiou2', 'onay91', 'cfranc20', 'hanbacca', 'yurilee2', 'mikeudelhofen', 'adoboluver', 'ryanschuster', 'kane11', 'jashari1', 'munjal2', 'jang34', 'dmgo17', 'tom69sawyer', 'zhuxh529', 'zson2', 'smedber2', 'ahasija2', 'lmendez2', 'bredemer', 'sundstr2', 'b3nny312', 'khaostehnoob', 'scarlett', 'zhang155', 'bhuiya1', 'elachman', 'isankar21', 'yohanko322', 'wheele11', 'godofdeath', 'rooney5', 'fluxayh', 'maninpat', 'azure3t', 'kim325', 'profballack', 'dinger104', 'mohamed', 'roybell', 'ededens', 'vik579', 'sherlaby25', 'bilalgabula', 'ren6', 'alee13', 'shah19', 'wolf13', 'takagi1', 'ammario', 'bae7', 'dmoonxp5', 'hansanderson', 'kantner1', 'young10', 'garcias1', 'sebasti2', 'chitten1', 'kadakiy1', 'rturner', 'drtesla90', 'chang112', 'chanj45', 'choquet1', 'yin9', 'chivukula3', 'keramat1', 'scalise1', 'sfoolgenius', 'kylekalk', 'shah4u19', 'kevinlooby', 'oper321', 'murray18', 'tumblesoup', 'theyubo', 'kong7', 'crisci1', 'leijin3', 'danyangzhuo', 'seanyen1', 'rccarca', 'digitalmouse12', 'ysun12', 'lincoln5', 'stewart9', None, 'cialdel1', 'sungbea89', 'v3lox', 'sulas2', 'dtoome2', 'bdlftth2', 'rhein1', 'savysaville', 'lylo', 'ehgma0821']",126,"['adamwright08', 'hjsong2', 'wells8', 'sonicbro', 'landin', 'zyf7284563', 'shiou2', 'onay91', 'cardena2', 'ericwei1', 'mikeudelhofen', 'oper951', 'kane11', 'jashari1', 'munjal2', 'dmgo17', 'tom69sawyer', 'ahasija2', 'lmendez2', 'khaostehnoob', 'scarlett', 'bhuiya1', 'elachman', 'wheele11', 'ragunat1', 'godofdeath', 'fluxayh', 'azure3t', 'kim325', 'profballack', 'dinger104', 'mohamed', 'ededens', 'vik579', 'sherlaby25', 'ren6', 'shah19', 'wolf13', 'takagi1', 'ammario', 'bae7', 'kantner1', 'young10', 'garcias1', 'rturner', 'chanj45', 'choquet1', 'scalise1', 'sfoolgenius', 'kylekalk', 'shah4u19', 'kong7', 'crisci1', 'leijin3', 'danyangzhuo', 'digitalmouse12', 'lincoln5', 'stewart9', 'ray4', 'wrubrec2', 'v3lox', 'dtoome2', 'choquett', 'savysaville', 'yuqili1', 'predatorhunter51', 'ucapssong', 'huanghewill', 'nithinreddyc', 'icfmi90', 'kazi1', 'cfranc20', 'hanbacca', 'yurilee2', 'lobert124', 'adoboluver', 'cabraal', 'ryanschuster', 'rohanamin', 'jang34', 'zhuxh529', 'zson2', 'smedber2', 'bredemer', 'sundstr2', 'b3nny312', 'zhang155', 'isankar21', 'yohanko322', 'rooney5', 'maninpat', 'roybell', 'djung31', 'bilalgabula', 'alee13', 'dmoonxp5', 'hansanderson', 'cvendi2', 'lumiao88', 'sebasti2', 'shook2', 'chitten1', 'kadakiy1', 'drtesla90', 'chang112', 'yin9', 'chivukula3', 'keramat1', 'kevinlooby', 'oper321', 'murray18', 'tumblesoup', 'theyubo', 'seanyen1', 'rccarca', 'luyun198993', 'ysun12', None, 'cialdel1', 'sungbea89', 'sulas2', 'bdlftth2', 'rhein1', 'lylo', 'ehgma0821', 'red6290']"
19,62,22,53,6,"['ragunat1', 'rohanamin', 'luyun198993', 'cardena2', 'djung31', 'ericwei1']",15,"['shook2', 'wrubrec2', 'ucapssong', 'lobert124', 'cabraal', 'oper951', 'choquett', 'nithinreddyc', 'cvendi2', 'icfmi90', 'zyf7284563', 'kazi1', 'lumiao88', 'red6290', 'ray4']",47,"['gravityplanx', 'caz1429', 'hjsong2', 'assem2', 'hansanderson', 'sonicbro', 'rkuryl2', 'onay91', 'demint1', 'zhu52', 'ckhuang999', 'wang212', 'mikeudelhofen', 'ryanschuster', 'seanlee14', 'frisbie1', 'chorvat2', 'jpack91', 'chanj45', 'mtzcardfan08', 'dmgo17', 'kong7', 'sundstr2', 'drejmeisterdrej', 'philip', 'khaostehnoob', 'columbine', 'digitalmouse12', 'brinlee2', 'stewart9', 'bettenh1', None, 'wang217', 'nikhrmn', 'rose4', 'mattycat9000', 'nullaa', 'v3lox', 'mmcdow4', 'maninpat', 'huddles1', 'azure3t', 'ehgma0821', 'yening9063', 'fahmad6', 'tmalone3', 'vik579']",68,"['ucapssong', 'hjsong2', 'caz1429', 'nithinreddyc', 'sonicbro', 'icfmi90', 'zyf7284563', 'onay91', 'cardena2', 'kazi1', 'zhu52', 'ericwei1', 'lobert124', 'wang212', 'cabraal', 'mikeudelhofen', 'oper951', 'ryanschuster', 'rohanamin', 'chorvat2', 'mtzcardfan08', 'dmgo17', 'sundstr2', 'drejmeisterdrej', 'philip', 'khaostehnoob', 'columbine', 'bettenh1', 'rose4', 'ragunat1', 'mattycat9000', 'maninpat', 'azure3t', 'yening9063', 'djung31', 'fahmad6', 'vik579', 'gravityplanx', 'assem2', 'hansanderson', 'cvendi2', 'rkuryl2', 'lumiao88', 'ckhuang999', 'demint1', 'shook2', 'seanlee14', 'frisbie1', 'jpack91', 'chanj45', 'tmalone3', 'kong7', 'luyun198993', 'digitalmouse12', 'brinlee2', 'stewart9', None, 'ray4', 'wang217', 'nikhrmn', 'wrubrec2', 'v3lox', 'nullaa', 'mmcdow4', 'choquett', 'huddles1', 'ehgma0821', 'red6290']"
19,64,22,28,5,"['shook2', 'ucapssong', 'oper951', 'icfmi90', 'red6290']",16,"['wrubrec2', 'lobert124', 'ragunat1', 'cabraal', 'choquett', 'nithinreddyc', 'cvendi2', 'zyf7284563', 'rohanamin', 'luyun198993', 'cardena2', 'lumiao88', 'djung31', 'ericwei1', 'kazi1', 'ray4']",23,"['takagi1', 'qliu9', 'matamor1', 'josephxu', 'creepdeadly', 'dou1', 'stanzzang', 'lawrenceli', 'jifeixu', 'mwang53', 'bradzab', 'enyuluo', 'searuff', 'rschmid2', None, 'eteran7', 'toan52', 'rasinsk1', 'mccann4', 'rooney5', 'jacobs25', 'yuan10', 'cbarth2']",44,"['ucapssong', 'takagi1', 'nithinreddyc', 'cvendi2', 'icfmi90', 'zyf7284563', 'cardena2', 'lumiao88', 'kazi1', 'qliu9', 'ericwei1', 'matamor1', 'cbarth2', 'shook2', 'lobert124', 'cabraal', 'josephxu', 'oper951', 'creepdeadly', 'dou1', 'rohanamin', 'stanzzang', 'lawrenceli', 'jifeixu', 'mwang53', 'bradzab', 'enyuluo', 'searuff', 'luyun198993', 'rschmid2', None, 'ray4', 'eteran7', 'wrubrec2', 'ragunat1', 'toan52', 'rasinsk1', 'mccann4', 'rooney5', 'choquett', 'jacobs25', 'yuan10', 'djung31', 'red6290']"
19,99,22,28,1,['ericwei1'],20,"['ucapssong', 'nithinreddyc', 'cvendi2', 'icfmi90', 'zyf7284563', 'cardena2', 'lumiao88', 'kazi1', 'shook2', 'lobert124', 'cabraal', 'oper951', 'rohanamin', 'luyun198993', 'ray4', 'wrubrec2', 'ragunat1', 'choquett', 'djung31', 'red6290']",27,"['gravityplanx', 'shah19', 'caz1429', 'assem2', 'hansanderson', 'onay91', 'demint1', 'ckhuang999', 'hong64', 'jpack91', 'jifeixu', 'kong7', 'drejmeisterdrej', 'rccarca', None, 'bettenh1', 'wang217', 'rose4', 'v3lox', 'ljbaker2', 'mmcdow4', 'savysaville', 'ehgma0821', 'yening9063', 'yuan10', 'tmalone3', 'pixton1']",48,"['gravityplanx', 'ucapssong', 'shah19', 'caz1429', 'nithinreddyc', 'assem2', 'cvendi2', 'hansanderson', 'icfmi90', 'zyf7284563', 'onay91', 'cardena2', 'lumiao88', 'kazi1', 'demint1', 'ericwei1', 'ckhuang999', 'shook2', 'lobert124', 'cabraal', 'oper951', 'rohanamin', 'hong64', 'jpack91', 'tmalone3', 'jifeixu', 'kong7', 'drejmeisterdrej', 'rccarca', 'luyun198993', None, 'bettenh1', 'ray4', 'wang217', 'wrubrec2', 'ragunat1', 'rose4', 'v3lox', 'ljbaker2', 'mmcdow4', 'choquett', 'savysaville', 'ehgma0821', 'yening9063', 'yuan10', 'djung31', 'red6290', 'pixton1']"
19,77,22,21,14,"['shook2', 'wrubrec2', 'ucapssong', 'lobert124', 'cabraal', 'oper951', 'nithinreddyc', 'cvendi2', 'zyf7284563', 'rohanamin', 'luyun198993', 'cardena2', 'red6290', 'kazi1']",7,"['ragunat1', 'choquett', 'icfmi90', 'lumiao88', 'djung31', 'ericwei1', 'ray4']",7,"['leo19890725', 'bae7', 'b3nny312', 'bhuiya1', 'crosscounter87', 'lee142', None]",28,"['ucapssong', 'bae7', 'nithinreddyc', 'cvendi2', 'icfmi90', 'zyf7284563', 'crosscounter87', 'cardena2', 'lumiao88', 'kazi1', 'ericwei1', 'shook2', 'lobert124', 'cabraal', 'leo19890725', 'oper951', 'rohanamin', 'b3nny312', 'bhuiya1', 'luyun198993', 'lee142', None, 'ray4', 'wrubrec2', 'ragunat1', 'choquett', 'djung31', 'red6290']"
19,78,22,10,7,"['ragunat1', 'rohanamin', 'luyun198993', 'cardena2', 'lumiao88', 'djung31', 'ericwei1']",14,"['shook2', 'wrubrec2', 'ucapssong', 'lobert124', 'cabraal', 'oper951', 'choquett', 'nithinreddyc', 'cvendi2', 'icfmi90', 'zyf7284563', 'kazi1', 'red6290', 'ray4']",3,"['luisccruz', 'vik579', None]",24,"['luisccruz', 'ucapssong', 'nithinreddyc', 'cvendi2', 'icfmi90', 'zyf7284563', 'luyun198993', 'cardena2', 'lumiao88', 'kazi1', 'ericwei1', None, 'ray4', 'shook2', 'wrubrec2', 'lobert124', 'ragunat1', 'cabraal', 'oper951', 'choquett', 'rohanamin', 'djung31', 'red6290', 'vik579']"
20,42,21,34,18,"['jd.bernal2802', 'pguzman1', 'as.plazas2099', 'd.de5511', 'malopez395', 'ap.cuerdo2685', 'valenciajd', 'dimigaro', 'nick13571', 'dtavera2296', 'ia.bulla548', 'mc.guacheta177', 'lc.gaitan2035', 'amsuar92', 'jp.combariza833', 'anferesa', 'ivon0502', 'diegoc906']",2,"['jccarranza1617', 'miguelortiz11']",16,"['tefa_233', 'jreiss', 's.jimenez774', 'ce.castillo489', 'd.de551', 'camil30', 'david_espejo', 'jplagos', 'master0001', 'gaonaf', 'lumarin', 'nesquiv', 'leonardogm91', 'jbucheli', None, 'carlosandres03cp']",36,"['jccarranza1617', 'jreiss', 'malopez395', 'ap.cuerdo2685', 'david_espejo', 'dimigaro', 'dtavera2296', 'jplagos', 'lumarin', 'jp.combariza833', 'anferesa', 'carlosandres03cp', 's.jimenez774', 'pguzman1', 'ivon0502', 'miguelortiz11', 'ce.castillo489', 'nick13571', 'ia.bulla548', 'leonardogm91', 'amsuar92', 'jbucheli', None, 'jd.bernal2802', 'tefa_233', 'as.plazas2099', 'd.de5511', 'd.de551', 'valenciajd', 'camil30', 'master0001', 'gaonaf', 'lc.gaitan2035', 'nesquiv', 'mc.guacheta177', 'diegoc906']"
20,102,21,25,18,"['jd.bernal2802', 'miguelortiz11', 'pguzman1', 'd.de5511', 'malopez395', 'ap.cuerdo2685', 'valenciajd', 'dimigaro', 'nick13571', 'dtavera2296', 'ia.bulla548', 'mc.guacheta177', 'lc.gaitan2035', 'amsuar92', 'jp.combariza833', 'anferesa', 'ivon0502', 'diegoc906']",2,"['jccarranza1617', 'as.plazas2099']",7,"['nanoems', 'camil30', 'david_espejo', 'logan.mejia', 'leonardogm91', 'jbucheli', None]",27,"['jccarranza1617', 'malopez395', 'ap.cuerdo2685', 'david_espejo', 'dimigaro', 'logan.mejia', 'dtavera2296', 'jp.combariza833', 'anferesa', 'pguzman1', 'ivon0502', 'miguelortiz11', 'nick13571', 'ia.bulla548', 'leonardogm91', 'amsuar92', 'jbucheli', None, 'jd.bernal2802', 'nanoems', 'as.plazas2099', 'd.de5511', 'valenciajd', 'camil30', 'lc.gaitan2035', 'mc.guacheta177', 'diegoc906']"
21,115,18,32,16,"['jeffsanchez987', 'delphiboy', 'sandhyat', 'kaitlin0326', 'btgoding', 'eek735', 'adamberman14', 'hardliquor', 'dccronin', 'jwnanohub', 'dglispie', 'jonlaw91', 'heli1986', 'rvg2013', 'davidlin49', 'chloe126']",1,['rrs091'],16,"['serhanozgul', 'petercha', 'cockettm', 'radhika12', 'domjack', 'jlr181', 'slhatch', 'gretskyw', None, 'ejskelnik', 'ras620', 'ebn494', 'ral262', 'kgu988', 'karly6', 'hollaphant']",33,"['serhanozgul', 'delphiboy', 'radhika12', 'adamberman14', 'hardliquor', 'jwnanohub', 'ral262', 'rrs091', 'davidlin49', 'chloe126', 'hollaphant', 'cockettm', 'btgoding', 'kaitlin0326', 'gretskyw', 'dglispie', 'jonlaw91', 'ejskelnik', 'kgu988', 'karly6', 'domjack', 'sandhyat', 'rvg2013', None, 'jlr181', 'jeffsanchez987', 'petercha', 'eek735', 'dccronin', 'slhatch', 'ebn494', 'heli1986', 'ras620']"
21,45,18,25,17,"['jeffsanchez987', 'delphiboy', 'sandhyat', 'kaitlin0326', 'btgoding', 'eek735', 'adamberman14', 'hardliquor', 'dccronin', 'rvg2013', 'jwnanohub', 'dglispie', 'jonlaw91', 'heli1986', 'rrs091', 'davidlin49', 'chloe126']",0,[],8,"['hat741', 'laterriataylor', 'tejerina', 'nebiu', 'gretskyw', 'jessicaebenson', 'ejskelnik', None]",25,"['delphiboy', 'laterriataylor', 'adamberman14', 'hardliquor', 'jwnanohub', 'rrs091', 'davidlin49', 'chloe126', 'btgoding', 'kaitlin0326', 'tejerina', 'gretskyw', 'dglispie', 'jonlaw91', 'ejskelnik', 'hat741', 'jessicaebenson', 'sandhyat', 'rvg2013', None, 'jeffsanchez987', 'eek735', 'nebiu', 'dccronin', 'heli1986']"
22,114,18,19,10,"['plittlej', 'niveah', 'aktina907', 'blueberriemuffins21', 'michel2', 'lyonm', 'beemer92', 'willi624', 'cwraight', 'tscapin']",7,"['ywijesek', 'nherhusk', 'mlemcher', 'oawofeso', 'eegolf', 'karlaarmenta', 'nboychuc']",9,"['dharna', 'schnei23', 'aharonhannan', 'eziga', 'chuazm', 'jstobias', 'abossert15', None, 'cassidyjane']",26,"['ywijesek', 'schnei23', 'blueberriemuffins21', 'aktina907', 'aharonhannan', 'lyonm', 'eziga', 'chuazm', 'jstobias', 'mlemcher', None, 'cwraight', 'oawofeso', 'tscapin', 'cassidyjane', 'plittlej', 'niveah', 'nherhusk', 'dharna', 'michel2', 'beemer92', 'willi624', 'eegolf', 'abossert15', 'karlaarmenta', 'nboychuc']"
22,111,18,15,9,"['ywijesek', 'nherhusk', 'niveah', 'aktina907', 'blueberriemuffins21', 'oawofeso', 'tscapin', 'karlaarmenta', 'nboychuc']",8,"['plittlej', 'mlemcher', 'michel2', 'lyonm', 'beemer92', 'willi624', 'eegolf', 'cwraight']",6,"['richa109', 'kwoodwor', 'cm', 'jacobboiler15', 'dwisser', None]",23,"['ywijesek', 'richa109', 'blueberriemuffins21', 'aktina907', 'kwoodwor', 'lyonm', 'jacobboiler15', 'mlemcher', None, 'cwraight', 'oawofeso', 'tscapin', 'plittlej', 'niveah', 'nherhusk', 'michel2', 'cm', 'beemer92', 'dwisser', 'willi624', 'eegolf', 'karlaarmenta', 'nboychuc']"
22,112,18,14,6,"['plittlej', 'ywijesek', 'nherhusk', 'willi624', 'eegolf', 'karlaarmenta']",11,"['niveah', 'aktina907', 'blueberriemuffins21', 'oawofeso', 'tscapin', 'michel2', 'lyonm', 'beemer92', 'mlemcher', 'cwraight', 'nboychuc']",8,"['ahathoot', 'johns906', 'akalsi', 'adimston', 'gbrescil1', None, 'bumblebeez', 'rice40']",25,"['ywijesek', 'blueberriemuffins21', 'aktina907', 'lyonm', 'mlemcher', 'adimston', 'gbrescil1', None, 'cwraight', 'oawofeso', 'tscapin', 'plittlej', 'niveah', 'nherhusk', 'ahathoot', 'johns906', 'rice40', 'akalsi', 'michel2', 'beemer92', 'willi624', 'eegolf', 'bumblebeez', 'karlaarmenta', 'nboychuc']"
22,113,18,8,4,"['eegolf', 'cwraight', 'karlaarmenta', 'oawofeso']",13,"['plittlej', 'ywijesek', 'nherhusk', 'niveah', 'blueberriemuffins21', 'aktina907', 'tscapin', 'michel2', 'lyonm', 'beemer92', 'willi624', 'mlemcher', 'nboychuc']",4,"['cmuturi', 'jwgilber', None, 'wilso356']",21,"['ywijesek', 'blueberriemuffins21', 'aktina907', 'lyonm', 'mlemcher', None, 'cwraight', 'oawofeso', 'tscapin', 'plittlej', 'niveah', 'nherhusk', 'jwgilber', 'wilso356', 'michel2', 'cmuturi', 'beemer92', 'willi624', 'eegolf', 'karlaarmenta', 'nboychuc']"
23,115,17,32,12,"['serhanozgul', 'petercha', 'cockettm', 'ral262', 'domjack', 'radhika12', 'jlr181', 'ebn494', 'ras620', 'kgu988', 'karly6', 'hollaphant']",4,"['amc480', 'danielnavarrourrios', 'aph10000', 'prachinanotech1']",20,"['delphiboy', 'adamberman14', 'hardliquor', 'jwnanohub', 'davidlin49', 'chloe126', 'btgoding', 'kaitlin0326', 'gretskyw', 'jonlaw91', 'ejskelnik', 'dglispie', 'sandhyat', None, 'rvg2013', 'jeffsanchez987', 'eek735', 'dccronin', 'slhatch', 'heli1986']",36,"['serhanozgul', 'delphiboy', 'radhika12', 'adamberman14', 'amc480', 'hardliquor', 'jwnanohub', 'ral262', 'davidlin49', 'chloe126', 'hollaphant', 'cockettm', 'btgoding', 'kaitlin0326', 'danielnavarrourrios', 'gretskyw', 'jonlaw91', 'ejskelnik', 'dglispie', 'kgu988', 'karly6', 'heli1986', 'aph10000', 'domjack', 'sandhyat', 'rvg2013', 'prachinanotech1', None, 'jlr181', 'jeffsanchez987', 'petercha', 'eek735', 'dccronin', 'slhatch', 'ebn494', 'ras620']"
24,133,17,21,16,"['oliverhe', 'reshmananohub166', 'iangrey', 'donghee1025', 'ribh', 'tymoss', 'jensyao', 'no1here', 'eirrgang', 'samnola', 'dempseyj', 'kvdir', 'hlwilsh', 'mhichen', 'wmohr', 'jbmeng']",0,[],5,"['abere', 'kthorn01', 'kworth', None, 'orvanano']",21,"['oliverhe', 'reshmananohub166', 'ribh', 'tymoss', 'jensyao', 'samnola', 'kthorn01', 'kvdir', None, 'orvanano', 'iangrey', 'donghee1025', 'abere', 'no1here', 'eirrgang', 'kworth', 'dempseyj', 'hlwilsh', 'mhichen', 'wmohr', 'jbmeng']"
24,72,17,18,16,"['oliverhe', 'reshmananohub166', 'iangrey', 'donghee1025', 'ribh', 'tymoss', 'jensyao', 'no1here', 'eirrgang', 'samnola', 'dempseyj', 'kvdir', 'hlwilsh', 'mhichen', 'wmohr', 'jbmeng']",0,[],2,"[None, 'orvanano']",18,"['oliverhe', 'reshmananohub166', 'ribh', 'tymoss', 'jensyao', 'samnola', 'kvdir', None, 'orvanano', 'iangrey', 'donghee1025', 'no1here', 'eirrgang', 'dempseyj', 'hlwilsh', 'mhichen', 'wmohr', 'jbmeng']"
24,89,17,15,10,"['reshmananohub166', 'donghee1025', 'ribh', 'tymoss', 'jensyao', 'no1here', 'samnola', 'hlwilsh', 'mhichen', 'wmohr']",6,"['oliverhe', 'iangrey', 'eirrgang', 'dempseyj', 'kvdir', 'jbmeng']",5,"['abere', 'jamillan', 'kthorn01', 'khalid.its.me', None]",21,"['oliverhe', 'reshmananohub166', 'ribh', 'tymoss', 'jensyao', 'samnola', 'kthorn01', 'kvdir', None, 'iangrey', 'donghee1025', 'abere', 'no1here', 'eirrgang', 'jamillan', 'khalid.its.me', 'dempseyj', 'hlwilsh', 'mhichen', 'wmohr', 'jbmeng']"
25,145,16,17,9,"['sami6108', 'bachman', 'laserengineer.yu', 'cshorvat', 'vedranj', 'delosrey', 'tmotahar', 'robertfpeters', 'lhn']",6,"['tvinialves', 'dingdingbj', 'jtriesch', 'dimavavulin', 'ludmila', 'whermoso']",8,"['tschoepp', 'sourenshams', 'ccortes', 'mnielsen', 'pshekhar', 'wnewman', 'sjmolesk', None]",23,"['tvinialves', 'laserengineer.yu', 'tmotahar', 'whermoso', 'ccortes', 'delosrey', 'sami6108', 'tschoepp', 'sourenshams', 'cshorvat', 'vedranj', 'ludmila', 'dimavavulin', 'wnewman', 'robertfpeters', None, 'lhn', 'bachman', 'mnielsen', 'dingdingbj', 'pshekhar', 'jtriesch', 'sjmolesk']"
25,144,16,6,4,"['delosrey', 'cshorvat', 'bachman', 'lhn']",11,"['sami6108', 'tvinialves', 'laserengineer.yu', 'dingdingbj', 'vedranj', 'jtriesch', 'ludmila', 'dimavavulin', 'tmotahar', 'whermoso', 'robertfpeters']",2,"['ccortes', None]",17,"['sami6108', 'tvinialves', 'laserengineer.yu', 'cshorvat', 'vedranj', 'ludmila', 'dimavavulin', 'tmotahar', 'whermoso', 'robertfpeters', None, 'lhn', 'bachman', 'ccortes', 'dingdingbj', 'jtriesch', 'delosrey']"
26,92,15,15,12,"['ilazur', 'anisabbas', 'ankitchowdhary', 'scottread', 'sasa1112', 'cparks', 'tmohamma', 'snsoesie', 'thishleo', 'pdrouillard', 'shanlon', 'karteek88']",2,"['potteraa', 'viacobel']",3,"['ronmiller', None, 'karsm775']",17,"['anisabbas', 'ronmiller', 'sasa1112', 'cparks', 'snsoesie', 'potteraa', None, 'shanlon', 'karteek88', 'ilazur', 'ankitchowdhary', 'scottread', 'tmohamma', 'viacobel', 'thishleo', 'pdrouillard', 'karsm775']"
26,93,15,11,10,"['ilazur', 'ankitchowdhary', 'scottread', 'sasa1112', 'cparks', 'tmohamma', 'snsoesie', 'thishleo', 'shanlon', 'karteek88']",4,"['viacobel', 'pdrouillard', 'potteraa', 'anisabbas']",1,[None],15,"['anisabbas', 'sasa1112', 'cparks', 'snsoesie', 'potteraa', None, 'shanlon', 'karteek88', 'ilazur', 'ankitchowdhary', 'scottread', 'tmohamma', 'viacobel', 'thishleo', 'pdrouillard']"
26,94,15,7,6,"['anisabbas', 'cparks', 'viacobel', 'pdrouillard', 'potteraa', 'shanlon']",8,"['ilazur', 'ankitchowdhary', 'scottread', 'sasa1112', 'tmohamma', 'snsoesie', 'thishleo', 'karteek88']",1,[None],15,"['anisabbas', 'sasa1112', 'cparks', 'snsoesie', 'potteraa', None, 'shanlon', 'karteek88', 'ilazur', 'ankitchowdhary', 'scottread', 'tmohamma', 'viacobel', 'thishleo', 'pdrouillard']"
27,22,15,11,6,"['666dante666', 'synputh', 'scronin', 'karan129', 'chenliang', 'alirezai']",8,"['novnik', 'dls1947', 'darkestside', 'mcintosh', 'jventer', 'psykoen', 'liubingh', 'suprayoga']",5,"['mxnano1', 'rdhall', 'nnning', None, 'hooman4']",19,"['dls1947', 'mxnano1', 'karan129', 'mcintosh', 'rdhall', 'chenliang', 'liubingh', 'alirezai', None, 'hooman4', '666dante666', 'novnik', 'synputh', 'scronin', 'darkestside', 'jventer', 'psykoen', 'nnning', 'suprayoga']"
27,21,15,10,5,"['666dante666', 'synputh', 'karan129', 'chenliang', 'liubingh']",9,"['novnik', 'dls1947', 'scronin', 'darkestside', 'mcintosh', 'jventer', 'psykoen', 'suprayoga', 'alirezai']",5,"['666_dante_666', 'mxnano1', 'rdhall', 'nnning', None]",19,"['dls1947', 'mxnano1', 'karan129', 'mcintosh', 'rdhall', 'chenliang', 'liubingh', 'alirezai', None, '666dante666', 'novnik', 'synputh', '666_dante_666', 'scronin', 'darkestside', 'jventer', 'psykoen', 'nnning', 'suprayoga']"
28,167,13,10,9,"['pepo023', 'dexbryan42', 'humberto', 'verogutierrez', 'emirielys', 'hectorrrebollo', 'christianjoel', 'osalgado', 'patk']",3,"['gstein', 'vyasrmurnal1984', 'santanasidney']",1,[None],13,"['pepo023', 'dexbryan42', 'humberto', 'verogutierrez', 'hectorrrebollo', 'gstein', None, 'vyasrmurnal1984', 'osalgado', 'santanasidney', 'patk', 'emirielys', 'christianjoel']"
29,95,13,11,10,"['fiska', 'kelcey', 'osterberg', 'brblmrl', 'nakaye12', 'imchipwood', 'hickey12', 'mtchhor', 'kwigton', 'caracheo']",2,"['jesstate', 'groulik']",1,[None],13,"['fiska', 'groulik', 'osterberg', 'nakaye12', 'brblmrl', 'imchipwood', None, 'jesstate', 'kelcey', 'hickey12', 'mtchhor', 'kwigton', 'caracheo']"
30,84,13,20,9,"['kundozerova1', 'monana', 'amjadiq', 'pevere', 'amonge', 'mdcmunoz', 'kunli', 'fgeenen', 'mikekeee']",3,"['hoda', 'sunil221', 'dragonfigo']",11,"['mazimazi', 'noroozi', 'safayet', 'aabedin', 'lg90114', 'aydinci', 'kvar', 'yanuo', 'arashsalemi1976', None, 'jind']",23,"['kundozerova1', 'noroozi', 'aabedin', 'sunil221', 'lg90114', 'kunli', 'yanuo', 'mikekeee', 'amjadiq', 'aydinci', 'fgeenen', 'jind', 'mazimazi', 'safayet', 'dragonfigo', 'pevere', 'amonge', 'hoda', None, 'monana', 'mdcmunoz', 'kvar', 'arashsalemi1976']"
30,155,13,18,9,"['amjadiq', 'pevere', 'amonge', 'hoda', 'sunil221', 'mdcmunoz', 'kunli', 'fgeenen', 'mikekeee']",3,"['kundozerova1', 'monana', 'dragonfigo']",9,"['ccccccccat', 'aabedin', 'himanshuk', 'reyhaneh_soltan', 'sarahri', 'parnimi', 'zjy63562688', 'arashsalemi1976', None]",21,"['kundozerova1', 'ccccccccat', 'dragonfigo', 'aabedin', 'pevere', 'amonge', 'hoda', 'sunil221', 'reyhaneh_soltan', 'kunli', 'sarahri', 'zjy63562688', 'mikekeee', None, 'monana', 'amjadiq', 'himanshuk', 'mdcmunoz', 'parnimi', 'fgeenen', 'arashsalemi1976']"
30,104,13,15,8,"['kundozerova1', 'monana', 'amjadiq', 'pevere', 'hoda', 'mdcmunoz', 'kunli', 'fgeenen']",4,"['amonge', 'sunil221', 'mikekeee', 'dragonfigo']",7,"['mazimazi', 'safayet', 'ccccccccat', 'reyhaneh_soltan', 'addius', 'arashsalemi1976', None]",19,"['kundozerova1', 'mazimazi', 'safayet', 'dragonfigo', 'ccccccccat', 'pevere', 'amonge', 'hoda', 'sunil221', 'reyhaneh_soltan', 'kunli', 'mikekeee', 'addius', None, 'monana', 'amjadiq', 'mdcmunoz', 'fgeenen', 'arashsalemi1976']"
30,85,13,11,4,"['amonge', 'kundozerova1', 'mikekeee', 'kunli']",8,"['monana', 'dragonfigo', 'amjadiq', 'pevere', 'hoda', 'sunil221', 'mdcmunoz', 'fgeenen']",7,"['noroozi', 'sunxu3325', 'osamak', 'km2kash', None, 'jind', 'xiaoyiw']",19,"['kundozerova1', 'noroozi', 'dragonfigo', 'pevere', 'amonge', 'hoda', 'sunil221', 'sunxu3325', 'osamak', 'kunli', 'mikekeee', None, 'xiaoyiw', 'monana', 'amjadiq', 'mdcmunoz', 'fgeenen', 'km2kash', 'jind']"
30,105,13,7,4,"['amonge', 'kundozerova1', 'sunil221', 'mikekeee']",8,"['monana', 'dragonfigo', 'amjadiq', 'pevere', 'hoda', 'mdcmunoz', 'kunli', 'fgeenen']",3,"['sunxu3325', None, 'osamak']",15,"['kundozerova1', 'dragonfigo', 'pevere', 'amonge', 'hoda', 'sunil221', 'osamak', 'sunxu3325', 'kunli', 'mikekeee', None, 'monana', 'amjadiq', 'mdcmunoz', 'fgeenen']"
30,106,13,6,4,"['hoda', 'fgeenen', 'amjadiq', 'pevere']",8,"['kundozerova1', 'monana', 'dragonfigo', 'amonge', 'sunil221', 'mdcmunoz', 'kunli', 'mikekeee']",2,"['mazimazi', None]",14,"['kundozerova1', 'mazimazi', 'monana', 'dragonfigo', 'amjadiq', 'pevere', 'amonge', 'hoda', 'sunil221', 'mdcmunoz', 'kunli', 'fgeenen', 'mikekeee', None]"
31,17,13,20,10,"['akhiloswal', 'mudit585', 'amanc058', 'nivedhan1990', 'abhimanyu123', 'karan0227', 'kesh221', 'salman_khurshid', 'sachinbhatt1989', 'adarshnb']",2,"['eananewa', 'brutus1125']",10,"['ajmal123', 'gandhikunjan', 'preyas3359', 'mihir1190', 'suhassuraj', None, 'deepakchandra1991', 'pavankumar', 'rockinraghavan', 'vakul319']",22,"['gandhikunjan', 'preyas3359', 'kesh221', 'mihir1190', 'brutus1125', 'deepakchandra1991', 'sachinbhatt1989', 'ajmal123', 'amanc058', 'suhassuraj', 'vakul319', 'akhiloswal', 'mudit585', 'abhimanyu123', 'karan0227', 'pavankumar', 'eananewa', 'rockinraghavan', None, 'nivedhan1990', 'salman_khurshid', 'adarshnb']"
32,146,13,7,6,"['a_gryba', 'budmeo', 'mattmatt256', 'zawadadaniel', 'mnk792', 'srd740']",6,"['phi4ever1', 'jjbrando', 'cricket_pissa', 'hyuk0326', 'yz2001zzx', 'jcwirth']",1,[None],13,"['budmeo', 'mattmatt256', 'phi4ever1', 'zawadadaniel', 'yz2001zzx', 'srd740', None, 'jcwirth', 'a_gryba', 'cricket_pissa', 'jjbrando', 'hyuk0326', 'mnk792']"
33,123,13,29,1,['johnea'],11,"['nick5487', 'scdiaz', 'thermalsprayang', 'jkoppes', 'prateek_nath', 'mehrdadd', 'woozey', 'taylor', 'jscibett', 'xie10', 'xiaoyang2011']",28,"['terryduong84', 'kuhrbrya', 'mummywly', 'kkalac', 'kthorn01', 'jwsinger', 'superalloy16', 'chenz1987', 'jarvisia', 'orvanano', 'ljabbott', 'wblawrimore', 'shengyenli', 'pholvey', 'ededa', 'jguyer', 'okeles', 'sgsri', 'redwing', 'saurabh_02', 'laagesen', 'alemottura', None, 'bieler', 'partha7372', 'schiavo1', 'lihongmei', 'nirand']",40,"['terryduong84', 'kuhrbrya', 'mummywly', 'kkalac', 'prateek_nath', 'kthorn01', 'jwsinger', 'superalloy16', 'chenz1987', 'orvanano', 'jarvisia', 'ljabbott', 'nick5487', 'thermalsprayang', 'wblawrimore', 'woozey', 'shengyenli', 'pholvey', 'ededa', 'jguyer', 'okeles', 'johnea', 'jscibett', 'xie10', 'scdiaz', 'sgsri', 'mehrdadd', 'taylor', 'redwing', 'saurabh_02', 'laagesen', 'alemottura', None, 'bieler', 'jkoppes', 'partha7372', 'schiavo1', 'lihongmei', 'xiaoyang2011', 'nirand']"
34,203,13,35,12,"['terryduong84', 'mummywly', 'partha7372', 'ededa', 'lihongmei', 'okeles', 'jwsinger', 'chenz1987', 'alemottura', 'nirand', 'jarvisia', 'ljabbott']",0,[],23,"['kuhrbrya', 'kkalac', 'suttonsc', 'kthorn01', 'ylifan', 'superalloy16', 'shoshaz1', 'gouskova', 'orvanano', 'amjokisaari', 'shengyenli', 'wblawrimore', 'pholvey', 'jguyer', 'sgsri', 'kokimura', 'redwing', 'saurabh_02', 'laagesen', 'bieler', None, 'schiavo1', 'goirijo']",35,"['terryduong84', 'kuhrbrya', 'mummywly', 'kkalac', 'suttonsc', 'ylifan', 'kthorn01', 'jwsinger', 'chenz1987', 'superalloy16', 'shoshaz1', 'gouskova', 'jarvisia', 'ljabbott', 'orvanano', 'amjokisaari', 'shengyenli', 'wblawrimore', 'pholvey', 'ededa', 'jguyer', 'okeles', 'sgsri', 'kokimura', 'redwing', 'saurabh_02', 'laagesen', 'alemottura', 'bieler', None, 'partha7372', 'schiavo1', 'lihongmei', 'goirijo', 'nirand']"
34,123,13,29,12,"['terryduong84', 'mummywly', 'partha7372', 'ededa', 'lihongmei', 'okeles', 'jwsinger', 'chenz1987', 'alemottura', 'nirand', 'jarvisia', 'ljabbott']",0,[],17,"['kuhrbrya', 'kkalac', 'sgsri', 'wblawrimore', 'shengyenli', 'pholvey', 'bieler', 'kthorn01', 'jguyer', 'schiavo1', 'redwing', 'saurabh_02', 'johnea', 'superalloy16', 'laagesen', None, 'orvanano']",29,"['terryduong84', 'kuhrbrya', 'mummywly', 'kkalac', 'kthorn01', 'jwsinger', 'chenz1987', 'superalloy16', 'jarvisia', 'ljabbott', 'orvanano', 'wblawrimore', 'shengyenli', 'pholvey', 'ededa', 'jguyer', 'okeles', 'johnea', 'sgsri', 'redwing', 'saurabh_02', 'laagesen', 'alemottura', None, 'bieler', 'partha7372', 'schiavo1', 'lihongmei', 'nirand']"
34,68,13,7,2,"['partha7372', 'okeles']",10,"['terryduong84', 'mummywly', 'ededa', 'lihongmei', 'jwsinger', 'chenz1987', 'alemottura', 'nirand', 'jarvisia', 'ljabbott']",5,"['kkalac', 'sgsri', 'pholvey', 'superalloy16', None]",17,"['terryduong84', 'mummywly', 'kkalac', 'sgsri', 'jwsinger', 'chenz1987', 'superalloy16', 'alemottura', None, 'jarvisia', 'ljabbott', 'partha7372', 'pholvey', 'ededa', 'lihongmei', 'okeles', 'nirand']"
37,160,13,6,5,"['ramy379', 'h_g_elec', 'ahmedrajaie11', 'dallo407', 'kareem115']",7,"['sukreth', 'viainfinito', 'mabdelfattah', 'pererra', 'lemon625', 'omarfathym', 'xilvita']",1,[None],13,"['ramy379', 'viainfinito', 'mabdelfattah', 'pererra', 'h_g_elec', 'lemon625', 'ahmedrajaie11', 'xilvita', 'omarfathym', 'dallo407', 'kareem115', None, 'sukreth']"
38,86,12,13,10,"['wchill', 'alex1307', 'dragonrob02', 'gervasio89', 'almightybacoo', 'tkblair', 'michel_vargasv', 'rumbel', 'sabinevirg', 'elliotm']",1,['thomasd1'],3,"[None, 'kuhrbrya', 'elmkharram']",14,"['kuhrbrya', 'alex1307', 'tkblair', 'sabinevirg', 'elliotm', None, 'wchill', 'thomasd1', 'dragonrob02', 'gervasio89', 'almightybacoo', 'michel_vargasv', 'rumbel', 'elmkharram']"
39,58,12,11,10,"['haider66', 'bilal77', 'marvideshi', 'muneer', 'saim', 'wajiha', 'faisal_hallian', 'faizan63', 'sarwan', 'noman781']",1,['jgernand1'],1,[None],12,"['haider66', 'faisal_hallian', 'jgernand1', 'faizan63', None, 'sarwan', 'noman781', 'bilal77', 'marvideshi', 'saim', 'wajiha', 'muneer']"
40,63,12,114,8,"['smedber2', 'huanghewill', 'hjsong2', 'chang112', 'yin9', 'chivukula3', 'stewart9', 'sfoolgenius']",3,"['nikhrmn', 'gauthamv', 'eteran7']",106,"['yuqili1', 'predatorhunter51', 'adamwright08', 'ucapssong', 'wells8', 'nithinreddyc', 'sonicbro', 'landin', 'zyf7284563', 'shiou2', 'onay91', 'kazi1', 'cfranc20', 'hanbacca', 'yurilee2', 'lobert124', 'mikeudelhofen', 'adoboluver', 'cabraal', 'ryanschuster', 'kane11', 'jashari1', 'munjal2', 'jang34', 'dmgo17', 'tom69sawyer', 'zhuxh529', 'zson2', 'ahasija2', 'lmendez2', 'bredemer', 'sundstr2', 'b3nny312', 'khaostehnoob', 'scarlett', 'zhang155', 'bhuiya1', 'elachman', 'isankar21', 'yohanko322', 'wheele11', 'godofdeath', 'rooney5', 'fluxayh', 'maninpat', 'azure3t', 'kim325', 'profballack', 'dinger104', 'mohamed', 'roybell', 'ededens', 'vik579', 'sherlaby25', 'bilalgabula', 'ren6', 'alee13', 'shah19', 'wolf13', 'takagi1', 'ammario', 'bae7', 'dmoonxp5', 'hansanderson', 'cvendi2', 'kantner1', 'young10', 'garcias1', 'sebasti2', 'shook2', 'chitten1', 'kadakiy1', 'rturner', 'drtesla90', 'chanj45', 'choquet1', 'keramat1', 'scalise1', 'kylekalk', 'shah4u19', 'kevinlooby', 'oper321', 'murray18', 'tumblesoup', 'theyubo', 'kong7', 'crisci1', 'leijin3', 'danyangzhuo', 'seanyen1', 'rccarca', 'digitalmouse12', 'ysun12', 'lincoln5', None, 'cialdel1', 'sungbea89', 'wrubrec2', 'v3lox', 'sulas2', 'dtoome2', 'bdlftth2', 'rhein1', 'savysaville', 'lylo', 'ehgma0821']",117,"['yuqili1', 'huanghewill', 'predatorhunter51', 'adamwright08', 'ucapssong', 'hjsong2', 'wells8', 'nithinreddyc', 'sonicbro', 'landin', 'zyf7284563', 'shiou2', 'onay91', 'kazi1', 'cfranc20', 'hanbacca', 'yurilee2', 'lobert124', 'mikeudelhofen', 'adoboluver', 'cabraal', 'ryanschuster', 'kane11', 'jashari1', 'munjal2', 'jang34', 'dmgo17', 'tom69sawyer', 'smedber2', 'zhuxh529', 'zson2', 'ahasija2', 'lmendez2', 'bredemer', 'sundstr2', 'b3nny312', 'khaostehnoob', 'scarlett', 'zhang155', 'bhuiya1', 'elachman', 'isankar21', 'yohanko322', 'wheele11', 'godofdeath', 'rooney5', 'fluxayh', 'maninpat', 'azure3t', 'kim325', 'profballack', 'dinger104', 'mohamed', 'roybell', 'ededens', 'vik579', 'sherlaby25', 'bilalgabula', 'ren6', 'alee13', 'shah19', 'wolf13', 'takagi1', 'ammario', 'bae7', 'dmoonxp5', 'hansanderson', 'cvendi2', 'kantner1', 'young10', 'garcias1', 'sebasti2', 'shook2', 'chitten1', 'kadakiy1', 'rturner', 'chang112', 'drtesla90', 'chanj45', 'choquet1', 'yin9', 'chivukula3', 'keramat1', 'scalise1', 'sfoolgenius', 'kylekalk', 'shah4u19', 'kevinlooby', 'oper321', 'murray18', 'tumblesoup', 'theyubo', 'kong7', 'crisci1', 'leijin3', 'gauthamv', 'danyangzhuo', 'seanyen1', 'rccarca', 'digitalmouse12', 'ysun12', 'lincoln5', 'stewart9', None, 'cialdel1', 'nikhrmn', 'eteran7', 'wrubrec2', 'v3lox', 'sungbea89', 'sulas2', 'dtoome2', 'bdlftth2', 'rhein1', 'savysaville', 'lylo', 'ehgma0821']"
40,62,12,53,3,"['nikhrmn', 'hjsong2', 'stewart9']",8,"['eteran7', 'smedber2', 'huanghewill', 'gauthamv', 'chang112', 'yin9', 'chivukula3', 'sfoolgenius']",50,"['gravityplanx', 'caz1429', 'assem2', 'hansanderson', 'sonicbro', 'rkuryl2', 'onay91', 'cardena2', 'zhu52', 'ckhuang999', 'demint1', 'ericwei1', 'wang212', 'mikeudelhofen', 'ryanschuster', 'seanlee14', 'rohanamin', 'frisbie1', 'chorvat2', 'jpack91', 'chanj45', 'mtzcardfan08', 'dmgo17', 'kong7', 'sundstr2', 'drejmeisterdrej', 'philip', 'khaostehnoob', 'columbine', 'digitalmouse12', 'luyun198993', 'brinlee2', 'bettenh1', None, 'wang217', 'rose4', 'ragunat1', 'nullaa', 'mattycat9000', 'v3lox', 'djung31', 'mmcdow4', 'maninpat', 'huddles1', 'azure3t', 'ehgma0821', 'yening9063', 'fahmad6', 'tmalone3', 'vik579']",61,"['huanghewill', 'hjsong2', 'caz1429', 'sonicbro', 'onay91', 'cardena2', 'zhu52', 'ericwei1', 'wang212', 'mikeudelhofen', 'ryanschuster', 'rohanamin', 'chorvat2', 'mtzcardfan08', 'dmgo17', 'smedber2', 'sundstr2', 'drejmeisterdrej', 'philip', 'khaostehnoob', 'columbine', 'bettenh1', 'rose4', 'ragunat1', 'mattycat9000', 'maninpat', 'azure3t', 'yening9063', 'djung31', 'fahmad6', 'vik579', 'gravityplanx', 'assem2', 'hansanderson', 'rkuryl2', 'demint1', 'ckhuang999', 'seanlee14', 'frisbie1', 'chang112', 'jpack91', 'chanj45', 'yin9', 'chivukula3', 'sfoolgenius', 'kong7', 'gauthamv', 'digitalmouse12', 'luyun198993', 'brinlee2', 'stewart9', None, 'nikhrmn', 'eteran7', 'wang217', 'v3lox', 'nullaa', 'mmcdow4', 'huddles1', 'ehgma0821', 'tmalone3']"
40,64,12,28,1,['eteran7'],10,"['nikhrmn', 'smedber2', 'huanghewill', 'hjsong2', 'gauthamv', 'chang112', 'yin9', 'chivukula3', 'stewart9', 'sfoolgenius']",27,"['ucapssong', 'takagi1', 'icfmi90', 'qliu9', 'matamor1', 'cbarth2', 'shook2', 'josephxu', 'oper951', 'creepdeadly', 'dou1', 'stanzzang', 'lawrenceli', 'jifeixu', 'mwang53', 'bradzab', 'enyuluo', 'searuff', 'rschmid2', None, 'toan52', 'rasinsk1', 'mccann4', 'rooney5', 'jacobs25', 'yuan10', 'red6290']",38,"['huanghewill', 'ucapssong', 'takagi1', 'hjsong2', 'icfmi90', 'qliu9', 'matamor1', 'cbarth2', 'shook2', 'josephxu', 'oper951', 'creepdeadly', 'dou1', 'chang112', 'yin9', 'chivukula3', 'stanzzang', 'lawrenceli', 'sfoolgenius', 'smedber2', 'jifeixu', 'mwang53', 'gauthamv', 'bradzab', 'enyuluo', 'searuff', 'rschmid2', 'stewart9', None, 'nikhrmn', 'eteran7', 'toan52', 'rasinsk1', 'mccann4', 'rooney5', 'jacobs25', 'yuan10', 'red6290']"
42,22,11,11,1,['hooman4'],9,"['friesz', 'c_dds', 'hiroshi', 'stefanop', 'jbeuken', 'nanorom', 'connollym', 'safi1', 'chw128']",10,"['666dante666', 'synputh', 'mxnano1', 'scronin', 'karan129', 'rdhall', 'chenliang', 'nnning', None, 'alirezai']",20,"['stefanop', 'mxnano1', 'karan129', 'jbeuken', 'rdhall', 'chenliang', 'safi1', 'alirezai', None, 'hooman4', 'friesz', '666dante666', 'c_dds', 'synputh', 'nnning', 'hiroshi', 'scronin', 'nanorom', 'connollym', 'chw128']"
43,116,11,13,7,"['cgeorge1', 'twilightdream37', 'zrimsekab', 'bspoka', 'lysslyss11', 'draconian144', 'butler464']",3,"['kamranqadir', 'boonsong', 'ericz']",6,"['ta101', 'julitroi', 'mnobrien', 'leonardiszekely', 'noahnuta', None]",16,"['cgeorge1', 'twilightdream37', 'lysslyss11', 'boonsong', 'ericz', 'butler464', None, 'zrimsekab', 'bspoka', 'kamranqadir', 'julitroi', 'ta101', 'draconian144', 'mnobrien', 'leonardiszekely', 'noahnuta']"
44,100,11,13,10,"['jmpuentez', 'lalaniz5', 'kcleochicoz', 'gukanti26', 'javiercastillo', 'malaniz87', 'ebenitezz', 'rtlalolini', 'rygarza', 'samgh10']",0,[],3,"[None, 'hhuq', 'roy7770']",13,"['jmpuentez', 'hhuq', 'javiercastillo', 'ebenitezz', 'rtlalolini', None, 'lalaniz5', 'kcleochicoz', 'gukanti26', 'roy7770', 'malaniz87', 'rygarza', 'samgh10']"
44,108,11,13,10,"['jmpuentez', 'lalaniz5', 'kcleochicoz', 'gukanti26', 'javiercastillo', 'malaniz87', 'ebenitezz', 'rtlalolini', 'rygarza', 'samgh10']",0,[],3,"[None, 'hhuq', 'roy7770']",13,"['jmpuentez', 'hhuq', 'javiercastillo', 'ebenitezz', 'rtlalolini', None, 'lalaniz5', 'kcleochicoz', 'gukanti26', 'roy7770', 'malaniz87', 'rygarza', 'samgh10']"
44,109,11,11,9,"['lalaniz5', 'kcleochicoz', 'gukanti26', 'javiercastillo', 'malaniz87', 'ebenitezz', 'rtlalolini', 'rygarza', 'samgh10']",1,['jmpuentez'],2,"[None, 'hhuq']",12,"['jmpuentez', 'hhuq', 'javiercastillo', 'ebenitezz', 'rtlalolini', None, 'lalaniz5', 'kcleochicoz', 'gukanti26', 'malaniz87', 'rygarza', 'samgh10']"
45,114,11,19,7,"['dharna', 'schnei23', 'aharonhannan', 'eziga', 'jstobias', 'chuazm', 'abossert15']",3,"['hobbs5', 'posheal', 'chaselho']",12,"['plittlej', 'niveah', 'aktina907', 'blueberriemuffins21', 'tscapin', 'michel2', 'lyonm', 'beemer92', 'willi624', 'cwraight', None, 'cassidyjane']",22,"['schnei23', 'blueberriemuffins21', 'aktina907', 'chaselho', 'aharonhannan', 'lyonm', 'eziga', 'jstobias', 'chuazm', None, 'cassidyjane', 'tscapin', 'plittlej', 'niveah', 'dharna', 'hobbs5', 'posheal', 'michel2', 'beemer92', 'willi624', 'cwraight', 'abossert15']"
46,42,11,34,8,"['tefa_233', 'ce.castillo489', 's.jimenez774', 'd.de551', 'jreiss', 'jplagos', 'lumarin', 'carlosandres03cp']",2,"['lc.jimenez1861', 'anbo_']",26,"['malopez395', 'ap.cuerdo2685', 'david_espejo', 'dimigaro', 'dtavera2296', 'jp.combariza833', 'anferesa', 'pguzman1', 'ivon0502', 'nick13571', 'ia.bulla548', 'leonardogm91', 'amsuar92', 'jbucheli', None, 'jd.bernal2802', 'as.plazas2099', 'd.de5511', 'camil30', 'valenciajd', 'master0001', 'gaonaf', 'lc.gaitan2035', 'nesquiv', 'mc.guacheta177', 'diegoc906']",36,"['jreiss', 'anbo_', 'malopez395', 'ap.cuerdo2685', 'david_espejo', 'dimigaro', 'dtavera2296', 'jplagos', 'lumarin', 'jp.combariza833', 'carlosandres03cp', 'anferesa', 's.jimenez774', 'pguzman1', 'ivon0502', 'ce.castillo489', 'nick13571', 'lc.jimenez1861', 'ia.bulla548', 'leonardogm91', 'amsuar92', 'jbucheli', None, 'tefa_233', 'jd.bernal2802', 'd.de551', 'd.de5511', 'as.plazas2099', 'camil30', 'valenciajd', 'master0001', 'gaonaf', 'lc.gaitan2035', 'nesquiv', 'mc.guacheta177', 'diegoc906']"
47,83,11,24,2,"['tbharvey', 'slobodyan']",8,"['omardahy', 'pharaohboy', 'mohamed.badawy91', 'everyone0', 'mohamedelazamy', 'm.badr_44', 'khaled321', 'marieboyadjian']",22,"['tarring', 'kp', 'asoudegi', 'szisman', 'swk1230', 'galimdor', 'zzhang18', 'lizhy14', 'mdh266', 'willsix', 'lixiaojuventus', 'phsu', 'u9120009', 'melamala', 'amithrajv88', 'dbaniya', 'nst46', 'matibabenco', 'dsalta', None, 'art', 'ccorbet']",32,"['tarring', 'tbharvey', 'kp', 'asoudegi', 'szisman', 'swk1230', 'galimdor', 'khaled321', 'marieboyadjian', 'zzhang18', 'lizhy14', 'mdh266', 'willsix', 'lixiaojuventus', 'phsu', 'melamala', 'u9120009', 'amithrajv88', 'dbaniya', 'slobodyan', 'nst46', 'everyone0', 'mohamedelazamy', 'matibabenco', 'dsalta', None, 'omardahy', 'mohamed.badawy91', 'pharaohboy', 'art', 'm.badr_44', 'ccorbet']"
47,82,11,7,6,"['omardahy', 'mohamed.badawy91', 'everyone0', 'mohamedelazamy', 'm.badr_44', 'khaled321']",4,"['tbharvey', 'marieboyadjian', 'slobodyan', 'pharaohboy']",1,[None],11,"['omardahy', 'mohamed.badawy91', 'pharaohboy', 'slobodyan', 'tbharvey', 'everyone0', 'mohamedelazamy', 'm.badr_44', 'khaled321', 'marieboyadjian', None]"
48,40,11,9,7,"['shamus_mcnamara', 'j0beha01', 'jordancolburn', 'bennyr502', 'shrikasun', 'sean', 'tqn289']",3,"['gomes11', 'eabaum01', 'scress']",2,"[None, 'sowmya17']",12,"['shamus_mcnamara', 'sean', None, 'tqn289', 'eabaum01', 'sowmya17', 'gomes11', 'scress', 'jordancolburn', 'j0beha01', 'bennyr502', 'shrikasun']"
48,37,11,7,5,"['shamus_mcnamara', 'jordancolburn', 'j0beha01', 'shrikasun', 'tqn289']",5,"['eabaum01', 'gomes11', 'scress', 'bennyr502', 'sean']",2,"[None, 'sowmya17']",12,"['shamus_mcnamara', 'eabaum01', 'sowmya17', 'gomes11', 'scress', 'jordancolburn', 'j0beha01', 'bennyr502', 'shrikasun', 'sean', None, 'tqn289']"
48,39,11,7,6,"['shamus_mcnamara', 'jordancolburn', 'j0beha01', 'bennyr502', 'sean', 'tqn289']",4,"['gomes11', 'eabaum01', 'scress', 'shrikasun']",1,[None],11,"['shamus_mcnamara', 'eabaum01', 'gomes11', 'scress', 'jordancolburn', 'j0beha01', 'bennyr502', 'shrikasun', 'sean', None, 'tqn289']"
49,84,11,20,5,"['aabedin', 'lg90114', 'aydinci', 'yanuo', 'jind']",5,"['sunxu3325', 'osamak', 'km2kash', 'praram', 'xiaoyiw']",15,"['kundozerova1', 'mazimazi', 'monana', 'noroozi', 'safayet', 'amjadiq', 'pevere', 'amonge', 'mdcmunoz', 'kunli', 'kvar', 'fgeenen', 'mikekeee', 'arashsalemi1976', None]",25,"['kundozerova1', 'mazimazi', 'noroozi', 'safayet', 'aabedin', 'pevere', 'amonge', 'lg90114', 'osamak', 'sunxu3325', 'kunli', 'yanuo', 'mikekeee', None, 'praram', 'xiaoyiw', 'monana', 'amjadiq', 'aydinci', 'mdcmunoz', 'kvar', 'fgeenen', 'km2kash', 'arashsalemi1976', 'jind']"
49,155,11,18,1,['aabedin'],9,"['lg90114', 'sunxu3325', 'aydinci', 'osamak', 'yanuo', 'km2kash', 'jind', 'praram', 'xiaoyiw']",17,"['ccccccccat', 'amjadiq', 'pevere', 'amonge', 'hoda', 'sunil221', 'himanshuk', 'mdcmunoz', 'reyhaneh_soltan', 'sarahri', 'kunli', 'zjy63562688', 'parnimi', 'fgeenen', 'mikekeee', 'arashsalemi1976', None]",27,"['ccccccccat', 'aabedin', 'pevere', 'amonge', 'hoda', 'sunil221', 'lg90114', 'osamak', 'sunxu3325', 'reyhaneh_soltan', 'sarahri', 'kunli', 'zjy63562688', 'yanuo', 'mikekeee', None, 'praram', 'xiaoyiw', 'amjadiq', 'himanshuk', 'aydinci', 'mdcmunoz', 'parnimi', 'fgeenen', 'km2kash', 'arashsalemi1976', 'jind']"
49,85,11,11,5,"['sunxu3325', 'osamak', 'km2kash', 'jind', 'xiaoyiw']",5,"['aabedin', 'lg90114', 'aydinci', 'yanuo', 'praram']",6,"['kundozerova1', 'noroozi', 'amonge', 'kunli', 'mikekeee', None]",16,"['kundozerova1', 'noroozi', 'aabedin', 'amonge', 'lg90114', 'osamak', 'sunxu3325', 'kunli', 'yanuo', 'mikekeee', None, 'praram', 'xiaoyiw', 'aydinci', 'km2kash', 'jind']"
49,18,11,9,5,"['aabedin', 'lg90114', 'aydinci', 'yanuo', 'praram']",5,"['sunxu3325', 'osamak', 'km2kash', 'jind', 'xiaoyiw']",4,"['sarahri', None, 'noroozi', 'bellmanz']",14,"['noroozi', 'aabedin', 'lg90114', 'osamak', 'sunxu3325', 'bellmanz', 'sarahri', 'yanuo', None, 'praram', 'xiaoyiw', 'aydinci', 'km2kash', 'jind']"
49,13,11,8,5,"['aydinci', 'yanuo', 'km2kash', 'jind', 'praram']",5,"['aabedin', 'lg90114', 'sunxu3325', 'osamak', 'xiaoyiw']",3,"[None, 'noroozi', 'bellmanz']",13,"['noroozi', 'aabedin', 'lg90114', 'osamak', 'sunxu3325', 'aydinci', 'bellmanz', 'yanuo', 'km2kash', None, 'jind', 'praram', 'xiaoyiw']"
49,20,11,8,4,"['praram', 'aydinci', 'aabedin', 'yanuo']",6,"['lg90114', 'sunxu3325', 'osamak', 'km2kash', 'jind', 'xiaoyiw']",4,"['sarahri', 'parnimi', None, 'noroozi']",14,"['noroozi', 'aabedin', 'lg90114', 'osamak', 'sunxu3325', 'aydinci', 'sarahri', 'parnimi', 'yanuo', 'km2kash', None, 'jind', 'praram', 'xiaoyiw']"
49,14,11,7,4,"['km2kash', 'jind', 'sunxu3325', 'xiaoyiw']",6,"['aabedin', 'lg90114', 'aydinci', 'osamak', 'yanuo', 'praram']",3,"[None, 'noroozi', 'ibrahimkazi']",13,"['noroozi', 'ibrahimkazi', 'aabedin', 'lg90114', 'osamak', 'sunxu3325', 'aydinci', 'yanuo', 'km2kash', None, 'jind', 'praram', 'xiaoyiw']"
49,105,11,7,2,"['sunxu3325', 'osamak']",8,"['aabedin', 'lg90114', 'aydinci', 'yanuo', 'km2kash', 'jind', 'praram', 'xiaoyiw']",5,"['kundozerova1', 'amonge', 'sunil221', 'mikekeee', None]",15,"['kundozerova1', 'aabedin', 'amonge', 'sunil221', 'lg90114', 'osamak', 'sunxu3325', 'aydinci', 'yanuo', 'mikekeee', 'km2kash', None, 'jind', 'praram', 'xiaoyiw']"
49,19,11,6,2,"['km2kash', 'jind']",8,"['aabedin', 'lg90114', 'sunxu3325', 'aydinci', 'osamak', 'yanuo', 'praram', 'xiaoyiw']",4,"['sarahri', None, 'noroozi', 'sethusaveda']",14,"['noroozi', 'aabedin', 'lg90114', 'osamak', 'sunxu3325', 'aydinci', 'sarahri', 'sethusaveda', 'yanuo', 'km2kash', None, 'jind', 'praram', 'xiaoyiw']"
51,166,10,216,1,['nickpic90'],8,"['mbunda', 'jmbingham', 'db52401', 'bn60701', 'ct59001', 'rb20101', 'cm61901', 'danigriff18']",215,"['lnk645', 'yyuchen', 'nehapatel', 'achatrathi', 'eramos', 'nsp483', 'pranavspatel', 'kguo92', 'austinhunter21', 'rbattisfore', 'lms878', 'etran27', 'nym3t5fan', 'dis821', 'brandonstaunton', 'tywon35', 'jarnold93', 'aelliott', 'bcaldwell7', 'kerutila', 'ezuehlke322', 'dteplov', 'hvw198', 'krd450', 'johnplaxco', 'kcwikla', 'yuanxi', 'ckh9393', 'lpatel', 'clarahofeldt', 'cap292', 'cli', 'epae962', 'musicdude202', 'cto324', 'jbeck3r', 'lmw880', 'sakim1', 'tkp337', 'kpanchal2015', 'jnb385', 'jrjeevarajan', 'aca821', 'courtneyam324', 'mshi', 'slabrador', 'kas617', 'clayton', 'rparrillo', 'arjunbalakumar1', 'abronder', 'mattfasa', 'asanz', 'praju1', 'drsmith93', 'kkm195', 'cynthias361', 'rchowdhury', 'rscholes', 'yslee', 'pamurphy1', 'laurenk', 'wdd017', 'scasteel13', 'victorquan', 'robertbarnes', 'jcm112', 'cearap123', 'cchung', 'sabughnaim', 'mab729', 'kam470', 'julitroi', 'epa148', 'wbao2', 'rgradone', 'aarohi1993', 'ckc043', 'all701', 'aznchristian', 'dchang', 'sibarra', 'jdrapekin', 'mrpika284', 'schoo', 'seungyeonseo2015', 'avyfain', 'ksz858', 'kjohnson07', 'mph62293', 'sjk423', 'eschonher', 'ajishiotaro', 'hjk342', 'karishang', 'bohanxing', 'trekkiegus', 'rkd406', 'fungerer', 'cjn341', 'sab982', 'katherinekrupinski2015', 'van229', 'tnchang', 'joonzzz', 'sabinas', 'lakintilo', 'pioneer825', 'shreder2b', 'rld391', 'smd622', 'prasanth92', 'yunkatherine', 'jsprice23', 'psb481', 'skim049', 'lolitschen', 'pchenji', 'jpadgen', 'bschmitz', 'jefrandolig228', 'ka23te', 'dlf575', 'adonaldson', 'aorwasher', 'sep285', 'smortensen', 'ashaff993', 'mnathal', 'ta101', 'tkaltenecker', 'achalasani', 'mnobrien', 'jackmo1993', 'jrr998', 'hgr752', 'akcarlson420', 'ali.falouji', 'nwalia', 'clehman', 'prarthana.dalal', 'jennadiaz', 'drc716', 'msazo', 'cac559', 'sverma', 'devoraisseroff2015', 'vrc965', 'udesai93', 'vincericola44', 'youjinlee2015', 'al.johri', 'dls977', 'bugmenot', 'shishuyao', 'erinkirton', 'mattzhou', 'gracek', 'mgm54', 'cbh364', 'jmad593', 'sdz149', 'tmckinney', 'ethanritz2015', 'abchinen', 'achalasani11', 'fillangrady', 'blakekidd2015', 'nzaporski', 'palakpatel2015', 'bherrick', 'violaplayer75', 'dhuang333', 'kgreenberg360', 'anvarelas', 'nanohub88', 'mantzouj', 'bdt015', 'asipher', 'nitestars', 'sirseven', 'alorenzaucentre', 'cbinkley1', 'jcg786', 'jooi', 'kristil93', 'oopascual2', 'leonardiszekely', 'kgancedo', 'rat815', 'noahnuta', 'kikkaviki', 'henrikwesterkam', 'vincentkenny', 'bretth444', 'mdk016', 'tslater13', 'sotirioskarathanasis', 'shussaini', 'rjackson', 'okeowoolatunde', 'jli7', 'dianaleatha', 's2rach', 'fergusma', 'spencerjsaldana', 'mab497', 'slhatch', 'mkim1025', 'maraikar', 'jcy197', 'frandolig268', 'haddenklima', 'jtizzelfoshizzel', 'dmarks']",224,"['lnk645', 'yyuchen', 'nehapatel', 'bn60701', 'achatrathi', 'eramos', 'nsp483', 'pranavspatel', 'kguo92', 'austinhunter21', 'rbattisfore', 'lms878', 'etran27', 'nym3t5fan', 'dis821', 'brandonstaunton', 'tywon35', 'jarnold93', 'aelliott', 'bcaldwell7', 'kerutila', 'ezuehlke322', 'dteplov', 'hvw198', 'krd450', 'johnplaxco', 'kcwikla', 'yuanxi', 'ckh9393', 'lpatel', 'clarahofeldt', 'cap292', 'cli', 'epae962', 'musicdude202', 'cto324', 'jbeck3r', 'danigriff18', 'lmw880', 'ct59001', 'sakim1', 'tkp337', 'kpanchal2015', 'jnb385', 'jrjeevarajan', 'aca821', 'courtneyam324', 'mshi', 'slabrador', 'kas617', 'clayton', 'rparrillo', 'arjunbalakumar1', 'abronder', 'mattfasa', 'asanz', 'praju1', 'drsmith93', 'kkm195', 'cynthias361', 'rchowdhury', 'rscholes', 'yslee', 'pamurphy1', 'laurenk', 'wdd017', 'scasteel13', 'victorquan', 'robertbarnes', 'jcm112', 'cearap123', 'cchung', 'sabughnaim', 'db52401', 'mab729', 'kam470', 'julitroi', 'epa148', 'wbao2', 'rgradone', 'aarohi1993', 'ckc043', 'all701', 'aznchristian', 'dchang', 'sibarra', 'jdrapekin', 'mrpika284', 'schoo', 'seungyeonseo2015', 'avyfain', 'ksz858', 'kjohnson07', 'mph62293', 'sjk423', 'eschonher', 'ajishiotaro', 'hjk342', 'karishang', 'bohanxing', 'trekkiegus', 'rkd406', 'fungerer', 'cjn341', 'sab982', 'katherinekrupinski2015', 'van229', 'tnchang', 'joonzzz', 'sabinas', 'lakintilo', 'pioneer825', 'shreder2b', 'rld391', 'smd622', 'prasanth92', 'yunkatherine', 'jsprice23', 'psb481', 'skim049', 'lolitschen', 'pchenji', 'jpadgen', 'bschmitz', 'jefrandolig228', 'ka23te', 'dlf575', 'adonaldson', 'aorwasher', 'sep285', 'smortensen', 'ashaff993', 'mnathal', 'jmbingham', 'ta101', 'tkaltenecker', 'achalasani', 'mnobrien', 'jackmo1993', 'jrr998', 'hgr752', 'akcarlson420', 'ali.falouji', 'nwalia', 'clehman', 'prarthana.dalal', 'jennadiaz', 'drc716', 'msazo', 'cac559', 'sverma', 'devoraisseroff2015', 'vrc965', 'udesai93', 'cm61901', 'vincericola44', 'youjinlee2015', 'al.johri', 'dls977', 'bugmenot', 'shishuyao', 'erinkirton', 'mattzhou', 'gracek', 'mgm54', 'cbh364', 'jmad593', 'sdz149', 'tmckinney', 'ethanritz2015', 'abchinen', 'achalasani11', 'fillangrady', 'blakekidd2015', 'nzaporski', 'palakpatel2015', 'bherrick', 'violaplayer75', 'dhuang333', 'kgreenberg360', 'anvarelas', 'nanohub88', 'mantzouj', 'bdt015', 'asipher', 'nitestars', 'sirseven', 'rb20101', 'alorenzaucentre', 'cbinkley1', 'mbunda', 'jcg786', 'jooi', 'kristil93', 'oopascual2', 'leonardiszekely', 'kgancedo', 'rat815', 'noahnuta', 'kikkaviki', 'henrikwesterkam', 'vincentkenny', 'bretth444', 'mdk016', 'tslater13', 'sotirioskarathanasis', 'shussaini', 'rjackson', 'okeowoolatunde', 'jli7', 'dianaleatha', 's2rach', 'fergusma', 'spencerjsaldana', 'mab497', 'slhatch', 'nickpic90', 'mkim1025', 'maraikar', 'jcy197', 'frandolig268', 'haddenklima', 'jtizzelfoshizzel', 'dmarks']"
51,164,10,12,9,"['mbunda', 'jmbingham', 'db52401', 'bn60701', 'ct59001', 'nickpic90', 'rb20101', 'cm61901', 'danigriff18']",0,[],3,"['sabina', None, 'iman1211']",12,"['bn60701', 'rb20101', 'cm61901', None, 'danigriff18', 'mbunda', 'jmbingham', 'db52401', 'ct59001', 'nickpic90', 'iman1211', 'sabina']"
51,117,10,8,7,"['mbunda', 'db52401', 'bn60701', 'ct59001', 'rb20101', 'cm61901', 'danigriff18']",2,"['nickpic90', 'jmbingham']",1,[None],10,"['mbunda', 'jmbingham', 'db52401', 'bn60701', 'ct59001', 'nickpic90', None, 'rb20101', 'cm61901', 'danigriff18']"
51,165,10,8,7,"['mbunda', 'jmbingham', 'db52401', 'bn60701', 'ct59001', 'nickpic90', 'cm61901']",2,"['rb20101', 'danigriff18']",1,[None],10,"['mbunda', 'jmbingham', 'db52401', 'bn60701', 'ct59001', 'nickpic90', None, 'rb20101', 'cm61901', 'danigriff18']"
52,70,10,9,7,"['briancollins1988', 'kenrayunh', 'johnfmcclain6', 'cannonballpaul', 'adipy', 'ami3phys', 'jqk2']",2,"['susee', 'tojo']",2,"['jmtang', None]",11,"['briancollins1988', 'kenrayunh', 'susee', 'johnfmcclain6', 'cannonballpaul', 'tojo', 'jmtang', 'adipy', 'ami3phys', None, 'jqk2']"
52,71,10,9,7,"['briancollins1988', 'kenrayunh', 'johnfmcclain6', 'cannonballpaul', 'adipy', 'ami3phys', 'jqk2']",2,"['susee', 'tojo']",2,"['jmtang', None]",11,"['briancollins1988', 'kenrayunh', 'susee', 'johnfmcclain6', 'cannonballpaul', 'tojo', 'jmtang', 'adipy', 'ami3phys', None, 'jqk2']"
54,97,9,74,2,"['gruber1', 'xingli1']",6,"['roberth2011', 'ljbaker2', 'joanavp', 'ragnarok', 'jamani', 'awomac2']",72,"['predatorhunter51', 'wells8', 'sonicbro', 'landin', 'shiou2', 'hanbacca', 'pniemer2', 'adoboluver', 'josephxu', 'kane11', 'jashari1', 'jang34', 'munjal2', 'zhuxh529', 'dmgo17', 'mwang53', 'yinghe3', 'sundstr2', 'bredemer', 'philip', 'b3nny312', 'jasperli', 'isankar21', 'yohanko322', 'wheele11', 'mccann4', 'rooney5', 'fluxayh', 'azure3t', 'maninpat', 'kim325', 'profballack', 'pokemeng', 'roybell', 'ededens', 'bilalgabula', 'ren6', 'shah19', 'campbel3', 'takagi1', 'ammario', 'bae7', 'hansanderson', 'young10', 'kantner1', 'garcias1', 'zstone2', 'chitten1', 'rturner', 'willwang0737', 'drtesla90', 'chanj45', 'keramat1', 'theyubo', 'shah4u19', 'murray18', 'tumblesoup', 'awesly2', 'seanyen1', 'leijin3', 'danyangzhuo', 'searuff', 'mkandel', 'digitalmouse12', 'lincoln5', None, 'cialdel1', 'v3lox', 'vsalovnh', 'sulas2', 'lylo', 'jacobs25']",80,"['predatorhunter51', 'joanavp', 'wells8', 'sonicbro', 'landin', 'shiou2', 'hanbacca', 'gruber1', 'pniemer2', 'roberth2011', 'adoboluver', 'josephxu', 'kane11', 'jashari1', 'jang34', 'munjal2', 'zhuxh529', 'dmgo17', 'mwang53', 'yinghe3', 'sundstr2', 'bredemer', 'philip', 'b3nny312', 'jasperli', 'isankar21', 'yohanko322', 'wheele11', 'ljbaker2', 'mccann4', 'rooney5', 'fluxayh', 'xingli1', 'azure3t', 'maninpat', 'kim325', 'profballack', 'pokemeng', 'roybell', 'ededens', 'bilalgabula', 'ren6', 'shah19', 'campbel3', 'takagi1', 'ammario', 'bae7', 'hansanderson', 'young10', 'kantner1', 'garcias1', 'zstone2', 'chitten1', 'rturner', 'willwang0737', 'ragnarok', 'drtesla90', 'chanj45', 'awomac2', 'keramat1', 'theyubo', 'shah4u19', 'murray18', 'tumblesoup', 'awesly2', 'seanyen1', 'leijin3', 'danyangzhuo', 'searuff', 'mkandel', 'digitalmouse12', 'lincoln5', None, 'cialdel1', 'v3lox', 'vsalovnh', 'sulas2', 'lylo', 'jamani', 'jacobs25']"
54,99,9,28,1,['ljbaker2'],7,"['gruber1', 'roberth2011', 'joanavp', 'xingli1', 'ragnarok', 'jamani', 'awomac2']",27,"['gravityplanx', 'shah19', 'caz1429', 'assem2', 'hansanderson', 'onay91', 'demint1', 'ckhuang999', 'ericwei1', 'hong64', 'jpack91', 'jifeixu', 'kong7', 'drejmeisterdrej', 'rccarca', None, 'bettenh1', 'wang217', 'rose4', 'v3lox', 'mmcdow4', 'savysaville', 'ehgma0821', 'yening9063', 'yuan10', 'tmalone3', 'pixton1']",35,"['gravityplanx', 'shah19', 'joanavp', 'caz1429', 'assem2', 'hansanderson', 'onay91', 'demint1', 'ckhuang999', 'yuan10', 'ericwei1', 'gruber1', 'roberth2011', 'hong64', 'ragnarok', 'jpack91', 'awomac2', 'jifeixu', 'kong7', 'drejmeisterdrej', 'rccarca', None, 'bettenh1', 'wang217', 'rose4', 'v3lox', 'ljbaker2', 'mmcdow4', 'xingli1', 'savysaville', 'jamani', 'ehgma0821', 'yening9063', 'tmalone3', 'pixton1']"
55,181,9,12,1,['balu167'],7,"['livio84', 'charlie197', 'schroder', 'chuanweitsou', 'cat00351', 'm_ossimi', 'zahoor357']",11,"['spandana', 'supriya0307', 'afsana', 'yalavarthi', 'rajasantosh6', 'antenna2015', 'jenny8523', 'tushnikrock', 'deweave', 'rajesharisa', None]",19,"['charlie197', 'yalavarthi', 'chuanweitsou', 'cat00351', 'antenna2015', 'tushnikrock', 'deweave', 'supriya0307', 'rajesharisa', 'm_ossimi', None, 'zahoor357', 'livio84', 'spandana', 'schroder', 'balu167', 'afsana', 'rajasantosh6', 'jenny8523']"
55,180,9,7,1,['cat00351'],7,"['livio84', 'charlie197', 'schroder', 'balu167', 'chuanweitsou', 'm_ossimi', 'zahoor357']",6,"['dorun113', 'yinian', 'neoneon', 'chasebreeze', 'lily211152', None]",14,"['livio84', 'charlie197', 'dorun113', 'schroder', 'balu167', 'yinian', 'chuanweitsou', 'cat00351', 'neoneon', 'chasebreeze', 'lily211152', None, 'm_ossimi', 'zahoor357']"
56,15,9,19,7,"['gauravmisra', 'gvenkatesh', 'sreedevi', 'sakshambhatla', 'vibhutiawasthi', 'anandsatya', 'shishirsalvatore']",1,['ibrahimkazi'],12,"['gandhikunjan', 'benthomas', 'suchismitanaik15', 'mihir1190', 'suhassuraj', None, 'pavankumar', 'govindam', 'rockinraghavan', 'vakul319', 'kasturibhardwaj', 'neethubal']",20,"['gandhikunjan', 'ibrahimkazi', 'benthomas', 'sakshambhatla', 'suchismitanaik15', 'vibhutiawasthi', 'mihir1190', 'pavankumar', 'govindam', 'anandsatya', 'rockinraghavan', None, 'kasturibhardwaj', 'gauravmisra', 'gvenkatesh', 'sreedevi', 'suhassuraj', 'neethubal', 'shishirsalvatore', 'vakul319']"
56,14,9,7,1,['ibrahimkazi'],7,"['gauravmisra', 'gvenkatesh', 'sreedevi', 'sakshambhatla', 'vibhutiawasthi', 'anandsatya', 'shishirsalvatore']",6,"['noroozi', 'sunxu3325', 'km2kash', None, 'jind', 'xiaoyiw']",14,"['gauravmisra', 'jind', 'noroozi', 'ibrahimkazi', 'gvenkatesh', 'sreedevi', 'sakshambhatla', 'sunxu3325', 'vibhutiawasthi', 'km2kash', 'anandsatya', None, 'shishirsalvatore', 'xiaoyiw']"
57,38,9,12,1,['sdfzzyf'],7,"['ccoriasso', 'spetz', 'stchang', 'liuchong1989', 'richterivan', 'armary39', 'kalam']",11,"['andyterry', 'kokll', 'gaoy0022', 'bliu3', 'raina2', 'taobing', 'samsilver', 'ramakanetkar', 'jessie', None, 'lgoh3833']",19,"['andyterry', 'kokll', 'ccoriasso', 'bliu3', 'jessie', 'samsilver', 'stchang', 'ramakanetkar', None, 'armary39', 'kalam', 'raina2', 'gaoy0022', 'sdfzzyf', 'taobing', 'spetz', 'liuchong1989', 'richterivan', 'lgoh3833']"
59,151,9,18,5,"['alssss', 'fmachado1', 'lacruzaltamirano', 'nafuentes', 'rosalinda2']",3,"['andiewand', 'martingnauck', 'leibiger']",13,"['jsmoore', 'mrprana', 'echaidez', 'rachavez6', 'guizar11', 'dsusaita2', 'jskyle12', 'htshearman2013', 'dbujanda', 'eestrada11', 'jdrich', None, 'sgonzalez11']",21,"['jsmoore', 'leibiger', 'echaidez', 'dsusaita2', 'jskyle12', 'htshearman2013', 'andiewand', 'dbujanda', 'eestrada11', 'nafuentes', None, 'rosalinda2', 'alssss', 'mrprana', 'rachavez6', 'guizar11', 'fmachado1', 'martingnauck', 'lacruzaltamirano', 'jdrich', 'sgonzalez11']"
60,171,8,19,6,"['jsmoore', 'mrprana', 'guizar11', 'dsusaita2', 'dbujanda', 'eestrada11']",1,['etmaestas'],13,"['jcdelao', 'jafernandez4', 'bcarrera2', 'echaidez', 'rachavez6', 'nmaxwell', 'htshearman2013', 'jemadrid', 'jlujan4', 'jrkyle11', 'jdrich', None, 'sgonzalez11']",20,"['jsmoore', 'bcarrera2', 'echaidez', 'nmaxwell', 'dsusaita2', 'htshearman2013', 'dbujanda', 'eestrada11', 'etmaestas', 'jrkyle11', None, 'jcdelao', 'mrprana', 'rachavez6', 'guizar11', 'jemadrid', 'jlujan4', 'jafernandez4', 'jdrich', 'sgonzalez11']"
60,151,8,18,6,"['jsmoore', 'mrprana', 'guizar11', 'dsusaita2', 'dbujanda', 'eestrada11']",1,['etmaestas'],12,"['rosalinda2', 'alssss', 'echaidez', 'rachavez6', 'fmachado1', 'jskyle12', 'htshearman2013', 'lacruzaltamirano', 'nafuentes', 'jdrich', None, 'sgonzalez11']",19,"['jsmoore', 'echaidez', 'dsusaita2', 'jskyle12', 'htshearman2013', 'dbujanda', 'eestrada11', 'nafuentes', 'etmaestas', None, 'rosalinda2', 'alssss', 'mrprana', 'rachavez6', 'guizar11', 'fmachado1', 'lacruzaltamirano', 'jdrich', 'sgonzalez11']"
60,178,8,17,7,"['jsmoore', 'mrprana', 'guizar11', 'dsusaita2', 'dbujanda', 'eestrada11', 'etmaestas']",0,[],10,"['jcdelao', 'bcarrera2', 'stella', 'nmaxwell', 'jskyle12', 'jemadrid', 'jafernandez4', 'aacarrera', None, 'sgonzalez11']",17,"['jsmoore', 'bcarrera2', 'nmaxwell', 'dsusaita2', 'jskyle12', 'dbujanda', 'eestrada11', 'etmaestas', None, 'aacarrera', 'jcdelao', 'mrprana', 'stella', 'guizar11', 'jemadrid', 'jafernandez4', 'sgonzalez11']"
60,177,8,13,7,"['jsmoore', 'mrprana', 'guizar11', 'dsusaita2', 'dbujanda', 'eestrada11', 'etmaestas']",0,[],6,"['jcdelao', 'bcarrera2', 'stella', 'nmaxwell', 'jafernandez4', None]",13,"['jsmoore', 'bcarrera2', 'nmaxwell', 'dsusaita2', 'dbujanda', 'eestrada11', 'etmaestas', None, 'jcdelao', 'mrprana', 'stella', 'guizar11', 'jafernandez4']"
63,1,8,19,1,['stevensun'],6,"['metcalfa', 'acej1213', 'priyank89', 'nevitsmo', 'sunnychugh90', 'djwigen']",18,"['karthiky', 'wu337', 'instandwu', 'rvenkate', 'ashraf', 'yuling', 'mayurb', 'neopangaea84', 'jolenesingh', 'ahzeeper', 'chanw', 'shwet', 'omar0', 'nandrews', 'sebrahim', None, 'rmeka', 'li841']",25,"['stevensun', 'instandwu', 'mayurb', 'chanw', 'acej1213', 'nevitsmo', 'djwigen', 'sunnychugh90', 'sebrahim', None, 'karthiky', 'wu337', 'ashraf', 'yuling', 'metcalfa', 'neopangaea84', 'priyank89', 'jolenesingh', 'ahzeeper', 'shwet', 'nandrews', 'rvenkate', 'omar0', 'rmeka', 'li841']"
63,2,8,7,1,['acej1213'],6,"['stevensun', 'metcalfa', 'priyank89', 'nevitsmo', 'sunnychugh90', 'djwigen']",6,"['lee251', 'ahzeeper', 'anujsisodia85', 'eigurrola', None, 'reedra1']",13,"['stevensun', 'lee251', 'metcalfa', 'acej1213', 'priyank89', 'ahzeeper', 'eigurrola', 'nevitsmo', 'anujsisodia85', 'sunnychugh90', None, 'reedra1', 'djwigen']"
63,3,8,7,1,['priyank89'],6,"['stevensun', 'metcalfa', 'acej1213', 'nevitsmo', 'sunnychugh90', 'djwigen']",6,"['gautam92reddy', 'anandselvins', 'deepakchandra1991', 'neethubal', 'govindam', None]",13,"['gautam92reddy', 'stevensun', 'anandselvins', 'metcalfa', 'acej1213', 'priyank89', 'deepakchandra1991', 'neethubal', 'nevitsmo', 'govindam', 'sunnychugh90', None, 'djwigen']"
65,48,8,8,2,"['rlamond', 'dssawyer']",5,"['akpja', 'federicarigoni', 'mwalock', 'harshadbits', 'masoudb1']",6,"['aguan88', 'treede', 'strocchi', 'bhavenm', 'williamgibb', None]",13,"['aguan88', 'dssawyer', 'williamgibb', 'treede', 'mwalock', 'akpja', 'strocchi', 'federicarigoni', None, 'bhavenm', 'rlamond', 'harshadbits', 'masoudb1']"
66,205,8,15,7,"['wandrews', 'wnaville', 'chen549', 'ahtippma', 'heginator16', 'bhfredman', 'borkisze']",0,[],8,"['wood67', 'zbo', 'audupa', 'aalnasee', 'redwing', 'gyoways', 'mokomi89', None]",15,"['wandrews', 'wnaville', 'chen549', 'ahtippma', 'heginator16', 'bhfredman', 'redwing', 'aalnasee', 'borkisze', None, 'wood67', 'zbo', 'audupa', 'gyoways', 'mokomi89']"
66,132,8,14,7,"['wandrews', 'wnaville', 'chen549', 'ahtippma', 'heginator16', 'bhfredman', 'borkisze']",0,[],7,"['askachen369', 'wood67', 'j3holaday', 'zbo', 'audupa', 'gyoways', None]",14,"['wandrews', 'wnaville', 'chen549', 'ahtippma', 'heginator16', 'bhfredman', 'borkisze', None, 'askachen369', 'wood67', 'j3holaday', 'zbo', 'audupa', 'gyoways']"
66,204,8,14,7,"['wandrews', 'wnaville', 'chen549', 'ahtippma', 'heginator16', 'bhfredman', 'borkisze']",0,[],7,"['wood67', 'zbo', 'audupa', 'aalnasee', 'redwing', 'gyoways', None]",14,"['wandrews', 'wnaville', 'chen549', 'ahtippma', 'heginator16', 'bhfredman', 'redwing', 'aalnasee', 'borkisze', None, 'wood67', 'zbo', 'audupa', 'gyoways']"
66,129,8,13,6,"['wandrews', 'wnaville', 'chen549', 'ahtippma', 'bhfredman', 'borkisze']",1,['heginator16'],7,"['wood67', 'zbo', 'audupa', 'redwing', 'gyoways', 'mokomi89', None]",14,"['wandrews', 'wnaville', 'chen549', 'ahtippma', 'heginator16', 'bhfredman', 'redwing', 'borkisze', None, 'wood67', 'zbo', 'audupa', 'gyoways', 'mokomi89']"
66,130,8,13,7,"['wandrews', 'wnaville', 'chen549', 'ahtippma', 'heginator16', 'bhfredman', 'borkisze']",0,[],6,"['wood67', 'zbo', 'redwing', 'gyoways', 'helloyc', None]",13,"['wandrews', 'wnaville', 'chen549', 'ahtippma', 'heginator16', 'bhfredman', 'redwing', 'borkisze', 'helloyc', None, 'wood67', 'zbo', 'gyoways']"
66,131,8,13,6,"['wandrews', 'wnaville', 'chen549', 'ahtippma', 'heginator16', 'borkisze']",1,['bhfredman'],7,"['wood67', 'j3holaday', 'zbo', 'audupa', 'gyoways', 'mokomi89', None]",14,"['wandrews', 'wnaville', 'chen549', 'ahtippma', 'heginator16', 'bhfredman', 'borkisze', None, 'wood67', 'j3holaday', 'zbo', 'audupa', 'gyoways', 'mokomi89']"
66,126,8,12,7,"['wandrews', 'wnaville', 'chen549', 'ahtippma', 'heginator16', 'bhfredman', 'borkisze']",0,[],5,"['zbo', 'audupa', 'gyoways', 'mokomi89', None]",12,"['wandrews', 'wnaville', 'chen549', 'ahtippma', 'heginator16', 'bhfredman', 'borkisze', None, 'zbo', 'audupa', 'gyoways', 'mokomi89']"
66,134,8,12,7,"['wandrews', 'wnaville', 'chen549', 'ahtippma', 'heginator16', 'bhfredman', 'borkisze']",0,[],5,"['wood67', 'zbo', 'audupa', 'mokomi89', None]",12,"['wandrews', 'wnaville', 'chen549', 'ahtippma', 'heginator16', 'bhfredman', 'borkisze', None, 'wood67', 'zbo', 'audupa', 'mokomi89']"
66,202,8,10,6,"['wandrews', 'chen549', 'ahtippma', 'heginator16', 'bhfredman', 'borkisze']",1,['wnaville'],4,"['redwing', None, 'zbo', 'wood67']",11,"['wandrews', 'wnaville', 'chen549', 'ahtippma', 'heginator16', 'bhfredman', 'redwing', 'borkisze', None, 'wood67', 'zbo']"
66,207,8,10,5,"['wandrews', 'chen549', 'heginator16', 'bhfredman', 'borkisze']",2,"['wnaville', 'ahtippma']",5,"['wood67', 'zbo', 'audupa', 'redwing', None]",12,"['wandrews', 'wnaville', 'chen549', 'ahtippma', 'heginator16', 'bhfredman', 'redwing', 'borkisze', None, 'wood67', 'zbo', 'audupa']"
66,206,8,9,5,"['wandrews', 'chen549', 'ahtippma', 'heginator16', 'borkisze']",2,"['wnaville', 'bhfredman']",4,"['mokomi89', None, 'gyoways', 'audupa']",11,"['wandrews', 'wnaville', 'chen549', 'ahtippma', 'heginator16', 'bhfredman', 'borkisze', None, 'audupa', 'gyoways', 'mokomi89']"
69,2,7,7,1,['lee251'],5,"['zeggy79', 'zdiggins', 'mcquaidb', 'andre_l_barcellos', 'paulpurelar']",6,"['acej1213', 'ahzeeper', 'anujsisodia85', 'eigurrola', None, 'reedra1']",12,"['zeggy79', 'lee251', 'zdiggins', 'mcquaidb', 'acej1213', 'andre_l_barcellos', 'ahzeeper', 'paulpurelar', 'anujsisodia85', 'eigurrola', None, 'reedra1']"
72,26,7,6,1,['rory.lamond'],5,"['jslevy91', 'willpaul', 'b.sudharsan1989', 'paulpersonne', 'lauriey']",5,"['aguan88', 'veganista01', 'strocchi', 'bhavenm', None]",11,"['jslevy91', 'willpaul', 'aguan88', 'b.sudharsan1989', 'veganista01', 'strocchi', 'paulpersonne', 'lauriey', 'rory.lamond', 'bhavenm', None]"
73,23,7,9,3,"['smalakooti', 'comphyguy', 'djione']",3,"['stonemason89', 'eloapreza', 'cfancher']",6,"['jchristman', 'jbcutright', 'amoore', 'cawhittern', None, 'accancio']",12,"['smalakooti', 'jchristman', 'jbcutright', 'comphyguy', 'amoore', 'eloapreza', 'stonemason89', 'cawhittern', None, 'accancio', 'djione', 'cfancher']"
73,24,7,8,3,"['smalakooti', 'comphyguy', 'djione']",3,"['stonemason89', 'eloapreza', 'cfancher']",5,"['jchristman', 'jbcutright', 'amoore', 'cawhittern', None]",11,"['smalakooti', 'jchristman', 'jbcutright', 'comphyguy', 'amoore', 'eloapreza', 'stonemason89', 'cawhittern', None, 'djione', 'cfancher']"
77,172,6,29,1,['james301'],4,"['dphoward', 'unihamburg', 'jothi', 'bearsfan54']",28,"['clickiu', 'poteito', 'pkh5310', 'changjun0605', 'wnghks3201', 'shuni', 'sam2858', 'kmy8823', 'feedback50', 'ursus33', 'sykim1008', None, 'teias', 'stjns', 'mint91', 'spower', 'kdw2104', 'dlehdwls01', 'kms4105', 'bine77', 'nswhsh12', 'sc1010', 'solji0329', 'yesiamtoo', 'jsb0731', 'johou5325', 'yeoheeim', 'wannyk']",33,"['james301', 'clickiu', 'pkh5310', 'changjun0605', 'kmy8823', 'sykim1008', 'teias', 'stjns', 'kdw2104', 'bine77', 'jothi', 'solji0329', 'yesiamtoo', 'dphoward', 'jsb0731', 'johou5325', 'yeoheeim', 'poteito', 'wnghks3201', 'shuni', 'sam2858', 'feedback50', 'ursus33', None, 'unihamburg', 'mint91', 'bearsfan54', 'spower', 'dlehdwls01', 'kms4105', 'nswhsh12', 'sc1010', 'wannyk']"
78,203,6,35,4,"['shoshaz1', 'amjokisaari', 'gouskova', 'ylifan']",1,['bharath88'],31,"['terryduong84', 'kuhrbrya', 'mummywly', 'kkalac', 'suttonsc', 'kthorn01', 'jwsinger', 'superalloy16', 'chenz1987', 'orvanano', 'jarvisia', 'ljabbott', 'shengyenli', 'wblawrimore', 'pholvey', 'ededa', 'jguyer', 'okeles', 'sgsri', 'kokimura', 'redwing', 'saurabh_02', 'laagesen', 'alemottura', 'bieler', None, 'partha7372', 'schiavo1', 'lihongmei', 'goirijo', 'nirand']",36,"['terryduong84', 'kuhrbrya', 'mummywly', 'kkalac', 'suttonsc', 'ylifan', 'kthorn01', 'jwsinger', 'superalloy16', 'chenz1987', 'shoshaz1', 'gouskova', 'orvanano', 'jarvisia', 'ljabbott', 'amjokisaari', 'shengyenli', 'wblawrimore', 'pholvey', 'ededa', 'jguyer', 'okeles', 'sgsri', 'bharath88', 'kokimura', 'redwing', 'saurabh_02', 'laagesen', 'alemottura', 'bieler', None, 'partha7372', 'schiavo1', 'lihongmei', 'goirijo', 'nirand']"
79,118,6,177,5,"['xzong', 'hmannam', 'melissa', 'ssy387', 'rdb040']",0,[],172,"['lnk645', 'yyuchen', 'nehapatel', 'achatrathi', 'eramos', 'nsp483', 'pranavspatel', 'kguo92', 'austinhunter21', 'rbattisfore', 'lms878', 'etran27', 'dis821', 'brandonstaunton', 'tywon35', 'jarnold93', 'aelliott', 'bcaldwell7', 'ezuehlke322', 'kerutila', 'dteplov', 'hvw198', 'krd450', 'johnplaxco', 'yuanxi', 'ckh9393', 'clarahofeldt', 'cap292', 'cli', 'epae962', 'musicdude202', 'jbeck3r', 'lmw880', 'sakim1', 'kpanchal2015', 'jrjeevarajan', 'courtneyam324', 'mshi', 'slabrador', 'kas617', 'clayton', 'arjunbalakumar1', 'abronder', 'mattfasa', 'asanz', 'praju1', 'drsmith93', 'cynthias361', 'rchowdhury', 'rscholes', 'yslee', 'pamurphy1', 'wdd017', 'scasteel13', 'victorquan', 'jcm112', 'cearap123', 'cchung', 'sabughnaim', 'mab729', 'kam470', 'epa148', 'rgradone', 'aarohi1993', 'ckc043', 'all701', 'dchang', 'sibarra', 'jdrapekin', 'mrpika284', 'schoo', 'seungyeonseo2015', 'avyfain', 'ksz858', 'kjohnson07', 'mph62293', 'sjk423', 'eschonher', 'ajishiotaro', 'hjk342', 'karishang', 'bohanxing', 'rkd406', 'cjn341', 'sab982', 'katherinekrupinski2015', 'van229', 'tnchang', 'joonzzz', 'sabinas', 'lakintilo', 'pioneer825', 'shreder2b', 'smd622', 'prasanth92', 'yunkatherine', 'jsprice23', 'skim049', 'lolitschen', 'pchenji', 'jpadgen', 'bschmitz', 'jefrandolig228', 'ka23te', 'adonaldson', 'aorwasher', 'sep285', 'smortensen', 'mnathal', 'tkaltenecker', 'jrr998', 'akcarlson420', 'hgr752', 'nwalia', 'msazo', 'cac559', 'sverma', 'devoraisseroff2015', 'vrc965', 'udesai93', 'vincericola44', 'youjinlee2015', 'dls977', 'bugmenot', 'shishuyao', 'mattzhou', 'erinkirton', 'gracek', 'cbh364', 'jmad593', 'sdz149', 'tmckinney', 'ethanritz2015', 'blakekidd2015', 'bherrick', 'nzaporski', 'palakpatel2015', 'violaplayer75', 'dhuang333', 'kgreenberg360', 'mantzouj', 'nanohub88', 'bdt015', 'asipher', 'nitestars', 'sirseven', 'alorenzaucentre', 'jcg786', 'jooi', 'kristil93', 'oopascual2', 'rat815', 'kikkaviki', 'henrikwesterkam', 'bretth444', 'mdk016', 'tslater13', 'sotirioskarathanasis', 'shussaini', 'rjackson', 'okeowoolatunde', None, 'jli7', 's2rach', 'dianaleatha', 'spencerjsaldana', 'jcy197', 'mab497', 'maraikar', 'haddenklima', 'jtizzelfoshizzel', 'dmarks']",177,"['lnk645', 'yyuchen', 'nehapatel', 'achatrathi', 'eramos', 'nsp483', 'pranavspatel', 'kguo92', 'austinhunter21', 'rbattisfore', 'lms878', 'etran27', 'dis821', 'brandonstaunton', 'tywon35', 'jarnold93', 'aelliott', 'bcaldwell7', 'ezuehlke322', 'kerutila', 'melissa', 'ssy387', 'dteplov', 'hvw198', 'krd450', 'johnplaxco', 'yuanxi', 'ckh9393', 'clarahofeldt', 'cap292', 'cli', 'epae962', 'musicdude202', 'jbeck3r', 'lmw880', 'sakim1', 'kpanchal2015', 'jrjeevarajan', 'courtneyam324', 'mshi', 'slabrador', 'kas617', 'clayton', 'arjunbalakumar1', 'abronder', 'mattfasa', 'asanz', 'praju1', 'drsmith93', 'cynthias361', 'rchowdhury', 'rscholes', 'yslee', 'pamurphy1', 'wdd017', 'scasteel13', 'victorquan', 'jcm112', 'cearap123', 'cchung', 'sabughnaim', 'mab729', 'kam470', 'epa148', 'rgradone', 'aarohi1993', 'ckc043', 'all701', 'dchang', 'sibarra', 'jdrapekin', 'mrpika284', 'schoo', 'seungyeonseo2015', 'avyfain', 'ksz858', 'kjohnson07', 'mph62293', 'sjk423', 'eschonher', 'ajishiotaro', 'hjk342', 'karishang', 'bohanxing', 'rkd406', 'cjn341', 'sab982', 'katherinekrupinski2015', 'van229', 'tnchang', 'joonzzz', 'sabinas', 'lakintilo', 'pioneer825', 'shreder2b', 'smd622', 'rdb040', 'prasanth92', 'yunkatherine', 'jsprice23', 'skim049', 'lolitschen', 'pchenji', 'jpadgen', 'bschmitz', 'jefrandolig228', 'ka23te', 'adonaldson', 'aorwasher', 'sep285', 'smortensen', 'mnathal', 'tkaltenecker', 'jrr998', 'akcarlson420', 'hgr752', 'nwalia', 'msazo', 'cac559', 'sverma', 'devoraisseroff2015', 'vrc965', 'udesai93', 'vincericola44', 'youjinlee2015', 'dls977', 'bugmenot', 'shishuyao', 'mattzhou', 'erinkirton', 'gracek', 'cbh364', 'jmad593', 'sdz149', 'tmckinney', 'ethanritz2015', 'blakekidd2015', 'bherrick', 'nzaporski', 'palakpatel2015', 'violaplayer75', 'dhuang333', 'kgreenberg360', 'mantzouj', 'nanohub88', 'bdt015', 'asipher', 'nitestars', 'sirseven', 'alorenzaucentre', 'jcg786', 'jooi', 'kristil93', 'oopascual2', 'rat815', 'kikkaviki', 'henrikwesterkam', 'bretth444', 'mdk016', 'tslater13', 'sotirioskarathanasis', 'xzong', 'shussaini', 'rjackson', 'okeowoolatunde', None, 'jli7', 's2rach', 'dianaleatha', 'spencerjsaldana', 'jcy197', 'mab497', 'maraikar', 'hmannam', 'haddenklima', 'jtizzelfoshizzel', 'dmarks']"
79,46,6,161,5,"['xzong', 'hmannam', 'melissa', 'ssy387', 'rdb040']",0,[],156,"['yyuchen', 'nehapatel', 'achatrathi', 'eramos', 'nsp483', 'pranavspatel', 'kguo92', 'austinhunter21', 'rbattisfore', 'lms878', 'etran27', 'brandonstaunton', 'tywon35', 'jarnold93', 'aelliott', 'bcaldwell7', 'ezuehlke322', 'kerutila', 'dteplov', 'hvw198', 'krd450', 'yuanxi', 'ckh9393', 'lpatel', 'clarahofeldt', 'cap292', 'epae962', 'musicdude202', 'tkp337', 'kpanchal2015', 'aca821', 'courtneyam324', 'mshi', 'kas617', 'clayton', 'abronder', 'drsmith93', 'cynthias361', 'rchowdhury', 'rscholes', 'yslee', 'pamurphy1', 'wdd017', 'scasteel13', 'victorquan', 'cchung', 'mab729', 'kam470', 'julitroi', 'epa148', 'rgradone', 'aarohi1993', 'ckc043', 'all701', 'dchang', 'sibarra', 'jdrapekin', 'seungyeonseo2015', 'avyfain', 'ksz858', 'mph62293', 'sjk423', 'adarsh172', 'eschonher', 'ajishiotaro', 'hjk342', 'karishang', 'bohanxing', 'fungerer', 'rkd406', 'bcan14', 'sab982', 'cjn341', 'van229', 'tnchang', 'sabinas', 'lakintilo', 'pioneer825', 'rld391', 'smd622', 'prasanth92', 'yunkatherine', 'jsprice23', 'psb481', 'lolitschen', 'pchenji', 'jpadgen', 'bschmitz', 'jefrandolig228', 'ka23te', 'adonaldson', 'aorwasher', 'sep285', 'smortensen', 'ashaff993', 'mnathal', 'jackmo1993', 'jrr998', 'akcarlson420', 'hgr752', 'nwalia', 'clehman', 'jennadiaz', 'drc716', 'msazo', 'cac559', 'sverma', 'udesai93', 'vincericola44', 'bugmenot', 'mattzhou', 'cbh364', 'sdz149', 'tmckinney', 'ethanritz2015', 'fillangrady', 'blakekidd2015', 'bherrick', 'nzaporski', 'palakpatel2015', 'violaplayer75', 'kgreenberg360', 'mantzouj', 'nanohub88', 'bdt015', 'asipher', 'alexesanz', 'nitestars', 'sirseven', 'alorenzaucentre', 'cbinkley1', 'omalleys4', 'jcg786', 'jooi', 'oopascual2', 'rat815', 'gretskyw', 'kikkaviki', 'noahnuta', 'henrikwesterkam', 'vincentkenny', 'bretth444', 'tslater13', 'sotirioskarathanasis', 'shussaini', 'okeowoolatunde', None, 'jli7', 'dianaleatha', 'spencerjsaldana', 'jcy197', 'mab497', 'maraikar', 'frandolig268', 'jtizzelfoshizzel', 'dmarks']",161,"['yyuchen', 'nehapatel', 'achatrathi', 'eramos', 'nsp483', 'pranavspatel', 'kguo92', 'austinhunter21', 'rbattisfore', 'lms878', 'etran27', 'brandonstaunton', 'tywon35', 'jarnold93', 'aelliott', 'bcaldwell7', 'ezuehlke322', 'kerutila', 'melissa', 'ssy387', 'dteplov', 'hvw198', 'krd450', 'yuanxi', 'ckh9393', 'lpatel', 'clarahofeldt', 'cap292', 'epae962', 'musicdude202', 'tkp337', 'kpanchal2015', 'aca821', 'courtneyam324', 'mshi', 'kas617', 'clayton', 'abronder', 'drsmith93', 'cynthias361', 'rchowdhury', 'rscholes', 'yslee', 'pamurphy1', 'wdd017', 'scasteel13', 'victorquan', 'cchung', 'mab729', 'kam470', 'julitroi', 'epa148', 'rgradone', 'aarohi1993', 'ckc043', 'all701', 'dchang', 'sibarra', 'jdrapekin', 'seungyeonseo2015', 'avyfain', 'ksz858', 'mph62293', 'sjk423', 'adarsh172', 'eschonher', 'ajishiotaro', 'hjk342', 'karishang', 'bohanxing', 'fungerer', 'rkd406', 'bcan14', 'sab982', 'cjn341', 'van229', 'tnchang', 'sabinas', 'lakintilo', 'pioneer825', 'rld391', 'smd622', 'rdb040', 'prasanth92', 'yunkatherine', 'jsprice23', 'psb481', 'lolitschen', 'pchenji', 'jpadgen', 'bschmitz', 'jefrandolig228', 'ka23te', 'adonaldson', 'aorwasher', 'sep285', 'smortensen', 'ashaff993', 'mnathal', 'jackmo1993', 'jrr998', 'akcarlson420', 'hgr752', 'nwalia', 'clehman', 'jennadiaz', 'drc716', 'msazo', 'cac559', 'sverma', 'udesai93', 'vincericola44', 'bugmenot', 'mattzhou', 'cbh364', 'sdz149', 'tmckinney', 'ethanritz2015', 'fillangrady', 'blakekidd2015', 'bherrick', 'nzaporski', 'palakpatel2015', 'violaplayer75', 'kgreenberg360', 'mantzouj', 'nanohub88', 'bdt015', 'asipher', 'alexesanz', 'nitestars', 'sirseven', 'alorenzaucentre', 'cbinkley1', 'omalleys4', 'jcg786', 'jooi', 'oopascual2', 'rat815', 'gretskyw', 'kikkaviki', 'noahnuta', 'henrikwesterkam', 'vincentkenny', 'bretth444', 'tslater13', 'sotirioskarathanasis', 'xzong', 'shussaini', 'okeowoolatunde', None, 'jli7', 'dianaleatha', 'spencerjsaldana', 'jcy197', 'mab497', 'maraikar', 'frandolig268', 'hmannam', 'jtizzelfoshizzel', 'dmarks']"
80,1,6,19,4,"['ahzeeper', 'rvenkate', 'omar0', 'jolenesingh']",1,['youngj'],15,"['stevensun', 'karthiky', 'wu337', 'instandwu', 'ashraf', 'yuling', 'mayurb', 'neopangaea84', 'chanw', 'shwet', 'nandrews', 'sebrahim', None, 'rmeka', 'li841']",20,"['stevensun', 'instandwu', 'mayurb', 'chanw', 'sebrahim', None, 'karthiky', 'wu337', 'ashraf', 'yuling', 'jolenesingh', 'ahzeeper', 'neopangaea84', 'shwet', 'youngj', 'nandrews', 'rvenkate', 'omar0', 'rmeka', 'li841']"
80,153,6,12,4,"['ahzeeper', 'rvenkate', 'omar0', 'jolenesingh']",1,['youngj'],8,"['instandwu', 'schcats', 'mazad', 'neopangaea84', 'pdak', 'sebrahim', None, 'li841']",13,"['instandwu', 'mazad', 'sebrahim', None, 'schcats', 'jolenesingh', 'ahzeeper', 'neopangaea84', 'pdak', 'youngj', 'rvenkate', 'omar0', 'li841']"
80,67,6,10,3,"['ahzeeper', 'rvenkate', 'omar0']",2,"['youngj', 'jolenesingh']",7,"['instandwu', 'mayurb', 'chanw', 'pdak', 'nandrews', 'sebrahim', None]",12,"['instandwu', 'mayurb', 'jolenesingh', 'ahzeeper', 'chanw', 'sebrahim', 'pdak', None, 'youngj', 'nandrews', 'rvenkate', 'omar0']"
80,2,6,7,1,['ahzeeper'],4,"['youngj', 'rvenkate', 'omar0', 'jolenesingh']",6,"['lee251', 'acej1213', 'anujsisodia85', 'eigurrola', None, 'reedra1']",11,"['lee251', 'jolenesingh', 'ahzeeper', 'acej1213', None, 'eigurrola', 'youngj', 'anujsisodia85', 'rvenkate', 'omar0', 'reedra1']"
80,4,6,7,1,['rvenkate'],4,"['ahzeeper', 'youngj', 'omar0', 'jolenesingh']",6,"['instandwu', 'jackwilliams', 'neopangaea84', 'chanw', 'sebrahim', None]",11,"['instandwu', 'jackwilliams', 'jolenesingh', 'ahzeeper', 'chanw', 'neopangaea84', 'sebrahim', None, 'youngj', 'rvenkate', 'omar0']"
81,60,6,21,5,"['haroldau87', 'chunteh', 'leonsokrates', 'swchang', 'ccchou']",0,[],16,"['yixing', 'tgiesa', 'sinam', 'seagraves', 'abishekk', 'yaningli', 'ju21743', 'wpolache', 'muhannad', 'denvid', 'adeirieh', 'annat', None, 'tamarabi', 'dbrommer', 'tcoles']",21,"['leonsokrates', 'sinam', 'seagraves', 'yaningli', 'wpolache', 'denvid', 'adeirieh', 'ccchou', None, 'tcoles', 'yixing', 'haroldau87', 'tgiesa', 'chunteh', 'abishekk', 'ju21743', 'swchang', 'muhannad', 'annat', 'tamarabi', 'dbrommer']"
81,188,6,20,5,"['haroldau87', 'chunteh', 'leonsokrates', 'swchang', 'ccchou']",0,[],15,"['yixing', 'tgiesa', 'elifini', 'seagraves', 'abishekk', 'yaningli', 'ju21743', 'powell.385', 'msolar', 'akn', 'denvid', 'adeirieh', None, 'annat', 'dbrommer']",20,"['leonsokrates', 'elifini', 'seagraves', 'yaningli', 'powell.385', 'msolar', 'denvid', 'adeirieh', 'ccchou', None, 'yixing', 'haroldau87', 'tgiesa', 'chunteh', 'abishekk', 'ju21743', 'swchang', 'akn', 'annat', 'dbrommer']"
81,191,6,20,5,"['haroldau87', 'chunteh', 'leonsokrates', 'swchang', 'ccchou']",0,[],15,"['yixing', 'dmpowell', 'jaisree', 'haroldau', 'sinam', 'seagraves', 'abishekk', 'shchlin', 'msolar', 'akn', 'adeirieh', None, 'annat', 'dbrommer', 'tcoles']",20,"['leonsokrates', 'sinam', 'seagraves', 'shchlin', 'msolar', 'adeirieh', 'ccchou', None, 'tcoles', 'yixing', 'haroldau87', 'dmpowell', 'chunteh', 'jaisree', 'abishekk', 'swchang', 'akn', 'haroldau', 'annat', 'dbrommer']"
81,192,6,20,5,"['haroldau87', 'chunteh', 'leonsokrates', 'swchang', 'ccchou']",0,[],15,"['yixing', 'tgiesa', 'elifini', 'seagraves', 'abishekk', 'yaningli', 'ju21743', 'powell.385', 'msolar', 'akn', 'denvid', 'adeirieh', None, 'annat', 'dbrommer']",20,"['leonsokrates', 'elifini', 'seagraves', 'yaningli', 'powell.385', 'msolar', 'denvid', 'adeirieh', 'ccchou', None, 'yixing', 'haroldau87', 'tgiesa', 'chunteh', 'abishekk', 'ju21743', 'swchang', 'akn', 'annat', 'dbrommer']"
81,61,6,16,5,"['haroldau87', 'chunteh', 'leonsokrates', 'swchang', 'ccchou']",0,[],11,"['ggronau', 'yixing', 'sinam', 'ju21743', 'msolar', 'wpolache', 'shchlin', 'akn', 'adeirieh', None, 'tcoles']",16,"['ggronau', 'leonsokrates', 'sinam', 'msolar', 'wpolache', 'shchlin', 'adeirieh', 'ccchou', None, 'tcoles', 'yixing', 'haroldau87', 'chunteh', 'ju21743', 'swchang', 'akn']"
81,50,6,14,3,"['chunteh', 'leonsokrates', 'haroldau87']",2,"['ccchou', 'swchang']",11,"['ggronau', 'yixing', 'tgiesa', 'jaisree', 'dmpowell', 'msolar', 'akn', 'adeirieh', None, 'annat', 'dbrommer']",16,"['ggronau', 'leonsokrates', 'msolar', 'adeirieh', 'ccchou', None, 'yixing', 'haroldau87', 'dmpowell', 'chunteh', 'jaisree', 'tgiesa', 'swchang', 'akn', 'annat', 'dbrommer']"
81,189,6,12,3,"['swchang', 'leonsokrates', 'haroldau87']",2,"['chunteh', 'ccchou']",9,"['tgiesa', 'jaisree', 'sinam', 'seagraves', 'abishekk', 'msolar', None, 'annat', 'dbrommer']",14,"['leonsokrates', 'sinam', 'seagraves', 'msolar', 'ccchou', None, 'haroldau87', 'tgiesa', 'chunteh', 'jaisree', 'abishekk', 'swchang', 'annat', 'dbrommer']"
81,199,6,12,3,"['chunteh', 'leonsokrates', 'haroldau87']",2,"['ccchou', 'swchang']",9,"['yixing', 'tgiesa', 'seagraves', 'msolar', 'akn', 'adeirieh', None, 'annat', 'dbrommer']",14,"['leonsokrates', 'seagraves', 'msolar', 'adeirieh', 'ccchou', None, 'yixing', 'haroldau87', 'tgiesa', 'chunteh', 'swchang', 'akn', 'annat', 'dbrommer']"
81,201,6,12,3,"['ccchou', 'leonsokrates', 'haroldau87']",2,"['chunteh', 'swchang']",9,"['tgiesa', 'jaisree', 'seagraves', 'abishekk', 'msolar', 'akn', 'adeirieh', None, 'dbrommer']",14,"['leonsokrates', 'seagraves', 'msolar', 'adeirieh', 'ccchou', None, 'haroldau87', 'tgiesa', 'chunteh', 'jaisree', 'abishekk', 'swchang', 'akn', 'dbrommer']"
81,190,6,11,3,"['chunteh', 'leonsokrates', 'haroldau87']",2,"['ccchou', 'swchang']",8,"['yixing', 'tgiesa', 'jaisree', 'msolar', 'akn', 'adeirieh', None, 'annat']",13,"['leonsokrates', 'msolar', 'adeirieh', 'ccchou', None, 'yixing', 'haroldau87', 'tgiesa', 'chunteh', 'jaisree', 'swchang', 'akn', 'annat']"
81,193,6,10,3,"['chunteh', 'ccchou', 'leonsokrates']",2,"['swchang', 'haroldau87']",7,"['yixing', 'seagraves', 'shchlin', 'adeirieh', None, 'annat', 'dbrommer']",12,"['yixing', 'haroldau87', 'chunteh', 'leonsokrates', 'seagraves', 'shchlin', 'swchang', 'adeirieh', 'ccchou', None, 'annat', 'dbrommer']"
81,51,6,8,2,"['leonsokrates', 'haroldau87']",3,"['chunteh', 'ccchou', 'swchang']",6,"['ggronau', 'jaisree', 'seagraves', 'adeirieh', None, 'haroldau']",11,"['ggronau', 'haroldau87', 'chunteh', 'jaisree', 'leonsokrates', 'seagraves', None, 'swchang', 'adeirieh', 'ccchou', 'haroldau']"
81,200,6,6,2,"['leonsokrates', 'haroldau87']",3,"['chunteh', 'ccchou', 'swchang']",4,"[None, 'msolar', 'seagraves', 'tgiesa']",9,"['haroldau87', 'tgiesa', 'chunteh', 'leonsokrates', 'seagraves', 'msolar', 'swchang', 'ccchou', None]"
82,150,6,14,1,['msifeddin'],4,"['kajetan', 'bellona', 'mailhexu', 'yc97463240']",13,"['zihanxu89', 'sarthk_joshi', 'pradyumna', 'doleksy', 'manangada', 'sulemansami', 'liustone', 'guoda1988', 'fpolonh', 'eazhar', 'vasileska', 'dpradeep', None]",18,"['msifeddin', 'doleksy', 'guoda1988', 'eazhar', 'bellona', 'mailhexu', None, 'zihanxu89', 'sarthk_joshi', 'pradyumna', 'kajetan', 'manangada', 'sulemansami', 'liustone', 'fpolonh', 'vasileska', 'dpradeep', 'yc97463240']"
86,30,6,9,3,"['asma1', 'amberhabib', 'shahrukh']",2,"['farhanahmed', 'mumair']",6,"['ssushj', 'umeriqbal', 'danishmushtaq', 'azherkhan', 'shiraz', None]",11,"['asma1', 'ssushj', 'amberhabib', 'farhanahmed', 'umeriqbal', 'danishmushtaq', 'azherkhan', 'shiraz', None, 'mumair', 'shahrukh']"
87,17,6,20,4,"['gandhikunjan', 'mihir1190', 'vakul319', 'pavankumar']",1,['raj260291'],16,"['ajmal123', 'akhiloswal', 'mudit585', 'amanc058', 'rockinraghavan', 'nivedhan1990', 'preyas3359', 'abhimanyu123', 'karan0227', 'kesh221', 'suhassuraj', 'deepakchandra1991', 'salman_khurshid', 'sachinbhatt1989', None, 'adarshnb']",21,"['gandhikunjan', 'akhiloswal', 'mudit585', 'preyas3359', 'abhimanyu123', 'karan0227', 'mihir1190', 'kesh221', 'deepakchandra1991', 'pavankumar', 'sachinbhatt1989', 'rockinraghavan', None, 'ajmal123', 'amanc058', 'nivedhan1990', 'raj260291', 'suhassuraj', 'salman_khurshid', 'vakul319', 'adarshnb']"
87,15,6,19,4,"['gandhikunjan', 'mihir1190', 'vakul319', 'pavankumar']",1,['raj260291'],15,"['gauravmisra', 'benthomas', 'gvenkatesh', 'sreedevi', 'rockinraghavan', 'suchismitanaik15', 'sakshambhatla', 'vibhutiawasthi', 'suhassuraj', 'neethubal', 'govindam', 'anandsatya', None, 'shishirsalvatore', 'kasturibhardwaj']",20,"['gandhikunjan', 'benthomas', 'suchismitanaik15', 'sakshambhatla', 'vibhutiawasthi', 'mihir1190', 'pavankumar', 'govindam', 'anandsatya', 'rockinraghavan', None, 'kasturibhardwaj', 'gauravmisra', 'gvenkatesh', 'sreedevi', 'raj260291', 'suhassuraj', 'neethubal', 'shishirsalvatore', 'vakul319']"
