MClusterID,XClusterID,MClusterSize,XClusterSize,OverlapSize,OverlapMembers,MOnlySize,MOnlyMembers,XOnlySize,XOnlyMembers,CombinedSize,CombinedMembers
1,204,394,390,376,"['lmichelsen', 'sarahclark2014', 'wiscorower', 'jki416', 'kmdoherty', 'jwoll1692', 'chem10232269', 'elisees', 'zrs686', 'elinraun', 'sicelo', 'ignacioestrada', 'mweber', 'hct669', 'dannyginz', 'kpescadora', 'jhuber', 'pvonachen', 'kegley', 'aqh681', 'rossmac13', 'kjh321', 'bhamilton', 'willworden', 'mcm179', 'cel156', 'vincenthuang', 'njneil92', 'jbuser92', 'jpalarczyk', 'gusbus06', 'markbachrach', 'wngo', 'nebiu', 'jpkmufc11', 'ccf165', 'makanter', 'rose', 'sor427', 'kwerling', 'johnmari', 'jeg770', 'axz244', 'kdwoods', 'jennly', 'aoabraham', 'jdf478', 'jsd713', 'ddjrl', 'jkzhou99', 'mdj146', 'hhass', 'ltu197', 'ktdutchman', 'abz881', 'mz1030', 'adriennedunk', 'lee9jo', 'rch465', 'alanpan', 'stephmandir', 'mjiang112', 'deboisbn', 'jlj592', 'bli', 'jli', 'saxo', 'danielmcfarland', 'catherinealthaus', 'vjh199', 'jherzog', 'dmirtsching', 'jeliff7', 'esosdian', 'nicolechem', 'rjs374', 'abd892', 'mwiersema', 'csilvestre', 'matshu92', 'coreygoodwin', 'kpratt', 'lianggu91', 'greed0812', 'bcarlis', 'sydneyblack', 'sharris', 'eeg951', 'erica123', 'changbeeray', 'teresak', 'mkegermann', 'tmengesha', 'kelseythom', 'mrauf', 'jetzoh51', 'jyu3138', 'ewo304', 'msh986', 'jboxman7', 'payasarraf1', 'har580', 'shj210', 'mmmccc', 'jsh8', 'bmsiwek', 'samtam', 'nicroth', 'jamesbhigdon', 'lae247', 'tjw107', 'rosemilavitz', 'rbraga25', 'kogden', 'lrl839', 'wizmaster', 'stingraymart1', 'cjanczak', 'mhj872', 'crkramer', 'simontj', 'yuliya12', 'amandafrankel2014', 'giah', 'kswann', 'kapoornu', 'cberkowitz', 'sjl123', 'ecp899', 'ezaonegina', 'kgc375', 'kik101', 'lamar0404', 'ksd948', 'msw466', 'gmv672', 'cvickst14', 'sunjaejung', 'meganghub', 'tli132', 'bhuang92', 'kalishah', 'charleyp', 'jkilcommons', 'copperbeech1', 'nkj745', 'jtargos', 'mwagner987', 'karenoreilly', 'arandle', 'btredz49', 'nulab24c', 'suekim2014', 'sam413', 'kes690', 'kconnors', 'eterzer', 'jcao618', 'lillian2011', 'ntp742', 'gusdomel', 'dhw191', 'ggon03', 'ays976', 'benjaminrafshoon2014', 'kstclaire', 'vasanoah', 'mdw994', 'shawnkim332', 'varshinicherukupalli', 'shadiasadaqa', 'arps714', 'jhk931', 'cmw897', 'kkenney', 'suziepeter', 'tjconsidine', 'hbaker', 'shilliger', 'eweichmann', 'dpfeffer', 'vmitra92', 'hitopgun', 'kkiani', 'nuchem', 'phw454', 'bchanzit', 'lisamithun', 'chc727', 'ssa886', 'nanolab218', 'tdupper', 'knutecuk', 'runningfreak21', 'cfirman', 'dannywinans', 'yaejinpark2014', 'jkchem3', 'jpmccleary', 'chiggins', 'chancecim', 'sraiter', 'jschultz57', 'pthimsuwan5050', 'samhatfield', 'aspiegel', 'dmp556', 'chem102', 'xdi870', 'brockburdyl', 'jwchoi13', 'sonalid', 'jkoszela', 'eap01', 'mollykbaker', 'meghan1', 'regit627', 'ecrystal', 'pdu937', 'arilederman', 'alipka', 'chloe126', 'nhan3', 'ghm918', 'alannahenry', 'alamens', 'sdv465', 'trp982', 'jpj917', 'gatesmeg', 'vraghunath', 'knp750', 'moekou', 'sghelani', 'dwerickson', 'patwood78', 'juliaretzky', 'kegermann', 'bgerber', 'mborba', 'tkagadawala', 'martakulich', 'wchoi1025', 'brivard', 'ethanmcginnis2014', 'bkurcz', 'vfa774', 'danalec23', 'ncalta', 'meshun11', 'jasminejones', 'edsarah', 'amcgary', 'mss647', 'jguitart', 'srv123', 'nch964', 'mrossi14', 'rnorval', 'azeliko', 'sahartman4', 'spencermartens', 'markc', 'juliateresa1', 'hopeandseema', 'nebiutadele', 'vwang92', 'hcm888', 'sarahjeong2014', 'vcz359', 'noliver97', 'amee', 'kevingreenhalgh2014', 'vog399', 'soh207', 'benthemonkey', 'amlyniec', 'aramis16', 'bjr124', 'cms201', 'ajm882', 'vickieotto', 'lph854', 'twu', 'ebens', 'musiclover324', 'amandaziffer2014', 'tak825', 'mevans', 'jquinn825', 'graceminix', 'dac279', 'alijoe2014', 'jwu525', 'jmb489', 'mikejgleeson10', 'jsolis7', 'vpp990', 'edp592', 'sem227', 'fjk562', 'hkw198', 'hrendos', 'jgruszeczki', 'msistla46', 'shaina_nano', 'gkoshelev', 'tan190', 'avanisingh1', 'saracov726', 'bumpin8er', 'cosidari', 'annpowers', 'clairemelvin', 'tweiner92', 'dbali423', 'ras525', 'wenbinbin2010', 'awalker6', 'kgu988', 'lslesur', 'ses457', 'smc895', 'cfeldhaus', 'hgf596', 'atif24', 'akantzos', 'harlynn14siler', 'eek735', 'slhatch', 'madelineschwid', 'johnandalex', 'sah285', 'kennedyq', 'cskeehan', 'jds119', 'hairandholman', 'kendrahertz2014', 'lmsadowsky', 'blai', 'dsh926', 'kayliepmiller', 'zil338', 'knk953', 'pinararikan', 'rmullen2', 'cdarin', 'jsierks2', 'the13thmachete', 'yzh199', 'jeffandrose', 'nehanimm', 'amc480', 'mark123', 'zachkis', 'titosmith12', 'chriscappello', 'dlrhksgud4', 'jocandkev', 'sli674', 'abbyroopali', 'landislandis', 'alereyes', 'cwollaeger', 'danielthomas2014', 'ath800', 'wsc826', 'johnpark8', 'mhartoun', 'chemistry1', 'sahopki', 'rchalmers', 'amattias', 'robbie529', 'rgeiwitz', 'aarora']",18,"['scoobidy', 'zaraq', 'ipreston', 'keeleyjean86', 'jherrera', 'saraha', 'bpg109', 'vishyt123', 'cthayer709', 'chem1', 'chknfngers', 'samgbur', 'nchristo85', 'eofferman', 'rgruenhagen', 'mrauf13', 'kalindishah', 'markuline']",14,"['jesusflores2013', 'cnj373', 'bugmenot', 'gcutsail', 'dangerousdan', 'lmadison13', 'swa423', 'laurensoccer13', 'mshelby', 'lwint', 'mwrobes', 'whoff', 'iam007stina', 'ngruenke']",408,"['lmichelsen', 'sarahclark2014', 'wiscorower', 'jki416', 'kmdoherty', 'jwoll1692', 'chem10232269', 'elisees', 'zrs686', 'elinraun', 'sicelo', 'ignacioestrada', 'dangerousdan', 'cthayer709', 'mweber', 'hct669', 'dannyginz', 'kpescadora', 'jhuber', 'jherrera', 'pvonachen', 'kegley', 'aqh681', 'rossmac13', 'kjh321', 'bhamilton', 'willworden', 'mcm179', 'cel156', 'vincenthuang', 'njneil92', 'jbuser92', 'jpalarczyk', 'gusbus06', 'markbachrach', 'wngo', 'nebiu', 'jpkmufc11', 'makanter', 'ccf165', 'sor427', 'rose', 'kwerling', 'johnmari', 'jeg770', 'axz244', 'kalindishah', 'kdwoods', 'jennly', 'aoabraham', 'jdf478', 'jsd713', 'ddjrl', 'jkzhou99', 'mdj146', 'hhass', 'ltu197', 'ktdutchman', 'vishyt123', 'abz881', 'samgbur', 'mz1030', 'adriennedunk', 'lee9jo', 'rch465', 'alanpan', 'stephmandir', 'mjiang112', 'mshelby', 'deboisbn', 'bli', 'jlj592', 'jli', 'saxo', 'danielmcfarland', 'vjh199', 'dmirtsching', 'jherzog', 'catherinealthaus', 'jeliff7', 'esosdian', 'nicolechem', 'rjs374', 'abd892', 'mwiersema', 'csilvestre', 'matshu92', 'coreygoodwin', 'kpratt', 'lianggu91', 'greed0812', 'bcarlis', 'sydneyblack', 'sharris', 'eeg951', 'erica123', 'swa423', 'changbeeray', 'lwint', 'teresak', 'mkegermann', 'tmengesha', 'kelseythom', 'mrauf', 'jetzoh51', 'jyu3138', 'ewo304', 'eofferman', 'msh986', 'jboxman7', 'payasarraf1', 'har580', 'shj210', 'mmmccc', 'jsh8', 'ngruenke', 'bmsiwek', 'samtam', 'nicroth', 'jamesbhigdon', 'lae247', 'tjw107', 'lmadison13', 'rosemilavitz', 'rbraga25', 'kogden', 'lrl839', 'wizmaster', 'stingraymart1', 'cjanczak', 'mhj872', 'crkramer', 'saraha', 'simontj', 'yuliya12', 'amandafrankel2014', 'giah', 'kswann', 'kapoornu', 'zaraq', 'cberkowitz', 'sjl123', 'ecp899', 'ezaonegina', 'kgc375', 'kik101', 'markuline', 'lamar0404', 'ksd948', 'msw466', 'gmv672', 'cvickst14', 'meganghub', 'sunjaejung', 'tli132', 'bhuang92', 'kalishah', 'charleyp', 'copperbeech1', 'nkj745', 'jkilcommons', 'iam007stina', 'jtargos', 'mwagner987', 'karenoreilly', 'arandle', 'btredz49', 'nulab24c', 'suekim2014', 'nchristo85', 'sam413', 'kes690', 'kconnors', 'bugmenot', 'eterzer', 'jcao618', 'lillian2011', 'ntp742', 'gusdomel', 'dhw191', 'ggon03', 'chem1', 'ays976', 'benjaminrafshoon2014', 'kstclaire', 'vasanoah', 'shawnkim332', 'varshinicherukupalli', 'mdw994', 'shadiasadaqa', 'arps714', 'jhk931', 'cmw897', 'kkenney', 'suziepeter', 'tjconsidine', 'hbaker', 'shilliger', 'eweichmann', 'dpfeffer', 'vmitra92', 'hitopgun', 'kkiani', 'nuchem', 'phw454', 'bchanzit', 'lisamithun', 'ipreston', 'rgruenhagen', 'chc727', 'ssa886', 'nanolab218', 'tdupper', 'knutecuk', 'runningfreak21', 'cfirman', 'dannywinans', 'yaejinpark2014', 'scoobidy', 'jkchem3', 'jpmccleary', 'chiggins', 'chancecim', 'sraiter', 'jschultz57', 'pthimsuwan5050', 'samhatfield', 'aspiegel', 'dmp556', 'gcutsail', 'chem102', 'xdi870', 'brockburdyl', 'mrauf13', 'jwchoi13', 'sonalid', 'jkoszela', 'eap01', 'mollykbaker', 'meghan1', 'regit627', 'ecrystal', 'pdu937', 'arilederman', 'alipka', 'chloe126', 'nhan3', 'ghm918', 'alannahenry', 'alamens', 'sdv465', 'jpj917', 'trp982', 'gatesmeg', 'vraghunath', 'knp750', 'moekou', 'sghelani', 'dwerickson', 'patwood78', 'juliaretzky', 'kegermann', 'bgerber', 'mborba', 'martakulich', 'tkagadawala', 'wchoi1025', 'brivard', 'ethanmcginnis2014', 'bkurcz', 'vfa774', 'ncalta', 'danalec23', 'meshun11', 'amcgary', 'edsarah', 'jasminejones', 'mss647', 'jguitart', 'nch964', 'srv123', 'rnorval', 'azeliko', 'mrossi14', 'spencermartens', 'sahartman4', 'markc', 'juliateresa1', 'hopeandseema', 'nebiutadele', 'vwang92', 'hcm888', 'sarahjeong2014', 'vcz359', 'noliver97', 'amee', 'kevingreenhalgh2014', 'vog399', 'soh207', 'benthemonkey', 'amlyniec', 'aramis16', 'bpg109', 'bjr124', 'cms201', 'ajm882', 'vickieotto', 'lph854', 'twu', 'ebens', 'musiclover324', 'tak825', 'amandaziffer2014', 'mevans', 'jquinn825', 'chknfngers', 'graceminix', 'whoff', 'dac279', 'alijoe2014', 'jwu525', 'jmb489', 'keeleyjean86', 'mikejgleeson10', 'jsolis7', 'vpp990', 'sem227', 'edp592', 'fjk562', 'hkw198', 'hrendos', 'jgruszeczki', 'msistla46', 'laurensoccer13', 'shaina_nano', 'gkoshelev', 'tan190', 'avanisingh1', 'saracov726', 'bumpin8er', 'cosidari', 'annpowers', 'clairemelvin', 'dbali423', 'tweiner92', 'ras525', 'wenbinbin2010', 'awalker6', 'kgu988', 'lslesur', 'ses457', 'cfeldhaus', 'smc895', 'hgf596', 'atif24', 'akantzos', 'harlynn14siler', 'eek735', 'slhatch', 'madelineschwid', 'johnandalex', 'sah285', 'jesusflores2013', 'kennedyq', 'cskeehan', 'jds119', 'hairandholman', 'lmsadowsky', 'kendrahertz2014', 'blai', 'dsh926', 'kayliepmiller', 'zil338', 'knk953', 'rmullen2', 'cdarin', 'pinararikan', 'jsierks2', 'cnj373', 'the13thmachete', 'yzh199', 'jeffandrose', 'nehanimm', 'amc480', 'mark123', 'zachkis', 'titosmith12', 'mwrobes', 'chriscappello', 'dlrhksgud4', 'jocandkev', 'sli674', 'landislandis', 'abbyroopali', 'alereyes', 'cwollaeger', 'danielthomas2014', 'ath800', 'wsc826', 'johnpark8', 'mhartoun', 'chemistry1', 'sahopki', 'rchalmers', 'amattias', 'robbie529', 'rgeiwitz', 'aarora']"
1,48,394,288,273,"['vickieotto', 'sarahclark2014', 'eeg951', 'lph854', 'erica123', 'ebens', 'jki416', 'changbeeray', 'kmdoherty', 'musiclover324', 'phw454', 'teresak', 'amandaziffer2014', 'lisamithun', 'tak825', 'jwoll1692', 'chem10232269', 'bchanzit', 'ipreston', 'elisees', 'zrs686', 'sicelo', 'kelseythom', 'cthayer709', 'jquinn825', 'mweber', 'rgruenhagen', 'graceminix', 'hct669', 'jetzoh51', 'dac279', 'chc727', 'jyu3138', 'ssa886', 'ewo304', 'nanolab218', 'jwu525', 'msh986', 'jboxman7', 'jmb489', 'dannyginz', 'tdupper', 'jsolis7', 'runningfreak21', 'payasarraf1', 'pvonachen', 'vpp990', 'kegley', 'edp592', 'sem227', 'fjk562', 'hkw198', 'har580', 'dannywinans', 'hrendos', 'aqh681', 'scoobidy', 'rossmac13', 'shj210', 'jkchem3', 'mmmccc', 'msistla46', 'bhamilton', 'willworden', 'jsh8', 'mcm179', 'tan190', 'bmsiwek', 'saracov726', 'chancecim', 'bumpin8er', 'cel156', 'cosidari', 'clairemelvin', 'jschultz57', 'tweiner92', 'njneil92', 'dbali423', 'jbuser92', 'ras525', 'lae247', 'jpalarczyk', 'samhatfield', 'wenbinbin2010', 'gusbus06', 'markbachrach', 'aspiegel', 'dmp556', 'chem102', 'wngo', 'lslesur', 'ses457', 'rosemilavitz', 'brockburdyl', 'rbraga25', 'mrauf13', 'lrl839', 'sonalid', 'jkoszela', 'stingraymart1', 'eap01', 'nebiu', 'smc895', 'mollykbaker', 'meghan1', 'mhj872', 'ccf165', 'atif24', 'crkramer', 'akantzos', 'harlynn14siler', 'simontj', 'yuliya12', 'kwerling', 'amandafrankel2014', 'giah', 'johnmari', 'pdu937', 'madelineschwid', 'arilederman', 'alipka', 'jeg770', 'ghm918', 'johnandalex', 'axz244', 'sah285', 'kalindishah', 'alannahenry', 'sdv465', 'zaraq', 'kdwoods', 'trp982', 'jpj917', 'cskeehan', 'hairandholman', 'cberkowitz', 'gatesmeg', 'jennly', 'sjl123', 'ecp899', 'ezaonegina', 'kgc375', 'knp750', 'aoabraham', 'moekou', 'kendrahertz2014', 'lmsadowsky', 'blai', 'dsh926', 'dwerickson', 'jsd713', 'patwood78', 'ddjrl', 'juliaretzky', 'jkzhou99', 'zil338', 'mdj146', 'mborba', 'hhass', 'knk953', 'martakulich', 'lamar0404', 'ksd948', 'ltu197', 'wchoi1025', 'ethanmcginnis2014', 'ktdutchman', 'msw466', 'gmv672', 'pinararikan', 'vfa774', 'cvickst14', 'jsierks2', 'danalec23', 'sunjaejung', 'meshun11', 'meganghub', 'jasminejones', 'edsarah', 'amcgary', 'the13thmachete', 'yzh199', 'jeffandrose', 'samgbur', 'mz1030', 'mss647', 'bhuang92', 'charleyp', 'adriennedunk', 'nch964', 'srv123', 'jkilcommons', 'copperbeech1', 'mark123', 'mrossi14', 'rnorval', 'zachkis', 'titosmith12', 'sahartman4', 'spencermartens', 'dlrhksgud4', 'mwagner987', 'juliateresa1', 'rch465', 'btredz49', 'jocandkev', 'alanpan', 'hopeandseema', 'stephmandir', 'suekim2014', 'mjiang112', 'sam413', 'vwang92', 'jlj592', 'sli674', 'ajm882', 'jli', 'hcm888', 'danielmcfarland', 'eterzer', 'abbyroopali', 'catherinealthaus', 'jcao618', 'landislandis', 'lillian2011', 'alereyes', 'cwollaeger', 'danielthomas2014', 'ath800', 'wsc826', 'esosdian', 'ntp742', 'gusdomel', 'dhw191', 'noliver97', 'ggon03', 'nicolechem', 'amee', 'kevingreenhalgh2014', 'vog399', 'chem1', 'johnpark8', 'benjaminrafshoon2014', 'mhartoun', 'rjs374', 'chemistry1', 'abd892', 'benthemonkey', 'vasanoah', 'mdw994', 'shawnkim332', 'varshinicherukupalli', 'mwiersema', 'sahopki', 'csilvestre', 'aramis16', 'matshu92', 'arps714', 'jhk931', 'cmw897', 'amattias', 'bpg109', 'lianggu91', 'greed0812', 'suziepeter', 'bjr124', 'tjconsidine', 'robbie529', 'rgeiwitz', 'aarora', 'cms201', 'sydneyblack', 'shilliger']",121,"['sharris', 'eweichmann', 'dpfeffer', 'vmitra92', 'lmichelsen', 'hitopgun', 'kkiani', 'nuchem', 'twu', 'wiscorower', 'mkegermann', 'mevans', 'elinraun', 'ignacioestrada', 'tmengesha', 'chknfngers', 'mrauf', 'alijoe2014', 'eofferman', 'kpescadora', 'jhuber', 'keeleyjean86', 'jherrera', 'mikejgleeson10', 'knutecuk', 'cfirman', 'yaejinpark2014', 'jpmccleary', 'jgruszeczki', 'kjh321', 'shaina_nano', 'chiggins', 'gkoshelev', 'avanisingh1', 'samtam', 'nicroth', 'jamesbhigdon', 'sraiter', 'annpowers', 'vincenthuang', 'pthimsuwan5050', 'tjw107', 'awalker6', 'kgu988', 'xdi870', 'kogden', 'jwchoi13', 'wizmaster', 'cjanczak', 'jpkmufc11', 'cfeldhaus', 'hgf596', 'makanter', 'saraha', 'sor427', 'rose', 'regit627', 'eek735', 'ecrystal', 'slhatch', 'kswann', 'chloe126', 'nhan3', 'kapoornu', 'alamens', 'kennedyq', 'jds119', 'kik101', 'vraghunath', 'jdf478', 'sghelani', 'markuline', 'kegermann', 'kayliepmiller', 'bgerber', 'tkagadawala', 'brivard', 'bkurcz', 'rmullen2', 'cdarin', 'ncalta', 'tli132', 'vishyt123', 'abz881', 'nehanimm', 'kalishah', 'jguitart', 'nkj745', 'amc480', 'azeliko', 'chriscappello', 'jtargos', 'lee9jo', 'karenoreilly', 'markc', 'arandle', 'nulab24c', 'nebiutadele', 'nchristo85', 'deboisbn', 'bli', 'kes690', 'kconnors', 'saxo', 'sarahjeong2014', 'vjh199', 'dmirtsching', 'jherzog', 'vcz359', 'jeliff7', 'ays976', 'soh207', 'kstclaire', 'rchalmers', 'shadiasadaqa', 'amlyniec', 'coreygoodwin', 'kpratt', 'kkenney', 'bcarlis', 'hbaker']",15,"['dunner87', 'cnj373', 'philip', 'jpkmufc', 'bugmenot', 'knt528', 'dangerousdan', 'tejerina', 'lmadison13', 'atracey3', 'mkanter', 'jbuford1', 'laurensoccer13', 'poobag2', None]",409,"['lmichelsen', 'sarahclark2014', 'wiscorower', 'atracey3', 'jki416', 'kmdoherty', 'jwoll1692', 'chem10232269', 'elisees', 'zrs686', 'elinraun', 'sicelo', 'ignacioestrada', 'dangerousdan', 'cthayer709', 'mweber', 'hct669', 'dannyginz', 'kpescadora', 'jhuber', 'jherrera', 'pvonachen', 'kegley', 'aqh681', 'rossmac13', 'kjh321', 'bhamilton', 'willworden', 'mcm179', 'cel156', 'vincenthuang', 'njneil92', 'jbuser92', 'jpalarczyk', 'gusbus06', 'markbachrach', 'wngo', 'jbuford1', 'nebiu', 'dunner87', 'jpkmufc11', 'makanter', 'ccf165', 'sor427', 'rose', 'kwerling', 'johnmari', 'jeg770', 'axz244', 'kalindishah', 'kdwoods', 'jennly', 'aoabraham', 'jdf478', 'jsd713', 'ddjrl', 'jkzhou99', 'mdj146', 'hhass', 'ltu197', 'ktdutchman', 'vishyt123', 'abz881', 'samgbur', 'mz1030', 'adriennedunk', 'lee9jo', 'rch465', 'alanpan', 'stephmandir', 'mkanter', 'mjiang112', 'deboisbn', 'bli', 'jlj592', 'jli', 'saxo', 'danielmcfarland', 'vjh199', 'dmirtsching', 'jherzog', 'catherinealthaus', 'jeliff7', 'esosdian', 'nicolechem', 'rjs374', 'abd892', 'mwiersema', 'csilvestre', 'matshu92', 'coreygoodwin', 'kpratt', 'lianggu91', 'greed0812', 'bcarlis', 'sydneyblack', 'sharris', 'eeg951', 'erica123', 'changbeeray', 'teresak', 'mkegermann', 'tmengesha', 'kelseythom', 'mrauf', 'jetzoh51', 'jyu3138', 'ewo304', 'eofferman', 'msh986', 'jboxman7', 'payasarraf1', 'har580', 'shj210', 'mmmccc', 'jsh8', 'bmsiwek', 'samtam', 'nicroth', 'jamesbhigdon', 'lae247', 'tjw107', 'lmadison13', 'rosemilavitz', 'rbraga25', 'kogden', 'lrl839', 'wizmaster', 'stingraymart1', 'cjanczak', 'mhj872', 'crkramer', 'saraha', 'simontj', 'yuliya12', 'amandafrankel2014', 'giah', 'kswann', 'kapoornu', 'zaraq', 'cberkowitz', 'sjl123', 'ecp899', 'ezaonegina', 'kgc375', 'kik101', 'markuline', 'lamar0404', 'ksd948', 'msw466', 'gmv672', 'cvickst14', 'meganghub', 'sunjaejung', 'tli132', 'bhuang92', 'kalishah', 'charleyp', 'copperbeech1', 'nkj745', 'jkilcommons', 'jtargos', 'mwagner987', 'karenoreilly', 'arandle', 'btredz49', 'nulab24c', 'suekim2014', 'nchristo85', 'sam413', 'kes690', 'kconnors', 'bugmenot', 'eterzer', 'jcao618', 'lillian2011', 'ntp742', 'gusdomel', 'dhw191', 'ggon03', 'jpkmufc', 'knt528', 'chem1', 'ays976', 'benjaminrafshoon2014', 'kstclaire', 'vasanoah', 'shawnkim332', 'varshinicherukupalli', 'mdw994', 'shadiasadaqa', 'arps714', 'jhk931', 'cmw897', 'kkenney', 'suziepeter', 'tjconsidine', 'hbaker', 'shilliger', 'eweichmann', 'dpfeffer', 'vmitra92', 'hitopgun', 'kkiani', 'nuchem', 'phw454', 'bchanzit', 'lisamithun', 'ipreston', 'rgruenhagen', 'philip', 'chc727', 'ssa886', 'nanolab218', 'tdupper', 'knutecuk', 'runningfreak21', 'cfirman', 'dannywinans', 'yaejinpark2014', 'scoobidy', 'jkchem3', 'jpmccleary', 'chiggins', 'chancecim', 'sraiter', 'jschultz57', 'pthimsuwan5050', 'samhatfield', 'aspiegel', 'dmp556', 'chem102', 'xdi870', 'brockburdyl', 'mrauf13', 'jwchoi13', 'sonalid', 'jkoszela', 'eap01', 'mollykbaker', 'meghan1', 'regit627', 'ecrystal', 'pdu937', 'arilederman', 'alipka', 'chloe126', 'nhan3', 'ghm918', 'alannahenry', 'alamens', 'sdv465', 'jpj917', 'trp982', 'gatesmeg', 'vraghunath', 'knp750', 'moekou', 'sghelani', 'dwerickson', 'patwood78', 'juliaretzky', 'kegermann', 'bgerber', 'mborba', 'martakulich', 'tkagadawala', 'wchoi1025', 'brivard', 'ethanmcginnis2014', 'bkurcz', 'vfa774', 'ncalta', 'danalec23', 'meshun11', 'amcgary', 'edsarah', 'jasminejones', 'mss647', 'jguitart', 'nch964', 'srv123', 'rnorval', 'azeliko', 'mrossi14', 'spencermartens', 'sahartman4', 'markc', 'juliateresa1', 'hopeandseema', 'nebiutadele', 'vwang92', 'hcm888', 'sarahjeong2014', 'vcz359', 'noliver97', 'amee', 'kevingreenhalgh2014', 'vog399', 'soh207', 'benthemonkey', 'amlyniec', 'aramis16', 'bpg109', 'bjr124', 'cms201', 'ajm882', 'vickieotto', 'lph854', 'twu', 'ebens', 'musiclover324', 'tak825', 'amandaziffer2014', 'mevans', 'jquinn825', 'chknfngers', 'graceminix', 'dac279', 'alijoe2014', 'jwu525', 'jmb489', 'keeleyjean86', 'mikejgleeson10', 'jsolis7', 'vpp990', 'sem227', 'edp592', 'fjk562', 'hkw198', 'hrendos', 'jgruszeczki', 'msistla46', 'laurensoccer13', 'shaina_nano', 'gkoshelev', 'tan190', 'avanisingh1', 'saracov726', 'bumpin8er', 'cosidari', 'annpowers', 'clairemelvin', 'dbali423', 'tweiner92', 'ras525', 'wenbinbin2010', 'awalker6', 'kgu988', 'lslesur', 'ses457', None, 'cfeldhaus', 'smc895', 'hgf596', 'atif24', 'akantzos', 'harlynn14siler', 'eek735', 'slhatch', 'madelineschwid', 'johnandalex', 'sah285', 'kennedyq', 'cskeehan', 'jds119', 'hairandholman', 'lmsadowsky', 'kendrahertz2014', 'blai', 'dsh926', 'kayliepmiller', 'zil338', 'knk953', 'rmullen2', 'cdarin', 'pinararikan', 'jsierks2', 'cnj373', 'the13thmachete', 'yzh199', 'jeffandrose', 'nehanimm', 'amc480', 'mark123', 'zachkis', 'titosmith12', 'chriscappello', 'dlrhksgud4', 'jocandkev', 'tejerina', 'poobag2', 'sli674', 'landislandis', 'abbyroopali', 'alereyes', 'cwollaeger', 'danielthomas2014', 'ath800', 'wsc826', 'johnpark8', 'mhartoun', 'chemistry1', 'sahopki', 'rchalmers', 'amattias', 'robbie529', 'rgeiwitz', 'aarora']"
1,163,394,217,181,"['vmitra92', 'vickieotto', 'nuchem', 'eeg951', 'lph854', 'ebens', 'changbeeray', 'kmdoherty', 'musiclover324', 'phw454', 'teresak', 'amandaziffer2014', 'lisamithun', 'jwoll1692', 'chem10232269', 'ipreston', 'elisees', 'sicelo', 'cthayer709', 'jquinn825', 'mweber', 'rgruenhagen', 'hct669', 'chc727', 'ssa886', 'jwu525', 'jboxman7', 'jmb489', 'dannyginz', 'tdupper', 'runningfreak21', 'payasarraf1', 'pvonachen', 'edp592', 'fjk562', 'har580', 'dannywinans', 'yaejinpark2014', 'hrendos', 'aqh681', 'scoobidy', 'jkchem3', 'mmmccc', 'shilliger', 'msistla46', 'willworden', 'bmsiwek', 'saracov726', 'chancecim', 'cel156', 'sraiter', 'nicroth', 'cosidari', 'clairemelvin', 'dbali423', 'njneil92', 'jbuser92', 'lae247', 'samhatfield', 'markbachrach', 'dmp556', 'wngo', 'ses457', 'rbraga25', 'mrauf13', 'lrl839', 'stingraymart1', 'eap01', 'smc895', 'mollykbaker', 'meghan1', 'hgf596', 'ccf165', 'crkramer', 'rose', 'sor427', 'simontj', 'eek735', 'amandafrankel2014', 'slhatch', 'arilederman', 'jeg770', 'axz244', 'kapoornu', 'kalindishah', 'alannahenry', 'sdv465', 'hairandholman', 'gatesmeg', 'sjl123', 'kik101', 'knp750', 'moekou', 'jdf478', 'lmsadowsky', 'dsh926', 'dwerickson', 'juliaretzky', 'ddjrl', 'kayliepmiller', 'kegermann', 'jkzhou99', 'knk953', 'lamar0404', 'ksd948', 'martakulich', 'ltu197', 'wchoi1025', 'ethanmcginnis2014', 'msw466', 'gmv672', 'vfa774', 'jsierks2', 'sunjaejung', 'danalec23', 'edsarah', 'vishyt123', 'jeffandrose', 'samgbur', 'nehanimm', 'mz1030', 'mss647', 'bhuang92', 'abz881', 'jkilcommons', 'srv123', 'nkj745', 'mrossi14', 'azeliko', 'chriscappello', 'spencermartens', 'sahartman4', 'dlrhksgud4', 'markc', 'juliateresa1', 'rch465', 'btredz49', 'jocandkev', 'alanpan', 'nulab24c', 'hopeandseema', 'stephmandir', 'suekim2014', 'sam413', 'vwang92', 'sli674', 'saxo', 'danielmcfarland', 'jcao618', 'catherinealthaus', 'lillian2011', 'danielthomas2014', 'ath800', 'wsc826', 'ntp742', 'gusdomel', 'dhw191', 'noliver97', 'amee', 'kevingreenhalgh2014', 'chem1', 'mhartoun', 'benjaminrafshoon2014', 'shawnkim332', 'varshinicherukupalli', 'sahopki', 'mwiersema', 'csilvestre', 'arps714', 'matshu92', 'coreygoodwin', 'cmw897', 'amattias', 'robbie529', 'rgeiwitz', 'bcarlis', 'aarora', 'bjr124', 'cms201', 'sydneyblack', 'ajm882']",213,"['sharris', 'eweichmann', 'dpfeffer', 'lmichelsen', 'hitopgun', 'kkiani', 'sarahclark2014', 'twu', 'erica123', 'wiscorower', 'jki416', 'bchanzit', 'mkegermann', 'tak825', 'mevans', 'zrs686', 'elinraun', 'ignacioestrada', 'tmengesha', 'kelseythom', 'chknfngers', 'graceminix', 'mrauf', 'jetzoh51', 'dac279', 'jyu3138', 'ewo304', 'nanolab218', 'alijoe2014', 'eofferman', 'msh986', 'kpescadora', 'jhuber', 'keeleyjean86', 'jherrera', 'mikejgleeson10', 'jsolis7', 'knutecuk', 'vpp990', 'cfirman', 'kegley', 'sem227', 'hkw198', 'rossmac13', 'shj210', 'jpmccleary', 'jgruszeczki', 'kjh321', 'bhamilton', 'jsh8', 'shaina_nano', 'chiggins', 'mcm179', 'gkoshelev', 'tan190', 'avanisingh1', 'bumpin8er', 'samtam', 'jamesbhigdon', 'annpowers', 'vincenthuang', 'jschultz57', 'tweiner92', 'pthimsuwan5050', 'ras525', 'jpalarczyk', 'wenbinbin2010', 'tjw107', 'gusbus06', 'aspiegel', 'awalker6', 'chem102', 'kgu988', 'xdi870', 'lslesur', 'rosemilavitz', 'brockburdyl', 'kogden', 'jwchoi13', 'sonalid', 'wizmaster', 'jkoszela', 'nebiu', 'cjanczak', 'jpkmufc11', 'cfeldhaus', 'mhj872', 'makanter', 'saraha', 'atif24', 'regit627', 'akantzos', 'harlynn14siler', 'yuliya12', 'ecrystal', 'kwerling', 'giah', 'johnmari', 'pdu937', 'madelineschwid', 'kswann', 'alipka', 'chloe126', 'nhan3', 'ghm918', 'johnandalex', 'sah285', 'alamens', 'kennedyq', 'zaraq', 'kdwoods', 'jpj917', 'trp982', 'cberkowitz', 'cskeehan', 'jds119', 'jennly', 'ecp899', 'ezaonegina', 'kgc375', 'vraghunath', 'aoabraham', 'sghelani', 'markuline', 'kendrahertz2014', 'blai', 'jsd713', 'patwood78', 'zil338', 'bgerber', 'mdj146', 'mborba', 'hhass', 'tkagadawala', 'brivard', 'ktdutchman', 'bkurcz', 'rmullen2', 'cdarin', 'cvickst14', 'pinararikan', 'meganghub', 'ncalta', 'meshun11', 'the13thmachete', 'tli132', 'amcgary', 'jasminejones', 'yzh199', 'kalishah', 'charleyp', 'adriennedunk', 'copperbeech1', 'jguitart', 'nch964', 'amc480', 'mark123', 'rnorval', 'zachkis', 'titosmith12', 'jtargos', 'lee9jo', 'mwagner987', 'karenoreilly', 'arandle', 'nebiutadele', 'nchristo85', 'mjiang112', 'deboisbn', 'bli', 'jlj592', 'kes690', 'kconnors', 'jli', 'hcm888', 'eterzer', 'sarahjeong2014', 'vjh199', 'dmirtsching', 'jherzog', 'vcz359', 'landislandis', 'abbyroopali', 'jeliff7', 'alereyes', 'cwollaeger', 'esosdian', 'ggon03', 'nicolechem', 'vog399', 'ays976', 'johnpark8', 'soh207', 'rjs374', 'kstclaire', 'chemistry1', 'abd892', 'vasanoah', 'mdw994', 'benthemonkey', 'rchalmers', 'shadiasadaqa', 'amlyniec', 'aramis16', 'jhk931', 'kpratt', 'lianggu91', 'kkenney', 'bpg109', 'greed0812', 'suziepeter', 'tjconsidine', 'hbaker']",36,"['benkiesel', 'ajiang', 'kevinbilal', 'swa423', 'noor207', 'jennifersiedjak', 'diamondlg21', 'carolinedarin', 'jaleel', 'amunarang', 'zdk186', 'aew751', 'bugmenot', 'oniontech', 'dangerousdan', 'jwj198', 'annpowers2014', 'zp2014', 'davidlin49', 'harryyu', 'bob323', 'clockwork', 'charley', 'zchsnow0', 'gcutsail', 'jsierks', 'sah199', 'pthimsuwan', 'jws600', None, 'dunner87', 'cnj373', 'ssalah', 'lhv642', 'thecrazedbaker1', 'ruthjackie']",430,"['eweichmann', 'dpfeffer', 'vmitra92', 'lmichelsen', 'hitopgun', 'kkiani', 'sarahclark2014', 'nuchem', 'wiscorower', 'jki416', 'kmdoherty', 'phw454', 'diamondlg21', 'carolinedarin', 'bchanzit', 'lisamithun', 'jwoll1692', 'chem10232269', 'elisees', 'ipreston', 'zrs686', 'elinraun', 'sicelo', 'ignacioestrada', 'dangerousdan', 'cthayer709', 'mweber', 'rgruenhagen', 'annpowers2014', 'hct669', 'chc727', 'ssa886', 'nanolab218', 'dannyginz', 'kpescadora', 'jhuber', 'jherrera', 'tdupper', 'knutecuk', 'runningfreak21', 'pvonachen', 'cfirman', 'kegley', 'dannywinans', 'aqh681', 'yaejinpark2014', 'scoobidy', 'rossmac13', 'jkchem3', 'kevinbilal', 'jpmccleary', 'kjh321', 'bhamilton', 'willworden', 'chiggins', 'mcm179', 'chancecim', 'cel156', 'sraiter', 'vincenthuang', 'jschultz57', 'njneil92', 'pthimsuwan5050', 'jbuser92', 'jpalarczyk', 'samhatfield', 'gusbus06', 'markbachrach', 'aspiegel', 'dmp556', 'gcutsail', 'chem102', 'xdi870', 'wngo', 'brockburdyl', 'mrauf13', 'jwchoi13', 'sonalid', 'jkoszela', 'nebiu', 'eap01', 'dunner87', 'jpkmufc11', 'mollykbaker', 'meghan1', 'makanter', 'ccf165', 'sor427', 'rose', 'regit627', 'thecrazedbaker1', 'ecrystal', 'kwerling', 'johnmari', 'pdu937', 'arilederman', 'jeg770', 'alipka', 'chloe126', 'nhan3', 'ghm918', 'axz244', 'kalindishah', 'alannahenry', 'alamens', 'sdv465', 'kdwoods', 'jpj917', 'trp982', 'oniontech', 'gatesmeg', 'jennly', 'vraghunath', 'zp2014', 'knp750', 'aoabraham', 'jdf478', 'moekou', 'sghelani', 'dwerickson', 'jsd713', 'patwood78', 'ddjrl', 'juliaretzky', 'jkzhou99', 'kegermann', 'bgerber', 'mdj146', 'mborba', 'hhass', 'pthimsuwan', 'martakulich', 'tkagadawala', 'ltu197', 'wchoi1025', 'brivard', 'ethanmcginnis2014', 'ktdutchman', 'bkurcz', 'vfa774', 'ncalta', 'danalec23', 'meshun11', 'amcgary', 'edsarah', 'jasminejones', 'vishyt123', 'abz881', 'samgbur', 'mz1030', 'mss647', 'jguitart', 'adriennedunk', 'nch964', 'srv123', 'rnorval', 'azeliko', 'mrossi14', 'spencermartens', 'sahartman4', 'lee9jo', 'markc', 'rch465', 'juliateresa1', 'alanpan', 'hopeandseema', 'nebiutadele', 'stephmandir', 'mjiang112', 'deboisbn', 'vwang92', 'bli', 'jlj592', 'amunarang', 'jli', 'saxo', 'hcm888', 'danielmcfarland', 'sarahjeong2014', 'vjh199', 'dmirtsching', 'jherzog', 'catherinealthaus', 'vcz359', 'jeliff7', 'harryyu', 'bob323', 'esosdian', 'noliver97', 'nicolechem', 'amee', 'kevingreenhalgh2014', 'vog399', 'soh207', 'rjs374', 'abd892', 'benthemonkey', 'jws600', 'mwiersema', 'amlyniec', 'csilvestre', 'aramis16', 'matshu92', 'coreygoodwin', 'kpratt', 'lianggu91', 'bpg109', 'greed0812', 'bcarlis', 'bjr124', 'cms201', 'sydneyblack', 'ajm882', 'sharris', 'vickieotto', 'eeg951', 'lph854', 'twu', 'erica123', 'ebens', 'swa423', 'changbeeray', 'musiclover324', 'jaleel', 'teresak', 'tak825', 'mkegermann', 'amandaziffer2014', 'mevans', 'tmengesha', 'kelseythom', 'jquinn825', 'chknfngers', 'graceminix', 'davidlin49', 'mrauf', 'jetzoh51', 'dac279', 'zchsnow0', 'jyu3138', 'ewo304', 'sah199', 'alijoe2014', 'jwu525', 'eofferman', 'msh986', 'jboxman7', 'jmb489', 'keeleyjean86', 'mikejgleeson10', 'jsolis7', 'payasarraf1', 'vpp990', 'sem227', 'edp592', 'fjk562', 'hkw198', 'har580', 'hrendos', 'shj210', 'benkiesel', 'ajiang', 'mmmccc', 'jgruszeczki', 'msistla46', 'noor207', 'jsh8', 'shaina_nano', 'gkoshelev', 'tan190', 'aew751', 'avanisingh1', 'bmsiwek', 'saracov726', 'bumpin8er', 'samtam', 'nicroth', 'jamesbhigdon', 'cosidari', 'annpowers', 'clairemelvin', 'dbali423', 'tweiner92', 'ras525', 'lae247', 'clockwork', 'wenbinbin2010', 'tjw107', 'awalker6', 'kgu988', 'lslesur', 'ses457', 'rosemilavitz', 'rbraga25', 'kogden', 'lrl839', None, 'wizmaster', 'stingraymart1', 'cjanczak', 'cfeldhaus', 'smc895', 'hgf596', 'mhj872', 'atif24', 'crkramer', 'saraha', 'akantzos', 'harlynn14siler', 'simontj', 'eek735', 'yuliya12', 'amandafrankel2014', 'slhatch', 'giah', 'madelineschwid', 'kswann', 'johnandalex', 'kapoornu', 'sah285', 'jennifersiedjak', 'kennedyq', 'zaraq', 'cskeehan', 'jds119', 'cberkowitz', 'hairandholman', 'sjl123', 'ecp899', 'ezaonegina', 'kgc375', 'kik101', 'jwj198', 'markuline', 'lmsadowsky', 'kendrahertz2014', 'blai', 'dsh926', 'charley', 'kayliepmiller', 'zil338', 'knk953', 'lamar0404', 'ksd948', 'msw466', 'gmv672', 'rmullen2', 'cdarin', 'cvickst14', 'pinararikan', 'jsierks2', 'cnj373', 'meganghub', 'sunjaejung', 'the13thmachete', 'yzh199', 'tli132', 'ssalah', 'jeffandrose', 'nehanimm', 'bhuang92', 'kalishah', 'charleyp', 'copperbeech1', 'nkj745', 'jkilcommons', 'amc480', 'mark123', 'zachkis', 'titosmith12', 'chriscappello', 'jtargos', 'dlrhksgud4', 'mwagner987', 'karenoreilly', 'arandle', 'btredz49', 'jocandkev', 'nulab24c', 'suekim2014', 'nchristo85', 'sam413', 'kes690', 'kconnors', 'sli674', 'zdk186', 'bugmenot', 'eterzer', 'jcao618', 'landislandis', 'abbyroopali', 'lillian2011', 'alereyes', 'cwollaeger', 'ntp742', 'danielthomas2014', 'ath800', 'wsc826', 'gusdomel', 'dhw191', 'ggon03', 'jsierks', 'chem1', 'ays976', 'benjaminrafshoon2014', 'johnpark8', 'mhartoun', 'kstclaire', 'chemistry1', 'vasanoah', 'shawnkim332', 'varshinicherukupalli', 'mdw994', 'sahopki', 'rchalmers', 'shadiasadaqa', 'arps714', 'jhk931', 'cmw897', 'amattias', 'kkenney', 'suziepeter', 'tjconsidine', 'robbie529', 'rgeiwitz', 'aarora', 'lhv642', 'ruthjackie', 'hbaker', 'shilliger']"
1,164,394,97,80,"['changbeeray', 'jki416', 'jwoll1692', 'ignacioestrada', 'tmengesha', 'sicelo', 'jyu3138', 'ssa886', 'nanolab218', 'alijoe2014', 'jwu525', 'keeleyjean86', 'jsolis7', 'knutecuk', 'vpp990', 'sem227', 'rossmac13', 'shj210', 'jgruszeczki', 'jsh8', 'shaina_nano', 'chiggins', 'bumpin8er', 'samtam', 'cel156', 'jschultz57', 'tjw107', 'gusbus06', 'kgu988', 'chem102', 'xdi870', 'lslesur', 'sonalid', 'jkoszela', 'nebiu', 'mhj872', 'ccf165', 'atif24', 'akantzos', 'kwerling', 'johnmari', 'pdu937', 'chloe126', 'johnandalex', 'zaraq', 'kdwoods', 'cskeehan', 'jpj917', 'jds119', 'ezaonegina', 'kgc375', 'zil338', 'mdj146', 'ktdutchman', 'pinararikan', 'cvickst14', 'amcgary', 'mss647', 'amc480', 'adriennedunk', 'nch964', 'titosmith12', 'mwagner987', 'rch465', 'jlj592', 'eterzer', 'abbyroopali', 'landislandis', 'cwollaeger', 'ggon03', 'nicolechem', 'johnpark8', 'rjs374', 'mdw994', 'vasanoah', 'aramis16', 'jhk931', 'bpg109', 'suziepeter', 'tjconsidine']",314,"['eweichmann', 'dpfeffer', 'vmitra92', 'lmichelsen', 'hitopgun', 'kkiani', 'sarahclark2014', 'nuchem', 'wiscorower', 'kmdoherty', 'phw454', 'bchanzit', 'lisamithun', 'chem10232269', 'elisees', 'ipreston', 'zrs686', 'elinraun', 'cthayer709', 'mweber', 'rgruenhagen', 'hct669', 'chc727', 'dannyginz', 'kpescadora', 'jhuber', 'jherrera', 'tdupper', 'runningfreak21', 'pvonachen', 'cfirman', 'kegley', 'dannywinans', 'aqh681', 'yaejinpark2014', 'scoobidy', 'jkchem3', 'jpmccleary', 'kjh321', 'bhamilton', 'willworden', 'mcm179', 'chancecim', 'sraiter', 'vincenthuang', 'njneil92', 'pthimsuwan5050', 'jbuser92', 'jpalarczyk', 'samhatfield', 'markbachrach', 'aspiegel', 'dmp556', 'wngo', 'brockburdyl', 'mrauf13', 'jwchoi13', 'eap01', 'jpkmufc11', 'mollykbaker', 'meghan1', 'makanter', 'sor427', 'rose', 'regit627', 'ecrystal', 'arilederman', 'jeg770', 'alipka', 'nhan3', 'ghm918', 'axz244', 'kalindishah', 'alannahenry', 'alamens', 'sdv465', 'trp982', 'gatesmeg', 'jennly', 'vraghunath', 'knp750', 'aoabraham', 'jdf478', 'moekou', 'sghelani', 'dwerickson', 'jsd713', 'patwood78', 'ddjrl', 'juliaretzky', 'jkzhou99', 'kegermann', 'bgerber', 'mborba', 'hhass', 'martakulich', 'tkagadawala', 'ltu197', 'wchoi1025', 'brivard', 'ethanmcginnis2014', 'bkurcz', 'vfa774', 'ncalta', 'danalec23', 'meshun11', 'edsarah', 'jasminejones', 'vishyt123', 'abz881', 'samgbur', 'mz1030', 'jguitart', 'srv123', 'rnorval', 'azeliko', 'mrossi14', 'spencermartens', 'sahartman4', 'lee9jo', 'markc', 'juliateresa1', 'alanpan', 'hopeandseema', 'nebiutadele', 'stephmandir', 'mjiang112', 'deboisbn', 'vwang92', 'bli', 'jli', 'saxo', 'hcm888', 'danielmcfarland', 'sarahjeong2014', 'vjh199', 'dmirtsching', 'jherzog', 'catherinealthaus', 'vcz359', 'jeliff7', 'esosdian', 'noliver97', 'amee', 'kevingreenhalgh2014', 'vog399', 'soh207', 'abd892', 'benthemonkey', 'mwiersema', 'amlyniec', 'csilvestre', 'matshu92', 'coreygoodwin', 'kpratt', 'lianggu91', 'greed0812', 'bcarlis', 'bjr124', 'cms201', 'sydneyblack', 'ajm882', 'sharris', 'vickieotto', 'eeg951', 'lph854', 'twu', 'erica123', 'ebens', 'musiclover324', 'teresak', 'tak825', 'mkegermann', 'amandaziffer2014', 'mevans', 'kelseythom', 'jquinn825', 'chknfngers', 'graceminix', 'mrauf', 'jetzoh51', 'dac279', 'ewo304', 'eofferman', 'msh986', 'jboxman7', 'jmb489', 'mikejgleeson10', 'payasarraf1', 'edp592', 'fjk562', 'hkw198', 'har580', 'hrendos', 'mmmccc', 'msistla46', 'gkoshelev', 'tan190', 'avanisingh1', 'bmsiwek', 'saracov726', 'nicroth', 'jamesbhigdon', 'cosidari', 'annpowers', 'clairemelvin', 'dbali423', 'tweiner92', 'ras525', 'lae247', 'wenbinbin2010', 'awalker6', 'ses457', 'rosemilavitz', 'rbraga25', 'kogden', 'lrl839', 'wizmaster', 'stingraymart1', 'cjanczak', 'cfeldhaus', 'smc895', 'hgf596', 'crkramer', 'saraha', 'harlynn14siler', 'simontj', 'eek735', 'yuliya12', 'amandafrankel2014', 'slhatch', 'giah', 'madelineschwid', 'kswann', 'kapoornu', 'sah285', 'kennedyq', 'cberkowitz', 'hairandholman', 'sjl123', 'ecp899', 'kik101', 'markuline', 'lmsadowsky', 'kendrahertz2014', 'blai', 'dsh926', 'kayliepmiller', 'knk953', 'lamar0404', 'ksd948', 'msw466', 'gmv672', 'rmullen2', 'cdarin', 'jsierks2', 'meganghub', 'sunjaejung', 'the13thmachete', 'yzh199', 'tli132', 'jeffandrose', 'nehanimm', 'bhuang92', 'kalishah', 'charleyp', 'copperbeech1', 'nkj745', 'jkilcommons', 'mark123', 'zachkis', 'chriscappello', 'jtargos', 'dlrhksgud4', 'karenoreilly', 'arandle', 'btredz49', 'jocandkev', 'nulab24c', 'suekim2014', 'nchristo85', 'sam413', 'kes690', 'kconnors', 'sli674', 'jcao618', 'lillian2011', 'alereyes', 'ntp742', 'danielthomas2014', 'ath800', 'wsc826', 'gusdomel', 'dhw191', 'chem1', 'ays976', 'benjaminrafshoon2014', 'mhartoun', 'kstclaire', 'chemistry1', 'shawnkim332', 'varshinicherukupalli', 'sahopki', 'rchalmers', 'shadiasadaqa', 'arps714', 'cmw897', 'amattias', 'kkenney', 'robbie529', 'rgeiwitz', 'aarora', 'hbaker', 'shilliger']",17,"['cjj777', 'mgs943', 'pablosanchez', 'aze969', 'amh690', 'haley6', 'mwrobes', 'jpk953', 'bugmenot', 'mini6467', 'tomvonheill', 'jbk285', 'mikeli', 'bendover', 'nch863', None, 'zabin']",411,"['eweichmann', 'dpfeffer', 'vmitra92', 'lmichelsen', 'hitopgun', 'kkiani', 'sarahclark2014', 'nuchem', 'wiscorower', 'jki416', 'kmdoherty', 'phw454', 'bchanzit', 'lisamithun', 'jwoll1692', 'chem10232269', 'elisees', 'ipreston', 'zrs686', 'elinraun', 'sicelo', 'ignacioestrada', 'cthayer709', 'mweber', 'rgruenhagen', 'hct669', 'chc727', 'ssa886', 'nanolab218', 'tomvonheill', 'dannyginz', 'kpescadora', 'jhuber', 'jherrera', 'tdupper', 'knutecuk', 'runningfreak21', 'pvonachen', 'cfirman', 'kegley', 'dannywinans', 'aqh681', 'yaejinpark2014', 'scoobidy', 'rossmac13', 'jkchem3', 'jpmccleary', 'kjh321', 'bhamilton', 'willworden', 'chiggins', 'mcm179', 'chancecim', 'cel156', 'sraiter', 'vincenthuang', 'jschultz57', 'njneil92', 'pthimsuwan5050', 'jbuser92', 'jpalarczyk', 'samhatfield', 'gusbus06', 'markbachrach', 'aspiegel', 'dmp556', 'chem102', 'xdi870', 'wngo', 'brockburdyl', 'mrauf13', 'jwchoi13', 'sonalid', 'jkoszela', 'nebiu', 'eap01', 'jpkmufc11', 'mollykbaker', 'meghan1', 'makanter', 'ccf165', 'sor427', 'rose', 'regit627', 'ecrystal', 'kwerling', 'johnmari', 'pdu937', 'arilederman', 'jeg770', 'alipka', 'chloe126', 'nhan3', 'ghm918', 'aze969', 'axz244', 'kalindishah', 'alannahenry', 'alamens', 'sdv465', 'cjj777', 'kdwoods', 'jpj917', 'trp982', 'gatesmeg', 'jennly', 'vraghunath', 'knp750', 'aoabraham', 'jdf478', 'moekou', 'sghelani', 'dwerickson', 'jsd713', 'patwood78', 'ddjrl', 'juliaretzky', 'jkzhou99', 'kegermann', 'bgerber', 'mdj146', 'mborba', 'hhass', 'martakulich', 'tkagadawala', 'ltu197', 'wchoi1025', 'brivard', 'ethanmcginnis2014', 'ktdutchman', 'bkurcz', 'mikeli', 'vfa774', 'ncalta', 'danalec23', 'meshun11', 'amcgary', 'edsarah', 'jasminejones', 'vishyt123', 'abz881', 'samgbur', 'mz1030', 'mss647', 'jguitart', 'adriennedunk', 'nch964', 'srv123', 'rnorval', 'azeliko', 'mrossi14', 'zabin', 'spencermartens', 'sahartman4', 'lee9jo', 'markc', 'rch465', 'juliateresa1', 'alanpan', 'hopeandseema', 'nebiutadele', 'stephmandir', 'mjiang112', 'deboisbn', 'vwang92', 'bli', 'jlj592', 'jli', 'saxo', 'hcm888', 'danielmcfarland', 'sarahjeong2014', 'vjh199', 'dmirtsching', 'jherzog', 'catherinealthaus', 'vcz359', 'jeliff7', 'esosdian', 'noliver97', 'nicolechem', 'amee', 'kevingreenhalgh2014', 'vog399', 'soh207', 'rjs374', 'abd892', 'benthemonkey', 'mwiersema', 'amlyniec', 'csilvestre', 'aramis16', 'matshu92', 'coreygoodwin', 'kpratt', 'lianggu91', 'bpg109', 'greed0812', 'bcarlis', 'bjr124', 'cms201', 'sydneyblack', 'ajm882', 'sharris', 'vickieotto', 'eeg951', 'lph854', 'twu', 'erica123', 'ebens', 'changbeeray', 'musiclover324', 'bendover', 'teresak', 'tak825', 'mkegermann', 'amandaziffer2014', 'mevans', 'mgs943', 'haley6', 'tmengesha', 'kelseythom', 'jquinn825', 'chknfngers', 'graceminix', 'mrauf', 'jetzoh51', 'dac279', 'jyu3138', 'ewo304', 'mini6467', 'alijoe2014', 'jbk285', 'jwu525', 'eofferman', 'msh986', 'nch863', 'jboxman7', 'jmb489', 'keeleyjean86', 'mikejgleeson10', 'jsolis7', 'payasarraf1', 'vpp990', 'sem227', 'edp592', 'fjk562', 'hkw198', 'har580', 'hrendos', 'shj210', 'mmmccc', 'jgruszeczki', 'msistla46', 'jsh8', 'shaina_nano', 'gkoshelev', 'tan190', 'avanisingh1', 'bmsiwek', 'saracov726', 'bumpin8er', 'samtam', 'nicroth', 'jamesbhigdon', 'cosidari', 'annpowers', 'clairemelvin', 'dbali423', 'tweiner92', 'ras525', 'lae247', 'wenbinbin2010', 'tjw107', 'pablosanchez', 'awalker6', 'kgu988', 'lslesur', 'ses457', 'rosemilavitz', 'rbraga25', 'kogden', 'lrl839', None, 'wizmaster', 'stingraymart1', 'cjanczak', 'cfeldhaus', 'smc895', 'hgf596', 'mhj872', 'atif24', 'crkramer', 'saraha', 'akantzos', 'harlynn14siler', 'simontj', 'eek735', 'yuliya12', 'amandafrankel2014', 'slhatch', 'giah', 'madelineschwid', 'kswann', 'johnandalex', 'kapoornu', 'sah285', 'kennedyq', 'zaraq', 'cskeehan', 'jds119', 'cberkowitz', 'hairandholman', 'sjl123', 'ecp899', 'ezaonegina', 'kgc375', 'kik101', 'markuline', 'lmsadowsky', 'kendrahertz2014', 'blai', 'dsh926', 'kayliepmiller', 'zil338', 'knk953', 'lamar0404', 'ksd948', 'msw466', 'gmv672', 'rmullen2', 'cdarin', 'cvickst14', 'pinararikan', 'jsierks2', 'meganghub', 'sunjaejung', 'the13thmachete', 'yzh199', 'tli132', 'jeffandrose', 'nehanimm', 'bhuang92', 'kalishah', 'charleyp', 'copperbeech1', 'nkj745', 'jkilcommons', 'amc480', 'mark123', 'zachkis', 'titosmith12', 'mwrobes', 'chriscappello', 'jtargos', 'dlrhksgud4', 'mwagner987', 'karenoreilly', 'arandle', 'amh690', 'btredz49', 'jocandkev', 'jpk953', 'nulab24c', 'suekim2014', 'nchristo85', 'sam413', 'kes690', 'kconnors', 'sli674', 'bugmenot', 'eterzer', 'jcao618', 'landislandis', 'abbyroopali', 'lillian2011', 'alereyes', 'cwollaeger', 'ntp742', 'danielthomas2014', 'ath800', 'wsc826', 'gusdomel', 'dhw191', 'ggon03', 'chem1', 'ays976', 'benjaminrafshoon2014', 'johnpark8', 'mhartoun', 'kstclaire', 'chemistry1', 'vasanoah', 'shawnkim332', 'varshinicherukupalli', 'mdw994', 'sahopki', 'rchalmers', 'shadiasadaqa', 'arps714', 'jhk931', 'cmw897', 'amattias', 'kkenney', 'suziepeter', 'tjconsidine', 'robbie529', 'rgeiwitz', 'aarora', 'hbaker', 'shilliger']"
1,203,394,18,1,['sicelo'],393,"['eweichmann', 'dpfeffer', 'vmitra92', 'lmichelsen', 'hitopgun', 'kkiani', 'sarahclark2014', 'nuchem', 'wiscorower', 'jki416', 'kmdoherty', 'phw454', 'bchanzit', 'lisamithun', 'jwoll1692', 'chem10232269', 'elisees', 'ipreston', 'zrs686', 'elinraun', 'ignacioestrada', 'cthayer709', 'mweber', 'rgruenhagen', 'hct669', 'chc727', 'ssa886', 'nanolab218', 'dannyginz', 'kpescadora', 'jhuber', 'jherrera', 'tdupper', 'knutecuk', 'runningfreak21', 'pvonachen', 'cfirman', 'kegley', 'dannywinans', 'aqh681', 'yaejinpark2014', 'scoobidy', 'rossmac13', 'jkchem3', 'jpmccleary', 'kjh321', 'bhamilton', 'willworden', 'chiggins', 'mcm179', 'chancecim', 'cel156', 'sraiter', 'vincenthuang', 'jschultz57', 'njneil92', 'pthimsuwan5050', 'jbuser92', 'jpalarczyk', 'samhatfield', 'gusbus06', 'markbachrach', 'aspiegel', 'dmp556', 'chem102', 'xdi870', 'wngo', 'brockburdyl', 'mrauf13', 'jwchoi13', 'sonalid', 'jkoszela', 'nebiu', 'eap01', 'jpkmufc11', 'mollykbaker', 'meghan1', 'makanter', 'ccf165', 'sor427', 'rose', 'regit627', 'ecrystal', 'kwerling', 'johnmari', 'pdu937', 'arilederman', 'jeg770', 'alipka', 'chloe126', 'nhan3', 'ghm918', 'axz244', 'kalindishah', 'alannahenry', 'alamens', 'sdv465', 'kdwoods', 'jpj917', 'trp982', 'gatesmeg', 'jennly', 'vraghunath', 'knp750', 'aoabraham', 'jdf478', 'moekou', 'sghelani', 'dwerickson', 'jsd713', 'patwood78', 'ddjrl', 'juliaretzky', 'jkzhou99', 'kegermann', 'bgerber', 'mdj146', 'mborba', 'hhass', 'martakulich', 'tkagadawala', 'ltu197', 'wchoi1025', 'brivard', 'ethanmcginnis2014', 'ktdutchman', 'bkurcz', 'vfa774', 'ncalta', 'danalec23', 'meshun11', 'amcgary', 'edsarah', 'jasminejones', 'vishyt123', 'abz881', 'samgbur', 'mz1030', 'mss647', 'jguitart', 'adriennedunk', 'nch964', 'srv123', 'rnorval', 'azeliko', 'mrossi14', 'spencermartens', 'sahartman4', 'lee9jo', 'markc', 'rch465', 'juliateresa1', 'alanpan', 'hopeandseema', 'nebiutadele', 'stephmandir', 'mjiang112', 'deboisbn', 'vwang92', 'bli', 'jlj592', 'jli', 'saxo', 'hcm888', 'danielmcfarland', 'sarahjeong2014', 'vjh199', 'dmirtsching', 'jherzog', 'catherinealthaus', 'vcz359', 'jeliff7', 'esosdian', 'noliver97', 'nicolechem', 'amee', 'kevingreenhalgh2014', 'vog399', 'soh207', 'rjs374', 'abd892', 'benthemonkey', 'mwiersema', 'amlyniec', 'csilvestre', 'aramis16', 'matshu92', 'coreygoodwin', 'kpratt', 'lianggu91', 'bpg109', 'greed0812', 'bcarlis', 'bjr124', 'cms201', 'sydneyblack', 'ajm882', 'sharris', 'vickieotto', 'eeg951', 'lph854', 'twu', 'erica123', 'ebens', 'changbeeray', 'musiclover324', 'teresak', 'tak825', 'mkegermann', 'amandaziffer2014', 'mevans', 'tmengesha', 'kelseythom', 'jquinn825', 'chknfngers', 'graceminix', 'mrauf', 'jetzoh51', 'dac279', 'jyu3138', 'ewo304', 'alijoe2014', 'jwu525', 'eofferman', 'msh986', 'jboxman7', 'jmb489', 'keeleyjean86', 'mikejgleeson10', 'jsolis7', 'payasarraf1', 'vpp990', 'sem227', 'edp592', 'fjk562', 'hkw198', 'har580', 'hrendos', 'shj210', 'mmmccc', 'jgruszeczki', 'msistla46', 'jsh8', 'shaina_nano', 'gkoshelev', 'tan190', 'avanisingh1', 'bmsiwek', 'saracov726', 'bumpin8er', 'samtam', 'nicroth', 'jamesbhigdon', 'cosidari', 'annpowers', 'clairemelvin', 'dbali423', 'tweiner92', 'ras525', 'lae247', 'wenbinbin2010', 'tjw107', 'awalker6', 'kgu988', 'lslesur', 'ses457', 'rosemilavitz', 'rbraga25', 'kogden', 'lrl839', 'wizmaster', 'stingraymart1', 'cjanczak', 'cfeldhaus', 'smc895', 'hgf596', 'mhj872', 'atif24', 'crkramer', 'saraha', 'akantzos', 'harlynn14siler', 'simontj', 'eek735', 'yuliya12', 'amandafrankel2014', 'slhatch', 'giah', 'madelineschwid', 'kswann', 'johnandalex', 'kapoornu', 'sah285', 'kennedyq', 'zaraq', 'cskeehan', 'jds119', 'cberkowitz', 'hairandholman', 'sjl123', 'ecp899', 'ezaonegina', 'kgc375', 'kik101', 'markuline', 'lmsadowsky', 'kendrahertz2014', 'blai', 'dsh926', 'kayliepmiller', 'zil338', 'knk953', 'lamar0404', 'ksd948', 'msw466', 'gmv672', 'rmullen2', 'cdarin', 'cvickst14', 'pinararikan', 'jsierks2', 'meganghub', 'sunjaejung', 'the13thmachete', 'yzh199', 'tli132', 'jeffandrose', 'nehanimm', 'bhuang92', 'kalishah', 'charleyp', 'copperbeech1', 'nkj745', 'jkilcommons', 'amc480', 'mark123', 'zachkis', 'titosmith12', 'chriscappello', 'jtargos', 'dlrhksgud4', 'mwagner987', 'karenoreilly', 'arandle', 'btredz49', 'jocandkev', 'nulab24c', 'suekim2014', 'nchristo85', 'sam413', 'kes690', 'kconnors', 'sli674', 'eterzer', 'jcao618', 'landislandis', 'abbyroopali', 'lillian2011', 'alereyes', 'cwollaeger', 'ntp742', 'danielthomas2014', 'ath800', 'wsc826', 'gusdomel', 'dhw191', 'ggon03', 'chem1', 'ays976', 'benjaminrafshoon2014', 'johnpark8', 'mhartoun', 'kstclaire', 'chemistry1', 'vasanoah', 'shawnkim332', 'varshinicherukupalli', 'mdw994', 'sahopki', 'rchalmers', 'shadiasadaqa', 'arps714', 'jhk931', 'cmw897', 'amattias', 'kkenney', 'suziepeter', 'tjconsidine', 'robbie529', 'rgeiwitz', 'aarora', 'hbaker', 'shilliger']",17,"['dunner87', 'amberdavis2014', 'bugmenot', 'gcutsail', 'heitzerh', 'dangerousdan', 'scottydyar', 'lmadison13', 'bashwell', 'iam007stina', 'iamicde', 'mrm663', 'mshelby', None, 'whoff', 'nathaniel87', 'ngruenke']",411,"['eweichmann', 'dpfeffer', 'vmitra92', 'lmichelsen', 'hitopgun', 'kkiani', 'sarahclark2014', 'nuchem', 'wiscorower', 'jki416', 'kmdoherty', 'phw454', 'bchanzit', 'lisamithun', 'jwoll1692', 'chem10232269', 'elisees', 'ipreston', 'zrs686', 'elinraun', 'sicelo', 'ignacioestrada', 'dangerousdan', 'cthayer709', 'mweber', 'rgruenhagen', 'hct669', 'chc727', 'ssa886', 'nanolab218', 'dannyginz', 'kpescadora', 'jhuber', 'jherrera', 'tdupper', 'knutecuk', 'runningfreak21', 'pvonachen', 'cfirman', 'kegley', 'dannywinans', 'aqh681', 'yaejinpark2014', 'scoobidy', 'rossmac13', 'jkchem3', 'jpmccleary', 'bashwell', 'kjh321', 'bhamilton', 'willworden', 'chiggins', 'mcm179', 'chancecim', 'cel156', 'sraiter', 'vincenthuang', 'jschultz57', 'njneil92', 'pthimsuwan5050', 'jbuser92', 'mrm663', 'jpalarczyk', 'samhatfield', 'gusbus06', 'markbachrach', 'aspiegel', 'dmp556', 'gcutsail', 'chem102', 'xdi870', 'wngo', 'brockburdyl', 'mrauf13', 'jwchoi13', 'sonalid', 'jkoszela', 'nebiu', 'eap01', 'dunner87', 'jpkmufc11', 'mollykbaker', 'meghan1', 'makanter', 'ccf165', 'sor427', 'rose', 'regit627', 'ecrystal', 'kwerling', 'johnmari', 'pdu937', 'arilederman', 'jeg770', 'alipka', 'chloe126', 'nhan3', 'ghm918', 'axz244', 'kalindishah', 'alannahenry', 'alamens', 'sdv465', 'kdwoods', 'jpj917', 'trp982', 'gatesmeg', 'jennly', 'vraghunath', 'knp750', 'aoabraham', 'jdf478', 'moekou', 'sghelani', 'dwerickson', 'jsd713', 'patwood78', 'ddjrl', 'juliaretzky', 'jkzhou99', 'kegermann', 'bgerber', 'mdj146', 'mborba', 'hhass', 'martakulich', 'tkagadawala', 'ltu197', 'wchoi1025', 'brivard', 'ethanmcginnis2014', 'ktdutchman', 'bkurcz', 'vfa774', 'ncalta', 'danalec23', 'meshun11', 'amcgary', 'edsarah', 'jasminejones', 'vishyt123', 'abz881', 'samgbur', 'mz1030', 'mss647', 'jguitart', 'adriennedunk', 'nch964', 'srv123', 'rnorval', 'azeliko', 'mrossi14', 'spencermartens', 'sahartman4', 'lee9jo', 'amberdavis2014', 'markc', 'rch465', 'juliateresa1', 'alanpan', 'hopeandseema', 'nebiutadele', 'stephmandir', 'mjiang112', 'mshelby', 'deboisbn', 'vwang92', 'bli', 'jlj592', 'jli', 'saxo', 'hcm888', 'danielmcfarland', 'sarahjeong2014', 'vjh199', 'dmirtsching', 'jherzog', 'catherinealthaus', 'vcz359', 'jeliff7', 'esosdian', 'nathaniel87', 'noliver97', 'nicolechem', 'amee', 'kevingreenhalgh2014', 'vog399', 'soh207', 'rjs374', 'abd892', 'benthemonkey', 'mwiersema', 'amlyniec', 'csilvestre', 'aramis16', 'matshu92', 'coreygoodwin', 'kpratt', 'lianggu91', 'bpg109', 'greed0812', 'bcarlis', 'bjr124', 'cms201', 'iamicde', 'sydneyblack', 'ajm882', 'sharris', 'vickieotto', 'heitzerh', 'eeg951', 'lph854', 'twu', 'erica123', 'ebens', 'changbeeray', 'musiclover324', 'teresak', 'tak825', 'mkegermann', 'amandaziffer2014', 'mevans', 'tmengesha', 'kelseythom', 'jquinn825', 'chknfngers', 'graceminix', 'mrauf', 'whoff', 'jetzoh51', 'dac279', 'jyu3138', 'ewo304', 'alijoe2014', 'jwu525', 'eofferman', 'msh986', 'jboxman7', 'jmb489', 'keeleyjean86', 'mikejgleeson10', 'jsolis7', 'payasarraf1', 'vpp990', 'sem227', 'edp592', 'fjk562', 'hkw198', 'har580', 'hrendos', 'shj210', 'mmmccc', 'jgruszeczki', 'msistla46', 'jsh8', 'shaina_nano', 'ngruenke', 'gkoshelev', 'tan190', 'avanisingh1', 'bmsiwek', 'saracov726', 'bumpin8er', 'samtam', 'nicroth', 'jamesbhigdon', 'cosidari', 'annpowers', 'clairemelvin', 'dbali423', 'tweiner92', 'ras525', 'lae247', 'wenbinbin2010', 'tjw107', 'awalker6', 'kgu988', 'scottydyar', 'lslesur', 'lmadison13', 'ses457', 'rosemilavitz', 'rbraga25', 'kogden', 'lrl839', None, 'wizmaster', 'stingraymart1', 'cjanczak', 'cfeldhaus', 'smc895', 'hgf596', 'mhj872', 'atif24', 'crkramer', 'saraha', 'akantzos', 'harlynn14siler', 'simontj', 'eek735', 'yuliya12', 'amandafrankel2014', 'slhatch', 'giah', 'madelineschwid', 'kswann', 'johnandalex', 'kapoornu', 'sah285', 'kennedyq', 'zaraq', 'cskeehan', 'jds119', 'cberkowitz', 'hairandholman', 'sjl123', 'ecp899', 'ezaonegina', 'kgc375', 'kik101', 'markuline', 'lmsadowsky', 'kendrahertz2014', 'blai', 'dsh926', 'kayliepmiller', 'zil338', 'knk953', 'lamar0404', 'ksd948', 'msw466', 'gmv672', 'rmullen2', 'cdarin', 'cvickst14', 'pinararikan', 'jsierks2', 'meganghub', 'sunjaejung', 'the13thmachete', 'yzh199', 'tli132', 'jeffandrose', 'nehanimm', 'bhuang92', 'kalishah', 'charleyp', 'copperbeech1', 'nkj745', 'jkilcommons', 'amc480', 'mark123', 'zachkis', 'titosmith12', 'iam007stina', 'chriscappello', 'jtargos', 'dlrhksgud4', 'mwagner987', 'karenoreilly', 'arandle', 'btredz49', 'jocandkev', 'nulab24c', 'suekim2014', 'nchristo85', 'sam413', 'kes690', 'kconnors', 'sli674', 'bugmenot', 'eterzer', 'jcao618', 'landislandis', 'abbyroopali', 'lillian2011', 'alereyes', 'cwollaeger', 'ntp742', 'danielthomas2014', 'ath800', 'wsc826', 'gusdomel', 'dhw191', 'ggon03', 'chem1', 'ays976', 'benjaminrafshoon2014', 'johnpark8', 'mhartoun', 'kstclaire', 'chemistry1', 'vasanoah', 'shawnkim332', 'varshinicherukupalli', 'mdw994', 'sahopki', 'rchalmers', 'shadiasadaqa', 'arps714', 'jhk931', 'cmw897', 'amattias', 'kkenney', 'suziepeter', 'tjconsidine', 'robbie529', 'rgeiwitz', 'aarora', 'hbaker', 'shilliger']"
1,168,394,14,10,"['the13thmachete', 'jeg770', 'rch465', 'runningfreak21', 'sjl123', 'lamar0404', 'knp750', 'graceminix', 'ath800', 'amandafrankel2014']",384,"['eweichmann', 'dpfeffer', 'vmitra92', 'lmichelsen', 'hitopgun', 'kkiani', 'sarahclark2014', 'nuchem', 'wiscorower', 'jki416', 'kmdoherty', 'phw454', 'bchanzit', 'lisamithun', 'jwoll1692', 'chem10232269', 'elisees', 'ipreston', 'zrs686', 'elinraun', 'sicelo', 'ignacioestrada', 'cthayer709', 'mweber', 'rgruenhagen', 'hct669', 'chc727', 'ssa886', 'nanolab218', 'dannyginz', 'kpescadora', 'jhuber', 'jherrera', 'tdupper', 'knutecuk', 'pvonachen', 'cfirman', 'kegley', 'dannywinans', 'aqh681', 'yaejinpark2014', 'scoobidy', 'rossmac13', 'jkchem3', 'jpmccleary', 'kjh321', 'bhamilton', 'willworden', 'chiggins', 'mcm179', 'chancecim', 'cel156', 'sraiter', 'vincenthuang', 'jschultz57', 'njneil92', 'pthimsuwan5050', 'jbuser92', 'jpalarczyk', 'samhatfield', 'gusbus06', 'markbachrach', 'aspiegel', 'dmp556', 'chem102', 'xdi870', 'wngo', 'brockburdyl', 'mrauf13', 'jwchoi13', 'sonalid', 'jkoszela', 'nebiu', 'eap01', 'jpkmufc11', 'mollykbaker', 'meghan1', 'makanter', 'ccf165', 'sor427', 'rose', 'regit627', 'ecrystal', 'kwerling', 'johnmari', 'pdu937', 'arilederman', 'alipka', 'chloe126', 'nhan3', 'ghm918', 'axz244', 'kalindishah', 'alannahenry', 'alamens', 'sdv465', 'kdwoods', 'jpj917', 'trp982', 'gatesmeg', 'jennly', 'vraghunath', 'aoabraham', 'jdf478', 'moekou', 'sghelani', 'dwerickson', 'jsd713', 'patwood78', 'ddjrl', 'juliaretzky', 'jkzhou99', 'kegermann', 'bgerber', 'mdj146', 'mborba', 'hhass', 'martakulich', 'tkagadawala', 'ltu197', 'wchoi1025', 'brivard', 'ethanmcginnis2014', 'ktdutchman', 'bkurcz', 'vfa774', 'ncalta', 'danalec23', 'meshun11', 'amcgary', 'edsarah', 'jasminejones', 'vishyt123', 'abz881', 'samgbur', 'mz1030', 'mss647', 'jguitart', 'adriennedunk', 'nch964', 'srv123', 'rnorval', 'azeliko', 'mrossi14', 'spencermartens', 'sahartman4', 'lee9jo', 'markc', 'juliateresa1', 'alanpan', 'hopeandseema', 'nebiutadele', 'stephmandir', 'mjiang112', 'deboisbn', 'vwang92', 'bli', 'jlj592', 'jli', 'saxo', 'hcm888', 'danielmcfarland', 'sarahjeong2014', 'vjh199', 'dmirtsching', 'jherzog', 'catherinealthaus', 'vcz359', 'jeliff7', 'esosdian', 'noliver97', 'nicolechem', 'amee', 'kevingreenhalgh2014', 'vog399', 'soh207', 'rjs374', 'abd892', 'benthemonkey', 'mwiersema', 'amlyniec', 'csilvestre', 'aramis16', 'matshu92', 'coreygoodwin', 'kpratt', 'lianggu91', 'bpg109', 'greed0812', 'bcarlis', 'bjr124', 'cms201', 'sydneyblack', 'ajm882', 'sharris', 'vickieotto', 'eeg951', 'lph854', 'twu', 'erica123', 'ebens', 'changbeeray', 'musiclover324', 'teresak', 'tak825', 'mkegermann', 'amandaziffer2014', 'mevans', 'tmengesha', 'kelseythom', 'jquinn825', 'chknfngers', 'mrauf', 'jetzoh51', 'dac279', 'jyu3138', 'ewo304', 'alijoe2014', 'jwu525', 'eofferman', 'msh986', 'jboxman7', 'jmb489', 'keeleyjean86', 'mikejgleeson10', 'jsolis7', 'payasarraf1', 'vpp990', 'sem227', 'edp592', 'fjk562', 'hkw198', 'har580', 'hrendos', 'shj210', 'mmmccc', 'jgruszeczki', 'msistla46', 'jsh8', 'shaina_nano', 'gkoshelev', 'tan190', 'avanisingh1', 'bmsiwek', 'saracov726', 'bumpin8er', 'samtam', 'nicroth', 'jamesbhigdon', 'cosidari', 'annpowers', 'clairemelvin', 'dbali423', 'tweiner92', 'ras525', 'lae247', 'wenbinbin2010', 'tjw107', 'awalker6', 'kgu988', 'lslesur', 'ses457', 'rosemilavitz', 'rbraga25', 'kogden', 'lrl839', 'wizmaster', 'stingraymart1', 'cjanczak', 'cfeldhaus', 'smc895', 'hgf596', 'mhj872', 'atif24', 'crkramer', 'saraha', 'akantzos', 'harlynn14siler', 'simontj', 'eek735', 'yuliya12', 'slhatch', 'giah', 'madelineschwid', 'kswann', 'johnandalex', 'kapoornu', 'sah285', 'kennedyq', 'zaraq', 'cskeehan', 'jds119', 'cberkowitz', 'hairandholman', 'ecp899', 'ezaonegina', 'kgc375', 'kik101', 'markuline', 'lmsadowsky', 'kendrahertz2014', 'blai', 'dsh926', 'kayliepmiller', 'zil338', 'knk953', 'ksd948', 'msw466', 'gmv672', 'rmullen2', 'cdarin', 'cvickst14', 'pinararikan', 'jsierks2', 'meganghub', 'sunjaejung', 'yzh199', 'tli132', 'jeffandrose', 'nehanimm', 'bhuang92', 'kalishah', 'charleyp', 'copperbeech1', 'nkj745', 'jkilcommons', 'amc480', 'mark123', 'zachkis', 'titosmith12', 'chriscappello', 'jtargos', 'dlrhksgud4', 'mwagner987', 'karenoreilly', 'arandle', 'btredz49', 'jocandkev', 'nulab24c', 'suekim2014', 'nchristo85', 'sam413', 'kes690', 'kconnors', 'sli674', 'eterzer', 'jcao618', 'landislandis', 'abbyroopali', 'lillian2011', 'alereyes', 'cwollaeger', 'ntp742', 'danielthomas2014', 'wsc826', 'gusdomel', 'dhw191', 'ggon03', 'chem1', 'ays976', 'benjaminrafshoon2014', 'johnpark8', 'mhartoun', 'kstclaire', 'chemistry1', 'vasanoah', 'shawnkim332', 'varshinicherukupalli', 'mdw994', 'sahopki', 'rchalmers', 'shadiasadaqa', 'arps714', 'jhk931', 'cmw897', 'amattias', 'kkenney', 'suziepeter', 'tjconsidine', 'robbie529', 'rgeiwitz', 'aarora', 'hbaker', 'shilliger']",4,"['swa423', 'bmchanzit', None, 'annpowers2014']",398,"['eweichmann', 'dpfeffer', 'vmitra92', 'lmichelsen', 'hitopgun', 'kkiani', 'sarahclark2014', 'nuchem', 'wiscorower', 'jki416', 'kmdoherty', 'phw454', 'bchanzit', 'lisamithun', 'jwoll1692', 'chem10232269', 'elisees', 'ipreston', 'zrs686', 'elinraun', 'sicelo', 'ignacioestrada', 'cthayer709', 'mweber', 'rgruenhagen', 'annpowers2014', 'hct669', 'chc727', 'ssa886', 'nanolab218', 'dannyginz', 'kpescadora', 'jhuber', 'jherrera', 'tdupper', 'knutecuk', 'runningfreak21', 'pvonachen', 'cfirman', 'kegley', 'dannywinans', 'aqh681', 'yaejinpark2014', 'scoobidy', 'rossmac13', 'jkchem3', 'jpmccleary', 'kjh321', 'bhamilton', 'willworden', 'chiggins', 'mcm179', 'chancecim', 'cel156', 'sraiter', 'vincenthuang', 'jschultz57', 'njneil92', 'pthimsuwan5050', 'jbuser92', 'jpalarczyk', 'samhatfield', 'gusbus06', 'markbachrach', 'aspiegel', 'dmp556', 'chem102', 'xdi870', 'wngo', 'brockburdyl', 'mrauf13', 'jwchoi13', 'sonalid', 'jkoszela', 'nebiu', 'eap01', 'jpkmufc11', 'mollykbaker', 'meghan1', 'makanter', 'ccf165', 'sor427', 'rose', 'regit627', 'ecrystal', 'kwerling', 'johnmari', 'pdu937', 'arilederman', 'jeg770', 'alipka', 'chloe126', 'nhan3', 'ghm918', 'axz244', 'kalindishah', 'alannahenry', 'alamens', 'sdv465', 'kdwoods', 'jpj917', 'trp982', 'gatesmeg', 'jennly', 'vraghunath', 'knp750', 'aoabraham', 'jdf478', 'moekou', 'sghelani', 'dwerickson', 'jsd713', 'patwood78', 'ddjrl', 'juliaretzky', 'jkzhou99', 'kegermann', 'bgerber', 'mdj146', 'mborba', 'hhass', 'martakulich', 'tkagadawala', 'ltu197', 'wchoi1025', 'brivard', 'ethanmcginnis2014', 'ktdutchman', 'bkurcz', 'vfa774', 'ncalta', 'danalec23', 'meshun11', 'amcgary', 'edsarah', 'jasminejones', 'vishyt123', 'abz881', 'samgbur', 'mz1030', 'mss647', 'jguitart', 'adriennedunk', 'nch964', 'srv123', 'rnorval', 'azeliko', 'mrossi14', 'spencermartens', 'sahartman4', 'lee9jo', 'markc', 'rch465', 'juliateresa1', 'alanpan', 'hopeandseema', 'nebiutadele', 'stephmandir', 'mjiang112', 'deboisbn', 'vwang92', 'bli', 'jlj592', 'jli', 'saxo', 'bmchanzit', 'hcm888', 'danielmcfarland', 'sarahjeong2014', 'vjh199', 'dmirtsching', 'jherzog', 'catherinealthaus', 'vcz359', 'jeliff7', 'esosdian', 'noliver97', 'nicolechem', 'amee', 'kevingreenhalgh2014', 'vog399', 'soh207', 'rjs374', 'abd892', 'benthemonkey', 'mwiersema', 'amlyniec', 'csilvestre', 'aramis16', 'matshu92', 'coreygoodwin', 'kpratt', 'lianggu91', 'bpg109', 'greed0812', 'bcarlis', 'bjr124', 'cms201', 'sydneyblack', 'ajm882', 'sharris', 'vickieotto', 'eeg951', 'lph854', 'twu', 'erica123', 'ebens', 'swa423', 'changbeeray', 'musiclover324', 'teresak', 'tak825', 'mkegermann', 'amandaziffer2014', 'mevans', 'tmengesha', 'kelseythom', 'jquinn825', 'chknfngers', 'graceminix', 'mrauf', 'jetzoh51', 'dac279', 'jyu3138', 'ewo304', 'alijoe2014', 'jwu525', 'eofferman', 'msh986', 'jboxman7', 'jmb489', 'keeleyjean86', 'mikejgleeson10', 'jsolis7', 'payasarraf1', 'vpp990', 'sem227', 'edp592', 'fjk562', 'hkw198', 'har580', 'hrendos', 'shj210', 'mmmccc', 'jgruszeczki', 'msistla46', 'jsh8', 'shaina_nano', 'gkoshelev', 'tan190', 'avanisingh1', 'bmsiwek', 'saracov726', 'bumpin8er', 'samtam', 'nicroth', 'jamesbhigdon', 'cosidari', 'annpowers', 'clairemelvin', 'dbali423', 'tweiner92', 'ras525', 'lae247', 'wenbinbin2010', 'tjw107', 'awalker6', 'kgu988', 'lslesur', 'ses457', 'rosemilavitz', 'rbraga25', 'kogden', 'lrl839', None, 'wizmaster', 'stingraymart1', 'cjanczak', 'cfeldhaus', 'smc895', 'hgf596', 'mhj872', 'atif24', 'crkramer', 'saraha', 'akantzos', 'harlynn14siler', 'simontj', 'eek735', 'yuliya12', 'amandafrankel2014', 'slhatch', 'giah', 'madelineschwid', 'kswann', 'johnandalex', 'kapoornu', 'sah285', 'kennedyq', 'zaraq', 'cskeehan', 'jds119', 'cberkowitz', 'hairandholman', 'sjl123', 'ecp899', 'ezaonegina', 'kgc375', 'kik101', 'markuline', 'lmsadowsky', 'kendrahertz2014', 'blai', 'dsh926', 'kayliepmiller', 'zil338', 'knk953', 'lamar0404', 'ksd948', 'msw466', 'gmv672', 'rmullen2', 'cdarin', 'cvickst14', 'pinararikan', 'jsierks2', 'meganghub', 'sunjaejung', 'the13thmachete', 'yzh199', 'tli132', 'jeffandrose', 'nehanimm', 'bhuang92', 'kalishah', 'charleyp', 'copperbeech1', 'nkj745', 'jkilcommons', 'amc480', 'mark123', 'zachkis', 'titosmith12', 'chriscappello', 'jtargos', 'dlrhksgud4', 'mwagner987', 'karenoreilly', 'arandle', 'btredz49', 'jocandkev', 'nulab24c', 'suekim2014', 'nchristo85', 'sam413', 'kes690', 'kconnors', 'sli674', 'eterzer', 'jcao618', 'landislandis', 'abbyroopali', 'lillian2011', 'alereyes', 'cwollaeger', 'ntp742', 'danielthomas2014', 'ath800', 'wsc826', 'gusdomel', 'dhw191', 'ggon03', 'chem1', 'ays976', 'benjaminrafshoon2014', 'johnpark8', 'mhartoun', 'kstclaire', 'chemistry1', 'vasanoah', 'shawnkim332', 'varshinicherukupalli', 'mdw994', 'sahopki', 'rchalmers', 'shadiasadaqa', 'arps714', 'jhk931', 'cmw897', 'amattias', 'kkenney', 'suziepeter', 'tjconsidine', 'robbie529', 'rgeiwitz', 'aarora', 'hbaker', 'shilliger']"
1,205,394,14,12,"['kpescadora', 'eweichmann', 'lmichelsen', 'arandle', 'jasminejones', 'saraha', 'knutecuk', 'sarahjeong2014', 'abz881', 'nehanimm', 'eek735', 'rchalmers']",382,"['dpfeffer', 'vmitra92', 'hitopgun', 'kkiani', 'sarahclark2014', 'nuchem', 'wiscorower', 'jki416', 'kmdoherty', 'phw454', 'bchanzit', 'lisamithun', 'jwoll1692', 'chem10232269', 'elisees', 'ipreston', 'zrs686', 'elinraun', 'sicelo', 'ignacioestrada', 'cthayer709', 'mweber', 'rgruenhagen', 'hct669', 'chc727', 'ssa886', 'nanolab218', 'dannyginz', 'jhuber', 'jherrera', 'tdupper', 'runningfreak21', 'pvonachen', 'cfirman', 'kegley', 'dannywinans', 'aqh681', 'yaejinpark2014', 'scoobidy', 'rossmac13', 'jkchem3', 'jpmccleary', 'kjh321', 'bhamilton', 'willworden', 'chiggins', 'mcm179', 'chancecim', 'cel156', 'sraiter', 'vincenthuang', 'jschultz57', 'njneil92', 'pthimsuwan5050', 'jbuser92', 'jpalarczyk', 'samhatfield', 'gusbus06', 'markbachrach', 'aspiegel', 'dmp556', 'chem102', 'xdi870', 'wngo', 'brockburdyl', 'mrauf13', 'jwchoi13', 'sonalid', 'jkoszela', 'nebiu', 'eap01', 'jpkmufc11', 'mollykbaker', 'meghan1', 'makanter', 'ccf165', 'sor427', 'rose', 'regit627', 'ecrystal', 'kwerling', 'johnmari', 'pdu937', 'arilederman', 'jeg770', 'alipka', 'chloe126', 'nhan3', 'ghm918', 'axz244', 'kalindishah', 'alannahenry', 'alamens', 'sdv465', 'kdwoods', 'jpj917', 'trp982', 'gatesmeg', 'jennly', 'vraghunath', 'knp750', 'aoabraham', 'jdf478', 'moekou', 'sghelani', 'dwerickson', 'jsd713', 'patwood78', 'ddjrl', 'juliaretzky', 'jkzhou99', 'kegermann', 'bgerber', 'mdj146', 'mborba', 'hhass', 'martakulich', 'tkagadawala', 'ltu197', 'wchoi1025', 'brivard', 'ethanmcginnis2014', 'ktdutchman', 'bkurcz', 'vfa774', 'ncalta', 'danalec23', 'meshun11', 'amcgary', 'edsarah', 'vishyt123', 'samgbur', 'mz1030', 'mss647', 'jguitart', 'adriennedunk', 'nch964', 'srv123', 'rnorval', 'azeliko', 'mrossi14', 'spencermartens', 'sahartman4', 'lee9jo', 'markc', 'rch465', 'juliateresa1', 'alanpan', 'hopeandseema', 'nebiutadele', 'stephmandir', 'mjiang112', 'deboisbn', 'vwang92', 'bli', 'jlj592', 'jli', 'saxo', 'hcm888', 'danielmcfarland', 'vjh199', 'dmirtsching', 'jherzog', 'catherinealthaus', 'vcz359', 'jeliff7', 'esosdian', 'noliver97', 'nicolechem', 'amee', 'kevingreenhalgh2014', 'vog399', 'soh207', 'rjs374', 'abd892', 'benthemonkey', 'mwiersema', 'amlyniec', 'csilvestre', 'aramis16', 'matshu92', 'coreygoodwin', 'kpratt', 'lianggu91', 'bpg109', 'greed0812', 'bcarlis', 'bjr124', 'cms201', 'sydneyblack', 'ajm882', 'sharris', 'vickieotto', 'eeg951', 'lph854', 'twu', 'erica123', 'ebens', 'changbeeray', 'musiclover324', 'teresak', 'tak825', 'mkegermann', 'amandaziffer2014', 'mevans', 'tmengesha', 'kelseythom', 'jquinn825', 'chknfngers', 'graceminix', 'mrauf', 'jetzoh51', 'dac279', 'jyu3138', 'ewo304', 'alijoe2014', 'jwu525', 'eofferman', 'msh986', 'jboxman7', 'jmb489', 'keeleyjean86', 'mikejgleeson10', 'jsolis7', 'payasarraf1', 'vpp990', 'sem227', 'edp592', 'fjk562', 'hkw198', 'har580', 'hrendos', 'shj210', 'mmmccc', 'jgruszeczki', 'msistla46', 'jsh8', 'shaina_nano', 'gkoshelev', 'tan190', 'avanisingh1', 'bmsiwek', 'saracov726', 'bumpin8er', 'samtam', 'nicroth', 'jamesbhigdon', 'cosidari', 'annpowers', 'clairemelvin', 'dbali423', 'tweiner92', 'ras525', 'lae247', 'wenbinbin2010', 'tjw107', 'awalker6', 'kgu988', 'lslesur', 'ses457', 'rosemilavitz', 'rbraga25', 'kogden', 'lrl839', 'wizmaster', 'stingraymart1', 'cjanczak', 'cfeldhaus', 'smc895', 'hgf596', 'mhj872', 'atif24', 'crkramer', 'akantzos', 'harlynn14siler', 'simontj', 'yuliya12', 'amandafrankel2014', 'slhatch', 'giah', 'madelineschwid', 'kswann', 'johnandalex', 'kapoornu', 'sah285', 'kennedyq', 'zaraq', 'cskeehan', 'jds119', 'cberkowitz', 'hairandholman', 'sjl123', 'ecp899', 'ezaonegina', 'kgc375', 'kik101', 'markuline', 'lmsadowsky', 'kendrahertz2014', 'blai', 'dsh926', 'kayliepmiller', 'zil338', 'knk953', 'lamar0404', 'ksd948', 'msw466', 'gmv672', 'rmullen2', 'cdarin', 'cvickst14', 'pinararikan', 'jsierks2', 'meganghub', 'sunjaejung', 'the13thmachete', 'yzh199', 'tli132', 'jeffandrose', 'bhuang92', 'kalishah', 'charleyp', 'copperbeech1', 'nkj745', 'jkilcommons', 'amc480', 'mark123', 'zachkis', 'titosmith12', 'chriscappello', 'jtargos', 'dlrhksgud4', 'mwagner987', 'karenoreilly', 'btredz49', 'jocandkev', 'nulab24c', 'suekim2014', 'nchristo85', 'sam413', 'kes690', 'kconnors', 'sli674', 'eterzer', 'jcao618', 'landislandis', 'abbyroopali', 'lillian2011', 'alereyes', 'cwollaeger', 'ntp742', 'danielthomas2014', 'ath800', 'wsc826', 'gusdomel', 'dhw191', 'ggon03', 'chem1', 'ays976', 'benjaminrafshoon2014', 'johnpark8', 'mhartoun', 'kstclaire', 'chemistry1', 'vasanoah', 'shawnkim332', 'varshinicherukupalli', 'mdw994', 'sahopki', 'shadiasadaqa', 'arps714', 'jhk931', 'cmw897', 'amattias', 'kkenney', 'suziepeter', 'tjconsidine', 'robbie529', 'rgeiwitz', 'aarora', 'hbaker', 'shilliger']",2,"[None, 'lmadison13']",396,"['eweichmann', 'dpfeffer', 'vmitra92', 'lmichelsen', 'hitopgun', 'kkiani', 'sarahclark2014', 'nuchem', 'wiscorower', 'jki416', 'kmdoherty', 'phw454', 'bchanzit', 'lisamithun', 'jwoll1692', 'chem10232269', 'elisees', 'ipreston', 'zrs686', 'elinraun', 'sicelo', 'ignacioestrada', 'cthayer709', 'mweber', 'rgruenhagen', 'hct669', 'chc727', 'ssa886', 'nanolab218', 'dannyginz', 'kpescadora', 'jhuber', 'jherrera', 'tdupper', 'knutecuk', 'runningfreak21', 'pvonachen', 'cfirman', 'kegley', 'dannywinans', 'aqh681', 'yaejinpark2014', 'scoobidy', 'rossmac13', 'jkchem3', 'jpmccleary', 'kjh321', 'bhamilton', 'willworden', 'chiggins', 'mcm179', 'chancecim', 'cel156', 'sraiter', 'vincenthuang', 'jschultz57', 'njneil92', 'pthimsuwan5050', 'jbuser92', 'jpalarczyk', 'samhatfield', 'gusbus06', 'markbachrach', 'aspiegel', 'dmp556', 'chem102', 'xdi870', 'wngo', 'brockburdyl', 'mrauf13', 'jwchoi13', 'sonalid', 'jkoszela', 'nebiu', 'eap01', 'jpkmufc11', 'mollykbaker', 'meghan1', 'makanter', 'ccf165', 'sor427', 'rose', 'regit627', 'ecrystal', 'kwerling', 'johnmari', 'pdu937', 'arilederman', 'jeg770', 'alipka', 'chloe126', 'nhan3', 'ghm918', 'axz244', 'kalindishah', 'alannahenry', 'alamens', 'sdv465', 'kdwoods', 'jpj917', 'trp982', 'gatesmeg', 'jennly', 'vraghunath', 'knp750', 'aoabraham', 'jdf478', 'moekou', 'sghelani', 'dwerickson', 'jsd713', 'patwood78', 'ddjrl', 'juliaretzky', 'jkzhou99', 'kegermann', 'bgerber', 'mdj146', 'mborba', 'hhass', 'martakulich', 'tkagadawala', 'ltu197', 'wchoi1025', 'brivard', 'ethanmcginnis2014', 'ktdutchman', 'bkurcz', 'vfa774', 'ncalta', 'danalec23', 'meshun11', 'amcgary', 'edsarah', 'jasminejones', 'vishyt123', 'abz881', 'samgbur', 'mz1030', 'mss647', 'jguitart', 'adriennedunk', 'nch964', 'srv123', 'rnorval', 'azeliko', 'mrossi14', 'spencermartens', 'sahartman4', 'lee9jo', 'markc', 'rch465', 'juliateresa1', 'alanpan', 'hopeandseema', 'nebiutadele', 'stephmandir', 'mjiang112', 'deboisbn', 'vwang92', 'bli', 'jlj592', 'jli', 'saxo', 'hcm888', 'danielmcfarland', 'sarahjeong2014', 'vjh199', 'dmirtsching', 'jherzog', 'catherinealthaus', 'vcz359', 'jeliff7', 'esosdian', 'noliver97', 'nicolechem', 'amee', 'kevingreenhalgh2014', 'vog399', 'soh207', 'rjs374', 'abd892', 'benthemonkey', 'mwiersema', 'amlyniec', 'csilvestre', 'aramis16', 'matshu92', 'coreygoodwin', 'kpratt', 'lianggu91', 'bpg109', 'greed0812', 'bcarlis', 'bjr124', 'cms201', 'sydneyblack', 'ajm882', 'sharris', 'vickieotto', 'eeg951', 'lph854', 'twu', 'erica123', 'ebens', 'changbeeray', 'musiclover324', 'teresak', 'tak825', 'mkegermann', 'amandaziffer2014', 'mevans', 'tmengesha', 'kelseythom', 'jquinn825', 'chknfngers', 'graceminix', 'mrauf', 'jetzoh51', 'dac279', 'jyu3138', 'ewo304', 'alijoe2014', 'jwu525', 'eofferman', 'msh986', 'jboxman7', 'jmb489', 'keeleyjean86', 'mikejgleeson10', 'jsolis7', 'payasarraf1', 'vpp990', 'sem227', 'edp592', 'fjk562', 'hkw198', 'har580', 'hrendos', 'shj210', 'mmmccc', 'jgruszeczki', 'msistla46', 'jsh8', 'shaina_nano', 'gkoshelev', 'tan190', 'avanisingh1', 'bmsiwek', 'saracov726', 'bumpin8er', 'samtam', 'nicroth', 'jamesbhigdon', 'cosidari', 'annpowers', 'clairemelvin', 'dbali423', 'tweiner92', 'ras525', 'lae247', 'wenbinbin2010', 'tjw107', 'awalker6', 'kgu988', 'lslesur', 'lmadison13', 'ses457', 'rosemilavitz', 'rbraga25', 'kogden', 'lrl839', None, 'wizmaster', 'stingraymart1', 'cjanczak', 'cfeldhaus', 'smc895', 'hgf596', 'mhj872', 'atif24', 'crkramer', 'saraha', 'akantzos', 'harlynn14siler', 'simontj', 'eek735', 'yuliya12', 'amandafrankel2014', 'slhatch', 'giah', 'madelineschwid', 'kswann', 'johnandalex', 'kapoornu', 'sah285', 'kennedyq', 'zaraq', 'cskeehan', 'jds119', 'cberkowitz', 'hairandholman', 'sjl123', 'ecp899', 'ezaonegina', 'kgc375', 'kik101', 'markuline', 'lmsadowsky', 'kendrahertz2014', 'blai', 'dsh926', 'kayliepmiller', 'zil338', 'knk953', 'lamar0404', 'ksd948', 'msw466', 'gmv672', 'rmullen2', 'cdarin', 'cvickst14', 'pinararikan', 'jsierks2', 'meganghub', 'sunjaejung', 'the13thmachete', 'yzh199', 'tli132', 'jeffandrose', 'nehanimm', 'bhuang92', 'kalishah', 'charleyp', 'copperbeech1', 'nkj745', 'jkilcommons', 'amc480', 'mark123', 'zachkis', 'titosmith12', 'chriscappello', 'jtargos', 'dlrhksgud4', 'mwagner987', 'karenoreilly', 'arandle', 'btredz49', 'jocandkev', 'nulab24c', 'suekim2014', 'nchristo85', 'sam413', 'kes690', 'kconnors', 'sli674', 'eterzer', 'jcao618', 'landislandis', 'abbyroopali', 'lillian2011', 'alereyes', 'cwollaeger', 'ntp742', 'danielthomas2014', 'ath800', 'wsc826', 'gusdomel', 'dhw191', 'ggon03', 'chem1', 'ays976', 'benjaminrafshoon2014', 'johnpark8', 'mhartoun', 'kstclaire', 'chemistry1', 'vasanoah', 'shawnkim332', 'varshinicherukupalli', 'mdw994', 'sahopki', 'rchalmers', 'shadiasadaqa', 'arps714', 'jhk931', 'cmw897', 'amattias', 'kkenney', 'suziepeter', 'tjconsidine', 'robbie529', 'rgeiwitz', 'aarora', 'hbaker', 'shilliger']"
1,202,394,10,1,['sicelo'],393,"['eweichmann', 'dpfeffer', 'vmitra92', 'lmichelsen', 'hitopgun', 'kkiani', 'sarahclark2014', 'nuchem', 'wiscorower', 'jki416', 'kmdoherty', 'phw454', 'bchanzit', 'lisamithun', 'jwoll1692', 'chem10232269', 'elisees', 'ipreston', 'zrs686', 'elinraun', 'ignacioestrada', 'cthayer709', 'mweber', 'rgruenhagen', 'hct669', 'chc727', 'ssa886', 'nanolab218', 'dannyginz', 'kpescadora', 'jhuber', 'jherrera', 'tdupper', 'knutecuk', 'runningfreak21', 'pvonachen', 'cfirman', 'kegley', 'dannywinans', 'aqh681', 'yaejinpark2014', 'scoobidy', 'rossmac13', 'jkchem3', 'jpmccleary', 'kjh321', 'bhamilton', 'willworden', 'chiggins', 'mcm179', 'chancecim', 'cel156', 'sraiter', 'vincenthuang', 'jschultz57', 'njneil92', 'pthimsuwan5050', 'jbuser92', 'jpalarczyk', 'samhatfield', 'gusbus06', 'markbachrach', 'aspiegel', 'dmp556', 'chem102', 'xdi870', 'wngo', 'brockburdyl', 'mrauf13', 'jwchoi13', 'sonalid', 'jkoszela', 'nebiu', 'eap01', 'jpkmufc11', 'mollykbaker', 'meghan1', 'makanter', 'ccf165', 'sor427', 'rose', 'regit627', 'ecrystal', 'kwerling', 'johnmari', 'pdu937', 'arilederman', 'jeg770', 'alipka', 'chloe126', 'nhan3', 'ghm918', 'axz244', 'kalindishah', 'alannahenry', 'alamens', 'sdv465', 'kdwoods', 'jpj917', 'trp982', 'gatesmeg', 'jennly', 'vraghunath', 'knp750', 'aoabraham', 'jdf478', 'moekou', 'sghelani', 'dwerickson', 'jsd713', 'patwood78', 'ddjrl', 'juliaretzky', 'jkzhou99', 'kegermann', 'bgerber', 'mdj146', 'mborba', 'hhass', 'martakulich', 'tkagadawala', 'ltu197', 'wchoi1025', 'brivard', 'ethanmcginnis2014', 'ktdutchman', 'bkurcz', 'vfa774', 'ncalta', 'danalec23', 'meshun11', 'amcgary', 'edsarah', 'jasminejones', 'vishyt123', 'abz881', 'samgbur', 'mz1030', 'mss647', 'jguitart', 'adriennedunk', 'nch964', 'srv123', 'rnorval', 'azeliko', 'mrossi14', 'spencermartens', 'sahartman4', 'lee9jo', 'markc', 'rch465', 'juliateresa1', 'alanpan', 'hopeandseema', 'nebiutadele', 'stephmandir', 'mjiang112', 'deboisbn', 'vwang92', 'bli', 'jlj592', 'jli', 'saxo', 'hcm888', 'danielmcfarland', 'sarahjeong2014', 'vjh199', 'dmirtsching', 'jherzog', 'catherinealthaus', 'vcz359', 'jeliff7', 'esosdian', 'noliver97', 'nicolechem', 'amee', 'kevingreenhalgh2014', 'vog399', 'soh207', 'rjs374', 'abd892', 'benthemonkey', 'mwiersema', 'amlyniec', 'csilvestre', 'aramis16', 'matshu92', 'coreygoodwin', 'kpratt', 'lianggu91', 'bpg109', 'greed0812', 'bcarlis', 'bjr124', 'cms201', 'sydneyblack', 'ajm882', 'sharris', 'vickieotto', 'eeg951', 'lph854', 'twu', 'erica123', 'ebens', 'changbeeray', 'musiclover324', 'teresak', 'tak825', 'mkegermann', 'amandaziffer2014', 'mevans', 'tmengesha', 'kelseythom', 'jquinn825', 'chknfngers', 'graceminix', 'mrauf', 'jetzoh51', 'dac279', 'jyu3138', 'ewo304', 'alijoe2014', 'jwu525', 'eofferman', 'msh986', 'jboxman7', 'jmb489', 'keeleyjean86', 'mikejgleeson10', 'jsolis7', 'payasarraf1', 'vpp990', 'sem227', 'edp592', 'fjk562', 'hkw198', 'har580', 'hrendos', 'shj210', 'mmmccc', 'jgruszeczki', 'msistla46', 'jsh8', 'shaina_nano', 'gkoshelev', 'tan190', 'avanisingh1', 'bmsiwek', 'saracov726', 'bumpin8er', 'samtam', 'nicroth', 'jamesbhigdon', 'cosidari', 'annpowers', 'clairemelvin', 'dbali423', 'tweiner92', 'ras525', 'lae247', 'wenbinbin2010', 'tjw107', 'awalker6', 'kgu988', 'lslesur', 'ses457', 'rosemilavitz', 'rbraga25', 'kogden', 'lrl839', 'wizmaster', 'stingraymart1', 'cjanczak', 'cfeldhaus', 'smc895', 'hgf596', 'mhj872', 'atif24', 'crkramer', 'saraha', 'akantzos', 'harlynn14siler', 'simontj', 'eek735', 'yuliya12', 'amandafrankel2014', 'slhatch', 'giah', 'madelineschwid', 'kswann', 'johnandalex', 'kapoornu', 'sah285', 'kennedyq', 'zaraq', 'cskeehan', 'jds119', 'cberkowitz', 'hairandholman', 'sjl123', 'ecp899', 'ezaonegina', 'kgc375', 'kik101', 'markuline', 'lmsadowsky', 'kendrahertz2014', 'blai', 'dsh926', 'kayliepmiller', 'zil338', 'knk953', 'lamar0404', 'ksd948', 'msw466', 'gmv672', 'rmullen2', 'cdarin', 'cvickst14', 'pinararikan', 'jsierks2', 'meganghub', 'sunjaejung', 'the13thmachete', 'yzh199', 'tli132', 'jeffandrose', 'nehanimm', 'bhuang92', 'kalishah', 'charleyp', 'copperbeech1', 'nkj745', 'jkilcommons', 'amc480', 'mark123', 'zachkis', 'titosmith12', 'chriscappello', 'jtargos', 'dlrhksgud4', 'mwagner987', 'karenoreilly', 'arandle', 'btredz49', 'jocandkev', 'nulab24c', 'suekim2014', 'nchristo85', 'sam413', 'kes690', 'kconnors', 'sli674', 'eterzer', 'jcao618', 'landislandis', 'abbyroopali', 'lillian2011', 'alereyes', 'cwollaeger', 'ntp742', 'danielthomas2014', 'ath800', 'wsc826', 'gusdomel', 'dhw191', 'ggon03', 'chem1', 'ays976', 'benjaminrafshoon2014', 'johnpark8', 'mhartoun', 'kstclaire', 'chemistry1', 'vasanoah', 'shawnkim332', 'varshinicherukupalli', 'mdw994', 'sahopki', 'rchalmers', 'shadiasadaqa', 'arps714', 'jhk931', 'cmw897', 'amattias', 'kkenney', 'suziepeter', 'tjconsidine', 'robbie529', 'rgeiwitz', 'aarora', 'hbaker', 'shilliger']",9,"['nvalley', 'gcutsail', 'scottydyar', 'lmadison13', 'koaruda', 'mshelby', None, 'whoff', 'nathaniel87']",403,"['eweichmann', 'dpfeffer', 'vmitra92', 'lmichelsen', 'hitopgun', 'kkiani', 'sarahclark2014', 'nuchem', 'wiscorower', 'jki416', 'kmdoherty', 'phw454', 'bchanzit', 'lisamithun', 'jwoll1692', 'chem10232269', 'elisees', 'ipreston', 'zrs686', 'elinraun', 'sicelo', 'ignacioestrada', 'cthayer709', 'mweber', 'rgruenhagen', 'hct669', 'chc727', 'ssa886', 'nanolab218', 'dannyginz', 'kpescadora', 'jhuber', 'jherrera', 'tdupper', 'knutecuk', 'runningfreak21', 'pvonachen', 'cfirman', 'kegley', 'dannywinans', 'aqh681', 'yaejinpark2014', 'scoobidy', 'rossmac13', 'jkchem3', 'jpmccleary', 'kjh321', 'bhamilton', 'willworden', 'chiggins', 'mcm179', 'chancecim', 'cel156', 'sraiter', 'vincenthuang', 'jschultz57', 'njneil92', 'pthimsuwan5050', 'jbuser92', 'jpalarczyk', 'samhatfield', 'gusbus06', 'markbachrach', 'aspiegel', 'dmp556', 'nvalley', 'gcutsail', 'chem102', 'xdi870', 'wngo', 'brockburdyl', 'koaruda', 'mrauf13', 'jwchoi13', 'sonalid', 'jkoszela', 'nebiu', 'eap01', 'jpkmufc11', 'mollykbaker', 'meghan1', 'makanter', 'ccf165', 'sor427', 'rose', 'regit627', 'ecrystal', 'kwerling', 'johnmari', 'pdu937', 'arilederman', 'jeg770', 'alipka', 'chloe126', 'nhan3', 'ghm918', 'axz244', 'kalindishah', 'alannahenry', 'alamens', 'sdv465', 'kdwoods', 'jpj917', 'trp982', 'gatesmeg', 'jennly', 'vraghunath', 'knp750', 'aoabraham', 'jdf478', 'moekou', 'sghelani', 'dwerickson', 'jsd713', 'patwood78', 'ddjrl', 'juliaretzky', 'jkzhou99', 'kegermann', 'bgerber', 'mdj146', 'mborba', 'hhass', 'martakulich', 'tkagadawala', 'ltu197', 'wchoi1025', 'brivard', 'ethanmcginnis2014', 'ktdutchman', 'bkurcz', 'vfa774', 'ncalta', 'danalec23', 'meshun11', 'amcgary', 'edsarah', 'jasminejones', 'vishyt123', 'abz881', 'samgbur', 'mz1030', 'mss647', 'jguitart', 'adriennedunk', 'nch964', 'srv123', 'rnorval', 'azeliko', 'mrossi14', 'spencermartens', 'sahartman4', 'lee9jo', 'markc', 'rch465', 'juliateresa1', 'alanpan', 'hopeandseema', 'nebiutadele', 'stephmandir', 'mjiang112', 'mshelby', 'deboisbn', 'vwang92', 'bli', 'jlj592', 'jli', 'saxo', 'hcm888', 'danielmcfarland', 'sarahjeong2014', 'vjh199', 'dmirtsching', 'jherzog', 'catherinealthaus', 'vcz359', 'jeliff7', 'esosdian', 'nathaniel87', 'noliver97', 'nicolechem', 'amee', 'kevingreenhalgh2014', 'vog399', 'soh207', 'rjs374', 'abd892', 'benthemonkey', 'mwiersema', 'amlyniec', 'csilvestre', 'aramis16', 'matshu92', 'coreygoodwin', 'kpratt', 'lianggu91', 'bpg109', 'greed0812', 'bcarlis', 'bjr124', 'cms201', 'sydneyblack', 'ajm882', 'sharris', 'vickieotto', 'eeg951', 'lph854', 'twu', 'erica123', 'ebens', 'changbeeray', 'musiclover324', 'teresak', 'tak825', 'mkegermann', 'amandaziffer2014', 'mevans', 'tmengesha', 'kelseythom', 'jquinn825', 'chknfngers', 'graceminix', 'mrauf', 'whoff', 'jetzoh51', 'dac279', 'jyu3138', 'ewo304', 'alijoe2014', 'jwu525', 'eofferman', 'msh986', 'jboxman7', 'jmb489', 'keeleyjean86', 'mikejgleeson10', 'jsolis7', 'payasarraf1', 'vpp990', 'sem227', 'edp592', 'fjk562', 'hkw198', 'har580', 'hrendos', 'shj210', 'mmmccc', 'jgruszeczki', 'msistla46', 'jsh8', 'shaina_nano', 'gkoshelev', 'tan190', 'avanisingh1', 'bmsiwek', 'saracov726', 'bumpin8er', 'samtam', 'nicroth', 'jamesbhigdon', 'cosidari', 'annpowers', 'clairemelvin', 'dbali423', 'tweiner92', 'ras525', 'lae247', 'wenbinbin2010', 'tjw107', 'awalker6', 'kgu988', 'scottydyar', 'lslesur', 'lmadison13', 'ses457', 'rosemilavitz', 'rbraga25', 'kogden', 'lrl839', None, 'wizmaster', 'stingraymart1', 'cjanczak', 'cfeldhaus', 'smc895', 'hgf596', 'mhj872', 'atif24', 'crkramer', 'saraha', 'akantzos', 'harlynn14siler', 'simontj', 'eek735', 'yuliya12', 'amandafrankel2014', 'slhatch', 'giah', 'madelineschwid', 'kswann', 'johnandalex', 'kapoornu', 'sah285', 'kennedyq', 'zaraq', 'cskeehan', 'jds119', 'cberkowitz', 'hairandholman', 'sjl123', 'ecp899', 'ezaonegina', 'kgc375', 'kik101', 'markuline', 'lmsadowsky', 'kendrahertz2014', 'blai', 'dsh926', 'kayliepmiller', 'zil338', 'knk953', 'lamar0404', 'ksd948', 'msw466', 'gmv672', 'rmullen2', 'cdarin', 'cvickst14', 'pinararikan', 'jsierks2', 'meganghub', 'sunjaejung', 'the13thmachete', 'yzh199', 'tli132', 'jeffandrose', 'nehanimm', 'bhuang92', 'kalishah', 'charleyp', 'copperbeech1', 'nkj745', 'jkilcommons', 'amc480', 'mark123', 'zachkis', 'titosmith12', 'chriscappello', 'jtargos', 'dlrhksgud4', 'mwagner987', 'karenoreilly', 'arandle', 'btredz49', 'jocandkev', 'nulab24c', 'suekim2014', 'nchristo85', 'sam413', 'kes690', 'kconnors', 'sli674', 'eterzer', 'jcao618', 'landislandis', 'abbyroopali', 'lillian2011', 'alereyes', 'cwollaeger', 'ntp742', 'danielthomas2014', 'ath800', 'wsc826', 'gusdomel', 'dhw191', 'ggon03', 'chem1', 'ays976', 'benjaminrafshoon2014', 'johnpark8', 'mhartoun', 'kstclaire', 'chemistry1', 'vasanoah', 'shawnkim332', 'varshinicherukupalli', 'mdw994', 'sahopki', 'rchalmers', 'shadiasadaqa', 'arps714', 'jhk931', 'cmw897', 'amattias', 'kkenney', 'suziepeter', 'tjconsidine', 'robbie529', 'rgeiwitz', 'aarora', 'hbaker', 'shilliger']"
1,206,394,7,1,['markuline'],393,"['eweichmann', 'dpfeffer', 'vmitra92', 'lmichelsen', 'hitopgun', 'kkiani', 'sarahclark2014', 'nuchem', 'wiscorower', 'jki416', 'kmdoherty', 'phw454', 'bchanzit', 'lisamithun', 'jwoll1692', 'chem10232269', 'elisees', 'ipreston', 'zrs686', 'elinraun', 'sicelo', 'ignacioestrada', 'cthayer709', 'mweber', 'rgruenhagen', 'hct669', 'chc727', 'ssa886', 'nanolab218', 'dannyginz', 'kpescadora', 'jhuber', 'jherrera', 'tdupper', 'knutecuk', 'runningfreak21', 'pvonachen', 'cfirman', 'kegley', 'dannywinans', 'aqh681', 'yaejinpark2014', 'scoobidy', 'rossmac13', 'jkchem3', 'jpmccleary', 'kjh321', 'bhamilton', 'willworden', 'chiggins', 'mcm179', 'chancecim', 'cel156', 'sraiter', 'vincenthuang', 'jschultz57', 'njneil92', 'pthimsuwan5050', 'jbuser92', 'jpalarczyk', 'samhatfield', 'gusbus06', 'markbachrach', 'aspiegel', 'dmp556', 'chem102', 'xdi870', 'wngo', 'brockburdyl', 'mrauf13', 'jwchoi13', 'sonalid', 'jkoszela', 'nebiu', 'eap01', 'jpkmufc11', 'mollykbaker', 'meghan1', 'makanter', 'ccf165', 'sor427', 'rose', 'regit627', 'ecrystal', 'kwerling', 'johnmari', 'pdu937', 'arilederman', 'jeg770', 'alipka', 'chloe126', 'nhan3', 'ghm918', 'axz244', 'kalindishah', 'alannahenry', 'alamens', 'sdv465', 'kdwoods', 'jpj917', 'trp982', 'gatesmeg', 'jennly', 'vraghunath', 'knp750', 'aoabraham', 'jdf478', 'moekou', 'sghelani', 'dwerickson', 'jsd713', 'patwood78', 'ddjrl', 'juliaretzky', 'jkzhou99', 'kegermann', 'bgerber', 'mdj146', 'mborba', 'hhass', 'martakulich', 'tkagadawala', 'ltu197', 'wchoi1025', 'brivard', 'ethanmcginnis2014', 'ktdutchman', 'bkurcz', 'vfa774', 'ncalta', 'danalec23', 'meshun11', 'amcgary', 'edsarah', 'jasminejones', 'vishyt123', 'abz881', 'samgbur', 'mz1030', 'mss647', 'jguitart', 'adriennedunk', 'nch964', 'srv123', 'rnorval', 'azeliko', 'mrossi14', 'spencermartens', 'sahartman4', 'lee9jo', 'markc', 'rch465', 'juliateresa1', 'alanpan', 'hopeandseema', 'nebiutadele', 'stephmandir', 'mjiang112', 'deboisbn', 'vwang92', 'bli', 'jlj592', 'jli', 'saxo', 'hcm888', 'danielmcfarland', 'sarahjeong2014', 'vjh199', 'dmirtsching', 'jherzog', 'catherinealthaus', 'vcz359', 'jeliff7', 'esosdian', 'noliver97', 'nicolechem', 'amee', 'kevingreenhalgh2014', 'vog399', 'soh207', 'rjs374', 'abd892', 'benthemonkey', 'mwiersema', 'amlyniec', 'csilvestre', 'aramis16', 'matshu92', 'coreygoodwin', 'kpratt', 'lianggu91', 'bpg109', 'greed0812', 'bcarlis', 'bjr124', 'cms201', 'sydneyblack', 'ajm882', 'sharris', 'vickieotto', 'eeg951', 'lph854', 'twu', 'erica123', 'ebens', 'changbeeray', 'musiclover324', 'teresak', 'tak825', 'mkegermann', 'amandaziffer2014', 'mevans', 'tmengesha', 'kelseythom', 'jquinn825', 'chknfngers', 'graceminix', 'mrauf', 'jetzoh51', 'dac279', 'jyu3138', 'ewo304', 'alijoe2014', 'jwu525', 'eofferman', 'msh986', 'jboxman7', 'jmb489', 'keeleyjean86', 'mikejgleeson10', 'jsolis7', 'payasarraf1', 'vpp990', 'sem227', 'edp592', 'fjk562', 'hkw198', 'har580', 'hrendos', 'shj210', 'mmmccc', 'jgruszeczki', 'msistla46', 'jsh8', 'shaina_nano', 'gkoshelev', 'tan190', 'avanisingh1', 'bmsiwek', 'saracov726', 'bumpin8er', 'samtam', 'nicroth', 'jamesbhigdon', 'cosidari', 'annpowers', 'clairemelvin', 'dbali423', 'tweiner92', 'ras525', 'lae247', 'wenbinbin2010', 'tjw107', 'awalker6', 'kgu988', 'lslesur', 'ses457', 'rosemilavitz', 'rbraga25', 'kogden', 'lrl839', 'wizmaster', 'stingraymart1', 'cjanczak', 'cfeldhaus', 'smc895', 'hgf596', 'mhj872', 'atif24', 'crkramer', 'saraha', 'akantzos', 'harlynn14siler', 'simontj', 'eek735', 'yuliya12', 'amandafrankel2014', 'slhatch', 'giah', 'madelineschwid', 'kswann', 'johnandalex', 'kapoornu', 'sah285', 'kennedyq', 'zaraq', 'cskeehan', 'jds119', 'cberkowitz', 'hairandholman', 'sjl123', 'ecp899', 'ezaonegina', 'kgc375', 'kik101', 'lmsadowsky', 'kendrahertz2014', 'blai', 'dsh926', 'kayliepmiller', 'zil338', 'knk953', 'lamar0404', 'ksd948', 'msw466', 'gmv672', 'rmullen2', 'cdarin', 'cvickst14', 'pinararikan', 'jsierks2', 'meganghub', 'sunjaejung', 'the13thmachete', 'yzh199', 'tli132', 'jeffandrose', 'nehanimm', 'bhuang92', 'kalishah', 'charleyp', 'copperbeech1', 'nkj745', 'jkilcommons', 'amc480', 'mark123', 'zachkis', 'titosmith12', 'chriscappello', 'jtargos', 'dlrhksgud4', 'mwagner987', 'karenoreilly', 'arandle', 'btredz49', 'jocandkev', 'nulab24c', 'suekim2014', 'nchristo85', 'sam413', 'kes690', 'kconnors', 'sli674', 'eterzer', 'jcao618', 'landislandis', 'abbyroopali', 'lillian2011', 'alereyes', 'cwollaeger', 'ntp742', 'danielthomas2014', 'ath800', 'wsc826', 'gusdomel', 'dhw191', 'ggon03', 'chem1', 'ays976', 'benjaminrafshoon2014', 'johnpark8', 'mhartoun', 'kstclaire', 'chemistry1', 'vasanoah', 'shawnkim332', 'varshinicherukupalli', 'mdw994', 'sahopki', 'rchalmers', 'shadiasadaqa', 'arps714', 'jhk931', 'cmw897', 'amattias', 'kkenney', 'suziepeter', 'tjconsidine', 'robbie529', 'rgeiwitz', 'aarora', 'hbaker', 'shilliger']",6,"['aes549', 'hmayes', 'dad587', 'stephy1204', 'ycolon1002', None]",400,"['eweichmann', 'dpfeffer', 'vmitra92', 'lmichelsen', 'hitopgun', 'kkiani', 'sarahclark2014', 'nuchem', 'wiscorower', 'jki416', 'kmdoherty', 'phw454', 'bchanzit', 'lisamithun', 'jwoll1692', 'chem10232269', 'elisees', 'ipreston', 'zrs686', 'elinraun', 'sicelo', 'ignacioestrada', 'cthayer709', 'mweber', 'rgruenhagen', 'hct669', 'chc727', 'ssa886', 'dad587', 'nanolab218', 'dannyginz', 'kpescadora', 'jhuber', 'jherrera', 'tdupper', 'knutecuk', 'runningfreak21', 'pvonachen', 'cfirman', 'kegley', 'dannywinans', 'aqh681', 'yaejinpark2014', 'scoobidy', 'rossmac13', 'jkchem3', 'jpmccleary', 'kjh321', 'bhamilton', 'willworden', 'chiggins', 'mcm179', 'chancecim', 'cel156', 'sraiter', 'vincenthuang', 'jschultz57', 'njneil92', 'pthimsuwan5050', 'jbuser92', 'jpalarczyk', 'samhatfield', 'gusbus06', 'markbachrach', 'aspiegel', 'dmp556', 'chem102', 'xdi870', 'wngo', 'stephy1204', 'brockburdyl', 'mrauf13', 'jwchoi13', 'sonalid', 'jkoszela', 'nebiu', 'eap01', 'jpkmufc11', 'mollykbaker', 'meghan1', 'makanter', 'ccf165', 'sor427', 'rose', 'regit627', 'ecrystal', 'kwerling', 'johnmari', 'pdu937', 'arilederman', 'jeg770', 'alipka', 'chloe126', 'nhan3', 'ghm918', 'axz244', 'kalindishah', 'alannahenry', 'alamens', 'sdv465', 'kdwoods', 'hmayes', 'jpj917', 'trp982', 'gatesmeg', 'jennly', 'vraghunath', 'knp750', 'aoabraham', 'jdf478', 'moekou', 'sghelani', 'dwerickson', 'jsd713', 'patwood78', 'ddjrl', 'juliaretzky', 'jkzhou99', 'kegermann', 'bgerber', 'mdj146', 'mborba', 'hhass', 'martakulich', 'tkagadawala', 'ltu197', 'wchoi1025', 'brivard', 'ethanmcginnis2014', 'ktdutchman', 'bkurcz', 'vfa774', 'ncalta', 'danalec23', 'meshun11', 'amcgary', 'edsarah', 'jasminejones', 'vishyt123', 'abz881', 'samgbur', 'mz1030', 'mss647', 'jguitart', 'adriennedunk', 'nch964', 'srv123', 'rnorval', 'azeliko', 'mrossi14', 'spencermartens', 'sahartman4', 'lee9jo', 'markc', 'rch465', 'juliateresa1', 'alanpan', 'hopeandseema', 'nebiutadele', 'stephmandir', 'mjiang112', 'deboisbn', 'vwang92', 'bli', 'jlj592', 'jli', 'saxo', 'hcm888', 'danielmcfarland', 'sarahjeong2014', 'vjh199', 'dmirtsching', 'jherzog', 'catherinealthaus', 'vcz359', 'jeliff7', 'esosdian', 'noliver97', 'nicolechem', 'amee', 'kevingreenhalgh2014', 'vog399', 'soh207', 'rjs374', 'abd892', 'benthemonkey', 'mwiersema', 'amlyniec', 'csilvestre', 'aramis16', 'matshu92', 'coreygoodwin', 'kpratt', 'lianggu91', 'bpg109', 'greed0812', 'bcarlis', 'bjr124', 'cms201', 'sydneyblack', 'ajm882', 'sharris', 'vickieotto', 'eeg951', 'lph854', 'twu', 'erica123', 'ebens', 'changbeeray', 'musiclover324', 'teresak', 'tak825', 'mkegermann', 'amandaziffer2014', 'mevans', 'tmengesha', 'kelseythom', 'jquinn825', 'chknfngers', 'graceminix', 'mrauf', 'jetzoh51', 'dac279', 'jyu3138', 'ewo304', 'alijoe2014', 'jwu525', 'eofferman', 'msh986', 'jboxman7', 'jmb489', 'keeleyjean86', 'mikejgleeson10', 'jsolis7', 'payasarraf1', 'vpp990', 'sem227', 'edp592', 'fjk562', 'hkw198', 'har580', 'hrendos', 'shj210', 'mmmccc', 'jgruszeczki', 'msistla46', 'jsh8', 'shaina_nano', 'gkoshelev', 'tan190', 'avanisingh1', 'bmsiwek', 'saracov726', 'bumpin8er', 'samtam', 'nicroth', 'jamesbhigdon', 'cosidari', 'annpowers', 'clairemelvin', 'dbali423', 'tweiner92', 'ras525', 'lae247', 'wenbinbin2010', 'tjw107', 'awalker6', 'kgu988', 'lslesur', 'ses457', 'rosemilavitz', 'rbraga25', 'kogden', 'lrl839', None, 'wizmaster', 'stingraymart1', 'cjanczak', 'cfeldhaus', 'smc895', 'hgf596', 'mhj872', 'atif24', 'crkramer', 'saraha', 'akantzos', 'harlynn14siler', 'simontj', 'eek735', 'yuliya12', 'amandafrankel2014', 'slhatch', 'giah', 'madelineschwid', 'kswann', 'aes549', 'johnandalex', 'kapoornu', 'sah285', 'kennedyq', 'zaraq', 'cskeehan', 'jds119', 'cberkowitz', 'hairandholman', 'sjl123', 'ecp899', 'ezaonegina', 'kgc375', 'kik101', 'markuline', 'lmsadowsky', 'kendrahertz2014', 'blai', 'dsh926', 'kayliepmiller', 'zil338', 'knk953', 'lamar0404', 'ksd948', 'msw466', 'gmv672', 'rmullen2', 'cdarin', 'cvickst14', 'pinararikan', 'jsierks2', 'meganghub', 'sunjaejung', 'the13thmachete', 'yzh199', 'tli132', 'jeffandrose', 'nehanimm', 'bhuang92', 'kalishah', 'charleyp', 'copperbeech1', 'nkj745', 'jkilcommons', 'amc480', 'mark123', 'zachkis', 'titosmith12', 'chriscappello', 'jtargos', 'dlrhksgud4', 'mwagner987', 'karenoreilly', 'arandle', 'btredz49', 'jocandkev', 'nulab24c', 'ycolon1002', 'suekim2014', 'nchristo85', 'sam413', 'kes690', 'kconnors', 'sli674', 'eterzer', 'jcao618', 'landislandis', 'abbyroopali', 'lillian2011', 'alereyes', 'cwollaeger', 'ntp742', 'danielthomas2014', 'ath800', 'wsc826', 'gusdomel', 'dhw191', 'ggon03', 'chem1', 'ays976', 'benjaminrafshoon2014', 'johnpark8', 'mhartoun', 'kstclaire', 'chemistry1', 'vasanoah', 'shawnkim332', 'varshinicherukupalli', 'mdw994', 'sahopki', 'rchalmers', 'shadiasadaqa', 'arps714', 'jhk931', 'cmw897', 'amattias', 'kkenney', 'suziepeter', 'tjconsidine', 'robbie529', 'rgeiwitz', 'aarora', 'hbaker', 'shilliger']"
1,166,394,6,4,"['suziepeter', 'pinararikan', 'gusdomel', 'jboxman7']",390,"['eweichmann', 'dpfeffer', 'vmitra92', 'lmichelsen', 'hitopgun', 'kkiani', 'sarahclark2014', 'nuchem', 'wiscorower', 'jki416', 'kmdoherty', 'phw454', 'bchanzit', 'lisamithun', 'jwoll1692', 'chem10232269', 'elisees', 'ipreston', 'zrs686', 'elinraun', 'sicelo', 'ignacioestrada', 'cthayer709', 'mweber', 'rgruenhagen', 'hct669', 'chc727', 'ssa886', 'nanolab218', 'dannyginz', 'kpescadora', 'jhuber', 'jherrera', 'tdupper', 'knutecuk', 'runningfreak21', 'pvonachen', 'cfirman', 'kegley', 'dannywinans', 'aqh681', 'yaejinpark2014', 'scoobidy', 'rossmac13', 'jkchem3', 'jpmccleary', 'kjh321', 'bhamilton', 'willworden', 'chiggins', 'mcm179', 'chancecim', 'cel156', 'sraiter', 'vincenthuang', 'jschultz57', 'njneil92', 'pthimsuwan5050', 'jbuser92', 'jpalarczyk', 'samhatfield', 'gusbus06', 'markbachrach', 'aspiegel', 'dmp556', 'chem102', 'xdi870', 'wngo', 'brockburdyl', 'mrauf13', 'jwchoi13', 'sonalid', 'jkoszela', 'nebiu', 'eap01', 'jpkmufc11', 'mollykbaker', 'meghan1', 'makanter', 'ccf165', 'sor427', 'rose', 'regit627', 'ecrystal', 'kwerling', 'johnmari', 'pdu937', 'arilederman', 'jeg770', 'alipka', 'chloe126', 'nhan3', 'ghm918', 'axz244', 'kalindishah', 'alannahenry', 'alamens', 'sdv465', 'kdwoods', 'jpj917', 'trp982', 'gatesmeg', 'jennly', 'vraghunath', 'knp750', 'aoabraham', 'jdf478', 'moekou', 'sghelani', 'dwerickson', 'jsd713', 'patwood78', 'ddjrl', 'juliaretzky', 'jkzhou99', 'kegermann', 'bgerber', 'mdj146', 'mborba', 'hhass', 'martakulich', 'tkagadawala', 'ltu197', 'wchoi1025', 'brivard', 'ethanmcginnis2014', 'ktdutchman', 'bkurcz', 'vfa774', 'ncalta', 'danalec23', 'meshun11', 'amcgary', 'edsarah', 'jasminejones', 'vishyt123', 'abz881', 'samgbur', 'mz1030', 'mss647', 'jguitart', 'adriennedunk', 'nch964', 'srv123', 'rnorval', 'azeliko', 'mrossi14', 'spencermartens', 'sahartman4', 'lee9jo', 'markc', 'rch465', 'juliateresa1', 'alanpan', 'hopeandseema', 'nebiutadele', 'stephmandir', 'mjiang112', 'deboisbn', 'vwang92', 'bli', 'jlj592', 'jli', 'saxo', 'hcm888', 'danielmcfarland', 'sarahjeong2014', 'vjh199', 'dmirtsching', 'jherzog', 'catherinealthaus', 'vcz359', 'jeliff7', 'esosdian', 'noliver97', 'nicolechem', 'amee', 'kevingreenhalgh2014', 'vog399', 'soh207', 'rjs374', 'abd892', 'benthemonkey', 'mwiersema', 'amlyniec', 'csilvestre', 'aramis16', 'matshu92', 'coreygoodwin', 'kpratt', 'lianggu91', 'bpg109', 'greed0812', 'bcarlis', 'bjr124', 'cms201', 'sydneyblack', 'ajm882', 'sharris', 'vickieotto', 'eeg951', 'lph854', 'twu', 'erica123', 'ebens', 'changbeeray', 'musiclover324', 'teresak', 'tak825', 'mkegermann', 'amandaziffer2014', 'mevans', 'tmengesha', 'kelseythom', 'jquinn825', 'chknfngers', 'graceminix', 'mrauf', 'jetzoh51', 'dac279', 'jyu3138', 'ewo304', 'alijoe2014', 'jwu525', 'eofferman', 'msh986', 'jmb489', 'keeleyjean86', 'mikejgleeson10', 'jsolis7', 'payasarraf1', 'vpp990', 'sem227', 'edp592', 'fjk562', 'hkw198', 'har580', 'hrendos', 'shj210', 'mmmccc', 'jgruszeczki', 'msistla46', 'jsh8', 'shaina_nano', 'gkoshelev', 'tan190', 'avanisingh1', 'bmsiwek', 'saracov726', 'bumpin8er', 'samtam', 'nicroth', 'jamesbhigdon', 'cosidari', 'annpowers', 'clairemelvin', 'dbali423', 'tweiner92', 'ras525', 'lae247', 'wenbinbin2010', 'tjw107', 'awalker6', 'kgu988', 'lslesur', 'ses457', 'rosemilavitz', 'rbraga25', 'kogden', 'lrl839', 'wizmaster', 'stingraymart1', 'cjanczak', 'cfeldhaus', 'smc895', 'hgf596', 'mhj872', 'atif24', 'crkramer', 'saraha', 'akantzos', 'harlynn14siler', 'simontj', 'eek735', 'yuliya12', 'amandafrankel2014', 'slhatch', 'giah', 'madelineschwid', 'kswann', 'johnandalex', 'kapoornu', 'sah285', 'kennedyq', 'zaraq', 'cskeehan', 'jds119', 'cberkowitz', 'hairandholman', 'sjl123', 'ecp899', 'ezaonegina', 'kgc375', 'kik101', 'markuline', 'lmsadowsky', 'kendrahertz2014', 'blai', 'dsh926', 'kayliepmiller', 'zil338', 'knk953', 'lamar0404', 'ksd948', 'msw466', 'gmv672', 'rmullen2', 'cdarin', 'cvickst14', 'jsierks2', 'meganghub', 'sunjaejung', 'the13thmachete', 'yzh199', 'tli132', 'jeffandrose', 'nehanimm', 'bhuang92', 'kalishah', 'charleyp', 'copperbeech1', 'nkj745', 'jkilcommons', 'amc480', 'mark123', 'zachkis', 'titosmith12', 'chriscappello', 'jtargos', 'dlrhksgud4', 'mwagner987', 'karenoreilly', 'arandle', 'btredz49', 'jocandkev', 'nulab24c', 'suekim2014', 'nchristo85', 'sam413', 'kes690', 'kconnors', 'sli674', 'eterzer', 'jcao618', 'landislandis', 'abbyroopali', 'lillian2011', 'alereyes', 'cwollaeger', 'ntp742', 'danielthomas2014', 'ath800', 'wsc826', 'dhw191', 'ggon03', 'chem1', 'ays976', 'benjaminrafshoon2014', 'johnpark8', 'mhartoun', 'kstclaire', 'chemistry1', 'vasanoah', 'shawnkim332', 'varshinicherukupalli', 'mdw994', 'sahopki', 'rchalmers', 'shadiasadaqa', 'arps714', 'jhk931', 'cmw897', 'amattias', 'kkenney', 'tjconsidine', 'robbie529', 'rgeiwitz', 'aarora', 'hbaker', 'shilliger']",2,"['lwint', None]",396,"['eweichmann', 'dpfeffer', 'vmitra92', 'lmichelsen', 'hitopgun', 'kkiani', 'sarahclark2014', 'nuchem', 'wiscorower', 'jki416', 'kmdoherty', 'phw454', 'bchanzit', 'lisamithun', 'jwoll1692', 'chem10232269', 'elisees', 'ipreston', 'zrs686', 'elinraun', 'sicelo', 'ignacioestrada', 'cthayer709', 'mweber', 'rgruenhagen', 'hct669', 'chc727', 'ssa886', 'nanolab218', 'dannyginz', 'kpescadora', 'jhuber', 'jherrera', 'tdupper', 'knutecuk', 'runningfreak21', 'pvonachen', 'cfirman', 'kegley', 'dannywinans', 'aqh681', 'yaejinpark2014', 'scoobidy', 'rossmac13', 'jkchem3', 'jpmccleary', 'kjh321', 'bhamilton', 'willworden', 'chiggins', 'mcm179', 'chancecim', 'cel156', 'sraiter', 'vincenthuang', 'jschultz57', 'njneil92', 'pthimsuwan5050', 'jbuser92', 'jpalarczyk', 'samhatfield', 'gusbus06', 'markbachrach', 'aspiegel', 'dmp556', 'chem102', 'xdi870', 'wngo', 'brockburdyl', 'mrauf13', 'jwchoi13', 'sonalid', 'jkoszela', 'nebiu', 'eap01', 'jpkmufc11', 'mollykbaker', 'meghan1', 'makanter', 'ccf165', 'sor427', 'rose', 'regit627', 'ecrystal', 'kwerling', 'johnmari', 'pdu937', 'arilederman', 'jeg770', 'alipka', 'chloe126', 'nhan3', 'ghm918', 'axz244', 'kalindishah', 'alannahenry', 'alamens', 'sdv465', 'kdwoods', 'jpj917', 'trp982', 'gatesmeg', 'jennly', 'vraghunath', 'knp750', 'aoabraham', 'jdf478', 'moekou', 'sghelani', 'dwerickson', 'jsd713', 'patwood78', 'ddjrl', 'juliaretzky', 'jkzhou99', 'kegermann', 'bgerber', 'mdj146', 'mborba', 'hhass', 'martakulich', 'tkagadawala', 'ltu197', 'wchoi1025', 'brivard', 'ethanmcginnis2014', 'ktdutchman', 'bkurcz', 'vfa774', 'ncalta', 'danalec23', 'meshun11', 'amcgary', 'edsarah', 'jasminejones', 'vishyt123', 'abz881', 'samgbur', 'mz1030', 'mss647', 'jguitart', 'adriennedunk', 'nch964', 'srv123', 'rnorval', 'azeliko', 'mrossi14', 'spencermartens', 'sahartman4', 'lee9jo', 'markc', 'rch465', 'juliateresa1', 'alanpan', 'hopeandseema', 'nebiutadele', 'stephmandir', 'mjiang112', 'deboisbn', 'vwang92', 'bli', 'jlj592', 'jli', 'saxo', 'hcm888', 'danielmcfarland', 'sarahjeong2014', 'vjh199', 'dmirtsching', 'jherzog', 'catherinealthaus', 'vcz359', 'jeliff7', 'esosdian', 'noliver97', 'nicolechem', 'amee', 'kevingreenhalgh2014', 'vog399', 'soh207', 'rjs374', 'abd892', 'benthemonkey', 'mwiersema', 'amlyniec', 'csilvestre', 'aramis16', 'matshu92', 'coreygoodwin', 'kpratt', 'lianggu91', 'bpg109', 'greed0812', 'bcarlis', 'bjr124', 'cms201', 'sydneyblack', 'ajm882', 'sharris', 'vickieotto', 'eeg951', 'lph854', 'twu', 'erica123', 'ebens', 'changbeeray', 'musiclover324', 'lwint', 'teresak', 'tak825', 'mkegermann', 'amandaziffer2014', 'mevans', 'tmengesha', 'kelseythom', 'jquinn825', 'chknfngers', 'graceminix', 'mrauf', 'jetzoh51', 'dac279', 'jyu3138', 'ewo304', 'alijoe2014', 'jwu525', 'eofferman', 'msh986', 'jboxman7', 'jmb489', 'keeleyjean86', 'mikejgleeson10', 'jsolis7', 'payasarraf1', 'vpp990', 'sem227', 'edp592', 'fjk562', 'hkw198', 'har580', 'hrendos', 'shj210', 'mmmccc', 'jgruszeczki', 'msistla46', 'jsh8', 'shaina_nano', 'gkoshelev', 'tan190', 'avanisingh1', 'bmsiwek', 'saracov726', 'bumpin8er', 'samtam', 'nicroth', 'jamesbhigdon', 'cosidari', 'annpowers', 'clairemelvin', 'dbali423', 'tweiner92', 'ras525', 'lae247', 'wenbinbin2010', 'tjw107', 'awalker6', 'kgu988', 'lslesur', 'ses457', 'rosemilavitz', 'rbraga25', 'kogden', 'lrl839', None, 'wizmaster', 'stingraymart1', 'cjanczak', 'cfeldhaus', 'smc895', 'hgf596', 'mhj872', 'atif24', 'crkramer', 'saraha', 'akantzos', 'harlynn14siler', 'simontj', 'eek735', 'yuliya12', 'amandafrankel2014', 'slhatch', 'giah', 'madelineschwid', 'kswann', 'johnandalex', 'kapoornu', 'sah285', 'kennedyq', 'zaraq', 'cskeehan', 'jds119', 'cberkowitz', 'hairandholman', 'sjl123', 'ecp899', 'ezaonegina', 'kgc375', 'kik101', 'markuline', 'lmsadowsky', 'kendrahertz2014', 'blai', 'dsh926', 'kayliepmiller', 'zil338', 'knk953', 'lamar0404', 'ksd948', 'msw466', 'gmv672', 'rmullen2', 'cdarin', 'cvickst14', 'pinararikan', 'jsierks2', 'meganghub', 'sunjaejung', 'the13thmachete', 'yzh199', 'tli132', 'jeffandrose', 'nehanimm', 'bhuang92', 'kalishah', 'charleyp', 'copperbeech1', 'nkj745', 'jkilcommons', 'amc480', 'mark123', 'zachkis', 'titosmith12', 'chriscappello', 'jtargos', 'dlrhksgud4', 'mwagner987', 'karenoreilly', 'arandle', 'btredz49', 'jocandkev', 'nulab24c', 'suekim2014', 'nchristo85', 'sam413', 'kes690', 'kconnors', 'sli674', 'eterzer', 'jcao618', 'landislandis', 'abbyroopali', 'lillian2011', 'alereyes', 'cwollaeger', 'ntp742', 'danielthomas2014', 'ath800', 'wsc826', 'gusdomel', 'dhw191', 'ggon03', 'chem1', 'ays976', 'benjaminrafshoon2014', 'johnpark8', 'mhartoun', 'kstclaire', 'chemistry1', 'vasanoah', 'shawnkim332', 'varshinicherukupalli', 'mdw994', 'sahopki', 'rchalmers', 'shadiasadaqa', 'arps714', 'jhk931', 'cmw897', 'amattias', 'kkenney', 'suziepeter', 'tjconsidine', 'robbie529', 'rgeiwitz', 'aarora', 'hbaker', 'shilliger']"
2,37,134,116,86,"['balistic2', 'hipaulshi', 'bpatzin2', 'cardena2', 'kim325', 'beugels1', 'shook2', 'photoyub', 'boehle2', 'phoenix_0510', 'jortiz125', 'wicky', 'mmenon3', 'beran1', 'crazycai', 'ericcj21', 'johnso49', 'barlaz', 'wrubrec2', 'keramat1', 'kocek1', 'marchevskiy', 'spitula2', 'lilgoose3', 'moruzi1', 'mast5', 'daiyuan1991', 'nahsor', 'akusan', 'fahim89', 'komo', 'forcejedi', 'capota2', 'kejacs', 'baruin2', 'fedorov1', 'tsteige2', 'richers1', 'robert25', 'meagher1', 'eshanso', 'will07c5', 'cheng78', 'horvat1', 'liu141', 'schlude1', 'rareearth', 'huilinng', 'healy4', 'shin34', 'cpwalsh2', 'nanto1', 'divito3', 'scholl1', 'rmuryan2', 'eszato', 'icfmi90', 'gomez14', 'rishi_ratan', 'chan47', 'skyzzm', 'willspringzhang', 'chinvet1', 'felipealonso1', 'hamburger123', 'karlsino', 'rmahaja2', 'djtanaka', 'cschan3', 'diablopbc', 'tuoliu1', 'squeeksrocks', 'pyropenguinx', 'kazi1', 'megarza2', 'cvendi2', 'yc_ng', 'uppal1', 'stacey2', 'xu34', 'pay1', 'kbliu46', 'niyingkan', 'tmurray5', 'bhuiya1', 'cjhughes17']",47,"['mus423', 'cjsmile', 'foo5', 'drmalkovich', 'nammari1', 'dluzen3', 'bertbusdriver', 'pcrutch2', 'tmalone3', 'crzftx', 'maoshouse', 'stoddar1', 'saima1', 'perng2', 'cheeloh1', 'beaver1128', 'jsun31', 'tungdo1', 'tbvance', 'gheimbe2', 'dgrocho2', 'hsu16', 'akshat1521', 'echo781', 'tohms19', 'suchko1', 'artus1', 'geneyu2', 'bobbit1', 'zhimin', 'liu7979', 'mcarney2', 'snowpd', 'dongdong', 'hillebr1', 'darkhelmet2346', 'gkx39', 'ammarfaris', 'dhruvbhatia7', 'cthayer3', 'cyanrook', 'lumiao88', 'tonyli1', 'sixgallon', 'frost1', 'swaffor1', 'aneavil2']",30,"['shuzhongyou', 'nikunjk', 'fthis', 'ren6', 'aviraljain12', 'skorets2', 'lu34', 'trongtong', 'ededens', 'japheth', 'ragunat1', 'ray4', 'suyagya', 'liangyaning', 'amit13012001', 'albertczc', 'vik579', 'peterk8', 'kurtovi1', 'rohanamin', 'simon6', None, 'tgorti', 'chen128', 'shin65', 'jclee9', 'faorlando', 'starring', 'chen95', 'ambrood']",163,"['balistic2', 'hipaulshi', 'fthis', 'bpatzin2', 'cardena2', 'kim325', 'beugels1', 'ededens', 'amit13012001', 'shook2', 'saima1', 'photoyub', 'perng2', 'cheeloh1', 'boehle2', 'phoenix_0510', 'jortiz125', 'wicky', 'mmenon3', 'beran1', 'zhimin', 'liu7979', 'rohanamin', 'crazycai', 'ericcj21', 'johnso49', 'wrubrec2', 'barlaz', 'chen95', 'tonyli1', 'frost1', 'keramat1', 'kocek1', 'shuzhongyou', 'marchevskiy', 'nikunjk', 'mus423', 'spitula2', 'aviraljain12', 'foo5', 'bertbusdriver', 'lilgoose3', 'japheth', 'pcrutch2', 'moruzi1', 'mast5', 'ragunat1', 'ray4', 'stoddar1', 'daiyuan1991', 'nahsor', 'akusan', 'echo781', 'fahim89', 'tohms19', 'suchko1', 'komo', 'geneyu2', 'forcejedi', 'capota2', 'kejacs', None, 'tgorti', 'baruin2', 'ammarfaris', 'fedorov1', 'tsteige2', 'lumiao88', 'richers1', 'ambrood', 'robert25', 'aneavil2', 'hsu16', 'meagher1', 'eshanso', 'will07c5', 'cheng78', 'cjsmile', 'horvat1', 'liu141', 'schlude1', 'ren6', 'drmalkovich', 'rareearth', 'dluzen3', 'lu34', 'huilinng', 'healy4', 'trongtong', 'tmalone3', 'shin34', 'maoshouse', 'albertczc', 'beaver1128', 'nanto1', 'cpwalsh2', 'eszato', 'scholl1', 'akshat1521', 'divito3', 'rmuryan2', 'icfmi90', 'gomez14', 'artus1', 'rishi_ratan', 'chan47', 'skyzzm', 'peterk8', 'willspringzhang', 'chinvet1', 'mcarney2', 'snowpd', 'darkhelmet2346', 'chen128', 'felipealonso1', 'gkx39', 'shin65', 'jclee9', 'starring', 'sixgallon', 'hamburger123', 'karlsino', 'rmahaja2', 'djtanaka', 'cschan3', 'skorets2', 'nammari1', 'diablopbc', 'tuoliu1', 'squeeksrocks', 'pyropenguinx', 'kazi1', 'suyagya', 'liangyaning', 'megarza2', 'crzftx', 'cvendi2', 'jsun31', 'tungdo1', 'tbvance', 'gheimbe2', 'dgrocho2', 'uppal1', 'yc_ng', 'vik579', 'stacey2', 'bobbit1', 'kurtovi1', 'simon6', 'dongdong', 'xu34', 'pay1', 'hillebr1', 'kbliu46', 'niyingkan', 'dhruvbhatia7', 'tmurray5', 'faorlando', 'bhuiya1', 'cthayer3', 'cyanrook', 'cjhughes17', 'swaffor1']"
2,132,134,97,77,"['hipaulshi', 'bpatzin2', 'cardena2', 'kim325', 'beugels1', 'shook2', 'perng2', 'photoyub', 'boehle2', 'phoenix_0510', 'jortiz125', 'mmenon3', 'ericcj21', 'barlaz', 'tonyli1', 'keramat1', 'kocek1', 'bertbusdriver', 'lilgoose3', 'moruzi1', 'mast5', 'daiyuan1991', 'nahsor', 'akusan', 'echo781', 'fahim89', 'suchko1', 'capota2', 'kejacs', 'baruin2', 'ammarfaris', 'fedorov1', 'tsteige2', 'richers1', 'robert25', 'meagher1', 'eshanso', 'cheng78', 'horvat1', 'liu141', 'healy4', 'shin34', 'cpwalsh2', 'nanto1', 'divito3', 'scholl1', 'rmuryan2', 'eszato', 'akshat1521', 'chan47', 'skyzzm', 'willspringzhang', 'chinvet1', 'mcarney2', 'darkhelmet2346', 'gkx39', 'hamburger123', 'karlsino', 'rmahaja2', 'djtanaka', 'cschan3', 'nammari1', 'tuoliu1', 'squeeksrocks', 'kazi1', 'megarza2', 'cvendi2', 'jsun31', 'tungdo1', 'yc_ng', 'uppal1', 'stacey2', 'hillebr1', 'kbliu46', 'tmurray5', 'bhuiya1', 'cjhughes17']",56,"['balistic2', 'will07c5', 'marchevskiy', 'mus423', 'cjsmile', 'spitula2', 'schlude1', 'foo5', 'drmalkovich', 'rareearth', 'dluzen3', 'diablopbc', 'huilinng', 'pyropenguinx', 'pcrutch2', 'tmalone3', 'crzftx', 'maoshouse', 'stoddar1', 'saima1', 'cheeloh1', 'beaver1128', 'tbvance', 'gheimbe2', 'dgrocho2', 'hsu16', 'icfmi90', 'wicky', 'tohms19', 'gomez14', 'komo', 'geneyu2', 'artus1', 'rishi_ratan', 'forcejedi', 'bobbit1', 'beran1', 'zhimin', 'liu7979', 'snowpd', 'dongdong', 'xu34', 'pay1', 'felipealonso1', 'niyingkan', 'crazycai', 'dhruvbhatia7', 'cthayer3', 'johnso49', 'cyanrook', 'wrubrec2', 'lumiao88', 'sixgallon', 'frost1', 'swaffor1', 'aneavil2']",20,"['yuanyao3', 'joseph6', 'ren6', 'lu34', 'artonis7', 'japheth', 'mohamed', 'albertczc', 'philip', 'vik579', 'kurtovi1', 'rohanamin', 'simon6', None, 'tgorti', 'chen128', 'shin65', 'starring', 'chen95', 'ambrood']",153,"['balistic2', 'hipaulshi', 'joseph6', 'bpatzin2', 'cardena2', 'kim325', 'beugels1', 'artonis7', 'shook2', 'saima1', 'photoyub', 'perng2', 'cheeloh1', 'boehle2', 'phoenix_0510', 'philip', 'jortiz125', 'wicky', 'mmenon3', 'beran1', 'zhimin', 'liu7979', 'rohanamin', 'crazycai', 'ericcj21', 'johnso49', 'wrubrec2', 'barlaz', 'chen95', 'tonyli1', 'frost1', 'keramat1', 'kocek1', 'marchevskiy', 'mus423', 'spitula2', 'foo5', 'bertbusdriver', 'lilgoose3', 'japheth', 'pcrutch2', 'moruzi1', 'mast5', 'mohamed', 'stoddar1', 'daiyuan1991', 'nahsor', 'akusan', 'echo781', 'fahim89', 'tohms19', 'suchko1', 'komo', 'geneyu2', 'forcejedi', 'capota2', 'kejacs', None, 'tgorti', 'baruin2', 'ammarfaris', 'fedorov1', 'tsteige2', 'lumiao88', 'richers1', 'ambrood', 'robert25', 'aneavil2', 'hsu16', 'meagher1', 'eshanso', 'will07c5', 'cheng78', 'cjsmile', 'horvat1', 'liu141', 'schlude1', 'ren6', 'drmalkovich', 'rareearth', 'dluzen3', 'lu34', 'huilinng', 'healy4', 'tmalone3', 'shin34', 'maoshouse', 'albertczc', 'beaver1128', 'nanto1', 'cpwalsh2', 'eszato', 'scholl1', 'akshat1521', 'divito3', 'rmuryan2', 'icfmi90', 'gomez14', 'artus1', 'rishi_ratan', 'chan47', 'skyzzm', 'willspringzhang', 'chinvet1', 'mcarney2', 'snowpd', 'darkhelmet2346', 'chen128', 'felipealonso1', 'gkx39', 'shin65', 'starring', 'sixgallon', 'hamburger123', 'karlsino', 'rmahaja2', 'djtanaka', 'yuanyao3', 'cschan3', 'nammari1', 'diablopbc', 'tuoliu1', 'squeeksrocks', 'pyropenguinx', 'kazi1', 'megarza2', 'crzftx', 'cvendi2', 'jsun31', 'tungdo1', 'tbvance', 'gheimbe2', 'dgrocho2', 'uppal1', 'yc_ng', 'vik579', 'stacey2', 'bobbit1', 'kurtovi1', 'simon6', 'dongdong', 'xu34', 'pay1', 'hillebr1', 'kbliu46', 'niyingkan', 'dhruvbhatia7', 'tmurray5', 'bhuiya1', 'cthayer3', 'cyanrook', 'cjhughes17', 'swaffor1']"
2,81,134,88,74,"['kocek1', 'meagher1', 'hamburger123', 'eshanso', 'hipaulshi', 'cheng78', 'rmahaja2', 'horvat1', 'djtanaka', 'liu141', 'cschan3', 'schlude1', 'bpatzin2', 'cardena2', 'drmalkovich', 'dluzen3', 'nammari1', 'healy4', 'kim325', 'squeeksrocks', 'pyropenguinx', 'moruzi1', 'tmalone3', 'shin34', 'mast5', 'kazi1', 'saima1', 'cvendi2', 'daiyuan1991', 'boehle2', 'cpwalsh2', 'nanto1', 'jsun31', 'nahsor', 'tungdo1', 'akusan', 'divito3', 'phoenix_0510', 'eszato', 'echo781', 'rmuryan2', 'fahim89', 'jortiz125', 'akshat1521', 'icfmi90', 'mmenon3', 'rishi_ratan', 'geneyu2', 'uppal1', 'skyzzm', 'forcejedi', 'stacey2', 'beran1', 'mcarney2', 'snowpd', 'capota2', 'kejacs', 'pay1', 'kbliu46', 'baruin2', 'dhruvbhatia7', 'crazycai', 'fedorov1', 'tmurray5', 'bhuiya1', 'cthayer3', 'ericcj21', 'johnso49', 'barlaz', 'frost1', 'cjhughes17', 'keramat1', 'robert25', 'aneavil2']",59,"['balistic2', 'karlsino', 'will07c5', 'marchevskiy', 'mus423', 'cjsmile', 'spitula2', 'foo5', 'rareearth', 'diablopbc', 'bertbusdriver', 'huilinng', 'beugels1', 'tuoliu1', 'lilgoose3', 'pcrutch2', 'megarza2', 'crzftx', 'shook2', 'stoddar1', 'maoshouse', 'photoyub', 'perng2', 'cheeloh1', 'beaver1128', 'tbvance', 'gheimbe2', 'dgrocho2', 'yc_ng', 'scholl1', 'wicky', 'tohms19', 'suchko1', 'komo', 'gomez14', 'artus1', 'chan47', 'bobbit1', 'willspringzhang', 'zhimin', 'liu7979', 'chinvet1', 'dongdong', 'xu34', 'hillebr1', 'darkhelmet2346', 'felipealonso1', 'gkx39', 'ammarfaris', 'niyingkan', 'tsteige2', 'cyanrook', 'wrubrec2', 'lumiao88', 'tonyli1', 'sixgallon', 'richers1', 'swaffor1', 'hsu16']",14,"['shin65', 'vik579', 'starring', 'chen95', 'yuanyao3', 'drake5', 'joseph6', 'guo31', 'leiyang1', 'kurtovi1', 'albertczc', 'lu34', None, 'tgorti']",147,"['balistic2', 'hipaulshi', 'joseph6', 'bpatzin2', 'cardena2', 'kim325', 'beugels1', 'shook2', 'saima1', 'photoyub', 'perng2', 'cheeloh1', 'boehle2', 'phoenix_0510', 'jortiz125', 'wicky', 'mmenon3', 'beran1', 'zhimin', 'liu7979', 'crazycai', 'ericcj21', 'johnso49', 'wrubrec2', 'barlaz', 'chen95', 'tonyli1', 'frost1', 'keramat1', 'kocek1', 'marchevskiy', 'mus423', 'spitula2', 'drake5', 'foo5', 'bertbusdriver', 'lilgoose3', 'pcrutch2', 'moruzi1', 'mast5', 'stoddar1', 'daiyuan1991', 'nahsor', 'akusan', 'echo781', 'fahim89', 'tohms19', 'suchko1', 'komo', 'geneyu2', 'forcejedi', 'capota2', 'kejacs', None, 'tgorti', 'baruin2', 'ammarfaris', 'fedorov1', 'tsteige2', 'lumiao88', 'richers1', 'robert25', 'aneavil2', 'hsu16', 'meagher1', 'eshanso', 'will07c5', 'cheng78', 'cjsmile', 'horvat1', 'liu141', 'schlude1', 'drmalkovich', 'rareearth', 'dluzen3', 'lu34', 'huilinng', 'healy4', 'tmalone3', 'shin34', 'maoshouse', 'albertczc', 'beaver1128', 'nanto1', 'cpwalsh2', 'eszato', 'scholl1', 'akshat1521', 'divito3', 'rmuryan2', 'icfmi90', 'gomez14', 'artus1', 'rishi_ratan', 'chan47', 'skyzzm', 'willspringzhang', 'chinvet1', 'mcarney2', 'snowpd', 'darkhelmet2346', 'felipealonso1', 'gkx39', 'shin65', 'starring', 'sixgallon', 'guo31', 'hamburger123', 'karlsino', 'rmahaja2', 'djtanaka', 'yuanyao3', 'cschan3', 'nammari1', 'diablopbc', 'tuoliu1', 'squeeksrocks', 'pyropenguinx', 'kazi1', 'leiyang1', 'megarza2', 'crzftx', 'cvendi2', 'jsun31', 'tungdo1', 'tbvance', 'gheimbe2', 'dgrocho2', 'uppal1', 'yc_ng', 'vik579', 'stacey2', 'bobbit1', 'kurtovi1', 'dongdong', 'xu34', 'pay1', 'hillebr1', 'kbliu46', 'niyingkan', 'dhruvbhatia7', 'tmurray5', 'bhuiya1', 'cthayer3', 'cyanrook', 'cjhughes17', 'swaffor1']"
2,60,134,86,66,"['kocek1', 'hamburger123', 'karlsino', 'eshanso', 'hipaulshi', 'horvat1', 'cschan3', 'bpatzin2', 'cardena2', 'dluzen3', 'diablopbc', 'healy4', 'kim325', 'squeeksrocks', 'pyropenguinx', 'moruzi1', 'kazi1', 'megarza2', 'crzftx', 'saima1', 'photoyub', 'daiyuan1991', 'cpwalsh2', 'nanto1', 'jsun31', 'gheimbe2', 'nahsor', 'akusan', 'eszato', 'akshat1521', 'rmuryan2', 'echo781', 'yc_ng', 'fahim89', 'gomez14', 'mmenon3', 'suchko1', 'komo', 'stacey2', 'skyzzm', 'forcejedi', 'beran1', 'zhimin', 'willspringzhang', 'chinvet1', 'capota2', 'xu34', 'kejacs', 'hillebr1', 'pay1', 'kbliu46', 'baruin2', 'ammarfaris', 'gkx39', 'niyingkan', 'dhruvbhatia7', 'bhuiya1', 'tsteige2', 'ericcj21', 'johnso49', 'barlaz', 'lumiao88', 'frost1', 'cjhughes17', 'keramat1', 'robert25']",67,"['balistic2', 'meagher1', 'will07c5', 'marchevskiy', 'mus423', 'cheng78', 'cjsmile', 'rmahaja2', 'djtanaka', 'spitula2', 'liu141', 'schlude1', 'foo5', 'drmalkovich', 'nammari1', 'rareearth', 'bertbusdriver', 'huilinng', 'beugels1', 'tuoliu1', 'lilgoose3', 'pcrutch2', 'tmalone3', 'shin34', 'mast5', 'shook2', 'stoddar1', 'maoshouse', 'perng2', 'cheeloh1', 'boehle2', 'beaver1128', 'cvendi2', 'tungdo1', 'tbvance', 'dgrocho2', 'divito3', 'phoenix_0510', 'hsu16', 'scholl1', 'uppal1', 'icfmi90', 'jortiz125', 'wicky', 'tohms19', 'artus1', 'geneyu2', 'rishi_ratan', 'chan47', 'bobbit1', 'liu7979', 'mcarney2', 'snowpd', 'dongdong', 'darkhelmet2346', 'felipealonso1', 'crazycai', 'fedorov1', 'tmurray5', 'cthayer3', 'cyanrook', 'wrubrec2', 'tonyli1', 'sixgallon', 'richers1', 'swaffor1', 'aneavil2']",20,"['shuzhongyou', 'zhong8', 'drake5', 'mewyn', 'ren6', 'aviraljain12', 'lu34', 'artonis7', 'trongtong', 'shao11', 'suyagya', 'albertczc', 'philip', 'rdowdy2', 'kurtovi1', None, 'tgorti', 'shin65', 'ealmeid2', 'chen95']",153,"['balistic2', 'hipaulshi', 'bpatzin2', 'cardena2', 'kim325', 'beugels1', 'artonis7', 'shook2', 'saima1', 'photoyub', 'perng2', 'cheeloh1', 'boehle2', 'phoenix_0510', 'philip', 'rdowdy2', 'jortiz125', 'wicky', 'mmenon3', 'beran1', 'zhimin', 'liu7979', 'crazycai', 'ealmeid2', 'ericcj21', 'johnso49', 'wrubrec2', 'barlaz', 'chen95', 'tonyli1', 'frost1', 'keramat1', 'kocek1', 'shuzhongyou', 'marchevskiy', 'mus423', 'spitula2', 'drake5', 'mewyn', 'aviraljain12', 'foo5', 'bertbusdriver', 'lilgoose3', 'pcrutch2', 'moruzi1', 'mast5', 'stoddar1', 'daiyuan1991', 'nahsor', 'akusan', 'echo781', 'fahim89', 'tohms19', 'suchko1', 'komo', 'geneyu2', 'forcejedi', 'capota2', 'kejacs', None, 'tgorti', 'baruin2', 'ammarfaris', 'fedorov1', 'tsteige2', 'lumiao88', 'richers1', 'robert25', 'aneavil2', 'hsu16', 'meagher1', 'eshanso', 'will07c5', 'zhong8', 'cheng78', 'cjsmile', 'horvat1', 'liu141', 'schlude1', 'ren6', 'drmalkovich', 'rareearth', 'dluzen3', 'lu34', 'huilinng', 'healy4', 'trongtong', 'tmalone3', 'shin34', 'maoshouse', 'albertczc', 'beaver1128', 'nanto1', 'cpwalsh2', 'eszato', 'scholl1', 'akshat1521', 'divito3', 'rmuryan2', 'icfmi90', 'gomez14', 'artus1', 'rishi_ratan', 'chan47', 'skyzzm', 'willspringzhang', 'chinvet1', 'mcarney2', 'snowpd', 'darkhelmet2346', 'felipealonso1', 'gkx39', 'shin65', 'sixgallon', 'hamburger123', 'karlsino', 'rmahaja2', 'djtanaka', 'cschan3', 'nammari1', 'diablopbc', 'tuoliu1', 'squeeksrocks', 'pyropenguinx', 'shao11', 'kazi1', 'suyagya', 'megarza2', 'crzftx', 'cvendi2', 'jsun31', 'tungdo1', 'tbvance', 'gheimbe2', 'dgrocho2', 'uppal1', 'yc_ng', 'stacey2', 'bobbit1', 'kurtovi1', 'dongdong', 'xu34', 'pay1', 'hillebr1', 'kbliu46', 'niyingkan', 'dhruvbhatia7', 'tmurray5', 'bhuiya1', 'cthayer3', 'cyanrook', 'cjhughes17', 'swaffor1']"
2,115,134,38,3,"['nanto1', 'bertbusdriver', 'shin34']",130,"['balistic2', 'hipaulshi', 'cardena2', 'bpatzin2', 'kim325', 'beugels1', 'shook2', 'saima1', 'photoyub', 'perng2', 'cheeloh1', 'boehle2', 'phoenix_0510', 'jortiz125', 'wicky', 'mmenon3', 'beran1', 'zhimin', 'liu7979', 'crazycai', 'ericcj21', 'johnso49', 'wrubrec2', 'barlaz', 'tonyli1', 'frost1', 'keramat1', 'kocek1', 'marchevskiy', 'mus423', 'spitula2', 'foo5', 'lilgoose3', 'pcrutch2', 'moruzi1', 'mast5', 'stoddar1', 'daiyuan1991', 'nahsor', 'akusan', 'echo781', 'fahim89', 'tohms19', 'suchko1', 'komo', 'geneyu2', 'forcejedi', 'capota2', 'kejacs', 'baruin2', 'ammarfaris', 'fedorov1', 'tsteige2', 'lumiao88', 'richers1', 'robert25', 'hsu16', 'aneavil2', 'meagher1', 'eshanso', 'will07c5', 'cheng78', 'cjsmile', 'horvat1', 'liu141', 'schlude1', 'drmalkovich', 'rareearth', 'dluzen3', 'huilinng', 'healy4', 'tmalone3', 'maoshouse', 'beaver1128', 'cpwalsh2', 'eszato', 'scholl1', 'akshat1521', 'divito3', 'rmuryan2', 'icfmi90', 'gomez14', 'artus1', 'rishi_ratan', 'chan47', 'skyzzm', 'willspringzhang', 'chinvet1', 'mcarney2', 'snowpd', 'darkhelmet2346', 'felipealonso1', 'gkx39', 'sixgallon', 'hamburger123', 'karlsino', 'rmahaja2', 'djtanaka', 'cschan3', 'nammari1', 'diablopbc', 'tuoliu1', 'squeeksrocks', 'pyropenguinx', 'kazi1', 'megarza2', 'crzftx', 'cvendi2', 'jsun31', 'tungdo1', 'tbvance', 'gheimbe2', 'dgrocho2', 'uppal1', 'yc_ng', 'stacey2', 'bobbit1', 'dongdong', 'xu34', 'pay1', 'hillebr1', 'kbliu46', 'niyingkan', 'dhruvbhatia7', 'tmurray5', 'bhuiya1', 'cthayer3', 'cyanrook', 'cjhughes17', 'swaffor1']",35,"['skung2', 'navdeep3000', 'johnwonlim', 'semeraroln', 'wilson19881229', 'drmeyer87', 'simpson5', 'aguzman4', 'chavali1', 'tmishra3', 'shao11', 'harring4', 'styoisworo', 'profballack', 'modeng1', 'karnik202', 'blee51', 'promemorex', 'hd89c', 'aan8008', 'pwang25', 'winoto2', 'liu155', None, 'jaina2', 'dass1', 'alark2', 'chen95', 'yjongmin', 'jackchai', 'chenqian1024', 'pranavsharma9', 'aamikam', 'uribe6', 'wenyang1']",168,"['balistic2', 'hipaulshi', 'wilson19881229', 'drmeyer87', 'bpatzin2', 'cardena2', 'kim325', 'beugels1', 'tmishra3', 'shook2', 'saima1', 'photoyub', 'perng2', 'cheeloh1', 'boehle2', 'phoenix_0510', 'promemorex', 'jortiz125', 'wicky', 'mmenon3', 'beran1', 'zhimin', 'liu7979', 'dass1', 'crazycai', 'ericcj21', 'johnso49', 'wrubrec2', 'barlaz', 'alark2', 'tonyli1', 'chen95', 'jackchai', 'frost1', 'keramat1', 'kocek1', 'skung2', 'marchevskiy', 'mus423', 'spitula2', 'foo5', 'bertbusdriver', 'lilgoose3', 'pcrutch2', 'moruzi1', 'profballack', 'mast5', 'stoddar1', 'daiyuan1991', 'karnik202', 'nahsor', 'akusan', 'echo781', 'fahim89', 'tohms19', 'suchko1', 'komo', 'geneyu2', 'forcejedi', 'capota2', 'kejacs', None, 'jaina2', 'baruin2', 'ammarfaris', 'fedorov1', 'tsteige2', 'lumiao88', 'pranavsharma9', 'richers1', 'robert25', 'aneavil2', 'hsu16', 'meagher1', 'eshanso', 'will07c5', 'cheng78', 'cjsmile', 'horvat1', 'liu141', 'schlude1', 'simpson5', 'drmalkovich', 'rareearth', 'dluzen3', 'huilinng', 'healy4', 'chavali1', 'aguzman4', 'tmalone3', 'shin34', 'maoshouse', 'beaver1128', 'nanto1', 'cpwalsh2', 'eszato', 'scholl1', 'akshat1521', 'divito3', 'rmuryan2', 'icfmi90', 'blee51', 'gomez14', 'artus1', 'rishi_ratan', 'chan47', 'skyzzm', 'aan8008', 'winoto2', 'willspringzhang', 'chinvet1', 'mcarney2', 'snowpd', 'liu155', 'darkhelmet2346', 'felipealonso1', 'gkx39', 'sixgallon', 'chenqian1024', 'aamikam', 'wenyang1', 'hamburger123', 'karlsino', 'navdeep3000', 'rmahaja2', 'djtanaka', 'cschan3', 'semeraroln', 'johnwonlim', 'nammari1', 'diablopbc', 'tuoliu1', 'squeeksrocks', 'pyropenguinx', 'shao11', 'harring4', 'styoisworo', 'kazi1', 'megarza2', 'crzftx', 'modeng1', 'cvendi2', 'jsun31', 'tungdo1', 'tbvance', 'gheimbe2', 'dgrocho2', 'uppal1', 'yc_ng', 'stacey2', 'hd89c', 'pwang25', 'bobbit1', 'dongdong', 'xu34', 'pay1', 'hillebr1', 'kbliu46', 'niyingkan', 'dhruvbhatia7', 'tmurray5', 'bhuiya1', 'cthayer3', 'cyanrook', 'yjongmin', 'uribe6', 'cjhughes17', 'swaffor1']"
2,84,134,28,25,"['karlsino', 'djtanaka', 'huilinng', 'tuoliu1', 'pcrutch2', 'tmalone3', 'crzftx', 'cheeloh1', 'beaver1128', 'gheimbe2', 'gomez14', 'komo', 'bobbit1', 'chinvet1', 'mcarney2', 'pay1', 'darkhelmet2346', 'felipealonso1', 'niyingkan', 'fedorov1', 'tsteige2', 'johnso49', 'richers1', 'swaffor1', 'hsu16']",108,"['balistic2', 'hipaulshi', 'bpatzin2', 'cardena2', 'kim325', 'beugels1', 'shook2', 'saima1', 'photoyub', 'perng2', 'boehle2', 'phoenix_0510', 'jortiz125', 'wicky', 'mmenon3', 'beran1', 'zhimin', 'liu7979', 'crazycai', 'ericcj21', 'wrubrec2', 'barlaz', 'tonyli1', 'frost1', 'keramat1', 'kocek1', 'marchevskiy', 'mus423', 'spitula2', 'foo5', 'bertbusdriver', 'lilgoose3', 'moruzi1', 'mast5', 'stoddar1', 'daiyuan1991', 'nahsor', 'akusan', 'echo781', 'fahim89', 'tohms19', 'suchko1', 'geneyu2', 'forcejedi', 'capota2', 'kejacs', 'baruin2', 'ammarfaris', 'lumiao88', 'robert25', 'aneavil2', 'meagher1', 'eshanso', 'will07c5', 'cheng78', 'cjsmile', 'horvat1', 'liu141', 'schlude1', 'drmalkovich', 'rareearth', 'dluzen3', 'healy4', 'shin34', 'maoshouse', 'nanto1', 'cpwalsh2', 'eszato', 'scholl1', 'akshat1521', 'divito3', 'rmuryan2', 'icfmi90', 'artus1', 'rishi_ratan', 'chan47', 'skyzzm', 'willspringzhang', 'snowpd', 'gkx39', 'sixgallon', 'hamburger123', 'rmahaja2', 'cschan3', 'nammari1', 'diablopbc', 'squeeksrocks', 'pyropenguinx', 'kazi1', 'megarza2', 'cvendi2', 'jsun31', 'tungdo1', 'tbvance', 'dgrocho2', 'uppal1', 'yc_ng', 'stacey2', 'dongdong', 'xu34', 'hillebr1', 'kbliu46', 'dhruvbhatia7', 'tmurray5', 'bhuiya1', 'cthayer3', 'cyanrook', 'cjhughes17']",3,"['trongtong', None, 'wanglee1']",136,"['balistic2', 'hipaulshi', 'bpatzin2', 'cardena2', 'kim325', 'beugels1', 'shook2', 'saima1', 'photoyub', 'perng2', 'cheeloh1', 'boehle2', 'phoenix_0510', 'jortiz125', 'wicky', 'mmenon3', 'beran1', 'zhimin', 'liu7979', 'crazycai', 'ericcj21', 'johnso49', 'wrubrec2', 'barlaz', 'tonyli1', 'frost1', 'keramat1', 'kocek1', 'marchevskiy', 'mus423', 'spitula2', 'foo5', 'bertbusdriver', 'lilgoose3', 'pcrutch2', 'wanglee1', 'moruzi1', 'mast5', 'stoddar1', 'daiyuan1991', 'nahsor', 'akusan', 'echo781', 'fahim89', 'tohms19', 'suchko1', 'komo', 'geneyu2', 'forcejedi', 'capota2', 'kejacs', None, 'baruin2', 'ammarfaris', 'fedorov1', 'tsteige2', 'lumiao88', 'richers1', 'robert25', 'aneavil2', 'hsu16', 'meagher1', 'eshanso', 'will07c5', 'cheng78', 'cjsmile', 'horvat1', 'liu141', 'schlude1', 'drmalkovich', 'rareearth', 'dluzen3', 'huilinng', 'healy4', 'trongtong', 'tmalone3', 'shin34', 'maoshouse', 'beaver1128', 'nanto1', 'cpwalsh2', 'eszato', 'scholl1', 'akshat1521', 'divito3', 'rmuryan2', 'icfmi90', 'gomez14', 'artus1', 'rishi_ratan', 'chan47', 'skyzzm', 'willspringzhang', 'chinvet1', 'mcarney2', 'snowpd', 'darkhelmet2346', 'felipealonso1', 'gkx39', 'sixgallon', 'hamburger123', 'karlsino', 'rmahaja2', 'djtanaka', 'cschan3', 'nammari1', 'diablopbc', 'tuoliu1', 'squeeksrocks', 'pyropenguinx', 'kazi1', 'megarza2', 'crzftx', 'cvendi2', 'jsun31', 'tungdo1', 'tbvance', 'gheimbe2', 'dgrocho2', 'uppal1', 'yc_ng', 'stacey2', 'bobbit1', 'dongdong', 'xu34', 'pay1', 'hillebr1', 'kbliu46', 'niyingkan', 'dhruvbhatia7', 'tmurray5', 'bhuiya1', 'cthayer3', 'cyanrook', 'cjhughes17', 'swaffor1']"
2,134,134,25,20,"['spitula2', 'foo5', 'drmalkovich', 'huilinng', 'pcrutch2', 'tmalone3', 'crzftx', 'cheeloh1', 'beaver1128', 'gheimbe2', 'yc_ng', 'komo', 'snowpd', 'pay1', 'felipealonso1', 'ammarfaris', 'johnso49', 'sixgallon', 'swaffor1', 'hsu16']",113,"['balistic2', 'hipaulshi', 'bpatzin2', 'cardena2', 'kim325', 'beugels1', 'shook2', 'saima1', 'photoyub', 'perng2', 'boehle2', 'phoenix_0510', 'jortiz125', 'wicky', 'mmenon3', 'beran1', 'zhimin', 'liu7979', 'crazycai', 'ericcj21', 'wrubrec2', 'barlaz', 'tonyli1', 'frost1', 'keramat1', 'kocek1', 'marchevskiy', 'mus423', 'bertbusdriver', 'lilgoose3', 'moruzi1', 'mast5', 'stoddar1', 'daiyuan1991', 'nahsor', 'akusan', 'echo781', 'fahim89', 'tohms19', 'suchko1', 'geneyu2', 'forcejedi', 'capota2', 'kejacs', 'baruin2', 'fedorov1', 'tsteige2', 'lumiao88', 'richers1', 'robert25', 'aneavil2', 'meagher1', 'eshanso', 'will07c5', 'cheng78', 'cjsmile', 'horvat1', 'liu141', 'schlude1', 'rareearth', 'dluzen3', 'healy4', 'shin34', 'maoshouse', 'nanto1', 'cpwalsh2', 'eszato', 'scholl1', 'akshat1521', 'divito3', 'rmuryan2', 'icfmi90', 'gomez14', 'artus1', 'rishi_ratan', 'chan47', 'skyzzm', 'willspringzhang', 'chinvet1', 'mcarney2', 'darkhelmet2346', 'gkx39', 'hamburger123', 'karlsino', 'rmahaja2', 'djtanaka', 'cschan3', 'nammari1', 'diablopbc', 'tuoliu1', 'squeeksrocks', 'pyropenguinx', 'kazi1', 'megarza2', 'cvendi2', 'jsun31', 'tungdo1', 'tbvance', 'dgrocho2', 'uppal1', 'stacey2', 'bobbit1', 'dongdong', 'xu34', 'hillebr1', 'kbliu46', 'niyingkan', 'dhruvbhatia7', 'tmurray5', 'bhuiya1', 'cthayer3', 'cyanrook', 'cjhughes17']",5,"['liu76', 'skorets2', 'mkchow5913', None, 'zsyrobin']",138,"['balistic2', 'hipaulshi', 'bpatzin2', 'cardena2', 'mkchow5913', 'kim325', 'beugels1', 'shook2', 'saima1', 'photoyub', 'perng2', 'cheeloh1', 'boehle2', 'zsyrobin', 'phoenix_0510', 'jortiz125', 'wicky', 'mmenon3', 'beran1', 'zhimin', 'liu7979', 'crazycai', 'ericcj21', 'johnso49', 'wrubrec2', 'barlaz', 'tonyli1', 'frost1', 'keramat1', 'kocek1', 'marchevskiy', 'mus423', 'spitula2', 'foo5', 'bertbusdriver', 'lilgoose3', 'pcrutch2', 'moruzi1', 'mast5', 'stoddar1', 'daiyuan1991', 'nahsor', 'akusan', 'echo781', 'fahim89', 'tohms19', 'suchko1', 'komo', 'geneyu2', 'forcejedi', 'capota2', 'kejacs', None, 'baruin2', 'ammarfaris', 'fedorov1', 'tsteige2', 'lumiao88', 'richers1', 'robert25', 'aneavil2', 'hsu16', 'meagher1', 'eshanso', 'will07c5', 'cheng78', 'cjsmile', 'horvat1', 'liu141', 'schlude1', 'drmalkovich', 'rareearth', 'dluzen3', 'huilinng', 'healy4', 'tmalone3', 'shin34', 'maoshouse', 'beaver1128', 'nanto1', 'cpwalsh2', 'eszato', 'scholl1', 'akshat1521', 'divito3', 'rmuryan2', 'icfmi90', 'gomez14', 'artus1', 'rishi_ratan', 'chan47', 'skyzzm', 'willspringzhang', 'chinvet1', 'mcarney2', 'snowpd', 'darkhelmet2346', 'felipealonso1', 'gkx39', 'sixgallon', 'hamburger123', 'karlsino', 'rmahaja2', 'djtanaka', 'cschan3', 'skorets2', 'nammari1', 'diablopbc', 'tuoliu1', 'squeeksrocks', 'pyropenguinx', 'kazi1', 'megarza2', 'crzftx', 'cvendi2', 'jsun31', 'tungdo1', 'tbvance', 'gheimbe2', 'dgrocho2', 'uppal1', 'yc_ng', 'liu76', 'stacey2', 'bobbit1', 'dongdong', 'xu34', 'pay1', 'hillebr1', 'kbliu46', 'niyingkan', 'dhruvbhatia7', 'tmurray5', 'bhuiya1', 'cthayer3', 'cyanrook', 'cjhughes17', 'swaffor1']"
2,63,134,24,11,"['divito3', 'crazycai', 'will07c5', 'cthayer3', 'icfmi90', 'geneyu2', 'chan47', 'tonyli1', 'maoshouse', 'stoddar1', 'aneavil2']",122,"['balistic2', 'hipaulshi', 'bpatzin2', 'cardena2', 'kim325', 'beugels1', 'shook2', 'saima1', 'photoyub', 'perng2', 'cheeloh1', 'boehle2', 'phoenix_0510', 'jortiz125', 'wicky', 'mmenon3', 'beran1', 'zhimin', 'liu7979', 'ericcj21', 'johnso49', 'wrubrec2', 'barlaz', 'frost1', 'keramat1', 'kocek1', 'marchevskiy', 'mus423', 'spitula2', 'foo5', 'bertbusdriver', 'lilgoose3', 'pcrutch2', 'moruzi1', 'mast5', 'daiyuan1991', 'nahsor', 'akusan', 'echo781', 'fahim89', 'tohms19', 'suchko1', 'komo', 'forcejedi', 'capota2', 'kejacs', 'baruin2', 'ammarfaris', 'fedorov1', 'tsteige2', 'lumiao88', 'richers1', 'robert25', 'hsu16', 'meagher1', 'eshanso', 'cheng78', 'cjsmile', 'horvat1', 'liu141', 'schlude1', 'drmalkovich', 'rareearth', 'dluzen3', 'huilinng', 'healy4', 'tmalone3', 'shin34', 'beaver1128', 'nanto1', 'cpwalsh2', 'eszato', 'scholl1', 'akshat1521', 'rmuryan2', 'gomez14', 'artus1', 'rishi_ratan', 'skyzzm', 'willspringzhang', 'chinvet1', 'mcarney2', 'snowpd', 'darkhelmet2346', 'felipealonso1', 'gkx39', 'sixgallon', 'hamburger123', 'karlsino', 'rmahaja2', 'djtanaka', 'cschan3', 'nammari1', 'diablopbc', 'tuoliu1', 'squeeksrocks', 'pyropenguinx', 'kazi1', 'megarza2', 'crzftx', 'cvendi2', 'jsun31', 'tungdo1', 'tbvance', 'gheimbe2', 'dgrocho2', 'uppal1', 'yc_ng', 'stacey2', 'bobbit1', 'dongdong', 'xu34', 'pay1', 'hillebr1', 'kbliu46', 'niyingkan', 'dhruvbhatia7', 'tmurray5', 'bhuiya1', 'cyanrook', 'cjhughes17', 'swaffor1']",13,"['spribble', 'nbauer087', 'knuts003', 'thom0876', 'cbahr2005', 'jackwenner', 'willg001', 'silver104', 'jmarti', 'gnarly_dana', None, 'chrisowens', 'gnarlytoast']",146,"['balistic2', 'hipaulshi', 'bpatzin2', 'cardena2', 'kim325', 'beugels1', 'shook2', 'saima1', 'photoyub', 'perng2', 'cheeloh1', 'boehle2', 'gnarlytoast', 'phoenix_0510', 'jortiz125', 'wicky', 'mmenon3', 'beran1', 'zhimin', 'liu7979', 'jmarti', 'gnarly_dana', 'spribble', 'crazycai', 'ericcj21', 'johnso49', 'wrubrec2', 'barlaz', 'tonyli1', 'frost1', 'willg001', 'keramat1', 'kocek1', 'marchevskiy', 'mus423', 'spitula2', 'foo5', 'bertbusdriver', 'lilgoose3', 'pcrutch2', 'moruzi1', 'mast5', 'stoddar1', 'daiyuan1991', 'nahsor', 'akusan', 'echo781', 'fahim89', 'tohms19', 'suchko1', 'komo', 'geneyu2', 'forcejedi', 'capota2', 'kejacs', None, 'baruin2', 'ammarfaris', 'fedorov1', 'tsteige2', 'lumiao88', 'richers1', 'robert25', 'chrisowens', 'aneavil2', 'hsu16', 'meagher1', 'eshanso', 'will07c5', 'nbauer087', 'cheng78', 'cjsmile', 'horvat1', 'liu141', 'jackwenner', 'schlude1', 'drmalkovich', 'rareearth', 'dluzen3', 'huilinng', 'healy4', 'thom0876', 'tmalone3', 'shin34', 'cbahr2005', 'maoshouse', 'beaver1128', 'nanto1', 'cpwalsh2', 'eszato', 'scholl1', 'akshat1521', 'divito3', 'rmuryan2', 'icfmi90', 'gomez14', 'artus1', 'rishi_ratan', 'chan47', 'skyzzm', 'willspringzhang', 'chinvet1', 'mcarney2', 'snowpd', 'silver104', 'darkhelmet2346', 'felipealonso1', 'gkx39', 'sixgallon', 'hamburger123', 'karlsino', 'rmahaja2', 'djtanaka', 'cschan3', 'nammari1', 'diablopbc', 'tuoliu1', 'squeeksrocks', 'pyropenguinx', 'knuts003', 'kazi1', 'megarza2', 'crzftx', 'cvendi2', 'jsun31', 'tungdo1', 'tbvance', 'gheimbe2', 'dgrocho2', 'uppal1', 'yc_ng', 'stacey2', 'bobbit1', 'dongdong', 'xu34', 'pay1', 'hillebr1', 'kbliu46', 'niyingkan', 'dhruvbhatia7', 'tmurray5', 'bhuiya1', 'cthayer3', 'cyanrook', 'cjhughes17', 'swaffor1']"
2,49,134,20,1,['baruin2'],132,"['balistic2', 'hipaulshi', 'bpatzin2', 'cardena2', 'kim325', 'beugels1', 'shook2', 'saima1', 'photoyub', 'perng2', 'cheeloh1', 'boehle2', 'phoenix_0510', 'jortiz125', 'wicky', 'mmenon3', 'beran1', 'zhimin', 'liu7979', 'crazycai', 'ericcj21', 'johnso49', 'wrubrec2', 'barlaz', 'tonyli1', 'frost1', 'keramat1', 'kocek1', 'marchevskiy', 'mus423', 'spitula2', 'foo5', 'bertbusdriver', 'lilgoose3', 'pcrutch2', 'moruzi1', 'mast5', 'stoddar1', 'daiyuan1991', 'nahsor', 'akusan', 'echo781', 'fahim89', 'tohms19', 'suchko1', 'komo', 'geneyu2', 'forcejedi', 'capota2', 'kejacs', 'ammarfaris', 'fedorov1', 'tsteige2', 'lumiao88', 'richers1', 'robert25', 'aneavil2', 'hsu16', 'meagher1', 'eshanso', 'will07c5', 'cheng78', 'cjsmile', 'horvat1', 'liu141', 'schlude1', 'drmalkovich', 'rareearth', 'dluzen3', 'huilinng', 'healy4', 'tmalone3', 'shin34', 'maoshouse', 'beaver1128', 'nanto1', 'cpwalsh2', 'eszato', 'scholl1', 'akshat1521', 'divito3', 'rmuryan2', 'icfmi90', 'gomez14', 'artus1', 'rishi_ratan', 'chan47', 'skyzzm', 'willspringzhang', 'chinvet1', 'mcarney2', 'snowpd', 'darkhelmet2346', 'felipealonso1', 'gkx39', 'sixgallon', 'hamburger123', 'karlsino', 'rmahaja2', 'djtanaka', 'cschan3', 'nammari1', 'diablopbc', 'tuoliu1', 'squeeksrocks', 'pyropenguinx', 'kazi1', 'megarza2', 'crzftx', 'cvendi2', 'jsun31', 'tungdo1', 'tbvance', 'gheimbe2', 'dgrocho2', 'uppal1', 'yc_ng', 'stacey2', 'bobbit1', 'dongdong', 'xu34', 'pay1', 'hillebr1', 'kbliu46', 'niyingkan', 'dhruvbhatia7', 'tmurray5', 'bhuiya1', 'cthayer3', 'cyanrook', 'cjhughes17', 'swaffor1']",19,"['sadderly', 'ran1363', 'gulsim', 'quoy26', 'heinzel2', 'ztrata2', 'mail2na', 'andrewspb', 'ragunat1', 'chuneven', 'uasyed2', 'lyding', 'aeroice', 'nafgnahz', None, 'sgeorge4', 'zambran1', 'ecarrion232', 'ryanskim']",152,"['balistic2', 'sadderly', 'hipaulshi', 'bpatzin2', 'cardena2', 'ztrata2', 'kim325', 'beugels1', 'andrewspb', 'chuneven', 'shook2', 'saima1', 'photoyub', 'perng2', 'cheeloh1', 'boehle2', 'phoenix_0510', 'jortiz125', 'wicky', 'mmenon3', 'beran1', 'zhimin', 'liu7979', 'nafgnahz', 'crazycai', 'ericcj21', 'johnso49', 'wrubrec2', 'barlaz', 'tonyli1', 'frost1', 'keramat1', 'kocek1', 'marchevskiy', 'mus423', 'spitula2', 'quoy26', 'foo5', 'bertbusdriver', 'lilgoose3', 'pcrutch2', 'mail2na', 'moruzi1', 'mast5', 'ragunat1', 'stoddar1', 'daiyuan1991', 'nahsor', 'akusan', 'echo781', 'fahim89', 'lyding', 'tohms19', 'suchko1', 'komo', 'geneyu2', 'forcejedi', 'capota2', 'kejacs', None, 'baruin2', 'ammarfaris', 'fedorov1', 'tsteige2', 'lumiao88', 'richers1', 'robert25', 'ran1363', 'aneavil2', 'hsu16', 'meagher1', 'eshanso', 'will07c5', 'cheng78', 'cjsmile', 'horvat1', 'liu141', 'schlude1', 'drmalkovich', 'rareearth', 'dluzen3', 'huilinng', 'healy4', 'tmalone3', 'shin34', 'maoshouse', 'beaver1128', 'nanto1', 'cpwalsh2', 'eszato', 'scholl1', 'akshat1521', 'divito3', 'rmuryan2', 'icfmi90', 'gomez14', 'artus1', 'rishi_ratan', 'chan47', 'skyzzm', 'willspringzhang', 'chinvet1', 'mcarney2', 'snowpd', 'darkhelmet2346', 'felipealonso1', 'gkx39', 'sixgallon', 'ecarrion232', 'ryanskim', 'hamburger123', 'karlsino', 'rmahaja2', 'djtanaka', 'cschan3', 'gulsim', 'heinzel2', 'nammari1', 'diablopbc', 'tuoliu1', 'squeeksrocks', 'pyropenguinx', 'kazi1', 'megarza2', 'crzftx', 'uasyed2', 'cvendi2', 'jsun31', 'tungdo1', 'tbvance', 'gheimbe2', 'dgrocho2', 'uppal1', 'yc_ng', 'stacey2', 'aeroice', 'bobbit1', 'dongdong', 'xu34', 'pay1', 'hillebr1', 'kbliu46', 'niyingkan', 'dhruvbhatia7', 'tmurray5', 'bhuiya1', 'cthayer3', 'cyanrook', 'sgeorge4', 'zambran1', 'cjhughes17', 'swaffor1']"
2,133,134,18,12,"['beugels1', 'tuoliu1', 'scholl1', 'dhruvbhatia7', 'pyropenguinx', 'cyanrook', 'djtanaka', 'rishi_ratan', 'lumiao88', 'shook2', 'diablopbc', 'bertbusdriver']",121,"['balistic2', 'hipaulshi', 'bpatzin2', 'cardena2', 'kim325', 'saima1', 'photoyub', 'perng2', 'cheeloh1', 'boehle2', 'phoenix_0510', 'jortiz125', 'wicky', 'mmenon3', 'beran1', 'zhimin', 'liu7979', 'crazycai', 'ericcj21', 'johnso49', 'wrubrec2', 'barlaz', 'tonyli1', 'frost1', 'keramat1', 'kocek1', 'marchevskiy', 'mus423', 'spitula2', 'foo5', 'lilgoose3', 'pcrutch2', 'moruzi1', 'mast5', 'stoddar1', 'daiyuan1991', 'nahsor', 'akusan', 'echo781', 'fahim89', 'tohms19', 'suchko1', 'komo', 'geneyu2', 'forcejedi', 'capota2', 'kejacs', 'baruin2', 'ammarfaris', 'fedorov1', 'tsteige2', 'richers1', 'robert25', 'aneavil2', 'hsu16', 'meagher1', 'eshanso', 'will07c5', 'cheng78', 'cjsmile', 'horvat1', 'liu141', 'schlude1', 'drmalkovich', 'rareearth', 'dluzen3', 'huilinng', 'healy4', 'tmalone3', 'shin34', 'maoshouse', 'beaver1128', 'nanto1', 'cpwalsh2', 'eszato', 'akshat1521', 'divito3', 'rmuryan2', 'icfmi90', 'gomez14', 'artus1', 'chan47', 'skyzzm', 'willspringzhang', 'chinvet1', 'mcarney2', 'snowpd', 'darkhelmet2346', 'felipealonso1', 'gkx39', 'sixgallon', 'hamburger123', 'karlsino', 'rmahaja2', 'cschan3', 'nammari1', 'squeeksrocks', 'kazi1', 'megarza2', 'crzftx', 'cvendi2', 'jsun31', 'tungdo1', 'tbvance', 'gheimbe2', 'dgrocho2', 'uppal1', 'yc_ng', 'stacey2', 'bobbit1', 'dongdong', 'xu34', 'pay1', 'hillebr1', 'kbliu46', 'niyingkan', 'tmurray5', 'bhuiya1', 'cthayer3', 'cjhughes17', 'swaffor1']",6,"['faorlando', 'xinzhao2', 'skorets2', 'thinair89', None, 'tgorti']",139,"['balistic2', 'hipaulshi', 'xinzhao2', 'bpatzin2', 'cardena2', 'kim325', 'beugels1', 'shook2', 'saima1', 'photoyub', 'perng2', 'cheeloh1', 'boehle2', 'thinair89', 'phoenix_0510', 'jortiz125', 'wicky', 'mmenon3', 'beran1', 'zhimin', 'liu7979', 'crazycai', 'ericcj21', 'johnso49', 'wrubrec2', 'barlaz', 'tonyli1', 'frost1', 'keramat1', 'kocek1', 'marchevskiy', 'mus423', 'spitula2', 'foo5', 'bertbusdriver', 'lilgoose3', 'pcrutch2', 'moruzi1', 'mast5', 'stoddar1', 'daiyuan1991', 'nahsor', 'akusan', 'echo781', 'fahim89', 'tohms19', 'suchko1', 'komo', 'geneyu2', 'forcejedi', 'capota2', 'kejacs', None, 'tgorti', 'baruin2', 'ammarfaris', 'fedorov1', 'tsteige2', 'lumiao88', 'richers1', 'robert25', 'aneavil2', 'hsu16', 'meagher1', 'eshanso', 'will07c5', 'cheng78', 'cjsmile', 'horvat1', 'liu141', 'schlude1', 'drmalkovich', 'rareearth', 'dluzen3', 'huilinng', 'healy4', 'tmalone3', 'shin34', 'maoshouse', 'beaver1128', 'nanto1', 'cpwalsh2', 'eszato', 'scholl1', 'akshat1521', 'divito3', 'rmuryan2', 'icfmi90', 'gomez14', 'artus1', 'rishi_ratan', 'chan47', 'skyzzm', 'willspringzhang', 'chinvet1', 'mcarney2', 'snowpd', 'darkhelmet2346', 'felipealonso1', 'gkx39', 'sixgallon', 'hamburger123', 'karlsino', 'rmahaja2', 'djtanaka', 'cschan3', 'skorets2', 'nammari1', 'diablopbc', 'tuoliu1', 'squeeksrocks', 'pyropenguinx', 'kazi1', 'megarza2', 'crzftx', 'cvendi2', 'jsun31', 'tungdo1', 'tbvance', 'gheimbe2', 'dgrocho2', 'uppal1', 'yc_ng', 'stacey2', 'bobbit1', 'dongdong', 'xu34', 'pay1', 'hillebr1', 'kbliu46', 'niyingkan', 'dhruvbhatia7', 'tmurray5', 'faorlando', 'bhuiya1', 'cthayer3', 'cyanrook', 'cjhughes17', 'swaffor1']"
2,38,134,17,14,"['balistic2', 'niyingkan', 'tmurray5', 'echo781', 'tmalone3', 'chinvet1', 'crzftx', 'mcarney2', 'foo5', 'drmalkovich', 'cheeloh1', 'beaver1128', 'gheimbe2', 'swaffor1']",119,"['hipaulshi', 'bpatzin2', 'cardena2', 'kim325', 'beugels1', 'shook2', 'saima1', 'photoyub', 'perng2', 'boehle2', 'phoenix_0510', 'jortiz125', 'wicky', 'mmenon3', 'beran1', 'zhimin', 'liu7979', 'crazycai', 'ericcj21', 'johnso49', 'wrubrec2', 'barlaz', 'tonyli1', 'frost1', 'keramat1', 'kocek1', 'marchevskiy', 'mus423', 'spitula2', 'bertbusdriver', 'lilgoose3', 'pcrutch2', 'moruzi1', 'mast5', 'stoddar1', 'daiyuan1991', 'nahsor', 'akusan', 'fahim89', 'tohms19', 'suchko1', 'komo', 'geneyu2', 'forcejedi', 'capota2', 'kejacs', 'baruin2', 'ammarfaris', 'fedorov1', 'tsteige2', 'lumiao88', 'richers1', 'robert25', 'aneavil2', 'hsu16', 'meagher1', 'eshanso', 'will07c5', 'cheng78', 'cjsmile', 'horvat1', 'liu141', 'schlude1', 'rareearth', 'dluzen3', 'huilinng', 'healy4', 'shin34', 'maoshouse', 'nanto1', 'cpwalsh2', 'eszato', 'scholl1', 'akshat1521', 'divito3', 'rmuryan2', 'icfmi90', 'gomez14', 'artus1', 'rishi_ratan', 'chan47', 'skyzzm', 'willspringzhang', 'snowpd', 'darkhelmet2346', 'felipealonso1', 'gkx39', 'sixgallon', 'hamburger123', 'karlsino', 'rmahaja2', 'djtanaka', 'cschan3', 'nammari1', 'diablopbc', 'tuoliu1', 'squeeksrocks', 'pyropenguinx', 'kazi1', 'megarza2', 'cvendi2', 'jsun31', 'tungdo1', 'tbvance', 'dgrocho2', 'uppal1', 'yc_ng', 'stacey2', 'bobbit1', 'dongdong', 'xu34', 'pay1', 'hillebr1', 'kbliu46', 'dhruvbhatia7', 'bhuiya1', 'cthayer3', 'cyanrook', 'cjhughes17']",3,"[None, 'nishitsharma13', 'shakamd']",136,"['balistic2', 'hipaulshi', 'bpatzin2', 'cardena2', 'kim325', 'beugels1', 'shook2', 'saima1', 'photoyub', 'perng2', 'cheeloh1', 'boehle2', 'phoenix_0510', 'jortiz125', 'wicky', 'mmenon3', 'beran1', 'zhimin', 'liu7979', 'crazycai', 'ericcj21', 'johnso49', 'wrubrec2', 'barlaz', 'tonyli1', 'frost1', 'keramat1', 'kocek1', 'marchevskiy', 'shakamd', 'mus423', 'spitula2', 'foo5', 'bertbusdriver', 'lilgoose3', 'pcrutch2', 'moruzi1', 'mast5', 'stoddar1', 'daiyuan1991', 'nahsor', 'akusan', 'echo781', 'fahim89', 'tohms19', 'suchko1', 'komo', 'geneyu2', 'forcejedi', 'capota2', 'kejacs', None, 'baruin2', 'ammarfaris', 'fedorov1', 'tsteige2', 'lumiao88', 'richers1', 'robert25', 'aneavil2', 'hsu16', 'meagher1', 'eshanso', 'will07c5', 'cheng78', 'cjsmile', 'horvat1', 'liu141', 'schlude1', 'drmalkovich', 'rareearth', 'dluzen3', 'huilinng', 'healy4', 'tmalone3', 'shin34', 'maoshouse', 'beaver1128', 'nanto1', 'cpwalsh2', 'eszato', 'scholl1', 'akshat1521', 'divito3', 'rmuryan2', 'icfmi90', 'gomez14', 'artus1', 'rishi_ratan', 'chan47', 'skyzzm', 'willspringzhang', 'chinvet1', 'mcarney2', 'snowpd', 'darkhelmet2346', 'felipealonso1', 'gkx39', 'nishitsharma13', 'sixgallon', 'hamburger123', 'karlsino', 'rmahaja2', 'djtanaka', 'cschan3', 'nammari1', 'diablopbc', 'tuoliu1', 'squeeksrocks', 'pyropenguinx', 'kazi1', 'megarza2', 'crzftx', 'cvendi2', 'jsun31', 'tungdo1', 'tbvance', 'gheimbe2', 'dgrocho2', 'uppal1', 'yc_ng', 'stacey2', 'bobbit1', 'dongdong', 'xu34', 'pay1', 'hillebr1', 'kbliu46', 'niyingkan', 'dhruvbhatia7', 'tmurray5', 'bhuiya1', 'cthayer3', 'cyanrook', 'cjhughes17', 'swaffor1']"
2,83,134,17,14,"['gkx39', 'beugels1', 'scholl1', 'lilgoose3', 'cjsmile', 'djtanaka', 'suchko1', 'cyanrook', 'zhimin', 'shook2', 'cjhughes17', 'perng2', 'tungdo1', 'bertbusdriver']",119,"['balistic2', 'hipaulshi', 'bpatzin2', 'cardena2', 'kim325', 'saima1', 'photoyub', 'cheeloh1', 'boehle2', 'phoenix_0510', 'jortiz125', 'wicky', 'mmenon3', 'beran1', 'liu7979', 'crazycai', 'ericcj21', 'johnso49', 'wrubrec2', 'barlaz', 'tonyli1', 'frost1', 'keramat1', 'kocek1', 'marchevskiy', 'mus423', 'spitula2', 'foo5', 'pcrutch2', 'moruzi1', 'mast5', 'stoddar1', 'daiyuan1991', 'nahsor', 'akusan', 'echo781', 'fahim89', 'tohms19', 'komo', 'geneyu2', 'forcejedi', 'capota2', 'kejacs', 'baruin2', 'ammarfaris', 'fedorov1', 'tsteige2', 'lumiao88', 'richers1', 'robert25', 'aneavil2', 'hsu16', 'meagher1', 'eshanso', 'will07c5', 'cheng78', 'horvat1', 'liu141', 'schlude1', 'drmalkovich', 'rareearth', 'dluzen3', 'huilinng', 'healy4', 'tmalone3', 'shin34', 'maoshouse', 'beaver1128', 'nanto1', 'cpwalsh2', 'eszato', 'akshat1521', 'divito3', 'rmuryan2', 'icfmi90', 'gomez14', 'artus1', 'rishi_ratan', 'chan47', 'skyzzm', 'willspringzhang', 'chinvet1', 'mcarney2', 'snowpd', 'darkhelmet2346', 'felipealonso1', 'sixgallon', 'hamburger123', 'karlsino', 'rmahaja2', 'cschan3', 'nammari1', 'diablopbc', 'tuoliu1', 'squeeksrocks', 'pyropenguinx', 'kazi1', 'megarza2', 'crzftx', 'cvendi2', 'jsun31', 'tbvance', 'gheimbe2', 'dgrocho2', 'uppal1', 'yc_ng', 'stacey2', 'bobbit1', 'dongdong', 'xu34', 'pay1', 'hillebr1', 'kbliu46', 'niyingkan', 'dhruvbhatia7', 'tmurray5', 'bhuiya1', 'cthayer3', 'swaffor1']",3,"['thinair89', None, 'tgorti']",136,"['balistic2', 'hipaulshi', 'bpatzin2', 'cardena2', 'kim325', 'beugels1', 'shook2', 'saima1', 'photoyub', 'perng2', 'cheeloh1', 'boehle2', 'thinair89', 'phoenix_0510', 'jortiz125', 'wicky', 'mmenon3', 'beran1', 'zhimin', 'liu7979', 'crazycai', 'ericcj21', 'johnso49', 'wrubrec2', 'barlaz', 'tonyli1', 'frost1', 'keramat1', 'kocek1', 'marchevskiy', 'mus423', 'spitula2', 'foo5', 'bertbusdriver', 'lilgoose3', 'pcrutch2', 'moruzi1', 'mast5', 'stoddar1', 'daiyuan1991', 'nahsor', 'akusan', 'echo781', 'fahim89', 'tohms19', 'suchko1', 'komo', 'geneyu2', 'forcejedi', 'capota2', 'kejacs', None, 'tgorti', 'baruin2', 'ammarfaris', 'fedorov1', 'tsteige2', 'lumiao88', 'richers1', 'robert25', 'aneavil2', 'hsu16', 'meagher1', 'eshanso', 'will07c5', 'cheng78', 'cjsmile', 'horvat1', 'liu141', 'schlude1', 'drmalkovich', 'rareearth', 'dluzen3', 'huilinng', 'healy4', 'tmalone3', 'shin34', 'maoshouse', 'beaver1128', 'nanto1', 'cpwalsh2', 'eszato', 'scholl1', 'akshat1521', 'divito3', 'rmuryan2', 'icfmi90', 'gomez14', 'artus1', 'rishi_ratan', 'chan47', 'skyzzm', 'willspringzhang', 'chinvet1', 'mcarney2', 'snowpd', 'darkhelmet2346', 'felipealonso1', 'gkx39', 'sixgallon', 'hamburger123', 'karlsino', 'rmahaja2', 'djtanaka', 'cschan3', 'nammari1', 'diablopbc', 'tuoliu1', 'squeeksrocks', 'pyropenguinx', 'kazi1', 'megarza2', 'crzftx', 'cvendi2', 'jsun31', 'tungdo1', 'tbvance', 'gheimbe2', 'dgrocho2', 'uppal1', 'yc_ng', 'stacey2', 'bobbit1', 'dongdong', 'xu34', 'pay1', 'hillebr1', 'kbliu46', 'niyingkan', 'dhruvbhatia7', 'tmurray5', 'bhuiya1', 'cthayer3', 'cyanrook', 'cjhughes17', 'swaffor1']"
2,64,134,15,11,"['balistic2', 'karlsino', 'tmurray5', 'chinvet1', 'mcarney2', 'foo5', 'cvendi2', 'cheeloh1', 'beaver1128', 'swaffor1', 'huilinng']",122,"['hipaulshi', 'bpatzin2', 'cardena2', 'kim325', 'beugels1', 'shook2', 'saima1', 'photoyub', 'perng2', 'boehle2', 'phoenix_0510', 'jortiz125', 'wicky', 'mmenon3', 'beran1', 'zhimin', 'liu7979', 'crazycai', 'ericcj21', 'johnso49', 'wrubrec2', 'barlaz', 'tonyli1', 'frost1', 'keramat1', 'kocek1', 'marchevskiy', 'mus423', 'spitula2', 'bertbusdriver', 'lilgoose3', 'pcrutch2', 'moruzi1', 'mast5', 'stoddar1', 'daiyuan1991', 'nahsor', 'akusan', 'echo781', 'fahim89', 'tohms19', 'suchko1', 'komo', 'geneyu2', 'forcejedi', 'capota2', 'kejacs', 'baruin2', 'ammarfaris', 'fedorov1', 'tsteige2', 'lumiao88', 'richers1', 'robert25', 'aneavil2', 'hsu16', 'meagher1', 'eshanso', 'will07c5', 'cheng78', 'cjsmile', 'horvat1', 'liu141', 'schlude1', 'drmalkovich', 'rareearth', 'dluzen3', 'healy4', 'tmalone3', 'shin34', 'maoshouse', 'nanto1', 'cpwalsh2', 'eszato', 'scholl1', 'akshat1521', 'divito3', 'rmuryan2', 'icfmi90', 'gomez14', 'artus1', 'rishi_ratan', 'chan47', 'skyzzm', 'willspringzhang', 'snowpd', 'darkhelmet2346', 'felipealonso1', 'gkx39', 'sixgallon', 'hamburger123', 'rmahaja2', 'djtanaka', 'cschan3', 'nammari1', 'diablopbc', 'tuoliu1', 'squeeksrocks', 'pyropenguinx', 'kazi1', 'megarza2', 'crzftx', 'jsun31', 'tungdo1', 'tbvance', 'gheimbe2', 'dgrocho2', 'uppal1', 'yc_ng', 'stacey2', 'bobbit1', 'dongdong', 'xu34', 'pay1', 'hillebr1', 'kbliu46', 'niyingkan', 'dhruvbhatia7', 'bhuiya1', 'cthayer3', 'cyanrook', 'cjhughes17']",4,"['nishsharma', 'trongtong', None, 'shakamd']",137,"['balistic2', 'hipaulshi', 'bpatzin2', 'cardena2', 'kim325', 'beugels1', 'shook2', 'saima1', 'photoyub', 'perng2', 'cheeloh1', 'boehle2', 'phoenix_0510', 'jortiz125', 'wicky', 'mmenon3', 'beran1', 'zhimin', 'liu7979', 'crazycai', 'ericcj21', 'johnso49', 'wrubrec2', 'barlaz', 'tonyli1', 'frost1', 'keramat1', 'kocek1', 'marchevskiy', 'shakamd', 'mus423', 'spitula2', 'foo5', 'bertbusdriver', 'nishsharma', 'lilgoose3', 'pcrutch2', 'moruzi1', 'mast5', 'stoddar1', 'daiyuan1991', 'nahsor', 'akusan', 'echo781', 'fahim89', 'tohms19', 'suchko1', 'komo', 'geneyu2', 'forcejedi', 'capota2', 'kejacs', None, 'baruin2', 'ammarfaris', 'fedorov1', 'tsteige2', 'lumiao88', 'richers1', 'robert25', 'aneavil2', 'hsu16', 'meagher1', 'eshanso', 'will07c5', 'cheng78', 'cjsmile', 'horvat1', 'liu141', 'schlude1', 'drmalkovich', 'rareearth', 'dluzen3', 'huilinng', 'healy4', 'trongtong', 'tmalone3', 'shin34', 'maoshouse', 'beaver1128', 'nanto1', 'cpwalsh2', 'eszato', 'scholl1', 'akshat1521', 'divito3', 'rmuryan2', 'icfmi90', 'gomez14', 'artus1', 'rishi_ratan', 'chan47', 'skyzzm', 'willspringzhang', 'chinvet1', 'mcarney2', 'snowpd', 'darkhelmet2346', 'felipealonso1', 'gkx39', 'sixgallon', 'hamburger123', 'karlsino', 'rmahaja2', 'djtanaka', 'cschan3', 'nammari1', 'diablopbc', 'tuoliu1', 'squeeksrocks', 'pyropenguinx', 'kazi1', 'megarza2', 'crzftx', 'cvendi2', 'jsun31', 'tungdo1', 'tbvance', 'gheimbe2', 'dgrocho2', 'uppal1', 'yc_ng', 'stacey2', 'bobbit1', 'dongdong', 'xu34', 'pay1', 'hillebr1', 'kbliu46', 'niyingkan', 'dhruvbhatia7', 'tmurray5', 'bhuiya1', 'cthayer3', 'cyanrook', 'cjhughes17', 'swaffor1']"
2,41,134,14,10,"['gkx39', 'beugels1', 'dhruvbhatia7', 'hillebr1', 'cyanrook', 'suchko1', 'frost1', 'zhimin', 'tungdo1', 'bertbusdriver']",123,"['balistic2', 'hipaulshi', 'bpatzin2', 'cardena2', 'kim325', 'shook2', 'saima1', 'photoyub', 'perng2', 'cheeloh1', 'boehle2', 'phoenix_0510', 'jortiz125', 'wicky', 'mmenon3', 'beran1', 'liu7979', 'crazycai', 'ericcj21', 'johnso49', 'wrubrec2', 'barlaz', 'tonyli1', 'keramat1', 'kocek1', 'marchevskiy', 'mus423', 'spitula2', 'foo5', 'lilgoose3', 'pcrutch2', 'moruzi1', 'mast5', 'stoddar1', 'daiyuan1991', 'nahsor', 'akusan', 'echo781', 'fahim89', 'tohms19', 'komo', 'geneyu2', 'forcejedi', 'capota2', 'kejacs', 'baruin2', 'ammarfaris', 'fedorov1', 'tsteige2', 'lumiao88', 'richers1', 'robert25', 'aneavil2', 'hsu16', 'meagher1', 'eshanso', 'will07c5', 'cheng78', 'cjsmile', 'horvat1', 'liu141', 'schlude1', 'drmalkovich', 'rareearth', 'dluzen3', 'huilinng', 'healy4', 'tmalone3', 'shin34', 'maoshouse', 'beaver1128', 'nanto1', 'cpwalsh2', 'eszato', 'scholl1', 'akshat1521', 'divito3', 'rmuryan2', 'icfmi90', 'gomez14', 'artus1', 'rishi_ratan', 'chan47', 'skyzzm', 'willspringzhang', 'chinvet1', 'mcarney2', 'snowpd', 'darkhelmet2346', 'felipealonso1', 'sixgallon', 'hamburger123', 'karlsino', 'rmahaja2', 'djtanaka', 'cschan3', 'nammari1', 'diablopbc', 'tuoliu1', 'squeeksrocks', 'pyropenguinx', 'kazi1', 'megarza2', 'crzftx', 'cvendi2', 'jsun31', 'tbvance', 'gheimbe2', 'dgrocho2', 'uppal1', 'yc_ng', 'stacey2', 'bobbit1', 'dongdong', 'xu34', 'pay1', 'kbliu46', 'niyingkan', 'tmurray5', 'bhuiya1', 'cthayer3', 'cjhughes17', 'swaffor1']",4,"['faorlando', None, 'tfreire2', 'tgorti']",137,"['balistic2', 'hipaulshi', 'bpatzin2', 'cardena2', 'kim325', 'beugels1', 'shook2', 'saima1', 'photoyub', 'perng2', 'cheeloh1', 'boehle2', 'phoenix_0510', 'jortiz125', 'wicky', 'mmenon3', 'beran1', 'zhimin', 'liu7979', 'crazycai', 'ericcj21', 'johnso49', 'wrubrec2', 'barlaz', 'tonyli1', 'frost1', 'keramat1', 'kocek1', 'marchevskiy', 'mus423', 'spitula2', 'foo5', 'bertbusdriver', 'lilgoose3', 'pcrutch2', 'moruzi1', 'mast5', 'stoddar1', 'daiyuan1991', 'nahsor', 'akusan', 'echo781', 'fahim89', 'tohms19', 'suchko1', 'komo', 'geneyu2', 'forcejedi', 'capota2', 'kejacs', None, 'tgorti', 'baruin2', 'ammarfaris', 'fedorov1', 'tsteige2', 'lumiao88', 'richers1', 'robert25', 'aneavil2', 'hsu16', 'meagher1', 'eshanso', 'will07c5', 'cheng78', 'cjsmile', 'horvat1', 'liu141', 'schlude1', 'drmalkovich', 'rareearth', 'dluzen3', 'huilinng', 'healy4', 'tmalone3', 'shin34', 'maoshouse', 'beaver1128', 'nanto1', 'cpwalsh2', 'eszato', 'scholl1', 'akshat1521', 'divito3', 'rmuryan2', 'icfmi90', 'gomez14', 'artus1', 'rishi_ratan', 'chan47', 'skyzzm', 'willspringzhang', 'chinvet1', 'mcarney2', 'snowpd', 'darkhelmet2346', 'felipealonso1', 'gkx39', 'sixgallon', 'hamburger123', 'karlsino', 'rmahaja2', 'djtanaka', 'cschan3', 'tfreire2', 'nammari1', 'diablopbc', 'tuoliu1', 'squeeksrocks', 'pyropenguinx', 'kazi1', 'megarza2', 'crzftx', 'cvendi2', 'jsun31', 'tungdo1', 'tbvance', 'gheimbe2', 'dgrocho2', 'uppal1', 'yc_ng', 'stacey2', 'bobbit1', 'dongdong', 'xu34', 'pay1', 'hillebr1', 'kbliu46', 'niyingkan', 'dhruvbhatia7', 'tmurray5', 'faorlando', 'bhuiya1', 'cthayer3', 'cyanrook', 'cjhughes17', 'swaffor1']"
2,67,134,14,13,"['meagher1', 'fedorov1', 'pcrutch2', 'komo', 'spitula2', 'bobbit1', 'schlude1', 'richers1', 'foo5', 'snowpd', 'boehle2', 'huilinng', 'felipealonso1']",120,"['balistic2', 'hipaulshi', 'bpatzin2', 'cardena2', 'kim325', 'beugels1', 'shook2', 'saima1', 'photoyub', 'perng2', 'cheeloh1', 'phoenix_0510', 'jortiz125', 'wicky', 'mmenon3', 'beran1', 'zhimin', 'liu7979', 'crazycai', 'ericcj21', 'johnso49', 'wrubrec2', 'barlaz', 'tonyli1', 'frost1', 'keramat1', 'kocek1', 'marchevskiy', 'mus423', 'bertbusdriver', 'lilgoose3', 'moruzi1', 'mast5', 'stoddar1', 'daiyuan1991', 'nahsor', 'akusan', 'echo781', 'fahim89', 'tohms19', 'suchko1', 'geneyu2', 'forcejedi', 'capota2', 'kejacs', 'baruin2', 'ammarfaris', 'tsteige2', 'lumiao88', 'robert25', 'aneavil2', 'hsu16', 'eshanso', 'will07c5', 'cheng78', 'cjsmile', 'horvat1', 'liu141', 'drmalkovich', 'rareearth', 'dluzen3', 'healy4', 'tmalone3', 'shin34', 'maoshouse', 'beaver1128', 'nanto1', 'cpwalsh2', 'eszato', 'scholl1', 'akshat1521', 'divito3', 'rmuryan2', 'icfmi90', 'gomez14', 'artus1', 'rishi_ratan', 'chan47', 'skyzzm', 'willspringzhang', 'chinvet1', 'mcarney2', 'darkhelmet2346', 'gkx39', 'sixgallon', 'hamburger123', 'karlsino', 'rmahaja2', 'djtanaka', 'cschan3', 'nammari1', 'diablopbc', 'tuoliu1', 'squeeksrocks', 'pyropenguinx', 'kazi1', 'megarza2', 'crzftx', 'cvendi2', 'jsun31', 'tungdo1', 'tbvance', 'gheimbe2', 'dgrocho2', 'uppal1', 'yc_ng', 'stacey2', 'dongdong', 'xu34', 'pay1', 'hillebr1', 'kbliu46', 'niyingkan', 'dhruvbhatia7', 'tmurray5', 'bhuiya1', 'cthayer3', 'cyanrook', 'cjhughes17', 'swaffor1']",1,[None],134,"['balistic2', 'hipaulshi', 'bpatzin2', 'cardena2', 'kim325', 'beugels1', 'shook2', 'saima1', 'photoyub', 'perng2', 'cheeloh1', 'boehle2', 'phoenix_0510', 'jortiz125', 'wicky', 'mmenon3', 'beran1', 'zhimin', 'liu7979', 'crazycai', 'ericcj21', 'johnso49', 'wrubrec2', 'barlaz', 'tonyli1', 'frost1', 'keramat1', 'kocek1', 'marchevskiy', 'mus423', 'spitula2', 'foo5', 'bertbusdriver', 'lilgoose3', 'pcrutch2', 'moruzi1', 'mast5', 'stoddar1', 'daiyuan1991', 'nahsor', 'akusan', 'echo781', 'fahim89', 'tohms19', 'suchko1', 'komo', 'geneyu2', 'forcejedi', 'capota2', 'kejacs', None, 'baruin2', 'ammarfaris', 'fedorov1', 'tsteige2', 'lumiao88', 'richers1', 'robert25', 'aneavil2', 'hsu16', 'meagher1', 'eshanso', 'will07c5', 'cheng78', 'cjsmile', 'horvat1', 'liu141', 'schlude1', 'drmalkovich', 'rareearth', 'dluzen3', 'huilinng', 'healy4', 'tmalone3', 'shin34', 'maoshouse', 'beaver1128', 'nanto1', 'cpwalsh2', 'eszato', 'scholl1', 'akshat1521', 'divito3', 'rmuryan2', 'icfmi90', 'gomez14', 'artus1', 'rishi_ratan', 'chan47', 'skyzzm', 'willspringzhang', 'chinvet1', 'mcarney2', 'snowpd', 'darkhelmet2346', 'felipealonso1', 'gkx39', 'sixgallon', 'hamburger123', 'karlsino', 'rmahaja2', 'djtanaka', 'cschan3', 'nammari1', 'diablopbc', 'tuoliu1', 'squeeksrocks', 'pyropenguinx', 'kazi1', 'megarza2', 'crzftx', 'cvendi2', 'jsun31', 'tungdo1', 'tbvance', 'gheimbe2', 'dgrocho2', 'uppal1', 'yc_ng', 'stacey2', 'bobbit1', 'dongdong', 'xu34', 'pay1', 'hillebr1', 'kbliu46', 'niyingkan', 'dhruvbhatia7', 'tmurray5', 'bhuiya1', 'cthayer3', 'cyanrook', 'cjhughes17', 'swaffor1']"
2,40,134,12,8,"['pcrutch2', 'spitula2', 'sixgallon', 'bobbit1', 'richers1', 'foo5', 'darkhelmet2346', 'hsu16']",125,"['balistic2', 'hipaulshi', 'bpatzin2', 'cardena2', 'kim325', 'beugels1', 'shook2', 'saima1', 'photoyub', 'perng2', 'cheeloh1', 'boehle2', 'phoenix_0510', 'jortiz125', 'wicky', 'mmenon3', 'beran1', 'zhimin', 'liu7979', 'crazycai', 'ericcj21', 'johnso49', 'wrubrec2', 'barlaz', 'tonyli1', 'frost1', 'keramat1', 'kocek1', 'marchevskiy', 'mus423', 'bertbusdriver', 'lilgoose3', 'moruzi1', 'mast5', 'stoddar1', 'daiyuan1991', 'nahsor', 'akusan', 'echo781', 'fahim89', 'tohms19', 'suchko1', 'komo', 'geneyu2', 'forcejedi', 'capota2', 'kejacs', 'baruin2', 'ammarfaris', 'fedorov1', 'tsteige2', 'lumiao88', 'robert25', 'aneavil2', 'meagher1', 'eshanso', 'will07c5', 'cheng78', 'cjsmile', 'horvat1', 'liu141', 'schlude1', 'drmalkovich', 'rareearth', 'dluzen3', 'huilinng', 'healy4', 'tmalone3', 'shin34', 'maoshouse', 'beaver1128', 'nanto1', 'cpwalsh2', 'eszato', 'scholl1', 'akshat1521', 'divito3', 'rmuryan2', 'icfmi90', 'gomez14', 'artus1', 'rishi_ratan', 'chan47', 'skyzzm', 'willspringzhang', 'chinvet1', 'mcarney2', 'snowpd', 'felipealonso1', 'gkx39', 'hamburger123', 'karlsino', 'rmahaja2', 'djtanaka', 'cschan3', 'nammari1', 'diablopbc', 'tuoliu1', 'squeeksrocks', 'pyropenguinx', 'kazi1', 'megarza2', 'crzftx', 'cvendi2', 'jsun31', 'tungdo1', 'tbvance', 'gheimbe2', 'dgrocho2', 'uppal1', 'yc_ng', 'stacey2', 'dongdong', 'xu34', 'pay1', 'hillebr1', 'kbliu46', 'niyingkan', 'dhruvbhatia7', 'tmurray5', 'bhuiya1', 'cthayer3', 'cyanrook', 'cjhughes17', 'swaffor1']",4,"['pao1', 'liu76', 'philip', None]",137,"['balistic2', 'hipaulshi', 'bpatzin2', 'cardena2', 'kim325', 'beugels1', 'shook2', 'saima1', 'photoyub', 'perng2', 'cheeloh1', 'boehle2', 'phoenix_0510', 'philip', 'jortiz125', 'wicky', 'mmenon3', 'beran1', 'zhimin', 'liu7979', 'crazycai', 'ericcj21', 'johnso49', 'wrubrec2', 'barlaz', 'tonyli1', 'frost1', 'keramat1', 'kocek1', 'marchevskiy', 'mus423', 'spitula2', 'foo5', 'bertbusdriver', 'lilgoose3', 'pcrutch2', 'moruzi1', 'mast5', 'stoddar1', 'daiyuan1991', 'nahsor', 'akusan', 'echo781', 'fahim89', 'tohms19', 'suchko1', 'komo', 'geneyu2', 'forcejedi', 'capota2', 'kejacs', None, 'baruin2', 'ammarfaris', 'fedorov1', 'tsteige2', 'lumiao88', 'richers1', 'robert25', 'aneavil2', 'hsu16', 'meagher1', 'eshanso', 'will07c5', 'cheng78', 'cjsmile', 'horvat1', 'liu141', 'schlude1', 'drmalkovich', 'rareearth', 'dluzen3', 'huilinng', 'healy4', 'tmalone3', 'shin34', 'maoshouse', 'beaver1128', 'nanto1', 'cpwalsh2', 'eszato', 'scholl1', 'akshat1521', 'divito3', 'rmuryan2', 'icfmi90', 'gomez14', 'artus1', 'rishi_ratan', 'chan47', 'skyzzm', 'willspringzhang', 'chinvet1', 'mcarney2', 'snowpd', 'darkhelmet2346', 'felipealonso1', 'gkx39', 'sixgallon', 'hamburger123', 'karlsino', 'rmahaja2', 'djtanaka', 'cschan3', 'pao1', 'nammari1', 'diablopbc', 'tuoliu1', 'squeeksrocks', 'pyropenguinx', 'kazi1', 'megarza2', 'crzftx', 'cvendi2', 'jsun31', 'tungdo1', 'tbvance', 'gheimbe2', 'dgrocho2', 'uppal1', 'yc_ng', 'liu76', 'stacey2', 'bobbit1', 'dongdong', 'xu34', 'pay1', 'hillebr1', 'kbliu46', 'niyingkan', 'dhruvbhatia7', 'tmurray5', 'bhuiya1', 'cthayer3', 'cyanrook', 'cjhughes17', 'swaffor1']"
2,65,134,12,11,"['beugels1', 'scholl1', 'lilgoose3', 'cyanrook', 'djtanaka', 'cjsmile', 'suchko1', 'shook2', 'nammari1', 'perng2', 'bertbusdriver']",122,"['balistic2', 'hipaulshi', 'bpatzin2', 'cardena2', 'kim325', 'saima1', 'photoyub', 'cheeloh1', 'boehle2', 'phoenix_0510', 'jortiz125', 'wicky', 'mmenon3', 'beran1', 'zhimin', 'liu7979', 'crazycai', 'ericcj21', 'johnso49', 'wrubrec2', 'barlaz', 'tonyli1', 'frost1', 'keramat1', 'kocek1', 'marchevskiy', 'mus423', 'spitula2', 'foo5', 'pcrutch2', 'moruzi1', 'mast5', 'stoddar1', 'daiyuan1991', 'nahsor', 'akusan', 'echo781', 'fahim89', 'tohms19', 'komo', 'geneyu2', 'forcejedi', 'capota2', 'kejacs', 'baruin2', 'ammarfaris', 'fedorov1', 'tsteige2', 'lumiao88', 'richers1', 'robert25', 'aneavil2', 'hsu16', 'meagher1', 'eshanso', 'will07c5', 'cheng78', 'horvat1', 'liu141', 'schlude1', 'drmalkovich', 'rareearth', 'dluzen3', 'huilinng', 'healy4', 'tmalone3', 'shin34', 'maoshouse', 'beaver1128', 'nanto1', 'cpwalsh2', 'eszato', 'akshat1521', 'divito3', 'rmuryan2', 'icfmi90', 'gomez14', 'artus1', 'rishi_ratan', 'chan47', 'skyzzm', 'willspringzhang', 'chinvet1', 'mcarney2', 'snowpd', 'darkhelmet2346', 'felipealonso1', 'gkx39', 'sixgallon', 'hamburger123', 'karlsino', 'rmahaja2', 'cschan3', 'diablopbc', 'tuoliu1', 'squeeksrocks', 'pyropenguinx', 'kazi1', 'megarza2', 'crzftx', 'cvendi2', 'jsun31', 'tungdo1', 'tbvance', 'gheimbe2', 'dgrocho2', 'uppal1', 'yc_ng', 'stacey2', 'bobbit1', 'dongdong', 'xu34', 'pay1', 'hillebr1', 'kbliu46', 'niyingkan', 'dhruvbhatia7', 'tmurray5', 'bhuiya1', 'cthayer3', 'cjhughes17', 'swaffor1']",1,[None],134,"['balistic2', 'hipaulshi', 'bpatzin2', 'cardena2', 'kim325', 'beugels1', 'shook2', 'saima1', 'photoyub', 'perng2', 'cheeloh1', 'boehle2', 'phoenix_0510', 'jortiz125', 'wicky', 'mmenon3', 'beran1', 'zhimin', 'liu7979', 'crazycai', 'ericcj21', 'johnso49', 'wrubrec2', 'barlaz', 'tonyli1', 'frost1', 'keramat1', 'kocek1', 'marchevskiy', 'mus423', 'spitula2', 'foo5', 'bertbusdriver', 'lilgoose3', 'pcrutch2', 'moruzi1', 'mast5', 'stoddar1', 'daiyuan1991', 'nahsor', 'akusan', 'echo781', 'fahim89', 'tohms19', 'suchko1', 'komo', 'geneyu2', 'forcejedi', 'capota2', 'kejacs', None, 'baruin2', 'ammarfaris', 'fedorov1', 'tsteige2', 'lumiao88', 'richers1', 'robert25', 'aneavil2', 'hsu16', 'meagher1', 'eshanso', 'will07c5', 'cheng78', 'cjsmile', 'horvat1', 'liu141', 'schlude1', 'drmalkovich', 'rareearth', 'dluzen3', 'huilinng', 'healy4', 'tmalone3', 'shin34', 'maoshouse', 'beaver1128', 'nanto1', 'cpwalsh2', 'eszato', 'scholl1', 'akshat1521', 'divito3', 'rmuryan2', 'icfmi90', 'gomez14', 'artus1', 'rishi_ratan', 'chan47', 'skyzzm', 'willspringzhang', 'chinvet1', 'mcarney2', 'snowpd', 'darkhelmet2346', 'felipealonso1', 'gkx39', 'sixgallon', 'hamburger123', 'karlsino', 'rmahaja2', 'djtanaka', 'cschan3', 'nammari1', 'diablopbc', 'tuoliu1', 'squeeksrocks', 'pyropenguinx', 'kazi1', 'megarza2', 'crzftx', 'cvendi2', 'jsun31', 'tungdo1', 'tbvance', 'gheimbe2', 'dgrocho2', 'uppal1', 'yc_ng', 'stacey2', 'bobbit1', 'dongdong', 'xu34', 'pay1', 'hillebr1', 'kbliu46', 'niyingkan', 'dhruvbhatia7', 'tmurray5', 'bhuiya1', 'cthayer3', 'cyanrook', 'cjhughes17', 'swaffor1']"
2,42,134,10,9,"['balistic2', 'divito3', 'cthayer3', 'artus1', 'geneyu2', 'tonyli1', 'chan47', 'stoddar1', 'aneavil2']",124,"['hipaulshi', 'bpatzin2', 'cardena2', 'kim325', 'beugels1', 'shook2', 'saima1', 'photoyub', 'perng2', 'cheeloh1', 'boehle2', 'phoenix_0510', 'jortiz125', 'wicky', 'mmenon3', 'beran1', 'zhimin', 'liu7979', 'crazycai', 'ericcj21', 'johnso49', 'wrubrec2', 'barlaz', 'frost1', 'keramat1', 'kocek1', 'marchevskiy', 'mus423', 'spitula2', 'foo5', 'bertbusdriver', 'lilgoose3', 'pcrutch2', 'moruzi1', 'mast5', 'daiyuan1991', 'nahsor', 'akusan', 'echo781', 'fahim89', 'tohms19', 'suchko1', 'komo', 'forcejedi', 'capota2', 'kejacs', 'baruin2', 'ammarfaris', 'fedorov1', 'tsteige2', 'lumiao88', 'richers1', 'robert25', 'hsu16', 'meagher1', 'eshanso', 'will07c5', 'cheng78', 'cjsmile', 'horvat1', 'liu141', 'schlude1', 'drmalkovich', 'rareearth', 'dluzen3', 'huilinng', 'healy4', 'tmalone3', 'shin34', 'maoshouse', 'beaver1128', 'nanto1', 'cpwalsh2', 'eszato', 'scholl1', 'akshat1521', 'rmuryan2', 'icfmi90', 'gomez14', 'rishi_ratan', 'skyzzm', 'willspringzhang', 'chinvet1', 'mcarney2', 'snowpd', 'darkhelmet2346', 'felipealonso1', 'gkx39', 'sixgallon', 'hamburger123', 'karlsino', 'rmahaja2', 'djtanaka', 'cschan3', 'nammari1', 'diablopbc', 'tuoliu1', 'squeeksrocks', 'pyropenguinx', 'kazi1', 'megarza2', 'crzftx', 'cvendi2', 'jsun31', 'tungdo1', 'tbvance', 'gheimbe2', 'dgrocho2', 'uppal1', 'yc_ng', 'stacey2', 'bobbit1', 'dongdong', 'xu34', 'pay1', 'hillebr1', 'kbliu46', 'niyingkan', 'dhruvbhatia7', 'tmurray5', 'bhuiya1', 'cyanrook', 'cjhughes17', 'swaffor1']",1,[None],134,"['balistic2', 'hipaulshi', 'bpatzin2', 'cardena2', 'kim325', 'beugels1', 'shook2', 'saima1', 'photoyub', 'perng2', 'cheeloh1', 'boehle2', 'phoenix_0510', 'jortiz125', 'wicky', 'mmenon3', 'beran1', 'zhimin', 'liu7979', 'crazycai', 'ericcj21', 'johnso49', 'wrubrec2', 'barlaz', 'tonyli1', 'frost1', 'keramat1', 'kocek1', 'marchevskiy', 'mus423', 'spitula2', 'foo5', 'bertbusdriver', 'lilgoose3', 'pcrutch2', 'moruzi1', 'mast5', 'stoddar1', 'daiyuan1991', 'nahsor', 'akusan', 'echo781', 'fahim89', 'tohms19', 'suchko1', 'komo', 'geneyu2', 'forcejedi', 'capota2', 'kejacs', None, 'baruin2', 'ammarfaris', 'fedorov1', 'tsteige2', 'lumiao88', 'richers1', 'robert25', 'aneavil2', 'hsu16', 'meagher1', 'eshanso', 'will07c5', 'cheng78', 'cjsmile', 'horvat1', 'liu141', 'schlude1', 'drmalkovich', 'rareearth', 'dluzen3', 'huilinng', 'healy4', 'tmalone3', 'shin34', 'maoshouse', 'beaver1128', 'nanto1', 'cpwalsh2', 'eszato', 'scholl1', 'akshat1521', 'divito3', 'rmuryan2', 'icfmi90', 'gomez14', 'artus1', 'rishi_ratan', 'chan47', 'skyzzm', 'willspringzhang', 'chinvet1', 'mcarney2', 'snowpd', 'darkhelmet2346', 'felipealonso1', 'gkx39', 'sixgallon', 'hamburger123', 'karlsino', 'rmahaja2', 'djtanaka', 'cschan3', 'nammari1', 'diablopbc', 'tuoliu1', 'squeeksrocks', 'pyropenguinx', 'kazi1', 'megarza2', 'crzftx', 'cvendi2', 'jsun31', 'tungdo1', 'tbvance', 'gheimbe2', 'dgrocho2', 'uppal1', 'yc_ng', 'stacey2', 'bobbit1', 'dongdong', 'xu34', 'pay1', 'hillebr1', 'kbliu46', 'niyingkan', 'dhruvbhatia7', 'tmurray5', 'bhuiya1', 'cthayer3', 'cyanrook', 'cjhughes17', 'swaffor1']"
2,85,134,10,9,"['crazycai', 'divito3', 'will07c5', 'artus1', 'geneyu2', 'tonyli1', 'chan47', 'beran1', 'stoddar1']",124,"['balistic2', 'hipaulshi', 'bpatzin2', 'cardena2', 'kim325', 'beugels1', 'shook2', 'saima1', 'photoyub', 'perng2', 'cheeloh1', 'boehle2', 'phoenix_0510', 'jortiz125', 'wicky', 'mmenon3', 'zhimin', 'liu7979', 'ericcj21', 'johnso49', 'wrubrec2', 'barlaz', 'frost1', 'keramat1', 'kocek1', 'marchevskiy', 'mus423', 'spitula2', 'foo5', 'bertbusdriver', 'lilgoose3', 'pcrutch2', 'moruzi1', 'mast5', 'daiyuan1991', 'nahsor', 'akusan', 'echo781', 'fahim89', 'tohms19', 'suchko1', 'komo', 'forcejedi', 'capota2', 'kejacs', 'baruin2', 'ammarfaris', 'fedorov1', 'tsteige2', 'lumiao88', 'richers1', 'robert25', 'aneavil2', 'hsu16', 'meagher1', 'eshanso', 'cheng78', 'cjsmile', 'horvat1', 'liu141', 'schlude1', 'drmalkovich', 'rareearth', 'dluzen3', 'huilinng', 'healy4', 'tmalone3', 'shin34', 'maoshouse', 'beaver1128', 'nanto1', 'cpwalsh2', 'eszato', 'scholl1', 'akshat1521', 'rmuryan2', 'icfmi90', 'gomez14', 'rishi_ratan', 'skyzzm', 'willspringzhang', 'chinvet1', 'mcarney2', 'snowpd', 'darkhelmet2346', 'felipealonso1', 'gkx39', 'sixgallon', 'hamburger123', 'karlsino', 'rmahaja2', 'djtanaka', 'cschan3', 'nammari1', 'diablopbc', 'tuoliu1', 'squeeksrocks', 'pyropenguinx', 'kazi1', 'megarza2', 'crzftx', 'cvendi2', 'jsun31', 'tungdo1', 'tbvance', 'gheimbe2', 'dgrocho2', 'uppal1', 'yc_ng', 'stacey2', 'bobbit1', 'dongdong', 'xu34', 'pay1', 'hillebr1', 'kbliu46', 'niyingkan', 'dhruvbhatia7', 'tmurray5', 'bhuiya1', 'cthayer3', 'cyanrook', 'cjhughes17', 'swaffor1']",1,[None],134,"['balistic2', 'hipaulshi', 'bpatzin2', 'cardena2', 'kim325', 'beugels1', 'shook2', 'saima1', 'photoyub', 'perng2', 'cheeloh1', 'boehle2', 'phoenix_0510', 'jortiz125', 'wicky', 'mmenon3', 'beran1', 'zhimin', 'liu7979', 'crazycai', 'ericcj21', 'johnso49', 'wrubrec2', 'barlaz', 'tonyli1', 'frost1', 'keramat1', 'kocek1', 'marchevskiy', 'mus423', 'spitula2', 'foo5', 'bertbusdriver', 'lilgoose3', 'pcrutch2', 'moruzi1', 'mast5', 'stoddar1', 'daiyuan1991', 'nahsor', 'akusan', 'echo781', 'fahim89', 'tohms19', 'suchko1', 'komo', 'geneyu2', 'forcejedi', 'capota2', 'kejacs', None, 'baruin2', 'ammarfaris', 'fedorov1', 'tsteige2', 'lumiao88', 'richers1', 'robert25', 'aneavil2', 'hsu16', 'meagher1', 'eshanso', 'will07c5', 'cheng78', 'cjsmile', 'horvat1', 'liu141', 'schlude1', 'drmalkovich', 'rareearth', 'dluzen3', 'huilinng', 'healy4', 'tmalone3', 'shin34', 'maoshouse', 'beaver1128', 'nanto1', 'cpwalsh2', 'eszato', 'scholl1', 'akshat1521', 'divito3', 'rmuryan2', 'icfmi90', 'gomez14', 'artus1', 'rishi_ratan', 'chan47', 'skyzzm', 'willspringzhang', 'chinvet1', 'mcarney2', 'snowpd', 'darkhelmet2346', 'felipealonso1', 'gkx39', 'sixgallon', 'hamburger123', 'karlsino', 'rmahaja2', 'djtanaka', 'cschan3', 'nammari1', 'diablopbc', 'tuoliu1', 'squeeksrocks', 'pyropenguinx', 'kazi1', 'megarza2', 'crzftx', 'cvendi2', 'jsun31', 'tungdo1', 'tbvance', 'gheimbe2', 'dgrocho2', 'uppal1', 'yc_ng', 'stacey2', 'bobbit1', 'dongdong', 'xu34', 'pay1', 'hillebr1', 'kbliu46', 'niyingkan', 'dhruvbhatia7', 'tmurray5', 'bhuiya1', 'cthayer3', 'cyanrook', 'cjhughes17', 'swaffor1']"
2,135,134,10,9,"['balistic2', 'tmurray5', 'will07c5', 'artus1', 'geneyu2', 'tonyli1', 'beran1', 'stoddar1', 'aneavil2']",124,"['hipaulshi', 'bpatzin2', 'cardena2', 'kim325', 'beugels1', 'shook2', 'saima1', 'photoyub', 'perng2', 'cheeloh1', 'boehle2', 'phoenix_0510', 'jortiz125', 'wicky', 'mmenon3', 'zhimin', 'liu7979', 'crazycai', 'ericcj21', 'johnso49', 'wrubrec2', 'barlaz', 'frost1', 'keramat1', 'kocek1', 'marchevskiy', 'mus423', 'spitula2', 'foo5', 'bertbusdriver', 'lilgoose3', 'pcrutch2', 'moruzi1', 'mast5', 'daiyuan1991', 'nahsor', 'akusan', 'echo781', 'fahim89', 'tohms19', 'suchko1', 'komo', 'forcejedi', 'capota2', 'kejacs', 'baruin2', 'ammarfaris', 'fedorov1', 'tsteige2', 'lumiao88', 'richers1', 'robert25', 'hsu16', 'meagher1', 'eshanso', 'cheng78', 'cjsmile', 'horvat1', 'liu141', 'schlude1', 'drmalkovich', 'rareearth', 'dluzen3', 'huilinng', 'healy4', 'tmalone3', 'shin34', 'maoshouse', 'beaver1128', 'nanto1', 'cpwalsh2', 'eszato', 'scholl1', 'akshat1521', 'divito3', 'rmuryan2', 'icfmi90', 'gomez14', 'rishi_ratan', 'chan47', 'skyzzm', 'willspringzhang', 'chinvet1', 'mcarney2', 'snowpd', 'darkhelmet2346', 'felipealonso1', 'gkx39', 'sixgallon', 'hamburger123', 'karlsino', 'rmahaja2', 'djtanaka', 'cschan3', 'nammari1', 'diablopbc', 'tuoliu1', 'squeeksrocks', 'pyropenguinx', 'kazi1', 'megarza2', 'crzftx', 'cvendi2', 'jsun31', 'tungdo1', 'tbvance', 'gheimbe2', 'dgrocho2', 'uppal1', 'yc_ng', 'stacey2', 'bobbit1', 'dongdong', 'xu34', 'pay1', 'hillebr1', 'kbliu46', 'niyingkan', 'dhruvbhatia7', 'bhuiya1', 'cthayer3', 'cyanrook', 'cjhughes17', 'swaffor1']",1,[None],134,"['balistic2', 'hipaulshi', 'bpatzin2', 'cardena2', 'kim325', 'beugels1', 'shook2', 'saima1', 'photoyub', 'perng2', 'cheeloh1', 'boehle2', 'phoenix_0510', 'jortiz125', 'wicky', 'mmenon3', 'beran1', 'zhimin', 'liu7979', 'crazycai', 'ericcj21', 'johnso49', 'wrubrec2', 'barlaz', 'tonyli1', 'frost1', 'keramat1', 'kocek1', 'marchevskiy', 'mus423', 'spitula2', 'foo5', 'bertbusdriver', 'lilgoose3', 'pcrutch2', 'moruzi1', 'mast5', 'stoddar1', 'daiyuan1991', 'nahsor', 'akusan', 'echo781', 'fahim89', 'tohms19', 'suchko1', 'komo', 'geneyu2', 'forcejedi', 'capota2', 'kejacs', None, 'baruin2', 'ammarfaris', 'fedorov1', 'tsteige2', 'lumiao88', 'richers1', 'robert25', 'aneavil2', 'hsu16', 'meagher1', 'eshanso', 'will07c5', 'cheng78', 'cjsmile', 'horvat1', 'liu141', 'schlude1', 'drmalkovich', 'rareearth', 'dluzen3', 'huilinng', 'healy4', 'tmalone3', 'shin34', 'maoshouse', 'beaver1128', 'nanto1', 'cpwalsh2', 'eszato', 'scholl1', 'akshat1521', 'divito3', 'rmuryan2', 'icfmi90', 'gomez14', 'artus1', 'rishi_ratan', 'chan47', 'skyzzm', 'willspringzhang', 'chinvet1', 'mcarney2', 'snowpd', 'darkhelmet2346', 'felipealonso1', 'gkx39', 'sixgallon', 'hamburger123', 'karlsino', 'rmahaja2', 'djtanaka', 'cschan3', 'nammari1', 'diablopbc', 'tuoliu1', 'squeeksrocks', 'pyropenguinx', 'kazi1', 'megarza2', 'crzftx', 'cvendi2', 'jsun31', 'tungdo1', 'tbvance', 'gheimbe2', 'dgrocho2', 'uppal1', 'yc_ng', 'stacey2', 'bobbit1', 'dongdong', 'xu34', 'pay1', 'hillebr1', 'kbliu46', 'niyingkan', 'dhruvbhatia7', 'tmurray5', 'bhuiya1', 'cthayer3', 'cyanrook', 'cjhughes17', 'swaffor1']"
2,86,134,8,7,"['tohms19', 'sixgallon', 'willspringzhang', 'maoshouse', 'saima1', 'xu34', 'tbvance']",126,"['balistic2', 'hipaulshi', 'bpatzin2', 'cardena2', 'kim325', 'beugels1', 'shook2', 'photoyub', 'perng2', 'cheeloh1', 'boehle2', 'phoenix_0510', 'jortiz125', 'wicky', 'mmenon3', 'beran1', 'zhimin', 'liu7979', 'crazycai', 'ericcj21', 'johnso49', 'wrubrec2', 'barlaz', 'tonyli1', 'frost1', 'keramat1', 'kocek1', 'marchevskiy', 'mus423', 'spitula2', 'foo5', 'bertbusdriver', 'lilgoose3', 'pcrutch2', 'moruzi1', 'mast5', 'stoddar1', 'daiyuan1991', 'nahsor', 'akusan', 'echo781', 'fahim89', 'suchko1', 'komo', 'geneyu2', 'forcejedi', 'capota2', 'kejacs', 'baruin2', 'ammarfaris', 'fedorov1', 'tsteige2', 'lumiao88', 'richers1', 'robert25', 'aneavil2', 'hsu16', 'meagher1', 'eshanso', 'will07c5', 'cheng78', 'cjsmile', 'horvat1', 'liu141', 'schlude1', 'drmalkovich', 'rareearth', 'dluzen3', 'huilinng', 'healy4', 'tmalone3', 'shin34', 'beaver1128', 'nanto1', 'cpwalsh2', 'eszato', 'scholl1', 'akshat1521', 'divito3', 'rmuryan2', 'icfmi90', 'gomez14', 'artus1', 'rishi_ratan', 'chan47', 'skyzzm', 'chinvet1', 'mcarney2', 'snowpd', 'darkhelmet2346', 'felipealonso1', 'gkx39', 'hamburger123', 'karlsino', 'rmahaja2', 'djtanaka', 'cschan3', 'nammari1', 'diablopbc', 'tuoliu1', 'squeeksrocks', 'pyropenguinx', 'kazi1', 'megarza2', 'crzftx', 'cvendi2', 'jsun31', 'tungdo1', 'gheimbe2', 'dgrocho2', 'uppal1', 'yc_ng', 'stacey2', 'bobbit1', 'dongdong', 'pay1', 'hillebr1', 'kbliu46', 'niyingkan', 'dhruvbhatia7', 'tmurray5', 'bhuiya1', 'cthayer3', 'cyanrook', 'cjhughes17', 'swaffor1']",1,[None],134,"['balistic2', 'hipaulshi', 'bpatzin2', 'cardena2', 'kim325', 'beugels1', 'shook2', 'saima1', 'photoyub', 'perng2', 'cheeloh1', 'boehle2', 'phoenix_0510', 'jortiz125', 'wicky', 'mmenon3', 'beran1', 'zhimin', 'liu7979', 'crazycai', 'ericcj21', 'johnso49', 'wrubrec2', 'barlaz', 'tonyli1', 'frost1', 'keramat1', 'kocek1', 'marchevskiy', 'mus423', 'spitula2', 'foo5', 'bertbusdriver', 'lilgoose3', 'pcrutch2', 'moruzi1', 'mast5', 'stoddar1', 'daiyuan1991', 'nahsor', 'akusan', 'echo781', 'fahim89', 'tohms19', 'suchko1', 'komo', 'geneyu2', 'forcejedi', 'capota2', 'kejacs', None, 'baruin2', 'ammarfaris', 'fedorov1', 'tsteige2', 'lumiao88', 'richers1', 'robert25', 'aneavil2', 'hsu16', 'meagher1', 'eshanso', 'will07c5', 'cheng78', 'cjsmile', 'horvat1', 'liu141', 'schlude1', 'drmalkovich', 'rareearth', 'dluzen3', 'huilinng', 'healy4', 'tmalone3', 'shin34', 'maoshouse', 'beaver1128', 'nanto1', 'cpwalsh2', 'eszato', 'scholl1', 'akshat1521', 'divito3', 'rmuryan2', 'icfmi90', 'gomez14', 'artus1', 'rishi_ratan', 'chan47', 'skyzzm', 'willspringzhang', 'chinvet1', 'mcarney2', 'snowpd', 'darkhelmet2346', 'felipealonso1', 'gkx39', 'sixgallon', 'hamburger123', 'karlsino', 'rmahaja2', 'djtanaka', 'cschan3', 'nammari1', 'diablopbc', 'tuoliu1', 'squeeksrocks', 'pyropenguinx', 'kazi1', 'megarza2', 'crzftx', 'cvendi2', 'jsun31', 'tungdo1', 'tbvance', 'gheimbe2', 'dgrocho2', 'uppal1', 'yc_ng', 'stacey2', 'bobbit1', 'dongdong', 'xu34', 'pay1', 'hillebr1', 'kbliu46', 'niyingkan', 'dhruvbhatia7', 'tmurray5', 'bhuiya1', 'cthayer3', 'cyanrook', 'cjhughes17', 'swaffor1']"
2,136,134,8,5,"['mus423', 'liu7979', 'dongdong', 'rareearth', 'dgrocho2']",128,"['balistic2', 'hipaulshi', 'bpatzin2', 'cardena2', 'kim325', 'beugels1', 'shook2', 'saima1', 'photoyub', 'perng2', 'cheeloh1', 'boehle2', 'phoenix_0510', 'jortiz125', 'wicky', 'mmenon3', 'beran1', 'zhimin', 'crazycai', 'ericcj21', 'johnso49', 'wrubrec2', 'barlaz', 'tonyli1', 'frost1', 'keramat1', 'kocek1', 'marchevskiy', 'spitula2', 'foo5', 'bertbusdriver', 'lilgoose3', 'pcrutch2', 'moruzi1', 'mast5', 'stoddar1', 'daiyuan1991', 'nahsor', 'akusan', 'echo781', 'fahim89', 'tohms19', 'suchko1', 'komo', 'geneyu2', 'forcejedi', 'capota2', 'kejacs', 'baruin2', 'ammarfaris', 'fedorov1', 'tsteige2', 'lumiao88', 'richers1', 'robert25', 'aneavil2', 'hsu16', 'meagher1', 'eshanso', 'will07c5', 'cheng78', 'cjsmile', 'horvat1', 'liu141', 'schlude1', 'drmalkovich', 'dluzen3', 'huilinng', 'healy4', 'tmalone3', 'shin34', 'maoshouse', 'beaver1128', 'nanto1', 'cpwalsh2', 'eszato', 'scholl1', 'akshat1521', 'divito3', 'rmuryan2', 'icfmi90', 'gomez14', 'artus1', 'rishi_ratan', 'chan47', 'skyzzm', 'willspringzhang', 'chinvet1', 'mcarney2', 'snowpd', 'darkhelmet2346', 'felipealonso1', 'gkx39', 'sixgallon', 'hamburger123', 'karlsino', 'rmahaja2', 'djtanaka', 'cschan3', 'nammari1', 'diablopbc', 'tuoliu1', 'squeeksrocks', 'pyropenguinx', 'kazi1', 'megarza2', 'crzftx', 'cvendi2', 'jsun31', 'tungdo1', 'tbvance', 'gheimbe2', 'uppal1', 'yc_ng', 'stacey2', 'bobbit1', 'xu34', 'pay1', 'hillebr1', 'kbliu46', 'niyingkan', 'dhruvbhatia7', 'tmurray5', 'bhuiya1', 'cthayer3', 'cyanrook', 'cjhughes17', 'swaffor1']",3,"['lu34', 'schaffe3', None]",136,"['balistic2', 'hipaulshi', 'bpatzin2', 'cardena2', 'kim325', 'beugels1', 'shook2', 'saima1', 'photoyub', 'perng2', 'cheeloh1', 'boehle2', 'phoenix_0510', 'jortiz125', 'wicky', 'mmenon3', 'beran1', 'zhimin', 'liu7979', 'crazycai', 'ericcj21', 'johnso49', 'wrubrec2', 'barlaz', 'tonyli1', 'frost1', 'keramat1', 'kocek1', 'marchevskiy', 'mus423', 'spitula2', 'foo5', 'bertbusdriver', 'lilgoose3', 'pcrutch2', 'moruzi1', 'mast5', 'stoddar1', 'daiyuan1991', 'nahsor', 'akusan', 'echo781', 'fahim89', 'tohms19', 'suchko1', 'komo', 'geneyu2', 'forcejedi', 'capota2', 'kejacs', 'schaffe3', None, 'baruin2', 'ammarfaris', 'fedorov1', 'tsteige2', 'lumiao88', 'richers1', 'robert25', 'aneavil2', 'hsu16', 'meagher1', 'eshanso', 'will07c5', 'cheng78', 'cjsmile', 'horvat1', 'liu141', 'schlude1', 'drmalkovich', 'rareearth', 'dluzen3', 'lu34', 'huilinng', 'healy4', 'tmalone3', 'shin34', 'maoshouse', 'beaver1128', 'nanto1', 'cpwalsh2', 'eszato', 'scholl1', 'akshat1521', 'divito3', 'rmuryan2', 'icfmi90', 'gomez14', 'artus1', 'rishi_ratan', 'chan47', 'skyzzm', 'willspringzhang', 'chinvet1', 'mcarney2', 'snowpd', 'darkhelmet2346', 'felipealonso1', 'gkx39', 'sixgallon', 'hamburger123', 'karlsino', 'rmahaja2', 'djtanaka', 'cschan3', 'nammari1', 'diablopbc', 'tuoliu1', 'squeeksrocks', 'pyropenguinx', 'kazi1', 'megarza2', 'crzftx', 'cvendi2', 'jsun31', 'tungdo1', 'tbvance', 'gheimbe2', 'dgrocho2', 'uppal1', 'yc_ng', 'stacey2', 'bobbit1', 'dongdong', 'xu34', 'pay1', 'hillebr1', 'kbliu46', 'niyingkan', 'dhruvbhatia7', 'tmurray5', 'bhuiya1', 'cthayer3', 'cyanrook', 'cjhughes17', 'swaffor1']"
2,137,134,8,5,"['tohms19', 'maoshouse', 'saima1', 'xu34', 'tbvance']",128,"['balistic2', 'hipaulshi', 'bpatzin2', 'cardena2', 'kim325', 'beugels1', 'shook2', 'photoyub', 'perng2', 'cheeloh1', 'boehle2', 'phoenix_0510', 'jortiz125', 'wicky', 'mmenon3', 'beran1', 'zhimin', 'liu7979', 'crazycai', 'ericcj21', 'johnso49', 'wrubrec2', 'barlaz', 'tonyli1', 'frost1', 'keramat1', 'kocek1', 'marchevskiy', 'mus423', 'spitula2', 'foo5', 'bertbusdriver', 'lilgoose3', 'pcrutch2', 'moruzi1', 'mast5', 'stoddar1', 'daiyuan1991', 'nahsor', 'akusan', 'echo781', 'fahim89', 'suchko1', 'komo', 'geneyu2', 'forcejedi', 'capota2', 'kejacs', 'baruin2', 'ammarfaris', 'fedorov1', 'tsteige2', 'lumiao88', 'richers1', 'robert25', 'aneavil2', 'hsu16', 'meagher1', 'eshanso', 'will07c5', 'cheng78', 'cjsmile', 'horvat1', 'liu141', 'schlude1', 'drmalkovich', 'rareearth', 'dluzen3', 'huilinng', 'healy4', 'tmalone3', 'shin34', 'beaver1128', 'nanto1', 'cpwalsh2', 'eszato', 'scholl1', 'akshat1521', 'divito3', 'rmuryan2', 'icfmi90', 'gomez14', 'artus1', 'rishi_ratan', 'chan47', 'skyzzm', 'willspringzhang', 'chinvet1', 'mcarney2', 'snowpd', 'darkhelmet2346', 'felipealonso1', 'gkx39', 'sixgallon', 'hamburger123', 'karlsino', 'rmahaja2', 'djtanaka', 'cschan3', 'nammari1', 'diablopbc', 'tuoliu1', 'squeeksrocks', 'pyropenguinx', 'kazi1', 'megarza2', 'crzftx', 'cvendi2', 'jsun31', 'tungdo1', 'gheimbe2', 'dgrocho2', 'uppal1', 'yc_ng', 'stacey2', 'bobbit1', 'dongdong', 'pay1', 'hillebr1', 'kbliu46', 'niyingkan', 'dhruvbhatia7', 'tmurray5', 'bhuiya1', 'cthayer3', 'cyanrook', 'cjhughes17', 'swaffor1']",3,"['siucarlos', None, 'xu52']",136,"['balistic2', 'hipaulshi', 'bpatzin2', 'cardena2', 'kim325', 'beugels1', 'shook2', 'saima1', 'photoyub', 'perng2', 'cheeloh1', 'boehle2', 'phoenix_0510', 'jortiz125', 'wicky', 'mmenon3', 'beran1', 'zhimin', 'liu7979', 'crazycai', 'ericcj21', 'johnso49', 'wrubrec2', 'barlaz', 'tonyli1', 'frost1', 'keramat1', 'kocek1', 'marchevskiy', 'mus423', 'spitula2', 'foo5', 'bertbusdriver', 'lilgoose3', 'pcrutch2', 'moruzi1', 'mast5', 'stoddar1', 'daiyuan1991', 'nahsor', 'akusan', 'echo781', 'fahim89', 'tohms19', 'suchko1', 'komo', 'geneyu2', 'forcejedi', 'capota2', 'kejacs', None, 'baruin2', 'ammarfaris', 'fedorov1', 'tsteige2', 'lumiao88', 'richers1', 'robert25', 'aneavil2', 'hsu16', 'meagher1', 'eshanso', 'will07c5', 'cheng78', 'cjsmile', 'horvat1', 'liu141', 'schlude1', 'xu52', 'drmalkovich', 'rareearth', 'dluzen3', 'huilinng', 'healy4', 'tmalone3', 'shin34', 'maoshouse', 'beaver1128', 'nanto1', 'cpwalsh2', 'eszato', 'scholl1', 'akshat1521', 'divito3', 'rmuryan2', 'icfmi90', 'gomez14', 'artus1', 'rishi_ratan', 'chan47', 'skyzzm', 'willspringzhang', 'chinvet1', 'mcarney2', 'snowpd', 'darkhelmet2346', 'felipealonso1', 'gkx39', 'sixgallon', 'hamburger123', 'siucarlos', 'karlsino', 'rmahaja2', 'djtanaka', 'cschan3', 'nammari1', 'diablopbc', 'tuoliu1', 'squeeksrocks', 'pyropenguinx', 'kazi1', 'megarza2', 'crzftx', 'cvendi2', 'jsun31', 'tungdo1', 'tbvance', 'gheimbe2', 'dgrocho2', 'uppal1', 'yc_ng', 'stacey2', 'bobbit1', 'dongdong', 'xu34', 'pay1', 'hillebr1', 'kbliu46', 'niyingkan', 'dhruvbhatia7', 'tmurray5', 'bhuiya1', 'cthayer3', 'cyanrook', 'cjhughes17', 'swaffor1']"
2,66,134,7,4,"['mast5', 'dgrocho2', 'dongdong', 'mus423']",129,"['balistic2', 'hipaulshi', 'bpatzin2', 'cardena2', 'kim325', 'beugels1', 'shook2', 'saima1', 'photoyub', 'perng2', 'cheeloh1', 'boehle2', 'phoenix_0510', 'jortiz125', 'wicky', 'mmenon3', 'beran1', 'zhimin', 'liu7979', 'crazycai', 'ericcj21', 'johnso49', 'wrubrec2', 'barlaz', 'tonyli1', 'frost1', 'keramat1', 'kocek1', 'marchevskiy', 'spitula2', 'foo5', 'bertbusdriver', 'lilgoose3', 'pcrutch2', 'moruzi1', 'stoddar1', 'daiyuan1991', 'nahsor', 'akusan', 'echo781', 'fahim89', 'tohms19', 'suchko1', 'komo', 'geneyu2', 'forcejedi', 'capota2', 'kejacs', 'baruin2', 'ammarfaris', 'fedorov1', 'tsteige2', 'lumiao88', 'richers1', 'robert25', 'aneavil2', 'hsu16', 'meagher1', 'eshanso', 'will07c5', 'cheng78', 'cjsmile', 'horvat1', 'liu141', 'schlude1', 'drmalkovich', 'rareearth', 'dluzen3', 'huilinng', 'healy4', 'tmalone3', 'shin34', 'maoshouse', 'beaver1128', 'nanto1', 'cpwalsh2', 'eszato', 'scholl1', 'akshat1521', 'divito3', 'rmuryan2', 'icfmi90', 'gomez14', 'artus1', 'rishi_ratan', 'chan47', 'skyzzm', 'willspringzhang', 'chinvet1', 'mcarney2', 'snowpd', 'darkhelmet2346', 'felipealonso1', 'gkx39', 'sixgallon', 'hamburger123', 'karlsino', 'rmahaja2', 'djtanaka', 'cschan3', 'nammari1', 'diablopbc', 'tuoliu1', 'squeeksrocks', 'pyropenguinx', 'kazi1', 'megarza2', 'crzftx', 'cvendi2', 'jsun31', 'tungdo1', 'tbvance', 'gheimbe2', 'uppal1', 'yc_ng', 'stacey2', 'bobbit1', 'xu34', 'pay1', 'hillebr1', 'kbliu46', 'niyingkan', 'dhruvbhatia7', 'tmurray5', 'bhuiya1', 'cthayer3', 'cyanrook', 'cjhughes17', 'swaffor1']",3,"['kevin5345179', 'lu34', None]",136,"['balistic2', 'hipaulshi', 'bpatzin2', 'cardena2', 'kim325', 'beugels1', 'shook2', 'saima1', 'photoyub', 'perng2', 'cheeloh1', 'boehle2', 'phoenix_0510', 'jortiz125', 'wicky', 'mmenon3', 'beran1', 'zhimin', 'liu7979', 'crazycai', 'ericcj21', 'johnso49', 'wrubrec2', 'barlaz', 'tonyli1', 'frost1', 'keramat1', 'kocek1', 'marchevskiy', 'mus423', 'spitula2', 'foo5', 'bertbusdriver', 'lilgoose3', 'pcrutch2', 'moruzi1', 'mast5', 'stoddar1', 'daiyuan1991', 'nahsor', 'akusan', 'echo781', 'fahim89', 'tohms19', 'suchko1', 'komo', 'geneyu2', 'forcejedi', 'capota2', 'kejacs', None, 'baruin2', 'ammarfaris', 'fedorov1', 'tsteige2', 'lumiao88', 'richers1', 'robert25', 'aneavil2', 'hsu16', 'meagher1', 'eshanso', 'will07c5', 'cheng78', 'cjsmile', 'horvat1', 'liu141', 'schlude1', 'drmalkovich', 'rareearth', 'dluzen3', 'lu34', 'huilinng', 'healy4', 'tmalone3', 'shin34', 'maoshouse', 'beaver1128', 'nanto1', 'cpwalsh2', 'eszato', 'scholl1', 'akshat1521', 'divito3', 'rmuryan2', 'icfmi90', 'gomez14', 'artus1', 'rishi_ratan', 'chan47', 'skyzzm', 'willspringzhang', 'chinvet1', 'mcarney2', 'snowpd', 'darkhelmet2346', 'felipealonso1', 'gkx39', 'sixgallon', 'kevin5345179', 'hamburger123', 'karlsino', 'rmahaja2', 'djtanaka', 'cschan3', 'nammari1', 'diablopbc', 'tuoliu1', 'squeeksrocks', 'pyropenguinx', 'kazi1', 'megarza2', 'crzftx', 'cvendi2', 'jsun31', 'tungdo1', 'tbvance', 'gheimbe2', 'dgrocho2', 'uppal1', 'yc_ng', 'stacey2', 'bobbit1', 'dongdong', 'xu34', 'pay1', 'hillebr1', 'kbliu46', 'niyingkan', 'dhruvbhatia7', 'tmurray5', 'bhuiya1', 'cthayer3', 'cyanrook', 'cjhughes17', 'swaffor1']"
2,69,134,7,3,"['saima1', 'tbvance', 'sixgallon']",130,"['balistic2', 'hipaulshi', 'bpatzin2', 'cardena2', 'kim325', 'beugels1', 'shook2', 'photoyub', 'perng2', 'cheeloh1', 'boehle2', 'phoenix_0510', 'jortiz125', 'wicky', 'mmenon3', 'beran1', 'zhimin', 'liu7979', 'crazycai', 'ericcj21', 'johnso49', 'wrubrec2', 'barlaz', 'tonyli1', 'frost1', 'keramat1', 'kocek1', 'marchevskiy', 'mus423', 'spitula2', 'foo5', 'bertbusdriver', 'lilgoose3', 'pcrutch2', 'moruzi1', 'mast5', 'stoddar1', 'daiyuan1991', 'nahsor', 'akusan', 'echo781', 'fahim89', 'tohms19', 'suchko1', 'komo', 'geneyu2', 'forcejedi', 'capota2', 'kejacs', 'baruin2', 'ammarfaris', 'fedorov1', 'tsteige2', 'lumiao88', 'richers1', 'robert25', 'aneavil2', 'hsu16', 'meagher1', 'eshanso', 'will07c5', 'cheng78', 'cjsmile', 'horvat1', 'liu141', 'schlude1', 'drmalkovich', 'rareearth', 'dluzen3', 'huilinng', 'healy4', 'tmalone3', 'shin34', 'maoshouse', 'beaver1128', 'nanto1', 'cpwalsh2', 'eszato', 'scholl1', 'akshat1521', 'divito3', 'rmuryan2', 'icfmi90', 'gomez14', 'artus1', 'rishi_ratan', 'chan47', 'skyzzm', 'willspringzhang', 'chinvet1', 'mcarney2', 'snowpd', 'darkhelmet2346', 'felipealonso1', 'gkx39', 'hamburger123', 'karlsino', 'rmahaja2', 'djtanaka', 'cschan3', 'nammari1', 'diablopbc', 'tuoliu1', 'squeeksrocks', 'pyropenguinx', 'kazi1', 'megarza2', 'crzftx', 'cvendi2', 'jsun31', 'tungdo1', 'gheimbe2', 'dgrocho2', 'uppal1', 'yc_ng', 'stacey2', 'bobbit1', 'dongdong', 'xu34', 'pay1', 'hillebr1', 'kbliu46', 'niyingkan', 'dhruvbhatia7', 'tmurray5', 'bhuiya1', 'cthayer3', 'cyanrook', 'cjhughes17', 'swaffor1']",4,"['pao1', None, 'leo19890725', 'mkchow5913']",137,"['balistic2', 'hipaulshi', 'bpatzin2', 'cardena2', 'mkchow5913', 'kim325', 'beugels1', 'shook2', 'saima1', 'photoyub', 'perng2', 'cheeloh1', 'boehle2', 'phoenix_0510', 'jortiz125', 'wicky', 'mmenon3', 'beran1', 'zhimin', 'liu7979', 'crazycai', 'ericcj21', 'johnso49', 'wrubrec2', 'barlaz', 'tonyli1', 'frost1', 'keramat1', 'kocek1', 'marchevskiy', 'mus423', 'spitula2', 'foo5', 'bertbusdriver', 'lilgoose3', 'pcrutch2', 'moruzi1', 'mast5', 'stoddar1', 'daiyuan1991', 'nahsor', 'akusan', 'echo781', 'fahim89', 'tohms19', 'suchko1', 'komo', 'geneyu2', 'forcejedi', 'capota2', 'kejacs', None, 'baruin2', 'ammarfaris', 'fedorov1', 'tsteige2', 'lumiao88', 'richers1', 'robert25', 'aneavil2', 'hsu16', 'meagher1', 'eshanso', 'will07c5', 'cheng78', 'cjsmile', 'horvat1', 'liu141', 'schlude1', 'drmalkovich', 'rareearth', 'dluzen3', 'huilinng', 'healy4', 'tmalone3', 'shin34', 'maoshouse', 'beaver1128', 'nanto1', 'cpwalsh2', 'eszato', 'scholl1', 'akshat1521', 'divito3', 'rmuryan2', 'icfmi90', 'gomez14', 'artus1', 'rishi_ratan', 'chan47', 'skyzzm', 'willspringzhang', 'chinvet1', 'mcarney2', 'snowpd', 'darkhelmet2346', 'felipealonso1', 'gkx39', 'sixgallon', 'hamburger123', 'karlsino', 'leo19890725', 'rmahaja2', 'djtanaka', 'cschan3', 'pao1', 'nammari1', 'diablopbc', 'tuoliu1', 'squeeksrocks', 'pyropenguinx', 'kazi1', 'megarza2', 'crzftx', 'cvendi2', 'jsun31', 'tungdo1', 'tbvance', 'gheimbe2', 'dgrocho2', 'uppal1', 'yc_ng', 'stacey2', 'bobbit1', 'dongdong', 'xu34', 'pay1', 'hillebr1', 'kbliu46', 'niyingkan', 'dhruvbhatia7', 'tmurray5', 'bhuiya1', 'cthayer3', 'cyanrook', 'cjhughes17', 'swaffor1']"
3,109,52,47,44,"['afretana7', 'jamiller1', 'klopez', 'roobster', 'duyh', 'pnostlund', 'wgunawan', 'npdang', 'waiwuta', 'mamcdannel', 'quocttran', 'wgsanders', 'burlsmith', 'rjrandle', 'kjslevkov', 'yanghungliu', 'jmcvjetkovic', 'inhoekim', 'mggatas', 'gnvu', 'smstumpf', 'tkportugal', 'cffreire', 'aplargoza', 'adcava', 'alejandrov', 'jsbristol', 'rlchapman', 'jdturner', 'bperaza', 'andoan', 'pdbenalcazar', 'marcoslemus', 'pjpatel', 'slsu', 'kjjudy', 'kmjohnson', 'krpeltcher', 'kewickizer', 'mvmarquez', 'mamontalvo', 'mesmele', 'jmekstrom', 'creek1']",7,"['skunal19', 'rubncto', 'gasimmons', 'salvadorg', 'jsegura88', 'majidirshad', 'ra2006ra21']",3,"['faltens', None, 'dresquer']",54,"['afretana7', 'jamiller1', 'klopez', 'roobster', 'jmekstrom', 'dresquer', 'pnostlund', 'npdang', 'quocttran', 'majidirshad', 'rjrandle', 'kjslevkov', 'jmcvjetkovic', 'mggatas', 'tkportugal', 'jsegura88', 'aplargoza', 'adcava', 'alejandrov', 'andoan', 'rlchapman', 'jdturner', 'bperaza', 'jsbristol', 'pdbenalcazar', 'slsu', 'kjjudy', 'krpeltcher', 'mamontalvo', 'mesmele', 'creek1', 'duyh', 'wgunawan', 'waiwuta', 'rubncto', 'mamcdannel', 'wgsanders', 'burlsmith', 'yanghungliu', 'inhoekim', 'gasimmons', 'gnvu', 'smstumpf', 'salvadorg', 'cffreire', 'marcoslemus', 'faltens', 'pjpatel', None, 'skunal19', 'kmjohnson', 'kewickizer', 'ra2006ra21', 'mvmarquez']"
3,59,52,34,1,['majidirshad'],50,"['afretana7', 'jamiller1', 'klopez', 'roobster', 'jmekstrom', 'pnostlund', 'duyh', 'wgunawan', 'npdang', 'waiwuta', 'rubncto', 'mamcdannel', 'quocttran', 'wgsanders', 'burlsmith', 'rjrandle', 'kjslevkov', 'yanghungliu', 'jmcvjetkovic', 'inhoekim', 'mggatas', 'gnvu', 'smstumpf', 'gasimmons', 'jsegura88', 'tkportugal', 'cffreire', 'salvadorg', 'aplargoza', 'marcoslemus', 'alejandrov', 'andoan', 'pjpatel', 'jdturner', 'bperaza', 'rlchapman', 'pdbenalcazar', 'jsbristol', 'adcava', 'slsu', 'skunal19', 'kmjohnson', 'kjjudy', 'krpeltcher', 'kewickizer', 'ra2006ra21', 'mamontalvo', 'mesmele', 'mvmarquez', 'creek1']",33,"['maheen03', 'abdulmajid123', 'bushrajafri', 'namrah', 'bushara', 'hirashumail', 'ssdlab', 'fehmida', 'marium', 'maliha', 'sfb_baig', 'mahhammustafa', 'palwashazafar', 'safia', 'humaira13', 'ayazned', 'hera', 'faaz90', 'kamranasghar', 'mudasir', 'shamim', 'wardah', 'sumayya', 'sinlessdev', 'fahadhussain', None, 'taqi', 'mumairsaleem', 'hiraimtiaz', 'fari911', 'syedaamna', 'kanza', 'sadafdilshad']",84,"['afretana7', 'jamiller1', 'namrah', 'klopez', 'roobster', 'jmekstrom', 'pnostlund', 'hirashumail', 'npdang', 'quocttran', 'majidirshad', 'rjrandle', 'sfb_baig', 'palwashazafar', 'kjslevkov', 'jmcvjetkovic', 'safia', 'mggatas', 'tkportugal', 'jsegura88', 'ayazned', 'hera', 'faaz90', 'aplargoza', 'adcava', 'alejandrov', 'andoan', 'rlchapman', 'jdturner', 'bperaza', 'jsbristol', 'pdbenalcazar', 'mudasir', 'shamim', 'slsu', 'wardah', 'sumayya', 'fahadhussain', 'kjjudy', 'hiraimtiaz', 'fari911', 'krpeltcher', 'kanza', 'mamontalvo', 'mesmele', 'creek1', 'maheen03', 'abdulmajid123', 'bushrajafri', 'bushara', 'duyh', 'ssdlab', 'wgunawan', 'waiwuta', 'fehmida', 'rubncto', 'mamcdannel', 'marium', 'wgsanders', 'burlsmith', 'maliha', 'mahhammustafa', 'yanghungliu', 'inhoekim', 'humaira13', 'gasimmons', 'gnvu', 'smstumpf', 'salvadorg', 'cffreire', 'kamranasghar', 'marcoslemus', 'pjpatel', 'sinlessdev', None, 'taqi', 'mumairsaleem', 'skunal19', 'kmjohnson', 'syedaamna', 'kewickizer', 'ra2006ra21', 'sadafdilshad', 'mvmarquez']"
3,106,52,22,20,"['klopez', 'rubncto', 'burlsmith', 'kjslevkov', 'gasimmons', 'gnvu', 'salvadorg', 'jsegura88', 'cffreire', 'adcava', 'alejandrov', 'rlchapman', 'andoan', 'jsbristol', 'marcoslemus', 'pjpatel', 'kmjohnson', 'krpeltcher', 'kewickizer', 'ra2006ra21']",31,"['afretana7', 'jamiller1', 'roobster', 'jmekstrom', 'pnostlund', 'duyh', 'wgunawan', 'npdang', 'waiwuta', 'mamcdannel', 'quocttran', 'wgsanders', 'majidirshad', 'rjrandle', 'yanghungliu', 'jmcvjetkovic', 'inhoekim', 'mggatas', 'smstumpf', 'tkportugal', 'aplargoza', 'jdturner', 'bperaza', 'pdbenalcazar', 'slsu', 'skunal19', 'kjjudy', 'mamontalvo', 'mesmele', 'mvmarquez', 'creek1']",2,"['faltens', None]",53,"['afretana7', 'jamiller1', 'klopez', 'roobster', 'faltens', 'duyh', 'pnostlund', 'wgunawan', 'npdang', 'waiwuta', 'rubncto', 'mamcdannel', 'quocttran', 'wgsanders', 'burlsmith', 'majidirshad', 'rjrandle', 'kjslevkov', 'yanghungliu', 'jmcvjetkovic', 'inhoekim', 'mggatas', 'gnvu', 'smstumpf', 'gasimmons', 'jsegura88', 'tkportugal', 'cffreire', 'salvadorg', 'aplargoza', 'marcoslemus', 'alejandrov', 'andoan', 'pjpatel', 'jdturner', 'bperaza', 'rlchapman', 'pdbenalcazar', 'jsbristol', 'adcava', 'slsu', None, 'skunal19', 'kmjohnson', 'kjjudy', 'krpeltcher', 'kewickizer', 'mvmarquez', 'ra2006ra21', 'mamontalvo', 'mesmele', 'jmekstrom', 'creek1']"
3,108,52,7,6,"['waiwuta', 'kmjohnson', 'kjjudy', 'mggatas', 'gasimmons', 'tkportugal']",45,"['afretana7', 'jamiller1', 'klopez', 'roobster', 'duyh', 'pnostlund', 'wgunawan', 'npdang', 'rubncto', 'mamcdannel', 'quocttran', 'wgsanders', 'burlsmith', 'majidirshad', 'rjrandle', 'kjslevkov', 'yanghungliu', 'jmcvjetkovic', 'inhoekim', 'gnvu', 'smstumpf', 'jsegura88', 'cffreire', 'salvadorg', 'aplargoza', 'marcoslemus', 'alejandrov', 'andoan', 'pjpatel', 'jdturner', 'bperaza', 'rlchapman', 'pdbenalcazar', 'jsbristol', 'adcava', 'slsu', 'skunal19', 'krpeltcher', 'kewickizer', 'mvmarquez', 'ra2006ra21', 'mamontalvo', 'mesmele', 'jmekstrom', 'creek1']",1,[None],52,"['afretana7', 'jamiller1', 'klopez', 'roobster', 'duyh', 'pnostlund', 'wgunawan', 'npdang', 'waiwuta', 'rubncto', 'mamcdannel', 'quocttran', 'wgsanders', 'burlsmith', 'majidirshad', 'rjrandle', 'kjslevkov', 'yanghungliu', 'jmcvjetkovic', 'inhoekim', 'mggatas', 'gnvu', 'smstumpf', 'gasimmons', 'jsegura88', 'tkportugal', 'cffreire', 'salvadorg', 'aplargoza', 'marcoslemus', 'alejandrov', 'andoan', 'pjpatel', 'jdturner', 'bperaza', 'rlchapman', 'pdbenalcazar', 'jsbristol', 'adcava', 'slsu', None, 'skunal19', 'kmjohnson', 'kjjudy', 'krpeltcher', 'kewickizer', 'mvmarquez', 'ra2006ra21', 'mamontalvo', 'mesmele', 'jmekstrom', 'creek1']"
4,163,51,217,28,"['benkiesel', 'ajiang', 'kevinbilal', 'noor207', 'jennifersiedjak', 'diamondlg21', 'carolinedarin', 'jaleel', 'amunarang', 'zdk186', 'aew751', 'oniontech', 'jwj198', 'zp2014', 'davidlin49', 'harryyu', 'bob323', 'clockwork', 'charley', 'zchsnow0', 'jsierks', 'sah199', 'pthimsuwan', 'jws600', 'ssalah', 'lhv642', 'thecrazedbaker1', 'ruthjackie']",22,"['ssmith23', 'armel', 'dgraninger', 'jpk953', 'rtsenthilkumarpnt', 'bendover', 'cjj777', 'nvoelcker', 'mgs943', 'haley6', 'bburruss', 'kferry', 'pablosanchez', 'mini6467', 'jbk285', 'tomvonheill', 'okedem', 'rsfyath', 'v_singlemolecule_r', 'raytusc', 'crhodes', 'zabin']",189,"['vmitra92', 'vickieotto', 'nuchem', 'eeg951', 'lph854', 'ebens', 'swa423', 'changbeeray', 'kmdoherty', 'musiclover324', 'phw454', 'teresak', 'amandaziffer2014', 'lisamithun', 'jwoll1692', 'chem10232269', 'ipreston', 'elisees', 'sicelo', 'dangerousdan', 'cthayer709', 'jquinn825', 'mweber', 'annpowers2014', 'rgruenhagen', 'hct669', 'chc727', 'ssa886', 'jwu525', 'jboxman7', 'jmb489', 'dannyginz', 'tdupper', 'runningfreak21', 'payasarraf1', 'pvonachen', 'edp592', 'fjk562', 'dannywinans', 'har580', 'aqh681', 'hrendos', 'yaejinpark2014', 'scoobidy', 'jkchem3', 'mmmccc', 'msistla46', 'willworden', 'bmsiwek', 'saracov726', 'chancecim', 'cel156', 'sraiter', 'nicroth', 'cosidari', 'clairemelvin', 'dbali423', 'njneil92', 'jbuser92', 'lae247', 'samhatfield', 'markbachrach', 'dmp556', 'gcutsail', 'wngo', 'ses457', 'rbraga25', 'mrauf13', 'lrl839', None, 'stingraymart1', 'eap01', 'dunner87', 'smc895', 'mollykbaker', 'meghan1', 'hgf596', 'ccf165', 'crkramer', 'rose', 'sor427', 'simontj', 'eek735', 'amandafrankel2014', 'slhatch', 'arilederman', 'jeg770', 'axz244', 'kapoornu', 'kalindishah', 'alannahenry', 'sdv465', 'hairandholman', 'gatesmeg', 'sjl123', 'sydneyblack', 'kik101', 'knp750', 'moekou', 'jdf478', 'lmsadowsky', 'dsh926', 'dwerickson', 'juliaretzky', 'ddjrl', 'kayliepmiller', 'kegermann', 'jkzhou99', 'knk953', 'lamar0404', 'ksd948', 'martakulich', 'ltu197', 'wchoi1025', 'ethanmcginnis2014', 'msw466', 'gmv672', 'vfa774', 'jsierks2', 'cnj373', 'sunjaejung', 'danalec23', 'edsarah', 'vishyt123', 'jeffandrose', 'samgbur', 'nehanimm', 'mz1030', 'mss647', 'bhuang92', 'abz881', 'jkilcommons', 'srv123', 'nkj745', 'mrossi14', 'azeliko', 'chriscappello', 'spencermartens', 'sahartman4', 'dlrhksgud4', 'markc', 'juliateresa1', 'rch465', 'btredz49', 'jocandkev', 'alanpan', 'nulab24c', 'hopeandseema', 'stephmandir', 'suekim2014', 'sam413', 'vwang92', 'sli674', 'ajm882', 'saxo', 'bugmenot', 'danielmcfarland', 'jcao618', 'catherinealthaus', 'lillian2011', 'danielthomas2014', 'ath800', 'wsc826', 'gusdomel', 'ntp742', 'dhw191', 'noliver97', 'amee', 'kevingreenhalgh2014', 'chem1', 'mhartoun', 'benjaminrafshoon2014', 'shawnkim332', 'varshinicherukupalli', 'sahopki', 'mwiersema', 'csilvestre', 'arps714', 'matshu92', 'coreygoodwin', 'cmw897', 'amattias', 'robbie529', 'rgeiwitz', 'aarora', 'bcarlis', 'bjr124', 'cms201', 'shilliger']",239,"['vmitra92', 'nuchem', 'kmdoherty', 'phw454', 'diamondlg21', 'carolinedarin', 'lisamithun', 'jwoll1692', 'chem10232269', 'ipreston', 'elisees', 'sicelo', 'dangerousdan', 'cthayer709', 'mweber', 'annpowers2014', 'rgruenhagen', 'hct669', 'chc727', 'ssa886', 'tomvonheill', 'dannyginz', 'okedem', 'tdupper', 'runningfreak21', 'pvonachen', 'dannywinans', 'aqh681', 'yaejinpark2014', 'scoobidy', 'jkchem3', 'kevinbilal', 'willworden', 'chancecim', 'cel156', 'sraiter', 'njneil92', 'jbuser92', 'samhatfield', 'markbachrach', 'dmp556', 'gcutsail', 'wngo', 'mrauf13', 'eap01', 'dunner87', 'mollykbaker', 'meghan1', 'ccf165', 'rose', 'sor427', 'thecrazedbaker1', 'ssmith23', 'arilederman', 'jeg770', 'axz244', 'kalindishah', 'alannahenry', 'cjj777', 'sdv465', 'oniontech', 'gatesmeg', 'zp2014', 'knp750', 'moekou', 'jdf478', 'dwerickson', 'juliaretzky', 'ddjrl', 'kegermann', 'jkzhou99', 'pthimsuwan', 'martakulich', 'ltu197', 'wchoi1025', 'ethanmcginnis2014', 'vfa774', 'danalec23', 'edsarah', 'vishyt123', 'abz881', 'samgbur', 'mz1030', 'mss647', 'crhodes', 'srv123', 'zabin', 'mrossi14', 'azeliko', 'spencermartens', 'sahartman4', 'markc', 'juliateresa1', 'rch465', 'alanpan', 'hopeandseema', 'stephmandir', 'amunarang', 'vwang92', 'saxo', 'danielmcfarland', 'catherinealthaus', 'harryyu', 'bob323', 'noliver97', 'amee', 'kevingreenhalgh2014', 'jws600', 'mwiersema', 'csilvestre', 'matshu92', 'coreygoodwin', 'raytusc', 'bcarlis', 'bjr124', 'cms201', 'sydneyblack', 'ajm882', 'dgraninger', 'vickieotto', 'eeg951', 'lph854', 'ebens', 'swa423', 'changbeeray', 'bendover', 'musiclover324', 'jaleel', 'teresak', 'amandaziffer2014', 'mgs943', 'haley6', 'jquinn825', 'davidlin49', 'zchsnow0', 'sah199', 'mini6467', 'jbk285', 'jwu525', 'jboxman7', 'jmb489', 'payasarraf1', 'edp592', 'fjk562', 'har580', 'hrendos', 'armel', 'benkiesel', 'ajiang', 'mmmccc', 'noor207', 'msistla46', 'aew751', 'bmsiwek', 'saracov726', 'nicroth', 'cosidari', 'clairemelvin', 'dbali423', 'lae247', 'clockwork', 'kferry', 'pablosanchez', 'ses457', 'rbraga25', 'lrl839', None, 'stingraymart1', 'smc895', 'hgf596', 'crkramer', 'v_singlemolecule_r', 'simontj', 'eek735', 'amandafrankel2014', 'slhatch', 'kapoornu', 'jennifersiedjak', 'hairandholman', 'sjl123', 'jwj198', 'kik101', 'lmsadowsky', 'dsh926', 'charley', 'kayliepmiller', 'knk953', 'lamar0404', 'ksd948', 'msw466', 'gmv672', 'jsierks2', 'cnj373', 'sunjaejung', 'ssalah', 'jeffandrose', 'nehanimm', 'bhuang92', 'jkilcommons', 'nkj745', 'chriscappello', 'dlrhksgud4', 'jpk953', 'btredz49', 'jocandkev', 'rtsenthilkumarpnt', 'nulab24c', 'suekim2014', 'sam413', 'sli674', 'nvoelcker', 'zdk186', 'bugmenot', 'jcao618', 'lillian2011', 'danielthomas2014', 'ath800', 'wsc826', 'ntp742', 'gusdomel', 'bburruss', 'dhw191', 'jsierks', 'chem1', 'mhartoun', 'benjaminrafshoon2014', 'shawnkim332', 'varshinicherukupalli', 'sahopki', 'arps714', 'rsfyath', 'cmw897', 'amattias', 'robbie529', 'rgeiwitz', 'lhv642', 'aarora', 'ruthjackie', 'shilliger']"
4,164,51,97,10,"['cjj777', 'mgs943', 'pablosanchez', 'jpk953', 'haley6', 'mini6467', 'jbk285', 'tomvonheill', 'bendover', 'zabin']",40,"['ssmith23', 'armel', 'benkiesel', 'dgraninger', 'ajiang', 'kevinbilal', 'rtsenthilkumarpnt', 'noor207', 'jennifersiedjak', 'diamondlg21', 'carolinedarin', 'jaleel', 'amunarang', 'nvoelcker', 'zdk186', 'aew751', 'oniontech', 'jwj198', 'zp2014', 'davidlin49', 'harryyu', 'bob323', 'clockwork', 'bburruss', 'kferry', 'charley', 'zchsnow0', 'jsierks', 'sah199', 'pthimsuwan', 'jws600', 'okedem', 'rsfyath', 'v_singlemolecule_r', 'raytusc', 'ssalah', 'lhv642', 'crhodes', 'thecrazedbaker1', 'ruthjackie']",87,"['changbeeray', 'jki416', 'jwoll1692', 'ignacioestrada', 'tmengesha', 'sicelo', 'jyu3138', 'ssa886', 'nanolab218', 'alijoe2014', 'jwu525', 'nch863', 'keeleyjean86', 'jsolis7', 'knutecuk', 'vpp990', 'sem227', 'rossmac13', 'shj210', 'jgruszeczki', 'jsh8', 'shaina_nano', 'chiggins', 'bumpin8er', 'samtam', 'cel156', 'jschultz57', 'tjw107', 'gusbus06', 'kgu988', 'chem102', 'xdi870', 'lslesur', 'sonalid', None, 'jkoszela', 'nebiu', 'mhj872', 'ccf165', 'atif24', 'akantzos', 'kwerling', 'johnmari', 'pdu937', 'chloe126', 'aze969', 'johnandalex', 'zaraq', 'kdwoods', 'cskeehan', 'jpj917', 'jds119', 'ezaonegina', 'kgc375', 'zil338', 'mdj146', 'ktdutchman', 'mikeli', 'pinararikan', 'cvickst14', 'amcgary', 'mss647', 'amc480', 'adriennedunk', 'nch964', 'mwrobes', 'titosmith12', 'amh690', 'mwagner987', 'rch465', 'jlj592', 'bugmenot', 'eterzer', 'abbyroopali', 'landislandis', 'cwollaeger', 'ggon03', 'nicolechem', 'johnpark8', 'rjs374', 'mdw994', 'vasanoah', 'aramis16', 'jhk931', 'bpg109', 'suziepeter', 'tjconsidine']",137,"['dgraninger', 'jki416', 'changbeeray', 'bendover', 'diamondlg21', 'carolinedarin', 'jaleel', 'jwoll1692', 'mgs943', 'haley6', 'ignacioestrada', 'tmengesha', 'sicelo', 'davidlin49', 'zchsnow0', 'jyu3138', 'ssa886', 'sah199', 'mini6467', 'alijoe2014', 'jbk285', 'tomvonheill', 'nanolab218', 'jwu525', 'nch863', 'okedem', 'keeleyjean86', 'jsolis7', 'knutecuk', 'vpp990', 'sem227', 'rossmac13', 'armel', 'shj210', 'benkiesel', 'ajiang', 'kevinbilal', 'jgruszeczki', 'noor207', 'jsh8', 'shaina_nano', 'chiggins', 'aew751', 'bumpin8er', 'samtam', 'cel156', 'jschultz57', 'clockwork', 'kferry', 'tjw107', 'gusbus06', 'pablosanchez', 'kgu988', 'chem102', 'xdi870', 'lslesur', 'sonalid', None, 'jkoszela', 'nebiu', 'mhj872', 'ccf165', 'atif24', 'v_singlemolecule_r', 'akantzos', 'thecrazedbaker1', 'kwerling', 'johnmari', 'pdu937', 'ssmith23', 'chloe126', 'aze969', 'johnandalex', 'jennifersiedjak', 'cjj777', 'zaraq', 'kdwoods', 'oniontech', 'cskeehan', 'jpj917', 'jds119', 'jwj198', 'ezaonegina', 'kgc375', 'zp2014', 'charley', 'zil338', 'mdj146', 'pthimsuwan', 'ktdutchman', 'mikeli', 'pinararikan', 'cvickst14', 'amcgary', 'ssalah', 'mss647', 'crhodes', 'amc480', 'adriennedunk', 'nch964', 'titosmith12', 'mwrobes', 'zabin', 'amh690', 'mwagner987', 'jpk953', 'rch465', 'rtsenthilkumarpnt', 'amunarang', 'jlj592', 'nvoelcker', 'zdk186', 'bugmenot', 'eterzer', 'abbyroopali', 'landislandis', 'cwollaeger', 'harryyu', 'bob323', 'bburruss', 'ggon03', 'nicolechem', 'jsierks', 'johnpark8', 'rjs374', 'mdw994', 'vasanoah', 'jws600', 'aramis16', 'rsfyath', 'jhk931', 'bpg109', 'raytusc', 'suziepeter', 'tjconsidine', 'lhv642', 'ruthjackie']"
5,115,45,38,32,"['skung2', 'navdeep3000', 'johnwonlim', 'semeraroln', 'wilson19881229', 'drmeyer87', 'simpson5', 'aguzman4', 'chavali1', 'tmishra3', 'harring4', 'styoisworo', 'profballack', 'modeng1', 'karnik202', 'blee51', 'promemorex', 'hd89c', 'aan8008', 'pwang25', 'winoto2', 'liu155', 'jaina2', 'dass1', 'alark2', 'yjongmin', 'jackchai', 'chenqian1024', 'pranavsharma9', 'aamikam', 'uribe6', 'wenyang1']",12,"['aarongipp', 'grewalsartaj', 'shuynh3', 'mehrab88', 'malik', 'bryantly', 'dahitul1', 'vsalovnh', 'mei9', 'jchall2', 'achavarria', 'hanraha3']",6,"['nanto1', 'shao11', 'chen95', 'shin34', None, 'bertbusdriver']",50,"['wilson19881229', 'drmeyer87', 'simpson5', 'mei9', 'aguzman4', 'chavali1', 'tmishra3', 'mehrab88', 'shin34', 'dahitul1', 'jchall2', 'nanto1', 'blee51', 'promemorex', 'aan8008', 'winoto2', 'liu155', 'dass1', 'shuynh3', 'alark2', 'chen95', 'jackchai', 'chenqian1024', 'aamikam', 'wenyang1', 'skung2', 'aarongipp', 'navdeep3000', 'johnwonlim', 'semeraroln', 'bryantly', 'vsalovnh', 'bertbusdriver', 'shao11', 'harring4', 'styoisworo', 'profballack', 'modeng1', 'karnik202', 'grewalsartaj', 'hd89c', 'pwang25', None, 'jaina2', 'achavarria', 'hanraha3', 'yjongmin', 'pranavsharma9', 'uribe6', 'malik']"
6,11,44,26,22,"['noroozi', 'afzalm', 'mksharma', 'araz123', 'joinafzal', 'snyoon', 'fatjon', 'waqas86', 'sinanag', 'waqas2k11', 'niklausf', 'mokay006', 'minar', 'cmiller2air', 'asahmed', 'sanau', 'orangeshea', 'consciousgaze', 'hammadanwer', 'kvar', 'bellmanz', 'sethusaveda']",21,"['krusor', 'dlwldud89', 'sadid17', 'patseo', 'prahampi6', 'lesecret', 'oren_s', 'doudou11', 'phg35', 'gahoi', 'tvasen', 'iftikhar15', 'ish', 'nanoboy98', 'raffigar', 'mcb', 'shwet', 'ander125', 'bhsieh2000', 'amishche', 'benggriffin']",4,"['m_maziar', None, 'dvenkt', 'afshan']",47,"['krusor', 'dlwldud89', 'dvenkt', 'sadid17', 'noroozi', 'patseo', 'afzalm', 'm_maziar', 'mksharma', 'araz123', 'joinafzal', 'prahampi6', 'snyoon', 'fatjon', 'lesecret', 'waqas86', 'oren_s', 'sinanag', 'doudou11', 'phg35', 'gahoi', 'waqas2k11', 'niklausf', 'mokay006', 'minar', 'tvasen', 'iftikhar15', 'cmiller2air', 'nanoboy98', 'ish', 'asahmed', 'sanau', 'raffigar', 'orangeshea', None, 'mcb', 'consciousgaze', 'hammadanwer', 'shwet', 'ander125', 'bhsieh2000', 'kvar', 'amishche', 'afshan', 'bellmanz', 'benggriffin', 'sethusaveda']"
6,10,44,14,2,"['dlwldud89', 'patseo']",41,"['krusor', 'sadid17', 'noroozi', 'afzalm', 'mksharma', 'araz123', 'joinafzal', 'prahampi6', 'snyoon', 'fatjon', 'lesecret', 'waqas86', 'oren_s', 'sinanag', 'doudou11', 'phg35', 'gahoi', 'sethusaveda', 'niklausf', 'mokay006', 'minar', 'tvasen', 'iftikhar15', 'cmiller2air', 'nanoboy98', 'ish', 'asahmed', 'sanau', 'raffigar', 'orangeshea', 'mcb', 'consciousgaze', 'hammadanwer', 'shwet', 'ander125', 'bhsieh2000', 'kvar', 'amishche', 'bellmanz', 'benggriffin', 'waqas2k11']",12,"['hsyang25', 'kdm52', 'ancap19', 'riosniyper', 'hsptl', 'narunalive', 'shinhyuk001', 'hoonsangyoon', 'drummersh', 'truewhat', 'rla19425', None]",55,"['hsyang25', 'ancap19', 'krusor', 'dlwldud89', 'sadid17', 'noroozi', 'patseo', 'afzalm', 'rla19425', 'mksharma', 'araz123', 'joinafzal', 'prahampi6', 'snyoon', 'fatjon', 'lesecret', 'shinhyuk001', 'drummersh', 'waqas86', 'oren_s', 'sinanag', 'riosniyper', 'doudou11', 'phg35', 'hsptl', 'gahoi', 'waqas2k11', 'niklausf', 'mokay006', 'minar', 'tvasen', 'iftikhar15', 'truewhat', 'cmiller2air', 'nanoboy98', 'ish', 'asahmed', 'sanau', 'raffigar', 'orangeshea', None, 'kdm52', 'mcb', 'narunalive', 'consciousgaze', 'hammadanwer', 'shwet', 'ander125', 'bhsieh2000', 'kvar', 'amishche', 'hoonsangyoon', 'bellmanz', 'benggriffin', 'sethusaveda']"
6,14,44,14,1,['shwet'],42,"['krusor', 'dlwldud89', 'sadid17', 'noroozi', 'patseo', 'afzalm', 'mksharma', 'araz123', 'joinafzal', 'prahampi6', 'snyoon', 'fatjon', 'lesecret', 'waqas86', 'oren_s', 'sinanag', 'doudou11', 'phg35', 'gahoi', 'sethusaveda', 'niklausf', 'mokay006', 'minar', 'tvasen', 'iftikhar15', 'cmiller2air', 'nanoboy98', 'ish', 'asahmed', 'sanau', 'raffigar', 'orangeshea', 'mcb', 'consciousgaze', 'hammadanwer', 'ander125', 'bhsieh2000', 'kvar', 'amishche', 'bellmanz', 'benggriffin', 'waqas2k11']",13,"['vedpragyan', 'msharad', 'ziyunlong', 'lin180', 'brianlew', 'hsohail', 'mstone56', 'glowzbd', 'chandrar88', 'heyu07', 'leedj111', 'qianw', None]",56,"['krusor', 'dlwldud89', 'ziyunlong', 'sadid17', 'noroozi', 'patseo', 'brianlew', 'mstone56', 'afzalm', 'chandrar88', 'heyu07', 'mksharma', 'araz123', 'joinafzal', 'prahampi6', 'lin180', 'hsohail', 'snyoon', 'fatjon', 'lesecret', 'waqas86', 'oren_s', 'sinanag', 'doudou11', 'vedpragyan', 'phg35', 'glowzbd', 'gahoi', 'waqas2k11', 'niklausf', 'mokay006', 'minar', 'tvasen', 'iftikhar15', 'leedj111', 'cmiller2air', 'nanoboy98', 'ish', 'asahmed', 'sanau', 'raffigar', 'orangeshea', None, 'msharad', 'mcb', 'consciousgaze', 'hammadanwer', 'shwet', 'ander125', 'bhsieh2000', 'kvar', 'amishche', 'bellmanz', 'qianw', 'benggriffin', 'sethusaveda']"
6,6,44,12,1,['shwet'],42,"['krusor', 'dlwldud89', 'sadid17', 'noroozi', 'patseo', 'afzalm', 'mksharma', 'araz123', 'joinafzal', 'prahampi6', 'snyoon', 'fatjon', 'lesecret', 'waqas86', 'oren_s', 'sinanag', 'doudou11', 'phg35', 'gahoi', 'sethusaveda', 'niklausf', 'mokay006', 'minar', 'tvasen', 'iftikhar15', 'cmiller2air', 'nanoboy98', 'ish', 'asahmed', 'sanau', 'raffigar', 'orangeshea', 'mcb', 'consciousgaze', 'hammadanwer', 'ander125', 'bhsieh2000', 'kvar', 'amishche', 'bellmanz', 'benggriffin', 'waqas2k11']",11,"['charleshages', 'vedpragyan', 'msharad', 'ziyunlong', 'glowzbd', 'brianlew', 'mstone56', 'kaimiao', 'heyu07', 'qianw', None]",54,"['krusor', 'dlwldud89', 'ziyunlong', 'sadid17', 'noroozi', 'patseo', 'brianlew', 'mstone56', 'kaimiao', 'afzalm', 'heyu07', 'mksharma', 'araz123', 'joinafzal', 'prahampi6', 'snyoon', 'fatjon', 'lesecret', 'waqas86', 'oren_s', 'sinanag', 'doudou11', 'vedpragyan', 'phg35', 'glowzbd', 'gahoi', 'waqas2k11', 'niklausf', 'mokay006', 'minar', 'tvasen', 'iftikhar15', 'cmiller2air', 'nanoboy98', 'ish', 'asahmed', 'sanau', 'raffigar', 'orangeshea', None, 'charleshages', 'mcb', 'msharad', 'consciousgaze', 'hammadanwer', 'shwet', 'ander125', 'bhsieh2000', 'kvar', 'amishche', 'bellmanz', 'qianw', 'benggriffin', 'sethusaveda']"
6,146,44,11,6,"['consciousgaze', 'fatjon', 'mokay006', 'waqas86', 'sinanag', 'sanau']",37,"['krusor', 'dlwldud89', 'sadid17', 'noroozi', 'patseo', 'afzalm', 'mksharma', 'araz123', 'joinafzal', 'prahampi6', 'snyoon', 'lesecret', 'oren_s', 'doudou11', 'phg35', 'gahoi', 'sethusaveda', 'niklausf', 'minar', 'tvasen', 'iftikhar15', 'cmiller2air', 'nanoboy98', 'ish', 'asahmed', 'raffigar', 'orangeshea', 'mcb', 'hammadanwer', 'shwet', 'ander125', 'bhsieh2000', 'kvar', 'amishche', 'bellmanz', 'benggriffin', 'waqas2k11']",5,"['dvenkt', 'm_maziar', 'yanuo', None, 'sathya713']",48,"['krusor', 'dlwldud89', 'dvenkt', 'sadid17', 'noroozi', 'patseo', 'afzalm', 'm_maziar', 'mksharma', 'araz123', 'joinafzal', 'prahampi6', 'snyoon', 'fatjon', 'lesecret', 'waqas86', 'oren_s', 'sinanag', 'sathya713', 'doudou11', 'phg35', 'gahoi', 'waqas2k11', 'niklausf', 'mokay006', 'minar', 'tvasen', 'iftikhar15', 'cmiller2air', 'nanoboy98', 'ish', 'asahmed', 'sanau', 'raffigar', 'orangeshea', 'yanuo', None, 'mcb', 'consciousgaze', 'hammadanwer', 'shwet', 'ander125', 'bhsieh2000', 'kvar', 'amishche', 'bellmanz', 'benggriffin', 'sethusaveda']"
6,13,44,7,1,['patseo'],42,"['krusor', 'dlwldud89', 'sadid17', 'noroozi', 'afzalm', 'mksharma', 'araz123', 'joinafzal', 'prahampi6', 'snyoon', 'fatjon', 'lesecret', 'waqas86', 'oren_s', 'sinanag', 'doudou11', 'phg35', 'gahoi', 'waqas2k11', 'niklausf', 'mokay006', 'minar', 'tvasen', 'iftikhar15', 'cmiller2air', 'nanoboy98', 'ish', 'asahmed', 'sanau', 'raffigar', 'orangeshea', 'mcb', 'consciousgaze', 'hammadanwer', 'shwet', 'ander125', 'bhsieh2000', 'kvar', 'amishche', 'bellmanz', 'benggriffin', 'sethusaveda']",6,"['hsyang25', 'riosniyper', 'hsptl', 'shinhyuk001', 'rla19425', None]",49,"['hsyang25', 'krusor', 'dlwldud89', 'sadid17', 'noroozi', 'patseo', 'afzalm', 'rla19425', 'mksharma', 'araz123', 'joinafzal', 'prahampi6', 'snyoon', 'fatjon', 'lesecret', 'shinhyuk001', 'waqas86', 'oren_s', 'sinanag', 'riosniyper', 'doudou11', 'phg35', 'hsptl', 'gahoi', 'waqas2k11', 'niklausf', 'mokay006', 'minar', 'tvasen', 'iftikhar15', 'cmiller2air', 'nanoboy98', 'ish', 'asahmed', 'sanau', 'raffigar', 'orangeshea', None, 'mcb', 'consciousgaze', 'hammadanwer', 'shwet', 'ander125', 'bhsieh2000', 'kvar', 'amishche', 'bellmanz', 'benggriffin', 'sethusaveda']"
6,15,44,6,1,['patseo'],42,"['krusor', 'dlwldud89', 'sadid17', 'noroozi', 'afzalm', 'mksharma', 'araz123', 'joinafzal', 'prahampi6', 'snyoon', 'fatjon', 'lesecret', 'waqas86', 'oren_s', 'sinanag', 'doudou11', 'phg35', 'gahoi', 'waqas2k11', 'niklausf', 'mokay006', 'minar', 'tvasen', 'iftikhar15', 'cmiller2air', 'nanoboy98', 'ish', 'asahmed', 'sanau', 'raffigar', 'orangeshea', 'mcb', 'consciousgaze', 'hammadanwer', 'shwet', 'ander125', 'bhsieh2000', 'kvar', 'amishche', 'bellmanz', 'benggriffin', 'sethusaveda']",5,"['hsyang25', 'hsptl', 'shinhyuk001', 'rla19425', None]",48,"['hsyang25', 'krusor', 'dlwldud89', 'sadid17', 'noroozi', 'patseo', 'afzalm', 'rla19425', 'mksharma', 'araz123', 'joinafzal', 'prahampi6', 'snyoon', 'fatjon', 'lesecret', 'shinhyuk001', 'waqas86', 'oren_s', 'sinanag', 'doudou11', 'phg35', 'hsptl', 'gahoi', 'waqas2k11', 'niklausf', 'mokay006', 'minar', 'tvasen', 'iftikhar15', 'cmiller2air', 'nanoboy98', 'ish', 'asahmed', 'sanau', 'raffigar', 'orangeshea', None, 'mcb', 'consciousgaze', 'hammadanwer', 'shwet', 'ander125', 'bhsieh2000', 'kvar', 'amishche', 'bellmanz', 'benggriffin', 'sethusaveda']"
6,147,44,6,1,['consciousgaze'],42,"['krusor', 'dlwldud89', 'sadid17', 'noroozi', 'patseo', 'afzalm', 'mksharma', 'araz123', 'joinafzal', 'prahampi6', 'snyoon', 'fatjon', 'lesecret', 'waqas86', 'oren_s', 'sinanag', 'doudou11', 'phg35', 'gahoi', 'waqas2k11', 'niklausf', 'mokay006', 'minar', 'tvasen', 'iftikhar15', 'cmiller2air', 'nanoboy98', 'ish', 'asahmed', 'sanau', 'raffigar', 'orangeshea', 'mcb', 'hammadanwer', 'shwet', 'ander125', 'bhsieh2000', 'kvar', 'amishche', 'bellmanz', 'benggriffin', 'sethusaveda']",5,"['vickey', 'sathya85', 'yanuo', None, 'sathya713']",48,"['krusor', 'dlwldud89', 'sadid17', 'noroozi', 'patseo', 'afzalm', 'mksharma', 'araz123', 'joinafzal', 'prahampi6', 'snyoon', 'fatjon', 'lesecret', 'waqas86', 'oren_s', 'sinanag', 'sathya713', 'doudou11', 'vickey', 'phg35', 'gahoi', 'waqas2k11', 'niklausf', 'mokay006', 'sathya85', 'minar', 'tvasen', 'iftikhar15', 'cmiller2air', 'nanoboy98', 'ish', 'asahmed', 'sanau', 'raffigar', 'orangeshea', 'yanuo', None, 'mcb', 'consciousgaze', 'hammadanwer', 'shwet', 'ander125', 'bhsieh2000', 'kvar', 'amishche', 'bellmanz', 'benggriffin', 'sethusaveda']"
7,222,43,38,37,"['kclark35', 'cworley1', 'rsimion', 'ccrain', 'utkchem240', 'jwill', 'rturnage', 'dnaik1', 'rpatel23', 'coheed33', 'collin530', 'rneedham', 'lwilso', 'mbrook14', 'kjohn116', 'msmit175', 'mhobs1120', 'bgood1', 'elgammal', 'ksmit162', 'cheesedonkey', 'agatson11', 'rwr', 'gmdavies865', 'eboyd7', 'sforres2', 'vpatel15', 'clevisman', 'jbaxte18', 'bmandre1', 'acehlr', 'jbruch', 'whembree', 'jrowe12', 'sbrown36', 'klurie', 'bgard2']",5,"['jbrading', 'rajeshtata', 'b_sadra', 'anu7df', 'haydertouran']",1,[None],43,"['kclark35', 'b_sadra', 'ccrain', 'rsimion', 'anu7df', 'rturnage', 'collin530', 'coheed33', 'rneedham', 'lwilso', 'mbrook14', 'kjohn116', 'mhobs1120', 'elgammal', 'cheesedonkey', 'sforres2', 'jbrading', 'acehlr', 'whembree', 'jrowe12', 'sbrown36', 'haydertouran', 'bgard2', 'clevisman', 'cworley1', 'utkchem240', 'jwill', 'dnaik1', 'rpatel23', 'msmit175', 'bgood1', 'ksmit162', 'agatson11', 'rwr', 'gmdavies865', 'eboyd7', 'vpatel15', None, 'jbaxte18', 'bmandre1', 'rajeshtata', 'jbruch', 'klurie']"
8,25,40,38,33,"['lullinj', 'carueln', 'moeadham', 'fly8bri', 'kilmus', 'sandrinijury', 'maratus', 'tyruchi', 'dc79', 'valeria2552', 'daniele', 'valeryp', 'montinae', 'marinela', 'brunetad', 'd4romuald', 'pmarchan', 'matthieug', 'olzhas007', 'yakimetsd', 'furrytonic', 'venerdi17', 'fedeledl', 'matthieup88', 'jc', 'pizzatodaniel', 'matteocossale', 'shabalaus', 'nanobalaji', 'ferrottt', 'eandrew88', 'clementfleury', 'meunierb38']",6,"['mbasso', 'mehrpouyam', 'fid', 'mariazel', 'vassalli', 'edrakox']",5,"['joelchevrier', 'sfacchin88', 'legros_nanotech', 'nanun10', None]",44,"['lullinj', 'carueln', 'sfacchin88', 'legros_nanotech', 'tyruchi', 'joelchevrier', 'daniele', 'nanun10', 'valeryp', 'vassalli', 'd4romuald', 'brunetad', 'olzhas007', 'furrytonic', 'matthieup88', 'jc', 'ferrottt', 'nanobalaji', 'clementfleury', 'mariazel', 'mbasso', 'moeadham', 'fly8bri', 'kilmus', 'sandrinijury', 'maratus', 'mehrpouyam', 'dc79', 'valeria2552', 'montinae', 'marinela', 'pmarchan', 'matthieug', 'yakimetsd', 'venerdi17', 'fedeledl', None, 'edrakox', 'pizzatodaniel', 'matteocossale', 'shabalaus', 'eandrew88', 'fid', 'meunierb38']"
8,24,40,32,30,"['moeadham', 'fly8bri', 'kilmus', 'sandrinijury', 'maratus', 'tyruchi', 'dc79', 'valeria2552', 'daniele', 'montinae', 'marinela', 'brunetad', 'd4romuald', 'pmarchan', 'matthieug', 'olzhas007', 'yakimetsd', 'furrytonic', 'venerdi17', 'matthieup88', 'jc', 'pizzatodaniel', 'shabalaus', 'nanobalaji', 'ferrottt', 'eandrew88', 'clementfleury', 'fid', 'mariazel', 'meunierb38']",9,"['lullinj', 'carueln', 'matteocossale', 'edrakox', 'mbasso', 'valeryp', 'fedeledl', 'vassalli', 'mehrpouyam']",2,"[None, 'nanun10']",41,"['lullinj', 'carueln', 'moeadham', 'fly8bri', 'kilmus', 'sandrinijury', 'maratus', 'tyruchi', 'mehrpouyam', 'dc79', 'valeria2552', 'daniele', 'nanun10', 'valeryp', 'montinae', 'vassalli', 'marinela', 'd4romuald', 'brunetad', 'pmarchan', 'matthieug', 'olzhas007', 'yakimetsd', 'furrytonic', 'venerdi17', 'fedeledl', 'matthieup88', 'edrakox', 'jc', None, 'pizzatodaniel', 'matteocossale', 'shabalaus', 'ferrottt', 'nanobalaji', 'eandrew88', 'clementfleury', 'fid', 'mariazel', 'mbasso', 'meunierb38']"
8,26,40,27,22,"['lullinj', 'carueln', 'kilmus', 'maratus', 'tyruchi', 'valeria2552', 'daniele', 'valeryp', 'montinae', 'marinela', 'd4romuald', 'pmarchan', 'matthieug', 'furrytonic', 'venerdi17', 'fedeledl', 'matthieup88', 'pizzatodaniel', 'shabalaus', 'ferrottt', 'eandrew88', 'clementfleury']",17,"['olzhas007', 'dc79', 'jc', 'matteocossale', 'moeadham', 'nanobalaji', 'fly8bri', 'yakimetsd', 'edrakox', 'mbasso', 'sandrinijury', 'fid', 'mariazel', 'vassalli', 'meunierb38', 'brunetad', 'mehrpouyam']",5,"['benazizz', 'joelchevrier', 'sfacchin88', 'nanun10', None]",44,"['lullinj', 'carueln', 'moeadham', 'fly8bri', 'sfacchin88', 'kilmus', 'sandrinijury', 'maratus', 'tyruchi', 'mehrpouyam', 'benazizz', 'dc79', 'valeria2552', 'joelchevrier', 'daniele', 'nanun10', 'valeryp', 'montinae', 'vassalli', 'marinela', 'd4romuald', 'brunetad', 'pmarchan', 'matthieug', 'olzhas007', 'yakimetsd', 'furrytonic', 'venerdi17', 'fedeledl', 'matthieup88', 'edrakox', 'jc', None, 'pizzatodaniel', 'matteocossale', 'shabalaus', 'ferrottt', 'nanobalaji', 'eandrew88', 'clementfleury', 'fid', 'mariazel', 'mbasso', 'meunierb38']"
8,23,40,21,17,"['matthieug', 'lullinj', 'carueln', 'pizzatodaniel', 'matteocossale', 'shabalaus', 'valeria2552', 'ferrottt', 'daniele', 'kilmus', 'eandrew88', 'clementfleury', 'fedeledl', 'montinae', 'marinela', 'matthieup88', 'pmarchan']",22,"['moeadham', 'fly8bri', 'sandrinijury', 'maratus', 'tyruchi', 'mehrpouyam', 'dc79', 'valeryp', 'vassalli', 'd4romuald', 'brunetad', 'olzhas007', 'yakimetsd', 'furrytonic', 'venerdi17', 'jc', 'edrakox', 'nanobalaji', 'fid', 'mariazel', 'mbasso', 'meunierb38']",4,"[None, 'legros_nanotech', 'arriccab', 'sfacchin88']",43,"['lullinj', 'carueln', 'moeadham', 'fly8bri', 'sfacchin88', 'kilmus', 'legros_nanotech', 'sandrinijury', 'maratus', 'tyruchi', 'mehrpouyam', 'dc79', 'arriccab', 'valeria2552', 'daniele', 'valeryp', 'montinae', 'vassalli', 'marinela', 'd4romuald', 'brunetad', 'pmarchan', 'matthieug', 'olzhas007', 'yakimetsd', 'furrytonic', 'venerdi17', 'fedeledl', 'matthieup88', 'edrakox', 'jc', None, 'pizzatodaniel', 'matteocossale', 'shabalaus', 'ferrottt', 'nanobalaji', 'eandrew88', 'clementfleury', 'fid', 'mariazel', 'mbasso', 'meunierb38']"
8,27,40,20,18,"['dc79', 'moeadham', 'nanobalaji', 'ferrottt', 'meunierb38', 'fly8bri', 'yakimetsd', 'kilmus', 'furrytonic', 'eandrew88', 'sandrinijury', 'mariazel', 'd4romuald', 'maratus', 'brunetad', 'matthieup88', 'jc', 'pmarchan']",21,"['lullinj', 'carueln', 'tyruchi', 'mehrpouyam', 'valeria2552', 'daniele', 'valeryp', 'montinae', 'vassalli', 'marinela', 'matthieug', 'olzhas007', 'venerdi17', 'fedeledl', 'edrakox', 'pizzatodaniel', 'matteocossale', 'shabalaus', 'clementfleury', 'fid', 'mbasso']",2,"[None, 'skotniks']",41,"['lullinj', 'carueln', 'moeadham', 'fly8bri', 'kilmus', 'sandrinijury', 'maratus', 'tyruchi', 'mehrpouyam', 'dc79', 'valeria2552', 'daniele', 'valeryp', 'montinae', 'vassalli', 'marinela', 'd4romuald', 'brunetad', 'pmarchan', 'matthieug', 'olzhas007', 'yakimetsd', 'furrytonic', 'venerdi17', 'skotniks', 'fedeledl', 'matthieup88', 'edrakox', 'jc', None, 'pizzatodaniel', 'matteocossale', 'shabalaus', 'ferrottt', 'nanobalaji', 'eandrew88', 'clementfleury', 'fid', 'mariazel', 'mbasso', 'meunierb38']"
8,22,40,15,1,['vassalli'],38,"['lullinj', 'carueln', 'moeadham', 'fly8bri', 'kilmus', 'sandrinijury', 'maratus', 'tyruchi', 'mehrpouyam', 'dc79', 'valeria2552', 'daniele', 'valeryp', 'montinae', 'marinela', 'brunetad', 'd4romuald', 'pmarchan', 'matthieug', 'olzhas007', 'yakimetsd', 'furrytonic', 'venerdi17', 'fedeledl', 'matthieup88', 'edrakox', 'jc', 'pizzatodaniel', 'matteocossale', 'shabalaus', 'ferrottt', 'nanobalaji', 'eandrew88', 'clementfleury', 'fid', 'mariazel', 'mbasso', 'meunierb38']",14,"['micromanager', None, 'iknittel', 'raman', 'drkiraco', 'j790902', 'kmusthu', 'averdaguer', 'andreacerreta', 'jmelcher', 'neusdm', 'stephenjesse', 'fistho81', 'kida']",53,"['lullinj', 'carueln', 'iknittel', 'moeadham', 'drkiraco', 'fly8bri', 'kilmus', 'averdaguer', 'sandrinijury', 'maratus', 'tyruchi', 'fistho81', 'mehrpouyam', 'neusdm', 'stephenjesse', 'micromanager', 'dc79', 'valeria2552', 'daniele', 'kmusthu', 'valeryp', 'montinae', 'vassalli', 'marinela', 'd4romuald', 'brunetad', 'jmelcher', 'pmarchan', 'matthieug', 'olzhas007', 'raman', 'yakimetsd', 'furrytonic', 'venerdi17', 'andreacerreta', 'fedeledl', 'matthieup88', 'edrakox', 'jc', None, 'kida', 'pizzatodaniel', 'matteocossale', 'shabalaus', 'ferrottt', 'nanobalaji', 'j790902', 'eandrew88', 'clementfleury', 'fid', 'mariazel', 'mbasso', 'meunierb38']"
9,253,35,35,24,"['sjhi2000', 'innov10', 'wlsheon', 'chw405', 'rladncjf', 'sjlee1406', 'cjw2525', 'vygotsky', 'cms1051', 'hd0126', 'zxcvlcc', 'youorange', 'ainklain', 'altoan36', 'aguilera614', 'father', 'marinetg1', 'yhkim1127', 'yu0830', 'iiawqii', 'jjang3057', 'leoseo321', 'hawki17', 'torrydance']",10,"['quarter123', 'shinhwajhn', 'poka_poka', 'tenis87', 'yusiky', 'jiyoee', 'nanopuritans', 'won3197', 'wnghks3201', 'shinhwajhj']",11,"['notav', 'ysjtweety', 'johou5325', 'jingu91', 'kukchul16', 'nswhsh12', 'safe1001', 'wkc87', 'ho4th89', None, 'poteito']",45,"['sjhi2000', 'tenis87', 'jingu91', 'kukchul16', 'innov10', 'wlsheon', 'poteito', 'quarter123', 'chw405', 'rladncjf', 'shinhwajhn', 'johou5325', 'yusiky', 'nswhsh12', 'sjlee1406', 'nanopuritans', 'vygotsky', 'cjw2525', 'cms1051', 'hd0126', 'zxcvlcc', 'youorange', 'ainklain', 'poka_poka', 'altoan36', 'aguilera614', 'father', 'marinetg1', 'yhkim1127', None, 'yu0830', 'ho4th89', 'iiawqii', 'notav', 'jjang3057', 'ysjtweety', 'leoseo321', 'jiyoee', 'hawki17', 'safe1001', 'wkc87', 'torrydance', 'won3197', 'wnghks3201', 'shinhwajhj']"
9,254,35,17,11,"['chw405', 'jjang3057', 'quarter123', 'shinhwajhn', 'poka_poka', 'tenis87', 'yusiky', 'jiyoee', 'nanopuritans', 'won3197', 'shinhwajhj']",23,"['sjhi2000', 'innov10', 'wlsheon', 'rladncjf', 'sjlee1406', 'cjw2525', 'vygotsky', 'cms1051', 'hd0126', 'zxcvlcc', 'youorange', 'ainklain', 'altoan36', 'aguilera614', 'father', 'marinetg1', 'yhkim1127', 'yu0830', 'iiawqii', 'leoseo321', 'hawki17', 'torrydance', 'wnghks3201']",6,"['daumgod39', 'ysjtweety', 'kaist20071136', 'davidkim', 'ho4th89', None]",40,"['sjhi2000', 'tenis87', 'davidkim', 'innov10', 'wlsheon', 'daumgod39', 'quarter123', 'chw405', 'rladncjf', 'shinhwajhn', 'yusiky', 'sjlee1406', 'nanopuritans', 'vygotsky', 'cjw2525', 'cms1051', 'hd0126', 'zxcvlcc', 'youorange', 'kaist20071136', 'ainklain', 'poka_poka', 'altoan36', 'aguilera614', 'father', 'marinetg1', 'yhkim1127', None, 'yu0830', 'ho4th89', 'iiawqii', 'jjang3057', 'ysjtweety', 'leoseo321', 'jiyoee', 'hawki17', 'torrydance', 'won3197', 'wnghks3201', 'shinhwajhj']"
10,171,35,27,23,"['heba_sabri', 'anadrol', 'samozeid', 'heba_sadek', 'kymera', 'shaker', 'fayzabs', 'abd_allah', 'shaymaa', 'basma_shaalan', 'zooma88', 'ibrahemmetwally77', 'marwa1', 'eauchy', 'mohamedamin2010', 'omarmonem', 'moatazhegab', 'marwa', 'himahmoud', 'salehov', 'mmatda1976', 'm_fouly', 'tarekameen']",11,"['joostvdheijden', 'aruege', 'ajayraman', 'mzaghloul', 'dk12', 'hhtran', 'mitpbg', 'luchaoyang', 'adilah', 'bsensale2', 'siamak63']",4,"['a4atmel', 'ahmd_sadk', 'islam_sayd31', None]",38,"['joostvdheijden', 'heba_sabri', 'a4atmel', 'samozeid', 'anadrol', 'dk12', 'kymera', 'heba_sadek', 'shaker', 'fayzabs', 'ahmd_sadk', 'siamak63', 'ajayraman', 'islam_sayd31', 'abd_allah', 'mzaghloul', 'shaymaa', 'mitpbg', 'basma_shaalan', 'zooma88', 'adilah', 'bsensale2', 'ibrahemmetwally77', 'marwa1', 'eauchy', 'luchaoyang', 'mohamedamin2010', 'omarmonem', None, 'aruege', 'moatazhegab', 'tarekameen', 'marwa', 'hhtran', 'himahmoud', 'salehov', 'mmatda1976', 'm_fouly']"
10,170,35,7,3,"['salehov', 'anadrol', 'mohamedamin2010']",31,"['joostvdheijden', 'heba_sabri', 'samozeid', 'dk12', 'kymera', 'heba_sadek', 'shaker', 'fayzabs', 'siamak63', 'ajayraman', 'abd_allah', 'mzaghloul', 'shaymaa', 'mitpbg', 'basma_shaalan', 'zooma88', 'adilah', 'bsensale2', 'ibrahemmetwally77', 'marwa1', 'eauchy', 'luchaoyang', 'omarmonem', 'aruege', 'moatazhegab', 'tarekameen', 'marwa', 'hhtran', 'himahmoud', 'mmatda1976', 'm_fouly']",4,"['a4atmel', 'ahmd_sadk', 'serag', None]",38,"['joostvdheijden', 'heba_sabri', 'a4atmel', 'samozeid', 'anadrol', 'dk12', 'kymera', 'heba_sadek', 'shaker', 'fayzabs', 'ahmd_sadk', 'siamak63', 'ajayraman', 'abd_allah', 'mzaghloul', 'shaymaa', 'mitpbg', 'basma_shaalan', 'zooma88', 'adilah', 'bsensale2', 'ibrahemmetwally77', 'marwa1', 'eauchy', 'luchaoyang', 'mohamedamin2010', 'omarmonem', None, 'aruege', 'moatazhegab', 'tarekameen', 'marwa', 'hhtran', 'himahmoud', 'salehov', 'mmatda1976', 'serag', 'm_fouly']"
11,37,30,116,1,['ragunat1'],28,"['ryanskim', 'sadderly', 'aelkadi', 'p05pradhan', 'oper951', 'gulsim', 'quoy26', 'heinzel2', 'bhavenm', 'jkim273', 'ztrata2', 'soorty1', 'tanxiaoxiao0103', 'psix', 'mail2na', 'ganhualu', 'andrewspb', 'gavin_campbell', 'uasyed2', 'galimberti', 'lyding', 'aeroice', 'nafgnahz', 'rogue555', 'sgeorge4', 'zambran1', 'ecarrion232', 'ran1363']",115,"['balistic2', 'hipaulshi', 'fthis', 'bpatzin2', 'cardena2', 'kim325', 'beugels1', 'ededens', 'amit13012001', 'shook2', 'photoyub', 'boehle2', 'phoenix_0510', 'jortiz125', 'wicky', 'mmenon3', 'beran1', 'rohanamin', 'crazycai', 'ericcj21', 'johnso49', 'barlaz', 'wrubrec2', 'chen95', 'keramat1', 'kocek1', 'shuzhongyou', 'nikunjk', 'marchevskiy', 'spitula2', 'aviraljain12', 'lilgoose3', 'japheth', 'moruzi1', 'mast5', 'ray4', 'daiyuan1991', 'nahsor', 'akusan', 'fahim89', 'komo', 'forcejedi', 'capota2', 'kejacs', None, 'tgorti', 'baruin2', 'fedorov1', 'tsteige2', 'richers1', 'ambrood', 'robert25', 'meagher1', 'eshanso', 'will07c5', 'cheng78', 'horvat1', 'liu141', 'schlude1', 'ren6', 'lu34', 'rareearth', 'huilinng', 'healy4', 'trongtong', 'shin34', 'albertczc', 'cpwalsh2', 'nanto1', 'divito3', 'scholl1', 'rmuryan2', 'eszato', 'icfmi90', 'gomez14', 'rishi_ratan', 'chan47', 'skyzzm', 'peterk8', 'willspringzhang', 'chinvet1', 'chen128', 'felipealonso1', 'shin65', 'jclee9', 'starring', 'hamburger123', 'karlsino', 'rmahaja2', 'djtanaka', 'cschan3', 'skorets2', 'diablopbc', 'tuoliu1', 'squeeksrocks', 'pyropenguinx', 'kazi1', 'suyagya', 'liangyaning', 'megarza2', 'cvendi2', 'yc_ng', 'uppal1', 'vik579', 'stacey2', 'kurtovi1', 'simon6', 'xu34', 'pay1', 'kbliu46', 'niyingkan', 'faorlando', 'tmurray5', 'bhuiya1', 'cjhughes17']",144,"['balistic2', 'sadderly', 'hipaulshi', 'fthis', 'cardena2', 'bpatzin2', 'bhavenm', 'ztrata2', 'kim325', 'beugels1', 'ededens', 'psix', 'andrewspb', 'gavin_campbell', 'amit13012001', 'shook2', 'photoyub', 'boehle2', 'phoenix_0510', 'jortiz125', 'wicky', 'mmenon3', 'beran1', 'rohanamin', 'nafgnahz', 'crazycai', 'ericcj21', 'johnso49', 'barlaz', 'wrubrec2', 'chen95', 'keramat1', 'kocek1', 'shuzhongyou', 'nikunjk', 'marchevskiy', 'oper951', 'spitula2', 'quoy26', 'aviraljain12', 'jkim273', 'lilgoose3', 'japheth', 'mail2na', 'moruzi1', 'ragunat1', 'mast5', 'ray4', 'daiyuan1991', 'nahsor', 'akusan', 'lyding', 'fahim89', 'komo', 'forcejedi', 'capota2', 'kejacs', None, 'tgorti', 'baruin2', 'fedorov1', 'tsteige2', 'richers1', 'ambrood', 'robert25', 'ran1363', 'meagher1', 'eshanso', 'will07c5', 'cheng78', 'horvat1', 'p05pradhan', 'liu141', 'schlude1', 'ren6', 'lu34', 'rareearth', 'huilinng', 'healy4', 'trongtong', 'tanxiaoxiao0103', 'shin34', 'albertczc', 'cpwalsh2', 'nanto1', 'divito3', 'galimberti', 'scholl1', 'rmuryan2', 'eszato', 'icfmi90', 'gomez14', 'rishi_ratan', 'chan47', 'skyzzm', 'peterk8', 'willspringzhang', 'chinvet1', 'chen128', 'felipealonso1', 'shin65', 'jclee9', 'starring', 'ecarrion232', 'ryanskim', 'hamburger123', 'karlsino', 'aelkadi', 'rmahaja2', 'djtanaka', 'cschan3', 'gulsim', 'skorets2', 'heinzel2', 'diablopbc', 'tuoliu1', 'soorty1', 'squeeksrocks', 'pyropenguinx', 'ganhualu', 'kazi1', 'suyagya', 'liangyaning', 'megarza2', 'uasyed2', 'cvendi2', 'yc_ng', 'uppal1', 'vik579', 'stacey2', 'aeroice', 'kurtovi1', 'simon6', 'xu34', 'pay1', 'rogue555', 'kbliu46', 'niyingkan', 'faorlando', 'tmurray5', 'bhuiya1', 'sgeorge4', 'zambran1', 'cjhughes17']"
11,169,30,25,1,['uasyed2'],28,"['ryanskim', 'sadderly', 'aelkadi', 'p05pradhan', 'oper951', 'gulsim', 'quoy26', 'heinzel2', 'bhavenm', 'jkim273', 'ztrata2', 'soorty1', 'tanxiaoxiao0103', 'psix', 'mail2na', 'ganhualu', 'andrewspb', 'ragunat1', 'gavin_campbell', 'galimberti', 'lyding', 'aeroice', 'nafgnahz', 'rogue555', 'sgeorge4', 'zambran1', 'ecarrion232', 'ran1363']",24,"['paritoshpande', 'hubler2', 'rlblackm', 'leeau', 'crablau01', 'kaje83', 'somikae1', 'rajtarun', 'urraliu', 'aczapar', 'huangp02', 'yasamana', 'v0vela01', 'hadiyah', 'pmushenh', 'lee893', 'thnguyn2', None, 'sprab001', 'vegawhi1', 'tmfowler', 'gwu', 'ludovic', 'wenyenwu']",53,"['paritoshpande', 'sadderly', 'hubler2', 'aelkadi', 'p05pradhan', 'oper951', 'ran1363', 'ludovic', 'gulsim', 'quoy26', 'rlblackm', 'leeau', 'heinzel2', 'kaje83', 'bhavenm', 'jkim273', 'ztrata2', 'crablau01', 'soorty1', 'tanxiaoxiao0103', 'somikae1', 'psix', 'rajtarun', 'mail2na', 'ganhualu', 'andrewspb', 'urraliu', 'aczapar', 'huangp02', 'ragunat1', 'yasamana', 'gavin_campbell', 'v0vela01', 'uasyed2', 'hadiyah', 'galimberti', 'pmushenh', 'lyding', 'lee893', 'aeroice', 'nafgnahz', 'rogue555', None, 'thnguyn2', 'sprab001', 'vegawhi1', 'tmfowler', 'gwu', 'sgeorge4', 'zambran1', 'ecarrion232', 'ryanskim', 'wenyenwu']"
11,49,30,20,17,"['ryanskim', 'sadderly', 'lyding', 'mail2na', 'andrewspb', 'sgeorge4', 'aeroice', 'zambran1', 'ragunat1', 'gulsim', 'quoy26', 'ecarrion232', 'uasyed2', 'heinzel2', 'nafgnahz', 'ran1363', 'ztrata2']",12,"['galimberti', 'soorty1', 'tanxiaoxiao0103', 'psix', 'ganhualu', 'aelkadi', 'p05pradhan', 'oper951', 'gavin_campbell', 'rogue555', 'bhavenm', 'jkim273']",3,"['baruin2', 'chuneven', None]",32,"['sadderly', 'aelkadi', 'p05pradhan', 'oper951', 'ran1363', 'gulsim', 'quoy26', 'heinzel2', 'bhavenm', 'jkim273', 'ztrata2', 'soorty1', 'tanxiaoxiao0103', 'psix', 'mail2na', 'ganhualu', 'andrewspb', 'ragunat1', 'chuneven', 'gavin_campbell', 'uasyed2', 'galimberti', 'lyding', 'aeroice', 'nafgnahz', 'rogue555', None, 'baruin2', 'sgeorge4', 'zambran1', 'ecarrion232', 'ryanskim']"
11,50,30,8,7,"['soorty1', 'tanxiaoxiao0103', 'mail2na', 'oper951', 'gavin_campbell', 'uasyed2', 'ran1363']",22,"['sadderly', 'aelkadi', 'p05pradhan', 'gulsim', 'quoy26', 'heinzel2', 'bhavenm', 'ztrata2', 'jkim273', 'psix', 'ganhualu', 'andrewspb', 'ragunat1', 'galimberti', 'lyding', 'aeroice', 'nafgnahz', 'rogue555', 'sgeorge4', 'zambran1', 'ecarrion232', 'ryanskim']",1,[None],30,"['ryanskim', 'galimberti', 'sadderly', 'lyding', 'aelkadi', 'p05pradhan', 'oper951', 'aeroice', 'gulsim', 'quoy26', 'heinzel2', 'nafgnahz', 'rogue555', None, 'bhavenm', 'jkim273', 'ztrata2', 'soorty1', 'tanxiaoxiao0103', 'psix', 'mail2na', 'ganhualu', 'andrewspb', 'sgeorge4', 'zambran1', 'ragunat1', 'gavin_campbell', 'ecarrion232', 'uasyed2', 'ran1363']"
12,190,30,18,6,"['phongvu', 'girumsetegn', 'howardstien', 'tduong', 'baosemi2011', 'atoney']",23,"['fvargas3', 'helasraizam', 'silveira', 'mdmeraz', 'm_sulistyanto', 'hockeyd05', 'amayorga2', 'paper2tape', 'nxanth', 'gustavocm', 'vjtorres', 'hrodri89', 'gbs', 'juampac2003', 'skimble', 'rctbraj', 'liuliu', 'bulajicm', 'deepthidsz', 'ksurana', 'kenaku', 'gobelc', 'smburris']",12,"['huyvitran', None, 'ejon1801', 'mdieye', 'hsataria', 'torekan', 'shirosaki0', 'aayodele', 'crazzzy1', 'jesusaa1', 'solarman', 'eikpeme']",41,"['fvargas3', 'silveira', 'helasraizam', 'ejon1801', 'mdmeraz', 'mdieye', 'tduong', 'baosemi2011', 'aayodele', 'm_sulistyanto', 'phongvu', 'hockeyd05', 'amayorga2', 'paper2tape', 'nxanth', 'shirosaki0', 'gustavocm', 'hsataria', 'crazzzy1', 'jesusaa1', 'vjtorres', 'hrodri89', 'juampac2003', 'skimble', 'rctbraj', 'atoney', 'liuliu', 'bulajicm', 'deepthidsz', None, 'eikpeme', 'huyvitran', 'ksurana', 'smburris', 'kenaku', 'girumsetegn', 'howardstien', 'gobelc', 'torekan', 'gbs', 'solarman']"
12,191,30,14,7,"['fvargas3', 'kenaku', 'amayorga2', 'mdmeraz', 'smburris', 'vjtorres', 'hrodri89']",22,"['silveira', 'helasraizam', 'baosemi2011', 'tduong', 'm_sulistyanto', 'phongvu', 'hockeyd05', 'paper2tape', 'nxanth', 'gustavocm', 'juampac2003', 'skimble', 'rctbraj', 'atoney', 'liuliu', 'bulajicm', 'deepthidsz', 'ksurana', 'girumsetegn', 'howardstien', 'gobelc', 'gbs']",7,"['mmoreno13', 'mjde2', 'laszlo', 'stella', None, 'jemadrid', 'jlflores5']",36,"['fvargas3', 'silveira', 'helasraizam', 'mdmeraz', 'tduong', 'baosemi2011', 'm_sulistyanto', 'phongvu', 'hockeyd05', 'amayorga2', 'paper2tape', 'mjde2', 'nxanth', 'gustavocm', 'vjtorres', 'hrodri89', 'jemadrid', 'mmoreno13', 'juampac2003', 'skimble', 'rctbraj', 'atoney', 'liuliu', 'bulajicm', 'laszlo', 'deepthidsz', None, 'jlflores5', 'ksurana', 'smburris', 'kenaku', 'girumsetegn', 'howardstien', 'gobelc', 'stella', 'gbs']"
13,20,28,26,23,"['bozorgui', 'yangg', 'haleyjd', 'dputnam1000', 'tomkat5', 'costrou', 'ericbeiter', 'keitha', 'kendis_dia', 'mukherjeesiladitya', 'sperka', 'shyno2011', 'zhangz9', 'whalenrp', 'gcnanohub', 'frenchwr', 'jagantk', 'skkumar0912', 'claussmw', 'muliabee', 'ptc2u', 'nsayson', 'xuweiwei']",4,"['duydat_bel', 'poursalehi', 'delarez', 'bjdpjq']",3,"['ciacovella', 'zmanish', None]",30,"['bozorgui', 'yangg', 'zmanish', 'haleyjd', 'delarez', 'tomkat5', 'dputnam1000', 'ciacovella', 'costrou', 'ericbeiter', 'keitha', 'kendis_dia', 'mukherjeesiladitya', 'sperka', 'poursalehi', 'shyno2011', 'bjdpjq', None, 'whalenrp', 'zhangz9', 'frenchwr', 'gcnanohub', 'jagantk', 'skkumar0912', 'claussmw', 'muliabee', 'ptc2u', 'nsayson', 'xuweiwei', 'duydat_bel']"
14,172,27,15,14,"['mkendall', 'mille670', 'morriso0', 'johns717', 'cbellusc', 'acstark', 'lmeece', 'mwdunn', 'thomps28', 'cgbates', 'detra1844', 'hudsone', 'etate', 'csutter88']",12,"['jhuff', 'pyoder', 'smbackus', 'tcdarlin', 'mlringwa', 'lindsaynicole08', 'riley25', 'celutes', 'ewoodcoc', 'amackle', 'almightycaesar', 'kbross']",1,[None],27,"['jhuff', 'pyoder', 'cbellusc', 'detra1844', 'mwdunn', 'cgbates', 'morriso0', 'johns717', 'acstark', 'lmeece', 'thomps28', 'lindsaynicole08', 'etate', 'ewoodcoc', 'kbross', 'smbackus', 'mlringwa', 'celutes', 'hudsone', 'csutter88', 'amackle', None, 'mkendall', 'mille670', 'tcdarlin', 'riley25', 'almightycaesar']"
14,173,27,7,6,"['morriso0', 'mwdunn', 'lindsaynicole08', 'celutes', 'ewoodcoc', 'amackle']",20,"['jhuff', 'pyoder', 'cbellusc', 'detra1844', 'cgbates', 'johns717', 'acstark', 'lmeece', 'thomps28', 'etate', 'kbross', 'smbackus', 'mlringwa', 'hudsone', 'csutter88', 'mkendall', 'mille670', 'tcdarlin', 'riley25', 'almightycaesar']",1,[None],27,"['jhuff', 'pyoder', 'smbackus', 'cbellusc', 'detra1844', 'mwdunn', 'mlringwa', 'cgbates', 'celutes', 'hudsone', 'csutter88', 'amackle', None, 'mkendall', 'mille670', 'morriso0', 'johns717', 'acstark', 'tcdarlin', 'lmeece', 'thomps28', 'lindsaynicole08', 'riley25', 'etate', 'ewoodcoc', 'almightycaesar', 'kbross']"
15,176,23,23,19,"['zjali9889', 'dingni529', 'mgautam', 'wzhlove2003', 'z3246932', 'rachponkalra', 'chicheng', 'ysrrcool', 'ruoxiyang', 'hanyufeng', 'z3286385', 'kushal_das', 'alexb', 'ka2552001', 'chnpp', 'z3323355', 'songyanfan', 'tuyu1988', 'happyhome1025']",3,"['pflammer', 'windyday', 'windydays111']",4,"['solfreer', None, 'henryyang', 'andreamorello']",26,"['zjali9889', 'dingni529', 'henryyang', 'mgautam', 'wzhlove2003', 'z3246932', 'windyday', 'rachponkalra', 'chicheng', 'ysrrcool', 'andreamorello', 'ruoxiyang', 'hanyufeng', 'z3286385', 'kushal_das', 'alexb', 'ka2552001', 'chnpp', 'windydays111', None, 'pflammer', 'z3323355', 'solfreer', 'songyanfan', 'tuyu1988', 'happyhome1025']"
16,80,23,25,22,"['ess954', 'babberton', 'jam124', 'yti0811', 'dtoconn', 'orangemonkey', 'articuno37', 'emredewrim', 'maoyanren', 'charliekbrown', 'xucheng2014', 'chenzhongbi', 'autoevan', 'krishanu', 'sonic28', 'circles', 'xwa431', 'vktdm111', 'jzh953', 'qingminyu', 'smalin', 'tws771']",0,[],3,"['lar739', None, 'keten']",25,"['ess954', 'jam124', 'lar739', 'yti0811', 'dtoconn', 'orangemonkey', 'articuno37', 'emredewrim', 'maoyanren', 'keten', 'charliekbrown', 'smalin', 'xucheng2014', 'chenzhongbi', 'autoevan', 'krishanu', 'sonic28', 'circles', None, 'xwa431', 'vktdm111', 'jzh953', 'qingminyu', 'babberton', 'tws771']"
18,162,21,35,18,"['ppacey', 'mzolnows', 'dklenosk', 'md1032', 'jgarves', 'lancaste', 'ecummin', 'zeastman', 'ldrotos', 'bosecki', 'xie10', 'zfarrell', 'sfrissel', 'svaselan', 'mbrant102', 'hill14', 'alohse', 'tqiu']",2,"['lnichol', 'dschalle']",17,"['jmccarle', 'rvedula', None, 'psarobol', 'taeyong7', 'jblackw', 'dadrin2026', 'j3holaday', 'xie11', 'hao90408', 'thirvo', 'georger', 'edeutsch90', 'zhu51', 'ckopf', 'li319', 'lmarroni']",37,"['rvedula', 'psarobol', 'dschalle', 'lancaste', 'zeastman', 'zfarrell', 'j3holaday', 'lmarroni', 'ppacey', 'mzolnows', 'md1032', 'ecummin', 'xie10', 'hao90408', 'alohse', 'zhu51', 'ckopf', 'li319', 'tqiu', 'taeyong7', 'jgarves', 'dadrin2026', 'lnichol', 'mbrant102', 'ldrotos', 'edeutsch90', None, 'jmccarle', 'jblackw', 'bosecki', 'sfrissel', 'svaselan', 'thirvo', 'hill14', 'xie11', 'georger', 'dklenosk']"
18,94,21,24,18,"['ppacey', 'mzolnows', 'md1032', 'jgarves', 'dschalle', 'lancaste', 'ecummin', 'zeastman', 'bosecki', 'sfrissel', 'xie10', 'zfarrell', 'lnichol', 'svaselan', 'mbrant102', 'hill14', 'alohse', 'dklenosk']",2,"['ldrotos', 'tqiu']",6,"['taeyong7', 'jblackw', 'dquickel', 'wnaville1', 'zhu51', None]",26,"['dschalle', 'lancaste', 'zeastman', 'zfarrell', 'ppacey', 'mzolnows', 'md1032', 'ecummin', 'xie10', 'dquickel', 'wnaville1', 'alohse', 'zhu51', 'tqiu', 'taeyong7', 'jgarves', 'lnichol', 'mbrant102', 'ldrotos', None, 'jblackw', 'bosecki', 'sfrissel', 'svaselan', 'hill14', 'dklenosk']"
20,164,20,97,2,"['amh690', 'aze969']",17,"['bbattle', 'ekajrazrahmanovic', 'wkuang', 'ckitche', 'jonw007', 'maxton', 'abayneh', 'dmiller5', 'p5peng', 'salmahda', 'lurecased', 'asamaras', 'rameil', 'kristjanl', 'aneeza89', 'bwenberg', 'mthomps4']",95,"['pdu937', 'chloe126', 'johnandalex', 'jki416', 'changbeeray', 'bendover', 'cjj777', 'jwoll1692', 'zaraq', 'mgs943', 'kdwoods', 'cskeehan', 'haley6', 'ignacioestrada', 'tmengesha', 'sicelo', 'jpj917', 'jds119', 'ezaonegina', 'kgc375', 'zil338', 'jyu3138', 'ssa886', 'mdj146', 'mini6467', 'alijoe2014', 'tomvonheill', 'nanolab218', 'jwu525', 'jbk285', 'ktdutchman', 'nch863', 'mikeli', 'pinararikan', 'cvickst14', 'keeleyjean86', 'amcgary', 'jsolis7', 'knutecuk', 'vpp990', 'sem227', 'mss647', 'amc480', 'adriennedunk', 'nch964', 'titosmith12', 'mwrobes', 'zabin', 'rossmac13', 'shj210', 'mwagner987', 'jpk953', 'rch465', 'jgruszeczki', 'jsh8', 'shaina_nano', 'chiggins', 'jlj592', 'bugmenot', 'bumpin8er', 'eterzer', 'abbyroopali', 'samtam', 'cel156', 'landislandis', 'jschultz57', 'cwollaeger', 'tjw107', 'gusbus06', 'ggon03', 'nicolechem', 'pablosanchez', 'kgu988', 'chem102', 'xdi870', 'lslesur', 'johnpark8', 'rjs374', 'mdw994', 'vasanoah', 'sonalid', None, 'jkoszela', 'nebiu', 'aramis16', 'jhk931', 'mhj872', 'ccf165', 'atif24', 'bpg109', 'suziepeter', 'akantzos', 'tjconsidine', 'kwerling', 'johnmari']",114,"['pdu937', 'chloe126', 'aze969', 'johnandalex', 'jki416', 'changbeeray', 'bendover', 'aneeza89', 'cjj777', 'jwoll1692', 'zaraq', 'mgs943', 'kdwoods', 'cskeehan', 'haley6', 'ignacioestrada', 'tmengesha', 'sicelo', 'maxton', 'jpj917', 'jds119', 'ezaonegina', 'kgc375', 'ekajrazrahmanovic', 'ckitche', 'jonw007', 'zil338', 'dmiller5', 'jyu3138', 'ssa886', 'mini6467', 'alijoe2014', 'tomvonheill', 'asamaras', 'nanolab218', 'jwu525', 'jbk285', 'mdj146', 'ktdutchman', 'nch863', 'mikeli', 'pinararikan', 'bwenberg', 'cvickst14', 'keeleyjean86', 'amcgary', 'jsolis7', 'knutecuk', 'vpp990', 'sem227', 'lurecased', 'mss647', 'amc480', 'adriennedunk', 'nch964', 'titosmith12', 'mwrobes', 'zabin', 'rossmac13', 'shj210', 'amh690', 'mwagner987', 'jpk953', 'rch465', 'abayneh', 'jgruszeczki', 'rameil', 'kristjanl', 'jsh8', 'shaina_nano', 'chiggins', 'jlj592', 'bugmenot', 'bumpin8er', 'eterzer', 'abbyroopali', 'samtam', 'cel156', 'landislandis', 'jschultz57', 'cwollaeger', 'mthomps4', 'tjw107', 'gusbus06', 'ggon03', 'nicolechem', 'pablosanchez', 'kgu988', 'chem102', 'xdi870', 'p5peng', 'lslesur', 'johnpark8', 'rjs374', 'mdw994', 'vasanoah', 'sonalid', None, 'bbattle', 'jkoszela', 'nebiu', 'aramis16', 'wkuang', 'jhk931', 'mhj872', 'ccf165', 'atif24', 'bpg109', 'salmahda', 'suziepeter', 'akantzos', 'tjconsidine', 'kwerling', 'johnmari']"
20,165,20,7,6,"['dmiller5', 'maxton', 'salmahda', 'lurecased', 'bwenberg', 'mthomps4']",13,"['ekajrazrahmanovic', 'wkuang', 'amh690', 'aze969', 'ckitche', 'jonw007', 'abayneh', 'p5peng', 'asamaras', 'rameil', 'kristjanl', 'aneeza89', 'bbattle']",1,[None],20,"['ekajrazrahmanovic', 'amh690', 'aze969', 'ckitche', 'jonw007', 'dmiller5', 'abayneh', 'p5peng', 'asamaras', 'rameil', 'kristjanl', None, 'aneeza89', 'bwenberg', 'bbattle', 'wkuang', 'maxton', 'salmahda', 'lurecased', 'mthomps4']"
21,54,20,15,13,"['gutierd', 'aschluet', 'ajmendoz', 'mhockeme', 'ananya15', 'palvarad', 'chen549', 'sdana', 'csrockerzero', 'svpeders', 'jgarrett', 'monsterd5', 'sbandla']",6,"['jmarin', 'fek90', 'plapetin', 'chuberty', 'foster8', 'dlucero108']",2,"[None, 'yomae314']",21,"['jmarin', 'aschluet', 'yomae314', 'mhockeme', 'palvarad', 'plapetin', 'csrockerzero', 'dlucero108', None, 'jgarrett', 'monsterd5', 'sbandla', 'gutierd', 'ajmendoz', 'fek90', 'ananya15', 'chen549', 'chuberty', 'sdana', 'svpeders', 'foster8']"
21,55,20,8,7,"['gutierd', 'aschluet', 'ajmendoz', 'ananya15', 'chuberty', 'sdana', 'monsterd5']",12,"['jmarin', 'fek90', 'mhockeme', 'palvarad', 'chen549', 'plapetin', 'csrockerzero', 'svpeders', 'foster8', 'dlucero108', 'jgarrett', 'sbandla']",1,[None],20,"['jmarin', 'aschluet', 'mhockeme', 'palvarad', 'plapetin', 'csrockerzero', 'dlucero108', None, 'jgarrett', 'monsterd5', 'sbandla', 'gutierd', 'ajmendoz', 'fek90', 'ananya15', 'chen549', 'chuberty', 'sdana', 'svpeders', 'foster8']"
23,215,18,19,9,"['8bit', 'xbenda00', 'xjanda05', 'hejtmi', 'xkahan02', 'nestaron', 'xjelin02', 'petrdohnal', 'vasilijzaitsev']",8,"['pocky', 'tomasrouca', 'xnovot27', 'steko', 'xpavli51', 'achran', 'vachalukas', 'alexandrotahal']",10,"['xlneni02', 'majak', 'xhavli04', 'ladislavchvila', 'xhudec16', 'sanjuro', 'xjande00', 'xberna08', None, 'xkuben08']",27,"['pocky', '8bit', 'tomasrouca', 'xnovot27', 'hejtmi', 'xkahan02', 'xpavli51', 'nestaron', 'xjelin02', 'vachalukas', None, 'alexandrotahal', 'xkuben08', 'xbenda00', 'xlneni02', 'xjanda05', 'majak', 'xhavli04', 'ladislavchvila', 'xhudec16', 'steko', 'sanjuro', 'achran', 'petrdohnal', 'xjande00', 'xberna08', 'vasilijzaitsev']"
23,126,18,17,9,"['8bit', 'xbenda00', 'xjanda05', 'xkahan02', 'hejtmi', 'nestaron', 'xjelin02', 'petrdohnal', 'vasilijzaitsev']",8,"['pocky', 'tomasrouca', 'xnovot27', 'steko', 'xpavli51', 'achran', 'vachalukas', 'alexandrotahal']",8,"['xhudec16', 'xhavli04', 'ladislavchvila', 'xjande00', 'xberna08', None, 'xkupar00', 'xkuben08']",25,"['pocky', '8bit', 'tomasrouca', 'xnovot27', 'hejtmi', 'xkahan02', 'xpavli51', 'nestaron', 'xjelin02', 'vachalukas', None, 'alexandrotahal', 'xkupar00', 'xkuben08', 'xbenda00', 'xjanda05', 'xhudec16', 'xhavli04', 'ladislavchvila', 'steko', 'achran', 'petrdohnal', 'xjande00', 'xberna08', 'vasilijzaitsev']"
23,178,18,17,9,"['8bit', 'xbenda00', 'xjanda05', 'xkahan02', 'hejtmi', 'nestaron', 'xjelin02', 'petrdohnal', 'vasilijzaitsev']",8,"['pocky', 'tomasrouca', 'xnovot27', 'steko', 'xpavli51', 'achran', 'vachalukas', 'alexandrotahal']",8,"['xhudec16', 'xhavli04', 'ladislavchvila', 'xjande00', 'xberna08', None, 'xkupar00', 'xkuben08']",25,"['pocky', '8bit', 'tomasrouca', 'xnovot27', 'hejtmi', 'xkahan02', 'xpavli51', 'nestaron', 'xjelin02', 'vachalukas', None, 'alexandrotahal', 'xkupar00', 'xkuben08', 'xbenda00', 'xjanda05', 'xhudec16', 'xhavli04', 'ladislavchvila', 'steko', 'achran', 'petrdohnal', 'xjande00', 'xberna08', 'vasilijzaitsev']"
23,51,18,15,9,"['8bit', 'xbenda00', 'xjanda05', 'xkahan02', 'hejtmi', 'nestaron', 'xjelin02', 'petrdohnal', 'vasilijzaitsev']",8,"['pocky', 'tomasrouca', 'xnovot27', 'steko', 'xpavli51', 'achran', 'vachalukas', 'alexandrotahal']",6,"['ladislavchvila', 'sanjuro', 'xjande00', 'xvenos00', 'xberna08', None]",23,"['pocky', '8bit', 'tomasrouca', 'xnovot27', 'hejtmi', 'xkahan02', 'xpavli51', 'nestaron', 'xjelin02', 'vachalukas', None, 'alexandrotahal', 'xbenda00', 'xjanda05', 'ladislavchvila', 'steko', 'sanjuro', 'achran', 'petrdohnal', 'xjande00', 'xvenos00', 'xberna08', 'vasilijzaitsev']"
23,128,18,15,8,"['pocky', 'tomasrouca', 'xnovot27', 'steko', 'xpavli51', 'achran', 'vachalukas', 'alexandrotahal']",9,"['8bit', 'xbenda00', 'xjanda05', 'hejtmi', 'xkahan02', 'nestaron', 'xjelin02', 'petrdohnal', 'vasilijzaitsev']",7,"[None, 'lenkapetrova', 'spaam', 'kory', 'avanicek', 'xvitaz00', 'xmalin04']",24,"['pocky', '8bit', 'tomasrouca', 'xnovot27', 'hejtmi', 'xkahan02', 'lenkapetrova', 'xpavli51', 'spaam', 'nestaron', 'kory', 'xjelin02', 'vachalukas', 'xmalin04', None, 'alexandrotahal', 'xbenda00', 'xjanda05', 'steko', 'achran', 'petrdohnal', 'avanicek', 'vasilijzaitsev', 'xvitaz00']"
23,179,18,15,8,"['pocky', 'tomasrouca', 'xnovot27', 'steko', 'xpavli51', 'achran', 'vachalukas', 'alexandrotahal']",9,"['8bit', 'xbenda00', 'xjanda05', 'hejtmi', 'xkahan02', 'nestaron', 'xjelin02', 'petrdohnal', 'vasilijzaitsev']",7,"[None, 'lenkapetrova', 'spaam', 'kory', 'avanicek', 'xvitaz00', 'xmalin04']",24,"['pocky', '8bit', 'tomasrouca', 'xnovot27', 'hejtmi', 'xkahan02', 'lenkapetrova', 'xpavli51', 'spaam', 'nestaron', 'kory', 'xjelin02', 'vachalukas', 'xmalin04', None, 'alexandrotahal', 'xbenda00', 'xjanda05', 'steko', 'achran', 'petrdohnal', 'avanicek', 'vasilijzaitsev', 'xvitaz00']"
23,228,18,14,7,"['8bit', 'xjanda05', 'xkahan02', 'hejtmi', 'nestaron', 'xjelin02', 'vasilijzaitsev']",10,"['pocky', 'xbenda00', 'tomasrouca', 'xnovot27', 'steko', 'xpavli51', 'achran', 'petrdohnal', 'vachalukas', 'alexandrotahal']",7,"['xlneni02', 'xhudec16', 'xhavli04', 'sanjuro', 'xjande00', None, 'xkupar00']",24,"['pocky', '8bit', 'tomasrouca', 'xnovot27', 'hejtmi', 'xkahan02', 'xpavli51', 'nestaron', 'xjelin02', 'vachalukas', None, 'alexandrotahal', 'xkupar00', 'xbenda00', 'xlneni02', 'xjanda05', 'xhudec16', 'xhavli04', 'steko', 'sanjuro', 'achran', 'petrdohnal', 'xjande00', 'vasilijzaitsev']"
23,116,18,12,6,"['8bit', 'xbenda00', 'xjanda05', 'xkahan02', 'hejtmi', 'petrdohnal']",11,"['pocky', 'tomasrouca', 'xnovot27', 'steko', 'xpavli51', 'nestaron', 'achran', 'xjelin02', 'vachalukas', 'vasilijzaitsev', 'alexandrotahal']",6,"['ladislavchvila', 'sanjuro', 'xjande00', 'xvenos00', 'xberna08', None]",23,"['pocky', '8bit', 'tomasrouca', 'xnovot27', 'hejtmi', 'xkahan02', 'xpavli51', 'nestaron', 'xjelin02', 'vachalukas', None, 'alexandrotahal', 'xbenda00', 'xjanda05', 'ladislavchvila', 'steko', 'sanjuro', 'achran', 'petrdohnal', 'xjande00', 'xvenos00', 'xberna08', 'vasilijzaitsev']"
23,216,18,12,8,"['pocky', 'tomasrouca', 'xnovot27', 'steko', 'xpavli51', 'achran', 'vachalukas', 'alexandrotahal']",9,"['8bit', 'xbenda00', 'xjanda05', 'hejtmi', 'xkahan02', 'nestaron', 'xjelin02', 'petrdohnal', 'vasilijzaitsev']",4,"['majak', 'spaam', 'avanicek', None]",21,"['pocky', '8bit', 'tomasrouca', 'xnovot27', 'hejtmi', 'xkahan02', 'spaam', 'xpavli51', 'nestaron', 'xjelin02', 'vachalukas', None, 'alexandrotahal', 'xbenda00', 'xjanda05', 'majak', 'steko', 'achran', 'petrdohnal', 'avanicek', 'vasilijzaitsev']"
23,229,18,10,7,"['pocky', 'tomasrouca', 'xnovot27', 'steko', 'achran', 'vachalukas', 'alexandrotahal']",10,"['8bit', 'xbenda00', 'xjanda05', 'hejtmi', 'xkahan02', 'xpavli51', 'nestaron', 'xjelin02', 'petrdohnal', 'vasilijzaitsev']",3,"['majak', None, 'kory']",20,"['pocky', '8bit', 'tomasrouca', 'xnovot27', 'hejtmi', 'xkahan02', 'kory', 'xpavli51', 'nestaron', 'xjelin02', 'vachalukas', None, 'alexandrotahal', 'xbenda00', 'xjanda05', 'majak', 'steko', 'achran', 'petrdohnal', 'vasilijzaitsev']"
23,52,18,6,5,"['pocky', 'tomasrouca', 'achran', 'vachalukas', 'alexandrotahal']",12,"['8bit', 'xbenda00', 'xjanda05', 'xnovot27', 'hejtmi', 'xkahan02', 'steko', 'xpavli51', 'nestaron', 'xjelin02', 'petrdohnal', 'vasilijzaitsev']",1,[None],18,"['pocky', '8bit', 'tomasrouca', 'xnovot27', 'hejtmi', 'xkahan02', 'xpavli51', 'nestaron', 'xjelin02', 'vachalukas', None, 'alexandrotahal', 'xbenda00', 'xjanda05', 'steko', 'achran', 'petrdohnal', 'vasilijzaitsev']"
24,268,18,11,8,"['mhuang3', 'jihardy2', 'sccrisco', 'dtminsk', 'kowhite', 'whluke', 'kpabadil', 'ntalmira']",9,"['lm2a0604', 'ptgrigg', 'jschuet', 'caralbertiphy', 'hlee19', 'proggerardo', 'bdwells', 'plsherid', 'bashaw2']",3,"['jtlamb08', None, 'laharve2']",20,"['mhuang3', 'lm2a0604', 'jihardy2', 'jtlamb08', 'hlee19', 'caralbertiphy', 'dtminsk', 'proggerardo', 'bdwells', 'jschuet', 'ntalmira', 'kpabadil', None, 'bashaw2', 'laharve2', 'ptgrigg', 'sccrisco', 'kowhite', 'plsherid', 'whluke']"
24,269,18,11,5,"['mhuang3', 'jihardy2', 'hlee19', 'dtminsk', 'kowhite']",12,"['lm2a0604', 'ptgrigg', 'sccrisco', 'jschuet', 'caralbertiphy', 'proggerardo', 'bdwells', 'plsherid', 'whluke', 'kpabadil', 'ntalmira', 'bashaw2']",6,"['jcledfo2', 'greengiant208', 'amleszcz', 'mvlanzon', None, 'jhlardo']",23,"['mhuang3', 'jcledfo2', 'lm2a0604', 'jihardy2', 'hlee19', 'caralbertiphy', 'dtminsk', 'proggerardo', 'bdwells', 'jschuet', 'ntalmira', 'kpabadil', 'mvlanzon', None, 'bashaw2', 'jhlardo', 'ptgrigg', 'sccrisco', 'kowhite', 'greengiant208', 'amleszcz', 'plsherid', 'whluke']"
24,266,18,9,4,"['bashaw2', 'whluke', 'bdwells', 'plsherid']",13,"['mhuang3', 'lm2a0604', 'jihardy2', 'ptgrigg', 'sccrisco', 'hlee19', 'caralbertiphy', 'dtminsk', 'kowhite', 'proggerardo', 'jschuet', 'ntalmira', 'kpabadil']",5,"['csu2', 'dlirving', 'nrohrbaugh', 'patwelch43', None]",22,"['mhuang3', 'csu2', 'lm2a0604', 'jihardy2', 'dlirving', 'hlee19', 'caralbertiphy', 'dtminsk', 'proggerardo', 'patwelch43', 'bdwells', 'jschuet', 'ntalmira', 'kpabadil', None, 'bashaw2', 'ptgrigg', 'sccrisco', 'kowhite', 'nrohrbaugh', 'plsherid', 'whluke']"
24,267,18,8,6,"['ptgrigg', 'sccrisco', 'plsherid', 'whluke', 'kpabadil', 'ntalmira']",11,"['mhuang3', 'lm2a0604', 'jihardy2', 'caralbertiphy', 'hlee19', 'dtminsk', 'kowhite', 'proggerardo', 'bdwells', 'jschuet', 'bashaw2']",2,"['csu2', None]",19,"['mhuang3', 'csu2', 'lm2a0604', 'jihardy2', 'hlee19', 'caralbertiphy', 'dtminsk', 'proggerardo', 'bdwells', 'jschuet', 'ntalmira', 'kpabadil', None, 'bashaw2', 'ptgrigg', 'sccrisco', 'kowhite', 'plsherid', 'whluke']"
24,270,18,8,1,['hlee19'],16,"['mhuang3', 'lm2a0604', 'jihardy2', 'ptgrigg', 'sccrisco', 'jschuet', 'caralbertiphy', 'dtminsk', 'kowhite', 'proggerardo', 'bdwells', 'plsherid', 'whluke', 'kpabadil', 'ntalmira', 'bashaw2']",7,"['bmmarcin', 'jdmccoy2', 'zmmahbo2', 'kfplunke', 'eemille3', 'jamedfor', None]",24,"['mhuang3', 'lm2a0604', 'jihardy2', 'hlee19', 'caralbertiphy', 'dtminsk', 'proggerardo', 'bdwells', 'jschuet', 'eemille3', 'ntalmira', 'kpabadil', 'jamedfor', None, 'bashaw2', 'bmmarcin', 'jdmccoy2', 'zmmahbo2', 'ptgrigg', 'sccrisco', 'kowhite', 'kfplunke', 'plsherid', 'whluke']"
26,72,18,7,5,"['kuci', 'sms6284', 'imanwaring', 'jms5565', 'daphins1']",12,"['jinojohn', 'prakas', 'alleycat145', 'xmiao3', 'afa8572', 'msyeom77', 'kjean', 'camilocano93', 'fantico', 'leonid', 'vidushi', 'joelasubar7']",2,"['kdhemc', None]",19,"['prakas', 'kuci', 'xmiao3', 'alleycat145', 'afa8572', 'msyeom77', 'kdhemc', 'sms6284', 'leonid', 'vidushi', None, 'joelasubar7', 'daphins1', 'jinojohn', 'kjean', 'camilocano93', 'fantico', 'imanwaring', 'jms5565']"
27,272,17,19,16,"['klramos', 'turkeybrain', 'rebekahgordon', 'mloosh', 'jaxmann', 'walkerknight', 'srujan', 'hmason0', 'kennedke', 'alexolo', 'jenniferei77', 'hayleybraun', 'bobiscrazy', 'paperdisciple', 'chrismunley7', 'wolfpacknick']",0,[],3,"['jamedfor', 'cllada', None]",19,"['klramos', 'rebekahgordon', 'mloosh', 'jaxmann', 'cllada', 'srujan', 'kennedke', 'alexolo', 'jenniferei77', 'chrismunley7', 'jamedfor', None, 'turkeybrain', 'walkerknight', 'hmason0', 'hayleybraun', 'bobiscrazy', 'paperdisciple', 'wolfpacknick']"
28,271,16,18,13,"['aler1', 'rlash013', 'jmcgarrhan', 'temp042', 'raw831', 'moriah', 'shyam_v', 'cbroome', 'username2010', 'nathanm', 'moodyboy96', 'justinnyva', 'fbrunner']",2,"['stefan83', 'g_glez']",5,"['cllada', 'dlirving', '15brownd', 'jamedfor', None]",20,"['cllada', 'rlash013', 'aler1', 'dlirving', 'shyam_v', 'cbroome', 'jamedfor', 'jmcgarrhan', 'nathanm', 'justinnyva', 'temp042', 'raw831', 'stefan83', 'username2010', 'moodyboy96', 'fbrunner', None, 'g_glez', '15brownd', 'moriah']"
29,162,16,35,10,"['jmccarle', 'psarobol', 'li319', 'ckopf', 'j3holaday', 'hao90408', 'thirvo', 'xie11', 'georger', 'lmarroni']",5,"['tojo', 'eanthon', 'zarthur', 'lingj', 'chen399']",25,"['rvedula', 'lancaste', 'zeastman', 'zfarrell', 'ppacey', 'mzolnows', 'md1032', 'ecummin', 'xie10', 'alohse', 'zhu51', 'tqiu', 'taeyong7', 'jgarves', 'dadrin2026', 'mbrant102', 'ldrotos', 'edeutsch90', None, 'jblackw', 'sfrissel', 'bosecki', 'svaselan', 'hill14', 'dklenosk']",40,"['zarthur', 'rvedula', 'psarobol', 'lancaste', 'zeastman', 'j3holaday', 'zfarrell', 'lmarroni', 'tojo', 'ppacey', 'mzolnows', 'md1032', 'ecummin', 'xie10', 'hao90408', 'alohse', 'zhu51', 'ckopf', 'li319', 'tqiu', 'eanthon', 'taeyong7', 'jgarves', 'dadrin2026', 'lingj', 'mbrant102', 'ldrotos', 'edeutsch90', None, 'jmccarle', 'jblackw', 'sfrissel', 'bosecki', 'svaselan', 'thirvo', 'hill14', 'chen399', 'xie11', 'georger', 'dklenosk']"
30,253,15,35,10,"['notav', 'ysjtweety', 'jingu91', 'johou5325', 'kukchul16', 'nswhsh12', 'safe1001', 'wkc87', 'ho4th89', 'poteito']",4,"['yinglan', 'daumgod39', 'davidkim', 'kaist20071136']",25,"['sjhi2000', 'innov10', 'wlsheon', 'chw405', 'rladncjf', 'sjlee1406', 'cjw2525', 'vygotsky', 'cms1051', 'hd0126', 'zxcvlcc', 'youorange', 'ainklain', 'altoan36', 'aguilera614', 'marinetg1', 'father', 'yhkim1127', None, 'yu0830', 'iiawqii', 'jjang3057', 'leoseo321', 'hawki17', 'torrydance']",39,"['sjhi2000', 'jingu91', 'kukchul16', 'davidkim', 'innov10', 'wlsheon', 'poteito', 'daumgod39', 'chw405', 'rladncjf', 'johou5325', 'nswhsh12', 'sjlee1406', 'vygotsky', 'cjw2525', 'cms1051', 'hd0126', 'zxcvlcc', 'yinglan', 'youorange', 'kaist20071136', 'ainklain', 'altoan36', 'aguilera614', 'marinetg1', 'father', 'yhkim1127', None, 'yu0830', 'iiawqii', 'notav', 'jjang3057', 'ysjtweety', 'leoseo321', 'safe1001', 'wkc87', 'hawki17', 'torrydance', 'ho4th89']"
30,254,15,17,5,"['daumgod39', 'ysjtweety', 'kaist20071136', 'davidkim', 'ho4th89']",9,"['yinglan', 'notav', 'jingu91', 'johou5325', 'kukchul16', 'nswhsh12', 'safe1001', 'wkc87', 'poteito']",12,"['chw405', 'jjang3057', 'quarter123', 'shinhwajhn', 'poka_poka', 'tenis87', 'yusiky', 'jiyoee', 'nanopuritans', 'won3197', 'shinhwajhj', None]",26,"['yinglan', 'kaist20071136', 'poka_poka', 'jingu91', 'tenis87', 'kukchul16', 'davidkim', None, 'poteito', 'daumgod39', 'notav', 'jjang3057', 'ysjtweety', 'chw405', 'quarter123', 'won3197', 'shinhwajhn', 'johou5325', 'yusiky', 'jiyoee', 'nswhsh12', 'safe1001', 'wkc87', 'nanopuritans', 'ho4th89', 'shinhwajhj']"
30,194,15,8,7,"['notav', 'ysjtweety', 'jingu91', 'johou5325', 'kukchul16', 'safe1001', 'wkc87']",7,"['yinglan', 'daumgod39', 'kaist20071136', 'nswhsh12', 'davidkim', 'ho4th89', 'poteito']",1,[None],15,"['yinglan', 'kaist20071136', 'jingu91', 'kukchul16', 'davidkim', None, 'poteito', 'daumgod39', 'notav', 'ysjtweety', 'johou5325', 'nswhsh12', 'safe1001', 'wkc87', 'ho4th89']"
32,25,14,38,1,['legros_nanotech'],12,"['brunotorre', 'jalegleiter', 'iknittel', 'gerard', 'kmusthu', 'averdaguer', 'jmunerao', 'andreacerreta', 'lludrigot', 'neusdm', 'stephenjesse', 'fistho81']",37,"['lullinj', 'carueln', 'moeadham', 'fly8bri', 'sfacchin88', 'kilmus', 'sandrinijury', 'maratus', 'tyruchi', 'dc79', 'valeria2552', 'joelchevrier', 'daniele', 'nanun10', 'valeryp', 'montinae', 'marinela', 'brunetad', 'd4romuald', 'pmarchan', 'matthieug', 'olzhas007', 'yakimetsd', 'furrytonic', 'venerdi17', 'fedeledl', 'matthieup88', 'jc', None, 'pizzatodaniel', 'matteocossale', 'shabalaus', 'nanobalaji', 'ferrottt', 'eandrew88', 'clementfleury', 'meunierb38']",50,"['lullinj', 'carueln', 'iknittel', 'moeadham', 'fly8bri', 'sfacchin88', 'averdaguer', 'kilmus', 'legros_nanotech', 'sandrinijury', 'lludrigot', 'neusdm', 'stephenjesse', 'fistho81', 'maratus', 'tyruchi', 'dc79', 'valeria2552', 'gerard', 'joelchevrier', 'daniele', 'kmusthu', 'nanun10', 'valeryp', 'montinae', 'jalegleiter', 'marinela', 'brunetad', 'd4romuald', 'pmarchan', 'brunotorre', 'matthieug', 'olzhas007', 'yakimetsd', 'furrytonic', 'jmunerao', 'andreacerreta', 'venerdi17', 'fedeledl', 'matthieup88', 'jc', None, 'pizzatodaniel', 'matteocossale', 'shabalaus', 'nanobalaji', 'ferrottt', 'eandrew88', 'clementfleury', 'meunierb38']"
32,23,14,21,1,['legros_nanotech'],12,"['brunotorre', 'jalegleiter', 'iknittel', 'gerard', 'kmusthu', 'averdaguer', 'jmunerao', 'andreacerreta', 'lludrigot', 'neusdm', 'stephenjesse', 'fistho81']",20,"['lullinj', 'carueln', 'sfacchin88', 'kilmus', 'arriccab', 'valeria2552', 'daniele', 'montinae', 'marinela', 'pmarchan', 'matthieug', 'fedeledl', 'matthieup88', None, 'pizzatodaniel', 'matteocossale', 'shabalaus', 'ferrottt', 'eandrew88', 'clementfleury']",33,"['lullinj', 'carueln', 'iknittel', 'sfacchin88', 'averdaguer', 'kilmus', 'legros_nanotech', 'lludrigot', 'neusdm', 'stephenjesse', 'fistho81', 'arriccab', 'valeria2552', 'gerard', 'daniele', 'kmusthu', 'montinae', 'jalegleiter', 'marinela', 'pmarchan', 'brunotorre', 'matthieug', 'jmunerao', 'andreacerreta', 'fedeledl', None, 'matthieup88', 'pizzatodaniel', 'matteocossale', 'shabalaus', 'ferrottt', 'eandrew88', 'clementfleury']"
32,22,14,15,7,"['iknittel', 'kmusthu', 'averdaguer', 'andreacerreta', 'neusdm', 'stephenjesse', 'fistho81']",6,"['brunotorre', 'gerard', 'jmunerao', 'legros_nanotech', 'lludrigot', 'jalegleiter']",8,"['micromanager', 'raman', 'drkiraco', 'jmelcher', 'j790902', 'vassalli', None, 'kida']",21,"['brunotorre', 'iknittel', 'raman', 'drkiraco', 'jmelcher', 'averdaguer', 'legros_nanotech', 'jmunerao', 'andreacerreta', 'lludrigot', 'neusdm', 'stephenjesse', 'fistho81', None, 'kida', 'micromanager', 'gerard', 'j790902', 'kmusthu', 'vassalli', 'jalegleiter']"
33,21,14,8,7,"['ribor', 'asefunc', 'oguzhan', 'serkal', 'bihter', 'dkocaay', 'yayanmel']",6,"['georgakd', 'guzelturk', 'xcuh', 'msbentley', 'berreick', 'cinkara']",1,[None],14,"['oguzhan', 'georgakd', 'xcuh', 'msbentley', 'bihter', 'dkocaay', 'yayanmel', None, 'ribor', 'asefunc', 'guzelturk', 'serkal', 'berreick', 'cinkara']"
36,225,14,12,8,"['stokesj', 'danbruder', 'glennfife', 'adam921', 'prusm', 'vermeede', 'lumj', 'diemertim']",5,"['vrinside', 'joyashish_d', 'django', 'evensenh', 'pigmaster']",4,"['acalverley', 'tkubis', 'jefonseca', None]",17,"['stokesj', 'jefonseca', 'glennfife', 'vrinside', 'joyashish_d', 'adam921', 'django', 'tkubis', 'evensenh', 'vermeede', 'pigmaster', 'diemertim', None, 'danbruder', 'acalverley', 'prusm', 'lumj']"
36,224,14,7,2,"['glennfife', 'adam921']",11,"['stokesj', 'diemertim', 'danbruder', 'vrinside', 'joyashish_d', 'django', 'prusm', 'evensenh', 'vermeede', 'lumj', 'pigmaster']",5,"[None, 'dbros01', 'tkubis', 'kllangeland', 'jakehall']",18,"['stokesj', 'glennfife', 'vrinside', 'joyashish_d', 'adam921', 'django', 'tkubis', 'evensenh', 'vermeede', 'pigmaster', 'diemertim', None, 'kllangeland', 'jakehall', 'danbruder', 'dbros01', 'prusm', 'lumj']"
37,80,13,25,1,['lar739'],11,"['mroenbeck', 'biw936', 'ksekar', 'abthomps', 'emm355', 'prithag', 'z2z007', 'rpitner1115', 'skbrand', 'aes27', 'swtheart312']",24,"['ess954', 'jam124', 'yti0811', 'dtoconn', 'orangemonkey', 'articuno37', 'emredewrim', 'maoyanren', 'keten', 'charliekbrown', 'smalin', 'chenzhongbi', 'xucheng2014', 'autoevan', 'krishanu', 'sonic28', 'circles', None, 'xwa431', 'vktdm111', 'jzh953', 'qingminyu', 'babberton', 'tws771']",36,"['ess954', 'ksekar', 'babberton', 'prithag', 'z2z007', 'jam124', 'lar739', 'yti0811', 'dtoconn', 'orangemonkey', 'articuno37', 'rpitner1115', 'emredewrim', 'swtheart312', 'maoyanren', 'keten', 'charliekbrown', 'smalin', 'chenzhongbi', 'xucheng2014', 'autoevan', 'abthomps', 'krishanu', 'sonic28', None, 'circles', 'xwa431', 'mroenbeck', 'biw936', 'vktdm111', 'emm355', 'jzh953', 'skbrand', 'qingminyu', 'aes27', 'tws771']"
37,213,13,19,10,"['mroenbeck', 'biw936', 'abthomps', 'prithag', 'emm355', 'z2z007', 'rpitner1115', 'skbrand', 'swtheart312', 'lar739']",2,"['ksekar', 'aes27']",9,"['aes549', 'hmayes', 'bjs388', 'bashwell', 'clof', 'ycolon1002', 'stephy1204', None, 'nathaniel87']",21,"['aes549', 'ksekar', 'abthomps', 'prithag', 'bashwell', 'clof', 'z2z007', 'ycolon1002', 'stephy1204', 'lar739', None, 'mroenbeck', 'biw936', 'hmayes', 'bjs388', 'emm355', 'rpitner1115', 'skbrand', 'aes27', 'swtheart312', 'nathaniel87']"
37,212,13,15,6,"['mroenbeck', 'biw936', 'z2z007', 'skbrand', 'aes27', 'lar739']",6,"['ksekar', 'abthomps', 'prithag', 'emm355', 'rpitner1115', 'swtheart312']",9,"['aes549', 'cari', 'hmayes', 'bjs388', 'bashwell', 'ycolon1002', 'stephy1204', 'daniel84', None]",21,"['aes549', 'ksekar', 'abthomps', 'prithag', 'bashwell', 'z2z007', 'ycolon1002', 'stephy1204', 'lar739', None, 'mroenbeck', 'cari', 'biw936', 'hmayes', 'bjs388', 'emm355', 'rpitner1115', 'skbrand', 'daniel84', 'aes27', 'swtheart312']"
39,37,12,116,6,"['japheth', 'skorets2', 'simon6', 'rohanamin', 'ambrood', 'chen128']",5,"['siucarlos', 'liu76', 'adrianazero', 'schaffe3', 'ftreviso']",110,"['balistic2', 'meagher1', 'eshanso', 'will07c5', 'hipaulshi', 'cheng78', 'horvat1', 'liu141', 'schlude1', 'fthis', 'ren6', 'cardena2', 'bpatzin2', 'lu34', 'rareearth', 'huilinng', 'healy4', 'kim325', 'beugels1', 'trongtong', 'ededens', 'shin34', 'amit13012001', 'shook2', 'photoyub', 'albertczc', 'boehle2', 'cpwalsh2', 'nanto1', 'divito3', 'phoenix_0510', 'scholl1', 'rmuryan2', 'eszato', 'icfmi90', 'jortiz125', 'wicky', 'gomez14', 'mmenon3', 'rishi_ratan', 'chan47', 'skyzzm', 'peterk8', 'beran1', 'willspringzhang', 'chinvet1', 'felipealonso1', 'shin65', 'crazycai', 'jclee9', 'starring', 'ericcj21', 'johnso49', 'barlaz', 'wrubrec2', 'chen95', 'keramat1', 'kocek1', 'shuzhongyou', 'hamburger123', 'karlsino', 'nikunjk', 'marchevskiy', 'rmahaja2', 'djtanaka', 'spitula2', 'cschan3', 'aviraljain12', 'diablopbc', 'tuoliu1', 'lilgoose3', 'squeeksrocks', 'pyropenguinx', 'moruzi1', 'kazi1', 'ragunat1', 'mast5', 'ray4', 'suyagya', 'liangyaning', 'megarza2', 'cvendi2', 'daiyuan1991', 'nahsor', 'akusan', 'yc_ng', 'uppal1', 'vik579', 'fahim89', 'komo', 'stacey2', 'forcejedi', 'kurtovi1', 'capota2', 'xu34', 'kejacs', None, 'tgorti', 'pay1', 'kbliu46', 'baruin2', 'niyingkan', 'fedorov1', 'faorlando', 'tmurray5', 'bhuiya1', 'tsteige2', 'richers1', 'cjhughes17', 'robert25']",121,"['balistic2', 'meagher1', 'eshanso', 'will07c5', 'hipaulshi', 'cheng78', 'horvat1', 'liu141', 'schlude1', 'fthis', 'ren6', 'cardena2', 'bpatzin2', 'lu34', 'rareearth', 'huilinng', 'healy4', 'kim325', 'beugels1', 'trongtong', 'ededens', 'shin34', 'amit13012001', 'shook2', 'photoyub', 'albertczc', 'boehle2', 'cpwalsh2', 'nanto1', 'divito3', 'phoenix_0510', 'scholl1', 'rmuryan2', 'eszato', 'icfmi90', 'jortiz125', 'wicky', 'gomez14', 'mmenon3', 'rishi_ratan', 'chan47', 'skyzzm', 'peterk8', 'beran1', 'willspringzhang', 'chinvet1', 'rohanamin', 'chen128', 'felipealonso1', 'shin65', 'crazycai', 'jclee9', 'starring', 'ericcj21', 'johnso49', 'barlaz', 'wrubrec2', 'chen95', 'keramat1', 'kocek1', 'siucarlos', 'shuzhongyou', 'hamburger123', 'karlsino', 'nikunjk', 'marchevskiy', 'rmahaja2', 'djtanaka', 'spitula2', 'cschan3', 'skorets2', 'aviraljain12', 'diablopbc', 'tuoliu1', 'lilgoose3', 'squeeksrocks', 'japheth', 'pyropenguinx', 'moruzi1', 'kazi1', 'ragunat1', 'mast5', 'ray4', 'suyagya', 'liangyaning', 'megarza2', 'cvendi2', 'daiyuan1991', 'ftreviso', 'nahsor', 'akusan', 'yc_ng', 'uppal1', 'vik579', 'fahim89', 'liu76', 'komo', 'stacey2', 'forcejedi', 'kurtovi1', 'simon6', 'capota2', 'xu34', 'kejacs', 'schaffe3', None, 'tgorti', 'pay1', 'baruin2', 'kbliu46', 'fedorov1', 'niyingkan', 'faorlando', 'tmurray5', 'tsteige2', 'bhuiya1', 'richers1', 'adrianazero', 'cjhughes17', 'ambrood', 'robert25']"
39,132,12,97,5,"['japheth', 'simon6', 'rohanamin', 'ambrood', 'chen128']",6,"['siucarlos', 'liu76', 'skorets2', 'adrianazero', 'schaffe3', 'ftreviso']",92,"['meagher1', 'eshanso', 'hipaulshi', 'cheng78', 'horvat1', 'liu141', 'joseph6', 'ren6', 'bpatzin2', 'cardena2', 'lu34', 'healy4', 'kim325', 'artonis7', 'beugels1', 'shin34', 'shook2', 'perng2', 'photoyub', 'boehle2', 'albertczc', 'cpwalsh2', 'nanto1', 'divito3', 'philip', 'phoenix_0510', 'scholl1', 'rmuryan2', 'eszato', 'jortiz125', 'akshat1521', 'mmenon3', 'chan47', 'skyzzm', 'willspringzhang', 'chinvet1', 'mcarney2', 'darkhelmet2346', 'gkx39', 'shin65', 'starring', 'ericcj21', 'barlaz', 'chen95', 'tonyli1', 'keramat1', 'kocek1', 'hamburger123', 'karlsino', 'rmahaja2', 'djtanaka', 'yuanyao3', 'cschan3', 'nammari1', 'bertbusdriver', 'tuoliu1', 'lilgoose3', 'squeeksrocks', 'moruzi1', 'kazi1', 'mast5', 'mohamed', 'megarza2', 'cvendi2', 'daiyuan1991', 'jsun31', 'tungdo1', 'nahsor', 'akusan', 'yc_ng', 'uppal1', 'vik579', 'echo781', 'fahim89', 'suchko1', 'stacey2', 'kurtovi1', 'capota2', 'kejacs', None, 'tgorti', 'hillebr1', 'kbliu46', 'baruin2', 'ammarfaris', 'fedorov1', 'tmurray5', 'bhuiya1', 'tsteige2', 'richers1', 'cjhughes17', 'robert25']",103,"['meagher1', 'eshanso', 'hipaulshi', 'cheng78', 'horvat1', 'liu141', 'joseph6', 'ren6', 'bpatzin2', 'cardena2', 'lu34', 'healy4', 'kim325', 'artonis7', 'beugels1', 'shin34', 'shook2', 'perng2', 'photoyub', 'boehle2', 'albertczc', 'cpwalsh2', 'nanto1', 'divito3', 'philip', 'phoenix_0510', 'scholl1', 'rmuryan2', 'eszato', 'jortiz125', 'akshat1521', 'mmenon3', 'chan47', 'skyzzm', 'willspringzhang', 'chinvet1', 'rohanamin', 'mcarney2', 'darkhelmet2346', 'chen128', 'gkx39', 'shin65', 'starring', 'ericcj21', 'barlaz', 'chen95', 'tonyli1', 'keramat1', 'kocek1', 'siucarlos', 'hamburger123', 'karlsino', 'rmahaja2', 'djtanaka', 'yuanyao3', 'cschan3', 'skorets2', 'nammari1', 'bertbusdriver', 'tuoliu1', 'lilgoose3', 'squeeksrocks', 'japheth', 'moruzi1', 'kazi1', 'mast5', 'mohamed', 'megarza2', 'cvendi2', 'daiyuan1991', 'jsun31', 'tungdo1', 'ftreviso', 'nahsor', 'akusan', 'yc_ng', 'uppal1', 'vik579', 'echo781', 'fahim89', 'liu76', 'suchko1', 'stacey2', 'kurtovi1', 'simon6', 'capota2', 'kejacs', 'schaffe3', None, 'tgorti', 'hillebr1', 'baruin2', 'ammarfaris', 'fedorov1', 'kbliu46', 'tmurray5', 'bhuiya1', 'tsteige2', 'richers1', 'adrianazero', 'cjhughes17', 'ambrood', 'robert25']"
39,134,12,25,2,"['liu76', 'skorets2']",9,"['siucarlos', 'japheth', 'adrianazero', 'simon6', 'rohanamin', 'ambrood', 'schaffe3', 'ftreviso', 'chen128']",23,"['spitula2', 'foo5', 'drmalkovich', 'mkchow5913', 'huilinng', 'pcrutch2', 'tmalone3', 'crzftx', 'cheeloh1', 'beaver1128', 'gheimbe2', 'zsyrobin', 'yc_ng', 'komo', 'snowpd', 'pay1', None, 'felipealonso1', 'ammarfaris', 'johnso49', 'sixgallon', 'swaffor1', 'hsu16']",34,"['siucarlos', 'spitula2', 'skorets2', 'foo5', 'drmalkovich', 'mkchow5913', 'huilinng', 'japheth', 'pcrutch2', 'tmalone3', 'crzftx', 'cheeloh1', 'beaver1128', 'gheimbe2', 'ftreviso', 'zsyrobin', 'yc_ng', 'liu76', 'komo', 'rohanamin', 'simon6', 'snowpd', 'pay1', 'schaffe3', None, 'chen128', 'felipealonso1', 'ammarfaris', 'johnso49', 'sixgallon', 'adrianazero', 'ambrood', 'swaffor1', 'hsu16']"
39,133,12,18,1,['skorets2'],10,"['siucarlos', 'japheth', 'liu76', 'adrianazero', 'rohanamin', 'simon6', 'ambrood', 'schaffe3', 'ftreviso', 'chen128']",17,"['beugels1', 'tuoliu1', 'scholl1', 'faorlando', 'dhruvbhatia7', 'pyropenguinx', 'cyanrook', 'djtanaka', 'rishi_ratan', 'xinzhao2', 'lumiao88', 'tgorti', 'shook2', 'thinair89', None, 'diablopbc', 'bertbusdriver']",28,"['siucarlos', 'scholl1', 'liu76', 'djtanaka', 'rishi_ratan', 'xinzhao2', 'skorets2', 'rohanamin', 'simon6', 'schaffe3', 'diablopbc', 'chen128', None, 'tgorti', 'beugels1', 'tuoliu1', 'faorlando', 'dhruvbhatia7', 'bertbusdriver', 'japheth', 'pyropenguinx', 'cyanrook', 'lumiao88', 'adrianazero', 'shook2', 'thinair89', 'ambrood', 'ftreviso']"
39,40,12,12,1,['liu76'],10,"['siucarlos', 'japheth', 'skorets2', 'adrianazero', 'rohanamin', 'simon6', 'ambrood', 'schaffe3', 'ftreviso', 'chen128']",11,"['philip', None, 'pcrutch2', 'spitula2', 'sixgallon', 'bobbit1', 'pao1', 'richers1', 'foo5', 'darkhelmet2346', 'hsu16']",22,"['siucarlos', 'philip', 'liu76', 'spitula2', 'bobbit1', 'pao1', 'skorets2', 'rohanamin', 'simon6', 'foo5', 'schaffe3', 'darkhelmet2346', 'chen128', None, 'japheth', 'pcrutch2', 'sixgallon', 'richers1', 'adrianazero', 'ambrood', 'ftreviso', 'hsu16']"
39,136,12,8,1,['schaffe3'],10,"['siucarlos', 'japheth', 'liu76', 'skorets2', 'adrianazero', 'rohanamin', 'simon6', 'ambrood', 'ftreviso', 'chen128']",7,"['rareearth', 'mus423', 'liu7979', 'dongdong', 'lu34', None, 'dgrocho2']",18,"['siucarlos', 'mus423', 'liu76', 'skorets2', 'liu7979', 'rohanamin', 'simon6', 'dongdong', 'rareearth', 'schaffe3', 'lu34', 'chen128', None, 'japheth', 'adrianazero', 'ambrood', 'ftreviso', 'dgrocho2']"
39,137,12,8,1,['siucarlos'],10,"['japheth', 'liu76', 'skorets2', 'adrianazero', 'rohanamin', 'simon6', 'ambrood', 'schaffe3', 'ftreviso', 'chen128']",7,"[None, 'tohms19', 'xu52', 'maoshouse', 'saima1', 'xu34', 'tbvance']",18,"['siucarlos', 'tohms19', 'liu76', 'skorets2', 'rohanamin', 'simon6', 'xu52', 'xu34', 'schaffe3', None, 'chen128', 'japheth', 'adrianazero', 'maoshouse', 'saima1', 'ambrood', 'tbvance', 'ftreviso']"
39,139,12,6,1,['adrianazero'],10,"['siucarlos', 'japheth', 'liu76', 'skorets2', 'rohanamin', 'simon6', 'ambrood', 'schaffe3', 'ftreviso', 'chen128']",5,"['nanobot2011', 'acargo22', 'quintero', 'stephanyabarca', None]",16,"['siucarlos', 'nanobot2011', None, 'acargo22', 'japheth', 'liu76', 'quintero', 'stephanyabarca', 'skorets2', 'adrianazero', 'rohanamin', 'simon6', 'ambrood', 'schaffe3', 'ftreviso', 'chen128']"
40,292,12,60,7,"['couperin', 'gtakahas', 'kadillma', 'qingxu', 'umashantini', 'wmuhoza', 'cpritche']",4,"['onayfeh', 'karl0100', 'ellio167', 'nbeaver']",53,"['wgw', 'dkearney', 'wizjeong', 'cmwesigw', 'arun2987', 'nesquiv', 'kaimiao', 'eigurrola', 'swoop', 'gah', 'kylecaddigan', 'zoso0789', 'yao14', 'raseong', 'rchavali', 'pbagaria', 'pcharala', 'smonirul', 'skumar33', 'xie0', 'clarksm', 'jmunley1', 'hojin92', 'paul_nano_tran', 'fcordisc', 'jemadrid', 'mmc', 'camilaagw', 'taeyong7', 'sokrates', 'pmeunier', 'schcats', 'dadrin2026', 'asma1701', 'oodele', 'steigers', 'kelzholley', 'nkissebe', 'bhaley', 'biswajit025', 'csmoak', 'spwilson', None, 'dcifuent', 'crvantas', 'isantos2', 'dalemus', 'rappture', 'skyw', 'apps', 'moore32', 'marisol', 'sunxingshu']",64,"['dkearney', 'wizjeong', 'cmwesigw', 'kadillma', 'kaimiao', 'gah', 'kylecaddigan', 'yao14', 'onayfeh', 'rchavali', 'pbagaria', 'xie0', 'clarksm', 'fcordisc', 'cpritche', 'sokrates', 'schcats', 'oodele', 'steigers', 'bhaley', 'nbeaver', 'dcifuent', 'ellio167', 'smonirul', 'moore32', 'sunxingshu', 'wgw', 'couperin', 'arun2987', 'nesquiv', 'eigurrola', 'swoop', 'zoso0789', 'raseong', 'karl0100', 'pcharala', 'skumar33', 'jmunley1', 'hojin92', 'paul_nano_tran', 'jemadrid', 'mmc', 'camilaagw', 'umashantini', 'taeyong7', 'dadrin2026', 'pmeunier', 'asma1701', 'kelzholley', 'wmuhoza', 'nkissebe', 'biswajit025', 'csmoak', 'spwilson', None, 'crvantas', 'qingxu', 'gtakahas', 'isantos2', 'dalemus', 'rappture', 'skyw', 'apps', 'marisol']"
41,197,12,14,8,"['abatain1', 'mdavydo1', 'brendank310', 'tigger29900', 'txu2', 'kmasri1', 'apizzo1', 'rahuldixit']",3,"['dmnano40', 'rpower', 'cpoole1']",6,"['crystalwall', 'bewhitejr', 'rkuntz', 'yike2011', 'helenazhou6', None]",17,"['crystalwall', 'bewhitejr', 'abatain1', 'tigger29900', 'txu2', 'yike2011', 'helenazhou6', None, 'rahuldixit', 'mdavydo1', 'rkuntz', 'dmnano40', 'brendank310', 'kmasri1', 'cpoole1', 'apizzo1', 'rpower']"
41,200,12,14,9,"['abatain1', 'mdavydo1', 'brendank310', 'tigger29900', 'txu2', 'kmasri1', 'rahuldixit', 'apizzo1', 'rpower']",2,"['dmnano40', 'cpoole1']",5,"['bewhitejr', 'rkuntz', 'yike2011', 'helenazhou6', None]",16,"['bewhitejr', 'abatain1', 'tigger29900', 'txu2', 'yike2011', 'helenazhou6', None, 'rahuldixit', 'mdavydo1', 'rkuntz', 'dmnano40', 'brendank310', 'kmasri1', 'cpoole1', 'apizzo1', 'rpower']"
41,150,12,13,8,"['abatain1', 'mdavydo1', 'brendank310', 'tigger29900', 'txu2', 'kmasri1', 'apizzo1', 'rahuldixit']",3,"['dmnano40', 'rpower', 'cpoole1']",5,"['bewhitejr', 'rkuntz', 'yike2011', 'helenazhou6', None]",16,"['bewhitejr', 'abatain1', 'tigger29900', 'txu2', 'yike2011', 'helenazhou6', None, 'rahuldixit', 'mdavydo1', 'rkuntz', 'dmnano40', 'brendank310', 'kmasri1', 'cpoole1', 'apizzo1', 'rpower']"
41,199,12,8,2,"['brendank310', 'abatain1']",9,"['mdavydo1', 'dmnano40', 'tigger29900', 'txu2', 'kmasri1', 'cpoole1', 'apizzo1', 'rpower', 'rahuldixit']",6,"['andrewnico', 'jhp88', 'yike2011', 'apang1', 'helenazhou6', None]",17,"['abatain1', 'andrewnico', 'jhp88', 'tigger29900', 'txu2', 'yike2011', 'apang1', 'helenazhou6', None, 'rahuldixit', 'mdavydo1', 'dmnano40', 'brendank310', 'kmasri1', 'cpoole1', 'apizzo1', 'rpower']"
41,198,12,6,3,"['dmnano40', 'cpoole1', 'tigger29900']",8,"['abatain1', 'mdavydo1', 'brendank310', 'txu2', 'kmasri1', 'rahuldixit', 'apizzo1', 'rpower']",3,"['crystalwall', None, 'jhp88']",14,"['crystalwall', None, 'abatain1', 'mdavydo1', 'dmnano40', 'brendank310', 'jhp88', 'tigger29900', 'txu2', 'kmasri1', 'cpoole1', 'rpower', 'apizzo1', 'rahuldixit']"
41,201,12,6,3,"['dmnano40', 'cpoole1', 'tigger29900']",8,"['abatain1', 'mdavydo1', 'brendank310', 'txu2', 'kmasri1', 'rahuldixit', 'apizzo1', 'rpower']",3,"['crystalwall', None, 'jhp88']",14,"['crystalwall', None, 'abatain1', 'mdavydo1', 'dmnano40', 'brendank310', 'jhp88', 'tigger29900', 'txu2', 'kmasri1', 'cpoole1', 'rpower', 'apizzo1', 'rahuldixit']"
42,277,11,14,8,"['bae4', 'wrucker', 'dchung88', 'lkearney', 'fengk', 'azamojsk', 'cjwagner', 'takinfe']",2,"['skunplin', 'rkusuma']",6,"['redwing', 'dely', 'mehtad', 'gnave', None, 'behaley']",16,"['redwing', 'wrucker', 'dchung88', 'lkearney', 'fengk', 'azamojsk', 'skunplin', None, 'rkusuma', 'cjwagner', 'takinfe', 'bae4', 'dely', 'mehtad', 'gnave', 'behaley']"
42,276,11,13,9,"['bae4', 'cjwagner', 'wrucker', 'dchung88', 'lkearney', 'fengk', 'skunplin', 'rkusuma', 'takinfe']",1,['azamojsk'],4,"[None, 'sajordan', 'wrightb26', 'behaley']",14,"['wrucker', 'dchung88', 'lkearney', 'fengk', 'azamojsk', 'skunplin', None, 'rkusuma', 'cjwagner', 'takinfe', 'bae4', 'wrightb26', 'sajordan', 'behaley']"
42,280,11,13,10,"['bae4', 'cjwagner', 'wrucker', 'dchung88', 'lkearney', 'fengk', 'azamojsk', 'skunplin', 'rkusuma', 'takinfe']",0,[],3,"['redwing', None, 'mehtad']",13,"['redwing', 'wrucker', 'dchung88', 'lkearney', 'fengk', 'azamojsk', 'skunplin', None, 'rkusuma', 'cjwagner', 'takinfe', 'bae4', 'mehtad']"
42,278,11,12,8,"['bae4', 'cjwagner', 'wrucker', 'dchung88', 'fengk', 'azamojsk', 'skunplin', 'rkusuma']",2,"['takinfe', 'lkearney']",4,"['redwing', None, 'dely', 'behaley']",14,"['redwing', 'wrucker', 'dchung88', 'lkearney', 'fengk', 'azamojsk', 'skunplin', None, 'rkusuma', 'cjwagner', 'takinfe', 'bae4', 'dely', 'behaley']"
42,279,11,12,8,"['bae4', 'cjwagner', 'wrucker', 'dchung88', 'fengk', 'azamojsk', 'rkusuma', 'takinfe']",2,"['skunplin', 'lkearney']",4,"['redwing', None, 'mehtad', 'dely']",14,"['redwing', 'wrucker', 'dchung88', 'lkearney', 'fengk', 'azamojsk', 'skunplin', None, 'rkusuma', 'cjwagner', 'takinfe', 'bae4', 'dely', 'mehtad']"
42,281,11,8,7,"['bae4', 'wrucker', 'lkearney', 'fengk', 'azamojsk', 'cjwagner', 'takinfe']",3,"['skunplin', 'dchung88', 'rkusuma']",1,[None],11,"['bae4', 'wrucker', 'dchung88', 'lkearney', 'fengk', 'azamojsk', 'rkusuma', 'skunplin', None, 'cjwagner', 'takinfe']"
43,210,11,11,9,"['jbpalmer7', 'gabra29', 'lyndseyb328', 'shankuria', 'asmclaurin', 'hotfroggy', 'zdehart89', 'courtney_mitchell_2007', 'jlorenzorii']",1,['1falling2'],2,"[None, 'nanohub2']",12,"['asmclaurin', 'nanohub2', 'hotfroggy', 'zdehart89', 'lyndseyb328', 'courtney_mitchell_2007', 'jlorenzorii', None, '1falling2', 'jbpalmer7', 'gabra29', 'shankuria']"
43,223,11,11,9,"['jbpalmer7', 'gabra29', 'lyndseyb328', 'shankuria', 'asmclaurin', 'hotfroggy', 'zdehart89', 'courtney_mitchell_2007', 'jlorenzorii']",1,['1falling2'],2,"[None, 'nanohub2']",12,"['asmclaurin', 'nanohub2', 'hotfroggy', 'zdehart89', 'lyndseyb328', 'courtney_mitchell_2007', 'jlorenzorii', None, '1falling2', 'jbpalmer7', 'gabra29', 'shankuria']"
44,204,11,390,2,"['mshelby', 'whoff']",8,"['nvalley', 'amberdavis2014', 'heitzerh', 'scottydyar', 'koaruda', 'iamicde', 'mrm663', 'alguzduxtan']",388,"['eweichmann', 'dpfeffer', 'vmitra92', 'lmichelsen', 'hitopgun', 'kkiani', 'sarahclark2014', 'nuchem', 'wiscorower', 'jki416', 'kmdoherty', 'phw454', 'bchanzit', 'lisamithun', 'jwoll1692', 'chem10232269', 'elisees', 'zrs686', 'elinraun', 'sicelo', 'ignacioestrada', 'dangerousdan', 'mweber', 'hct669', 'chc727', 'ssa886', 'nanolab218', 'dannyginz', 'kpescadora', 'jhuber', 'tdupper', 'knutecuk', 'runningfreak21', 'pvonachen', 'cfirman', 'kegley', 'dannywinans', 'aqh681', 'yaejinpark2014', 'rossmac13', 'jkchem3', 'jpmccleary', 'kjh321', 'bhamilton', 'willworden', 'chiggins', 'mcm179', 'chancecim', 'cel156', 'sraiter', 'vincenthuang', 'jschultz57', 'njneil92', 'pthimsuwan5050', 'jbuser92', 'jpalarczyk', 'samhatfield', 'gusbus06', 'markbachrach', 'aspiegel', 'dmp556', 'gcutsail', 'chem102', 'xdi870', 'wngo', 'brockburdyl', 'jwchoi13', 'sonalid', 'jkoszela', 'nebiu', 'eap01', 'jpkmufc11', 'mollykbaker', 'meghan1', 'ccf165', 'makanter', 'rose', 'sor427', 'regit627', 'ecrystal', 'kwerling', 'johnmari', 'pdu937', 'arilederman', 'jeg770', 'alipka', 'chloe126', 'nhan3', 'ghm918', 'axz244', 'alannahenry', 'alamens', 'sdv465', 'kdwoods', 'trp982', 'jpj917', 'gatesmeg', 'jennly', 'vraghunath', 'knp750', 'aoabraham', 'jdf478', 'moekou', 'sghelani', 'dwerickson', 'jsd713', 'patwood78', 'ddjrl', 'juliaretzky', 'jkzhou99', 'kegermann', 'bgerber', 'mdj146', 'mborba', 'hhass', 'tkagadawala', 'martakulich', 'ltu197', 'wchoi1025', 'brivard', 'ethanmcginnis2014', 'ktdutchman', 'bkurcz', 'vfa774', 'danalec23', 'ncalta', 'meshun11', 'jasminejones', 'edsarah', 'amcgary', 'abz881', 'mz1030', 'mss647', 'jguitart', 'adriennedunk', 'srv123', 'nch964', 'mrossi14', 'rnorval', 'azeliko', 'sahartman4', 'spencermartens', 'lee9jo', 'markc', 'rch465', 'juliateresa1', 'alanpan', 'hopeandseema', 'nebiutadele', 'stephmandir', 'mjiang112', 'deboisbn', 'vwang92', 'jlj592', 'bli', 'jli', 'saxo', 'hcm888', 'danielmcfarland', 'sarahjeong2014', 'catherinealthaus', 'vjh199', 'jherzog', 'dmirtsching', 'vcz359', 'jeliff7', 'esosdian', 'noliver97', 'nicolechem', 'amee', 'kevingreenhalgh2014', 'vog399', 'soh207', 'rjs374', 'abd892', 'benthemonkey', 'mwiersema', 'amlyniec', 'csilvestre', 'aramis16', 'matshu92', 'coreygoodwin', 'kpratt', 'lianggu91', 'greed0812', 'bcarlis', 'bjr124', 'cms201', 'sydneyblack', 'ajm882', 'sharris', 'vickieotto', 'eeg951', 'lph854', 'twu', 'erica123', 'ebens', 'swa423', 'changbeeray', 'musiclover324', 'lwint', 'teresak', 'amandaziffer2014', 'mkegermann', 'tak825', 'mevans', 'tmengesha', 'kelseythom', 'jquinn825', 'graceminix', 'mrauf', 'jetzoh51', 'dac279', 'jyu3138', 'ewo304', 'alijoe2014', 'jwu525', 'msh986', 'jboxman7', 'jmb489', 'mikejgleeson10', 'jsolis7', 'payasarraf1', 'vpp990', 'edp592', 'sem227', 'fjk562', 'hkw198', 'har580', 'hrendos', 'shj210', 'mmmccc', 'jgruszeczki', 'msistla46', 'laurensoccer13', 'jsh8', 'shaina_nano', 'ngruenke', 'gkoshelev', 'tan190', 'avanisingh1', 'bmsiwek', 'saracov726', 'bumpin8er', 'samtam', 'nicroth', 'jamesbhigdon', 'cosidari', 'annpowers', 'clairemelvin', 'tweiner92', 'dbali423', 'ras525', 'lae247', 'wenbinbin2010', 'tjw107', 'awalker6', 'kgu988', 'lslesur', 'lmadison13', 'ses457', 'rosemilavitz', 'rbraga25', 'kogden', 'lrl839', 'wizmaster', 'stingraymart1', 'cjanczak', 'smc895', 'cfeldhaus', 'hgf596', 'mhj872', 'atif24', 'crkramer', 'akantzos', 'harlynn14siler', 'simontj', 'eek735', 'yuliya12', 'amandafrankel2014', 'slhatch', 'giah', 'madelineschwid', 'kswann', 'johnandalex', 'kapoornu', 'sah285', 'jesusflores2013', 'kennedyq', 'cskeehan', 'jds119', 'cberkowitz', 'hairandholman', 'sjl123', 'ecp899', 'ezaonegina', 'kgc375', 'kik101', 'kendrahertz2014', 'lmsadowsky', 'blai', 'dsh926', 'kayliepmiller', 'zil338', 'knk953', 'lamar0404', 'ksd948', 'msw466', 'gmv672', 'pinararikan', 'rmullen2', 'cvickst14', 'cdarin', 'jsierks2', 'cnj373', 'sunjaejung', 'meganghub', 'the13thmachete', 'yzh199', 'tli132', 'jeffandrose', 'nehanimm', 'bhuang92', 'kalishah', 'charleyp', 'jkilcommons', 'copperbeech1', 'iam007stina', 'nkj745', 'amc480', 'mark123', 'zachkis', 'mwrobes', 'titosmith12', 'chriscappello', 'jtargos', 'dlrhksgud4', 'mwagner987', 'karenoreilly', 'arandle', 'btredz49', 'jocandkev', 'nulab24c', 'suekim2014', 'sam413', 'kes690', 'kconnors', 'sli674', 'bugmenot', 'eterzer', 'jcao618', 'abbyroopali', 'landislandis', 'lillian2011', 'alereyes', 'cwollaeger', 'ntp742', 'danielthomas2014', 'ath800', 'wsc826', 'gusdomel', 'dhw191', 'ggon03', 'ays976', 'johnpark8', 'benjaminrafshoon2014', 'mhartoun', 'kstclaire', 'chemistry1', 'vasanoah', 'mdw994', 'shawnkim332', 'varshinicherukupalli', 'sahopki', 'rchalmers', 'shadiasadaqa', 'arps714', 'jhk931', 'cmw897', 'amattias', 'kkenney', 'suziepeter', 'tjconsidine', 'robbie529', 'rgeiwitz', 'aarora', 'hbaker', 'shilliger']",398,"['eweichmann', 'dpfeffer', 'vmitra92', 'lmichelsen', 'hitopgun', 'kkiani', 'sarahclark2014', 'nuchem', 'wiscorower', 'jki416', 'kmdoherty', 'phw454', 'bchanzit', 'lisamithun', 'jwoll1692', 'chem10232269', 'elisees', 'zrs686', 'elinraun', 'sicelo', 'ignacioestrada', 'dangerousdan', 'mweber', 'hct669', 'chc727', 'ssa886', 'nanolab218', 'dannyginz', 'kpescadora', 'jhuber', 'tdupper', 'knutecuk', 'runningfreak21', 'pvonachen', 'cfirman', 'kegley', 'dannywinans', 'aqh681', 'yaejinpark2014', 'rossmac13', 'jkchem3', 'jpmccleary', 'kjh321', 'bhamilton', 'willworden', 'chiggins', 'mcm179', 'chancecim', 'cel156', 'sraiter', 'vincenthuang', 'jschultz57', 'njneil92', 'mrm663', 'jbuser92', 'pthimsuwan5050', 'jpalarczyk', 'samhatfield', 'gusbus06', 'nvalley', 'markbachrach', 'aspiegel', 'dmp556', 'gcutsail', 'chem102', 'xdi870', 'wngo', 'koaruda', 'brockburdyl', 'jwchoi13', 'sonalid', 'jkoszela', 'nebiu', 'eap01', 'jpkmufc11', 'mollykbaker', 'meghan1', 'ccf165', 'makanter', 'rose', 'sor427', 'regit627', 'ecrystal', 'kwerling', 'johnmari', 'pdu937', 'arilederman', 'jeg770', 'alipka', 'chloe126', 'nhan3', 'ghm918', 'axz244', 'alannahenry', 'alamens', 'sdv465', 'kdwoods', 'trp982', 'jpj917', 'gatesmeg', 'jennly', 'vraghunath', 'knp750', 'aoabraham', 'jdf478', 'moekou', 'sghelani', 'dwerickson', 'jsd713', 'patwood78', 'ddjrl', 'juliaretzky', 'jkzhou99', 'kegermann', 'bgerber', 'mdj146', 'mborba', 'hhass', 'tkagadawala', 'martakulich', 'ltu197', 'wchoi1025', 'brivard', 'ethanmcginnis2014', 'ktdutchman', 'bkurcz', 'vfa774', 'danalec23', 'ncalta', 'meshun11', 'jasminejones', 'edsarah', 'amcgary', 'abz881', 'mz1030', 'mss647', 'jguitart', 'adriennedunk', 'srv123', 'nch964', 'mrossi14', 'rnorval', 'azeliko', 'sahartman4', 'amberdavis2014', 'lee9jo', 'spencermartens', 'markc', 'rch465', 'juliateresa1', 'alanpan', 'hopeandseema', 'nebiutadele', 'stephmandir', 'mjiang112', 'mshelby', 'deboisbn', 'vwang92', 'jlj592', 'bli', 'jli', 'saxo', 'hcm888', 'danielmcfarland', 'sarahjeong2014', 'catherinealthaus', 'vjh199', 'jherzog', 'dmirtsching', 'vcz359', 'jeliff7', 'esosdian', 'noliver97', 'nicolechem', 'amee', 'kevingreenhalgh2014', 'vog399', 'soh207', 'rjs374', 'abd892', 'benthemonkey', 'mwiersema', 'amlyniec', 'csilvestre', 'aramis16', 'matshu92', 'coreygoodwin', 'kpratt', 'lianggu91', 'greed0812', 'bcarlis', 'bjr124', 'cms201', 'iamicde', 'sydneyblack', 'ajm882', 'sharris', 'vickieotto', 'heitzerh', 'eeg951', 'lph854', 'twu', 'erica123', 'ebens', 'swa423', 'changbeeray', 'musiclover324', 'alguzduxtan', 'lwint', 'teresak', 'amandaziffer2014', 'mkegermann', 'tak825', 'mevans', 'tmengesha', 'kelseythom', 'jquinn825', 'graceminix', 'mrauf', 'whoff', 'jetzoh51', 'dac279', 'jyu3138', 'ewo304', 'alijoe2014', 'jwu525', 'msh986', 'jboxman7', 'jmb489', 'mikejgleeson10', 'jsolis7', 'payasarraf1', 'vpp990', 'edp592', 'sem227', 'fjk562', 'hkw198', 'har580', 'hrendos', 'shj210', 'mmmccc', 'jgruszeczki', 'msistla46', 'laurensoccer13', 'jsh8', 'shaina_nano', 'ngruenke', 'gkoshelev', 'tan190', 'avanisingh1', 'bmsiwek', 'saracov726', 'bumpin8er', 'samtam', 'nicroth', 'jamesbhigdon', 'cosidari', 'annpowers', 'clairemelvin', 'tweiner92', 'dbali423', 'ras525', 'lae247', 'wenbinbin2010', 'tjw107', 'awalker6', 'kgu988', 'scottydyar', 'lslesur', 'lmadison13', 'ses457', 'rosemilavitz', 'rbraga25', 'kogden', 'lrl839', 'wizmaster', 'stingraymart1', 'cjanczak', 'smc895', 'cfeldhaus', 'hgf596', 'mhj872', 'atif24', 'crkramer', 'akantzos', 'harlynn14siler', 'simontj', 'eek735', 'yuliya12', 'amandafrankel2014', 'slhatch', 'giah', 'madelineschwid', 'kswann', 'johnandalex', 'kapoornu', 'sah285', 'jesusflores2013', 'kennedyq', 'cskeehan', 'jds119', 'cberkowitz', 'hairandholman', 'sjl123', 'ecp899', 'ezaonegina', 'kgc375', 'kik101', 'kendrahertz2014', 'lmsadowsky', 'blai', 'dsh926', 'kayliepmiller', 'zil338', 'knk953', 'lamar0404', 'ksd948', 'msw466', 'gmv672', 'pinararikan', 'rmullen2', 'cvickst14', 'cdarin', 'jsierks2', 'cnj373', 'sunjaejung', 'meganghub', 'the13thmachete', 'yzh199', 'tli132', 'jeffandrose', 'nehanimm', 'bhuang92', 'kalishah', 'charleyp', 'jkilcommons', 'copperbeech1', 'iam007stina', 'nkj745', 'amc480', 'mark123', 'zachkis', 'mwrobes', 'titosmith12', 'chriscappello', 'jtargos', 'dlrhksgud4', 'mwagner987', 'karenoreilly', 'arandle', 'btredz49', 'jocandkev', 'nulab24c', 'suekim2014', 'sam413', 'kes690', 'kconnors', 'sli674', 'bugmenot', 'eterzer', 'jcao618', 'abbyroopali', 'landislandis', 'lillian2011', 'alereyes', 'cwollaeger', 'ntp742', 'danielthomas2014', 'ath800', 'wsc826', 'gusdomel', 'dhw191', 'ggon03', 'ays976', 'johnpark8', 'benjaminrafshoon2014', 'mhartoun', 'kstclaire', 'chemistry1', 'vasanoah', 'mdw994', 'shawnkim332', 'varshinicherukupalli', 'sahopki', 'rchalmers', 'shadiasadaqa', 'arps714', 'jhk931', 'cmw897', 'amattias', 'kkenney', 'suziepeter', 'tjconsidine', 'robbie529', 'rgeiwitz', 'aarora', 'hbaker', 'shilliger']"
44,203,11,18,7,"['amberdavis2014', 'heitzerh', 'scottydyar', 'iamicde', 'mrm663', 'mshelby', 'whoff']",3,"['alguzduxtan', 'nvalley', 'koaruda']",11,"['dunner87', 'bugmenot', 'gcutsail', 'sicelo', 'dangerousdan', 'lmadison13', 'bashwell', 'iam007stina', None, 'nathaniel87', 'ngruenke']",21,"['nvalley', 'amberdavis2014', 'gcutsail', 'heitzerh', 'scottydyar', 'lmadison13', 'bashwell', 'koaruda', 'mshelby', 'alguzduxtan', None, 'ngruenke', 'dunner87', 'bugmenot', 'sicelo', 'dangerousdan', 'iamicde', 'mrm663', 'iam007stina', 'whoff', 'nathaniel87']"
44,202,11,10,5,"['nvalley', 'scottydyar', 'koaruda', 'mshelby', 'whoff']",5,"['amberdavis2014', 'heitzerh', 'iamicde', 'mrm663', 'alguzduxtan']",5,"['gcutsail', 'sicelo', 'lmadison13', None, 'nathaniel87']",15,"['nvalley', 'amberdavis2014', 'gcutsail', 'heitzerh', 'scottydyar', 'lmadison13', 'koaruda', 'mshelby', 'alguzduxtan', None, 'sicelo', 'iamicde', 'mrm663', 'whoff', 'nathaniel87']"
45,29,11,8,7,"['jpcaputo', 'oluchi4585', 'jared', 'wins2001', 'desta', 'kmatariyeh', 'jrsanguinetti']",3,"['eithan', 'blkstone', 'blankso3']",1,[None],11,"['jpcaputo', 'eithan', 'oluchi4585', 'jared', 'wins2001', 'kmatariyeh', 'desta', 'blkstone', 'blankso3', 'jrsanguinetti', None]"
46,60,11,86,1,['rdowdy2'],9,"['azharuddinjokhio', 'nbauer087', 'knuts003', 'jackwenner', 'willg001', 'mehreen', 'gnarly_dana', 'chrisowens', 'gnarlytoast']",85,"['eshanso', 'zhong8', 'hipaulshi', 'horvat1', 'ren6', 'bpatzin2', 'cardena2', 'lu34', 'dluzen3', 'healy4', 'kim325', 'artonis7', 'trongtong', 'saima1', 'photoyub', 'albertczc', 'cpwalsh2', 'nanto1', 'eszato', 'philip', 'akshat1521', 'rmuryan2', 'gomez14', 'mmenon3', 'skyzzm', 'beran1', 'zhimin', 'willspringzhang', 'chinvet1', 'gkx39', 'shin65', 'ealmeid2', 'ericcj21', 'johnso49', 'barlaz', 'chen95', 'frost1', 'keramat1', 'kocek1', 'shuzhongyou', 'hamburger123', 'karlsino', 'drake5', 'cschan3', 'mewyn', 'aviraljain12', 'diablopbc', 'squeeksrocks', 'pyropenguinx', 'shao11', 'moruzi1', 'kazi1', 'suyagya', 'megarza2', 'crzftx', 'daiyuan1991', 'jsun31', 'gheimbe2', 'nahsor', 'akusan', 'yc_ng', 'echo781', 'fahim89', 'suchko1', 'komo', 'stacey2', 'forcejedi', 'kurtovi1', 'capota2', 'xu34', 'kejacs', None, 'tgorti', 'hillebr1', 'pay1', 'baruin2', 'ammarfaris', 'kbliu46', 'niyingkan', 'dhruvbhatia7', 'bhuiya1', 'tsteige2', 'lumiao88', 'cjhughes17', 'robert25']",95,"['eshanso', 'nbauer087', 'zhong8', 'hipaulshi', 'horvat1', 'jackwenner', 'ren6', 'bpatzin2', 'cardena2', 'lu34', 'dluzen3', 'healy4', 'kim325', 'artonis7', 'trongtong', 'saima1', 'mehreen', 'photoyub', 'albertczc', 'cpwalsh2', 'nanto1', 'gnarlytoast', 'eszato', 'philip', 'akshat1521', 'rdowdy2', 'rmuryan2', 'gomez14', 'mmenon3', 'skyzzm', 'beran1', 'zhimin', 'willspringzhang', 'chinvet1', 'gnarly_dana', 'gkx39', 'shin65', 'ealmeid2', 'ericcj21', 'johnso49', 'barlaz', 'chen95', 'frost1', 'willg001', 'keramat1', 'kocek1', 'shuzhongyou', 'hamburger123', 'karlsino', 'drake5', 'cschan3', 'mewyn', 'aviraljain12', 'diablopbc', 'squeeksrocks', 'pyropenguinx', 'shao11', 'knuts003', 'moruzi1', 'kazi1', 'suyagya', 'megarza2', 'crzftx', 'daiyuan1991', 'jsun31', 'gheimbe2', 'nahsor', 'akusan', 'azharuddinjokhio', 'yc_ng', 'echo781', 'fahim89', 'suchko1', 'komo', 'stacey2', 'forcejedi', 'kurtovi1', 'capota2', 'xu34', 'kejacs', None, 'tgorti', 'hillebr1', 'pay1', 'baruin2', 'ammarfaris', 'kbliu46', 'niyingkan', 'dhruvbhatia7', 'bhuiya1', 'tsteige2', 'lumiao88', 'cjhughes17', 'robert25', 'chrisowens']"
46,63,11,24,7,"['nbauer087', 'knuts003', 'jackwenner', 'willg001', 'gnarly_dana', 'chrisowens', 'gnarlytoast']",3,"['mehreen', 'azharuddinjokhio', 'rdowdy2']",17,"['spribble', 'divito3', 'crazycai', 'will07c5', 'cthayer3', 'icfmi90', 'thom0876', 'geneyu2', 'cbahr2005', 'chan47', 'silver104', 'tonyli1', 'maoshouse', 'stoddar1', 'jmarti', None, 'aneavil2']",27,"['nbauer087', 'will07c5', 'jackwenner', 'knuts003', 'thom0876', 'cbahr2005', 'maoshouse', 'stoddar1', 'mehreen', 'gnarlytoast', 'azharuddinjokhio', 'divito3', 'rdowdy2', 'icfmi90', 'geneyu2', 'chan47', 'silver104', 'jmarti', 'gnarly_dana', None, 'spribble', 'crazycai', 'cthayer3', 'tonyli1', 'willg001', 'chrisowens', 'aneavil2']"
46,61,11,10,2,"['mehreen', 'azharuddinjokhio']",8,"['nbauer087', 'rdowdy2', 'knuts003', 'jackwenner', 'willg001', 'gnarly_dana', 'chrisowens', 'gnarlytoast']",8,"['asra', 'khu_18', 'hiraimtiaz', 'waqas', 'fatima', 'muneebp4', 'sadafdilshad', None]",18,"['asra', 'azharuddinjokhio', 'nbauer087', 'rdowdy2', 'khu_18', 'fatima', 'muneebp4', 'jackwenner', 'gnarly_dana', None, 'hiraimtiaz', 'waqas', 'knuts003', 'willg001', 'sadafdilshad', 'mehreen', 'chrisowens', 'gnarlytoast']"
47,14,11,14,6,"['vedpragyan', 'lin180', 'glowzbd', 'hsohail', 'brianlew', 'qianw']",4,"['teadams30', 'mbadreldin', 'anandakumar', 'abhay_bitsg']",8,"['msharad', 'ziyunlong', 'mstone56', 'shwet', 'chandrar88', 'heyu07', 'leedj111', None]",18,"['vedpragyan', 'glowzbd', 'ziyunlong', 'brianlew', 'mstone56', 'chandrar88', 'mbadreldin', 'heyu07', 'leedj111', None, 'msharad', 'lin180', 'hsohail', 'anandakumar', 'shwet', 'teadams30', 'abhay_bitsg', 'qianw']"
47,120,11,14,6,"['lin180', 'glowzbd', 'brianlew', 'hsohail', 'teadams30', 'qianw']",4,"['vedpragyan', 'mbadreldin', 'anandakumar', 'abhay_bitsg']",8,"['msharad', 'mstone56', 'hsu21', 'zhang581', 'alicejou6733', 'leedj111', 'kbrew', None]",18,"['vedpragyan', 'glowzbd', 'brianlew', 'mstone56', 'hsu21', 'mbadreldin', 'alicejou6733', 'leedj111', None, 'msharad', 'lin180', 'hsohail', 'anandakumar', 'teadams30', 'zhang581', 'abhay_bitsg', 'qianw', 'kbrew']"
47,6,11,12,4,"['glowzbd', 'vedpragyan', 'qianw', 'brianlew']",6,"['lin180', 'hsohail', 'anandakumar', 'teadams30', 'mbadreldin', 'abhay_bitsg']",8,"['charleshages', 'msharad', 'ziyunlong', 'mstone56', 'shwet', 'kaimiao', 'heyu07', None]",18,"['vedpragyan', 'glowzbd', 'ziyunlong', 'brianlew', 'mstone56', 'kaimiao', 'mbadreldin', 'heyu07', None, 'charleshages', 'msharad', 'lin180', 'hsohail', 'anandakumar', 'shwet', 'teadams30', 'abhay_bitsg', 'qianw']"
47,9,11,10,3,"['teadams30', 'hsohail', 'anandakumar']",7,"['vedpragyan', 'lin180', 'glowzbd', 'brianlew', 'mbadreldin', 'abhay_bitsg', 'qianw']",7,"['rgdaniel', 'msharad', 'clozakitr', 'kevecan', 'mynameiskory', None, 'ferry']",17,"['vedpragyan', 'glowzbd', 'brianlew', 'kevecan', 'mbadreldin', 'rgdaniel', None, 'msharad', 'lin180', 'clozakitr', 'hsohail', 'anandakumar', 'teadams30', 'abhay_bitsg', 'qianw', 'mynameiskory', 'ferry']"
47,119,11,8,2,"['vedpragyan', 'anandakumar']",8,"['lin180', 'glowzbd', 'brianlew', 'hsohail', 'teadams30', 'mbadreldin', 'abhay_bitsg', 'qianw']",6,"['kevecan', 'xinzhao2', 'chandrar88', 'mchabinyc', 'dsutherl', None]",16,"['vedpragyan', 'lin180', 'glowzbd', 'brianlew', 'hsohail', 'anandakumar', 'kevecan', 'xinzhao2', 'teadams30', 'chandrar88', 'mbadreldin', 'abhay_bitsg', 'qianw', 'dsutherl', 'mchabinyc', None]"
47,58,11,6,3,"['lin180', 'anandakumar', 'qianw']",7,"['vedpragyan', 'glowzbd', 'hsohail', 'brianlew', 'teadams30', 'mbadreldin', 'abhay_bitsg']",3,"['jgeng', None, 'leedj111']",13,"['vedpragyan', 'lin180', 'glowzbd', 'brianlew', 'hsohail', 'anandakumar', 'jgeng', 'teadams30', 'mbadreldin', 'abhay_bitsg', 'qianw', 'leedj111', None]"
47,121,11,6,3,"['hsohail', 'teadams30', 'vedpragyan']",7,"['lin180', 'glowzbd', 'brianlew', 'anandakumar', 'mbadreldin', 'abhay_bitsg', 'qianw']",3,"[None, 'ajagadee', 'sheetse']",13,"['vedpragyan', 'ajagadee', 'sheetse', 'lin180', 'glowzbd', 'brianlew', 'hsohail', 'anandakumar', 'teadams30', 'mbadreldin', 'abhay_bitsg', 'qianw', None]"
48,219,11,6,4,"['liowa', 'oanovam', 'racso', 'lukassalazar']",6,"['azcod', 'mrueth', 'meem', 'jnassar', 'shakil80', 'mundet']",2,"[None, 'joseg']",12,"['azcod', 'mrueth', 'liowa', 'meem', 'lukassalazar', 'jnassar', 'oanovam', 'racso', 'shakil80', 'joseg', 'mundet', None]"
49,60,10,86,2,"['ealmeid2', 'zhong8']",7,"['nishsharma', 'leo19890725', 'mudasir', 'hhkart2001', 'jlee4689', 'kikelsey', 'minxu']",84,"['eshanso', 'hipaulshi', 'horvat1', 'ren6', 'bpatzin2', 'cardena2', 'lu34', 'dluzen3', 'healy4', 'kim325', 'artonis7', 'trongtong', 'saima1', 'photoyub', 'albertczc', 'cpwalsh2', 'nanto1', 'eszato', 'philip', 'akshat1521', 'rdowdy2', 'rmuryan2', 'gomez14', 'mmenon3', 'skyzzm', 'beran1', 'zhimin', 'willspringzhang', 'chinvet1', 'gkx39', 'shin65', 'ericcj21', 'johnso49', 'barlaz', 'chen95', 'frost1', 'keramat1', 'kocek1', 'shuzhongyou', 'hamburger123', 'karlsino', 'drake5', 'cschan3', 'mewyn', 'aviraljain12', 'diablopbc', 'squeeksrocks', 'pyropenguinx', 'shao11', 'moruzi1', 'kazi1', 'suyagya', 'megarza2', 'crzftx', 'daiyuan1991', 'jsun31', 'gheimbe2', 'nahsor', 'akusan', 'yc_ng', 'echo781', 'fahim89', 'suchko1', 'komo', 'stacey2', 'forcejedi', 'kurtovi1', 'capota2', 'xu34', 'kejacs', None, 'tgorti', 'hillebr1', 'pay1', 'baruin2', 'ammarfaris', 'kbliu46', 'niyingkan', 'dhruvbhatia7', 'bhuiya1', 'tsteige2', 'lumiao88', 'cjhughes17', 'robert25']",93,"['eshanso', 'zhong8', 'hipaulshi', 'horvat1', 'ren6', 'hhkart2001', 'bpatzin2', 'cardena2', 'lu34', 'dluzen3', 'healy4', 'kim325', 'artonis7', 'trongtong', 'jlee4689', 'saima1', 'photoyub', 'albertczc', 'cpwalsh2', 'nanto1', 'eszato', 'philip', 'akshat1521', 'rdowdy2', 'rmuryan2', 'gomez14', 'mmenon3', 'skyzzm', 'mudasir', 'beran1', 'zhimin', 'willspringzhang', 'chinvet1', 'gkx39', 'shin65', 'ealmeid2', 'ericcj21', 'johnso49', 'barlaz', 'chen95', 'frost1', 'kikelsey', 'keramat1', 'kocek1', 'shuzhongyou', 'hamburger123', 'karlsino', 'leo19890725', 'drake5', 'cschan3', 'mewyn', 'aviraljain12', 'diablopbc', 'nishsharma', 'squeeksrocks', 'pyropenguinx', 'shao11', 'moruzi1', 'kazi1', 'suyagya', 'megarza2', 'crzftx', 'daiyuan1991', 'jsun31', 'gheimbe2', 'nahsor', 'akusan', 'yc_ng', 'echo781', 'fahim89', 'suchko1', 'komo', 'stacey2', 'forcejedi', 'kurtovi1', 'capota2', 'xu34', 'kejacs', None, 'tgorti', 'hillebr1', 'robert25', 'baruin2', 'ammarfaris', 'pay1', 'kbliu46', 'niyingkan', 'dhruvbhatia7', 'tsteige2', 'bhuiya1', 'lumiao88', 'cjhughes17', 'minxu']"
49,59,10,34,1,['mudasir'],8,"['nishsharma', 'zhong8', 'leo19890725', 'ealmeid2', 'hhkart2001', 'jlee4689', 'kikelsey', 'minxu']",33,"['maheen03', 'abdulmajid123', 'bushrajafri', 'namrah', 'bushara', 'hirashumail', 'ssdlab', 'fehmida', 'marium', 'maliha', 'majidirshad', 'sfb_baig', 'mahhammustafa', 'palwashazafar', 'safia', 'humaira13', 'ayazned', 'hera', 'faaz90', 'kamranasghar', 'shamim', 'wardah', 'sumayya', 'sinlessdev', 'fahadhussain', None, 'taqi', 'mumairsaleem', 'hiraimtiaz', 'fari911', 'syedaamna', 'kanza', 'sadafdilshad']",42,"['maheen03', 'abdulmajid123', 'zhong8', 'leo19890725', 'bushrajafri', 'namrah', 'hhkart2001', 'bushara', 'hirashumail', 'ssdlab', 'nishsharma', 'fehmida', 'marium', 'maliha', 'majidirshad', 'jlee4689', 'sfb_baig', 'mahhammustafa', 'palwashazafar', 'safia', 'humaira13', 'ayazned', 'hera', 'faaz90', 'kamranasghar', 'mudasir', 'shamim', 'wardah', 'sumayya', 'sinlessdev', 'fahadhussain', None, 'taqi', 'mumairsaleem', 'hiraimtiaz', 'fari911', 'ealmeid2', 'syedaamna', 'kanza', 'sadafdilshad', 'kikelsey', 'minxu']"
49,64,10,15,1,['nishsharma'],8,"['zhong8', 'leo19890725', 'ealmeid2', 'mudasir', 'hhkart2001', 'jlee4689', 'kikelsey', 'minxu']",14,"['balistic2', 'karlsino', 'tmurray5', 'trongtong', 'shakamd', 'chinvet1', 'mcarney2', 'foo5', 'cvendi2', 'cheeloh1', 'beaver1128', None, 'swaffor1', 'huilinng']",23,"['balistic2', 'karlsino', 'zhong8', 'leo19890725', 'shakamd', 'mudasir', 'chinvet1', 'hhkart2001', 'beaver1128', 'mcarney2', 'foo5', None, 'huilinng', 'nishsharma', 'trongtong', 'tmurray5', 'ealmeid2', 'jlee4689', 'kikelsey', 'cvendi2', 'cheeloh1', 'minxu', 'swaffor1']"
49,68,10,10,1,['mudasir'],8,"['nishsharma', 'zhong8', 'leo19890725', 'ealmeid2', 'hhkart2001', 'jlee4689', 'kikelsey', 'minxu']",9,"['fehmida', None, 'bushrajafri', 'nimrah', 'taqveen', 'muneebp4', 'anum', 'mahhammustafa', 'palwashazafar']",18,"['zhong8', 'leo19890725', 'bushrajafri', 'nimrah', 'taqveen', 'muneebp4', 'mudasir', 'hhkart2001', None, 'nishsharma', 'fehmida', 'ealmeid2', 'anum', 'jlee4689', 'kikelsey', 'mahhammustafa', 'minxu', 'palwashazafar']"
49,69,10,7,1,['leo19890725'],8,"['nishsharma', 'zhong8', 'ealmeid2', 'mudasir', 'hhkart2001', 'jlee4689', 'kikelsey', 'minxu']",6,"['tbvance', 'sixgallon', 'pao1', 'saima1', 'mkchow5913', None]",15,"['nishsharma', 'zhong8', 'leo19890725', 'ealmeid2', 'tbvance', 'sixgallon', 'mudasir', 'pao1', 'hhkart2001', 'jlee4689', 'kikelsey', 'saima1', 'mkchow5913', 'minxu', None]"
50,149,10,18,6,"['lmcnear', 'acook45', 'enap33', 'preethit', 'ericbudimier', 'mmcguire']",3,"['trevorw', 'antenna2015', 'shortluke']",12,"['nanimurali', 'chimalgi', 'karthik1', 'kranthi431', 'shruthi', 'mahanth_nani', 'mounikakadiyala', 'siu850655168', 'boyapati', 'kpavan425', None, 'uravi']",21,"['nanimurali', 'acook45', 'chimalgi', 'karthik1', 'enap33', 'shruthi', 'preethit', 'antenna2015', 'shortluke', 'boyapati', None, 'uravi', 'lmcnear', 'kranthi431', 'mahanth_nani', 'mounikakadiyala', 'siu850655168', 'trevorw', 'kpavan425', 'ericbudimier', 'mmcguire']"
50,33,10,10,6,"['lmcnear', 'acook45', 'enap33', 'antenna2015', 'ericbudimier', 'mmcguire']",3,"['trevorw', 'preethit', 'shortluke']",4,"['yashvanth86', 'muntahi', 'jus10h', None]",13,"['yashvanth86', 'acook45', 'enap33', 'preethit', 'antenna2015', 'shortluke', 'jus10h', None, 'lmcnear', 'trevorw', 'muntahi', 'ericbudimier', 'mmcguire']"
50,187,10,9,6,"['lmcnear', 'acook45', 'enap33', 'preethit', 'antenna2015', 'mmcguire']",3,"['trevorw', 'ericbudimier', 'shortluke']",3,"['yashvanth86', None, 'jus10h']",12,"['lmcnear', 'yashvanth86', 'jus10h', None, 'acook45', 'enap33', 'preethit', 'antenna2015', 'shortluke', 'trevorw', 'ericbudimier', 'mmcguire']"
50,214,10,8,5,"['acook45', 'enap33', 'preethit', 'ericbudimier', 'mmcguire']",4,"['lmcnear', 'antenna2015', 'trevorw', 'shortluke']",3,"['mahanth_nani', 'muntahi', None]",12,"['lmcnear', None, 'acook45', 'enap33', 'preethit', 'mahanth_nani', 'antenna2015', 'shortluke', 'trevorw', 'muntahi', 'ericbudimier', 'mmcguire']"
51,225,10,12,1,['acalverley'],8,"['seongsin', 'pacej', 'dbros01', 'ewjanitz', 'feifang', 'kllangeland', 'jakehall', 'roshantheengh']",11,"['stokesj', 'jefonseca', 'danbruder', 'glennfife', 'adam921', 'tkubis', 'prusm', 'vermeede', 'lumj', 'diemertim', None]",20,"['stokesj', 'seongsin', 'jefonseca', 'glennfife', 'adam921', 'tkubis', 'vermeede', 'kllangeland', 'jakehall', 'diemertim', None, 'danbruder', 'acalverley', 'pacej', 'dbros01', 'prusm', 'ewjanitz', 'feifang', 'lumj', 'roshantheengh']"
51,224,10,7,3,"['jakehall', 'kllangeland', 'dbros01']",6,"['seongsin', 'acalverley', 'pacej', 'ewjanitz', 'feifang', 'roshantheengh']",4,"['adam921', 'glennfife', 'tkubis', None]",13,"['seongsin', None, 'acalverley', 'glennfife', 'pacej', 'dbros01', 'adam921', 'tkubis', 'ewjanitz', 'feifang', 'kllangeland', 'jakehall', 'roshantheengh']"
52,37,10,116,6,"['nikunjk', 'ededens', 'peterk8', 'ray4', 'liangyaning', 'fthis']",3,"['james414', 'nishitsharma13', 'hamzeh']",110,"['balistic2', 'meagher1', 'eshanso', 'will07c5', 'hipaulshi', 'cheng78', 'horvat1', 'liu141', 'schlude1', 'ren6', 'cardena2', 'bpatzin2', 'lu34', 'rareearth', 'huilinng', 'healy4', 'kim325', 'beugels1', 'trongtong', 'shin34', 'amit13012001', 'shook2', 'photoyub', 'albertczc', 'boehle2', 'cpwalsh2', 'nanto1', 'divito3', 'phoenix_0510', 'scholl1', 'rmuryan2', 'eszato', 'icfmi90', 'jortiz125', 'wicky', 'gomez14', 'mmenon3', 'rishi_ratan', 'chan47', 'skyzzm', 'beran1', 'willspringzhang', 'chinvet1', 'rohanamin', 'chen128', 'felipealonso1', 'shin65', 'crazycai', 'jclee9', 'starring', 'ericcj21', 'johnso49', 'barlaz', 'wrubrec2', 'chen95', 'keramat1', 'kocek1', 'shuzhongyou', 'hamburger123', 'karlsino', 'marchevskiy', 'rmahaja2', 'djtanaka', 'spitula2', 'cschan3', 'skorets2', 'aviraljain12', 'diablopbc', 'tuoliu1', 'lilgoose3', 'squeeksrocks', 'japheth', 'pyropenguinx', 'moruzi1', 'kazi1', 'ragunat1', 'mast5', 'suyagya', 'megarza2', 'cvendi2', 'daiyuan1991', 'nahsor', 'akusan', 'yc_ng', 'uppal1', 'vik579', 'fahim89', 'komo', 'stacey2', 'forcejedi', 'kurtovi1', 'simon6', 'capota2', 'xu34', 'kejacs', None, 'tgorti', 'pay1', 'kbliu46', 'baruin2', 'niyingkan', 'fedorov1', 'faorlando', 'tmurray5', 'bhuiya1', 'tsteige2', 'richers1', 'cjhughes17', 'ambrood', 'robert25']",119,"['balistic2', 'meagher1', 'eshanso', 'will07c5', 'hipaulshi', 'cheng78', 'horvat1', 'liu141', 'schlude1', 'fthis', 'ren6', 'cardena2', 'bpatzin2', 'lu34', 'rareearth', 'huilinng', 'healy4', 'kim325', 'beugels1', 'trongtong', 'ededens', 'shin34', 'amit13012001', 'shook2', 'photoyub', 'albertczc', 'boehle2', 'cpwalsh2', 'nanto1', 'divito3', 'phoenix_0510', 'scholl1', 'rmuryan2', 'eszato', 'icfmi90', 'jortiz125', 'wicky', 'gomez14', 'mmenon3', 'rishi_ratan', 'chan47', 'skyzzm', 'peterk8', 'james414', 'beran1', 'willspringzhang', 'chinvet1', 'rohanamin', 'chen128', 'felipealonso1', 'shin65', 'crazycai', 'jclee9', 'starring', 'ericcj21', 'johnso49', 'barlaz', 'wrubrec2', 'nishitsharma13', 'chen95', 'hamzeh', 'keramat1', 'kocek1', 'shuzhongyou', 'hamburger123', 'karlsino', 'nikunjk', 'marchevskiy', 'rmahaja2', 'djtanaka', 'spitula2', 'cschan3', 'skorets2', 'aviraljain12', 'diablopbc', 'tuoliu1', 'lilgoose3', 'squeeksrocks', 'japheth', 'pyropenguinx', 'moruzi1', 'kazi1', 'ray4', 'ragunat1', 'liangyaning', 'mast5', 'suyagya', 'megarza2', 'cvendi2', 'daiyuan1991', 'nahsor', 'akusan', 'yc_ng', 'uppal1', 'vik579', 'fahim89', 'komo', 'stacey2', 'forcejedi', 'kurtovi1', 'simon6', 'capota2', 'xu34', 'kejacs', None, 'tgorti', 'pay1', 'kbliu46', 'baruin2', 'niyingkan', 'fedorov1', 'faorlando', 'tmurray5', 'bhuiya1', 'tsteige2', 'richers1', 'cjhughes17', 'ambrood', 'robert25']"
52,38,10,17,1,['nishitsharma13'],8,"['nikunjk', 'ededens', 'peterk8', 'james414', 'liangyaning', 'fthis', 'ray4', 'hamzeh']",16,"['balistic2', 'niyingkan', 'tmurray5', None, 'echo781', 'shakamd', 'tmalone3', 'chinvet1', 'crzftx', 'mcarney2', 'foo5', 'drmalkovich', 'cheeloh1', 'beaver1128', 'gheimbe2', 'swaffor1']",25,"['balistic2', 'nikunjk', 'echo781', 'shakamd', 'peterk8', 'james414', 'fthis', 'chinvet1', 'mcarney2', 'foo5', 'drmalkovich', None, 'niyingkan', 'tmurray5', 'ededens', 'nishitsharma13', 'tmalone3', 'ray4', 'liangyaning', 'crzftx', 'hamzeh', 'cheeloh1', 'beaver1128', 'gheimbe2', 'swaffor1']"
53,230,10,29,9,"['jcorrea4', 'jrbeltran', 'mefurth', 'lebaron', 'vross', 'utepee4395dmarellanobuendia', 'pmchavez2', 'jemunoz6', 'jacastorena']",0,[],20,"['dmanerek', 'litapia', 'jacortez04', 'laoliva', 'crodriguez33', 'eidelatorre', 'bhgarcia', 'ejochoa', 'viktorn3lc3', 'osobafemi', 'ee4395brooks', None, 'rbpost', 'lberumen3', 'dalemus', 'javalencia2', 'eopayan', 'nene07', 'smsanchez3', 'drobles4']",29,"['jcorrea4', 'dmanerek', 'utepee4395dmarellanobuendia', 'litapia', 'jacortez04', 'jemunoz6', 'laoliva', 'crodriguez33', 'mefurth', 'vross', 'eidelatorre', 'bhgarcia', 'ejochoa', 'viktorn3lc3', 'lebaron', 'osobafemi', 'ee4395brooks', 'jacastorena', None, 'jrbeltran', 'rbpost', 'lberumen3', 'dalemus', 'javalencia2', 'eopayan', 'pmchavez2', 'nene07', 'smsanchez3', 'drobles4']"
53,180,10,23,8,"['jcorrea4', 'jrbeltran', 'mefurth', 'lebaron', 'utepee4395dmarellanobuendia', 'pmchavez2', 'jemunoz6', 'jacastorena']",1,['vross'],15,"['luisrgamez', 'viktorn3lc3', 'lberumen3', 'dmanerek', 'dalemus', 'nmaxwell', 'ee4395brooks', 'aholivas', 'fernandoa1', 'dgguzman', 'dianeggaytan', 'laoliva', 'lvalles3', None, 'jlflores5']",24,"['jcorrea4', 'dmanerek', 'nmaxwell', 'utepee4395dmarellanobuendia', 'jemunoz6', 'laoliva', 'luisrgamez', 'mefurth', 'vross', 'viktorn3lc3', 'lebaron', 'dianeggaytan', 'ee4395brooks', 'jacastorena', None, 'dgguzman', 'jlflores5', 'jrbeltran', 'lberumen3', 'dalemus', 'aholivas', 'fernandoa1', 'pmchavez2', 'lvalles3']"
53,226,10,18,5,"['mefurth', 'lebaron', 'pmchavez2', 'jemunoz6', 'jacastorena']",4,"['jcorrea4', 'utepee4395dmarellanobuendia', 'jrbeltran', 'vross']",13,"['viktorn3lc3', 'rbpost', 'lberumen3', 'dmanerek', 'dalemus', 'osobafemi', 'fernandoa1', 'eopayan', 'nene07', 'smsanchez3', 'drobles4', None, 'crodriguez33']",22,"['jcorrea4', 'viktorn3lc3', 'dmanerek', 'lebaron', 'utepee4395dmarellanobuendia', 'jemunoz6', 'osobafemi', 'jacastorena', None, 'crodriguez33', 'jrbeltran', 'rbpost', 'mefurth', 'lberumen3', 'dalemus', 'vross', 'fernandoa1', 'eopayan', 'pmchavez2', 'nene07', 'smsanchez3', 'drobles4']"
53,220,10,14,6,"['mefurth', 'lebaron', 'vross', 'pmchavez2', 'jemunoz6', 'jacastorena']",3,"['jcorrea4', 'utepee4395dmarellanobuendia', 'jrbeltran']",8,"[None, 'dalemus', 'israelp', 'fernandoa1', 'lcorral9', 'litapia', 'lvalles3', 'dgguzman']",17,"['jcorrea4', 'lebaron', 'utepee4395dmarellanobuendia', 'lcorral9', 'litapia', 'jemunoz6', 'jacastorena', 'dgguzman', None, 'jrbeltran', 'mefurth', 'dalemus', 'israelp', 'vross', 'fernandoa1', 'pmchavez2', 'lvalles3']"
53,221,10,14,9,"['jcorrea4', 'jrbeltran', 'mefurth', 'lebaron', 'vross', 'utepee4395dmarellanobuendia', 'pmchavez2', 'jemunoz6', 'jacastorena']",0,[],5,"['dalemus', 'eidelatorre', 'fernandoa1', 'litapia', None]",14,"['jcorrea4', 'lebaron', 'utepee4395dmarellanobuendia', 'litapia', 'jemunoz6', 'jacastorena', None, 'jrbeltran', 'mefurth', 'dalemus', 'vross', 'eidelatorre', 'fernandoa1', 'pmchavez2']"
54,153,9,10,8,"['matthom', 'vicray', 'blondeteam', 'oz006', 'ctachon', 'fguitard', 'mgarnier', 'javier_v27']",0,[],2,"['costinanghel', None]",10,"['matthom', 'vicray', None, 'blondeteam', 'oz006', 'ctachon', 'fguitard', 'mgarnier', 'costinanghel', 'javier_v27']"
55,59,9,34,5,"['humaira13', 'marium', 'ayazned', 'hera', 'shamim']",3,"['alkamid', 'wilphys', 'mauderl']",29,"['maheen03', 'abdulmajid123', 'bushrajafri', 'namrah', 'bushara', 'hirashumail', 'ssdlab', 'fehmida', 'maliha', 'majidirshad', 'sfb_baig', 'mahhammustafa', 'palwashazafar', 'safia', 'faaz90', 'kamranasghar', 'mudasir', 'wardah', 'sumayya', 'sinlessdev', 'fahadhussain', None, 'taqi', 'mumairsaleem', 'hiraimtiaz', 'fari911', 'syedaamna', 'kanza', 'sadafdilshad']",37,"['maheen03', 'abdulmajid123', 'bushrajafri', 'namrah', 'bushara', 'hirashumail', 'ssdlab', 'fehmida', 'marium', 'maliha', 'wilphys', 'majidirshad', 'sfb_baig', 'mahhammustafa', 'palwashazafar', 'alkamid', 'humaira13', 'safia', 'ayazned', 'hera', 'faaz90', 'kamranasghar', 'mudasir', 'shamim', 'wardah', 'sumayya', 'sinlessdev', 'fahadhussain', None, 'taqi', 'mumairsaleem', 'hiraimtiaz', 'fari911', 'syedaamna', 'kanza', 'sadafdilshad', 'mauderl']"
57,63,9,24,1,['spribble'],7,"['tkrenik', 'dansteingart', 'yogyatamehan', 'perfecktionist', 'cschaus', 'robins6876', 'wannabee1989']",23,"['will07c5', 'nbauer087', 'jackwenner', 'knuts003', 'thom0876', 'cbahr2005', 'maoshouse', 'stoddar1', 'gnarlytoast', 'divito3', 'icfmi90', 'geneyu2', 'chan47', 'silver104', 'jmarti', 'gnarly_dana', None, 'crazycai', 'cthayer3', 'tonyli1', 'willg001', 'chrisowens', 'aneavil2']",31,"['will07c5', 'nbauer087', 'yogyatamehan', 'jackwenner', 'knuts003', 'thom0876', 'cbahr2005', 'cschaus', 'maoshouse', 'wannabee1989', 'stoddar1', 'gnarlytoast', 'divito3', 'tkrenik', 'icfmi90', 'geneyu2', 'chan47', 'silver104', 'jmarti', 'gnarly_dana', None, 'spribble', 'crazycai', 'dansteingart', 'cthayer3', 'perfecktionist', 'tonyli1', 'willg001', 'robins6876', 'chrisowens', 'aneavil2']"
60,177,8,16,7,"['cbowland', 'bpetersen', 'aklarner', 'jjustic6', 'ttoll', 'joduor2', 'awomac2']",0,[],9,"['spacepope58', 'arcwing1', 'mhmielew', 'hpembert', 'jhamil33', 'houstdycus', 'manuelcarlo', None, 'alowden']",16,"['cbowland', 'spacepope58', 'arcwing1', 'alowden', 'houstdycus', 'jjustic6', 'ttoll', 'joduor2', 'manuelcarlo', None, 'aklarner', 'bpetersen', 'mhmielew', 'hpembert', 'jhamil33', 'awomac2']"
60,167,8,13,7,"['cbowland', 'bpetersen', 'aklarner', 'jjustic6', 'ttoll', 'joduor2', 'awomac2']",0,[],6,"['mhmielew', 'hpembert', 'jhamil33', 'lpoland1', None, 'cosborn4']",13,"['cbowland', 'jjustic6', 'ttoll', 'joduor2', None, 'cosborn4', 'aklarner', 'bpetersen', 'mhmielew', 'hpembert', 'jhamil33', 'lpoland1', 'awomac2']"
60,218,8,12,7,"['cbowland', 'bpetersen', 'aklarner', 'jjustic6', 'ttoll', 'joduor2', 'awomac2']",0,[],5,"['hpembert', 'jhamil33', 'lpoland1', None, 'cosborn4']",12,"['cbowland', 'jjustic6', 'ttoll', 'joduor2', None, 'cosborn4', 'aklarner', 'bpetersen', 'hpembert', 'jhamil33', 'lpoland1', 'awomac2']"
61,169,8,25,7,"['pmushenh', 'hubler2', 'tmfowler', 'aczapar', 'yasamana', 'thnguyn2', 'crablau01']",0,[],18,"['paritoshpande', 'vegawhi1', 'somikae1', 'rajtarun', 'urraliu', 'huangp02', 'lee893', 'gwu', 'wenyenwu', 'rlblackm', 'v0vela01', 'leeau', 'uasyed2', 'hadiyah', None, 'kaje83', 'ludovic', 'sprab001']",25,"['paritoshpande', 'hubler2', 'rlblackm', 'leeau', 'crablau01', 'kaje83', 'somikae1', 'rajtarun', 'urraliu', 'aczapar', 'huangp02', 'yasamana', 'v0vela01', 'uasyed2', 'hadiyah', 'pmushenh', 'lee893', 'thnguyn2', None, 'sprab001', 'vegawhi1', 'tmfowler', 'gwu', 'ludovic', 'wenyenwu']"
61,156,8,17,7,"['pmushenh', 'hubler2', 'tmfowler', 'aczapar', 'yasamana', 'thnguyn2', 'crablau01']",0,[],10,"['somikae1', 'rajtarun', 'urraliu', 'gwu', 'sprab001', 'rlblackm', 'v0vela01', 'leeau', None, 'wenyenwu']",17,"['pmushenh', 'hubler2', 'rlblackm', 'leeau', 'thnguyn2', 'crablau01', None, 'sprab001', 'somikae1', 'rajtarun', 'tmfowler', 'urraliu', 'aczapar', 'gwu', 'yasamana', 'v0vela01', 'wenyenwu']"
61,161,8,15,7,"['pmushenh', 'hubler2', 'tmfowler', 'aczapar', 'yasamana', 'thnguyn2', 'crablau01']",0,[],8,"['somikae1', 'rajtarun', 'urraliu', 'sprab001', 'v0vela01', 'leeau', None, 'wenyenwu']",15,"['pmushenh', 'hubler2', 'leeau', 'thnguyn2', 'crablau01', None, 'sprab001', 'somikae1', 'rajtarun', 'tmfowler', 'urraliu', 'aczapar', 'yasamana', 'v0vela01', 'wenyenwu']"
62,28,8,11,4,"['albridge', 'rsells', 'nikko2385', 'jyuan']",3,"['baker36', 'guy1981', 'jones65']",7,"['jonesrr', None, 'scotte', 'zkoch', 'kdwalton', 'mreuter', 'mbruhn']",14,"['jonesrr', 'rsells', 'zkoch', 'kdwalton', 'nikko2385', 'mreuter', None, 'baker36', 'jyuan', 'scotte', 'jones65', 'albridge', 'mbruhn', 'guy1981']"
64,44,8,14,7,"['amrita13', 'amrita7', 'amrita12', 'amrita10', 'amrita11', 'amrita8', 'amrita9']",0,[],7,"['amrita6', 'amrita2', 'amrita4', 'amrita5', 'amrita1', 'amrita3', None]",14,"['amrita7', 'amrita6', 'amrita5', 'amrita1', 'amrita3', None, 'amrita12', 'amrita9', 'amrita13', 'amrita10', 'amrita2', 'amrita4', 'amrita11', 'amrita8']"
64,45,8,14,7,"['amrita13', 'amrita7', 'amrita12', 'amrita10', 'amrita11', 'amrita8', 'amrita9']",0,[],7,"['amrita6', 'amrita2', 'amrita4', 'amrita1', 'amrita5', 'amrita3', None]",14,"['amrita7', 'amrita6', 'amrita1', 'amrita5', 'amrita3', None, 'amrita12', 'amrita9', 'amrita13', 'amrita10', 'amrita2', 'amrita4', 'amrita11', 'amrita8']"
64,46,8,9,2,"['amrita7', 'amrita8']",5,"['amrita13', 'amrita10', 'amrita9', 'amrita11', 'amrita12']",7,"['amrita6', 'amrita2', 'amrita4', 'amrita5', 'amrita1', 'amrita3', None]",14,"['amrita7', 'amrita6', 'amrita5', 'amrita1', 'amrita3', None, 'amrita12', 'amrita9', 'amrita13', 'amrita10', 'amrita2', 'amrita4', 'amrita11', 'amrita8']"
67,14,8,14,2,"['ziyunlong', 'mstone56']",5,"['mengren', 'charleshages', 'sheetse', 'ajrobiso', 'eblount']",12,"['vedpragyan', 'msharad', 'lin180', 'glowzbd', 'hsohail', 'brianlew', 'shwet', 'chandrar88', 'heyu07', 'leedj111', 'qianw', None]",19,"['mengren', 'vedpragyan', 'ziyunlong', 'glowzbd', 'brianlew', 'ajrobiso', 'mstone56', 'eblount', 'chandrar88', 'heyu07', 'leedj111', None, 'charleshages', 'msharad', 'sheetse', 'lin180', 'hsohail', 'shwet', 'qianw']"
67,120,8,14,1,['mstone56'],6,"['mengren', 'charleshages', 'sheetse', 'ziyunlong', 'ajrobiso', 'eblount']",13,"['msharad', 'lin180', 'glowzbd', 'brianlew', 'hsohail', 'hsu21', 'teadams30', 'zhang581', 'alicejou6733', 'leedj111', 'qianw', 'kbrew', None]",20,"['mengren', 'ziyunlong', 'glowzbd', 'brianlew', 'ajrobiso', 'mstone56', 'eblount', 'hsu21', 'alicejou6733', 'leedj111', None, 'charleshages', 'msharad', 'sheetse', 'lin180', 'hsohail', 'teadams30', 'zhang581', 'qianw', 'kbrew']"
67,6,8,12,3,"['ziyunlong', 'charleshages', 'mstone56']",4,"['mengren', 'ajrobiso', 'eblount', 'sheetse']",9,"['vedpragyan', 'msharad', 'glowzbd', 'brianlew', 'shwet', 'kaimiao', 'heyu07', 'qianw', None]",16,"['mengren', 'vedpragyan', 'ziyunlong', 'glowzbd', 'brianlew', 'ajrobiso', 'mstone56', 'eblount', 'kaimiao', 'heyu07', None, 'charleshages', 'msharad', 'sheetse', 'shwet', 'qianw']"
67,121,8,6,1,['sheetse'],6,"['mengren', 'charleshages', 'ziyunlong', 'ajrobiso', 'mstone56', 'eblount']",5,"['vedpragyan', 'ajagadee', 'hsohail', 'teadams30', None]",12,"['mengren', 'charleshages', 'vedpragyan', 'ajagadee', 'sheetse', 'ziyunlong', 'hsohail', 'ajrobiso', 'mstone56', 'eblount', 'teadams30', None]"
68,47,7,45,3,"['akashmvp', 'adamcalli', 'bjankuna']",3,"['clozakitr', 'tinoblas', 'electroguy02']",42,"['aalduwee', 'mawismail', 'vasileska', 'ryansterbenz', 'ddpressl', 'kdriggsc', 'cschuldt', 'sminter', 'rgdaniel', 'bgall', 'stevenlimpert', '9mmlow', 'ali_obeid89', 'amykk0503', 'daerhart', 'nehalem650', 'srshacke', 'boselio1', 'bsheffie', 'hnajafi1', 'spfoster', 'hchung91', 'klarosa', 'jwang117', 'sstowe', 'duffy', 'geminemi', 'dabeyta', 'tkmooney1', 'amenicos', 'acorona', None, 'rmfoss', 'nssabbah', 'bick1234', 'isaacaa21', 'qyan5', 'ntbui1', 'mynameiskory', 'jrruggie', 'treblitz', 'ferry']",48,"['aalduwee', 'mawismail', 'vasileska', 'ryansterbenz', 'ddpressl', 'kdriggsc', 'electroguy02', 'adamcalli', 'cschuldt', 'sminter', 'akashmvp', 'rgdaniel', 'stevenlimpert', 'clozakitr', '9mmlow', 'ali_obeid89', 'amykk0503', 'bjankuna', 'daerhart', 'nehalem650', 'srshacke', 'boselio1', 'bsheffie', 'hnajafi1', 'spfoster', 'hchung91', 'klarosa', 'jwang117', 'sstowe', 'duffy', 'geminemi', 'dabeyta', 'tkmooney1', 'amenicos', 'acorona', None, 'rmfoss', 'nssabbah', 'bick1234', 'tinoblas', 'jrruggie', 'isaacaa21', 'qyan5', 'ntbui1', 'mynameiskory', 'bgall', 'treblitz', 'ferry']"
68,5,7,43,6,"['clozakitr', 'tinoblas', 'electroguy02', 'adamcalli', 'akashmvp', 'bjankuna']",0,[],37,"['aalduwee', 'mawismail', 'jakaye', 'ryansterbenz', 'kdriggsc', 'ddpressl', 'cschuldt', 'sminter', 'stevenlimpert', '9mmlow', 'daerhart', 'srshacke', 'boselio1', 'bsheffie', 'spfoster', 'hchung91', 'klarosa', 'jwang117', 'sstowe', 'duffy', 'geminemi', 'dabeyta', 'tkmooney1', 'amenicos', 'acorona', None, 'rmfoss', 'nssabbah', 'matthewburesh', 'bick1234', 'isaacaa21', 'qyan5', 'ntbui1', 'mynameiskory', 'jrruggie', 'treblitz', 'ferry']",43,"['aalduwee', 'mawismail', 'jakaye', 'ryansterbenz', 'kdriggsc', 'ddpressl', 'electroguy02', 'adamcalli', 'cschuldt', 'sminter', 'akashmvp', 'stevenlimpert', 'clozakitr', '9mmlow', 'bjankuna', 'daerhart', 'srshacke', 'boselio1', 'bsheffie', 'spfoster', 'hchung91', 'klarosa', 'jwang117', 'sstowe', 'duffy', 'geminemi', 'dabeyta', 'tkmooney1', 'amenicos', 'acorona', None, 'rmfoss', 'nssabbah', 'matthewburesh', 'bick1234', 'tinoblas', 'isaacaa21', 'qyan5', 'ntbui1', 'mynameiskory', 'jrruggie', 'treblitz', 'ferry']"
68,105,7,40,6,"['clozakitr', 'tinoblas', 'electroguy02', 'adamcalli', 'akashmvp', 'bjankuna']",0,[],34,"['aalduwee', 'mawismail', 'ryansterbenz', 'kdriggsc', 'ddpressl', 'cschuldt', 'sminter', 'rgdaniel', 'bgall', 'ali_obeid89', 'boselio1', 'hnajafi1', 'spfoster', 'hchung91', 'klarosa', 'sstowe', 'duffy', 'geminemi', 'dabeyta', 'tkmooney1', 'amenicos', 'acorona', None, 'rmfoss', 'nssabbah', 'matthewburesh', 'bick1234', 'ricagalvan', 'isaacaa21', 'qyan5', 'ntbui1', 'mynameiskory', 'jrruggie', 'treblitz']",40,"['aalduwee', 'mawismail', 'ryansterbenz', 'kdriggsc', 'ddpressl', 'electroguy02', 'adamcalli', 'cschuldt', 'sminter', 'akashmvp', 'rgdaniel', 'clozakitr', 'ali_obeid89', 'bjankuna', 'boselio1', 'hnajafi1', 'spfoster', 'hchung91', 'klarosa', 'sstowe', 'duffy', 'geminemi', 'dabeyta', 'tkmooney1', 'amenicos', 'acorona', None, 'rmfoss', 'nssabbah', 'matthewburesh', 'bick1234', 'tinoblas', 'ricagalvan', 'jrruggie', 'isaacaa21', 'qyan5', 'ntbui1', 'mynameiskory', 'bgall', 'treblitz']"
68,122,7,39,5,"['clozakitr', 'tinoblas', 'electroguy02', 'akashmvp', 'bjankuna']",1,['adamcalli'],34,"['aalduwee', 'ryansterbenz', 'kdriggsc', 'ddpressl', 'cschuldt', 'sminter', 'rgdaniel', 'bgall', 'stevenlimpert', 'ali_obeid89', 'daerhart', 'srshacke', 'boselio1', 'hnajafi1', 'hchung91', 'klarosa', 'jwang117', 'sstowe', 'duffy', 'amenicos', 'dabeyta', 'tkmooney1', None, 'acorona', 'rmfoss', 'matthewburesh', 'bick1234', 'isaacaa21', 'qyan5', 'ntbui1', 'mynameiskory', 'jrruggie', 'treblitz', 'ferry']",40,"['aalduwee', 'ryansterbenz', 'kdriggsc', 'ddpressl', 'electroguy02', 'adamcalli', 'cschuldt', 'sminter', 'akashmvp', 'rgdaniel', 'stevenlimpert', 'clozakitr', 'ali_obeid89', 'bjankuna', 'daerhart', 'srshacke', 'boselio1', 'hnajafi1', 'hchung91', 'klarosa', 'jwang117', 'sstowe', 'duffy', 'amenicos', 'dabeyta', 'tkmooney1', None, 'acorona', 'rmfoss', 'matthewburesh', 'bick1234', 'tinoblas', 'jrruggie', 'isaacaa21', 'qyan5', 'ntbui1', 'mynameiskory', 'bgall', 'treblitz', 'ferry']"
68,174,7,35,1,['akashmvp'],5,"['clozakitr', 'tinoblas', 'electroguy02', 'adamcalli', 'bjankuna']",34,"['aalduwee', 'vasileska', 'kdriggsc', 'ddpressl', 'cschuldt', 'sminter', 'rgdaniel', 'bgall', 'ali_obeid89', 'daerhart', 'boselio1', 'hnajafi1', 'hchung91', 'klarosa', 'jwang117', 'sstowe', 'duffy', 'geminemi', 'tkmooney1', 'dabeyta', 'amenicos', 'acorona', None, 'rmfoss', 'nssabbah', 'matthewburesh', 'bick1234', 'ricagalvan', 'isaacaa21', 'qyan5', 'ntbui1', 'mynameiskory', 'jrruggie', 'treblitz']",40,"['aalduwee', 'vasileska', 'kdriggsc', 'ddpressl', 'electroguy02', 'adamcalli', 'cschuldt', 'sminter', 'akashmvp', 'rgdaniel', 'clozakitr', 'ali_obeid89', 'bjankuna', 'daerhart', 'boselio1', 'hnajafi1', 'hchung91', 'klarosa', 'jwang117', 'sstowe', 'duffy', 'geminemi', 'tkmooney1', 'dabeyta', 'amenicos', 'acorona', None, 'rmfoss', 'nssabbah', 'matthewburesh', 'bick1234', 'tinoblas', 'ricagalvan', 'jrruggie', 'isaacaa21', 'qyan5', 'ntbui1', 'mynameiskory', 'bgall', 'treblitz']"
68,125,7,34,5,"['tinoblas', 'electroguy02', 'adamcalli', 'akashmvp', 'bjankuna']",1,['clozakitr'],29,"['aalduwee', 'mawismail', 'jakaye', 'ryansterbenz', 'ddpressl', 'cschuldt', 'sminter', 'stevenlimpert', '9mmlow', 'daerhart', 'boselio1', 'hchung91', 'sstowe', 'duffy', 'geminemi', 'tkmooney1', 'dabeyta', 'amenicos', 'acorona', None, 'nssabbah', 'jwister', 'matthewburesh', 'bick1234', 'qyan5', 'mynameiskory', 'jrruggie', 'treblitz', 'ferry']",35,"['aalduwee', 'mawismail', 'jakaye', 'ryansterbenz', 'ddpressl', 'electroguy02', 'adamcalli', 'cschuldt', 'sminter', 'akashmvp', 'stevenlimpert', 'clozakitr', '9mmlow', 'bjankuna', 'daerhart', 'boselio1', 'hchung91', 'sstowe', 'duffy', 'geminemi', 'tkmooney1', 'dabeyta', 'amenicos', 'acorona', None, 'nssabbah', 'jwister', 'matthewburesh', 'bick1234', 'tinoblas', 'qyan5', 'mynameiskory', 'jrruggie', 'treblitz', 'ferry']"
68,196,7,34,4,"['bjankuna', 'tinoblas', 'electroguy02', 'adamcalli']",2,"['clozakitr', 'akashmvp']",30,"['mawismail', 'jakaye', 'ryansterbenz', 'kdriggsc', 'ddpressl', 'cschuldt', 'sminter', '9mmlow', 'ali_obeid89', 'daerhart', 'nehalem650', 'boselio1', 'spfoster', 'hchung91', 'jwang117', 'sstowe', 'duffy', 'geminemi', 'tkmooney1', 'amenicos', None, 'acorona', 'rmfoss', 'jwister', 'matthewburesh', 'bick1234', 'isaacaa21', 'qyan5', 'ntbui1', 'mynameiskory']",36,"['mawismail', 'jakaye', 'ryansterbenz', 'kdriggsc', 'ddpressl', 'electroguy02', 'adamcalli', 'cschuldt', 'sminter', 'akashmvp', 'clozakitr', '9mmlow', 'ali_obeid89', 'bjankuna', 'daerhart', 'nehalem650', 'boselio1', 'spfoster', 'hchung91', 'jwang117', 'sstowe', 'duffy', 'geminemi', 'tkmooney1', 'amenicos', None, 'acorona', 'rmfoss', 'jwister', 'matthewburesh', 'bick1234', 'tinoblas', 'isaacaa21', 'qyan5', 'ntbui1', 'mynameiskory']"
68,78,7,33,3,"['akashmvp', 'adamcalli', 'bjankuna']",3,"['clozakitr', 'tinoblas', 'electroguy02']",30,"['aalduwee', 'mawismail', 'jakaye', 'ryansterbenz', 'kdriggsc', 'ddpressl', 'sminter', 'stevenlimpert', 'ali_obeid89', 'amykk0503', 'daerhart', 'srshacke', 'boselio1', 'spfoster', 'hchung91', 'sstowe', 'duffy', 'geminemi', 'tkmooney1', 'dabeyta', 'amenicos', 'acorona', None, 'nssabbah', 'bick1234', 'qyan5', 'mynameiskory', 'jrruggie', 'treblitz', 'ferry']",36,"['aalduwee', 'mawismail', 'jakaye', 'ryansterbenz', 'kdriggsc', 'ddpressl', 'electroguy02', 'adamcalli', 'sminter', 'akashmvp', 'stevenlimpert', 'clozakitr', 'ali_obeid89', 'amykk0503', 'bjankuna', 'daerhart', 'srshacke', 'boselio1', 'spfoster', 'hchung91', 'sstowe', 'duffy', 'geminemi', 'tkmooney1', 'dabeyta', 'amenicos', 'acorona', None, 'nssabbah', 'bick1234', 'tinoblas', 'qyan5', 'mynameiskory', 'jrruggie', 'treblitz', 'ferry']"
68,12,7,31,5,"['tinoblas', 'electroguy02', 'adamcalli', 'akashmvp', 'bjankuna']",1,['clozakitr'],26,"['aalduwee', 'bsheffie', 'mawismail', 'ryansterbenz', 'kdriggsc', 'ddpressl', 'ferry', 'jwang117', 'cschuldt', 'sstowe', 'sminter', 'amenicos', None, 'dabeyta', 'stevenlimpert', 'tkmooney1', 'nssabbah', 'matthewburesh', '9mmlow', 'bick1234', 'qyan5', 'daerhart', 'mynameiskory', 'jrruggie', 'treblitz', 'boselio1']",32,"['aalduwee', 'mawismail', 'ryansterbenz', 'kdriggsc', 'ddpressl', 'electroguy02', 'adamcalli', 'cschuldt', 'sminter', 'akashmvp', 'stevenlimpert', 'clozakitr', '9mmlow', 'bjankuna', 'daerhart', 'boselio1', 'bsheffie', 'jwang117', 'sstowe', 'amenicos', None, 'dabeyta', 'tkmooney1', 'nssabbah', 'matthewburesh', 'bick1234', 'tinoblas', 'qyan5', 'mynameiskory', 'jrruggie', 'treblitz', 'ferry']"
68,183,7,29,5,"['tinoblas', 'electroguy02', 'adamcalli', 'akashmvp', 'bjankuna']",1,['clozakitr'],24,"['mawismail', 'jakaye', 'ryansterbenz', 'kdriggsc', 'ddpressl', 'spfoster', 'hchung91', 'jwang117', 'duffy', 'sminter', 'geminemi', None, 'tkmooney1', 'dabeyta', 'acorona', 'matthewburesh', '9mmlow', 'bick1234', 'qyan5', 'daerhart', 'ntbui1', 'bgall', 'treblitz', 'srshacke']",30,"['mawismail', 'jakaye', 'ryansterbenz', 'kdriggsc', 'ddpressl', 'electroguy02', 'adamcalli', 'sminter', 'akashmvp', 'clozakitr', '9mmlow', 'bjankuna', 'daerhart', 'srshacke', 'spfoster', 'hchung91', 'jwang117', 'duffy', 'geminemi', None, 'tkmooney1', 'dabeyta', 'acorona', 'matthewburesh', 'bick1234', 'tinoblas', 'qyan5', 'ntbui1', 'bgall', 'treblitz']"
68,130,7,27,5,"['tinoblas', 'electroguy02', 'adamcalli', 'akashmvp', 'bjankuna']",1,['clozakitr'],22,"['mawismail', 'jakaye', 'kdriggsc', 'ddpressl', 'sminter', '9mmlow', 'boselio1', 'srshacke', 'spfoster', 'hchung91', 'jwang117', 'duffy', 'geminemi', None, 'dabeyta', 'tkmooney1', 'acorona', 'matthewburesh', 'bick1234', 'qyan5', 'bgall', 'treblitz']",28,"['mawismail', 'jakaye', 'kdriggsc', 'ddpressl', 'electroguy02', 'adamcalli', 'sminter', 'akashmvp', 'clozakitr', '9mmlow', 'bjankuna', 'srshacke', 'boselio1', 'spfoster', 'hchung91', 'jwang117', 'duffy', 'geminemi', 'tkmooney1', None, 'dabeyta', 'acorona', 'matthewburesh', 'bick1234', 'tinoblas', 'qyan5', 'bgall', 'treblitz']"
68,1,7,24,6,"['clozakitr', 'tinoblas', 'electroguy02', 'adamcalli', 'akashmvp', 'bjankuna']",0,[],18,"['bsheffie', 'mawismail', 'rmfoss', 'jakaye', 'ryansterbenz', 'ferry', '9mmlow', 'bick1234', 'srshacke', 'isaacaa21', 'qyan5', 'daerhart', 'ntbui1', 'nehalem650', 'amenicos', None, 'stevenlimpert', 'boselio1']",24,"['bsheffie', 'mawismail', 'jakaye', 'ryansterbenz', 'ferry', 'electroguy02', 'adamcalli', 'akashmvp', 'amenicos', None, 'stevenlimpert', 'rmfoss', 'clozakitr', '9mmlow', 'tinoblas', 'bick1234', 'srshacke', 'isaacaa21', 'qyan5', 'bjankuna', 'daerhart', 'nehalem650', 'ntbui1', 'boselio1']"
68,3,7,24,4,"['bjankuna', 'tinoblas', 'electroguy02', 'adamcalli']",2,"['clozakitr', 'akashmvp']",20,"['mawismail', 'jakaye', 'kdriggsc', 'ddpressl', 'cschuldt', '9mmlow', 'daerhart', 'boselio1', 'bsheffie', 'spfoster', 'sstowe', 'amenicos', 'geminemi', None, 'acorona', 'matthewburesh', 'bick1234', 'isaacaa21', 'ntbui1', 'mynameiskory']",26,"['bsheffie', 'mawismail', 'jakaye', 'kdriggsc', 'spfoster', 'ddpressl', 'electroguy02', 'adamcalli', 'sstowe', 'cschuldt', 'akashmvp', 'geminemi', 'amenicos', None, 'acorona', 'matthewburesh', 'clozakitr', '9mmlow', 'tinoblas', 'bick1234', 'isaacaa21', 'bjankuna', 'daerhart', 'ntbui1', 'mynameiskory', 'boselio1']"
68,248,7,16,1,['bjankuna'],5,"['clozakitr', 'tinoblas', 'electroguy02', 'adamcalli', 'akashmvp']",15,"['mawismail', None, 'dabeyta', 'ryansterbenz', 'spfoster', 'ddpressl', 'ali_obeid89', 'bick1234', 'jwang117', 'duffy', 'sminter', 'qyan5', 'nehalem650', 'tkmooney1', 'acorona']",21,"['mawismail', 'ryansterbenz', 'spfoster', 'ddpressl', 'electroguy02', 'adamcalli', 'jwang117', 'duffy', 'sminter', 'akashmvp', 'tkmooney1', None, 'dabeyta', 'acorona', 'clozakitr', 'ali_obeid89', 'tinoblas', 'bick1234', 'qyan5', 'bjankuna', 'nehalem650']"
68,2,7,15,1,['adamcalli'],5,"['clozakitr', 'tinoblas', 'electroguy02', 'akashmvp', 'bjankuna']",14,"['bsheffie', 'rmfoss', None, 'jakaye', 'klarosa', 'jwister', '9mmlow', 'srshacke', 'daerhart', 'amenicos', 'jrruggie', 'treblitz', 'stevenlimpert', 'ferry']",20,"['bsheffie', 'jakaye', 'klarosa', 'electroguy02', 'adamcalli', 'akashmvp', 'amenicos', None, 'stevenlimpert', 'rmfoss', 'jwister', 'clozakitr', '9mmlow', 'tinoblas', 'srshacke', 'bjankuna', 'daerhart', 'jrruggie', 'treblitz', 'ferry']"
68,9,7,10,1,['clozakitr'],5,"['tinoblas', 'electroguy02', 'adamcalli', 'akashmvp', 'bjankuna']",9,"['msharad', 'mynameiskory', 'hsohail', 'kevecan', 'anandakumar', 'teadams30', 'rgdaniel', None, 'ferry']",15,"['kevecan', 'electroguy02', 'adamcalli', 'akashmvp', 'rgdaniel', None, 'msharad', 'clozakitr', 'hsohail', 'tinoblas', 'anandakumar', 'teadams30', 'bjankuna', 'mynameiskory', 'ferry']"
68,123,7,8,4,"['clozakitr', 'tinoblas', 'electroguy02', 'bjankuna']",2,"['akashmvp', 'adamcalli']",4,"['rmfoss', None, 'stevenlimpert', 'ferry']",10,"['rmfoss', 'clozakitr', 'tinoblas', 'electroguy02', 'adamcalli', 'akashmvp', 'bjankuna', None, 'stevenlimpert', 'ferry']"
70,146,7,11,1,['yanuo'],5,"['wgriffin', 'victorct', 'intrimind', 'sathya85', 'cinzia']",10,"[None, 'consciousgaze', 'sanau', 'fatjon', 'mokay006', 'waqas86', 'sinanag', 'm_maziar', 'dvenkt', 'sathya713']",16,"['wgriffin', 'sathya85', 'mokay006', 'm_maziar', 'yanuo', None, 'sanau', 'cinzia', 'consciousgaze', 'victorct', 'intrimind', 'fatjon', 'waqas86', 'sinanag', 'dvenkt', 'sathya713']"
70,147,7,6,2,"['sathya85', 'yanuo']",4,"['victorct', 'wgriffin', 'intrimind', 'cinzia']",4,"['vickey', None, 'sathya713', 'consciousgaze']",10,"['vickey', 'wgriffin', 'consciousgaze', 'victorct', 'intrimind', 'sathya85', 'yanuo', None, 'sathya713', 'cinzia']"
72,269,7,11,5,"['jcledfo2', 'greengiant208', 'amleszcz', 'mvlanzon', 'jhlardo']",1,['gustavogimenez'],6,"['mhuang3', 'jihardy2', 'hlee19', 'dtminsk', 'kowhite', None]",12,"['mhuang3', 'jcledfo2', 'jihardy2', 'hlee19', 'dtminsk', 'mvlanzon', None, 'jhlardo', 'gustavogimenez', 'kowhite', 'greengiant208', 'amleszcz']"
74,71,7,8,6,"['thatyferreira', 'laluiza', 'gelbe', 'gabiautran', 'rodrigog', 'kibecsp']",0,[],2,"['singulani', None]",8,"['singulani', 'thatyferreira', 'laluiza', 'gelbe', 'gabiautran', 'rodrigog', 'kibecsp', None]"
74,155,7,8,6,"['thatyferreira', 'laluiza', 'gelbe', 'gabiautran', 'rodrigog', 'kibecsp']",0,[],2,"['singulani', None]",8,"['singulani', 'thatyferreira', 'laluiza', 'gelbe', 'gabiautran', 'rodrigog', 'kibecsp', None]"
74,217,7,8,6,"['thatyferreira', 'laluiza', 'gelbe', 'gabiautran', 'rodrigog', 'kibecsp']",0,[],2,"['singulani', None]",8,"['singulani', 'thatyferreira', 'laluiza', 'gelbe', 'gabiautran', 'rodrigog', 'kibecsp', None]"
75,169,7,25,5,"['paritoshpande', 'vegawhi1', 'huangp02', 'hadiyah', 'kaje83']",1,['qianli'],20,"['hubler2', 'rlblackm', 'leeau', 'crablau01', 'somikae1', 'rajtarun', 'urraliu', 'aczapar', 'yasamana', 'v0vela01', 'uasyed2', 'pmushenh', 'lee893', 'thnguyn2', None, 'sprab001', 'tmfowler', 'gwu', 'ludovic', 'wenyenwu']",26,"['paritoshpande', 'pmushenh', 'hubler2', 'lee893', 'qianli', 'rlblackm', 'leeau', None, 'kaje83', 'crablau01', 'thnguyn2', 'sprab001', 'vegawhi1', 'somikae1', 'rajtarun', 'tmfowler', 'huangp02', 'urraliu', 'aczapar', 'gwu', 'yasamana', 'v0vela01', 'hadiyah', 'uasyed2', 'ludovic', 'wenyenwu']"
77,175,7,23,5,"['kys86', 'ysmmsy', 'liyanage777', 'helencxy', 'marjana']",1,['solfreer'],18,"['femto', 'ajain88', 'aryan88', 'clee58', 'chovic99', 'yuanze_2008', 'pqbdco', 'dsukhdeo', 'sagerke', 'yesheng', 'cyahn', 'vijayp', 'archana256', 'wanghan', 'meiyueht', 'ivyluo', 'jjean', None]",24,"['femto', 'ajain88', 'ysmmsy', 'clee58', 'chovic99', 'yuanze_2008', 'pqbdco', 'dsukhdeo', 'vijayp', 'wanghan', 'ivyluo', 'yesheng', 'aryan88', 'jjean', None, 'kys86', 'sagerke', 'cyahn', 'liyanage777', 'helencxy', 'solfreer', 'meiyueht', 'marjana', 'archana256']"
77,176,7,23,1,['solfreer'],5,"['kys86', 'ysmmsy', 'liyanage777', 'helencxy', 'marjana']",22,"['zjali9889', 'dingni529', 'henryyang', 'mgautam', 'wzhlove2003', 'z3246932', 'rachponkalra', 'chicheng', 'ysrrcool', 'andreamorello', 'ruoxiyang', 'hanyufeng', 'z3286385', 'kushal_das', 'alexb', 'ka2552001', None, 'chnpp', 'z3323355', 'songyanfan', 'tuyu1988', 'happyhome1025']",28,"['zjali9889', 'ruoxiyang', 'ysmmsy', 'hanyufeng', 'dingni529', 'z3286385', 'kushal_das', 'henryyang', 'alexb', 'mgautam', 'wzhlove2003', 'ka2552001', None, 'z3246932', 'chnpp', 'kys86', 'rachponkalra', 'chicheng', 'z3323355', 'ysrrcool', 'liyanage777', 'helencxy', 'solfreer', 'songyanfan', 'tuyu1988', 'andreamorello', 'marjana', 'happyhome1025']"
78,213,7,19,5,"['aes549', 'hmayes', 'clof', 'stephy1204', 'ycolon1002']",1,['dad587'],14,"['mroenbeck', 'biw936', 'bjs388', 'abthomps', 'prithag', 'bashwell', 'emm355', 'z2z007', 'rpitner1115', 'skbrand', 'swtheart312', 'lar739', None, 'nathaniel87']",20,"['aes549', 'dad587', 'prithag', 'clof', 'bashwell', 'stephy1204', 'ycolon1002', 'z2z007', 'abthomps', 'lar739', None, 'mroenbeck', 'biw936', 'hmayes', 'bjs388', 'emm355', 'rpitner1115', 'skbrand', 'swtheart312', 'nathaniel87']"
78,212,7,15,4,"['stephy1204', 'aes549', 'hmayes', 'ycolon1002']",2,"['clof', 'dad587']",11,"['mroenbeck', 'cari', 'biw936', 'bjs388', 'bashwell', 'z2z007', 'skbrand', 'daniel84', 'aes27', 'lar739', None]",17,"['aes549', 'dad587', 'clof', 'bashwell', 'stephy1204', 'ycolon1002', 'z2z007', 'lar739', None, 'mroenbeck', 'cari', 'biw936', 'hmayes', 'bjs388', 'skbrand', 'daniel84', 'aes27']"
78,207,7,11,6,"['aes549', 'hmayes', 'dad587', 'clof', 'stephy1204', 'ycolon1002']",0,[],5,"['cari', 'bashwell', None, 'nathaniel87', 'ngruenke']",11,"['aes549', 'dad587', 'clof', 'bashwell', 'stephy1204', 'ycolon1002', None, 'ngruenke', 'cari', 'hmayes', 'nathaniel87']"
78,208,7,9,5,"['aes549', 'hmayes', 'clof', 'stephy1204', 'ycolon1002']",1,['dad587'],4,"['bashwell', 'cari', None, 'ngruenke']",10,"['aes549', 'cari', 'hmayes', 'dad587', 'clof', 'bashwell', 'stephy1204', 'ycolon1002', None, 'ngruenke']"
78,209,7,8,5,"['aes549', 'hmayes', 'clof', 'stephy1204', 'ycolon1002']",1,['dad587'],3,"['bashwell', 'cari', None]",9,"['aes549', 'cari', 'hmayes', 'dad587', 'clof', 'bashwell', 'stephy1204', 'ycolon1002', None]"
78,211,7,8,5,"['aes549', 'hmayes', 'clof', 'stephy1204', 'ycolon1002']",1,['dad587'],3,"['bashwell', 'cari', None]",9,"['aes549', 'cari', 'hmayes', 'dad587', 'clof', 'bashwell', 'stephy1204', 'ycolon1002', None]"
78,206,7,7,5,"['aes549', 'hmayes', 'dad587', 'stephy1204', 'ycolon1002']",1,['clof'],2,"['markuline', None]",8,"['aes549', 'hmayes', 'dad587', 'clof', 'stephy1204', 'ycolon1002', 'markuline', None]"
79,32,7,9,1,['tejas777'],5,"['mihaela', 'birner', 'atom77phy', 'rohitbhasin', 'fdomingue']",8,"['zahrah', 'gr', 'shouvik87', 'astquintin', 'atlas00', 'harack1b', None, 'vsridh']",14,"['mihaela', 'zahrah', 'gr', 'shouvik87', 'birner', 'atom77phy', 'astquintin', 'atlas00', 'rohitbhasin', 'fdomingue', 'harack1b', 'tejas777', None, 'vsridh']"
83,189,7,9,1,['murtaza'],5,"['weigao616', 'cbuurma', 'pkuschak', 'djung31', 'noah1989']",8,"['abdulmajid123', 'fari911', 'rahmatyarkhan', 'haiderzaidi', 'madawood', 'zaidyes', 'fahadhussain', None]",14,"['abdulmajid123', 'weigao616', 'fari911', 'rahmatyarkhan', 'cbuurma', 'pkuschak', 'djung31', 'murtaza', 'haiderzaidi', 'madawood', 'noah1989', 'zaidyes', 'fahadhussain', None]"
84,48,7,288,6,"['jpkmufc', 'knt528', 'atracey3', 'mkanter', 'jbuford1', 'poobag2']",0,[],282,"['sarahclark2014', 'jki416', 'kmdoherty', 'phw454', 'bchanzit', 'lisamithun', 'jwoll1692', 'chem10232269', 'ipreston', 'elisees', 'zrs686', 'sicelo', 'dangerousdan', 'cthayer709', 'mweber', 'rgruenhagen', 'hct669', 'philip', 'chc727', 'ssa886', 'nanolab218', 'dannyginz', 'tdupper', 'runningfreak21', 'pvonachen', 'kegley', 'dannywinans', 'aqh681', 'scoobidy', 'rossmac13', 'jkchem3', 'bhamilton', 'willworden', 'mcm179', 'chancecim', 'cel156', 'jschultz57', 'njneil92', 'jbuser92', 'jpalarczyk', 'samhatfield', 'gusbus06', 'markbachrach', 'aspiegel', 'dmp556', 'chem102', 'wngo', 'brockburdyl', 'mrauf13', 'sonalid', 'jkoszela', 'eap01', 'nebiu', 'dunner87', 'mollykbaker', 'meghan1', 'ccf165', 'kwerling', 'johnmari', 'pdu937', 'arilederman', 'alipka', 'jeg770', 'ghm918', 'axz244', 'kalindishah', 'alannahenry', 'sdv465', 'kdwoods', 'trp982', 'jpj917', 'gatesmeg', 'jennly', 'knp750', 'aoabraham', 'moekou', 'dwerickson', 'jsd713', 'patwood78', 'ddjrl', 'juliaretzky', 'jkzhou99', 'mdj146', 'mborba', 'hhass', 'martakulich', 'ltu197', 'wchoi1025', 'ethanmcginnis2014', 'ktdutchman', 'vfa774', 'danalec23', 'meshun11', 'jasminejones', 'edsarah', 'amcgary', 'samgbur', 'mz1030', 'mss647', 'adriennedunk', 'nch964', 'srv123', 'mrossi14', 'rnorval', 'sahartman4', 'spencermartens', 'juliateresa1', 'rch465', 'alanpan', 'hopeandseema', 'stephmandir', 'mjiang112', 'vwang92', 'jlj592', 'jli', 'hcm888', 'danielmcfarland', 'catherinealthaus', 'esosdian', 'noliver97', 'nicolechem', 'amee', 'kevingreenhalgh2014', 'vog399', 'rjs374', 'abd892', 'benthemonkey', 'mwiersema', 'csilvestre', 'aramis16', 'matshu92', 'bpg109', 'lianggu91', 'greed0812', 'bjr124', 'cms201', 'sydneyblack', 'ajm882', 'vickieotto', 'eeg951', 'lph854', 'erica123', 'ebens', 'changbeeray', 'musiclover324', 'teresak', 'amandaziffer2014', 'tak825', 'kelseythom', 'jquinn825', 'graceminix', 'jetzoh51', 'dac279', 'jyu3138', 'ewo304', 'jwu525', 'msh986', 'jboxman7', 'jmb489', 'jsolis7', 'payasarraf1', 'vpp990', 'edp592', 'sem227', 'fjk562', 'hkw198', 'har580', 'hrendos', 'shj210', 'mmmccc', 'msistla46', 'laurensoccer13', 'jsh8', 'tan190', 'bmsiwek', 'saracov726', 'bumpin8er', 'cosidari', 'clairemelvin', 'tweiner92', 'dbali423', 'ras525', 'lae247', 'wenbinbin2010', 'lslesur', 'lmadison13', 'ses457', 'rosemilavitz', 'rbraga25', 'lrl839', None, 'stingraymart1', 'smc895', 'mhj872', 'atif24', 'crkramer', 'akantzos', 'harlynn14siler', 'simontj', 'yuliya12', 'amandafrankel2014', 'giah', 'madelineschwid', 'johnandalex', 'sah285', 'zaraq', 'cskeehan', 'hairandholman', 'cberkowitz', 'sjl123', 'ecp899', 'ezaonegina', 'kgc375', 'kendrahertz2014', 'lmsadowsky', 'blai', 'dsh926', 'zil338', 'knk953', 'lamar0404', 'ksd948', 'msw466', 'gmv672', 'pinararikan', 'cvickst14', 'jsierks2', 'cnj373', 'sunjaejung', 'meganghub', 'the13thmachete', 'yzh199', 'jeffandrose', 'bhuang92', 'charleyp', 'jkilcommons', 'copperbeech1', 'mark123', 'zachkis', 'titosmith12', 'dlrhksgud4', 'mwagner987', 'btredz49', 'jocandkev', 'tejerina', 'suekim2014', 'sam413', 'sli674', 'bugmenot', 'eterzer', 'abbyroopali', 'jcao618', 'landislandis', 'lillian2011', 'alereyes', 'cwollaeger', 'danielthomas2014', 'ath800', 'wsc826', 'ntp742', 'gusdomel', 'dhw191', 'ggon03', 'chem1', 'johnpark8', 'benjaminrafshoon2014', 'mhartoun', 'chemistry1', 'vasanoah', 'mdw994', 'shawnkim332', 'varshinicherukupalli', 'sahopki', 'arps714', 'jhk931', 'cmw897', 'amattias', 'suziepeter', 'tjconsidine', 'robbie529', 'rgeiwitz', 'aarora', 'shilliger']",288,"['sarahclark2014', 'atracey3', 'jki416', 'kmdoherty', 'phw454', 'bchanzit', 'lisamithun', 'jwoll1692', 'chem10232269', 'ipreston', 'elisees', 'zrs686', 'sicelo', 'dangerousdan', 'cthayer709', 'mweber', 'rgruenhagen', 'hct669', 'philip', 'chc727', 'ssa886', 'nanolab218', 'dannyginz', 'tdupper', 'runningfreak21', 'pvonachen', 'kegley', 'dannywinans', 'aqh681', 'scoobidy', 'rossmac13', 'jkchem3', 'bhamilton', 'willworden', 'mcm179', 'chancecim', 'cel156', 'jschultz57', 'njneil92', 'jbuser92', 'jpalarczyk', 'samhatfield', 'gusbus06', 'markbachrach', 'aspiegel', 'dmp556', 'chem102', 'wngo', 'brockburdyl', 'jbuford1', 'mrauf13', 'sonalid', 'jkoszela', 'eap01', 'nebiu', 'dunner87', 'mollykbaker', 'meghan1', 'ccf165', 'kwerling', 'johnmari', 'pdu937', 'arilederman', 'alipka', 'jeg770', 'ghm918', 'axz244', 'kalindishah', 'alannahenry', 'sdv465', 'kdwoods', 'trp982', 'jpj917', 'gatesmeg', 'jennly', 'knp750', 'aoabraham', 'moekou', 'dwerickson', 'jsd713', 'patwood78', 'ddjrl', 'juliaretzky', 'jkzhou99', 'mdj146', 'mborba', 'hhass', 'martakulich', 'ltu197', 'wchoi1025', 'ethanmcginnis2014', 'ktdutchman', 'vfa774', 'danalec23', 'meshun11', 'jasminejones', 'edsarah', 'amcgary', 'samgbur', 'mz1030', 'mss647', 'adriennedunk', 'nch964', 'srv123', 'mrossi14', 'rnorval', 'sahartman4', 'spencermartens', 'juliateresa1', 'rch465', 'alanpan', 'hopeandseema', 'stephmandir', 'mkanter', 'mjiang112', 'vwang92', 'jlj592', 'jli', 'hcm888', 'danielmcfarland', 'catherinealthaus', 'esosdian', 'noliver97', 'nicolechem', 'amee', 'kevingreenhalgh2014', 'vog399', 'rjs374', 'abd892', 'benthemonkey', 'mwiersema', 'csilvestre', 'aramis16', 'matshu92', 'bpg109', 'lianggu91', 'greed0812', 'bjr124', 'cms201', 'sydneyblack', 'ajm882', 'vickieotto', 'eeg951', 'lph854', 'erica123', 'ebens', 'changbeeray', 'musiclover324', 'teresak', 'amandaziffer2014', 'tak825', 'kelseythom', 'jquinn825', 'graceminix', 'jetzoh51', 'dac279', 'jyu3138', 'ewo304', 'jwu525', 'msh986', 'jboxman7', 'jmb489', 'jsolis7', 'payasarraf1', 'vpp990', 'edp592', 'sem227', 'fjk562', 'hkw198', 'har580', 'hrendos', 'shj210', 'mmmccc', 'msistla46', 'laurensoccer13', 'jsh8', 'tan190', 'bmsiwek', 'saracov726', 'bumpin8er', 'cosidari', 'clairemelvin', 'tweiner92', 'dbali423', 'ras525', 'lae247', 'wenbinbin2010', 'lslesur', 'lmadison13', 'ses457', 'rosemilavitz', 'rbraga25', 'lrl839', None, 'stingraymart1', 'smc895', 'mhj872', 'atif24', 'crkramer', 'akantzos', 'harlynn14siler', 'simontj', 'yuliya12', 'amandafrankel2014', 'giah', 'madelineschwid', 'johnandalex', 'sah285', 'zaraq', 'cskeehan', 'hairandholman', 'cberkowitz', 'sjl123', 'ecp899', 'ezaonegina', 'kgc375', 'kendrahertz2014', 'lmsadowsky', 'blai', 'dsh926', 'zil338', 'knk953', 'lamar0404', 'ksd948', 'msw466', 'gmv672', 'pinararikan', 'cvickst14', 'jsierks2', 'cnj373', 'sunjaejung', 'meganghub', 'the13thmachete', 'yzh199', 'jeffandrose', 'bhuang92', 'charleyp', 'jkilcommons', 'copperbeech1', 'mark123', 'zachkis', 'titosmith12', 'dlrhksgud4', 'mwagner987', 'btredz49', 'jocandkev', 'tejerina', 'suekim2014', 'sam413', 'poobag2', 'sli674', 'bugmenot', 'eterzer', 'abbyroopali', 'jcao618', 'landislandis', 'lillian2011', 'alereyes', 'cwollaeger', 'danielthomas2014', 'ath800', 'wsc826', 'ntp742', 'gusdomel', 'dhw191', 'ggon03', 'jpkmufc', 'knt528', 'chem1', 'johnpark8', 'benjaminrafshoon2014', 'mhartoun', 'chemistry1', 'vasanoah', 'mdw994', 'shawnkim332', 'varshinicherukupalli', 'sahopki', 'arps714', 'jhk931', 'cmw897', 'amattias', 'suziepeter', 'tjconsidine', 'robbie529', 'rgeiwitz', 'aarora', 'shilliger']"
85,230,6,29,5,"['nene07', 'osobafemi', 'smsanchez3', 'drobles4', 'crodriguez33']",0,[],24,"['ejochoa', 'jcorrea4', 'viktorn3lc3', 'dmanerek', 'lebaron', 'utepee4395dmarellanobuendia', 'litapia', 'jacortez04', 'jemunoz6', 'laoliva', 'ee4395brooks', 'jacastorena', None, 'jrbeltran', 'rbpost', 'mefurth', 'lberumen3', 'dalemus', 'vross', 'javalencia2', 'eidelatorre', 'eopayan', 'pmchavez2', 'bhgarcia']",29,"['jcorrea4', 'dmanerek', 'utepee4395dmarellanobuendia', 'litapia', 'jacortez04', 'jemunoz6', 'laoliva', 'crodriguez33', 'mefurth', 'vross', 'eidelatorre', 'bhgarcia', 'ejochoa', 'viktorn3lc3', 'lebaron', 'osobafemi', 'ee4395brooks', 'jacastorena', None, 'jrbeltran', 'rbpost', 'lberumen3', 'dalemus', 'javalencia2', 'eopayan', 'pmchavez2', 'nene07', 'smsanchez3', 'drobles4']"
85,226,6,18,5,"['nene07', 'osobafemi', 'smsanchez3', 'drobles4', 'crodriguez33']",0,[],13,"['viktorn3lc3', 'rbpost', 'mefurth', 'lberumen3', 'dmanerek', 'lebaron', 'dalemus', 'fernandoa1', 'eopayan', 'pmchavez2', 'jemunoz6', 'jacastorena', None]",18,"['viktorn3lc3', 'dmanerek', 'lebaron', 'osobafemi', 'jemunoz6', 'jacastorena', None, 'crodriguez33', 'rbpost', 'mefurth', 'lberumen3', 'dalemus', 'fernandoa1', 'eopayan', 'pmchavez2', 'nene07', 'smsanchez3', 'drobles4']"
87,270,6,8,5,"['bmmarcin', 'jdmccoy2', 'zmmahbo2', 'kfplunke', 'eemille3']",0,[],3,"['jamedfor', None, 'hlee19']",8,"['bmmarcin', 'jdmccoy2', 'zmmahbo2', 'hlee19', 'kfplunke', 'eemille3', 'jamedfor', None]"
90,160,6,14,5,"['cjt3940', 'aklau', 'flyng88', 'yikhoong', 'louisliew']",0,[],9,"['milkysoo', 'petertan', 'xelenix', 'miccjy', 'edisonboey', 'michaelfng88', None, 'adrianfooutar', 'kwanglee']",14,"['milkysoo', 'cjt3940', 'yikhoong', 'edisonboey', 'michaelfng88', None, 'adrianfooutar', 'kwanglee', 'petertan', 'xelenix', 'aklau', 'miccjy', 'flyng88', 'louisliew']"
91,28,6,11,4,"['kdwalton', 'zkoch', 'mreuter', 'mbruhn']",1,['cwhetsel'],7,"['jonesrr', 'rsells', 'scotte', 'jyuan', 'nikko2385', 'albridge', None]",12,"['jonesrr', 'rsells', 'zkoch', 'cwhetsel', 'kdwalton', 'nikko2385', 'mreuter', None, 'jyuan', 'scotte', 'albridge', 'mbruhn']"
93,175,6,23,5,"['aryan88', 'ajain88', 'vijayp', 'yesheng', 'archana256']",0,[],18,"['femto', 'kys86', 'ysmmsy', 'clee58', 'chovic99', 'yuanze_2008', 'pqbdco', 'dsukhdeo', 'sagerke', 'ivyluo', 'cyahn', 'wanghan', 'liyanage777', 'helencxy', 'meiyueht', 'marjana', 'jjean', None]",23,"['femto', 'ajain88', 'ysmmsy', 'clee58', 'chovic99', 'yuanze_2008', 'pqbdco', 'dsukhdeo', 'vijayp', 'wanghan', 'aryan88', 'yesheng', 'ivyluo', 'jjean', None, 'kys86', 'sagerke', 'cyahn', 'liyanage777', 'helencxy', 'meiyueht', 'marjana', 'archana256']"
93,231,6,7,5,"['aryan88', 'ajain88', 'vijayp', 'yesheng', 'archana256']",0,[],2,"[None, 'simonguan']",7,"[None, 'ajain88', 'yesheng', 'vijayp', 'aryan88', 'archana256', 'simonguan']"
96,10,6,14,5,"['riosniyper', 'hsptl', 'shinhyuk001', 'drummersh', 'truewhat']",0,[],9,"['hsyang25', 'kdm52', 'ancap19', 'narunalive', 'dlwldud89', 'patseo', 'hoonsangyoon', 'rla19425', None]",14,"['hsyang25', 'riosniyper', 'ancap19', 'hsptl', 'dlwldud89', 'patseo', 'truewhat', 'rla19425', None, 'kdm52', 'narunalive', 'shinhyuk001', 'hoonsangyoon', 'drummersh']"
96,19,6,13,4,"['truewhat', 'riosniyper', 'shinhyuk001', 'hsptl']",1,['drummersh'],9,"['hsyang25', 'kdm52', 'ancap19', 'sjwkillsjw', 'hoonsangyoon', 'rla19425', 'otw88', None, 'njm0810']",14,"['hsyang25', 'riosniyper', 'ancap19', 'hsptl', 'truewhat', 'rla19425', 'otw88', None, 'njm0810', 'kdm52', 'sjwkillsjw', 'shinhyuk001', 'hoonsangyoon', 'drummersh']"
96,17,6,12,4,"['truewhat', 'riosniyper', 'shinhyuk001', 'hsptl']",1,['drummersh'],8,"['hsyang25', 'kdm52', 'hoonsangyoon', 'uhahaha', 'rla19425', 'otw88', None, 'njm0810']",13,"['hsyang25', 'riosniyper', 'hsptl', 'uhahaha', 'truewhat', 'rla19425', 'otw88', None, 'njm0810', 'kdm52', 'shinhyuk001', 'hoonsangyoon', 'drummersh']"
96,8,6,11,5,"['riosniyper', 'hsptl', 'shinhyuk001', 'drummersh', 'truewhat']",0,[],6,"['hsyang25', 'kdm52', 'narunalive', 'hoonsangyoon', 'rla19425', None]",11,"['hsyang25', 'riosniyper', 'hsptl', 'truewhat', 'rla19425', None, 'kdm52', 'narunalive', 'shinhyuk001', 'hoonsangyoon', 'drummersh']"
96,18,6,11,4,"['truewhat', 'riosniyper', 'shinhyuk001', 'hsptl']",1,['drummersh'],7,"['hsyang25', 'kdm52', 'hoonsangyoon', 'rla19425', 'otw88', None, 'njm0810']",12,"['hsyang25', 'riosniyper', 'hsptl', 'truewhat', 'rla19425', 'otw88', None, 'njm0810', 'kdm52', 'shinhyuk001', 'hoonsangyoon', 'drummersh']"
96,13,6,7,3,"['riosniyper', 'shinhyuk001', 'hsptl']",2,"['drummersh', 'truewhat']",4,"['hsyang25', None, 'patseo', 'rla19425']",9,"['hsyang25', 'riosniyper', 'hsptl', 'patseo', 'shinhyuk001', 'drummersh', 'truewhat', 'rla19425', None]"
96,16,6,7,4,"['truewhat', 'riosniyper', 'drummersh', 'hsptl']",1,['shinhyuk001'],3,"['kdm52', None, 'rla19425']",8,"['riosniyper', 'kdm52', 'hsptl', 'shinhyuk001', 'drummersh', 'truewhat', 'rla19425', None]"
96,15,6,6,2,"['shinhyuk001', 'hsptl']",3,"['riosniyper', 'drummersh', 'truewhat']",4,"['hsyang25', None, 'patseo', 'rla19425']",9,"['hsyang25', 'riosniyper', 'hsptl', 'patseo', 'shinhyuk001', 'drummersh', 'truewhat', 'rla19425', None]"
