MClusterID,XClusterID,MClusterSize,XClusterSize,OverlapSize,OverlapMembers,MOnlySize,MOnlyMembers,XOnlySize,XOnlyMembers,CombinedSize,CombinedMembers
1,209,484,453,449,"['clynsky06', 'reneewharton', 'hboas', 'mhs287', 'dpanford96', 'aestrada', 'msalazer', 'caitlin2015', 'roboro727', 'allisonschloss', 'ppairs', 'vnm816', 'miayankow', 'uijungan', 'men544', 'eec781', 'jrc261', 'alamens', 'agoldman', 'sks491', 'clarkey2369', 'abl849', 'arouse', 'newcombjb', 'tpendergrast', 'jwr915', 'cmd750', 'elenaber19', 'mek767', 'fauxsnail', 'lpatras', 'danaya707', 'jem824', 'kfan', 'twhite', 'chrispontisakos', 'mgrollins', 'mr.jesusleon1', 'fpaulgreen', 'slk620', 'slenzini', 'alex_layng', 'jkwon66', 'sbenteftifa1', 'mbartnovsky', 'imankhan2015', 'nshaw123', 'zrimsekab', 'msp793', 'jhenfran2015', 'krf206', 'fare', 'ssadeghi', 'kateritter922', 'cathyjo_l', 'victoria.dubose', 'rmoore', 'jessicapowers', 'creyes221', 'twilightdream37', 'hmf014', 'mmccormick', 'ntrautenberg', 'pgl314', 'aschlatter', 'edwardcytryn2015', 'blooshnog', 'cju107', 'benwhite', 'hhung', 'kjorgensen514', 'havs23', 'kleung', 'moneil', 'ameliageitz2015', 'ghosh009', 'thomasaugust', 'cadnams', 'krushers', 'albertren', 'jsantos', 'nichaaar', 'bjk', 'xyn711', 'aspruston', 'meredyth', 'ua_patel24', 'sevangelista', 'msl333', 'epa268', 'lcn329', 'jbrutzkus', 'grk689', 'rbailey', 'tmorreale', 'cnwaelele', 'sportzboy2', '09mcclellan21', 'arr891', 'dchi3', 'whenjenn', 'kcolter08', 'mcssports1', 'rhunter', 'ericajepsen', 'kek725', 'lcassens', 'chrysacheronis', 'dzdunek', 'pbevacqua', 'lilib246', 'mspiezio32', 'lubben', 'cgcizek', 'coolivia', 'han607', 'ablandford12', 'isabelrv', 'smontgomery', 'sarahb1', 'kiracalavera', 'asampson2012', 'kerwinjo', 'mahlbeck', 'jrc699', 'ramanmichael2015', 'nyeh', 'chem102lab', 'athorne', 'ocecconi', 'nfw17531', 'ayaassi93', 'pozzi', 'jthumel', 'abeir', 'mnajjarpour', 'epeterson', 'lgarcia', 'jhr252', 'jnephan93', 'lkc503', 'bwieg92', 'yusufoner', 'vlc780', 'kas042', 'fmontana93', 'arthurpollard', 'askowalczuk', 'dgainski', 'lloweth1', 'nabroady', 'bbachelor', 'wcp795', 'amh690', 'css539', 'jpt117', 'defenseman91', 'abhatti', 'dfeld', 'sms618', 'farzaankassam2015', 'mark523', 'jbascom24', 'jahodapp', 'tlar650', 'jtc143', 'bearfan92', 'michael_western2015', 'chemlabman10', 'alower', 'rajiv23', 'jorigoodman2015', 'ees264', 'dpawletki', 'wyouman', 'rmh586', 'ericenu', 'emf062', 'bdolan7329', 'cgutermuth', 'maddiejcole', 'megan.kasik', 'nelsonschang', 'karenwang2015', 'oliviamorales', 'michaelcreatura2015', 'hurleyjoseph', 'vanseng13', 'hebaiyor13', 'jdong', 'sixth', 'lwulf', 'sschoeneman', 'dpatel', 'cherylwang1992', 'kwooliver', 'gabyperea5', 'sdangles', 'mchi', 'iwali1993', 'mwantuch', 'sjthompson09', 'nnayar', 'lstreich', 'brandonbock2015', 'thekush93', 'martaturowski', 'jorwhore124', 'jwolloch19', 'juliebloom2015', 'mdz860', 'alexandraprodriguez', 'twilmanski', 'ajh874', 'aagbeh', 'aaa766', 'wzuczek', 'lrw789', 'swaterbury', 'thomashulley', 'blee2015', 'sgier', 'rid180', 'arielmalloy', 'mbagwell', 'hbd635', 'psp502', 'cedano', 'jmarthouse', 'jprescottsmith', 'clairemccloskey2015', 'agowani', 'malbrecht', 'mjs718', 'chasebrewster2015', 'dct353', 'bam368', 'dsgarharda001', 'helenl', 'jhenjhenn1', 'jvuong93', 'matthewmelamed2015', 'ninaor3', 'csheidinger7', 'ajit326', 'wutangclan', 'dfogel', 'fteller', 'jennastoehr2015', 'jcarrillo', 'jsk127', 'eaf591', 'hellojello44', 'kyletaylor', 'umerftw', 'clovo', 'squintus11', 'kspitzercohn', 'jde165', 'azaffer', 'omowunmi', 'valeriejchen', 'ewigley10', 'karlyroser2015', 'tjorda21', 'aah526', 'ssmith', 'deiden26', 'apfeiffer', 'pkf549', 'samfoolery', 'justinwhite2014', 'lhelfrich', 'rcignoni', 'zhsueh', 'asv810', 'mrt728', 'alw490', 'phogan', 'amf997', 'tfiorica', 'ejn531', 'rhabbestad', 'klg257', 'ceterpstra', 'kthakkar', 'chammond3', 'erinyoung2015', 'kkielbania', 'asteinwald', 'omorales', 'hauserb', 'rem421', 'sejal', 'nancygu', 'teaisfortiffany', 'bzelch', 'rsibley', 'jennypark2015', 'mferber', 'stephanielo', 'acheatham', 'jasminealadefa2015', 'scottingham2015', 'albertsong2015', 'makrasnow15', 'djw278', 'nsisterson', 'eacostatorres', 'avillacres', 'tkiguradze', 'ryansachs2011', 'mmargritier', 'hgartner', 'yhc973', 'zaynabquadri2015', 'jcv809', 'epc257', 'eggfooyang', 'matsglj', 'peteswims1818', 'kabia47', 'speysakhovich', 'cys969', 'madalyngisch2015', 'rhj572', 'mpl1002', 'whunt', 'apatrick', 'casey', 'roadracer1', 'elliotyucesan', 'ldk620', 'dapatriot497', 'mcunningham', 'zhosseinian', 'jmcguire', 'jdf130', 'egw955', 'vcurtis', 'tiwu', 'jky552', 'slhatch', 'clarson', 'vicky123xyz', 'sergeantnick', 'naomimerer2015', 'kkaur', 'devoraisseroff2015', 'madelinehooper', 'dianecole1', 'annacassell', 'dprivit', 'rtotten', 'asonta', 'sritchey', 'vharris', 'jlamberth8', 'ram330', 'jennmurphy11', 'barcatorres', 'frank.parilla', 'sysmith', 'frank_avino', 'kbenintende', 'jamccarthy89', 'lfeltz78', 'seastwood', 'jkelter', 'aseitz10', 'sarahtoy', 'jkstoller', 'robertfisch2015', 'ras423', 'selkins', 'taizenman', 'jcc068', 'jbeyrau', 'dylanheck2015', 'selberts', 'lfm377', 'sfritz2015', 'pekarah', 'sfong', 'jwh252', 'sms483', 'kevjung', 'yakanbi1', 'iasega', 'cleclerq', 'abh019', 'yfs322', 'm.d.marcus', 'nschmidt', 'arpaskewitz', 'tjt149', 'jonfeldman', 'rachelgladney2015', 'woestreich', 'richarathore', 'dlt075', 'eric.schoenbach', 'dchon', 'akendall', 'joeentenman', 'hfrudden', 'bassman211', 'sgj140', 'cbryan136', 'lcl218', 'lucasnr', 'mmcgreal', 'willoliver', 'jsadelman', 'aeyarbro', 'adoro', 'msp034', 'tjdohm', 'hcrippen', 'booknut467', 'randerson', 'theokelly382', 'jsemkiu', 'conniegu', 'kkbarr2015', 'atregnery', 'ejwebb92', 'amldywhite', 'mgb217', 'jch507', 'yhong93', 'ericaminor2015', 'askzorno', 'aylinelma', 'djacobs2015', 'jch450', 'tylermanci2015', 'gracejaworski', 'hannahbeck', 'lmk232', 'hbrown', 'szaleski', 'michaelraso', 'amandatorgerson', 'tells', 'jlipsitz', 'msc958', 'zpiser', 'ccoravos']",35,"['bspoka', 'rp8988', 'juhui1215', 'brycew25', 'mariluwho4', 'jbbechard', 'lluc8', 'lhall8695', 'janigus', 'yhong', 'julitroi', 'eriedy', 'sadeb45', 'grahajym', 'francesconaccarato', 'misaacson2015', 'rachaelo', 'kaze', 'arvindalchemist', 'enpar25', 'rohara', 'rdaniels', 'jkevern', 'prabhakar.b', 'cmaikens', 'nickjack13', 'noahnuta', 'mrthyfau', 'klink07', 'vinrivera', 'hagjos', 'camomcg', 'mabellera', 'ckyle', 'khurst']",4,"['jszekely', 'tkinard1', 'mrb716', 'hartze']",488,"['bspoka', 'clynsky06', 'reneewharton', 'hboas', 'mhs287', 'dpanford96', 'aestrada', 'msalazer', 'caitlin2015', 'yhong', 'roboro727', 'allisonschloss', 'ppairs', 'vnm816', 'miayankow', 'uijungan', 'eec781', 'men544', 'jrc261', 'alamens', 'agoldman', 'sks491', 'clarkey2369', 'abl849', 'arouse', 'newcombjb', 'tpendergrast', 'jwr915', 'cmd750', 'elenaber19', 'rp8988', 'juhui1215', 'mek767', 'fauxsnail', 'lluc8', 'janigus', 'julitroi', 'danaya707', 'lpatras', 'jem824', 'kfan', 'twhite', 'chrispontisakos', 'mgrollins', 'mr.jesusleon1', 'slk620', 'fpaulgreen', 'slenzini', 'rdaniels', 'alex_layng', 'jkwon66', 'sbenteftifa1', 'mbartnovsky', 'imankhan2015', 'nshaw123', 'zrimsekab', 'msp793', 'vinrivera', 'jhenfran2015', 'krf206', 'fare', 'ssadeghi', 'kateritter922', 'cathyjo_l', 'victoria.dubose', 'rmoore', 'jessicapowers', 'creyes221', 'twilightdream37', 'hmf014', 'pgl314', 'ntrautenberg', 'mmccormick', 'aschlatter', 'edwardcytryn2015', 'blooshnog', 'cju107', 'benwhite', 'hhung', 'kjorgensen514', 'havs23', 'jkevern', 'kleung', 'moneil', 'ameliageitz2015', 'ghosh009', 'thomasaugust', 'cadnams', 'krushers', 'albertren', 'jsantos', 'nichaaar', 'bjk', 'xyn711', 'brycew25', 'sevangelista', 'aspruston', 'ua_patel24', 'meredyth', 'msl333', 'epa268', 'lcn329', 'jbrutzkus', 'misaacson2015', 'grk689', 'rbailey', 'tmorreale', 'rohara', 'cnwaelele', 'sportzboy2', 'arr891', 'whenjenn', '09mcclellan21', 'dchi3', 'kcolter08', 'mcssports1', 'nickjack13', 'rhunter', 'ericajepsen', 'kek725', 'lcassens', 'pbevacqua', 'dzdunek', 'chrysacheronis', 'camomcg', 'lilib246', 'mspiezio32', 'lubben', 'coolivia', 'cgcizek', 'han607', 'ablandford12', 'isabelrv', 'smontgomery', 'sarahb1', 'kiracalavera', 'eriedy', 'asampson2012', 'kerwinjo', 'mahlbeck', 'jrc699', 'ramanmichael2015', 'nyeh', 'chem102lab', 'athorne', 'ocecconi', 'nfw17531', 'ayaassi93', 'pozzi', 'jthumel', 'mnajjarpour', 'abeir', 'epeterson', 'lgarcia', 'jhr252', 'jnephan93', 'lkc503', 'bwieg92', 'yusufoner', 'vlc780', 'kas042', 'fmontana93', 'arthurpollard', 'askowalczuk', 'dgainski', 'lloweth1', 'nabroady', 'wcp795', 'bbachelor', 'amh690', 'css539', 'jpt117', 'defenseman91', 'abhatti', 'dfeld', 'sms618', 'klink07', 'farzaankassam2015', 'mark523', 'jbascom24', 'jahodapp', 'tlar650', 'jtc143', 'michael_western2015', 'bearfan92', 'chemlabman10', 'rajiv23', 'alower', 'jorigoodman2015', 'ees264', 'dpawletki', 'wyouman', 'rmh586', 'ericenu', 'mrb716', 'emf062', 'bdolan7329', 'cgutermuth', 'maddiejcole', 'nelsonschang', 'megan.kasik', 'karenwang2015', 'oliviamorales', 'michaelcreatura2015', 'arvindalchemist', 'hurleyjoseph', 'vanseng13', 'hebaiyor13', 'jdong', 'sixth', 'lwulf', 'sschoeneman', 'dpatel', 'cmaikens', 'cherylwang1992', 'kwooliver', 'gabyperea5', 'sdangles', 'mchi', 'iwali1993', 'mwantuch', 'sjthompson09', 'lstreich', 'nnayar', 'brandonbock2015', 'thekush93', 'jorwhore124', 'martaturowski', 'jwolloch19', 'juliebloom2015', 'mdz860', 'alexandraprodriguez', 'twilmanski', 'ajh874', 'aagbeh', 'aaa766', 'wzuczek', 'lrw789', 'swaterbury', 'thomashulley', 'blee2015', 'sgier', 'rid180', 'arielmalloy', 'mbagwell', 'hbd635', 'psp502', 'cedano', 'jmarthouse', 'jprescottsmith', 'clairemccloskey2015', 'agowani', 'malbrecht', 'mjs718', 'chasebrewster2015', 'dct353', 'bam368', 'dsgarharda001', 'helenl', 'jhenjhenn1', 'jvuong93', 'matthewmelamed2015', 'ninaor3', 'csheidinger7', 'wutangclan', 'ajit326', 'dfogel', 'fteller', 'jennastoehr2015', 'jcarrillo', 'jsk127', 'eaf591', 'hellojello44', 'hagjos', 'ckyle', 'kyletaylor', 'umerftw', 'clovo', 'squintus11', 'kspitzercohn', 'jde165', 'azaffer', 'valeriejchen', 'omowunmi', 'ewigley10', 'karlyroser2015', 'tjorda21', 'aah526', 'ssmith', 'deiden26', 'apfeiffer', 'pkf549', 'samfoolery', 'lhelfrich', 'justinwhite2014', 'rcignoni', 'zhsueh', 'asv810', 'mrt728', 'alw490', 'mrthyfau', 'phogan', 'amf997', 'tfiorica', 'ejn531', 'rhabbestad', 'klg257', 'kthakkar', 'ceterpstra', 'chammond3', 'erinyoung2015', 'kkielbania', 'lhall8695', 'asteinwald', 'omorales', 'hauserb', 'rem421', 'sadeb45', 'francesconaccarato', 'sejal', 'nancygu', 'bzelch', 'teaisfortiffany', 'rsibley', 'jennypark2015', 'mferber', 'stephanielo', 'acheatham', 'jasminealadefa2015', 'scottingham2015', 'albertsong2015', 'makrasnow15', 'djw278', 'hartze', 'nsisterson', 'eacostatorres', 'avillacres', 'tkiguradze', 'ryansachs2011', 'mmargritier', 'hgartner', 'khurst', 'yhc973', 'epc257', 'zaynabquadri2015', 'jcv809', 'eggfooyang', 'mariluwho4', 'matsglj', 'peteswims1818', 'kabia47', 'speysakhovich', 'cys969', 'rhj572', 'madalyngisch2015', 'mpl1002', 'whunt', 'apatrick', 'kaze', 'jszekely', 'casey', 'roadracer1', 'elliotyucesan', 'ldk620', 'mcunningham', 'dapatriot497', 'zhosseinian', 'jmcguire', 'jdf130', 'egw955', 'vcurtis', 'tiwu', 'jky552', 'slhatch', 'clarson', 'vicky123xyz', 'sergeantnick', 'naomimerer2015', 'kkaur', 'devoraisseroff2015', 'madelinehooper', 'dianecole1', 'annacassell', 'dprivit', 'rtotten', 'asonta', 'sritchey', 'vharris', 'jlamberth8', 'enpar25', 'jennmurphy11', 'ram330', 'barcatorres', 'prabhakar.b', 'frank.parilla', 'sysmith', 'frank_avino', 'tkinard1', 'kbenintende', 'jamccarthy89', 'lfeltz78', 'seastwood', 'jkelter', 'aseitz10', 'sarahtoy', 'jkstoller', 'ras423', 'robertfisch2015', 'selkins', 'taizenman', 'jcc068', 'jbeyrau', 'dylanheck2015', 'selberts', 'lfm377', 'sfritz2015', 'pekarah', 'sfong', 'jwh252', 'sms483', 'kevjung', 'yakanbi1', 'iasega', 'cleclerq', 'abh019', 'noahnuta', 'yfs322', 'm.d.marcus', 'nschmidt', 'arpaskewitz', 'tjt149', 'jonfeldman', 'rachelgladney2015', 'woestreich', 'richarathore', 'dlt075', 'eric.schoenbach', 'dchon', 'akendall', 'joeentenman', 'grahajym', 'hfrudden', 'bassman211', 'sgj140', 'cbryan136', 'lcl218', 'lucasnr', 'mmcgreal', 'willoliver', 'jsadelman', 'aeyarbro', 'adoro', 'msp034', 'tjdohm', 'hcrippen', 'booknut467', 'randerson', 'theokelly382', 'jbbechard', 'jsemkiu', 'conniegu', 'kkbarr2015', 'atregnery', 'ejwebb92', 'amldywhite', 'mgb217', 'rachaelo', 'yhong93', 'jch507', 'ericaminor2015', 'askzorno', 'aylinelma', 'djacobs2015', 'jch450', 'tylermanci2015', 'gracejaworski', 'hannahbeck', 'lmk232', 'hbrown', 'szaleski', 'michaelraso', 'amandatorgerson', 'tells', 'jlipsitz', 'msc958', 'zpiser', 'mabellera', 'ccoravos']"
1,171,484,269,261,"['jky552', 'clynsky06', 'clarson', 'lubben', 'cgcizek', 'coolivia', 'jmarthouse', 'naomimerer2015', 'han607', 'jprescottsmith', 'ablandford12', 'isabelrv', 'roboro727', 'madelinehooper', 'mjs718', 'ppairs', 'vnm816', 'smontgomery', 'rtotten', 'chasebrewster2015', 'dct353', 'kiracalavera', 'asonta', 'helenl', 'jhenjhenn1', 'men544', 'eec781', 'ramanmichael2015', 'jlamberth8', 'matthewmelamed2015', 'ninaor3', 'csheidinger7', 'ajit326', 'wutangclan', 'ram330', 'jennmurphy11', 'dfogel', 'barcatorres', 'chem102lab', 'frank.parilla', 'sysmith', 'frank_avino', 'sks491', 'jennastoehr2015', 'clarkey2369', 'abl849', 'jcarrillo', 'jsk127', 'eaf591', 'arouse', 'lfeltz78', 'ocecconi', 'hellojello44', 'newcombjb', 'jkelter', 'aseitz10', 'kyletaylor', 'tpendergrast', 'jkstoller', 'robertfisch2015', 'ras423', 'ayaassi93', 'umerftw', 'clovo', 'squintus11', 'selkins', 'jthumel', 'cmd750', 'jde165', 'elenaber19', 'taizenman', 'omowunmi', 'valeriejchen', 'abeir', 'dylanheck2015', 'danaya707', 'jhr252', 'jem824', 'kfan', 'sfritz2015', 'jnephan93', 'lkc503', 'karlyroser2015', 'sfong', 'tjorda21', 'chrispontisakos', 'yusufoner', 'jwh252', 'vlc780', 'aah526', 'kas042', 'askowalczuk', 'ssmith', 'deiden26', 'mgrollins', 'apfeiffer', 'sms483', 'fpaulgreen', 'pkf549', 'samfoolery', 'slenzini', 'lhelfrich', 'nabroady', 'iasega', 'cleclerq', 'zhsueh', 'alex_layng', 'jkwon66', 'amh690', 'css539', 'asv810', 'abh019', 'mbartnovsky', 'nshaw123', 'mrt728', 'jpt117', 'alw490', 'yfs322', 'm.d.marcus', 'nschmidt', 'sms618', 'ejn531', 'farzaankassam2015', 'rhabbestad', 'jonfeldman', 'rachelgladney2015', 'ceterpstra', 'kthakkar', 'jahodapp', 'woestreich', 'chammond3', 'richarathore', 'erinyoung2015', 'jtc143', 'michael_western2015', 'kateritter922', 'dlt075', 'eric.schoenbach', 'rajiv23', 'kkielbania', 'dchon', 'akendall', 'ees264', 'hmf014', 'dpawletki', 'mmccormick', 'pgl314', 'ntrautenberg', 'joeentenman', 'rmh586', 'ericenu', 'rem421', 'edwardcytryn2015', 'emf062', 'hfrudden', 'bdolan7329', 'cgutermuth', 'maddiejcole', 'blooshnog', 'sejal', 'bassman211', 'megan.kasik', 'nelsonschang', 'lcl218', 'cbryan136', 'nancygu', 'karenwang2015', 'michaelcreatura2015', 'mmcgreal', 'teaisfortiffany', 'willoliver', 'stephanielo', 'havs23', 'acheatham', 'kleung', 'sixth', 'jasminealadefa2015', 'scottingham2015', 'ghosh009', 'albertsong2015', 'cadnams', 'thomasaugust', 'ameliageitz2015', 'msp034', 'dpatel', 'vcurtis', 'tjdohm', 'krushers', 'cherylwang1992', 'albertren', 'avillacres', 'jsantos', 'randerson', 'mmargritier', 'bjk', 'hgartner', 'gabyperea5', 'sdangles', 'zaynabquadri2015', 'jcv809', 'epc257', 'sjthompson09', 'eggfooyang', 'xyn711', 'nnayar', 'thekush93', 'jwolloch19', 'peteswims1818', 'meredyth', 'aspruston', 'juliebloom2015', 'mdz860', 'msl333', 'epa268', 'cys969', 'conniegu', 'alexandraprodriguez', 'lcn329', 'ejwebb92', 'twilmanski', 'madalyngisch2015', 'rhj572', 'mgb217', 'mpl1002', 'misaacson2015', 'grk689', 'aagbeh', 'yhong93', 'apatrick', 'tmorreale', 'wzuczek', 'ericaminor2015', 'lrw789', 'djacobs2015', 'gracejaworski', 'cnwaelele', 'elliotyucesan', 'hannahbeck', 'sportzboy2', '09mcclellan21', 'arr891', 'mcunningham', 'dapatriot497', 'whenjenn', 'hbrown', 'blee2015', 'mcssports1', 'michaelraso', 'tells', 'rhunter', 'ericajepsen', 'msc958', 'chrysacheronis', 'dzdunek', 'jmcguire', 'jdf130', 'mbagwell', 'zpiser', 'egw955', 'ccoravos', 'psp502']",223,"['bspoka', 'slhatch', 'reneewharton', 'hboas', 'mhs287', 'vicky123xyz', 'dpanford96', 'cedano', 'aestrada', 'msalazer', 'sergeantnick', 'clairemccloskey2015', 'caitlin2015', 'kkaur', 'yhong', 'agowani', 'devoraisseroff2015', 'malbrecht', 'allisonschloss', 'dianecole1', 'annacassell', 'sarahb1', 'dprivit', 'eriedy', 'bam368', 'asampson2012', 'miayankow', 'kerwinjo', 'sritchey', 'mahlbeck', 'dsgarharda001', 'jrc699', 'uijungan', 'jrc261', 'vharris', 'enpar25', 'jvuong93', 'nyeh', 'fteller', 'alamens', 'prabhakar.b', 'agoldman', 'kbenintende', 'athorne', 'jamccarthy89', 'nfw17531', 'seastwood', 'hagjos', 'ckyle', 'sarahtoy', 'jwr915', 'pozzi', 'kspitzercohn', 'rp8988', 'juhui1215', 'azaffer', 'mek767', 'fauxsnail', 'jcc068', 'lluc8', 'jbeyrau', 'janigus', 'julitroi', 'mnajjarpour', 'lpatras', 'epeterson', 'lgarcia', 'ewigley10', 'selberts', 'lfm377', 'twhite', 'pekarah', 'bwieg92', 'fmontana93', 'arthurpollard', 'mr.jesusleon1', 'dgainski', 'lloweth1', 'slk620', 'justinwhite2014', 'kevjung', 'yakanbi1', 'rcignoni', 'rdaniels', 'wcp795', 'bbachelor', 'sbenteftifa1', 'imankhan2015', 'zrimsekab', 'noahnuta', 'msp793', 'mrthyfau', 'phogan', 'defenseman91', 'abhatti', 'dfeld', 'amf997', 'tfiorica', 'klink07', 'vinrivera', 'jhenfran2015', 'arpaskewitz', 'mark523', 'krf206', 'klg257', 'tjt149', 'jbascom24', 'fare', 'tlar650', 'hbd635', 'bearfan92', 'ssadeghi', 'cathyjo_l', 'chemlabman10', 'victoria.dubose', 'alower', 'jorigoodman2015', 'rmoore', 'lhall8695', 'jessicapowers', 'creyes221', 'twilightdream37', 'asteinwald', 'omorales', 'wyouman', 'hauserb', 'aschlatter', 'sadeb45', 'grahajym', 'francesconaccarato', 'sgj140', 'cju107', 'lucasnr', 'benwhite', 'oliviamorales', 'bzelch', 'arvindalchemist', 'rsibley', 'hurleyjoseph', 'jennypark2015', 'mferber', 'jsadelman', 'vanseng13', 'hhung', 'kjorgensen514', 'aeyarbro', 'jkevern', 'hebaiyor13', 'jdong', 'adoro', 'lwulf', 'moneil', 'sschoeneman', 'makrasnow15', 'cmaikens', 'djw278', 'hcrippen', 'booknut467', 'nsisterson', 'eacostatorres', 'kwooliver', 'tkiguradze', 'ryansachs2011', 'nichaaar', 'khurst', 'mchi', 'iwali1993', 'mwantuch', 'yhc973', 'theokelly382', 'lstreich', 'brandonbock2015', 'brycew25', 'jorwhore124', 'martaturowski', 'mariluwho4', 'matsglj', 'sevangelista', 'kabia47', 'ua_patel24', 'jbbechard', 'jsemkiu', 'speysakhovich', 'kkbarr2015', 'atregnery', 'amldywhite', 'camomcg', 'jbrutzkus', 'ajh874', 'rachaelo', 'jch507', 'whunt', 'kaze', 'rbailey', 'aaa766', 'askzorno', 'aylinelma', 'rohara', 'swaterbury', 'casey', 'jch450', 'tylermanci2015', 'roadracer1', 'thomashulley', 'ldk620', 'lmk232', 'dchi3', 'kcolter08', 'sgier', 'szaleski', 'nickjack13', 'amandatorgerson', 'jlipsitz', 'rid180', 'kek725', 'lcassens', 'arielmalloy', 'pbevacqua', 'zhosseinian', 'lilib246', 'mabellera', 'mspiezio32', 'tiwu']",8,"['gretskyw', 'mrb716', 'ellenchoe', 'dmalone', 'esp424', 'akazaryan', None, 'dangerousdan']",492,"['bspoka', 'clynsky06', 'reneewharton', 'hboas', 'mhs287', 'dpanford96', 'aestrada', 'msalazer', 'caitlin2015', 'yhong', 'roboro727', 'allisonschloss', 'ppairs', 'vnm816', 'miayankow', 'uijungan', 'eec781', 'men544', 'jrc261', 'alamens', 'agoldman', 'sks491', 'clarkey2369', 'abl849', 'arouse', 'newcombjb', 'tpendergrast', 'jwr915', 'cmd750', 'elenaber19', 'rp8988', 'juhui1215', 'mek767', 'fauxsnail', 'lluc8', 'janigus', 'julitroi', 'danaya707', 'lpatras', 'jem824', 'kfan', 'twhite', 'chrispontisakos', 'mgrollins', 'mr.jesusleon1', 'slk620', 'fpaulgreen', 'slenzini', 'rdaniels', 'alex_layng', 'jkwon66', 'sbenteftifa1', 'mbartnovsky', 'imankhan2015', 'nshaw123', 'zrimsekab', 'msp793', 'vinrivera', 'jhenfran2015', 'krf206', 'fare', 'ssadeghi', 'kateritter922', 'cathyjo_l', 'victoria.dubose', 'rmoore', 'jessicapowers', 'creyes221', 'twilightdream37', 'hmf014', 'pgl314', 'ntrautenberg', 'mmccormick', 'aschlatter', 'edwardcytryn2015', 'blooshnog', 'cju107', 'benwhite', 'hhung', 'kjorgensen514', 'havs23', 'jkevern', 'kleung', 'moneil', 'ameliageitz2015', 'ghosh009', 'thomasaugust', 'cadnams', 'krushers', 'albertren', 'jsantos', 'nichaaar', 'bjk', 'xyn711', 'brycew25', 'sevangelista', 'aspruston', 'ua_patel24', 'meredyth', 'msl333', 'epa268', 'lcn329', 'jbrutzkus', 'misaacson2015', 'grk689', 'rbailey', 'tmorreale', 'rohara', 'cnwaelele', 'sportzboy2', 'arr891', 'whenjenn', '09mcclellan21', 'dchi3', 'kcolter08', 'mcssports1', 'nickjack13', 'rhunter', 'ericajepsen', 'kek725', 'lcassens', 'pbevacqua', 'dzdunek', 'chrysacheronis', 'camomcg', 'lilib246', 'mspiezio32', 'gretskyw', 'lubben', 'coolivia', 'cgcizek', 'han607', 'ablandford12', 'isabelrv', 'smontgomery', 'sarahb1', 'kiracalavera', 'eriedy', 'asampson2012', 'kerwinjo', 'mahlbeck', 'jrc699', 'ramanmichael2015', 'nyeh', 'chem102lab', 'athorne', 'ocecconi', 'nfw17531', 'ayaassi93', 'pozzi', 'jthumel', 'dmalone', 'mnajjarpour', 'abeir', 'epeterson', 'lgarcia', 'jhr252', 'jnephan93', 'lkc503', 'bwieg92', 'yusufoner', 'vlc780', 'kas042', 'fmontana93', 'arthurpollard', 'askowalczuk', 'dgainski', 'lloweth1', 'nabroady', 'wcp795', 'bbachelor', 'amh690', 'css539', 'jpt117', 'defenseman91', 'abhatti', 'dfeld', 'sms618', 'klink07', 'farzaankassam2015', 'mark523', 'jbascom24', 'jahodapp', 'tlar650', 'jtc143', 'michael_western2015', 'bearfan92', 'chemlabman10', 'rajiv23', 'alower', 'jorigoodman2015', 'ees264', 'dpawletki', 'wyouman', 'rmh586', 'ericenu', 'mrb716', 'emf062', 'bdolan7329', 'cgutermuth', 'maddiejcole', 'nelsonschang', 'megan.kasik', 'karenwang2015', 'oliviamorales', 'michaelcreatura2015', 'arvindalchemist', 'hurleyjoseph', 'vanseng13', 'hebaiyor13', 'jdong', 'sixth', 'lwulf', 'sschoeneman', 'dpatel', 'cmaikens', 'cherylwang1992', 'akazaryan', 'kwooliver', 'gabyperea5', 'sdangles', 'mchi', 'iwali1993', 'mwantuch', 'sjthompson09', 'lstreich', 'nnayar', 'brandonbock2015', 'thekush93', 'jorwhore124', 'martaturowski', 'jwolloch19', 'juliebloom2015', 'mdz860', 'alexandraprodriguez', 'twilmanski', 'ajh874', 'aagbeh', 'aaa766', 'wzuczek', 'lrw789', 'swaterbury', 'thomashulley', 'blee2015', 'sgier', 'rid180', 'arielmalloy', 'mbagwell', 'hbd635', 'psp502', 'ellenchoe', 'cedano', 'jmarthouse', 'jprescottsmith', 'clairemccloskey2015', 'agowani', 'malbrecht', 'mjs718', 'chasebrewster2015', 'dct353', 'bam368', 'dsgarharda001', 'helenl', 'jhenjhenn1', 'jvuong93', 'matthewmelamed2015', 'ninaor3', 'csheidinger7', 'wutangclan', 'ajit326', 'dfogel', 'fteller', 'jennastoehr2015', 'jcarrillo', 'jsk127', 'eaf591', 'hellojello44', 'hagjos', 'ckyle', 'kyletaylor', 'umerftw', 'clovo', 'squintus11', 'kspitzercohn', 'jde165', 'azaffer', 'valeriejchen', 'omowunmi', 'ewigley10', 'karlyroser2015', 'tjorda21', 'aah526', 'ssmith', 'deiden26', 'apfeiffer', 'pkf549', 'samfoolery', 'lhelfrich', 'justinwhite2014', 'rcignoni', 'zhsueh', 'asv810', 'mrt728', 'alw490', 'mrthyfau', 'phogan', 'amf997', 'tfiorica', 'ejn531', 'rhabbestad', 'klg257', 'kthakkar', 'ceterpstra', 'chammond3', 'erinyoung2015', 'kkielbania', 'lhall8695', 'asteinwald', 'omorales', 'hauserb', 'rem421', 'sadeb45', 'francesconaccarato', 'sejal', 'nancygu', 'bzelch', 'teaisfortiffany', 'rsibley', 'jennypark2015', 'mferber', 'stephanielo', 'acheatham', 'jasminealadefa2015', 'scottingham2015', 'albertsong2015', 'makrasnow15', 'djw278', 'nsisterson', 'eacostatorres', 'avillacres', 'tkiguradze', 'ryansachs2011', 'mmargritier', 'hgartner', 'khurst', 'yhc973', 'epc257', 'zaynabquadri2015', 'jcv809', 'eggfooyang', 'mariluwho4', 'matsglj', 'peteswims1818', 'kabia47', 'speysakhovich', 'cys969', 'rhj572', 'madalyngisch2015', 'mpl1002', 'whunt', 'apatrick', 'kaze', 'casey', 'roadracer1', 'elliotyucesan', 'ldk620', 'mcunningham', 'dapatriot497', 'zhosseinian', 'jmcguire', 'jdf130', 'egw955', 'vcurtis', 'tiwu', 'jky552', 'slhatch', 'clarson', 'vicky123xyz', 'sergeantnick', 'naomimerer2015', 'kkaur', 'devoraisseroff2015', 'madelinehooper', 'dianecole1', 'annacassell', 'dprivit', 'rtotten', 'asonta', 'sritchey', 'vharris', 'jlamberth8', 'enpar25', 'jennmurphy11', 'ram330', 'barcatorres', 'prabhakar.b', 'frank.parilla', 'sysmith', 'frank_avino', 'kbenintende', 'jamccarthy89', 'lfeltz78', 'seastwood', 'jkelter', 'aseitz10', 'sarahtoy', 'jkstoller', 'ras423', 'robertfisch2015', 'selkins', 'taizenman', 'jcc068', 'jbeyrau', 'dylanheck2015', 'selberts', 'lfm377', 'sfritz2015', 'pekarah', 'sfong', 'jwh252', 'sms483', 'kevjung', 'yakanbi1', 'iasega', 'cleclerq', 'abh019', None, 'noahnuta', 'yfs322', 'm.d.marcus', 'nschmidt', 'arpaskewitz', 'tjt149', 'jonfeldman', 'rachelgladney2015', 'woestreich', 'richarathore', 'dlt075', 'eric.schoenbach', 'dchon', 'akendall', 'joeentenman', 'grahajym', 'hfrudden', 'bassman211', 'sgj140', 'cbryan136', 'lcl218', 'lucasnr', 'mmcgreal', 'willoliver', 'jsadelman', 'aeyarbro', 'esp424', 'adoro', 'msp034', 'tjdohm', 'hcrippen', 'booknut467', 'randerson', 'theokelly382', 'jbbechard', 'jsemkiu', 'conniegu', 'kkbarr2015', 'atregnery', 'ejwebb92', 'amldywhite', 'mgb217', 'rachaelo', 'yhong93', 'jch507', 'dangerousdan', 'ericaminor2015', 'askzorno', 'aylinelma', 'djacobs2015', 'jch450', 'tylermanci2015', 'gracejaworski', 'hannahbeck', 'lmk232', 'hbrown', 'szaleski', 'michaelraso', 'amandatorgerson', 'tells', 'jlipsitz', 'msc958', 'zpiser', 'mabellera', 'ccoravos']"
1,52,484,214,202,"['clynsky06', 'lubben', 'mhs287', 'cgcizek', 'coolivia', 'jmarthouse', 'naomimerer2015', 'han607', 'isabelrv', 'roboro727', 'malbrecht', 'mjs718', 'ppairs', 'vnm816', 'smontgomery', 'dprivit', 'kiracalavera', 'chasebrewster2015', 'dct353', 'asonta', 'dsgarharda001', 'jrc699', 'helenl', 'ramanmichael2015', 'men544', 'jlamberth8', 'matthewmelamed2015', 'ninaor3', 'ajit326', 'jennmurphy11', 'wutangclan', 'barcatorres', 'chem102lab', 'frank.parilla', 'sysmith', 'sks491', 'jennastoehr2015', 'abl849', 'jcarrillo', 'eaf591', 'arouse', 'nfw17531', 'newcombjb', 'jkelter', 'aseitz10', 'sarahtoy', 'tpendergrast', 'robertfisch2015', 'ras423', 'jwr915', 'jthumel', 'cmd750', 'taizenman', 'azaffer', 'valeriejchen', 'omowunmi', 'abeir', 'danaya707', 'jhr252', 'jem824', 'jnephan93', 'karlyroser2015', 'tjorda21', 'chrispontisakos', 'kas042', 'askowalczuk', 'mgrollins', 'apfeiffer', 'sms483', 'slk620', 'nabroady', 'samfoolery', 'lhelfrich', 'iasega', 'rcignoni', 'cleclerq', 'zhsueh', 'wcp795', 'jkwon66', 'css539', 'asv810', 'abh019', 'mbartnovsky', 'nshaw123', 'mrt728', 'msp793', 'alw490', 'defenseman91', 'yfs322', 'nschmidt', 'sms618', 'ejn531', 'farzaankassam2015', 'jonfeldman', 'rachelgladney2015', 'ceterpstra', 'woestreich', 'richarathore', 'erinyoung2015', 'jtc143', 'michael_western2015', 'kateritter922', 'eric.schoenbach', 'alower', 'rajiv23', 'dchon', 'kkielbania', 'ees264', 'dpawletki', 'joeentenman', 'wyouman', 'mmccormick', 'rmh586', 'ntrautenberg', 'ericenu', 'rem421', 'aschlatter', 'bdolan7329', 'maddiejcole', 'bassman211', 'sejal', 'blooshnog', 'sgj140', 'cbryan136', 'karenwang2015', 'michaelcreatura2015', 'mmcgreal', 'teaisfortiffany', 'willoliver', 'rsibley', 'jennypark2015', 'mferber', 'stephanielo', 'hhung', 'kjorgensen514', 'aeyarbro', 'acheatham', 'kleung', 'adoro', 'jasminealadefa2015', 'scottingham2015', 'ghosh009', 'albertsong2015', 'makrasnow15', 'dpatel', 'cadnams', 'msp034', 'djw278', 'thomasaugust', 'krushers', 'eacostatorres', 'ryansachs2011', 'mmargritier', 'nichaaar', 'sdangles', 'gabyperea5', 'hgartner', 'zaynabquadri2015', 'sjthompson09', 'jcv809', 'eggfooyang', 'xyn711', 'nnayar', 'brandonbock2015', 'jwolloch19', 'peteswims1818', 'kabia47', 'meredyth', 'juliebloom2015', 'conniegu', 'msl333', 'cys969', 'alexandraprodriguez', 'lcn329', 'atregnery', 'ejwebb92', 'madalyngisch2015', 'mpl1002', 'ajh874', 'grk689', 'aagbeh', 'apatrick', 'tmorreale', 'wzuczek', 'ericaminor2015', 'askzorno', 'lrw789', 'cnwaelele', 'elliotyucesan', 'hannahbeck', 'sportzboy2', 'arr891', 'mcunningham', 'szaleski', 'kcolter08', 'tells', 'ericajepsen', 'msc958', 'mbagwell', 'zpiser', 'tiwu', 'psp502']",282,"['jky552', 'bspoka', 'slhatch', 'reneewharton', 'hboas', 'clarson', 'vicky123xyz', 'dpanford96', 'cedano', 'aestrada', 'msalazer', 'sergeantnick', 'clairemccloskey2015', 'caitlin2015', 'ablandford12', 'jprescottsmith', 'kkaur', 'yhong', 'agowani', 'devoraisseroff2015', 'madelinehooper', 'allisonschloss', 'dianecole1', 'annacassell', 'sarahb1', 'rtotten', 'eriedy', 'bam368', 'asampson2012', 'miayankow', 'lilib246', 'kerwinjo', 'sritchey', 'mahlbeck', 'uijungan', 'jhenjhenn1', 'eec781', 'jrc261', 'vharris', 'enpar25', 'jvuong93', 'nyeh', 'csheidinger7', 'ram330', 'dfogel', 'fteller', 'alamens', 'prabhakar.b', 'frank_avino', 'agoldman', 'clarkey2369', 'kbenintende', 'jsk127', 'athorne', 'jamccarthy89', 'ocecconi', 'lfeltz78', 'hellojello44', 'seastwood', 'hagjos', 'ckyle', 'kyletaylor', 'jkstoller', 'ayaassi93', 'umerftw', 'pozzi', 'clovo', 'squintus11', 'selkins', 'kspitzercohn', 'elenaber19', 'jde165', 'rp8988', 'juhui1215', 'mek767', 'fauxsnail', 'jcc068', 'lluc8', 'jbeyrau', 'janigus', 'julitroi', 'mnajjarpour', 'lpatras', 'epeterson', 'lgarcia', 'ewigley10', 'dylanheck2015', 'selberts', 'lfm377', 'kfan', 'sfritz2015', 'lkc503', 'twhite', 'pekarah', 'sfong', 'bwieg92', 'yusufoner', 'jwh252', 'vlc780', 'ccoravos', 'aah526', 'fmontana93', 'arthurpollard', 'ssmith', 'deiden26', 'mr.jesusleon1', 'dgainski', 'lloweth1', 'fpaulgreen', 'pkf549', 'slenzini', 'justinwhite2014', 'kevjung', 'yakanbi1', 'rdaniels', 'alex_layng', 'bbachelor', 'sbenteftifa1', 'amh690', 'imankhan2015', 'zrimsekab', 'noahnuta', 'jpt117', 'mrthyfau', 'phogan', 'abhatti', 'dfeld', 'amf997', 'm.d.marcus', 'tfiorica', 'klink07', 'vinrivera', 'jhenfran2015', 'arpaskewitz', 'rhabbestad', 'mark523', 'krf206', 'klg257', 'tjt149', 'jbascom24', 'fare', 'kthakkar', 'jahodapp', 'chammond3', 'tlar650', 'hbd635', 'bearfan92', 'ssadeghi', 'dlt075', 'cathyjo_l', 'chemlabman10', 'victoria.dubose', 'jorigoodman2015', 'rmoore', 'lhall8695', 'jessicapowers', 'creyes221', 'twilightdream37', 'hmf014', 'asteinwald', 'omorales', 'pgl314', 'akendall', 'hauserb', 'edwardcytryn2015', 'emf062', 'sadeb45', 'grahajym', 'hfrudden', 'cgutermuth', 'francesconaccarato', 'nelsonschang', 'megan.kasik', 'lcl218', 'cju107', 'nancygu', 'lucasnr', 'benwhite', 'oliviamorales', 'bzelch', 'arvindalchemist', 'hurleyjoseph', 'jsadelman', 'vanseng13', 'havs23', 'jkevern', 'hebaiyor13', 'jdong', 'sixth', 'lwulf', 'moneil', 'ameliageitz2015', 'sschoeneman', 'egw955', 'cmaikens', 'tjdohm', 'hcrippen', 'booknut467', 'cherylwang1992', 'nsisterson', 'albertren', 'avillacres', 'jsantos', 'kwooliver', 'tkiguradze', 'randerson', 'bjk', 'khurst', 'mchi', 'iwali1993', 'mwantuch', 'yhc973', 'epc257', 'theokelly382', 'lstreich', 'brycew25', 'thekush93', 'jorwhore124', 'martaturowski', 'mariluwho4', 'aspruston', 'sevangelista', 'ua_patel24', 'matsglj', 'jbbechard', 'jsemkiu', 'mdz860', 'epa268', 'speysakhovich', 'kkbarr2015', 'twilmanski', 'amldywhite', 'rhj572', 'mgb217', 'jbrutzkus', 'misaacson2015', 'rachaelo', 'yhong93', 'whunt', 'jch507', 'kaze', 'rbailey', 'aaa766', 'aylinelma', 'djacobs2015', 'rohara', 'swaterbury', 'casey', 'jch450', 'tylermanci2015', 'gracejaworski', 'roadracer1', 'thomashulley', 'ldk620', '09mcclellan21', 'whenjenn', 'dchi3', 'blee2015', 'dapatriot497', 'lmk232', 'sgier', 'mcssports1', 'hbrown', 'nickjack13', 'michaelraso', 'amandatorgerson', 'rhunter', 'jlipsitz', 'rid180', 'kek725', 'lcassens', 'arielmalloy', 'pbevacqua', 'dzdunek', 'chrysacheronis', 'zhosseinian', 'jmcguire', 'jdf130', 'camomcg', 'mabellera', 'mspiezio32', 'vcurtis']",12,"['gretskyw', 'narokkurai', 'ebeck', 'shaloni', 'ellenchoe', 'jfreedman', 'jjgordo92', 'smuehrcke', 'mvh312', 'dmalone', 'esp424', None]",496,"['bspoka', 'clynsky06', 'reneewharton', 'hboas', 'mhs287', 'dpanford96', 'aestrada', 'msalazer', 'caitlin2015', 'yhong', 'roboro727', 'allisonschloss', 'ppairs', 'vnm816', 'miayankow', 'uijungan', 'eec781', 'men544', 'jrc261', 'alamens', 'agoldman', 'sks491', 'clarkey2369', 'abl849', 'arouse', 'newcombjb', 'tpendergrast', 'jwr915', 'cmd750', 'elenaber19', 'rp8988', 'juhui1215', 'mek767', 'fauxsnail', 'lluc8', 'janigus', 'julitroi', 'danaya707', 'lpatras', 'jem824', 'kfan', 'twhite', 'chrispontisakos', 'mgrollins', 'mr.jesusleon1', 'slk620', 'fpaulgreen', 'slenzini', 'rdaniels', 'alex_layng', 'jkwon66', 'sbenteftifa1', 'mbartnovsky', 'imankhan2015', 'nshaw123', 'zrimsekab', 'msp793', 'jjgordo92', 'vinrivera', 'jhenfran2015', 'krf206', 'fare', 'ssadeghi', 'kateritter922', 'cathyjo_l', 'victoria.dubose', 'rmoore', 'jessicapowers', 'creyes221', 'twilightdream37', 'hmf014', 'pgl314', 'ntrautenberg', 'mmccormick', 'aschlatter', 'edwardcytryn2015', 'blooshnog', 'cju107', 'benwhite', 'hhung', 'kjorgensen514', 'havs23', 'jkevern', 'kleung', 'moneil', 'ameliageitz2015', 'ghosh009', 'thomasaugust', 'cadnams', 'krushers', 'albertren', 'jsantos', 'nichaaar', 'bjk', 'xyn711', 'brycew25', 'sevangelista', 'aspruston', 'ua_patel24', 'meredyth', 'msl333', 'epa268', 'lcn329', 'jbrutzkus', 'misaacson2015', 'grk689', 'rbailey', 'tmorreale', 'rohara', 'cnwaelele', 'sportzboy2', 'arr891', 'whenjenn', '09mcclellan21', 'dchi3', 'kcolter08', 'mcssports1', 'nickjack13', 'rhunter', 'ericajepsen', 'kek725', 'lcassens', 'pbevacqua', 'dzdunek', 'chrysacheronis', 'camomcg', 'lilib246', 'mspiezio32', 'gretskyw', 'ebeck', 'lubben', 'coolivia', 'cgcizek', 'han607', 'ablandford12', 'isabelrv', 'smontgomery', 'sarahb1', 'kiracalavera', 'eriedy', 'asampson2012', 'kerwinjo', 'mahlbeck', 'jrc699', 'ramanmichael2015', 'nyeh', 'chem102lab', 'athorne', 'ocecconi', 'nfw17531', 'ayaassi93', 'pozzi', 'jthumel', 'dmalone', 'mnajjarpour', 'abeir', 'epeterson', 'lgarcia', 'jhr252', 'jnephan93', 'lkc503', 'bwieg92', 'yusufoner', 'vlc780', 'kas042', 'fmontana93', 'arthurpollard', 'askowalczuk', 'dgainski', 'lloweth1', 'nabroady', 'wcp795', 'bbachelor', 'amh690', 'css539', 'jpt117', 'defenseman91', 'abhatti', 'dfeld', 'sms618', 'klink07', 'farzaankassam2015', 'mark523', 'jbascom24', 'jahodapp', 'tlar650', 'jtc143', 'michael_western2015', 'bearfan92', 'chemlabman10', 'rajiv23', 'alower', 'jorigoodman2015', 'ees264', 'dpawletki', 'wyouman', 'rmh586', 'ericenu', 'emf062', 'bdolan7329', 'cgutermuth', 'maddiejcole', 'nelsonschang', 'megan.kasik', 'karenwang2015', 'oliviamorales', 'michaelcreatura2015', 'arvindalchemist', 'jfreedman', 'hurleyjoseph', 'vanseng13', 'hebaiyor13', 'jdong', 'sixth', 'lwulf', 'sschoeneman', 'dpatel', 'cmaikens', 'cherylwang1992', 'kwooliver', 'gabyperea5', 'sdangles', 'mchi', 'iwali1993', 'mwantuch', 'sjthompson09', 'lstreich', 'nnayar', 'brandonbock2015', 'thekush93', 'jorwhore124', 'martaturowski', 'jwolloch19', 'juliebloom2015', 'mdz860', 'alexandraprodriguez', 'narokkurai', 'twilmanski', 'ajh874', 'aagbeh', 'aaa766', 'wzuczek', 'lrw789', 'swaterbury', 'thomashulley', 'blee2015', 'sgier', 'rid180', 'arielmalloy', 'mbagwell', 'hbd635', 'psp502', 'ellenchoe', 'cedano', 'jmarthouse', 'jprescottsmith', 'clairemccloskey2015', 'agowani', 'malbrecht', 'mjs718', 'shaloni', 'chasebrewster2015', 'dct353', 'bam368', 'dsgarharda001', 'helenl', 'jhenjhenn1', 'jvuong93', 'matthewmelamed2015', 'ninaor3', 'csheidinger7', 'wutangclan', 'ajit326', 'dfogel', 'fteller', 'jennastoehr2015', 'jcarrillo', 'jsk127', 'eaf591', 'mvh312', 'hellojello44', 'hagjos', 'ckyle', 'kyletaylor', 'umerftw', 'clovo', 'squintus11', 'kspitzercohn', 'jde165', 'azaffer', 'valeriejchen', 'omowunmi', 'ewigley10', 'karlyroser2015', 'tjorda21', 'aah526', 'ssmith', 'deiden26', 'apfeiffer', 'pkf549', 'samfoolery', 'lhelfrich', 'justinwhite2014', 'rcignoni', 'zhsueh', 'asv810', 'mrt728', 'alw490', 'mrthyfau', 'phogan', 'smuehrcke', 'amf997', 'tfiorica', 'ejn531', 'rhabbestad', 'klg257', 'kthakkar', 'ceterpstra', 'chammond3', 'erinyoung2015', 'kkielbania', 'lhall8695', 'asteinwald', 'omorales', 'hauserb', 'rem421', 'sadeb45', 'francesconaccarato', 'sejal', 'nancygu', 'bzelch', 'teaisfortiffany', 'rsibley', 'jennypark2015', 'mferber', 'stephanielo', 'acheatham', 'jasminealadefa2015', 'scottingham2015', 'albertsong2015', 'makrasnow15', 'djw278', 'nsisterson', 'eacostatorres', 'avillacres', 'tkiguradze', 'ryansachs2011', 'mmargritier', 'hgartner', 'khurst', 'yhc973', 'epc257', 'zaynabquadri2015', 'jcv809', 'eggfooyang', 'mariluwho4', 'matsglj', 'peteswims1818', 'kabia47', 'speysakhovich', 'cys969', 'rhj572', 'madalyngisch2015', 'mpl1002', 'whunt', 'apatrick', 'kaze', 'casey', 'roadracer1', 'elliotyucesan', 'ldk620', 'mcunningham', 'dapatriot497', 'zhosseinian', 'jmcguire', 'jdf130', 'egw955', 'vcurtis', 'tiwu', 'jky552', 'slhatch', 'clarson', 'vicky123xyz', 'sergeantnick', 'naomimerer2015', 'kkaur', 'devoraisseroff2015', 'madelinehooper', 'dianecole1', 'annacassell', 'dprivit', 'rtotten', 'asonta', 'sritchey', 'vharris', 'jlamberth8', 'enpar25', 'jennmurphy11', 'ram330', 'barcatorres', 'prabhakar.b', 'frank.parilla', 'sysmith', 'frank_avino', 'kbenintende', 'jamccarthy89', 'lfeltz78', 'seastwood', 'jkelter', 'aseitz10', 'sarahtoy', 'jkstoller', 'ras423', 'robertfisch2015', 'selkins', 'taizenman', 'jcc068', 'jbeyrau', 'dylanheck2015', 'selberts', 'lfm377', 'sfritz2015', 'pekarah', 'sfong', 'jwh252', 'sms483', 'kevjung', 'yakanbi1', 'iasega', 'cleclerq', 'abh019', None, 'noahnuta', 'yfs322', 'm.d.marcus', 'nschmidt', 'arpaskewitz', 'tjt149', 'jonfeldman', 'rachelgladney2015', 'woestreich', 'richarathore', 'dlt075', 'eric.schoenbach', 'dchon', 'akendall', 'joeentenman', 'grahajym', 'hfrudden', 'bassman211', 'sgj140', 'cbryan136', 'lcl218', 'lucasnr', 'mmcgreal', 'willoliver', 'jsadelman', 'aeyarbro', 'esp424', 'adoro', 'msp034', 'tjdohm', 'hcrippen', 'booknut467', 'randerson', 'theokelly382', 'jbbechard', 'jsemkiu', 'conniegu', 'kkbarr2015', 'atregnery', 'ejwebb92', 'amldywhite', 'mgb217', 'rachaelo', 'yhong93', 'jch507', 'ericaminor2015', 'askzorno', 'aylinelma', 'djacobs2015', 'jch450', 'tylermanci2015', 'gracejaworski', 'hannahbeck', 'lmk232', 'hbrown', 'szaleski', 'michaelraso', 'amandatorgerson', 'tells', 'jlipsitz', 'msc958', 'zpiser', 'mabellera', 'ccoravos']"
1,170,484,114,110,"['lubben', 'vicky123xyz', 'dpanford96', 'isabelrv', 'allisonschloss', 'annacassell', 'sarahb1', 'dprivit', 'rtotten', 'kiracalavera', 'dct353', 'jrc699', 'jhenjhenn1', 'eec781', 'jlamberth8', 'jennmurphy11', 'ajit326', 'dfogel', 'chem102lab', 'frank.parilla', 'sks491', 'eaf591', 'arouse', 'nfw17531', 'hellojello44', 'ras423', 'umerftw', 'jthumel', 'taizenman', 'elenaber19', 'jde165', 'omowunmi', 'valeriejchen', 'selberts', 'danaya707', 'jem824', 'vlc780', 'arthurpollard', 'slk620', 'wcp795', 'alex_layng', 'asv810', 'nshaw123', 'mrt728', 'msp793', 'ejn531', 'farzaankassam2015', 'rhabbestad', 'kthakkar', 'bearfan92', 'dlt075', 'chemlabman10', 'victoria.dubose', 'akendall', 'ees264', 'twilightdream37', 'hmf014', 'dpawletki', 'joeentenman', 'rem421', 'edwardcytryn2015', 'aschlatter', 'hfrudden', 'maddiejcole', 'bassman211', 'sejal', 'blooshnog', 'nelsonschang', 'cju107', 'michaelcreatura2015', 'willoliver', 'kjorgensen514', 'havs23', 'albertren', 'kwooliver', 'mmargritier', 'bjk', 'iwali1993', 'mwantuch', 'jcv809', 'eggfooyang', 'jwolloch19', 'peteswims1818', 'meredyth', 'juliebloom2015', 'msl333', 'epa268', 'lcn329', 'kkbarr2015', 'ejwebb92', 'twilmanski', 'amldywhite', 'rhj572', 'mgb217', 'mpl1002', 'aaa766', 'askzorno', 'jch450', 'gracejaworski', 'elliotyucesan', 'arr891', 'mcssports1', 'amandatorgerson', 'rhunter', 'ericajepsen', 'arielmalloy', 'dzdunek', 'zpiser', 'egw955', 'ccoravos']",374,"['bspoka', 'clynsky06', 'reneewharton', 'hboas', 'mhs287', 'cedano', 'aestrada', 'msalazer', 'jmarthouse', 'caitlin2015', 'jprescottsmith', 'clairemccloskey2015', 'yhong', 'agowani', 'roboro727', 'malbrecht', 'mjs718', 'ppairs', 'vnm816', 'chasebrewster2015', 'bam368', 'miayankow', 'dsgarharda001', 'uijungan', 'helenl', 'men544', 'jrc261', 'jvuong93', 'matthewmelamed2015', 'ninaor3', 'csheidinger7', 'wutangclan', 'fteller', 'alamens', 'agoldman', 'jennastoehr2015', 'clarkey2369', 'abl849', 'jcarrillo', 'jsk127', 'newcombjb', 'hagjos', 'ckyle', 'kyletaylor', 'tpendergrast', 'jwr915', 'clovo', 'squintus11', 'cmd750', 'kspitzercohn', 'rp8988', 'juhui1215', 'azaffer', 'mek767', 'fauxsnail', 'lluc8', 'janigus', 'julitroi', 'lpatras', 'ewigley10', 'kfan', 'twhite', 'karlyroser2015', 'tjorda21', 'chrispontisakos', 'aah526', 'ssmith', 'deiden26', 'mgrollins', 'mr.jesusleon1', 'apfeiffer', 'fpaulgreen', 'pkf549', 'slenzini', 'samfoolery', 'lhelfrich', 'justinwhite2014', 'rcignoni', 'rdaniels', 'jkwon66', 'sbenteftifa1', 'zhsueh', 'mbartnovsky', 'imankhan2015', 'zrimsekab', 'alw490', 'mrthyfau', 'phogan', 'amf997', 'tfiorica', 'vinrivera', 'jhenfran2015', 'krf206', 'klg257', 'fare', 'ceterpstra', 'chammond3', 'erinyoung2015', 'ssadeghi', 'kateritter922', 'cathyjo_l', 'kkielbania', 'rmoore', 'lhall8695', 'jessicapowers', 'creyes221', 'asteinwald', 'omorales', 'pgl314', 'ntrautenberg', 'mmccormick', 'hauserb', 'sadeb45', 'francesconaccarato', 'nancygu', 'benwhite', 'bzelch', 'teaisfortiffany', 'rsibley', 'jennypark2015', 'mferber', 'stephanielo', 'hhung', 'jkevern', 'acheatham', 'kleung', 'moneil', 'ameliageitz2015', 'ghosh009', 'thomasaugust', 'cadnams', 'jasminealadefa2015', 'scottingham2015', 'albertsong2015', 'makrasnow15', 'djw278', 'krushers', 'nsisterson', 'eacostatorres', 'avillacres', 'jsantos', 'tkiguradze', 'ryansachs2011', 'nichaaar', 'hgartner', 'khurst', 'yhc973', 'epc257', 'zaynabquadri2015', 'xyn711', 'brycew25', 'mariluwho4', 'matsglj', 'sevangelista', 'aspruston', 'ua_patel24', 'kabia47', 'speysakhovich', 'cys969', 'madalyngisch2015', 'jbrutzkus', 'misaacson2015', 'grk689', 'whunt', 'apatrick', 'kaze', 'rbailey', 'tmorreale', 'rohara', 'casey', 'cnwaelele', 'roadracer1', 'sportzboy2', 'whenjenn', '09mcclellan21', 'dchi3', 'ldk620', 'kcolter08', 'mcunningham', 'dapatriot497', 'nickjack13', 'kek725', 'lcassens', 'zhosseinian', 'pbevacqua', 'chrysacheronis', 'jmcguire', 'jdf130', 'camomcg', 'lilib246', 'mspiezio32', 'vcurtis', 'tiwu', 'jky552', 'slhatch', 'clarson', 'coolivia', 'cgcizek', 'sergeantnick', 'han607', 'ablandford12', 'naomimerer2015', 'kkaur', 'devoraisseroff2015', 'madelinehooper', 'dianecole1', 'smontgomery', 'eriedy', 'asampson2012', 'asonta', 'kerwinjo', 'sritchey', 'mahlbeck', 'ramanmichael2015', 'vharris', 'enpar25', 'nyeh', 'ram330', 'barcatorres', 'prabhakar.b', 'sysmith', 'frank_avino', 'kbenintende', 'athorne', 'jamccarthy89', 'ocecconi', 'lfeltz78', 'seastwood', 'jkelter', 'aseitz10', 'sarahtoy', 'jkstoller', 'ayaassi93', 'robertfisch2015', 'selkins', 'pozzi', 'jcc068', 'jbeyrau', 'mnajjarpour', 'abeir', 'dylanheck2015', 'epeterson', 'lgarcia', 'lfm377', 'jhr252', 'jnephan93', 'sfritz2015', 'lkc503', 'pekarah', 'sfong', 'bwieg92', 'yusufoner', 'jwh252', 'kas042', 'fmontana93', 'askowalczuk', 'dgainski', 'sms483', 'lloweth1', 'nabroady', 'kevjung', 'yakanbi1', 'iasega', 'cleclerq', 'bbachelor', 'amh690', 'css539', 'abh019', 'noahnuta', 'jpt117', 'defenseman91', 'abhatti', 'dfeld', 'yfs322', 'm.d.marcus', 'nschmidt', 'sms618', 'klink07', 'arpaskewitz', 'mark523', 'tjt149', 'jonfeldman', 'rachelgladney2015', 'jbascom24', 'jahodapp', 'woestreich', 'richarathore', 'tlar650', 'jtc143', 'michael_western2015', 'eric.schoenbach', 'rajiv23', 'alower', 'jorigoodman2015', 'dchon', 'wyouman', 'rmh586', 'ericenu', 'emf062', 'grahajym', 'bdolan7329', 'cgutermuth', 'sgj140', 'megan.kasik', 'cbryan136', 'lcl218', 'karenwang2015', 'lucasnr', 'oliviamorales', 'mmcgreal', 'arvindalchemist', 'hurleyjoseph', 'jsadelman', 'vanseng13', 'aeyarbro', 'hebaiyor13', 'jdong', 'sixth', 'lwulf', 'sschoeneman', 'adoro', 'msp034', 'dpatel', 'cmaikens', 'tjdohm', 'hcrippen', 'booknut467', 'cherylwang1992', 'randerson', 'gabyperea5', 'sdangles', 'mchi', 'theokelly382', 'sjthompson09', 'lstreich', 'nnayar', 'brandonbock2015', 'thekush93', 'jorwhore124', 'martaturowski', 'jbbechard', 'jsemkiu', 'mdz860', 'conniegu', 'alexandraprodriguez', 'atregnery', 'ajh874', 'aagbeh', 'rachaelo', 'yhong93', 'jch507', 'wzuczek', 'ericaminor2015', 'lrw789', 'aylinelma', 'djacobs2015', 'swaterbury', 'tylermanci2015', 'hannahbeck', 'thomashulley', 'lmk232', 'hbrown', 'blee2015', 'szaleski', 'sgier', 'michaelraso', 'tells', 'jlipsitz', 'rid180', 'msc958', 'mbagwell', 'mabellera', 'hbd635', 'psp502']",4,"[None, 'lrw183', 'akazaryan', 'osglopez']",488,"['bspoka', 'clynsky06', 'reneewharton', 'hboas', 'mhs287', 'dpanford96', 'cedano', 'aestrada', 'msalazer', 'jmarthouse', 'caitlin2015', 'jprescottsmith', 'clairemccloskey2015', 'yhong', 'agowani', 'roboro727', 'malbrecht', 'mjs718', 'allisonschloss', 'ppairs', 'vnm816', 'chasebrewster2015', 'dct353', 'bam368', 'miayankow', 'dsgarharda001', 'uijungan', 'helenl', 'jhenjhenn1', 'eec781', 'men544', 'jrc261', 'jvuong93', 'matthewmelamed2015', 'ninaor3', 'csheidinger7', 'wutangclan', 'ajit326', 'dfogel', 'fteller', 'alamens', 'agoldman', 'sks491', 'jennastoehr2015', 'clarkey2369', 'abl849', 'jcarrillo', 'jsk127', 'eaf591', 'arouse', 'hellojello44', 'newcombjb', 'hagjos', 'ckyle', 'kyletaylor', 'tpendergrast', 'jwr915', 'umerftw', 'clovo', 'squintus11', 'cmd750', 'elenaber19', 'kspitzercohn', 'rp8988', 'jde165', 'juhui1215', 'azaffer', 'mek767', 'fauxsnail', 'valeriejchen', 'omowunmi', 'lluc8', 'janigus', 'julitroi', 'danaya707', 'lpatras', 'ewigley10', 'jem824', 'kfan', 'twhite', 'karlyroser2015', 'tjorda21', 'chrispontisakos', 'aah526', 'ssmith', 'deiden26', 'mgrollins', 'mr.jesusleon1', 'apfeiffer', 'slk620', 'fpaulgreen', 'pkf549', 'slenzini', 'samfoolery', 'lhelfrich', 'justinwhite2014', 'rcignoni', 'rdaniels', 'alex_layng', 'jkwon66', 'sbenteftifa1', 'zhsueh', 'asv810', 'mbartnovsky', 'imankhan2015', 'nshaw123', 'zrimsekab', 'mrt728', 'msp793', 'alw490', 'mrthyfau', 'phogan', 'amf997', 'tfiorica', 'vinrivera', 'jhenfran2015', 'ejn531', 'rhabbestad', 'krf206', 'klg257', 'fare', 'kthakkar', 'ceterpstra', 'chammond3', 'erinyoung2015', 'ssadeghi', 'kateritter922', 'cathyjo_l', 'victoria.dubose', 'kkielbania', 'rmoore', 'lhall8695', 'jessicapowers', 'creyes221', 'twilightdream37', 'hmf014', 'asteinwald', 'omorales', 'pgl314', 'ntrautenberg', 'mmccormick', 'hauserb', 'rem421', 'aschlatter', 'edwardcytryn2015', 'sadeb45', 'blooshnog', 'francesconaccarato', 'sejal', 'cju107', 'nancygu', 'benwhite', 'bzelch', 'teaisfortiffany', 'rsibley', 'jennypark2015', 'mferber', 'stephanielo', 'hhung', 'kjorgensen514', 'havs23', 'jkevern', 'acheatham', 'kleung', 'moneil', 'ameliageitz2015', 'ghosh009', 'thomasaugust', 'cadnams', 'jasminealadefa2015', 'scottingham2015', 'albertsong2015', 'makrasnow15', 'djw278', 'krushers', 'nsisterson', 'eacostatorres', 'albertren', 'avillacres', 'jsantos', 'tkiguradze', 'ryansachs2011', 'mmargritier', 'nichaaar', 'bjk', 'hgartner', 'khurst', 'yhc973', 'epc257', 'zaynabquadri2015', 'jcv809', 'eggfooyang', 'xyn711', 'brycew25', 'mariluwho4', 'matsglj', 'sevangelista', 'aspruston', 'ua_patel24', 'meredyth', 'peteswims1818', 'kabia47', 'osglopez', 'msl333', 'epa268', 'speysakhovich', 'cys969', 'lcn329', 'rhj572', 'madalyngisch2015', 'jbrutzkus', 'mpl1002', 'misaacson2015', 'grk689', 'whunt', 'apatrick', 'kaze', 'rbailey', 'tmorreale', 'rohara', 'casey', 'cnwaelele', 'roadracer1', 'elliotyucesan', 'sportzboy2', 'arr891', 'whenjenn', '09mcclellan21', 'dchi3', 'ldk620', 'kcolter08', 'mcunningham', 'mcssports1', 'dapatriot497', 'nickjack13', 'rhunter', 'ericajepsen', 'kek725', 'lcassens', 'zhosseinian', 'pbevacqua', 'dzdunek', 'chrysacheronis', 'jmcguire', 'jdf130', 'camomcg', 'lilib246', 'mspiezio32', 'egw955', 'vcurtis', 'tiwu', 'jky552', 'slhatch', 'clarson', 'lubben', 'coolivia', 'cgcizek', 'vicky123xyz', 'sergeantnick', 'lrw183', 'han607', 'ablandford12', 'naomimerer2015', 'kkaur', 'isabelrv', 'devoraisseroff2015', 'madelinehooper', 'dianecole1', 'smontgomery', 'sarahb1', 'annacassell', 'dprivit', 'kiracalavera', 'eriedy', 'rtotten', 'asampson2012', 'asonta', 'kerwinjo', 'sritchey', 'mahlbeck', 'jrc699', 'ramanmichael2015', 'vharris', 'jlamberth8', 'enpar25', 'nyeh', 'jennmurphy11', 'ram330', 'barcatorres', 'chem102lab', 'prabhakar.b', 'frank.parilla', 'sysmith', 'frank_avino', 'kbenintende', 'athorne', 'jamccarthy89', 'ocecconi', 'lfeltz78', 'nfw17531', 'seastwood', 'jkelter', 'aseitz10', 'sarahtoy', 'jkstoller', 'ayaassi93', 'ras423', 'robertfisch2015', 'selkins', 'pozzi', 'jthumel', 'taizenman', 'jcc068', 'jbeyrau', 'mnajjarpour', 'abeir', 'dylanheck2015', 'epeterson', 'selberts', 'lgarcia', 'lfm377', 'jhr252', 'jnephan93', 'sfritz2015', 'lkc503', 'pekarah', 'sfong', 'bwieg92', 'yusufoner', 'jwh252', 'vlc780', 'kas042', 'fmontana93', 'arthurpollard', 'askowalczuk', 'dgainski', 'sms483', 'lloweth1', 'nabroady', 'kevjung', 'yakanbi1', 'iasega', 'cleclerq', 'wcp795', 'bbachelor', 'amh690', 'css539', 'abh019', None, 'noahnuta', 'jpt117', 'defenseman91', 'abhatti', 'dfeld', 'yfs322', 'm.d.marcus', 'nschmidt', 'sms618', 'klink07', 'arpaskewitz', 'farzaankassam2015', 'mark523', 'tjt149', 'jonfeldman', 'rachelgladney2015', 'jbascom24', 'jahodapp', 'woestreich', 'richarathore', 'tlar650', 'jtc143', 'michael_western2015', 'bearfan92', 'dlt075', 'eric.schoenbach', 'chemlabman10', 'rajiv23', 'alower', 'jorigoodman2015', 'dchon', 'akendall', 'ees264', 'dpawletki', 'wyouman', 'joeentenman', 'rmh586', 'ericenu', 'emf062', 'grahajym', 'bdolan7329', 'hfrudden', 'cgutermuth', 'maddiejcole', 'bassman211', 'sgj140', 'nelsonschang', 'megan.kasik', 'cbryan136', 'lcl218', 'karenwang2015', 'lucasnr', 'oliviamorales', 'michaelcreatura2015', 'mmcgreal', 'arvindalchemist', 'willoliver', 'hurleyjoseph', 'jsadelman', 'vanseng13', 'aeyarbro', 'hebaiyor13', 'jdong', 'sixth', 'lwulf', 'sschoeneman', 'adoro', 'msp034', 'dpatel', 'cmaikens', 'tjdohm', 'hcrippen', 'booknut467', 'cherylwang1992', 'akazaryan', 'kwooliver', 'randerson', 'gabyperea5', 'sdangles', 'mchi', 'iwali1993', 'mwantuch', 'theokelly382', 'sjthompson09', 'lstreich', 'nnayar', 'brandonbock2015', 'thekush93', 'jorwhore124', 'martaturowski', 'jwolloch19', 'jbbechard', 'jsemkiu', 'juliebloom2015', 'mdz860', 'conniegu', 'alexandraprodriguez', 'kkbarr2015', 'atregnery', 'ejwebb92', 'twilmanski', 'amldywhite', 'mgb217', 'ajh874', 'aagbeh', 'rachaelo', 'yhong93', 'jch507', 'aaa766', 'wzuczek', 'ericaminor2015', 'askzorno', 'lrw789', 'aylinelma', 'djacobs2015', 'swaterbury', 'jch450', 'tylermanci2015', 'gracejaworski', 'hannahbeck', 'thomashulley', 'lmk232', 'hbrown', 'blee2015', 'szaleski', 'sgier', 'michaelraso', 'amandatorgerson', 'tells', 'jlipsitz', 'rid180', 'msc958', 'arielmalloy', 'mbagwell', 'zpiser', 'mabellera', 'hbd635', 'ccoravos', 'psp502']"
1,208,484,22,15,"['mmccormick', 'szaleski', 'bspoka', 'cadnams', 'theokelly382', 'noahnuta', 'djw278', 'nickjack13', 'pozzi', 'rp8988', 'cgutermuth', 'mariluwho4', 'yhong', 'julitroi', 'khurst']",469,"['clynsky06', 'reneewharton', 'hboas', 'mhs287', 'dpanford96', 'cedano', 'aestrada', 'msalazer', 'jmarthouse', 'caitlin2015', 'jprescottsmith', 'clairemccloskey2015', 'agowani', 'roboro727', 'malbrecht', 'mjs718', 'allisonschloss', 'ppairs', 'vnm816', 'chasebrewster2015', 'dct353', 'bam368', 'miayankow', 'dsgarharda001', 'uijungan', 'helenl', 'jhenjhenn1', 'eec781', 'men544', 'jrc261', 'jvuong93', 'matthewmelamed2015', 'ninaor3', 'csheidinger7', 'wutangclan', 'ajit326', 'dfogel', 'fteller', 'alamens', 'agoldman', 'sks491', 'jennastoehr2015', 'clarkey2369', 'abl849', 'jcarrillo', 'jsk127', 'eaf591', 'arouse', 'hellojello44', 'newcombjb', 'hagjos', 'ckyle', 'kyletaylor', 'tpendergrast', 'jwr915', 'umerftw', 'clovo', 'squintus11', 'cmd750', 'elenaber19', 'kspitzercohn', 'jde165', 'juhui1215', 'azaffer', 'mek767', 'fauxsnail', 'valeriejchen', 'omowunmi', 'lluc8', 'janigus', 'danaya707', 'lpatras', 'ewigley10', 'jem824', 'kfan', 'twhite', 'karlyroser2015', 'tjorda21', 'chrispontisakos', 'aah526', 'ssmith', 'deiden26', 'mgrollins', 'mr.jesusleon1', 'apfeiffer', 'slk620', 'fpaulgreen', 'pkf549', 'slenzini', 'samfoolery', 'lhelfrich', 'justinwhite2014', 'rcignoni', 'rdaniels', 'alex_layng', 'jkwon66', 'sbenteftifa1', 'zhsueh', 'asv810', 'mbartnovsky', 'imankhan2015', 'nshaw123', 'zrimsekab', 'mrt728', 'msp793', 'alw490', 'mrthyfau', 'phogan', 'amf997', 'tfiorica', 'vinrivera', 'jhenfran2015', 'ejn531', 'rhabbestad', 'krf206', 'klg257', 'fare', 'kthakkar', 'ceterpstra', 'chammond3', 'erinyoung2015', 'ssadeghi', 'kateritter922', 'cathyjo_l', 'victoria.dubose', 'kkielbania', 'rmoore', 'lhall8695', 'jessicapowers', 'creyes221', 'twilightdream37', 'hmf014', 'asteinwald', 'omorales', 'pgl314', 'ntrautenberg', 'hauserb', 'rem421', 'aschlatter', 'edwardcytryn2015', 'sadeb45', 'blooshnog', 'francesconaccarato', 'sejal', 'cju107', 'nancygu', 'benwhite', 'bzelch', 'teaisfortiffany', 'rsibley', 'jennypark2015', 'mferber', 'stephanielo', 'hhung', 'kjorgensen514', 'havs23', 'jkevern', 'acheatham', 'kleung', 'moneil', 'ameliageitz2015', 'ghosh009', 'thomasaugust', 'jasminealadefa2015', 'scottingham2015', 'albertsong2015', 'makrasnow15', 'krushers', 'nsisterson', 'eacostatorres', 'albertren', 'avillacres', 'jsantos', 'tkiguradze', 'ryansachs2011', 'mmargritier', 'nichaaar', 'bjk', 'hgartner', 'yhc973', 'epc257', 'zaynabquadri2015', 'jcv809', 'eggfooyang', 'xyn711', 'brycew25', 'matsglj', 'sevangelista', 'aspruston', 'ua_patel24', 'meredyth', 'peteswims1818', 'kabia47', 'msl333', 'epa268', 'speysakhovich', 'cys969', 'lcn329', 'rhj572', 'madalyngisch2015', 'jbrutzkus', 'mpl1002', 'misaacson2015', 'grk689', 'whunt', 'apatrick', 'kaze', 'rbailey', 'tmorreale', 'rohara', 'casey', 'cnwaelele', 'roadracer1', 'elliotyucesan', 'sportzboy2', 'arr891', 'whenjenn', '09mcclellan21', 'dchi3', 'ldk620', 'kcolter08', 'mcunningham', 'mcssports1', 'dapatriot497', 'rhunter', 'ericajepsen', 'kek725', 'lcassens', 'zhosseinian', 'pbevacqua', 'dzdunek', 'chrysacheronis', 'jmcguire', 'jdf130', 'camomcg', 'lilib246', 'mspiezio32', 'egw955', 'vcurtis', 'tiwu', 'jky552', 'slhatch', 'clarson', 'lubben', 'coolivia', 'cgcizek', 'vicky123xyz', 'sergeantnick', 'han607', 'ablandford12', 'naomimerer2015', 'kkaur', 'isabelrv', 'devoraisseroff2015', 'madelinehooper', 'dianecole1', 'smontgomery', 'sarahb1', 'annacassell', 'dprivit', 'kiracalavera', 'eriedy', 'rtotten', 'asampson2012', 'asonta', 'kerwinjo', 'sritchey', 'mahlbeck', 'jrc699', 'ramanmichael2015', 'vharris', 'jlamberth8', 'enpar25', 'nyeh', 'jennmurphy11', 'ram330', 'barcatorres', 'chem102lab', 'prabhakar.b', 'frank.parilla', 'sysmith', 'frank_avino', 'kbenintende', 'athorne', 'jamccarthy89', 'ocecconi', 'lfeltz78', 'nfw17531', 'seastwood', 'jkelter', 'aseitz10', 'sarahtoy', 'jkstoller', 'ayaassi93', 'ras423', 'robertfisch2015', 'selkins', 'jthumel', 'taizenman', 'jcc068', 'jbeyrau', 'mnajjarpour', 'abeir', 'dylanheck2015', 'epeterson', 'selberts', 'lgarcia', 'lfm377', 'jhr252', 'jnephan93', 'sfritz2015', 'lkc503', 'pekarah', 'sfong', 'bwieg92', 'yusufoner', 'jwh252', 'vlc780', 'kas042', 'fmontana93', 'arthurpollard', 'askowalczuk', 'dgainski', 'sms483', 'lloweth1', 'nabroady', 'kevjung', 'yakanbi1', 'iasega', 'cleclerq', 'wcp795', 'bbachelor', 'amh690', 'css539', 'abh019', 'jpt117', 'defenseman91', 'abhatti', 'dfeld', 'yfs322', 'm.d.marcus', 'nschmidt', 'sms618', 'klink07', 'arpaskewitz', 'farzaankassam2015', 'mark523', 'tjt149', 'jonfeldman', 'rachelgladney2015', 'jbascom24', 'jahodapp', 'woestreich', 'richarathore', 'tlar650', 'jtc143', 'michael_western2015', 'bearfan92', 'dlt075', 'eric.schoenbach', 'chemlabman10', 'rajiv23', 'alower', 'jorigoodman2015', 'dchon', 'akendall', 'ees264', 'dpawletki', 'wyouman', 'joeentenman', 'rmh586', 'ericenu', 'emf062', 'grahajym', 'bdolan7329', 'hfrudden', 'maddiejcole', 'bassman211', 'sgj140', 'nelsonschang', 'megan.kasik', 'cbryan136', 'lcl218', 'karenwang2015', 'lucasnr', 'oliviamorales', 'michaelcreatura2015', 'mmcgreal', 'arvindalchemist', 'willoliver', 'hurleyjoseph', 'jsadelman', 'vanseng13', 'aeyarbro', 'hebaiyor13', 'jdong', 'sixth', 'lwulf', 'sschoeneman', 'adoro', 'msp034', 'dpatel', 'cmaikens', 'tjdohm', 'hcrippen', 'booknut467', 'cherylwang1992', 'kwooliver', 'randerson', 'gabyperea5', 'sdangles', 'mchi', 'iwali1993', 'mwantuch', 'sjthompson09', 'lstreich', 'nnayar', 'brandonbock2015', 'thekush93', 'jorwhore124', 'martaturowski', 'jwolloch19', 'jbbechard', 'jsemkiu', 'juliebloom2015', 'mdz860', 'conniegu', 'alexandraprodriguez', 'kkbarr2015', 'atregnery', 'ejwebb92', 'twilmanski', 'amldywhite', 'mgb217', 'ajh874', 'aagbeh', 'rachaelo', 'yhong93', 'jch507', 'aaa766', 'wzuczek', 'ericaminor2015', 'askzorno', 'lrw789', 'aylinelma', 'djacobs2015', 'swaterbury', 'jch450', 'tylermanci2015', 'gracejaworski', 'hannahbeck', 'thomashulley', 'lmk232', 'hbrown', 'blee2015', 'sgier', 'michaelraso', 'amandatorgerson', 'tells', 'jlipsitz', 'rid180', 'msc958', 'arielmalloy', 'mbagwell', 'zpiser', 'mabellera', 'hbd635', 'ccoravos', 'psp502']",7,"['ericsmoll', 'mrb716', 'hartze', 'jszekely', 'cegras', None, 'yshzhang88']",491,"['bspoka', 'clynsky06', 'reneewharton', 'hboas', 'mhs287', 'dpanford96', 'cedano', 'aestrada', 'msalazer', 'jmarthouse', 'caitlin2015', 'jprescottsmith', 'clairemccloskey2015', 'yhong', 'agowani', 'roboro727', 'malbrecht', 'mjs718', 'allisonschloss', 'ppairs', 'vnm816', 'chasebrewster2015', 'dct353', 'bam368', 'miayankow', 'dsgarharda001', 'uijungan', 'helenl', 'jhenjhenn1', 'yshzhang88', 'eec781', 'men544', 'jrc261', 'jvuong93', 'matthewmelamed2015', 'ninaor3', 'csheidinger7', 'wutangclan', 'ajit326', 'dfogel', 'fteller', 'alamens', 'agoldman', 'sks491', 'jennastoehr2015', 'clarkey2369', 'abl849', 'jcarrillo', 'jsk127', 'eaf591', 'arouse', 'hellojello44', 'newcombjb', 'hagjos', 'ckyle', 'kyletaylor', 'tpendergrast', 'jwr915', 'umerftw', 'clovo', 'squintus11', 'cmd750', 'elenaber19', 'kspitzercohn', 'rp8988', 'jde165', 'juhui1215', 'azaffer', 'mek767', 'fauxsnail', 'valeriejchen', 'omowunmi', 'lluc8', 'janigus', 'julitroi', 'danaya707', 'lpatras', 'ewigley10', 'jem824', 'kfan', 'twhite', 'karlyroser2015', 'tjorda21', 'chrispontisakos', 'aah526', 'ssmith', 'deiden26', 'mgrollins', 'mr.jesusleon1', 'apfeiffer', 'slk620', 'fpaulgreen', 'pkf549', 'slenzini', 'samfoolery', 'lhelfrich', 'justinwhite2014', 'rcignoni', 'rdaniels', 'alex_layng', 'jkwon66', 'sbenteftifa1', 'zhsueh', 'asv810', 'mbartnovsky', 'imankhan2015', 'nshaw123', 'zrimsekab', 'mrt728', 'msp793', 'alw490', 'mrthyfau', 'phogan', 'amf997', 'tfiorica', 'vinrivera', 'jhenfran2015', 'ejn531', 'rhabbestad', 'krf206', 'klg257', 'fare', 'kthakkar', 'ceterpstra', 'chammond3', 'erinyoung2015', 'ssadeghi', 'kateritter922', 'cathyjo_l', 'victoria.dubose', 'kkielbania', 'rmoore', 'lhall8695', 'jessicapowers', 'creyes221', 'twilightdream37', 'hmf014', 'asteinwald', 'omorales', 'pgl314', 'ntrautenberg', 'mmccormick', 'hauserb', 'rem421', 'aschlatter', 'edwardcytryn2015', 'sadeb45', 'blooshnog', 'francesconaccarato', 'sejal', 'cju107', 'nancygu', 'benwhite', 'bzelch', 'teaisfortiffany', 'rsibley', 'jennypark2015', 'mferber', 'stephanielo', 'hhung', 'kjorgensen514', 'havs23', 'jkevern', 'acheatham', 'kleung', 'moneil', 'ameliageitz2015', 'ghosh009', 'thomasaugust', 'cadnams', 'jasminealadefa2015', 'scottingham2015', 'albertsong2015', 'makrasnow15', 'djw278', 'hartze', 'krushers', 'nsisterson', 'eacostatorres', 'albertren', 'avillacres', 'jsantos', 'tkiguradze', 'ryansachs2011', 'mmargritier', 'nichaaar', 'bjk', 'hgartner', 'khurst', 'yhc973', 'epc257', 'zaynabquadri2015', 'jcv809', 'eggfooyang', 'xyn711', 'brycew25', 'mariluwho4', 'matsglj', 'sevangelista', 'aspruston', 'ua_patel24', 'meredyth', 'peteswims1818', 'kabia47', 'msl333', 'epa268', 'speysakhovich', 'cys969', 'lcn329', 'rhj572', 'madalyngisch2015', 'jbrutzkus', 'mpl1002', 'misaacson2015', 'grk689', 'whunt', 'apatrick', 'kaze', 'rbailey', 'tmorreale', 'jszekely', 'rohara', 'casey', 'cnwaelele', 'roadracer1', 'elliotyucesan', 'sportzboy2', 'arr891', 'whenjenn', '09mcclellan21', 'dchi3', 'ldk620', 'kcolter08', 'mcunningham', 'mcssports1', 'dapatriot497', 'nickjack13', 'rhunter', 'ericajepsen', 'kek725', 'lcassens', 'zhosseinian', 'pbevacqua', 'dzdunek', 'chrysacheronis', 'jmcguire', 'jdf130', 'camomcg', 'lilib246', 'mspiezio32', 'egw955', 'vcurtis', 'tiwu', 'jky552', 'slhatch', 'clarson', 'lubben', 'coolivia', 'cgcizek', 'vicky123xyz', 'sergeantnick', 'han607', 'ablandford12', 'naomimerer2015', 'kkaur', 'isabelrv', 'devoraisseroff2015', 'madelinehooper', 'dianecole1', 'smontgomery', 'sarahb1', 'annacassell', 'dprivit', 'kiracalavera', 'eriedy', 'rtotten', 'asampson2012', 'asonta', 'kerwinjo', 'sritchey', 'mahlbeck', 'jrc699', 'ramanmichael2015', 'vharris', 'jlamberth8', 'enpar25', 'nyeh', 'jennmurphy11', 'ram330', 'barcatorres', 'chem102lab', 'prabhakar.b', 'frank.parilla', 'sysmith', 'frank_avino', 'kbenintende', 'athorne', 'jamccarthy89', 'ocecconi', 'lfeltz78', 'nfw17531', 'seastwood', 'jkelter', 'aseitz10', 'sarahtoy', 'jkstoller', 'ayaassi93', 'ras423', 'robertfisch2015', 'selkins', 'pozzi', 'jthumel', 'taizenman', 'jcc068', 'jbeyrau', 'mnajjarpour', 'abeir', 'dylanheck2015', 'epeterson', 'selberts', 'lgarcia', 'lfm377', 'jhr252', 'jnephan93', 'sfritz2015', 'lkc503', 'pekarah', 'sfong', 'bwieg92', 'yusufoner', 'jwh252', 'vlc780', 'kas042', 'fmontana93', 'arthurpollard', 'askowalczuk', 'dgainski', 'sms483', 'lloweth1', 'nabroady', 'kevjung', 'yakanbi1', 'iasega', 'cleclerq', 'wcp795', 'bbachelor', 'amh690', 'css539', 'abh019', None, 'noahnuta', 'jpt117', 'defenseman91', 'abhatti', 'dfeld', 'yfs322', 'm.d.marcus', 'nschmidt', 'sms618', 'klink07', 'arpaskewitz', 'farzaankassam2015', 'mark523', 'tjt149', 'jonfeldman', 'rachelgladney2015', 'jbascom24', 'jahodapp', 'woestreich', 'richarathore', 'tlar650', 'jtc143', 'michael_western2015', 'bearfan92', 'dlt075', 'eric.schoenbach', 'chemlabman10', 'rajiv23', 'alower', 'cegras', 'jorigoodman2015', 'dchon', 'akendall', 'ees264', 'dpawletki', 'wyouman', 'joeentenman', 'rmh586', 'ericenu', 'mrb716', 'emf062', 'grahajym', 'bdolan7329', 'hfrudden', 'cgutermuth', 'maddiejcole', 'bassman211', 'sgj140', 'nelsonschang', 'megan.kasik', 'cbryan136', 'lcl218', 'karenwang2015', 'lucasnr', 'oliviamorales', 'michaelcreatura2015', 'mmcgreal', 'arvindalchemist', 'willoliver', 'hurleyjoseph', 'jsadelman', 'vanseng13', 'aeyarbro', 'hebaiyor13', 'jdong', 'sixth', 'lwulf', 'sschoeneman', 'adoro', 'msp034', 'dpatel', 'cmaikens', 'tjdohm', 'hcrippen', 'booknut467', 'cherylwang1992', 'kwooliver', 'randerson', 'gabyperea5', 'sdangles', 'mchi', 'iwali1993', 'mwantuch', 'theokelly382', 'sjthompson09', 'lstreich', 'nnayar', 'brandonbock2015', 'thekush93', 'jorwhore124', 'martaturowski', 'jwolloch19', 'jbbechard', 'jsemkiu', 'juliebloom2015', 'mdz860', 'conniegu', 'ericsmoll', 'alexandraprodriguez', 'kkbarr2015', 'atregnery', 'ejwebb92', 'twilmanski', 'amldywhite', 'mgb217', 'ajh874', 'aagbeh', 'rachaelo', 'yhong93', 'jch507', 'aaa766', 'wzuczek', 'ericaminor2015', 'askzorno', 'lrw789', 'aylinelma', 'djacobs2015', 'swaterbury', 'jch450', 'tylermanci2015', 'gracejaworski', 'hannahbeck', 'thomashulley', 'lmk232', 'hbrown', 'blee2015', 'szaleski', 'sgier', 'michaelraso', 'amandatorgerson', 'tells', 'jlipsitz', 'rid180', 'msc958', 'arielmalloy', 'mbagwell', 'zpiser', 'mabellera', 'hbd635', 'ccoravos', 'psp502']"
1,211,484,21,20,"['juhui1215', 'brycew25', 'jbbechard', 'lhall8695', 'lluc8', 'janigus', 'eriedy', 'sadeb45', 'grahajym', 'rachaelo', 'enpar25', 'rdaniels', 'jkevern', 'cmaikens', 'mrthyfau', 'klink07', 'vinrivera', 'hagjos', 'camomcg', 'ckyle']",464,"['bspoka', 'clynsky06', 'reneewharton', 'hboas', 'mhs287', 'dpanford96', 'cedano', 'aestrada', 'msalazer', 'jmarthouse', 'caitlin2015', 'jprescottsmith', 'clairemccloskey2015', 'yhong', 'agowani', 'roboro727', 'malbrecht', 'mjs718', 'allisonschloss', 'ppairs', 'vnm816', 'chasebrewster2015', 'dct353', 'bam368', 'miayankow', 'dsgarharda001', 'uijungan', 'helenl', 'jhenjhenn1', 'eec781', 'men544', 'jrc261', 'jvuong93', 'matthewmelamed2015', 'ninaor3', 'csheidinger7', 'wutangclan', 'ajit326', 'dfogel', 'fteller', 'alamens', 'agoldman', 'sks491', 'jennastoehr2015', 'clarkey2369', 'abl849', 'jcarrillo', 'jsk127', 'eaf591', 'arouse', 'hellojello44', 'newcombjb', 'kyletaylor', 'tpendergrast', 'jwr915', 'umerftw', 'clovo', 'squintus11', 'cmd750', 'elenaber19', 'kspitzercohn', 'rp8988', 'jde165', 'azaffer', 'mek767', 'fauxsnail', 'valeriejchen', 'omowunmi', 'julitroi', 'danaya707', 'lpatras', 'ewigley10', 'jem824', 'kfan', 'twhite', 'karlyroser2015', 'tjorda21', 'chrispontisakos', 'aah526', 'ssmith', 'deiden26', 'mgrollins', 'mr.jesusleon1', 'apfeiffer', 'slk620', 'fpaulgreen', 'pkf549', 'slenzini', 'samfoolery', 'lhelfrich', 'justinwhite2014', 'rcignoni', 'alex_layng', 'jkwon66', 'sbenteftifa1', 'zhsueh', 'asv810', 'mbartnovsky', 'imankhan2015', 'nshaw123', 'zrimsekab', 'mrt728', 'msp793', 'alw490', 'phogan', 'amf997', 'tfiorica', 'jhenfran2015', 'ejn531', 'rhabbestad', 'krf206', 'klg257', 'fare', 'kthakkar', 'ceterpstra', 'chammond3', 'erinyoung2015', 'ssadeghi', 'kateritter922', 'cathyjo_l', 'victoria.dubose', 'kkielbania', 'rmoore', 'jessicapowers', 'creyes221', 'twilightdream37', 'hmf014', 'asteinwald', 'omorales', 'pgl314', 'ntrautenberg', 'mmccormick', 'hauserb', 'rem421', 'aschlatter', 'edwardcytryn2015', 'blooshnog', 'francesconaccarato', 'sejal', 'cju107', 'nancygu', 'benwhite', 'bzelch', 'teaisfortiffany', 'rsibley', 'jennypark2015', 'mferber', 'stephanielo', 'hhung', 'kjorgensen514', 'havs23', 'acheatham', 'kleung', 'moneil', 'ameliageitz2015', 'ghosh009', 'thomasaugust', 'cadnams', 'jasminealadefa2015', 'scottingham2015', 'albertsong2015', 'makrasnow15', 'djw278', 'krushers', 'nsisterson', 'eacostatorres', 'albertren', 'avillacres', 'jsantos', 'tkiguradze', 'ryansachs2011', 'mmargritier', 'nichaaar', 'bjk', 'hgartner', 'khurst', 'yhc973', 'epc257', 'zaynabquadri2015', 'jcv809', 'eggfooyang', 'xyn711', 'mariluwho4', 'matsglj', 'sevangelista', 'aspruston', 'ua_patel24', 'meredyth', 'peteswims1818', 'kabia47', 'msl333', 'epa268', 'speysakhovich', 'cys969', 'lcn329', 'rhj572', 'madalyngisch2015', 'jbrutzkus', 'mpl1002', 'misaacson2015', 'grk689', 'whunt', 'apatrick', 'kaze', 'rbailey', 'tmorreale', 'rohara', 'casey', 'cnwaelele', 'roadracer1', 'elliotyucesan', 'sportzboy2', 'arr891', 'whenjenn', '09mcclellan21', 'dchi3', 'ldk620', 'kcolter08', 'mcunningham', 'mcssports1', 'dapatriot497', 'nickjack13', 'rhunter', 'ericajepsen', 'kek725', 'lcassens', 'zhosseinian', 'pbevacqua', 'dzdunek', 'chrysacheronis', 'jmcguire', 'jdf130', 'lilib246', 'mspiezio32', 'egw955', 'vcurtis', 'tiwu', 'jky552', 'slhatch', 'clarson', 'lubben', 'coolivia', 'cgcizek', 'vicky123xyz', 'sergeantnick', 'han607', 'ablandford12', 'naomimerer2015', 'kkaur', 'isabelrv', 'devoraisseroff2015', 'madelinehooper', 'dianecole1', 'smontgomery', 'sarahb1', 'annacassell', 'dprivit', 'kiracalavera', 'rtotten', 'asampson2012', 'asonta', 'kerwinjo', 'sritchey', 'mahlbeck', 'jrc699', 'ramanmichael2015', 'vharris', 'jlamberth8', 'nyeh', 'jennmurphy11', 'ram330', 'barcatorres', 'chem102lab', 'prabhakar.b', 'frank.parilla', 'sysmith', 'frank_avino', 'kbenintende', 'athorne', 'jamccarthy89', 'ocecconi', 'lfeltz78', 'nfw17531', 'seastwood', 'jkelter', 'aseitz10', 'sarahtoy', 'jkstoller', 'ayaassi93', 'ras423', 'robertfisch2015', 'selkins', 'pozzi', 'jthumel', 'taizenman', 'jcc068', 'jbeyrau', 'mnajjarpour', 'abeir', 'dylanheck2015', 'epeterson', 'selberts', 'lgarcia', 'lfm377', 'jhr252', 'jnephan93', 'sfritz2015', 'lkc503', 'pekarah', 'sfong', 'bwieg92', 'yusufoner', 'jwh252', 'vlc780', 'kas042', 'fmontana93', 'arthurpollard', 'askowalczuk', 'dgainski', 'sms483', 'lloweth1', 'nabroady', 'kevjung', 'yakanbi1', 'iasega', 'cleclerq', 'wcp795', 'bbachelor', 'amh690', 'css539', 'abh019', 'noahnuta', 'jpt117', 'defenseman91', 'abhatti', 'dfeld', 'yfs322', 'm.d.marcus', 'nschmidt', 'sms618', 'arpaskewitz', 'farzaankassam2015', 'mark523', 'tjt149', 'jonfeldman', 'rachelgladney2015', 'jbascom24', 'jahodapp', 'woestreich', 'richarathore', 'tlar650', 'jtc143', 'michael_western2015', 'bearfan92', 'dlt075', 'eric.schoenbach', 'chemlabman10', 'rajiv23', 'alower', 'jorigoodman2015', 'dchon', 'akendall', 'ees264', 'dpawletki', 'wyouman', 'joeentenman', 'rmh586', 'ericenu', 'emf062', 'bdolan7329', 'hfrudden', 'cgutermuth', 'maddiejcole', 'bassman211', 'sgj140', 'nelsonschang', 'megan.kasik', 'cbryan136', 'lcl218', 'karenwang2015', 'lucasnr', 'oliviamorales', 'michaelcreatura2015', 'mmcgreal', 'arvindalchemist', 'willoliver', 'hurleyjoseph', 'jsadelman', 'vanseng13', 'aeyarbro', 'hebaiyor13', 'jdong', 'sixth', 'lwulf', 'sschoeneman', 'adoro', 'msp034', 'dpatel', 'tjdohm', 'hcrippen', 'booknut467', 'cherylwang1992', 'kwooliver', 'randerson', 'gabyperea5', 'sdangles', 'mchi', 'iwali1993', 'mwantuch', 'theokelly382', 'sjthompson09', 'lstreich', 'nnayar', 'brandonbock2015', 'thekush93', 'jorwhore124', 'martaturowski', 'jwolloch19', 'jsemkiu', 'juliebloom2015', 'mdz860', 'conniegu', 'alexandraprodriguez', 'kkbarr2015', 'atregnery', 'ejwebb92', 'twilmanski', 'amldywhite', 'mgb217', 'ajh874', 'aagbeh', 'yhong93', 'jch507', 'aaa766', 'wzuczek', 'ericaminor2015', 'askzorno', 'lrw789', 'aylinelma', 'djacobs2015', 'swaterbury', 'jch450', 'tylermanci2015', 'gracejaworski', 'hannahbeck', 'thomashulley', 'lmk232', 'hbrown', 'blee2015', 'szaleski', 'sgier', 'michaelraso', 'amandatorgerson', 'tells', 'jlipsitz', 'rid180', 'msc958', 'arielmalloy', 'mbagwell', 'zpiser', 'mabellera', 'hbd635', 'ccoravos', 'psp502']",1,[None],485,"['bspoka', 'clynsky06', 'reneewharton', 'hboas', 'mhs287', 'dpanford96', 'cedano', 'aestrada', 'msalazer', 'jmarthouse', 'caitlin2015', 'jprescottsmith', 'clairemccloskey2015', 'yhong', 'agowani', 'roboro727', 'malbrecht', 'mjs718', 'allisonschloss', 'ppairs', 'vnm816', 'chasebrewster2015', 'dct353', 'bam368', 'miayankow', 'dsgarharda001', 'uijungan', 'helenl', 'jhenjhenn1', 'eec781', 'men544', 'jrc261', 'jvuong93', 'matthewmelamed2015', 'ninaor3', 'csheidinger7', 'wutangclan', 'ajit326', 'dfogel', 'fteller', 'alamens', 'agoldman', 'sks491', 'jennastoehr2015', 'clarkey2369', 'abl849', 'jcarrillo', 'jsk127', 'eaf591', 'arouse', 'hellojello44', 'newcombjb', 'hagjos', 'ckyle', 'kyletaylor', 'tpendergrast', 'jwr915', 'umerftw', 'clovo', 'squintus11', 'cmd750', 'elenaber19', 'kspitzercohn', 'rp8988', 'jde165', 'juhui1215', 'azaffer', 'mek767', 'fauxsnail', 'valeriejchen', 'omowunmi', 'lluc8', 'janigus', 'julitroi', 'danaya707', 'lpatras', 'ewigley10', 'jem824', 'kfan', 'twhite', 'karlyroser2015', 'tjorda21', 'chrispontisakos', 'aah526', 'ssmith', 'deiden26', 'mgrollins', 'mr.jesusleon1', 'apfeiffer', 'slk620', 'fpaulgreen', 'pkf549', 'slenzini', 'samfoolery', 'lhelfrich', 'justinwhite2014', 'rcignoni', 'rdaniels', 'alex_layng', 'jkwon66', 'sbenteftifa1', 'zhsueh', 'asv810', 'mbartnovsky', 'imankhan2015', 'nshaw123', 'zrimsekab', 'mrt728', 'msp793', 'alw490', 'mrthyfau', 'phogan', 'amf997', 'tfiorica', 'vinrivera', 'jhenfran2015', 'ejn531', 'rhabbestad', 'krf206', 'klg257', 'fare', 'kthakkar', 'ceterpstra', 'chammond3', 'erinyoung2015', 'ssadeghi', 'kateritter922', 'cathyjo_l', 'victoria.dubose', 'kkielbania', 'rmoore', 'lhall8695', 'jessicapowers', 'creyes221', 'twilightdream37', 'hmf014', 'asteinwald', 'omorales', 'pgl314', 'ntrautenberg', 'mmccormick', 'hauserb', 'rem421', 'aschlatter', 'edwardcytryn2015', 'sadeb45', 'blooshnog', 'francesconaccarato', 'sejal', 'cju107', 'nancygu', 'benwhite', 'bzelch', 'teaisfortiffany', 'rsibley', 'jennypark2015', 'mferber', 'stephanielo', 'hhung', 'kjorgensen514', 'havs23', 'jkevern', 'acheatham', 'kleung', 'moneil', 'ameliageitz2015', 'ghosh009', 'thomasaugust', 'cadnams', 'jasminealadefa2015', 'scottingham2015', 'albertsong2015', 'makrasnow15', 'djw278', 'krushers', 'nsisterson', 'eacostatorres', 'albertren', 'avillacres', 'jsantos', 'tkiguradze', 'ryansachs2011', 'mmargritier', 'nichaaar', 'bjk', 'hgartner', 'khurst', 'yhc973', 'epc257', 'zaynabquadri2015', 'jcv809', 'eggfooyang', 'xyn711', 'brycew25', 'mariluwho4', 'matsglj', 'sevangelista', 'aspruston', 'ua_patel24', 'meredyth', 'peteswims1818', 'kabia47', 'msl333', 'epa268', 'speysakhovich', 'cys969', 'lcn329', 'rhj572', 'madalyngisch2015', 'jbrutzkus', 'mpl1002', 'misaacson2015', 'grk689', 'whunt', 'apatrick', 'kaze', 'rbailey', 'tmorreale', 'rohara', 'casey', 'cnwaelele', 'roadracer1', 'elliotyucesan', 'sportzboy2', 'arr891', 'whenjenn', '09mcclellan21', 'dchi3', 'ldk620', 'kcolter08', 'mcunningham', 'mcssports1', 'dapatriot497', 'nickjack13', 'rhunter', 'ericajepsen', 'kek725', 'lcassens', 'zhosseinian', 'pbevacqua', 'dzdunek', 'chrysacheronis', 'jmcguire', 'jdf130', 'camomcg', 'lilib246', 'mspiezio32', 'egw955', 'vcurtis', 'tiwu', 'jky552', 'slhatch', 'clarson', 'lubben', 'coolivia', 'cgcizek', 'vicky123xyz', 'sergeantnick', 'han607', 'ablandford12', 'naomimerer2015', 'kkaur', 'isabelrv', 'devoraisseroff2015', 'madelinehooper', 'dianecole1', 'smontgomery', 'sarahb1', 'annacassell', 'dprivit', 'kiracalavera', 'eriedy', 'rtotten', 'asampson2012', 'asonta', 'kerwinjo', 'sritchey', 'mahlbeck', 'jrc699', 'ramanmichael2015', 'vharris', 'jlamberth8', 'enpar25', 'nyeh', 'jennmurphy11', 'ram330', 'barcatorres', 'chem102lab', 'prabhakar.b', 'frank.parilla', 'sysmith', 'frank_avino', 'kbenintende', 'athorne', 'jamccarthy89', 'ocecconi', 'lfeltz78', 'nfw17531', 'seastwood', 'jkelter', 'aseitz10', 'sarahtoy', 'jkstoller', 'ayaassi93', 'ras423', 'robertfisch2015', 'selkins', 'pozzi', 'jthumel', 'taizenman', 'jcc068', 'jbeyrau', 'mnajjarpour', 'abeir', 'dylanheck2015', 'epeterson', 'selberts', 'lgarcia', 'lfm377', 'jhr252', 'jnephan93', 'sfritz2015', 'lkc503', 'pekarah', 'sfong', 'bwieg92', 'yusufoner', 'jwh252', 'vlc780', 'kas042', 'fmontana93', 'arthurpollard', 'askowalczuk', 'dgainski', 'sms483', 'lloweth1', 'nabroady', 'kevjung', 'yakanbi1', 'iasega', 'cleclerq', 'wcp795', 'bbachelor', 'amh690', 'css539', 'abh019', None, 'noahnuta', 'jpt117', 'defenseman91', 'abhatti', 'dfeld', 'yfs322', 'm.d.marcus', 'nschmidt', 'sms618', 'klink07', 'arpaskewitz', 'farzaankassam2015', 'mark523', 'tjt149', 'jonfeldman', 'rachelgladney2015', 'jbascom24', 'jahodapp', 'woestreich', 'richarathore', 'tlar650', 'jtc143', 'michael_western2015', 'bearfan92', 'dlt075', 'eric.schoenbach', 'chemlabman10', 'rajiv23', 'alower', 'jorigoodman2015', 'dchon', 'akendall', 'ees264', 'dpawletki', 'wyouman', 'joeentenman', 'rmh586', 'ericenu', 'emf062', 'grahajym', 'bdolan7329', 'hfrudden', 'cgutermuth', 'maddiejcole', 'bassman211', 'sgj140', 'nelsonschang', 'megan.kasik', 'cbryan136', 'lcl218', 'karenwang2015', 'lucasnr', 'oliviamorales', 'michaelcreatura2015', 'mmcgreal', 'arvindalchemist', 'willoliver', 'hurleyjoseph', 'jsadelman', 'vanseng13', 'aeyarbro', 'hebaiyor13', 'jdong', 'sixth', 'lwulf', 'sschoeneman', 'adoro', 'msp034', 'dpatel', 'cmaikens', 'tjdohm', 'hcrippen', 'booknut467', 'cherylwang1992', 'kwooliver', 'randerson', 'gabyperea5', 'sdangles', 'mchi', 'iwali1993', 'mwantuch', 'theokelly382', 'sjthompson09', 'lstreich', 'nnayar', 'brandonbock2015', 'thekush93', 'jorwhore124', 'martaturowski', 'jwolloch19', 'jbbechard', 'jsemkiu', 'juliebloom2015', 'mdz860', 'conniegu', 'alexandraprodriguez', 'kkbarr2015', 'atregnery', 'ejwebb92', 'twilmanski', 'amldywhite', 'mgb217', 'ajh874', 'aagbeh', 'rachaelo', 'yhong93', 'jch507', 'aaa766', 'wzuczek', 'ericaminor2015', 'askzorno', 'lrw789', 'aylinelma', 'djacobs2015', 'swaterbury', 'jch450', 'tylermanci2015', 'gracejaworski', 'hannahbeck', 'thomashulley', 'lmk232', 'hbrown', 'blee2015', 'szaleski', 'sgier', 'michaelraso', 'amandatorgerson', 'tells', 'jlipsitz', 'rid180', 'msc958', 'arielmalloy', 'mbagwell', 'zpiser', 'mabellera', 'hbd635', 'ccoravos', 'psp502']"
1,210,484,6,5,"['zhosseinian', 'nsisterson', 'abhatti', 'm.d.marcus', 'tkiguradze']",479,"['bspoka', 'clynsky06', 'reneewharton', 'hboas', 'mhs287', 'dpanford96', 'cedano', 'aestrada', 'msalazer', 'jmarthouse', 'caitlin2015', 'jprescottsmith', 'clairemccloskey2015', 'yhong', 'agowani', 'roboro727', 'malbrecht', 'mjs718', 'allisonschloss', 'ppairs', 'vnm816', 'chasebrewster2015', 'dct353', 'bam368', 'miayankow', 'dsgarharda001', 'uijungan', 'helenl', 'jhenjhenn1', 'eec781', 'men544', 'jrc261', 'jvuong93', 'matthewmelamed2015', 'ninaor3', 'csheidinger7', 'wutangclan', 'ajit326', 'dfogel', 'fteller', 'alamens', 'agoldman', 'sks491', 'jennastoehr2015', 'clarkey2369', 'abl849', 'jcarrillo', 'jsk127', 'eaf591', 'arouse', 'hellojello44', 'newcombjb', 'hagjos', 'ckyle', 'kyletaylor', 'tpendergrast', 'jwr915', 'umerftw', 'clovo', 'squintus11', 'cmd750', 'elenaber19', 'kspitzercohn', 'rp8988', 'jde165', 'juhui1215', 'azaffer', 'mek767', 'fauxsnail', 'valeriejchen', 'omowunmi', 'lluc8', 'janigus', 'julitroi', 'danaya707', 'lpatras', 'ewigley10', 'jem824', 'kfan', 'twhite', 'karlyroser2015', 'tjorda21', 'chrispontisakos', 'aah526', 'ssmith', 'deiden26', 'mgrollins', 'mr.jesusleon1', 'apfeiffer', 'slk620', 'fpaulgreen', 'pkf549', 'slenzini', 'samfoolery', 'lhelfrich', 'justinwhite2014', 'rcignoni', 'rdaniels', 'alex_layng', 'jkwon66', 'sbenteftifa1', 'zhsueh', 'asv810', 'mbartnovsky', 'imankhan2015', 'nshaw123', 'zrimsekab', 'mrt728', 'msp793', 'alw490', 'mrthyfau', 'phogan', 'amf997', 'tfiorica', 'vinrivera', 'jhenfran2015', 'ejn531', 'rhabbestad', 'krf206', 'klg257', 'fare', 'kthakkar', 'ceterpstra', 'chammond3', 'erinyoung2015', 'ssadeghi', 'kateritter922', 'cathyjo_l', 'victoria.dubose', 'kkielbania', 'rmoore', 'lhall8695', 'jessicapowers', 'creyes221', 'twilightdream37', 'hmf014', 'asteinwald', 'omorales', 'pgl314', 'ntrautenberg', 'mmccormick', 'hauserb', 'rem421', 'aschlatter', 'edwardcytryn2015', 'sadeb45', 'blooshnog', 'francesconaccarato', 'sejal', 'cju107', 'nancygu', 'benwhite', 'bzelch', 'teaisfortiffany', 'rsibley', 'jennypark2015', 'mferber', 'stephanielo', 'hhung', 'kjorgensen514', 'havs23', 'jkevern', 'acheatham', 'kleung', 'moneil', 'ameliageitz2015', 'ghosh009', 'thomasaugust', 'cadnams', 'jasminealadefa2015', 'scottingham2015', 'albertsong2015', 'makrasnow15', 'djw278', 'krushers', 'eacostatorres', 'albertren', 'avillacres', 'jsantos', 'ryansachs2011', 'mmargritier', 'nichaaar', 'bjk', 'hgartner', 'khurst', 'yhc973', 'epc257', 'zaynabquadri2015', 'jcv809', 'eggfooyang', 'xyn711', 'brycew25', 'mariluwho4', 'matsglj', 'sevangelista', 'aspruston', 'ua_patel24', 'meredyth', 'peteswims1818', 'kabia47', 'msl333', 'epa268', 'speysakhovich', 'cys969', 'lcn329', 'rhj572', 'madalyngisch2015', 'jbrutzkus', 'mpl1002', 'misaacson2015', 'grk689', 'whunt', 'apatrick', 'kaze', 'rbailey', 'tmorreale', 'rohara', 'casey', 'cnwaelele', 'roadracer1', 'elliotyucesan', 'sportzboy2', 'arr891', 'whenjenn', '09mcclellan21', 'dchi3', 'ldk620', 'kcolter08', 'mcunningham', 'mcssports1', 'dapatriot497', 'nickjack13', 'rhunter', 'ericajepsen', 'kek725', 'lcassens', 'pbevacqua', 'dzdunek', 'chrysacheronis', 'jmcguire', 'jdf130', 'camomcg', 'lilib246', 'mspiezio32', 'egw955', 'vcurtis', 'tiwu', 'jky552', 'slhatch', 'clarson', 'lubben', 'coolivia', 'cgcizek', 'vicky123xyz', 'sergeantnick', 'han607', 'ablandford12', 'naomimerer2015', 'kkaur', 'isabelrv', 'devoraisseroff2015', 'madelinehooper', 'dianecole1', 'smontgomery', 'sarahb1', 'annacassell', 'dprivit', 'kiracalavera', 'eriedy', 'rtotten', 'asampson2012', 'asonta', 'kerwinjo', 'sritchey', 'mahlbeck', 'jrc699', 'ramanmichael2015', 'vharris', 'jlamberth8', 'enpar25', 'nyeh', 'jennmurphy11', 'ram330', 'barcatorres', 'chem102lab', 'prabhakar.b', 'frank.parilla', 'sysmith', 'frank_avino', 'kbenintende', 'athorne', 'jamccarthy89', 'ocecconi', 'lfeltz78', 'nfw17531', 'seastwood', 'jkelter', 'aseitz10', 'sarahtoy', 'jkstoller', 'ayaassi93', 'ras423', 'robertfisch2015', 'selkins', 'pozzi', 'jthumel', 'taizenman', 'jcc068', 'jbeyrau', 'mnajjarpour', 'abeir', 'dylanheck2015', 'epeterson', 'selberts', 'lgarcia', 'lfm377', 'jhr252', 'jnephan93', 'sfritz2015', 'lkc503', 'pekarah', 'sfong', 'bwieg92', 'yusufoner', 'jwh252', 'vlc780', 'kas042', 'fmontana93', 'arthurpollard', 'askowalczuk', 'dgainski', 'sms483', 'lloweth1', 'nabroady', 'kevjung', 'yakanbi1', 'iasega', 'cleclerq', 'wcp795', 'bbachelor', 'amh690', 'css539', 'abh019', 'noahnuta', 'jpt117', 'defenseman91', 'dfeld', 'yfs322', 'nschmidt', 'sms618', 'klink07', 'arpaskewitz', 'farzaankassam2015', 'mark523', 'tjt149', 'jonfeldman', 'rachelgladney2015', 'jbascom24', 'jahodapp', 'woestreich', 'richarathore', 'tlar650', 'jtc143', 'michael_western2015', 'bearfan92', 'dlt075', 'eric.schoenbach', 'chemlabman10', 'rajiv23', 'alower', 'jorigoodman2015', 'dchon', 'akendall', 'ees264', 'dpawletki', 'wyouman', 'joeentenman', 'rmh586', 'ericenu', 'emf062', 'grahajym', 'bdolan7329', 'hfrudden', 'cgutermuth', 'maddiejcole', 'bassman211', 'sgj140', 'nelsonschang', 'megan.kasik', 'cbryan136', 'lcl218', 'karenwang2015', 'lucasnr', 'oliviamorales', 'michaelcreatura2015', 'mmcgreal', 'arvindalchemist', 'willoliver', 'hurleyjoseph', 'jsadelman', 'vanseng13', 'aeyarbro', 'hebaiyor13', 'jdong', 'sixth', 'lwulf', 'sschoeneman', 'adoro', 'msp034', 'dpatel', 'cmaikens', 'tjdohm', 'hcrippen', 'booknut467', 'cherylwang1992', 'kwooliver', 'randerson', 'gabyperea5', 'sdangles', 'mchi', 'iwali1993', 'mwantuch', 'theokelly382', 'sjthompson09', 'lstreich', 'nnayar', 'brandonbock2015', 'thekush93', 'jorwhore124', 'martaturowski', 'jwolloch19', 'jbbechard', 'jsemkiu', 'juliebloom2015', 'mdz860', 'conniegu', 'alexandraprodriguez', 'kkbarr2015', 'atregnery', 'ejwebb92', 'twilmanski', 'amldywhite', 'mgb217', 'ajh874', 'aagbeh', 'rachaelo', 'yhong93', 'jch507', 'aaa766', 'wzuczek', 'ericaminor2015', 'askzorno', 'lrw789', 'aylinelma', 'djacobs2015', 'swaterbury', 'jch450', 'tylermanci2015', 'gracejaworski', 'hannahbeck', 'thomashulley', 'lmk232', 'hbrown', 'blee2015', 'szaleski', 'sgier', 'michaelraso', 'amandatorgerson', 'tells', 'jlipsitz', 'rid180', 'msc958', 'arielmalloy', 'mbagwell', 'zpiser', 'mabellera', 'hbd635', 'ccoravos', 'psp502']",1,[None],485,"['bspoka', 'clynsky06', 'reneewharton', 'hboas', 'mhs287', 'dpanford96', 'cedano', 'aestrada', 'msalazer', 'jmarthouse', 'caitlin2015', 'jprescottsmith', 'clairemccloskey2015', 'yhong', 'agowani', 'roboro727', 'malbrecht', 'mjs718', 'allisonschloss', 'ppairs', 'vnm816', 'chasebrewster2015', 'dct353', 'bam368', 'miayankow', 'dsgarharda001', 'uijungan', 'helenl', 'jhenjhenn1', 'eec781', 'men544', 'jrc261', 'jvuong93', 'matthewmelamed2015', 'ninaor3', 'csheidinger7', 'wutangclan', 'ajit326', 'dfogel', 'fteller', 'alamens', 'agoldman', 'sks491', 'jennastoehr2015', 'clarkey2369', 'abl849', 'jcarrillo', 'jsk127', 'eaf591', 'arouse', 'hellojello44', 'newcombjb', 'hagjos', 'ckyle', 'kyletaylor', 'tpendergrast', 'jwr915', 'umerftw', 'clovo', 'squintus11', 'cmd750', 'elenaber19', 'kspitzercohn', 'rp8988', 'jde165', 'juhui1215', 'azaffer', 'mek767', 'fauxsnail', 'valeriejchen', 'omowunmi', 'lluc8', 'janigus', 'julitroi', 'danaya707', 'lpatras', 'ewigley10', 'jem824', 'kfan', 'twhite', 'karlyroser2015', 'tjorda21', 'chrispontisakos', 'aah526', 'ssmith', 'deiden26', 'mgrollins', 'mr.jesusleon1', 'apfeiffer', 'slk620', 'fpaulgreen', 'pkf549', 'slenzini', 'samfoolery', 'lhelfrich', 'justinwhite2014', 'rcignoni', 'rdaniels', 'alex_layng', 'jkwon66', 'sbenteftifa1', 'zhsueh', 'asv810', 'mbartnovsky', 'imankhan2015', 'nshaw123', 'zrimsekab', 'mrt728', 'msp793', 'alw490', 'mrthyfau', 'phogan', 'amf997', 'tfiorica', 'vinrivera', 'jhenfran2015', 'ejn531', 'rhabbestad', 'krf206', 'klg257', 'fare', 'kthakkar', 'ceterpstra', 'chammond3', 'erinyoung2015', 'ssadeghi', 'kateritter922', 'cathyjo_l', 'victoria.dubose', 'kkielbania', 'rmoore', 'lhall8695', 'jessicapowers', 'creyes221', 'twilightdream37', 'hmf014', 'asteinwald', 'omorales', 'pgl314', 'ntrautenberg', 'mmccormick', 'hauserb', 'rem421', 'aschlatter', 'edwardcytryn2015', 'sadeb45', 'blooshnog', 'francesconaccarato', 'sejal', 'cju107', 'nancygu', 'benwhite', 'bzelch', 'teaisfortiffany', 'rsibley', 'jennypark2015', 'mferber', 'stephanielo', 'hhung', 'kjorgensen514', 'havs23', 'jkevern', 'acheatham', 'kleung', 'moneil', 'ameliageitz2015', 'ghosh009', 'thomasaugust', 'cadnams', 'jasminealadefa2015', 'scottingham2015', 'albertsong2015', 'makrasnow15', 'djw278', 'krushers', 'nsisterson', 'eacostatorres', 'albertren', 'avillacres', 'jsantos', 'tkiguradze', 'ryansachs2011', 'mmargritier', 'nichaaar', 'bjk', 'hgartner', 'khurst', 'yhc973', 'epc257', 'zaynabquadri2015', 'jcv809', 'eggfooyang', 'xyn711', 'brycew25', 'mariluwho4', 'matsglj', 'sevangelista', 'aspruston', 'ua_patel24', 'meredyth', 'peteswims1818', 'kabia47', 'msl333', 'epa268', 'speysakhovich', 'cys969', 'lcn329', 'rhj572', 'madalyngisch2015', 'jbrutzkus', 'mpl1002', 'misaacson2015', 'grk689', 'whunt', 'apatrick', 'kaze', 'rbailey', 'tmorreale', 'rohara', 'casey', 'cnwaelele', 'roadracer1', 'elliotyucesan', 'sportzboy2', 'arr891', 'whenjenn', '09mcclellan21', 'dchi3', 'ldk620', 'kcolter08', 'mcunningham', 'mcssports1', 'dapatriot497', 'nickjack13', 'rhunter', 'ericajepsen', 'kek725', 'lcassens', 'zhosseinian', 'pbevacqua', 'dzdunek', 'chrysacheronis', 'jmcguire', 'jdf130', 'camomcg', 'lilib246', 'mspiezio32', 'egw955', 'vcurtis', 'tiwu', 'jky552', 'slhatch', 'clarson', 'lubben', 'coolivia', 'cgcizek', 'vicky123xyz', 'sergeantnick', 'han607', 'ablandford12', 'naomimerer2015', 'kkaur', 'isabelrv', 'devoraisseroff2015', 'madelinehooper', 'dianecole1', 'smontgomery', 'sarahb1', 'annacassell', 'dprivit', 'kiracalavera', 'eriedy', 'rtotten', 'asampson2012', 'asonta', 'kerwinjo', 'sritchey', 'mahlbeck', 'jrc699', 'ramanmichael2015', 'vharris', 'jlamberth8', 'enpar25', 'nyeh', 'jennmurphy11', 'ram330', 'barcatorres', 'chem102lab', 'prabhakar.b', 'frank.parilla', 'sysmith', 'frank_avino', 'kbenintende', 'athorne', 'jamccarthy89', 'ocecconi', 'lfeltz78', 'nfw17531', 'seastwood', 'jkelter', 'aseitz10', 'sarahtoy', 'jkstoller', 'ayaassi93', 'ras423', 'robertfisch2015', 'selkins', 'pozzi', 'jthumel', 'taizenman', 'jcc068', 'jbeyrau', 'mnajjarpour', 'abeir', 'dylanheck2015', 'epeterson', 'selberts', 'lgarcia', 'lfm377', 'jhr252', 'jnephan93', 'sfritz2015', 'lkc503', 'pekarah', 'sfong', 'bwieg92', 'yusufoner', 'jwh252', 'vlc780', 'kas042', 'fmontana93', 'arthurpollard', 'askowalczuk', 'dgainski', 'sms483', 'lloweth1', 'nabroady', 'kevjung', 'yakanbi1', 'iasega', 'cleclerq', 'wcp795', 'bbachelor', 'amh690', 'css539', 'abh019', None, 'noahnuta', 'jpt117', 'defenseman91', 'abhatti', 'dfeld', 'yfs322', 'm.d.marcus', 'nschmidt', 'sms618', 'klink07', 'arpaskewitz', 'farzaankassam2015', 'mark523', 'tjt149', 'jonfeldman', 'rachelgladney2015', 'jbascom24', 'jahodapp', 'woestreich', 'richarathore', 'tlar650', 'jtc143', 'michael_western2015', 'bearfan92', 'dlt075', 'eric.schoenbach', 'chemlabman10', 'rajiv23', 'alower', 'jorigoodman2015', 'dchon', 'akendall', 'ees264', 'dpawletki', 'wyouman', 'joeentenman', 'rmh586', 'ericenu', 'emf062', 'grahajym', 'bdolan7329', 'hfrudden', 'cgutermuth', 'maddiejcole', 'bassman211', 'sgj140', 'nelsonschang', 'megan.kasik', 'cbryan136', 'lcl218', 'karenwang2015', 'lucasnr', 'oliviamorales', 'michaelcreatura2015', 'mmcgreal', 'arvindalchemist', 'willoliver', 'hurleyjoseph', 'jsadelman', 'vanseng13', 'aeyarbro', 'hebaiyor13', 'jdong', 'sixth', 'lwulf', 'sschoeneman', 'adoro', 'msp034', 'dpatel', 'cmaikens', 'tjdohm', 'hcrippen', 'booknut467', 'cherylwang1992', 'kwooliver', 'randerson', 'gabyperea5', 'sdangles', 'mchi', 'iwali1993', 'mwantuch', 'theokelly382', 'sjthompson09', 'lstreich', 'nnayar', 'brandonbock2015', 'thekush93', 'jorwhore124', 'martaturowski', 'jwolloch19', 'jbbechard', 'jsemkiu', 'juliebloom2015', 'mdz860', 'conniegu', 'alexandraprodriguez', 'kkbarr2015', 'atregnery', 'ejwebb92', 'twilmanski', 'amldywhite', 'mgb217', 'ajh874', 'aagbeh', 'rachaelo', 'yhong93', 'jch507', 'aaa766', 'wzuczek', 'ericaminor2015', 'askzorno', 'lrw789', 'aylinelma', 'djacobs2015', 'swaterbury', 'jch450', 'tylermanci2015', 'gracejaworski', 'hannahbeck', 'thomashulley', 'lmk232', 'hbrown', 'blee2015', 'szaleski', 'sgier', 'michaelraso', 'amandatorgerson', 'tells', 'jlipsitz', 'rid180', 'msc958', 'arielmalloy', 'mbagwell', 'zpiser', 'mabellera', 'hbd635', 'ccoravos', 'psp502']"
2,89,164,132,96,"['dhuang123', 'nookala', 'bae10', 'melurie03', 'b3nny312', 'oknoel', 'gobias', 'fredhdx', 'lshi14', 'johns149', 'muneebahmed95', 'boertew1', 'sherrypri', 'snanav3', 'hronik1', 'jkinne2', 'sfanou2', '1upgreenshroom', 'siwin2', 'sutchaya', 'neilchristanto', 'kumikknd', 'wang183', 'ewalt1', 'maddali1', 'cernaus1', 'hartant2', 'hoang4', 'profballack', 'gong10', 'nanotie', 'malik15', 'madigan5', 'alabi2', 'feng12', 'mikenike', 'swarley', 'lidazhu1', 'yjaquinas', 'mazzola1', 'wlee26', 'wanchoi1', 'luiszelaya', 'keating7', 'blee51', 'maxcan', 'leiche1', 'chrisgoulet', 'samuelzhang', 'achavarria', 'tatuhiro', 'pashea1', 'geschreyr', 'shapir11', 'kwak27', 'zeqiuwu1', 'emma', 'foxytop', 'brittovivek', 'jielv1', 'toblerone16', 'bony', 'jksikai', 'nam18', 'szhang51', 'jataput1', 'lupas2', 'kilpatr2', 'mikeudelhofen', 'amnueyp1', 'mihrenoe', 'theerasit', 'jtlust3', 'aczerepak', 'stuber1', 'kim563', 'piyawon1', 'gazdzia1', 'williamhn', 'bector1', 'roloscool', 'yun19', 'ddanielw', 'jain53', 'ludao822', 'hasken1', 'hchao2', 'hazypensieve', 'gloger', '8kobe24', 'hgao10', 'stephenyzc', 'genome852', 'morris57', 'ucapssong', 'tischer1']",67,"['jiwonp224', 'chan1cyrus2', 'lucasmac37', 'ekapin2', 'weberxzq', 'chan32', 'monnett1', 'alostu3', 'arvman', 'case7', 'xiaoyr068', 'rice14', 'trovill1', 'yuanweih', 'spesard1', 'chellia1', 'lee117', 'jlorozc2', 'kgiacobazzi', 'bhchen2', 'sunjialin', 'wente1', 'qliu9', 'diliber1', 'geethabijjam', 'kandel3', 'shawkat', 'fandi514', 'griffi21', 'supermeatboy', 'ericwoo1', 'donner1', 'greenwa1', 'moy21', 'edavilax', 'jclift3', 'btanabe2', 'zhou60', 'handa1', 'kadakiy1', 'heebidiwup', 'nmisak', 'gavinwinkel', 'mroczek1', 'dahlke2', 'dferrell68', 'novawater', 'mckiern1', 'mattycat9000', 'dicksonsalim', 'lu30', 'mstlyhrmlss', 'levitas1', 'devharlalka', 'alex81388', 'weber36', 'vargas3', 'deasey1', 'hatfarm', 'spadin1', 'tchajed', 'omghaxcode', 'banerje1', 'hardy6', 'jefflale', 'mraval', 'lobert124']",36,"['mahed', 'liao24hoho', 'searuff', 'liyd', 'moon1002', 'dubois1', 'zulueta1', 'congshanwan', 'kchuang5', 'mrwilsonsaid', 'sundar0301', 'esanch29', 'okekeoc1', 'hur6', 'nkingw', 'mjy5', 'mim1c', 'ysun12', 'azam2', 'menghuang', 'miketeufel1', 'sgrand2', 'ssingh18', None, 'kim405', 'baoshi314', 'qiu12', 'zhangyj', 'savankadakiya', 'shawnwin1234', 'jkim449', 'daybreak410039', 'panlei616', 'coolcrew', 'tsai11', 'pranav9']",199,"['dhuang123', 'nookala', 'bae10', 'lucasmac37', 'ekapin2', 'chan32', 'case7', 'moon1002', 'melurie03', 'b3nny312', 'jlorozc2', 'kgiacobazzi', 'bhchen2', 'oknoel', 'gobias', 'sunjialin', 'fredhdx', 'lshi14', 'shawkat', 'esanch29', 'johns149', 'muneebahmed95', 'boertew1', 'sherrypri', 'hronik1', 'snanav3', 'jkinne2', 'sfanou2', '1upgreenshroom', 'siwin2', 'sutchaya', 'baoshi314', 'vargas3', 'deasey1', 'kumikknd', 'neilchristanto', 'wang183', 'savankadakiya', 'shawnwin1234', 'omghaxcode', 'daybreak410039', 'ewalt1', 'banerje1', 'coolcrew', 'trovill1', 'lobert124', 'maddali1', 'chan1cyrus2', 'cernaus1', 'pranav9', 'hartant2', 'jiwonp224', 'hoang4', 'profballack', 'gong10', 'alostu3', 'xiaoyr068', 'nanotie', 'spesard1', 'chellia1', 'malik15', 'congshanwan', 'qliu9', 'madigan5', 'alabi2', 'sundar0301', 'supermeatboy', 'ericwoo1', 'feng12', 'mjy5', 'greenwa1', 'mikenike', 'jclift3', 'zhou60', 'heebidiwup', 'swarley', 'gavinwinkel', 'yjaquinas', 'lidazhu1', 'mazzola1', 'azam2', 'menghuang', 'novawater', 'mattycat9000', 'wlee26', 'lu30', 'ssingh18', 'mstlyhrmlss', 'levitas1', None, 'kim405', 'qiu12', 'zhangyj', 'wanchoi1', 'hatfarm', 'luiszelaya', 'spadin1', 'keating7', 'blee51', 'maxcan', 'leiche1', 'chrisgoulet', 'achavarria', 'samuelzhang', 'mahed', 'liao24hoho', 'searuff', 'weberxzq', 'tatuhiro', 'rice14', 'pashea1', 'yuanweih', 'dubois1', 'geschreyr', 'zulueta1', 'kwak27', 'shapir11', 'zeqiuwu1', 'mraval', 'emma', 'foxytop', 'brittovivek', 'jielv1', 'toblerone16', 'okekeoc1', 'hur6', 'bony', 'nkingw', 'donner1', 'moy21', 'jksikai', 'nam18', 'szhang51', 'mim1c', 'handa1', 'jataput1', 'miketeufel1', 'lupas2', 'kilpatr2', 'sgrand2', 'mikeudelhofen', 'amnueyp1', 'alex81388', 'mihrenoe', 'weber36', 'theerasit', 'tchajed', 'jtlust3', 'hardy6', 'aczerepak', 'stuber1', 'piyawon1', 'kim563', 'kandel3', 'gazdzia1', 'williamhn', 'liyd', 'monnett1', 'bector1', 'arvman', 'roloscool', 'yun19', 'ddanielw', 'lee117', 'kchuang5', 'jain53', 'wente1', 'diliber1', 'geethabijjam', 'mrwilsonsaid', 'fandi514', 'ludao822', 'griffi21', 'edavilax', 'btanabe2', 'hasken1', 'kadakiy1', 'hchao2', 'nmisak', 'mroczek1', 'hazypensieve', 'gloger', 'dahlke2', 'hgao10', '8kobe24', 'dferrell68', 'ysun12', 'mckiern1', 'stephenyzc', 'genome852', 'dicksonsalim', 'morris57', 'devharlalka', 'ucapssong', 'tsai11', 'jkim449', 'panlei616', 'jefflale', 'tischer1']"
2,43,164,130,99,"['dhuang123', 'nookala', 'bae10', 'lucasmac37', 'melurie03', 'oknoel', 'jlorozc2', 'fredhdx', 'lshi14', 'johns149', 'muneebahmed95', 'boertew1', 'sherrypri', 'snanav3', 'jkinne2', 'sfanou2', '1upgreenshroom', 'siwin2', 'sutchaya', 'neilchristanto', 'kumikknd', 'wang183', 'ewalt1', 'maddali1', 'cernaus1', 'hartant2', 'jiwonp224', 'hoang4', 'profballack', 'gong10', 'alostu3', 'nanotie', 'malik15', 'alabi2', 'supermeatboy', 'mikenike', 'jclift3', 'yjaquinas', 'lidazhu1', 'wlee26', 'lu30', 'levitas1', 'wanchoi1', 'spadin1', 'luiszelaya', 'keating7', 'hatfarm', 'blee51', 'maxcan', 'leiche1', 'samuelzhang', 'achavarria', 'weberxzq', 'tatuhiro', 'rice14', 'pashea1', 'yuanweih', 'kwak27', 'zeqiuwu1', 'mraval', 'emma', 'foxytop', 'brittovivek', 'toblerone16', 'bony', 'jksikai', 'nam18', 'szhang51', 'handa1', 'jataput1', 'kilpatr2', 'mikeudelhofen', 'alex81388', 'mihrenoe', 'jtlust3', 'tchajed', 'aczerepak', 'stuber1', 'kim563', 'williamhn', 'yun19', 'ddanielw', 'lee117', 'jain53', 'geethabijjam', 'ludao822', 'btanabe2', 'hasken1', 'kadakiy1', 'hchao2', 'nmisak', 'hazypensieve', '8kobe24', 'hgao10', 'stephenyzc', 'genome852', 'morris57', 'ucapssong', 'tischer1']",64,"['gazdzia1', 'chan1cyrus2', 'ekapin2', 'chan32', 'monnett1', 'bector1', 'arvman', 'case7', 'xiaoyr068', 'roloscool', 'trovill1', 'geschreyr', 'spesard1', 'chellia1', 'b3nny312', 'kgiacobazzi', 'bhchen2', 'shapir11', 'gobias', 'sunjialin', 'qliu9', 'wente1', 'diliber1', 'madigan5', 'jielv1', 'kandel3', 'shawkat', 'fandi514', 'griffi21', 'ericwoo1', 'feng12', 'donner1', 'greenwa1', 'moy21', 'edavilax', 'zhou60', 'heebidiwup', 'swarley', 'gavinwinkel', 'mroczek1', 'gloger', 'mazzola1', 'dahlke2', 'dferrell68', 'novawater', 'mckiern1', 'hronik1', 'mattycat9000', 'lupas2', 'dicksonsalim', 'mstlyhrmlss', 'devharlalka', 'amnueyp1', 'weber36', 'vargas3', 'deasey1', 'theerasit', 'omghaxcode', 'banerje1', 'hardy6', 'jefflale', 'piyawon1', 'chrisgoulet', 'lobert124']",31,"['mahed', 'jashari1', 'congshan', 'taoyang', 'reebbhaa', 'parsoj', 'liyd', 'moon1002', 'kchuang5', 'redyoshi49q', 'okekeoc1', 'roboemperor', 'ysun12', 'menghuang', 'miketeufel1', 'rushx1', 'broll1', 'ssingh18', 'sgrand2', None, 'dmoonxp5', 'wdyarthas', 'wang227', 'qiu12', 'tsai11', 'shawnwin1234', 'yao10', 'daybreak410039', 'panlei616', 'coolcrew', 'akshay17567']",194,"['dhuang123', 'nookala', 'bae10', 'lucasmac37', 'ekapin2', 'parsoj', 'chan32', 'case7', 'moon1002', 'melurie03', 'b3nny312', 'jlorozc2', 'kgiacobazzi', 'bhchen2', 'oknoel', 'gobias', 'sunjialin', 'fredhdx', 'lshi14', 'redyoshi49q', 'shawkat', 'johns149', 'muneebahmed95', 'boertew1', 'sherrypri', 'hronik1', 'snanav3', 'jkinne2', 'sfanou2', '1upgreenshroom', 'siwin2', 'sutchaya', 'vargas3', 'deasey1', 'kumikknd', 'neilchristanto', 'wang183', 'shawnwin1234', 'omghaxcode', 'daybreak410039', 'ewalt1', 'banerje1', 'coolcrew', 'trovill1', 'lobert124', 'maddali1', 'chan1cyrus2', 'cernaus1', 'hartant2', 'jiwonp224', 'hoang4', 'profballack', 'gong10', 'reebbhaa', 'alostu3', 'xiaoyr068', 'nanotie', 'spesard1', 'chellia1', 'malik15', 'qliu9', 'madigan5', 'alabi2', 'supermeatboy', 'roboemperor', 'ericwoo1', 'feng12', 'greenwa1', 'mikenike', 'jclift3', 'zhou60', 'heebidiwup', 'swarley', 'gavinwinkel', 'yjaquinas', 'lidazhu1', 'mazzola1', 'menghuang', 'novawater', 'rushx1', 'mattycat9000', 'wlee26', 'broll1', 'lu30', 'ssingh18', 'mstlyhrmlss', 'levitas1', 'dmoonxp5', None, 'qiu12', 'wanchoi1', 'hatfarm', 'luiszelaya', 'spadin1', 'keating7', 'blee51', 'maxcan', 'leiche1', 'chrisgoulet', 'achavarria', 'samuelzhang', 'mahed', 'jashari1', 'congshan', 'weberxzq', 'tatuhiro', 'rice14', 'pashea1', 'yuanweih', 'geschreyr', 'kwak27', 'shapir11', 'zeqiuwu1', 'mraval', 'emma', 'foxytop', 'brittovivek', 'jielv1', 'toblerone16', 'okekeoc1', 'bony', 'donner1', 'moy21', 'jksikai', 'nam18', 'szhang51', 'handa1', 'jataput1', 'miketeufel1', 'lupas2', 'akshay17567', 'kilpatr2', 'sgrand2', 'mikeudelhofen', 'amnueyp1', 'alex81388', 'mihrenoe', 'wang227', 'weber36', 'theerasit', 'tchajed', 'jtlust3', 'hardy6', 'aczerepak', 'stuber1', 'piyawon1', 'kim563', 'kandel3', 'gazdzia1', 'williamhn', 'taoyang', 'liyd', 'monnett1', 'bector1', 'arvman', 'roloscool', 'yun19', 'ddanielw', 'lee117', 'kchuang5', 'jain53', 'wente1', 'diliber1', 'geethabijjam', 'fandi514', 'ludao822', 'griffi21', 'edavilax', 'btanabe2', 'hasken1', 'kadakiy1', 'hchao2', 'nmisak', 'mroczek1', 'hazypensieve', 'gloger', 'dahlke2', 'hgao10', '8kobe24', 'dferrell68', 'ysun12', 'mckiern1', 'stephenyzc', 'genome852', 'dicksonsalim', 'morris57', 'devharlalka', 'wdyarthas', 'ucapssong', 'tsai11', 'yao10', 'panlei616', 'jefflale', 'tischer1']"
2,69,164,118,74,"['achavarria', 'samuelzhang', 'dhuang123', 'nookala', 'hartant2', 'jiwonp224', 'hoang4', 'williamhn', 'profballack', 'monnett1', 'alostu3', 'tatuhiro', 'nanotie', 'pashea1', 'b3nny312', 'malik15', 'lee117', 'shapir11', 'kwak27', 'fredhdx', 'lshi14', 'madigan5', 'alabi2', 'kandel3', 'shawkat', 'supermeatboy', 'ericwoo1', 'feng12', 'donner1', 'nam18', 'jksikai', 'mikenike', 'johns149', 'muneebahmed95', 'jclift3', 'szhang51', 'jataput1', 'kadakiy1', 'heebidiwup', 'yjaquinas', 'lidazhu1', 'hchao2', 'nmisak', 'hazypensieve', 'dferrell68', 'hgao10', 'sherrypri', 'hronik1', 'stephenyzc', 'wlee26', 'lu30', 'morris57', 'sfanou2', 'mikeudelhofen', 'siwin2', 'sutchaya', 'mihrenoe', 'vargas3', 'kumikknd', 'neilchristanto', 'wanchoi1', 'luiszelaya', 'spadin1', 'keating7', 'blee51', 'ewalt1', 'banerje1', 'aczerepak', 'stuber1', 'maxcan', 'leiche1', 'tischer1', 'jefflale', 'trovill1']",89,"['bae10', 'lucasmac37', 'ekapin2', 'chan32', 'case7', 'melurie03', 'jlorozc2', 'kgiacobazzi', 'bhchen2', 'oknoel', 'gobias', 'sunjialin', 'boertew1', 'snanav3', 'jkinne2', '1upgreenshroom', 'deasey1', 'wang183', 'omghaxcode', 'chan1cyrus2', 'maddali1', 'lobert124', 'cernaus1', 'gong10', 'xiaoyr068', 'spesard1', 'chellia1', 'qliu9', 'greenwa1', 'zhou60', 'swarley', 'gavinwinkel', 'mazzola1', 'novawater', 'mattycat9000', 'mstlyhrmlss', 'levitas1', 'hatfarm', 'chrisgoulet', 'weberxzq', 'rice14', 'yuanweih', 'geschreyr', 'zeqiuwu1', 'emma', 'foxytop', 'brittovivek', 'jielv1', 'toblerone16', 'bony', 'moy21', 'handa1', 'lupas2', 'kilpatr2', 'amnueyp1', 'alex81388', 'weber36', 'theerasit', 'tchajed', 'jtlust3', 'hardy6', 'piyawon1', 'kim563', 'gazdzia1', 'bector1', 'arvman', 'roloscool', 'yun19', 'ddanielw', 'jain53', 'wente1', 'diliber1', 'geethabijjam', 'fandi514', 'ludao822', 'griffi21', 'edavilax', 'btanabe2', 'hasken1', 'mroczek1', 'gloger', 'dahlke2', '8kobe24', 'mckiern1', 'genome852', 'dicksonsalim', 'devharlalka', 'ucapssong', 'mraval']",44,"['mahed', 'dwass', 'jashari1', 'mintzo', 'izquier2', 'ouyang4', 'ahoboke', 'reebbhaa', 'liyd', 'moon1002', 'chenhu1', 'zulueta1', 'ltompki2', 'surajmodi', 'hua5', 'lmendez2', 'redyoshi49q', 'ravitheja22', 'echegil1', 'red6290', 'a2104707', 'bradsnyder', 'vigneshka', 'jyao5', 'mim1c', 'jayfurrie', 'menghuang', 'miketeufel1', 'rushx1', 'broll1', 'sgrand2', None, 'dinger104', 'qiu12', 'zhangyj', 'yuan11', 'shawnwin1234', 'yao10', 'daybreak410039', 'panlei616', 'baker48', 'coolcrew', 'grace3050', 'chen338']",207,"['dhuang123', 'nookala', 'dwass', 'izquier2', 'bae10', 'lucasmac37', 'ekapin2', 'chan32', 'case7', 'moon1002', 'melurie03', 'b3nny312', 'jlorozc2', 'kgiacobazzi', 'bhchen2', 'oknoel', 'gobias', 'sunjialin', 'hua5', 'fredhdx', 'lshi14', 'redyoshi49q', 'shawkat', 'bradsnyder', 'johns149', 'muneebahmed95', 'boertew1', 'sherrypri', 'hronik1', 'snanav3', 'jkinne2', 'sfanou2', '1upgreenshroom', 'siwin2', 'sutchaya', 'vargas3', 'deasey1', 'kumikknd', 'neilchristanto', 'wang183', 'yuan11', 'shawnwin1234', 'omghaxcode', 'daybreak410039', 'ewalt1', 'banerje1', 'baker48', 'coolcrew', 'trovill1', 'lobert124', 'maddali1', 'chan1cyrus2', 'cernaus1', 'chen338', 'hartant2', 'jiwonp224', 'hoang4', 'profballack', 'gong10', 'reebbhaa', 'alostu3', 'xiaoyr068', 'nanotie', 'chenhu1', 'spesard1', 'chellia1', 'malik15', 'qliu9', 'madigan5', 'alabi2', 'ravitheja22', 'supermeatboy', 'ericwoo1', 'feng12', 'greenwa1', 'mikenike', 'jclift3', 'zhou60', 'heebidiwup', 'swarley', 'gavinwinkel', 'yjaquinas', 'lidazhu1', 'mazzola1', 'menghuang', 'novawater', 'rushx1', 'mattycat9000', 'wlee26', 'broll1', 'lu30', 'mstlyhrmlss', 'levitas1', None, 'qiu12', 'zhangyj', 'wanchoi1', 'hatfarm', 'luiszelaya', 'spadin1', 'keating7', 'blee51', 'maxcan', 'leiche1', 'chrisgoulet', 'achavarria', 'samuelzhang', 'mahed', 'jashari1', 'mintzo', 'ouyang4', 'weberxzq', 'tatuhiro', 'rice14', 'pashea1', 'yuanweih', 'geschreyr', 'zulueta1', 'kwak27', 'shapir11', 'zeqiuwu1', 'mraval', 'emma', 'foxytop', 'brittovivek', 'jielv1', 'toblerone16', 'echegil1', 'bony', 'donner1', 'moy21', 'jksikai', 'nam18', 'vigneshka', 'jyao5', 'szhang51', 'mim1c', 'handa1', 'jataput1', 'jayfurrie', 'miketeufel1', 'lupas2', 'kilpatr2', 'sgrand2', 'mikeudelhofen', 'amnueyp1', 'alex81388', 'dinger104', 'mihrenoe', 'weber36', 'theerasit', 'tchajed', 'jtlust3', 'hardy6', 'aczerepak', 'stuber1', 'piyawon1', 'kim563', 'kandel3', 'gazdzia1', 'williamhn', 'ahoboke', 'liyd', 'monnett1', 'bector1', 'arvman', 'roloscool', 'yun19', 'ddanielw', 'ltompki2', 'lee117', 'jain53', 'wente1', 'surajmodi', 'diliber1', 'geethabijjam', 'lmendez2', 'fandi514', 'ludao822', 'griffi21', 'red6290', 'a2104707', 'edavilax', 'btanabe2', 'hasken1', 'kadakiy1', 'hchao2', 'nmisak', 'mroczek1', 'hazypensieve', 'gloger', 'dahlke2', 'hgao10', '8kobe24', 'dferrell68', 'mckiern1', 'stephenyzc', 'genome852', 'dicksonsalim', 'morris57', 'devharlalka', 'ucapssong', 'yao10', 'panlei616', 'jefflale', 'grace3050', 'tischer1']"
2,150,164,116,95,"['dhuang123', 'nookala', 'bae10', 'lucasmac37', 'chan32', 'case7', 'melurie03', 'b3nny312', 'oknoel', 'sunjialin', 'fredhdx', 'shawkat', 'johns149', 'muneebahmed95', 'boertew1', 'snanav3', 'jkinne2', 'sfanou2', 'siwin2', 'sutchaya', 'deasey1', 'neilchristanto', 'kumikknd', 'wang183', 'banerje1', 'tischer1', 'maddali1', 'cernaus1', 'hartant2', 'jiwonp224', 'hoang4', 'profballack', 'gong10', 'alostu3', 'nanotie', 'malik15', 'supermeatboy', 'ericwoo1', 'feng12', 'mikenike', 'jclift3', 'yjaquinas', 'lidazhu1', 'novawater', 'wlee26', 'wanchoi1', 'spadin1', 'luiszelaya', 'keating7', 'blee51', 'maxcan', 'leiche1', 'achavarria', 'weberxzq', 'pashea1', 'yuanweih', 'shapir11', 'kwak27', 'zeqiuwu1', 'emma', 'foxytop', 'jielv1', 'bony', 'nam18', 'moy21', 'szhang51', 'jataput1', 'lupas2', 'kilpatr2', 'mihrenoe', 'theerasit', 'jtlust3', 'tchajed', 'hardy6', 'stuber1', 'kim563', 'gazdzia1', 'bector1', 'yun19', 'lee117', 'jain53', 'ludao822', 'btanabe2', 'hasken1', 'hchao2', 'nmisak', 'hazypensieve', '8kobe24', 'stephenyzc', 'genome852', 'morris57', 'devharlalka', 'ucapssong', 'jefflale', 'mraval']",68,"['samuelzhang', 'chan1cyrus2', 'williamhn', 'ekapin2', 'monnett1', 'arvman', 'tatuhiro', 'rice14', 'xiaoyr068', 'roloscool', 'trovill1', 'geschreyr', 'spesard1', 'ddanielw', 'chellia1', 'kgiacobazzi', 'bhchen2', 'jlorozc2', 'gobias', 'wente1', 'qliu9', 'diliber1', 'geethabijjam', 'lshi14', 'madigan5', 'alabi2', 'brittovivek', 'toblerone16', 'kandel3', 'fandi514', 'griffi21', 'donner1', 'greenwa1', 'jksikai', 'edavilax', 'zhou60', 'handa1', 'kadakiy1', 'heebidiwup', 'swarley', 'gavinwinkel', 'mroczek1', 'gloger', 'mazzola1', 'dahlke2', 'hgao10', 'sherrypri', 'dferrell68', 'mckiern1', 'hronik1', 'mattycat9000', 'dicksonsalim', 'lu30', 'mstlyhrmlss', 'levitas1', 'mikeudelhofen', '1upgreenshroom', 'amnueyp1', 'alex81388', 'weber36', 'vargas3', 'hatfarm', 'omghaxcode', 'ewalt1', 'aczerepak', 'piyawon1', 'chrisgoulet', 'lobert124']",21,"['mahed', 'congshan', 'parsoj', 'liyd', 'moon1002', 'okekeoc1', 'aminenko', 'ysun12', 'menghuang', 'miketeufel1', 'sgrand2', 'ssingh18', None, 'wang227', 'qiu12', 'shawnwin1234', 'zhang291', 'daybreak410039', 'uasyed2', 'panlei616', 'tsai11']",184,"['dhuang123', 'nookala', 'bae10', 'lucasmac37', 'ekapin2', 'parsoj', 'chan32', 'case7', 'moon1002', 'melurie03', 'b3nny312', 'jlorozc2', 'kgiacobazzi', 'bhchen2', 'oknoel', 'gobias', 'sunjialin', 'fredhdx', 'lshi14', 'shawkat', 'johns149', 'muneebahmed95', 'boertew1', 'sherrypri', 'hronik1', 'snanav3', 'jkinne2', 'sfanou2', '1upgreenshroom', 'siwin2', 'sutchaya', 'vargas3', 'deasey1', 'kumikknd', 'neilchristanto', 'wang183', 'shawnwin1234', 'omghaxcode', 'daybreak410039', 'ewalt1', 'banerje1', 'trovill1', 'lobert124', 'maddali1', 'chan1cyrus2', 'cernaus1', 'hartant2', 'jiwonp224', 'hoang4', 'profballack', 'gong10', 'alostu3', 'xiaoyr068', 'nanotie', 'spesard1', 'chellia1', 'malik15', 'qliu9', 'madigan5', 'alabi2', 'supermeatboy', 'ericwoo1', 'feng12', 'greenwa1', 'mikenike', 'jclift3', 'zhou60', 'heebidiwup', 'swarley', 'gavinwinkel', 'yjaquinas', 'lidazhu1', 'mazzola1', 'menghuang', 'novawater', 'mattycat9000', 'wlee26', 'lu30', 'ssingh18', 'mstlyhrmlss', 'levitas1', None, 'qiu12', 'wanchoi1', 'hatfarm', 'luiszelaya', 'spadin1', 'keating7', 'zhang291', 'blee51', 'maxcan', 'leiche1', 'chrisgoulet', 'achavarria', 'samuelzhang', 'mahed', 'congshan', 'weberxzq', 'tatuhiro', 'rice14', 'pashea1', 'yuanweih', 'geschreyr', 'kwak27', 'shapir11', 'zeqiuwu1', 'mraval', 'emma', 'foxytop', 'brittovivek', 'jielv1', 'toblerone16', 'okekeoc1', 'bony', 'donner1', 'moy21', 'jksikai', 'nam18', 'szhang51', 'handa1', 'jataput1', 'miketeufel1', 'lupas2', 'kilpatr2', 'sgrand2', 'mikeudelhofen', 'amnueyp1', 'alex81388', 'mihrenoe', 'wang227', 'weber36', 'theerasit', 'tchajed', 'jtlust3', 'hardy6', 'aczerepak', 'stuber1', 'piyawon1', 'kim563', 'kandel3', 'gazdzia1', 'williamhn', 'liyd', 'monnett1', 'bector1', 'arvman', 'roloscool', 'yun19', 'ddanielw', 'lee117', 'jain53', 'wente1', 'diliber1', 'geethabijjam', 'fandi514', 'ludao822', 'griffi21', 'edavilax', 'aminenko', 'btanabe2', 'hasken1', 'kadakiy1', 'hchao2', 'nmisak', 'mroczek1', 'hazypensieve', 'gloger', 'dahlke2', 'hgao10', '8kobe24', 'dferrell68', 'ysun12', 'mckiern1', 'stephenyzc', 'genome852', 'dicksonsalim', 'morris57', 'devharlalka', 'ucapssong', 'tsai11', 'uasyed2', 'panlei616', 'jefflale', 'tischer1']"
2,70,164,48,38,"['ekapin2', 'xiaoyr068', 'yuanweih', 'geschreyr', 'ddanielw', 'bhchen2', 'mraval', 'sunjialin', 'gobias', 'emma', 'geethabijjam', 'foxytop', 'brittovivek', 'ludao822', 'griffi21', 'bony', 'feng12', 'btanabe2', 'heebidiwup', 'boertew1', 'gavinwinkel', 'gloger', 'lupas2', 'mattycat9000', 'devharlalka', 'alex81388', 'weber36', 'deasey1', 'wang183', 'hatfarm', 'jtlust3', 'omghaxcode', 'tchajed', 'hardy6', 'stuber1', 'tischer1', 'trovill1', 'cernaus1']",125,"['dhuang123', 'nookala', 'bae10', 'lucasmac37', 'chan32', 'case7', 'melurie03', 'b3nny312', 'jlorozc2', 'kgiacobazzi', 'oknoel', 'fredhdx', 'lshi14', 'shawkat', 'johns149', 'muneebahmed95', 'sherrypri', 'hronik1', 'snanav3', 'jkinne2', 'sfanou2', '1upgreenshroom', 'siwin2', 'sutchaya', 'vargas3', 'kumikknd', 'neilchristanto', 'ewalt1', 'banerje1', 'chan1cyrus2', 'maddali1', 'lobert124', 'hartant2', 'jiwonp224', 'hoang4', 'profballack', 'gong10', 'alostu3', 'nanotie', 'spesard1', 'chellia1', 'malik15', 'qliu9', 'madigan5', 'alabi2', 'supermeatboy', 'ericwoo1', 'greenwa1', 'mikenike', 'jclift3', 'zhou60', 'swarley', 'yjaquinas', 'lidazhu1', 'mazzola1', 'novawater', 'wlee26', 'lu30', 'mstlyhrmlss', 'levitas1', 'wanchoi1', 'luiszelaya', 'spadin1', 'keating7', 'blee51', 'maxcan', 'leiche1', 'chrisgoulet', 'achavarria', 'samuelzhang', 'weberxzq', 'tatuhiro', 'rice14', 'pashea1', 'kwak27', 'shapir11', 'zeqiuwu1', 'jielv1', 'toblerone16', 'donner1', 'moy21', 'jksikai', 'nam18', 'szhang51', 'handa1', 'jataput1', 'kilpatr2', 'mikeudelhofen', 'amnueyp1', 'mihrenoe', 'theerasit', 'aczerepak', 'piyawon1', 'kim563', 'kandel3', 'gazdzia1', 'williamhn', 'monnett1', 'bector1', 'arvman', 'roloscool', 'yun19', 'lee117', 'jain53', 'wente1', 'diliber1', 'fandi514', 'edavilax', 'hasken1', 'kadakiy1', 'hchao2', 'nmisak', 'mroczek1', 'hazypensieve', 'dahlke2', 'dferrell68', 'hgao10', '8kobe24', 'mckiern1', 'stephenyzc', 'genome852', 'dicksonsalim', 'morris57', 'ucapssong', 'jefflale']",10,"['wdyarthas', 'zoboomafoo', 'powerplayer7', 'izquier2', 'jkim331', 'zhang291', 'sabio00', 'esanch29', 'lefkowi1', None]",173,"['dhuang123', 'nookala', 'izquier2', 'bae10', 'lucasmac37', 'ekapin2', 'chan32', 'case7', 'melurie03', 'b3nny312', 'jlorozc2', 'kgiacobazzi', 'bhchen2', 'oknoel', 'gobias', 'sunjialin', 'zoboomafoo', 'fredhdx', 'lshi14', 'shawkat', 'esanch29', 'johns149', 'muneebahmed95', 'boertew1', 'sherrypri', 'hronik1', 'snanav3', 'jkinne2', 'sfanou2', '1upgreenshroom', 'siwin2', 'sutchaya', 'vargas3', 'deasey1', 'kumikknd', 'neilchristanto', 'wang183', 'omghaxcode', 'ewalt1', 'banerje1', 'trovill1', 'lobert124', 'maddali1', 'chan1cyrus2', 'cernaus1', 'hartant2', 'jiwonp224', 'hoang4', 'profballack', 'gong10', 'alostu3', 'xiaoyr068', 'nanotie', 'spesard1', 'chellia1', 'malik15', 'qliu9', 'madigan5', 'alabi2', 'jkim331', 'supermeatboy', 'ericwoo1', 'feng12', 'greenwa1', 'mikenike', 'jclift3', 'zhou60', 'heebidiwup', 'swarley', 'gavinwinkel', 'yjaquinas', 'lidazhu1', 'mazzola1', 'novawater', 'mattycat9000', 'wlee26', 'lu30', 'mstlyhrmlss', 'levitas1', None, 'wanchoi1', 'hatfarm', 'luiszelaya', 'spadin1', 'keating7', 'zhang291', 'blee51', 'maxcan', 'leiche1', 'chrisgoulet', 'achavarria', 'samuelzhang', 'weberxzq', 'tatuhiro', 'rice14', 'pashea1', 'yuanweih', 'lefkowi1', 'geschreyr', 'kwak27', 'shapir11', 'zeqiuwu1', 'mraval', 'emma', 'foxytop', 'brittovivek', 'jielv1', 'toblerone16', 'bony', 'donner1', 'moy21', 'jksikai', 'nam18', 'szhang51', 'handa1', 'jataput1', 'sabio00', 'lupas2', 'kilpatr2', 'mikeudelhofen', 'amnueyp1', 'alex81388', 'mihrenoe', 'weber36', 'theerasit', 'tchajed', 'jtlust3', 'hardy6', 'aczerepak', 'stuber1', 'piyawon1', 'kim563', 'kandel3', 'gazdzia1', 'powerplayer7', 'williamhn', 'monnett1', 'bector1', 'arvman', 'roloscool', 'yun19', 'ddanielw', 'lee117', 'jain53', 'wente1', 'diliber1', 'geethabijjam', 'fandi514', 'ludao822', 'griffi21', 'edavilax', 'btanabe2', 'hasken1', 'kadakiy1', 'hchao2', 'nmisak', 'mroczek1', 'hazypensieve', 'gloger', 'dahlke2', 'hgao10', '8kobe24', 'dferrell68', 'mckiern1', 'stephenyzc', 'genome852', 'dicksonsalim', 'morris57', 'devharlalka', 'wdyarthas', 'ucapssong', 'jefflale', 'tischer1']"
2,44,164,43,32,"['ekapin2', 'bector1', 'xiaoyr068', 'yuanweih', 'trovill1', 'bhchen2', 'sunjialin', 'gobias', 'griffi21', 'ericwoo1', 'feng12', 'btanabe2', 'heebidiwup', 'lidazhu1', 'gloger', 'gavinwinkel', 'mazzola1', 'lupas2', 'devharlalka', 'alex81388', 'weber36', 'theerasit', 'deasey1', 'vargas3', 'hatfarm', 'jtlust3', 'omghaxcode', 'hardy6', 'banerje1', 'jefflale', 'chan1cyrus2', 'cernaus1']",131,"['dhuang123', 'nookala', 'bae10', 'lucasmac37', 'chan32', 'case7', 'melurie03', 'b3nny312', 'jlorozc2', 'kgiacobazzi', 'oknoel', 'fredhdx', 'lshi14', 'shawkat', 'johns149', 'muneebahmed95', 'boertew1', 'sherrypri', 'hronik1', 'snanav3', 'jkinne2', 'sfanou2', '1upgreenshroom', 'siwin2', 'sutchaya', 'kumikknd', 'neilchristanto', 'wang183', 'ewalt1', 'tischer1', 'maddali1', 'lobert124', 'hartant2', 'jiwonp224', 'hoang4', 'profballack', 'gong10', 'alostu3', 'nanotie', 'spesard1', 'chellia1', 'malik15', 'qliu9', 'madigan5', 'alabi2', 'supermeatboy', 'greenwa1', 'mikenike', 'jclift3', 'zhou60', 'swarley', 'yjaquinas', 'novawater', 'mattycat9000', 'wlee26', 'lu30', 'mstlyhrmlss', 'levitas1', 'wanchoi1', 'luiszelaya', 'spadin1', 'keating7', 'blee51', 'maxcan', 'leiche1', 'chrisgoulet', 'achavarria', 'samuelzhang', 'weberxzq', 'tatuhiro', 'rice14', 'pashea1', 'geschreyr', 'kwak27', 'shapir11', 'zeqiuwu1', 'emma', 'foxytop', 'brittovivek', 'jielv1', 'toblerone16', 'bony', 'donner1', 'moy21', 'jksikai', 'nam18', 'szhang51', 'handa1', 'jataput1', 'kilpatr2', 'mikeudelhofen', 'amnueyp1', 'mihrenoe', 'tchajed', 'aczerepak', 'stuber1', 'piyawon1', 'kim563', 'kandel3', 'gazdzia1', 'williamhn', 'monnett1', 'arvman', 'roloscool', 'yun19', 'ddanielw', 'lee117', 'jain53', 'wente1', 'diliber1', 'geethabijjam', 'fandi514', 'ludao822', 'edavilax', 'hasken1', 'kadakiy1', 'hchao2', 'nmisak', 'mroczek1', 'hazypensieve', 'dahlke2', 'dferrell68', 'hgao10', '8kobe24', 'mckiern1', 'stephenyzc', 'genome852', 'dicksonsalim', 'morris57', 'ucapssong', 'mraval']",11,"['esanch29', 'baoshi314', 'powerplayer7', 'congshan', 'yao10', 'tocirahl', 'jkim331', 'a2104707', 'lnicklaus', 'tsai11', None]",174,"['dhuang123', 'nookala', 'bae10', 'lucasmac37', 'ekapin2', 'chan32', 'case7', 'melurie03', 'b3nny312', 'jlorozc2', 'kgiacobazzi', 'bhchen2', 'oknoel', 'gobias', 'sunjialin', 'fredhdx', 'lshi14', 'shawkat', 'esanch29', 'lnicklaus', 'johns149', 'muneebahmed95', 'boertew1', 'sherrypri', 'hronik1', 'snanav3', 'jkinne2', 'sfanou2', '1upgreenshroom', 'siwin2', 'sutchaya', 'baoshi314', 'vargas3', 'deasey1', 'kumikknd', 'neilchristanto', 'wang183', 'omghaxcode', 'ewalt1', 'banerje1', 'trovill1', 'lobert124', 'maddali1', 'chan1cyrus2', 'cernaus1', 'hartant2', 'jiwonp224', 'hoang4', 'profballack', 'gong10', 'alostu3', 'xiaoyr068', 'nanotie', 'spesard1', 'chellia1', 'malik15', 'qliu9', 'madigan5', 'alabi2', 'jkim331', 'supermeatboy', 'ericwoo1', 'feng12', 'greenwa1', 'mikenike', 'jclift3', 'zhou60', 'heebidiwup', 'swarley', 'gavinwinkel', 'yjaquinas', 'lidazhu1', 'mazzola1', 'novawater', 'mattycat9000', 'wlee26', 'lu30', 'mstlyhrmlss', 'levitas1', None, 'wanchoi1', 'hatfarm', 'luiszelaya', 'spadin1', 'keating7', 'blee51', 'maxcan', 'leiche1', 'chrisgoulet', 'achavarria', 'samuelzhang', 'congshan', 'weberxzq', 'tatuhiro', 'rice14', 'pashea1', 'yuanweih', 'geschreyr', 'kwak27', 'shapir11', 'zeqiuwu1', 'mraval', 'emma', 'foxytop', 'brittovivek', 'jielv1', 'toblerone16', 'bony', 'donner1', 'moy21', 'jksikai', 'nam18', 'szhang51', 'handa1', 'jataput1', 'tocirahl', 'lupas2', 'kilpatr2', 'mikeudelhofen', 'amnueyp1', 'alex81388', 'mihrenoe', 'weber36', 'theerasit', 'tchajed', 'jtlust3', 'hardy6', 'aczerepak', 'stuber1', 'piyawon1', 'kim563', 'kandel3', 'gazdzia1', 'powerplayer7', 'williamhn', 'monnett1', 'bector1', 'arvman', 'roloscool', 'yun19', 'ddanielw', 'lee117', 'jain53', 'wente1', 'diliber1', 'geethabijjam', 'fandi514', 'ludao822', 'griffi21', 'a2104707', 'edavilax', 'btanabe2', 'hasken1', 'kadakiy1', 'hchao2', 'nmisak', 'mroczek1', 'hazypensieve', 'gloger', 'dahlke2', 'hgao10', '8kobe24', 'dferrell68', 'mckiern1', 'stephenyzc', 'genome852', 'dicksonsalim', 'morris57', 'devharlalka', 'ucapssong', 'tsai11', 'yao10', 'jefflale', 'tischer1']"
2,149,164,43,30,"['samuelzhang', 'chan1cyrus2', 'williamhn', 'ekapin2', 'xiaoyr068', 'yuanweih', 'geschreyr', 'bhchen2', 'sunjialin', 'gobias', 'geethabijjam', 'madigan5', 'ludao822', 'griffi21', 'ericwoo1', 'greenwa1', 'kadakiy1', 'heebidiwup', 'gloger', 'mazzola1', 'levitas1', 'alex81388', 'weber36', 'theerasit', 'deasey1', 'lobert124', 'wang183', 'hatfarm', 'jtlust3', 'trovill1']",133,"['dhuang123', 'nookala', 'bae10', 'lucasmac37', 'chan32', 'case7', 'melurie03', 'b3nny312', 'jlorozc2', 'kgiacobazzi', 'oknoel', 'fredhdx', 'lshi14', 'shawkat', 'johns149', 'muneebahmed95', 'boertew1', 'sherrypri', 'hronik1', 'snanav3', 'jkinne2', 'sfanou2', '1upgreenshroom', 'siwin2', 'sutchaya', 'vargas3', 'kumikknd', 'neilchristanto', 'omghaxcode', 'ewalt1', 'banerje1', 'tischer1', 'maddali1', 'cernaus1', 'hartant2', 'jiwonp224', 'hoang4', 'profballack', 'gong10', 'alostu3', 'nanotie', 'spesard1', 'chellia1', 'malik15', 'qliu9', 'alabi2', 'supermeatboy', 'feng12', 'mikenike', 'jclift3', 'zhou60', 'swarley', 'gavinwinkel', 'yjaquinas', 'lidazhu1', 'novawater', 'mattycat9000', 'wlee26', 'lu30', 'mstlyhrmlss', 'wanchoi1', 'luiszelaya', 'spadin1', 'keating7', 'blee51', 'maxcan', 'leiche1', 'chrisgoulet', 'achavarria', 'weberxzq', 'tatuhiro', 'rice14', 'pashea1', 'kwak27', 'shapir11', 'zeqiuwu1', 'emma', 'foxytop', 'brittovivek', 'jielv1', 'toblerone16', 'bony', 'donner1', 'moy21', 'jksikai', 'nam18', 'szhang51', 'handa1', 'jataput1', 'lupas2', 'kilpatr2', 'mikeudelhofen', 'amnueyp1', 'mihrenoe', 'tchajed', 'hardy6', 'aczerepak', 'stuber1', 'piyawon1', 'kim563', 'kandel3', 'gazdzia1', 'monnett1', 'bector1', 'arvman', 'roloscool', 'yun19', 'ddanielw', 'lee117', 'jain53', 'wente1', 'diliber1', 'fandi514', 'edavilax', 'btanabe2', 'hasken1', 'hchao2', 'nmisak', 'mroczek1', 'hazypensieve', 'dahlke2', 'dferrell68', 'hgao10', '8kobe24', 'mckiern1', 'stephenyzc', 'genome852', 'dicksonsalim', 'morris57', 'devharlalka', 'ucapssong', 'jefflale', 'mraval']",13,"['wdyarthas', 'esanch29', 'parks8', 'powerplayer7', 'mayapati', 'zhang291', 'tocirahl', 'pranavram', 'baker48', 'jkim331', 'ssingh18', 'tsai11', None]",176,"['dhuang123', 'nookala', 'bae10', 'lucasmac37', 'ekapin2', 'chan32', 'case7', 'melurie03', 'b3nny312', 'jlorozc2', 'kgiacobazzi', 'bhchen2', 'oknoel', 'gobias', 'sunjialin', 'fredhdx', 'lshi14', 'shawkat', 'esanch29', 'johns149', 'muneebahmed95', 'boertew1', 'sherrypri', 'hronik1', 'snanav3', 'pranavram', 'jkinne2', 'sfanou2', '1upgreenshroom', 'siwin2', 'sutchaya', 'vargas3', 'deasey1', 'kumikknd', 'neilchristanto', 'wang183', 'omghaxcode', 'ewalt1', 'banerje1', 'baker48', 'trovill1', 'lobert124', 'maddali1', 'chan1cyrus2', 'cernaus1', 'hartant2', 'jiwonp224', 'hoang4', 'profballack', 'gong10', 'alostu3', 'xiaoyr068', 'nanotie', 'spesard1', 'chellia1', 'malik15', 'qliu9', 'madigan5', 'alabi2', 'jkim331', 'supermeatboy', 'ericwoo1', 'feng12', 'greenwa1', 'mikenike', 'jclift3', 'zhou60', 'heebidiwup', 'swarley', 'gavinwinkel', 'yjaquinas', 'lidazhu1', 'mazzola1', 'novawater', 'mattycat9000', 'wlee26', 'lu30', 'ssingh18', 'mstlyhrmlss', 'levitas1', None, 'wanchoi1', 'hatfarm', 'luiszelaya', 'spadin1', 'keating7', 'zhang291', 'blee51', 'maxcan', 'leiche1', 'chrisgoulet', 'achavarria', 'samuelzhang', 'weberxzq', 'tatuhiro', 'rice14', 'pashea1', 'yuanweih', 'geschreyr', 'kwak27', 'shapir11', 'zeqiuwu1', 'mraval', 'parks8', 'emma', 'foxytop', 'brittovivek', 'jielv1', 'toblerone16', 'bony', 'donner1', 'moy21', 'jksikai', 'nam18', 'szhang51', 'handa1', 'jataput1', 'tocirahl', 'lupas2', 'kilpatr2', 'mikeudelhofen', 'amnueyp1', 'alex81388', 'mihrenoe', 'weber36', 'theerasit', 'tchajed', 'jtlust3', 'hardy6', 'aczerepak', 'stuber1', 'piyawon1', 'kim563', 'kandel3', 'gazdzia1', 'powerplayer7', 'williamhn', 'monnett1', 'bector1', 'arvman', 'roloscool', 'yun19', 'ddanielw', 'lee117', 'jain53', 'wente1', 'diliber1', 'geethabijjam', 'fandi514', 'ludao822', 'griffi21', 'edavilax', 'btanabe2', 'hasken1', 'kadakiy1', 'hchao2', 'nmisak', 'mroczek1', 'hazypensieve', 'gloger', 'dahlke2', 'hgao10', '8kobe24', 'dferrell68', 'mckiern1', 'stephenyzc', 'genome852', 'dicksonsalim', 'morris57', 'devharlalka', 'wdyarthas', 'ucapssong', 'tsai11', 'mayapati', 'jefflale', 'tischer1']"
2,91,164,35,22,"['ekapin2', 'bector1', 'bhchen2', 'sunjialin', 'diliber1', 'geethabijjam', 'heebidiwup', 'nmisak', 'gavinwinkel', 'gloger', 'mazzola1', 'sherrypri', 'lupas2', 'mattycat9000', 'levitas1', 'alex81388', 'weber36', 'deasey1', 'hatfarm', 'tchajed', 'omghaxcode', 'hardy6']",141,"['dhuang123', 'nookala', 'bae10', 'lucasmac37', 'chan32', 'case7', 'melurie03', 'b3nny312', 'jlorozc2', 'kgiacobazzi', 'oknoel', 'gobias', 'fredhdx', 'lshi14', 'shawkat', 'johns149', 'muneebahmed95', 'boertew1', 'hronik1', 'snanav3', 'jkinne2', 'sfanou2', '1upgreenshroom', 'siwin2', 'sutchaya', 'vargas3', 'kumikknd', 'neilchristanto', 'wang183', 'ewalt1', 'banerje1', 'trovill1', 'lobert124', 'maddali1', 'chan1cyrus2', 'cernaus1', 'hartant2', 'jiwonp224', 'hoang4', 'profballack', 'gong10', 'alostu3', 'xiaoyr068', 'nanotie', 'spesard1', 'chellia1', 'malik15', 'qliu9', 'madigan5', 'alabi2', 'supermeatboy', 'ericwoo1', 'feng12', 'greenwa1', 'mikenike', 'jclift3', 'zhou60', 'swarley', 'yjaquinas', 'lidazhu1', 'novawater', 'wlee26', 'lu30', 'mstlyhrmlss', 'wanchoi1', 'luiszelaya', 'spadin1', 'keating7', 'blee51', 'maxcan', 'leiche1', 'chrisgoulet', 'achavarria', 'samuelzhang', 'weberxzq', 'tatuhiro', 'rice14', 'pashea1', 'yuanweih', 'geschreyr', 'kwak27', 'shapir11', 'zeqiuwu1', 'mraval', 'emma', 'foxytop', 'brittovivek', 'jielv1', 'toblerone16', 'bony', 'donner1', 'moy21', 'jksikai', 'nam18', 'szhang51', 'handa1', 'jataput1', 'kilpatr2', 'mikeudelhofen', 'amnueyp1', 'mihrenoe', 'theerasit', 'jtlust3', 'aczerepak', 'stuber1', 'piyawon1', 'kim563', 'kandel3', 'gazdzia1', 'williamhn', 'monnett1', 'arvman', 'roloscool', 'yun19', 'ddanielw', 'lee117', 'jain53', 'wente1', 'fandi514', 'ludao822', 'griffi21', 'edavilax', 'btanabe2', 'hasken1', 'kadakiy1', 'hchao2', 'mroczek1', 'hazypensieve', 'dahlke2', 'hgao10', '8kobe24', 'dferrell68', 'mckiern1', 'stephenyzc', 'genome852', 'dicksonsalim', 'morris57', 'devharlalka', 'ucapssong', 'jefflale', 'tischer1']",13,"['wdyarthas', 'nima_one', 'mast5', 'parks8', 'jkim331', 'savankadakiya', 'jeeves631', 'dongdong', 'ssingh18', 'tsai11', None, 'mjy5', 'ltompki2']",176,"['dhuang123', 'nookala', 'bae10', 'lucasmac37', 'ekapin2', 'chan32', 'case7', 'dongdong', 'melurie03', 'b3nny312', 'nima_one', 'jlorozc2', 'kgiacobazzi', 'bhchen2', 'oknoel', 'gobias', 'sunjialin', 'fredhdx', 'lshi14', 'shawkat', 'johns149', 'muneebahmed95', 'boertew1', 'sherrypri', 'hronik1', 'snanav3', 'jkinne2', 'sfanou2', '1upgreenshroom', 'siwin2', 'sutchaya', 'vargas3', 'deasey1', 'kumikknd', 'neilchristanto', 'wang183', 'savankadakiya', 'omghaxcode', 'ewalt1', 'banerje1', 'trovill1', 'lobert124', 'maddali1', 'chan1cyrus2', 'cernaus1', 'hartant2', 'jiwonp224', 'hoang4', 'profballack', 'gong10', 'alostu3', 'xiaoyr068', 'nanotie', 'spesard1', 'chellia1', 'malik15', 'qliu9', 'madigan5', 'alabi2', 'jeeves631', 'jkim331', 'supermeatboy', 'ericwoo1', 'feng12', 'mjy5', 'greenwa1', 'mikenike', 'jclift3', 'zhou60', 'heebidiwup', 'swarley', 'gavinwinkel', 'yjaquinas', 'lidazhu1', 'mazzola1', 'novawater', 'mattycat9000', 'wlee26', 'lu30', 'ssingh18', 'mstlyhrmlss', 'levitas1', None, 'mast5', 'wanchoi1', 'hatfarm', 'luiszelaya', 'spadin1', 'keating7', 'blee51', 'maxcan', 'leiche1', 'chrisgoulet', 'achavarria', 'samuelzhang', 'weberxzq', 'tatuhiro', 'rice14', 'pashea1', 'yuanweih', 'geschreyr', 'kwak27', 'shapir11', 'zeqiuwu1', 'mraval', 'parks8', 'emma', 'foxytop', 'brittovivek', 'jielv1', 'toblerone16', 'bony', 'donner1', 'moy21', 'jksikai', 'nam18', 'szhang51', 'handa1', 'jataput1', 'lupas2', 'kilpatr2', 'mikeudelhofen', 'amnueyp1', 'alex81388', 'mihrenoe', 'weber36', 'theerasit', 'tchajed', 'jtlust3', 'hardy6', 'aczerepak', 'stuber1', 'piyawon1', 'kim563', 'kandel3', 'gazdzia1', 'williamhn', 'monnett1', 'bector1', 'arvman', 'roloscool', 'yun19', 'ddanielw', 'ltompki2', 'lee117', 'jain53', 'wente1', 'diliber1', 'geethabijjam', 'fandi514', 'ludao822', 'griffi21', 'edavilax', 'btanabe2', 'hasken1', 'kadakiy1', 'hchao2', 'nmisak', 'mroczek1', 'hazypensieve', 'gloger', 'dahlke2', 'hgao10', '8kobe24', 'dferrell68', 'mckiern1', 'stephenyzc', 'genome852', 'dicksonsalim', 'morris57', 'devharlalka', 'wdyarthas', 'ucapssong', 'tsai11', 'jefflale', 'tischer1']"
2,93,164,34,23,"['bector1', 'xiaoyr068', 'bhchen2', 'sunjialin', 'diliber1', 'geethabijjam', 'griffi21', 'heebidiwup', 'nmisak', 'gavinwinkel', 'gloger', 'mazzola1', 'sherrypri', 'mattycat9000', 'lupas2', 'levitas1', 'alex81388', 'weber36', 'hatfarm', 'tchajed', 'omghaxcode', 'jefflale', 'mraval']",140,"['dhuang123', 'nookala', 'bae10', 'lucasmac37', 'ekapin2', 'chan32', 'case7', 'melurie03', 'b3nny312', 'jlorozc2', 'kgiacobazzi', 'oknoel', 'gobias', 'fredhdx', 'lshi14', 'shawkat', 'johns149', 'muneebahmed95', 'boertew1', 'hronik1', 'snanav3', 'jkinne2', 'sfanou2', '1upgreenshroom', 'siwin2', 'sutchaya', 'vargas3', 'deasey1', 'kumikknd', 'neilchristanto', 'wang183', 'ewalt1', 'banerje1', 'trovill1', 'lobert124', 'maddali1', 'chan1cyrus2', 'cernaus1', 'hartant2', 'jiwonp224', 'hoang4', 'profballack', 'gong10', 'alostu3', 'nanotie', 'spesard1', 'chellia1', 'malik15', 'qliu9', 'madigan5', 'alabi2', 'supermeatboy', 'ericwoo1', 'feng12', 'greenwa1', 'mikenike', 'jclift3', 'zhou60', 'swarley', 'yjaquinas', 'lidazhu1', 'novawater', 'wlee26', 'lu30', 'mstlyhrmlss', 'wanchoi1', 'luiszelaya', 'spadin1', 'keating7', 'blee51', 'maxcan', 'leiche1', 'chrisgoulet', 'achavarria', 'samuelzhang', 'weberxzq', 'tatuhiro', 'rice14', 'pashea1', 'yuanweih', 'geschreyr', 'kwak27', 'shapir11', 'zeqiuwu1', 'emma', 'foxytop', 'brittovivek', 'jielv1', 'toblerone16', 'bony', 'donner1', 'moy21', 'jksikai', 'nam18', 'szhang51', 'handa1', 'jataput1', 'kilpatr2', 'mikeudelhofen', 'amnueyp1', 'mihrenoe', 'theerasit', 'jtlust3', 'hardy6', 'aczerepak', 'stuber1', 'piyawon1', 'kim563', 'kandel3', 'gazdzia1', 'williamhn', 'monnett1', 'arvman', 'roloscool', 'yun19', 'ddanielw', 'lee117', 'jain53', 'wente1', 'fandi514', 'ludao822', 'edavilax', 'btanabe2', 'hasken1', 'kadakiy1', 'hchao2', 'mroczek1', 'hazypensieve', 'dahlke2', 'hgao10', '8kobe24', 'dferrell68', 'mckiern1', 'stephenyzc', 'genome852', 'dicksonsalim', 'morris57', 'devharlalka', 'ucapssong', 'tischer1']",11,"['wdyarthas', 'nima_one', 'mast5', 'parks8', 'dongdong', 'jkim331', 'ssingh18', 'tsai11', None, 'mjy5', 'ltompki2']",174,"['dhuang123', 'nookala', 'bae10', 'lucasmac37', 'ekapin2', 'chan32', 'case7', 'dongdong', 'melurie03', 'b3nny312', 'nima_one', 'jlorozc2', 'kgiacobazzi', 'bhchen2', 'oknoel', 'gobias', 'sunjialin', 'fredhdx', 'lshi14', 'shawkat', 'johns149', 'muneebahmed95', 'boertew1', 'sherrypri', 'hronik1', 'snanav3', 'jkinne2', 'sfanou2', '1upgreenshroom', 'siwin2', 'sutchaya', 'vargas3', 'deasey1', 'kumikknd', 'neilchristanto', 'wang183', 'omghaxcode', 'ewalt1', 'banerje1', 'trovill1', 'lobert124', 'maddali1', 'chan1cyrus2', 'cernaus1', 'hartant2', 'jiwonp224', 'hoang4', 'profballack', 'gong10', 'alostu3', 'xiaoyr068', 'nanotie', 'spesard1', 'chellia1', 'malik15', 'qliu9', 'madigan5', 'alabi2', 'jkim331', 'supermeatboy', 'ericwoo1', 'feng12', 'mjy5', 'greenwa1', 'mikenike', 'jclift3', 'zhou60', 'heebidiwup', 'swarley', 'gavinwinkel', 'yjaquinas', 'lidazhu1', 'mazzola1', 'novawater', 'mattycat9000', 'wlee26', 'lu30', 'ssingh18', 'mstlyhrmlss', 'levitas1', None, 'mast5', 'wanchoi1', 'hatfarm', 'luiszelaya', 'spadin1', 'keating7', 'blee51', 'maxcan', 'leiche1', 'chrisgoulet', 'achavarria', 'samuelzhang', 'weberxzq', 'tatuhiro', 'rice14', 'pashea1', 'yuanweih', 'geschreyr', 'kwak27', 'shapir11', 'zeqiuwu1', 'mraval', 'parks8', 'emma', 'foxytop', 'brittovivek', 'jielv1', 'toblerone16', 'bony', 'donner1', 'moy21', 'jksikai', 'nam18', 'szhang51', 'handa1', 'jataput1', 'lupas2', 'kilpatr2', 'mikeudelhofen', 'amnueyp1', 'alex81388', 'mihrenoe', 'weber36', 'theerasit', 'tchajed', 'jtlust3', 'hardy6', 'aczerepak', 'stuber1', 'piyawon1', 'kim563', 'kandel3', 'gazdzia1', 'williamhn', 'monnett1', 'bector1', 'arvman', 'roloscool', 'yun19', 'ddanielw', 'ltompki2', 'lee117', 'jain53', 'wente1', 'diliber1', 'geethabijjam', 'fandi514', 'ludao822', 'griffi21', 'edavilax', 'btanabe2', 'hasken1', 'kadakiy1', 'hchao2', 'nmisak', 'mroczek1', 'hazypensieve', 'gloger', 'dahlke2', 'hgao10', '8kobe24', 'dferrell68', 'mckiern1', 'stephenyzc', 'genome852', 'dicksonsalim', 'morris57', 'devharlalka', 'wdyarthas', 'ucapssong', 'tsai11', 'jefflale', 'tischer1']"
2,71,164,30,7,"['amnueyp1', 'theerasit', 'gazdzia1', 'toblerone16', 'bector1', 'arvman', 'donner1']",156,"['dhuang123', 'nookala', 'bae10', 'lucasmac37', 'ekapin2', 'chan32', 'case7', 'melurie03', 'b3nny312', 'jlorozc2', 'kgiacobazzi', 'bhchen2', 'oknoel', 'gobias', 'sunjialin', 'fredhdx', 'lshi14', 'shawkat', 'johns149', 'muneebahmed95', 'boertew1', 'sherrypri', 'hronik1', 'snanav3', 'jkinne2', 'sfanou2', '1upgreenshroom', 'siwin2', 'sutchaya', 'vargas3', 'deasey1', 'kumikknd', 'neilchristanto', 'wang183', 'omghaxcode', 'ewalt1', 'banerje1', 'trovill1', 'lobert124', 'maddali1', 'chan1cyrus2', 'cernaus1', 'hartant2', 'jiwonp224', 'hoang4', 'profballack', 'gong10', 'alostu3', 'xiaoyr068', 'nanotie', 'spesard1', 'chellia1', 'malik15', 'qliu9', 'madigan5', 'alabi2', 'supermeatboy', 'ericwoo1', 'feng12', 'greenwa1', 'mikenike', 'jclift3', 'zhou60', 'heebidiwup', 'swarley', 'gavinwinkel', 'yjaquinas', 'lidazhu1', 'mazzola1', 'novawater', 'mattycat9000', 'wlee26', 'lu30', 'mstlyhrmlss', 'levitas1', 'wanchoi1', 'hatfarm', 'luiszelaya', 'spadin1', 'keating7', 'blee51', 'maxcan', 'leiche1', 'chrisgoulet', 'achavarria', 'samuelzhang', 'weberxzq', 'tatuhiro', 'rice14', 'pashea1', 'yuanweih', 'geschreyr', 'kwak27', 'shapir11', 'zeqiuwu1', 'mraval', 'emma', 'foxytop', 'brittovivek', 'jielv1', 'bony', 'moy21', 'jksikai', 'nam18', 'szhang51', 'handa1', 'jataput1', 'lupas2', 'kilpatr2', 'mikeudelhofen', 'alex81388', 'mihrenoe', 'weber36', 'tchajed', 'jtlust3', 'hardy6', 'aczerepak', 'stuber1', 'piyawon1', 'kim563', 'kandel3', 'williamhn', 'monnett1', 'roloscool', 'yun19', 'ddanielw', 'lee117', 'jain53', 'wente1', 'diliber1', 'geethabijjam', 'fandi514', 'ludao822', 'griffi21', 'edavilax', 'btanabe2', 'hasken1', 'kadakiy1', 'hchao2', 'nmisak', 'mroczek1', 'hazypensieve', 'gloger', 'dahlke2', 'hgao10', '8kobe24', 'dferrell68', 'mckiern1', 'stephenyzc', 'genome852', 'dicksonsalim', 'morris57', 'devharlalka', 'ucapssong', 'jefflale', 'tischer1']",23,"['cwjohnson', 'swallerick', 'eder0020', 'aflocchini', 'dereknowacki1', '11018499jd', 'brenda.bedeaux', 'dynamicdoyle', 'aashay1991', 'jeffwebber808', 'nrb722', 'psmisek07', None, 'walter9', 'rmeekin11', 'mersch', 'mikeystarr', 'yuan11', 'toddlienemann', 'capissen', 'siveo123', 'tomn7201', 'jmarti']",186,"['dhuang123', 'nookala', 'bae10', 'lucasmac37', 'ekapin2', 'chan32', 'case7', 'melurie03', 'b3nny312', 'aflocchini', 'jlorozc2', 'kgiacobazzi', 'bhchen2', 'oknoel', 'gobias', 'sunjialin', 'fredhdx', 'lshi14', 'shawkat', 'brenda.bedeaux', 'johns149', 'muneebahmed95', 'aashay1991', 'boertew1', 'sherrypri', 'nrb722', 'hronik1', 'snanav3', 'jkinne2', 'sfanou2', '1upgreenshroom', 'siwin2', 'sutchaya', 'vargas3', 'deasey1', 'kumikknd', 'neilchristanto', 'wang183', 'yuan11', 'toddlienemann', 'omghaxcode', 'capissen', 'ewalt1', 'banerje1', 'trovill1', 'lobert124', 'maddali1', 'chan1cyrus2', 'cernaus1', 'hartant2', 'jiwonp224', 'hoang4', 'cwjohnson', 'profballack', 'gong10', 'alostu3', 'xiaoyr068', 'nanotie', 'spesard1', 'chellia1', 'malik15', 'qliu9', 'madigan5', 'alabi2', 'supermeatboy', 'ericwoo1', 'feng12', 'greenwa1', 'mikenike', 'jclift3', 'zhou60', 'heebidiwup', 'swarley', 'gavinwinkel', 'yjaquinas', 'lidazhu1', 'mazzola1', 'novawater', 'jeffwebber808', 'mattycat9000', 'wlee26', 'psmisek07', 'lu30', 'mstlyhrmlss', 'levitas1', None, 'mikeystarr', 'wanchoi1', 'hatfarm', 'luiszelaya', 'spadin1', 'keating7', 'blee51', 'maxcan', 'leiche1', 'chrisgoulet', 'achavarria', 'samuelzhang', 'weberxzq', 'swallerick', 'tatuhiro', 'rice14', 'pashea1', 'yuanweih', 'geschreyr', 'kwak27', 'shapir11', 'zeqiuwu1', 'mraval', 'emma', 'foxytop', 'brittovivek', 'jielv1', 'toblerone16', '11018499jd', 'bony', 'donner1', 'moy21', 'jksikai', 'nam18', 'szhang51', 'handa1', 'jataput1', 'dynamicdoyle', 'lupas2', 'kilpatr2', 'mikeudelhofen', 'amnueyp1', 'alex81388', 'rmeekin11', 'mihrenoe', 'weber36', 'theerasit', 'mersch', 'tchajed', 'jtlust3', 'tomn7201', 'hardy6', 'aczerepak', 'stuber1', 'piyawon1', 'kim563', 'kandel3', 'gazdzia1', 'williamhn', 'eder0020', 'monnett1', 'bector1', 'arvman', 'roloscool', 'yun19', 'ddanielw', 'lee117', 'jain53', 'wente1', 'dereknowacki1', 'diliber1', 'geethabijjam', 'fandi514', 'ludao822', 'griffi21', 'edavilax', 'btanabe2', 'hasken1', 'kadakiy1', 'hchao2', 'nmisak', 'mroczek1', 'hazypensieve', 'gloger', 'dahlke2', 'hgao10', '8kobe24', 'dferrell68', 'mckiern1', 'stephenyzc', 'genome852', 'dicksonsalim', 'morris57', 'devharlalka', 'walter9', 'ucapssong', 'siveo123', 'jmarti', 'jefflale', 'tischer1']"
2,148,164,29,3,"['chrisgoulet', 'roloscool', 'dicksonsalim']",160,"['dhuang123', 'nookala', 'bae10', 'lucasmac37', 'ekapin2', 'chan32', 'case7', 'melurie03', 'b3nny312', 'jlorozc2', 'kgiacobazzi', 'bhchen2', 'oknoel', 'gobias', 'sunjialin', 'fredhdx', 'lshi14', 'shawkat', 'johns149', 'muneebahmed95', 'boertew1', 'sherrypri', 'hronik1', 'snanav3', 'jkinne2', 'sfanou2', '1upgreenshroom', 'siwin2', 'sutchaya', 'vargas3', 'deasey1', 'kumikknd', 'neilchristanto', 'wang183', 'omghaxcode', 'ewalt1', 'banerje1', 'trovill1', 'lobert124', 'maddali1', 'chan1cyrus2', 'cernaus1', 'hartant2', 'jiwonp224', 'hoang4', 'profballack', 'gong10', 'alostu3', 'xiaoyr068', 'nanotie', 'spesard1', 'chellia1', 'malik15', 'qliu9', 'madigan5', 'alabi2', 'supermeatboy', 'ericwoo1', 'feng12', 'greenwa1', 'mikenike', 'jclift3', 'zhou60', 'heebidiwup', 'swarley', 'gavinwinkel', 'yjaquinas', 'lidazhu1', 'mazzola1', 'novawater', 'mattycat9000', 'wlee26', 'lu30', 'mstlyhrmlss', 'levitas1', 'wanchoi1', 'hatfarm', 'luiszelaya', 'spadin1', 'keating7', 'blee51', 'maxcan', 'leiche1', 'achavarria', 'samuelzhang', 'weberxzq', 'tatuhiro', 'rice14', 'pashea1', 'yuanweih', 'geschreyr', 'kwak27', 'shapir11', 'zeqiuwu1', 'mraval', 'emma', 'foxytop', 'brittovivek', 'jielv1', 'toblerone16', 'bony', 'donner1', 'moy21', 'jksikai', 'nam18', 'szhang51', 'handa1', 'jataput1', 'lupas2', 'kilpatr2', 'mikeudelhofen', 'amnueyp1', 'alex81388', 'mihrenoe', 'weber36', 'theerasit', 'tchajed', 'jtlust3', 'hardy6', 'aczerepak', 'stuber1', 'piyawon1', 'kim563', 'kandel3', 'gazdzia1', 'williamhn', 'monnett1', 'bector1', 'arvman', 'yun19', 'ddanielw', 'lee117', 'jain53', 'wente1', 'diliber1', 'geethabijjam', 'fandi514', 'ludao822', 'griffi21', 'edavilax', 'btanabe2', 'hasken1', 'kadakiy1', 'hchao2', 'nmisak', 'mroczek1', 'hazypensieve', 'gloger', 'dahlke2', 'hgao10', '8kobe24', 'dferrell68', 'mckiern1', 'stephenyzc', 'genome852', 'morris57', 'devharlalka', 'ucapssong', 'jefflale', 'tischer1']",26,"['cshaffre', 'jill_freeland', 'ncorral2', 'thawley', 'sosany', 'kennethom1', 'cwkimbrough', 'carlosatkins', 'tbatth', 'daveleon', 'shanmich10', 'hodgesprodges', 'kdorsain', 'rmclinch', 'cbrown25', 'elockett', 'jakedubya', 'dpleasan', 'lance', 'sorubin2', 'sgrand2', None, 'ryanledbetter135', 'jmills6', 'carlthefuzzy1', 'tcopelan']",189,"['dhuang123', 'nookala', 'bae10', 'lucasmac37', 'ekapin2', 'chan32', 'sosany', 'case7', 'melurie03', 'b3nny312', 'jlorozc2', 'kgiacobazzi', 'bhchen2', 'oknoel', 'gobias', 'sunjialin', 'fredhdx', 'lshi14', 'shawkat', 'johns149', 'muneebahmed95', 'boertew1', 'sherrypri', 'hronik1', 'snanav3', 'sorubin2', 'jkinne2', 'sfanou2', '1upgreenshroom', 'siwin2', 'sutchaya', 'vargas3', 'deasey1', 'kumikknd', 'neilchristanto', 'wang183', 'omghaxcode', 'ewalt1', 'banerje1', 'trovill1', 'lobert124', 'maddali1', 'chan1cyrus2', 'cernaus1', 'hartant2', 'jiwonp224', 'hoang4', 'jill_freeland', 'profballack', 'gong10', 'ncorral2', 'thawley', 'alostu3', 'xiaoyr068', 'nanotie', 'cwkimbrough', 'spesard1', 'chellia1', 'malik15', 'qliu9', 'madigan5', 'alabi2', 'hodgesprodges', 'kdorsain', 'supermeatboy', 'rmclinch', 'ericwoo1', 'feng12', 'greenwa1', 'mikenike', 'jclift3', 'elockett', 'zhou60', 'heebidiwup', 'swarley', 'gavinwinkel', 'yjaquinas', 'lidazhu1', 'mazzola1', 'novawater', 'lance', 'mattycat9000', 'wlee26', 'lu30', 'mstlyhrmlss', 'levitas1', None, 'wanchoi1', 'hatfarm', 'luiszelaya', 'spadin1', 'keating7', 'blee51', 'maxcan', 'leiche1', 'chrisgoulet', 'achavarria', 'samuelzhang', 'weberxzq', 'kennethom1', 'tatuhiro', 'rice14', 'pashea1', 'yuanweih', 'geschreyr', 'carlosatkins', 'tbatth', 'kwak27', 'shapir11', 'zeqiuwu1', 'mraval', 'daveleon', 'emma', 'foxytop', 'brittovivek', 'jielv1', 'toblerone16', 'bony', 'donner1', 'moy21', 'jksikai', 'nam18', 'szhang51', 'handa1', 'jataput1', 'dpleasan', 'lupas2', 'kilpatr2', 'sgrand2', 'ryanledbetter135', 'mikeudelhofen', 'amnueyp1', 'alex81388', 'mihrenoe', 'weber36', 'theerasit', 'jmills6', 'tchajed', 'jtlust3', 'hardy6', 'aczerepak', 'stuber1', 'piyawon1', 'kim563', 'kandel3', 'tcopelan', 'gazdzia1', 'williamhn', 'cshaffre', 'monnett1', 'bector1', 'arvman', 'roloscool', 'yun19', 'ddanielw', 'lee117', 'jain53', 'wente1', 'diliber1', 'geethabijjam', 'shanmich10', 'fandi514', 'ludao822', 'griffi21', 'edavilax', 'btanabe2', 'hasken1', 'kadakiy1', 'hchao2', 'cbrown25', 'nmisak', 'mroczek1', 'hazypensieve', 'gloger', 'dahlke2', 'hgao10', '8kobe24', 'dferrell68', 'jakedubya', 'mckiern1', 'stephenyzc', 'genome852', 'dicksonsalim', 'morris57', 'devharlalka', 'ucapssong', 'carlthefuzzy1', 'jefflale', 'tischer1']"
2,151,164,28,18,"['kgiacobazzi', 'handa1', 'wente1', 'yjaquinas', 'qliu9', 'mroczek1', 'diliber1', 'dferrell68', 'dahlke2', 'jielv1', 'hronik1', 'roloscool', 'fandi514', 'dicksonsalim', 'ewalt1', 'chrisgoulet', 'greenwa1', 'edavilax']",145,"['dhuang123', 'nookala', 'bae10', 'lucasmac37', 'ekapin2', 'chan32', 'case7', 'melurie03', 'b3nny312', 'jlorozc2', 'bhchen2', 'oknoel', 'gobias', 'sunjialin', 'fredhdx', 'lshi14', 'shawkat', 'johns149', 'muneebahmed95', 'boertew1', 'sherrypri', 'snanav3', 'jkinne2', 'sfanou2', '1upgreenshroom', 'siwin2', 'sutchaya', 'vargas3', 'deasey1', 'kumikknd', 'neilchristanto', 'wang183', 'omghaxcode', 'banerje1', 'trovill1', 'lobert124', 'maddali1', 'chan1cyrus2', 'cernaus1', 'hartant2', 'jiwonp224', 'hoang4', 'profballack', 'gong10', 'alostu3', 'xiaoyr068', 'nanotie', 'spesard1', 'chellia1', 'malik15', 'madigan5', 'alabi2', 'supermeatboy', 'ericwoo1', 'feng12', 'mikenike', 'jclift3', 'zhou60', 'heebidiwup', 'swarley', 'gavinwinkel', 'lidazhu1', 'mazzola1', 'novawater', 'mattycat9000', 'wlee26', 'lu30', 'mstlyhrmlss', 'levitas1', 'wanchoi1', 'hatfarm', 'luiszelaya', 'spadin1', 'keating7', 'blee51', 'maxcan', 'leiche1', 'achavarria', 'samuelzhang', 'weberxzq', 'tatuhiro', 'rice14', 'pashea1', 'yuanweih', 'geschreyr', 'kwak27', 'shapir11', 'zeqiuwu1', 'mraval', 'emma', 'foxytop', 'brittovivek', 'toblerone16', 'bony', 'donner1', 'moy21', 'jksikai', 'nam18', 'szhang51', 'jataput1', 'lupas2', 'kilpatr2', 'mikeudelhofen', 'amnueyp1', 'alex81388', 'mihrenoe', 'weber36', 'theerasit', 'tchajed', 'jtlust3', 'hardy6', 'aczerepak', 'stuber1', 'piyawon1', 'kim563', 'kandel3', 'gazdzia1', 'williamhn', 'monnett1', 'bector1', 'arvman', 'yun19', 'ddanielw', 'lee117', 'jain53', 'geethabijjam', 'ludao822', 'griffi21', 'btanabe2', 'hasken1', 'kadakiy1', 'hchao2', 'nmisak', 'hazypensieve', 'gloger', 'hgao10', '8kobe24', 'mckiern1', 'stephenyzc', 'genome852', 'morris57', 'devharlalka', 'ucapssong', 'jefflale', 'tischer1']",10,"[None, 'tbatth', 'cbrown25', 'sgrand2', 'thawley', 'badger1', 'chen425', 'cwkimbrough', 'vishnunath822', 'martin14']",173,"['dhuang123', 'nookala', 'bae10', 'lucasmac37', 'ekapin2', 'chan32', 'case7', 'melurie03', 'b3nny312', 'jlorozc2', 'kgiacobazzi', 'bhchen2', 'oknoel', 'gobias', 'sunjialin', 'fredhdx', 'lshi14', 'shawkat', 'martin14', 'johns149', 'muneebahmed95', 'boertew1', 'sherrypri', 'hronik1', 'snanav3', 'jkinne2', 'sfanou2', '1upgreenshroom', 'siwin2', 'sutchaya', 'vargas3', 'deasey1', 'kumikknd', 'neilchristanto', 'wang183', 'omghaxcode', 'ewalt1', 'banerje1', 'trovill1', 'lobert124', 'maddali1', 'chan1cyrus2', 'cernaus1', 'hartant2', 'jiwonp224', 'hoang4', 'profballack', 'gong10', 'thawley', 'alostu3', 'xiaoyr068', 'nanotie', 'cwkimbrough', 'spesard1', 'chellia1', 'malik15', 'qliu9', 'madigan5', 'alabi2', 'supermeatboy', 'ericwoo1', 'feng12', 'greenwa1', 'mikenike', 'jclift3', 'zhou60', 'heebidiwup', 'swarley', 'gavinwinkel', 'yjaquinas', 'lidazhu1', 'mazzola1', 'novawater', 'mattycat9000', 'wlee26', 'lu30', 'mstlyhrmlss', 'levitas1', None, 'wanchoi1', 'hatfarm', 'luiszelaya', 'spadin1', 'keating7', 'blee51', 'badger1', 'chen425', 'maxcan', 'leiche1', 'chrisgoulet', 'achavarria', 'samuelzhang', 'weberxzq', 'tatuhiro', 'rice14', 'pashea1', 'yuanweih', 'geschreyr', 'tbatth', 'kwak27', 'shapir11', 'zeqiuwu1', 'mraval', 'emma', 'foxytop', 'brittovivek', 'jielv1', 'toblerone16', 'bony', 'donner1', 'moy21', 'jksikai', 'nam18', 'szhang51', 'handa1', 'jataput1', 'lupas2', 'kilpatr2', 'sgrand2', 'mikeudelhofen', 'amnueyp1', 'alex81388', 'mihrenoe', 'weber36', 'theerasit', 'tchajed', 'jtlust3', 'hardy6', 'aczerepak', 'stuber1', 'piyawon1', 'kim563', 'kandel3', 'gazdzia1', 'williamhn', 'monnett1', 'bector1', 'arvman', 'roloscool', 'yun19', 'ddanielw', 'lee117', 'jain53', 'wente1', 'diliber1', 'geethabijjam', 'fandi514', 'ludao822', 'griffi21', 'edavilax', 'btanabe2', 'hasken1', 'kadakiy1', 'hchao2', 'cbrown25', 'nmisak', 'mroczek1', 'hazypensieve', 'gloger', 'dahlke2', 'hgao10', '8kobe24', 'dferrell68', 'mckiern1', 'stephenyzc', 'genome852', 'dicksonsalim', 'morris57', 'vishnunath822', 'devharlalka', 'ucapssong', 'jefflale', 'tischer1']"
2,72,164,26,19,"['chan32', 'roloscool', 'case7', 'kgiacobazzi', 'wente1', 'qliu9', 'jielv1', 'fandi514', 'greenwa1', 'edavilax', 'handa1', 'swarley', 'mroczek1', 'dahlke2', 'novawater', 'snanav3', 'dicksonsalim', 'chrisgoulet', 'lobert124']",144,"['dhuang123', 'nookala', 'bae10', 'lucasmac37', 'ekapin2', 'melurie03', 'b3nny312', 'jlorozc2', 'bhchen2', 'oknoel', 'gobias', 'sunjialin', 'fredhdx', 'lshi14', 'shawkat', 'johns149', 'muneebahmed95', 'boertew1', 'sherrypri', 'hronik1', 'jkinne2', 'sfanou2', '1upgreenshroom', 'siwin2', 'sutchaya', 'vargas3', 'deasey1', 'kumikknd', 'neilchristanto', 'wang183', 'omghaxcode', 'ewalt1', 'banerje1', 'trovill1', 'maddali1', 'chan1cyrus2', 'cernaus1', 'hartant2', 'jiwonp224', 'hoang4', 'profballack', 'gong10', 'alostu3', 'xiaoyr068', 'nanotie', 'spesard1', 'chellia1', 'malik15', 'madigan5', 'alabi2', 'supermeatboy', 'ericwoo1', 'feng12', 'mikenike', 'jclift3', 'zhou60', 'heebidiwup', 'gavinwinkel', 'yjaquinas', 'lidazhu1', 'mazzola1', 'mattycat9000', 'wlee26', 'lu30', 'mstlyhrmlss', 'levitas1', 'wanchoi1', 'hatfarm', 'luiszelaya', 'spadin1', 'keating7', 'blee51', 'maxcan', 'leiche1', 'achavarria', 'samuelzhang', 'weberxzq', 'tatuhiro', 'rice14', 'pashea1', 'yuanweih', 'geschreyr', 'kwak27', 'shapir11', 'zeqiuwu1', 'mraval', 'emma', 'foxytop', 'brittovivek', 'toblerone16', 'bony', 'donner1', 'moy21', 'jksikai', 'nam18', 'szhang51', 'jataput1', 'lupas2', 'kilpatr2', 'mikeudelhofen', 'amnueyp1', 'alex81388', 'mihrenoe', 'weber36', 'theerasit', 'tchajed', 'jtlust3', 'hardy6', 'aczerepak', 'stuber1', 'piyawon1', 'kim563', 'kandel3', 'gazdzia1', 'williamhn', 'monnett1', 'bector1', 'arvman', 'yun19', 'ddanielw', 'lee117', 'jain53', 'diliber1', 'geethabijjam', 'ludao822', 'griffi21', 'btanabe2', 'hasken1', 'kadakiy1', 'hchao2', 'nmisak', 'hazypensieve', 'gloger', 'hgao10', '8kobe24', 'dferrell68', 'mckiern1', 'stephenyzc', 'genome852', 'morris57', 'devharlalka', 'ucapssong', 'jefflale', 'tischer1']",7,"['ryandwyer91', 'mrwilsonsaid', 't14', 'cpatchava', 'crosscounter87', 'mhg624', None]",170,"['dhuang123', 'nookala', 'bae10', 'lucasmac37', 'ekapin2', 'chan32', 'cpatchava', 'case7', 'melurie03', 'b3nny312', 'jlorozc2', 'kgiacobazzi', 'bhchen2', 'oknoel', 'gobias', 'sunjialin', 'fredhdx', 'lshi14', 'shawkat', 'johns149', 'muneebahmed95', 'boertew1', 'sherrypri', 'hronik1', 'snanav3', 'jkinne2', 'sfanou2', '1upgreenshroom', 'siwin2', 'sutchaya', 'vargas3', 'deasey1', 'kumikknd', 'neilchristanto', 'wang183', 'omghaxcode', 'ewalt1', 'banerje1', 'trovill1', 'lobert124', 'maddali1', 'chan1cyrus2', 'cernaus1', 'hartant2', 'jiwonp224', 'hoang4', 'profballack', 'gong10', 'alostu3', 'xiaoyr068', 'nanotie', 'spesard1', 'chellia1', 'malik15', 'qliu9', 't14', 'madigan5', 'alabi2', 'supermeatboy', 'ericwoo1', 'feng12', 'greenwa1', 'mikenike', 'jclift3', 'zhou60', 'heebidiwup', 'swarley', 'gavinwinkel', 'yjaquinas', 'lidazhu1', 'mazzola1', 'novawater', 'mattycat9000', 'wlee26', 'lu30', 'mstlyhrmlss', 'levitas1', None, 'wanchoi1', 'hatfarm', 'luiszelaya', 'spadin1', 'keating7', 'blee51', 'maxcan', 'leiche1', 'chrisgoulet', 'achavarria', 'samuelzhang', 'weberxzq', 'tatuhiro', 'rice14', 'pashea1', 'yuanweih', 'geschreyr', 'kwak27', 'shapir11', 'zeqiuwu1', 'mraval', 'emma', 'foxytop', 'brittovivek', 'jielv1', 'toblerone16', 'bony', 'donner1', 'moy21', 'jksikai', 'nam18', 'ryandwyer91', 'szhang51', 'handa1', 'jataput1', 'lupas2', 'kilpatr2', 'mikeudelhofen', 'amnueyp1', 'alex81388', 'mihrenoe', 'weber36', 'theerasit', 'tchajed', 'jtlust3', 'hardy6', 'aczerepak', 'stuber1', 'mhg624', 'piyawon1', 'kim563', 'kandel3', 'gazdzia1', 'williamhn', 'monnett1', 'bector1', 'arvman', 'roloscool', 'crosscounter87', 'yun19', 'ddanielw', 'lee117', 'jain53', 'wente1', 'diliber1', 'geethabijjam', 'mrwilsonsaid', 'fandi514', 'ludao822', 'griffi21', 'edavilax', 'btanabe2', 'hasken1', 'kadakiy1', 'hchao2', 'nmisak', 'mroczek1', 'hazypensieve', 'gloger', 'dahlke2', 'hgao10', '8kobe24', 'dferrell68', 'mckiern1', 'stephenyzc', 'genome852', 'dicksonsalim', 'morris57', 'devharlalka', 'ucapssong', 'jefflale', 'tischer1']"
2,90,164,22,15,"['dicksonsalim', 'kgiacobazzi', 'wente1', 'neilchristanto', 'qliu9', 'mroczek1', 'dahlke2', 'lobert124', 'jielv1', 'chan32', 'fandi514', 'case7', 'supermeatboy', 'greenwa1', 'edavilax']",148,"['dhuang123', 'nookala', 'bae10', 'lucasmac37', 'ekapin2', 'melurie03', 'b3nny312', 'jlorozc2', 'bhchen2', 'oknoel', 'gobias', 'sunjialin', 'fredhdx', 'lshi14', 'shawkat', 'johns149', 'muneebahmed95', 'boertew1', 'sherrypri', 'hronik1', 'snanav3', 'jkinne2', 'sfanou2', '1upgreenshroom', 'siwin2', 'sutchaya', 'vargas3', 'deasey1', 'kumikknd', 'wang183', 'omghaxcode', 'ewalt1', 'banerje1', 'trovill1', 'maddali1', 'chan1cyrus2', 'cernaus1', 'hartant2', 'jiwonp224', 'hoang4', 'profballack', 'gong10', 'alostu3', 'xiaoyr068', 'nanotie', 'spesard1', 'chellia1', 'malik15', 'madigan5', 'alabi2', 'ericwoo1', 'feng12', 'mikenike', 'jclift3', 'zhou60', 'heebidiwup', 'swarley', 'gavinwinkel', 'yjaquinas', 'lidazhu1', 'mazzola1', 'novawater', 'mattycat9000', 'wlee26', 'lu30', 'mstlyhrmlss', 'levitas1', 'wanchoi1', 'hatfarm', 'luiszelaya', 'spadin1', 'keating7', 'blee51', 'maxcan', 'leiche1', 'chrisgoulet', 'achavarria', 'samuelzhang', 'weberxzq', 'tatuhiro', 'rice14', 'pashea1', 'yuanweih', 'geschreyr', 'kwak27', 'shapir11', 'zeqiuwu1', 'mraval', 'emma', 'foxytop', 'brittovivek', 'toblerone16', 'bony', 'donner1', 'moy21', 'jksikai', 'nam18', 'szhang51', 'handa1', 'jataput1', 'lupas2', 'kilpatr2', 'mikeudelhofen', 'amnueyp1', 'alex81388', 'mihrenoe', 'weber36', 'theerasit', 'tchajed', 'jtlust3', 'hardy6', 'aczerepak', 'stuber1', 'piyawon1', 'kim563', 'kandel3', 'gazdzia1', 'williamhn', 'monnett1', 'bector1', 'arvman', 'roloscool', 'yun19', 'ddanielw', 'lee117', 'jain53', 'diliber1', 'geethabijjam', 'ludao822', 'griffi21', 'btanabe2', 'hasken1', 'kadakiy1', 'hchao2', 'nmisak', 'hazypensieve', 'gloger', 'hgao10', '8kobe24', 'dferrell68', 'mckiern1', 'stephenyzc', 'genome852', 'morris57', 'devharlalka', 'ucapssong', 'jefflale', 'tischer1']",7,"['ouldsaghir', 'bdlftth2', 'shamohan', 'hur6', 'roboemperor', 'red6290', None]",170,"['dhuang123', 'nookala', 'bae10', 'lucasmac37', 'ekapin2', 'chan32', 'case7', 'melurie03', 'b3nny312', 'jlorozc2', 'kgiacobazzi', 'bhchen2', 'oknoel', 'gobias', 'sunjialin', 'fredhdx', 'lshi14', 'shawkat', 'johns149', 'muneebahmed95', 'boertew1', 'sherrypri', 'hronik1', 'snanav3', 'shamohan', 'jkinne2', 'sfanou2', '1upgreenshroom', 'siwin2', 'sutchaya', 'vargas3', 'deasey1', 'kumikknd', 'neilchristanto', 'wang183', 'bdlftth2', 'omghaxcode', 'ewalt1', 'banerje1', 'trovill1', 'lobert124', 'maddali1', 'chan1cyrus2', 'cernaus1', 'hartant2', 'jiwonp224', 'hoang4', 'profballack', 'gong10', 'alostu3', 'xiaoyr068', 'nanotie', 'spesard1', 'chellia1', 'malik15', 'qliu9', 'madigan5', 'alabi2', 'supermeatboy', 'roboemperor', 'ericwoo1', 'feng12', 'greenwa1', 'mikenike', 'jclift3', 'zhou60', 'heebidiwup', 'swarley', 'gavinwinkel', 'yjaquinas', 'lidazhu1', 'mazzola1', 'novawater', 'mattycat9000', 'wlee26', 'lu30', 'mstlyhrmlss', 'levitas1', None, 'wanchoi1', 'hatfarm', 'luiszelaya', 'spadin1', 'keating7', 'blee51', 'maxcan', 'leiche1', 'chrisgoulet', 'achavarria', 'samuelzhang', 'weberxzq', 'tatuhiro', 'rice14', 'pashea1', 'yuanweih', 'geschreyr', 'kwak27', 'shapir11', 'zeqiuwu1', 'mraval', 'emma', 'foxytop', 'brittovivek', 'jielv1', 'toblerone16', 'hur6', 'bony', 'donner1', 'moy21', 'jksikai', 'nam18', 'szhang51', 'handa1', 'jataput1', 'lupas2', 'kilpatr2', 'mikeudelhofen', 'amnueyp1', 'alex81388', 'mihrenoe', 'weber36', 'theerasit', 'tchajed', 'jtlust3', 'hardy6', 'aczerepak', 'stuber1', 'piyawon1', 'kim563', 'kandel3', 'gazdzia1', 'ouldsaghir', 'williamhn', 'monnett1', 'bector1', 'arvman', 'roloscool', 'yun19', 'ddanielw', 'lee117', 'jain53', 'wente1', 'diliber1', 'geethabijjam', 'fandi514', 'ludao822', 'griffi21', 'red6290', 'edavilax', 'btanabe2', 'hasken1', 'kadakiy1', 'hchao2', 'nmisak', 'mroczek1', 'hazypensieve', 'gloger', 'dahlke2', 'hgao10', '8kobe24', 'dferrell68', 'mckiern1', 'stephenyzc', 'genome852', 'dicksonsalim', 'morris57', 'devharlalka', 'ucapssong', 'jefflale', 'tischer1']"
2,46,164,21,18,"['dicksonsalim', 'hasken1', 'kgiacobazzi', 'wente1', 'swarley', 'qliu9', 'mroczek1', 'dahlke2', 'neilchristanto', 'hgao10', 'jielv1', 'chan32', 'ewalt1', 'fandi514', 'case7', 'chrisgoulet', 'greenwa1', 'edavilax']",145,"['dhuang123', 'nookala', 'bae10', 'lucasmac37', 'ekapin2', 'melurie03', 'b3nny312', 'jlorozc2', 'bhchen2', 'oknoel', 'gobias', 'sunjialin', 'fredhdx', 'lshi14', 'shawkat', 'johns149', 'muneebahmed95', 'boertew1', 'sherrypri', 'hronik1', 'snanav3', 'jkinne2', 'sfanou2', '1upgreenshroom', 'siwin2', 'sutchaya', 'vargas3', 'deasey1', 'kumikknd', 'wang183', 'omghaxcode', 'banerje1', 'trovill1', 'lobert124', 'maddali1', 'chan1cyrus2', 'cernaus1', 'hartant2', 'jiwonp224', 'hoang4', 'profballack', 'gong10', 'alostu3', 'xiaoyr068', 'nanotie', 'spesard1', 'chellia1', 'malik15', 'madigan5', 'alabi2', 'supermeatboy', 'ericwoo1', 'feng12', 'mikenike', 'jclift3', 'zhou60', 'heebidiwup', 'gavinwinkel', 'yjaquinas', 'lidazhu1', 'mazzola1', 'novawater', 'mattycat9000', 'wlee26', 'lu30', 'mstlyhrmlss', 'levitas1', 'wanchoi1', 'hatfarm', 'luiszelaya', 'spadin1', 'keating7', 'blee51', 'maxcan', 'leiche1', 'achavarria', 'samuelzhang', 'weberxzq', 'tatuhiro', 'rice14', 'pashea1', 'yuanweih', 'geschreyr', 'kwak27', 'shapir11', 'zeqiuwu1', 'mraval', 'emma', 'foxytop', 'brittovivek', 'toblerone16', 'bony', 'donner1', 'moy21', 'jksikai', 'nam18', 'szhang51', 'handa1', 'jataput1', 'lupas2', 'kilpatr2', 'mikeudelhofen', 'amnueyp1', 'alex81388', 'mihrenoe', 'weber36', 'theerasit', 'tchajed', 'jtlust3', 'hardy6', 'aczerepak', 'stuber1', 'piyawon1', 'kim563', 'kandel3', 'gazdzia1', 'williamhn', 'monnett1', 'bector1', 'arvman', 'roloscool', 'yun19', 'ddanielw', 'lee117', 'jain53', 'diliber1', 'geethabijjam', 'ludao822', 'griffi21', 'btanabe2', 'kadakiy1', 'hchao2', 'nmisak', 'hazypensieve', 'gloger', '8kobe24', 'dferrell68', 'mckiern1', 'stephenyzc', 'genome852', 'morris57', 'devharlalka', 'ucapssong', 'jefflale', 'tischer1']",3,"['vishnunath822', None, 'martin14']",166,"['dhuang123', 'nookala', 'bae10', 'lucasmac37', 'ekapin2', 'chan32', 'case7', 'melurie03', 'b3nny312', 'jlorozc2', 'kgiacobazzi', 'bhchen2', 'oknoel', 'gobias', 'sunjialin', 'fredhdx', 'lshi14', 'shawkat', 'martin14', 'johns149', 'muneebahmed95', 'boertew1', 'sherrypri', 'hronik1', 'snanav3', 'jkinne2', 'sfanou2', '1upgreenshroom', 'siwin2', 'sutchaya', 'vargas3', 'deasey1', 'kumikknd', 'neilchristanto', 'wang183', 'omghaxcode', 'ewalt1', 'banerje1', 'trovill1', 'lobert124', 'maddali1', 'chan1cyrus2', 'cernaus1', 'hartant2', 'jiwonp224', 'hoang4', 'profballack', 'gong10', 'alostu3', 'xiaoyr068', 'nanotie', 'spesard1', 'chellia1', 'malik15', 'qliu9', 'madigan5', 'alabi2', 'supermeatboy', 'ericwoo1', 'feng12', 'greenwa1', 'mikenike', 'jclift3', 'zhou60', 'heebidiwup', 'swarley', 'gavinwinkel', 'yjaquinas', 'lidazhu1', 'mazzola1', 'novawater', 'mattycat9000', 'wlee26', 'lu30', 'mstlyhrmlss', 'levitas1', None, 'wanchoi1', 'hatfarm', 'luiszelaya', 'spadin1', 'keating7', 'blee51', 'maxcan', 'leiche1', 'chrisgoulet', 'achavarria', 'samuelzhang', 'weberxzq', 'tatuhiro', 'rice14', 'pashea1', 'yuanweih', 'geschreyr', 'kwak27', 'shapir11', 'zeqiuwu1', 'mraval', 'emma', 'foxytop', 'brittovivek', 'jielv1', 'toblerone16', 'bony', 'donner1', 'moy21', 'jksikai', 'nam18', 'szhang51', 'handa1', 'jataput1', 'lupas2', 'kilpatr2', 'mikeudelhofen', 'amnueyp1', 'alex81388', 'mihrenoe', 'weber36', 'theerasit', 'tchajed', 'jtlust3', 'hardy6', 'aczerepak', 'stuber1', 'piyawon1', 'kim563', 'kandel3', 'gazdzia1', 'williamhn', 'monnett1', 'bector1', 'arvman', 'roloscool', 'yun19', 'ddanielw', 'lee117', 'jain53', 'wente1', 'diliber1', 'geethabijjam', 'fandi514', 'ludao822', 'griffi21', 'edavilax', 'btanabe2', 'hasken1', 'kadakiy1', 'hchao2', 'nmisak', 'mroczek1', 'hazypensieve', 'gloger', 'dahlke2', 'hgao10', '8kobe24', 'dferrell68', 'mckiern1', 'stephenyzc', 'genome852', 'dicksonsalim', 'morris57', 'vishnunath822', 'devharlalka', 'ucapssong', 'jefflale', 'tischer1']"
2,116,164,16,3,"['amnueyp1', 'blee51', 'nookala']",160,"['dhuang123', 'bae10', 'lucasmac37', 'ekapin2', 'chan32', 'case7', 'melurie03', 'b3nny312', 'jlorozc2', 'kgiacobazzi', 'bhchen2', 'oknoel', 'gobias', 'sunjialin', 'fredhdx', 'lshi14', 'shawkat', 'johns149', 'muneebahmed95', 'boertew1', 'sherrypri', 'hronik1', 'snanav3', 'jkinne2', 'sfanou2', '1upgreenshroom', 'siwin2', 'sutchaya', 'vargas3', 'deasey1', 'kumikknd', 'neilchristanto', 'wang183', 'omghaxcode', 'ewalt1', 'banerje1', 'trovill1', 'lobert124', 'maddali1', 'chan1cyrus2', 'cernaus1', 'hartant2', 'jiwonp224', 'hoang4', 'profballack', 'gong10', 'alostu3', 'xiaoyr068', 'nanotie', 'spesard1', 'chellia1', 'malik15', 'qliu9', 'madigan5', 'alabi2', 'supermeatboy', 'ericwoo1', 'feng12', 'greenwa1', 'mikenike', 'jclift3', 'zhou60', 'heebidiwup', 'swarley', 'gavinwinkel', 'yjaquinas', 'lidazhu1', 'mazzola1', 'novawater', 'mattycat9000', 'wlee26', 'lu30', 'mstlyhrmlss', 'levitas1', 'wanchoi1', 'hatfarm', 'luiszelaya', 'spadin1', 'keating7', 'maxcan', 'leiche1', 'chrisgoulet', 'achavarria', 'samuelzhang', 'weberxzq', 'tatuhiro', 'rice14', 'pashea1', 'yuanweih', 'geschreyr', 'kwak27', 'shapir11', 'zeqiuwu1', 'mraval', 'emma', 'foxytop', 'brittovivek', 'jielv1', 'toblerone16', 'bony', 'donner1', 'moy21', 'jksikai', 'nam18', 'szhang51', 'handa1', 'jataput1', 'lupas2', 'kilpatr2', 'mikeudelhofen', 'alex81388', 'mihrenoe', 'weber36', 'theerasit', 'tchajed', 'jtlust3', 'hardy6', 'aczerepak', 'stuber1', 'piyawon1', 'kim563', 'kandel3', 'gazdzia1', 'williamhn', 'monnett1', 'bector1', 'arvman', 'roloscool', 'yun19', 'ddanielw', 'lee117', 'jain53', 'wente1', 'diliber1', 'geethabijjam', 'fandi514', 'ludao822', 'griffi21', 'edavilax', 'btanabe2', 'hasken1', 'kadakiy1', 'hchao2', 'nmisak', 'mroczek1', 'hazypensieve', 'gloger', 'dahlke2', 'hgao10', '8kobe24', 'dferrell68', 'mckiern1', 'stephenyzc', 'genome852', 'dicksonsalim', 'morris57', 'devharlalka', 'ucapssong', 'jefflale', 'tischer1']",13,"['mahed', 'mast5', 'sungbea89', 'bababu', 'bdlftth2', 'bobdole777', 'azam2', 'jkim449', 'sundar0301', 'kejacs', None, 'rajaraj1', 'pranav9']",176,"['dhuang123', 'nookala', 'bae10', 'lucasmac37', 'ekapin2', 'chan32', 'case7', 'melurie03', 'b3nny312', 'jlorozc2', 'kgiacobazzi', 'bhchen2', 'oknoel', 'gobias', 'sunjialin', 'sungbea89', 'fredhdx', 'lshi14', 'shawkat', 'johns149', 'muneebahmed95', 'boertew1', 'sherrypri', 'hronik1', 'snanav3', 'jkinne2', 'sfanou2', '1upgreenshroom', 'siwin2', 'sutchaya', 'vargas3', 'deasey1', 'kumikknd', 'neilchristanto', 'wang183', 'bdlftth2', 'omghaxcode', 'ewalt1', 'banerje1', 'trovill1', 'lobert124', 'maddali1', 'chan1cyrus2', 'cernaus1', 'pranav9', 'hartant2', 'jiwonp224', 'hoang4', 'profballack', 'gong10', 'alostu3', 'xiaoyr068', 'nanotie', 'spesard1', 'chellia1', 'malik15', 'qliu9', 'madigan5', 'alabi2', 'sundar0301', 'kejacs', 'supermeatboy', 'ericwoo1', 'feng12', 'greenwa1', 'mikenike', 'jclift3', 'zhou60', 'heebidiwup', 'swarley', 'gavinwinkel', 'yjaquinas', 'lidazhu1', 'mazzola1', 'azam2', 'novawater', 'mattycat9000', 'wlee26', 'lu30', 'mstlyhrmlss', 'levitas1', None, 'mast5', 'wanchoi1', 'hatfarm', 'luiszelaya', 'spadin1', 'keating7', 'blee51', 'maxcan', 'leiche1', 'chrisgoulet', 'achavarria', 'samuelzhang', 'mahed', 'weberxzq', 'tatuhiro', 'rice14', 'pashea1', 'yuanweih', 'geschreyr', 'kwak27', 'shapir11', 'zeqiuwu1', 'mraval', 'emma', 'foxytop', 'brittovivek', 'jielv1', 'toblerone16', 'bony', 'donner1', 'moy21', 'jksikai', 'nam18', 'szhang51', 'handa1', 'jataput1', 'lupas2', 'kilpatr2', 'mikeudelhofen', 'amnueyp1', 'alex81388', 'mihrenoe', 'weber36', 'theerasit', 'tchajed', 'jtlust3', 'hardy6', 'aczerepak', 'stuber1', 'piyawon1', 'kim563', 'kandel3', 'gazdzia1', 'bababu', 'williamhn', 'monnett1', 'bector1', 'arvman', 'roloscool', 'yun19', 'ddanielw', 'lee117', 'jain53', 'wente1', 'diliber1', 'geethabijjam', 'fandi514', 'ludao822', 'griffi21', 'edavilax', 'btanabe2', 'hasken1', 'kadakiy1', 'hchao2', 'nmisak', 'mroczek1', 'hazypensieve', 'gloger', 'dahlke2', 'hgao10', '8kobe24', 'dferrell68', 'bobdole777', 'mckiern1', 'stephenyzc', 'genome852', 'dicksonsalim', 'morris57', 'devharlalka', 'ucapssong', 'jkim449', 'jefflale', 'tischer1', 'rajaraj1']"
2,51,164,10,6,"['emma', 'jtlust3', 'hronik1', 'jefflale', 'mraval', 'jkinne2']",157,"['dhuang123', 'nookala', 'bae10', 'lucasmac37', 'ekapin2', 'chan32', 'case7', 'melurie03', 'b3nny312', 'jlorozc2', 'kgiacobazzi', 'bhchen2', 'oknoel', 'gobias', 'sunjialin', 'fredhdx', 'lshi14', 'shawkat', 'johns149', 'muneebahmed95', 'boertew1', 'sherrypri', 'snanav3', 'sfanou2', '1upgreenshroom', 'siwin2', 'sutchaya', 'vargas3', 'deasey1', 'kumikknd', 'neilchristanto', 'wang183', 'omghaxcode', 'ewalt1', 'banerje1', 'trovill1', 'lobert124', 'maddali1', 'chan1cyrus2', 'cernaus1', 'hartant2', 'jiwonp224', 'hoang4', 'profballack', 'gong10', 'alostu3', 'xiaoyr068', 'nanotie', 'spesard1', 'chellia1', 'malik15', 'qliu9', 'madigan5', 'alabi2', 'supermeatboy', 'ericwoo1', 'feng12', 'greenwa1', 'mikenike', 'jclift3', 'zhou60', 'heebidiwup', 'swarley', 'gavinwinkel', 'yjaquinas', 'lidazhu1', 'mazzola1', 'novawater', 'mattycat9000', 'wlee26', 'lu30', 'mstlyhrmlss', 'levitas1', 'wanchoi1', 'hatfarm', 'luiszelaya', 'spadin1', 'keating7', 'blee51', 'maxcan', 'leiche1', 'chrisgoulet', 'achavarria', 'samuelzhang', 'weberxzq', 'tatuhiro', 'rice14', 'pashea1', 'yuanweih', 'geschreyr', 'kwak27', 'shapir11', 'zeqiuwu1', 'foxytop', 'brittovivek', 'jielv1', 'toblerone16', 'bony', 'donner1', 'moy21', 'jksikai', 'nam18', 'szhang51', 'handa1', 'jataput1', 'lupas2', 'kilpatr2', 'mikeudelhofen', 'amnueyp1', 'alex81388', 'mihrenoe', 'weber36', 'theerasit', 'tchajed', 'hardy6', 'aczerepak', 'stuber1', 'piyawon1', 'kim563', 'kandel3', 'gazdzia1', 'williamhn', 'monnett1', 'bector1', 'arvman', 'roloscool', 'yun19', 'ddanielw', 'lee117', 'jain53', 'wente1', 'diliber1', 'geethabijjam', 'fandi514', 'ludao822', 'griffi21', 'edavilax', 'btanabe2', 'hasken1', 'kadakiy1', 'hchao2', 'nmisak', 'mroczek1', 'hazypensieve', 'gloger', 'dahlke2', 'hgao10', '8kobe24', 'dferrell68', 'mckiern1', 'stephenyzc', 'genome852', 'dicksonsalim', 'morris57', 'devharlalka', 'ucapssong', 'tischer1']",4,"['zhangyj', 'mahed', None, 'ysun12']",167,"['dhuang123', 'nookala', 'bae10', 'lucasmac37', 'ekapin2', 'chan32', 'case7', 'melurie03', 'b3nny312', 'jlorozc2', 'kgiacobazzi', 'bhchen2', 'oknoel', 'gobias', 'sunjialin', 'fredhdx', 'lshi14', 'shawkat', 'johns149', 'muneebahmed95', 'boertew1', 'sherrypri', 'hronik1', 'snanav3', 'jkinne2', 'sfanou2', '1upgreenshroom', 'siwin2', 'sutchaya', 'vargas3', 'deasey1', 'kumikknd', 'neilchristanto', 'wang183', 'omghaxcode', 'ewalt1', 'banerje1', 'trovill1', 'lobert124', 'maddali1', 'chan1cyrus2', 'cernaus1', 'hartant2', 'jiwonp224', 'hoang4', 'profballack', 'gong10', 'alostu3', 'xiaoyr068', 'nanotie', 'spesard1', 'chellia1', 'malik15', 'qliu9', 'madigan5', 'alabi2', 'supermeatboy', 'ericwoo1', 'feng12', 'greenwa1', 'mikenike', 'jclift3', 'zhou60', 'heebidiwup', 'swarley', 'gavinwinkel', 'yjaquinas', 'lidazhu1', 'mazzola1', 'novawater', 'mattycat9000', 'wlee26', 'lu30', 'mstlyhrmlss', 'levitas1', None, 'zhangyj', 'wanchoi1', 'hatfarm', 'luiszelaya', 'spadin1', 'keating7', 'blee51', 'maxcan', 'leiche1', 'chrisgoulet', 'achavarria', 'samuelzhang', 'mahed', 'weberxzq', 'tatuhiro', 'rice14', 'pashea1', 'yuanweih', 'geschreyr', 'kwak27', 'shapir11', 'zeqiuwu1', 'mraval', 'emma', 'foxytop', 'brittovivek', 'jielv1', 'toblerone16', 'bony', 'donner1', 'moy21', 'jksikai', 'nam18', 'szhang51', 'handa1', 'jataput1', 'lupas2', 'kilpatr2', 'mikeudelhofen', 'amnueyp1', 'alex81388', 'mihrenoe', 'weber36', 'theerasit', 'tchajed', 'jtlust3', 'hardy6', 'aczerepak', 'stuber1', 'piyawon1', 'kim563', 'kandel3', 'gazdzia1', 'williamhn', 'monnett1', 'bector1', 'arvman', 'roloscool', 'yun19', 'ddanielw', 'lee117', 'jain53', 'wente1', 'diliber1', 'geethabijjam', 'fandi514', 'ludao822', 'griffi21', 'edavilax', 'btanabe2', 'hasken1', 'kadakiy1', 'hchao2', 'nmisak', 'mroczek1', 'hazypensieve', 'gloger', 'dahlke2', 'hgao10', '8kobe24', 'dferrell68', 'ysun12', 'mckiern1', 'stephenyzc', 'genome852', 'dicksonsalim', 'morris57', 'devharlalka', 'ucapssong', 'jefflale', 'tischer1']"
2,47,164,7,6,"['amnueyp1', 'gazdzia1', 'toblerone16', 'arvman', 'mattycat9000', 'piyawon1']",157,"['dhuang123', 'nookala', 'bae10', 'lucasmac37', 'ekapin2', 'chan32', 'case7', 'melurie03', 'b3nny312', 'jlorozc2', 'kgiacobazzi', 'bhchen2', 'oknoel', 'gobias', 'sunjialin', 'fredhdx', 'lshi14', 'shawkat', 'johns149', 'muneebahmed95', 'boertew1', 'sherrypri', 'hronik1', 'snanav3', 'jkinne2', 'sfanou2', '1upgreenshroom', 'siwin2', 'sutchaya', 'vargas3', 'deasey1', 'kumikknd', 'neilchristanto', 'wang183', 'omghaxcode', 'ewalt1', 'banerje1', 'trovill1', 'lobert124', 'maddali1', 'chan1cyrus2', 'cernaus1', 'hartant2', 'jiwonp224', 'hoang4', 'profballack', 'gong10', 'alostu3', 'xiaoyr068', 'nanotie', 'spesard1', 'chellia1', 'malik15', 'qliu9', 'madigan5', 'alabi2', 'supermeatboy', 'ericwoo1', 'feng12', 'greenwa1', 'mikenike', 'jclift3', 'zhou60', 'heebidiwup', 'swarley', 'gavinwinkel', 'yjaquinas', 'lidazhu1', 'mazzola1', 'novawater', 'wlee26', 'lu30', 'mstlyhrmlss', 'levitas1', 'wanchoi1', 'hatfarm', 'luiszelaya', 'spadin1', 'keating7', 'blee51', 'maxcan', 'leiche1', 'chrisgoulet', 'achavarria', 'samuelzhang', 'weberxzq', 'tatuhiro', 'rice14', 'pashea1', 'yuanweih', 'geschreyr', 'kwak27', 'shapir11', 'zeqiuwu1', 'mraval', 'emma', 'foxytop', 'brittovivek', 'jielv1', 'bony', 'donner1', 'moy21', 'jksikai', 'nam18', 'szhang51', 'handa1', 'jataput1', 'lupas2', 'kilpatr2', 'mikeudelhofen', 'alex81388', 'mihrenoe', 'weber36', 'theerasit', 'tchajed', 'jtlust3', 'hardy6', 'aczerepak', 'stuber1', 'kim563', 'kandel3', 'williamhn', 'monnett1', 'bector1', 'roloscool', 'yun19', 'ddanielw', 'lee117', 'jain53', 'wente1', 'diliber1', 'geethabijjam', 'fandi514', 'ludao822', 'griffi21', 'edavilax', 'btanabe2', 'hasken1', 'kadakiy1', 'hchao2', 'nmisak', 'mroczek1', 'hazypensieve', 'gloger', 'dahlke2', 'hgao10', '8kobe24', 'dferrell68', 'mckiern1', 'stephenyzc', 'genome852', 'dicksonsalim', 'morris57', 'devharlalka', 'ucapssong', 'jefflale', 'tischer1']",1,[None],164,"['dhuang123', 'nookala', 'bae10', 'lucasmac37', 'ekapin2', 'chan32', 'case7', 'melurie03', 'b3nny312', 'jlorozc2', 'kgiacobazzi', 'bhchen2', 'oknoel', 'gobias', 'sunjialin', 'fredhdx', 'lshi14', 'shawkat', 'johns149', 'muneebahmed95', 'boertew1', 'sherrypri', 'hronik1', 'snanav3', 'jkinne2', 'sfanou2', '1upgreenshroom', 'siwin2', 'sutchaya', 'vargas3', 'deasey1', 'kumikknd', 'neilchristanto', 'wang183', 'omghaxcode', 'ewalt1', 'banerje1', 'trovill1', 'lobert124', 'maddali1', 'chan1cyrus2', 'cernaus1', 'hartant2', 'jiwonp224', 'hoang4', 'profballack', 'gong10', 'alostu3', 'xiaoyr068', 'nanotie', 'spesard1', 'chellia1', 'malik15', 'qliu9', 'madigan5', 'alabi2', 'supermeatboy', 'ericwoo1', 'feng12', 'greenwa1', 'mikenike', 'jclift3', 'zhou60', 'heebidiwup', 'swarley', 'gavinwinkel', 'yjaquinas', 'lidazhu1', 'mazzola1', 'novawater', 'mattycat9000', 'wlee26', 'lu30', 'mstlyhrmlss', 'levitas1', None, 'wanchoi1', 'hatfarm', 'luiszelaya', 'spadin1', 'keating7', 'blee51', 'maxcan', 'leiche1', 'chrisgoulet', 'achavarria', 'samuelzhang', 'weberxzq', 'tatuhiro', 'rice14', 'pashea1', 'yuanweih', 'geschreyr', 'kwak27', 'shapir11', 'zeqiuwu1', 'mraval', 'emma', 'foxytop', 'brittovivek', 'jielv1', 'toblerone16', 'bony', 'donner1', 'moy21', 'jksikai', 'nam18', 'szhang51', 'handa1', 'jataput1', 'lupas2', 'kilpatr2', 'mikeudelhofen', 'amnueyp1', 'alex81388', 'mihrenoe', 'weber36', 'theerasit', 'tchajed', 'jtlust3', 'hardy6', 'aczerepak', 'stuber1', 'piyawon1', 'kim563', 'kandel3', 'gazdzia1', 'williamhn', 'monnett1', 'bector1', 'arvman', 'roloscool', 'yun19', 'ddanielw', 'lee117', 'jain53', 'wente1', 'diliber1', 'geethabijjam', 'fandi514', 'ludao822', 'griffi21', 'edavilax', 'btanabe2', 'hasken1', 'kadakiy1', 'hchao2', 'nmisak', 'mroczek1', 'hazypensieve', 'gloger', 'dahlke2', 'hgao10', '8kobe24', 'dferrell68', 'mckiern1', 'stephenyzc', 'genome852', 'dicksonsalim', 'morris57', 'devharlalka', 'ucapssong', 'jefflale', 'tischer1']"
2,73,164,7,6,"['lucasmac37', 'diliber1', 'mckiern1', 'rice14', 'melurie03', 'chan1cyrus2']",157,"['dhuang123', 'nookala', 'bae10', 'ekapin2', 'chan32', 'case7', 'b3nny312', 'jlorozc2', 'kgiacobazzi', 'bhchen2', 'oknoel', 'gobias', 'sunjialin', 'fredhdx', 'lshi14', 'shawkat', 'johns149', 'muneebahmed95', 'boertew1', 'sherrypri', 'hronik1', 'snanav3', 'jkinne2', 'sfanou2', '1upgreenshroom', 'siwin2', 'sutchaya', 'vargas3', 'deasey1', 'kumikknd', 'neilchristanto', 'wang183', 'omghaxcode', 'ewalt1', 'banerje1', 'trovill1', 'lobert124', 'maddali1', 'cernaus1', 'hartant2', 'jiwonp224', 'hoang4', 'profballack', 'gong10', 'alostu3', 'xiaoyr068', 'nanotie', 'spesard1', 'chellia1', 'malik15', 'qliu9', 'madigan5', 'alabi2', 'supermeatboy', 'ericwoo1', 'feng12', 'greenwa1', 'mikenike', 'jclift3', 'zhou60', 'heebidiwup', 'swarley', 'gavinwinkel', 'yjaquinas', 'lidazhu1', 'mazzola1', 'novawater', 'mattycat9000', 'wlee26', 'lu30', 'mstlyhrmlss', 'levitas1', 'wanchoi1', 'hatfarm', 'luiszelaya', 'spadin1', 'keating7', 'blee51', 'maxcan', 'leiche1', 'chrisgoulet', 'achavarria', 'samuelzhang', 'weberxzq', 'tatuhiro', 'pashea1', 'yuanweih', 'geschreyr', 'kwak27', 'shapir11', 'zeqiuwu1', 'mraval', 'emma', 'foxytop', 'brittovivek', 'jielv1', 'toblerone16', 'bony', 'donner1', 'moy21', 'jksikai', 'nam18', 'szhang51', 'handa1', 'jataput1', 'lupas2', 'kilpatr2', 'mikeudelhofen', 'amnueyp1', 'alex81388', 'mihrenoe', 'weber36', 'theerasit', 'tchajed', 'jtlust3', 'hardy6', 'aczerepak', 'stuber1', 'piyawon1', 'kim563', 'kandel3', 'gazdzia1', 'williamhn', 'monnett1', 'bector1', 'arvman', 'roloscool', 'yun19', 'ddanielw', 'lee117', 'jain53', 'wente1', 'geethabijjam', 'fandi514', 'ludao822', 'griffi21', 'edavilax', 'btanabe2', 'hasken1', 'kadakiy1', 'hchao2', 'nmisak', 'mroczek1', 'hazypensieve', 'gloger', 'dahlke2', 'hgao10', '8kobe24', 'dferrell68', 'stephenyzc', 'genome852', 'dicksonsalim', 'morris57', 'devharlalka', 'ucapssong', 'jefflale', 'tischer1']",1,[None],164,"['dhuang123', 'nookala', 'bae10', 'lucasmac37', 'ekapin2', 'chan32', 'case7', 'melurie03', 'b3nny312', 'jlorozc2', 'kgiacobazzi', 'bhchen2', 'oknoel', 'gobias', 'sunjialin', 'fredhdx', 'lshi14', 'shawkat', 'johns149', 'muneebahmed95', 'boertew1', 'sherrypri', 'hronik1', 'snanav3', 'jkinne2', 'sfanou2', '1upgreenshroom', 'siwin2', 'sutchaya', 'vargas3', 'deasey1', 'kumikknd', 'neilchristanto', 'wang183', 'omghaxcode', 'ewalt1', 'banerje1', 'trovill1', 'lobert124', 'maddali1', 'chan1cyrus2', 'cernaus1', 'hartant2', 'jiwonp224', 'hoang4', 'profballack', 'gong10', 'alostu3', 'xiaoyr068', 'nanotie', 'spesard1', 'chellia1', 'malik15', 'qliu9', 'madigan5', 'alabi2', 'supermeatboy', 'ericwoo1', 'feng12', 'greenwa1', 'mikenike', 'jclift3', 'zhou60', 'heebidiwup', 'swarley', 'gavinwinkel', 'yjaquinas', 'lidazhu1', 'mazzola1', 'novawater', 'mattycat9000', 'wlee26', 'lu30', 'mstlyhrmlss', 'levitas1', None, 'wanchoi1', 'hatfarm', 'luiszelaya', 'spadin1', 'keating7', 'blee51', 'maxcan', 'leiche1', 'chrisgoulet', 'achavarria', 'samuelzhang', 'weberxzq', 'tatuhiro', 'rice14', 'pashea1', 'yuanweih', 'geschreyr', 'kwak27', 'shapir11', 'zeqiuwu1', 'mraval', 'emma', 'foxytop', 'brittovivek', 'jielv1', 'toblerone16', 'bony', 'donner1', 'moy21', 'jksikai', 'nam18', 'szhang51', 'handa1', 'jataput1', 'lupas2', 'kilpatr2', 'mikeudelhofen', 'amnueyp1', 'alex81388', 'mihrenoe', 'weber36', 'theerasit', 'tchajed', 'jtlust3', 'hardy6', 'aczerepak', 'stuber1', 'piyawon1', 'kim563', 'kandel3', 'gazdzia1', 'williamhn', 'monnett1', 'bector1', 'arvman', 'roloscool', 'yun19', 'ddanielw', 'lee117', 'jain53', 'wente1', 'diliber1', 'geethabijjam', 'fandi514', 'ludao822', 'griffi21', 'edavilax', 'btanabe2', 'hasken1', 'kadakiy1', 'hchao2', 'nmisak', 'mroczek1', 'hazypensieve', 'gloger', 'dahlke2', 'hgao10', '8kobe24', 'dferrell68', 'mckiern1', 'stephenyzc', 'genome852', 'dicksonsalim', 'morris57', 'devharlalka', 'ucapssong', 'jefflale', 'tischer1']"
2,88,164,7,1,['siwin2'],162,"['dhuang123', 'nookala', 'bae10', 'lucasmac37', 'ekapin2', 'chan32', 'case7', 'melurie03', 'b3nny312', 'jlorozc2', 'kgiacobazzi', 'bhchen2', 'oknoel', 'gobias', 'sunjialin', 'fredhdx', 'lshi14', 'shawkat', 'johns149', 'muneebahmed95', 'boertew1', 'sherrypri', 'hronik1', 'snanav3', 'jkinne2', 'sfanou2', '1upgreenshroom', 'sutchaya', 'vargas3', 'deasey1', 'kumikknd', 'neilchristanto', 'wang183', 'omghaxcode', 'ewalt1', 'banerje1', 'trovill1', 'lobert124', 'maddali1', 'chan1cyrus2', 'cernaus1', 'hartant2', 'jiwonp224', 'hoang4', 'profballack', 'gong10', 'alostu3', 'xiaoyr068', 'nanotie', 'spesard1', 'chellia1', 'malik15', 'qliu9', 'madigan5', 'alabi2', 'supermeatboy', 'ericwoo1', 'feng12', 'greenwa1', 'mikenike', 'jclift3', 'zhou60', 'heebidiwup', 'swarley', 'gavinwinkel', 'yjaquinas', 'lidazhu1', 'mazzola1', 'novawater', 'mattycat9000', 'wlee26', 'lu30', 'mstlyhrmlss', 'levitas1', 'wanchoi1', 'hatfarm', 'luiszelaya', 'spadin1', 'keating7', 'blee51', 'maxcan', 'leiche1', 'chrisgoulet', 'achavarria', 'samuelzhang', 'weberxzq', 'tatuhiro', 'rice14', 'pashea1', 'yuanweih', 'geschreyr', 'kwak27', 'shapir11', 'zeqiuwu1', 'mraval', 'emma', 'foxytop', 'brittovivek', 'jielv1', 'toblerone16', 'bony', 'donner1', 'moy21', 'jksikai', 'nam18', 'szhang51', 'handa1', 'jataput1', 'lupas2', 'kilpatr2', 'mikeudelhofen', 'amnueyp1', 'alex81388', 'mihrenoe', 'weber36', 'theerasit', 'tchajed', 'jtlust3', 'hardy6', 'aczerepak', 'stuber1', 'piyawon1', 'kim563', 'kandel3', 'gazdzia1', 'williamhn', 'monnett1', 'bector1', 'arvman', 'roloscool', 'yun19', 'ddanielw', 'lee117', 'jain53', 'wente1', 'diliber1', 'geethabijjam', 'fandi514', 'ludao822', 'griffi21', 'edavilax', 'btanabe2', 'hasken1', 'kadakiy1', 'hchao2', 'nmisak', 'mroczek1', 'hazypensieve', 'gloger', 'dahlke2', 'hgao10', '8kobe24', 'dferrell68', 'mckiern1', 'stephenyzc', 'genome852', 'dicksonsalim', 'morris57', 'devharlalka', 'ucapssong', 'jefflale', 'tischer1']",6,"['mahed', 'congshanwan', 'sungbea89', 'savankadakiya', 'panlei616', None]",169,"['dhuang123', 'nookala', 'bae10', 'lucasmac37', 'ekapin2', 'chan32', 'case7', 'melurie03', 'b3nny312', 'jlorozc2', 'kgiacobazzi', 'bhchen2', 'oknoel', 'gobias', 'sunjialin', 'sungbea89', 'fredhdx', 'lshi14', 'shawkat', 'johns149', 'muneebahmed95', 'boertew1', 'sherrypri', 'hronik1', 'snanav3', 'jkinne2', 'sfanou2', '1upgreenshroom', 'siwin2', 'sutchaya', 'vargas3', 'deasey1', 'kumikknd', 'neilchristanto', 'wang183', 'savankadakiya', 'omghaxcode', 'ewalt1', 'banerje1', 'trovill1', 'lobert124', 'maddali1', 'chan1cyrus2', 'cernaus1', 'hartant2', 'jiwonp224', 'hoang4', 'profballack', 'gong10', 'alostu3', 'xiaoyr068', 'nanotie', 'spesard1', 'chellia1', 'malik15', 'congshanwan', 'qliu9', 'madigan5', 'alabi2', 'supermeatboy', 'ericwoo1', 'feng12', 'greenwa1', 'mikenike', 'jclift3', 'zhou60', 'heebidiwup', 'swarley', 'gavinwinkel', 'yjaquinas', 'lidazhu1', 'mazzola1', 'novawater', 'mattycat9000', 'wlee26', 'lu30', 'mstlyhrmlss', 'levitas1', None, 'wanchoi1', 'hatfarm', 'luiszelaya', 'spadin1', 'keating7', 'blee51', 'maxcan', 'leiche1', 'chrisgoulet', 'achavarria', 'samuelzhang', 'mahed', 'weberxzq', 'tatuhiro', 'rice14', 'pashea1', 'yuanweih', 'geschreyr', 'kwak27', 'shapir11', 'zeqiuwu1', 'mraval', 'emma', 'foxytop', 'brittovivek', 'jielv1', 'toblerone16', 'bony', 'donner1', 'moy21', 'jksikai', 'nam18', 'szhang51', 'handa1', 'jataput1', 'lupas2', 'kilpatr2', 'mikeudelhofen', 'amnueyp1', 'alex81388', 'mihrenoe', 'weber36', 'theerasit', 'tchajed', 'jtlust3', 'hardy6', 'aczerepak', 'stuber1', 'piyawon1', 'kim563', 'kandel3', 'gazdzia1', 'williamhn', 'monnett1', 'bector1', 'arvman', 'roloscool', 'yun19', 'ddanielw', 'lee117', 'jain53', 'wente1', 'diliber1', 'geethabijjam', 'fandi514', 'ludao822', 'griffi21', 'edavilax', 'btanabe2', 'hasken1', 'kadakiy1', 'hchao2', 'nmisak', 'mroczek1', 'hazypensieve', 'gloger', 'dahlke2', 'hgao10', '8kobe24', 'dferrell68', 'mckiern1', 'stephenyzc', 'genome852', 'dicksonsalim', 'morris57', 'devharlalka', 'ucapssong', 'panlei616', 'jefflale', 'tischer1']"
2,94,164,7,6,"['lucasmac37', 'weberxzq', 'mckiern1', 'lu30', 'donner1', 'kandel3']",157,"['dhuang123', 'nookala', 'bae10', 'ekapin2', 'chan32', 'case7', 'melurie03', 'b3nny312', 'jlorozc2', 'kgiacobazzi', 'bhchen2', 'oknoel', 'gobias', 'sunjialin', 'fredhdx', 'lshi14', 'shawkat', 'johns149', 'muneebahmed95', 'boertew1', 'sherrypri', 'hronik1', 'snanav3', 'jkinne2', 'sfanou2', '1upgreenshroom', 'siwin2', 'sutchaya', 'vargas3', 'deasey1', 'kumikknd', 'neilchristanto', 'wang183', 'omghaxcode', 'ewalt1', 'banerje1', 'trovill1', 'lobert124', 'maddali1', 'chan1cyrus2', 'cernaus1', 'hartant2', 'jiwonp224', 'hoang4', 'profballack', 'gong10', 'alostu3', 'xiaoyr068', 'nanotie', 'spesard1', 'chellia1', 'malik15', 'qliu9', 'madigan5', 'alabi2', 'supermeatboy', 'ericwoo1', 'feng12', 'greenwa1', 'mikenike', 'jclift3', 'zhou60', 'heebidiwup', 'swarley', 'gavinwinkel', 'yjaquinas', 'lidazhu1', 'mazzola1', 'novawater', 'mattycat9000', 'wlee26', 'mstlyhrmlss', 'levitas1', 'wanchoi1', 'hatfarm', 'luiszelaya', 'spadin1', 'keating7', 'blee51', 'maxcan', 'leiche1', 'chrisgoulet', 'achavarria', 'samuelzhang', 'tatuhiro', 'rice14', 'pashea1', 'yuanweih', 'geschreyr', 'kwak27', 'shapir11', 'zeqiuwu1', 'mraval', 'emma', 'foxytop', 'brittovivek', 'jielv1', 'toblerone16', 'bony', 'moy21', 'jksikai', 'nam18', 'szhang51', 'handa1', 'jataput1', 'lupas2', 'kilpatr2', 'mikeudelhofen', 'amnueyp1', 'alex81388', 'mihrenoe', 'weber36', 'theerasit', 'tchajed', 'jtlust3', 'hardy6', 'aczerepak', 'stuber1', 'piyawon1', 'kim563', 'gazdzia1', 'williamhn', 'monnett1', 'bector1', 'arvman', 'roloscool', 'yun19', 'ddanielw', 'lee117', 'jain53', 'wente1', 'diliber1', 'geethabijjam', 'fandi514', 'ludao822', 'griffi21', 'edavilax', 'btanabe2', 'hasken1', 'kadakiy1', 'hchao2', 'nmisak', 'mroczek1', 'hazypensieve', 'gloger', 'dahlke2', 'hgao10', '8kobe24', 'dferrell68', 'stephenyzc', 'genome852', 'dicksonsalim', 'morris57', 'devharlalka', 'ucapssong', 'jefflale', 'tischer1']",1,[None],164,"['dhuang123', 'nookala', 'bae10', 'lucasmac37', 'ekapin2', 'chan32', 'case7', 'melurie03', 'b3nny312', 'jlorozc2', 'kgiacobazzi', 'bhchen2', 'oknoel', 'gobias', 'sunjialin', 'fredhdx', 'lshi14', 'shawkat', 'johns149', 'muneebahmed95', 'boertew1', 'sherrypri', 'hronik1', 'snanav3', 'jkinne2', 'sfanou2', '1upgreenshroom', 'siwin2', 'sutchaya', 'vargas3', 'deasey1', 'kumikknd', 'neilchristanto', 'wang183', 'omghaxcode', 'ewalt1', 'banerje1', 'trovill1', 'lobert124', 'maddali1', 'chan1cyrus2', 'cernaus1', 'hartant2', 'jiwonp224', 'hoang4', 'profballack', 'gong10', 'alostu3', 'xiaoyr068', 'nanotie', 'spesard1', 'chellia1', 'malik15', 'qliu9', 'madigan5', 'alabi2', 'supermeatboy', 'ericwoo1', 'feng12', 'greenwa1', 'mikenike', 'jclift3', 'zhou60', 'heebidiwup', 'swarley', 'gavinwinkel', 'yjaquinas', 'lidazhu1', 'mazzola1', 'novawater', 'mattycat9000', 'wlee26', 'lu30', 'mstlyhrmlss', 'levitas1', None, 'wanchoi1', 'hatfarm', 'luiszelaya', 'spadin1', 'keating7', 'blee51', 'maxcan', 'leiche1', 'chrisgoulet', 'achavarria', 'samuelzhang', 'weberxzq', 'tatuhiro', 'rice14', 'pashea1', 'yuanweih', 'geschreyr', 'kwak27', 'shapir11', 'zeqiuwu1', 'mraval', 'emma', 'foxytop', 'brittovivek', 'jielv1', 'toblerone16', 'bony', 'donner1', 'moy21', 'jksikai', 'nam18', 'szhang51', 'handa1', 'jataput1', 'lupas2', 'kilpatr2', 'mikeudelhofen', 'amnueyp1', 'alex81388', 'mihrenoe', 'weber36', 'theerasit', 'tchajed', 'jtlust3', 'hardy6', 'aczerepak', 'stuber1', 'piyawon1', 'kim563', 'kandel3', 'gazdzia1', 'williamhn', 'monnett1', 'bector1', 'arvman', 'roloscool', 'yun19', 'ddanielw', 'lee117', 'jain53', 'wente1', 'diliber1', 'geethabijjam', 'fandi514', 'ludao822', 'griffi21', 'edavilax', 'btanabe2', 'hasken1', 'kadakiy1', 'hchao2', 'nmisak', 'mroczek1', 'hazypensieve', 'gloger', 'dahlke2', 'hgao10', '8kobe24', 'dferrell68', 'mckiern1', 'stephenyzc', 'genome852', 'dicksonsalim', 'morris57', 'devharlalka', 'ucapssong', 'jefflale', 'tischer1']"
2,95,164,7,5,"['jiwonp224', 'theerasit', 'chan1cyrus2', 'ericwoo1', 'maddali1']",158,"['dhuang123', 'nookala', 'bae10', 'lucasmac37', 'ekapin2', 'chan32', 'case7', 'melurie03', 'b3nny312', 'jlorozc2', 'kgiacobazzi', 'bhchen2', 'oknoel', 'gobias', 'sunjialin', 'fredhdx', 'lshi14', 'shawkat', 'johns149', 'muneebahmed95', 'boertew1', 'sherrypri', 'hronik1', 'snanav3', 'jkinne2', 'sfanou2', '1upgreenshroom', 'siwin2', 'sutchaya', 'vargas3', 'deasey1', 'kumikknd', 'neilchristanto', 'wang183', 'omghaxcode', 'ewalt1', 'banerje1', 'trovill1', 'lobert124', 'cernaus1', 'hartant2', 'hoang4', 'profballack', 'gong10', 'alostu3', 'xiaoyr068', 'nanotie', 'spesard1', 'chellia1', 'malik15', 'qliu9', 'madigan5', 'alabi2', 'supermeatboy', 'feng12', 'greenwa1', 'mikenike', 'jclift3', 'zhou60', 'heebidiwup', 'swarley', 'gavinwinkel', 'yjaquinas', 'lidazhu1', 'mazzola1', 'novawater', 'mattycat9000', 'wlee26', 'lu30', 'mstlyhrmlss', 'levitas1', 'wanchoi1', 'hatfarm', 'luiszelaya', 'spadin1', 'keating7', 'blee51', 'maxcan', 'leiche1', 'chrisgoulet', 'achavarria', 'samuelzhang', 'weberxzq', 'tatuhiro', 'rice14', 'pashea1', 'yuanweih', 'geschreyr', 'kwak27', 'shapir11', 'zeqiuwu1', 'mraval', 'emma', 'foxytop', 'brittovivek', 'jielv1', 'toblerone16', 'bony', 'donner1', 'moy21', 'jksikai', 'nam18', 'szhang51', 'handa1', 'jataput1', 'lupas2', 'kilpatr2', 'mikeudelhofen', 'amnueyp1', 'alex81388', 'mihrenoe', 'weber36', 'tchajed', 'jtlust3', 'hardy6', 'aczerepak', 'stuber1', 'piyawon1', 'kim563', 'kandel3', 'gazdzia1', 'williamhn', 'monnett1', 'bector1', 'arvman', 'roloscool', 'yun19', 'ddanielw', 'lee117', 'jain53', 'wente1', 'diliber1', 'geethabijjam', 'fandi514', 'ludao822', 'griffi21', 'edavilax', 'btanabe2', 'hasken1', 'kadakiy1', 'hchao2', 'nmisak', 'mroczek1', 'hazypensieve', 'gloger', 'dahlke2', 'hgao10', '8kobe24', 'dferrell68', 'mckiern1', 'stephenyzc', 'genome852', 'dicksonsalim', 'morris57', 'devharlalka', 'ucapssong', 'jefflale', 'tischer1']",2,"[None, 'lmendez2']",165,"['dhuang123', 'nookala', 'bae10', 'lucasmac37', 'ekapin2', 'chan32', 'case7', 'melurie03', 'b3nny312', 'jlorozc2', 'kgiacobazzi', 'bhchen2', 'oknoel', 'gobias', 'sunjialin', 'fredhdx', 'lshi14', 'shawkat', 'johns149', 'muneebahmed95', 'boertew1', 'sherrypri', 'hronik1', 'snanav3', 'jkinne2', 'sfanou2', '1upgreenshroom', 'siwin2', 'sutchaya', 'vargas3', 'deasey1', 'kumikknd', 'neilchristanto', 'wang183', 'omghaxcode', 'ewalt1', 'banerje1', 'trovill1', 'lobert124', 'maddali1', 'chan1cyrus2', 'cernaus1', 'hartant2', 'jiwonp224', 'hoang4', 'profballack', 'gong10', 'alostu3', 'xiaoyr068', 'nanotie', 'spesard1', 'chellia1', 'malik15', 'qliu9', 'madigan5', 'alabi2', 'supermeatboy', 'ericwoo1', 'feng12', 'greenwa1', 'mikenike', 'jclift3', 'zhou60', 'heebidiwup', 'swarley', 'gavinwinkel', 'yjaquinas', 'lidazhu1', 'mazzola1', 'novawater', 'mattycat9000', 'wlee26', 'lu30', 'mstlyhrmlss', 'levitas1', None, 'wanchoi1', 'hatfarm', 'luiszelaya', 'spadin1', 'keating7', 'blee51', 'maxcan', 'leiche1', 'chrisgoulet', 'achavarria', 'samuelzhang', 'weberxzq', 'tatuhiro', 'rice14', 'pashea1', 'yuanweih', 'geschreyr', 'kwak27', 'shapir11', 'zeqiuwu1', 'mraval', 'emma', 'foxytop', 'brittovivek', 'jielv1', 'toblerone16', 'bony', 'donner1', 'moy21', 'jksikai', 'nam18', 'szhang51', 'handa1', 'jataput1', 'lupas2', 'kilpatr2', 'mikeudelhofen', 'amnueyp1', 'alex81388', 'mihrenoe', 'weber36', 'theerasit', 'tchajed', 'jtlust3', 'hardy6', 'aczerepak', 'stuber1', 'piyawon1', 'kim563', 'kandel3', 'gazdzia1', 'williamhn', 'monnett1', 'bector1', 'arvman', 'roloscool', 'yun19', 'ddanielw', 'lee117', 'jain53', 'wente1', 'diliber1', 'geethabijjam', 'lmendez2', 'fandi514', 'ludao822', 'griffi21', 'edavilax', 'btanabe2', 'hasken1', 'kadakiy1', 'hchao2', 'nmisak', 'mroczek1', 'hazypensieve', 'gloger', 'dahlke2', 'hgao10', '8kobe24', 'dferrell68', 'mckiern1', 'stephenyzc', 'genome852', 'dicksonsalim', 'morris57', 'devharlalka', 'ucapssong', 'jefflale', 'tischer1']"
4,192,94,54,52,"['rbatara', 'ljl1991', 'sfi3r', 'eriksywu', 'hadikholeif', 'mlanki', 'ivangum', 'auri0ayu', 'jwig', 'cvl91', 'appleofjoy', 'walinga', 'fox2667', 'kaitagsd', 'liao111', 'marpaj', 'jassu', 'allstar0000', 'daryaa', 'jerry43000', 'nick1717', 'ckylai', 'llao', 'trevorjk', 'aliafi90', 'alidav', 'gsaran15', 'fhschan', 'stoyanov', 'spiraunited', 'bayanb', 'akrait', 'glade', 'dr.henry', 'bbycraft', 'wth1455', 'y1m7', 'nater', 'marpaj_2', 'kevinpe90', 'jhermoso', 'jkhuu19', 'mireghou', 'shahin', 'waterhead', 'rohams', 'shoss050', 'phalonx', 'jaspyu1988', 'gungun1010', 'albert7c', 'rudy']",41,"['alistairhp', 'shery', 'perrija', 'emre_ergecen', 'hughe119', 'xiaoyaojian', 'uzair', 'nettigerman', 'jramos8', 'rytlewsw', 'alext9', 'shinhyuk001', 'wb', 'wahaj', 'mjamidon224', 'm_yehia', 'm_elneanaei', 'mkudenov', 'antdong', 'leopoldv', 'asdfasdfasdf', 'rogesamu', 'cenkenj', 'wengxiao', 'bellku', 'knovack87', 'collbria', 'lightfoj', 'ortegavj', 'jairoandres', 'javeria', 'shariq', 'pierre38', 'explokid', 'lusifer_age', 'matrix1536', 'tlee', 'roycrafe', 'sjyu', 'nanotechgeek', 'zit0s']",2,"[None, 'gpenford']",95,"['perrija', 'hughe119', 'uzair', 'sfi3r', 'mlanki', 'ivangum', 'alext9', 'auri0ayu', 'walinga', 'fox2667', 'kaitagsd', 'liao111', 'allstar0000', 'daryaa', 'jerry43000', 'nick1717', 'leopoldv', 'llao', 'trevorjk', 'bellku', 'knovack87', 'fhschan', 'stoyanov', 'spiraunited', 'bayanb', 'akrait', 'wth1455', 'bbycraft', 'y1m7', 'nater', 'marpaj_2', 'kevinpe90', 'shariq', 'jkhuu19', 'pierre38', 'mireghou', 'tlee', 'waterhead', 'roycrafe', 'shoss050', 'phalonx', 'nanotechgeek', 'rudy', 'alistairhp', 'shery', 'emre_ergecen', 'rbatara', 'ljl1991', 'xiaoyaojian', 'nettigerman', 'jramos8', 'eriksywu', 'rytlewsw', 'hadikholeif', 'shinhyuk001', 'wb', 'wahaj', 'mjamidon224', 'jwig', 'appleofjoy', 'cvl91', 'm_yehia', 'm_elneanaei', 'mkudenov', 'jassu', 'marpaj', 'antdong', 'ckylai', 'asdfasdfasdf', 'rogesamu', 'aliafi90', 'cenkenj', 'alidav', 'wengxiao', 'gsaran15', 'collbria', 'lightfoj', 'ortegavj', 'jairoandres', 'glade', 'dr.henry', None, 'javeria', 'jhermoso', 'explokid', 'gpenford', 'shahin', 'lusifer_age', 'matrix1536', 'rohams', 'jaspyu1988', 'gungun1010', 'sjyu', 'albert7c', 'zit0s']"
4,191,94,52,4,"['wahaj', 'shariq', 'uzair', 'javeria']",89,"['perrija', 'ivangum', 'alext9', 'auri0ayu', 'walinga', 'fox2667', 'liao111', 'daryaa', 'jerry43000', 'nick1717', 'trevorjk', 'bellku', 'akrait', 'wth1455', 'bbycraft', 'nater', 'marpaj_2', 'tlee', 'roycrafe', 'nanotechgeek', 'rudy', 'alistairhp', 'shery', 'emre_ergecen', 'xiaoyaojian', 'nettigerman', 'jramos8', 'eriksywu', 'hadikholeif', 'shinhyuk001', 'wb', 'jwig', 'mkudenov', 'jassu', 'ckylai', 'rogesamu', 'cenkenj', 'glade', 'dr.henry', 'shahin', 'matrix1536', 'rohams', 'gungun1010', 'albert7c', 'zit0s', 'hughe119', 'sfi3r', 'mlanki', 'kaitagsd', 'allstar0000', 'leopoldv', 'llao', 'knovack87', 'fhschan', 'stoyanov', 'spiraunited', 'bayanb', 'y1m7', 'kevinpe90', 'jkhuu19', 'pierre38', 'mireghou', 'waterhead', 'shoss050', 'phalonx', 'rbatara', 'ljl1991', 'rytlewsw', 'mjamidon224', 'appleofjoy', 'cvl91', 'm_yehia', 'm_elneanaei', 'marpaj', 'antdong', 'asdfasdfasdf', 'aliafi90', 'alidav', 'wengxiao', 'gsaran15', 'collbria', 'lightfoj', 'ortegavj', 'jairoandres', 'jhermoso', 'explokid', 'lusifer_age', 'jaspyu1988', 'sjyu']",48,"['spaxorid', 'i_sameen', 'sajjad', 'adeelamin', 'el003', 'sheeraz', 'hiraimtiaz', 'basit', 'farooq141', 'hunaiz', 'tzs', 'ffm78692', 'reema_rizwan01', 'arsalan79', 'ul08034', 'nabeelkhan634', 'danish_muneer', 'salma', 'saad_007', 'swaleha115', 'ayesha5910', 'adiljaliawala', 'anum72', 'arsal124', 'komal', 'alihaider', 'yousufmujahid', 'rahul1990', 'umar314', 'muhammad_ashfaq', 'mehwish', 'umerzia', 'marium98', 'misha_fawad', 'safiahrehman', 'faizi', None, 'adilabbas', 'nauman007', 'tehreem', 'phool', 'yaser664', 'abbi', 'wajiyazafar', 'naveednano', 'fawadned0809', 'abdul_moiz', 'ul08044']",141,"['adeelamin', 'i_sameen', 'perrija', 'hughe119', 'uzair', 'sfi3r', 'el003', 'hiraimtiaz', 'spaxorid', 'basit', 'farooq141', 'hunaiz', 'mlanki', 'ivangum', 'alext9', 'tzs', 'arsalan79', 'auri0ayu', 'walinga', 'fox2667', 'nabeelkhan634', 'kaitagsd', 'liao111', 'danish_muneer', 'allstar0000', 'daryaa', 'anum72', 'jerry43000', 'nick1717', 'leopoldv', 'llao', 'trevorjk', 'komal', 'rahul1990', 'bellku', 'knovack87', 'fhschan', 'umar314', 'stoyanov', 'muhammad_ashfaq', 'spiraunited', 'marium98', 'bayanb', 'akrait', 'safiahrehman', 'faizi', 'wth1455', 'bbycraft', 'y1m7', 'nater', 'adilabbas', 'marpaj_2', 'kevinpe90', 'nauman007', 'shariq', 'jkhuu19', 'yaser664', 'pierre38', 'mireghou', 'naveednano', 'tlee', 'waterhead', 'roycrafe', 'shoss050', 'phalonx', 'abdul_moiz', 'ul08044', 'nanotechgeek', 'rudy', 'alistairhp', 'shery', 'emre_ergecen', 'rbatara', 'ljl1991', 'xiaoyaojian', 'nettigerman', 'jramos8', 'eriksywu', 'rytlewsw', 'sajjad', 'sheeraz', 'hadikholeif', 'shinhyuk001', 'reema_rizwan01', 'wb', 'wahaj', 'mjamidon224', 'jwig', 'appleofjoy', 'cvl91', 'm_yehia', 'ul08034', 'm_elneanaei', 'salma', 'saad_007', 'swaleha115', 'ayesha5910', 'mkudenov', 'jassu', 'marpaj', 'antdong', 'adiljaliawala', 'arsal124', 'ckylai', 'asdfasdfasdf', 'rogesamu', 'aliafi90', 'cenkenj', 'alihaider', 'alidav', 'yousufmujahid', 'wengxiao', 'gsaran15', 'collbria', 'lightfoj', 'mehwish', 'umerzia', 'ortegavj', 'jairoandres', 'misha_fawad', 'glade', 'dr.henry', None, 'javeria', 'tehreem', 'jhermoso', 'phool', 'abbi', 'explokid', 'shahin', 'lusifer_age', 'wajiyazafar', 'matrix1536', 'fawadned0809', 'rohams', 'jaspyu1988', 'gungun1010', 'sjyu', 'ffm78692', 'albert7c', 'zit0s']"
4,193,94,19,1,['shinhyuk001'],92,"['perrija', 'hughe119', 'uzair', 'sfi3r', 'mlanki', 'ivangum', 'alext9', 'auri0ayu', 'walinga', 'fox2667', 'kaitagsd', 'liao111', 'allstar0000', 'daryaa', 'jerry43000', 'nick1717', 'leopoldv', 'llao', 'trevorjk', 'bellku', 'knovack87', 'fhschan', 'stoyanov', 'spiraunited', 'bayanb', 'akrait', 'wth1455', 'bbycraft', 'y1m7', 'nater', 'marpaj_2', 'kevinpe90', 'shariq', 'jkhuu19', 'pierre38', 'mireghou', 'tlee', 'waterhead', 'roycrafe', 'shoss050', 'phalonx', 'nanotechgeek', 'rudy', 'alistairhp', 'shery', 'emre_ergecen', 'rbatara', 'ljl1991', 'xiaoyaojian', 'nettigerman', 'jramos8', 'eriksywu', 'rytlewsw', 'hadikholeif', 'wb', 'wahaj', 'mjamidon224', 'jwig', 'appleofjoy', 'cvl91', 'm_yehia', 'm_elneanaei', 'mkudenov', 'jassu', 'marpaj', 'antdong', 'ckylai', 'asdfasdfasdf', 'rogesamu', 'aliafi90', 'cenkenj', 'alidav', 'wengxiao', 'gsaran15', 'collbria', 'lightfoj', 'ortegavj', 'jairoandres', 'glade', 'dr.henry', 'javeria', 'jhermoso', 'explokid', 'shahin', 'lusifer_age', 'matrix1536', 'rohams', 'jaspyu1988', 'gungun1010', 'sjyu', 'albert7c', 'zit0s']",18,"[None, 'dltjrqja04', 'a615045', 'yosemo1', 'joddolms', 'zenorc', 'gamma0burst', 'kalrin', 'monytu', 'scapall', 'clowlide', 'lottoz', 'jyjeong', 'suhosin87', 'lionanna', 'vrozooa', 'skadbsthf77', 'primeevir']",111,"['perrija', 'hughe119', 'uzair', 'sfi3r', 'joddolms', 'yosemo1', 'zenorc', 'mlanki', 'ivangum', 'alext9', 'auri0ayu', 'walinga', 'skadbsthf77', 'fox2667', 'kaitagsd', 'liao111', 'gamma0burst', 'lottoz', 'allstar0000', 'daryaa', 'jerry43000', 'nick1717', 'leopoldv', 'llao', 'trevorjk', 'bellku', 'knovack87', 'kalrin', 'fhschan', 'monytu', 'stoyanov', 'spiraunited', 'clowlide', 'bayanb', 'akrait', 'wth1455', 'bbycraft', 'y1m7', 'nater', 'marpaj_2', 'kevinpe90', 'shariq', 'jkhuu19', 'dltjrqja04', 'pierre38', 'mireghou', 'tlee', 'waterhead', 'roycrafe', 'shoss050', 'phalonx', 'nanotechgeek', 'rudy', 'jyjeong', 'alistairhp', 'shery', 'emre_ergecen', 'rbatara', 'ljl1991', 'xiaoyaojian', 'nettigerman', 'jramos8', 'eriksywu', 'rytlewsw', 'hadikholeif', 'shinhyuk001', 'wb', 'wahaj', 'mjamidon224', 'jwig', 'appleofjoy', 'cvl91', 'm_yehia', 'vrozooa', 'm_elneanaei', 'mkudenov', 'jassu', 'marpaj', 'antdong', 'lionanna', 'ckylai', 'asdfasdfasdf', 'rogesamu', 'aliafi90', 'cenkenj', 'alidav', 'a615045', 'wengxiao', 'gsaran15', 'collbria', 'lightfoj', 'scapall', 'ortegavj', 'jairoandres', 'glade', 'dr.henry', None, 'javeria', 'primeevir', 'jhermoso', 'explokid', 'shahin', 'lusifer_age', 'matrix1536', 'rohams', 'jaspyu1988', 'gungun1010', 'sjyu', 'suhosin87', 'albert7c', 'zit0s']"
4,195,94,14,12,"['rogesamu', 'hughe119', 'perrija', 'rytlewsw', 'knovack87', 'bellku', 'tlee', 'lightfoj', 'roycrafe', 'ortegavj', 'wb', 'mjamidon224']",81,"['uzair', 'sfi3r', 'mlanki', 'ivangum', 'alext9', 'auri0ayu', 'walinga', 'fox2667', 'kaitagsd', 'liao111', 'allstar0000', 'daryaa', 'jerry43000', 'nick1717', 'leopoldv', 'llao', 'trevorjk', 'fhschan', 'stoyanov', 'spiraunited', 'bayanb', 'akrait', 'wth1455', 'bbycraft', 'y1m7', 'nater', 'marpaj_2', 'kevinpe90', 'shariq', 'jkhuu19', 'pierre38', 'mireghou', 'waterhead', 'shoss050', 'phalonx', 'nanotechgeek', 'rudy', 'alistairhp', 'shery', 'emre_ergecen', 'rbatara', 'ljl1991', 'xiaoyaojian', 'nettigerman', 'jramos8', 'eriksywu', 'hadikholeif', 'shinhyuk001', 'wahaj', 'jwig', 'appleofjoy', 'cvl91', 'm_yehia', 'm_elneanaei', 'mkudenov', 'jassu', 'marpaj', 'antdong', 'ckylai', 'asdfasdfasdf', 'aliafi90', 'cenkenj', 'alidav', 'wengxiao', 'gsaran15', 'collbria', 'jairoandres', 'glade', 'dr.henry', 'javeria', 'jhermoso', 'explokid', 'shahin', 'lusifer_age', 'matrix1536', 'rohams', 'jaspyu1988', 'gungun1010', 'sjyu', 'albert7c', 'zit0s']",2,"['smithmat', None]",95,"['perrija', 'hughe119', 'uzair', 'sfi3r', 'mlanki', 'ivangum', 'alext9', 'auri0ayu', 'walinga', 'fox2667', 'kaitagsd', 'liao111', 'allstar0000', 'daryaa', 'jerry43000', 'nick1717', 'leopoldv', 'llao', 'trevorjk', 'bellku', 'knovack87', 'fhschan', 'stoyanov', 'spiraunited', 'bayanb', 'akrait', 'wth1455', 'bbycraft', 'y1m7', 'nater', 'marpaj_2', 'kevinpe90', 'shariq', 'jkhuu19', 'pierre38', 'mireghou', 'tlee', 'waterhead', 'roycrafe', 'shoss050', 'phalonx', 'smithmat', 'nanotechgeek', 'rudy', 'alistairhp', 'shery', 'emre_ergecen', 'rbatara', 'ljl1991', 'xiaoyaojian', 'nettigerman', 'jramos8', 'eriksywu', 'rytlewsw', 'hadikholeif', 'shinhyuk001', 'wb', 'wahaj', 'mjamidon224', 'jwig', 'appleofjoy', 'cvl91', 'm_yehia', 'm_elneanaei', 'mkudenov', 'jassu', 'marpaj', 'antdong', 'ckylai', 'asdfasdfasdf', 'rogesamu', 'aliafi90', 'cenkenj', 'alidav', 'wengxiao', 'gsaran15', 'collbria', 'lightfoj', 'ortegavj', 'jairoandres', 'glade', 'dr.henry', None, 'javeria', 'jhermoso', 'explokid', 'shahin', 'lusifer_age', 'matrix1536', 'rohams', 'jaspyu1988', 'gungun1010', 'sjyu', 'albert7c', 'zit0s']"
4,194,94,8,1,['jairoandres'],92,"['perrija', 'hughe119', 'uzair', 'sfi3r', 'mlanki', 'ivangum', 'alext9', 'auri0ayu', 'walinga', 'fox2667', 'kaitagsd', 'liao111', 'allstar0000', 'daryaa', 'jerry43000', 'nick1717', 'leopoldv', 'llao', 'trevorjk', 'bellku', 'knovack87', 'fhschan', 'stoyanov', 'spiraunited', 'bayanb', 'akrait', 'wth1455', 'bbycraft', 'y1m7', 'nater', 'marpaj_2', 'kevinpe90', 'shariq', 'jkhuu19', 'pierre38', 'mireghou', 'tlee', 'waterhead', 'roycrafe', 'shoss050', 'phalonx', 'nanotechgeek', 'rudy', 'alistairhp', 'shery', 'emre_ergecen', 'rbatara', 'ljl1991', 'xiaoyaojian', 'nettigerman', 'jramos8', 'eriksywu', 'rytlewsw', 'hadikholeif', 'shinhyuk001', 'wb', 'wahaj', 'mjamidon224', 'jwig', 'appleofjoy', 'cvl91', 'm_yehia', 'm_elneanaei', 'mkudenov', 'jassu', 'marpaj', 'antdong', 'ckylai', 'asdfasdfasdf', 'rogesamu', 'aliafi90', 'cenkenj', 'alidav', 'wengxiao', 'gsaran15', 'collbria', 'lightfoj', 'ortegavj', 'glade', 'dr.henry', 'javeria', 'jhermoso', 'explokid', 'shahin', 'lusifer_age', 'matrix1536', 'rohams', 'jaspyu1988', 'gungun1010', 'sjyu', 'albert7c', 'zit0s']",7,"['vep87', 'df.castellanos1413', 'billyrevelo', 'dk.kuratomi1423', 'comediante', None, 'davidar9182']",100,"['perrija', 'hughe119', 'uzair', 'sfi3r', 'mlanki', 'ivangum', 'alext9', 'auri0ayu', 'walinga', 'fox2667', 'kaitagsd', 'liao111', 'allstar0000', 'daryaa', 'jerry43000', 'nick1717', 'leopoldv', 'llao', 'trevorjk', 'bellku', 'knovack87', 'fhschan', 'stoyanov', 'df.castellanos1413', 'spiraunited', 'bayanb', 'akrait', 'wth1455', 'bbycraft', 'y1m7', 'nater', 'marpaj_2', 'kevinpe90', 'shariq', 'jkhuu19', 'pierre38', 'mireghou', 'tlee', 'waterhead', 'roycrafe', 'shoss050', 'phalonx', 'nanotechgeek', 'rudy', 'alistairhp', 'shery', 'emre_ergecen', 'rbatara', 'ljl1991', 'xiaoyaojian', 'nettigerman', 'jramos8', 'eriksywu', 'rytlewsw', 'vep87', 'hadikholeif', 'shinhyuk001', 'wb', 'wahaj', 'mjamidon224', 'jwig', 'comediante', 'appleofjoy', 'cvl91', 'm_yehia', 'm_elneanaei', 'billyrevelo', 'mkudenov', 'jassu', 'marpaj', 'antdong', 'ckylai', 'asdfasdfasdf', 'rogesamu', 'aliafi90', 'cenkenj', 'alidav', 'wengxiao', 'gsaran15', 'collbria', 'lightfoj', 'ortegavj', 'jairoandres', 'glade', 'dr.henry', None, 'javeria', 'jhermoso', 'explokid', 'shahin', 'lusifer_age', 'matrix1536', 'rohams', 'jaspyu1988', 'gungun1010', 'sjyu', 'dk.kuratomi1423', 'albert7c', 'zit0s', 'davidar9182']"
5,22,88,31,23,"['joelchevrier', 'valerya03', 'ozografos', 'vale.rust', 'giovanni89', 'luciana_cendon', 'gabenl0', 'maneerox', 'sofiane.sirajeddine', 'jorgelagos', 'umbi69', 'shadow222', 'giuseppecantarella', 'ladama', 'vituccig', 'cutaiad', 'episthmonas03', 'mnow', 'arep', 'felixgerenton', 'marettea', 'mecaflu', 'seblanc']",64,"['mjikim84', 'tduersto', 'yanad', 'bcelmer', 'yanghaiyan', 'vjaganna', 'alouis', 'jmeadows', 'atwell61', 'weifanan', 'richrat', 'ncr5014', 'micromanager', 'gwabi', 'horatz', 'youngms', 'jmcphee', 'jspasoff', 'lopezf987', 'cmcleod', 'necoraptor', 'karodger', 'kida', 'mariajo.cadena', 'seamon', 'nicholas.g.franconi', 'lubarsky', 'zhoutao', 'braeder', 'nanomuttoncl', 'djrobles', 'givemethreesteps', 'edam', 'rharnish', 'nstrozie', 'jmb156', 'hthomps', 'acleverphrase', 'pmankow', 'dschaetzl', 'avirani627', 'seanman247', 'nissenhan', 'gyli9753', 'cole30', 'jmelcher', 'pablovegav', 'jledward', 'nurulhuda', 'shijiewu', 'bohuifeng', 'watergrave', 'kilpatrj', 'smith422', 'acthomps', 'ess26', 'nanobalaji', 'haiyanyecao', 'jlocket', 'rngzc', 'ranayhbd', 'taq3', 'fejkaman869', 'timbrosnan']",8,"['youpi502', 'agent00ced', 'ashwyn280689', 'nadia', 'dimitrydf13', 'nanoman21', None, 'mebj30']",95,"['tduersto', 'joelchevrier', 'valerya03', 'alouis', 'giovanni89', 'richrat', 'luciana_cendon', 'gabenl0', 'lopezf987', 'karodger', 'umbi69', 'mariajo.cadena', 'nicholas.g.franconi', 'lubarsky', 'shadow222', 'zhoutao', 'braeder', 'djrobles', 'givemethreesteps', 'edam', 'jmb156', 'nadia', 'hthomps', 'acleverphrase', 'vituccig', 'dschaetzl', 'avirani627', 'nissenhan', 'gyli9753', 'pablovegav', 'mnow', 'nurulhuda', 'watergrave', 'kilpatrj', 'ess26', 'jlocket', 'rngzc', 'ranayhbd', 'mecaflu', 'taq3', 'fejkaman869', 'mjikim84', 'ozografos', 'yanad', 'agent00ced', 'bcelmer', 'vale.rust', 'vjaganna', 'yanghaiyan', 'jmeadows', 'atwell61', 'weifanan', 'ncr5014', 'micromanager', 'gwabi', 'horatz', 'youngms', 'jmcphee', 'maneerox', 'jspasoff', 'cmcleod', 'ashwyn280689', 'sofiane.sirajeddine', 'necoraptor', 'jorgelagos', 'kida', 'seamon', 'nanomuttoncl', 'youpi502', 'giuseppecantarella', 'ladama', 'rharnish', 'nstrozie', 'pmankow', 'seanman247', 'cutaiad', 'cole30', 'jmelcher', 'episthmonas03', 'dimitrydf13', None, 'nanoman21', 'jledward', 'arep', 'shijiewu', 'felixgerenton', 'bohuifeng', 'smith422', 'acthomps', 'nanobalaji', 'marettea', 'haiyanyecao', 'seblanc', 'timbrosnan', 'mebj30']"
5,24,88,12,8,"['jspasoff', 'jledward', 'hthomps', 'acleverphrase', 'acthomps', 'jmeadows', 'jlocket', 'jmcphee']",79,"['tduersto', 'joelchevrier', 'valerya03', 'alouis', 'giovanni89', 'richrat', 'luciana_cendon', 'gabenl0', 'lopezf987', 'karodger', 'umbi69', 'mariajo.cadena', 'nicholas.g.franconi', 'lubarsky', 'shadow222', 'zhoutao', 'braeder', 'djrobles', 'givemethreesteps', 'edam', 'jmb156', 'vituccig', 'dschaetzl', 'avirani627', 'nissenhan', 'gyli9753', 'pablovegav', 'mnow', 'nurulhuda', 'watergrave', 'kilpatrj', 'ess26', 'rngzc', 'ranayhbd', 'mecaflu', 'taq3', 'fejkaman869', 'mjikim84', 'ozografos', 'yanad', 'bcelmer', 'vale.rust', 'vjaganna', 'yanghaiyan', 'atwell61', 'weifanan', 'ncr5014', 'micromanager', 'gwabi', 'horatz', 'youngms', 'maneerox', 'cmcleod', 'sofiane.sirajeddine', 'necoraptor', 'jorgelagos', 'kida', 'seamon', 'nanomuttoncl', 'giuseppecantarella', 'ladama', 'rharnish', 'nstrozie', 'pmankow', 'seanman247', 'cutaiad', 'cole30', 'jmelcher', 'episthmonas03', 'arep', 'shijiewu', 'felixgerenton', 'bohuifeng', 'smith422', 'nanobalaji', 'marettea', 'haiyanyecao', 'seblanc', 'timbrosnan']",4,"['balasus', None, 'reifenberger', 'glhardin']",91,"['tduersto', 'joelchevrier', 'valerya03', 'alouis', 'giovanni89', 'richrat', 'luciana_cendon', 'gabenl0', 'lopezf987', 'karodger', 'umbi69', 'mariajo.cadena', 'nicholas.g.franconi', 'lubarsky', 'shadow222', 'zhoutao', 'braeder', 'djrobles', 'givemethreesteps', 'edam', 'jmb156', 'hthomps', 'acleverphrase', 'vituccig', 'dschaetzl', 'avirani627', 'nissenhan', 'gyli9753', 'pablovegav', 'mnow', 'nurulhuda', 'glhardin', 'balasus', 'watergrave', 'kilpatrj', 'ess26', 'jlocket', 'rngzc', 'ranayhbd', 'mecaflu', 'taq3', 'fejkaman869', 'mjikim84', 'ozografos', 'yanad', 'bcelmer', 'vale.rust', 'vjaganna', 'yanghaiyan', 'jmeadows', 'atwell61', 'weifanan', 'ncr5014', 'micromanager', 'gwabi', 'horatz', 'youngms', 'jmcphee', 'maneerox', 'jspasoff', 'cmcleod', 'sofiane.sirajeddine', 'necoraptor', 'jorgelagos', 'kida', 'seamon', 'nanomuttoncl', 'giuseppecantarella', 'ladama', 'rharnish', 'nstrozie', 'pmankow', 'reifenberger', 'seanman247', 'cutaiad', 'cole30', 'jmelcher', 'episthmonas03', None, 'jledward', 'arep', 'shijiewu', 'felixgerenton', 'bohuifeng', 'smith422', 'acthomps', 'nanobalaji', 'marettea', 'haiyanyecao', 'seblanc', 'timbrosnan']"
5,26,88,12,6,"['givemethreesteps', 'karodger', 'jmeadows', 'acthomps', 'alouis', 'jlocket']",81,"['tduersto', 'joelchevrier', 'valerya03', 'giovanni89', 'richrat', 'luciana_cendon', 'gabenl0', 'lopezf987', 'umbi69', 'mariajo.cadena', 'nicholas.g.franconi', 'lubarsky', 'shadow222', 'zhoutao', 'braeder', 'djrobles', 'edam', 'jmb156', 'hthomps', 'acleverphrase', 'vituccig', 'dschaetzl', 'avirani627', 'nissenhan', 'gyli9753', 'pablovegav', 'mnow', 'nurulhuda', 'watergrave', 'kilpatrj', 'ess26', 'rngzc', 'ranayhbd', 'mecaflu', 'taq3', 'fejkaman869', 'mjikim84', 'ozografos', 'yanad', 'bcelmer', 'vale.rust', 'vjaganna', 'yanghaiyan', 'atwell61', 'weifanan', 'ncr5014', 'micromanager', 'gwabi', 'horatz', 'youngms', 'jmcphee', 'maneerox', 'jspasoff', 'cmcleod', 'sofiane.sirajeddine', 'necoraptor', 'jorgelagos', 'kida', 'seamon', 'nanomuttoncl', 'giuseppecantarella', 'ladama', 'rharnish', 'nstrozie', 'pmankow', 'seanman247', 'cutaiad', 'cole30', 'jmelcher', 'episthmonas03', 'jledward', 'arep', 'shijiewu', 'felixgerenton', 'bohuifeng', 'smith422', 'nanobalaji', 'marettea', 'haiyanyecao', 'seblanc', 'timbrosnan']",6,"['kapoor6', 'ljdillard', 'reifenberger', 'alexandercartagena', 'raman', None]",93,"['tduersto', 'joelchevrier', 'valerya03', 'alouis', 'giovanni89', 'richrat', 'luciana_cendon', 'gabenl0', 'lopezf987', 'karodger', 'umbi69', 'mariajo.cadena', 'raman', 'nicholas.g.franconi', 'lubarsky', 'shadow222', 'zhoutao', 'braeder', 'djrobles', 'givemethreesteps', 'edam', 'jmb156', 'hthomps', 'acleverphrase', 'vituccig', 'dschaetzl', 'avirani627', 'nissenhan', 'gyli9753', 'pablovegav', 'mnow', 'nurulhuda', 'watergrave', 'kilpatrj', 'ess26', 'jlocket', 'rngzc', 'ranayhbd', 'mecaflu', 'taq3', 'fejkaman869', 'mjikim84', 'ozografos', 'yanad', 'bcelmer', 'ljdillard', 'vale.rust', 'vjaganna', 'yanghaiyan', 'jmeadows', 'atwell61', 'weifanan', 'ncr5014', 'micromanager', 'gwabi', 'horatz', 'youngms', 'jmcphee', 'maneerox', 'jspasoff', 'cmcleod', 'kapoor6', 'sofiane.sirajeddine', 'necoraptor', 'jorgelagos', 'kida', 'alexandercartagena', 'seamon', 'nanomuttoncl', 'giuseppecantarella', 'ladama', 'rharnish', 'nstrozie', 'pmankow', 'reifenberger', 'seanman247', 'cutaiad', 'cole30', 'jmelcher', 'episthmonas03', None, 'jledward', 'arep', 'shijiewu', 'felixgerenton', 'bohuifeng', 'smith422', 'acthomps', 'nanobalaji', 'marettea', 'haiyanyecao', 'seblanc', 'timbrosnan']"
5,23,88,10,7,"['yanad', 'jmb156', 'watergrave', 'rngzc', 'nicholas.g.franconi', 'ncr5014', 'taq3']",80,"['tduersto', 'joelchevrier', 'valerya03', 'alouis', 'giovanni89', 'richrat', 'luciana_cendon', 'gabenl0', 'lopezf987', 'karodger', 'umbi69', 'mariajo.cadena', 'lubarsky', 'shadow222', 'zhoutao', 'braeder', 'djrobles', 'givemethreesteps', 'edam', 'hthomps', 'acleverphrase', 'vituccig', 'dschaetzl', 'avirani627', 'nissenhan', 'gyli9753', 'pablovegav', 'mnow', 'nurulhuda', 'kilpatrj', 'ess26', 'jlocket', 'ranayhbd', 'mecaflu', 'fejkaman869', 'mjikim84', 'ozografos', 'bcelmer', 'vale.rust', 'vjaganna', 'yanghaiyan', 'jmeadows', 'atwell61', 'weifanan', 'micromanager', 'gwabi', 'horatz', 'youngms', 'jmcphee', 'maneerox', 'jspasoff', 'cmcleod', 'sofiane.sirajeddine', 'necoraptor', 'jorgelagos', 'kida', 'seamon', 'nanomuttoncl', 'giuseppecantarella', 'ladama', 'rharnish', 'nstrozie', 'pmankow', 'seanman247', 'cutaiad', 'cole30', 'jmelcher', 'episthmonas03', 'jledward', 'arep', 'shijiewu', 'felixgerenton', 'bohuifeng', 'smith422', 'acthomps', 'nanobalaji', 'marettea', 'haiyanyecao', 'seblanc', 'timbrosnan']",3,"[None, 'fel22', 'jack1988']",90,"['tduersto', 'joelchevrier', 'valerya03', 'alouis', 'giovanni89', 'richrat', 'luciana_cendon', 'gabenl0', 'lopezf987', 'karodger', 'umbi69', 'mariajo.cadena', 'nicholas.g.franconi', 'lubarsky', 'shadow222', 'zhoutao', 'braeder', 'djrobles', 'givemethreesteps', 'edam', 'jmb156', 'hthomps', 'acleverphrase', 'vituccig', 'dschaetzl', 'avirani627', 'nissenhan', 'gyli9753', 'pablovegav', 'fel22', 'mnow', 'nurulhuda', 'watergrave', 'kilpatrj', 'ess26', 'jlocket', 'rngzc', 'ranayhbd', 'mecaflu', 'taq3', 'fejkaman869', 'mjikim84', 'ozografos', 'yanad', 'bcelmer', 'vale.rust', 'vjaganna', 'yanghaiyan', 'jmeadows', 'atwell61', 'weifanan', 'ncr5014', 'micromanager', 'gwabi', 'horatz', 'youngms', 'jmcphee', 'maneerox', 'jspasoff', 'cmcleod', 'sofiane.sirajeddine', 'necoraptor', 'jorgelagos', 'kida', 'seamon', 'nanomuttoncl', 'giuseppecantarella', 'ladama', 'rharnish', 'nstrozie', 'pmankow', 'seanman247', 'cutaiad', 'cole30', 'jmelcher', 'episthmonas03', None, 'jledward', 'arep', 'shijiewu', 'felixgerenton', 'bohuifeng', 'smith422', 'acthomps', 'jack1988', 'nanobalaji', 'marettea', 'haiyanyecao', 'seblanc', 'timbrosnan']"
5,25,88,10,7,"['jspasoff', 'givemethreesteps', 'rharnish', 'hthomps', 'acthomps', 'dschaetzl', 'jmcphee']",80,"['tduersto', 'joelchevrier', 'valerya03', 'alouis', 'giovanni89', 'richrat', 'luciana_cendon', 'gabenl0', 'lopezf987', 'karodger', 'umbi69', 'mariajo.cadena', 'nicholas.g.franconi', 'lubarsky', 'shadow222', 'zhoutao', 'braeder', 'djrobles', 'edam', 'jmb156', 'acleverphrase', 'vituccig', 'avirani627', 'nissenhan', 'gyli9753', 'pablovegav', 'mnow', 'nurulhuda', 'watergrave', 'kilpatrj', 'ess26', 'jlocket', 'rngzc', 'ranayhbd', 'mecaflu', 'taq3', 'fejkaman869', 'mjikim84', 'ozografos', 'yanad', 'bcelmer', 'vale.rust', 'vjaganna', 'yanghaiyan', 'jmeadows', 'atwell61', 'weifanan', 'ncr5014', 'micromanager', 'gwabi', 'horatz', 'youngms', 'maneerox', 'cmcleod', 'sofiane.sirajeddine', 'necoraptor', 'jorgelagos', 'kida', 'seamon', 'nanomuttoncl', 'giuseppecantarella', 'ladama', 'nstrozie', 'pmankow', 'seanman247', 'cutaiad', 'cole30', 'jmelcher', 'episthmonas03', 'jledward', 'arep', 'shijiewu', 'felixgerenton', 'bohuifeng', 'smith422', 'nanobalaji', 'marettea', 'haiyanyecao', 'seblanc', 'timbrosnan']",3,"[None, 'reifenberger', 'glhardin']",90,"['tduersto', 'joelchevrier', 'valerya03', 'alouis', 'giovanni89', 'richrat', 'luciana_cendon', 'gabenl0', 'lopezf987', 'karodger', 'umbi69', 'mariajo.cadena', 'nicholas.g.franconi', 'lubarsky', 'shadow222', 'zhoutao', 'braeder', 'djrobles', 'givemethreesteps', 'edam', 'jmb156', 'hthomps', 'acleverphrase', 'vituccig', 'dschaetzl', 'avirani627', 'nissenhan', 'gyli9753', 'pablovegav', 'mnow', 'nurulhuda', 'glhardin', 'watergrave', 'kilpatrj', 'ess26', 'jlocket', 'rngzc', 'ranayhbd', 'mecaflu', 'taq3', 'fejkaman869', 'mjikim84', 'ozografos', 'yanad', 'bcelmer', 'vale.rust', 'vjaganna', 'yanghaiyan', 'jmeadows', 'atwell61', 'weifanan', 'ncr5014', 'micromanager', 'gwabi', 'horatz', 'youngms', 'jmcphee', 'maneerox', 'jspasoff', 'cmcleod', 'sofiane.sirajeddine', 'necoraptor', 'jorgelagos', 'kida', 'seamon', 'nanomuttoncl', 'giuseppecantarella', 'ladama', 'rharnish', 'nstrozie', 'pmankow', 'reifenberger', 'seanman247', 'cutaiad', 'cole30', 'jmelcher', 'episthmonas03', None, 'jledward', 'arep', 'shijiewu', 'felixgerenton', 'bohuifeng', 'smith422', 'acthomps', 'nanobalaji', 'marettea', 'haiyanyecao', 'seblanc', 'timbrosnan']"
5,20,88,9,5,"['bcelmer', 'acleverphrase', 'dschaetzl', 'cole30', 'jmcphee']",82,"['tduersto', 'joelchevrier', 'valerya03', 'alouis', 'giovanni89', 'richrat', 'luciana_cendon', 'gabenl0', 'lopezf987', 'karodger', 'umbi69', 'mariajo.cadena', 'nicholas.g.franconi', 'lubarsky', 'shadow222', 'zhoutao', 'braeder', 'djrobles', 'givemethreesteps', 'edam', 'jmb156', 'hthomps', 'vituccig', 'avirani627', 'nissenhan', 'gyli9753', 'pablovegav', 'mnow', 'nurulhuda', 'watergrave', 'kilpatrj', 'ess26', 'jlocket', 'rngzc', 'ranayhbd', 'mecaflu', 'taq3', 'fejkaman869', 'mjikim84', 'ozografos', 'yanad', 'vale.rust', 'vjaganna', 'yanghaiyan', 'jmeadows', 'atwell61', 'weifanan', 'ncr5014', 'micromanager', 'gwabi', 'horatz', 'youngms', 'maneerox', 'jspasoff', 'cmcleod', 'sofiane.sirajeddine', 'necoraptor', 'jorgelagos', 'kida', 'seamon', 'nanomuttoncl', 'giuseppecantarella', 'ladama', 'rharnish', 'nstrozie', 'pmankow', 'seanman247', 'cutaiad', 'jmelcher', 'episthmonas03', 'jledward', 'arep', 'shijiewu', 'felixgerenton', 'bohuifeng', 'smith422', 'acthomps', 'nanobalaji', 'marettea', 'haiyanyecao', 'seblanc', 'timbrosnan']",4,"[None, 'stanislaw', 'nonofrio', 'glhardin']",91,"['tduersto', 'joelchevrier', 'valerya03', 'stanislaw', 'alouis', 'giovanni89', 'richrat', 'luciana_cendon', 'gabenl0', 'lopezf987', 'karodger', 'umbi69', 'mariajo.cadena', 'nicholas.g.franconi', 'lubarsky', 'shadow222', 'zhoutao', 'braeder', 'djrobles', 'givemethreesteps', 'edam', 'jmb156', 'hthomps', 'acleverphrase', 'vituccig', 'dschaetzl', 'avirani627', 'nissenhan', 'gyli9753', 'pablovegav', 'mnow', 'nurulhuda', 'glhardin', 'watergrave', 'kilpatrj', 'ess26', 'jlocket', 'rngzc', 'ranayhbd', 'mecaflu', 'taq3', 'fejkaman869', 'mjikim84', 'ozografos', 'yanad', 'bcelmer', 'vale.rust', 'vjaganna', 'yanghaiyan', 'jmeadows', 'atwell61', 'weifanan', 'ncr5014', 'micromanager', 'gwabi', 'horatz', 'youngms', 'jmcphee', 'maneerox', 'jspasoff', 'cmcleod', 'sofiane.sirajeddine', 'necoraptor', 'jorgelagos', 'kida', 'seamon', 'nanomuttoncl', 'giuseppecantarella', 'ladama', 'rharnish', 'nstrozie', 'pmankow', 'nonofrio', 'seanman247', 'cutaiad', 'cole30', 'jmelcher', 'episthmonas03', None, 'jledward', 'arep', 'shijiewu', 'felixgerenton', 'bohuifeng', 'smith422', 'acthomps', 'nanobalaji', 'marettea', 'haiyanyecao', 'seblanc', 'timbrosnan']"
5,21,88,8,5,"['mjikim84', 'jmb156', 'weifanan', 'ncr5014', 'ranayhbd']",82,"['tduersto', 'joelchevrier', 'valerya03', 'alouis', 'giovanni89', 'richrat', 'luciana_cendon', 'gabenl0', 'lopezf987', 'karodger', 'umbi69', 'mariajo.cadena', 'nicholas.g.franconi', 'lubarsky', 'shadow222', 'zhoutao', 'braeder', 'djrobles', 'givemethreesteps', 'edam', 'hthomps', 'acleverphrase', 'vituccig', 'dschaetzl', 'avirani627', 'nissenhan', 'gyli9753', 'pablovegav', 'mnow', 'nurulhuda', 'watergrave', 'kilpatrj', 'ess26', 'jlocket', 'rngzc', 'mecaflu', 'taq3', 'fejkaman869', 'ozografos', 'yanad', 'bcelmer', 'vale.rust', 'vjaganna', 'yanghaiyan', 'jmeadows', 'atwell61', 'micromanager', 'gwabi', 'horatz', 'youngms', 'jmcphee', 'maneerox', 'jspasoff', 'cmcleod', 'sofiane.sirajeddine', 'necoraptor', 'jorgelagos', 'kida', 'seamon', 'nanomuttoncl', 'giuseppecantarella', 'ladama', 'rharnish', 'nstrozie', 'pmankow', 'seanman247', 'cutaiad', 'cole30', 'jmelcher', 'episthmonas03', 'jledward', 'arep', 'shijiewu', 'felixgerenton', 'bohuifeng', 'smith422', 'acthomps', 'nanobalaji', 'marettea', 'haiyanyecao', 'seblanc', 'timbrosnan']",3,"[None, 'fel22', 'jack1988']",90,"['tduersto', 'joelchevrier', 'valerya03', 'alouis', 'giovanni89', 'richrat', 'luciana_cendon', 'gabenl0', 'lopezf987', 'karodger', 'umbi69', 'mariajo.cadena', 'nicholas.g.franconi', 'lubarsky', 'shadow222', 'zhoutao', 'braeder', 'djrobles', 'givemethreesteps', 'edam', 'jmb156', 'hthomps', 'acleverphrase', 'vituccig', 'dschaetzl', 'avirani627', 'nissenhan', 'gyli9753', 'pablovegav', 'fel22', 'mnow', 'nurulhuda', 'watergrave', 'kilpatrj', 'ess26', 'jlocket', 'rngzc', 'ranayhbd', 'mecaflu', 'taq3', 'fejkaman869', 'mjikim84', 'ozografos', 'yanad', 'bcelmer', 'vale.rust', 'vjaganna', 'yanghaiyan', 'jmeadows', 'atwell61', 'weifanan', 'ncr5014', 'micromanager', 'gwabi', 'horatz', 'youngms', 'jmcphee', 'maneerox', 'jspasoff', 'cmcleod', 'sofiane.sirajeddine', 'necoraptor', 'jorgelagos', 'kida', 'seamon', 'nanomuttoncl', 'giuseppecantarella', 'ladama', 'rharnish', 'nstrozie', 'pmankow', 'seanman247', 'cutaiad', 'cole30', 'jmelcher', 'episthmonas03', None, 'jledward', 'arep', 'shijiewu', 'felixgerenton', 'bohuifeng', 'smith422', 'acthomps', 'jack1988', 'nanobalaji', 'marettea', 'haiyanyecao', 'seblanc', 'timbrosnan']"
5,19,88,7,4,"['weifanan', 'gyli9753', 'ncr5014', 'jmb156']",83,"['tduersto', 'joelchevrier', 'valerya03', 'alouis', 'giovanni89', 'richrat', 'luciana_cendon', 'gabenl0', 'lopezf987', 'karodger', 'umbi69', 'mariajo.cadena', 'nicholas.g.franconi', 'lubarsky', 'shadow222', 'zhoutao', 'braeder', 'djrobles', 'givemethreesteps', 'edam', 'hthomps', 'acleverphrase', 'vituccig', 'dschaetzl', 'avirani627', 'nissenhan', 'pablovegav', 'mnow', 'nurulhuda', 'watergrave', 'kilpatrj', 'ess26', 'jlocket', 'rngzc', 'ranayhbd', 'mecaflu', 'taq3', 'fejkaman869', 'mjikim84', 'ozografos', 'yanad', 'bcelmer', 'vale.rust', 'vjaganna', 'yanghaiyan', 'jmeadows', 'atwell61', 'micromanager', 'gwabi', 'horatz', 'youngms', 'jmcphee', 'maneerox', 'jspasoff', 'cmcleod', 'sofiane.sirajeddine', 'necoraptor', 'jorgelagos', 'kida', 'seamon', 'nanomuttoncl', 'giuseppecantarella', 'ladama', 'rharnish', 'nstrozie', 'pmankow', 'seanman247', 'cutaiad', 'cole30', 'jmelcher', 'episthmonas03', 'jledward', 'arep', 'shijiewu', 'felixgerenton', 'bohuifeng', 'smith422', 'acthomps', 'nanobalaji', 'marettea', 'haiyanyecao', 'seblanc', 'timbrosnan']",3,"[None, 'fel22', 'jack1988']",90,"['tduersto', 'joelchevrier', 'valerya03', 'alouis', 'giovanni89', 'richrat', 'luciana_cendon', 'gabenl0', 'lopezf987', 'karodger', 'umbi69', 'mariajo.cadena', 'nicholas.g.franconi', 'lubarsky', 'shadow222', 'zhoutao', 'braeder', 'djrobles', 'givemethreesteps', 'edam', 'jmb156', 'hthomps', 'acleverphrase', 'vituccig', 'dschaetzl', 'avirani627', 'nissenhan', 'gyli9753', 'pablovegav', 'fel22', 'mnow', 'nurulhuda', 'watergrave', 'kilpatrj', 'ess26', 'jlocket', 'rngzc', 'ranayhbd', 'mecaflu', 'taq3', 'fejkaman869', 'mjikim84', 'ozografos', 'yanad', 'bcelmer', 'vale.rust', 'vjaganna', 'yanghaiyan', 'jmeadows', 'atwell61', 'weifanan', 'ncr5014', 'micromanager', 'gwabi', 'horatz', 'youngms', 'jmcphee', 'maneerox', 'jspasoff', 'cmcleod', 'sofiane.sirajeddine', 'necoraptor', 'jorgelagos', 'kida', 'seamon', 'nanomuttoncl', 'giuseppecantarella', 'ladama', 'rharnish', 'nstrozie', 'pmankow', 'seanman247', 'cutaiad', 'cole30', 'jmelcher', 'episthmonas03', None, 'jledward', 'arep', 'shijiewu', 'felixgerenton', 'bohuifeng', 'smith422', 'acthomps', 'jack1988', 'nanobalaji', 'marettea', 'haiyanyecao', 'seblanc', 'timbrosnan']"
5,27,88,7,5,"['arep', 'ozografos', 'vale.rust', 'luciana_cendon', 'episthmonas03']",82,"['tduersto', 'joelchevrier', 'valerya03', 'alouis', 'giovanni89', 'richrat', 'gabenl0', 'lopezf987', 'karodger', 'umbi69', 'mariajo.cadena', 'nicholas.g.franconi', 'lubarsky', 'shadow222', 'zhoutao', 'braeder', 'djrobles', 'givemethreesteps', 'edam', 'jmb156', 'hthomps', 'acleverphrase', 'vituccig', 'dschaetzl', 'avirani627', 'nissenhan', 'gyli9753', 'pablovegav', 'mnow', 'nurulhuda', 'watergrave', 'kilpatrj', 'ess26', 'jlocket', 'rngzc', 'ranayhbd', 'mecaflu', 'taq3', 'fejkaman869', 'mjikim84', 'yanad', 'bcelmer', 'vjaganna', 'yanghaiyan', 'jmeadows', 'atwell61', 'weifanan', 'ncr5014', 'micromanager', 'gwabi', 'horatz', 'youngms', 'jmcphee', 'maneerox', 'jspasoff', 'cmcleod', 'sofiane.sirajeddine', 'necoraptor', 'jorgelagos', 'kida', 'seamon', 'nanomuttoncl', 'giuseppecantarella', 'ladama', 'rharnish', 'nstrozie', 'pmankow', 'seanman247', 'cutaiad', 'cole30', 'jmelcher', 'jledward', 'shijiewu', 'felixgerenton', 'bohuifeng', 'smith422', 'acthomps', 'nanobalaji', 'marettea', 'haiyanyecao', 'seblanc', 'timbrosnan']",2,"[None, 'ashwyn280689']",89,"['tduersto', 'joelchevrier', 'valerya03', 'alouis', 'giovanni89', 'richrat', 'luciana_cendon', 'gabenl0', 'lopezf987', 'karodger', 'umbi69', 'mariajo.cadena', 'nicholas.g.franconi', 'lubarsky', 'shadow222', 'zhoutao', 'braeder', 'djrobles', 'givemethreesteps', 'edam', 'jmb156', 'hthomps', 'acleverphrase', 'vituccig', 'dschaetzl', 'avirani627', 'nissenhan', 'gyli9753', 'pablovegav', 'mnow', 'nurulhuda', 'watergrave', 'kilpatrj', 'ess26', 'jlocket', 'rngzc', 'ranayhbd', 'mecaflu', 'taq3', 'fejkaman869', 'mjikim84', 'ozografos', 'yanad', 'bcelmer', 'vale.rust', 'vjaganna', 'yanghaiyan', 'jmeadows', 'atwell61', 'weifanan', 'ncr5014', 'micromanager', 'gwabi', 'horatz', 'youngms', 'jmcphee', 'maneerox', 'jspasoff', 'cmcleod', 'ashwyn280689', 'sofiane.sirajeddine', 'necoraptor', 'jorgelagos', 'kida', 'seamon', 'nanomuttoncl', 'giuseppecantarella', 'ladama', 'rharnish', 'nstrozie', 'pmankow', 'seanman247', 'cutaiad', 'cole30', 'jmelcher', 'episthmonas03', None, 'jledward', 'arep', 'shijiewu', 'felixgerenton', 'bohuifeng', 'smith422', 'acthomps', 'nanobalaji', 'marettea', 'haiyanyecao', 'seblanc', 'timbrosnan']"
6,174,59,35,34,"['cyyeung', 'akleland', 'hannamm', 'dsuh90', 'wcao', 'mirandak', 'breemail11', 'jkim138', 'rresseguie', 'nguyenuh', 'kasramkakavand', 'thinhqn', 'tingh1', 'ljhung', 'a655329', 'sbougie', 'sgpark', 'rjsong', 'chsu3', 'dbelshei', 'jjocson', 'matsci1', 'wha13ver', 'sapphire15', 'mdaly45', 'caoa', 'mcarnold', 'andreww1', 'wangkp', 'waterdooob', 'cacampbe', 'amliao', 'mchan8', 'jmerz']",24,"['toroserkan', 'jml5691', 'alireza.ostadhossein', 'deabreuronaldo', 'mps5098', 'slp300', 'rbn5009', 'mbb5123', 'twt5082', 'jeffspringmeier', 'costmen', 'wood67', 'hizj1981', 'ccolina', 'lbadaui', 'ryuseun', 'miguelciria', 'glaucio', 'javadsovizi', 'ostadhossein.hanif', 'rpchenguci', 'atp5028', 'veronica_632000', 'phongtt']",1,[None],59,"['cyyeung', 'akleland', 'hannamm', 'wcao', 'dsuh90', 'breemail11', 'rbn5009', 'jkim138', 'rresseguie', 'nguyenuh', 'tingh1', 'ljhung', 'costmen', 'wood67', 'sbougie', 'hizj1981', 'sgpark', 'rjsong', 'chsu3', 'dbelshei', 'lbadaui', 'jjocson', 'wha13ver', 'mdaly45', 'caoa', 'mcarnold', 'andreww1', 'wangkp', 'waterdooob', 'ostadhossein.hanif', 'atp5028', 'mchan8', 'toroserkan', 'jml5691', 'alireza.ostadhossein', 'mirandak', 'deabreuronaldo', 'mps5098', 'slp300', 'mbb5123', 'twt5082', 'kasramkakavand', 'thinhqn', 'a655329', 'jeffspringmeier', 'ccolina', 'ryuseun', 'miguelciria', None, 'matsci1', 'sapphire15', 'glaucio', 'javadsovizi', 'amliao', 'cacampbe', 'rpchenguci', 'veronica_632000', 'jmerz', 'phongtt']"
6,175,59,13,12,"['mps5098', 'slp300', 'rbn5009', 'mbb5123', 'twt5082', 'ccolina', 'ostadhossein.hanif', 'jml5691', 'atp5028', 'jeffspringmeier', 'alireza.ostadhossein', 'veronica_632000']",46,"['cyyeung', 'akleland', 'toroserkan', 'hannamm', 'wcao', 'dsuh90', 'mirandak', 'breemail11', 'deabreuronaldo', 'jkim138', 'rresseguie', 'kasramkakavand', 'nguyenuh', 'thinhqn', 'tingh1', 'ljhung', 'a655329', 'costmen', 'wood67', 'sbougie', 'hizj1981', 'sgpark', 'rjsong', 'chsu3', 'dbelshei', 'lbadaui', 'jjocson', 'ryuseun', 'miguelciria', 'matsci1', 'wha13ver', 'sapphire15', 'mdaly45', 'caoa', 'mcarnold', 'andreww1', 'glaucio', 'wangkp', 'waterdooob', 'javadsovizi', 'amliao', 'cacampbe', 'rpchenguci', 'mchan8', 'jmerz', 'phongtt']",1,[None],59,"['cyyeung', 'akleland', 'toroserkan', 'hannamm', 'jml5691', 'wcao', 'dsuh90', 'alireza.ostadhossein', 'mirandak', 'breemail11', 'deabreuronaldo', 'mps5098', 'slp300', 'rbn5009', 'mbb5123', 'twt5082', 'jkim138', 'rresseguie', 'kasramkakavand', 'nguyenuh', 'thinhqn', 'tingh1', 'ljhung', 'a655329', 'jeffspringmeier', 'costmen', 'wood67', 'sbougie', 'hizj1981', 'sgpark', 'rjsong', 'ccolina', 'chsu3', 'dbelshei', 'lbadaui', 'jjocson', 'ryuseun', 'miguelciria', None, 'matsci1', 'wha13ver', 'sapphire15', 'mdaly45', 'caoa', 'mcarnold', 'andreww1', 'glaucio', 'wangkp', 'waterdooob', 'javadsovizi', 'ostadhossein.hanif', 'amliao', 'cacampbe', 'rpchenguci', 'mchan8', 'atp5028', 'veronica_632000', 'jmerz', 'phongtt']"
6,176,59,7,6,"['jkim138', 'wangkp', 'chsu3', 'mirandak', 'jmerz', 'phongtt']",52,"['cyyeung', 'akleland', 'toroserkan', 'hannamm', 'jml5691', 'wcao', 'dsuh90', 'alireza.ostadhossein', 'breemail11', 'deabreuronaldo', 'mps5098', 'slp300', 'rbn5009', 'mbb5123', 'twt5082', 'rresseguie', 'kasramkakavand', 'nguyenuh', 'thinhqn', 'tingh1', 'ljhung', 'a655329', 'jeffspringmeier', 'costmen', 'wood67', 'sbougie', 'hizj1981', 'sgpark', 'rjsong', 'ccolina', 'dbelshei', 'lbadaui', 'jjocson', 'ryuseun', 'miguelciria', 'matsci1', 'wha13ver', 'sapphire15', 'mdaly45', 'caoa', 'mcarnold', 'andreww1', 'glaucio', 'waterdooob', 'javadsovizi', 'ostadhossein.hanif', 'amliao', 'cacampbe', 'rpchenguci', 'mchan8', 'atp5028', 'veronica_632000']",1,[None],59,"['cyyeung', 'akleland', 'toroserkan', 'hannamm', 'jml5691', 'wcao', 'dsuh90', 'alireza.ostadhossein', 'mirandak', 'breemail11', 'deabreuronaldo', 'mps5098', 'slp300', 'rbn5009', 'mbb5123', 'twt5082', 'jkim138', 'rresseguie', 'kasramkakavand', 'nguyenuh', 'thinhqn', 'tingh1', 'ljhung', 'a655329', 'jeffspringmeier', 'costmen', 'wood67', 'sbougie', 'hizj1981', 'sgpark', 'rjsong', 'ccolina', 'chsu3', 'dbelshei', 'lbadaui', 'jjocson', 'ryuseun', 'miguelciria', None, 'matsci1', 'wha13ver', 'sapphire15', 'mdaly45', 'caoa', 'mcarnold', 'andreww1', 'glaucio', 'wangkp', 'waterdooob', 'javadsovizi', 'ostadhossein.hanif', 'amliao', 'cacampbe', 'rpchenguci', 'mchan8', 'atp5028', 'veronica_632000', 'jmerz', 'phongtt']"
7,118,58,48,45,"['uqhoang', 'rzclemente', 'nriaz', 'mhbuettner', 'jberroteran', 'fegonzalez', 'pjpacis', 'jcfan', 'lfflores', 'georgeperez33', 'mqiu', 'kavehking7', 'pashayan', 'zjpahle', 'revillnaueva', 'rayxxx8277', 'mac01', 'chrisbuen92', 'tekfreek7', 'nmnguyen', 'edmondwong', 'esemerson', 'lillie06', 'sparvin', 'tlnguyen', 'tfphan', 'mtellam', 'drbogan', 'aer', 'kdbrooks', 'egorgoyan', 'sgskidmore', 'jfg', 'thunderboie', 'wamorales', 'trungdibi', 'xpupodndx', 'jytom', 'stevenuraine', 'hjseo0313', 'tn123456', 'michaelyang', 'eclaro', 'basaia', 'ggfc']",12,"['jim87072', 'dadinh', 'lyflys9', 'adsalce', 'bjscarberry', 'jtirona', 'tjkampen', 'josephklee', 'jbsosa', 'mehenning', 'schin2', 'jjyung']",3,"[None, 'faltens', 'victors']",60,"['rzclemente', 'nriaz', 'jberroteran', 'fegonzalez', 'pjpacis', 'jcfan', 'lfflores', 'georgeperez33', 'kavehking7', 'zjpahle', 'adsalce', 'revillnaueva', 'tekfreek7', 'nmnguyen', 'edmondwong', 'schin2', 'esemerson', 'lillie06', 'tlnguyen', 'mtellam', 'josephklee', 'aer', 'sgskidmore', 'jfg', 'dadinh', 'trungdibi', 'xpupodndx', 'jytom', 'stevenuraine', 'jbsosa', 'michaelyang', 'eclaro', 'basaia', 'ggfc', 'jtirona', 'uqhoang', 'mhbuettner', 'mehenning', 'jjyung', 'pashayan', 'mqiu', 'jim87072', 'bjscarberry', 'tjkampen', 'rayxxx8277', 'mac01', 'chrisbuen92', 'victors', 'faltens', 'sparvin', 'tfphan', 'drbogan', 'kdbrooks', 'egorgoyan', None, 'thunderboie', 'wamorales', 'lyflys9', 'hjseo0313', 'tn123456']"
7,120,58,34,32,"['jtirona', 'rzclemente', 'mhbuettner', 'fegonzalez', 'jcfan', 'lfflores', 'jjyung', 'georgeperez33', 'mqiu', 'pashayan', 'zjpahle', 'adsalce', 'revillnaueva', 'tjkampen', 'mac01', 'chrisbuen92', 'tekfreek7', 'nmnguyen', 'edmondwong', 'schin2', 'esemerson', 'lillie06', 'tfphan', 'tlnguyen', 'drbogan', 'aer', 'kdbrooks', 'trungdibi', 'stevenuraine', 'hjseo0313', 'tn123456', 'basaia']",25,"['uqhoang', 'nriaz', 'jberroteran', 'mehenning', 'pjpacis', 'jim87072', 'kavehking7', 'bjscarberry', 'rayxxx8277', 'sparvin', 'mtellam', 'josephklee', 'sgskidmore', 'egorgoyan', 'jfg', 'thunderboie', 'wamorales', 'dadinh', 'lyflys9', 'xpupodndx', 'jytom', 'jbsosa', 'michaelyang', 'eclaro', 'ggfc']",2,"[None, 'faltens']",59,"['rzclemente', 'nriaz', 'jberroteran', 'fegonzalez', 'pjpacis', 'jcfan', 'lfflores', 'georgeperez33', 'kavehking7', 'zjpahle', 'adsalce', 'revillnaueva', 'tekfreek7', 'nmnguyen', 'edmondwong', 'schin2', 'esemerson', 'lillie06', 'tlnguyen', 'mtellam', 'josephklee', 'aer', 'sgskidmore', 'jfg', 'dadinh', 'trungdibi', 'xpupodndx', 'jytom', 'stevenuraine', 'jbsosa', 'michaelyang', 'eclaro', 'basaia', 'ggfc', 'jtirona', 'uqhoang', 'mhbuettner', 'mehenning', 'jjyung', 'pashayan', 'mqiu', 'jim87072', 'bjscarberry', 'tjkampen', 'rayxxx8277', 'mac01', 'chrisbuen92', 'faltens', 'sparvin', 'tfphan', 'drbogan', 'kdbrooks', 'egorgoyan', None, 'thunderboie', 'wamorales', 'lyflys9', 'hjseo0313', 'tn123456']"
7,119,58,12,11,"['jim87072', 'dadinh', 'bjscarberry', 'jtirona', 'tjkampen', 'jytom', 'chrisbuen92', 'nmnguyen', 'mehenning', 'jfg', 'jjyung']",46,"['uqhoang', 'rzclemente', 'nriaz', 'mhbuettner', 'jberroteran', 'fegonzalez', 'pjpacis', 'jcfan', 'lfflores', 'georgeperez33', 'pashayan', 'mqiu', 'zjpahle', 'adsalce', 'kavehking7', 'revillnaueva', 'rayxxx8277', 'mac01', 'tekfreek7', 'edmondwong', 'schin2', 'esemerson', 'lillie06', 'sparvin', 'tlnguyen', 'tfphan', 'mtellam', 'drbogan', 'josephklee', 'aer', 'kdbrooks', 'sgskidmore', 'egorgoyan', 'thunderboie', 'wamorales', 'lyflys9', 'trungdibi', 'xpupodndx', 'stevenuraine', 'hjseo0313', 'jbsosa', 'tn123456', 'michaelyang', 'eclaro', 'basaia', 'ggfc']",1,[None],58,"['jtirona', 'uqhoang', 'rzclemente', 'nriaz', 'mhbuettner', 'jberroteran', 'mehenning', 'fegonzalez', 'pjpacis', 'jcfan', 'lfflores', 'jjyung', 'georgeperez33', 'pashayan', 'mqiu', 'zjpahle', 'jim87072', 'adsalce', 'bjscarberry', 'kavehking7', 'tjkampen', 'revillnaueva', 'rayxxx8277', 'mac01', 'chrisbuen92', 'tekfreek7', 'nmnguyen', 'edmondwong', 'schin2', 'esemerson', 'lillie06', 'sparvin', 'tlnguyen', 'tfphan', 'mtellam', 'drbogan', 'josephklee', 'aer', 'kdbrooks', 'sgskidmore', 'egorgoyan', None, 'jfg', 'thunderboie', 'wamorales', 'dadinh', 'lyflys9', 'trungdibi', 'xpupodndx', 'jytom', 'stevenuraine', 'hjseo0313', 'jbsosa', 'tn123456', 'michaelyang', 'eclaro', 'basaia', 'ggfc']"
8,270,58,28,27,"['crpriest', 'lddevon', 'trhumble', 'ajapit12345', 'ajray2', 'ewlindau', 'bjalyea', 'ncsu_2011', 'nanunn', 'zstroman', 'btanthon', 'asalrush', 'owd', 'blizzman91', 'alhawksl', 'brogers526', 'wdyandle', 'wesleyjones', 'xji3', 'tbarlaz', 'amleszcz', 'chmeredi', 'cmbuchan', 'tsjohnst', 'wphallig', 'hughtrue', 'abcollie']",30,"['mbrake', 'oddfirefly', 'webbjam', 'clfreder', 'maxilgoi', 'jjsantor', 'dlirving', 'leecho', 'kellermuckl', 'jwlewis2', 'jmbaro', 'bjsc0tt', 'daferruz', 'amadan1', 'awlewis4', 'dglossman', 'fosterbj', 'lab106tsu', 'mavaleri', 'mbhill3', 'revan', 'ronalme', 'tavonwin', 'neobatty', 'danielgri14', 'mpbruner', 'kibben', 'evancallaway', 'gajanan78', 'kaschny']",1,[None],58,"['mbrake', 'crpriest', 'lddevon', 'oddfirefly', 'webbjam', 'clfreder', 'dlirving', 'leecho', 'jwlewis2', 'ncsu_2011', 'jmbaro', 'zstroman', 'bjsc0tt', 'amadan1', 'awlewis4', 'lab106tsu', 'blizzman91', 'revan', 'brogers526', 'ronalme', 'tavonwin', 'xji3', 'kibben', 'tbarlaz', 'amleszcz', 'cmbuchan', 'gajanan78', 'kaschny', 'tsjohnst', 'alhawksl', 'hughtrue', 'trhumble', 'maxilgoi', 'ajapit12345', 'jjsantor', 'ajray2', 'ewlindau', 'kellermuckl', 'bjalyea', 'nanunn', 'btanthon', 'asalrush', 'daferruz', 'owd', 'dglossman', 'fosterbj', 'mavaleri', 'mbhill3', 'wdyandle', 'wesleyjones', None, 'neobatty', 'danielgri14', 'mpbruner', 'evancallaway', 'chmeredi', 'wphallig', 'abcollie']"
8,271,58,18,17,"['xji3', 'awlewis4', 'crpriest', 'wesleyjones', 'tbarlaz', 'bjalyea', 'evancallaway', 'jwlewis2', 'ncsu_2011', 'amadan1', 'jmbaro', 'zstroman', 'mbhill3', 'dlirving', 'ewlindau', 'abcollie', 'danielgri14']",40,"['mbrake', 'lddevon', 'hughtrue', 'trhumble', 'oddfirefly', 'webbjam', 'maxilgoi', 'ajapit12345', 'clfreder', 'jjsantor', 'ajray2', 'leecho', 'kellermuckl', 'nanunn', 'bjsc0tt', 'btanthon', 'asalrush', 'daferruz', 'owd', 'dglossman', 'fosterbj', 'lab106tsu', 'mavaleri', 'blizzman91', 'revan', 'brogers526', 'ronalme', 'tavonwin', 'wdyandle', 'neobatty', 'mpbruner', 'kibben', 'amleszcz', 'chmeredi', 'cmbuchan', 'gajanan78', 'kaschny', 'tsjohnst', 'wphallig', 'alhawksl']",1,[None],58,"['mbrake', 'crpriest', 'lddevon', 'trhumble', 'oddfirefly', 'webbjam', 'maxilgoi', 'ajapit12345', 'clfreder', 'jjsantor', 'ajray2', 'dlirving', 'ewlindau', 'leecho', 'kellermuckl', 'bjalyea', 'jwlewis2', 'ncsu_2011', 'jmbaro', 'zstroman', 'nanunn', 'bjsc0tt', 'btanthon', 'asalrush', 'daferruz', 'owd', 'amadan1', 'awlewis4', 'dglossman', 'fosterbj', 'lab106tsu', 'mavaleri', 'blizzman91', 'alhawksl', 'mbhill3', 'revan', 'brogers526', 'ronalme', 'tavonwin', 'wdyandle', 'wesleyjones', None, 'neobatty', 'danielgri14', 'xji3', 'mpbruner', 'kibben', 'tbarlaz', 'evancallaway', 'amleszcz', 'chmeredi', 'cmbuchan', 'gajanan78', 'kaschny', 'tsjohnst', 'wphallig', 'hughtrue', 'abcollie']"
8,272,58,16,14,"['xji3', 'awlewis4', 'mpbruner', 'evancallaway', 'mavaleri', 'chmeredi', 'jwlewis2', 'jmbaro', 'clfreder', 'jjsantor', 'daferruz', 'tavonwin', 'amadan1', 'danielgri14']",43,"['mbrake', 'crpriest', 'lddevon', 'hughtrue', 'trhumble', 'oddfirefly', 'webbjam', 'maxilgoi', 'ajapit12345', 'ajray2', 'dlirving', 'ewlindau', 'leecho', 'kellermuckl', 'bjalyea', 'ncsu_2011', 'zstroman', 'nanunn', 'bjsc0tt', 'btanthon', 'asalrush', 'owd', 'dglossman', 'fosterbj', 'lab106tsu', 'blizzman91', 'mbhill3', 'revan', 'brogers526', 'ronalme', 'wdyandle', 'wesleyjones', 'neobatty', 'kibben', 'tbarlaz', 'amleszcz', 'cmbuchan', 'gajanan78', 'kaschny', 'tsjohnst', 'wphallig', 'alhawksl', 'abcollie']",2,"[None, 'jenorket']",59,"['mbrake', 'crpriest', 'lddevon', 'trhumble', 'oddfirefly', 'webbjam', 'maxilgoi', 'ajapit12345', 'clfreder', 'jjsantor', 'ajray2', 'dlirving', 'ewlindau', 'leecho', 'kellermuckl', 'bjalyea', 'jwlewis2', 'ncsu_2011', 'jmbaro', 'zstroman', 'nanunn', 'bjsc0tt', 'btanthon', 'asalrush', 'daferruz', 'owd', 'amadan1', 'awlewis4', 'dglossman', 'fosterbj', 'lab106tsu', 'mavaleri', 'blizzman91', 'alhawksl', 'mbhill3', 'revan', 'brogers526', 'ronalme', 'tavonwin', 'wdyandle', 'wesleyjones', None, 'neobatty', 'danielgri14', 'xji3', 'mpbruner', 'kibben', 'jenorket', 'tbarlaz', 'evancallaway', 'amleszcz', 'chmeredi', 'cmbuchan', 'gajanan78', 'kaschny', 'tsjohnst', 'wphallig', 'hughtrue', 'abcollie']"
8,269,58,11,10,"['xji3', 'lddevon', 'chmeredi', 'ncsu_2011', 'trhumble', 'cmbuchan', 'blizzman91', 'tsjohnst', 'ajray2', 'owd']",47,"['mbrake', 'crpriest', 'oddfirefly', 'webbjam', 'maxilgoi', 'ajapit12345', 'clfreder', 'jjsantor', 'dlirving', 'ewlindau', 'leecho', 'kellermuckl', 'bjalyea', 'jwlewis2', 'jmbaro', 'zstroman', 'nanunn', 'bjsc0tt', 'btanthon', 'asalrush', 'daferruz', 'amadan1', 'awlewis4', 'dglossman', 'fosterbj', 'lab106tsu', 'mavaleri', 'alhawksl', 'mbhill3', 'revan', 'brogers526', 'ronalme', 'tavonwin', 'wdyandle', 'wesleyjones', 'neobatty', 'danielgri14', 'mpbruner', 'kibben', 'tbarlaz', 'evancallaway', 'amleszcz', 'gajanan78', 'kaschny', 'wphallig', 'hughtrue', 'abcollie']",1,[None],58,"['mbrake', 'crpriest', 'lddevon', 'trhumble', 'oddfirefly', 'webbjam', 'maxilgoi', 'ajapit12345', 'clfreder', 'jjsantor', 'ajray2', 'dlirving', 'ewlindau', 'leecho', 'kellermuckl', 'bjalyea', 'jwlewis2', 'ncsu_2011', 'jmbaro', 'zstroman', 'nanunn', 'bjsc0tt', 'btanthon', 'asalrush', 'daferruz', 'owd', 'amadan1', 'awlewis4', 'dglossman', 'fosterbj', 'lab106tsu', 'mavaleri', 'blizzman91', 'alhawksl', 'mbhill3', 'revan', 'brogers526', 'ronalme', 'tavonwin', 'wdyandle', 'wesleyjones', None, 'neobatty', 'danielgri14', 'xji3', 'mpbruner', 'kibben', 'tbarlaz', 'evancallaway', 'amleszcz', 'chmeredi', 'cmbuchan', 'gajanan78', 'kaschny', 'tsjohnst', 'wphallig', 'hughtrue', 'abcollie']"
8,273,58,7,4,"['clfreder', 'mpbruner', 'mavaleri', 'tavonwin']",53,"['mbrake', 'crpriest', 'lddevon', 'trhumble', 'oddfirefly', 'webbjam', 'maxilgoi', 'ajapit12345', 'jjsantor', 'ajray2', 'dlirving', 'ewlindau', 'leecho', 'kellermuckl', 'bjalyea', 'jwlewis2', 'ncsu_2011', 'jmbaro', 'zstroman', 'nanunn', 'bjsc0tt', 'btanthon', 'asalrush', 'daferruz', 'owd', 'amadan1', 'awlewis4', 'dglossman', 'fosterbj', 'lab106tsu', 'blizzman91', 'alhawksl', 'mbhill3', 'revan', 'brogers526', 'ronalme', 'wdyandle', 'wesleyjones', 'neobatty', 'danielgri14', 'xji3', 'kibben', 'tbarlaz', 'evancallaway', 'amleszcz', 'chmeredi', 'cmbuchan', 'gajanan78', 'kaschny', 'tsjohnst', 'wphallig', 'hughtrue', 'abcollie']",3,"[None, 'jenorket', 'kev']",60,"['mbrake', 'crpriest', 'lddevon', 'trhumble', 'kev', 'oddfirefly', 'webbjam', 'maxilgoi', 'ajapit12345', 'clfreder', 'jjsantor', 'ajray2', 'dlirving', 'ewlindau', 'leecho', 'kellermuckl', 'bjalyea', 'jwlewis2', 'ncsu_2011', 'jmbaro', 'zstroman', 'nanunn', 'bjsc0tt', 'btanthon', 'asalrush', 'daferruz', 'owd', 'amadan1', 'awlewis4', 'dglossman', 'fosterbj', 'lab106tsu', 'mavaleri', 'blizzman91', 'alhawksl', 'mbhill3', 'revan', 'brogers526', 'ronalme', 'tavonwin', 'wdyandle', 'wesleyjones', None, 'neobatty', 'danielgri14', 'xji3', 'mpbruner', 'kibben', 'jenorket', 'tbarlaz', 'evancallaway', 'amleszcz', 'chmeredi', 'cmbuchan', 'gajanan78', 'kaschny', 'tsjohnst', 'wphallig', 'hughtrue', 'abcollie']"
9,69,57,118,1,['izquier2'],55,"['fatema', 'last1004in', 'lht6050', 'nasir93', 'aspanwar', 'johnslon', 'dimkin3', 'jdj0524', 'jongkook90', 'mkshim34', 'sanchezmarenghi', 'robins6876', 'yhs5928', 'lefthand86', 'khushali', 'seyeon625', 'ankita88', 'eringoldstraw', 'kaist1728', 'tlarldnd', 'farhan', 'nirmalgvr', 'brenda.bedeaux', 'marcozorzi', 'ingerslev', 'somaia_sylvia', 'arlevin', 'genius124', 'redwanhq', 'sweet711', 'ryanhannam', 'sangick3929', 'billyjames14', 'nrb722', 'newnovel3000', 'rajames29', 'kimis080', 'yookwang285', 'vidhi', 'jonathan.shinsato', 'gaurangbiomed', 'ksyu', 'chrozer', 'jatorbet1', 'duqrlrhemfma', 'justinaechols', 'bulentaslan', 'u8877', 'siveo123', 'win198978', 'mhg624', 'astronaut1984', 'tmina', 'rihene', 'florencendum']",117,"['dhuang123', 'nookala', 'dwass', 'moon1002', 'b3nny312', 'hua5', 'fredhdx', 'redyoshi49q', 'lshi14', 'shawkat', 'bradsnyder', 'johns149', 'muneebahmed95', 'sherrypri', 'hronik1', 'sfanou2', 'siwin2', 'sutchaya', 'vargas3', 'kumikknd', 'neilchristanto', 'yuan11', 'shawnwin1234', 'daybreak410039', 'ewalt1', 'baker48', 'coolcrew', 'banerje1', 'trovill1', 'chen338', 'hartant2', 'jiwonp224', 'hoang4', 'reebbhaa', 'profballack', 'alostu3', 'nanotie', 'chenhu1', 'malik15', 'madigan5', 'alabi2', 'ravitheja22', 'supermeatboy', 'ericwoo1', 'feng12', 'mikenike', 'jclift3', 'heebidiwup', 'yjaquinas', 'lidazhu1', 'menghuang', 'rushx1', 'wlee26', 'broll1', 'lu30', None, 'qiu12', 'zhangyj', 'wanchoi1', 'luiszelaya', 'spadin1', 'keating7', 'blee51', 'maxcan', 'leiche1', 'achavarria', 'samuelzhang', 'mahed', 'jashari1', 'mintzo', 'ouyang4', 'tatuhiro', 'pashea1', 'zulueta1', 'shapir11', 'kwak27', 'echegil1', 'donner1', 'nam18', 'vigneshka', 'jyao5', 'jksikai', 'szhang51', 'mim1c', 'jataput1', 'jayfurrie', 'miketeufel1', 'sgrand2', 'mikeudelhofen', 'dinger104', 'mihrenoe', 'aczerepak', 'stuber1', 'kandel3', 'williamhn', 'ahoboke', 'liyd', 'monnett1', 'ltompki2', 'lee117', 'surajmodi', 'lmendez2', 'red6290', 'a2104707', 'kadakiy1', 'hchao2', 'nmisak', 'hazypensieve', 'dferrell68', 'hgao10', 'stephenyzc', 'morris57', 'yao10', 'panlei616', 'jefflale', 'grace3050', 'tischer1']",173,"['dhuang123', 'nookala', 'dwass', 'izquier2', 'moon1002', 'jdj0524', 'b3nny312', 'hua5', 'fredhdx', 'redyoshi49q', 'tlarldnd', 'lshi14', 'shawkat', 'nirmalgvr', 'brenda.bedeaux', 'bradsnyder', 'marcozorzi', 'ingerslev', 'johns149', 'muneebahmed95', 'genius124', 'sweet711', 'ryanhannam', 'sherrypri', 'billyjames14', 'nrb722', 'hronik1', 'newnovel3000', 'sfanou2', 'siwin2', 'sutchaya', 'gaurangbiomed', 'vargas3', 'kumikknd', 'neilchristanto', 'ksyu', 'chrozer', 'duqrlrhemfma', 'yuan11', 'shawnwin1234', 'daybreak410039', 'ewalt1', 'baker48', 'coolcrew', 'banerje1', 'trovill1', 'chen338', 'fatema', 'last1004in', 'hartant2', 'jiwonp224', 'hoang4', 'reebbhaa', 'profballack', 'johnslon', 'alostu3', 'nanotie', 'chenhu1', 'dimkin3', 'malik15', 'ankita88', 'eringoldstraw', 'kaist1728', 'madigan5', 'farhan', 'alabi2', 'ravitheja22', 'supermeatboy', 'ericwoo1', 'feng12', 'mikenike', 'jclift3', 'somaia_sylvia', 'heebidiwup', 'yjaquinas', 'lidazhu1', 'redwanhq', 'sangick3929', 'menghuang', 'rushx1', 'wlee26', 'broll1', 'lu30', None, 'jonathan.shinsato', 'qiu12', 'zhangyj', 'wanchoi1', 'jatorbet1', 'luiszelaya', 'spadin1', 'keating7', 'u8877', 'blee51', 'maxcan', 'leiche1', 'tmina', 'florencendum', 'jefflale', 'achavarria', 'samuelzhang', 'mahed', 'jashari1', 'mintzo', 'nasir93', 'ouyang4', 'tatuhiro', 'pashea1', 'jongkook90', 'zulueta1', 'shapir11', 'kwak27', 'seyeon625', 'echegil1', 'donner1', 'nam18', 'vigneshka', 'jyao5', 'jksikai', 'szhang51', 'mim1c', 'jataput1', 'arlevin', 'jayfurrie', 'miketeufel1', 'rajames29', 'kimis080', 'sgrand2', 'mikeudelhofen', 'dinger104', 'mihrenoe', 'win198978', 'mhg624', 'yhs5928', 'aczerepak', 'stuber1', 'rihene', 'kandel3', 'lht6050', 'williamhn', 'ahoboke', 'liyd', 'aspanwar', 'monnett1', 'mkshim34', 'sanchezmarenghi', 'robins6876', 'ltompki2', 'lefthand86', 'lee117', 'khushali', 'surajmodi', 'lmendez2', 'red6290', 'a2104707', 'kadakiy1', 'hchao2', 'nmisak', 'hazypensieve', 'dferrell68', 'hgao10', 'stephenyzc', 'yookwang285', 'morris57', 'vidhi', 'justinaechols', 'yao10', 'bulentaslan', 'siveo123', 'panlei616', 'astronaut1984', 'grace3050', 'tischer1']"
9,67,57,50,2,"['jonathan.shinsato', 'justinaechols']",54,"['fatema', 'last1004in', 'lht6050', 'izquier2', 'nasir93', 'aspanwar', 'johnslon', 'dimkin3', 'jdj0524', 'jongkook90', 'mkshim34', 'sanchezmarenghi', 'robins6876', 'yhs5928', 'lefthand86', 'khushali', 'seyeon625', 'ankita88', 'eringoldstraw', 'kaist1728', 'tlarldnd', 'farhan', 'nirmalgvr', 'brenda.bedeaux', 'marcozorzi', 'ingerslev', 'somaia_sylvia', 'arlevin', 'genius124', 'redwanhq', 'sweet711', 'ryanhannam', 'sangick3929', 'billyjames14', 'nrb722', 'newnovel3000', 'rajames29', 'kimis080', 'yookwang285', 'vidhi', 'gaurangbiomed', 'ksyu', 'chrozer', 'jatorbet1', 'duqrlrhemfma', 'bulentaslan', 'u8877', 'siveo123', 'win198978', 'mhg624', 'astronaut1984', 'tmina', 'rihene', 'florencendum']",48,"['carrieculp', 'khauf', 'bdnunes', 'kreed241', 'jwbowles', 'philly_d', 'mabreslow', 'jarrodcole', 'snappa', 'ragalva1', 'bluudhoundd', 'john_hess_asu', 'mosfetology101', 'dchoux2', 'nlt2836', 'rylax2389', 'martinsolis1', 'sierrah2009', 'kslawlor', 'bpaulso1', 'jasonhulme', 'ijacobso', 'r.welker', 'justin.echols', 'jonathanshinsato', 'radlad', 'memo1108', 'tim.house2', 'amontes', 'breenok', 'beekman1', 'davidwiley', 'ferry', 'nehalem650', 'mqgabriel', 'gunangel', 'ishtayer', None, 'tjday', 'screwdriver631', 'nheinric1', 'alajevar', 'sdenke', 'racoonrick', 'bprudhom', 'emartan227', 'treblitz', 'jakepage']",104,"['carrieculp', 'khauf', 'izquier2', 'nasir93', 'mabreslow', 'jdj0524', 'snappa', 'jongkook90', 'bluudhoundd', 'seyeon625', 'nlt2836', 'rylax2389', 'martinsolis1', 'tlarldnd', 'nirmalgvr', 'bpaulso1', 'ijacobso', 'brenda.bedeaux', 'radlad', 'marcozorzi', 'memo1108', 'ingerslev', 'tim.house2', 'amontes', 'arlevin', 'beekman1', 'genius124', 'sweet711', 'ryanhannam', 'ferry', 'mqgabriel', 'billyjames14', 'nrb722', 'newnovel3000', 'rajames29', 'kimis080', 'gunangel', 'tjday', 'nheinric1', 'gaurangbiomed', 'alajevar', 'ksyu', 'chrozer', 'duqrlrhemfma', 'win198978', 'treblitz', 'mhg624', 'yhs5928', 'rihene', 'jakepage', 'fatema', 'last1004in', 'lht6050', 'bdnunes', 'kreed241', 'jwbowles', 'philly_d', 'aspanwar', 'johnslon', 'jarrodcole', 'dimkin3', 'ragalva1', 'mkshim34', 'sanchezmarenghi', 'robins6876', 'john_hess_asu', 'lefthand86', 'khushali', 'mosfetology101', 'dchoux2', 'ankita88', 'eringoldstraw', 'sierrah2009', 'kaist1728', 'kslawlor', 'farhan', 'jasonhulme', 'r.welker', 'justin.echols', 'jonathanshinsato', 'somaia_sylvia', 'breenok', 'redwanhq', 'davidwiley', 'nehalem650', 'sangick3929', 'yookwang285', 'ishtayer', None, 'vidhi', 'jonathan.shinsato', 'screwdriver631', 'sdenke', 'racoonrick', 'jatorbet1', 'justinaechols', 'bulentaslan', 'u8877', 'bprudhom', 'siveo123', 'emartan227', 'astronaut1984', 'tmina', 'florencendum']"
9,70,57,48,1,['izquier2'],55,"['fatema', 'last1004in', 'lht6050', 'nasir93', 'aspanwar', 'johnslon', 'dimkin3', 'jdj0524', 'jongkook90', 'mkshim34', 'sanchezmarenghi', 'robins6876', 'yhs5928', 'lefthand86', 'khushali', 'seyeon625', 'ankita88', 'eringoldstraw', 'kaist1728', 'tlarldnd', 'farhan', 'nirmalgvr', 'brenda.bedeaux', 'marcozorzi', 'ingerslev', 'somaia_sylvia', 'arlevin', 'genius124', 'redwanhq', 'sweet711', 'ryanhannam', 'sangick3929', 'billyjames14', 'nrb722', 'newnovel3000', 'rajames29', 'kimis080', 'yookwang285', 'vidhi', 'jonathan.shinsato', 'gaurangbiomed', 'ksyu', 'chrozer', 'jatorbet1', 'duqrlrhemfma', 'justinaechols', 'bulentaslan', 'u8877', 'siveo123', 'win198978', 'mhg624', 'astronaut1984', 'tmina', 'rihene', 'florencendum']",47,"['powerplayer7', 'ekapin2', 'xiaoyr068', 'lefkowi1', 'yuanweih', 'geschreyr', 'ddanielw', 'zoboomafoo', 'bhchen2', 'mraval', 'sunjialin', 'gobias', 'emma', 'geethabijjam', 'foxytop', 'brittovivek', 'ludao822', 'esanch29', 'jkim331', 'griffi21', 'bony', 'feng12', 'btanabe2', 'heebidiwup', 'boertew1', 'gavinwinkel', 'gloger', 'sabio00', 'lupas2', 'mattycat9000', None, 'devharlalka', 'wdyarthas', 'alex81388', 'weber36', 'deasey1', 'wang183', 'hatfarm', 'jtlust3', 'omghaxcode', 'tchajed', 'zhang291', 'hardy6', 'stuber1', 'tischer1', 'trovill1', 'cernaus1']",103,"['izquier2', 'nasir93', 'ekapin2', 'jdj0524', 'lefkowi1', 'jongkook90', 'yuanweih', 'geschreyr', 'zoboomafoo', 'bhchen2', 'mraval', 'seyeon625', 'sunjialin', 'gobias', 'emma', 'foxytop', 'tlarldnd', 'brittovivek', 'nirmalgvr', 'esanch29', 'bony', 'brenda.bedeaux', 'marcozorzi', 'ingerslev', 'arlevin', 'boertew1', 'genius124', 'sweet711', 'ryanhannam', 'sabio00', 'billyjames14', 'nrb722', 'newnovel3000', 'rajames29', 'kimis080', 'lupas2', 'alex81388', 'gaurangbiomed', 'weber36', 'deasey1', 'ksyu', 'chrozer', 'duqrlrhemfma', 'wang183', 'jtlust3', 'omghaxcode', 'tchajed', 'win198978', 'hardy6', 'mhg624', 'yhs5928', 'tischer1', 'stuber1', 'rihene', 'trovill1', 'cernaus1', 'fatema', 'last1004in', 'lht6050', 'powerplayer7', 'aspanwar', 'johnslon', 'xiaoyr068', 'dimkin3', 'mkshim34', 'sanchezmarenghi', 'robins6876', 'ddanielw', 'lefthand86', 'khushali', 'ankita88', 'eringoldstraw', 'geethabijjam', 'kaist1728', 'farhan', 'ludao822', 'griffi21', 'jkim331', 'feng12', 'btanabe2', 'somaia_sylvia', 'heebidiwup', 'gavinwinkel', 'redwanhq', 'gloger', 'sangick3929', 'mattycat9000', 'yookwang285', None, 'devharlalka', 'vidhi', 'wdyarthas', 'jonathan.shinsato', 'jatorbet1', 'justinaechols', 'hatfarm', 'bulentaslan', 'u8877', 'zhang291', 'siveo123', 'astronaut1984', 'tmina', 'florencendum']"
9,71,57,30,3,"['nrb722', 'brenda.bedeaux', 'siveo123']",53,"['fatema', 'last1004in', 'lht6050', 'izquier2', 'nasir93', 'aspanwar', 'johnslon', 'dimkin3', 'jdj0524', 'jongkook90', 'mkshim34', 'sanchezmarenghi', 'robins6876', 'yhs5928', 'lefthand86', 'khushali', 'seyeon625', 'ankita88', 'eringoldstraw', 'kaist1728', 'tlarldnd', 'farhan', 'nirmalgvr', 'marcozorzi', 'ingerslev', 'somaia_sylvia', 'arlevin', 'genius124', 'redwanhq', 'sweet711', 'ryanhannam', 'sangick3929', 'billyjames14', 'newnovel3000', 'rajames29', 'kimis080', 'yookwang285', 'vidhi', 'jonathan.shinsato', 'gaurangbiomed', 'ksyu', 'chrozer', 'jatorbet1', 'duqrlrhemfma', 'justinaechols', 'bulentaslan', 'u8877', 'win198978', 'mhg624', 'astronaut1984', 'tmina', 'rihene', 'florencendum']",27,"['gazdzia1', 'cwjohnson', 'swallerick', 'eder0020', 'bector1', 'arvman', 'aflocchini', 'dereknowacki1', 'toblerone16', '11018499jd', 'donner1', 'dynamicdoyle', 'aashay1991', 'jeffwebber808', 'psmisek07', None, 'walter9', 'amnueyp1', 'rmeekin11', 'theerasit', 'mersch', 'mikeystarr', 'yuan11', 'toddlienemann', 'capissen', 'tomn7201', 'jmarti']",83,"['izquier2', 'nasir93', 'swallerick', 'jdj0524', 'jongkook90', 'aflocchini', 'seyeon625', 'tlarldnd', 'toblerone16', '11018499jd', 'nirmalgvr', 'brenda.bedeaux', 'donner1', 'marcozorzi', 'ingerslev', 'dynamicdoyle', 'aashay1991', 'arlevin', 'genius124', 'sweet711', 'ryanhannam', 'billyjames14', 'nrb722', 'newnovel3000', 'rajames29', 'kimis080', 'amnueyp1', 'rmeekin11', 'gaurangbiomed', 'theerasit', 'mersch', 'ksyu', 'chrozer', 'duqrlrhemfma', 'yuan11', 'toddlienemann', 'capissen', 'win198978', 'tomn7201', 'mhg624', 'yhs5928', 'rihene', 'fatema', 'last1004in', 'lht6050', 'gazdzia1', 'cwjohnson', 'eder0020', 'aspanwar', 'johnslon', 'bector1', 'arvman', 'dimkin3', 'mkshim34', 'sanchezmarenghi', 'robins6876', 'lefthand86', 'khushali', 'dereknowacki1', 'ankita88', 'eringoldstraw', 'kaist1728', 'farhan', 'somaia_sylvia', 'redwanhq', 'sangick3929', 'jeffwebber808', 'psmisek07', 'yookwang285', None, 'walter9', 'vidhi', 'jonathan.shinsato', 'mikeystarr', 'jatorbet1', 'justinaechols', 'bulentaslan', 'u8877', 'siveo123', 'jmarti', 'astronaut1984', 'tmina', 'florencendum']"
9,72,57,26,1,['mhg624'],55,"['fatema', 'last1004in', 'lht6050', 'izquier2', 'nasir93', 'aspanwar', 'johnslon', 'dimkin3', 'jdj0524', 'jongkook90', 'mkshim34', 'sanchezmarenghi', 'robins6876', 'lefthand86', 'khushali', 'seyeon625', 'ankita88', 'eringoldstraw', 'kaist1728', 'tlarldnd', 'farhan', 'nirmalgvr', 'brenda.bedeaux', 'marcozorzi', 'ingerslev', 'somaia_sylvia', 'arlevin', 'genius124', 'redwanhq', 'sweet711', 'ryanhannam', 'sangick3929', 'billyjames14', 'nrb722', 'newnovel3000', 'rajames29', 'kimis080', 'yookwang285', 'vidhi', 'jonathan.shinsato', 'gaurangbiomed', 'ksyu', 'chrozer', 'jatorbet1', 'duqrlrhemfma', 'justinaechols', 'bulentaslan', 'u8877', 'siveo123', 'win198978', 'yhs5928', 'astronaut1984', 'tmina', 'rihene', 'florencendum']",25,"['chan32', 'crosscounter87', 'cpatchava', 'case7', 'roloscool', 'kgiacobazzi', 'wente1', 'qliu9', 'mrwilsonsaid', 't14', 'jielv1', 'fandi514', 'greenwa1', 'edavilax', 'ryandwyer91', 'handa1', 'swarley', 'mroczek1', 'dahlke2', 'novawater', 'snanav3', 'dicksonsalim', None, 'chrisgoulet', 'lobert124']",81,"['izquier2', 'nasir93', 'chan32', 'cpatchava', 'case7', 'chrisgoulet', 'jdj0524', 'jongkook90', 'kgiacobazzi', 'seyeon625', 'tlarldnd', 'jielv1', 'nirmalgvr', 'brenda.bedeaux', 'marcozorzi', 'ryandwyer91', 'ingerslev', 'handa1', 'arlevin', 'genius124', 'sweet711', 'ryanhannam', 'billyjames14', 'nrb722', 'snanav3', 'newnovel3000', 'rajames29', 'kimis080', 'gaurangbiomed', 'ksyu', 'chrozer', 'duqrlrhemfma', 'win198978', 'mhg624', 'yhs5928', 'rihene', 'lobert124', 'fatema', 'last1004in', 'lht6050', 'aspanwar', 'johnslon', 'roloscool', 'crosscounter87', 'dimkin3', 'mkshim34', 'sanchezmarenghi', 'robins6876', 'lefthand86', 'khushali', 'wente1', 'ankita88', 'qliu9', 'eringoldstraw', 'mrwilsonsaid', 'kaist1728', 't14', 'farhan', 'fandi514', 'greenwa1', 'edavilax', 'somaia_sylvia', 'swarley', 'mroczek1', 'redwanhq', 'dahlke2', 'sangick3929', 'novawater', 'dicksonsalim', 'yookwang285', None, 'vidhi', 'jonathan.shinsato', 'jatorbet1', 'justinaechols', 'bulentaslan', 'u8877', 'siveo123', 'astronaut1984', 'tmina', 'florencendum']"
9,75,57,16,13,"['lefthand86', 'last1004in', 'jongkook90', 'lht6050', 'seyeon625', 'redwanhq', 'kaist1728', 'sangick3929', 'tlarldnd', 'newnovel3000', 'yookwang285', 'jdj0524', 'mkshim34']",43,"['fatema', 'izquier2', 'nasir93', 'aspanwar', 'johnslon', 'dimkin3', 'sanchezmarenghi', 'robins6876', 'yhs5928', 'khushali', 'ankita88', 'eringoldstraw', 'farhan', 'nirmalgvr', 'brenda.bedeaux', 'marcozorzi', 'ingerslev', 'somaia_sylvia', 'arlevin', 'genius124', 'sweet711', 'ryanhannam', 'billyjames14', 'nrb722', 'rajames29', 'kimis080', 'vidhi', 'jonathan.shinsato', 'gaurangbiomed', 'ksyu', 'chrozer', 'jatorbet1', 'duqrlrhemfma', 'justinaechols', 'bulentaslan', 'u8877', 'siveo123', 'win198978', 'mhg624', 'astronaut1984', 'tmina', 'rihene', 'florencendum']",3,"['bdsfh0820', None, 'whktmddn']",59,"['fatema', 'last1004in', 'lht6050', 'whktmddn', 'bdsfh0820', 'izquier2', 'nasir93', 'aspanwar', 'johnslon', 'jdj0524', 'dimkin3', 'mkshim34', 'jongkook90', 'sanchezmarenghi', 'robins6876', 'lefthand86', 'khushali', 'seyeon625', 'ankita88', 'eringoldstraw', 'kaist1728', 'tlarldnd', 'farhan', 'nirmalgvr', 'brenda.bedeaux', 'marcozorzi', 'ingerslev', 'somaia_sylvia', 'arlevin', 'genius124', 'redwanhq', 'sweet711', 'ryanhannam', 'sangick3929', 'billyjames14', 'nrb722', 'newnovel3000', 'rajames29', 'kimis080', 'yookwang285', None, 'vidhi', 'mhg624', 'jonathan.shinsato', 'gaurangbiomed', 'ksyu', 'chrozer', 'jatorbet1', 'duqrlrhemfma', 'justinaechols', 'bulentaslan', 'u8877', 'siveo123', 'win198978', 'yhs5928', 'astronaut1984', 'tmina', 'rihene', 'florencendum']"
9,246,57,13,3,"['ankita88', 'rihene', 'gaurangbiomed']",53,"['fatema', 'last1004in', 'lht6050', 'izquier2', 'nasir93', 'aspanwar', 'johnslon', 'jdj0524', 'dimkin3', 'mkshim34', 'jongkook90', 'sanchezmarenghi', 'robins6876', 'lefthand86', 'khushali', 'seyeon625', 'eringoldstraw', 'kaist1728', 'tlarldnd', 'farhan', 'nirmalgvr', 'brenda.bedeaux', 'marcozorzi', 'ingerslev', 'somaia_sylvia', 'arlevin', 'genius124', 'redwanhq', 'sweet711', 'ryanhannam', 'sangick3929', 'billyjames14', 'nrb722', 'newnovel3000', 'rajames29', 'kimis080', 'yookwang285', 'vidhi', 'mhg624', 'jonathan.shinsato', 'ksyu', 'chrozer', 'jatorbet1', 'duqrlrhemfma', 'justinaechols', 'bulentaslan', 'u8877', 'siveo123', 'win198978', 'yhs5928', 'astronaut1984', 'tmina', 'florencendum']",10,"['nikhilgangan19', 'ajitjdv', 'jeet250', 'harsh', 'vaibhav19', 'biomedjv', 'bhavin', 'aditipoorna', 'biomems', None]",66,"['fatema', 'last1004in', 'lht6050', 'ajitjdv', 'izquier2', 'jeet250', 'nasir93', 'aspanwar', 'johnslon', 'biomedjv', 'bhavin', 'jdj0524', 'dimkin3', 'mkshim34', 'jongkook90', 'sanchezmarenghi', 'robins6876', 'lefthand86', 'khushali', 'seyeon625', 'harsh', 'ankita88', 'eringoldstraw', 'kaist1728', 'tlarldnd', 'farhan', 'biomems', 'aditipoorna', 'nirmalgvr', 'brenda.bedeaux', 'marcozorzi', 'ingerslev', 'somaia_sylvia', 'arlevin', 'genius124', 'redwanhq', 'sweet711', 'ryanhannam', 'vaibhav19', 'sangick3929', 'billyjames14', 'nrb722', 'newnovel3000', 'rajames29', 'kimis080', 'yookwang285', None, 'vidhi', 'mhg624', 'jonathan.shinsato', 'gaurangbiomed', 'nikhilgangan19', 'ksyu', 'chrozer', 'jatorbet1', 'duqrlrhemfma', 'justinaechols', 'bulentaslan', 'u8877', 'siveo123', 'win198978', 'yhs5928', 'astronaut1984', 'tmina', 'rihene', 'florencendum']"
9,74,57,11,6,"['fatema', 'khushali', 'gaurangbiomed', 'ankita88', 'rihene', 'vidhi']",50,"['last1004in', 'lht6050', 'izquier2', 'nasir93', 'aspanwar', 'johnslon', 'jdj0524', 'dimkin3', 'mkshim34', 'jongkook90', 'sanchezmarenghi', 'robins6876', 'lefthand86', 'seyeon625', 'eringoldstraw', 'kaist1728', 'tlarldnd', 'farhan', 'nirmalgvr', 'brenda.bedeaux', 'marcozorzi', 'ingerslev', 'somaia_sylvia', 'arlevin', 'genius124', 'redwanhq', 'sweet711', 'ryanhannam', 'sangick3929', 'billyjames14', 'nrb722', 'newnovel3000', 'rajames29', 'kimis080', 'yookwang285', 'mhg624', 'jonathan.shinsato', 'ksyu', 'chrozer', 'jatorbet1', 'duqrlrhemfma', 'justinaechols', 'bulentaslan', 'u8877', 'siveo123', 'win198978', 'yhs5928', 'astronaut1984', 'tmina', 'florencendum']",5,"['nikhilgangan19', 'vaibhav19', 'biomedjv', 'aditipoorna', None]",61,"['fatema', 'last1004in', 'lht6050', 'izquier2', 'nasir93', 'aspanwar', 'johnslon', 'biomedjv', 'jdj0524', 'dimkin3', 'mkshim34', 'jongkook90', 'sanchezmarenghi', 'robins6876', 'lefthand86', 'khushali', 'seyeon625', 'ankita88', 'eringoldstraw', 'kaist1728', 'tlarldnd', 'farhan', 'aditipoorna', 'nirmalgvr', 'brenda.bedeaux', 'marcozorzi', 'ingerslev', 'somaia_sylvia', 'arlevin', 'genius124', 'redwanhq', 'sweet711', 'ryanhannam', 'vaibhav19', 'sangick3929', 'billyjames14', 'nrb722', 'newnovel3000', 'rajames29', 'kimis080', 'yookwang285', None, 'vidhi', 'mhg624', 'jonathan.shinsato', 'gaurangbiomed', 'nikhilgangan19', 'ksyu', 'chrozer', 'jatorbet1', 'duqrlrhemfma', 'justinaechols', 'bulentaslan', 'u8877', 'siveo123', 'win198978', 'yhs5928', 'astronaut1984', 'tmina', 'rihene', 'florencendum']"
9,76,57,9,6,"['seyeon625', 'genius124', 'duqrlrhemfma', 'win198978', 'kimis080', 'jdj0524']",50,"['fatema', 'last1004in', 'lht6050', 'izquier2', 'nasir93', 'aspanwar', 'johnslon', 'dimkin3', 'mkshim34', 'jongkook90', 'sanchezmarenghi', 'robins6876', 'lefthand86', 'khushali', 'ankita88', 'eringoldstraw', 'kaist1728', 'tlarldnd', 'farhan', 'nirmalgvr', 'brenda.bedeaux', 'marcozorzi', 'ingerslev', 'somaia_sylvia', 'arlevin', 'redwanhq', 'sweet711', 'ryanhannam', 'sangick3929', 'billyjames14', 'nrb722', 'newnovel3000', 'rajames29', 'yookwang285', 'vidhi', 'mhg624', 'jonathan.shinsato', 'gaurangbiomed', 'ksyu', 'chrozer', 'jatorbet1', 'justinaechols', 'bulentaslan', 'u8877', 'siveo123', 'yhs5928', 'astronaut1984', 'tmina', 'rihene', 'florencendum']",3,"[None, 'kkt87', 'indiandh']",59,"['fatema', 'last1004in', 'lht6050', 'izquier2', 'nasir93', 'kkt87', 'aspanwar', 'johnslon', 'jdj0524', 'dimkin3', 'mkshim34', 'jongkook90', 'sanchezmarenghi', 'robins6876', 'lefthand86', 'khushali', 'seyeon625', 'ankita88', 'eringoldstraw', 'kaist1728', 'tlarldnd', 'farhan', 'indiandh', 'nirmalgvr', 'brenda.bedeaux', 'marcozorzi', 'ingerslev', 'somaia_sylvia', 'arlevin', 'genius124', 'redwanhq', 'sweet711', 'ryanhannam', 'sangick3929', 'billyjames14', 'nrb722', 'newnovel3000', 'rajames29', 'kimis080', 'yookwang285', None, 'vidhi', 'mhg624', 'jonathan.shinsato', 'gaurangbiomed', 'ksyu', 'chrozer', 'jatorbet1', 'duqrlrhemfma', 'justinaechols', 'bulentaslan', 'u8877', 'siveo123', 'win198978', 'yhs5928', 'astronaut1984', 'tmina', 'rihene', 'florencendum']"
9,247,57,8,1,['rihene'],55,"['fatema', 'last1004in', 'lht6050', 'izquier2', 'nasir93', 'aspanwar', 'johnslon', 'jdj0524', 'dimkin3', 'mkshim34', 'jongkook90', 'sanchezmarenghi', 'robins6876', 'lefthand86', 'khushali', 'seyeon625', 'ankita88', 'eringoldstraw', 'kaist1728', 'tlarldnd', 'farhan', 'nirmalgvr', 'brenda.bedeaux', 'marcozorzi', 'ingerslev', 'somaia_sylvia', 'arlevin', 'genius124', 'redwanhq', 'sweet711', 'ryanhannam', 'sangick3929', 'billyjames14', 'nrb722', 'newnovel3000', 'rajames29', 'kimis080', 'yookwang285', 'vidhi', 'mhg624', 'jonathan.shinsato', 'gaurangbiomed', 'ksyu', 'chrozer', 'jatorbet1', 'duqrlrhemfma', 'justinaechols', 'bulentaslan', 'u8877', 'siveo123', 'win198978', 'yhs5928', 'astronaut1984', 'tmina', 'florencendum']",7,"['ajitjdv', 'harsh', 'vaibhav19', 'biomems', 'bhavin', 'aditipoorna', None]",63,"['fatema', 'last1004in', 'lht6050', 'ajitjdv', 'izquier2', 'nasir93', 'aspanwar', 'johnslon', 'bhavin', 'jdj0524', 'dimkin3', 'mkshim34', 'jongkook90', 'sanchezmarenghi', 'robins6876', 'lefthand86', 'khushali', 'seyeon625', 'harsh', 'ankita88', 'eringoldstraw', 'kaist1728', 'tlarldnd', 'farhan', 'biomems', 'aditipoorna', 'nirmalgvr', 'brenda.bedeaux', 'marcozorzi', 'ingerslev', 'somaia_sylvia', 'arlevin', 'genius124', 'redwanhq', 'sweet711', 'ryanhannam', 'vaibhav19', 'sangick3929', 'billyjames14', 'nrb722', 'newnovel3000', 'rajames29', 'kimis080', 'yookwang285', None, 'vidhi', 'mhg624', 'jonathan.shinsato', 'gaurangbiomed', 'ksyu', 'chrozer', 'jatorbet1', 'duqrlrhemfma', 'justinaechols', 'bulentaslan', 'u8877', 'siveo123', 'win198978', 'yhs5928', 'astronaut1984', 'tmina', 'rihene', 'florencendum']"
10,69,53,118,1,['baker48'],51,"['rubicon777', 'cinkilic2804', 'hellomancn', 'cshaffre', 'madhubawankar', 'jill_freeland', 'ncorral2', 'thawley', 'sosany', 'kennethom1', 'cwkimbrough', 'benabdelmoumene', 'carlosatkins', 'tbatth', 'fconde', 'parks8', 'angelicahz', 'daveleon', 'sekchinn', 'ediaz', 'shanmich10', 'hodgesprodges', 'kdorsain', 'lucianbarbut', 'rmclinch', 'aminenko', 'duwen', 'elockett', 'bmanolo', 'jakedubya', 'cbrown25', 'dpleasan', 'stifkaya', 'sorubin2', 'ryanledbetter135', 'pgmalejandro', 'balavinayagam', 'orebeca', 'nimrod.gazit', 'lau_cinvest', 'sergegtr', 'andresvarela', 'carlthefuzzy1', 'fsflack', 'almaarreola', 'mohok_hugo', 'badger1', 'chen425', 'itzam', 'ansehyuk', 'tcopelan']",117,"['dhuang123', 'nookala', 'dwass', 'izquier2', 'moon1002', 'b3nny312', 'hua5', 'fredhdx', 'redyoshi49q', 'lshi14', 'shawkat', 'bradsnyder', 'johns149', 'muneebahmed95', 'sherrypri', 'hronik1', 'sfanou2', 'siwin2', 'sutchaya', 'vargas3', 'kumikknd', 'neilchristanto', 'yuan11', 'shawnwin1234', 'daybreak410039', 'ewalt1', 'banerje1', 'coolcrew', 'trovill1', 'chen338', 'hartant2', 'jiwonp224', 'hoang4', 'reebbhaa', 'profballack', 'alostu3', 'nanotie', 'chenhu1', 'malik15', 'madigan5', 'alabi2', 'ravitheja22', 'supermeatboy', 'ericwoo1', 'feng12', 'mikenike', 'jclift3', 'heebidiwup', 'yjaquinas', 'lidazhu1', 'menghuang', 'rushx1', 'wlee26', 'broll1', 'lu30', None, 'qiu12', 'zhangyj', 'wanchoi1', 'luiszelaya', 'spadin1', 'keating7', 'blee51', 'maxcan', 'leiche1', 'achavarria', 'samuelzhang', 'mahed', 'jashari1', 'mintzo', 'ouyang4', 'tatuhiro', 'pashea1', 'zulueta1', 'shapir11', 'kwak27', 'echegil1', 'donner1', 'nam18', 'vigneshka', 'jyao5', 'jksikai', 'szhang51', 'mim1c', 'jataput1', 'jayfurrie', 'miketeufel1', 'sgrand2', 'mikeudelhofen', 'dinger104', 'mihrenoe', 'aczerepak', 'stuber1', 'kandel3', 'williamhn', 'ahoboke', 'liyd', 'monnett1', 'ltompki2', 'lee117', 'surajmodi', 'lmendez2', 'red6290', 'a2104707', 'kadakiy1', 'hchao2', 'nmisak', 'hazypensieve', 'dferrell68', 'hgao10', 'stephenyzc', 'morris57', 'yao10', 'panlei616', 'jefflale', 'grace3050', 'tischer1']",169,"['dhuang123', 'nookala', 'hellomancn', 'dwass', 'izquier2', 'madhubawankar', 'sosany', 'moon1002', 'b3nny312', 'hua5', 'fredhdx', 'ediaz', 'redyoshi49q', 'lshi14', 'shawkat', 'bradsnyder', 'johns149', 'muneebahmed95', 'sherrypri', 'hronik1', 'sorubin2', 'pgmalejandro', 'balavinayagam', 'sfanou2', 'siwin2', 'sutchaya', 'lau_cinvest', 'vargas3', 'kumikknd', 'neilchristanto', 'yuan11', 'shawnwin1234', 'daybreak410039', 'ewalt1', 'baker48', 'coolcrew', 'banerje1', 'itzam', 'trovill1', 'chen338', 'hartant2', 'jiwonp224', 'hoang4', 'jill_freeland', 'reebbhaa', 'ncorral2', 'thawley', 'profballack', 'alostu3', 'nanotie', 'cwkimbrough', 'chenhu1', 'malik15', 'angelicahz', 'sekchinn', 'madigan5', 'hodgesprodges', 'alabi2', 'ravitheja22', 'kdorsain', 'supermeatboy', 'rmclinch', 'ericwoo1', 'feng12', 'mikenike', 'jclift3', 'heebidiwup', 'yjaquinas', 'lidazhu1', 'menghuang', 'rushx1', 'wlee26', 'broll1', 'lu30', None, 'qiu12', 'zhangyj', 'wanchoi1', 'luiszelaya', 'spadin1', 'keating7', 'blee51', 'badger1', 'chen425', 'maxcan', 'leiche1', 'achavarria', 'samuelzhang', 'cinkilic2804', 'mahed', 'jashari1', 'mintzo', 'ouyang4', 'kennethom1', 'tatuhiro', 'pashea1', 'zulueta1', 'carlosatkins', 'tbatth', 'shapir11', 'parks8', 'kwak27', 'daveleon', 'echegil1', 'donner1', 'nam18', 'vigneshka', 'jyao5', 'jksikai', 'szhang51', 'mim1c', 'jataput1', 'bmanolo', 'jayfurrie', 'dpleasan', 'miketeufel1', 'sgrand2', 'ryanledbetter135', 'mikeudelhofen', 'dinger104', 'mihrenoe', 'nimrod.gazit', 'almaarreola', 'fsflack', 'aczerepak', 'stuber1', 'tcopelan', 'kandel3', 'rubicon777', 'williamhn', 'cshaffre', 'ahoboke', 'liyd', 'monnett1', 'benabdelmoumene', 'ltompki2', 'lee117', 'fconde', 'surajmodi', 'lmendez2', 'shanmich10', 'lucianbarbut', 'red6290', 'a2104707', 'aminenko', 'duwen', 'elockett', 'cbrown25', 'jakedubya', 'kadakiy1', 'hchao2', 'nmisak', 'hazypensieve', 'dferrell68', 'hgao10', 'stephenyzc', 'stifkaya', 'morris57', 'orebeca', 'sergegtr', 'yao10', 'andresvarela', 'carlthefuzzy1', 'mohok_hugo', 'panlei616', 'jefflale', 'grace3050', 'tischer1', 'ansehyuk']"
10,150,53,116,1,['aminenko'],51,"['rubicon777', 'cinkilic2804', 'hellomancn', 'cshaffre', 'madhubawankar', 'jill_freeland', 'ncorral2', 'thawley', 'sosany', 'kennethom1', 'cwkimbrough', 'benabdelmoumene', 'carlosatkins', 'tbatth', 'fconde', 'parks8', 'angelicahz', 'daveleon', 'sekchinn', 'ediaz', 'shanmich10', 'hodgesprodges', 'kdorsain', 'lucianbarbut', 'rmclinch', 'duwen', 'elockett', 'bmanolo', 'jakedubya', 'cbrown25', 'dpleasan', 'stifkaya', 'sorubin2', 'ryanledbetter135', 'pgmalejandro', 'balavinayagam', 'orebeca', 'nimrod.gazit', 'lau_cinvest', 'sergegtr', 'andresvarela', 'carlthefuzzy1', 'fsflack', 'almaarreola', 'mohok_hugo', 'baker48', 'chen425', 'badger1', 'itzam', 'ansehyuk', 'tcopelan']",115,"['dhuang123', 'nookala', 'bae10', 'lucasmac37', 'parsoj', 'chan32', 'moon1002', 'case7', 'melurie03', 'b3nny312', 'oknoel', 'sunjialin', 'fredhdx', 'shawkat', 'johns149', 'muneebahmed95', 'boertew1', 'snanav3', 'jkinne2', 'sfanou2', 'siwin2', 'sutchaya', 'deasey1', 'neilchristanto', 'kumikknd', 'wang183', 'shawnwin1234', 'daybreak410039', 'banerje1', 'tischer1', 'maddali1', 'cernaus1', 'hartant2', 'jiwonp224', 'hoang4', 'profballack', 'gong10', 'alostu3', 'nanotie', 'malik15', 'supermeatboy', 'ericwoo1', 'feng12', 'mikenike', 'jclift3', 'yjaquinas', 'lidazhu1', 'menghuang', 'novawater', 'wlee26', 'ssingh18', None, 'qiu12', 'wanchoi1', 'spadin1', 'luiszelaya', 'keating7', 'zhang291', 'blee51', 'maxcan', 'leiche1', 'achavarria', 'mahed', 'congshan', 'weberxzq', 'pashea1', 'yuanweih', 'shapir11', 'kwak27', 'zeqiuwu1', 'emma', 'foxytop', 'jielv1', 'okekeoc1', 'bony', 'nam18', 'moy21', 'szhang51', 'jataput1', 'miketeufel1', 'lupas2', 'kilpatr2', 'sgrand2', 'wang227', 'mihrenoe', 'theerasit', 'jtlust3', 'tchajed', 'hardy6', 'stuber1', 'kim563', 'gazdzia1', 'liyd', 'bector1', 'yun19', 'lee117', 'jain53', 'ludao822', 'btanabe2', 'hasken1', 'hchao2', 'nmisak', 'hazypensieve', 'ysun12', '8kobe24', 'stephenyzc', 'genome852', 'morris57', 'devharlalka', 'ucapssong', 'tsai11', 'uasyed2', 'panlei616', 'jefflale', 'mraval']",167,"['dhuang123', 'nookala', 'hellomancn', 'bae10', 'madhubawankar', 'lucasmac37', 'parsoj', 'sosany', 'chan32', 'case7', 'moon1002', 'melurie03', 'b3nny312', 'oknoel', 'sunjialin', 'fredhdx', 'ediaz', 'shawkat', 'johns149', 'muneebahmed95', 'boertew1', 'snanav3', 'sorubin2', 'jkinne2', 'pgmalejandro', 'balavinayagam', 'sfanou2', 'siwin2', 'sutchaya', 'lau_cinvest', 'deasey1', 'neilchristanto', 'kumikknd', 'wang183', 'shawnwin1234', 'daybreak410039', 'baker48', 'banerje1', 'tischer1', 'itzam', 'maddali1', 'cernaus1', 'hartant2', 'jiwonp224', 'hoang4', 'jill_freeland', 'profballack', 'ncorral2', 'thawley', 'gong10', 'alostu3', 'nanotie', 'cwkimbrough', 'malik15', 'angelicahz', 'sekchinn', 'hodgesprodges', 'kdorsain', 'supermeatboy', 'rmclinch', 'ericwoo1', 'feng12', 'mikenike', 'jclift3', 'yjaquinas', 'lidazhu1', 'menghuang', 'novawater', 'wlee26', 'ssingh18', None, 'qiu12', 'wanchoi1', 'spadin1', 'luiszelaya', 'keating7', 'zhang291', 'blee51', 'badger1', 'chen425', 'maxcan', 'leiche1', 'achavarria', 'cinkilic2804', 'mahed', 'congshan', 'weberxzq', 'kennethom1', 'pashea1', 'yuanweih', 'carlosatkins', 'tbatth', 'shapir11', 'parks8', 'kwak27', 'zeqiuwu1', 'daveleon', 'emma', 'foxytop', 'jielv1', 'okekeoc1', 'bony', 'nam18', 'moy21', 'szhang51', 'jataput1', 'bmanolo', 'dpleasan', 'miketeufel1', 'lupas2', 'kilpatr2', 'sgrand2', 'ryanledbetter135', 'wang227', 'mihrenoe', 'nimrod.gazit', 'theerasit', 'jtlust3', 'tchajed', 'almaarreola', 'fsflack', 'hardy6', 'stuber1', 'kim563', 'tcopelan', 'rubicon777', 'gazdzia1', 'cshaffre', 'liyd', 'bector1', 'benabdelmoumene', 'yun19', 'lee117', 'fconde', 'jain53', 'shanmich10', 'ludao822', 'lucianbarbut', 'aminenko', 'duwen', 'btanabe2', 'hasken1', 'elockett', 'cbrown25', 'jakedubya', 'hchao2', 'nmisak', 'hazypensieve', 'ysun12', '8kobe24', 'stephenyzc', 'genome852', 'stifkaya', 'morris57', 'devharlalka', 'orebeca', 'ucapssong', 'tsai11', 'sergegtr', 'andresvarela', 'uasyed2', 'carlthefuzzy1', 'mohok_hugo', 'panlei616', 'jefflale', 'mraval', 'ansehyuk']"
10,149,53,43,2,"['parks8', 'baker48']",50,"['rubicon777', 'cinkilic2804', 'hellomancn', 'cshaffre', 'madhubawankar', 'jill_freeland', 'ncorral2', 'thawley', 'sosany', 'kennethom1', 'cwkimbrough', 'benabdelmoumene', 'carlosatkins', 'tbatth', 'fconde', 'angelicahz', 'daveleon', 'sekchinn', 'ediaz', 'shanmich10', 'hodgesprodges', 'kdorsain', 'lucianbarbut', 'rmclinch', 'aminenko', 'duwen', 'elockett', 'bmanolo', 'jakedubya', 'cbrown25', 'dpleasan', 'stifkaya', 'sorubin2', 'ryanledbetter135', 'pgmalejandro', 'balavinayagam', 'orebeca', 'nimrod.gazit', 'lau_cinvest', 'sergegtr', 'andresvarela', 'carlthefuzzy1', 'fsflack', 'almaarreola', 'mohok_hugo', 'badger1', 'chen425', 'itzam', 'ansehyuk', 'tcopelan']",41,"['samuelzhang', 'powerplayer7', 'chan1cyrus2', 'williamhn', 'ekapin2', 'xiaoyr068', 'yuanweih', 'geschreyr', 'bhchen2', 'sunjialin', 'gobias', 'geethabijjam', 'madigan5', 'ludao822', 'jkim331', 'griffi21', 'esanch29', 'ericwoo1', 'greenwa1', 'kadakiy1', 'heebidiwup', 'gloger', 'mazzola1', 'tocirahl', 'pranavram', 'ssingh18', 'levitas1', None, 'wdyarthas', 'alex81388', 'weber36', 'theerasit', 'deasey1', 'lobert124', 'mayapati', 'wang183', 'hatfarm', 'jtlust3', 'zhang291', 'tsai11', 'trovill1']",93,"['samuelzhang', 'cinkilic2804', 'hellomancn', 'madhubawankar', 'ekapin2', 'sosany', 'kennethom1', 'yuanweih', 'geschreyr', 'carlosatkins', 'tbatth', 'bhchen2', 'parks8', 'sunjialin', 'gobias', 'daveleon', 'ediaz', 'esanch29', 'bmanolo', 'dpleasan', 'tocirahl', 'pranavram', 'sorubin2', 'ryanledbetter135', 'pgmalejandro', 'balavinayagam', 'alex81388', 'nimrod.gazit', 'lau_cinvest', 'weber36', 'theerasit', 'deasey1', 'wang183', 'jtlust3', 'almaarreola', 'fsflack', 'baker48', 'itzam', 'tcopelan', 'trovill1', 'rubicon777', 'lobert124', 'chan1cyrus2', 'powerplayer7', 'williamhn', 'cshaffre', 'jill_freeland', 'ncorral2', 'thawley', 'xiaoyr068', 'cwkimbrough', 'benabdelmoumene', 'angelicahz', 'fconde', 'sekchinn', 'geethabijjam', 'shanmich10', 'madigan5', 'hodgesprodges', 'ludao822', 'kdorsain', 'griffi21', 'lucianbarbut', 'rmclinch', 'jkim331', 'ericwoo1', 'greenwa1', 'aminenko', 'duwen', 'elockett', 'cbrown25', 'jakedubya', 'kadakiy1', 'heebidiwup', 'gloger', 'mazzola1', 'stifkaya', 'ssingh18', 'levitas1', None, 'orebeca', 'wdyarthas', 'mayapati', 'sergegtr', 'hatfarm', 'andresvarela', 'zhang291', 'carlthefuzzy1', 'badger1', 'mohok_hugo', 'chen425', 'tsai11', 'ansehyuk']"
10,91,53,35,1,['parks8'],51,"['rubicon777', 'cinkilic2804', 'hellomancn', 'cshaffre', 'madhubawankar', 'jill_freeland', 'ncorral2', 'thawley', 'sosany', 'kennethom1', 'cwkimbrough', 'benabdelmoumene', 'carlosatkins', 'tbatth', 'fconde', 'angelicahz', 'daveleon', 'sekchinn', 'ediaz', 'shanmich10', 'hodgesprodges', 'kdorsain', 'lucianbarbut', 'rmclinch', 'aminenko', 'duwen', 'elockett', 'bmanolo', 'jakedubya', 'cbrown25', 'dpleasan', 'stifkaya', 'sorubin2', 'ryanledbetter135', 'pgmalejandro', 'balavinayagam', 'orebeca', 'nimrod.gazit', 'lau_cinvest', 'sergegtr', 'andresvarela', 'carlthefuzzy1', 'fsflack', 'almaarreola', 'mohok_hugo', 'baker48', 'chen425', 'badger1', 'itzam', 'ansehyuk', 'tcopelan']",34,"['ekapin2', 'bector1', 'dongdong', 'ltompki2', 'nima_one', 'bhchen2', 'sunjialin', 'diliber1', 'geethabijjam', 'jeeves631', 'jkim331', 'mjy5', 'heebidiwup', 'nmisak', 'gavinwinkel', 'gloger', 'mazzola1', 'sherrypri', 'lupas2', 'mattycat9000', 'ssingh18', 'levitas1', None, 'wdyarthas', 'alex81388', 'mast5', 'weber36', 'deasey1', 'savankadakiya', 'hatfarm', 'tchajed', 'omghaxcode', 'hardy6', 'tsai11']",86,"['cinkilic2804', 'hellomancn', 'madhubawankar', 'ekapin2', 'sosany', 'kennethom1', 'dongdong', 'carlosatkins', 'nima_one', 'tbatth', 'bhchen2', 'parks8', 'sunjialin', 'daveleon', 'ediaz', 'bmanolo', 'dpleasan', 'sherrypri', 'lupas2', 'sorubin2', 'ryanledbetter135', 'pgmalejandro', 'balavinayagam', 'alex81388', 'nimrod.gazit', 'lau_cinvest', 'weber36', 'deasey1', 'savankadakiya', 'tchajed', 'omghaxcode', 'almaarreola', 'fsflack', 'baker48', 'hardy6', 'itzam', 'tcopelan', 'rubicon777', 'cshaffre', 'jill_freeland', 'ncorral2', 'thawley', 'bector1', 'cwkimbrough', 'benabdelmoumene', 'ltompki2', 'angelicahz', 'fconde', 'sekchinn', 'diliber1', 'shanmich10', 'geethabijjam', 'hodgesprodges', 'jeeves631', 'kdorsain', 'jkim331', 'lucianbarbut', 'rmclinch', 'mjy5', 'aminenko', 'duwen', 'elockett', 'cbrown25', 'jakedubya', 'heebidiwup', 'nmisak', 'gavinwinkel', 'gloger', 'mazzola1', 'stifkaya', 'mattycat9000', 'ssingh18', 'levitas1', None, 'orebeca', 'wdyarthas', 'mast5', 'sergegtr', 'hatfarm', 'andresvarela', 'carlthefuzzy1', 'badger1', 'mohok_hugo', 'chen425', 'tsai11', 'ansehyuk']"
10,93,53,34,1,['parks8'],51,"['rubicon777', 'cinkilic2804', 'hellomancn', 'cshaffre', 'madhubawankar', 'jill_freeland', 'ncorral2', 'thawley', 'sosany', 'kennethom1', 'cwkimbrough', 'benabdelmoumene', 'carlosatkins', 'tbatth', 'fconde', 'angelicahz', 'daveleon', 'sekchinn', 'ediaz', 'shanmich10', 'hodgesprodges', 'kdorsain', 'lucianbarbut', 'rmclinch', 'aminenko', 'duwen', 'elockett', 'bmanolo', 'jakedubya', 'cbrown25', 'dpleasan', 'stifkaya', 'sorubin2', 'ryanledbetter135', 'pgmalejandro', 'balavinayagam', 'orebeca', 'nimrod.gazit', 'lau_cinvest', 'sergegtr', 'andresvarela', 'carlthefuzzy1', 'fsflack', 'almaarreola', 'mohok_hugo', 'baker48', 'chen425', 'badger1', 'itzam', 'ansehyuk', 'tcopelan']",33,"['bector1', 'dongdong', 'xiaoyr068', 'ltompki2', 'nima_one', 'bhchen2', 'mraval', 'sunjialin', 'diliber1', 'geethabijjam', 'jkim331', 'griffi21', 'mjy5', 'heebidiwup', 'nmisak', 'gavinwinkel', 'gloger', 'mazzola1', 'sherrypri', 'lupas2', 'mattycat9000', 'ssingh18', 'levitas1', None, 'wdyarthas', 'alex81388', 'mast5', 'weber36', 'hatfarm', 'tchajed', 'omghaxcode', 'jefflale', 'tsai11']",85,"['cinkilic2804', 'hellomancn', 'madhubawankar', 'sosany', 'kennethom1', 'dongdong', 'carlosatkins', 'nima_one', 'tbatth', 'bhchen2', 'parks8', 'sunjialin', 'mraval', 'daveleon', 'ediaz', 'bmanolo', 'dpleasan', 'sherrypri', 'lupas2', 'sorubin2', 'ryanledbetter135', 'pgmalejandro', 'balavinayagam', 'alex81388', 'nimrod.gazit', 'lau_cinvest', 'weber36', 'tchajed', 'omghaxcode', 'almaarreola', 'fsflack', 'baker48', 'itzam', 'tcopelan', 'rubicon777', 'cshaffre', 'jill_freeland', 'ncorral2', 'thawley', 'bector1', 'xiaoyr068', 'cwkimbrough', 'benabdelmoumene', 'ltompki2', 'angelicahz', 'fconde', 'sekchinn', 'diliber1', 'shanmich10', 'geethabijjam', 'hodgesprodges', 'kdorsain', 'jkim331', 'lucianbarbut', 'rmclinch', 'griffi21', 'mjy5', 'aminenko', 'duwen', 'elockett', 'cbrown25', 'jakedubya', 'heebidiwup', 'nmisak', 'gavinwinkel', 'gloger', 'mazzola1', 'stifkaya', 'mattycat9000', 'ssingh18', 'levitas1', None, 'orebeca', 'wdyarthas', 'mast5', 'sergegtr', 'hatfarm', 'andresvarela', 'carlthefuzzy1', 'badger1', 'mohok_hugo', 'chen425', 'jefflale', 'tsai11', 'ansehyuk']"
10,148,53,29,22,"['cshaffre', 'jill_freeland', 'ncorral2', 'thawley', 'sosany', 'kennethom1', 'cwkimbrough', 'carlosatkins', 'tbatth', 'daveleon', 'shanmich10', 'hodgesprodges', 'kdorsain', 'rmclinch', 'cbrown25', 'elockett', 'jakedubya', 'dpleasan', 'sorubin2', 'ryanledbetter135', 'carlthefuzzy1', 'tcopelan']",30,"['rubicon777', 'cinkilic2804', 'hellomancn', 'madhubawankar', 'benabdelmoumene', 'angelicahz', 'fconde', 'parks8', 'sekchinn', 'ediaz', 'lucianbarbut', 'aminenko', 'duwen', 'bmanolo', 'stifkaya', 'pgmalejandro', 'orebeca', 'balavinayagam', 'nimrod.gazit', 'lau_cinvest', 'sergegtr', 'andresvarela', 'almaarreola', 'fsflack', 'badger1', 'mohok_hugo', 'baker48', 'chen425', 'itzam', 'ansehyuk']",7,"['jmills6', 'lance', 'roloscool', 'dicksonsalim', 'sgrand2', None, 'chrisgoulet']",59,"['cinkilic2804', 'hellomancn', 'madhubawankar', 'sosany', 'kennethom1', 'chrisgoulet', 'carlosatkins', 'tbatth', 'parks8', 'daveleon', 'ediaz', 'bmanolo', 'dpleasan', 'sorubin2', 'sgrand2', 'ryanledbetter135', 'pgmalejandro', 'balavinayagam', 'nimrod.gazit', 'lau_cinvest', 'jmills6', 'almaarreola', 'fsflack', 'baker48', 'itzam', 'tcopelan', 'rubicon777', 'cshaffre', 'jill_freeland', 'ncorral2', 'thawley', 'roloscool', 'cwkimbrough', 'benabdelmoumene', 'angelicahz', 'fconde', 'sekchinn', 'shanmich10', 'hodgesprodges', 'kdorsain', 'lucianbarbut', 'rmclinch', 'aminenko', 'duwen', 'elockett', 'cbrown25', 'jakedubya', 'lance', 'stifkaya', 'dicksonsalim', None, 'orebeca', 'sergegtr', 'andresvarela', 'carlthefuzzy1', 'badger1', 'mohok_hugo', 'chen425', 'ansehyuk']"
10,151,53,28,6,"['tbatth', 'cbrown25', 'thawley', 'badger1', 'chen425', 'cwkimbrough']",46,"['rubicon777', 'cinkilic2804', 'hellomancn', 'cshaffre', 'madhubawankar', 'jill_freeland', 'ncorral2', 'sosany', 'kennethom1', 'benabdelmoumene', 'carlosatkins', 'angelicahz', 'fconde', 'parks8', 'daveleon', 'sekchinn', 'ediaz', 'shanmich10', 'hodgesprodges', 'kdorsain', 'lucianbarbut', 'rmclinch', 'aminenko', 'duwen', 'elockett', 'bmanolo', 'jakedubya', 'dpleasan', 'stifkaya', 'sorubin2', 'ryanledbetter135', 'pgmalejandro', 'balavinayagam', 'orebeca', 'nimrod.gazit', 'lau_cinvest', 'sergegtr', 'andresvarela', 'carlthefuzzy1', 'fsflack', 'almaarreola', 'mohok_hugo', 'baker48', 'itzam', 'ansehyuk', 'tcopelan']",22,"['roloscool', 'kgiacobazzi', 'wente1', 'qliu9', 'diliber1', 'jielv1', 'fandi514', 'martin14', 'greenwa1', 'edavilax', 'handa1', 'yjaquinas', 'mroczek1', 'dferrell68', 'dahlke2', 'hronik1', 'dicksonsalim', 'sgrand2', None, 'vishnunath822', 'ewalt1', 'chrisgoulet']",74,"['cinkilic2804', 'hellomancn', 'madhubawankar', 'sosany', 'kennethom1', 'chrisgoulet', 'carlosatkins', 'kgiacobazzi', 'tbatth', 'parks8', 'daveleon', 'ediaz', 'jielv1', 'martin14', 'handa1', 'bmanolo', 'dpleasan', 'hronik1', 'sorubin2', 'sgrand2', 'ryanledbetter135', 'pgmalejandro', 'balavinayagam', 'nimrod.gazit', 'lau_cinvest', 'almaarreola', 'fsflack', 'ewalt1', 'baker48', 'itzam', 'tcopelan', 'rubicon777', 'cshaffre', 'jill_freeland', 'ncorral2', 'thawley', 'roloscool', 'cwkimbrough', 'benabdelmoumene', 'angelicahz', 'fconde', 'wente1', 'qliu9', 'sekchinn', 'diliber1', 'shanmich10', 'hodgesprodges', 'fandi514', 'kdorsain', 'lucianbarbut', 'rmclinch', 'greenwa1', 'edavilax', 'aminenko', 'duwen', 'elockett', 'cbrown25', 'jakedubya', 'yjaquinas', 'mroczek1', 'dferrell68', 'dahlke2', 'stifkaya', 'dicksonsalim', None, 'vishnunath822', 'orebeca', 'sergegtr', 'andresvarela', 'carlthefuzzy1', 'badger1', 'mohok_hugo', 'chen425', 'ansehyuk']"
10,154,53,14,1,['rubicon777'],51,"['cinkilic2804', 'hellomancn', 'cshaffre', 'madhubawankar', 'jill_freeland', 'ncorral2', 'thawley', 'sosany', 'kennethom1', 'cwkimbrough', 'benabdelmoumene', 'carlosatkins', 'tbatth', 'fconde', 'parks8', 'angelicahz', 'daveleon', 'sekchinn', 'ediaz', 'shanmich10', 'hodgesprodges', 'kdorsain', 'lucianbarbut', 'rmclinch', 'aminenko', 'duwen', 'elockett', 'bmanolo', 'jakedubya', 'cbrown25', 'dpleasan', 'stifkaya', 'sorubin2', 'ryanledbetter135', 'pgmalejandro', 'balavinayagam', 'orebeca', 'nimrod.gazit', 'lau_cinvest', 'sergegtr', 'andresvarela', 'carlthefuzzy1', 'fsflack', 'almaarreola', 'mohok_hugo', 'baker48', 'chen425', 'badger1', 'itzam', 'ansehyuk', 'tcopelan']",13,"[None, 'a615045', 'vrozooa', 'yosemo1', 'monytu', 'kalrin', 'gamma0burst', 'scapall', 'joddolms', 'clowlide', 'suhosin87', 'lionanna', 'jyjeong']",65,"['rubicon777', 'cinkilic2804', 'hellomancn', 'cshaffre', 'madhubawankar', 'yosemo1', 'jill_freeland', 'joddolms', 'ncorral2', 'thawley', 'sosany', 'suhosin87', 'kennethom1', 'cwkimbrough', 'benabdelmoumene', 'vrozooa', 'carlosatkins', 'tbatth', 'fconde', 'parks8', 'angelicahz', 'daveleon', 'sekchinn', 'gamma0burst', 'ediaz', 'shanmich10', 'hodgesprodges', 'kdorsain', 'lucianbarbut', 'rmclinch', 'lionanna', 'aminenko', 'duwen', 'a615045', 'elockett', 'bmanolo', 'jakedubya', 'cbrown25', 'kalrin', 'monytu', 'dpleasan', 'scapall', 'clowlide', 'jyjeong', 'stifkaya', 'sorubin2', None, 'ryanledbetter135', 'pgmalejandro', 'balavinayagam', 'orebeca', 'nimrod.gazit', 'lau_cinvest', 'sergegtr', 'andresvarela', 'carlthefuzzy1', 'fsflack', 'almaarreola', 'mohok_hugo', 'baker48', 'chen425', 'badger1', 'itzam', 'ansehyuk', 'tcopelan']"
10,153,53,13,10,"['duwen', 'lau_cinvest', 'fconde', 'sergegtr', 'andresvarela', 'ediaz', 'almaarreola', 'mohok_hugo', 'pgmalejandro', 'orebeca']",42,"['rubicon777', 'cinkilic2804', 'hellomancn', 'cshaffre', 'madhubawankar', 'jill_freeland', 'ncorral2', 'thawley', 'sosany', 'kennethom1', 'cwkimbrough', 'benabdelmoumene', 'carlosatkins', 'tbatth', 'angelicahz', 'parks8', 'daveleon', 'sekchinn', 'shanmich10', 'hodgesprodges', 'kdorsain', 'lucianbarbut', 'rmclinch', 'aminenko', 'elockett', 'bmanolo', 'jakedubya', 'cbrown25', 'dpleasan', 'stifkaya', 'sorubin2', 'ryanledbetter135', 'balavinayagam', 'nimrod.gazit', 'carlthefuzzy1', 'fsflack', 'badger1', 'baker48', 'chen425', 'itzam', 'ansehyuk', 'tcopelan']",3,"['rosarioherrera', None, 'quintero']",55,"['rubicon777', 'cinkilic2804', 'hellomancn', 'cshaffre', 'madhubawankar', 'jill_freeland', 'ncorral2', 'thawley', 'sosany', 'kennethom1', 'cwkimbrough', 'benabdelmoumene', 'carlosatkins', 'tbatth', 'fconde', 'parks8', 'angelicahz', 'daveleon', 'sekchinn', 'ediaz', 'shanmich10', 'hodgesprodges', 'kdorsain', 'lucianbarbut', 'rmclinch', 'rosarioherrera', 'aminenko', 'duwen', 'elockett', 'bmanolo', 'jakedubya', 'cbrown25', 'dpleasan', 'stifkaya', 'sorubin2', None, 'ryanledbetter135', 'pgmalejandro', 'balavinayagam', 'orebeca', 'nimrod.gazit', 'lau_cinvest', 'sergegtr', 'andresvarela', 'carlthefuzzy1', 'fsflack', 'almaarreola', 'mohok_hugo', 'baker48', 'chen425', 'badger1', 'quintero', 'itzam', 'ansehyuk', 'tcopelan']"
10,146,53,7,5,"['carlosatkins', 'tbatth', 'daveleon', 'shanmich10', 'ryanledbetter135']",47,"['rubicon777', 'cinkilic2804', 'hellomancn', 'cshaffre', 'madhubawankar', 'jill_freeland', 'ncorral2', 'thawley', 'sosany', 'kennethom1', 'cwkimbrough', 'benabdelmoumene', 'fconde', 'parks8', 'angelicahz', 'sekchinn', 'ediaz', 'hodgesprodges', 'kdorsain', 'lucianbarbut', 'rmclinch', 'aminenko', 'duwen', 'elockett', 'bmanolo', 'jakedubya', 'cbrown25', 'dpleasan', 'stifkaya', 'sorubin2', 'pgmalejandro', 'balavinayagam', 'orebeca', 'nimrod.gazit', 'lau_cinvest', 'sergegtr', 'andresvarela', 'carlthefuzzy1', 'fsflack', 'almaarreola', 'mohok_hugo', 'baker48', 'chen425', 'badger1', 'itzam', 'ansehyuk', 'tcopelan']",2,"['jmills6', None]",54,"['rubicon777', 'cinkilic2804', 'hellomancn', 'cshaffre', 'madhubawankar', 'jill_freeland', 'ncorral2', 'thawley', 'sosany', 'kennethom1', 'cwkimbrough', 'benabdelmoumene', 'carlosatkins', 'tbatth', 'fconde', 'parks8', 'angelicahz', 'daveleon', 'sekchinn', 'ediaz', 'shanmich10', 'hodgesprodges', 'kdorsain', 'lucianbarbut', 'rmclinch', 'aminenko', 'duwen', 'elockett', 'bmanolo', 'jakedubya', 'cbrown25', 'dpleasan', 'stifkaya', 'sorubin2', None, 'ryanledbetter135', 'pgmalejandro', 'balavinayagam', 'orebeca', 'nimrod.gazit', 'lau_cinvest', 'jmills6', 'sergegtr', 'andresvarela', 'carlthefuzzy1', 'fsflack', 'almaarreola', 'mohok_hugo', 'baker48', 'chen425', 'badger1', 'itzam', 'ansehyuk', 'tcopelan']"
10,147,53,7,5,"['carlosatkins', 'tbatth', 'daveleon', 'dpleasan', 'shanmich10']",47,"['rubicon777', 'cinkilic2804', 'hellomancn', 'cshaffre', 'madhubawankar', 'jill_freeland', 'ncorral2', 'thawley', 'sosany', 'kennethom1', 'cwkimbrough', 'benabdelmoumene', 'fconde', 'parks8', 'angelicahz', 'sekchinn', 'ediaz', 'hodgesprodges', 'kdorsain', 'lucianbarbut', 'rmclinch', 'aminenko', 'duwen', 'elockett', 'bmanolo', 'jakedubya', 'cbrown25', 'stifkaya', 'sorubin2', 'ryanledbetter135', 'pgmalejandro', 'balavinayagam', 'orebeca', 'nimrod.gazit', 'lau_cinvest', 'sergegtr', 'andresvarela', 'carlthefuzzy1', 'fsflack', 'almaarreola', 'mohok_hugo', 'baker48', 'chen425', 'badger1', 'itzam', 'ansehyuk', 'tcopelan']",2,"['jmills6', None]",54,"['rubicon777', 'cinkilic2804', 'hellomancn', 'cshaffre', 'madhubawankar', 'jill_freeland', 'ncorral2', 'thawley', 'sosany', 'kennethom1', 'cwkimbrough', 'benabdelmoumene', 'carlosatkins', 'tbatth', 'fconde', 'parks8', 'angelicahz', 'daveleon', 'sekchinn', 'ediaz', 'shanmich10', 'hodgesprodges', 'kdorsain', 'lucianbarbut', 'rmclinch', 'aminenko', 'duwen', 'elockett', 'bmanolo', 'jakedubya', 'cbrown25', 'dpleasan', 'stifkaya', 'sorubin2', None, 'ryanledbetter135', 'pgmalejandro', 'balavinayagam', 'orebeca', 'nimrod.gazit', 'lau_cinvest', 'jmills6', 'sergegtr', 'andresvarela', 'carlthefuzzy1', 'fsflack', 'almaarreola', 'mohok_hugo', 'baker48', 'chen425', 'badger1', 'itzam', 'ansehyuk', 'tcopelan']"
11,29,52,58,48,"['jjojjo888', 'kaoce', 'yellowdie87', 'jachar01', 'wdswds', 'gochujang8', 'yuri9eoul', 'sunmook', 'jym0275', 'ses0009', 'silvereyes87', 'pjw1018', 'popburster', 'sehuyn2', 'versatility', 'stalbert', 'm01140114', 'sjm3zzang', 'slekd7', 'djbumsangi', 'blueband902', 'gaelstory', 'lmwon0912', 'min789', 'pyi87', 'ses0008', 'soulk87', 'osijwn', 'tpgns0519', 'moya118', 'gagoholic', 'darkmingu', 'hoony0107', 'lhg123123', 'crazyman999', 'kjh191013', 'rpdlarpdlxm', 'mylie', 'best546', 'rpdlarpdlxm1', 'no3suk', 'jane7090', 'hbl1030', 'hwangstars', 'sunhyun2745', 'doctork5', 'dlejrwo0410', 'cd8876']",3,"['hoony8717', 'm0stafiz', 'brajeshbeec']",10,"['hcha71', 'yosemo1', 'gamma0burst', 'joddolms', 'zenorc', 'yswqd', 'mychin9yu', 'suhosin87', None, 'primeevir']",61,"['kaoce', 'jjojjo888', 'jachar01', 'joddolms', 'yosemo1', 'zenorc', 'sunmook', 'hoony8717', 'ses0009', 'popburster', 'm01140114', 'sjm3zzang', 'gamma0burst', 'pyi87', 'hcha71', 'osijwn', 'tpgns0519', 'moya118', 'gagoholic', 'darkmingu', 'hoony0107', 'lhg123123', 'mylie', 'best546', 'rpdlarpdlxm1', 'no3suk', 'hwangstars', 'dlejrwo0410', 'cd8876', 'yellowdie87', 'wdswds', 'gochujang8', 'yuri9eoul', 'jym0275', 'silvereyes87', 'pjw1018', 'sehuyn2', 'versatility', 'stalbert', 'slekd7', 'djbumsangi', 'blueband902', 'gaelstory', 'lmwon0912', 'min789', 'ses0008', 'soulk87', 'crazyman999', None, 'primeevir', 'kjh191013', 'rpdlarpdlxm', 'jane7090', 'hbl1030', 'brajeshbeec', 'yswqd', 'mychin9yu', 'sunhyun2745', 'doctork5', 'm0stafiz', 'suhosin87']"
11,165,52,24,3,"['yuri9eoul', 'mylie', 'gochujang8']",48,"['jjojjo888', 'kaoce', 'yellowdie87', 'jachar01', 'wdswds', 'sunmook', 'hoony8717', 'jym0275', 'ses0009', 'silvereyes87', 'pjw1018', 'popburster', 'sehuyn2', 'versatility', 'stalbert', 'm01140114', 'sjm3zzang', 'slekd7', 'djbumsangi', 'blueband902', 'gaelstory', 'lmwon0912', 'min789', 'pyi87', 'ses0008', 'soulk87', 'osijwn', 'tpgns0519', 'moya118', 'gagoholic', 'darkmingu', 'hoony0107', 'lhg123123', 'crazyman999', 'kjh191013', 'rpdlarpdlxm', 'best546', 'rpdlarpdlxm1', 'no3suk', 'jane7090', 'hbl1030', 'brajeshbeec', 'hwangstars', 'sunhyun2745', 'doctork5', 'm0stafiz', 'dlejrwo0410', 'cd8876']",21,"['yosemo1', 'joddolms', 'zenorc', 'vrozooa', 'gamma0burst', 'tarka', 'lottoz', 'lionanna', 'hcha71', 'a615045', 'kalrin', 'monytu', 'kdm52', 'scapall', 'clowlide', None, 'primeevir', 'yswqd', 'mychin9yu', 'suhosin87', 'jyjeong']",72,"['kaoce', 'jjojjo888', 'yellowdie87', 'wdswds', 'jachar01', 'joddolms', 'yosemo1', 'gochujang8', 'yuri9eoul', 'sunmook', 'hoony8717', 'zenorc', 'jym0275', 'ses0009', 'vrozooa', 'silvereyes87', 'pjw1018', 'popburster', 'sehuyn2', 'versatility', 'stalbert', 'm01140114', 'sjm3zzang', 'slekd7', 'gamma0burst', 'tarka', 'djbumsangi', 'blueband902', 'lottoz', 'gaelstory', 'lmwon0912', 'min789', 'lionanna', 'pyi87', 'hcha71', 'ses0008', 'a615045', 'soulk87', 'osijwn', 'kalrin', 'monytu', 'kdm52', 'tpgns0519', 'scapall', 'moya118', 'gagoholic', 'darkmingu', 'clowlide', 'hoony0107', 'lhg123123', 'crazyman999', None, 'primeevir', 'kjh191013', 'rpdlarpdlxm', 'mylie', 'best546', 'rpdlarpdlxm1', 'no3suk', 'jane7090', 'hbl1030', 'brajeshbeec', 'yswqd', 'mychin9yu', 'hwangstars', 'sunhyun2745', 'doctork5', 'm0stafiz', 'suhosin87', 'dlejrwo0410', 'jyjeong', 'cd8876']"
11,207,52,8,7,"['pyi87', 'kjh191013', 'kaoce', 'jachar01', 'gochujang8', 'hwangstars', 'lhg123123']",44,"['jjojjo888', 'yellowdie87', 'wdswds', 'yuri9eoul', 'sunmook', 'hoony8717', 'jym0275', 'ses0009', 'silvereyes87', 'pjw1018', 'popburster', 'sehuyn2', 'versatility', 'stalbert', 'm01140114', 'sjm3zzang', 'slekd7', 'djbumsangi', 'blueband902', 'gaelstory', 'lmwon0912', 'min789', 'ses0008', 'soulk87', 'osijwn', 'tpgns0519', 'moya118', 'gagoholic', 'darkmingu', 'hoony0107', 'crazyman999', 'rpdlarpdlxm', 'mylie', 'best546', 'rpdlarpdlxm1', 'no3suk', 'jane7090', 'hbl1030', 'brajeshbeec', 'sunhyun2745', 'doctork5', 'm0stafiz', 'dlejrwo0410', 'cd8876']",1,[None],52,"['kaoce', 'jjojjo888', 'yellowdie87', 'wdswds', 'jachar01', 'gochujang8', 'yuri9eoul', 'sunmook', 'hoony8717', 'jym0275', 'ses0009', 'silvereyes87', 'pjw1018', 'popburster', 'sehuyn2', 'versatility', 'stalbert', 'm01140114', 'sjm3zzang', 'slekd7', 'djbumsangi', 'blueband902', 'gaelstory', 'lmwon0912', 'min789', 'pyi87', 'ses0008', 'soulk87', 'osijwn', 'tpgns0519', 'moya118', 'gagoholic', 'darkmingu', 'hoony0107', 'lhg123123', 'crazyman999', None, 'kjh191013', 'rpdlarpdlxm', 'mylie', 'best546', 'rpdlarpdlxm1', 'no3suk', 'jane7090', 'hbl1030', 'brajeshbeec', 'hwangstars', 'sunhyun2745', 'doctork5', 'm0stafiz', 'dlejrwo0410', 'cd8876']"
12,69,39,118,14,"['jyao5', 'dinger104', 'dwass', 'surajmodi', 'mintzo', 'hua5', 'jayfurrie', 'ouyang4', 'ahoboke', 'chen338', 'echegil1', 'chenhu1', 'bradsnyder', 'vigneshka']",24,"['flybywire91', 'tiziana.cesca', 'cwjohnson', 'crosscounter87', 'cpatchava', 'lefkowi1', 'koroibos', 'aflocchini', 'zoboomafoo', 'dereknowacki1', 'hutchr2', 'ryandwyer91', 'zaidi', 'aashay1991', 'oleksie1', 'sabio00', 'jeffwebber808', 'stacheung', 'walter9', 'rmeekin11', 'dpiraner', 'jacobstinnett', 'tomn7201', 'gopi178']",104,"['dhuang123', 'nookala', 'izquier2', 'moon1002', 'b3nny312', 'fredhdx', 'redyoshi49q', 'lshi14', 'shawkat', 'johns149', 'muneebahmed95', 'sherrypri', 'hronik1', 'sfanou2', 'siwin2', 'sutchaya', 'vargas3', 'kumikknd', 'neilchristanto', 'yuan11', 'shawnwin1234', 'daybreak410039', 'ewalt1', 'baker48', 'coolcrew', 'banerje1', 'trovill1', 'hartant2', 'jiwonp224', 'hoang4', 'reebbhaa', 'profballack', 'alostu3', 'nanotie', 'malik15', 'madigan5', 'alabi2', 'ravitheja22', 'supermeatboy', 'ericwoo1', 'feng12', 'mikenike', 'jclift3', 'heebidiwup', 'yjaquinas', 'lidazhu1', 'menghuang', 'rushx1', 'wlee26', 'broll1', 'lu30', None, 'qiu12', 'zhangyj', 'wanchoi1', 'luiszelaya', 'spadin1', 'keating7', 'blee51', 'maxcan', 'leiche1', 'achavarria', 'samuelzhang', 'mahed', 'jashari1', 'tatuhiro', 'pashea1', 'zulueta1', 'shapir11', 'kwak27', 'donner1', 'nam18', 'jksikai', 'szhang51', 'mim1c', 'jataput1', 'miketeufel1', 'sgrand2', 'mikeudelhofen', 'mihrenoe', 'aczerepak', 'stuber1', 'kandel3', 'williamhn', 'liyd', 'monnett1', 'ltompki2', 'lee117', 'lmendez2', 'red6290', 'a2104707', 'kadakiy1', 'hchao2', 'nmisak', 'hazypensieve', 'dferrell68', 'hgao10', 'stephenyzc', 'morris57', 'yao10', 'panlei616', 'jefflale', 'grace3050', 'tischer1']",142,"['dhuang123', 'nookala', 'dwass', 'izquier2', 'cpatchava', 'moon1002', 'b3nny312', 'aflocchini', 'zoboomafoo', 'hua5', 'fredhdx', 'redyoshi49q', 'lshi14', 'shawkat', 'hutchr2', 'bradsnyder', 'johns149', 'muneebahmed95', 'aashay1991', 'sherrypri', 'hronik1', 'sfanou2', 'siwin2', 'sutchaya', 'vargas3', 'kumikknd', 'neilchristanto', 'yuan11', 'shawnwin1234', 'daybreak410039', 'ewalt1', 'baker48', 'coolcrew', 'banerje1', 'trovill1', 'chen338', 'hartant2', 'jiwonp224', 'hoang4', 'cwjohnson', 'reebbhaa', 'profballack', 'alostu3', 'nanotie', 'chenhu1', 'koroibos', 'malik15', 'madigan5', 'alabi2', 'ravitheja22', 'supermeatboy', 'ericwoo1', 'feng12', 'zaidi', 'mikenike', 'jclift3', 'heebidiwup', 'oleksie1', 'yjaquinas', 'lidazhu1', 'menghuang', 'jeffwebber808', 'stacheung', 'rushx1', 'wlee26', 'broll1', 'lu30', None, 'qiu12', 'zhangyj', 'wanchoi1', 'luiszelaya', 'spadin1', 'keating7', 'blee51', 'maxcan', 'leiche1', 'jefflale', 'achavarria', 'samuelzhang', 'mahed', 'jashari1', 'flybywire91', 'mintzo', 'ouyang4', 'tiziana.cesca', 'tatuhiro', 'pashea1', 'lefkowi1', 'zulueta1', 'shapir11', 'kwak27', 'echegil1', 'donner1', 'nam18', 'vigneshka', 'jyao5', 'ryandwyer91', 'jksikai', 'szhang51', 'mim1c', 'jataput1', 'jayfurrie', 'sabio00', 'miketeufel1', 'sgrand2', 'mikeudelhofen', 'dinger104', 'rmeekin11', 'mihrenoe', 'tomn7201', 'aczerepak', 'stuber1', 'kandel3', 'williamhn', 'ahoboke', 'liyd', 'monnett1', 'crosscounter87', 'ltompki2', 'lee117', 'surajmodi', 'dereknowacki1', 'lmendez2', 'red6290', 'a2104707', 'kadakiy1', 'hchao2', 'nmisak', 'hazypensieve', 'dferrell68', 'hgao10', 'stephenyzc', 'morris57', 'walter9', 'dpiraner', 'yao10', 'jacobstinnett', 'panlei616', 'gopi178', 'grace3050', 'tischer1']"
12,68,39,94,1,['zaidi'],37,"['dwass', 'flybywire91', 'mintzo', 'ouyang4', 'ahoboke', 'tiziana.cesca', 'cwjohnson', 'cpatchava', 'crosscounter87', 'chenhu1', 'lefkowi1', 'koroibos', 'aflocchini', 'zoboomafoo', 'surajmodi', 'dereknowacki1', 'hua5', 'echegil1', 'hutchr2', 'bradsnyder', 'vigneshka', 'jyao5', 'ryandwyer91', 'aashay1991', 'jayfurrie', 'oleksie1', 'sabio00', 'jeffwebber808', 'stacheung', 'walter9', 'dinger104', 'rmeekin11', 'dpiraner', 'jacobstinnett', 'tomn7201', 'gopi178', 'chen338']",93,"['shehzad83', 'el003', 'shahnawaz', 'sana', 'khtanveer.arif', 'yumna_zaidi', 'ady', 'arsalan79', 'erum', 'danish_muneer', 'danish', 'aliraza', 'raheel35', 'muhammad_ashfaq', 'marium98', 'salmanmakhdoom', 'rumsha', 'mahesharjun', 'safi', 'abdul_moiz', 'shakeeb', 'hatim', 'ab_007', 'salma', 'saad_007', 'sherazahmed_021', 'muhammadshahzaib786', 'atifsheikh_91', 'arsal124', 'aysha', 'alihaider', 'saadali', 'zarariz', 'misha_fawad', None, 'tehreem', 'abbi', 'wajiyazafar', 'fawadned0809', 'ffm78692', 'yumna', 'hiraimtiaz', 'farayakazmi', 'basit', 'hunaiz', 'farooq141', 'rubina', 'tzs', 'minhajnaim', 'faizan_tariq', 'abdulaleemshaikh', 'nausheen109', 'shahbaz_el', 'anum72', 'komal', 'anumkhan', 'rahul1990', 'areeba', 'faizi', 'rak_312', 'safiahrehman', 'ammarah012', 'azhar', 'yaser664', 'beena', 'wikki123', 'ul08044', 'spaxorid', 'sajjad', 'maarij', 'sheeraz', 'nishat34', 'ahmedshah', 'kubrafatima', 'madiha020', 'el301', 'sofia', 'ul08034', 'sidrakhalid', 'uroojsajid', 'swaleha115', 'adiljaliawala', 'el306', 'yousufmujahid', 'umerzia', 'danish67', 'zubikhan', 'hariskhan', 'hinarahim', 'ammardg', 'el044', 'mariyum8', 'ameed']",131,"['shehzad83', 'dwass', 'el003', 'shahnawaz', 'sana', 'khtanveer.arif', 'yumna_zaidi', 'ady', 'cpatchava', 'arsalan79', 'aflocchini', 'zoboomafoo', 'erum', 'hua5', 'danish_muneer', 'danish', 'aliraza', 'hutchr2', 'bradsnyder', 'raheel35', 'aashay1991', 'muhammad_ashfaq', 'marium98', 'salmanmakhdoom', 'rumsha', 'mahesharjun', 'safi', 'abdul_moiz', 'chen338', 'shakeeb', 'hatim', 'cwjohnson', 'chenhu1', 'koroibos', 'ab_007', 'salma', 'saad_007', 'sherazahmed_021', 'muhammadshahzaib786', 'atifsheikh_91', 'arsal124', 'aysha', 'zaidi', 'alihaider', 'saadali', 'oleksie1', 'jeffwebber808', 'zarariz', 'stacheung', 'misha_fawad', None, 'tehreem', 'abbi', 'wajiyazafar', 'fawadned0809', 'ffm78692', 'flybywire91', 'mintzo', 'yumna', 'ouyang4', 'tiziana.cesca', 'hiraimtiaz', 'farayakazmi', 'basit', 'hunaiz', 'farooq141', 'rubina', 'tzs', 'lefkowi1', 'minhajnaim', 'faizan_tariq', 'abdulaleemshaikh', 'nausheen109', 'shahbaz_el', 'echegil1', 'anum72', 'vigneshka', 'jyao5', 'ryandwyer91', 'komal', 'anumkhan', 'jayfurrie', 'rahul1990', 'areeba', 'sabio00', 'faizi', 'rak_312', 'safiahrehman', 'ammarah012', 'dinger104', 'rmeekin11', 'azhar', 'yaser664', 'beena', 'wikki123', 'tomn7201', 'ul08044', 'spaxorid', 'sajjad', 'maarij', 'sheeraz', 'ahoboke', 'nishat34', 'ahmedshah', 'kubrafatima', 'madiha020', 'crosscounter87', 'el301', 'sofia', 'ul08034', 'sidrakhalid', 'surajmodi', 'dereknowacki1', 'uroojsajid', 'swaleha115', 'adiljaliawala', 'el306', 'yousufmujahid', 'umerzia', 'danish67', 'zubikhan', 'hariskhan', 'walter9', 'hinarahim', 'ammardg', 'el044', 'dpiraner', 'jacobstinnett', 'gopi178', 'mariyum8', 'ameed']"
12,70,39,48,3,"['sabio00', 'lefkowi1', 'zoboomafoo']",35,"['dwass', 'flybywire91', 'mintzo', 'ouyang4', 'ahoboke', 'tiziana.cesca', 'cwjohnson', 'cpatchava', 'crosscounter87', 'chenhu1', 'koroibos', 'aflocchini', 'surajmodi', 'dereknowacki1', 'hua5', 'echegil1', 'hutchr2', 'bradsnyder', 'vigneshka', 'jyao5', 'zaidi', 'ryandwyer91', 'aashay1991', 'jayfurrie', 'oleksie1', 'jeffwebber808', 'stacheung', 'walter9', 'dinger104', 'rmeekin11', 'dpiraner', 'jacobstinnett', 'tomn7201', 'gopi178', 'chen338']",45,"['powerplayer7', 'izquier2', 'ekapin2', 'xiaoyr068', 'yuanweih', 'geschreyr', 'ddanielw', 'bhchen2', 'mraval', 'sunjialin', 'gobias', 'emma', 'geethabijjam', 'foxytop', 'brittovivek', 'ludao822', 'esanch29', 'jkim331', 'griffi21', 'bony', 'feng12', 'btanabe2', 'heebidiwup', 'boertew1', 'gavinwinkel', 'gloger', 'lupas2', 'mattycat9000', None, 'devharlalka', 'wdyarthas', 'alex81388', 'weber36', 'deasey1', 'wang183', 'hatfarm', 'jtlust3', 'omghaxcode', 'tchajed', 'zhang291', 'hardy6', 'stuber1', 'tischer1', 'trovill1', 'cernaus1']",83,"['dwass', 'flybywire91', 'mintzo', 'izquier2', 'ouyang4', 'tiziana.cesca', 'ekapin2', 'cpatchava', 'lefkowi1', 'yuanweih', 'geschreyr', 'aflocchini', 'zoboomafoo', 'bhchen2', 'mraval', 'sunjialin', 'hua5', 'gobias', 'emma', 'foxytop', 'brittovivek', 'echegil1', 'esanch29', 'bony', 'hutchr2', 'bradsnyder', 'vigneshka', 'jyao5', 'ryandwyer91', 'aashay1991', 'jayfurrie', 'boertew1', 'sabio00', 'lupas2', 'alex81388', 'dinger104', 'rmeekin11', 'weber36', 'deasey1', 'wang183', 'jtlust3', 'omghaxcode', 'tchajed', 'tomn7201', 'hardy6', 'stuber1', 'trovill1', 'chen338', 'cernaus1', 'powerplayer7', 'ahoboke', 'cwjohnson', 'crosscounter87', 'xiaoyr068', 'chenhu1', 'ddanielw', 'koroibos', 'surajmodi', 'dereknowacki1', 'geethabijjam', 'ludao822', 'griffi21', 'jkim331', 'feng12', 'zaidi', 'btanabe2', 'heebidiwup', 'oleksie1', 'gavinwinkel', 'gloger', 'jeffwebber808', 'stacheung', 'mattycat9000', None, 'walter9', 'devharlalka', 'wdyarthas', 'dpiraner', 'hatfarm', 'zhang291', 'jacobstinnett', 'gopi178', 'tischer1']"
12,71,39,30,8,"['aflocchini', 'rmeekin11', 'aashay1991', 'dereknowacki1', 'cwjohnson', 'jeffwebber808', 'tomn7201', 'walter9']",30,"['dwass', 'flybywire91', 'mintzo', 'ouyang4', 'ahoboke', 'tiziana.cesca', 'cpatchava', 'crosscounter87', 'chenhu1', 'lefkowi1', 'koroibos', 'zoboomafoo', 'surajmodi', 'hua5', 'echegil1', 'hutchr2', 'bradsnyder', 'vigneshka', 'jyao5', 'zaidi', 'ryandwyer91', 'jayfurrie', 'oleksie1', 'sabio00', 'stacheung', 'dinger104', 'dpiraner', 'jacobstinnett', 'gopi178', 'chen338']",22,"['gazdzia1', 'swallerick', 'eder0020', 'bector1', 'arvman', 'toblerone16', '11018499jd', 'donner1', 'brenda.bedeaux', 'dynamicdoyle', 'nrb722', 'psmisek07', None, 'amnueyp1', 'theerasit', 'mersch', 'mikeystarr', 'yuan11', 'toddlienemann', 'capissen', 'siveo123', 'jmarti']",60,"['dwass', 'flybywire91', 'mintzo', 'gazdzia1', 'ouyang4', 'ahoboke', 'tiziana.cesca', 'cwjohnson', 'swallerick', 'eder0020', 'bector1', 'cpatchava', 'crosscounter87', 'arvman', 'chenhu1', 'lefkowi1', 'koroibos', 'aflocchini', 'zoboomafoo', 'surajmodi', 'dereknowacki1', 'hua5', 'toblerone16', '11018499jd', 'echegil1', 'hutchr2', 'brenda.bedeaux', 'bradsnyder', 'vigneshka', 'jyao5', 'zaidi', 'ryandwyer91', 'donner1', 'aashay1991', 'dynamicdoyle', 'jayfurrie', 'oleksie1', 'sabio00', 'jeffwebber808', 'nrb722', 'stacheung', 'psmisek07', None, 'walter9', 'amnueyp1', 'dinger104', 'rmeekin11', 'theerasit', 'mersch', 'mikeystarr', 'dpiraner', 'yuan11', 'toddlienemann', 'capissen', 'jacobstinnett', 'siveo123', 'tomn7201', 'jmarti', 'gopi178', 'chen338']"
12,72,39,26,3,"['ryandwyer91', 'cpatchava', 'crosscounter87']",35,"['dwass', 'flybywire91', 'mintzo', 'ouyang4', 'ahoboke', 'tiziana.cesca', 'cwjohnson', 'chenhu1', 'lefkowi1', 'koroibos', 'aflocchini', 'zoboomafoo', 'surajmodi', 'dereknowacki1', 'hua5', 'echegil1', 'hutchr2', 'bradsnyder', 'vigneshka', 'jyao5', 'zaidi', 'aashay1991', 'jayfurrie', 'oleksie1', 'sabio00', 'jeffwebber808', 'stacheung', 'walter9', 'dinger104', 'rmeekin11', 'dpiraner', 'jacobstinnett', 'tomn7201', 'gopi178', 'chen338']",23,"['chan32', 'roloscool', 'case7', 'kgiacobazzi', 'wente1', 'qliu9', 'mrwilsonsaid', 't14', 'jielv1', 'fandi514', 'greenwa1', 'edavilax', 'handa1', 'swarley', 'mroczek1', 'dahlke2', 'novawater', 'snanav3', 'dicksonsalim', None, 'mhg624', 'chrisgoulet', 'lobert124']",61,"['dwass', 'flybywire91', 'mintzo', 'ouyang4', 'ahoboke', 'tiziana.cesca', 'cwjohnson', 'chan32', 'cpatchava', 'crosscounter87', 'roloscool', 'case7', 'chenhu1', 'lefkowi1', 'koroibos', 'aflocchini', 'zoboomafoo', 'kgiacobazzi', 'surajmodi', 'wente1', 'dereknowacki1', 'hua5', 'qliu9', 'mrwilsonsaid', 't14', 'jielv1', 'echegil1', 'fandi514', 'hutchr2', 'bradsnyder', 'vigneshka', 'jyao5', 'zaidi', 'ryandwyer91', 'greenwa1', 'edavilax', 'handa1', 'aashay1991', 'jayfurrie', 'oleksie1', 'swarley', 'mroczek1', 'dahlke2', 'sabio00', 'jeffwebber808', 'novawater', 'snanav3', 'stacheung', 'dicksonsalim', None, 'walter9', 'dinger104', 'rmeekin11', 'dpiraner', 'jacobstinnett', 'tomn7201', 'mhg624', 'gopi178', 'chrisgoulet', 'lobert124', 'chen338']"
13,17,38,30,25,"['mccarthj', 'bing', 'averyp', 'dsawei', 'bbanik', 'rmedina49', 'owensj3', 'blackj4', 'atkinsmc', 'santosa', 'carerley', 'hammont', 'bollmal', 'frenchwr', 'agr126', 'cdseacri', 'kanyewest', 'huntreje', 'srinade23', 'ajules29', 'faulknerak', 'secampbell', 'mksmith3', 'fpologarzon', 'matulic']",12,"['anima783', 'amelkonian', 'stonemason89', 'tonylee33', 'ziletti', 'triphysics', 'aries2357', 'larson', 'karl.merz', 'schrodienstein', 'myeung123', 'sjaonline']",5,"['gundama', 'dousek', 'ciacovella', 'tengd', None]",42,"['mccarthj', 'bing', 'averyp', 'anima783', 'bbanik', 'dsawei', 'rmedina49', 'dousek', 'ciacovella', 'owensj3', 'blackj4', 'atkinsmc', 'ziletti', 'triphysics', 'aries2357', 'santosa', 'carerley', 'hammont', 'tengd', 'schrodienstein', 'myeung123', 'amelkonian', 'stonemason89', 'bollmal', 'frenchwr', 'agr126', 'cdseacri', 'karl.merz', None, 'kanyewest', 'huntreje', 'srinade23', 'ajules29', 'faulknerak', 'secampbell', 'mksmith3', 'tonylee33', 'fpologarzon', 'gundama', 'larson', 'matulic', 'sjaonline']"
14,60,33,33,31,"['tiandra', 'uddhav', 'hjsong', 'kbear', 'pagonakis', 'jfabi', 'duttm0709', 'elainemkung', 'nbravo', 'hwood', 'tgiesa', 'ashley6256', 'gomalley93', 'toehmke', 'ggronau', 'aptowitz', 'mfryer', 'rosales', 'kgorick', 'mbairey', 'jhkroll', 'kalib', 'nkkhouri', 'mzkhweis', 'sokaine', 'yvonne4', 'romans1975', 'tlin15', 'frvargas', 'phoebe', 'apthomas']",1,['swchang'],2,"['buehler', None]",34,"['tiandra', 'uddhav', 'hjsong', 'kbear', 'pagonakis', 'jfabi', 'duttm0709', 'elainemkung', 'nbravo', 'hwood', 'tgiesa', 'ashley6256', 'gomalley93', 'buehler', 'toehmke', 'ggronau', 'aptowitz', 'mfryer', 'rosales', 'kgorick', 'mbairey', 'swchang', 'jhkroll', 'kalib', 'nkkhouri', None, 'mzkhweis', 'sokaine', 'yvonne4', 'romans1975', 'tlin15', 'frvargas', 'phoebe', 'apthomas']"
15,80,30,18,15,"['chen334', 'rossboe2', 'wukevin91', 'gu1', 'kevinjin0607', 'peterkang7', 'tushdante', 'chen361', 'ambieca', 'caz1429', 'troypetersen', 'rhino4691', 'pudong2', 'ansai1', 'shseo0315']",14,"['freshandclean', 'kyrphen', 'zou11', 'kunaldatta', 'raymondyeh', 'wsypeter', 'pachopepe', 'dinin', 'chiemes919', 'shengtaishi', 'phugdy', 'bconline', 'enyuluo', 'uditsharma101']",3,"[None, 'miketeufel1', 'azam2']",32,"['freshandclean', 'chen334', 'wukevin91', 'kevinjin0607', 'caz1429', 'ambieca', 'troypetersen', 'pudong2', 'ansai1', 'kyrphen', 'rossboe2', 'rhino4691', 'wsypeter', 'chiemes919', 'enyuluo', 'uditsharma101', 'zou11', 'kunaldatta', 'gu1', 'azam2', 'peterkang7', 'tushdante', 'chen361', 'pachopepe', 'miketeufel1', 'phugdy', None, 'raymondyeh', 'dinin', 'shengtaishi', 'bconline', 'shseo0315']"
15,81,30,11,7,"['freshandclean', 'raymondyeh', 'peterkang7', 'wsypeter', 'shengtaishi', 'chiemes919', 'enyuluo']",22,"['chen334', 'wukevin91', 'kevinjin0607', 'caz1429', 'ambieca', 'troypetersen', 'pudong2', 'ansai1', 'kyrphen', 'rossboe2', 'rhino4691', 'uditsharma101', 'zou11', 'kunaldatta', 'gu1', 'tushdante', 'chen361', 'pachopepe', 'phugdy', 'dinin', 'bconline', 'shseo0315']",4,"['sgrand2', 'powerplayer7', None, 'miketeufel1']",33,"['freshandclean', 'chen334', 'wukevin91', 'powerplayer7', 'kevinjin0607', 'caz1429', 'ambieca', 'troypetersen', 'pudong2', 'ansai1', 'kyrphen', 'rossboe2', 'rhino4691', 'wsypeter', 'chiemes919', 'enyuluo', 'uditsharma101', 'zou11', 'kunaldatta', 'gu1', 'peterkang7', 'tushdante', 'chen361', 'pachopepe', 'miketeufel1', 'phugdy', 'sgrand2', None, 'raymondyeh', 'dinin', 'shengtaishi', 'bconline', 'shseo0315']"
16,54,30,20,13,"['ani3989', 'beozsy', 'ahmed19', 'vc15', 'gsee2', 'hailee', 'ortigar1', 'capota2', 'parkin1', 'djung31', 'aiyin_liu', 'wakewaker', 'shivare2']",16,"['afiorino', 'kyongsoo', 'sgautam71', 'kyooho', 'bmarco', 'hsnuer', 'ngel1914', 'ktung3', 'afromaniac', 'arnie', 'unluerdincer', 'flian2', 'bdmonster', 'oberon2', 'khughes5', 'lbaghuis']",7,"[None, 'shong45', 'sixgallon', 'meagher1', 'starryjared', 'daiyuan1991', 'shanesivan']",36,"['gsee2', 'ortigar1', 'capota2', 'djung31', 'starryjared', 'aiyin_liu', 'wakewaker', 'shivare2', 'lbaghuis', 'afiorino', 'beozsy', 'kyongsoo', 'hailee', 'shanesivan', 'sgautam71', 'kyooho', 'shong45', 'sixgallon', 'meagher1', 'afromaniac', 'parkin1', 'arnie', 'unluerdincer', 'flian2', 'bdmonster', 'ahmed19', 'khughes5', None, 'daiyuan1991', 'ani3989', 'vc15', 'bmarco', 'hsnuer', 'ngel1914', 'ktung3', 'oberon2']"
16,57,30,10,1,['hsnuer'],28,"['gsee2', 'ortigar1', 'capota2', 'djung31', 'aiyin_liu', 'wakewaker', 'shivare2', 'lbaghuis', 'afiorino', 'beozsy', 'kyongsoo', 'hailee', 'sgautam71', 'kyooho', 'afromaniac', 'parkin1', 'arnie', 'unluerdincer', 'flian2', 'bdmonster', 'ahmed19', 'khughes5', 'ani3989', 'vc15', 'bmarco', 'ngel1914', 'ktung3', 'oberon2']",9,"['darkepiyon', 'davidhall', 'jstsmalley', 'fastjacksonmin', 'goanfigher', 'saharnaz', 'mokhtari', None, 'mike6789']",38,"['gsee2', 'fastjacksonmin', 'ortigar1', 'capota2', 'djung31', 'aiyin_liu', 'wakewaker', 'shivare2', 'lbaghuis', 'afiorino', 'beozsy', 'kyongsoo', 'hailee', 'mike6789', 'sgautam71', 'kyooho', 'davidhall', 'afromaniac', 'parkin1', 'arnie', 'unluerdincer', 'flian2', 'bdmonster', 'ahmed19', 'khughes5', None, 'jstsmalley', 'ani3989', 'vc15', 'darkepiyon', 'bmarco', 'hsnuer', 'ngel1914', 'ktung3', 'goanfigher', 'saharnaz', 'oberon2', 'mokhtari']"
16,56,30,7,1,['hsnuer'],28,"['gsee2', 'ortigar1', 'capota2', 'djung31', 'aiyin_liu', 'wakewaker', 'shivare2', 'lbaghuis', 'afiorino', 'beozsy', 'kyongsoo', 'hailee', 'sgautam71', 'kyooho', 'afromaniac', 'parkin1', 'arnie', 'unluerdincer', 'flian2', 'bdmonster', 'ahmed19', 'khughes5', 'ani3989', 'vc15', 'bmarco', 'ngel1914', 'ktung3', 'oberon2']",6,"['davidhall', 'fastjacksonmin', 'crekdestiny', 'goanfigher', None, 'jstsmalley']",35,"['sgautam71', 'gsee2', 'kyooho', 'davidhall', 'fastjacksonmin', 'ortigar1', 'capota2', 'afromaniac', 'djung31', 'parkin1', 'arnie', 'unluerdincer', 'aiyin_liu', 'flian2', 'bdmonster', 'wakewaker', 'shivare2', 'ahmed19', 'khughes5', 'lbaghuis', 'ani3989', 'afiorino', 'beozsy', 'kyongsoo', 'vc15', None, 'jstsmalley', 'bmarco', 'hsnuer', 'ngel1914', 'ktung3', 'crekdestiny', 'goanfigher', 'oberon2', 'hailee']"
16,55,30,6,5,"['bmarco', 'bdmonster', 'flian2', 'hailee', 'khughes5']",24,"['sgautam71', 'gsee2', 'kyooho', 'ortigar1', 'capota2', 'afromaniac', 'djung31', 'parkin1', 'arnie', 'unluerdincer', 'aiyin_liu', 'wakewaker', 'shivare2', 'ahmed19', 'lbaghuis', 'ani3989', 'afiorino', 'beozsy', 'kyongsoo', 'vc15', 'hsnuer', 'ngel1914', 'ktung3', 'oberon2']",1,[None],30,"['sgautam71', 'gsee2', 'kyooho', 'ortigar1', 'capota2', 'afromaniac', 'djung31', 'parkin1', 'arnie', 'unluerdincer', 'aiyin_liu', 'flian2', 'bdmonster', 'wakewaker', 'shivare2', 'ahmed19', 'khughes5', 'lbaghuis', 'ani3989', 'afiorino', 'beozsy', 'kyongsoo', 'vc15', None, 'bmarco', 'hsnuer', 'ngel1914', 'ktung3', 'oberon2', 'hailee']"
17,169,30,24,12,"['richarl', 'brumpke', 'burton13', 'opierce', 'mpavlic', 'bcrowe', 'anderst90', 'sunnyzsq', 'madducci', 'hall82', 'beckerd', 'agatons']",17,"['cochraj', 'nlantier', 'bminton', 'zkwok', 'cheinen', 'colemaj', 'lim107', 'lopez32', 'wandrews', 'tliberat', 'buck_ian', 'wang576', 'memo_juentes', 'li334', 'davis206', 'miguelgastelum', 'hamsini']",12,"['strachan', 'kharry', None, 'davids', 'jpicone', 'rstone', 'thir098', 'willi446', 'ankitrn', 'tlambros', 'takinfe', 'kstubbs12']",41,"['cochraj', 'strachan', 'zkwok', 'wandrews', 'tliberat', 'buck_ian', 'thir098', 'willi446', 'anderst90', 'li334', 'hall82', 'hamsini', 'tlambros', 'richarl', 'nlantier', 'kstubbs12', 'bminton', 'cheinen', 'colemaj', 'madducci', 'memo_juentes', 'davis206', 'ankitrn', 'takinfe', 'kharry', 'brumpke', 'rstone', 'lim107', 'bcrowe', 'mpavlic', 'sunnyzsq', None, 'miguelgastelum', 'agatons', 'burton13', 'davids', 'jpicone', 'lopez32', 'opierce', 'wang576', 'beckerd']"
17,274,30,13,9,"['cochraj', 'brumpke', 'burton13', 'cheinen', 'wandrews', 'sunnyzsq', 'wang576', 'li334', 'agatons']",20,"['zkwok', 'tliberat', 'buck_ian', 'hall82', 'anderst90', 'hamsini', 'richarl', 'nlantier', 'bminton', 'colemaj', 'madducci', 'memo_juentes', 'davis206', 'lim107', 'bcrowe', 'mpavlic', 'miguelgastelum', 'lopez32', 'opierce', 'beckerd']",4,"['redwing', 'jroland', None, 'ankitrn']",33,"['cochraj', 'zkwok', 'wandrews', 'tliberat', 'buck_ian', 'anderst90', 'li334', 'hall82', 'hamsini', 'jroland', 'richarl', 'nlantier', 'redwing', 'bminton', 'cheinen', 'colemaj', 'madducci', 'memo_juentes', 'davis206', 'ankitrn', 'brumpke', 'lim107', 'bcrowe', 'mpavlic', 'sunnyzsq', None, 'miguelgastelum', 'agatons', 'burton13', 'lopez32', 'opierce', 'wang576', 'beckerd']"
17,128,30,10,6,"['nlantier', 'lopez32', 'opierce', 'mpavlic', 'madducci', 'davis206']",23,"['cochraj', 'zkwok', 'wandrews', 'tliberat', 'buck_ian', 'hall82', 'li334', 'anderst90', 'hamsini', 'richarl', 'bminton', 'cheinen', 'colemaj', 'memo_juentes', 'brumpke', 'lim107', 'bcrowe', 'sunnyzsq', 'miguelgastelum', 'agatons', 'burton13', 'wang576', 'beckerd']",4,"['fox8', None, 'mbrant102', 'zhou118']",33,"['cochraj', 'mbrant102', 'zkwok', 'wandrews', 'tliberat', 'buck_ian', 'anderst90', 'li334', 'hall82', 'hamsini', 'richarl', 'nlantier', 'bminton', 'cheinen', 'colemaj', 'madducci', 'memo_juentes', 'davis206', 'zhou118', 'brumpke', 'lim107', 'bcrowe', 'mpavlic', 'sunnyzsq', None, 'miguelgastelum', 'agatons', 'burton13', 'lopez32', 'opierce', 'fox8', 'wang576', 'beckerd']"
18,201,25,7,5,"['btdaki', 'charderak', 'pablocas', 'bohr', 'fnoguer']",19,"['ortelius', 'gifbox', 'trino', 'tomasgrimm', 'lkslongo', 'pnelson', 'morningwind', 'rvherrero', 'ycyzyp', 'dyanali', 'ssob', 'aryannav', 'federphi', 'pmarrai', 'hayzwx', 'guadanha', 'awsch829', 'sachin789', 'baireuther']",2,"[None, 'elennim']",26,"['ortelius', 'gifbox', 'hayzwx', 'trino', 'tomasgrimm', 'guadanha', 'lkslongo', 'awsch829', 'pnelson', None, 'morningwind', 'fnoguer', 'baireuther', 'rvherrero', 'ycyzyp', 'btdaki', 'dyanali', 'charderak', 'ssob', 'elennim', 'aryannav', 'pablocas', 'bohr', 'federphi', 'sachin789', 'pmarrai']"
18,202,25,6,4,"['pmarrai', 'ssob', 'charderak', 'pablocas']",20,"['ortelius', 'gifbox', 'trino', 'tomasgrimm', 'lkslongo', 'pnelson', 'morningwind', 'fnoguer', 'rvherrero', 'ycyzyp', 'btdaki', 'dyanali', 'aryannav', 'federphi', 'hayzwx', 'guadanha', 'awsch829', 'baireuther', 'bohr', 'sachin789']",2,"['maribelarjona', None]",26,"['ortelius', 'gifbox', 'hayzwx', 'maribelarjona', 'trino', 'tomasgrimm', 'guadanha', 'lkslongo', 'awsch829', 'pnelson', None, 'morningwind', 'fnoguer', 'baireuther', 'rvherrero', 'ycyzyp', 'btdaki', 'dyanali', 'charderak', 'ssob', 'aryannav', 'pablocas', 'bohr', 'federphi', 'sachin789', 'pmarrai']"
19,204,25,14,13,"['sale', 'andzelo', 'grizzliess', 'meri_d', 'maja22', 'alek8stuki', 'sasho', 'sntcoso', 'cekovskabeti', 'duli', 'radeue', 'filip', 'slavica_07']",11,"['jeffchen', 'branko', 'faryer', 'miro', 'maga726', 'petar89', 'ivanivan', 'anastojkovic', 'elena', 'kiril86', 'mareks']",1,[None],25,"['jeffchen', 'branko', 'faryer', 'maja22', 'maga726', 'cekovskabeti', 'ivanivan', 'slavica_07', 'sntcoso', 'filip', 'sale', 'miro', 'meri_d', 'alek8stuki', 'radeue', 'petar89', None, 'sasho', 'andzelo', 'grizzliess', 'anastojkovic', 'elena', 'duli', 'kiril86', 'mareks']"
19,205,25,11,10,"['branko', 'meri_d', 'maja22', 'anastojkovic', 'ivanivan', 'petar89', 'kiril86', 'sntcoso', 'radeue', 'slavica_07']",14,"['sale', 'jeffchen', 'faryer', 'andzelo', 'mareks', 'miro', 'grizzliess', 'alek8stuki', 'maga726', 'sasho', 'cekovskabeti', 'elena', 'duli', 'filip']",1,[None],25,"['sale', 'jeffchen', 'branko', 'faryer', 'miro', 'meri_d', 'maja22', 'alek8stuki', 'maga726', 'cekovskabeti', 'petar89', 'ivanivan', 'kiril86', None, 'sasho', 'slavica_07', 'andzelo', 'mareks', 'grizzliess', 'duli', 'anastojkovic', 'elena', 'sntcoso', 'radeue', 'filip']"
19,206,25,9,3,"['maga726', 'mareks', 'miro']",21,"['jeffchen', 'branko', 'faryer', 'maja22', 'cekovskabeti', 'ivanivan', 'slavica_07', 'sntcoso', 'filip', 'sale', 'meri_d', 'alek8stuki', 'petar89', 'kiril86', 'sasho', 'andzelo', 'grizzliess', 'anastojkovic', 'elena', 'duli', 'radeue']",6,"['toc100', 'isankar21', 'tazima18', 'wy46', 'aizhangzhi', None]",30,"['sale', 'jeffchen', 'branko', 'faryer', 'toc100', 'miro', 'meri_d', 'maja22', 'alek8stuki', 'maga726', 'tazima18', 'cekovskabeti', 'petar89', 'ivanivan', 'aizhangzhi', 'kiril86', None, 'sasho', 'slavica_07', 'andzelo', 'mareks', 'isankar21', 'grizzliess', 'wy46', 'duli', 'anastojkovic', 'elena', 'sntcoso', 'radeue', 'filip']"
20,132,23,27,18,"['sntshraghavan', 'abbygoldman', 'testicle123', 'ccatania', 'larsgtb', 'petermage', 'andrewyip', 'arice343', 'cynxwang', 'wilsonn', 'jedouglas', 'ludomega82', 'lrettberg', 'leah9288', 'alanyliu', 'byonkee', 'cmacauley', 'tstan']",4,"['anjac07', 'neisenmenger', 'uli12345678', 'rbforesman']",9,"['bhoskins', 'ucsb_matrl_200b', 'nicoeagle89', 'emikheev', 'torim', 'bugmenot', 'davey', 'acpebley', None]",31,"['rbforesman', 'testicle123', 'emikheev', 'nicoeagle89', 'alanyliu', 'cmacauley', 'larsgtb', 'arice343', 'leah9288', 'sntshraghavan', 'anjac07', 'uli12345678', 'cynxwang', 'ludomega82', 'lrettberg', 'acpebley', 'byonkee', None, 'bhoskins', 'abbygoldman', 'ccatania', 'torim', 'petermage', 'andrewyip', 'wilsonn', 'jedouglas', 'neisenmenger', 'davey', 'bugmenot', 'ucsb_matrl_200b', 'tstan']"
21,180,21,22,17,"['mmatda1976', 'kymera', 'ahmed88', 'nahlaelazab', 'msawaby', 'mohmmad_mahusin', 'aktkira', 'mahmoud1986', 'ratshih', 'mariaaaa', 'ahussein', 'mohamed2011', 'fayezelsisy', 'helionpower', 'himahmoud', 'auchy', 'ibrahemmetwally77']",3,"['nicolas88', 'spax', 'kmbuck']",5,"['ranya_samy', 'samozeid', 'asoltan', 'shaker', None]",25,"['nahlaelazab', 'aktkira', 'ratshih', 'mohamed2011', 'fayezelsisy', 'himahmoud', 'samozeid', 'ibrahemmetwally77', 'mmatda1976', 'kymera', 'ahmed88', 'msawaby', 'asoltan', 'helionpower', 'auchy', 'ranya_samy', 'kmbuck', 'mohmmad_mahusin', 'mahmoud1986', 'mariaaaa', None, 'ahussein', 'nicolas88', 'shaker', 'spax']"
21,138,21,9,6,"['msawaby', 'mariaaaa', 'ratshih', 'helionpower', 'fayezelsisy', 'auchy']",14,"['mmatda1976', 'kymera', 'ahmed88', 'nahlaelazab', 'nicolas88', 'kmbuck', 'mohmmad_mahusin', 'aktkira', 'mahmoud1986', 'ahussein', 'mohamed2011', 'himahmoud', 'spax', 'ibrahemmetwally77']",3,"[None, 'asoltan', 'shaker']",23,"['nahlaelazab', 'kmbuck', 'mohmmad_mahusin', 'aktkira', 'mahmoud1986', 'ratshih', 'mariaaaa', 'mohamed2011', 'fayezelsisy', 'himahmoud', None, 'ibrahemmetwally77', 'ahussein', 'mmatda1976', 'kymera', 'ahmed88', 'nicolas88', 'msawaby', 'asoltan', 'shaker', 'helionpower', 'auchy', 'spax']"
21,140,21,7,3,"['auchy', 'mariaaaa', 'fayezelsisy']",17,"['mmatda1976', 'kymera', 'ahmed88', 'nahlaelazab', 'nicolas88', 'msawaby', 'kmbuck', 'aktkira', 'mohmmad_mahusin', 'ratshih', 'mahmoud1986', 'ahussein', 'mohamed2011', 'helionpower', 'himahmoud', 'spax', 'ibrahemmetwally77']",4,"['ranya_samy', None, 'asoltan', 'shaker']",24,"['ranya_samy', 'nahlaelazab', 'kmbuck', 'mohmmad_mahusin', 'aktkira', 'mahmoud1986', 'ratshih', 'mariaaaa', 'mohamed2011', 'fayezelsisy', 'himahmoud', None, 'ibrahemmetwally77', 'ahussein', 'mmatda1976', 'kymera', 'ahmed88', 'nicolas88', 'msawaby', 'asoltan', 'shaker', 'helionpower', 'auchy', 'spax']"
22,186,21,23,6,"['matamor1', 'amit13012001', 'kjung8', 'kurtovi1', 'teweichang', 'chivukula3']",14,"['sadeghyazdi', 'aleeks', 'atamura', 'elopez29', 'mmousa', 'ppxmg', 'ksamadi', 'tusker888', 'pbanker85', 'marco__bellini', 'pc1', 'isanjeevsingh', 'ee403lecture', 'mrock']",17,"['albertczc', 'ckhuang999', 'weichunan', 'shong45', 'sixgallon', 'destrad3', 'ivansetiawan', 'meagher1', 'josephxu', 'rccarca', 'neumann9', 'starryjared', 'daiyuan1991', 'beran1', 'ragunat1', None, 'eszato']",37,"['sadeghyazdi', 'aleeks', 'albertczc', 'kjung8', 'mmousa', 'ppxmg', 'kurtovi1', 'starryjared', 'ragunat1', 'eszato', 'mrock', 'amit13012001', 'matamor1', 'ivansetiawan', 'rccarca', 'isanjeevsingh', 'ee403lecture', 'atamura', 'weichunan', 'shong45', 'sixgallon', 'ksamadi', 'tusker888', 'meagher1', 'teweichang', 'chivukula3', 'beran1', None, 'daiyuan1991', 'ckhuang999', 'elopez29', 'destrad3', 'josephxu', 'neumann9', 'pbanker85', 'marco__bellini', 'pc1']"
22,188,21,8,3,"['atamura', 'teweichang', 'pbanker85']",17,"['sadeghyazdi', 'aleeks', 'amit13012001', 'matamor1', 'kjung8', 'elopez29', 'mmousa', 'ppxmg', 'ksamadi', 'tusker888', 'kurtovi1', 'marco__bellini', 'chivukula3', 'pc1', 'isanjeevsingh', 'ee403lecture', 'mrock']",5,"['winoto2', 'uzeta27', 'gavin_campbell', 'aditya_1978', None]",25,"['winoto2', 'sadeghyazdi', 'aleeks', 'uzeta27', 'atamura', 'kjung8', 'mmousa', 'ppxmg', 'ksamadi', 'tusker888', 'kurtovi1', 'teweichang', 'chivukula3', 'aditya_1978', None, 'mrock', 'amit13012001', 'matamor1', 'gavin_campbell', 'elopez29', 'pbanker85', 'marco__bellini', 'pc1', 'isanjeevsingh', 'ee403lecture']"
23,37,20,18,13,"['michelen', 'brune.12', 'mgram7', 'fengcheng90', 'dmills6788', 'xuxingchen', 'morton.168', 'khs5062', 'driegner', 'jkuper11', 'tsmithjr', 'nantolin', 'pitichon']",6,"['tomstearns', 'blwill', 'zhmed', 'kent.169', 'djedidi', 'channagiri.1']",5,"['chembebo', 'paranjape2', 'timmymaster7', None, 'duxin']",24,"['michelen', 'brune.12', 'chembebo', 'dmills6788', 'tomstearns', 'blwill', 'djedidi', 'paranjape2', 'driegner', 'tsmithjr', None, 'duxin', 'mgram7', 'fengcheng90', 'zhmed', 'kent.169', 'xuxingchen', 'timmymaster7', 'khs5062', 'jkuper11', 'morton.168', 'nantolin', 'channagiri.1', 'pitichon']"
24,133,20,20,15,"['msbaghaee', 'raesteve', 'lanreogedengbe', 'aaboagye', 'sonic311', 'dkshinde', 'ochijehenry', 'ahmed12345', 'nsirelkhatim', 'kahogan', 'koreyc77', 'klrhineh', 'talal', 'ecennona', 'mahen5608']",4,"['magg', 'upam', 'tcvitanic', 'mahbub03']",5,"['davidjohnson', 'mmghazizadeh', 'rvmohan', None, 'davidjohnson50']",24,"['raesteve', 'tcvitanic', 'talal', 'ecennona', 'davidjohnson50', 'ahmed12345', 'rvmohan', 'nsirelkhatim', 'koreyc77', 'mahen5608', 'aaboagye', 'magg', 'dkshinde', 'mmghazizadeh', 'kahogan', None, 'sonic311', 'msbaghaee', 'lanreogedengbe', 'davidjohnson', 'upam', 'ochijehenry', 'klrhineh', 'mahbub03']"
25,186,20,23,15,"['albertczc', 'ckhuang999', 'shong45', 'weichunan', 'sixgallon', 'neumann9', 'ivansetiawan', 'meagher1', 'josephxu', 'rccarca', 'starryjared', 'beran1', 'ragunat1', 'daiyuan1991', 'eszato']",4,"['gavin_campbell', 'winoto2', 'shanesivan', 'vik579']",8,"['amit13012001', 'matamor1', 'kjung8', 'destrad3', 'kurtovi1', 'teweichang', 'chivukula3', None]",27,"['albertczc', 'kjung8', 'kurtovi1', 'starryjared', 'ragunat1', 'eszato', 'matamor1', 'amit13012001', 'gavin_campbell', 'ivansetiawan', 'rccarca', 'shanesivan', 'winoto2', 'shong45', 'weichunan', 'sixgallon', 'meagher1', 'vik579', 'teweichang', 'chivukula3', 'beran1', 'daiyuan1991', None, 'ckhuang999', 'neumann9', 'josephxu', 'destrad3']"
25,54,20,20,6,"['shong45', 'sixgallon', 'meagher1', 'starryjared', 'daiyuan1991', 'shanesivan']",13,"['winoto2', 'albertczc', 'gavin_campbell', 'weichunan', 'ckhuang999', 'neumann9', 'ivansetiawan', 'josephxu', 'rccarca', 'vik579', 'beran1', 'ragunat1', 'eszato']",14,"['ani3989', 'beozsy', 'ahmed19', None, 'vc15', 'gsee2', 'hailee', 'ortigar1', 'capota2', 'parkin1', 'djung31', 'aiyin_liu', 'wakewaker', 'shivare2']",33,"['albertczc', 'gsee2', 'ortigar1', 'capota2', 'djung31', 'starryjared', 'aiyin_liu', 'ragunat1', 'wakewaker', 'shivare2', 'eszato', 'beozsy', 'gavin_campbell', 'ivansetiawan', 'rccarca', 'hailee', 'shanesivan', 'winoto2', 'shong45', 'weichunan', 'sixgallon', 'meagher1', 'parkin1', 'vik579', 'beran1', 'ahmed19', 'daiyuan1991', None, 'ani3989', 'vc15', 'ckhuang999', 'neumann9', 'josephxu']"
25,161,20,17,12,"['winoto2', 'albertczc', 'ckhuang999', 'weichunan', 'shong45', 'neumann9', 'meagher1', 'josephxu', 'starryjared', 'daiyuan1991', 'ragunat1', 'shanesivan']",7,"['gavin_campbell', 'sixgallon', 'ivansetiawan', 'rccarca', 'vik579', 'beran1', 'eszato']",5,"['ren6', 'mwang53', 'bordain1', 'destrad3', None]",24,"['winoto2', 'albertczc', 'shong45', 'weichunan', 'sixgallon', 'mwang53', 'meagher1', 'vik579', 'starryjared', 'beran1', 'ragunat1', 'daiyuan1991', 'eszato', None, 'ren6', 'gavin_campbell', 'ckhuang999', 'bordain1', 'neumann9', 'ivansetiawan', 'josephxu', 'destrad3', 'rccarca', 'shanesivan']"
25,230,20,15,11,"['winoto2', 'ckhuang999', 'shong45', 'weichunan', 'neumann9', 'meagher1', 'starryjared', 'daiyuan1991', 'ragunat1', 'shanesivan', 'eszato']",8,"['albertczc', 'gavin_campbell', 'sixgallon', 'ivansetiawan', 'josephxu', 'rccarca', 'vik579', 'beran1']",4,"['ren6', 'mwang53', None, 'destrad3']",23,"['winoto2', 'albertczc', 'shong45', 'weichunan', 'sixgallon', 'mwang53', 'meagher1', 'vik579', 'starryjared', 'beran1', 'ragunat1', 'daiyuan1991', 'eszato', None, 'ren6', 'gavin_campbell', 'ckhuang999', 'neumann9', 'ivansetiawan', 'josephxu', 'destrad3', 'rccarca', 'shanesivan']"
25,162,20,11,6,"['winoto2', 'gavin_campbell', 'ivansetiawan', 'rccarca', 'vik579', 'shanesivan']",13,"['albertczc', 'ckhuang999', 'shong45', 'weichunan', 'sixgallon', 'neumann9', 'meagher1', 'josephxu', 'starryjared', 'beran1', 'ragunat1', 'daiyuan1991', 'eszato']",5,"['mwang53', 'hugo_lopez', 'laszlo', None, 'styoisworo']",24,"['winoto2', 'albertczc', 'shong45', 'weichunan', 'sixgallon', 'mwang53', 'meagher1', 'vik579', 'starryjared', 'hugo_lopez', 'beran1', 'ragunat1', 'daiyuan1991', 'eszato', None, 'styoisworo', 'gavin_campbell', 'ckhuang999', 'neumann9', 'ivansetiawan', 'josephxu', 'rccarca', 'laszlo', 'shanesivan']"
25,188,20,8,2,"['gavin_campbell', 'winoto2']",17,"['albertczc', 'ckhuang999', 'shong45', 'weichunan', 'sixgallon', 'neumann9', 'ivansetiawan', 'meagher1', 'josephxu', 'rccarca', 'vik579', 'starryjared', 'daiyuan1991', 'beran1', 'ragunat1', 'shanesivan', 'eszato']",6,"['uzeta27', 'atamura', 'pbanker85', 'aditya_1978', 'teweichang', None]",25,"['winoto2', 'uzeta27', 'albertczc', 'atamura', 'shong45', 'weichunan', 'sixgallon', 'meagher1', 'vik579', 'aditya_1978', 'teweichang', 'starryjared', 'beran1', 'ragunat1', 'daiyuan1991', 'eszato', None, 'gavin_campbell', 'ckhuang999', 'neumann9', 'ivansetiawan', 'josephxu', 'pbanker85', 'rccarca', 'shanesivan']"
25,231,20,7,5,"['winoto2', 'gavin_campbell', 'ivansetiawan', 'rccarca', 'vik579']",14,"['albertczc', 'ckhuang999', 'shong45', 'weichunan', 'sixgallon', 'neumann9', 'meagher1', 'josephxu', 'starryjared', 'daiyuan1991', 'beran1', 'ragunat1', 'shanesivan', 'eszato']",2,"[None, 'styoisworo']",21,"['winoto2', 'albertczc', 'shong45', 'weichunan', 'sixgallon', 'meagher1', 'vik579', 'starryjared', 'beran1', 'ragunat1', 'daiyuan1991', 'eszato', None, 'styoisworo', 'gavin_campbell', 'ckhuang999', 'neumann9', 'ivansetiawan', 'josephxu', 'rccarca', 'shanesivan']"
26,191,20,52,1,['nauman007'],18,"['sammael01', 'md.trujillo73', 'camil30', 'wrat93', 'vep87', 'jasrico', 'jaicas99', 'napiledo', 'df.castellanos1413', 'jd.pico2083', 'billyrevelo', 'hugosin89', 'samsonjet', 'dk.kuratomi1423', 'comediante', 'af.guerrero1210', 'timohnocanuck', 'davidar9182']",51,"['spaxorid', 'i_sameen', 'sajjad', 'adeelamin', 'el003', 'uzair', 'sheeraz', 'hiraimtiaz', 'basit', 'farooq141', 'hunaiz', 'tzs', 'ffm78692', 'reema_rizwan01', 'arsalan79', 'wahaj', 'ul08034', 'nabeelkhan634', 'danish_muneer', 'salma', 'saad_007', 'swaleha115', 'ayesha5910', 'adiljaliawala', 'anum72', 'arsal124', 'komal', 'alihaider', 'yousufmujahid', 'rahul1990', 'umar314', 'muhammad_ashfaq', 'mehwish', 'umerzia', 'marium98', 'misha_fawad', 'safiahrehman', 'faizi', None, 'adilabbas', 'javeria', 'tehreem', 'phool', 'shariq', 'yaser664', 'abbi', 'wajiyazafar', 'naveednano', 'fawadned0809', 'abdul_moiz', 'ul08044']",70,"['adeelamin', 'i_sameen', 'el003', 'uzair', 'jasrico', 'jaicas99', 'hiraimtiaz', 'basit', 'farooq141', 'hunaiz', 'tzs', 'arsalan79', 'nabeelkhan634', 'wrat93', 'danish_muneer', 'anum72', 'sammael01', 'komal', 'rahul1990', 'umar314', 'muhammad_ashfaq', 'df.castellanos1413', 'marium98', 'jd.pico2083', 'safiahrehman', 'faizi', 'adilabbas', 'nauman007', 'shariq', 'yaser664', 'naveednano', 'abdul_moiz', 'af.guerrero1210', 'ul08044', 'spaxorid', 'sajjad', 'sheeraz', 'vep87', 'reema_rizwan01', 'wahaj', 'comediante', 'md.trujillo73', 'ul08034', 'salma', 'saad_007', 'swaleha115', 'ayesha5910', 'billyrevelo', 'hugosin89', 'adiljaliawala', 'arsal124', 'alihaider', 'camil30', 'yousufmujahid', 'napiledo', 'mehwish', 'umerzia', 'misha_fawad', None, 'timohnocanuck', 'javeria', 'tehreem', 'phool', 'abbi', 'wajiyazafar', 'fawadned0809', 'samsonjet', 'dk.kuratomi1423', 'ffm78692', 'davidar9182']"
26,40,20,30,1,['nauman007'],18,"['sammael01', 'md.trujillo73', 'camil30', 'wrat93', 'vep87', 'jasrico', 'jaicas99', 'napiledo', 'df.castellanos1413', 'jd.pico2083', 'billyrevelo', 'hugosin89', 'samsonjet', 'dk.kuratomi1423', 'comediante', 'af.guerrero1210', 'timohnocanuck', 'davidar9182']",29,"['hiraimtiaz', 'farooq141', 'hunaiz', 'tzs', 'arsalan79', 'ul08034', 'abdulaleemshaikh', 'salma', 'danish', 'saad_007', 'anum72', 'arsal124', 'alihaider', 'yousufmujahid', 'rahul1990', 'umar314', 'muhammad_ashfaq', 'mehwish', 'marium98', 'misha_fawad', 'safiahrehman', 'faizi', None, 'adilabbas', 'phool', 'abbi', 'wajiyazafar', 'fawadned0809', 'ul08044']",48,"['vep87', 'jasrico', 'jaicas99', 'hiraimtiaz', 'farooq141', 'hunaiz', 'tzs', 'arsalan79', 'comediante', 'md.trujillo73', 'ul08034', 'wrat93', 'abdulaleemshaikh', 'salma', 'danish', 'saad_007', 'billyrevelo', 'hugosin89', 'anum72', 'arsal124', 'sammael01', 'alihaider', 'camil30', 'yousufmujahid', 'rahul1990', 'napiledo', 'umar314', 'muhammad_ashfaq', 'mehwish', 'df.castellanos1413', 'marium98', 'jd.pico2083', 'misha_fawad', 'safiahrehman', 'faizi', 'ul08044', None, 'adilabbas', 'timohnocanuck', 'nauman007', 'phool', 'abbi', 'wajiyazafar', 'fawadned0809', 'samsonjet', 'dk.kuratomi1423', 'af.guerrero1210', 'davidar9182']"
26,190,20,22,16,"['sammael01', 'md.trujillo73', 'camil30', 'wrat93', 'vep87', 'jasrico', 'jaicas99', 'napiledo', 'df.castellanos1413', 'jd.pico2083', 'billyrevelo', 'hugosin89', 'dk.kuratomi1423', 'comediante', 'af.guerrero1210', 'davidar9182']",3,"['nauman007', 'timohnocanuck', 'samsonjet']",6,"['jairo', None, 'linapch', 'am.villamil1467', 'jorgem93', 'gaonaf']",25,"['jairo', 'am.villamil1467', 'vep87', 'jasrico', 'jaicas99', 'jorgem93', 'comediante', 'md.trujillo73', 'wrat93', 'billyrevelo', 'hugosin89', 'gaonaf', 'sammael01', 'camil30', 'linapch', 'napiledo', 'df.castellanos1413', 'jd.pico2083', None, 'timohnocanuck', 'nauman007', 'samsonjet', 'dk.kuratomi1423', 'af.guerrero1210', 'davidar9182']"
26,38,20,14,12,"['sammael01', 'camil30', 'wrat93', 'jasrico', 'jaicas99', 'napiledo', 'df.castellanos1413', 'hugosin89', 'dk.kuratomi1423', 'comediante', 'af.guerrero1210', 'davidar9182']",7,"['nauman007', 'md.trujillo73', 'vep87', 'jd.pico2083', 'billyrevelo', 'samsonjet', 'timohnocanuck']",2,"['chiri93', None]",21,"['sammael01', 'camil30', 'vep87', 'jasrico', 'jaicas99', 'napiledo', 'df.castellanos1413', 'jd.pico2083', 'comediante', None, 'timohnocanuck', 'nauman007', 'md.trujillo73', 'wrat93', 'chiri93', 'billyrevelo', 'samsonjet', 'dk.kuratomi1423', 'hugosin89', 'af.guerrero1210', 'davidar9182']"
26,39,20,12,11,"['md.trujillo73', 'vep87', 'jaicas99', 'napiledo', 'df.castellanos1413', 'jd.pico2083', 'billyrevelo', 'hugosin89', 'dk.kuratomi1423', 'comediante', 'af.guerrero1210']",8,"['nauman007', 'sammael01', 'camil30', 'wrat93', 'jasrico', 'samsonjet', 'timohnocanuck', 'davidar9182']",1,[None],20,"['sammael01', 'camil30', 'vep87', 'jasrico', 'jaicas99', 'napiledo', 'df.castellanos1413', 'jd.pico2083', 'comediante', None, 'timohnocanuck', 'nauman007', 'md.trujillo73', 'wrat93', 'billyrevelo', 'samsonjet', 'dk.kuratomi1423', 'hugosin89', 'af.guerrero1210', 'davidar9182']"
26,45,20,12,10,"['md.trujillo73', 'comediante', 'wrat93', 'vep87', 'jasrico', 'jaicas99', 'df.castellanos1413', 'billyrevelo', 'hugosin89', 'af.guerrero1210']",9,"['nauman007', 'sammael01', 'camil30', 'napiledo', 'jd.pico2083', 'samsonjet', 'dk.kuratomi1423', 'timohnocanuck', 'davidar9182']",2,"[None, 's.olivares1120']",21,"['sammael01', 'camil30', 'vep87', 'jasrico', 'jaicas99', 'napiledo', 'df.castellanos1413', 's.olivares1120', 'jd.pico2083', 'comediante', None, 'timohnocanuck', 'nauman007', 'md.trujillo73', 'wrat93', 'billyrevelo', 'samsonjet', 'dk.kuratomi1423', 'hugosin89', 'af.guerrero1210', 'davidar9182']"
26,194,20,8,6,"['vep87', 'df.castellanos1413', 'billyrevelo', 'dk.kuratomi1423', 'comediante', 'davidar9182']",13,"['nauman007', 'sammael01', 'md.trujillo73', 'camil30', 'wrat93', 'jasrico', 'jaicas99', 'napiledo', 'jd.pico2083', 'samsonjet', 'hugosin89', 'af.guerrero1210', 'timohnocanuck']",2,"[None, 'jairoandres']",21,"['sammael01', 'camil30', 'vep87', 'jasrico', 'jaicas99', 'napiledo', 'df.castellanos1413', 'jd.pico2083', 'jairoandres', 'comediante', None, 'timohnocanuck', 'nauman007', 'md.trujillo73', 'wrat93', 'billyrevelo', 'samsonjet', 'dk.kuratomi1423', 'hugosin89', 'af.guerrero1210', 'davidar9182']"
27,125,19,18,15,"['mtran', 'himendoza1', 'jabrockett', 'dfnelson', 'philip.znamiec', 'awjones', 'jjpangilinan', 'njdunn', 'rtquan', 'rapolonio', 'demagpie', 'rwvetter', 'sadl', 'jorge_mendoza', 'jaminleung']",3,"['rjstrobel1', 'ecchow', 'ethanchow']",3,"[None, 'tkyaw', 'mmegan']",21,"['mtran', 'himendoza1', 'dfnelson', 'ecchow', 'jjpangilinan', 'awjones', 'tkyaw', 'ethanchow', 'demagpie', 'sadl', None, 'mmegan', 'jaminleung', 'jabrockett', 'philip.znamiec', 'njdunn', 'rtquan', 'rapolonio', 'rjstrobel1', 'rwvetter', 'jorge_mendoza']"
28,185,17,26,1,['bhgarcia'],15,"['jacastorena', 'earredondo', 'dereyes2', 'gvelasco', 'hrodri89', 'felipedea10', 'lavicente', 'eidelatorre', 'ledelgado2', 'jcmunoz5', 'mefurth', 'hugo_lopez', 'laszlo', 'eddiehub', 'jqramirez']",25,"['uzeta27', 'lrod1989', 'aavargas3', 'darix79', 'jccastro2', 'tarek90', 'rrodriguez91', 'josortega80', 'lauupadilla', 'aortiz24', 'cemartinez2', 'icereceres', 'jdtriggs', 'jcvicente', 'cmrodriguez', 'jfsalas2', 'cavalos9', None, 'arzaga27', 'yzgaribay', 'adiaz6', 'nmaxwell', 'wolffang01', 'melendeztony', 'jfcastillo33']",41,"['gvelasco', 'uzeta27', 'bhgarcia', 'lrod1989', 'aavargas3', 'ledelgado2', 'mefurth', 'hugo_lopez', 'darix79', 'jccastro2', 'eddiehub', 'tarek90', 'dereyes2', 'rrodriguez91', 'josortega80', 'lavicente', 'eidelatorre', 'lauupadilla', 'aortiz24', 'laszlo', 'cemartinez2', 'felipedea10', 'icereceres', 'jdtriggs', 'hrodri89', 'jcvicente', 'cmrodriguez', 'jfsalas2', 'cavalos9', 'earredondo', None, 'arzaga27', 'jqramirez', 'jacastorena', 'yzgaribay', 'adiaz6', 'nmaxwell', 'wolffang01', 'melendeztony', 'jfcastillo33', 'jcmunoz5']"
28,159,17,17,15,"['jacastorena', 'earredondo', 'dereyes2', 'gvelasco', 'hrodri89', 'bhgarcia', 'felipedea10', 'lavicente', 'eidelatorre', 'jcmunoz5', 'mefurth', 'hugo_lopez', 'laszlo', 'eddiehub', 'jqramirez']",1,['ledelgado2'],2,"['sahernandez3', None]",18,"['gvelasco', 'hrodri89', 'bhgarcia', 'ledelgado2', 'jcmunoz5', 'mefurth', 'hugo_lopez', 'earredondo', None, 'eddiehub', 'jqramirez', 'jacastorena', 'dereyes2', 'sahernandez3', 'lavicente', 'eidelatorre', 'laszlo', 'felipedea10']"
28,157,17,16,14,"['jacastorena', 'earredondo', 'dereyes2', 'gvelasco', 'jqramirez', 'hrodri89', 'bhgarcia', 'lavicente', 'eidelatorre', 'mefurth', 'hugo_lopez', 'laszlo', 'eddiehub', 'felipedea10']",2,"['ledelgado2', 'jcmunoz5']",2,"['sahernandez3', None]",18,"['gvelasco', 'hrodri89', 'bhgarcia', 'ledelgado2', 'jcmunoz5', 'mefurth', 'hugo_lopez', 'earredondo', None, 'eddiehub', 'jqramirez', 'jacastorena', 'dereyes2', 'sahernandez3', 'lavicente', 'eidelatorre', 'laszlo', 'felipedea10']"
28,139,17,15,12,"['dereyes2', 'jqramirez', 'hrodri89', 'bhgarcia', 'eidelatorre', 'laszlo', 'jcmunoz5', 'mefurth', 'hugo_lopez', 'earredondo', 'eddiehub', 'felipedea10']",4,"['jacastorena', 'ledelgado2', 'gvelasco', 'lavicente']",3,"['sahernandez3', None, 'stella']",19,"['gvelasco', 'hrodri89', 'bhgarcia', 'ledelgado2', 'jcmunoz5', 'mefurth', 'hugo_lopez', 'earredondo', 'stella', None, 'eddiehub', 'jqramirez', 'jacastorena', 'dereyes2', 'sahernandez3', 'lavicente', 'eidelatorre', 'laszlo', 'felipedea10']"
28,155,17,15,12,"['jacastorena', 'dereyes2', 'jqramirez', 'hrodri89', 'eidelatorre', 'laszlo', 'ledelgado2', 'jcmunoz5', 'mefurth', 'hugo_lopez', 'earredondo', 'felipedea10']",4,"['lavicente', 'gvelasco', 'bhgarcia', 'eddiehub']",3,"['sahernandez3', None, 'stella']",19,"['gvelasco', 'hrodri89', 'bhgarcia', 'ledelgado2', 'jcmunoz5', 'mefurth', 'hugo_lopez', 'earredondo', 'stella', None, 'eddiehub', 'jqramirez', 'jacastorena', 'dereyes2', 'sahernandez3', 'lavicente', 'eidelatorre', 'laszlo', 'felipedea10']"
28,164,17,15,13,"['jacastorena', 'dereyes2', 'gvelasco', 'jqramirez', 'bhgarcia', 'lavicente', 'eidelatorre', 'laszlo', 'ledelgado2', 'jcmunoz5', 'hugo_lopez', 'earredondo', 'felipedea10']",3,"['mefurth', 'hrodri89', 'eddiehub']",2,"['sahernandez3', None]",18,"['gvelasco', 'hrodri89', 'bhgarcia', 'ledelgado2', 'jcmunoz5', 'mefurth', 'hugo_lopez', 'earredondo', None, 'eddiehub', 'jqramirez', 'jacastorena', 'dereyes2', 'sahernandez3', 'lavicente', 'eidelatorre', 'laszlo', 'felipedea10']"
28,162,17,11,2,"['laszlo', 'hugo_lopez']",14,"['jacastorena', 'dereyes2', 'gvelasco', 'hrodri89', 'bhgarcia', 'felipedea10', 'lavicente', 'eidelatorre', 'ledelgado2', 'jcmunoz5', 'mefurth', 'earredondo', 'eddiehub', 'jqramirez']",9,"['winoto2', None, 'gavin_campbell', 'mwang53', 'ivansetiawan', 'rccarca', 'vik579', 'shanesivan', 'styoisworo']",25,"['winoto2', 'gvelasco', 'hrodri89', 'bhgarcia', 'mwang53', 'ledelgado2', 'jcmunoz5', 'mefurth', 'vik579', 'hugo_lopez', 'earredondo', None, 'eddiehub', 'jqramirez', 'jacastorena', 'styoisworo', 'dereyes2', 'gavin_campbell', 'lavicente', 'eidelatorre', 'ivansetiawan', 'rccarca', 'laszlo', 'shanesivan', 'felipedea10']"
29,261,16,18,15,"['libithababu', 'rachel', 'srini123', 'santhoshjeferson', 'rajmas92', 'nanoscienceku', 'bharathrock', 'kampa24', 'markdavid', 'eujenny', 'davidchidu', 'shannen31', 'fifaadhitya77', 'binojen', 'aasaan']",0,[],3,"['josv3209', 'kujurabhash', None]",18,"['libithababu', 'rachel', 'rajmas92', 'eujenny', 'santhoshjeferson', 'nanoscienceku', 'markdavid', 'aasaan', 'kujurabhash', 'davidchidu', 'binojen', None, 'srini123', 'josv3209', 'bharathrock', 'kampa24', 'shannen31', 'fifaadhitya77']"
30,18,15,9,6,"['jhbutle', 'jgrabow', 'ahtsou', 'dwabmayrjr', 'amschil', 'thaque']",8,"['peipeitantan', 'roygbiv1', 'yunusctn', 'kosger', 'webers', 'splichards', 'badger2006', 'ajbons']",3,"['rlocker', None, 'dgyablo']",17,"['amschil', 'peipeitantan', 'kosger', 'jhbutle', 'splichards', 'ahtsou', None, 'thaque', 'dgyablo', 'roygbiv1', 'rlocker', 'yunusctn', 'webers', 'badger2006', 'dwabmayrjr', 'ajbons', 'jgrabow']"
31,8,15,12,7,"['furkan', 'dkocaay', 'sssooosss', 'ahmetdgrmnc', 'iyidogan', 'semih', 'guzelturk']",7,"['spanosangelos', 'mackin', 'fangjian318', 'vinodg', 'denise267', 'sukruekinkocabas', 'iezenwa1']",5,"['e163026', 'fatihbilge', 'bytaktik', 'talhaerdem', None]",19,"['mackin', 'fangjian318', 'bytaktik', 'vinodg', 'talhaerdem', 'sukruekinkocabas', None, 'e163026', 'spanosangelos', 'furkan', 'fatihbilge', 'dkocaay', 'sssooosss', 'ahmetdgrmnc', 'iyidogan', 'semih', 'denise267', 'iezenwa1', 'guzelturk']"
32,212,15,18,13,"['samkdavis', 'jeff303', 'lintaopeach', 'mir20609', 'muratahan', 'fengze0421', 'yfjing', 'tanujgupta1987', 'gwc900', 'krickert', 'martydd', 'chrisengelhardt', 'paragdeshpande']",1,['wobrien87'],5,"['mrb716', 'hartze', 'cegras', 'cari', None]",19,"['jeff303', 'cegras', 'yfjing', 'tanujgupta1987', 'krickert', 'samkdavis', 'mrb716', 'martydd', 'lintaopeach', 'mir20609', 'cari', None, 'wobrien87', 'chrisengelhardt', 'paragdeshpande', 'hartze', 'muratahan', 'fengze0421', 'gwc900']"
33,4,14,21,11,"['bgraeser', 'karthiky', 'ytoh', 'jungujchoi', 'mcleods', 'jkamar', 'brookywat', 'peihsun', 'zhang655', 'mnelis', 'lrostro']",2,"['abaradwaj', 'leiyanggz']",10,"['qnian', 'metcalfa', None, 'kwon43', 'ckmiskin', 'wang779', 'ashahidi', 'brianlew', 'nelder', 'smith172']",23,"['abaradwaj', 'kwon43', 'bgraeser', 'mnelis', 'nelder', 'qnian', 'karthiky', 'jungujchoi', 'wang779', 'lrostro', 'metcalfa', 'ytoh', 'leiyanggz', 'jkamar', 'zhang655', 'peihsun', 'brianlew', None, 'smith172', 'mcleods', 'ckmiskin', 'brookywat', 'ashahidi']"
33,129,14,20,11,"['bgraeser', 'abaradwaj', 'karthiky', 'ytoh', 'jungujchoi', 'leiyanggz', 'mcleods', 'jkamar', 'peihsun', 'mnelis', 'lrostro']",2,"['zhang655', 'brookywat']",9,"['qnian', 'metcalfa', 'kwon43', 'paulpurelar', 'dacongcong', 'ksingha', 'wang779', 'chinmay153', None]",22,"['abaradwaj', 'kwon43', 'dacongcong', 'bgraeser', 'mnelis', 'qnian', 'karthiky', 'jungujchoi', 'paulpurelar', 'ksingha', 'wang779', 'chinmay153', 'lrostro', 'metcalfa', 'ytoh', 'leiyanggz', 'jkamar', 'zhang655', 'peihsun', None, 'mcleods', 'brookywat']"
33,13,14,17,11,"['bgraeser', 'abaradwaj', 'ytoh', 'jungujchoi', 'leiyanggz', 'mcleods', 'brookywat', 'peihsun', 'zhang655', 'mnelis', 'lrostro']",2,"['jkamar', 'karthiky']",6,"['qnian', 'metcalfa', 'kwon43', 'dacongcong', 'wang779', None]",19,"['abaradwaj', 'metcalfa', 'kwon43', 'ytoh', 'dacongcong', 'leiyanggz', 'jkamar', 'zhang655', 'peihsun', 'bgraeser', 'mnelis', None, 'qnian', 'karthiky', 'jungujchoi', 'mcleods', 'wang779', 'brookywat', 'lrostro']"
33,32,14,15,11,"['bgraeser', 'abaradwaj', 'karthiky', 'ytoh', 'jungujchoi', 'mcleods', 'jkamar', 'brookywat', 'peihsun', 'mnelis', 'lrostro']",2,"['zhang655', 'leiyanggz']",4,"['ksingha', 'dacongcong', None, 'sumeetkumargupta']",17,"['abaradwaj', 'ytoh', 'dacongcong', 'leiyanggz', 'jkamar', 'zhang655', 'peihsun', 'bgraeser', 'mnelis', None, 'karthiky', 'jungujchoi', 'sumeetkumargupta', 'mcleods', 'ksingha', 'brookywat', 'lrostro']"
33,113,14,12,10,"['karthiky', 'jungujchoi', 'mcleods', 'jkamar', 'zhang655', 'brookywat', 'peihsun', 'bgraeser', 'mnelis', 'lrostro']",3,"['leiyanggz', 'abaradwaj', 'ytoh']",2,"['dacongcong', None]",15,"['abaradwaj', 'ytoh', 'dacongcong', 'leiyanggz', 'jkamar', 'zhang655', 'peihsun', 'bgraeser', 'mnelis', None, 'karthiky', 'jungujchoi', 'mcleods', 'brookywat', 'lrostro']"
33,30,14,7,6,"['karthiky', 'ytoh', 'jkamar', 'peihsun', 'mnelis', 'lrostro']",7,"['bgraeser', 'abaradwaj', 'jungujchoi', 'leiyanggz', 'mcleods', 'brookywat', 'zhang655']",1,[None],14,"['abaradwaj', 'ytoh', 'leiyanggz', 'jkamar', 'zhang655', 'peihsun', 'bgraeser', 'mnelis', None, 'karthiky', 'jungujchoi', 'mcleods', 'brookywat', 'lrostro']"
34,177,14,21,13,"['jrim317', 'joelpolchinski', 'oncu', 'cmstine', 'spatala', 'kampe', 'challan', 'cr18', 'paranjape2', 'wfrazier', 'sanders', 'anjanatalapatra', 'markdeguire']",0,[],8,"['zhouyang1991', 'laagesen', 'kthorn01', 'dempseyj', 'abhiks', 'km468', None, 'mrplich']",21,"['zhouyang1991', 'jrim317', 'laagesen', 'cr18', 'paranjape2', 'wfrazier', 'kthorn01', 'anjanatalapatra', 'km468', 'oncu', 'challan', 'dempseyj', 'sanders', None, 'markdeguire', 'joelpolchinski', 'cmstine', 'spatala', 'kampe', 'abhiks', 'mrplich']"
34,103,14,20,13,"['jrim317', 'joelpolchinski', 'oncu', 'cmstine', 'spatala', 'kampe', 'challan', 'cr18', 'paranjape2', 'wfrazier', 'sanders', 'anjanatalapatra', 'markdeguire']",0,[],7,"['laagesen', 'mdasta', 'bdarned', 'kthorn01', 'susanta', 'km468', None]",20,"['jrim317', 'laagesen', 'cr18', 'mdasta', 'paranjape2', 'wfrazier', 'bdarned', 'kthorn01', 'anjanatalapatra', 'km468', 'oncu', 'challan', 'sanders', 'susanta', None, 'markdeguire', 'joelpolchinski', 'cmstine', 'spatala', 'kampe']"
34,275,14,19,13,"['jrim317', 'joelpolchinski', 'oncu', 'cmstine', 'spatala', 'kampe', 'challan', 'cr18', 'paranjape2', 'wfrazier', 'sanders', 'anjanatalapatra', 'markdeguire']",0,[],6,"['mrplich', 'laagesen', 'mdasta', 'km468', None, 'jguyer']",19,"['jrim317', 'laagesen', 'cr18', 'mdasta', 'paranjape2', 'wfrazier', 'anjanatalapatra', 'km468', 'jguyer', 'oncu', 'challan', 'sanders', None, 'markdeguire', 'joelpolchinski', 'cmstine', 'spatala', 'kampe', 'mrplich']"
34,37,14,18,1,['paranjape2'],12,"['jrim317', 'joelpolchinski', 'oncu', 'cmstine', 'spatala', 'kampe', 'challan', 'cr18', 'wfrazier', 'sanders', 'anjanatalapatra', 'markdeguire']",17,"['michelen', 'brune.12', 'mgram7', 'fengcheng90', 'chembebo', 'dmills6788', 'xuxingchen', 'timmymaster7', 'morton.168', 'khs5062', 'driegner', 'jkuper11', 'duxin', 'tsmithjr', 'nantolin', None, 'pitichon']",30,"['michelen', 'brune.12', 'jrim317', 'chembebo', 'dmills6788', 'oncu', 'challan', 'cr18', 'paranjape2', 'wfrazier', 'driegner', 'sanders', 'anjanatalapatra', 'tsmithjr', None, 'markdeguire', 'duxin', 'mgram7', 'joelpolchinski', 'fengcheng90', 'cmstine', 'spatala', 'kampe', 'xuxingchen', 'timmymaster7', 'morton.168', 'khs5062', 'jkuper11', 'nantolin', 'pitichon']"
35,101,13,20,12,"['kisheon', 'zcasto64', 'labburi', 'lamas14', 'lonniebowe', 'qingwang', 'hannietono', 'elitegeek', 'oguzide', 'mdinc', 'benide89', 'nisshoku1729']",0,[],8,"['hoduc', 'aniketa', 'nhorvath', 'arice12', 'ureddy', 'whhoney', None, 'ctvano']",20,"['labburi', 'lamas14', 'ctvano', 'hoduc', 'aniketa', 'nhorvath', 'whhoney', 'hannietono', 'mdinc', 'ureddy', None, 'benide89', 'zcasto64', 'arice12', 'qingwang', 'elitegeek', 'oguzide', 'kisheon', 'lonniebowe', 'nisshoku1729']"
35,79,13,14,12,"['kisheon', 'zcasto64', 'labburi', 'lamas14', 'lonniebowe', 'qingwang', 'hannietono', 'elitegeek', 'oguzide', 'mdinc', 'benide89', 'nisshoku1729']",0,[],2,"[None, 'aniketa']",14,"['labburi', 'lamas14', None, 'benide89', 'kisheon', 'zcasto64', 'aniketa', 'qingwang', 'hannietono', 'elitegeek', 'oguzide', 'mdinc', 'lonniebowe', 'nisshoku1729']"
36,182,13,9,8,"['jele0701', 'kost0703', 'abha0702', 'sisa0703', 'robr0502', 'animesh', 'debr0702', 'sympathy112']",4,"['waje0501', 'shom0801', 'j1santos', 'trmo0601']",1,[None],13,"['jele0701', 'kost0703', 'sisa0703', None, 'shom0801', 'trmo0601', 'waje0501', 'abha0702', 'robr0502', 'j1santos', 'animesh', 'debr0702', 'sympathy112']"
38,169,12,24,9,"['kharry', 'davids', 'jpicone', 'rstone', 'thir098', 'willi446', 'tlambros', 'takinfe', 'kstubbs12']",2,"['ckopf', 'bvancure']",15,"['richarl', 'strachan', None, 'brumpke', 'burton13', 'opierce', 'beckerd', 'mpavlic', 'bcrowe', 'anderst90', 'sunnyzsq', 'madducci', 'hall82', 'ankitrn', 'agatons']",26,"['strachan', 'thir098', 'willi446', 'hall82', 'anderst90', 'tlambros', 'kstubbs12', 'richarl', 'ckopf', 'madducci', 'ankitrn', 'takinfe', 'kharry', 'brumpke', 'rstone', 'mpavlic', 'bcrowe', 'sunnyzsq', None, 'agatons', 'davids', 'burton13', 'jpicone', 'opierce', 'bvancure', 'beckerd']"
39,265,12,44,9,"['villalon', 'mbrefo9', 'csample', 'jbalchun', 'solee', 'kaitlinj', 'whuffman', 'venjamio', 'wagnert']",2,"['rmm2011', 'mgager']",35,"['hekopp', 'nzussbla', 'sstep117', 'dunnwi', 'mbagheri', 'pedrof1990', 'egargus', 'keve', 'jeesoo', 'hvincent', 'kolpak', 'afevans', 'ekrueger', 'clabaza13', 'jgrossman', 'smtjoy', 'dicksonw', 'ejohlin', 'cananea', 'helen', 'dondina', 'colleenloynachan', 'rdtaylor', 'mbreton', None, 'dengd33', 'cypark', 'shames', 'ambar91', 'anikagupta', 'linjia1984', 'kirby_d', 'phanvltt', 'lalbertorio', 'claudiar']",46,"['claudiar', 'solee', 'hekopp', 'nzussbla', 'sstep117', 'dunnwi', 'pedrof1990', 'mbagheri', 'egargus', 'keve', 'jeesoo', 'hvincent', 'villalon', 'kolpak', 'afevans', 'mgager', 'ekrueger', 'clabaza13', 'jgrossman', 'smtjoy', 'dicksonw', 'ejohlin', 'phanvltt', 'cananea', 'csample', 'dondina', 'colleenloynachan', 'helen', 'rdtaylor', 'mbreton', 'whuffman', None, 'rmm2011', 'mbrefo9', 'dengd33', 'jbalchun', 'cypark', 'shames', 'kaitlinj', 'ambar91', 'anikagupta', 'linjia1984', 'kirby_d', 'venjamio', 'lalbertorio', 'wagnert']"
39,83,12,41,10,"['villalon', 'mbrefo9', 'csample', 'mgager', 'solee', 'jbalchun', 'kaitlinj', 'whuffman', 'rmm2011', 'wagnert']",1,['venjamio'],31,"['hekopp', 'nzussbla', 'sstep117', 'dunnwi', 'pedrof1990', 'egargus', 'keve', 'hvincent', 'buehler', 'ekrueger', 'maxp', 'dicksonw', 'smtjoy', 'g_srikant80', 'dondina', 'colleenloynachan', 'rdtaylor', 'jtriley', 'mbreton', None, 'dengd33', 'elai', 'xiangk07', 'cypark', 'shames', 'xiangnandang', 'ambar91', 'linjia1984', 'kirby_d', 'phanvltt', 'claudiar']",42,"['claudiar', 'solee', 'hekopp', 'nzussbla', 'sstep117', 'dunnwi', 'pedrof1990', 'egargus', 'keve', 'hvincent', 'villalon', 'mgager', 'buehler', 'ekrueger', 'phanvltt', 'maxp', 'smtjoy', 'dicksonw', 'g_srikant80', 'csample', 'dondina', 'colleenloynachan', 'rdtaylor', 'jtriley', 'mbreton', 'whuffman', None, 'rmm2011', 'mbrefo9', 'dengd33', 'jbalchun', 'elai', 'xiangk07', 'cypark', 'kaitlinj', 'shames', 'xiangnandang', 'ambar91', 'linjia1984', 'kirby_d', 'venjamio', 'wagnert']"
39,253,12,28,8,"['villalon', 'mbrefo9', 'csample', 'mgager', 'solee', 'jbalchun', 'whuffman', 'wagnert']",3,"['kaitlinj', 'rmm2011', 'venjamio']",20,"['nzussbla', 'sstep117', 'pedrof1990', 'rosebud', 'egargus', 'keve', 'hvincent', 'ekrueger', 'clabaza13', 'dicksonw', 'smtjoy', 'dondina', 'colleenloynachan', 'mbreton', None, 'dengd33', 'cypark', 'shames', 'linjia1984', 'phanvltt']",31,"['solee', 'nzussbla', 'sstep117', 'pedrof1990', 'rosebud', 'egargus', 'keve', 'hvincent', 'villalon', 'mgager', 'ekrueger', 'clabaza13', 'phanvltt', 'dicksonw', 'smtjoy', 'csample', 'dondina', 'colleenloynachan', 'mbreton', 'whuffman', None, 'rmm2011', 'mbrefo9', 'dengd33', 'jbalchun', 'cypark', 'shames', 'kaitlinj', 'linjia1984', 'venjamio', 'wagnert']"
39,250,12,26,7,"['villalon', 'csample', 'mgager', 'jbalchun', 'solee', 'whuffman', 'wagnert']",4,"['mbrefo9', 'kaitlinj', 'rmm2011', 'venjamio']",19,"['hekopp', 'nzussbla', 'pedrof1990', 'egargus', 'keve', 'hvincent', 'ekrueger', 'smtjoy', 'deeni', 'colleenloynachan', 'rdtaylor', 'mbreton', None, 'dengd33', 'ambar91', 'shames', 'linjia1984', 'phanvltt', 'afevans']",30,"['solee', 'hekopp', 'nzussbla', 'pedrof1990', 'egargus', 'keve', 'hvincent', 'villalon', 'afevans', 'mgager', 'ekrueger', 'phanvltt', 'smtjoy', 'deeni', 'csample', 'colleenloynachan', 'rdtaylor', 'mbreton', 'whuffman', None, 'rmm2011', 'mbrefo9', 'dengd33', 'jbalchun', 'ambar91', 'shames', 'kaitlinj', 'linjia1984', 'venjamio', 'wagnert']"
39,65,12,23,6,"['villalon', 'csample', 'jbalchun', 'solee', 'whuffman', 'wagnert']",5,"['mbrefo9', 'mgager', 'kaitlinj', 'venjamio', 'rmm2011']",17,"['egargus', 'mbreton', 'keve', None, 'linjia1984', 'hvincent', 'dengd33', 'phanvltt', 'colleenloynachan', 'rdtaylor', 'ekrueger', 'hekopp', 'nzussbla', 'smtjoy', 'pedrof1990', 'dunnwi', 'deeni']",28,"['solee', 'hekopp', 'nzussbla', 'pedrof1990', 'dunnwi', 'egargus', 'keve', 'hvincent', 'villalon', 'mgager', 'ekrueger', 'phanvltt', 'smtjoy', 'deeni', 'csample', 'colleenloynachan', 'rdtaylor', 'mbreton', 'whuffman', None, 'rmm2011', 'mbrefo9', 'dengd33', 'jbalchun', 'kaitlinj', 'linjia1984', 'venjamio', 'wagnert']"
39,108,12,21,5,"['villalon', 'csample', 'kaitlinj', 'whuffman', 'wagnert']",6,"['mbrefo9', 'mgager', 'jbalchun', 'solee', 'venjamio', 'rmm2011']",16,"['egargus', 'linjia1984', 'keve', 'hvincent', 'dengd33', 'colleenloynachan', 'rdtaylor', 'ambar91', 'kirby_d', 'clabaza13', 'nzussbla', 'smtjoy', 'sstep117', 'pedrof1990', 'phanvltt', None]",27,"['solee', 'nzussbla', 'sstep117', 'pedrof1990', 'egargus', 'keve', 'hvincent', 'villalon', 'mgager', 'clabaza13', 'phanvltt', 'smtjoy', 'csample', 'colleenloynachan', 'rdtaylor', 'whuffman', None, 'rmm2011', 'mbrefo9', 'dengd33', 'jbalchun', 'ambar91', 'kaitlinj', 'linjia1984', 'kirby_d', 'venjamio', 'wagnert']"
39,61,12,20,3,"['villalon', 'mgager', 'wagnert']",8,"['mbrefo9', 'csample', 'jbalchun', 'solee', 'kaitlinj', 'whuffman', 'venjamio', 'rmm2011']",17,"['emcd2692', 'linjia1984', 'keve', 'hvincent', 'colleenloynachan', 'elai', 'rdtaylor', 'kirby_d', 'shames', 'ekrueger', 'hekopp', 'nzussbla', 'maxp', 'dunnwi', 'pedrof1990', None, 'smtjoy']",28,"['csample', 'colleenloynachan', 'solee', 'rdtaylor', 'kirby_d', 'smtjoy', 'hekopp', 'nzussbla', 'whuffman', 'dunnwi', 'pedrof1990', None, 'rmm2011', 'emcd2692', 'keve', 'hvincent', 'villalon', 'mbrefo9', 'mgager', 'jbalchun', 'elai', 'shames', 'kaitlinj', 'ekrueger', 'linjia1984', 'maxp', 'venjamio', 'wagnert']"
39,249,12,16,1,['wagnert'],10,"['villalon', 'mbrefo9', 'csample', 'mgager', 'solee', 'jbalchun', 'kaitlinj', 'whuffman', 'venjamio', 'rmm2011']",15,"['nzussbla', 'keve', 'hvincent', 'colleenloynachan', 'elai', 'rdtaylor', 'shames', 'ekrueger', 'hekopp', 'linjia1984', 'kirby_d', 'dunnwi', 'pedrof1990', None, 'maxp']",26,"['maxp', 'csample', 'colleenloynachan', 'solee', 'rdtaylor', 'hekopp', 'nzussbla', 'whuffman', 'dunnwi', 'pedrof1990', None, 'rmm2011', 'keve', 'hvincent', 'villalon', 'mbrefo9', 'mgager', 'jbalchun', 'elai', 'shames', 'kaitlinj', 'ekrueger', 'linjia1984', 'kirby_d', 'venjamio', 'wagnert']"
39,84,12,12,2,"['whuffman', 'venjamio']",9,"['villalon', 'mbrefo9', 'csample', 'mgager', 'solee', 'jbalchun', 'kaitlinj', 'rmm2011', 'wagnert']",10,"['helen', 'colleenloynachan', 'xiangk07', 'clabaza13', 'anikagupta', 'dicksonw', 'sstep117', 'gtuyiringire', None, 'afevans']",21,"['csample', 'helen', 'colleenloynachan', 'solee', 'whuffman', 'sstep117', 'gtuyiringire', None, 'rmm2011', 'villalon', 'mbrefo9', 'afevans', 'mgager', 'jbalchun', 'xiangk07', 'kaitlinj', 'clabaza13', 'anikagupta', 'dicksonw', 'venjamio', 'wagnert']"
39,85,12,12,2,"['whuffman', 'venjamio']",9,"['villalon', 'mbrefo9', 'csample', 'mgager', 'solee', 'jbalchun', 'kaitlinj', 'rmm2011', 'wagnert']",10,"[None, 'dondina', 'colleenloynachan', 'xiangnandang', 'clabaza13', 'anikagupta', 'dicksonw', 'sstep117', 'gtuyiringire', 'deeni']",21,"['csample', 'dondina', 'colleenloynachan', 'solee', 'whuffman', 'sstep117', 'gtuyiringire', None, 'rmm2011', 'villalon', 'mbrefo9', 'mgager', 'jbalchun', 'xiangnandang', 'kaitlinj', 'clabaza13', 'anikagupta', 'dicksonw', 'venjamio', 'deeni', 'wagnert']"
39,254,12,11,2,"['villalon', 'venjamio']",9,"['mbrefo9', 'csample', 'mgager', 'jbalchun', 'solee', 'kaitlinj', 'whuffman', 'rmm2011', 'wagnert']",9,"['mbreton', 'dondina', 'buehler', 'clabaza13', 'anikagupta', 'kirby_d', 'sstep117', None, 'afevans']",20,"['csample', 'dondina', 'solee', 'mbreton', 'whuffman', 'sstep117', None, 'rmm2011', 'villalon', 'mbrefo9', 'afevans', 'mgager', 'jbalchun', 'buehler', 'kaitlinj', 'anikagupta', 'clabaza13', 'kirby_d', 'venjamio', 'wagnert']"
39,266,12,11,3,"['villalon', 'mbrefo9', 'venjamio']",8,"['csample', 'mgager', 'jbalchun', 'solee', 'kaitlinj', 'whuffman', 'rmm2011', 'wagnert']",8,"['dondina', 'clabaza13', 'anikagupta', 'dicksonw', 'mbreton', 'sstep117', 'dunnwi', None]",19,"['csample', 'dondina', 'solee', 'mbreton', 'whuffman', 'sstep117', 'dunnwi', None, 'rmm2011', 'villalon', 'mbrefo9', 'mgager', 'jbalchun', 'kaitlinj', 'anikagupta', 'clabaza13', 'dicksonw', 'venjamio', 'wagnert']"
39,251,12,10,2,"['mbrefo9', 'venjamio']",9,"['villalon', 'csample', 'mgager', 'jbalchun', 'solee', 'kaitlinj', 'whuffman', 'rmm2011', 'wagnert']",8,"['dondina', 'xiangnandang', 'clabaza13', 'anikagupta', 'kirby_d', 'sstep117', None, 'afevans']",19,"['csample', 'dondina', 'solee', 'whuffman', 'sstep117', None, 'rmm2011', 'villalon', 'mbrefo9', 'afevans', 'mgager', 'jbalchun', 'xiangnandang', 'kaitlinj', 'anikagupta', 'clabaza13', 'kirby_d', 'venjamio', 'wagnert']"
39,63,12,9,2,"['villalon', 'wagnert']",9,"['mbrefo9', 'csample', 'mgager', 'jbalchun', 'solee', 'kaitlinj', 'whuffman', 'venjamio', 'rmm2011']",7,"['hvincent', 'kirby_d', 'rdtaylor', 'ekrueger', 'maxp', 'pedrof1990', None]",18,"['csample', 'solee', 'rdtaylor', 'kirby_d', 'whuffman', 'pedrof1990', None, 'rmm2011', 'hvincent', 'villalon', 'mbrefo9', 'mgager', 'jbalchun', 'kaitlinj', 'ekrueger', 'maxp', 'venjamio', 'wagnert']"
39,66,12,9,2,"['mbrefo9', 'venjamio']",9,"['villalon', 'csample', 'mgager', 'jbalchun', 'solee', 'kaitlinj', 'whuffman', 'rmm2011', 'wagnert']",7,"['xiangnandang', 'anikagupta', 'clabaza13', 'dicksonw', 'dunnwi', None, 'afevans']",18,"['csample', 'solee', 'whuffman', 'dunnwi', None, 'rmm2011', 'villalon', 'mbrefo9', 'afevans', 'mgager', 'jbalchun', 'xiangnandang', 'kaitlinj', 'clabaza13', 'anikagupta', 'dicksonw', 'venjamio', 'wagnert']"
39,109,12,6,3,"['villalon', 'mbrefo9', 'venjamio']",8,"['csample', 'mgager', 'jbalchun', 'solee', 'kaitlinj', 'whuffman', 'rmm2011', 'wagnert']",3,"['mbreton', None, 'anikagupta']",14,"['villalon', 'mbrefo9', 'csample', 'mgager', 'solee', 'jbalchun', 'kaitlinj', 'anikagupta', 'mbreton', 'whuffman', 'venjamio', None, 'rmm2011', 'wagnert']"
41,245,11,12,5,"['anjanadissa', 'tharatch', 'hiapplegod', 'oyes252', 'laoconeth']",5,"['qzerolinep', 'so8836', 'maribelarjona', 'elennim', 'juno2006']",7,"['mint91', 'ssr01270', 'wannyk', 'alleyday', 'pharaoh1700', None, 'jkwon22']",17,"['anjanadissa', 'mint91', 'qzerolinep', 'so8836', 'maribelarjona', 'juno2006', 'hiapplegod', None, 'jkwon22', 'laoconeth', 'ssr01270', 'wannyk', 'elennim', 'alleyday', 'tharatch', 'pharaoh1700', 'oyes252']"
41,201,11,7,1,['elennim'],9,"['anjanadissa', 'qzerolinep', 'so8836', 'maribelarjona', 'juno2006', 'tharatch', 'hiapplegod', 'oyes252', 'laoconeth']",6,"['btdaki', 'charderak', 'pablocas', 'bohr', None, 'fnoguer']",16,"['anjanadissa', 'btdaki', 'qzerolinep', 'so8836', 'charderak', 'maribelarjona', 'elennim', 'juno2006', 'tharatch', 'pablocas', 'bohr', 'hiapplegod', None, 'oyes252', 'fnoguer', 'laoconeth']"
41,202,11,6,1,['maribelarjona'],9,"['anjanadissa', 'qzerolinep', 'so8836', 'elennim', 'juno2006', 'tharatch', 'hiapplegod', 'oyes252', 'laoconeth']",5,"['charderak', 'ssob', 'pablocas', None, 'pmarrai']",15,"['anjanadissa', 'qzerolinep', 'so8836', 'charderak', 'maribelarjona', 'ssob', 'elennim', 'pmarrai', 'juno2006', 'tharatch', 'pablocas', 'hiapplegod', None, 'oyes252', 'laoconeth']"
42,172,11,7,6,"['karen.marvin', 'dgayek', 'ramborambo555', 'aleninge', 'dnatour', 'jormor4']",4,"['lasruni', 'danieldd89', 'germanykahn', 'pine']",1,[None],11,"['lasruni', 'danieldd89', 'karen.marvin', 'pine', 'dgayek', 'ramborambo555', 'aleninge', 'germanykahn', 'dnatour', None, 'jormor4']"
43,14,11,9,4,"['rommel_kth', 't.kanazawa', 'sana123', 'himadri2000']",6,"['martin_holzbauer', 'sanaullah1986', 'farizah', 'indigoclay', 'alba452', 'mullenn']",5,"['karlfredrik', 'morinessan', 'froggen172', 'sufal', None]",15,"['martin_holzbauer', 'sanaullah1986', 'farizah', 'sufal', 'indigoclay', 'rommel_kth', None, 'mullenn', 'karlfredrik', 'morinessan', 'himadri2000', 'froggen172', 't.kanazawa', 'sana123', 'alba452']"
43,12,11,6,2,"['himadri2000', 'farizah']",8,"['martin_holzbauer', 'sanaullah1986', 'indigoclay', 't.kanazawa', 'sana123', 'rommel_kth', 'alba452', 'mullenn']",4,"['karlfredrik', 'morinessan', 'mksharma', None]",14,"['martin_holzbauer', 'karlfredrik', 'sanaullah1986', 'morinessan', 'himadri2000', 'farizah', 'mksharma', 'indigoclay', 't.kanazawa', 'sana123', 'rommel_kth', 'alba452', None, 'mullenn']"
44,177,11,21,3,"['zhouyang1991', 'dempseyj', 'abhiks']",7,"['sjmen', 'zmichels', 'ashrafalhajjeh', 'drkim31', 'dodla', 'emgates', 'naren2405']",18,"['jrim317', 'joelpolchinski', 'oncu', 'spatala', 'laagesen', 'cmstine', 'challan', 'cr18', 'kampe', 'paranjape2', 'wfrazier', 'kthorn01', 'km468', 'sanders', 'anjanatalapatra', None, 'mrplich', 'markdeguire']",28,"['zhouyang1991', 'sjmen', 'jrim317', 'oncu', 'laagesen', 'challan', 'dodla', 'cr18', 'paranjape2', 'emgates', 'wfrazier', 'kthorn01', 'dempseyj', 'sanders', 'anjanatalapatra', 'km468', None, 'markdeguire', 'joelpolchinski', 'ashrafalhajjeh', 'zmichels', 'drkim31', 'spatala', 'cmstine', 'kampe', 'abhiks', 'naren2405', 'mrplich']"
45,134,10,8,6,"['abollo3', 'abollo2', 'nannan', 'abollo4', 'booq', 'abollo1']",3,"['xinge', 'ntetreau', 'tacayuky']",2,"[None, 'abollo']",11,"['ntetreau', 'xinge', 'abollo3', 'nannan', 'abollo2', 'abollo', 'abollo4', 'booq', 'abollo1', 'tacayuky', None]"
45,135,10,8,6,"['xinge', 'abollo3', 'abollo2', 'abollo4', 'booq', 'abollo1']",3,"['ntetreau', 'tacayuky', 'nannan']",2,"[None, 'abollo']",11,"['ntetreau', 'xinge', 'abollo3', 'nannan', 'abollo2', 'abollo', 'abollo4', 'booq', 'abollo1', 'tacayuky', None]"
46,53,10,12,9,"['hsullan', 'vacheh', 'hooray', 'tsd2m', 'hyongx', 'swzhao', 'mohhsoh', 'pallavi1120', 'kshang']",0,[],3,"['hsrascon', 'chaqin', None]",12,"['vacheh', 'hooray', 'tsd2m', 'hyongx', 'swzhao', 'mohhsoh', None, 'kshang', 'hsullan', 'chaqin', 'hsrascon', 'pallavi1120']"
46,16,10,10,8,"['hsullan', 'vacheh', 'hooray', 'tsd2m', 'hyongx', 'swzhao', 'mohhsoh', 'pallavi1120']",1,['kshang'],2,"['jhihath', None]",11,"['vacheh', 'hooray', 'tsd2m', 'hyongx', 'swzhao', 'jhihath', 'mohhsoh', None, 'kshang', 'hsullan', 'pallavi1120']"
47,245,10,12,6,"['mint91', 'ssr01270', 'wannyk', 'alleyday', 'pharaoh1700', 'jkwon22']",3,"['touma161989', 'kwagjj', 'priscilla']",6,"['anjanadissa', 'tharatch', 'hiapplegod', None, 'oyes252', 'laoconeth']",15,"['anjanadissa', 'mint91', 'priscilla', 'touma161989', 'hiapplegod', None, 'jkwon22', 'laoconeth', 'kwagjj', 'ssr01270', 'wannyk', 'alleyday', 'tharatch', 'pharaoh1700', 'oyes252']"
48,86,10,10,8,"['pennyaries', 'wxq933', 'jonespr', 'jls066', 'dariuswheeler', 'mroenbeck', 'r3signation', 'demeng']",1,['shawn_sass'],2,"[None, 'andre545']",11,"['jonespr', 'mroenbeck', 'demeng', None, 'wxq933', 'jls066', 'dariuswheeler', 'shawn_sass', 'andre545', 'r3signation', 'pennyaries']"
49,127,10,9,3,"['hchiang7', 'cwen', 'adammortazavi']",6,"['rafaelmaciel', 'antonmmoore', 'satyaganesh12', 'steven16888', 'edisonzhao', 'catherin']",6,"['zsy1110', 'gashi001', 'bwinters', 'jchen046', None, 'ken_hwang']",15,"['zsy1110', 'hchiang7', 'rafaelmaciel', 'antonmmoore', 'gashi001', 'adammortazavi', 'bwinters', 'satyaganesh12', 'steven16888', 'cwen', 'jchen046', 'edisonzhao', None, 'catherin', 'ken_hwang']"
50,1,10,10,6,"['fredrik.bergflodt', 'hbanks12', 'simonbill', 'tonymc', 'kurto', 'mac2012']",3,"['aneeshnainani', 'cumaisse', 'akodigala']",4,"['minkowsky', 'sudarvizhi', None, 'mpendharkar']",13,"['akodigala', 'aneeshnainani', 'cumaisse', 'fredrik.bergflodt', 'hbanks12', 'tonymc', 'kurto', None, 'minkowsky', 'sudarvizhi', 'simonbill', 'mpendharkar', 'mac2012']"
50,2,10,9,5,"['fredrik.bergflodt', 'hbanks12', 'simonbill', 'tonymc', 'mac2012']",4,"['aneeshnainani', 'cumaisse', 'akodigala', 'kurto']",4,"['minkowsky', 'arditvelia', None, 'mpendharkar']",13,"['minkowsky', 'akodigala', 'arditvelia', 'aneeshnainani', 'cumaisse', 'fredrik.bergflodt', 'hbanks12', 'simonbill', 'tonymc', 'kurto', None, 'mpendharkar', 'mac2012']"
51,14,10,9,2,"['froggen172', 'sufal']",7,"['wellenius', 'bedougi007', 'kys86', 'ferhat', 'campuspoint2005', 'art_nugraha', 'gtvieira']",7,"['karlfredrik', 'morinessan', 'himadri2000', 't.kanazawa', 'sana123', 'rommel_kth', None]",16,"['wellenius', 'bedougi007', 'karlfredrik', 'morinessan', 'kys86', 'himadri2000', 'froggen172', 'ferhat', 'sufal', 'campuspoint2005', 'art_nugraha', 'gtvieira', 't.kanazawa', 'sana123', 'rommel_kth', None]"
53,75,9,16,1,['bdsfh0820'],7,"['santoshchiniwar', 'cjy8836', 'rajsre', 'amahmood', 'rosegray', 'ngmelkin', 'jvaldes']",15,"['lefthand86', 'last1004in', None, 'lht6050', 'whktmddn', 'mkshim34', 'seyeon625', 'redwanhq', 'kaist1728', 'sangick3929', 'tlarldnd', 'newnovel3000', 'yookwang285', 'jdj0524', 'jongkook90']",23,"['last1004in', 'lht6050', 'santoshchiniwar', 'whktmddn', 'cjy8836', 'bdsfh0820', 'redwanhq', 'rosegray', 'sangick3929', 'newnovel3000', 'ngmelkin', 'yookwang285', 'jdj0524', 'jongkook90', 'mkshim34', None, 'lefthand86', 'seyeon625', 'amahmood', 'rajsre', 'kaist1728', 'tlarldnd', 'jvaldes']"
54,43,9,130,3,"['parsoj', 'wang227', 'congshan']",5,"['lance', 'tocirahl', 'kylecaddigan', 'vishnunath822', 'martin14']",127,"['dhuang123', 'nookala', 'bae10', 'lucasmac37', 'moon1002', 'melurie03', 'oknoel', 'jlorozc2', 'fredhdx', 'redyoshi49q', 'lshi14', 'johns149', 'muneebahmed95', 'boertew1', 'sherrypri', 'snanav3', 'jkinne2', 'sfanou2', '1upgreenshroom', 'siwin2', 'sutchaya', 'neilchristanto', 'kumikknd', 'wang183', 'shawnwin1234', 'daybreak410039', 'ewalt1', 'coolcrew', 'tischer1', 'maddali1', 'cernaus1', 'hartant2', 'jiwonp224', 'hoang4', 'profballack', 'gong10', 'reebbhaa', 'alostu3', 'nanotie', 'malik15', 'alabi2', 'supermeatboy', 'roboemperor', 'mikenike', 'jclift3', 'yjaquinas', 'lidazhu1', 'menghuang', 'rushx1', 'wlee26', 'broll1', 'lu30', 'ssingh18', 'levitas1', 'dmoonxp5', None, 'qiu12', 'wanchoi1', 'spadin1', 'luiszelaya', 'keating7', 'hatfarm', 'blee51', 'maxcan', 'leiche1', 'samuelzhang', 'achavarria', 'mahed', 'jashari1', 'weberxzq', 'tatuhiro', 'rice14', 'pashea1', 'yuanweih', 'kwak27', 'zeqiuwu1', 'emma', 'foxytop', 'brittovivek', 'toblerone16', 'okekeoc1', 'bony', 'jksikai', 'nam18', 'szhang51', 'handa1', 'jataput1', 'miketeufel1', 'akshay17567', 'kilpatr2', 'sgrand2', 'mikeudelhofen', 'alex81388', 'mihrenoe', 'jtlust3', 'tchajed', 'aczerepak', 'stuber1', 'kim563', 'williamhn', 'taoyang', 'liyd', 'yun19', 'ddanielw', 'lee117', 'kchuang5', 'jain53', 'geethabijjam', 'ludao822', 'btanabe2', 'hasken1', 'kadakiy1', 'hchao2', 'nmisak', 'hazypensieve', 'ysun12', '8kobe24', 'hgao10', 'stephenyzc', 'genome852', 'morris57', 'wdyarthas', 'ucapssong', 'tsai11', 'yao10', 'panlei616', 'mraval']",135,"['dhuang123', 'nookala', 'bae10', 'lucasmac37', 'parsoj', 'moon1002', 'melurie03', 'oknoel', 'jlorozc2', 'fredhdx', 'redyoshi49q', 'lshi14', 'martin14', 'johns149', 'muneebahmed95', 'boertew1', 'sherrypri', 'kylecaddigan', 'snanav3', 'jkinne2', 'sfanou2', '1upgreenshroom', 'siwin2', 'sutchaya', 'neilchristanto', 'kumikknd', 'wang183', 'shawnwin1234', 'daybreak410039', 'ewalt1', 'coolcrew', 'maddali1', 'cernaus1', 'hartant2', 'jiwonp224', 'hoang4', 'profballack', 'gong10', 'reebbhaa', 'alostu3', 'nanotie', 'malik15', 'alabi2', 'supermeatboy', 'roboemperor', 'mikenike', 'jclift3', 'yjaquinas', 'lidazhu1', 'menghuang', 'lance', 'rushx1', 'wlee26', 'broll1', 'lu30', 'ssingh18', 'levitas1', 'dmoonxp5', None, 'qiu12', 'wanchoi1', 'spadin1', 'luiszelaya', 'keating7', 'hatfarm', 'blee51', 'maxcan', 'leiche1', 'samuelzhang', 'achavarria', 'mahed', 'jashari1', 'congshan', 'weberxzq', 'tatuhiro', 'rice14', 'pashea1', 'yuanweih', 'kwak27', 'zeqiuwu1', 'mraval', 'emma', 'foxytop', 'brittovivek', 'toblerone16', 'okekeoc1', 'bony', 'jksikai', 'nam18', 'szhang51', 'handa1', 'jataput1', 'tocirahl', 'miketeufel1', 'akshay17567', 'kilpatr2', 'sgrand2', 'mikeudelhofen', 'alex81388', 'wang227', 'mihrenoe', 'jtlust3', 'tchajed', 'aczerepak', 'stuber1', 'kim563', 'williamhn', 'taoyang', 'liyd', 'yun19', 'ddanielw', 'lee117', 'kchuang5', 'jain53', 'geethabijjam', 'ludao822', 'btanabe2', 'hasken1', 'kadakiy1', 'hchao2', 'nmisak', 'hazypensieve', 'ysun12', '8kobe24', 'hgao10', 'stephenyzc', 'genome852', 'morris57', 'vishnunath822', 'wdyarthas', 'ucapssong', 'tsai11', 'yao10', 'panlei616', 'tischer1']"
54,150,9,116,3,"['parsoj', 'wang227', 'congshan']",5,"['lance', 'tocirahl', 'kylecaddigan', 'vishnunath822', 'martin14']",113,"['achavarria', 'dhuang123', 'mahed', 'nookala', 'bae10', 'lucasmac37', 'weberxzq', 'chan32', 'case7', 'moon1002', 'pashea1', 'yuanweih', 'melurie03', 'b3nny312', 'oknoel', 'shapir11', 'kwak27', 'sunjialin', 'zeqiuwu1', 'emma', 'fredhdx', 'foxytop', 'jielv1', 'shawkat', 'okekeoc1', 'bony', 'nam18', 'moy21', 'johns149', 'muneebahmed95', 'szhang51', 'jataput1', 'boertew1', 'snanav3', 'miketeufel1', 'lupas2', 'kilpatr2', 'sgrand2', 'jkinne2', 'sfanou2', 'siwin2', 'sutchaya', 'mihrenoe', 'deasey1', 'neilchristanto', 'kumikknd', 'wang183', 'theerasit', 'shawnwin1234', 'jtlust3', 'daybreak410039', 'tchajed', 'banerje1', 'hardy6', 'stuber1', 'tischer1', 'kim563', 'maddali1', 'cernaus1', 'hartant2', 'jiwonp224', 'hoang4', 'gazdzia1', 'profballack', 'gong10', 'liyd', 'bector1', 'alostu3', 'nanotie', 'yun19', 'malik15', 'lee117', 'jain53', 'ludao822', 'supermeatboy', 'ericwoo1', 'feng12', 'aminenko', 'mikenike', 'jclift3', 'btanabe2', 'hasken1', 'hchao2', 'yjaquinas', 'lidazhu1', 'nmisak', 'hazypensieve', 'ysun12', '8kobe24', 'menghuang', 'novawater', 'stephenyzc', 'genome852', 'wlee26', 'ssingh18', 'morris57', None, 'devharlalka', 'ucapssong', 'qiu12', 'tsai11', 'wanchoi1', 'spadin1', 'luiszelaya', 'keating7', 'zhang291', 'uasyed2', 'blee51', 'panlei616', 'maxcan', 'leiche1', 'mraval', 'jefflale']",121,"['achavarria', 'dhuang123', 'mahed', 'nookala', 'bae10', 'lucasmac37', 'congshan', 'weberxzq', 'parsoj', 'chan32', 'case7', 'moon1002', 'pashea1', 'yuanweih', 'melurie03', 'b3nny312', 'oknoel', 'shapir11', 'kwak27', 'sunjialin', 'zeqiuwu1', 'emma', 'fredhdx', 'foxytop', 'jielv1', 'shawkat', 'okekeoc1', 'bony', 'martin14', 'nam18', 'moy21', 'johns149', 'muneebahmed95', 'szhang51', 'jataput1', 'boertew1', 'tocirahl', 'kylecaddigan', 'snanav3', 'miketeufel1', 'lupas2', 'kilpatr2', 'sgrand2', 'jkinne2', 'sfanou2', 'wang227', 'siwin2', 'sutchaya', 'mihrenoe', 'deasey1', 'neilchristanto', 'kumikknd', 'wang183', 'theerasit', 'shawnwin1234', 'jtlust3', 'daybreak410039', 'tchajed', 'banerje1', 'hardy6', 'stuber1', 'tischer1', 'kim563', 'maddali1', 'cernaus1', 'hartant2', 'jiwonp224', 'hoang4', 'gazdzia1', 'profballack', 'gong10', 'liyd', 'bector1', 'alostu3', 'nanotie', 'yun19', 'malik15', 'lee117', 'jain53', 'ludao822', 'supermeatboy', 'ericwoo1', 'feng12', 'aminenko', 'mikenike', 'jclift3', 'btanabe2', 'hasken1', 'hchao2', 'yjaquinas', 'lidazhu1', 'nmisak', 'hazypensieve', 'ysun12', '8kobe24', 'menghuang', 'novawater', 'lance', 'stephenyzc', 'genome852', 'wlee26', 'ssingh18', 'morris57', 'vishnunath822', None, 'devharlalka', 'ucapssong', 'qiu12', 'tsai11', 'wanchoi1', 'spadin1', 'luiszelaya', 'keating7', 'zhang291', 'uasyed2', 'blee51', 'panlei616', 'maxcan', 'leiche1', 'mraval', 'jefflale']"
54,44,9,43,2,"['tocirahl', 'congshan']",6,"['wang227', 'parsoj', 'lance', 'kylecaddigan', 'vishnunath822', 'martin14']",41,"['powerplayer7', 'chan1cyrus2', 'ekapin2', 'bector1', 'xiaoyr068', 'yuanweih', 'bhchen2', 'sunjialin', 'gobias', 'esanch29', 'griffi21', 'jkim331', 'lnicklaus', 'a2104707', 'ericwoo1', 'feng12', 'btanabe2', 'heebidiwup', 'lidazhu1', 'gloger', 'gavinwinkel', 'mazzola1', 'lupas2', None, 'devharlalka', 'alex81388', 'baoshi314', 'theerasit', 'deasey1', 'weber36', 'vargas3', 'hatfarm', 'yao10', 'jtlust3', 'omghaxcode', 'hardy6', 'banerje1', 'jefflale', 'tsai11', 'trovill1', 'cernaus1']",49,"['powerplayer7', 'congshan', 'ekapin2', 'parsoj', 'bector1', 'xiaoyr068', 'yuanweih', 'trovill1', 'bhchen2', 'sunjialin', 'gobias', 'esanch29', 'griffi21', 'jkim331', 'lnicklaus', 'a2104707', 'martin14', 'ericwoo1', 'feng12', 'btanabe2', 'heebidiwup', 'lidazhu1', 'gloger', 'gavinwinkel', 'mazzola1', 'lance', 'tocirahl', 'kylecaddigan', 'lupas2', 'vishnunath822', None, 'devharlalka', 'alex81388', 'wang227', 'baoshi314', 'theerasit', 'deasey1', 'weber36', 'vargas3', 'hatfarm', 'yao10', 'jtlust3', 'omghaxcode', 'hardy6', 'banerje1', 'jefflale', 'tsai11', 'chan1cyrus2', 'cernaus1']"
54,149,9,43,1,['tocirahl'],7,"['wang227', 'congshan', 'parsoj', 'lance', 'kylecaddigan', 'vishnunath822', 'martin14']",42,"['samuelzhang', 'powerplayer7', 'williamhn', 'ekapin2', 'xiaoyr068', 'yuanweih', 'trovill1', 'geschreyr', 'bhchen2', 'parks8', 'sunjialin', 'gobias', 'geethabijjam', 'madigan5', 'ludao822', 'esanch29', 'griffi21', 'jkim331', 'ericwoo1', 'greenwa1', 'kadakiy1', 'heebidiwup', 'gloger', 'mazzola1', 'pranavram', 'ssingh18', 'levitas1', None, 'wdyarthas', 'alex81388', 'weber36', 'theerasit', 'deasey1', 'lobert124', 'mayapati', 'wang183', 'hatfarm', 'jtlust3', 'zhang291', 'baker48', 'tsai11', 'chan1cyrus2']",50,"['samuelzhang', 'powerplayer7', 'chan1cyrus2', 'williamhn', 'congshan', 'ekapin2', 'parsoj', 'xiaoyr068', 'yuanweih', 'geschreyr', 'bhchen2', 'parks8', 'sunjialin', 'gobias', 'geethabijjam', 'madigan5', 'ludao822', 'esanch29', 'griffi21', 'jkim331', 'ericwoo1', 'martin14', 'greenwa1', 'kadakiy1', 'heebidiwup', 'gloger', 'mazzola1', 'lance', 'tocirahl', 'kylecaddigan', 'pranavram', 'ssingh18', 'vishnunath822', 'levitas1', None, 'wdyarthas', 'alex81388', 'wang227', 'weber36', 'theerasit', 'deasey1', 'lobert124', 'mayapati', 'wang183', 'hatfarm', 'jtlust3', 'zhang291', 'baker48', 'tsai11', 'trovill1']"
54,148,9,29,1,['lance'],7,"['wang227', 'congshan', 'parsoj', 'kylecaddigan', 'tocirahl', 'vishnunath822', 'martin14']",28,"['cshaffre', 'jill_freeland', 'ncorral2', 'thawley', 'sosany', 'roloscool', 'kennethom1', 'cwkimbrough', 'carlosatkins', 'tbatth', 'daveleon', 'shanmich10', 'hodgesprodges', 'kdorsain', 'rmclinch', 'cbrown25', 'elockett', 'jakedubya', 'dpleasan', 'dicksonsalim', 'sorubin2', 'sgrand2', None, 'ryanledbetter135', 'jmills6', 'carlthefuzzy1', 'chrisgoulet', 'tcopelan']",36,"['cshaffre', 'congshan', 'jill_freeland', 'parsoj', 'ncorral2', 'thawley', 'sosany', 'roloscool', 'kennethom1', 'cwkimbrough', 'carlosatkins', 'tbatth', 'daveleon', 'shanmich10', 'hodgesprodges', 'kdorsain', 'rmclinch', 'martin14', 'cbrown25', 'elockett', 'jakedubya', 'dpleasan', 'lance', 'tocirahl', 'kylecaddigan', 'dicksonsalim', 'sorubin2', 'sgrand2', 'vishnunath822', None, 'ryanledbetter135', 'wang227', 'jmills6', 'carlthefuzzy1', 'chrisgoulet', 'tcopelan']"
54,151,9,28,2,"['vishnunath822', 'martin14']",6,"['wang227', 'congshan', 'parsoj', 'lance', 'tocirahl', 'kylecaddigan']",26,"['thawley', 'roloscool', 'cwkimbrough', 'kgiacobazzi', 'tbatth', 'wente1', 'qliu9', 'diliber1', 'jielv1', 'fandi514', 'greenwa1', 'edavilax', 'handa1', 'cbrown25', 'yjaquinas', 'mroczek1', 'dferrell68', 'dahlke2', 'hronik1', 'dicksonsalim', 'sgrand2', None, 'ewalt1', 'badger1', 'chen425', 'chrisgoulet']",34,"['congshan', 'parsoj', 'thawley', 'roloscool', 'cwkimbrough', 'kgiacobazzi', 'tbatth', 'wente1', 'qliu9', 'diliber1', 'jielv1', 'fandi514', 'martin14', 'greenwa1', 'edavilax', 'handa1', 'cbrown25', 'yjaquinas', 'mroczek1', 'dferrell68', 'dahlke2', 'lance', 'tocirahl', 'kylecaddigan', 'hronik1', 'dicksonsalim', 'sgrand2', 'vishnunath822', None, 'wang227', 'ewalt1', 'badger1', 'chen425', 'chrisgoulet']"
54,46,9,21,2,"['vishnunath822', 'martin14']",6,"['wang227', 'congshan', 'parsoj', 'lance', 'tocirahl', 'kylecaddigan']",19,"['chan32', 'case7', 'kgiacobazzi', 'wente1', 'qliu9', 'jielv1', 'fandi514', 'greenwa1', 'edavilax', 'hasken1', 'swarley', 'mroczek1', 'dahlke2', 'hgao10', 'dicksonsalim', None, 'neilchristanto', 'ewalt1', 'chrisgoulet']",27,"['hasken1', 'swarley', 'mroczek1', 'dahlke2', 'congshan', 'hgao10', 'parsoj', 'lance', 'tocirahl', 'kylecaddigan', 'chan32', 'case7', 'dicksonsalim', 'vishnunath822', None, 'wang227', 'kgiacobazzi', 'wente1', 'neilchristanto', 'qliu9', 'jielv1', 'ewalt1', 'fandi514', 'martin14', 'chrisgoulet', 'greenwa1', 'edavilax']"
55,35,9,34,8,"['zuser.e', 'giovanni.ughi', 'avapope', 'agentcoop', 'asingh', 'pmurria', 'firoozehbkh', 'brendankhuang']",0,[],26,"['anahas', 'gpasha', 'msislam', 'can.xu', 'joebilkobailey', 'leemonti', 'ychoi57', 'sdagach', 'fatemeh.n', 'naveenkadasala', 'alatrive', 'sobh1', 'jaber2', 'mkeenan', 'tlu2', 'bio2012', 'shin44', 'sobh', 'meggie121', None, 'jiehejaneho', 'rxist525', 'bdlftth2', 'rattlebum', 'cblatter', 'tpinon']",34,"['anahas', 'gpasha', 'msislam', 'can.xu', 'joebilkobailey', 'leemonti', 'ychoi57', 'sdagach', 'fatemeh.n', 'firoozehbkh', 'naveenkadasala', 'alatrive', 'giovanni.ughi', 'sobh1', 'asingh', 'jaber2', 'mkeenan', 'brendankhuang', 'tlu2', 'zuser.e', 'bio2012', 'shin44', 'sobh', 'meggie121', 'agentcoop', None, 'jiehejaneho', 'rxist525', 'bdlftth2', 'avapope', 'rattlebum', 'cblatter', 'pmurria', 'tpinon']"
55,178,9,34,8,"['zuser.e', 'giovanni.ughi', 'avapope', 'agentcoop', 'asingh', 'pmurria', 'firoozehbkh', 'brendankhuang']",0,[],26,"['anahas', 'gpasha', 'msislam', 'can.xu', 'joebilkobailey', 'leemonti', 'ychoi57', 'sdagach', 'fatemeh.n', 'naveenkadasala', 'alatrive', 'sobh1', 'jaber2', 'mkeenan', 'tlu2', 'bio2012', 'shin44', 'sobh', 'meggie121', None, 'jiehejaneho', 'rxist525', 'bdlftth2', 'rattlebum', 'cblatter', 'tpinon']",34,"['anahas', 'gpasha', 'msislam', 'can.xu', 'joebilkobailey', 'leemonti', 'ychoi57', 'sdagach', 'fatemeh.n', 'firoozehbkh', 'naveenkadasala', 'alatrive', 'giovanni.ughi', 'sobh1', 'asingh', 'jaber2', 'mkeenan', 'brendankhuang', 'tlu2', 'zuser.e', 'bio2012', 'shin44', 'sobh', 'meggie121', 'agentcoop', None, 'jiehejaneho', 'rxist525', 'bdlftth2', 'avapope', 'rattlebum', 'cblatter', 'pmurria', 'tpinon']"
55,179,9,33,8,"['zuser.e', 'giovanni.ughi', 'avapope', 'agentcoop', 'asingh', 'pmurria', 'firoozehbkh', 'brendankhuang']",0,[],25,"['anahas', 'gpasha', 'msislam', 'can.xu', 'joebilkobailey', 'leemonti', 'ychoi57', 'sdagach', 'fatemeh.n', 'naveenkadasala', 'alatrive', 'jaber2', 'mkeenan', 'tlu2', 'bio2012', 'shin44', 'sobh', 'meggie121', None, 'jiehejaneho', 'rxist525', 'bdlftth2', 'rattlebum', 'cblatter', 'tpinon']",33,"['anahas', 'gpasha', 'msislam', 'can.xu', 'joebilkobailey', 'leemonti', 'ychoi57', 'sdagach', 'fatemeh.n', 'firoozehbkh', 'naveenkadasala', 'alatrive', 'giovanni.ughi', 'asingh', 'jaber2', 'mkeenan', 'brendankhuang', 'tlu2', 'zuser.e', 'bio2012', 'shin44', 'sobh', 'meggie121', 'agentcoop', None, 'jiehejaneho', 'rxist525', 'bdlftth2', 'avapope', 'rattlebum', 'cblatter', 'pmurria', 'tpinon']"
55,36,9,24,8,"['zuser.e', 'giovanni.ughi', 'avapope', 'agentcoop', 'asingh', 'pmurria', 'firoozehbkh', 'brendankhuang']",0,[],16,"['shin44', 'naveenkadasala', 'sobh', 'rxist525', 'gpasha', 'msislam', 'meggie121', 'bdlftth2', 'sobh1', 'joebilkobailey', 'jaber2', 'sdagach', 'rattlebum', 'mkeenan', None, 'tlu2']",24,"['gpasha', 'msislam', 'joebilkobailey', 'sdagach', 'firoozehbkh', 'naveenkadasala', 'giovanni.ughi', 'sobh1', 'asingh', 'jaber2', 'mkeenan', 'brendankhuang', 'tlu2', 'zuser.e', 'shin44', 'sobh', 'meggie121', 'agentcoop', None, 'rxist525', 'bdlftth2', 'avapope', 'rattlebum', 'pmurria']"
56,35,9,34,8,"['bio2012', 'alatrive', 'can.xu', 'leemonti', 'ychoi57', 'fatemeh.n', 'tpinon', 'jiehejaneho']",0,[],26,"['anahas', 'gpasha', 'msislam', 'joebilkobailey', 'sdagach', 'firoozehbkh', 'naveenkadasala', 'giovanni.ughi', 'sobh1', 'asingh', 'jaber2', 'mkeenan', 'brendankhuang', 'tlu2', 'zuser.e', 'shin44', 'sobh', 'meggie121', 'agentcoop', None, 'rxist525', 'bdlftth2', 'avapope', 'rattlebum', 'cblatter', 'pmurria']",34,"['anahas', 'gpasha', 'can.xu', 'msislam', 'joebilkobailey', 'leemonti', 'ychoi57', 'sdagach', 'fatemeh.n', 'firoozehbkh', 'naveenkadasala', 'alatrive', 'giovanni.ughi', 'sobh1', 'asingh', 'jaber2', 'mkeenan', 'brendankhuang', 'tlu2', 'bio2012', 'shin44', 'sobh', 'zuser.e', 'meggie121', 'agentcoop', None, 'jiehejaneho', 'rxist525', 'bdlftth2', 'avapope', 'rattlebum', 'cblatter', 'pmurria', 'tpinon']"
56,178,9,34,8,"['bio2012', 'alatrive', 'can.xu', 'leemonti', 'ychoi57', 'fatemeh.n', 'tpinon', 'jiehejaneho']",0,[],26,"['anahas', 'gpasha', 'msislam', 'joebilkobailey', 'sdagach', 'firoozehbkh', 'naveenkadasala', 'giovanni.ughi', 'sobh1', 'asingh', 'jaber2', 'mkeenan', 'brendankhuang', 'tlu2', 'zuser.e', 'shin44', 'sobh', 'meggie121', 'agentcoop', None, 'rxist525', 'bdlftth2', 'avapope', 'rattlebum', 'cblatter', 'pmurria']",34,"['anahas', 'gpasha', 'can.xu', 'msislam', 'joebilkobailey', 'leemonti', 'ychoi57', 'sdagach', 'fatemeh.n', 'firoozehbkh', 'naveenkadasala', 'alatrive', 'giovanni.ughi', 'sobh1', 'asingh', 'jaber2', 'mkeenan', 'brendankhuang', 'tlu2', 'bio2012', 'shin44', 'sobh', 'zuser.e', 'meggie121', 'agentcoop', None, 'jiehejaneho', 'rxist525', 'bdlftth2', 'avapope', 'rattlebum', 'cblatter', 'pmurria', 'tpinon']"
56,179,9,33,8,"['bio2012', 'alatrive', 'can.xu', 'leemonti', 'ychoi57', 'fatemeh.n', 'tpinon', 'jiehejaneho']",0,[],25,"['anahas', 'gpasha', 'msislam', 'joebilkobailey', 'sdagach', 'firoozehbkh', 'naveenkadasala', 'giovanni.ughi', 'asingh', 'jaber2', 'mkeenan', 'brendankhuang', 'tlu2', 'zuser.e', 'shin44', 'sobh', 'meggie121', 'agentcoop', None, 'rxist525', 'bdlftth2', 'avapope', 'rattlebum', 'cblatter', 'pmurria']",33,"['anahas', 'gpasha', 'can.xu', 'msislam', 'joebilkobailey', 'leemonti', 'ychoi57', 'sdagach', 'fatemeh.n', 'firoozehbkh', 'naveenkadasala', 'alatrive', 'giovanni.ughi', 'asingh', 'jaber2', 'mkeenan', 'brendankhuang', 'tlu2', 'bio2012', 'shin44', 'sobh', 'zuser.e', 'meggie121', 'agentcoop', None, 'jiehejaneho', 'rxist525', 'bdlftth2', 'avapope', 'rattlebum', 'cblatter', 'pmurria', 'tpinon']"
57,130,9,15,6,"['binhle', 'ankijin', 'saka23', 'dmarek', 'wendit', 'kregon']",2,"['sblb', 'toby870820']",9,"['fatemehafshar', 'keving', 'ndys', 'ashfiqua', 'adamgordon', 'anthony.santaguida', None, 'sinadhane', 'vanilla1124']",17,"['fatemehafshar', 'toby870820', 'keving', 'ndys', 'wendit', None, 'kregon', 'vanilla1124', 'binhle', 'sblb', 'ankijin', 'ashfiqua', 'saka23', 'dmarek', 'adamgordon', 'anthony.santaguida', 'sinadhane']"
57,3,9,6,4,"['wendit', 'sblb', 'binhle', 'toby870820']",4,"['saka23', 'dmarek', 'ankijin', 'kregon']",2,"[None, 'keving']",10,"['binhle', 'sblb', 'ankijin', 'toby870820', 'keving', 'saka23', 'dmarek', 'wendit', None, 'kregon']"
60,225,9,13,4,"['cp2586', 'ziqian', 'cstap91', 'slimwudi']",4,"['ruizh', 'acer562xup', 'oliviawei', 'diegoscara']",9,"['zeynep22', 'fabiez', 'lyldl', 'berkeleyeric', 'vmi2102', 'sixers0130', None, 'dragon88kt', 'ptg2106']",17,"['cp2586', 'lyldl', 'ruizh', 'vmi2102', 'slimwudi', 'sixers0130', 'ziqian', None, 'acer562xup', 'cstap91', 'oliviawei', 'zeynep22', 'fabiez', 'diegoscara', 'berkeleyeric', 'dragon88kt', 'ptg2106']"
61,89,8,132,4,"['sundar0301', 'hur6', 'searuff', 'jkim449']",3,"['sungbea89', 'mast5', 'dongdong']",128,"['dhuang123', 'nookala', 'bae10', 'moon1002', 'melurie03', 'b3nny312', 'oknoel', 'gobias', 'fredhdx', 'lshi14', 'esanch29', 'johns149', 'muneebahmed95', 'boertew1', 'sherrypri', 'snanav3', 'hronik1', 'jkinne2', 'sfanou2', '1upgreenshroom', 'siwin2', 'sutchaya', 'baoshi314', 'neilchristanto', 'kumikknd', 'wang183', 'savankadakiya', 'shawnwin1234', 'daybreak410039', 'ewalt1', 'coolcrew', 'maddali1', 'cernaus1', 'pranav9', 'hartant2', 'hoang4', 'profballack', 'gong10', 'nanotie', 'congshanwan', 'malik15', 'alabi2', 'madigan5', 'feng12', 'mjy5', 'mikenike', 'swarley', 'lidazhu1', 'yjaquinas', 'mazzola1', 'azam2', 'menghuang', 'wlee26', 'ssingh18', None, 'kim405', 'qiu12', 'zhangyj', 'wanchoi1', 'luiszelaya', 'keating7', 'blee51', 'maxcan', 'leiche1', 'chrisgoulet', 'samuelzhang', 'achavarria', 'mahed', 'liao24hoho', 'tatuhiro', 'pashea1', 'dubois1', 'geschreyr', 'zulueta1', 'shapir11', 'kwak27', 'zeqiuwu1', 'emma', 'foxytop', 'brittovivek', 'jielv1', 'toblerone16', 'okekeoc1', 'bony', 'nkingw', 'jksikai', 'nam18', 'szhang51', 'mim1c', 'jataput1', 'miketeufel1', 'lupas2', 'kilpatr2', 'sgrand2', 'mikeudelhofen', 'amnueyp1', 'mihrenoe', 'theerasit', 'jtlust3', 'aczerepak', 'stuber1', 'piyawon1', 'kim563', 'gazdzia1', 'williamhn', 'liyd', 'bector1', 'roloscool', 'yun19', 'ddanielw', 'kchuang5', 'jain53', 'mrwilsonsaid', 'ludao822', 'hasken1', 'hchao2', 'hazypensieve', 'gloger', 'ysun12', '8kobe24', 'hgao10', 'stephenyzc', 'genome852', 'morris57', 'ucapssong', 'tsai11', 'panlei616', 'tischer1']",135,"['dhuang123', 'nookala', 'bae10', 'dongdong', 'moon1002', 'melurie03', 'b3nny312', 'oknoel', 'sungbea89', 'gobias', 'fredhdx', 'lshi14', 'esanch29', 'johns149', 'muneebahmed95', 'boertew1', 'sherrypri', 'snanav3', 'hronik1', 'jkinne2', 'sfanou2', '1upgreenshroom', 'siwin2', 'sutchaya', 'baoshi314', 'neilchristanto', 'kumikknd', 'wang183', 'savankadakiya', 'shawnwin1234', 'daybreak410039', 'ewalt1', 'coolcrew', 'tischer1', 'maddali1', 'cernaus1', 'pranav9', 'hartant2', 'hoang4', 'profballack', 'gong10', 'nanotie', 'congshanwan', 'malik15', 'sundar0301', 'alabi2', 'madigan5', 'feng12', 'mjy5', 'mikenike', 'swarley', 'lidazhu1', 'yjaquinas', 'mazzola1', 'azam2', 'menghuang', 'wlee26', 'ssingh18', None, 'kim405', 'mast5', 'qiu12', 'zhangyj', 'wanchoi1', 'luiszelaya', 'keating7', 'blee51', 'maxcan', 'leiche1', 'chrisgoulet', 'samuelzhang', 'achavarria', 'mahed', 'liao24hoho', 'searuff', 'tatuhiro', 'pashea1', 'dubois1', 'geschreyr', 'zulueta1', 'shapir11', 'kwak27', 'zeqiuwu1', 'emma', 'foxytop', 'brittovivek', 'jielv1', 'toblerone16', 'okekeoc1', 'hur6', 'bony', 'nkingw', 'jksikai', 'nam18', 'szhang51', 'mim1c', 'jataput1', 'miketeufel1', 'lupas2', 'kilpatr2', 'sgrand2', 'mikeudelhofen', 'amnueyp1', 'mihrenoe', 'theerasit', 'jtlust3', 'aczerepak', 'stuber1', 'piyawon1', 'kim563', 'gazdzia1', 'williamhn', 'liyd', 'bector1', 'roloscool', 'yun19', 'ddanielw', 'kchuang5', 'jain53', 'mrwilsonsaid', 'ludao822', 'hasken1', 'hchao2', 'hazypensieve', 'gloger', 'ysun12', '8kobe24', 'hgao10', 'stephenyzc', 'genome852', 'morris57', 'ucapssong', 'jkim449', 'panlei616', 'tsai11']"
61,91,8,35,2,"['mast5', 'dongdong']",5,"['sungbea89', 'searuff', 'jkim449', 'sundar0301', 'hur6']",33,"['ekapin2', 'bector1', 'ltompki2', 'nima_one', 'bhchen2', 'parks8', 'sunjialin', 'diliber1', 'geethabijjam', 'jeeves631', 'jkim331', 'mjy5', 'heebidiwup', 'nmisak', 'gavinwinkel', 'gloger', 'mazzola1', 'sherrypri', 'lupas2', 'mattycat9000', 'ssingh18', 'levitas1', None, 'wdyarthas', 'alex81388', 'weber36', 'deasey1', 'savankadakiya', 'hatfarm', 'tchajed', 'omghaxcode', 'hardy6', 'tsai11']",40,"['searuff', 'ekapin2', 'bector1', 'dongdong', 'ltompki2', 'nima_one', 'bhchen2', 'sungbea89', 'parks8', 'sunjialin', 'diliber1', 'geethabijjam', 'sundar0301', 'jeeves631', 'jkim331', 'hur6', 'mjy5', 'heebidiwup', 'nmisak', 'gavinwinkel', 'gloger', 'mazzola1', 'sherrypri', 'lupas2', 'mattycat9000', 'ssingh18', 'levitas1', None, 'wdyarthas', 'alex81388', 'mast5', 'weber36', 'deasey1', 'savankadakiya', 'hatfarm', 'jkim449', 'tchajed', 'omghaxcode', 'hardy6', 'tsai11']"
61,93,8,34,2,"['mast5', 'dongdong']",5,"['sungbea89', 'searuff', 'jkim449', 'sundar0301', 'hur6']",32,"['bector1', 'xiaoyr068', 'ltompki2', 'nima_one', 'bhchen2', 'parks8', 'sunjialin', 'diliber1', 'geethabijjam', 'jkim331', 'griffi21', 'mjy5', 'heebidiwup', 'nmisak', 'gavinwinkel', 'gloger', 'mazzola1', 'sherrypri', 'lupas2', 'mattycat9000', 'ssingh18', 'levitas1', None, 'wdyarthas', 'alex81388', 'weber36', 'tsai11', 'hatfarm', 'tchajed', 'omghaxcode', 'jefflale', 'mraval']",39,"['searuff', 'bector1', 'dongdong', 'xiaoyr068', 'ltompki2', 'nima_one', 'bhchen2', 'mraval', 'sungbea89', 'parks8', 'sunjialin', 'diliber1', 'geethabijjam', 'sundar0301', 'jkim331', 'griffi21', 'hur6', 'mjy5', 'heebidiwup', 'nmisak', 'gavinwinkel', 'gloger', 'mazzola1', 'sherrypri', 'lupas2', 'mattycat9000', 'ssingh18', 'levitas1', None, 'wdyarthas', 'alex81388', 'mast5', 'weber36', 'hatfarm', 'jkim449', 'tchajed', 'omghaxcode', 'jefflale', 'tsai11']"
61,90,8,22,1,['hur6'],6,"['mast5', 'sungbea89', 'searuff', 'jkim449', 'sundar0301', 'dongdong']",21,"['ouldsaghir', 'chan32', 'case7', 'kgiacobazzi', 'wente1', 'qliu9', 'jielv1', 'fandi514', 'supermeatboy', 'roboemperor', 'red6290', 'greenwa1', 'edavilax', 'mroczek1', 'dahlke2', 'dicksonsalim', 'shamohan', None, 'neilchristanto', 'bdlftth2', 'lobert124']",28,"['ouldsaghir', 'mroczek1', 'dahlke2', 'searuff', 'chan32', 'supermeatboy', 'dongdong', 'case7', 'dicksonsalim', 'shamohan', None, 'mast5', 'kgiacobazzi', 'sungbea89', 'wente1', 'neilchristanto', 'qliu9', 'bdlftth2', 'lobert124', 'jkim449', 'sundar0301', 'jielv1', 'fandi514', 'hur6', 'roboemperor', 'red6290', 'greenwa1', 'edavilax']"
61,116,8,16,4,"['sungbea89', 'sundar0301', 'mast5', 'jkim449']",3,"['hur6', 'searuff', 'dongdong']",12,"['amnueyp1', 'mahed', 'nookala', 'bababu', 'bdlftth2', 'bobdole777', 'azam2', 'kejacs', 'blee51', None, 'rajaraj1', 'pranav9']",19,"['mahed', 'nookala', 'bababu', 'searuff', 'bobdole777', 'azam2', 'dongdong', None, 'amnueyp1', 'mast5', 'sungbea89', 'bdlftth2', 'jkim449', 'sundar0301', 'kejacs', 'blee51', 'hur6', 'rajaraj1', 'pranav9']"
61,117,8,8,2,"['hur6', 'searuff']",5,"['mast5', 'sungbea89', 'jkim449', 'sundar0301', 'dongdong']",6,"['tim.house2', 'alajevar', 'bdlftth2', 'jasperli', None, 'pmarkis0']",13,"['tim.house2', 'mast5', 'alajevar', 'sungbea89', 'bdlftth2', 'searuff', 'jkim449', 'jasperli', 'sundar0301', 'dongdong', 'hur6', None, 'pmarkis0']"
61,88,8,7,1,['sungbea89'],6,"['mast5', 'searuff', 'jkim449', 'sundar0301', 'dongdong', 'hur6']",6,"['mahed', 'siwin2', 'congshanwan', 'savankadakiya', 'panlei616', None]",13,"['mahed', 'mast5', 'siwin2', 'congshanwan', 'sungbea89', 'savankadakiya', 'searuff', 'jkim449', 'sundar0301', 'panlei616', 'dongdong', 'hur6', None]"
63,101,8,20,6,"['hoduc', 'nhorvath', 'arice12', 'ureddy', 'whhoney', 'ctvano']",1,['psrana'],14,"['kisheon', None, 'aniketa', 'zcasto64', 'labburi', 'lamas14', 'lonniebowe', 'qingwang', 'hannietono', 'elitegeek', 'oguzide', 'mdinc', 'benide89', 'nisshoku1729']",21,"['psrana', 'labburi', 'lamas14', 'ureddy', None, 'ctvano', 'benide89', 'kisheon', 'hoduc', 'aniketa', 'zcasto64', 'nhorvath', 'arice12', 'qingwang', 'whhoney', 'hannietono', 'elitegeek', 'oguzide', 'mdinc', 'lonniebowe', 'nisshoku1729']"
63,102,8,7,6,"['hoduc', 'nhorvath', 'arice12', 'ureddy', 'whhoney', 'ctvano']",1,['psrana'],1,[None],8,"['hoduc', 'nhorvath', 'arice12', 'psrana', 'ureddy', 'whhoney', None, 'ctvano']"
64,206,8,9,5,"['toc100', 'isankar21', 'tazima18', 'wy46', 'aizhangzhi']",2,"['lampader', 'mxx203']",4,"['maga726', None, 'mareks', 'miro']",11,"['toc100', 'miro', 'maga726', 'tazima18', 'lampader', 'aizhangzhi', None, 'isankar21', 'wy46', 'mxx203', 'mareks']"
66,43,8,130,6,"['jashari1', 'yao10', 'reebbhaa', 'redyoshi49q', 'rushx1', 'broll1']",1,['a2104707'],124,"['dhuang123', 'nookala', 'bae10', 'lucasmac37', 'parsoj', 'moon1002', 'melurie03', 'oknoel', 'jlorozc2', 'fredhdx', 'lshi14', 'johns149', 'muneebahmed95', 'boertew1', 'sherrypri', 'snanav3', 'jkinne2', 'sfanou2', '1upgreenshroom', 'siwin2', 'sutchaya', 'neilchristanto', 'kumikknd', 'wang183', 'shawnwin1234', 'daybreak410039', 'ewalt1', 'coolcrew', 'tischer1', 'maddali1', 'cernaus1', 'hartant2', 'jiwonp224', 'hoang4', 'profballack', 'gong10', 'alostu3', 'nanotie', 'malik15', 'alabi2', 'supermeatboy', 'roboemperor', 'mikenike', 'jclift3', 'yjaquinas', 'lidazhu1', 'menghuang', 'wlee26', 'lu30', 'ssingh18', 'levitas1', 'dmoonxp5', None, 'qiu12', 'wanchoi1', 'spadin1', 'luiszelaya', 'keating7', 'hatfarm', 'blee51', 'maxcan', 'leiche1', 'samuelzhang', 'achavarria', 'mahed', 'congshan', 'weberxzq', 'tatuhiro', 'rice14', 'pashea1', 'yuanweih', 'kwak27', 'zeqiuwu1', 'emma', 'foxytop', 'brittovivek', 'toblerone16', 'okekeoc1', 'bony', 'jksikai', 'nam18', 'szhang51', 'handa1', 'jataput1', 'miketeufel1', 'akshay17567', 'kilpatr2', 'sgrand2', 'mikeudelhofen', 'alex81388', 'wang227', 'mihrenoe', 'jtlust3', 'tchajed', 'aczerepak', 'stuber1', 'kim563', 'williamhn', 'taoyang', 'liyd', 'yun19', 'ddanielw', 'lee117', 'kchuang5', 'jain53', 'geethabijjam', 'ludao822', 'btanabe2', 'hasken1', 'kadakiy1', 'hchao2', 'nmisak', 'hazypensieve', 'ysun12', '8kobe24', 'hgao10', 'stephenyzc', 'genome852', 'morris57', 'wdyarthas', 'ucapssong', 'tsai11', 'panlei616', 'mraval']",131,"['dhuang123', 'nookala', 'bae10', 'lucasmac37', 'parsoj', 'moon1002', 'melurie03', 'oknoel', 'jlorozc2', 'fredhdx', 'redyoshi49q', 'lshi14', 'johns149', 'muneebahmed95', 'boertew1', 'sherrypri', 'snanav3', 'jkinne2', 'sfanou2', '1upgreenshroom', 'siwin2', 'sutchaya', 'neilchristanto', 'kumikknd', 'wang183', 'shawnwin1234', 'daybreak410039', 'ewalt1', 'coolcrew', 'maddali1', 'cernaus1', 'hartant2', 'jiwonp224', 'hoang4', 'reebbhaa', 'profballack', 'gong10', 'alostu3', 'nanotie', 'malik15', 'alabi2', 'supermeatboy', 'roboemperor', 'mikenike', 'jclift3', 'yjaquinas', 'lidazhu1', 'menghuang', 'rushx1', 'wlee26', 'broll1', 'lu30', 'ssingh18', 'levitas1', 'dmoonxp5', None, 'qiu12', 'wanchoi1', 'spadin1', 'luiszelaya', 'keating7', 'hatfarm', 'blee51', 'maxcan', 'leiche1', 'samuelzhang', 'achavarria', 'mahed', 'jashari1', 'congshan', 'weberxzq', 'tatuhiro', 'rice14', 'pashea1', 'yuanweih', 'kwak27', 'zeqiuwu1', 'mraval', 'emma', 'foxytop', 'brittovivek', 'toblerone16', 'okekeoc1', 'bony', 'jksikai', 'nam18', 'szhang51', 'handa1', 'jataput1', 'miketeufel1', 'akshay17567', 'kilpatr2', 'sgrand2', 'mikeudelhofen', 'alex81388', 'wang227', 'mihrenoe', 'jtlust3', 'tchajed', 'aczerepak', 'stuber1', 'kim563', 'williamhn', 'taoyang', 'liyd', 'yun19', 'ddanielw', 'lee117', 'kchuang5', 'jain53', 'geethabijjam', 'ludao822', 'a2104707', 'btanabe2', 'hasken1', 'kadakiy1', 'hchao2', 'nmisak', 'hazypensieve', 'ysun12', '8kobe24', 'hgao10', 'stephenyzc', 'genome852', 'morris57', 'wdyarthas', 'ucapssong', 'tsai11', 'yao10', 'panlei616', 'tischer1']"
66,69,8,118,7,"['jashari1', 'yao10', 'reebbhaa', 'redyoshi49q', 'broll1', 'rushx1', 'a2104707']",0,[],111,"['achavarria', 'samuelzhang', 'dhuang123', 'mahed', 'nookala', 'dwass', 'mintzo', 'izquier2', 'ouyang4', 'tatuhiro', 'moon1002', 'pashea1', 'zulueta1', 'b3nny312', 'shapir11', 'kwak27', 'hua5', 'fredhdx', 'lshi14', 'shawkat', 'echegil1', 'donner1', 'bradsnyder', 'nam18', 'vigneshka', 'jyao5', 'jksikai', 'johns149', 'muneebahmed95', 'szhang51', 'mim1c', 'jataput1', 'jayfurrie', 'sherrypri', 'hronik1', 'miketeufel1', 'sgrand2', 'sfanou2', 'mikeudelhofen', 'grace3050', 'dinger104', 'siwin2', 'sutchaya', 'mihrenoe', 'vargas3', 'kumikknd', 'neilchristanto', 'yuan11', 'shawnwin1234', 'daybreak410039', 'ewalt1', 'baker48', 'coolcrew', 'banerje1', 'aczerepak', 'stuber1', 'trovill1', 'chen338', 'kandel3', 'hartant2', 'jiwonp224', 'hoang4', 'williamhn', 'ahoboke', 'profballack', 'liyd', 'monnett1', 'alostu3', 'nanotie', 'chenhu1', 'ltompki2', 'malik15', 'lee117', 'surajmodi', 'lmendez2', 'madigan5', 'alabi2', 'ravitheja22', 'supermeatboy', 'red6290', 'ericwoo1', 'feng12', 'mikenike', 'jclift3', 'kadakiy1', 'hchao2', 'heebidiwup', 'yjaquinas', 'lidazhu1', 'nmisak', 'hazypensieve', 'dferrell68', 'hgao10', 'menghuang', 'stephenyzc', 'wlee26', 'lu30', 'morris57', None, 'qiu12', 'zhangyj', 'wanchoi1', 'luiszelaya', 'spadin1', 'keating7', 'blee51', 'panlei616', 'maxcan', 'leiche1', 'tischer1', 'jefflale']",118,"['achavarria', 'samuelzhang', 'dhuang123', 'mahed', 'nookala', 'dwass', 'jashari1', 'mintzo', 'izquier2', 'ouyang4', 'tatuhiro', 'moon1002', 'pashea1', 'zulueta1', 'b3nny312', 'shapir11', 'kwak27', 'hua5', 'fredhdx', 'redyoshi49q', 'lshi14', 'shawkat', 'echegil1', 'donner1', 'bradsnyder', 'nam18', 'vigneshka', 'jyao5', 'jksikai', 'johns149', 'muneebahmed95', 'szhang51', 'mim1c', 'jataput1', 'jayfurrie', 'sherrypri', 'hronik1', 'miketeufel1', 'sgrand2', 'sfanou2', 'mikeudelhofen', 'grace3050', 'dinger104', 'siwin2', 'sutchaya', 'mihrenoe', 'vargas3', 'kumikknd', 'neilchristanto', 'yuan11', 'shawnwin1234', 'daybreak410039', 'ewalt1', 'baker48', 'coolcrew', 'banerje1', 'aczerepak', 'stuber1', 'trovill1', 'chen338', 'kandel3', 'hartant2', 'jiwonp224', 'hoang4', 'williamhn', 'ahoboke', 'reebbhaa', 'profballack', 'liyd', 'monnett1', 'alostu3', 'nanotie', 'chenhu1', 'ltompki2', 'malik15', 'lee117', 'surajmodi', 'lmendez2', 'madigan5', 'alabi2', 'ravitheja22', 'a2104707', 'supermeatboy', 'ericwoo1', 'feng12', 'red6290', 'mikenike', 'jclift3', 'kadakiy1', 'hchao2', 'heebidiwup', 'yjaquinas', 'lidazhu1', 'nmisak', 'hazypensieve', 'dferrell68', 'hgao10', 'menghuang', 'stephenyzc', 'rushx1', 'wlee26', 'broll1', 'lu30', 'morris57', None, 'qiu12', 'zhangyj', 'wanchoi1', 'luiszelaya', 'yao10', 'spadin1', 'keating7', 'blee51', 'panlei616', 'maxcan', 'leiche1', 'tischer1', 'jefflale']"
66,44,8,43,2,"['a2104707', 'yao10']",5,"['jashari1', 'reebbhaa', 'redyoshi49q', 'rushx1', 'broll1']",41,"['powerplayer7', 'chan1cyrus2', 'congshan', 'ekapin2', 'bector1', 'xiaoyr068', 'yuanweih', 'bhchen2', 'sunjialin', 'gobias', 'esanch29', 'griffi21', 'jkim331', 'lnicklaus', 'ericwoo1', 'feng12', 'btanabe2', 'heebidiwup', 'lidazhu1', 'gloger', 'gavinwinkel', 'mazzola1', 'tocirahl', 'lupas2', None, 'devharlalka', 'alex81388', 'baoshi314', 'theerasit', 'deasey1', 'weber36', 'vargas3', 'hatfarm', 'jtlust3', 'omghaxcode', 'hardy6', 'banerje1', 'jefflale', 'tsai11', 'trovill1', 'cernaus1']",48,"['jashari1', 'powerplayer7', 'congshan', 'ekapin2', 'reebbhaa', 'bector1', 'xiaoyr068', 'yuanweih', 'trovill1', 'bhchen2', 'sunjialin', 'gobias', 'redyoshi49q', 'esanch29', 'griffi21', 'a2104707', 'jkim331', 'lnicklaus', 'ericwoo1', 'feng12', 'btanabe2', 'heebidiwup', 'lidazhu1', 'gloger', 'gavinwinkel', 'mazzola1', 'tocirahl', 'rushx1', 'lupas2', 'broll1', None, 'devharlalka', 'alex81388', 'baoshi314', 'theerasit', 'deasey1', 'weber36', 'vargas3', 'hatfarm', 'yao10', 'jtlust3', 'omghaxcode', 'hardy6', 'banerje1', 'jefflale', 'tsai11', 'chan1cyrus2', 'cernaus1']"
67,31,8,14,1,['yic035'],6,"['wobrien1', 'ashuhhley', 'ashishpal', 'quantumdotmaster', 'kati', 'live7550']",13,"['poy_nerd', 'bjhong', 'davidhall', 'tjenny', 'crekdestiny', 'negin', 'goanfigher', 'saharnaz', 'mokhtari', None, 'pallameh', 'prinseven', 'jstsmalley']",20,"['ashuhhley', 'poy_nerd', 'bjhong', 'davidhall', None, 'pallameh', 'live7550', 'prinseven', 'jstsmalley', 'yic035', 'tjenny', 'ashishpal', 'crekdestiny', 'negin', 'quantumdotmaster', 'goanfigher', 'saharnaz', 'mokhtari', 'kati', 'wobrien1']"
69,190,8,22,5,"['jairo', 'am.villamil1467', 'linapch', 'jorgem93', 'gaonaf']",2,"['bclauss', 'ystratakos']",17,"['sammael01', 'md.trujillo73', 'camil30', 'wrat93', 'vep87', 'jasrico', 'jaicas99', 'napiledo', 'df.castellanos1413', 'jd.pico2083', 'billyrevelo', 'hugosin89', 'af.guerrero1210', 'dk.kuratomi1423', 'comediante', None, 'davidar9182']",24,"['jairo', 'bclauss', 'sammael01', 'linapch', 'am.villamil1467', 'vep87', 'camil30', 'jasrico', 'jaicas99', 'napiledo', 'df.castellanos1413', 'jd.pico2083', 'jorgem93', 'comediante', None, 'ystratakos', 'md.trujillo73', 'wrat93', 'billyrevelo', 'af.guerrero1210', 'dk.kuratomi1423', 'hugosin89', 'gaonaf', 'davidar9182']"
71,141,7,19,5,"['t.hresil', 'jar.vecera', 'xschen01', 'yoyo_cz', 'jirkahromek']",1,['huserka.jozef'],14,"['aranid', 'housik', 'patik0', 'gmike', 'doktord7', 'bouri', 'c.honza', 'joskat', 'davejeking', 'matejka.lukas', 'xteska00', 'xmucha00', 'xkernd00', None]",20,"['aranid', 't.hresil', 'jar.vecera', 'bouri', 'huserka.jozef', 'doktord7', 'xmucha00', 'xteska00', 'xkernd00', None, 'patik0', 'matejka.lukas', 'gmike', 'c.honza', 'joskat', 'xschen01', 'yoyo_cz', 'davejeking', 'jirkahromek', 'housik']"
71,184,7,19,5,"['t.hresil', 'jar.vecera', 'xschen01', 'yoyo_cz', 'jirkahromek']",1,['huserka.jozef'],14,"['aranid', 'housik', 'patik0', 'gmike', 'doktord7', 'bouri', 'c.honza', 'joskat', 'davejeking', 'matejka.lukas', 'xteska00', 'xmucha00', 'xkernd00', None]",20,"['aranid', 't.hresil', 'jar.vecera', 'bouri', 'huserka.jozef', 'doktord7', 'xmucha00', 'xteska00', 'xkernd00', None, 'patik0', 'matejka.lukas', 'gmike', 'c.honza', 'joskat', 'xschen01', 'yoyo_cz', 'davejeking', 'jirkahromek', 'housik']"
71,59,7,12,6,"['t.hresil', 'jar.vecera', 'huserka.jozef', 'xschen01', 'yoyo_cz', 'jirkahromek']",0,[],6,"['berraneck', 'c.honza', 'bouri', 'housik', 'xkernd00', None]",12,"['t.hresil', 'jar.vecera', 'bouri', 'huserka.jozef', 'berraneck', 'xkernd00', None, 'c.honza', 'xschen01', 'yoyo_cz', 'jirkahromek', 'housik']"
71,142,7,11,1,['huserka.jozef'],5,"['t.hresil', 'jar.vecera', 'xschen01', 'yoyo_cz', 'jirkahromek']",10,"['skor89', 'xmarik02', None, 'j.brtnickz', 'chmela', 'sikula', 'ttom159', 'xvalic06', 'xurban22', 'ixoxi']",16,"['skor89', 't.hresil', 'xmarik02', 'j.brtnickz', 'jar.vecera', 'huserka.jozef', None, 'chmela', 'sikula', 'ttom159', 'xschen01', 'yoyo_cz', 'jirkahromek', 'xvalic06', 'xurban22', 'ixoxi']"
71,187,7,11,1,['huserka.jozef'],5,"['t.hresil', 'jar.vecera', 'xschen01', 'yoyo_cz', 'jirkahromek']",10,"['skor89', 'xmarik02', None, 'j.brtnickz', 'chmela', 'sikula', 'ttom159', 'xvalic06', 'xurban22', 'ixoxi']",16,"['skor89', 't.hresil', 'xmarik02', 'j.brtnickz', 'jar.vecera', 'huserka.jozef', None, 'chmela', 'sikula', 'ttom159', 'xschen01', 'yoyo_cz', 'jirkahromek', 'xvalic06', 'xurban22', 'ixoxi']"
71,221,7,10,6,"['t.hresil', 'jar.vecera', 'huserka.jozef', 'xschen01', 'yoyo_cz', 'jirkahromek']",0,[],4,"['xteska00', 'bouri', None, 'gmike']",10,"['t.hresil', 'jar.vecera', 'bouri', 'huserka.jozef', 'xteska00', None, 'gmike', 'xschen01', 'yoyo_cz', 'jirkahromek']"
71,217,7,9,5,"['t.hresil', 'jar.vecera', 'xschen01', 'yoyo_cz', 'jirkahromek']",1,['huserka.jozef'],4,"['xteska00', 'bouri', None, 'gmike']",10,"['t.hresil', 'gmike', 'jar.vecera', 'bouri', 'huserka.jozef', 'xschen01', 'yoyo_cz', 'jirkahromek', 'xteska00', None]"
71,216,7,8,1,['huserka.jozef'],5,"['t.hresil', 'jar.vecera', 'xschen01', 'yoyo_cz', 'jirkahromek']",7,"['skor89', 'j.brtnickz', 'chmela', 'sikula', 'ttom159', 'xurban22', None]",13,"['skor89', 't.hresil', 'j.brtnickz', 'chmela', 'sikula', 'ttom159', 'jar.vecera', 'huserka.jozef', 'xschen01', 'yoyo_cz', 'jirkahromek', 'xurban22', None]"
72,29,7,58,1,['joddolms'],5,"['a615045', 'kalrin', 'clowlide', 'lionanna', 'jyjeong']",57,"['kaoce', 'jjojjo888', 'yellowdie87', 'jachar01', 'wdswds', 'yosemo1', 'gochujang8', 'yuri9eoul', 'sunmook', 'zenorc', 'jym0275', 'ses0009', 'silvereyes87', 'sehuyn2', 'popburster', 'pjw1018', 'versatility', 'stalbert', 'm01140114', 'sjm3zzang', 'slekd7', 'gamma0burst', 'blueband902', 'djbumsangi', 'gaelstory', 'lmwon0912', 'min789', 'hcha71', 'pyi87', 'ses0008', 'soulk87', 'osijwn', 'tpgns0519', 'moya118', 'gagoholic', 'darkmingu', 'hoony0107', 'lhg123123', 'crazyman999', None, 'primeevir', 'kjh191013', 'rpdlarpdlxm', 'mylie', 'best546', 'rpdlarpdlxm1', 'no3suk', 'jane7090', 'hbl1030', 'yswqd', 'mychin9yu', 'sunhyun2745', 'hwangstars', 'doctork5', 'suhosin87', 'dlejrwo0410', 'cd8876']",63,"['kaoce', 'jjojjo888', 'jachar01', 'joddolms', 'yosemo1', 'zenorc', 'sunmook', 'ses0009', 'popburster', 'm01140114', 'sjm3zzang', 'gamma0burst', 'hcha71', 'pyi87', 'osijwn', 'kalrin', 'tpgns0519', 'moya118', 'clowlide', 'gagoholic', 'darkmingu', 'hoony0107', 'lhg123123', 'mylie', 'best546', 'rpdlarpdlxm1', 'no3suk', 'hwangstars', 'dlejrwo0410', 'jyjeong', 'cd8876', 'yellowdie87', 'wdswds', 'gochujang8', 'yuri9eoul', 'jym0275', 'silvereyes87', 'sehuyn2', 'pjw1018', 'versatility', 'stalbert', 'slekd7', 'blueband902', 'djbumsangi', 'gaelstory', 'lmwon0912', 'lionanna', 'min789', 'ses0008', 'a615045', 'soulk87', 'crazyman999', None, 'primeevir', 'kjh191013', 'rpdlarpdlxm', 'jane7090', 'hbl1030', 'yswqd', 'mychin9yu', 'sunhyun2745', 'doctork5', 'suhosin87']"
72,165,7,24,6,"['a615045', 'kalrin', 'joddolms', 'clowlide', 'lionanna', 'jyjeong']",0,[],18,"['hcha71', 'mylie', 'yosemo1', 'gamma0burst', 'zenorc', 'yuri9eoul', 'gochujang8', 'tarka', 'monytu', 'kdm52', 'lottoz', 'scapall', 'yswqd', 'mychin9yu', 'suhosin87', None, 'vrozooa', 'primeevir']",24,"['hcha71', 'a615045', 'kalrin', 'joddolms', 'yosemo1', 'gochujang8', 'yuri9eoul', 'zenorc', 'monytu', 'clowlide', 'kdm52', 'scapall', None, 'vrozooa', 'primeevir', 'mylie', 'gamma0burst', 'yswqd', 'tarka', 'mychin9yu', 'lottoz', 'suhosin87', 'lionanna', 'jyjeong']"
72,193,7,19,6,"['a615045', 'kalrin', 'joddolms', 'clowlide', 'lionanna', 'jyjeong']",0,[],13,"['dltjrqja04', 'yosemo1', 'gamma0burst', 'zenorc', 'monytu', 'scapall', 'shinhyuk001', 'lottoz', 'suhosin87', None, 'vrozooa', 'skadbsthf77', 'primeevir']",19,"['a615045', 'kalrin', 'joddolms', 'yosemo1', 'zenorc', 'monytu', 'scapall', 'clowlide', 'shinhyuk001', None, 'vrozooa', 'skadbsthf77', 'primeevir', 'dltjrqja04', 'gamma0burst', 'lottoz', 'suhosin87', 'lionanna', 'jyjeong']"
72,152,7,14,5,"['a615045', 'joddolms', 'clowlide', 'lionanna', 'jyjeong']",1,['kalrin'],9,"['gamma0burst', 'yosemo1', 'monytu', 'zenorc', 'scapall', 'suhosin87', None, 'vrozooa', 'primeevir']",15,"['a615045', 'kalrin', 'joddolms', 'yosemo1', 'monytu', 'zenorc', 'scapall', 'clowlide', None, 'vrozooa', 'primeevir', 'gamma0burst', 'suhosin87', 'lionanna', 'jyjeong']"
72,154,7,14,6,"['a615045', 'kalrin', 'joddolms', 'clowlide', 'lionanna', 'jyjeong']",0,[],8,"['rubicon777', 'yosemo1', 'gamma0burst', 'monytu', 'scapall', 'suhosin87', None, 'vrozooa']",14,"['rubicon777', 'a615045', 'kalrin', 'joddolms', 'monytu', 'yosemo1', 'scapall', 'clowlide', None, 'vrozooa', 'gamma0burst', 'suhosin87', 'lionanna', 'jyjeong']"
72,197,7,14,5,"['a615045', 'joddolms', 'clowlide', 'lionanna', 'jyjeong']",1,['kalrin'],9,"['gamma0burst', 'yosemo1', 'monytu', 'zenorc', 'lottoz', 'suhosin87', None, 'vrozooa', 'skadbsthf77']",15,"['a615045', 'kalrin', 'joddolms', 'yosemo1', 'monytu', 'zenorc', 'clowlide', None, 'vrozooa', 'skadbsthf77', 'gamma0burst', 'lottoz', 'suhosin87', 'lionanna', 'jyjeong']"
73,52,7,214,5,"['narokkurai', 'ebeck', 'shaloni', 'smuehrcke', 'mvh312']",1,['altequz1'],209,"['gretskyw', 'clynsky06', 'ellenchoe', 'lubben', 'mhs287', 'cgcizek', 'coolivia', 'jmarthouse', 'han607', 'naomimerer2015', 'roboro727', 'isabelrv', 'malbrecht', 'mjs718', 'ppairs', 'vnm816', 'smontgomery', 'dprivit', 'kiracalavera', 'chasebrewster2015', 'dct353', 'asonta', 'dsgarharda001', 'jrc699', 'helenl', 'ramanmichael2015', 'men544', 'jlamberth8', 'matthewmelamed2015', 'ninaor3', 'ajit326', 'jennmurphy11', 'wutangclan', 'barcatorres', 'chem102lab', 'frank.parilla', 'sysmith', 'sks491', 'jennastoehr2015', 'abl849', 'jcarrillo', 'eaf591', 'arouse', 'nfw17531', 'newcombjb', 'jkelter', 'sarahtoy', 'aseitz10', 'tpendergrast', 'robertfisch2015', 'ras423', 'jwr915', 'jthumel', 'cmd750', 'taizenman', 'dmalone', 'azaffer', 'valeriejchen', 'omowunmi', 'abeir', 'danaya707', 'jhr252', 'jem824', 'jnephan93', 'karlyroser2015', 'tjorda21', 'chrispontisakos', 'kas042', 'askowalczuk', 'mgrollins', 'apfeiffer', 'sms483', 'slk620', 'nabroady', 'samfoolery', 'lhelfrich', 'iasega', 'rcignoni', 'cleclerq', 'zhsueh', 'wcp795', 'jkwon66', 'css539', 'asv810', 'abh019', 'mbartnovsky', None, 'nshaw123', 'mrt728', 'msp793', 'alw490', 'jjgordo92', 'defenseman91', 'yfs322', 'nschmidt', 'sms618', 'ejn531', 'farzaankassam2015', 'jonfeldman', 'rachelgladney2015', 'ceterpstra', 'woestreich', 'richarathore', 'erinyoung2015', 'jtc143', 'michael_western2015', 'kateritter922', 'eric.schoenbach', 'alower', 'rajiv23', 'dchon', 'kkielbania', 'ees264', 'dpawletki', 'joeentenman', 'wyouman', 'mmccormick', 'rmh586', 'ntrautenberg', 'ericenu', 'rem421', 'aschlatter', 'bdolan7329', 'maddiejcole', 'bassman211', 'sejal', 'blooshnog', 'sgj140', 'cbryan136', 'karenwang2015', 'michaelcreatura2015', 'mmcgreal', 'teaisfortiffany', 'willoliver', 'rsibley', 'jfreedman', 'jennypark2015', 'mferber', 'stephanielo', 'hhung', 'kjorgensen514', 'aeyarbro', 'esp424', 'acheatham', 'kleung', 'adoro', 'jasminealadefa2015', 'scottingham2015', 'ghosh009', 'albertsong2015', 'makrasnow15', 'dpatel', 'cadnams', 'msp034', 'djw278', 'thomasaugust', 'krushers', 'eacostatorres', 'ryansachs2011', 'mmargritier', 'nichaaar', 'sdangles', 'gabyperea5', 'hgartner', 'zaynabquadri2015', 'sjthompson09', 'jcv809', 'eggfooyang', 'xyn711', 'nnayar', 'brandonbock2015', 'jwolloch19', 'peteswims1818', 'kabia47', 'meredyth', 'juliebloom2015', 'conniegu', 'msl333', 'cys969', 'alexandraprodriguez', 'lcn329', 'atregnery', 'ejwebb92', 'madalyngisch2015', 'mpl1002', 'ajh874', 'grk689', 'aagbeh', 'apatrick', 'tmorreale', 'wzuczek', 'ericaminor2015', 'askzorno', 'lrw789', 'cnwaelele', 'elliotyucesan', 'hannahbeck', 'sportzboy2', 'arr891', 'mcunningham', 'szaleski', 'kcolter08', 'tells', 'ericajepsen', 'msc958', 'mbagwell', 'zpiser', 'tiwu', 'psp502']",215,"['gretskyw', 'clynsky06', 'ebeck', 'ellenchoe', 'lubben', 'mhs287', 'cgcizek', 'coolivia', 'jmarthouse', 'han607', 'naomimerer2015', 'roboro727', 'isabelrv', 'malbrecht', 'mjs718', 'ppairs', 'vnm816', 'shaloni', 'smontgomery', 'dprivit', 'kiracalavera', 'chasebrewster2015', 'dct353', 'asonta', 'dsgarharda001', 'jrc699', 'helenl', 'ramanmichael2015', 'men544', 'jlamberth8', 'matthewmelamed2015', 'ninaor3', 'ajit326', 'jennmurphy11', 'wutangclan', 'barcatorres', 'chem102lab', 'frank.parilla', 'sysmith', 'sks491', 'jennastoehr2015', 'abl849', 'jcarrillo', 'eaf591', 'arouse', 'mvh312', 'nfw17531', 'newcombjb', 'jkelter', 'sarahtoy', 'aseitz10', 'tpendergrast', 'robertfisch2015', 'ras423', 'jwr915', 'jthumel', 'cmd750', 'taizenman', 'dmalone', 'azaffer', 'valeriejchen', 'omowunmi', 'abeir', 'danaya707', 'jhr252', 'jem824', 'jnephan93', 'karlyroser2015', 'tjorda21', 'chrispontisakos', 'kas042', 'askowalczuk', 'mgrollins', 'apfeiffer', 'sms483', 'slk620', 'nabroady', 'samfoolery', 'lhelfrich', 'iasega', 'rcignoni', 'cleclerq', 'zhsueh', 'wcp795', 'jkwon66', 'css539', 'asv810', 'abh019', 'mbartnovsky', None, 'nshaw123', 'mrt728', 'msp793', 'alw490', 'jjgordo92', 'smuehrcke', 'defenseman91', 'yfs322', 'nschmidt', 'sms618', 'ejn531', 'farzaankassam2015', 'jonfeldman', 'rachelgladney2015', 'ceterpstra', 'woestreich', 'richarathore', 'erinyoung2015', 'jtc143', 'michael_western2015', 'kateritter922', 'eric.schoenbach', 'alower', 'rajiv23', 'dchon', 'kkielbania', 'ees264', 'dpawletki', 'joeentenman', 'wyouman', 'mmccormick', 'rmh586', 'ntrautenberg', 'ericenu', 'rem421', 'aschlatter', 'bdolan7329', 'maddiejcole', 'bassman211', 'sejal', 'blooshnog', 'sgj140', 'cbryan136', 'karenwang2015', 'michaelcreatura2015', 'mmcgreal', 'teaisfortiffany', 'willoliver', 'rsibley', 'jfreedman', 'jennypark2015', 'mferber', 'stephanielo', 'hhung', 'kjorgensen514', 'aeyarbro', 'esp424', 'acheatham', 'kleung', 'adoro', 'jasminealadefa2015', 'scottingham2015', 'ghosh009', 'albertsong2015', 'makrasnow15', 'dpatel', 'cadnams', 'msp034', 'djw278', 'thomasaugust', 'krushers', 'eacostatorres', 'ryansachs2011', 'mmargritier', 'nichaaar', 'sdangles', 'gabyperea5', 'hgartner', 'altequz1', 'zaynabquadri2015', 'sjthompson09', 'jcv809', 'eggfooyang', 'xyn711', 'nnayar', 'brandonbock2015', 'jwolloch19', 'peteswims1818', 'kabia47', 'meredyth', 'juliebloom2015', 'conniegu', 'msl333', 'cys969', 'narokkurai', 'alexandraprodriguez', 'lcn329', 'atregnery', 'ejwebb92', 'madalyngisch2015', 'mpl1002', 'ajh874', 'grk689', 'aagbeh', 'apatrick', 'tmorreale', 'wzuczek', 'ericaminor2015', 'askzorno', 'lrw789', 'cnwaelele', 'elliotyucesan', 'hannahbeck', 'sportzboy2', 'arr891', 'mcunningham', 'szaleski', 'kcolter08', 'tells', 'ericajepsen', 'msc958', 'mbagwell', 'zpiser', 'tiwu', 'psp502']"
75,185,7,26,6,"['tarek90', 'rrodriguez91', 'lrod1989', 'josortega80', 'cmrodriguez', 'lauupadilla']",0,[],20,"['uzeta27', 'bhgarcia', 'aavargas3', 'darix79', 'jccastro2', 'aortiz24', 'cemartinez2', 'icereceres', 'jdtriggs', 'jcvicente', 'jfsalas2', 'cavalos9', None, 'arzaga27', 'yzgaribay', 'adiaz6', 'nmaxwell', 'wolffang01', 'melendeztony', 'jfcastillo33']",26,"['uzeta27', 'bhgarcia', 'lrod1989', 'aavargas3', 'darix79', 'jccastro2', 'tarek90', 'rrodriguez91', 'josortega80', 'lauupadilla', 'aortiz24', 'cemartinez2', 'icereceres', 'jdtriggs', 'jcvicente', 'cmrodriguez', 'jfsalas2', 'cavalos9', None, 'arzaga27', 'yzgaribay', 'adiaz6', 'nmaxwell', 'wolffang01', 'melendeztony', 'jfcastillo33']"
75,219,7,9,6,"['tarek90', 'rrodriguez91', 'lrod1989', 'josortega80', 'cmrodriguez', 'lauupadilla']",0,[],3,"['lrodri26', 'samartinez14', None]",9,"['tarek90', 'rrodriguez91', 'lrod1989', 'josortega80', 'cmrodriguez', 'lauupadilla', 'samartinez14', 'lrodri26', None]"
76,89,7,132,3,"['nkingw', 'liao24hoho', 'mjy5']",3,"['shamohan', 'nima_one', 'djcarroll']",129,"['dhuang123', 'nookala', 'bae10', 'moon1002', 'melurie03', 'b3nny312', 'oknoel', 'gobias', 'fredhdx', 'lshi14', 'esanch29', 'johns149', 'muneebahmed95', 'boertew1', 'sherrypri', 'snanav3', 'hronik1', 'jkinne2', 'sfanou2', '1upgreenshroom', 'siwin2', 'sutchaya', 'baoshi314', 'neilchristanto', 'kumikknd', 'wang183', 'savankadakiya', 'shawnwin1234', 'daybreak410039', 'ewalt1', 'coolcrew', 'maddali1', 'cernaus1', 'pranav9', 'hartant2', 'hoang4', 'profballack', 'gong10', 'nanotie', 'congshanwan', 'malik15', 'sundar0301', 'alabi2', 'madigan5', 'feng12', 'mikenike', 'swarley', 'lidazhu1', 'yjaquinas', 'mazzola1', 'azam2', 'menghuang', 'wlee26', 'ssingh18', None, 'kim405', 'qiu12', 'zhangyj', 'wanchoi1', 'luiszelaya', 'keating7', 'blee51', 'maxcan', 'leiche1', 'chrisgoulet', 'samuelzhang', 'achavarria', 'mahed', 'searuff', 'tatuhiro', 'pashea1', 'dubois1', 'geschreyr', 'zulueta1', 'shapir11', 'kwak27', 'zeqiuwu1', 'emma', 'foxytop', 'brittovivek', 'jielv1', 'toblerone16', 'okekeoc1', 'hur6', 'bony', 'jksikai', 'nam18', 'szhang51', 'mim1c', 'jataput1', 'miketeufel1', 'lupas2', 'kilpatr2', 'sgrand2', 'mikeudelhofen', 'amnueyp1', 'mihrenoe', 'theerasit', 'jtlust3', 'aczerepak', 'stuber1', 'piyawon1', 'kim563', 'gazdzia1', 'williamhn', 'liyd', 'bector1', 'roloscool', 'yun19', 'ddanielw', 'kchuang5', 'jain53', 'mrwilsonsaid', 'ludao822', 'hasken1', 'hchao2', 'hazypensieve', 'gloger', 'ysun12', '8kobe24', 'hgao10', 'stephenyzc', 'genome852', 'morris57', 'ucapssong', 'tsai11', 'jkim449', 'panlei616', 'tischer1']",135,"['dhuang123', 'nookala', 'bae10', 'moon1002', 'melurie03', 'b3nny312', 'nima_one', 'oknoel', 'gobias', 'fredhdx', 'lshi14', 'esanch29', 'johns149', 'muneebahmed95', 'djcarroll', 'boertew1', 'sherrypri', 'snanav3', 'hronik1', 'shamohan', 'jkinne2', 'sfanou2', '1upgreenshroom', 'siwin2', 'sutchaya', 'baoshi314', 'neilchristanto', 'kumikknd', 'wang183', 'savankadakiya', 'shawnwin1234', 'daybreak410039', 'ewalt1', 'coolcrew', 'tischer1', 'maddali1', 'cernaus1', 'pranav9', 'hartant2', 'hoang4', 'profballack', 'gong10', 'nanotie', 'congshanwan', 'malik15', 'sundar0301', 'alabi2', 'madigan5', 'feng12', 'mjy5', 'mikenike', 'swarley', 'lidazhu1', 'yjaquinas', 'mazzola1', 'azam2', 'menghuang', 'wlee26', 'ssingh18', None, 'kim405', 'qiu12', 'zhangyj', 'wanchoi1', 'luiszelaya', 'keating7', 'blee51', 'maxcan', 'leiche1', 'chrisgoulet', 'samuelzhang', 'achavarria', 'mahed', 'liao24hoho', 'searuff', 'tatuhiro', 'pashea1', 'dubois1', 'geschreyr', 'zulueta1', 'shapir11', 'kwak27', 'zeqiuwu1', 'emma', 'foxytop', 'brittovivek', 'jielv1', 'toblerone16', 'okekeoc1', 'hur6', 'nkingw', 'bony', 'jksikai', 'nam18', 'szhang51', 'mim1c', 'jataput1', 'miketeufel1', 'lupas2', 'kilpatr2', 'sgrand2', 'mikeudelhofen', 'amnueyp1', 'mihrenoe', 'theerasit', 'jtlust3', 'aczerepak', 'stuber1', 'piyawon1', 'kim563', 'gazdzia1', 'williamhn', 'liyd', 'bector1', 'roloscool', 'yun19', 'ddanielw', 'kchuang5', 'jain53', 'mrwilsonsaid', 'ludao822', 'hasken1', 'hchao2', 'hazypensieve', 'gloger', 'ysun12', '8kobe24', 'hgao10', 'stephenyzc', 'genome852', 'morris57', 'ucapssong', 'jkim449', 'panlei616', 'tsai11']"
76,91,7,35,2,"['nima_one', 'mjy5']",4,"['shamohan', 'nkingw', 'liao24hoho', 'djcarroll']",33,"['ekapin2', 'bector1', 'dongdong', 'ltompki2', 'bhchen2', 'parks8', 'sunjialin', 'diliber1', 'geethabijjam', 'jeeves631', 'jkim331', 'heebidiwup', 'nmisak', 'gavinwinkel', 'gloger', 'mazzola1', 'sherrypri', 'lupas2', 'mattycat9000', 'ssingh18', 'levitas1', None, 'wdyarthas', 'alex81388', 'mast5', 'weber36', 'deasey1', 'savankadakiya', 'hatfarm', 'tchajed', 'omghaxcode', 'hardy6', 'tsai11']",39,"['liao24hoho', 'ekapin2', 'bector1', 'dongdong', 'ltompki2', 'nima_one', 'bhchen2', 'parks8', 'sunjialin', 'diliber1', 'geethabijjam', 'jeeves631', 'jkim331', 'nkingw', 'mjy5', 'djcarroll', 'heebidiwup', 'nmisak', 'gavinwinkel', 'gloger', 'mazzola1', 'sherrypri', 'lupas2', 'shamohan', 'mattycat9000', 'ssingh18', 'levitas1', None, 'wdyarthas', 'alex81388', 'mast5', 'weber36', 'deasey1', 'savankadakiya', 'hatfarm', 'tchajed', 'omghaxcode', 'hardy6', 'tsai11']"
76,93,7,34,2,"['nima_one', 'mjy5']",4,"['shamohan', 'nkingw', 'liao24hoho', 'djcarroll']",32,"['bector1', 'dongdong', 'xiaoyr068', 'ltompki2', 'bhchen2', 'parks8', 'sunjialin', 'diliber1', 'geethabijjam', 'jkim331', 'griffi21', 'heebidiwup', 'nmisak', 'gavinwinkel', 'gloger', 'mazzola1', 'sherrypri', 'lupas2', 'mattycat9000', 'ssingh18', 'levitas1', None, 'wdyarthas', 'alex81388', 'mast5', 'weber36', 'tsai11', 'hatfarm', 'tchajed', 'omghaxcode', 'jefflale', 'mraval']",38,"['liao24hoho', 'bector1', 'dongdong', 'xiaoyr068', 'ltompki2', 'nima_one', 'bhchen2', 'mraval', 'parks8', 'sunjialin', 'diliber1', 'geethabijjam', 'jkim331', 'griffi21', 'nkingw', 'mjy5', 'djcarroll', 'heebidiwup', 'nmisak', 'gavinwinkel', 'gloger', 'mazzola1', 'sherrypri', 'lupas2', 'shamohan', 'mattycat9000', 'ssingh18', 'levitas1', None, 'wdyarthas', 'alex81388', 'mast5', 'weber36', 'hatfarm', 'tchajed', 'omghaxcode', 'jefflale', 'tsai11']"
76,90,7,22,1,['shamohan'],5,"['nima_one', 'djcarroll', 'liao24hoho', 'nkingw', 'mjy5']",21,"['ouldsaghir', 'chan32', 'case7', 'kgiacobazzi', 'wente1', 'qliu9', 'jielv1', 'fandi514', 'hur6', 'supermeatboy', 'roboemperor', 'red6290', 'greenwa1', 'edavilax', 'mroczek1', 'dahlke2', 'dicksonsalim', None, 'neilchristanto', 'bdlftth2', 'lobert124']",27,"['djcarroll', 'hur6', 'ouldsaghir', 'liao24hoho', 'mroczek1', 'dahlke2', 'chan32', 'case7', 'shamohan', 'roboemperor', 'dicksonsalim', None, 'nima_one', 'kgiacobazzi', 'wente1', 'neilchristanto', 'qliu9', 'bdlftth2', 'lobert124', 'jielv1', 'fandi514', 'supermeatboy', 'nkingw', 'red6290', 'mjy5', 'greenwa1', 'edavilax']"
77,89,7,132,3,"['mim1c', 'kim405', 'zulueta1']",3,"['grace3050', 'lmendez2', 'ltompki2']",129,"['dhuang123', 'nookala', 'bae10', 'moon1002', 'melurie03', 'b3nny312', 'oknoel', 'gobias', 'fredhdx', 'lshi14', 'esanch29', 'johns149', 'muneebahmed95', 'boertew1', 'sherrypri', 'snanav3', 'hronik1', 'jkinne2', 'sfanou2', '1upgreenshroom', 'siwin2', 'sutchaya', 'baoshi314', 'neilchristanto', 'kumikknd', 'wang183', 'savankadakiya', 'shawnwin1234', 'daybreak410039', 'ewalt1', 'coolcrew', 'maddali1', 'cernaus1', 'pranav9', 'hartant2', 'hoang4', 'profballack', 'gong10', 'nanotie', 'congshanwan', 'malik15', 'sundar0301', 'alabi2', 'madigan5', 'feng12', 'mjy5', 'mikenike', 'swarley', 'lidazhu1', 'yjaquinas', 'mazzola1', 'azam2', 'menghuang', 'wlee26', 'ssingh18', None, 'qiu12', 'zhangyj', 'wanchoi1', 'luiszelaya', 'keating7', 'blee51', 'maxcan', 'leiche1', 'chrisgoulet', 'samuelzhang', 'achavarria', 'mahed', 'liao24hoho', 'searuff', 'tatuhiro', 'pashea1', 'dubois1', 'geschreyr', 'shapir11', 'kwak27', 'zeqiuwu1', 'emma', 'foxytop', 'brittovivek', 'jielv1', 'toblerone16', 'okekeoc1', 'hur6', 'bony', 'nkingw', 'jksikai', 'nam18', 'szhang51', 'jataput1', 'miketeufel1', 'lupas2', 'kilpatr2', 'sgrand2', 'mikeudelhofen', 'amnueyp1', 'mihrenoe', 'theerasit', 'jtlust3', 'aczerepak', 'stuber1', 'piyawon1', 'kim563', 'gazdzia1', 'williamhn', 'liyd', 'bector1', 'roloscool', 'yun19', 'ddanielw', 'kchuang5', 'jain53', 'mrwilsonsaid', 'ludao822', 'hasken1', 'hchao2', 'hazypensieve', 'gloger', 'ysun12', '8kobe24', 'hgao10', 'stephenyzc', 'genome852', 'morris57', 'ucapssong', 'tsai11', 'jkim449', 'panlei616', 'tischer1']",135,"['dhuang123', 'nookala', 'bae10', 'moon1002', 'melurie03', 'b3nny312', 'oknoel', 'gobias', 'fredhdx', 'lshi14', 'esanch29', 'johns149', 'muneebahmed95', 'boertew1', 'sherrypri', 'snanav3', 'hronik1', 'jkinne2', 'sfanou2', '1upgreenshroom', 'siwin2', 'sutchaya', 'baoshi314', 'neilchristanto', 'kumikknd', 'wang183', 'savankadakiya', 'shawnwin1234', 'daybreak410039', 'ewalt1', 'coolcrew', 'tischer1', 'maddali1', 'cernaus1', 'pranav9', 'hartant2', 'hoang4', 'profballack', 'gong10', 'nanotie', 'congshanwan', 'malik15', 'sundar0301', 'alabi2', 'madigan5', 'feng12', 'mjy5', 'mikenike', 'swarley', 'lidazhu1', 'yjaquinas', 'mazzola1', 'azam2', 'menghuang', 'wlee26', 'ssingh18', None, 'kim405', 'qiu12', 'zhangyj', 'wanchoi1', 'luiszelaya', 'keating7', 'blee51', 'maxcan', 'leiche1', 'chrisgoulet', 'samuelzhang', 'achavarria', 'mahed', 'liao24hoho', 'searuff', 'tatuhiro', 'pashea1', 'dubois1', 'geschreyr', 'zulueta1', 'shapir11', 'kwak27', 'zeqiuwu1', 'emma', 'foxytop', 'brittovivek', 'jielv1', 'toblerone16', 'okekeoc1', 'hur6', 'bony', 'nkingw', 'jksikai', 'nam18', 'szhang51', 'mim1c', 'jataput1', 'miketeufel1', 'lupas2', 'kilpatr2', 'sgrand2', 'mikeudelhofen', 'amnueyp1', 'mihrenoe', 'theerasit', 'jtlust3', 'aczerepak', 'stuber1', 'piyawon1', 'kim563', 'gazdzia1', 'williamhn', 'liyd', 'bector1', 'roloscool', 'yun19', 'ddanielw', 'ltompki2', 'kchuang5', 'jain53', 'lmendez2', 'mrwilsonsaid', 'ludao822', 'hasken1', 'hchao2', 'hazypensieve', 'gloger', 'ysun12', '8kobe24', 'hgao10', 'stephenyzc', 'genome852', 'morris57', 'ucapssong', 'jkim449', 'panlei616', 'grace3050', 'tsai11']"
77,69,7,118,5,"['mim1c', 'zulueta1', 'lmendez2', 'grace3050', 'ltompki2']",1,['kim405'],113,"['achavarria', 'samuelzhang', 'dhuang123', 'mahed', 'nookala', 'dwass', 'jashari1', 'mintzo', 'izquier2', 'ouyang4', 'tatuhiro', 'moon1002', 'pashea1', 'b3nny312', 'shapir11', 'kwak27', 'hua5', 'fredhdx', 'redyoshi49q', 'lshi14', 'shawkat', 'echegil1', 'donner1', 'bradsnyder', 'nam18', 'vigneshka', 'jyao5', 'jksikai', 'johns149', 'muneebahmed95', 'szhang51', 'jataput1', 'jayfurrie', 'sherrypri', 'hronik1', 'miketeufel1', 'sgrand2', 'sfanou2', 'mikeudelhofen', 'dinger104', 'siwin2', 'sutchaya', 'mihrenoe', 'vargas3', 'kumikknd', 'neilchristanto', 'yuan11', 'shawnwin1234', 'daybreak410039', 'ewalt1', 'baker48', 'coolcrew', 'banerje1', 'aczerepak', 'stuber1', 'trovill1', 'chen338', 'kandel3', 'hartant2', 'jiwonp224', 'hoang4', 'williamhn', 'ahoboke', 'reebbhaa', 'profballack', 'liyd', 'monnett1', 'alostu3', 'nanotie', 'chenhu1', 'malik15', 'lee117', 'surajmodi', 'madigan5', 'alabi2', 'ravitheja22', 'supermeatboy', 'red6290', 'ericwoo1', 'feng12', 'a2104707', 'mikenike', 'jclift3', 'kadakiy1', 'hchao2', 'heebidiwup', 'yjaquinas', 'lidazhu1', 'nmisak', 'hazypensieve', 'dferrell68', 'hgao10', 'menghuang', 'stephenyzc', 'rushx1', 'wlee26', 'broll1', 'lu30', 'morris57', None, 'qiu12', 'zhangyj', 'wanchoi1', 'luiszelaya', 'spadin1', 'keating7', 'yao10', 'blee51', 'panlei616', 'maxcan', 'leiche1', 'tischer1', 'jefflale']",119,"['achavarria', 'samuelzhang', 'dhuang123', 'mahed', 'nookala', 'dwass', 'jashari1', 'mintzo', 'izquier2', 'ouyang4', 'tatuhiro', 'moon1002', 'pashea1', 'zulueta1', 'b3nny312', 'shapir11', 'kwak27', 'hua5', 'fredhdx', 'redyoshi49q', 'lshi14', 'shawkat', 'echegil1', 'donner1', 'bradsnyder', 'nam18', 'vigneshka', 'jyao5', 'jksikai', 'johns149', 'mim1c', 'muneebahmed95', 'szhang51', 'jataput1', 'jayfurrie', 'sherrypri', 'hronik1', 'miketeufel1', 'sgrand2', 'sfanou2', 'mikeudelhofen', 'dinger104', 'siwin2', 'sutchaya', 'mihrenoe', 'vargas3', 'kumikknd', 'neilchristanto', 'yuan11', 'shawnwin1234', 'daybreak410039', 'ewalt1', 'baker48', 'coolcrew', 'banerje1', 'aczerepak', 'stuber1', 'trovill1', 'chen338', 'kandel3', 'hartant2', 'jiwonp224', 'hoang4', 'williamhn', 'ahoboke', 'reebbhaa', 'profballack', 'liyd', 'monnett1', 'alostu3', 'nanotie', 'chenhu1', 'ltompki2', 'malik15', 'lee117', 'surajmodi', 'leiche1', 'lmendez2', 'madigan5', 'alabi2', 'ravitheja22', 'supermeatboy', 'red6290', 'ericwoo1', 'feng12', 'a2104707', 'mikenike', 'jclift3', 'kadakiy1', 'hchao2', 'heebidiwup', 'yjaquinas', 'lidazhu1', 'nmisak', 'hazypensieve', 'dferrell68', 'hgao10', 'menghuang', 'stephenyzc', 'rushx1', 'wlee26', 'broll1', 'lu30', 'morris57', None, 'kim405', 'qiu12', 'zhangyj', 'wanchoi1', 'luiszelaya', 'spadin1', 'keating7', 'yao10', 'blee51', 'panlei616', 'maxcan', 'grace3050', 'tischer1', 'jefflale']"
77,91,7,35,1,['ltompki2'],5,"['mim1c', 'lmendez2', 'grace3050', 'kim405', 'zulueta1']",34,"['ekapin2', 'bector1', 'dongdong', 'nima_one', 'bhchen2', 'parks8', 'sunjialin', 'diliber1', 'geethabijjam', 'jeeves631', 'jkim331', 'mjy5', 'heebidiwup', 'nmisak', 'gavinwinkel', 'gloger', 'mazzola1', 'sherrypri', 'lupas2', 'mattycat9000', 'ssingh18', 'levitas1', None, 'wdyarthas', 'alex81388', 'mast5', 'weber36', 'deasey1', 'savankadakiya', 'hatfarm', 'tchajed', 'omghaxcode', 'hardy6', 'tsai11']",40,"['ekapin2', 'bector1', 'dongdong', 'ltompki2', 'zulueta1', 'nima_one', 'bhchen2', 'parks8', 'sunjialin', 'lmendez2', 'diliber1', 'geethabijjam', 'jeeves631', 'jkim331', 'mjy5', 'mim1c', 'heebidiwup', 'nmisak', 'gavinwinkel', 'gloger', 'mazzola1', 'sherrypri', 'lupas2', 'mattycat9000', 'ssingh18', 'levitas1', 'kim405', None, 'wdyarthas', 'alex81388', 'mast5', 'weber36', 'deasey1', 'savankadakiya', 'hatfarm', 'tchajed', 'omghaxcode', 'hardy6', 'grace3050', 'tsai11']"
77,93,7,34,1,['ltompki2'],5,"['mim1c', 'lmendez2', 'grace3050', 'kim405', 'zulueta1']",33,"['bector1', 'dongdong', 'xiaoyr068', 'nima_one', 'bhchen2', 'parks8', 'sunjialin', 'diliber1', 'geethabijjam', 'jkim331', 'griffi21', 'mjy5', 'heebidiwup', 'nmisak', 'gavinwinkel', 'gloger', 'mazzola1', 'sherrypri', 'lupas2', 'mattycat9000', 'ssingh18', 'levitas1', None, 'wdyarthas', 'alex81388', 'mast5', 'weber36', 'tsai11', 'hatfarm', 'tchajed', 'omghaxcode', 'jefflale', 'mraval']",39,"['bector1', 'dongdong', 'xiaoyr068', 'ltompki2', 'zulueta1', 'nima_one', 'bhchen2', 'mraval', 'parks8', 'sunjialin', 'lmendez2', 'diliber1', 'geethabijjam', 'jkim331', 'griffi21', 'mjy5', 'mim1c', 'heebidiwup', 'nmisak', 'gavinwinkel', 'gloger', 'mazzola1', 'sherrypri', 'lupas2', 'mattycat9000', 'ssingh18', 'levitas1', 'kim405', None, 'wdyarthas', 'alex81388', 'mast5', 'weber36', 'hatfarm', 'tchajed', 'omghaxcode', 'jefflale', 'grace3050', 'tsai11']"
77,95,7,7,1,['lmendez2'],5,"['mim1c', 'zulueta1', 'grace3050', 'kim405', 'ltompki2']",6,"['jiwonp224', 'theerasit', 'maddali1', 'ericwoo1', None, 'chan1cyrus2']",12,"['mim1c', 'zulueta1', 'jiwonp224', 'theerasit', 'maddali1', 'lmendez2', 'grace3050', 'ericwoo1', None, 'kim405', 'chan1cyrus2', 'ltompki2']"
78,4,7,21,6,"['qnian', 'metcalfa', 'kwon43', 'ckmiskin', 'wang779', 'smith172']",0,[],15,"[None, 'karthiky', 'jungujchoi', 'ytoh', 'mcleods', 'jkamar', 'ashahidi', 'zhang655', 'bgraeser', 'peihsun', 'brianlew', 'mnelis', 'nelder', 'brookywat', 'lrostro']",21,"['metcalfa', 'kwon43', 'ytoh', 'jkamar', 'bgraeser', 'zhang655', 'peihsun', 'mnelis', 'nelder', 'brianlew', None, 'smith172', 'qnian', 'karthiky', 'jungujchoi', 'mcleods', 'ckmiskin', 'wang779', 'ashahidi', 'brookywat', 'lrostro']"
78,129,7,20,4,"['qnian', 'metcalfa', 'wang779', 'kwon43']",2,"['ckmiskin', 'smith172']",16,"['chinmay153', 'abaradwaj', 'karthiky', 'jungujchoi', 'ytoh', 'paulpurelar', 'dacongcong', 'leiyanggz', 'mcleods', 'ksingha', 'jkamar', 'peihsun', 'bgraeser', 'mnelis', None, 'lrostro']",22,"['metcalfa', 'abaradwaj', 'kwon43', 'ytoh', 'dacongcong', 'leiyanggz', 'jkamar', 'bgraeser', 'peihsun', 'mnelis', None, 'smith172', 'qnian', 'karthiky', 'jungujchoi', 'paulpurelar', 'mcleods', 'ckmiskin', 'ksingha', 'wang779', 'chinmay153', 'lrostro']"
78,13,7,17,4,"['qnian', 'metcalfa', 'wang779', 'kwon43']",2,"['ckmiskin', 'smith172']",13,"['abaradwaj', 'jungujchoi', 'ytoh', 'dacongcong', 'leiyanggz', 'mcleods', 'zhang655', 'brookywat', 'peihsun', 'bgraeser', 'mnelis', None, 'lrostro']",19,"['metcalfa', 'abaradwaj', 'kwon43', 'ytoh', 'dacongcong', 'leiyanggz', 'bgraeser', 'peihsun', 'zhang655', 'mnelis', None, 'smith172', 'qnian', 'jungujchoi', 'mcleods', 'ckmiskin', 'wang779', 'brookywat', 'lrostro']"
81,130,7,15,4,"['vanilla1124', 'ashfiqua', 'anthony.santaguida', 'sinadhane']",2,"['ifakih', 'shizhaofan']",11,"['fatemehafshar', 'binhle', 'ankijin', 'keving', 'ndys', 'saka23', 'dmarek', 'wendit', 'adamgordon', None, 'kregon']",17,"['fatemehafshar', 'keving', 'shizhaofan', 'ndys', 'wendit', None, 'kregon', 'binhle', 'ankijin', 'ifakih', 'ashfiqua', 'saka23', 'dmarek', 'adamgordon', 'vanilla1124', 'anthony.santaguida', 'sinadhane']"
84,185,6,26,5,"['yzgaribay', 'melendeztony', 'jfcastillo33', 'cavalos9', 'cemartinez2']",0,[],21,"['icereceres', 'jdtriggs', 'uzeta27', 'bhgarcia', 'lrod1989', 'aavargas3', 'jcvicente', 'cmrodriguez', 'jfsalas2', 'darix79', 'jccastro2', None, 'arzaga27', 'tarek90', 'rrodriguez91', 'adiaz6', 'josortega80', 'nmaxwell', 'wolffang01', 'lauupadilla', 'aortiz24']",26,"['icereceres', 'jdtriggs', 'uzeta27', 'bhgarcia', 'lrod1989', 'aavargas3', 'jcvicente', 'cmrodriguez', 'jfsalas2', 'cavalos9', 'darix79', 'jccastro2', None, 'arzaga27', 'tarek90', 'yzgaribay', 'rrodriguez91', 'adiaz6', 'josortega80', 'nmaxwell', 'wolffang01', 'lauupadilla', 'melendeztony', 'aortiz24', 'jfcastillo33', 'cemartinez2']"
89,33,6,7,4,"['oscgz', 'lm', 'fito', 'eecb']",1,['ivbrea'],3,"['biel', None, 'kikefreixo']",8,"['biel', 'lm', 'ivbrea', 'fito', 'kikefreixo', 'eecb', 'oscgz', None]"
89,160,6,7,4,"['oscgz', 'lm', 'fito', 'eecb']",1,['ivbrea'],3,"['biel', None, 'kikefreixo']",8,"['biel', 'lm', 'ivbrea', 'fito', 'kikefreixo', 'eecb', 'oscgz', None]"
91,34,6,6,4,"['michael.waltl', 'albirdeo', 'samvaziri', 'varlamava']",1,['daweiheh'],2,"[None, 'paperoga85']",7,"['albirdeo', None, 'varlamava', 'paperoga85', 'michael.waltl', 'samvaziri', 'daweiheh']"
