MClusterID,XClusterID,MClusterSize,XClusterSize,OverlapSize,OverlapMembers,MOnlySize,MOnlyMembers,XOnlySize,XOnlyMembers,CombinedSize,CombinedMembers
1,130,194,321,189,"['n6n8u3', 'jameswillis2017', 'sgorlick', 'juanmena2017', 'hopkins2', 'robertzhu2017', 'nward', 'lchen', 'gesta', 'alila', 'emilymorris2017', 'lafern', 'bbl076', 'sshull', 'annapetersen21', 'krembisz', 'jbs916', 'bishtonn', 'bdougherty', 'gmc830', 'imasamba', 'bbecerra', 'nasher', 'mmihalache', 'vmehta', 'jschaefer', 'jburkechem122', 'isi.sturla', 'sdaniel', 'mattsherman95', 'abfilicko05', 'nuchem102', 'ajsnu', 'rmehta95', 'annaduban2017', 'smezyk7', 'gallardoy09', 'cfleesmith', 'obabatola', 'uditapersaud', 'cmucharraz', 'gcohen', 'myi', 'nicholas.mccombe.3', 'tla95', 'kkim27', 'rweidinger', 'rodriguez.ricardo13', 'broconnell', 'amyers17', 'alw231', 'melikimmy', 'coravasserman2017', 'swert', 'mpostoll4', 'jsammon', 'marinamin2017', 'lra391', 'ajennings', 'lindseymehl2017', 'lisa.kim.961993', 'bspielman', 'kathrynpillischafske2017', 'msobhani', 'jesus.leon1', 'ydeng', 'dperlovsky', 'kimhoff', 'christycal17', 'jalonbrown', 'ljung', 'mfluellen', 'aostenso', 'mgullott', 'miriam.perez.35574', 'bfeinstein', 'ssbanic', 'bkraft383', 'vilte', 'igau', 'cweers', 'mdoody359', 'vrutherford', 'kschuster', 'j3nnif3r37', 'jtucker', 'rsarette', 'ggillow', 'benedict.dungca', 'sem742', 'nn3210', 'jruan', 'estebanmercado2017', 'emathews', 'shwang', 'geapen', 'jvegaperkins713', 'lsleung', 'jdk681', 'mhopfner', 'yokim', 'santana', 'hpervaiz', 'aparikh22', 'asears', 'rst345', 'ellenpatterson2017', 'catherineding', 'annapreston2017', 'gcamozzi', 'kgong', 'njandali', 'crobinson19', 'bananapiehl', 'agrenen', 'isaacheine', 'rachelrogers', 'ahofmeister', 'minjooson', 'aamattey', 'nwh027', 'wizu', 'ndivine', 'ijackylei', 'rboodram', 'annahinrichs', 'clacrosse', 'anewell', 'yuehu9510', 'joshauck', 'rsherman', 'kdaftary', 'afisher', 'marsak', 'phaun', 'jmarquez95', 'ddapuzzo', 'ecripe', 'jgw599', 'cfox', 'ecbold13', 'tstoimenoff', 'pgrewal', 'alzipursky', 'peter.g.vlahakis', 'tomliggett', 'juliakovalenko2017', 'ccj009', 'zfenske', 'jdrews', 'jvillanueva8', 'hannahbrady2017', 'hrucinski', 'camilleblackman2016', 'wjhager2016', 'kcm010', 'phawkyard', 'annedeb', 'james.amick94', 'hwhite', 'evanbeuningen', 'jki699', 'afarsheed', 'zwatson', 'vlh774', 'aveerina', 'glak', 'cconnelly', 'shorstman', 'rschaaf', 'stam', 'omarosorio2017', 'krichards', 'kristensmith2017', 'plim', 'davidkarlin2013', 'mclark032', 'nnwagbo', 'jmccartney', 'laurenabruzzo2017', 'wlindstrom', 'elisa4201', 'bchen', 'marknelson2012', 'kqu', 'hlou88', 'bbair', 'mcoden', 'mstotzy1']",5,"['pcastro', 'eam093', 'sauditore', 'valeriek', 'nalharithi']",132,"['ssandor', 'mforrest', 'rzelesko', 'ngriffiths', 'rmalhotra', 'survaishkhastgir', 'ldimarco', 'mcm938', 'maura.clement', 'agreenstein', 'lstyer', 'sjmacrowski', 'natalianagy1', 'rastatke', 'jalvear', 'connor.donovan.31', 'kbranch', 'crazyindianpride', 'ayl675', 'awalls', 'jarmstrong', 'jakmak37', 'jsd31josh', 'makeda.springette', 'mhackerteper', 'sarajohns2017', 'haleykoch2017', 'cryu', 'meganaaudipudy', 'araewilliams', 'vjansen', 'aacosta', 'aec943', 'mgates', 'sgray', 'sarceo', 'jgrocott', 'rachelli2017', 'lhu642', 'bbakalarski', 'jgupta', 'majedfataftahnu', 'cjw', 'ajalali', 'jamily80', 'natalie.m.stanley.9', 'sgarcia2017', 'jkk284', 'lilyzoo', 'mfoulkes', 'ahurst', 'etburklow', 'natalie5', 'aaubrun', 'lfoley82', 'twang2017', 'msb843', 'aibeh7906', 'jma', 'radiohedzz', 'tpierce14', 'zrubnitz', 'pasha', 'lrawitscher', 'msamyyi', 'natalianagytakahashi2015', 'rmalekmadani', 'kserv', 'manistranski', 'youjon5', 'sperez', 'rznewman', 'okohler', 'bklein', 'sonyaluthra2015', 'torear', 'samanthamurphy2017', 'daniel.c.eghdami', 'sobel.shawn', 'kelseyaaronson', 'dweber', 'cprucnal', 'hmiller', 'emares84', 'rmetzgerii', 'delagarl', 'morrisemily18', 'ajaynadig', 'slhatch', 'schandran', 'gabrielleforcier2015', 'sarahacs', 'brosenberg', 'mkelsten', 'jshin', 'brennanjackson2017', 'sebgar', 'ynessary', 'sbahena', 'jayahn0518', 'bensullivan', 'natalienowogrodzki', 'amansur', 'jbowleg', 'jboyer', 'anichols', 'bbisrat', 'borazine', 'mdefreitas', 'grahambullmore2017', 'bonesjones612', 'lawrencevinson2017', 'thomasodell2017', 'nickmartin44', 'astults', 'tav162', 'ajaynadig1', 'atsui4', 'cpieri', 'dfloyd', 'akmohring', 'mwaldegerma', 'kmobrien', 'wcho', 'pklimkow', 'pmccullough', 'dmw514', 'kburke1', 'mlaw70', 'mgreene', 'mco2745', 'kristinzubritzky']",326,"['jameswillis2017', 'sgorlick', 'gesta', 'alila', 'emilymorris2017', 'bbl076', 'mcm938', 'annapetersen21', 'gmc830', 'sjmacrowski', 'jalvear', 'ayl675', 'jarmstrong', 'jakmak37', 'cfleesmith', 'cryu', 'myi', 'tla95', 'kkim27', 'jgrocott', 'rachelli2017', 'jsammon', 'lra391', 'jamily80', 'ydeng', 'dperlovsky', 'jalonbrown', 'sgarcia2017', 'jkk284', 'lilyzoo', 'sauditore', 'mgullott', 'bfeinstein', 'natalie5', 'lfoley82', 'msb843', 'igau', 'mdoody359', 'jma', 'rsarette', 'lrawitscher', 'emathews', 'shwang', 'jvegaperkins713', 'kserv', 'lsleung', 'yokim', 'samanthamurphy2017', 'isaacheine', 'ahofmeister', 'rboodram', 'anewell', 'schandran', 'joshauck', 'rsherman', 'kdaftary', 'afisher', 'mkelsten', 'jshin', 'ecripe', 'jgw599', 'ecbold13', 'pgrewal', 'zfenske', 'jbowleg', 'hrucinski', 'kcm010', 'phawkyard', 'hwhite', 'afarsheed', 'borazine', 'vlh774', 'grahambullmore2017', 'lawrencevinson2017', 'davidkarlin2013', 'mclark032', 'kmobrien', 'jmccartney', 'marknelson2012', 'mco2745', 'n6n8u3', 'ssandor', 'mforrest', 'nward', 'rmalhotra', 'maura.clement', 'jbs916', 'sshull', 'bdougherty', 'bbecerra', 'jschaefer', 'connor.donovan.31', 'crazyindianpride', 'mattsherman95', 'annaduban2017', 'smezyk7', 'obabatola', 'nicholas.mccombe.3', 'vjansen', 'aacosta', 'aec943', 'mgates', 'alw231', 'bbakalarski', 'jgupta', 'swert', 'marinamin2017', 'lisa.kim.961993', 'jesus.leon1', 'mfluellen', 'aostenso', 'ssbanic', 'eam093', 'cweers', 'vrutherford', 'tpierce14', 'pcastro', 'ggillow', 'estebanmercado2017', 'natalianagytakahashi2015', 'jdk681', 'youjon5', 'hpervaiz', 'aparikh22', 'sonyaluthra2015', 'asears', 'catherineding', 'gcamozzi', 'sobel.shawn', 'dweber', 'rachelrogers', 'cprucnal', 'hmiller', 'emares84', 'wizu', 'yuehu9510', 'slhatch', 'phaun', 'brennanjackson2017', 'natalienowogrodzki', 'hannahbrady2017', 'annedeb', 'evanbeuningen', 'aveerina', 'valeriek', 'kristensmith2017', 'plim', 'atsui4', 'cpieri', 'bbair', 'mcoden', 'mlaw70', 'mstotzy1', 'kristinzubritzky', 'robertzhu2017', 'rzelesko', 'survaishkhastgir', 'ldimarco', 'lafern', 'nalharithi', 'agreenstein', 'krembisz', 'bishtonn', 'lstyer', 'imasamba', 'nasher', 'natalianagy1', 'vmehta', 'rastatke', 'isi.sturla', 'sdaniel', 'kbranch', 'abfilicko05', 'nuchem102', 'ajsnu', 'mhackerteper', 'gcohen', 'araewilliams', 'rodriguez.ricardo13', 'broconnell', 'sgray', 'sarceo', 'lhu642', 'ajalali', 'ajennings', 'kathrynpillischafske2017', 'kimhoff', 'etburklow', 'miriam.perez.35574', 'aaubrun', 'aibeh7906', 'j3nnif3r37', 'benedict.dungca', 'sem742', 'msamyyi', 'rmalekmadani', 'geapen', 'manistranski', 'sperez', 'torear', 'annapreston2017', 'kgong', 'bananapiehl', 'kelseyaaronson', 'minjooson', 'rmetzgerii', 'ndivine', 'ijackylei', 'annahinrichs', 'clacrosse', 'ajaynadig', 'sarahacs', 'marsak', 'sebgar', 'ynessary', 'tstoimenoff', 'jayahn0518', 'peter.g.vlahakis', 'tomliggett', 'jvillanueva8', 'camilleblackman2016', 'jboyer', 'bbisrat', 'jki699', 'cconnelly', 'shorstman', 'omarosorio2017', 'bonesjones612', 'astults', 'laurenabruzzo2017', 'wlindstrom', 'wcho', 'bchen', 'pklimkow', 'hlou88', 'kburke1', 'mgreene', 'juanmena2017', 'hopkins2', 'lchen', 'ngriffiths', 'mmihalache', 'jburkechem122', 'awalls', 'rmehta95', 'jsd31josh', 'makeda.springette', 'gallardoy09', 'sarajohns2017', 'haleykoch2017', 'meganaaudipudy', 'uditapersaud', 'cmucharraz', 'rweidinger', 'amyers17', 'melikimmy', 'coravasserman2017', 'mpostoll4', 'majedfataftahnu', 'cjw', 'lindseymehl2017', 'bspielman', 'msobhani', 'natalie.m.stanley.9', 'christycal17', 'ljung', 'mfoulkes', 'ahurst', 'bkraft383', 'twang2017', 'vilte', 'radiohedzz', 'kschuster', 'zrubnitz', 'jtucker', 'pasha', 'nn3210', 'jruan', 'mhopfner', 'santana', 'rznewman', 'okohler', 'bklein', 'rst345', 'ellenpatterson2017', 'njandali', 'crobinson19', 'daniel.c.eghdami', 'agrenen', 'aamattey', 'nwh027', 'delagarl', 'morrisemily18', 'gabrielleforcier2015', 'brosenberg', 'jmarquez95', 'ddapuzzo', 'cfox', 'sbahena', 'alzipursky', 'juliakovalenko2017', 'bensullivan', 'ccj009', 'amansur', 'jdrews', 'wjhager2016', 'anichols', 'james.amick94', 'zwatson', 'glak', 'mdefreitas', 'rschaaf', 'stam', 'krichards', 'thomasodell2017', 'nickmartin44', 'tav162', 'ajaynadig1', 'nnwagbo', 'dfloyd', 'akmohring', 'mwaldegerma', 'elisa4201', 'pmccullough', 'kqu', 'dmw514']"
1,35,194,236,190,"['n6n8u3', 'jameswillis2017', 'sgorlick', 'juanmena2017', 'hopkins2', 'robertzhu2017', 'nward', 'lchen', 'gesta', 'alila', 'emilymorris2017', 'lafern', 'bbl076', 'sshull', 'annapetersen21', 'krembisz', 'jbs916', 'bishtonn', 'bdougherty', 'gmc830', 'imasamba', 'bbecerra', 'nasher', 'mmihalache', 'vmehta', 'jschaefer', 'jburkechem122', 'isi.sturla', 'sdaniel', 'mattsherman95', 'abfilicko05', 'nuchem102', 'ajsnu', 'rmehta95', 'annaduban2017', 'smezyk7', 'gallardoy09', 'cfleesmith', 'obabatola', 'uditapersaud', 'cmucharraz', 'gcohen', 'myi', 'nicholas.mccombe.3', 'tla95', 'kkim27', 'rweidinger', 'rodriguez.ricardo13', 'broconnell', 'amyers17', 'alw231', 'melikimmy', 'coravasserman2017', 'swert', 'mpostoll4', 'jsammon', 'marinamin2017', 'lra391', 'ajennings', 'lindseymehl2017', 'lisa.kim.961993', 'bspielman', 'kathrynpillischafske2017', 'msobhani', 'jesus.leon1', 'ydeng', 'dperlovsky', 'kimhoff', 'christycal17', 'jalonbrown', 'ljung', 'mfluellen', 'aostenso', 'sauditore', 'mgullott', 'miriam.perez.35574', 'bfeinstein', 'ssbanic', 'bkraft383', 'vilte', 'igau', 'eam093', 'cweers', 'mdoody359', 'vrutherford', 'kschuster', 'j3nnif3r37', 'pcastro', 'jtucker', 'rsarette', 'ggillow', 'benedict.dungca', 'sem742', 'nn3210', 'jruan', 'estebanmercado2017', 'emathews', 'shwang', 'geapen', 'jvegaperkins713', 'lsleung', 'jdk681', 'mhopfner', 'yokim', 'santana', 'hpervaiz', 'aparikh22', 'asears', 'rst345', 'ellenpatterson2017', 'catherineding', 'annapreston2017', 'gcamozzi', 'kgong', 'njandali', 'crobinson19', 'bananapiehl', 'agrenen', 'isaacheine', 'rachelrogers', 'ahofmeister', 'minjooson', 'aamattey', 'nwh027', 'wizu', 'ndivine', 'ijackylei', 'rboodram', 'annahinrichs', 'clacrosse', 'anewell', 'yuehu9510', 'joshauck', 'rsherman', 'kdaftary', 'afisher', 'marsak', 'phaun', 'jmarquez95', 'ddapuzzo', 'ecripe', 'jgw599', 'cfox', 'ecbold13', 'tstoimenoff', 'pgrewal', 'alzipursky', 'peter.g.vlahakis', 'tomliggett', 'juliakovalenko2017', 'ccj009', 'zfenske', 'jdrews', 'jvillanueva8', 'hannahbrady2017', 'hrucinski', 'camilleblackman2016', 'wjhager2016', 'kcm010', 'phawkyard', 'annedeb', 'james.amick94', 'hwhite', 'evanbeuningen', 'jki699', 'afarsheed', 'zwatson', 'vlh774', 'aveerina', 'glak', 'cconnelly', 'shorstman', 'rschaaf', 'stam', 'omarosorio2017', 'krichards', 'kristensmith2017', 'plim', 'mclark032', 'nnwagbo', 'jmccartney', 'laurenabruzzo2017', 'wlindstrom', 'bchen', 'marknelson2012', 'kqu', 'hlou88', 'bbair', 'mcoden', 'mstotzy1']",4,"['elisa4201', 'valeriek', 'nalharithi', 'davidkarlin2013']",46,"['kburke', 'selinaarceo2017', 'cjwethers', 'ozero', 'natalie555', 'xkirkham1', 'carlpieri2017', 'rachel.lin.96592', 'jwaltstadt', 'andrew_cramer2017', 'dfloyd367', 'hak656', 'meganpurdy', 'kaylabrooks', 'vaishali.mehta.925', 'achandran12', 'samilton840', 'jkk284', 'saskianaegele26', 'sobel.shawn', 'ericanderson2017', 'samuelkahn2017', 'annikahansen2017', 'shandon6', 'thenewflamel', 'thratsh', 'benjaminjones2017', 'lillie', 'joefobi2017', 'jschartz90', 'm.forrest', None, 'tefisbando', 'stephanyvalladares11', 'sarajohns2017', 'mhz636', 'pklimkow', 'wmckinney', 'scottgoldberg2017', 'ahw087', 'mattgates1995', 'mkelsten', 'mmcmullan', 'christopherpierce2017', 'creamnsugar', 'foulkes2']",240,"['jameswillis2017', 'sgorlick', 'robertzhu2017', 'gesta', 'alila', 'cjwethers', 'emilymorris2017', 'lafern', 'bbl076', 'nalharithi', 'annapetersen21', 'krembisz', 'bishtonn', 'gmc830', 'imasamba', 'nasher', 'vmehta', 'isi.sturla', 'sdaniel', 'abfilicko05', 'nuchem102', 'ajsnu', 'lillie', 'jschartz90', 'cfleesmith', 'gcohen', 'myi', 'tla95', 'kkim27', 'rodriguez.ricardo13', 'broconnell', 'selinaarceo2017', 'jsammon', 'natalie555', 'lra391', 'ajennings', 'rachel.lin.96592', 'hak656', 'kathrynpillischafske2017', 'ydeng', 'dperlovsky', 'kimhoff', 'jalonbrown', 'jkk284', 'sauditore', 'mgullott', 'miriam.perez.35574', 'bfeinstein', 'igau', 'mdoody359', 'j3nnif3r37', 'stephanyvalladares11', 'rsarette', 'benedict.dungca', 'sem742', 'emathews', 'shwang', 'geapen', 'jvegaperkins713', 'lsleung', 'yokim', 'dfloyd367', 'annapreston2017', 'kgong', 'bananapiehl', 'isaacheine', 'thenewflamel', 'ahofmeister', 'minjooson', 'ndivine', 'ijackylei', 'rboodram', 'annahinrichs', 'm.forrest', 'tefisbando', 'clacrosse', 'anewell', 'joshauck', 'rsherman', 'kdaftary', 'afisher', 'marsak', 'mkelsten', 'ecripe', 'jgw599', 'ecbold13', 'tstoimenoff', 'pgrewal', 'peter.g.vlahakis', 'tomliggett', 'zfenske', 'jvillanueva8', 'camilleblackman2016', 'hrucinski', 'carlpieri2017', 'kcm010', 'phawkyard', 'andrew_cramer2017', 'hwhite', 'afarsheed', 'jki699', 'vlh774', 'achandran12', 'cconnelly', 'shorstman', 'ericanderson2017', 'omarosorio2017', 'shandon6', 'davidkarlin2013', 'mclark032', 'jmccartney', 'laurenabruzzo2017', 'wlindstrom', None, 'mhz636', 'bchen', 'pklimkow', 'marknelson2012', 'scottgoldberg2017', 'hlou88', 'creamnsugar', 'n6n8u3', 'juanmena2017', 'hopkins2', 'nward', 'lchen', 'kburke', 'jbs916', 'sshull', 'bdougherty', 'bbecerra', 'mmihalache', 'jschaefer', 'jburkechem122', 'mattsherman95', 'benjaminjones2017', 'rmehta95', 'annaduban2017', 'joefobi2017', 'smezyk7', 'gallardoy09', 'obabatola', 'sarajohns2017', 'wmckinney', 'uditapersaud', 'cmucharraz', 'nicholas.mccombe.3', 'rweidinger', 'foulkes2', 'amyers17', 'alw231', 'melikimmy', 'coravasserman2017', 'swert', 'mpostoll4', 'marinamin2017', 'ozero', 'xkirkham1', 'lindseymehl2017', 'jwaltstadt', 'lisa.kim.961993', 'bspielman', 'msobhani', 'jesus.leon1', 'christycal17', 'ljung', 'samilton840', 'mfluellen', 'saskianaegele26', 'aostenso', 'samuelkahn2017', 'annikahansen2017', 'thratsh', 'ssbanic', 'bkraft383', 'vilte', 'eam093', 'cweers', 'vrutherford', 'kschuster', 'pcastro', 'jtucker', 'ggillow', 'ahw087', 'mattgates1995', 'nn3210', 'mmcmullan', 'jruan', 'estebanmercado2017', 'christopherpierce2017', 'jdk681', 'mhopfner', 'santana', 'hpervaiz', 'aparikh22', 'asears', 'rst345', 'ellenpatterson2017', 'catherineding', 'gcamozzi', 'njandali', 'crobinson19', 'sobel.shawn', 'agrenen', 'rachelrogers', 'aamattey', 'nwh027', 'wizu', 'yuehu9510', 'phaun', 'jmarquez95', 'ddapuzzo', 'cfox', 'alzipursky', 'juliakovalenko2017', 'ccj009', 'jdrews', 'hannahbrady2017', 'wjhager2016', 'annedeb', 'james.amick94', 'evanbeuningen', 'zwatson', 'kaylabrooks', 'vaishali.mehta.925', 'meganpurdy', 'glak', 'aveerina', 'rschaaf', 'stam', 'valeriek', 'krichards', 'kristensmith2017', 'plim', 'nnwagbo', 'elisa4201', 'kqu', 'bbair', 'mcoden', 'mstotzy1']"
1,132,194,10,8,"['asears', 'bchen', 'nward', 'marknelson2012', 'aveerina', 'nicholas.mccombe.3', 'estebanmercado2017', 'annedeb']",186,"['n6n8u3', 'jameswillis2017', 'sgorlick', 'juanmena2017', 'hopkins2', 'robertzhu2017', 'lchen', 'gesta', 'alila', 'emilymorris2017', 'lafern', 'bbl076', 'nalharithi', 'jbs916', 'annapetersen21', 'krembisz', 'sshull', 'bishtonn', 'bdougherty', 'gmc830', 'imasamba', 'bbecerra', 'nasher', 'mmihalache', 'vmehta', 'jschaefer', 'jburkechem122', 'isi.sturla', 'sdaniel', 'mattsherman95', 'abfilicko05', 'nuchem102', 'ajsnu', 'rmehta95', 'annaduban2017', 'smezyk7', 'gallardoy09', 'cfleesmith', 'obabatola', 'uditapersaud', 'cmucharraz', 'gcohen', 'myi', 'tla95', 'kkim27', 'rweidinger', 'rodriguez.ricardo13', 'broconnell', 'amyers17', 'alw231', 'melikimmy', 'coravasserman2017', 'swert', 'mpostoll4', 'jsammon', 'marinamin2017', 'lra391', 'ajennings', 'lindseymehl2017', 'lisa.kim.961993', 'bspielman', 'kathrynpillischafske2017', 'msobhani', 'jesus.leon1', 'ydeng', 'dperlovsky', 'kimhoff', 'christycal17', 'jalonbrown', 'ljung', 'mfluellen', 'aostenso', 'sauditore', 'mgullott', 'miriam.perez.35574', 'bfeinstein', 'ssbanic', 'bkraft383', 'vilte', 'igau', 'eam093', 'cweers', 'mdoody359', 'vrutherford', 'kschuster', 'j3nnif3r37', 'pcastro', 'jtucker', 'rsarette', 'ggillow', 'benedict.dungca', 'sem742', 'nn3210', 'jruan', 'emathews', 'shwang', 'geapen', 'jvegaperkins713', 'lsleung', 'jdk681', 'mhopfner', 'yokim', 'santana', 'hpervaiz', 'aparikh22', 'rst345', 'ellenpatterson2017', 'catherineding', 'annapreston2017', 'gcamozzi', 'kgong', 'njandali', 'crobinson19', 'bananapiehl', 'agrenen', 'isaacheine', 'rachelrogers', 'ahofmeister', 'minjooson', 'aamattey', 'nwh027', 'wizu', 'ndivine', 'ijackylei', 'rboodram', 'annahinrichs', 'clacrosse', 'anewell', 'yuehu9510', 'joshauck', 'rsherman', 'kdaftary', 'afisher', 'marsak', 'phaun', 'jmarquez95', 'ddapuzzo', 'ecripe', 'jgw599', 'cfox', 'ecbold13', 'tstoimenoff', 'pgrewal', 'alzipursky', 'peter.g.vlahakis', 'tomliggett', 'juliakovalenko2017', 'ccj009', 'zfenske', 'jdrews', 'jvillanueva8', 'hannahbrady2017', 'hrucinski', 'camilleblackman2016', 'wjhager2016', 'kcm010', 'phawkyard', 'james.amick94', 'hwhite', 'evanbeuningen', 'jki699', 'afarsheed', 'zwatson', 'vlh774', 'glak', 'cconnelly', 'shorstman', 'rschaaf', 'stam', 'omarosorio2017', 'valeriek', 'krichards', 'kristensmith2017', 'plim', 'davidkarlin2013', 'mclark032', 'nnwagbo', 'jmccartney', 'laurenabruzzo2017', 'wlindstrom', 'elisa4201', 'kqu', 'hlou88', 'bbair', 'mcoden', 'mstotzy1']",2,"['sbahena', None]",196,"['n6n8u3', 'jameswillis2017', 'sgorlick', 'juanmena2017', 'hopkins2', 'robertzhu2017', 'nward', 'lchen', 'gesta', 'alila', 'emilymorris2017', 'lafern', 'bbl076', 'nalharithi', 'jbs916', 'annapetersen21', 'krembisz', 'sshull', 'bishtonn', 'bdougherty', 'gmc830', 'imasamba', 'bbecerra', 'nasher', 'mmihalache', 'vmehta', 'jschaefer', 'jburkechem122', 'isi.sturla', 'sdaniel', 'mattsherman95', 'abfilicko05', 'nuchem102', 'ajsnu', 'rmehta95', 'annaduban2017', 'smezyk7', 'gallardoy09', 'cfleesmith', 'obabatola', 'uditapersaud', 'cmucharraz', 'gcohen', 'myi', 'nicholas.mccombe.3', 'tla95', 'kkim27', 'rweidinger', 'rodriguez.ricardo13', 'broconnell', 'amyers17', 'alw231', 'melikimmy', 'coravasserman2017', 'swert', 'mpostoll4', 'jsammon', 'marinamin2017', 'lra391', 'ajennings', 'lindseymehl2017', 'lisa.kim.961993', 'bspielman', 'kathrynpillischafske2017', 'msobhani', 'jesus.leon1', 'ydeng', 'dperlovsky', 'kimhoff', 'christycal17', 'jalonbrown', 'ljung', 'mfluellen', 'aostenso', 'sauditore', 'mgullott', 'miriam.perez.35574', 'bfeinstein', 'ssbanic', 'bkraft383', 'vilte', 'igau', 'eam093', 'cweers', 'mdoody359', 'vrutherford', 'kschuster', 'j3nnif3r37', 'pcastro', 'jtucker', 'rsarette', 'ggillow', 'benedict.dungca', 'sem742', 'nn3210', 'jruan', 'estebanmercado2017', 'emathews', 'shwang', 'geapen', 'jvegaperkins713', 'lsleung', 'jdk681', 'mhopfner', 'yokim', 'santana', 'hpervaiz', 'aparikh22', 'asears', 'rst345', 'ellenpatterson2017', 'catherineding', 'annapreston2017', 'gcamozzi', 'kgong', 'njandali', 'crobinson19', 'bananapiehl', 'agrenen', 'isaacheine', 'rachelrogers', 'ahofmeister', 'minjooson', 'aamattey', 'nwh027', 'wizu', 'ndivine', 'ijackylei', 'rboodram', 'annahinrichs', 'clacrosse', 'anewell', 'yuehu9510', 'joshauck', 'rsherman', 'kdaftary', 'afisher', 'marsak', 'phaun', 'jmarquez95', 'ddapuzzo', 'ecripe', 'jgw599', 'cfox', 'ecbold13', 'tstoimenoff', 'sbahena', 'pgrewal', 'alzipursky', 'peter.g.vlahakis', 'tomliggett', 'juliakovalenko2017', 'ccj009', 'zfenske', 'jdrews', 'jvillanueva8', 'hannahbrady2017', 'hrucinski', 'camilleblackman2016', 'wjhager2016', 'kcm010', 'phawkyard', 'annedeb', 'james.amick94', 'hwhite', 'evanbeuningen', 'jki699', 'afarsheed', 'zwatson', 'vlh774', 'aveerina', 'glak', 'cconnelly', 'shorstman', 'rschaaf', 'stam', 'omarosorio2017', 'valeriek', 'krichards', 'kristensmith2017', 'plim', 'davidkarlin2013', 'mclark032', 'nnwagbo', 'jmccartney', 'laurenabruzzo2017', 'wlindstrom', None, 'elisa4201', 'bchen', 'marknelson2012', 'kqu', 'hlou88', 'bbair', 'mcoden', 'mstotzy1']"
1,131,194,9,2,"['valeriek', 'sauditore']",192,"['n6n8u3', 'jameswillis2017', 'sgorlick', 'juanmena2017', 'hopkins2', 'robertzhu2017', 'nward', 'lchen', 'gesta', 'alila', 'emilymorris2017', 'lafern', 'bbl076', 'nalharithi', 'jbs916', 'annapetersen21', 'krembisz', 'sshull', 'bishtonn', 'bdougherty', 'gmc830', 'imasamba', 'bbecerra', 'nasher', 'mmihalache', 'vmehta', 'jschaefer', 'jburkechem122', 'isi.sturla', 'sdaniel', 'mattsherman95', 'abfilicko05', 'nuchem102', 'ajsnu', 'rmehta95', 'annaduban2017', 'smezyk7', 'gallardoy09', 'cfleesmith', 'obabatola', 'uditapersaud', 'cmucharraz', 'gcohen', 'myi', 'nicholas.mccombe.3', 'tla95', 'kkim27', 'rweidinger', 'rodriguez.ricardo13', 'broconnell', 'amyers17', 'alw231', 'melikimmy', 'coravasserman2017', 'swert', 'mpostoll4', 'jsammon', 'marinamin2017', 'lra391', 'ajennings', 'lindseymehl2017', 'lisa.kim.961993', 'bspielman', 'kathrynpillischafske2017', 'msobhani', 'jesus.leon1', 'ydeng', 'dperlovsky', 'kimhoff', 'christycal17', 'jalonbrown', 'ljung', 'mfluellen', 'aostenso', 'mgullott', 'miriam.perez.35574', 'bfeinstein', 'ssbanic', 'bkraft383', 'vilte', 'igau', 'eam093', 'cweers', 'mdoody359', 'vrutherford', 'kschuster', 'j3nnif3r37', 'pcastro', 'jtucker', 'rsarette', 'ggillow', 'benedict.dungca', 'sem742', 'nn3210', 'jruan', 'estebanmercado2017', 'emathews', 'shwang', 'geapen', 'jvegaperkins713', 'lsleung', 'jdk681', 'mhopfner', 'yokim', 'santana', 'hpervaiz', 'aparikh22', 'asears', 'rst345', 'ellenpatterson2017', 'catherineding', 'annapreston2017', 'gcamozzi', 'kgong', 'njandali', 'crobinson19', 'bananapiehl', 'agrenen', 'isaacheine', 'rachelrogers', 'ahofmeister', 'minjooson', 'aamattey', 'nwh027', 'wizu', 'ndivine', 'ijackylei', 'rboodram', 'annahinrichs', 'clacrosse', 'anewell', 'yuehu9510', 'joshauck', 'rsherman', 'kdaftary', 'afisher', 'marsak', 'phaun', 'jmarquez95', 'ddapuzzo', 'ecripe', 'jgw599', 'cfox', 'ecbold13', 'tstoimenoff', 'pgrewal', 'alzipursky', 'peter.g.vlahakis', 'tomliggett', 'juliakovalenko2017', 'ccj009', 'zfenske', 'jdrews', 'jvillanueva8', 'hannahbrady2017', 'hrucinski', 'camilleblackman2016', 'wjhager2016', 'kcm010', 'phawkyard', 'annedeb', 'james.amick94', 'hwhite', 'evanbeuningen', 'jki699', 'afarsheed', 'zwatson', 'vlh774', 'aveerina', 'glak', 'cconnelly', 'shorstman', 'rschaaf', 'stam', 'omarosorio2017', 'krichards', 'kristensmith2017', 'plim', 'davidkarlin2013', 'mclark032', 'nnwagbo', 'jmccartney', 'laurenabruzzo2017', 'wlindstrom', 'elisa4201', 'bchen', 'marknelson2012', 'kqu', 'hlou88', 'bbair', 'mcoden', 'mstotzy1']",7,"['tav162', 'sophiemilord2015', 'mmcadet1', 'radiohedzz', 'cprucnal', None, 'daguilar']",201,"['n6n8u3', 'jameswillis2017', 'sgorlick', 'juanmena2017', 'hopkins2', 'robertzhu2017', 'nward', 'lchen', 'gesta', 'alila', 'sophiemilord2015', 'mmcadet1', 'emilymorris2017', 'lafern', 'bbl076', 'nalharithi', 'jbs916', 'annapetersen21', 'krembisz', 'sshull', 'bishtonn', 'bdougherty', 'gmc830', 'imasamba', 'bbecerra', 'nasher', 'mmihalache', 'vmehta', 'jschaefer', 'jburkechem122', 'isi.sturla', 'sdaniel', 'mattsherman95', 'abfilicko05', 'nuchem102', 'ajsnu', 'rmehta95', 'annaduban2017', 'smezyk7', 'gallardoy09', 'cfleesmith', 'obabatola', 'uditapersaud', 'cmucharraz', 'gcohen', 'myi', 'nicholas.mccombe.3', 'tla95', 'kkim27', 'rweidinger', 'rodriguez.ricardo13', 'broconnell', 'amyers17', 'alw231', 'melikimmy', 'coravasserman2017', 'swert', 'mpostoll4', 'jsammon', 'marinamin2017', 'lra391', 'ajennings', 'lindseymehl2017', 'lisa.kim.961993', 'bspielman', 'kathrynpillischafske2017', 'msobhani', 'jesus.leon1', 'ydeng', 'dperlovsky', 'kimhoff', 'christycal17', 'jalonbrown', 'ljung', 'mfluellen', 'aostenso', 'sauditore', 'mgullott', 'miriam.perez.35574', 'bfeinstein', 'ssbanic', 'bkraft383', 'vilte', 'igau', 'eam093', 'cweers', 'mdoody359', 'radiohedzz', 'vrutherford', 'kschuster', 'j3nnif3r37', 'pcastro', 'jtucker', 'rsarette', 'ggillow', 'benedict.dungca', 'sem742', 'nn3210', 'jruan', 'estebanmercado2017', 'emathews', 'shwang', 'geapen', 'jvegaperkins713', 'lsleung', 'jdk681', 'mhopfner', 'yokim', 'santana', 'hpervaiz', 'aparikh22', 'asears', 'rst345', 'ellenpatterson2017', 'catherineding', 'annapreston2017', 'gcamozzi', 'kgong', 'njandali', 'crobinson19', 'bananapiehl', 'agrenen', 'isaacheine', 'rachelrogers', 'cprucnal', 'ahofmeister', 'minjooson', 'aamattey', 'nwh027', 'wizu', 'ndivine', 'ijackylei', 'rboodram', 'annahinrichs', 'clacrosse', 'anewell', 'yuehu9510', 'joshauck', 'rsherman', 'kdaftary', 'afisher', 'marsak', 'phaun', 'jmarquez95', 'ddapuzzo', 'ecripe', 'jgw599', 'cfox', 'ecbold13', 'tstoimenoff', 'pgrewal', 'alzipursky', 'peter.g.vlahakis', 'tomliggett', 'juliakovalenko2017', 'ccj009', 'zfenske', 'jdrews', 'jvillanueva8', 'hannahbrady2017', 'hrucinski', 'camilleblackman2016', 'wjhager2016', 'kcm010', 'phawkyard', 'annedeb', 'james.amick94', 'hwhite', 'evanbeuningen', 'jki699', 'afarsheed', 'zwatson', 'vlh774', 'aveerina', 'glak', 'cconnelly', 'shorstman', 'rschaaf', 'stam', 'omarosorio2017', 'valeriek', 'krichards', 'kristensmith2017', 'plim', 'tav162', 'davidkarlin2013', 'mclark032', 'nnwagbo', 'jmccartney', 'laurenabruzzo2017', 'wlindstrom', None, 'elisa4201', 'bchen', 'marknelson2012', 'kqu', 'hlou88', 'bbair', 'mcoden', 'mstotzy1', 'daguilar']"
2,198,162,149,138,"['jiyuxiao', 'viperacr', 'merridius', 'shahkaran94', 'rahulraju93', 'djinkorea', 'slin471992', 'lin194', 'danzuo', 'italy5150', 'chentan08', 'nsparik2', 'cjv21', 'premal.tailor', 'andsmy', 'carberr2', 'dekunukem', 'chumakabaghe', 'rglazer2', 'james.younce92', 'shugotanaka', 'dillon', 'weizeor2', 'kwh1210', 'bree.peng', 'dpatnai2', 'dudes', 'hnrcksn2', 'vanillayyy', 'tanaka6', 'temitayo.adeoshifogun', 'jingfu.nian', 'treetopluver', 'xia.alex', 'daosyn', 'yuanshuowu', 'gene820715', 'dziegle2', 'lipengyanghappy', 'xouyang5', 'siddhanth.munukutla', 'swojto', 'supermarth64', 'j234560', 'nopshusang', 'tan.ozdogan', 'koopmnn2', 'tiagovla', 'smsagan', 'ganshun', 'jayanth0001', 'kunyilin9211', 'jorden.brown.54', 'ajeong3', 'hpowen6', 'zhiyang2', 'zhen.mike', 'almulla', 'jeppydude', 'manu.shallow', 'jng12', 'fermat', 'lhendre2', 'jofu803', 'jayyao', 'boatmee', 'bojjave2', 'vanshk', 'seadler1', 'awesome.young.choi', 'zyao4', 'wywang2', 'yong.b.lee.73', 'broadhurst.josh', 'justin.danger.brooks', 'lee267', 'deveshj4', 'chris.12', 'nicolls1', 'yousaf_salam', 'amurthy26', 'kim619', 'olivercai', 'cano3', 'dereckluo', 'alex.t.zhu', 'ramaiah2', 'kjabon2', 'nmenne2', 'jhollen93', 'hanns16', 'rigotech', 'sivaram3', 'stupib', 'arjun.balwally', 'jakerock44', 'bkesler', 'yue.li.10441', 'ngoswam2', 'jiang100', 'andygongyb', 'sowinsk2', 'themanderson14', 'istayev2', 'aagrawa4', 'naraeyoon92', 'stephenbudhi', 'nparikh6', 'ryan.tompkins22', 'sing619', 'chou27', 'swang75', 'shunchu', 'zheshen', 'gvelard2edu', 'machali1', 'dantonacci', 'niktike', 'fujinam2', 'rbelul2', 'jshowail', 'zixing.wang.9', 'bsorich32', 'bcc4994', 'cnnorbe2', 'darwinwalters', 'reagan1', 'psahgal', 'leinber2', 'wesley.zhang.92', 'aldave', 'gduchar', 'scai7', 'apcomic', 'dliang8', 'lukic2', 'whyshouldimakeanaccountseriously', 'bwpmail']",23,"['duranma2', 'mika_mkia', 'gplauck', 'himelic2', 'wilner2', 'roychow2', 'tadekaw2', 'bonick2', 'srosenje', 'rustem.burkhanov', 'dytrych2', 'siravar2', 'matthewvilim', 'chanatr2', 'davidzhao26', 'davidservose', 'mikeeraci', 'bolesta2', 'subzeroscorpion', 'baur728', 'david.tomecek.94', 'jiranun2', 'dzugan2']",11,"['nesp215', 'arosmith3', 'sid.sethupathi', 'tomqin93', 'tyler.mey', 'jhou6', 'lyluyaoh', 'davidlee0248', 'ashimiz2', None, 'seiser2']",172,"['viperacr', 'mika_mkia', 'sid.sethupathi', 'merridius', 'himelic2', 'djinkorea', 'slin471992', 'tadekaw2', 'bonick2', 'nsparik2', 'premal.tailor', 'carberr2', 'chumakabaghe', 'rglazer2', 'james.younce92', 'weizeor2', 'kwh1210', 'bree.peng', 'dudes', 'hnrcksn2', 'vanillayyy', 'temitayo.adeoshifogun', 'treetopluver', 'daosyn', 'gene820715', 'siddhanth.munukutla', 'wilner2', 'roychow2', 'tiagovla', 'lyluyaoh', 'smsagan', 'ganshun', 'kunyilin9211', 'hpowen6', 'matthewvilim', 'jeppydude', 'almulla', 'jayyao', 'jofu803', 'boatmee', 'bojjave2', 'zyao4', 'deveshj4', 'yousaf_salam', 'amurthy26', 'kim619', 'cano3', 'dereckluo', 'kjabon2', 'nmenne2', 'jhollen93', 'hanns16', 'rigotech', 'jakerock44', 'davidservose', 'bolesta2', 'david.tomecek.94', 'yue.li.10441', 'ngoswam2', 'jiang100', 'themanderson14', 'istayev2', 'aagrawa4', 'naraeyoon92', 'nparikh6', 'ryan.tompkins22', 'sing619', 'chou27', 'swang75', 'zheshen', 'gvelard2edu', 'machali1', 'fujinam2', 'rustem.burkhanov', 'rbelul2', 'zixing.wang.9', 'bcc4994', 'cnnorbe2', 'darwinwalters', 'chanatr2', None, 'psahgal', 'aldave', 'wesley.zhang.92', 'gduchar', 'scai7', 'apcomic', 'dliang8', 'whyshouldimakeanaccountseriously', 'bwpmail', 'jiyuxiao', 'duranma2', 'rahulraju93', 'lin194', 'danzuo', 'italy5150', 'chentan08', 'tyler.mey', 'srosenje', 'cjv21', 'andsmy', 'dekunukem', 'dytrych2', 'seiser2', 'dillon', 'shugotanaka', 'baur728', 'dpatnai2', 'tanaka6', 'jingfu.nian', 'xia.alex', 'yuanshuowu', 'dziegle2', 'lipengyanghappy', 'xouyang5', 'swojto', 'supermarth64', 'j234560', 'nopshusang', 'tan.ozdogan', 'koopmnn2', 'ashimiz2', 'jayanth0001', 'jorden.brown.54', 'ajeong3', 'zhen.mike', 'zhiyang2', 'manu.shallow', 'jng12', 'fermat', 'lhendre2', 'vanshk', 'seadler1', 'awesome.young.choi', 'wywang2', 'yong.b.lee.73', 'broadhurst.josh', 'justin.danger.brooks', 'lee267', 'chris.12', 'nicolls1', 'olivercai', 'davidlee0248', 'arosmith3', 'alex.t.zhu', 'ramaiah2', 'davidzhao26', 'sivaram3', 'stupib', 'arjun.balwally', 'nesp215', 'subzeroscorpion', 'jiranun2', 'jhou6', 'bkesler', 'andygongyb', 'sowinsk2', 'gplauck', 'stephenbudhi', 'shunchu', 'dantonacci', 'tomqin93', 'niktike', 'jshowail', 'bsorich32', 'siravar2', 'reagan1', 'leinber2', 'mikeeraci', 'dzugan2', 'lukic2', 'shahkaran94']"
2,33,162,140,135,"['jiyuxiao', 'viperacr', 'mika_mkia', 'merridius', 'shahkaran94', 'rahulraju93', 'djinkorea', 'slin471992', 'lin194', 'danzuo', 'italy5150', 'chentan08', 'nsparik2', 'srosenje', 'cjv21', 'premal.tailor', 'andsmy', 'carberr2', 'dekunukem', 'chumakabaghe', 'rglazer2', 'james.younce92', 'shugotanaka', 'dillon', 'weizeor2', 'kwh1210', 'baur728', 'bree.peng', 'dpatnai2', 'dudes', 'hnrcksn2', 'vanillayyy', 'tanaka6', 'temitayo.adeoshifogun', 'jingfu.nian', 'treetopluver', 'xia.alex', 'daosyn', 'yuanshuowu', 'gene820715', 'dziegle2', 'lipengyanghappy', 'xouyang5', 'siddhanth.munukutla', 'swojto', 'supermarth64', 'j234560', 'nopshusang', 'tan.ozdogan', 'koopmnn2', 'tiagovla', 'smsagan', 'ganshun', 'jayanth0001', 'hpowen6', 'zhiyang2', 'matthewvilim', 'jeppydude', 'manu.shallow', 'jng12', 'fermat', 'lhendre2', 'jofu803', 'jayyao', 'boatmee', 'bojjave2', 'vanshk', 'seadler1', 'awesome.young.choi', 'zyao4', 'wywang2', 'yong.b.lee.73', 'broadhurst.josh', 'justin.danger.brooks', 'lee267', 'deveshj4', 'nicolls1', 'yousaf_salam', 'amurthy26', 'kim619', 'cano3', 'dereckluo', 'ramaiah2', 'kjabon2', 'nmenne2', 'jhollen93', 'hanns16', 'davidzhao26', 'sivaram3', 'rigotech', 'stupib', 'arjun.balwally', 'jakerock44', 'bkesler', 'yue.li.10441', 'ngoswam2', 'jiang100', 'andygongyb', 'sowinsk2', 'themanderson14', 'istayev2', 'aagrawa4', 'naraeyoon92', 'stephenbudhi', 'nparikh6', 'ryan.tompkins22', 'sing619', 'chou27', 'swang75', 'shunchu', 'zheshen', 'gvelard2edu', 'machali1', 'niktike', 'fujinam2', 'rustem.burkhanov', 'rbelul2', 'jshowail', 'zixing.wang.9', 'bsorich32', 'bcc4994', 'cnnorbe2', 'darwinwalters', 'reagan1', 'psahgal', 'leinber2', 'wesley.zhang.92', 'aldave', 'gduchar', 'scai7', 'apcomic', 'dliang8', 'lukic2', 'whyshouldimakeanaccountseriously', 'bwpmail']",26,"['duranma2', 'gplauck', 'chris.12', 'himelic2', 'wilner2', 'roychow2', 'tadekaw2', 'dantonacci', 'bonick2', 'olivercai', 'kunyilin9211', 'jorden.brown.54', 'alex.t.zhu', 'ajeong3', 'dytrych2', 'zhen.mike', 'siravar2', 'chanatr2', 'almulla', 'davidservose', 'mikeeraci', 'bolesta2', 'subzeroscorpion', 'david.tomecek.94', 'jiranun2', 'dzugan2']",5,"['gabriel.hruskovec', 'tyler.mey', 'wang217', 'ashimiz2', None]",166,"['jiyuxiao', 'duranma2', 'viperacr', 'mika_mkia', 'merridius', 'shahkaran94', 'himelic2', 'rahulraju93', 'djinkorea', 'slin471992', 'lin194', 'tadekaw2', 'bonick2', 'danzuo', 'nsparik2', 'italy5150', 'chentan08', 'srosenje', 'cjv21', 'tyler.mey', 'premal.tailor', 'andsmy', 'carberr2', 'dekunukem', 'dytrych2', 'chumakabaghe', 'rglazer2', 'james.younce92', 'dillon', 'shugotanaka', 'weizeor2', 'kwh1210', 'baur728', 'bree.peng', 'dpatnai2', 'dudes', 'hnrcksn2', 'tanaka6', 'vanillayyy', 'temitayo.adeoshifogun', 'jingfu.nian', 'xia.alex', 'daosyn', 'treetopluver', 'gene820715', 'yuanshuowu', 'dziegle2', 'lipengyanghappy', 'xouyang5', 'siddhanth.munukutla', 'wilner2', 'swojto', 'supermarth64', 'roychow2', 'j234560', 'nopshusang', 'tan.ozdogan', 'koopmnn2', 'tiagovla', 'smsagan', 'ganshun', 'ashimiz2', 'jayanth0001', 'kunyilin9211', 'jorden.brown.54', 'ajeong3', 'zhen.mike', 'zhiyang2', 'hpowen6', 'gabriel.hruskovec', 'matthewvilim', 'jeppydude', 'manu.shallow', 'almulla', 'jng12', 'fermat', 'lhendre2', 'jayyao', 'jofu803', 'boatmee', 'bojjave2', 'vanshk', 'seadler1', 'awesome.young.choi', 'zyao4', 'wywang2', 'yong.b.lee.73', 'broadhurst.josh', 'justin.danger.brooks', 'lee267', 'deveshj4', 'chris.12', 'nicolls1', 'yousaf_salam', 'amurthy26', 'kim619', 'olivercai', 'wang217', 'cano3', 'dereckluo', 'alex.t.zhu', 'ramaiah2', 'kjabon2', 'nmenne2', 'jhollen93', 'hanns16', 'rigotech', 'sivaram3', 'davidzhao26', 'stupib', 'arjun.balwally', 'jakerock44', 'davidservose', 'bolesta2', 'subzeroscorpion', 'david.tomecek.94', 'jiranun2', 'bkesler', 'yue.li.10441', 'ngoswam2', 'andygongyb', 'jiang100', 'sowinsk2', 'themanderson14', 'istayev2', 'gplauck', 'aagrawa4', 'naraeyoon92', 'stephenbudhi', 'nparikh6', 'ryan.tompkins22', 'sing619', 'chou27', 'swang75', 'shunchu', 'zheshen', 'gvelard2edu', 'machali1', 'dantonacci', 'niktike', 'fujinam2', 'rustem.burkhanov', 'rbelul2', 'jshowail', 'zixing.wang.9', 'bsorich32', 'bcc4994', 'cnnorbe2', 'darwinwalters', 'siravar2', 'chanatr2', 'reagan1', None, 'leinber2', 'psahgal', 'aldave', 'mikeeraci', 'wesley.zhang.92', 'gduchar', 'scai7', 'apcomic', 'dzugan2', 'dliang8', 'lukic2', 'whyshouldimakeanaccountseriously', 'bwpmail']"
2,78,162,71,55,"['viperacr', 'broadhurst.josh', 'daosyn', 'gplauck', 'aagrawa4', 'chris.12', 'vanillayyy', 'sing619', 'supermarth64', 'nicolls1', 'roychow2', 'yousaf_salam', 'gvelard2edu', 'nopshusang', 'chentan08', 'danzuo', 'nsparik2', 'olivercai', 'fujinam2', 'tiagovla', 'ganshun', 'kunyilin9211', 'dereckluo', 'alex.t.zhu', 'dekunukem', 'kjabon2', 'ajeong3', 'bcc4994', 'zhiyang2', 'wywang2', 'darwinwalters', 'reagan1', 'jeppydude', 'chumakabaghe', 'manu.shallow', 'stupib', 'arjun.balwally', 'psahgal', 'leinber2', 'james.younce92', 'jofu803', 'whyshouldimakeanaccountseriously', 'wesley.zhang.92', 'weizeor2', 'baur728', 'jiranun2', 'bree.peng', 'bojjave2', 'vanshk', 'bkesler', 'dliang8', 'yue.li.10441', 'dudes', 'ngoswam2', 'yong.b.lee.73']",106,"['jiyuxiao', 'duranma2', 'mika_mkia', 'merridius', 'himelic2', 'rahulraju93', 'djinkorea', 'slin471992', 'lin194', 'tadekaw2', 'bonick2', 'italy5150', 'srosenje', 'cjv21', 'premal.tailor', 'andsmy', 'carberr2', 'dytrych2', 'rglazer2', 'dillon', 'shugotanaka', 'kwh1210', 'dpatnai2', 'hnrcksn2', 'tanaka6', 'temitayo.adeoshifogun', 'jingfu.nian', 'xia.alex', 'treetopluver', 'gene820715', 'yuanshuowu', 'dziegle2', 'lipengyanghappy', 'xouyang5', 'siddhanth.munukutla', 'wilner2', 'swojto', 'j234560', 'tan.ozdogan', 'koopmnn2', 'smsagan', 'jayanth0001', 'jorden.brown.54', 'hpowen6', 'zhen.mike', 'matthewvilim', 'almulla', 'jng12', 'fermat', 'lhendre2', 'jayyao', 'boatmee', 'seadler1', 'awesome.young.choi', 'zyao4', 'justin.danger.brooks', 'lee267', 'deveshj4', 'amurthy26', 'kim619', 'cano3', 'ramaiah2', 'nmenne2', 'jhollen93', 'hanns16', 'rigotech', 'sivaram3', 'davidzhao26', 'jakerock44', 'davidservose', 'bolesta2', 'subzeroscorpion', 'david.tomecek.94', 'jiang100', 'andygongyb', 'sowinsk2', 'themanderson14', 'istayev2', 'naraeyoon92', 'stephenbudhi', 'nparikh6', 'ryan.tompkins22', 'chou27', 'swang75', 'shunchu', 'zheshen', 'machali1', 'dantonacci', 'niktike', 'rustem.burkhanov', 'rbelul2', 'jshowail', 'zixing.wang.9', 'bsorich32', 'cnnorbe2', 'siravar2', 'chanatr2', 'aldave', 'mikeeraci', 'gduchar', 'scai7', 'apcomic', 'dzugan2', 'lukic2', 'shahkaran94', 'bwpmail']",16,"['michael.goodlow', 'ejander2', 'adams52', 'gvelard2', 'jdallesasse', 'rohanbambery', 'sehui04', 'garrettnducharme', 'tyler.mey', 'beholla2', 'dlee210', 'pmarian2', 'tommyfedrigon', 'ashimiz2', None, 'jiyuxiao2010']",177,"['jiyuxiao', 'duranma2', 'viperacr', 'mika_mkia', 'merridius', 'shahkaran94', 'himelic2', 'rahulraju93', 'djinkorea', 'slin471992', 'lin194', 'tadekaw2', 'sehui04', 'bonick2', 'danzuo', 'nsparik2', 'italy5150', 'chentan08', 'srosenje', 'cjv21', 'tyler.mey', 'premal.tailor', 'andsmy', 'carberr2', 'dekunukem', 'dytrych2', 'chumakabaghe', 'rglazer2', 'james.younce92', 'dillon', 'shugotanaka', 'weizeor2', 'kwh1210', 'baur728', 'bree.peng', 'dpatnai2', 'dudes', 'hnrcksn2', 'tanaka6', 'vanillayyy', 'temitayo.adeoshifogun', 'jingfu.nian', 'xia.alex', 'daosyn', 'treetopluver', 'gene820715', 'yuanshuowu', 'dziegle2', 'lipengyanghappy', 'xouyang5', 'siddhanth.munukutla', 'wilner2', 'swojto', 'supermarth64', 'roychow2', 'garrettnducharme', 'jiyuxiao2010', 'jdallesasse', 'j234560', 'nopshusang', 'tan.ozdogan', 'koopmnn2', 'tiagovla', 'smsagan', 'pmarian2', 'ganshun', 'ashimiz2', 'jayanth0001', 'kunyilin9211', 'jorden.brown.54', 'ajeong3', 'zhen.mike', 'zhiyang2', 'hpowen6', 'matthewvilim', 'jeppydude', 'manu.shallow', 'almulla', 'dlee210', 'jng12', 'fermat', 'lhendre2', 'jayyao', 'jofu803', 'boatmee', 'bojjave2', 'vanshk', 'seadler1', 'awesome.young.choi', 'zyao4', 'wywang2', 'yong.b.lee.73', 'broadhurst.josh', 'justin.danger.brooks', 'lee267', 'deveshj4', 'chris.12', 'nicolls1', 'yousaf_salam', 'gvelard2', 'amurthy26', 'kim619', 'olivercai', 'cano3', 'dereckluo', 'alex.t.zhu', 'ramaiah2', 'kjabon2', 'nmenne2', 'jhollen93', 'hanns16', 'rigotech', 'sivaram3', 'davidzhao26', 'beholla2', 'stupib', 'arjun.balwally', 'tommyfedrigon', 'jakerock44', 'davidservose', 'bolesta2', 'subzeroscorpion', 'david.tomecek.94', 'jiranun2', 'bkesler', 'yue.li.10441', 'ngoswam2', 'andygongyb', 'jiang100', 'sowinsk2', 'rohanbambery', 'themanderson14', 'istayev2', 'gplauck', 'aagrawa4', 'naraeyoon92', 'stephenbudhi', 'nparikh6', 'ryan.tompkins22', 'sing619', 'chou27', 'swang75', 'michael.goodlow', 'shunchu', 'adams52', 'zheshen', 'gvelard2edu', 'machali1', 'dantonacci', 'niktike', 'fujinam2', 'rustem.burkhanov', 'rbelul2', 'ejander2', 'jshowail', 'zixing.wang.9', 'bsorich32', 'bcc4994', 'cnnorbe2', 'darwinwalters', 'siravar2', 'chanatr2', 'reagan1', None, 'leinber2', 'psahgal', 'aldave', 'mikeeraci', 'wesley.zhang.92', 'gduchar', 'scai7', 'apcomic', 'dzugan2', 'dliang8', 'lukic2', 'whyshouldimakeanaccountseriously', 'bwpmail']"
2,39,162,26,1,['daosyn'],160,"['jiyuxiao', 'duranma2', 'viperacr', 'mika_mkia', 'merridius', 'shahkaran94', 'himelic2', 'rahulraju93', 'djinkorea', 'slin471992', 'lin194', 'tadekaw2', 'bonick2', 'danzuo', 'nsparik2', 'italy5150', 'chentan08', 'srosenje', 'cjv21', 'premal.tailor', 'andsmy', 'carberr2', 'dekunukem', 'dytrych2', 'chumakabaghe', 'rglazer2', 'james.younce92', 'dillon', 'shugotanaka', 'weizeor2', 'kwh1210', 'baur728', 'bree.peng', 'dpatnai2', 'dudes', 'hnrcksn2', 'tanaka6', 'vanillayyy', 'temitayo.adeoshifogun', 'jingfu.nian', 'xia.alex', 'treetopluver', 'gene820715', 'yuanshuowu', 'dziegle2', 'lipengyanghappy', 'xouyang5', 'siddhanth.munukutla', 'wilner2', 'swojto', 'supermarth64', 'roychow2', 'j234560', 'nopshusang', 'tan.ozdogan', 'koopmnn2', 'tiagovla', 'smsagan', 'ganshun', 'jayanth0001', 'kunyilin9211', 'jorden.brown.54', 'ajeong3', 'zhen.mike', 'zhiyang2', 'hpowen6', 'matthewvilim', 'jeppydude', 'manu.shallow', 'almulla', 'jng12', 'fermat', 'lhendre2', 'jayyao', 'jofu803', 'boatmee', 'bojjave2', 'vanshk', 'seadler1', 'awesome.young.choi', 'zyao4', 'wywang2', 'yong.b.lee.73', 'broadhurst.josh', 'justin.danger.brooks', 'lee267', 'deveshj4', 'chris.12', 'nicolls1', 'yousaf_salam', 'amurthy26', 'kim619', 'olivercai', 'cano3', 'dereckluo', 'alex.t.zhu', 'ramaiah2', 'kjabon2', 'nmenne2', 'jhollen93', 'hanns16', 'rigotech', 'sivaram3', 'davidzhao26', 'stupib', 'arjun.balwally', 'jakerock44', 'davidservose', 'bolesta2', 'subzeroscorpion', 'david.tomecek.94', 'jiranun2', 'bkesler', 'yue.li.10441', 'ngoswam2', 'andygongyb', 'jiang100', 'sowinsk2', 'themanderson14', 'istayev2', 'gplauck', 'aagrawa4', 'naraeyoon92', 'stephenbudhi', 'nparikh6', 'ryan.tompkins22', 'sing619', 'chou27', 'swang75', 'shunchu', 'zheshen', 'gvelard2edu', 'machali1', 'dantonacci', 'niktike', 'fujinam2', 'rustem.burkhanov', 'rbelul2', 'jshowail', 'zixing.wang.9', 'bsorich32', 'bcc4994', 'cnnorbe2', 'darwinwalters', 'siravar2', 'chanatr2', 'reagan1', 'leinber2', 'psahgal', 'aldave', 'mikeeraci', 'wesley.zhang.92', 'gduchar', 'scai7', 'apcomic', 'dzugan2', 'dliang8', 'lukic2', 'whyshouldimakeanaccountseriously', 'bwpmail']",25,"['myloginname', 'bohmbac2', 'arpraka2', 'kyhan2', 'connor.ekelund', 'brinkmanship', 'sabareesh.kumar', 'xak1101', 'xman', 'surya2', 'mdreis2', 'aspire.chan', 'aishsingh', 't14', 'marvadar', 'wstreyer', None, 'fengkaiyin2010', 'fajardo1', 'johnlu1', 'datye1', 'bholybee', 'haukchung', 'tschop2', 'azure3t']",186,"['jiyuxiao', 'duranma2', 'viperacr', 'mika_mkia', 'brinkmanship', 'merridius', 'shahkaran94', 'himelic2', 'rahulraju93', 'djinkorea', 'slin471992', 'lin194', 'tadekaw2', 'bonick2', 'xman', 'danzuo', 'nsparik2', 'italy5150', 'chentan08', 'srosenje', 'cjv21', 'premal.tailor', 'andsmy', 'carberr2', 'dekunukem', 'dytrych2', 'wstreyer', 'chumakabaghe', 'rglazer2', 'james.younce92', 'datye1', 'dillon', 'shugotanaka', 'weizeor2', 'kwh1210', 'baur728', 'tschop2', 'bree.peng', 'dpatnai2', 'dudes', 'hnrcksn2', 'tanaka6', 'vanillayyy', 'temitayo.adeoshifogun', 'bohmbac2', 'jingfu.nian', 'xia.alex', 'daosyn', 'treetopluver', 'gene820715', 'yuanshuowu', 'dziegle2', 'lipengyanghappy', 'xouyang5', 'siddhanth.munukutla', 'wilner2', 'swojto', 'supermarth64', 'roychow2', 'j234560', 'nopshusang', 'tan.ozdogan', 'koopmnn2', 'tiagovla', 'smsagan', 'ganshun', 'jayanth0001', 'kunyilin9211', 't14', 'jorden.brown.54', 'ajeong3', 'zhen.mike', 'zhiyang2', 'hpowen6', 'matthewvilim', 'jeppydude', 'manu.shallow', 'almulla', 'jng12', 'fermat', 'lhendre2', 'jayyao', 'jofu803', 'boatmee', 'bojjave2', 'vanshk', 'seadler1', 'awesome.young.choi', 'zyao4', 'wywang2', 'yong.b.lee.73', 'arpraka2', 'broadhurst.josh', 'justin.danger.brooks', 'lee267', 'deveshj4', 'chris.12', 'sabareesh.kumar', 'nicolls1', 'yousaf_salam', 'amurthy26', 'kim619', 'olivercai', 'surya2', 'mdreis2', 'cano3', 'aishsingh', 'dereckluo', 'alex.t.zhu', 'ramaiah2', 'kjabon2', 'nmenne2', 'jhollen93', 'hanns16', 'rigotech', 'sivaram3', 'davidzhao26', 'stupib', 'arjun.balwally', 'fajardo1', 'jakerock44', 'johnlu1', 'davidservose', 'bholybee', 'bolesta2', 'subzeroscorpion', 'david.tomecek.94', 'jiranun2', 'bkesler', 'yue.li.10441', 'ngoswam2', 'andygongyb', 'jiang100', 'sowinsk2', 'myloginname', 'themanderson14', 'istayev2', 'gplauck', 'aagrawa4', 'kyhan2', 'connor.ekelund', 'naraeyoon92', 'stephenbudhi', 'nparikh6', 'ryan.tompkins22', 'sing619', 'chou27', 'swang75', 'shunchu', 'zheshen', 'xak1101', 'gvelard2edu', 'machali1', 'dantonacci', 'niktike', 'fujinam2', 'rustem.burkhanov', 'rbelul2', 'aspire.chan', 'jshowail', 'marvadar', 'zixing.wang.9', 'bsorich32', 'bcc4994', 'cnnorbe2', 'darwinwalters', 'siravar2', 'chanatr2', 'reagan1', None, 'fengkaiyin2010', 'leinber2', 'psahgal', 'aldave', 'mikeeraci', 'wesley.zhang.92', 'gduchar', 'scai7', 'haukchung', 'apcomic', 'dzugan2', 'dliang8', 'azure3t', 'lukic2', 'whyshouldimakeanaccountseriously', 'bwpmail']"
2,34,162,21,17,"['duranma2', 'jorden.brown.54', 'davidservose', 'dillon', 'zhen.mike', 'bolesta2', 'kwh1210', 'tadekaw2', 'darwinwalters', 'jiranun2', 'siravar2', 'chanatr2', 'himelic2', 'davidzhao26', 'fermat', 'rahulraju93', 'psahgal']",144,"['jiyuxiao', 'viperacr', 'mika_mkia', 'merridius', 'shahkaran94', 'djinkorea', 'slin471992', 'lin194', 'bonick2', 'danzuo', 'nsparik2', 'italy5150', 'chentan08', 'srosenje', 'cjv21', 'premal.tailor', 'andsmy', 'carberr2', 'dekunukem', 'dytrych2', 'chumakabaghe', 'rglazer2', 'james.younce92', 'shugotanaka', 'weizeor2', 'baur728', 'bree.peng', 'dpatnai2', 'dudes', 'hnrcksn2', 'tanaka6', 'vanillayyy', 'temitayo.adeoshifogun', 'jingfu.nian', 'xia.alex', 'daosyn', 'treetopluver', 'gene820715', 'yuanshuowu', 'dziegle2', 'lipengyanghappy', 'xouyang5', 'siddhanth.munukutla', 'wilner2', 'swojto', 'supermarth64', 'roychow2', 'j234560', 'nopshusang', 'tan.ozdogan', 'koopmnn2', 'tiagovla', 'smsagan', 'ganshun', 'jayanth0001', 'kunyilin9211', 'ajeong3', 'zhiyang2', 'hpowen6', 'matthewvilim', 'jeppydude', 'manu.shallow', 'almulla', 'jng12', 'lhendre2', 'jayyao', 'jofu803', 'boatmee', 'bojjave2', 'vanshk', 'seadler1', 'awesome.young.choi', 'zyao4', 'wywang2', 'yong.b.lee.73', 'broadhurst.josh', 'justin.danger.brooks', 'lee267', 'deveshj4', 'chris.12', 'nicolls1', 'yousaf_salam', 'amurthy26', 'kim619', 'olivercai', 'cano3', 'dereckluo', 'alex.t.zhu', 'ramaiah2', 'kjabon2', 'nmenne2', 'jhollen93', 'hanns16', 'rigotech', 'sivaram3', 'stupib', 'arjun.balwally', 'jakerock44', 'subzeroscorpion', 'david.tomecek.94', 'bkesler', 'yue.li.10441', 'ngoswam2', 'andygongyb', 'jiang100', 'sowinsk2', 'themanderson14', 'istayev2', 'gplauck', 'aagrawa4', 'naraeyoon92', 'stephenbudhi', 'nparikh6', 'ryan.tompkins22', 'sing619', 'chou27', 'swang75', 'shunchu', 'zheshen', 'gvelard2edu', 'machali1', 'dantonacci', 'niktike', 'fujinam2', 'rustem.burkhanov', 'rbelul2', 'jshowail', 'zixing.wang.9', 'bsorich32', 'bcc4994', 'cnnorbe2', 'reagan1', 'leinber2', 'aldave', 'mikeeraci', 'wesley.zhang.92', 'gduchar', 'scai7', 'apcomic', 'dzugan2', 'dliang8', 'lukic2', 'whyshouldimakeanaccountseriously', 'bwpmail']",4,"['js574', 'ulisesd1', 'fhismail', None]",165,"['jiyuxiao', 'duranma2', 'viperacr', 'mika_mkia', 'merridius', 'shahkaran94', 'himelic2', 'rahulraju93', 'djinkorea', 'slin471992', 'lin194', 'tadekaw2', 'bonick2', 'danzuo', 'nsparik2', 'italy5150', 'chentan08', 'srosenje', 'cjv21', 'premal.tailor', 'andsmy', 'carberr2', 'dekunukem', 'dytrych2', 'chumakabaghe', 'rglazer2', 'js574', 'fhismail', 'james.younce92', 'dillon', 'shugotanaka', 'weizeor2', 'kwh1210', 'baur728', 'bree.peng', 'dpatnai2', 'dudes', 'hnrcksn2', 'tanaka6', 'vanillayyy', 'temitayo.adeoshifogun', 'jingfu.nian', 'xia.alex', 'daosyn', 'treetopluver', 'gene820715', 'yuanshuowu', 'dziegle2', 'lipengyanghappy', 'xouyang5', 'siddhanth.munukutla', 'wilner2', 'swojto', 'supermarth64', 'roychow2', 'j234560', 'nopshusang', 'tan.ozdogan', 'koopmnn2', 'tiagovla', 'smsagan', 'ganshun', 'jayanth0001', 'kunyilin9211', 'jorden.brown.54', 'ajeong3', 'zhen.mike', 'zhiyang2', 'hpowen6', 'matthewvilim', 'jeppydude', 'manu.shallow', 'almulla', 'jng12', 'fermat', 'lhendre2', 'jayyao', 'jofu803', 'boatmee', 'bojjave2', 'vanshk', 'ulisesd1', 'seadler1', 'awesome.young.choi', 'zyao4', 'wywang2', 'yong.b.lee.73', 'broadhurst.josh', 'justin.danger.brooks', 'lee267', 'deveshj4', 'chris.12', 'nicolls1', 'yousaf_salam', 'amurthy26', 'kim619', 'olivercai', 'cano3', 'dereckluo', 'alex.t.zhu', 'ramaiah2', 'kjabon2', 'nmenne2', 'jhollen93', 'hanns16', 'rigotech', 'sivaram3', 'davidzhao26', 'stupib', 'arjun.balwally', 'jakerock44', 'davidservose', 'bolesta2', 'subzeroscorpion', 'david.tomecek.94', 'jiranun2', 'bkesler', 'yue.li.10441', 'ngoswam2', 'andygongyb', 'jiang100', 'sowinsk2', 'themanderson14', 'istayev2', 'gplauck', 'aagrawa4', 'naraeyoon92', 'stephenbudhi', 'nparikh6', 'ryan.tompkins22', 'sing619', 'chou27', 'swang75', 'shunchu', 'zheshen', 'gvelard2edu', 'machali1', 'dantonacci', 'niktike', 'fujinam2', 'rustem.burkhanov', 'rbelul2', 'jshowail', 'zixing.wang.9', 'bsorich32', 'bcc4994', 'cnnorbe2', 'darwinwalters', 'siravar2', 'chanatr2', 'reagan1', None, 'leinber2', 'psahgal', 'aldave', 'mikeeraci', 'wesley.zhang.92', 'gduchar', 'scai7', 'apcomic', 'dzugan2', 'dliang8', 'lukic2', 'whyshouldimakeanaccountseriously', 'bwpmail']"
2,56,162,21,1,['boatmee'],160,"['jiyuxiao', 'duranma2', 'viperacr', 'mika_mkia', 'merridius', 'shahkaran94', 'himelic2', 'rahulraju93', 'djinkorea', 'slin471992', 'lin194', 'tadekaw2', 'bonick2', 'danzuo', 'nsparik2', 'italy5150', 'chentan08', 'srosenje', 'cjv21', 'premal.tailor', 'andsmy', 'carberr2', 'dekunukem', 'dytrych2', 'chumakabaghe', 'rglazer2', 'james.younce92', 'dillon', 'shugotanaka', 'weizeor2', 'kwh1210', 'baur728', 'bree.peng', 'dpatnai2', 'dudes', 'hnrcksn2', 'tanaka6', 'vanillayyy', 'temitayo.adeoshifogun', 'jingfu.nian', 'xia.alex', 'daosyn', 'treetopluver', 'gene820715', 'yuanshuowu', 'dziegle2', 'lipengyanghappy', 'xouyang5', 'siddhanth.munukutla', 'wilner2', 'swojto', 'supermarth64', 'roychow2', 'j234560', 'nopshusang', 'tan.ozdogan', 'koopmnn2', 'tiagovla', 'smsagan', 'ganshun', 'jayanth0001', 'kunyilin9211', 'jorden.brown.54', 'ajeong3', 'zhen.mike', 'zhiyang2', 'hpowen6', 'matthewvilim', 'jeppydude', 'manu.shallow', 'almulla', 'jng12', 'fermat', 'lhendre2', 'jayyao', 'jofu803', 'bojjave2', 'vanshk', 'seadler1', 'awesome.young.choi', 'zyao4', 'wywang2', 'yong.b.lee.73', 'broadhurst.josh', 'justin.danger.brooks', 'lee267', 'deveshj4', 'chris.12', 'nicolls1', 'yousaf_salam', 'amurthy26', 'kim619', 'olivercai', 'cano3', 'dereckluo', 'alex.t.zhu', 'ramaiah2', 'kjabon2', 'nmenne2', 'jhollen93', 'hanns16', 'rigotech', 'sivaram3', 'davidzhao26', 'stupib', 'arjun.balwally', 'jakerock44', 'davidservose', 'bolesta2', 'subzeroscorpion', 'david.tomecek.94', 'jiranun2', 'bkesler', 'yue.li.10441', 'ngoswam2', 'andygongyb', 'jiang100', 'sowinsk2', 'themanderson14', 'istayev2', 'gplauck', 'aagrawa4', 'naraeyoon92', 'stephenbudhi', 'nparikh6', 'ryan.tompkins22', 'sing619', 'chou27', 'swang75', 'shunchu', 'zheshen', 'gvelard2edu', 'machali1', 'dantonacci', 'niktike', 'fujinam2', 'rustem.burkhanov', 'rbelul2', 'jshowail', 'zixing.wang.9', 'bsorich32', 'bcc4994', 'cnnorbe2', 'darwinwalters', 'siravar2', 'chanatr2', 'reagan1', 'leinber2', 'psahgal', 'aldave', 'mikeeraci', 'wesley.zhang.92', 'gduchar', 'scai7', 'apcomic', 'dzugan2', 'dliang8', 'lukic2', 'whyshouldimakeanaccountseriously', 'bwpmail']",20,"['lustera', 'chantar2', 'sahmad13', 'polariz90', 'robs94', 'carolgu', 'alibhujwala', 'dantexdsc', 'whuang12', 'crhee6', 'glaciation', 'zhuge2', 'xuhaobi2', None, 'benbenben', 'timj261', 'duke8253', 'dryzhak2', 'tnam5', 'brearto2']",181,"['jiyuxiao', 'duranma2', 'viperacr', 'mika_mkia', 'lustera', 'merridius', 'sahmad13', 'shahkaran94', 'himelic2', 'polariz90', 'rahulraju93', 'djinkorea', 'slin471992', 'lin194', 'tadekaw2', 'bonick2', 'danzuo', 'nsparik2', 'italy5150', 'chentan08', 'srosenje', 'cjv21', 'carolgu', 'premal.tailor', 'andsmy', 'carberr2', 'dekunukem', 'dytrych2', 'chumakabaghe', 'rglazer2', 'james.younce92', 'dillon', 'shugotanaka', 'weizeor2', 'kwh1210', 'baur728', 'bree.peng', 'dpatnai2', 'dudes', 'hnrcksn2', 'tanaka6', 'vanillayyy', 'temitayo.adeoshifogun', 'jingfu.nian', 'xia.alex', 'daosyn', 'treetopluver', 'gene820715', 'yuanshuowu', 'chantar2', 'dziegle2', 'lipengyanghappy', 'xouyang5', 'siddhanth.munukutla', 'wilner2', 'swojto', 'supermarth64', 'roychow2', 'j234560', 'nopshusang', 'tan.ozdogan', 'koopmnn2', 'tiagovla', 'smsagan', 'ganshun', 'jayanth0001', 'kunyilin9211', 'jorden.brown.54', 'ajeong3', 'zhen.mike', 'zhiyang2', 'hpowen6', 'matthewvilim', 'jeppydude', 'manu.shallow', 'almulla', 'zhuge2', 'jng12', 'fermat', 'lhendre2', 'benbenben', 'jayyao', 'jofu803', 'boatmee', 'bojjave2', 'vanshk', 'seadler1', 'awesome.young.choi', 'zyao4', 'wywang2', 'yong.b.lee.73', 'brearto2', 'tnam5', 'broadhurst.josh', 'justin.danger.brooks', 'lee267', 'deveshj4', 'chris.12', 'nicolls1', 'yousaf_salam', 'amurthy26', 'kim619', 'olivercai', 'cano3', 'dereckluo', 'alex.t.zhu', 'ramaiah2', 'kjabon2', 'whuang12', 'crhee6', 'nmenne2', 'jhollen93', 'hanns16', 'rigotech', 'sivaram3', 'davidzhao26', 'stupib', 'xuhaobi2', 'arjun.balwally', 'jakerock44', 'davidservose', 'timj261', 'bolesta2', 'subzeroscorpion', 'david.tomecek.94', 'jiranun2', 'bkesler', 'yue.li.10441', 'ngoswam2', 'andygongyb', 'jiang100', 'dryzhak2', 'sowinsk2', 'themanderson14', 'istayev2', 'gplauck', 'aagrawa4', 'naraeyoon92', 'stephenbudhi', 'nparikh6', 'ryan.tompkins22', 'sing619', 'robs94', 'chou27', 'swang75', 'shunchu', 'zheshen', 'gvelard2edu', 'machali1', 'dantonacci', 'niktike', 'fujinam2', 'rustem.burkhanov', 'rbelul2', 'alibhujwala', 'dantexdsc', 'jshowail', 'zixing.wang.9', 'bsorich32', 'bcc4994', 'cnnorbe2', 'darwinwalters', 'siravar2', 'glaciation', 'chanatr2', 'reagan1', None, 'leinber2', 'psahgal', 'aldave', 'mikeeraci', 'wesley.zhang.92', 'gduchar', 'scai7', 'apcomic', 'duke8253', 'dzugan2', 'dliang8', 'lukic2', 'whyshouldimakeanaccountseriously', 'bwpmail']"
2,199,162,21,17,"['duranma2', 'jorden.brown.54', 'davidservose', 'dillon', 'zhen.mike', 'bolesta2', 'tadekaw2', 'jiranun2', 'siravar2', 'chanatr2', 'himelic2', 'rigotech', 'wilner2', 'davidzhao26', 'fermat', 'rahulraju93', 'psahgal']",144,"['jiyuxiao', 'viperacr', 'mika_mkia', 'merridius', 'shahkaran94', 'djinkorea', 'slin471992', 'lin194', 'bonick2', 'danzuo', 'nsparik2', 'italy5150', 'chentan08', 'srosenje', 'cjv21', 'premal.tailor', 'andsmy', 'carberr2', 'dekunukem', 'dytrych2', 'chumakabaghe', 'rglazer2', 'james.younce92', 'shugotanaka', 'weizeor2', 'kwh1210', 'baur728', 'bree.peng', 'dpatnai2', 'dudes', 'hnrcksn2', 'tanaka6', 'vanillayyy', 'temitayo.adeoshifogun', 'jingfu.nian', 'xia.alex', 'daosyn', 'treetopluver', 'gene820715', 'yuanshuowu', 'dziegle2', 'lipengyanghappy', 'xouyang5', 'siddhanth.munukutla', 'swojto', 'supermarth64', 'roychow2', 'j234560', 'nopshusang', 'tan.ozdogan', 'koopmnn2', 'tiagovla', 'smsagan', 'ganshun', 'jayanth0001', 'kunyilin9211', 'ajeong3', 'zhiyang2', 'hpowen6', 'matthewvilim', 'jeppydude', 'manu.shallow', 'almulla', 'jng12', 'lhendre2', 'jayyao', 'jofu803', 'boatmee', 'bojjave2', 'vanshk', 'seadler1', 'awesome.young.choi', 'zyao4', 'wywang2', 'yong.b.lee.73', 'broadhurst.josh', 'justin.danger.brooks', 'lee267', 'deveshj4', 'chris.12', 'nicolls1', 'yousaf_salam', 'amurthy26', 'kim619', 'olivercai', 'cano3', 'dereckluo', 'alex.t.zhu', 'ramaiah2', 'kjabon2', 'nmenne2', 'jhollen93', 'hanns16', 'sivaram3', 'stupib', 'arjun.balwally', 'jakerock44', 'subzeroscorpion', 'david.tomecek.94', 'bkesler', 'yue.li.10441', 'ngoswam2', 'andygongyb', 'jiang100', 'sowinsk2', 'themanderson14', 'istayev2', 'gplauck', 'aagrawa4', 'naraeyoon92', 'stephenbudhi', 'nparikh6', 'ryan.tompkins22', 'sing619', 'chou27', 'swang75', 'shunchu', 'zheshen', 'gvelard2edu', 'machali1', 'dantonacci', 'niktike', 'fujinam2', 'rustem.burkhanov', 'rbelul2', 'jshowail', 'zixing.wang.9', 'bsorich32', 'bcc4994', 'cnnorbe2', 'darwinwalters', 'reagan1', 'leinber2', 'aldave', 'mikeeraci', 'wesley.zhang.92', 'gduchar', 'scai7', 'apcomic', 'dzugan2', 'dliang8', 'lukic2', 'whyshouldimakeanaccountseriously', 'bwpmail']",4,"['js574', 'apamapam', 'fhismail', None]",165,"['jiyuxiao', 'duranma2', 'viperacr', 'mika_mkia', 'merridius', 'apamapam', 'shahkaran94', 'himelic2', 'rahulraju93', 'djinkorea', 'slin471992', 'lin194', 'tadekaw2', 'bonick2', 'danzuo', 'nsparik2', 'italy5150', 'chentan08', 'srosenje', 'cjv21', 'premal.tailor', 'andsmy', 'carberr2', 'dekunukem', 'dytrych2', 'chumakabaghe', 'rglazer2', 'js574', 'fhismail', 'james.younce92', 'dillon', 'shugotanaka', 'weizeor2', 'kwh1210', 'baur728', 'bree.peng', 'dpatnai2', 'dudes', 'hnrcksn2', 'tanaka6', 'vanillayyy', 'temitayo.adeoshifogun', 'jingfu.nian', 'xia.alex', 'daosyn', 'treetopluver', 'gene820715', 'yuanshuowu', 'dziegle2', 'lipengyanghappy', 'xouyang5', 'siddhanth.munukutla', 'wilner2', 'swojto', 'supermarth64', 'roychow2', 'j234560', 'nopshusang', 'tan.ozdogan', 'koopmnn2', 'tiagovla', 'smsagan', 'ganshun', 'jayanth0001', 'kunyilin9211', 'jorden.brown.54', 'ajeong3', 'zhen.mike', 'zhiyang2', 'hpowen6', 'matthewvilim', 'jeppydude', 'manu.shallow', 'almulla', 'jng12', 'fermat', 'lhendre2', 'jayyao', 'jofu803', 'boatmee', 'bojjave2', 'vanshk', 'seadler1', 'awesome.young.choi', 'zyao4', 'wywang2', 'yong.b.lee.73', 'broadhurst.josh', 'justin.danger.brooks', 'lee267', 'deveshj4', 'chris.12', 'nicolls1', 'yousaf_salam', 'amurthy26', 'kim619', 'olivercai', 'cano3', 'dereckluo', 'alex.t.zhu', 'ramaiah2', 'kjabon2', 'nmenne2', 'jhollen93', 'hanns16', 'rigotech', 'sivaram3', 'davidzhao26', 'stupib', 'arjun.balwally', 'jakerock44', 'davidservose', 'bolesta2', 'subzeroscorpion', 'david.tomecek.94', 'jiranun2', 'bkesler', 'yue.li.10441', 'ngoswam2', 'andygongyb', 'jiang100', 'sowinsk2', 'themanderson14', 'istayev2', 'gplauck', 'aagrawa4', 'naraeyoon92', 'stephenbudhi', 'nparikh6', 'ryan.tompkins22', 'sing619', 'chou27', 'swang75', 'shunchu', 'zheshen', 'gvelard2edu', 'machali1', 'dantonacci', 'niktike', 'fujinam2', 'rustem.burkhanov', 'rbelul2', 'jshowail', 'zixing.wang.9', 'bsorich32', 'bcc4994', 'cnnorbe2', 'darwinwalters', 'siravar2', 'chanatr2', 'reagan1', None, 'leinber2', 'psahgal', 'aldave', 'mikeeraci', 'wesley.zhang.92', 'gduchar', 'scai7', 'apcomic', 'dzugan2', 'dliang8', 'lukic2', 'whyshouldimakeanaccountseriously', 'bwpmail']"
2,203,162,16,14,"['dereckluo', 'gene820715', 'aagrawa4', 'dantonacci', 'bree.peng', 'dliang8', 'yue.li.10441', 'manu.shallow', 'rigotech', 'sing619', 'awesome.young.choi', 'ngoswam2', 'yong.b.lee.73', 'roychow2']",147,"['jiyuxiao', 'duranma2', 'viperacr', 'mika_mkia', 'merridius', 'shahkaran94', 'himelic2', 'rahulraju93', 'djinkorea', 'slin471992', 'lin194', 'tadekaw2', 'bonick2', 'danzuo', 'nsparik2', 'italy5150', 'chentan08', 'srosenje', 'cjv21', 'premal.tailor', 'andsmy', 'carberr2', 'dekunukem', 'dytrych2', 'chumakabaghe', 'rglazer2', 'james.younce92', 'dillon', 'shugotanaka', 'weizeor2', 'kwh1210', 'baur728', 'dpatnai2', 'dudes', 'hnrcksn2', 'tanaka6', 'vanillayyy', 'temitayo.adeoshifogun', 'jingfu.nian', 'xia.alex', 'daosyn', 'treetopluver', 'yuanshuowu', 'dziegle2', 'lipengyanghappy', 'xouyang5', 'siddhanth.munukutla', 'wilner2', 'swojto', 'supermarth64', 'j234560', 'nopshusang', 'tan.ozdogan', 'koopmnn2', 'tiagovla', 'smsagan', 'ganshun', 'jayanth0001', 'kunyilin9211', 'jorden.brown.54', 'ajeong3', 'zhen.mike', 'zhiyang2', 'hpowen6', 'matthewvilim', 'jeppydude', 'almulla', 'jng12', 'fermat', 'lhendre2', 'jayyao', 'jofu803', 'boatmee', 'bojjave2', 'vanshk', 'seadler1', 'zyao4', 'wywang2', 'broadhurst.josh', 'justin.danger.brooks', 'lee267', 'deveshj4', 'chris.12', 'nicolls1', 'yousaf_salam', 'amurthy26', 'kim619', 'olivercai', 'cano3', 'alex.t.zhu', 'ramaiah2', 'kjabon2', 'nmenne2', 'jhollen93', 'hanns16', 'sivaram3', 'davidzhao26', 'stupib', 'arjun.balwally', 'jakerock44', 'davidservose', 'bolesta2', 'subzeroscorpion', 'david.tomecek.94', 'jiranun2', 'bkesler', 'andygongyb', 'jiang100', 'sowinsk2', 'themanderson14', 'istayev2', 'gplauck', 'naraeyoon92', 'stephenbudhi', 'nparikh6', 'ryan.tompkins22', 'chou27', 'swang75', 'shunchu', 'zheshen', 'gvelard2edu', 'machali1', 'niktike', 'fujinam2', 'rustem.burkhanov', 'rbelul2', 'jshowail', 'zixing.wang.9', 'bsorich32', 'bcc4994', 'cnnorbe2', 'darwinwalters', 'siravar2', 'chanatr2', 'reagan1', 'leinber2', 'psahgal', 'aldave', 'mikeeraci', 'wesley.zhang.92', 'gduchar', 'scai7', 'apcomic', 'dzugan2', 'lukic2', 'whyshouldimakeanaccountseriously', 'bwpmail']",2,"[None, 's.rajat1203']",163,"['jiyuxiao', 'duranma2', 'viperacr', 'mika_mkia', 'merridius', 'shahkaran94', 'himelic2', 's.rajat1203', 'rahulraju93', 'djinkorea', 'slin471992', 'lin194', 'tadekaw2', 'bonick2', 'danzuo', 'nsparik2', 'italy5150', 'chentan08', 'srosenje', 'cjv21', 'premal.tailor', 'andsmy', 'carberr2', 'dekunukem', 'dytrych2', 'chumakabaghe', 'rglazer2', 'james.younce92', 'dillon', 'shugotanaka', 'weizeor2', 'kwh1210', 'baur728', 'bree.peng', 'dpatnai2', 'dudes', 'hnrcksn2', 'tanaka6', 'vanillayyy', 'temitayo.adeoshifogun', 'jingfu.nian', 'xia.alex', 'daosyn', 'treetopluver', 'gene820715', 'yuanshuowu', 'dziegle2', 'lipengyanghappy', 'xouyang5', 'siddhanth.munukutla', 'wilner2', 'swojto', 'supermarth64', 'roychow2', 'j234560', 'nopshusang', 'tan.ozdogan', 'koopmnn2', 'tiagovla', 'smsagan', 'ganshun', 'jayanth0001', 'kunyilin9211', 'jorden.brown.54', 'ajeong3', 'zhen.mike', 'zhiyang2', 'hpowen6', 'matthewvilim', 'jeppydude', 'manu.shallow', 'almulla', 'jng12', 'fermat', 'lhendre2', 'jayyao', 'jofu803', 'boatmee', 'bojjave2', 'vanshk', 'seadler1', 'awesome.young.choi', 'zyao4', 'wywang2', 'yong.b.lee.73', 'broadhurst.josh', 'justin.danger.brooks', 'lee267', 'deveshj4', 'chris.12', 'nicolls1', 'yousaf_salam', 'amurthy26', 'kim619', 'olivercai', 'cano3', 'dereckluo', 'alex.t.zhu', 'ramaiah2', 'kjabon2', 'nmenne2', 'jhollen93', 'hanns16', 'rigotech', 'sivaram3', 'davidzhao26', 'stupib', 'arjun.balwally', 'jakerock44', 'davidservose', 'bolesta2', 'subzeroscorpion', 'david.tomecek.94', 'jiranun2', 'bkesler', 'yue.li.10441', 'ngoswam2', 'andygongyb', 'jiang100', 'sowinsk2', 'themanderson14', 'istayev2', 'gplauck', 'aagrawa4', 'naraeyoon92', 'stephenbudhi', 'nparikh6', 'ryan.tompkins22', 'sing619', 'chou27', 'swang75', 'shunchu', 'zheshen', 'gvelard2edu', 'machali1', 'dantonacci', 'niktike', 'fujinam2', 'rustem.burkhanov', 'rbelul2', 'jshowail', 'zixing.wang.9', 'bsorich32', 'bcc4994', 'cnnorbe2', 'darwinwalters', 'siravar2', 'chanatr2', 'reagan1', None, 'leinber2', 'psahgal', 'aldave', 'mikeeraci', 'wesley.zhang.92', 'gduchar', 'scai7', 'apcomic', 'dzugan2', 'dliang8', 'lukic2', 'whyshouldimakeanaccountseriously', 'bwpmail']"
2,79,162,11,10,"['duranma2', 'davidservose', 'aldave', 'dillon', 'tadekaw2', 'darwinwalters', 'chanatr2', 'himelic2', 'sivaram3', 'psahgal']",151,"['jiyuxiao', 'viperacr', 'mika_mkia', 'merridius', 'shahkaran94', 'rahulraju93', 'djinkorea', 'slin471992', 'lin194', 'bonick2', 'danzuo', 'nsparik2', 'italy5150', 'chentan08', 'srosenje', 'cjv21', 'premal.tailor', 'andsmy', 'carberr2', 'dekunukem', 'dytrych2', 'chumakabaghe', 'rglazer2', 'james.younce92', 'shugotanaka', 'weizeor2', 'kwh1210', 'baur728', 'bree.peng', 'dpatnai2', 'dudes', 'hnrcksn2', 'tanaka6', 'vanillayyy', 'temitayo.adeoshifogun', 'jingfu.nian', 'xia.alex', 'daosyn', 'treetopluver', 'gene820715', 'yuanshuowu', 'dziegle2', 'lipengyanghappy', 'xouyang5', 'siddhanth.munukutla', 'wilner2', 'swojto', 'supermarth64', 'roychow2', 'j234560', 'nopshusang', 'tan.ozdogan', 'koopmnn2', 'tiagovla', 'smsagan', 'ganshun', 'jayanth0001', 'kunyilin9211', 'jorden.brown.54', 'ajeong3', 'zhen.mike', 'zhiyang2', 'hpowen6', 'matthewvilim', 'jeppydude', 'manu.shallow', 'almulla', 'jng12', 'fermat', 'lhendre2', 'jayyao', 'jofu803', 'boatmee', 'bojjave2', 'vanshk', 'seadler1', 'awesome.young.choi', 'zyao4', 'wywang2', 'yong.b.lee.73', 'broadhurst.josh', 'justin.danger.brooks', 'lee267', 'deveshj4', 'chris.12', 'nicolls1', 'yousaf_salam', 'amurthy26', 'kim619', 'olivercai', 'cano3', 'dereckluo', 'alex.t.zhu', 'ramaiah2', 'kjabon2', 'nmenne2', 'jhollen93', 'hanns16', 'rigotech', 'davidzhao26', 'stupib', 'arjun.balwally', 'jakerock44', 'bolesta2', 'subzeroscorpion', 'david.tomecek.94', 'jiranun2', 'bkesler', 'yue.li.10441', 'ngoswam2', 'andygongyb', 'jiang100', 'sowinsk2', 'themanderson14', 'istayev2', 'gplauck', 'aagrawa4', 'naraeyoon92', 'stephenbudhi', 'nparikh6', 'ryan.tompkins22', 'sing619', 'chou27', 'swang75', 'shunchu', 'zheshen', 'gvelard2edu', 'machali1', 'dantonacci', 'niktike', 'fujinam2', 'rustem.burkhanov', 'rbelul2', 'jshowail', 'zixing.wang.9', 'bsorich32', 'bcc4994', 'cnnorbe2', 'siravar2', 'reagan1', 'leinber2', 'mikeeraci', 'wesley.zhang.92', 'gduchar', 'scai7', 'apcomic', 'dzugan2', 'dliang8', 'lukic2', 'whyshouldimakeanaccountseriously', 'bwpmail']",1,[None],162,"['jiyuxiao', 'duranma2', 'viperacr', 'mika_mkia', 'merridius', 'shahkaran94', 'himelic2', 'rahulraju93', 'djinkorea', 'slin471992', 'lin194', 'tadekaw2', 'bonick2', 'danzuo', 'nsparik2', 'italy5150', 'chentan08', 'srosenje', 'cjv21', 'premal.tailor', 'andsmy', 'carberr2', 'dekunukem', 'dytrych2', 'chumakabaghe', 'rglazer2', 'james.younce92', 'dillon', 'shugotanaka', 'weizeor2', 'kwh1210', 'baur728', 'bree.peng', 'dpatnai2', 'dudes', 'hnrcksn2', 'tanaka6', 'vanillayyy', 'temitayo.adeoshifogun', 'jingfu.nian', 'xia.alex', 'daosyn', 'treetopluver', 'gene820715', 'yuanshuowu', 'dziegle2', 'lipengyanghappy', 'xouyang5', 'siddhanth.munukutla', 'wilner2', 'swojto', 'supermarth64', 'roychow2', 'j234560', 'nopshusang', 'tan.ozdogan', 'koopmnn2', 'tiagovla', 'smsagan', 'ganshun', 'jayanth0001', 'kunyilin9211', 'jorden.brown.54', 'ajeong3', 'zhen.mike', 'zhiyang2', 'hpowen6', 'matthewvilim', 'jeppydude', 'manu.shallow', 'almulla', 'jng12', 'fermat', 'lhendre2', 'jayyao', 'jofu803', 'boatmee', 'bojjave2', 'vanshk', 'seadler1', 'awesome.young.choi', 'zyao4', 'wywang2', 'yong.b.lee.73', 'broadhurst.josh', 'justin.danger.brooks', 'lee267', 'deveshj4', 'chris.12', 'nicolls1', 'yousaf_salam', 'amurthy26', 'kim619', 'olivercai', 'cano3', 'dereckluo', 'alex.t.zhu', 'ramaiah2', 'kjabon2', 'nmenne2', 'jhollen93', 'hanns16', 'rigotech', 'sivaram3', 'davidzhao26', 'stupib', 'arjun.balwally', 'jakerock44', 'davidservose', 'bolesta2', 'subzeroscorpion', 'david.tomecek.94', 'jiranun2', 'bkesler', 'yue.li.10441', 'ngoswam2', 'andygongyb', 'jiang100', 'sowinsk2', 'themanderson14', 'istayev2', 'gplauck', 'aagrawa4', 'naraeyoon92', 'stephenbudhi', 'nparikh6', 'ryan.tompkins22', 'sing619', 'chou27', 'swang75', 'shunchu', 'zheshen', 'gvelard2edu', 'machali1', 'dantonacci', 'niktike', 'fujinam2', 'rustem.burkhanov', 'rbelul2', 'jshowail', 'zixing.wang.9', 'bsorich32', 'bcc4994', 'cnnorbe2', 'darwinwalters', 'siravar2', 'chanatr2', 'reagan1', None, 'leinber2', 'psahgal', 'aldave', 'mikeeraci', 'wesley.zhang.92', 'gduchar', 'scai7', 'apcomic', 'dzugan2', 'dliang8', 'lukic2', 'whyshouldimakeanaccountseriously', 'bwpmail']"
2,200,162,11,9,"['mika_mkia', 'amurthy26', 'baur728', 'apcomic', 'matthewvilim', 'srosenje', 'ryan.tompkins22', 'rustem.burkhanov', 'bwpmail']",152,"['jiyuxiao', 'duranma2', 'viperacr', 'merridius', 'shahkaran94', 'himelic2', 'rahulraju93', 'djinkorea', 'slin471992', 'lin194', 'tadekaw2', 'bonick2', 'danzuo', 'nsparik2', 'italy5150', 'chentan08', 'cjv21', 'premal.tailor', 'andsmy', 'carberr2', 'dekunukem', 'dytrych2', 'chumakabaghe', 'rglazer2', 'james.younce92', 'dillon', 'shugotanaka', 'weizeor2', 'kwh1210', 'bree.peng', 'dpatnai2', 'dudes', 'hnrcksn2', 'tanaka6', 'vanillayyy', 'temitayo.adeoshifogun', 'jingfu.nian', 'xia.alex', 'daosyn', 'treetopluver', 'gene820715', 'yuanshuowu', 'dziegle2', 'lipengyanghappy', 'xouyang5', 'siddhanth.munukutla', 'wilner2', 'swojto', 'supermarth64', 'roychow2', 'j234560', 'nopshusang', 'tan.ozdogan', 'koopmnn2', 'tiagovla', 'smsagan', 'ganshun', 'jayanth0001', 'kunyilin9211', 'jorden.brown.54', 'ajeong3', 'zhen.mike', 'zhiyang2', 'hpowen6', 'jeppydude', 'manu.shallow', 'almulla', 'jng12', 'fermat', 'lhendre2', 'jayyao', 'jofu803', 'boatmee', 'bojjave2', 'vanshk', 'seadler1', 'awesome.young.choi', 'zyao4', 'wywang2', 'yong.b.lee.73', 'broadhurst.josh', 'justin.danger.brooks', 'lee267', 'deveshj4', 'chris.12', 'nicolls1', 'yousaf_salam', 'kim619', 'olivercai', 'cano3', 'dereckluo', 'alex.t.zhu', 'ramaiah2', 'kjabon2', 'nmenne2', 'jhollen93', 'hanns16', 'rigotech', 'sivaram3', 'davidzhao26', 'stupib', 'arjun.balwally', 'jakerock44', 'davidservose', 'bolesta2', 'subzeroscorpion', 'david.tomecek.94', 'jiranun2', 'bkesler', 'yue.li.10441', 'ngoswam2', 'andygongyb', 'jiang100', 'sowinsk2', 'themanderson14', 'istayev2', 'gplauck', 'aagrawa4', 'naraeyoon92', 'stephenbudhi', 'nparikh6', 'sing619', 'chou27', 'swang75', 'shunchu', 'zheshen', 'gvelard2edu', 'machali1', 'dantonacci', 'niktike', 'fujinam2', 'rbelul2', 'jshowail', 'zixing.wang.9', 'bsorich32', 'bcc4994', 'cnnorbe2', 'darwinwalters', 'siravar2', 'chanatr2', 'reagan1', 'leinber2', 'psahgal', 'aldave', 'mikeeraci', 'wesley.zhang.92', 'gduchar', 'scai7', 'dzugan2', 'dliang8', 'lukic2', 'whyshouldimakeanaccountseriously']",2,"[None, 'doskoooo']",163,"['jiyuxiao', 'duranma2', 'viperacr', 'mika_mkia', 'merridius', 'shahkaran94', 'himelic2', 'rahulraju93', 'djinkorea', 'slin471992', 'lin194', 'tadekaw2', 'bonick2', 'danzuo', 'nsparik2', 'italy5150', 'chentan08', 'srosenje', 'cjv21', 'premal.tailor', 'andsmy', 'carberr2', 'dekunukem', 'dytrych2', 'chumakabaghe', 'rglazer2', 'james.younce92', 'dillon', 'shugotanaka', 'weizeor2', 'kwh1210', 'baur728', 'bree.peng', 'dpatnai2', 'dudes', 'hnrcksn2', 'tanaka6', 'vanillayyy', 'temitayo.adeoshifogun', 'jingfu.nian', 'xia.alex', 'daosyn', 'treetopluver', 'gene820715', 'yuanshuowu', 'dziegle2', 'lipengyanghappy', 'xouyang5', 'siddhanth.munukutla', 'wilner2', 'swojto', 'supermarth64', 'doskoooo', 'roychow2', 'j234560', 'nopshusang', 'tan.ozdogan', 'koopmnn2', 'tiagovla', 'smsagan', 'ganshun', 'jayanth0001', 'kunyilin9211', 'jorden.brown.54', 'ajeong3', 'zhen.mike', 'zhiyang2', 'hpowen6', 'matthewvilim', 'jeppydude', 'manu.shallow', 'almulla', 'jng12', 'fermat', 'lhendre2', 'jayyao', 'jofu803', 'boatmee', 'bojjave2', 'vanshk', 'seadler1', 'awesome.young.choi', 'zyao4', 'wywang2', 'yong.b.lee.73', 'broadhurst.josh', 'justin.danger.brooks', 'lee267', 'deveshj4', 'chris.12', 'nicolls1', 'yousaf_salam', 'amurthy26', 'kim619', 'olivercai', 'cano3', 'dereckluo', 'alex.t.zhu', 'ramaiah2', 'kjabon2', 'nmenne2', 'jhollen93', 'hanns16', 'rigotech', 'sivaram3', 'davidzhao26', 'stupib', 'arjun.balwally', 'jakerock44', 'davidservose', 'bolesta2', 'subzeroscorpion', 'david.tomecek.94', 'jiranun2', 'bkesler', 'yue.li.10441', 'ngoswam2', 'andygongyb', 'jiang100', 'sowinsk2', 'themanderson14', 'istayev2', 'gplauck', 'aagrawa4', 'naraeyoon92', 'stephenbudhi', 'nparikh6', 'ryan.tompkins22', 'sing619', 'chou27', 'swang75', 'shunchu', 'zheshen', 'gvelard2edu', 'machali1', 'dantonacci', 'niktike', 'fujinam2', 'rustem.burkhanov', 'rbelul2', 'jshowail', 'zixing.wang.9', 'bsorich32', 'bcc4994', 'cnnorbe2', 'darwinwalters', 'siravar2', 'chanatr2', 'reagan1', None, 'leinber2', 'psahgal', 'aldave', 'mikeeraci', 'wesley.zhang.92', 'gduchar', 'scai7', 'apcomic', 'dzugan2', 'dliang8', 'lukic2', 'whyshouldimakeanaccountseriously', 'bwpmail']"
2,83,162,7,6,"['broadhurst.josh', 'ajeong3', 'darwinwalters', 'reagan1', 'tiagovla', 'arjun.balwally']",155,"['jiyuxiao', 'duranma2', 'viperacr', 'mika_mkia', 'merridius', 'shahkaran94', 'himelic2', 'rahulraju93', 'djinkorea', 'slin471992', 'lin194', 'tadekaw2', 'bonick2', 'danzuo', 'nsparik2', 'italy5150', 'chentan08', 'srosenje', 'cjv21', 'premal.tailor', 'andsmy', 'carberr2', 'dekunukem', 'dytrych2', 'chumakabaghe', 'rglazer2', 'james.younce92', 'dillon', 'shugotanaka', 'weizeor2', 'kwh1210', 'baur728', 'bree.peng', 'dpatnai2', 'dudes', 'hnrcksn2', 'tanaka6', 'vanillayyy', 'temitayo.adeoshifogun', 'jingfu.nian', 'xia.alex', 'daosyn', 'treetopluver', 'gene820715', 'yuanshuowu', 'dziegle2', 'lipengyanghappy', 'xouyang5', 'siddhanth.munukutla', 'wilner2', 'swojto', 'supermarth64', 'roychow2', 'j234560', 'nopshusang', 'tan.ozdogan', 'koopmnn2', 'smsagan', 'ganshun', 'jayanth0001', 'kunyilin9211', 'jorden.brown.54', 'zhen.mike', 'zhiyang2', 'hpowen6', 'matthewvilim', 'jeppydude', 'manu.shallow', 'almulla', 'jng12', 'fermat', 'lhendre2', 'jayyao', 'jofu803', 'boatmee', 'bojjave2', 'vanshk', 'seadler1', 'awesome.young.choi', 'zyao4', 'wywang2', 'yong.b.lee.73', 'justin.danger.brooks', 'lee267', 'deveshj4', 'chris.12', 'nicolls1', 'yousaf_salam', 'amurthy26', 'kim619', 'olivercai', 'cano3', 'dereckluo', 'alex.t.zhu', 'ramaiah2', 'kjabon2', 'nmenne2', 'jhollen93', 'hanns16', 'rigotech', 'sivaram3', 'davidzhao26', 'stupib', 'jakerock44', 'davidservose', 'bolesta2', 'subzeroscorpion', 'david.tomecek.94', 'jiranun2', 'bkesler', 'yue.li.10441', 'ngoswam2', 'andygongyb', 'jiang100', 'sowinsk2', 'themanderson14', 'istayev2', 'gplauck', 'aagrawa4', 'naraeyoon92', 'stephenbudhi', 'nparikh6', 'ryan.tompkins22', 'sing619', 'chou27', 'swang75', 'shunchu', 'zheshen', 'gvelard2edu', 'machali1', 'dantonacci', 'niktike', 'fujinam2', 'rustem.burkhanov', 'rbelul2', 'jshowail', 'zixing.wang.9', 'bsorich32', 'bcc4994', 'cnnorbe2', 'siravar2', 'chanatr2', 'leinber2', 'psahgal', 'aldave', 'mikeeraci', 'wesley.zhang.92', 'gduchar', 'scai7', 'apcomic', 'dzugan2', 'dliang8', 'lukic2', 'whyshouldimakeanaccountseriously', 'bwpmail']",1,[None],162,"['jiyuxiao', 'duranma2', 'viperacr', 'mika_mkia', 'merridius', 'shahkaran94', 'himelic2', 'rahulraju93', 'djinkorea', 'slin471992', 'lin194', 'tadekaw2', 'bonick2', 'danzuo', 'nsparik2', 'italy5150', 'chentan08', 'srosenje', 'cjv21', 'premal.tailor', 'andsmy', 'carberr2', 'dekunukem', 'dytrych2', 'chumakabaghe', 'rglazer2', 'james.younce92', 'dillon', 'shugotanaka', 'weizeor2', 'kwh1210', 'baur728', 'bree.peng', 'dpatnai2', 'dudes', 'hnrcksn2', 'tanaka6', 'vanillayyy', 'temitayo.adeoshifogun', 'jingfu.nian', 'xia.alex', 'daosyn', 'treetopluver', 'gene820715', 'yuanshuowu', 'dziegle2', 'lipengyanghappy', 'xouyang5', 'siddhanth.munukutla', 'wilner2', 'swojto', 'supermarth64', 'roychow2', 'j234560', 'nopshusang', 'tan.ozdogan', 'koopmnn2', 'tiagovla', 'smsagan', 'ganshun', 'jayanth0001', 'kunyilin9211', 'jorden.brown.54', 'ajeong3', 'zhen.mike', 'zhiyang2', 'hpowen6', 'matthewvilim', 'jeppydude', 'manu.shallow', 'almulla', 'jng12', 'fermat', 'lhendre2', 'jayyao', 'jofu803', 'boatmee', 'bojjave2', 'vanshk', 'seadler1', 'awesome.young.choi', 'zyao4', 'wywang2', 'yong.b.lee.73', 'broadhurst.josh', 'justin.danger.brooks', 'lee267', 'deveshj4', 'chris.12', 'nicolls1', 'yousaf_salam', 'amurthy26', 'kim619', 'olivercai', 'cano3', 'dereckluo', 'alex.t.zhu', 'ramaiah2', 'kjabon2', 'nmenne2', 'jhollen93', 'hanns16', 'rigotech', 'sivaram3', 'davidzhao26', 'stupib', 'arjun.balwally', 'jakerock44', 'davidservose', 'bolesta2', 'subzeroscorpion', 'david.tomecek.94', 'jiranun2', 'bkesler', 'yue.li.10441', 'ngoswam2', 'andygongyb', 'jiang100', 'sowinsk2', 'themanderson14', 'istayev2', 'gplauck', 'aagrawa4', 'naraeyoon92', 'stephenbudhi', 'nparikh6', 'ryan.tompkins22', 'sing619', 'chou27', 'swang75', 'shunchu', 'zheshen', 'gvelard2edu', 'machali1', 'dantonacci', 'niktike', 'fujinam2', 'rustem.burkhanov', 'rbelul2', 'jshowail', 'zixing.wang.9', 'bsorich32', 'bcc4994', 'cnnorbe2', 'darwinwalters', 'siravar2', 'chanatr2', 'reagan1', None, 'leinber2', 'psahgal', 'aldave', 'mikeeraci', 'wesley.zhang.92', 'gduchar', 'scai7', 'apcomic', 'dzugan2', 'dliang8', 'lukic2', 'whyshouldimakeanaccountseriously', 'bwpmail']"
3,130,146,321,127,"['ssandor', 'mforrest', 'rzelesko', 'ngriffiths', 'rmalhotra', 'survaishkhastgir', 'ldimarco', 'mcm938', 'agreenstein', 'maura.clement', 'lstyer', 'sjmacrowski', 'natalianagy1', 'rastatke', 'jalvear', 'connor.donovan.31', 'kbranch', 'crazyindianpride', 'ayl675', 'awalls', 'jarmstrong', 'jakmak37', 'jsd31josh', 'makeda.springette', 'mhackerteper', 'sarajohns2017', 'haleykoch2017', 'cryu', 'araewilliams', 'vjansen', 'aec943', 'mgates', 'sgray', 'sarceo', 'jgrocott', 'rachelli2017', 'lhu642', 'bbakalarski', 'jgupta', 'majedfataftahnu', 'ajalali', 'jamily80', 'natalie.m.stanley.9', 'sgarcia2017', 'jkk284', 'lilyzoo', 'mfoulkes', 'ahurst', 'etburklow', 'natalie5', 'aaubrun', 'lfoley82', 'twang2017', 'msb843', 'aibeh7906', 'jma', 'radiohedzz', 'tpierce14', 'zrubnitz', 'pasha', 'lrawitscher', 'msamyyi', 'natalianagytakahashi2015', 'rmalekmadani', 'kserv', 'manistranski', 'youjon5', 'rznewman', 'sperez', 'okohler', 'bklein', 'torear', 'sonyaluthra2015', 'samanthamurphy2017', 'daniel.c.eghdami', 'sobel.shawn', 'kelseyaaronson', 'dweber', 'cprucnal', 'hmiller', 'emares84', 'rmetzgerii', 'delagarl', 'morrisemily18', 'ajaynadig', 'slhatch', 'schandran', 'gabrielleforcier2015', 'sarahacs', 'brosenberg', 'mkelsten', 'jshin', 'brennanjackson2017', 'sebgar', 'ynessary', 'jayahn0518', 'bensullivan', 'natalienowogrodzki', 'amansur', 'jbowleg', 'jboyer', 'anichols', 'bbisrat', 'borazine', 'mdefreitas', 'grahambullmore2017', 'bonesjones612', 'lawrencevinson2017', 'thomasodell2017', 'nickmartin44', 'astults', 'tav162', 'ajaynadig1', 'atsui4', 'cpieri', 'dfloyd', 'akmohring', 'kmobrien', 'wcho', 'pklimkow', 'pmccullough', 'dmw514', 'kburke1', 'mlaw70', 'mgreene', 'mco2745', 'kristinzubritzky']",18,"['jlynch2014', 'ckitche', 'cardiaza', 'sophiemilord2015', 'jmiller1', 'mkeeler', 'ejohnso3', 'kvanderp', 'mmcadet1', 'thompson.mefford', 'vnarayanamurthy', 'che_perry', 'eprussac', 'gcs', 'alasaldana', 'hperucci', 'drmanishsg', 'daguilar']",194,"['jameswillis2017', 'sgorlick', 'n6n8u3', 'juanmena2017', 'robertzhu2017', 'hopkins2', 'nward', 'gesta', 'lchen', 'alila', 'emilymorris2017', 'lafern', 'bbl076', 'annapetersen21', 'jbs916', 'sshull', 'krembisz', 'bishtonn', 'bdougherty', 'gmc830', 'imasamba', 'bbecerra', 'nasher', 'mmihalache', 'vmehta', 'jschaefer', 'isi.sturla', 'jburkechem122', 'sdaniel', 'mattsherman95', 'abfilicko05', 'nuchem102', 'ajsnu', 'rmehta95', 'annaduban2017', 'smezyk7', 'gallardoy09', 'cfleesmith', 'obabatola', 'meganaaudipudy', 'uditapersaud', 'gcohen', 'cmucharraz', 'myi', 'nicholas.mccombe.3', 'kkim27', 'tla95', 'aacosta', 'rweidinger', 'rodriguez.ricardo13', 'broconnell', 'amyers17', 'alw231', 'melikimmy', 'coravasserman2017', 'swert', 'mpostoll4', 'jsammon', 'marinamin2017', 'cjw', 'lra391', 'ajennings', 'lindseymehl2017', 'lisa.kim.961993', 'bspielman', 'kathrynpillischafske2017', 'msobhani', 'jesus.leon1', 'ydeng', 'dperlovsky', 'kimhoff', 'christycal17', 'jalonbrown', 'ljung', 'mfluellen', 'aostenso', 'mgullott', 'miriam.perez.35574', 'bfeinstein', 'ssbanic', 'bkraft383', 'vilte', 'igau', 'cweers', 'mdoody359', 'vrutherford', 'kschuster', 'j3nnif3r37', 'jtucker', 'rsarette', 'ggillow', 'benedict.dungca', 'sem742', 'nn3210', 'emathews', 'estebanmercado2017', 'jruan', 'shwang', 'geapen', 'jvegaperkins713', 'lsleung', 'jdk681', 'yokim', 'mhopfner', 'santana', 'hpervaiz', 'aparikh22', 'asears', 'rst345', 'ellenpatterson2017', 'catherineding', 'gcamozzi', 'annapreston2017', 'kgong', 'njandali', 'crobinson19', 'bananapiehl', 'agrenen', 'isaacheine', 'rachelrogers', 'ahofmeister', 'minjooson', 'aamattey', 'nwh027', 'wizu', 'ndivine', 'ijackylei', 'rboodram', 'annahinrichs', 'clacrosse', 'anewell', 'yuehu9510', 'joshauck', 'rsherman', 'kdaftary', 'afisher', 'marsak', 'phaun', 'ecripe', 'jmarquez95', 'ddapuzzo', 'jgw599', 'cfox', 'ecbold13', 'tstoimenoff', 'sbahena', 'pgrewal', 'alzipursky', 'peter.g.vlahakis', 'tomliggett', 'juliakovalenko2017', 'ccj009', 'zfenske', 'jdrews', 'jvillanueva8', 'hannahbrady2017', 'hrucinski', 'camilleblackman2016', 'wjhager2016', 'kcm010', 'phawkyard', 'annedeb', 'james.amick94', 'hwhite', 'afarsheed', 'evanbeuningen', 'jki699', 'zwatson', 'vlh774', 'aveerina', 'glak', 'cconnelly', 'shorstman', 'rschaaf', 'stam', 'omarosorio2017', 'krichards', 'kristensmith2017', 'plim', 'davidkarlin2013', 'mclark032', 'nnwagbo', 'mwaldegerma', 'jmccartney', 'wlindstrom', 'laurenabruzzo2017', 'elisa4201', 'bchen', 'marknelson2012', 'kqu', 'hlou88', 'mcoden', 'bbair', 'mstotzy1']",339,"['jameswillis2017', 'sgorlick', 'robertzhu2017', 'gesta', 'alila', 'sophiemilord2015', 'rzelesko', 'mmcadet1', 'survaishkhastgir', 'ldimarco', 'emilymorris2017', 'lafern', 'mcm938', 'bbl076', 'agreenstein', 'annapetersen21', 'krembisz', 'bishtonn', 'lstyer', 'sjmacrowski', 'gmc830', 'imasamba', 'nasher', 'natalianagy1', 'vmehta', 'rastatke', 'isi.sturla', 'sdaniel', 'jalvear', 'kbranch', 'ayl675', 'jarmstrong', 'abfilicko05', 'nuchem102', 'ajsnu', 'jakmak37', 'cfleesmith', 'mhackerteper', 'cryu', 'jmiller1', 'gcohen', 'myi', 'araewilliams', 'kkim27', 'tla95', 'rodriguez.ricardo13', 'broconnell', 'sgray', 'sarceo', 'jgrocott', 'rachelli2017', 'lhu642', 'ckitche', 'jsammon', 'ajalali', 'jamily80', 'lra391', 'ajennings', 'drmanishsg', 'kathrynpillischafske2017', 'ydeng', 'dperlovsky', 'kimhoff', 'jalonbrown', 'sgarcia2017', 'jkk284', 'lilyzoo', 'hperucci', 'etburklow', 'mgullott', 'miriam.perez.35574', 'natalie5', 'aaubrun', 'bfeinstein', 'lfoley82', 'msb843', 'aibeh7906', 'thompson.mefford', 'igau', 'jma', 'mdoody359', 'j3nnif3r37', 'rsarette', 'benedict.dungca', 'lrawitscher', 'sem742', 'msamyyi', 'emathews', 'rmalekmadani', 'shwang', 'geapen', 'jvegaperkins713', 'kserv', 'lsleung', 'manistranski', 'yokim', 'sperez', 'torear', 'annapreston2017', 'kgong', 'samanthamurphy2017', 'kelseyaaronson', 'bananapiehl', 'isaacheine', 'ahofmeister', 'minjooson', 'rmetzgerii', 'ndivine', 'eprussac', 'ijackylei', 'rboodram', 'annahinrichs', 'clacrosse', 'ajaynadig', 'anewell', 'schandran', 'joshauck', 'rsherman', 'sarahacs', 'kdaftary', 'afisher', 'mkelsten', 'jshin', 'marsak', 'ecripe', 'sebgar', 'jgw599', 'ynessary', 'ecbold13', 'tstoimenoff', 'jayahn0518', 'pgrewal', 'peter.g.vlahakis', 'tomliggett', 'zfenske', 'jbowleg', 'jvillanueva8', 'camilleblackman2016', 'hrucinski', 'kcm010', 'phawkyard', 'jboyer', 'bbisrat', 'hwhite', 'afarsheed', 'jki699', 'jlynch2014', 'borazine', 'vlh774', 'cconnelly', 'shorstman', 'alasaldana', 'grahambullmore2017', 'omarosorio2017', 'bonesjones612', 'lawrencevinson2017', 'astults', 'davidkarlin2013', 'mclark032', 'kmobrien', 'jmccartney', 'wlindstrom', 'laurenabruzzo2017', 'wcho', 'bchen', 'pklimkow', 'marknelson2012', 'gcs', 'kburke1', 'hlou88', 'mgreene', 'mco2745', 'daguilar', 'ssandor', 'mforrest', 'n6n8u3', 'juanmena2017', 'hopkins2', 'nward', 'lchen', 'ngriffiths', 'rmalhotra', 'maura.clement', 'jbs916', 'sshull', 'bdougherty', 'bbecerra', 'mmihalache', 'jschaefer', 'jburkechem122', 'connor.donovan.31', 'crazyindianpride', 'awalls', 'mattsherman95', 'cardiaza', 'rmehta95', 'annaduban2017', 'jsd31josh', 'smezyk7', 'makeda.springette', 'gallardoy09', 'obabatola', 'sarajohns2017', 'haleykoch2017', 'meganaaudipudy', 'uditapersaud', 'cmucharraz', 'vjansen', 'nicholas.mccombe.3', 'aacosta', 'aec943', 'rweidinger', 'mgates', 'amyers17', 'alw231', 'melikimmy', 'coravasserman2017', 'bbakalarski', 'jgupta', 'swert', 'mpostoll4', 'majedfataftahnu', 'marinamin2017', 'cjw', 'lindseymehl2017', 'lisa.kim.961993', 'bspielman', 'natalie.m.stanley.9', 'jesus.leon1', 'msobhani', 'christycal17', 'ljung', 'mfluellen', 'mfoulkes', 'aostenso', 'ahurst', 'ssbanic', 'bkraft383', 'twang2017', 'vilte', 'cweers', 'radiohedzz', 'vrutherford', 'kschuster', 'tpierce14', 'zrubnitz', 'jtucker', 'pasha', 'ggillow', 'nn3210', 'jruan', 'natalianagytakahashi2015', 'estebanmercado2017', 'jdk681', 'mhopfner', 'che_perry', 'youjon5', 'santana', 'hpervaiz', 'rznewman', 'okohler', 'bklein', 'sonyaluthra2015', 'aparikh22', 'asears', 'rst345', 'ellenpatterson2017', 'catherineding', 'gcamozzi', 'daniel.c.eghdami', 'njandali', 'sobel.shawn', 'crobinson19', 'agrenen', 'dweber', 'rachelrogers', 'cprucnal', 'hmiller', 'emares84', 'aamattey', 'mkeeler', 'nwh027', 'wizu', 'delagarl', 'morrisemily18', 'ejohnso3', 'slhatch', 'yuehu9510', 'gabrielleforcier2015', 'brosenberg', 'brennanjackson2017', 'phaun', 'jmarquez95', 'ddapuzzo', 'kvanderp', 'cfox', 'sbahena', 'alzipursky', 'bensullivan', 'juliakovalenko2017', 'natalienowogrodzki', 'vnarayanamurthy', 'amansur', 'ccj009', 'jdrews', 'hannahbrady2017', 'wjhager2016', 'annedeb', 'anichols', 'james.amick94', 'evanbeuningen', 'zwatson', 'glak', 'aveerina', 'mdefreitas', 'rschaaf', 'stam', 'krichards', 'thomasodell2017', 'nickmartin44', 'kristensmith2017', 'plim', 'tav162', 'ajaynadig1', 'atsui4', 'cpieri', 'nnwagbo', 'dfloyd', 'akmohring', 'mwaldegerma', 'elisa4201', 'pmccullough', 'kqu', 'dmw514', 'mlaw70', 'mcoden', 'bbair', 'mstotzy1', 'kristinzubritzky']"
3,35,146,236,5,"['sarajohns2017', 'pklimkow', 'jkk284', 'sobel.shawn', 'mkelsten']",140,"['ssandor', 'mforrest', 'sophiemilord2015', 'rzelesko', 'ngriffiths', 'rmalhotra', 'mmcadet1', 'survaishkhastgir', 'ldimarco', 'mcm938', 'agreenstein', 'maura.clement', 'lstyer', 'sjmacrowski', 'natalianagy1', 'rastatke', 'jalvear', 'connor.donovan.31', 'kbranch', 'crazyindianpride', 'ayl675', 'awalls', 'jarmstrong', 'cardiaza', 'jakmak37', 'jsd31josh', 'makeda.springette', 'mhackerteper', 'haleykoch2017', 'cryu', 'jmiller1', 'araewilliams', 'vjansen', 'aec943', 'mgates', 'sgray', 'sarceo', 'jgrocott', 'rachelli2017', 'lhu642', 'ckitche', 'bbakalarski', 'jgupta', 'majedfataftahnu', 'ajalali', 'jamily80', 'drmanishsg', 'natalie.m.stanley.9', 'sgarcia2017', 'lilyzoo', 'mfoulkes', 'ahurst', 'hperucci', 'etburklow', 'natalie5', 'aaubrun', 'lfoley82', 'twang2017', 'msb843', 'aibeh7906', 'thompson.mefford', 'jma', 'radiohedzz', 'tpierce14', 'zrubnitz', 'pasha', 'lrawitscher', 'msamyyi', 'natalianagytakahashi2015', 'rmalekmadani', 'kserv', 'manistranski', 'che_perry', 'youjon5', 'rznewman', 'sperez', 'okohler', 'bklein', 'torear', 'sonyaluthra2015', 'samanthamurphy2017', 'daniel.c.eghdami', 'kelseyaaronson', 'dweber', 'cprucnal', 'hmiller', 'emares84', 'rmetzgerii', 'mkeeler', 'eprussac', 'delagarl', 'morrisemily18', 'ajaynadig', 'ejohnso3', 'slhatch', 'schandran', 'gabrielleforcier2015', 'sarahacs', 'brosenberg', 'jshin', 'brennanjackson2017', 'sebgar', 'kvanderp', 'ynessary', 'jayahn0518', 'bensullivan', 'natalienowogrodzki', 'vnarayanamurthy', 'amansur', 'jbowleg', 'jboyer', 'anichols', 'bbisrat', 'jlynch2014', 'borazine', 'mdefreitas', 'alasaldana', 'grahambullmore2017', 'bonesjones612', 'lawrencevinson2017', 'thomasodell2017', 'nickmartin44', 'astults', 'tav162', 'ajaynadig1', 'atsui4', 'cpieri', 'dfloyd', 'akmohring', 'kmobrien', 'wcho', 'pmccullough', 'gcs', 'dmw514', 'kburke1', 'mlaw70', 'mgreene', 'mco2745', 'kristinzubritzky', 'daguilar']",231,"['n6n8u3', 'sgorlick', 'jameswillis2017', 'juanmena2017', 'robertzhu2017', 'hopkins2', 'nward', 'lchen', 'gesta', 'alila', 'kburke', 'cjwethers', 'lafern', 'emilymorris2017', 'bbl076', 'sshull', 'krembisz', 'jbs916', 'bishtonn', 'annapetersen21', 'bdougherty', 'gmc830', 'imasamba', 'bbecerra', 'nasher', 'mmihalache', 'vmehta', 'jschaefer', 'jburkechem122', 'isi.sturla', 'sdaniel', 'mattsherman95', 'abfilicko05', 'nuchem102', 'ajsnu', 'benjaminjones2017', 'rmehta95', 'lillie', 'annaduban2017', 'joefobi2017', 'jschartz90', 'smezyk7', 'gallardoy09', 'cfleesmith', 'obabatola', 'wmckinney', 'uditapersaud', 'gcohen', 'cmucharraz', 'myi', 'nicholas.mccombe.3', 'rweidinger', 'kkim27', 'tla95', 'rodriguez.ricardo13', 'broconnell', 'foulkes2', 'amyers17', 'melikimmy', 'alw231', 'coravasserman2017', 'selinaarceo2017', 'swert', 'mpostoll4', 'jsammon', 'ozero', 'marinamin2017', 'natalie555', 'xkirkham1', 'lra391', 'ajennings', 'rachel.lin.96592', 'lindseymehl2017', 'jwaltstadt', 'lisa.kim.961993', 'hak656', 'bspielman', 'kathrynpillischafske2017', 'msobhani', 'jesus.leon1', 'ydeng', 'dperlovsky', 'kimhoff', 'christycal17', 'ljung', 'samilton840', 'mfluellen', 'jalonbrown', 'saskianaegele26', 'aostenso', 'samuelkahn2017', 'annikahansen2017', 'sauditore', 'mgullott', 'miriam.perez.35574', 'bfeinstein', 'thratsh', 'ssbanic', 'bkraft383', 'vilte', 'igau', 'eam093', 'cweers', 'mdoody359', 'vrutherford', 'kschuster', 'j3nnif3r37', 'stephanyvalladares11', 'pcastro', 'jtucker', 'rsarette', 'ggillow', 'ahw087', 'benedict.dungca', 'mattgates1995', 'nn3210', 'mmcmullan', 'sem742', 'emathews', 'jruan', 'christopherpierce2017', 'shwang', 'estebanmercado2017', 'geapen', 'jvegaperkins713', 'lsleung', 'jdk681', 'yokim', 'mhopfner', 'santana', 'hpervaiz', 'aparikh22', 'dfloyd367', 'rst345', 'ellenpatterson2017', 'asears', 'catherineding', 'gcamozzi', 'annapreston2017', 'kgong', 'njandali', 'crobinson19', 'bananapiehl', 'agrenen', 'isaacheine', 'rachelrogers', 'thenewflamel', 'ahofmeister', 'minjooson', 'aamattey', 'nwh027', 'wizu', 'ndivine', 'ijackylei', 'rboodram', 'm.forrest', 'annahinrichs', 'tefisbando', 'clacrosse', 'anewell', 'yuehu9510', 'joshauck', 'rsherman', 'kdaftary', 'afisher', 'marsak', 'phaun', 'jmarquez95', 'ecripe', 'ddapuzzo', 'jgw599', 'cfox', 'tstoimenoff', 'ecbold13', 'pgrewal', 'alzipursky', 'peter.g.vlahakis', 'tomliggett', 'juliakovalenko2017', 'ccj009', 'jdrews', 'zfenske', 'jvillanueva8', 'hannahbrady2017', 'wjhager2016', 'carlpieri2017', 'camilleblackman2016', 'kcm010', 'phawkyard', 'hrucinski', 'annedeb', 'andrew_cramer2017', 'james.amick94', 'afarsheed', 'evanbeuningen', 'hwhite', 'jki699', 'kaylabrooks', 'vaishali.mehta.925', 'zwatson', 'meganpurdy', 'glak', 'vlh774', 'achandran12', 'aveerina', 'cconnelly', 'shorstman', 'ericanderson2017', 'rschaaf', 'stam', 'shandon6', 'omarosorio2017', 'krichards', 'kristensmith2017', 'plim', 'mclark032', 'nnwagbo', 'jmccartney', 'wlindstrom', 'laurenabruzzo2017', None, 'mhz636', 'bchen', 'marknelson2012', 'scottgoldberg2017', 'kqu', 'hlou88', 'bbair', 'mcoden', 'mstotzy1', 'creamnsugar']",376,"['sgorlick', 'jameswillis2017', 'robertzhu2017', 'gesta', 'alila', 'sophiemilord2015', 'rzelesko', 'cjwethers', 'mmcadet1', 'survaishkhastgir', 'ldimarco', 'lafern', 'emilymorris2017', 'mcm938', 'bbl076', 'agreenstein', 'krembisz', 'bishtonn', 'annapetersen21', 'lstyer', 'sjmacrowski', 'gmc830', 'imasamba', 'nasher', 'natalianagy1', 'vmehta', 'rastatke', 'isi.sturla', 'sdaniel', 'jalvear', 'kbranch', 'ayl675', 'jarmstrong', 'abfilicko05', 'nuchem102', 'ajsnu', 'jakmak37', 'lillie', 'jschartz90', 'cfleesmith', 'mhackerteper', 'cryu', 'jmiller1', 'gcohen', 'myi', 'araewilliams', 'kkim27', 'tla95', 'rodriguez.ricardo13', 'broconnell', 'sgray', 'sarceo', 'jgrocott', 'rachelli2017', 'lhu642', 'ckitche', 'selinaarceo2017', 'jsammon', 'natalie555', 'ajalali', 'jamily80', 'lra391', 'ajennings', 'rachel.lin.96592', 'drmanishsg', 'hak656', 'kathrynpillischafske2017', 'ydeng', 'dperlovsky', 'kimhoff', 'jalonbrown', 'sgarcia2017', 'jkk284', 'lilyzoo', 'sauditore', 'hperucci', 'etburklow', 'mgullott', 'miriam.perez.35574', 'natalie5', 'aaubrun', 'bfeinstein', 'lfoley82', 'msb843', 'aibeh7906', 'thompson.mefford', 'igau', 'jma', 'mdoody359', 'j3nnif3r37', 'stephanyvalladares11', 'rsarette', 'benedict.dungca', 'lrawitscher', 'sem742', 'msamyyi', 'emathews', 'rmalekmadani', 'shwang', 'geapen', 'jvegaperkins713', 'kserv', 'lsleung', 'manistranski', 'yokim', 'sperez', 'torear', 'dfloyd367', 'annapreston2017', 'kgong', 'samanthamurphy2017', 'kelseyaaronson', 'bananapiehl', 'isaacheine', 'thenewflamel', 'ahofmeister', 'minjooson', 'rmetzgerii', 'ndivine', 'eprussac', 'ijackylei', 'rboodram', 'm.forrest', 'annahinrichs', 'tefisbando', 'clacrosse', 'ajaynadig', 'anewell', 'schandran', 'joshauck', 'rsherman', 'sarahacs', 'kdaftary', 'afisher', 'mkelsten', 'jshin', 'marsak', 'ecripe', 'sebgar', 'jgw599', 'ynessary', 'tstoimenoff', 'ecbold13', 'jayahn0518', 'pgrewal', 'peter.g.vlahakis', 'tomliggett', 'zfenske', 'jbowleg', 'jvillanueva8', 'camilleblackman2016', 'hrucinski', 'carlpieri2017', 'kcm010', 'phawkyard', 'jboyer', 'andrew_cramer2017', 'bbisrat', 'afarsheed', 'hwhite', 'jki699', 'jlynch2014', 'borazine', 'vlh774', 'achandran12', 'cconnelly', 'shorstman', 'ericanderson2017', 'alasaldana', 'grahambullmore2017', 'shandon6', 'bonesjones612', 'omarosorio2017', 'lawrencevinson2017', 'astults', 'mclark032', 'kmobrien', 'jmccartney', 'wlindstrom', 'laurenabruzzo2017', 'wcho', None, 'mhz636', 'bchen', 'pklimkow', 'marknelson2012', 'scottgoldberg2017', 'gcs', 'kburke1', 'hlou88', 'mgreene', 'creamnsugar', 'mco2745', 'daguilar', 'ssandor', 'mforrest', 'n6n8u3', 'juanmena2017', 'hopkins2', 'nward', 'lchen', 'kburke', 'ngriffiths', 'rmalhotra', 'maura.clement', 'jbs916', 'sshull', 'bdougherty', 'bbecerra', 'mmihalache', 'jschaefer', 'jburkechem122', 'connor.donovan.31', 'crazyindianpride', 'awalls', 'mattsherman95', 'cardiaza', 'benjaminjones2017', 'rmehta95', 'annaduban2017', 'joefobi2017', 'jsd31josh', 'smezyk7', 'makeda.springette', 'gallardoy09', 'obabatola', 'sarajohns2017', 'haleykoch2017', 'wmckinney', 'uditapersaud', 'cmucharraz', 'vjansen', 'nicholas.mccombe.3', 'rweidinger', 'aec943', 'mgates', 'foulkes2', 'amyers17', 'melikimmy', 'alw231', 'coravasserman2017', 'bbakalarski', 'jgupta', 'swert', 'mpostoll4', 'majedfataftahnu', 'ozero', 'marinamin2017', 'xkirkham1', 'lindseymehl2017', 'jwaltstadt', 'lisa.kim.961993', 'bspielman', 'natalie.m.stanley.9', 'msobhani', 'jesus.leon1', 'christycal17', 'ljung', 'samilton840', 'mfluellen', 'saskianaegele26', 'mfoulkes', 'aostenso', 'samuelkahn2017', 'annikahansen2017', 'ahurst', 'thratsh', 'ssbanic', 'bkraft383', 'twang2017', 'vilte', 'eam093', 'cweers', 'radiohedzz', 'vrutherford', 'kschuster', 'tpierce14', 'zrubnitz', 'pcastro', 'jtucker', 'pasha', 'ggillow', 'ahw087', 'mattgates1995', 'nn3210', 'mmcmullan', 'jruan', 'natalianagytakahashi2015', 'christopherpierce2017', 'estebanmercado2017', 'jdk681', 'mhopfner', 'che_perry', 'youjon5', 'santana', 'hpervaiz', 'rznewman', 'okohler', 'bklein', 'sonyaluthra2015', 'aparikh22', 'asears', 'rst345', 'ellenpatterson2017', 'catherineding', 'gcamozzi', 'daniel.c.eghdami', 'njandali', 'sobel.shawn', 'crobinson19', 'agrenen', 'dweber', 'rachelrogers', 'cprucnal', 'hmiller', 'emares84', 'aamattey', 'mkeeler', 'nwh027', 'wizu', 'delagarl', 'morrisemily18', 'ejohnso3', 'slhatch', 'yuehu9510', 'gabrielleforcier2015', 'brosenberg', 'brennanjackson2017', 'phaun', 'jmarquez95', 'ddapuzzo', 'kvanderp', 'cfox', 'alzipursky', 'bensullivan', 'juliakovalenko2017', 'natalienowogrodzki', 'vnarayanamurthy', 'amansur', 'ccj009', 'jdrews', 'hannahbrady2017', 'wjhager2016', 'annedeb', 'anichols', 'james.amick94', 'evanbeuningen', 'zwatson', 'kaylabrooks', 'vaishali.mehta.925', 'meganpurdy', 'glak', 'aveerina', 'mdefreitas', 'rschaaf', 'stam', 'krichards', 'thomasodell2017', 'nickmartin44', 'kristensmith2017', 'plim', 'tav162', 'ajaynadig1', 'atsui4', 'cpieri', 'nnwagbo', 'dfloyd', 'akmohring', 'pmccullough', 'kqu', 'dmw514', 'mlaw70', 'bbair', 'mcoden', 'mstotzy1', 'kristinzubritzky']"
3,131,146,9,6,"['tav162', 'sophiemilord2015', 'mmcadet1', 'radiohedzz', 'cprucnal', 'daguilar']",139,"['ssandor', 'mforrest', 'rzelesko', 'ngriffiths', 'rmalhotra', 'survaishkhastgir', 'ldimarco', 'mcm938', 'maura.clement', 'agreenstein', 'lstyer', 'sjmacrowski', 'natalianagy1', 'rastatke', 'jalvear', 'connor.donovan.31', 'kbranch', 'crazyindianpride', 'ayl675', 'awalls', 'jarmstrong', 'cardiaza', 'jakmak37', 'jsd31josh', 'makeda.springette', 'mhackerteper', 'sarajohns2017', 'haleykoch2017', 'cryu', 'jmiller1', 'araewilliams', 'vjansen', 'aec943', 'mgates', 'sgray', 'sarceo', 'jgrocott', 'rachelli2017', 'lhu642', 'ckitche', 'bbakalarski', 'jgupta', 'majedfataftahnu', 'ajalali', 'jamily80', 'drmanishsg', 'natalie.m.stanley.9', 'sgarcia2017', 'jkk284', 'lilyzoo', 'mfoulkes', 'ahurst', 'hperucci', 'etburklow', 'natalie5', 'aaubrun', 'lfoley82', 'twang2017', 'msb843', 'aibeh7906', 'thompson.mefford', 'jma', 'tpierce14', 'zrubnitz', 'pasha', 'lrawitscher', 'msamyyi', 'natalianagytakahashi2015', 'rmalekmadani', 'kserv', 'manistranski', 'che_perry', 'youjon5', 'rznewman', 'sperez', 'okohler', 'bklein', 'torear', 'sonyaluthra2015', 'samanthamurphy2017', 'daniel.c.eghdami', 'sobel.shawn', 'kelseyaaronson', 'dweber', 'hmiller', 'emares84', 'rmetzgerii', 'mkeeler', 'eprussac', 'delagarl', 'morrisemily18', 'ajaynadig', 'ejohnso3', 'slhatch', 'schandran', 'gabrielleforcier2015', 'sarahacs', 'brosenberg', 'mkelsten', 'jshin', 'brennanjackson2017', 'sebgar', 'kvanderp', 'ynessary', 'jayahn0518', 'bensullivan', 'natalienowogrodzki', 'vnarayanamurthy', 'amansur', 'jbowleg', 'jboyer', 'anichols', 'bbisrat', 'jlynch2014', 'borazine', 'mdefreitas', 'alasaldana', 'grahambullmore2017', 'bonesjones612', 'lawrencevinson2017', 'thomasodell2017', 'nickmartin44', 'astults', 'ajaynadig1', 'atsui4', 'cpieri', 'dfloyd', 'akmohring', 'kmobrien', 'wcho', 'pklimkow', 'pmccullough', 'gcs', 'dmw514', 'kburke1', 'mlaw70', 'mgreene', 'mco2745', 'kristinzubritzky']",3,"['valeriek', None, 'sauditore']",148,"['ssandor', 'mforrest', 'sophiemilord2015', 'rzelesko', 'ngriffiths', 'rmalhotra', 'mmcadet1', 'survaishkhastgir', 'ldimarco', 'mcm938', 'maura.clement', 'agreenstein', 'lstyer', 'sjmacrowski', 'natalianagy1', 'rastatke', 'jalvear', 'connor.donovan.31', 'kbranch', 'crazyindianpride', 'ayl675', 'awalls', 'jarmstrong', 'cardiaza', 'jakmak37', 'jsd31josh', 'makeda.springette', 'mhackerteper', 'sarajohns2017', 'haleykoch2017', 'cryu', 'jmiller1', 'araewilliams', 'vjansen', 'aec943', 'mgates', 'sgray', 'sarceo', 'jgrocott', 'rachelli2017', 'lhu642', 'ckitche', 'bbakalarski', 'jgupta', 'majedfataftahnu', 'ajalali', 'jamily80', 'drmanishsg', 'natalie.m.stanley.9', 'sgarcia2017', 'jkk284', 'lilyzoo', 'mfoulkes', 'sauditore', 'ahurst', 'hperucci', 'etburklow', 'natalie5', 'aaubrun', 'lfoley82', 'twang2017', 'msb843', 'aibeh7906', 'thompson.mefford', 'jma', 'radiohedzz', 'tpierce14', 'zrubnitz', 'pasha', 'lrawitscher', 'msamyyi', 'natalianagytakahashi2015', 'rmalekmadani', 'kserv', 'manistranski', 'che_perry', 'youjon5', 'rznewman', 'sperez', 'okohler', 'bklein', 'torear', 'sonyaluthra2015', 'samanthamurphy2017', 'daniel.c.eghdami', 'sobel.shawn', 'kelseyaaronson', 'dweber', 'cprucnal', 'hmiller', 'emares84', 'rmetzgerii', 'mkeeler', 'eprussac', 'delagarl', 'morrisemily18', 'ajaynadig', 'ejohnso3', 'slhatch', 'schandran', 'gabrielleforcier2015', 'sarahacs', 'brosenberg', 'mkelsten', 'jshin', 'brennanjackson2017', 'sebgar', 'kvanderp', 'ynessary', 'jayahn0518', 'bensullivan', 'natalienowogrodzki', 'vnarayanamurthy', 'amansur', 'jbowleg', 'jboyer', 'anichols', 'bbisrat', 'jlynch2014', 'borazine', 'mdefreitas', 'alasaldana', 'grahambullmore2017', 'bonesjones612', 'valeriek', 'lawrencevinson2017', 'thomasodell2017', 'nickmartin44', 'astults', 'tav162', 'ajaynadig1', 'atsui4', 'cpieri', 'dfloyd', 'akmohring', 'kmobrien', None, 'wcho', 'pklimkow', 'pmccullough', 'gcs', 'dmw514', 'kburke1', 'mlaw70', 'mgreene', 'mco2745', 'kristinzubritzky', 'daguilar']"
4,164,132,38,28,"['moeffat', 'engabdallah1', 'nahlahamed', 'sherif.ghozzy', 'mohamed123456', 'raghda.mohammad.5', 'ranaahmed', 'menaesam', 'muhammed333', 'ahmed.asfour.1466', 'shadi31', 'ahmedflamenco', 'sorial.samy.7', 'ahmedreda', 'omargamalhafez21', 'marco.adel.37', 'islam.js24', 'sherinemohamed', 'mostafa.radwan', 'ramiahmedhussien', 'tantoon.soryal', 'rana.a.ghoneim', 'mark_nader', 'adelrashad', 'rami.abulfadl', 'karimwissa', 'heshamehab', 'ahmedmedhat10']",103,"['ntestin', 'nguyetim', 'romana8799', 'wdobbins', 'kate.schreiber.33', 'zeroik0017', 'ryanhiggins', 'bweatherly2011', 'jhaynes3', 'bethanykanten', 'ipsips', 'lafavorj', 'neduet14', 'pwhitmire', 'pandahieu99', 'sosnowsn', 'zoom9119', 'jabiabas', 'fabio.guzman.figueroa', 'hi.joezef', 'kareem_saleh', 'jarobins139', 'epatten', 'au2016', 'joeydajock', 'sasi', 'browthom', 'ccloud92', 'paytertot', 'guangxi', 'filipo.sarevski', 'jana.galal', 'salma.al.aidy', 'wwnjameson', 'josan', 'afahad', 'gerami1352', 'boevemac', 'nishit', 'wpkish', 'romeo2011', 'zakjwalton', 'yyson2000', 'kmac4', 'xz', 'naveenmahenderkar', 'findingnemo2', 'vividwinter', 'howlanjo', 'dragons6666x', 'pacific1912', 'frederique.mittelstaedt', 'imyjer', '1pilo', 'jiaolh', 'mohamed123', 'guikemch', 'ecamp', 'xyzsam', 'velda', 'amirazer', 'zhout07', 'andy.greenspon', 'jbrunini', 'richardsaliba', 'tiarlopez', 'mkinkella', 'wfair', 'williamshake', 'jeverest', 'jonscherf', 'rkmeels', 'cfergus3', 'mgurak', 'vinotd', 'jamakihe', 'jvesic', 'jensfrost', 'sishaat', 'salmatarek', 'aluxander', 'mostafahelal', 'obaron', 'mnyboer', 'peastham23', 'marco_truccolo', 'adelaney515', 'alex.contreras.792', 'mebendana', 'arcibaldo89', 'captainjkirk', 'ktcagen', 'cpetrow', 'harrylpc', 'hetmanan', 'qsvick07', 'mrm328i', 'terahertz', 'defy60', 'jacarr', 'taiedy', 'ginnboy', 'maik23d']",10,"['amgad.ahmed', 'marinamedhat', 'rody.osama', 'mahmoudabdelmoniem', 'maramsalah', 'ahmed.shedid.12', 'ahazem254', None, 'omar.amin.750', 'mosab94']",141,"['ntestin', 'nguyetim', 'romana8799', 'mohamed123456', 'muhammed333', 'shadi31', 'sorial.samy.7', 'wdobbins', 'kate.schreiber.33', 'maramsalah', 'zeroik0017', 'ryanhiggins', 'bweatherly2011', 'jhaynes3', 'bethanykanten', 'ipsips', 'lafavorj', 'neduet14', 'pwhitmire', 'pandahieu99', 'zoom9119', 'jabiabas', 'sosnowsn', 'fabio.guzman.figueroa', 'hi.joezef', 'kareem_saleh', 'jarobins139', 'au2016', 'epatten', 'joeydajock', 'engabdallah1', 'sasi', 'browthom', 'ccloud92', 'paytertot', 'rody.osama', 'guangxi', 'filipo.sarevski', 'jana.galal', 'salma.al.aidy', 'wwnjameson', 'josan', 'afahad', 'gerami1352', 'boevemac', 'nishit', 'wpkish', 'romeo2011', 'islam.js24', 'mosab94', 'mostafa.radwan', 'zakjwalton', 'yyson2000', 'kmac4', 'xz', 'naveenmahenderkar', 'findingnemo2', 'vividwinter', 'howlanjo', 'ahmed.shedid.12', 'dragons6666x', 'pacific1912', 'ahmedmedhat10', 'frederique.mittelstaedt', 'imyjer', '1pilo', 'moeffat', 'jiaolh', 'amgad.ahmed', 'mohamed123', 'guikemch', 'sherif.ghozzy', 'marinamedhat', 'ecamp', 'xyzsam', 'omar.amin.750', 'velda', 'menaesam', 'amirazer', 'zhout07', 'andy.greenspon', 'jbrunini', 'richardsaliba', 'tiarlopez', 'marco.adel.37', 'mkinkella', 'sherinemohamed', 'wfair', 'tantoon.soryal', 'williamshake', 'jeverest', 'jonscherf', 'mark_nader', 'ahazem254', 'rkmeels', 'cfergus3', 'heshamehab', 'mgurak', 'vinotd', 'jamakihe', 'jvesic', 'jensfrost', 'sishaat', 'salmatarek', 'nahlahamed', 'aluxander', 'mahmoudabdelmoniem', 'mostafahelal', 'raghda.mohammad.5', 'obaron', 'mnyboer', 'peastham23', 'ranaahmed', 'marco_truccolo', 'adelaney515', 'alex.contreras.792', 'mebendana', 'arcibaldo89', 'ahmedflamenco', 'captainjkirk', 'ahmed.asfour.1466', 'ahmedreda', 'omargamalhafez21', 'ktcagen', 'cpetrow', 'harrylpc', 'ramiahmedhussien', 'hetmanan', 'rana.a.ghoneim', 'qsvick07', 'adelrashad', None, 'rami.abulfadl', 'mrm328i', 'terahertz', 'defy60', 'karimwissa', 'jacarr', 'taiedy', 'ginnboy', 'maik23d']"
4,163,132,31,30,"['aluxander', 'ccloud92', 'ntestin', 'paytertot', 'guangxi', 'ecamp', 'velda', 'wdobbins', 'afahad', 'cpetrow', 'jhaynes3', 'mkinkella', 'hetmanan', 'wfair', 'kmac4', 'pwhitmire', 'jeverest', 'jonscherf', 'jabiabas', 'rkmeels', 'mrm328i', 'defy60', 'cfergus3', 'jamakihe', 'taiedy', 'jarobins139', 'sishaat', 'epatten', 'ginnboy', 'joeydajock']",101,"['nguyetim', 'romana8799', 'mohamed123456', 'muhammed333', 'shadi31', 'sorial.samy.7', 'kate.schreiber.33', 'zeroik0017', 'ryanhiggins', 'bweatherly2011', 'bethanykanten', 'ipsips', 'lafavorj', 'neduet14', 'pandahieu99', 'zoom9119', 'sosnowsn', 'fabio.guzman.figueroa', 'hi.joezef', 'kareem_saleh', 'au2016', 'engabdallah1', 'sasi', 'browthom', 'filipo.sarevski', 'jana.galal', 'salma.al.aidy', 'wwnjameson', 'josan', 'gerami1352', 'boevemac', 'nishit', 'wpkish', 'romeo2011', 'islam.js24', 'mostafa.radwan', 'zakjwalton', 'yyson2000', 'xz', 'naveenmahenderkar', 'findingnemo2', 'vividwinter', 'howlanjo', 'dragons6666x', 'pacific1912', 'ahmedmedhat10', 'frederique.mittelstaedt', 'imyjer', '1pilo', 'moeffat', 'jiaolh', 'mohamed123', 'guikemch', 'sherif.ghozzy', 'xyzsam', 'menaesam', 'amirazer', 'zhout07', 'andy.greenspon', 'jbrunini', 'richardsaliba', 'tiarlopez', 'marco.adel.37', 'sherinemohamed', 'tantoon.soryal', 'williamshake', 'mark_nader', 'heshamehab', 'mgurak', 'vinotd', 'jvesic', 'jensfrost', 'salmatarek', 'nahlahamed', 'mostafahelal', 'raghda.mohammad.5', 'obaron', 'mnyboer', 'peastham23', 'ranaahmed', 'marco_truccolo', 'adelaney515', 'alex.contreras.792', 'mebendana', 'arcibaldo89', 'ahmedflamenco', 'captainjkirk', 'ahmed.asfour.1466', 'ahmedreda', 'omargamalhafez21', 'ktcagen', 'harrylpc', 'ramiahmedhussien', 'rana.a.ghoneim', 'qsvick07', 'adelrashad', 'rami.abulfadl', 'terahertz', 'karimwissa', 'jacarr', 'maik23d']",1,[None],132,"['ntestin', 'nguyetim', 'romana8799', 'mohamed123456', 'muhammed333', 'shadi31', 'sorial.samy.7', 'wdobbins', 'kate.schreiber.33', 'zeroik0017', 'ryanhiggins', 'bweatherly2011', 'jhaynes3', 'bethanykanten', 'ipsips', 'lafavorj', 'neduet14', 'pwhitmire', 'pandahieu99', 'zoom9119', 'jabiabas', 'sosnowsn', 'fabio.guzman.figueroa', 'hi.joezef', 'kareem_saleh', 'jarobins139', 'au2016', 'epatten', 'joeydajock', 'engabdallah1', 'sasi', 'browthom', 'ccloud92', 'paytertot', 'guangxi', 'filipo.sarevski', 'jana.galal', 'salma.al.aidy', 'wwnjameson', 'josan', 'afahad', 'gerami1352', 'boevemac', 'nishit', 'wpkish', 'romeo2011', 'islam.js24', 'mostafa.radwan', 'zakjwalton', 'yyson2000', 'kmac4', 'xz', 'naveenmahenderkar', 'findingnemo2', 'vividwinter', 'howlanjo', 'dragons6666x', 'pacific1912', 'ahmedmedhat10', 'frederique.mittelstaedt', 'imyjer', '1pilo', 'moeffat', 'jiaolh', 'mohamed123', 'guikemch', 'sherif.ghozzy', 'ecamp', 'xyzsam', 'velda', 'menaesam', 'amirazer', 'zhout07', 'andy.greenspon', 'jbrunini', 'richardsaliba', 'tiarlopez', 'marco.adel.37', 'mkinkella', 'sherinemohamed', 'wfair', 'tantoon.soryal', 'williamshake', 'jeverest', 'jonscherf', 'mark_nader', 'rkmeels', 'cfergus3', 'heshamehab', 'mgurak', 'vinotd', 'jamakihe', 'jvesic', 'jensfrost', 'sishaat', 'salmatarek', 'nahlahamed', 'aluxander', 'mostafahelal', 'raghda.mohammad.5', 'obaron', 'mnyboer', 'peastham23', 'ranaahmed', 'marco_truccolo', 'adelaney515', 'alex.contreras.792', 'mebendana', 'arcibaldo89', 'ahmedflamenco', 'captainjkirk', 'ahmed.asfour.1466', 'ahmedreda', 'omargamalhafez21', 'ktcagen', 'cpetrow', 'harrylpc', 'ramiahmedhussien', 'hetmanan', 'rana.a.ghoneim', 'qsvick07', 'adelrashad', None, 'rami.abulfadl', 'mrm328i', 'terahertz', 'defy60', 'karimwissa', 'jacarr', 'taiedy', 'ginnboy', 'maik23d']"
4,162,132,22,1,['neduet14'],130,"['ntestin', 'nguyetim', 'romana8799', 'mohamed123456', 'muhammed333', 'shadi31', 'sorial.samy.7', 'wdobbins', 'kate.schreiber.33', 'zeroik0017', 'ryanhiggins', 'bweatherly2011', 'jhaynes3', 'bethanykanten', 'ipsips', 'lafavorj', 'pwhitmire', 'pandahieu99', 'zoom9119', 'jabiabas', 'sosnowsn', 'fabio.guzman.figueroa', 'hi.joezef', 'kareem_saleh', 'jarobins139', 'au2016', 'epatten', 'joeydajock', 'engabdallah1', 'sasi', 'browthom', 'ccloud92', 'paytertot', 'guangxi', 'filipo.sarevski', 'jana.galal', 'salma.al.aidy', 'wwnjameson', 'josan', 'afahad', 'gerami1352', 'boevemac', 'nishit', 'wpkish', 'romeo2011', 'islam.js24', 'mostafa.radwan', 'zakjwalton', 'yyson2000', 'kmac4', 'xz', 'naveenmahenderkar', 'findingnemo2', 'vividwinter', 'howlanjo', 'dragons6666x', 'pacific1912', 'ahmedmedhat10', 'frederique.mittelstaedt', 'imyjer', '1pilo', 'moeffat', 'jiaolh', 'mohamed123', 'guikemch', 'sherif.ghozzy', 'ecamp', 'xyzsam', 'velda', 'menaesam', 'amirazer', 'zhout07', 'andy.greenspon', 'jbrunini', 'richardsaliba', 'tiarlopez', 'marco.adel.37', 'mkinkella', 'sherinemohamed', 'wfair', 'tantoon.soryal', 'williamshake', 'jeverest', 'jonscherf', 'mark_nader', 'rkmeels', 'cfergus3', 'heshamehab', 'mgurak', 'vinotd', 'jamakihe', 'jvesic', 'jensfrost', 'sishaat', 'salmatarek', 'nahlahamed', 'aluxander', 'mostafahelal', 'raghda.mohammad.5', 'obaron', 'mnyboer', 'peastham23', 'ranaahmed', 'marco_truccolo', 'adelaney515', 'alex.contreras.792', 'mebendana', 'arcibaldo89', 'ahmedflamenco', 'captainjkirk', 'ahmed.asfour.1466', 'ahmedreda', 'omargamalhafez21', 'ktcagen', 'cpetrow', 'harrylpc', 'ramiahmedhussien', 'hetmanan', 'rana.a.ghoneim', 'qsvick07', 'adelrashad', 'rami.abulfadl', 'mrm328i', 'terahertz', 'defy60', 'karimwissa', 'jacarr', 'taiedy', 'ginnboy', 'maik23d']",21,"['amnah.zubair', 'elecengrmka', 'el120', 'saadbsohail', 'uzaif', 'hafsah', 'aneeba', 'rabiya.tabassum.31', 'shfinal', 'sayyeda.umbereen', 'neev.kiran', 'alvinabatool1', 'mazhar861992', 'hk', 'hassannawaz', 'ahmed_umais', 'anum91', 'aimen.naz.3', None, 'sweetsaimaanis', 'shariq.khi']",152,"['ntestin', 'nguyetim', 'romana8799', 'mohamed123456', 'muhammed333', 'shadi31', 'sorial.samy.7', 'wdobbins', 'kate.schreiber.33', 'rabiya.tabassum.31', 'zeroik0017', 'ryanhiggins', 'bweatherly2011', 'jhaynes3', 'sayyeda.umbereen', 'bethanykanten', 'ipsips', 'lafavorj', 'neduet14', 'pwhitmire', 'ahmed_umais', 'pandahieu99', 'anum91', 'zoom9119', 'jabiabas', 'sosnowsn', 'fabio.guzman.figueroa', 'hi.joezef', 'kareem_saleh', 'jarobins139', 'au2016', 'epatten', 'joeydajock', 'engabdallah1', 'sasi', 'amnah.zubair', 'browthom', 'ccloud92', 'paytertot', 'guangxi', 'el120', 'saadbsohail', 'filipo.sarevski', 'uzaif', 'hafsah', 'jana.galal', 'salma.al.aidy', 'wwnjameson', 'josan', 'afahad', 'gerami1352', 'shfinal', 'boevemac', 'nishit', 'wpkish', 'romeo2011', 'islam.js24', 'alvinabatool1', 'mostafa.radwan', 'zakjwalton', 'yyson2000', 'kmac4', 'xz', 'naveenmahenderkar', 'findingnemo2', 'vividwinter', 'howlanjo', 'dragons6666x', 'pacific1912', 'shariq.khi', 'ahmedmedhat10', 'frederique.mittelstaedt', 'imyjer', '1pilo', 'moeffat', 'jiaolh', 'mohamed123', 'guikemch', 'sherif.ghozzy', 'ecamp', 'xyzsam', 'velda', 'menaesam', 'amirazer', 'zhout07', 'andy.greenspon', 'jbrunini', 'aneeba', 'richardsaliba', 'tiarlopez', 'marco.adel.37', 'mkinkella', 'sherinemohamed', 'mazhar861992', 'wfair', 'hk', 'tantoon.soryal', 'williamshake', 'jeverest', 'jonscherf', 'mark_nader', 'aimen.naz.3', 'rkmeels', 'cfergus3', 'heshamehab', 'mgurak', 'vinotd', 'jamakihe', 'jvesic', 'jensfrost', 'sishaat', 'salmatarek', 'nahlahamed', 'elecengrmka', 'aluxander', 'mostafahelal', 'raghda.mohammad.5', 'obaron', 'mnyboer', 'peastham23', 'ranaahmed', 'marco_truccolo', 'adelaney515', 'alex.contreras.792', 'mebendana', 'arcibaldo89', 'ahmedflamenco', 'captainjkirk', 'ahmed.asfour.1466', 'ahmedreda', 'omargamalhafez21', 'ktcagen', 'cpetrow', 'harrylpc', 'neev.kiran', 'ramiahmedhussien', 'hetmanan', 'hassannawaz', 'rana.a.ghoneim', 'qsvick07', 'adelrashad', None, 'rami.abulfadl', 'sweetsaimaanis', 'mrm328i', 'terahertz', 'defy60', 'karimwissa', 'jacarr', 'taiedy', 'ginnboy', 'maik23d']"
4,157,132,17,15,"['zhout07', 'wwnjameson', 'adelaney515', 'bethanykanten', 'mebendana', 'andy.greenspon', 'mgurak', 'xz', 'williamshake', 'richardsaliba', 'xyzsam', 'qsvick07', 'findingnemo2', 'ktcagen', 'imyjer']",116,"['ntestin', 'nguyetim', 'romana8799', 'mohamed123456', 'muhammed333', 'shadi31', 'sorial.samy.7', 'wdobbins', 'kate.schreiber.33', 'zeroik0017', 'ryanhiggins', 'bweatherly2011', 'jhaynes3', 'ipsips', 'lafavorj', 'neduet14', 'pwhitmire', 'pandahieu99', 'zoom9119', 'jabiabas', 'sosnowsn', 'fabio.guzman.figueroa', 'hi.joezef', 'kareem_saleh', 'jarobins139', 'au2016', 'epatten', 'joeydajock', 'engabdallah1', 'sasi', 'browthom', 'ccloud92', 'paytertot', 'guangxi', 'filipo.sarevski', 'jana.galal', 'salma.al.aidy', 'josan', 'afahad', 'gerami1352', 'boevemac', 'nishit', 'wpkish', 'romeo2011', 'islam.js24', 'mostafa.radwan', 'zakjwalton', 'yyson2000', 'kmac4', 'naveenmahenderkar', 'vividwinter', 'howlanjo', 'dragons6666x', 'pacific1912', 'ahmedmedhat10', 'frederique.mittelstaedt', '1pilo', 'moeffat', 'jiaolh', 'mohamed123', 'guikemch', 'sherif.ghozzy', 'ecamp', 'velda', 'menaesam', 'amirazer', 'jbrunini', 'tiarlopez', 'marco.adel.37', 'mkinkella', 'sherinemohamed', 'wfair', 'tantoon.soryal', 'jeverest', 'jonscherf', 'mark_nader', 'rkmeels', 'cfergus3', 'heshamehab', 'vinotd', 'jamakihe', 'jvesic', 'jensfrost', 'sishaat', 'salmatarek', 'nahlahamed', 'aluxander', 'mostafahelal', 'raghda.mohammad.5', 'obaron', 'mnyboer', 'peastham23', 'ranaahmed', 'marco_truccolo', 'alex.contreras.792', 'arcibaldo89', 'ahmedflamenco', 'captainjkirk', 'ahmed.asfour.1466', 'ahmedreda', 'omargamalhafez21', 'cpetrow', 'harrylpc', 'ramiahmedhussien', 'hetmanan', 'rana.a.ghoneim', 'adelrashad', 'rami.abulfadl', 'mrm328i', 'terahertz', 'defy60', 'karimwissa', 'jacarr', 'taiedy', 'ginnboy', 'maik23d']",2,"['samuelkim', None]",133,"['ntestin', 'nguyetim', 'romana8799', 'mohamed123456', 'muhammed333', 'shadi31', 'sorial.samy.7', 'wdobbins', 'kate.schreiber.33', 'zeroik0017', 'ryanhiggins', 'bweatherly2011', 'jhaynes3', 'bethanykanten', 'ipsips', 'lafavorj', 'neduet14', 'pwhitmire', 'pandahieu99', 'zoom9119', 'jabiabas', 'sosnowsn', 'fabio.guzman.figueroa', 'hi.joezef', 'kareem_saleh', 'jarobins139', 'au2016', 'epatten', 'joeydajock', 'engabdallah1', 'sasi', 'browthom', 'samuelkim', 'ccloud92', 'paytertot', 'guangxi', 'filipo.sarevski', 'jana.galal', 'salma.al.aidy', 'wwnjameson', 'josan', 'afahad', 'gerami1352', 'boevemac', 'nishit', 'wpkish', 'romeo2011', 'islam.js24', 'mostafa.radwan', 'zakjwalton', 'yyson2000', 'kmac4', 'xz', 'naveenmahenderkar', 'findingnemo2', 'vividwinter', 'howlanjo', 'dragons6666x', 'pacific1912', 'ahmedmedhat10', 'frederique.mittelstaedt', 'imyjer', '1pilo', 'moeffat', 'jiaolh', 'mohamed123', 'guikemch', 'sherif.ghozzy', 'ecamp', 'xyzsam', 'velda', 'menaesam', 'amirazer', 'zhout07', 'andy.greenspon', 'jbrunini', 'richardsaliba', 'tiarlopez', 'marco.adel.37', 'mkinkella', 'sherinemohamed', 'wfair', 'tantoon.soryal', 'williamshake', 'jeverest', 'jonscherf', 'mark_nader', 'rkmeels', 'cfergus3', 'heshamehab', 'mgurak', 'vinotd', 'jamakihe', 'jvesic', 'jensfrost', 'sishaat', 'salmatarek', 'nahlahamed', 'aluxander', 'mostafahelal', 'raghda.mohammad.5', 'obaron', 'mnyboer', 'peastham23', 'ranaahmed', 'marco_truccolo', 'adelaney515', 'alex.contreras.792', 'mebendana', 'arcibaldo89', 'ahmedflamenco', 'captainjkirk', 'ahmed.asfour.1466', 'ahmedreda', 'omargamalhafez21', 'ktcagen', 'cpetrow', 'harrylpc', 'ramiahmedhussien', 'hetmanan', 'rana.a.ghoneim', 'qsvick07', 'adelrashad', None, 'rami.abulfadl', 'mrm328i', 'terahertz', 'defy60', 'karimwissa', 'jacarr', 'taiedy', 'ginnboy', 'maik23d']"
4,159,132,14,12,"['jiaolh', 'yyson2000', 'browthom', 'captainjkirk', 'guikemch', 'nguyetim', 'lafavorj', 'boevemac', 'sosnowsn', 'wpkish', 'mnyboer', 'ryanhiggins']",119,"['ntestin', 'romana8799', 'mohamed123456', 'muhammed333', 'shadi31', 'sorial.samy.7', 'wdobbins', 'kate.schreiber.33', 'zeroik0017', 'bweatherly2011', 'jhaynes3', 'bethanykanten', 'ipsips', 'neduet14', 'pwhitmire', 'pandahieu99', 'zoom9119', 'jabiabas', 'fabio.guzman.figueroa', 'hi.joezef', 'kareem_saleh', 'jarobins139', 'au2016', 'epatten', 'joeydajock', 'engabdallah1', 'sasi', 'ccloud92', 'paytertot', 'guangxi', 'filipo.sarevski', 'jana.galal', 'salma.al.aidy', 'wwnjameson', 'josan', 'afahad', 'gerami1352', 'nishit', 'romeo2011', 'islam.js24', 'mostafa.radwan', 'zakjwalton', 'kmac4', 'xz', 'naveenmahenderkar', 'findingnemo2', 'vividwinter', 'howlanjo', 'dragons6666x', 'pacific1912', 'ahmedmedhat10', 'frederique.mittelstaedt', 'imyjer', '1pilo', 'moeffat', 'mohamed123', 'sherif.ghozzy', 'ecamp', 'xyzsam', 'velda', 'menaesam', 'amirazer', 'zhout07', 'andy.greenspon', 'jbrunini', 'richardsaliba', 'tiarlopez', 'marco.adel.37', 'mkinkella', 'sherinemohamed', 'wfair', 'tantoon.soryal', 'williamshake', 'jeverest', 'jonscherf', 'mark_nader', 'rkmeels', 'cfergus3', 'heshamehab', 'mgurak', 'vinotd', 'jamakihe', 'jvesic', 'jensfrost', 'sishaat', 'salmatarek', 'nahlahamed', 'aluxander', 'mostafahelal', 'raghda.mohammad.5', 'obaron', 'peastham23', 'ranaahmed', 'marco_truccolo', 'adelaney515', 'alex.contreras.792', 'mebendana', 'arcibaldo89', 'ahmedflamenco', 'ahmed.asfour.1466', 'ahmedreda', 'omargamalhafez21', 'ktcagen', 'cpetrow', 'harrylpc', 'ramiahmedhussien', 'hetmanan', 'rana.a.ghoneim', 'qsvick07', 'adelrashad', 'rami.abulfadl', 'mrm328i', 'terahertz', 'defy60', 'karimwissa', 'jacarr', 'taiedy', 'ginnboy', 'maik23d']",2,"['aldridgr', None]",133,"['ntestin', 'nguyetim', 'romana8799', 'mohamed123456', 'muhammed333', 'shadi31', 'sorial.samy.7', 'wdobbins', 'kate.schreiber.33', 'zeroik0017', 'ryanhiggins', 'bweatherly2011', 'jhaynes3', 'bethanykanten', 'ipsips', 'lafavorj', 'neduet14', 'pwhitmire', 'pandahieu99', 'zoom9119', 'jabiabas', 'sosnowsn', 'fabio.guzman.figueroa', 'hi.joezef', 'kareem_saleh', 'jarobins139', 'au2016', 'epatten', 'joeydajock', 'engabdallah1', 'sasi', 'browthom', 'ccloud92', 'paytertot', 'guangxi', 'filipo.sarevski', 'jana.galal', 'salma.al.aidy', 'wwnjameson', 'josan', 'afahad', 'gerami1352', 'boevemac', 'nishit', 'aldridgr', 'wpkish', 'romeo2011', 'islam.js24', 'mostafa.radwan', 'zakjwalton', 'yyson2000', 'kmac4', 'xz', 'naveenmahenderkar', 'findingnemo2', 'vividwinter', 'howlanjo', 'dragons6666x', 'pacific1912', 'ahmedmedhat10', 'frederique.mittelstaedt', 'imyjer', '1pilo', 'moeffat', 'jiaolh', 'mohamed123', 'guikemch', 'sherif.ghozzy', 'ecamp', 'xyzsam', 'velda', 'menaesam', 'amirazer', 'zhout07', 'andy.greenspon', 'jbrunini', 'richardsaliba', 'tiarlopez', 'marco.adel.37', 'mkinkella', 'sherinemohamed', 'wfair', 'tantoon.soryal', 'williamshake', 'jeverest', 'jonscherf', 'mark_nader', 'rkmeels', 'cfergus3', 'heshamehab', 'mgurak', 'vinotd', 'jamakihe', 'jvesic', 'jensfrost', 'sishaat', 'salmatarek', 'nahlahamed', 'aluxander', 'mostafahelal', 'raghda.mohammad.5', 'obaron', 'mnyboer', 'peastham23', 'ranaahmed', 'marco_truccolo', 'adelaney515', 'alex.contreras.792', 'mebendana', 'arcibaldo89', 'ahmedflamenco', 'captainjkirk', 'ahmed.asfour.1466', 'ahmedreda', 'omargamalhafez21', 'ktcagen', 'cpetrow', 'harrylpc', 'ramiahmedhussien', 'hetmanan', 'rana.a.ghoneim', 'qsvick07', 'adelrashad', None, 'rami.abulfadl', 'mrm328i', 'terahertz', 'defy60', 'karimwissa', 'jacarr', 'taiedy', 'ginnboy', 'maik23d']"
4,165,132,10,8,"['pacific1912', 'jamakihe', 'jarobins139', 'tiarlopez', 'epatten', 'vividwinter', 'rkmeels', 'maik23d']",123,"['ntestin', 'nguyetim', 'romana8799', 'mohamed123456', 'muhammed333', 'shadi31', 'sorial.samy.7', 'wdobbins', 'kate.schreiber.33', 'zeroik0017', 'ryanhiggins', 'bweatherly2011', 'jhaynes3', 'bethanykanten', 'ipsips', 'lafavorj', 'neduet14', 'pwhitmire', 'pandahieu99', 'zoom9119', 'jabiabas', 'sosnowsn', 'fabio.guzman.figueroa', 'hi.joezef', 'kareem_saleh', 'au2016', 'joeydajock', 'engabdallah1', 'sasi', 'browthom', 'ccloud92', 'paytertot', 'guangxi', 'filipo.sarevski', 'jana.galal', 'salma.al.aidy', 'wwnjameson', 'josan', 'afahad', 'gerami1352', 'boevemac', 'nishit', 'wpkish', 'romeo2011', 'islam.js24', 'mostafa.radwan', 'zakjwalton', 'yyson2000', 'kmac4', 'xz', 'naveenmahenderkar', 'findingnemo2', 'howlanjo', 'dragons6666x', 'ahmedmedhat10', 'frederique.mittelstaedt', 'imyjer', '1pilo', 'moeffat', 'jiaolh', 'mohamed123', 'guikemch', 'sherif.ghozzy', 'ecamp', 'xyzsam', 'velda', 'menaesam', 'amirazer', 'zhout07', 'andy.greenspon', 'jbrunini', 'richardsaliba', 'marco.adel.37', 'mkinkella', 'sherinemohamed', 'wfair', 'tantoon.soryal', 'williamshake', 'jeverest', 'jonscherf', 'mark_nader', 'cfergus3', 'heshamehab', 'mgurak', 'vinotd', 'jvesic', 'jensfrost', 'sishaat', 'salmatarek', 'nahlahamed', 'aluxander', 'mostafahelal', 'raghda.mohammad.5', 'obaron', 'mnyboer', 'peastham23', 'ranaahmed', 'marco_truccolo', 'adelaney515', 'alex.contreras.792', 'mebendana', 'arcibaldo89', 'ahmedflamenco', 'captainjkirk', 'ahmed.asfour.1466', 'ahmedreda', 'omargamalhafez21', 'ktcagen', 'cpetrow', 'harrylpc', 'ramiahmedhussien', 'hetmanan', 'rana.a.ghoneim', 'qsvick07', 'adelrashad', 'rami.abulfadl', 'mrm328i', 'terahertz', 'defy60', 'karimwissa', 'jacarr', 'taiedy', 'ginnboy']",2,"['kemalparlar', None]",133,"['ntestin', 'nguyetim', 'romana8799', 'mohamed123456', 'muhammed333', 'shadi31', 'sorial.samy.7', 'wdobbins', 'kate.schreiber.33', 'zeroik0017', 'ryanhiggins', 'bweatherly2011', 'jhaynes3', 'bethanykanten', 'ipsips', 'lafavorj', 'neduet14', 'pwhitmire', 'pandahieu99', 'zoom9119', 'jabiabas', 'sosnowsn', 'fabio.guzman.figueroa', 'hi.joezef', 'kareem_saleh', 'jarobins139', 'au2016', 'epatten', 'joeydajock', 'engabdallah1', 'sasi', 'browthom', 'ccloud92', 'paytertot', 'guangxi', 'filipo.sarevski', 'jana.galal', 'salma.al.aidy', 'wwnjameson', 'josan', 'afahad', 'gerami1352', 'boevemac', 'nishit', 'wpkish', 'romeo2011', 'islam.js24', 'mostafa.radwan', 'zakjwalton', 'yyson2000', 'kmac4', 'xz', 'naveenmahenderkar', 'findingnemo2', 'vividwinter', 'howlanjo', 'dragons6666x', 'pacific1912', 'ahmedmedhat10', 'frederique.mittelstaedt', 'imyjer', '1pilo', 'moeffat', 'jiaolh', 'mohamed123', 'guikemch', 'sherif.ghozzy', 'ecamp', 'xyzsam', 'velda', 'menaesam', 'amirazer', 'zhout07', 'andy.greenspon', 'jbrunini', 'richardsaliba', 'tiarlopez', 'marco.adel.37', 'mkinkella', 'sherinemohamed', 'wfair', 'tantoon.soryal', 'williamshake', 'jeverest', 'jonscherf', 'mark_nader', 'rkmeels', 'cfergus3', 'heshamehab', 'mgurak', 'vinotd', 'jamakihe', 'jvesic', 'jensfrost', 'sishaat', 'salmatarek', 'nahlahamed', 'aluxander', 'mostafahelal', 'raghda.mohammad.5', 'obaron', 'mnyboer', 'peastham23', 'ranaahmed', 'marco_truccolo', 'adelaney515', 'alex.contreras.792', 'mebendana', 'arcibaldo89', 'ahmedflamenco', 'captainjkirk', 'ahmed.asfour.1466', 'ahmedreda', 'omargamalhafez21', 'ktcagen', 'cpetrow', 'harrylpc', 'ramiahmedhussien', 'hetmanan', 'rana.a.ghoneim', 'qsvick07', 'adelrashad', None, 'rami.abulfadl', 'mrm328i', 'terahertz', 'defy60', 'karimwissa', 'jacarr', 'taiedy', 'kemalparlar', 'ginnboy', 'maik23d']"
4,154,132,6,5,"['cfergus3', 'afahad', 'jarobins139', 'tiarlopez', 'mkinkella']",126,"['ntestin', 'nguyetim', 'romana8799', 'mohamed123456', 'muhammed333', 'shadi31', 'sorial.samy.7', 'wdobbins', 'kate.schreiber.33', 'zeroik0017', 'ryanhiggins', 'bweatherly2011', 'jhaynes3', 'bethanykanten', 'ipsips', 'lafavorj', 'neduet14', 'pwhitmire', 'pandahieu99', 'zoom9119', 'jabiabas', 'sosnowsn', 'fabio.guzman.figueroa', 'hi.joezef', 'kareem_saleh', 'au2016', 'epatten', 'joeydajock', 'engabdallah1', 'sasi', 'browthom', 'ccloud92', 'paytertot', 'guangxi', 'filipo.sarevski', 'jana.galal', 'salma.al.aidy', 'wwnjameson', 'josan', 'gerami1352', 'boevemac', 'nishit', 'wpkish', 'romeo2011', 'islam.js24', 'mostafa.radwan', 'zakjwalton', 'yyson2000', 'kmac4', 'xz', 'naveenmahenderkar', 'findingnemo2', 'vividwinter', 'howlanjo', 'dragons6666x', 'pacific1912', 'ahmedmedhat10', 'frederique.mittelstaedt', 'imyjer', '1pilo', 'moeffat', 'jiaolh', 'mohamed123', 'guikemch', 'sherif.ghozzy', 'ecamp', 'xyzsam', 'velda', 'menaesam', 'amirazer', 'zhout07', 'andy.greenspon', 'jbrunini', 'richardsaliba', 'marco.adel.37', 'sherinemohamed', 'wfair', 'tantoon.soryal', 'williamshake', 'jeverest', 'jonscherf', 'mark_nader', 'rkmeels', 'heshamehab', 'mgurak', 'vinotd', 'jamakihe', 'jvesic', 'jensfrost', 'sishaat', 'salmatarek', 'nahlahamed', 'aluxander', 'mostafahelal', 'raghda.mohammad.5', 'obaron', 'mnyboer', 'peastham23', 'ranaahmed', 'marco_truccolo', 'adelaney515', 'alex.contreras.792', 'mebendana', 'arcibaldo89', 'ahmedflamenco', 'captainjkirk', 'ahmed.asfour.1466', 'ahmedreda', 'omargamalhafez21', 'ktcagen', 'cpetrow', 'harrylpc', 'ramiahmedhussien', 'hetmanan', 'rana.a.ghoneim', 'qsvick07', 'adelrashad', 'rami.abulfadl', 'mrm328i', 'terahertz', 'defy60', 'karimwissa', 'jacarr', 'taiedy', 'ginnboy', 'maik23d']",1,[None],132,"['ntestin', 'nguyetim', 'romana8799', 'mohamed123456', 'muhammed333', 'shadi31', 'sorial.samy.7', 'wdobbins', 'kate.schreiber.33', 'zeroik0017', 'ryanhiggins', 'bweatherly2011', 'jhaynes3', 'bethanykanten', 'ipsips', 'lafavorj', 'neduet14', 'pwhitmire', 'pandahieu99', 'zoom9119', 'jabiabas', 'sosnowsn', 'fabio.guzman.figueroa', 'hi.joezef', 'kareem_saleh', 'jarobins139', 'au2016', 'epatten', 'joeydajock', 'engabdallah1', 'sasi', 'browthom', 'ccloud92', 'paytertot', 'guangxi', 'filipo.sarevski', 'jana.galal', 'salma.al.aidy', 'wwnjameson', 'josan', 'afahad', 'gerami1352', 'boevemac', 'nishit', 'wpkish', 'romeo2011', 'islam.js24', 'mostafa.radwan', 'zakjwalton', 'yyson2000', 'kmac4', 'xz', 'naveenmahenderkar', 'findingnemo2', 'vividwinter', 'howlanjo', 'dragons6666x', 'pacific1912', 'ahmedmedhat10', 'frederique.mittelstaedt', 'imyjer', '1pilo', 'moeffat', 'jiaolh', 'mohamed123', 'guikemch', 'sherif.ghozzy', 'ecamp', 'xyzsam', 'velda', 'menaesam', 'amirazer', 'zhout07', 'andy.greenspon', 'jbrunini', 'richardsaliba', 'tiarlopez', 'marco.adel.37', 'mkinkella', 'sherinemohamed', 'wfair', 'tantoon.soryal', 'williamshake', 'jeverest', 'jonscherf', 'mark_nader', 'rkmeels', 'cfergus3', 'heshamehab', 'mgurak', 'vinotd', 'jamakihe', 'jvesic', 'jensfrost', 'sishaat', 'salmatarek', 'nahlahamed', 'aluxander', 'mostafahelal', 'raghda.mohammad.5', 'obaron', 'mnyboer', 'peastham23', 'ranaahmed', 'marco_truccolo', 'adelaney515', 'alex.contreras.792', 'mebendana', 'arcibaldo89', 'ahmedflamenco', 'captainjkirk', 'ahmed.asfour.1466', 'ahmedreda', 'omargamalhafez21', 'ktcagen', 'cpetrow', 'harrylpc', 'ramiahmedhussien', 'hetmanan', 'rana.a.ghoneim', 'qsvick07', 'adelrashad', None, 'rami.abulfadl', 'mrm328i', 'terahertz', 'defy60', 'karimwissa', 'jacarr', 'taiedy', 'ginnboy', 'maik23d']"
5,46,79,93,15,"['anumbasheer22', 'imtiazhira', 'mw', 'syedsaadahmed', 'engrhafizirfan450yahoo.com', 'kashifssiddiqui', 'mirzafaizan.baig.129', 'theacessalman', 'tjfonn', 'ifrah_jaffri', 'ifrahashraf', 'ayeshahassan92', 'quratulainalikhan', 'wahaba', 'kanwaalnaz']",63,"['josh.epstein.79', 'mariange8282', 'apop2', 'aaron12', 'ferdelarr', 'bonecrusher', 'daveontw', 'nmerstorf', 'kevinsantiago1', 'rick9eller', 'rbrosius', 'catalina2709', 'carlos.e.puerto.s', 'pipe9404', 'superpes', 'mild.piyawan.1', 'am.alarcon346', 'cajrgato', 'susanne.pfeifer85', 'shikhor.himadri', 'sm4343if', 'jm.rodriguez11', 'deejaystander', 'ds.restrepo10', 'poosuda.phetban', 'cristianjavier.cifuentessilva', 'ra.cordoba10', 'julian.david.00300', 'li_imperial', 'zhewu43', 'mattnohava', 'cnhoang', 'sbowcock', 'benbburn', 'suchiya', 'fabianm95', 'caerrome', 'hsterry22', 'tarod13', 'lf.burbano10', 'mac_1701_117', 'jkung', 'akkaratch.sukserm', 'carolina.duque.sierra', 'csiefer', 'jezl9559', 'yuitan87', 'jd.martinez1062', 'jsebas.1995', 'guptasukriti1', 'gferrusca019', 'c.gomez11', 'ferdousru1', 'alejobb94', 'getkay1214', 'juliantrilli', 'chriskumm', 'jcorrea', 'kh', 'perroski', 'hooman2461', 's.correa12', 'navidp']",78,"['sadiameeran', 'mariakanwal', 'warda26', 'el043', 'rabiya.tabassum.31', 'bilalkhalideleng', 'sayyeda.umbereen', 'iqrajohim', 'sidrakanwal', 'sidrah.126', 'jahanxaib', 'muneebnadeem92', 'ahmed_umais', 'ijlal.as', 'anum91', 'hammad157', 'sidragillani92', 'aabiya.mansoor', 'burhan.saif52', 'siddiqi', 'ali25', 'asmamahar', 'anizaaa', 'el120', 'abber.online91', 'hafsah', 'uzaif', 'iqramanzoorjohim', 'arham', 'daniausman', 'shfinal', 'sidra.khan.188', 'saifullah', 'alvinabatool1', 'abeera', 'hiraimtiaz', 'shariq.khi', 'bismashaheen21', 'daniyal', 'ssdlabs', 'arisha.binte.ishrat', 'sidrah.mukhi', 'alishariq9', 'anum.7', 'daniyal_zakaria', 'aneeba', 'billal', 'hoora', 'faizan_hadi', 'yusramarium', 'r.kanwal', 'mazhar861992', 'jiaa', 'hk', 'manoj_panjwani', 'insiya.batool', 'moazza304', 'aimen.naz.3', 'farhanali9228', 'tahreem', '23may199x', 'yousra', 'mehreen.mehmood', 'elecengrmka', 'sairakayani07', 'best_score92', 'nausheenjamil', 'arshiahafeez', 'faraz.ali47', 'sehrishfatima', 'neev.kiran', 'fateeha.92', 'hassannawaz', 'yamnazain', 'javeria_abbasi', 'maisra', 'sweetsaimaanis', None]",156,"['josh.epstein.79', 'sadiameeran', 'mariakanwal', 'tjfonn', 'ifrahashraf', 'kevinsantiago1', 'rbrosius', 'jm.rodriguez11', 'warda26', 'rabiya.tabassum.31', 'el043', 'deejaystander', 'julian.david.00300', 'bilalkhalideleng', 'li_imperial', 'sayyeda.umbereen', 'iqrajohim', 'mattnohava', 'sidrakanwal', 'sidrah.126', 'sbowcock', 'jahanxaib', 'suchiya', 'muneebnadeem92', 'ahmed_umais', 'ijlal.as', 'anum91', 'hsterry22', 'mac_1701_117', 'lf.burbano10', 'hammad157', 'carolina.duque.sierra', 'sidragillani92', 'aabiya.mansoor', 'engrhafizirfan450yahoo.com', 'guptasukriti1', 'burhan.saif52', 'alejobb94', 'chriskumm', 'siddiqi', 'kh', 'anumbasheer22', 'mariange8282', 'ali25', 'syedsaadahmed', 'asmamahar', 'ferdelarr', 'anizaaa', 'el120', 'abber.online91', 'hafsah', 'uzaif', 'iqramanzoorjohim', 'catalina2709', 'carlos.e.puerto.s', 'pipe9404', 'arham', 'daniausman', 'shfinal', 'ds.restrepo10', 'poosuda.phetban', 'cristianjavier.cifuentessilva', 'sidra.khan.188', 'saifullah', 'alvinabatool1', 'mw', 'abeera', 'benbburn', 'quratulainalikhan', 'hiraimtiaz', 'csiefer', 'imtiazhira', 'jsebas.1995', 'gferrusca019', 'shariq.khi', 'bismashaheen21', 'perroski', 'daniyal', 'hooman2461', 'ssdlabs', 'apop2', 'arisha.binte.ishrat', 'sidrah.mukhi', 'bonecrusher', 'nmerstorf', 'alishariq9', 'wahaba', 'anum.7', 'superpes', 'daniyal_zakaria', 'cajrgato', 'susanne.pfeifer85', 'aneeba', 'sm4343if', 'ra.cordoba10', 'billal', 'hoora', 'faizan_hadi', 'yusramarium', 'cnhoang', 'r.kanwal', 'mazhar861992', 'jiaa', 'hk', 'manoj_panjwani', 'ayeshahassan92', 'insiya.batool', 'moazza304', 'aimen.naz.3', 'farhanali9228', 'jezl9559', 'yuitan87', 'tahreem', 'juliantrilli', 'jcorrea', '23may199x', 'navidp', 'aaron12', 'yousra', 'mehreen.mehmood', 'elecengrmka', 'kashifssiddiqui', 'sairakayani07', 'daveontw', 'best_score92', 'nausheenjamil', 'arshiahafeez', 'rick9eller', 'mild.piyawan.1', 'faraz.ali47', 'am.alarcon346', 'shikhor.himadri', 'kanwaalnaz', 'zhewu43', 'sehrishfatima', 'neev.kiran', 'fateeha.92', 'theacessalman', 'ifrah_jaffri', 'fabianm95', 'hassannawaz', 'yamnazain', 'javeria_abbasi', 'caerrome', 'maisra', 'tarod13', 'sweetsaimaanis', 'jkung', None, 'akkaratch.sukserm', 'jd.martinez1062', 'mirzafaizan.baig.129', 'c.gomez11', 'ferdousru1', 'getkay1214', 's.correa12']"
5,30,79,76,1,['cnhoang'],77,"['josh.epstein.79', 'tjfonn', 'ifrahashraf', 'kevinsantiago1', 'rbrosius', 'jm.rodriguez11', 'deejaystander', 'julian.david.00300', 'li_imperial', 'mattnohava', 'sbowcock', 'suchiya', 'hsterry22', 'lf.burbano10', 'mac_1701_117', 'carolina.duque.sierra', 'engrhafizirfan450yahoo.com', 'guptasukriti1', 'alejobb94', 'chriskumm', 'kh', 'anumbasheer22', 'mariange8282', 'syedsaadahmed', 'ferdelarr', 'catalina2709', 'carlos.e.puerto.s', 'pipe9404', 'ds.restrepo10', 'poosuda.phetban', 'cristianjavier.cifuentessilva', 'mw', 'benbburn', 'quratulainalikhan', 'csiefer', 'imtiazhira', 'jsebas.1995', 'gferrusca019', 'perroski', 'hooman2461', 'apop2', 'bonecrusher', 'nmerstorf', 'wahaba', 'superpes', 'cajrgato', 'susanne.pfeifer85', 'sm4343if', 'ra.cordoba10', 'ayeshahassan92', 'jezl9559', 'yuitan87', 'juliantrilli', 'jcorrea', 'navidp', 'aaron12', 'kashifssiddiqui', 'daveontw', 'rick9eller', 'mild.piyawan.1', 'am.alarcon346', 'shikhor.himadri', 'kanwaalnaz', 'zhewu43', 'theacessalman', 'ifrah_jaffri', 'fabianm95', 'caerrome', 'tarod13', 'jkung', 'akkaratch.sukserm', 'jd.martinez1062', 'mirzafaizan.baig.129', 'c.gomez11', 'ferdousru1', 'getkay1214', 's.correa12']",75,"['deanhartman7', 'asharip', 'jonathan.davis.391', 'gavingt', 'sensisounds', 'jaredbecker', 'geniuslb12345', 'drinkupmehearties525', 'connorchilton', 'srini999', 'rfang4', 'amandankeil', 'gouron73', 'jalon_sisson', 'sbowcock1', 'alecmcc93', 'mgjaggers', 'eshaikh', 'joshuajerkins', 'yyemitan1', 'steve6707', 'mkanand89', 'kkalexa1', 'spdewitt', 'ohdannyboy25', 'gspell', 'nshemer', 'lemaitre7', 'thvincent200690', 'jaduart1', 'iwillzuu', 'lunwei', 'mkgeres', 'lightfooot', 'ironkaanon', 'gilbert.madril', 'geselby', 'michael.jason.ku', 'timmerix', 'brandondeal', 'pdcurtis', 'shannonlip', 'speakoutloudly', 'nhorvat1', 'jmsloan1', 'awtanner', 'chrisloff', 'jpbefort', 'wtlittle', 'timt8ion', 'uaevip20000', 'kcrosner', 'mrsnef1', None, 'donkeykonk', 'ferry', 'chrismay', 'veramos92', 'rburke12', 'nmaududi', 'adharan', 'tmerick1', 'acipressi', 'nmspirak', 'pastorin', 'jingliangzhong', 'lbj2128694', 'leotherprofile', 'dustin.esman', 'smatheos', 'kevdhanson', 'csikes', 'rymahoney12', 'jgwright', 'tvdo1']",153,"['josh.epstein.79', 'deanhartman7', 'gavingt', 'tjfonn', 'connorchilton', 'srini999', 'ifrahashraf', 'kevinsantiago1', 'rbrosius', 'sbowcock1', 'mgjaggers', 'joshuajerkins', 'yyemitan1', 'jm.rodriguez11', 'deejaystander', 'ohdannyboy25', 'julian.david.00300', 'li_imperial', 'mattnohava', 'michael.jason.ku', 'brandondeal', 'nhorvat1', 'awtanner', 'sbowcock', 'suchiya', 'uaevip20000', 'hsterry22', 'mac_1701_117', 'lf.burbano10', 'carolina.duque.sierra', 'engrhafizirfan450yahoo.com', 'guptasukriti1', 'pastorin', 'alejobb94', 'jingliangzhong', 'chriskumm', 'kh', 'tvdo1', 'anumbasheer22', 'mariange8282', 'asharip', 'jonathan.davis.391', 'sensisounds', 'syedsaadahmed', 'jaredbecker', 'ferdelarr', 'rfang4', 'jalon_sisson', 'catalina2709', 'carlos.e.puerto.s', 'pipe9404', 'nshemer', 'ds.restrepo10', 'poosuda.phetban', 'cristianjavier.cifuentessilva', 'jaduart1', 'lunwei', 'ironkaanon', 'geselby', 'mw', 'jmsloan1', 'chrisloff', 'benbburn', 'quratulainalikhan', 'timt8ion', 'csiefer', 'imtiazhira', 'nmaududi', 'jsebas.1995', 'nmspirak', 'gferrusca019', 'lbj2128694', 'leotherprofile', 'rymahoney12', 'perroski', 'veramos92', 'hooman2461', 'apop2', 'bonecrusher', 'nmerstorf', 'wahaba', 'superpes', 'alecmcc93', 'cajrgato', 'susanne.pfeifer85', 'eshaikh', 'sm4343if', 'mkanand89', 'kkalexa1', 'ra.cordoba10', 'spdewitt', 'gspell', 'lemaitre7', 'mkgeres', 'lightfooot', 'gilbert.madril', 'cnhoang', 'pdcurtis', 'shannonlip', 'speakoutloudly', 'ayeshahassan92', 'wtlittle', 'donkeykonk', 'ferry', 'rburke12', 'jezl9559', 'yuitan87', 'adharan', 'tmerick1', 'juliantrilli', 'jcorrea', 'dustin.esman', 'kcrosner', 'navidp', 'aaron12', 'kashifssiddiqui', 'geniuslb12345', 'drinkupmehearties525', 'daveontw', 'amandankeil', 'rick9eller', 'gouron73', 'mild.piyawan.1', 'am.alarcon346', 'shikhor.himadri', 'thvincent200690', 'iwillzuu', 'kanwaalnaz', 'zhewu43', 'timmerix', 'theacessalman', 'ifrah_jaffri', 'fabianm95', 'jpbefort', 'caerrome', 'mrsnef1', 'tarod13', None, 'jkung', 'chrismay', 'akkaratch.sukserm', 'jd.martinez1062', 'mirzafaizan.baig.129', 'acipressi', 'c.gomez11', 'ferdousru1', 'getkay1214', 'kevdhanson', 'smatheos', 'jgwright', 'csikes', 'steve6707', 's.correa12']"
5,48,79,70,4,"['aaron12', 'sbowcock', 'cnhoang', 'jkung']",74,"['josh.epstein.79', 'anumbasheer22', 'mariange8282', 'apop2', 'syedsaadahmed', 'kashifssiddiqui', 'tjfonn', 'ferdelarr', 'bonecrusher', 'ifrahashraf', 'daveontw', 'nmerstorf', 'kevinsantiago1', 'rick9eller', 'wahaba', 'rbrosius', 'catalina2709', 'carlos.e.puerto.s', 'pipe9404', 'superpes', 'mild.piyawan.1', 'am.alarcon346', 'cajrgato', 'susanne.pfeifer85', 'shikhor.himadri', 'sm4343if', 'jm.rodriguez11', 'deejaystander', 'ds.restrepo10', 'poosuda.phetban', 'cristianjavier.cifuentessilva', 'ra.cordoba10', 'julian.david.00300', 'kanwaalnaz', 'li_imperial', 'zhewu43', 'mattnohava', 'mw', 'theacessalman', 'benbburn', 'ifrah_jaffri', 'suchiya', 'fabianm95', 'ayeshahassan92', 'quratulainalikhan', 'caerrome', 'hsterry22', 'tarod13', 'lf.burbano10', 'mac_1701_117', 'akkaratch.sukserm', 'carolina.duque.sierra', 'csiefer', 'imtiazhira', 'jezl9559', 'yuitan87', 'jd.martinez1062', 'mirzafaizan.baig.129', 'engrhafizirfan450yahoo.com', 'guptasukriti1', 'jsebas.1995', 'gferrusca019', 'c.gomez11', 'ferdousru1', 'alejobb94', 'getkay1214', 'juliantrilli', 'chriskumm', 'jcorrea', 'kh', 'perroski', 'hooman2461', 's.correa12', 'navidp']",66,"['payelray', 'deanhartman7', 'asharip', 'jonathan.davis.391', 'gavingt', 'jaredbecker', 'drinkupmehearties525', 'connorchilton', 'amandankeil', 'gouron73', 'anshul1993', 'nkjorgen', 'alecmcc93', 'mgjaggers', 'eshaikh', 'joshuajerkins', 'yyemitan1', 'kkalexa1', 'spdewitt', 'ohdannyboy25', 'gspell', 'nshemer', 'lemaitre7', 'thvincent200690', 'jaduart1', 'iwillzuu', 'ironkaanon', 'mkgeres', 'lightfooot', 'geselby', 'gilbert.madril', 'michael.jason.ku', 'brandondeal', 'pdcurtis', 'shannonlip', 'speakoutloudly', 'nhorvat1', 'jmsloan1', 'awtanner', 'chrisloff', 'jpbefort', 'wtlittle', 'timt8ion', 'uaevip20000', 'kcrosner', 'mrsnef1', None, 'donkeykonk', 'chrismay', 'sposborn', 'rburke12', 'tmerick1', 'acipressi', 'nmspirak', 'pastorin', 'jingliangzhong', 'nitishsharmabit', 'lbj2128694', 'dustin.esman', 'smatheos', 'kevdhanson', 'csikes', 'rymahoney12', 'veramos92', 'tvdo1', 'jgwright']",144,"['josh.epstein.79', 'apop2', 'deanhartman7', 'gavingt', 'tjfonn', 'connorchilton', 'bonecrusher', 'ifrahashraf', 'nmerstorf', 'kevinsantiago1', 'wahaba', 'rbrosius', 'anshul1993', 'superpes', 'alecmcc93', 'mgjaggers', 'cajrgato', 'susanne.pfeifer85', 'eshaikh', 'sm4343if', 'joshuajerkins', 'jm.rodriguez11', 'yyemitan1', 'deejaystander', 'ra.cordoba10', 'kkalexa1', 'spdewitt', 'ohdannyboy25', 'julian.david.00300', 'gspell', 'lemaitre7', 'mkgeres', 'li_imperial', 'lightfooot', 'gilbert.madril', 'mattnohava', 'michael.jason.ku', 'cnhoang', 'pdcurtis', 'shannonlip', 'brandondeal', 'speakoutloudly', 'nhorvat1', 'awtanner', 'sbowcock', 'suchiya', 'ayeshahassan92', 'wtlittle', 'uaevip20000', 'hsterry22', 'mac_1701_117', 'lf.burbano10', 'donkeykonk', 'carolina.duque.sierra', 'rburke12', 'jezl9559', 'yuitan87', 'engrhafizirfan450yahoo.com', 'guptasukriti1', 'tmerick1', 'pastorin', 'alejobb94', 'jingliangzhong', 'juliantrilli', 'chriskumm', 'jcorrea', 'dustin.esman', 'kh', 'tvdo1', 'kcrosner', 'navidp', 'payelray', 'anumbasheer22', 'mariange8282', 'aaron12', 'asharip', 'jonathan.davis.391', 'syedsaadahmed', 'kashifssiddiqui', 'jaredbecker', 'ferdelarr', 'drinkupmehearties525', 'daveontw', 'amandankeil', 'rick9eller', 'gouron73', 'catalina2709', 'carlos.e.puerto.s', 'pipe9404', 'mild.piyawan.1', 'nkjorgen', 'am.alarcon346', 'shikhor.himadri', 'nshemer', 'ds.restrepo10', 'poosuda.phetban', 'cristianjavier.cifuentessilva', 'thvincent200690', 'jaduart1', 'iwillzuu', 'kanwaalnaz', 'ironkaanon', 'geselby', 'zhewu43', 'mw', 'jmsloan1', 'chrisloff', 'theacessalman', 'benbburn', 'ifrah_jaffri', 'fabianm95', 'jpbefort', 'quratulainalikhan', 'timt8ion', 'caerrome', 'mrsnef1', 'tarod13', None, 'jkung', 'chrismay', 'akkaratch.sukserm', 'csiefer', 'imtiazhira', 'jd.martinez1062', 'sposborn', 'mirzafaizan.baig.129', 'jsebas.1995', 'acipressi', 'nmspirak', 'gferrusca019', 'c.gomez11', 'ferdousru1', 'getkay1214', 'nitishsharmabit', 'lbj2128694', 'kevdhanson', 'smatheos', 'rymahoney12', 'csikes', 'perroski', 'veramos92', 'hooman2461', 's.correa12', 'jgwright']"
5,53,79,35,26,"['mariange8282', 'ferdelarr', 'catalina2709', 'carlos.e.puerto.s', 'pipe9404', 'superpes', 'am.alarcon346', 'cajrgato', 'jm.rodriguez11', 'deejaystander', 'ds.restrepo10', 'ra.cordoba10', 'julian.david.00300', 'fabianm95', 'caerrome', 'tarod13', 'lf.burbano10', 'carolina.duque.sierra', 'jd.martinez1062', 'jezl9559', 'jsebas.1995', 'c.gomez11', 'alejobb94', 'juliantrilli', 'perroski', 's.correa12']",52,"['josh.epstein.79', 'anumbasheer22', 'apop2', 'aaron12', 'syedsaadahmed', 'kashifssiddiqui', 'tjfonn', 'bonecrusher', 'ifrahashraf', 'daveontw', 'nmerstorf', 'kevinsantiago1', 'rick9eller', 'wahaba', 'rbrosius', 'mild.piyawan.1', 'susanne.pfeifer85', 'shikhor.himadri', 'sm4343if', 'poosuda.phetban', 'cristianjavier.cifuentessilva', 'kanwaalnaz', 'li_imperial', 'zhewu43', 'mattnohava', 'cnhoang', 'mw', 'theacessalman', 'sbowcock', 'benbburn', 'suchiya', 'ifrah_jaffri', 'ayeshahassan92', 'quratulainalikhan', 'hsterry22', 'mac_1701_117', 'jkung', 'akkaratch.sukserm', 'csiefer', 'imtiazhira', 'yuitan87', 'mirzafaizan.baig.129', 'engrhafizirfan450yahoo.com', 'guptasukriti1', 'gferrusca019', 'ferdousru1', 'getkay1214', 'jcorrea', 'chriskumm', 'kh', 'hooman2461', 'navidp']",9,"['julian321', 'wa.forero10', 'ruedagato4t0', 'crashmateriales', 'osesnoguerrero', 'dcjorge10', 'avilaalba', None, 'jp.martinez10']",87,"['josh.epstein.79', 'apop2', 'tjfonn', 'bonecrusher', 'ifrahashraf', 'nmerstorf', 'kevinsantiago1', 'wahaba', 'rbrosius', 'superpes', 'cajrgato', 'susanne.pfeifer85', 'sm4343if', 'jm.rodriguez11', 'osesnoguerrero', 'deejaystander', 'ra.cordoba10', 'julian.david.00300', 'li_imperial', 'mattnohava', 'cnhoang', 'sbowcock', 'suchiya', 'ayeshahassan92', 'hsterry22', 'mac_1701_117', 'lf.burbano10', 'carolina.duque.sierra', 'julian321', 'jezl9559', 'yuitan87', 'engrhafizirfan450yahoo.com', 'guptasukriti1', 'alejobb94', 'juliantrilli', 'chriskumm', 'jcorrea', 'dcjorge10', 'kh', 'navidp', 'anumbasheer22', 'mariange8282', 'aaron12', 'syedsaadahmed', 'kashifssiddiqui', 'ferdelarr', 'crashmateriales', 'daveontw', 'rick9eller', 'jp.martinez10', 'catalina2709', 'carlos.e.puerto.s', 'pipe9404', 'mild.piyawan.1', 'wa.forero10', 'am.alarcon346', 'shikhor.himadri', 'ds.restrepo10', 'poosuda.phetban', 'cristianjavier.cifuentessilva', 'kanwaalnaz', 'zhewu43', 'mw', 'theacessalman', 'benbburn', 'ifrah_jaffri', 'fabianm95', 'quratulainalikhan', 'caerrome', 'tarod13', None, 'jkung', 'akkaratch.sukserm', 'csiefer', 'imtiazhira', 'jd.martinez1062', 'mirzafaizan.baig.129', 'ruedagato4t0', 'jsebas.1995', 'gferrusca019', 'c.gomez11', 'ferdousru1', 'getkay1214', 'avilaalba', 'perroski', 'hooman2461', 's.correa12']"
5,85,79,26,1,['quratulainalikhan'],77,"['josh.epstein.79', 'tjfonn', 'ifrahashraf', 'kevinsantiago1', 'rbrosius', 'jm.rodriguez11', 'deejaystander', 'julian.david.00300', 'li_imperial', 'mattnohava', 'sbowcock', 'suchiya', 'hsterry22', 'lf.burbano10', 'mac_1701_117', 'carolina.duque.sierra', 'engrhafizirfan450yahoo.com', 'guptasukriti1', 'alejobb94', 'chriskumm', 'kh', 'anumbasheer22', 'mariange8282', 'syedsaadahmed', 'ferdelarr', 'catalina2709', 'carlos.e.puerto.s', 'pipe9404', 'ds.restrepo10', 'poosuda.phetban', 'cristianjavier.cifuentessilva', 'mw', 'benbburn', 'csiefer', 'imtiazhira', 'jsebas.1995', 'gferrusca019', 'perroski', 'hooman2461', 'apop2', 'bonecrusher', 'nmerstorf', 'wahaba', 'superpes', 'cajrgato', 'susanne.pfeifer85', 'sm4343if', 'ra.cordoba10', 'cnhoang', 'ayeshahassan92', 'jezl9559', 'yuitan87', 'juliantrilli', 'jcorrea', 'navidp', 'aaron12', 'kashifssiddiqui', 'daveontw', 'rick9eller', 'mild.piyawan.1', 'am.alarcon346', 'shikhor.himadri', 'kanwaalnaz', 'zhewu43', 'theacessalman', 'ifrah_jaffri', 'fabianm95', 'caerrome', 'tarod13', 'jkung', 'akkaratch.sukserm', 'jd.martinez1062', 'mirzafaizan.baig.129', 'c.gomez11', 'ferdousru1', 'getkay1214', 's.correa12']",25,"['ssdlabs', 'yousra', 'mariakanwal', 'ali25', 'loginlogin', 'arshiahafeez', 'alishariq9', 'faraz.ali47', 'arham', 'aneeba', 'sanamalik', 'daniausman', 'sidra.khan.188', 'sehrishfatima', 'faizan_hadi', 'sidrah.126', 'abeera', 'muneebnadeem92', 'maisra', None, 'hiraimtiaz', 'aabiya.mansoor', 'naseeruddin.shinwari', 'tahreem', '23may199x']",103,"['ssdlabs', 'josh.epstein.79', 'apop2', 'mariakanwal', 'tjfonn', 'bonecrusher', 'ifrahashraf', 'loginlogin', 'nmerstorf', 'kevinsantiago1', 'alishariq9', 'wahaba', 'rbrosius', 'superpes', 'cajrgato', 'susanne.pfeifer85', 'aneeba', 'sm4343if', 'jm.rodriguez11', 'deejaystander', 'ra.cordoba10', 'julian.david.00300', 'li_imperial', 'faizan_hadi', 'mattnohava', 'cnhoang', 'sidrah.126', 'sbowcock', 'suchiya', 'muneebnadeem92', 'ayeshahassan92', 'hsterry22', 'mac_1701_117', 'lf.burbano10', 'carolina.duque.sierra', 'aabiya.mansoor', 'jezl9559', 'yuitan87', 'engrhafizirfan450yahoo.com', 'guptasukriti1', 'tahreem', 'alejobb94', 'juliantrilli', 'chriskumm', 'jcorrea', 'kh', '23may199x', 'navidp', 'anumbasheer22', 'mariange8282', 'aaron12', 'yousra', 'ali25', 'syedsaadahmed', 'kashifssiddiqui', 'ferdelarr', 'daveontw', 'arshiahafeez', 'rick9eller', 'catalina2709', 'carlos.e.puerto.s', 'pipe9404', 'mild.piyawan.1', 'faraz.ali47', 'am.alarcon346', 'arham', 'shikhor.himadri', 'sanamalik', 'daniausman', 'ds.restrepo10', 'poosuda.phetban', 'cristianjavier.cifuentessilva', 'sidra.khan.188', 'kanwaalnaz', 'zhewu43', 'sehrishfatima', 'mw', 'abeera', 'theacessalman', 'benbburn', 'ifrah_jaffri', 'fabianm95', 'quratulainalikhan', 'caerrome', 'maisra', 'tarod13', None, 'jkung', 'hiraimtiaz', 'akkaratch.sukserm', 'csiefer', 'imtiazhira', 'jd.martinez1062', 'mirzafaizan.baig.129', 'jsebas.1995', 'naseeruddin.shinwari', 'gferrusca019', 'c.gomez11', 'ferdousru1', 'getkay1214', 'perroski', 'hooman2461', 's.correa12']"
5,51,79,13,2,"['mild.piyawan.1', 'poosuda.phetban']",76,"['josh.epstein.79', 'apop2', 'tjfonn', 'bonecrusher', 'ifrahashraf', 'nmerstorf', 'kevinsantiago1', 'wahaba', 'rbrosius', 'superpes', 'cajrgato', 'susanne.pfeifer85', 'sm4343if', 'jm.rodriguez11', 'deejaystander', 'ra.cordoba10', 'julian.david.00300', 'li_imperial', 'mattnohava', 'cnhoang', 'sbowcock', 'suchiya', 'ayeshahassan92', 'hsterry22', 'mac_1701_117', 'lf.burbano10', 'carolina.duque.sierra', 'jezl9559', 'yuitan87', 'engrhafizirfan450yahoo.com', 'guptasukriti1', 'alejobb94', 'juliantrilli', 'chriskumm', 'jcorrea', 'kh', 'navidp', 'anumbasheer22', 'mariange8282', 'aaron12', 'syedsaadahmed', 'kashifssiddiqui', 'ferdelarr', 'daveontw', 'rick9eller', 'catalina2709', 'carlos.e.puerto.s', 'pipe9404', 'am.alarcon346', 'shikhor.himadri', 'ds.restrepo10', 'cristianjavier.cifuentessilva', 'kanwaalnaz', 'zhewu43', 'mw', 'theacessalman', 'benbburn', 'ifrah_jaffri', 'fabianm95', 'quratulainalikhan', 'caerrome', 'tarod13', 'jkung', 'akkaratch.sukserm', 'csiefer', 'imtiazhira', 'jd.martinez1062', 'mirzafaizan.baig.129', 'jsebas.1995', 'gferrusca019', 'c.gomez11', 'ferdousru1', 'getkay1214', 'perroski', 'hooman2461', 's.correa12']",11,"[None, 'saowaluk', 'alongkot', 'p.dulyaseree', 'm.worawut', 'aaomaum', 'jomjamjungko', 'armmy', 'mingly', 'kanoknans', 'weesuke']",89,"['josh.epstein.79', 'apop2', 'tjfonn', 'm.worawut', 'bonecrusher', 'ifrahashraf', 'nmerstorf', 'kevinsantiago1', 'armmy', 'wahaba', 'mingly', 'rbrosius', 'superpes', 'cajrgato', 'susanne.pfeifer85', 'alongkot', 'sm4343if', 'jm.rodriguez11', 'deejaystander', 'ra.cordoba10', 'julian.david.00300', 'kanoknans', 'li_imperial', 'mattnohava', 'saowaluk', 'cnhoang', 'sbowcock', 'suchiya', 'ayeshahassan92', 'aaomaum', 'hsterry22', 'mac_1701_117', 'lf.burbano10', 'carolina.duque.sierra', 'jezl9559', 'yuitan87', 'engrhafizirfan450yahoo.com', 'guptasukriti1', 'p.dulyaseree', 'alejobb94', 'juliantrilli', 'chriskumm', 'jcorrea', 'kh', 'navidp', 'anumbasheer22', 'mariange8282', 'aaron12', 'syedsaadahmed', 'kashifssiddiqui', 'ferdelarr', 'daveontw', 'rick9eller', 'catalina2709', 'carlos.e.puerto.s', 'pipe9404', 'mild.piyawan.1', 'am.alarcon346', 'shikhor.himadri', 'jomjamjungko', 'ds.restrepo10', 'poosuda.phetban', 'cristianjavier.cifuentessilva', 'kanwaalnaz', 'zhewu43', 'weesuke', 'mw', 'theacessalman', 'benbburn', 'ifrah_jaffri', 'fabianm95', 'quratulainalikhan', 'caerrome', 'tarod13', None, 'jkung', 'akkaratch.sukserm', 'csiefer', 'imtiazhira', 'jd.martinez1062', 'mirzafaizan.baig.129', 'jsebas.1995', 'gferrusca019', 'c.gomez11', 'ferdousru1', 'getkay1214', 'perroski', 'hooman2461', 's.correa12']"
5,49,79,11,2,"['hsterry22', 'kevinsantiago1']",76,"['josh.epstein.79', 'apop2', 'tjfonn', 'bonecrusher', 'ifrahashraf', 'nmerstorf', 'wahaba', 'rbrosius', 'superpes', 'cajrgato', 'susanne.pfeifer85', 'sm4343if', 'jm.rodriguez11', 'deejaystander', 'ra.cordoba10', 'julian.david.00300', 'li_imperial', 'mattnohava', 'cnhoang', 'sbowcock', 'suchiya', 'ayeshahassan92', 'mac_1701_117', 'lf.burbano10', 'carolina.duque.sierra', 'jezl9559', 'yuitan87', 'engrhafizirfan450yahoo.com', 'guptasukriti1', 'alejobb94', 'juliantrilli', 'chriskumm', 'jcorrea', 'kh', 'navidp', 'anumbasheer22', 'mariange8282', 'aaron12', 'syedsaadahmed', 'kashifssiddiqui', 'ferdelarr', 'daveontw', 'rick9eller', 'catalina2709', 'carlos.e.puerto.s', 'pipe9404', 'mild.piyawan.1', 'am.alarcon346', 'shikhor.himadri', 'ds.restrepo10', 'poosuda.phetban', 'cristianjavier.cifuentessilva', 'kanwaalnaz', 'zhewu43', 'mw', 'theacessalman', 'benbburn', 'ifrah_jaffri', 'fabianm95', 'quratulainalikhan', 'caerrome', 'tarod13', 'jkung', 'akkaratch.sukserm', 'csiefer', 'imtiazhira', 'jd.martinez1062', 'mirzafaizan.baig.129', 'jsebas.1995', 'gferrusca019', 'c.gomez11', 'ferdousru1', 'getkay1214', 'perroski', 'hooman2461', 's.correa12']",9,"['sola', 'solamash', 'ketbrandon', 'a.s.falconer', 'c.d.white18426', 'kipkemoi.rono.9', None, 'lumu.manandhar', 't.j.birdsong']",87,"['josh.epstein.79', 'apop2', 'tjfonn', 'bonecrusher', 'ifrahashraf', 'nmerstorf', 'kevinsantiago1', 'wahaba', 'rbrosius', 'solamash', 'superpes', 'cajrgato', 'susanne.pfeifer85', 'sm4343if', 'jm.rodriguez11', 'deejaystander', 'ra.cordoba10', 'julian.david.00300', 'li_imperial', 'mattnohava', 'cnhoang', 'sbowcock', 'suchiya', 'ayeshahassan92', 'hsterry22', 'mac_1701_117', 'lf.burbano10', 'carolina.duque.sierra', 'jezl9559', 'yuitan87', 'engrhafizirfan450yahoo.com', 'guptasukriti1', 'alejobb94', 'juliantrilli', 'chriskumm', 'jcorrea', 'kh', 'navidp', 'lumu.manandhar', 't.j.birdsong', 'anumbasheer22', 'mariange8282', 'aaron12', 'syedsaadahmed', 'kashifssiddiqui', 'a.s.falconer', 'ferdelarr', 'daveontw', 'rick9eller', 'catalina2709', 'carlos.e.puerto.s', 'pipe9404', 'mild.piyawan.1', 'sola', 'am.alarcon346', 'ketbrandon', 'shikhor.himadri', 'ds.restrepo10', 'poosuda.phetban', 'cristianjavier.cifuentessilva', 'kanwaalnaz', 'zhewu43', 'mw', 'theacessalman', 'benbburn', 'ifrah_jaffri', 'fabianm95', 'c.d.white18426', 'quratulainalikhan', 'caerrome', 'kipkemoi.rono.9', 'tarod13', None, 'jkung', 'akkaratch.sukserm', 'csiefer', 'imtiazhira', 'jd.martinez1062', 'mirzafaizan.baig.129', 'jsebas.1995', 'gferrusca019', 'c.gomez11', 'ferdousru1', 'getkay1214', 'perroski', 'hooman2461', 's.correa12']"
5,47,79,10,1,['mild.piyawan.1'],77,"['josh.epstein.79', 'apop2', 'tjfonn', 'bonecrusher', 'ifrahashraf', 'nmerstorf', 'kevinsantiago1', 'wahaba', 'rbrosius', 'superpes', 'cajrgato', 'susanne.pfeifer85', 'sm4343if', 'jm.rodriguez11', 'deejaystander', 'ra.cordoba10', 'julian.david.00300', 'li_imperial', 'mattnohava', 'cnhoang', 'sbowcock', 'suchiya', 'ayeshahassan92', 'hsterry22', 'mac_1701_117', 'lf.burbano10', 'carolina.duque.sierra', 'jezl9559', 'yuitan87', 'engrhafizirfan450yahoo.com', 'guptasukriti1', 'alejobb94', 'juliantrilli', 'chriskumm', 'jcorrea', 'kh', 'navidp', 'anumbasheer22', 'mariange8282', 'aaron12', 'syedsaadahmed', 'kashifssiddiqui', 'ferdelarr', 'daveontw', 'rick9eller', 'catalina2709', 'carlos.e.puerto.s', 'pipe9404', 'am.alarcon346', 'shikhor.himadri', 'ds.restrepo10', 'poosuda.phetban', 'cristianjavier.cifuentessilva', 'kanwaalnaz', 'zhewu43', 'mw', 'theacessalman', 'benbburn', 'ifrah_jaffri', 'fabianm95', 'quratulainalikhan', 'caerrome', 'tarod13', 'jkung', 'akkaratch.sukserm', 'csiefer', 'imtiazhira', 'jd.martinez1062', 'mirzafaizan.baig.129', 'jsebas.1995', 'gferrusca019', 'c.gomez11', 'ferdousru1', 'getkay1214', 'perroski', 'hooman2461', 's.correa12']",9,"['aanuck.loveup', 'wertyerfire', 'pbwedding', 'palmtree', 'far2love', 'afrose', 'winadda', None, 'kanoknans']",87,"['josh.epstein.79', 'apop2', 'pbwedding', 'tjfonn', 'bonecrusher', 'ifrahashraf', 'nmerstorf', 'kevinsantiago1', 'wahaba', 'rbrosius', 'superpes', 'cajrgato', 'susanne.pfeifer85', 'sm4343if', 'jm.rodriguez11', 'palmtree', 'deejaystander', 'ra.cordoba10', 'julian.david.00300', 'kanoknans', 'li_imperial', 'mattnohava', 'cnhoang', 'sbowcock', 'far2love', 'suchiya', 'ayeshahassan92', 'hsterry22', 'mac_1701_117', 'lf.burbano10', 'carolina.duque.sierra', 'jezl9559', 'yuitan87', 'engrhafizirfan450yahoo.com', 'guptasukriti1', 'alejobb94', 'juliantrilli', 'chriskumm', 'jcorrea', 'kh', 'navidp', 'anumbasheer22', 'mariange8282', 'aaron12', 'syedsaadahmed', 'kashifssiddiqui', 'ferdelarr', 'afrose', 'daveontw', 'rick9eller', 'catalina2709', 'aanuck.loveup', 'carlos.e.puerto.s', 'pipe9404', 'mild.piyawan.1', 'wertyerfire', 'am.alarcon346', 'shikhor.himadri', 'ds.restrepo10', 'poosuda.phetban', 'cristianjavier.cifuentessilva', 'kanwaalnaz', 'zhewu43', 'mw', 'theacessalman', 'benbburn', 'ifrah_jaffri', 'fabianm95', 'quratulainalikhan', 'caerrome', 'winadda', 'tarod13', None, 'jkung', 'akkaratch.sukserm', 'csiefer', 'imtiazhira', 'jd.martinez1062', 'mirzafaizan.baig.129', 'jsebas.1995', 'gferrusca019', 'c.gomez11', 'ferdousru1', 'getkay1214', 'perroski', 'hooman2461', 's.correa12']"
5,52,79,9,5,"['mattnohava', 'gferrusca019', 'sm4343if', 'chriskumm', 'mac_1701_117']",73,"['josh.epstein.79', 'apop2', 'tjfonn', 'bonecrusher', 'ifrahashraf', 'nmerstorf', 'kevinsantiago1', 'wahaba', 'rbrosius', 'superpes', 'cajrgato', 'susanne.pfeifer85', 'jm.rodriguez11', 'deejaystander', 'ra.cordoba10', 'julian.david.00300', 'li_imperial', 'cnhoang', 'sbowcock', 'suchiya', 'ayeshahassan92', 'hsterry22', 'lf.burbano10', 'carolina.duque.sierra', 'jezl9559', 'yuitan87', 'engrhafizirfan450yahoo.com', 'guptasukriti1', 'alejobb94', 'juliantrilli', 'jcorrea', 'kh', 'navidp', 'anumbasheer22', 'mariange8282', 'aaron12', 'syedsaadahmed', 'kashifssiddiqui', 'ferdelarr', 'daveontw', 'rick9eller', 'catalina2709', 'carlos.e.puerto.s', 'pipe9404', 'mild.piyawan.1', 'am.alarcon346', 'shikhor.himadri', 'ds.restrepo10', 'poosuda.phetban', 'cristianjavier.cifuentessilva', 'kanwaalnaz', 'zhewu43', 'mw', 'theacessalman', 'benbburn', 'ifrah_jaffri', 'fabianm95', 'quratulainalikhan', 'caerrome', 'tarod13', 'jkung', 'akkaratch.sukserm', 'csiefer', 'imtiazhira', 'jd.martinez1062', 'mirzafaizan.baig.129', 'jsebas.1995', 'c.gomez11', 'ferdousru1', 'getkay1214', 'perroski', 'hooman2461', 's.correa12']",4,"['emilyfellerer', 'gilliam', None, 'curtsmith']",82,"['josh.epstein.79', 'apop2', 'tjfonn', 'bonecrusher', 'ifrahashraf', 'nmerstorf', 'kevinsantiago1', 'wahaba', 'rbrosius', 'superpes', 'cajrgato', 'susanne.pfeifer85', 'sm4343if', 'jm.rodriguez11', 'deejaystander', 'ra.cordoba10', 'julian.david.00300', 'li_imperial', 'mattnohava', 'cnhoang', 'sbowcock', 'suchiya', 'ayeshahassan92', 'hsterry22', 'mac_1701_117', 'lf.burbano10', 'emilyfellerer', 'carolina.duque.sierra', 'jezl9559', 'yuitan87', 'engrhafizirfan450yahoo.com', 'guptasukriti1', 'alejobb94', 'juliantrilli', 'chriskumm', 'jcorrea', 'kh', 'navidp', 'anumbasheer22', 'mariange8282', 'aaron12', 'syedsaadahmed', 'kashifssiddiqui', 'ferdelarr', 'daveontw', 'rick9eller', 'catalina2709', 'carlos.e.puerto.s', 'pipe9404', 'mild.piyawan.1', 'am.alarcon346', 'shikhor.himadri', 'ds.restrepo10', 'poosuda.phetban', 'cristianjavier.cifuentessilva', 'kanwaalnaz', 'zhewu43', 'curtsmith', 'mw', 'theacessalman', 'benbburn', 'ifrah_jaffri', 'fabianm95', 'gilliam', 'quratulainalikhan', 'caerrome', 'tarod13', None, 'jkung', 'akkaratch.sukserm', 'csiefer', 'imtiazhira', 'jd.martinez1062', 'mirzafaizan.baig.129', 'jsebas.1995', 'gferrusca019', 'c.gomez11', 'ferdousru1', 'getkay1214', 'perroski', 'hooman2461', 's.correa12']"
5,50,79,7,1,['rbrosius'],77,"['josh.epstein.79', 'apop2', 'tjfonn', 'bonecrusher', 'ifrahashraf', 'nmerstorf', 'kevinsantiago1', 'wahaba', 'superpes', 'cajrgato', 'susanne.pfeifer85', 'sm4343if', 'jm.rodriguez11', 'deejaystander', 'ra.cordoba10', 'julian.david.00300', 'li_imperial', 'mattnohava', 'cnhoang', 'sbowcock', 'suchiya', 'ayeshahassan92', 'hsterry22', 'mac_1701_117', 'lf.burbano10', 'carolina.duque.sierra', 'jezl9559', 'yuitan87', 'engrhafizirfan450yahoo.com', 'guptasukriti1', 'alejobb94', 'juliantrilli', 'chriskumm', 'jcorrea', 'kh', 'navidp', 'anumbasheer22', 'mariange8282', 'aaron12', 'syedsaadahmed', 'kashifssiddiqui', 'ferdelarr', 'daveontw', 'rick9eller', 'catalina2709', 'carlos.e.puerto.s', 'pipe9404', 'mild.piyawan.1', 'am.alarcon346', 'shikhor.himadri', 'ds.restrepo10', 'poosuda.phetban', 'cristianjavier.cifuentessilva', 'kanwaalnaz', 'zhewu43', 'mw', 'theacessalman', 'benbburn', 'ifrah_jaffri', 'fabianm95', 'quratulainalikhan', 'caerrome', 'tarod13', 'jkung', 'akkaratch.sukserm', 'csiefer', 'imtiazhira', 'jd.martinez1062', 'mirzafaizan.baig.129', 'jsebas.1995', 'gferrusca019', 'c.gomez11', 'ferdousru1', 'getkay1214', 'perroski', 'hooman2461', 's.correa12']",6,"['nmaududi', 'zhipeng', 'steve6707', 'haoshulu', None, 'jalon_sisson']",84,"['josh.epstein.79', 'apop2', 'tjfonn', 'bonecrusher', 'ifrahashraf', 'nmerstorf', 'kevinsantiago1', 'wahaba', 'rbrosius', 'superpes', 'cajrgato', 'susanne.pfeifer85', 'sm4343if', 'jm.rodriguez11', 'deejaystander', 'ra.cordoba10', 'julian.david.00300', 'li_imperial', 'mattnohava', 'cnhoang', 'sbowcock', 'suchiya', 'ayeshahassan92', 'hsterry22', 'mac_1701_117', 'lf.burbano10', 'carolina.duque.sierra', 'jezl9559', 'yuitan87', 'engrhafizirfan450yahoo.com', 'guptasukriti1', 'alejobb94', 'haoshulu', 'juliantrilli', 'chriskumm', 'jcorrea', 'kh', 'navidp', 'anumbasheer22', 'mariange8282', 'aaron12', 'syedsaadahmed', 'kashifssiddiqui', 'ferdelarr', 'daveontw', 'rick9eller', 'jalon_sisson', 'catalina2709', 'carlos.e.puerto.s', 'pipe9404', 'mild.piyawan.1', 'am.alarcon346', 'shikhor.himadri', 'steve6707', 'ds.restrepo10', 'poosuda.phetban', 'cristianjavier.cifuentessilva', 'kanwaalnaz', 'zhewu43', 'mw', 'theacessalman', 'benbburn', 'ifrah_jaffri', 'fabianm95', 'quratulainalikhan', 'caerrome', 'tarod13', None, 'jkung', 'akkaratch.sukserm', 'csiefer', 'imtiazhira', 'jd.martinez1062', 'nmaududi', 'mirzafaizan.baig.129', 'jsebas.1995', 'zhipeng', 'gferrusca019', 'c.gomez11', 'ferdousru1', 'getkay1214', 'perroski', 'hooman2461', 's.correa12']"
5,55,79,6,2,"['daveontw', 'perroski']",76,"['josh.epstein.79', 'apop2', 'tjfonn', 'bonecrusher', 'ifrahashraf', 'nmerstorf', 'kevinsantiago1', 'wahaba', 'rbrosius', 'superpes', 'cajrgato', 'susanne.pfeifer85', 'sm4343if', 'jm.rodriguez11', 'deejaystander', 'ra.cordoba10', 'julian.david.00300', 'li_imperial', 'mattnohava', 'cnhoang', 'sbowcock', 'suchiya', 'ayeshahassan92', 'hsterry22', 'mac_1701_117', 'lf.burbano10', 'carolina.duque.sierra', 'jezl9559', 'yuitan87', 'engrhafizirfan450yahoo.com', 'guptasukriti1', 'alejobb94', 'juliantrilli', 'chriskumm', 'jcorrea', 'kh', 'navidp', 'anumbasheer22', 'mariange8282', 'aaron12', 'syedsaadahmed', 'kashifssiddiqui', 'ferdelarr', 'rick9eller', 'catalina2709', 'carlos.e.puerto.s', 'pipe9404', 'mild.piyawan.1', 'am.alarcon346', 'shikhor.himadri', 'ds.restrepo10', 'poosuda.phetban', 'cristianjavier.cifuentessilva', 'kanwaalnaz', 'zhewu43', 'mw', 'theacessalman', 'benbburn', 'ifrah_jaffri', 'fabianm95', 'quratulainalikhan', 'caerrome', 'tarod13', 'jkung', 'akkaratch.sukserm', 'csiefer', 'imtiazhira', 'jd.martinez1062', 'mirzafaizan.baig.129', 'jsebas.1995', 'gferrusca019', 'c.gomez11', 'ferdousru1', 'getkay1214', 'hooman2461', 's.correa12']",4,"['catherine_rodriguez', None, 'dcjorge10', 'ruedagato4t0']",82,"['josh.epstein.79', 'apop2', 'tjfonn', 'bonecrusher', 'ifrahashraf', 'nmerstorf', 'kevinsantiago1', 'wahaba', 'rbrosius', 'superpes', 'cajrgato', 'susanne.pfeifer85', 'sm4343if', 'jm.rodriguez11', 'deejaystander', 'ra.cordoba10', 'julian.david.00300', 'li_imperial', 'mattnohava', 'cnhoang', 'sbowcock', 'suchiya', 'ayeshahassan92', 'hsterry22', 'mac_1701_117', 'lf.burbano10', 'carolina.duque.sierra', 'jezl9559', 'yuitan87', 'engrhafizirfan450yahoo.com', 'guptasukriti1', 'alejobb94', 'juliantrilli', 'chriskumm', 'jcorrea', 'dcjorge10', 'kh', 'navidp', 'anumbasheer22', 'mariange8282', 'aaron12', 'syedsaadahmed', 'kashifssiddiqui', 'ferdelarr', 'daveontw', 'rick9eller', 'catalina2709', 'carlos.e.puerto.s', 'pipe9404', 'mild.piyawan.1', 'am.alarcon346', 'shikhor.himadri', 'ds.restrepo10', 'poosuda.phetban', 'cristianjavier.cifuentessilva', 'catherine_rodriguez', 'kanwaalnaz', 'zhewu43', 'mw', 'theacessalman', 'benbburn', 'ifrah_jaffri', 'fabianm95', 'quratulainalikhan', 'caerrome', 'tarod13', None, 'jkung', 'akkaratch.sukserm', 'csiefer', 'imtiazhira', 'jd.martinez1062', 'mirzafaizan.baig.129', 'ruedagato4t0', 'jsebas.1995', 'gferrusca019', 'c.gomez11', 'ferdousru1', 'getkay1214', 'perroski', 'hooman2461', 's.correa12']"
6,233,63,36,33,"['edna.sanchezve', 'spyridoula_koumousi', 'simonepagliano', 'mariogreece', 'valliappan09', 'joelchevrier', 'jacobronu', 'ninocaiz', 'surianom', 'kesuxgigio', 'frachicco', 'deferrfa', 'decontil', 'fwalther', 'diommede', 'olivan', 'thibautguimard', 'vire.eric', 'vincent.torquet', 'edocecca23', 'alessandro.enrico', 'enrico1990', 'pkyiitdelhi', 'andrea.richaud', 'eugene.marianathan', 'giorgiogiop', 'koerckec', 'ele_testa', '14sa79', 'elisacco91', 'davidegt4', 'andrearuffino31', 'robin_1']",29,"['rosalia.moreddu', 'rvardimon', 'feixin9804', 'rosalia', 'bordain1', 'sianano', 'nesrine.chaabani9', 'jialinshi', 'ronennandm', 'mdiazmoreno', 'dgyablo', 'raman', 'chaussep', 'amalia.spataru', 'turkanbayrak', 'lilh0303', 'ahmad.mbs', 'omrigo5', 'nurulhuda', 'usovv', 'quyong', 'antlab', 'sidney684', 'vnahid54', 'volrath85', 'reifenberger', 'druso', 'ran.tivony', 'bondonk']",3,"['angelica2802', None, 'cacciotti92']",65,"['rvardimon', 'rosalia', 'cacciotti92', 'sianano', 'nesrine.chaabani9', 'ronennandm', 'dgyablo', 'ninocaiz', 'surianom', 'chaussep', 'deferrfa', 'frachicco', 'decontil', 'lilh0303', 'diommede', 'olivan', 'enrico1990', 'alessandro.enrico', 'sidney684', 'pkyiitdelhi', 'andrea.richaud', 'koerckec', 'volrath85', 'reifenberger', 'ele_testa', '14sa79', 'druso', 'davidegt4', 'andrearuffino31', 'robin_1', 'bondonk', 'rosalia.moreddu', 'feixin9804', 'edna.sanchezve', 'bordain1', 'spyridoula_koumousi', 'simonepagliano', 'mariogreece', 'valliappan09', 'joelchevrier', 'jialinshi', 'mdiazmoreno', 'jacobronu', 'raman', 'amalia.spataru', 'kesuxgigio', 'turkanbayrak', 'fwalther', 'ahmad.mbs', 'thibautguimard', 'vire.eric', 'vincent.torquet', 'omrigo5', 'edocecca23', 'nurulhuda', 'usovv', 'quyong', 'antlab', 'angelica2802', 'vnahid54', None, 'eugene.marianathan', 'giorgiogiop', 'elisacco91', 'ran.tivony']"
6,231,63,34,33,"['edna.sanchezve', 'rosalia', 'spyridoula_koumousi', 'simonepagliano', 'mariogreece', 'valliappan09', 'nesrine.chaabani9', 'jacobronu', 'ninocaiz', 'surianom', 'amalia.spataru', 'kesuxgigio', 'frachicco', 'deferrfa', 'decontil', 'fwalther', 'olivan', 'thibautguimard', 'vire.eric', 'vincent.torquet', 'edocecca23', 'alessandro.enrico', 'enrico1990', 'pkyiitdelhi', 'andrea.richaud', 'eugene.marianathan', 'giorgiogiop', 'koerckec', '14sa79', 'elisacco91', 'davidegt4', 'andrearuffino31', 'robin_1']",29,"['rosalia.moreddu', 'rvardimon', 'feixin9804', 'bordain1', 'joelchevrier', 'sianano', 'jialinshi', 'ronennandm', 'mdiazmoreno', 'dgyablo', 'raman', 'chaussep', 'turkanbayrak', 'lilh0303', 'ahmad.mbs', 'diommede', 'omrigo5', 'nurulhuda', 'usovv', 'quyong', 'antlab', 'sidney684', 'vnahid54', 'volrath85', 'reifenberger', 'ele_testa', 'druso', 'ran.tivony', 'bondonk']",1,[None],63,"['rvardimon', 'rosalia', 'sianano', 'nesrine.chaabani9', 'ronennandm', 'dgyablo', 'ninocaiz', 'surianom', 'chaussep', 'deferrfa', 'frachicco', 'decontil', 'lilh0303', 'diommede', 'olivan', 'enrico1990', 'alessandro.enrico', 'sidney684', 'pkyiitdelhi', 'andrea.richaud', 'koerckec', 'volrath85', 'reifenberger', 'ele_testa', '14sa79', 'druso', 'davidegt4', 'andrearuffino31', 'robin_1', 'bondonk', 'rosalia.moreddu', 'feixin9804', 'edna.sanchezve', 'bordain1', 'spyridoula_koumousi', 'simonepagliano', 'mariogreece', 'valliappan09', 'joelchevrier', 'jialinshi', 'mdiazmoreno', 'jacobronu', 'raman', 'amalia.spataru', 'kesuxgigio', 'turkanbayrak', 'fwalther', 'ahmad.mbs', 'thibautguimard', 'vire.eric', 'vincent.torquet', 'omrigo5', 'edocecca23', 'nurulhuda', 'usovv', 'quyong', 'antlab', 'vnahid54', None, 'eugene.marianathan', 'giorgiogiop', 'elisacco91', 'ran.tivony']"
6,232,63,20,19,"['edna.sanchezve', 'jacobronu', 'ninocaiz', 'chaussep', 'kesuxgigio', 'frachicco', 'diommede', 'olivan', 'thibautguimard', 'vire.eric', 'vincent.torquet', 'enrico1990', 'koerckec', 'giorgiogiop', 'ele_testa', 'elisacco91', 'davidegt4', 'andrearuffino31', 'robin_1']",43,"['rosalia.moreddu', 'rvardimon', 'feixin9804', 'rosalia', 'bordain1', 'spyridoula_koumousi', 'simonepagliano', 'mariogreece', 'valliappan09', 'joelchevrier', 'sianano', 'nesrine.chaabani9', 'jialinshi', 'ronennandm', 'mdiazmoreno', 'dgyablo', 'raman', 'surianom', 'amalia.spataru', 'deferrfa', 'turkanbayrak', 'decontil', 'lilh0303', 'ahmad.mbs', 'fwalther', 'edocecca23', 'omrigo5', 'nurulhuda', 'usovv', 'alessandro.enrico', 'quyong', 'antlab', 'sidney684', 'pkyiitdelhi', 'andrea.richaud', 'vnahid54', 'eugene.marianathan', 'volrath85', 'reifenberger', '14sa79', 'druso', 'ran.tivony', 'bondonk']",1,[None],63,"['rvardimon', 'rosalia', 'sianano', 'nesrine.chaabani9', 'ronennandm', 'dgyablo', 'ninocaiz', 'surianom', 'chaussep', 'deferrfa', 'frachicco', 'decontil', 'lilh0303', 'diommede', 'olivan', 'enrico1990', 'alessandro.enrico', 'sidney684', 'pkyiitdelhi', 'andrea.richaud', 'koerckec', 'volrath85', 'reifenberger', 'ele_testa', '14sa79', 'druso', 'davidegt4', 'andrearuffino31', 'robin_1', 'bondonk', 'rosalia.moreddu', 'feixin9804', 'edna.sanchezve', 'bordain1', 'spyridoula_koumousi', 'simonepagliano', 'mariogreece', 'valliappan09', 'joelchevrier', 'jialinshi', 'mdiazmoreno', 'jacobronu', 'raman', 'amalia.spataru', 'kesuxgigio', 'turkanbayrak', 'fwalther', 'ahmad.mbs', 'thibautguimard', 'vire.eric', 'vincent.torquet', 'omrigo5', 'edocecca23', 'nurulhuda', 'usovv', 'quyong', 'antlab', 'vnahid54', None, 'eugene.marianathan', 'giorgiogiop', 'elisacco91', 'ran.tivony']"
7,228,52,49,43,"['kerice', 'whfuss', 'ajohnson8617', 'mgmosche', 'jpsimmo2', 'mbmcmurr', 'gasingac', 'jmpilato', 'leander3', 'abondar', 'pwwessle', 'rammsteiner42', 'ijowsian', 'arfranc3', 'nnswyger', 'nkvonwin', 'bhallen', 'jswilkin', 'jclunara', 'ptwethin', 'jmgriff5', 'klfreem2', 'brianhaidet', 'pdgannet', 'tsbuchan', 'asporcel', 'byrowley', 'caharkin', 'latashan3', 'wawitzen', 'brent.morrison.1993', 'hackettman', 'bciezzi', 'raberezi', 'retrometer94', 'amygoodling', 'rwmattin', 'eholmes93.secondary', 'pmpoyman', 'gpscisco', 'jnbaker2', 'pjburger', 'ucawuruo']",8,"['aiurdane', 'linda_spremulli', 'will_abarca', 'silviagarciam', 'himmat_46', 'mmrandol', 'cnjacks4', 'james.lumbers']",6,"['klarleon', 'taconfre', 'mtrossignol', 'bljenio', None, 'aaalsale']",57,"['kerice', 'linda_spremulli', 'bljenio', 'leander3', 'arfranc3', 'nnswyger', 'himmat_46', 'jswilkin', 'aaalsale', 'brianhaidet', 'tsbuchan', 'byrowley', 'raberezi', 'klarleon', 'silviagarciam', 'retrometer94', 'james.lumbers', 'amygoodling', 'rwmattin', 'eholmes93.secondary', 'pjburger', 'ucawuruo', 'whfuss', 'mmrandol', 'ajohnson8617', 'mgmosche', 'mbmcmurr', 'jpsimmo2', 'gasingac', 'jmpilato', 'abondar', 'pwwessle', 'ijowsian', 'nkvonwin', 'taconfre', 'bhallen', 'jclunara', 'jmgriff5', 'klfreem2', 'pdgannet', 'asporcel', 'caharkin', 'latashan3', 'wawitzen', None, 'hackettman', 'brent.morrison.1993', 'bciezzi', 'aiurdane', 'will_abarca', 'cnjacks4', 'mtrossignol', 'rammsteiner42', 'pmpoyman', 'gpscisco', 'jnbaker2', 'ptwethin']"
7,227,52,12,9,"['aiurdane', 'cnjacks4', 'whfuss', 'mmrandol', 'mgmosche', 'amygoodling', 'hackettman', 'jnbaker2', 'jmpilato']",42,"['kerice', 'linda_spremulli', 'ajohnson8617', 'eholmes93.secondary', 'jpsimmo2', 'mbmcmurr', 'gasingac', 'leander3', 'abondar', 'pwwessle', 'ijowsian', 'arfranc3', 'nnswyger', 'nkvonwin', 'himmat_46', 'bhallen', 'jswilkin', 'jclunara', 'ptwethin', 'jmgriff5', 'klfreem2', 'brianhaidet', 'pdgannet', 'tsbuchan', 'asporcel', 'byrowley', 'caharkin', 'latashan3', 'wawitzen', 'brent.morrison.1993', 'raberezi', 'bciezzi', 'will_abarca', 'silviagarciam', 'retrometer94', 'james.lumbers', 'rwmattin', 'rammsteiner42', 'pmpoyman', 'gpscisco', 'pjburger', 'ucawuruo']",3,"[None, 'ceriers2', 'kmbeal']",54,"['kerice', 'linda_spremulli', 'ceriers2', 'whfuss', 'mmrandol', 'ajohnson8617', 'mgmosche', 'mbmcmurr', 'jpsimmo2', 'gasingac', 'jmpilato', 'leander3', 'abondar', 'pwwessle', 'rammsteiner42', 'ijowsian', 'arfranc3', 'nnswyger', 'nkvonwin', 'himmat_46', 'bhallen', 'jswilkin', 'jclunara', 'jmgriff5', 'klfreem2', 'ucawuruo', 'brianhaidet', 'pdgannet', 'tsbuchan', 'asporcel', 'byrowley', 'caharkin', 'latashan3', 'wawitzen', None, 'hackettman', 'brent.morrison.1993', 'raberezi', 'bciezzi', 'aiurdane', 'will_abarca', 'silviagarciam', 'retrometer94', 'cnjacks4', 'james.lumbers', 'amygoodling', 'kmbeal', 'rwmattin', 'eholmes93.secondary', 'pmpoyman', 'gpscisco', 'jnbaker2', 'pjburger', 'ptwethin']"
7,229,52,8,7,"['kerice', 'abondar', 'bciezzi', 'wawitzen', 'mbmcmurr', 'brent.morrison.1993', 'ptwethin']",44,"['linda_spremulli', 'whfuss', 'mmrandol', 'ajohnson8617', 'mgmosche', 'jpsimmo2', 'gasingac', 'jmpilato', 'leander3', 'pwwessle', 'rammsteiner42', 'ijowsian', 'arfranc3', 'nnswyger', 'nkvonwin', 'himmat_46', 'bhallen', 'jswilkin', 'jclunara', 'jmgriff5', 'klfreem2', 'ucawuruo', 'brianhaidet', 'pdgannet', 'tsbuchan', 'asporcel', 'byrowley', 'caharkin', 'latashan3', 'hackettman', 'raberezi', 'aiurdane', 'will_abarca', 'silviagarciam', 'retrometer94', 'cnjacks4', 'james.lumbers', 'amygoodling', 'rwmattin', 'eholmes93.secondary', 'pmpoyman', 'gpscisco', 'jnbaker2', 'pjburger']",1,[None],52,"['kerice', 'linda_spremulli', 'whfuss', 'mmrandol', 'ajohnson8617', 'mgmosche', 'mbmcmurr', 'jpsimmo2', 'gasingac', 'jmpilato', 'leander3', 'abondar', 'pwwessle', 'rammsteiner42', 'ijowsian', 'arfranc3', 'nnswyger', 'nkvonwin', 'himmat_46', 'bhallen', 'jswilkin', 'jclunara', 'jmgriff5', 'klfreem2', 'ucawuruo', 'brianhaidet', 'pdgannet', 'tsbuchan', 'asporcel', 'byrowley', 'caharkin', 'latashan3', 'wawitzen', None, 'hackettman', 'brent.morrison.1993', 'raberezi', 'bciezzi', 'aiurdane', 'will_abarca', 'silviagarciam', 'retrometer94', 'cnjacks4', 'james.lumbers', 'amygoodling', 'rwmattin', 'eholmes93.secondary', 'pmpoyman', 'gpscisco', 'jnbaker2', 'pjburger', 'ptwethin']"
8,35,39,236,36,"['kburke', 'selinaarceo2017', 'cjwethers', 'ozero', 'natalie555', 'xkirkham1', 'carlpieri2017', 'rachel.lin.96592', 'andrew_cramer2017', 'dfloyd367', 'hak656', 'vaishali.mehta.925', 'kaylabrooks', 'achandran12', 'samilton840', 'ericanderson2017', 'saskianaegele26', 'samuelkahn2017', 'annikahansen2017', 'shandon6', 'thenewflamel', 'thratsh', 'benjaminjones2017', 'lillie', 'joefobi2017', 'jschartz90', 'm.forrest', 'tefisbando', 'stephanyvalladares11', 'mhz636', 'scottgoldberg2017', 'ahw087', 'mattgates1995', 'christopherpierce2017', 'creamnsugar', 'foulkes2']",2,"['cgcri_fopd', 'subir.majumder.23']",200,"['n6n8u3', 'sgorlick', 'jameswillis2017', 'juanmena2017', 'robertzhu2017', 'hopkins2', 'nward', 'lchen', 'gesta', 'alila', 'lafern', 'emilymorris2017', 'bbl076', 'jbs916', 'krembisz', 'sshull', 'bishtonn', 'annapetersen21', 'bdougherty', 'gmc830', 'imasamba', 'bbecerra', 'nasher', 'mmihalache', 'vmehta', 'jschaefer', 'jburkechem122', 'isi.sturla', 'sdaniel', 'mattsherman95', 'abfilicko05', 'nuchem102', 'ajsnu', 'rmehta95', 'annaduban2017', 'smezyk7', 'gallardoy09', 'cfleesmith', 'obabatola', 'sarajohns2017', 'wmckinney', 'uditapersaud', 'gcohen', 'cmucharraz', 'myi', 'nicholas.mccombe.3', 'rweidinger', 'kkim27', 'tla95', 'rodriguez.ricardo13', 'broconnell', 'amyers17', 'melikimmy', 'alw231', 'coravasserman2017', 'swert', 'mpostoll4', 'jsammon', 'marinamin2017', 'lra391', 'ajennings', 'lindseymehl2017', 'jwaltstadt', 'lisa.kim.961993', 'bspielman', 'kathrynpillischafske2017', 'msobhani', 'jesus.leon1', 'ydeng', 'dperlovsky', 'kimhoff', 'christycal17', 'ljung', 'jkk284', 'mfluellen', 'jalonbrown', 'aostenso', 'sauditore', 'mgullott', 'miriam.perez.35574', 'bfeinstein', 'ssbanic', 'bkraft383', 'vilte', 'igau', 'eam093', 'cweers', 'mdoody359', 'vrutherford', 'kschuster', 'j3nnif3r37', 'pcastro', 'jtucker', 'rsarette', 'ggillow', 'benedict.dungca', 'nn3210', 'mmcmullan', 'sem742', 'emathews', 'jruan', 'shwang', 'estebanmercado2017', 'geapen', 'jvegaperkins713', 'lsleung', 'jdk681', 'yokim', 'mhopfner', 'santana', 'hpervaiz', 'aparikh22', 'rst345', 'ellenpatterson2017', 'asears', 'catherineding', 'gcamozzi', 'annapreston2017', 'kgong', 'njandali', 'crobinson19', 'sobel.shawn', 'bananapiehl', 'agrenen', 'isaacheine', 'rachelrogers', 'ahofmeister', 'minjooson', 'aamattey', 'nwh027', 'wizu', 'ndivine', 'ijackylei', 'rboodram', 'annahinrichs', 'clacrosse', 'anewell', 'yuehu9510', 'joshauck', 'rsherman', 'kdaftary', 'afisher', 'marsak', 'phaun', 'mkelsten', 'jmarquez95', 'ecripe', 'ddapuzzo', 'jgw599', 'cfox', 'tstoimenoff', 'ecbold13', 'pgrewal', 'alzipursky', 'peter.g.vlahakis', 'tomliggett', 'juliakovalenko2017', 'ccj009', 'jdrews', 'zfenske', 'jvillanueva8', 'hannahbrady2017', 'wjhager2016', 'camilleblackman2016', 'kcm010', 'phawkyard', 'hrucinski', 'annedeb', 'james.amick94', 'afarsheed', 'evanbeuningen', 'hwhite', 'jki699', 'zwatson', 'meganpurdy', 'glak', 'vlh774', 'aveerina', 'cconnelly', 'shorstman', 'rschaaf', 'stam', 'omarosorio2017', 'krichards', 'kristensmith2017', 'plim', 'mclark032', 'nnwagbo', 'jmccartney', 'wlindstrom', 'laurenabruzzo2017', None, 'bchen', 'pklimkow', 'marknelson2012', 'kqu', 'hlou88', 'bbair', 'mcoden', 'mstotzy1']",238,"['sgorlick', 'jameswillis2017', 'robertzhu2017', 'gesta', 'alila', 'cjwethers', 'lafern', 'emilymorris2017', 'bbl076', 'krembisz', 'bishtonn', 'annapetersen21', 'gmc830', 'imasamba', 'nasher', 'vmehta', 'isi.sturla', 'sdaniel', 'abfilicko05', 'nuchem102', 'ajsnu', 'lillie', 'jschartz90', 'cfleesmith', 'gcohen', 'myi', 'kkim27', 'tla95', 'rodriguez.ricardo13', 'broconnell', 'selinaarceo2017', 'jsammon', 'natalie555', 'lra391', 'ajennings', 'rachel.lin.96592', 'hak656', 'kathrynpillischafske2017', 'ydeng', 'dperlovsky', 'kimhoff', 'jalonbrown', 'jkk284', 'sauditore', 'mgullott', 'miriam.perez.35574', 'bfeinstein', 'igau', 'mdoody359', 'j3nnif3r37', 'stephanyvalladares11', 'rsarette', 'benedict.dungca', 'sem742', 'emathews', 'shwang', 'geapen', 'jvegaperkins713', 'lsleung', 'yokim', 'dfloyd367', 'annapreston2017', 'kgong', 'bananapiehl', 'isaacheine', 'thenewflamel', 'ahofmeister', 'minjooson', 'ndivine', 'ijackylei', 'm.forrest', 'rboodram', 'annahinrichs', 'tefisbando', 'clacrosse', 'anewell', 'joshauck', 'rsherman', 'kdaftary', 'afisher', 'marsak', 'mkelsten', 'ecripe', 'jgw599', 'tstoimenoff', 'ecbold13', 'pgrewal', 'peter.g.vlahakis', 'tomliggett', 'zfenske', 'jvillanueva8', 'camilleblackman2016', 'hrucinski', 'carlpieri2017', 'kcm010', 'phawkyard', 'andrew_cramer2017', 'afarsheed', 'hwhite', 'jki699', 'achandran12', 'vlh774', 'cconnelly', 'shorstman', 'ericanderson2017', 'shandon6', 'omarosorio2017', 'mclark032', 'jmccartney', 'wlindstrom', 'laurenabruzzo2017', None, 'mhz636', 'bchen', 'pklimkow', 'marknelson2012', 'scottgoldberg2017', 'hlou88', 'creamnsugar', 'n6n8u3', 'juanmena2017', 'hopkins2', 'nward', 'lchen', 'kburke', 'jbs916', 'sshull', 'bdougherty', 'bbecerra', 'mmihalache', 'jschaefer', 'jburkechem122', 'mattsherman95', 'subir.majumder.23', 'benjaminjones2017', 'rmehta95', 'joefobi2017', 'annaduban2017', 'smezyk7', 'gallardoy09', 'obabatola', 'sarajohns2017', 'wmckinney', 'uditapersaud', 'cmucharraz', 'nicholas.mccombe.3', 'rweidinger', 'foulkes2', 'amyers17', 'melikimmy', 'alw231', 'coravasserman2017', 'swert', 'mpostoll4', 'ozero', 'marinamin2017', 'xkirkham1', 'lindseymehl2017', 'jwaltstadt', 'lisa.kim.961993', 'bspielman', 'msobhani', 'jesus.leon1', 'christycal17', 'ljung', 'samilton840', 'saskianaegele26', 'mfluellen', 'aostenso', 'samuelkahn2017', 'annikahansen2017', 'thratsh', 'ssbanic', 'bkraft383', 'vilte', 'eam093', 'cweers', 'vrutherford', 'kschuster', 'pcastro', 'jtucker', 'ggillow', 'ahw087', 'mattgates1995', 'nn3210', 'mmcmullan', 'christopherpierce2017', 'jruan', 'estebanmercado2017', 'jdk681', 'mhopfner', 'santana', 'hpervaiz', 'aparikh22', 'asears', 'rst345', 'ellenpatterson2017', 'catherineding', 'gcamozzi', 'njandali', 'crobinson19', 'sobel.shawn', 'agrenen', 'rachelrogers', 'aamattey', 'nwh027', 'wizu', 'yuehu9510', 'phaun', 'jmarquez95', 'ddapuzzo', 'cfox', 'alzipursky', 'juliakovalenko2017', 'ccj009', 'jdrews', 'hannahbrady2017', 'wjhager2016', 'annedeb', 'james.amick94', 'evanbeuningen', 'zwatson', 'vaishali.mehta.925', 'kaylabrooks', 'meganpurdy', 'glak', 'aveerina', 'cgcri_fopd', 'rschaaf', 'stam', 'krichards', 'kristensmith2017', 'plim', 'nnwagbo', 'kqu', 'bbair', 'mcoden', 'mstotzy1']"
9,39,39,26,20,"['myloginname', 'bohmbac2', 'kyhan2', 'connor.ekelund', 'brinkmanship', 'sabareesh.kumar', 'xak1101', 'xman', 'aspire.chan', 'aishsingh', 't14', 'marvadar', 'wstreyer', 'fengkaiyin2010', 'fajardo1', 'johnlu1', 'datye1', 'haukchung', 'tschop2', 'azure3t']",18,"['flavianoman', 'dinesh.bioinfo', 'salamatburjuev', 'art_nugraha', 'samir.s.damle', 'wasdfa', 'jyhuang09', 'gilsonj', 'nammeni2002', 'kim161', 'ronniej6987', 'abeltra', 'lanzin', 'jimmyfontana27', 'duk9786', 'grewal2', 'arsenalfirer', 'julrod123']",6,"['arpraka2', 'bholybee', 'daosyn', 'surya2', 'mdreis2', None]",44,"['bohmbac2', 'myloginname', 'arpraka2', 'salamatburjuev', 'daosyn', 'kyhan2', 'connor.ekelund', 'brinkmanship', 'samir.s.damle', 'sabareesh.kumar', 'abeltra', 'arsenalfirer', 'xak1101', 'art_nugraha', 'xman', 'wasdfa', 'jyhuang09', 'gilsonj', 'nammeni2002', 'kim161', 'surya2', 'mdreis2', 'lanzin', 'aspire.chan', 'grewal2', 'aishsingh', 't14', 'marvadar', 'jimmyfontana27', 'wstreyer', 'duk9786', 'ronniej6987', 'fengkaiyin2010', 'dinesh.bioinfo', 'fajardo1', 'flavianoman', 'johnlu1', 'datye1', None, 'haukchung', 'bholybee', 'tschop2', 'azure3t', 'julrod123']"
9,40,39,10,2,"['samir.s.damle', 'jyhuang09']",36,"['bohmbac2', 'myloginname', 'salamatburjuev', 'kyhan2', 'connor.ekelund', 'brinkmanship', 'sabareesh.kumar', 'abeltra', 'arsenalfirer', 'xak1101', 'art_nugraha', 'xman', 'wasdfa', 'gilsonj', 'nammeni2002', 'kim161', 'lanzin', 'aspire.chan', 'grewal2', 'aishsingh', 't14', 'marvadar', 'azure3t', 'wstreyer', 'duk9786', 'ronniej6987', 'fengkaiyin2010', 'dinesh.bioinfo', 'fajardo1', 'flavianoman', 'johnlu1', 'datye1', 'haukchung', 'tschop2', 'jimmyfontana27', 'julrod123']",8,"['yaoguanwen', 'woerns', 'liuhang', 'wassupyo412', 'yao14', 'spencerward', 'lujiang', None]",46,"['bohmbac2', 'myloginname', 'salamatburjuev', 'kyhan2', 'connor.ekelund', 'brinkmanship', 'woerns', 'wassupyo412', 'samir.s.damle', 'sabareesh.kumar', 'lujiang', 'abeltra', 'arsenalfirer', 'xak1101', 'art_nugraha', 'yaoguanwen', 'liuhang', 'xman', 'wasdfa', 'jyhuang09', 'gilsonj', 'nammeni2002', 'kim161', 'lanzin', 'aspire.chan', 'grewal2', 'aishsingh', 't14', 'marvadar', 'jimmyfontana27', 'wstreyer', 'spencerward', 'duk9786', 'ronniej6987', 'fengkaiyin2010', 'dinesh.bioinfo', 'fajardo1', 'flavianoman', 'johnlu1', 'datye1', None, 'haukchung', 'tschop2', 'yao14', 'azure3t', 'julrod123']"
10,164,39,38,6,"['rody.osama', 'mahmoudabdelmoniem', 'ahmed.shedid.12', 'ahazem254', 'omar.amin.750', 'mosab94']",32,"['sweiheng', 'kimonas', 'bellmanz', 'jasjitsinghsidhu', 'cjpeter5', 'pmj', 'loda1', 'rodrigo_103', 'pvergili', 'zhichaoy', 'ibram.hossam', 'z800201002005', 'bauer.u', 'katayoun.zahmatkesh', 'aldridgr', 'diegodelvalle', 'arash83', 'sarahlion', 'aranya', 'chris.chen.kista', 'shadi1993', 'mostafahelal93', 'princevarun', 'freemonsandlewould', 'taimur.rabuske', 'saralaji006', 'ckakizaw', 'kemalparlar', 'shrijeet64', 'andrewalbert00', 'sebadeli', 'nikoo5']",32,"['moeffat', 'engabdallah1', 'nahlahamed', 'amgad.ahmed', 'marinamedhat', 'sherif.ghozzy', 'mohamed123456', 'raghda.mohammad.5', 'ranaahmed', 'menaesam', 'muhammed333', 'ahmed.asfour.1466', 'shadi31', 'ahmedflamenco', 'sorial.samy.7', 'maramsalah', 'ahmedreda', 'omargamalhafez21', 'marco.adel.37', 'islam.js24', 'sherinemohamed', 'mostafa.radwan', 'ramiahmedhussien', 'tantoon.soryal', 'rana.a.ghoneim', 'mark_nader', 'adelrashad', None, 'rami.abulfadl', 'karimwissa', 'heshamehab', 'ahmedmedhat10']",70,"['sweiheng', 'moeffat', 'kimonas', 'engabdallah1', 'nahlahamed', 'cjpeter5', 'jasjitsinghsidhu', 'bellmanz', 'amgad.ahmed', 'pmj', 'marinamedhat', 'rody.osama', 'mahmoudabdelmoniem', 'sherif.ghozzy', 'mohamed123456', 'loda1', 'rodrigo_103', 'raghda.mohammad.5', 'omar.amin.750', 'pvergili', 'zhichaoy', 'ibram.hossam', 'menaesam', 'z800201002005', 'ranaahmed', 'muhammed333', 'ahmed.asfour.1466', 'bauer.u', 'shadi31', 'ahmedflamenco', 'sorial.samy.7', 'maramsalah', 'katayoun.zahmatkesh', 'ahmedreda', 'omargamalhafez21', 'nikoo5', 'aldridgr', 'marco.adel.37', 'arash83', 'islam.js24', 'sarahlion', 'mosab94', 'aranya', 'sherinemohamed', 'mostafa.radwan', 'ramiahmedhussien', 'chris.chen.kista', 'shadi1993', 'mostafahelal93', 'tantoon.soryal', 'rana.a.ghoneim', 'princevarun', 'ahazem254', 'mark_nader', 'freemonsandlewould', 'adelrashad', None, 'rami.abulfadl', 'ahmed.shedid.12', 'taimur.rabuske', 'saralaji006', 'karimwissa', 'heshamehab', 'ckakizaw', 'kemalparlar', 'shrijeet64', 'ahmedmedhat10', 'andrewalbert00', 'sebadeli', 'diegodelvalle']"
10,15,39,23,8,"['rody.osama', 'mahmoudabdelmoniem', 'mosab94', 'ahmed.shedid.12', 'ahazem254', 'andrewalbert00', 'omar.amin.750', 'sarahlion']",30,"['sweiheng', 'kimonas', 'bellmanz', 'jasjitsinghsidhu', 'cjpeter5', 'pmj', 'loda1', 'rodrigo_103', 'pvergili', 'zhichaoy', 'ibram.hossam', 'z800201002005', 'bauer.u', 'katayoun.zahmatkesh', 'aldridgr', 'diegodelvalle', 'arash83', 'aranya', 'chris.chen.kista', 'shadi1993', 'mostafahelal93', 'princevarun', 'freemonsandlewould', 'taimur.rabuske', 'saralaji006', 'ckakizaw', 'kemalparlar', 'shrijeet64', 'sebadeli', 'nikoo5']",15,"['abelrahmanmohamed', 'aboelamras', 'samdozer', 'doaa', 'amgad_swedan', 'ahmed_mohamed_abdelalim', 'nadamohamedmahrous', 'sarakhalaf', 'mohamedhesham', 'nadine.elwessimy', 'kesmatshahin', 'mahmoud.ehab1', 'vina.salah', None, 'lol.ask92']",53,"['sweiheng', 'kimonas', 'cjpeter5', 'jasjitsinghsidhu', 'bellmanz', 'mohamedhesham', 'pmj', 'rody.osama', 'mahmoudabdelmoniem', 'kesmatshahin', 'mahmoud.ehab1', 'loda1', 'rodrigo_103', 'omar.amin.750', 'pvergili', 'zhichaoy', 'ibram.hossam', 'abelrahmanmohamed', 'z800201002005', 'aboelamras', 'bauer.u', 'katayoun.zahmatkesh', 'nadine.elwessimy', 'nikoo5', 'aldridgr', 'arash83', 'sarahlion', 'mosab94', 'aranya', 'lol.ask92', 'samdozer', 'chris.chen.kista', 'amgad_swedan', 'nadamohamedmahrous', 'sarakhalaf', 'shadi1993', 'mostafahelal93', 'princevarun', 'ahazem254', 'freemonsandlewould', 'vina.salah', 'ahmed_mohamed_abdelalim', None, 'ahmed.shedid.12', 'taimur.rabuske', 'saralaji006', 'doaa', 'ckakizaw', 'kemalparlar', 'shrijeet64', 'andrewalbert00', 'sebadeli', 'diegodelvalle']"
10,159,39,14,1,['aldridgr'],37,"['sweiheng', 'kimonas', 'bellmanz', 'jasjitsinghsidhu', 'cjpeter5', 'pmj', 'rody.osama', 'mahmoudabdelmoniem', 'loda1', 'rodrigo_103', 'pvergili', 'omar.amin.750', 'zhichaoy', 'ibram.hossam', 'z800201002005', 'bauer.u', 'katayoun.zahmatkesh', 'diegodelvalle', 'arash83', 'sarahlion', 'mosab94', 'aranya', 'chris.chen.kista', 'shadi1993', 'mostafahelal93', 'princevarun', 'ahazem254', 'freemonsandlewould', 'ahmed.shedid.12', 'taimur.rabuske', 'saralaji006', 'ckakizaw', 'kemalparlar', 'shrijeet64', 'andrewalbert00', 'sebadeli', 'nikoo5']",13,"['jiaolh', 'yyson2000', 'browthom', 'captainjkirk', 'guikemch', 'nguyetim', 'lafavorj', 'boevemac', 'sosnowsn', 'wpkish', 'mnyboer', None, 'ryanhiggins']",51,"['sweiheng', 'jiaolh', 'kimonas', 'cjpeter5', 'jasjitsinghsidhu', 'bellmanz', 'browthom', 'guikemch', 'pmj', 'nguyetim', 'rody.osama', 'mahmoudabdelmoniem', 'loda1', 'rodrigo_103', 'mnyboer', 'omar.amin.750', 'pvergili', 'zhichaoy', 'ibram.hossam', 'z800201002005', 'bauer.u', 'captainjkirk', 'katayoun.zahmatkesh', 'nikoo5', 'boevemac', 'aldridgr', 'wpkish', 'ryanhiggins', 'arash83', 'sarahlion', 'mosab94', 'aranya', 'yyson2000', 'chris.chen.kista', 'shadi1993', 'mostafahelal93', 'lafavorj', 'princevarun', 'ahazem254', 'freemonsandlewould', 'sosnowsn', None, 'ahmed.shedid.12', 'taimur.rabuske', 'saralaji006', 'ckakizaw', 'kemalparlar', 'shrijeet64', 'andrewalbert00', 'sebadeli', 'diegodelvalle']"
10,165,39,10,1,['kemalparlar'],37,"['sweiheng', 'kimonas', 'bellmanz', 'jasjitsinghsidhu', 'cjpeter5', 'pmj', 'rody.osama', 'mahmoudabdelmoniem', 'loda1', 'rodrigo_103', 'pvergili', 'omar.amin.750', 'zhichaoy', 'ibram.hossam', 'z800201002005', 'bauer.u', 'katayoun.zahmatkesh', 'aldridgr', 'diegodelvalle', 'arash83', 'sarahlion', 'mosab94', 'aranya', 'chris.chen.kista', 'shadi1993', 'mostafahelal93', 'princevarun', 'ahazem254', 'freemonsandlewould', 'ahmed.shedid.12', 'taimur.rabuske', 'saralaji006', 'ckakizaw', 'shrijeet64', 'andrewalbert00', 'sebadeli', 'nikoo5']",9,"['pacific1912', 'rkmeels', 'jamakihe', 'jarobins139', 'tiarlopez', 'epatten', 'vividwinter', None, 'maik23d']",47,"['sweiheng', 'kimonas', 'cjpeter5', 'jasjitsinghsidhu', 'bellmanz', 'pmj', 'rody.osama', 'mahmoudabdelmoniem', 'maik23d', 'loda1', 'rodrigo_103', 'omar.amin.750', 'pvergili', 'zhichaoy', 'ibram.hossam', 'z800201002005', 'bauer.u', 'katayoun.zahmatkesh', 'nikoo5', 'tiarlopez', 'aldridgr', 'arash83', 'sarahlion', 'mosab94', 'aranya', 'chris.chen.kista', 'shadi1993', 'mostafahelal93', 'princevarun', 'ahazem254', 'vividwinter', 'freemonsandlewould', None, 'rkmeels', 'ahmed.shedid.12', 'taimur.rabuske', 'saralaji006', 'pacific1912', 'ckakizaw', 'jamakihe', 'kemalparlar', 'shrijeet64', 'jarobins139', 'epatten', 'andrewalbert00', 'sebadeli', 'diegodelvalle']"
10,13,39,9,4,"['katayoun.zahmatkesh', 'arash83', 'saralaji006', 'bellmanz']",34,"['sweiheng', 'kimonas', 'cjpeter5', 'jasjitsinghsidhu', 'pmj', 'rody.osama', 'mahmoudabdelmoniem', 'loda1', 'rodrigo_103', 'pvergili', 'omar.amin.750', 'zhichaoy', 'ibram.hossam', 'z800201002005', 'bauer.u', 'aldridgr', 'diegodelvalle', 'sarahlion', 'mosab94', 'aranya', 'chris.chen.kista', 'shadi1993', 'mostafahelal93', 'princevarun', 'ahazem254', 'freemonsandlewould', 'ahmed.shedid.12', 'taimur.rabuske', 'ckakizaw', 'kemalparlar', 'shrijeet64', 'andrewalbert00', 'sebadeli', 'nikoo5']",5,"['szymon.sollamidelekta', 'micarl', None, 'behnam0o', 'farazkhavari']",43,"['sweiheng', 'kimonas', 'cjpeter5', 'jasjitsinghsidhu', 'bellmanz', 'pmj', 'rody.osama', 'mahmoudabdelmoniem', 'loda1', 'rodrigo_103', 'omar.amin.750', 'pvergili', 'zhichaoy', 'ibram.hossam', 'farazkhavari', 'z800201002005', 'bauer.u', 'katayoun.zahmatkesh', 'nikoo5', 'aldridgr', 'arash83', 'behnam0o', 'sarahlion', 'mosab94', 'aranya', 'szymon.sollamidelekta', 'chris.chen.kista', 'shadi1993', 'mostafahelal93', 'princevarun', 'ahazem254', 'freemonsandlewould', None, 'ahmed.shedid.12', 'taimur.rabuske', 'saralaji006', 'micarl', 'ckakizaw', 'kemalparlar', 'shrijeet64', 'andrewalbert00', 'sebadeli', 'diegodelvalle']"
10,17,39,9,2,"['ckakizaw', 'loda1']",36,"['sweiheng', 'kimonas', 'bellmanz', 'jasjitsinghsidhu', 'cjpeter5', 'pmj', 'rody.osama', 'mahmoudabdelmoniem', 'rodrigo_103', 'pvergili', 'omar.amin.750', 'zhichaoy', 'ibram.hossam', 'z800201002005', 'bauer.u', 'katayoun.zahmatkesh', 'aldridgr', 'diegodelvalle', 'arash83', 'sarahlion', 'mosab94', 'aranya', 'chris.chen.kista', 'shadi1993', 'mostafahelal93', 'princevarun', 'ahazem254', 'freemonsandlewould', 'ahmed.shedid.12', 'taimur.rabuske', 'saralaji006', 'kemalparlar', 'shrijeet64', 'andrewalbert00', 'sebadeli', 'nikoo5']",7,"['sbowcock1', 'acipressi', 'vasileska', 'dustin.esman', 'nkjorgen', None, 'a9b1c3']",45,"['sweiheng', 'kimonas', 'cjpeter5', 'jasjitsinghsidhu', 'bellmanz', 'pmj', 'rody.osama', 'mahmoudabdelmoniem', 'loda1', 'rodrigo_103', 'omar.amin.750', 'pvergili', 'zhichaoy', 'ibram.hossam', 'sbowcock1', 'z800201002005', 'a9b1c3', 'bauer.u', 'vasileska', 'katayoun.zahmatkesh', 'nikoo5', 'aldridgr', 'arash83', 'sarahlion', 'mosab94', 'aranya', 'chris.chen.kista', 'shadi1993', 'mostafahelal93', 'princevarun', 'ahazem254', 'freemonsandlewould', None, 'ahmed.shedid.12', 'taimur.rabuske', 'saralaji006', 'acipressi', 'ckakizaw', 'kemalparlar', 'shrijeet64', 'dustin.esman', 'nkjorgen', 'andrewalbert00', 'sebadeli', 'diegodelvalle']"
10,18,39,9,4,"['nikoo5', 'rodrigo_103', 'sebadeli', 'diegodelvalle']",34,"['sweiheng', 'kimonas', 'bellmanz', 'jasjitsinghsidhu', 'cjpeter5', 'pmj', 'rody.osama', 'mahmoudabdelmoniem', 'loda1', 'pvergili', 'omar.amin.750', 'zhichaoy', 'ibram.hossam', 'z800201002005', 'bauer.u', 'katayoun.zahmatkesh', 'aldridgr', 'arash83', 'sarahlion', 'mosab94', 'aranya', 'chris.chen.kista', 'shadi1993', 'mostafahelal93', 'princevarun', 'ahazem254', 'freemonsandlewould', 'ahmed.shedid.12', 'taimur.rabuske', 'saralaji006', 'ckakizaw', 'kemalparlar', 'shrijeet64', 'andrewalbert00']",5,"['acordatedelmail', 'monteirotiago90', 'gasparrubio', 'ezeaudi', None]",43,"['sweiheng', 'kimonas', 'cjpeter5', 'jasjitsinghsidhu', 'bellmanz', 'pmj', 'rody.osama', 'mahmoudabdelmoniem', 'loda1', 'rodrigo_103', 'omar.amin.750', 'pvergili', 'zhichaoy', 'ibram.hossam', 'z800201002005', 'bauer.u', 'ezeaudi', 'katayoun.zahmatkesh', 'nikoo5', 'aldridgr', 'arash83', 'sarahlion', 'mosab94', 'aranya', 'chris.chen.kista', 'monteirotiago90', 'shadi1993', 'mostafahelal93', 'princevarun', 'ahazem254', 'freemonsandlewould', None, 'ahmed.shedid.12', 'taimur.rabuske', 'saralaji006', 'acordatedelmail', 'gasparrubio', 'ckakizaw', 'kemalparlar', 'shrijeet64', 'andrewalbert00', 'sebadeli', 'diegodelvalle']"
10,16,39,7,4,"['chris.chen.kista', 'katayoun.zahmatkesh', 'arash83', 'zhichaoy']",34,"['sweiheng', 'kimonas', 'cjpeter5', 'jasjitsinghsidhu', 'bellmanz', 'pmj', 'rody.osama', 'mahmoudabdelmoniem', 'loda1', 'rodrigo_103', 'omar.amin.750', 'pvergili', 'ibram.hossam', 'z800201002005', 'bauer.u', 'nikoo5', 'aldridgr', 'sarahlion', 'mosab94', 'aranya', 'shadi1993', 'mostafahelal93', 'princevarun', 'ahazem254', 'freemonsandlewould', 'ahmed.shedid.12', 'taimur.rabuske', 'saralaji006', 'ckakizaw', 'kemalparlar', 'shrijeet64', 'andrewalbert00', 'sebadeli', 'diegodelvalle']",3,"[None, 'behnam0o', 'farazkhavari']",41,"['sweiheng', 'kimonas', 'cjpeter5', 'jasjitsinghsidhu', 'bellmanz', 'pmj', 'rody.osama', 'mahmoudabdelmoniem', 'loda1', 'rodrigo_103', 'omar.amin.750', 'pvergili', 'zhichaoy', 'ibram.hossam', 'farazkhavari', 'z800201002005', 'bauer.u', 'katayoun.zahmatkesh', 'nikoo5', 'aldridgr', 'arash83', 'behnam0o', 'sarahlion', 'mosab94', 'aranya', 'chris.chen.kista', 'shadi1993', 'mostafahelal93', 'princevarun', 'ahazem254', 'freemonsandlewould', None, 'ahmed.shedid.12', 'taimur.rabuske', 'saralaji006', 'ckakizaw', 'kemalparlar', 'shrijeet64', 'andrewalbert00', 'sebadeli', 'diegodelvalle']"
11,92,37,39,36,"['colinstewart', 'pcdodge', 'ehlim90', 'dpennachio', 'robert.manriquez', 'rivkab.reitz', 'rreitz', 'wwwennie', 'cforman', 'mchabinyc', 'tbrownhe', 'mtruong', 'brandonjisaac', 'nathanogden', 'levmil', 'dhwang', 'reginea', 'marsh461', 'lamontal', 'malafata', 'emily.wonder', 'anne.tofte.1', 'asad856', 'eperry4', 'jbechtel91', 'cantbelikewater', 'jnorman', 'darkbotk', 'jg.goiri', 'nmlarson2', 'hiralt', 'silentscope', 'jonathandcook', 'ntalmirall', 'ndolinski', 'mjford']",0,[],3,"['masterbennett', 'trcristiani', None]",39,"['colinstewart', 'trcristiani', 'pcdodge', 'ehlim90', 'dpennachio', 'robert.manriquez', 'rivkab.reitz', 'rreitz', 'wwwennie', 'cforman', 'mchabinyc', 'tbrownhe', 'brandonjisaac', 'mtruong', 'nathanogden', 'levmil', 'dhwang', 'reginea', 'marsh461', 'lamontal', 'malafata', 'emily.wonder', 'anne.tofte.1', 'asad856', 'eperry4', 'jbechtel91', 'cantbelikewater', 'jnorman', None, 'darkbotk', 'masterbennett', 'jg.goiri', 'nmlarson2', 'hiralt', 'silentscope', 'jonathandcook', 'ntalmirall', 'ndolinski', 'mjford']"
12,141,35,37,30,"['kyhwan91', 's900817', 'usio91', 'genline', 'terry2009', 'shininyong', 'dnsrl1753', 'jwh0114', 'dlwnsgh714', 'byeongok112233', 'jennifergaramlee', 'fish34560', 'fgl1152', 'hhs5214', 'uniquedia2', 'kinghelp', 'chrismahjw', 'sdcc22', 'choijin90', 'seong216', 'ha.sangwoo', 'ksj4861', 'martinojs', 'gustlr881120', 'ehdgnsdlzpq', 'chdmnn', 'lngstar2013', 'minsung459', 'laskiy', 'lijyg10']",4,"['k1134', 'arya1n', 'hemendra_kala', 'damond']",7,"['gog40', 'qnfehf', 'hcha71', 'xotlr0213', 'kimsinho6890', None, 'bacchus2011']",41,"['usio91', 's900817', 'damond', 'kyhwan91', 'genline', 'kimsinho6890', 'k1134', 'terry2009', 'shininyong', 'jwh0114', 'dnsrl1753', 'dlwnsgh714', 'byeongok112233', 'hemendra_kala', 'jennifergaramlee', 'fish34560', 'fgl1152', 'hhs5214', 'uniquedia2', 'hcha71', 'kinghelp', 'chrismahjw', 'arya1n', 'sdcc22', 'choijin90', 'seong216', 'ha.sangwoo', 'ksj4861', 'bacchus2011', None, 'gog40', 'martinojs', 'gustlr881120', 'ehdgnsdlzpq', 'chdmnn', 'xotlr0213', 'lngstar2013', 'minsung459', 'laskiy', 'lijyg10', 'qnfehf']"
13,144,33,35,32,"['shrutthika', 'sandeepsamal', 'skotkar3', 'samantak.gangopadhyay', 'dmehta19', 'adityabarve90', 'lizhilun90', 'anandhavel91', 'nrbiberidis', 'lacey.yao', 'umangdeora', 'amrutha17', 'zybird', 'sdutta14', 'darshakdoshi', 'prabha101', 'acardwell0418', 'sw24449', 'xiheasas', 'sriharshapv', 'lyt0826', 'arijit.raychowdhury', 'dhivya.sankar', 'pallavihprasad', 'ksahil04', 'kdivekar3', 'nazimmomin', 'abhinavparihar', 'poojitha.p', 'vgatne3', 'sindhusethu16', 'souchi']",0,[],3,"['varsha3', None, 'snasir7']",35,"['shrutthika', 'sandeepsamal', 'skotkar3', 'samantak.gangopadhyay', 'dmehta19', 'adityabarve90', 'lizhilun90', 'anandhavel91', 'nrbiberidis', 'lacey.yao', 'umangdeora', 'amrutha17', 'zybird', 'varsha3', 'sdutta14', 'snasir7', 'darshakdoshi', 'prabha101', 'acardwell0418', 'sw24449', 'xiheasas', 'sriharshapv', 'lyt0826', 'arijit.raychowdhury', 'dhivya.sankar', 'pallavihprasad', None, 'ksahil04', 'kdivekar3', 'nazimmomin', 'abhinavparihar', 'poojitha.p', 'vgatne3', 'sindhusethu16', 'souchi']"
13,89,33,31,30,"['shrutthika', 'sandeepsamal', 'skotkar3', 'samantak.gangopadhyay', 'dmehta19', 'adityabarve90', 'lizhilun90', 'anandhavel91', 'nrbiberidis', 'umangdeora', 'amrutha17', 'zybird', 'sdutta14', 'darshakdoshi', 'prabha101', 'acardwell0418', 'sw24449', 'xiheasas', 'sriharshapv', 'arijit.raychowdhury', 'dhivya.sankar', 'pallavihprasad', 'ksahil04', 'abhinavparihar', 'nazimmomin', 'kdivekar3', 'poojitha.p', 'vgatne3', 'sindhusethu16', 'souchi']",2,"['lacey.yao', 'lyt0826']",1,[None],33,"['shrutthika', 'sandeepsamal', 'skotkar3', 'samantak.gangopadhyay', 'dmehta19', 'adityabarve90', 'lizhilun90', 'anandhavel91', 'nrbiberidis', 'lacey.yao', 'umangdeora', 'amrutha17', 'zybird', 'sdutta14', 'darshakdoshi', 'prabha101', 'acardwell0418', 'sw24449', 'xiheasas', 'sriharshapv', 'lyt0826', 'arijit.raychowdhury', 'dhivya.sankar', 'pallavihprasad', None, 'ksahil04', 'kdivekar3', 'nazimmomin', 'abhinavparihar', 'poojitha.p', 'vgatne3', 'sindhusethu16', 'souchi']"
14,74,32,31,28,"['dblomek', 'jterrel61', 'sun272', 'song218', 'port', 'bkads1163', 'chen1011', 'havins', 'tlambros', 'grawlins', 'jcompara', 'duvall0', 'lyeh', 'kint', 'jackie0212', 'dollarboy', 'wcostaki', 'ben.helfrecht', 'schumm', 'obrien70', 'rwilmes', 'pelaez204', 'liu991', 'kim1325', 'yang463', 'love20', 'sdeschai', 'cdymond']",3,"['quentinl', 'soltys', 'mroux']",3,"['abcazaz22', None, 'garrettwass']",34,"['dblomek', 'jterrel61', 'sun272', 'song218', 'soltys', 'port', 'bkads1163', 'chen1011', 'quentinl', 'havins', 'tlambros', 'grawlins', 'jcompara', 'duvall0', 'mroux', 'kint', 'jackie0212', 'lyeh', 'dollarboy', 'wcostaki', 'ben.helfrecht', 'abcazaz22', 'garrettwass', 'schumm', 'obrien70', 'rwilmes', 'pelaez204', 'liu991', 'kim1325', None, 'yang463', 'love20', 'sdeschai', 'cdymond']"
14,126,32,29,19,"['sun272', 'soltys', 'bkads1163', 'chen1011', 'quentinl', 'havins', 'tlambros', 'duvall0', 'lyeh', 'dollarboy', 'wcostaki', 'ben.helfrecht', 'obrien70', 'rwilmes', 'pelaez204', 'liu991', 'love20', 'sdeschai', 'cdymond']",12,"['yang463', 'dblomek', 'jterrel61', 'song218', 'grawlins', 'jcompara', 'mroux', 'kint', 'jackie0212', 'port', 'kim1325', 'schumm']",10,"['liquidxskull', 'pnoren', 'mrencheck', 'gscofiel', 'wang1640', 'rhein', 'ckwok144', 'abcazaz22', None, 'haojiex']",41,"['dblomek', 'jterrel61', 'mrencheck', 'sun272', 'song218', 'soltys', 'port', 'bkads1163', 'chen1011', 'quentinl', 'haojiex', 'havins', 'tlambros', 'grawlins', 'jcompara', 'rhein', 'duvall0', 'mroux', 'kint', 'jackie0212', 'lyeh', 'dollarboy', 'wcostaki', 'ben.helfrecht', 'abcazaz22', 'schumm', 'obrien70', 'rwilmes', 'pelaez204', 'wang1640', 'ckwok144', 'liu991', 'kim1325', None, 'yang463', 'liquidxskull', 'pnoren', 'gscofiel', 'love20', 'sdeschai', 'cdymond']"
14,129,32,26,24,"['dblomek', 'jterrel61', 'sun272', 'song218', 'port', 'bkads1163', 'havins', 'tlambros', 'grawlins', 'jcompara', 'duvall0', 'lyeh', 'jackie0212', 'dollarboy', 'wcostaki', 'ben.helfrecht', 'schumm', 'rwilmes', 'pelaez204', 'liu991', 'kim1325', 'yang463', 'sdeschai', 'cdymond']",7,"['obrien70', 'mroux', 'kint', 'love20', 'soltys', 'chen1011', 'quentinl']",2,"[None, 'garrettwass']",33,"['dblomek', 'jterrel61', 'sun272', 'song218', 'soltys', 'port', 'bkads1163', 'chen1011', 'quentinl', 'havins', 'tlambros', 'grawlins', 'jcompara', 'duvall0', 'mroux', 'kint', 'jackie0212', 'lyeh', 'dollarboy', 'wcostaki', 'ben.helfrecht', 'garrettwass', 'schumm', 'obrien70', 'rwilmes', 'pelaez204', 'liu991', 'kim1325', None, 'yang463', 'love20', 'sdeschai', 'cdymond']"
14,76,32,25,20,"['dblomek', 'jterrel61', 'sun272', 'port', 'chen1011', 'quentinl', 'havins', 'tlambros', 'grawlins', 'duvall0', 'mroux', 'jackie0212', 'wcostaki', 'ben.helfrecht', 'obrien70', 'liu991', 'kim1325', 'yang463', 'sdeschai', 'cdymond']",11,"['rwilmes', 'song218', 'jcompara', 'pelaez204', 'lyeh', 'kint', 'love20', 'dollarboy', 'soltys', 'bkads1163', 'schumm']",5,"['zeng31purdue', 'zhan1193', 'abcazaz22', None, 'haojiex']",36,"['dblomek', 'jterrel61', 'sun272', 'song218', 'soltys', 'port', 'bkads1163', 'chen1011', 'quentinl', 'haojiex', 'havins', 'tlambros', 'zeng31purdue', 'grawlins', 'jcompara', 'duvall0', 'mroux', 'kint', 'jackie0212', 'lyeh', 'dollarboy', 'wcostaki', 'ben.helfrecht', 'abcazaz22', 'schumm', 'obrien70', 'rwilmes', 'pelaez204', 'liu991', 'kim1325', None, 'yang463', 'zhan1193', 'love20', 'sdeschai', 'cdymond']"
14,128,32,19,15,"['yang463', 'rwilmes', 'dblomek', 'tlambros', 'sun272', 'grawlins', 'duvall0', 'kint', 'liu991', 'dollarboy', 'soltys', 'wcostaki', 'sdeschai', 'cdymond', 'quentinl']",16,"['obrien70', 'ben.helfrecht', 'kim1325', 'jterrel61', 'havins', 'song218', 'jcompara', 'pelaez204', 'mroux', 'jackie0212', 'lyeh', 'love20', 'port', 'bkads1163', 'chen1011', 'schumm']",4,"['gscofiel', 'derek.schwanz', None, 'ckwok144']",35,"['dblomek', 'jterrel61', 'sun272', 'song218', 'soltys', 'port', 'bkads1163', 'chen1011', 'quentinl', 'havins', 'tlambros', 'grawlins', 'jcompara', 'duvall0', 'mroux', 'kint', 'jackie0212', 'lyeh', 'dollarboy', 'wcostaki', 'ben.helfrecht', 'schumm', 'obrien70', 'rwilmes', 'pelaez204', 'ckwok144', 'liu991', 'derek.schwanz', 'kim1325', None, 'yang463', 'gscofiel', 'love20', 'sdeschai', 'cdymond']"
14,127,32,18,15,"['rwilmes', 'jterrel61', 'havins', 'sun272', 'song218', 'pelaez204', 'tlambros', 'duvall0', 'port', 'dollarboy', 'wcostaki', 'ben.helfrecht', 'cdymond', 'chen1011', 'quentinl']",16,"['obrien70', 'yang463', 'kim1325', 'dblomek', 'jcompara', 'grawlins', 'mroux', 'kint', 'jackie0212', 'lyeh', 'liu991', 'love20', 'soltys', 'sdeschai', 'bkads1163', 'schumm']",3,"[None, 'pnoren', 'ckwok144']",34,"['dblomek', 'jterrel61', 'sun272', 'song218', 'soltys', 'port', 'bkads1163', 'chen1011', 'quentinl', 'havins', 'tlambros', 'grawlins', 'jcompara', 'duvall0', 'mroux', 'kint', 'jackie0212', 'lyeh', 'dollarboy', 'wcostaki', 'ben.helfrecht', 'schumm', 'obrien70', 'rwilmes', 'pelaez204', 'ckwok144', 'liu991', 'kim1325', None, 'yang463', 'pnoren', 'love20', 'sdeschai', 'cdymond']"
15,56,31,21,19,"['lustera', 'chantar2', 'sahmad13', 'polariz90', 'robs94', 'brearto2', 'carolgu', 'alibhujwala', 'dantexdsc', 'crhee6', 'glaciation', 'zhuge2', 'xuhaobi2', 'benbenben', 'timj261', 'duke8253', 'dryzhak2', 'tnam5', 'whuang12']",11,"['hadwig', 'gshen2', 'jake.belica', 'wwang53', 'khanti', 'jerry_9500', 'hieubui92', 'jeroble2', 'kaspar.jenni', 'sfortuna', 'nmorelli4592']",2,"['boatmee', None]",32,"['hadwig', 'lustera', 'chantar2', 'sahmad13', 'polariz90', 'jeroble2', 'robs94', 'nmorelli4592', 'brearto2', 'gshen2', 'jake.belica', 'jerry_9500', 'hieubui92', 'carolgu', 'kaspar.jenni', 'alibhujwala', 'dantexdsc', 'wwang53', 'khanti', 'crhee6', 'glaciation', 'zhuge2', 'xuhaobi2', None, 'benbenben', 'timj261', 'boatmee', 'duke8253', 'sfortuna', 'dryzhak2', 'tnam5', 'whuang12']"
16,84,30,33,27,"['jason410724', 'rrr00ngc', 'hjfxmu', 'jpculebro', 'driley13', 'arushiarora15', 'tania2', 'bhrugu', 'czlee', 'bcivey', 'wesleychang1463', 'ashwin29', 'shang.colleen', 'adolfredo', 'kcxchen', 'jlopez12', 'thericem', 'ieva', 'dwalls', 'bhuffman', 'flyingpiggy', 'thellstern89', 'xjduan', 'jerrygiese', 'mathmaniac314', 'apalmstr', 'anguyen7']",2,"['djzorn', 'rthowe']",6,"['bergsdav', 'ashwin2990', 'iskenderk', 'yiklun.lee', 'vincent.sparacio', None]",35,"['jason410724', 'rrr00ngc', 'ashwin2990', 'hjfxmu', 'jpculebro', 'driley13', 'yiklun.lee', 'arushiarora15', 'tania2', 'vincent.sparacio', 'bhrugu', 'bergsdav', 'czlee', 'bcivey', 'rthowe', 'wesleychang1463', 'ashwin29', 'iskenderk', 'shang.colleen', 'adolfredo', 'kcxchen', 'jlopez12', 'thericem', 'ieva', 'dwalls', 'bhuffman', 'flyingpiggy', 'thellstern89', 'xjduan', 'jerrygiese', None, 'mathmaniac314', 'apalmstr', 'djzorn', 'anguyen7']"
16,148,30,29,25,"['jason410724', 'rrr00ngc', 'hjfxmu', 'jpculebro', 'driley13', 'arushiarora15', 'tania2', 'bhrugu', 'czlee', 'bcivey', 'wesleychang1463', 'ashwin29', 'shang.colleen', 'adolfredo', 'kcxchen', 'thericem', 'ieva', 'dwalls', 'bhuffman', 'flyingpiggy', 'thellstern89', 'xjduan', 'jerrygiese', 'mathmaniac314', 'anguyen7']",4,"['jlopez12', 'djzorn', 'apalmstr', 'rthowe']",4,"['bergsdav', None, 'yiklun.lee', 'iskenderk']",33,"['jason410724', 'rrr00ngc', 'hjfxmu', 'jpculebro', 'driley13', 'yiklun.lee', 'arushiarora15', 'tania2', 'bhrugu', 'bergsdav', 'czlee', 'bcivey', 'rthowe', 'wesleychang1463', 'ashwin29', 'iskenderk', 'shang.colleen', 'adolfredo', 'kcxchen', 'jlopez12', 'thericem', 'ieva', 'dwalls', 'bhuffman', 'flyingpiggy', 'thellstern89', 'xjduan', 'jerrygiese', None, 'mathmaniac314', 'apalmstr', 'djzorn', 'anguyen7']"
16,149,30,26,23,"['jason410724', 'rrr00ngc', 'jpculebro', 'arushiarora15', 'tania2', 'bhrugu', 'czlee', 'wesleychang1463', 'ashwin29', 'shang.colleen', 'adolfredo', 'jlopez12', 'thericem', 'ieva', 'dwalls', 'bhuffman', 'flyingpiggy', 'thellstern89', 'xjduan', 'jerrygiese', 'mathmaniac314', 'apalmstr', 'anguyen7']",6,"['bcivey', 'rthowe', 'hjfxmu', 'djzorn', 'driley13', 'kcxchen']",3,"['yiklun.lee', None, 'dford129']",32,"['jason410724', 'rrr00ngc', 'hjfxmu', 'jpculebro', 'driley13', 'yiklun.lee', 'arushiarora15', 'tania2', 'bhrugu', 'czlee', 'bcivey', 'rthowe', 'wesleychang1463', 'ashwin29', 'shang.colleen', 'dford129', 'adolfredo', 'kcxchen', 'jlopez12', 'thericem', 'ieva', 'dwalls', 'bhuffman', 'flyingpiggy', 'thellstern89', 'xjduan', 'jerrygiese', None, 'mathmaniac314', 'apalmstr', 'djzorn', 'anguyen7']"
17,141,26,37,3,"['qnfehf', 'xotlr0213', 'bacchus2011']",22,"['rspencer', 'josetheto', 'dannelle', 'ajmirab', 'albert.i.perry', 'brh5103', 'dirkjake', 'jhood01', 'ieluna', 'merdman', 'lepluart', 'ndawson1', 'dsaucier', 'clayunm', 'elewis04', 'tbusby1', 'sinedu', 'jenkinsa', 'jmccab11', 'biggestworld', 'mariella', 'kmcd312']",34,"['usio91', 's900817', 'kyhwan91', 'kimsinho6890', 'genline', 'terry2009', 'shininyong', 'jwh0114', 'dnsrl1753', 'dlwnsgh714', 'byeongok112233', 'jennifergaramlee', 'fish34560', 'fgl1152', 'hhs5214', 'uniquedia2', 'hcha71', 'kinghelp', 'chrismahjw', 'sdcc22', 'ksj4861', 'ha.sangwoo', 'choijin90', 'seong216', None, 'gog40', 'gustlr881120', 'martinojs', 'ehdgnsdlzpq', 'chdmnn', 'lngstar2013', 'laskiy', 'minsung459', 'lijyg10']",59,"['rspencer', 'kyhwan91', 's900817', 'josetheto', 'usio91', 'kimsinho6890', 'genline', 'dannelle', 'ajmirab', 'terry2009', 'shininyong', 'dnsrl1753', 'jwh0114', 'albert.i.perry', 'dlwnsgh714', 'byeongok112233', 'brh5103', 'dirkjake', 'jhood01', 'ieluna', 'merdman', 'jennifergaramlee', 'fish34560', 'fgl1152', 'lepluart', 'ndawson1', 'dsaucier', 'hhs5214', 'clayunm', 'uniquedia2', 'hcha71', 'elewis04', 'kinghelp', 'tbusby1', 'chrismahjw', 'jenkinsa', 'sinedu', 'sdcc22', 'ksj4861', 'ha.sangwoo', 'bacchus2011', 'choijin90', 'seong216', None, 'gog40', 'gustlr881120', 'martinojs', 'ehdgnsdlzpq', 'chdmnn', 'xotlr0213', 'jmccab11', 'lngstar2013', 'biggestworld', 'laskiy', 'minsung459', 'mariella', 'lijyg10', 'kmcd312', 'qnfehf']"
17,174,26,25,18,"['albert.i.perry', 'rspencer', 'ndawson1', 'dsaucier', 'lepluart', 'sinedu', 'jmccab11', 'brh5103', 'josetheto', 'elewis04', 'jenkinsa', 'biggestworld', 'dirkjake', 'dannelle', 'jhood01', 'ajmirab', 'merdman', 'mariella']",7,"['qnfehf', 'clayunm', 'xotlr0213', 'tbusby1', 'ieluna', 'kmcd312', 'bacchus2011']",7,"['tnakotte', 'crriley', 'esalsber', 'kmego1', 'ccarrillo', 'basstee', None]",32,"['rspencer', 'crriley', 'josetheto', 'kmego1', 'basstee', 'dannelle', 'ajmirab', 'albert.i.perry', 'brh5103', 'dirkjake', 'jhood01', 'ieluna', 'merdman', 'tnakotte', 'lepluart', 'ndawson1', 'dsaucier', 'clayunm', 'esalsber', 'elewis04', 'tbusby1', 'jenkinsa', 'sinedu', None, 'bacchus2011', 'xotlr0213', 'jmccab11', 'biggestworld', 'ccarrillo', 'mariella', 'kmcd312', 'qnfehf']"
17,142,26,17,15,"['albert.i.perry', 'lepluart', 'ndawson1', 'rspencer', 'dsaucier', 'ajmirab', 'brh5103', 'josetheto', 'biggestworld', 'jenkinsa', 'dirkjake', 'dannelle', 'ieluna', 'jhood01', 'sinedu']",10,"['qnfehf', 'clayunm', 'xotlr0213', 'jmccab11', 'elewis04', 'tbusby1', 'mariella', 'merdman', 'kmcd312', 'bacchus2011']",2,"['basstee', None]",27,"['rspencer', 'josetheto', 'basstee', 'dannelle', 'ajmirab', 'albert.i.perry', 'brh5103', 'dirkjake', 'jhood01', 'ieluna', 'merdman', 'lepluart', 'ndawson1', 'dsaucier', 'clayunm', 'elewis04', 'tbusby1', 'jenkinsa', 'sinedu', None, 'bacchus2011', 'xotlr0213', 'jmccab11', 'biggestworld', 'mariella', 'kmcd312', 'qnfehf']"
17,181,26,11,5,"['rspencer', 'dsaucier', 'josetheto', 'ajmirab', 'merdman']",20,"['dannelle', 'albert.i.perry', 'brh5103', 'dirkjake', 'jhood01', 'ieluna', 'lepluart', 'ndawson1', 'clayunm', 'elewis04', 'tbusby1', 'sinedu', 'jenkinsa', 'bacchus2011', 'xotlr0213', 'jmccab11', 'biggestworld', 'mariella', 'kmcd312', 'qnfehf']",6,"['crriley', 'esalsber', 'kmego1', 'ccarrillo', 'basstee', None]",31,"['rspencer', 'lepluart', 'ndawson1', 'dsaucier', 'crriley', 'clayunm', 'esalsber', 'elewis04', 'josetheto', 'tbusby1', 'mariella', 'basstee', 'kmego1', 'dannelle', 'ajmirab', 'jenkinsa', 'sinedu', None, 'bacchus2011', 'albert.i.perry', 'xotlr0213', 'jmccab11', 'brh5103', 'biggestworld', 'ccarrillo', 'dirkjake', 'jhood01', 'ieluna', 'merdman', 'kmcd312', 'qnfehf']"
18,78,25,71,13,"['michael.goodlow', 'ejander2', 'adams52', 'gvelard2', 'jdallesasse', 'sehui04', 'jiyuxiao2010', 'beholla2', 'dlee210', 'pmarian2', 'tommyfedrigon', 'rohanbambery', 'garrettnducharme']",11,"['klee137', 'mlatime2', 'bobby.gr99', 'riley.oconnor', 'csyu32', 'jmjhnsn2', 'ejclark', 'menglv', 'alextillema', 'sgweiss816', 'mrr.shhl']",58,"['viperacr', 'broadhurst.josh', 'daosyn', 'gplauck', 'aagrawa4', 'chris.12', 'vanillayyy', 'sing619', 'supermarth64', 'nicolls1', 'roychow2', 'yousaf_salam', 'gvelard2edu', 'nopshusang', 'chentan08', 'danzuo', 'tyler.mey', 'nsparik2', 'olivercai', 'fujinam2', 'tiagovla', 'ganshun', 'ashimiz2', 'kunyilin9211', 'dereckluo', 'alex.t.zhu', 'dekunukem', 'kjabon2', 'ajeong3', 'bcc4994', 'zhiyang2', 'wywang2', 'darwinwalters', 'reagan1', 'jeppydude', 'chumakabaghe', 'manu.shallow', 'stupib', None, 'arjun.balwally', 'psahgal', 'leinber2', 'james.younce92', 'jofu803', 'whyshouldimakeanaccountseriously', 'wesley.zhang.92', 'weizeor2', 'baur728', 'jiranun2', 'bree.peng', 'bojjave2', 'vanshk', 'bkesler', 'dliang8', 'yue.li.10441', 'dudes', 'ngoswam2', 'yong.b.lee.73']",82,"['viperacr', 'broadhurst.josh', 'chris.12', 'menglv', 'nicolls1', 'yousaf_salam', 'gvelard2', 'sehui04', 'chentan08', 'danzuo', 'tyler.mey', 'nsparik2', 'olivercai', 'alextillema', 'dereckluo', 'alex.t.zhu', 'dekunukem', 'kjabon2', 'riley.oconnor', 'wywang2', 'jmjhnsn2', 'beholla2', 'chumakabaghe', 'stupib', 'arjun.balwally', 'tommyfedrigon', 'james.younce92', 'klee137', 'weizeor2', 'baur728', 'jiranun2', 'bree.peng', 'bkesler', 'yue.li.10441', 'dudes', 'ngoswam2', 'rohanbambery', 'vanillayyy', 'daosyn', 'bobby.gr99', 'gplauck', 'aagrawa4', 'sing619', 'sgweiss816', 'supermarth64', 'roychow2', 'jiyuxiao2010', 'michael.goodlow', 'garrettnducharme', 'adams52', 'mlatime2', 'jdallesasse', 'gvelard2edu', 'nopshusang', 'csyu32', 'fujinam2', 'tiagovla', 'pmarian2', 'ejclark', 'ganshun', 'mrr.shhl', 'ashimiz2', 'kunyilin9211', 'ejander2', 'ajeong3', 'bcc4994', 'zhiyang2', 'darwinwalters', 'reagan1', 'dlee210', 'manu.shallow', 'jeppydude', None, 'psahgal', 'leinber2', 'jofu803', 'whyshouldimakeanaccountseriously', 'wesley.zhang.92', 'bojjave2', 'vanshk', 'dliang8', 'yong.b.lee.73']"
18,80,25,8,6,"['sgweiss816', 'riley.oconnor', 'bobby.gr99', 'csyu32', 'menglv', 'alextillema']",18,"['michael.goodlow', 'ejander2', 'klee137', 'gvelard2', 'mlatime2', 'adams52', 'jdallesasse', 'rohanbambery', 'sehui04', 'jmjhnsn2', 'jiyuxiao2010', 'beholla2', 'dlee210', 'pmarian2', 'ejclark', 'tommyfedrigon', 'mrr.shhl', 'garrettnducharme']",2,"[None, 'spnelson']",26,"['ejander2', 'bobby.gr99', 'riley.oconnor', 'rohanbambery', 'jmjhnsn2', 'beholla2', 'menglv', 'dlee210', 'sgweiss816', None, 'jiyuxiao2010', 'michael.goodlow', 'garrettnducharme', 'tommyfedrigon', 'klee137', 'gvelard2', 'mlatime2', 'adams52', 'jdallesasse', 'sehui04', 'csyu32', 'ejclark', 'spnelson', 'pmarian2', 'alextillema', 'mrr.shhl']"
19,67,25,15,14,"['shinshijie', 'rromanbatista', 'orvyan', 'wcmohr', 'dbrommer', 'csanker', 'durug', 'fsbuaben', 'phil_yu', 'buehler', 'rafael84', 'mehdiamiri', 'adwinter', 'bdepalle']",10,"['dhs007', 'mirzaeifar', 'sehieber', 'fmartinm', 'abdullahka', 'boyat.allie', 'ashahall1978', 'mroenbeck1', 'kkwanyang', 'chinchun1912ar85']",1,[None],25,"['rromanbatista', 'orvyan', 'kkwanyang', 'shinshijie', 'dhs007', 'mirzaeifar', 'mroenbeck1', 'adwinter', 'bdepalle', 'chinchun1912ar85', 'sehieber', 'dbrommer', 'fsbuaben', 'phil_yu', 'rafael84', 'mehdiamiri', 'wcmohr', None, 'fmartinm', 'csanker', 'durug', 'abdullahka', 'boyat.allie', 'buehler', 'ashahall1978']"
19,66,25,10,9,"['dhs007', 'orvyan', 'sehieber', 'abdullahka', 'rafael84', 'ashahall1978', 'mroenbeck1', 'kkwanyang', 'chinchun1912ar85']",15,"['shinshijie', 'rromanbatista', 'wcmohr', 'mirzaeifar', 'dbrommer', 'fmartinm', 'csanker', 'fsbuaben', 'durug', 'boyat.allie', 'phil_yu', 'buehler', 'mehdiamiri', 'adwinter', 'bdepalle']",1,[None],25,"['rromanbatista', 'orvyan', 'sehieber', 'dbrommer', 'fsbuaben', 'phil_yu', 'rafael84', 'mehdiamiri', 'kkwanyang', 'wcmohr', None, 'shinshijie', 'dhs007', 'mirzaeifar', 'fmartinm', 'csanker', 'durug', 'abdullahka', 'boyat.allie', 'buehler', 'ashahall1978', 'mroenbeck1', 'adwinter', 'bdepalle', 'chinchun1912ar85']"
20,138,25,28,22,"['ehabbelal', 'sherif.omar', 'ecija', 'mohamedradwan', 'omar.bakry.eece', 'rasha.thr', 'eng.mahmoudayman', 'ayassin', 'romany', 'ahmed_1990shs', 'ahmed.amer', 'eng.mai', 'm.mohsen', 'samar.moustafa.56', 'eng.mohammed', 'maha_beheiry', 'ramy.ahmed.ali', 'm.a.ahmed', 'zema_gouchy', 'imbaby0ahmed', 'ahmed.badawy2020', 'samar.moustafa791']",2,"['amine_zer', 'mohmmad_mahusin']",6,"['mohammad.s.harraz', 'a.hesham', 'serag', 'modysather', 'yasmine.elogail', None]",30,"['ehabbelal', 'sherif.omar', 'ecija', 'mohamedradwan', 'modysather', 'mohmmad_mahusin', 'omar.bakry.eece', 'rasha.thr', 'yasmine.elogail', 'eng.mahmoudayman', 'amine_zer', 'ayassin', 'romany', 'mohammad.s.harraz', 'ahmed_1990shs', 'ahmed.amer', 'eng.mai', 'm.mohsen', 'samar.moustafa.56', 'a.hesham', 'eng.mohammed', 'serag', None, 'maha_beheiry', 'ramy.ahmed.ali', 'm.a.ahmed', 'zema_gouchy', 'imbaby0ahmed', 'ahmed.badawy2020', 'samar.moustafa791']"
20,102,25,24,20,"['ehabbelal', 'ecija', 'mohamedradwan', 'omar.bakry.eece', 'rasha.thr', 'eng.mahmoudayman', 'ayassin', 'romany', 'ahmed_1990shs', 'ahmed.amer', 'eng.mai', 'm.mohsen', 'samar.moustafa.56', 'eng.mohammed', 'maha_beheiry', 'ramy.ahmed.ali', 'zema_gouchy', 'imbaby0ahmed', 'ahmed.badawy2020', 'samar.moustafa791']",4,"['sherif.omar', 'amine_zer', 'm.a.ahmed', 'mohmmad_mahusin']",4,"[None, 'modysather', 'mohammad.s.harraz', 'a.hesham']",28,"['ehabbelal', 'sherif.omar', 'ecija', 'mohamedradwan', 'modysather', 'mohmmad_mahusin', 'omar.bakry.eece', 'rasha.thr', 'eng.mahmoudayman', 'amine_zer', 'ayassin', 'romany', 'mohammad.s.harraz', 'ahmed_1990shs', 'ahmed.amer', 'eng.mai', 'm.mohsen', 'samar.moustafa.56', 'a.hesham', 'eng.mohammed', None, 'maha_beheiry', 'ramy.ahmed.ali', 'm.a.ahmed', 'zema_gouchy', 'imbaby0ahmed', 'ahmed.badawy2020', 'samar.moustafa791']"
21,215,24,28,23,"['a.pandiyarajan', 'sanmaynair', 'alltrin', 'aswinthomas5', 'sujitachandrasekaran', 'jenniferjoana', 'mariaantonyjesudoss', 'krithikaravichandran', 'vinesh', 'sweetrider007', 'wrenitgempearl', 'boopathi', 'roselin1695j', 'amankumar', 'naveenkumartr', 'sharonjayakumar', 'minumarythomas123', 'poojanoramanik', 'lokeshzot', 'subasivabalan', 'kiranpreethi', 'madhumithajayakumar', 'pr12ns023']",0,[],5,"['vdamodaran2030', 'teddy.rebeirro', 'daved3', 'hariharan', None]",28,"['a.pandiyarajan', 'sanmaynair', 'alltrin', 'aswinthomas5', 'sujitachandrasekaran', 'jenniferjoana', 'mariaantonyjesudoss', 'krithikaravichandran', 'daved3', 'hariharan', 'vinesh', 'sweetrider007', 'wrenitgempearl', 'boopathi', 'roselin1695j', 'amankumar', 'naveenkumartr', 'sharonjayakumar', 'minumarythomas123', None, 'poojanoramanik', 'lokeshzot', 'subasivabalan', 'kiranpreethi', 'madhumithajayakumar', 'vdamodaran2030', 'teddy.rebeirro', 'pr12ns023']"
21,221,24,22,19,"['sanmaynair', 'a.pandiyarajan', 'alltrin', 'aswinthomas5', 'jenniferjoana', 'krithikaravichandran', 'vinesh', 'sweetrider007', 'wrenitgempearl', 'boopathi', 'roselin1695j', 'amankumar', 'sharonjayakumar', 'minumarythomas123', 'poojanoramanik', 'subasivabalan', 'lokeshzot', 'kiranpreethi', 'pr12ns023']",4,"['madhumithajayakumar', 'mariaantonyjesudoss', 'naveenkumartr', 'sujitachandrasekaran']",3,"[None, 'jagadeeshnagalakshmi', 'teddy.rebeirro']",26,"['a.pandiyarajan', 'sanmaynair', 'jagadeeshnagalakshmi', 'alltrin', 'aswinthomas5', 'sujitachandrasekaran', 'jenniferjoana', 'mariaantonyjesudoss', 'krithikaravichandran', 'vinesh', 'sweetrider007', 'wrenitgempearl', 'boopathi', 'roselin1695j', 'amankumar', 'naveenkumartr', 'sharonjayakumar', 'minumarythomas123', None, 'poojanoramanik', 'lokeshzot', 'subasivabalan', 'kiranpreethi', 'madhumithajayakumar', 'teddy.rebeirro', 'pr12ns023']"
21,225,24,19,15,"['a.pandiyarajan', 'wrenitgempearl', 'mariaantonyjesudoss', 'lokeshzot', 'subasivabalan', 'kiranpreethi', 'roselin1695j', 'alltrin', 'aswinthomas5', 'sharonjayakumar', 'minumarythomas123', 'pr12ns023', 'krithikaravichandran', 'vinesh', 'poojanoramanik']",8,"['sweetrider007', 'jenniferjoana', 'sanmaynair', 'madhumithajayakumar', 'boopathi', 'amankumar', 'naveenkumartr', 'sujitachandrasekaran']",4,"[None, 'naveen.....', 'teddy.rebeirro', 'mvrteja']",27,"['a.pandiyarajan', 'sanmaynair', 'alltrin', 'aswinthomas5', 'sujitachandrasekaran', 'jenniferjoana', 'mariaantonyjesudoss', 'krithikaravichandran', 'naveen.....', 'mvrteja', 'vinesh', 'sweetrider007', 'wrenitgempearl', 'boopathi', 'roselin1695j', 'amankumar', 'naveenkumartr', 'sharonjayakumar', 'minumarythomas123', None, 'poojanoramanik', 'lokeshzot', 'subasivabalan', 'kiranpreethi', 'madhumithajayakumar', 'teddy.rebeirro', 'pr12ns023']"
21,217,24,18,12,"['lokeshzot', 'mariaantonyjesudoss', 'madhumithajayakumar', 'kiranpreethi', 'roselin1695j', 'amankumar', 'naveenkumartr', 'sharonjayakumar', 'minumarythomas123', 'pr12ns023', 'sujitachandrasekaran', 'vinesh']",11,"['jenniferjoana', 'a.pandiyarajan', 'sanmaynair', 'sweetrider007', 'wrenitgempearl', 'subasivabalan', 'boopathi', 'alltrin', 'aswinthomas5', 'krithikaravichandran', 'poojanoramanik']",6,"['jagadeeshnagalakshmi', 'kuttysivabalan', 'teddy.rebeirro', 'hariharan', None, 'madhumithaj']",29,"['a.pandiyarajan', 'sanmaynair', 'jagadeeshnagalakshmi', 'alltrin', 'aswinthomas5', 'sujitachandrasekaran', 'jenniferjoana', 'mariaantonyjesudoss', 'krithikaravichandran', 'hariharan', 'vinesh', 'madhumithaj', 'sweetrider007', 'wrenitgempearl', 'boopathi', 'roselin1695j', 'amankumar', 'kuttysivabalan', 'naveenkumartr', 'sharonjayakumar', 'minumarythomas123', None, 'poojanoramanik', 'lokeshzot', 'subasivabalan', 'kiranpreethi', 'madhumithajayakumar', 'teddy.rebeirro', 'pr12ns023']"
21,214,24,15,12,"['sweetrider007', 'sanmaynair', 'lokeshzot', 'boopathi', 'amankumar', 'alltrin', 'aswinthomas5', 'naveenkumartr', 'sharonjayakumar', 'minumarythomas123', 'vinesh', 'poojanoramanik']",11,"['jenniferjoana', 'a.pandiyarajan', 'wrenitgempearl', 'mariaantonyjesudoss', 'subasivabalan', 'kiranpreethi', 'madhumithajayakumar', 'roselin1695j', 'pr12ns023', 'krithikaravichandran', 'sujitachandrasekaran']",3,"[None, 'daved3', 'hariharan']",26,"['a.pandiyarajan', 'sanmaynair', 'alltrin', 'aswinthomas5', 'sujitachandrasekaran', 'jenniferjoana', 'mariaantonyjesudoss', 'krithikaravichandran', 'daved3', 'hariharan', 'vinesh', 'sweetrider007', 'wrenitgempearl', 'boopathi', 'roselin1695j', 'amankumar', 'naveenkumartr', 'sharonjayakumar', 'minumarythomas123', None, 'poojanoramanik', 'lokeshzot', 'subasivabalan', 'kiranpreethi', 'madhumithajayakumar', 'pr12ns023']"
21,223,24,15,10,"['sanmaynair', 'subasivabalan', 'kiranpreethi', 'madhumithajayakumar', 'amankumar', 'alltrin', 'aswinthomas5', 'sharonjayakumar', 'krithikaravichandran', 'vinesh']",13,"['sweetrider007', 'jenniferjoana', 'a.pandiyarajan', 'mariaantonyjesudoss', 'wrenitgempearl', 'lokeshzot', 'boopathi', 'roselin1695j', 'naveenkumartr', 'minumarythomas123', 'pr12ns023', 'sujitachandrasekaran', 'poojanoramanik']",5,"['jagadeeshnagalakshmi', 'teddy.rebeirro', 'naveen.....', 'hariharan', None]",28,"['a.pandiyarajan', 'sanmaynair', 'jagadeeshnagalakshmi', 'alltrin', 'aswinthomas5', 'sujitachandrasekaran', 'jenniferjoana', 'mariaantonyjesudoss', 'krithikaravichandran', 'naveen.....', 'hariharan', 'vinesh', 'sweetrider007', 'wrenitgempearl', 'boopathi', 'roselin1695j', 'amankumar', 'naveenkumartr', 'sharonjayakumar', 'minumarythomas123', None, 'poojanoramanik', 'lokeshzot', 'subasivabalan', 'kiranpreethi', 'madhumithajayakumar', 'teddy.rebeirro', 'pr12ns023']"
21,222,24,12,8,"['a.pandiyarajan', 'lokeshzot', 'mariaantonyjesudoss', 'kiranpreethi', 'boopathi', 'pr12ns023', 'sujitachandrasekaran', 'vinesh']",15,"['jenniferjoana', 'sanmaynair', 'sweetrider007', 'wrenitgempearl', 'subasivabalan', 'madhumithajayakumar', 'roselin1695j', 'amankumar', 'alltrin', 'aswinthomas5', 'naveenkumartr', 'sharonjayakumar', 'minumarythomas123', 'krithikaravichandran', 'poojanoramanik']",4,"[None, 'hariharan', 'naveen.....', 'teddy.rebeirro']",27,"['sweetrider007', 'a.pandiyarajan', 'sanmaynair', 'wrenitgempearl', 'boopathi', 'roselin1695j', 'amankumar', 'alltrin', 'aswinthomas5', 'naveenkumartr', 'sharonjayakumar', 'minumarythomas123', 'sujitachandrasekaran', None, 'poojanoramanik', 'jenniferjoana', 'lokeshzot', 'mariaantonyjesudoss', 'subasivabalan', 'kiranpreethi', 'madhumithajayakumar', 'teddy.rebeirro', 'pr12ns023', 'krithikaravichandran', 'naveen.....', 'hariharan', 'vinesh']"
21,224,24,11,9,"['jenniferjoana', 'a.pandiyarajan', 'lokeshzot', 'madhumithajayakumar', 'amankumar', 'alltrin', 'pr12ns023', 'sujitachandrasekaran', 'poojanoramanik']",14,"['sweetrider007', 'sanmaynair', 'wrenitgempearl', 'mariaantonyjesudoss', 'subasivabalan', 'kiranpreethi', 'boopathi', 'roselin1695j', 'aswinthomas5', 'naveenkumartr', 'sharonjayakumar', 'minumarythomas123', 'krithikaravichandran', 'vinesh']",2,"[None, 'jagadeeshnagalakshmi']",25,"['sweetrider007', 'a.pandiyarajan', 'sanmaynair', 'wrenitgempearl', 'jagadeeshnagalakshmi', 'boopathi', 'roselin1695j', 'amankumar', 'alltrin', 'aswinthomas5', 'naveenkumartr', 'sharonjayakumar', 'minumarythomas123', 'sujitachandrasekaran', None, 'poojanoramanik', 'jenniferjoana', 'lokeshzot', 'mariaantonyjesudoss', 'subasivabalan', 'kiranpreethi', 'madhumithajayakumar', 'pr12ns023', 'krithikaravichandran', 'vinesh']"
21,216,24,10,7,"['wrenitgempearl', 'sanmaynair', 'kiranpreethi', 'aswinthomas5', 'krithikaravichandran', 'vinesh', 'poojanoramanik']",16,"['jenniferjoana', 'a.pandiyarajan', 'sweetrider007', 'mariaantonyjesudoss', 'lokeshzot', 'subasivabalan', 'madhumithajayakumar', 'boopathi', 'roselin1695j', 'amankumar', 'alltrin', 'naveenkumartr', 'sharonjayakumar', 'minumarythomas123', 'pr12ns023', 'sujitachandrasekaran']",3,"['vdamodaran2030', None, 'hariharan']",26,"['sweetrider007', 'a.pandiyarajan', 'sanmaynair', 'wrenitgempearl', 'boopathi', 'roselin1695j', 'amankumar', 'alltrin', 'aswinthomas5', 'naveenkumartr', 'sharonjayakumar', 'minumarythomas123', 'sujitachandrasekaran', None, 'poojanoramanik', 'jenniferjoana', 'lokeshzot', 'mariaantonyjesudoss', 'subasivabalan', 'kiranpreethi', 'madhumithajayakumar', 'vdamodaran2030', 'pr12ns023', 'krithikaravichandran', 'hariharan', 'vinesh']"
22,143,23,20,19,"['tangweitao', 'z3471499', 'serena.bai.627', 'williamnguyen', 'sid145', 'hubbadeba', 'xl2550789', 'feifan_lv', 'jl19891221', 'windmangu', 'janezhang', 'krazyklink', 'andreamorello', 'sunildahal', 'jxaa100173', 'pledge92', 'parkerv', 'dennis.garnsey', 'defy1984']",3,"['meilleur', 'to4koo', 'amireluz']",1,[None],23,"['tangweitao', 'z3471499', 'serena.bai.627', 'meilleur', 'williamnguyen', 'sid145', 'hubbadeba', 'xl2550789', 'amireluz', 'feifan_lv', 'jl19891221', 'windmangu', 'janezhang', 'krazyklink', 'andreamorello', None, 'sunildahal', 'jxaa100173', 'pledge92', 'to4koo', 'parkerv', 'dennis.garnsey', 'defy1984']"
23,43,22,35,20,"['coolll', 'xmalin24', 'xkunzj00', 'kovacsjan', 'sikit', 'prist.lukas', 'jandor', 'xpivni01', 'xdvora0u', 'rufius.sliz', 'ag', 'tomskra', 'matus.kozovsky', 'mickis89', 'petr', 'vkotrc', 'kill12', 'peter.molcany', 'mazal.ctibor', 'hl.venca']",1,['kubatzdenek'],15,"['karel', 'xmarek47', 'payne003', None, 'radka', 'filipveskrna', 'petr.sefara', 'tompalacky', 'jansimurda', 'joohnycz', 'pavel.vlcek.73', 'mierzwinsky', 'm4w3r1ck', 'michal.panek', 'xkosav00']",36,"['coolll', 'xmalin24', 'petr.sefara', 'tompalacky', 'xkunzj00', 'jansimurda', 'kovacsjan', 'michal.panek', 'karel', 'sikit', 'prist.lukas', 'jandor', 'filipveskrna', 'xpivni01', 'xdvora0u', 'rufius.sliz', 'pavel.vlcek.73', 'ag', 'm4w3r1ck', 'xmarek47', 'payne003', 'kubatzdenek', 'tomskra', 'matus.kozovsky', 'mickis89', 'joohnycz', 'mierzwinsky', None, 'petr', 'vkotrc', 'xkosav00', 'kill12', 'radka', 'peter.molcany', 'mazal.ctibor', 'hl.venca']"
23,105,22,35,18,"['coolll', 'sikit', 'prist.lukas', 'kill12', 'jandor', 'tomskra', 'xpivni01', 'xdvora0u', 'xkunzj00', 'rufius.sliz', 'matus.kozovsky', 'mickis89', 'mazal.ctibor', 'kovacsjan', 'ag', 'hl.venca', 'petr', 'vkotrc']",3,"['kubatzdenek', 'xmalin24', 'peter.molcany']",17,"[None, 'michnajakub1991', 'radka', 'kubik.beranek', 'filipveskrna', 'petr.sefara', 'xsikud00', 'xhaha', 'jannovak', 'xrajno05', 'joohnycz', 'xlangr05', 'rattlefrcz', 'mierzwinsky', 'm4w3r1ck', 'michal.panek', 'xkosav00']",38,"['coolll', 'michnajakub1991', 'xmalin24', 'petr.sefara', 'xkunzj00', 'kovacsjan', 'rattlefrcz', 'michal.panek', 'sikit', 'prist.lukas', 'jandor', 'filipveskrna', 'xpivni01', 'xdvora0u', 'xsikud00', 'rufius.sliz', 'ag', 'kubik.beranek', 'm4w3r1ck', 'kubatzdenek', 'tomskra', 'xhaha', 'matus.kozovsky', 'mickis89', 'jannovak', 'xrajno05', 'joohnycz', 'mierzwinsky', None, 'petr', 'vkotrc', 'xkosav00', 'kill12', 'radka', 'peter.molcany', 'mazal.ctibor', 'xlangr05', 'hl.venca']"
23,177,22,35,19,"['xmalin24', 'xkunzj00', 'kovacsjan', 'sikit', 'prist.lukas', 'jandor', 'xpivni01', 'xdvora0u', 'rufius.sliz', 'ag', 'tomskra', 'matus.kozovsky', 'mickis89', 'petr', 'vkotrc', 'kill12', 'peter.molcany', 'mazal.ctibor', 'hl.venca']",2,"['coolll', 'kubatzdenek']",16,"['karel', 'xmarek47', 'michnajakub1991', 'stefanisko.ivan', 'filipveskrna', 'tompalacky', 'xberan30', 'jansimurda', 'xhaha', 'jannovak', 'xrajno05', 'weisslukas90', 'xlangr05', 'rattlefrcz', 'pavel.vlcek.73', None]",37,"['coolll', 'michnajakub1991', 'xmalin24', 'tompalacky', 'xkunzj00', 'jansimurda', 'kovacsjan', 'rattlefrcz', 'karel', 'sikit', 'prist.lukas', 'jandor', 'filipveskrna', 'xpivni01', 'xdvora0u', 'rufius.sliz', 'pavel.vlcek.73', 'ag', 'xmarek47', 'stefanisko.ivan', 'kubatzdenek', 'tomskra', 'xberan30', 'xhaha', 'matus.kozovsky', 'mickis89', 'jannovak', 'xrajno05', 'weisslukas90', None, 'petr', 'vkotrc', 'kill12', 'peter.molcany', 'mazal.ctibor', 'xlangr05', 'hl.venca']"
23,151,22,34,18,"['coolll', 'sikit', 'prist.lukas', 'kill12', 'jandor', 'tomskra', 'xpivni01', 'xdvora0u', 'xkunzj00', 'rufius.sliz', 'matus.kozovsky', 'mickis89', 'mazal.ctibor', 'kovacsjan', 'ag', 'hl.venca', 'petr', 'vkotrc']",3,"['kubatzdenek', 'xmalin24', 'peter.molcany']",16,"[None, 'michnajakub1991', 'radka', 'kubik.beranek', 'petr.sefara', 'xsikud00', 'xhaha', 'jannovak', 'xrajno05', 'joohnycz', 'xlangr05', 'rattlefrcz', 'mierzwinsky', 'm4w3r1ck', 'michal.panek', 'xkosav00']",37,"['coolll', 'michnajakub1991', 'xmalin24', 'petr.sefara', 'xkunzj00', 'kovacsjan', 'rattlefrcz', 'michal.panek', 'sikit', 'prist.lukas', 'jandor', 'xpivni01', 'xdvora0u', 'xsikud00', 'rufius.sliz', 'ag', 'kubik.beranek', 'm4w3r1ck', 'kubatzdenek', 'tomskra', 'xhaha', 'matus.kozovsky', 'mickis89', 'jannovak', 'xrajno05', 'joohnycz', 'mierzwinsky', None, 'petr', 'vkotrc', 'xkosav00', 'kill12', 'radka', 'peter.molcany', 'mazal.ctibor', 'xlangr05', 'hl.venca']"
23,41,22,33,1,['kubatzdenek'],20,"['coolll', 'xmalin24', 'xkunzj00', 'kovacsjan', 'sikit', 'prist.lukas', 'jandor', 'xpivni01', 'xdvora0u', 'rufius.sliz', 'ag', 'tomskra', 'matus.kozovsky', 'mickis89', 'petr', 'vkotrc', 'kill12', 'peter.molcany', 'mazal.ctibor', 'hl.venca']",32,"['inferno91', 'xjuric20', 'xmasar09', 'michal22', 'xlakom03', 'xzicha02', 'jarda', 'cibulator', 'masty', 'hak.david', 'xkarli04', 'byvoko', 'jbrukner', 'xstrit06', 'martin1991', 'malsik1234', 'xstejs19', 'daniel1appel', 'xgilik00', 'filipkovac', 'mhoryna', 'wlady', 'jak36', 'weisslukas90', 'lukas5452', None, 'tomas.cicmansky', 'kubrrrt', 'sere_pes', 'rastislavcervenak', 'xkocik00', 'blaha.vita']",53,"['coolll', 'inferno91', 'xmalin24', 'xjuric20', 'xkunzj00', 'kovacsjan', 'xmasar09', 'michal22', 'sikit', 'prist.lukas', 'xlakom03', 'jandor', 'xzicha02', 'jarda', 'cibulator', 'xpivni01', 'masty', 'hak.david', 'xdvora0u', 'xkarli04', 'byvoko', 'jbrukner', 'rufius.sliz', 'xstrit06', 'ag', 'martin1991', 'malsik1234', 'xstejs19', 'daniel1appel', 'kubatzdenek', 'tomskra', 'xgilik00', 'filipkovac', 'mhoryna', 'wlady', 'matus.kozovsky', 'mickis89', 'jak36', 'weisslukas90', 'lukas5452', None, 'tomas.cicmansky', 'petr', 'vkotrc', 'kubrrrt', 'kill12', 'sere_pes', 'rastislavcervenak', 'peter.molcany', 'mazal.ctibor', 'xkocik00', 'hl.venca', 'blaha.vita']"
23,104,22,27,1,['kubatzdenek'],20,"['coolll', 'xmalin24', 'xkunzj00', 'kovacsjan', 'sikit', 'prist.lukas', 'jandor', 'xpivni01', 'xdvora0u', 'rufius.sliz', 'ag', 'tomskra', 'matus.kozovsky', 'mickis89', 'petr', 'vkotrc', 'kill12', 'peter.molcany', 'mazal.ctibor', 'hl.venca']",26,"['fuckerregistations', 'elellael', 'xjuric20', 'xmasar09', 'maja90', 'michal22', 'xlakom03', 'masty', 'xkarli04', 'roman.krej', 'byvoko', 'xstrit06', 'martin1991', 'malsik1234', 'xstejs19', 'daniel1appel', 'mhoryna', 'lukas5452', 'mik652', None, 'jerro66', 'sere_pes', 'rastislavcervenak', 'dopitak32', 'xkocik00', 'blaha.vita']",47,"['coolll', 'fuckerregistations', 'elellael', 'xmalin24', 'xjuric20', 'xkunzj00', 'kovacsjan', 'xmasar09', 'maja90', 'michal22', 'sikit', 'prist.lukas', 'xlakom03', 'jandor', 'xpivni01', 'masty', 'xkarli04', 'xdvora0u', 'roman.krej', 'byvoko', 'rufius.sliz', 'xstrit06', 'ag', 'martin1991', 'malsik1234', 'xstejs19', 'daniel1appel', 'kubatzdenek', 'tomskra', 'mhoryna', 'matus.kozovsky', 'mickis89', 'lukas5452', 'mik652', None, 'petr', 'vkotrc', 'kill12', 'jerro66', 'sere_pes', 'rastislavcervenak', 'dopitak32', 'peter.molcany', 'mazal.ctibor', 'xkocik00', 'hl.venca', 'blaha.vita']"
23,150,22,27,1,['kubatzdenek'],20,"['coolll', 'xmalin24', 'xkunzj00', 'kovacsjan', 'sikit', 'prist.lukas', 'jandor', 'xpivni01', 'xdvora0u', 'rufius.sliz', 'ag', 'tomskra', 'matus.kozovsky', 'mickis89', 'petr', 'vkotrc', 'kill12', 'peter.molcany', 'mazal.ctibor', 'hl.venca']",26,"['fuckerregistations', 'elellael', 'xjuric20', 'xmasar09', 'maja90', 'michal22', 'xlakom03', 'masty', 'xkarli04', 'roman.krej', 'byvoko', 'xstrit06', 'martin1991', 'malsik1234', 'xstejs19', 'daniel1appel', 'mhoryna', 'lukas5452', 'mik652', None, 'jerro66', 'sere_pes', 'rastislavcervenak', 'dopitak32', 'xkocik00', 'blaha.vita']",47,"['coolll', 'fuckerregistations', 'elellael', 'xmalin24', 'xjuric20', 'xkunzj00', 'kovacsjan', 'xmasar09', 'maja90', 'michal22', 'sikit', 'prist.lukas', 'xlakom03', 'jandor', 'xpivni01', 'masty', 'xkarli04', 'xdvora0u', 'roman.krej', 'byvoko', 'rufius.sliz', 'xstrit06', 'ag', 'martin1991', 'malsik1234', 'xstejs19', 'daniel1appel', 'kubatzdenek', 'tomskra', 'mhoryna', 'matus.kozovsky', 'mickis89', 'lukas5452', 'mik652', None, 'petr', 'vkotrc', 'kill12', 'jerro66', 'sere_pes', 'rastislavcervenak', 'dopitak32', 'peter.molcany', 'mazal.ctibor', 'xkocik00', 'hl.venca', 'blaha.vita']"
23,191,22,23,13,"['coolll', 'sikit', 'kill12', 'jandor', 'tomskra', 'xmalin24', 'xpivni01', 'xdvora0u', 'peter.molcany', 'xkunzj00', 'matus.kozovsky', 'hl.venca', 'vkotrc']",8,"['prist.lukas', 'kubatzdenek', 'rufius.sliz', 'mickis89', 'mazal.ctibor', 'kovacsjan', 'ag', 'petr']",10,"['xmarek47', 'michnajakub1991', 'stefanisko.ivan', None, 'xglosj00', 'z.fusek', 'xlangr05', 'mierzwinsky', 'm4w3r1ck', 'michal.panek']",31,"['coolll', 'michnajakub1991', 'xmalin24', 'xkunzj00', 'kovacsjan', 'michal.panek', 'sikit', 'prist.lukas', 'jandor', 'xpivni01', 'xdvora0u', 'rufius.sliz', 'ag', 'm4w3r1ck', 'xmarek47', 'stefanisko.ivan', 'kubatzdenek', 'tomskra', 'matus.kozovsky', 'mickis89', 'z.fusek', 'mierzwinsky', None, 'petr', 'vkotrc', 'kill12', 'xglosj00', 'peter.molcany', 'mazal.ctibor', 'xlangr05', 'hl.venca']"
23,188,22,16,10,"['coolll', 'kill12', 'jandor', 'tomskra', 'xmalin24', 'xdvora0u', 'xkunzj00', 'matus.kozovsky', 'hl.venca', 'vkotrc']",11,"['sikit', 'prist.lukas', 'kubatzdenek', 'xpivni01', 'peter.molcany', 'rufius.sliz', 'mickis89', 'mazal.ctibor', 'kovacsjan', 'ag', 'petr']",6,"[None, 'michnajakub1991', 'xglosj00', 'xlangr05', 'mierzwinsky', 'm4w3r1ck']",27,"['coolll', 'michnajakub1991', 'kubatzdenek', 'xmalin24', 'tomskra', 'xkunzj00', 'matus.kozovsky', 'mickis89', 'kovacsjan', 'mierzwinsky', None, 'petr', 'vkotrc', 'sikit', 'prist.lukas', 'kill12', 'jandor', 'xglosj00', 'xpivni01', 'xdvora0u', 'peter.molcany', 'rufius.sliz', 'mazal.ctibor', 'xlangr05', 'ag', 'hl.venca', 'm4w3r1ck']"
23,185,22,13,1,['kubatzdenek'],20,"['coolll', 'xmalin24', 'xkunzj00', 'kovacsjan', 'sikit', 'prist.lukas', 'jandor', 'xpivni01', 'xdvora0u', 'rufius.sliz', 'ag', 'tomskra', 'matus.kozovsky', 'mickis89', 'petr', 'vkotrc', 'kill12', 'peter.molcany', 'mazal.ctibor', 'hl.venca']",12,"['michal22', 'xzicha02', 'jarda', 'daniel1appel', 'rastislavcervenak', 'hak.david', 'xjuric20', 'byvoko', 'mhoryna', 'xvesel56', 'mik652', None]",33,"['coolll', 'daniel1appel', 'kubatzdenek', 'xmalin24', 'tomskra', 'xjuric20', 'mhoryna', 'xkunzj00', 'matus.kozovsky', 'mickis89', 'kovacsjan', 'mik652', 'xvesel56', None, 'petr', 'vkotrc', 'michal22', 'sikit', 'prist.lukas', 'kill12', 'jandor', 'xzicha02', 'jarda', 'rastislavcervenak', 'xpivni01', 'hak.david', 'xdvora0u', 'peter.molcany', 'byvoko', 'rufius.sliz', 'mazal.ctibor', 'ag', 'hl.venca']"
23,190,22,11,1,['kubatzdenek'],20,"['coolll', 'xmalin24', 'xkunzj00', 'kovacsjan', 'sikit', 'prist.lukas', 'jandor', 'xpivni01', 'xdvora0u', 'rufius.sliz', 'ag', 'tomskra', 'matus.kozovsky', 'mickis89', 'petr', 'vkotrc', 'kill12', 'peter.molcany', 'mazal.ctibor', 'hl.venca']",10,"['michal22', 'xzicha02', 'jarda', 'daniel1appel', 'hak.david', 'xjuric20', 'mhoryna', 'xvesel56', None, 'm4w3r1ck']",31,"['coolll', 'daniel1appel', 'kubatzdenek', 'xmalin24', 'tomskra', 'xjuric20', 'mhoryna', 'xkunzj00', 'matus.kozovsky', 'mickis89', 'kovacsjan', 'xvesel56', None, 'petr', 'vkotrc', 'michal22', 'sikit', 'prist.lukas', 'kill12', 'jandor', 'xzicha02', 'jarda', 'xpivni01', 'hak.david', 'xdvora0u', 'peter.molcany', 'rufius.sliz', 'mazal.ctibor', 'ag', 'hl.venca', 'm4w3r1ck']"
23,187,22,10,5,"['rufius.sliz', 'mazal.ctibor', 'kovacsjan', 'ag', 'petr']",16,"['coolll', 'sikit', 'prist.lukas', 'kill12', 'jandor', 'kubatzdenek', 'xmalin24', 'tomskra', 'xpivni01', 'xdvora0u', 'peter.molcany', 'xkunzj00', 'matus.kozovsky', 'mickis89', 'hl.venca', 'vkotrc']",5,"['petr.sefara', 'tompalacky', 'kubik.beranek', None, 'xkosav00']",26,"['coolll', 'kubatzdenek', 'xmalin24', 'tomskra', 'tompalacky', 'petr.sefara', 'xkunzj00', 'matus.kozovsky', 'mickis89', 'kovacsjan', None, 'petr', 'vkotrc', 'xkosav00', 'sikit', 'prist.lukas', 'kill12', 'jandor', 'kubik.beranek', 'xpivni01', 'xdvora0u', 'peter.molcany', 'rufius.sliz', 'mazal.ctibor', 'ag', 'hl.venca']"
23,176,22,7,1,['kubatzdenek'],20,"['coolll', 'xmalin24', 'xkunzj00', 'kovacsjan', 'sikit', 'prist.lukas', 'jandor', 'xpivni01', 'xdvora0u', 'rufius.sliz', 'ag', 'tomskra', 'matus.kozovsky', 'mickis89', 'petr', 'vkotrc', 'kill12', 'peter.molcany', 'mazal.ctibor', 'hl.venca']",6,"['malsik1234', 'xgilik00', 'roman.krej', 'jbrukner', 'xmasar09', None]",27,"['coolll', 'malsik1234', 'kubatzdenek', 'xmalin24', 'tomskra', 'xgilik00', 'xkunzj00', 'matus.kozovsky', 'mickis89', 'kovacsjan', 'xmasar09', None, 'petr', 'vkotrc', 'sikit', 'prist.lukas', 'kill12', 'jandor', 'xpivni01', 'xdvora0u', 'peter.molcany', 'roman.krej', 'jbrukner', 'rufius.sliz', 'mazal.ctibor', 'ag', 'hl.venca']"
23,182,22,7,1,['kubatzdenek'],20,"['coolll', 'xmalin24', 'xkunzj00', 'kovacsjan', 'sikit', 'prist.lukas', 'jandor', 'xpivni01', 'xdvora0u', 'rufius.sliz', 'ag', 'tomskra', 'matus.kozovsky', 'mickis89', 'petr', 'vkotrc', 'kill12', 'peter.molcany', 'mazal.ctibor', 'hl.venca']",6,"['malsik1234', 'xgilik00', 'roman.krej', 'jbrukner', 'xmasar09', None]",27,"['coolll', 'malsik1234', 'kubatzdenek', 'xmalin24', 'tomskra', 'xgilik00', 'xkunzj00', 'matus.kozovsky', 'mickis89', 'kovacsjan', 'xmasar09', None, 'petr', 'vkotrc', 'sikit', 'prist.lukas', 'kill12', 'jandor', 'xpivni01', 'xdvora0u', 'peter.molcany', 'roman.krej', 'jbrukner', 'rufius.sliz', 'mazal.ctibor', 'ag', 'hl.venca']"
24,15,21,23,13,"['abelrahmanmohamed', 'aboelamras', 'doaa', 'amgad_swedan', 'ahmed_mohamed_abdelalim', 'nadamohamedmahrous', 'sarakhalaf', 'mohamedhesham', 'nadine.elwessimy', 'kesmatshahin', 'mahmoud.ehab1', 'vina.salah', 'lol.ask92']",7,"['jricker', 'gregsrt410', 'raghunandan.m.rao', 'abdelrahman93', 'kaloob00', 'behnam0o', 'farazkhavari']",10,"['samdozer', 'rody.osama', 'mahmoudabdelmoniem', 'mosab94', 'ahmed.shedid.12', 'ahazem254', 'andrewalbert00', None, 'omar.amin.750', 'sarahlion']",30,"['mohamedhesham', 'rody.osama', 'mahmoudabdelmoniem', 'kesmatshahin', 'mahmoud.ehab1', 'omar.amin.750', 'farazkhavari', 'abelrahmanmohamed', 'aboelamras', 'jricker', 'abdelrahman93', 'nadine.elwessimy', 'kaloob00', 'behnam0o', 'lol.ask92', 'mosab94', 'sarahlion', 'samdozer', 'amgad_swedan', 'nadamohamedmahrous', 'sarakhalaf', 'gregsrt410', 'raghunandan.m.rao', 'ahazem254', 'vina.salah', 'ahmed_mohamed_abdelalim', None, 'ahmed.shedid.12', 'doaa', 'andrewalbert00']"
24,13,21,9,2,"['behnam0o', 'farazkhavari']",18,"['abelrahmanmohamed', 'aboelamras', 'doaa', 'amgad_swedan', 'ahmed_mohamed_abdelalim', 'nadamohamedmahrous', 'jricker', 'mohamedhesham', 'sarakhalaf', 'gregsrt410', 'raghunandan.m.rao', 'abdelrahman93', 'kesmatshahin', 'nadine.elwessimy', 'mahmoud.ehab1', 'vina.salah', 'kaloob00', 'lol.ask92']",7,"['szymon.sollamidelekta', 'saralaji006', 'bellmanz', 'micarl', 'katayoun.zahmatkesh', None, 'arash83']",27,"['szymon.sollamidelekta', 'bellmanz', 'amgad_swedan', 'nadamohamedmahrous', 'sarakhalaf', 'mohamedhesham', 'gregsrt410', 'raghunandan.m.rao', 'kesmatshahin', 'mahmoud.ehab1', 'vina.salah', 'ahmed_mohamed_abdelalim', None, 'farazkhavari', 'abelrahmanmohamed', 'aboelamras', 'saralaji006', 'doaa', 'jricker', 'micarl', 'katayoun.zahmatkesh', 'abdelrahman93', 'nadine.elwessimy', 'arash83', 'kaloob00', 'behnam0o', 'lol.ask92']"
24,16,21,7,2,"['behnam0o', 'farazkhavari']",18,"['abelrahmanmohamed', 'aboelamras', 'doaa', 'amgad_swedan', 'ahmed_mohamed_abdelalim', 'nadamohamedmahrous', 'jricker', 'mohamedhesham', 'sarakhalaf', 'gregsrt410', 'raghunandan.m.rao', 'abdelrahman93', 'kesmatshahin', 'nadine.elwessimy', 'mahmoud.ehab1', 'vina.salah', 'kaloob00', 'lol.ask92']",5,"['chris.chen.kista', 'arash83', 'katayoun.zahmatkesh', None, 'zhichaoy']",25,"['chris.chen.kista', 'amgad_swedan', 'nadamohamedmahrous', 'sarakhalaf', 'mohamedhesham', 'gregsrt410', 'raghunandan.m.rao', 'kesmatshahin', 'mahmoud.ehab1', 'vina.salah', 'ahmed_mohamed_abdelalim', None, 'zhichaoy', 'farazkhavari', 'abelrahmanmohamed', 'aboelamras', 'doaa', 'jricker', 'katayoun.zahmatkesh', 'abdelrahman93', 'nadine.elwessimy', 'arash83', 'kaloob00', 'behnam0o', 'lol.ask92']"
25,198,20,149,8,"['nesp215', 'sid.sethupathi', 'tomqin93', 'jhou6', 'davidlee0248', 'lyluyaoh', 'arosmith3', 'seiser2']",11,"['mariapaulavivas', 'apamapam', 'sebastovar', 'repreman', 'lumarin', 'david.garzonrangel', 'jdcasadiego', 'larruibo', 'cristiandimas', 'doskoooo', 'lina320']",141,"['jiyuxiao', 'viperacr', 'merridius', 'rahulraju93', 'djinkorea', 'slin471992', 'lin194', 'danzuo', 'italy5150', 'tyler.mey', 'chentan08', 'nsparik2', 'cjv21', 'premal.tailor', 'andsmy', 'carberr2', 'dekunukem', 'chumakabaghe', 'rglazer2', 'james.younce92', 'shugotanaka', 'dillon', 'weizeor2', 'kwh1210', 'bree.peng', 'dpatnai2', 'dudes', 'hnrcksn2', 'tanaka6', 'vanillayyy', 'temitayo.adeoshifogun', 'jingfu.nian', 'treetopluver', 'xia.alex', 'daosyn', 'yuanshuowu', 'gene820715', 'dziegle2', 'lipengyanghappy', 'xouyang5', 'siddhanth.munukutla', 'swojto', 'supermarth64', 'j234560', 'nopshusang', 'tan.ozdogan', 'koopmnn2', 'tiagovla', 'smsagan', 'ashimiz2', 'ganshun', 'jayanth0001', 'kunyilin9211', 'jorden.brown.54', 'ajeong3', 'hpowen6', 'zhiyang2', 'zhen.mike', 'almulla', 'jeppydude', 'manu.shallow', 'jng12', 'fermat', 'lhendre2', 'jofu803', 'jayyao', 'boatmee', 'bojjave2', 'vanshk', 'seadler1', 'awesome.young.choi', 'zyao4', 'wywang2', 'yong.b.lee.73', 'broadhurst.josh', 'justin.danger.brooks', 'lee267', 'deveshj4', 'chris.12', 'nicolls1', 'yousaf_salam', 'amurthy26', 'kim619', 'olivercai', 'cano3', 'dereckluo', 'alex.t.zhu', 'ramaiah2', 'kjabon2', 'nmenne2', 'jhollen93', 'hanns16', 'rigotech', 'sivaram3', 'stupib', 'arjun.balwally', 'jakerock44', 'bkesler', 'yue.li.10441', 'ngoswam2', 'jiang100', 'andygongyb', 'sowinsk2', 'themanderson14', 'istayev2', 'aagrawa4', 'naraeyoon92', 'stephenbudhi', 'nparikh6', 'ryan.tompkins22', 'sing619', 'chou27', 'swang75', 'shunchu', 'zheshen', 'gvelard2edu', 'machali1', 'dantonacci', 'niktike', 'fujinam2', 'rbelul2', 'jshowail', 'zixing.wang.9', 'bsorich32', 'bcc4994', 'cnnorbe2', 'darwinwalters', 'reagan1', None, 'psahgal', 'leinber2', 'whyshouldimakeanaccountseriously', 'wesley.zhang.92', 'aldave', 'gduchar', 'scai7', 'apcomic', 'dliang8', 'lukic2', 'shahkaran94', 'bwpmail']",160,"['jiyuxiao', 'viperacr', 'sid.sethupathi', 'apamapam', 'merridius', 'shahkaran94', 'rahulraju93', 'djinkorea', 'slin471992', 'lin194', 'danzuo', 'italy5150', 'tyler.mey', 'repreman', 'chentan08', 'nsparik2', 'cjv21', 'cristiandimas', 'premal.tailor', 'andsmy', 'carberr2', 'dekunukem', 'lumarin', 'chumakabaghe', 'rglazer2', 'seiser2', 'james.younce92', 'mariapaulavivas', 'shugotanaka', 'dillon', 'weizeor2', 'kwh1210', 'bree.peng', 'dpatnai2', 'dudes', 'hnrcksn2', 'tanaka6', 'vanillayyy', 'temitayo.adeoshifogun', 'jingfu.nian', 'treetopluver', 'xia.alex', 'daosyn', 'yuanshuowu', 'gene820715', 'dziegle2', 'lipengyanghappy', 'xouyang5', 'siddhanth.munukutla', 'swojto', 'supermarth64', 'doskoooo', 'j234560', 'nopshusang', 'tan.ozdogan', 'koopmnn2', 'tiagovla', 'lyluyaoh', 'smsagan', 'ashimiz2', 'ganshun', 'jayanth0001', 'kunyilin9211', 'jorden.brown.54', 'ajeong3', 'hpowen6', 'zhiyang2', 'zhen.mike', 'sebastovar', 'almulla', 'jeppydude', 'manu.shallow', 'david.garzonrangel', 'jng12', 'fermat', 'lhendre2', 'jofu803', 'jayyao', 'boatmee', 'bojjave2', 'vanshk', 'seadler1', 'awesome.young.choi', 'jdcasadiego', 'zyao4', 'wywang2', 'yong.b.lee.73', 'broadhurst.josh', 'justin.danger.brooks', 'lee267', 'deveshj4', 'chris.12', 'larruibo', 'nicolls1', 'yousaf_salam', 'amurthy26', 'kim619', 'olivercai', 'davidlee0248', 'cano3', 'arosmith3', 'dereckluo', 'alex.t.zhu', 'ramaiah2', 'kjabon2', 'nmenne2', 'jhollen93', 'hanns16', 'rigotech', 'sivaram3', 'stupib', 'arjun.balwally', 'nesp215', 'jakerock44', 'jhou6', 'bkesler', 'yue.li.10441', 'ngoswam2', 'jiang100', 'andygongyb', 'sowinsk2', 'themanderson14', 'istayev2', 'aagrawa4', 'naraeyoon92', 'stephenbudhi', 'nparikh6', 'ryan.tompkins22', 'sing619', 'chou27', 'swang75', 'shunchu', 'zheshen', 'gvelard2edu', 'machali1', 'dantonacci', 'tomqin93', 'niktike', 'fujinam2', 'rbelul2', 'lina320', 'jshowail', 'zixing.wang.9', 'bsorich32', 'bcc4994', 'cnnorbe2', 'darwinwalters', 'reagan1', None, 'psahgal', 'leinber2', 'wesley.zhang.92', 'aldave', 'gduchar', 'scai7', 'apcomic', 'dliang8', 'lukic2', 'whyshouldimakeanaccountseriously', 'bwpmail']"
25,196,20,37,7,"['sebastovar', 'repreman', 'lumarin', 'jdcasadiego', 'larruibo', 'cristiandimas', 'lina320']",12,"['nesp215', 'mariapaulavivas', 'sid.sethupathi', 'apamapam', 'tomqin93', 'jhou6', 'lyluyaoh', 'davidlee0248', 'david.garzonrangel', 'arosmith3', 'doskoooo', 'seiser2']",30,"['rafaelalfonsorodriguezc', 'crisiberny', 'jj.gonzalez2491', 'pc.combariza2656', 'cristhiansanchez94', 'andresleonardo.osorio', 'juanpabloaa21', 'danherrera06', 'keitarokusanagi', 'perri1612', 'je.pestana', 'rz.carlos10', 'ca.acosta977', 'cdaza933', 'jf.velandia10', 'nicman16216', 'oi.torres135', 'ca.padilla', 'antonioguzmanp', None, 'jcrincon29', 'clavix2', 'cristina123', 'ya.africano', 'camilom', 'segova8', 'regis.rodriguez2', 'alexei.rodriguez.102', 'estebangutierrezs', 'ml.corredor466']",49,"['rafaelalfonsorodriguezc', 'crisiberny', 'jj.gonzalez2491', 'pc.combariza2656', 'sid.sethupathi', 'apamapam', 'cristhiansanchez94', 'andresleonardo.osorio', 'juanpabloaa21', 'danherrera06', 'larruibo', 'keitarokusanagi', 'doskoooo', 'perri1612', 'je.pestana', 'rz.carlos10', 'tomqin93', 'repreman', 'lyluyaoh', 'davidlee0248', 'ca.acosta977', 'cristiandimas', 'arosmith3', 'lina320', 'cdaza933', 'jf.velandia10', 'nicman16216', 'sebastovar', 'oi.torres135', 'lumarin', 'ca.padilla', 'david.garzonrangel', 'antonioguzmanp', None, 'seiser2', 'nesp215', 'mariapaulavivas', 'jcrincon29', 'clavix2', 'cristina123', 'ya.africano', 'camilom', 'jhou6', 'segova8', 'regis.rodriguez2', 'alexei.rodriguez.102', 'estebangutierrezs', 'jdcasadiego', 'ml.corredor466']"
25,199,20,21,1,['apamapam'],18,"['nesp215', 'mariapaulavivas', 'sid.sethupathi', 'cristiandimas', 'sebastovar', 'tomqin93', 'jhou6', 'repreman', 'lumarin', 'lyluyaoh', 'davidlee0248', 'david.garzonrangel', 'jdcasadiego', 'larruibo', 'arosmith3', 'doskoooo', 'seiser2', 'lina320']",20,"['duranma2', 'himelic2', 'wilner2', 'rahulraju93', 'tadekaw2', 'jorden.brown.54', 'zhen.mike', 'siravar2', 'chanatr2', 'rigotech', 'davidzhao26', 'js574', 'fhismail', None, 'fermat', 'psahgal', 'davidservose', 'dillon', 'bolesta2', 'jiranun2']",39,"['duranma2', 'sid.sethupathi', 'apamapam', 'himelic2', 'wilner2', 'larruibo', 'rahulraju93', 'doskoooo', 'tadekaw2', 'tomqin93', 'repreman', 'lyluyaoh', 'davidlee0248', 'cristiandimas', 'arosmith3', 'lina320', 'jorden.brown.54', 'zhen.mike', 'sebastovar', 'siravar2', 'chanatr2', 'lumarin', 'rigotech', 'davidzhao26', 'david.garzonrangel', 'js574', 'fhismail', None, 'fermat', 'seiser2', 'psahgal', 'nesp215', 'davidservose', 'mariapaulavivas', 'dillon', 'bolesta2', 'jiranun2', 'jhou6', 'jdcasadiego']"
25,200,20,11,1,['doskoooo'],18,"['nesp215', 'mariapaulavivas', 'sid.sethupathi', 'apamapam', 'cristiandimas', 'sebastovar', 'tomqin93', 'jhou6', 'repreman', 'lumarin', 'lyluyaoh', 'davidlee0248', 'david.garzonrangel', 'jdcasadiego', 'larruibo', 'arosmith3', 'seiser2', 'lina320']",10,"['mika_mkia', 'amurthy26', 'baur728', 'apcomic', 'matthewvilim', 'srosenje', 'ryan.tompkins22', 'rustem.burkhanov', None, 'bwpmail']",29,"['mika_mkia', 'sid.sethupathi', 'apamapam', 'cristiandimas', 'bwpmail', 'sebastovar', 'matthewvilim', 'lumarin', 'ryan.tompkins22', 'david.garzonrangel', 'larruibo', None, 'doskoooo', 'seiser2', 'nesp215', 'mariapaulavivas', 'amurthy26', 'baur728', 'apcomic', 'tomqin93', 'jhou6', 'repreman', 'srosenje', 'lyluyaoh', 'davidlee0248', 'jdcasadiego', 'rustem.burkhanov', 'arosmith3', 'lina320']"
25,197,20,8,2,"['jdcasadiego', 'mariapaulavivas']",17,"['nesp215', 'sid.sethupathi', 'apamapam', 'cristiandimas', 'sebastovar', 'tomqin93', 'jhou6', 'repreman', 'lumarin', 'lyluyaoh', 'davidlee0248', 'david.garzonrangel', 'larruibo', 'arosmith3', 'doskoooo', 'seiser2', 'lina320']",6,"['careyes1787', 'garcia_', 'natscarrasco', 'ej.araujo', None, 'juseus']",25,"['sid.sethupathi', 'apamapam', 'cristiandimas', 'careyes1787', 'sebastovar', 'garcia_', 'lumarin', 'david.garzonrangel', 'larruibo', 'ej.araujo', None, 'doskoooo', 'seiser2', 'juseus', 'nesp215', 'mariapaulavivas', 'tomqin93', 'jhou6', 'repreman', 'natscarrasco', 'lyluyaoh', 'davidlee0248', 'jdcasadiego', 'arosmith3', 'lina320']"
26,115,20,12,9,"['jmontes8', 'jcvicente', 'mfflorescacho', 'drflores2', 'rmessina', 'lrod1989', 'ahernandez71', 'shopgirl052202', 'etmaestas']",10,"['rganguli', 'tuppai', 'manju070584', 'szymon.sollamidelekta', 'nlarsso', 'markushont', 'pepebarbacoa', 'helugo', 'bbk', 'aarone']",3,"[None, 'stella', 'nibarra2']",22,"['rganguli', 'tuppai', 'manju070584', 'szymon.sollamidelekta', 'mfflorescacho', 'markushont', 'pepebarbacoa', 'drflores2', 'helugo', 'rmessina', 'lrod1989', 'aarone', None, 'nibarra2', 'jmontes8', 'jcvicente', 'nlarsso', 'stella', 'bbk', 'ahernandez71', 'shopgirl052202', 'etmaestas']"
26,113,20,10,7,"['jmontes8', 'jcvicente', 'drflores2', 'helugo', 'rmessina', 'shopgirl052202', 'etmaestas']",12,"['rganguli', 'tuppai', 'manju070584', 'szymon.sollamidelekta', 'mfflorescacho', 'nlarsso', 'markushont', 'pepebarbacoa', 'bbk', 'aarone', 'lrod1989', 'ahernandez71']",3,"[None, 'nibarra2', 'cgaytan2']",22,"['rganguli', 'tuppai', 'manju070584', 'szymon.sollamidelekta', 'mfflorescacho', 'markushont', 'pepebarbacoa', 'drflores2', 'helugo', 'rmessina', 'lrod1989', 'aarone', None, 'nibarra2', 'jmontes8', 'jcvicente', 'nlarsso', 'cgaytan2', 'bbk', 'ahernandez71', 'shopgirl052202', 'etmaestas']"
26,13,20,9,1,['szymon.sollamidelekta'],18,"['jmontes8', 'rganguli', 'tuppai', 'manju070584', 'jcvicente', 'mfflorescacho', 'nlarsso', 'markushont', 'pepebarbacoa', 'drflores2', 'helugo', 'rmessina', 'bbk', 'aarone', 'lrod1989', 'ahernandez71', 'shopgirl052202', 'etmaestas']",8,"['saralaji006', 'bellmanz', 'micarl', 'katayoun.zahmatkesh', None, 'arash83', 'behnam0o', 'farazkhavari']",27,"['rganguli', 'tuppai', 'manju070584', 'szymon.sollamidelekta', 'mfflorescacho', 'markushont', 'bellmanz', 'pepebarbacoa', 'drflores2', 'helugo', 'rmessina', 'lrod1989', 'aarone', None, 'farazkhavari', 'jmontes8', 'jcvicente', 'saralaji006', 'nlarsso', 'micarl', 'katayoun.zahmatkesh', 'bbk', 'ahernandez71', 'shopgirl052202', 'arash83', 'behnam0o', 'etmaestas']"
26,117,20,7,4,"['nlarsso', 'bbk', 'aarone', 'markushont']",15,"['jmontes8', 'rganguli', 'tuppai', 'manju070584', 'szymon.sollamidelekta', 'jcvicente', 'mfflorescacho', 'pepebarbacoa', 'drflores2', 'helugo', 'rmessina', 'lrod1989', 'ahernandez71', 'shopgirl052202', 'etmaestas']",3,"['shuoben', None, 'ahdefga']",22,"['rganguli', 'tuppai', 'manju070584', 'szymon.sollamidelekta', 'mfflorescacho', 'markushont', 'shuoben', 'pepebarbacoa', 'drflores2', 'helugo', 'rmessina', 'lrod1989', 'aarone', None, 'jmontes8', 'jcvicente', 'ahdefga', 'nlarsso', 'bbk', 'ahernandez71', 'shopgirl052202', 'etmaestas']"
27,41,20,33,16,"['michal22', 'xlakom03', 'jarda', 'daniel1appel', 'rastislavcervenak', 'masty', 'hak.david', 'xkarli04', 'xjuric20', 'byvoko', 'mhoryna', 'jak36', 'lukas5452', 'xkocik00', 'xstrit06', 'blaha.vita']",3,"['maja90', 'mik652', 'jerro66']",17,"['malsik1234', 'xzicha02', 'xstejs19', 'inferno91', 'kubatzdenek', 'cibulator', 'xgilik00', 'filipkovac', 'sere_pes', 'wlady', 'jbrukner', 'weisslukas90', 'xmasar09', None, 'martin1991', 'tomas.cicmansky', 'kubrrrt']",36,"['inferno91', 'xjuric20', 'xmasar09', 'maja90', 'michal22', 'xlakom03', 'xzicha02', 'jarda', 'cibulator', 'masty', 'hak.david', 'xkarli04', 'byvoko', 'jbrukner', 'xstrit06', 'martin1991', 'malsik1234', 'xstejs19', 'daniel1appel', 'kubatzdenek', 'xgilik00', 'filipkovac', 'mhoryna', 'wlady', 'jak36', 'lukas5452', 'weisslukas90', 'mik652', None, 'tomas.cicmansky', 'kubrrrt', 'jerro66', 'sere_pes', 'rastislavcervenak', 'xkocik00', 'blaha.vita']"
27,175,20,33,19,"['xjuric20', 'maja90', 'michal22', 'xlakom03', 'jarda', 'masty', 'hak.david', 'xkarli04', 'byvoko', 'xstrit06', 'daniel1appel', 'mhoryna', 'jak36', 'lukas5452', 'mik652', 'jerro66', 'rastislavcervenak', 'xkocik00', 'blaha.vita']",0,[],14,"['fuckerregistations', 'xzicha02', 'xstejs19', 'inferno91', 'sere_pes', 'filipkovac', 'dopitak32', 'wlady', 'pavelbortlik', 'weisslukas90', None, 'martin1991', 'holcik.m', 'kubrrrt']",33,"['fuckerregistations', 'inferno91', 'xjuric20', 'maja90', 'michal22', 'xlakom03', 'xzicha02', 'jarda', 'masty', 'hak.david', 'xkarli04', 'byvoko', 'pavelbortlik', 'xstrit06', 'martin1991', 'xstejs19', 'daniel1appel', 'filipkovac', 'mhoryna', 'wlady', 'jak36', 'lukas5452', 'weisslukas90', 'mik652', None, 'holcik.m', 'kubrrrt', 'jerro66', 'sere_pes', 'rastislavcervenak', 'dopitak32', 'xkocik00', 'blaha.vita']"
27,104,20,27,16,"['michal22', 'xlakom03', 'jerro66', 'daniel1appel', 'rastislavcervenak', 'masty', 'xkocik00', 'xkarli04', 'xjuric20', 'byvoko', 'mhoryna', 'lukas5452', 'xstrit06', 'maja90', 'mik652', 'blaha.vita']",3,"['jak36', 'hak.david', 'jarda']",11,"['fuckerregistations', 'malsik1234', 'elellael', 'xstejs19', 'kubatzdenek', 'sere_pes', 'dopitak32', 'roman.krej', 'xmasar09', None, 'martin1991']",30,"['fuckerregistations', 'elellael', 'xjuric20', 'xmasar09', 'maja90', 'michal22', 'xlakom03', 'jarda', 'masty', 'hak.david', 'xkarli04', 'byvoko', 'roman.krej', 'xstrit06', 'martin1991', 'malsik1234', 'xstejs19', 'daniel1appel', 'kubatzdenek', 'mhoryna', 'jak36', 'lukas5452', 'mik652', None, 'jerro66', 'sere_pes', 'rastislavcervenak', 'dopitak32', 'xkocik00', 'blaha.vita']"
27,150,20,27,16,"['michal22', 'xlakom03', 'jerro66', 'daniel1appel', 'rastislavcervenak', 'masty', 'xkocik00', 'xkarli04', 'xjuric20', 'byvoko', 'mhoryna', 'lukas5452', 'xstrit06', 'maja90', 'mik652', 'blaha.vita']",3,"['jak36', 'hak.david', 'jarda']",11,"['fuckerregistations', 'malsik1234', 'elellael', 'xstejs19', 'kubatzdenek', 'sere_pes', 'dopitak32', 'roman.krej', 'xmasar09', None, 'martin1991']",30,"['fuckerregistations', 'elellael', 'xjuric20', 'xmasar09', 'maja90', 'michal22', 'xlakom03', 'jarda', 'masty', 'hak.david', 'xkarli04', 'byvoko', 'roman.krej', 'xstrit06', 'martin1991', 'malsik1234', 'xstejs19', 'daniel1appel', 'kubatzdenek', 'mhoryna', 'jak36', 'lukas5452', 'mik652', None, 'jerro66', 'sere_pes', 'rastislavcervenak', 'dopitak32', 'xkocik00', 'blaha.vita']"
27,29,20,25,16,"['xlakom03', 'jarda', 'daniel1appel', 'jerro66', 'rastislavcervenak', 'masty', 'hak.david', 'xkocik00', 'xjuric20', 'byvoko', 'jak36', 'lukas5452', 'xstrit06', 'maja90', 'mik652', 'blaha.vita']",3,"['michal22', 'xkarli04', 'mhoryna']",9,"['xgilik00', 'filipkovac', 'cibulator', 'dopitak32', 'wlady', 'xmasar09', 'xvesel56', None, 'tomas.cicmansky']",28,"['xjuric20', 'xmasar09', 'maja90', 'xvesel56', 'michal22', 'xlakom03', 'jarda', 'cibulator', 'masty', 'hak.david', 'xkarli04', 'byvoko', 'xstrit06', 'daniel1appel', 'xgilik00', 'filipkovac', 'mhoryna', 'wlady', 'jak36', 'lukas5452', 'mik652', None, 'tomas.cicmansky', 'jerro66', 'rastislavcervenak', 'dopitak32', 'xkocik00', 'blaha.vita']"
27,185,20,13,9,"['michal22', 'jarda', 'daniel1appel', 'rastislavcervenak', 'hak.david', 'xjuric20', 'byvoko', 'mhoryna', 'mik652']",10,"['xlakom03', 'jerro66', 'xkocik00', 'masty', 'xkarli04', 'jak36', 'lukas5452', 'xstrit06', 'maja90', 'blaha.vita']",4,"['kubatzdenek', 'xvesel56', 'xzicha02', None]",23,"['daniel1appel', 'kubatzdenek', 'xjuric20', 'mhoryna', 'jak36', 'lukas5452', 'maja90', 'mik652', 'xvesel56', None, 'michal22', 'xlakom03', 'xzicha02', 'jarda', 'jerro66', 'rastislavcervenak', 'masty', 'hak.david', 'xkarli04', 'byvoko', 'xkocik00', 'xstrit06', 'blaha.vita']"
27,189,20,13,5,"['xlakom03', 'jerro66', 'masty', 'jak36', 'maja90']",14,"['michal22', 'jarda', 'daniel1appel', 'rastislavcervenak', 'hak.david', 'xkarli04', 'xjuric20', 'byvoko', 'mhoryna', 'lukas5452', 'xkocik00', 'xstrit06', 'mik652', 'blaha.vita']",8,"['malsik1234', 'xstejs19', 'inferno91', 'cibulator', 'wlady', 'jbrukner', 'xmasar09', None]",27,"['malsik1234', 'xstejs19', 'inferno91', 'daniel1appel', 'xjuric20', 'mhoryna', 'wlady', 'jak36', 'lukas5452', 'xmasar09', 'maja90', 'mik652', None, 'michal22', 'xlakom03', 'jarda', 'jerro66', 'cibulator', 'rastislavcervenak', 'masty', 'hak.david', 'xkarli04', 'byvoko', 'jbrukner', 'xkocik00', 'xstrit06', 'blaha.vita']"
27,190,20,11,6,"['michal22', 'jarda', 'daniel1appel', 'hak.david', 'xjuric20', 'mhoryna']",13,"['xlakom03', 'jerro66', 'rastislavcervenak', 'masty', 'xkocik00', 'xkarli04', 'byvoko', 'jak36', 'lukas5452', 'xstrit06', 'maja90', 'mik652', 'blaha.vita']",5,"['xzicha02', 'kubatzdenek', 'xvesel56', None, 'm4w3r1ck']",24,"['daniel1appel', 'kubatzdenek', 'xjuric20', 'mhoryna', 'jak36', 'lukas5452', 'maja90', 'mik652', 'xvesel56', None, 'michal22', 'xlakom03', 'xzicha02', 'jarda', 'jerro66', 'rastislavcervenak', 'masty', 'hak.david', 'xkarli04', 'byvoko', 'xkocik00', 'xstrit06', 'm4w3r1ck', 'blaha.vita']"
27,103,20,10,1,['jarda'],18,"['michal22', 'xlakom03', 'jerro66', 'daniel1appel', 'rastislavcervenak', 'masty', 'hak.david', 'xkarli04', 'xjuric20', 'byvoko', 'mhoryna', 'xkocik00', 'jak36', 'lukas5452', 'xstrit06', 'maja90', 'mik652', 'blaha.vita']",9,"['lw', 'aranid', 'mr.martix', 'tomas.cicmansky', 'pavelbortlik', 'xvesel56', None, 'holcik.m', 'kubrrrt']",28,"['lw', 'aranid', 'daniel1appel', 'xjuric20', 'mhoryna', 'jak36', 'lukas5452', 'maja90', 'mik652', 'xvesel56', None, 'holcik.m', 'tomas.cicmansky', 'kubrrrt', 'michal22', 'xlakom03', 'jarda', 'jerro66', 'mr.martix', 'rastislavcervenak', 'masty', 'hak.david', 'xkarli04', 'byvoko', 'pavelbortlik', 'xkocik00', 'xstrit06', 'blaha.vita']"
27,186,20,6,2,"['xstrit06', 'xkarli04']",17,"['michal22', 'xlakom03', 'jarda', 'daniel1appel', 'jerro66', 'rastislavcervenak', 'masty', 'hak.david', 'xjuric20', 'byvoko', 'mhoryna', 'jak36', 'lukas5452', 'xkocik00', 'maja90', 'mik652', 'blaha.vita']",4,"['tomas.cicmansky', 'xgilik00', None, 'holcik.m']",23,"['daniel1appel', 'xgilik00', 'xjuric20', 'mhoryna', 'jak36', 'lukas5452', 'maja90', 'mik652', None, 'holcik.m', 'tomas.cicmansky', 'michal22', 'xlakom03', 'jarda', 'jerro66', 'rastislavcervenak', 'masty', 'hak.david', 'xkarli04', 'byvoko', 'xkocik00', 'xstrit06', 'blaha.vita']"
27,206,20,6,2,"['xstrit06', 'xkarli04']",17,"['michal22', 'xlakom03', 'jarda', 'daniel1appel', 'jerro66', 'rastislavcervenak', 'masty', 'hak.david', 'xjuric20', 'byvoko', 'mhoryna', 'jak36', 'lukas5452', 'xkocik00', 'maja90', 'mik652', 'blaha.vita']",4,"['tomas.cicmansky', 'xgilik00', None, 'holcik.m']",23,"['daniel1appel', 'xgilik00', 'xjuric20', 'mhoryna', 'jak36', 'lukas5452', 'maja90', 'mik652', None, 'holcik.m', 'tomas.cicmansky', 'michal22', 'xlakom03', 'jarda', 'jerro66', 'rastislavcervenak', 'masty', 'hak.david', 'xkarli04', 'byvoko', 'xkocik00', 'xstrit06', 'blaha.vita']"
28,196,19,37,11,"['crisiberny', 'jj.gonzalez2491', 'je.pestana', 'cristhiansanchez94', 'clavix2', 'cristina123', 'oi.torres135', 'ca.acosta977', 'alexei.rodriguez.102', 'estebangutierrezs', 'keitarokusanagi']",7,"['garcia_', 'natscarrasco', 'af.villamil231', 'andresr06', 'juancamilosh', 'ej.araujo', 'juseus']",26,"['rafaelalfonsorodriguezc', 'pc.combariza2656', 'andresleonardo.osorio', 'juanpabloaa21', 'danherrera06', 'larruibo', 'perri1612', 'rz.carlos10', 'repreman', 'cristiandimas', 'lina320', 'cdaza933', 'jf.velandia10', 'nicman16216', 'sebastovar', 'lumarin', 'ca.padilla', 'antonioguzmanp', None, 'jcrincon29', 'ya.africano', 'camilom', 'segova8', 'regis.rodriguez2', 'jdcasadiego', 'ml.corredor466']",44,"['rafaelalfonsorodriguezc', 'crisiberny', 'jj.gonzalez2491', 'pc.combariza2656', 'cristhiansanchez94', 'andresleonardo.osorio', 'juanpabloaa21', 'andresr06', 'danherrera06', 'larruibo', 'keitarokusanagi', 'perri1612', 'juseus', 'je.pestana', 'rz.carlos10', 'natscarrasco', 'repreman', 'ca.acosta977', 'cristiandimas', 'lina320', 'cdaza933', 'jf.velandia10', 'nicman16216', 'sebastovar', 'oi.torres135', 'garcia_', 'af.villamil231', 'lumarin', 'ca.padilla', 'juancamilosh', 'ej.araujo', 'antonioguzmanp', None, 'jcrincon29', 'clavix2', 'cristina123', 'ya.africano', 'camilom', 'segova8', 'alexei.rodriguez.102', 'estebangutierrezs', 'regis.rodriguez2', 'jdcasadiego', 'ml.corredor466']"
28,100,19,32,17,"['crisiberny', 'jj.gonzalez2491', 'je.pestana', 'cristhiansanchez94', 'clavix2', 'cristina123', 'oi.torres135', 'garcia_', 'natscarrasco', 'af.villamil231', 'andresr06', 'ca.acosta977', 'estebangutierrezs', 'juancamilosh', 'ej.araujo', 'keitarokusanagi', 'juseus']",1,['alexei.rodriguez.102'],15,"['julian321', 'cdaza933', 'ruedagato4t0', 'juanbustamante', 'jorgeelpollodiaz', 'jcrincon29', 'ya.africano', 'quillen', 'camilom', 'juanpabloaa21', 'anferesa1', 'maldoedisson', 'felipesua', None, 'ml.corredor466']",33,"['crisiberny', 'jj.gonzalez2491', 'juanbustamante', 'cristhiansanchez94', 'juanpabloaa21', 'andresr06', 'maldoedisson', 'keitarokusanagi', 'juseus', 'je.pestana', 'quillen', 'natscarrasco', 'ca.acosta977', 'cdaza933', 'jorgeelpollodiaz', 'oi.torres135', 'garcia_', 'anferesa1', 'af.villamil231', 'juancamilosh', 'ej.araujo', 'felipesua', None, 'julian321', 'ruedagato4t0', 'jcrincon29', 'clavix2', 'cristina123', 'ya.africano', 'camilom', 'alexei.rodriguez.102', 'estebangutierrezs', 'ml.corredor466']"
28,204,19,32,18,"['crisiberny', 'jj.gonzalez2491', 'je.pestana', 'cristhiansanchez94', 'clavix2', 'cristina123', 'oi.torres135', 'garcia_', 'natscarrasco', 'af.villamil231', 'andresr06', 'ca.acosta977', 'alexei.rodriguez.102', 'estebangutierrezs', 'juancamilosh', 'ej.araujo', 'keitarokusanagi', 'juseus']",0,[],14,"['julian321', 'cdaza933', 'ruedagato4t0', 'juanbustamante', 'nicman16216', 'jorgeelpollodiaz', 'jcrincon29', 'ya.africano', 'quillen', 'camilom', 'anferesa1', 'felipesua', None, 'ml.corredor466']",32,"['crisiberny', 'jj.gonzalez2491', 'juanbustamante', 'cristhiansanchez94', 'andresr06', 'keitarokusanagi', 'juseus', 'je.pestana', 'quillen', 'natscarrasco', 'ca.acosta977', 'cdaza933', 'jorgeelpollodiaz', 'nicman16216', 'oi.torres135', 'garcia_', 'anferesa1', 'af.villamil231', 'juancamilosh', 'ej.araujo', 'felipesua', None, 'julian321', 'ruedagato4t0', 'jcrincon29', 'clavix2', 'cristina123', 'ya.africano', 'camilom', 'alexei.rodriguez.102', 'estebangutierrezs', 'ml.corredor466']"
28,27,19,26,12,"['crisiberny', 'jj.gonzalez2491', 'je.pestana', 'cristhiansanchez94', 'cristina123', 'oi.torres135', 'garcia_', 'andresr06', 'estebangutierrezs', 'juancamilosh', 'ej.araujo', 'keitarokusanagi']",6,"['clavix2', 'natscarrasco', 'af.villamil231', 'alexei.rodriguez.102', 'ca.acosta977', 'juseus']",14,"['rafaelalfonsorodriguezc', 'pc.combariza2656', 'rz.carlos10', 'jf.velandia10', 'careyes1787', 'juanpabloaa21', 'danielcarrillo602', 'segova8', 'danherrera06', 'ca.padilla', 'crisebas', 'cm.pedraza161', None, 'ml.corredor466']",32,"['rafaelalfonsorodriguezc', 'crisiberny', 'jj.gonzalez2491', 'pc.combariza2656', 'cristhiansanchez94', 'careyes1787', 'juanpabloaa21', 'danielcarrillo602', 'andresr06', 'danherrera06', 'cm.pedraza161', 'keitarokusanagi', 'juseus', 'je.pestana', 'rz.carlos10', 'natscarrasco', 'ca.acosta977', 'jf.velandia10', 'oi.torres135', 'garcia_', 'af.villamil231', 'ca.padilla', 'juancamilosh', 'ej.araujo', 'crisebas', None, 'clavix2', 'cristina123', 'segova8', 'alexei.rodriguez.102', 'estebangutierrezs', 'ml.corredor466']"
28,197,19,8,4,"['ej.araujo', 'natscarrasco', 'juseus', 'garcia_']",14,"['crisiberny', 'jj.gonzalez2491', 'je.pestana', 'cristhiansanchez94', 'clavix2', 'cristina123', 'oi.torres135', 'af.villamil231', 'andresr06', 'ca.acosta977', 'alexei.rodriguez.102', 'estebangutierrezs', 'juancamilosh', 'keitarokusanagi']",4,"['jdcasadiego', None, 'careyes1787', 'mariapaulavivas']",22,"['crisiberny', 'jj.gonzalez2491', 'cristhiansanchez94', 'careyes1787', 'oi.torres135', 'garcia_', 'af.villamil231', 'andresr06', 'juancamilosh', 'ej.araujo', 'keitarokusanagi', None, 'juseus', 'je.pestana', 'mariapaulavivas', 'clavix2', 'cristina123', 'natscarrasco', 'ca.acosta977', 'alexei.rodriguez.102', 'estebangutierrezs', 'jdcasadiego']"
29,90,16,25,15,"['mw2_mctavish', 'xgtxgt', 'shogo', 'collage_name', 'himajin_2nd', 'sora', 'g1215110', 'tsubasa', 'ten', 'hirooda', 'yusuketakada', 'g1215012', 'o3o3m7m7', 'g1215028', 'mossim']",0,[],10,"['taikitakada', 'araijunnya', 'sakurayuu', 'g1215108', 'shirotoru', 'g1115036', 'marui', 'a1215084', 'toshitarou', None]",25,"['araijunnya', 'shirotoru', 'g1215110', 'tsubasa', 'ten', 'marui', 'g1215012', 'a1215084', 'taikitakada', 'sakurayuu', 'g1215108', 'hirooda', 'mossim', 'mw2_mctavish', 'toshitarou', None, 'g1215028', 'collage_name', 'xgtxgt', 'shogo', 'himajin_2nd', 'sora', 'g1115036', 'yusuketakada', 'o3o3m7m7']"
30,212,16,16,14,"['saniyaleblanc', 'hernandezkatheryne', 'austinwang', 'jichizhang', 'csickel', 'mike8592', 'mingzi000', 'jjj262', 'jevonsshi9', 'txian226', 'limao88', 'chasevjohnson', 'benholmes', 'ddibachi']",1,['slothloveschunk2006'],2,"['h0mesickange1', None]",17,"['csickel', 'limao88', None, 'ddibachi', 'saniyaleblanc', 'hernandezkatheryne', 'austinwang', 'jichizhang', 'mike8592', 'mingzi000', 'jjj262', 'slothloveschunk2006', 'jevonsshi9', 'txian226', 'chasevjohnson', 'h0mesickange1', 'benholmes']"
30,213,16,7,5,"['saniyaleblanc', 'mike8592', 'csickel', 'jevonsshi9', 'limao88']",10,"['hernandezkatheryne', 'austinwang', 'mingzi000', 'jichizhang', 'jjj262', 'slothloveschunk2006', 'txian226', 'chasevjohnson', 'benholmes', 'ddibachi']",2,"['h0mesickange1', None]",17,"['csickel', 'limao88', None, 'ddibachi', 'saniyaleblanc', 'hernandezkatheryne', 'austinwang', 'jichizhang', 'mike8592', 'mingzi000', 'jjj262', 'slothloveschunk2006', 'jevonsshi9', 'txian226', 'chasevjohnson', 'h0mesickange1', 'benholmes']"
31,179,15,45,14,"['miguel.saldana.395017', 'lcoronado', 'nfalcon2015', 'kite9450', 'pvelarde', 'sbaca2', 'jcande_21', 'danny62217', 'dasmith4', 'ashapgood', 'rrivera19', 'junknexus', 'oalopez', 'richard.yanez.90']",0,[],31,"['acastro007', 'iflores10', 'ereyes12', 'joseeugade', 'mfmartinez3', 'frhernandez3', 'masanchez19', 'dhramirez2', 'disturbedones60', 'vitorres', 'dakerstiens', 'mbijan', 'trixhnd', 'bdkern', 'jbarron5', 'larissatv.lt', 'ebustamante3', 'amdelarosa2', 'orlandogomez', 'lmedina92', 'isaac_demon', None, 'recarmonab', 'asoto21', 'jahernandez35', 'christianfwolters', 'jgortega3', 'luis.cangas', 'gsilva5', 'crfriedman', 'iazarate50']",45,"['acastro007', 'iflores10', 'ereyes12', 'nfalcon2015', 'pvelarde', 'joseeugade', 'gsilva5', 'mfmartinez3', 'frhernandez3', 'masanchez19', 'iazarate50', 'dhramirez2', 'richard.yanez.90', 'miguel.saldana.395017', 'disturbedones60', 'vitorres', 'dakerstiens', 'mbijan', 'trixhnd', 'bdkern', 'jbarron5', 'larissatv.lt', 'kite9450', 'ebustamante3', 'jcande_21', 'amdelarosa2', 'danny62217', 'orlandogomez', 'ashapgood', 'lmedina92', 'isaac_demon', None, 'oalopez', 'asoto21', 'recarmonab', 'lcoronado', 'jahernandez35', 'christianfwolters', 'jgortega3', 'sbaca2', 'luis.cangas', 'rrivera19', 'junknexus', 'crfriedman', 'dasmith4']"
31,192,15,30,14,"['miguel.saldana.395017', 'lcoronado', 'nfalcon2015', 'kite9450', 'pvelarde', 'sbaca2', 'jcande_21', 'danny62217', 'dasmith4', 'ashapgood', 'rrivera19', 'junknexus', 'oalopez', 'richard.yanez.90']",0,[],16,"['iflores10', 'disturbedones60', 'ereyes12', 'christianfwolters', 'jgortega3', 'ebustamante3', 'joseeugade', 'crfriedman', 'masanchez19', 'vitorres', 'mbijan', 'trixhnd', None, 'larissatv.lt', 'recarmonab', 'asoto21']",30,"['iflores10', 'ereyes12', 'nfalcon2015', 'pvelarde', 'joseeugade', 'masanchez19', 'richard.yanez.90', 'miguel.saldana.395017', 'disturbedones60', 'vitorres', 'mbijan', 'trixhnd', 'larissatv.lt', 'kite9450', 'ebustamante3', 'jcande_21', 'danny62217', 'ashapgood', None, 'oalopez', 'recarmonab', 'asoto21', 'lcoronado', 'christianfwolters', 'jgortega3', 'sbaca2', 'rrivera19', 'junknexus', 'crfriedman', 'dasmith4']"
32,108,15,13,10,"['zp2151', 'dalianyangshu', 'seonjaekim88', 'jiwonp224', 'pam2175', 'my2404', 'chris8', 'taegjin87', '1991ivanzhang', 'argall.aj']",4,"['jrothenberg', 'rsaravanan', 'bl2463', 'rbleak']",3,"['hsnix.kim', None, 'blueeac']",17,"['rbleak', 'seonjaekim88', 'hsnix.kim', 'chris8', 'taegjin87', None, 'argall.aj', 'bl2463', 'dalianyangshu', 'jiwonp224', 'pam2175', 'my2404', 'blueeac', 'rsaravanan', 'jrothenberg', '1991ivanzhang', 'zp2151']"
33,250,14,26,10,"['gvr', 'khalid.its.me', 'jpmathis', 'skramad', 'george.hargenrader', 'nathort13', 'ldzuniga', 'timzhang', 'dsoltan', 'tge']",3,"['croop', 'allamour', 'yoonseob']",16,"['aunnie', 'chadak', 'joannamm', 'xuxun', 'chuenlai', 'caifuxi', 'ringoh', 'coolhighschoolloser', 'amritarc', 'tccykkkk', 'zhihua.huang.77', 'shaunj', 'wangzt', 'qcb', None, 'shoshaz1']",29,"['aunnie', 'caifuxi', 'chuenlai', 'tccykkkk', 'zhihua.huang.77', 'yoonseob', 'shaunj', 'wangzt', 'khalid.its.me', 'chadak', 'dsoltan', 'joannamm', 'croop', 'coolhighschoolloser', 'amritarc', 'gvr', 'xuxun', 'ringoh', 'nathort13', 'timzhang', 'allamour', 'qcb', 'tge', None, 'shoshaz1', 'jpmathis', 'skramad', 'george.hargenrader', 'ldzuniga']"
33,172,14,25,12,"['gvr', 'khalid.its.me', 'croop', 'jpmathis', 'skramad', 'george.hargenrader', 'yoonseob', 'nathort13', 'timzhang', 'allamour', 'dsoltan', 'tge']",1,['ldzuniga'],13,"['aunnie', 'joannamm', 'tmushove', 'chuenlai', 'caifuxi', 'ringoh', 'songkaixin', 'zhihua.huang.77', 'shaunj', 'chadak', 'ekhera', 'qcb', None]",26,"['aunnie', 'caifuxi', 'chuenlai', 'zhihua.huang.77', 'yoonseob', 'shaunj', 'chadak', 'khalid.its.me', 'dsoltan', 'joannamm', 'croop', 'ekhera', 'gvr', 'tmushove', 'ringoh', 'nathort13', 'timzhang', 'allamour', 'qcb', 'tge', None, 'jpmathis', 'skramad', 'george.hargenrader', 'ldzuniga', 'songkaixin']"
33,42,14,20,13,"['gvr', 'khalid.its.me', 'croop', 'jpmathis', 'skramad', 'george.hargenrader', 'yoonseob', 'nathort13', 'ldzuniga', 'timzhang', 'allamour', 'dsoltan', 'tge']",0,[],7,"['aunnie', 'joannamm', 'xuxun', 'caifuxi', 'sarang.umarji', 'qcb', None]",20,"['aunnie', 'caifuxi', 'sarang.umarji', 'yoonseob', 'khalid.its.me', 'dsoltan', 'joannamm', 'croop', 'gvr', 'xuxun', 'nathort13', 'timzhang', 'allamour', 'qcb', 'tge', None, 'jpmathis', 'skramad', 'george.hargenrader', 'ldzuniga']"
34,46,14,93,13,"['ssdlabs', 'sadiameeran', 'mariakanwal', 'aabiya.mansoor', 'yousra', 'ali25', 'arham', 'sidrakanwal', 'tahreem', 'sidrah.126', 'arshiahafeez', 'alishariq9', 'maisra']",0,[],80,"['arisha.binte.ishrat', 'tjfonn', 'sidrah.mukhi', 'ifrahashraf', 'wahaba', 'anum.7', 'daniyal_zakaria', 'aneeba', 'warda26', 'rabiya.tabassum.31', 'el043', 'billal', 'bilalkhalideleng', 'hoora', 'sayyeda.umbereen', 'iqrajohim', 'faizan_hadi', 'yusramarium', 'r.kanwal', 'mazhar861992', 'jiaa', 'hk', 'jahanxaib', 'muneebnadeem92', 'ahmed_umais', 'manoj_panjwani', 'ijlal.as', 'ayeshahassan92', 'insiya.batool', 'moazza304', 'anum91', 'aimen.naz.3', 'hammad157', 'farhanali9228', 'sidragillani92', 'engrhafizirfan450yahoo.com', 'burhan.saif52', 'siddiqi', '23may199x', 'anumbasheer22', 'mehreen.mehmood', 'asmamahar', 'syedsaadahmed', 'elecengrmka', 'kashifssiddiqui', 'sairakayani07', 'anizaaa', 'best_score92', 'el120', 'nausheenjamil', 'abber.online91', 'hafsah', 'uzaif', 'iqramanzoorjohim', 'faraz.ali47', 'daniausman', 'shfinal', 'sidra.khan.188', 'saifullah', 'kanwaalnaz', 'alvinabatool1', 'sehrishfatima', 'neev.kiran', 'fateeha.92', 'mw', 'abeera', 'theacessalman', 'ifrah_jaffri', 'hassannawaz', 'yamnazain', 'quratulainalikhan', 'javeria_abbasi', 'sweetsaimaanis', None, 'hiraimtiaz', 'imtiazhira', 'mirzafaizan.baig.129', 'shariq.khi', 'bismashaheen21', 'daniyal']",93,"['ssdlabs', 'sadiameeran', 'mariakanwal', 'arisha.binte.ishrat', 'tjfonn', 'sidrah.mukhi', 'ifrahashraf', 'alishariq9', 'wahaba', 'anum.7', 'daniyal_zakaria', 'aneeba', 'warda26', 'rabiya.tabassum.31', 'el043', 'billal', 'bilalkhalideleng', 'hoora', 'sayyeda.umbereen', 'iqrajohim', 'faizan_hadi', 'yusramarium', 'r.kanwal', 'mazhar861992', 'sidrakanwal', 'sidrah.126', 'jiaa', 'hk', 'jahanxaib', 'muneebnadeem92', 'ahmed_umais', 'manoj_panjwani', 'ijlal.as', 'ayeshahassan92', 'insiya.batool', 'moazza304', 'anum91', 'aimen.naz.3', 'hammad157', 'farhanali9228', 'aabiya.mansoor', 'sidragillani92', 'engrhafizirfan450yahoo.com', 'tahreem', 'burhan.saif52', 'siddiqi', '23may199x', 'anumbasheer22', 'yousra', 'ali25', 'mehreen.mehmood', 'asmamahar', 'syedsaadahmed', 'elecengrmka', 'kashifssiddiqui', 'sairakayani07', 'anizaaa', 'best_score92', 'el120', 'nausheenjamil', 'arshiahafeez', 'abber.online91', 'hafsah', 'uzaif', 'iqramanzoorjohim', 'faraz.ali47', 'arham', 'daniausman', 'shfinal', 'sidra.khan.188', 'saifullah', 'kanwaalnaz', 'alvinabatool1', 'sehrishfatima', 'neev.kiran', 'fateeha.92', 'mw', 'abeera', 'theacessalman', 'ifrah_jaffri', 'hassannawaz', 'yamnazain', 'quratulainalikhan', 'javeria_abbasi', 'maisra', 'sweetsaimaanis', None, 'hiraimtiaz', 'imtiazhira', 'mirzafaizan.baig.129', 'shariq.khi', 'bismashaheen21', 'daniyal']"
34,201,14,61,13,"['ssdlabs', 'sadiameeran', 'mariakanwal', 'aabiya.mansoor', 'yousra', 'ali25', 'arham', 'sidrakanwal', 'tahreem', 'sidrah.126', 'arshiahafeez', 'alishariq9', 'maisra']",0,[],48,"['mehreen.mehmood', 'arisha.binte.ishrat', 'asmamahar', 'asra.habib.71', 'sairakayani07', 'balol.kashif', 'anizaaa', 'nausheenjamil', 'loginlogin', 'anum.7', 'faraz.ali47', 'daniyal_zakaria', 'aneeba', 'sanamalik', 'warda26', 'daniausman', 'el043', 'bilalkhalideleng', 'hoora', 'sehrishfatima', 'yusramarium', 'alvina52', 'faizan_hadi', 'r.kanwal', 'fateeha.92', 'iqrajohim', 'syed.aneeba1', 'abeera', 'jiaa', 'jahanxaib', 'manoj_panjwani', 'hasieee', 'muneebnadeem92', 'ijlal.as', 'moazza304', 'javeria_abbasi', None, 'hammad157', 'hiraimtiaz', 'farhanali9228', 'mujji123', 'sidragillani92', 'naseeruddin.shinwari', 'burhan.saif52', 'bismashaheen21', 'siddiqi', 'daniyal', '23may199x']",61,"['ssdlabs', 'sadiameeran', 'mariakanwal', 'arisha.binte.ishrat', 'asra.habib.71', 'balol.kashif', 'loginlogin', 'alishariq9', 'anum.7', 'daniyal_zakaria', 'aneeba', 'warda26', 'el043', 'bilalkhalideleng', 'hoora', 'yusramarium', 'faizan_hadi', 'iqrajohim', 'r.kanwal', 'syed.aneeba1', 'sidrakanwal', 'sidrah.126', 'jiaa', 'jahanxaib', 'manoj_panjwani', 'hasieee', 'muneebnadeem92', 'ijlal.as', 'moazza304', 'hammad157', 'farhanali9228', 'aabiya.mansoor', 'mujji123', 'sidragillani92', 'tahreem', 'burhan.saif52', 'siddiqi', '23may199x', 'yousra', 'ali25', 'mehreen.mehmood', 'asmamahar', 'sairakayani07', 'anizaaa', 'nausheenjamil', 'arshiahafeez', 'faraz.ali47', 'arham', 'sanamalik', 'daniausman', 'sehrishfatima', 'alvina52', 'fateeha.92', 'abeera', 'javeria_abbasi', 'maisra', None, 'hiraimtiaz', 'naseeruddin.shinwari', 'bismashaheen21', 'daniyal']"
34,86,14,49,13,"['ssdlabs', 'sadiameeran', 'mariakanwal', 'aabiya.mansoor', 'yousra', 'ali25', 'arham', 'sidrakanwal', 'tahreem', 'sidrah.126', 'arshiahafeez', 'alishariq9', 'maisra']",0,[],36,"['mehreen.mehmood', 'arisha.binte.ishrat', 'mariummasooma', 'asmamahar', 'sairakayani07', 'sidrah.mukhi', 'nausheenjamil', 'loginlogin', 'anum.7', 'aneeba', 'sanamalik', 'warda26', 'daniausman', 'el043', 'sidra.khan.188', 'hoora', 'neev.kiran', 'yusramarium', 'faizan_hadi', 'fateeha.92', 'iqrajohim', 'syed.aneeba1', 'jiaa', 'jahanxaib', 'insiya.batool', 'moazza304', 'javeria_abbasi', None, 'hammad157', 'hiraimtiaz', 'mujji123', 'sidragillani92', 'naseeruddin.shinwari', 'burhan.saif52', 'siddiqi', 'daniyal']",49,"['ssdlabs', 'sadiameeran', 'mariakanwal', 'yousra', 'ali25', 'mehreen.mehmood', 'arisha.binte.ishrat', 'asmamahar', 'mariummasooma', 'sairakayani07', 'sidrah.mukhi', 'nausheenjamil', 'loginlogin', 'arshiahafeez', 'alishariq9', 'anum.7', 'arham', 'aneeba', 'sanamalik', 'warda26', 'daniausman', 'el043', 'sidra.khan.188', 'hoora', 'neev.kiran', 'yusramarium', 'faizan_hadi', 'fateeha.92', 'iqrajohim', 'syed.aneeba1', 'sidrakanwal', 'sidrah.126', 'jiaa', 'jahanxaib', 'insiya.batool', 'moazza304', 'javeria_abbasi', 'maisra', None, 'hammad157', 'hiraimtiaz', 'mujji123', 'aabiya.mansoor', 'sidragillani92', 'naseeruddin.shinwari', 'tahreem', 'burhan.saif52', 'siddiqi', 'daniyal']"
34,68,14,42,13,"['ssdlabs', 'sadiameeran', 'mariakanwal', 'aabiya.mansoor', 'yousra', 'ali25', 'arham', 'sidrakanwal', 'tahreem', 'sidrah.126', 'arshiahafeez', 'alishariq9', 'maisra']",0,[],29,"['mehreen.mehmood', 'arisha.binte.ishrat', 'nausheenjamil', 'abber.online91', 'anum.7', 'faraz.ali47', 'daniyal_zakaria', 'aneeba', 'sanamalik', 'warda26', 'daniausman', 'sidra.khan.188', 'hoora', 'sehrishfatima', 'yusramarium', 'fateeha.92', 'jiaa', 'jahanxaib', 'ijlal.as', 'moazza304', None, 'hiraimtiaz', 'farhanali9228', 'sidragillani92', 'naseeruddin.shinwari', 'zeeshan.adil', 'bismashaheen21', 'daniyal', '23may199x']",42,"['ssdlabs', 'sadiameeran', 'mariakanwal', 'yousra', 'ali25', 'mehreen.mehmood', 'arisha.binte.ishrat', 'nausheenjamil', 'arshiahafeez', 'alishariq9', 'abber.online91', 'anum.7', 'faraz.ali47', 'daniyal_zakaria', 'arham', 'aneeba', 'sanamalik', 'warda26', 'daniausman', 'sidra.khan.188', 'hoora', 'sehrishfatima', 'yusramarium', 'fateeha.92', 'sidrakanwal', 'sidrah.126', 'jiaa', 'jahanxaib', 'ijlal.as', 'moazza304', 'maisra', None, 'hiraimtiaz', 'farhanali9228', 'aabiya.mansoor', 'sidragillani92', 'naseeruddin.shinwari', 'tahreem', 'zeeshan.adil', 'bismashaheen21', 'daniyal', '23may199x']"
34,81,14,40,13,"['ssdlabs', 'sadiameeran', 'mariakanwal', 'aabiya.mansoor', 'yousra', 'ali25', 'arham', 'sidrakanwal', 'tahreem', 'sidrah.126', 'arshiahafeez', 'alishariq9', 'maisra']",0,[],27,"['mehreen.mehmood', 'arisha.binte.ishrat', 'asmamahar', 'sairakayani07', 'balol.kashif', 'nausheenjamil', 'anum.7', 'aneeba', 'sanamalik', 'daniausman', 'sidra.khan.188', 'hoora', 'sehrishfatima', 'yusramarium', 'iqrajohim', 'jahanxaib', 'insiya.batool', 'moazza304', 'javeria_abbasi', None, 'hiraimtiaz', 'mujji123', 'sidragillani92', 'burhan.saif52', 'bismashaheen21', 'siddiqi', 'daniyal']",40,"['ssdlabs', 'sadiameeran', 'mariakanwal', 'yousra', 'ali25', 'mehreen.mehmood', 'arisha.binte.ishrat', 'asmamahar', 'sairakayani07', 'balol.kashif', 'nausheenjamil', 'arshiahafeez', 'alishariq9', 'anum.7', 'arham', 'aneeba', 'sanamalik', 'daniausman', 'sidra.khan.188', 'hoora', 'sehrishfatima', 'yusramarium', 'iqrajohim', 'sidrakanwal', 'sidrah.126', 'jahanxaib', 'insiya.batool', 'moazza304', 'javeria_abbasi', 'maisra', None, 'hiraimtiaz', 'mujji123', 'aabiya.mansoor', 'sidragillani92', 'tahreem', 'burhan.saif52', 'bismashaheen21', 'siddiqi', 'daniyal']"
34,85,14,26,11,"['ssdlabs', 'mariakanwal', 'aabiya.mansoor', 'ali25', 'yousra', 'arham', 'tahreem', 'sidrah.126', 'arshiahafeez', 'alishariq9', 'maisra']",2,"['sadiameeran', 'sidrakanwal']",15,"['sehrishfatima', 'faizan_hadi', 'faraz.ali47', '23may199x', 'naseeruddin.shinwari', 'aneeba', 'abeera', 'sanamalik', 'daniausman', 'muneebnadeem92', 'loginlogin', 'quratulainalikhan', 'sidra.khan.188', None, 'hiraimtiaz']",28,"['ssdlabs', 'sadiameeran', 'mariakanwal', 'yousra', 'ali25', 'loginlogin', 'arshiahafeez', 'alishariq9', 'faraz.ali47', 'arham', 'aneeba', 'sanamalik', 'daniausman', 'sidra.khan.188', 'sehrishfatima', 'faizan_hadi', 'sidrakanwal', 'sidrah.126', 'abeera', 'muneebnadeem92', 'quratulainalikhan', 'maisra', None, 'hiraimtiaz', 'aabiya.mansoor', 'naseeruddin.shinwari', 'tahreem', '23may199x']"
34,70,14,19,10,"['ssdlabs', 'sadiameeran', 'yousra', 'ali25', 'arham', 'sidrakanwal', 'tahreem', 'arshiahafeez', 'alishariq9', 'maisra']",3,"['mariakanwal', 'sidrah.126', 'aabiya.mansoor']",9,"['hiramustafa1', 'hiraimtiaz', 'sanamalik', 'muneebnadeem92', 'nausheenjamil', 'bismashaheen21', 'siddiqi', None, 'hoora']",22,"['ssdlabs', 'sadiameeran', 'mariakanwal', 'yousra', 'ali25', 'nausheenjamil', 'arshiahafeez', 'alishariq9', 'arham', 'sanamalik', 'hoora', 'sidrakanwal', 'sidrah.126', 'muneebnadeem92', 'maisra', None, 'hiraimtiaz', 'hiramustafa1', 'aabiya.mansoor', 'tahreem', 'bismashaheen21', 'siddiqi']"
34,160,14,13,6,"['ssdlabs', 'yousra', 'ali25', 'arham', 'tahreem', 'alishariq9']",7,"['sadiameeran', 'mariakanwal', 'aabiya.mansoor', 'sidrah.126', 'sidrakanwal', 'arshiahafeez', 'maisra']",7,"['sehrishfatima', 'hiramustafa1', 'hoora', 'sanamalik', 'muneebnadeem92', None, 'hiraimtiaz']",20,"['ssdlabs', 'sadiameeran', 'mariakanwal', 'yousra', 'ali25', 'sehrishfatima', 'sidrakanwal', 'sidrah.126', 'muneebnadeem92', 'arshiahafeez', 'alishariq9', 'maisra', None, 'hiraimtiaz', 'hiramustafa1', 'aabiya.mansoor', 'arham', 'tahreem', 'sanamalik', 'hoora']"
35,19,13,18,12,"['yabc912', 'iiijjj222', 'hihibyebye', 'jyarika', 'jyj1895', 'kyungrock.son.75', 'yohany', 'fasterthan88', 'jjh1115kr', 'guma2020', 'choeun.park.71', 'jae7woo']",0,[],6,"['midnightsm', 'leem4230', 'njsdhd', None, 'elvlf1611', 'poby']",18,"['yabc912', 'iiijjj222', 'jyarika', 'jyj1895', 'njsdhd', None, 'elvlf1611', 'jae7woo', 'hihibyebye', 'kyungrock.son.75', 'leem4230', 'midnightsm', 'yohany', 'fasterthan88', 'jjh1115kr', 'guma2020', 'choeun.park.71', 'poby']"
35,20,13,17,12,"['yabc912', 'iiijjj222', 'hihibyebye', 'jyarika', 'jyj1895', 'kyungrock.son.75', 'yohany', 'fasterthan88', 'jjh1115kr', 'guma2020', 'choeun.park.71', 'jae7woo']",0,[],5,"['leem4230', 'njsdhd', 'zhcm123', None, 'elvlf1611']",17,"['yabc912', 'iiijjj222', 'jyarika', 'jyj1895', 'njsdhd', None, 'elvlf1611', 'jae7woo', 'hihibyebye', 'kyungrock.son.75', 'leem4230', 'yohany', 'fasterthan88', 'jjh1115kr', 'guma2020', 'zhcm123', 'choeun.park.71']"
35,21,13,16,12,"['yabc912', 'iiijjj222', 'hihibyebye', 'jyarika', 'jyj1895', 'kyungrock.son.75', 'yohany', 'fasterthan88', 'jjh1115kr', 'guma2020', 'choeun.park.71', 'jae7woo']",0,[],4,"['hongjm213', None, 'elvlf1611', 'njsdhd']",16,"['yabc912', 'iiijjj222', 'jyarika', 'jyj1895', 'njsdhd', None, 'elvlf1611', 'jae7woo', 'hongjm213', 'hihibyebye', 'kyungrock.son.75', 'yohany', 'fasterthan88', 'jjh1115kr', 'guma2020', 'choeun.park.71']"
35,23,13,15,12,"['yabc912', 'iiijjj222', 'hihibyebye', 'jyarika', 'jyj1895', 'kyungrock.son.75', 'yohany', 'fasterthan88', 'jjh1115kr', 'guma2020', 'choeun.park.71', 'jae7woo']",0,[],3,"['s9342492', None, 'elvlf1611']",15,"['yabc912', 'iiijjj222', 'jyarika', 'jyj1895', 's9342492', None, 'elvlf1611', 'jae7woo', 'hihibyebye', 'kyungrock.son.75', 'yohany', 'fasterthan88', 'jjh1115kr', 'guma2020', 'choeun.park.71']"
35,24,13,15,12,"['yabc912', 'iiijjj222', 'hihibyebye', 'jyarika', 'jyj1895', 'kyungrock.son.75', 'yohany', 'fasterthan88', 'jjh1115kr', 'guma2020', 'choeun.park.71', 'jae7woo']",0,[],3,"['hongjm213', None, 'elvlf1611']",15,"['yabc912', 'iiijjj222', 'jyarika', 'jyj1895', None, 'elvlf1611', 'jae7woo', 'hongjm213', 'hihibyebye', 'kyungrock.son.75', 'yohany', 'fasterthan88', 'jjh1115kr', 'guma2020', 'choeun.park.71']"
35,25,13,15,12,"['yabc912', 'iiijjj222', 'hihibyebye', 'jyarika', 'jyj1895', 'kyungrock.son.75', 'yohany', 'fasterthan88', 'jjh1115kr', 'guma2020', 'choeun.park.71', 'jae7woo']",0,[],3,"['hongjm213', None, 'elvlf1611']",15,"['yabc912', 'iiijjj222', 'jyarika', 'jyj1895', None, 'elvlf1611', 'jae7woo', 'hongjm213', 'hihibyebye', 'kyungrock.son.75', 'yohany', 'fasterthan88', 'jjh1115kr', 'guma2020', 'choeun.park.71']"
35,22,13,7,4,"['guma2020', 'iiijjj222', 'yabc912', 'jjh1115kr']",8,"['hihibyebye', 'kyungrock.son.75', 'jyarika', 'jyj1895', 'yohany', 'fasterthan88', 'choeun.park.71', 'jae7woo']",3,"['s9342492', None, 'elvlf1611']",15,"['yabc912', 'iiijjj222', 'jyarika', 'jyj1895', 's9342492', None, 'elvlf1611', 'jae7woo', 'hihibyebye', 'kyungrock.son.75', 'yohany', 'fasterthan88', 'jjh1115kr', 'guma2020', 'choeun.park.71']"
36,226,13,14,11,"['lee.wendy.90', 'lenikali', 'satoshi.410277', 'nanomaterial', 'yuki.kawashiri', 'eccdragon1991', 'hirai_qoo', 'zvyn5955', 'matsuhashi', 'deguchi_masaya', 'hiroki_ikegaya']",1,['zuko10'],3,"[None, 'svcwatanabe', 'satoshi.vc.watanabe']",15,"['lee.wendy.90', 'eccdragon1991', 'matsuhashi', 'zvyn5955', 'zuko10', 'svcwatanabe', None, 'lenikali', 'satoshi.410277', 'nanomaterial', 'yuki.kawashiri', 'hirai_qoo', 'satoshi.vc.watanabe', 'deguchi_masaya', 'hiroki_ikegaya']"
37,135,13,14,12,"['nestor.polanco', 'dmerkel', 'spkessle', 'jgardner', 'cornelius.rand', 'ewyluda', 'mbrown30', 'willbetts', 'gpauza', 'fsansoz', 'thotte10', 'bribbans']",0,[],2,"['qfang1', None]",14,"['dmerkel', 'spkessle', 'jgardner', 'cornelius.rand', 'willbetts', 'gpauza', None, 'thotte10', 'bribbans', 'nestor.polanco', 'qfang1', 'ewyluda', 'fsansoz', 'mbrown30']"
38,179,13,45,12,"['ereyes12', 'disturbedones60', 'christianfwolters', 'jgortega3', 'ebustamante3', 'joseeugade', 'vitorres', 'masanchez19', 'mbijan', 'trixhnd', 'larissatv.lt', 'recarmonab']",0,[],33,"['acastro007', 'iflores10', 'nfalcon2015', 'pvelarde', 'gsilva5', 'mfmartinez3', 'frhernandez3', 'iazarate50', 'dhramirez2', 'richard.yanez.90', 'miguel.saldana.395017', 'dakerstiens', 'bdkern', 'jbarron5', 'kite9450', 'jcande_21', 'amdelarosa2', 'danny62217', 'orlandogomez', 'ashapgood', 'lmedina92', 'isaac_demon', None, 'oalopez', 'asoto21', 'lcoronado', 'jahernandez35', 'sbaca2', 'luis.cangas', 'rrivera19', 'junknexus', 'crfriedman', 'dasmith4']",45,"['acastro007', 'ereyes12', 'iflores10', 'nfalcon2015', 'pvelarde', 'joseeugade', 'gsilva5', 'mfmartinez3', 'frhernandez3', 'masanchez19', 'iazarate50', 'dhramirez2', 'richard.yanez.90', 'miguel.saldana.395017', 'disturbedones60', 'vitorres', 'dakerstiens', 'mbijan', 'trixhnd', 'bdkern', 'jbarron5', 'larissatv.lt', 'ebustamante3', 'kite9450', 'jcande_21', 'amdelarosa2', 'danny62217', 'orlandogomez', 'ashapgood', 'lmedina92', 'isaac_demon', None, 'recarmonab', 'oalopez', 'asoto21', 'lcoronado', 'jahernandez35', 'christianfwolters', 'jgortega3', 'sbaca2', 'luis.cangas', 'rrivera19', 'junknexus', 'crfriedman', 'dasmith4']"
38,192,13,30,12,"['ereyes12', 'disturbedones60', 'christianfwolters', 'jgortega3', 'ebustamante3', 'joseeugade', 'vitorres', 'masanchez19', 'mbijan', 'trixhnd', 'larissatv.lt', 'recarmonab']",0,[],18,"['miguel.saldana.395017', 'lcoronado', 'iflores10', 'junknexus', 'crfriedman', 'nfalcon2015', 'pvelarde', 'kite9450', 'sbaca2', 'oalopez', 'jcande_21', 'danny62217', 'dasmith4', 'ashapgood', 'rrivera19', None, 'asoto21', 'richard.yanez.90']",30,"['ereyes12', 'iflores10', 'nfalcon2015', 'pvelarde', 'joseeugade', 'masanchez19', 'richard.yanez.90', 'miguel.saldana.395017', 'disturbedones60', 'vitorres', 'mbijan', 'trixhnd', 'larissatv.lt', 'ebustamante3', 'kite9450', 'jcande_21', 'danny62217', 'ashapgood', None, 'recarmonab', 'asoto21', 'oalopez', 'lcoronado', 'christianfwolters', 'jgortega3', 'sbaca2', 'rrivera19', 'junknexus', 'crfriedman', 'dasmith4']"
38,183,13,16,10,"['disturbedones60', 'christianfwolters', 'jgortega3', 'ebustamante3', 'joseeugade', 'vitorres', 'masanchez19', 'mbijan', 'larissatv.lt', 'recarmonab']",2,"['ereyes12', 'trixhnd']",6,"['frhernandez3', 'bdkern', 'orlandogomez', None, 'gsilva5', 'asoto21']",18,"['ereyes12', 'ebustamante3', 'joseeugade', 'gsilva5', 'frhernandez3', 'masanchez19', 'orlandogomez', None, 'recarmonab', 'asoto21', 'disturbedones60', 'christianfwolters', 'jgortega3', 'vitorres', 'mbijan', 'trixhnd', 'bdkern', 'larissatv.lt']"
39,39,13,26,1,['mdreis2'],11,"['svichuda', 'childspa', 'gperezgo', 'carbelaez', 'vmishra', 'jnames', 'xyftc321', 'h.arpad91', 'vancso', 'sss82323', 'cxsong']",25,"['myloginname', 'bohmbac2', 'arpraka2', 'daosyn', 'kyhan2', 'connor.ekelund', 'brinkmanship', 'sabareesh.kumar', 'xak1101', 'xman', 'surya2', 'aspire.chan', 'aishsingh', 't14', 'marvadar', 'wstreyer', None, 'fengkaiyin2010', 'fajardo1', 'johnlu1', 'datye1', 'bholybee', 'haukchung', 'tschop2', 'azure3t']",37,"['myloginname', 'bohmbac2', 'arpraka2', 'daosyn', 'kyhan2', 'connor.ekelund', 'brinkmanship', 'vmishra', 'sabareesh.kumar', 'gperezgo', 'svichuda', 'xak1101', 'xman', 'carbelaez', 'surya2', 'mdreis2', 'vancso', 'aspire.chan', 'aishsingh', 't14', 'marvadar', 'childspa', 'wstreyer', 'xyftc321', 'sss82323', 'cxsong', None, 'fengkaiyin2010', 'fajardo1', 'johnlu1', 'datye1', 'bholybee', 'haukchung', 'tschop2', 'jnames', 'h.arpad91', 'azure3t']"
39,37,13,13,1,['svichuda'],11,"['childspa', 'gperezgo', 'carbelaez', 'vmishra', 'jnames', 'xyftc321', 'mdreis2', 'vancso', 'sss82323', 'cxsong', 'h.arpad91']",12,"[None, 'saowaluk', 'wertyerfire', 'alongkot', 'p.dulyaseree', 'sansiri_h', 'm.worawut', 'aaomaum', 'jomjamjungko', 'mingly', 'kanoknans', 'weesuke']",24,"['saowaluk', 'childspa', 'sansiri_h', 'm.worawut', 'vmishra', 'aaomaum', 'xyftc321', 'sss82323', 'gperezgo', 'cxsong', 'mingly', None, 'h.arpad91', 'svichuda', 'wertyerfire', 'alongkot', 'p.dulyaseree', 'carbelaez', 'jomjamjungko', 'jnames', 'mdreis2', 'vancso', 'kanoknans', 'weesuke']"
40,230,13,7,5,"['sil26', 'wangjwly', 'ericbuaa', 'emon0606087', 'semiflyer1978']",7,"['sagib101', 'micromanager', 'mustafaifl', 'sissidebeer', 'taleana.huff', 'gyli9753', 'mariajo.cadena']",2,"['yugong', None]",14,"['sil26', 'yugong', 'sagib101', 'micromanager', 'mustafaifl', 'ericbuaa', 'emon0606087', None, 'wangjwly', 'sissidebeer', 'taleana.huff', 'gyli9753', 'semiflyer1978', 'mariajo.cadena']"
41,179,12,45,11,"['acastro007', 'jahernandez35', 'mfmartinez3', 'luis.cangas', 'dhramirez2', 'dakerstiens', 'amdelarosa2', 'lmedina92', 'jbarron5', 'isaac_demon', 'iazarate50']",0,[],34,"['iflores10', 'ereyes12', 'nfalcon2015', 'pvelarde', 'joseeugade', 'gsilva5', 'frhernandez3', 'masanchez19', 'richard.yanez.90', 'miguel.saldana.395017', 'disturbedones60', 'vitorres', 'mbijan', 'trixhnd', 'bdkern', 'larissatv.lt', 'ebustamante3', 'kite9450', 'jcande_21', 'danny62217', 'orlandogomez', 'ashapgood', None, 'oalopez', 'asoto21', 'recarmonab', 'lcoronado', 'christianfwolters', 'jgortega3', 'sbaca2', 'rrivera19', 'junknexus', 'crfriedman', 'dasmith4']",45,"['acastro007', 'iflores10', 'ereyes12', 'nfalcon2015', 'pvelarde', 'joseeugade', 'gsilva5', 'mfmartinez3', 'frhernandez3', 'masanchez19', 'dhramirez2', 'richard.yanez.90', 'miguel.saldana.395017', 'dasmith4', 'disturbedones60', 'vitorres', 'dakerstiens', 'mbijan', 'trixhnd', 'bdkern', 'jbarron5', 'larissatv.lt', 'ebustamante3', 'kite9450', 'jcande_21', 'amdelarosa2', 'danny62217', 'orlandogomez', 'ashapgood', 'lmedina92', 'isaac_demon', None, 'oalopez', 'asoto21', 'recarmonab', 'lcoronado', 'jahernandez35', 'christianfwolters', 'jgortega3', 'sbaca2', 'luis.cangas', 'rrivera19', 'junknexus', 'crfriedman', 'iazarate50']"
42,195,12,17,9,"['avenug1', 'arnabshashi', 'tiesto1114', 'chuard', 'stanzzang', 'wenma', 'jjzero1', 'liyongdong.leon', 'emstark']",2,"['tsaiyihe', 'chasebreeze']",8,"['aunnie', 'avenug', 'caifuxi', 'danherrera10', 'fredty', 'whhsu1229', None, 'esmoon']",19,"['avenug1', 'tsaiyihe', 'aunnie', 'avenug', 'caifuxi', 'arnabshashi', 'tiesto1114', 'stanzzang', 'wenma', 'chasebreeze', 'jjzero1', 'whhsu1229', None, 'danherrera10', 'chuard', 'fredty', 'liyongdong.leon', 'emstark', 'esmoon']"
42,193,12,16,8,"['avenug1', 'arnabshashi', 'tiesto1114', 'chuard', 'wenma', 'jjzero1', 'liyongdong.leon', 'emstark']",3,"['tsaiyihe', 'chasebreeze', 'stanzzang']",8,"['aunnie', 'caifuxi', 'kimstanley88', 'qcb', 'fredty', 'whhsu1229', None, 'esmoon']",19,"['avenug1', 'tsaiyihe', 'aunnie', 'caifuxi', 'arnabshashi', 'tiesto1114', 'stanzzang', 'wenma', 'chasebreeze', 'jjzero1', 'whhsu1229', 'qcb', None, 'kimstanley88', 'chuard', 'fredty', 'liyongdong.leon', 'emstark', 'esmoon']"
42,194,12,9,1,['tsaiyihe'],10,"['avenug1', 'arnabshashi', 'tiesto1114', 'chuard', 'stanzzang', 'wenma', 'chasebreeze', 'jjzero1', 'liyongdong.leon', 'emstark']",8,"['zxcasdqwe50717', 'j22618468', 'rainlove5421', 'x17393', '531015c', 'mapledust0127', 'a777422002', None]",19,"['avenug1', 'tsaiyihe', 'arnabshashi', 'tiesto1114', 'x17393', '531015c', 'stanzzang', 'wenma', 'chasebreeze', 'jjzero1', 'a777422002', None, 'zxcasdqwe50717', 'j22618468', 'rainlove5421', 'chuard', 'mapledust0127', 'liyongdong.leon', 'emstark']"
44,53,11,35,2,"['wa.forero10', 'crashmateriales']",8,"['saowaluk', 'alongkot', 'p.dulyaseree', 'm.worawut', 'aaomaum', 'armmy', 'mingly', 'weesuke']",33,"['mariange8282', 'ferdelarr', 'jp.martinez10', 'catalina2709', 'carlos.e.puerto.s', 'pipe9404', 'superpes', 'am.alarcon346', 'cajrgato', 'jm.rodriguez11', 'osesnoguerrero', 'deejaystander', 'ds.restrepo10', 'ra.cordoba10', 'julian.david.00300', 'fabianm95', 'caerrome', 'tarod13', 'lf.burbano10', None, 'carolina.duque.sierra', 'julian321', 'jd.martinez1062', 'jezl9559', 'ruedagato4t0', 'jsebas.1995', 'c.gomez11', 'alejobb94', 'juliantrilli', 'dcjorge10', 'avilaalba', 'perroski', 's.correa12']",43,"['mariange8282', 'ferdelarr', 'm.worawut', 'crashmateriales', 'armmy', 'mingly', 'jp.martinez10', 'catalina2709', 'carlos.e.puerto.s', 'wa.forero10', 'superpes', 'pipe9404', 'am.alarcon346', 'cajrgato', 'alongkot', 'jm.rodriguez11', 'osesnoguerrero', 'deejaystander', 'ds.restrepo10', 'ra.cordoba10', 'julian.david.00300', 'weesuke', 'saowaluk', 'fabianm95', 'aaomaum', 'caerrome', 'tarod13', 'lf.burbano10', None, 'carolina.duque.sierra', 'julian321', 'jd.martinez1062', 'jezl9559', 'ruedagato4t0', 'jsebas.1995', 'p.dulyaseree', 'c.gomez11', 'alejobb94', 'juliantrilli', 'dcjorge10', 'avilaalba', 'perroski', 's.correa12']"
44,37,11,13,7,"['saowaluk', 'alongkot', 'p.dulyaseree', 'm.worawut', 'aaomaum', 'mingly', 'weesuke']",3,"['armmy', 'wa.forero10', 'crashmateriales']",6,"['svichuda', 'wertyerfire', 'sansiri_h', 'jomjamjungko', None, 'kanoknans']",16,"['saowaluk', 'sansiri_h', 'm.worawut', 'crashmateriales', 'aaomaum', 'armmy', 'mingly', None, 'svichuda', 'wa.forero10', 'wertyerfire', 'alongkot', 'p.dulyaseree', 'jomjamjungko', 'kanoknans', 'weesuke']"
44,51,11,13,8,"['saowaluk', 'alongkot', 'p.dulyaseree', 'm.worawut', 'aaomaum', 'armmy', 'mingly', 'weesuke']",2,"['wa.forero10', 'crashmateriales']",5,"['mild.piyawan.1', 'jomjamjungko', 'poosuda.phetban', None, 'kanoknans']",15,"['saowaluk', 'm.worawut', 'crashmateriales', 'aaomaum', 'armmy', 'mingly', None, 'mild.piyawan.1', 'wa.forero10', 'alongkot', 'p.dulyaseree', 'jomjamjungko', 'poosuda.phetban', 'kanoknans', 'weesuke']"
47,30,11,76,8,"['rburke12', 'tmerick1', 'joshuajerkins', 'pastorin', 'connorchilton', 'nshemer', 'steve6707', 'lightfooot']",2,"['payelray', 'anshul1993']",68,"['deanhartman7', 'gavingt', 'srini999', 'sbowcock1', 'alecmcc93', 'mgjaggers', 'eshaikh', 'yyemitan1', 'mkanand89', 'kkalexa1', 'spdewitt', 'ohdannyboy25', 'gspell', 'lemaitre7', 'mkgeres', 'gilbert.madril', 'michael.jason.ku', 'cnhoang', 'pdcurtis', 'shannonlip', 'brandondeal', 'speakoutloudly', 'nhorvat1', 'awtanner', 'wtlittle', 'uaevip20000', 'donkeykonk', 'ferry', 'adharan', 'jingliangzhong', 'dustin.esman', 'tvdo1', 'kcrosner', 'asharip', 'jonathan.davis.391', 'sensisounds', 'jaredbecker', 'geniuslb12345', 'drinkupmehearties525', 'rfang4', 'amandankeil', 'gouron73', 'jalon_sisson', 'thvincent200690', 'jaduart1', 'iwillzuu', 'lunwei', 'ironkaanon', 'geselby', 'timmerix', 'jmsloan1', 'chrisloff', 'jpbefort', 'timt8ion', 'mrsnef1', None, 'chrismay', 'nmaududi', 'acipressi', 'nmspirak', 'lbj2128694', 'leotherprofile', 'kevdhanson', 'smatheos', 'rymahoney12', 'csikes', 'jgwright', 'veramos92']",78,"['deanhartman7', 'gavingt', 'connorchilton', 'srini999', 'sbowcock1', 'anshul1993', 'alecmcc93', 'mgjaggers', 'eshaikh', 'joshuajerkins', 'yyemitan1', 'mkanand89', 'kkalexa1', 'spdewitt', 'ohdannyboy25', 'gspell', 'lemaitre7', 'mkgeres', 'lightfooot', 'gilbert.madril', 'michael.jason.ku', 'cnhoang', 'pdcurtis', 'shannonlip', 'brandondeal', 'speakoutloudly', 'nhorvat1', 'awtanner', 'wtlittle', 'uaevip20000', 'donkeykonk', 'ferry', 'rburke12', 'adharan', 'tmerick1', 'pastorin', 'jingliangzhong', 'dustin.esman', 'tvdo1', 'kcrosner', 'payelray', 'asharip', 'jonathan.davis.391', 'sensisounds', 'jaredbecker', 'geniuslb12345', 'drinkupmehearties525', 'rfang4', 'amandankeil', 'gouron73', 'jalon_sisson', 'nshemer', 'thvincent200690', 'jaduart1', 'iwillzuu', 'lunwei', 'ironkaanon', 'geselby', 'timmerix', 'jmsloan1', 'chrisloff', 'jpbefort', 'timt8ion', 'mrsnef1', None, 'chrismay', 'nmaududi', 'acipressi', 'nmspirak', 'lbj2128694', 'leotherprofile', 'kevdhanson', 'smatheos', 'rymahoney12', 'csikes', 'jgwright', 'veramos92', 'steve6707']"
47,48,11,70,9,"['payelray', 'anshul1993', 'rburke12', 'tmerick1', 'joshuajerkins', 'pastorin', 'connorchilton', 'nshemer', 'lightfooot']",1,['steve6707'],61,"['deanhartman7', 'gavingt', 'alecmcc93', 'mgjaggers', 'eshaikh', 'yyemitan1', 'kkalexa1', 'spdewitt', 'ohdannyboy25', 'gspell', 'lemaitre7', 'mkgeres', 'gilbert.madril', 'michael.jason.ku', 'cnhoang', 'pdcurtis', 'shannonlip', 'brandondeal', 'speakoutloudly', 'nhorvat1', 'awtanner', 'sbowcock', 'wtlittle', 'uaevip20000', 'donkeykonk', 'jingliangzhong', 'dustin.esman', 'tvdo1', 'kcrosner', 'aaron12', 'asharip', 'jonathan.davis.391', 'jaredbecker', 'drinkupmehearties525', 'amandankeil', 'gouron73', 'nkjorgen', 'thvincent200690', 'jaduart1', 'iwillzuu', 'ironkaanon', 'geselby', 'jmsloan1', 'chrisloff', 'jpbefort', 'timt8ion', 'mrsnef1', None, 'chrismay', 'sposborn', 'jkung', 'acipressi', 'nmspirak', 'nitishsharmabit', 'lbj2128694', 'kevdhanson', 'smatheos', 'rymahoney12', 'csikes', 'jgwright', 'veramos92']",71,"['deanhartman7', 'gavingt', 'connorchilton', 'anshul1993', 'alecmcc93', 'mgjaggers', 'eshaikh', 'joshuajerkins', 'yyemitan1', 'kkalexa1', 'spdewitt', 'ohdannyboy25', 'gspell', 'lemaitre7', 'mkgeres', 'lightfooot', 'gilbert.madril', 'michael.jason.ku', 'cnhoang', 'pdcurtis', 'shannonlip', 'brandondeal', 'speakoutloudly', 'nhorvat1', 'awtanner', 'sbowcock', 'wtlittle', 'uaevip20000', 'donkeykonk', 'rburke12', 'tmerick1', 'pastorin', 'jingliangzhong', 'dustin.esman', 'tvdo1', 'kcrosner', 'payelray', 'aaron12', 'asharip', 'jonathan.davis.391', 'jaredbecker', 'drinkupmehearties525', 'amandankeil', 'gouron73', 'nkjorgen', 'nshemer', 'thvincent200690', 'jaduart1', 'iwillzuu', 'ironkaanon', 'geselby', 'jmsloan1', 'chrisloff', 'jpbefort', 'timt8ion', 'mrsnef1', None, 'chrismay', 'sposborn', 'jkung', 'acipressi', 'nmspirak', 'nitishsharmabit', 'lbj2128694', 'kevdhanson', 'smatheos', 'rymahoney12', 'csikes', 'jgwright', 'veramos92', 'steve6707']"
47,167,11,66,8,"['payelray', 'anshul1993', 'rburke12', 'tmerick1', 'joshuajerkins', 'pastorin', 'connorchilton', 'lightfooot']",2,"['steve6707', 'nshemer']",58,"['deanhartman7', 'gavingt', 'sbowcock1', 'alecmcc93', 'mgjaggers', 'yyemitan1', 'kkalexa1', 'spdewitt', 'gspell', 'lemaitre7', 'mkgeres', 'gilbert.madril', 'michael.jason.ku', 'brandondeal', 'pdcurtis', 'shannonlip', 'speakoutloudly', 'nhorvat1', 'awtanner', 'wtlittle', 'uaevip20000', 'donkeykonk', 'ferry', 'adharan', 'jingliangzhong', 'dustin.esman', 'tvdo1', 'kcrosner', 'asharip', 'jonathan.davis.391', 'drinkupmehearties525', 'amandankeil', 'gouron73', 'jalon_sisson', 'thvincent200690', 'jaduart1', 'jshahani', 'iwillzuu', 'ironkaanon', 'geselby', 'jmsloan1', 'chrisloff', 'jpbefort', 'timt8ion', None, 'chrismay', 'nmaududi', 'hlhaines', 'acipressi', 'missymar', 'nmspirak', 'lbj2128694', 'kevdhanson', 'smatheos', 'rymahoney12', 'csikes', 'jgwright', 'veramos92']",68,"['deanhartman7', 'gavingt', 'connorchilton', 'sbowcock1', 'anshul1993', 'alecmcc93', 'mgjaggers', 'joshuajerkins', 'yyemitan1', 'kkalexa1', 'spdewitt', 'gspell', 'lemaitre7', 'mkgeres', 'lightfooot', 'gilbert.madril', 'michael.jason.ku', 'brandondeal', 'pdcurtis', 'shannonlip', 'speakoutloudly', 'nhorvat1', 'awtanner', 'wtlittle', 'uaevip20000', 'donkeykonk', 'ferry', 'rburke12', 'adharan', 'tmerick1', 'pastorin', 'jingliangzhong', 'dustin.esman', 'tvdo1', 'kcrosner', 'payelray', 'asharip', 'jonathan.davis.391', 'drinkupmehearties525', 'amandankeil', 'gouron73', 'jalon_sisson', 'nshemer', 'thvincent200690', 'jaduart1', 'jshahani', 'iwillzuu', 'ironkaanon', 'geselby', 'jmsloan1', 'chrisloff', 'jpbefort', 'timt8ion', None, 'chrismay', 'nmaududi', 'hlhaines', 'acipressi', 'missymar', 'nmspirak', 'lbj2128694', 'kevdhanson', 'smatheos', 'rymahoney12', 'csikes', 'jgwright', 'veramos92', 'steve6707']"
47,87,11,60,9,"['payelray', 'anshul1993', 'rburke12', 'tmerick1', 'joshuajerkins', 'pastorin', 'connorchilton', 'nshemer', 'lightfooot']",1,['steve6707'],51,"['deanhartman7', 'asharip', 'jonathan.davis.391', 'gavingt', 'drinkupmehearties525', 'tvdo1', 'amandankeil', 'gouron73', 'jalon_sisson', 'sbowcock1', 'alecmcc93', 'yyemitan1', 'ksa.elias', 'thvincent200690', 'ohdannyboy25', 'gspell', 'kkalexa1', 'jaduart1', 'jshahani', 'lemaitre7', 'spdewitt', 'ironkaanon', 'mkgeres', 'geselby', 'gilbert.madril', 'michael.jason.ku', 'brandondeal', 'pdcurtis', 'shannonlip', 'speakoutloudly', 'nhorvat1', 'chrisloff', 'awtanner', 'jpbefort', 'timt8ion', 'mrsnef1', None, 'chrismay', 'donkeykonk', 'eshaikh12', 'nmaududi', 'adharan', 'acipressi', 'missymar', 'nmspirak', 'lbj2128694', 'kevdhanson', 'nkjorgen', 'csikes', 'veramos92', 'kcrosner']",61,"['deanhartman7', 'gavingt', 'connorchilton', 'sbowcock1', 'anshul1993', 'alecmcc93', 'joshuajerkins', 'yyemitan1', 'kkalexa1', 'spdewitt', 'ohdannyboy25', 'gspell', 'lemaitre7', 'mkgeres', 'lightfooot', 'gilbert.madril', 'michael.jason.ku', 'brandondeal', 'pdcurtis', 'shannonlip', 'speakoutloudly', 'nhorvat1', 'awtanner', 'donkeykonk', 'eshaikh12', 'rburke12', 'adharan', 'tmerick1', 'pastorin', 'tvdo1', 'kcrosner', 'payelray', 'asharip', 'jonathan.davis.391', 'drinkupmehearties525', 'amandankeil', 'gouron73', 'jalon_sisson', 'ksa.elias', 'nshemer', 'thvincent200690', 'jaduart1', 'jshahani', 'ironkaanon', 'chrisloff', 'jpbefort', 'csikes', 'timt8ion', 'mrsnef1', None, 'chrismay', 'nmaududi', 'acipressi', 'missymar', 'nmspirak', 'lbj2128694', 'kevdhanson', 'nkjorgen', 'geselby', 'veramos92', 'steve6707']"
47,91,11,59,8,"['payelray', 'anshul1993', 'rburke12', 'joshuajerkins', 'pastorin', 'connorchilton', 'nshemer', 'lightfooot']",2,"['tmerick1', 'steve6707']",51,"['deanhartman7', 'asharip', 'jonathan.davis.391', 'gavingt', 'drinkupmehearties525', 'amandankeil', 'gouron73', 'jalon_sisson', 'sbowcock1', 'alecmcc93', 'yyemitan1', 'kkalexa1', 'thvincent200690', 'gspell', 'jaduart1', 'lemaitre7', 'iwillzuu', 'spdewitt', 'ohdannyboy25', 'ironkaanon', 'geselby', 'gilbert.madril', 'michael.jason.ku', 'brandondeal', 'pdcurtis', 'shannonlip', 'speakoutloudly', 'jmsloan1', 'nhorvat1', 'awtanner', 'jpbefort', 'chrisloff', 'timt8ion', 'kcrosner', 'mrsnef1', None, 'donkeykonk', 'chrismay', 'nmaududi', 'nmspirak', 'acipressi', 'haoshulu', 'jingliangzhong', 'lbj2128694', 'kevdhanson', 'nkjorgen', 'dustin.esman', 'csikes', 'rymahoney12', 'jgwright', 'tvdo1']",61,"['deanhartman7', 'gavingt', 'connorchilton', 'sbowcock1', 'anshul1993', 'alecmcc93', 'joshuajerkins', 'yyemitan1', 'kkalexa1', 'spdewitt', 'ohdannyboy25', 'gspell', 'lemaitre7', 'lightfooot', 'gilbert.madril', 'michael.jason.ku', 'brandondeal', 'pdcurtis', 'shannonlip', 'speakoutloudly', 'nhorvat1', 'awtanner', 'donkeykonk', 'rburke12', 'tmerick1', 'pastorin', 'haoshulu', 'jingliangzhong', 'dustin.esman', 'kcrosner', 'tvdo1', 'payelray', 'asharip', 'jonathan.davis.391', 'drinkupmehearties525', 'amandankeil', 'gouron73', 'jalon_sisson', 'nshemer', 'thvincent200690', 'jaduart1', 'iwillzuu', 'ironkaanon', 'jmsloan1', 'chrisloff', 'jpbefort', 'csikes', 'timt8ion', 'mrsnef1', None, 'chrismay', 'nmaududi', 'nmspirak', 'acipressi', 'lbj2128694', 'kevdhanson', 'nkjorgen', 'rymahoney12', 'geselby', 'jgwright', 'steve6707']"
47,140,11,59,9,"['payelray', 'anshul1993', 'rburke12', 'tmerick1', 'joshuajerkins', 'pastorin', 'connorchilton', 'nshemer', 'lightfooot']",1,['steve6707'],50,"['deanhartman7', 'jonathan.davis.391', 'drinkupmehearties525', 'amandankeil', 'gouron73', 'jalon_sisson', 'eko2crossfire', 'sbowcock1', 'alecmcc93', 'mgjaggers', 'eshaikh', 'yyemitan1', 'kkalexa1', 'thvincent200690', 'gspell', 'jaduart1', 'lemaitre7', 'iwillzuu', 'spdewitt', 'ohdannyboy25', 'ironkaanon', 'mkgeres', 'geselby', 'gilbert.madril', 'michael.jason.ku', 'pdcurtis', 'shannonlip', 'speakoutloudly', 'jmsloan1', 'nhorvat1', 'awtanner', 'jpbefort', 'chrisloff', 'timt8ion', 'uaevip20000', 'kcrosner', 'mrsnef1', None, 'donkeykonk', 'chrismay', 'nmaududi', 'adharan', 'nmspirak', 'acipressi', 'lbj2128694', 'nitishsharmabit', 'kevdhanson', 'rymahoney12', 'csikes', 'tvdo1']",60,"['deanhartman7', 'connorchilton', 'sbowcock1', 'anshul1993', 'alecmcc93', 'mgjaggers', 'eshaikh', 'joshuajerkins', 'yyemitan1', 'kkalexa1', 'spdewitt', 'ohdannyboy25', 'gspell', 'lemaitre7', 'mkgeres', 'lightfooot', 'gilbert.madril', 'michael.jason.ku', 'pdcurtis', 'shannonlip', 'speakoutloudly', 'nhorvat1', 'awtanner', 'uaevip20000', 'donkeykonk', 'rburke12', 'adharan', 'tmerick1', 'pastorin', 'kcrosner', 'tvdo1', 'payelray', 'jonathan.davis.391', 'drinkupmehearties525', 'amandankeil', 'gouron73', 'jalon_sisson', 'eko2crossfire', 'nshemer', 'thvincent200690', 'jaduart1', 'iwillzuu', 'ironkaanon', 'jmsloan1', 'chrisloff', 'jpbefort', 'csikes', 'timt8ion', 'mrsnef1', None, 'chrismay', 'nmaududi', 'nmspirak', 'acipressi', 'lbj2128694', 'nitishsharmabit', 'kevdhanson', 'rymahoney12', 'geselby', 'steve6707']"
47,97,11,57,8,"['payelray', 'anshul1993', 'rburke12', 'tmerick1', 'joshuajerkins', 'pastorin', 'connorchilton', 'lightfooot']",2,"['steve6707', 'nshemer']",49,"['deanhartman7', 'asharip', 'jonathan.davis.391', 'drinkupmehearties525', 'tvdo1', 'amandankeil', 'gouron73', 'jalon_sisson', 'sbowcock1', 'yyemitan1', 'kkalexa1', 'thvincent200690', 'ohdannyboy25', 'gspell', 'jshahani', 'lemaitre7', 'iwillzuu', 'spdewitt', 'ironkaanon', 'mkgeres', 'geselby', 'gilbert.madril', 'michael.jason.ku', 'pdcurtis', 'speakoutloudly', 'nhorvat1', 'chrisloff', 'awtanner', 'jpbefort', 'timt8ion', 'uaevip20000', 'mrsnef1', None, 'chrismay', 'donkeykonk', 'eshaikh12', 'nmaududi', 'acipressi', 'nmspirak', 'haoshulu', 'jingliangzhong', 'lbj2128694', 'kevdhanson', 'nkjorgen', 'dustin.esman', 'csikes', 'rymahoney12', 'jgwright', 'kcrosner']",59,"['deanhartman7', 'connorchilton', 'sbowcock1', 'anshul1993', 'joshuajerkins', 'yyemitan1', 'kkalexa1', 'spdewitt', 'ohdannyboy25', 'gspell', 'lemaitre7', 'mkgeres', 'lightfooot', 'gilbert.madril', 'michael.jason.ku', 'pdcurtis', 'speakoutloudly', 'nhorvat1', 'awtanner', 'uaevip20000', 'donkeykonk', 'eshaikh12', 'rburke12', 'tmerick1', 'pastorin', 'haoshulu', 'jingliangzhong', 'dustin.esman', 'tvdo1', 'kcrosner', 'payelray', 'asharip', 'jonathan.davis.391', 'drinkupmehearties525', 'amandankeil', 'gouron73', 'jalon_sisson', 'nshemer', 'thvincent200690', 'jshahani', 'iwillzuu', 'ironkaanon', 'chrisloff', 'jpbefort', 'csikes', 'timt8ion', 'mrsnef1', None, 'chrismay', 'nmaududi', 'acipressi', 'nmspirak', 'lbj2128694', 'kevdhanson', 'nkjorgen', 'rymahoney12', 'geselby', 'jgwright', 'steve6707']"
47,10,11,55,10,"['payelray', 'anshul1993', 'rburke12', 'tmerick1', 'joshuajerkins', 'pastorin', 'connorchilton', 'nshemer', 'steve6707', 'lightfooot']",0,[],45,"['deanhartman7', 'asharip', 'jonathan.davis.391', 'drinkupmehearties525', 'amandankeil', 'gouron73', 'sbowcock1', 'nkjorgen', 'alecmcc93', 'mgjaggers', 'yyemitan1', 'thvincent200690', 'jaduart1', 'gspell', 'spdewitt', 'lemaitre7', 'iwillzuu', 'ohdannyboy25', 'geselby', 'mkgeres', 'michael.jason.ku', 'pdcurtis', 'shannonlip', 'nhorvat1', 'chrisloff', 'awtanner', 'jpbefort', 'wtlittle', 'kcrosner', 'mrsnef1', None, 'donkeykonk', 'sposborn', 'chrismay', 'adharan', 'hlhaines', 'nmspirak', 'acipressi', 'haoshulu', 'kevdhanson', 'smatheos', 'dustin.esman', 'csikes', 'rymahoney12', 'jgwright']",55,"['deanhartman7', 'connorchilton', 'sbowcock1', 'anshul1993', 'alecmcc93', 'mgjaggers', 'joshuajerkins', 'yyemitan1', 'spdewitt', 'ohdannyboy25', 'gspell', 'lemaitre7', 'mkgeres', 'lightfooot', 'michael.jason.ku', 'pdcurtis', 'shannonlip', 'nhorvat1', 'awtanner', 'wtlittle', 'donkeykonk', 'rburke12', 'adharan', 'tmerick1', 'pastorin', 'haoshulu', 'dustin.esman', 'kcrosner', 'payelray', 'asharip', 'jonathan.davis.391', 'drinkupmehearties525', 'amandankeil', 'gouron73', 'nshemer', 'thvincent200690', 'jaduart1', 'iwillzuu', 'chrisloff', 'jpbefort', 'csikes', 'mrsnef1', None, 'chrismay', 'sposborn', 'smatheos', 'hlhaines', 'nmspirak', 'acipressi', 'kevdhanson', 'nkjorgen', 'rymahoney12', 'geselby', 'jgwright', 'steve6707']"
47,155,11,53,7,"['payelray', 'anshul1993', 'rburke12', 'joshuajerkins', 'pastorin', 'connorchilton', 'lightfooot']",3,"['tmerick1', 'steve6707', 'nshemer']",46,"['deanhartman7', 'asharip', 'jonathan.davis.391', 'drinkupmehearties525', 'amandankeil', 'gouron73', 'nkjorgen', 'alecmcc93', 'mgjaggers', 'yyemitan1', 'kkalexa1', 'thvincent200690', 'jaduart1', 'gspell', 'spdewitt', 'lemaitre7', 'ohdannyboy25', 'ironkaanon', 'mkgeres', 'geselby', 'gilbert.madril', 'michael.jason.ku', 'brandondeal', 'pdcurtis', 'shannonlip', 'awtanner', 'jpbefort', 'wtlittle', 'timt8ion', 'mrsnef1', None, 'donkeykonk', 'chrismay', 'eshaikh12', 'adharan', 'nmspirak', 'acipressi', 'jingliangzhong', 'lbj2128694', 'kevdhanson', 'smatheos', 'dustin.esman', 'csikes', 'rymahoney12', 'jgwright', 'kcrosner']",56,"['payelray', 'deanhartman7', 'asharip', 'jonathan.davis.391', 'drinkupmehearties525', 'connorchilton', 'amandankeil', 'gouron73', 'anshul1993', 'alecmcc93', 'mgjaggers', 'joshuajerkins', 'yyemitan1', 'nshemer', 'kkalexa1', 'thvincent200690', 'jaduart1', 'gspell', 'spdewitt', 'lemaitre7', 'ohdannyboy25', 'ironkaanon', 'mkgeres', 'lightfooot', 'gilbert.madril', 'michael.jason.ku', 'brandondeal', 'pdcurtis', 'shannonlip', 'awtanner', 'jpbefort', 'csikes', 'wtlittle', 'timt8ion', 'kcrosner', 'mrsnef1', None, 'donkeykonk', 'chrismay', 'eshaikh12', 'rburke12', 'smatheos', 'adharan', 'tmerick1', 'nmspirak', 'acipressi', 'pastorin', 'jingliangzhong', 'lbj2128694', 'kevdhanson', 'nkjorgen', 'dustin.esman', 'geselby', 'rymahoney12', 'jgwright', 'steve6707']"
47,106,11,51,8,"['payelray', 'anshul1993', 'rburke12', 'joshuajerkins', 'pastorin', 'connorchilton', 'nshemer', 'lightfooot']",2,"['tmerick1', 'steve6707']",43,"['deanhartman7', 'asharip', 'jonathan.davis.391', 'amandankeil', 'gouron73', 'alecmcc93', 'yyemitan1', 'thvincent200690', 'ohdannyboy25', 'gspell', 'kkalexa1', 'jaduart1', 'spdewitt', 'ironkaanon', 'mkgeres', 'geselby', 'gilbert.madril', 'michael.jason.ku', 'brandondeal', 'pdcurtis', 'shannonlip', 'nhorvat1', 'chrisloff', 'awtanner', 'wtlittle', 'timt8ion', 'mrsnef1', None, 'chrismay', 'donkeykonk', 'eshaikh12', 'adharan', 'hlhaines', 'acipressi', 'nmspirak', 'jingliangzhong', 'lbj2128694', 'kevdhanson', 'smatheos', 'dustin.esman', 'csikes', 'jgwright', 'kcrosner']",53,"['payelray', 'deanhartman7', 'asharip', 'jonathan.davis.391', 'connorchilton', 'amandankeil', 'gouron73', 'anshul1993', 'alecmcc93', 'joshuajerkins', 'yyemitan1', 'nshemer', 'thvincent200690', 'ohdannyboy25', 'gspell', 'kkalexa1', 'jaduart1', 'spdewitt', 'ironkaanon', 'mkgeres', 'lightfooot', 'gilbert.madril', 'michael.jason.ku', 'brandondeal', 'pdcurtis', 'shannonlip', 'nhorvat1', 'chrisloff', 'awtanner', 'csikes', 'wtlittle', 'timt8ion', 'kcrosner', 'mrsnef1', None, 'chrismay', 'donkeykonk', 'eshaikh12', 'rburke12', 'adharan', 'hlhaines', 'tmerick1', 'acipressi', 'nmspirak', 'pastorin', 'jingliangzhong', 'lbj2128694', 'kevdhanson', 'smatheos', 'dustin.esman', 'geselby', 'jgwright', 'steve6707']"
47,63,11,48,7,"['anshul1993', 'rburke12', 'tmerick1', 'joshuajerkins', 'pastorin', 'connorchilton', 'lightfooot']",3,"['payelray', 'steve6707', 'nshemer']",41,"['deanhartman7', 'asharip', 'jonathan.davis.391', 'drinkupmehearties525', 'amandankeil', 'jalon_sisson', 'sbowcock1', 'kkalexa1', 'thvincent200690', 'jaduart1', 'gspell', 'spdewitt', 'lemaitre7', 'iwillzuu', 'ohdannyboy25', 'ironkaanon', 'mkgeres', 'geselby', 'michael.jason.ku', 'pdcurtis', 'shannonlip', 'speakoutloudly', 'nhorvat1', 'chrisloff', 'awtanner', 'jpbefort', 'wtlittle', 'kcrosner', 'mrsnef1', None, 'donkeykonk', 'chrismay', 'nmaududi', 'nmspirak', 'acipressi', 'lbj2128694', 'dustin.esman', 'nkjorgen', 'rymahoney12', 'csikes', 'tvdo1']",51,"['payelray', 'deanhartman7', 'asharip', 'jonathan.davis.391', 'drinkupmehearties525', 'connorchilton', 'tvdo1', 'amandankeil', 'jalon_sisson', 'sbowcock1', 'anshul1993', 'joshuajerkins', 'nshemer', 'kkalexa1', 'thvincent200690', 'jaduart1', 'gspell', 'spdewitt', 'lemaitre7', 'iwillzuu', 'ohdannyboy25', 'ironkaanon', 'mkgeres', 'lightfooot', 'michael.jason.ku', 'pdcurtis', 'shannonlip', 'speakoutloudly', 'nhorvat1', 'chrisloff', 'awtanner', 'jpbefort', 'csikes', 'wtlittle', 'kcrosner', 'mrsnef1', None, 'donkeykonk', 'chrismay', 'rburke12', 'nmaududi', 'tmerick1', 'nmspirak', 'acipressi', 'pastorin', 'lbj2128694', 'dustin.esman', 'nkjorgen', 'rymahoney12', 'geselby', 'steve6707']"
47,202,11,35,8,"['payelray', 'anshul1993', 'rburke12', 'tmerick1', 'joshuajerkins', 'pastorin', 'connorchilton', 'lightfooot']",2,"['steve6707', 'nshemer']",27,"['jalon_sisson', 'alecmcc93', 'ksa.elias', 'kkalexa1', 'jaduart1', 'jshahani', 'lemaitre7', 'ironkaanon', 'mkgeres', 'gilbert.madril', 'pdcurtis', 'shannonlip', 'nhorvat1', 'chrisloff', 'jpbefort', 'csikes', 'timt8ion', None, 'donkeykonk', 'chrismay', 'nmaududi', 'missymar', 'lbj2128694', 'kevdhanson', 'nkjorgen', 'geselby', 'kcrosner']",37,"['payelray', 'connorchilton', 'jalon_sisson', 'anshul1993', 'alecmcc93', 'joshuajerkins', 'ksa.elias', 'nshemer', 'kkalexa1', 'jaduart1', 'jshahani', 'lemaitre7', 'ironkaanon', 'mkgeres', 'lightfooot', 'gilbert.madril', 'pdcurtis', 'shannonlip', 'nhorvat1', 'chrisloff', 'jpbefort', 'csikes', 'timt8ion', 'kcrosner', None, 'donkeykonk', 'chrismay', 'rburke12', 'nmaududi', 'tmerick1', 'missymar', 'pastorin', 'lbj2128694', 'kevdhanson', 'nkjorgen', 'geselby', 'steve6707']"
47,14,11,33,6,"['payelray', 'anshul1993', 'rburke12', 'joshuajerkins', 'pastorin', 'lightfooot']",4,"['tmerick1', 'steve6707', 'nshemer', 'connorchilton']",27,"['deanhartman7', 'asharip', 'jonathan.davis.391', 'drinkupmehearties525', 'sbowcock1', 'thvincent200690', 'spdewitt', 'gspell', 'ohdannyboy25', 'lemaitre7', 'iwillzuu', 'mkgeres', 'pdcurtis', 'shannonlip', 'awtanner', 'mrsnef1', None, 'donkeykonk', 'chrismay', 'nmspirak', 'acipressi', 'dustin.esman', 'nkjorgen', 'rymahoney12', 'csikes', 'jgwright', 'kcrosner']",37,"['payelray', 'deanhartman7', 'asharip', 'jonathan.davis.391', 'drinkupmehearties525', 'connorchilton', 'sbowcock1', 'anshul1993', 'joshuajerkins', 'nshemer', 'thvincent200690', 'spdewitt', 'gspell', 'ohdannyboy25', 'lemaitre7', 'iwillzuu', 'mkgeres', 'lightfooot', 'pdcurtis', 'shannonlip', 'awtanner', 'kcrosner', 'mrsnef1', None, 'donkeykonk', 'chrismay', 'rburke12', 'tmerick1', 'nmspirak', 'acipressi', 'pastorin', 'dustin.esman', 'nkjorgen', 'rymahoney12', 'csikes', 'jgwright', 'steve6707']"
47,111,11,32,8,"['payelray', 'anshul1993', 'rburke12', 'tmerick1', 'joshuajerkins', 'connorchilton', 'nshemer', 'lightfooot']",2,"['steve6707', 'pastorin']",24,"['tvdo1', 'alecmcc93', 'yyemitan1', 'kkalexa1', 'jaduart1', 'lemaitre7', 'ironkaanon', 'mkgeres', 'gilbert.madril', 'michael.jason.ku', 'shannonlip', 'speakoutloudly', 'wtlittle', None, 'sposborn', 'eshaikh12', 'nmaududi', 'adharan', 'haoshulu', 'lbj2128694', 'kevdhanson', 'rymahoney12', 'csikes', 'kcrosner']",34,"['payelray', 'connorchilton', 'tvdo1', 'anshul1993', 'alecmcc93', 'joshuajerkins', 'yyemitan1', 'nshemer', 'kkalexa1', 'jaduart1', 'lemaitre7', 'ironkaanon', 'mkgeres', 'lightfooot', 'gilbert.madril', 'michael.jason.ku', 'shannonlip', 'speakoutloudly', 'wtlittle', 'kcrosner', None, 'sposborn', 'eshaikh12', 'rburke12', 'nmaududi', 'adharan', 'tmerick1', 'pastorin', 'haoshulu', 'lbj2128694', 'kevdhanson', 'rymahoney12', 'csikes', 'steve6707']"
47,8,11,28,1,['lightfooot'],9,"['payelray', 'anshul1993', 'rburke12', 'tmerick1', 'joshuajerkins', 'pastorin', 'connorchilton', 'nshemer', 'steve6707']",27,"['deanhartman7', 'jonathan.davis.391', 'asharip', 'gavingt', 'drinkupmehearties525', 'amandankeil', 'gouron73', 'sbowcock1', 'spdewitt', 'thvincent200690', 'gspell', 'lemaitre7', 'iwillzuu', 'brandondeal', 'nhorvat1', 'awtanner', 'csikes', 'mrsnef1', None, 'donkeykonk', 'nmspirak', 'acipressi', 'kevdhanson', 'nkjorgen', 'dustin.esman', 'geselby', 'jgwright']",37,"['payelray', 'deanhartman7', 'jonathan.davis.391', 'asharip', 'gavingt', 'drinkupmehearties525', 'connorchilton', 'amandankeil', 'gouron73', 'sbowcock1', 'anshul1993', 'joshuajerkins', 'nshemer', 'spdewitt', 'thvincent200690', 'gspell', 'lemaitre7', 'iwillzuu', 'lightfooot', 'brandondeal', 'nhorvat1', 'awtanner', 'csikes', 'mrsnef1', None, 'donkeykonk', 'rburke12', 'tmerick1', 'nmspirak', 'acipressi', 'pastorin', 'kevdhanson', 'nkjorgen', 'dustin.esman', 'geselby', 'jgwright', 'steve6707']"
47,12,11,21,3,"['tmerick1', 'nshemer', 'connorchilton']",7,"['payelray', 'anshul1993', 'rburke12', 'joshuajerkins', 'pastorin', 'steve6707', 'lightfooot']",18,"['sbowcock1', 'jaredbecker', 'hlhaines', 'nhorvat1', 'chrisloff', 'nmspirak', 'awtanner', 'mrsnef1', 'haoshulu', 'amandankeil', 'jaduart1', 'dustin.esman', 'kcrosner', 'lemaitre7', 'iwillzuu', None, 'mkgeres', 'ferry']",28,"['payelray', 'jaredbecker', 'nhorvat1', 'chrisloff', 'awtanner', 'connorchilton', 'amandankeil', 'kcrosner', 'mrsnef1', None, 'ferry', 'sbowcock1', 'anshul1993', 'rburke12', 'hlhaines', 'tmerick1', 'nmspirak', 'joshuajerkins', 'pastorin', 'haoshulu', 'nshemer', 'jaduart1', 'dustin.esman', 'lemaitre7', 'iwillzuu', 'steve6707', 'mkgeres', 'lightfooot']"
47,31,11,8,1,['steve6707'],9,"['payelray', 'anshul1993', 'rburke12', 'tmerick1', 'joshuajerkins', 'pastorin', 'connorchilton', 'nshemer', 'lightfooot']",7,"['missymar', 'zhipeng', 'anshikasharma', 'haoshulu', 'swathipanchala', 'nkjorgen', None]",17,"['payelray', 'anshul1993', 'rburke12', 'tmerick1', 'missymar', 'zhipeng', 'joshuajerkins', 'pastorin', 'connorchilton', 'anshikasharma', 'haoshulu', 'nshemer', 'swathipanchala', 'nkjorgen', None, 'steve6707', 'lightfooot']"
47,11,11,7,1,['steve6707'],9,"['payelray', 'anshul1993', 'rburke12', 'tmerick1', 'joshuajerkins', 'pastorin', 'connorchilton', 'nshemer', 'lightfooot']",6,"['brandondeal', 'mgjaggers', 'hlhaines', 'zhipeng', 'haoshulu', None]",16,"['payelray', 'anshul1993', 'rburke12', 'mgjaggers', 'brandondeal', 'hlhaines', 'tmerick1', 'zhipeng', 'joshuajerkins', 'pastorin', 'connorchilton', 'haoshulu', 'nshemer', None, 'steve6707', 'lightfooot']"
47,50,11,7,1,['steve6707'],9,"['payelray', 'anshul1993', 'rburke12', 'tmerick1', 'joshuajerkins', 'pastorin', 'connorchilton', 'nshemer', 'lightfooot']",6,"['nmaududi', 'zhipeng', 'haoshulu', None, 'jalon_sisson', 'rbrosius']",16,"['payelray', 'anshul1993', 'rburke12', 'nmaududi', 'tmerick1', 'zhipeng', 'joshuajerkins', 'pastorin', 'connorchilton', 'haoshulu', 'nshemer', None, 'steve6707', 'jalon_sisson', 'rbrosius', 'lightfooot']"
47,88,11,7,2,"['nshemer', 'steve6707']",8,"['payelray', 'anshul1993', 'rburke12', 'tmerick1', 'joshuajerkins', 'pastorin', 'connorchilton', 'lightfooot']",5,"['mgjaggers', 'zhipeng', 'yyemitan1', 'haoshulu', None]",15,"['payelray', 'anshul1993', 'rburke12', 'mgjaggers', 'tmerick1', 'zhipeng', 'joshuajerkins', 'pastorin', 'connorchilton', 'yyemitan1', 'haoshulu', 'nshemer', None, 'steve6707', 'lightfooot']"
47,107,11,7,2,"['nshemer', 'steve6707']",8,"['payelray', 'anshul1993', 'rburke12', 'tmerick1', 'joshuajerkins', 'pastorin', 'connorchilton', 'lightfooot']",5,"['mgjaggers', 'zhipeng', 'haoshulu', None, 'jalon_sisson']",15,"['payelray', 'anshul1993', 'rburke12', 'mgjaggers', 'tmerick1', 'zhipeng', 'joshuajerkins', 'pastorin', 'connorchilton', 'haoshulu', 'nshemer', None, 'steve6707', 'jalon_sisson', 'lightfooot']"
47,156,11,7,2,"['nshemer', 'steve6707']",8,"['payelray', 'anshul1993', 'rburke12', 'tmerick1', 'joshuajerkins', 'pastorin', 'connorchilton', 'lightfooot']",5,"['m202002022020', 'zhipeng', 'haoshulu', None, 'jalon_sisson']",15,"['payelray', 'anshul1993', 'rburke12', 'm202002022020', 'tmerick1', 'zhipeng', 'joshuajerkins', 'pastorin', 'connorchilton', 'haoshulu', 'nshemer', None, 'steve6707', 'jalon_sisson', 'lightfooot']"
47,168,11,7,2,"['nshemer', 'steve6707']",8,"['payelray', 'anshul1993', 'rburke12', 'tmerick1', 'joshuajerkins', 'pastorin', 'connorchilton', 'lightfooot']",5,"['mgjaggers', 'missymar', 'zhipeng', 'haoshulu', None]",15,"['payelray', 'anshul1993', 'rburke12', 'mgjaggers', 'tmerick1', 'missymar', 'zhipeng', 'joshuajerkins', 'pastorin', 'connorchilton', 'haoshulu', 'nshemer', None, 'steve6707', 'lightfooot']"
48,30,11,76,10,"['deanhartman7', 'jonathan.davis.391', 'mgjaggers', 'nmspirak', 'drinkupmehearties525', 'spdewitt', 'thvincent200690', 'chrismay', 'csikes', 'donkeykonk']",0,[],66,"['gavingt', 'connorchilton', 'srini999', 'sbowcock1', 'alecmcc93', 'eshaikh', 'joshuajerkins', 'yyemitan1', 'mkanand89', 'kkalexa1', 'ohdannyboy25', 'gspell', 'lemaitre7', 'mkgeres', 'lightfooot', 'gilbert.madril', 'michael.jason.ku', 'cnhoang', 'pdcurtis', 'shannonlip', 'brandondeal', 'speakoutloudly', 'nhorvat1', 'awtanner', 'wtlittle', 'uaevip20000', 'ferry', 'rburke12', 'adharan', 'tmerick1', 'pastorin', 'jingliangzhong', 'dustin.esman', 'tvdo1', 'kcrosner', 'asharip', 'sensisounds', 'jaredbecker', 'geniuslb12345', 'rfang4', 'amandankeil', 'gouron73', 'jalon_sisson', 'nshemer', 'jaduart1', 'iwillzuu', 'lunwei', 'ironkaanon', 'geselby', 'timmerix', 'jmsloan1', 'chrisloff', 'jpbefort', 'timt8ion', 'mrsnef1', None, 'nmaududi', 'acipressi', 'lbj2128694', 'leotherprofile', 'kevdhanson', 'smatheos', 'rymahoney12', 'jgwright', 'veramos92', 'steve6707']",76,"['deanhartman7', 'gavingt', 'connorchilton', 'srini999', 'sbowcock1', 'mgjaggers', 'alecmcc93', 'eshaikh', 'joshuajerkins', 'yyemitan1', 'mkanand89', 'kkalexa1', 'spdewitt', 'ohdannyboy25', 'gspell', 'lemaitre7', 'mkgeres', 'lightfooot', 'gilbert.madril', 'michael.jason.ku', 'cnhoang', 'pdcurtis', 'shannonlip', 'brandondeal', 'speakoutloudly', 'nhorvat1', 'awtanner', 'wtlittle', 'uaevip20000', 'donkeykonk', 'ferry', 'rburke12', 'adharan', 'tmerick1', 'pastorin', 'jingliangzhong', 'dustin.esman', 'tvdo1', 'kcrosner', 'jonathan.davis.391', 'asharip', 'sensisounds', 'jaredbecker', 'geniuslb12345', 'drinkupmehearties525', 'rfang4', 'amandankeil', 'gouron73', 'jalon_sisson', 'nshemer', 'thvincent200690', 'jaduart1', 'iwillzuu', 'lunwei', 'ironkaanon', 'geselby', 'timmerix', 'jmsloan1', 'chrisloff', 'jpbefort', 'timt8ion', 'mrsnef1', None, 'chrismay', 'nmaududi', 'nmspirak', 'acipressi', 'lbj2128694', 'leotherprofile', 'kevdhanson', 'smatheos', 'rymahoney12', 'csikes', 'jgwright', 'veramos92', 'steve6707']"
48,48,11,70,10,"['deanhartman7', 'jonathan.davis.391', 'mgjaggers', 'nmspirak', 'drinkupmehearties525', 'spdewitt', 'thvincent200690', 'chrismay', 'csikes', 'donkeykonk']",0,[],60,"['gavingt', 'connorchilton', 'anshul1993', 'alecmcc93', 'eshaikh', 'joshuajerkins', 'yyemitan1', 'kkalexa1', 'ohdannyboy25', 'gspell', 'lemaitre7', 'mkgeres', 'lightfooot', 'gilbert.madril', 'michael.jason.ku', 'cnhoang', 'pdcurtis', 'shannonlip', 'brandondeal', 'speakoutloudly', 'nhorvat1', 'awtanner', 'sbowcock', 'wtlittle', 'uaevip20000', 'rburke12', 'tmerick1', 'pastorin', 'jingliangzhong', 'dustin.esman', 'tvdo1', 'kcrosner', 'payelray', 'aaron12', 'asharip', 'jaredbecker', 'amandankeil', 'gouron73', 'nkjorgen', 'nshemer', 'jaduart1', 'iwillzuu', 'ironkaanon', 'geselby', 'jmsloan1', 'chrisloff', 'jpbefort', 'timt8ion', 'mrsnef1', None, 'sposborn', 'jkung', 'acipressi', 'nitishsharmabit', 'lbj2128694', 'kevdhanson', 'smatheos', 'rymahoney12', 'jgwright', 'veramos92']",70,"['deanhartman7', 'gavingt', 'connorchilton', 'anshul1993', 'mgjaggers', 'alecmcc93', 'eshaikh', 'joshuajerkins', 'yyemitan1', 'kkalexa1', 'spdewitt', 'ohdannyboy25', 'gspell', 'lemaitre7', 'mkgeres', 'lightfooot', 'gilbert.madril', 'michael.jason.ku', 'cnhoang', 'pdcurtis', 'shannonlip', 'brandondeal', 'speakoutloudly', 'nhorvat1', 'awtanner', 'sbowcock', 'wtlittle', 'uaevip20000', 'donkeykonk', 'rburke12', 'tmerick1', 'pastorin', 'jingliangzhong', 'dustin.esman', 'tvdo1', 'kcrosner', 'payelray', 'aaron12', 'jonathan.davis.391', 'asharip', 'jaredbecker', 'drinkupmehearties525', 'amandankeil', 'gouron73', 'nkjorgen', 'nshemer', 'thvincent200690', 'jaduart1', 'iwillzuu', 'ironkaanon', 'geselby', 'jmsloan1', 'chrisloff', 'jpbefort', 'timt8ion', 'mrsnef1', None, 'chrismay', 'sposborn', 'jkung', 'nmspirak', 'acipressi', 'nitishsharmabit', 'lbj2128694', 'kevdhanson', 'smatheos', 'rymahoney12', 'csikes', 'jgwright', 'veramos92']"
48,167,11,66,10,"['deanhartman7', 'jonathan.davis.391', 'mgjaggers', 'nmspirak', 'drinkupmehearties525', 'spdewitt', 'thvincent200690', 'chrismay', 'csikes', 'donkeykonk']",0,[],56,"['gavingt', 'connorchilton', 'sbowcock1', 'anshul1993', 'alecmcc93', 'joshuajerkins', 'yyemitan1', 'kkalexa1', 'gspell', 'lemaitre7', 'mkgeres', 'lightfooot', 'gilbert.madril', 'michael.jason.ku', 'brandondeal', 'pdcurtis', 'shannonlip', 'speakoutloudly', 'nhorvat1', 'awtanner', 'wtlittle', 'uaevip20000', 'ferry', 'rburke12', 'adharan', 'tmerick1', 'pastorin', 'jingliangzhong', 'dustin.esman', 'tvdo1', 'kcrosner', 'payelray', 'asharip', 'amandankeil', 'gouron73', 'jalon_sisson', 'jaduart1', 'jshahani', 'iwillzuu', 'ironkaanon', 'geselby', 'jmsloan1', 'chrisloff', 'jpbefort', 'timt8ion', None, 'nmaududi', 'hlhaines', 'acipressi', 'missymar', 'lbj2128694', 'kevdhanson', 'smatheos', 'rymahoney12', 'jgwright', 'veramos92']",66,"['deanhartman7', 'gavingt', 'connorchilton', 'sbowcock1', 'anshul1993', 'mgjaggers', 'alecmcc93', 'joshuajerkins', 'yyemitan1', 'kkalexa1', 'spdewitt', 'gspell', 'lemaitre7', 'mkgeres', 'lightfooot', 'gilbert.madril', 'michael.jason.ku', 'brandondeal', 'pdcurtis', 'shannonlip', 'speakoutloudly', 'nhorvat1', 'awtanner', 'wtlittle', 'uaevip20000', 'donkeykonk', 'ferry', 'rburke12', 'adharan', 'tmerick1', 'pastorin', 'jingliangzhong', 'dustin.esman', 'tvdo1', 'kcrosner', 'payelray', 'jonathan.davis.391', 'asharip', 'drinkupmehearties525', 'amandankeil', 'gouron73', 'jalon_sisson', 'thvincent200690', 'jaduart1', 'jshahani', 'iwillzuu', 'ironkaanon', 'geselby', 'jmsloan1', 'chrisloff', 'jpbefort', 'timt8ion', None, 'chrismay', 'nmaududi', 'hlhaines', 'nmspirak', 'acipressi', 'missymar', 'lbj2128694', 'kevdhanson', 'smatheos', 'rymahoney12', 'csikes', 'jgwright', 'veramos92']"
48,87,11,60,9,"['deanhartman7', 'jonathan.davis.391', 'nmspirak', 'drinkupmehearties525', 'spdewitt', 'thvincent200690', 'chrismay', 'csikes', 'donkeykonk']",1,['mgjaggers'],51,"['payelray', 'asharip', 'gavingt', 'connorchilton', 'tvdo1', 'amandankeil', 'gouron73', 'jalon_sisson', 'sbowcock1', 'anshul1993', 'alecmcc93', 'joshuajerkins', 'yyemitan1', 'ksa.elias', 'nshemer', 'ohdannyboy25', 'gspell', 'kkalexa1', 'jaduart1', 'jshahani', 'lemaitre7', 'ironkaanon', 'mkgeres', 'lightfooot', 'geselby', 'gilbert.madril', 'michael.jason.ku', 'brandondeal', 'pdcurtis', 'shannonlip', 'speakoutloudly', 'nhorvat1', 'chrisloff', 'awtanner', 'jpbefort', 'timt8ion', 'mrsnef1', None, 'eshaikh12', 'nmaududi', 'rburke12', 'adharan', 'acipressi', 'missymar', 'tmerick1', 'pastorin', 'lbj2128694', 'kevdhanson', 'nkjorgen', 'veramos92', 'kcrosner']",61,"['deanhartman7', 'gavingt', 'connorchilton', 'sbowcock1', 'anshul1993', 'mgjaggers', 'alecmcc93', 'joshuajerkins', 'yyemitan1', 'kkalexa1', 'spdewitt', 'ohdannyboy25', 'gspell', 'lemaitre7', 'mkgeres', 'lightfooot', 'gilbert.madril', 'michael.jason.ku', 'brandondeal', 'pdcurtis', 'shannonlip', 'speakoutloudly', 'nhorvat1', 'awtanner', 'donkeykonk', 'eshaikh12', 'rburke12', 'adharan', 'tmerick1', 'pastorin', 'tvdo1', 'kcrosner', 'payelray', 'jonathan.davis.391', 'asharip', 'drinkupmehearties525', 'amandankeil', 'gouron73', 'jalon_sisson', 'ksa.elias', 'nshemer', 'thvincent200690', 'jaduart1', 'jshahani', 'ironkaanon', 'geselby', 'chrisloff', 'jpbefort', 'timt8ion', 'mrsnef1', None, 'chrismay', 'nmaududi', 'nmspirak', 'acipressi', 'missymar', 'lbj2128694', 'kevdhanson', 'nkjorgen', 'csikes', 'veramos92']"
48,91,11,59,9,"['deanhartman7', 'jonathan.davis.391', 'nmspirak', 'drinkupmehearties525', 'spdewitt', 'thvincent200690', 'chrismay', 'csikes', 'donkeykonk']",1,['mgjaggers'],50,"['payelray', 'asharip', 'gavingt', 'connorchilton', 'amandankeil', 'gouron73', 'jalon_sisson', 'sbowcock1', 'anshul1993', 'alecmcc93', 'joshuajerkins', 'yyemitan1', 'kkalexa1', 'nshemer', 'gspell', 'jaduart1', 'lemaitre7', 'iwillzuu', 'ohdannyboy25', 'ironkaanon', 'geselby', 'lightfooot', 'gilbert.madril', 'michael.jason.ku', 'brandondeal', 'pdcurtis', 'shannonlip', 'speakoutloudly', 'jmsloan1', 'nhorvat1', 'awtanner', 'jpbefort', 'chrisloff', 'timt8ion', 'kcrosner', 'mrsnef1', None, 'nmaududi', 'rburke12', 'acipressi', 'pastorin', 'haoshulu', 'jingliangzhong', 'lbj2128694', 'kevdhanson', 'nkjorgen', 'dustin.esman', 'rymahoney12', 'jgwright', 'tvdo1']",60,"['deanhartman7', 'gavingt', 'connorchilton', 'sbowcock1', 'anshul1993', 'mgjaggers', 'alecmcc93', 'joshuajerkins', 'yyemitan1', 'kkalexa1', 'spdewitt', 'ohdannyboy25', 'gspell', 'lemaitre7', 'lightfooot', 'gilbert.madril', 'michael.jason.ku', 'brandondeal', 'pdcurtis', 'shannonlip', 'speakoutloudly', 'nhorvat1', 'awtanner', 'donkeykonk', 'rburke12', 'pastorin', 'haoshulu', 'jingliangzhong', 'dustin.esman', 'kcrosner', 'tvdo1', 'payelray', 'jonathan.davis.391', 'asharip', 'drinkupmehearties525', 'amandankeil', 'gouron73', 'jalon_sisson', 'nshemer', 'thvincent200690', 'jaduart1', 'iwillzuu', 'ironkaanon', 'geselby', 'jmsloan1', 'chrisloff', 'jpbefort', 'timt8ion', 'mrsnef1', None, 'chrismay', 'nmaududi', 'nmspirak', 'acipressi', 'lbj2128694', 'kevdhanson', 'nkjorgen', 'rymahoney12', 'csikes', 'jgwright']"
48,140,11,59,10,"['deanhartman7', 'jonathan.davis.391', 'mgjaggers', 'nmspirak', 'drinkupmehearties525', 'spdewitt', 'thvincent200690', 'chrismay', 'csikes', 'donkeykonk']",0,[],49,"['payelray', 'connorchilton', 'amandankeil', 'gouron73', 'jalon_sisson', 'eko2crossfire', 'sbowcock1', 'anshul1993', 'alecmcc93', 'eshaikh', 'joshuajerkins', 'yyemitan1', 'kkalexa1', 'nshemer', 'gspell', 'jaduart1', 'lemaitre7', 'iwillzuu', 'ohdannyboy25', 'ironkaanon', 'mkgeres', 'lightfooot', 'geselby', 'gilbert.madril', 'michael.jason.ku', 'pdcurtis', 'shannonlip', 'speakoutloudly', 'jmsloan1', 'nhorvat1', 'awtanner', 'jpbefort', 'chrisloff', 'timt8ion', 'uaevip20000', 'kcrosner', 'mrsnef1', None, 'nmaududi', 'rburke12', 'adharan', 'tmerick1', 'acipressi', 'pastorin', 'lbj2128694', 'nitishsharmabit', 'kevdhanson', 'rymahoney12', 'tvdo1']",59,"['deanhartman7', 'connorchilton', 'sbowcock1', 'anshul1993', 'mgjaggers', 'alecmcc93', 'eshaikh', 'joshuajerkins', 'yyemitan1', 'kkalexa1', 'spdewitt', 'ohdannyboy25', 'gspell', 'lemaitre7', 'mkgeres', 'lightfooot', 'gilbert.madril', 'michael.jason.ku', 'pdcurtis', 'shannonlip', 'speakoutloudly', 'nhorvat1', 'awtanner', 'uaevip20000', 'donkeykonk', 'rburke12', 'adharan', 'tmerick1', 'pastorin', 'kcrosner', 'tvdo1', 'payelray', 'jonathan.davis.391', 'drinkupmehearties525', 'amandankeil', 'gouron73', 'jalon_sisson', 'eko2crossfire', 'nshemer', 'thvincent200690', 'jaduart1', 'iwillzuu', 'ironkaanon', 'geselby', 'jmsloan1', 'chrisloff', 'jpbefort', 'timt8ion', 'mrsnef1', None, 'chrismay', 'nmaududi', 'nmspirak', 'acipressi', 'lbj2128694', 'nitishsharmabit', 'kevdhanson', 'rymahoney12', 'csikes']"
48,97,11,57,9,"['deanhartman7', 'jonathan.davis.391', 'nmspirak', 'drinkupmehearties525', 'spdewitt', 'thvincent200690', 'chrismay', 'csikes', 'donkeykonk']",1,['mgjaggers'],48,"['payelray', 'asharip', 'connorchilton', 'tvdo1', 'amandankeil', 'gouron73', 'jalon_sisson', 'sbowcock1', 'anshul1993', 'joshuajerkins', 'yyemitan1', 'kkalexa1', 'ohdannyboy25', 'gspell', 'jshahani', 'lemaitre7', 'iwillzuu', 'ironkaanon', 'mkgeres', 'lightfooot', 'geselby', 'gilbert.madril', 'michael.jason.ku', 'pdcurtis', 'speakoutloudly', 'nhorvat1', 'chrisloff', 'awtanner', 'jpbefort', 'timt8ion', 'uaevip20000', 'mrsnef1', None, 'eshaikh12', 'nmaududi', 'rburke12', 'acipressi', 'tmerick1', 'pastorin', 'haoshulu', 'jingliangzhong', 'lbj2128694', 'kevdhanson', 'nkjorgen', 'dustin.esman', 'rymahoney12', 'jgwright', 'kcrosner']",58,"['deanhartman7', 'connorchilton', 'sbowcock1', 'anshul1993', 'mgjaggers', 'joshuajerkins', 'yyemitan1', 'kkalexa1', 'spdewitt', 'ohdannyboy25', 'gspell', 'lemaitre7', 'mkgeres', 'lightfooot', 'gilbert.madril', 'michael.jason.ku', 'pdcurtis', 'speakoutloudly', 'nhorvat1', 'awtanner', 'uaevip20000', 'donkeykonk', 'eshaikh12', 'rburke12', 'tmerick1', 'pastorin', 'haoshulu', 'jingliangzhong', 'dustin.esman', 'tvdo1', 'kcrosner', 'payelray', 'jonathan.davis.391', 'asharip', 'drinkupmehearties525', 'amandankeil', 'gouron73', 'jalon_sisson', 'thvincent200690', 'jshahani', 'iwillzuu', 'ironkaanon', 'geselby', 'chrisloff', 'jpbefort', 'timt8ion', 'mrsnef1', None, 'chrismay', 'nmaududi', 'nmspirak', 'acipressi', 'lbj2128694', 'kevdhanson', 'nkjorgen', 'rymahoney12', 'csikes', 'jgwright']"
48,10,11,55,10,"['deanhartman7', 'jonathan.davis.391', 'mgjaggers', 'nmspirak', 'drinkupmehearties525', 'spdewitt', 'thvincent200690', 'chrismay', 'csikes', 'donkeykonk']",0,[],45,"['payelray', 'asharip', 'connorchilton', 'amandankeil', 'gouron73', 'sbowcock1', 'anshul1993', 'nkjorgen', 'alecmcc93', 'joshuajerkins', 'yyemitan1', 'nshemer', 'jaduart1', 'gspell', 'lemaitre7', 'iwillzuu', 'ohdannyboy25', 'geselby', 'mkgeres', 'lightfooot', 'michael.jason.ku', 'pdcurtis', 'shannonlip', 'nhorvat1', 'chrisloff', 'awtanner', 'jpbefort', 'wtlittle', 'kcrosner', 'mrsnef1', None, 'sposborn', 'rburke12', 'adharan', 'hlhaines', 'tmerick1', 'acipressi', 'pastorin', 'haoshulu', 'kevdhanson', 'smatheos', 'dustin.esman', 'rymahoney12', 'jgwright', 'steve6707']",55,"['deanhartman7', 'connorchilton', 'sbowcock1', 'anshul1993', 'mgjaggers', 'alecmcc93', 'joshuajerkins', 'yyemitan1', 'spdewitt', 'ohdannyboy25', 'gspell', 'lemaitre7', 'mkgeres', 'lightfooot', 'michael.jason.ku', 'pdcurtis', 'shannonlip', 'nhorvat1', 'awtanner', 'wtlittle', 'donkeykonk', 'rburke12', 'adharan', 'tmerick1', 'pastorin', 'haoshulu', 'dustin.esman', 'kcrosner', 'payelray', 'jonathan.davis.391', 'asharip', 'drinkupmehearties525', 'amandankeil', 'gouron73', 'nshemer', 'thvincent200690', 'jaduart1', 'iwillzuu', 'geselby', 'chrisloff', 'jpbefort', 'mrsnef1', None, 'chrismay', 'sposborn', 'smatheos', 'hlhaines', 'nmspirak', 'acipressi', 'kevdhanson', 'nkjorgen', 'rymahoney12', 'csikes', 'jgwright', 'steve6707']"
48,155,11,53,10,"['deanhartman7', 'jonathan.davis.391', 'mgjaggers', 'nmspirak', 'drinkupmehearties525', 'spdewitt', 'thvincent200690', 'chrismay', 'csikes', 'donkeykonk']",0,[],43,"['payelray', 'asharip', 'connorchilton', 'amandankeil', 'gouron73', 'anshul1993', 'nkjorgen', 'alecmcc93', 'joshuajerkins', 'yyemitan1', 'kkalexa1', 'jaduart1', 'gspell', 'lemaitre7', 'ohdannyboy25', 'ironkaanon', 'mkgeres', 'lightfooot', 'geselby', 'gilbert.madril', 'michael.jason.ku', 'brandondeal', 'pdcurtis', 'shannonlip', 'awtanner', 'jpbefort', 'wtlittle', 'timt8ion', 'mrsnef1', None, 'eshaikh12', 'rburke12', 'adharan', 'acipressi', 'pastorin', 'jingliangzhong', 'lbj2128694', 'kevdhanson', 'smatheos', 'dustin.esman', 'rymahoney12', 'jgwright', 'kcrosner']",53,"['payelray', 'deanhartman7', 'jonathan.davis.391', 'asharip', 'drinkupmehearties525', 'connorchilton', 'amandankeil', 'gouron73', 'anshul1993', 'mgjaggers', 'alecmcc93', 'joshuajerkins', 'yyemitan1', 'kkalexa1', 'spdewitt', 'thvincent200690', 'jaduart1', 'gspell', 'lemaitre7', 'ohdannyboy25', 'ironkaanon', 'mkgeres', 'lightfooot', 'geselby', 'gilbert.madril', 'michael.jason.ku', 'brandondeal', 'pdcurtis', 'shannonlip', 'awtanner', 'jpbefort', 'wtlittle', 'timt8ion', 'mrsnef1', None, 'donkeykonk', 'chrismay', 'eshaikh12', 'rburke12', 'smatheos', 'adharan', 'nmspirak', 'acipressi', 'pastorin', 'jingliangzhong', 'lbj2128694', 'kevdhanson', 'nkjorgen', 'dustin.esman', 'csikes', 'rymahoney12', 'jgwright', 'kcrosner']"
48,106,11,51,8,"['deanhartman7', 'jonathan.davis.391', 'nmspirak', 'spdewitt', 'thvincent200690', 'chrismay', 'csikes', 'donkeykonk']",2,"['mgjaggers', 'drinkupmehearties525']",43,"['payelray', 'asharip', 'connorchilton', 'amandankeil', 'gouron73', 'anshul1993', 'alecmcc93', 'joshuajerkins', 'yyemitan1', 'nshemer', 'ohdannyboy25', 'gspell', 'kkalexa1', 'jaduart1', 'ironkaanon', 'mkgeres', 'lightfooot', 'geselby', 'gilbert.madril', 'michael.jason.ku', 'brandondeal', 'pdcurtis', 'shannonlip', 'nhorvat1', 'chrisloff', 'awtanner', 'wtlittle', 'timt8ion', 'mrsnef1', None, 'eshaikh12', 'rburke12', 'adharan', 'hlhaines', 'acipressi', 'pastorin', 'jingliangzhong', 'lbj2128694', 'kevdhanson', 'smatheos', 'dustin.esman', 'jgwright', 'kcrosner']",53,"['payelray', 'deanhartman7', 'jonathan.davis.391', 'asharip', 'drinkupmehearties525', 'connorchilton', 'amandankeil', 'gouron73', 'anshul1993', 'mgjaggers', 'alecmcc93', 'joshuajerkins', 'yyemitan1', 'nshemer', 'spdewitt', 'thvincent200690', 'ohdannyboy25', 'gspell', 'kkalexa1', 'jaduart1', 'ironkaanon', 'mkgeres', 'lightfooot', 'geselby', 'gilbert.madril', 'michael.jason.ku', 'brandondeal', 'pdcurtis', 'shannonlip', 'nhorvat1', 'chrisloff', 'awtanner', 'wtlittle', 'timt8ion', 'mrsnef1', None, 'donkeykonk', 'chrismay', 'eshaikh12', 'rburke12', 'adharan', 'hlhaines', 'nmspirak', 'acipressi', 'pastorin', 'jingliangzhong', 'lbj2128694', 'kevdhanson', 'smatheos', 'dustin.esman', 'csikes', 'jgwright', 'kcrosner']"
48,63,11,48,9,"['deanhartman7', 'jonathan.davis.391', 'nmspirak', 'drinkupmehearties525', 'spdewitt', 'thvincent200690', 'chrismay', 'csikes', 'donkeykonk']",1,['mgjaggers'],39,"['asharip', 'connorchilton', 'amandankeil', 'jalon_sisson', 'sbowcock1', 'anshul1993', 'joshuajerkins', 'kkalexa1', 'jaduart1', 'gspell', 'lemaitre7', 'iwillzuu', 'ohdannyboy25', 'ironkaanon', 'mkgeres', 'lightfooot', 'geselby', 'michael.jason.ku', 'pdcurtis', 'shannonlip', 'speakoutloudly', 'nhorvat1', 'chrisloff', 'awtanner', 'jpbefort', 'wtlittle', 'kcrosner', 'mrsnef1', None, 'nmaududi', 'rburke12', 'tmerick1', 'acipressi', 'pastorin', 'lbj2128694', 'dustin.esman', 'nkjorgen', 'rymahoney12', 'tvdo1']",49,"['deanhartman7', 'jonathan.davis.391', 'asharip', 'drinkupmehearties525', 'connorchilton', 'tvdo1', 'amandankeil', 'jalon_sisson', 'sbowcock1', 'anshul1993', 'mgjaggers', 'joshuajerkins', 'kkalexa1', 'spdewitt', 'thvincent200690', 'jaduart1', 'gspell', 'lemaitre7', 'iwillzuu', 'ohdannyboy25', 'ironkaanon', 'mkgeres', 'lightfooot', 'geselby', 'michael.jason.ku', 'pdcurtis', 'shannonlip', 'speakoutloudly', 'nhorvat1', 'chrisloff', 'awtanner', 'jpbefort', 'wtlittle', 'mrsnef1', None, 'donkeykonk', 'chrismay', 'nmaududi', 'rburke12', 'nmspirak', 'tmerick1', 'acipressi', 'pastorin', 'lbj2128694', 'dustin.esman', 'nkjorgen', 'rymahoney12', 'csikes', 'kcrosner']"
48,202,11,35,3,"['csikes', 'chrismay', 'donkeykonk']",7,"['deanhartman7', 'jonathan.davis.391', 'mgjaggers', 'nmspirak', 'drinkupmehearties525', 'spdewitt', 'thvincent200690']",32,"['payelray', 'connorchilton', 'jalon_sisson', 'anshul1993', 'alecmcc93', 'joshuajerkins', 'ksa.elias', 'kkalexa1', 'jaduart1', 'jshahani', 'lemaitre7', 'ironkaanon', 'mkgeres', 'lightfooot', 'gilbert.madril', 'pdcurtis', 'shannonlip', 'nhorvat1', 'chrisloff', 'jpbefort', 'timt8ion', None, 'nmaududi', 'rburke12', 'tmerick1', 'missymar', 'pastorin', 'lbj2128694', 'kevdhanson', 'nkjorgen', 'geselby', 'kcrosner']",42,"['payelray', 'deanhartman7', 'jonathan.davis.391', 'drinkupmehearties525', 'connorchilton', 'jalon_sisson', 'anshul1993', 'mgjaggers', 'alecmcc93', 'joshuajerkins', 'ksa.elias', 'kkalexa1', 'spdewitt', 'thvincent200690', 'jaduart1', 'jshahani', 'lemaitre7', 'ironkaanon', 'mkgeres', 'lightfooot', 'geselby', 'gilbert.madril', 'pdcurtis', 'shannonlip', 'nhorvat1', 'chrisloff', 'jpbefort', 'timt8ion', None, 'donkeykonk', 'chrismay', 'nmaududi', 'rburke12', 'nmspirak', 'tmerick1', 'missymar', 'pastorin', 'lbj2128694', 'kevdhanson', 'nkjorgen', 'csikes', 'kcrosner']"
48,14,11,33,9,"['deanhartman7', 'jonathan.davis.391', 'nmspirak', 'drinkupmehearties525', 'spdewitt', 'thvincent200690', 'chrismay', 'csikes', 'donkeykonk']",1,['mgjaggers'],24,"['payelray', 'asharip', 'sbowcock1', 'anshul1993', 'joshuajerkins', 'ohdannyboy25', 'gspell', 'lemaitre7', 'iwillzuu', 'mkgeres', 'lightfooot', 'pdcurtis', 'shannonlip', 'awtanner', 'mrsnef1', None, 'rburke12', 'acipressi', 'pastorin', 'dustin.esman', 'nkjorgen', 'rymahoney12', 'jgwright', 'kcrosner']",34,"['payelray', 'deanhartman7', 'jonathan.davis.391', 'asharip', 'drinkupmehearties525', 'sbowcock1', 'anshul1993', 'mgjaggers', 'joshuajerkins', 'spdewitt', 'thvincent200690', 'gspell', 'ohdannyboy25', 'lemaitre7', 'iwillzuu', 'mkgeres', 'lightfooot', 'pdcurtis', 'shannonlip', 'awtanner', 'mrsnef1', None, 'donkeykonk', 'chrismay', 'rburke12', 'nmspirak', 'acipressi', 'pastorin', 'dustin.esman', 'nkjorgen', 'rymahoney12', 'csikes', 'jgwright', 'kcrosner']"
48,111,11,32,1,['csikes'],9,"['deanhartman7', 'jonathan.davis.391', 'mgjaggers', 'nmspirak', 'drinkupmehearties525', 'spdewitt', 'thvincent200690', 'chrismay', 'donkeykonk']",31,"['payelray', 'connorchilton', 'tvdo1', 'anshul1993', 'alecmcc93', 'joshuajerkins', 'yyemitan1', 'kkalexa1', 'nshemer', 'jaduart1', 'lemaitre7', 'ironkaanon', 'mkgeres', 'lightfooot', 'gilbert.madril', 'michael.jason.ku', 'shannonlip', 'speakoutloudly', 'wtlittle', None, 'sposborn', 'eshaikh12', 'nmaududi', 'rburke12', 'adharan', 'tmerick1', 'haoshulu', 'lbj2128694', 'kevdhanson', 'rymahoney12', 'kcrosner']",41,"['payelray', 'deanhartman7', 'jonathan.davis.391', 'drinkupmehearties525', 'connorchilton', 'tvdo1', 'anshul1993', 'mgjaggers', 'alecmcc93', 'joshuajerkins', 'yyemitan1', 'kkalexa1', 'spdewitt', 'thvincent200690', 'nshemer', 'jaduart1', 'lemaitre7', 'ironkaanon', 'mkgeres', 'lightfooot', 'gilbert.madril', 'michael.jason.ku', 'shannonlip', 'speakoutloudly', 'wtlittle', None, 'donkeykonk', 'chrismay', 'sposborn', 'eshaikh12', 'nmaududi', 'rburke12', 'adharan', 'nmspirak', 'tmerick1', 'haoshulu', 'lbj2128694', 'kevdhanson', 'rymahoney12', 'csikes', 'kcrosner']"
48,8,11,28,8,"['deanhartman7', 'jonathan.davis.391', 'nmspirak', 'drinkupmehearties525', 'spdewitt', 'thvincent200690', 'csikes', 'donkeykonk']",2,"['mgjaggers', 'chrismay']",20,"['asharip', 'gavingt', 'amandankeil', 'gouron73', 'sbowcock1', 'gspell', 'lemaitre7', 'iwillzuu', 'lightfooot', 'brandondeal', 'nhorvat1', 'awtanner', 'mrsnef1', None, 'acipressi', 'kevdhanson', 'nkjorgen', 'dustin.esman', 'geselby', 'jgwright']",30,"['deanhartman7', 'jonathan.davis.391', 'asharip', 'gavingt', 'drinkupmehearties525', 'amandankeil', 'gouron73', 'sbowcock1', 'mgjaggers', 'spdewitt', 'thvincent200690', 'gspell', 'lemaitre7', 'iwillzuu', 'geselby', 'lightfooot', 'brandondeal', 'nhorvat1', 'awtanner', 'mrsnef1', None, 'donkeykonk', 'chrismay', 'nmspirak', 'acipressi', 'kevdhanson', 'nkjorgen', 'dustin.esman', 'csikes', 'jgwright']"
48,12,11,21,1,['nmspirak'],9,"['deanhartman7', 'jonathan.davis.391', 'mgjaggers', 'drinkupmehearties525', 'spdewitt', 'thvincent200690', 'chrismay', 'csikes', 'donkeykonk']",20,"['jaredbecker', 'connorchilton', 'amandankeil', 'sbowcock1', 'nshemer', 'jaduart1', 'lemaitre7', 'iwillzuu', 'mkgeres', 'nhorvat1', 'chrisloff', 'awtanner', 'mrsnef1', None, 'ferry', 'hlhaines', 'tmerick1', 'haoshulu', 'dustin.esman', 'kcrosner']",30,"['deanhartman7', 'jonathan.davis.391', 'jaredbecker', 'lemaitre7', 'nhorvat1', 'chrisloff', 'awtanner', 'drinkupmehearties525', 'connorchilton', 'amandankeil', 'mrsnef1', None, 'donkeykonk', 'chrismay', 'sbowcock1', 'ferry', 'mgjaggers', 'hlhaines', 'nmspirak', 'tmerick1', 'haoshulu', 'nshemer', 'spdewitt', 'thvincent200690', 'jaduart1', 'dustin.esman', 'csikes', 'iwillzuu', 'kcrosner', 'mkgeres']"
48,28,11,10,1,['nmspirak'],9,"['deanhartman7', 'jonathan.davis.391', 'mgjaggers', 'drinkupmehearties525', 'spdewitt', 'thvincent200690', 'chrismay', 'csikes', 'donkeykonk']",9,"['michael.jason.ku', 'alecmcc93', 'jalon_sisson', 'missymar', 'jpbefort', 'lbj2128694', 'kkalexa1', None, 'ironkaanon']",19,"['deanhartman7', 'jonathan.davis.391', 'michael.jason.ku', 'drinkupmehearties525', 'jpbefort', None, 'jalon_sisson', 'donkeykonk', 'chrismay', 'mgjaggers', 'alecmcc93', 'nmspirak', 'missymar', 'lbj2128694', 'kkalexa1', 'spdewitt', 'thvincent200690', 'csikes', 'ironkaanon']"
48,11,11,7,1,['mgjaggers'],9,"['deanhartman7', 'jonathan.davis.391', 'nmspirak', 'drinkupmehearties525', 'spdewitt', 'thvincent200690', 'chrismay', 'csikes', 'donkeykonk']",6,"['brandondeal', 'hlhaines', 'zhipeng', 'haoshulu', None, 'steve6707']",16,"['deanhartman7', 'jonathan.davis.391', 'mgjaggers', 'brandondeal', 'hlhaines', 'nmspirak', 'zhipeng', 'drinkupmehearties525', 'donkeykonk', 'haoshulu', 'spdewitt', 'thvincent200690', 'csikes', None, 'steve6707', 'chrismay']"
48,88,11,7,1,['mgjaggers'],9,"['deanhartman7', 'jonathan.davis.391', 'nmspirak', 'drinkupmehearties525', 'spdewitt', 'thvincent200690', 'chrismay', 'csikes', 'donkeykonk']",6,"['zhipeng', 'yyemitan1', 'haoshulu', 'nshemer', None, 'steve6707']",16,"['deanhartman7', 'jonathan.davis.391', 'mgjaggers', 'nmspirak', 'zhipeng', 'drinkupmehearties525', 'yyemitan1', 'donkeykonk', 'haoshulu', 'nshemer', 'spdewitt', 'thvincent200690', 'csikes', None, 'steve6707', 'chrismay']"
48,107,11,7,1,['mgjaggers'],9,"['deanhartman7', 'jonathan.davis.391', 'nmspirak', 'drinkupmehearties525', 'spdewitt', 'thvincent200690', 'chrismay', 'csikes', 'donkeykonk']",6,"['zhipeng', 'steve6707', 'haoshulu', 'nshemer', None, 'jalon_sisson']",16,"['deanhartman7', 'jonathan.davis.391', 'mgjaggers', 'nmspirak', 'zhipeng', 'drinkupmehearties525', 'donkeykonk', 'haoshulu', 'nshemer', 'spdewitt', 'thvincent200690', 'csikes', None, 'steve6707', 'jalon_sisson', 'chrismay']"
48,168,11,7,1,['mgjaggers'],9,"['deanhartman7', 'jonathan.davis.391', 'nmspirak', 'drinkupmehearties525', 'spdewitt', 'thvincent200690', 'chrismay', 'csikes', 'donkeykonk']",6,"['missymar', 'zhipeng', 'haoshulu', 'nshemer', None, 'steve6707']",16,"['deanhartman7', 'jonathan.davis.391', 'mgjaggers', 'nmspirak', 'missymar', 'zhipeng', 'drinkupmehearties525', 'donkeykonk', 'haoshulu', 'nshemer', 'spdewitt', 'thvincent200690', 'csikes', None, 'steve6707', 'chrismay']"
49,1,11,6,2,"['ertou79', 'jiang267']",8,"['jwsteenbergen', 'ahgardn1', 'samsdevel', 'dtrikkad', 'cvvu2', 'ipka', 'zuoanwuwu', 'habtegiorgis']",4,"['pwijesin', None, 'sajidmc', 'zubair_al_azim']",14,"['sajidmc', 'ertou79', 'jwsteenbergen', 'zubair_al_azim', 'pwijesin', 'ahgardn1', 'jiang267', 'samsdevel', 'dtrikkad', 'cvvu2', 'ipka', None, 'zuoanwuwu', 'habtegiorgis']"
50,5,11,11,2,"['santiagoduquev', 'camilaabr']",8,"['david9402', 'mviera', 'dm14', 'okayillioglu', 'mohammadzakwan', 'mhumayun13', 'boundaryroad.2002', 'steve.ortiznarvaez']",9,"['sonial.boterog', 'jerkhg', 'ancrozo', 'linibrmeo0502', 'lizetteandrea', 'ginnap.parodim', 'carloalqu', None, 'roxyulei']",19,"['sonial.boterog', 'ancrozo', 'santiagoduquev', 'linibrmeo0502', None, 'roxyulei', 'david9402', 'jerkhg', 'mviera', 'dm14', 'camilaabr', 'okayillioglu', 'mohammadzakwan', 'lizetteandrea', 'ginnap.parodim', 'carloalqu', 'mhumayun13', 'boundaryroad.2002', 'steve.ortiznarvaez']"
50,7,11,11,4,"['david9402', 'dm14', 'camilaabr', 'steve.ortiznarvaez']",6,"['mviera', 'okayillioglu', 'mohammadzakwan', 'santiagoduquev', 'mhumayun13', 'boundaryroad.2002']",7,"['jerkhg', 'ancrozo', 'nanofredy', 'ginnap.parodim', 'linibrmeo0502', None, 'roxyuleidy']",17,"['ancrozo', 'santiagoduquev', 'linibrmeo0502', None, 'david9402', 'jerkhg', 'mviera', 'nanofredy', 'dm14', 'camilaabr', 'okayillioglu', 'mohammadzakwan', 'ginnap.parodim', 'mhumayun13', 'boundaryroad.2002', 'roxyuleidy', 'steve.ortiznarvaez']"
53,171,10,14,9,"['wzhu12', 'jnguyen', 'ghc0605', 'bmathew2', 'btran2', 'rchan9', 'hpatel14', 'mchakra2', 'dandaman4716']",0,[],5,"['aditidesai', 'svaddi2', 'mozdoga1', 'achanda3', None]",14,"['jnguyen', 'aditidesai', 'svaddi2', 'ghc0605', 'btran2', 'mchakra2', None, 'wzhu12', 'bmathew2', 'rchan9', 'hpatel14', 'dandaman4716', 'mozdoga1', 'achanda3']"
53,119,10,13,9,"['wzhu12', 'jnguyen', 'ghc0605', 'bmathew2', 'btran2', 'rchan9', 'hpatel14', 'mchakra2', 'dandaman4716']",0,[],4,"['svaddi2', 'mozdoga1', None, 'aditidesai']",13,"['jnguyen', 'aditidesai', 'svaddi2', 'ghc0605', 'btran2', 'mchakra2', None, 'wzhu12', 'bmathew2', 'rchan9', 'hpatel14', 'dandaman4716', 'mozdoga1']"
53,170,10,10,8,"['wzhu12', 'jnguyen', 'ghc0605', 'bmathew2', 'btran2', 'rchan9', 'hpatel14', 'mchakra2']",1,['dandaman4716'],2,"['mozdoga1', None]",11,"['jnguyen', 'ghc0605', 'btran2', 'mchakra2', None, 'wzhu12', 'bmathew2', 'rchan9', 'hpatel14', 'dandaman4716', 'mozdoga1']"
54,164,10,38,1,['marinamedhat'],8,"['piaoshi', 'sanshui', 'gradnishit', 'mohammed.eladawy', 'andrew.b.wong', 'ferrottt', 'ariel.werle', 'bll_hb']",37,"['moeffat', 'engabdallah1', 'nahlahamed', 'amgad.ahmed', 'sherif.ghozzy', 'rody.osama', 'mahmoudabdelmoniem', 'mohamed123456', 'raghda.mohammad.5', 'omar.amin.750', 'ranaahmed', 'menaesam', 'muhammed333', 'ahmed.asfour.1466', 'shadi31', 'ahmedflamenco', 'sorial.samy.7', 'maramsalah', 'ahmedreda', 'omargamalhafez21', 'marco.adel.37', 'islam.js24', 'mosab94', 'sherinemohamed', 'mostafa.radwan', 'ramiahmedhussien', 'tantoon.soryal', 'rana.a.ghoneim', 'ahazem254', 'mark_nader', 'adelrashad', None, 'rami.abulfadl', 'ahmed.shedid.12', 'karimwissa', 'heshamehab', 'ahmedmedhat10']",46,"['moeffat', 'engabdallah1', 'nahlahamed', 'sanshui', 'amgad.ahmed', 'gradnishit', 'marinamedhat', 'rody.osama', 'mahmoudabdelmoniem', 'sherif.ghozzy', 'mohamed123456', 'ariel.werle', 'raghda.mohammad.5', 'omar.amin.750', 'menaesam', 'ranaahmed', 'muhammed333', 'piaoshi', 'ahmed.asfour.1466', 'shadi31', 'ahmedflamenco', 'sorial.samy.7', 'maramsalah', 'ahmedreda', 'omargamalhafez21', 'ferrottt', 'marco.adel.37', 'islam.js24', 'mosab94', 'sherinemohamed', 'mostafa.radwan', 'ramiahmedhussien', 'tantoon.soryal', 'rana.a.ghoneim', 'ahazem254', 'mark_nader', 'adelrashad', None, 'rami.abulfadl', 'ahmed.shedid.12', 'karimwissa', 'heshamehab', 'mohammed.eladawy', 'andrew.b.wong', 'ahmedmedhat10', 'bll_hb']"
55,44,9,12,8,"['resultugay', 'davidmendez', 'srh60', 'lisecardin', 'mkwilli2', 'peslier53', 'manuel2092', 'bschedler']",0,[],4,"['clotilde', 'acoudad', None, 'jtutor_cu']",12,"['resultugay', 'srh60', 'manuel2092', 'acoudad', None, 'clotilde', 'davidmendez', 'lisecardin', 'jtutor_cu', 'mkwilli2', 'peslier53', 'bschedler']"
56,174,9,25,1,['tnakotte'],7,"['btaber', 'leldridge14', 'ashwik.battu', 'sdougherty2986', 'neimantas', 'mikayla.means', 'svittygirl']",24,"['rspencer', 'crriley', 'kmego1', 'josetheto', 'basstee', 'dannelle', 'ajmirab', 'albert.i.perry', 'brh5103', 'dirkjake', 'jhood01', 'merdman', 'ndawson1', 'dsaucier', 'lepluart', 'esalsber', 'elewis04', 'sinedu', 'jenkinsa', None, 'jmccab11', 'ccarrillo', 'biggestworld', 'mariella']",32,"['btaber', 'rspencer', 'crriley', 'kmego1', 'josetheto', 'basstee', 'dannelle', 'ajmirab', 'albert.i.perry', 'brh5103', 'dirkjake', 'jhood01', 'merdman', 'tnakotte', 'leldridge14', 'ndawson1', 'dsaucier', 'lepluart', 'esalsber', 'sdougherty2986', 'elewis04', 'mikayla.means', 'jenkinsa', 'svittygirl', 'sinedu', None, 'ashwik.battu', 'neimantas', 'jmccab11', 'ccarrillo', 'biggestworld', 'mariella']"
57,90,9,25,8,"['taikitakada', 'sakurayuu', 'araijunnya', 'g1215108', 'shirotoru', 'g1115036', 'a1215084', 'toshitarou']",0,[],17,"['mw2_mctavish', 'xgtxgt', 'shogo', 'collage_name', 'himajin_2nd', 'sora', 'g1215110', 'tsubasa', 'ten', 'marui', 'hirooda', 'yusuketakada', 'g1215012', 'o3o3m7m7', None, 'g1215028', 'mossim']",25,"['araijunnya', 'shirotoru', 'g1215110', 'tsubasa', 'ten', 'marui', 'g1215012', 'a1215084', 'taikitakada', 'sakurayuu', 'g1215108', 'hirooda', 'mossim', 'mw2_mctavish', 'toshitarou', None, 'g1215028', 'collage_name', 'xgtxgt', 'shogo', 'himajin_2nd', 'sora', 'g1115036', 'yusuketakada', 'o3o3m7m7']"
57,124,9,7,5,"['taikitakada', 'g1215108', 'shirotoru', 'a1215084', 'toshitarou']",3,"['araijunnya', 'sakurayuu', 'g1115036']",2,"['marui', None]",10,"['taikitakada', 'araijunnya', 'sakurayuu', 'g1215108', 'shirotoru', 'g1115036', 'marui', 'a1215084', 'toshitarou', None]"
60,122,9,8,4,"['grannykiller', 'predrag.pejic', 'barboco', 'slusko']",4,"['mateo.skeva', 'priscila.ebert', 'jalinegm02', 'thiarlesmedeiros2']",4,"['zvuksic', None, 'davor.pocepan', 'zvuksic2']",12,"['grannykiller', 'priscila.ebert', 'barboco', 'slusko', 'mateo.skeva', 'zvuksic2', 'jalinegm02', 'predrag.pejic', 'thiarlesmedeiros2', 'davor.pocepan', 'zvuksic', None]"
60,121,9,7,3,"['predrag.pejic', 'barboco', 'slusko']",5,"['grannykiller', 'priscila.ebert', 'mateo.skeva', 'jalinegm02', 'thiarlesmedeiros2']",4,"['zvuksic', None, 'davor.pocepan', 'zvuksic2']",12,"['grannykiller', 'priscila.ebert', 'barboco', 'slusko', 'mateo.skeva', 'zvuksic2', 'jalinegm02', 'predrag.pejic', 'thiarlesmedeiros2', 'davor.pocepan', 'zvuksic', None]"
63,122,8,8,2,"['davor.pocepan', 'zvuksic2']",5,"['alianme1', 'jamwitcher', 'jonathanbehrens21', 'robsondomanski', 'fuleco33']",6,"['grannykiller', 'barboco', 'slusko', 'predrag.pejic', 'zvuksic', None]",13,"['grannykiller', 'alianme1', 'barboco', 'zvuksic2', 'slusko', 'jamwitcher', 'jonathanbehrens21', 'predrag.pejic', 'davor.pocepan', 'robsondomanski', 'zvuksic', None, 'fuleco33']"
63,121,8,7,2,"['davor.pocepan', 'zvuksic2']",5,"['alianme1', 'jamwitcher', 'jonathanbehrens21', 'robsondomanski', 'fuleco33']",5,"['barboco', 'slusko', 'predrag.pejic', 'zvuksic', None]",12,"['alianme1', 'barboco', 'zvuksic2', 'slusko', 'jamwitcher', 'jonathanbehrens21', 'predrag.pejic', 'davor.pocepan', 'robsondomanski', 'zvuksic', None, 'fuleco33']"
65,74,7,31,1,['abcazaz22'],5,"['liquidxskull', 'zeng31purdue', 'gscofiel', 'rhein', 'haojiex']",30,"['obrien70', 'rwilmes', 'dblomek', 'jterrel61', 'sun272', 'song218', 'pelaez204', 'liu991', 'port', 'bkads1163', 'chen1011', 'kim1325', None, 'cdymond', 'yang463', 'havins', 'tlambros', 'grawlins', 'jcompara', 'duvall0', 'sdeschai', 'lyeh', 'kint', 'jackie0212', 'love20', 'dollarboy', 'wcostaki', 'ben.helfrecht', 'garrettwass', 'schumm']",36,"['dblomek', 'jterrel61', 'sun272', 'song218', 'port', 'bkads1163', 'haojiex', 'chen1011', 'havins', 'zeng31purdue', 'tlambros', 'grawlins', 'rhein', 'jcompara', 'duvall0', 'lyeh', 'kint', 'jackie0212', 'dollarboy', 'wcostaki', 'ben.helfrecht', 'garrettwass', 'schumm', 'obrien70', 'rwilmes', 'pelaez204', 'liu991', 'kim1325', None, 'yang463', 'liquidxskull', 'gscofiel', 'sdeschai', 'love20', 'abcazaz22', 'cdymond']"
65,126,7,29,5,"['liquidxskull', 'gscofiel', 'rhein', 'abcazaz22', 'haojiex']",1,['zeng31purdue'],24,"['obrien70', 'rwilmes', 'mrencheck', 'sun272', 'wang1640', 'pelaez204', 'ckwok144', 'liu991', 'soltys', 'bkads1163', 'chen1011', 'quentinl', None, 'pnoren', 'havins', 'tlambros', 'duvall0', 'sdeschai', 'lyeh', 'love20', 'dollarboy', 'wcostaki', 'ben.helfrecht', 'cdymond']",30,"['mrencheck', 'sun272', 'soltys', 'bkads1163', 'haojiex', 'chen1011', 'quentinl', 'havins', 'zeng31purdue', 'tlambros', 'rhein', 'duvall0', 'lyeh', 'dollarboy', 'wcostaki', 'ben.helfrecht', 'obrien70', 'rwilmes', 'wang1640', 'pelaez204', 'ckwok144', 'liu991', None, 'liquidxskull', 'pnoren', 'gscofiel', 'sdeschai', 'love20', 'abcazaz22', 'cdymond']"
65,76,7,25,3,"['abcazaz22', 'haojiex', 'zeng31purdue']",3,"['gscofiel', 'rhein', 'liquidxskull']",22,"['dblomek', 'jterrel61', 'sun272', 'port', 'chen1011', 'quentinl', 'havins', 'tlambros', 'grawlins', 'duvall0', 'mroux', 'jackie0212', 'wcostaki', 'ben.helfrecht', 'obrien70', 'liu991', 'kim1325', None, 'yang463', 'zhan1193', 'sdeschai', 'cdymond']",28,"['obrien70', 'dblomek', 'jterrel61', 'sun272', 'liu991', 'port', None, 'haojiex', 'chen1011', 'quentinl', 'kim1325', 'yang463', 'liquidxskull', 'havins', 'zeng31purdue', 'gscofiel', 'tlambros', 'rhein', 'grawlins', 'duvall0', 'zhan1193', 'sdeschai', 'mroux', 'jackie0212', 'wcostaki', 'ben.helfrecht', 'abcazaz22', 'cdymond']"
65,128,7,19,1,['gscofiel'],5,"['liquidxskull', 'zeng31purdue', 'rhein', 'abcazaz22', 'haojiex']",18,"['cdymond', 'yang463', 'rwilmes', 'dblomek', 'tlambros', 'sun272', 'grawlins', 'duvall0', 'sdeschai', 'ckwok144', 'kint', 'liu991', 'dollarboy', 'soltys', 'wcostaki', 'derek.schwanz', None, 'quentinl']",24,"['rwilmes', 'dblomek', 'sun272', 'ckwok144', 'liu991', 'soltys', 'derek.schwanz', None, 'haojiex', 'quentinl', 'yang463', 'liquidxskull', 'zeng31purdue', 'gscofiel', 'tlambros', 'rhein', 'grawlins', 'duvall0', 'sdeschai', 'kint', 'dollarboy', 'wcostaki', 'abcazaz22', 'cdymond']"
66,211,7,8,6,"['pavel92', 'radistka_ive711', 'chernyshev.nd', 'funny92', 'uporot', 'dno1']",0,[],2,"['lyudmillaa', None]",8,"['pavel92', 'radistka_ive711', 'chernyshev.nd', 'lyudmillaa', 'funny92', 'uporot', None, 'dno1']"
67,5,7,11,4,"['carloalqu', 'sonial.boterog', 'roxyulei', 'lizetteandrea']",2,"['bidrohipothik', 'sukruekinkocabas']",7,"['jerkhg', 'ancrozo', 'camilaabr', 'santiagoduquev', 'ginnap.parodim', 'linibrmeo0502', None]",13,"['sonial.boterog', 'sukruekinkocabas', 'ancrozo', 'santiagoduquev', 'linibrmeo0502', None, 'roxyulei', 'jerkhg', 'camilaabr', 'lizetteandrea', 'ginnap.parodim', 'bidrohipothik', 'carloalqu']"
68,95,7,12,5,"['gjcoram', 'chuizhou', 'shen59', 'maassenj1', 'twweng']",1,['bichen'],7,"['jmaeng', 'fluzhy', 'pdak', 'tianshi', 'shaloo', None, 'bichoy']",13,"['jmaeng', 'fluzhy', 'shen59', 'shaloo', 'maassenj1', None, 'bichen', 'bichoy', 'pdak', 'gjcoram', 'chuizhou', 'tianshi', 'twweng']"
70,18,7,9,4,"['ezeaudi', 'monteirotiago90', 'gasparrubio', 'acordatedelmail']",2,"['sumanshu', 'marcelhoffmann']",5,"['sebadeli', 'diegodelvalle', 'rodrigo_103', None, 'nikoo5']",11,"['acordatedelmail', 'monteirotiago90', 'gasparrubio', 'ezeaudi', 'nikoo5', 'sumanshu', 'marcelhoffmann', 'rodrigo_103', None, 'sebadeli', 'diegodelvalle']"
74,26,7,12,5,"['ztsin7574', 'msclemon', 'yaoguanwen', 'wassupyo412', 'spencerward']",1,['woerns'],7,"['liuhang', 'nosa2104', 'yao14', 'sdamle', 'physics4thewin', None, 'ucapssong']",13,"['ztsin7574', 'woerns', 'wassupyo412', 'physics4thewin', 'spencerward', None, 'ucapssong', 'msclemon', 'yaoguanwen', 'nosa2104', 'liuhang', 'yao14', 'sdamle']"
74,40,7,10,4,"['yaoguanwen', 'woerns', 'wassupyo412', 'spencerward']",2,"['ztsin7574', 'msclemon']",6,"['liuhang', 'samir.s.damle', 'jyhuang09', 'yao14', 'lujiang', None]",12,"['ztsin7574', 'woerns', 'wassupyo412', 'samir.s.damle', 'spencerward', 'lujiang', None, 'msclemon', 'yaoguanwen', 'liuhang', 'jyhuang09', 'yao14']"
78,5,7,11,4,"['ancrozo', 'linibrmeo0502', 'jerkhg', 'ginnap.parodim']",2,"['dalanbayar', 'moh30373']",7,"['sonial.boterog', 'camilaabr', 'lizetteandrea', 'santiagoduquev', 'carloalqu', None, 'roxyulei']",13,"['sonial.boterog', 'ancrozo', 'moh30373', 'santiagoduquev', 'linibrmeo0502', None, 'roxyulei', 'dalanbayar', 'jerkhg', 'camilaabr', 'lizetteandrea', 'ginnap.parodim', 'carloalqu']"
78,7,7,11,4,"['ancrozo', 'linibrmeo0502', 'jerkhg', 'ginnap.parodim']",2,"['dalanbayar', 'moh30373']",7,"['david9402', 'nanofredy', 'dm14', 'camilaabr', None, 'roxyuleidy', 'steve.ortiznarvaez']",13,"['ancrozo', 'moh30373', 'linibrmeo0502', None, 'david9402', 'dalanbayar', 'jerkhg', 'nanofredy', 'dm14', 'camilaabr', 'ginnap.parodim', 'roxyuleidy', 'steve.ortiznarvaez']"
79,248,6,81,1,['sschafft'],4,"['nik121nik', 'kennell', 'ewitkosk', 'park43']",80,"['rajugupta', 'zwzhang.purdue', 'hctest5', 'h.chenchu', 'cao42', 'heyu07', 'bermel', 'pastabasta8', 'nkissebe', 'hctest1', 'bss12', 'sissichen0322', 'nrajpurk', 'svee', 'wang159', 'poji', 'amrshahat', 'josephsilva823', 'woodswims', 'spalit', 'pmeunier', 'hctest4', 'hesam', 'swoop', 'jsudibyo', 'valencid', 'bhaley', 'spwilson', 'ishan66', 'tjhacker', 'jin52', 'msalmani', 'hctest3', 'kibech', 'chuyuanchen', 'hojin92', 'hankh825', 'clarksm', 'kevyblock', 'feng55', 'kmargata', 'zooley', 'faltens', 'prasadsarang', 'jdbermeol', 'jorgem93', 'light2', 'ltang', 'wangyide92', 'samikm', 'gf.giraldo239', 'apps', 'jgeng', 'casfan', 'browne3', 'bmsutton', 'barasaadah', 'turkstra', 'ontarugera', 'schcats', 'aghimire00', 'mmh', 'dalemus', 'lu216', 'dkearney', 'cshang', None, 'gah', 'saima', 'mathur7', 'rafatulfaria', 'sramadas', 'han226', 'nkharche', 'ghosh17', 'cao54', 'amr7582', 'mmc', 'ovi_1000', 'denphi']",85,"['rajugupta', 'park43', 'zwzhang.purdue', 'hctest5', 'h.chenchu', 'cao42', 'heyu07', 'bermel', 'pastabasta8', 'nkissebe', 'hctest1', 'bss12', 'sissichen0322', 'nrajpurk', 'svee', 'wang159', 'poji', 'amrshahat', 'josephsilva823', 'woodswims', 'spalit', 'pmeunier', 'hctest4', 'hesam', 'swoop', 'jsudibyo', 'valencid', 'bhaley', 'spwilson', 'ishan66', 'tjhacker', 'jin52', 'msalmani', 'hctest3', 'kibech', 'chuyuanchen', 'sschafft', 'hojin92', 'hankh825', 'clarksm', 'nik121nik', 'kevyblock', 'feng55', 'kmargata', 'zooley', 'faltens', 'prasadsarang', 'jdbermeol', 'jorgem93', 'light2', 'ltang', 'kennell', 'wangyide92', 'samikm', 'apps', 'gf.giraldo239', 'jgeng', 'casfan', 'browne3', 'bmsutton', 'barasaadah', 'turkstra', 'ontarugera', 'schcats', 'aghimire00', 'mmh', 'dalemus', 'lu216', 'dkearney', 'cshang', None, 'gah', 'saima', 'ewitkosk', 'mathur7', 'rafatulfaria', 'sramadas', 'han226', 'nkharche', 'ghosh17', 'cao54', 'amr7582', 'mmc', 'ovi_1000', 'denphi']"
79,249,6,8,1,['sschafft'],4,"['nik121nik', 'kennell', 'ewitkosk', 'park43']",7,"['kibech', 'nkharche', 'davgumo', 'j.mohamadinegad92', 'barasaadah', None, 'gah']",12,"['nik121nik', 'kennell', 'ewitkosk', 'kibech', 'park43', 'nkharche', 'davgumo', 'j.mohamadinegad92', 'barasaadah', 'sschafft', None, 'gah']"
82,30,6,76,4,"['jgwright', 'asharip', 'brandondeal', 'dustin.esman']",1,['hlhaines'],72,"['deanhartman7', 'gavingt', 'connorchilton', 'srini999', 'sbowcock1', 'alecmcc93', 'mgjaggers', 'eshaikh', 'joshuajerkins', 'yyemitan1', 'mkanand89', 'kkalexa1', 'spdewitt', 'ohdannyboy25', 'gspell', 'lemaitre7', 'mkgeres', 'lightfooot', 'gilbert.madril', 'michael.jason.ku', 'cnhoang', 'pdcurtis', 'shannonlip', 'speakoutloudly', 'nhorvat1', 'awtanner', 'wtlittle', 'uaevip20000', 'donkeykonk', 'ferry', 'rburke12', 'adharan', 'tmerick1', 'pastorin', 'jingliangzhong', 'tvdo1', 'kcrosner', 'jonathan.davis.391', 'sensisounds', 'jaredbecker', 'geniuslb12345', 'drinkupmehearties525', 'rfang4', 'amandankeil', 'gouron73', 'jalon_sisson', 'nshemer', 'thvincent200690', 'jaduart1', 'iwillzuu', 'lunwei', 'ironkaanon', 'geselby', 'timmerix', 'jmsloan1', 'chrisloff', 'jpbefort', 'timt8ion', 'mrsnef1', None, 'chrismay', 'nmaududi', 'acipressi', 'nmspirak', 'lbj2128694', 'leotherprofile', 'kevdhanson', 'smatheos', 'rymahoney12', 'csikes', 'veramos92', 'steve6707']",77,"['deanhartman7', 'gavingt', 'connorchilton', 'srini999', 'sbowcock1', 'alecmcc93', 'mgjaggers', 'eshaikh', 'joshuajerkins', 'yyemitan1', 'mkanand89', 'kkalexa1', 'spdewitt', 'ohdannyboy25', 'gspell', 'lemaitre7', 'mkgeres', 'lightfooot', 'gilbert.madril', 'michael.jason.ku', 'brandondeal', 'cnhoang', 'pdcurtis', 'shannonlip', 'speakoutloudly', 'nhorvat1', 'awtanner', 'wtlittle', 'uaevip20000', 'donkeykonk', 'ferry', 'rburke12', 'adharan', 'tmerick1', 'pastorin', 'jingliangzhong', 'dustin.esman', 'tvdo1', 'kcrosner', 'asharip', 'jonathan.davis.391', 'sensisounds', 'jaredbecker', 'geniuslb12345', 'drinkupmehearties525', 'rfang4', 'amandankeil', 'gouron73', 'jalon_sisson', 'nshemer', 'thvincent200690', 'jaduart1', 'iwillzuu', 'lunwei', 'ironkaanon', 'geselby', 'timmerix', 'jmsloan1', 'chrisloff', 'jpbefort', 'timt8ion', 'mrsnef1', None, 'chrismay', 'nmaududi', 'hlhaines', 'acipressi', 'nmspirak', 'lbj2128694', 'leotherprofile', 'jgwright', 'smatheos', 'kevdhanson', 'csikes', 'rymahoney12', 'veramos92', 'steve6707']"
82,48,6,70,4,"['jgwright', 'asharip', 'brandondeal', 'dustin.esman']",1,['hlhaines'],66,"['deanhartman7', 'gavingt', 'connorchilton', 'anshul1993', 'alecmcc93', 'mgjaggers', 'eshaikh', 'joshuajerkins', 'yyemitan1', 'kkalexa1', 'spdewitt', 'ohdannyboy25', 'gspell', 'lemaitre7', 'mkgeres', 'lightfooot', 'gilbert.madril', 'michael.jason.ku', 'cnhoang', 'pdcurtis', 'shannonlip', 'speakoutloudly', 'nhorvat1', 'awtanner', 'sbowcock', 'wtlittle', 'uaevip20000', 'donkeykonk', 'rburke12', 'tmerick1', 'pastorin', 'jingliangzhong', 'tvdo1', 'kcrosner', 'payelray', 'aaron12', 'jonathan.davis.391', 'jaredbecker', 'drinkupmehearties525', 'amandankeil', 'gouron73', 'nkjorgen', 'nshemer', 'thvincent200690', 'jaduart1', 'iwillzuu', 'ironkaanon', 'geselby', 'jmsloan1', 'chrisloff', 'jpbefort', 'timt8ion', 'mrsnef1', None, 'chrismay', 'sposborn', 'jkung', 'acipressi', 'nmspirak', 'nitishsharmabit', 'lbj2128694', 'kevdhanson', 'smatheos', 'rymahoney12', 'csikes', 'veramos92']",71,"['deanhartman7', 'gavingt', 'connorchilton', 'anshul1993', 'alecmcc93', 'mgjaggers', 'eshaikh', 'joshuajerkins', 'yyemitan1', 'kkalexa1', 'spdewitt', 'ohdannyboy25', 'gspell', 'lemaitre7', 'mkgeres', 'lightfooot', 'gilbert.madril', 'michael.jason.ku', 'brandondeal', 'cnhoang', 'pdcurtis', 'shannonlip', 'speakoutloudly', 'nhorvat1', 'awtanner', 'sbowcock', 'wtlittle', 'uaevip20000', 'donkeykonk', 'rburke12', 'tmerick1', 'pastorin', 'jingliangzhong', 'dustin.esman', 'tvdo1', 'kcrosner', 'payelray', 'aaron12', 'asharip', 'jonathan.davis.391', 'jaredbecker', 'drinkupmehearties525', 'amandankeil', 'gouron73', 'nkjorgen', 'nshemer', 'thvincent200690', 'jaduart1', 'iwillzuu', 'ironkaanon', 'geselby', 'jmsloan1', 'chrisloff', 'jpbefort', 'timt8ion', 'mrsnef1', None, 'chrismay', 'sposborn', 'jkung', 'hlhaines', 'acipressi', 'nmspirak', 'nitishsharmabit', 'lbj2128694', 'jgwright', 'smatheos', 'kevdhanson', 'csikes', 'rymahoney12', 'veramos92']"
82,167,6,66,5,"['asharip', 'brandondeal', 'hlhaines', 'jgwright', 'dustin.esman']",0,[],61,"['deanhartman7', 'gavingt', 'connorchilton', 'sbowcock1', 'anshul1993', 'alecmcc93', 'mgjaggers', 'joshuajerkins', 'yyemitan1', 'kkalexa1', 'spdewitt', 'gspell', 'lemaitre7', 'mkgeres', 'lightfooot', 'gilbert.madril', 'michael.jason.ku', 'pdcurtis', 'shannonlip', 'speakoutloudly', 'nhorvat1', 'awtanner', 'wtlittle', 'uaevip20000', 'donkeykonk', 'ferry', 'rburke12', 'adharan', 'tmerick1', 'pastorin', 'jingliangzhong', 'tvdo1', 'kcrosner', 'payelray', 'jonathan.davis.391', 'drinkupmehearties525', 'amandankeil', 'gouron73', 'jalon_sisson', 'thvincent200690', 'jaduart1', 'jshahani', 'iwillzuu', 'ironkaanon', 'geselby', 'jmsloan1', 'chrisloff', 'jpbefort', 'timt8ion', None, 'chrismay', 'nmaududi', 'acipressi', 'missymar', 'nmspirak', 'lbj2128694', 'kevdhanson', 'smatheos', 'rymahoney12', 'csikes', 'veramos92']",66,"['deanhartman7', 'gavingt', 'connorchilton', 'sbowcock1', 'anshul1993', 'alecmcc93', 'mgjaggers', 'joshuajerkins', 'yyemitan1', 'kkalexa1', 'spdewitt', 'gspell', 'lemaitre7', 'mkgeres', 'lightfooot', 'gilbert.madril', 'michael.jason.ku', 'brandondeal', 'pdcurtis', 'shannonlip', 'speakoutloudly', 'nhorvat1', 'awtanner', 'wtlittle', 'uaevip20000', 'donkeykonk', 'ferry', 'rburke12', 'adharan', 'tmerick1', 'pastorin', 'jingliangzhong', 'dustin.esman', 'tvdo1', 'kcrosner', 'payelray', 'asharip', 'jonathan.davis.391', 'drinkupmehearties525', 'amandankeil', 'gouron73', 'jalon_sisson', 'thvincent200690', 'jaduart1', 'jshahani', 'iwillzuu', 'ironkaanon', 'geselby', 'jmsloan1', 'chrisloff', 'jpbefort', 'timt8ion', None, 'chrismay', 'nmaududi', 'hlhaines', 'acipressi', 'missymar', 'nmspirak', 'lbj2128694', 'jgwright', 'smatheos', 'kevdhanson', 'csikes', 'rymahoney12', 'veramos92']"
82,87,6,60,2,"['asharip', 'brandondeal']",3,"['jgwright', 'dustin.esman', 'hlhaines']",58,"['payelray', 'deanhartman7', 'jonathan.davis.391', 'gavingt', 'drinkupmehearties525', 'connorchilton', 'tvdo1', 'amandankeil', 'gouron73', 'jalon_sisson', 'sbowcock1', 'anshul1993', 'alecmcc93', 'joshuajerkins', 'yyemitan1', 'ksa.elias', 'nshemer', 'thvincent200690', 'ohdannyboy25', 'gspell', 'kkalexa1', 'jaduart1', 'jshahani', 'lemaitre7', 'spdewitt', 'ironkaanon', 'mkgeres', 'lightfooot', 'geselby', 'gilbert.madril', 'michael.jason.ku', 'pdcurtis', 'shannonlip', 'speakoutloudly', 'nhorvat1', 'chrisloff', 'awtanner', 'jpbefort', 'timt8ion', 'mrsnef1', None, 'chrismay', 'donkeykonk', 'eshaikh12', 'nmaududi', 'rburke12', 'adharan', 'acipressi', 'missymar', 'tmerick1', 'nmspirak', 'pastorin', 'lbj2128694', 'kevdhanson', 'nkjorgen', 'csikes', 'veramos92', 'kcrosner']",63,"['deanhartman7', 'gavingt', 'connorchilton', 'sbowcock1', 'anshul1993', 'alecmcc93', 'joshuajerkins', 'yyemitan1', 'kkalexa1', 'spdewitt', 'ohdannyboy25', 'gspell', 'lemaitre7', 'mkgeres', 'lightfooot', 'gilbert.madril', 'michael.jason.ku', 'brandondeal', 'pdcurtis', 'shannonlip', 'speakoutloudly', 'nhorvat1', 'awtanner', 'donkeykonk', 'eshaikh12', 'rburke12', 'adharan', 'tmerick1', 'pastorin', 'dustin.esman', 'tvdo1', 'kcrosner', 'payelray', 'asharip', 'jonathan.davis.391', 'drinkupmehearties525', 'amandankeil', 'gouron73', 'jalon_sisson', 'nkjorgen', 'ksa.elias', 'nshemer', 'thvincent200690', 'jaduart1', 'jshahani', 'ironkaanon', 'chrisloff', 'jpbefort', 'csikes', 'timt8ion', 'mrsnef1', None, 'chrismay', 'nmaududi', 'hlhaines', 'acipressi', 'missymar', 'nmspirak', 'lbj2128694', 'jgwright', 'kevdhanson', 'geselby', 'veramos92']"
82,91,6,59,4,"['jgwright', 'asharip', 'brandondeal', 'dustin.esman']",1,['hlhaines'],55,"['payelray', 'deanhartman7', 'jonathan.davis.391', 'gavingt', 'drinkupmehearties525', 'connorchilton', 'amandankeil', 'gouron73', 'jalon_sisson', 'sbowcock1', 'anshul1993', 'alecmcc93', 'joshuajerkins', 'yyemitan1', 'kkalexa1', 'thvincent200690', 'nshemer', 'gspell', 'jaduart1', 'lemaitre7', 'iwillzuu', 'spdewitt', 'ohdannyboy25', 'ironkaanon', 'geselby', 'lightfooot', 'gilbert.madril', 'michael.jason.ku', 'pdcurtis', 'shannonlip', 'speakoutloudly', 'jmsloan1', 'nhorvat1', 'awtanner', 'jpbefort', 'chrisloff', 'timt8ion', 'kcrosner', 'mrsnef1', None, 'donkeykonk', 'chrismay', 'nmaududi', 'rburke12', 'nmspirak', 'acipressi', 'pastorin', 'haoshulu', 'jingliangzhong', 'lbj2128694', 'kevdhanson', 'nkjorgen', 'csikes', 'rymahoney12', 'tvdo1']",60,"['deanhartman7', 'gavingt', 'connorchilton', 'sbowcock1', 'anshul1993', 'alecmcc93', 'joshuajerkins', 'yyemitan1', 'kkalexa1', 'spdewitt', 'ohdannyboy25', 'gspell', 'lemaitre7', 'lightfooot', 'gilbert.madril', 'michael.jason.ku', 'brandondeal', 'pdcurtis', 'shannonlip', 'speakoutloudly', 'nhorvat1', 'awtanner', 'donkeykonk', 'rburke12', 'pastorin', 'haoshulu', 'jingliangzhong', 'dustin.esman', 'kcrosner', 'tvdo1', 'payelray', 'asharip', 'jonathan.davis.391', 'drinkupmehearties525', 'amandankeil', 'gouron73', 'jalon_sisson', 'nkjorgen', 'nshemer', 'thvincent200690', 'jaduart1', 'iwillzuu', 'ironkaanon', 'jmsloan1', 'chrisloff', 'jpbefort', 'csikes', 'timt8ion', 'mrsnef1', None, 'chrismay', 'nmaududi', 'hlhaines', 'nmspirak', 'acipressi', 'lbj2128694', 'jgwright', 'kevdhanson', 'rymahoney12', 'geselby']"
82,97,6,57,3,"['jgwright', 'asharip', 'dustin.esman']",2,"['brandondeal', 'hlhaines']",54,"['payelray', 'deanhartman7', 'jonathan.davis.391', 'drinkupmehearties525', 'connorchilton', 'tvdo1', 'amandankeil', 'gouron73', 'jalon_sisson', 'sbowcock1', 'anshul1993', 'joshuajerkins', 'yyemitan1', 'kkalexa1', 'thvincent200690', 'ohdannyboy25', 'gspell', 'jshahani', 'lemaitre7', 'iwillzuu', 'spdewitt', 'ironkaanon', 'mkgeres', 'lightfooot', 'geselby', 'gilbert.madril', 'michael.jason.ku', 'pdcurtis', 'speakoutloudly', 'nhorvat1', 'chrisloff', 'awtanner', 'jpbefort', 'timt8ion', 'uaevip20000', 'mrsnef1', None, 'chrismay', 'donkeykonk', 'eshaikh12', 'nmaududi', 'rburke12', 'acipressi', 'tmerick1', 'nmspirak', 'pastorin', 'haoshulu', 'jingliangzhong', 'lbj2128694', 'kevdhanson', 'nkjorgen', 'csikes', 'rymahoney12', 'kcrosner']",59,"['payelray', 'deanhartman7', 'asharip', 'jonathan.davis.391', 'drinkupmehearties525', 'connorchilton', 'amandankeil', 'gouron73', 'jalon_sisson', 'sbowcock1', 'anshul1993', 'nkjorgen', 'joshuajerkins', 'yyemitan1', 'kkalexa1', 'thvincent200690', 'ohdannyboy25', 'gspell', 'jshahani', 'lemaitre7', 'iwillzuu', 'spdewitt', 'ironkaanon', 'mkgeres', 'lightfooot', 'gilbert.madril', 'michael.jason.ku', 'brandondeal', 'pdcurtis', 'speakoutloudly', 'nhorvat1', 'chrisloff', 'awtanner', 'jpbefort', 'csikes', 'timt8ion', 'uaevip20000', 'kcrosner', 'mrsnef1', None, 'chrismay', 'donkeykonk', 'eshaikh12', 'nmaududi', 'rburke12', 'hlhaines', 'acipressi', 'tmerick1', 'nmspirak', 'pastorin', 'haoshulu', 'jingliangzhong', 'lbj2128694', 'dustin.esman', 'jgwright', 'kevdhanson', 'geselby', 'rymahoney12', 'tvdo1']"
82,10,6,55,4,"['jgwright', 'asharip', 'dustin.esman', 'hlhaines']",1,['brandondeal'],51,"['payelray', 'deanhartman7', 'jonathan.davis.391', 'drinkupmehearties525', 'connorchilton', 'amandankeil', 'gouron73', 'sbowcock1', 'anshul1993', 'nkjorgen', 'alecmcc93', 'mgjaggers', 'joshuajerkins', 'yyemitan1', 'nshemer', 'thvincent200690', 'jaduart1', 'gspell', 'spdewitt', 'lemaitre7', 'iwillzuu', 'ohdannyboy25', 'geselby', 'mkgeres', 'lightfooot', 'michael.jason.ku', 'pdcurtis', 'shannonlip', 'nhorvat1', 'chrisloff', 'awtanner', 'jpbefort', 'wtlittle', 'kcrosner', 'mrsnef1', None, 'donkeykonk', 'sposborn', 'chrismay', 'rburke12', 'adharan', 'tmerick1', 'nmspirak', 'acipressi', 'pastorin', 'haoshulu', 'kevdhanson', 'smatheos', 'csikes', 'rymahoney12', 'steve6707']",56,"['payelray', 'deanhartman7', 'asharip', 'jonathan.davis.391', 'drinkupmehearties525', 'connorchilton', 'amandankeil', 'gouron73', 'sbowcock1', 'anshul1993', 'nkjorgen', 'alecmcc93', 'mgjaggers', 'joshuajerkins', 'yyemitan1', 'steve6707', 'nshemer', 'thvincent200690', 'jaduart1', 'gspell', 'spdewitt', 'lemaitre7', 'iwillzuu', 'ohdannyboy25', 'mkgeres', 'lightfooot', 'michael.jason.ku', 'brandondeal', 'pdcurtis', 'shannonlip', 'nhorvat1', 'chrisloff', 'awtanner', 'jpbefort', 'csikes', 'wtlittle', 'mrsnef1', None, 'donkeykonk', 'sposborn', 'chrismay', 'rburke12', 'smatheos', 'adharan', 'hlhaines', 'tmerick1', 'nmspirak', 'acipressi', 'pastorin', 'haoshulu', 'dustin.esman', 'jgwright', 'kevdhanson', 'geselby', 'rymahoney12', 'kcrosner']"
82,155,6,53,4,"['jgwright', 'asharip', 'brandondeal', 'dustin.esman']",1,['hlhaines'],49,"['payelray', 'deanhartman7', 'jonathan.davis.391', 'drinkupmehearties525', 'connorchilton', 'amandankeil', 'gouron73', 'anshul1993', 'nkjorgen', 'alecmcc93', 'mgjaggers', 'joshuajerkins', 'yyemitan1', 'kkalexa1', 'thvincent200690', 'jaduart1', 'gspell', 'spdewitt', 'lemaitre7', 'ohdannyboy25', 'ironkaanon', 'mkgeres', 'lightfooot', 'geselby', 'gilbert.madril', 'michael.jason.ku', 'pdcurtis', 'shannonlip', 'awtanner', 'jpbefort', 'wtlittle', 'timt8ion', 'mrsnef1', None, 'donkeykonk', 'chrismay', 'eshaikh12', 'rburke12', 'adharan', 'nmspirak', 'acipressi', 'pastorin', 'jingliangzhong', 'lbj2128694', 'kevdhanson', 'smatheos', 'csikes', 'rymahoney12', 'kcrosner']",54,"['payelray', 'deanhartman7', 'asharip', 'jonathan.davis.391', 'drinkupmehearties525', 'connorchilton', 'amandankeil', 'gouron73', 'anshul1993', 'nkjorgen', 'alecmcc93', 'mgjaggers', 'joshuajerkins', 'yyemitan1', 'kkalexa1', 'thvincent200690', 'jaduart1', 'gspell', 'spdewitt', 'lemaitre7', 'ohdannyboy25', 'ironkaanon', 'mkgeres', 'lightfooot', 'gilbert.madril', 'michael.jason.ku', 'brandondeal', 'pdcurtis', 'shannonlip', 'awtanner', 'jpbefort', 'csikes', 'wtlittle', 'timt8ion', 'mrsnef1', None, 'donkeykonk', 'chrismay', 'eshaikh12', 'rburke12', 'smatheos', 'adharan', 'hlhaines', 'nmspirak', 'acipressi', 'pastorin', 'jingliangzhong', 'lbj2128694', 'dustin.esman', 'jgwright', 'kevdhanson', 'geselby', 'rymahoney12', 'kcrosner']"
82,106,6,51,5,"['asharip', 'brandondeal', 'hlhaines', 'jgwright', 'dustin.esman']",0,[],46,"['payelray', 'deanhartman7', 'jonathan.davis.391', 'connorchilton', 'amandankeil', 'gouron73', 'anshul1993', 'alecmcc93', 'joshuajerkins', 'yyemitan1', 'nshemer', 'thvincent200690', 'ohdannyboy25', 'gspell', 'kkalexa1', 'jaduart1', 'spdewitt', 'ironkaanon', 'mkgeres', 'lightfooot', 'geselby', 'gilbert.madril', 'michael.jason.ku', 'pdcurtis', 'shannonlip', 'nhorvat1', 'chrisloff', 'awtanner', 'wtlittle', 'timt8ion', 'mrsnef1', None, 'chrismay', 'donkeykonk', 'eshaikh12', 'rburke12', 'adharan', 'acipressi', 'nmspirak', 'pastorin', 'jingliangzhong', 'lbj2128694', 'kevdhanson', 'smatheos', 'csikes', 'kcrosner']",51,"['payelray', 'deanhartman7', 'asharip', 'jonathan.davis.391', 'connorchilton', 'amandankeil', 'gouron73', 'anshul1993', 'alecmcc93', 'joshuajerkins', 'yyemitan1', 'nshemer', 'thvincent200690', 'ohdannyboy25', 'gspell', 'kkalexa1', 'jaduart1', 'spdewitt', 'ironkaanon', 'mkgeres', 'lightfooot', 'gilbert.madril', 'michael.jason.ku', 'brandondeal', 'pdcurtis', 'shannonlip', 'nhorvat1', 'chrisloff', 'awtanner', 'csikes', 'wtlittle', 'timt8ion', 'mrsnef1', None, 'chrismay', 'donkeykonk', 'eshaikh12', 'rburke12', 'smatheos', 'adharan', 'hlhaines', 'acipressi', 'nmspirak', 'pastorin', 'jingliangzhong', 'lbj2128694', 'dustin.esman', 'jgwright', 'kevdhanson', 'geselby', 'kcrosner']"
82,63,6,48,2,"['asharip', 'dustin.esman']",3,"['brandondeal', 'jgwright', 'hlhaines']",46,"['deanhartman7', 'jonathan.davis.391', 'drinkupmehearties525', 'connorchilton', 'amandankeil', 'jalon_sisson', 'sbowcock1', 'anshul1993', 'joshuajerkins', 'kkalexa1', 'thvincent200690', 'jaduart1', 'gspell', 'spdewitt', 'lemaitre7', 'iwillzuu', 'ohdannyboy25', 'ironkaanon', 'mkgeres', 'lightfooot', 'geselby', 'michael.jason.ku', 'pdcurtis', 'shannonlip', 'speakoutloudly', 'nhorvat1', 'chrisloff', 'awtanner', 'jpbefort', 'wtlittle', 'kcrosner', 'mrsnef1', None, 'donkeykonk', 'chrismay', 'nmaududi', 'rburke12', 'tmerick1', 'nmspirak', 'acipressi', 'pastorin', 'lbj2128694', 'nkjorgen', 'rymahoney12', 'csikes', 'tvdo1']",51,"['deanhartman7', 'asharip', 'jonathan.davis.391', 'drinkupmehearties525', 'connorchilton', 'tvdo1', 'amandankeil', 'jalon_sisson', 'sbowcock1', 'anshul1993', 'nkjorgen', 'joshuajerkins', 'kkalexa1', 'thvincent200690', 'jaduart1', 'gspell', 'spdewitt', 'lemaitre7', 'iwillzuu', 'ohdannyboy25', 'ironkaanon', 'mkgeres', 'lightfooot', 'michael.jason.ku', 'brandondeal', 'pdcurtis', 'shannonlip', 'speakoutloudly', 'nhorvat1', 'chrisloff', 'awtanner', 'jpbefort', 'csikes', 'wtlittle', 'mrsnef1', None, 'donkeykonk', 'chrismay', 'nmaududi', 'rburke12', 'hlhaines', 'tmerick1', 'nmspirak', 'acipressi', 'pastorin', 'lbj2128694', 'dustin.esman', 'jgwright', 'rymahoney12', 'geselby', 'kcrosner']"
82,14,6,33,3,"['jgwright', 'asharip', 'dustin.esman']",2,"['brandondeal', 'hlhaines']",30,"['payelray', 'deanhartman7', 'jonathan.davis.391', 'drinkupmehearties525', 'sbowcock1', 'anshul1993', 'joshuajerkins', 'thvincent200690', 'spdewitt', 'gspell', 'ohdannyboy25', 'lemaitre7', 'iwillzuu', 'mkgeres', 'lightfooot', 'pdcurtis', 'shannonlip', 'awtanner', 'mrsnef1', None, 'donkeykonk', 'chrismay', 'rburke12', 'nmspirak', 'acipressi', 'pastorin', 'nkjorgen', 'rymahoney12', 'csikes', 'kcrosner']",35,"['payelray', 'deanhartman7', 'asharip', 'jonathan.davis.391', 'drinkupmehearties525', 'sbowcock1', 'anshul1993', 'nkjorgen', 'joshuajerkins', 'thvincent200690', 'spdewitt', 'gspell', 'ohdannyboy25', 'lemaitre7', 'iwillzuu', 'mkgeres', 'lightfooot', 'brandondeal', 'pdcurtis', 'shannonlip', 'awtanner', 'mrsnef1', None, 'donkeykonk', 'chrismay', 'rburke12', 'hlhaines', 'nmspirak', 'acipressi', 'pastorin', 'dustin.esman', 'jgwright', 'rymahoney12', 'csikes', 'kcrosner']"
82,8,6,28,4,"['jgwright', 'asharip', 'brandondeal', 'dustin.esman']",1,['hlhaines'],24,"['deanhartman7', 'jonathan.davis.391', 'gavingt', 'nhorvat1', 'awtanner', 'drinkupmehearties525', 'csikes', 'amandankeil', 'mrsnef1', 'gouron73', None, 'donkeykonk', 'sbowcock1', 'nkjorgen', 'nmspirak', 'acipressi', 'spdewitt', 'thvincent200690', 'gspell', 'kevdhanson', 'lemaitre7', 'iwillzuu', 'geselby', 'lightfooot']",29,"['deanhartman7', 'asharip', 'jonathan.davis.391', 'gavingt', 'drinkupmehearties525', 'amandankeil', 'gouron73', 'sbowcock1', 'nkjorgen', 'spdewitt', 'thvincent200690', 'gspell', 'lemaitre7', 'iwillzuu', 'lightfooot', 'brandondeal', 'nhorvat1', 'awtanner', 'csikes', 'mrsnef1', None, 'donkeykonk', 'hlhaines', 'nmspirak', 'acipressi', 'dustin.esman', 'jgwright', 'kevdhanson', 'geselby']"
82,12,6,21,2,"['dustin.esman', 'hlhaines']",3,"['asharip', 'brandondeal', 'jgwright']",19,"['jaredbecker', 'connorchilton', 'amandankeil', 'sbowcock1', 'nshemer', 'jaduart1', 'lemaitre7', 'iwillzuu', 'mkgeres', 'nhorvat1', 'chrisloff', 'awtanner', 'mrsnef1', None, 'ferry', 'tmerick1', 'nmspirak', 'haoshulu', 'kcrosner']",24,"['asharip', 'brandondeal', 'jaredbecker', 'nhorvat1', 'chrisloff', 'awtanner', 'connorchilton', 'amandankeil', 'mrsnef1', None, 'ferry', 'sbowcock1', 'hlhaines', 'tmerick1', 'nmspirak', 'haoshulu', 'nshemer', 'jaduart1', 'dustin.esman', 'jgwright', 'lemaitre7', 'iwillzuu', 'kcrosner', 'mkgeres']"
82,3,6,10,4,"['jgwright', 'asharip', 'brandondeal', 'dustin.esman']",1,['hlhaines'],6,"['gavingt', 'mrsnef1', 'jingliangzhong', 'gspell', 'iwillzuu', None]",11,"['iwillzuu', 'asharip', 'brandondeal', 'gavingt', 'hlhaines', 'gspell', 'jingliangzhong', 'dustin.esman', 'jgwright', 'mrsnef1', None]"
82,17,6,9,1,['dustin.esman'],4,"['asharip', 'brandondeal', 'jgwright', 'hlhaines']",8,"['sbowcock1', 'acipressi', 'vasileska', 'ckakizaw', 'nkjorgen', 'loda1', None, 'a9b1c3']",13,"['sbowcock1', 'asharip', 'nkjorgen', 'brandondeal', 'hlhaines', 'acipressi', 'vasileska', 'ckakizaw', 'dustin.esman', 'jgwright', 'loda1', None, 'a9b1c3']"
82,11,6,7,2,"['brandondeal', 'hlhaines']",3,"['jgwright', 'asharip', 'dustin.esman']",5,"['mgjaggers', 'zhipeng', 'steve6707', 'haoshulu', None]",10,"['asharip', 'brandondeal', 'mgjaggers', 'hlhaines', 'zhipeng', 'haoshulu', 'dustin.esman', 'jgwright', None, 'steve6707']"
83,30,6,76,4,"['mkanand89', 'lunwei', 'leotherprofile', 'timmerix']",1,['lcy1128'],72,"['deanhartman7', 'gavingt', 'connorchilton', 'srini999', 'sbowcock1', 'alecmcc93', 'mgjaggers', 'eshaikh', 'joshuajerkins', 'yyemitan1', 'kkalexa1', 'spdewitt', 'ohdannyboy25', 'gspell', 'lemaitre7', 'mkgeres', 'lightfooot', 'gilbert.madril', 'michael.jason.ku', 'cnhoang', 'pdcurtis', 'shannonlip', 'brandondeal', 'speakoutloudly', 'nhorvat1', 'awtanner', 'wtlittle', 'uaevip20000', 'donkeykonk', 'ferry', 'rburke12', 'adharan', 'tmerick1', 'pastorin', 'jingliangzhong', 'dustin.esman', 'tvdo1', 'kcrosner', 'asharip', 'jonathan.davis.391', 'sensisounds', 'jaredbecker', 'geniuslb12345', 'drinkupmehearties525', 'rfang4', 'amandankeil', 'gouron73', 'jalon_sisson', 'nshemer', 'thvincent200690', 'jaduart1', 'iwillzuu', 'ironkaanon', 'geselby', 'jmsloan1', 'chrisloff', 'jpbefort', 'timt8ion', 'mrsnef1', None, 'chrismay', 'nmaududi', 'acipressi', 'nmspirak', 'lbj2128694', 'kevdhanson', 'smatheos', 'rymahoney12', 'csikes', 'jgwright', 'veramos92', 'steve6707']",77,"['deanhartman7', 'gavingt', 'connorchilton', 'srini999', 'sbowcock1', 'alecmcc93', 'mgjaggers', 'eshaikh', 'joshuajerkins', 'yyemitan1', 'mkanand89', 'kkalexa1', 'spdewitt', 'ohdannyboy25', 'gspell', 'lemaitre7', 'lcy1128', 'mkgeres', 'lightfooot', 'gilbert.madril', 'michael.jason.ku', 'cnhoang', 'pdcurtis', 'shannonlip', 'brandondeal', 'speakoutloudly', 'nhorvat1', 'awtanner', 'wtlittle', 'uaevip20000', 'donkeykonk', 'ferry', 'rburke12', 'adharan', 'tmerick1', 'pastorin', 'jingliangzhong', 'dustin.esman', 'tvdo1', 'kcrosner', 'asharip', 'jonathan.davis.391', 'sensisounds', 'jaredbecker', 'geniuslb12345', 'drinkupmehearties525', 'rfang4', 'amandankeil', 'gouron73', 'jalon_sisson', 'nshemer', 'thvincent200690', 'jaduart1', 'lunwei', 'iwillzuu', 'ironkaanon', 'geselby', 'timmerix', 'jmsloan1', 'chrisloff', 'jpbefort', 'timt8ion', 'mrsnef1', None, 'chrismay', 'nmaududi', 'acipressi', 'nmspirak', 'lbj2128694', 'leotherprofile', 'kevdhanson', 'smatheos', 'rymahoney12', 'csikes', 'jgwright', 'veramos92', 'steve6707']"
86,243,6,6,5,"['tangchun', 'huxiaoli', 'larry2014', 'kcheung9', 'zhijiangye1106']",0,[],1,[None],6,"['tangchun', 'huxiaoli', 'larry2014', 'kcheung9', 'zhijiangye1106', None]"
87,93,6,16,2,"['caperezg', 'danielduarteruiz']",3,"['joaofonseca', 'vsbvnit', 'd.e.j.armstrong']",14,"['smonsalve', 'javierhaz', 'manueljgr', 'jdpinedac', 'oscar3578', 'lpatino', 'dafranco8', 'liguaran', 'dmarque33', 'marcomas', 'ealarco1', 'lalzatev', None, 'wsanche2']",19,"['javierhaz', 'caperezg', 'joaofonseca', 'dmarque33', 'vsbvnit', 'd.e.j.armstrong', 'danielduarteruiz', None, 'wsanche2', 'smonsalve', 'manueljgr', 'jdpinedac', 'oscar3578', 'lpatino', 'dafranco8', 'liguaran', 'marcomas', 'ealarco1', 'lalzatev']"
90,172,6,25,2,"['ekhera', 'tmushove']",3,"['sorin', 'vivek.ka', 'emma1210']",23,"['aunnie', 'gvr', 'caifuxi', 'chuenlai', 'ringoh', 'zhihua.huang.77', 'shaunj', 'yoonseob', 'chadak', 'khalid.its.me', 'nathort13', 'dsoltan', 'qcb', 'timzhang', None, 'allamour', 'joannamm', 'tge', 'croop', 'jpmathis', 'skramad', 'george.hargenrader', 'songkaixin']",28,"['aunnie', 'gvr', 'tmushove', 'caifuxi', 'chuenlai', 'ringoh', 'zhihua.huang.77', 'shaunj', 'yoonseob', 'chadak', 'khalid.its.me', 'nathort13', 'dsoltan', 'qcb', 'timzhang', None, 'allamour', 'joannamm', 'tge', 'sorin', 'emma1210', 'croop', 'jpmathis', 'vivek.ka', 'skramad', 'george.hargenrader', 'ekhera', 'songkaixin']"
91,98,6,6,3,"['aviraj', 'shubhrantjibhkate', 'sumeetisai']",2,"['ashwini.visave', 'ppp']",3,"['farhanrpatel', None, 'renu24']",8,"['shubhrantjibhkate', 'sumeetisai', 'ppp', 'renu24', 'farhanrpatel', 'ashwini.visave', 'aviraj', None]"
91,116,6,6,3,"['aviraj', 'shubhrantjibhkate', 'sumeetisai']",2,"['ashwini.visave', 'ppp']",3,"['farhanrpatel', None, 'renu24']",8,"['shubhrantjibhkate', 'sumeetisai', 'ppp', 'renu24', 'farhanrpatel', 'ashwini.visave', 'aviraj', None]"
92,228,6,49,4,"['bljenio', 'mtrossignol', 'klarleon', 'aaalsale']",1,['cm09l'],45,"['kerice', 'whfuss', 'ajohnson8617', 'mgmosche', 'eholmes93.secondary', 'mbmcmurr', 'jpsimmo2', 'jmpilato', 'gasingac', 'leander3', 'abondar', 'pwwessle', 'ijowsian', 'arfranc3', 'nnswyger', 'nkvonwin', 'taconfre', 'bhallen', 'jswilkin', 'jclunara', 'jmgriff5', 'klfreem2', 'ucawuruo', 'brianhaidet', 'pdgannet', 'tsbuchan', 'asporcel', 'byrowley', 'caharkin', 'latashan3', 'wawitzen', None, 'brent.morrison.1993', 'hackettman', 'bciezzi', 'raberezi', 'retrometer94', 'amygoodling', 'rwmattin', 'rammsteiner42', 'pmpoyman', 'gpscisco', 'jnbaker2', 'pjburger', 'ptwethin']",50,"['kerice', 'whfuss', 'ajohnson8617', 'bljenio', 'mgmosche', 'mbmcmurr', 'jpsimmo2', 'jmpilato', 'gasingac', 'leander3', 'abondar', 'pwwessle', 'rammsteiner42', 'ijowsian', 'arfranc3', 'nnswyger', 'nkvonwin', 'taconfre', 'bhallen', 'jswilkin', 'jclunara', 'ptwethin', 'aaalsale', 'jmgriff5', 'klfreem2', 'cm09l', 'brianhaidet', 'pdgannet', 'tsbuchan', 'asporcel', 'byrowley', 'caharkin', 'latashan3', 'wawitzen', None, 'brent.morrison.1993', 'hackettman', 'klarleon', 'bciezzi', 'raberezi', 'retrometer94', 'mtrossignol', 'amygoodling', 'rwmattin', 'eholmes93.secondary', 'pmpoyman', 'gpscisco', 'jnbaker2', 'pjburger', 'ucawuruo']"
93,26,6,12,1,['nosa2104'],4,"['ceraworld', 'jonaande106', 'jayweilu', 'disni']",11,"['ztsin7574', 'msclemon', 'yaoguanwen', 'liuhang', 'wassupyo412', 'yao14', 'sdamle', 'physics4thewin', 'spencerward', None, 'ucapssong']",16,"['jonaande106', 'ztsin7574', 'wassupyo412', 'physics4thewin', 'spencerward', None, 'ucapssong', 'msclemon', 'yaoguanwen', 'nosa2104', 'liuhang', 'yao14', 'sdamle', 'jayweilu', 'disni', 'ceraworld']"
94,130,6,321,2,"['aacosta', 'cjw']",3,"['ronogara1', 'kmcpeak', 'janosch89']",319,"['jameswillis2017', 'sgorlick', 'robertzhu2017', 'gesta', 'alila', 'rzelesko', 'survaishkhastgir', 'ldimarco', 'emilymorris2017', 'lafern', 'mcm938', 'bbl076', 'agreenstein', 'annapetersen21', 'krembisz', 'bishtonn', 'gmc830', 'sjmacrowski', 'lstyer', 'imasamba', 'nasher', 'natalianagy1', 'vmehta', 'rastatke', 'isi.sturla', 'sdaniel', 'jalvear', 'kbranch', 'ayl675', 'jarmstrong', 'abfilicko05', 'nuchem102', 'ajsnu', 'jakmak37', 'cfleesmith', 'mhackerteper', 'cryu', 'gcohen', 'myi', 'araewilliams', 'kkim27', 'tla95', 'rodriguez.ricardo13', 'broconnell', 'sgray', 'sarceo', 'jgrocott', 'rachelli2017', 'lhu642', 'jsammon', 'ajalali', 'lra391', 'jamily80', 'ajennings', 'kathrynpillischafske2017', 'ydeng', 'dperlovsky', 'kimhoff', 'jalonbrown', 'sgarcia2017', 'jkk284', 'lilyzoo', 'etburklow', 'mgullott', 'miriam.perez.35574', 'natalie5', 'bfeinstein', 'aaubrun', 'lfoley82', 'msb843', 'aibeh7906', 'igau', 'jma', 'mdoody359', 'j3nnif3r37', 'rsarette', 'benedict.dungca', 'lrawitscher', 'sem742', 'emathews', 'msamyyi', 'shwang', 'rmalekmadani', 'geapen', 'jvegaperkins713', 'kserv', 'lsleung', 'manistranski', 'yokim', 'sperez', 'torear', 'annapreston2017', 'kgong', 'samanthamurphy2017', 'bananapiehl', 'kelseyaaronson', 'isaacheine', 'ahofmeister', 'minjooson', 'rmetzgerii', 'ndivine', 'ijackylei', 'rboodram', 'annahinrichs', 'clacrosse', 'ajaynadig', 'anewell', 'schandran', 'joshauck', 'rsherman', 'sarahacs', 'kdaftary', 'afisher', 'mkelsten', 'jshin', 'marsak', 'ecripe', 'sebgar', 'jgw599', 'ynessary', 'ecbold13', 'tstoimenoff', 'pgrewal', 'jayahn0518', 'peter.g.vlahakis', 'tomliggett', 'zfenske', 'jbowleg', 'jvillanueva8', 'camilleblackman2016', 'hrucinski', 'kcm010', 'phawkyard', 'jboyer', 'bbisrat', 'hwhite', 'afarsheed', 'jki699', 'borazine', 'vlh774', 'cconnelly', 'shorstman', 'grahambullmore2017', 'omarosorio2017', 'bonesjones612', 'lawrencevinson2017', 'astults', 'davidkarlin2013', 'mclark032', 'kmobrien', 'jmccartney', 'wlindstrom', 'laurenabruzzo2017', 'wcho', 'bchen', 'pklimkow', 'marknelson2012', 'hlou88', 'kburke1', 'mgreene', 'mco2745', 'ssandor', 'n6n8u3', 'mforrest', 'juanmena2017', 'hopkins2', 'nward', 'lchen', 'ngriffiths', 'rmalhotra', 'maura.clement', 'jbs916', 'sshull', 'bdougherty', 'bbecerra', 'mmihalache', 'jschaefer', 'jburkechem122', 'connor.donovan.31', 'crazyindianpride', 'mattsherman95', 'awalls', 'rmehta95', 'annaduban2017', 'jsd31josh', 'smezyk7', 'makeda.springette', 'gallardoy09', 'obabatola', 'sarajohns2017', 'haleykoch2017', 'meganaaudipudy', 'uditapersaud', 'cmucharraz', 'nicholas.mccombe.3', 'vjansen', 'aec943', 'rweidinger', 'mgates', 'amyers17', 'alw231', 'melikimmy', 'coravasserman2017', 'bbakalarski', 'jgupta', 'swert', 'mpostoll4', 'majedfataftahnu', 'marinamin2017', 'lindseymehl2017', 'lisa.kim.961993', 'bspielman', 'msobhani', 'jesus.leon1', 'natalie.m.stanley.9', 'christycal17', 'ljung', 'mfluellen', 'mfoulkes', 'aostenso', 'ahurst', 'ssbanic', 'bkraft383', 'twang2017', 'vilte', 'cweers', 'radiohedzz', 'vrutherford', 'kschuster', 'tpierce14', 'zrubnitz', 'jtucker', 'pasha', 'ggillow', 'nn3210', 'jruan', 'natalianagytakahashi2015', 'estebanmercado2017', 'jdk681', 'mhopfner', 'youjon5', 'santana', 'hpervaiz', 'rznewman', 'okohler', 'bklein', 'aparikh22', 'sonyaluthra2015', 'asears', 'rst345', 'ellenpatterson2017', 'catherineding', 'gcamozzi', 'daniel.c.eghdami', 'njandali', 'sobel.shawn', 'crobinson19', 'agrenen', 'dweber', 'rachelrogers', 'cprucnal', 'hmiller', 'emares84', 'aamattey', 'nwh027', 'wizu', 'delagarl', 'morrisemily18', 'yuehu9510', 'slhatch', 'gabrielleforcier2015', 'brosenberg', 'brennanjackson2017', 'phaun', 'jmarquez95', 'ddapuzzo', 'cfox', 'sbahena', 'alzipursky', 'juliakovalenko2017', 'bensullivan', 'natalienowogrodzki', 'ccj009', 'amansur', 'jdrews', 'hannahbrady2017', 'wjhager2016', 'annedeb', 'anichols', 'james.amick94', 'evanbeuningen', 'zwatson', 'glak', 'aveerina', 'mdefreitas', 'rschaaf', 'stam', 'krichards', 'thomasodell2017', 'kristensmith2017', 'nickmartin44', 'plim', 'tav162', 'ajaynadig1', 'atsui4', 'cpieri', 'nnwagbo', 'dfloyd', 'akmohring', 'mwaldegerma', 'elisa4201', 'pmccullough', 'kqu', 'dmw514', 'mlaw70', 'mcoden', 'bbair', 'mstotzy1', 'kristinzubritzky']",324,"['jameswillis2017', 'sgorlick', 'robertzhu2017', 'gesta', 'alila', 'rzelesko', 'survaishkhastgir', 'ldimarco', 'emilymorris2017', 'lafern', 'mcm938', 'bbl076', 'agreenstein', 'annapetersen21', 'krembisz', 'bishtonn', 'gmc830', 'sjmacrowski', 'lstyer', 'imasamba', 'nasher', 'natalianagy1', 'vmehta', 'rastatke', 'isi.sturla', 'sdaniel', 'jalvear', 'kbranch', 'ayl675', 'jarmstrong', 'abfilicko05', 'nuchem102', 'ajsnu', 'jakmak37', 'cfleesmith', 'mhackerteper', 'cryu', 'gcohen', 'myi', 'araewilliams', 'kkim27', 'tla95', 'rodriguez.ricardo13', 'broconnell', 'sgray', 'sarceo', 'jgrocott', 'janosch89', 'rachelli2017', 'lhu642', 'jsammon', 'ajalali', 'lra391', 'jamily80', 'ajennings', 'kathrynpillischafske2017', 'ydeng', 'dperlovsky', 'kimhoff', 'jalonbrown', 'sgarcia2017', 'jkk284', 'lilyzoo', 'etburklow', 'mgullott', 'miriam.perez.35574', 'natalie5', 'bfeinstein', 'aaubrun', 'lfoley82', 'msb843', 'aibeh7906', 'igau', 'jma', 'mdoody359', 'j3nnif3r37', 'rsarette', 'benedict.dungca', 'lrawitscher', 'sem742', 'emathews', 'msamyyi', 'shwang', 'rmalekmadani', 'geapen', 'jvegaperkins713', 'kserv', 'lsleung', 'manistranski', 'yokim', 'sperez', 'torear', 'annapreston2017', 'kgong', 'samanthamurphy2017', 'bananapiehl', 'kelseyaaronson', 'isaacheine', 'ahofmeister', 'minjooson', 'rmetzgerii', 'ndivine', 'ijackylei', 'rboodram', 'annahinrichs', 'clacrosse', 'ajaynadig', 'anewell', 'schandran', 'joshauck', 'rsherman', 'sarahacs', 'kdaftary', 'afisher', 'mkelsten', 'jshin', 'marsak', 'ecripe', 'sebgar', 'jgw599', 'ynessary', 'ecbold13', 'tstoimenoff', 'pgrewal', 'jayahn0518', 'peter.g.vlahakis', 'tomliggett', 'zfenske', 'jbowleg', 'jvillanueva8', 'camilleblackman2016', 'hrucinski', 'kcm010', 'phawkyard', 'jboyer', 'bbisrat', 'hwhite', 'afarsheed', 'jki699', 'borazine', 'vlh774', 'cconnelly', 'shorstman', 'grahambullmore2017', 'omarosorio2017', 'bonesjones612', 'lawrencevinson2017', 'astults', 'davidkarlin2013', 'mclark032', 'ronogara1', 'kmobrien', 'jmccartney', 'wlindstrom', 'laurenabruzzo2017', 'wcho', 'bchen', 'pklimkow', 'marknelson2012', 'hlou88', 'kburke1', 'mgreene', 'mco2745', 'ssandor', 'n6n8u3', 'mforrest', 'juanmena2017', 'hopkins2', 'nward', 'lchen', 'ngriffiths', 'rmalhotra', 'maura.clement', 'jbs916', 'sshull', 'bdougherty', 'bbecerra', 'mmihalache', 'jschaefer', 'jburkechem122', 'connor.donovan.31', 'crazyindianpride', 'mattsherman95', 'awalls', 'rmehta95', 'annaduban2017', 'jsd31josh', 'smezyk7', 'makeda.springette', 'gallardoy09', 'obabatola', 'sarajohns2017', 'haleykoch2017', 'meganaaudipudy', 'uditapersaud', 'cmucharraz', 'nicholas.mccombe.3', 'aacosta', 'vjansen', 'aec943', 'rweidinger', 'mgates', 'amyers17', 'alw231', 'melikimmy', 'coravasserman2017', 'bbakalarski', 'jgupta', 'swert', 'mpostoll4', 'majedfataftahnu', 'marinamin2017', 'cjw', 'lindseymehl2017', 'lisa.kim.961993', 'bspielman', 'msobhani', 'jesus.leon1', 'natalie.m.stanley.9', 'christycal17', 'ljung', 'mfluellen', 'mfoulkes', 'aostenso', 'ahurst', 'ssbanic', 'bkraft383', 'twang2017', 'vilte', 'cweers', 'radiohedzz', 'vrutherford', 'kschuster', 'tpierce14', 'zrubnitz', 'jtucker', 'pasha', 'ggillow', 'nn3210', 'jruan', 'natalianagytakahashi2015', 'estebanmercado2017', 'jdk681', 'mhopfner', 'youjon5', 'santana', 'hpervaiz', 'rznewman', 'okohler', 'bklein', 'aparikh22', 'sonyaluthra2015', 'asears', 'rst345', 'ellenpatterson2017', 'catherineding', 'gcamozzi', 'daniel.c.eghdami', 'njandali', 'sobel.shawn', 'crobinson19', 'agrenen', 'dweber', 'rachelrogers', 'cprucnal', 'hmiller', 'emares84', 'aamattey', 'nwh027', 'wizu', 'delagarl', 'morrisemily18', 'yuehu9510', 'slhatch', 'gabrielleforcier2015', 'brosenberg', 'brennanjackson2017', 'phaun', 'jmarquez95', 'ddapuzzo', 'cfox', 'sbahena', 'alzipursky', 'juliakovalenko2017', 'bensullivan', 'natalienowogrodzki', 'ccj009', 'amansur', 'jdrews', 'hannahbrady2017', 'wjhager2016', 'annedeb', 'anichols', 'james.amick94', 'evanbeuningen', 'zwatson', 'glak', 'aveerina', 'mdefreitas', 'rschaaf', 'stam', 'krichards', 'thomasodell2017', 'kristensmith2017', 'nickmartin44', 'plim', 'tav162', 'ajaynadig1', 'atsui4', 'cpieri', 'nnwagbo', 'dfloyd', 'akmohring', 'mwaldegerma', 'elisa4201', 'pmccullough', 'kqu', 'dmw514', 'mlaw70', 'mcoden', 'bbair', 'mstotzy1', 'kmcpeak', 'kristinzubritzky']"
95,207,6,8,4,"['jbldwn.1234', 'kentpeng', 'pk490625936', 'ialkhala']",1,['fhopp'],4,"['pataro', None, 'nlarew', 'tennis.diti']",9,"['kentpeng', 'pk490625936', 'ialkhala', 'fhopp', 'nlarew', 'tennis.diti', 'pataro', 'jbldwn.1234', None]"
98,72,6,11,5,"['m.beyramali', 'beethovium', 'ryangrohsmeyer', 'nihal20', 'wx2kc']",0,[],6,"['jmlr53', 'kkalac', '199108hsx', 'llg359', 'ry877', None]",11,"['kkalac', '199108hsx', 'ry877', 'ryangrohsmeyer', None, 'wx2kc', 'jmlr53', 'm.beyramali', 'beethovium', 'llg359', 'nihal20']"
98,71,6,10,4,"['nihal20', 'wx2kc', 'm.beyramali', 'beethovium']",1,['ryangrohsmeyer'],6,"['kkalac', '199108hsx', 'llg359', 'ry877', 'praetorian', None]",11,"['m.beyramali', 'beethovium', 'kkalac', '199108hsx', 'praetorian', 'ry877', 'llg359', 'ryangrohsmeyer', 'nihal20', None, 'wx2kc']"
98,75,6,7,3,"['m.beyramali', 'beethovium', 'ryangrohsmeyer']",2,"['nihal20', 'wx2kc']",4,"['jmlr53', None, 'ry877', 'kkalac']",9,"['jmlr53', 'm.beyramali', 'beethovium', 'kkalac', 'ry877', 'ryangrohsmeyer', 'nihal20', None, 'wx2kc']"
98,77,6,7,3,"['wx2kc', 'beethovium', 'ryangrohsmeyer']",2,"['nihal20', 'm.beyramali']",4,"['jmlr53', None, 'ry877', 'kkalac']",9,"['jmlr53', 'm.beyramali', 'beethovium', 'kkalac', 'ry877', 'ryangrohsmeyer', 'nihal20', None, 'wx2kc']"
