MClusterID,XClusterID,MClusterSize,XClusterSize,OverlapSize,OverlapMembers,MOnlySize,MOnlyMembers,XOnlySize,XOnlyMembers,CombinedSize,CombinedMembers
1,50,109,55,6,"['ajh930', 'mpdinan', 'kansan67', 'kan.kawabata', 'holmano', 'karthikeya.2009']",103,"['csmcinto', 'mangur.k4', 'jzhang102', 'leoxia95', 'karissa', 'kwoodwor', 'shingchi', 'sue.pernett', 'sverhale', 'gtadams', 'mehulnair2014', 'cdsierra1199', 'alexei22', 'ej.pinzon10', 'askenned', 'kfqualls', 'amydills', 'darwindubay', 'pawanmishra2010', 'fireraptor', 'joao.adorno7', 'xijingzhang', 'emmaharrelson', 'lnav', 'sindy', 'diegoa08', 'af.otero10', 'jimmieli', 'hazem.abdelmaksoud', 'robertortiz', 'santiago.laravalle', 'wmrey', 's.mendez10', 'jeissoncz', 'earnold', 'rhmarsha', 'zanziano', 'laura94', 'jbever', 'brianage', 'colemanbaker', 'ranchomanuel', 'agar434', 'alixguti96', 'wang701', 'jchan13', 'tarod13', 'doragerardo', 'davidalvar11', 'jd.botero320', 'dfeezell', 'cajrgato', 'hubertshek', 'cj.hernandez11', 'priyabha', 'camronm21', 'kinda', 'agrawa39', 'samirchar', 'seanhan', 'dacg9515', 'sshooshtarian', 'dboehler', 'sandy2122', 'dcheng289', 'polyfrank000', 'thomasmatt88', 'vhaditya', 'stephaaf', 'dfields', 'samzasloffcohen', 'gomezago', 'ddmm9304', 'jones.a.doug', 'dkidwell88', 'hlepe', 'awsilvers', 'madwood21', 'cbridge', 'mart136', 'calopo1', 'jamesdma', 'grupodelaboratorio', 'spython', 'wzmjnwzmjn', 'amyvandy', 'mayankam', 'ericaleung', 'jordanadriano', 'gqiu', 'jackboyle', 'poyuanc', 'rosstin1', 'kleaks', 'justinaf', 'mileidypinzon', 'eyokote', 'bkredito', 'macer199', 'fosforitofercho', 'ndaugher', 'williamrodriguez1819', 'madb']",49,"['bahammon', 'mohad1993', 'akkisubhu061', 'ebaldwin25', 'ntapia720', 'raypropoggio', 'csusanto', 'fernando', 'thomas901', 'nhorvat1', 'cfarnsw2', 'jyliu4', 'jdcox10', 'msouzaon', 'jerry.chau', 'harshjain2691', 'bmkral', 'fendraki', 'talam', 'bpravong', 'nzorob', 'ealfalas', 'jeremy5756', 'space1008', 'rjfarrer', 'mamircha', 'sgolwalkar', 'jcm2006', 'chrissuchomski', 'tklu1', 'tpharmon', 'jjhibben', 'sgares', 'acemind', 'ahornbuckle0930', 'matt.flores17', 'xxbrucexx', 'elizabethbesenyei', None, 'aesquivias', 'rgowin', 'pryan02', 'nmistry1', 'ferry', 'sapman', 'treblitz', 'andrew.herschfelt', 'zjufennizhang', 'dyyoon']",158,"['csmcinto', 'akkisubhu061', 'mangur.k4', 'jzhang102', 'leoxia95', 'karissa', 'kwoodwor', 'shingchi', 'sue.pernett', 'sverhale', 'gtadams', 'mehulnair2014', 'cdsierra1199', 'alexei22', 'jerry.chau', 'ej.pinzon10', 'bmkral', 'askenned', 'talam', 'bpravong', 'kfqualls', 'darwindubay', 'amydills', 'pawanmishra2010', 'space1008', 'mamircha', 'fireraptor', 'chrissuchomski', 'joao.adorno7', 'xijingzhang', 'emmaharrelson', 'jjhibben', 'lnav', 'sindy', 'diegoa08', 'af.otero10', 'jimmieli', 'hazem.abdelmaksoud', 'robertortiz', 'santiago.laravalle', 'xxbrucexx', 'wmrey', 's.mendez10', 'jeissoncz', 'rgowin', 'pryan02', 'ferry', 'earnold', 'rhmarsha', 'zanziano', 'laura94', 'jbever', 'brianage', 'colemanbaker', 'mpdinan', 'kansan67', 'ranchomanuel', 'zjufennizhang', 'nzorob', 'agar434', 'alixguti96', 'ebaldwin25', 'wang701', 'raypropoggio', 'csusanto', 'fernando', 'jchan13', 'karthikeya.2009', 'tarod13', 'doragerardo', 'harshjain2691', 'davidalvar11', 'jd.botero320', 'dfeezell', 'ealfalas', 'cajrgato', 'hubertshek', 'cj.hernandez11', 'tpharmon', 'priyabha', 'elizabethbesenyei', 'holmano', 'camronm21', 'nmistry1', 'kinda', 'agrawa39', 'samirchar', 'treblitz', 'seanhan', 'dacg9515', 'sshooshtarian', 'dboehler', 'bahammon', 'ntapia720', 'sandy2122', 'dcheng289', 'thomas901', 'polyfrank000', 'thomasmatt88', 'vhaditya', 'stephaaf', 'jyliu4', 'dfields', 'jdcox10', 'samzasloffcohen', 'fendraki', 'gomezago', 'ddmm9304', 'jeremy5756', 'jones.a.doug', 'rjfarrer', 'dkidwell88', 'hlepe', 'kan.kawabata', 'awsilvers', 'madwood21', 'cbridge', 'mart136', 'calopo1', 'jamesdma', 'grupodelaboratorio', 'acemind', 'spython', 'mohad1993', 'wzmjnwzmjn', 'amyvandy', 'mayankam', 'nhorvat1', 'ericaleung', 'jordanadriano', 'gqiu', 'cfarnsw2', 'jackboyle', 'msouzaon', 'poyuanc', 'rosstin1', 'kleaks', 'jcm2006', 'ajh930', 'justinaf', 'sgolwalkar', 'tklu1', 'sgares', 'ahornbuckle0930', 'matt.flores17', 'mileidypinzon', None, 'eyokote', 'aesquivias', 'bkredito', 'macer199', 'fosforitofercho', 'sapman', 'ndaugher', 'williamrodriguez1819', 'madb', 'andrew.herschfelt', 'dyyoon']"
1,51,109,52,50,"['csmcinto', 'wzmjnwzmjn', 'amyvandy', 'leoxia95', 'dcheng289', 'shingchi', 'ericaleung', 'jchan13', 'thomasmatt88', 'jackboyle', 'gtadams', 'stephaaf', 'mehulnair2014', 'doragerardo', 'samzasloffcohen', 'askenned', 'poyuanc', 'spython', 'rosstin1', 'kleaks', 'kfqualls', 'amydills', 'hubertshek', 'jones.a.doug', 'justinaf', 'dkidwell88', 'hlepe', 'xijingzhang', 'emmaharrelson', 'priyabha', 'jimmieli', 'eyokote', 'bkredito', 'macer199', 'kinda', 'madwood21', 'awsilvers', 'rhmarsha', 'earnold', 'zanziano', 'cbridge', 'ndaugher', 'jbever', 'brianage', 'seanhan', 'colemanbaker', 'sshooshtarian', 'mart136', 'jamesdma', 'agar434']",59,"['alixguti96', 'mangur.k4', 'jzhang102', 'mayankam', 'sandy2122', 'karissa', 'wang701', 'kwoodwor', 'sue.pernett', 'jordanadriano', 'polyfrank000', 'sverhale', 'vhaditya', 'karthikeya.2009', 'gqiu', 'dfields', 'tarod13', 'cdsierra1199', 'alexei22', 'ej.pinzon10', 'davidalvar11', 'jd.botero320', 'dfeezell', 'gomezago', 'ddmm9304', 'grupodelaboratorio', 'darwindubay', 'cajrgato', 'pawanmishra2010', 'cj.hernandez11', 'calopo1', 'ajh930', 'fireraptor', 'joao.adorno7', 'lnav', 'diegoa08', 'sindy', 'af.otero10', 'kan.kawabata', 'hazem.abdelmaksoud', 'robertortiz', 'santiago.laravalle', 'holmano', 'mileidypinzon', 'wmrey', 's.mendez10', 'jeissoncz', 'camronm21', 'agrawa39', 'fosforitofercho', 'laura94', 'samirchar', 'dacg9515', 'williamrodriguez1819', 'mpdinan', 'madb', 'kansan67', 'ranchomanuel', 'dboehler']",2,"[None, 'lhamill']",111,"['csmcinto', 'mangur.k4', 'jzhang102', 'leoxia95', 'karissa', 'kwoodwor', 'shingchi', 'sue.pernett', 'sverhale', 'gtadams', 'mehulnair2014', 'cdsierra1199', 'alexei22', 'ej.pinzon10', 'askenned', 'kfqualls', 'darwindubay', 'amydills', 'pawanmishra2010', 'fireraptor', 'joao.adorno7', 'xijingzhang', 'emmaharrelson', 'lnav', 'sindy', 'diegoa08', 'af.otero10', 'jimmieli', 'hazem.abdelmaksoud', 'robertortiz', 'santiago.laravalle', 'wmrey', 's.mendez10', 'jeissoncz', 'earnold', 'rhmarsha', 'zanziano', 'laura94', 'jbever', 'brianage', 'colemanbaker', 'mpdinan', 'kansan67', 'ranchomanuel', 'agar434', 'alixguti96', 'wang701', 'jchan13', 'karthikeya.2009', 'tarod13', 'doragerardo', 'davidalvar11', 'jd.botero320', 'dfeezell', 'cajrgato', 'hubertshek', 'cj.hernandez11', 'priyabha', 'lhamill', 'holmano', 'camronm21', 'kinda', 'agrawa39', 'samirchar', 'seanhan', 'dacg9515', 'sshooshtarian', 'dboehler', 'sandy2122', 'dcheng289', 'polyfrank000', 'thomasmatt88', 'vhaditya', 'stephaaf', 'dfields', 'samzasloffcohen', 'gomezago', 'ddmm9304', 'jones.a.doug', 'dkidwell88', 'hlepe', 'kan.kawabata', 'awsilvers', 'madwood21', 'cbridge', 'mart136', 'calopo1', 'jamesdma', 'grupodelaboratorio', 'spython', 'wzmjnwzmjn', 'amyvandy', 'mayankam', 'ericaleung', 'jordanadriano', 'gqiu', 'jackboyle', 'poyuanc', 'rosstin1', 'kleaks', 'ajh930', 'justinaf', 'mileidypinzon', None, 'eyokote', 'bkredito', 'macer199', 'fosforitofercho', 'ndaugher', 'williamrodriguez1819', 'madb']"
1,49,109,38,27,"['alixguti96', 'sue.pernett', 'tarod13', 'cdsierra1199', 'alexei22', 'jd.botero320', 'davidalvar11', 'ranchomanuel', 'gomezago', 'ddmm9304', 'darwindubay', 'cj.hernandez11', 'fireraptor', 'diegoa08', 'mileidypinzon', 'sindy', 'af.otero10', 'santiago.laravalle', 'wmrey', 'jeissoncz', 'fosforitofercho', 'laura94', 'samirchar', 'williamrodriguez1819', 'madb', 'calopo1', 'grupodelaboratorio']",82,"['csmcinto', 'mangur.k4', 'jzhang102', 'leoxia95', 'karissa', 'kwoodwor', 'shingchi', 'sverhale', 'gtadams', 'mehulnair2014', 'ej.pinzon10', 'askenned', 'kfqualls', 'amydills', 'pawanmishra2010', 'joao.adorno7', 'xijingzhang', 'emmaharrelson', 'lnav', 'jimmieli', 'hazem.abdelmaksoud', 'robertortiz', 's.mendez10', 'earnold', 'rhmarsha', 'zanziano', 'jbever', 'brianage', 'colemanbaker', 'mpdinan', 'kansan67', 'agar434', 'wang701', 'jchan13', 'karthikeya.2009', 'doragerardo', 'dfeezell', 'cajrgato', 'hubertshek', 'priyabha', 'holmano', 'camronm21', 'kinda', 'agrawa39', 'seanhan', 'dacg9515', 'sshooshtarian', 'dboehler', 'sandy2122', 'dcheng289', 'polyfrank000', 'thomasmatt88', 'vhaditya', 'stephaaf', 'dfields', 'samzasloffcohen', 'jones.a.doug', 'dkidwell88', 'hlepe', 'kan.kawabata', 'awsilvers', 'madwood21', 'cbridge', 'mart136', 'jamesdma', 'spython', 'wzmjnwzmjn', 'amyvandy', 'mayankam', 'ericaleung', 'jordanadriano', 'gqiu', 'jackboyle', 'poyuanc', 'rosstin1', 'kleaks', 'ajh930', 'justinaf', 'eyokote', 'bkredito', 'macer199', 'ndaugher']",11,"['franz', 'prietonico', 'leiverj.martinezl', 'danielr.ullo', 'sararoma', 'miguel738', 'wall', 'celene23', 'kellyx.morac', 'ing.horo', None]",120,"['prietonico', 'csmcinto', 'mangur.k4', 'jzhang102', 'sandy2122', 'leoxia95', 'karissa', 'kellyx.morac', 'kwoodwor', 'dcheng289', 'shingchi', 'sue.pernett', 'polyfrank000', 'sverhale', 'thomasmatt88', 'vhaditya', 'gtadams', 'stephaaf', 'dfields', 'mehulnair2014', 'cdsierra1199', 'alexei22', 'samzasloffcohen', 'ej.pinzon10', 'miguel738', 'askenned', 'gomezago', 'kfqualls', 'ddmm9304', 'darwindubay', 'amydills', 'pawanmishra2010', 'jones.a.doug', 'dkidwell88', 'fireraptor', 'joao.adorno7', 'hlepe', 'xijingzhang', 'emmaharrelson', 'lnav', 'ing.horo', 'sindy', 'diegoa08', 'af.otero10', 'jimmieli', 'hazem.abdelmaksoud', 'robertortiz', 'santiago.laravalle', 'kan.kawabata', 'wmrey', 's.mendez10', 'jeissoncz', 'earnold', 'awsilvers', 'madwood21', 'rhmarsha', 'zanziano', 'laura94', 'cbridge', 'jbever', 'brianage', 'mart136', 'colemanbaker', 'mpdinan', 'kansan67', 'calopo1', 'jamesdma', 'ranchomanuel', 'grupodelaboratorio', 'agar434', 'spython', 'wzmjnwzmjn', 'alixguti96', 'danielr.ullo', 'amyvandy', 'mayankam', 'wang701', 'ericaleung', 'jordanadriano', 'jchan13', 'gqiu', 'karthikeya.2009', 'jackboyle', 'tarod13', 'doragerardo', 'sararoma', 'davidalvar11', 'jd.botero320', 'dfeezell', 'poyuanc', 'rosstin1', 'kleaks', 'cajrgato', 'hubertshek', 'franz', 'cj.hernandez11', 'ajh930', 'justinaf', 'leiverj.martinezl', 'wall', 'celene23', 'priyabha', 'mileidypinzon', None, 'holmano', 'eyokote', 'bkredito', 'camronm21', 'kinda', 'macer199', 'agrawa39', 'fosforitofercho', 'samirchar', 'ndaugher', 'seanhan', 'dacg9515', 'sshooshtarian', 'williamrodriguez1819', 'madb', 'dboehler']"
1,149,109,37,1,['mpdinan'],108,"['csmcinto', 'mangur.k4', 'jzhang102', 'leoxia95', 'karissa', 'kwoodwor', 'shingchi', 'sue.pernett', 'sverhale', 'gtadams', 'mehulnair2014', 'cdsierra1199', 'alexei22', 'ej.pinzon10', 'askenned', 'kfqualls', 'amydills', 'darwindubay', 'pawanmishra2010', 'fireraptor', 'joao.adorno7', 'xijingzhang', 'emmaharrelson', 'lnav', 'sindy', 'diegoa08', 'af.otero10', 'jimmieli', 'hazem.abdelmaksoud', 'robertortiz', 'santiago.laravalle', 'wmrey', 's.mendez10', 'jeissoncz', 'earnold', 'rhmarsha', 'zanziano', 'laura94', 'jbever', 'brianage', 'colemanbaker', 'kansan67', 'ranchomanuel', 'agar434', 'alixguti96', 'wang701', 'jchan13', 'karthikeya.2009', 'tarod13', 'doragerardo', 'davidalvar11', 'jd.botero320', 'dfeezell', 'cajrgato', 'hubertshek', 'cj.hernandez11', 'priyabha', 'holmano', 'camronm21', 'kinda', 'agrawa39', 'samirchar', 'seanhan', 'dacg9515', 'sshooshtarian', 'dboehler', 'sandy2122', 'dcheng289', 'polyfrank000', 'thomasmatt88', 'vhaditya', 'stephaaf', 'dfields', 'samzasloffcohen', 'gomezago', 'ddmm9304', 'jones.a.doug', 'dkidwell88', 'hlepe', 'kan.kawabata', 'awsilvers', 'madwood21', 'cbridge', 'mart136', 'calopo1', 'jamesdma', 'grupodelaboratorio', 'spython', 'wzmjnwzmjn', 'amyvandy', 'mayankam', 'ericaleung', 'jordanadriano', 'gqiu', 'jackboyle', 'poyuanc', 'rosstin1', 'kleaks', 'ajh930', 'justinaf', 'mileidypinzon', 'eyokote', 'bkredito', 'macer199', 'fosforitofercho', 'ndaugher', 'williamrodriguez1819', 'madb']",36,"['mohad1993', 'dyyoon', 'ebaldwin25', 'ntapia720', 'raypropoggio', 'csusanto', 'fernando', 'thomas901', 'cfarnsw2', 'jdcox10', 'msouzaon', 'chrith', 'bmkral', 'kkawabat', 'ealfalas', 'jeremy5756', 'mamircha', 'sgolwalkar', 'chrissuchomski', 'tklu1', 'tpharmon', 'jjhibben', 'acemind', 'sgares', 'matt.flores17', 'xxbrucexx', 'ejsanch2', None, 'aesquivias', 'rgowin', 'pryan02', 'nmistry1', 'ferry', 'rpraneeth06', 'zjufennizhang', 'nzorob']",145,"['csmcinto', 'ntapia720', 'mangur.k4', 'jzhang102', 'sandy2122', 'leoxia95', 'karissa', 'kwoodwor', 'dcheng289', 'shingchi', 'thomas901', 'sue.pernett', 'polyfrank000', 'sverhale', 'thomasmatt88', 'vhaditya', 'gtadams', 'stephaaf', 'dfields', 'mehulnair2014', 'cdsierra1199', 'alexei22', 'jdcox10', 'samzasloffcohen', 'ej.pinzon10', 'bmkral', 'askenned', 'kkawabat', 'gomezago', 'kfqualls', 'ddmm9304', 'darwindubay', 'amydills', 'pawanmishra2010', 'jones.a.doug', 'jeremy5756', 'mamircha', 'dkidwell88', 'fireraptor', 'chrissuchomski', 'joao.adorno7', 'hlepe', 'xijingzhang', 'emmaharrelson', 'jjhibben', 'lnav', 'sindy', 'diegoa08', 'af.otero10', 'jimmieli', 'hazem.abdelmaksoud', 'robertortiz', 'santiago.laravalle', 'kan.kawabata', 'xxbrucexx', 'wmrey', 's.mendez10', 'jeissoncz', 'ejsanch2', 'rgowin', 'pryan02', 'earnold', 'awsilvers', 'madwood21', 'rhmarsha', 'zanziano', 'laura94', 'cbridge', 'ferry', 'jbever', 'brianage', 'mart136', 'colemanbaker', 'mpdinan', 'kansan67', 'calopo1', 'jamesdma', 'ranchomanuel', 'grupodelaboratorio', 'zjufennizhang', 'nzorob', 'agar434', 'spython', 'acemind', 'mohad1993', 'wzmjnwzmjn', 'alixguti96', 'ebaldwin25', 'amyvandy', 'mayankam', 'wang701', 'raypropoggio', 'csusanto', 'fernando', 'ericaleung', 'jordanadriano', 'jchan13', 'gqiu', 'cfarnsw2', 'karthikeya.2009', 'jackboyle', 'tarod13', 'doragerardo', 'msouzaon', 'chrith', 'davidalvar11', 'jd.botero320', 'dfeezell', 'poyuanc', 'rosstin1', 'kleaks', 'ealfalas', 'cajrgato', 'hubertshek', 'cj.hernandez11', 'ajh930', 'justinaf', 'sgolwalkar', 'tklu1', 'tpharmon', 'sgares', 'priyabha', 'matt.flores17', 'mileidypinzon', None, 'holmano', 'eyokote', 'aesquivias', 'bkredito', 'camronm21', 'nmistry1', 'kinda', 'macer199', 'agrawa39', 'fosforitofercho', 'samirchar', 'ndaugher', 'rpraneeth06', 'seanhan', 'dacg9515', 'sshooshtarian', 'williamrodriguez1819', 'madb', 'dboehler', 'dyyoon']"
1,193,109,6,1,['ej.pinzon10'],108,"['csmcinto', 'mangur.k4', 'jzhang102', 'sandy2122', 'leoxia95', 'karissa', 'kwoodwor', 'dcheng289', 'shingchi', 'sue.pernett', 'polyfrank000', 'sverhale', 'thomasmatt88', 'vhaditya', 'gtadams', 'stephaaf', 'dfields', 'mehulnair2014', 'cdsierra1199', 'alexei22', 'samzasloffcohen', 'askenned', 'gomezago', 'kfqualls', 'ddmm9304', 'darwindubay', 'amydills', 'pawanmishra2010', 'jones.a.doug', 'dkidwell88', 'fireraptor', 'joao.adorno7', 'hlepe', 'xijingzhang', 'emmaharrelson', 'lnav', 'sindy', 'diegoa08', 'af.otero10', 'jimmieli', 'hazem.abdelmaksoud', 'robertortiz', 'santiago.laravalle', 'kan.kawabata', 'wmrey', 's.mendez10', 'jeissoncz', 'earnold', 'awsilvers', 'madwood21', 'rhmarsha', 'zanziano', 'laura94', 'cbridge', 'jbever', 'brianage', 'mart136', 'colemanbaker', 'mpdinan', 'kansan67', 'calopo1', 'jamesdma', 'ranchomanuel', 'grupodelaboratorio', 'agar434', 'spython', 'wzmjnwzmjn', 'alixguti96', 'amyvandy', 'mayankam', 'wang701', 'ericaleung', 'jordanadriano', 'jchan13', 'gqiu', 'karthikeya.2009', 'jackboyle', 'tarod13', 'doragerardo', 'davidalvar11', 'jd.botero320', 'dfeezell', 'poyuanc', 'rosstin1', 'kleaks', 'cajrgato', 'hubertshek', 'cj.hernandez11', 'ajh930', 'justinaf', 'priyabha', 'mileidypinzon', 'holmano', 'eyokote', 'bkredito', 'camronm21', 'kinda', 'macer199', 'agrawa39', 'fosforitofercho', 'samirchar', 'ndaugher', 'seanhan', 'dacg9515', 'sshooshtarian', 'williamrodriguez1819', 'madb', 'dboehler']",5,"['lf.burbano10', 'andresenrique28', 'mariange8282', 'caj2014', None]",114,"['csmcinto', 'mangur.k4', 'jzhang102', 'sandy2122', 'leoxia95', 'karissa', 'kwoodwor', 'dcheng289', 'caj2014', 'shingchi', 'sue.pernett', 'polyfrank000', 'sverhale', 'thomasmatt88', 'vhaditya', 'gtadams', 'stephaaf', 'dfields', 'mehulnair2014', 'cdsierra1199', 'alexei22', 'samzasloffcohen', 'ej.pinzon10', 'askenned', 'gomezago', 'kfqualls', 'ddmm9304', 'darwindubay', 'amydills', 'pawanmishra2010', 'jones.a.doug', 'dkidwell88', 'fireraptor', 'joao.adorno7', 'hlepe', 'xijingzhang', 'emmaharrelson', 'lnav', 'sindy', 'diegoa08', 'af.otero10', 'jimmieli', 'hazem.abdelmaksoud', 'robertortiz', 'santiago.laravalle', 'kan.kawabata', 'wmrey', 's.mendez10', 'jeissoncz', 'earnold', 'awsilvers', 'madwood21', 'rhmarsha', 'zanziano', 'laura94', 'cbridge', 'jbever', 'brianage', 'mart136', 'colemanbaker', 'mpdinan', 'kansan67', 'calopo1', 'jamesdma', 'ranchomanuel', 'grupodelaboratorio', 'agar434', 'spython', 'wzmjnwzmjn', 'alixguti96', 'amyvandy', 'mayankam', 'wang701', 'ericaleung', 'jordanadriano', 'jchan13', 'gqiu', 'karthikeya.2009', 'jackboyle', 'tarod13', 'doragerardo', 'lf.burbano10', 'davidalvar11', 'jd.botero320', 'andresenrique28', 'dfeezell', 'poyuanc', 'rosstin1', 'kleaks', 'cajrgato', 'hubertshek', 'cj.hernandez11', 'ajh930', 'justinaf', 'priyabha', 'mileidypinzon', None, 'holmano', 'eyokote', 'bkredito', 'camronm21', 'kinda', 'macer199', 'agrawa39', 'fosforitofercho', 'samirchar', 'ndaugher', 'mariange8282', 'seanhan', 'dacg9515', 'sshooshtarian', 'williamrodriguez1819', 'madb', 'dboehler']"
2,92,104,42,39,"['jbalderr', 'fardady', 'jeffliu6068', 'laureneh', 'jakeiuele', 'brianjch', 'apoje', 'arch91', 'jfre1', 'jgoodhea', 'esolene', 'dskeen', 'eliazinetti', 'ksmithca22', 'murpheyz', 'lajh', 'tachunli', 'jonjonoch', 'jbrian.92', 'nayeonk15', 'afek', 'myepremi', 'siuhayta', 'mart358', 'sylvestm', 'londawg77', 'bhammers', 'briansha', 'ajang130', 'pargo1', 'briana.chue', 'hangwei314', 'rcburrow2', 'gdupas', 'gcaine', 'dking310', 'natalie.nguyen16', 'kevinblu', 'caroline.carney2']",64,"['townsenm', 'schumm', 'kevin.gilmer', 'hallowj', 'glinvill', 'azzedinr', 'wang1178', 'beckerd', 'green109', 'addison1001', 'pspagnolo72', 'ppriya', 'jlessley', 'smithjared1994', 'kaitlyn.fisher', 'posta', 'sun272', 'lkroneman', 'kiettipong1', 'lrobinson.2757', 'cristianomeag96', 'hannahkat57', 'nspear17', 'jrotella', 'mmaughan', 'alaimana', 'kaiser17', 'tlshelhart', 'tbruttom', 'nannan.tian', 'smadelin', 'luray95', 'campb122', 'gowthamsriram', 'danielli1018', 'qqxiaobai228', 'ross_piedmonte', 'jiaanli1994', 'mmckinne', 'liu991', 'tcurtiss', 'jinghan1022', 'cohen.jakedavid', 'youzimonster28', 'ahmed49', 'paulleonc', 'ttgtarun', 'hjian21', 'vganapa', 'mheiden', 'sawa', 'cmarrer', 'horner1', 'eric.prussack', 'dacapo007', 'czy121301', 'theresa.saenz.1', 'thoma386', 'xphuah', 'cynthiar32', 'agaroufa', 'fiferj', 'kim383', 'kohlerc']",3,"['grunenfe', None, 'lhamill']",106,"['schumm', 'kevin.gilmer', 'hallowj', 'fardady', 'jeffliu6068', 'azzedinr', 'wang1178', 'beckerd', 'green109', 'addison1001', 'brianjch', 'apoje', 'jfre1', 'ppriya', 'jlessley', 'smithjared1994', 'esolene', 'jgoodhea', 'dskeen', 'eliazinetti', 'lkroneman', 'kiettipong1', 'murpheyz', 'lrobinson.2757', 'lajh', 'mmaughan', 'alaimana', 'tbruttom', 'afek', 'briansha', 'mart358', 'londawg77', 'bhammers', 'gowthamsriram', 'qqxiaobai228', 'mmckinne', 'liu991', 'pargo1', 'jinghan1022', 'youzimonster28', 'ahmed49', 'briana.chue', 'ttgtarun', 'hjian21', 'vganapa', 'rcburrow2', 'mheiden', 'sawa', 'horner1', 'gcaine', 'dking310', 'natalie.nguyen16', 'dacapo007', 'czy121301', 'theresa.saenz.1', 'thoma386', 'kevinblu', 'cynthiar32', 'ross_piedmonte', 'agaroufa', 'kim383', 'townsenm', 'jbalderr', 'glinvill', 'laureneh', 'jakeiuele', 'arch91', 'pspagnolo72', 'kaitlyn.fisher', 'posta', 'sun272', 'tachunli', 'ksmithca22', 'cristianomeag96', 'hannahkat57', 'nspear17', 'jrotella', 'kaiser17', 'jonjonoch', 'jbrian.92', 'tlshelhart', 'nayeonk15', 'nannan.tian', 'myepremi', 'smadelin', 'luray95', 'siuhayta', 'sylvestm', 'campb122', 'ajang130', 'danielli1018', 'jiaanli1994', 'tcurtiss', 'lhamill', 'cohen.jakedavid', None, 'hangwei314', 'paulleonc', 'grunenfe', 'gdupas', 'cmarrer', 'eric.prussack', 'caroline.carney2', 'xphuah', 'fiferj', 'kohlerc']"
2,90,104,37,35,"['kevin.gilmer', 'azzedinr', 'green109', 'pspagnolo72', 'jlessley', 'smithjared1994', 'posta', 'sun272', 'lrobinson.2757', 'hannahkat57', 'jrotella', 'nspear17', 'alaimana', 'kaiser17', 'tlshelhart', 'tbruttom', 'luray95', 'campb122', 'jiaanli1994', 'liu991', 'tcurtiss', 'cohen.jakedavid', 'ahmed49', 'paulleonc', 'vganapa', 'horner1', 'sawa', 'cmarrer', 'dacapo007', 'czy121301', 'thoma386', 'theresa.saenz.1', 'xphuah', 'cynthiar32', 'kohlerc']",68,"['townsenm', 'schumm', 'jbalderr', 'hallowj', 'fardady', 'jeffliu6068', 'glinvill', 'wang1178', 'laureneh', 'beckerd', 'agaroufa', 'jakeiuele', 'addison1001', 'brianjch', 'apoje', 'arch91', 'jfre1', 'ppriya', 'kaitlyn.fisher', 'esolene', 'jgoodhea', 'dskeen', 'eliazinetti', 'lkroneman', 'kiettipong1', 'murpheyz', 'tachunli', 'cristianomeag96', 'lajh', 'mmaughan', 'ksmithca22', 'jonjonoch', 'jbrian.92', 'nayeonk15', 'afek', 'nannan.tian', 'myepremi', 'smadelin', 'briansha', 'mart358', 'siuhayta', 'londawg77', 'bhammers', 'sylvestm', 'gowthamsriram', 'ajang130', 'danielli1018', 'qqxiaobai228', 'mmckinne', 'pargo1', 'jinghan1022', 'youzimonster28', 'briana.chue', 'hangwei314', 'ttgtarun', 'hjian21', 'rcburrow2', 'mheiden', 'gcaine', 'gdupas', 'eric.prussack', 'dking310', 'natalie.nguyen16', 'kevinblu', 'caroline.carney2', 'ross_piedmonte', 'fiferj', 'kim383']",2,"['astronut95', None]",105,"['schumm', 'kevin.gilmer', 'hallowj', 'fardady', 'jeffliu6068', 'azzedinr', 'wang1178', 'beckerd', 'green109', 'addison1001', 'brianjch', 'apoje', 'jfre1', 'ppriya', 'jlessley', 'smithjared1994', 'esolene', 'jgoodhea', 'dskeen', 'eliazinetti', 'lkroneman', 'kiettipong1', 'murpheyz', 'lrobinson.2757', 'lajh', 'mmaughan', 'alaimana', 'tbruttom', 'afek', 'briansha', 'mart358', 'londawg77', 'bhammers', 'gowthamsriram', 'qqxiaobai228', 'mmckinne', 'liu991', 'pargo1', 'jinghan1022', 'youzimonster28', 'ahmed49', 'briana.chue', 'ttgtarun', 'hjian21', 'vganapa', 'rcburrow2', 'mheiden', 'sawa', 'horner1', 'gcaine', 'dking310', 'natalie.nguyen16', 'dacapo007', 'czy121301', 'theresa.saenz.1', 'thoma386', 'kevinblu', 'cynthiar32', 'ross_piedmonte', 'agaroufa', 'kim383', 'townsenm', 'jbalderr', 'glinvill', 'laureneh', 'jakeiuele', 'arch91', 'pspagnolo72', 'kaitlyn.fisher', 'astronut95', 'posta', 'sun272', 'tachunli', 'ksmithca22', 'cristianomeag96', 'hannahkat57', 'nspear17', 'jrotella', 'kaiser17', 'jonjonoch', 'jbrian.92', 'tlshelhart', 'nayeonk15', 'nannan.tian', 'myepremi', 'smadelin', 'luray95', 'siuhayta', 'sylvestm', 'campb122', 'ajang130', 'danielli1018', 'jiaanli1994', 'tcurtiss', 'cohen.jakedavid', None, 'hangwei314', 'paulleonc', 'gdupas', 'cmarrer', 'eric.prussack', 'caroline.carney2', 'xphuah', 'fiferj', 'kohlerc']"
2,89,104,34,29,"['townsenm', 'schumm', 'glinvill', 'hallowj', 'beckerd', 'agaroufa', 'pspagnolo72', 'smithjared1994', 'kaitlyn.fisher', 'posta', 'sun272', 'jrotella', 'cristianomeag96', 'smadelin', 'campb122', 'qqxiaobai228', 'mmckinne', 'jinghan1022', 'cohen.jakedavid', 'ahmed49', 'ttgtarun', 'vganapa', 'eric.prussack', 'czy121301', 'thoma386', 'xphuah', 'ross_piedmonte', 'fiferj', 'kim383']",74,"['kevin.gilmer', 'jbalderr', 'fardady', 'jeffliu6068', 'azzedinr', 'wang1178', 'laureneh', 'jakeiuele', 'green109', 'addison1001', 'brianjch', 'apoje', 'arch91', 'jfre1', 'ppriya', 'jlessley', 'esolene', 'jgoodhea', 'dskeen', 'eliazinetti', 'lkroneman', 'kiettipong1', 'murpheyz', 'tachunli', 'lrobinson.2757', 'lajh', 'mmaughan', 'alaimana', 'ksmithca22', 'hannahkat57', 'nspear17', 'jonjonoch', 'kaiser17', 'jbrian.92', 'tbruttom', 'tlshelhart', 'afek', 'nannan.tian', 'myepremi', 'nayeonk15', 'briansha', 'mart358', 'luray95', 'londawg77', 'bhammers', 'siuhayta', 'sylvestm', 'gowthamsriram', 'ajang130', 'danielli1018', 'jiaanli1994', 'liu991', 'pargo1', 'tcurtiss', 'youzimonster28', 'briana.chue', 'paulleonc', 'hangwei314', 'hjian21', 'rcburrow2', 'mheiden', 'sawa', 'cmarrer', 'horner1', 'dking310', 'gcaine', 'natalie.nguyen16', 'dacapo007', 'gdupas', 'theresa.saenz.1', 'kevinblu', 'caroline.carney2', 'cynthiar32', 'kohlerc']",5,"['dklenosk', 'parsonsm', 'davidjohnson', 'poojanshah99', None]",108,"['schumm', 'kevin.gilmer', 'hallowj', 'fardady', 'jeffliu6068', 'azzedinr', 'wang1178', 'beckerd', 'green109', 'addison1001', 'brianjch', 'apoje', 'jfre1', 'ppriya', 'jlessley', 'smithjared1994', 'esolene', 'jgoodhea', 'dskeen', 'eliazinetti', 'lkroneman', 'kiettipong1', 'murpheyz', 'lrobinson.2757', 'lajh', 'mmaughan', 'alaimana', 'parsonsm', 'tbruttom', 'afek', 'briansha', 'mart358', 'londawg77', 'bhammers', 'gowthamsriram', 'qqxiaobai228', 'mmckinne', 'liu991', 'pargo1', 'jinghan1022', 'youzimonster28', 'ahmed49', 'briana.chue', 'ttgtarun', 'hjian21', 'vganapa', 'rcburrow2', 'mheiden', 'sawa', 'horner1', 'gcaine', 'dking310', 'dklenosk', 'natalie.nguyen16', 'dacapo007', 'czy121301', 'theresa.saenz.1', 'thoma386', 'kevinblu', 'cynthiar32', 'ross_piedmonte', 'agaroufa', 'kim383', 'townsenm', 'jbalderr', 'glinvill', 'laureneh', 'jakeiuele', 'arch91', 'pspagnolo72', 'poojanshah99', 'kaitlyn.fisher', 'posta', 'sun272', 'tachunli', 'ksmithca22', 'cristianomeag96', 'hannahkat57', 'nspear17', 'jrotella', 'kaiser17', 'jonjonoch', 'jbrian.92', 'tlshelhart', 'nayeonk15', 'nannan.tian', 'myepremi', 'smadelin', 'luray95', 'siuhayta', 'sylvestm', 'campb122', 'ajang130', 'danielli1018', 'jiaanli1994', 'tcurtiss', 'davidjohnson', 'cohen.jakedavid', None, 'hangwei314', 'paulleonc', 'gdupas', 'cmarrer', 'eric.prussack', 'caroline.carney2', 'xphuah', 'fiferj', 'kohlerc']"
2,91,104,7,6,"['paulleonc', 'azzedinr', 'nspear17', 'alaimana', 'kaiser17', 'jlessley']",97,"['schumm', 'kevin.gilmer', 'hallowj', 'fardady', 'jeffliu6068', 'wang1178', 'beckerd', 'green109', 'addison1001', 'brianjch', 'apoje', 'jfre1', 'ppriya', 'smithjared1994', 'esolene', 'jgoodhea', 'dskeen', 'eliazinetti', 'lkroneman', 'kiettipong1', 'murpheyz', 'lrobinson.2757', 'lajh', 'mmaughan', 'tbruttom', 'afek', 'briansha', 'mart358', 'londawg77', 'bhammers', 'gowthamsriram', 'qqxiaobai228', 'mmckinne', 'liu991', 'pargo1', 'jinghan1022', 'youzimonster28', 'ahmed49', 'briana.chue', 'ttgtarun', 'hjian21', 'vganapa', 'rcburrow2', 'mheiden', 'sawa', 'horner1', 'gcaine', 'dking310', 'natalie.nguyen16', 'dacapo007', 'czy121301', 'theresa.saenz.1', 'thoma386', 'kevinblu', 'cynthiar32', 'ross_piedmonte', 'agaroufa', 'kim383', 'townsenm', 'jbalderr', 'glinvill', 'laureneh', 'jakeiuele', 'arch91', 'pspagnolo72', 'kaitlyn.fisher', 'posta', 'sun272', 'tachunli', 'ksmithca22', 'cristianomeag96', 'hannahkat57', 'jrotella', 'jonjonoch', 'jbrian.92', 'tlshelhart', 'nayeonk15', 'nannan.tian', 'myepremi', 'smadelin', 'luray95', 'siuhayta', 'sylvestm', 'campb122', 'ajang130', 'danielli1018', 'jiaanli1994', 'tcurtiss', 'cohen.jakedavid', 'hangwei314', 'gdupas', 'cmarrer', 'eric.prussack', 'caroline.carney2', 'xphuah', 'fiferj', 'kohlerc']",1,[None],104,"['schumm', 'kevin.gilmer', 'hallowj', 'fardady', 'jeffliu6068', 'azzedinr', 'wang1178', 'beckerd', 'green109', 'addison1001', 'brianjch', 'apoje', 'jfre1', 'ppriya', 'jlessley', 'smithjared1994', 'esolene', 'jgoodhea', 'dskeen', 'eliazinetti', 'lkroneman', 'kiettipong1', 'murpheyz', 'lrobinson.2757', 'lajh', 'mmaughan', 'alaimana', 'tbruttom', 'afek', 'briansha', 'mart358', 'londawg77', 'bhammers', 'gowthamsriram', 'qqxiaobai228', 'mmckinne', 'liu991', 'pargo1', 'jinghan1022', 'youzimonster28', 'ahmed49', 'briana.chue', 'ttgtarun', 'hjian21', 'vganapa', 'rcburrow2', 'mheiden', 'sawa', 'horner1', 'gcaine', 'dking310', 'natalie.nguyen16', 'dacapo007', 'czy121301', 'theresa.saenz.1', 'thoma386', 'kevinblu', 'cynthiar32', 'ross_piedmonte', 'agaroufa', 'kim383', 'townsenm', 'jbalderr', 'glinvill', 'laureneh', 'jakeiuele', 'arch91', 'pspagnolo72', 'kaitlyn.fisher', 'posta', 'sun272', 'tachunli', 'ksmithca22', 'cristianomeag96', 'hannahkat57', 'nspear17', 'jrotella', 'kaiser17', 'jonjonoch', 'jbrian.92', 'tlshelhart', 'nayeonk15', 'nannan.tian', 'myepremi', 'smadelin', 'luray95', 'siuhayta', 'sylvestm', 'campb122', 'ajang130', 'danielli1018', 'jiaanli1994', 'tcurtiss', 'cohen.jakedavid', None, 'hangwei314', 'paulleonc', 'gdupas', 'cmarrer', 'eric.prussack', 'caroline.carney2', 'xphuah', 'fiferj', 'kohlerc']"
3,165,84,59,54,"['tchntimothy', 'lujingwen1991', 'frayne.cameron', 'didacfc', 'kai.godfrey.50', 'marceloyuan', 'kleung13', 'shahbaj', 'tavisp', 'xanderbetts', 'sarahn162', 'plwilkie', 'haydenlinterman123', 'jtsnow', 'erictung', 'gabrielf89', 'esra.m.alhabshi', 'awebb94', 'g_dawg', '222alice', 'asdfg2443', 'kutkaan2014', 'olmeca.mcgillicuddy', 'earlierearlier', 'sherrie.wang.3', 'mr.liam.henderson', 'xiazhenzheng', 'yeezy', 'khaebler', 'bluu10b', 'albert.wong.1232', 'pnjunction', 'ajmis94', 'anonymous673', 'can.rozanes', 'edsondzhang', 'deterex', 'mackenzie.leung', 'max.prokopenko', 'wilson.to.18', 'charingchen', 'feefarfelufee', 'nicos', 'tim.tseng.47', 'benjamin.le.98', 'andre.clerc', 'jackiengame', 'daniel1', 'saoud', 'samuelngsh', 'echo3960', 'emmanak1', 'mxcmail', 'gelapes.gs']",29,"['shriramsb', 'kaank2014', 'oliver.tedder', 'florian.galler', 'pserv', 'seabaugh', 'df1990', 'luluuum', 'michelle.ntampaka', 'eng.mustafa.k', 'rpiwyxie', 'qu.polo', 'zkenny', 'mikehsiao789', 'jeremy.tang94', 'vignesh04', 'isaiah.thiessen', 'ab3914', 'hrykaens', 'eceeric4702', 'eece352car', 'bell10142003', 'alessandrobrisotto', 'cheklon', 'yezhichao1028', 'stephane.bilbey', 'andreagiaccherini', 'yalbochi', 'raghavg02']",5,"['dougchung8', 'zengks', 'dmfrey3', None, 'brad.macneil5']",88,"['lujingwen1991', 'shriramsb', 'kaank2014', 'oliver.tedder', 'didacfc', 'kai.godfrey.50', 'marceloyuan', 'seabaugh', 'df1990', 'michelle.ntampaka', 'xanderbetts', 'rpiwyxie', 'eng.mustafa.k', 'esra.m.alhabshi', 'erictung', 'jtsnow', 'awebb94', 'dougchung8', 'mikehsiao789', 'asdfg2443', 'olmeca.mcgillicuddy', 'sherrie.wang.3', 'mr.liam.henderson', 'earlierearlier', 'vignesh04', 'xiazhenzheng', 'yeezy', 'isaiah.thiessen', 'bluu10b', 'eceeric4702', 'ajmis94', 'anonymous673', 'bell10142003', 'deterex', 'cheklon', 'max.prokopenko', 'brad.macneil5', 'feefarfelufee', 'benjamin.le.98', 'andre.clerc', 'jackiengame', 'daniel1', 'andreagiaccherini', 'saoud', 'zengks', 'emmanak1', 'mxcmail', 'gelapes.gs', 'tchntimothy', 'frayne.cameron', 'florian.galler', 'pserv', 'kleung13', 'dmfrey3', 'tavisp', 'shahbaj', 'luluuum', 'plwilkie', 'haydenlinterman123', 'qu.polo', 'sarahn162', 'zkenny', 'g_dawg', 'gabrielf89', 'kutkaan2014', '222alice', 'jeremy.tang94', 'khaebler', 'ab3914', 'pnjunction', 'albert.wong.1232', 'hrykaens', 'eece352car', 'can.rozanes', 'edsondzhang', 'alessandrobrisotto', None, 'mackenzie.leung', 'wilson.to.18', 'charingchen', 'tim.tseng.47', 'yezhichao1028', 'stephane.bilbey', 'samuelngsh', 'yalbochi', 'echo3960', 'nicos', 'raghavg02']"
3,164,84,32,1,['ab3914'],82,"['lujingwen1991', 'didacfc', 'marceloyuan', 'seabaugh', 'df1990', 'xanderbetts', 'rpiwyxie', 'esra.m.alhabshi', 'erictung', 'jtsnow', 'mikehsiao789', 'asdfg2443', 'olmeca.mcgillicuddy', 'mr.liam.henderson', 'isaiah.thiessen', 'ajmis94', 'cheklon', 'feefarfelufee', 'benjamin.le.98', 'andre.clerc', 'jackiengame', 'daniel1', 'mxcmail', 'gelapes.gs', 'florian.galler', 'pserv', 'kleung13', 'plwilkie', 'haydenlinterman123', 'qu.polo', 'g_dawg', 'kutkaan2014', 'jeremy.tang94', 'khaebler', 'pnjunction', 'hrykaens', 'can.rozanes', 'edsondzhang', 'alessandrobrisotto', 'mackenzie.leung', 'yezhichao1028', 'stephane.bilbey', 'samuelngsh', 'yalbochi', 'raghavg02', 'shriramsb', 'kaank2014', 'oliver.tedder', 'kai.godfrey.50', 'michelle.ntampaka', 'eng.mustafa.k', 'awebb94', 'sherrie.wang.3', 'earlierearlier', 'vignesh04', 'xiazhenzheng', 'yeezy', 'bluu10b', 'eceeric4702', 'anonymous673', 'bell10142003', 'deterex', 'max.prokopenko', 'andreagiaccherini', 'saoud', 'emmanak1', 'tchntimothy', 'frayne.cameron', 'tavisp', 'shahbaj', 'luluuum', 'sarahn162', 'zkenny', 'gabrielf89', '222alice', 'albert.wong.1232', 'eece352car', 'wilson.to.18', 'charingchen', 'tim.tseng.47', 'echo3960', 'nicos']",31,"['smohsin16', 'saleil.bhat', 'ka2531', 'yangyx', 'steev16', 'jessicazhao', 'gkewley87', 'caleb.fujimori', 'cedricmayer', 'tonid', 'houseoflastwords', 'nikoala3', 'neilorzechowski', 'giovanna.silvateixeira', 'dmarsed18', 'hekle', 'jjw2170', 'nazlituncer94', 'ajorquera', 'lfv2108', 'benthezhu', 'jmd2251', None, 'jeffrey11366', 'ndg2119', 'af2791', 'rsv2111', 'wuyi0623', 'dms2264', 'harrisonliew', 'gmackcrane']",114,"['lujingwen1991', 'shriramsb', 'kaank2014', 'oliver.tedder', 'didacfc', 'kai.godfrey.50', 'yangyx', 'marceloyuan', 'steev16', 'seabaugh', 'df1990', 'gkewley87', 'caleb.fujimori', 'michelle.ntampaka', 'xanderbetts', 'rpiwyxie', 'eng.mustafa.k', 'esra.m.alhabshi', 'erictung', 'jtsnow', 'houseoflastwords', 'awebb94', 'mikehsiao789', 'asdfg2443', 'olmeca.mcgillicuddy', 'neilorzechowski', 'sherrie.wang.3', 'mr.liam.henderson', 'earlierearlier', 'dmarsed18', 'hekle', 'vignesh04', 'xiazhenzheng', 'yeezy', 'isaiah.thiessen', 'bluu10b', 'eceeric4702', 'ajmis94', 'anonymous673', 'bell10142003', 'deterex', 'cheklon', 'max.prokopenko', 'jeffrey11366', 'feefarfelufee', 'benjamin.le.98', 'andre.clerc', 'wuyi0623', 'jackiengame', 'daniel1', 'andreagiaccherini', 'saoud', 'emmanak1', 'mxcmail', 'gelapes.gs', 'tchntimothy', 'smohsin16', 'saleil.bhat', 'ka2531', 'frayne.cameron', 'florian.galler', 'pserv', 'jessicazhao', 'kleung13', 'tavisp', 'shahbaj', 'luluuum', 'cedricmayer', 'plwilkie', 'haydenlinterman123', 'qu.polo', 'sarahn162', 'zkenny', 'g_dawg', 'gabrielf89', 'kutkaan2014', 'tonid', '222alice', 'nikoala3', 'giovanna.silvateixeira', 'jeremy.tang94', 'khaebler', 'jjw2170', 'nazlituncer94', 'ab3914', 'pnjunction', 'albert.wong.1232', 'ajorquera', 'hrykaens', 'eece352car', 'lfv2108', 'can.rozanes', 'edsondzhang', 'benthezhu', 'alessandrobrisotto', 'jmd2251', None, 'mackenzie.leung', 'wilson.to.18', 'charingchen', 'ndg2119', 'tim.tseng.47', 'af2791', 'rsv2111', 'yezhichao1028', 'stephane.bilbey', 'dms2264', 'harrisonliew', 'samuelngsh', 'yalbochi', 'echo3960', 'nicos', 'gmackcrane', 'raghavg02']"
3,170,84,16,1,['eng.mustafa.k'],82,"['lujingwen1991', 'shriramsb', 'kaank2014', 'oliver.tedder', 'didacfc', 'kai.godfrey.50', 'marceloyuan', 'seabaugh', 'df1990', 'michelle.ntampaka', 'xanderbetts', 'rpiwyxie', 'esra.m.alhabshi', 'erictung', 'jtsnow', 'awebb94', 'mikehsiao789', 'asdfg2443', 'olmeca.mcgillicuddy', 'sherrie.wang.3', 'mr.liam.henderson', 'earlierearlier', 'vignesh04', 'xiazhenzheng', 'yeezy', 'isaiah.thiessen', 'bluu10b', 'eceeric4702', 'ajmis94', 'anonymous673', 'bell10142003', 'deterex', 'cheklon', 'max.prokopenko', 'feefarfelufee', 'benjamin.le.98', 'andre.clerc', 'jackiengame', 'daniel1', 'andreagiaccherini', 'saoud', 'emmanak1', 'mxcmail', 'gelapes.gs', 'tchntimothy', 'frayne.cameron', 'florian.galler', 'pserv', 'kleung13', 'tavisp', 'shahbaj', 'luluuum', 'plwilkie', 'haydenlinterman123', 'qu.polo', 'sarahn162', 'zkenny', 'g_dawg', 'gabrielf89', 'kutkaan2014', '222alice', 'jeremy.tang94', 'khaebler', 'ab3914', 'pnjunction', 'albert.wong.1232', 'hrykaens', 'eece352car', 'can.rozanes', 'edsondzhang', 'alessandrobrisotto', 'mackenzie.leung', 'wilson.to.18', 'charingchen', 'tim.tseng.47', 'yezhichao1028', 'stephane.bilbey', 'samuelngsh', 'yalbochi', 'echo3960', 'nicos', 'raghavg02']",15,"['krepton', 'abdelrahman.heikal', 'amnsawaby', 'engam1993', 'eng.somayaahmed', 'omnia12347', 'omnia.mahmoud', 'mohamed_mahmoud', 'ahmed.badawy2020', 'amr1992ahmed', 'ahmedelsayed', 'engabdelrahman', 'mmorsy1981', None, 'secondprep.2013']",98,"['lujingwen1991', 'shriramsb', 'kaank2014', 'oliver.tedder', 'didacfc', 'kai.godfrey.50', 'marceloyuan', 'seabaugh', 'amr1992ahmed', 'df1990', 'michelle.ntampaka', 'xanderbetts', 'rpiwyxie', 'eng.mustafa.k', 'esra.m.alhabshi', 'erictung', 'jtsnow', 'abdelrahman.heikal', 'awebb94', 'mikehsiao789', 'asdfg2443', 'olmeca.mcgillicuddy', 'sherrie.wang.3', 'mr.liam.henderson', 'earlierearlier', 'vignesh04', 'xiazhenzheng', 'yeezy', 'krepton', 'isaiah.thiessen', 'bluu10b', 'eceeric4702', 'ajmis94', 'anonymous673', 'bell10142003', 'deterex', 'cheklon', 'max.prokopenko', 'feefarfelufee', 'benjamin.le.98', 'andre.clerc', 'amnsawaby', 'jackiengame', 'daniel1', 'andreagiaccherini', 'saoud', 'emmanak1', 'ahmedelsayed', 'mxcmail', 'gelapes.gs', 'tchntimothy', 'frayne.cameron', 'florian.galler', 'pserv', 'omnia.mahmoud', 'ahmed.badawy2020', 'kleung13', 'tavisp', 'shahbaj', 'luluuum', 'plwilkie', 'haydenlinterman123', 'qu.polo', 'sarahn162', 'zkenny', 'g_dawg', 'gabrielf89', 'kutkaan2014', '222alice', 'jeremy.tang94', 'khaebler', 'ab3914', 'pnjunction', 'albert.wong.1232', 'hrykaens', 'eece352car', 'eng.somayaahmed', 'can.rozanes', 'edsondzhang', 'mohamed_mahmoud', 'alessandrobrisotto', 'engabdelrahman', None, 'mackenzie.leung', 'wilson.to.18', 'charingchen', 'tim.tseng.47', 'yezhichao1028', 'engam1993', 'stephane.bilbey', 'omnia12347', 'samuelngsh', 'yalbochi', 'echo3960', 'nicos', 'mmorsy1981', 'raghavg02', 'secondprep.2013']"
3,166,84,13,12,"['qu.polo', 'zkenny', 'erictung', 'pnjunction', 'eceeric4702', 'eece352car', 'mikehsiao789', 'stephane.bilbey', 'bell10142003', 'yalbochi', 'df1990', 'cheklon']",71,"['lujingwen1991', 'shriramsb', 'kaank2014', 'oliver.tedder', 'didacfc', 'kai.godfrey.50', 'marceloyuan', 'seabaugh', 'michelle.ntampaka', 'xanderbetts', 'rpiwyxie', 'eng.mustafa.k', 'esra.m.alhabshi', 'jtsnow', 'awebb94', 'asdfg2443', 'olmeca.mcgillicuddy', 'sherrie.wang.3', 'mr.liam.henderson', 'earlierearlier', 'vignesh04', 'xiazhenzheng', 'yeezy', 'isaiah.thiessen', 'bluu10b', 'ajmis94', 'anonymous673', 'deterex', 'max.prokopenko', 'feefarfelufee', 'benjamin.le.98', 'andre.clerc', 'jackiengame', 'daniel1', 'andreagiaccherini', 'saoud', 'emmanak1', 'mxcmail', 'gelapes.gs', 'tchntimothy', 'frayne.cameron', 'florian.galler', 'pserv', 'kleung13', 'tavisp', 'shahbaj', 'luluuum', 'plwilkie', 'haydenlinterman123', 'sarahn162', 'g_dawg', 'gabrielf89', 'kutkaan2014', '222alice', 'jeremy.tang94', 'khaebler', 'ab3914', 'albert.wong.1232', 'hrykaens', 'can.rozanes', 'edsondzhang', 'alessandrobrisotto', 'mackenzie.leung', 'wilson.to.18', 'charingchen', 'tim.tseng.47', 'yezhichao1028', 'samuelngsh', 'echo3960', 'nicos', 'raghavg02']",1,[None],84,"['lujingwen1991', 'shriramsb', 'kaank2014', 'oliver.tedder', 'didacfc', 'kai.godfrey.50', 'marceloyuan', 'seabaugh', 'df1990', 'michelle.ntampaka', 'xanderbetts', 'rpiwyxie', 'eng.mustafa.k', 'esra.m.alhabshi', 'erictung', 'jtsnow', 'awebb94', 'mikehsiao789', 'asdfg2443', 'olmeca.mcgillicuddy', 'sherrie.wang.3', 'mr.liam.henderson', 'earlierearlier', 'vignesh04', 'xiazhenzheng', 'yeezy', 'isaiah.thiessen', 'bluu10b', 'eceeric4702', 'ajmis94', 'anonymous673', 'bell10142003', 'deterex', 'cheklon', 'max.prokopenko', 'feefarfelufee', 'benjamin.le.98', 'andre.clerc', 'jackiengame', 'daniel1', 'andreagiaccherini', 'saoud', 'emmanak1', 'mxcmail', 'gelapes.gs', 'tchntimothy', 'frayne.cameron', 'florian.galler', 'pserv', 'kleung13', 'tavisp', 'shahbaj', 'luluuum', 'plwilkie', 'haydenlinterman123', 'qu.polo', 'sarahn162', 'zkenny', 'g_dawg', 'gabrielf89', 'kutkaan2014', '222alice', 'jeremy.tang94', 'khaebler', 'ab3914', 'pnjunction', 'albert.wong.1232', 'hrykaens', 'eece352car', 'can.rozanes', 'edsondzhang', 'alessandrobrisotto', None, 'mackenzie.leung', 'wilson.to.18', 'charingchen', 'tim.tseng.47', 'yezhichao1028', 'stephane.bilbey', 'samuelngsh', 'yalbochi', 'echo3960', 'nicos', 'raghavg02']"
3,167,84,11,2,"['yezhichao1028', 'hrykaens']",81,"['lujingwen1991', 'shriramsb', 'kaank2014', 'oliver.tedder', 'didacfc', 'kai.godfrey.50', 'marceloyuan', 'seabaugh', 'df1990', 'michelle.ntampaka', 'xanderbetts', 'rpiwyxie', 'eng.mustafa.k', 'esra.m.alhabshi', 'erictung', 'jtsnow', 'awebb94', 'mikehsiao789', 'asdfg2443', 'olmeca.mcgillicuddy', 'sherrie.wang.3', 'mr.liam.henderson', 'earlierearlier', 'vignesh04', 'xiazhenzheng', 'yeezy', 'isaiah.thiessen', 'bluu10b', 'eceeric4702', 'ajmis94', 'anonymous673', 'bell10142003', 'deterex', 'cheklon', 'max.prokopenko', 'feefarfelufee', 'benjamin.le.98', 'andre.clerc', 'jackiengame', 'daniel1', 'andreagiaccherini', 'saoud', 'emmanak1', 'mxcmail', 'gelapes.gs', 'tchntimothy', 'frayne.cameron', 'florian.galler', 'pserv', 'kleung13', 'tavisp', 'shahbaj', 'luluuum', 'plwilkie', 'haydenlinterman123', 'qu.polo', 'sarahn162', 'zkenny', 'g_dawg', 'gabrielf89', 'kutkaan2014', '222alice', 'jeremy.tang94', 'khaebler', 'ab3914', 'pnjunction', 'albert.wong.1232', 'eece352car', 'can.rozanes', 'edsondzhang', 'alessandrobrisotto', 'mackenzie.leung', 'wilson.to.18', 'charingchen', 'tim.tseng.47', 'stephane.bilbey', 'samuelngsh', 'yalbochi', 'echo3960', 'nicos', 'raghavg02']",9,"['mreckmann', 'sethusaveda', 'bellmanz', 'karimelgammal', 'shuoben', 'aarone', 'kimonas', 'saralaji', None]",92,"['lujingwen1991', 'shriramsb', 'kaank2014', 'oliver.tedder', 'didacfc', 'shuoben', 'kai.godfrey.50', 'marceloyuan', 'seabaugh', 'df1990', 'kimonas', 'michelle.ntampaka', 'xanderbetts', 'rpiwyxie', 'eng.mustafa.k', 'esra.m.alhabshi', 'erictung', 'jtsnow', 'awebb94', 'mikehsiao789', 'asdfg2443', 'olmeca.mcgillicuddy', 'sherrie.wang.3', 'mr.liam.henderson', 'earlierearlier', 'vignesh04', 'xiazhenzheng', 'yeezy', 'mreckmann', 'isaiah.thiessen', 'bluu10b', 'eceeric4702', 'ajmis94', 'anonymous673', 'bell10142003', 'deterex', 'cheklon', 'max.prokopenko', 'feefarfelufee', 'benjamin.le.98', 'andre.clerc', 'jackiengame', 'daniel1', 'andreagiaccherini', 'saoud', 'emmanak1', 'mxcmail', 'gelapes.gs', 'tchntimothy', 'bellmanz', 'frayne.cameron', 'florian.galler', 'pserv', 'kleung13', 'tavisp', 'shahbaj', 'luluuum', 'sethusaveda', 'plwilkie', 'haydenlinterman123', 'qu.polo', 'sarahn162', 'zkenny', 'g_dawg', 'gabrielf89', 'kutkaan2014', '222alice', 'karimelgammal', 'aarone', 'saralaji', 'jeremy.tang94', 'khaebler', 'ab3914', 'pnjunction', 'albert.wong.1232', 'hrykaens', 'eece352car', 'can.rozanes', 'edsondzhang', 'alessandrobrisotto', None, 'mackenzie.leung', 'wilson.to.18', 'charingchen', 'tim.tseng.47', 'yezhichao1028', 'stephane.bilbey', 'samuelngsh', 'yalbochi', 'echo3960', 'nicos', 'raghavg02']"
4,105,81,120,71,"['jack.arendt', 'iliveincoto5464', 'xli121', 'jterwil2', 'yhren1993', 'flie2illinois', 'quantumseren', 'josh.barrett.589', 'mpalmer2', 'aarti.shah147', 'tamtran2', 'rps233', 'yu91', 'yumin2', 'aromeo', 'christu2', 'mikra616', 'edennis3', 'ydong119', 'ph0606', 'dhansel036', 'qhu12', 'george.s9999', 'kluhrsen', 'lee117', 'jzhu34', 'chris.reinke.16', 'kaalvar2', 'bomcdon2', 'sligh3ece', 'ks.lamb14', 'eric.groeteke', 'meng325', 'alex.mitsdarfer', 'allen412068', 'henry.ko.94', 'junpeng.qiu', 'kornholi', 'png4', 'chaken2', 'raghavkochhar9', 'zhenqin3', 'rxiao3', 'hlee156', 'truszko1993', 'ece340', 'jacklee3', 'laura_b_galbraith', 'tong.yin.1', 'liupufan', 'charlie.dreebin', 'jdlenz', 'toujours.meiling93', 'yzhao60', 'darksnape', 'hnrcksn2', 'greerdavidc', 'benck', 'uber12', 'peihan0807', 'teerapatpoka', 'dsolanki', 'fwirjo', 'cx1048539626', 'billstan42', 'kurmanba1', 'shijiakimi', 'ece34', 'kkong7', 'pbhatta2', 'stps']",9,"['tumaini.francesco', 'k0yaku', 'abheshek18', 'wchi2', 'tiffyye', 'chen.s.jimmy', 'yfkwan', 'foukster', 'sariel12345']",49,"['ujrav', 'rglazer21', 'richrdtang', 'alexzzz1991', 'winoto2', 'cpx0rpc', 'kenned45', 'karwal2', 'xchen84', 'molly.pace.3', 'jdurant2', '1993sonu01', 'hmtaylo2', 'paur2', 'bordain1', 'ppitchyy', 'brianchien390', 'grandcn', 'decraen2', 'emily.hannigan.31', 'brianchien', 'thephiltsai', 'weineran', 'haelim1227', 'sangyuno0o', 'sehui04', 'shawnahn318', 'dekunukem', 'earicha2', 'daehee0104', 'mingkang.he', 'tim.sutyak2', 'dan.long.7505', 'piyayott9', None, 'dguo8', 'aderoo2', 'dingldn2', 'blu6', 'eric.stiles3', 'replogl2', 'ecl01', 'archiehok', 'yc6', 'bryniar2', 'golasze2', 'kshin10', 'whuang56', 'jemysoul']",129,"['xli121', 'tumaini.francesco', 'richrdtang', 'mpalmer2', 'alexzzz1991', 'winoto2', 'rps233', 'cpx0rpc', 'ph0606', 'sariel12345', 'chris.reinke.16', 'eric.groeteke', 'kornholi', 'png4', 'chaken2', 'rxiao3', 'emily.hannigan.31', 'weineran', 'haelim1227', 'laura_b_galbraith', 'shawnahn318', 'greerdavidc', 'daehee0104', 'chen.s.jimmy', 'mingkang.he', 'dan.long.7505', 'teerapatpoka', 'bryniar2', 'ece34', 'golasze2', 'kkong7', 'aderoo2', 'ujrav', 'jterwil2', 'yhren1993', 'quantumseren', 'aarti.shah147', 'yu91', 'yumin2', 'kenned45', 'karwal2', 'xchen84', 'edennis3', 'kluhrsen', 'bomcdon2', 'ks.lamb14', 'allen412068', 'raghavkochhar9', 'zhenqin3', 'hlee156', 'brianchien', 'foukster', 'jdlenz', 'k0yaku', 'sehui04', 'abheshek18', 'earicha2', 'benck', 'uber12', 'piyayott9', 'dguo8', 'fwirjo', 'dingldn2', 'cx1048539626', 'eric.stiles3', 'yc6', 'kurmanba1', 'yfkwan', 'whuang56', 'josh.barrett.589', 'pbhatta2', 'jemysoul', 'jack.arendt', 'iliveincoto5464', 'tamtran2', 'aromeo', 'molly.pace.3', 'mikra616', 'ydong119', 'dhansel036', 'jdurant2', '1993sonu01', 'hmtaylo2', 'jzhu34', 'paur2', 'kaalvar2', 'sligh3ece', 'ppitchyy', 'bordain1', 'meng325', 'alex.mitsdarfer', 'yzhao60', 'sangyuno0o', 'wchi2', 'tim.sutyak2', 'peihan0807', 'dsolanki', 'tiffyye', 'billstan42', 'shijiakimi', 'stps', 'rglazer21', 'flie2illinois', 'christu2', 'qhu12', 'george.s9999', 'lee117', 'brianchien390', 'grandcn', 'henry.ko.94', 'junpeng.qiu', 'decraen2', 'truszko1993', 'thephiltsai', 'ece340', 'jacklee3', 'liupufan', 'charlie.dreebin', 'toujours.meiling93', 'darksnape', 'hnrcksn2', 'dekunukem', None, 'blu6', 'replogl2', 'ecl01', 'archiehok', 'tong.yin.1', 'kshin10']"
4,186,81,117,62,"['jack.arendt', 'iliveincoto5464', 'jterwil2', 'quantumseren', 'josh.barrett.589', 'mpalmer2', 'aarti.shah147', 'rps233', 'yu91', 'yumin2', 'aromeo', 'christu2', 'mikra616', 'edennis3', 'dhansel036', 'ph0606', 'george.s9999', 'lee117', 'kluhrsen', 'sariel12345', 'chris.reinke.16', 'jzhu34', 'kaalvar2', 'bomcdon2', 'sligh3ece', 'ks.lamb14', 'eric.groeteke', 'meng325', 'alex.mitsdarfer', 'allen412068', 'henry.ko.94', 'kornholi', 'png4', 'chaken2', 'raghavkochhar9', 'zhenqin3', 'rxiao3', 'hlee156', 'truszko1993', 'ece340', 'jacklee3', 'laura_b_galbraith', 'tong.yin.1', 'liupufan', 'charlie.dreebin', 'jdlenz', 'toujours.meiling93', 'yzhao60', 'darksnape', 'hnrcksn2', 'greerdavidc', 'benck', 'uber12', 'peihan0807', 'dsolanki', 'fwirjo', 'billstan42', 'kurmanba1', 'tiffyye', 'ece34', 'kkong7', 'pbhatta2']",18,"['xli121', 'yhren1993', 'tumaini.francesco', 'foukster', 'cx1048539626', 'tamtran2', 'flie2illinois', 'k0yaku', 'junpeng.qiu', 'abheshek18', 'wchi2', 'chen.s.jimmy', 'ydong119', 'shijiakimi', 'yfkwan', 'teerapatpoka', 'qhu12', 'stps']",55,"['ujrav', 'julia.labelle2', 'kknom1', 'tim.sutyak', 'michael370662', 'mysonu', 'ssheik22', 'haunlliam', 'xiongfei.ding', 'jdurant2', 'danzuo', 'hmtaylo2', 'yoo66', 'cooldaehee', 'miller7', 'eclee2', 'posso.mario', 'mikeyling18', 'tapeter2', 'michael.diehl.583', 'tatanve', 'kumikknd', 'bkesler', 'jmxscrs', 'wang217', 'li160', 'joshuaphua1', 'mithun.manivannan', 'henryahn', 'grandcn4', 'xinding33', 'austin.martinovich', 'sangyuno0o', 'mattsucich', 'au.chinprutthiwong', 'dan5664', 'jtomaras', 'jzhu46', 'beholla2', 'sarielqjl', 'yk.karwal', 'molly.pace93', None, 'coolkat677', 'dyangsteven', 'rstang2', 'zlc31993', 'kpsrini2', 'tobrien7', 'djiang7', 'studpuffin', 'ndecraene', 'bryniar2', 'piyayott', 'pescenck']",135,"['xli121', 'tumaini.francesco', 'mysonu', 'mpalmer2', 'ssheik22', 'rps233', 'haunlliam', 'ph0606', 'danzuo', 'sariel12345', 'chris.reinke.16', 'eric.groeteke', 'kornholi', 'png4', 'chaken2', 'rxiao3', 'tatanve', 'michael.diehl.583', 'laura_b_galbraith', 'mithun.manivannan', 'jtomaras', 'greerdavidc', 'chen.s.jimmy', 'teerapatpoka', 'dyangsteven', 'rstang2', 'kpsrini2', 'tobrien7', 'djiang7', 'bryniar2', 'ece34', 'kkong7', 'ujrav', 'jterwil2', 'yhren1993', 'quantumseren', 'aarti.shah147', 'yu91', 'yumin2', 'edennis3', 'kluhrsen', 'yoo66', 'bomcdon2', 'ks.lamb14', 'eclee2', 'allen412068', 'raghavkochhar9', 'zhenqin3', 'hlee156', 'foukster', 'wang217', 'li160', 'jdlenz', 'xinding33', 'austin.martinovich', 'k0yaku', 'abheshek18', 'benck', 'uber12', 'fwirjo', 'cx1048539626', 'studpuffin', 'kurmanba1', 'ndecraene', 'yfkwan', 'josh.barrett.589', 'pbhatta2', 'pescenck', 'jack.arendt', 'julia.labelle2', 'iliveincoto5464', 'michael370662', 'tamtran2', 'aromeo', 'mikra616', 'ydong119', 'dhansel036', 'jdurant2', 'hmtaylo2', 'jzhu34', 'cooldaehee', 'kaalvar2', 'sligh3ece', 'meng325', 'alex.mitsdarfer', 'posso.mario', 'tapeter2', 'bkesler', 'jmxscrs', 'joshuaphua1', 'henryahn', 'yzhao60', 'sangyuno0o', 'wchi2', 'sarielqjl', 'peihan0807', 'yk.karwal', 'coolkat677', 'zlc31993', 'dsolanki', 'tiffyye', 'billstan42', 'shijiakimi', 'stps', 'kknom1', 'tim.sutyak', 'flie2illinois', 'christu2', 'qhu12', 'george.s9999', 'lee117', 'xiongfei.ding', 'miller7', 'henry.ko.94', 'junpeng.qiu', 'mikeyling18', 'truszko1993', 'ece340', 'kumikknd', 'jacklee3', 'grandcn4', 'liupufan', 'charlie.dreebin', 'toujours.meiling93', 'mattsucich', 'darksnape', 'hnrcksn2', 'au.chinprutthiwong', 'dan5664', 'jzhu46', 'beholla2', 'molly.pace93', None, 'piyayott', 'tong.yin.1']"
4,143,81,80,5,"['bomcdon2', 'xli121', 'cx1048539626', 'junpeng.qiu', 'pbhatta2']",75,"['jack.arendt', 'iliveincoto5464', 'jterwil2', 'tumaini.francesco', 'yhren1993', 'flie2illinois', 'quantumseren', 'tamtran2', 'mpalmer2', 'aarti.shah147', 'rps233', 'yu91', 'yumin2', 'aromeo', 'christu2', 'mikra616', 'edennis3', 'ydong119', 'ph0606', 'dhansel036', 'qhu12', 'george.s9999', 'kluhrsen', 'lee117', 'sariel12345', 'chris.reinke.16', 'jzhu34', 'kaalvar2', 'sligh3ece', 'ks.lamb14', 'eric.groeteke', 'meng325', 'alex.mitsdarfer', 'allen412068', 'henry.ko.94', 'kornholi', 'png4', 'chaken2', 'raghavkochhar9', 'zhenqin3', 'rxiao3', 'hlee156', 'truszko1993', 'ece340', 'foukster', 'jacklee3', 'laura_b_galbraith', 'tong.yin.1', 'liupufan', 'charlie.dreebin', 'jdlenz', 'toujours.meiling93', 'yzhao60', 'darksnape', 'k0yaku', 'hnrcksn2', 'greerdavidc', 'abheshek18', 'wchi2', 'chen.s.jimmy', 'benck', 'uber12', 'peihan0807', 'teerapatpoka', 'dsolanki', 'fwirjo', 'billstan42', 'kurmanba1', 'tiffyye', 'shijiakimi', 'ece34', 'yfkwan', 'kkong7', 'josh.barrett.589', 'stps']",75,"['toglitt2', 'klwells2', 'stakek2', 'kemehan', 'limberg2', 'angela525huangjj', 'jinpeng.zhuo', 'lolipopcarolwang', 'btkern2', 'akatsulis', 'jwang124', 'hylin2', 'simpkns2', 'gvelard2edu', 'danieldli1993', 'cory93', 'akagti2', 'hmtaylo2', 'siyi.xu.180', 'hsheng3', 'schiavo1', 'adsnyde2', 'qazyyc93', 'nickpalcheck', 'jcjc2222', 'mingxu3', 'arjun.balwally', 'siyima2', 'xnypr', 'yyang10', 'dtascone92', 'jos26coh', 'jjacksn', 'litton2', 'qiujiezhao1994', 'cljohnson0', 'trick2', 'allysonv10', 'dagapit2', 'salman2', 'qyang13', 'cledesma2331', 'dkwok2', 'sage', 'shalper2', 'ahli2', 'ramaiah2', 'fang.the.tall', 'jwsmith6', 'jmmille6', 'rflore24', 'kathyzhou0124', 'bhanley2', 'crichrd2', None, 'bcclanc2', 'jwang182', 'kfeng', 'aamurthy', 'palchec2', 'tara.cullerton', 'csbaile2', 'limsiri2', 'alexkim3', 'achoi121', 'abaddon2mist', 'isaacehoffman', 'jinpengzhuo', 'sguo1', 'bcc4994', 'npalcheck', 'elin11', 'scpiper2', 'gargula2', 'eslee5']",155,"['xli121', 'tumaini.francesco', 'kemehan', 'mpalmer2', 'angela525huangjj', 'rps233', 'ph0606', 'simpkns2', 'gvelard2edu', 'sariel12345', 'chris.reinke.16', 'hsheng3', 'eric.groeteke', 'qazyyc93', 'kornholi', 'png4', 'chaken2', 'rxiao3', 'dtascone92', 'jos26coh', 'laura_b_galbraith', 'trick2', 'salman2', 'qyang13', 'cledesma2331', 'sage', 'greerdavidc', 'chen.s.jimmy', 'teerapatpoka', 'palchec2', 'tara.cullerton', 'alexkim3', 'sguo1', 'bcc4994', 'npalcheck', 'scpiper2', 'gargula2', 'ece34', 'kkong7', 'jterwil2', 'yhren1993', 'klwells2', 'quantumseren', 'stakek2', 'aarti.shah147', 'limberg2', 'yu91', 'yumin2', 'edennis3', 'kluhrsen', 'cory93', 'bomcdon2', 'schiavo1', 'ks.lamb14', 'nickpalcheck', 'allen412068', 'mingxu3', 'raghavkochhar9', 'zhenqin3', 'hlee156', 'foukster', 'jjacksn', 'cljohnson0', 'jdlenz', 'dagapit2', 'dkwok2', 'k0yaku', 'shalper2', 'ahli2', 'ramaiah2', 'fang.the.tall', 'abheshek18', 'benck', 'uber12', 'fwirjo', 'aamurthy', 'cx1048539626', 'jinpengzhuo', 'kurmanba1', 'danieldli1993', 'yfkwan', 'josh.barrett.589', 'pbhatta2', 'eslee5', 'jack.arendt', 'iliveincoto5464', 'jinpeng.zhuo', 'tamtran2', 'btkern2', 'akatsulis', 'aromeo', 'mikra616', 'ydong119', 'dhansel036', 'akagti2', 'hmtaylo2', 'jzhu34', 'siyi.xu.180', 'kaalvar2', 'sligh3ece', 'adsnyde2', 'meng325', 'alex.mitsdarfer', 'jcjc2222', 'xnypr', 'litton2', 'yzhao60', 'jwsmith6', 'jmmille6', 'wchi2', 'peihan0807', 'kathyzhou0124', 'crichrd2', 'dsolanki', 'csbaile2', 'limsiri2', 'achoi121', 'abaddon2mist', 'elin11', 'tiffyye', 'billstan42', 'shijiakimi', 'stps', 'flie2illinois', 'lolipopcarolwang', 'jwang124', 'hylin2', 'christu2', 'qhu12', 'george.s9999', 'lee117', 'henry.ko.94', 'arjun.balwally', 'junpeng.qiu', 'siyima2', 'truszko1993', 'ece340', 'yyang10', 'jacklee3', 'qiujiezhao1994', 'liupufan', 'charlie.dreebin', 'toujours.meiling93', 'allysonv10', 'darksnape', 'toglitt2', 'hnrcksn2', 'rflore24', 'bhanley2', None, 'bcclanc2', 'jwang182', 'kfeng', 'isaacehoffman', 'tong.yin.1']"
4,106,81,12,3,"['abheshek18', 'chen.s.jimmy', 'yhren1993']",77,"['jack.arendt', 'iliveincoto5464', 'xli121', 'tumaini.francesco', 'josh.barrett.589', 'tamtran2', 'mpalmer2', 'rps233', 'aromeo', 'mikra616', 'ydong119', 'dhansel036', 'ph0606', 'sariel12345', 'chris.reinke.16', 'jzhu34', 'kaalvar2', 'sligh3ece', 'eric.groeteke', 'meng325', 'alex.mitsdarfer', 'kornholi', 'png4', 'chaken2', 'rxiao3', 'laura_b_galbraith', 'yzhao60', 'greerdavidc', 'wchi2', 'peihan0807', 'teerapatpoka', 'dsolanki', 'tiffyye', 'ece34', 'billstan42', 'kkong7', 'shijiakimi', 'stps', 'jterwil2', 'flie2illinois', 'quantumseren', 'aarti.shah147', 'yu91', 'yumin2', 'christu2', 'qhu12', 'edennis3', 'george.s9999', 'lee117', 'kluhrsen', 'bomcdon2', 'ks.lamb14', 'allen412068', 'henry.ko.94', 'junpeng.qiu', 'raghavkochhar9', 'zhenqin3', 'hlee156', 'truszko1993', 'ece340', 'foukster', 'jacklee3', 'liupufan', 'charlie.dreebin', 'jdlenz', 'toujours.meiling93', 'darksnape', 'k0yaku', 'hnrcksn2', 'benck', 'uber12', 'fwirjo', 'cx1048539626', 'kurmanba1', 'yfkwan', 'tong.yin.1', 'pbhatta2']",9,"['fan.ling.507', 'muttley.mutt', 'madnesswrap', 'forcade1', 'ssheik22', 'hdou731', 'adam.neuses', 'rmadsen2', None]",89,"['jack.arendt', 'iliveincoto5464', 'xli121', 'tumaini.francesco', 'josh.barrett.589', 'tamtran2', 'mpalmer2', 'ssheik22', 'rps233', 'adam.neuses', 'aromeo', 'mikra616', 'ydong119', 'dhansel036', 'ph0606', 'sariel12345', 'chris.reinke.16', 'jzhu34', 'kaalvar2', 'sligh3ece', 'eric.groeteke', 'meng325', 'alex.mitsdarfer', 'kornholi', 'png4', 'chaken2', 'rxiao3', 'rmadsen2', 'laura_b_galbraith', 'muttley.mutt', 'yzhao60', 'greerdavidc', 'wchi2', 'chen.s.jimmy', 'peihan0807', 'teerapatpoka', 'dsolanki', 'hdou731', 'tiffyye', 'ece34', 'billstan42', 'kkong7', 'shijiakimi', 'stps', 'jterwil2', 'yhren1993', 'flie2illinois', 'quantumseren', 'madnesswrap', 'aarti.shah147', 'yu91', 'yumin2', 'christu2', 'qhu12', 'edennis3', 'george.s9999', 'lee117', 'kluhrsen', 'bomcdon2', 'ks.lamb14', 'allen412068', 'henry.ko.94', 'junpeng.qiu', 'raghavkochhar9', 'zhenqin3', 'hlee156', 'truszko1993', 'ece340', 'foukster', 'jacklee3', 'liupufan', 'charlie.dreebin', 'jdlenz', 'toujours.meiling93', 'darksnape', 'k0yaku', 'hnrcksn2', 'forcade1', 'abheshek18', 'benck', 'uber12', None, 'fwirjo', 'fan.ling.507', 'cx1048539626', 'kurmanba1', 'yfkwan', 'tong.yin.1', 'pbhatta2']"
4,187,81,11,6,"['flie2illinois', 'wchi2', 'rxiao3', 'qhu12', 'edennis3', 'stps']",74,"['jack.arendt', 'iliveincoto5464', 'xli121', 'tumaini.francesco', 'josh.barrett.589', 'tamtran2', 'mpalmer2', 'rps233', 'aromeo', 'mikra616', 'ydong119', 'dhansel036', 'ph0606', 'sariel12345', 'chris.reinke.16', 'jzhu34', 'kaalvar2', 'sligh3ece', 'eric.groeteke', 'meng325', 'alex.mitsdarfer', 'kornholi', 'png4', 'chaken2', 'laura_b_galbraith', 'yzhao60', 'greerdavidc', 'chen.s.jimmy', 'peihan0807', 'teerapatpoka', 'dsolanki', 'tiffyye', 'ece34', 'billstan42', 'kkong7', 'shijiakimi', 'jterwil2', 'yhren1993', 'quantumseren', 'aarti.shah147', 'yu91', 'yumin2', 'christu2', 'george.s9999', 'lee117', 'kluhrsen', 'bomcdon2', 'ks.lamb14', 'allen412068', 'henry.ko.94', 'junpeng.qiu', 'raghavkochhar9', 'zhenqin3', 'hlee156', 'truszko1993', 'ece340', 'foukster', 'jacklee3', 'liupufan', 'charlie.dreebin', 'jdlenz', 'toujours.meiling93', 'darksnape', 'k0yaku', 'hnrcksn2', 'abheshek18', 'benck', 'uber12', 'fwirjo', 'cx1048539626', 'kurmanba1', 'yfkwan', 'tong.yin.1', 'pbhatta2']",5,"['themightybaloon88', 'chien8', 'de2313', 'sahn15', None]",85,"['jack.arendt', 'iliveincoto5464', 'xli121', 'tumaini.francesco', 'josh.barrett.589', 'tamtran2', 'mpalmer2', 'themightybaloon88', 'de2313', 'rps233', 'aromeo', 'mikra616', 'ydong119', 'dhansel036', 'ph0606', 'sariel12345', 'chris.reinke.16', 'jzhu34', 'kaalvar2', 'sligh3ece', 'eric.groeteke', 'meng325', 'alex.mitsdarfer', 'kornholi', 'png4', 'chaken2', 'sahn15', 'rxiao3', 'laura_b_galbraith', 'yzhao60', 'greerdavidc', 'wchi2', 'chen.s.jimmy', 'peihan0807', 'teerapatpoka', 'dsolanki', 'chien8', 'tiffyye', 'ece34', 'billstan42', 'kkong7', 'shijiakimi', 'stps', 'jterwil2', 'yhren1993', 'flie2illinois', 'quantumseren', 'aarti.shah147', 'yu91', 'yumin2', 'christu2', 'qhu12', 'edennis3', 'george.s9999', 'lee117', 'kluhrsen', 'bomcdon2', 'ks.lamb14', 'allen412068', 'henry.ko.94', 'junpeng.qiu', 'raghavkochhar9', 'zhenqin3', 'hlee156', 'truszko1993', 'ece340', 'foukster', 'jacklee3', 'liupufan', 'charlie.dreebin', 'jdlenz', 'toujours.meiling93', 'darksnape', 'k0yaku', 'hnrcksn2', 'abheshek18', 'benck', 'uber12', None, 'fwirjo', 'cx1048539626', 'kurmanba1', 'yfkwan', 'tong.yin.1', 'pbhatta2']"
4,188,81,11,6,"['yhren1993', 'alex.mitsdarfer', 'abheshek18', 'chaken2', 'chen.s.jimmy', 'lee117']",74,"['jack.arendt', 'iliveincoto5464', 'xli121', 'tumaini.francesco', 'josh.barrett.589', 'tamtran2', 'mpalmer2', 'rps233', 'aromeo', 'mikra616', 'ydong119', 'dhansel036', 'ph0606', 'sariel12345', 'chris.reinke.16', 'jzhu34', 'kaalvar2', 'sligh3ece', 'eric.groeteke', 'meng325', 'kornholi', 'png4', 'rxiao3', 'laura_b_galbraith', 'yzhao60', 'greerdavidc', 'wchi2', 'peihan0807', 'teerapatpoka', 'dsolanki', 'tiffyye', 'ece34', 'billstan42', 'kkong7', 'shijiakimi', 'stps', 'jterwil2', 'flie2illinois', 'quantumseren', 'aarti.shah147', 'yu91', 'yumin2', 'christu2', 'qhu12', 'edennis3', 'george.s9999', 'kluhrsen', 'bomcdon2', 'ks.lamb14', 'allen412068', 'henry.ko.94', 'junpeng.qiu', 'raghavkochhar9', 'zhenqin3', 'hlee156', 'truszko1993', 'ece340', 'foukster', 'jacklee3', 'liupufan', 'charlie.dreebin', 'jdlenz', 'toujours.meiling93', 'darksnape', 'k0yaku', 'hnrcksn2', 'benck', 'uber12', 'fwirjo', 'cx1048539626', 'kurmanba1', 'yfkwan', 'tong.yin.1', 'pbhatta2']",5,"['nemitz22', 'amencherla2401', 'rahful', 'ssheik22', None]",85,"['jack.arendt', 'iliveincoto5464', 'xli121', 'tumaini.francesco', 'josh.barrett.589', 'tamtran2', 'mpalmer2', 'ssheik22', 'rps233', 'aromeo', 'mikra616', 'ydong119', 'dhansel036', 'ph0606', 'sariel12345', 'chris.reinke.16', 'jzhu34', 'kaalvar2', 'amencherla2401', 'sligh3ece', 'eric.groeteke', 'meng325', 'alex.mitsdarfer', 'kornholi', 'png4', 'chaken2', 'rxiao3', 'laura_b_galbraith', 'nemitz22', 'yzhao60', 'greerdavidc', 'wchi2', 'chen.s.jimmy', 'peihan0807', 'teerapatpoka', 'dsolanki', 'tiffyye', 'ece34', 'billstan42', 'kkong7', 'shijiakimi', 'stps', 'jterwil2', 'yhren1993', 'flie2illinois', 'quantumseren', 'aarti.shah147', 'yu91', 'yumin2', 'christu2', 'qhu12', 'edennis3', 'george.s9999', 'lee117', 'kluhrsen', 'bomcdon2', 'ks.lamb14', 'allen412068', 'henry.ko.94', 'junpeng.qiu', 'raghavkochhar9', 'zhenqin3', 'hlee156', 'truszko1993', 'ece340', 'foukster', 'jacklee3', 'liupufan', 'charlie.dreebin', 'jdlenz', 'toujours.meiling93', 'darksnape', 'rahful', 'k0yaku', 'hnrcksn2', 'abheshek18', 'benck', 'uber12', None, 'fwirjo', 'cx1048539626', 'kurmanba1', 'yfkwan', 'tong.yin.1', 'pbhatta2']"
4,41,81,9,4,"['png4', 'peihan0807', 'yumin2', 'billstan42']",76,"['jack.arendt', 'iliveincoto5464', 'xli121', 'tumaini.francesco', 'josh.barrett.589', 'tamtran2', 'mpalmer2', 'rps233', 'aromeo', 'mikra616', 'ydong119', 'dhansel036', 'ph0606', 'sariel12345', 'chris.reinke.16', 'jzhu34', 'kaalvar2', 'sligh3ece', 'eric.groeteke', 'meng325', 'alex.mitsdarfer', 'kornholi', 'chaken2', 'rxiao3', 'laura_b_galbraith', 'yzhao60', 'greerdavidc', 'wchi2', 'chen.s.jimmy', 'teerapatpoka', 'dsolanki', 'tiffyye', 'ece34', 'kkong7', 'shijiakimi', 'stps', 'jterwil2', 'yhren1993', 'flie2illinois', 'quantumseren', 'aarti.shah147', 'yu91', 'christu2', 'qhu12', 'edennis3', 'george.s9999', 'lee117', 'kluhrsen', 'bomcdon2', 'ks.lamb14', 'allen412068', 'henry.ko.94', 'junpeng.qiu', 'raghavkochhar9', 'zhenqin3', 'hlee156', 'truszko1993', 'ece340', 'foukster', 'jacklee3', 'liupufan', 'charlie.dreebin', 'jdlenz', 'toujours.meiling93', 'darksnape', 'k0yaku', 'hnrcksn2', 'abheshek18', 'benck', 'uber12', 'fwirjo', 'cx1048539626', 'kurmanba1', 'yfkwan', 'tong.yin.1', 'pbhatta2']",5,"['kknom1', 'ujrav', 'li160', 'eclee2', None]",85,"['jack.arendt', 'iliveincoto5464', 'xli121', 'tumaini.francesco', 'josh.barrett.589', 'tamtran2', 'mpalmer2', 'rps233', 'aromeo', 'mikra616', 'ydong119', 'dhansel036', 'ph0606', 'sariel12345', 'chris.reinke.16', 'jzhu34', 'kaalvar2', 'sligh3ece', 'eric.groeteke', 'meng325', 'alex.mitsdarfer', 'kornholi', 'png4', 'chaken2', 'rxiao3', 'laura_b_galbraith', 'yzhao60', 'greerdavidc', 'wchi2', 'chen.s.jimmy', 'peihan0807', 'teerapatpoka', 'dsolanki', 'tiffyye', 'ece34', 'billstan42', 'kkong7', 'shijiakimi', 'stps', 'kknom1', 'ujrav', 'jterwil2', 'yhren1993', 'flie2illinois', 'quantumseren', 'aarti.shah147', 'yu91', 'yumin2', 'christu2', 'qhu12', 'edennis3', 'george.s9999', 'lee117', 'kluhrsen', 'bomcdon2', 'ks.lamb14', 'eclee2', 'allen412068', 'henry.ko.94', 'junpeng.qiu', 'raghavkochhar9', 'zhenqin3', 'hlee156', 'truszko1993', 'ece340', 'foukster', 'jacklee3', 'li160', 'liupufan', 'charlie.dreebin', 'jdlenz', 'toujours.meiling93', 'darksnape', 'k0yaku', 'hnrcksn2', 'abheshek18', 'benck', 'uber12', None, 'fwirjo', 'cx1048539626', 'kurmanba1', 'yfkwan', 'tong.yin.1', 'pbhatta2']"
4,107,81,9,6,"['junpeng.qiu', 'wchi2', 'tiffyye', 'mikra616', 'sariel12345', 'jzhu34']",74,"['jack.arendt', 'iliveincoto5464', 'xli121', 'tumaini.francesco', 'josh.barrett.589', 'tamtran2', 'mpalmer2', 'rps233', 'aromeo', 'ydong119', 'dhansel036', 'ph0606', 'chris.reinke.16', 'kaalvar2', 'sligh3ece', 'eric.groeteke', 'meng325', 'alex.mitsdarfer', 'kornholi', 'png4', 'chaken2', 'rxiao3', 'laura_b_galbraith', 'yzhao60', 'greerdavidc', 'chen.s.jimmy', 'peihan0807', 'teerapatpoka', 'dsolanki', 'ece34', 'billstan42', 'kkong7', 'shijiakimi', 'stps', 'jterwil2', 'yhren1993', 'flie2illinois', 'quantumseren', 'aarti.shah147', 'yu91', 'yumin2', 'christu2', 'qhu12', 'edennis3', 'george.s9999', 'lee117', 'kluhrsen', 'bomcdon2', 'ks.lamb14', 'allen412068', 'henry.ko.94', 'raghavkochhar9', 'zhenqin3', 'hlee156', 'truszko1993', 'ece340', 'foukster', 'jacklee3', 'liupufan', 'charlie.dreebin', 'jdlenz', 'toujours.meiling93', 'darksnape', 'k0yaku', 'hnrcksn2', 'abheshek18', 'benck', 'uber12', 'fwirjo', 'cx1048539626', 'kurmanba1', 'yfkwan', 'tong.yin.1', 'pbhatta2']",3,"['emdeity', None, 'shawnahn318']",83,"['jack.arendt', 'iliveincoto5464', 'xli121', 'tumaini.francesco', 'josh.barrett.589', 'tamtran2', 'mpalmer2', 'rps233', 'aromeo', 'mikra616', 'ydong119', 'dhansel036', 'ph0606', 'sariel12345', 'chris.reinke.16', 'jzhu34', 'kaalvar2', 'sligh3ece', 'eric.groeteke', 'meng325', 'alex.mitsdarfer', 'kornholi', 'png4', 'chaken2', 'rxiao3', 'laura_b_galbraith', 'yzhao60', 'shawnahn318', 'emdeity', 'greerdavidc', 'wchi2', 'chen.s.jimmy', 'peihan0807', 'teerapatpoka', 'dsolanki', 'tiffyye', 'ece34', 'billstan42', 'kkong7', 'shijiakimi', 'stps', 'jterwil2', 'yhren1993', 'flie2illinois', 'quantumseren', 'aarti.shah147', 'yu91', 'yumin2', 'christu2', 'qhu12', 'edennis3', 'george.s9999', 'lee117', 'kluhrsen', 'bomcdon2', 'ks.lamb14', 'allen412068', 'henry.ko.94', 'junpeng.qiu', 'raghavkochhar9', 'zhenqin3', 'hlee156', 'truszko1993', 'ece340', 'foukster', 'jacklee3', 'liupufan', 'charlie.dreebin', 'jdlenz', 'toujours.meiling93', 'darksnape', 'k0yaku', 'hnrcksn2', 'abheshek18', 'benck', 'uber12', None, 'fwirjo', 'cx1048539626', 'kurmanba1', 'yfkwan', 'tong.yin.1', 'pbhatta2']"
5,75,67,61,59,"['cglenno2', 'andr.buhl', 'clealauten', 'dsch33', 'ewok', 'witvlit', 'jaikarnik95', 'shamaleegoonetilleke', 'alvinlvalysa', 'elliot.young1996', 'pjnick0', 'a_kuzni2', 'stephanieh', 'sho1123', 'vasyltheonly', 'pokhym', 'zhoffm', 'cwojtan', 'billli1997', 'raugmoss1', 'zuojulia', 'alexmkuznicki', 'reneening', 'mchu5', 'adiassasino', 'njamali2', 'nicholascadler', 'zzaman22', 'boycexu', 'liuyuting1006', 'mpunuk', 'gracepakeltis', 'lgwarpinski', 'ssrajer', 'bbknipfer', 'streufe1', 'jacobcamp1', 'ans.liverpool', 'joylin11', 'fangguanhua2013', 'zhanshi', 'dman5505', 'yliu181', 'jbeta95', 'dpapanicolas', 'eaallen', 'cacheuiuc', 'oweimrin', 'dsch0908', 'elindgren', 'shenyuwu94', 'werkkdy2', 'hhardin2', 'schiavone.emily', 'guchenchen9393', 'toni.nepo7', 'sdschmi2', 'ewokoniad', 'ecyoung3']",7,"['stephanieho', 'wiseatvice', 'hamza.maizhadjahmed.1', 'daut', 'joaleksonis', 'sloneil2', 'ajeyvenkat91']",2,"[None, 'ed.tir.1']",68,"['wiseatvice', 'ewok', 'alvinlvalysa', 'elliot.young1996', 'pjnick0', 'joaleksonis', 'vasyltheonly', 'pokhym', 'zhoffm', 'cwojtan', 'raugmoss1', 'zuojulia', 'reneening', 'njamali2', 'nicholascadler', 'zzaman22', 'lgwarpinski', 'stephanieho', 'jacobcamp1', 'ed.tir.1', 'fangguanhua2013', 'yliu181', 'jbeta95', 'cacheuiuc', 'eaallen', 'werkkdy2', 'dsch0908', 'shenyuwu94', 'schiavone.emily', 'guchenchen9393', 'sdschmi2', 'ewokoniad', 'ecyoung3', 'cglenno2', 'clealauten', 'andr.buhl', 'dsch33', 'jaikarnik95', 'witvlit', 'shamaleegoonetilleke', 'daut', 'a_kuzni2', 'stephanieh', 'ajeyvenkat91', 'sho1123', 'billli1997', 'alexmkuznicki', 'mchu5', 'adiassasino', 'boycexu', 'liuyuting1006', 'mpunuk', 'gracepakeltis', 'ssrajer', 'bbknipfer', 'streufe1', 'hamza.maizhadjahmed.1', 'ans.liverpool', 'joylin11', 'zhanshi', 'dman5505', 'sloneil2', None, 'dpapanicolas', 'elindgren', 'oweimrin', 'toni.nepo7', 'hhardin2']"
6,232,66,52,49,"['bciezzi', 'bdbehrho', 'cbomb20', 'kjmirrie', 'kmbeal', 'jrledfor1', 'latashan3', 'jpwhita2', 'rlfulghu', 'bstull', 'crwest2', 'chingulya1', 'bljenio', 'ucawuruo', 'smmurphyncsu', 'leander3', 'csbarcla', 'cgcarter', 'aseeri8', 'hackettman', 'cbdonohu', 'carajackson27', 'atjohns7', 'jpsimmo2', 'kurosaki1', 'twaters10', 'gasingac', 'nnswyger', 'pmpoyman', 'brian.doheny', 'jswilkin', 'wawitzen', 'smokedestructer', 'ajohnson8617', 'asporcel', 'wdcrumpl', 'ptwethin', 'klarissaramos', 'brianhaidet', 'aaalsale', 'michelle.ferrara.33', 'daniellestallings4', 'mgmosche', 'lilian.montgomery', 'pwwessle', 'abondar', 'aiurdane', 'byrowley', 'colindonahue15']",16,"['jmgriff5', 'raberezi', 'jmstaimp', 'bcbrwk', 'polwyn', 'pdgannet', 'cchi', 'eddigrig', 'maniamir', 'lshiaa', 'murkrotmg', 'mbmcmurr', 'liuzhixiao', 'kerice', 'pburger', 'kevandeg']",3,"['amygoodling', None, 'whfuss']",68,"['bciezzi', 'cbomb20', 'bdbehrho', 'kjmirrie', 'kmbeal', 'bcbrwk', 'jrledfor1', 'latashan3', 'kevandeg', 'crwest2', 'bljenio', 'smmurphyncsu', 'aseeri8', 'hackettman', 'carajackson27', 'jpsimmo2', 'amygoodling', 'twaters10', 'gasingac', 'nnswyger', 'pmpoyman', 'brian.doheny', 'jmstaimp', 'raberezi', 'ptwethin', 'klarissaramos', 'daniellestallings4', 'mgmosche', 'lilian.montgomery', 'pwwessle', 'mbmcmurr', 'byrowley', 'jmgriff5', 'eddigrig', 'lshiaa', 'jpwhita2', 'rlfulghu', 'chingulya1', 'bstull', 'ucawuruo', 'leander3', 'polwyn', 'csbarcla', 'cgcarter', 'cbdonohu', 'atjohns7', 'liuzhixiao', 'kerice', 'kurosaki1', 'whfuss', 'jswilkin', 'wawitzen', 'cchi', 'smokedestructer', 'ajohnson8617', None, 'asporcel', 'wdcrumpl', 'pdgannet', 'brianhaidet', 'aaalsale', 'michelle.ferrara.33', 'maniamir', 'abondar', 'murkrotmg', 'aiurdane', 'pburger', 'colindonahue15']"
7,137,55,48,45,"['tanis.emma.everest', 'kjjchapman', 'tomloe101', 'jasmine.darlow', 'naomimary', 'izydaoud', 'hannah.jongkind.5', 'victoria.chapman.98', 'amie.parker.313', 'tforrow', 'mattmills2110', 'lil.eley.dude', 'hannah.brackley', 'chrisandrews273', 'joe.george.58958', 'morlec', 'mandeep.dhak', 'amypenfold17', 'simon.will8', 'rebeccaclaringbold', 'fateweaverer', 'rob5729582', 'plthornstrom', 'kwilliams312', 'adada1319', 'amyrosebannister', 'charlotte.denniss.9', 'lukeno94', 'eki_95', 'njmiddleton', 'kaan.alkan.54', 'alexlnufc', 'zoeselfe1', 'olivia.cottam1', 'eduns123', 'jsefton95', 'ellefsb', 'jack.avis.3', 'anguscollins95', 'ben54321', 'blisskelly26', 'jsbabra', 'samuel.dunn.3', 'joelwood', 'benplackett1']",9,"['baileyalex6', 'pughjp', 'jackd321', 'jcheeseman', 'joshybaylis', 'jake.lee.9461', 'joe.clarke.948', 'hirbod', 'smidgley2310']",3,"['sophieharris', None, 'matt.hagreen']",57,"['tanis.emma.everest', 'kjjchapman', 'tomloe101', 'naomimary', 'izydaoud', 'amie.parker.313', 'lil.eley.dude', 'hannah.brackley', 'joe.george.58958', 'morlec', 'mandeep.dhak', 'pughjp', 'fateweaverer', 'kwilliams312', 'adada1319', 'joshybaylis', 'eki_95', 'zoeselfe1', 'olivia.cottam1', 'smidgley2310', 'jsefton95', 'ellefsb', 'anguscollins95', 'ben54321', 'blisskelly26', 'jake.lee.9461', 'hirbod', 'benplackett1', 'jasmine.darlow', 'baileyalex6', 'hannah.jongkind.5', 'victoria.chapman.98', 'tforrow', 'mattmills2110', 'chrisandrews273', 'amypenfold17', 'simon.will8', 'rebeccaclaringbold', 'rob5729582', 'plthornstrom', 'jcheeseman', 'amyrosebannister', 'charlotte.denniss.9', 'lukeno94', 'matt.hagreen', 'njmiddleton', 'kaan.alkan.54', 'sophieharris', 'alexlnufc', 'joe.clarke.948', None, 'eduns123', 'jack.avis.3', 'jackd321', 'jsbabra', 'samuel.dunn.3', 'joelwood']"
7,138,55,7,5,"['baileyalex6', 'jackd321', 'jake.lee.9461', 'alexlnufc', 'smidgley2310']",49,"['tanis.emma.everest', 'kjjchapman', 'tomloe101', 'jasmine.darlow', 'naomimary', 'hannah.jongkind.5', 'izydaoud', 'victoria.chapman.98', 'amie.parker.313', 'tforrow', 'mattmills2110', 'lil.eley.dude', 'hannah.brackley', 'chrisandrews273', 'morlec', 'mandeep.dhak', 'amypenfold17', 'simon.will8', 'pughjp', 'rebeccaclaringbold', 'rob5729582', 'fateweaverer', 'plthornstrom', 'kwilliams312', 'adada1319', 'amyrosebannister', 'jcheeseman', 'joelwood', 'joshybaylis', 'charlotte.denniss.9', 'lukeno94', 'eki_95', 'njmiddleton', 'kaan.alkan.54', 'zoeselfe1', 'joe.clarke.948', 'olivia.cottam1', 'eduns123', 'jsefton95', 'ellefsb', 'jack.avis.3', 'anguscollins95', 'ben54321', 'jsbabra', 'blisskelly26', 'samuel.dunn.3', 'joe.george.58958', 'hirbod', 'benplackett1']",2,"['sophieharris', None]",56,"['tanis.emma.everest', 'kjjchapman', 'tomloe101', 'jasmine.darlow', 'naomimary', 'baileyalex6', 'hannah.jongkind.5', 'izydaoud', 'victoria.chapman.98', 'amie.parker.313', 'tforrow', 'mattmills2110', 'lil.eley.dude', 'hannah.brackley', 'chrisandrews273', 'morlec', 'mandeep.dhak', 'amypenfold17', 'simon.will8', 'pughjp', 'rebeccaclaringbold', 'rob5729582', 'fateweaverer', 'plthornstrom', 'kwilliams312', 'adada1319', 'amyrosebannister', 'jcheeseman', 'joelwood', 'joshybaylis', 'charlotte.denniss.9', 'lukeno94', 'eki_95', 'njmiddleton', 'kaan.alkan.54', 'sophieharris', 'alexlnufc', 'zoeselfe1', 'joe.clarke.948', None, 'olivia.cottam1', 'eduns123', 'smidgley2310', 'jsefton95', 'ellefsb', 'jack.avis.3', 'jackd321', 'anguscollins95', 'ben54321', 'jsbabra', 'jake.lee.9461', 'blisskelly26', 'samuel.dunn.3', 'joe.george.58958', 'hirbod', 'benplackett1']"
8,13,52,58,42,"['peterge', 'amr_ahmed', 'hendy_93', 'waelazzam54', 'khaled.abotaleb', 'mona.mony.503092', 'mohamed_ismail', 'mage0x', 'amirahussein94', 'marco100', 'mohamed.t.heikal', 'ahmed.nagy.3344913', 'gamalalaa92', 'khaled.a.abdelmoniem', 'mohsenzakaria63', 'mohanad', 'morsy', 'mohamedfarid', 'mohamed.eleraky', 'mohamedhussein223', 'hannood45', 'aya.yasser.992', 'khaledsalem92', 'samar.abdelazez.37', 'mina.medhat.357', 'injyradwan', 'isk.ibm', 'motazfahmy', 'alaa.gamal.980315', 'menna.m.farouk.1', 'mohamedalisamier', 'juicyblonde.reem', 'mostafa.hesham.58958', 'abdouu.sleem', 'reemahmed5', 'momo224411', 'andrew.adel.5205', 'isaac_ibm', 'afengasu', 'loala_92', 'alaabedeir', 'yaraessamasu']",9,"['nkhong', 'chenxidianedu', 'mohamed.wael.16', 'dhanunjaya.ind', 'enghady.mohamed', 'neo.deckard', 'jiwoon.im', 'aya.atif.756', 'mohamed.nohy.5']",16,"['mostafa.elsayeh.1', 'mazenhesham', 'ykholousy', 'dinahany52', None, 'mohamed.ahmed7960420', 'rodina.magdy.9', 'nourhanhelal', 'shazasalem92', 'hassan.m.ahmed93', 'asmaa.mostafa.581', 'omnia12347', 'bloomymud', 'mavea_800', 'esrraahamdy', 'm.o.ahmed55']",67,"['amr_ahmed', 'hendy_93', 'waelazzam54', 'khaled.abotaleb', 'mage0x', 'mavea_800', 'chenxidianedu', 'enghady.mohamed', 'khaled.a.abdelmoniem', 'mohanad', 'morsy', 'mohamed.eleraky', 'dhanunjaya.ind', 'shazasalem92', 'khaledsalem92', 'samar.abdelazez.37', 'injyradwan', 'alaa.gamal.980315', 'menna.m.farouk.1', 'nkhong', 'ykholousy', 'mohamed.wael.16', 'momo224411', 'andrew.adel.5205', 'afengasu', 'loala_92', 'rodina.magdy.9', 'alaabedeir', 'jiwoon.im', 'mohamed.nohy.5', 'yaraessamasu', 'peterge', 'mona.mony.503092', 'mohamed_ismail', 'amirahussein94', 'm.o.ahmed55', 'marco100', 'mohamed.t.heikal', 'dinahany52', 'ahmed.nagy.3344913', 'gamalalaa92', 'neo.deckard', 'hassan.m.ahmed93', 'aya.atif.756', 'mohsenzakaria63', 'mohamedfarid', 'mostafa.elsayeh.1', 'mazenhesham', 'mohamedhussein223', 'hannood45', 'mohamed.ahmed7960420', 'aya.yasser.992', 'asmaa.mostafa.581', 'mina.medhat.357', 'isk.ibm', 'esrraahamdy', 'motazfahmy', 'mohamedalisamier', None, 'juicyblonde.reem', 'mostafa.hesham.58958', 'abdouu.sleem', 'reemahmed5', 'isaac_ibm', 'nourhanhelal', 'omnia12347', 'bloomymud']"
8,169,52,10,1,['waelazzam54'],50,"['peterge', 'amr_ahmed', 'hendy_93', 'khaled.abotaleb', 'mona.mony.503092', 'mohamed_ismail', 'mage0x', 'amirahussein94', 'chenxidianedu', 'marco100', 'mohamed.t.heikal', 'enghady.mohamed', 'ahmed.nagy.3344913', 'gamalalaa92', 'neo.deckard', 'khaled.a.abdelmoniem', 'aya.atif.756', 'mohsenzakaria63', 'mohanad', 'morsy', 'mohamedfarid', 'mohamed.eleraky', 'mohamedhussein223', 'dhanunjaya.ind', 'hannood45', 'aya.yasser.992', 'khaledsalem92', 'samar.abdelazez.37', 'mina.medhat.357', 'injyradwan', 'isk.ibm', 'motazfahmy', 'alaa.gamal.980315', 'menna.m.farouk.1', 'mohamedalisamier', 'nkhong', 'juicyblonde.reem', 'mostafa.hesham.58958', 'abdouu.sleem', 'reemahmed5', 'momo224411', 'andrew.adel.5205', 'isaac_ibm', 'afengasu', 'loala_92', 'mohamed.wael.16', 'alaabedeir', 'jiwoon.im', 'mohamed.nohy.5', 'yaraessamasu']",9,"['moh.mostafa.92', 'jam4you30', 'saeeed3', None, 'amnsawaby', 'engam1993', 'eng.somayaahmed', 'hassanelassal99', 'amaassg']",60,"['peterge', 'amr_ahmed', 'hendy_93', 'jam4you30', 'waelazzam54', 'khaled.abotaleb', 'mona.mony.503092', 'mohamed_ismail', 'mage0x', 'amirahussein94', 'chenxidianedu', 'marco100', 'mohamed.t.heikal', 'enghady.mohamed', 'ahmed.nagy.3344913', 'gamalalaa92', 'neo.deckard', 'khaled.a.abdelmoniem', 'aya.atif.756', 'mohsenzakaria63', 'mohanad', 'morsy', 'mohamedfarid', 'moh.mostafa.92', 'mohamed.eleraky', 'mohamedhussein223', 'dhanunjaya.ind', 'hannood45', 'aya.yasser.992', 'eng.somayaahmed', 'khaledsalem92', 'samar.abdelazez.37', 'mina.medhat.357', 'injyradwan', 'isk.ibm', 'motazfahmy', 'alaa.gamal.980315', 'menna.m.farouk.1', 'mohamedalisamier', 'nkhong', 'hassanelassal99', 'juicyblonde.reem', None, 'amaassg', 'mostafa.hesham.58958', 'abdouu.sleem', 'reemahmed5', 'momo224411', 'andrew.adel.5205', 'isaac_ibm', 'afengasu', 'loala_92', 'mohamed.wael.16', 'saeeed3', 'alaabedeir', 'amnsawaby', 'engam1993', 'jiwoon.im', 'mohamed.nohy.5', 'yaraessamasu']"
9,105,51,120,39,"['rglazer21', 'richrdtang', 'alexzzz1991', 'winoto2', 'kenned45', 'cpx0rpc', 'xchen84', 'karwal2', 'molly.pace.3', '1993sonu01', 'golasze2', 'ppitchyy', 'brianchien390', 'grandcn', 'decraen2', 'emily.hannigan.31', 'thephiltsai', 'brianchien', 'haelim1227', 'sehui04', 'shawnahn318', 'dekunukem', 'earicha2', 'daehee0104', 'tim.sutyak2', 'mingkang.he', 'dan.long.7505', 'dguo8', 'dingldn2', 'blu6', 'replogl2', 'ecl01', 'eric.stiles3', 'archiehok', 'yc6', 'aderoo2', 'kshin10', 'whuang56', 'jemysoul']",11,"['ahmedchakroun', 'lfdm', 'lifan.ch', 'fan.ling.507', 'muttley.mutt', 'madnesswrap', 'tvmani.d', 'shreyasmangalgi', 'adam.neuses', 'forcade1', 'hdou731']",81,"['xli121', 'mpalmer2', 'rps233', 'ph0606', 'chris.reinke.16', 'eric.groeteke', 'kornholi', 'png4', 'chaken2', 'rxiao3', 'weineran', 'laura_b_galbraith', 'greerdavidc', 'teerapatpoka', 'bryniar2', 'ece34', 'kkong7', 'ujrav', 'jterwil2', 'yhren1993', 'quantumseren', 'aarti.shah147', 'yumin2', 'yu91', 'edennis3', 'kluhrsen', 'bomcdon2', 'ks.lamb14', 'allen412068', 'raghavkochhar9', 'zhenqin3', 'hlee156', 'jdlenz', 'uber12', 'benck', 'piyayott9', 'fwirjo', 'cx1048539626', 'kurmanba1', 'pbhatta2', 'josh.barrett.589', 'jack.arendt', 'iliveincoto5464', 'tamtran2', 'aromeo', 'mikra616', 'ydong119', 'dhansel036', 'jdurant2', 'hmtaylo2', 'jzhu34', 'paur2', 'kaalvar2', 'sligh3ece', 'bordain1', 'meng325', 'alex.mitsdarfer', 'yzhao60', 'sangyuno0o', 'peihan0807', 'dsolanki', 'billstan42', 'shijiakimi', 'stps', 'flie2illinois', 'christu2', 'qhu12', 'lee117', 'george.s9999', 'henry.ko.94', 'junpeng.qiu', 'truszko1993', 'ece340', 'jacklee3', 'liupufan', 'toujours.meiling93', 'charlie.dreebin', 'darksnape', 'hnrcksn2', None, 'tong.yin.1']",131,"['richrdtang', 'lifan.ch', 'xli121', 'mpalmer2', 'alexzzz1991', 'winoto2', 'adam.neuses', 'rps233', 'cpx0rpc', 'ph0606', 'chris.reinke.16', 'eric.groeteke', 'kornholi', 'png4', 'chaken2', 'emily.hannigan.31', 'rxiao3', 'weineran', 'haelim1227', 'laura_b_galbraith', 'muttley.mutt', 'shawnahn318', 'greerdavidc', 'daehee0104', 'mingkang.he', 'dan.long.7505', 'teerapatpoka', 'ahmedchakroun', 'hdou731', 'bryniar2', 'ece34', 'aderoo2', 'golasze2', 'kkong7', 'ujrav', 'jterwil2', 'yhren1993', 'quantumseren', 'madnesswrap', 'aarti.shah147', 'tvmani.d', 'shreyasmangalgi', 'yumin2', 'yu91', 'kenned45', 'karwal2', 'xchen84', 'edennis3', 'kluhrsen', 'bomcdon2', 'ks.lamb14', 'allen412068', 'raghavkochhar9', 'zhenqin3', 'hlee156', 'brianchien', 'jdlenz', 'sehui04', 'forcade1', 'earicha2', 'uber12', 'benck', 'piyayott9', 'dguo8', 'dingldn2', 'fwirjo', 'cx1048539626', 'eric.stiles3', 'yc6', 'kurmanba1', 'whuang56', 'josh.barrett.589', 'jemysoul', 'pbhatta2', 'jack.arendt', 'iliveincoto5464', 'tamtran2', 'molly.pace.3', 'aromeo', 'mikra616', 'ydong119', 'dhansel036', 'jdurant2', '1993sonu01', 'hmtaylo2', 'jzhu34', 'paur2', 'kaalvar2', 'sligh3ece', 'ppitchyy', 'bordain1', 'meng325', 'alex.mitsdarfer', 'lfdm', 'yzhao60', 'sangyuno0o', 'tim.sutyak2', 'peihan0807', 'dsolanki', 'billstan42', 'shijiakimi', 'stps', 'rglazer21', 'flie2illinois', 'christu2', 'qhu12', 'lee117', 'george.s9999', 'brianchien390', 'grandcn', 'henry.ko.94', 'decraen2', 'junpeng.qiu', 'truszko1993', 'thephiltsai', 'ece340', 'jacklee3', 'liupufan', 'toujours.meiling93', 'charlie.dreebin', 'darksnape', 'hnrcksn2', 'dekunukem', None, 'fan.ling.507', 'blu6', 'replogl2', 'ecl01', 'archiehok', 'tong.yin.1', 'kshin10']"
9,106,51,12,6,"['fan.ling.507', 'muttley.mutt', 'madnesswrap', 'forcade1', 'hdou731', 'adam.neuses']",44,"['rglazer21', 'richrdtang', 'lifan.ch', 'tvmani.d', 'alexzzz1991', 'shreyasmangalgi', 'winoto2', 'kenned45', 'cpx0rpc', 'xchen84', 'karwal2', 'molly.pace.3', '1993sonu01', 'golasze2', 'ppitchyy', 'brianchien390', 'grandcn', 'decraen2', 'emily.hannigan.31', 'thephiltsai', 'brianchien', 'haelim1227', 'lfdm', 'sehui04', 'shawnahn318', 'dekunukem', 'earicha2', 'daehee0104', 'tim.sutyak2', 'mingkang.he', 'dan.long.7505', 'dguo8', 'ahmedchakroun', 'dingldn2', 'blu6', 'replogl2', 'ecl01', 'eric.stiles3', 'archiehok', 'yc6', 'aderoo2', 'kshin10', 'whuang56', 'jemysoul']",6,"['yhren1993', 'ssheik22', 'abheshek18', 'chen.s.jimmy', 'rmadsen2', None]",56,"['rglazer21', 'richrdtang', 'lifan.ch', 'yhren1993', 'madnesswrap', 'alexzzz1991', 'tvmani.d', 'shreyasmangalgi', 'winoto2', 'adam.neuses', 'ssheik22', 'kenned45', 'cpx0rpc', 'xchen84', 'karwal2', 'molly.pace.3', '1993sonu01', 'ppitchyy', 'brianchien390', 'grandcn', 'decraen2', 'emily.hannigan.31', 'thephiltsai', 'brianchien', 'rmadsen2', 'haelim1227', 'lfdm', 'muttley.mutt', 'sehui04', 'shawnahn318', 'dekunukem', 'forcade1', 'abheshek18', 'earicha2', 'daehee0104', 'tim.sutyak2', 'mingkang.he', 'dan.long.7505', 'chen.s.jimmy', None, 'dguo8', 'aderoo2', 'ahmedchakroun', 'dingldn2', 'fan.ling.507', 'blu6', 'replogl2', 'ecl01', 'eric.stiles3', 'archiehok', 'hdou731', 'yc6', 'golasze2', 'kshin10', 'whuang56', 'jemysoul']"
9,107,51,9,1,['shawnahn318'],49,"['rglazer21', 'richrdtang', 'lifan.ch', 'madnesswrap', 'alexzzz1991', 'tvmani.d', 'shreyasmangalgi', 'winoto2', 'adam.neuses', 'kenned45', 'cpx0rpc', 'xchen84', 'karwal2', 'molly.pace.3', '1993sonu01', 'ppitchyy', 'brianchien390', 'grandcn', 'decraen2', 'emily.hannigan.31', 'thephiltsai', 'brianchien', 'haelim1227', 'lfdm', 'muttley.mutt', 'sehui04', 'dekunukem', 'forcade1', 'earicha2', 'daehee0104', 'tim.sutyak2', 'mingkang.he', 'dan.long.7505', 'dguo8', 'aderoo2', 'ahmedchakroun', 'dingldn2', 'fan.ling.507', 'blu6', 'replogl2', 'ecl01', 'eric.stiles3', 'archiehok', 'hdou731', 'yc6', 'golasze2', 'kshin10', 'whuang56', 'jemysoul']",8,"['junpeng.qiu', 'sariel12345', 'emdeity', 'wchi2', 'tiffyye', 'mikra616', None, 'jzhu34']",58,"['rglazer21', 'richrdtang', 'lifan.ch', 'madnesswrap', 'alexzzz1991', 'tvmani.d', 'shreyasmangalgi', 'winoto2', 'adam.neuses', 'kenned45', 'cpx0rpc', 'xchen84', 'karwal2', 'molly.pace.3', 'mikra616', '1993sonu01', 'jzhu34', 'sariel12345', 'ppitchyy', 'brianchien390', 'grandcn', 'decraen2', 'junpeng.qiu', 'emily.hannigan.31', 'thephiltsai', 'brianchien', 'haelim1227', 'lfdm', 'muttley.mutt', 'sehui04', 'shawnahn318', 'dekunukem', 'forcade1', 'emdeity', 'wchi2', 'earicha2', 'daehee0104', 'tim.sutyak2', 'mingkang.he', 'dan.long.7505', None, 'dguo8', 'aderoo2', 'ahmedchakroun', 'dingldn2', 'fan.ling.507', 'blu6', 'replogl2', 'ecl01', 'eric.stiles3', 'archiehok', 'hdou731', 'yc6', 'tiffyye', 'golasze2', 'kshin10', 'whuang56', 'jemysoul']"
10,186,50,117,41,"['julia.labelle2', 'tim.sutyak', 'michael370662', 'mysonu', 'haunlliam', 'xiongfei.ding', 'danzuo', 'miller7', 'yoo66', 'cooldaehee', 'mikeyling18', 'tapeter2', 'tatanve', 'michael.diehl.583', 'kumikknd', 'jmxscrs', 'bkesler', 'grandcn4', 'wang217', 'henryahn', 'mithun.manivannan', 'xinding33', 'mattsucich', 'au.chinprutthiwong', 'dan5664', 'jzhu46', 'jtomaras', 'beholla2', 'sarielqjl', 'molly.pace93', 'yk.karwal', 'coolkat677', 'dyangsteven', 'rstang2', 'zlc31993', 'kpsrini2', 'tobrien7', 'djiang7', 'ndecraene', 'piyayott', 'pescenck']",8,"['nemitz22', 'amencherla2401', 'themightybaloon88', 'syed.mohsin.311', 'rahful', 'chien8', 'sahn15', 'david.boucard']",76,"['ujrav', 'jack.arendt', 'kknom1', 'iliveincoto5464', 'jterwil2', 'quantumseren', 'mpalmer2', 'aarti.shah147', 'ssheik22', 'rps233', 'yumin2', 'yu91', 'aromeo', 'christu2', 'mikra616', 'edennis3', 'dhansel036', 'ph0606', 'lee117', 'jdurant2', 'george.s9999', 'kluhrsen', 'hmtaylo2', 'sariel12345', 'chris.reinke.16', 'jzhu34', 'kaalvar2', 'bomcdon2', 'sligh3ece', 'ks.lamb14', 'eric.groeteke', 'eclee2', 'pbhatta2', 'allen412068', 'meng325', 'alex.mitsdarfer', 'kornholi', 'png4', 'chaken2', 'raghavkochhar9', 'zhenqin3', 'rxiao3', 'hlee156', 'posso.mario', 'henry.ko.94', 'truszko1993', 'ece340', 'jacklee3', 'laura_b_galbraith', 'li160', 'joshuaphua1', 'tong.yin.1', 'liupufan', 'toujours.meiling93', 'jdlenz', 'charlie.dreebin', 'austin.martinovich', 'yzhao60', 'sangyuno0o', 'darksnape', 'hnrcksn2', 'greerdavidc', 'uber12', 'benck', 'peihan0807', None, 'dsolanki', 'fwirjo', 'studpuffin', 'billstan42', 'kurmanba1', 'bryniar2', 'tiffyye', 'ece34', 'kkong7', 'josh.barrett.589']",125,"['mysonu', 'mpalmer2', 'ssheik22', 'rps233', 'haunlliam', 'ph0606', 'danzuo', 'sariel12345', 'chris.reinke.16', 'amencherla2401', 'eric.groeteke', 'sahn15', 'kornholi', 'png4', 'chaken2', 'rxiao3', 'michael.diehl.583', 'tatanve', 'laura_b_galbraith', 'nemitz22', 'mithun.manivannan', 'jtomaras', 'greerdavidc', 'dyangsteven', 'rstang2', 'kpsrini2', 'tobrien7', 'djiang7', 'bryniar2', 'ece34', 'kkong7', 'ujrav', 'jterwil2', 'quantumseren', 'aarti.shah147', 'david.boucard', 'yumin2', 'yu91', 'edennis3', 'kluhrsen', 'yoo66', 'bomcdon2', 'ks.lamb14', 'eclee2', 'allen412068', 'raghavkochhar9', 'zhenqin3', 'hlee156', 'wang217', 'li160', 'jdlenz', 'xinding33', 'austin.martinovich', 'rahful', 'uber12', 'benck', 'fwirjo', 'studpuffin', 'ndecraene', 'kurmanba1', 'pescenck', 'josh.barrett.589', 'pbhatta2', 'jack.arendt', 'julia.labelle2', 'iliveincoto5464', 'michael370662', 'themightybaloon88', 'aromeo', 'mikra616', 'dhansel036', 'jdurant2', 'hmtaylo2', 'cooldaehee', 'jzhu34', 'kaalvar2', 'sligh3ece', 'meng325', 'alex.mitsdarfer', 'posso.mario', 'tapeter2', 'jmxscrs', 'bkesler', 'joshuaphua1', 'henryahn', 'yzhao60', 'sangyuno0o', 'sarielqjl', 'yk.karwal', 'peihan0807', 'coolkat677', 'zlc31993', 'dsolanki', 'chien8', 'tiffyye', 'billstan42', 'kknom1', 'tim.sutyak', 'syed.mohsin.311', 'christu2', 'lee117', 'xiongfei.ding', 'george.s9999', 'miller7', 'henry.ko.94', 'mikeyling18', 'truszko1993', 'ece340', 'kumikknd', 'jacklee3', 'grandcn4', 'liupufan', 'toujours.meiling93', 'charlie.dreebin', 'mattsucich', 'darksnape', 'au.chinprutthiwong', 'dan5664', 'hnrcksn2', 'jzhu46', 'beholla2', 'molly.pace93', None, 'piyayott', 'tong.yin.1']"
10,185,50,46,2,"['david.boucard', 'syed.mohsin.311']",47,"['julia.labelle2', 'tim.sutyak', 'michael370662', 'themightybaloon88', 'mysonu', 'haunlliam', 'xiongfei.ding', 'danzuo', 'miller7', 'yoo66', 'cooldaehee', 'amencherla2401', 'mikeyling18', 'sahn15', 'tapeter2', 'tatanve', 'michael.diehl.583', 'kumikknd', 'jmxscrs', 'bkesler', 'grandcn4', 'wang217', 'nemitz22', 'henryahn', 'mithun.manivannan', 'xinding33', 'mattsucich', 'rahful', 'au.chinprutthiwong', 'dan5664', 'jzhu46', 'jtomaras', 'beholla2', 'sarielqjl', 'molly.pace93', 'yk.karwal', 'coolkat677', 'dyangsteven', 'rstang2', 'zlc31993', 'kpsrini2', 'chien8', 'tobrien7', 'djiang7', 'ndecraene', 'piyayott', 'pescenck']",44,"['serena.shahsimpson', 'smohsin16', 'saleil.bhat', 'ka2531', 'de2313', 'csyolen', 'yangyx', 'steev16', 'jessicazhao', 'gkewley87', 'cedricmayer', 'tonid', 'houseoflastwords', 'nikoala3', 'neilorzechowski', 'zhenghao', 'giovanna.silvateixeira', 'hekle', 'dmarsed18', 'johnkym', 'jjw2170', 'nazlituncer94', 'ajorquera', 'lfv2108', 'shen92', 'jy2537', 'benthezhu', 'jmd2251', None, 'antonio_soild_state', 'gayathriraj', 'jeffrey11366', 'nilespaulthethird', 'ndg2119', 'af2791', 'shenyz', 'frostgyt', 'rsv2111', 'wuyi0623', 'dms2264', 'harrisonliew', 'dps2144', 'gmackcrane', 'aji2112']",93,"['julia.labelle2', 'michael370662', 'themightybaloon88', 'mysonu', 'de2313', 'yangyx', 'steev16', 'haunlliam', 'gkewley87', 'danzuo', 'cooldaehee', 'amencherla2401', 'houseoflastwords', 'sahn15', 'tapeter2', 'neilorzechowski', 'michael.diehl.583', 'tatanve', 'dmarsed18', 'zhenghao', 'hekle', 'jmxscrs', 'bkesler', 'nemitz22', 'henryahn', 'mithun.manivannan', 'shen92', 'jtomaras', 'jy2537', 'sarielqjl', 'yk.karwal', 'coolkat677', 'dyangsteven', 'rstang2', 'zlc31993', 'jeffrey11366', 'kpsrini2', 'chien8', 'wuyi0623', 'tobrien7', 'djiang7', 'dps2144', 'aji2112', 'serena.shahsimpson', 'smohsin16', 'tim.sutyak', 'saleil.bhat', 'ka2531', 'syed.mohsin.311', 'csyolen', 'david.boucard', 'jessicazhao', 'xiongfei.ding', 'miller7', 'yoo66', 'cedricmayer', 'tonid', 'mikeyling18', 'nikoala3', 'kumikknd', 'giovanna.silvateixeira', 'grandcn4', 'wang217', 'johnkym', 'jjw2170', 'xinding33', 'mattsucich', 'rahful', 'nazlituncer94', 'au.chinprutthiwong', 'dan5664', 'ajorquera', 'jzhu46', 'lfv2108', 'benthezhu', 'beholla2', 'molly.pace93', 'jmd2251', None, 'antonio_soild_state', 'gayathriraj', 'nilespaulthethird', 'ndg2119', 'af2791', 'shenyz', 'frostgyt', 'rsv2111', 'dms2264', 'harrisonliew', 'gmackcrane', 'ndecraene', 'piyayott', 'pescenck']"
10,187,50,11,3,"['themightybaloon88', 'chien8', 'sahn15']",46,"['julia.labelle2', 'tim.sutyak', 'michael370662', 'syed.mohsin.311', 'mysonu', 'david.boucard', 'haunlliam', 'xiongfei.ding', 'danzuo', 'miller7', 'cooldaehee', 'yoo66', 'amencherla2401', 'mikeyling18', 'tapeter2', 'michael.diehl.583', 'tatanve', 'kumikknd', 'jmxscrs', 'bkesler', 'grandcn4', 'wang217', 'nemitz22', 'henryahn', 'mithun.manivannan', 'xinding33', 'mattsucich', 'rahful', 'au.chinprutthiwong', 'dan5664', 'jzhu46', 'jtomaras', 'beholla2', 'sarielqjl', 'molly.pace93', 'yk.karwal', 'coolkat677', 'dyangsteven', 'rstang2', 'zlc31993', 'kpsrini2', 'tobrien7', 'djiang7', 'ndecraene', 'piyayott', 'pescenck']",8,"['flie2illinois', 'de2313', 'wchi2', 'rxiao3', 'qhu12', 'edennis3', None, 'stps']",57,"['julia.labelle2', 'tim.sutyak', 'flie2illinois', 'michael370662', 'themightybaloon88', 'syed.mohsin.311', 'mysonu', 'de2313', 'david.boucard', 'haunlliam', 'qhu12', 'edennis3', 'xiongfei.ding', 'danzuo', 'miller7', 'cooldaehee', 'yoo66', 'amencherla2401', 'mikeyling18', 'sahn15', 'tapeter2', 'rxiao3', 'michael.diehl.583', 'tatanve', 'kumikknd', 'jmxscrs', 'bkesler', 'grandcn4', 'wang217', 'nemitz22', 'henryahn', 'mithun.manivannan', 'xinding33', 'mattsucich', 'rahful', 'au.chinprutthiwong', 'dan5664', 'jzhu46', 'jtomaras', 'wchi2', 'beholla2', 'sarielqjl', 'molly.pace93', 'yk.karwal', None, 'coolkat677', 'dyangsteven', 'rstang2', 'zlc31993', 'kpsrini2', 'chien8', 'tobrien7', 'djiang7', 'ndecraene', 'piyayott', 'pescenck', 'stps']"
10,188,50,11,3,"['nemitz22', 'amencherla2401', 'rahful']",46,"['julia.labelle2', 'tim.sutyak', 'michael370662', 'themightybaloon88', 'syed.mohsin.311', 'mysonu', 'david.boucard', 'haunlliam', 'xiongfei.ding', 'danzuo', 'miller7', 'cooldaehee', 'yoo66', 'mikeyling18', 'sahn15', 'tapeter2', 'michael.diehl.583', 'tatanve', 'kumikknd', 'jmxscrs', 'bkesler', 'grandcn4', 'wang217', 'henryahn', 'mithun.manivannan', 'xinding33', 'mattsucich', 'au.chinprutthiwong', 'dan5664', 'jzhu46', 'jtomaras', 'beholla2', 'sarielqjl', 'molly.pace93', 'yk.karwal', 'coolkat677', 'dyangsteven', 'rstang2', 'zlc31993', 'kpsrini2', 'chien8', 'tobrien7', 'djiang7', 'ndecraene', 'piyayott', 'pescenck']",8,"['yhren1993', 'alex.mitsdarfer', 'ssheik22', 'abheshek18', 'chaken2', 'chen.s.jimmy', 'lee117', None]",57,"['julia.labelle2', 'tim.sutyak', 'yhren1993', 'michael370662', 'themightybaloon88', 'syed.mohsin.311', 'mysonu', 'ssheik22', 'david.boucard', 'haunlliam', 'lee117', 'xiongfei.ding', 'danzuo', 'miller7', 'cooldaehee', 'yoo66', 'amencherla2401', 'alex.mitsdarfer', 'mikeyling18', 'sahn15', 'tapeter2', 'chaken2', 'michael.diehl.583', 'tatanve', 'kumikknd', 'jmxscrs', 'bkesler', 'grandcn4', 'wang217', 'nemitz22', 'henryahn', 'mithun.manivannan', 'xinding33', 'mattsucich', 'rahful', 'au.chinprutthiwong', 'dan5664', 'jzhu46', 'jtomaras', 'abheshek18', 'beholla2', 'chen.s.jimmy', 'sarielqjl', 'molly.pace93', 'yk.karwal', None, 'coolkat677', 'dyangsteven', 'rstang2', 'zlc31993', 'kpsrini2', 'chien8', 'tobrien7', 'djiang7', 'ndecraene', 'piyayott', 'pescenck']"
11,143,44,80,38,"['jwang124', 'kemehan', 'angela525huangjj', 'hylin2', 'btkern2', 'akatsulis', 'cory93', 'adsnyde2', 'qazyyc93', 'nickpalcheck', 'jcjc2222', 'arjun.balwally', 'mingxu3', 'siyima2', 'xnypr', 'yyang10', 'jjacksn', 'jos26coh', 'litton2', 'cljohnson0', 'allysonv10', 'salman2', 'qyang13', 'shalper2', 'sage', 'kathyzhou0124', 'bhanley2', 'crichrd2', 'bcclanc2', 'jwang182', 'isaacehoffman', 'achoi121', 'limsiri2', 'abaddon2mist', 'jinpengzhuo', 'sguo1', 'npalcheck', 'scpiper2']",5,"['akpolfein', 'dtrinkle', 'zzkobezz', 'alxtrck', 'haohanyuzhou']",42,"['xli121', 'klwells2', 'stakek2', 'limberg2', 'jinpeng.zhuo', 'lolipopcarolwang', 'simpkns2', 'gvelard2edu', 'akagti2', 'hmtaylo2', 'siyi.xu.180', 'hsheng3', 'bomcdon2', 'schiavo1', 'junpeng.qiu', 'dtascone92', 'qiujiezhao1994', 'trick2', 'dagapit2', 'dkwok2', 'toglitt2', 'cledesma2331', 'ramaiah2', 'ahli2', 'jwsmith6', 'fang.the.tall', 'jmmille6', 'rflore24', None, 'kfeng', 'aamurthy', 'palchec2', 'tara.cullerton', 'csbaile2', 'cx1048539626', 'alexkim3', 'elin11', 'bcc4994', 'gargula2', 'danieldli1993', 'pbhatta2', 'eslee5']",85,"['xli121', 'jinpeng.zhuo', 'kemehan', 'angela525huangjj', 'btkern2', 'akatsulis', 'haohanyuzhou', 'simpkns2', 'gvelard2edu', 'akagti2', 'hmtaylo2', 'siyi.xu.180', 'hsheng3', 'adsnyde2', 'qazyyc93', 'jcjc2222', 'xnypr', 'dtascone92', 'jos26coh', 'litton2', 'trick2', 'salman2', 'qyang13', 'cledesma2331', 'jwsmith6', 'sage', 'jmmille6', 'kathyzhou0124', 'crichrd2', 'csbaile2', 'palchec2', 'tara.cullerton', 'achoi121', 'limsiri2', 'alexkim3', 'abaddon2mist', 'sguo1', 'bcc4994', 'npalcheck', 'elin11', 'scpiper2', 'gargula2', 'klwells2', 'jwang124', 'stakek2', 'limberg2', 'dtrinkle', 'hylin2', 'lolipopcarolwang', 'cory93', 'bomcdon2', 'schiavo1', 'nickpalcheck', 'arjun.balwally', 'mingxu3', 'siyima2', 'junpeng.qiu', 'yyang10', 'jjacksn', 'qiujiezhao1994', 'akpolfein', 'cljohnson0', 'allysonv10', 'dagapit2', 'dkwok2', 'toglitt2', 'shalper2', 'ahli2', 'ramaiah2', 'fang.the.tall', 'rflore24', 'bhanley2', None, 'bcclanc2', 'jwang182', 'kfeng', 'isaacehoffman', 'aamurthy', 'cx1048539626', 'zzkobezz', 'jinpengzhuo', 'danieldli1993', 'alxtrck', 'pbhatta2', 'eslee5']"
12,165,42,59,4,"['zengks', 'dmfrey3', 'dougchung8', 'brad.macneil5']",37,"['jbaeza915', 'jkosal', 'r96524074', 'chakir', 'luisrrodriguez', 'janaki23995', 'abel.a.mendez', 'saracec', 'zkokz', 'luisanthony21', 'subha.on.the.run', 'wildwolf498', 'rnstpwll2', 'junknexus', 'jam_27', 'shrijitm10', 'hqasem', 'keith.alexanderpapa', 'joey11', 'mdangiolillo', 'fretman', 'harshpreet.singh.39', 'royaedalatpour', 'ealt1992', 'jmbuenoolague', 'richienagi', 'jgalindo362', 'neela2208', 'sv2340', 'dbecerra', 'pangracious', 'mxcom88', 'kflores9', 'jcsandoval2', 'niloyeee147', 'paytorr', 'beyondarrow']",55,"['tchntimothy', 'lujingwen1991', 'frayne.cameron', 'didacfc', 'kai.godfrey.50', 'marceloyuan', 'kleung13', 'shahbaj', 'tavisp', 'xanderbetts', 'sarahn162', 'plwilkie', 'haydenlinterman123', 'jtsnow', 'erictung', 'gabrielf89', 'esra.m.alhabshi', 'awebb94', 'g_dawg', '222alice', 'asdfg2443', 'kutkaan2014', 'olmeca.mcgillicuddy', 'earlierearlier', 'sherrie.wang.3', 'mr.liam.henderson', 'xiazhenzheng', 'yeezy', 'khaebler', 'bluu10b', 'albert.wong.1232', 'pnjunction', 'ajmis94', 'anonymous673', 'can.rozanes', 'edsondzhang', 'deterex', None, 'mackenzie.leung', 'max.prokopenko', 'wilson.to.18', 'charingchen', 'feefarfelufee', 'nicos', 'tim.tseng.47', 'benjamin.le.98', 'andre.clerc', 'jackiengame', 'daniel1', 'saoud', 'samuelngsh', 'echo3960', 'emmanak1', 'mxcmail', 'gelapes.gs']",96,"['lujingwen1991', 'jkosal', 'didacfc', 'kai.godfrey.50', 'marceloyuan', 'xanderbetts', 'erictung', 'luisanthony21', 'jtsnow', 'esra.m.alhabshi', 'awebb94', 'dougchung8', 'asdfg2443', 'subha.on.the.run', 'wildwolf498', 'olmeca.mcgillicuddy', 'rnstpwll2', 'earlierearlier', 'junknexus', 'jam_27', 'sherrie.wang.3', 'mr.liam.henderson', 'xiazhenzheng', 'hqasem', 'keith.alexanderpapa', 'yeezy', 'bluu10b', 'mdangiolillo', 'fretman', 'harshpreet.singh.39', 'ajmis94', 'anonymous673', 'richienagi', 'deterex', 'sv2340', 'brad.macneil5', 'dbecerra', 'pangracious', 'max.prokopenko', 'feefarfelufee', 'kflores9', 'niloyeee147', 'benjamin.le.98', 'andre.clerc', 'paytorr', 'jackiengame', 'daniel1', 'saoud', 'zengks', 'emmanak1', 'mxcmail', 'gelapes.gs', 'tchntimothy', 'jbaeza915', 'r96524074', 'chakir', 'frayne.cameron', 'luisrrodriguez', 'janaki23995', 'abel.a.mendez', 'kleung13', 'dmfrey3', 'saracec', 'tavisp', 'shahbaj', 'zkokz', 'sarahn162', 'plwilkie', 'haydenlinterman123', 'gabrielf89', 'g_dawg', 'kutkaan2014', '222alice', 'shrijitm10', 'joey11', 'khaebler', 'albert.wong.1232', 'pnjunction', 'royaedalatpour', 'ealt1992', 'jmbuenoolague', 'can.rozanes', 'edsondzhang', 'jgalindo362', None, 'mackenzie.leung', 'neela2208', 'wilson.to.18', 'charingchen', 'mxcom88', 'tim.tseng.47', 'jcsandoval2', 'samuelngsh', 'echo3960', 'beyondarrow', 'nicos']"
12,158,42,42,2,"['keith.alexanderpapa', 'sv2340']",39,"['jbaeza915', 'jkosal', 'r96524074', 'chakir', 'luisrrodriguez', 'janaki23995', 'abel.a.mendez', 'dmfrey3', 'saracec', 'zkokz', 'luisanthony21', 'dougchung8', 'subha.on.the.run', 'wildwolf498', 'rnstpwll2', 'junknexus', 'jam_27', 'shrijitm10', 'hqasem', 'joey11', 'mdangiolillo', 'fretman', 'harshpreet.singh.39', 'royaedalatpour', 'ealt1992', 'jmbuenoolague', 'richienagi', 'jgalindo362', 'neela2208', 'brad.macneil5', 'dbecerra', 'pangracious', 'mxcom88', 'kflores9', 'jcsandoval2', 'niloyeee147', 'paytorr', 'zengks', 'beyondarrow']",40,"['serena.shahsimpson', 'smohsin16', 'saleil.bhat', 'ka2531', 'de2313', 'csyolen', 'yangyx', 'steev16', 'jessicazhao', 'gkewley87', 'cedricmayer', 'tonid', 'houseoflastwords', 'nikoala3', 'neilorzechowski', 'giovanna.silvateixeira', 'dmarsed18', 'hekle', 'johnkym', 'jjw2170', 'ajorquera', 'lfv2108', 'shen92', 'jy2537', 'benthezhu', 'jmd2251', 'chf2117', None, 'antonio_soild_state', 'gayathriraj', 'nilespaulthethird', 'ndg2119', 'frostgyt', 'af2791', 'rsv2111', 'dms2264', 'harrisonliew', 'dps2144', 'gmackcrane', 'aji2112']",81,"['jkosal', 'de2313', 'yangyx', 'steev16', 'gkewley87', 'houseoflastwords', 'luisanthony21', 'dougchung8', 'subha.on.the.run', 'wildwolf498', 'neilorzechowski', 'rnstpwll2', 'dmarsed18', 'junknexus', 'jam_27', 'hekle', 'hqasem', 'keith.alexanderpapa', 'mdangiolillo', 'fretman', 'harshpreet.singh.39', 'shen92', 'jy2537', 'richienagi', 'sv2340', 'brad.macneil5', 'dbecerra', 'pangracious', 'kflores9', 'niloyeee147', 'paytorr', 'dps2144', 'zengks', 'aji2112', 'serena.shahsimpson', 'smohsin16', 'saleil.bhat', 'jbaeza915', 'r96524074', 'chakir', 'ka2531', 'csyolen', 'luisrrodriguez', 'janaki23995', 'abel.a.mendez', 'jessicazhao', 'dmfrey3', 'saracec', 'cedricmayer', 'zkokz', 'tonid', 'nikoala3', 'giovanna.silvateixeira', 'shrijitm10', 'joey11', 'johnkym', 'jjw2170', 'ajorquera', 'royaedalatpour', 'lfv2108', 'ealt1992', 'jmbuenoolague', 'benthezhu', 'jgalindo362', 'jmd2251', 'chf2117', None, 'neela2208', 'gayathriraj', 'antonio_soild_state', 'nilespaulthethird', 'ndg2119', 'mxcom88', 'frostgyt', 'af2791', 'jcsandoval2', 'rsv2111', 'dms2264', 'harrisonliew', 'beyondarrow', 'gmackcrane']"
12,159,42,17,15,"['dbecerra', 'joey11', 'kflores9', 'jbaeza915', 'jkosal', 'luisanthony21', 'jcsandoval2', 'royaedalatpour', 'jgalindo362', 'ealt1992', 'jmbuenoolague', 'wildwolf498', 'abel.a.mendez', 'rnstpwll2', 'junknexus']",26,"['r96524074', 'chakir', 'luisrrodriguez', 'janaki23995', 'dmfrey3', 'saracec', 'zkokz', 'dougchung8', 'subha.on.the.run', 'jam_27', 'shrijitm10', 'hqasem', 'keith.alexanderpapa', 'mdangiolillo', 'fretman', 'harshpreet.singh.39', 'richienagi', 'sv2340', 'neela2208', 'brad.macneil5', 'pangracious', 'mxcom88', 'niloyeee147', 'paytorr', 'zengks', 'beyondarrow']",2,"[None, 'samuellindsey08']",43,"['jbaeza915', 'jkosal', 'r96524074', 'chakir', 'samuellindsey08', 'luisrrodriguez', 'janaki23995', 'abel.a.mendez', 'dmfrey3', 'saracec', 'zkokz', 'luisanthony21', 'dougchung8', 'subha.on.the.run', 'wildwolf498', 'rnstpwll2', 'junknexus', 'jam_27', 'shrijitm10', 'hqasem', 'keith.alexanderpapa', 'joey11', 'mdangiolillo', 'fretman', 'harshpreet.singh.39', 'royaedalatpour', 'ealt1992', 'jmbuenoolague', 'richienagi', 'jgalindo362', None, 'neela2208', 'sv2340', 'dbecerra', 'brad.macneil5', 'pangracious', 'mxcom88', 'kflores9', 'jcsandoval2', 'niloyeee147', 'paytorr', 'zengks', 'beyondarrow']"
12,160,42,7,3,"['subha.on.the.run', 'neela2208', 'mdangiolillo']",38,"['jbaeza915', 'jkosal', 'r96524074', 'chakir', 'luisrrodriguez', 'janaki23995', 'abel.a.mendez', 'dmfrey3', 'saracec', 'zkokz', 'luisanthony21', 'dougchung8', 'wildwolf498', 'rnstpwll2', 'junknexus', 'jam_27', 'shrijitm10', 'hqasem', 'keith.alexanderpapa', 'joey11', 'fretman', 'harshpreet.singh.39', 'royaedalatpour', 'ealt1992', 'jmbuenoolague', 'richienagi', 'jgalindo362', 'sv2340', 'dbecerra', 'brad.macneil5', 'pangracious', 'mxcom88', 'kflores9', 'jcsandoval2', 'niloyeee147', 'paytorr', 'zengks', 'beyondarrow']",4,"['hardik1004', 'cdn27', None, 'sb1126']",45,"['jbaeza915', 'jkosal', 'r96524074', 'chakir', 'luisrrodriguez', 'janaki23995', 'abel.a.mendez', 'dmfrey3', 'saracec', 'zkokz', 'luisanthony21', 'dougchung8', 'sb1126', 'subha.on.the.run', 'wildwolf498', 'rnstpwll2', 'junknexus', 'jam_27', 'shrijitm10', 'hqasem', 'keith.alexanderpapa', 'joey11', 'mdangiolillo', 'fretman', 'harshpreet.singh.39', 'royaedalatpour', 'ealt1992', 'jmbuenoolague', 'cdn27', 'richienagi', 'jgalindo362', None, 'neela2208', 'sv2340', 'dbecerra', 'brad.macneil5', 'pangracious', 'hardik1004', 'mxcom88', 'kflores9', 'jcsandoval2', 'niloyeee147', 'paytorr', 'zengks', 'beyondarrow']"
13,225,41,153,37,"['jingjingshi', 'hvr', 'dweber1', 'jacks311', 'taeho81909', 'skkzlj7', 'darshanpala', 'ebusquet', 'aodubitsky', 'zhan1457', 'nrsyed', 'amcbain', 'wang945', 'nguyenct', 'cyamamot', 'borgesebastiao', 'ybommire', 'mbrindise', 'eshaanmathew', 'zharman', 'ksaviers', 'ajey.091', 'scalvert', 'jeong4', 'rosscarnahan', 'eddiewhite1', 'hkoval', 'thomp340', 'ecamaren', 'zqingzi', 'abahman', 'fpena', 'agarwa80', 'vgoutham', 'alegomez544', 'harshnisar', 'alo08864']",3,"['okravche', 'drupad', 'mcarthur']",116,"['evans260', 'jgeng', 'sunxingshu', 'maassenj1', 'mramazan', 'saima', 'hctest5', 'schiotz', 'kevyblock', 'sganguly', 'amrshahat', 'zhan1337', 'gonza226', 'sobh1', 'lalzatev', 'shubham.singh091', 'clarksm', 'caduartec', 'kmargata', 'volkswind', 'rajugupta', 'sallu', 'weiyiwang', 'dkearney', 'ldelgass', 'dchaffee', 'cshang', 'xu716', 'sarath_ramadurgam', 'pmeunier', 'akanti', 'cao42', 'nonofrio', 'turkstra', 'poojanshah99', 'dalemus', 'hsun.chao', 'bss12', 'aghimire00', 'vladiakhnine', 'wenye1213', 'chandrar88', 'kuntalroy', 'jiashenghui2014', 'goudarz2', 'lee1281', 'davgumo', 'crvantas', 'hamed0', 'mathur7', 'browne3', 'sissichen0322', 'douzengyi1528', 'ovi_1000', 'gah', 'wang159', 'valencid', 'nrajpurk', 'wendyq', 'kevin60105', 'chinyi', 'sobh1_2', 'hrs353', 'light2', 'mmc', 'gandhi10', 'cao54', 'h.chenchu', 'denphi', 'mhollars', 'samikm', 'ghowlett', 'jorgem93', 'jscher1', 'nkharche', 'kfezi', 'bmsutton', 'abarat', 'apps', 'sreeve', 'hctest4', 'jdbermeol', 'atankas', 'mmh', 'nkissebe', 'wangyide92', 'ndaman', 'tkriegel', 'barasaadah', 'ontarugera', 'hctest3', 'yang62', 'sun73', 'rrx1992', 'bhaley', 'hojin92', 'tjhacker', 'dunn45', 'woodswims', 'prasadsarang', 'kim1797', 'ksnvikrant', 'jsudibyo', 'ishan66', 'jin52', 'vdiep', 'karim1986', 'lu216', 'gf.giraldo239', 'msalmani', 'jpalsdot', 'schcats', 'swoop', 'ashishod', 'marisol', 'chuyuanchen']",156,"['jingjingshi', 'evans260', 'jgeng', 'hvr', 'sunxingshu', 'maassenj1', 'mramazan', 'saima', 'hctest5', 'schiotz', 'kevyblock', 'sganguly', 'amrshahat', 'zhan1337', 'gonza226', 'sobh1', 'nrsyed', 'lalzatev', 'shubham.singh091', 'borgesebastiao', 'clarksm', 'eshaanmathew', 'kmargata', 'caduartec', 'volkswind', 'rajugupta', 'jeong4', 'sallu', 'weiyiwang', 'dkearney', 'ldelgass', 'fpena', 'dchaffee', 'agarwa80', 'cshang', 'xu716', 'mcarthur', 'sarath_ramadurgam', 'pmeunier', 'alo08864', 'akanti', 'drupad', 'cao42', 'nonofrio', 'jacks311', 'turkstra', 'poojanshah99', 'skkzlj7', 'dalemus', 'hsun.chao', 'aodubitsky', 'zhan1457', 'bss12', 'aghimire00', 'vladiakhnine', 'nguyenct', 'wenye1213', 'cyamamot', 'chandrar88', 'kuntalroy', 'jiashenghui2014', 'zharman', 'goudarz2', 'lee1281', 'scalvert', 'okravche', 'rosscarnahan', 'davgumo', 'crvantas', 'hamed0', 'mathur7', 'zqingzi', 'browne3', 'sissichen0322', 'douzengyi1528', 'ovi_1000', 'gah', 'wang159', 'valencid', 'nrajpurk', 'wendyq', 'kevin60105', 'chinyi', 'sobh1_2', 'hrs353', 'light2', 'mmc', 'ebusquet', 'gandhi10', 'cao54', 'h.chenchu', 'denphi', 'mhollars', 'samikm', 'ghowlett', 'jorgem93', 'ybommire', 'jscher1', 'ksaviers', 'nkharche', 'ajey.091', 'kfezi', 'eddiewhite1', 'bmsutton', 'abarat', 'hkoval', 'thomp340', 'apps', 'sreeve', 'vgoutham', 'hctest4', 'jdbermeol', 'atankas', 'harshnisar', 'mmh', 'nkissebe', 'wangyide92', 'ndaman', 'tkriegel', 'dweber1', 'barasaadah', 'ontarugera', 'taeho81909', 'hctest3', 'yang62', 'darshanpala', 'sun73', 'rrx1992', 'bhaley', 'hojin92', 'amcbain', 'wang945', 'tjhacker', 'dunn45', 'woodswims', 'prasadsarang', 'mbrindise', 'kim1797', 'ksnvikrant', 'jsudibyo', 'ishan66', 'jin52', 'vdiep', 'karim1986', 'lu216', 'gf.giraldo239', 'msalmani', 'jpalsdot', 'ecamaren', 'schcats', 'swoop', 'abahman', 'ashishod', 'alegomez544', 'marisol', 'chuyuanchen']"
13,229,41,20,5,"['eshaanmathew', 'abahman', 'nrsyed', 'harshnisar', 'hkoval']",35,"['jingjingshi', 'drupad', 'hvr', 'dweber1', 'jacks311', 'taeho81909', 'skkzlj7', 'darshanpala', 'ebusquet', 'aodubitsky', 'zhan1457', 'amcbain', 'wang945', 'nguyenct', 'cyamamot', 'borgesebastiao', 'ybommire', 'mbrindise', 'zharman', 'ksaviers', 'ajey.091', 'scalvert', 'jeong4', 'okravche', 'rosscarnahan', 'eddiewhite1', 'thomp340', 'ecamaren', 'zqingzi', 'fpena', 'agarwa80', 'vgoutham', 'alegomez544', 'mcarthur', 'alo08864']",15,"['hsun.chao', 'dunn45', 'caduartec', 'goudarz2', 'sreeve', 'keshav.amburay', 'nonofrio', 'lee1281', 'douzengyi1528', 'shubham.singh091', 'aghimire00', 'karim1986', 'livingston.cv', None, 'kibech']",55,"['jingjingshi', 'drupad', 'hvr', 'keshav.amburay', 'nonofrio', 'dweber1', 'jacks311', 'livingston.cv', 'taeho81909', 'skkzlj7', 'kibech', 'darshanpala', 'hsun.chao', 'ebusquet', 'aodubitsky', 'zhan1457', 'nrsyed', 'shubham.singh091', 'aghimire00', 'amcbain', 'wang945', 'nguyenct', 'cyamamot', 'borgesebastiao', 'dunn45', 'ybommire', 'mbrindise', 'eshaanmathew', 'caduartec', 'zharman', 'ksaviers', 'goudarz2', 'ajey.091', 'lee1281', 'scalvert', 'jeong4', 'okravche', 'rosscarnahan', 'eddiewhite1', 'karim1986', 'hkoval', None, 'thomp340', 'ecamaren', 'zqingzi', 'abahman', 'fpena', 'sreeve', 'douzengyi1528', 'agarwa80', 'vgoutham', 'alegomez544', 'mcarthur', 'harshnisar', 'alo08864']"
13,231,41,9,6,"['aodubitsky', 'agarwa80', 'eddiewhite1', 'mcarthur', 'alo08864', 'ecamaren']",34,"['jingjingshi', 'drupad', 'hvr', 'dweber1', 'jacks311', 'taeho81909', 'skkzlj7', 'darshanpala', 'ebusquet', 'zhan1457', 'nrsyed', 'amcbain', 'wang945', 'nguyenct', 'cyamamot', 'borgesebastiao', 'ybommire', 'mbrindise', 'eshaanmathew', 'zharman', 'ksaviers', 'ajey.091', 'scalvert', 'jeong4', 'okravche', 'rosscarnahan', 'hkoval', 'thomp340', 'zqingzi', 'abahman', 'fpena', 'vgoutham', 'alegomez544', 'harshnisar']",3,"['cshang', None, 'carbaker']",43,"['jingjingshi', 'drupad', 'hvr', 'dweber1', 'jacks311', 'taeho81909', 'skkzlj7', 'darshanpala', 'ebusquet', 'aodubitsky', 'zhan1457', 'carbaker', 'nrsyed', 'amcbain', 'wang945', 'nguyenct', 'cyamamot', 'borgesebastiao', 'ybommire', 'mbrindise', 'eshaanmathew', 'zharman', 'ksaviers', 'ajey.091', 'scalvert', 'jeong4', 'okravche', 'rosscarnahan', 'eddiewhite1', 'hkoval', None, 'thomp340', 'ecamaren', 'zqingzi', 'abahman', 'fpena', 'agarwa80', 'vgoutham', 'alegomez544', 'cshang', 'mcarthur', 'harshnisar', 'alo08864']"
13,230,41,6,4,"['eddiewhite1', 'aodubitsky', 'alo08864', 'ecamaren']",36,"['jingjingshi', 'drupad', 'hvr', 'dweber1', 'jacks311', 'taeho81909', 'skkzlj7', 'darshanpala', 'ebusquet', 'zhan1457', 'nrsyed', 'amcbain', 'wang945', 'nguyenct', 'cyamamot', 'borgesebastiao', 'ybommire', 'mbrindise', 'eshaanmathew', 'zharman', 'ksaviers', 'ajey.091', 'scalvert', 'jeong4', 'okravche', 'rosscarnahan', 'hkoval', 'thomp340', 'zqingzi', 'abahman', 'fpena', 'agarwa80', 'vgoutham', 'alegomez544', 'mcarthur', 'harshnisar']",2,"['cshang', None]",42,"['jingjingshi', 'drupad', 'hvr', 'dweber1', 'jacks311', 'taeho81909', 'skkzlj7', 'darshanpala', 'ebusquet', 'aodubitsky', 'zhan1457', 'nrsyed', 'amcbain', 'wang945', 'nguyenct', 'cyamamot', 'borgesebastiao', 'ybommire', 'mbrindise', 'eshaanmathew', 'zharman', 'ksaviers', 'ajey.091', 'scalvert', 'jeong4', 'okravche', 'rosscarnahan', 'eddiewhite1', 'hkoval', None, 'thomp340', 'ecamaren', 'zqingzi', 'abahman', 'fpena', 'agarwa80', 'vgoutham', 'alegomez544', 'cshang', 'mcarthur', 'harshnisar', 'alo08864']"
14,33,41,23,8,"['baoxun1', 'sbatchu1', 'salman.manzoor', 'balabanmb', 'doublefan', 'mpreynos', 'harshadsurdi', 'mpreynos1']",32,"['swethasmenon', 'pradeep1450', 'swapnildabade70', 'ajitaneogi', 'shivangi30', 'durgesh123', 'hasanraza', 'swathimnt0049', 'ank', 'arazavie', 'vishnusasi', 'surender', 'venu652', 'karthick30', 'rafikul', 'narayanamh123', 'ashishjwk', 'bishakha1606', 'mjayara3', 'balacool', 'abipriyan3', 'nehavr25', 'sabby1611', 'bharathi19', 'nrredd00', 'shyampadhi2', 'joseph207', 'kartik1', 'suresh047', 'sunny.patel361', 'astjraj', 'atulverma1992']",15,"['hongya', 'ramnraop', 'monicareynoso', 'jianyi.gao.1', 'adar1312', 'sapman', None, 'pfirth', 'treblitz', 'ththomp2', 'akdeshpa', 'pkoswatt', 'maitreyadutta', 'surisuraj', 'jaspreety86']",55,"['swethasmenon', 'baoxun1', 'pradeep1450', 'swapnildabade70', 'balabanmb', 'ajitaneogi', 'adar1312', 'sunny.patel361', 'shivangi30', 'astjraj', 'durgesh123', 'mpreynos1', 'jaspreety86', 'swathimnt0049', 'ank', 'arazavie', 'vishnusasi', 'surender', 'doublefan', 'venu652', 'karthick30', 'sbatchu1', 'rafikul', 'jianyi.gao.1', 'narayanamh123', 'ashishjwk', 'salman.manzoor', 'monicareynoso', 'bishakha1606', 'mjayara3', 'akdeshpa', 'pkoswatt', 'balacool', 'abipriyan3', 'nehavr25', 'mpreynos', 'harshadsurdi', 'maitreyadutta', 'bharathi19', 'nrredd00', None, 'hongya', 'ramnraop', 'shyampadhi2', 'joseph207', 'kartik1', 'sapman', 'pfirth', 'treblitz', 'ththomp2', 'suresh047', 'surisuraj', 'sabby1611', 'hasanraza', 'atulverma1992']"
14,27,41,21,10,"['swethasmenon', 'sabby1611', 'ajitaneogi', 'bishakha1606', 'shivangi30', 'balacool', 'nehavr25', 'durgesh123', 'astjraj', 'atulverma1992']",30,"['baoxun1', 'pradeep1450', 'swapnildabade70', 'balabanmb', 'mpreynos1', 'swathimnt0049', 'ank', 'arazavie', 'vishnusasi', 'surender', 'doublefan', 'venu652', 'karthick30', 'sbatchu1', 'rafikul', 'narayanamh123', 'ashishjwk', 'salman.manzoor', 'mjayara3', 'abipriyan3', 'mpreynos', 'harshadsurdi', 'bharathi19', 'nrredd00', 'shyampadhi2', 'joseph207', 'kartik1', 'suresh047', 'sunny.patel361', 'hasanraza']",11,"['jyothichandran111', 'athirasudarsananv', 's.divyalakshmi', None, 'debika26', 'avvaruvenkat225', 'giriedusport', 'apurva3007', 'visheshmk', 'ram14mnt007', 'garimadang']",51,"['swethasmenon', 'baoxun1', 'pradeep1450', 'swapnildabade70', 'balabanmb', 'ajitaneogi', 'sunny.patel361', 'shivangi30', 'astjraj', 'durgesh123', 'mpreynos1', 'swathimnt0049', 'ank', 'arazavie', 'vishnusasi', 'surender', 'doublefan', 'giriedusport', 'venu652', 'karthick30', 'ram14mnt007', 'garimadang', 'sbatchu1', 'rafikul', 'jyothichandran111', 'narayanamh123', 'ashishjwk', 'salman.manzoor', 'athirasudarsananv', 's.divyalakshmi', 'avvaruvenkat225', 'bishakha1606', 'mjayara3', 'apurva3007', 'balacool', 'abipriyan3', 'nehavr25', 'mpreynos', 'harshadsurdi', 'visheshmk', 'bharathi19', 'nrredd00', None, 'shyampadhi2', 'joseph207', 'kartik1', 'debika26', 'suresh047', 'sabby1611', 'hasanraza', 'atulverma1992']"
14,28,41,21,10,"['swethasmenon', 'sabby1611', 'ajitaneogi', 'bishakha1606', 'shivangi30', 'balacool', 'nehavr25', 'durgesh123', 'astjraj', 'atulverma1992']",30,"['baoxun1', 'pradeep1450', 'swapnildabade70', 'balabanmb', 'mpreynos1', 'swathimnt0049', 'ank', 'arazavie', 'vishnusasi', 'surender', 'doublefan', 'venu652', 'karthick30', 'sbatchu1', 'rafikul', 'narayanamh123', 'ashishjwk', 'salman.manzoor', 'mjayara3', 'abipriyan3', 'mpreynos', 'harshadsurdi', 'bharathi19', 'nrredd00', 'shyampadhi2', 'joseph207', 'kartik1', 'suresh047', 'sunny.patel361', 'hasanraza']",11,"['jyothichandran111', 's.divyalakshmi', None, 'debika26', 'avvaruvenkat225', 'giriedusport', 'apurva3007', 'visheshmk', 'shruthivs', 'ram14mnt007', 'garimadang']",51,"['swethasmenon', 'baoxun1', 'pradeep1450', 'swapnildabade70', 'balabanmb', 'ajitaneogi', 'sunny.patel361', 'shivangi30', 'astjraj', 'durgesh123', 'mpreynos1', 'swathimnt0049', 'ank', 'arazavie', 'vishnusasi', 'surender', 'doublefan', 'giriedusport', 'venu652', 'karthick30', 'ram14mnt007', 'garimadang', 'sbatchu1', 'rafikul', 'jyothichandran111', 'narayanamh123', 'ashishjwk', 'salman.manzoor', 's.divyalakshmi', 'avvaruvenkat225', 'bishakha1606', 'mjayara3', 'apurva3007', 'balacool', 'abipriyan3', 'nehavr25', 'mpreynos', 'harshadsurdi', 'visheshmk', 'bharathi19', 'nrredd00', None, 'shyampadhi2', 'joseph207', 'kartik1', 'debika26', 'suresh047', 'sabby1611', 'hasanraza', 'shruthivs', 'atulverma1992']"
14,30,41,21,10,"['swethasmenon', 'rafikul', 'ank', 'sunny.patel361', 'balacool', 'abipriyan3', 'bharathi19', 'suresh047', 'hasanraza', 'karthick30']",30,"['baoxun1', 'pradeep1450', 'swapnildabade70', 'balabanmb', 'ajitaneogi', 'shivangi30', 'durgesh123', 'mpreynos1', 'swathimnt0049', 'surender', 'arazavie', 'vishnusasi', 'doublefan', 'venu652', 'sbatchu1', 'narayanamh123', 'ashishjwk', 'salman.manzoor', 'bishakha1606', 'mjayara3', 'nehavr25', 'mpreynos', 'harshadsurdi', 'nrredd00', 'shyampadhi2', 'joseph207', 'kartik1', 'sabby1611', 'astjraj', 'atulverma1992']",11,"['kommanaveen51', 'ravitejasolleti', 'mytheeswaran001', 'rhera312', 'avvaruvenkat225', 'esathiyacnr', 'vasi2013nano', 'saiekhnath', 'nithya0038', 'riyadavis', None]",51,"['kommanaveen51', 'swethasmenon', 'baoxun1', 'pradeep1450', 'swapnildabade70', 'balabanmb', 'ajitaneogi', 'sunny.patel361', 'shivangi30', 'astjraj', 'durgesh123', 'mpreynos1', 'swathimnt0049', 'ank', 'arazavie', 'vishnusasi', 'surender', 'mytheeswaran001', 'doublefan', 'saiekhnath', 'venu652', 'karthick30', 'ravitejasolleti', 'sbatchu1', 'rafikul', 'narayanamh123', 'ashishjwk', 'salman.manzoor', 'avvaruvenkat225', 'bishakha1606', 'mjayara3', 'esathiyacnr', 'balacool', 'abipriyan3', 'nehavr25', 'mpreynos', 'harshadsurdi', 'nithya0038', 'bharathi19', 'nrredd00', None, 'shyampadhi2', 'rhera312', 'joseph207', 'kartik1', 'vasi2013nano', 'suresh047', 'sabby1611', 'hasanraza', 'riyadavis', 'atulverma1992']"
14,31,41,19,7,"['swathimnt0049', 'vishnusasi', 'narayanamh123', 'pradeep1450', 'swapnildabade70', 'joseph207', 'kartik1']",33,"['swethasmenon', 'baoxun1', 'balabanmb', 'ajitaneogi', 'shivangi30', 'durgesh123', 'hasanraza', 'mpreynos1', 'ank', 'arazavie', 'surender', 'doublefan', 'venu652', 'karthick30', 'sbatchu1', 'rafikul', 'ashishjwk', 'salman.manzoor', 'bishakha1606', 'mjayara3', 'balacool', 'abipriyan3', 'nehavr25', 'mpreynos', 'harshadsurdi', 'sabby1611', 'bharathi19', 'nrredd00', 'shyampadhi2', 'suresh047', 'sunny.patel361', 'astjraj', 'atulverma1992']",12,"['saurabhjoshi', 'prathyush14mnt0020', 'ayushikamalkar', 'becky0070', 'durga0045', 'esathiyacnr', 'dayakar3', 'pawan12', 'bishuishwari', 'eswar369', 'jeethu123', None]",52,"['saurabhjoshi', 'swethasmenon', 'baoxun1', 'pradeep1450', 'swapnildabade70', 'balabanmb', 'ajitaneogi', 'sunny.patel361', 'shivangi30', 'astjraj', 'pawan12', 'durgesh123', 'eswar369', 'mpreynos1', 'swathimnt0049', 'ank', 'arazavie', 'vishnusasi', 'surender', 'becky0070', 'doublefan', 'dayakar3', 'venu652', 'bishuishwari', 'karthick30', 'jeethu123', 'prathyush14mnt0020', 'sbatchu1', 'rafikul', 'narayanamh123', 'ashishjwk', 'salman.manzoor', 'esathiyacnr', 'bishakha1606', 'mjayara3', 'balacool', 'abipriyan3', 'nehavr25', 'mpreynos', 'harshadsurdi', 'bharathi19', 'nrredd00', None, 'shyampadhi2', 'joseph207', 'ayushikamalkar', 'durga0045', 'kartik1', 'suresh047', 'sabby1611', 'hasanraza', 'atulverma1992']"
14,34,41,19,4,"['joseph207', 'karthick30', 'bharathi19', 'suresh047']",36,"['swethasmenon', 'baoxun1', 'pradeep1450', 'swapnildabade70', 'balabanmb', 'ajitaneogi', 'shivangi30', 'durgesh123', 'hasanraza', 'mpreynos1', 'swathimnt0049', 'ank', 'arazavie', 'vishnusasi', 'surender', 'doublefan', 'venu652', 'sbatchu1', 'rafikul', 'narayanamh123', 'ashishjwk', 'salman.manzoor', 'bishakha1606', 'mjayara3', 'balacool', 'abipriyan3', 'nehavr25', 'mpreynos', 'harshadsurdi', 'sabby1611', 'nrredd00', 'shyampadhi2', 'kartik1', 'sunny.patel361', 'astjraj', 'atulverma1992']",15,"['kommanaveen51', 'ravitejasolleti', 'mytheeswaran001', 'becky0070', 'jeethu123', 's.divyalakshmi', 'revathyd14mnt0018', 'esathiyacnr', 'avvaruvenkat225', 'dayakar3', 'syamsai', 'bishuishwari', 'shruthivs', 'ram14mnt007', None]",55,"['kommanaveen51', 'swethasmenon', 'baoxun1', 'pradeep1450', 'swapnildabade70', 'balabanmb', 'ajitaneogi', 'sunny.patel361', 'shivangi30', 'astjraj', 'durgesh123', 'mpreynos1', 'swathimnt0049', 'ank', 'arazavie', 'vishnusasi', 'surender', 'mytheeswaran001', 'becky0070', 'doublefan', 'dayakar3', 'venu652', 'bishuishwari', 'karthick30', 'ram14mnt007', 'jeethu123', 'ravitejasolleti', 'sbatchu1', 'rafikul', 'narayanamh123', 'ashishjwk', 'salman.manzoor', 's.divyalakshmi', 'esathiyacnr', 'bishakha1606', 'mjayara3', 'avvaruvenkat225', 'balacool', 'abipriyan3', 'nehavr25', 'mpreynos', 'harshadsurdi', 'bharathi19', 'nrredd00', None, 'shyampadhi2', 'joseph207', 'kartik1', 'revathyd14mnt0018', 'syamsai', 'suresh047', 'sabby1611', 'hasanraza', 'shruthivs', 'atulverma1992']"
14,32,41,17,7,"['swathimnt0049', 'shyampadhi2', 'pradeep1450', 'narayanamh123', 'swapnildabade70', 'vishnusasi', 'kartik1']",33,"['swethasmenon', 'baoxun1', 'balabanmb', 'ajitaneogi', 'shivangi30', 'durgesh123', 'hasanraza', 'mpreynos1', 'ank', 'arazavie', 'surender', 'doublefan', 'venu652', 'karthick30', 'sbatchu1', 'rafikul', 'ashishjwk', 'salman.manzoor', 'bishakha1606', 'mjayara3', 'balacool', 'abipriyan3', 'nehavr25', 'mpreynos', 'harshadsurdi', 'sabby1611', 'bharathi19', 'nrredd00', 'joseph207', 'suresh047', 'sunny.patel361', 'astjraj', 'atulverma1992']",10,"['saurabhjoshi', 'prathyush14mnt0020', 'ayushikamalkar', 'becky0070', 'durga0045', 'esathiyacnr', 'pawan12', 'eswar369', 'jeethu123', None]",50,"['saurabhjoshi', 'swethasmenon', 'baoxun1', 'pradeep1450', 'swapnildabade70', 'balabanmb', 'ajitaneogi', 'sunny.patel361', 'shivangi30', 'astjraj', 'pawan12', 'durgesh123', 'eswar369', 'mpreynos1', 'swathimnt0049', 'ank', 'arazavie', 'vishnusasi', 'surender', 'becky0070', 'doublefan', 'venu652', 'karthick30', 'jeethu123', 'prathyush14mnt0020', 'sbatchu1', 'rafikul', 'narayanamh123', 'ashishjwk', 'salman.manzoor', 'esathiyacnr', 'bishakha1606', 'mjayara3', 'balacool', 'abipriyan3', 'nehavr25', 'mpreynos', 'harshadsurdi', 'bharathi19', 'nrredd00', None, 'shyampadhi2', 'joseph207', 'ayushikamalkar', 'durga0045', 'kartik1', 'suresh047', 'sabby1611', 'hasanraza', 'atulverma1992']"
14,29,41,15,10,"['rafikul', 'shyampadhi2', 'ank', 'sunny.patel361', 'hasanraza', 'suresh047', 'durgesh123', 'astjraj', 'karthick30', 'atulverma1992']",30,"['swethasmenon', 'baoxun1', 'pradeep1450', 'swapnildabade70', 'balabanmb', 'ajitaneogi', 'shivangi30', 'mpreynos1', 'swathimnt0049', 'surender', 'arazavie', 'vishnusasi', 'doublefan', 'venu652', 'sbatchu1', 'narayanamh123', 'ashishjwk', 'salman.manzoor', 'bishakha1606', 'mjayara3', 'balacool', 'abipriyan3', 'nehavr25', 'mpreynos', 'harshadsurdi', 'bharathi19', 'nrredd00', 'joseph207', 'kartik1', 'sabby1611']",5,"['mytheeswaran001', 'rhera312', None, 'bharathithasan111', 'gandhamsatish1107']",45,"['swethasmenon', 'baoxun1', 'pradeep1450', 'swapnildabade70', 'balabanmb', 'ajitaneogi', 'sunny.patel361', 'shivangi30', 'astjraj', 'durgesh123', 'mpreynos1', 'swathimnt0049', 'ank', 'arazavie', 'vishnusasi', 'surender', 'mytheeswaran001', 'doublefan', 'bharathithasan111', 'venu652', 'karthick30', 'sbatchu1', 'rafikul', 'narayanamh123', 'ashishjwk', 'salman.manzoor', 'bishakha1606', 'mjayara3', 'balacool', 'abipriyan3', 'nehavr25', 'mpreynos', 'harshadsurdi', 'bharathi19', 'nrredd00', 'gandhamsatish1107', None, 'shyampadhi2', 'rhera312', 'joseph207', 'kartik1', 'suresh047', 'sabby1611', 'hasanraza', 'atulverma1992']"
15,195,41,39,14,"['alexei.frutig', 'huang406', 'timmynewbi', 'lgoedde', 'jiwborad', 'nchesnut', 'suraj123', 'amduslim', 'ian.j.horstman', 'scottbkelly', 'dtank', 'ha14', 'scopod', 'benderd']",26,"['njtsh', 'cathy.spyr', 'alexa.malaspino', 'grahamnelliott', 'bdutts20', 'frog020531', 'stephens2633', 'zach.mcdonald.180', 'pharjani', 'bbbrander', 'gdykes', 'craig.francis2', 'philbold', 'nate.pabrai', 'curtuscd', 'sanu92', 'preetisht', 'phoun49', 'andrew.doyle.779857', 'satmatzi', 'aalip', 'simon.chao.18041', 'shivani.joshi.73', 'donald.bender', 'rohan.j.srivastava', 'brieder']",25,"['katie.bauschka', 'shuhui.tang.nj', 'tian37', 'davidmhein', 'cspyr001', 'jiruotong', 'xjlei', 'apaulson18', 'wwxxhh', 'zhuzijian1993', 'wang1580', 'zooley', 'zmcdona', 'zxy844288792', 'alexj9', 'nathanpabrai', 'jseifert', None, 'gmcminde124', 'mmakak', 'davis489', 'huang442purdue', 'jmaricha', 'kgdn2008', 'stephe55']",65,"['cathy.spyr', 'alexa.malaspino', 'grahamnelliott', 'frog020531', 'katie.bauschka', 'amduslim', 'scottbkelly', 'dtank', 'davidmhein', 'scopod', 'benderd', 'stephens2633', 'cspyr001', 'zach.mcdonald.180', 'lgoedde', 'gdykes', 'zhuzijian1993', 'philbold', 'ian.j.horstman', 'sanu92', 'preetisht', 'alexj9', 'andrew.doyle.779857', 'satmatzi', 'davis489', 'aalip', 'simon.chao.18041', 'suraj123', 'huang442purdue', 'rohan.j.srivastava', 'kgdn2008', 'stephe55', 'brieder', 'alexei.frutig', 'njtsh', 'timmynewbi', 'bdutts20', 'shuhui.tang.nj', 'tian37', 'jiruotong', 'xjlei', 'nchesnut', 'apaulson18', 'pharjani', 'bbbrander', 'ha14', 'wwxxhh', 'wang1580', 'craig.francis2', 'huang406', 'zooley', 'zmcdona', 'nate.pabrai', 'zxy844288792', 'curtuscd', 'phoun49', 'nathanpabrai', 'jseifert', None, 'gmcminde124', 'mmakak', 'jiwborad', 'shivani.joshi.73', 'donald.bender', 'jmaricha']"
15,197,41,34,25,"['alexei.frutig', 'njtsh', 'cathy.spyr', 'timmynewbi', 'grahamnelliott', 'amduslim', 'scottbkelly', 'scopod', 'benderd', 'lgoedde', 'nchesnut', 'gdykes', 'bbbrander', 'ha14', 'craig.francis2', 'huang406', 'philbold', 'nate.pabrai', 'curtuscd', 'ian.j.horstman', 'sanu92', 'phoun49', 'suraj123', 'shivani.joshi.73', 'brieder']",15,"['aalip', 'simon.chao.18041', 'alexa.malaspino', 'frog020531', 'bdutts20', 'jiwborad', 'pharjani', 'dtank', 'preetisht', 'andrew.doyle.779857', 'donald.bender', 'rohan.j.srivastava', 'stephens2633', 'zach.mcdonald.180', 'satmatzi']",9,"['katie.bauschka', 'zmcdona', 'apaulson18', 'danbobwilson', 'jmaricha', 'willi900', 'stephe55', None, 'rohan117']",49,"['alexei.frutig', 'njtsh', 'cathy.spyr', 'timmynewbi', 'alexa.malaspino', 'grahamnelliott', 'bdutts20', 'frog020531', 'amduslim', 'katie.bauschka', 'scottbkelly', 'dtank', 'scopod', 'benderd', 'stephens2633', 'zach.mcdonald.180', 'rohan117', 'lgoedde', 'nchesnut', 'apaulson18', 'pharjani', 'bbbrander', 'ha14', 'gdykes', 'willi900', 'craig.francis2', 'huang406', 'philbold', 'zmcdona', 'nate.pabrai', 'curtuscd', 'ian.j.horstman', 'sanu92', 'preetisht', 'danbobwilson', 'phoun49', 'andrew.doyle.779857', None, 'satmatzi', 'aalip', 'simon.chao.18041', 'jiwborad', 'suraj123', 'shivani.joshi.73', 'donald.bender', 'jmaricha', 'rohan.j.srivastava', 'stephe55', 'brieder']"
15,198,41,32,29,"['alexei.frutig', 'timmynewbi', 'cathy.spyr', 'grahamnelliott', 'scottbkelly', 'scopod', 'benderd', 'stephens2633', 'zach.mcdonald.180', 'lgoedde', 'nchesnut', 'pharjani', 'bbbrander', 'ha14', 'gdykes', 'craig.francis2', 'huang406', 'philbold', 'nate.pabrai', 'curtuscd', 'ian.j.horstman', 'preetisht', 'phoun49', 'andrew.doyle.779857', 'satmatzi', 'suraj123', 'shivani.joshi.73', 'rohan.j.srivastava', 'brieder']",11,"['njtsh', 'aalip', 'simon.chao.18041', 'alexa.malaspino', 'frog020531', 'bdutts20', 'jiwborad', 'amduslim', 'sanu92', 'dtank', 'donald.bender']",3,"['kildisha', None, 'cspyr001']",43,"['alexei.frutig', 'njtsh', 'cathy.spyr', 'timmynewbi', 'alexa.malaspino', 'grahamnelliott', 'bdutts20', 'frog020531', 'amduslim', 'scottbkelly', 'dtank', 'scopod', 'benderd', 'stephens2633', 'cspyr001', 'zach.mcdonald.180', 'lgoedde', 'nchesnut', 'pharjani', 'bbbrander', 'ha14', 'gdykes', 'craig.francis2', 'huang406', 'philbold', 'kildisha', 'nate.pabrai', 'curtuscd', 'ian.j.horstman', 'sanu92', 'preetisht', 'phoun49', 'andrew.doyle.779857', None, 'satmatzi', 'aalip', 'simon.chao.18041', 'jiwborad', 'suraj123', 'shivani.joshi.73', 'donald.bender', 'rohan.j.srivastava', 'brieder']"
15,196,41,24,9,"['timmynewbi', 'cathy.spyr', 'alexa.malaspino', 'nchesnut', 'suraj123', 'ian.j.horstman', 'scottbkelly', 'pharjani', 'benderd']",31,"['alexei.frutig', 'njtsh', 'grahamnelliott', 'frog020531', 'bdutts20', 'amduslim', 'dtank', 'scopod', 'stephens2633', 'zach.mcdonald.180', 'lgoedde', 'gdykes', 'bbbrander', 'ha14', 'craig.francis2', 'huang406', 'philbold', 'nate.pabrai', 'curtuscd', 'sanu92', 'preetisht', 'phoun49', 'andrew.doyle.779857', 'satmatzi', 'aalip', 'simon.chao.18041', 'jiwborad', 'shivani.joshi.73', 'donald.bender', 'rohan.j.srivastava', 'brieder']",15,"['katie.bauschka', 'sherndo', 'zmcdona', 'zxy844288792', 'apaulson18', 'sjy0302', 'shuhui.tang.nj', 'alexj9', 'tian37', 'feng59', 'jmaricha', 'zhuzijian1993', None, 'rohan117', 'gmcminde124']",55,"['alexei.frutig', 'njtsh', 'cathy.spyr', 'timmynewbi', 'alexa.malaspino', 'grahamnelliott', 'bdutts20', 'frog020531', 'amduslim', 'katie.bauschka', 'scottbkelly', 'dtank', 'shuhui.tang.nj', 'tian37', 'scopod', 'benderd', 'stephens2633', 'zach.mcdonald.180', 'rohan117', 'lgoedde', 'nchesnut', 'apaulson18', 'pharjani', 'bbbrander', 'ha14', 'gdykes', 'feng59', 'zhuzijian1993', 'craig.francis2', 'huang406', 'philbold', 'sherndo', 'nate.pabrai', 'zmcdona', 'curtuscd', 'ian.j.horstman', 'sanu92', 'preetisht', 'zxy844288792', 'phoun49', 'sjy0302', 'alexj9', 'andrew.doyle.779857', None, 'satmatzi', 'gmcminde124', 'aalip', 'simon.chao.18041', 'jiwborad', 'suraj123', 'shivani.joshi.73', 'donald.bender', 'jmaricha', 'rohan.j.srivastava', 'brieder']"
16,11,40,31,30,"['kylekug', 'kfrancis91', 'rhej3', 'john5049', 'kparsons', 'jkting3', 'awest32', 'suacide24', 'arefinhaque22', 'philip.gordon', 'hunter.brooks.374', 'lordxiaogg', 'abubakr1992', 'ateet101', 'henrynicole57', 'williamgauspohl', 'jamespelder3', 'jyoungblood87', 'kcook39', 'richardemail007', 'rliou92', 'drfilled', 'mizell.zakery', 'lchen375', 'rosawa', 'rheindt.sven', 'dturmel3', 'rndzz', 'ahaque30', 'cindy.chen']",9,"['pramodr91', 'shrugatade', 'dhanya.bharadhwaj', 'skyswan', 'bhuvancind', 'carlos.a.cortes.167', 'sebas1501', 'kirankmr199', 'larrottanatalia']",1,[None],40,"['kylekug', 'dhanya.bharadhwaj', 'rhej3', 'kfrancis91', 'carlos.a.cortes.167', 'skyswan', 'john5049', 'kparsons', 'jkting3', 'awest32', 'suacide24', 'shrugatade', 'bhuvancind', 'cindy.chen', 'arefinhaque22', 'philip.gordon', 'kirankmr199', 'hunter.brooks.374', 'lordxiaogg', 'abubakr1992', 'ateet101', 'henrynicole57', 'williamgauspohl', 'jamespelder3', 'jyoungblood87', 'pramodr91', 'kcook39', 'richardemail007', 'rliou92', 'sebas1501', 'drfilled', 'lchen375', 'mizell.zakery', None, 'rosawa', 'rheindt.sven', 'dturmel3', 'rndzz', 'ahaque30', 'larrottanatalia']"
16,10,40,14,5,"['pramodr91', 'shrugatade', 'dhanya.bharadhwaj', 'bhuvancind', 'kirankmr199']",34,"['kylekug', 'kfrancis91', 'rhej3', 'skyswan', 'carlos.a.cortes.167', 'john5049', 'kparsons', 'jkting3', 'awest32', 'suacide24', 'arefinhaque22', 'philip.gordon', 'lordxiaogg', 'hunter.brooks.374', 'abubakr1992', 'ateet101', 'henrynicole57', 'williamgauspohl', 'jamespelder3', 'jyoungblood87', 'kcook39', 'richardemail007', 'rliou92', 'sebas1501', 'drfilled', 'lchen375', 'mizell.zakery', 'rosawa', 'larrottanatalia', 'rheindt.sven', 'dturmel3', 'rndzz', 'ahaque30', 'cindy.chen']",9,"['teju.raman.39', 'ravim0288', 'ravikanth.katti', 'praveenjnvh', 'mahammad.gous.s', 'sekharguru257', 'ragunaik.ec', None, 'justraghu']",48,"['kylekug', 'ravikanth.katti', 'dhanya.bharadhwaj', 'rhej3', 'kfrancis91', 'carlos.a.cortes.167', 'skyswan', 'john5049', 'sekharguru257', 'kparsons', 'ragunaik.ec', 'jkting3', 'awest32', 'suacide24', 'shrugatade', 'bhuvancind', 'cindy.chen', 'arefinhaque22', 'philip.gordon', 'kirankmr199', 'hunter.brooks.374', 'lordxiaogg', 'abubakr1992', 'ateet101', 'henrynicole57', 'williamgauspohl', 'jamespelder3', 'jyoungblood87', 'pramodr91', 'praveenjnvh', 'kcook39', 'richardemail007', 'rliou92', 'sebas1501', 'drfilled', 'lchen375', 'mizell.zakery', 'mahammad.gous.s', None, 'rosawa', 'justraghu', 'teju.raman.39', 'ravim0288', 'rheindt.sven', 'dturmel3', 'rndzz', 'ahaque30', 'larrottanatalia']"
16,7,40,12,5,"['pramodr91', 'shrugatade', 'dhanya.bharadhwaj', 'bhuvancind', 'kirankmr199']",34,"['kylekug', 'kfrancis91', 'rhej3', 'skyswan', 'carlos.a.cortes.167', 'john5049', 'kparsons', 'jkting3', 'awest32', 'suacide24', 'arefinhaque22', 'philip.gordon', 'lordxiaogg', 'hunter.brooks.374', 'abubakr1992', 'ateet101', 'henrynicole57', 'williamgauspohl', 'jamespelder3', 'jyoungblood87', 'kcook39', 'richardemail007', 'rliou92', 'sebas1501', 'drfilled', 'lchen375', 'mizell.zakery', 'rosawa', 'larrottanatalia', 'rheindt.sven', 'dturmel3', 'rndzz', 'ahaque30', 'cindy.chen']",7,"['ravikanth.katti', 'vinaysridhar', 'ravikanthpamidi', 'geethanand.n', 'justraghu', None, 'an.aravind.014']",46,"['kylekug', 'ravikanth.katti', 'vinaysridhar', 'dhanya.bharadhwaj', 'rhej3', 'kfrancis91', 'carlos.a.cortes.167', 'skyswan', 'john5049', 'kparsons', 'jkting3', 'awest32', 'suacide24', 'shrugatade', 'bhuvancind', 'geethanand.n', 'cindy.chen', 'arefinhaque22', 'philip.gordon', 'kirankmr199', 'hunter.brooks.374', 'lordxiaogg', 'abubakr1992', 'ateet101', 'henrynicole57', 'williamgauspohl', 'jamespelder3', 'jyoungblood87', 'pramodr91', 'kcook39', 'richardemail007', 'rliou92', 'sebas1501', 'drfilled', 'lchen375', 'mizell.zakery', 'justraghu', None, 'rosawa', 'an.aravind.014', 'rheindt.sven', 'dturmel3', 'ravikanthpamidi', 'rndzz', 'ahaque30', 'larrottanatalia']"
17,195,39,39,23,"['katie.bauschka', 'shuhui.tang.nj', 'tian37', 'davidmhein', 'jiruotong', 'xjlei', 'apaulson18', 'wwxxhh', 'zhuzijian1993', 'wang1580', 'zooley', 'zmcdona', 'zxy844288792', 'alexj9', 'nathanpabrai', 'jseifert', 'gmcminde124', 'mmakak', 'davis489', 'huang442purdue', 'jmaricha', 'kgdn2008', 'stephe55']",15,"['simbernal', 'brian.rieder777', 'khaki', 'hsmith', 'omar.pineda.33', 'huang467', 'liu837', 'deathpheonix', 'cmothersead', 'feng59', 'alvare15', 'wsanche2', 'amalaspi', 'nzitnick', 'ianhorstman']",16,"['alexei.frutig', 'huang406', 'timmynewbi', 'cspyr001', 'lgoedde', 'jiwborad', 'nchesnut', 'suraj123', 'amduslim', 'ian.j.horstman', 'scottbkelly', 'dtank', 'ha14', 'scopod', 'benderd', None]",54,"['katie.bauschka', 'amduslim', 'scottbkelly', 'dtank', 'deathpheonix', 'davidmhein', 'scopod', 'cspyr001', 'benderd', 'amalaspi', 'lgoedde', 'hsmith', 'huang467', 'feng59', 'zhuzijian1993', 'khaki', 'ian.j.horstman', 'alexj9', 'nzitnick', 'davis489', 'suraj123', 'huang442purdue', 'wsanche2', 'kgdn2008', 'stephe55', 'simbernal', 'alexei.frutig', 'timmynewbi', 'omar.pineda.33', 'shuhui.tang.nj', 'liu837', 'tian37', 'jiruotong', 'brian.rieder777', 'xjlei', 'nchesnut', 'apaulson18', 'ha14', 'alvare15', 'wwxxhh', 'wang1580', 'ianhorstman', 'huang406', 'zooley', 'zmcdona', 'zxy844288792', 'cmothersead', 'nathanpabrai', 'jseifert', None, 'gmcminde124', 'mmakak', 'jiwborad', 'jmaricha']"
17,197,39,34,5,"['katie.bauschka', 'zmcdona', 'apaulson18', 'jmaricha', 'stephe55']",33,"['simbernal', 'omar.pineda.33', 'shuhui.tang.nj', 'liu837', 'deathpheonix', 'davidmhein', 'tian37', 'amalaspi', 'jiruotong', 'brian.rieder777', 'xjlei', 'hsmith', 'huang467', 'feng59', 'alvare15', 'wwxxhh', 'zhuzijian1993', 'wang1580', 'ianhorstman', 'zooley', 'khaki', 'zxy844288792', 'alexj9', 'cmothersead', 'nathanpabrai', 'jseifert', 'nzitnick', 'davis489', 'mmakak', 'gmcminde124', 'huang442purdue', 'wsanche2', 'kgdn2008']",29,"['alexei.frutig', 'njtsh', 'cathy.spyr', 'timmynewbi', 'grahamnelliott', 'amduslim', 'scottbkelly', 'scopod', 'benderd', 'rohan117', 'lgoedde', 'nchesnut', 'gdykes', 'bbbrander', 'ha14', 'willi900', 'craig.francis2', 'huang406', 'philbold', 'nate.pabrai', 'curtuscd', 'ian.j.horstman', 'danbobwilson', 'sanu92', 'phoun49', None, 'suraj123', 'shivani.joshi.73', 'brieder']",67,"['simbernal', 'alexei.frutig', 'njtsh', 'cathy.spyr', 'timmynewbi', 'katie.bauschka', 'grahamnelliott', 'amduslim', 'omar.pineda.33', 'scottbkelly', 'shuhui.tang.nj', 'liu837', 'deathpheonix', 'davidmhein', 'tian37', 'scopod', 'benderd', 'amalaspi', 'jiruotong', 'rohan117', 'brian.rieder777', 'xjlei', 'lgoedde', 'nchesnut', 'hsmith', 'apaulson18', 'huang467', 'gdykes', 'bbbrander', 'ha14', 'feng59', 'alvare15', 'wwxxhh', 'zhuzijian1993', 'willi900', 'wang1580', 'craig.francis2', 'ianhorstman', 'huang406', 'zooley', 'khaki', 'zmcdona', 'zxy844288792', 'philbold', 'nate.pabrai', 'curtuscd', 'ian.j.horstman', 'alexj9', 'cmothersead', 'danbobwilson', 'nathanpabrai', 'sanu92', 'phoun49', 'jseifert', None, 'nzitnick', 'davis489', 'mmakak', 'gmcminde124', 'suraj123', 'shivani.joshi.73', 'huang442purdue', 'wsanche2', 'jmaricha', 'kgdn2008', 'stephe55', 'brieder']"
17,196,39,24,11,"['katie.bauschka', 'zmcdona', 'zxy844288792', 'apaulson18', 'shuhui.tang.nj', 'alexj9', 'tian37', 'feng59', 'jmaricha', 'zhuzijian1993', 'gmcminde124']",27,"['simbernal', 'omar.pineda.33', 'liu837', 'deathpheonix', 'davidmhein', 'amalaspi', 'jiruotong', 'brian.rieder777', 'xjlei', 'hsmith', 'huang467', 'alvare15', 'wwxxhh', 'wang1580', 'ianhorstman', 'zooley', 'khaki', 'cmothersead', 'nathanpabrai', 'jseifert', 'nzitnick', 'davis489', 'mmakak', 'huang442purdue', 'wsanche2', 'kgdn2008', 'stephe55']",13,"['timmynewbi', 'cathy.spyr', 'alexa.malaspino', 'sherndo', 'nchesnut', 'suraj123', 'ian.j.horstman', 'scottbkelly', 'pharjani', 'sjy0302', 'benderd', None, 'rohan117']",51,"['simbernal', 'timmynewbi', 'cathy.spyr', 'katie.bauschka', 'alexa.malaspino', 'omar.pineda.33', 'scottbkelly', 'shuhui.tang.nj', 'liu837', 'deathpheonix', 'davidmhein', 'tian37', 'benderd', 'amalaspi', 'jiruotong', 'rohan117', 'brian.rieder777', 'xjlei', 'nchesnut', 'hsmith', 'apaulson18', 'huang467', 'pharjani', 'feng59', 'alvare15', 'wwxxhh', 'zhuzijian1993', 'wang1580', 'ianhorstman', 'zooley', 'khaki', 'zmcdona', 'zxy844288792', 'sherndo', 'ian.j.horstman', 'sjy0302', 'alexj9', 'cmothersead', 'nathanpabrai', 'jseifert', None, 'nzitnick', 'davis489', 'mmakak', 'gmcminde124', 'suraj123', 'huang442purdue', 'wsanche2', 'jmaricha', 'kgdn2008', 'stephe55']"
18,143,34,80,32,"['jinpeng.zhuo', 'stakek2', 'limberg2', 'klwells2', 'lolipopcarolwang', 'simpkns2', 'gvelard2edu', 'akagti2', 'siyi.xu.180', 'hsheng3', 'dtascone92', 'qiujiezhao1994', 'trick2', 'dkwok2', 'dagapit2', 'toglitt2', 'cledesma2331', 'jwsmith6', 'ahli2', 'rflore24', 'jmmille6', 'fang.the.tall', 'kfeng', 'csbaile2', 'palchec2', 'tara.cullerton', 'aamurthy', 'alexkim3', 'elin11', 'gargula2', 'danieldli1993', 'eslee5']",1,['nadimi.sadegh'],48,"['xli121', 'jwang124', 'kemehan', 'angela525huangjj', 'hylin2', 'btkern2', 'akatsulis', 'cory93', 'hmtaylo2', 'bomcdon2', 'schiavo1', 'adsnyde2', 'qazyyc93', 'nickpalcheck', 'jcjc2222', 'mingxu3', 'arjun.balwally', 'siyima2', 'junpeng.qiu', 'xnypr', 'yyang10', 'jjacksn', 'jos26coh', 'litton2', 'cljohnson0', 'allysonv10', 'salman2', 'qyang13', 'shalper2', 'sage', 'ramaiah2', 'kathyzhou0124', 'bhanley2', 'crichrd2', None, 'bcclanc2', 'jwang182', 'isaacehoffman', 'limsiri2', 'cx1048539626', 'achoi121', 'abaddon2mist', 'jinpengzhuo', 'sguo1', 'bcc4994', 'npalcheck', 'scpiper2', 'pbhatta2']",81,"['xli121', 'jinpeng.zhuo', 'kemehan', 'angela525huangjj', 'btkern2', 'akatsulis', 'simpkns2', 'gvelard2edu', 'akagti2', 'hmtaylo2', 'siyi.xu.180', 'hsheng3', 'adsnyde2', 'qazyyc93', 'jcjc2222', 'xnypr', 'dtascone92', 'jos26coh', 'litton2', 'trick2', 'salman2', 'qyang13', 'cledesma2331', 'jwsmith6', 'sage', 'jmmille6', 'kathyzhou0124', 'crichrd2', 'csbaile2', 'palchec2', 'tara.cullerton', 'limsiri2', 'achoi121', 'alexkim3', 'abaddon2mist', 'elin11', 'sguo1', 'bcc4994', 'npalcheck', 'gargula2', 'scpiper2', 'klwells2', 'stakek2', 'limberg2', 'lolipopcarolwang', 'jwang124', 'hylin2', 'nadimi.sadegh', 'cory93', 'bomcdon2', 'schiavo1', 'nickpalcheck', 'mingxu3', 'arjun.balwally', 'siyima2', 'junpeng.qiu', 'yyang10', 'jjacksn', 'qiujiezhao1994', 'cljohnson0', 'allysonv10', 'dkwok2', 'dagapit2', 'toglitt2', 'shalper2', 'ahli2', 'rflore24', 'fang.the.tall', 'ramaiah2', 'bhanley2', None, 'kfeng', 'bcclanc2', 'jwang182', 'aamurthy', 'isaacehoffman', 'cx1048539626', 'jinpengzhuo', 'danieldli1993', 'pbhatta2', 'eslee5']"
18,147,34,52,32,"['jinpeng.zhuo', 'stakek2', 'limberg2', 'klwells2', 'lolipopcarolwang', 'simpkns2', 'gvelard2edu', 'akagti2', 'siyi.xu.180', 'hsheng3', 'dtascone92', 'qiujiezhao1994', 'trick2', 'dkwok2', 'dagapit2', 'toglitt2', 'cledesma2331', 'jwsmith6', 'ahli2', 'rflore24', 'jmmille6', 'fang.the.tall', 'kfeng', 'csbaile2', 'palchec2', 'tara.cullerton', 'aamurthy', 'alexkim3', 'elin11', 'gargula2', 'danieldli1993', 'eslee5']",1,['nadimi.sadegh'],20,"['trgordo2', 'gcnelson33', 'bsorich32', 'tjweber2', 'hmtaylo2', 'gsunnysmile', 'lxl370141857', 'angela.huang.501', 'jtcohen2', 'ducharm2', 'taperez2', 'isaacehoffman2', 'dwchris2', 'emdeity', 'amber.snil', 'kjcsport1', None, 'ajgordon', 'tomtang1993', 'yyang100']",53,"['jinpeng.zhuo', 'bsorich32', 'simpkns2', 'gvelard2edu', 'akagti2', 'hmtaylo2', 'siyi.xu.180', 'hsheng3', 'angela.huang.501', 'ducharm2', 'dtascone92', 'taperez2', 'trick2', 'cledesma2331', 'jwsmith6', 'jmmille6', 'emdeity', 'amber.snil', 'csbaile2', 'palchec2', 'tara.cullerton', 'alexkim3', 'elin11', 'gargula2', 'tomtang1993', 'yyang100', 'trgordo2', 'klwells2', 'stakek2', 'limberg2', 'lolipopcarolwang', 'gcnelson33', 'tjweber2', 'nadimi.sadegh', 'gsunnysmile', 'lxl370141857', 'jtcohen2', 'qiujiezhao1994', 'dkwok2', 'dagapit2', 'toglitt2', 'isaacehoffman2', 'dwchris2', 'ahli2', 'rflore24', 'fang.the.tall', 'kjcsport1', None, 'ajgordon', 'kfeng', 'aamurthy', 'danieldli1993', 'eslee5']"
19,225,34,153,20,"['evans260', 'wendyq', 'ndaman', 'tkriegel', 'hrs353', 'yang62', 'zhan1337', 'gandhi10', 'shubham.singh091', 'wenye1213', 'kim1797', 'jiashenghui2014', 'volkswind', 'sallu', 'abarat', 'weiyiwang', 'jpalsdot', 'ashishod', 'douzengyi1528', 'xu716']",13,"['florinda', 'cedricxie', 'zhan1589', 'carbaker', 'cpiya', 'keshav.amburay', 'manand', 'rlearley', 'fidelcomguy', 'jnarkar', 'sdharkar', 'livingston.cv', 'zhaoxinchi']",133,"['jingjingshi', 'jgeng', 'chuyuanchen', 'sunxingshu', 'hvr', 'maassenj1', 'mramazan', 'saima', 'hctest5', 'schiotz', 'kevyblock', 'sganguly', 'amrshahat', 'gonza226', 'sobh1', 'nrsyed', 'lalzatev', 'clarksm', 'borgesebastiao', 'eshaanmathew', 'kmargata', 'caduartec', 'rajugupta', 'jeong4', 'dkearney', 'dchaffee', 'fpena', 'agarwa80', 'cshang', 'sarath_ramadurgam', 'pmeunier', 'alo08864', 'akanti', 'cao42', 'nonofrio', 'jacks311', 'turkstra', 'poojanshah99', 'skkzlj7', 'dalemus', 'hsun.chao', 'aodubitsky', 'zhan1457', 'bss12', 'aghimire00', 'vladiakhnine', 'nguyenct', 'chandrar88', 'cyamamot', 'kuntalroy', 'zharman', 'goudarz2', 'lee1281', 'scalvert', 'davgumo', 'rosscarnahan', 'crvantas', 'hamed0', 'mathur7', 'browne3', 'zqingzi', 'sissichen0322', 'ovi_1000', 'gah', 'wang159', 'valencid', 'nrajpurk', 'kevin60105', 'chinyi', 'sobh1_2', 'light2', 'mmc', 'cao54', 'ebusquet', 'h.chenchu', 'denphi', 'mhollars', 'samikm', 'ghowlett', 'jorgem93', 'ybommire', 'jscher1', 'ksaviers', 'nkharche', 'ajey.091', 'kfezi', 'eddiewhite1', 'bmsutton', 'hkoval', 'thomp340', 'apps', 'sreeve', 'vgoutham', 'hctest4', 'jdbermeol', 'atankas', 'harshnisar', 'mmh', 'nkissebe', 'wangyide92', 'dweber1', 'barasaadah', 'ontarugera', 'taeho81909', 'hctest3', 'darshanpala', 'sun73', 'rrx1992', 'bhaley', 'hojin92', 'amcbain', 'wang945', 'tjhacker', 'dunn45', 'woodswims', 'prasadsarang', 'mbrindise', 'ksnvikrant', 'jsudibyo', 'ishan66', 'jin52', 'vdiep', 'karim1986', 'lu216', 'gf.giraldo239', 'msalmani', 'ecamaren', 'schcats', 'swoop', 'abahman', 'alegomez544', 'marisol', 'ldelgass']",166,"['jingjingshi', 'evans260', 'jgeng', 'sunxingshu', 'hvr', 'maassenj1', 'mramazan', 'saima', 'hctest5', 'schiotz', 'kevyblock', 'sganguly', 'amrshahat', 'zhan1337', 'gonza226', 'carbaker', 'sobh1', 'nrsyed', 'lalzatev', 'shubham.singh091', 'clarksm', 'borgesebastiao', 'florinda', 'eshaanmathew', 'kmargata', 'caduartec', 'volkswind', 'rajugupta', 'jeong4', 'sallu', 'weiyiwang', 'dkearney', 'ldelgass', 'dchaffee', 'fpena', 'agarwa80', 'cshang', 'xu716', 'sarath_ramadurgam', 'pmeunier', 'alo08864', 'akanti', 'cao42', 'nonofrio', 'jacks311', 'turkstra', 'livingston.cv', 'poojanshah99', 'skkzlj7', 'dalemus', 'hsun.chao', 'aodubitsky', 'zhan1457', 'bss12', 'manand', 'aghimire00', 'vladiakhnine', 'nguyenct', 'wenye1213', 'chandrar88', 'cyamamot', 'kuntalroy', 'jiashenghui2014', 'zharman', 'goudarz2', 'lee1281', 'scalvert', 'davgumo', 'rosscarnahan', 'crvantas', 'hamed0', 'mathur7', 'browne3', 'zqingzi', 'cpiya', 'sissichen0322', 'douzengyi1528', 'ovi_1000', 'gah', 'wang159', 'valencid', 'nrajpurk', 'wendyq', 'zhan1589', 'fidelcomguy', 'kevin60105', 'chinyi', 'jnarkar', 'sobh1_2', 'sdharkar', 'hrs353', 'light2', 'mmc', 'gandhi10', 'cao54', 'ebusquet', 'h.chenchu', 'denphi', 'mhollars', 'samikm', 'ghowlett', 'jorgem93', 'ybommire', 'jscher1', 'ksaviers', 'nkharche', 'ajey.091', 'kfezi', 'eddiewhite1', 'bmsutton', 'abarat', 'hkoval', 'thomp340', 'apps', 'sreeve', 'vgoutham', 'hctest4', 'jdbermeol', 'atankas', 'harshnisar', 'mmh', 'nkissebe', 'wangyide92', 'ndaman', 'keshav.amburay', 'tkriegel', 'dweber1', 'barasaadah', 'ontarugera', 'yang62', 'taeho81909', 'hctest3', 'darshanpala', 'sun73', 'rrx1992', 'bhaley', 'hojin92', 'amcbain', 'wang945', 'tjhacker', 'dunn45', 'zhaoxinchi', 'woodswims', 'prasadsarang', 'mbrindise', 'kim1797', 'ksnvikrant', 'jsudibyo', 'ishan66', 'jin52', 'vdiep', 'karim1986', 'lu216', 'gf.giraldo239', 'msalmani', 'jpalsdot', 'ecamaren', 'cedricxie', 'schcats', 'swoop', 'abahman', 'ashishod', 'rlearley', 'alegomez544', 'marisol', 'chuyuanchen']"
19,229,34,20,4,"['douzengyi1528', 'keshav.amburay', 'shubham.singh091', 'livingston.cv']",29,"['evans260', 'zhan1589', 'wendyq', 'ndaman', 'tkriegel', 'fidelcomguy', 'jnarkar', 'sdharkar', 'hrs353', 'yang62', 'zhan1337', 'gandhi10', 'carbaker', 'manand', 'wenye1213', 'zhaoxinchi', 'florinda', 'kim1797', 'jiashenghui2014', 'volkswind', 'sallu', 'abarat', 'weiyiwang', 'jpalsdot', 'cedricxie', 'cpiya', 'ashishod', 'rlearley', 'xu716']",16,"['hsun.chao', 'caduartec', 'eshaanmathew', 'goudarz2', 'abahman', 'sreeve', 'nrsyed', 'nonofrio', 'lee1281', 'aghimire00', 'karim1986', 'dunn45', 'harshnisar', 'hkoval', None, 'kibech']",49,"['evans260', 'wendyq', 'zhan1589', 'ndaman', 'keshav.amburay', 'nonofrio', 'tkriegel', 'fidelcomguy', 'jnarkar', 'sdharkar', 'livingston.cv', 'yang62', 'hrs353', 'kibech', 'zhan1337', 'hsun.chao', 'gandhi10', 'carbaker', 'manand', 'nrsyed', 'shubham.singh091', 'aghimire00', 'wenye1213', 'dunn45', 'zhaoxinchi', 'florinda', 'kim1797', 'jiashenghui2014', 'caduartec', 'volkswind', 'eshaanmathew', 'goudarz2', 'lee1281', 'sallu', 'karim1986', 'abarat', 'hkoval', None, 'weiyiwang', 'jpalsdot', 'cedricxie', 'cpiya', 'ashishod', 'douzengyi1528', 'abahman', 'rlearley', 'sreeve', 'xu716', 'harshnisar']"
19,231,34,9,1,['carbaker'],32,"['evans260', 'zhan1589', 'wendyq', 'ndaman', 'keshav.amburay', 'tkriegel', 'fidelcomguy', 'jnarkar', 'sdharkar', 'livingston.cv', 'yang62', 'hrs353', 'zhan1337', 'gandhi10', 'manand', 'shubham.singh091', 'wenye1213', 'zhaoxinchi', 'florinda', 'kim1797', 'jiashenghui2014', 'volkswind', 'sallu', 'abarat', 'weiyiwang', 'jpalsdot', 'cedricxie', 'cpiya', 'ashishod', 'douzengyi1528', 'rlearley', 'xu716']",8,"['aodubitsky', 'agarwa80', 'cshang', 'eddiewhite1', 'mcarthur', None, 'alo08864', 'ecamaren']",41,"['evans260', 'wendyq', 'zhan1589', 'ndaman', 'keshav.amburay', 'tkriegel', 'fidelcomguy', 'jnarkar', 'sdharkar', 'livingston.cv', 'yang62', 'hrs353', 'zhan1337', 'gandhi10', 'aodubitsky', 'carbaker', 'manand', 'shubham.singh091', 'wenye1213', 'zhaoxinchi', 'florinda', 'kim1797', 'jiashenghui2014', 'volkswind', 'sallu', 'eddiewhite1', 'abarat', None, 'weiyiwang', 'jpalsdot', 'ecamaren', 'cedricxie', 'cpiya', 'ashishod', 'douzengyi1528', 'rlearley', 'agarwa80', 'cshang', 'xu716', 'mcarthur', 'alo08864']"
20,105,32,120,1,['sangyuno0o'],30,"['polarisatv4', 'anetherton19', 'ssheik22', 'lappleb2', 'almirk', 'nikhil78888', 'matt.koopmann', 'kapadia3', 'choquett', 'posso.mario', 'xunyu2', 'mantrarush', 'pvuong3', 'mhaider2', 'insung0224', 'austin.martinovich', 'djinkorea', 'jofu803', 'alai6', 'tonyinhk', 'fuchslu2', 'dvncrtr', 'illini1208', 'lityo2', 'nikola.ivancevic.1', 'yliu160', 'adatia1', 'davidar2', 'broadhurst.josh', 'mjbollan']",119,"['richrdtang', 'xli121', 'mpalmer2', 'alexzzz1991', 'winoto2', 'rps233', 'cpx0rpc', 'ph0606', 'chris.reinke.16', 'eric.groeteke', 'kornholi', 'png4', 'chaken2', 'emily.hannigan.31', 'rxiao3', 'weineran', 'haelim1227', 'laura_b_galbraith', 'shawnahn318', 'greerdavidc', 'daehee0104', 'mingkang.he', 'dan.long.7505', 'teerapatpoka', 'bryniar2', 'ece34', 'aderoo2', 'golasze2', 'kkong7', 'ujrav', 'jterwil2', 'yhren1993', 'quantumseren', 'aarti.shah147', 'yumin2', 'yu91', 'kenned45', 'karwal2', 'xchen84', 'edennis3', 'kluhrsen', 'bomcdon2', 'ks.lamb14', 'allen412068', 'raghavkochhar9', 'zhenqin3', 'hlee156', 'brianchien', 'jdlenz', 'sehui04', 'earicha2', 'uber12', 'benck', 'piyayott9', 'dguo8', 'dingldn2', 'fwirjo', 'cx1048539626', 'eric.stiles3', 'yc6', 'kurmanba1', 'whuang56', 'pbhatta2', 'josh.barrett.589', 'jemysoul', 'jack.arendt', 'iliveincoto5464', 'tamtran2', 'aromeo', 'molly.pace.3', 'mikra616', 'ydong119', 'dhansel036', 'jdurant2', '1993sonu01', 'hmtaylo2', 'jzhu34', 'paur2', 'kaalvar2', 'sligh3ece', 'ppitchyy', 'bordain1', 'meng325', 'alex.mitsdarfer', 'yzhao60', 'tim.sutyak2', 'peihan0807', 'dsolanki', 'billstan42', 'shijiakimi', 'stps', 'rglazer21', 'flie2illinois', 'christu2', 'qhu12', 'lee117', 'george.s9999', 'brianchien390', 'grandcn', 'henry.ko.94', 'decraen2', 'junpeng.qiu', 'truszko1993', 'thephiltsai', 'ece340', 'jacklee3', 'liupufan', 'toujours.meiling93', 'charlie.dreebin', 'darksnape', 'hnrcksn2', 'dekunukem', None, 'blu6', 'replogl2', 'ecl01', 'archiehok', 'tong.yin.1', 'kshin10']",150,"['xli121', 'richrdtang', 'mpalmer2', 'alexzzz1991', 'winoto2', 'ssheik22', 'rps233', 'cpx0rpc', 'ph0606', 'chris.reinke.16', 'eric.groeteke', 'kornholi', 'png4', 'chaken2', 'emily.hannigan.31', 'rxiao3', 'weineran', 'pvuong3', 'haelim1227', 'laura_b_galbraith', 'shawnahn318', 'greerdavidc', 'tonyinhk', 'daehee0104', 'mingkang.he', 'dan.long.7505', 'teerapatpoka', 'archiehok', 'bryniar2', 'ece34', 'golasze2', 'aderoo2', 'kkong7', 'ujrav', 'jterwil2', 'yhren1993', 'quantumseren', 'aarti.shah147', 'yumin2', 'lappleb2', 'yu91', 'kenned45', 'karwal2', 'xchen84', 'edennis3', 'kluhrsen', 'bomcdon2', 'matt.koopmann', 'ks.lamb14', 'choquett', 'allen412068', 'raghavkochhar9', 'zhenqin3', 'hlee156', 'brianchien', 'insung0224', 'jdlenz', 'austin.martinovich', 'sehui04', 'earicha2', 'uber12', 'benck', 'piyayott9', 'dguo8', 'dingldn2', 'fwirjo', 'illini1208', 'cx1048539626', 'eric.stiles3', 'yc6', 'kurmanba1', 'davidar2', 'whuang56', 'josh.barrett.589', 'pbhatta2', 'jemysoul', 'jack.arendt', 'polarisatv4', 'iliveincoto5464', 'tamtran2', 'aromeo', 'molly.pace.3', 'almirk', 'mikra616', 'ydong119', 'dhansel036', 'nikhil78888', 'jdurant2', '1993sonu01', 'hmtaylo2', 'jzhu34', 'paur2', 'kaalvar2', 'sligh3ece', 'ppitchyy', 'bordain1', 'meng325', 'alex.mitsdarfer', 'posso.mario', 'xunyu2', 'mhaider2', 'djinkorea', 'sangyuno0o', 'yzhao60', 'alai6', 'fuchslu2', 'tim.sutyak2', 'peihan0807', 'dsolanki', 'nikola.ivancevic.1', 'billstan42', 'shijiakimi', 'mjbollan', 'stps', 'rglazer21', 'flie2illinois', 'anetherton19', 'christu2', 'qhu12', 'lee117', 'george.s9999', 'kapadia3', 'brianchien390', 'grandcn', 'henry.ko.94', 'decraen2', 'junpeng.qiu', 'truszko1993', 'thephiltsai', 'ece340', 'mantrarush', 'jacklee3', 'liupufan', 'toujours.meiling93', 'charlie.dreebin', 'darksnape', 'hnrcksn2', 'jofu803', 'dekunukem', None, 'dvncrtr', 'blu6', 'lityo2', 'replogl2', 'ecl01', 'yliu160', 'adatia1', 'tong.yin.1', 'kshin10', 'broadhurst.josh']"
20,186,32,117,4,"['ssheik22', 'sangyuno0o', 'posso.mario', 'austin.martinovich']",27,"['polarisatv4', 'anetherton19', 'lappleb2', 'almirk', 'nikhil78888', 'matt.koopmann', 'kapadia3', 'choquett', 'xunyu2', 'mantrarush', 'pvuong3', 'mhaider2', 'insung0224', 'djinkorea', 'jofu803', 'alai6', 'tonyinhk', 'fuchslu2', 'dvncrtr', 'illini1208', 'lityo2', 'nikola.ivancevic.1', 'yliu160', 'adatia1', 'davidar2', 'broadhurst.josh', 'mjbollan']",113,"['mysonu', 'mpalmer2', 'rps233', 'haunlliam', 'ph0606', 'danzuo', 'sariel12345', 'chris.reinke.16', 'eric.groeteke', 'kornholi', 'png4', 'chaken2', 'rxiao3', 'michael.diehl.583', 'tatanve', 'laura_b_galbraith', 'mithun.manivannan', 'jtomaras', 'greerdavidc', 'dyangsteven', 'rstang2', 'kpsrini2', 'tobrien7', 'djiang7', 'bryniar2', 'ece34', 'kkong7', 'ujrav', 'jterwil2', 'quantumseren', 'aarti.shah147', 'yumin2', 'yu91', 'edennis3', 'kluhrsen', 'yoo66', 'bomcdon2', 'ks.lamb14', 'eclee2', 'allen412068', 'raghavkochhar9', 'zhenqin3', 'hlee156', 'wang217', 'li160', 'jdlenz', 'xinding33', 'uber12', 'benck', 'fwirjo', 'studpuffin', 'ndecraene', 'kurmanba1', 'pbhatta2', 'pescenck', 'josh.barrett.589', 'jack.arendt', 'julia.labelle2', 'iliveincoto5464', 'michael370662', 'aromeo', 'mikra616', 'dhansel036', 'jdurant2', 'hmtaylo2', 'jzhu34', 'cooldaehee', 'kaalvar2', 'sligh3ece', 'meng325', 'alex.mitsdarfer', 'tapeter2', 'bkesler', 'jmxscrs', 'joshuaphua1', 'henryahn', 'yzhao60', 'sarielqjl', 'peihan0807', 'yk.karwal', 'coolkat677', 'zlc31993', 'dsolanki', 'tiffyye', 'billstan42', 'kknom1', 'tim.sutyak', 'christu2', 'lee117', 'george.s9999', 'xiongfei.ding', 'miller7', 'henry.ko.94', 'mikeyling18', 'truszko1993', 'ece340', 'kumikknd', 'jacklee3', 'grandcn4', 'liupufan', 'toujours.meiling93', 'charlie.dreebin', 'mattsucich', 'darksnape', 'hnrcksn2', 'au.chinprutthiwong', 'dan5664', 'jzhu46', 'beholla2', 'molly.pace93', None, 'piyayott', 'tong.yin.1']",144,"['mysonu', 'mpalmer2', 'ssheik22', 'rps233', 'haunlliam', 'ph0606', 'danzuo', 'sariel12345', 'chris.reinke.16', 'eric.groeteke', 'kornholi', 'png4', 'chaken2', 'rxiao3', 'tatanve', 'michael.diehl.583', 'pvuong3', 'laura_b_galbraith', 'mithun.manivannan', 'jtomaras', 'greerdavidc', 'tonyinhk', 'dyangsteven', 'rstang2', 'kpsrini2', 'tobrien7', 'djiang7', 'bryniar2', 'ece34', 'kkong7', 'ujrav', 'jterwil2', 'quantumseren', 'aarti.shah147', 'yumin2', 'lappleb2', 'yu91', 'edennis3', 'kluhrsen', 'yoo66', 'bomcdon2', 'matt.koopmann', 'ks.lamb14', 'eclee2', 'choquett', 'allen412068', 'raghavkochhar9', 'zhenqin3', 'hlee156', 'wang217', 'li160', 'insung0224', 'jdlenz', 'austin.martinovich', 'xinding33', 'uber12', 'benck', 'fwirjo', 'illini1208', 'studpuffin', 'ndecraene', 'kurmanba1', 'davidar2', 'josh.barrett.589', 'pescenck', 'pbhatta2', 'jack.arendt', 'polarisatv4', 'julia.labelle2', 'iliveincoto5464', 'michael370662', 'aromeo', 'almirk', 'mikra616', 'dhansel036', 'nikhil78888', 'jdurant2', 'hmtaylo2', 'jzhu34', 'cooldaehee', 'kaalvar2', 'sligh3ece', 'meng325', 'alex.mitsdarfer', 'posso.mario', 'tapeter2', 'xunyu2', 'bkesler', 'jmxscrs', 'mhaider2', 'joshuaphua1', 'henryahn', 'djinkorea', 'sangyuno0o', 'yzhao60', 'alai6', 'fuchslu2', 'sarielqjl', 'peihan0807', 'yk.karwal', 'coolkat677', 'zlc31993', 'dsolanki', 'nikola.ivancevic.1', 'tiffyye', 'billstan42', 'mjbollan', 'kknom1', 'tim.sutyak', 'anetherton19', 'christu2', 'lee117', 'george.s9999', 'xiongfei.ding', 'miller7', 'kapadia3', 'henry.ko.94', 'mikeyling18', 'truszko1993', 'ece340', 'kumikknd', 'mantrarush', 'jacklee3', 'grandcn4', 'liupufan', 'toujours.meiling93', 'charlie.dreebin', 'mattsucich', 'darksnape', 'hnrcksn2', 'au.chinprutthiwong', 'dan5664', 'jzhu46', 'jofu803', 'beholla2', 'molly.pace93', None, 'dvncrtr', 'lityo2', 'yliu160', 'piyayott', 'adatia1', 'tong.yin.1', 'broadhurst.josh']"
20,80,32,33,26,"['polarisatv4', 'lappleb2', 'almirk', 'matt.koopmann', 'kapadia3', 'choquett', 'xunyu2', 'mantrarush', 'pvuong3', 'mhaider2', 'insung0224', 'austin.martinovich', 'djinkorea', 'sangyuno0o', 'jofu803', 'alai6', 'tonyinhk', 'fuchslu2', 'dvncrtr', 'illini1208', 'nikola.ivancevic.1', 'yliu160', 'adatia1', 'davidar2', 'broadhurst.josh', 'mjbollan']",5,"['lityo2', 'anetherton19', 'posso.mario', 'ssheik22', 'nikhil78888']",7,"['paur2', 'srinisrikumar', 'pramesh2', 'ljapplebaum', 'bhyoon91', None, 'jayyao']",38,"['polarisatv4', 'ssheik22', 'almirk', 'nikhil78888', 'paur2', 'posso.mario', 'ljapplebaum', 'xunyu2', 'pvuong3', 'jayyao', 'mhaider2', 'djinkorea', 'sangyuno0o', 'pramesh2', 'alai6', 'tonyinhk', 'fuchslu2', 'nikola.ivancevic.1', 'mjbollan', 'anetherton19', 'lappleb2', 'matt.koopmann', 'kapadia3', 'choquett', 'bhyoon91', 'mantrarush', 'insung0224', 'srinisrikumar', 'austin.martinovich', 'jofu803', None, 'dvncrtr', 'illini1208', 'lityo2', 'yliu160', 'adatia1', 'davidar2', 'broadhurst.josh']"
20,72,32,31,25,"['lappleb2', 'almirk', 'nikhil78888', 'matt.koopmann', 'kapadia3', 'choquett', 'xunyu2', 'mantrarush', 'pvuong3', 'mhaider2', 'insung0224', 'austin.martinovich', 'sangyuno0o', 'jofu803', 'alai6', 'tonyinhk', 'fuchslu2', 'illini1208', 'lityo2', 'nikola.ivancevic.1', 'yliu160', 'adatia1', 'davidar2', 'broadhurst.josh', 'mjbollan']",6,"['polarisatv4', 'dvncrtr', 'djinkorea', 'anetherton19', 'posso.mario', 'ssheik22']",6,"['paur2', 'pramesh2', 'zihe.gao', 'jkim440', None, 'jayyao']",37,"['polarisatv4', 'anetherton19', 'ssheik22', 'zihe.gao', 'lappleb2', 'almirk', 'nikhil78888', 'paur2', 'matt.koopmann', 'kapadia3', 'choquett', 'posso.mario', 'jkim440', 'xunyu2', 'mantrarush', 'pvuong3', 'jayyao', 'mhaider2', 'insung0224', 'austin.martinovich', 'djinkorea', 'sangyuno0o', 'pramesh2', 'jofu803', 'alai6', 'tonyinhk', 'fuchslu2', None, 'dvncrtr', 'illini1208', 'lityo2', 'nikola.ivancevic.1', 'yliu160', 'adatia1', 'davidar2', 'broadhurst.josh', 'mjbollan']"
20,106,32,12,1,['ssheik22'],30,"['polarisatv4', 'anetherton19', 'lappleb2', 'almirk', 'nikhil78888', 'matt.koopmann', 'kapadia3', 'choquett', 'posso.mario', 'xunyu2', 'mantrarush', 'pvuong3', 'mhaider2', 'insung0224', 'austin.martinovich', 'djinkorea', 'sangyuno0o', 'jofu803', 'alai6', 'tonyinhk', 'fuchslu2', 'dvncrtr', 'illini1208', 'lityo2', 'nikola.ivancevic.1', 'yliu160', 'adatia1', 'davidar2', 'broadhurst.josh', 'mjbollan']",11,"['yhren1993', 'fan.ling.507', 'muttley.mutt', 'madnesswrap', 'forcade1', 'hdou731', 'abheshek18', 'adam.neuses', 'chen.s.jimmy', 'rmadsen2', None]",42,"['polarisatv4', 'yhren1993', 'madnesswrap', 'anetherton19', 'ssheik22', 'adam.neuses', 'lappleb2', 'almirk', 'nikhil78888', 'matt.koopmann', 'kapadia3', 'choquett', 'posso.mario', 'rmadsen2', 'xunyu2', 'mantrarush', 'pvuong3', 'mhaider2', 'insung0224', 'austin.martinovich', 'djinkorea', 'sangyuno0o', 'muttley.mutt', 'jofu803', 'alai6', 'forcade1', 'abheshek18', 'tonyinhk', 'fuchslu2', 'chen.s.jimmy', None, 'dvncrtr', 'illini1208', 'fan.ling.507', 'lityo2', 'nikola.ivancevic.1', 'hdou731', 'yliu160', 'adatia1', 'davidar2', 'broadhurst.josh', 'mjbollan']"
20,188,32,11,1,['ssheik22'],30,"['polarisatv4', 'anetherton19', 'lappleb2', 'almirk', 'nikhil78888', 'matt.koopmann', 'kapadia3', 'choquett', 'posso.mario', 'xunyu2', 'mantrarush', 'pvuong3', 'mhaider2', 'insung0224', 'austin.martinovich', 'djinkorea', 'sangyuno0o', 'jofu803', 'alai6', 'tonyinhk', 'fuchslu2', 'dvncrtr', 'illini1208', 'lityo2', 'nikola.ivancevic.1', 'yliu160', 'adatia1', 'davidar2', 'broadhurst.josh', 'mjbollan']",10,"['nemitz22', 'amencherla2401', 'yhren1993', 'rahful', 'alex.mitsdarfer', 'abheshek18', 'chaken2', 'chen.s.jimmy', 'lee117', None]",41,"['polarisatv4', 'yhren1993', 'anetherton19', 'ssheik22', 'lappleb2', 'almirk', 'lee117', 'nikhil78888', 'amencherla2401', 'matt.koopmann', 'kapadia3', 'alex.mitsdarfer', 'choquett', 'posso.mario', 'chaken2', 'xunyu2', 'mantrarush', 'pvuong3', 'mhaider2', 'nemitz22', 'insung0224', 'austin.martinovich', 'djinkorea', 'sangyuno0o', 'rahful', 'jofu803', 'alai6', 'abheshek18', 'tonyinhk', 'fuchslu2', 'chen.s.jimmy', None, 'dvncrtr', 'illini1208', 'lityo2', 'nikola.ivancevic.1', 'yliu160', 'adatia1', 'davidar2', 'broadhurst.josh', 'mjbollan']"
21,56,29,41,25,"['andersdhenriksen', 'clareclare', 'lejk80', 'zichen', 'ckmckmckmckm', 'carrasquilla', 'rachelhatano', 'phuongbaole', 'sunjane2014', 'skyblue4', 'lewong27', 'gudavalli_r', 'ariel.ashshakoor', 'lnphant', 'ncalvo11', 'chiamori', 'edespeaux', 'sliliana.arias', 'oa3957', 'rahil2', 'jenniferbme90', 'matthew.n.martin', 'memic', 'cmrace', 'dtn0028']",3,"['kaiweili86', 'ngoswam2', 'nasim.m']",16,"['kfisher2', 'sethspitulski', 'sobh', 'kchauhan', 'akiramadono', None, 'sarahwhite603', 'matt.leslie2003', 'barasaadah', 'yaser_yaseen', 'jeremysmith244', 'alqadi2', 'apentecost25', 'dyland', 'ana.aarteaga', 'jparedes4']",44,"['clareclare', 'lejk80', 'zichen', 'andersdhenriksen', 'carrasquilla', 'jeremysmith244', 'phuongbaole', 'sunjane2014', 'lewong27', 'gudavalli_r', 'ariel.ashshakoor', 'lnphant', 'ncalvo11', 'jparedes4', 'chiamori', 'sarahwhite603', 'sliliana.arias', 'oa3957', 'jenniferbme90', 'matt.leslie2003', 'nasim.m', 'ngoswam2', 'sobh', 'kchauhan', 'ckmckmckmckm', 'barasaadah', 'yaser_yaseen', 'rachelhatano', 'ana.aarteaga', 'skyblue4', 'kaiweili86', 'kfisher2', 'edespeaux', 'apentecost25', None, 'sethspitulski', 'rahil2', 'matthew.n.martin', 'akiramadono', 'memic', 'alqadi2', 'cmrace', 'dtn0028', 'dyland']"
21,61,29,9,2,"['oa3957', 'cmrace']",26,"['clareclare', 'andersdhenriksen', 'ngoswam2', 'lejk80', 'zichen', 'ckmckmckmckm', 'carrasquilla', 'rachelhatano', 'phuongbaole', 'sunjane2014', 'skyblue4', 'lewong27', 'gudavalli_r', 'ariel.ashshakoor', 'lnphant', 'kaiweili86', 'ncalvo11', 'chiamori', 'edespeaux', 'sliliana.arias', 'rahil2', 'jenniferbme90', 'matthew.n.martin', 'nasim.m', 'memic', 'dtn0028']",7,"['sobh', 'kchauhan', 'barasaadah', 'jeremysmith244', 'yaser_yaseen', 'alqadi2', None]",35,"['dtn0028', 'ngoswam2', 'clareclare', 'lejk80', 'zichen', 'andersdhenriksen', 'sobh', 'kchauhan', 'edespeaux', 'ckmckmckmckm', 'barasaadah', 'carrasquilla', 'yaser_yaseen', 'jeremysmith244', 'sliliana.arias', 'rachelhatano', 'oa3957', None, 'phuongbaole', 'sunjane2014', 'rahil2', 'skyblue4', 'jenniferbme90', 'lewong27', 'matthew.n.martin', 'gudavalli_r', 'nasim.m', 'ariel.ashshakoor', 'memic', 'cmrace', 'lnphant', 'kaiweili86', 'alqadi2', 'ncalvo11', 'chiamori']"
22,116,29,34,26,"['krystlei', 'sindhureddy25', 'martinrodrz', 'lalithasirigiri', 'obardb', 'huangcw2', 'sarmila_pandiyan', 'varunloya123', 'ivan92', 'studdmuffin9140', 'turkishdlite', 'respiritu1', 'cherishmavadlamudi', 'harshpathak', 'chaitanya.alladi', 'deepikangala', 'jim94', 'henrytai', 'diazdave25', 'bhavik.ec24', 'acastillo', 'usergim', 'harpreeitsaini', 'sindhu13', 'harishdasariraju', 'trushnapatel']",2,"['jcabrera010', 'ahdel']",8,"[None, 'kusumar', 'edsmaildude', 'dhavalsule', 'tetris.battle.14289210', 'kanish_hossain', 'armersuender', 'arundasari']",36,"['krystlei', 'sindhureddy25', 'martinrodrz', 'lalithasirigiri', 'obardb', 'huangcw2', 'sarmila_pandiyan', 'varunloya123', 'dhavalsule', 'ahdel', 'ivan92', 'armersuender', 'studdmuffin9140', 'turkishdlite', 'respiritu1', 'cherishmavadlamudi', 'jcabrera010', 'arundasari', 'harshpathak', 'chaitanya.alladi', 'trushnapatel', 'edsmaildude', 'tetris.battle.14289210', 'kanish_hossain', None, 'jim94', 'henrytai', 'diazdave25', 'kusumar', 'bhavik.ec24', 'acastillo', 'usergim', 'harpreeitsaini', 'sindhu13', 'harishdasariraju', 'deepikangala']"
22,181,29,34,26,"['krystlei', 'sindhureddy25', 'martinrodrz', 'lalithasirigiri', 'obardb', 'huangcw2', 'sarmila_pandiyan', 'varunloya123', 'ahdel', 'ivan92', 'studdmuffin9140', 'turkishdlite', 'respiritu1', 'harshpathak', 'chaitanya.alladi', 'deepikangala', 'jim94', 'henrytai', 'diazdave25', 'bhavik.ec24', 'acastillo', 'usergim', 'harpreeitsaini', 'sindhu13', 'harishdasariraju', 'trushnapatel']",2,"['jcabrera010', 'cherishmavadlamudi']",8,"[None, 'kusumar', 'dhavalsule', 'harpreeit.saini', 'tp1805', 'armersuender', 'arundasari', 'nirmaladasamoni']",36,"['krystlei', 'sindhureddy25', 'martinrodrz', 'lalithasirigiri', 'obardb', 'huangcw2', 'sarmila_pandiyan', 'varunloya123', 'dhavalsule', 'ahdel', 'ivan92', 'armersuender', 'studdmuffin9140', 'turkishdlite', 'respiritu1', 'cherishmavadlamudi', 'jcabrera010', 'arundasari', 'nirmaladasamoni', 'harshpathak', 'chaitanya.alladi', 'trushnapatel', 'harpreeit.saini', None, 'tp1805', 'jim94', 'henrytai', 'diazdave25', 'kusumar', 'bhavik.ec24', 'acastillo', 'usergim', 'harpreeitsaini', 'sindhu13', 'harishdasariraju', 'deepikangala']"
22,20,29,32,26,"['krystlei', 'sindhureddy25', 'martinrodrz', 'lalithasirigiri', 'obardb', 'huangcw2', 'sarmila_pandiyan', 'varunloya123', 'ahdel', 'ivan92', 'studdmuffin9140', 'respiritu1', 'cherishmavadlamudi', 'jcabrera010', 'harshpathak', 'chaitanya.alladi', 'deepikangala', 'jim94', 'henrytai', 'diazdave25', 'acastillo', 'usergim', 'harpreeitsaini', 'sindhu13', 'harishdasariraju', 'trushnapatel']",2,"['turkishdlite', 'bhavik.ec24']",6,"['kusumar', 'nirmaladasamoni', 'kanish_sultana20000', None, 'arundasari', 'tp1805']",34,"['krystlei', 'sindhureddy25', 'martinrodrz', 'lalithasirigiri', 'obardb', 'huangcw2', 'sarmila_pandiyan', 'varunloya123', 'ahdel', 'ivan92', 'studdmuffin9140', 'turkishdlite', 'respiritu1', 'cherishmavadlamudi', 'jcabrera010', 'arundasari', 'nirmaladasamoni', 'harshpathak', 'chaitanya.alladi', 'trushnapatel', None, 'tp1805', 'jim94', 'henrytai', 'diazdave25', 'kusumar', 'bhavik.ec24', 'acastillo', 'usergim', 'harpreeitsaini', 'sindhu13', 'harishdasariraju', 'kanish_sultana20000', 'deepikangala']"
22,96,29,22,17,"['sindhureddy25', 'deepikangala', 'henrytai', 'lalithasirigiri', 'huangcw2', 'cherishmavadlamudi', 'diazdave25', 'bhavik.ec24', 'harshpathak', 'acastillo', 'sarmila_pandiyan', 'chaitanya.alladi', 'harpreeitsaini', 'harishdasariraju', 'ahdel', 'jcabrera010', 'trushnapatel']",11,"['krystlei', 'jim94', 'martinrodrz', 'obardb', 'turkishdlite', 'respiritu1', 'usergim', 'varunloya123', 'sindhu13', 'ivan92', 'studdmuffin9140']",5,"['kusumar', 'shah.manish1', None, 'arundasari', 'nirmaladasamoni']",33,"['krystlei', 'sindhureddy25', 'martinrodrz', 'lalithasirigiri', 'obardb', 'huangcw2', 'sarmila_pandiyan', 'varunloya123', 'ahdel', 'ivan92', 'studdmuffin9140', 'turkishdlite', 'respiritu1', 'cherishmavadlamudi', 'jcabrera010', 'arundasari', 'nirmaladasamoni', 'harshpathak', 'shah.manish1', 'chaitanya.alladi', 'trushnapatel', None, 'jim94', 'henrytai', 'diazdave25', 'kusumar', 'bhavik.ec24', 'acastillo', 'usergim', 'harpreeitsaini', 'sindhu13', 'harishdasariraju', 'deepikangala']"
22,126,29,11,6,"['lalithasirigiri', 'huangcw2', 'harshpathak', 'chaitanya.alladi', 'harishdasariraju', 'studdmuffin9140']",22,"['krystlei', 'sindhureddy25', 'martinrodrz', 'obardb', 'sarmila_pandiyan', 'varunloya123', 'ahdel', 'ivan92', 'turkishdlite', 'respiritu1', 'cherishmavadlamudi', 'jcabrera010', 'deepikangala', 'jim94', 'henrytai', 'diazdave25', 'bhavik.ec24', 'acastillo', 'usergim', 'harpreeitsaini', 'sindhu13', 'trushnapatel']",5,"['kusumar', 'edsmaildude', 'kanish_hossain', None, 'arundasari']",33,"['krystlei', 'sindhureddy25', 'martinrodrz', 'lalithasirigiri', 'obardb', 'huangcw2', 'sarmila_pandiyan', 'varunloya123', 'ahdel', 'ivan92', 'studdmuffin9140', 'turkishdlite', 'respiritu1', 'cherishmavadlamudi', 'jcabrera010', 'arundasari', 'harshpathak', 'chaitanya.alladi', 'trushnapatel', 'edsmaildude', 'kanish_hossain', None, 'jim94', 'henrytai', 'diazdave25', 'kusumar', 'bhavik.ec24', 'acastillo', 'usergim', 'harpreeitsaini', 'sindhu13', 'harishdasariraju', 'deepikangala']"
22,52,29,7,4,"['huangcw2', 'trushnapatel', 'diazdave25', 'henrytai']",24,"['krystlei', 'sindhureddy25', 'martinrodrz', 'lalithasirigiri', 'obardb', 'sarmila_pandiyan', 'varunloya123', 'ahdel', 'ivan92', 'studdmuffin9140', 'turkishdlite', 'respiritu1', 'cherishmavadlamudi', 'jcabrera010', 'harshpathak', 'chaitanya.alladi', 'jim94', 'bhavik.ec24', 'acastillo', 'usergim', 'harpreeitsaini', 'sindhu13', 'harishdasariraju', 'deepikangala']",3,"['kusumar', None, 'nirmaladasamoni']",31,"['krystlei', 'sindhureddy25', 'martinrodrz', 'lalithasirigiri', 'obardb', 'huangcw2', 'harshpathak', 'sarmila_pandiyan', 'varunloya123', 'chaitanya.alladi', 'ahdel', 'ivan92', None, 'studdmuffin9140', 'deepikangala', 'jim94', 'henrytai', 'diazdave25', 'kusumar', 'turkishdlite', 'bhavik.ec24', 'acastillo', 'respiritu1', 'usergim', 'harpreeitsaini', 'sindhu13', 'harishdasariraju', 'cherishmavadlamudi', 'jcabrera010', 'trushnapatel', 'nirmaladasamoni']"
22,180,29,7,4,"['lalithasirigiri', 'huangcw2', 'harpreeitsaini', 'deepikangala']",24,"['krystlei', 'sindhureddy25', 'martinrodrz', 'obardb', 'sarmila_pandiyan', 'varunloya123', 'ahdel', 'ivan92', 'studdmuffin9140', 'turkishdlite', 'respiritu1', 'cherishmavadlamudi', 'jcabrera010', 'harshpathak', 'chaitanya.alladi', 'jim94', 'henrytai', 'diazdave25', 'bhavik.ec24', 'acastillo', 'usergim', 'sindhu13', 'harishdasariraju', 'trushnapatel']",3,"['kusumar', None, 'kiranrajgeorge']",31,"['krystlei', 'sindhureddy25', 'martinrodrz', 'lalithasirigiri', 'obardb', 'huangcw2', 'harshpathak', 'sarmila_pandiyan', 'varunloya123', 'chaitanya.alladi', 'kiranrajgeorge', 'ahdel', 'ivan92', None, 'studdmuffin9140', 'deepikangala', 'jim94', 'henrytai', 'diazdave25', 'kusumar', 'turkishdlite', 'bhavik.ec24', 'acastillo', 'respiritu1', 'usergim', 'harpreeitsaini', 'sindhu13', 'harishdasariraju', 'cherishmavadlamudi', 'jcabrera010', 'trushnapatel']"
23,121,28,11,10,"['pravinms22', 'chaitanyajoshi126', 'koshtisanket148', 'shailu0003', 'kaajal26jain', 'kadamswatis', 'nikhildeshingkar', 'cnjoshi009', 'shahshoaib62', 'smita.smile1993']",17,"['nikdeshingkar', 'stephanmichard', 'anjaliprem.27', 'rsindhuja93', 'joetroughton', 'tomasbar94', 'roody', 'moosegf65', 'siva174sangeetha', 'ankuragarwal', 'chaitali2111', 'yogeshwariece', 'nikhilrmendhe', 'nehaprk28', 'mtechextc', 'andrew.nederhoff', 'mulepradip']",1,[None],28,"['moosegf65', 'yogeshwariece', 'cnjoshi009', 'nehaprk28', 'andrew.nederhoff', 'pravinms22', 'nikdeshingkar', 'stephanmichard', 'anjaliprem.27', 'tomasbar94', 'roody', 'kaajal26jain', 'chaitali2111', 'rsindhuja93', 'chaitanyajoshi126', 'siva174sangeetha', 'ankuragarwal', 'mtechextc', 'smita.smile1993', None, 'mulepradip', 'koshtisanket148', 'joetroughton', 'shailu0003', 'kadamswatis', 'nikhilrmendhe', 'nikhildeshingkar', 'shahshoaib62']"
23,122,28,8,4,"['yogeshwariece', 'anjaliprem.27', 'siva174sangeetha', 'rsindhuja93']",23,"['moosegf65', 'nehaprk28', 'cnjoshi009', 'andrew.nederhoff', 'pravinms22', 'nikdeshingkar', 'stephanmichard', 'tomasbar94', 'roody', 'kaajal26jain', 'chaitali2111', 'chaitanyajoshi126', 'ankuragarwal', 'mtechextc', 'smita.smile1993', 'mulepradip', 'koshtisanket148', 'joetroughton', 'shailu0003', 'kadamswatis', 'nikhilrmendhe', 'nikhildeshingkar', 'shahshoaib62']",4,"['k.p.dhivyakala', None, 'ibzz82', 'urusha14akash']",31,"['chaitanyajoshi126', 'moosegf65', 'siva174sangeetha', 'ankuragarwal', 'yogeshwariece', 'cnjoshi009', 'nehaprk28', 'shahshoaib62', 'mtechextc', 'smita.smile1993', None, 'mulepradip', 'pravinms22', 'nikdeshingkar', 'stephanmichard', 'anjaliprem.27', 'rsindhuja93', 'koshtisanket148', 'tomasbar94', 'roody', 'joetroughton', 'shailu0003', 'kaajal26jain', 'kadamswatis', 'urusha14akash', 'chaitali2111', 'nikhilrmendhe', 'nikhildeshingkar', 'ibzz82', 'k.p.dhivyakala', 'andrew.nederhoff']"
23,123,28,7,6,"['pravinms22', 'kaajal26jain', 'kadamswatis', 'ankuragarwal', 'smita.smile1993', 'mulepradip']",21,"['moosegf65', 'yogeshwariece', 'nehaprk28', 'cnjoshi009', 'andrew.nederhoff', 'nikdeshingkar', 'stephanmichard', 'anjaliprem.27', 'tomasbar94', 'roody', 'chaitali2111', 'rsindhuja93', 'chaitanyajoshi126', 'siva174sangeetha', 'mtechextc', 'koshtisanket148', 'joetroughton', 'shailu0003', 'nikhilrmendhe', 'nikhildeshingkar', 'shahshoaib62']",1,[None],28,"['chaitanyajoshi126', 'moosegf65', 'siva174sangeetha', 'ankuragarwal', 'yogeshwariece', 'cnjoshi009', 'nehaprk28', 'shahshoaib62', 'mtechextc', 'smita.smile1993', None, 'mulepradip', 'pravinms22', 'nikdeshingkar', 'stephanmichard', 'anjaliprem.27', 'rsindhuja93', 'koshtisanket148', 'tomasbar94', 'roody', 'joetroughton', 'shailu0003', 'kaajal26jain', 'kadamswatis', 'chaitali2111', 'nikhilrmendhe', 'nikhildeshingkar', 'andrew.nederhoff']"
23,120,28,6,4,"['nikdeshingkar', 'cnjoshi009', 'mtechextc', 'nikhildeshingkar']",23,"['moosegf65', 'yogeshwariece', 'nehaprk28', 'andrew.nederhoff', 'pravinms22', 'anjaliprem.27', 'stephanmichard', 'tomasbar94', 'roody', 'kaajal26jain', 'chaitali2111', 'rsindhuja93', 'chaitanyajoshi126', 'siva174sangeetha', 'ankuragarwal', 'smita.smile1993', 'mulepradip', 'koshtisanket148', 'joetroughton', 'shailu0003', 'kadamswatis', 'nikhilrmendhe', 'shahshoaib62']",2,"[None, 'manishkumarsharma0911']",29,"['chaitanyajoshi126', 'moosegf65', 'siva174sangeetha', 'ankuragarwal', 'yogeshwariece', 'cnjoshi009', 'nehaprk28', 'shahshoaib62', 'mtechextc', 'smita.smile1993', None, 'mulepradip', 'pravinms22', 'nikdeshingkar', 'stephanmichard', 'anjaliprem.27', 'rsindhuja93', 'koshtisanket148', 'tomasbar94', 'roody', 'joetroughton', 'shailu0003', 'kaajal26jain', 'kadamswatis', 'chaitali2111', 'nikhilrmendhe', 'nikhildeshingkar', 'andrew.nederhoff', 'manishkumarsharma0911']"
24,129,24,36,22,"['afzisson', 'taehee_kim', 'jianfei_zhao', 'hongxia_hao', 'ndsheriff', 'kdillione', 'glowry', 'tkcloutier', 'zgreenburg', 'tegan.tingley', 'ishabubaker', 'karenpchen', 'eric.eisenhauer.16', 'raz.rivlis', 'emilee28nyy', 'gmencoff', 'dante1111', 'yuyang_li', 'junrui.li', 'ewittgrove', 'emily_eruysal', 'collin_felten']",1,['aklee'],14,"['christianz0991', 'jpstevens15', 'lichuheng240', 'youngerlyy', 'raz_rivlis', 'kenny157', 'catherine.a.haay', None, 'andrew_hitt', 'hjweds', 'avery_baumann', 'frchung', 'acerium', 'catherine_a_hay']",37,"['lichuheng240', 'afzisson', 'youngerlyy', 'raz_rivlis', 'taehee_kim', 'jianfei_zhao', 'hongxia_hao', 'ndsheriff', 'kdillione', 'frchung', 'jpstevens15', 'catherine.a.haay', 'glowry', 'tkcloutier', 'zgreenburg', 'tegan.tingley', 'acerium', 'ishabubaker', 'karenpchen', 'christianz0991', 'eric.eisenhauer.16', 'raz.rivlis', 'emilee28nyy', 'gmencoff', 'dante1111', None, 'yuyang_li', 'catherine_a_hay', 'junrui.li', 'kenny157', 'ewittgrove', 'emily_eruysal', 'collin_felten', 'andrew_hitt', 'aklee', 'avery_baumann', 'hjweds']"
24,139,24,31,23,"['afzisson', 'taehee_kim', 'jianfei_zhao', 'hongxia_hao', 'ndsheriff', 'kdillione', 'glowry', 'tkcloutier', 'zgreenburg', 'tegan.tingley', 'ishabubaker', 'karenpchen', 'eric.eisenhauer.16', 'raz.rivlis', 'emilee28nyy', 'gmencoff', 'dante1111', 'yuyang_li', 'junrui.li', 'ewittgrove', 'emily_eruysal', 'collin_felten', 'aklee']",0,[],8,"['jpstevens15', 'lichuheng240', 'bs40', 'frchung', 'andrew_hitt', 'hjweds', 'avery_baumann', None]",31,"['lichuheng240', 'afzisson', 'taehee_kim', 'jianfei_zhao', 'hongxia_hao', 'ndsheriff', 'kdillione', 'frchung', 'jpstevens15', 'bs40', 'glowry', 'tkcloutier', 'zgreenburg', 'tegan.tingley', 'ishabubaker', 'karenpchen', 'eric.eisenhauer.16', 'raz.rivlis', 'emilee28nyy', 'gmencoff', 'dante1111', None, 'yuyang_li', 'junrui.li', 'ewittgrove', 'emily_eruysal', 'collin_felten', 'andrew_hitt', 'aklee', 'avery_baumann', 'hjweds']"
24,128,24,8,6,"['afzisson', 'emily_eruysal', 'emilee28nyy', 'aklee', 'dante1111', 'karenpchen']",17,"['junrui.li', 'ewittgrove', 'eric.eisenhauer.16', 'raz.rivlis', 'collin_felten', 'yuyang_li', 'taehee_kim', 'glowry', 'jianfei_zhao', 'hongxia_hao', 'gmencoff', 'tkcloutier', 'ndsheriff', 'zgreenburg', 'kdillione', 'tegan.tingley', 'ishabubaker']",2,"[None, 'jpstevens15']",25,"['eric.eisenhauer.16', 'raz.rivlis', 'afzisson', 'emilee28nyy', 'taehee_kim', 'jianfei_zhao', 'hongxia_hao', 'gmencoff', 'dante1111', 'ndsheriff', 'kdillione', None, 'yuyang_li', 'junrui.li', 'ewittgrove', 'jpstevens15', 'emily_eruysal', 'collin_felten', 'aklee', 'glowry', 'tkcloutier', 'zgreenburg', 'tegan.tingley', 'ishabubaker', 'karenpchen']"
24,127,24,7,5,"['emily_eruysal', 'emilee28nyy', 'aklee', 'hongxia_hao', 'dante1111']",18,"['junrui.li', 'ewittgrove', 'eric.eisenhauer.16', 'raz.rivlis', 'afzisson', 'collin_felten', 'yuyang_li', 'taehee_kim', 'glowry', 'jianfei_zhao', 'gmencoff', 'tkcloutier', 'ndsheriff', 'zgreenburg', 'kdillione', 'tegan.tingley', 'ishabubaker', 'karenpchen']",2,"['qvas', None]",25,"['eric.eisenhauer.16', 'raz.rivlis', 'afzisson', 'emilee28nyy', 'qvas', 'taehee_kim', 'jianfei_zhao', 'hongxia_hao', 'gmencoff', 'dante1111', 'ndsheriff', 'kdillione', None, 'yuyang_li', 'junrui.li', 'ewittgrove', 'emily_eruysal', 'collin_felten', 'aklee', 'glowry', 'tkcloutier', 'zgreenburg', 'tegan.tingley', 'ishabubaker', 'karenpchen']"
25,83,23,15,13,"['zhuwnthu', 'sdmarch', 'liang.kelly', 'haokai1987', 'gcossio14', 'ngoquangthongphucat', 'omar.badr.904', 'jskhan87', 'rlawogus03', 'keframe', 'kellliangy', 'ksullivan1031', 'allan442433634']",9,"['i7sain', 'bassamnn', 'afrokingsolid', 'fabiodsilva', 'vaibhav.vaidya', 'abhishek.chauhan.965580', 'marcosantonio.jcoelho', 'felipeatondo', 'nitinprasad']",2,"['wenfeng5000', None]",24,"['liang.kelly', 'haokai1987', 'ngoquangthongphucat', 'fabiodsilva', 'vaibhav.vaidya', 'keframe', 'kellliangy', 'omar.badr.904', 'bassamnn', None, 'nitinprasad', 'zhuwnthu', 'i7sain', 'sdmarch', 'afrokingsolid', 'wenfeng5000', 'gcossio14', 'jskhan87', 'rlawogus03', 'abhishek.chauhan.965580', 'marcosantonio.jcoelho', 'felipeatondo', 'ksullivan1031', 'allan442433634']"
25,82,23,6,5,"['sdmarch', 'omar.badr.904', 'keframe', 'ksullivan1031', 'nitinprasad']",17,"['zhuwnthu', 'i7sain', 'bassamnn', 'liang.kelly', 'haokai1987', 'afrokingsolid', 'gcossio14', 'ngoquangthongphucat', 'fabiodsilva', 'rlawogus03', 'vaibhav.vaidya', 'jskhan87', 'marcosantonio.jcoelho', 'kellliangy', 'abhishek.chauhan.965580', 'felipeatondo', 'allan442433634']",1,[None],23,"['liang.kelly', 'haokai1987', 'ngoquangthongphucat', 'fabiodsilva', 'vaibhav.vaidya', 'keframe', 'kellliangy', 'omar.badr.904', 'bassamnn', None, 'nitinprasad', 'zhuwnthu', 'i7sain', 'sdmarch', 'afrokingsolid', 'gcossio14', 'jskhan87', 'rlawogus03', 'abhishek.chauhan.965580', 'marcosantonio.jcoelho', 'felipeatondo', 'ksullivan1031', 'allan442433634']"
26,144,22,30,20,"['bding2', 'sikaufm2', 'darkoscar96', 'biesboe2', 'rmcauliffe', 'ntsherm2', 'mariovaldez', 'jshin17', 'sun57', 'mwitzke', 'sarnmo', 'kcederberg', 'jasminelichen', 'axzhao2', 'vrajend2', 'cheevap2', 'schang47', 'abhutan2', 'tzhu11', 'jbittn2']",1,['sergspe'],10,"['alf', 'me1291441', 'akiramadono', 'kpark39', 'jabeach', 'zjiang18', 'jennytang0426', 'djung31', None, 'gsunnysmile']",31,"['bding2', 'sikaufm2', 'alf', 'darkoscar96', 'biesboe2', 'rmcauliffe', 'kpark39', 'gsunnysmile', 'ntsherm2', 'mariovaldez', 'jshin17', 'sun57', 'mwitzke', 'sarnmo', 'me1291441', 'kcederberg', 'jasminelichen', 'jennytang0426', 'axzhao2', 'djung31', None, 'sergspe', 'vrajend2', 'cheevap2', 'akiramadono', 'schang47', 'abhutan2', 'jabeach', 'zjiang18', 'tzhu11', 'jbittn2']"
26,145,22,19,16,"['jshin17', 'bding2', 'sikaufm2', 'ntsherm2', 'vrajend2', 'sun57', 'mwitzke', 'darkoscar96', 'sarnmo', 'biesboe2', 'cheevap2', 'rmcauliffe', 'schang47', 'kcederberg', 'abhutan2', 'jbittn2']",5,"['sergspe', 'jasminelichen', 'tzhu11', 'axzhao2', 'mariovaldez']",3,"['lijasminechen', None, 'schiavo1']",24,"['bding2', 'sikaufm2', 'darkoscar96', 'biesboe2', 'rmcauliffe', 'ntsherm2', 'schiavo1', 'mariovaldez', 'jshin17', 'lijasminechen', 'sun57', 'mwitzke', 'sarnmo', 'kcederberg', 'jasminelichen', 'axzhao2', None, 'sergspe', 'vrajend2', 'cheevap2', 'schang47', 'abhutan2', 'tzhu11', 'jbittn2']"
27,26,21,15,10,"['aswathyss', 'daughty2390', 'shennes.mathew', 'deepaabraham', 'jeffin.antony.35', 'teakhan', 'abdul.hakeem.9469545', 'cecsplab', 'jyothishb07', 'vabdulkareemv']",10,"['bbakeroot', 'thomsonpmani', 'jm1116.lee', 'krzysztof.koska.9', 'tahir123', 'taeyoung.kim.5686322', 'yaseensherif15', 'jetstream.90', 'ancypmani', 'drakoon34.jk']",5,"['jaison.jacob3', 'george.karamel', 'ajithvvariar1992', 'unni.praveencs', None]",25,"['aswathyss', 'bbakeroot', 'shennes.mathew', 'thomsonpmani', 'krzysztof.koska.9', 'teakhan', 'jetstream.90', 'jyothishb07', 'cecsplab', None, 'jm1116.lee', 'daughty2390', 'jaison.jacob3', 'deepaabraham', 'george.karamel', 'jeffin.antony.35', 'tahir123', 'taeyoung.kim.5686322', 'ajithvvariar1992', 'yaseensherif15', 'abdul.hakeem.9469545', 'unni.praveencs', 'ancypmani', 'vabdulkareemv', 'drakoon34.jk']"
28,76,20,25,19,"['ruilin', 'paigegrett', 'nskr', 'apwc', 'aronius', 'balagnam', 'bryan.eyers', 'wangyich', 'tzmz', 'siyuchen', 'splovera', 'alsholtz', 'maureen.daum', 'peterxsu', 'ldzuniga', 'xiaofji', 'thomas.bajis', 'joshambr', 'sdoering']",0,[],6,"['brettric', 'beyers', 'mnburke', 'rlanigan', 'dogkitter', None]",25,"['ruilin', 'paigegrett', 'nskr', 'apwc', 'aronius', 'balagnam', 'bryan.eyers', 'wangyich', 'mnburke', 'rlanigan', 'dogkitter', 'tzmz', 'siyuchen', 'brettric', 'splovera', 'alsholtz', 'maureen.daum', None, 'peterxsu', 'beyers', 'ldzuniga', 'xiaofji', 'thomas.bajis', 'joshambr', 'sdoering']"
28,146,20,21,17,"['siyuchen', 'aronius', 'peterxsu', 'ruilin', 'balagnam', 'paigegrett', 'bryan.eyers', 'alsholtz', 'ldzuniga', 'xiaofji', 'wangyich', 'nskr', 'thomas.bajis', 'joshambr', 'sdoering', 'apwc', 'maureen.daum']",2,"['tzmz', 'splovera']",4,"['brettric', 'kthorn01', None, 'jintao.chen.39']",23,"['ruilin', 'paigegrett', 'nskr', 'apwc', 'aronius', 'balagnam', 'bryan.eyers', 'jintao.chen.39', 'wangyich', 'tzmz', 'siyuchen', 'brettric', 'splovera', 'alsholtz', 'maureen.daum', None, 'peterxsu', 'ldzuniga', 'xiaofji', 'kthorn01', 'thomas.bajis', 'joshambr', 'sdoering']"
29,27,20,21,9,"['jyothichandran111', 's.divyalakshmi', 'debika26', 'avvaruvenkat225', 'giriedusport', 'apurva3007', 'visheshmk', 'ram14mnt007', 'garimadang']",10,"['saurabhjoshi', 'shruthivs', 'becky0070', 'durga0045', 'esathiyacnr', 'dayakar3', 'bishuishwari', 'nithya0038', 'eswar369', 'gandhamsatish1107']",12,"['swethasmenon', 'athirasudarsananv', 'sabby1611', 'ajitaneogi', 'bishakha1606', 'shivangi30', 'balacool', 'nehavr25', 'durgesh123', 'astjraj', None, 'atulverma1992']",31,"['saurabhjoshi', 'swethasmenon', 'ajitaneogi', 'shivangi30', 'durgesh123', 'eswar369', 'becky0070', 'giriedusport', 'dayakar3', 'bishuishwari', 'ram14mnt007', 'garimadang', 'jyothichandran111', 'athirasudarsananv', 's.divyalakshmi', 'avvaruvenkat225', 'esathiyacnr', 'bishakha1606', 'apurva3007', 'balacool', 'visheshmk', 'nehavr25', 'nithya0038', 'gandhamsatish1107', None, 'durga0045', 'debika26', 'sabby1611', 'astjraj', 'shruthivs', 'atulverma1992']"
29,28,20,21,10,"['jyothichandran111', 's.divyalakshmi', 'debika26', 'avvaruvenkat225', 'giriedusport', 'apurva3007', 'visheshmk', 'shruthivs', 'ram14mnt007', 'garimadang']",9,"['saurabhjoshi', 'becky0070', 'durga0045', 'esathiyacnr', 'dayakar3', 'bishuishwari', 'nithya0038', 'eswar369', 'gandhamsatish1107']",11,"['swethasmenon', 'sabby1611', 'ajitaneogi', 'bishakha1606', 'shivangi30', 'balacool', 'nehavr25', 'durgesh123', 'astjraj', None, 'atulverma1992']",30,"['saurabhjoshi', 'swethasmenon', 'ajitaneogi', 'shivangi30', 'durgesh123', 'eswar369', 'becky0070', 'giriedusport', 'dayakar3', 'bishuishwari', 'ram14mnt007', 'garimadang', 'jyothichandran111', 's.divyalakshmi', 'avvaruvenkat225', 'esathiyacnr', 'bishakha1606', 'apurva3007', 'balacool', 'visheshmk', 'nehavr25', 'nithya0038', 'gandhamsatish1107', None, 'durga0045', 'debika26', 'sabby1611', 'astjraj', 'shruthivs', 'atulverma1992']"
29,30,20,21,3,"['nithya0038', 'esathiyacnr', 'avvaruvenkat225']",16,"['saurabhjoshi', 'jyothichandran111', 'shruthivs', 'becky0070', 's.divyalakshmi', 'gandhamsatish1107', 'durga0045', 'debika26', 'giriedusport', 'apurva3007', 'dayakar3', 'visheshmk', 'bishuishwari', 'eswar369', 'ram14mnt007', 'garimadang']",18,"['kommanaveen51', 'swethasmenon', 'ravitejasolleti', 'rafikul', 'mytheeswaran001', 'ank', 'rhera312', 'sunny.patel361', 'vasi2013nano', 'hasanraza', 'balacool', 'abipriyan3', 'bharathi19', 'saiekhnath', 'suresh047', 'riyadavis', 'karthick30', None]",37,"['saurabhjoshi', 'kommanaveen51', 'swethasmenon', 'sunny.patel361', 'eswar369', 'mytheeswaran001', 'ank', 'becky0070', 'giriedusport', 'dayakar3', 'bishuishwari', 'ram14mnt007', 'garimadang', 'karthick30', 'ravitejasolleti', 'jyothichandran111', 'rafikul', 's.divyalakshmi', 'avvaruvenkat225', 'esathiyacnr', 'apurva3007', 'balacool', 'abipriyan3', 'visheshmk', 'nithya0038', 'bharathi19', 'gandhamsatish1107', None, 'riyadavis', 'rhera312', 'durga0045', 'debika26', 'vasi2013nano', 'suresh047', 'saiekhnath', 'hasanraza', 'shruthivs']"
29,31,20,19,7,"['saurabhjoshi', 'becky0070', 'durga0045', 'esathiyacnr', 'dayakar3', 'bishuishwari', 'eswar369']",12,"['jyothichandran111', 's.divyalakshmi', 'gandhamsatish1107', 'debika26', 'avvaruvenkat225', 'giriedusport', 'apurva3007', 'visheshmk', 'nithya0038', 'shruthivs', 'ram14mnt007', 'garimadang']",12,"['swathimnt0049', 'prathyush14mnt0020', 'vishnusasi', 'pradeep1450', 'swapnildabade70', 'narayanamh123', 'ayushikamalkar', 'joseph207', 'kartik1', 'pawan12', 'jeethu123', None]",31,"['saurabhjoshi', 'pradeep1450', 'swapnildabade70', 'pawan12', 'eswar369', 'swathimnt0049', 'vishnusasi', 'becky0070', 'giriedusport', 'dayakar3', 'bishuishwari', 'ram14mnt007', 'garimadang', 'jeethu123', 'prathyush14mnt0020', 'jyothichandran111', 'narayanamh123', 's.divyalakshmi', 'avvaruvenkat225', 'esathiyacnr', 'apurva3007', 'visheshmk', 'nithya0038', 'gandhamsatish1107', None, 'ayushikamalkar', 'joseph207', 'durga0045', 'kartik1', 'debika26', 'shruthivs']"
29,34,20,19,8,"['becky0070', 's.divyalakshmi', 'esathiyacnr', 'avvaruvenkat225', 'dayakar3', 'bishuishwari', 'shruthivs', 'ram14mnt007']",11,"['saurabhjoshi', 'jyothichandran111', 'durga0045', 'debika26', 'giriedusport', 'apurva3007', 'visheshmk', 'nithya0038', 'eswar369', 'gandhamsatish1107', 'garimadang']",11,"['kommanaveen51', 'ravitejasolleti', 'mytheeswaran001', 'joseph207', 'revathyd14mnt0018', 'syamsai', 'bharathi19', 'suresh047', 'jeethu123', None, 'karthick30']",30,"['saurabhjoshi', 'kommanaveen51', 'eswar369', 'mytheeswaran001', 'becky0070', 'giriedusport', 'dayakar3', 'bishuishwari', 'ram14mnt007', 'garimadang', 'jeethu123', 'karthick30', 'ravitejasolleti', 'jyothichandran111', 's.divyalakshmi', 'avvaruvenkat225', 'esathiyacnr', 'apurva3007', 'visheshmk', 'nithya0038', 'bharathi19', 'gandhamsatish1107', None, 'joseph207', 'durga0045', 'debika26', 'revathyd14mnt0018', 'syamsai', 'suresh047', 'shruthivs']"
29,36,20,18,15,"['saurabhjoshi', 'jyothichandran111', 's.divyalakshmi', 'garimadang', 'debika26', 'avvaruvenkat225', 'esathiyacnr', 'apurva3007', 'dayakar3', 'bishuishwari', 'nithya0038', 'shruthivs', 'ram14mnt007', 'gandhamsatish1107', 'eswar369']",4,"['becky0070', 'durga0045', 'giriedusport', 'visheshmk']",3,"[None, 'taraprasanna', 'pawan12']",22,"['saurabhjoshi', 'jyothichandran111', 's.divyalakshmi', 'avvaruvenkat225', 'esathiyacnr', 'apurva3007', 'visheshmk', 'pawan12', 'nithya0038', 'eswar369', 'gandhamsatish1107', None, 'becky0070', 'durga0045', 'debika26', 'giriedusport', 'dayakar3', 'bishuishwari', 'shruthivs', 'ram14mnt007', 'garimadang', 'taraprasanna']"
29,32,20,17,5,"['saurabhjoshi', 'becky0070', 'durga0045', 'esathiyacnr', 'eswar369']",14,"['jyothichandran111', 's.divyalakshmi', 'gandhamsatish1107', 'debika26', 'avvaruvenkat225', 'giriedusport', 'apurva3007', 'dayakar3', 'visheshmk', 'bishuishwari', 'nithya0038', 'shruthivs', 'ram14mnt007', 'garimadang']",12,"['prathyush14mnt0020', 'swathimnt0049', 'shyampadhi2', 'pradeep1450', 'swapnildabade70', 'narayanamh123', 'vishnusasi', 'ayushikamalkar', 'kartik1', 'pawan12', 'jeethu123', None]",31,"['saurabhjoshi', 'prathyush14mnt0020', 'jyothichandran111', 'pradeep1450', 'swapnildabade70', 'narayanamh123', 's.divyalakshmi', 'avvaruvenkat225', 'esathiyacnr', 'apurva3007', 'visheshmk', 'pawan12', 'nithya0038', 'eswar369', 'gandhamsatish1107', None, 'swathimnt0049', 'shyampadhi2', 'vishnusasi', 'ayushikamalkar', 'becky0070', 'durga0045', 'kartik1', 'debika26', 'jeethu123', 'giriedusport', 'dayakar3', 'bishuishwari', 'shruthivs', 'ram14mnt007', 'garimadang']"
29,29,20,15,1,['gandhamsatish1107'],18,"['saurabhjoshi', 'jyothichandran111', 'shruthivs', 'becky0070', 's.divyalakshmi', 'durga0045', 'debika26', 'avvaruvenkat225', 'giriedusport', 'esathiyacnr', 'apurva3007', 'dayakar3', 'visheshmk', 'bishuishwari', 'nithya0038', 'eswar369', 'ram14mnt007', 'garimadang']",14,"['rafikul', 'shyampadhi2', 'mytheeswaran001', 'rhera312', 'ank', 'sunny.patel361', 'bharathithasan111', 'hasanraza', 'suresh047', 'durgesh123', 'astjraj', 'karthick30', None, 'atulverma1992']",33,"['saurabhjoshi', 'jyothichandran111', 'rafikul', 's.divyalakshmi', 'sunny.patel361', 'avvaruvenkat225', 'esathiyacnr', 'apurva3007', 'visheshmk', 'durgesh123', 'nithya0038', 'eswar369', 'hasanraza', 'gandhamsatish1107', 'karthick30', None, 'mytheeswaran001', 'shyampadhi2', 'rhera312', 'ank', 'becky0070', 'durga0045', 'debika26', 'giriedusport', 'bharathithasan111', 'dayakar3', 'suresh047', 'bishuishwari', 'astjraj', 'shruthivs', 'ram14mnt007', 'garimadang', 'atulverma1992']"
29,35,20,8,4,"['bishuishwari', 's.divyalakshmi', 'shruthivs', 'esathiyacnr']",15,"['saurabhjoshi', 'jyothichandran111', 'becky0070', 'durga0045', 'gandhamsatish1107', 'debika26', 'avvaruvenkat225', 'giriedusport', 'apurva3007', 'dayakar3', 'visheshmk', 'nithya0038', 'eswar369', 'ram14mnt007', 'garimadang']",4,"['revathyd14mnt0018', None, 'taraprasanna', 'rbishakha']",23,"['saurabhjoshi', 'jyothichandran111', 's.divyalakshmi', 'avvaruvenkat225', 'esathiyacnr', 'apurva3007', 'visheshmk', 'nithya0038', 'eswar369', 'gandhamsatish1107', None, 'becky0070', 'durga0045', 'debika26', 'revathyd14mnt0018', 'giriedusport', 'rbishakha', 'dayakar3', 'bishuishwari', 'shruthivs', 'ram14mnt007', 'garimadang', 'taraprasanna']"
30,77,19,23,17,"['mattrandall1', 'wingking18', 'tholomyes', 'ove', 'mah228', 'dxz136', 'disserate', 'svenv', 'ejw89', 'ngt2', 'anthonymartone', 'tqn', 'jmw159', 'mjs289', 'kap90', 'bkb31', 'mmanspeak']",1,['sak140'],6,"['aaron.thompson.3517', 'rsz13', 'williampsmythe', 'rxf131', None, 'jmdege']",24,"['bkb31', 'jmdege', 'mattrandall1', 'wingking18', 'sak140', 'ejw89', 'ngt2', 'rxf131', 'tholomyes', 'dxz136', 'rsz13', 'jmw159', 'mjs289', None, 'mmanspeak', 'aaron.thompson.3517', 'mah228', 'ove', 'disserate', 'svenv', 'anthonymartone', 'tqn', 'kap90', 'williampsmythe']"
30,219,19,20,18,"['mattrandall1', 'wingking18', 'tholomyes', 'ove', 'mah228', 'dxz136', 'sak140', 'disserate', 'svenv', 'ejw89', 'ngt2', 'anthonymartone', 'tqn', 'jmw159', 'mjs289', 'kap90', 'bkb31', 'mmanspeak']",0,[],2,"['jmdegenova', None]",20,"['bkb31', 'mattrandall1', 'wingking18', 'sak140', 'ejw89', 'ngt2', 'tholomyes', 'dxz136', 'jmw159', 'mjs289', None, 'mmanspeak', 'mah228', 'ove', 'disserate', 'svenv', 'anthonymartone', 'tqn', 'jmdegenova', 'kap90']"
31,111,19,15,9,"['kem51', 'morganegoodwin', 'hk150', 'yangziyi99', 'lucyli115', 'wileyds', 'lindsay.mctague', 'jinghua.li.37', 'hanqiwei']",9,"['chang.je', 'psclare', 'utkarsh.columbia', 'jing99', 'justkmy', 'msolis', 'vh71886', 'shruti.rastgi', 'ronanrice']",6,"['teslacheng', 'afrankl', 'benj1986', 'christopher.reyes14', None, 'fam14']",24,"['teslacheng', 'kem51', 'psclare', 'utkarsh.columbia', 'yangziyi99', 'morganegoodwin', 'hk150', 'lucyli115', 'benj1986', 'christopher.reyes14', 'vh71886', 'lindsay.mctague', 'ronanrice', 'shruti.rastgi', None, 'chang.je', 'fam14', 'afrankl', 'jing99', 'justkmy', 'msolis', 'wileyds', 'jinghua.li.37', 'hanqiwei']"
31,131,19,14,9,"['kem51', 'morganegoodwin', 'hk150', 'yangziyi99', 'lucyli115', 'wileyds', 'lindsay.mctague', 'jinghua.li.37', 'hanqiwei']",9,"['chang.je', 'psclare', 'utkarsh.columbia', 'jing99', 'justkmy', 'msolis', 'vh71886', 'shruti.rastgi', 'ronanrice']",5,"['teslacheng', 'benj1986', 'christopher.reyes14', None, 'fam14']",23,"['teslacheng', 'kem51', 'psclare', 'utkarsh.columbia', 'yangziyi99', 'morganegoodwin', 'hk150', 'lucyli115', 'benj1986', 'christopher.reyes14', 'vh71886', 'lindsay.mctague', 'ronanrice', 'shruti.rastgi', None, 'chang.je', 'fam14', 'jing99', 'justkmy', 'msolis', 'wileyds', 'jinghua.li.37', 'hanqiwei']"
31,112,19,13,9,"['chang.je', 'psclare', 'utkarsh.columbia', 'jing99', 'justkmy', 'msolis', 'vh71886', 'shruti.rastgi', 'ronanrice']",9,"['kem51', 'morganegoodwin', 'hk150', 'yangziyi99', 'lucyli115', 'wileyds', 'lindsay.mctague', 'jinghua.li.37', 'hanqiwei']",4,"['mk3697', 'igweckay', 'skibum23', None]",22,"['kem51', 'psclare', 'utkarsh.columbia', 'yangziyi99', 'morganegoodwin', 'hk150', 'lucyli115', 'vh71886', 'lindsay.mctague', 'ronanrice', 'shruti.rastgi', 'skibum23', None, 'mk3697', 'chang.je', 'jing99', 'justkmy', 'msolis', 'igweckay', 'wileyds', 'jinghua.li.37', 'hanqiwei']"
31,133,19,13,9,"['chang.je', 'psclare', 'utkarsh.columbia', 'jing99', 'justkmy', 'msolis', 'vh71886', 'shruti.rastgi', 'ronanrice']",9,"['kem51', 'morganegoodwin', 'hk150', 'yangziyi99', 'lucyli115', 'wileyds', 'lindsay.mctague', 'jinghua.li.37', 'hanqiwei']",4,"['mk3697', 'skibum23', None, 'strocchi']",22,"['kem51', 'psclare', 'utkarsh.columbia', 'yangziyi99', 'morganegoodwin', 'hk150', 'lucyli115', 'vh71886', 'lindsay.mctague', 'ronanrice', 'shruti.rastgi', 'skibum23', None, 'strocchi', 'mk3697', 'chang.je', 'jing99', 'justkmy', 'msolis', 'wileyds', 'jinghua.li.37', 'hanqiwei']"
31,113,19,7,4,"['justkmy', 'msolis', 'psclare', 'vh71886']",14,"['chang.je', 'kem51', 'morganegoodwin', 'utkarsh.columbia', 'yangziyi99', 'hk150', 'jing99', 'lucyli115', 'wileyds', 'shruti.rastgi', 'lindsay.mctague', 'ronanrice', 'jinghua.li.37', 'hanqiwei']",3,"['mk3697', 'igweckay', None]",21,"['kem51', 'psclare', 'utkarsh.columbia', 'yangziyi99', 'morganegoodwin', 'hk150', 'lucyli115', 'vh71886', 'lindsay.mctague', 'ronanrice', 'shruti.rastgi', None, 'mk3697', 'chang.je', 'jing99', 'justkmy', 'msolis', 'igweckay', 'wileyds', 'jinghua.li.37', 'hanqiwei']"
31,114,19,7,3,"['justkmy', 'msolis', 'psclare']",15,"['chang.je', 'kem51', 'morganegoodwin', 'utkarsh.columbia', 'yangziyi99', 'hk150', 'jing99', 'lucyli115', 'vh71886', 'wileyds', 'lindsay.mctague', 'ronanrice', 'jinghua.li.37', 'shruti.rastgi', 'hanqiwei']",4,"['mk3697', 'igweckay', None, 'strocchi']",22,"['kem51', 'psclare', 'utkarsh.columbia', 'yangziyi99', 'morganegoodwin', 'hk150', 'lucyli115', 'vh71886', 'lindsay.mctague', 'ronanrice', 'shruti.rastgi', None, 'strocchi', 'mk3697', 'chang.je', 'jing99', 'justkmy', 'msolis', 'igweckay', 'wileyds', 'jinghua.li.37', 'hanqiwei']"
31,125,19,7,4,"['jing99', 'psclare', 'vh71886', 'shruti.rastgi']",14,"['chang.je', 'kem51', 'morganegoodwin', 'utkarsh.columbia', 'yangziyi99', 'hk150', 'justkmy', 'lucyli115', 'msolis', 'wileyds', 'lindsay.mctague', 'ronanrice', 'jinghua.li.37', 'hanqiwei']",3,"['mk3697', 'igweckay', None]",21,"['kem51', 'psclare', 'utkarsh.columbia', 'yangziyi99', 'morganegoodwin', 'hk150', 'lucyli115', 'vh71886', 'lindsay.mctague', 'ronanrice', 'shruti.rastgi', None, 'mk3697', 'chang.je', 'jing99', 'justkmy', 'msolis', 'igweckay', 'wileyds', 'jinghua.li.37', 'hanqiwei']"
32,212,19,12,9,"['saeedawan88', 'shamsh08', 'raheel.aryan', 'aliiii', 'osama90', 'mirza123', 'ahsandanish18', 'arif.aslam', 'faisalkhan6862']",9,"['ricardo.sierra.75491', 'reifenberger', 'sianano', 'malikliaquat76', 'ntronb', 'amnamaqsood91', 'malikliaquat', 'j790902', 'simonos1290']",3,"['systemengineer', None, 'miuhaq']",21,"['saeedawan88', 'raheel.aryan', 'ntronb', 'amnamaqsood91', 'systemengineer', 'aliiii', 'mirza123', 'malikliaquat', None, 'miuhaq', 'ricardo.sierra.75491', 'reifenberger', 'sianano', 'shamsh08', 'malikliaquat76', 'osama90', 'ahsandanish18', 'arif.aslam', 'j790902', 'faisalkhan6862', 'simonos1290']"
32,213,19,9,7,"['malikliaquat76', 'raheel.aryan', 'amnamaqsood91', 'ahsandanish18', 'malikliaquat', 'arif.aslam', 'faisalkhan6862']",11,"['ricardo.sierra.75491', 'saeedawan88', 'reifenberger', 'sianano', 'shamsh08', 'ntronb', 'aliiii', 'osama90', 'mirza123', 'j790902', 'simonos1290']",2,"['systemengineer', None]",20,"['saeedawan88', 'raheel.aryan', 'ntronb', 'amnamaqsood91', 'systemengineer', 'aliiii', 'mirza123', 'malikliaquat', None, 'ricardo.sierra.75491', 'reifenberger', 'sianano', 'shamsh08', 'malikliaquat76', 'osama90', 'ahsandanish18', 'arif.aslam', 'j790902', 'faisalkhan6862', 'simonos1290']"
33,1,18,16,13,"['unlvengineerj', 'ocampor5', 'ee453student', 'ghimirea', 'manuelr3', 'ianyanga', 'm18091990', 'swinney2', 'kaushiknandan2003', 'kateyhoff18', 'wolvert9', 'lso_093', 'insanaf']",4,"['bandsim', 'esachet', 'vdipuccio', 'himadri.barman.56']",3,"['andy2cool4school', None, 'mookherj']",20,"['vdipuccio', 'manuelr3', 'wolvert9', 'andy2cool4school', 'esachet', 'lso_093', 'bandsim', None, 'unlvengineerj', 'ocampor5', 'ghimirea', 'ee453student', 'm18091990', 'swinney2', 'ianyanga', 'kaushiknandan2003', 'kateyhoff18', 'himadri.barman.56', 'mookherj', 'insanaf']"
34,136,17,23,16,"['jtrousda', 'noah123', 'mjanisch', 'brittanybrandon22', 'sboots', 'angel.huang90', 'ewilliamson', 'kwalcott', 'kcha', 'sbenteftifa', 'akinczewski', 'clundgren', 'atuttle', 'mfersch', 'uqarni', 'jberkowitz']",0,[],7,"['nwass182', 'sp520', 'jabel21', 'spalmersheim', 'elliottsiu', 'slhatch', None]",23,"['nwass182', 'sp520', 'brittanybrandon22', 'sboots', 'angel.huang90', 'kwalcott', 'kcha', 'jberkowitz', 'noah123', 'spalmersheim', 'sbenteftifa', 'atuttle', 'slhatch', 'uqarni', 'ewilliamson', None, 'jtrousda', 'mjanisch', 'jabel21', 'akinczewski', 'clundgren', 'elliottsiu', 'mfersch']"
34,43,17,18,15,"['jtrousda', 'noah123', 'mjanisch', 'brittanybrandon22', 'sboots', 'angel.huang90', 'ewilliamson', 'kcha', 'sbenteftifa', 'akinczewski', 'clundgren', 'atuttle', 'mfersch', 'uqarni', 'jberkowitz']",1,['kwalcott'],3,"['nieder23', None, 'jec279']",19,"['jec279', 'brittanybrandon22', 'sboots', 'angel.huang90', 'ewilliamson', 'kwalcott', 'kcha', 'nieder23', None, 'jberkowitz', 'jtrousda', 'mjanisch', 'noah123', 'sbenteftifa', 'akinczewski', 'clundgren', 'atuttle', 'mfersch', 'uqarni']"
35,147,17,52,12,"['trgordo2', 'lxl370141857', 'angela.huang.501', 'jtcohen2', 'isaacehoffman2', 'dwchris2', 'bsorich32', 'ducharm2', 'tjweber2', 'ajgordon', 'yyang100', 'taperez2']",4,"['bart.teerlinck', 'jonahduerst', 'rajeshraghavan', 'lionbadger']",40,"['jinpeng.zhuo', 'lolipopcarolwang', 'limberg2', 'klwells2', 'stakek2', 'gcnelson33', 'simpkns2', 'gvelard2edu', 'akagti2', 'hmtaylo2', 'gsunnysmile', 'siyi.xu.180', 'hsheng3', 'dtascone92', 'qiujiezhao1994', 'trick2', 'dagapit2', 'dkwok2', 'toglitt2', 'cledesma2331', 'jwsmith6', 'ahli2', 'rflore24', 'fang.the.tall', 'emdeity', 'jmmille6', 'amber.snil', 'kjcsport1', None, 'kfeng', 'csbaile2', 'palchec2', 'tara.cullerton', 'aamurthy', 'alexkim3', 'elin11', 'gargula2', 'danieldli1993', 'tomtang1993', 'eslee5']",56,"['jinpeng.zhuo', 'bsorich32', 'simpkns2', 'gvelard2edu', 'akagti2', 'hmtaylo2', 'siyi.xu.180', 'hsheng3', 'angela.huang.501', 'jonahduerst', 'ducharm2', 'dtascone92', 'taperez2', 'trick2', 'cledesma2331', 'jwsmith6', 'emdeity', 'jmmille6', 'amber.snil', 'csbaile2', 'lionbadger', 'palchec2', 'tara.cullerton', 'alexkim3', 'elin11', 'gargula2', 'tomtang1993', 'yyang100', 'trgordo2', 'klwells2', 'lolipopcarolwang', 'limberg2', 'stakek2', 'gcnelson33', 'tjweber2', 'gsunnysmile', 'lxl370141857', 'jtcohen2', 'qiujiezhao1994', 'dagapit2', 'dkwok2', 'toglitt2', 'isaacehoffman2', 'dwchris2', 'ahli2', 'rflore24', 'fang.the.tall', 'kjcsport1', None, 'ajgordon', 'kfeng', 'aamurthy', 'bart.teerlinck', 'danieldli1993', 'rajeshraghavan', 'eslee5']"
36,65,17,14,9,"['ctowle', 'kai626', 'spostak', 'aleide', 'amcdunn', 'shrutisharma810', 'forestsears', 'luisab', 'bomattix']",7,"['gs4phone', 'almulla2', 'kdoolit', 'paulomib', 'rlangomas', 'maddie.noteware', 'munchun.alex.lai']",5,"['dvanegeren', 'rwatari', 'josehazi', 'shellingford', None]",21,"['gs4phone', 'kai626', 'almulla2', 'dvanegeren', 'spostak', 'munchun.alex.lai', 'paulomib', 'shrutisharma810', 'rwatari', 'rlangomas', 'amcdunn', 'forestsears', None, 'bomattix', 'luisab', 'kdoolit', 'josehazi', 'maddie.noteware', 'shellingford', 'aleide', 'ctowle']"
36,69,17,14,9,"['spostak', 'paulomib', 'amcdunn', 'rlangomas', 'maddie.noteware', 'shrutisharma810', 'forestsears', 'munchun.alex.lai', 'bomattix']",7,"['gs4phone', 'kai626', 'luisab', 'almulla2', 'kdoolit', 'aleide', 'ctowle']",5,"['dvanegeren', 'sonjapostak', 'msuglian', 'rwatari', None]",21,"['gs4phone', 'kai626', 'almulla2', 'dvanegeren', 'spostak', 'munchun.alex.lai', 'msuglian', 'paulomib', 'shrutisharma810', 'rwatari', 'rlangomas', 'amcdunn', 'forestsears', None, 'bomattix', 'luisab', 'kdoolit', 'sonjapostak', 'maddie.noteware', 'aleide', 'ctowle']"
36,68,17,11,6,"['gs4phone', 'almulla2', 'kdoolit', 'munchun.alex.lai', 'maddie.noteware', 'ctowle']",10,"['kai626', 'spostak', 'paulomib', 'shrutisharma810', 'rlangomas', 'amcdunn', 'aleide', 'forestsears', 'luisab', 'bomattix']",5,"['msuglian', 'demkowicz', 'shellingford', None, 'newhooloovoo']",21,"['gs4phone', 'kai626', 'almulla2', 'spostak', 'munchun.alex.lai', 'msuglian', 'paulomib', 'shrutisharma810', 'rlangomas', 'amcdunn', 'forestsears', None, 'newhooloovoo', 'bomattix', 'luisab', 'kdoolit', 'demkowicz', 'maddie.noteware', 'shellingford', 'aleide', 'ctowle']"
36,200,17,11,7,"['spostak', 'aleide', 'paulomib', 'rlangomas', 'amcdunn', 'shrutisharma810', 'bomattix']",9,"['gs4phone', 'kai626', 'luisab', 'almulla2', 'kdoolit', 'munchun.alex.lai', 'maddie.noteware', 'forestsears', 'ctowle']",4,"['shellingford', None, 'rwatari', 'josehazi']",20,"['gs4phone', 'kai626', 'almulla2', 'spostak', 'munchun.alex.lai', 'paulomib', 'shrutisharma810', 'rwatari', 'rlangomas', 'amcdunn', 'forestsears', None, 'bomattix', 'luisab', 'kdoolit', 'josehazi', 'maddie.noteware', 'shellingford', 'aleide', 'ctowle']"
36,66,17,9,3,"['kdoolit', 'gs4phone', 'munchun.alex.lai']",13,"['kai626', 'luisab', 'almulla2', 'spostak', 'paulomib', 'shrutisharma810', 'rlangomas', 'amcdunn', 'maddie.noteware', 'aleide', 'forestsears', 'ctowle', 'bomattix']",6,"['gracegu', 'mulla', 'demkowicz', 'akido707', 'shellingford', None]",22,"['gs4phone', 'kai626', 'almulla2', 'spostak', 'gracegu', 'munchun.alex.lai', 'paulomib', 'shrutisharma810', 'rlangomas', 'amcdunn', 'akido707', 'forestsears', None, 'bomattix', 'luisab', 'kdoolit', 'mulla', 'demkowicz', 'maddie.noteware', 'shellingford', 'aleide', 'ctowle']"
36,199,17,8,5,"['gs4phone', 'kdoolit', 'munchun.alex.lai', 'maddie.noteware', 'ctowle']",11,"['kai626', 'almulla2', 'spostak', 'paulomib', 'shrutisharma810', 'rlangomas', 'amcdunn', 'aleide', 'forestsears', 'luisab', 'bomattix']",3,"['shellingford', None, 'gracegu']",19,"['gs4phone', 'kai626', 'almulla2', 'spostak', 'gracegu', 'munchun.alex.lai', 'paulomib', 'shrutisharma810', 'rlangomas', 'amcdunn', 'forestsears', None, 'bomattix', 'luisab', 'kdoolit', 'maddie.noteware', 'shellingford', 'aleide', 'ctowle']"
36,48,17,6,5,"['spostak', 'rlangomas', 'amcdunn', 'shrutisharma810', 'forestsears']",11,"['gs4phone', 'kai626', 'luisab', 'almulla2', 'kdoolit', 'munchun.alex.lai', 'paulomib', 'maddie.noteware', 'aleide', 'ctowle', 'bomattix']",1,[None],17,"['gs4phone', 'kai626', 'almulla2', 'spostak', 'munchun.alex.lai', 'paulomib', 'shrutisharma810', 'rlangomas', 'amcdunn', 'forestsears', None, 'bomattix', 'luisab', 'kdoolit', 'maddie.noteware', 'aleide', 'ctowle']"
37,172,17,27,7,"['polacasper3', 'amrghoniem94', 'jam4you30', 'engam1993', 'mahmoud.nagib', 'seddiqmostafa39', 'mahmod']",9,"['traumanshow', 'dia2hamdy', 'hadeer.ibrahim.73', 'kero.raafat.9', 'mahmoud_elgamal', 'mohamed_mahmoud', 'ahmed.badawy2020', 'ahmedelsayed', 'hassanelassal99']",20,"['moataz.ebrahim1', 'mavea_800', 'm.o.ahmed55', 'omarhesham578', 'dinahany52', 'mai.hosny.16', 'ahmed.heshamglal', 'hassan.m.ahmed93', 'mostafa.elsayeh.1', 'mazenhesham', 'a7med3la2', 'shazasalem92', 'asmaa.mostafa.581', 'esrraahamdy', None, 'ahmed.salah6713', 'ykholousy', 'rodina.magdy.9', 'omnia12347', 'bloomymud']",36,"['traumanshow', 'dia2hamdy', 'jam4you30', 'hadeer.ibrahim.73', 'mahmoud_elgamal', 'moataz.ebrahim1', 'ahmed.badawy2020', 'mavea_800', 'seddiqmostafa39', 'mahmod', 'm.o.ahmed55', 'omarhesham578', 'dinahany52', 'mai.hosny.16', 'ahmed.heshamglal', 'hassan.m.ahmed93', 'mahmoud.nagib', 'mostafa.elsayeh.1', 'mazenhesham', 'a7med3la2', 'kero.raafat.9', 'shazasalem92', 'asmaa.mostafa.581', 'mohamed_mahmoud', 'esrraahamdy', 'hassanelassal99', None, 'ahmed.salah6713', 'polacasper3', 'ykholousy', 'amrghoniem94', 'rodina.magdy.9', 'engam1993', 'omnia12347', 'bloomymud', 'ahmedelsayed']"
37,108,17,21,11,"['polacasper3', 'amrghoniem94', 'jam4you30', 'hadeer.ibrahim.73', 'engam1993', 'hassanelassal99', 'mohamed_mahmoud', 'ahmedelsayed', 'mahmoud.nagib', 'seddiqmostafa39', 'mahmod']",5,"['traumanshow', 'dia2hamdy', 'kero.raafat.9', 'mahmoud_elgamal', 'ahmed.badawy2020']",10,"['mazenhesham', 'ykholousy', 'omarhesham578', 'a7med3la2', 'omnia12347', 'mavea_800', 'engabdelrahman', None, 'fattoh', 'ahmed.salah6713']",26,"['mazenhesham', 'traumanshow', 'dia2hamdy', 'jam4you30', 'hadeer.ibrahim.73', 'a7med3la2', 'kero.raafat.9', 'mahmoud_elgamal', 'mohamed_mahmoud', 'ahmed.badawy2020', 'mavea_800', 'seddiqmostafa39', 'engabdelrahman', 'mahmod', 'hassanelassal99', None, 'fattoh', 'ahmed.salah6713', 'polacasper3', 'ykholousy', 'omarhesham578', 'amrghoniem94', 'engam1993', 'omnia12347', 'ahmedelsayed', 'mahmoud.nagib']"
37,170,17,16,4,"['ahmedelsayed', 'mohamed_mahmoud', 'ahmed.badawy2020', 'engam1993']",12,"['traumanshow', 'polacasper3', 'amrghoniem94', 'jam4you30', 'dia2hamdy', 'hadeer.ibrahim.73', 'kero.raafat.9', 'mahmoud_elgamal', 'hassanelassal99', 'mahmoud.nagib', 'seddiqmostafa39', 'mahmod']",12,"['krepton', 'eng.mustafa.k', 'abdelrahman.heikal', 'amnsawaby', 'eng.somayaahmed', 'omnia12347', 'omnia.mahmoud', 'amr1992ahmed', 'engabdelrahman', 'mmorsy1981', None, 'secondprep.2013']",28,"['traumanshow', 'krepton', 'dia2hamdy', 'jam4you30', 'hadeer.ibrahim.73', 'kero.raafat.9', 'mahmoud_elgamal', 'eng.somayaahmed', 'omnia.mahmoud', 'mohamed_mahmoud', 'ahmed.badawy2020', 'amr1992ahmed', 'seddiqmostafa39', 'engabdelrahman', 'mahmod', 'hassanelassal99', None, 'polacasper3', 'eng.mustafa.k', 'amrghoniem94', 'abdelrahman.heikal', 'amnsawaby', 'engam1993', 'omnia12347', 'ahmedelsayed', 'mahmoud.nagib', 'mmorsy1981', 'secondprep.2013']"
37,171,17,12,5,"['amrghoniem94', 'jam4you30', 'engam1993', 'mohamed_mahmoud', 'seddiqmostafa39']",11,"['traumanshow', 'polacasper3', 'dia2hamdy', 'hadeer.ibrahim.73', 'kero.raafat.9', 'mahmoud_elgamal', 'hassanelassal99', 'ahmed.badawy2020', 'ahmedelsayed', 'mahmoud.nagib', 'mahmod']",7,"['omarhesham578', 'mai.hosny.16', 'a7med3la2', 'ahmed.heshamglal', 'engabdelrahman', None, 'ahmed.salah6713']",23,"['traumanshow', 'dia2hamdy', 'jam4you30', 'hadeer.ibrahim.73', 'a7med3la2', 'kero.raafat.9', 'mahmoud_elgamal', 'mohamed_mahmoud', 'ahmed.badawy2020', 'seddiqmostafa39', 'engabdelrahman', 'mahmod', 'hassanelassal99', None, 'ahmed.salah6713', 'polacasper3', 'omarhesham578', 'amrghoniem94', 'mai.hosny.16', 'engam1993', 'ahmed.heshamglal', 'ahmedelsayed', 'mahmoud.nagib']"
37,169,17,10,3,"['engam1993', 'hassanelassal99', 'jam4you30']",13,"['traumanshow', 'polacasper3', 'amrghoniem94', 'dia2hamdy', 'hadeer.ibrahim.73', 'kero.raafat.9', 'mahmoud_elgamal', 'mohamed_mahmoud', 'ahmed.badawy2020', 'ahmedelsayed', 'mahmoud.nagib', 'seddiqmostafa39', 'mahmod']",7,"['moh.mostafa.92', 'saeeed3', 'waelazzam54', 'amnsawaby', 'eng.somayaahmed', None, 'amaassg']",23,"['traumanshow', 'moh.mostafa.92', 'dia2hamdy', 'jam4you30', 'hadeer.ibrahim.73', 'waelazzam54', 'kero.raafat.9', 'mahmoud_elgamal', 'eng.somayaahmed', 'mohamed_mahmoud', 'ahmed.badawy2020', 'seddiqmostafa39', 'mahmod', 'hassanelassal99', None, 'amaassg', 'polacasper3', 'amrghoniem94', 'saeeed3', 'amnsawaby', 'engam1993', 'ahmedelsayed', 'mahmoud.nagib']"
38,185,17,46,16,"['smohsin16', 'saleil.bhat', 'tonid', 'jjw2170', 'ajorquera', 'rsv2111', 'de2313', 'steev16', 'nikoala3', 'benthezhu', 'neilorzechowski', 'jessicazhao', 'jmd2251', 'hekle', 'gmackcrane', 'cedricmayer']",0,[],30,"['serena.shahsimpson', 'ka2531', 'syed.mohsin.311', 'csyolen', 'yangyx', 'david.boucard', 'gkewley87', 'houseoflastwords', 'zhenghao', 'giovanna.silvateixeira', 'dmarsed18', 'johnkym', 'nazlituncer94', 'lfv2108', 'shen92', 'jy2537', None, 'antonio_soild_state', 'gayathriraj', 'jeffrey11366', 'nilespaulthethird', 'ndg2119', 'af2791', 'shenyz', 'frostgyt', 'wuyi0623', 'dms2264', 'harrisonliew', 'dps2144', 'aji2112']",46,"['serena.shahsimpson', 'smohsin16', 'saleil.bhat', 'ka2531', 'syed.mohsin.311', 'de2313', 'csyolen', 'steev16', 'yangyx', 'david.boucard', 'jessicazhao', 'gkewley87', 'cedricmayer', 'tonid', 'houseoflastwords', 'nikoala3', 'neilorzechowski', 'giovanna.silvateixeira', 'dmarsed18', 'hekle', 'zhenghao', 'johnkym', 'jjw2170', 'nazlituncer94', 'ajorquera', 'lfv2108', 'shen92', 'jy2537', 'benthezhu', 'jmd2251', None, 'antonio_soild_state', 'gayathriraj', 'jeffrey11366', 'nilespaulthethird', 'ndg2119', 'af2791', 'shenyz', 'frostgyt', 'rsv2111', 'wuyi0623', 'dms2264', 'harrisonliew', 'dps2144', 'gmackcrane', 'aji2112']"
38,158,17,42,16,"['smohsin16', 'saleil.bhat', 'tonid', 'jjw2170', 'ajorquera', 'rsv2111', 'de2313', 'steev16', 'nikoala3', 'benthezhu', 'neilorzechowski', 'jessicazhao', 'jmd2251', 'hekle', 'gmackcrane', 'cedricmayer']",0,[],26,"['serena.shahsimpson', 'ka2531', 'csyolen', 'yangyx', 'gkewley87', 'houseoflastwords', 'giovanna.silvateixeira', 'dmarsed18', 'johnkym', 'keith.alexanderpapa', 'lfv2108', 'shen92', 'jy2537', 'chf2117', None, 'antonio_soild_state', 'sv2340', 'gayathriraj', 'nilespaulthethird', 'ndg2119', 'frostgyt', 'af2791', 'dms2264', 'harrisonliew', 'dps2144', 'aji2112']",42,"['serena.shahsimpson', 'smohsin16', 'saleil.bhat', 'ka2531', 'de2313', 'csyolen', 'steev16', 'yangyx', 'jessicazhao', 'gkewley87', 'cedricmayer', 'tonid', 'houseoflastwords', 'nikoala3', 'neilorzechowski', 'giovanna.silvateixeira', 'dmarsed18', 'hekle', 'johnkym', 'keith.alexanderpapa', 'jjw2170', 'ajorquera', 'lfv2108', 'shen92', 'jy2537', 'benthezhu', 'jmd2251', 'chf2117', None, 'sv2340', 'gayathriraj', 'antonio_soild_state', 'nilespaulthethird', 'ndg2119', 'frostgyt', 'af2791', 'rsv2111', 'dms2264', 'harrisonliew', 'dps2144', 'gmackcrane', 'aji2112']"
38,115,17,38,16,"['smohsin16', 'saleil.bhat', 'tonid', 'jjw2170', 'ajorquera', 'rsv2111', 'de2313', 'steev16', 'nikoala3', 'benthezhu', 'neilorzechowski', 'jessicazhao', 'jmd2251', 'hekle', 'gmackcrane', 'cedricmayer']",0,[],22,"['ka2531', 'yangyx', 'gkewley87', 'caleb.fujimori', 'houseoflastwords', 'giovanna.silvateixeira', 'dmarsed18', 'zhenghao', 'nazlituncer94', 'lfv2108', 'jy2537', None, 'jeffrey11366', 'nilespaulthethird', 'ndg2119', 'frostgyt', 'af2791', 'wuyi0623', 'dms2264', 'harrisonliew', 'dps2144', 'aji2112']",38,"['smohsin16', 'saleil.bhat', 'ka2531', 'de2313', 'steev16', 'yangyx', 'jessicazhao', 'gkewley87', 'caleb.fujimori', 'cedricmayer', 'tonid', 'houseoflastwords', 'nikoala3', 'neilorzechowski', 'dmarsed18', 'giovanna.silvateixeira', 'hekle', 'zhenghao', 'jjw2170', 'nazlituncer94', 'ajorquera', 'lfv2108', 'jy2537', 'benthezhu', 'jmd2251', None, 'jeffrey11366', 'nilespaulthethird', 'ndg2119', 'frostgyt', 'af2791', 'rsv2111', 'wuyi0623', 'dms2264', 'harrisonliew', 'dps2144', 'gmackcrane', 'aji2112']"
38,102,17,35,15,"['smohsin16', 'saleil.bhat', 'tonid', 'jjw2170', 'rsv2111', 'de2313', 'steev16', 'nikoala3', 'benthezhu', 'neilorzechowski', 'jessicazhao', 'jmd2251', 'hekle', 'gmackcrane', 'cedricmayer']",1,['ajorquera'],20,"['ka2531', 'csyolen', 'yangyx', 'gkewley87', 'houseoflastwords', 'giovanna.silvateixeira', 'dmarsed18', 'nazlituncer94', 'lfv2108', None, 'jeffrey11366', 'nilespaulthethird', 'ndg2119', 'frostgyt', 'af2791', 'wuyi0623', 'dms2264', 'harrisonliew', 'dps2144', 'aji2112']",36,"['smohsin16', 'saleil.bhat', 'ka2531', 'de2313', 'csyolen', 'steev16', 'yangyx', 'jessicazhao', 'gkewley87', 'cedricmayer', 'tonid', 'houseoflastwords', 'nikoala3', 'neilorzechowski', 'giovanna.silvateixeira', 'dmarsed18', 'hekle', 'jjw2170', 'nazlituncer94', 'ajorquera', 'lfv2108', 'benthezhu', 'jmd2251', None, 'jeffrey11366', 'nilespaulthethird', 'ndg2119', 'frostgyt', 'af2791', 'rsv2111', 'wuyi0623', 'dms2264', 'harrisonliew', 'dps2144', 'gmackcrane', 'aji2112']"
38,164,17,32,15,"['smohsin16', 'saleil.bhat', 'tonid', 'jjw2170', 'ajorquera', 'rsv2111', 'steev16', 'nikoala3', 'benthezhu', 'neilorzechowski', 'jessicazhao', 'jmd2251', 'hekle', 'gmackcrane', 'cedricmayer']",1,['de2313'],17,"['jeffrey11366', 'ndg2119', 'af2791', 'houseoflastwords', 'nazlituncer94', 'ka2531', 'ab3914', 'lfv2108', None, 'wuyi0623', 'yangyx', 'dms2264', 'harrisonliew', 'gkewley87', 'giovanna.silvateixeira', 'caleb.fujimori', 'dmarsed18']",33,"['smohsin16', 'saleil.bhat', 'ka2531', 'de2313', 'steev16', 'yangyx', 'jessicazhao', 'gkewley87', 'caleb.fujimori', 'cedricmayer', 'tonid', 'houseoflastwords', 'nikoala3', 'neilorzechowski', 'giovanna.silvateixeira', 'dmarsed18', 'hekle', 'jjw2170', 'nazlituncer94', 'ab3914', 'ajorquera', 'lfv2108', 'benthezhu', 'jmd2251', None, 'jeffrey11366', 'ndg2119', 'af2791', 'rsv2111', 'wuyi0623', 'dms2264', 'harrisonliew', 'gmackcrane']"
38,37,17,28,14,"['smohsin16', 'saleil.bhat', 'tonid', 'jjw2170', 'rsv2111', 'de2313', 'steev16', 'nikoala3', 'benthezhu', 'neilorzechowski', 'jessicazhao', 'jmd2251', 'hekle', 'cedricmayer']",2,"['ajorquera', 'gmackcrane']",14,"['frostgyt', 'houseoflastwords', 'nazlituncer94', 'ka2531', 'lfv2108', 'wuyi0623', 'jy2537', 'yangyx', 'harrisonliew', 'dps2144', 'gkewley87', 'dmarsed18', 'caleb.fujimori', None]",30,"['smohsin16', 'saleil.bhat', 'ka2531', 'de2313', 'steev16', 'yangyx', 'jessicazhao', 'gkewley87', 'caleb.fujimori', 'cedricmayer', 'tonid', 'houseoflastwords', 'nikoala3', 'neilorzechowski', 'dmarsed18', 'hekle', 'jjw2170', 'nazlituncer94', 'ajorquera', 'lfv2108', 'jy2537', 'benthezhu', 'jmd2251', None, 'frostgyt', 'rsv2111', 'wuyi0623', 'harrisonliew', 'dps2144', 'gmackcrane']"
38,103,17,22,12,"['smohsin16', 'saleil.bhat', 'tonid', 'jjw2170', 'rsv2111', 'de2313', 'steev16', 'nikoala3', 'benthezhu', 'neilorzechowski', 'jmd2251', 'hekle']",4,"['cedricmayer', 'ajorquera', 'gmackcrane', 'jessicazhao']",10,"['houseoflastwords', 'nazlituncer94', 'ka2531', 'lfv2108', 'harrisonliew', 'dps2144', 'gkewley87', 'dmarsed18', 'caleb.fujimori', None]",26,"['smohsin16', 'saleil.bhat', 'ka2531', 'de2313', 'steev16', 'jessicazhao', 'gkewley87', 'caleb.fujimori', 'cedricmayer', 'tonid', 'houseoflastwords', 'nikoala3', 'neilorzechowski', 'dmarsed18', 'hekle', 'jjw2170', 'nazlituncer94', 'ajorquera', 'lfv2108', 'benthezhu', 'jmd2251', None, 'rsv2111', 'harrisonliew', 'dps2144', 'gmackcrane']"
38,187,17,11,1,['de2313'],15,"['smohsin16', 'saleil.bhat', 'tonid', 'jjw2170', 'ajorquera', 'rsv2111', 'steev16', 'nikoala3', 'benthezhu', 'neilorzechowski', 'jessicazhao', 'jmd2251', 'hekle', 'gmackcrane', 'cedricmayer']",10,"['flie2illinois', 'themightybaloon88', 'chien8', 'sahn15', 'wchi2', 'rxiao3', 'qhu12', 'edennis3', None, 'stps']",26,"['smohsin16', 'saleil.bhat', 'jjw2170', 'flie2illinois', 'themightybaloon88', 'ajorquera', 'de2313', 'steev16', 'benthezhu', 'wchi2', 'qhu12', 'jessicazhao', 'edennis3', 'jmd2251', None, 'cedricmayer', 'tonid', 'rsv2111', 'chien8', 'sahn15', 'nikoala3', 'rxiao3', 'neilorzechowski', 'hekle', 'gmackcrane', 'stps']"
38,104,17,9,6,"['saleil.bhat', 'tonid', 'rsv2111', 'de2313', 'steev16', 'jmd2251']",10,"['smohsin16', 'jjw2170', 'ajorquera', 'nikoala3', 'benthezhu', 'neilorzechowski', 'jessicazhao', 'hekle', 'gmackcrane', 'cedricmayer']",3,"['zhenghao', 'lfv2108', None]",19,"['smohsin16', 'saleil.bhat', 'jjw2170', 'ajorquera', 'lfv2108', 'de2313', 'steev16', 'benthezhu', 'jessicazhao', 'jmd2251', None, 'cedricmayer', 'tonid', 'rsv2111', 'nikoala3', 'neilorzechowski', 'zhenghao', 'hekle', 'gmackcrane']"
38,118,17,8,2,"['jmd2251', 'tonid']",14,"['smohsin16', 'saleil.bhat', 'jjw2170', 'ajorquera', 'rsv2111', 'de2313', 'steev16', 'nikoala3', 'benthezhu', 'neilorzechowski', 'jessicazhao', 'hekle', 'gmackcrane', 'cedricmayer']",6,"['ndg2119', 'nazlituncer94', 'lfv2108', 'wuyi0623', 'zhenghao', None]",22,"['smohsin16', 'saleil.bhat', 'jjw2170', 'nazlituncer94', 'ajorquera', 'lfv2108', 'de2313', 'steev16', 'benthezhu', 'jessicazhao', 'jmd2251', None, 'cedricmayer', 'ndg2119', 'tonid', 'rsv2111', 'wuyi0623', 'nikoala3', 'neilorzechowski', 'zhenghao', 'hekle', 'gmackcrane']"
38,168,17,7,3,"['jmd2251', 'tonid', 'jjw2170']",13,"['smohsin16', 'saleil.bhat', 'ajorquera', 'rsv2111', 'de2313', 'steev16', 'nikoala3', 'benthezhu', 'neilorzechowski', 'jessicazhao', 'hekle', 'gmackcrane', 'cedricmayer']",4,"['caleb.fujimori', 'gkewley87', 'lfv2108', None]",20,"['smohsin16', 'saleil.bhat', 'jjw2170', 'ajorquera', 'lfv2108', 'de2313', 'steev16', 'benthezhu', 'jessicazhao', 'gkewley87', 'jmd2251', 'caleb.fujimori', None, 'cedricmayer', 'tonid', 'rsv2111', 'nikoala3', 'neilorzechowski', 'hekle', 'gmackcrane']"
39,76,16,25,4,"['beyers', 'dogkitter', 'rlanigan', 'mnburke']",11,"['y7958223', 'canitz', 'quantumnet', 'rsz13', 'aleperezme', 'darnok', 'puckjojo', 'aleenakaitlyn', 'williampsmythe', 'panya0320', 'jmdege']",21,"['ruilin', 'paigegrett', 'nskr', 'apwc', 'aronius', 'balagnam', 'bryan.eyers', 'wangyich', 'tzmz', 'siyuchen', 'brettric', 'splovera', 'alsholtz', 'maureen.daum', None, 'peterxsu', 'ldzuniga', 'xiaofji', 'thomas.bajis', 'joshambr', 'sdoering']",36,"['ruilin', 'paigegrett', 'aleperezme', 'darnok', 'nskr', 'puckjojo', 'apwc', 'panya0320', 'jmdege', 'y7958223', 'aronius', 'balagnam', 'bryan.eyers', 'mnburke', 'wangyich', 'rlanigan', 'aleenakaitlyn', 'dogkitter', 'tzmz', 'siyuchen', 'brettric', 'canitz', 'splovera', 'alsholtz', 'rsz13', 'maureen.daum', None, 'peterxsu', 'beyers', 'quantumnet', 'ldzuniga', 'xiaofji', 'thomas.bajis', 'joshambr', 'sdoering', 'williampsmythe']"
39,77,16,23,3,"['rsz13', 'williampsmythe', 'jmdege']",12,"['y7958223', 'canitz', 'beyers', 'quantumnet', 'aleperezme', 'darnok', 'mnburke', 'rlanigan', 'puckjojo', 'aleenakaitlyn', 'dogkitter', 'panya0320']",20,"['bkb31', 'mattrandall1', 'wingking18', 'ngt2', 'ejw89', 'rxf131', 'tholomyes', 'dxz136', 'mjs289', 'jmw159', None, 'mmanspeak', 'aaron.thompson.3517', 'mah228', 'ove', 'svenv', 'disserate', 'anthonymartone', 'tqn', 'kap90']",35,"['aleperezme', 'darnok', 'puckjojo', 'panya0320', 'jmdege', 'bkb31', 'y7958223', 'mattrandall1', 'wingking18', 'ejw89', 'mnburke', 'ngt2', 'rlanigan', 'aleenakaitlyn', 'dogkitter', 'rxf131', 'canitz', 'tholomyes', 'dxz136', 'rsz13', 'mjs289', 'jmw159', None, 'mmanspeak', 'aaron.thompson.3517', 'mah228', 'ove', 'beyers', 'quantumnet', 'svenv', 'disserate', 'anthonymartone', 'tqn', 'kap90', 'williampsmythe']"
40,175,16,18,12,"['nanohub3412405', 'qiyake', 'wangyi', 'kellylin1993', 'wangxinyu1115', 'aa3243608', 'keshu', 'inmyworld', 'bonggu', 'yf77abc', 'dh393058878', 'zhangrunzhou.zhezhe']",3,"['hacrii', 'tahira1', 'stive882003']",6,"['sunwoodwater', 'demohn', 'kjkj129', 'platole', None, 'frankzhong829475']",21,"['wangyi', 'yf77abc', 'dh393058878', 'wangxinyu1115', 'demohn', 'stive882003', 'bonggu', 'zhangrunzhou.zhezhe', 'qiyake', 'sunwoodwater', 'aa3243608', 'kjkj129', 'inmyworld', 'platole', None, 'nanohub3412405', 'kellylin1993', 'tahira1', 'keshu', 'hacrii', 'frankzhong829475']"
41,40,16,65,12,"['rgowin', 'nmistry1', 'ebaldwin25', 'tklu1', 'bmkral', 'jjhibben', 'acemind', 'matt.flores17', 'thomas901', 'xxbrucexx', 'cfarnsw2', 'dyyoon']",3,"['havvyliu', 'msmekal', 'hcm386']",53,"['kdtyler1', 'bahammon', 'akkisubhu061', 'ntapia720', 'jyliu4', 'jdcox10', 'jerry.chau', 'fendraki', 'talam', 'kkawabat', 'bpravong', 'abdul529', 'jeremy5756', 'armunoz', 'chrismay', 'mamircha', 'rjfarrer', 'iwillzuu', 'space1008', 'chrissuchomski', 'pryan02', 'ferry', 'zjufennizhang', 'nzorob', 'hallchenhust', 'mohad1993', 'thvincent200690', 'bonecrusher', 'raypropoggio', 'csusanto', 'fernando', 'msouzaon', 'chrith', 'vasileska', 'ealfalas', 'joel.g.wright', 'jcm2006', 'sgolwalkar', 'subinkim', 'tpharmon', 'sgares', 'akstempl10', 'ahornbuckle0930', 'elizabethbesenyei', 'shizhisha', None, 'aesquivias', 'nmspirak', 'camackay', 'rpraneeth06', 'mgjaggers', 'andrew.herschfelt', 'gxinchen']",68,"['kdtyler1', 'bahammon', 'akkisubhu061', 'ntapia720', 'thomas901', 'jyliu4', 'jdcox10', 'jerry.chau', 'bmkral', 'fendraki', 'talam', 'kkawabat', 'bpravong', 'abdul529', 'jeremy5756', 'armunoz', 'chrismay', 'mamircha', 'rjfarrer', 'hcm386', 'iwillzuu', 'space1008', 'chrissuchomski', 'jjhibben', 'xxbrucexx', 'rgowin', 'pryan02', 'ferry', 'zjufennizhang', 'acemind', 'nzorob', 'hallchenhust', 'mohad1993', 'gxinchen', 'ebaldwin25', 'thvincent200690', 'bonecrusher', 'raypropoggio', 'csusanto', 'fernando', 'havvyliu', 'cfarnsw2', 'msouzaon', 'chrith', 'vasileska', 'ealfalas', 'joel.g.wright', 'jcm2006', 'sgolwalkar', 'tklu1', 'subinkim', 'tpharmon', 'sgares', 'akstempl10', 'matt.flores17', 'ahornbuckle0930', 'elizabethbesenyei', 'shizhisha', None, 'aesquivias', 'nmspirak', 'nmistry1', 'camackay', 'rpraneeth06', 'mgjaggers', 'andrew.herschfelt', 'msmekal', 'dyyoon']"
41,50,16,55,12,"['rgowin', 'nmistry1', 'ebaldwin25', 'tklu1', 'bmkral', 'jjhibben', 'acemind', 'matt.flores17', 'thomas901', 'xxbrucexx', 'cfarnsw2', 'dyyoon']",3,"['havvyliu', 'msmekal', 'hcm386']",43,"['bahammon', 'mohad1993', 'akkisubhu061', 'ntapia720', 'raypropoggio', 'csusanto', 'fernando', 'nhorvat1', 'jyliu4', 'karthikeya.2009', 'jdcox10', 'msouzaon', 'jerry.chau', 'harshjain2691', 'fendraki', 'talam', 'bpravong', 'ealfalas', 'jeremy5756', 'space1008', 'rjfarrer', 'mamircha', 'sgolwalkar', 'ajh930', 'jcm2006', 'chrissuchomski', 'tpharmon', 'sgares', 'ahornbuckle0930', 'elizabethbesenyei', 'kan.kawabata', None, 'holmano', 'aesquivias', 'pryan02', 'ferry', 'sapman', 'treblitz', 'mpdinan', 'kansan67', 'andrew.herschfelt', 'zjufennizhang', 'nzorob']",58,"['bahammon', 'akkisubhu061', 'ntapia720', 'thomas901', 'jyliu4', 'jdcox10', 'jerry.chau', 'bmkral', 'fendraki', 'talam', 'bpravong', 'jeremy5756', 'space1008', 'rjfarrer', 'mamircha', 'hcm386', 'chrissuchomski', 'jjhibben', 'xxbrucexx', 'kan.kawabata', 'rgowin', 'pryan02', 'ferry', 'mpdinan', 'kansan67', 'zjufennizhang', 'acemind', 'nzorob', 'mohad1993', 'ebaldwin25', 'raypropoggio', 'csusanto', 'fernando', 'nhorvat1', 'havvyliu', 'cfarnsw2', 'karthikeya.2009', 'msouzaon', 'harshjain2691', 'ealfalas', 'jcm2006', 'ajh930', 'sgolwalkar', 'tklu1', 'tpharmon', 'sgares', 'ahornbuckle0930', 'matt.flores17', 'elizabethbesenyei', None, 'holmano', 'aesquivias', 'nmistry1', 'sapman', 'treblitz', 'andrew.herschfelt', 'msmekal', 'dyyoon']"
41,178,16,45,13,"['rgowin', 'nmistry1', 'hcm386', 'ebaldwin25', 'tklu1', 'bmkral', 'jjhibben', 'acemind', 'matt.flores17', 'thomas901', 'xxbrucexx', 'cfarnsw2', 'dyyoon']",2,"['havvyliu', 'msmekal']",32,"['bahammon', 'mohad1993', 'ntapia720', 'raypropoggio', 'csusanto', 'jyliu4', 'jdcox10', 'msouzaon', 'chrith', 'jerry.chau', 'fendraki', 'talam', 'kkawabat', 'ealfalas', 'jeremy5756', 'space1008', 'rjfarrer', 'mamircha', 'jcm2006', 'chrissuchomski', 'tpharmon', 'sgares', 'ahornbuckle0930', 'elizabethbesenyei', 'ejsanch2', None, 'aesquivias', 'pryan02', 'ferry', 'andrew.herschfelt', 'zjufennizhang', 'nzorob']",47,"['bahammon', 'mohad1993', 'ebaldwin25', 'ntapia720', 'raypropoggio', 'csusanto', 'thomas901', 'havvyliu', 'cfarnsw2', 'jyliu4', 'jdcox10', 'msouzaon', 'chrith', 'jerry.chau', 'bmkral', 'fendraki', 'talam', 'kkawabat', 'nzorob', 'ealfalas', 'jeremy5756', 'space1008', 'rjfarrer', 'mamircha', 'jcm2006', 'hcm386', 'tklu1', 'chrissuchomski', 'tpharmon', 'jjhibben', 'acemind', 'sgares', 'ahornbuckle0930', 'matt.flores17', 'xxbrucexx', 'elizabethbesenyei', 'ejsanch2', None, 'aesquivias', 'rgowin', 'pryan02', 'nmistry1', 'ferry', 'andrew.herschfelt', 'zjufennizhang', 'msmekal', 'dyyoon']"
41,81,16,40,12,"['rgowin', 'nmistry1', 'ebaldwin25', 'tklu1', 'bmkral', 'jjhibben', 'acemind', 'matt.flores17', 'thomas901', 'xxbrucexx', 'cfarnsw2', 'dyyoon']",3,"['havvyliu', 'msmekal', 'hcm386']",28,"['bahammon', 'mohad1993', 'ntapia720', 'raypropoggio', 'csusanto', 'nhorvat1', 'jdcox10', 'msouzaon', 'chrith', 'jerry.chau', 'fendraki', 'kkawabat', 'bpravong', 'ealfalas', 'jeremy5756', 'space1008', 'rjfarrer', 'mamircha', 'jcm2006', 'chrissuchomski', 'ahornbuckle0930', 'elizabethbesenyei', None, 'aesquivias', 'pryan02', 'andrew.herschfelt', 'zjufennizhang', 'nzorob']",43,"['bahammon', 'mohad1993', 'ebaldwin25', 'ntapia720', 'raypropoggio', 'csusanto', 'thomas901', 'nhorvat1', 'havvyliu', 'cfarnsw2', 'jdcox10', 'msouzaon', 'chrith', 'jerry.chau', 'bmkral', 'fendraki', 'kkawabat', 'bpravong', 'nzorob', 'ealfalas', 'jeremy5756', 'space1008', 'rjfarrer', 'mamircha', 'jcm2006', 'hcm386', 'tklu1', 'chrissuchomski', 'jjhibben', 'acemind', 'ahornbuckle0930', 'matt.flores17', 'xxbrucexx', 'elizabethbesenyei', None, 'aesquivias', 'rgowin', 'pryan02', 'nmistry1', 'andrew.herschfelt', 'zjufennizhang', 'msmekal', 'dyyoon']"
41,162,16,39,12,"['rgowin', 'nmistry1', 'ebaldwin25', 'tklu1', 'bmkral', 'jjhibben', 'acemind', 'matt.flores17', 'thomas901', 'xxbrucexx', 'cfarnsw2', 'dyyoon']",3,"['havvyliu', 'msmekal', 'hcm386']",27,"['bahammon', 'mohad1993', 'ntapia720', 'raypropoggio', 'csusanto', 'jyliu4', 'jdcox10', 'msouzaon', 'chrith', 'jerry.chau', 'fendraki', 'talam', 'kkawabat', 'bpravong', 'ealfalas', 'jeremy5756', 'rjfarrer', 'mamircha', 'chrissuchomski', 'ahornbuckle0930', 'elizabethbesenyei', None, 'aesquivias', 'pryan02', 'andrew.herschfelt', 'zjufennizhang', 'nzorob']",42,"['bahammon', 'mohad1993', 'ebaldwin25', 'ntapia720', 'raypropoggio', 'csusanto', 'thomas901', 'havvyliu', 'cfarnsw2', 'jyliu4', 'jdcox10', 'msouzaon', 'chrith', 'jerry.chau', 'bmkral', 'fendraki', 'talam', 'kkawabat', 'bpravong', 'nzorob', 'ealfalas', 'jeremy5756', 'rjfarrer', 'mamircha', 'hcm386', 'tklu1', 'chrissuchomski', 'jjhibben', 'acemind', 'ahornbuckle0930', 'matt.flores17', 'xxbrucexx', 'elizabethbesenyei', None, 'aesquivias', 'rgowin', 'pryan02', 'nmistry1', 'andrew.herschfelt', 'zjufennizhang', 'msmekal', 'dyyoon']"
41,149,16,37,12,"['rgowin', 'nmistry1', 'ebaldwin25', 'tklu1', 'bmkral', 'jjhibben', 'acemind', 'matt.flores17', 'thomas901', 'xxbrucexx', 'cfarnsw2', 'dyyoon']",3,"['havvyliu', 'msmekal', 'hcm386']",25,"['mohad1993', 'ntapia720', 'raypropoggio', 'csusanto', 'fernando', 'jdcox10', 'msouzaon', 'chrith', 'kkawabat', 'ealfalas', 'jeremy5756', 'mamircha', 'sgolwalkar', 'chrissuchomski', 'tpharmon', 'sgares', None, 'ejsanch2', 'aesquivias', 'pryan02', 'ferry', 'rpraneeth06', 'mpdinan', 'zjufennizhang', 'nzorob']",40,"['mohad1993', 'ebaldwin25', 'ntapia720', 'raypropoggio', 'csusanto', 'thomas901', 'fernando', 'havvyliu', 'cfarnsw2', 'jdcox10', 'msouzaon', 'chrith', 'bmkral', 'kkawabat', 'nzorob', 'ealfalas', 'jeremy5756', 'mamircha', 'sgolwalkar', 'hcm386', 'tklu1', 'chrissuchomski', 'tpharmon', 'jjhibben', 'acemind', 'sgares', 'matt.flores17', 'xxbrucexx', 'ejsanch2', None, 'aesquivias', 'rgowin', 'pryan02', 'nmistry1', 'ferry', 'rpraneeth06', 'mpdinan', 'zjufennizhang', 'msmekal', 'dyyoon']"
41,86,16,36,10,"['rgowin', 'nmistry1', 'ebaldwin25', 'tklu1', 'bmkral', 'jjhibben', 'matt.flores17', 'thomas901', 'xxbrucexx', 'dyyoon']",5,"['hcm386', 'havvyliu', 'cfarnsw2', 'msmekal', 'acemind']",26,"['bahammon', 'mohad1993', 'ntapia720', 'raypropoggio', 'jyliu4', 'jdcox10', 'msouzaon', 'chrith', 'fendraki', 'talam', 'kkawabat', 'ealfalas', 'jeremy5756', 'jcm2006', 'rjfarrer', 'mamircha', 'chrissuchomski', 'sgares', 'elizabethbesenyei', 'ejsanch2', None, 'aesquivias', 'pryan02', 'andrew.herschfelt', 'zjufennizhang', 'nzorob']",41,"['bahammon', 'mohad1993', 'ebaldwin25', 'ntapia720', 'raypropoggio', 'thomas901', 'havvyliu', 'cfarnsw2', 'jyliu4', 'jdcox10', 'msouzaon', 'chrith', 'bmkral', 'fendraki', 'talam', 'kkawabat', 'nzorob', 'ealfalas', 'jeremy5756', 'jcm2006', 'rjfarrer', 'mamircha', 'hcm386', 'tklu1', 'chrissuchomski', 'jjhibben', 'acemind', 'sgares', 'matt.flores17', 'xxbrucexx', 'elizabethbesenyei', 'ejsanch2', None, 'aesquivias', 'rgowin', 'pryan02', 'nmistry1', 'andrew.herschfelt', 'zjufennizhang', 'msmekal', 'dyyoon']"
41,63,16,35,9,"['rgowin', 'nmistry1', 'ebaldwin25', 'tklu1', 'jjhibben', 'matt.flores17', 'thomas901', 'cfarnsw2', 'acemind']",6,"['hcm386', 'bmkral', 'xxbrucexx', 'havvyliu', 'msmekal', 'dyyoon']",26,"['bahammon', 'mohad1993', 'ntapia720', 'raypropoggio', 'jyliu4', 'jdcox10', 'msouzaon', 'chrith', 'jerry.chau', 'fendraki', 'talam', 'kkawabat', 'bpravong', 'ealfalas', 'jeremy5756', 'jcm2006', 'rjfarrer', 'chrissuchomski', 'elizabethbesenyei', 'ejsanch2', None, 'aesquivias', 'pryan02', 'andrew.herschfelt', 'zjufennizhang', 'nzorob']",41,"['bahammon', 'mohad1993', 'ebaldwin25', 'ntapia720', 'raypropoggio', 'thomas901', 'havvyliu', 'cfarnsw2', 'jyliu4', 'jdcox10', 'msouzaon', 'chrith', 'jerry.chau', 'bmkral', 'fendraki', 'talam', 'kkawabat', 'bpravong', 'nzorob', 'ealfalas', 'jeremy5756', 'jcm2006', 'rjfarrer', 'hcm386', 'tklu1', 'chrissuchomski', 'jjhibben', 'acemind', 'matt.flores17', 'xxbrucexx', 'elizabethbesenyei', 'ejsanch2', None, 'aesquivias', 'rgowin', 'pryan02', 'nmistry1', 'andrew.herschfelt', 'zjufennizhang', 'msmekal', 'dyyoon']"
41,9,16,27,13,"['rgowin', 'nmistry1', 'hcm386', 'ebaldwin25', 'tklu1', 'bmkral', 'jjhibben', 'acemind', 'matt.flores17', 'thomas901', 'xxbrucexx', 'cfarnsw2', 'dyyoon']",2,"['havvyliu', 'msmekal']",14,"['jcm2006', 'rjfarrer', 'bahammon', 'ferry', 'jerry.chau', 'fendraki', 'zjufennizhang', 'talam', 'ealfalas', 'bpravong', 'andrew.herschfelt', None, 'jyliu4', 'chenliangdu']",29,"['bahammon', 'ebaldwin25', 'thomas901', 'havvyliu', 'cfarnsw2', 'jyliu4', 'jerry.chau', 'bmkral', 'fendraki', 'talam', 'bpravong', 'ealfalas', 'chenliangdu', 'jcm2006', 'rjfarrer', 'hcm386', 'tklu1', 'jjhibben', 'acemind', 'matt.flores17', 'xxbrucexx', None, 'rgowin', 'nmistry1', 'ferry', 'andrew.herschfelt', 'zjufennizhang', 'msmekal', 'dyyoon']"
41,189,16,24,4,"['jjhibben', 'nmistry1', 'matt.flores17', 'dyyoon']",11,"['rgowin', 'hcm386', 'ebaldwin25', 'tklu1', 'bmkral', 'acemind', 'thomas901', 'xxbrucexx', 'havvyliu', 'msmekal', 'cfarnsw2']",20,"['mohad1993', 'ntapia720', 'raypropoggio', 'csusanto', 'jerry.chau', 'chrith', 'fendraki', 'kkawabat', 'bpravong', 'ealfalas', 'jeremy5756', 'space1008', 'mamircha', 'chrissuchomski', 'ahornbuckle0930', 'elizabethbesenyei', None, 'aesquivias', 'pryan02', 'nzorob']",35,"['mohad1993', 'ebaldwin25', 'ntapia720', 'raypropoggio', 'csusanto', 'thomas901', 'havvyliu', 'cfarnsw2', 'jerry.chau', 'chrith', 'bmkral', 'fendraki', 'kkawabat', 'bpravong', 'nzorob', 'ealfalas', 'jeremy5756', 'space1008', 'mamircha', 'hcm386', 'tklu1', 'chrissuchomski', 'jjhibben', 'acemind', 'ahornbuckle0930', 'matt.flores17', 'xxbrucexx', 'elizabethbesenyei', None, 'aesquivias', 'rgowin', 'pryan02', 'nmistry1', 'msmekal', 'dyyoon']"
41,117,16,22,1,['nmistry1'],14,"['rgowin', 'hcm386', 'ebaldwin25', 'tklu1', 'bmkral', 'jjhibben', 'acemind', 'matt.flores17', 'thomas901', 'xxbrucexx', 'havvyliu', 'cfarnsw2', 'msmekal', 'dyyoon']",21,"['kdtyler1', 'mohad1993', 'ntapia720', 'raypropoggio', 'csusanto', 'fernando', 'jdcox10', 'msouzaon', 'chrith', 'kkawabat', 'jeremy5756', 'mamircha', 'chrissuchomski', 'tpharmon', 'ahornbuckle0930', 'elizabethbesenyei', 'ejsanch2', None, 'aesquivias', 'pryan02', 'nzorob']",36,"['kdtyler1', 'mohad1993', 'ebaldwin25', 'ntapia720', 'raypropoggio', 'csusanto', 'thomas901', 'fernando', 'havvyliu', 'cfarnsw2', 'jdcox10', 'msouzaon', 'chrith', 'bmkral', 'kkawabat', 'nzorob', 'jeremy5756', 'mamircha', 'hcm386', 'tklu1', 'chrissuchomski', 'tpharmon', 'jjhibben', 'acemind', 'ahornbuckle0930', 'matt.flores17', 'xxbrucexx', 'elizabethbesenyei', None, 'ejsanch2', 'aesquivias', 'rgowin', 'pryan02', 'nmistry1', 'msmekal', 'dyyoon']"
41,12,16,21,9,"['rgowin', 'nmistry1', 'ebaldwin25', 'tklu1', 'jjhibben', 'matt.flores17', 'thomas901', 'cfarnsw2', 'acemind']",6,"['hcm386', 'bmkral', 'xxbrucexx', 'havvyliu', 'msmekal', 'dyyoon']",12,"['jcm2006', 'bahammon', 'msouzaon', 'jerry.chau', 'fendraki', 'zjufennizhang', 'talam', 'ealfalas', 'andrew.herschfelt', 'elizabethbesenyei', None, 'jyliu4']",27,"['bahammon', 'ebaldwin25', 'thomas901', 'havvyliu', 'cfarnsw2', 'jyliu4', 'msouzaon', 'jerry.chau', 'bmkral', 'fendraki', 'talam', 'ealfalas', 'jcm2006', 'hcm386', 'tklu1', 'jjhibben', 'acemind', 'matt.flores17', 'xxbrucexx', 'elizabethbesenyei', None, 'rgowin', 'nmistry1', 'andrew.herschfelt', 'zjufennizhang', 'msmekal', 'dyyoon']"
41,39,16,7,2,"['tklu1', 'acemind']",13,"['rgowin', 'nmistry1', 'hcm386', 'ebaldwin25', 'bmkral', 'jjhibben', 'matt.flores17', 'thomas901', 'xxbrucexx', 'havvyliu', 'cfarnsw2', 'msmekal', 'dyyoon']",5,"['fendraki', 'talam', 'elizabethbesenyei', None, 'ealfalas']",20,"['hcm386', 'ebaldwin25', 'tklu1', 'jjhibben', 'acemind', 'matt.flores17', 'thomas901', 'xxbrucexx', 'havvyliu', 'elizabethbesenyei', None, 'cfarnsw2', 'rgowin', 'nmistry1', 'bmkral', 'fendraki', 'talam', 'ealfalas', 'msmekal', 'dyyoon']"
41,163,16,7,3,"['tklu1', 'cfarnsw2', 'acemind']",12,"['rgowin', 'nmistry1', 'hcm386', 'ebaldwin25', 'bmkral', 'jjhibben', 'matt.flores17', 'thomas901', 'xxbrucexx', 'havvyliu', 'msmekal', 'dyyoon']",4,"[None, 'bahammon', 'talam', 'jyliu4']",19,"['bahammon', 'hcm386', 'ebaldwin25', 'tklu1', 'jjhibben', 'acemind', 'matt.flores17', 'thomas901', 'xxbrucexx', 'havvyliu', None, 'cfarnsw2', 'jyliu4', 'rgowin', 'nmistry1', 'bmkral', 'talam', 'msmekal', 'dyyoon']"
43,40,15,65,13,"['space1008', 'pryan02', 'mamircha', 'mohad1993', 'kdtyler1', 'jdcox10', 'ntapia720', 'chrissuchomski', 'raypropoggio', 'csusanto', 'kkawabat', 'jeremy5756', 'aesquivias']",1,['ejsanch2'],52,"['bahammon', 'dyyoon', 'akkisubhu061', 'thomas901', 'jyliu4', 'jerry.chau', 'bmkral', 'fendraki', 'talam', 'bpravong', 'abdul529', 'armunoz', 'chrismay', 'rjfarrer', 'iwillzuu', 'jjhibben', 'xxbrucexx', 'rgowin', 'ferry', 'zjufennizhang', 'acemind', 'nzorob', 'hallchenhust', 'ebaldwin25', 'thvincent200690', 'bonecrusher', 'fernando', 'cfarnsw2', 'msouzaon', 'chrith', 'vasileska', 'ealfalas', 'joel.g.wright', 'jcm2006', 'sgolwalkar', 'subinkim', 'tklu1', 'tpharmon', 'sgares', 'akstempl10', 'matt.flores17', 'ahornbuckle0930', 'elizabethbesenyei', 'shizhisha', None, 'nmspirak', 'nmistry1', 'camackay', 'rpraneeth06', 'mgjaggers', 'andrew.herschfelt', 'gxinchen']",66,"['kdtyler1', 'bahammon', 'dyyoon', 'akkisubhu061', 'ntapia720', 'thomas901', 'jyliu4', 'jdcox10', 'jerry.chau', 'bmkral', 'fendraki', 'talam', 'kkawabat', 'bpravong', 'abdul529', 'jeremy5756', 'space1008', 'armunoz', 'mamircha', 'chrismay', 'rjfarrer', 'iwillzuu', 'chrissuchomski', 'jjhibben', 'xxbrucexx', 'ejsanch2', 'rgowin', 'pryan02', 'ferry', 'zjufennizhang', 'acemind', 'nzorob', 'hallchenhust', 'mohad1993', 'ebaldwin25', 'thvincent200690', 'bonecrusher', 'raypropoggio', 'csusanto', 'fernando', 'cfarnsw2', 'msouzaon', 'chrith', 'vasileska', 'ealfalas', 'joel.g.wright', 'jcm2006', 'sgolwalkar', 'subinkim', 'tklu1', 'tpharmon', 'sgares', 'akstempl10', 'matt.flores17', 'ahornbuckle0930', 'elizabethbesenyei', 'shizhisha', None, 'aesquivias', 'nmspirak', 'nmistry1', 'camackay', 'rpraneeth06', 'mgjaggers', 'andrew.herschfelt', 'gxinchen']"
43,50,15,55,11,"['space1008', 'pryan02', 'mamircha', 'mohad1993', 'jdcox10', 'ntapia720', 'chrissuchomski', 'raypropoggio', 'csusanto', 'jeremy5756', 'aesquivias']",3,"['kdtyler1', 'ejsanch2', 'kkawabat']",44,"['bahammon', 'akkisubhu061', 'ebaldwin25', 'nhorvat1', 'fernando', 'thomas901', 'cfarnsw2', 'karthikeya.2009', 'jyliu4', 'msouzaon', 'jerry.chau', 'harshjain2691', 'bmkral', 'fendraki', 'talam', 'bpravong', 'nzorob', 'ealfalas', 'jcm2006', 'rjfarrer', 'ajh930', 'sgolwalkar', 'tklu1', 'tpharmon', 'jjhibben', 'sgares', 'acemind', 'ahornbuckle0930', 'matt.flores17', 'xxbrucexx', 'elizabethbesenyei', 'kan.kawabata', None, 'holmano', 'rgowin', 'nmistry1', 'ferry', 'sapman', 'treblitz', 'mpdinan', 'kansan67', 'andrew.herschfelt', 'zjufennizhang', 'dyyoon']",58,"['kdtyler1', 'bahammon', 'akkisubhu061', 'ntapia720', 'thomas901', 'jyliu4', 'jdcox10', 'jerry.chau', 'bmkral', 'fendraki', 'talam', 'kkawabat', 'bpravong', 'jeremy5756', 'space1008', 'rjfarrer', 'mamircha', 'chrissuchomski', 'jjhibben', 'xxbrucexx', 'kan.kawabata', 'ejsanch2', 'rgowin', 'pryan02', 'ferry', 'mpdinan', 'kansan67', 'zjufennizhang', 'acemind', 'nzorob', 'mohad1993', 'ebaldwin25', 'raypropoggio', 'csusanto', 'fernando', 'nhorvat1', 'cfarnsw2', 'karthikeya.2009', 'msouzaon', 'harshjain2691', 'ealfalas', 'jcm2006', 'ajh930', 'sgolwalkar', 'tklu1', 'tpharmon', 'sgares', 'ahornbuckle0930', 'matt.flores17', 'elizabethbesenyei', None, 'holmano', 'aesquivias', 'nmistry1', 'sapman', 'treblitz', 'andrew.herschfelt', 'dyyoon']"
43,178,15,45,13,"['space1008', 'pryan02', 'mamircha', 'mohad1993', 'jdcox10', 'ntapia720', 'chrissuchomski', 'raypropoggio', 'csusanto', 'kkawabat', 'jeremy5756', 'ejsanch2', 'aesquivias']",1,['kdtyler1'],32,"['bahammon', 'dyyoon', 'ebaldwin25', 'thomas901', 'jyliu4', 'cfarnsw2', 'msouzaon', 'chrith', 'jerry.chau', 'bmkral', 'fendraki', 'talam', 'ealfalas', 'jcm2006', 'rjfarrer', 'hcm386', 'tklu1', 'tpharmon', 'jjhibben', 'sgares', 'acemind', 'ahornbuckle0930', 'matt.flores17', 'xxbrucexx', 'elizabethbesenyei', None, 'rgowin', 'nmistry1', 'ferry', 'andrew.herschfelt', 'zjufennizhang', 'nzorob']",46,"['kdtyler1', 'mohad1993', 'bahammon', 'dyyoon', 'ebaldwin25', 'ntapia720', 'raypropoggio', 'csusanto', 'thomas901', 'jyliu4', 'cfarnsw2', 'jdcox10', 'msouzaon', 'chrith', 'jerry.chau', 'bmkral', 'fendraki', 'talam', 'kkawabat', 'ealfalas', 'jeremy5756', 'space1008', 'rjfarrer', 'mamircha', 'jcm2006', 'hcm386', 'chrissuchomski', 'tklu1', 'tpharmon', 'jjhibben', 'sgares', 'acemind', 'ahornbuckle0930', 'matt.flores17', 'xxbrucexx', 'elizabethbesenyei', 'ejsanch2', None, 'aesquivias', 'rgowin', 'pryan02', 'nmistry1', 'ferry', 'andrew.herschfelt', 'zjufennizhang', 'nzorob']"
43,81,15,40,12,"['space1008', 'pryan02', 'mamircha', 'mohad1993', 'jdcox10', 'ntapia720', 'chrissuchomski', 'raypropoggio', 'csusanto', 'kkawabat', 'jeremy5756', 'aesquivias']",2,"['kdtyler1', 'ejsanch2']",28,"['bahammon', 'dyyoon', 'ebaldwin25', 'nhorvat1', 'thomas901', 'cfarnsw2', 'msouzaon', 'chrith', 'jerry.chau', 'bmkral', 'fendraki', 'bpravong', 'nzorob', 'ealfalas', 'jcm2006', 'rjfarrer', 'tklu1', 'jjhibben', 'ahornbuckle0930', 'matt.flores17', 'xxbrucexx', 'elizabethbesenyei', None, 'rgowin', 'nmistry1', 'andrew.herschfelt', 'zjufennizhang', 'acemind']",42,"['kdtyler1', 'mohad1993', 'bahammon', 'dyyoon', 'ebaldwin25', 'ntapia720', 'raypropoggio', 'csusanto', 'thomas901', 'nhorvat1', 'cfarnsw2', 'jdcox10', 'msouzaon', 'chrith', 'jerry.chau', 'bmkral', 'fendraki', 'kkawabat', 'bpravong', 'ealfalas', 'jeremy5756', 'space1008', 'rjfarrer', 'mamircha', 'jcm2006', 'chrissuchomski', 'tklu1', 'jjhibben', 'acemind', 'ahornbuckle0930', 'matt.flores17', 'xxbrucexx', 'elizabethbesenyei', 'ejsanch2', None, 'aesquivias', 'rgowin', 'pryan02', 'nmistry1', 'andrew.herschfelt', 'zjufennizhang', 'nzorob']"
43,162,15,39,11,"['pryan02', 'mamircha', 'mohad1993', 'jdcox10', 'ntapia720', 'chrissuchomski', 'raypropoggio', 'csusanto', 'kkawabat', 'jeremy5756', 'aesquivias']",3,"['space1008', 'ejsanch2', 'kdtyler1']",28,"['bahammon', 'dyyoon', 'ebaldwin25', 'thomas901', 'cfarnsw2', 'jyliu4', 'msouzaon', 'chrith', 'jerry.chau', 'bmkral', 'fendraki', 'talam', 'bpravong', 'nzorob', 'ealfalas', 'rjfarrer', 'tklu1', 'jjhibben', 'ahornbuckle0930', 'matt.flores17', 'xxbrucexx', 'elizabethbesenyei', None, 'rgowin', 'nmistry1', 'andrew.herschfelt', 'zjufennizhang', 'acemind']",42,"['kdtyler1', 'mohad1993', 'bahammon', 'ebaldwin25', 'ntapia720', 'raypropoggio', 'csusanto', 'thomas901', 'jyliu4', 'cfarnsw2', 'jdcox10', 'msouzaon', 'chrith', 'jerry.chau', 'bmkral', 'fendraki', 'talam', 'kkawabat', 'bpravong', 'nzorob', 'ealfalas', 'jeremy5756', 'space1008', 'rjfarrer', 'mamircha', 'chrissuchomski', 'tklu1', 'jjhibben', 'acemind', 'ahornbuckle0930', 'matt.flores17', 'xxbrucexx', 'elizabethbesenyei', 'ejsanch2', None, 'aesquivias', 'rgowin', 'pryan02', 'nmistry1', 'andrew.herschfelt', 'zjufennizhang', 'dyyoon']"
43,149,15,37,12,"['pryan02', 'mamircha', 'mohad1993', 'jdcox10', 'ntapia720', 'chrissuchomski', 'raypropoggio', 'csusanto', 'kkawabat', 'jeremy5756', 'ejsanch2', 'aesquivias']",2,"['space1008', 'kdtyler1']",25,"['dyyoon', 'ebaldwin25', 'fernando', 'thomas901', 'cfarnsw2', 'msouzaon', 'chrith', 'bmkral', 'nzorob', 'ealfalas', 'sgolwalkar', 'tklu1', 'tpharmon', 'jjhibben', 'sgares', 'matt.flores17', 'xxbrucexx', None, 'rgowin', 'nmistry1', 'ferry', 'rpraneeth06', 'mpdinan', 'zjufennizhang', 'acemind']",39,"['kdtyler1', 'mohad1993', 'dyyoon', 'ebaldwin25', 'ntapia720', 'raypropoggio', 'csusanto', 'fernando', 'thomas901', 'cfarnsw2', 'jdcox10', 'msouzaon', 'chrith', 'bmkral', 'kkawabat', 'ealfalas', 'jeremy5756', 'space1008', 'mamircha', 'sgolwalkar', 'chrissuchomski', 'tklu1', 'tpharmon', 'jjhibben', 'acemind', 'sgares', 'matt.flores17', 'xxbrucexx', 'ejsanch2', None, 'aesquivias', 'rgowin', 'pryan02', 'nmistry1', 'ferry', 'rpraneeth06', 'mpdinan', 'zjufennizhang', 'nzorob']"
43,86,15,36,11,"['pryan02', 'mamircha', 'mohad1993', 'jdcox10', 'ntapia720', 'chrissuchomski', 'raypropoggio', 'jeremy5756', 'kkawabat', 'ejsanch2', 'aesquivias']",3,"['space1008', 'csusanto', 'kdtyler1']",25,"['bahammon', 'dyyoon', 'ebaldwin25', 'thomas901', 'jyliu4', 'msouzaon', 'chrith', 'bmkral', 'fendraki', 'talam', 'ealfalas', 'jcm2006', 'rjfarrer', 'tklu1', 'jjhibben', 'sgares', 'matt.flores17', 'xxbrucexx', 'elizabethbesenyei', None, 'rgowin', 'nmistry1', 'andrew.herschfelt', 'zjufennizhang', 'nzorob']",39,"['kdtyler1', 'mohad1993', 'bahammon', 'dyyoon', 'ebaldwin25', 'ntapia720', 'raypropoggio', 'csusanto', 'thomas901', 'jyliu4', 'jdcox10', 'msouzaon', 'chrith', 'bmkral', 'fendraki', 'talam', 'kkawabat', 'ealfalas', 'jeremy5756', 'space1008', 'jcm2006', 'mamircha', 'rjfarrer', 'chrissuchomski', 'tklu1', 'jjhibben', 'sgares', 'matt.flores17', 'xxbrucexx', 'elizabethbesenyei', 'ejsanch2', None, 'aesquivias', 'rgowin', 'pryan02', 'nmistry1', 'andrew.herschfelt', 'zjufennizhang', 'nzorob']"
43,63,15,35,10,"['pryan02', 'mohad1993', 'jdcox10', 'ntapia720', 'chrissuchomski', 'raypropoggio', 'jeremy5756', 'kkawabat', 'ejsanch2', 'aesquivias']",4,"['space1008', 'mamircha', 'csusanto', 'kdtyler1']",25,"['bahammon', 'ebaldwin25', 'thomas901', 'jyliu4', 'cfarnsw2', 'msouzaon', 'chrith', 'jerry.chau', 'fendraki', 'talam', 'bpravong', 'ealfalas', 'jcm2006', 'rjfarrer', 'tklu1', 'jjhibben', 'acemind', 'matt.flores17', 'elizabethbesenyei', None, 'rgowin', 'nmistry1', 'andrew.herschfelt', 'zjufennizhang', 'nzorob']",39,"['kdtyler1', 'mohad1993', 'bahammon', 'ebaldwin25', 'ntapia720', 'raypropoggio', 'csusanto', 'thomas901', 'jyliu4', 'cfarnsw2', 'jdcox10', 'msouzaon', 'chrith', 'jerry.chau', 'fendraki', 'talam', 'kkawabat', 'bpravong', 'ealfalas', 'jeremy5756', 'space1008', 'jcm2006', 'mamircha', 'rjfarrer', 'chrissuchomski', 'tklu1', 'jjhibben', 'acemind', 'matt.flores17', 'elizabethbesenyei', 'ejsanch2', None, 'aesquivias', 'rgowin', 'pryan02', 'nmistry1', 'andrew.herschfelt', 'zjufennizhang', 'nzorob']"
43,189,15,24,11,"['space1008', 'pryan02', 'mamircha', 'mohad1993', 'ntapia720', 'chrissuchomski', 'raypropoggio', 'csusanto', 'kkawabat', 'jeremy5756', 'aesquivias']",3,"['jdcox10', 'kdtyler1', 'ejsanch2']",13,"['nmistry1', 'dyyoon', 'jerry.chau', 'chrith', 'fendraki', 'jjhibben', 'ahornbuckle0930', 'matt.flores17', 'elizabethbesenyei', 'bpravong', None, 'ealfalas', 'nzorob']",27,"['kdtyler1', 'mohad1993', 'dyyoon', 'ntapia720', 'raypropoggio', 'csusanto', 'jdcox10', 'jerry.chau', 'chrith', 'fendraki', 'kkawabat', 'bpravong', 'ealfalas', 'jeremy5756', 'space1008', 'mamircha', 'chrissuchomski', 'jjhibben', 'ahornbuckle0930', 'matt.flores17', 'elizabethbesenyei', 'ejsanch2', None, 'aesquivias', 'pryan02', 'nmistry1', 'nzorob']"
43,117,15,22,13,"['kdtyler1', 'pryan02', 'mamircha', 'mohad1993', 'jdcox10', 'ntapia720', 'chrissuchomski', 'raypropoggio', 'csusanto', 'kkawabat', 'jeremy5756', 'ejsanch2', 'aesquivias']",1,['space1008'],9,"['nmistry1', 'msouzaon', 'chrith', 'tpharmon', 'ahornbuckle0930', 'fernando', 'elizabethbesenyei', None, 'nzorob']",23,"['kdtyler1', 'mohad1993', 'ntapia720', 'raypropoggio', 'csusanto', 'fernando', 'jdcox10', 'msouzaon', 'chrith', 'kkawabat', 'jeremy5756', 'space1008', 'mamircha', 'chrissuchomski', 'tpharmon', 'ahornbuckle0930', 'elizabethbesenyei', 'ejsanch2', None, 'aesquivias', 'pryan02', 'nmistry1', 'nzorob']"
43,38,15,13,9,"['pryan02', 'mamircha', 'mohad1993', 'jdcox10', 'ntapia720', 'chrissuchomski', 'jeremy5756', 'kkawabat', 'aesquivias']",5,"['space1008', 'kdtyler1', 'raypropoggio', 'csusanto', 'ejsanch2']",4,"['chrith', None, 'tpharmon', 'nzorob']",18,"['space1008', 'kdtyler1', 'mamircha', 'mohad1993', 'ntapia720', 'chrissuchomski', 'tpharmon', 'raypropoggio', 'csusanto', 'ejsanch2', None, 'aesquivias', 'pryan02', 'jdcox10', 'chrith', 'kkawabat', 'nzorob', 'jeremy5756']"
44,152,14,7,5,"['peterng.20', 'lmanzoor', 'longman', 'mahmood.noweir', 'noweir']",8,"['mengxiangeng', 'kalhor', 'yes110766106', 'admueller84', 'cpotts', 'gv8', 'zjw1091110214', 'zhouweizhong0']",2,"[None, 'dpurschk']",15,"['peterng.20', 'yes110766106', 'lmanzoor', 'gv8', 'mahmood.noweir', 'zjw1091110214', None, 'dpurschk', 'mengxiangeng', 'kalhor', 'admueller84', 'cpotts', 'longman', 'noweir', 'zhouweizhong0']"
44,153,14,6,5,"['peterng.20', 'lmanzoor', 'longman', 'mahmood.noweir', 'noweir']",8,"['mengxiangeng', 'kalhor', 'yes110766106', 'admueller84', 'cpotts', 'gv8', 'zjw1091110214', 'zhouweizhong0']",1,[None],14,"['peterng.20', 'yes110766106', 'lmanzoor', 'gv8', 'mahmood.noweir', 'zjw1091110214', None, 'mengxiangeng', 'kalhor', 'admueller84', 'cpotts', 'longman', 'noweir', 'zhouweizhong0']"
44,154,14,6,4,"['mahmood.noweir', 'noweir', 'longman', 'cpotts']",9,"['peterng.20', 'mengxiangeng', 'kalhor', 'yes110766106', 'admueller84', 'lmanzoor', 'gv8', 'zjw1091110214', 'zhouweizhong0']",2,"[None, 'dpurschk']",15,"['peterng.20', 'yes110766106', 'lmanzoor', 'gv8', 'mahmood.noweir', 'zjw1091110214', None, 'dpurschk', 'mengxiangeng', 'kalhor', 'admueller84', 'cpotts', 'longman', 'noweir', 'zhouweizhong0']"
44,155,14,6,3,"['mahmood.noweir', 'kalhor', 'cpotts']",10,"['peterng.20', 'mengxiangeng', 'yes110766106', 'admueller84', 'lmanzoor', 'longman', 'gv8', 'noweir', 'zjw1091110214', 'zhouweizhong0']",3,"[None, 'jatkinson98', 'dpurschk']",16,"['peterng.20', 'yes110766106', 'jatkinson98', 'lmanzoor', 'gv8', 'mahmood.noweir', 'zjw1091110214', None, 'dpurschk', 'mengxiangeng', 'kalhor', 'admueller84', 'cpotts', 'longman', 'noweir', 'zhouweizhong0']"
45,100,13,13,11,"['taitano15', 'connorlang', 'achong15', 'lujan15', 'rick800', 'chhor15', 'lanceislame1234', 'swuest', 'alexvarvel', 'aomeszaga', 'meyer15']",1,['harper14'],2,"[None, 'amurao15']",14,"['connorlang', 'chhor15', 'lanceislame1234', 'swuest', 'aomeszaga', None, 'harper14', 'taitano15', 'achong15', 'lujan15', 'rick800', 'alexvarvel', 'amurao15', 'meyer15']"
46,16,13,18,9,"['jonathon', 'ongki', 'john.flowers.5', 'gaurav.bunny', 'skmahoss', 'rogerindy', 'sivasumanth', 'feelthefurey', 'bmagnett']",3,"['tjs041', 'jacschwa', 'mchua']",9,"['kul.abhishake', 'veeraghanta.siddharth', 'edamian57', 'sudhirshrestha', 'ipnm70', 'ameya', 'woshisita', 'ashitamohile', None]",21,"['veeraghanta.siddharth', 'edamian57', 'sudhirshrestha', 'gaurav.bunny', 'skmahoss', 'rogerindy', 'mchua', 'feelthefurey', 'jacschwa', 'bmagnett', None, 'tjs041', 'kul.abhishake', 'jonathon', 'ongki', 'ipnm70', 'john.flowers.5', 'ameya', 'sivasumanth', 'woshisita', 'ashitamohile']"
47,88,12,12,10,"['thania', 'juliandc', 'daniela2317', 'ronal741', 'directioner99', 'anthonyhhh', 'salipe96', 'cardyyankee2012', 'jhoanruiz', 'juanca1200']",1,['aguti'],2,"[None, 'liquidxskull']",13,"['juliandc', 'ronal741', 'directioner99', 'anthonyhhh', 'cardyyankee2012', 'juanca1200', None, 'liquidxskull', 'thania', 'daniela2317', 'salipe96', 'jhoanruiz', 'aguti']"
48,44,12,12,11,"['meliss.val.mer', 'anjalim', 'frlescroart', 'nanotechgroup1', 'chibre', 'aliciakcabrera', 'adrienbarbey32', 'luismar14', 'jtutor_cu', 'evapaz', 'leocouty']",0,[],1,[None],12,"['meliss.val.mer', 'anjalim', 'frlescroart', 'aliciakcabrera', 'jtutor_cu', None, 'leocouty', 'nanotechgroup1', 'chibre', 'adrienbarbey32', 'luismar14', 'evapaz']"
51,176,12,8,5,"['fjhidalgor', 'aduenas', 'jnettleton', 'jacquemjones20', 'arlinehan']",6,"['agnair140', 'magnusbergh75', 'gyiapanis', 'yuexieguxiang', 'joachim.latzer', 'apusansar710']",3,"['amosier', 'johnyboi08', None]",14,"['agnair140', 'magnusbergh75', 'fjhidalgor', 'johnyboi08', 'jnettleton', 'jacquemjones20', 'apusansar710', None, 'arlinehan', 'amosier', 'gyiapanis', 'aduenas', 'yuexieguxiang', 'joachim.latzer']"
51,177,12,7,5,"['aduenas', 'joachim.latzer', 'jnettleton', 'jacquemjones20', 'arlinehan']",6,"['agnair140', 'fjhidalgor', 'magnusbergh75', 'gyiapanis', 'yuexieguxiang', 'apusansar710']",2,"[None, 'sandragadow']",13,"['agnair140', 'magnusbergh75', 'fjhidalgor', 'gyiapanis', 'aduenas', 'yuexieguxiang', 'joachim.latzer', 'jnettleton', 'sandragadow', 'jacquemjones20', 'apusansar710', None, 'arlinehan']"
52,172,12,27,2,"['ahmed.heshamglal', 'mai.hosny.16']",9,"['christophermuzzillo', 'jmlloren', 'alex.naiman', 'omnia.mahmoud', 'iopigor', 'libowen', 'mangosamp', 'wuest.f', 'secondprep.2013']",25,"['jam4you30', 'moataz.ebrahim1', 'mavea_800', 'seddiqmostafa39', 'm.o.ahmed55', 'mahmod', 'omarhesham578', 'dinahany52', 'hassan.m.ahmed93', 'mahmoud.nagib', 'mostafa.elsayeh.1', 'mazenhesham', 'a7med3la2', 'shazasalem92', 'asmaa.mostafa.581', 'esrraahamdy', None, 'ahmed.salah6713', 'polacasper3', 'ykholousy', 'amrghoniem94', 'rodina.magdy.9', 'engam1993', 'omnia12347', 'bloomymud']",36,"['jam4you30', 'jmlloren', 'moataz.ebrahim1', 'alex.naiman', 'omnia.mahmoud', 'mavea_800', 'seddiqmostafa39', 'mahmod', 'm.o.ahmed55', 'omarhesham578', 'dinahany52', 'mai.hosny.16', 'ahmed.heshamglal', 'hassan.m.ahmed93', 'mahmoud.nagib', 'mostafa.elsayeh.1', 'mazenhesham', 'a7med3la2', 'shazasalem92', 'asmaa.mostafa.581', 'wuest.f', 'mangosamp', 'esrraahamdy', None, 'ahmed.salah6713', 'polacasper3', 'christophermuzzillo', 'ykholousy', 'amrghoniem94', 'rodina.magdy.9', 'engam1993', 'omnia12347', 'bloomymud', 'iopigor', 'libowen', 'secondprep.2013']"
52,170,12,16,2,"['omnia.mahmoud', 'secondprep.2013']",9,"['christophermuzzillo', 'mai.hosny.16', 'jmlloren', 'ahmed.heshamglal', 'alex.naiman', 'iopigor', 'libowen', 'mangosamp', 'wuest.f']",14,"['krepton', 'eng.mustafa.k', 'abdelrahman.heikal', 'amnsawaby', 'engam1993', 'eng.somayaahmed', 'omnia12347', 'mohamed_mahmoud', 'ahmed.badawy2020', 'amr1992ahmed', 'ahmedelsayed', 'engabdelrahman', 'mmorsy1981', None]",25,"['krepton', 'jmlloren', 'alex.naiman', 'eng.somayaahmed', 'omnia.mahmoud', 'mohamed_mahmoud', 'ahmed.badawy2020', 'wuest.f', 'amr1992ahmed', 'mangosamp', 'engabdelrahman', None, 'christophermuzzillo', 'eng.mustafa.k', 'mai.hosny.16', 'abdelrahman.heikal', 'amnsawaby', 'engam1993', 'ahmed.heshamglal', 'omnia12347', 'iopigor', 'libowen', 'ahmedelsayed', 'mmorsy1981', 'secondprep.2013']"
52,171,12,12,2,"['ahmed.heshamglal', 'mai.hosny.16']",9,"['christophermuzzillo', 'jmlloren', 'alex.naiman', 'omnia.mahmoud', 'iopigor', 'libowen', 'mangosamp', 'wuest.f', 'secondprep.2013']",10,"['omarhesham578', 'amrghoniem94', 'jam4you30', 'a7med3la2', 'engam1993', 'mohamed_mahmoud', 'engabdelrahman', 'seddiqmostafa39', None, 'ahmed.salah6713']",21,"['jam4you30', 'jmlloren', 'a7med3la2', 'alex.naiman', 'omnia.mahmoud', 'mohamed_mahmoud', 'wuest.f', 'mangosamp', 'seddiqmostafa39', 'engabdelrahman', None, 'ahmed.salah6713', 'christophermuzzillo', 'omarhesham578', 'amrghoniem94', 'mai.hosny.16', 'engam1993', 'ahmed.heshamglal', 'iopigor', 'libowen', 'secondprep.2013']"
52,173,12,7,1,['libowen'],10,"['christophermuzzillo', 'mai.hosny.16', 'jmlloren', 'ahmed.heshamglal', 'alex.naiman', 'omnia.mahmoud', 'iopigor', 'wuest.f', 'mangosamp', 'secondprep.2013']",6,"['cuichao', 'zj_wxw', 'kjkj129', 'ftppbcxc', None, 'myth_verdict']",17,"['christophermuzzillo', 'cuichao', 'mai.hosny.16', 'jmlloren', 'ahmed.heshamglal', 'alex.naiman', 'zj_wxw', 'omnia.mahmoud', 'ftppbcxc', 'kjkj129', 'iopigor', 'libowen', 'mangosamp', None, 'myth_verdict', 'wuest.f', 'secondprep.2013']"
53,40,11,65,9,"['chrismay', 'nmspirak', 'subinkim', 'camackay', 'thvincent200690', 'bonecrusher', 'akstempl10', 'mgjaggers', 'hallchenhust']",1,['uaevip20000'],56,"['kdtyler1', 'bahammon', 'dyyoon', 'akkisubhu061', 'ntapia720', 'thomas901', 'jyliu4', 'jdcox10', 'jerry.chau', 'bmkral', 'fendraki', 'talam', 'kkawabat', 'bpravong', 'abdul529', 'jeremy5756', 'armunoz', 'mamircha', 'rjfarrer', 'iwillzuu', 'space1008', 'chrissuchomski', 'jjhibben', 'xxbrucexx', 'rgowin', 'pryan02', 'ferry', 'zjufennizhang', 'acemind', 'nzorob', 'mohad1993', 'ebaldwin25', 'raypropoggio', 'csusanto', 'fernando', 'cfarnsw2', 'msouzaon', 'chrith', 'vasileska', 'ealfalas', 'joel.g.wright', 'jcm2006', 'sgolwalkar', 'tklu1', 'tpharmon', 'sgares', 'matt.flores17', 'ahornbuckle0930', 'elizabethbesenyei', 'shizhisha', None, 'aesquivias', 'nmistry1', 'rpraneeth06', 'andrew.herschfelt', 'gxinchen']",66,"['kdtyler1', 'bahammon', 'dyyoon', 'akkisubhu061', 'ntapia720', 'thomas901', 'jyliu4', 'jdcox10', 'jerry.chau', 'bmkral', 'fendraki', 'talam', 'kkawabat', 'bpravong', 'abdul529', 'jeremy5756', 'chrismay', 'armunoz', 'mamircha', 'rjfarrer', 'iwillzuu', 'space1008', 'chrissuchomski', 'jjhibben', 'uaevip20000', 'xxbrucexx', 'rgowin', 'pryan02', 'ferry', 'zjufennizhang', 'acemind', 'hallchenhust', 'nzorob', 'mohad1993', 'ebaldwin25', 'thvincent200690', 'bonecrusher', 'raypropoggio', 'csusanto', 'fernando', 'cfarnsw2', 'msouzaon', 'chrith', 'vasileska', 'ealfalas', 'joel.g.wright', 'jcm2006', 'sgolwalkar', 'subinkim', 'tklu1', 'tpharmon', 'sgares', 'akstempl10', 'matt.flores17', 'ahornbuckle0930', 'elizabethbesenyei', 'shizhisha', None, 'aesquivias', 'nmspirak', 'nmistry1', 'camackay', 'rpraneeth06', 'mgjaggers', 'andrew.herschfelt', 'gxinchen']"
54,87,11,18,10,"['telliott', 'jacob.haller.908', 'bhattaca', 'mbinkle', 'christinarosales', 'sboes', 'tictonk', 'jcompara', 'zhan1222', 'jcassady']",0,[],8,"['hojin92', 'edantillon', 'yang463', 'aislingcoughlan', 'davidjohnson50', 'davidjohnson', None, 'liquidxskull']",18,"['jacob.haller.908', 'bhattaca', 'christinarosales', 'yang463', 'sboes', 'davidjohnson50', 'davidjohnson', None, 'liquidxskull', 'telliott', 'mbinkle', 'hojin92', 'edantillon', 'aislingcoughlan', 'tictonk', 'jcompara', 'zhan1222', 'jcassady']"
55,136,11,23,5,"['sp520', 'nwass182', 'jabel21', 'spalmersheim', 'elliottsiu']",5,"['ngarci02', 'funshoaro', 'fodong01', 'cmbump', 'ceejeek']",18,"['jtrousda', 'noah123', 'mjanisch', 'brittanybrandon22', 'angel.huang90', 'sboots', 'atuttle', None, 'ewilliamson', 'kwalcott', 'kcha', 'sbenteftifa', 'akinczewski', 'clundgren', 'slhatch', 'mfersch', 'uqarni', 'jberkowitz']",28,"['sp520', 'nwass182', 'brittanybrandon22', 'angel.huang90', 'sboots', 'kwalcott', 'kcha', 'fodong01', 'ceejeek', 'jberkowitz', 'noah123', 'ngarci02', 'spalmersheim', 'sbenteftifa', 'slhatch', 'atuttle', 'uqarni', 'ewilliamson', None, 'jtrousda', 'mjanisch', 'jabel21', 'funshoaro', 'akinczewski', 'clundgren', 'elliottsiu', 'cmbump', 'mfersch']"
56,33,11,23,8,"['ramnraop', 'monicareynoso', 'jianyi.gao.1', 'adar1312', 'pfirth', 'akdeshpa', 'maitreyadutta', 'jaspreety86']",2,"['alansam', 'catterrell']",15,"['baoxun1', 'hongya', 'sbatchu1', 'salman.manzoor', 'balabanmb', 'sapman', 'doublefan', 'treblitz', 'ththomp2', 'pkoswatt', 'surisuraj', 'mpreynos', 'harshadsurdi', 'mpreynos1', None]",25,"['baoxun1', 'balabanmb', 'adar1312', 'mpreynos1', 'jaspreety86', 'doublefan', 'alansam', 'sbatchu1', 'monicareynoso', 'jianyi.gao.1', 'salman.manzoor', 'akdeshpa', 'pkoswatt', 'maitreyadutta', 'mpreynos', 'harshadsurdi', None, 'hongya', 'ramnraop', 'sapman', 'pfirth', 'treblitz', 'ththomp2', 'surisuraj', 'catterrell']"
56,184,11,19,8,"['alansam', 'ramnraop', 'jianyi.gao.1', 'adar1312', 'pfirth', 'catterrell', 'maitreyadutta', 'jaspreety86']",2,"['akdeshpa', 'monicareynoso']",11,"['hsurdi', 'rmusalay', 'akkisubhu061', 'nvulic2', 'sapman', 'treblitz', 'rpraneeth06', 'shizhisha', 'pkoswatt', 'surisuraj', None]",21,"['alansam', 'monicareynoso', 'jianyi.gao.1', 'rmusalay', 'akkisubhu061', 'adar1312', 'akdeshpa', 'pkoswatt', 'shizhisha', 'maitreyadutta', 'jaspreety86', None, 'ramnraop', 'hsurdi', 'nvulic2', 'sapman', 'pfirth', 'treblitz', 'rpraneeth06', 'surisuraj', 'catterrell']"
56,161,11,7,2,"['pfirth', 'maitreyadutta']",8,"['alansam', 'ramnraop', 'monicareynoso', 'jianyi.gao.1', 'adar1312', 'akdeshpa', 'catterrell', 'jaspreety86']",5,"['gerhard.tulzer', 'sapman', 'treblitz', 'pkoswatt', None]",15,"['alansam', 'ramnraop', 'monicareynoso', 'jianyi.gao.1', 'gerhard.tulzer', 'adar1312', 'sapman', None, 'pfirth', 'treblitz', 'akdeshpa', 'pkoswatt', 'jaspreety86', 'maitreyadutta', 'catterrell']"
58,3,9,10,5,"['cristianmvillamil', 'chanss', 'cri5ne', 'anmavaro', 'jairoa.suac']",3,"['timamundsen', 'showing0521', 'ajavey']",5,"['paula.lamprea', 'dianamzuletar', 'juan93andres', 'santiaguillo', None]",13,"['paula.lamprea', 'cristianmvillamil', 'dianamzuletar', 'juan93andres', 'ajavey', 'santiaguillo', 'timamundsen', 'showing0521', 'chanss', 'cri5ne', 'anmavaro', None, 'jairoa.suac']"
62,140,8,9,6,"['rigelation', 'ntallari', 'descofet', 'cpirim1285', 'kudich', 'purnimd']",1,['seesea20086'],3,"['schatz', None, 'yuanxi.hz']",10,"['rigelation', 'descofet', 'cpirim1285', 'kudich', 'schatz', None, 'ntallari', 'seesea20086', 'purnimd', 'yuanxi.hz']"
65,211,8,8,7,"['padickala', 'mathew.sdjsmk', 'smithy.philip', 'bmcaneesh', 'gladstoneduraisamir', 'alavalamonicavarsha', 'aneeshlalmu']",0,[],1,[None],8,"['padickala', 'mathew.sdjsmk', 'smithy.philip', 'bmcaneesh', 'gladstoneduraisamir', 'alavalamonicavarsha', None, 'aneeshlalmu']"
67,16,8,18,4,"['kul.abhishake', 'sudhirshrestha', 'veeraghanta.siddharth', 'edamian57']",3,"['patrick.obrien.9210', 'creasyclauser', 'rightfuture42']",14,"['jonathon', 'ipnm70', 'ongki', None, 'gaurav.bunny', 'john.flowers.5', 'skmahoss', 'rogerindy', 'ameya', 'sivasumanth', 'woshisita', 'feelthefurey', 'ashitamohile', 'bmagnett']",21,"['veeraghanta.siddharth', 'edamian57', 'sudhirshrestha', 'gaurav.bunny', 'ashitamohile', 'skmahoss', 'rogerindy', 'feelthefurey', 'creasyclauser', 'bmagnett', None, 'kul.abhishake', 'jonathon', 'ipnm70', 'ongki', 'john.flowers.5', 'ameya', 'sivasumanth', 'woshisita', 'rightfuture42', 'patrick.obrien.9210']"
67,15,8,10,5,"['kul.abhishake', 'veeraghanta.siddharth', 'edamian57', 'sudhirshrestha', 'patrick.obrien.9210']",2,"['creasyclauser', 'rightfuture42']",5,"['gmbankar37', 'rocky.hossain1990', 'haybaum07', 'ashitamohile', None]",12,"['veeraghanta.siddharth', 'edamian57', 'sudhirshrestha', 'ashitamohile', 'haybaum07', 'creasyclauser', 'rocky.hossain1990', None, 'kul.abhishake', 'gmbankar37', 'rightfuture42', 'patrick.obrien.9210']"
67,93,8,10,1,['kul.abhishake'],6,"['veeraghanta.siddharth', 'edamian57', 'sudhirshrestha', 'rightfuture42', 'patrick.obrien.9210', 'creasyclauser']",9,"['ttruongv', 'gmbankar37', 'kiatleng', 'ipnm70', None, 'ameya', 'dvemula', 'ashitamohile', 'rocky.hossain1990']",16,"['ttruongv', 'veeraghanta.siddharth', 'dvemula', 'edamian57', 'sudhirshrestha', 'ashitamohile', 'creasyclauser', 'rocky.hossain1990', None, 'kul.abhishake', 'gmbankar37', 'kiatleng', 'ipnm70', 'ameya', 'rightfuture42', 'patrick.obrien.9210']"
68,98,8,13,4,"['lf.burbano10', 'camigod1', 'mariange8282', 'crashmateriales']",3,"['caj2014', 'ferdelarr', 'superpes']",9,"['franz', 'julian.david.00300', 'jf.quintero927', 'jp.martinez10', 'natscarrasco', 'juan_bohorquez', 'segova8', 'ing.horo', None]",16,"['franz', 'natscarrasco', 'ferdelarr', 'segova8', 'caj2014', 'ing.horo', 'crashmateriales', None, 'julian.david.00300', 'jf.quintero927', 'jp.martinez10', 'lf.burbano10', 'juan_bohorquez', 'mariange8282', 'camigod1', 'superpes']"
68,191,8,12,4,"['lf.burbano10', 'camigod1', 'mariange8282', 'crashmateriales']",3,"['caj2014', 'ferdelarr', 'superpes']",8,"['franz', 'jf.quintero927', 'jp.martinez10', 'natscarrasco', 'juan_bohorquez', 'segova8', 'ing.horo', None]",15,"['franz', 'natscarrasco', 'ferdelarr', 'segova8', 'caj2014', 'ing.horo', 'crashmateriales', None, 'jp.martinez10', 'jf.quintero927', 'lf.burbano10', 'juan_bohorquez', 'mariange8282', 'camigod1', 'superpes']"
68,99,8,9,5,"['lf.burbano10', 'ferdelarr', 'camigod1', 'caj2014', 'superpes']",2,"['mariange8282', 'crashmateriales']",4,"['julian.david.00300', 'sararoma', None, 'andresenrique28']",11,"['ferdelarr', 'caj2014', 'crashmateriales', None, 'julian.david.00300', 'lf.burbano10', 'sararoma', 'andresenrique28', 'mariange8282', 'camigod1', 'superpes']"
68,192,8,9,5,"['lf.burbano10', 'ferdelarr', 'camigod1', 'caj2014', 'superpes']",2,"['mariange8282', 'crashmateriales']",4,"['henry.m.m.g', 'sararoma', None, 'andresenrique28']",11,"['henry.m.m.g', 'ferdelarr', 'caj2014', 'crashmateriales', None, 'lf.burbano10', 'sararoma', 'andresenrique28', 'mariange8282', 'camigod1', 'superpes']"
68,193,8,6,3,"['lf.burbano10', 'caj2014', 'mariange8282']",4,"['camigod1', 'ferdelarr', 'superpes', 'crashmateriales']",3,"[None, 'ej.pinzon10', 'andresenrique28']",10,"['lf.burbano10', 'ferdelarr', 'ej.pinzon10', 'andresenrique28', 'mariange8282', 'camigod1', 'caj2014', 'crashmateriales', None, 'superpes']"
69,71,8,9,7,"['cwg2', 'qsullivan11', 'noah.brummer', 'reolmes', 'maddogclc', 'caracheo', 'dontornquist']",0,[],2,"['brano', None]",9,"['cwg2', 'noah.brummer', 'maddogclc', 'caracheo', 'dontornquist', None, 'qsullivan11', 'reolmes', 'brano']"
71,161,8,7,1,['gerhard.tulzer'],6,"['leedandan', 'michal.tomasz.pomorski', 'czajkap', 'ninge', 'msciullo2010', 'ssgdla']",6,"['sapman', 'pfirth', 'treblitz', 'pkoswatt', 'maitreyadutta', None]",13,"['leedandan', 'gerhard.tulzer', 'michal.tomasz.pomorski', 'sapman', 'pfirth', 'treblitz', 'czajkap', 'ninge', 'pkoswatt', 'maitreyadutta', 'msciullo2010', None, 'ssgdla']"
75,10,7,14,6,"['teju.raman.39', 'ravim0288', 'praveenjnvh', 'ragunaik.ec', 'sekharguru257', 'mahammad.gous.s']",0,[],8,"['ravikanth.katti', 'pramodr91', 'shrugatade', 'dhanya.bharadhwaj', 'bhuvancind', 'kirankmr199', 'justraghu', None]",14,"['ravikanth.katti', 'pramodr91', 'praveenjnvh', 'dhanya.bharadhwaj', 'sekharguru257', 'ragunaik.ec', 'mahammad.gous.s', None, 'justraghu', 'teju.raman.39', 'ravim0288', 'shrugatade', 'bhuvancind', 'kirankmr199']"
76,129,7,36,6,"['youngerlyy', 'raz_rivlis', 'kenny157', 'catherine.a.haay', 'acerium', 'catherine_a_hay']",0,[],30,"['lichuheng240', 'afzisson', 'taehee_kim', 'jianfei_zhao', 'hongxia_hao', 'ndsheriff', 'kdillione', 'frchung', 'jpstevens15', 'glowry', 'tkcloutier', 'zgreenburg', 'tegan.tingley', 'ishabubaker', 'karenpchen', 'christianz0991', 'eric.eisenhauer.16', 'raz.rivlis', 'emilee28nyy', 'gmencoff', 'dante1111', None, 'junrui.li', 'yuyang_li', 'ewittgrove', 'emily_eruysal', 'collin_felten', 'andrew_hitt', 'avery_baumann', 'hjweds']",36,"['lichuheng240', 'youngerlyy', 'afzisson', 'raz_rivlis', 'taehee_kim', 'jianfei_zhao', 'hongxia_hao', 'ndsheriff', 'kdillione', 'frchung', 'jpstevens15', 'catherine.a.haay', 'glowry', 'tkcloutier', 'zgreenburg', 'tegan.tingley', 'acerium', 'ishabubaker', 'karenpchen', 'christianz0991', 'eric.eisenhauer.16', 'raz.rivlis', 'emilee28nyy', 'gmencoff', 'dante1111', None, 'kenny157', 'catherine_a_hay', 'junrui.li', 'yuyang_li', 'ewittgrove', 'emily_eruysal', 'collin_felten', 'andrew_hitt', 'avery_baumann', 'hjweds']"
78,185,7,46,6,"['jeffrey11366', 'nilespaulthethird', 'dms2264', 'giovanna.silvateixeira', 'zhenghao', 'aji2112']",0,[],40,"['serena.shahsimpson', 'smohsin16', 'saleil.bhat', 'ka2531', 'syed.mohsin.311', 'de2313', 'csyolen', 'yangyx', 'david.boucard', 'steev16', 'jessicazhao', 'gkewley87', 'cedricmayer', 'tonid', 'houseoflastwords', 'nikoala3', 'neilorzechowski', 'dmarsed18', 'hekle', 'johnkym', 'jjw2170', 'nazlituncer94', 'ajorquera', 'lfv2108', 'shen92', 'jy2537', 'benthezhu', 'jmd2251', None, 'antonio_soild_state', 'gayathriraj', 'ndg2119', 'af2791', 'shenyz', 'frostgyt', 'rsv2111', 'wuyi0623', 'harrisonliew', 'dps2144', 'gmackcrane']",46,"['serena.shahsimpson', 'smohsin16', 'saleil.bhat', 'ka2531', 'syed.mohsin.311', 'de2313', 'csyolen', 'yangyx', 'david.boucard', 'steev16', 'jessicazhao', 'gkewley87', 'cedricmayer', 'tonid', 'houseoflastwords', 'nikoala3', 'neilorzechowski', 'giovanna.silvateixeira', 'zhenghao', 'dmarsed18', 'hekle', 'johnkym', 'jjw2170', 'nazlituncer94', 'ajorquera', 'lfv2108', 'shen92', 'jy2537', 'benthezhu', 'jmd2251', None, 'antonio_soild_state', 'gayathriraj', 'jeffrey11366', 'nilespaulthethird', 'ndg2119', 'af2791', 'shenyz', 'frostgyt', 'rsv2111', 'wuyi0623', 'dms2264', 'harrisonliew', 'dps2144', 'gmackcrane', 'aji2112']"
78,158,7,42,4,"['giovanna.silvateixeira', 'dms2264', 'nilespaulthethird', 'aji2112']",2,"['jeffrey11366', 'zhenghao']",38,"['serena.shahsimpson', 'smohsin16', 'saleil.bhat', 'ka2531', 'de2313', 'csyolen', 'yangyx', 'steev16', 'jessicazhao', 'gkewley87', 'cedricmayer', 'tonid', 'houseoflastwords', 'nikoala3', 'neilorzechowski', 'dmarsed18', 'hekle', 'johnkym', 'keith.alexanderpapa', 'jjw2170', 'ajorquera', 'lfv2108', 'shen92', 'jy2537', 'benthezhu', 'jmd2251', 'chf2117', None, 'sv2340', 'gayathriraj', 'antonio_soild_state', 'ndg2119', 'frostgyt', 'af2791', 'rsv2111', 'harrisonliew', 'dps2144', 'gmackcrane']",44,"['serena.shahsimpson', 'smohsin16', 'saleil.bhat', 'ka2531', 'de2313', 'csyolen', 'yangyx', 'steev16', 'jessicazhao', 'gkewley87', 'cedricmayer', 'tonid', 'houseoflastwords', 'nikoala3', 'neilorzechowski', 'giovanna.silvateixeira', 'zhenghao', 'dmarsed18', 'hekle', 'johnkym', 'keith.alexanderpapa', 'jjw2170', 'ajorquera', 'lfv2108', 'shen92', 'jy2537', 'benthezhu', 'jmd2251', 'chf2117', None, 'sv2340', 'gayathriraj', 'antonio_soild_state', 'jeffrey11366', 'nilespaulthethird', 'ndg2119', 'frostgyt', 'af2791', 'rsv2111', 'dms2264', 'harrisonliew', 'dps2144', 'gmackcrane', 'aji2112']"
78,115,7,38,6,"['jeffrey11366', 'nilespaulthethird', 'dms2264', 'giovanna.silvateixeira', 'zhenghao', 'aji2112']",0,[],32,"['smohsin16', 'saleil.bhat', 'ka2531', 'de2313', 'yangyx', 'steev16', 'jessicazhao', 'gkewley87', 'caleb.fujimori', 'cedricmayer', 'tonid', 'houseoflastwords', 'nikoala3', 'neilorzechowski', 'dmarsed18', 'hekle', 'jjw2170', 'nazlituncer94', 'ajorquera', 'lfv2108', 'jy2537', 'benthezhu', 'jmd2251', None, 'ndg2119', 'frostgyt', 'af2791', 'rsv2111', 'wuyi0623', 'harrisonliew', 'dps2144', 'gmackcrane']",38,"['smohsin16', 'saleil.bhat', 'ka2531', 'de2313', 'yangyx', 'steev16', 'jessicazhao', 'gkewley87', 'caleb.fujimori', 'cedricmayer', 'tonid', 'houseoflastwords', 'nikoala3', 'neilorzechowski', 'giovanna.silvateixeira', 'zhenghao', 'dmarsed18', 'hekle', 'jjw2170', 'nazlituncer94', 'ajorquera', 'lfv2108', 'jy2537', 'benthezhu', 'jmd2251', None, 'jeffrey11366', 'nilespaulthethird', 'ndg2119', 'frostgyt', 'af2791', 'rsv2111', 'wuyi0623', 'dms2264', 'harrisonliew', 'dps2144', 'gmackcrane', 'aji2112']"
78,102,7,35,5,"['jeffrey11366', 'nilespaulthethird', 'dms2264', 'giovanna.silvateixeira', 'aji2112']",1,['zhenghao'],30,"['smohsin16', 'saleil.bhat', 'ka2531', 'de2313', 'csyolen', 'yangyx', 'steev16', 'jessicazhao', 'gkewley87', 'cedricmayer', 'tonid', 'houseoflastwords', 'nikoala3', 'neilorzechowski', 'dmarsed18', 'hekle', 'jjw2170', 'nazlituncer94', 'lfv2108', 'benthezhu', 'jmd2251', None, 'ndg2119', 'frostgyt', 'af2791', 'rsv2111', 'wuyi0623', 'harrisonliew', 'dps2144', 'gmackcrane']",36,"['smohsin16', 'saleil.bhat', 'ka2531', 'de2313', 'csyolen', 'yangyx', 'steev16', 'jessicazhao', 'gkewley87', 'cedricmayer', 'tonid', 'houseoflastwords', 'nikoala3', 'neilorzechowski', 'giovanna.silvateixeira', 'zhenghao', 'dmarsed18', 'hekle', 'jjw2170', 'nazlituncer94', 'lfv2108', 'benthezhu', 'jmd2251', None, 'jeffrey11366', 'nilespaulthethird', 'ndg2119', 'frostgyt', 'af2791', 'rsv2111', 'wuyi0623', 'dms2264', 'harrisonliew', 'dps2144', 'gmackcrane', 'aji2112']"
78,164,7,32,3,"['jeffrey11366', 'giovanna.silvateixeira', 'dms2264']",3,"['nilespaulthethird', 'zhenghao', 'aji2112']",29,"['smohsin16', 'saleil.bhat', 'ka2531', 'yangyx', 'steev16', 'jessicazhao', 'gkewley87', 'caleb.fujimori', 'cedricmayer', 'tonid', 'houseoflastwords', 'nikoala3', 'neilorzechowski', 'dmarsed18', 'hekle', 'jjw2170', 'nazlituncer94', 'ab3914', 'ajorquera', 'lfv2108', 'benthezhu', 'jmd2251', None, 'ndg2119', 'af2791', 'rsv2111', 'wuyi0623', 'harrisonliew', 'gmackcrane']",35,"['smohsin16', 'saleil.bhat', 'ka2531', 'yangyx', 'steev16', 'jessicazhao', 'gkewley87', 'caleb.fujimori', 'cedricmayer', 'tonid', 'houseoflastwords', 'nikoala3', 'neilorzechowski', 'giovanna.silvateixeira', 'zhenghao', 'dmarsed18', 'hekle', 'jjw2170', 'nazlituncer94', 'ab3914', 'ajorquera', 'lfv2108', 'benthezhu', 'jmd2251', None, 'jeffrey11366', 'nilespaulthethird', 'ndg2119', 'af2791', 'rsv2111', 'wuyi0623', 'dms2264', 'harrisonliew', 'gmackcrane', 'aji2112']"
78,104,7,9,1,['zhenghao'],5,"['jeffrey11366', 'nilespaulthethird', 'dms2264', 'giovanna.silvateixeira', 'aji2112']",8,"['saleil.bhat', 'tonid', 'rsv2111', 'lfv2108', 'de2313', 'steev16', 'jmd2251', None]",14,"['jeffrey11366', 'nilespaulthethird', 'saleil.bhat', 'tonid', 'rsv2111', 'lfv2108', 'de2313', None, 'dms2264', 'steev16', 'giovanna.silvateixeira', 'jmd2251', 'zhenghao', 'aji2112']"
78,118,7,8,1,['zhenghao'],5,"['jeffrey11366', 'nilespaulthethird', 'dms2264', 'giovanna.silvateixeira', 'aji2112']",7,"['ndg2119', 'tonid', 'nazlituncer94', 'lfv2108', 'wuyi0623', 'jmd2251', None]",13,"['jeffrey11366', 'nilespaulthethird', 'ndg2119', 'tonid', 'nazlituncer94', 'lfv2108', 'wuyi0623', None, 'dms2264', 'giovanna.silvateixeira', 'jmd2251', 'zhenghao', 'aji2112']"
80,14,7,7,4,"['alberto.castro.barrigon', 'ambelaza', 'adrigomez', '2.nysc.2']",2,"['ishihara0211', 'shaofeng']",3,"['dgellabi', 'mpjcavero', None]",9,"['mpjcavero', 'ishihara0211', '2.nysc.2', 'alberto.castro.barrigon', 'ambelaza', 'shaofeng', 'adrigomez', 'dgellabi', None]"
81,2,7,7,4,"['rodrigo_103', 'jordysp', 'sebadeli', 'nikoo5']",2,"['angelomarmartinez07', 'prateeksharma']",3,"['chv_matt', None, 'spazos']",9,"['rodrigo_103', 'jordysp', 'spazos', 'chv_matt', 'nikoo5', 'sebadeli', 'angelomarmartinez07', 'prateeksharma', None]"
82,150,7,9,6,"['mhe5', 'skeald1988', 'jsm45', 'shahjigar23', 'anh3', 'asa58']",0,[],3,"['tazima18', None, 'ulyseez']",9,"['mhe5', 'skeald1988', 'jsm45', 'shahjigar23', 'anh3', 'ulyseez', 'tazima18', 'asa58', None]"
83,201,7,15,1,['tau123'],5,"['shkhan', 'elee4472', 'ansiyuan', 'roland.traxl', 'des.1303.nanohub']",14,"['ariful114', 'sdey1', 'dy521', 'pri222', 'sakidja', 'dbosch', None, 'rez123', 'delower', 'anagh123', 'ekk002', 'dan1233', 'an0505', 'seanilla']",20,"['ariful114', 'dy521', 'shkhan', 'pri222', 'sakidja', 'dbosch', 'anagh123', 'ekk002', 'tau123', 'an0505', None, 'seanilla', 'sdey1', 'elee4472', 'ansiyuan', 'roland.traxl', 'rez123', 'delower', 'des.1303.nanohub', 'dan1233']"
83,207,7,14,1,['tau123'],5,"['shkhan', 'elee4472', 'ansiyuan', 'roland.traxl', 'des.1303.nanohub']",13,"['ariful114', 'sdey1', 'pri222', 'sakidja', 'dbosch', 'rez123', 'delower', 'anagh123', 'apoorv8029', 'gemar824', None, 'dan1233', 'seanilla']",19,"['ariful114', 'shkhan', 'pri222', 'sakidja', 'dbosch', 'anagh123', 'tau123', None, 'dan1233', 'seanilla', 'sdey1', 'elee4472', 'ansiyuan', 'roland.traxl', 'rez123', 'delower', 'apoorv8029', 'des.1303.nanohub', 'gemar824']"
83,208,7,14,1,['ansiyuan'],5,"['shkhan', 'elee4472', 'roland.traxl', 'des.1303.nanohub', 'tau123']",13,"['pliu1991', 'engahmedamin88', 'bharat.k.suthar', 'jsimpher', 's.m.chintapalli', 'benjamin.leifer', 'siyuan07', 'shalineekavadiya', 'changwoo.kim.50702', 'toyetunde', 'c.martins', 'jxu0317', None]",19,"['engahmedamin88', 'shkhan', 'bharat.k.suthar', 'c.martins', 'tau123', None, 'pliu1991', 'jsimpher', 's.m.chintapalli', 'benjamin.leifer', 'elee4472', 'ansiyuan', 'roland.traxl', 'siyuan07', 'shalineekavadiya', 'changwoo.kim.50702', 'toyetunde', 'jxu0317', 'des.1303.nanohub']"
83,204,7,8,1,['elee4472'],5,"['shkhan', 'ansiyuan', 'roland.traxl', 'des.1303.nanohub', 'tau123']",7,"['pliu1991', 'engahmedamin88', 's.m.chintapalli', 'clo', 'toyetunde', 'c.martins', None]",13,"['pliu1991', 'engahmedamin88', 'shkhan', 's.m.chintapalli', 'clo', 'elee4472', 'ansiyuan', 'roland.traxl', 'toyetunde', 'c.martins', 'des.1303.nanohub', 'tau123', None]"
84,16,6,18,2,"['ipnm70', 'ameya']",3,"['zhang209', 'ttruongv', 'alialkhaleefah']",16,"['kul.abhishake', 'veeraghanta.siddharth', 'jonathon', 'edamian57', 'sudhirshrestha', 'ongki', None, 'gaurav.bunny', 'john.flowers.5', 'skmahoss', 'rogerindy', 'sivasumanth', 'woshisita', 'feelthefurey', 'ashitamohile', 'bmagnett']",21,"['ttruongv', 'veeraghanta.siddharth', 'edamian57', 'sudhirshrestha', 'gaurav.bunny', 'skmahoss', 'rogerindy', 'alialkhaleefah', 'feelthefurey', 'zhang209', 'bmagnett', None, 'kul.abhishake', 'jonathon', 'ipnm70', 'ongki', 'ameya', 'john.flowers.5', 'sivasumanth', 'woshisita', 'ashitamohile']"
84,93,6,10,3,"['ttruongv', 'ipnm70', 'ameya']",2,"['zhang209', 'alialkhaleefah']",7,"['kul.abhishake', 'gmbankar37', 'kiatleng', None, 'dvemula', 'ashitamohile', 'rocky.hossain1990']",12,"['kul.abhishake', 'ttruongv', 'gmbankar37', 'kiatleng', 'ipnm70', None, 'ameya', 'alialkhaleefah', 'dvemula', 'ashitamohile', 'zhang209', 'rocky.hossain1990']"
88,53,6,12,5,"['l445250779', 'nwblock2', 'vondev', 'duncanzhang', 'ywang272']",0,[],7,"['sobh', 'sobh1', 'barasaadah', 'alqadi2', 'yaser_yaseen', 'ssong18', None]",12,"['sobh', 'vondev', 'barasaadah', 'yaser_yaseen', 'ssong18', 'ywang272', None, 'l445250779', 'sobh1', 'duncanzhang', 'alqadi2', 'nwblock2']"
88,60,6,11,4,"['vondev', 'l445250779', 'duncanzhang', 'nwblock2']",1,['ywang272'],7,"['sarahwhite603', 'hlai10', 'barasaadah', 'yaser_yaseen', 'alqadi2', 'ssong18', None]",12,"['vondev', 'sarahwhite603', 'barasaadah', 'yaser_yaseen', 'ssong18', 'ywang272', None, 'l445250779', 'duncanzhang', 'hlai10', 'alqadi2', 'nwblock2']"
88,54,6,7,2,"['l445250779', 'duncanzhang']",3,"['vondev', 'ywang272', 'nwblock2']",5,"['sobh', 'barasaadah', 'yaser_yaseen', 'alqadi2', None]",10,"['l445250779', 'sobh', 'vondev', 'ywang272', 'duncanzhang', 'barasaadah', 'alqadi2', 'yaser_yaseen', 'nwblock2', None]"
89,42,6,6,4,"['asdelarosa0531', 'fattycorpsl', 'kemontano', 'larissatv.lt']",1,['jeorozco'],2,"['isaac_demon', None]",7,"['fattycorpsl', 'kemontano', 'asdelarosa0531', 'jeorozco', 'larissatv.lt', 'isaac_demon', None]"
90,40,6,65,5,"['jcm2006', 'rjfarrer', 'bahammon', 'andrew.herschfelt', 'jyliu4']",0,[],60,"['kdtyler1', 'dyyoon', 'akkisubhu061', 'ntapia720', 'thomas901', 'jdcox10', 'jerry.chau', 'bmkral', 'fendraki', 'talam', 'kkawabat', 'bpravong', 'abdul529', 'jeremy5756', 'armunoz', 'chrismay', 'mamircha', 'iwillzuu', 'space1008', 'chrissuchomski', 'jjhibben', 'xxbrucexx', 'rgowin', 'pryan02', 'ferry', 'zjufennizhang', 'acemind', 'nzorob', 'hallchenhust', 'mohad1993', 'ebaldwin25', 'thvincent200690', 'bonecrusher', 'raypropoggio', 'csusanto', 'fernando', 'cfarnsw2', 'msouzaon', 'chrith', 'vasileska', 'ealfalas', 'joel.g.wright', 'sgolwalkar', 'subinkim', 'tklu1', 'tpharmon', 'sgares', 'akstempl10', 'matt.flores17', 'ahornbuckle0930', 'elizabethbesenyei', 'shizhisha', None, 'aesquivias', 'nmspirak', 'nmistry1', 'camackay', 'rpraneeth06', 'mgjaggers', 'gxinchen']",65,"['kdtyler1', 'bahammon', 'dyyoon', 'akkisubhu061', 'ntapia720', 'thomas901', 'jyliu4', 'jdcox10', 'jerry.chau', 'bmkral', 'fendraki', 'talam', 'kkawabat', 'bpravong', 'abdul529', 'jeremy5756', 'armunoz', 'rjfarrer', 'chrismay', 'mamircha', 'iwillzuu', 'space1008', 'chrissuchomski', 'jjhibben', 'xxbrucexx', 'rgowin', 'pryan02', 'ferry', 'zjufennizhang', 'acemind', 'nzorob', 'hallchenhust', 'mohad1993', 'ebaldwin25', 'thvincent200690', 'bonecrusher', 'raypropoggio', 'csusanto', 'fernando', 'cfarnsw2', 'msouzaon', 'chrith', 'vasileska', 'ealfalas', 'joel.g.wright', 'jcm2006', 'sgolwalkar', 'subinkim', 'tklu1', 'tpharmon', 'sgares', 'akstempl10', 'matt.flores17', 'ahornbuckle0930', 'elizabethbesenyei', 'shizhisha', None, 'aesquivias', 'nmspirak', 'nmistry1', 'camackay', 'rpraneeth06', 'mgjaggers', 'andrew.herschfelt', 'gxinchen']"
90,50,6,55,5,"['jcm2006', 'rjfarrer', 'bahammon', 'andrew.herschfelt', 'jyliu4']",0,[],50,"['mohad1993', 'dyyoon', 'akkisubhu061', 'ebaldwin25', 'ntapia720', 'raypropoggio', 'csusanto', 'fernando', 'thomas901', 'nhorvat1', 'cfarnsw2', 'karthikeya.2009', 'jdcox10', 'msouzaon', 'jerry.chau', 'harshjain2691', 'bmkral', 'fendraki', 'talam', 'bpravong', 'ealfalas', 'jeremy5756', 'space1008', 'mamircha', 'sgolwalkar', 'ajh930', 'chrissuchomski', 'tklu1', 'tpharmon', 'jjhibben', 'sgares', 'acemind', 'ahornbuckle0930', 'matt.flores17', 'xxbrucexx', 'elizabethbesenyei', 'kan.kawabata', None, 'holmano', 'aesquivias', 'rgowin', 'pryan02', 'nmistry1', 'ferry', 'sapman', 'treblitz', 'mpdinan', 'kansan67', 'zjufennizhang', 'nzorob']",55,"['bahammon', 'mohad1993', 'akkisubhu061', 'ebaldwin25', 'ntapia720', 'raypropoggio', 'csusanto', 'fernando', 'thomas901', 'nhorvat1', 'jyliu4', 'cfarnsw2', 'karthikeya.2009', 'jdcox10', 'msouzaon', 'jerry.chau', 'harshjain2691', 'bmkral', 'fendraki', 'talam', 'bpravong', 'nzorob', 'ealfalas', 'jeremy5756', 'jcm2006', 'rjfarrer', 'space1008', 'mamircha', 'sgolwalkar', 'ajh930', 'chrissuchomski', 'tklu1', 'tpharmon', 'jjhibben', 'sgares', 'acemind', 'ahornbuckle0930', 'matt.flores17', 'xxbrucexx', 'elizabethbesenyei', 'kan.kawabata', None, 'holmano', 'aesquivias', 'rgowin', 'pryan02', 'nmistry1', 'ferry', 'sapman', 'treblitz', 'mpdinan', 'kansan67', 'andrew.herschfelt', 'zjufennizhang', 'dyyoon']"
90,178,6,45,5,"['jcm2006', 'rjfarrer', 'bahammon', 'andrew.herschfelt', 'jyliu4']",0,[],40,"['mohad1993', 'ebaldwin25', 'ntapia720', 'raypropoggio', 'csusanto', 'thomas901', 'cfarnsw2', 'jdcox10', 'msouzaon', 'chrith', 'jerry.chau', 'bmkral', 'fendraki', 'talam', 'kkawabat', 'nzorob', 'ealfalas', 'jeremy5756', 'space1008', 'mamircha', 'hcm386', 'chrissuchomski', 'tklu1', 'tpharmon', 'jjhibben', 'sgares', 'acemind', 'ahornbuckle0930', 'matt.flores17', 'xxbrucexx', 'elizabethbesenyei', 'ejsanch2', None, 'aesquivias', 'rgowin', 'pryan02', 'nmistry1', 'ferry', 'zjufennizhang', 'dyyoon']",45,"['bahammon', 'mohad1993', 'dyyoon', 'ebaldwin25', 'ntapia720', 'raypropoggio', 'csusanto', 'thomas901', 'jyliu4', 'cfarnsw2', 'jdcox10', 'msouzaon', 'chrith', 'jerry.chau', 'bmkral', 'fendraki', 'talam', 'kkawabat', 'ealfalas', 'jeremy5756', 'jcm2006', 'rjfarrer', 'space1008', 'mamircha', 'hcm386', 'chrissuchomski', 'tklu1', 'tpharmon', 'jjhibben', 'sgares', 'acemind', 'ahornbuckle0930', 'matt.flores17', 'xxbrucexx', 'elizabethbesenyei', 'ejsanch2', None, 'aesquivias', 'rgowin', 'pryan02', 'nmistry1', 'ferry', 'andrew.herschfelt', 'zjufennizhang', 'nzorob']"
90,81,6,40,4,"['jcm2006', 'rjfarrer', 'bahammon', 'andrew.herschfelt']",1,['jyliu4'],36,"['mohad1993', 'ebaldwin25', 'ntapia720', 'raypropoggio', 'csusanto', 'thomas901', 'nhorvat1', 'cfarnsw2', 'jdcox10', 'msouzaon', 'chrith', 'jerry.chau', 'bmkral', 'fendraki', 'kkawabat', 'bpravong', 'nzorob', 'ealfalas', 'jeremy5756', 'space1008', 'mamircha', 'chrissuchomski', 'tklu1', 'jjhibben', 'acemind', 'ahornbuckle0930', 'matt.flores17', 'xxbrucexx', 'elizabethbesenyei', None, 'aesquivias', 'rgowin', 'pryan02', 'nmistry1', 'zjufennizhang', 'dyyoon']",41,"['bahammon', 'mohad1993', 'dyyoon', 'ebaldwin25', 'ntapia720', 'raypropoggio', 'csusanto', 'thomas901', 'nhorvat1', 'jyliu4', 'cfarnsw2', 'jdcox10', 'msouzaon', 'chrith', 'jerry.chau', 'bmkral', 'fendraki', 'kkawabat', 'bpravong', 'ealfalas', 'jeremy5756', 'jcm2006', 'rjfarrer', 'space1008', 'mamircha', 'chrissuchomski', 'tklu1', 'jjhibben', 'acemind', 'ahornbuckle0930', 'matt.flores17', 'xxbrucexx', 'elizabethbesenyei', None, 'aesquivias', 'rgowin', 'pryan02', 'nmistry1', 'andrew.herschfelt', 'zjufennizhang', 'nzorob']"
90,162,6,39,4,"['andrew.herschfelt', 'rjfarrer', 'bahammon', 'jyliu4']",1,['jcm2006'],35,"['mohad1993', 'dyyoon', 'ebaldwin25', 'ntapia720', 'raypropoggio', 'csusanto', 'thomas901', 'cfarnsw2', 'jdcox10', 'msouzaon', 'chrith', 'jerry.chau', 'bmkral', 'fendraki', 'talam', 'kkawabat', 'bpravong', 'ealfalas', 'jeremy5756', 'mamircha', 'chrissuchomski', 'tklu1', 'jjhibben', 'acemind', 'ahornbuckle0930', 'matt.flores17', 'xxbrucexx', 'elizabethbesenyei', None, 'aesquivias', 'rgowin', 'pryan02', 'nmistry1', 'zjufennizhang', 'nzorob']",40,"['bahammon', 'mohad1993', 'ebaldwin25', 'ntapia720', 'raypropoggio', 'csusanto', 'thomas901', 'jyliu4', 'cfarnsw2', 'jdcox10', 'msouzaon', 'chrith', 'jerry.chau', 'bmkral', 'fendraki', 'talam', 'kkawabat', 'bpravong', 'nzorob', 'ealfalas', 'jeremy5756', 'jcm2006', 'rjfarrer', 'mamircha', 'chrissuchomski', 'tklu1', 'jjhibben', 'acemind', 'ahornbuckle0930', 'matt.flores17', 'xxbrucexx', 'elizabethbesenyei', None, 'aesquivias', 'rgowin', 'pryan02', 'nmistry1', 'andrew.herschfelt', 'zjufennizhang', 'dyyoon']"
90,86,6,36,5,"['jcm2006', 'rjfarrer', 'bahammon', 'andrew.herschfelt', 'jyliu4']",0,[],31,"['mohad1993', 'ebaldwin25', 'ntapia720', 'raypropoggio', 'thomas901', 'jdcox10', 'msouzaon', 'chrith', 'bmkral', 'fendraki', 'talam', 'kkawabat', 'nzorob', 'ealfalas', 'jeremy5756', 'mamircha', 'chrissuchomski', 'tklu1', 'jjhibben', 'sgares', 'matt.flores17', 'xxbrucexx', 'elizabethbesenyei', 'ejsanch2', None, 'aesquivias', 'rgowin', 'pryan02', 'nmistry1', 'zjufennizhang', 'dyyoon']",36,"['bahammon', 'mohad1993', 'dyyoon', 'ebaldwin25', 'ntapia720', 'raypropoggio', 'thomas901', 'jyliu4', 'jdcox10', 'msouzaon', 'chrith', 'bmkral', 'fendraki', 'talam', 'kkawabat', 'ealfalas', 'jeremy5756', 'jcm2006', 'rjfarrer', 'mamircha', 'chrissuchomski', 'tklu1', 'jjhibben', 'sgares', 'matt.flores17', 'xxbrucexx', 'elizabethbesenyei', 'ejsanch2', None, 'aesquivias', 'rgowin', 'pryan02', 'nmistry1', 'andrew.herschfelt', 'zjufennizhang', 'nzorob']"
90,63,6,35,5,"['jcm2006', 'rjfarrer', 'bahammon', 'andrew.herschfelt', 'jyliu4']",0,[],30,"['mohad1993', 'ebaldwin25', 'ntapia720', 'raypropoggio', 'thomas901', 'cfarnsw2', 'jdcox10', 'msouzaon', 'chrith', 'jerry.chau', 'fendraki', 'talam', 'kkawabat', 'bpravong', 'nzorob', 'ealfalas', 'jeremy5756', 'chrissuchomski', 'tklu1', 'jjhibben', 'matt.flores17', 'elizabethbesenyei', 'ejsanch2', None, 'aesquivias', 'rgowin', 'pryan02', 'nmistry1', 'zjufennizhang', 'acemind']",35,"['bahammon', 'mohad1993', 'ebaldwin25', 'ntapia720', 'raypropoggio', 'thomas901', 'jyliu4', 'cfarnsw2', 'jdcox10', 'msouzaon', 'chrith', 'jerry.chau', 'fendraki', 'talam', 'kkawabat', 'bpravong', 'ealfalas', 'jeremy5756', 'jcm2006', 'rjfarrer', 'chrissuchomski', 'tklu1', 'jjhibben', 'acemind', 'matt.flores17', 'elizabethbesenyei', 'ejsanch2', None, 'aesquivias', 'rgowin', 'pryan02', 'nmistry1', 'andrew.herschfelt', 'zjufennizhang', 'nzorob']"
90,9,6,27,5,"['jcm2006', 'rjfarrer', 'bahammon', 'andrew.herschfelt', 'jyliu4']",0,[],22,"['chenliangdu', 'hcm386', 'ebaldwin25', 'tklu1', 'jjhibben', 'acemind', 'matt.flores17', 'thomas901', 'xxbrucexx', None, 'cfarnsw2', 'rgowin', 'nmistry1', 'ferry', 'jerry.chau', 'bmkral', 'fendraki', 'talam', 'bpravong', 'zjufennizhang', 'ealfalas', 'dyyoon']",27,"['bahammon', 'ebaldwin25', 'thomas901', 'jyliu4', 'cfarnsw2', 'jerry.chau', 'bmkral', 'fendraki', 'talam', 'bpravong', 'ealfalas', 'chenliangdu', 'jcm2006', 'rjfarrer', 'hcm386', 'tklu1', 'jjhibben', 'acemind', 'matt.flores17', 'xxbrucexx', None, 'rgowin', 'nmistry1', 'ferry', 'andrew.herschfelt', 'zjufennizhang', 'dyyoon']"
90,12,6,21,4,"['jcm2006', 'jyliu4', 'bahammon', 'andrew.herschfelt']",1,['rjfarrer'],17,"['rgowin', 'nmistry1', 'ebaldwin25', 'msouzaon', 'jerry.chau', 'tklu1', 'fendraki', 'zjufennizhang', 'jjhibben', 'talam', 'matt.flores17', 'thomas901', 'ealfalas', 'elizabethbesenyei', None, 'cfarnsw2', 'acemind']",22,"['jcm2006', 'rjfarrer', 'bahammon', 'ebaldwin25', 'tklu1', 'jjhibben', 'matt.flores17', 'thomas901', 'elizabethbesenyei', None, 'jyliu4', 'cfarnsw2', 'rgowin', 'nmistry1', 'msouzaon', 'jerry.chau', 'fendraki', 'talam', 'andrew.herschfelt', 'zjufennizhang', 'ealfalas', 'acemind']"
90,6,6,18,5,"['jcm2006', 'rjfarrer', 'bahammon', 'andrew.herschfelt', 'jyliu4']",0,[],13,"['rohitmusalay009', 'iwillzuu', 'white111', 'tim.amundsen', 'jerry.chau', 'fendraki', 'sgares', 'ahornbuckle0930', 'shizhisha', 'talam', 'elizabethbesenyei', None, 'toshiyanka36']",18,"['jcm2006', 'rjfarrer', 'bahammon', 'iwillzuu', 'tim.amundsen', 'sgares', 'ahornbuckle0930', 'shizhisha', 'elizabethbesenyei', None, 'jyliu4', 'toshiyanka36', 'rohitmusalay009', 'white111', 'jerry.chau', 'fendraki', 'talam', 'andrew.herschfelt']"
90,163,6,7,2,"['bahammon', 'jyliu4']",3,"['jcm2006', 'rjfarrer', 'andrew.herschfelt']",5,"['tklu1', 'talam', None, 'cfarnsw2', 'acemind']",10,"['jcm2006', 'rjfarrer', 'bahammon', 'tklu1', 'acemind', 'talam', 'andrew.herschfelt', None, 'jyliu4', 'cfarnsw2']"
92,156,6,9,5,"['juanitoing84', 'josesoteroesteva', 'carolina.vargas', 'edelgomez17', 'sebas.dav']",0,[],4,"['gito2301', 'jorgem93', None, 'cesarromero227']",9,"['juanitoing84', 'cesarromero227', 'josesoteroesteva', 'carolina.vargas', 'edelgomez17', 'sebas.dav', 'jorgem93', None, 'gito2301']"
93,98,6,13,5,"['jf.quintero927', 'jp.martinez10', 'natscarrasco', 'juan_bohorquez', 'segova8']",0,[],8,"['franz', 'julian.david.00300', 'lf.burbano10', 'mariange8282', 'camigod1', 'ing.horo', 'crashmateriales', None]",13,"['franz', 'natscarrasco', 'segova8', 'ing.horo', 'crashmateriales', None, 'julian.david.00300', 'jp.martinez10', 'jf.quintero927', 'lf.burbano10', 'juan_bohorquez', 'mariange8282', 'camigod1']"
93,191,6,12,5,"['jf.quintero927', 'jp.martinez10', 'natscarrasco', 'juan_bohorquez', 'segova8']",0,[],7,"['franz', 'lf.burbano10', 'mariange8282', 'camigod1', 'ing.horo', 'crashmateriales', None]",12,"['franz', 'natscarrasco', 'segova8', 'ing.horo', 'crashmateriales', None, 'jp.martinez10', 'jf.quintero927', 'lf.burbano10', 'juan_bohorquez', 'mariange8282', 'camigod1']"
95,179,6,7,5,"['marta.savchuk', 'anastasia.fedorak', 'sokira', 'nazar.savytsky', 'andrew.grytsak']",0,[],2,"[None, 'bovgyra']",7,"['marta.savchuk', 'bovgyra', 'anastasia.fedorak', 'sokira', None, 'nazar.savytsky', 'andrew.grytsak']"
97,23,6,19,5,"['fasterthan88', 'guma2020', 'jyarika', 'yabc912', 'jae7woo']",0,[],14,"['yohany', 'iiijjj222', 'kyungrock.son.75', 'elvlf1611', 'choeun.park.71', 'leem4230', 'youngin90', None, 'hihibyebye', 'poby', 'supreme892', 'leess1206', 'zenorc', 'jjh1115kr']",19,"['fasterthan88', 'leem4230', 'hihibyebye', 'jyarika', 'supreme892', 'zenorc', 'yabc912', 'jjh1115kr', 'iiijjj222', None, 'yohany', 'kyungrock.son.75', 'elvlf1611', 'guma2020', 'choeun.park.71', 'youngin90', 'poby', 'leess1206', 'jae7woo']"
97,24,6,18,5,"['fasterthan88', 'guma2020', 'jyarika', 'yabc912', 'jae7woo']",0,[],13,"['yohany', 'iiijjj222', 'kyungrock.son.75', 'elvlf1611', 'leem4230', 'youngin90', 'hihibyebye', 'poby', 'supreme892', 'jjh1115kr', 'leess1206', 'zenorc', None]",18,"['fasterthan88', 'leem4230', 'hihibyebye', 'jyarika', 'supreme892', 'zenorc', 'yabc912', None, 'jjh1115kr', 'iiijjj222', 'yohany', 'kyungrock.son.75', 'elvlf1611', 'guma2020', 'youngin90', 'poby', 'leess1206', 'jae7woo']"
97,22,6,17,5,"['fasterthan88', 'guma2020', 'jyarika', 'yabc912', 'jae7woo']",0,[],12,"['yohany', 'iiijjj222', 'kyungrock.son.75', 'elvlf1611', 'choeun.park.71', 'leem4230', 'youngin90', 'hihibyebye', 'supreme892', 'jjh1115kr', 'leess1206', None]",17,"['fasterthan88', 'leem4230', 'hihibyebye', 'jyarika', 'supreme892', 'yabc912', None, 'jjh1115kr', 'iiijjj222', 'yohany', 'kyungrock.son.75', 'elvlf1611', 'guma2020', 'choeun.park.71', 'youngin90', 'leess1206', 'jae7woo']"
97,21,6,16,5,"['fasterthan88', 'guma2020', 'jyarika', 'yabc912', 'jae7woo']",0,[],11,"['yohany', 'iiijjj222', 'kyungrock.son.75', 'elvlf1611', 'choeun.park.71', 'leem4230', 'youngin90', 'njsdhd', 'hihibyebye', 'jjh1115kr', None]",16,"['fasterthan88', 'leem4230', 'hihibyebye', 'jyarika', 'yabc912', None, 'jjh1115kr', 'iiijjj222', 'yohany', 'kyungrock.son.75', 'elvlf1611', 'guma2020', 'choeun.park.71', 'youngin90', 'njsdhd', 'jae7woo']"
97,25,6,15,5,"['fasterthan88', 'guma2020', 'jyarika', 'yabc912', 'jae7woo']",0,[],10,"['yohany', 'kyungrock.son.75', 'elvlf1611', 'leem4230', 'youngin90', None, 'hihibyebye', 'supreme892', 'leess1206', 'jjh1115kr']",15,"['fasterthan88', 'leem4230', 'hihibyebye', 'jyarika', 'supreme892', 'yabc912', 'jjh1115kr', None, 'yohany', 'kyungrock.son.75', 'elvlf1611', 'guma2020', 'youngin90', 'leess1206', 'jae7woo']"
100,73,6,22,5,"['awaisali989', 'adehgha', 'eragasa', 'luoj.rpi', 'haris.rudianto']",0,[],17,"['laagesen', 'cjmar227', 'zyu_csm', 'jwc137', 'grunenfe', 'schiavo1', 'dlipke', 'siddharth.s410', 'eric.casavant.568', 'kthorn01', 'wwarriner', 'alirezaa66', 'dbhhit', 'altaf.karim.7', 'lhamill', 'sedmorteza', None]",22,"['laagesen', 'awaisali989', 'adehgha', 'zyu_csm', 'eragasa', 'cjmar227', 'siddharth.s410', 'dlipke', 'luoj.rpi', 'haris.rudianto', 'wwarriner', 'dbhhit', 'alirezaa66', 'altaf.karim.7', 'lhamill', None, 'jwc137', 'grunenfe', 'schiavo1', 'eric.casavant.568', 'kthorn01', 'sedmorteza']"
100,218,6,22,5,"['awaisali989', 'adehgha', 'eragasa', 'luoj.rpi', 'haris.rudianto']",0,[],17,"['laagesen', 'cjmar227', 'zyu_csm', 'jwc137', 'grunenfe', 'schiavo1', 'dlipke', 'sg630', 'siddharth.s410', 'eric.casavant.568', 'wwarriner', 'alirezaa66', 'dbhhit', 'altaf.karim.7', 'lhamill', 'sedmorteza', None]",22,"['laagesen', 'awaisali989', 'adehgha', 'zyu_csm', 'eragasa', 'cjmar227', 'siddharth.s410', 'dlipke', 'sg630', 'luoj.rpi', 'haris.rudianto', 'wwarriner', 'dbhhit', 'alirezaa66', 'altaf.karim.7', 'lhamill', None, 'jwc137', 'grunenfe', 'schiavo1', 'eric.casavant.568', 'sedmorteza']"
100,142,6,20,4,"['haris.rudianto', 'awaisali989', 'adehgha', 'luoj.rpi']",1,['eragasa'],16,"['laagesen', 'cjmar227', 'zyu_csm', 'jwc137', 'grunenfe', 'schiavo1', 'dlipke', 'siddharth.s410', 'eric.casavant.568', 'kthorn01', 'wwarriner', 'alirezaa66', 'dbhhit', 'altaf.karim.7', 'sedmorteza', None]",21,"['laagesen', 'awaisali989', 'adehgha', 'zyu_csm', 'eragasa', 'cjmar227', 'siddharth.s410', 'dlipke', 'luoj.rpi', 'haris.rudianto', 'wwarriner', 'dbhhit', 'alirezaa66', 'altaf.karim.7', None, 'jwc137', 'grunenfe', 'schiavo1', 'eric.casavant.568', 'kthorn01', 'sedmorteza']"
100,74,6,11,4,"['awaisali989', 'eragasa', 'adehgha', 'luoj.rpi']",1,['haris.rudianto'],7,"['siddharth.s410', 'schiavo1', 'wwarriner', 'alirezaa66', 'altaf.karim.7', 'sedmorteza', None]",12,"['awaisali989', 'adehgha', 'eragasa', 'siddharth.s410', 'luoj.rpi', 'haris.rudianto', 'wwarriner', 'alirezaa66', 'altaf.karim.7', None, 'schiavo1', 'sedmorteza']"
100,214,6,7,4,"['haris.rudianto', 'awaisali989', 'adehgha', 'luoj.rpi']",1,['eragasa'],3,"['lhamill', None, 'grunenfe']",8,"['awaisali989', 'adehgha', 'eragasa', 'grunenfe', 'luoj.rpi', 'haris.rudianto', 'lhamill', None]"
