MClusterID,XClusterID,MClusterSize,XClusterSize,OverlapSize,OverlapMembers,MOnlySize,MOnlyMembers,XOnlySize,XOnlyMembers,CombinedSize,CombinedMembers
1,175,246,45,44,"['michaela.ragoonath', 'leehyungjoo94', 'linus744', 'wphan604', 'jiwhan328', 'ellinorcrux', 'emilyxu1995', 'gfbeales', 'mohammad.kabir92', 'eece_user_03', 'lejaym', 'garrett', 'smalhi', 'gcasey', 'mankity', 'pouriagh', 'trafalgarlove', 'sports', 'nchiu94', 'pwnt818', 'kurt.ahn', 'sanguoshaisawesome', 'tashfiq.yazdan.alam', 'casey.gx', 'noobkiller0', 'talonchandler', 'sj306', 'lemon82124', 'talesdv', 'curi87', 'alexberlingeri', 'jethro4', 'james.q.feng', 'ice7ven', 'nicolas.ivanov94', 'pardiss1', 'robynstar87', 'ncrofty', 'malonej', 'ibnul.hussain.1', 'williamtbwright', 'bkbkbkbk', 'polardusk', 'aabadi']",202,"['alex.badmaev', 'feralfire', 'a94', 'mahmousa91', 'weicong', 'yamen', 'b.m.romeira', 'yasmin.adel.ya', 'raaidarshad', 'lazyasfcuk', 'jiaolh', 'danm1ch1gan', 'arya1080', 'fermioncj', 'ghostavoo', 'maxmankin2', 'shinyoung.park.5688', 'olivia.smith8787', 'hollybo', 'jainilgpatel', 'mounikav', 'hassanin74', 'mberthou', 'asif0047', 'lailamo95', '2kanghee', 'sadeghyazdi', 'dginoza', 'soyabk1198', 'javier.laitue', 'hassanism', 'pradozurita', 'wuyiyang', 'wiss', 'sush2308', 'dpalanch', 'wieling94', 'arnaudstolz', 'csabin18', 'xinnancao', 'palmbeach316', 'zplotzke', 'felfelflafely', 'patnilki', 'archduke900', 'kaustubhshah', 'wilsonn1996', 'hallmat', 'alexbene', 'kiseob.jung', 'dola47', 'blairhan0126', 'dheer.mehrotra', 'tsangmichael', 'mwcraig', 'stefanieark', 'tatchinj', 'salma.elshamy.754', 'dgevans86', 'dtassis', 'alshahrooor', 'drew.sheffield.10', 'rarshad', 'junkinja', 'anthony.remo', 'david.luo.73', 'usfmohy', 'midomatrixrb10', 'ceicher', 'daveestrada12', 'amalkaba', 'inyeal.lee', 'smallandred126', 'dkarnazes', 'isaac.labean', 'minwoo.kong.1', 'dmills9', 'mivuong1191', 'shawn', 'nineta', 'audrey.hendon', 'kbradley411', 'dinohyun', 'yasmin.atef3', 'robert.botsford', 'turkiat', 'yousra.azab.9', 'aikblackarmy83', 'nadine_atef', 'bshanmo', 'dyour', 'barofske', 'tusharmonapara', 'elzingan', 'ckddns777', 'woshiee123', 'mmiri', 'abalshuaibi', 'tifa.madboly', 'ganzevol', 'jaykg37', 'catalina1986', 'goldy.sakhre', 'capel', 'josh.morris.92167789', 'vincent.chen.5494', 'bboylekz', 'wilsscot', 'lejustin.lv', 'vaishali.p.94', 'jthompson2645', 'caroline.ashraf2', 'alhaninb', 'nourin', 'void191', 'abdullah.alshuaibi', 'chahid_abdo', 'hos.mohammed', 'riessa', 'arankin', 'trevor.mackenzie117', 'matt.deno93', 'sherouknasr24', 'vijay_narasimhan', 'ramuamt', 'igor.josafa', 'yuexieguxiang', 'kyleeng', 'czy248200289', 'abesary', 'jessica.joussa', 'jstad', 'pf8363', 'keyurshahrajkotgujarat', 'andrrrew', 'hala.adel.142', 'hinchmaa', 'jperez35', 'adam.argetsinger', 'lydia.alfred93', 'hashem.emad', 'czajkows', 'vanossp', 'riru94', 'ebram.bero.92', 'alexbenedict', 'westrab', 'ahmedkhaled93', 'lettycastrejonbarron', 'raccio14', 'ayu', 'james.jacobson.370', 'thegreatwidesomewhere', 'deboerad', 'guseoanfflgkr', 'lavignan', 'gilletry', 'johntylerwallace', 'jeroenkorterik', 'polemale', 'reemakhaled', 'mkramer1', 'sambeau', 'maurom80', 'ahmed.tariq.94.10', 'gmorren11', 'cis', 'salma.ghobara', 'annaswan', 'chk0521', 'nikita.marus', 'almansouri', 'mdmobarokhossainrubel', 'kbbc1234', 'jerome.mourad', 'mpcondak', 'aravind.ravi', 'sloppyjoe911', 'dominiccostajames', 'pavanchowdaryntrfan', 'hunterla', 'mohammed.eng1994', 'kfaist', 'es.maniego', 'g.nitish.kumar', 'warnemar', 'chengjiu.zhang.7', 'ditionq', 'harvey.hany.71', 'sumeyrakrs', 'aishsingh', 'jason.cammarata.73', 'gaigalac', 'ahmad.wael.165', 'jamesbezuk', 'ericgregg300', 'mahmoud.h.konswa', 'king27med', 'nnovak3', 'phwoook', 'yany', 'zeinahesham423']",1,[None],247,"['michaela.ragoonath', 'alex.badmaev', 'feralfire', 'a94', 'mahmousa91', 'weicong', 'yamen', 'b.m.romeira', 'yasmin.adel.ya', 'raaidarshad', 'mohammad.kabir92', 'lazyasfcuk', 'aabadi', 'jiaolh', 'lejaym', 'danm1ch1gan', 'arya1080', 'fermioncj', 'ghostavoo', 'maxmankin2', 'shinyoung.park.5688', 'olivia.smith8787', 'hollybo', 'jainilgpatel', 'mounikav', 'hassanin74', 'mberthou', 'asif0047', 'lemon82124', 'lailamo95', 'curi87', '2kanghee', 'sadeghyazdi', 'dginoza', 'james.q.feng', 'soyabk1198', 'javier.laitue', 'hassanism', 'pradozurita', 'wuyiyang', 'malonej', 'wiss', 'sush2308', 'dpalanch', 'polardusk', 'wieling94', 'arnaudstolz', 'csabin18', 'xinnancao', 'palmbeach316', 'zplotzke', 'wphan604', 'felfelflafely', 'patnilki', 'archduke900', 'kaustubhshah', 'wilsonn1996', 'hallmat', 'garrett', 'alexbene', 'kiseob.jung', 'dola47', 'smalhi', 'blairhan0126', 'dheer.mehrotra', 'tsangmichael', 'mwcraig', 'stefanieark', 'tatchinj', 'pouriagh', 'pwnt818', 'salma.elshamy.754', 'dgevans86', 'dtassis', 'noobkiller0', 'alshahrooor', 'drew.sheffield.10', 'rarshad', 'junkinja', 'anthony.remo', 'alexberlingeri', 'david.luo.73', 'usfmohy', 'midomatrixrb10', 'jethro4', 'ceicher', 'daveestrada12', 'amalkaba', 'inyeal.lee', 'smallandred126', 'dkarnazes', 'robynstar87', 'isaac.labean', 'minwoo.kong.1', 'dmills9', 'mivuong1191', 'bkbkbkbk', 'shawn', 'nineta', 'audrey.hendon', 'kbradley411', 'dinohyun', 'yasmin.atef3', 'robert.botsford', 'turkiat', 'yousra.azab.9', 'aikblackarmy83', 'leehyungjoo94', 'nadine_atef', 'bshanmo', 'linus744', 'dyour', 'barofske', 'emilyxu1995', 'tusharmonapara', 'elzingan', 'ckddns777', 'woshiee123', 'gfbeales', 'mmiri', 'abalshuaibi', 'tifa.madboly', 'eece_user_03', 'ganzevol', 'jaykg37', 'catalina1986', 'goldy.sakhre', 'capel', 'josh.morris.92167789', 'vincent.chen.5494', 'bboylekz', 'gcasey', 'wilsscot', 'lejustin.lv', 'vaishali.p.94', 'jthompson2645', 'mankity', 'caroline.ashraf2', 'alhaninb', 'nourin', 'void191', 'casey.gx', 'sports', 'abdullah.alshuaibi', 'chahid_abdo', 'nchiu94', 'trafalgarlove', 'hos.mohammed', 'riessa', 'sanguoshaisawesome', 'arankin', 'trevor.mackenzie117', 'matt.deno93', 'talonchandler', 'sherouknasr24', 'sj306', 'vijay_narasimhan', 'ramuamt', 'igor.josafa', 'ice7ven', 'yuexieguxiang', 'kyleeng', 'czy248200289', 'abesary', 'jessica.joussa', 'jstad', 'pf8363', 'nicolas.ivanov94', 'keyurshahrajkotgujarat', 'andrrrew', 'hala.adel.142', 'hinchmaa', 'ibnul.hussain.1', 'jperez35', 'williamtbwright', 'adam.argetsinger', 'lydia.alfred93', 'hashem.emad', 'czajkows', 'vanossp', 'riru94', 'ebram.bero.92', 'alexbenedict', 'westrab', 'ahmedkhaled93', 'lettycastrejonbarron', 'raccio14', 'ayu', 'james.jacobson.370', 'thegreatwidesomewhere', 'jiwhan328', 'deboerad', 'ellinorcrux', 'guseoanfflgkr', 'lavignan', 'gilletry', 'johntylerwallace', 'jeroenkorterik', 'polemale', 'reemakhaled', 'mkramer1', 'sambeau', 'maurom80', 'ahmed.tariq.94.10', 'gmorren11', 'cis', 'kurt.ahn', 'salma.ghobara', 'annaswan', 'chk0521', 'tashfiq.yazdan.alam', 'nikita.marus', 'almansouri', 'mdmobarokhossainrubel', 'kbbc1234', 'jerome.mourad', 'mpcondak', 'talesdv', 'aravind.ravi', 'sloppyjoe911', 'dominiccostajames', 'pavanchowdaryntrfan', 'hunterla', None, 'mohammed.eng1994', 'kfaist', 'es.maniego', 'g.nitish.kumar', 'pardiss1', 'warnemar', 'chengjiu.zhang.7', 'ncrofty', 'ditionq', 'harvey.hany.71', 'sumeyrakrs', 'aishsingh', 'jason.cammarata.73', 'gaigalac', 'ahmad.wael.165', 'jamesbezuk', 'ericgregg300', 'mahmoud.h.konswa', 'king27med', 'nnovak3', 'phwoook', 'yany', 'zeinahesham423']"
1,165,246,38,1,['jperez35'],245,"['michaela.ragoonath', 'alex.badmaev', 'feralfire', 'a94', 'mahmousa91', 'weicong', 'yamen', 'b.m.romeira', 'yasmin.adel.ya', 'raaidarshad', 'mohammad.kabir92', 'lazyasfcuk', 'aabadi', 'jiaolh', 'lejaym', 'danm1ch1gan', 'arya1080', 'fermioncj', 'ghostavoo', 'maxmankin2', 'shinyoung.park.5688', 'olivia.smith8787', 'hollybo', 'jainilgpatel', 'mounikav', 'hassanin74', 'mberthou', 'asif0047', 'lemon82124', 'lailamo95', 'curi87', '2kanghee', 'sadeghyazdi', 'dginoza', 'james.q.feng', 'soyabk1198', 'javier.laitue', 'hassanism', 'pradozurita', 'wuyiyang', 'malonej', 'wiss', 'sush2308', 'dpalanch', 'polardusk', 'wieling94', 'arnaudstolz', 'csabin18', 'xinnancao', 'palmbeach316', 'zplotzke', 'wphan604', 'felfelflafely', 'patnilki', 'archduke900', 'kaustubhshah', 'wilsonn1996', 'hallmat', 'garrett', 'alexbene', 'kiseob.jung', 'dola47', 'smalhi', 'blairhan0126', 'dheer.mehrotra', 'tsangmichael', 'mwcraig', 'stefanieark', 'tatchinj', 'pouriagh', 'pwnt818', 'salma.elshamy.754', 'dgevans86', 'dtassis', 'noobkiller0', 'alshahrooor', 'drew.sheffield.10', 'rarshad', 'junkinja', 'anthony.remo', 'alexberlingeri', 'david.luo.73', 'usfmohy', 'midomatrixrb10', 'jethro4', 'ceicher', 'daveestrada12', 'amalkaba', 'inyeal.lee', 'smallandred126', 'dkarnazes', 'robynstar87', 'isaac.labean', 'minwoo.kong.1', 'dmills9', 'mivuong1191', 'bkbkbkbk', 'shawn', 'nineta', 'audrey.hendon', 'kbradley411', 'dinohyun', 'yasmin.atef3', 'robert.botsford', 'turkiat', 'yousra.azab.9', 'aikblackarmy83', 'leehyungjoo94', 'nadine_atef', 'bshanmo', 'linus744', 'dyour', 'barofske', 'emilyxu1995', 'tusharmonapara', 'elzingan', 'ckddns777', 'woshiee123', 'gfbeales', 'mmiri', 'abalshuaibi', 'tifa.madboly', 'eece_user_03', 'ganzevol', 'jaykg37', 'catalina1986', 'goldy.sakhre', 'capel', 'josh.morris.92167789', 'vincent.chen.5494', 'bboylekz', 'gcasey', 'wilsscot', 'lejustin.lv', 'vaishali.p.94', 'jthompson2645', 'mankity', 'caroline.ashraf2', 'alhaninb', 'nourin', 'void191', 'casey.gx', 'sports', 'abdullah.alshuaibi', 'chahid_abdo', 'nchiu94', 'trafalgarlove', 'hos.mohammed', 'riessa', 'sanguoshaisawesome', 'arankin', 'trevor.mackenzie117', 'matt.deno93', 'talonchandler', 'sherouknasr24', 'sj306', 'vijay_narasimhan', 'ramuamt', 'igor.josafa', 'ice7ven', 'yuexieguxiang', 'kyleeng', 'czy248200289', 'abesary', 'jessica.joussa', 'jstad', 'pf8363', 'nicolas.ivanov94', 'keyurshahrajkotgujarat', 'andrrrew', 'hala.adel.142', 'hinchmaa', 'ibnul.hussain.1', 'williamtbwright', 'adam.argetsinger', 'lydia.alfred93', 'hashem.emad', 'czajkows', 'vanossp', 'riru94', 'ebram.bero.92', 'alexbenedict', 'westrab', 'ahmedkhaled93', 'lettycastrejonbarron', 'raccio14', 'ayu', 'james.jacobson.370', 'thegreatwidesomewhere', 'jiwhan328', 'deboerad', 'ellinorcrux', 'guseoanfflgkr', 'lavignan', 'gilletry', 'johntylerwallace', 'jeroenkorterik', 'polemale', 'reemakhaled', 'mkramer1', 'sambeau', 'maurom80', 'ahmed.tariq.94.10', 'gmorren11', 'cis', 'kurt.ahn', 'salma.ghobara', 'annaswan', 'chk0521', 'tashfiq.yazdan.alam', 'nikita.marus', 'almansouri', 'mdmobarokhossainrubel', 'kbbc1234', 'jerome.mourad', 'mpcondak', 'talesdv', 'aravind.ravi', 'sloppyjoe911', 'dominiccostajames', 'pavanchowdaryntrfan', 'hunterla', 'mohammed.eng1994', 'kfaist', 'es.maniego', 'g.nitish.kumar', 'pardiss1', 'warnemar', 'chengjiu.zhang.7', 'ncrofty', 'ditionq', 'harvey.hany.71', 'sumeyrakrs', 'aishsingh', 'jason.cammarata.73', 'gaigalac', 'ahmad.wael.165', 'jamesbezuk', 'ericgregg300', 'mahmoud.h.konswa', 'king27med', 'nnovak3', 'phwoook', 'yany', 'zeinahesham423']",37,"['donnadel', 'jledesma5', 'itarin08', 'rm.mutz', 'ecarodelcastillo93', 'felipe.sanchez.127', 'eddierocha79', 'mariana_quantum', 'steese2000', 'icorral', 'antonl09', 'jrfarinas13', 'fandrade5', 'oring5express', 'rocolo14', 'gjesparza', 'boniljor', 'scampolla5', 'tmaldo22', 'pfrodriguez', 'alfredo.gonzalezflores', 'aeron17', 'stella', 'carmen.adel.56', None, 'fernando.torres.906', 'dedeniega', 'michael.e2005', 'supersaok666', 'gabriel00274', 'ericdodgers3', 'thisoneworked', 'raymundo.delarosa1', 'jamartinez16111982', 'andres.medina.79219', 'flsilva', 'hugo.solorzanocampos']",283,"['michaela.ragoonath', 'alex.badmaev', 'feralfire', 'a94', 'mahmousa91', 'weicong', 'yamen', 'b.m.romeira', 'yasmin.adel.ya', 'raaidarshad', 'mohammad.kabir92', 'lazyasfcuk', 'aabadi', 'jiaolh', 'rm.mutz', 'lejaym', 'danm1ch1gan', 'arya1080', 'fermioncj', 'felipe.sanchez.127', 'ghostavoo', 'maxmankin2', 'shinyoung.park.5688', 'olivia.smith8787', 'hollybo', 'jainilgpatel', 'steese2000', 'mounikav', 'hassanin74', 'antonl09', 'jrfarinas13', 'dedeniega', 'mberthou', 'asif0047', 'lemon82124', 'lailamo95', 'alfredo.gonzalezflores', 'curi87', '2kanghee', 'sadeghyazdi', 'dginoza', 'james.q.feng', 'soyabk1198', 'carmen.adel.56', 'javier.laitue', 'hassanism', 'pradozurita', 'fernando.torres.906', 'wuyiyang', 'malonej', 'jamartinez16111982', 'andres.medina.79219', 'wiss', 'sush2308', 'dpalanch', 'polardusk', 'wieling94', 'arnaudstolz', 'csabin18', 'xinnancao', 'palmbeach316', 'zplotzke', 'wphan604', 'felfelflafely', 'patnilki', 'archduke900', 'kaustubhshah', 'wilsonn1996', 'hallmat', 'garrett', 'ecarodelcastillo93', 'alexbene', 'kiseob.jung', 'dola47', 'smalhi', 'blairhan0126', 'dheer.mehrotra', 'eddierocha79', 'tsangmichael', 'mwcraig', 'stefanieark', 'tatchinj', 'pouriagh', 'pwnt818', 'salma.elshamy.754', 'dgevans86', 'gjesparza', 'fandrade5', 'rocolo14', 'boniljor', 'dtassis', 'noobkiller0', 'alshahrooor', 'scampolla5', 'drew.sheffield.10', 'rarshad', 'junkinja', 'pfrodriguez', 'aeron17', 'anthony.remo', 'alexberlingeri', 'david.luo.73', 'usfmohy', 'midomatrixrb10', 'jethro4', 'ceicher', 'daveestrada12', 'amalkaba', 'inyeal.lee', 'smallandred126', 'dkarnazes', 'robynstar87', 'isaac.labean', 'michael.e2005', 'supersaok666', 'minwoo.kong.1', 'dmills9', 'mivuong1191', 'bkbkbkbk', 'shawn', 'nineta', 'audrey.hendon', 'kbradley411', 'dinohyun', 'hugo.solorzanocampos', 'yasmin.atef3', 'robert.botsford', 'turkiat', 'yousra.azab.9', 'aikblackarmy83', 'leehyungjoo94', 'nadine_atef', 'bshanmo', 'linus744', 'donnadel', 'dyour', 'barofske', 'jledesma5', 'itarin08', 'emilyxu1995', 'tusharmonapara', 'elzingan', 'ckddns777', 'woshiee123', 'gfbeales', 'mmiri', 'abalshuaibi', 'tifa.madboly', 'eece_user_03', 'ganzevol', 'jaykg37', 'catalina1986', 'goldy.sakhre', 'capel', 'josh.morris.92167789', 'vincent.chen.5494', 'bboylekz', 'gcasey', 'wilsscot', 'lejustin.lv', 'vaishali.p.94', 'jthompson2645', 'mankity', 'caroline.ashraf2', 'alhaninb', 'nourin', 'void191', 'mariana_quantum', 'casey.gx', 'sports', 'abdullah.alshuaibi', 'chahid_abdo', 'nchiu94', 'trafalgarlove', 'hos.mohammed', 'riessa', 'sanguoshaisawesome', 'arankin', 'trevor.mackenzie117', 'matt.deno93', 'talonchandler', 'sherouknasr24', 'sj306', 'vijay_narasimhan', 'ramuamt', 'igor.josafa', 'ice7ven', 'yuexieguxiang', 'kyleeng', 'czy248200289', 'abesary', 'jessica.joussa', 'jstad', 'pf8363', 'nicolas.ivanov94', 'keyurshahrajkotgujarat', 'ericdodgers3', 'andrrrew', 'hala.adel.142', 'hinchmaa', 'raymundo.delarosa1', 'ibnul.hussain.1', 'jperez35', 'williamtbwright', 'adam.argetsinger', 'flsilva', 'lydia.alfred93', 'hashem.emad', 'czajkows', 'vanossp', 'riru94', 'ebram.bero.92', 'alexbenedict', 'westrab', 'ahmedkhaled93', 'lettycastrejonbarron', 'raccio14', 'ayu', 'james.jacobson.370', 'thegreatwidesomewhere', 'jiwhan328', 'deboerad', 'ellinorcrux', 'guseoanfflgkr', 'lavignan', 'gilletry', 'johntylerwallace', 'jeroenkorterik', 'polemale', 'reemakhaled', 'mkramer1', 'sambeau', 'maurom80', 'ahmed.tariq.94.10', 'gmorren11', 'cis', 'kurt.ahn', 'salma.ghobara', 'annaswan', 'chk0521', 'tashfiq.yazdan.alam', 'icorral', 'oring5express', 'nikita.marus', 'almansouri', 'mdmobarokhossainrubel', 'kbbc1234', 'jerome.mourad', 'mpcondak', 'talesdv', 'tmaldo22', 'aravind.ravi', 'sloppyjoe911', 'dominiccostajames', 'pavanchowdaryntrfan', 'hunterla', 'stella', None, 'mohammed.eng1994', 'kfaist', 'es.maniego', 'g.nitish.kumar', 'pardiss1', 'warnemar', 'chengjiu.zhang.7', 'ncrofty', 'ditionq', 'harvey.hany.71', 'sumeyrakrs', 'gabriel00274', 'aishsingh', 'thisoneworked', 'jason.cammarata.73', 'gaigalac', 'ahmad.wael.165', 'jamesbezuk', 'ericgregg300', 'mahmoud.h.konswa', 'king27med', 'nnovak3', 'phwoook', 'yany', 'zeinahesham423']"
1,174,246,36,30,"['yousra.azab.9', 'riru94', 'nadine_atef', 'a94', 'felfelflafely', 'yasmin.adel.ya', 'tifa.madboly', 'reemakhaled', 'dola47', 'ahmed.tariq.94.10', 'salma.ghobara', 'hos.mohammed', 'salma.elshamy.754', 'sherouknasr24', 'jerome.mourad', 'lailamo95', 'usfmohy', 'midomatrixrb10', 'jessica.joussa', 'hassanism', 'ebram.bero.92', 'harvey.hany.71', 'andrrrew', 'hala.adel.142', 'ahmad.wael.165', 'hashem.emad', 'king27med', 'lydia.alfred93', 'ahmedkhaled93', 'yasmin.atef3']",216,"['michaela.ragoonath', 'alex.badmaev', 'feralfire', 'mahmousa91', 'weicong', 'yamen', 'b.m.romeira', 'raaidarshad', 'mohammad.kabir92', 'lazyasfcuk', 'aabadi', 'jiaolh', 'lejaym', 'danm1ch1gan', 'arya1080', 'fermioncj', 'ghostavoo', 'maxmankin2', 'shinyoung.park.5688', 'olivia.smith8787', 'hollybo', 'jainilgpatel', 'mounikav', 'hassanin74', 'mberthou', 'asif0047', 'lemon82124', 'curi87', '2kanghee', 'sadeghyazdi', 'dginoza', 'james.q.feng', 'soyabk1198', 'javier.laitue', 'pradozurita', 'wuyiyang', 'malonej', 'wiss', 'sush2308', 'dpalanch', 'polardusk', 'wieling94', 'arnaudstolz', 'csabin18', 'xinnancao', 'palmbeach316', 'zplotzke', 'wphan604', 'patnilki', 'archduke900', 'kaustubhshah', 'wilsonn1996', 'hallmat', 'garrett', 'alexbene', 'kiseob.jung', 'smalhi', 'blairhan0126', 'dheer.mehrotra', 'tsangmichael', 'mwcraig', 'stefanieark', 'tatchinj', 'pouriagh', 'pwnt818', 'dgevans86', 'dtassis', 'noobkiller0', 'alshahrooor', 'drew.sheffield.10', 'rarshad', 'junkinja', 'anthony.remo', 'alexberlingeri', 'david.luo.73', 'jethro4', 'ceicher', 'daveestrada12', 'amalkaba', 'inyeal.lee', 'smallandred126', 'dkarnazes', 'robynstar87', 'isaac.labean', 'minwoo.kong.1', 'dmills9', 'mivuong1191', 'bkbkbkbk', 'shawn', 'nineta', 'audrey.hendon', 'kbradley411', 'dinohyun', 'robert.botsford', 'turkiat', 'aikblackarmy83', 'leehyungjoo94', 'bshanmo', 'linus744', 'dyour', 'barofske', 'emilyxu1995', 'tusharmonapara', 'elzingan', 'ckddns777', 'woshiee123', 'gfbeales', 'mmiri', 'abalshuaibi', 'eece_user_03', 'ganzevol', 'jaykg37', 'catalina1986', 'goldy.sakhre', 'capel', 'josh.morris.92167789', 'vincent.chen.5494', 'bboylekz', 'gcasey', 'wilsscot', 'lejustin.lv', 'vaishali.p.94', 'jthompson2645', 'mankity', 'caroline.ashraf2', 'alhaninb', 'nourin', 'void191', 'casey.gx', 'sports', 'abdullah.alshuaibi', 'chahid_abdo', 'nchiu94', 'trafalgarlove', 'riessa', 'sanguoshaisawesome', 'arankin', 'trevor.mackenzie117', 'matt.deno93', 'talonchandler', 'sj306', 'vijay_narasimhan', 'ramuamt', 'igor.josafa', 'ice7ven', 'yuexieguxiang', 'kyleeng', 'czy248200289', 'abesary', 'jstad', 'pf8363', 'nicolas.ivanov94', 'keyurshahrajkotgujarat', 'hinchmaa', 'ibnul.hussain.1', 'jperez35', 'williamtbwright', 'adam.argetsinger', 'czajkows', 'vanossp', 'alexbenedict', 'westrab', 'lettycastrejonbarron', 'raccio14', 'ayu', 'james.jacobson.370', 'thegreatwidesomewhere', 'jiwhan328', 'deboerad', 'ellinorcrux', 'guseoanfflgkr', 'lavignan', 'gilletry', 'johntylerwallace', 'jeroenkorterik', 'polemale', 'mkramer1', 'sambeau', 'maurom80', 'gmorren11', 'cis', 'kurt.ahn', 'annaswan', 'chk0521', 'tashfiq.yazdan.alam', 'nikita.marus', 'almansouri', 'mdmobarokhossainrubel', 'kbbc1234', 'mpcondak', 'talesdv', 'aravind.ravi', 'sloppyjoe911', 'dominiccostajames', 'pavanchowdaryntrfan', 'hunterla', 'mohammed.eng1994', 'kfaist', 'es.maniego', 'g.nitish.kumar', 'pardiss1', 'warnemar', 'chengjiu.zhang.7', 'ncrofty', 'ditionq', 'sumeyrakrs', 'aishsingh', 'jason.cammarata.73', 'gaigalac', 'jamesbezuk', 'ericgregg300', 'mahmoud.h.konswa', 'nnovak3', 'phwoook', 'yany', 'zeinahesham423']",6,"['shohdy', 'electro.ahmed', 'amr_taha_93', 'shosho.khaled.710', None, 'kareem.waseem']",252,"['michaela.ragoonath', 'alex.badmaev', 'feralfire', 'a94', 'mahmousa91', 'weicong', 'yamen', 'b.m.romeira', 'yasmin.adel.ya', 'raaidarshad', 'mohammad.kabir92', 'lazyasfcuk', 'aabadi', 'jiaolh', 'lejaym', 'danm1ch1gan', 'arya1080', 'fermioncj', 'ghostavoo', 'maxmankin2', 'shinyoung.park.5688', 'olivia.smith8787', 'hollybo', 'jainilgpatel', 'mounikav', 'hassanin74', 'mberthou', 'asif0047', 'lemon82124', 'lailamo95', 'curi87', '2kanghee', 'sadeghyazdi', 'dginoza', 'james.q.feng', 'soyabk1198', 'javier.laitue', 'hassanism', 'pradozurita', 'wuyiyang', 'malonej', 'wiss', 'sush2308', 'dpalanch', 'polardusk', 'wieling94', 'arnaudstolz', 'csabin18', 'xinnancao', 'palmbeach316', 'zplotzke', 'wphan604', 'felfelflafely', 'patnilki', 'archduke900', 'kaustubhshah', 'wilsonn1996', 'hallmat', 'garrett', 'alexbene', 'kiseob.jung', 'dola47', 'smalhi', 'blairhan0126', 'dheer.mehrotra', 'tsangmichael', 'mwcraig', 'stefanieark', 'tatchinj', 'pouriagh', 'pwnt818', 'salma.elshamy.754', 'dgevans86', 'kareem.waseem', 'dtassis', 'electro.ahmed', 'noobkiller0', 'alshahrooor', 'drew.sheffield.10', 'rarshad', 'junkinja', 'anthony.remo', 'alexberlingeri', 'david.luo.73', 'usfmohy', 'midomatrixrb10', 'jethro4', 'ceicher', 'daveestrada12', 'shosho.khaled.710', 'amalkaba', 'inyeal.lee', 'smallandred126', 'dkarnazes', 'robynstar87', 'isaac.labean', 'minwoo.kong.1', 'dmills9', 'mivuong1191', 'bkbkbkbk', 'shawn', 'nineta', 'audrey.hendon', 'kbradley411', 'dinohyun', 'yasmin.atef3', 'robert.botsford', 'turkiat', 'yousra.azab.9', 'aikblackarmy83', 'leehyungjoo94', 'nadine_atef', 'bshanmo', 'linus744', 'dyour', 'barofske', 'emilyxu1995', 'tusharmonapara', 'elzingan', 'ckddns777', 'woshiee123', 'gfbeales', 'mmiri', 'abalshuaibi', 'tifa.madboly', 'eece_user_03', 'ganzevol', 'jaykg37', 'catalina1986', 'goldy.sakhre', 'capel', 'josh.morris.92167789', 'vincent.chen.5494', 'bboylekz', 'shohdy', 'gcasey', 'wilsscot', 'lejustin.lv', 'vaishali.p.94', 'jthompson2645', 'mankity', 'caroline.ashraf2', 'alhaninb', 'nourin', 'void191', 'casey.gx', 'sports', 'abdullah.alshuaibi', 'chahid_abdo', 'nchiu94', 'trafalgarlove', 'hos.mohammed', 'riessa', 'sanguoshaisawesome', 'arankin', 'trevor.mackenzie117', 'matt.deno93', 'talonchandler', 'sherouknasr24', 'sj306', 'vijay_narasimhan', 'ramuamt', 'igor.josafa', 'ice7ven', 'yuexieguxiang', 'kyleeng', 'czy248200289', 'abesary', 'jessica.joussa', 'jstad', 'pf8363', 'nicolas.ivanov94', 'keyurshahrajkotgujarat', 'andrrrew', 'hala.adel.142', 'hinchmaa', 'ibnul.hussain.1', 'jperez35', 'williamtbwright', 'adam.argetsinger', 'lydia.alfred93', 'hashem.emad', 'czajkows', 'vanossp', 'riru94', 'ebram.bero.92', 'alexbenedict', 'westrab', 'ahmedkhaled93', 'lettycastrejonbarron', 'raccio14', 'ayu', 'james.jacobson.370', 'thegreatwidesomewhere', 'jiwhan328', 'deboerad', 'ellinorcrux', 'amr_taha_93', 'guseoanfflgkr', 'lavignan', 'gilletry', 'johntylerwallace', 'jeroenkorterik', 'polemale', 'reemakhaled', 'mkramer1', 'sambeau', 'maurom80', 'ahmed.tariq.94.10', 'gmorren11', 'cis', 'kurt.ahn', 'salma.ghobara', 'annaswan', 'chk0521', 'tashfiq.yazdan.alam', 'nikita.marus', 'almansouri', 'mdmobarokhossainrubel', 'kbbc1234', 'jerome.mourad', 'mpcondak', 'talesdv', 'aravind.ravi', 'sloppyjoe911', 'dominiccostajames', 'pavanchowdaryntrfan', 'hunterla', None, 'mohammed.eng1994', 'kfaist', 'es.maniego', 'g.nitish.kumar', 'pardiss1', 'warnemar', 'chengjiu.zhang.7', 'ncrofty', 'ditionq', 'harvey.hany.71', 'sumeyrakrs', 'aishsingh', 'jason.cammarata.73', 'gaigalac', 'ahmad.wael.165', 'jamesbezuk', 'ericgregg300', 'mahmoud.h.konswa', 'king27med', 'nnovak3', 'phwoook', 'yany', 'zeinahesham423']"
1,179,246,32,31,"['zplotzke', 'westrab', 'deboerad', 'barofske', 'elzingan', 'lavignan', 'gilletry', 'johntylerwallace', 'ganzevol', 'jiaolh', 'hallmat', 'josh.morris.92167789', 'wilsscot', 'gmorren11', 'alhaninb', 'void191', 'tatchinj', 'riessa', 'drew.sheffield.10', 'junkinja', 'hunterla', 'dkarnazes', 'isaac.labean', 'warnemar', 'hinchmaa', 'gaigalac', 'audrey.hendon', 'adam.argetsinger', 'wieling94', 'czajkows', 'vanossp']",215,"['michaela.ragoonath', 'alex.badmaev', 'feralfire', 'a94', 'mahmousa91', 'weicong', 'yamen', 'b.m.romeira', 'yasmin.adel.ya', 'raaidarshad', 'mohammad.kabir92', 'lazyasfcuk', 'aabadi', 'lejaym', 'danm1ch1gan', 'arya1080', 'fermioncj', 'ghostavoo', 'maxmankin2', 'shinyoung.park.5688', 'olivia.smith8787', 'hollybo', 'jainilgpatel', 'mounikav', 'hassanin74', 'mberthou', 'asif0047', 'lemon82124', 'lailamo95', 'curi87', '2kanghee', 'sadeghyazdi', 'dginoza', 'james.q.feng', 'soyabk1198', 'javier.laitue', 'hassanism', 'pradozurita', 'wuyiyang', 'malonej', 'wiss', 'sush2308', 'dpalanch', 'polardusk', 'arnaudstolz', 'csabin18', 'xinnancao', 'palmbeach316', 'wphan604', 'felfelflafely', 'patnilki', 'archduke900', 'kaustubhshah', 'wilsonn1996', 'garrett', 'alexbene', 'kiseob.jung', 'dola47', 'smalhi', 'blairhan0126', 'dheer.mehrotra', 'tsangmichael', 'mwcraig', 'stefanieark', 'pouriagh', 'pwnt818', 'salma.elshamy.754', 'dgevans86', 'dtassis', 'noobkiller0', 'alshahrooor', 'rarshad', 'anthony.remo', 'alexberlingeri', 'david.luo.73', 'usfmohy', 'midomatrixrb10', 'jethro4', 'ceicher', 'daveestrada12', 'amalkaba', 'inyeal.lee', 'smallandred126', 'robynstar87', 'minwoo.kong.1', 'dmills9', 'mivuong1191', 'bkbkbkbk', 'shawn', 'nineta', 'kbradley411', 'dinohyun', 'yasmin.atef3', 'robert.botsford', 'turkiat', 'yousra.azab.9', 'aikblackarmy83', 'leehyungjoo94', 'nadine_atef', 'bshanmo', 'linus744', 'dyour', 'emilyxu1995', 'tusharmonapara', 'ckddns777', 'woshiee123', 'gfbeales', 'mmiri', 'abalshuaibi', 'tifa.madboly', 'eece_user_03', 'jaykg37', 'catalina1986', 'goldy.sakhre', 'capel', 'vincent.chen.5494', 'bboylekz', 'gcasey', 'lejustin.lv', 'vaishali.p.94', 'jthompson2645', 'mankity', 'caroline.ashraf2', 'nourin', 'casey.gx', 'sports', 'abdullah.alshuaibi', 'chahid_abdo', 'nchiu94', 'trafalgarlove', 'hos.mohammed', 'sanguoshaisawesome', 'arankin', 'trevor.mackenzie117', 'matt.deno93', 'talonchandler', 'sherouknasr24', 'sj306', 'vijay_narasimhan', 'ramuamt', 'igor.josafa', 'ice7ven', 'yuexieguxiang', 'kyleeng', 'czy248200289', 'abesary', 'jessica.joussa', 'jstad', 'pf8363', 'nicolas.ivanov94', 'keyurshahrajkotgujarat', 'andrrrew', 'hala.adel.142', 'ibnul.hussain.1', 'jperez35', 'williamtbwright', 'lydia.alfred93', 'hashem.emad', 'riru94', 'ebram.bero.92', 'alexbenedict', 'ahmedkhaled93', 'lettycastrejonbarron', 'raccio14', 'ayu', 'james.jacobson.370', 'thegreatwidesomewhere', 'jiwhan328', 'ellinorcrux', 'guseoanfflgkr', 'jeroenkorterik', 'polemale', 'reemakhaled', 'mkramer1', 'sambeau', 'maurom80', 'ahmed.tariq.94.10', 'cis', 'kurt.ahn', 'salma.ghobara', 'annaswan', 'chk0521', 'tashfiq.yazdan.alam', 'nikita.marus', 'almansouri', 'mdmobarokhossainrubel', 'kbbc1234', 'jerome.mourad', 'mpcondak', 'talesdv', 'aravind.ravi', 'sloppyjoe911', 'dominiccostajames', 'pavanchowdaryntrfan', 'mohammed.eng1994', 'kfaist', 'es.maniego', 'g.nitish.kumar', 'pardiss1', 'chengjiu.zhang.7', 'ncrofty', 'ditionq', 'harvey.hany.71', 'sumeyrakrs', 'aishsingh', 'jason.cammarata.73', 'ahmad.wael.165', 'jamesbezuk', 'ericgregg300', 'mahmoud.h.konswa', 'king27med', 'nnovak3', 'phwoook', 'yany', 'zeinahesham423']",1,[None],247,"['michaela.ragoonath', 'alex.badmaev', 'feralfire', 'a94', 'mahmousa91', 'weicong', 'yamen', 'b.m.romeira', 'yasmin.adel.ya', 'raaidarshad', 'mohammad.kabir92', 'lazyasfcuk', 'aabadi', 'jiaolh', 'lejaym', 'danm1ch1gan', 'arya1080', 'fermioncj', 'ghostavoo', 'maxmankin2', 'shinyoung.park.5688', 'olivia.smith8787', 'hollybo', 'jainilgpatel', 'mounikav', 'hassanin74', 'mberthou', 'asif0047', 'lemon82124', 'lailamo95', 'curi87', '2kanghee', 'sadeghyazdi', 'dginoza', 'james.q.feng', 'soyabk1198', 'javier.laitue', 'hassanism', 'pradozurita', 'wuyiyang', 'malonej', 'wiss', 'sush2308', 'dpalanch', 'polardusk', 'wieling94', 'arnaudstolz', 'csabin18', 'xinnancao', 'palmbeach316', 'zplotzke', 'wphan604', 'felfelflafely', 'patnilki', 'archduke900', 'kaustubhshah', 'wilsonn1996', 'hallmat', 'garrett', 'alexbene', 'kiseob.jung', 'dola47', 'smalhi', 'blairhan0126', 'dheer.mehrotra', 'tsangmichael', 'mwcraig', 'stefanieark', 'tatchinj', 'pouriagh', 'pwnt818', 'salma.elshamy.754', 'dgevans86', 'dtassis', 'noobkiller0', 'alshahrooor', 'drew.sheffield.10', 'rarshad', 'junkinja', 'anthony.remo', 'alexberlingeri', 'david.luo.73', 'usfmohy', 'midomatrixrb10', 'jethro4', 'ceicher', 'daveestrada12', 'amalkaba', 'inyeal.lee', 'smallandred126', 'dkarnazes', 'robynstar87', 'isaac.labean', 'minwoo.kong.1', 'dmills9', 'mivuong1191', 'bkbkbkbk', 'shawn', 'nineta', 'audrey.hendon', 'kbradley411', 'dinohyun', 'yasmin.atef3', 'robert.botsford', 'turkiat', 'yousra.azab.9', 'aikblackarmy83', 'leehyungjoo94', 'nadine_atef', 'bshanmo', 'linus744', 'dyour', 'barofske', 'emilyxu1995', 'tusharmonapara', 'elzingan', 'ckddns777', 'woshiee123', 'gfbeales', 'mmiri', 'abalshuaibi', 'tifa.madboly', 'eece_user_03', 'ganzevol', 'jaykg37', 'catalina1986', 'goldy.sakhre', 'capel', 'josh.morris.92167789', 'vincent.chen.5494', 'bboylekz', 'gcasey', 'wilsscot', 'lejustin.lv', 'vaishali.p.94', 'jthompson2645', 'mankity', 'caroline.ashraf2', 'alhaninb', 'nourin', 'void191', 'casey.gx', 'sports', 'abdullah.alshuaibi', 'chahid_abdo', 'nchiu94', 'trafalgarlove', 'hos.mohammed', 'riessa', 'sanguoshaisawesome', 'arankin', 'trevor.mackenzie117', 'matt.deno93', 'talonchandler', 'sherouknasr24', 'sj306', 'vijay_narasimhan', 'ramuamt', 'igor.josafa', 'ice7ven', 'yuexieguxiang', 'kyleeng', 'czy248200289', 'abesary', 'jessica.joussa', 'jstad', 'pf8363', 'nicolas.ivanov94', 'keyurshahrajkotgujarat', 'andrrrew', 'hala.adel.142', 'hinchmaa', 'ibnul.hussain.1', 'jperez35', 'williamtbwright', 'adam.argetsinger', 'lydia.alfred93', 'hashem.emad', 'czajkows', 'vanossp', 'riru94', 'ebram.bero.92', 'alexbenedict', 'westrab', 'ahmedkhaled93', 'lettycastrejonbarron', 'raccio14', 'ayu', 'james.jacobson.370', 'thegreatwidesomewhere', 'jiwhan328', 'deboerad', 'ellinorcrux', 'guseoanfflgkr', 'lavignan', 'gilletry', 'johntylerwallace', 'jeroenkorterik', 'polemale', 'reemakhaled', 'mkramer1', 'sambeau', 'maurom80', 'ahmed.tariq.94.10', 'gmorren11', 'cis', 'kurt.ahn', 'salma.ghobara', 'annaswan', 'chk0521', 'tashfiq.yazdan.alam', 'nikita.marus', 'almansouri', 'mdmobarokhossainrubel', 'kbbc1234', 'jerome.mourad', 'mpcondak', 'talesdv', 'aravind.ravi', 'sloppyjoe911', 'dominiccostajames', 'pavanchowdaryntrfan', 'hunterla', None, 'mohammed.eng1994', 'kfaist', 'es.maniego', 'g.nitish.kumar', 'pardiss1', 'warnemar', 'chengjiu.zhang.7', 'ncrofty', 'ditionq', 'harvey.hany.71', 'sumeyrakrs', 'aishsingh', 'jason.cammarata.73', 'gaigalac', 'ahmad.wael.165', 'jamesbezuk', 'ericgregg300', 'mahmoud.h.konswa', 'king27med', 'nnovak3', 'phwoook', 'yany', 'zeinahesham423']"
1,166,246,21,20,"['weicong', 'archduke900', 'kaustubhshah', 'polemale', 'bboylekz', 'hollybo', 'dheer.mehrotra', 'jainilgpatel', 'stefanieark', 'hassanin74', 'xinnancao', 'dgevans86', 'matt.deno93', 'anthony.remo', 'sloppyjoe911', 'soyabk1198', 'kfaist', 'kbradley411', 'csabin18', 'palmbeach316']",226,"['michaela.ragoonath', 'alex.badmaev', 'feralfire', 'a94', 'mahmousa91', 'yamen', 'b.m.romeira', 'yasmin.adel.ya', 'raaidarshad', 'mohammad.kabir92', 'lazyasfcuk', 'aabadi', 'jiaolh', 'lejaym', 'danm1ch1gan', 'arya1080', 'fermioncj', 'ghostavoo', 'maxmankin2', 'shinyoung.park.5688', 'olivia.smith8787', 'mounikav', 'mberthou', 'asif0047', 'lemon82124', 'lailamo95', 'curi87', '2kanghee', 'sadeghyazdi', 'dginoza', 'james.q.feng', 'javier.laitue', 'hassanism', 'pradozurita', 'wuyiyang', 'malonej', 'wiss', 'sush2308', 'dpalanch', 'polardusk', 'wieling94', 'arnaudstolz', 'zplotzke', 'wphan604', 'felfelflafely', 'patnilki', 'wilsonn1996', 'hallmat', 'garrett', 'alexbene', 'kiseob.jung', 'dola47', 'smalhi', 'blairhan0126', 'tsangmichael', 'mwcraig', 'tatchinj', 'pouriagh', 'pwnt818', 'salma.elshamy.754', 'dtassis', 'noobkiller0', 'alshahrooor', 'drew.sheffield.10', 'rarshad', 'junkinja', 'alexberlingeri', 'david.luo.73', 'usfmohy', 'midomatrixrb10', 'jethro4', 'ceicher', 'daveestrada12', 'amalkaba', 'inyeal.lee', 'smallandred126', 'dkarnazes', 'robynstar87', 'isaac.labean', 'minwoo.kong.1', 'dmills9', 'mivuong1191', 'bkbkbkbk', 'shawn', 'nineta', 'audrey.hendon', 'dinohyun', 'yasmin.atef3', 'robert.botsford', 'turkiat', 'yousra.azab.9', 'aikblackarmy83', 'leehyungjoo94', 'nadine_atef', 'bshanmo', 'linus744', 'dyour', 'barofske', 'emilyxu1995', 'tusharmonapara', 'elzingan', 'ckddns777', 'woshiee123', 'gfbeales', 'mmiri', 'abalshuaibi', 'tifa.madboly', 'eece_user_03', 'ganzevol', 'jaykg37', 'catalina1986', 'goldy.sakhre', 'capel', 'josh.morris.92167789', 'vincent.chen.5494', 'gcasey', 'wilsscot', 'lejustin.lv', 'vaishali.p.94', 'jthompson2645', 'mankity', 'caroline.ashraf2', 'alhaninb', 'nourin', 'void191', 'casey.gx', 'sports', 'abdullah.alshuaibi', 'chahid_abdo', 'nchiu94', 'trafalgarlove', 'hos.mohammed', 'riessa', 'sanguoshaisawesome', 'arankin', 'trevor.mackenzie117', 'talonchandler', 'sherouknasr24', 'sj306', 'vijay_narasimhan', 'ramuamt', 'igor.josafa', 'ice7ven', 'yuexieguxiang', 'kyleeng', 'czy248200289', 'abesary', 'jessica.joussa', 'jstad', 'pf8363', 'nicolas.ivanov94', 'keyurshahrajkotgujarat', 'andrrrew', 'hala.adel.142', 'hinchmaa', 'ibnul.hussain.1', 'jperez35', 'williamtbwright', 'adam.argetsinger', 'lydia.alfred93', 'hashem.emad', 'czajkows', 'vanossp', 'riru94', 'ebram.bero.92', 'alexbenedict', 'westrab', 'ahmedkhaled93', 'lettycastrejonbarron', 'raccio14', 'ayu', 'james.jacobson.370', 'thegreatwidesomewhere', 'jiwhan328', 'deboerad', 'ellinorcrux', 'guseoanfflgkr', 'lavignan', 'gilletry', 'johntylerwallace', 'jeroenkorterik', 'reemakhaled', 'mkramer1', 'sambeau', 'maurom80', 'ahmed.tariq.94.10', 'gmorren11', 'cis', 'kurt.ahn', 'salma.ghobara', 'annaswan', 'chk0521', 'tashfiq.yazdan.alam', 'nikita.marus', 'almansouri', 'mdmobarokhossainrubel', 'kbbc1234', 'jerome.mourad', 'mpcondak', 'talesdv', 'aravind.ravi', 'dominiccostajames', 'pavanchowdaryntrfan', 'hunterla', 'mohammed.eng1994', 'es.maniego', 'g.nitish.kumar', 'pardiss1', 'warnemar', 'chengjiu.zhang.7', 'ncrofty', 'ditionq', 'harvey.hany.71', 'sumeyrakrs', 'aishsingh', 'jason.cammarata.73', 'gaigalac', 'ahmad.wael.165', 'jamesbezuk', 'ericgregg300', 'mahmoud.h.konswa', 'king27med', 'nnovak3', 'phwoook', 'yany', 'zeinahesham423']",1,[None],247,"['michaela.ragoonath', 'alex.badmaev', 'feralfire', 'a94', 'mahmousa91', 'weicong', 'yamen', 'b.m.romeira', 'yasmin.adel.ya', 'raaidarshad', 'mohammad.kabir92', 'lazyasfcuk', 'aabadi', 'jiaolh', 'lejaym', 'danm1ch1gan', 'arya1080', 'fermioncj', 'ghostavoo', 'maxmankin2', 'shinyoung.park.5688', 'olivia.smith8787', 'hollybo', 'jainilgpatel', 'mounikav', 'hassanin74', 'mberthou', 'asif0047', 'lemon82124', 'lailamo95', 'curi87', '2kanghee', 'sadeghyazdi', 'dginoza', 'james.q.feng', 'soyabk1198', 'javier.laitue', 'hassanism', 'pradozurita', 'wuyiyang', 'malonej', 'wiss', 'sush2308', 'dpalanch', 'polardusk', 'wieling94', 'arnaudstolz', 'csabin18', 'xinnancao', 'palmbeach316', 'zplotzke', 'wphan604', 'felfelflafely', 'patnilki', 'archduke900', 'kaustubhshah', 'wilsonn1996', 'hallmat', 'garrett', 'alexbene', 'kiseob.jung', 'dola47', 'smalhi', 'blairhan0126', 'dheer.mehrotra', 'tsangmichael', 'mwcraig', 'stefanieark', 'tatchinj', 'pouriagh', 'pwnt818', 'salma.elshamy.754', 'dgevans86', 'dtassis', 'noobkiller0', 'alshahrooor', 'drew.sheffield.10', 'rarshad', 'junkinja', 'anthony.remo', 'alexberlingeri', 'david.luo.73', 'usfmohy', 'midomatrixrb10', 'jethro4', 'ceicher', 'daveestrada12', 'amalkaba', 'inyeal.lee', 'smallandred126', 'dkarnazes', 'robynstar87', 'isaac.labean', 'minwoo.kong.1', 'dmills9', 'mivuong1191', 'bkbkbkbk', 'shawn', 'nineta', 'audrey.hendon', 'kbradley411', 'dinohyun', 'yasmin.atef3', 'robert.botsford', 'turkiat', 'yousra.azab.9', 'aikblackarmy83', 'leehyungjoo94', 'nadine_atef', 'bshanmo', 'linus744', 'dyour', 'barofske', 'emilyxu1995', 'tusharmonapara', 'elzingan', 'ckddns777', 'woshiee123', 'gfbeales', 'mmiri', 'abalshuaibi', 'tifa.madboly', 'eece_user_03', 'ganzevol', 'jaykg37', 'catalina1986', 'goldy.sakhre', 'capel', 'josh.morris.92167789', 'vincent.chen.5494', 'bboylekz', 'gcasey', 'wilsscot', 'lejustin.lv', 'vaishali.p.94', 'jthompson2645', 'mankity', 'caroline.ashraf2', 'alhaninb', 'nourin', 'void191', 'casey.gx', 'sports', 'abdullah.alshuaibi', 'chahid_abdo', 'nchiu94', 'trafalgarlove', 'hos.mohammed', 'riessa', 'sanguoshaisawesome', 'arankin', 'trevor.mackenzie117', 'matt.deno93', 'talonchandler', 'sherouknasr24', 'sj306', 'vijay_narasimhan', 'ramuamt', 'igor.josafa', 'ice7ven', 'yuexieguxiang', 'kyleeng', 'czy248200289', 'abesary', 'jessica.joussa', 'jstad', 'pf8363', 'nicolas.ivanov94', 'keyurshahrajkotgujarat', 'andrrrew', 'hala.adel.142', 'hinchmaa', 'ibnul.hussain.1', 'jperez35', 'williamtbwright', 'adam.argetsinger', 'lydia.alfred93', 'hashem.emad', 'czajkows', 'vanossp', 'riru94', 'ebram.bero.92', 'alexbenedict', 'westrab', 'ahmedkhaled93', 'lettycastrejonbarron', 'raccio14', 'ayu', 'james.jacobson.370', 'thegreatwidesomewhere', 'jiwhan328', 'deboerad', 'ellinorcrux', 'guseoanfflgkr', 'lavignan', 'gilletry', 'johntylerwallace', 'jeroenkorterik', 'polemale', 'reemakhaled', 'mkramer1', 'sambeau', 'maurom80', 'ahmed.tariq.94.10', 'gmorren11', 'cis', 'kurt.ahn', 'salma.ghobara', 'annaswan', 'chk0521', 'tashfiq.yazdan.alam', 'nikita.marus', 'almansouri', 'mdmobarokhossainrubel', 'kbbc1234', 'jerome.mourad', 'mpcondak', 'talesdv', 'aravind.ravi', 'sloppyjoe911', 'dominiccostajames', 'pavanchowdaryntrfan', 'hunterla', None, 'mohammed.eng1994', 'kfaist', 'es.maniego', 'g.nitish.kumar', 'pardiss1', 'warnemar', 'chengjiu.zhang.7', 'ncrofty', 'ditionq', 'harvey.hany.71', 'sumeyrakrs', 'aishsingh', 'jason.cammarata.73', 'gaigalac', 'ahmad.wael.165', 'jamesbezuk', 'ericgregg300', 'mahmoud.h.konswa', 'king27med', 'nnovak3', 'phwoook', 'yany', 'zeinahesham423']"
1,181,246,20,1,['inyeal.lee'],245,"['michaela.ragoonath', 'alex.badmaev', 'feralfire', 'a94', 'mahmousa91', 'weicong', 'yamen', 'b.m.romeira', 'yasmin.adel.ya', 'raaidarshad', 'mohammad.kabir92', 'lazyasfcuk', 'aabadi', 'jiaolh', 'lejaym', 'danm1ch1gan', 'arya1080', 'fermioncj', 'ghostavoo', 'maxmankin2', 'shinyoung.park.5688', 'olivia.smith8787', 'hollybo', 'jainilgpatel', 'mounikav', 'hassanin74', 'mberthou', 'asif0047', 'lemon82124', 'lailamo95', 'curi87', '2kanghee', 'sadeghyazdi', 'dginoza', 'james.q.feng', 'soyabk1198', 'javier.laitue', 'hassanism', 'pradozurita', 'wuyiyang', 'malonej', 'wiss', 'sush2308', 'dpalanch', 'polardusk', 'wieling94', 'arnaudstolz', 'csabin18', 'xinnancao', 'palmbeach316', 'zplotzke', 'wphan604', 'felfelflafely', 'patnilki', 'archduke900', 'kaustubhshah', 'wilsonn1996', 'hallmat', 'garrett', 'alexbene', 'kiseob.jung', 'dola47', 'smalhi', 'blairhan0126', 'dheer.mehrotra', 'tsangmichael', 'mwcraig', 'stefanieark', 'tatchinj', 'pouriagh', 'pwnt818', 'salma.elshamy.754', 'dgevans86', 'dtassis', 'noobkiller0', 'alshahrooor', 'drew.sheffield.10', 'rarshad', 'junkinja', 'anthony.remo', 'alexberlingeri', 'david.luo.73', 'usfmohy', 'midomatrixrb10', 'jethro4', 'ceicher', 'daveestrada12', 'amalkaba', 'smallandred126', 'dkarnazes', 'robynstar87', 'isaac.labean', 'minwoo.kong.1', 'dmills9', 'mivuong1191', 'bkbkbkbk', 'shawn', 'nineta', 'audrey.hendon', 'kbradley411', 'dinohyun', 'yasmin.atef3', 'robert.botsford', 'turkiat', 'yousra.azab.9', 'aikblackarmy83', 'leehyungjoo94', 'nadine_atef', 'bshanmo', 'linus744', 'dyour', 'barofske', 'emilyxu1995', 'tusharmonapara', 'elzingan', 'ckddns777', 'woshiee123', 'gfbeales', 'mmiri', 'abalshuaibi', 'tifa.madboly', 'eece_user_03', 'ganzevol', 'jaykg37', 'catalina1986', 'goldy.sakhre', 'capel', 'josh.morris.92167789', 'vincent.chen.5494', 'bboylekz', 'gcasey', 'wilsscot', 'lejustin.lv', 'vaishali.p.94', 'jthompson2645', 'mankity', 'caroline.ashraf2', 'alhaninb', 'nourin', 'void191', 'casey.gx', 'sports', 'abdullah.alshuaibi', 'chahid_abdo', 'nchiu94', 'trafalgarlove', 'hos.mohammed', 'riessa', 'sanguoshaisawesome', 'arankin', 'trevor.mackenzie117', 'matt.deno93', 'talonchandler', 'sherouknasr24', 'sj306', 'vijay_narasimhan', 'ramuamt', 'igor.josafa', 'ice7ven', 'yuexieguxiang', 'kyleeng', 'czy248200289', 'abesary', 'jessica.joussa', 'jstad', 'pf8363', 'nicolas.ivanov94', 'keyurshahrajkotgujarat', 'andrrrew', 'hala.adel.142', 'hinchmaa', 'ibnul.hussain.1', 'jperez35', 'williamtbwright', 'adam.argetsinger', 'lydia.alfred93', 'hashem.emad', 'czajkows', 'vanossp', 'riru94', 'ebram.bero.92', 'alexbenedict', 'westrab', 'ahmedkhaled93', 'lettycastrejonbarron', 'raccio14', 'ayu', 'james.jacobson.370', 'thegreatwidesomewhere', 'jiwhan328', 'deboerad', 'ellinorcrux', 'guseoanfflgkr', 'lavignan', 'gilletry', 'johntylerwallace', 'jeroenkorterik', 'polemale', 'reemakhaled', 'mkramer1', 'sambeau', 'maurom80', 'ahmed.tariq.94.10', 'gmorren11', 'cis', 'kurt.ahn', 'salma.ghobara', 'annaswan', 'chk0521', 'tashfiq.yazdan.alam', 'nikita.marus', 'almansouri', 'mdmobarokhossainrubel', 'kbbc1234', 'jerome.mourad', 'mpcondak', 'talesdv', 'aravind.ravi', 'sloppyjoe911', 'dominiccostajames', 'pavanchowdaryntrfan', 'hunterla', 'mohammed.eng1994', 'kfaist', 'es.maniego', 'g.nitish.kumar', 'pardiss1', 'warnemar', 'chengjiu.zhang.7', 'ncrofty', 'ditionq', 'harvey.hany.71', 'sumeyrakrs', 'aishsingh', 'jason.cammarata.73', 'gaigalac', 'ahmad.wael.165', 'jamesbezuk', 'ericgregg300', 'mahmoud.h.konswa', 'king27med', 'nnovak3', 'phwoook', 'yany', 'zeinahesham423']",19,"['harusari7', 'wngustlr5936', 'wjh4026', 'dowkzld1010', 'nam.hyeonwoo.7', 'nanosap', 'jongho7950', '1218g', 'gyeongsu.sim', 'cyj667', 'dkdud6874', 'dowkzld10', 'ssong4667', None, 'weare1235', 'hyukdoo.jang', 'qkssms1', 'ssj5711', 'junseog.jeon']",265,"['michaela.ragoonath', 'alex.badmaev', 'harusari7', 'feralfire', 'a94', 'mahmousa91', 'weicong', 'wjh4026', 'yamen', 'b.m.romeira', 'yasmin.adel.ya', 'raaidarshad', 'mohammad.kabir92', 'lazyasfcuk', 'aabadi', 'jiaolh', 'lejaym', 'danm1ch1gan', 'arya1080', 'fermioncj', 'dowkzld1010', 'ghostavoo', 'maxmankin2', 'nam.hyeonwoo.7', 'shinyoung.park.5688', 'olivia.smith8787', 'hollybo', 'jainilgpatel', 'mounikav', 'hassanin74', 'mberthou', 'asif0047', 'lemon82124', 'lailamo95', 'curi87', '2kanghee', 'sadeghyazdi', 'dginoza', 'james.q.feng', 'soyabk1198', 'javier.laitue', 'hassanism', 'pradozurita', 'wuyiyang', 'qkssms1', 'malonej', 'wiss', 'sush2308', 'dpalanch', 'ssj5711', 'polardusk', 'wieling94', 'arnaudstolz', 'csabin18', 'xinnancao', 'palmbeach316', 'zplotzke', 'wphan604', 'felfelflafely', 'patnilki', 'archduke900', 'kaustubhshah', 'wilsonn1996', 'hallmat', 'garrett', 'alexbene', 'kiseob.jung', 'dola47', 'nanosap', 'smalhi', 'blairhan0126', 'dheer.mehrotra', 'tsangmichael', 'mwcraig', 'stefanieark', 'tatchinj', 'pouriagh', 'pwnt818', 'salma.elshamy.754', 'dgevans86', 'dtassis', 'noobkiller0', 'alshahrooor', 'drew.sheffield.10', 'rarshad', 'junkinja', 'anthony.remo', 'alexberlingeri', 'david.luo.73', 'usfmohy', 'midomatrixrb10', 'jethro4', 'ceicher', 'daveestrada12', 'dowkzld10', 'ssong4667', 'amalkaba', 'inyeal.lee', 'smallandred126', 'dkarnazes', 'robynstar87', 'isaac.labean', 'minwoo.kong.1', 'dmills9', 'mivuong1191', 'bkbkbkbk', 'shawn', 'nineta', 'audrey.hendon', 'kbradley411', 'dinohyun', 'yasmin.atef3', 'robert.botsford', 'turkiat', 'yousra.azab.9', 'aikblackarmy83', 'leehyungjoo94', 'nadine_atef', 'bshanmo', 'linus744', 'dyour', 'barofske', 'emilyxu1995', 'tusharmonapara', 'elzingan', 'ckddns777', 'woshiee123', 'gfbeales', 'mmiri', 'abalshuaibi', 'tifa.madboly', 'eece_user_03', 'ganzevol', 'jaykg37', 'catalina1986', 'goldy.sakhre', 'capel', 'josh.morris.92167789', 'vincent.chen.5494', 'bboylekz', 'jongho7950', 'gcasey', 'wilsscot', 'lejustin.lv', 'vaishali.p.94', 'jthompson2645', 'mankity', 'caroline.ashraf2', 'alhaninb', 'nourin', 'void191', 'casey.gx', 'sports', 'abdullah.alshuaibi', 'chahid_abdo', 'nchiu94', 'trafalgarlove', 'hos.mohammed', 'riessa', 'sanguoshaisawesome', 'cyj667', 'arankin', 'trevor.mackenzie117', 'matt.deno93', 'talonchandler', 'sherouknasr24', 'sj306', 'vijay_narasimhan', 'ramuamt', 'igor.josafa', 'ice7ven', 'yuexieguxiang', 'kyleeng', 'czy248200289', 'abesary', 'jessica.joussa', 'jstad', 'pf8363', 'nicolas.ivanov94', 'keyurshahrajkotgujarat', 'weare1235', 'hyukdoo.jang', 'andrrrew', 'hala.adel.142', 'hinchmaa', 'ibnul.hussain.1', 'jperez35', 'williamtbwright', 'adam.argetsinger', 'lydia.alfred93', 'hashem.emad', 'czajkows', 'vanossp', 'riru94', 'ebram.bero.92', 'alexbenedict', 'westrab', 'ahmedkhaled93', 'lettycastrejonbarron', 'raccio14', 'ayu', 'james.jacobson.370', 'thegreatwidesomewhere', 'jiwhan328', 'deboerad', 'ellinorcrux', 'wngustlr5936', 'guseoanfflgkr', 'lavignan', 'gilletry', 'johntylerwallace', 'jeroenkorterik', 'polemale', 'reemakhaled', 'mkramer1', 'sambeau', 'maurom80', 'ahmed.tariq.94.10', 'gmorren11', 'cis', '1218g', 'gyeongsu.sim', 'kurt.ahn', 'dkdud6874', 'salma.ghobara', 'annaswan', 'chk0521', 'tashfiq.yazdan.alam', 'nikita.marus', 'almansouri', 'mdmobarokhossainrubel', 'kbbc1234', 'jerome.mourad', 'mpcondak', 'talesdv', 'aravind.ravi', 'sloppyjoe911', 'dominiccostajames', 'pavanchowdaryntrfan', 'hunterla', None, 'mohammed.eng1994', 'kfaist', 'es.maniego', 'g.nitish.kumar', 'pardiss1', 'warnemar', 'chengjiu.zhang.7', 'ncrofty', 'ditionq', 'harvey.hany.71', 'sumeyrakrs', 'aishsingh', 'jason.cammarata.73', 'gaigalac', 'ahmad.wael.165', 'jamesbezuk', 'ericgregg300', 'mahmoud.h.konswa', 'king27med', 'nnovak3', 'junseog.jeon', 'phwoook', 'yany', 'zeinahesham423']"
1,169,246,18,17,"['sambeau', 'wuyiyang', 'bshanmo', 'mkramer1', 'dyour', 'rarshad', 'mpcondak', 'nourin', 'jamesbezuk', 'mounikav', 'dginoza', 'lazyasfcuk', 'annaswan', 'pf8363', 'abesary', 'capel', 'yany']",229,"['michaela.ragoonath', 'alex.badmaev', 'feralfire', 'a94', 'mahmousa91', 'weicong', 'yamen', 'b.m.romeira', 'yasmin.adel.ya', 'raaidarshad', 'mohammad.kabir92', 'aabadi', 'jiaolh', 'lejaym', 'danm1ch1gan', 'arya1080', 'fermioncj', 'ghostavoo', 'maxmankin2', 'shinyoung.park.5688', 'olivia.smith8787', 'hollybo', 'jainilgpatel', 'hassanin74', 'mberthou', 'asif0047', 'lemon82124', 'lailamo95', 'curi87', '2kanghee', 'sadeghyazdi', 'james.q.feng', 'soyabk1198', 'javier.laitue', 'hassanism', 'pradozurita', 'malonej', 'wiss', 'sush2308', 'dpalanch', 'polardusk', 'wieling94', 'arnaudstolz', 'csabin18', 'xinnancao', 'palmbeach316', 'zplotzke', 'wphan604', 'felfelflafely', 'patnilki', 'archduke900', 'kaustubhshah', 'wilsonn1996', 'hallmat', 'garrett', 'alexbene', 'kiseob.jung', 'dola47', 'smalhi', 'blairhan0126', 'dheer.mehrotra', 'tsangmichael', 'mwcraig', 'stefanieark', 'tatchinj', 'pouriagh', 'pwnt818', 'salma.elshamy.754', 'dgevans86', 'dtassis', 'noobkiller0', 'alshahrooor', 'drew.sheffield.10', 'junkinja', 'anthony.remo', 'alexberlingeri', 'david.luo.73', 'usfmohy', 'midomatrixrb10', 'jethro4', 'ceicher', 'daveestrada12', 'amalkaba', 'inyeal.lee', 'smallandred126', 'dkarnazes', 'robynstar87', 'isaac.labean', 'minwoo.kong.1', 'dmills9', 'mivuong1191', 'bkbkbkbk', 'shawn', 'nineta', 'audrey.hendon', 'kbradley411', 'dinohyun', 'yasmin.atef3', 'robert.botsford', 'turkiat', 'yousra.azab.9', 'aikblackarmy83', 'leehyungjoo94', 'nadine_atef', 'linus744', 'barofske', 'emilyxu1995', 'tusharmonapara', 'elzingan', 'ckddns777', 'woshiee123', 'gfbeales', 'mmiri', 'abalshuaibi', 'tifa.madboly', 'eece_user_03', 'ganzevol', 'jaykg37', 'catalina1986', 'goldy.sakhre', 'josh.morris.92167789', 'vincent.chen.5494', 'bboylekz', 'gcasey', 'wilsscot', 'lejustin.lv', 'vaishali.p.94', 'jthompson2645', 'mankity', 'caroline.ashraf2', 'alhaninb', 'void191', 'casey.gx', 'sports', 'abdullah.alshuaibi', 'chahid_abdo', 'nchiu94', 'trafalgarlove', 'hos.mohammed', 'riessa', 'sanguoshaisawesome', 'arankin', 'trevor.mackenzie117', 'matt.deno93', 'talonchandler', 'sherouknasr24', 'sj306', 'vijay_narasimhan', 'ramuamt', 'igor.josafa', 'ice7ven', 'yuexieguxiang', 'kyleeng', 'czy248200289', 'jessica.joussa', 'jstad', 'nicolas.ivanov94', 'keyurshahrajkotgujarat', 'andrrrew', 'hala.adel.142', 'hinchmaa', 'ibnul.hussain.1', 'jperez35', 'williamtbwright', 'adam.argetsinger', 'lydia.alfred93', 'hashem.emad', 'czajkows', 'vanossp', 'riru94', 'ebram.bero.92', 'alexbenedict', 'westrab', 'ahmedkhaled93', 'lettycastrejonbarron', 'raccio14', 'ayu', 'james.jacobson.370', 'thegreatwidesomewhere', 'jiwhan328', 'deboerad', 'ellinorcrux', 'guseoanfflgkr', 'lavignan', 'gilletry', 'johntylerwallace', 'jeroenkorterik', 'polemale', 'reemakhaled', 'maurom80', 'ahmed.tariq.94.10', 'gmorren11', 'cis', 'kurt.ahn', 'salma.ghobara', 'chk0521', 'tashfiq.yazdan.alam', 'nikita.marus', 'almansouri', 'mdmobarokhossainrubel', 'kbbc1234', 'jerome.mourad', 'talesdv', 'aravind.ravi', 'sloppyjoe911', 'dominiccostajames', 'pavanchowdaryntrfan', 'hunterla', 'mohammed.eng1994', 'kfaist', 'es.maniego', 'g.nitish.kumar', 'pardiss1', 'warnemar', 'chengjiu.zhang.7', 'ncrofty', 'ditionq', 'harvey.hany.71', 'sumeyrakrs', 'aishsingh', 'jason.cammarata.73', 'gaigalac', 'ahmad.wael.165', 'ericgregg300', 'mahmoud.h.konswa', 'king27med', 'nnovak3', 'phwoook', 'zeinahesham423']",1,[None],247,"['michaela.ragoonath', 'alex.badmaev', 'feralfire', 'a94', 'mahmousa91', 'weicong', 'yamen', 'b.m.romeira', 'yasmin.adel.ya', 'raaidarshad', 'mohammad.kabir92', 'lazyasfcuk', 'aabadi', 'jiaolh', 'lejaym', 'danm1ch1gan', 'arya1080', 'fermioncj', 'ghostavoo', 'maxmankin2', 'shinyoung.park.5688', 'olivia.smith8787', 'hollybo', 'jainilgpatel', 'mounikav', 'hassanin74', 'mberthou', 'asif0047', 'lemon82124', 'lailamo95', 'curi87', '2kanghee', 'sadeghyazdi', 'dginoza', 'james.q.feng', 'soyabk1198', 'javier.laitue', 'hassanism', 'pradozurita', 'wuyiyang', 'malonej', 'wiss', 'sush2308', 'dpalanch', 'polardusk', 'wieling94', 'arnaudstolz', 'csabin18', 'xinnancao', 'palmbeach316', 'zplotzke', 'wphan604', 'felfelflafely', 'patnilki', 'archduke900', 'kaustubhshah', 'wilsonn1996', 'hallmat', 'garrett', 'alexbene', 'kiseob.jung', 'dola47', 'smalhi', 'blairhan0126', 'dheer.mehrotra', 'tsangmichael', 'mwcraig', 'stefanieark', 'tatchinj', 'pouriagh', 'pwnt818', 'salma.elshamy.754', 'dgevans86', 'dtassis', 'noobkiller0', 'alshahrooor', 'drew.sheffield.10', 'rarshad', 'junkinja', 'anthony.remo', 'alexberlingeri', 'david.luo.73', 'usfmohy', 'midomatrixrb10', 'jethro4', 'ceicher', 'daveestrada12', 'amalkaba', 'inyeal.lee', 'smallandred126', 'dkarnazes', 'robynstar87', 'isaac.labean', 'minwoo.kong.1', 'dmills9', 'mivuong1191', 'bkbkbkbk', 'shawn', 'nineta', 'audrey.hendon', 'kbradley411', 'dinohyun', 'yasmin.atef3', 'robert.botsford', 'turkiat', 'yousra.azab.9', 'aikblackarmy83', 'leehyungjoo94', 'nadine_atef', 'bshanmo', 'linus744', 'dyour', 'barofske', 'emilyxu1995', 'tusharmonapara', 'elzingan', 'ckddns777', 'woshiee123', 'gfbeales', 'mmiri', 'abalshuaibi', 'tifa.madboly', 'eece_user_03', 'ganzevol', 'jaykg37', 'catalina1986', 'goldy.sakhre', 'capel', 'josh.morris.92167789', 'vincent.chen.5494', 'bboylekz', 'gcasey', 'wilsscot', 'lejustin.lv', 'vaishali.p.94', 'jthompson2645', 'mankity', 'caroline.ashraf2', 'alhaninb', 'nourin', 'void191', 'casey.gx', 'sports', 'abdullah.alshuaibi', 'chahid_abdo', 'nchiu94', 'trafalgarlove', 'hos.mohammed', 'riessa', 'sanguoshaisawesome', 'arankin', 'trevor.mackenzie117', 'matt.deno93', 'talonchandler', 'sherouknasr24', 'sj306', 'vijay_narasimhan', 'ramuamt', 'igor.josafa', 'ice7ven', 'yuexieguxiang', 'kyleeng', 'czy248200289', 'abesary', 'jessica.joussa', 'jstad', 'pf8363', 'nicolas.ivanov94', 'keyurshahrajkotgujarat', 'andrrrew', 'hala.adel.142', 'hinchmaa', 'ibnul.hussain.1', 'jperez35', 'williamtbwright', 'adam.argetsinger', 'lydia.alfred93', 'hashem.emad', 'czajkows', 'vanossp', 'riru94', 'ebram.bero.92', 'alexbenedict', 'westrab', 'ahmedkhaled93', 'lettycastrejonbarron', 'raccio14', 'ayu', 'james.jacobson.370', 'thegreatwidesomewhere', 'jiwhan328', 'deboerad', 'ellinorcrux', 'guseoanfflgkr', 'lavignan', 'gilletry', 'johntylerwallace', 'jeroenkorterik', 'polemale', 'reemakhaled', 'mkramer1', 'sambeau', 'maurom80', 'ahmed.tariq.94.10', 'gmorren11', 'cis', 'kurt.ahn', 'salma.ghobara', 'annaswan', 'chk0521', 'tashfiq.yazdan.alam', 'nikita.marus', 'almansouri', 'mdmobarokhossainrubel', 'kbbc1234', 'jerome.mourad', 'mpcondak', 'talesdv', 'aravind.ravi', 'sloppyjoe911', 'dominiccostajames', 'pavanchowdaryntrfan', 'hunterla', None, 'mohammed.eng1994', 'kfaist', 'es.maniego', 'g.nitish.kumar', 'pardiss1', 'warnemar', 'chengjiu.zhang.7', 'ncrofty', 'ditionq', 'harvey.hany.71', 'sumeyrakrs', 'aishsingh', 'jason.cammarata.73', 'gaigalac', 'ahmad.wael.165', 'jamesbezuk', 'ericgregg300', 'mahmoud.h.konswa', 'king27med', 'nnovak3', 'phwoook', 'yany', 'zeinahesham423']"
1,176,246,9,8,"['kiseob.jung', 'shinyoung.park.5688', 'minwoo.kong.1', 'kbbc1234', '2kanghee', 'ckddns777', 'phwoook', 'fermioncj']",238,"['michaela.ragoonath', 'alex.badmaev', 'feralfire', 'a94', 'mahmousa91', 'weicong', 'yamen', 'b.m.romeira', 'yasmin.adel.ya', 'raaidarshad', 'mohammad.kabir92', 'lazyasfcuk', 'aabadi', 'jiaolh', 'lejaym', 'danm1ch1gan', 'arya1080', 'ghostavoo', 'maxmankin2', 'olivia.smith8787', 'hollybo', 'jainilgpatel', 'mounikav', 'hassanin74', 'mberthou', 'asif0047', 'lemon82124', 'lailamo95', 'curi87', 'sadeghyazdi', 'dginoza', 'james.q.feng', 'soyabk1198', 'javier.laitue', 'hassanism', 'pradozurita', 'wuyiyang', 'malonej', 'wiss', 'sush2308', 'dpalanch', 'polardusk', 'wieling94', 'arnaudstolz', 'csabin18', 'xinnancao', 'palmbeach316', 'zplotzke', 'wphan604', 'felfelflafely', 'patnilki', 'archduke900', 'kaustubhshah', 'wilsonn1996', 'hallmat', 'garrett', 'alexbene', 'dola47', 'smalhi', 'blairhan0126', 'dheer.mehrotra', 'tsangmichael', 'mwcraig', 'stefanieark', 'tatchinj', 'pouriagh', 'pwnt818', 'salma.elshamy.754', 'dgevans86', 'dtassis', 'noobkiller0', 'alshahrooor', 'drew.sheffield.10', 'rarshad', 'junkinja', 'anthony.remo', 'alexberlingeri', 'david.luo.73', 'usfmohy', 'midomatrixrb10', 'jethro4', 'ceicher', 'daveestrada12', 'amalkaba', 'inyeal.lee', 'smallandred126', 'dkarnazes', 'robynstar87', 'isaac.labean', 'dmills9', 'mivuong1191', 'bkbkbkbk', 'shawn', 'nineta', 'audrey.hendon', 'kbradley411', 'dinohyun', 'yasmin.atef3', 'robert.botsford', 'turkiat', 'yousra.azab.9', 'aikblackarmy83', 'leehyungjoo94', 'nadine_atef', 'bshanmo', 'linus744', 'dyour', 'barofske', 'emilyxu1995', 'tusharmonapara', 'elzingan', 'woshiee123', 'gfbeales', 'mmiri', 'abalshuaibi', 'tifa.madboly', 'eece_user_03', 'ganzevol', 'jaykg37', 'catalina1986', 'goldy.sakhre', 'capel', 'josh.morris.92167789', 'vincent.chen.5494', 'bboylekz', 'gcasey', 'wilsscot', 'lejustin.lv', 'vaishali.p.94', 'jthompson2645', 'mankity', 'caroline.ashraf2', 'alhaninb', 'nourin', 'void191', 'casey.gx', 'sports', 'abdullah.alshuaibi', 'chahid_abdo', 'nchiu94', 'trafalgarlove', 'hos.mohammed', 'riessa', 'sanguoshaisawesome', 'arankin', 'trevor.mackenzie117', 'matt.deno93', 'talonchandler', 'sherouknasr24', 'sj306', 'vijay_narasimhan', 'ramuamt', 'igor.josafa', 'ice7ven', 'yuexieguxiang', 'kyleeng', 'czy248200289', 'abesary', 'jessica.joussa', 'jstad', 'pf8363', 'nicolas.ivanov94', 'keyurshahrajkotgujarat', 'andrrrew', 'hala.adel.142', 'hinchmaa', 'ibnul.hussain.1', 'jperez35', 'williamtbwright', 'adam.argetsinger', 'lydia.alfred93', 'hashem.emad', 'czajkows', 'vanossp', 'riru94', 'ebram.bero.92', 'alexbenedict', 'westrab', 'ahmedkhaled93', 'lettycastrejonbarron', 'raccio14', 'ayu', 'james.jacobson.370', 'thegreatwidesomewhere', 'jiwhan328', 'deboerad', 'ellinorcrux', 'guseoanfflgkr', 'lavignan', 'gilletry', 'johntylerwallace', 'jeroenkorterik', 'polemale', 'reemakhaled', 'mkramer1', 'sambeau', 'maurom80', 'ahmed.tariq.94.10', 'gmorren11', 'cis', 'kurt.ahn', 'salma.ghobara', 'annaswan', 'chk0521', 'tashfiq.yazdan.alam', 'nikita.marus', 'almansouri', 'mdmobarokhossainrubel', 'jerome.mourad', 'mpcondak', 'talesdv', 'aravind.ravi', 'sloppyjoe911', 'dominiccostajames', 'pavanchowdaryntrfan', 'hunterla', 'mohammed.eng1994', 'kfaist', 'es.maniego', 'g.nitish.kumar', 'pardiss1', 'warnemar', 'chengjiu.zhang.7', 'ncrofty', 'ditionq', 'harvey.hany.71', 'sumeyrakrs', 'aishsingh', 'jason.cammarata.73', 'gaigalac', 'ahmad.wael.165', 'jamesbezuk', 'ericgregg300', 'mahmoud.h.konswa', 'king27med', 'nnovak3', 'yany', 'zeinahesham423']",1,[None],247,"['michaela.ragoonath', 'alex.badmaev', 'feralfire', 'a94', 'mahmousa91', 'weicong', 'yamen', 'b.m.romeira', 'yasmin.adel.ya', 'raaidarshad', 'mohammad.kabir92', 'lazyasfcuk', 'aabadi', 'jiaolh', 'lejaym', 'danm1ch1gan', 'arya1080', 'fermioncj', 'ghostavoo', 'maxmankin2', 'shinyoung.park.5688', 'olivia.smith8787', 'hollybo', 'jainilgpatel', 'mounikav', 'hassanin74', 'mberthou', 'asif0047', 'lemon82124', 'lailamo95', 'curi87', '2kanghee', 'sadeghyazdi', 'dginoza', 'james.q.feng', 'soyabk1198', 'javier.laitue', 'hassanism', 'pradozurita', 'wuyiyang', 'malonej', 'wiss', 'sush2308', 'dpalanch', 'polardusk', 'wieling94', 'arnaudstolz', 'csabin18', 'xinnancao', 'palmbeach316', 'zplotzke', 'wphan604', 'felfelflafely', 'patnilki', 'archduke900', 'kaustubhshah', 'wilsonn1996', 'hallmat', 'garrett', 'alexbene', 'kiseob.jung', 'dola47', 'smalhi', 'blairhan0126', 'dheer.mehrotra', 'tsangmichael', 'mwcraig', 'stefanieark', 'tatchinj', 'pouriagh', 'pwnt818', 'salma.elshamy.754', 'dgevans86', 'dtassis', 'noobkiller0', 'alshahrooor', 'drew.sheffield.10', 'rarshad', 'junkinja', 'anthony.remo', 'alexberlingeri', 'david.luo.73', 'usfmohy', 'midomatrixrb10', 'jethro4', 'ceicher', 'daveestrada12', 'amalkaba', 'inyeal.lee', 'smallandred126', 'dkarnazes', 'robynstar87', 'isaac.labean', 'minwoo.kong.1', 'dmills9', 'mivuong1191', 'bkbkbkbk', 'shawn', 'nineta', 'audrey.hendon', 'kbradley411', 'dinohyun', 'yasmin.atef3', 'robert.botsford', 'turkiat', 'yousra.azab.9', 'aikblackarmy83', 'leehyungjoo94', 'nadine_atef', 'bshanmo', 'linus744', 'dyour', 'barofske', 'emilyxu1995', 'tusharmonapara', 'elzingan', 'ckddns777', 'woshiee123', 'gfbeales', 'mmiri', 'abalshuaibi', 'tifa.madboly', 'eece_user_03', 'ganzevol', 'jaykg37', 'catalina1986', 'goldy.sakhre', 'capel', 'josh.morris.92167789', 'vincent.chen.5494', 'bboylekz', 'gcasey', 'wilsscot', 'lejustin.lv', 'vaishali.p.94', 'jthompson2645', 'mankity', 'caroline.ashraf2', 'alhaninb', 'nourin', 'void191', 'casey.gx', 'sports', 'abdullah.alshuaibi', 'chahid_abdo', 'nchiu94', 'trafalgarlove', 'hos.mohammed', 'riessa', 'sanguoshaisawesome', 'arankin', 'trevor.mackenzie117', 'matt.deno93', 'talonchandler', 'sherouknasr24', 'sj306', 'vijay_narasimhan', 'ramuamt', 'igor.josafa', 'ice7ven', 'yuexieguxiang', 'kyleeng', 'czy248200289', 'abesary', 'jessica.joussa', 'jstad', 'pf8363', 'nicolas.ivanov94', 'keyurshahrajkotgujarat', 'andrrrew', 'hala.adel.142', 'hinchmaa', 'ibnul.hussain.1', 'jperez35', 'williamtbwright', 'adam.argetsinger', 'lydia.alfred93', 'hashem.emad', 'czajkows', 'vanossp', 'riru94', 'ebram.bero.92', 'alexbenedict', 'westrab', 'ahmedkhaled93', 'lettycastrejonbarron', 'raccio14', 'ayu', 'james.jacobson.370', 'thegreatwidesomewhere', 'jiwhan328', 'deboerad', 'ellinorcrux', 'guseoanfflgkr', 'lavignan', 'gilletry', 'johntylerwallace', 'jeroenkorterik', 'polemale', 'reemakhaled', 'mkramer1', 'sambeau', 'maurom80', 'ahmed.tariq.94.10', 'gmorren11', 'cis', 'kurt.ahn', 'salma.ghobara', 'annaswan', 'chk0521', 'tashfiq.yazdan.alam', 'nikita.marus', 'almansouri', 'mdmobarokhossainrubel', 'kbbc1234', 'jerome.mourad', 'mpcondak', 'talesdv', 'aravind.ravi', 'sloppyjoe911', 'dominiccostajames', 'pavanchowdaryntrfan', 'hunterla', None, 'mohammed.eng1994', 'kfaist', 'es.maniego', 'g.nitish.kumar', 'pardiss1', 'warnemar', 'chengjiu.zhang.7', 'ncrofty', 'ditionq', 'harvey.hany.71', 'sumeyrakrs', 'aishsingh', 'jason.cammarata.73', 'gaigalac', 'ahmad.wael.165', 'jamesbezuk', 'ericgregg300', 'mahmoud.h.konswa', 'king27med', 'nnovak3', 'phwoook', 'yany', 'zeinahesham423']"
1,177,246,9,7,"['turkiat', 'almansouri', 'lettycastrejonbarron', 'alshahrooor', 'sumeyrakrs', 'abdullah.alshuaibi', 'javier.laitue']",239,"['michaela.ragoonath', 'alex.badmaev', 'feralfire', 'a94', 'mahmousa91', 'weicong', 'yamen', 'b.m.romeira', 'yasmin.adel.ya', 'raaidarshad', 'mohammad.kabir92', 'lazyasfcuk', 'aabadi', 'jiaolh', 'lejaym', 'danm1ch1gan', 'arya1080', 'fermioncj', 'ghostavoo', 'maxmankin2', 'shinyoung.park.5688', 'olivia.smith8787', 'hollybo', 'jainilgpatel', 'mounikav', 'hassanin74', 'mberthou', 'asif0047', 'lemon82124', 'lailamo95', 'curi87', '2kanghee', 'sadeghyazdi', 'dginoza', 'james.q.feng', 'soyabk1198', 'hassanism', 'pradozurita', 'wuyiyang', 'malonej', 'wiss', 'sush2308', 'dpalanch', 'polardusk', 'wieling94', 'arnaudstolz', 'csabin18', 'xinnancao', 'palmbeach316', 'zplotzke', 'wphan604', 'felfelflafely', 'patnilki', 'archduke900', 'kaustubhshah', 'wilsonn1996', 'hallmat', 'garrett', 'alexbene', 'kiseob.jung', 'dola47', 'smalhi', 'blairhan0126', 'dheer.mehrotra', 'tsangmichael', 'mwcraig', 'stefanieark', 'tatchinj', 'pouriagh', 'pwnt818', 'salma.elshamy.754', 'dgevans86', 'dtassis', 'noobkiller0', 'drew.sheffield.10', 'rarshad', 'junkinja', 'anthony.remo', 'alexberlingeri', 'david.luo.73', 'usfmohy', 'midomatrixrb10', 'jethro4', 'ceicher', 'daveestrada12', 'amalkaba', 'inyeal.lee', 'smallandred126', 'dkarnazes', 'robynstar87', 'isaac.labean', 'minwoo.kong.1', 'dmills9', 'mivuong1191', 'bkbkbkbk', 'shawn', 'nineta', 'audrey.hendon', 'kbradley411', 'dinohyun', 'yasmin.atef3', 'robert.botsford', 'yousra.azab.9', 'aikblackarmy83', 'leehyungjoo94', 'nadine_atef', 'bshanmo', 'linus744', 'dyour', 'barofske', 'emilyxu1995', 'tusharmonapara', 'elzingan', 'ckddns777', 'woshiee123', 'gfbeales', 'mmiri', 'abalshuaibi', 'tifa.madboly', 'eece_user_03', 'ganzevol', 'jaykg37', 'catalina1986', 'goldy.sakhre', 'capel', 'josh.morris.92167789', 'vincent.chen.5494', 'bboylekz', 'gcasey', 'wilsscot', 'lejustin.lv', 'vaishali.p.94', 'jthompson2645', 'mankity', 'caroline.ashraf2', 'alhaninb', 'nourin', 'void191', 'casey.gx', 'sports', 'chahid_abdo', 'nchiu94', 'trafalgarlove', 'hos.mohammed', 'riessa', 'sanguoshaisawesome', 'arankin', 'trevor.mackenzie117', 'matt.deno93', 'talonchandler', 'sherouknasr24', 'sj306', 'vijay_narasimhan', 'ramuamt', 'igor.josafa', 'ice7ven', 'yuexieguxiang', 'kyleeng', 'czy248200289', 'abesary', 'jessica.joussa', 'jstad', 'pf8363', 'nicolas.ivanov94', 'keyurshahrajkotgujarat', 'andrrrew', 'hala.adel.142', 'hinchmaa', 'ibnul.hussain.1', 'jperez35', 'williamtbwright', 'adam.argetsinger', 'lydia.alfred93', 'hashem.emad', 'czajkows', 'vanossp', 'riru94', 'ebram.bero.92', 'alexbenedict', 'westrab', 'ahmedkhaled93', 'raccio14', 'ayu', 'james.jacobson.370', 'thegreatwidesomewhere', 'jiwhan328', 'deboerad', 'ellinorcrux', 'guseoanfflgkr', 'lavignan', 'gilletry', 'johntylerwallace', 'jeroenkorterik', 'polemale', 'reemakhaled', 'mkramer1', 'sambeau', 'maurom80', 'ahmed.tariq.94.10', 'gmorren11', 'cis', 'kurt.ahn', 'salma.ghobara', 'annaswan', 'chk0521', 'tashfiq.yazdan.alam', 'nikita.marus', 'mdmobarokhossainrubel', 'kbbc1234', 'jerome.mourad', 'mpcondak', 'talesdv', 'aravind.ravi', 'sloppyjoe911', 'dominiccostajames', 'pavanchowdaryntrfan', 'hunterla', 'mohammed.eng1994', 'kfaist', 'es.maniego', 'g.nitish.kumar', 'pardiss1', 'warnemar', 'chengjiu.zhang.7', 'ncrofty', 'ditionq', 'harvey.hany.71', 'aishsingh', 'jason.cammarata.73', 'gaigalac', 'ahmad.wael.165', 'jamesbezuk', 'ericgregg300', 'mahmoud.h.konswa', 'king27med', 'nnovak3', 'phwoook', 'yany', 'zeinahesham423']",2,"['mtgho', None]",248,"['michaela.ragoonath', 'alex.badmaev', 'feralfire', 'a94', 'mahmousa91', 'weicong', 'yamen', 'b.m.romeira', 'yasmin.adel.ya', 'raaidarshad', 'mohammad.kabir92', 'lazyasfcuk', 'aabadi', 'jiaolh', 'lejaym', 'danm1ch1gan', 'arya1080', 'fermioncj', 'ghostavoo', 'maxmankin2', 'shinyoung.park.5688', 'olivia.smith8787', 'hollybo', 'jainilgpatel', 'mounikav', 'hassanin74', 'mberthou', 'asif0047', 'lemon82124', 'lailamo95', 'curi87', '2kanghee', 'sadeghyazdi', 'dginoza', 'james.q.feng', 'soyabk1198', 'javier.laitue', 'hassanism', 'pradozurita', 'wuyiyang', 'malonej', 'wiss', 'sush2308', 'dpalanch', 'polardusk', 'wieling94', 'arnaudstolz', 'csabin18', 'xinnancao', 'palmbeach316', 'zplotzke', 'wphan604', 'felfelflafely', 'patnilki', 'archduke900', 'kaustubhshah', 'wilsonn1996', 'hallmat', 'garrett', 'alexbene', 'kiseob.jung', 'dola47', 'mtgho', 'smalhi', 'blairhan0126', 'dheer.mehrotra', 'tsangmichael', 'mwcraig', 'stefanieark', 'tatchinj', 'pouriagh', 'pwnt818', 'salma.elshamy.754', 'dgevans86', 'dtassis', 'noobkiller0', 'alshahrooor', 'drew.sheffield.10', 'rarshad', 'junkinja', 'anthony.remo', 'alexberlingeri', 'david.luo.73', 'usfmohy', 'midomatrixrb10', 'jethro4', 'ceicher', 'daveestrada12', 'amalkaba', 'inyeal.lee', 'smallandred126', 'dkarnazes', 'robynstar87', 'isaac.labean', 'minwoo.kong.1', 'dmills9', 'mivuong1191', 'bkbkbkbk', 'shawn', 'nineta', 'audrey.hendon', 'kbradley411', 'dinohyun', 'yasmin.atef3', 'robert.botsford', 'turkiat', 'yousra.azab.9', 'aikblackarmy83', 'leehyungjoo94', 'nadine_atef', 'bshanmo', 'linus744', 'dyour', 'barofske', 'emilyxu1995', 'tusharmonapara', 'elzingan', 'ckddns777', 'woshiee123', 'gfbeales', 'mmiri', 'abalshuaibi', 'tifa.madboly', 'eece_user_03', 'ganzevol', 'jaykg37', 'catalina1986', 'goldy.sakhre', 'capel', 'josh.morris.92167789', 'vincent.chen.5494', 'bboylekz', 'gcasey', 'wilsscot', 'lejustin.lv', 'vaishali.p.94', 'jthompson2645', 'mankity', 'caroline.ashraf2', 'alhaninb', 'nourin', 'void191', 'casey.gx', 'sports', 'abdullah.alshuaibi', 'chahid_abdo', 'nchiu94', 'trafalgarlove', 'hos.mohammed', 'riessa', 'sanguoshaisawesome', 'arankin', 'trevor.mackenzie117', 'matt.deno93', 'talonchandler', 'sherouknasr24', 'sj306', 'vijay_narasimhan', 'ramuamt', 'igor.josafa', 'ice7ven', 'yuexieguxiang', 'kyleeng', 'czy248200289', 'abesary', 'jessica.joussa', 'jstad', 'pf8363', 'nicolas.ivanov94', 'keyurshahrajkotgujarat', 'andrrrew', 'hala.adel.142', 'hinchmaa', 'ibnul.hussain.1', 'jperez35', 'williamtbwright', 'adam.argetsinger', 'lydia.alfred93', 'hashem.emad', 'czajkows', 'vanossp', 'riru94', 'ebram.bero.92', 'alexbenedict', 'westrab', 'ahmedkhaled93', 'lettycastrejonbarron', 'raccio14', 'ayu', 'james.jacobson.370', 'thegreatwidesomewhere', 'jiwhan328', 'deboerad', 'ellinorcrux', 'guseoanfflgkr', 'lavignan', 'gilletry', 'johntylerwallace', 'jeroenkorterik', 'polemale', 'reemakhaled', 'mkramer1', 'sambeau', 'maurom80', 'ahmed.tariq.94.10', 'gmorren11', 'cis', 'kurt.ahn', 'salma.ghobara', 'annaswan', 'chk0521', 'tashfiq.yazdan.alam', 'nikita.marus', 'almansouri', 'mdmobarokhossainrubel', 'kbbc1234', 'jerome.mourad', 'mpcondak', 'talesdv', 'aravind.ravi', 'sloppyjoe911', 'dominiccostajames', 'pavanchowdaryntrfan', 'hunterla', None, 'mohammed.eng1994', 'kfaist', 'es.maniego', 'g.nitish.kumar', 'pardiss1', 'warnemar', 'chengjiu.zhang.7', 'ncrofty', 'ditionq', 'harvey.hany.71', 'sumeyrakrs', 'aishsingh', 'jason.cammarata.73', 'gaigalac', 'ahmad.wael.165', 'jamesbezuk', 'ericgregg300', 'mahmoud.h.konswa', 'king27med', 'nnovak3', 'phwoook', 'yany', 'zeinahesham423']"
1,167,246,8,7,"['dmills9', 'jainilgpatel', 'patnilki', 'czy248200289', 'woshiee123', 'dgevans86', 'kyleeng']",239,"['michaela.ragoonath', 'alex.badmaev', 'feralfire', 'a94', 'mahmousa91', 'weicong', 'yamen', 'b.m.romeira', 'yasmin.adel.ya', 'raaidarshad', 'mohammad.kabir92', 'lazyasfcuk', 'aabadi', 'jiaolh', 'lejaym', 'danm1ch1gan', 'arya1080', 'fermioncj', 'ghostavoo', 'maxmankin2', 'shinyoung.park.5688', 'olivia.smith8787', 'hollybo', 'mounikav', 'hassanin74', 'mberthou', 'asif0047', 'lemon82124', 'lailamo95', 'curi87', '2kanghee', 'sadeghyazdi', 'dginoza', 'james.q.feng', 'soyabk1198', 'javier.laitue', 'hassanism', 'pradozurita', 'wuyiyang', 'malonej', 'wiss', 'sush2308', 'dpalanch', 'polardusk', 'wieling94', 'arnaudstolz', 'csabin18', 'xinnancao', 'palmbeach316', 'zplotzke', 'wphan604', 'felfelflafely', 'archduke900', 'kaustubhshah', 'wilsonn1996', 'hallmat', 'garrett', 'alexbene', 'kiseob.jung', 'dola47', 'smalhi', 'blairhan0126', 'dheer.mehrotra', 'tsangmichael', 'mwcraig', 'stefanieark', 'tatchinj', 'pouriagh', 'pwnt818', 'salma.elshamy.754', 'dtassis', 'noobkiller0', 'alshahrooor', 'drew.sheffield.10', 'rarshad', 'junkinja', 'anthony.remo', 'alexberlingeri', 'david.luo.73', 'usfmohy', 'midomatrixrb10', 'jethro4', 'ceicher', 'daveestrada12', 'amalkaba', 'inyeal.lee', 'smallandred126', 'dkarnazes', 'robynstar87', 'isaac.labean', 'minwoo.kong.1', 'mivuong1191', 'bkbkbkbk', 'shawn', 'nineta', 'audrey.hendon', 'kbradley411', 'dinohyun', 'yasmin.atef3', 'robert.botsford', 'turkiat', 'yousra.azab.9', 'aikblackarmy83', 'leehyungjoo94', 'nadine_atef', 'bshanmo', 'linus744', 'dyour', 'barofske', 'emilyxu1995', 'tusharmonapara', 'elzingan', 'ckddns777', 'gfbeales', 'mmiri', 'abalshuaibi', 'tifa.madboly', 'eece_user_03', 'ganzevol', 'jaykg37', 'catalina1986', 'goldy.sakhre', 'capel', 'josh.morris.92167789', 'vincent.chen.5494', 'bboylekz', 'gcasey', 'wilsscot', 'lejustin.lv', 'vaishali.p.94', 'jthompson2645', 'mankity', 'caroline.ashraf2', 'alhaninb', 'nourin', 'void191', 'casey.gx', 'sports', 'abdullah.alshuaibi', 'chahid_abdo', 'nchiu94', 'trafalgarlove', 'hos.mohammed', 'riessa', 'sanguoshaisawesome', 'arankin', 'trevor.mackenzie117', 'matt.deno93', 'talonchandler', 'sherouknasr24', 'sj306', 'vijay_narasimhan', 'ramuamt', 'igor.josafa', 'ice7ven', 'yuexieguxiang', 'abesary', 'jessica.joussa', 'jstad', 'pf8363', 'nicolas.ivanov94', 'keyurshahrajkotgujarat', 'andrrrew', 'hala.adel.142', 'hinchmaa', 'ibnul.hussain.1', 'jperez35', 'williamtbwright', 'adam.argetsinger', 'lydia.alfred93', 'hashem.emad', 'czajkows', 'vanossp', 'riru94', 'ebram.bero.92', 'alexbenedict', 'westrab', 'ahmedkhaled93', 'lettycastrejonbarron', 'raccio14', 'ayu', 'james.jacobson.370', 'thegreatwidesomewhere', 'jiwhan328', 'deboerad', 'ellinorcrux', 'guseoanfflgkr', 'lavignan', 'gilletry', 'johntylerwallace', 'jeroenkorterik', 'polemale', 'reemakhaled', 'mkramer1', 'sambeau', 'maurom80', 'ahmed.tariq.94.10', 'gmorren11', 'cis', 'kurt.ahn', 'salma.ghobara', 'annaswan', 'chk0521', 'tashfiq.yazdan.alam', 'nikita.marus', 'almansouri', 'mdmobarokhossainrubel', 'kbbc1234', 'jerome.mourad', 'mpcondak', 'talesdv', 'aravind.ravi', 'sloppyjoe911', 'dominiccostajames', 'pavanchowdaryntrfan', 'hunterla', 'mohammed.eng1994', 'kfaist', 'es.maniego', 'g.nitish.kumar', 'pardiss1', 'warnemar', 'chengjiu.zhang.7', 'ncrofty', 'ditionq', 'harvey.hany.71', 'sumeyrakrs', 'aishsingh', 'jason.cammarata.73', 'gaigalac', 'ahmad.wael.165', 'jamesbezuk', 'ericgregg300', 'mahmoud.h.konswa', 'king27med', 'nnovak3', 'phwoook', 'yany', 'zeinahesham423']",1,[None],247,"['michaela.ragoonath', 'alex.badmaev', 'feralfire', 'a94', 'mahmousa91', 'weicong', 'yamen', 'b.m.romeira', 'yasmin.adel.ya', 'raaidarshad', 'mohammad.kabir92', 'lazyasfcuk', 'aabadi', 'jiaolh', 'lejaym', 'danm1ch1gan', 'arya1080', 'fermioncj', 'ghostavoo', 'maxmankin2', 'shinyoung.park.5688', 'olivia.smith8787', 'hollybo', 'jainilgpatel', 'mounikav', 'hassanin74', 'mberthou', 'asif0047', 'lemon82124', 'lailamo95', 'curi87', '2kanghee', 'sadeghyazdi', 'dginoza', 'james.q.feng', 'soyabk1198', 'javier.laitue', 'hassanism', 'pradozurita', 'wuyiyang', 'malonej', 'wiss', 'sush2308', 'dpalanch', 'polardusk', 'wieling94', 'arnaudstolz', 'csabin18', 'xinnancao', 'palmbeach316', 'zplotzke', 'wphan604', 'felfelflafely', 'patnilki', 'archduke900', 'kaustubhshah', 'wilsonn1996', 'hallmat', 'garrett', 'alexbene', 'kiseob.jung', 'dola47', 'smalhi', 'blairhan0126', 'dheer.mehrotra', 'tsangmichael', 'mwcraig', 'stefanieark', 'tatchinj', 'pouriagh', 'pwnt818', 'salma.elshamy.754', 'dgevans86', 'dtassis', 'noobkiller0', 'alshahrooor', 'drew.sheffield.10', 'rarshad', 'junkinja', 'anthony.remo', 'alexberlingeri', 'david.luo.73', 'usfmohy', 'midomatrixrb10', 'jethro4', 'ceicher', 'daveestrada12', 'amalkaba', 'inyeal.lee', 'smallandred126', 'dkarnazes', 'robynstar87', 'isaac.labean', 'minwoo.kong.1', 'dmills9', 'mivuong1191', 'bkbkbkbk', 'shawn', 'nineta', 'audrey.hendon', 'kbradley411', 'dinohyun', 'yasmin.atef3', 'robert.botsford', 'turkiat', 'yousra.azab.9', 'aikblackarmy83', 'leehyungjoo94', 'nadine_atef', 'bshanmo', 'linus744', 'dyour', 'barofske', 'emilyxu1995', 'tusharmonapara', 'elzingan', 'ckddns777', 'woshiee123', 'gfbeales', 'mmiri', 'abalshuaibi', 'tifa.madboly', 'eece_user_03', 'ganzevol', 'jaykg37', 'catalina1986', 'goldy.sakhre', 'capel', 'josh.morris.92167789', 'vincent.chen.5494', 'bboylekz', 'gcasey', 'wilsscot', 'lejustin.lv', 'vaishali.p.94', 'jthompson2645', 'mankity', 'caroline.ashraf2', 'alhaninb', 'nourin', 'void191', 'casey.gx', 'sports', 'abdullah.alshuaibi', 'chahid_abdo', 'nchiu94', 'trafalgarlove', 'hos.mohammed', 'riessa', 'sanguoshaisawesome', 'arankin', 'trevor.mackenzie117', 'matt.deno93', 'talonchandler', 'sherouknasr24', 'sj306', 'vijay_narasimhan', 'ramuamt', 'igor.josafa', 'ice7ven', 'yuexieguxiang', 'kyleeng', 'czy248200289', 'abesary', 'jessica.joussa', 'jstad', 'pf8363', 'nicolas.ivanov94', 'keyurshahrajkotgujarat', 'andrrrew', 'hala.adel.142', 'hinchmaa', 'ibnul.hussain.1', 'jperez35', 'williamtbwright', 'adam.argetsinger', 'lydia.alfred93', 'hashem.emad', 'czajkows', 'vanossp', 'riru94', 'ebram.bero.92', 'alexbenedict', 'westrab', 'ahmedkhaled93', 'lettycastrejonbarron', 'raccio14', 'ayu', 'james.jacobson.370', 'thegreatwidesomewhere', 'jiwhan328', 'deboerad', 'ellinorcrux', 'guseoanfflgkr', 'lavignan', 'gilletry', 'johntylerwallace', 'jeroenkorterik', 'polemale', 'reemakhaled', 'mkramer1', 'sambeau', 'maurom80', 'ahmed.tariq.94.10', 'gmorren11', 'cis', 'kurt.ahn', 'salma.ghobara', 'annaswan', 'chk0521', 'tashfiq.yazdan.alam', 'nikita.marus', 'almansouri', 'mdmobarokhossainrubel', 'kbbc1234', 'jerome.mourad', 'mpcondak', 'talesdv', 'aravind.ravi', 'sloppyjoe911', 'dominiccostajames', 'pavanchowdaryntrfan', 'hunterla', None, 'mohammed.eng1994', 'kfaist', 'es.maniego', 'g.nitish.kumar', 'pardiss1', 'warnemar', 'chengjiu.zhang.7', 'ncrofty', 'ditionq', 'harvey.hany.71', 'sumeyrakrs', 'aishsingh', 'jason.cammarata.73', 'gaigalac', 'ahmad.wael.165', 'jamesbezuk', 'ericgregg300', 'mahmoud.h.konswa', 'king27med', 'nnovak3', 'phwoook', 'yany', 'zeinahesham423']"
1,168,246,8,6,"['almansouri', 'lettycastrejonbarron', 'alshahrooor', 'abalshuaibi', 'chahid_abdo', 'javier.laitue']",240,"['michaela.ragoonath', 'alex.badmaev', 'feralfire', 'a94', 'mahmousa91', 'weicong', 'yamen', 'b.m.romeira', 'yasmin.adel.ya', 'raaidarshad', 'mohammad.kabir92', 'lazyasfcuk', 'aabadi', 'jiaolh', 'lejaym', 'danm1ch1gan', 'arya1080', 'fermioncj', 'ghostavoo', 'maxmankin2', 'shinyoung.park.5688', 'olivia.smith8787', 'hollybo', 'jainilgpatel', 'mounikav', 'hassanin74', 'mberthou', 'asif0047', 'lemon82124', 'lailamo95', 'curi87', '2kanghee', 'sadeghyazdi', 'dginoza', 'james.q.feng', 'soyabk1198', 'hassanism', 'pradozurita', 'wuyiyang', 'malonej', 'wiss', 'sush2308', 'dpalanch', 'polardusk', 'wieling94', 'arnaudstolz', 'csabin18', 'xinnancao', 'palmbeach316', 'zplotzke', 'wphan604', 'felfelflafely', 'patnilki', 'archduke900', 'kaustubhshah', 'wilsonn1996', 'hallmat', 'garrett', 'alexbene', 'kiseob.jung', 'dola47', 'smalhi', 'blairhan0126', 'dheer.mehrotra', 'tsangmichael', 'mwcraig', 'stefanieark', 'tatchinj', 'pouriagh', 'pwnt818', 'salma.elshamy.754', 'dgevans86', 'dtassis', 'noobkiller0', 'drew.sheffield.10', 'rarshad', 'junkinja', 'anthony.remo', 'alexberlingeri', 'david.luo.73', 'usfmohy', 'midomatrixrb10', 'jethro4', 'ceicher', 'daveestrada12', 'amalkaba', 'inyeal.lee', 'smallandred126', 'dkarnazes', 'robynstar87', 'isaac.labean', 'minwoo.kong.1', 'dmills9', 'mivuong1191', 'bkbkbkbk', 'shawn', 'nineta', 'audrey.hendon', 'kbradley411', 'dinohyun', 'yasmin.atef3', 'robert.botsford', 'turkiat', 'yousra.azab.9', 'aikblackarmy83', 'leehyungjoo94', 'nadine_atef', 'bshanmo', 'linus744', 'dyour', 'barofske', 'emilyxu1995', 'tusharmonapara', 'elzingan', 'ckddns777', 'woshiee123', 'gfbeales', 'mmiri', 'tifa.madboly', 'eece_user_03', 'ganzevol', 'jaykg37', 'catalina1986', 'goldy.sakhre', 'capel', 'josh.morris.92167789', 'vincent.chen.5494', 'bboylekz', 'gcasey', 'wilsscot', 'lejustin.lv', 'vaishali.p.94', 'jthompson2645', 'mankity', 'caroline.ashraf2', 'alhaninb', 'nourin', 'void191', 'casey.gx', 'sports', 'abdullah.alshuaibi', 'nchiu94', 'trafalgarlove', 'hos.mohammed', 'riessa', 'sanguoshaisawesome', 'arankin', 'trevor.mackenzie117', 'matt.deno93', 'talonchandler', 'sherouknasr24', 'sj306', 'vijay_narasimhan', 'ramuamt', 'igor.josafa', 'ice7ven', 'yuexieguxiang', 'kyleeng', 'czy248200289', 'abesary', 'jessica.joussa', 'jstad', 'pf8363', 'nicolas.ivanov94', 'keyurshahrajkotgujarat', 'andrrrew', 'hala.adel.142', 'hinchmaa', 'ibnul.hussain.1', 'jperez35', 'williamtbwright', 'adam.argetsinger', 'lydia.alfred93', 'hashem.emad', 'czajkows', 'vanossp', 'riru94', 'ebram.bero.92', 'alexbenedict', 'westrab', 'ahmedkhaled93', 'raccio14', 'ayu', 'james.jacobson.370', 'thegreatwidesomewhere', 'jiwhan328', 'deboerad', 'ellinorcrux', 'guseoanfflgkr', 'lavignan', 'gilletry', 'johntylerwallace', 'jeroenkorterik', 'polemale', 'reemakhaled', 'mkramer1', 'sambeau', 'maurom80', 'ahmed.tariq.94.10', 'gmorren11', 'cis', 'kurt.ahn', 'salma.ghobara', 'annaswan', 'chk0521', 'tashfiq.yazdan.alam', 'nikita.marus', 'mdmobarokhossainrubel', 'kbbc1234', 'jerome.mourad', 'mpcondak', 'talesdv', 'aravind.ravi', 'sloppyjoe911', 'dominiccostajames', 'pavanchowdaryntrfan', 'hunterla', 'mohammed.eng1994', 'kfaist', 'es.maniego', 'g.nitish.kumar', 'pardiss1', 'warnemar', 'chengjiu.zhang.7', 'ncrofty', 'ditionq', 'harvey.hany.71', 'sumeyrakrs', 'aishsingh', 'jason.cammarata.73', 'gaigalac', 'ahmad.wael.165', 'jamesbezuk', 'ericgregg300', 'mahmoud.h.konswa', 'king27med', 'nnovak3', 'phwoook', 'yany', 'zeinahesham423']",2,"['mtgho', None]",248,"['michaela.ragoonath', 'alex.badmaev', 'feralfire', 'a94', 'mahmousa91', 'weicong', 'yamen', 'b.m.romeira', 'yasmin.adel.ya', 'raaidarshad', 'mohammad.kabir92', 'lazyasfcuk', 'aabadi', 'jiaolh', 'lejaym', 'danm1ch1gan', 'arya1080', 'fermioncj', 'ghostavoo', 'maxmankin2', 'shinyoung.park.5688', 'olivia.smith8787', 'hollybo', 'jainilgpatel', 'mounikav', 'hassanin74', 'mberthou', 'asif0047', 'lemon82124', 'lailamo95', 'curi87', '2kanghee', 'sadeghyazdi', 'dginoza', 'james.q.feng', 'soyabk1198', 'javier.laitue', 'hassanism', 'pradozurita', 'wuyiyang', 'malonej', 'wiss', 'sush2308', 'dpalanch', 'polardusk', 'wieling94', 'arnaudstolz', 'csabin18', 'xinnancao', 'palmbeach316', 'zplotzke', 'wphan604', 'felfelflafely', 'patnilki', 'archduke900', 'kaustubhshah', 'wilsonn1996', 'hallmat', 'garrett', 'alexbene', 'kiseob.jung', 'dola47', 'mtgho', 'smalhi', 'blairhan0126', 'dheer.mehrotra', 'tsangmichael', 'mwcraig', 'stefanieark', 'tatchinj', 'pouriagh', 'pwnt818', 'salma.elshamy.754', 'dgevans86', 'dtassis', 'noobkiller0', 'alshahrooor', 'drew.sheffield.10', 'rarshad', 'junkinja', 'anthony.remo', 'alexberlingeri', 'david.luo.73', 'usfmohy', 'midomatrixrb10', 'jethro4', 'ceicher', 'daveestrada12', 'amalkaba', 'inyeal.lee', 'smallandred126', 'dkarnazes', 'robynstar87', 'isaac.labean', 'minwoo.kong.1', 'dmills9', 'mivuong1191', 'bkbkbkbk', 'shawn', 'nineta', 'audrey.hendon', 'kbradley411', 'dinohyun', 'yasmin.atef3', 'robert.botsford', 'turkiat', 'yousra.azab.9', 'aikblackarmy83', 'leehyungjoo94', 'nadine_atef', 'bshanmo', 'linus744', 'dyour', 'barofske', 'emilyxu1995', 'tusharmonapara', 'elzingan', 'ckddns777', 'woshiee123', 'gfbeales', 'mmiri', 'abalshuaibi', 'tifa.madboly', 'eece_user_03', 'ganzevol', 'jaykg37', 'catalina1986', 'goldy.sakhre', 'capel', 'josh.morris.92167789', 'vincent.chen.5494', 'bboylekz', 'gcasey', 'wilsscot', 'lejustin.lv', 'vaishali.p.94', 'jthompson2645', 'mankity', 'caroline.ashraf2', 'alhaninb', 'nourin', 'void191', 'casey.gx', 'sports', 'abdullah.alshuaibi', 'chahid_abdo', 'nchiu94', 'trafalgarlove', 'hos.mohammed', 'riessa', 'sanguoshaisawesome', 'arankin', 'trevor.mackenzie117', 'matt.deno93', 'talonchandler', 'sherouknasr24', 'sj306', 'vijay_narasimhan', 'ramuamt', 'igor.josafa', 'ice7ven', 'yuexieguxiang', 'kyleeng', 'czy248200289', 'abesary', 'jessica.joussa', 'jstad', 'pf8363', 'nicolas.ivanov94', 'keyurshahrajkotgujarat', 'andrrrew', 'hala.adel.142', 'hinchmaa', 'ibnul.hussain.1', 'jperez35', 'williamtbwright', 'adam.argetsinger', 'lydia.alfred93', 'hashem.emad', 'czajkows', 'vanossp', 'riru94', 'ebram.bero.92', 'alexbenedict', 'westrab', 'ahmedkhaled93', 'lettycastrejonbarron', 'raccio14', 'ayu', 'james.jacobson.370', 'thegreatwidesomewhere', 'jiwhan328', 'deboerad', 'ellinorcrux', 'guseoanfflgkr', 'lavignan', 'gilletry', 'johntylerwallace', 'jeroenkorterik', 'polemale', 'reemakhaled', 'mkramer1', 'sambeau', 'maurom80', 'ahmed.tariq.94.10', 'gmorren11', 'cis', 'kurt.ahn', 'salma.ghobara', 'annaswan', 'chk0521', 'tashfiq.yazdan.alam', 'nikita.marus', 'almansouri', 'mdmobarokhossainrubel', 'kbbc1234', 'jerome.mourad', 'mpcondak', 'talesdv', 'aravind.ravi', 'sloppyjoe911', 'dominiccostajames', 'pavanchowdaryntrfan', 'hunterla', None, 'mohammed.eng1994', 'kfaist', 'es.maniego', 'g.nitish.kumar', 'pardiss1', 'warnemar', 'chengjiu.zhang.7', 'ncrofty', 'ditionq', 'harvey.hany.71', 'sumeyrakrs', 'aishsingh', 'jason.cammarata.73', 'gaigalac', 'ahmad.wael.165', 'jamesbezuk', 'ericgregg300', 'mahmoud.h.konswa', 'king27med', 'nnovak3', 'phwoook', 'yany', 'zeinahesham423']"
1,171,246,8,7,"['turkiat', 'almansouri', 'lettycastrejonbarron', 'alshahrooor', 'abalshuaibi', 'chahid_abdo', 'javier.laitue']",239,"['michaela.ragoonath', 'alex.badmaev', 'feralfire', 'a94', 'mahmousa91', 'weicong', 'yamen', 'b.m.romeira', 'yasmin.adel.ya', 'raaidarshad', 'mohammad.kabir92', 'lazyasfcuk', 'aabadi', 'jiaolh', 'lejaym', 'danm1ch1gan', 'arya1080', 'fermioncj', 'ghostavoo', 'maxmankin2', 'shinyoung.park.5688', 'olivia.smith8787', 'hollybo', 'jainilgpatel', 'mounikav', 'hassanin74', 'mberthou', 'asif0047', 'lemon82124', 'lailamo95', 'curi87', '2kanghee', 'sadeghyazdi', 'dginoza', 'james.q.feng', 'soyabk1198', 'hassanism', 'pradozurita', 'wuyiyang', 'malonej', 'wiss', 'sush2308', 'dpalanch', 'polardusk', 'wieling94', 'arnaudstolz', 'csabin18', 'xinnancao', 'palmbeach316', 'zplotzke', 'wphan604', 'felfelflafely', 'patnilki', 'archduke900', 'kaustubhshah', 'wilsonn1996', 'hallmat', 'garrett', 'alexbene', 'kiseob.jung', 'dola47', 'smalhi', 'blairhan0126', 'dheer.mehrotra', 'tsangmichael', 'mwcraig', 'stefanieark', 'tatchinj', 'pouriagh', 'pwnt818', 'salma.elshamy.754', 'dgevans86', 'dtassis', 'noobkiller0', 'drew.sheffield.10', 'rarshad', 'junkinja', 'anthony.remo', 'alexberlingeri', 'david.luo.73', 'usfmohy', 'midomatrixrb10', 'jethro4', 'ceicher', 'daveestrada12', 'amalkaba', 'inyeal.lee', 'smallandred126', 'dkarnazes', 'robynstar87', 'isaac.labean', 'minwoo.kong.1', 'dmills9', 'mivuong1191', 'bkbkbkbk', 'shawn', 'nineta', 'audrey.hendon', 'kbradley411', 'dinohyun', 'yasmin.atef3', 'robert.botsford', 'yousra.azab.9', 'aikblackarmy83', 'leehyungjoo94', 'nadine_atef', 'bshanmo', 'linus744', 'dyour', 'barofske', 'emilyxu1995', 'tusharmonapara', 'elzingan', 'ckddns777', 'woshiee123', 'gfbeales', 'mmiri', 'tifa.madboly', 'eece_user_03', 'ganzevol', 'jaykg37', 'catalina1986', 'goldy.sakhre', 'capel', 'josh.morris.92167789', 'vincent.chen.5494', 'bboylekz', 'gcasey', 'wilsscot', 'lejustin.lv', 'vaishali.p.94', 'jthompson2645', 'mankity', 'caroline.ashraf2', 'alhaninb', 'nourin', 'void191', 'casey.gx', 'sports', 'abdullah.alshuaibi', 'nchiu94', 'trafalgarlove', 'hos.mohammed', 'riessa', 'sanguoshaisawesome', 'arankin', 'trevor.mackenzie117', 'matt.deno93', 'talonchandler', 'sherouknasr24', 'sj306', 'vijay_narasimhan', 'ramuamt', 'igor.josafa', 'ice7ven', 'yuexieguxiang', 'kyleeng', 'czy248200289', 'abesary', 'jessica.joussa', 'jstad', 'pf8363', 'nicolas.ivanov94', 'keyurshahrajkotgujarat', 'andrrrew', 'hala.adel.142', 'hinchmaa', 'ibnul.hussain.1', 'jperez35', 'williamtbwright', 'adam.argetsinger', 'lydia.alfred93', 'hashem.emad', 'czajkows', 'vanossp', 'riru94', 'ebram.bero.92', 'alexbenedict', 'westrab', 'ahmedkhaled93', 'raccio14', 'ayu', 'james.jacobson.370', 'thegreatwidesomewhere', 'jiwhan328', 'deboerad', 'ellinorcrux', 'guseoanfflgkr', 'lavignan', 'gilletry', 'johntylerwallace', 'jeroenkorterik', 'polemale', 'reemakhaled', 'mkramer1', 'sambeau', 'maurom80', 'ahmed.tariq.94.10', 'gmorren11', 'cis', 'kurt.ahn', 'salma.ghobara', 'annaswan', 'chk0521', 'tashfiq.yazdan.alam', 'nikita.marus', 'mdmobarokhossainrubel', 'kbbc1234', 'jerome.mourad', 'mpcondak', 'talesdv', 'aravind.ravi', 'sloppyjoe911', 'dominiccostajames', 'pavanchowdaryntrfan', 'hunterla', 'mohammed.eng1994', 'kfaist', 'es.maniego', 'g.nitish.kumar', 'pardiss1', 'warnemar', 'chengjiu.zhang.7', 'ncrofty', 'ditionq', 'harvey.hany.71', 'sumeyrakrs', 'aishsingh', 'jason.cammarata.73', 'gaigalac', 'ahmad.wael.165', 'jamesbezuk', 'ericgregg300', 'mahmoud.h.konswa', 'king27med', 'nnovak3', 'phwoook', 'yany', 'zeinahesham423']",1,[None],247,"['michaela.ragoonath', 'alex.badmaev', 'feralfire', 'a94', 'mahmousa91', 'weicong', 'yamen', 'b.m.romeira', 'yasmin.adel.ya', 'raaidarshad', 'mohammad.kabir92', 'lazyasfcuk', 'aabadi', 'jiaolh', 'lejaym', 'danm1ch1gan', 'arya1080', 'fermioncj', 'ghostavoo', 'maxmankin2', 'shinyoung.park.5688', 'olivia.smith8787', 'hollybo', 'jainilgpatel', 'mounikav', 'hassanin74', 'mberthou', 'asif0047', 'lemon82124', 'lailamo95', 'curi87', '2kanghee', 'sadeghyazdi', 'dginoza', 'james.q.feng', 'soyabk1198', 'javier.laitue', 'hassanism', 'pradozurita', 'wuyiyang', 'malonej', 'wiss', 'sush2308', 'dpalanch', 'polardusk', 'wieling94', 'arnaudstolz', 'csabin18', 'xinnancao', 'palmbeach316', 'zplotzke', 'wphan604', 'felfelflafely', 'patnilki', 'archduke900', 'kaustubhshah', 'wilsonn1996', 'hallmat', 'garrett', 'alexbene', 'kiseob.jung', 'dola47', 'smalhi', 'blairhan0126', 'dheer.mehrotra', 'tsangmichael', 'mwcraig', 'stefanieark', 'tatchinj', 'pouriagh', 'pwnt818', 'salma.elshamy.754', 'dgevans86', 'dtassis', 'noobkiller0', 'alshahrooor', 'drew.sheffield.10', 'rarshad', 'junkinja', 'anthony.remo', 'alexberlingeri', 'david.luo.73', 'usfmohy', 'midomatrixrb10', 'jethro4', 'ceicher', 'daveestrada12', 'amalkaba', 'inyeal.lee', 'smallandred126', 'dkarnazes', 'robynstar87', 'isaac.labean', 'minwoo.kong.1', 'dmills9', 'mivuong1191', 'bkbkbkbk', 'shawn', 'nineta', 'audrey.hendon', 'kbradley411', 'dinohyun', 'yasmin.atef3', 'robert.botsford', 'turkiat', 'yousra.azab.9', 'aikblackarmy83', 'leehyungjoo94', 'nadine_atef', 'bshanmo', 'linus744', 'dyour', 'barofske', 'emilyxu1995', 'tusharmonapara', 'elzingan', 'ckddns777', 'woshiee123', 'gfbeales', 'mmiri', 'abalshuaibi', 'tifa.madboly', 'eece_user_03', 'ganzevol', 'jaykg37', 'catalina1986', 'goldy.sakhre', 'capel', 'josh.morris.92167789', 'vincent.chen.5494', 'bboylekz', 'gcasey', 'wilsscot', 'lejustin.lv', 'vaishali.p.94', 'jthompson2645', 'mankity', 'caroline.ashraf2', 'alhaninb', 'nourin', 'void191', 'casey.gx', 'sports', 'abdullah.alshuaibi', 'chahid_abdo', 'nchiu94', 'trafalgarlove', 'hos.mohammed', 'riessa', 'sanguoshaisawesome', 'arankin', 'trevor.mackenzie117', 'matt.deno93', 'talonchandler', 'sherouknasr24', 'sj306', 'vijay_narasimhan', 'ramuamt', 'igor.josafa', 'ice7ven', 'yuexieguxiang', 'kyleeng', 'czy248200289', 'abesary', 'jessica.joussa', 'jstad', 'pf8363', 'nicolas.ivanov94', 'keyurshahrajkotgujarat', 'andrrrew', 'hala.adel.142', 'hinchmaa', 'ibnul.hussain.1', 'jperez35', 'williamtbwright', 'adam.argetsinger', 'lydia.alfred93', 'hashem.emad', 'czajkows', 'vanossp', 'riru94', 'ebram.bero.92', 'alexbenedict', 'westrab', 'ahmedkhaled93', 'lettycastrejonbarron', 'raccio14', 'ayu', 'james.jacobson.370', 'thegreatwidesomewhere', 'jiwhan328', 'deboerad', 'ellinorcrux', 'guseoanfflgkr', 'lavignan', 'gilletry', 'johntylerwallace', 'jeroenkorterik', 'polemale', 'reemakhaled', 'mkramer1', 'sambeau', 'maurom80', 'ahmed.tariq.94.10', 'gmorren11', 'cis', 'kurt.ahn', 'salma.ghobara', 'annaswan', 'chk0521', 'tashfiq.yazdan.alam', 'nikita.marus', 'almansouri', 'mdmobarokhossainrubel', 'kbbc1234', 'jerome.mourad', 'mpcondak', 'talesdv', 'aravind.ravi', 'sloppyjoe911', 'dominiccostajames', 'pavanchowdaryntrfan', 'hunterla', None, 'mohammed.eng1994', 'kfaist', 'es.maniego', 'g.nitish.kumar', 'pardiss1', 'warnemar', 'chengjiu.zhang.7', 'ncrofty', 'ditionq', 'harvey.hany.71', 'sumeyrakrs', 'aishsingh', 'jason.cammarata.73', 'gaigalac', 'ahmad.wael.165', 'jamesbezuk', 'ericgregg300', 'mahmoud.h.konswa', 'king27med', 'nnovak3', 'phwoook', 'yany', 'zeinahesham423']"
1,173,246,8,1,['mdmobarokhossainrubel'],245,"['michaela.ragoonath', 'alex.badmaev', 'feralfire', 'a94', 'mahmousa91', 'weicong', 'yamen', 'b.m.romeira', 'yasmin.adel.ya', 'raaidarshad', 'mohammad.kabir92', 'lazyasfcuk', 'aabadi', 'jiaolh', 'lejaym', 'danm1ch1gan', 'arya1080', 'fermioncj', 'ghostavoo', 'maxmankin2', 'shinyoung.park.5688', 'olivia.smith8787', 'hollybo', 'jainilgpatel', 'mounikav', 'hassanin74', 'mberthou', 'asif0047', 'lemon82124', 'lailamo95', 'curi87', '2kanghee', 'sadeghyazdi', 'dginoza', 'james.q.feng', 'soyabk1198', 'javier.laitue', 'hassanism', 'pradozurita', 'wuyiyang', 'malonej', 'wiss', 'sush2308', 'dpalanch', 'polardusk', 'wieling94', 'arnaudstolz', 'csabin18', 'xinnancao', 'palmbeach316', 'zplotzke', 'wphan604', 'felfelflafely', 'patnilki', 'archduke900', 'kaustubhshah', 'wilsonn1996', 'hallmat', 'garrett', 'alexbene', 'kiseob.jung', 'dola47', 'smalhi', 'blairhan0126', 'dheer.mehrotra', 'tsangmichael', 'mwcraig', 'stefanieark', 'tatchinj', 'pouriagh', 'pwnt818', 'salma.elshamy.754', 'dgevans86', 'dtassis', 'noobkiller0', 'alshahrooor', 'drew.sheffield.10', 'rarshad', 'junkinja', 'anthony.remo', 'alexberlingeri', 'david.luo.73', 'usfmohy', 'midomatrixrb10', 'jethro4', 'ceicher', 'daveestrada12', 'amalkaba', 'inyeal.lee', 'smallandred126', 'dkarnazes', 'robynstar87', 'isaac.labean', 'minwoo.kong.1', 'dmills9', 'mivuong1191', 'bkbkbkbk', 'shawn', 'nineta', 'audrey.hendon', 'kbradley411', 'dinohyun', 'yasmin.atef3', 'robert.botsford', 'turkiat', 'yousra.azab.9', 'aikblackarmy83', 'leehyungjoo94', 'nadine_atef', 'bshanmo', 'linus744', 'dyour', 'barofske', 'emilyxu1995', 'tusharmonapara', 'elzingan', 'ckddns777', 'woshiee123', 'gfbeales', 'mmiri', 'abalshuaibi', 'tifa.madboly', 'eece_user_03', 'ganzevol', 'jaykg37', 'catalina1986', 'goldy.sakhre', 'capel', 'josh.morris.92167789', 'vincent.chen.5494', 'bboylekz', 'gcasey', 'wilsscot', 'lejustin.lv', 'vaishali.p.94', 'jthompson2645', 'mankity', 'caroline.ashraf2', 'alhaninb', 'nourin', 'void191', 'casey.gx', 'sports', 'abdullah.alshuaibi', 'chahid_abdo', 'nchiu94', 'trafalgarlove', 'hos.mohammed', 'riessa', 'sanguoshaisawesome', 'arankin', 'trevor.mackenzie117', 'matt.deno93', 'talonchandler', 'sherouknasr24', 'sj306', 'vijay_narasimhan', 'ramuamt', 'igor.josafa', 'ice7ven', 'yuexieguxiang', 'kyleeng', 'czy248200289', 'abesary', 'jessica.joussa', 'jstad', 'pf8363', 'nicolas.ivanov94', 'keyurshahrajkotgujarat', 'andrrrew', 'hala.adel.142', 'hinchmaa', 'ibnul.hussain.1', 'jperez35', 'williamtbwright', 'adam.argetsinger', 'lydia.alfred93', 'hashem.emad', 'czajkows', 'vanossp', 'riru94', 'ebram.bero.92', 'alexbenedict', 'westrab', 'ahmedkhaled93', 'lettycastrejonbarron', 'raccio14', 'ayu', 'james.jacobson.370', 'thegreatwidesomewhere', 'jiwhan328', 'deboerad', 'ellinorcrux', 'guseoanfflgkr', 'lavignan', 'gilletry', 'johntylerwallace', 'jeroenkorterik', 'polemale', 'reemakhaled', 'mkramer1', 'sambeau', 'maurom80', 'ahmed.tariq.94.10', 'gmorren11', 'cis', 'kurt.ahn', 'salma.ghobara', 'annaswan', 'chk0521', 'tashfiq.yazdan.alam', 'nikita.marus', 'almansouri', 'kbbc1234', 'jerome.mourad', 'mpcondak', 'talesdv', 'aravind.ravi', 'sloppyjoe911', 'dominiccostajames', 'pavanchowdaryntrfan', 'hunterla', 'mohammed.eng1994', 'kfaist', 'es.maniego', 'g.nitish.kumar', 'pardiss1', 'warnemar', 'chengjiu.zhang.7', 'ncrofty', 'ditionq', 'harvey.hany.71', 'sumeyrakrs', 'aishsingh', 'jason.cammarata.73', 'gaigalac', 'ahmad.wael.165', 'jamesbezuk', 'ericgregg300', 'mahmoud.h.konswa', 'king27med', 'nnovak3', 'phwoook', 'yany', 'zeinahesham423']",7,"['andresvaldepena', 'gaurav.sheoran88', 'tylernichol', 'sumedhagandharava', 'azariasdolores', 'sepideh', None]",253,"['michaela.ragoonath', 'alex.badmaev', 'feralfire', 'a94', 'mahmousa91', 'weicong', 'yamen', 'b.m.romeira', 'yasmin.adel.ya', 'raaidarshad', 'mohammad.kabir92', 'lazyasfcuk', 'aabadi', 'jiaolh', 'lejaym', 'danm1ch1gan', 'arya1080', 'fermioncj', 'ghostavoo', 'maxmankin2', 'shinyoung.park.5688', 'olivia.smith8787', 'hollybo', 'jainilgpatel', 'mounikav', 'hassanin74', 'mberthou', 'sumedhagandharava', 'asif0047', 'lemon82124', 'lailamo95', 'curi87', '2kanghee', 'sadeghyazdi', 'dginoza', 'james.q.feng', 'soyabk1198', 'javier.laitue', 'hassanism', 'pradozurita', 'wuyiyang', 'malonej', 'wiss', 'sush2308', 'dpalanch', 'polardusk', 'wieling94', 'arnaudstolz', 'csabin18', 'xinnancao', 'palmbeach316', 'zplotzke', 'gaurav.sheoran88', 'wphan604', 'felfelflafely', 'patnilki', 'archduke900', 'kaustubhshah', 'wilsonn1996', 'hallmat', 'garrett', 'alexbene', 'kiseob.jung', 'dola47', 'tylernichol', 'smalhi', 'blairhan0126', 'dheer.mehrotra', 'tsangmichael', 'mwcraig', 'stefanieark', 'tatchinj', 'pouriagh', 'pwnt818', 'salma.elshamy.754', 'dgevans86', 'dtassis', 'noobkiller0', 'alshahrooor', 'drew.sheffield.10', 'rarshad', 'junkinja', 'anthony.remo', 'alexberlingeri', 'david.luo.73', 'usfmohy', 'midomatrixrb10', 'jethro4', 'ceicher', 'daveestrada12', 'amalkaba', 'inyeal.lee', 'smallandred126', 'dkarnazes', 'robynstar87', 'isaac.labean', 'minwoo.kong.1', 'dmills9', 'mivuong1191', 'bkbkbkbk', 'shawn', 'nineta', 'audrey.hendon', 'kbradley411', 'dinohyun', 'yasmin.atef3', 'robert.botsford', 'turkiat', 'yousra.azab.9', 'aikblackarmy83', 'leehyungjoo94', 'nadine_atef', 'bshanmo', 'linus744', 'dyour', 'barofske', 'emilyxu1995', 'tusharmonapara', 'elzingan', 'ckddns777', 'woshiee123', 'gfbeales', 'mmiri', 'abalshuaibi', 'tifa.madboly', 'eece_user_03', 'ganzevol', 'jaykg37', 'catalina1986', 'goldy.sakhre', 'capel', 'josh.morris.92167789', 'vincent.chen.5494', 'bboylekz', 'gcasey', 'wilsscot', 'lejustin.lv', 'vaishali.p.94', 'jthompson2645', 'mankity', 'caroline.ashraf2', 'alhaninb', 'nourin', 'void191', 'azariasdolores', 'casey.gx', 'sports', 'abdullah.alshuaibi', 'chahid_abdo', 'nchiu94', 'trafalgarlove', 'hos.mohammed', 'riessa', 'sanguoshaisawesome', 'arankin', 'trevor.mackenzie117', 'matt.deno93', 'talonchandler', 'sherouknasr24', 'sj306', 'vijay_narasimhan', 'ramuamt', 'igor.josafa', 'ice7ven', 'yuexieguxiang', 'kyleeng', 'czy248200289', 'abesary', 'jessica.joussa', 'jstad', 'pf8363', 'nicolas.ivanov94', 'keyurshahrajkotgujarat', 'andresvaldepena', 'andrrrew', 'hala.adel.142', 'hinchmaa', 'ibnul.hussain.1', 'jperez35', 'williamtbwright', 'adam.argetsinger', 'lydia.alfred93', 'hashem.emad', 'sepideh', 'czajkows', 'vanossp', 'riru94', 'ebram.bero.92', 'alexbenedict', 'westrab', 'ahmedkhaled93', 'lettycastrejonbarron', 'raccio14', 'ayu', 'james.jacobson.370', 'thegreatwidesomewhere', 'jiwhan328', 'deboerad', 'ellinorcrux', 'guseoanfflgkr', 'lavignan', 'gilletry', 'johntylerwallace', 'jeroenkorterik', 'polemale', 'reemakhaled', 'mkramer1', 'sambeau', 'maurom80', 'ahmed.tariq.94.10', 'gmorren11', 'cis', 'kurt.ahn', 'salma.ghobara', 'annaswan', 'chk0521', 'tashfiq.yazdan.alam', 'nikita.marus', 'almansouri', 'mdmobarokhossainrubel', 'kbbc1234', 'jerome.mourad', 'mpcondak', 'talesdv', 'aravind.ravi', 'sloppyjoe911', 'dominiccostajames', 'pavanchowdaryntrfan', 'hunterla', None, 'mohammed.eng1994', 'kfaist', 'es.maniego', 'g.nitish.kumar', 'pardiss1', 'warnemar', 'chengjiu.zhang.7', 'ncrofty', 'ditionq', 'harvey.hany.71', 'sumeyrakrs', 'aishsingh', 'jason.cammarata.73', 'gaigalac', 'ahmad.wael.165', 'jamesbezuk', 'ericgregg300', 'mahmoud.h.konswa', 'king27med', 'nnovak3', 'phwoook', 'yany', 'zeinahesham423']"
2,219,153,171,122,"['yarrama2', 'boisver2', 'andrewhowell', 'hzh631038469', 'pvuong3', 'peterwu2', 'nanohub77', 'vigneshka', 'yjiang71', 'ryanc', 'rdatta2', 'stanley0010703', 'rahul.bhatia.k', 'jochoe1', 'xxchriskimxx', 'svemulapati', 'tapeterson2', 'wonho.chungy', 'li160', 'dyangsteven', 'sauronalexander', 'paulmis2', 'mkersten', 'psroy2', 'langas2', 'mattfedd', 'pramesh2', 'njalexa2', 'han109', 'gabriel.su.7', 'kwh1210', 'jp199275', 'rodrig67', 'ysheng5', 'shmeeel', 'titusfong', 'kkoppula2', 'michael.gao1', 'sataylor8', 'kakaxizhixin', 'sheelshah22', 'sulaimn2', 'sid.muthal', 'skong10', 'dtaylo21', 'mohsaad', 'cyim2', 'saurav.puri', 'yizhu3', 'didizuibang', 'cmschuetz', 'jtolin2', 'iseri2', 'bluewaves3141', 'jkravitz61', 'lpfung2', 'jchardy2', 'renagade4', 'sam.chuanxie', 'kloseliebej', 'jake.didier', 'ozoude2', 'icetree', 'rshah82', 'intae12', 'eli.longbottom', 'melissacrawford396', 'bob.kummerer', 'adatia1', 'mjtomei', 'joseibert93', 'siddharth.bidasaria', 'yfang12', 'jaber2', 'lingyi.kong.5', 'haller2', 'cookie.green.7798', 'ashah13', 'dgardne2', 'obrzutkevin', 'frostybeverages', 'wratner', 'romanomatthew23', 'balsaofthespear', 'pschmid28', 'cgooding1', 'akagti2', 'fliu14', 'ojoya24', 'shravan.gupta', 'hpark90', 'rstang2', 'sxu32', 'jagraha2', 'kaaere94', 'ablandi2', 'jjleigh2', 'vbahl2', 'ammartn3', 'tjroger2', 'samdawg', 'jdolins2', 'eperbohner', 'nbruck2', 'cmao3', 'gregorlax37', 'eric.ayala2', 'ducharm2', 'keward3', 'lucas.liu.3367', 'tkao4', 'luminoussky07', 'afscg', 'icyroderick', 'vinjamu2', 'kenned45', 'caily1995', 'koliva2', 'pandabrewski2', 'jesse.w.gunderson', 'bhjhnsn2', 'chenxid']",30,"['zulqarnainshah15', 'ramu2', 'yixiong.li.5', 'zhengshiy', 'aldave', 'magician03', 'brandon.ricca', 'adrian.bolandthoms', 'tzhao11', 'kousari2', 'ychen361', 'saurabh.mishra.3576', 'uberdoodle', 'zwidder', 'njayant2', 'irtwiaos', 'ngeleza2', 'mgrawe', 'glink09', 'tianheng.chen', 'maximumsam6', 'saad.paya', 'funnyseanyu', 'lzy329287313', 'ngpeter2', 'zelun.luo', 'zerohp', 'syedfamily222', 'jcalhou2', 'me_i']",49,"['janewjp501', 'xiaozhouas', 'hhkkkxxx133', 'eya369', 'rlmcdon2', 'coleymei', 'june', 'aklaas2', 'cychan3', 'kote.deepa', 'lfirpo', 'csbaile2', 'rishychacko', 'jfoyer2', 'andrumar10', 'lcheng12', 'matteo.hoch.1', 'deepakcmani', 'fhismail', 'aabi10', 'lin.joanna.y', 'shuoliu3', 'mrloube2', 'thexcguy', 'drennan1', 'coolcristobal', 'avandorn1', 'jmxscrs', 'julia.zuo', 'wang.xiaohao.3', 'hjko0107', 'cledesma2331', 'minsu.yu', 'dpapanicolas', 'dalong2', 'pablorosas', 'gsharma80', 'jbrown76', 'salman2', 'jmmille6', 'bababu', 'mrhennek', 'wyattsmcall1', 'prashramani12', 'jtcohen2', 'abhimanyu.khandelwal', 'd82232004', 'knipfer2', 'marjorie.dallmann']",201,"['rlmcdon2', 'boisver2', 'aklaas2', 'andrewhowell', 'adrian.bolandthoms', 'pvuong3', 'vigneshka', 'yjiang71', 'stanley0010703', 'rahul.bhatia.k', 'jochoe1', 'tianheng.chen', 'wonho.chungy', 'hjko0107', 'pablorosas', 'dyangsteven', 'jmmille6', 'paulmis2', 'psroy2', 'langas2', 'aldave', 'lfirpo', 'njalexa2', 'jfoyer2', 'han109', 'gabriel.su.7', 'kwh1210', 'jp199275', 'rodrig67', 'ysheng5', 'shuoliu3', 'shmeeel', 'drennan1', 'titusfong', 'kkoppula2', 'sataylor8', 'sheelshah22', 'sulaimn2', 'minsu.yu', 'dtaylo21', 'mohsaad', 'bababu', 'cyim2', 'saurav.puri', 'jcalhou2', 'me_i', 'cmschuetz', 'xiaozhouas', 'hhkkkxxx133', 'iseri2', 'bluewaves3141', 'jkravitz61', 'eya369', 'coleymei', 'magician03', 'renagade4', 'sam.chuanxie', 'ozoude2', 'fhismail', 'melissacrawford396', 'bob.kummerer', 'siddharth.bidasaria', 'yfang12', 'jaber2', 'lingyi.kong.5', 'cledesma2331', 'ngpeter2', 'ashah13', 'dgardne2', 'jbrown76', 'wratner', 'balsaofthespear', 'pschmid28', 'cgooding1', 'akagti2', 'janewjp501', 'hpark90', 'rstang2', 'sxu32', 'jagraha2', 'jjleigh2', 'andrumar10', 'vbahl2', 'lcheng12', 'samdawg', 'gregorlax37', 'jmxscrs', 'ducharm2', 'saad.paya', 'keward3', 'lucas.liu.3367', 'afscg', 'vinjamu2', 'gsharma80', 'salman2', 'zelun.luo', 'pandabrewski2', 'jesse.w.gunderson', 'bhjhnsn2', 'd82232004', 'knipfer2', 'ramu2', 'yarrama2', 'kote.deepa', 'brandon.ricca', 'hzh631038469', 'peterwu2', 'nanohub77', 'ychen361', 'ryanc', 'rdatta2', 'xxchriskimxx', 'mrloube2', 'svemulapati', 'mgrawe', 'tapeterson2', 'li160', 'sauronalexander', 'mrhennek', 'wyattsmcall1', 'mkersten', 'syedfamily222', 'yixiong.li.5', 'mattfedd', 'pramesh2', 'csbaile2', 'rishychacko', 'kousari2', 'deepakcmani', 'uberdoodle', 'irtwiaos', 'lin.joanna.y', 'ngeleza2', 'michael.gao1', 'kakaxizhixin', 'lzy329287313', 'dalong2', 'sid.muthal', 'skong10', 'prashramani12', 'didizuibang', 'yizhu3', 'jtolin2', 'lpfung2', 'jchardy2', 'kloseliebej', 'jake.didier', 'icetree', 'intae12', 'rshah82', 'eli.longbottom', 'zwidder', 'njayant2', 'aabi10', 'adatia1', 'mjtomei', 'joseibert93', 'coolcristobal', 'avandorn1', 'julia.zuo', 'haller2', 'maximumsam6', 'cookie.green.7798', 'wang.xiaohao.3', 'funnyseanyu', 'obrzutkevin', 'frostybeverages', 'romanomatthew23', 'zerohp', 'abhimanyu.khandelwal', 'fliu14', 'zulqarnainshah15', 'ojoya24', 'shravan.gupta', 'zhengshiy', 'june', 'cychan3', 'kaaere94', 'ablandi2', 'tzhao11', 'ammartn3', 'saurabh.mishra.3576', 'matteo.hoch.1', 'tjroger2', 'jdolins2', 'eperbohner', 'nbruck2', 'cmao3', 'thexcguy', 'glink09', 'eric.ayala2', 'tkao4', 'luminoussky07', 'icyroderick', 'dpapanicolas', 'kenned45', 'caily1995', 'koliva2', 'jtcohen2', 'chenxid', 'marjorie.dallmann']"
2,224,153,36,1,['syedfamily222'],151,"['ramu2', 'yarrama2', 'boisver2', 'brandon.ricca', 'andrewhowell', 'adrian.bolandthoms', 'hzh631038469', 'pvuong3', 'peterwu2', 'nanohub77', 'ychen361', 'vigneshka', 'yjiang71', 'ryanc', 'rdatta2', 'stanley0010703', 'rahul.bhatia.k', 'jochoe1', 'xxchriskimxx', 'svemulapati', 'mgrawe', 'tapeterson2', 'tianheng.chen', 'wonho.chungy', 'li160', 'dyangsteven', 'sauronalexander', 'paulmis2', 'mkersten', 'psroy2', 'langas2', 'yixiong.li.5', 'mattfedd', 'pramesh2', 'aldave', 'njalexa2', 'han109', 'kousari2', 'gabriel.su.7', 'kwh1210', 'uberdoodle', 'jp199275', 'irtwiaos', 'rodrig67', 'ysheng5', 'ngeleza2', 'shmeeel', 'titusfong', 'kkoppula2', 'michael.gao1', 'sataylor8', 'kakaxizhixin', 'sheelshah22', 'lzy329287313', 'sulaimn2', 'sid.muthal', 'skong10', 'dtaylo21', 'mohsaad', 'cyim2', 'saurav.puri', 'jcalhou2', 'me_i', 'didizuibang', 'yizhu3', 'cmschuetz', 'jtolin2', 'iseri2', 'bluewaves3141', 'jkravitz61', 'lpfung2', 'magician03', 'jchardy2', 'renagade4', 'sam.chuanxie', 'kloseliebej', 'jake.didier', 'ozoude2', 'icetree', 'rshah82', 'intae12', 'eli.longbottom', 'zwidder', 'njayant2', 'melissacrawford396', 'bob.kummerer', 'adatia1', 'mjtomei', 'joseibert93', 'siddharth.bidasaria', 'yfang12', 'jaber2', 'lingyi.kong.5', 'haller2', 'maximumsam6', 'cookie.green.7798', 'funnyseanyu', 'ngpeter2', 'ashah13', 'dgardne2', 'obrzutkevin', 'frostybeverages', 'wratner', 'romanomatthew23', 'balsaofthespear', 'zerohp', 'pschmid28', 'cgooding1', 'akagti2', 'fliu14', 'zulqarnainshah15', 'ojoya24', 'shravan.gupta', 'hpark90', 'zhengshiy', 'rstang2', 'sxu32', 'jagraha2', 'kaaere94', 'ablandi2', 'jjleigh2', 'tzhao11', 'vbahl2', 'ammartn3', 'saurabh.mishra.3576', 'tjroger2', 'samdawg', 'jdolins2', 'eperbohner', 'nbruck2', 'cmao3', 'gregorlax37', 'glink09', 'eric.ayala2', 'ducharm2', 'saad.paya', 'keward3', 'lucas.liu.3367', 'tkao4', 'luminoussky07', 'afscg', 'icyroderick', 'vinjamu2', 'kenned45', 'caily1995', 'zelun.luo', 'koliva2', 'pandabrewski2', 'jesse.w.gunderson', 'bhjhnsn2', 'chenxid']",35,"['el93_el96', 'saadmohsinsiddiqui', 'faizansalehshaikh', 'zainzia', 's102', 'ramal.jafri', 'sidra2020', 'el83el85', 'huda.parvez01', 'aliirfan13', 'khwaja.nabeel', 'babarchacher', 'sumbul', 'sabanazir001', 'esaleem71', 'samreenasmara', 'sanam_sarwar', 'sidra30', 'alifyah1', None, 'talha.aly', 'saadhussainconquer', 'm1', 'el301el302', 'ruk_tuk', 'maheenjd', 'malihaashraf05', 'atiyab', 'mariamchoudry', 'erumnida', 'sanafaiza', 'nageenkhatri', 'ahsansag94', 'urooj.fatima.3745', 'ali.mubashir2993']",187,"['saadmohsinsiddiqui', 'ramu2', 'yarrama2', 'boisver2', 'zainzia', 'brandon.ricca', 'andrewhowell', 'adrian.bolandthoms', 's102', 'hzh631038469', 'pvuong3', 'peterwu2', 'nanohub77', 'ychen361', 'vigneshka', 'yjiang71', 'ryanc', 'rdatta2', 'stanley0010703', 'rahul.bhatia.k', 'jochoe1', 'xxchriskimxx', 'svemulapati', 'mgrawe', 'tapeterson2', 'tianheng.chen', 'wonho.chungy', 'li160', 'dyangsteven', 'sauronalexander', 'el301el302', 'ruk_tuk', 'atiyab', 'mariamchoudry', 'paulmis2', 'mkersten', 'syedfamily222', 'psroy2', 'langas2', 'yixiong.li.5', 'mattfedd', 'pramesh2', 'aldave', 'njalexa2', 'han109', 'kousari2', 'gabriel.su.7', 'kwh1210', 'uberdoodle', 'jp199275', 'irtwiaos', 'sidra2020', 'rodrig67', 'ysheng5', 'ngeleza2', 'shmeeel', 'aliirfan13', 'khwaja.nabeel', 'titusfong', 'kkoppula2', 'sabanazir001', 'michael.gao1', 'sataylor8', 'kakaxizhixin', 'sheelshah22', 'lzy329287313', 'sulaimn2', 'sanam_sarwar', 'sidra30', 'sid.muthal', 'skong10', 'dtaylo21', 'mohsaad', 'cyim2', 'sanafaiza', 'saurav.puri', 'erumnida', 'jcalhou2', 'ali.mubashir2993', 'me_i', 'didizuibang', 'yizhu3', 'cmschuetz', 'jtolin2', 'iseri2', 'bluewaves3141', 'jkravitz61', 'lpfung2', 'magician03', 'jchardy2', 'renagade4', 'ramal.jafri', 'sam.chuanxie', 'kloseliebej', 'jake.didier', 'ozoude2', 'icetree', 'rshah82', 'intae12', 'eli.longbottom', 'zwidder', 'njayant2', 'melissacrawford396', 'bob.kummerer', 'adatia1', 'mjtomei', 'el83el85', 'huda.parvez01', 'joseibert93', 'siddharth.bidasaria', 'yfang12', 'babarchacher', 'jaber2', 'lingyi.kong.5', 'haller2', 'maximumsam6', 'cookie.green.7798', 'funnyseanyu', 'ngpeter2', 'ashah13', 'dgardne2', 'saadhussainconquer', 'obrzutkevin', 'frostybeverages', 'wratner', 'maheenjd', 'romanomatthew23', 'balsaofthespear', 'zerohp', 'nageenkhatri', 'pschmid28', 'urooj.fatima.3745', 'cgooding1', 'akagti2', 'fliu14', 'el93_el96', 'zulqarnainshah15', 'ojoya24', 'shravan.gupta', 'hpark90', 'faizansalehshaikh', 'zhengshiy', 'rstang2', 'sxu32', 'jagraha2', 'kaaere94', 'ablandi2', 'jjleigh2', 'tzhao11', 'vbahl2', 'ammartn3', 'saurabh.mishra.3576', 'tjroger2', 'samdawg', 'jdolins2', 'eperbohner', 'nbruck2', 'cmao3', 'gregorlax37', 'glink09', 'eric.ayala2', 'sumbul', 'ducharm2', 'saad.paya', 'esaleem71', 'keward3', 'samreenasmara', 'lucas.liu.3367', 'tkao4', 'luminoussky07', 'alifyah1', 'afscg', 'icyroderick', 'vinjamu2', None, 'talha.aly', 'm1', 'kenned45', 'caily1995', 'zelun.luo', 'koliva2', 'malihaashraf05', 'pandabrewski2', 'jesse.w.gunderson', 'ahsansag94', 'bhjhnsn2', 'chenxid']"
2,226,153,18,1,['syedfamily222'],151,"['ramu2', 'yarrama2', 'boisver2', 'brandon.ricca', 'andrewhowell', 'adrian.bolandthoms', 'hzh631038469', 'pvuong3', 'peterwu2', 'nanohub77', 'ychen361', 'vigneshka', 'yjiang71', 'ryanc', 'rdatta2', 'stanley0010703', 'rahul.bhatia.k', 'jochoe1', 'xxchriskimxx', 'svemulapati', 'mgrawe', 'tapeterson2', 'tianheng.chen', 'wonho.chungy', 'li160', 'dyangsteven', 'sauronalexander', 'paulmis2', 'mkersten', 'psroy2', 'langas2', 'yixiong.li.5', 'mattfedd', 'pramesh2', 'aldave', 'njalexa2', 'han109', 'kousari2', 'gabriel.su.7', 'kwh1210', 'uberdoodle', 'jp199275', 'irtwiaos', 'rodrig67', 'ysheng5', 'ngeleza2', 'shmeeel', 'titusfong', 'kkoppula2', 'michael.gao1', 'sataylor8', 'kakaxizhixin', 'sheelshah22', 'lzy329287313', 'sulaimn2', 'sid.muthal', 'skong10', 'dtaylo21', 'mohsaad', 'cyim2', 'saurav.puri', 'jcalhou2', 'me_i', 'didizuibang', 'yizhu3', 'cmschuetz', 'jtolin2', 'iseri2', 'bluewaves3141', 'jkravitz61', 'lpfung2', 'magician03', 'jchardy2', 'renagade4', 'sam.chuanxie', 'kloseliebej', 'jake.didier', 'ozoude2', 'icetree', 'rshah82', 'intae12', 'eli.longbottom', 'zwidder', 'njayant2', 'melissacrawford396', 'bob.kummerer', 'adatia1', 'mjtomei', 'joseibert93', 'siddharth.bidasaria', 'yfang12', 'jaber2', 'lingyi.kong.5', 'haller2', 'maximumsam6', 'cookie.green.7798', 'funnyseanyu', 'ngpeter2', 'ashah13', 'dgardne2', 'obrzutkevin', 'frostybeverages', 'wratner', 'romanomatthew23', 'balsaofthespear', 'zerohp', 'pschmid28', 'cgooding1', 'akagti2', 'fliu14', 'zulqarnainshah15', 'ojoya24', 'shravan.gupta', 'hpark90', 'zhengshiy', 'rstang2', 'sxu32', 'jagraha2', 'kaaere94', 'ablandi2', 'jjleigh2', 'tzhao11', 'vbahl2', 'ammartn3', 'saurabh.mishra.3576', 'tjroger2', 'samdawg', 'jdolins2', 'eperbohner', 'nbruck2', 'cmao3', 'gregorlax37', 'glink09', 'eric.ayala2', 'ducharm2', 'saad.paya', 'keward3', 'lucas.liu.3367', 'tkao4', 'luminoussky07', 'afscg', 'icyroderick', 'vinjamu2', 'kenned45', 'caily1995', 'zelun.luo', 'koliva2', 'pandabrewski2', 'jesse.w.gunderson', 'bhjhnsn2', 'chenxid']",17,"['aliirfan13', 'el93_el96', 'el301el302', 'faizansalehshaikh', 'saqib.dastagir', 'esaleem71', 'malihaashraf05', 'sanafaiza', 'x_man', 'erumnida', 'yusra_ammara', 'sanam_sarwar', 'el83el85', 'ramal.jafri', None, 'saadhussainconquer', 'daneylpasha']",169,"['ramu2', 'saqib.dastagir', 'yarrama2', 'boisver2', 'brandon.ricca', 'andrewhowell', 'adrian.bolandthoms', 'hzh631038469', 'pvuong3', 'peterwu2', 'nanohub77', 'ychen361', 'vigneshka', 'yjiang71', 'ryanc', 'rdatta2', 'stanley0010703', 'rahul.bhatia.k', 'jochoe1', 'xxchriskimxx', 'svemulapati', 'mgrawe', 'tapeterson2', 'tianheng.chen', 'wonho.chungy', 'yusra_ammara', 'li160', 'dyangsteven', 'sauronalexander', 'el301el302', 'paulmis2', 'mkersten', 'syedfamily222', 'psroy2', 'langas2', 'yixiong.li.5', 'mattfedd', 'pramesh2', 'aldave', 'njalexa2', 'han109', 'daneylpasha', 'kousari2', 'gabriel.su.7', 'kwh1210', 'uberdoodle', 'jp199275', 'irtwiaos', 'rodrig67', 'ysheng5', 'ngeleza2', 'shmeeel', 'aliirfan13', 'titusfong', 'kkoppula2', 'michael.gao1', 'sataylor8', 'kakaxizhixin', 'sheelshah22', 'lzy329287313', 'sulaimn2', 'sanam_sarwar', 'sid.muthal', 'skong10', 'dtaylo21', 'mohsaad', 'cyim2', 'sanafaiza', 'x_man', 'saurav.puri', 'erumnida', 'jcalhou2', 'me_i', 'didizuibang', 'yizhu3', 'cmschuetz', 'jtolin2', 'iseri2', 'bluewaves3141', 'jkravitz61', 'lpfung2', 'magician03', 'jchardy2', 'renagade4', 'ramal.jafri', 'sam.chuanxie', 'kloseliebej', 'jake.didier', 'ozoude2', 'icetree', 'rshah82', 'intae12', 'eli.longbottom', 'zwidder', 'njayant2', 'melissacrawford396', 'bob.kummerer', 'adatia1', 'mjtomei', 'el83el85', 'joseibert93', 'siddharth.bidasaria', 'yfang12', 'jaber2', 'lingyi.kong.5', 'haller2', 'maximumsam6', 'cookie.green.7798', 'funnyseanyu', 'ngpeter2', 'ashah13', 'dgardne2', 'saadhussainconquer', 'obrzutkevin', 'frostybeverages', 'wratner', 'romanomatthew23', 'balsaofthespear', 'zerohp', 'pschmid28', 'cgooding1', 'akagti2', 'fliu14', 'el93_el96', 'zulqarnainshah15', 'ojoya24', 'shravan.gupta', 'hpark90', 'faizansalehshaikh', 'zhengshiy', 'rstang2', 'sxu32', 'jagraha2', 'kaaere94', 'ablandi2', 'jjleigh2', 'tzhao11', 'vbahl2', 'ammartn3', 'saurabh.mishra.3576', 'tjroger2', 'samdawg', 'jdolins2', 'eperbohner', 'nbruck2', 'cmao3', 'gregorlax37', 'glink09', 'eric.ayala2', 'ducharm2', 'saad.paya', 'esaleem71', 'keward3', 'lucas.liu.3367', 'tkao4', 'luminoussky07', 'afscg', 'icyroderick', 'vinjamu2', None, 'kenned45', 'caily1995', 'zelun.luo', 'koliva2', 'malihaashraf05', 'pandabrewski2', 'jesse.w.gunderson', 'bhjhnsn2', 'chenxid']"
2,222,153,14,12,"['ychen361', 'zelun.luo', 'ramu2', 'zwidder', 'irtwiaos', 'maximumsam6', 'zerohp', 'magician03', 'aldave', 'ngpeter2', 'mgrawe', 'glink09']",140,"['yarrama2', 'boisver2', 'brandon.ricca', 'andrewhowell', 'adrian.bolandthoms', 'hzh631038469', 'pvuong3', 'peterwu2', 'nanohub77', 'vigneshka', 'yjiang71', 'ryanc', 'rdatta2', 'stanley0010703', 'rahul.bhatia.k', 'jochoe1', 'xxchriskimxx', 'svemulapati', 'tapeterson2', 'tianheng.chen', 'wonho.chungy', 'li160', 'dyangsteven', 'sauronalexander', 'paulmis2', 'mkersten', 'syedfamily222', 'psroy2', 'langas2', 'yixiong.li.5', 'mattfedd', 'pramesh2', 'njalexa2', 'han109', 'kousari2', 'gabriel.su.7', 'kwh1210', 'uberdoodle', 'jp199275', 'rodrig67', 'ysheng5', 'ngeleza2', 'shmeeel', 'titusfong', 'kkoppula2', 'michael.gao1', 'sataylor8', 'kakaxizhixin', 'sheelshah22', 'lzy329287313', 'sulaimn2', 'sid.muthal', 'skong10', 'dtaylo21', 'mohsaad', 'cyim2', 'saurav.puri', 'jcalhou2', 'me_i', 'didizuibang', 'yizhu3', 'cmschuetz', 'jtolin2', 'iseri2', 'bluewaves3141', 'jkravitz61', 'lpfung2', 'jchardy2', 'renagade4', 'sam.chuanxie', 'kloseliebej', 'jake.didier', 'ozoude2', 'icetree', 'rshah82', 'intae12', 'eli.longbottom', 'njayant2', 'melissacrawford396', 'bob.kummerer', 'adatia1', 'mjtomei', 'joseibert93', 'siddharth.bidasaria', 'yfang12', 'jaber2', 'lingyi.kong.5', 'haller2', 'cookie.green.7798', 'funnyseanyu', 'ashah13', 'dgardne2', 'obrzutkevin', 'frostybeverages', 'wratner', 'romanomatthew23', 'balsaofthespear', 'pschmid28', 'cgooding1', 'akagti2', 'fliu14', 'zulqarnainshah15', 'ojoya24', 'shravan.gupta', 'hpark90', 'zhengshiy', 'rstang2', 'sxu32', 'jagraha2', 'kaaere94', 'ablandi2', 'jjleigh2', 'tzhao11', 'vbahl2', 'ammartn3', 'saurabh.mishra.3576', 'tjroger2', 'samdawg', 'jdolins2', 'eperbohner', 'nbruck2', 'cmao3', 'gregorlax37', 'eric.ayala2', 'ducharm2', 'saad.paya', 'keward3', 'lucas.liu.3367', 'tkao4', 'luminoussky07', 'afscg', 'icyroderick', 'vinjamu2', 'kenned45', 'caily1995', 'koliva2', 'pandabrewski2', 'jesse.w.gunderson', 'bhjhnsn2', 'chenxid']",2,"['julia.zuo', None]",154,"['ramu2', 'yarrama2', 'boisver2', 'brandon.ricca', 'andrewhowell', 'adrian.bolandthoms', 'hzh631038469', 'pvuong3', 'peterwu2', 'nanohub77', 'ychen361', 'vigneshka', 'yjiang71', 'ryanc', 'rdatta2', 'stanley0010703', 'rahul.bhatia.k', 'jochoe1', 'xxchriskimxx', 'svemulapati', 'mgrawe', 'tapeterson2', 'tianheng.chen', 'wonho.chungy', 'li160', 'dyangsteven', 'sauronalexander', 'paulmis2', 'mkersten', 'syedfamily222', 'psroy2', 'langas2', 'yixiong.li.5', 'mattfedd', 'pramesh2', 'aldave', 'njalexa2', 'han109', 'kousari2', 'gabriel.su.7', 'kwh1210', 'uberdoodle', 'jp199275', 'irtwiaos', 'rodrig67', 'ysheng5', 'ngeleza2', 'shmeeel', 'titusfong', 'kkoppula2', 'michael.gao1', 'sataylor8', 'kakaxizhixin', 'sheelshah22', 'lzy329287313', 'sulaimn2', 'sid.muthal', 'skong10', 'dtaylo21', 'mohsaad', 'cyim2', 'saurav.puri', 'jcalhou2', 'me_i', 'didizuibang', 'yizhu3', 'cmschuetz', 'jtolin2', 'iseri2', 'bluewaves3141', 'jkravitz61', 'lpfung2', 'magician03', 'jchardy2', 'renagade4', 'sam.chuanxie', 'kloseliebej', 'jake.didier', 'ozoude2', 'icetree', 'rshah82', 'intae12', 'eli.longbottom', 'zwidder', 'njayant2', 'melissacrawford396', 'bob.kummerer', 'adatia1', 'mjtomei', 'joseibert93', 'siddharth.bidasaria', 'yfang12', 'jaber2', 'lingyi.kong.5', 'haller2', 'julia.zuo', 'maximumsam6', 'cookie.green.7798', 'funnyseanyu', 'ngpeter2', 'ashah13', 'dgardne2', 'obrzutkevin', 'frostybeverages', 'wratner', 'romanomatthew23', 'balsaofthespear', 'zerohp', 'pschmid28', 'cgooding1', 'akagti2', 'fliu14', 'zulqarnainshah15', 'ojoya24', 'shravan.gupta', 'hpark90', 'zhengshiy', 'rstang2', 'sxu32', 'jagraha2', 'kaaere94', 'ablandi2', 'jjleigh2', 'tzhao11', 'vbahl2', 'ammartn3', 'saurabh.mishra.3576', 'tjroger2', 'samdawg', 'jdolins2', 'eperbohner', 'nbruck2', 'cmao3', 'gregorlax37', 'glink09', 'eric.ayala2', 'ducharm2', 'saad.paya', 'keward3', 'lucas.liu.3367', 'tkao4', 'luminoussky07', 'afscg', 'icyroderick', 'vinjamu2', None, 'kenned45', 'caily1995', 'zelun.luo', 'koliva2', 'pandabrewski2', 'jesse.w.gunderson', 'bhjhnsn2', 'chenxid']"
2,220,153,10,1,['zulqarnainshah15'],151,"['ramu2', 'yarrama2', 'boisver2', 'brandon.ricca', 'andrewhowell', 'adrian.bolandthoms', 'hzh631038469', 'pvuong3', 'peterwu2', 'nanohub77', 'ychen361', 'vigneshka', 'yjiang71', 'ryanc', 'rdatta2', 'stanley0010703', 'rahul.bhatia.k', 'jochoe1', 'xxchriskimxx', 'svemulapati', 'mgrawe', 'tapeterson2', 'tianheng.chen', 'wonho.chungy', 'li160', 'dyangsteven', 'sauronalexander', 'paulmis2', 'mkersten', 'syedfamily222', 'psroy2', 'langas2', 'yixiong.li.5', 'mattfedd', 'pramesh2', 'aldave', 'njalexa2', 'han109', 'kousari2', 'gabriel.su.7', 'kwh1210', 'uberdoodle', 'jp199275', 'irtwiaos', 'rodrig67', 'ysheng5', 'ngeleza2', 'shmeeel', 'titusfong', 'kkoppula2', 'michael.gao1', 'sataylor8', 'kakaxizhixin', 'sheelshah22', 'lzy329287313', 'sulaimn2', 'sid.muthal', 'skong10', 'dtaylo21', 'mohsaad', 'cyim2', 'saurav.puri', 'jcalhou2', 'me_i', 'didizuibang', 'yizhu3', 'cmschuetz', 'jtolin2', 'iseri2', 'bluewaves3141', 'jkravitz61', 'lpfung2', 'magician03', 'jchardy2', 'renagade4', 'sam.chuanxie', 'kloseliebej', 'jake.didier', 'ozoude2', 'icetree', 'rshah82', 'intae12', 'eli.longbottom', 'zwidder', 'njayant2', 'melissacrawford396', 'bob.kummerer', 'adatia1', 'mjtomei', 'joseibert93', 'siddharth.bidasaria', 'yfang12', 'jaber2', 'lingyi.kong.5', 'haller2', 'maximumsam6', 'cookie.green.7798', 'funnyseanyu', 'ngpeter2', 'ashah13', 'dgardne2', 'obrzutkevin', 'frostybeverages', 'wratner', 'romanomatthew23', 'balsaofthespear', 'zerohp', 'pschmid28', 'cgooding1', 'akagti2', 'fliu14', 'ojoya24', 'shravan.gupta', 'hpark90', 'zhengshiy', 'rstang2', 'sxu32', 'jagraha2', 'kaaere94', 'ablandi2', 'jjleigh2', 'tzhao11', 'vbahl2', 'ammartn3', 'saurabh.mishra.3576', 'tjroger2', 'samdawg', 'jdolins2', 'eperbohner', 'nbruck2', 'cmao3', 'gregorlax37', 'glink09', 'eric.ayala2', 'ducharm2', 'saad.paya', 'keward3', 'lucas.liu.3367', 'tkao4', 'luminoussky07', 'afscg', 'icyroderick', 'vinjamu2', 'kenned45', 'caily1995', 'zelun.luo', 'koliva2', 'pandabrewski2', 'jesse.w.gunderson', 'bhjhnsn2', 'chenxid']",9,"['khudaijasaleem', 'sabamalik000111', 'anonymousperson395', 'farheenjahan66', 'shanno447', 'jazib.kaleem', 'mammadsiddiqui15', 'el43', None]",161,"['ramu2', 'yarrama2', 'boisver2', 'brandon.ricca', 'andrewhowell', 'adrian.bolandthoms', 'hzh631038469', 'pvuong3', 'peterwu2', 'nanohub77', 'ychen361', 'vigneshka', 'yjiang71', 'ryanc', 'farheenjahan66', 'rdatta2', 'stanley0010703', 'rahul.bhatia.k', 'jochoe1', 'xxchriskimxx', 'el43', 'svemulapati', 'mgrawe', 'tapeterson2', 'sabamalik000111', 'tianheng.chen', 'wonho.chungy', 'li160', 'dyangsteven', 'sauronalexander', 'paulmis2', 'mkersten', 'syedfamily222', 'psroy2', 'langas2', 'yixiong.li.5', 'mattfedd', 'pramesh2', 'aldave', 'njalexa2', 'han109', 'kousari2', 'gabriel.su.7', 'kwh1210', 'uberdoodle', 'jp199275', 'irtwiaos', 'rodrig67', 'ysheng5', 'ngeleza2', 'shmeeel', 'titusfong', 'kkoppula2', 'michael.gao1', 'sataylor8', 'kakaxizhixin', 'sheelshah22', 'lzy329287313', 'sulaimn2', 'sid.muthal', 'skong10', 'dtaylo21', 'mohsaad', 'cyim2', 'jazib.kaleem', 'saurav.puri', 'jcalhou2', 'me_i', 'didizuibang', 'yizhu3', 'cmschuetz', 'jtolin2', 'iseri2', 'bluewaves3141', 'jkravitz61', 'lpfung2', 'magician03', 'jchardy2', 'renagade4', 'sam.chuanxie', 'kloseliebej', 'jake.didier', 'ozoude2', 'icetree', 'rshah82', 'intae12', 'eli.longbottom', 'zwidder', 'njayant2', 'melissacrawford396', 'bob.kummerer', 'adatia1', 'mjtomei', 'joseibert93', 'siddharth.bidasaria', 'yfang12', 'jaber2', 'lingyi.kong.5', 'haller2', 'maximumsam6', 'cookie.green.7798', 'shanno447', 'mammadsiddiqui15', 'funnyseanyu', 'ngpeter2', 'ashah13', 'dgardne2', 'obrzutkevin', 'frostybeverages', 'wratner', 'khudaijasaleem', 'romanomatthew23', 'balsaofthespear', 'zerohp', 'pschmid28', 'cgooding1', 'akagti2', 'fliu14', 'zulqarnainshah15', 'ojoya24', 'shravan.gupta', 'hpark90', 'zhengshiy', 'rstang2', 'anonymousperson395', 'sxu32', 'jagraha2', 'kaaere94', 'ablandi2', 'jjleigh2', 'tzhao11', 'vbahl2', 'ammartn3', 'saurabh.mishra.3576', 'tjroger2', 'samdawg', 'jdolins2', 'eperbohner', 'nbruck2', 'cmao3', 'gregorlax37', 'glink09', 'eric.ayala2', 'ducharm2', 'saad.paya', 'keward3', 'lucas.liu.3367', 'tkao4', 'luminoussky07', 'afscg', 'icyroderick', 'vinjamu2', None, 'kenned45', 'caily1995', 'zelun.luo', 'koliva2', 'pandabrewski2', 'jesse.w.gunderson', 'bhjhnsn2', 'chenxid']"
2,221,153,9,7,"['yixiong.li.5', 'cyim2', 'funnyseanyu', 'lzy329287313', 'ngeleza2', 'shmeeel', 'me_i']",145,"['ramu2', 'yarrama2', 'boisver2', 'brandon.ricca', 'andrewhowell', 'adrian.bolandthoms', 'hzh631038469', 'pvuong3', 'peterwu2', 'nanohub77', 'ychen361', 'vigneshka', 'yjiang71', 'ryanc', 'rdatta2', 'stanley0010703', 'rahul.bhatia.k', 'jochoe1', 'xxchriskimxx', 'svemulapati', 'mgrawe', 'tapeterson2', 'tianheng.chen', 'wonho.chungy', 'li160', 'dyangsteven', 'sauronalexander', 'paulmis2', 'mkersten', 'syedfamily222', 'psroy2', 'langas2', 'mattfedd', 'pramesh2', 'aldave', 'njalexa2', 'han109', 'kousari2', 'gabriel.su.7', 'kwh1210', 'uberdoodle', 'jp199275', 'irtwiaos', 'rodrig67', 'ysheng5', 'titusfong', 'kkoppula2', 'michael.gao1', 'sataylor8', 'kakaxizhixin', 'sheelshah22', 'sulaimn2', 'sid.muthal', 'skong10', 'dtaylo21', 'mohsaad', 'saurav.puri', 'jcalhou2', 'didizuibang', 'yizhu3', 'cmschuetz', 'jtolin2', 'iseri2', 'bluewaves3141', 'jkravitz61', 'lpfung2', 'magician03', 'jchardy2', 'renagade4', 'sam.chuanxie', 'kloseliebej', 'jake.didier', 'ozoude2', 'icetree', 'rshah82', 'intae12', 'eli.longbottom', 'zwidder', 'njayant2', 'melissacrawford396', 'bob.kummerer', 'adatia1', 'mjtomei', 'joseibert93', 'siddharth.bidasaria', 'yfang12', 'jaber2', 'lingyi.kong.5', 'haller2', 'maximumsam6', 'cookie.green.7798', 'ngpeter2', 'ashah13', 'dgardne2', 'obrzutkevin', 'frostybeverages', 'wratner', 'romanomatthew23', 'balsaofthespear', 'zerohp', 'pschmid28', 'cgooding1', 'akagti2', 'fliu14', 'zulqarnainshah15', 'ojoya24', 'shravan.gupta', 'hpark90', 'zhengshiy', 'rstang2', 'sxu32', 'jagraha2', 'kaaere94', 'ablandi2', 'jjleigh2', 'tzhao11', 'vbahl2', 'ammartn3', 'saurabh.mishra.3576', 'tjroger2', 'samdawg', 'jdolins2', 'eperbohner', 'nbruck2', 'cmao3', 'gregorlax37', 'glink09', 'eric.ayala2', 'ducharm2', 'saad.paya', 'keward3', 'lucas.liu.3367', 'tkao4', 'luminoussky07', 'afscg', 'icyroderick', 'vinjamu2', 'kenned45', 'caily1995', 'zelun.luo', 'koliva2', 'pandabrewski2', 'jesse.w.gunderson', 'bhjhnsn2', 'chenxid']",2,"[None, 'gggrade']",154,"['ramu2', 'yarrama2', 'boisver2', 'brandon.ricca', 'andrewhowell', 'adrian.bolandthoms', 'hzh631038469', 'pvuong3', 'peterwu2', 'nanohub77', 'ychen361', 'vigneshka', 'yjiang71', 'ryanc', 'rdatta2', 'stanley0010703', 'rahul.bhatia.k', 'jochoe1', 'xxchriskimxx', 'svemulapati', 'mgrawe', 'tapeterson2', 'tianheng.chen', 'wonho.chungy', 'li160', 'dyangsteven', 'sauronalexander', 'paulmis2', 'mkersten', 'syedfamily222', 'psroy2', 'langas2', 'yixiong.li.5', 'mattfedd', 'pramesh2', 'aldave', 'njalexa2', 'han109', 'kousari2', 'gabriel.su.7', 'kwh1210', 'uberdoodle', 'jp199275', 'irtwiaos', 'rodrig67', 'ysheng5', 'ngeleza2', 'shmeeel', 'titusfong', 'kkoppula2', 'michael.gao1', 'sataylor8', 'kakaxizhixin', 'sheelshah22', 'lzy329287313', 'sulaimn2', 'sid.muthal', 'skong10', 'dtaylo21', 'mohsaad', 'cyim2', 'saurav.puri', 'jcalhou2', 'me_i', 'didizuibang', 'yizhu3', 'cmschuetz', 'jtolin2', 'iseri2', 'bluewaves3141', 'jkravitz61', 'lpfung2', 'magician03', 'jchardy2', 'renagade4', 'sam.chuanxie', 'kloseliebej', 'jake.didier', 'ozoude2', 'icetree', 'rshah82', 'intae12', 'eli.longbottom', 'zwidder', 'njayant2', 'melissacrawford396', 'bob.kummerer', 'adatia1', 'mjtomei', 'joseibert93', 'siddharth.bidasaria', 'yfang12', 'jaber2', 'lingyi.kong.5', 'haller2', 'maximumsam6', 'cookie.green.7798', 'funnyseanyu', 'ngpeter2', 'ashah13', 'dgardne2', 'obrzutkevin', 'frostybeverages', 'wratner', 'romanomatthew23', 'balsaofthespear', 'zerohp', 'pschmid28', 'gggrade', 'cgooding1', 'akagti2', 'fliu14', 'zulqarnainshah15', 'ojoya24', 'shravan.gupta', 'hpark90', 'zhengshiy', 'rstang2', 'sxu32', 'jagraha2', 'kaaere94', 'ablandi2', 'jjleigh2', 'tzhao11', 'vbahl2', 'ammartn3', 'saurabh.mishra.3576', 'tjroger2', 'samdawg', 'jdolins2', 'eperbohner', 'nbruck2', 'cmao3', 'gregorlax37', 'glink09', 'eric.ayala2', 'ducharm2', 'saad.paya', 'keward3', 'lucas.liu.3367', 'tkao4', 'luminoussky07', 'afscg', 'icyroderick', 'vinjamu2', None, 'kenned45', 'caily1995', 'zelun.luo', 'koliva2', 'pandabrewski2', 'jesse.w.gunderson', 'bhjhnsn2', 'chenxid']"
3,134,146,94,93,"['hackers', 'philitup5', 'genius9367', 'li1014', 'xinyanglu', 'jtwirtz', 'sms2157', 'kreed321', 'zjuliot', 'b100curry', 'shah153', 'rfinch', 'cbg888', 'nicksand84', 'ktalathi', 'dsenpurdue', 'davis538', 'nkochhar01', 'cheng.chen.121772', 'jcgerber', 'jamesbob007', 'aquirini', 'luke.polster1', 'zhang767', 'neal27', 'kpm1669', 'catneff', 'jennifer.janusz.5', 'clarencechan0427', 'eck.justin', 'xuzhenlei', 'johnhenry.fischer', 'silverfoxno10', 'forrestson', 'robbyc.stevens', 'bojun.song', 'dylan.simpson.832', 'nasirbilal', 'dmills1028', 'delreajc', 'cyberg95', 'tarang.saxena.5', 'mruggier', 'humphrey.ariel', 'lzc360448787', 'huangwendi0623', 'jpej', 'allan.calomino', 'rstemme4', 'mapolaya12', 'parthsharda11', 'lchristl', 'jhoffine', 'saurabhsaboo14', 'young192', 'ifrankpurdue.edu', 'hpascoal', 'joelschwallier', 'dandaman9753', 'little12', 'rtjahjon', 'rubioc', 'cbunker', 'wbrumlev', 'smohler14', 'hansen56', 'sander75', 'jordanm', 'low0', 'crawfo20', 'cindyq1200', 'sgranger112', 'qmm7', 'sstoddar13', 'barkaloww', 'dandichen0502', 'arnabjghosh', 'marti578', 'connor9001', 'tpalcheck', 'bsemmens', 'mishra24', 'jmillerh', 'bhat.utsav', 'suzanne.bagnoli1', 'ryanspesard', 'dylanjmadden25', 'ateays', 'btramme', 'nanderson', 'barker7', 'zhinz', 'suzannebagnoli']",52,"['djsobs3', 'bankole.adenrele', 'erynhorton32', 'mtzsbxx', 'badenrel', 'jam94jm', 'adesalvo12', 'yasinalaa', 'bbornste', 'adharanipragada', 'nzabikh', 'tomohiro18', 'pggerber', 'mmeads12', 'junha0214', 'huaiyuanli', 'workschool67', 'efun', 'crickelm', 'asif.alam.adi', 'tanktanhao1990', 'jbollard', 'rtrostle', 'jackie.shao21', 'jain107', 'elum', 'kim19940509', 'bruce6', 'ahnaf.ryan.1', 'bwon56', 'annaplatanos', 'mikeemejia81', 'mert.karakaya.524', 'veer.p39', 'alexbenson25', 'nathanw594', 'dhook93', 'kx', 'mfulwid', 'apehr', 'nkelner1991', 'yang488', 'shijunzhespark', 'likunlong1130', 'smitt', 'sotongnic', 'nitesh52', 'shubhankar.takle', 'ziyan', 'ngducthanh99', 'gohwaikien2', 'haynes0']",1,[None],146,"['hackers', 'philitup5', 'genius9367', 'li1014', 'erynhorton32', 'xinyanglu', 'jam94jm', 'jtwirtz', 'sms2157', 'kreed321', 'zjuliot', 'b100curry', 'junha0214', 'shah153', 'rfinch', 'cbg888', 'jackie.shao21', 'nicksand84', 'elum', 'ktalathi', 'annaplatanos', 'mikeemejia81', 'alexbenson25', 'dsenpurdue', 'davis538', 'nkochhar01', 'cheng.chen.121772', 'jcgerber', 'jamesbob007', 'apehr', 'nkelner1991', 'aquirini', 'shijunzhespark', 'smitt', 'shubhankar.takle', 'luke.polster1', 'zhang767', 'neal27', 'kpm1669', 'catneff', 'jennifer.janusz.5', 'clarencechan0427', 'eck.justin', 'badenrel', 'xuzhenlei', 'johnhenry.fischer', 'bbornste', 'adharanipragada', 'silverfoxno10', 'forrestson', 'robbyc.stevens', 'bojun.song', 'dylan.simpson.832', 'huaiyuanli', 'workschool67', 'nasirbilal', 'tanktanhao1990', 'jbollard', 'dmills1028', 'jain107', 'delreajc', 'cyberg95', 'tarang.saxena.5', 'humphrey.ariel', 'mruggier', 'bwon56', 'lzc360448787', 'jpej', 'huangwendi0623', 'allan.calomino', 'rstemme4', 'yang488', 'likunlong1130', 'nitesh52', 'ziyan', 'ngducthanh99', 'gohwaikien2', 'mapolaya12', 'haynes0', 'parthsharda11', 'lchristl', 'jhoffine', 'saurabhsaboo14', 'adesalvo12', 'young192', 'ifrankpurdue.edu', 'nzabikh', 'tomohiro18', 'hpascoal', 'pggerber', 'joelschwallier', 'dandaman9753', 'little12', 'efun', 'crickelm', 'asif.alam.adi', 'rubioc', 'rtjahjon', 'rtrostle', 'cbunker', 'wbrumlev', 'kim19940509', 'smohler14', 'mert.karakaya.524', 'veer.p39', 'nathanw594', 'hansen56', 'kx', 'mfulwid', 'sander75', 'jordanm', 'low0', 'crawfo20', 'djsobs3', 'cindyq1200', 'bankole.adenrele', 'qmm7', 'sgranger112', 'mtzsbxx', 'yasinalaa', 'sstoddar13', 'dandichen0502', 'barkaloww', 'arnabjghosh', 'mmeads12', 'marti578', 'connor9001', 'tpalcheck', 'bsemmens', 'bruce6', 'mishra24', 'ahnaf.ryan.1', 'jmillerh', 'bhat.utsav', 'suzanne.bagnoli1', 'ryanspesard', 'dylanjmadden25', 'dhook93', 'ateays', 'btramme', None, 'nanderson', 'barker7', 'sotongnic', 'zhinz', 'suzannebagnoli']"
3,136,146,8,7,"['sotongnic', 'nathanw594', 'yasinalaa', 'nzabikh', 'rtrostle', 'wbrumlev', 'elum']",138,"['hackers', 'philitup5', 'genius9367', 'li1014', 'erynhorton32', 'xinyanglu', 'jam94jm', 'jtwirtz', 'sms2157', 'kreed321', 'zjuliot', 'b100curry', 'junha0214', 'shah153', 'rfinch', 'cbg888', 'jackie.shao21', 'nicksand84', 'ktalathi', 'annaplatanos', 'mikeemejia81', 'alexbenson25', 'dsenpurdue', 'davis538', 'nkochhar01', 'cheng.chen.121772', 'jcgerber', 'jamesbob007', 'apehr', 'nkelner1991', 'aquirini', 'shijunzhespark', 'smitt', 'shubhankar.takle', 'luke.polster1', 'zhang767', 'neal27', 'kpm1669', 'catneff', 'jennifer.janusz.5', 'clarencechan0427', 'eck.justin', 'badenrel', 'xuzhenlei', 'johnhenry.fischer', 'bbornste', 'adharanipragada', 'silverfoxno10', 'forrestson', 'robbyc.stevens', 'bojun.song', 'dylan.simpson.832', 'huaiyuanli', 'workschool67', 'nasirbilal', 'tanktanhao1990', 'jbollard', 'dmills1028', 'jain107', 'delreajc', 'cyberg95', 'tarang.saxena.5', 'humphrey.ariel', 'mruggier', 'bwon56', 'lzc360448787', 'jpej', 'huangwendi0623', 'allan.calomino', 'rstemme4', 'yang488', 'likunlong1130', 'nitesh52', 'ziyan', 'ngducthanh99', 'gohwaikien2', 'mapolaya12', 'haynes0', 'parthsharda11', 'lchristl', 'jhoffine', 'saurabhsaboo14', 'adesalvo12', 'young192', 'ifrankpurdue.edu', 'tomohiro18', 'hpascoal', 'pggerber', 'joelschwallier', 'dandaman9753', 'little12', 'efun', 'crickelm', 'asif.alam.adi', 'rubioc', 'rtjahjon', 'cbunker', 'kim19940509', 'smohler14', 'mert.karakaya.524', 'veer.p39', 'hansen56', 'kx', 'mfulwid', 'sander75', 'jordanm', 'low0', 'crawfo20', 'djsobs3', 'cindyq1200', 'bankole.adenrele', 'qmm7', 'sgranger112', 'mtzsbxx', 'sstoddar13', 'dandichen0502', 'barkaloww', 'arnabjghosh', 'mmeads12', 'marti578', 'connor9001', 'tpalcheck', 'bsemmens', 'bruce6', 'mishra24', 'ahnaf.ryan.1', 'jmillerh', 'bhat.utsav', 'suzanne.bagnoli1', 'ryanspesard', 'dylanjmadden25', 'dhook93', 'ateays', 'btramme', 'nanderson', 'barker7', 'zhinz', 'suzannebagnoli']",1,[None],146,"['hackers', 'philitup5', 'genius9367', 'li1014', 'erynhorton32', 'xinyanglu', 'jam94jm', 'jtwirtz', 'sms2157', 'kreed321', 'zjuliot', 'b100curry', 'junha0214', 'shah153', 'rfinch', 'cbg888', 'jackie.shao21', 'nicksand84', 'elum', 'ktalathi', 'annaplatanos', 'mikeemejia81', 'alexbenson25', 'dsenpurdue', 'davis538', 'nkochhar01', 'cheng.chen.121772', 'jcgerber', 'jamesbob007', 'apehr', 'nkelner1991', 'aquirini', 'shijunzhespark', 'smitt', 'shubhankar.takle', 'luke.polster1', 'zhang767', 'neal27', 'kpm1669', 'catneff', 'jennifer.janusz.5', 'clarencechan0427', 'eck.justin', 'badenrel', 'xuzhenlei', 'johnhenry.fischer', 'bbornste', 'adharanipragada', 'silverfoxno10', 'forrestson', 'robbyc.stevens', 'bojun.song', 'dylan.simpson.832', 'huaiyuanli', 'workschool67', 'nasirbilal', 'tanktanhao1990', 'jbollard', 'dmills1028', 'jain107', 'delreajc', 'cyberg95', 'tarang.saxena.5', 'humphrey.ariel', 'mruggier', 'bwon56', 'lzc360448787', 'jpej', 'huangwendi0623', 'allan.calomino', 'rstemme4', 'yang488', 'likunlong1130', 'nitesh52', 'ziyan', 'ngducthanh99', 'gohwaikien2', 'mapolaya12', 'haynes0', 'parthsharda11', 'lchristl', 'jhoffine', 'saurabhsaboo14', 'adesalvo12', 'young192', 'ifrankpurdue.edu', 'nzabikh', 'tomohiro18', 'hpascoal', 'pggerber', 'joelschwallier', 'dandaman9753', 'little12', 'efun', 'crickelm', 'asif.alam.adi', 'rubioc', 'rtjahjon', 'rtrostle', 'cbunker', 'wbrumlev', 'kim19940509', 'smohler14', 'mert.karakaya.524', 'veer.p39', 'nathanw594', 'hansen56', 'kx', 'mfulwid', 'sander75', 'jordanm', 'low0', 'crawfo20', 'djsobs3', 'cindyq1200', 'bankole.adenrele', 'qmm7', 'sgranger112', 'mtzsbxx', 'yasinalaa', 'sstoddar13', 'dandichen0502', 'barkaloww', 'arnabjghosh', 'mmeads12', 'marti578', 'connor9001', 'tpalcheck', 'bsemmens', 'bruce6', 'mishra24', 'ahnaf.ryan.1', 'jmillerh', 'bhat.utsav', 'suzanne.bagnoli1', 'ryanspesard', 'dylanjmadden25', 'dhook93', 'ateays', 'btramme', None, 'nanderson', 'barker7', 'sotongnic', 'zhinz', 'suzannebagnoli']"
3,135,146,7,6,"['eck.justin', 'low0', 'tomohiro18', 'bruce6', 'kx', 'mfulwid']",139,"['hackers', 'philitup5', 'genius9367', 'li1014', 'erynhorton32', 'xinyanglu', 'jam94jm', 'jtwirtz', 'sms2157', 'kreed321', 'zjuliot', 'b100curry', 'junha0214', 'shah153', 'rfinch', 'cbg888', 'jackie.shao21', 'nicksand84', 'elum', 'ktalathi', 'annaplatanos', 'mikeemejia81', 'alexbenson25', 'dsenpurdue', 'davis538', 'nkochhar01', 'cheng.chen.121772', 'jcgerber', 'jamesbob007', 'apehr', 'nkelner1991', 'aquirini', 'shijunzhespark', 'smitt', 'shubhankar.takle', 'luke.polster1', 'zhang767', 'neal27', 'kpm1669', 'catneff', 'jennifer.janusz.5', 'clarencechan0427', 'badenrel', 'xuzhenlei', 'johnhenry.fischer', 'bbornste', 'adharanipragada', 'silverfoxno10', 'forrestson', 'robbyc.stevens', 'bojun.song', 'dylan.simpson.832', 'huaiyuanli', 'workschool67', 'nasirbilal', 'tanktanhao1990', 'jbollard', 'dmills1028', 'jain107', 'delreajc', 'cyberg95', 'tarang.saxena.5', 'humphrey.ariel', 'mruggier', 'bwon56', 'lzc360448787', 'jpej', 'huangwendi0623', 'allan.calomino', 'rstemme4', 'yang488', 'likunlong1130', 'nitesh52', 'ziyan', 'ngducthanh99', 'gohwaikien2', 'mapolaya12', 'haynes0', 'parthsharda11', 'lchristl', 'jhoffine', 'saurabhsaboo14', 'adesalvo12', 'young192', 'ifrankpurdue.edu', 'nzabikh', 'hpascoal', 'pggerber', 'joelschwallier', 'dandaman9753', 'little12', 'efun', 'crickelm', 'asif.alam.adi', 'rubioc', 'rtjahjon', 'rtrostle', 'cbunker', 'wbrumlev', 'kim19940509', 'smohler14', 'mert.karakaya.524', 'veer.p39', 'nathanw594', 'hansen56', 'sander75', 'jordanm', 'crawfo20', 'djsobs3', 'cindyq1200', 'bankole.adenrele', 'qmm7', 'sgranger112', 'mtzsbxx', 'yasinalaa', 'sstoddar13', 'dandichen0502', 'barkaloww', 'arnabjghosh', 'mmeads12', 'marti578', 'connor9001', 'tpalcheck', 'bsemmens', 'mishra24', 'ahnaf.ryan.1', 'jmillerh', 'bhat.utsav', 'suzanne.bagnoli1', 'ryanspesard', 'dylanjmadden25', 'dhook93', 'ateays', 'btramme', 'nanderson', 'barker7', 'sotongnic', 'zhinz', 'suzannebagnoli']",1,[None],146,"['hackers', 'philitup5', 'genius9367', 'li1014', 'erynhorton32', 'xinyanglu', 'jam94jm', 'jtwirtz', 'sms2157', 'kreed321', 'zjuliot', 'b100curry', 'junha0214', 'shah153', 'rfinch', 'cbg888', 'jackie.shao21', 'nicksand84', 'elum', 'ktalathi', 'annaplatanos', 'mikeemejia81', 'alexbenson25', 'dsenpurdue', 'davis538', 'nkochhar01', 'cheng.chen.121772', 'jcgerber', 'jamesbob007', 'apehr', 'nkelner1991', 'aquirini', 'shijunzhespark', 'smitt', 'shubhankar.takle', 'luke.polster1', 'zhang767', 'neal27', 'kpm1669', 'catneff', 'jennifer.janusz.5', 'clarencechan0427', 'eck.justin', 'badenrel', 'xuzhenlei', 'johnhenry.fischer', 'bbornste', 'adharanipragada', 'silverfoxno10', 'forrestson', 'robbyc.stevens', 'bojun.song', 'dylan.simpson.832', 'huaiyuanli', 'workschool67', 'nasirbilal', 'tanktanhao1990', 'jbollard', 'dmills1028', 'jain107', 'delreajc', 'cyberg95', 'tarang.saxena.5', 'humphrey.ariel', 'mruggier', 'bwon56', 'lzc360448787', 'jpej', 'huangwendi0623', 'allan.calomino', 'rstemme4', 'yang488', 'likunlong1130', 'nitesh52', 'ziyan', 'ngducthanh99', 'gohwaikien2', 'mapolaya12', 'haynes0', 'parthsharda11', 'lchristl', 'jhoffine', 'saurabhsaboo14', 'adesalvo12', 'young192', 'ifrankpurdue.edu', 'nzabikh', 'tomohiro18', 'hpascoal', 'pggerber', 'joelschwallier', 'dandaman9753', 'little12', 'efun', 'crickelm', 'asif.alam.adi', 'rubioc', 'rtjahjon', 'rtrostle', 'cbunker', 'wbrumlev', 'kim19940509', 'smohler14', 'mert.karakaya.524', 'veer.p39', 'nathanw594', 'hansen56', 'kx', 'mfulwid', 'sander75', 'jordanm', 'low0', 'crawfo20', 'djsobs3', 'cindyq1200', 'bankole.adenrele', 'qmm7', 'sgranger112', 'mtzsbxx', 'yasinalaa', 'sstoddar13', 'dandichen0502', 'barkaloww', 'arnabjghosh', 'mmeads12', 'marti578', 'connor9001', 'tpalcheck', 'bsemmens', 'bruce6', 'mishra24', 'ahnaf.ryan.1', 'jmillerh', 'bhat.utsav', 'suzanne.bagnoli1', 'ryanspesard', 'dylanjmadden25', 'dhook93', 'ateays', 'btramme', None, 'nanderson', 'barker7', 'sotongnic', 'zhinz', 'suzannebagnoli']"
4,185,92,91,87,"['ssm5275', 'cmmiller67', 'neil.karmaker', 'rinkal23', 'efrock2', 'psuheyalong', 'nathankeilbart', 'dontagadson92', 'tyler.merica.15', 'jeff.kronz', 'baonanqi', 'mikewilkie', 'ras5763', 'williamferrell4', 'pmb5191', 'ama5801', 'rsweny33', 'jav5318', 'jawaher', 'landcarp', 'zetanpsu', 'tdh5096', 'shalinijr1993', 'eiw5060', 'mrahn', 'yww5270', 'jmanbaseball', 'yvl5323', 'zelong', 'jof5213', 'nss5132', 'zenger', 'nqb5128', 'jkopatz10', 'calebyoung26', 'jvm5700', 'excaliburorz', 'black.paulj', 'mingyuezhang93', 'yzz5174', 'jjf5345', 'sava.popovic.1993', 'ajc.constable', 'rsa5107', 'clc5537', 'hxn5042', 'sxa5283', 'zhouhn0413', 'mjb5893', 'rrh5100', 'lmr5491', 'sop5346', 'ppp5068', 'rws5608', 'tqd5098', 'ryan.romesberg.98', 'mls5686', 'wmi5002', 'svk5434', 'yyx5048', 'gt2199', 'sew5166', 'pnw5011', 'danshields1134', 'jfj5017', 'ryan.nigh', 'rav5132', 'rvw5155', 'owe5014', 'ram5798', 'hanna0993612', 'jmz5169', 'fon5018', 'alexhigh419', 'ajh5615', 'acs5538', 'nas5467', 'wchen117', 'h.bomb.rauchinator', 'controlad2', 'wpm5039', 'njc5188', 'rfs5115', 'pvs5183', 'bhwatson14', 'manicho11', 'yww5270123']",4,"['nigh36', 'nigh33', 'tul16', 'ljabbott']",4,"['xxm614', 'ccolina', None, 'mef231']",95,"['xxm614', 'ssm5275', 'cmmiller67', 'rinkal23', 'neil.karmaker', 'efrock2', 'psuheyalong', 'nathankeilbart', 'dontagadson92', 'tyler.merica.15', 'nigh33', 'jeff.kronz', 'baonanqi', 'mikewilkie', 'ras5763', 'williamferrell4', 'pmb5191', 'rsweny33', 'ama5801', 'jav5318', 'jawaher', 'mef231', 'landcarp', 'zetanpsu', 'tdh5096', 'shalinijr1993', 'eiw5060', 'mrahn', 'yww5270', 'jmanbaseball', 'yvl5323', 'zelong', 'jof5213', 'nss5132', 'zenger', 'nqb5128', 'jkopatz10', 'calebyoung26', 'jvm5700', 'excaliburorz', 'black.paulj', 'mingyuezhang93', 'yzz5174', 'jjf5345', 'ajc.constable', 'sava.popovic.1993', 'rsa5107', 'clc5537', 'hxn5042', 'sxa5283', 'zhouhn0413', 'mjb5893', 'rrh5100', 'lmr5491', 'sop5346', 'ppp5068', 'rws5608', 'tqd5098', 'ryan.romesberg.98', 'mls5686', 'wmi5002', 'svk5434', 'yyx5048', 'gt2199', 'sew5166', 'pnw5011', 'jfj5017', 'danshields1134', 'ryan.nigh', 'rav5132', 'rvw5155', 'owe5014', 'ram5798', 'ccolina', 'hanna0993612', 'jmz5169', 'fon5018', 'alexhigh419', 'ajh5615', 'acs5538', 'nas5467', 'nigh36', 'wchen117', 'ljabbott', 'h.bomb.rauchinator', 'controlad2', 'tul16', None, 'wpm5039', 'njc5188', 'rfs5115', 'pvs5183', 'bhwatson14', 'manicho11', 'yww5270123']"
4,186,92,56,46,"['mingyuezhang93', 'yzz5174', 'jfj5017', 'rav5132', 'rsweny33', 'jjf5345', 'neil.karmaker', 'cmmiller67', 'jav5318', 'ajc.constable', 'rvw5155', 'efrock2', 'ram5798', 'hxn5042', 'landcarp', 'black.paulj', 'sxa5283', 'tdh5096', 'zhouhn0413', 'sop5346', 'ppp5068', 'jmz5169', 'eiw5060', 'rws5608', 'mrahn', 'ryan.romesberg.98', 'yww5270', 'nas5467', 'wmi5002', 'controlad2', 'jmanbaseball', 'yvl5323', 'zelong', 'jof5213', 'jeff.kronz', 'zenger', 'yyx5048', 'jkopatz10', 'nqb5128', 'rfs5115', 'pvs5183', 'calebyoung26', 'manicho11', 'excaliburorz', 'danshields1134', 'pmb5191']",45,"['ssm5275', 'ryan.nigh', 'ama5801', 'sava.popovic.1993', 'rinkal23', 'rsa5107', 'owe5014', 'clc5537', 'jawaher', 'zetanpsu', 'psuheyalong', 'mjb5893', 'rrh5100', 'hanna0993612', 'lmr5491', 'fon5018', 'shalinijr1993', 'nathankeilbart', 'alexhigh419', 'tqd5098', 'ajh5615', 'mls5686', 'acs5538', 'dontagadson92', 'nigh36', 'wchen117', 'ljabbott', 'tyler.merica.15', 'h.bomb.rauchinator', 'svk5434', 'tul16', 'nss5132', 'wpm5039', 'njc5188', 'nigh33', 'baonanqi', 'gt2199', 'mikewilkie', 'sew5166', 'bhwatson14', 'jvm5700', 'ras5763', 'williamferrell4', 'pnw5011', 'yww5270123']",10,"['xxm614', 'pnw64000', 'yyz5263', 'a_hallway', 'sumant.sai', 'fatinazizi94', 'guizetan', 'whf4psu', None, 'rakan115']",101,"['mingyuezhang93', 'yzz5174', 'xxm614', 'ssm5275', 'jjf5345', 'cmmiller67', 'rinkal23', 'neil.karmaker', 'ajc.constable', 'sava.popovic.1993', 'guizetan', 'rsa5107', 'efrock2', 'yww5270123', 'clc5537', 'hxn5042', 'yyz5263', 'psuheyalong', 'sxa5283', 'zhouhn0413', 'mjb5893', 'rrh5100', 'lmr5491', 'sop5346', 'ppp5068', 'nathankeilbart', 'rws5608', 'tqd5098', 'ryan.romesberg.98', 'mls5686', 'dontagadson92', 'wmi5002', 'tyler.merica.15', 'svk5434', 'whf4psu', 'nigh33', 'jeff.kronz', 'sumant.sai', 'baonanqi', 'yyx5048', 'gt2199', 'mikewilkie', 'sew5166', 'ras5763', 'williamferrell4', 'pnw5011', 'jfj5017', 'pmb5191', 'danshields1134', 'pnw64000', 'ryan.nigh', 'rav5132', 'rsweny33', 'ama5801', 'jav5318', 'rvw5155', 'owe5014', 'ram5798', 'jawaher', 'landcarp', 'zetanpsu', 'tdh5096', 'fatinazizi94', 'hanna0993612', 'jmz5169', 'shalinijr1993', 'fon5018', 'eiw5060', 'alexhigh419', 'mrahn', 'rakan115', 'yww5270', 'ajh5615', 'acs5538', 'nas5467', 'nigh36', 'wchen117', 'ljabbott', 'h.bomb.rauchinator', 'controlad2', 'jmanbaseball', 'yvl5323', 'tul16', 'zelong', None, 'jof5213', 'nss5132', 'wpm5039', 'njc5188', 'a_hallway', 'zenger', 'nqb5128', 'jkopatz10', 'rfs5115', 'pvs5183', 'calebyoung26', 'bhwatson14', 'jvm5700', 'manicho11', 'excaliburorz', 'black.paulj']"
4,187,92,10,9,"['landcarp', 'sxa5283', 'zhouhn0413', 'mikewilkie', 'pvs5183', 'calebyoung26', 'shalinijr1993', 'clc5537', 'black.paulj']",82,"['mingyuezhang93', 'yzz5174', 'ssm5275', 'jjf5345', 'cmmiller67', 'rinkal23', 'neil.karmaker', 'ajc.constable', 'sava.popovic.1993', 'rsa5107', 'efrock2', 'yww5270123', 'hxn5042', 'psuheyalong', 'mjb5893', 'rrh5100', 'lmr5491', 'sop5346', 'ppp5068', 'nathankeilbart', 'rws5608', 'tqd5098', 'ryan.romesberg.98', 'mls5686', 'dontagadson92', 'wmi5002', 'tyler.merica.15', 'svk5434', 'nigh33', 'jeff.kronz', 'baonanqi', 'yyx5048', 'gt2199', 'sew5166', 'ras5763', 'williamferrell4', 'pnw5011', 'jfj5017', 'pmb5191', 'danshields1134', 'ryan.nigh', 'rav5132', 'rsweny33', 'ama5801', 'jav5318', 'rvw5155', 'owe5014', 'ram5798', 'jawaher', 'zetanpsu', 'tdh5096', 'hanna0993612', 'jmz5169', 'fon5018', 'eiw5060', 'alexhigh419', 'mrahn', 'yww5270', 'ajh5615', 'acs5538', 'nas5467', 'nigh36', 'wchen117', 'ljabbott', 'h.bomb.rauchinator', 'controlad2', 'jmanbaseball', 'yvl5323', 'tul16', 'zelong', 'jof5213', 'nss5132', 'wpm5039', 'njc5188', 'zenger', 'nqb5128', 'jkopatz10', 'rfs5115', 'bhwatson14', 'jvm5700', 'manicho11', 'excaliburorz']",1,[None],92,"['mingyuezhang93', 'yzz5174', 'ssm5275', 'jjf5345', 'cmmiller67', 'rinkal23', 'neil.karmaker', 'ajc.constable', 'sava.popovic.1993', 'rsa5107', 'efrock2', 'yww5270123', 'clc5537', 'hxn5042', 'psuheyalong', 'sxa5283', 'zhouhn0413', 'mjb5893', 'rrh5100', 'lmr5491', 'sop5346', 'ppp5068', 'nathankeilbart', 'rws5608', 'tqd5098', 'ryan.romesberg.98', 'mls5686', 'dontagadson92', 'wmi5002', 'tyler.merica.15', 'svk5434', 'nigh33', 'jeff.kronz', 'baonanqi', 'yyx5048', 'gt2199', 'mikewilkie', 'sew5166', 'ras5763', 'williamferrell4', 'pnw5011', 'jfj5017', 'pmb5191', 'danshields1134', 'ryan.nigh', 'rav5132', 'rsweny33', 'ama5801', 'jav5318', 'rvw5155', 'owe5014', 'ram5798', 'jawaher', 'landcarp', 'zetanpsu', 'tdh5096', 'hanna0993612', 'jmz5169', 'shalinijr1993', 'fon5018', 'eiw5060', 'alexhigh419', 'mrahn', 'yww5270', 'ajh5615', 'acs5538', 'nas5467', 'nigh36', 'wchen117', 'ljabbott', 'h.bomb.rauchinator', 'controlad2', 'jmanbaseball', 'yvl5323', 'tul16', 'zelong', None, 'jof5213', 'nss5132', 'wpm5039', 'njc5188', 'zenger', 'nqb5128', 'jkopatz10', 'rfs5115', 'pvs5183', 'calebyoung26', 'bhwatson14', 'jvm5700', 'manicho11', 'excaliburorz', 'black.paulj']"
5,219,84,171,8,"['jmmille6', 'mrhennek', 'julia.zuo', 'jtcohen2', 'lfirpo', 'cledesma2331', 'csbaile2', 'knipfer2']",75,"['spshah6', 'hlai7', 'antony.huang.129', 'amango4', 'aniruddhshivram', 'mcheng94', 'achoi121', 'ruining2', 'mantianxue0101', 'simpkns2', 'billli1996', 'cory93', 'remlevin', 'xiasang2', 'bhanley2', 'dman5505', 'yyang132', 'ryba.konrad', 'pbhatta2', 'bpgolfguy92', 'grober.dan', 'eprzyby2', 'cullenglasgow', 'ntxuby', 'mkbaile2', 'melissagoetter', 'hmwu2', 'tjweber2', 'tara.cullerton', 'elin11', 'sarahresarf', 'jjiang14', 'dmcgovern88', 'hmtaylo2', 'allysonv10', 'lbward93', 'hylin2', 'isaacehoffman2', 'gvelard2edu', 'janeyoo34', 'dkwok2', 'jiechen94', 'hsp6634', 'zhensun5', 'dagapit2', 'qiujiezhao1994', 'kjcsport1', 'bcclanc2', 'myeoh2', 'scpiper2', 'ntsherm2', 'jefrin', 'dwchris2', 'masiyi9406', 'curtis.c.baker', 'yoo66', 'meher.bharucha', 'klwells2', 'dlitt2', 'spmurra2', 'kfeng', 'beng3', 'jacobcamp1', 'carolgu2', 'lolipopcarolwang', 'sho1123', 'earthy', 'ahli2', 'faizal2', 'hank.liu.180', 'palchec2', 'anna.mast2', 'jake.kornacker', 'dyoon11', 'werkkdy2']",163,"['rlmcdon2', 'yarrama2', 'aklaas2', 'boisver2', 'kote.deepa', 'andrewhowell', 'hzh631038469', 'pvuong3', 'peterwu2', 'nanohub77', 'vigneshka', 'yjiang71', 'ryanc', 'rdatta2', 'stanley0010703', 'rahul.bhatia.k', 'jochoe1', 'xxchriskimxx', 'mrloube2', 'svemulapati', 'tapeterson2', 'wonho.chungy', 'hjko0107', 'li160', 'pablorosas', 'dyangsteven', 'sauronalexander', 'wyattsmcall1', 'paulmis2', 'mkersten', 'psroy2', 'langas2', 'mattfedd', 'pramesh2', 'njalexa2', 'jfoyer2', 'han109', 'rishychacko', 'gabriel.su.7', 'kwh1210', 'deepakcmani', 'jp199275', 'lin.joanna.y', 'rodrig67', 'shuoliu3', 'ysheng5', 'shmeeel', 'drennan1', 'kkoppula2', 'titusfong', 'michael.gao1', 'sataylor8', 'kakaxizhixin', 'sheelshah22', 'sulaimn2', 'minsu.yu', 'dalong2', 'sid.muthal', 'skong10', 'mohsaad', 'bababu', 'dtaylo21', 'cyim2', 'prashramani12', 'saurav.puri', 'yizhu3', 'didizuibang', 'cmschuetz', 'xiaozhouas', 'jtolin2', 'eya369', 'bluewaves3141', 'coleymei', 'jkravitz61', 'hhkkkxxx133', 'lpfung2', 'iseri2', 'jchardy2', 'renagade4', 'sam.chuanxie', 'kloseliebej', 'jake.didier', 'icetree', 'ozoude2', 'intae12', 'rshah82', 'eli.longbottom', 'fhismail', 'aabi10', 'melissacrawford396', 'bob.kummerer', 'adatia1', 'mjtomei', 'joseibert93', 'siddharth.bidasaria', 'coolcristobal', 'yfang12', 'avandorn1', 'jaber2', 'lingyi.kong.5', 'haller2', 'cookie.green.7798', 'wang.xiaohao.3', 'ashah13', 'jbrown76', 'dgardne2', 'obrzutkevin', 'frostybeverages', 'wratner', 'romanomatthew23', 'balsaofthespear', 'pschmid28', 'abhimanyu.khandelwal', 'cgooding1', 'akagti2', 'janewjp501', 'fliu14', 'ojoya24', 'shravan.gupta', 'hpark90', 'june', 'rstang2', 'cychan3', 'sxu32', 'jagraha2', 'kaaere94', 'jjleigh2', 'ablandi2', 'andrumar10', 'ammartn3', 'vbahl2', 'lcheng12', 'matteo.hoch.1', 'jdolins2', 'tjroger2', 'samdawg', 'eperbohner', 'nbruck2', 'cmao3', 'thexcguy', 'gregorlax37', 'eric.ayala2', 'jmxscrs', 'ducharm2', 'keward3', 'lucas.liu.3367', 'tkao4', 'luminoussky07', 'afscg', 'icyroderick', 'dpapanicolas', 'gsharma80', 'vinjamu2', 'kenned45', 'salman2', 'caily1995', 'koliva2', 'jesse.w.gunderson', 'pandabrewski2', 'bhjhnsn2', 'd82232004', 'chenxid', 'marjorie.dallmann']",246,"['amango4', 'aniruddhshivram', 'rlmcdon2', 'achoi121', 'yarrama2', 'boisver2', 'aklaas2', 'kote.deepa', 'andrewhowell', 'hzh631038469', 'pvuong3', 'peterwu2', 'nanohub77', 'vigneshka', 'cullenglasgow', 'yjiang71', 'ryanc', 'rdatta2', 'stanley0010703', 'rahul.bhatia.k', 'sarahresarf', 'jjiang14', 'dmcgovern88', 'jochoe1', 'xxchriskimxx', 'lbward93', 'mrloube2', 'svemulapati', 'janeyoo34', 'tapeterson2', 'bcclanc2', 'wonho.chungy', 'hjko0107', 'li160', 'pablorosas', 'dyangsteven', 'masiyi9406', 'sauronalexander', 'jmmille6', 'dlitt2', 'mrhennek', 'beng3', 'wyattsmcall1', 'lolipopcarolwang', 'paulmis2', 'earthy', 'mkersten', 'faizal2', 'palchec2', 'psroy2', 'langas2', 'hlai7', 'antony.huang.129', 'mcheng94', 'ruining2', 'mattfedd', 'mantianxue0101', 'pramesh2', 'bhanley2', 'lfirpo', 'njalexa2', 'dman5505', 'csbaile2', 'yyang132', 'jfoyer2', 'pbhatta2', 'han109', 'rishychacko', 'gabriel.su.7', 'bpgolfguy92', 'kwh1210', 'eprzyby2', 'deepakcmani', 'mkbaile2', 'jp199275', 'hmwu2', 'lin.joanna.y', 'elin11', 'rodrig67', 'shuoliu3', 'ysheng5', 'shmeeel', 'drennan1', 'gvelard2edu', 'jiechen94', 'kkoppula2', 'titusfong', 'dagapit2', 'michael.gao1', 'sataylor8', 'kakaxizhixin', 'sheelshah22', 'sulaimn2', 'ntsherm2', 'jefrin', 'minsu.yu', 'dalong2', 'dwchris2', 'sid.muthal', 'yoo66', 'meher.bharucha', 'klwells2', 'skong10', 'mohsaad', 'bababu', 'dtaylo21', 'cyim2', 'prashramani12', 'saurav.puri', 'sho1123', 'anna.mast2', 'dyoon11', 'didizuibang', 'yizhu3', 'cmschuetz', 'spshah6', 'xiaozhouas', 'simpkns2', 'jtolin2', 'billli1996', 'eya369', 'bluewaves3141', 'coleymei', 'jkravitz61', 'hhkkkxxx133', 'lpfung2', 'cory93', 'remlevin', 'iseri2', 'jchardy2', 'renagade4', 'sam.chuanxie', 'kloseliebej', 'jake.didier', 'icetree', 'ozoude2', 'intae12', 'rshah82', 'eli.longbottom', 'fhismail', 'aabi10', 'tjweber2', 'melissacrawford396', 'bob.kummerer', 'adatia1', 'mjtomei', 'chenxid', 'hmtaylo2', 'joseibert93', 'siddharth.bidasaria', 'coolcristobal', 'hylin2', 'isaacehoffman2', 'yfang12', 'dkwok2', 'avandorn1', 'jaber2', 'hsp6634', 'julia.zuo', 'lingyi.kong.5', 'zhensun5', 'haller2', 'cookie.green.7798', 'wang.xiaohao.3', 'myeoh2', 'cledesma2331', 'ashah13', 'jbrown76', 'dgardne2', 'obrzutkevin', 'frostybeverages', 'wratner', 'spmurra2', 'romanomatthew23', 'kfeng', 'jacobcamp1', 'carolgu2', 'balsaofthespear', 'pschmid28', 'abhimanyu.khandelwal', 'jake.kornacker', 'cgooding1', 'akagti2', 'janewjp501', 'fliu14', 'ojoya24', 'shravan.gupta', 'hpark90', 'june', 'xiasang2', 'rstang2', 'cychan3', 'sxu32', 'jagraha2', 'kaaere94', 'jjleigh2', 'ablandi2', 'ryba.konrad', 'andrumar10', 'ammartn3', 'vbahl2', 'lcheng12', 'grober.dan', 'matteo.hoch.1', 'ntxuby', 'melissagoetter', 'jdolins2', 'tjroger2', 'samdawg', 'eperbohner', 'tara.cullerton', 'nbruck2', 'cmao3', 'allysonv10', 'thexcguy', 'gregorlax37', 'eric.ayala2', 'jmxscrs', 'qiujiezhao1994', 'ducharm2', 'kjcsport1', 'keward3', 'lucas.liu.3367', 'scpiper2', 'tkao4', 'luminoussky07', 'afscg', 'icyroderick', 'dpapanicolas', 'gsharma80', 'vinjamu2', 'curtis.c.baker', 'kenned45', 'salman2', 'caily1995', 'koliva2', 'jtcohen2', 'ahli2', 'jesse.w.gunderson', 'pandabrewski2', 'hank.liu.180', 'bhjhnsn2', 'd82232004', 'werkkdy2', 'knipfer2', 'marjorie.dallmann']"
5,70,84,113,77,"['amango4', 'aniruddhshivram', 'achoi121', 'cullenglasgow', 'sarahresarf', 'jjiang14', 'dmcgovern88', 'lbward93', 'janeyoo34', 'bcclanc2', 'masiyi9406', 'jmmille6', 'mrhennek', 'beng3', 'lolipopcarolwang', 'earthy', 'faizal2', 'palchec2', 'hlai7', 'antony.huang.129', 'mcheng94', 'ruining2', 'mantianxue0101', 'bhanley2', 'lfirpo', 'dman5505', 'csbaile2', 'yyang132', 'pbhatta2', 'bpgolfguy92', 'eprzyby2', 'mkbaile2', 'elin11', 'gvelard2edu', 'jiechen94', 'dagapit2', 'ntsherm2', 'jefrin', 'dwchris2', 'yoo66', 'meher.bharucha', 'klwells2', 'sho1123', 'anna.mast2', 'dyoon11', 'spshah6', 'simpkns2', 'billli1996', 'cory93', 'remlevin', 'tjweber2', 'hmtaylo2', 'hylin2', 'isaacehoffman2', 'dkwok2', 'zhensun5', 'myeoh2', 'cledesma2331', 'spmurra2', 'kfeng', 'jacobcamp1', 'carolgu2', 'jake.kornacker', 'xiasang2', 'grober.dan', 'ntxuby', 'melissagoetter', 'tara.cullerton', 'allysonv10', 'qiujiezhao1994', 'kjcsport1', 'scpiper2', 'curtis.c.baker', 'jtcohen2', 'ahli2', 'werkkdy2', 'knipfer2']",6,"['dlitt2', 'hsp6634', 'julia.zuo', 'hmwu2', 'hank.liu.180', 'ryba.konrad']",36,"['wiieat.chen', 'chong.gu.5', 'abaddon2mist', 'jwang182', 'kote.deepa', 'adsnyde2', 'jiechen.wang7', 'yyang100', 'sguo12', 'billli1997', 'yitaohuangnb', 'seanxyy0914', 'hankliu00', 'yyang10', 'a_kuzni2', 'wlarson2', 'slee342', 'firpo2', 'vivianzry92', 'jmanand2', 'lee895', 'will.j.mccracken', 'dustin1', 'a.schleife', 'dpapanicolas', 'gsharma80', None, 'asimha2', 'salman2', 'qazyyc93', 'schiavo1', 'toujours.meiling93', 'padget1', 'me1291441', 'sage', 'junpeng.qiu']",119,"['amango4', 'aniruddhshivram', 'chong.gu.5', 'achoi121', 'kote.deepa', 'jiechen.wang7', 'cullenglasgow', 'yitaohuangnb', 'sarahresarf', 'jjiang14', 'dmcgovern88', 'yyang10', 'lbward93', 'janeyoo34', 'firpo2', 'jmanand2', 'bcclanc2', 'masiyi9406', 'jmmille6', 'dlitt2', 'mrhennek', 'beng3', 'lolipopcarolwang', 'earthy', 'faizal2', 'palchec2', 'sage', 'hlai7', 'antony.huang.129', 'mcheng94', 'ruining2', 'wiieat.chen', 'abaddon2mist', 'mantianxue0101', 'bhanley2', 'lfirpo', 'dman5505', 'csbaile2', 'yyang132', 'pbhatta2', 'bpgolfguy92', 'eprzyby2', 'mkbaile2', 'hmwu2', 'elin11', 'gvelard2edu', 'jiechen94', 'dagapit2', 'will.j.mccracken', 'ntsherm2', 'jefrin', 'dwchris2', 'asimha2', 'yoo66', 'meher.bharucha', 'klwells2', 'sho1123', 'qazyyc93', 'toujours.meiling93', 'anna.mast2', 'junpeng.qiu', 'dyoon11', 'spshah6', 'simpkns2', 'billli1996', 'cory93', 'remlevin', 'adsnyde2', 'tjweber2', 'seanxyy0914', 'hmtaylo2', 'hankliu00', 'hylin2', 'isaacehoffman2', 'dkwok2', 'hsp6634', 'julia.zuo', 'vivianzry92', 'zhensun5', 'lee895', 'myeoh2', 'dustin1', 'a.schleife', 'cledesma2331', 'spmurra2', 'kfeng', 'jacobcamp1', 'carolgu2', 'padget1', 'jake.kornacker', 'xiasang2', 'jwang182', 'ryba.konrad', 'yyang100', 'grober.dan', 'sguo12', 'ntxuby', 'melissagoetter', 'tara.cullerton', 'billli1997', 'allysonv10', 'a_kuzni2', 'wlarson2', 'slee342', 'qiujiezhao1994', 'kjcsport1', 'scpiper2', 'dpapanicolas', 'gsharma80', None, 'curtis.c.baker', 'salman2', 'jtcohen2', 'ahli2', 'schiavo1', 'me1291441', 'hank.liu.180', 'werkkdy2', 'knipfer2']"
5,153,84,100,16,"['melissagoetter', 'grober.dan', 'mcheng94', 'antony.huang.129', 'dlitt2', 'cullenglasgow', 'beng3', 'ruining2', 'mantianxue0101', 'julia.zuo', 'zhensun5', 'sho1123', 'jacobcamp1', 'ntxuby', 'jefrin', 'dman5505']",67,"['spshah6', 'hlai7', 'simpkns2', 'amango4', 'aniruddhshivram', 'billli1996', 'achoi121', 'xiasang2', 'cory93', 'remlevin', 'bhanley2', 'lfirpo', 'csbaile2', 'yyang132', 'ryba.konrad', 'pbhatta2', 'bpgolfguy92', 'eprzyby2', 'mkbaile2', 'hmwu2', 'tjweber2', 'tara.cullerton', 'elin11', 'sarahresarf', 'jjiang14', 'dmcgovern88', 'hmtaylo2', 'allysonv10', 'lbward93', 'hylin2', 'isaacehoffman2', 'gvelard2edu', 'janeyoo34', 'dkwok2', 'jiechen94', 'hsp6634', 'qiujiezhao1994', 'dagapit2', 'kjcsport1', 'bcclanc2', 'myeoh2', 'scpiper2', 'ntsherm2', 'cledesma2331', 'dwchris2', 'masiyi9406', 'curtis.c.baker', 'yoo66', 'jmmille6', 'meher.bharucha', 'klwells2', 'mrhennek', 'spmurra2', 'kfeng', 'jtcohen2', 'carolgu2', 'lolipopcarolwang', 'ahli2', 'earthy', 'faizal2', 'hank.liu.180', 'palchec2', 'anna.mast2', 'jake.kornacker', 'dyoon11', 'werkkdy2', 'knipfer2']",84,"['yliu181', 'zwu27', 'dkuai2', 'sdschmi2', 'avelard2', 'hmajith2', 'cwojtan', 'cgu8', 'dli29', 'clopes2', 'frankkelly47', 'reisber2', 'adam.brown.39395033', 'pokhym', 'prandle2', 'qinglin2', 'sdhanak1', 'samsrajer', 'njamali2', 'jkim561', 'stephanieh', 'pierce.randle', 'zhoffm', 'hhardin2', 'jonathan.lin.773', 'rishychacko', 'deepakcmani', 'nocyama', 'pakelti2', 'mingye.gao', 'bshen9', 'kregel2', 'mchu5', 'buhl2', 'amber.snil', 'shenxinrusue', 'asimha2', 'dshi10', 'kagebei2', 'chunxu2', 'jaikarnik95', 'statar2', 'emfoley14', 'mlandi6', 'ecyoung', 'mpunuk', 'gracepakeltis', 'ywada3', 'jedrals2', 'myang39', 'nlee17', 'alvinlvalysa', 'slbecke2', 'laurentaylor', 'ndunlap2', 'talee3', 'shirley123xiong', 'jylin4', 'khuang31', 'szhang87', 'yyao13', 'lachwsk2', 'dchlebek2', 'warpins2', '17staru', 'gooneti2', 'zhanshi', 'crosent2', 'a_kuzni2', 'tianshu2', 'shoppe2', 'naveedjamali7', 'hzhou30', 'dpapanicolas', 'gsharma80', None, 'adiassasino', 'ajwisni2', 'ed.tir.1', 'eaallen', 'schiavo1', 'me1291441', 'sali12', 'whu14']",167,"['yliu181', 'amango4', 'aniruddhshivram', 'achoi121', 'zwu27', 'dkuai2', 'sdschmi2', 'avelard2', 'hmajith2', 'cullenglasgow', 'cwojtan', 'cgu8', 'dli29', 'sarahresarf', 'jjiang14', 'dmcgovern88', 'clopes2', 'frankkelly47', 'lbward93', 'janeyoo34', 'reisber2', 'bcclanc2', 'adam.brown.39395033', 'masiyi9406', 'prandle2', 'pokhym', 'jmmille6', 'qinglin2', 'sdhanak1', 'dlitt2', 'mrhennek', 'beng3', 'lolipopcarolwang', 'earthy', 'faizal2', 'palchec2', 'samsrajer', 'njamali2', 'stephanieh', 'jkim561', 'pierce.randle', 'hlai7', 'antony.huang.129', 'mcheng94', 'ruining2', 'zhoffm', 'mantianxue0101', 'hhardin2', 'jonathan.lin.773', 'bhanley2', 'lfirpo', 'dman5505', 'csbaile2', 'yyang132', 'rishychacko', 'pbhatta2', 'bpgolfguy92', 'eprzyby2', 'deepakcmani', 'mkbaile2', 'hmwu2', 'nocyama', 'elin11', 'pakelti2', 'gvelard2edu', 'jiechen94', 'mingye.gao', 'dagapit2', 'bshen9', 'kregel2', 'ntsherm2', 'jefrin', 'mchu5', 'buhl2', 'amber.snil', 'dwchris2', 'shenxinrusue', 'asimha2', 'yoo66', 'meher.bharucha', 'klwells2', 'dshi10', 'sho1123', 'kagebei2', 'anna.mast2', 'dyoon11', 'chunxu2', 'spshah6', 'simpkns2', 'billli1996', 'cory93', 'remlevin', 'jaikarnik95', 'statar2', 'emfoley14', 'mlandi6', 'ecyoung', 'mpunuk', 'gracepakeltis', 'tjweber2', 'ywada3', 'jedrals2', 'hmtaylo2', 'hylin2', 'isaacehoffman2', 'myang39', 'dkwok2', 'hsp6634', 'julia.zuo', 'nlee17', 'zhensun5', 'alvinlvalysa', 'slbecke2', 'laurentaylor', 'ndunlap2', 'myeoh2', 'talee3', 'cledesma2331', 'spmurra2', 'kfeng', 'jacobcamp1', 'carolgu2', 'shirley123xiong', 'jylin4', 'khuang31', 'jake.kornacker', 'szhang87', 'yyao13', 'lachwsk2', 'dchlebek2', 'xiasang2', 'warpins2', '17staru', 'gooneti2', 'zhanshi', 'ryba.konrad', 'crosent2', 'grober.dan', 'ntxuby', 'melissagoetter', 'tara.cullerton', 'allysonv10', 'a_kuzni2', 'tianshu2', 'shoppe2', 'naveedjamali7', 'hzhou30', 'qiujiezhao1994', 'kjcsport1', 'scpiper2', 'dpapanicolas', 'gsharma80', None, 'curtis.c.baker', 'adiassasino', 'ajwisni2', 'ed.tir.1', 'jtcohen2', 'ahli2', 'eaallen', 'schiavo1', 'me1291441', 'sali12', 'hank.liu.180', 'whu14', 'werkkdy2', 'knipfer2']"
5,11,84,78,66,"['spshah6', 'amango4', 'ruining2', 'billli1996', 'achoi121', 'mantianxue0101', 'xiasang2', 'cory93', 'remlevin', 'lfirpo', 'dman5505', 'yyang132', 'csbaile2', 'ryba.konrad', 'pbhatta2', 'bpgolfguy92', 'grober.dan', 'eprzyby2', 'cullenglasgow', 'ntxuby', 'mkbaile2', 'melissagoetter', 'tjweber2', 'tara.cullerton', 'sarahresarf', 'jjiang14', 'hmtaylo2', 'allysonv10', 'lbward93', 'isaacehoffman2', 'hylin2', 'gvelard2edu', 'janeyoo34', 'dkwok2', 'jiechen94', 'julia.zuo', 'dagapit2', 'kjcsport1', 'myeoh2', 'scpiper2', 'ntsherm2', 'jefrin', 'cledesma2331', 'dwchris2', 'masiyi9406', 'curtis.c.baker', 'jmmille6', 'meher.bharucha', 'klwells2', 'mrhennek', 'dlitt2', 'spmurra2', 'beng3', 'kfeng', 'jtcohen2', 'carolgu2', 'lolipopcarolwang', 'sho1123', 'earthy', 'ahli2', 'hank.liu.180', 'palchec2', 'anna.mast2', 'jake.kornacker', 'werkkdy2', 'knipfer2']",17,"['yoo66', 'hlai7', 'antony.huang.129', 'mcheng94', 'aniruddhshivram', 'simpkns2', 'hsp6634', 'hmwu2', 'zhensun5', 'jacobcamp1', 'qiujiezhao1994', 'bcclanc2', 'elin11', 'dmcgovern88', 'faizal2', 'bhanley2', 'dyoon11']",12,"['kahill2', 'wlarson2', 'wem5637', 'xli121', 'angelaxbaby93', 'kote.deepa', 'mikeandike5374', 'jeremy.chew', 'ajgordon', 'yyang10', 'me1291441', None]",95,"['amango4', 'aniruddhshivram', 'achoi121', 'kote.deepa', 'cullenglasgow', 'sarahresarf', 'jjiang14', 'dmcgovern88', 'yyang10', 'lbward93', 'janeyoo34', 'bcclanc2', 'masiyi9406', 'jmmille6', 'dlitt2', 'mrhennek', 'beng3', 'lolipopcarolwang', 'earthy', 'xli121', 'faizal2', 'palchec2', 'hlai7', 'antony.huang.129', 'mcheng94', 'ruining2', 'mantianxue0101', 'bhanley2', 'lfirpo', 'dman5505', 'csbaile2', 'yyang132', 'pbhatta2', 'bpgolfguy92', 'eprzyby2', 'mkbaile2', 'hmwu2', 'elin11', 'gvelard2edu', 'jiechen94', 'dagapit2', 'jeremy.chew', 'ntsherm2', 'jefrin', 'dwchris2', 'yoo66', 'meher.bharucha', 'klwells2', 'sho1123', 'anna.mast2', 'dyoon11', 'spshah6', 'simpkns2', 'billli1996', 'cory93', 'remlevin', 'tjweber2', 'angelaxbaby93', 'hmtaylo2', 'hylin2', 'isaacehoffman2', 'dkwok2', 'kahill2', 'hsp6634', 'julia.zuo', 'zhensun5', 'mikeandike5374', 'myeoh2', 'cledesma2331', 'spmurra2', 'kfeng', 'jacobcamp1', 'carolgu2', 'jake.kornacker', 'xiasang2', 'wem5637', 'ryba.konrad', 'grober.dan', 'ntxuby', 'melissagoetter', 'tara.cullerton', 'allysonv10', 'ajgordon', 'wlarson2', 'qiujiezhao1994', 'kjcsport1', 'scpiper2', None, 'curtis.c.baker', 'jtcohen2', 'ahli2', 'me1291441', 'hank.liu.180', 'werkkdy2', 'knipfer2']"
5,37,84,40,2,"['csbaile2', 'mrhennek']",81,"['amango4', 'aniruddhshivram', 'achoi121', 'cullenglasgow', 'sarahresarf', 'jjiang14', 'dmcgovern88', 'lbward93', 'janeyoo34', 'bcclanc2', 'masiyi9406', 'jmmille6', 'dlitt2', 'beng3', 'lolipopcarolwang', 'earthy', 'faizal2', 'palchec2', 'hlai7', 'antony.huang.129', 'mcheng94', 'ruining2', 'mantianxue0101', 'bhanley2', 'lfirpo', 'dman5505', 'yyang132', 'pbhatta2', 'bpgolfguy92', 'eprzyby2', 'mkbaile2', 'hmwu2', 'elin11', 'gvelard2edu', 'jiechen94', 'dagapit2', 'ntsherm2', 'jefrin', 'dwchris2', 'yoo66', 'meher.bharucha', 'klwells2', 'sho1123', 'anna.mast2', 'dyoon11', 'spshah6', 'simpkns2', 'billli1996', 'cory93', 'remlevin', 'tjweber2', 'hmtaylo2', 'hylin2', 'isaacehoffman2', 'dkwok2', 'hsp6634', 'julia.zuo', 'zhensun5', 'myeoh2', 'cledesma2331', 'spmurra2', 'kfeng', 'jacobcamp1', 'carolgu2', 'jake.kornacker', 'xiasang2', 'ryba.konrad', 'grober.dan', 'ntxuby', 'melissagoetter', 'tara.cullerton', 'allysonv10', 'qiujiezhao1994', 'kjcsport1', 'scpiper2', 'curtis.c.baker', 'jtcohen2', 'ahli2', 'hank.liu.180', 'werkkdy2', 'knipfer2']",38,"['janewjp501', 'xiaozhouas', 'hhkkkxxx133', 'eya369', 'june', 'coleymei', 'rlmcdon2', 'aklaas2', 'cychan3', 'kote.deepa', 'dvnguye2', 'gomezsa2', 'rishychacko', 'jfoyer2', 'andrumar10', 'lcheng12', 'matteo.hoch.1', 'aabi10', 'fhismail', 'lin.joanna.y', 'shuoliu3', 'mrloube2', 'thexcguy', 'drennan1', 'coolcristobal', 'avandorn1', 'jmxscrs', 'wang.xiaohao.3', 'minsu.yu', 'dpapanicolas', 'dalong2', None, 'jbrown76', 'bababu', 'wyattsmcall1', 'prashramani12', 'd82232004', 'marjorie.dallmann']",121,"['spshah6', 'xiaozhouas', 'simpkns2', 'amango4', 'aniruddhshivram', 'billli1996', 'achoi121', 'hhkkkxxx133', 'eya369', 'coleymei', 'rlmcdon2', 'cory93', 'remlevin', 'aklaas2', 'kote.deepa', 'cullenglasgow', 'aabi10', 'fhismail', 'tjweber2', 'sarahresarf', 'jjiang14', 'dmcgovern88', 'hmtaylo2', 'lbward93', 'mrloube2', 'coolcristobal', 'hylin2', 'isaacehoffman2', 'janeyoo34', 'dkwok2', 'avandorn1', 'hsp6634', 'julia.zuo', 'zhensun5', 'bcclanc2', 'wang.xiaohao.3', 'myeoh2', 'cledesma2331', 'masiyi9406', 'jbrown76', 'jmmille6', 'dlitt2', 'mrhennek', 'spmurra2', 'beng3', 'kfeng', 'jacobcamp1', 'carolgu2', 'wyattsmcall1', 'lolipopcarolwang', 'earthy', 'faizal2', 'palchec2', 'jake.kornacker', 'janewjp501', 'hlai7', 'antony.huang.129', 'mcheng94', 'ruining2', 'june', 'xiasang2', 'mantianxue0101', 'cychan3', 'bhanley2', 'lfirpo', 'dvnguye2', 'dman5505', 'csbaile2', 'yyang132', 'ryba.konrad', 'gomezsa2', 'pbhatta2', 'jfoyer2', 'rishychacko', 'andrumar10', 'lcheng12', 'bpgolfguy92', 'grober.dan', 'eprzyby2', 'ntxuby', 'melissagoetter', 'mkbaile2', 'matteo.hoch.1', 'hmwu2', 'tara.cullerton', 'lin.joanna.y', 'elin11', 'allysonv10', 'shuoliu3', 'thexcguy', 'drennan1', 'gvelard2edu', 'jiechen94', 'jmxscrs', 'qiujiezhao1994', 'dagapit2', 'kjcsport1', 'scpiper2', 'ntsherm2', 'jefrin', 'minsu.yu', 'dpapanicolas', 'dalong2', 'dwchris2', None, 'curtis.c.baker', 'yoo66', 'meher.bharucha', 'klwells2', 'bababu', 'prashramani12', 'jtcohen2', 'sho1123', 'ahli2', 'hank.liu.180', 'anna.mast2', 'd82232004', 'dyoon11', 'werkkdy2', 'knipfer2', 'marjorie.dallmann']"
5,71,84,28,23,"['amango4', 'lfirpo', 'dman5505', 'csbaile2', 'ntxuby', 'melissagoetter', 'eprzyby2', 'mkbaile2', 'tjweber2', 'tara.cullerton', 'elin11', 'sarahresarf', 'jjiang14', 'hmtaylo2', 'janeyoo34', 'hsp6634', 'cledesma2331', 'dwchris2', 'masiyi9406', 'mrhennek', 'beng3', 'hank.liu.180', 'palchec2']",60,"['spshah6', 'hlai7', 'antony.huang.129', 'mcheng94', 'aniruddhshivram', 'ruining2', 'achoi121', 'mantianxue0101', 'simpkns2', 'billli1996', 'xiasang2', 'cory93', 'remlevin', 'bhanley2', 'yyang132', 'ryba.konrad', 'pbhatta2', 'bpgolfguy92', 'grober.dan', 'cullenglasgow', 'hmwu2', 'dmcgovern88', 'allysonv10', 'lbward93', 'hylin2', 'isaacehoffman2', 'gvelard2edu', 'dkwok2', 'jiechen94', 'julia.zuo', 'zhensun5', 'dagapit2', 'qiujiezhao1994', 'kjcsport1', 'bcclanc2', 'myeoh2', 'scpiper2', 'ntsherm2', 'jefrin', 'curtis.c.baker', 'yoo66', 'jmmille6', 'meher.bharucha', 'klwells2', 'dlitt2', 'spmurra2', 'kfeng', 'jacobcamp1', 'jtcohen2', 'carolgu2', 'lolipopcarolwang', 'sho1123', 'earthy', 'ahli2', 'faizal2', 'anna.mast2', 'jake.kornacker', 'dyoon11', 'werkkdy2', 'knipfer2']",5,"['vivianzry92', 'kevinchiou2019', 'kote.deepa', None, 'jcooney2']",88,"['spshah6', 'simpkns2', 'amango4', 'aniruddhshivram', 'billli1996', 'achoi121', 'cory93', 'remlevin', 'kote.deepa', 'cullenglasgow', 'tjweber2', 'sarahresarf', 'jjiang14', 'dmcgovern88', 'hmtaylo2', 'lbward93', 'hylin2', 'isaacehoffman2', 'janeyoo34', 'dkwok2', 'hsp6634', 'julia.zuo', 'vivianzry92', 'zhensun5', 'bcclanc2', 'myeoh2', 'cledesma2331', 'masiyi9406', 'jmmille6', 'dlitt2', 'mrhennek', 'spmurra2', 'beng3', 'kfeng', 'jacobcamp1', 'carolgu2', 'lolipopcarolwang', 'earthy', 'faizal2', 'palchec2', 'jake.kornacker', 'hlai7', 'antony.huang.129', 'mcheng94', 'ruining2', 'xiasang2', 'mantianxue0101', 'kevinchiou2019', 'bhanley2', 'lfirpo', 'dman5505', 'csbaile2', 'yyang132', 'ryba.konrad', 'pbhatta2', 'bpgolfguy92', 'grober.dan', 'eprzyby2', 'ntxuby', 'melissagoetter', 'mkbaile2', 'hmwu2', 'tara.cullerton', 'elin11', 'allysonv10', 'gvelard2edu', 'jiechen94', 'qiujiezhao1994', 'dagapit2', 'kjcsport1', 'scpiper2', 'ntsherm2', 'jefrin', 'dwchris2', None, 'jcooney2', 'curtis.c.baker', 'yoo66', 'meher.bharucha', 'klwells2', 'jtcohen2', 'sho1123', 'ahli2', 'hank.liu.180', 'anna.mast2', 'dyoon11', 'werkkdy2', 'knipfer2']"
5,72,84,15,9,"['jmmille6', 'spmurra2', 'dlitt2', 'julia.zuo', 'zhensun5', 'ahli2', 'bhanley2', 'anna.mast2', 'janeyoo34']",74,"['spshah6', 'simpkns2', 'amango4', 'aniruddhshivram', 'billli1996', 'achoi121', 'cory93', 'remlevin', 'cullenglasgow', 'tjweber2', 'sarahresarf', 'jjiang14', 'dmcgovern88', 'hmtaylo2', 'lbward93', 'hylin2', 'isaacehoffman2', 'dkwok2', 'hsp6634', 'bcclanc2', 'myeoh2', 'cledesma2331', 'masiyi9406', 'mrhennek', 'beng3', 'kfeng', 'jacobcamp1', 'carolgu2', 'lolipopcarolwang', 'earthy', 'faizal2', 'palchec2', 'jake.kornacker', 'hlai7', 'antony.huang.129', 'mcheng94', 'ruining2', 'xiasang2', 'mantianxue0101', 'lfirpo', 'dman5505', 'csbaile2', 'yyang132', 'ryba.konrad', 'pbhatta2', 'bpgolfguy92', 'grober.dan', 'eprzyby2', 'ntxuby', 'melissagoetter', 'mkbaile2', 'hmwu2', 'tara.cullerton', 'elin11', 'allysonv10', 'gvelard2edu', 'jiechen94', 'qiujiezhao1994', 'dagapit2', 'kjcsport1', 'scpiper2', 'ntsherm2', 'jefrin', 'dwchris2', 'curtis.c.baker', 'yoo66', 'meher.bharucha', 'klwells2', 'jtcohen2', 'sho1123', 'hank.liu.180', 'dyoon11', 'werkkdy2', 'knipfer2']",6,"['joonheekimk5', 'sikaufm2', 'abaddon2mist', 'xli121', 'a.schleife', None]",89,"['spshah6', 'simpkns2', 'amango4', 'aniruddhshivram', 'billli1996', 'achoi121', 'cory93', 'remlevin', 'cullenglasgow', 'tjweber2', 'sarahresarf', 'jjiang14', 'dmcgovern88', 'hmtaylo2', 'lbward93', 'hylin2', 'isaacehoffman2', 'janeyoo34', 'dkwok2', 'hsp6634', 'julia.zuo', 'zhensun5', 'bcclanc2', 'myeoh2', 'a.schleife', 'cledesma2331', 'masiyi9406', 'jmmille6', 'dlitt2', 'mrhennek', 'spmurra2', 'beng3', 'kfeng', 'jacobcamp1', 'carolgu2', 'lolipopcarolwang', 'earthy', 'xli121', 'faizal2', 'palchec2', 'jake.kornacker', 'hlai7', 'antony.huang.129', 'mcheng94', 'ruining2', 'xiasang2', 'mantianxue0101', 'abaddon2mist', 'bhanley2', 'lfirpo', 'dman5505', 'csbaile2', 'yyang132', 'ryba.konrad', 'pbhatta2', 'bpgolfguy92', 'grober.dan', 'eprzyby2', 'ntxuby', 'melissagoetter', 'mkbaile2', 'joonheekimk5', 'hmwu2', 'tara.cullerton', 'elin11', 'allysonv10', 'gvelard2edu', 'jiechen94', 'sikaufm2', 'qiujiezhao1994', 'dagapit2', 'kjcsport1', 'scpiper2', 'ntsherm2', 'jefrin', 'dwchris2', None, 'curtis.c.baker', 'yoo66', 'meher.bharucha', 'klwells2', 'jtcohen2', 'sho1123', 'ahli2', 'hank.liu.180', 'anna.mast2', 'dyoon11', 'werkkdy2', 'knipfer2']"
5,222,84,14,1,['julia.zuo'],82,"['spshah6', 'simpkns2', 'amango4', 'aniruddhshivram', 'billli1996', 'achoi121', 'cory93', 'remlevin', 'cullenglasgow', 'tjweber2', 'sarahresarf', 'jjiang14', 'dmcgovern88', 'hmtaylo2', 'lbward93', 'hylin2', 'isaacehoffman2', 'janeyoo34', 'dkwok2', 'hsp6634', 'zhensun5', 'bcclanc2', 'myeoh2', 'cledesma2331', 'masiyi9406', 'jmmille6', 'dlitt2', 'mrhennek', 'spmurra2', 'beng3', 'kfeng', 'jacobcamp1', 'carolgu2', 'lolipopcarolwang', 'earthy', 'faizal2', 'palchec2', 'jake.kornacker', 'hlai7', 'antony.huang.129', 'mcheng94', 'ruining2', 'xiasang2', 'mantianxue0101', 'bhanley2', 'lfirpo', 'dman5505', 'csbaile2', 'yyang132', 'ryba.konrad', 'pbhatta2', 'bpgolfguy92', 'grober.dan', 'eprzyby2', 'ntxuby', 'melissagoetter', 'mkbaile2', 'hmwu2', 'tara.cullerton', 'elin11', 'allysonv10', 'gvelard2edu', 'jiechen94', 'qiujiezhao1994', 'dagapit2', 'kjcsport1', 'scpiper2', 'ntsherm2', 'jefrin', 'dwchris2', 'curtis.c.baker', 'yoo66', 'meher.bharucha', 'klwells2', 'jtcohen2', 'sho1123', 'ahli2', 'hank.liu.180', 'anna.mast2', 'dyoon11', 'werkkdy2', 'knipfer2']",13,"['ychen361', 'zelun.luo', 'ramu2', 'zwidder', 'irtwiaos', 'maximumsam6', None, 'zerohp', 'magician03', 'aldave', 'ngpeter2', 'mgrawe', 'glink09']",96,"['spshah6', 'ramu2', 'simpkns2', 'amango4', 'aniruddhshivram', 'billli1996', 'achoi121', 'cory93', 'remlevin', 'magician03', 'ychen361', 'cullenglasgow', 'zwidder', 'tjweber2', 'sarahresarf', 'jjiang14', 'dmcgovern88', 'hmtaylo2', 'lbward93', 'mgrawe', 'hylin2', 'isaacehoffman2', 'janeyoo34', 'dkwok2', 'hsp6634', 'julia.zuo', 'zhensun5', 'maximumsam6', 'bcclanc2', 'myeoh2', 'cledesma2331', 'ngpeter2', 'masiyi9406', 'jmmille6', 'dlitt2', 'mrhennek', 'spmurra2', 'beng3', 'kfeng', 'jacobcamp1', 'carolgu2', 'lolipopcarolwang', 'zerohp', 'earthy', 'faizal2', 'palchec2', 'jake.kornacker', 'hlai7', 'antony.huang.129', 'mcheng94', 'ruining2', 'xiasang2', 'mantianxue0101', 'aldave', 'bhanley2', 'lfirpo', 'dman5505', 'csbaile2', 'yyang132', 'ryba.konrad', 'pbhatta2', 'bpgolfguy92', 'grober.dan', 'eprzyby2', 'ntxuby', 'melissagoetter', 'mkbaile2', 'hmwu2', 'irtwiaos', 'tara.cullerton', 'elin11', 'allysonv10', 'glink09', 'gvelard2edu', 'jiechen94', 'qiujiezhao1994', 'dagapit2', 'kjcsport1', 'scpiper2', 'ntsherm2', 'jefrin', 'dwchris2', None, 'curtis.c.baker', 'yoo66', 'meher.bharucha', 'klwells2', 'zelun.luo', 'jtcohen2', 'sho1123', 'ahli2', 'hank.liu.180', 'anna.mast2', 'dyoon11', 'werkkdy2', 'knipfer2']"
5,183,84,13,10,"['yoo66', 'antony.huang.129', 'simpkns2', 'jacobcamp1', 'aniruddhshivram', 'qiujiezhao1994', 'zhensun5', 'dmcgovern88', 'faizal2', 'dyoon11']",73,"['spshah6', 'amango4', 'billli1996', 'achoi121', 'cory93', 'remlevin', 'cullenglasgow', 'tjweber2', 'sarahresarf', 'jjiang14', 'hmtaylo2', 'lbward93', 'hylin2', 'isaacehoffman2', 'janeyoo34', 'dkwok2', 'hsp6634', 'julia.zuo', 'bcclanc2', 'myeoh2', 'cledesma2331', 'masiyi9406', 'jmmille6', 'dlitt2', 'mrhennek', 'spmurra2', 'beng3', 'kfeng', 'carolgu2', 'lolipopcarolwang', 'earthy', 'palchec2', 'jake.kornacker', 'hlai7', 'mcheng94', 'ruining2', 'xiasang2', 'mantianxue0101', 'bhanley2', 'lfirpo', 'dman5505', 'csbaile2', 'yyang132', 'ryba.konrad', 'pbhatta2', 'bpgolfguy92', 'grober.dan', 'eprzyby2', 'ntxuby', 'melissagoetter', 'mkbaile2', 'hmwu2', 'tara.cullerton', 'elin11', 'allysonv10', 'gvelard2edu', 'jiechen94', 'dagapit2', 'kjcsport1', 'scpiper2', 'ntsherm2', 'jefrin', 'dwchris2', 'curtis.c.baker', 'meher.bharucha', 'klwells2', 'jtcohen2', 'sho1123', 'ahli2', 'hank.liu.180', 'anna.mast2', 'werkkdy2', 'knipfer2']",3,"['a_kuzni2', None, 'gip0441']",86,"['spshah6', 'simpkns2', 'amango4', 'aniruddhshivram', 'billli1996', 'achoi121', 'cory93', 'remlevin', 'cullenglasgow', 'tjweber2', 'sarahresarf', 'jjiang14', 'dmcgovern88', 'hmtaylo2', 'lbward93', 'hylin2', 'isaacehoffman2', 'janeyoo34', 'dkwok2', 'hsp6634', 'julia.zuo', 'zhensun5', 'bcclanc2', 'myeoh2', 'cledesma2331', 'masiyi9406', 'jmmille6', 'dlitt2', 'mrhennek', 'spmurra2', 'beng3', 'kfeng', 'jacobcamp1', 'carolgu2', 'lolipopcarolwang', 'earthy', 'faizal2', 'palchec2', 'jake.kornacker', 'hlai7', 'antony.huang.129', 'mcheng94', 'ruining2', 'xiasang2', 'mantianxue0101', 'bhanley2', 'lfirpo', 'dman5505', 'csbaile2', 'yyang132', 'ryba.konrad', 'pbhatta2', 'bpgolfguy92', 'grober.dan', 'eprzyby2', 'ntxuby', 'melissagoetter', 'mkbaile2', 'hmwu2', 'tara.cullerton', 'elin11', 'allysonv10', 'a_kuzni2', 'gvelard2edu', 'jiechen94', 'qiujiezhao1994', 'dagapit2', 'kjcsport1', 'scpiper2', 'ntsherm2', 'jefrin', 'dwchris2', None, 'curtis.c.baker', 'yoo66', 'meher.bharucha', 'klwells2', 'gip0441', 'jtcohen2', 'sho1123', 'ahli2', 'hank.liu.180', 'anna.mast2', 'dyoon11', 'werkkdy2', 'knipfer2']"
5,12,84,7,6,"['hlai7', 'hsp6634', 'bcclanc2', 'elin11', 'hank.liu.180', 'anna.mast2']",77,"['spshah6', 'simpkns2', 'amango4', 'aniruddhshivram', 'billli1996', 'achoi121', 'cory93', 'remlevin', 'cullenglasgow', 'tjweber2', 'sarahresarf', 'jjiang14', 'dmcgovern88', 'hmtaylo2', 'lbward93', 'hylin2', 'isaacehoffman2', 'janeyoo34', 'dkwok2', 'julia.zuo', 'zhensun5', 'myeoh2', 'cledesma2331', 'masiyi9406', 'jmmille6', 'dlitt2', 'mrhennek', 'spmurra2', 'beng3', 'kfeng', 'jacobcamp1', 'carolgu2', 'lolipopcarolwang', 'earthy', 'faizal2', 'palchec2', 'jake.kornacker', 'antony.huang.129', 'mcheng94', 'ruining2', 'xiasang2', 'mantianxue0101', 'bhanley2', 'lfirpo', 'dman5505', 'csbaile2', 'yyang132', 'ryba.konrad', 'pbhatta2', 'bpgolfguy92', 'grober.dan', 'eprzyby2', 'ntxuby', 'melissagoetter', 'mkbaile2', 'hmwu2', 'tara.cullerton', 'allysonv10', 'gvelard2edu', 'jiechen94', 'qiujiezhao1994', 'dagapit2', 'kjcsport1', 'scpiper2', 'ntsherm2', 'jefrin', 'dwchris2', 'curtis.c.baker', 'yoo66', 'meher.bharucha', 'klwells2', 'jtcohen2', 'sho1123', 'ahli2', 'dyoon11', 'werkkdy2', 'knipfer2']",1,[None],84,"['spshah6', 'simpkns2', 'amango4', 'aniruddhshivram', 'billli1996', 'achoi121', 'cory93', 'remlevin', 'cullenglasgow', 'tjweber2', 'sarahresarf', 'jjiang14', 'dmcgovern88', 'hmtaylo2', 'lbward93', 'hylin2', 'isaacehoffman2', 'janeyoo34', 'dkwok2', 'hsp6634', 'julia.zuo', 'zhensun5', 'bcclanc2', 'myeoh2', 'cledesma2331', 'masiyi9406', 'jmmille6', 'dlitt2', 'mrhennek', 'spmurra2', 'beng3', 'kfeng', 'jacobcamp1', 'carolgu2', 'lolipopcarolwang', 'earthy', 'faizal2', 'palchec2', 'jake.kornacker', 'hlai7', 'antony.huang.129', 'mcheng94', 'ruining2', 'xiasang2', 'mantianxue0101', 'bhanley2', 'lfirpo', 'dman5505', 'csbaile2', 'yyang132', 'ryba.konrad', 'pbhatta2', 'bpgolfguy92', 'grober.dan', 'eprzyby2', 'ntxuby', 'melissagoetter', 'mkbaile2', 'hmwu2', 'tara.cullerton', 'elin11', 'allysonv10', 'gvelard2edu', 'jiechen94', 'qiujiezhao1994', 'dagapit2', 'kjcsport1', 'scpiper2', 'ntsherm2', 'jefrin', 'dwchris2', None, 'curtis.c.baker', 'yoo66', 'meher.bharucha', 'klwells2', 'jtcohen2', 'sho1123', 'ahli2', 'hank.liu.180', 'anna.mast2', 'dyoon11', 'werkkdy2', 'knipfer2']"
5,73,84,7,3,"['julia.zuo', 'jmmille6', 'dlitt2']",80,"['spshah6', 'simpkns2', 'amango4', 'aniruddhshivram', 'billli1996', 'achoi121', 'cory93', 'remlevin', 'cullenglasgow', 'tjweber2', 'sarahresarf', 'jjiang14', 'dmcgovern88', 'hmtaylo2', 'lbward93', 'hylin2', 'isaacehoffman2', 'janeyoo34', 'dkwok2', 'hsp6634', 'zhensun5', 'bcclanc2', 'myeoh2', 'cledesma2331', 'masiyi9406', 'mrhennek', 'spmurra2', 'beng3', 'kfeng', 'jacobcamp1', 'carolgu2', 'lolipopcarolwang', 'earthy', 'faizal2', 'palchec2', 'jake.kornacker', 'hlai7', 'antony.huang.129', 'mcheng94', 'ruining2', 'xiasang2', 'mantianxue0101', 'bhanley2', 'lfirpo', 'dman5505', 'csbaile2', 'yyang132', 'ryba.konrad', 'pbhatta2', 'bpgolfguy92', 'grober.dan', 'eprzyby2', 'ntxuby', 'melissagoetter', 'mkbaile2', 'hmwu2', 'tara.cullerton', 'elin11', 'allysonv10', 'gvelard2edu', 'jiechen94', 'qiujiezhao1994', 'dagapit2', 'kjcsport1', 'scpiper2', 'ntsherm2', 'jefrin', 'dwchris2', 'curtis.c.baker', 'yoo66', 'meher.bharucha', 'klwells2', 'jtcohen2', 'sho1123', 'ahli2', 'hank.liu.180', 'anna.mast2', 'dyoon11', 'werkkdy2', 'knipfer2']",4,"['xli121', 'sikaufm2', 'kuo20', None]",87,"['spshah6', 'simpkns2', 'amango4', 'aniruddhshivram', 'billli1996', 'achoi121', 'cory93', 'remlevin', 'cullenglasgow', 'tjweber2', 'sarahresarf', 'jjiang14', 'dmcgovern88', 'hmtaylo2', 'lbward93', 'hylin2', 'isaacehoffman2', 'janeyoo34', 'dkwok2', 'hsp6634', 'julia.zuo', 'zhensun5', 'bcclanc2', 'myeoh2', 'cledesma2331', 'masiyi9406', 'jmmille6', 'dlitt2', 'mrhennek', 'spmurra2', 'beng3', 'kfeng', 'jacobcamp1', 'carolgu2', 'lolipopcarolwang', 'earthy', 'xli121', 'faizal2', 'palchec2', 'jake.kornacker', 'kuo20', 'hlai7', 'antony.huang.129', 'mcheng94', 'ruining2', 'xiasang2', 'mantianxue0101', 'bhanley2', 'lfirpo', 'dman5505', 'csbaile2', 'yyang132', 'ryba.konrad', 'pbhatta2', 'bpgolfguy92', 'grober.dan', 'eprzyby2', 'ntxuby', 'melissagoetter', 'mkbaile2', 'hmwu2', 'tara.cullerton', 'elin11', 'allysonv10', 'gvelard2edu', 'jiechen94', 'sikaufm2', 'qiujiezhao1994', 'dagapit2', 'kjcsport1', 'scpiper2', 'ntsherm2', 'jefrin', 'dwchris2', None, 'curtis.c.baker', 'yoo66', 'meher.bharucha', 'klwells2', 'jtcohen2', 'sho1123', 'ahli2', 'hank.liu.180', 'anna.mast2', 'dyoon11', 'werkkdy2', 'knipfer2']"
6,219,78,171,1,['deepakcmani'],76,"['lachwsk2', 'yxie24', 'chunxu2', 'yliu181', 'dchlebek2', 'zhoffm', 'fangguanhua2013', 'hhardin2', 'warpins2', 'jaikarnik95', 'jonathan.lin.773', 'statar2', 'zwu27', 'emfoley14', 'gooneti2', 'zhanshi', 'crosent2', 'dkuai2', 'sdschmi2', 'mlandi6', 'avelard2', 'ecyoung', 'mpunuk', 'cwojtan', 'hmajith2', 'gracepakeltis', 'cgu8', 'eswu2', 'nocyama', 'ywada3', 'dli29', 'pakelti2', 'clopes2', 'jedrals2', 'tianshu2', 'shoppe2', 'myang39', 'naveedjamali7', 'hzhou30', 'reisber2', 'aleksns2', 'nlee17', 'alvinlvalysa', 'bshen9', 'slbecke2', 'laurentaylor', 'ndunlap2', 'kregel2', 'talee3', 'adam.brown.39395033', 'mchu5', 'buhl2', 'amber.snil', 'pokhym', 'prandle2', 'shenxinrusue', 'sdhanak1', 'adiassasino', 'ajwisni2', 'dshi10', 'ed.tir.1', 'devin.t.oconnor', 'shirley123xiong', 'eaallen', 'kagebei2', 'bjzy1990', 'xingye.guo', 'sali12', 'jylin4', 'khuang31', 'samsrajer', 'shardul.singh.panwar', 'njamali2', 'szhang87', 'stephanieh', 'pierce.randle']",170,"['rlmcdon2', 'yarrama2', 'aklaas2', 'boisver2', 'kote.deepa', 'andrewhowell', 'hzh631038469', 'pvuong3', 'peterwu2', 'nanohub77', 'vigneshka', 'yjiang71', 'ryanc', 'rdatta2', 'stanley0010703', 'rahul.bhatia.k', 'jochoe1', 'xxchriskimxx', 'mrloube2', 'svemulapati', 'tapeterson2', 'wonho.chungy', 'hjko0107', 'li160', 'pablorosas', 'dyangsteven', 'sauronalexander', 'jmmille6', 'mrhennek', 'wyattsmcall1', 'paulmis2', 'mkersten', 'psroy2', 'langas2', 'mattfedd', 'pramesh2', 'lfirpo', 'njalexa2', 'csbaile2', 'jfoyer2', 'han109', 'rishychacko', 'gabriel.su.7', 'kwh1210', 'jp199275', 'lin.joanna.y', 'rodrig67', 'shuoliu3', 'ysheng5', 'shmeeel', 'drennan1', 'kkoppula2', 'titusfong', 'michael.gao1', 'sataylor8', 'kakaxizhixin', 'sheelshah22', 'sulaimn2', 'minsu.yu', 'dalong2', 'sid.muthal', 'skong10', 'mohsaad', 'bababu', 'dtaylo21', 'cyim2', 'prashramani12', 'saurav.puri', 'yizhu3', 'didizuibang', 'cmschuetz', 'xiaozhouas', 'jtolin2', 'eya369', 'bluewaves3141', 'coleymei', 'jkravitz61', 'hhkkkxxx133', 'lpfung2', 'iseri2', 'jchardy2', 'renagade4', 'sam.chuanxie', 'kloseliebej', 'jake.didier', 'icetree', 'ozoude2', 'intae12', 'rshah82', 'eli.longbottom', 'fhismail', 'aabi10', 'melissacrawford396', 'bob.kummerer', 'adatia1', 'mjtomei', 'joseibert93', 'siddharth.bidasaria', 'coolcristobal', 'yfang12', 'avandorn1', 'jaber2', 'lingyi.kong.5', 'haller2', 'julia.zuo', 'cookie.green.7798', 'wang.xiaohao.3', 'cledesma2331', 'ashah13', 'jbrown76', 'dgardne2', 'obrzutkevin', 'frostybeverages', 'wratner', 'romanomatthew23', 'balsaofthespear', 'pschmid28', 'abhimanyu.khandelwal', 'cgooding1', 'akagti2', 'janewjp501', 'fliu14', 'ojoya24', 'shravan.gupta', 'hpark90', 'june', 'rstang2', 'cychan3', 'sxu32', 'jagraha2', 'kaaere94', 'jjleigh2', 'ablandi2', 'andrumar10', 'ammartn3', 'vbahl2', 'lcheng12', 'matteo.hoch.1', 'jdolins2', 'tjroger2', 'samdawg', 'eperbohner', 'nbruck2', 'cmao3', 'thexcguy', 'gregorlax37', 'eric.ayala2', 'jmxscrs', 'ducharm2', 'keward3', 'lucas.liu.3367', 'tkao4', 'luminoussky07', 'afscg', 'icyroderick', 'dpapanicolas', 'gsharma80', 'vinjamu2', 'kenned45', 'salman2', 'caily1995', 'koliva2', 'jtcohen2', 'jesse.w.gunderson', 'pandabrewski2', 'bhjhnsn2', 'd82232004', 'chenxid', 'knipfer2', 'marjorie.dallmann']",247,"['yliu181', 'rlmcdon2', 'yarrama2', 'boisver2', 'aklaas2', 'kote.deepa', 'andrewhowell', 'zwu27', 'hzh631038469', 'pvuong3', 'dkuai2', 'sdschmi2', 'avelard2', 'peterwu2', 'nanohub77', 'cwojtan', 'hmajith2', 'vigneshka', 'yjiang71', 'cgu8', 'ryanc', 'rdatta2', 'stanley0010703', 'dli29', 'rahul.bhatia.k', 'clopes2', 'jochoe1', 'xxchriskimxx', 'mrloube2', 'svemulapati', 'tapeterson2', 'reisber2', 'aleksns2', 'wonho.chungy', 'hjko0107', 'adam.brown.39395033', 'li160', 'pablorosas', 'dyangsteven', 'prandle2', 'pokhym', 'sauronalexander', 'jmmille6', 'sdhanak1', 'mrhennek', 'wyattsmcall1', 'paulmis2', 'bjzy1990', 'mkersten', 'samsrajer', 'psroy2', 'njamali2', 'langas2', 'stephanieh', 'pierce.randle', 'yxie24', 'zhoffm', 'mattfedd', 'hhardin2', 'pramesh2', 'jonathan.lin.773', 'lfirpo', 'njalexa2', 'csbaile2', 'jfoyer2', 'han109', 'rishychacko', 'gabriel.su.7', 'kwh1210', 'deepakcmani', 'jp199275', 'nocyama', 'lin.joanna.y', 'pakelti2', 'rodrig67', 'shuoliu3', 'ysheng5', 'shmeeel', 'drennan1', 'kkoppula2', 'titusfong', 'bshen9', 'michael.gao1', 'sataylor8', 'kakaxizhixin', 'sheelshah22', 'kregel2', 'sulaimn2', 'mchu5', 'minsu.yu', 'buhl2', 'dalong2', 'amber.snil', 'shenxinrusue', 'sid.muthal', 'skong10', 'mohsaad', 'bababu', 'dtaylo21', 'cyim2', 'dshi10', 'prashramani12', 'saurav.puri', 'kagebei2', 'didizuibang', 'yizhu3', 'cmschuetz', 'chunxu2', 'xiaozhouas', 'jtolin2', 'eya369', 'bluewaves3141', 'coleymei', 'jkravitz61', 'hhkkkxxx133', 'lpfung2', 'iseri2', 'jaikarnik95', 'statar2', 'jchardy2', 'renagade4', 'emfoley14', 'sam.chuanxie', 'kloseliebej', 'jake.didier', 'mlandi6', 'ecyoung', 'icetree', 'mpunuk', 'ozoude2', 'intae12', 'rshah82', 'gracepakeltis', 'eli.longbottom', 'fhismail', 'eswu2', 'ywada3', 'aabi10', 'melissacrawford396', 'bob.kummerer', 'adatia1', 'mjtomei', 'jedrals2', 'joseibert93', 'siddharth.bidasaria', 'coolcristobal', 'yfang12', 'myang39', 'avandorn1', 'jaber2', 'lingyi.kong.5', 'nlee17', 'haller2', 'alvinlvalysa', 'julia.zuo', 'cookie.green.7798', 'slbecke2', 'laurentaylor', 'ndunlap2', 'wang.xiaohao.3', 'talee3', 'cledesma2331', 'ashah13', 'jbrown76', 'dgardne2', 'obrzutkevin', 'frostybeverages', 'wratner', 'romanomatthew23', 'shirley123xiong', 'balsaofthespear', 'xingye.guo', 'pschmid28', 'jylin4', 'khuang31', 'abhimanyu.khandelwal', 'shardul.singh.panwar', 'szhang87', 'cgooding1', 'akagti2', 'lachwsk2', 'janewjp501', 'fliu14', 'dchlebek2', 'ojoya24', 'shravan.gupta', 'hpark90', 'fangguanhua2013', 'june', 'rstang2', 'warpins2', 'cychan3', 'sxu32', 'jagraha2', 'kaaere94', 'jjleigh2', 'gooneti2', 'ablandi2', 'zhanshi', 'crosent2', 'andrumar10', 'ammartn3', 'vbahl2', 'lcheng12', 'matteo.hoch.1', 'jdolins2', 'tjroger2', 'samdawg', 'eperbohner', 'nbruck2', 'cmao3', 'thexcguy', 'tianshu2', 'shoppe2', 'gregorlax37', 'naveedjamali7', 'hzhou30', 'eric.ayala2', 'jmxscrs', 'ducharm2', 'keward3', 'lucas.liu.3367', 'tkao4', 'luminoussky07', 'afscg', 'icyroderick', 'dpapanicolas', 'gsharma80', 'vinjamu2', 'kenned45', 'salman2', 'caily1995', 'adiassasino', 'ajwisni2', 'koliva2', 'ed.tir.1', 'devin.t.oconnor', 'jtcohen2', 'eaallen', 'jesse.w.gunderson', 'pandabrewski2', 'sali12', 'bhjhnsn2', 'd82232004', 'chenxid', 'knipfer2', 'marjorie.dallmann']"
6,153,78,100,69,"['lachwsk2', 'chunxu2', 'yliu181', 'dchlebek2', 'zhoffm', 'hhardin2', 'warpins2', 'jaikarnik95', 'jonathan.lin.773', 'statar2', 'zwu27', 'emfoley14', 'gooneti2', 'zhanshi', 'crosent2', 'dkuai2', 'sdschmi2', 'mlandi6', 'avelard2', 'ecyoung', 'mpunuk', 'cwojtan', 'hmajith2', 'deepakcmani', 'gracepakeltis', 'cgu8', 'nocyama', 'ywada3', 'dli29', 'pakelti2', 'clopes2', 'jedrals2', 'tianshu2', 'shoppe2', 'myang39', 'naveedjamali7', 'hzhou30', 'reisber2', 'nlee17', 'alvinlvalysa', 'bshen9', 'slbecke2', 'laurentaylor', 'ndunlap2', 'kregel2', 'talee3', 'adam.brown.39395033', 'mchu5', 'buhl2', 'amber.snil', 'pokhym', 'prandle2', 'shenxinrusue', 'sdhanak1', 'adiassasino', 'ajwisni2', 'dshi10', 'ed.tir.1', 'shirley123xiong', 'eaallen', 'kagebei2', 'sali12', 'jylin4', 'khuang31', 'samsrajer', 'njamali2', 'szhang87', 'stephanieh', 'pierce.randle']",8,"['yxie24', 'aleksns2', 'fangguanhua2013', 'eswu2', 'devin.t.oconnor', 'xingye.guo', 'bjzy1990', 'shardul.singh.panwar']",31,"['mcheng94', 'antony.huang.129', 'ruining2', 'mantianxue0101', '17staru', 'dman5505', 'rishychacko', 'grober.dan', 'ntxuby', 'cullenglasgow', 'melissagoetter', 'frankkelly47', 'a_kuzni2', 'mingye.gao', 'julia.zuo', 'zhensun5', 'jefrin', 'dpapanicolas', 'gsharma80', None, 'asimha2', 'qinglin2', 'dlitt2', 'jacobcamp1', 'beng3', 'sho1123', 'schiavo1', 'me1291441', 'whu14', 'jkim561', 'yyao13']",108,"['yliu181', 'zwu27', 'dkuai2', 'sdschmi2', 'avelard2', 'cwojtan', 'hmajith2', 'cullenglasgow', 'cgu8', 'dli29', 'clopes2', 'frankkelly47', 'reisber2', 'aleksns2', 'adam.brown.39395033', 'prandle2', 'pokhym', 'qinglin2', 'sdhanak1', 'dlitt2', 'beng3', 'bjzy1990', 'samsrajer', 'njamali2', 'stephanieh', 'jkim561', 'pierce.randle', 'yxie24', 'mcheng94', 'antony.huang.129', 'zhoffm', 'ruining2', 'hhardin2', 'mantianxue0101', 'jonathan.lin.773', 'dman5505', 'rishychacko', 'deepakcmani', 'nocyama', 'pakelti2', 'mingye.gao', 'bshen9', 'kregel2', 'mchu5', 'jefrin', 'buhl2', 'amber.snil', 'shenxinrusue', 'asimha2', 'dshi10', 'sho1123', 'kagebei2', 'chunxu2', 'jaikarnik95', 'statar2', 'emfoley14', 'mlandi6', 'ecyoung', 'mpunuk', 'gracepakeltis', 'eswu2', 'ywada3', 'jedrals2', 'myang39', 'julia.zuo', 'nlee17', 'zhensun5', 'alvinlvalysa', 'slbecke2', 'laurentaylor', 'ndunlap2', 'talee3', 'jacobcamp1', 'shirley123xiong', 'xingye.guo', 'jylin4', 'khuang31', 'shardul.singh.panwar', 'szhang87', 'yyao13', 'lachwsk2', 'dchlebek2', 'fangguanhua2013', 'warpins2', '17staru', 'gooneti2', 'zhanshi', 'crosent2', 'grober.dan', 'ntxuby', 'melissagoetter', 'a_kuzni2', 'tianshu2', 'shoppe2', 'naveedjamali7', 'hzhou30', 'dpapanicolas', 'gsharma80', None, 'adiassasino', 'ajwisni2', 'ed.tir.1', 'devin.t.oconnor', 'eaallen', 'schiavo1', 'me1291441', 'sali12', 'whu14']"
6,68,78,57,5,"['cwojtan', 'hmajith2', 'laurentaylor', 'emfoley14', 'pierce.randle']",72,"['lachwsk2', 'yxie24', 'chunxu2', 'yliu181', 'dchlebek2', 'zhoffm', 'fangguanhua2013', 'hhardin2', 'warpins2', 'jaikarnik95', 'jonathan.lin.773', 'statar2', 'zwu27', 'gooneti2', 'zhanshi', 'crosent2', 'dkuai2', 'sdschmi2', 'mlandi6', 'avelard2', 'ecyoung', 'mpunuk', 'deepakcmani', 'gracepakeltis', 'cgu8', 'eswu2', 'nocyama', 'ywada3', 'dli29', 'pakelti2', 'clopes2', 'jedrals2', 'tianshu2', 'shoppe2', 'myang39', 'naveedjamali7', 'hzhou30', 'reisber2', 'aleksns2', 'nlee17', 'alvinlvalysa', 'bshen9', 'slbecke2', 'ndunlap2', 'kregel2', 'talee3', 'adam.brown.39395033', 'mchu5', 'buhl2', 'amber.snil', 'pokhym', 'prandle2', 'shenxinrusue', 'sdhanak1', 'adiassasino', 'ajwisni2', 'dshi10', 'ed.tir.1', 'devin.t.oconnor', 'shirley123xiong', 'eaallen', 'kagebei2', 'bjzy1990', 'xingye.guo', 'sali12', 'jylin4', 'khuang31', 'samsrajer', 'shardul.singh.panwar', 'njamali2', 'szhang87', 'stephanieh']",52,"['michiizu1996', 'kmckillop', 'peiyiiina', 'zicheng.long', 'skapoln2', 'aaaandrew', 'jkim561', 'bfiszbein', 'jacob.dutler', 'marcin2', '17staru', 'adsnyde2', 'mgulson2', 'puthala2', 'tmccar4', 'vkhanna3', 'eslee6', 'qinli2', 'charmisuk', 'jasondxzhang', 'lafaye2', 'liamthirdtry', 'mizulsk2', 'bluefisher12', 'zhucq330873348', 'kavitasrinivasan', 'laoyumi904', 'madara61796', 'jjauch93', 'zjz.jiklint', 'jackxiao1104', 'jeoneil2', 'emilio.ramirez.37604', 'mingye.gao', 'dtmrnav', 'xsun45', 'jonbaebae', 'yiyue.luo.9', 'zjhaber', 'jshi3120', None, 'qinglin2', 'justinb1', 'brianwzx11', 'jjotte2', 'cjisrael1015', 'ychu18', 'goszkow2', 'saphknight', 'whu14', 'jhuang84', 'yyao13']",129,"['michiizu1996', 'chunxu2', 'yliu181', 'bfiszbein', 'jaikarnik95', 'marcin2', 'statar2', 'zwu27', 'emfoley14', 'adsnyde2', 'mgulson2', 'dkuai2', 'sdschmi2', 'mlandi6', 'avelard2', 'ecyoung', 'tmccar4', 'mpunuk', 'eslee6', 'cwojtan', 'hmajith2', 'gracepakeltis', 'qinli2', 'cgu8', 'eswu2', 'ywada3', 'lafaye2', 'mizulsk2', 'bluefisher12', 'dli29', 'clopes2', 'jedrals2', 'yyao13', 'kavitasrinivasan', 'laoyumi904', 'madara61796', 'zjz.jiklint', 'jackxiao1104', 'myang39', 'reisber2', 'aleksns2', 'nlee17', 'alvinlvalysa', 'slbecke2', 'laurentaylor', 'ndunlap2', 'xsun45', 'jonbaebae', 'talee3', 'yiyue.luo.9', 'adam.brown.39395033', 'zjhaber', 'prandle2', 'pokhym', 'qinglin2', 'sdhanak1', 'shirley123xiong', 'xingye.guo', 'bjzy1990', 'brianwzx11', 'cjisrael1015', 'jylin4', 'khuang31', 'samsrajer', 'ychu18', 'shardul.singh.panwar', 'njamali2', 'goszkow2', 'saphknight', 'szhang87', 'stephanieh', 'jkim561', 'pierce.randle', 'lachwsk2', 'yxie24', 'kmckillop', 'dchlebek2', 'peiyiiina', 'zicheng.long', 'skapoln2', 'aaaandrew', 'zhoffm', 'fangguanhua2013', 'hhardin2', 'warpins2', 'jacob.dutler', 'jonathan.lin.773', '17staru', 'gooneti2', 'zhanshi', 'puthala2', 'crosent2', 'vkhanna3', 'jasondxzhang', 'deepakcmani', 'liamthirdtry', 'nocyama', 'pakelti2', 'charmisuk', 'zhucq330873348', 'jjauch93', 'tianshu2', 'shoppe2', 'jeoneil2', 'naveedjamali7', 'hzhou30', 'emilio.ramirez.37604', 'mingye.gao', 'dtmrnav', 'bshen9', 'kregel2', 'mchu5', 'jshi3120', 'buhl2', 'amber.snil', None, 'shenxinrusue', 'adiassasino', 'justinb1', 'ajwisni2', 'dshi10', 'ed.tir.1', 'devin.t.oconnor', 'eaallen', 'kagebei2', 'jjotte2', 'sali12', 'whu14', 'jhuang84']"
7,1,74,74,72,"['jgibbons12', 'pvallima', 'morloff21', 'tsmolen', 'korrmuffin', 'matthew.s.armstrong', 'ilmanziat15', 'denniscolbert12', 'sherafaira986', 'zander.vartanian', 'ganizs', 'chrisnash3', 'tubbyocharles', 'kmusto', 'ben.whittle.37', 'bjmac12', 'apih.azmi', 'mcneiljg', 'jverdin30', 'aliasa', 'mullere', 'akmal.wahid.7', 'thynkbig', 'kovandbl', 'jaykrav', 'dshane28', 'd.martin.159', 'clay.harrell', 'wprieb', 'aronskind', 'tinninfs', 'cchorens', 'wolfele', 'muhannad.abumilhah', 'kurtrosolowsky', 'mhhostetler', 'adam.rubinsky', 'bh29', 'asmatnal', 'binhtd93', 'moose_the_vast', 'rob.rutherford2', 'emmakate11', 'nabhell', 'wan.m.wan.mohamad.zakari', 'sgrichnik', 'john.j.hayes', 'sthorson', 'hurtrs', 'ben.behseresht', 'schaubend', 'fifiebaek777', 'grollkt', 'valentjg', 'davidhirsch1994', 'gavin0802', 'sayanakjadilegend', 'wannajmie94', 'hurdok', 'adamlevinson94', 'geisreme', 'b3dinc', 'hannahturnbull', 'jimmythekid', 'brianwinokan', 'podolawe', 'ivan.c.biggs', 'sean.m.cartwright', 'jordanztodd', 'langston', 'jaimevest', 'matt.kelley.77715']",1,['ethan.b.levy'],2,"['gw014425', None]",75,"['jgibbons12', 'pvallima', 'tsmolen', 'korrmuffin', 'matthew.s.armstrong', 'ilmanziat15', 'denniscolbert12', 'sherafaira986', 'zander.vartanian', 'ethan.b.levy', 'chrisnash3', 'tubbyocharles', 'aliasa', 'mullere', 'kovandbl', 'jaykrav', 'dshane28', 'd.martin.159', 'cchorens', 'wolfele', 'kurtrosolowsky', 'bh29', 'rob.rutherford2', 'wan.m.wan.mohamad.zakari', 'gw014425', 'ben.behseresht', 'schaubend', 'fifiebaek777', 'grollkt', 'valentjg', 'gavin0802', 'sayanakjadilegend', 'wannajmie94', 'geisreme', 'jimmythekid', 'brianwinokan', 'sean.m.cartwright', 'jordanztodd', 'langston', 'hurtrs', 'sgrichnik', 'thynkbig', 'morloff21', 'ganizs', 'kmusto', 'ben.whittle.37', 'bjmac12', 'apih.azmi', 'mcneiljg', 'jverdin30', 'akmal.wahid.7', 'clay.harrell', 'wprieb', 'aronskind', 'tinninfs', 'muhannad.abumilhah', 'mhhostetler', 'adam.rubinsky', 'asmatnal', 'binhtd93', 'moose_the_vast', 'emmakate11', 'nabhell', 'john.j.hayes', 'sthorson', 'davidhirsch1994', None, 'hurdok', 'adamlevinson94', 'b3dinc', 'hannahturnbull', 'podolawe', 'ivan.c.biggs', 'jaimevest', 'matt.kelley.77715']"
7,2,74,17,16,"['kmusto', 'bjmac12', 'dshane28', 'morloff21', 'hurdok', 'adamlevinson94', 'd.martin.159', 'nabhell', 'sthorson', 'sean.m.cartwright', 'hurtrs', 'grollkt', 'davidhirsch1994', 'tinninfs', 'matt.kelley.77715', 'wolfele']",57,"['jgibbons12', 'pvallima', 'tsmolen', 'korrmuffin', 'matthew.s.armstrong', 'ilmanziat15', 'denniscolbert12', 'sherafaira986', 'zander.vartanian', 'ethan.b.levy', 'chrisnash3', 'tubbyocharles', 'aliasa', 'mullere', 'kovandbl', 'jaykrav', 'cchorens', 'kurtrosolowsky', 'bh29', 'rob.rutherford2', 'wan.m.wan.mohamad.zakari', 'ben.behseresht', 'schaubend', 'fifiebaek777', 'valentjg', 'gavin0802', 'sayanakjadilegend', 'wannajmie94', 'geisreme', 'jimmythekid', 'brianwinokan', 'jordanztodd', 'langston', 'sgrichnik', 'thynkbig', 'ganizs', 'ben.whittle.37', 'apih.azmi', 'mcneiljg', 'jverdin30', 'akmal.wahid.7', 'clay.harrell', 'wprieb', 'aronskind', 'muhannad.abumilhah', 'mhhostetler', 'adam.rubinsky', 'asmatnal', 'binhtd93', 'moose_the_vast', 'emmakate11', 'john.j.hayes', 'b3dinc', 'hannahturnbull', 'podolawe', 'ivan.c.biggs', 'jaimevest']",1,[None],74,"['jgibbons12', 'pvallima', 'tsmolen', 'korrmuffin', 'matthew.s.armstrong', 'ilmanziat15', 'denniscolbert12', 'sherafaira986', 'zander.vartanian', 'ethan.b.levy', 'chrisnash3', 'tubbyocharles', 'aliasa', 'mullere', 'kovandbl', 'jaykrav', 'dshane28', 'd.martin.159', 'cchorens', 'wolfele', 'kurtrosolowsky', 'bh29', 'rob.rutherford2', 'wan.m.wan.mohamad.zakari', 'ben.behseresht', 'schaubend', 'fifiebaek777', 'grollkt', 'valentjg', 'gavin0802', 'sayanakjadilegend', 'wannajmie94', 'geisreme', 'jimmythekid', 'brianwinokan', 'sean.m.cartwright', 'jordanztodd', 'langston', 'hurtrs', 'sgrichnik', 'thynkbig', 'morloff21', 'ganizs', 'kmusto', 'ben.whittle.37', 'bjmac12', 'apih.azmi', 'mcneiljg', 'jverdin30', 'akmal.wahid.7', 'clay.harrell', 'wprieb', 'aronskind', 'tinninfs', 'muhannad.abumilhah', 'mhhostetler', 'adam.rubinsky', 'asmatnal', 'binhtd93', 'moose_the_vast', 'emmakate11', 'nabhell', 'john.j.hayes', 'sthorson', 'davidhirsch1994', None, 'hurdok', 'adamlevinson94', 'b3dinc', 'hannahturnbull', 'podolawe', 'ivan.c.biggs', 'jaimevest', 'matt.kelley.77715']"
8,153,72,100,7,"['qinglin2', 'mingye.gao', 'frankkelly47', '17staru', 'whu14', 'jkim561', 'yyao13']",64,"['michiizu1996', 'kmckillop', 'peiyiiina', 'zicheng.long', 'aaaandrew', 'ehrmicha', 'bfiszbein', 'aaron.repholz', 'abdelazizalrufai', 'ebfleming', 'jacob.dutler', 'marcin2', 'myungsuk1020', 'halstar9', 'yuka.wada95', 'mgulson2', 'tmccar4', 'puthala2', 'vkhanna3', 'qinli2', 'eslee6', 'melbahr5', 'charmisuk', 'jasondxzhang', 'ryangrohsmeyer', 'orielys', 'tushar.chitrakar', 'mizulsk2', 'liamthirdtry', 'bluefisher12', 'goszkow2', 'zhucq330873348', 'kavitasrinivasan', 'bryantsugg', 'laoyumi904', 'madara61796', 'c.the.great12', 'zjz.jiklint', 'jjauch93', 'aweathers', 'jackxiao1104', 'jeoneil2', 'emilio.ramirez.37604', 'tianfeiliu90', 'ramire28', 'sehrish.physics', 'xsun45', 'jonbaebae', 'yiyue.luo.9', 'xiaoboy8', 'jshi3120', 'haleys', 'e.davies.94', 'justinb1', 'axp298', 'brianwzx11', 'jjotte2', 'cjisrael1015', 'jenna.roach.5', 'ychu18', 'spicyfizizo1', 'kruanlei', 'saphknight', 'jhuang84']",93,"['yliu181', 'zwu27', 'dkuai2', 'sdschmi2', 'avelard2', 'hmajith2', 'cullenglasgow', 'cwojtan', 'cgu8', 'dli29', 'clopes2', 'reisber2', 'adam.brown.39395033', 'pokhym', 'prandle2', 'sdhanak1', 'dlitt2', 'beng3', 'samsrajer', 'njamali2', 'stephanieh', 'pierce.randle', 'mcheng94', 'antony.huang.129', 'ruining2', 'zhoffm', 'mantianxue0101', 'hhardin2', 'jonathan.lin.773', 'dman5505', 'rishychacko', 'deepakcmani', 'nocyama', 'pakelti2', 'bshen9', 'kregel2', 'mchu5', 'jefrin', 'buhl2', 'amber.snil', 'shenxinrusue', 'asimha2', 'dshi10', 'sho1123', 'kagebei2', 'chunxu2', 'jaikarnik95', 'statar2', 'emfoley14', 'mlandi6', 'ecyoung', 'mpunuk', 'gracepakeltis', 'ywada3', 'jedrals2', 'myang39', 'julia.zuo', 'nlee17', 'zhensun5', 'alvinlvalysa', 'slbecke2', 'laurentaylor', 'ndunlap2', 'talee3', 'jacobcamp1', 'shirley123xiong', 'jylin4', 'khuang31', 'szhang87', 'lachwsk2', 'dchlebek2', 'warpins2', 'gooneti2', 'zhanshi', 'crosent2', 'grober.dan', 'ntxuby', 'melissagoetter', 'a_kuzni2', 'tianshu2', 'shoppe2', 'naveedjamali7', 'hzhou30', 'dpapanicolas', 'gsharma80', None, 'adiassasino', 'ajwisni2', 'ed.tir.1', 'eaallen', 'schiavo1', 'me1291441', 'sali12']",164,"['yliu181', 'aaron.repholz', 'ebfleming', 'zwu27', 'halstar9', 'tmccar4', 'dkuai2', 'sdschmi2', 'melbahr5', 'avelard2', 'ryangrohsmeyer', 'hmajith2', 'cullenglasgow', 'cwojtan', 'mizulsk2', 'cgu8', 'bluefisher12', 'dli29', 'frankkelly47', 'clopes2', 'madara61796', 'reisber2', 'ramire28', 'xsun45', 'jonbaebae', 'adam.brown.39395033', 'prandle2', 'pokhym', 'haleys', 'qinglin2', 'sdhanak1', 'dlitt2', 'beng3', 'axp298', 'samsrajer', 'saphknight', 'njamali2', 'jkim561', 'stephanieh', 'pierce.randle', 'kmckillop', 'zicheng.long', 'aaaandrew', 'mcheng94', 'ehrmicha', 'antony.huang.129', 'ruining2', 'zhoffm', 'mantianxue0101', 'hhardin2', 'jacob.dutler', 'jonathan.lin.773', 'dman5505', 'rishychacko', 'jasondxzhang', 'orielys', 'deepakcmani', 'nocyama', 'pakelti2', 'zhucq330873348', 'c.the.great12', 'aweathers', 'jeoneil2', 'mingye.gao', 'tianfeiliu90', 'bshen9', 'kregel2', 'mchu5', 'jefrin', 'xiaoboy8', 'jshi3120', 'buhl2', 'amber.snil', 'shenxinrusue', 'asimha2', 'dshi10', 'sho1123', 'kagebei2', 'jjotte2', 'jhuang84', 'michiizu1996', 'chunxu2', 'bfiszbein', 'jaikarnik95', 'marcin2', 'statar2', 'emfoley14', 'mgulson2', 'mlandi6', 'qinli2', 'eslee6', 'charmisuk', 'ecyoung', 'mpunuk', 'gracepakeltis', 'tushar.chitrakar', 'ywada3', 'jedrals2', 'kavitasrinivasan', 'laoyumi904', 'zjz.jiklint', 'jackxiao1104', 'myang39', 'julia.zuo', 'nlee17', 'zhensun5', 'alvinlvalysa', 'slbecke2', 'laurentaylor', 'ndunlap2', 'yiyue.luo.9', 'talee3', 'e.davies.94', 'jacobcamp1', 'shirley123xiong', 'brianwzx11', 'cjisrael1015', 'jenna.roach.5', 'ychu18', 'spicyfizizo1', 'goszkow2', 'jylin4', 'khuang31', 'szhang87', 'yyao13', 'lachwsk2', 'peiyiiina', 'dchlebek2', 'abdelazizalrufai', 'warpins2', 'myungsuk1020', '17staru', 'gooneti2', 'zhanshi', 'puthala2', 'yuka.wada95', 'crosent2', 'vkhanna3', 'grober.dan', 'ntxuby', 'melissagoetter', 'liamthirdtry', 'bryantsugg', 'jjauch93', 'a_kuzni2', 'tianshu2', 'shoppe2', 'naveedjamali7', 'hzhou30', 'emilio.ramirez.37604', 'sehrish.physics', 'dpapanicolas', 'gsharma80', None, 'justinb1', 'adiassasino', 'ajwisni2', 'ed.tir.1', 'eaallen', 'schiavo1', 'me1291441', 'sali12', 'kruanlei', 'whu14']"
8,68,72,57,46,"['michiizu1996', 'kmckillop', 'peiyiiina', 'zicheng.long', 'aaaandrew', 'jkim561', 'bfiszbein', 'jacob.dutler', 'marcin2', '17staru', 'mgulson2', 'puthala2', 'tmccar4', 'vkhanna3', 'eslee6', 'qinli2', 'charmisuk', 'jasondxzhang', 'liamthirdtry', 'mizulsk2', 'bluefisher12', 'zhucq330873348', 'kavitasrinivasan', 'laoyumi904', 'madara61796', 'jjauch93', 'zjz.jiklint', 'jackxiao1104', 'jeoneil2', 'emilio.ramirez.37604', 'mingye.gao', 'xsun45', 'jonbaebae', 'yiyue.luo.9', 'jshi3120', 'qinglin2', 'justinb1', 'brianwzx11', 'jjotte2', 'cjisrael1015', 'ychu18', 'goszkow2', 'saphknight', 'whu14', 'jhuang84', 'yyao13']",25,"['ehrmicha', 'abdelazizalrufai', 'aaron.repholz', 'ebfleming', 'myungsuk1020', 'halstar9', 'yuka.wada95', 'melbahr5', 'ryangrohsmeyer', 'orielys', 'tushar.chitrakar', 'frankkelly47', 'bryantsugg', 'c.the.great12', 'aweathers', 'tianfeiliu90', 'ramire28', 'sehrish.physics', 'xiaoboy8', 'haleys', 'e.davies.94', 'axp298', 'jenna.roach.5', 'spicyfizizo1', 'kruanlei']",11,"['skapoln2', 'cwojtan', 'hmajith2', 'dtmrnav', 'lafaye2', 'laurentaylor', 'zjhaber', 'adsnyde2', 'emfoley14', None, 'pierce.randle']",82,"['michiizu1996', 'bfiszbein', 'aaron.repholz', 'ebfleming', 'marcin2', 'adsnyde2', 'emfoley14', 'halstar9', 'mgulson2', 'tmccar4', 'qinli2', 'eslee6', 'melbahr5', 'charmisuk', 'ryangrohsmeyer', 'hmajith2', 'cwojtan', 'tushar.chitrakar', 'mizulsk2', 'lafaye2', 'bluefisher12', 'frankkelly47', 'kavitasrinivasan', 'laoyumi904', 'madara61796', 'zjz.jiklint', 'jackxiao1104', 'ramire28', 'xsun45', 'laurentaylor', 'jonbaebae', 'yiyue.luo.9', 'zjhaber', 'haleys', 'e.davies.94', 'qinglin2', 'axp298', 'brianwzx11', 'cjisrael1015', 'jenna.roach.5', 'ychu18', 'spicyfizizo1', 'goszkow2', 'saphknight', 'jkim561', 'yyao13', 'pierce.randle', 'kmckillop', 'peiyiiina', 'zicheng.long', 'aaaandrew', 'ehrmicha', 'skapoln2', 'abdelazizalrufai', 'jacob.dutler', 'myungsuk1020', '17staru', 'puthala2', 'yuka.wada95', 'vkhanna3', 'jasondxzhang', 'orielys', 'liamthirdtry', 'zhucq330873348', 'bryantsugg', 'c.the.great12', 'jjauch93', 'aweathers', 'jeoneil2', 'emilio.ramirez.37604', 'mingye.gao', 'dtmrnav', 'tianfeiliu90', 'sehrish.physics', 'xiaoboy8', 'jshi3120', None, 'justinb1', 'jjotte2', 'kruanlei', 'whu14', 'jhuang84']"
8,69,72,43,1,['ramire28'],70,"['michiizu1996', 'kmckillop', 'peiyiiina', 'zicheng.long', 'aaaandrew', 'ehrmicha', 'jkim561', 'bfiszbein', 'aaron.repholz', 'abdelazizalrufai', 'ebfleming', 'jacob.dutler', 'marcin2', 'myungsuk1020', '17staru', 'halstar9', 'mgulson2', 'puthala2', 'tmccar4', 'yuka.wada95', 'vkhanna3', 'qinli2', 'eslee6', 'melbahr5', 'charmisuk', 'jasondxzhang', 'ryangrohsmeyer', 'orielys', 'tushar.chitrakar', 'mizulsk2', 'liamthirdtry', 'bluefisher12', 'goszkow2', 'frankkelly47', 'zhucq330873348', 'kavitasrinivasan', 'bryantsugg', 'laoyumi904', 'madara61796', 'c.the.great12', 'zjz.jiklint', 'jjauch93', 'aweathers', 'jackxiao1104', 'jeoneil2', 'emilio.ramirez.37604', 'mingye.gao', 'tianfeiliu90', 'sehrish.physics', 'xsun45', 'jonbaebae', 'yiyue.luo.9', 'xiaoboy8', 'jshi3120', 'haleys', 'e.davies.94', 'qinglin2', 'justinb1', 'axp298', 'brianwzx11', 'jjotte2', 'cjisrael1015', 'jenna.roach.5', 'ychu18', 'spicyfizizo1', 'kruanlei', 'saphknight', 'whu14', 'jhuang84', 'yyao13']",42,"['dacapo007', 'kim383', 'posta', 'zhu431', 'tictonk', 'pangb1', 'paulleonc', 'azzedinr', 'telliott', 'robin198', 'ncain3', 'horner4', 'jfschrad', 'alexj9', 'gflesner', 'astronut95', 'cohen.jakedavid', 'tbruttom', 'theresa.saenz.1', 'czy121301', 'tlshelhart', 'parsonsm', 'hallowj', 'kaiser17', 'smithjared1994', 'li1470', 'haojiex', 'pnorman', 'vganapa', 'jinghan1022', 'lucas.ray.169', None, 'ahmed49', 'sullivaf', 'jtrouba', 'thoma386', 'pspagnolo72', 'woodsh', 'lim154', 'ross_piedmonte', 'glinvill', 'tcurtiss']",113,"['michiizu1996', 'bfiszbein', 'aaron.repholz', 'ebfleming', 'marcin2', 'pangb1', 'paulleonc', 'azzedinr', 'telliott', 'halstar9', 'ncain3', 'horner4', 'mgulson2', 'tmccar4', 'qinli2', 'eslee6', 'melbahr5', 'charmisuk', 'jfschrad', 'ryangrohsmeyer', 'alexj9', 'tushar.chitrakar', 'mizulsk2', 'bluefisher12', 'frankkelly47', 'theresa.saenz.1', 'czy121301', 'kavitasrinivasan', 'tlshelhart', 'laoyumi904', 'madara61796', 'zjz.jiklint', 'hallowj', 'jackxiao1104', 'smithjared1994', 'li1470', 'haojiex', 'ramire28', 'xsun45', 'jonbaebae', 'yiyue.luo.9', 'vganapa', 'jinghan1022', 'lucas.ray.169', 'ahmed49', 'haleys', 'e.davies.94', 'qinglin2', 'sullivaf', 'axp298', 'pspagnolo72', 'brianwzx11', 'cjisrael1015', 'jenna.roach.5', 'ychu18', 'spicyfizizo1', 'goszkow2', 'saphknight', 'woodsh', 'ross_piedmonte', 'glinvill', 'jkim561', 'yyao13', 'kmckillop', 'peiyiiina', 'zicheng.long', 'aaaandrew', 'ehrmicha', 'dacapo007', 'kim383', 'abdelazizalrufai', 'jacob.dutler', 'posta', 'zhu431', 'tictonk', 'myungsuk1020', '17staru', 'robin198', 'puthala2', 'yuka.wada95', 'vkhanna3', 'jasondxzhang', 'orielys', 'gflesner', 'liamthirdtry', 'astronut95', 'cohen.jakedavid', 'tbruttom', 'lim154', 'zhucq330873348', 'bryantsugg', 'c.the.great12', 'jjauch93', 'parsonsm', 'aweathers', 'kaiser17', 'jeoneil2', 'emilio.ramirez.37604', 'mingye.gao', 'tianfeiliu90', 'sehrish.physics', 'pnorman', 'xiaoboy8', 'jshi3120', None, 'justinb1', 'jtrouba', 'thoma386', 'jjotte2', 'kruanlei', 'whu14', 'tcurtiss', 'jhuang84']"
8,67,72,20,10,"['melbahr5', 'haleys', 'kruanlei', 'ehrmicha', 'tushar.chitrakar', 'tianfeiliu90', 'ebfleming', 'myungsuk1020', 'bryantsugg', 'aweathers']",61,"['michiizu1996', 'kmckillop', 'peiyiiina', 'zicheng.long', 'aaaandrew', 'jkim561', 'bfiszbein', 'aaron.repholz', 'abdelazizalrufai', 'jacob.dutler', 'marcin2', '17staru', 'halstar9', 'yuka.wada95', 'mgulson2', 'tmccar4', 'puthala2', 'vkhanna3', 'qinli2', 'eslee6', 'charmisuk', 'jasondxzhang', 'ryangrohsmeyer', 'orielys', 'mizulsk2', 'liamthirdtry', 'bluefisher12', 'frankkelly47', 'zhucq330873348', 'kavitasrinivasan', 'laoyumi904', 'madara61796', 'c.the.great12', 'zjz.jiklint', 'jjauch93', 'jackxiao1104', 'jeoneil2', 'emilio.ramirez.37604', 'mingye.gao', 'ramire28', 'sehrish.physics', 'xsun45', 'jonbaebae', 'yiyue.luo.9', 'xiaoboy8', 'jshi3120', 'e.davies.94', 'qinglin2', 'justinb1', 'axp298', 'brianwzx11', 'jjotte2', 'cjisrael1015', 'jenna.roach.5', 'ychu18', 'spicyfizizo1', 'goszkow2', 'saphknight', 'whu14', 'jhuang84', 'yyao13']",10,"['sesulliv', 'sewsulliv', 'kritim20', 'hangbui', 'pakles', 'mmsadeghi', 'ghartma', 'jcoolpepper', None, 'boyer2424']",81,"['michiizu1996', 'sewsulliv', 'bfiszbein', 'aaron.repholz', 'ebfleming', 'marcin2', 'halstar9', 'mgulson2', 'tmccar4', 'qinli2', 'eslee6', 'melbahr5', 'charmisuk', 'ryangrohsmeyer', 'tushar.chitrakar', 'mizulsk2', 'bluefisher12', 'frankkelly47', 'kavitasrinivasan', 'laoyumi904', 'madara61796', 'zjz.jiklint', 'jackxiao1104', 'boyer2424', 'pakles', 'ramire28', 'xsun45', 'jonbaebae', 'yiyue.luo.9', 'haleys', 'e.davies.94', 'qinglin2', 'axp298', 'brianwzx11', 'cjisrael1015', 'jenna.roach.5', 'ychu18', 'spicyfizizo1', 'goszkow2', 'saphknight', 'jkim561', 'yyao13', 'kmckillop', 'peiyiiina', 'zicheng.long', 'aaaandrew', 'ehrmicha', 'abdelazizalrufai', 'jacob.dutler', 'myungsuk1020', '17staru', 'puthala2', 'yuka.wada95', 'vkhanna3', 'jasondxzhang', 'orielys', 'liamthirdtry', 'zhucq330873348', 'bryantsugg', 'c.the.great12', 'jjauch93', 'aweathers', 'jeoneil2', 'emilio.ramirez.37604', 'mingye.gao', 'sesulliv', 'hangbui', 'tianfeiliu90', 'sehrish.physics', 'jcoolpepper', 'xiaoboy8', 'jshi3120', None, 'justinb1', 'kritim20', 'mmsadeghi', 'ghartma', 'jjotte2', 'kruanlei', 'whu14', 'jhuang84']"
9,70,51,113,1,['yyang10'],49,"['aamirh.kth', 'eng.hend.fahmy', 'bfrandsen11', 'lisen', 'ocampor5', 'solanos3', 'saleemhamady', 'sihuic35', 'ian_ezequiel', 'jjvraja', 'linchuck', 'hasanphy88', 'unlvengineerj', 'maciasc4', 'anhphm', 'chuanc', 'angelaxbaby93', 'm18091990', 'pablogarrillo', 'andsmi', 'se299792458', 'lauraz', 'eloise.anguluan', 'lixiang12', 'spazos', 'prevosti', 'giroolost', 'bsschroe', 'hoyuelaa', 'villalb5', 'louis.ng.5015', 'gmaidan', 'huangj19', 'workuy', 'christopherodaniel', 'reddyeie', 'bertas', 'jensdriller', 'xli121', 'degracia', 'sharifs', 'mariaofrena', 'david.schmelz.1', 'aliserdary', 'ghulamhussain3994', 'nimo', 'alv7n', 'aurelien.david', 'sumitm']",112,"['amango4', 'aniruddhshivram', 'chong.gu.5', 'achoi121', 'kote.deepa', 'jiechen.wang7', 'cullenglasgow', 'yitaohuangnb', 'sarahresarf', 'dmcgovern88', 'jjiang14', 'lbward93', 'janeyoo34', 'firpo2', 'jmanand2', 'bcclanc2', 'masiyi9406', 'jmmille6', 'mrhennek', 'beng3', 'lolipopcarolwang', 'earthy', 'faizal2', 'palchec2', 'sage', 'mcheng94', 'antony.huang.129', 'wiieat.chen', 'ruining2', 'hlai7', 'abaddon2mist', 'mantianxue0101', 'lfirpo', 'bhanley2', 'dman5505', 'yyang132', 'csbaile2', 'pbhatta2', 'bpgolfguy92', 'eprzyby2', 'mkbaile2', 'elin11', 'gvelard2edu', 'jiechen94', 'dagapit2', 'will.j.mccracken', 'ntsherm2', 'jefrin', 'dwchris2', 'asimha2', 'yoo66', 'meher.bharucha', 'klwells2', 'qazyyc93', 'sho1123', 'toujours.meiling93', 'anna.mast2', 'junpeng.qiu', 'dyoon11', 'spshah6', 'simpkns2', 'billli1996', 'cory93', 'remlevin', 'adsnyde2', 'tjweber2', 'seanxyy0914', 'hmtaylo2', 'hankliu00', 'hylin2', 'isaacehoffman2', 'dkwok2', 'vivianzry92', 'lee895', 'zhensun5', 'myeoh2', 'dustin1', 'a.schleife', 'cledesma2331', 'spmurra2', 'jacobcamp1', 'kfeng', 'carolgu2', 'padget1', 'jake.kornacker', 'xiasang2', 'jwang182', 'yyang100', 'grober.dan', 'sguo12', 'ntxuby', 'melissagoetter', 'tara.cullerton', 'billli1997', 'allysonv10', 'a_kuzni2', 'wlarson2', 'slee342', 'qiujiezhao1994', 'kjcsport1', 'scpiper2', 'dpapanicolas', 'gsharma80', None, 'curtis.c.baker', 'salman2', 'jtcohen2', 'ahli2', 'schiavo1', 'me1291441', 'werkkdy2', 'knipfer2']",162,"['amango4', 'aniruddhshivram', 'chong.gu.5', 'achoi121', 'bfrandsen11', 'ocampor5', 'kote.deepa', 'solanos3', 'saleemhamady', 'jiechen.wang7', 'linchuck', 'cullenglasgow', 'unlvengineerj', 'anhphm', 'yitaohuangnb', 'sarahresarf', 'dmcgovern88', 'jjiang14', 'yyang10', 'lbward93', 'janeyoo34', 'prevosti', 'firpo2', 'jmanand2', 'bcclanc2', 'masiyi9406', 'gmaidan', 'huangj19', 'jmmille6', 'reddyeie', 'bertas', 'mrhennek', 'beng3', 'jensdriller', 'lolipopcarolwang', 'xli121', 'earthy', 'faizal2', 'palchec2', 'sage', 'mcheng94', 'antony.huang.129', 'wiieat.chen', 'ruining2', 'hlai7', 'abaddon2mist', 'mantianxue0101', 'lisen', 'lfirpo', 'bhanley2', 'dman5505', 'yyang132', 'csbaile2', 'sihuic35', 'pbhatta2', 'bpgolfguy92', 'eprzyby2', 'mkbaile2', 'elin11', 'spazos', 'gvelard2edu', 'jiechen94', 'giroolost', 'dagapit2', 'will.j.mccracken', 'bsschroe', 'ntsherm2', 'hoyuelaa', 'jefrin', 'villalb5', 'dwchris2', 'louis.ng.5015', 'asimha2', 'yoo66', 'meher.bharucha', 'klwells2', 'qazyyc93', 'sho1123', 'toujours.meiling93', 'mariaofrena', 'david.schmelz.1', 'anna.mast2', 'nimo', 'junpeng.qiu', 'dyoon11', 'spshah6', 'simpkns2', 'billli1996', 'eng.hend.fahmy', 'cory93', 'remlevin', 'adsnyde2', 'ian_ezequiel', 'jjvraja', 'tjweber2', 'maciasc4', 'angelaxbaby93', 'm18091990', 'seanxyy0914', 'pablogarrillo', 'andsmi', 'hmtaylo2', 'hankliu00', 'hylin2', 'lixiang12', 'isaacehoffman2', 'dkwok2', 'vivianzry92', 'lee895', 'zhensun5', 'myeoh2', 'dustin1', 'a.schleife', 'cledesma2331', 'workuy', 'spmurra2', 'jacobcamp1', 'kfeng', 'carolgu2', 'degracia', 'padget1', 'aliserdary', 'jake.kornacker', 'alv7n', 'aurelien.david', 'sumitm', 'aamirh.kth', 'xiasang2', 'jwang182', 'yyang100', 'grober.dan', 'sguo12', 'hasanphy88', 'ntxuby', 'melissagoetter', 'tara.cullerton', 'billli1997', 'chuanc', 'allysonv10', 'se299792458', 'a_kuzni2', 'lauraz', 'eloise.anguluan', 'wlarson2', 'slee342', 'qiujiezhao1994', 'kjcsport1', 'scpiper2', 'dpapanicolas', 'gsharma80', None, 'curtis.c.baker', 'salman2', 'christopherodaniel', 'jtcohen2', 'ahli2', 'schiavo1', 'sharifs', 'me1291441', 'ghulamhussain3994', 'werkkdy2', 'knipfer2']"
9,11,51,78,3,"['xli121', 'angelaxbaby93', 'yyang10']",47,"['aamirh.kth', 'eng.hend.fahmy', 'bfrandsen11', 'lisen', 'ocampor5', 'solanos3', 'saleemhamady', 'sihuic35', 'ian_ezequiel', 'jjvraja', 'linchuck', 'hasanphy88', 'unlvengineerj', 'maciasc4', 'anhphm', 'chuanc', 'm18091990', 'pablogarrillo', 'andsmi', 'se299792458', 'lauraz', 'eloise.anguluan', 'lixiang12', 'spazos', 'prevosti', 'giroolost', 'bsschroe', 'hoyuelaa', 'villalb5', 'louis.ng.5015', 'gmaidan', 'huangj19', 'workuy', 'christopherodaniel', 'reddyeie', 'bertas', 'jensdriller', 'degracia', 'sharifs', 'mariaofrena', 'david.schmelz.1', 'aliserdary', 'ghulamhussain3994', 'nimo', 'alv7n', 'aurelien.david', 'sumitm']",75,"['spshah6', 'amango4', 'ruining2', 'billli1996', 'achoi121', 'mantianxue0101', 'xiasang2', 'wem5637', 'cory93', 'remlevin', 'kote.deepa', 'lfirpo', 'dman5505', 'yyang132', 'csbaile2', 'ryba.konrad', 'pbhatta2', 'bpgolfguy92', 'grober.dan', 'eprzyby2', 'cullenglasgow', 'ntxuby', 'mkbaile2', 'melissagoetter', 'tjweber2', 'tara.cullerton', 'sarahresarf', 'jjiang14', 'hmtaylo2', 'allysonv10', 'ajgordon', 'lbward93', 'isaacehoffman2', 'hylin2', 'gvelard2edu', 'janeyoo34', 'dkwok2', 'kahill2', 'jiechen94', 'wlarson2', 'julia.zuo', 'dagapit2', 'kjcsport1', 'mikeandike5374', 'myeoh2', 'scpiper2', 'jeremy.chew', 'ntsherm2', 'jefrin', 'cledesma2331', 'dwchris2', 'masiyi9406', None, 'curtis.c.baker', 'jmmille6', 'meher.bharucha', 'klwells2', 'mrhennek', 'dlitt2', 'spmurra2', 'beng3', 'kfeng', 'jtcohen2', 'carolgu2', 'lolipopcarolwang', 'sho1123', 'earthy', 'ahli2', 'me1291441', 'hank.liu.180', 'palchec2', 'anna.mast2', 'jake.kornacker', 'werkkdy2', 'knipfer2']",125,"['amango4', 'achoi121', 'bfrandsen11', 'ocampor5', 'kote.deepa', 'solanos3', 'saleemhamady', 'linchuck', 'cullenglasgow', 'unlvengineerj', 'anhphm', 'sarahresarf', 'jjiang14', 'yyang10', 'lbward93', 'janeyoo34', 'prevosti', 'masiyi9406', 'gmaidan', 'huangj19', 'jmmille6', 'reddyeie', 'bertas', 'mrhennek', 'dlitt2', 'beng3', 'jensdriller', 'lolipopcarolwang', 'xli121', 'earthy', 'palchec2', 'ruining2', 'mantianxue0101', 'lisen', 'lfirpo', 'dman5505', 'yyang132', 'csbaile2', 'sihuic35', 'pbhatta2', 'bpgolfguy92', 'eprzyby2', 'mkbaile2', 'spazos', 'gvelard2edu', 'jiechen94', 'giroolost', 'dagapit2', 'jeremy.chew', 'bsschroe', 'ntsherm2', 'hoyuelaa', 'jefrin', 'villalb5', 'dwchris2', 'louis.ng.5015', 'meher.bharucha', 'klwells2', 'sho1123', 'mariaofrena', 'david.schmelz.1', 'anna.mast2', 'nimo', 'spshah6', 'billli1996', 'eng.hend.fahmy', 'cory93', 'remlevin', 'ian_ezequiel', 'jjvraja', 'tjweber2', 'maciasc4', 'angelaxbaby93', 'm18091990', 'pablogarrillo', 'andsmi', 'hmtaylo2', 'isaacehoffman2', 'lixiang12', 'hylin2', 'dkwok2', 'kahill2', 'julia.zuo', 'mikeandike5374', 'myeoh2', 'cledesma2331', 'workuy', 'spmurra2', 'kfeng', 'carolgu2', 'degracia', 'aliserdary', 'jake.kornacker', 'alv7n', 'aurelien.david', 'sumitm', 'aamirh.kth', 'xiasang2', 'wem5637', 'ryba.konrad', 'grober.dan', 'hasanphy88', 'ntxuby', 'melissagoetter', 'tara.cullerton', 'chuanc', 'allysonv10', 'ajgordon', 'se299792458', 'lauraz', 'eloise.anguluan', 'wlarson2', 'kjcsport1', 'scpiper2', None, 'curtis.c.baker', 'christopherodaniel', 'jtcohen2', 'ahli2', 'sharifs', 'me1291441', 'hank.liu.180', 'ghulamhussain3994', 'werkkdy2', 'knipfer2']"
9,7,51,21,11,"['huangj19', 'workuy', 'bertas', 'unlvengineerj', 'maciasc4', 'degracia', 'ocampor5', 'sharifs', 'solanos3', 'hoyuelaa', 'alv7n']",39,"['aamirh.kth', 'eng.hend.fahmy', 'bfrandsen11', 'lisen', 'saleemhamady', 'sihuic35', 'ian_ezequiel', 'jjvraja', 'linchuck', 'hasanphy88', 'anhphm', 'chuanc', 'angelaxbaby93', 'm18091990', 'pablogarrillo', 'andsmi', 'se299792458', 'yyang10', 'lauraz', 'eloise.anguluan', 'lixiang12', 'spazos', 'prevosti', 'giroolost', 'bsschroe', 'villalb5', 'louis.ng.5015', 'gmaidan', 'christopherodaniel', 'reddyeie', 'jensdriller', 'xli121', 'mariaofrena', 'david.schmelz.1', 'aliserdary', 'ghulamhussain3994', 'nimo', 'aurelien.david', 'sumitm']",10,"['guevaral', 'kaidazan', 'mezam11', 'alyson305', 'lih12', 'mookherj', 'starksa4', None, 'rasmus20', 'leungs']",60,"['aamirh.kth', 'eng.hend.fahmy', 'lisen', 'bfrandsen11', 'ocampor5', 'solanos3', 'saleemhamady', 'sihuic35', 'ian_ezequiel', 'jjvraja', 'linchuck', 'hasanphy88', 'unlvengineerj', 'kaidazan', 'lih12', 'maciasc4', 'anhphm', 'chuanc', 'angelaxbaby93', 'm18091990', 'pablogarrillo', 'andsmi', 'se299792458', 'yyang10', 'lauraz', 'eloise.anguluan', 'lixiang12', 'spazos', 'rasmus20', 'prevosti', 'giroolost', 'mezam11', 'leungs', 'mookherj', 'bsschroe', 'hoyuelaa', 'starksa4', 'villalb5', None, 'louis.ng.5015', 'gmaidan', 'huangj19', 'workuy', 'christopherodaniel', 'reddyeie', 'bertas', 'guevaral', 'jensdriller', 'alyson305', 'xli121', 'degracia', 'sharifs', 'mariaofrena', 'david.schmelz.1', 'aliserdary', 'ghulamhussain3994', 'nimo', 'alv7n', 'aurelien.david', 'sumitm']"
9,10,51,15,9,"['prevosti', 'sumitm', 'aamirh.kth', 'hasanphy88', 'sihuic35', 'anhphm', 'andsmi', 'lixiang12', 'louis.ng.5015']",41,"['eng.hend.fahmy', 'lisen', 'bfrandsen11', 'ocampor5', 'solanos3', 'saleemhamady', 'ian_ezequiel', 'jjvraja', 'linchuck', 'unlvengineerj', 'maciasc4', 'chuanc', 'angelaxbaby93', 'm18091990', 'pablogarrillo', 'yyang10', 'se299792458', 'lauraz', 'eloise.anguluan', 'spazos', 'giroolost', 'bsschroe', 'hoyuelaa', 'villalb5', 'gmaidan', 'huangj19', 'workuy', 'christopherodaniel', 'reddyeie', 'bertas', 'jensdriller', 'xli121', 'degracia', 'sharifs', 'mariaofrena', 'david.schmelz.1', 'aliserdary', 'ghulamhussain3994', 'nimo', 'alv7n', 'aurelien.david']",6,"['hfrancon', 'wilhelmpiao', 'matheus1618', 'jespersr', 'alaskalany', None]",56,"['aamirh.kth', 'matheus1618', 'eng.hend.fahmy', 'lisen', 'bfrandsen11', 'ocampor5', 'jespersr', 'solanos3', 'saleemhamady', 'sihuic35', 'ian_ezequiel', 'jjvraja', 'linchuck', 'hfrancon', 'hasanphy88', 'unlvengineerj', 'maciasc4', 'anhphm', 'chuanc', 'angelaxbaby93', 'm18091990', 'pablogarrillo', 'andsmi', 'se299792458', 'yyang10', 'lauraz', 'eloise.anguluan', 'lixiang12', 'spazos', 'prevosti', 'giroolost', 'bsschroe', 'hoyuelaa', 'alaskalany', 'villalb5', None, 'louis.ng.5015', 'gmaidan', 'huangj19', 'workuy', 'christopherodaniel', 'reddyeie', 'bertas', 'wilhelmpiao', 'jensdriller', 'xli121', 'degracia', 'sharifs', 'mariaofrena', 'david.schmelz.1', 'aliserdary', 'ghulamhussain3994', 'nimo', 'alv7n', 'aurelien.david', 'sumitm']"
9,72,51,15,1,['xli121'],49,"['aamirh.kth', 'eng.hend.fahmy', 'bfrandsen11', 'lisen', 'ocampor5', 'solanos3', 'saleemhamady', 'sihuic35', 'ian_ezequiel', 'jjvraja', 'linchuck', 'hasanphy88', 'unlvengineerj', 'maciasc4', 'anhphm', 'chuanc', 'angelaxbaby93', 'm18091990', 'pablogarrillo', 'andsmi', 'se299792458', 'yyang10', 'lauraz', 'eloise.anguluan', 'lixiang12', 'spazos', 'prevosti', 'giroolost', 'bsschroe', 'hoyuelaa', 'villalb5', 'louis.ng.5015', 'gmaidan', 'huangj19', 'workuy', 'christopherodaniel', 'reddyeie', 'bertas', 'jensdriller', 'degracia', 'sharifs', 'mariaofrena', 'david.schmelz.1', 'aliserdary', 'ghulamhussain3994', 'nimo', 'alv7n', 'aurelien.david', 'sumitm']",14,"['jmmille6', 'spmurra2', 'dlitt2', 'julia.zuo', 'sikaufm2', 'abaddon2mist', 'zhensun5', 'joonheekimk5', 'ahli2', 'a.schleife', 'bhanley2', 'anna.mast2', None, 'janeyoo34']",64,"['aamirh.kth', 'abaddon2mist', 'eng.hend.fahmy', 'lisen', 'bfrandsen11', 'ocampor5', 'solanos3', 'saleemhamady', 'bhanley2', 'sihuic35', 'ian_ezequiel', 'jjvraja', 'linchuck', 'hasanphy88', 'unlvengineerj', 'joonheekimk5', 'maciasc4', 'anhphm', 'chuanc', 'angelaxbaby93', 'm18091990', 'pablogarrillo', 'andsmi', 'se299792458', 'yyang10', 'lauraz', 'eloise.anguluan', 'lixiang12', 'spazos', 'janeyoo34', 'prevosti', 'giroolost', 'julia.zuo', 'sikaufm2', 'zhensun5', 'bsschroe', 'a.schleife', 'hoyuelaa', 'villalb5', 'anna.mast2', None, 'louis.ng.5015', 'gmaidan', 'huangj19', 'workuy', 'christopherodaniel', 'jmmille6', 'reddyeie', 'bertas', 'dlitt2', 'spmurra2', 'jensdriller', 'ahli2', 'xli121', 'degracia', 'sharifs', 'mariaofrena', 'david.schmelz.1', 'aliserdary', 'ghulamhussain3994', 'nimo', 'alv7n', 'aurelien.david', 'sumitm']"
9,9,51,14,8,"['workuy', 'unlvengineerj', 'villalb5', 'sharifs', 'm18091990', 'hoyuelaa', 'nimo', 'alv7n']",42,"['aamirh.kth', 'eng.hend.fahmy', 'bfrandsen11', 'lisen', 'ocampor5', 'solanos3', 'saleemhamady', 'sihuic35', 'ian_ezequiel', 'jjvraja', 'linchuck', 'hasanphy88', 'maciasc4', 'anhphm', 'chuanc', 'angelaxbaby93', 'pablogarrillo', 'andsmi', 'se299792458', 'yyang10', 'lauraz', 'eloise.anguluan', 'lixiang12', 'spazos', 'prevosti', 'giroolost', 'bsschroe', 'louis.ng.5015', 'gmaidan', 'huangj19', 'christopherodaniel', 'reddyeie', 'bertas', 'jensdriller', 'xli121', 'degracia', 'mariaofrena', 'david.schmelz.1', 'aliserdary', 'ghulamhussain3994', 'aurelien.david', 'sumitm']",6,"['guevaral', 'alyson305', 'mookherj', None, 'jkdeboy', 'rasmus20']",56,"['aamirh.kth', 'eng.hend.fahmy', 'lisen', 'bfrandsen11', 'ocampor5', 'solanos3', 'saleemhamady', 'sihuic35', 'ian_ezequiel', 'jjvraja', 'linchuck', 'hasanphy88', 'unlvengineerj', 'maciasc4', 'anhphm', 'chuanc', 'angelaxbaby93', 'm18091990', 'pablogarrillo', 'andsmi', 'se299792458', 'yyang10', 'lauraz', 'eloise.anguluan', 'lixiang12', 'spazos', 'rasmus20', 'prevosti', 'giroolost', 'mookherj', 'bsschroe', 'hoyuelaa', 'villalb5', None, 'jkdeboy', 'louis.ng.5015', 'gmaidan', 'huangj19', 'workuy', 'christopherodaniel', 'reddyeie', 'bertas', 'guevaral', 'jensdriller', 'alyson305', 'xli121', 'degracia', 'sharifs', 'mariaofrena', 'david.schmelz.1', 'aliserdary', 'ghulamhussain3994', 'nimo', 'alv7n', 'aurelien.david', 'sumitm']"
9,6,51,8,1,['david.schmelz.1'],49,"['aamirh.kth', 'eng.hend.fahmy', 'lisen', 'bfrandsen11', 'ocampor5', 'solanos3', 'saleemhamady', 'sihuic35', 'ian_ezequiel', 'jjvraja', 'linchuck', 'hasanphy88', 'unlvengineerj', 'maciasc4', 'anhphm', 'chuanc', 'angelaxbaby93', 'm18091990', 'pablogarrillo', 'andsmi', 'se299792458', 'yyang10', 'lauraz', 'eloise.anguluan', 'lixiang12', 'spazos', 'prevosti', 'giroolost', 'bsschroe', 'hoyuelaa', 'villalb5', 'louis.ng.5015', 'gmaidan', 'huangj19', 'workuy', 'christopherodaniel', 'reddyeie', 'bertas', 'jensdriller', 'xli121', 'degracia', 'sharifs', 'mariaofrena', 'aliserdary', 'ghulamhussain3994', 'nimo', 'alv7n', 'aurelien.david', 'sumitm']",7,"['timoneda1', 'raul.4.bcn', 'anna1494', 'alexistellovalero', 'ritasalavert9', 'derverwuenschte', None]",57,"['anna1494', 'aamirh.kth', 'eng.hend.fahmy', 'lisen', 'bfrandsen11', 'ocampor5', 'solanos3', 'saleemhamady', 'sihuic35', 'ian_ezequiel', 'jjvraja', 'linchuck', 'hasanphy88', 'unlvengineerj', 'alexistellovalero', 'maciasc4', 'anhphm', 'chuanc', 'angelaxbaby93', 'm18091990', 'pablogarrillo', 'andsmi', 'se299792458', 'yyang10', 'derverwuenschte', 'lauraz', 'eloise.anguluan', 'lixiang12', 'spazos', 'prevosti', 'giroolost', 'bsschroe', 'hoyuelaa', 'villalb5', None, 'louis.ng.5015', 'gmaidan', 'huangj19', 'timoneda1', 'workuy', 'christopherodaniel', 'raul.4.bcn', 'reddyeie', 'bertas', 'jensdriller', 'ritasalavert9', 'xli121', 'degracia', 'sharifs', 'mariaofrena', 'david.schmelz.1', 'aliserdary', 'ghulamhussain3994', 'nimo', 'alv7n', 'aurelien.david', 'sumitm']"
9,8,51,8,4,"['prevosti', 'lauraz', 'aamirh.kth', 'hasanphy88']",46,"['eng.hend.fahmy', 'lisen', 'bfrandsen11', 'ocampor5', 'solanos3', 'saleemhamady', 'sihuic35', 'ian_ezequiel', 'jjvraja', 'linchuck', 'unlvengineerj', 'maciasc4', 'anhphm', 'chuanc', 'angelaxbaby93', 'm18091990', 'pablogarrillo', 'andsmi', 'se299792458', 'yyang10', 'eloise.anguluan', 'lixiang12', 'spazos', 'giroolost', 'bsschroe', 'hoyuelaa', 'villalb5', 'louis.ng.5015', 'gmaidan', 'huangj19', 'workuy', 'christopherodaniel', 'reddyeie', 'bertas', 'jensdriller', 'xli121', 'degracia', 'sharifs', 'mariaofrena', 'david.schmelz.1', 'aliserdary', 'ghulamhussain3994', 'nimo', 'alv7n', 'aurelien.david', 'sumitm']",4,"['wilhelm.piao.3', None, 'wilhelmpiao', 'alaskalany']",54,"['aamirh.kth', 'eng.hend.fahmy', 'lisen', 'bfrandsen11', 'ocampor5', 'solanos3', 'saleemhamady', 'sihuic35', 'ian_ezequiel', 'jjvraja', 'linchuck', 'hasanphy88', 'unlvengineerj', 'wilhelm.piao.3', 'maciasc4', 'anhphm', 'chuanc', 'angelaxbaby93', 'm18091990', 'pablogarrillo', 'andsmi', 'se299792458', 'yyang10', 'lauraz', 'eloise.anguluan', 'lixiang12', 'spazos', 'prevosti', 'giroolost', 'bsschroe', 'hoyuelaa', 'alaskalany', 'villalb5', None, 'louis.ng.5015', 'gmaidan', 'huangj19', 'workuy', 'christopherodaniel', 'reddyeie', 'bertas', 'wilhelmpiao', 'jensdriller', 'xli121', 'degracia', 'sharifs', 'mariaofrena', 'david.schmelz.1', 'aliserdary', 'ghulamhussain3994', 'nimo', 'alv7n', 'aurelien.david', 'sumitm']"
9,73,51,7,1,['xli121'],49,"['aamirh.kth', 'eng.hend.fahmy', 'lisen', 'bfrandsen11', 'ocampor5', 'solanos3', 'saleemhamady', 'sihuic35', 'ian_ezequiel', 'jjvraja', 'linchuck', 'hasanphy88', 'unlvengineerj', 'maciasc4', 'anhphm', 'chuanc', 'angelaxbaby93', 'm18091990', 'pablogarrillo', 'andsmi', 'se299792458', 'yyang10', 'lauraz', 'eloise.anguluan', 'lixiang12', 'spazos', 'prevosti', 'giroolost', 'bsschroe', 'hoyuelaa', 'villalb5', 'louis.ng.5015', 'gmaidan', 'huangj19', 'workuy', 'christopherodaniel', 'reddyeie', 'bertas', 'jensdriller', 'degracia', 'sharifs', 'mariaofrena', 'david.schmelz.1', 'aliserdary', 'ghulamhussain3994', 'nimo', 'alv7n', 'aurelien.david', 'sumitm']",6,"['jmmille6', 'kuo20', 'dlitt2', 'julia.zuo', 'sikaufm2', None]",56,"['kuo20', 'aamirh.kth', 'eng.hend.fahmy', 'lisen', 'bfrandsen11', 'ocampor5', 'solanos3', 'saleemhamady', 'sihuic35', 'ian_ezequiel', 'jjvraja', 'linchuck', 'hasanphy88', 'unlvengineerj', 'maciasc4', 'anhphm', 'chuanc', 'angelaxbaby93', 'm18091990', 'pablogarrillo', 'andsmi', 'se299792458', 'yyang10', 'lauraz', 'eloise.anguluan', 'lixiang12', 'spazos', 'prevosti', 'giroolost', 'julia.zuo', 'sikaufm2', 'bsschroe', 'hoyuelaa', 'villalb5', None, 'louis.ng.5015', 'gmaidan', 'huangj19', 'workuy', 'christopherodaniel', 'jmmille6', 'reddyeie', 'bertas', 'dlitt2', 'jensdriller', 'xli121', 'degracia', 'sharifs', 'mariaofrena', 'david.schmelz.1', 'aliserdary', 'ghulamhussain3994', 'nimo', 'alv7n', 'aurelien.david', 'sumitm']"
10,250,42,28,22,"['ryan.farlow.31', 'awsmall', 'kjmirrie94', 'jongkindjoe', 'dkang4', 'ktsaud', 'jmalle10', 'jaingra2', 'dswarre2', 'camooney', 'tjoweida', 'kmfrink', 'yyue94', 'mpbenbow', 'markitislily', 'abbaldwi', 'jddicker', 'twaters10', 'kgmingay', 'memays2', 'edeaster', 'jtjordan']",19,"['graham.marshall.9889', 'daniellestallings4', 'john.paton.35', 'baldassari', 'bepeter2', 'eric.cooper.353250', 'gthauser', 'jlin16', 'gwcrego', 'bradytrev', 'wdcrumpl', 'cbdonohu', 'rjlarrab', 'elucas', 'zzfelemb', 'sandra.luginbuehl', 'jhgillen', 'amitiitg2011', 'cjm1379']",6,"['apkellih', 'secarmea', 'msmorave', 'sanielpatrickk', 'amfarrah', None]",47,"['graham.marshall.9889', 'ryan.farlow.31', 'daniellestallings4', 'awsmall', 'kjmirrie94', 'jongkindjoe', 'john.paton.35', 'bepeter2', 'baldassari', 'dkang4', 'amfarrah', 'eric.cooper.353250', 'ktsaud', 'jmalle10', 'jaingra2', 'gthauser', 'jlin16', 'dswarre2', 'tjoweida', 'camooney', 'kmfrink', 'yyue94', 'mpbenbow', 'markitislily', 'abbaldwi', 'bradytrev', 'gwcrego', 'secarmea', 'wdcrumpl', 'jddicker', 'cbdonohu', 'twaters10', 'memays2', 'rjlarrab', 'kgmingay', 'elucas', 'zzfelemb', None, 'apkellih', 'edeaster', 'msmorave', 'sanielpatrickk', 'sandra.luginbuehl', 'jtjordan', 'jhgillen', 'amitiitg2011', 'cjm1379']"
10,252,42,16,15,"['yyue94', 'graham.marshall.9889', 'bradytrev', 'daniellestallings4', 'gwcrego', 'wdcrumpl', 'jlin16', 'cbdonohu', 'john.paton.35', 'bepeter2', 'kgmingay', 'jhgillen', 'elucas', 'zzfelemb', 'rjlarrab']",26,"['ryan.farlow.31', 'awsmall', 'kjmirrie94', 'jongkindjoe', 'baldassari', 'dkang4', 'eric.cooper.353250', 'ktsaud', 'jmalle10', 'jaingra2', 'gthauser', 'dswarre2', 'tjoweida', 'camooney', 'kmfrink', 'mpbenbow', 'markitislily', 'abbaldwi', 'jddicker', 'twaters10', 'memays2', 'edeaster', 'sandra.luginbuehl', 'jtjordan', 'amitiitg2011', 'cjm1379']",1,[None],42,"['graham.marshall.9889', 'ryan.farlow.31', 'daniellestallings4', 'awsmall', 'kjmirrie94', 'jongkindjoe', 'john.paton.35', 'bepeter2', 'baldassari', 'dkang4', 'eric.cooper.353250', 'ktsaud', 'jmalle10', 'jaingra2', 'gthauser', 'jlin16', 'dswarre2', 'tjoweida', 'camooney', 'kmfrink', 'yyue94', 'mpbenbow', 'markitislily', 'abbaldwi', 'bradytrev', 'gwcrego', 'wdcrumpl', 'jddicker', 'cbdonohu', 'twaters10', 'memays2', 'rjlarrab', 'kgmingay', 'elucas', 'zzfelemb', None, 'edeaster', 'sandra.luginbuehl', 'jtjordan', 'jhgillen', 'amitiitg2011', 'cjm1379']"
10,249,42,10,6,"['awsmall', 'jaingra2', 'gthauser', 'jddicker', 'dswarre2', 'camooney']",35,"['ryan.farlow.31', 'graham.marshall.9889', 'daniellestallings4', 'kjmirrie94', 'jongkindjoe', 'john.paton.35', 'bepeter2', 'baldassari', 'dkang4', 'eric.cooper.353250', 'ktsaud', 'jmalle10', 'jlin16', 'tjoweida', 'kmfrink', 'yyue94', 'mpbenbow', 'markitislily', 'abbaldwi', 'bradytrev', 'gwcrego', 'wdcrumpl', 'cbdonohu', 'twaters10', 'memays2', 'rjlarrab', 'kgmingay', 'elucas', 'zzfelemb', 'edeaster', 'sandra.luginbuehl', 'jtjordan', 'jhgillen', 'amitiitg2011', 'cjm1379']",4,"['ryanmcpherson', None, 'funnywille', 'sarober4']",45,"['graham.marshall.9889', 'ryan.farlow.31', 'daniellestallings4', 'awsmall', 'kjmirrie94', 'jongkindjoe', 'funnywille', 'ryanmcpherson', 'john.paton.35', 'bepeter2', 'baldassari', 'dkang4', 'eric.cooper.353250', 'ktsaud', 'jmalle10', 'jaingra2', 'gthauser', 'jlin16', 'dswarre2', 'tjoweida', 'camooney', 'kmfrink', 'yyue94', 'mpbenbow', 'markitislily', 'abbaldwi', 'bradytrev', 'gwcrego', 'wdcrumpl', 'jddicker', 'cbdonohu', 'twaters10', 'memays2', 'rjlarrab', 'kgmingay', 'elucas', 'zzfelemb', None, 'sarober4', 'edeaster', 'sandra.luginbuehl', 'jtjordan', 'jhgillen', 'amitiitg2011', 'cjm1379']"
10,251,42,7,5,"['yyue94', 'daniellestallings4', 'cbdonohu', 'bepeter2', 'rjlarrab']",36,"['graham.marshall.9889', 'ryan.farlow.31', 'awsmall', 'kjmirrie94', 'jongkindjoe', 'john.paton.35', 'baldassari', 'dkang4', 'eric.cooper.353250', 'ktsaud', 'jmalle10', 'jaingra2', 'gthauser', 'jlin16', 'dswarre2', 'tjoweida', 'camooney', 'kmfrink', 'mpbenbow', 'markitislily', 'abbaldwi', 'bradytrev', 'gwcrego', 'wdcrumpl', 'jddicker', 'twaters10', 'memays2', 'kgmingay', 'elucas', 'zzfelemb', 'edeaster', 'sandra.luginbuehl', 'jtjordan', 'jhgillen', 'amitiitg2011', 'cjm1379']",2,"['abloutha', None]",43,"['graham.marshall.9889', 'ryan.farlow.31', 'daniellestallings4', 'awsmall', 'kjmirrie94', 'jongkindjoe', 'john.paton.35', 'bepeter2', 'baldassari', 'dkang4', 'eric.cooper.353250', 'ktsaud', 'jmalle10', 'jaingra2', 'gthauser', 'jlin16', 'dswarre2', 'tjoweida', 'camooney', 'kmfrink', 'abloutha', 'yyue94', 'mpbenbow', 'markitislily', 'abbaldwi', 'bradytrev', 'gwcrego', 'wdcrumpl', 'jddicker', 'cbdonohu', 'twaters10', 'memays2', 'rjlarrab', 'kgmingay', 'elucas', 'zzfelemb', None, 'edeaster', 'sandra.luginbuehl', 'jtjordan', 'jhgillen', 'amitiitg2011', 'cjm1379']"
11,96,39,33,26,"['wang1178', 'mtowers', 'lopez32', 'dblomek', 'obrien70', 'cdymond', 'port', 'liu991', 'kim1325', 'wang1640', 'pelaez204', 'jterrel', 'yohung777', 'kint', 'zhan1193', 'marti447', 'qlewis', 'jcompara', 'ckwok144', 'zeng31purdue', 'dragontnt0923', 'bkads1163', 'abcazaz22', 'rhein', 'rwilmes', 'pnoren']",12,"['butler34', 'yang463', 'xlbai725', 'lmiles93', 'johnhoojiahwan', 'duvall0', 'love20', 'sdeschai', 'soltys', 'egrendze', 'ccluhrs', 'song218']",7,"['hoikim91', 'davidjohnson', 'ben.helfrecht', 'jackie0212', 'cshang', 'mkatamba', None]",45,"['wang1178', 'mtowers', 'yang463', 'lopez32', 'dblomek', 'obrien70', 'port', 'liu991', 'cdymond', 'cshang', 'ccluhrs', 'song218', 'pelaez204', 'kim1325', 'butler34', 'wang1640', 'xlbai725', 'lmiles93', 'jterrel', 'yohung777', 'duvall0', 'love20', 'sdeschai', 'kint', 'zhan1193', 'marti447', 'qlewis', 'johnhoojiahwan', 'hoikim91', 'davidjohnson', 'ben.helfrecht', 'jcompara', 'ckwok144', 'zeng31purdue', 'soltys', 'mkatamba', None, 'dragontnt0923', 'bkads1163', 'abcazaz22', 'jackie0212', 'rhein', 'rwilmes', 'pnoren', 'egrendze']"
12,219,37,171,32,"['janewjp501', 'xiaozhouas', 'hhkkkxxx133', 'eya369', 'coleymei', 'rlmcdon2', 'june', 'aklaas2', 'cychan3', 'rishychacko', 'jfoyer2', 'andrumar10', 'lcheng12', 'matteo.hoch.1', 'aabi10', 'lin.joanna.y', 'shuoliu3', 'mrloube2', 'thexcguy', 'drennan1', 'coolcristobal', 'jmxscrs', 'wang.xiaohao.3', 'hjko0107', 'minsu.yu', 'dalong2', 'pablorosas', 'jbrown76', 'wyattsmcall1', 'prashramani12', 'd82232004', 'marjorie.dallmann']",4,"['gomezsa2', 'lukasz.kosakowski.7', 'muselolz', 'thomas.navidi']",139,"['yarrama2', 'boisver2', 'kote.deepa', 'andrewhowell', 'hzh631038469', 'pvuong3', 'peterwu2', 'nanohub77', 'vigneshka', 'yjiang71', 'ryanc', 'rdatta2', 'stanley0010703', 'rahul.bhatia.k', 'jochoe1', 'xxchriskimxx', 'svemulapati', 'tapeterson2', 'wonho.chungy', 'li160', 'dyangsteven', 'sauronalexander', 'jmmille6', 'mrhennek', 'paulmis2', 'mkersten', 'psroy2', 'langas2', 'mattfedd', 'pramesh2', 'lfirpo', 'njalexa2', 'csbaile2', 'han109', 'gabriel.su.7', 'kwh1210', 'deepakcmani', 'jp199275', 'rodrig67', 'ysheng5', 'shmeeel', 'kkoppula2', 'titusfong', 'michael.gao1', 'sataylor8', 'kakaxizhixin', 'sheelshah22', 'sulaimn2', 'sid.muthal', 'skong10', 'mohsaad', 'bababu', 'dtaylo21', 'cyim2', 'saurav.puri', 'didizuibang', 'yizhu3', 'cmschuetz', 'jtolin2', 'bluewaves3141', 'jkravitz61', 'lpfung2', 'iseri2', 'jchardy2', 'renagade4', 'sam.chuanxie', 'kloseliebej', 'jake.didier', 'icetree', 'ozoude2', 'intae12', 'rshah82', 'eli.longbottom', 'fhismail', 'melissacrawford396', 'bob.kummerer', 'adatia1', 'mjtomei', 'joseibert93', 'siddharth.bidasaria', 'yfang12', 'avandorn1', 'jaber2', 'lingyi.kong.5', 'haller2', 'julia.zuo', 'cookie.green.7798', 'cledesma2331', 'ashah13', 'dgardne2', 'obrzutkevin', 'frostybeverages', 'wratner', 'romanomatthew23', 'balsaofthespear', 'pschmid28', 'abhimanyu.khandelwal', 'cgooding1', 'akagti2', 'fliu14', 'ojoya24', 'shravan.gupta', 'hpark90', 'rstang2', 'sxu32', 'jagraha2', 'kaaere94', 'jjleigh2', 'ablandi2', 'ammartn3', 'vbahl2', 'jdolins2', 'tjroger2', 'samdawg', 'eperbohner', 'nbruck2', 'cmao3', 'gregorlax37', 'eric.ayala2', 'ducharm2', 'keward3', 'lucas.liu.3367', 'tkao4', 'luminoussky07', 'afscg', 'icyroderick', 'dpapanicolas', 'gsharma80', 'vinjamu2', 'kenned45', 'salman2', 'caily1995', 'koliva2', 'jtcohen2', 'jesse.w.gunderson', 'pandabrewski2', 'bhjhnsn2', 'chenxid', 'knipfer2']",175,"['rlmcdon2', 'yarrama2', 'aklaas2', 'boisver2', 'kote.deepa', 'andrewhowell', 'hzh631038469', 'pvuong3', 'peterwu2', 'nanohub77', 'vigneshka', 'yjiang71', 'ryanc', 'rdatta2', 'stanley0010703', 'rahul.bhatia.k', 'jochoe1', 'xxchriskimxx', 'mrloube2', 'svemulapati', 'tapeterson2', 'wonho.chungy', 'hjko0107', 'li160', 'pablorosas', 'dyangsteven', 'sauronalexander', 'jmmille6', 'mrhennek', 'wyattsmcall1', 'paulmis2', 'mkersten', 'muselolz', 'psroy2', 'langas2', 'mattfedd', 'pramesh2', 'lfirpo', 'njalexa2', 'gomezsa2', 'csbaile2', 'jfoyer2', 'rishychacko', 'han109', 'gabriel.su.7', 'kwh1210', 'deepakcmani', 'jp199275', 'lin.joanna.y', 'rodrig67', 'shuoliu3', 'ysheng5', 'shmeeel', 'drennan1', 'kkoppula2', 'titusfong', 'thomas.navidi', 'michael.gao1', 'sataylor8', 'kakaxizhixin', 'sheelshah22', 'sulaimn2', 'minsu.yu', 'dalong2', 'sid.muthal', 'skong10', 'mohsaad', 'bababu', 'dtaylo21', 'cyim2', 'prashramani12', 'saurav.puri', 'didizuibang', 'yizhu3', 'cmschuetz', 'xiaozhouas', 'hhkkkxxx133', 'eya369', 'coleymei', 'jtolin2', 'bluewaves3141', 'jkravitz61', 'lpfung2', 'iseri2', 'jchardy2', 'renagade4', 'sam.chuanxie', 'kloseliebej', 'jake.didier', 'icetree', 'ozoude2', 'intae12', 'rshah82', 'eli.longbottom', 'aabi10', 'fhismail', 'melissacrawford396', 'bob.kummerer', 'adatia1', 'mjtomei', 'joseibert93', 'lukasz.kosakowski.7', 'coolcristobal', 'siddharth.bidasaria', 'yfang12', 'avandorn1', 'jaber2', 'lingyi.kong.5', 'haller2', 'julia.zuo', 'cookie.green.7798', 'wang.xiaohao.3', 'cledesma2331', 'ashah13', 'jbrown76', 'dgardne2', 'obrzutkevin', 'frostybeverages', 'wratner', 'romanomatthew23', 'balsaofthespear', 'pschmid28', 'abhimanyu.khandelwal', 'cgooding1', 'akagti2', 'janewjp501', 'fliu14', 'ojoya24', 'shravan.gupta', 'hpark90', 'june', 'rstang2', 'cychan3', 'sxu32', 'jagraha2', 'kaaere94', 'jjleigh2', 'ablandi2', 'andrumar10', 'ammartn3', 'lcheng12', 'vbahl2', 'matteo.hoch.1', 'jdolins2', 'tjroger2', 'samdawg', 'eperbohner', 'nbruck2', 'cmao3', 'thexcguy', 'gregorlax37', 'eric.ayala2', 'jmxscrs', 'ducharm2', 'keward3', 'lucas.liu.3367', 'tkao4', 'luminoussky07', 'afscg', 'icyroderick', 'dpapanicolas', 'gsharma80', 'vinjamu2', 'kenned45', 'salman2', 'caily1995', 'koliva2', 'jtcohen2', 'jesse.w.gunderson', 'pandabrewski2', 'bhjhnsn2', 'd82232004', 'chenxid', 'knipfer2', 'marjorie.dallmann']"
12,153,37,100,1,['rishychacko'],35,"['janewjp501', 'xiaozhouas', 'hhkkkxxx133', 'eya369', 'coleymei', 'rlmcdon2', 'june', 'aklaas2', 'cychan3', 'gomezsa2', 'jfoyer2', 'andrumar10', 'lcheng12', 'matteo.hoch.1', 'aabi10', 'lin.joanna.y', 'shuoliu3', 'mrloube2', 'thexcguy', 'drennan1', 'coolcristobal', 'lukasz.kosakowski.7', 'jmxscrs', 'thomas.navidi', 'wang.xiaohao.3', 'hjko0107', 'minsu.yu', 'dalong2', 'pablorosas', 'jbrown76', 'wyattsmcall1', 'prashramani12', 'muselolz', 'd82232004', 'marjorie.dallmann']",99,"['yliu181', 'zwu27', 'dkuai2', 'sdschmi2', 'avelard2', 'hmajith2', 'cullenglasgow', 'cwojtan', 'cgu8', 'dli29', 'clopes2', 'frankkelly47', 'reisber2', 'adam.brown.39395033', 'pokhym', 'prandle2', 'qinglin2', 'sdhanak1', 'dlitt2', 'beng3', 'samsrajer', 'njamali2', 'jkim561', 'stephanieh', 'pierce.randle', 'mcheng94', 'antony.huang.129', 'ruining2', 'zhoffm', 'mantianxue0101', 'hhardin2', 'jonathan.lin.773', 'dman5505', 'deepakcmani', 'nocyama', 'pakelti2', 'mingye.gao', 'bshen9', 'kregel2', 'mchu5', 'jefrin', 'buhl2', 'amber.snil', 'shenxinrusue', 'asimha2', 'dshi10', 'sho1123', 'kagebei2', 'chunxu2', 'jaikarnik95', 'statar2', 'emfoley14', 'mlandi6', 'ecyoung', 'mpunuk', 'gracepakeltis', 'ywada3', 'jedrals2', 'myang39', 'julia.zuo', 'nlee17', 'zhensun5', 'alvinlvalysa', 'slbecke2', 'laurentaylor', 'ndunlap2', 'talee3', 'jacobcamp1', 'shirley123xiong', 'jylin4', 'khuang31', 'szhang87', 'yyao13', 'lachwsk2', 'dchlebek2', 'warpins2', '17staru', 'gooneti2', 'zhanshi', 'crosent2', 'grober.dan', 'ntxuby', 'melissagoetter', 'a_kuzni2', 'tianshu2', 'shoppe2', 'naveedjamali7', 'hzhou30', 'dpapanicolas', 'gsharma80', None, 'adiassasino', 'ajwisni2', 'ed.tir.1', 'eaallen', 'schiavo1', 'me1291441', 'sali12', 'whu14']",135,"['yliu181', 'rlmcdon2', 'aklaas2', 'zwu27', 'dkuai2', 'sdschmi2', 'avelard2', 'hmajith2', 'cullenglasgow', 'cwojtan', 'cgu8', 'dli29', 'clopes2', 'frankkelly47', 'mrloube2', 'reisber2', 'hjko0107', 'adam.brown.39395033', 'pablorosas', 'prandle2', 'pokhym', 'qinglin2', 'sdhanak1', 'dlitt2', 'wyattsmcall1', 'beng3', 'muselolz', 'samsrajer', 'njamali2', 'stephanieh', 'jkim561', 'pierce.randle', 'mcheng94', 'antony.huang.129', 'ruining2', 'zhoffm', 'mantianxue0101', 'hhardin2', 'jonathan.lin.773', 'gomezsa2', 'dman5505', 'jfoyer2', 'rishychacko', 'deepakcmani', 'nocyama', 'lin.joanna.y', 'pakelti2', 'shuoliu3', 'drennan1', 'mingye.gao', 'thomas.navidi', 'bshen9', 'kregel2', 'mchu5', 'jefrin', 'minsu.yu', 'buhl2', 'dalong2', 'amber.snil', 'shenxinrusue', 'asimha2', 'prashramani12', 'dshi10', 'sho1123', 'kagebei2', 'chunxu2', 'xiaozhouas', 'hhkkkxxx133', 'eya369', 'coleymei', 'jaikarnik95', 'statar2', 'emfoley14', 'mlandi6', 'ecyoung', 'mpunuk', 'aabi10', 'gracepakeltis', 'ywada3', 'jedrals2', 'lukasz.kosakowski.7', 'coolcristobal', 'myang39', 'julia.zuo', 'nlee17', 'zhensun5', 'alvinlvalysa', 'wang.xiaohao.3', 'slbecke2', 'laurentaylor', 'ndunlap2', 'talee3', 'jbrown76', 'jacobcamp1', 'shirley123xiong', 'jylin4', 'khuang31', 'szhang87', 'yyao13', 'janewjp501', 'lachwsk2', 'dchlebek2', 'june', 'warpins2', 'cychan3', '17staru', 'gooneti2', 'zhanshi', 'crosent2', 'andrumar10', 'lcheng12', 'matteo.hoch.1', 'grober.dan', 'ntxuby', 'melissagoetter', 'thexcguy', 'a_kuzni2', 'tianshu2', 'shoppe2', 'naveedjamali7', 'hzhou30', 'jmxscrs', 'dpapanicolas', 'gsharma80', None, 'adiassasino', 'ajwisni2', 'ed.tir.1', 'eaallen', 'schiavo1', 'me1291441', 'sali12', 'd82232004', 'whu14', 'marjorie.dallmann']"
12,37,37,40,31,"['janewjp501', 'xiaozhouas', 'hhkkkxxx133', 'eya369', 'coleymei', 'rlmcdon2', 'june', 'aklaas2', 'cychan3', 'gomezsa2', 'rishychacko', 'jfoyer2', 'andrumar10', 'lcheng12', 'matteo.hoch.1', 'aabi10', 'lin.joanna.y', 'shuoliu3', 'mrloube2', 'thexcguy', 'drennan1', 'coolcristobal', 'jmxscrs', 'wang.xiaohao.3', 'minsu.yu', 'dalong2', 'jbrown76', 'wyattsmcall1', 'prashramani12', 'd82232004', 'marjorie.dallmann']",5,"['pablorosas', 'thomas.navidi', 'muselolz', 'hjko0107', 'lukasz.kosakowski.7']",9,"['avandorn1', 'bababu', 'mrhennek', 'fhismail', 'kote.deepa', 'dvnguye2', 'dpapanicolas', 'csbaile2', None]",45,"['janewjp501', 'xiaozhouas', 'hhkkkxxx133', 'eya369', 'coleymei', 'rlmcdon2', 'june', 'aklaas2', 'cychan3', 'kote.deepa', 'dvnguye2', 'gomezsa2', 'csbaile2', 'jfoyer2', 'rishychacko', 'andrumar10', 'lcheng12', 'matteo.hoch.1', 'aabi10', 'fhismail', 'lin.joanna.y', 'shuoliu3', 'mrloube2', 'thexcguy', 'drennan1', 'coolcristobal', 'lukasz.kosakowski.7', 'avandorn1', 'jmxscrs', 'thomas.navidi', 'wang.xiaohao.3', 'hjko0107', 'minsu.yu', 'dpapanicolas', 'dalong2', 'pablorosas', None, 'jbrown76', 'bababu', 'mrhennek', 'wyattsmcall1', 'prashramani12', 'muselolz', 'd82232004', 'marjorie.dallmann']"
13,253,36,28,24,"['marco_347', 'giu.meuli', 'guillaume_bonnet_93', 'lefechristopher', 'emhya', 'francescomanegatti92', 'luca92.petit', 'lu.iglesiash', 'gianmarcodelbono', 'antea.risso', 'ivan.nyhanitra', 'simonadalmasso', 'amira.bencherif', 'marco92', 'mahas', 'maryam.massouras', 'alessio.fragasso', 'chiararossi1993', 'lorenzo.meraldi', 'mastari.marouane', 'aalexis78', 'robin.didier', 'peppe91', 'victoria.mishukova']",11,"['deea', 'omid.tayefeh', 'mlodge', 'kristina.prudnikova.5', 'stephenkenny', 'tristan.c.zhao', 'alessandrof', 'nparson', 'hkpoffon', 'drunkenborat', 'alingaraju']",4,"['joelchevrier', None, 'raymenae', 'simeonipietro']",39,"['marco_347', 'giu.meuli', 'mlodge', 'joelchevrier', 'guillaume_bonnet_93', 'lefechristopher', 'tristan.c.zhao', 'emhya', 'francescomanegatti92', 'luca92.petit', 'lu.iglesiash', 'deea', 'gianmarcodelbono', 'antea.risso', 'ivan.nyhanitra', 'stephenkenny', 'nparson', 'hkpoffon', 'simonadalmasso', 'amira.bencherif', 'marco92', 'mahas', 'maryam.massouras', 'raymenae', 'kristina.prudnikova.5', 'alessio.fragasso', 'chiararossi1993', 'lorenzo.meraldi', 'mastari.marouane', None, 'drunkenborat', 'aalexis78', 'alingaraju', 'robin.didier', 'simeonipietro', 'omid.tayefeh', 'peppe91', 'alessandrof', 'victoria.mishukova']"
14,137,31,27,26,"['ewbruns', 'rachel.philiph', 'srconn', 'gjandersen', 'aoser', 'bdmich', 'renchenhao', 'jkuderer', 'zradecki', 'jritland', 'jrcollier14', 'jchammen', 'mitchellrainey', 'jaweber93', 'joeregen', 'zbylicki', 'max.wood.58', 'that.one.kid.robin', 'ryanwalk', 'noel.aguirre.96', 'jwvetter', 'pawilson', 'xinhangs', 'samdamandias', 'zhuqingl', 'ben.waldschmitt']",4,"['stehvin', 'jjsmith6', 'khalamri', 'jjwicks']",1,[None],31,"['ewbruns', 'rachel.philiph', 'gjandersen', 'srconn', 'aoser', 'bdmich', 'renchenhao', 'jkuderer', 'zradecki', 'jritland', 'jjsmith6', 'jrcollier14', 'jchammen', 'mitchellrainey', 'jaweber93', 'joeregen', 'zbylicki', 'stehvin', 'max.wood.58', 'that.one.kid.robin', 'ryanwalk', 'noel.aguirre.96', 'jwvetter', 'pawilson', 'khalamri', None, 'xinhangs', 'jjwicks', 'samdamandias', 'zhuqingl', 'ben.waldschmitt']"
15,32,31,32,14,"['gr4viton', 'xhavel04', 'vetrelec', 'dusouuaa', 'mahor12', 'chlad.miloslav', 'dohnalosobni', 'radek1234', 'xkrasn04', 'martin.stusek', 'xhulav00', 'rhrdina', 'dubrma', 'xdusek19']",16,"['xkopul02', 'chlupatej', 'kalab', 'zdenek.hrebicek', 'aspektxxx', 'xskals01', 'zoidbergus', 'lukas.janic', 'markoshappy001', 'xhajek29', 'peterson91x', 'xwalte01', 'josip23', '36tiger63', 'kapoo', 'd.pamanek']",18,"['jakub.kastner.79', 'sfence', 'xkrejs02', 'ondrejpijacek', 'xnohaj00', 'xbarin06', 'xvozar02', 'coarser', 'lucky99', 'xvasko09', 'xmucha05', 'xtesar27', 'dudamichal1992', 'vojta.moravec', 'dddddaviddddd', 'martin7334', None, 'budysvk']",48,"['gr4viton', 'jakub.kastner.79', 'xnohaj00', 'kalab', 'vetrelec', 'aspektxxx', 'chlad.miloslav', 'xvozar02', 'xvasko09', 'kapoo', '36tiger63', 'martin.stusek', 'vojta.moravec', 'xhulav00', 'dusouuaa', 'zdenek.hrebicek', 'xskals01', 'zoidbergus', 'lukas.janic', 'markoshappy001', 'xhajek29', 'xmucha05', 'xtesar27', 'd.pamanek', 'rhrdina', 'sfence', 'xkrejs02', 'peterson91x', 'radek1234', 'dddddaviddddd', 'dubrma', None, 'xdusek19', 'xkopul02', 'chlupatej', 'xhavel04', 'ondrejpijacek', 'xbarin06', 'mahor12', 'coarser', 'dohnalosobni', 'lucky99', 'xwalte01', 'josip23', 'xkrasn04', 'dudamichal1992', 'martin7334', 'budysvk']"
15,107,31,32,15,"['gr4viton', 'chlupatej', 'xhavel04', 'vetrelec', 'dusouuaa', 'mahor12', 'chlad.miloslav', 'zoidbergus', 'xhajek29', 'radek1234', 'xkrasn04', 'martin.stusek', 'xhulav00', 'rhrdina', 'xdusek19']",15,"['xkopul02', 'kalab', 'zdenek.hrebicek', 'aspektxxx', 'xskals01', 'markoshappy001', 'lukas.janic', 'dohnalosobni', 'peterson91x', 'xwalte01', 'josip23', '36tiger63', 'kapoo', 'd.pamanek', 'dubrma']",17,"['xkrcma12', 'sfence', 'elektronix', 'xkrejs02', 'xbarin06', 'xnohaj00', 'xvalik00', 'vojtisek', 'xbosti03', 'springer.radek', 'xsebes15', 'coarser', 'lucky99', 'honza03', 'junekji', 'johnymichal', None]",47,"['gr4viton', 'xkrcma12', 'xnohaj00', 'kalab', 'xvalik00', 'vetrelec', 'springer.radek', 'aspektxxx', 'chlad.miloslav', 'xsebes15', 'kapoo', '36tiger63', 'martin.stusek', 'xhulav00', 'vojtisek', 'dusouuaa', 'zdenek.hrebicek', 'xskals01', 'zoidbergus', 'lukas.janic', 'markoshappy001', 'xhajek29', 'johnymichal', 'd.pamanek', 'rhrdina', 'sfence', 'xkrejs02', 'xbosti03', 'peterson91x', 'radek1234', 'honza03', 'junekji', 'dubrma', None, 'xdusek19', 'xkopul02', 'elektronix', 'chlupatej', 'xhavel04', 'xbarin06', 'mahor12', 'coarser', 'dohnalosobni', 'lucky99', 'xwalte01', 'josip23', 'xkrasn04']"
15,46,31,31,14,"['gr4viton', 'xhavel04', 'vetrelec', 'dusouuaa', 'mahor12', 'chlad.miloslav', 'zoidbergus', 'dohnalosobni', 'xhajek29', 'radek1234', 'martin.stusek', 'xhulav00', 'rhrdina', 'xdusek19']",16,"['xkopul02', 'chlupatej', 'kalab', 'zdenek.hrebicek', 'aspektxxx', 'xskals01', 'markoshappy001', 'lukas.janic', 'peterson91x', 'xwalte01', 'josip23', '36tiger63', 'kapoo', 'xkrasn04', 'd.pamanek', 'dubrma']",17,"['johnymichal', 'gottwald9', 'xkrejs02', 'elektronix', 'xnohaj00', 'martin7334', 'xsebes15', 'justme', None, 'coarser', 'lebeda', 'dudamichal1992', 'xtesar27', 'tomasjasnu', 'martin666', 'vojta.moravec', 'nomad.007']",47,"['gr4viton', 'xnohaj00', 'kalab', 'vetrelec', 'xsebes15', 'aspektxxx', 'chlad.miloslav', 'kapoo', '36tiger63', 'martin.stusek', 'vojta.moravec', 'xhulav00', 'martin666', 'dusouuaa', 'zdenek.hrebicek', 'xskals01', 'zoidbergus', 'lukas.janic', 'markoshappy001', 'xhajek29', 'xtesar27', 'johnymichal', 'd.pamanek', 'rhrdina', 'nomad.007', 'gottwald9', 'xkrejs02', 'peterson91x', 'radek1234', 'lebeda', 'tomasjasnu', 'dubrma', None, 'xdusek19', 'xkopul02', 'elektronix', 'chlupatej', 'xhavel04', 'mahor12', 'justme', 'coarser', 'dohnalosobni', 'xwalte01', 'josip23', 'xkrasn04', 'dudamichal1992', 'martin7334']"
15,44,31,27,14,"['gr4viton', 'xkopul02', 'kalab', 'zdenek.hrebicek', 'aspektxxx', 'xskals01', 'markoshappy001', 'lukas.janic', 'peterson91x', 'xwalte01', 'josip23', '36tiger63', 'kapoo', 'dubrma']",16,"['chlupatej', 'xhavel04', 'vetrelec', 'dusouuaa', 'mahor12', 'chlad.miloslav', 'zoidbergus', 'dohnalosobni', 'xhajek29', 'radek1234', 'xkrasn04', 'martin.stusek', 'd.pamanek', 'xhulav00', 'rhrdina', 'xdusek19']",13,"['lorant124', 'ondrejpijacek', 'xnguyz07', 'martintatak', 'kozmos', 'xvasko09', 'xkondl', 'detroitracer', 'jan.machacek.12', 'richardjanac', 'xlefle00', 'mmod', None]",43,"['gr4viton', 'kalab', 'vetrelec', 'aspektxxx', 'chlad.miloslav', 'xvasko09', 'kapoo', '36tiger63', 'martin.stusek', 'richardjanac', 'xlefle00', 'xhulav00', 'dusouuaa', 'zdenek.hrebicek', 'xskals01', 'zoidbergus', 'lukas.janic', 'markoshappy001', 'martintatak', 'xhajek29', 'mmod', 'lorant124', 'd.pamanek', 'rhrdina', 'xnguyz07', 'kozmos', 'xkondl', 'peterson91x', 'radek1234', 'dubrma', None, 'xdusek19', 'xkopul02', 'chlupatej', 'xhavel04', 'ondrejpijacek', 'mahor12', 'dohnalosobni', 'detroitracer', 'jan.machacek.12', 'xwalte01', 'josip23', 'xkrasn04']"
15,199,31,27,13,"['xkopul02', 'kalab', 'aspektxxx', 'xskals01', 'markoshappy001', 'lukas.janic', 'peterson91x', 'xwalte01', 'josip23', '36tiger63', 'kapoo', 'd.pamanek', 'dubrma']",17,"['gr4viton', 'chlupatej', 'xhavel04', 'vetrelec', 'dusouuaa', 'zdenek.hrebicek', 'chlad.miloslav', 'zoidbergus', 'mahor12', 'dohnalosobni', 'xhajek29', 'radek1234', 'xkrasn04', 'martin.stusek', 'xhulav00', 'rhrdina', 'xdusek19']",14,"['alien007', 'sedlons451', 'sodyn', 'xnguyz07', 'dddddaviddddd', 'asterixias', 'ondrejpijacek', 'xvozar02', 'xkondl', 'detroitracer', 'jan.machacek.12', 'xmucha05', 'mmod', None]",44,"['gr4viton', 'alien007', 'kalab', 'vetrelec', 'aspektxxx', 'chlad.miloslav', 'xvozar02', 'kapoo', '36tiger63', 'martin.stusek', 'xhulav00', 'dusouuaa', 'zdenek.hrebicek', 'xskals01', 'zoidbergus', 'lukas.janic', 'markoshappy001', 'xhajek29', 'xmucha05', 'mmod', 'd.pamanek', 'rhrdina', 'sodyn', 'xnguyz07', 'xkondl', 'peterson91x', 'radek1234', 'dddddaviddddd', 'dubrma', None, 'xdusek19', 'xkopul02', 'sedlons451', 'chlupatej', 'xhavel04', 'asterixias', 'ondrejpijacek', 'mahor12', 'dohnalosobni', 'detroitracer', 'jan.machacek.12', 'xwalte01', 'josip23', 'xkrasn04']"
15,201,31,25,8,"['xhavel04', 'dusouuaa', 'mahor12', 'xhajek29', 'radek1234', 'xkrasn04', 'martin.stusek', 'xdusek19']",22,"['gr4viton', 'kalab', 'vetrelec', 'aspektxxx', 'chlad.miloslav', 'kapoo', '36tiger63', 'xhulav00', 'zdenek.hrebicek', 'xskals01', 'zoidbergus', 'lukas.janic', 'markoshappy001', 'd.pamanek', 'rhrdina', 'peterson91x', 'dubrma', 'xkopul02', 'chlupatej', 'dohnalosobni', 'xwalte01', 'josip23']",17,"['xkrcma12', 'xzmesk04', 'sfence', 'xarbos', 'elektronix', 'xnohaj00', 'xbarin06', 'nomaxx', 'coarser', 'lucky99', 'xjelin36', 'dudamichal1992', 'xtesar27', None, 'vojta.moravec', 'nomad.007', 'budysvk']",47,"['gr4viton', 'xkrcma12', 'xnohaj00', 'kalab', 'vetrelec', 'aspektxxx', 'chlad.miloslav', 'kapoo', '36tiger63', 'martin.stusek', 'vojta.moravec', 'xhulav00', 'dusouuaa', 'zdenek.hrebicek', 'xskals01', 'zoidbergus', 'lukas.janic', 'markoshappy001', 'nomaxx', 'xhajek29', 'xtesar27', 'd.pamanek', 'rhrdina', 'nomad.007', 'xzmesk04', 'sfence', 'peterson91x', 'radek1234', 'dubrma', None, 'xdusek19', 'xkopul02', 'xarbos', 'chlupatej', 'xhavel04', 'elektronix', 'xbarin06', 'mahor12', 'coarser', 'dohnalosobni', 'lucky99', 'xwalte01', 'josip23', 'xkrasn04', 'xjelin36', 'dudamichal1992', 'budysvk']"
15,106,31,19,11,"['xkopul02', 'kalab', 'zdenek.hrebicek', 'xskals01', 'markoshappy001', 'lukas.janic', 'peterson91x', 'josip23', '36tiger63', 'kapoo', 'd.pamanek']",19,"['gr4viton', 'vetrelec', 'aspektxxx', 'chlad.miloslav', 'martin.stusek', 'xhulav00', 'dusouuaa', 'zoidbergus', 'xhajek29', 'rhrdina', 'radek1234', 'dubrma', 'xdusek19', 'chlupatej', 'xhavel04', 'mahor12', 'dohnalosobni', 'xwalte01', 'xkrasn04']",8,"['petr.stastny.94', 'martintatak', 'machacek.jan2', 'kozmos', 'demeter.kykolka', 'richardjanac', 'mmod', None]",38,"['gr4viton', 'kalab', 'vetrelec', 'aspektxxx', 'chlad.miloslav', 'demeter.kykolka', 'kapoo', '36tiger63', 'martin.stusek', 'richardjanac', 'xhulav00', 'dusouuaa', 'zdenek.hrebicek', 'xskals01', 'zoidbergus', 'lukas.janic', 'markoshappy001', 'martintatak', 'xhajek29', 'machacek.jan2', 'mmod', 'd.pamanek', 'rhrdina', 'kozmos', 'peterson91x', 'radek1234', 'dubrma', None, 'xdusek19', 'xkopul02', 'chlupatej', 'xhavel04', 'petr.stastny.94', 'mahor12', 'dohnalosobni', 'xwalte01', 'josip23', 'xkrasn04']"
15,31,31,16,9,"['zdenek.hrebicek', 'aspektxxx', 'xskals01', 'peterson91x', 'xwalte01', 'josip23', 'kapoo', '36tiger63', 'd.pamanek']",21,"['gr4viton', 'kalab', 'vetrelec', 'chlad.miloslav', 'martin.stusek', 'xhulav00', 'dusouuaa', 'zoidbergus', 'lukas.janic', 'markoshappy001', 'xhajek29', 'rhrdina', 'radek1234', 'dubrma', 'xdusek19', 'xkopul02', 'chlupatej', 'xhavel04', 'mahor12', 'dohnalosobni', 'xkrasn04']",7,"['alien007', 'sedlons451', 'detroitracer', 'demeter.kykolka', 'lvenkrbec', 'xlefle00', None]",37,"['gr4viton', 'alien007', 'kalab', 'vetrelec', 'aspektxxx', 'chlad.miloslav', 'demeter.kykolka', 'kapoo', '36tiger63', 'martin.stusek', 'xlefle00', 'xhulav00', 'dusouuaa', 'zdenek.hrebicek', 'xskals01', 'zoidbergus', 'lukas.janic', 'markoshappy001', 'xhajek29', 'lvenkrbec', 'd.pamanek', 'rhrdina', 'peterson91x', 'radek1234', 'dubrma', None, 'xdusek19', 'xkopul02', 'sedlons451', 'chlupatej', 'xhavel04', 'mahor12', 'dohnalosobni', 'detroitracer', 'xwalte01', 'josip23', 'xkrasn04']"
15,210,31,16,11,"['gr4viton', 'aspektxxx', 'xskals01', 'markoshappy001', 'lukas.janic', 'peterson91x', 'xwalte01', 'kapoo', '36tiger63', 'd.pamanek', 'dubrma']",19,"['kalab', 'vetrelec', 'chlad.miloslav', 'martin.stusek', 'xhulav00', 'dusouuaa', 'zdenek.hrebicek', 'zoidbergus', 'xhajek29', 'rhrdina', 'radek1234', 'xdusek19', 'xkopul02', 'chlupatej', 'xhavel04', 'mahor12', 'dohnalosobni', 'josip23', 'xkrasn04']",5,"['sodyn', 'geralt.v.rivia', 'xkondl', 'xmucha05', None]",35,"['gr4viton', 'kalab', 'vetrelec', 'aspektxxx', 'chlad.miloslav', 'kapoo', '36tiger63', 'martin.stusek', 'xhulav00', 'dusouuaa', 'zdenek.hrebicek', 'xskals01', 'zoidbergus', 'lukas.janic', 'markoshappy001', 'xhajek29', 'xmucha05', 'd.pamanek', 'rhrdina', 'sodyn', 'xkondl', 'peterson91x', 'radek1234', 'dubrma', None, 'xdusek19', 'xkopul02', 'chlupatej', 'xhavel04', 'mahor12', 'dohnalosobni', 'xwalte01', 'josip23', 'xkrasn04', 'geralt.v.rivia']"
15,206,31,13,9,"['aspektxxx', 'xskals01', 'lukas.janic', 'peterson91x', 'xwalte01', 'kapoo', '36tiger63', 'd.pamanek', 'dubrma']",21,"['gr4viton', 'kalab', 'vetrelec', 'chlad.miloslav', 'martin.stusek', 'xhulav00', 'dusouuaa', 'zdenek.hrebicek', 'zoidbergus', 'markoshappy001', 'xhajek29', 'rhrdina', 'radek1234', 'xdusek19', 'xkopul02', 'chlupatej', 'xhavel04', 'mahor12', 'dohnalosobni', 'josip23', 'xkrasn04']",4,"['geralt.v.rivia', None, 'xmucha05', 'sodyn']",34,"['gr4viton', 'kalab', 'vetrelec', 'aspektxxx', 'chlad.miloslav', 'kapoo', '36tiger63', 'martin.stusek', 'xhulav00', 'dusouuaa', 'zdenek.hrebicek', 'xskals01', 'zoidbergus', 'lukas.janic', 'markoshappy001', 'xhajek29', 'xmucha05', 'd.pamanek', 'rhrdina', 'sodyn', 'peterson91x', 'radek1234', 'dubrma', None, 'xdusek19', 'xkopul02', 'chlupatej', 'xhavel04', 'mahor12', 'dohnalosobni', 'xwalte01', 'josip23', 'xkrasn04', 'geralt.v.rivia']"
15,211,31,13,4,"['xhajek29', 'rhrdina', 'chlad.miloslav', 'zoidbergus']",26,"['gr4viton', 'kalab', 'vetrelec', 'aspektxxx', 'kapoo', '36tiger63', 'martin.stusek', 'xhulav00', 'dusouuaa', 'zdenek.hrebicek', 'xskals01', 'markoshappy001', 'lukas.janic', 'd.pamanek', 'peterson91x', 'radek1234', 'dubrma', 'xdusek19', 'xkopul02', 'chlupatej', 'xhavel04', 'mahor12', 'dohnalosobni', 'xwalte01', 'josip23', 'xkrasn04']",9,"['sfence', 'xarbos', 'xnohaj00', 'coarser', 'xzahra18', 'dudamichal1992', 'lebeda', 'vojta.moravec', None]",39,"['gr4viton', 'xnohaj00', 'kalab', 'vetrelec', 'aspektxxx', 'chlad.miloslav', 'xzahra18', 'kapoo', '36tiger63', 'martin.stusek', 'vojta.moravec', 'xhulav00', 'dusouuaa', 'zdenek.hrebicek', 'xskals01', 'zoidbergus', 'lukas.janic', 'markoshappy001', 'xhajek29', 'd.pamanek', 'rhrdina', 'sfence', 'peterson91x', 'radek1234', 'lebeda', 'dubrma', None, 'xdusek19', 'xkopul02', 'xarbos', 'chlupatej', 'xhavel04', 'mahor12', 'coarser', 'dohnalosobni', 'xwalte01', 'josip23', 'xkrasn04', 'dudamichal1992']"
15,207,31,9,4,"['xkopul02', 'zdenek.hrebicek', 'josip23', 'kalab']",26,"['gr4viton', 'vetrelec', 'aspektxxx', 'chlad.miloslav', 'kapoo', '36tiger63', 'martin.stusek', 'xhulav00', 'dusouuaa', 'xskals01', 'zoidbergus', 'lukas.janic', 'markoshappy001', 'xhajek29', 'd.pamanek', 'rhrdina', 'peterson91x', 'radek1234', 'dubrma', 'xdusek19', 'chlupatej', 'xhavel04', 'mahor12', 'dohnalosobni', 'xwalte01', 'xkrasn04']",5,"['lorant124', 'richardjanac', 'xlefle00', 'dddddaviddddd', None]",35,"['gr4viton', 'kalab', 'vetrelec', 'aspektxxx', 'chlad.miloslav', 'kapoo', '36tiger63', 'martin.stusek', 'richardjanac', 'xlefle00', 'xhulav00', 'dusouuaa', 'zdenek.hrebicek', 'xskals01', 'zoidbergus', 'lukas.janic', 'markoshappy001', 'xhajek29', 'lorant124', 'd.pamanek', 'rhrdina', 'peterson91x', 'radek1234', 'dddddaviddddd', 'dubrma', None, 'xdusek19', 'xkopul02', 'chlupatej', 'xhavel04', 'mahor12', 'dohnalosobni', 'xwalte01', 'josip23', 'xkrasn04']"
15,209,31,7,5,"['xhavel04', 'dohnalosobni', 'radek1234', 'xkrasn04', 'xdusek19']",25,"['gr4viton', 'kalab', 'vetrelec', 'aspektxxx', 'chlad.miloslav', 'kapoo', '36tiger63', 'martin.stusek', 'xhulav00', 'dusouuaa', 'zdenek.hrebicek', 'xskals01', 'zoidbergus', 'lukas.janic', 'markoshappy001', 'xhajek29', 'd.pamanek', 'rhrdina', 'peterson91x', 'dubrma', 'xkopul02', 'chlupatej', 'mahor12', 'xwalte01', 'josip23']",2,"[None, 'nomad.007']",32,"['gr4viton', 'kalab', 'vetrelec', 'aspektxxx', 'chlad.miloslav', 'peterson91x', 'radek1234', 'kapoo', '36tiger63', 'martin.stusek', 'xhulav00', 'dubrma', None, 'xdusek19', 'xkopul02', 'chlupatej', 'xhavel04', 'dusouuaa', 'zdenek.hrebicek', 'xskals01', 'zoidbergus', 'lukas.janic', 'markoshappy001', 'mahor12', 'xhajek29', 'dohnalosobni', 'xwalte01', 'josip23', 'xkrasn04', 'd.pamanek', 'rhrdina', 'nomad.007']"
15,202,31,6,3,"['xhulav00', 'rhrdina', 'zoidbergus']",27,"['gr4viton', 'kalab', 'vetrelec', 'aspektxxx', 'chlad.miloslav', 'peterson91x', 'radek1234', 'kapoo', '36tiger63', 'martin.stusek', 'dubrma', 'xdusek19', 'xkopul02', 'chlupatej', 'xhavel04', 'dusouuaa', 'zdenek.hrebicek', 'xskals01', 'lukas.janic', 'markoshappy001', 'mahor12', 'xhajek29', 'dohnalosobni', 'xwalte01', 'josip23', 'xkrasn04', 'd.pamanek']",3,"['gottwald9', None, 'johnymichal']",33,"['gr4viton', 'gottwald9', 'kalab', 'vetrelec', 'aspektxxx', 'chlad.miloslav', 'peterson91x', 'radek1234', 'kapoo', '36tiger63', 'martin.stusek', 'xhulav00', 'dubrma', None, 'xdusek19', 'xkopul02', 'chlupatej', 'xhavel04', 'dusouuaa', 'zdenek.hrebicek', 'xskals01', 'zoidbergus', 'lukas.janic', 'markoshappy001', 'mahor12', 'xhajek29', 'dohnalosobni', 'xwalte01', 'josip23', 'xkrasn04', 'johnymichal', 'd.pamanek', 'rhrdina']"
15,204,31,6,3,"['xhulav00', 'rhrdina', 'zoidbergus']",27,"['gr4viton', 'kalab', 'vetrelec', 'aspektxxx', 'chlad.miloslav', 'peterson91x', 'radek1234', 'kapoo', '36tiger63', 'martin.stusek', 'dubrma', 'xdusek19', 'xkopul02', 'chlupatej', 'xhavel04', 'dusouuaa', 'zdenek.hrebicek', 'xskals01', 'lukas.janic', 'markoshappy001', 'mahor12', 'xhajek29', 'dohnalosobni', 'xwalte01', 'josip23', 'xkrasn04', 'd.pamanek']",3,"['gottwald9', None, 'johnymichal']",33,"['gr4viton', 'gottwald9', 'kalab', 'vetrelec', 'aspektxxx', 'chlad.miloslav', 'peterson91x', 'radek1234', 'kapoo', '36tiger63', 'martin.stusek', 'xhulav00', 'dubrma', None, 'xdusek19', 'xkopul02', 'chlupatej', 'xhavel04', 'dusouuaa', 'zdenek.hrebicek', 'xskals01', 'zoidbergus', 'lukas.janic', 'markoshappy001', 'mahor12', 'xhajek29', 'dohnalosobni', 'xwalte01', 'josip23', 'xkrasn04', 'johnymichal', 'd.pamanek', 'rhrdina']"
15,208,31,6,5,"['chlupatej', 'vetrelec', 'mahor12', 'dusouuaa', 'martin.stusek']",25,"['gr4viton', 'kalab', 'aspektxxx', 'chlad.miloslav', 'peterson91x', 'radek1234', 'kapoo', '36tiger63', 'xhulav00', 'dubrma', 'xdusek19', 'xkopul02', 'xhavel04', 'zdenek.hrebicek', 'xskals01', 'zoidbergus', 'lukas.janic', 'markoshappy001', 'xhajek29', 'dohnalosobni', 'xwalte01', 'josip23', 'xkrasn04', 'd.pamanek', 'rhrdina']",1,[None],31,"['gr4viton', 'kalab', 'vetrelec', 'aspektxxx', 'chlad.miloslav', 'peterson91x', 'radek1234', 'kapoo', '36tiger63', 'martin.stusek', 'xhulav00', 'dubrma', None, 'xdusek19', 'xkopul02', 'chlupatej', 'xhavel04', 'dusouuaa', 'zdenek.hrebicek', 'xskals01', 'zoidbergus', 'lukas.janic', 'markoshappy001', 'mahor12', 'xhajek29', 'dohnalosobni', 'xwalte01', 'josip23', 'xkrasn04', 'd.pamanek', 'rhrdina']"
15,212,31,6,5,"['chlupatej', 'vetrelec', 'mahor12', 'dusouuaa', 'martin.stusek']",25,"['gr4viton', 'kalab', 'aspektxxx', 'chlad.miloslav', 'peterson91x', 'radek1234', 'kapoo', '36tiger63', 'xhulav00', 'dubrma', 'xdusek19', 'xkopul02', 'xhavel04', 'zdenek.hrebicek', 'xskals01', 'zoidbergus', 'lukas.janic', 'markoshappy001', 'xhajek29', 'dohnalosobni', 'xwalte01', 'josip23', 'xkrasn04', 'd.pamanek', 'rhrdina']",1,[None],31,"['gr4viton', 'kalab', 'vetrelec', 'aspektxxx', 'chlad.miloslav', 'peterson91x', 'radek1234', 'kapoo', '36tiger63', 'martin.stusek', 'xhulav00', 'dubrma', None, 'xdusek19', 'xkopul02', 'chlupatej', 'xhavel04', 'dusouuaa', 'zdenek.hrebicek', 'xskals01', 'zoidbergus', 'lukas.janic', 'markoshappy001', 'mahor12', 'xhajek29', 'dohnalosobni', 'xwalte01', 'josip23', 'xkrasn04', 'd.pamanek', 'rhrdina']"
16,86,30,35,27,"['pitcha.mt', 'piyayott9', 'lchung9', 'rbelul3', 'tal33', 'ywu77', 'simmond2', 'secunni2', 'garyliu2', 'harshil128', 'jkrol2', 'chantar2', 'jake.belica', 'xinding33', 'jdurant2', 'captcarisma', 'ahnhs910', 'leeji790', 'pajense2', 'ndenard2', 'ajeong3', 'whatabeautiful', 'mcyang3', 'rppatel8', 'abhansa2', 'malak577', 'jwang012794']",2,"['kihong.ahn.9', 'grandcn']",8,"['may.jonathan12', 'doyoulikenoodles', 'paujesque', 'pmarian2', 'strzebo2', 'smirnov2', None, 'choquett']",37,"['may.jonathan12', 'pitcha.mt', 'piyayott9', 'ywu77', 'secunni2', 'jkrol2', 'chantar2', 'choquett', 'ahnhs910', 'leeji790', 'pajense2', 'ndenard2', 'mcyang3', 'whatabeautiful', 'jwang012794', 'lchung9', 'rbelul3', 'tal33', 'simmond2', 'garyliu2', 'harshil128', 'jake.belica', 'grandcn', 'doyoulikenoodles', 'xinding33', 'jdurant2', 'pmarian2', 'captcarisma', 'kihong.ahn.9', None, 'paujesque', 'strzebo2', 'ajeong3', 'rppatel8', 'smirnov2', 'malak577', 'abhansa2']"
16,64,30,34,27,"['pitcha.mt', 'piyayott9', 'lchung9', 'tal33', 'ywu77', 'simmond2', 'secunni2', 'garyliu2', 'harshil128', 'jkrol2', 'chantar2', 'jake.belica', 'xinding33', 'jdurant2', 'captcarisma', 'kihong.ahn.9', 'ahnhs910', 'leeji790', 'pajense2', 'ndenard2', 'ajeong3', 'whatabeautiful', 'mcyang3', 'rppatel8', 'abhansa2', 'malak577', 'jwang012794']",2,"['rbelul3', 'grandcn']",7,"['may.jonathan12', 'pmarian2', 'uiuczhang11', 'strzebo2', 'haelim1227', 'smirnov2', None]",36,"['may.jonathan12', 'pitcha.mt', 'haelim1227', 'piyayott9', 'lchung9', 'rbelul3', 'tal33', 'ywu77', 'simmond2', 'secunni2', 'garyliu2', 'harshil128', 'jkrol2', 'chantar2', 'jake.belica', 'grandcn', 'xinding33', 'jdurant2', 'pmarian2', 'jwang012794', 'uiuczhang11', 'captcarisma', 'kihong.ahn.9', 'ahnhs910', 'leeji790', None, 'pajense2', 'strzebo2', 'ndenard2', 'ajeong3', 'whatabeautiful', 'mcyang3', 'rppatel8', 'smirnov2', 'malak577', 'abhansa2']"
17,147,30,30,28,"['paolodrossi44', 'pbergin', 'tgarrow', 'ctillson', 'cjohara9992', 'braedonlohe', 'cdeloren', 'randal.s.baron', 'fsansoz', 'binh.bui.387', 'mjlareau', 'tgallant', 'ebrown18', 'carcovit', 'jdeforge', 'evan.albert12', 'bsherr', 'asar2525', 'ajkeith15', 'rtaft15', 'jpvander', 'mcl01190', 'mpereir1', 'ncareyuvm', 'cleaf30', 'jlister93', 'rgomesal', 'roipf']",1,['elinwi.alex'],2,"[None, 'marcus.wilkinson10']",31,"['paolodrossi44', 'pbergin', 'tgarrow', 'ctillson', 'cjohara9992', 'braedonlohe', 'cdeloren', 'randal.s.baron', 'fsansoz', 'binh.bui.387', 'mjlareau', 'tgallant', 'ebrown18', 'carcovit', 'elinwi.alex', 'jdeforge', 'evan.albert12', 'bsherr', 'asar2525', 'ajkeith15', 'rtaft15', 'jpvander', 'mcl01190', None, 'mpereir1', 'ncareyuvm', 'cleaf30', 'marcus.wilkinson10', 'jlister93', 'rgomesal', 'roipf']"
18,197,30,31,28,"['camille.b.18', 'whmadan1990', 'boranma', 'yingyu2012', 'newtons4thlaw', 'matthewpeters2013', 'ealster2004', 'zmc912', 'clw802', 'mbarona2', 'rrb915', 'arisb26', 'ealster', 'iza.samek', 'redmondlhota2015', 'jch371', 'aiscen1', 'karsonleperi', 'tribunus.vii', 'david.chen.david.chen', 'jedelbrock', 'monkeye26', 'kurinji', 'smarks13', 'hakyung.kwon', 'laurendellon2014', 'benbucior', 'mjskwarczek1']",1,['drfrpjr'],3,"[None, 'kevinchiou2019', 'aribenjamin2014']",32,"['camille.b.18', 'whmadan1990', 'boranma', 'yingyu2012', 'kevinchiou2019', 'newtons4thlaw', 'aribenjamin2014', 'matthewpeters2013', 'ealster2004', 'zmc912', 'clw802', 'mbarona2', 'rrb915', 'arisb26', 'ealster', 'iza.samek', 'redmondlhota2015', 'jch371', 'aiscen1', 'karsonleperi', None, 'tribunus.vii', 'david.chen.david.chen', 'jedelbrock', 'monkeye26', 'kurinji', 'smarks13', 'hakyung.kwon', 'laurendellon2014', 'drfrpjr', 'benbucior', 'mjskwarczek1']"
19,4,30,29,15,"['menna.khaled.925', 'binospop', 'dinatarek', 'carket23', 'omnia', 'safeddin', 'ali.elmaraghy.7', 'mostafa.kamel.8989', 'amgad.fekry.3', 'ayam.alaa', 'jocian.jemy', '3omariotareq', 'vanavinoo', 'nadinehelmy1', 'na3na3333']",14,"['timoneda1', 'nanobryant', 'anna1494', 'pandgi', 'joydnoah', 'yuhsukeyasutake', 'sexoistari', 'bjtimmer1', 'derverwuenschte', 'amrali598', 'jmansir', 'mourad.amer.asu', 'sdbv', 'pahwagirish2010']",14,"['abdelsalamadel', 'shahira.mohamed.22', 'hodashadi', 'ramsiscomm2014', 'magedaziz2011', 'sara.hanafy.752', 'sammikhail', 'ahmedelswify', 'halafadl94', 'amremad', 'ahmedcoolman', 'asmaamohamed94', 'rana_karem', None]",43,"['anna1494', 'abdelsalamadel', 'shahira.mohamed.22', 'omnia', 'ahmedcoolman', 'amgad.fekry.3', 'amrali598', '3omariotareq', 'nanobryant', 'menna.khaled.925', 'pandgi', 'joydnoah', 'magedaziz2011', 'sara.hanafy.752', 'ali.elmaraghy.7', 'amremad', 'ayam.alaa', 'derverwuenschte', 'asmaamohamed94', 'carket23', 'sexoistari', 'safeddin', 'sammikhail', 'ahmedelswify', 'mostafa.kamel.8989', 'bjtimmer1', 'jmansir', 'mourad.amer.asu', 'sdbv', 'vanavinoo', 'rana_karem', None, 'nadinehelmy1', 'timoneda1', 'binospop', 'hodashadi', 'dinatarek', 'ramsiscomm2014', 'yuhsukeyasutake', 'halafadl94', 'jocian.jemy', 'pahwagirish2010', 'na3na3333']"
19,6,30,8,3,"['timoneda1', 'anna1494', 'derverwuenschte']",26,"['omnia', 'amgad.fekry.3', 'amrali598', '3omariotareq', 'nanobryant', 'menna.khaled.925', 'pandgi', 'joydnoah', 'ali.elmaraghy.7', 'ayam.alaa', 'carket23', 'sexoistari', 'safeddin', 'mostafa.kamel.8989', 'bjtimmer1', 'jmansir', 'mourad.amer.asu', 'sdbv', 'vanavinoo', 'nadinehelmy1', 'binospop', 'dinatarek', 'yuhsukeyasutake', 'jocian.jemy', 'pahwagirish2010', 'na3na3333']",5,"['raul.4.bcn', 'alexistellovalero', 'ritasalavert9', 'david.schmelz.1', None]",34,"['anna1494', 'carket23', 'omnia', 'sexoistari', 'safeddin', 'mostafa.kamel.8989', 'bjtimmer1', 'amgad.fekry.3', 'amrali598', 'jmansir', 'mourad.amer.asu', '3omariotareq', 'sdbv', 'vanavinoo', None, 'nadinehelmy1', 'timoneda1', 'nanobryant', 'raul.4.bcn', 'menna.khaled.925', 'binospop', 'dinatarek', 'pandgi', 'joydnoah', 'yuhsukeyasutake', 'alexistellovalero', 'ritasalavert9', 'ali.elmaraghy.7', 'ayam.alaa', 'derverwuenschte', 'jocian.jemy', 'david.schmelz.1', 'pahwagirish2010', 'na3na3333']"
20,70,30,113,19,"['chong.gu.5', 'abaddon2mist', 'jwang182', 'adsnyde2', 'jiechen.wang7', 'billli1997', 'yitaohuangnb', 'seanxyy0914', 'hankliu00', 'slee342', 'firpo2', 'vivianzry92', 'lee895', 'dustin1', 'will.j.mccracken', 'qazyyc93', 'padget1', 'sage', 'junpeng.qiu']",10,"['kuo20', 'skapoln2', 'dtmrnav', 'joonheekimk5', 'lafaye2', 'khill1203', 'ruining22', 'mnauheimer', 'jychew2', 'jcooney2']",94,"['amango4', 'aniruddhshivram', 'achoi121', 'kote.deepa', 'cullenglasgow', 'sarahresarf', 'dmcgovern88', 'jjiang14', 'yyang10', 'lbward93', 'janeyoo34', 'jmanand2', 'bcclanc2', 'masiyi9406', 'jmmille6', 'mrhennek', 'beng3', 'lolipopcarolwang', 'earthy', 'faizal2', 'palchec2', 'mcheng94', 'antony.huang.129', 'wiieat.chen', 'ruining2', 'hlai7', 'mantianxue0101', 'lfirpo', 'bhanley2', 'dman5505', 'yyang132', 'csbaile2', 'pbhatta2', 'bpgolfguy92', 'eprzyby2', 'mkbaile2', 'elin11', 'gvelard2edu', 'jiechen94', 'dagapit2', 'ntsherm2', 'jefrin', 'dwchris2', 'asimha2', 'yoo66', 'meher.bharucha', 'klwells2', 'sho1123', 'toujours.meiling93', 'anna.mast2', 'dyoon11', 'spshah6', 'simpkns2', 'billli1996', 'cory93', 'remlevin', 'tjweber2', 'hmtaylo2', 'hylin2', 'isaacehoffman2', 'dkwok2', 'zhensun5', 'myeoh2', 'a.schleife', 'cledesma2331', 'spmurra2', 'jacobcamp1', 'kfeng', 'carolgu2', 'jake.kornacker', 'xiasang2', 'yyang100', 'grober.dan', 'sguo12', 'ntxuby', 'melissagoetter', 'tara.cullerton', 'allysonv10', 'a_kuzni2', 'wlarson2', 'qiujiezhao1994', 'kjcsport1', 'scpiper2', 'dpapanicolas', 'gsharma80', None, 'curtis.c.baker', 'salman2', 'jtcohen2', 'ahli2', 'schiavo1', 'me1291441', 'werkkdy2', 'knipfer2']",123,"['amango4', 'aniruddhshivram', 'chong.gu.5', 'achoi121', 'kote.deepa', 'jiechen.wang7', 'cullenglasgow', 'lafaye2', 'yitaohuangnb', 'sarahresarf', 'dmcgovern88', 'jjiang14', 'yyang10', 'lbward93', 'janeyoo34', 'firpo2', 'jmanand2', 'bcclanc2', 'masiyi9406', 'jmmille6', 'mrhennek', 'beng3', 'lolipopcarolwang', 'earthy', 'faizal2', 'sage', 'palchec2', 'kuo20', 'skapoln2', 'mcheng94', 'antony.huang.129', 'wiieat.chen', 'ruining2', 'abaddon2mist', 'hlai7', 'mantianxue0101', 'lfirpo', 'bhanley2', 'dman5505', 'yyang132', 'csbaile2', 'pbhatta2', 'bpgolfguy92', 'eprzyby2', 'joonheekimk5', 'mkbaile2', 'elin11', 'gvelard2edu', 'jiechen94', 'dagapit2', 'will.j.mccracken', 'ntsherm2', 'jefrin', 'dwchris2', 'asimha2', 'yoo66', 'meher.bharucha', 'klwells2', 'qazyyc93', 'sho1123', 'khill1203', 'toujours.meiling93', 'anna.mast2', 'junpeng.qiu', 'dyoon11', 'spshah6', 'simpkns2', 'billli1996', 'cory93', 'remlevin', 'adsnyde2', 'tjweber2', 'seanxyy0914', 'hankliu00', 'hmtaylo2', 'hylin2', 'isaacehoffman2', 'jychew2', 'dkwok2', 'vivianzry92', 'lee895', 'zhensun5', 'myeoh2', 'dustin1', 'a.schleife', 'cledesma2331', 'ruining22', 'mnauheimer', 'spmurra2', 'jacobcamp1', 'kfeng', 'carolgu2', 'padget1', 'jake.kornacker', 'xiasang2', 'jwang182', 'yyang100', 'grober.dan', 'sguo12', 'ntxuby', 'melissagoetter', 'tara.cullerton', 'billli1997', 'allysonv10', 'a_kuzni2', 'wlarson2', 'slee342', 'dtmrnav', 'qiujiezhao1994', 'kjcsport1', 'scpiper2', 'dpapanicolas', 'gsharma80', None, 'jcooney2', 'curtis.c.baker', 'salman2', 'jtcohen2', 'ahli2', 'schiavo1', 'me1291441', 'werkkdy2', 'knipfer2']"
20,68,30,57,4,"['lafaye2', 'skapoln2', 'dtmrnav', 'adsnyde2']",25,"['kuo20', 'chong.gu.5', 'abaddon2mist', 'jwang182', 'jiechen.wang7', 'joonheekimk5', 'billli1997', 'yitaohuangnb', 'seanxyy0914', 'hankliu00', 'jychew2', 'slee342', 'firpo2', 'vivianzry92', 'lee895', 'dustin1', 'will.j.mccracken', 'ruining22', 'mnauheimer', 'jcooney2', 'qazyyc93', 'khill1203', 'padget1', 'sage', 'junpeng.qiu']",53,"['michiizu1996', 'kmckillop', 'peiyiiina', 'zicheng.long', 'aaaandrew', 'jkim561', 'bfiszbein', 'jacob.dutler', 'marcin2', '17staru', 'emfoley14', 'mgulson2', 'puthala2', 'tmccar4', 'vkhanna3', 'eslee6', 'qinli2', 'charmisuk', 'jasondxzhang', 'hmajith2', 'cwojtan', 'liamthirdtry', 'mizulsk2', 'bluefisher12', 'zhucq330873348', 'kavitasrinivasan', 'laoyumi904', 'madara61796', 'jjauch93', 'zjz.jiklint', 'jackxiao1104', 'jeoneil2', 'emilio.ramirez.37604', 'mingye.gao', 'xsun45', 'laurentaylor', 'jonbaebae', 'yiyue.luo.9', 'zjhaber', 'jshi3120', None, 'qinglin2', 'justinb1', 'brianwzx11', 'jjotte2', 'cjisrael1015', 'ychu18', 'goszkow2', 'saphknight', 'whu14', 'jhuang84', 'yyao13', 'pierce.randle']",82,"['michiizu1996', 'chong.gu.5', 'bfiszbein', 'marcin2', 'adsnyde2', 'emfoley14', 'mgulson2', 'tmccar4', 'jiechen.wang7', 'eslee6', 'qinli2', 'charmisuk', 'hmajith2', 'cwojtan', 'lafaye2', 'mizulsk2', 'bluefisher12', 'yitaohuangnb', 'seanxyy0914', 'hankliu00', 'kavitasrinivasan', 'laoyumi904', 'madara61796', 'zjz.jiklint', 'jychew2', 'jackxiao1104', 'firpo2', 'vivianzry92', 'lee895', 'xsun45', 'laurentaylor', 'jonbaebae', 'dustin1', 'yiyue.luo.9', 'zjhaber', 'ruining22', 'mnauheimer', 'qinglin2', 'brianwzx11', 'padget1', 'cjisrael1015', 'ychu18', 'sage', 'goszkow2', 'saphknight', 'jkim561', 'yyao13', 'pierce.randle', 'kmckillop', 'kuo20', 'peiyiiina', 'skapoln2', 'zicheng.long', 'aaaandrew', 'abaddon2mist', 'jacob.dutler', 'jwang182', '17staru', 'puthala2', 'vkhanna3', 'jasondxzhang', 'joonheekimk5', 'liamthirdtry', 'billli1997', 'zhucq330873348', 'jjauch93', 'jeoneil2', 'emilio.ramirez.37604', 'slee342', 'dtmrnav', 'mingye.gao', 'will.j.mccracken', 'jshi3120', None, 'jcooney2', 'justinb1', 'qazyyc93', 'khill1203', 'jjotte2', 'junpeng.qiu', 'whu14', 'jhuang84']"
20,71,30,28,2,"['vivianzry92', 'jcooney2']",27,"['kuo20', 'skapoln2', 'chong.gu.5', 'abaddon2mist', 'jwang182', 'adsnyde2', 'jiechen.wang7', 'joonheekimk5', 'lafaye2', 'billli1997', 'yitaohuangnb', 'seanxyy0914', 'hankliu00', 'jychew2', 'slee342', 'dtmrnav', 'firpo2', 'lee895', 'dustin1', 'will.j.mccracken', 'ruining22', 'mnauheimer', 'qazyyc93', 'khill1203', 'padget1', 'sage', 'junpeng.qiu']",26,"['amango4', 'kevinchiou2019', 'kote.deepa', 'lfirpo', 'dman5505', 'csbaile2', 'ntxuby', 'melissagoetter', 'eprzyby2', 'mkbaile2', 'tjweber2', 'tara.cullerton', 'elin11', 'sarahresarf', 'jjiang14', 'hmtaylo2', 'janeyoo34', 'hsp6634', 'cledesma2331', None, 'dwchris2', 'masiyi9406', 'mrhennek', 'beng3', 'hank.liu.180', 'palchec2']",55,"['kuo20', 'skapoln2', 'amango4', 'chong.gu.5', 'abaddon2mist', 'kevinchiou2019', 'jwang182', 'kote.deepa', 'lfirpo', 'adsnyde2', 'csbaile2', 'dman5505', 'jiechen.wang7', 'ntxuby', 'melissagoetter', 'joonheekimk5', 'lafaye2', 'eprzyby2', 'mkbaile2', 'tjweber2', 'tara.cullerton', 'billli1997', 'elin11', 'yitaohuangnb', 'sarahresarf', 'jjiang14', 'seanxyy0914', 'hankliu00', 'hmtaylo2', 'jychew2', 'janeyoo34', 'slee342', 'dtmrnav', 'firpo2', 'vivianzry92', 'lee895', 'hsp6634', 'dustin1', 'will.j.mccracken', 'cledesma2331', 'ruining22', 'mnauheimer', None, 'jcooney2', 'dwchris2', 'masiyi9406', 'mrhennek', 'beng3', 'qazyyc93', 'khill1203', 'padget1', 'hank.liu.180', 'sage', 'palchec2', 'junpeng.qiu']"
20,72,30,15,2,"['joonheekimk5', 'abaddon2mist']",27,"['kuo20', 'skapoln2', 'chong.gu.5', 'jwang182', 'adsnyde2', 'jiechen.wang7', 'lafaye2', 'billli1997', 'yitaohuangnb', 'seanxyy0914', 'hankliu00', 'jychew2', 'slee342', 'dtmrnav', 'firpo2', 'vivianzry92', 'lee895', 'dustin1', 'will.j.mccracken', 'ruining22', 'mnauheimer', 'jcooney2', 'qazyyc93', 'khill1203', 'padget1', 'sage', 'junpeng.qiu']",13,"['jmmille6', 'spmurra2', 'dlitt2', 'julia.zuo', 'sikaufm2', 'zhensun5', 'ahli2', 'xli121', 'a.schleife', 'bhanley2', 'anna.mast2', None, 'janeyoo34']",42,"['kuo20', 'skapoln2', 'chong.gu.5', 'abaddon2mist', 'jwang182', 'bhanley2', 'adsnyde2', 'jiechen.wang7', 'joonheekimk5', 'lafaye2', 'billli1997', 'yitaohuangnb', 'seanxyy0914', 'hankliu00', 'jychew2', 'janeyoo34', 'slee342', 'dtmrnav', 'firpo2', 'vivianzry92', 'lee895', 'julia.zuo', 'sikaufm2', 'zhensun5', 'dustin1', 'will.j.mccracken', 'a.schleife', 'ruining22', 'mnauheimer', None, 'jcooney2', 'jmmille6', 'dlitt2', 'spmurra2', 'qazyyc93', 'ahli2', 'khill1203', 'xli121', 'padget1', 'sage', 'anna.mast2', 'junpeng.qiu']"
20,73,30,7,1,['kuo20'],28,"['skapoln2', 'chong.gu.5', 'abaddon2mist', 'jwang182', 'adsnyde2', 'jiechen.wang7', 'joonheekimk5', 'lafaye2', 'billli1997', 'yitaohuangnb', 'seanxyy0914', 'hankliu00', 'jychew2', 'slee342', 'dtmrnav', 'firpo2', 'vivianzry92', 'lee895', 'dustin1', 'will.j.mccracken', 'ruining22', 'mnauheimer', 'jcooney2', 'qazyyc93', 'khill1203', 'padget1', 'sage', 'junpeng.qiu']",6,"['jmmille6', 'dlitt2', 'julia.zuo', 'sikaufm2', 'xli121', None]",35,"['kuo20', 'skapoln2', 'slee342', 'dtmrnav', 'firpo2', 'chong.gu.5', 'abaddon2mist', 'vivianzry92', 'lee895', 'julia.zuo', 'sikaufm2', 'jwang182', 'dustin1', 'will.j.mccracken', 'adsnyde2', 'ruining22', 'mnauheimer', None, 'jcooney2', 'jiechen.wang7', 'jmmille6', 'dlitt2', 'joonheekimk5', 'lafaye2', 'qazyyc93', 'billli1997', 'khill1203', 'yitaohuangnb', 'padget1', 'xli121', 'seanxyy0914', 'hankliu00', 'sage', 'junpeng.qiu', 'jychew2']"
21,138,29,59,26,"['lopez86', 'kim383', 'azzedinr', 'paulleonc', 'telliott', 'adithyabhattachar', 'horner4', 'jfschrad', 'gflesner', 'astronut95', 'cohen.jakedavid', 'tbruttom', 'theresa.saenz.1', 'parsonsm', 'kaiser17', 'hallowj', 'smithjared1994', 'richa201', 'vganapa', 'ahmed49', 'ramirez28', 'jtrouba', 'fiferj', 'woodsh', 'ross_piedmonte', 'tcurtiss']",2,"['alaimana', 'sawa']",33,"['dacapo007', 'nspear17', 'clandon01', 'spschriver', 'jcassady30', 'posta', 'zhu431', 'tictonk', 'pangb1', 'mcapestr', 'robin198', 'ncain3', 'aianlo', 'xphuah', 'alexj9', 'lim154', 'czy121301', 'tlshelhart', 'jiamanhe', 'li1470', 'haojiex', 'mmckinne', 'mjankowicz', 'jinghan1022', 'mkatamba', 'lucas.ray.169', None, 'sullivaf', 'sboes95', 'thoma386', 'pspagnolo72', 'pnorman', 'glinvill']",61,"['nspear17', 'clandon01', 'spschriver', 'pangb1', 'azzedinr', 'paulleonc', 'telliott', 'ncain3', 'horner4', 'jfschrad', 'alexj9', 'theresa.saenz.1', 'czy121301', 'tlshelhart', 'hallowj', 'smithjared1994', 'li1470', 'haojiex', 'mmckinne', 'vganapa', 'jinghan1022', 'lucas.ray.169', 'ahmed49', 'ramirez28', 'sullivaf', 'sboes95', 'pspagnolo72', 'woodsh', 'ross_piedmonte', 'glinvill', 'lopez86', 'dacapo007', 'kim383', 'sawa', 'jcassady30', 'posta', 'zhu431', 'tictonk', 'mcapestr', 'robin198', 'adithyabhattachar', 'aianlo', 'xphuah', 'gflesner', 'astronut95', 'cohen.jakedavid', 'tbruttom', 'lim154', 'parsonsm', 'kaiser17', 'jiamanhe', 'mjankowicz', 'pnorman', 'richa201', 'mkatamba', None, 'jtrouba', 'fiferj', 'thoma386', 'alaimana', 'tcurtiss']"
21,268,29,55,26,"['lopez86', 'kim383', 'sawa', 'azzedinr', 'paulleonc', 'adithyabhattachar', 'horner4', 'jfschrad', 'gflesner', 'astronut95', 'cohen.jakedavid', 'tbruttom', 'parsonsm', 'kaiser17', 'hallowj', 'smithjared1994', 'richa201', 'vganapa', 'ahmed49', 'ramirez28', 'jtrouba', 'fiferj', 'woodsh', 'alaimana', 'ross_piedmonte', 'tcurtiss']",2,"['theresa.saenz.1', 'telliott']",29,"['dacapo007', 'nspear17', 'dtisdale', 'jcassady30', 'posta', 'zhu431', 'fernandd63', 'tictonk', 'robin198', 'ljc99', 'xphuah', 'czy121301', 'campb122', 'leavittm0', 'peachrings', 'mmckinne', 'haller1', 'redwing', None, 'sullivaf', 'sboes95', 'jackie0212', 'glhinkle', 'matthew.l.binkley', 'thoma386', 'pspagnolo72', 'ajana', 'lim154', 'gu97']",57,"['nspear17', 'fernandd63', 'azzedinr', 'paulleonc', 'telliott', 'horner4', 'jfschrad', 'theresa.saenz.1', 'czy121301', 'hallowj', 'campb122', 'smithjared1994', 'mmckinne', 'vganapa', 'redwing', 'ahmed49', 'ramirez28', 'sullivaf', 'sboes95', 'jackie0212', 'glhinkle', 'matthew.l.binkley', 'pspagnolo72', 'ajana', 'woodsh', 'ross_piedmonte', 'gu97', 'lopez86', 'dacapo007', 'dtisdale', 'kim383', 'sawa', 'posta', 'zhu431', 'tictonk', 'jcassady30', 'robin198', 'adithyabhattachar', 'ljc99', 'xphuah', 'gflesner', 'astronut95', 'cohen.jakedavid', 'tbruttom', 'lim154', 'parsonsm', 'kaiser17', 'leavittm0', 'peachrings', 'haller1', 'richa201', None, 'jtrouba', 'fiferj', 'thoma386', 'alaimana', 'tcurtiss']"
21,75,29,54,25,"['kim383', 'sawa', 'azzedinr', 'telliott', 'adithyabhattachar', 'jfschrad', 'gflesner', 'astronut95', 'cohen.jakedavid', 'tbruttom', 'theresa.saenz.1', 'parsonsm', 'kaiser17', 'hallowj', 'smithjared1994', 'richa201', 'vganapa', 'ahmed49', 'ramirez28', 'jtrouba', 'fiferj', 'woodsh', 'alaimana', 'ross_piedmonte', 'tcurtiss']",3,"['lopez86', 'horner4', 'paulleonc']",29,"['dacapo007', 'nspear17', 'clandon01', 'posta', 'zhu431', 'mcapestr', 'pangb1', 'robin198', 'ncain3', 'aianlo', 'xphuah', 'lim154', 'tlshelhart', 'hoikim91', 'peachrings', 'haojiex', 'mmckinne', 'mjankowicz', 'jinghan1022', 'lucas.ray.169', None, 'davgumo', 'sullivaf', 'nanohueb', 'sboes95', 'thoma386', 'pspagnolo72', 'pnorman', 'spschriver1']",57,"['spschriver1', 'nspear17', 'clandon01', 'pangb1', 'azzedinr', 'paulleonc', 'telliott', 'ncain3', 'horner4', 'jfschrad', 'theresa.saenz.1', 'tlshelhart', 'hallowj', 'smithjared1994', 'hoikim91', 'haojiex', 'mmckinne', 'vganapa', 'jinghan1022', 'lucas.ray.169', 'ahmed49', 'ramirez28', 'davgumo', 'sullivaf', 'sboes95', 'pspagnolo72', 'woodsh', 'ross_piedmonte', 'lopez86', 'dacapo007', 'kim383', 'sawa', 'posta', 'zhu431', 'mcapestr', 'robin198', 'adithyabhattachar', 'aianlo', 'xphuah', 'gflesner', 'astronut95', 'cohen.jakedavid', 'tbruttom', 'lim154', 'parsonsm', 'kaiser17', 'peachrings', 'mjankowicz', 'pnorman', 'richa201', None, 'jtrouba', 'nanohueb', 'fiferj', 'thoma386', 'alaimana', 'tcurtiss']"
21,69,29,43,21,"['kim383', 'azzedinr', 'paulleonc', 'telliott', 'horner4', 'jfschrad', 'gflesner', 'astronut95', 'cohen.jakedavid', 'tbruttom', 'theresa.saenz.1', 'parsonsm', 'kaiser17', 'hallowj', 'smithjared1994', 'vganapa', 'ahmed49', 'jtrouba', 'woodsh', 'ross_piedmonte', 'tcurtiss']",7,"['lopez86', 'fiferj', 'sawa', 'richa201', 'alaimana', 'adithyabhattachar', 'ramirez28']",22,"['dacapo007', 'posta', 'zhu431', 'tictonk', 'pangb1', 'robin198', 'ncain3', 'alexj9', 'czy121301', 'tlshelhart', 'li1470', 'haojiex', 'ramire28', 'pnorman', 'jinghan1022', 'lucas.ray.169', None, 'sullivaf', 'thoma386', 'pspagnolo72', 'lim154', 'glinvill']",50,"['pangb1', 'azzedinr', 'paulleonc', 'telliott', 'ncain3', 'horner4', 'jfschrad', 'alexj9', 'theresa.saenz.1', 'czy121301', 'tlshelhart', 'hallowj', 'smithjared1994', 'li1470', 'haojiex', 'ramire28', 'vganapa', 'jinghan1022', 'lucas.ray.169', 'ahmed49', 'ramirez28', 'sullivaf', 'pspagnolo72', 'woodsh', 'ross_piedmonte', 'glinvill', 'lopez86', 'dacapo007', 'kim383', 'sawa', 'posta', 'zhu431', 'tictonk', 'robin198', 'adithyabhattachar', 'gflesner', 'astronut95', 'cohen.jakedavid', 'tbruttom', 'lim154', 'parsonsm', 'kaiser17', 'pnorman', 'richa201', None, 'jtrouba', 'fiferj', 'thoma386', 'alaimana', 'tcurtiss']"
21,74,29,42,25,"['lopez86', 'kim383', 'sawa', 'azzedinr', 'paulleonc', 'telliott', 'adithyabhattachar', 'horner4', 'jfschrad', 'gflesner', 'astronut95', 'cohen.jakedavid', 'tbruttom', 'theresa.saenz.1', 'parsonsm', 'hallowj', 'smithjared1994', 'vganapa', 'ahmed49', 'ramirez28', 'jtrouba', 'woodsh', 'alaimana', 'ross_piedmonte', 'tcurtiss']",3,"['richa201', 'kaiser17', 'fiferj']",17,"['nspear17', 'hoikim91', 'lucas.ray.169', 'haojiex', 'mmckinne', 'thoma386', 'posta', 'zhu431', 'pspagnolo72', 'pnorman', 'czy121301', 'lim154', 'jinghan1022', 'tlshelhart', 'ncain3', 'aianlo', None]",45,"['nspear17', 'azzedinr', 'paulleonc', 'telliott', 'ncain3', 'horner4', 'jfschrad', 'theresa.saenz.1', 'czy121301', 'tlshelhart', 'hallowj', 'smithjared1994', 'hoikim91', 'haojiex', 'mmckinne', 'vganapa', 'jinghan1022', 'lucas.ray.169', 'ahmed49', 'ramirez28', 'pspagnolo72', 'woodsh', 'ross_piedmonte', 'lopez86', 'kim383', 'sawa', 'posta', 'zhu431', 'adithyabhattachar', 'aianlo', 'gflesner', 'astronut95', 'cohen.jakedavid', 'tbruttom', 'lim154', 'parsonsm', 'kaiser17', 'pnorman', 'richa201', None, 'jtrouba', 'fiferj', 'thoma386', 'alaimana', 'tcurtiss']"
21,267,29,39,20,"['lopez86', 'sawa', 'azzedinr', 'adithyabhattachar', 'horner4', 'gflesner', 'cohen.jakedavid', 'tbruttom', 'theresa.saenz.1', 'parsonsm', 'kaiser17', 'hallowj', 'smithjared1994', 'ahmed49', 'jtrouba', 'fiferj', 'woodsh', 'alaimana', 'ross_piedmonte', 'tcurtiss']",8,"['jfschrad', 'kim383', 'astronut95', 'paulleonc', 'richa201', 'vganapa', 'telliott', 'ramirez28']",19,"['nspear17', 'dtisdale', 'posta', 'fernandd63', 'zhu431', 'robin198', 'ljc99', 'xphuah', 'czy121301', 'mmckinne', 'haller1', 'lucas.ray.169', 'redwing', None, 'sullivaf', 'sboes95', 'jackie0212', 'matthew.l.binkley', 'pspagnolo72']",47,"['nspear17', 'fernandd63', 'azzedinr', 'paulleonc', 'telliott', 'horner4', 'jfschrad', 'theresa.saenz.1', 'czy121301', 'hallowj', 'smithjared1994', 'mmckinne', 'vganapa', 'lucas.ray.169', 'redwing', 'ahmed49', 'ramirez28', 'sullivaf', 'sboes95', 'jackie0212', 'matthew.l.binkley', 'pspagnolo72', 'woodsh', 'ross_piedmonte', 'lopez86', 'dtisdale', 'kim383', 'sawa', 'posta', 'zhu431', 'robin198', 'adithyabhattachar', 'ljc99', 'xphuah', 'gflesner', 'astronut95', 'cohen.jakedavid', 'tbruttom', 'parsonsm', 'kaiser17', 'haller1', 'richa201', None, 'jtrouba', 'fiferj', 'alaimana', 'tcurtiss']"
21,262,29,37,22,"['lopez86', 'kim383', 'sawa', 'adithyabhattachar', 'horner4', 'gflesner', 'astronut95', 'cohen.jakedavid', 'tbruttom', 'theresa.saenz.1', 'parsonsm', 'kaiser17', 'hallowj', 'smithjared1994', 'richa201', 'vganapa', 'ahmed49', 'jtrouba', 'woodsh', 'alaimana', 'ross_piedmonte', 'tcurtiss']",6,"['jfschrad', 'fiferj', 'azzedinr', 'paulleonc', 'telliott', 'ramirez28']",15,"['glinvill', 'nspear17', 'dtisdale', 'raphaelkimme', 'glhinkle', None, 'cvieira', 'matthew.l.binkley', 'posta', 'fernandd63', 'czy121301', 'robin198', 'redwing', 'ljc99', 'campb122']",43,"['nspear17', 'raphaelkimme', 'fernandd63', 'azzedinr', 'paulleonc', 'telliott', 'horner4', 'jfschrad', 'theresa.saenz.1', 'czy121301', 'hallowj', 'campb122', 'smithjared1994', 'vganapa', 'redwing', 'ahmed49', 'ramirez28', 'glhinkle', 'matthew.l.binkley', 'woodsh', 'ross_piedmonte', 'glinvill', 'lopez86', 'dtisdale', 'kim383', 'sawa', 'posta', 'robin198', 'adithyabhattachar', 'ljc99', 'gflesner', 'astronut95', 'cohen.jakedavid', 'tbruttom', 'parsonsm', 'kaiser17', 'richa201', None, 'jtrouba', 'cvieira', 'fiferj', 'alaimana', 'tcurtiss']"
21,264,29,12,5,"['smithjared1994', 'woodsh', 'azzedinr', 'vganapa', 'alaimana']",23,"['lopez86', 'kim383', 'sawa', 'paulleonc', 'telliott', 'adithyabhattachar', 'horner4', 'jfschrad', 'gflesner', 'astronut95', 'cohen.jakedavid', 'tbruttom', 'theresa.saenz.1', 'parsonsm', 'kaiser17', 'hallowj', 'richa201', 'ahmed49', 'ramirez28', 'jtrouba', 'fiferj', 'ross_piedmonte', 'tcurtiss']",7,"['leavittm0', 'li1470', 'cvieira', 'matthew.l.binkley', 'pangb1', 'jinghan1022', None]",35,"['lopez86', 'kim383', 'sawa', 'pangb1', 'azzedinr', 'paulleonc', 'telliott', 'adithyabhattachar', 'horner4', 'jfschrad', 'gflesner', 'astronut95', 'cohen.jakedavid', 'tbruttom', 'theresa.saenz.1', 'parsonsm', 'kaiser17', 'hallowj', 'smithjared1994', 'leavittm0', 'li1470', 'richa201', 'vganapa', 'jinghan1022', None, 'ahmed49', 'ramirez28', 'jtrouba', 'cvieira', 'matthew.l.binkley', 'fiferj', 'woodsh', 'alaimana', 'ross_piedmonte', 'tcurtiss']"
21,97,29,6,1,['jfschrad'],27,"['smithjared1994', 'lopez86', 'kim383', 'sawa', 'azzedinr', 'paulleonc', 'richa201', 'telliott', 'kaiser17', 'adithyabhattachar', 'horner4', 'vganapa', 'ahmed49', 'ramirez28', 'jtrouba', 'gflesner', 'astronut95', 'cohen.jakedavid', 'fiferj', 'tbruttom', 'theresa.saenz.1', 'woodsh', 'alaimana', 'ross_piedmonte', 'parsonsm', 'tcurtiss', 'hallowj']",5,"['haojiex', 'pspagnolo72', 'tictonk', 'mkatamba', None]",33,"['smithjared1994', 'lopez86', 'kim383', 'haojiex', 'sawa', 'tictonk', 'azzedinr', 'paulleonc', 'richa201', 'telliott', 'kaiser17', 'adithyabhattachar', 'horner4', 'vganapa', 'mkatamba', None, 'ahmed49', 'ramirez28', 'jfschrad', 'jtrouba', 'gflesner', 'astronut95', 'cohen.jakedavid', 'fiferj', 'tbruttom', 'pspagnolo72', 'theresa.saenz.1', 'woodsh', 'alaimana', 'ross_piedmonte', 'parsonsm', 'tcurtiss', 'hallowj']"
22,253,29,28,3,"['joelchevrier', 'raymenae', 'simeonipietro']",25,"['hushuiqing', 'jstrauss', 'nl2388', 'adrianp1294', 'krigdon27', 'peng022392', 'dborntra', 'quiquealej', 'bhoogenb', 'lunx', 'mehtadh', 'ross70', 'mswitzer0221', 'nikitaemelianov1988', 'bankowskih', 'mcnallyh', 'vtarrau', 'rhanniga', 'thomprya', 'dylangroves', 'jpandher', 'dauld1', 'toby.corner', 'patel238', 'kilpatrj']",25,"['marco_347', 'giu.meuli', 'guillaume_bonnet_93', 'lefechristopher', 'emhya', 'francescomanegatti92', 'luca92.petit', 'lu.iglesiash', 'gianmarcodelbono', 'antea.risso', 'ivan.nyhanitra', 'simonadalmasso', 'amira.bencherif', 'marco92', 'mahas', 'maryam.massouras', 'alessio.fragasso', 'chiararossi1993', 'lorenzo.meraldi', 'mastari.marouane', None, 'aalexis78', 'robin.didier', 'peppe91', 'victoria.mishukova']",53,"['marco_347', 'hushuiqing', 'giu.meuli', 'joelchevrier', 'jstrauss', 'nl2388', 'guillaume_bonnet_93', 'lefechristopher', 'adrianp1294', 'krigdon27', 'emhya', 'francescomanegatti92', 'luca92.petit', 'lu.iglesiash', 'peng022392', 'dborntra', 'gianmarcodelbono', 'quiquealej', 'bhoogenb', 'antea.risso', 'ivan.nyhanitra', 'lunx', 'mehtadh', 'ross70', 'simonadalmasso', 'amira.bencherif', 'marco92', 'raymenae', 'mahas', 'maryam.massouras', 'mswitzer0221', 'alessio.fragasso', 'chiararossi1993', 'lorenzo.meraldi', 'nikitaemelianov1988', 'mastari.marouane', 'bankowskih', 'mcnallyh', None, 'simeonipietro', 'aalexis78', 'vtarrau', 'rhanniga', 'robin.didier', 'peppe91', 'thomprya', 'dylangroves', 'jpandher', 'dauld1', 'toby.corner', 'patel238', 'victoria.mishukova', 'kilpatrj']"
23,43,25,8,7,"['sandra.sastre.riera', 'ann.barrufeta', 'rbarbosa', 'helena.taribo', 'akils', 'nooshin.abdollahii', 'tom602']",17,"['menyoung', 'atulnishad', 'akopec', 'masosa15', 'pabrda', 'pgehring1', 'erinjenrette', 'aggarwr', 'pedroveralara', 'ghslab4', 'ewertonsc3', 'gntez001', 'teleco', 'cm', 'jdpinedac', 'ciatico', 'byezidahmed01']",1,[None],25,"['menyoung', 'atulnishad', 'sandra.sastre.riera', 'rbarbosa', 'pabrda', 'pgehring1', 'aggarwr', 'ghslab4', 'akils', 'gntez001', 'teleco', 'cm', 'nooshin.abdollahii', 'tom602', None, 'ann.barrufeta', 'akopec', 'masosa15', 'helena.taribo', 'pedroveralara', 'ewertonsc3', 'erinjenrette', 'jdpinedac', 'ciatico', 'byezidahmed01']"
23,42,25,6,4,"['teleco', 'rbarbosa', 'pedroveralara', 'ann.barrufeta']",20,"['menyoung', 'sandra.sastre.riera', 'pabrda', 'gntez001', 'cm', 'akopec', 'masosa15', 'helena.taribo', 'ewertonsc3', 'atulnishad', 'pgehring1', 'aggarwr', 'ghslab4', 'akils', 'tom602', 'nooshin.abdollahii', 'erinjenrette', 'jdpinedac', 'ciatico', 'byezidahmed01']",2,"[None, 'vastago']",26,"['menyoung', 'atulnishad', 'sandra.sastre.riera', 'rbarbosa', 'pabrda', 'pgehring1', 'aggarwr', 'ghslab4', 'akils', 'vastago', 'gntez001', 'teleco', 'cm', 'nooshin.abdollahii', 'tom602', None, 'ann.barrufeta', 'akopec', 'masosa15', 'helena.taribo', 'pedroveralara', 'ewertonsc3', 'erinjenrette', 'jdpinedac', 'ciatico', 'byezidahmed01']"
24,105,24,33,20,"['sourabhchrs93', 'suryaiyer95', 'shoryaconsul', 'ayushshringi', 'p.k.sahaelectronics', 'maneeshmeena7', 'mahesh.anigol', 'dollarised.kshitiz', 'mustafa.lw', 'ksiddharth435', 'kirtikantsahu14389', 'ashlesha', 'anant.jaikray', 'vivekarte24', 'rupesh_chaudhari', 'jaineshdoshi', 'hitarthiitb', 'dagasarthak', 'karthikporwal7', 'aravindh.siddhu']",3,"['nigudkar.himanshu', 'lakecitystars', 'riju2205']",13,"['aritra.l895', 'varshith178', 'irfanmk', 'jontyjashan', 'sukhi1251', 'abhimanyu.iitp', 'akashsaini163', 'siva11', 'knikhil1995', 'tandon.pulkit', None, 'priyadarshi56', 'ranvirranaiitb']",36,"['jontyjashan', 'nigudkar.himanshu', 'sukhi1251', 'sourabhchrs93', 'suryaiyer95', 'lakecitystars', 'shoryaconsul', 'ayushshringi', 'p.k.sahaelectronics', 'priyadarshi56', 'maneeshmeena7', 'varshith178', 'mahesh.anigol', 'dollarised.kshitiz', 'mustafa.lw', 'abhimanyu.iitp', 'akashsaini163', 'ksiddharth435', 'kirtikantsahu14389', 'ashlesha', 'anant.jaikray', 'riju2205', 'vivekarte24', 'tandon.pulkit', 'rupesh_chaudhari', 'jaineshdoshi', None, 'hitarthiitb', 'aritra.l895', 'dagasarthak', 'irfanmk', 'karthikporwal7', 'siva11', 'knikhil1995', 'aravindh.siddhu', 'ranvirranaiitb']"
25,95,24,18,17,"['manikgoyal273', 'changminlee86', 'evancallaway', 'jhmartin1456', 'dhfabini', 'asabbas', 'jvinckeviciute', 'curlypie10', 'danielmyersj', 'aal7assan', 'richardccramer', 'nadamski', 'claytonjcozzan', 'arwasaudabdullah', 'superspartan999', 'gundang2', 'csample']",6,"['sherifamer', 'waseemr', 'lasidemonian', 'mahmood.akbari.12', 'aemara93', 'vvadimov93']",1,[None],24,"['lasidemonian', 'claytonjcozzan', 'asabbas', 'changminlee86', 'evancallaway', 'dhfabini', 'sherifamer', 'richardccramer', 'nadamski', 'mahmood.akbari.12', 'aemara93', 'superspartan999', 'csample', 'waseemr', 'jvinckeviciute', 'curlypie10', 'gundang2', None, 'jhmartin1456', 'manikgoyal273', 'danielmyersj', 'arwasaudabdullah', 'aal7assan', 'vvadimov93']"
26,161,24,20,17,"['silja_bogfjellmo', 'longpear', 'weng448', 'danielb', 'defy1984', 'hugh.braico', 'lofaldli', 'yuxinsun225', 'nightlord666', 'ruichen77', 'weihonghe.ee', 'suvinds', 'qq2524233', 'zjqhero266', 'magnus.mariero', 'javman1986', 'maij']",6,"['neda', 'weng449', 'elec9705', 'lpedraza', 'cloud1987', 'sognanou']",3,"[None, 'alauchtz', 'speedyfro']",26,"['silja_bogfjellmo', 'defy1984', 'nightlord666', 'weihonghe.ee', 'magnus.mariero', 'weng448', 'danielb', 'ruichen77', 'lpedraza', 'cloud1987', 'neda', 'weng449', 'elec9705', 'lofaldli', 'hugh.braico', 'suvinds', 'qq2524233', 'speedyfro', 'sognanou', None, 'longpear', 'alauchtz', 'yuxinsun225', 'zjqhero266', 'javman1986', 'maij']"
27,246,24,19,13,"['divyas', 'ashinaa', 'pr13ns013', 'youvanidha', 'aravindraja145', 'arthiravi1996', 'aishwarya', 'rachelrishar', 'achuma2501', 'richellerego7', 'stephena26', 'pr13ns017', 'nithya1031996']",10,"['arkayanitama', 'mrsm1l3yz', 'pr13ns026', 'prabha23', 'gouthami', 'prisky', 'dan1233', 'abisheikv', 'tamils801', 'rupicalois']",6,"['ajithaxavier', 'tonygeorge1995', 'arkamandal', 'pavi.62kumar', 'abifeb10', None]",29,"['ajithaxavier', 'arkayanitama', 'mrsm1l3yz', 'pr13ns013', 'rachelrishar', 'abifeb10', 'stephena26', 'rupicalois', 'divyas', 'tonygeorge1995', 'aravindraja145', 'pr13ns026', 'aishwarya', 'dan1233', 'pr13ns017', 'nithya1031996', 'pavi.62kumar', 'achuma2501', 'prisky', 'arthiravi1996', 'tamils801', None, 'ashinaa', 'youvanidha', 'prabha23', 'arkamandal', 'richellerego7', 'gouthami', 'abisheikv']"
27,243,24,18,14,"['ashinaa', 'pr13ns013', 'pr13ns026', 'aravindraja145', 'prabha23', 'richellerego7', 'rachelrishar', 'prisky', 'aishwarya', 'abisheikv', 'arthiravi1996', 'tamils801', 'pr13ns017', 'nithya1031996']",9,"['arkayanitama', 'mrsm1l3yz', 'divyas', 'youvanidha', 'achuma2501', 'gouthami', 'dan1233', 'stephena26', 'rupicalois']",4,"['ajithaxavier', None, 'arkamandal', 'abifeb10']",27,"['ajithaxavier', 'arkayanitama', 'mrsm1l3yz', 'pr13ns013', 'rachelrishar', 'abifeb10', 'stephena26', 'rupicalois', 'divyas', 'aravindraja145', 'pr13ns026', 'aishwarya', 'dan1233', 'pr13ns017', 'nithya1031996', 'achuma2501', 'prisky', 'arthiravi1996', 'tamils801', None, 'ashinaa', 'youvanidha', 'prabha23', 'arkamandal', 'richellerego7', 'gouthami', 'abisheikv']"
27,240,24,17,13,"['ashinaa', 'divyas', 'pr13ns013', 'aravindraja145', 'prabha23', 'aishwarya', 'achuma2501', 'gouthami', 'abisheikv', 'arthiravi1996', 'tamils801', 'nithya1031996', 'rupicalois']",10,"['arkayanitama', 'mrsm1l3yz', 'youvanidha', 'pr13ns026', 'richellerego7', 'rachelrishar', 'prisky', 'dan1233', 'stephena26', 'pr13ns017']",4,"['ajithaxavier', None, 'arkamandal', 'abifeb10']",27,"['ajithaxavier', 'arkayanitama', 'mrsm1l3yz', 'pr13ns013', 'rachelrishar', 'abifeb10', 'stephena26', 'rupicalois', 'divyas', 'aravindraja145', 'pr13ns026', 'aishwarya', 'dan1233', 'pr13ns017', 'nithya1031996', 'achuma2501', 'prisky', 'arthiravi1996', 'tamils801', None, 'ashinaa', 'youvanidha', 'prabha23', 'arkamandal', 'richellerego7', 'gouthami', 'abisheikv']"
27,244,24,17,12,"['divyas', 'pr13ns013', 'youvanidha', 'stephena26', 'richellerego7', 'rachelrishar', 'abisheikv', 'arthiravi1996', 'tamils801', 'pr13ns017', 'nithya1031996', 'rupicalois']",11,"['arkayanitama', 'mrsm1l3yz', 'ashinaa', 'aravindraja145', 'pr13ns026', 'prabha23', 'aishwarya', 'achuma2501', 'prisky', 'dan1233', 'gouthami']",5,"['tonygeorge1995', 'arkamandal', 'pavi.62kumar', 'abifeb10', None]",28,"['arkayanitama', 'mrsm1l3yz', 'pr13ns013', 'rachelrishar', 'abifeb10', 'stephena26', 'rupicalois', 'divyas', 'tonygeorge1995', 'aravindraja145', 'pr13ns026', 'aishwarya', 'dan1233', 'pr13ns017', 'nithya1031996', 'pavi.62kumar', 'achuma2501', 'prisky', 'arthiravi1996', 'tamils801', None, 'ashinaa', 'youvanidha', 'prabha23', 'arkamandal', 'richellerego7', 'gouthami', 'abisheikv']"
27,241,24,15,11,"['ashinaa', 'youvanidha', 'richellerego7', 'aishwarya', 'prisky', 'rachelrishar', 'stephena26', 'tamils801', 'pr13ns017', 'nithya1031996', 'rupicalois']",12,"['arkayanitama', 'mrsm1l3yz', 'divyas', 'pr13ns013', 'aravindraja145', 'pr13ns026', 'prabha23', 'achuma2501', 'gouthami', 'dan1233', 'abisheikv', 'arthiravi1996']",4,"['ajithaxavier', None, 'arkamandal', 'abifeb10']",27,"['ajithaxavier', 'arkayanitama', 'mrsm1l3yz', 'pr13ns013', 'rachelrishar', 'abifeb10', 'stephena26', 'rupicalois', 'divyas', 'aravindraja145', 'pr13ns026', 'aishwarya', 'dan1233', 'pr13ns017', 'nithya1031996', 'achuma2501', 'prisky', 'arthiravi1996', 'tamils801', None, 'ashinaa', 'youvanidha', 'prabha23', 'arkamandal', 'richellerego7', 'gouthami', 'abisheikv']"
27,245,24,14,11,"['ashinaa', 'divyas', 'youvanidha', 'pr13ns026', 'prabha23', 'richellerego7', 'aishwarya', 'prisky', 'achuma2501', 'arthiravi1996', 'tamils801']",12,"['arkayanitama', 'mrsm1l3yz', 'pr13ns013', 'aravindraja145', 'rachelrishar', 'gouthami', 'dan1233', 'pr13ns017', 'abisheikv', 'stephena26', 'nithya1031996', 'rupicalois']",3,"['ajithaxavier', None, 'abifeb10']",26,"['ajithaxavier', 'arkayanitama', 'mrsm1l3yz', 'pr13ns013', 'rachelrishar', 'achuma2501', 'prisky', 'abifeb10', 'stephena26', 'arthiravi1996', 'tamils801', None, 'rupicalois', 'divyas', 'ashinaa', 'youvanidha', 'aravindraja145', 'pr13ns026', 'prabha23', 'aishwarya', 'richellerego7', 'gouthami', 'dan1233', 'pr13ns017', 'abisheikv', 'nithya1031996']"
27,237,24,13,10,"['divyas', 'pr13ns026', 'aravindraja145', 'prabha23', 'stephena26', 'gouthami', 'prisky', 'achuma2501', 'arthiravi1996', 'nithya1031996']",13,"['arkayanitama', 'mrsm1l3yz', 'ashinaa', 'pr13ns013', 'youvanidha', 'aishwarya', 'rachelrishar', 'richellerego7', 'dan1233', 'abisheikv', 'tamils801', 'pr13ns017', 'rupicalois']",3,"['ajithaxavier', None, 'arkamandal']",26,"['ajithaxavier', 'arkayanitama', 'mrsm1l3yz', 'pr13ns013', 'rachelrishar', 'achuma2501', 'prisky', 'stephena26', 'arthiravi1996', 'tamils801', None, 'rupicalois', 'divyas', 'ashinaa', 'youvanidha', 'aravindraja145', 'pr13ns026', 'prabha23', 'arkamandal', 'aishwarya', 'richellerego7', 'gouthami', 'dan1233', 'pr13ns017', 'abisheikv', 'nithya1031996']"
27,238,24,7,1,['mrsm1l3yz'],22,"['arkayanitama', 'pr13ns013', 'rachelrishar', 'stephena26', 'rupicalois', 'divyas', 'aravindraja145', 'pr13ns026', 'aishwarya', 'dan1233', 'pr13ns017', 'nithya1031996', 'achuma2501', 'prisky', 'arthiravi1996', 'tamils801', 'ashinaa', 'youvanidha', 'prabha23', 'richellerego7', 'gouthami', 'abisheikv']",6,"['rafikasari', 'keti', 'robieths', 'firasatqiya', 'yusufhakimw', None]",29,"['arkayanitama', 'mrsm1l3yz', 'rafikasari', 'pr13ns013', 'rachelrishar', 'achuma2501', 'prisky', 'robieths', 'stephena26', 'arthiravi1996', 'tamils801', None, 'rupicalois', 'divyas', 'ashinaa', 'keti', 'youvanidha', 'aravindraja145', 'pr13ns026', 'prabha23', 'aishwarya', 'richellerego7', 'gouthami', 'dan1233', 'pr13ns017', 'abisheikv', 'firasatqiya', 'yusufhakimw', 'nithya1031996']"
27,242,24,6,4,"['divyas', 'pr13ns017', 'prisky', 'nithya1031996']",19,"['arkayanitama', 'mrsm1l3yz', 'pr13ns013', 'rachelrishar', 'stephena26', 'rupicalois', 'aravindraja145', 'pr13ns026', 'aishwarya', 'dan1233', 'achuma2501', 'arthiravi1996', 'tamils801', 'ashinaa', 'youvanidha', 'prabha23', 'richellerego7', 'gouthami', 'abisheikv']",2,"[None, 'arkamandal']",25,"['arkayanitama', 'mrsm1l3yz', 'pr13ns013', 'rachelrishar', 'achuma2501', 'prisky', 'stephena26', 'arthiravi1996', 'tamils801', None, 'rupicalois', 'divyas', 'ashinaa', 'youvanidha', 'aravindraja145', 'pr13ns026', 'prabha23', 'arkamandal', 'aishwarya', 'richellerego7', 'gouthami', 'dan1233', 'pr13ns017', 'abisheikv', 'nithya1031996']"
28,196,23,26,21,"['pragunbabber', 'karmagn1', 'jrivas2', 'languageofsky', 'trander1', 'agurkhe1', 'arfat', 'hkim241', 'ipatka1', 'vgaddam1', 'nkitamu1', 'mpallay1', 'jchappa1', '15vivek92', 'rohan.joshi321', 'vpamidi1', 'leonppontes', 'pnagabh1', 'jpeter13', 'rajatarun1', 'nuttar1']",1,['chigurupati.akhi'],5,"['rushuifang', 'rjoshi4', 'beckydeng1234', None, 'mymf8']",27,"['pragunbabber', 'karmagn1', 'rushuifang', 'jrivas2', 'languageofsky', 'trander1', 'agurkhe1', 'arfat', 'hkim241', 'mymf8', 'ipatka1', 'vgaddam1', 'nkitamu1', 'mpallay1', 'jchappa1', '15vivek92', 'rohan.joshi321', 'chigurupati.akhi', 'rjoshi4', 'beckydeng1234', 'vpamidi1', 'leonppontes', None, 'jpeter13', 'pnagabh1', 'rajatarun1', 'nuttar1']"
28,123,23,25,20,"['pragunbabber', 'karmagn1', 'jrivas2', 'arfat', 'agurkhe1', 'hkim241', 'ipatka1', 'vgaddam1', 'nkitamu1', 'mpallay1', 'jchappa1', '15vivek92', 'rohan.joshi321', 'chigurupati.akhi', 'vpamidi1', 'leonppontes', 'pnagabh1', 'jpeter13', 'rajatarun1', 'nuttar1']",2,"['languageofsky', 'trander1']",5,"['rushuifang', 'beckydeng1234', 'nagabhyruphanindra', None, 'mymf8']",27,"['pragunbabber', 'karmagn1', 'rushuifang', 'jrivas2', 'languageofsky', 'trander1', 'agurkhe1', 'arfat', 'hkim241', 'mymf8', 'ipatka1', 'vgaddam1', 'nkitamu1', 'mpallay1', 'nagabhyruphanindra', 'jchappa1', '15vivek92', 'rohan.joshi321', 'chigurupati.akhi', 'beckydeng1234', 'vpamidi1', 'leonppontes', None, 'jpeter13', 'pnagabh1', 'rajatarun1', 'nuttar1']"
28,191,23,22,17,"['pragunbabber', 'karmagn1', 'pnagabh1', 'jrivas2', 'ipatka1', 'nkitamu1', 'agurkhe1', 'trander1', 'arfat', 'mpallay1', 'vpamidi1', 'hkim241', 'leonppontes', '15vivek92', 'nuttar1', 'rohan.joshi321', 'jpeter13']",5,"['chigurupati.akhi', 'languageofsky', 'vgaddam1', 'jchappa1', 'rajatarun1']",5,"['rushuifang', 'rjoshi4', 'beckydeng1234', None, 'mymf8']",27,"['pragunbabber', 'karmagn1', 'rushuifang', 'jrivas2', 'languageofsky', 'trander1', 'agurkhe1', 'arfat', 'hkim241', 'mymf8', 'ipatka1', 'vgaddam1', 'nkitamu1', 'mpallay1', 'jchappa1', '15vivek92', 'rohan.joshi321', 'chigurupati.akhi', 'rjoshi4', 'beckydeng1234', 'vpamidi1', 'leonppontes', None, 'jpeter13', 'pnagabh1', 'rajatarun1', 'nuttar1']"
28,195,23,7,6,"['languageofsky', 'mpallay1', 'vpamidi1', 'trander1', 'rajatarun1', 'pnagabh1']",16,"['pragunbabber', 'chigurupati.akhi', 'karmagn1', 'jrivas2', 'ipatka1', 'vgaddam1', 'nkitamu1', 'arfat', 'agurkhe1', 'jchappa1', 'hkim241', 'leonppontes', '15vivek92', 'nuttar1', 'rohan.joshi321', 'jpeter13']",1,[None],23,"['pragunbabber', 'chigurupati.akhi', 'karmagn1', 'jrivas2', 'languageofsky', 'trander1', 'agurkhe1', 'arfat', 'vpamidi1', 'hkim241', 'leonppontes', None, 'jpeter13', 'pnagabh1', 'ipatka1', 'vgaddam1', 'nkitamu1', 'mpallay1', 'jchappa1', 'rajatarun1', '15vivek92', 'nuttar1', 'rohan.joshi321']"
29,50,23,86,22,"['el93_el96', 'saadmohsinsiddiqui', 'faizansalehshaikh', 'anm_92', 'aq.mahmoodqadri', 'sidra2020', 'khwaja.nabeel', 'aliirfan13', 'sumbul', 'samreenasmara', 'yusra_ammara', 'sanam_sarwar', 'alifyah1', 'm1', 'ruk_tuk', 'atiyab', 'sanafaiza', 'mariamchoudry', 'erumnida', 'nageenkhatri', 'urooj.fatima.3745', 'ali.mubashir2993']",0,[],64,"['1993daniyal', 'humi1245', 'usmansiddiqui316', 'saqib.dastagir', 'muhammad.usama.shakil', 'hiraimtiaz', 'tayyabsiddiqui19', 'zainzia', 'nabeelahmed956', 'hmf1492', 'jazibabidi', 's102', 'ramal.jafri', 'daneylpasha', 'arooj.fayyaz.9', 'tubafaizan', 'mahrukhasghar', 'zohaib.khan.16752754', 'mzp482', 'farheenjahan66', 'arqamkhan', 'umair.mallick93', 'mahrukh.asghar2120', 'wasif.engineer', 'el83el85', 'el43', 'hajra16', 'sabamalik000111', 'esaleem71', 'sameer.ansari786', 'faizan_bajwa13', 'shanno447', 'mammadsiddiqui15', 'mdaniyalmansoor', 'basrahafeez2000', 'arwakhuzema93', 'sidra30', 'alishahvadsaria', 'iframoid', 'nedianbilal', None, 'najmafaiza', 'saadhussainconquer', 'nedian.tahir', 'khudaijasaleem', 'talha.aly', '1ooie', 'el301el302', 'abdulbasitdhedhi', 'faizamoazzam8', 'maheenjd', 'nabeel.ahmed.79219', 'malihaashraf05', 'x_man', 'hiraamjad028', 'malinawaz345', 'sameer786', 'mohsin.nusrat', 'mehshar', 'juniman29', 'risik', 'fizza.shamim', 'tab1', 'jalal.shahab.brothers']",86,"['1993daniyal', 'saadmohsinsiddiqui', 'saqib.dastagir', 'hiraimtiaz', 'tayyabsiddiqui19', 'zainzia', 'nabeelahmed956', 'jazibabidi', 's102', 'ramal.jafri', 'aq.mahmoodqadri', 'arooj.fayyaz.9', 'mahrukhasghar', 'mzp482', 'farheenjahan66', 'arqamkhan', 'umair.mallick93', 'el83el85', 'el43', 'sabamalik000111', 'sameer.ansari786', 'shanno447', 'mammadsiddiqui15', 'mdaniyalmansoor', 'yusra_ammara', 'arwakhuzema93', 'saadhussainconquer', 'nedian.tahir', 'khudaijasaleem', 'el301el302', 'ruk_tuk', 'abdulbasitdhedhi', 'faizamoazzam8', 'maheenjd', 'nabeel.ahmed.79219', 'atiyab', 'mariamchoudry', 'nageenkhatri', 'mehshar', 'urooj.fatima.3745', 'juniman29', 'fizza.shamim', 'nedianbilal', 'el93_el96', 'humi1245', 'faizansalehshaikh', 'usmansiddiqui316', 'anm_92', 'muhammad.usama.shakil', 'tab1', 'hmf1492', 'daneylpasha', 'tubafaizan', 'zohaib.khan.16752754', 'sidra2020', 'mahrukh.asghar2120', 'wasif.engineer', 'hajra16', 'khwaja.nabeel', 'aliirfan13', 'sumbul', 'esaleem71', 'faizan_bajwa13', 'samreenasmara', 'basrahafeez2000', 'sanam_sarwar', 'sidra30', 'alifyah1', 'alishahvadsaria', 'iframoid', None, 'najmafaiza', 'm1', 'talha.aly', '1ooie', 'malihaashraf05', 'sanafaiza', 'x_man', 'erumnida', 'hiraamjad028', 'malinawaz345', 'sameer786', 'mohsin.nusrat', 'risik', 'ali.mubashir2993', 'jalal.shahab.brothers']"
29,85,23,43,18,"['el93_el96', 'khwaja.nabeel', 'aliirfan13', 'sumbul', 'faizansalehshaikh', 'ruk_tuk', 'anm_92', 'atiyab', 'sanafaiza', 'mariamchoudry', 'erumnida', 'samreenasmara', 'nageenkhatri', 'yusra_ammara', 'alifyah1', 'ali.mubashir2993', 'aq.mahmoodqadri', 'm1']",4,"['urooj.fatima.3745', 'sidra2020', 'sanam_sarwar', 'saadmohsinsiddiqui']",25,"['tehreemzehra', 'saqib.dastagir', 'hiraimtiaz', 'tayyabsiddiqui19', 'babar.siddique2', 'hmf1492', 's102', 'ramal.jafri', 'daneylpasha', 'tubafaizan', 'mahrukh.asghar2120', 'el83el85', 'faizan_bajwa13', 'sidra30', 'alishahvadsaria', 'sana_shaukat2005', None, 'saadhussainconquer', 'el301el302', 'maheenjd', 'malihaashraf05', 'x_man', 'sameer786', 'fizza.shamim', 'tab1']",47,"['saadmohsinsiddiqui', 'saqib.dastagir', 'hiraimtiaz', 'tayyabsiddiqui19', 's102', 'ramal.jafri', 'aq.mahmoodqadri', 'el83el85', 'yusra_ammara', 'sana_shaukat2005', 'saadhussainconquer', 'el301el302', 'ruk_tuk', 'maheenjd', 'atiyab', 'mariamchoudry', 'nageenkhatri', 'urooj.fatima.3745', 'fizza.shamim', 'el93_el96', 'faizansalehshaikh', 'tehreemzehra', 'anm_92', 'tab1', 'babar.siddique2', 'hmf1492', 'daneylpasha', 'tubafaizan', 'sidra2020', 'mahrukh.asghar2120', 'khwaja.nabeel', 'aliirfan13', 'sumbul', 'faizan_bajwa13', 'samreenasmara', 'sanam_sarwar', 'sidra30', 'alifyah1', 'alishahvadsaria', None, 'm1', 'malihaashraf05', 'sanafaiza', 'x_man', 'erumnida', 'sameer786', 'ali.mubashir2993']"
29,224,23,36,19,"['el93_el96', 'saadmohsinsiddiqui', 'faizansalehshaikh', 'sidra2020', 'khwaja.nabeel', 'aliirfan13', 'sumbul', 'samreenasmara', 'sanam_sarwar', 'alifyah1', 'm1', 'ruk_tuk', 'atiyab', 'sanafaiza', 'mariamchoudry', 'erumnida', 'nageenkhatri', 'urooj.fatima.3745', 'ali.mubashir2993']",3,"['anm_92', 'yusra_ammara', 'aq.mahmoodqadri']",17,"['babarchacher', 'el301el302', 'maheenjd', 'sabanazir001', 'esaleem71', 'malihaashraf05', 'el83el85', 'zainzia', 'huda.parvez01', 'sidra30', 'ahsansag94', 's102', 'syedfamily222', 'ramal.jafri', None, 'talha.aly', 'saadhussainconquer']",39,"['el93_el96', 'saadmohsinsiddiqui', 'faizansalehshaikh', 'anm_92', 'zainzia', 's102', 'ramal.jafri', 'aq.mahmoodqadri', 'sidra2020', 'el83el85', 'huda.parvez01', 'khwaja.nabeel', 'aliirfan13', 'babarchacher', 'sumbul', 'sabanazir001', 'esaleem71', 'samreenasmara', 'yusra_ammara', 'sanam_sarwar', 'sidra30', 'alifyah1', None, 'talha.aly', 'm1', 'saadhussainconquer', 'el301el302', 'ruk_tuk', 'maheenjd', 'atiyab', 'sanafaiza', 'mariamchoudry', 'erumnida', 'malihaashraf05', 'nageenkhatri', 'ahsansag94', 'urooj.fatima.3745', 'syedfamily222', 'ali.mubashir2993']"
29,80,23,34,15,"['el93_el96', 'khwaja.nabeel', 'aliirfan13', 'sumbul', 'ruk_tuk', 'anm_92', 'sidra2020', 'mariamchoudry', 'samreenasmara', 'erumnida', 'urooj.fatima.3745', 'alifyah1', 'ali.mubashir2993', 'aq.mahmoodqadri', 'm1']",7,"['saadmohsinsiddiqui', 'faizansalehshaikh', 'atiyab', 'sanafaiza', 'nageenkhatri', 'yusra_ammara', 'sanam_sarwar']",19,"['hannanwildfire', 'hiraimtiaz', 'ahsansag93', 'tayyabsiddiqui19', 'zainzia', 'hmf1492', 'ramal.jafri', 'tubafaizan', 'el83el85', 'babarchacher', 'esaleem71', None, 'najmafaiza', 'saadhussainconquer', 'faizamoazzam8', 'x_man', 'sameer786', 'risik', 'fizza.shamim']",41,"['el93_el96', 'saadmohsinsiddiqui', 'faizansalehshaikh', 'hannanwildfire', 'anm_92', 'hiraimtiaz', 'ahsansag93', 'tayyabsiddiqui19', 'zainzia', 'hmf1492', 'ramal.jafri', 'aq.mahmoodqadri', 'tubafaizan', 'sidra2020', 'el83el85', 'khwaja.nabeel', 'aliirfan13', 'babarchacher', 'sumbul', 'esaleem71', 'samreenasmara', 'yusra_ammara', 'sanam_sarwar', 'alifyah1', None, 'najmafaiza', 'm1', 'saadhussainconquer', 'ruk_tuk', 'faizamoazzam8', 'atiyab', 'sanafaiza', 'mariamchoudry', 'erumnida', 'x_man', 'nageenkhatri', 'sameer786', 'urooj.fatima.3745', 'risik', 'fizza.shamim', 'ali.mubashir2993']"
29,81,23,33,17,"['el93_el96', 'aliirfan13', 'saadmohsinsiddiqui', 'faizansalehshaikh', 'sumbul', 'ruk_tuk', 'anm_92', 'atiyab', 'sanafaiza', 'mariamchoudry', 'erumnida', 'samreenasmara', 'nageenkhatri', 'sanam_sarwar', 'alifyah1', 'aq.mahmoodqadri', 'm1']",5,"['khwaja.nabeel', 'sidra2020', 'yusra_ammara', 'urooj.fatima.3745', 'ali.mubashir2993']",16,"['tubafaizan', 'el301el302', 'maheenjd', 'saqib.dastagir', 'esaleem71', 'malihaashraf05', 'talhathefuture', 'basrahafeez2000', 'sameer786', 'el83el85', 'jazibabidi', 'sidra30', 'sana_shaukat2005', 'tab1', None, 'saadhussainconquer']",38,"['el93_el96', 'saadmohsinsiddiqui', 'faizansalehshaikh', 'saqib.dastagir', 'anm_92', 'tab1', 'jazibabidi', 'aq.mahmoodqadri', 'tubafaizan', 'sidra2020', 'el83el85', 'khwaja.nabeel', 'aliirfan13', 'sumbul', 'esaleem71', 'samreenasmara', 'talhathefuture', 'basrahafeez2000', 'yusra_ammara', 'sanam_sarwar', 'sidra30', 'alifyah1', 'sana_shaukat2005', None, 'm1', 'saadhussainconquer', 'el301el302', 'ruk_tuk', 'maheenjd', 'atiyab', 'sanafaiza', 'mariamchoudry', 'erumnida', 'malihaashraf05', 'nageenkhatri', 'sameer786', 'urooj.fatima.3745', 'ali.mubashir2993']"
29,223,23,29,9,"['sumbul', 'ruk_tuk', 'anm_92', 'atiyab', 'mariamchoudry', 'samreenasmara', 'nageenkhatri', 'alifyah1', 'aq.mahmoodqadri']",13,"['el93_el96', 'khwaja.nabeel', 'aliirfan13', 'saadmohsinsiddiqui', 'faizansalehshaikh', 'sanafaiza', 'sidra2020', 'erumnida', 'yusra_ammara', 'sanam_sarwar', 'urooj.fatima.3745', 'ali.mubashir2993', 'm1']",20,"['shafaqzehra1', 'tehreemzehra', 'jazibabidi', 'nabeelahmed956', 'tubafaizan', 'farheenjahan66', 'engrmkumailali', 'sabanazir001', 'mammadsiddiqui15', 'talhathefuture', 'basrahafeez2000', 'sidra30', 'sana_shaukat2005', None, 'khudaijasaleem', 'maheenjd', 'malihaashraf05', 'jazib.kaleem', 'sameer786', 'tab1']",42,"['el93_el96', 'saadmohsinsiddiqui', 'faizansalehshaikh', 'shafaqzehra1', 'tehreemzehra', 'anm_92', 'tab1', 'jazibabidi', 'nabeelahmed956', 'aq.mahmoodqadri', 'tubafaizan', 'sidra2020', 'farheenjahan66', 'engrmkumailali', 'khwaja.nabeel', 'aliirfan13', 'sumbul', 'sabanazir001', 'samreenasmara', 'mammadsiddiqui15', 'talhathefuture', 'basrahafeez2000', 'yusra_ammara', 'sanam_sarwar', 'sidra30', 'alifyah1', 'sana_shaukat2005', None, 'm1', 'khudaijasaleem', 'ruk_tuk', 'maheenjd', 'atiyab', 'sanafaiza', 'mariamchoudry', 'erumnida', 'malihaashraf05', 'nageenkhatri', 'jazib.kaleem', 'sameer786', 'urooj.fatima.3745', 'ali.mubashir2993']"
29,65,23,20,8,"['aliirfan13', 'ruk_tuk', 'faizansalehshaikh', 'sanafaiza', 'erumnida', 'nageenkhatri', 'yusra_ammara', 'urooj.fatima.3745']",14,"['el93_el96', 'khwaja.nabeel', 'saadmohsinsiddiqui', 'sumbul', 'anm_92', 'atiyab', 'sidra2020', 'mariamchoudry', 'samreenasmara', 'sanam_sarwar', 'alifyah1', 'ali.mubashir2993', 'aq.mahmoodqadri', 'm1']",12,"['tubafaizan', '1ooie', 'esaleem71', 'malihaashraf05', 'tayyabsiddiqui19', 'talhathefuture', 'el83el85', 'sidra30', 's102', 'ramal.jafri', None, 'daneylpasha']",34,"['el93_el96', 'saadmohsinsiddiqui', 'faizansalehshaikh', 'anm_92', 'tayyabsiddiqui19', 's102', 'ramal.jafri', 'aq.mahmoodqadri', 'daneylpasha', 'tubafaizan', 'sidra2020', 'el83el85', 'khwaja.nabeel', 'aliirfan13', 'sumbul', 'esaleem71', 'samreenasmara', 'talhathefuture', 'yusra_ammara', 'sanam_sarwar', 'sidra30', 'alifyah1', None, 'm1', '1ooie', 'ruk_tuk', 'atiyab', 'sanafaiza', 'mariamchoudry', 'erumnida', 'malihaashraf05', 'nageenkhatri', 'urooj.fatima.3745', 'ali.mubashir2993']"
29,225,23,20,7,"['sumbul', 'ruk_tuk', 'anm_92', 'sidra2020', 'nageenkhatri', 'alifyah1', 'ali.mubashir2993']",15,"['el93_el96', 'khwaja.nabeel', 'aliirfan13', 'saadmohsinsiddiqui', 'faizansalehshaikh', 'atiyab', 'sanafaiza', 'mariamchoudry', 'erumnida', 'samreenasmara', 'yusra_ammara', 'sanam_sarwar', 'urooj.fatima.3745', 'aq.mahmoodqadri', 'm1']",13,"['maheenjd', 'malihaashraf05', 'x_man', 'mdaniyalmansoor', 'zainzia', 'sidra30', 'risik', 'sana_shaukat2005', 'ramal.jafri', 'tab1', None, 'talha.aly', 'saadhussainconquer']",35,"['el93_el96', 'saadmohsinsiddiqui', 'faizansalehshaikh', 'anm_92', 'tab1', 'zainzia', 'ramal.jafri', 'aq.mahmoodqadri', 'sidra2020', 'khwaja.nabeel', 'aliirfan13', 'sumbul', 'samreenasmara', 'mdaniyalmansoor', 'yusra_ammara', 'sanam_sarwar', 'sidra30', 'alifyah1', 'sana_shaukat2005', None, 'talha.aly', 'm1', 'saadhussainconquer', 'ruk_tuk', 'maheenjd', 'atiyab', 'sanafaiza', 'mariamchoudry', 'erumnida', 'malihaashraf05', 'nageenkhatri', 'x_man', 'urooj.fatima.3745', 'risik', 'ali.mubashir2993']"
29,87,23,19,7,"['khwaja.nabeel', 'ruk_tuk', 'sidra2020', 'mariamchoudry', 'urooj.fatima.3745', 'alifyah1', 'm1']",15,"['el93_el96', 'aliirfan13', 'saadmohsinsiddiqui', 'faizansalehshaikh', 'sumbul', 'anm_92', 'atiyab', 'sanafaiza', 'erumnida', 'samreenasmara', 'nageenkhatri', 'yusra_ammara', 'sanam_sarwar', 'ali.mubashir2993', 'aq.mahmoodqadri']",12,"['tubafaizan', 'babarchacher', 'faizamoazzam8', 'maheenjd', 'esaleem71', 'ahsansag93', 'tayyabsiddiqui19', 'sameer786', 'fizza.shamim', 'ramal.jafri', None, 'najmafaiza']",34,"['el93_el96', 'saadmohsinsiddiqui', 'faizansalehshaikh', 'anm_92', 'ahsansag93', 'tayyabsiddiqui19', 'ramal.jafri', 'aq.mahmoodqadri', 'tubafaizan', 'sidra2020', 'khwaja.nabeel', 'aliirfan13', 'babarchacher', 'sumbul', 'esaleem71', 'samreenasmara', 'yusra_ammara', 'sanam_sarwar', 'alifyah1', None, 'najmafaiza', 'm1', 'ruk_tuk', 'faizamoazzam8', 'maheenjd', 'atiyab', 'sanafaiza', 'mariamchoudry', 'erumnida', 'nageenkhatri', 'sameer786', 'urooj.fatima.3745', 'fizza.shamim', 'ali.mubashir2993']"
29,226,23,18,7,"['aliirfan13', 'el93_el96', 'faizansalehshaikh', 'sanafaiza', 'erumnida', 'yusra_ammara', 'sanam_sarwar']",15,"['khwaja.nabeel', 'saadmohsinsiddiqui', 'sumbul', 'ruk_tuk', 'anm_92', 'atiyab', 'sidra2020', 'mariamchoudry', 'samreenasmara', 'nageenkhatri', 'urooj.fatima.3745', 'alifyah1', 'ali.mubashir2993', 'aq.mahmoodqadri', 'm1']",11,"['el301el302', 'saqib.dastagir', 'esaleem71', 'malihaashraf05', 'x_man', 'el83el85', 'syedfamily222', 'ramal.jafri', None, 'saadhussainconquer', 'daneylpasha']",33,"['el93_el96', 'saadmohsinsiddiqui', 'faizansalehshaikh', 'saqib.dastagir', 'anm_92', 'ramal.jafri', 'aq.mahmoodqadri', 'daneylpasha', 'sidra2020', 'el83el85', 'khwaja.nabeel', 'aliirfan13', 'sumbul', 'esaleem71', 'samreenasmara', 'yusra_ammara', 'sanam_sarwar', 'alifyah1', None, 'm1', 'saadhussainconquer', 'el301el302', 'ruk_tuk', 'atiyab', 'sanafaiza', 'mariamchoudry', 'erumnida', 'malihaashraf05', 'nageenkhatri', 'x_man', 'urooj.fatima.3745', 'syedfamily222', 'ali.mubashir2993']"
29,82,23,8,2,"['el93_el96', 'sidra2020']",20,"['saadmohsinsiddiqui', 'faizansalehshaikh', 'anm_92', 'aq.mahmoodqadri', 'khwaja.nabeel', 'aliirfan13', 'sumbul', 'samreenasmara', 'yusra_ammara', 'sanam_sarwar', 'alifyah1', 'm1', 'ruk_tuk', 'atiyab', 'sanafaiza', 'mariamchoudry', 'erumnida', 'nageenkhatri', 'urooj.fatima.3745', 'ali.mubashir2993']",6,"['maheenjd', 'sameer786', 'risik', 'huda.parvez01', 'hajra16', None]",28,"['el93_el96', 'khwaja.nabeel', 'aliirfan13', 'saadmohsinsiddiqui', 'faizansalehshaikh', 'sumbul', 'anm_92', 'samreenasmara', 'yusra_ammara', 'sanam_sarwar', 'alifyah1', 'aq.mahmoodqadri', None, 'm1', 'ruk_tuk', 'maheenjd', 'atiyab', 'sanafaiza', 'sidra2020', 'mariamchoudry', 'erumnida', 'nageenkhatri', 'sameer786', 'urooj.fatima.3745', 'risik', 'huda.parvez01', 'hajra16', 'ali.mubashir2993']"
29,88,23,7,4,"['atiyab', 'sanafaiza', 'saadmohsinsiddiqui', 'faizansalehshaikh']",18,"['el93_el96', 'khwaja.nabeel', 'aliirfan13', 'sumbul', 'ruk_tuk', 'anm_92', 'sidra2020', 'mariamchoudry', 'samreenasmara', 'erumnida', 'nageenkhatri', 'yusra_ammara', 'sanam_sarwar', 'urooj.fatima.3745', 'alifyah1', 'ali.mubashir2993', 'aq.mahmoodqadri', 'm1']",3,"['khudaijasaleem', None, 'saadhussainconquer']",25,"['el93_el96', 'khwaja.nabeel', 'aliirfan13', 'saadmohsinsiddiqui', 'faizansalehshaikh', 'sumbul', 'anm_92', 'samreenasmara', 'yusra_ammara', 'sanam_sarwar', 'alifyah1', 'aq.mahmoodqadri', None, 'm1', 'saadhussainconquer', 'khudaijasaleem', 'ruk_tuk', 'atiyab', 'sanafaiza', 'sidra2020', 'mariamchoudry', 'erumnida', 'nageenkhatri', 'urooj.fatima.3745', 'ali.mubashir2993']"
29,52,23,6,1,['aq.mahmoodqadri'],21,"['el93_el96', 'saadmohsinsiddiqui', 'faizansalehshaikh', 'anm_92', 'sidra2020', 'khwaja.nabeel', 'aliirfan13', 'sumbul', 'samreenasmara', 'yusra_ammara', 'sanam_sarwar', 'alifyah1', 'm1', 'ruk_tuk', 'atiyab', 'sanafaiza', 'mariamchoudry', 'erumnida', 'nageenkhatri', 'urooj.fatima.3745', 'ali.mubashir2993']",5,"['faizamoazzam8', 'sidra30', 'tab1', None, 'najmafaiza']",27,"['el93_el96', 'khwaja.nabeel', 'aliirfan13', 'saadmohsinsiddiqui', 'faizansalehshaikh', 'sumbul', 'anm_92', 'samreenasmara', 'tab1', 'yusra_ammara', 'sanam_sarwar', 'sidra30', 'alifyah1', 'aq.mahmoodqadri', None, 'm1', 'najmafaiza', 'ruk_tuk', 'faizamoazzam8', 'atiyab', 'sanafaiza', 'sidra2020', 'mariamchoudry', 'erumnida', 'nageenkhatri', 'urooj.fatima.3745', 'ali.mubashir2993']"
30,62,19,17,11,"['jhalloran', 'aboynton', 'msandhu', 'wenwen.w.huang', 'avahdati', 'lracz', 'theonlycappy', 'lucacironi87', 'smiranda80', 'prajak', 'ninadinjaski']",7,"['roftadeh65', 'edmundwschuster', 'stgaitan', 'shengjie', 'yrs22', 'karandoss', 'akinorikochi']",6,"['sweet711', 'yyd708', 'mfiorella', 'wylbeleiv', 'gayno015', None]",24,"['jhalloran', 'msandhu', 'wenwen.w.huang', 'edmundwschuster', 'yyd708', 'mfiorella', 'shengjie', 'lracz', 'wylbeleiv', 'gayno015', 'lucacironi87', 'yrs22', 'prajak', None, 'akinorikochi', 'roftadeh65', 'aboynton', 'sweet711', 'avahdati', 'stgaitan', 'ninadinjaski', 'theonlycappy', 'karandoss', 'smiranda80']"
30,63,19,13,8,"['roftadeh65', 'aboynton', 'edmundwschuster', 'lracz', 'theonlycappy', 'yrs22', 'karandoss', 'akinorikochi']",10,"['jhalloran', 'msandhu', 'wenwen.w.huang', 'avahdati', 'stgaitan', 'ninadinjaski', 'shengjie', 'lucacironi87', 'prajak', 'smiranda80']",5,"['jylee', 'nej', 'mfiorella', 'wylbeleiv', None]",23,"['jhalloran', 'msandhu', 'wenwen.w.huang', 'edmundwschuster', 'mfiorella', 'shengjie', 'lracz', 'wylbeleiv', 'lucacironi87', 'yrs22', 'prajak', None, 'akinorikochi', 'roftadeh65', 'aboynton', 'jylee', 'nej', 'avahdati', 'stgaitan', 'ninadinjaski', 'theonlycappy', 'karandoss', 'smiranda80']"
31,76,19,25,18,"['afchadwi', 'chandraveer', 'aak126', 'timchamb', 'bluefish817', 'yingma', 'hzxsbigpig', 'njchen', 'jhyang', 'ramansbach', 'jianluo', 'ksnvikrant', 'gann.reddy', 'wband', 'mdsalahuddin', 'kubra87', 'dmfreema', 'wxiong']",0,[],7,"['joannamm', 'mdasta', 'ajana', 'son536', 'laagesen', None, 'efrainhr']",25,"['bluefish817', 'njchen', 'ksnvikrant', 'wband', 'mdsalahuddin', 'afchadwi', 'aak126', 'hzxsbigpig', 'ramansbach', 'gann.reddy', 'laagesen', 'chandraveer', 'timchamb', 'joannamm', 'dmfreema', 'wxiong', None, 'mdasta', 'efrainhr', 'yingma', 'jhyang', 'ajana', 'son536', 'kubra87', 'jianluo']"
31,269,19,25,18,"['afchadwi', 'chandraveer', 'aak126', 'timchamb', 'bluefish817', 'yingma', 'hzxsbigpig', 'njchen', 'jhyang', 'ramansbach', 'jianluo', 'ksnvikrant', 'gann.reddy', 'wband', 'mdsalahuddin', 'kubra87', 'dmfreema', 'wxiong']",0,[],7,"['joannamm', 'mdasta', 'ajana', 'son536', 'laagesen', None, 'efrainhr']",25,"['bluefish817', 'njchen', 'ksnvikrant', 'wband', 'mdsalahuddin', 'afchadwi', 'aak126', 'hzxsbigpig', 'ramansbach', 'gann.reddy', 'laagesen', 'chandraveer', 'timchamb', 'joannamm', 'dmfreema', 'wxiong', None, 'mdasta', 'efrainhr', 'yingma', 'jhyang', 'ajana', 'son536', 'kubra87', 'jianluo']"
31,157,19,23,18,"['afchadwi', 'chandraveer', 'aak126', 'timchamb', 'bluefish817', 'yingma', 'hzxsbigpig', 'njchen', 'jhyang', 'ramansbach', 'jianluo', 'ksnvikrant', 'gann.reddy', 'wband', 'mdsalahuddin', 'kubra87', 'dmfreema', 'wxiong']",0,[],5,"['joannamm', 'son536', 'laagesen', None, 'efrainhr']",23,"['bluefish817', 'njchen', 'ksnvikrant', 'wband', 'mdsalahuddin', 'afchadwi', 'aak126', 'hzxsbigpig', 'ramansbach', 'gann.reddy', 'laagesen', 'chandraveer', 'timchamb', 'joannamm', 'dmfreema', 'wxiong', None, 'efrainhr', 'yingma', 'jhyang', 'son536', 'kubra87', 'jianluo']"
31,77,19,14,8,"['afchadwi', 'hzxsbigpig', 'njchen', 'jhyang', 'ramansbach', 'gann.reddy', 'wband', 'mdsalahuddin']",10,"['chandraveer', 'aak126', 'timchamb', 'bluefish817', 'yingma', 'ksnvikrant', 'dmfreema', 'kubra87', 'jianluo', 'wxiong']",6,"['ylifan', 'joannamm', 'mdasta', 'ajana', None, 'efrainhr']",24,"['chandraveer', 'timchamb', 'ylifan', 'bluefish817', 'joannamm', 'njchen', 'ksnvikrant', 'wband', 'mdsalahuddin', 'dmfreema', 'wxiong', 'mdasta', None, 'efrainhr', 'afchadwi', 'aak126', 'yingma', 'hzxsbigpig', 'jhyang', 'ramansbach', 'ajana', 'gann.reddy', 'kubra87', 'jianluo']"
31,270,19,7,5,"['afchadwi', 'njchen', 'ramansbach', 'gann.reddy', 'mdsalahuddin']",13,"['chandraveer', 'aak126', 'timchamb', 'bluefish817', 'yingma', 'hzxsbigpig', 'jhyang', 'ksnvikrant', 'wband', 'dmfreema', 'kubra87', 'jianluo', 'wxiong']",2,"[None, 'efrainhr']",20,"['chandraveer', 'timchamb', 'bluefish817', 'njchen', 'ksnvikrant', 'wband', 'mdsalahuddin', 'dmfreema', 'wxiong', None, 'efrainhr', 'afchadwi', 'aak126', 'yingma', 'hzxsbigpig', 'jhyang', 'ramansbach', 'gann.reddy', 'kubra87', 'jianluo']"
32,24,19,12,10,"['yuyang_li', 'jianfei_zhao', 'hew1', 'dtobe2012', 'pjl3', 'dante1111', 'hjwhjw123', 'ariana_spentzos', 'jninia', 'jon1']",8,"['ozhan.ozatay', 'ankitshrm11', 'saurav.gupta.melli', 'lunajlt', 'acaviglia', 'hanafox789', 'ruthenium', 'sangeeth']",2,"[None, 'junrui.li']",20,"['ozhan.ozatay', 'ankitshrm11', 'lunajlt', 'acaviglia', 'junrui.li', 'hanafox789', 'ariana_spentzos', 'jninia', None, 'yuyang_li', 'jianfei_zhao', 'hew1', 'dtobe2012', 'saurav.gupta.melli', 'pjl3', 'dante1111', 'hjwhjw123', 'ruthenium', 'sangeeth', 'jon1']"
32,35,19,7,1,['lunajlt'],17,"['ozhan.ozatay', 'jianfei_zhao', 'hew1', 'yuyang_li', 'dtobe2012', 'jon1', 'ankitshrm11', 'saurav.gupta.melli', 'pjl3', 'acaviglia', 'hanafox789', 'dante1111', 'hjwhjw123', 'ruthenium', 'ariana_spentzos', 'sangeeth', 'jninia']",6,"['a9b1c3', 'ferry', 'jackson.alec', 'rpraneeth06', None, 'sulemansami']",24,"['ozhan.ozatay', 'ankitshrm11', 'lunajlt', 'ferry', 'acaviglia', 'jackson.alec', 'hanafox789', 'ariana_spentzos', 'jninia', None, 'sulemansami', 'yuyang_li', 'jianfei_zhao', 'hew1', 'dtobe2012', 'a9b1c3', 'saurav.gupta.melli', 'pjl3', 'dante1111', 'rpraneeth06', 'hjwhjw123', 'ruthenium', 'sangeeth', 'jon1']"
33,109,19,15,10,"['giovonik', 'tallis', 'lphelp3', 'nblanc4', 'lifeiscool84', 'pchaco2', 'taxochacon', 'x.chen311', 'ayoun55', 'daniel.lepkowski']",8,"['shreyasmangalgi', 'frederic.gueth', 'manumu1', 'sizan007', 'evropa', 'rahulchangder', 'pc2007g', 'sakshi.g6']",5,"['hamed.shamkhali', 'zhouzhao', 'dravar1', 'amehrn1', None]",23,"['giovonik', 'shreyasmangalgi', 'tallis', 'lphelp3', 'manumu1', 'sizan007', 'nblanc4', 'zhouzhao', 'taxochacon', 'pchaco2', 'evropa', 'dravar1', 'x.chen311', 'amehrn1', 'pc2007g', None, 'sakshi.g6', 'frederic.gueth', 'lifeiscool84', 'hamed.shamkhali', 'rahulchangder', 'ayoun55', 'daniel.lepkowski']"
33,108,19,7,3,"['nblanc4', 'taxochacon', 'x.chen311']",15,"['giovonik', 'shreyasmangalgi', 'tallis', 'lphelp3', 'manumu1', 'frederic.gueth', 'sizan007', 'lifeiscool84', 'pchaco2', 'evropa', 'rahulchangder', 'ayoun55', 'daniel.lepkowski', 'pc2007g', 'sakshi.g6']",4,"['hamed.shamkhali', None, 'zhouzhao', 'amehrn1']",22,"['giovonik', 'shreyasmangalgi', 'tallis', 'lphelp3', 'manumu1', 'sizan007', 'nblanc4', 'zhouzhao', 'taxochacon', 'pchaco2', 'evropa', 'x.chen311', 'amehrn1', 'pc2007g', None, 'sakshi.g6', 'frederic.gueth', 'lifeiscool84', 'hamed.shamkhali', 'rahulchangder', 'ayoun55', 'daniel.lepkowski']"
34,25,19,22,14,"['samdias146', 'anikchowdhury', 'hasibdalim', 'navidanjumaadit', 'nujhat_91', 'rheo126', 'sgk15', 'hakimfaysal', 'rakibhyder', 'raisafabiha', 'amit31416', 'farjanasnigdha', 'chinmoysaha84', 'nishat118']",4,"['uti.rani101', 'sutapa.debnath08', 'mounin.ruthi10', 'pri91']",8,"['shuvajit.photo', 'jubayer', 'ehsan', 'aqeeb.i.arka', 'asir.sakib', 'raju024', 'tuloy10', None]",26,"['samdias146', 'anikchowdhury', 'hasibdalim', 'nujhat_91', 'hakimfaysal', 'shuvajit.photo', 'amit31416', 'mounin.ruthi10', 'tuloy10', 'nishat118', 'ehsan', 'navidanjumaadit', 'uti.rani101', 'rakibhyder', 'raisafabiha', 'sutapa.debnath08', 'chinmoysaha84', 'rheo126', None, 'jubayer', 'aqeeb.i.arka', 'asir.sakib', 'raju024', 'sgk15', 'pri91', 'farjanasnigdha']"
34,34,19,21,13,"['samdias146', 'anikchowdhury', 'nujhat_91', 'navidanjumaadit', 'rheo126', 'sgk15', 'hakimfaysal', 'rakibhyder', 'raisafabiha', 'amit31416', 'farjanasnigdha', 'chinmoysaha84', 'nishat118']",5,"['hasibdalim', 'pri91', 'uti.rani101', 'mounin.ruthi10', 'sutapa.debnath08']",8,"['shuvajit.photo', 'jubayer', 'asir.sakib', 'sayeedchowdhury', 'raju024', 'oishi.nnc', 'tuloy10', None]",26,"['samdias146', 'anikchowdhury', 'hasibdalim', 'nujhat_91', 'hakimfaysal', 'oishi.nnc', 'shuvajit.photo', 'amit31416', 'mounin.ruthi10', 'tuloy10', 'nishat118', 'navidanjumaadit', 'sayeedchowdhury', 'uti.rani101', 'rakibhyder', 'raisafabiha', 'sutapa.debnath08', 'chinmoysaha84', 'rheo126', None, 'jubayer', 'asir.sakib', 'raju024', 'sgk15', 'pri91', 'farjanasnigdha']"
34,16,19,7,1,['chinmoysaha84'],17,"['samdias146', 'anikchowdhury', 'hasibdalim', 'sutapa.debnath08', 'navidanjumaadit', 'nujhat_91', 'rheo126', 'sgk15', 'hakimfaysal', 'pri91', 'uti.rani101', 'rakibhyder', 'raisafabiha', 'amit31416', 'mounin.ruthi10', 'farjanasnigdha', 'nishat118']",6,"['raju024', 'mhdhsn48', 'asad43', 'tuloy10', 'mrinmoy.pol', None]",24,"['samdias146', 'anikchowdhury', 'hasibdalim', 'navidanjumaadit', 'nujhat_91', 'hakimfaysal', 'uti.rani101', 'rakibhyder', 'raisafabiha', 'sutapa.debnath08', 'chinmoysaha84', 'rheo126', 'mrinmoy.pol', None, 'tuloy10', 'raju024', 'sgk15', 'pri91', 'amit31416', 'asad43', 'mhdhsn48', 'mounin.ruthi10', 'farjanasnigdha', 'nishat118']"
34,33,19,7,3,"['anikchowdhury', 'nujhat_91', 'navidanjumaadit']",15,"['samdias146', 'hasibdalim', 'sutapa.debnath08', 'rheo126', 'sgk15', 'hakimfaysal', 'pri91', 'uti.rani101', 'rakibhyder', 'raisafabiha', 'amit31416', 'mounin.ruthi10', 'farjanasnigdha', 'chinmoysaha84', 'nishat118']",4,"['shuvajit.photo', 'raju024', None, 'anit.ahsan']",22,"['samdias146', 'anikchowdhury', 'hasibdalim', 'navidanjumaadit', 'nujhat_91', 'hakimfaysal', 'uti.rani101', 'rakibhyder', 'raisafabiha', 'anit.ahsan', 'sutapa.debnath08', 'chinmoysaha84', 'rheo126', None, 'shuvajit.photo', 'raju024', 'sgk15', 'pri91', 'amit31416', 'mounin.ruthi10', 'farjanasnigdha', 'nishat118']"
35,59,18,15,13,"['thomas901', 'veramos15', 'jeffreyasu', 'spdewitt', 'alvaro14', 'kfang5', 'kuanwang', 'connorchilton', 'glass08', 'jasisson', 'hustzzh1992', 'cfarnsw2', 'nagendra09']",4,"['hcm386', 'pryan02', 'raypropoggio', 'kdtyler1']",2,"['chrismay', None]",19,"['veramos15', 'jeffreyasu', 'kfang5', 'glass08', 'jasisson', 'chrismay', 'hustzzh1992', 'cfarnsw2', None, 'thomas901', 'spdewitt', 'alvaro14', 'connorchilton', 'kdtyler1', 'kuanwang', 'hcm386', 'raypropoggio', 'pryan02', 'nagendra09']"
36,138,18,59,16,"['dacapo007', 'sboes95', 'sullivaf', 'haojiex', 'mmckinne', 'thoma386', 'pspagnolo72', 'mcapestr', 'zhu431', 'pnorman', 'jinghan1022', 'lim154', 'lucas.ray.169', 'aianlo', 'tlshelhart', 'ncain3']",1,['dhurley'],43,"['lopez86', 'nspear17', 'kim383', 'clandon01', 'spschriver', 'jcassady30', 'posta', 'tictonk', 'pangb1', 'paulleonc', 'azzedinr', 'telliott', 'robin198', 'adithyabhattachar', 'horner4', 'xphuah', 'jfschrad', 'alexj9', 'gflesner', 'astronut95', 'cohen.jakedavid', 'tbruttom', 'theresa.saenz.1', 'czy121301', 'parsonsm', 'hallowj', 'kaiser17', 'smithjared1994', 'jiamanhe', 'li1470', 'mjankowicz', 'richa201', 'vganapa', 'mkatamba', None, 'ahmed49', 'ramirez28', 'jtrouba', 'fiferj', 'woodsh', 'ross_piedmonte', 'glinvill', 'tcurtiss']",60,"['nspear17', 'clandon01', 'spschriver', 'pangb1', 'paulleonc', 'azzedinr', 'telliott', 'ncain3', 'horner4', 'jfschrad', 'alexj9', 'theresa.saenz.1', 'czy121301', 'tlshelhart', 'hallowj', 'smithjared1994', 'haojiex', 'li1470', 'mmckinne', 'jinghan1022', 'vganapa', 'lucas.ray.169', 'ahmed49', 'ramirez28', 'sullivaf', 'sboes95', 'pspagnolo72', 'woodsh', 'ross_piedmonte', 'glinvill', 'dacapo007', 'lopez86', 'kim383', 'jcassady30', 'posta', 'mcapestr', 'zhu431', 'tictonk', 'robin198', 'adithyabhattachar', 'aianlo', 'xphuah', 'gflesner', 'astronut95', 'cohen.jakedavid', 'tbruttom', 'lim154', 'parsonsm', 'kaiser17', 'jiamanhe', 'dhurley', 'mjankowicz', 'richa201', 'mkatamba', None, 'jtrouba', 'fiferj', 'thoma386', 'pnorman', 'tcurtiss']"
36,268,18,55,8,"['dacapo007', 'sboes95', 'sullivaf', 'mmckinne', 'thoma386', 'pspagnolo72', 'zhu431', 'lim154']",9,"['haojiex', 'dhurley', 'mcapestr', 'jinghan1022', 'pnorman', 'lucas.ray.169', 'aianlo', 'tlshelhart', 'ncain3']",47,"['lopez86', 'nspear17', 'dtisdale', 'kim383', 'sawa', 'posta', 'fernandd63', 'tictonk', 'jcassady30', 'paulleonc', 'azzedinr', 'robin198', 'adithyabhattachar', 'horner4', 'ljc99', 'xphuah', 'jfschrad', 'gflesner', 'astronut95', 'cohen.jakedavid', 'tbruttom', 'czy121301', 'parsonsm', 'hallowj', 'kaiser17', 'campb122', 'smithjared1994', 'leavittm0', 'peachrings', 'haller1', 'richa201', 'vganapa', 'redwing', None, 'ahmed49', 'ramirez28', 'jtrouba', 'jackie0212', 'glhinkle', 'matthew.l.binkley', 'fiferj', 'ajana', 'woodsh', 'alaimana', 'ross_piedmonte', 'gu97', 'tcurtiss']",64,"['alaimana', 'nspear17', 'fernandd63', 'paulleonc', 'azzedinr', 'ncain3', 'horner4', 'jfschrad', 'czy121301', 'tlshelhart', 'hallowj', 'campb122', 'smithjared1994', 'haojiex', 'mmckinne', 'jinghan1022', 'vganapa', 'lucas.ray.169', 'redwing', 'ahmed49', 'ramirez28', 'sullivaf', 'sboes95', 'jackie0212', 'glhinkle', 'matthew.l.binkley', 'pspagnolo72', 'ajana', 'woodsh', 'ross_piedmonte', 'gu97', 'dacapo007', 'lopez86', 'dtisdale', 'kim383', 'sawa', 'posta', 'mcapestr', 'zhu431', 'tictonk', 'jcassady30', 'robin198', 'adithyabhattachar', 'aianlo', 'ljc99', 'xphuah', 'gflesner', 'astronut95', 'cohen.jakedavid', 'tbruttom', 'lim154', 'parsonsm', 'kaiser17', 'leavittm0', 'peachrings', 'dhurley', 'haller1', 'richa201', None, 'jtrouba', 'fiferj', 'thoma386', 'pnorman', 'tcurtiss']"
36,75,18,54,16,"['dacapo007', 'sboes95', 'sullivaf', 'haojiex', 'mmckinne', 'thoma386', 'pspagnolo72', 'mcapestr', 'zhu431', 'pnorman', 'jinghan1022', 'lim154', 'lucas.ray.169', 'aianlo', 'tlshelhart', 'ncain3']",1,['dhurley'],38,"['nspear17', 'kim383', 'clandon01', 'sawa', 'posta', 'pangb1', 'azzedinr', 'robin198', 'telliott', 'adithyabhattachar', 'xphuah', 'jfschrad', 'tcurtiss', 'gflesner', 'astronut95', 'cohen.jakedavid', 'tbruttom', 'theresa.saenz.1', 'parsonsm', 'kaiser17', 'hallowj', 'smithjared1994', 'hoikim91', 'peachrings', 'mjankowicz', 'richa201', 'vganapa', None, 'ahmed49', 'ramirez28', 'davgumo', 'jtrouba', 'nanohueb', 'fiferj', 'woodsh', 'alaimana', 'ross_piedmonte', 'spschriver1']",55,"['alaimana', 'nspear17', 'clandon01', 'pangb1', 'azzedinr', 'telliott', 'ncain3', 'jfschrad', 'theresa.saenz.1', 'tlshelhart', 'hallowj', 'smithjared1994', 'hoikim91', 'haojiex', 'mmckinne', 'jinghan1022', 'vganapa', 'lucas.ray.169', 'ahmed49', 'ramirez28', 'davgumo', 'sullivaf', 'sboes95', 'pspagnolo72', 'woodsh', 'ross_piedmonte', 'dacapo007', 'kim383', 'sawa', 'posta', 'mcapestr', 'zhu431', 'robin198', 'adithyabhattachar', 'aianlo', 'xphuah', 'tcurtiss', 'gflesner', 'astronut95', 'cohen.jakedavid', 'tbruttom', 'lim154', 'parsonsm', 'kaiser17', 'peachrings', 'dhurley', 'mjankowicz', 'richa201', None, 'jtrouba', 'nanohueb', 'fiferj', 'thoma386', 'pnorman', 'spschriver1']"
36,69,18,43,12,"['dacapo007', 'sullivaf', 'haojiex', 'pspagnolo72', 'thoma386', 'zhu431', 'pnorman', 'jinghan1022', 'lim154', 'lucas.ray.169', 'tlshelhart', 'ncain3']",5,"['sboes95', 'dhurley', 'mmckinne', 'mcapestr', 'aianlo']",31,"['kim383', 'posta', 'tictonk', 'pangb1', 'paulleonc', 'azzedinr', 'telliott', 'robin198', 'horner4', 'jfschrad', 'alexj9', 'gflesner', 'astronut95', 'cohen.jakedavid', 'tbruttom', 'theresa.saenz.1', 'czy121301', 'parsonsm', 'hallowj', 'kaiser17', 'smithjared1994', 'li1470', 'ramire28', 'vganapa', None, 'ahmed49', 'jtrouba', 'woodsh', 'ross_piedmonte', 'glinvill', 'tcurtiss']",48,"['dacapo007', 'kim383', 'posta', 'mcapestr', 'zhu431', 'tictonk', 'pangb1', 'paulleonc', 'azzedinr', 'robin198', 'telliott', 'ncain3', 'aianlo', 'horner4', 'jfschrad', 'alexj9', 'gflesner', 'astronut95', 'cohen.jakedavid', 'tbruttom', 'theresa.saenz.1', 'lim154', 'czy121301', 'tlshelhart', 'parsonsm', 'hallowj', 'kaiser17', 'smithjared1994', 'haojiex', 'li1470', 'dhurley', 'mmckinne', 'ramire28', 'jinghan1022', 'vganapa', 'lucas.ray.169', None, 'ahmed49', 'sullivaf', 'sboes95', 'jtrouba', 'thoma386', 'pspagnolo72', 'woodsh', 'pnorman', 'ross_piedmonte', 'glinvill', 'tcurtiss']"
36,74,18,42,12,"['haojiex', 'mmckinne', 'pspagnolo72', 'thoma386', 'zhu431', 'pnorman', 'jinghan1022', 'lim154', 'lucas.ray.169', 'aianlo', 'tlshelhart', 'ncain3']",5,"['dacapo007', 'sboes95', 'sullivaf', 'dhurley', 'mcapestr']",30,"['lopez86', 'nspear17', 'kim383', 'sawa', 'posta', 'paulleonc', 'azzedinr', 'telliott', 'adithyabhattachar', 'horner4', 'jfschrad', 'gflesner', 'astronut95', 'cohen.jakedavid', 'tbruttom', 'theresa.saenz.1', 'czy121301', 'parsonsm', 'hallowj', 'smithjared1994', 'hoikim91', 'vganapa', None, 'ahmed49', 'ramirez28', 'jtrouba', 'woodsh', 'alaimana', 'ross_piedmonte', 'tcurtiss']",47,"['dacapo007', 'lopez86', 'alaimana', 'nspear17', 'kim383', 'sawa', 'posta', 'mcapestr', 'zhu431', 'paulleonc', 'azzedinr', 'telliott', 'ncain3', 'aianlo', 'adithyabhattachar', 'horner4', 'jfschrad', 'gflesner', 'astronut95', 'cohen.jakedavid', 'tbruttom', 'theresa.saenz.1', 'lim154', 'czy121301', 'tlshelhart', 'parsonsm', 'hallowj', 'smithjared1994', 'hoikim91', 'haojiex', 'dhurley', 'mmckinne', 'jinghan1022', 'vganapa', 'lucas.ray.169', None, 'ahmed49', 'ramirez28', 'sullivaf', 'sboes95', 'jtrouba', 'thoma386', 'pspagnolo72', 'woodsh', 'pnorman', 'ross_piedmonte', 'tcurtiss']"
36,267,18,39,6,"['sboes95', 'sullivaf', 'mmckinne', 'pspagnolo72', 'zhu431', 'lucas.ray.169']",11,"['dacapo007', 'haojiex', 'dhurley', 'thoma386', 'mcapestr', 'pnorman', 'jinghan1022', 'lim154', 'ncain3', 'aianlo', 'tlshelhart']",33,"['lopez86', 'nspear17', 'dtisdale', 'sawa', 'posta', 'fernandd63', 'azzedinr', 'robin198', 'adithyabhattachar', 'horner4', 'ljc99', 'xphuah', 'gflesner', 'cohen.jakedavid', 'tbruttom', 'theresa.saenz.1', 'czy121301', 'parsonsm', 'hallowj', 'kaiser17', 'smithjared1994', 'haller1', 'redwing', None, 'ahmed49', 'jtrouba', 'jackie0212', 'matthew.l.binkley', 'fiferj', 'woodsh', 'alaimana', 'ross_piedmonte', 'tcurtiss']",50,"['dacapo007', 'lopez86', 'alaimana', 'nspear17', 'dtisdale', 'sawa', 'posta', 'mcapestr', 'zhu431', 'fernandd63', 'azzedinr', 'robin198', 'ncain3', 'aianlo', 'adithyabhattachar', 'horner4', 'ljc99', 'xphuah', 'gflesner', 'cohen.jakedavid', 'tbruttom', 'theresa.saenz.1', 'lim154', 'czy121301', 'tlshelhart', 'parsonsm', 'hallowj', 'kaiser17', 'smithjared1994', 'haojiex', 'dhurley', 'mmckinne', 'haller1', 'jinghan1022', 'lucas.ray.169', 'redwing', None, 'ahmed49', 'sullivaf', 'sboes95', 'jtrouba', 'jackie0212', 'matthew.l.binkley', 'fiferj', 'thoma386', 'pspagnolo72', 'woodsh', 'pnorman', 'ross_piedmonte', 'tcurtiss']"
36,264,18,12,1,['jinghan1022'],16,"['dacapo007', 'sboes95', 'sullivaf', 'haojiex', 'dhurley', 'mmckinne', 'thoma386', 'pspagnolo72', 'mcapestr', 'zhu431', 'pnorman', 'lim154', 'lucas.ray.169', 'aianlo', 'tlshelhart', 'ncain3']",11,"['smithjared1994', 'leavittm0', 'li1470', 'cvieira', 'matthew.l.binkley', 'woodsh', 'azzedinr', 'pangb1', 'vganapa', 'alaimana', None]",28,"['smithjared1994', 'dacapo007', 'leavittm0', 'alaimana', 'haojiex', 'li1470', 'dhurley', 'mmckinne', 'mcapestr', 'zhu431', 'pnorman', 'azzedinr', 'pangb1', 'jinghan1022', 'vganapa', 'lucas.ray.169', 'aianlo', 'ncain3', None, 'tlshelhart', 'sullivaf', 'sboes95', 'cvieira', 'matthew.l.binkley', 'thoma386', 'pspagnolo72', 'woodsh', 'lim154']"
36,97,18,6,2,"['haojiex', 'pspagnolo72']",15,"['dacapo007', 'sboes95', 'sullivaf', 'dhurley', 'mmckinne', 'thoma386', 'mcapestr', 'zhu431', 'pnorman', 'jinghan1022', 'lim154', 'lucas.ray.169', 'aianlo', 'tlshelhart', 'ncain3']",4,"['tictonk', 'jfschrad', None, 'mkatamba']",21,"['dacapo007', 'haojiex', 'dhurley', 'mmckinne', 'mcapestr', 'zhu431', 'pnorman', 'tictonk', 'jinghan1022', 'mkatamba', 'lucas.ray.169', 'aianlo', 'ncain3', None, 'tlshelhart', 'jfschrad', 'sullivaf', 'sboes95', 'thoma386', 'pspagnolo72', 'lim154']"
37,148,17,26,15,"['leichen312', 'simona5', 'colm.grant93', 'methusela', 'pstrhbn', 'rickak', 'lees23', 'choicexu', 'clinton.halloran', 'hoffmeister113', 'alex.levenstein.92', 'hodsod', 'swartr', 'aaldee', 'barras2']",1,['ssjadeguardian'],11,"['sarelistraub', 'mangiv2', 'lphuang', 'sonoftheson', 'willisis2', 'siddharth.s410', 'marshm3', 'brayfc', 'ladyace88', None, 'cretea.pikes']",27,"['colm.grant93', 'rickak', 'marshm3', 'leichen312', 'simona5', 'sarelistraub', 'pstrhbn', 'methusela', 'choicexu', 'sonoftheson', 'clinton.halloran', 'willisis2', 'cretea.pikes', 'barras2', 'lees23', 'hoffmeister113', 'ssjadeguardian', 'swartr', None, 'mangiv2', 'lphuang', 'siddharth.s410', 'alex.levenstein.92', 'brayfc', 'ladyace88', 'hodsod', 'aaldee']"
37,259,17,26,15,"['leichen312', 'simona5', 'colm.grant93', 'methusela', 'pstrhbn', 'choicexu', 'lees23', 'clinton.halloran', 'hoffmeister113', 'alex.levenstein.92', 'hodsod', 'ssjadeguardian', 'swartr', 'aaldee', 'barras2']",1,['rickak'],11,"['sarelistraub', 'mangiv2', 'lphuang', 'sonoftheson', 'willisis2', 'siddharth.s410', 'marshm3', 'brayfc', 'ladyace88', None, 'cretea.pikes']",27,"['colm.grant93', 'rickak', 'marshm3', 'leichen312', 'simona5', 'sarelistraub', 'pstrhbn', 'methusela', 'choicexu', 'sonoftheson', 'clinton.halloran', 'willisis2', 'cretea.pikes', 'barras2', 'lees23', 'hoffmeister113', 'ssjadeguardian', 'swartr', None, 'mangiv2', 'lphuang', 'siddharth.s410', 'alex.levenstein.92', 'brayfc', 'ladyace88', 'hodsod', 'aaldee']"
37,271,17,26,16,"['leichen312', 'simona5', 'colm.grant93', 'methusela', 'pstrhbn', 'rickak', 'lees23', 'choicexu', 'clinton.halloran', 'hoffmeister113', 'alex.levenstein.92', 'hodsod', 'ssjadeguardian', 'swartr', 'aaldee', 'barras2']",0,[],10,"['sarelistraub', 'mangiv2', 'lphuang', 'sonoftheson', 'siddharth.s410', 'marshm3', 'brayfc', 'ladyace88', None, 'cretea.pikes']",26,"['colm.grant93', 'rickak', 'marshm3', 'leichen312', 'simona5', 'sarelistraub', 'pstrhbn', 'methusela', 'choicexu', 'sonoftheson', 'clinton.halloran', 'cretea.pikes', 'barras2', 'lees23', 'hoffmeister113', 'ssjadeguardian', 'swartr', None, 'mangiv2', 'lphuang', 'siddharth.s410', 'alex.levenstein.92', 'brayfc', 'ladyace88', 'hodsod', 'aaldee']"
37,149,17,20,11,"['leichen312', 'simona5', 'methusela', 'pstrhbn', 'choicexu', 'lees23', 'clinton.halloran', 'alex.levenstein.92', 'ssjadeguardian', 'aaldee', 'barras2']",5,"['colm.grant93', 'rickak', 'hoffmeister113', 'hodsod', 'swartr']",9,"['mangiv2', 'lphuang', 'sonoftheson', 'siddharth.s410', 'marshm3', 'brayfc', 'ladyace88', None, 'cretea.pikes']",25,"['colm.grant93', 'rickak', 'lees23', 'marshm3', 'hoffmeister113', 'ssjadeguardian', 'swartr', None, 'leichen312', 'simona5', 'pstrhbn', 'methusela', 'choicexu', 'sonoftheson', 'clinton.halloran', 'mangiv2', 'alex.levenstein.92', 'lphuang', 'siddharth.s410', 'brayfc', 'ladyace88', 'hodsod', 'cretea.pikes', 'aaldee', 'barras2']"
37,260,17,17,9,"['leichen312', 'simona5', 'colm.grant93', 'choicexu', 'lees23', 'hodsod', 'swartr', 'aaldee', 'barras2']",7,"['methusela', 'pstrhbn', 'rickak', 'clinton.halloran', 'hoffmeister113', 'alex.levenstein.92', 'ssjadeguardian']",8,"['mangiv2', 'lphuang', 'siddharth.s410', 'sonoftheson', 'marshm3', 'ladyace88', None, 'cretea.pikes']",24,"['colm.grant93', 'rickak', 'lees23', 'marshm3', 'hoffmeister113', 'ssjadeguardian', 'swartr', None, 'leichen312', 'simona5', 'pstrhbn', 'methusela', 'choicexu', 'mangiv2', 'clinton.halloran', 'siddharth.s410', 'alex.levenstein.92', 'sonoftheson', 'lphuang', 'ladyace88', 'hodsod', 'cretea.pikes', 'aaldee', 'barras2']"
37,151,17,10,7,"['colm.grant93', 'pstrhbn', 'methusela', 'rickak', 'alex.levenstein.92', 'hoffmeister113', 'swartr']",9,"['leichen312', 'simona5', 'choicexu', 'lees23', 'clinton.halloran', 'hodsod', 'ssjadeguardian', 'aaldee', 'barras2']",3,"['willisis2', None, 'cretea.pikes']",19,"['colm.grant93', 'rickak', 'lees23', 'hoffmeister113', 'ssjadeguardian', 'swartr', None, 'leichen312', 'simona5', 'pstrhbn', 'methusela', 'choicexu', 'willisis2', 'clinton.halloran', 'alex.levenstein.92', 'hodsod', 'cretea.pikes', 'aaldee', 'barras2']"
37,261,17,8,6,"['colm.grant93', 'pstrhbn', 'methusela', 'rickak', 'alex.levenstein.92', 'hoffmeister113']",10,"['leichen312', 'simona5', 'choicexu', 'lees23', 'clinton.halloran', 'hodsod', 'ssjadeguardian', 'swartr', 'aaldee', 'barras2']",2,"[None, 'sarelistraub']",18,"['colm.grant93', 'rickak', 'lees23', 'hoffmeister113', 'ssjadeguardian', 'swartr', None, 'leichen312', 'simona5', 'sarelistraub', 'pstrhbn', 'methusela', 'choicexu', 'clinton.halloran', 'alex.levenstein.92', 'hodsod', 'aaldee', 'barras2']"
38,19,16,28,15,"['dreameryss', 'woo0069', 'dico7717', 'jjk00122', 'rohsh67', 'jaypark5769', 'ys5449', 'guheak92', 'jwh0114', 'rtow1', 'hwh7980', 'ehdrms3204', 'cjrlfrlf', 'skky9977', 'hodori90']",0,[],13,"['hihibyebye', 'qwer29', 'mjis14', 'jyarika', 'primeevir', 'jungmin.lee.14268', 'fasterthan88', 'qwdf29', 'dreameryss777', 'gog40', 'poby', None, 'alenldkr']",28,"['dreameryss', 'ys5449', 'jungmin.lee.14268', 'hwh7980', 'poby', 'jaypark5769', 'hihibyebye', 'woo0069', 'alenldkr', 'fasterthan88', 'jwh0114', 'cjrlfrlf', 'dreameryss777', 'ehdrms3204', 'skky9977', 'mjis14', 'primeevir', 'qwdf29', 'rtow1', 'gog40', 'dico7717', None, 'qwer29', 'jyarika', 'jjk00122', 'rohsh67', 'guheak92', 'hodori90']"
38,23,16,23,15,"['dreameryss', 'woo0069', 'dico7717', 'jjk00122', 'rohsh67', 'jaypark5769', 'ys5449', 'guheak92', 'jwh0114', 'rtow1', 'hwh7980', 'ehdrms3204', 'cjrlfrlf', 'skky9977', 'hodori90']",0,[],8,"['hihibyebye', 'jyarika', 'primeevir', 'shirinkami', 'qwdf29', 'gog40', 'wintergoon', None]",23,"['dreameryss', 'ys5449', 'shirinkami', 'hwh7980', 'jaypark5769', 'hihibyebye', 'woo0069', 'jwh0114', 'cjrlfrlf', 'ehdrms3204', 'skky9977', 'primeevir', 'qwdf29', 'rtow1', 'gog40', 'dico7717', None, 'jyarika', 'jjk00122', 'rohsh67', 'guheak92', 'wintergoon', 'hodori90']"
38,20,16,19,15,"['dreameryss', 'woo0069', 'dico7717', 'jjk00122', 'rohsh67', 'jaypark5769', 'ys5449', 'guheak92', 'jwh0114', 'rtow1', 'hwh7980', 'ehdrms3204', 'cjrlfrlf', 'skky9977', 'hodori90']",0,[],4,"['primeevir', None, 'qwdf29', 'gog40']",19,"['dreameryss', 'ys5449', 'hwh7980', 'jaypark5769', 'woo0069', 'jwh0114', 'cjrlfrlf', 'ehdrms3204', 'skky9977', 'primeevir', 'qwdf29', 'rtow1', 'gog40', 'dico7717', None, 'jjk00122', 'rohsh67', 'guheak92', 'hodori90']"
38,21,16,19,15,"['dreameryss', 'woo0069', 'dico7717', 'jjk00122', 'rohsh67', 'jaypark5769', 'ys5449', 'guheak92', 'jwh0114', 'rtow1', 'hwh7980', 'ehdrms3204', 'cjrlfrlf', 'skky9977', 'hodori90']",0,[],4,"['jyarika', None, 'qwdf29', 'gog40']",19,"['dreameryss', 'ys5449', 'hwh7980', 'jaypark5769', 'woo0069', 'jwh0114', 'cjrlfrlf', 'ehdrms3204', 'skky9977', 'qwdf29', 'rtow1', 'gog40', 'dico7717', None, 'jyarika', 'jjk00122', 'rohsh67', 'guheak92', 'hodori90']"
38,22,16,19,15,"['dreameryss', 'woo0069', 'dico7717', 'jjk00122', 'rohsh67', 'jaypark5769', 'ys5449', 'guheak92', 'jwh0114', 'rtow1', 'hwh7980', 'ehdrms3204', 'cjrlfrlf', 'skky9977', 'hodori90']",0,[],4,"['jyarika', None, 'qwdf29', 'gog40']",19,"['dreameryss', 'ys5449', 'hwh7980', 'jaypark5769', 'woo0069', 'jwh0114', 'cjrlfrlf', 'ehdrms3204', 'skky9977', 'qwdf29', 'rtow1', 'gog40', 'dico7717', None, 'jyarika', 'jjk00122', 'rohsh67', 'guheak92', 'hodori90']"
39,118,16,12,8,"['enmin.shih', 'js4691', 'alexxucui1988', 'jl3920', 'chunyu.li.330', 'ronanrice', 'stan.tseng.3', 'ktien']",7,"['akshatakki', 'zigorrom', 'pawar.avinash0007', 'chengtan', 'shipra.sharma.161', 'eng.samehfares', 'vlsifablab']",4,"['pc2671', 'btran2', None, 'sj2659']",19,"['akshatakki', 'js4691', 'enmin.shih', 'pawar.avinash0007', 'btran2', 'stan.tseng.3', None, 'ktien', 'vlsifablab', 'alexxucui1988', 'zigorrom', 'sj2659', 'jl3920', 'chengtan', 'pc2671', 'chunyu.li.330', 'ronanrice', 'shipra.sharma.161', 'eng.samehfares']"
39,115,16,10,1,['eng.samehfares'],14,"['akshatakki', 'js4691', 'enmin.shih', 'alexxucui1988', 'pawar.avinash0007', 'zigorrom', 'stan.tseng.3', 'jl3920', 'chengtan', 'chunyu.li.330', 'ronanrice', 'shipra.sharma.161', 'ktien', 'vlsifablab']",9,"['eng.raghda2011', 'amnsawaby', 'abdelrahmansf', 'krepton', 'karim.mohsen.1984', 'amr1992ahmed', 'abdelrahman.heikal', None, 'eng.mustafa.k']",24,"['akshatakki', 'js4691', 'enmin.shih', 'eng.mustafa.k', 'pawar.avinash0007', 'krepton', 'karim.mohsen.1984', 'amr1992ahmed', 'stan.tseng.3', None, 'ktien', 'vlsifablab', 'alexxucui1988', 'zigorrom', 'eng.raghda2011', 'amnsawaby', 'jl3920', 'abdelrahmansf', 'chengtan', 'chunyu.li.330', 'ronanrice', 'shipra.sharma.161', 'abdelrahman.heikal', 'eng.samehfares']"
39,116,16,10,3,"['shipra.sharma.161', 'akshatakki', 'vlsifablab']",12,"['enmin.shih', 'js4691', 'alexxucui1988', 'zigorrom', 'pawar.avinash0007', 'jl3920', 'chengtan', 'chunyu.li.330', 'ronanrice', 'stan.tseng.3', 'ktien', 'eng.samehfares']",7,"['sharma9shikha', 'priyanka.sarika1992', 'nitten', 'sonamjn98', 'pragatiagarwal', 'himanshugautam1908', None]",22,"['akshatakki', 'js4691', 'enmin.shih', 'sharma9shikha', 'pawar.avinash0007', 'nitten', 'pragatiagarwal', 'stan.tseng.3', 'himanshugautam1908', None, 'ktien', 'vlsifablab', 'alexxucui1988', 'zigorrom', 'jl3920', 'priyanka.sarika1992', 'chengtan', 'chunyu.li.330', 'ronanrice', 'sonamjn98', 'shipra.sharma.161', 'eng.samehfares']"
39,114,16,7,2,"['akshatakki', 'vlsifablab']",13,"['enmin.shih', 'js4691', 'alexxucui1988', 'zigorrom', 'pawar.avinash0007', 'stan.tseng.3', 'jl3920', 'chengtan', 'chunyu.li.330', 'ronanrice', 'shipra.sharma.161', 'ktien', 'eng.samehfares']",5,"['nitten', 'ashima02', 'shikha14vlp10', 'pragatiagarwal', None]",20,"['akshatakki', 'js4691', 'enmin.shih', 'pawar.avinash0007', 'nitten', 'ashima02', 'shikha14vlp10', 'pragatiagarwal', 'stan.tseng.3', None, 'ktien', 'vlsifablab', 'alexxucui1988', 'zigorrom', 'jl3920', 'chengtan', 'chunyu.li.330', 'ronanrice', 'shipra.sharma.161', 'eng.samehfares']"
39,117,16,7,3,"['shipra.sharma.161', 'akshatakki', 'vlsifablab']",12,"['enmin.shih', 'js4691', 'alexxucui1988', 'zigorrom', 'pawar.avinash0007', 'jl3920', 'chengtan', 'chunyu.li.330', 'ronanrice', 'stan.tseng.3', 'ktien', 'eng.samehfares']",4,"['himanshugautam1908', 'sharma9shikha', None, 'nitten']",19,"['akshatakki', 'js4691', 'enmin.shih', 'sharma9shikha', 'pawar.avinash0007', 'nitten', 'stan.tseng.3', 'himanshugautam1908', None, 'ktien', 'vlsifablab', 'alexxucui1988', 'zigorrom', 'jl3920', 'chengtan', 'chunyu.li.330', 'ronanrice', 'shipra.sharma.161', 'eng.samehfares']"
40,61,15,16,14,"['feiyang', 'wingsctt', 'winsgao', 'cxj6672016', 'shulan2010', 'lguan1992', 'yjw_piapia', 'ledliang110', 'liurunjia', 'gardenia1108670103', 'queenslandy', 'huangyujie', 'leesy', 'zxm_seu']",0,[],2,"['zk1991', None]",16,"['feiyang', 'wingsctt', 'winsgao', 'shulan2010', 'cxj6672016', 'queenslandy', 'huangyujie', 'leesy', 'zxm_seu', None, 'lguan1992', 'yjw_piapia', 'ledliang110', 'liurunjia', 'gardenia1108670103', 'zk1991']"
41,50,15,86,3,"['mahrukhasghar', 'arqamkhan', 'iframoid']",11,"['sjg8157', 'pokepc31', 'mjsteer', 'kdhemc', 'mpetric', 'conradn', 'edf4550', 'jbputhoff', 'kurova.nv', 'nicolo.sernicola', 'rngpsster']",83,"['1993daniyal', 'saadmohsinsiddiqui', 'saqib.dastagir', 'hiraimtiaz', 'tayyabsiddiqui19', 'zainzia', 'nabeelahmed956', 'jazibabidi', 's102', 'ramal.jafri', 'aq.mahmoodqadri', 'arooj.fayyaz.9', 'mzp482', 'farheenjahan66', 'umair.mallick93', 'el83el85', 'el43', 'sabamalik000111', 'sameer.ansari786', 'shanno447', 'mammadsiddiqui15', 'mdaniyalmansoor', 'yusra_ammara', 'arwakhuzema93', 'saadhussainconquer', 'nedian.tahir', 'khudaijasaleem', 'el301el302', 'ruk_tuk', 'abdulbasitdhedhi', 'faizamoazzam8', 'maheenjd', 'nabeel.ahmed.79219', 'atiyab', 'mariamchoudry', 'nageenkhatri', 'mehshar', 'juniman29', 'urooj.fatima.3745', 'fizza.shamim', 'nedianbilal', 'el93_el96', 'humi1245', 'usmansiddiqui316', 'faizansalehshaikh', 'anm_92', 'muhammad.usama.shakil', 'tab1', 'hmf1492', 'daneylpasha', 'tubafaizan', 'zohaib.khan.16752754', 'sidra2020', 'mahrukh.asghar2120', 'wasif.engineer', 'hajra16', 'aliirfan13', 'khwaja.nabeel', 'sumbul', 'esaleem71', 'faizan_bajwa13', 'samreenasmara', 'basrahafeez2000', 'sanam_sarwar', 'sidra30', 'alishahvadsaria', 'alifyah1', None, 'najmafaiza', 'talha.aly', 'm1', '1ooie', 'malihaashraf05', 'sanafaiza', 'x_man', 'erumnida', 'hiraamjad028', 'malinawaz345', 'sameer786', 'mohsin.nusrat', 'risik', 'ali.mubashir2993', 'jalal.shahab.brothers']",97,"['1993daniyal', 'saadmohsinsiddiqui', 'mjsteer', 'saqib.dastagir', 'hiraimtiaz', 'tayyabsiddiqui19', 'zainzia', 'nabeelahmed956', 'jazibabidi', 's102', 'ramal.jafri', 'aq.mahmoodqadri', 'arooj.fayyaz.9', 'mahrukhasghar', 'kdhemc', 'mzp482', 'farheenjahan66', 'arqamkhan', 'umair.mallick93', 'mpetric', 'el83el85', 'el43', 'sabamalik000111', 'sjg8157', 'sameer.ansari786', 'shanno447', 'mammadsiddiqui15', 'mdaniyalmansoor', 'yusra_ammara', 'arwakhuzema93', 'jbputhoff', 'saadhussainconquer', 'nedian.tahir', 'khudaijasaleem', 'el301el302', 'ruk_tuk', 'abdulbasitdhedhi', 'faizamoazzam8', 'maheenjd', 'nabeel.ahmed.79219', 'atiyab', 'mariamchoudry', 'nageenkhatri', 'mehshar', 'juniman29', 'edf4550', 'urooj.fatima.3745', 'fizza.shamim', 'nedianbilal', 'el93_el96', 'humi1245', 'usmansiddiqui316', 'faizansalehshaikh', 'anm_92', 'muhammad.usama.shakil', 'tab1', 'hmf1492', 'daneylpasha', 'tubafaizan', 'zohaib.khan.16752754', 'sidra2020', 'mahrukh.asghar2120', 'wasif.engineer', 'hajra16', 'kurova.nv', 'rngpsster', 'aliirfan13', 'pokepc31', 'khwaja.nabeel', 'jalal.shahab.brothers', 'sumbul', 'esaleem71', 'faizan_bajwa13', 'samreenasmara', 'basrahafeez2000', 'sanam_sarwar', 'sidra30', 'iframoid', 'alishahvadsaria', 'alifyah1', None, 'najmafaiza', 'talha.aly', 'm1', '1ooie', 'malihaashraf05', 'sanafaiza', 'x_man', 'erumnida', 'hiraamjad028', 'malinawaz345', 'sameer786', 'conradn', 'mohsin.nusrat', 'risik', 'ali.mubashir2993', 'nicolo.sernicola']"
42,3,15,27,12,"['lucy.bernarodriguez', 'josesusatama', 'edwinf.sarriar', 'juan93andres', 'prmjuan', 'monicavelasquez140', 'marialesalamanca94', 'stefy.barrero', 'sebastianam', 'gisselle.ramos.21', 'karenr.torresm', 'angiek.foreroe']",2,"['vikram.bakaraju', 'mnipavan']",15,"['maleja95', 'waltercruz', 'dianamg', 'lufecobe', 'mariap.diazc', 'leon241254', 'javierchurtadov', None, 'mariae.rueda.718', 'jeissonj.loaizam', 'larrottanatalia', 'carlosalejo979', 'sebas1501', 'patriciae.navarrop', 'darwindubay']",29,"['lufecobe', 'mariap.diazc', 'juan93andres', 'javierchurtadov', 'mariae.rueda.718', 'darwindubay', 'lucy.bernarodriguez', 'waltercruz', 'sebastianam', 'patriciae.navarrop', 'maleja95', 'dianamg', 'vikram.bakaraju', 'edwinf.sarriar', 'prmjuan', 'jeissonj.loaizam', 'stefy.barrero', 'gisselle.ramos.21', 'sebas1501', None, 'angiek.foreroe', 'josesusatama', 'leon241254', 'mnipavan', 'monicavelasquez140', 'marialesalamanca94', 'carlosalejo979', 'karenr.torresm', 'larrottanatalia']"
43,17,14,22,12,"['harshadsurdi', 'jianyi.gao.1', 'pfirth', 'gxinchen', 'yinglei8888', 'sapman', 'maitreyadutta', 'pkoswatt', 'salman.manzoor', 'timmerix', 'zjufennizhang', 'saba.rajabi']",1,['kettlecat'],10,"['zjduleo', 'a023087', 'ionman1968', 'a80718113a', 'wangld11', 'fywudi', 'catterrell', None, 'treblitz', 'sulemansami']",23,"['yinglei8888', 'sapman', 'wangld11', 'salman.manzoor', 'zjufennizhang', 'zjduleo', 'pfirth', 'gxinchen', 'a80718113a', 'pkoswatt', 'timmerix', 'harshadsurdi', 'a023087', 'jianyi.gao.1', None, 'treblitz', 'sulemansami', 'ionman1968', 'fywudi', 'maitreyadutta', 'catterrell', 'kettlecat', 'saba.rajabi']"
43,159,14,21,12,"['harshadsurdi', 'jianyi.gao.1', 'pfirth', 'gxinchen', 'yinglei8888', 'sapman', 'maitreyadutta', 'pkoswatt', 'salman.manzoor', 'timmerix', 'zjufennizhang', 'saba.rajabi']",1,['kettlecat'],9,"['a023087', 'ionman1968', 'rfang4', 'a80718113a', 'wangld11', 'fywudi', None, 'treblitz', 'sulemansami']",22,"['yinglei8888', 'sapman', 'wangld11', 'salman.manzoor', 'zjufennizhang', 'pfirth', 'gxinchen', 'rfang4', 'a80718113a', 'pkoswatt', 'timmerix', 'harshadsurdi', 'a023087', 'jianyi.gao.1', None, 'treblitz', 'sulemansami', 'ionman1968', 'fywudi', 'maitreyadutta', 'kettlecat', 'saba.rajabi']"
43,217,14,20,12,"['harshadsurdi', 'jianyi.gao.1', 'pfirth', 'gxinchen', 'yinglei8888', 'sapman', 'maitreyadutta', 'pkoswatt', 'salman.manzoor', 'timmerix', 'zjufennizhang', 'saba.rajabi']",1,['kettlecat'],8,"['ionman1968', 'rfang4', 'a80718113a', 'wangld11', 'fywudi', None, 'treblitz', 'sulemansami']",21,"['yinglei8888', 'sapman', 'wangld11', 'salman.manzoor', 'zjufennizhang', 'pfirth', 'gxinchen', 'rfang4', 'a80718113a', 'pkoswatt', 'timmerix', 'harshadsurdi', 'jianyi.gao.1', None, 'treblitz', 'sulemansami', 'ionman1968', 'fywudi', 'maitreyadutta', 'kettlecat', 'saba.rajabi']"
44,78,13,14,12,"['abenadia', 'garrettmonroe98', 'sammyyo1998', 'ork3red', 'priyank247', 'memeiselandi', 'admostkimo', 'tristanwu686', 'souto.alan', 'mrquell', 'cseiler16', 'mykytheman1']",0,[],2,"[None, 'aanto7614']",14,"['souto.alan', 'memeiselandi', 'admostkimo', 'mrquell', 'cseiler16', None, 'abenadia', 'aanto7614', 'ork3red', 'sammyyo1998', 'garrettmonroe98', 'priyank247', 'tristanwu686', 'mykytheman1']"
45,231,13,21,12,"['harshini', 's3526390', 'neeragmodi', 's3522008', 's3498837', 'josegomezdavila14', 's3495790', 's3416825', 's3333177', 's3513955', 'rosscap', 's3525659']",0,[],9,"['s3499389', 's3383281', 'patrickrossiter', 's3525533', 's3330480', 's3495868', None, 's3472907', 's3285100']",21,"['harshini', 's3526390', 's3499389', 's3383281', 's3416825', 'rosscap', 's3522008', 'patrickrossiter', 'josegomezdavila14', 's3495790', 's3330480', 's3495868', 's3285100', 's3498837', 's3333177', 's3525533', None, 's3525659', 'neeragmodi', 's3513955', 's3472907']"
45,232,13,9,1,['s3526390'],11,"['harshini', 'neeragmodi', 's3522008', 's3498837', 'josegomezdavila14', 's3495790', 's3416825', 's3333177', 's3513955', 'rosscap', 's3525659']",8,"['s3499389', 's3383281', 'patrickrossiter', 's3330480', 's3525533', 's3495868', None, 's3285100']",20,"['harshini', 's3526390', 's3499389', 's3383281', 's3498837', 's3416825', 's3333177', 'rosscap', 's3525533', None, 's3525659', 'neeragmodi', 's3522008', 'patrickrossiter', 'josegomezdavila14', 's3495790', 's3330480', 's3495868', 's3513955', 's3285100']"
46,247,13,13,10,"['berardone3', 'marcomandurrino', 'arastoo4522', 'ihussain899', 'gbruno', 'beatrice.miccoli', 'giacomo.bruno', 'mianfarrukhmehmood', 'dconti', 'pietrozaccagnini']",2,"['amit.sehrawat94', 'ycm6161']",3,"['filo91', None, 'jgrossman']",15,"['berardone3', 'marcomandurrino', 'arastoo4522', 'amit.sehrawat94', 'gbruno', 'ycm6161', 'giacomo.bruno', 'beatrice.miccoli', 'dconti', None, 'filo91', 'ihussain899', 'mianfarrukhmehmood', 'pietrozaccagnini', 'jgrossman']"
46,248,13,8,7,"['berardone3', 'marcomandurrino', 'arastoo4522', 'ihussain899', 'beatrice.miccoli', 'giacomo.bruno', 'mianfarrukhmehmood']",5,"['amit.sehrawat94', 'gbruno', 'ycm6161', 'dconti', 'pietrozaccagnini']",1,[None],13,"['berardone3', 'marcomandurrino', 'arastoo4522', 'amit.sehrawat94', 'gbruno', 'ycm6161', 'giacomo.bruno', 'beatrice.miccoli', 'dconti', None, 'ihussain899', 'mianfarrukhmehmood', 'pietrozaccagnini']"
47,130,13,9,7,"['dani36', 'ib46712', 'vlatko2204', 'aykutkabaoglu', 'shegz', 'zeki5505', 'fantinokarius']",5,"['kibum84', 'maven0709', 'zfarkas', 'gazivodamarko', 'amitjkp23']",2,"[None, 'karlo.uchytil']",14,"['dani36', 'karlo.uchytil', 'kibum84', 'gazivodamarko', None, 'fantinokarius', 'ib46712', 'vlatko2204', 'aykutkabaoglu', 'shegz', 'maven0709', 'zfarkas', 'zeki5505', 'amitjkp23']"
48,47,12,10,9,"['jurajs84', 'miroslavh', 'xgalra00', 'kubanek1', 'xnovak0l', 'xgamar', 'pepa.bobek', 'mdosedla', 'dolezalmiroslav']",2,"['ag854863', 'pascal.ruffieux.33']",1,[None],12,"['ag854863', 'miroslavh', 'xgamar', 'mdosedla', 'dolezalmiroslav', None, 'jurajs84', 'xgalra00', 'xnovak0l', 'kubanek1', 'pepa.bobek', 'pascal.ruffieux.33']"
49,186,12,56,8,"['pnw64000', 'yyz5263', 'a_hallway', 'sumant.sai', 'fatinazizi94', 'guizetan', 'whf4psu', 'rakan115']",3,"['khubaibahmad', 'kelsen', 'khubaibahmed']",48,"['mingyuezhang93', 'yzz5174', 'xxm614', 'rav5132', 'rsweny33', 'jjf5345', 'neil.karmaker', 'jav5318', 'cmmiller67', 'ajc.constable', 'rvw5155', 'efrock2', 'ram5798', 'hxn5042', 'landcarp', 'sxa5283', 'tdh5096', 'zhouhn0413', 'sop5346', 'ppp5068', 'jmz5169', 'eiw5060', 'rws5608', 'mrahn', 'ryan.romesberg.98', 'yww5270', 'danshields1134', 'nas5467', 'wmi5002', 'controlad2', 'jmanbaseball', 'yvl5323', 'zelong', None, 'jof5213', 'pmb5191', 'jeff.kronz', 'zenger', 'yyx5048', 'jkopatz10', 'nqb5128', 'rfs5115', 'pvs5183', 'calebyoung26', 'manicho11', 'excaliburorz', 'jfj5017', 'black.paulj']",59,"['mingyuezhang93', 'yzz5174', 'xxm614', 'jjf5345', 'neil.karmaker', 'guizetan', 'cmmiller67', 'ajc.constable', 'efrock2', 'khubaibahmed', 'hxn5042', 'yyz5263', 'sxa5283', 'zhouhn0413', 'sop5346', 'ppp5068', 'kelsen', 'rws5608', 'ryan.romesberg.98', 'wmi5002', 'whf4psu', 'jeff.kronz', 'sumant.sai', 'yyx5048', 'danshields1134', 'pmb5191', 'jfj5017', 'pnw64000', 'rav5132', 'rsweny33', 'jav5318', 'rvw5155', 'ram5798', 'landcarp', 'tdh5096', 'fatinazizi94', 'jmz5169', 'eiw5060', 'mrahn', 'rakan115', 'yww5270', 'nas5467', 'controlad2', 'jmanbaseball', 'yvl5323', 'khubaibahmad', 'zelong', None, 'jof5213', 'a_hallway', 'zenger', 'nqb5128', 'jkopatz10', 'rfs5115', 'pvs5183', 'calebyoung26', 'manicho11', 'excaliburorz', 'black.paulj']"
50,30,12,8,7,"['swetha.yadas60', 'anusha9660', 'kumaram5509', 'bharathgogikar', 'mugdha.2608', 'gvganeshslo', 'vinodnano707']",4,"['davidroyo93', 'chintala.mahesh24', 'nareshbusa434', 'jagirdarvrrao']",1,[None],12,"['davidroyo93', 'anusha9660', 'kumaram5509', 'nareshbusa434', 'mugdha.2608', 'gvganeshslo', 'vinodnano707', None, 'jagirdarvrrao', 'swetha.yadas60', 'bharathgogikar', 'chintala.mahesh24']"
52,198,11,13,10,"['brakokofi', 'appfranklin', 'kingsford.asare.31', 'deekay01', 'eislebd', 'kwabenaasante66', 'henryniiotu', 'josephdaafuor', 'banang11', 'kanbogtah.dindomah']",0,[],3,"['mightystar', None, 'slimsavern']",13,"['brakokofi', 'appfranklin', 'kingsford.asare.31', 'banang11', 'kanbogtah.dindomah', 'henryniiotu', 'mightystar', None, 'deekay01', 'eislebd', 'kwabenaasante66', 'josephdaafuor', 'slimsavern']"
53,275,11,49,3,"['li1114', 'glassd', 'jiruotong']",7,"['e722m355', 'lin382', 'mullen6', 'jpalsdot', 'ywang90', 'jduritsc95', 'kearneyd']",46,"['dbenham', 'pmeunier', 'valencid', 'rafatulfaria', 'vdiep', 'schcats', 'woodswims', 'edantillon', 'prasadsarang', 'sdhaka', 'robin198', 'ukamran', 'light2', 'apps', 'swoop', 'mathur7', 'htabatab', 'sganguly', 'jy009', 'liuzixuan199508', 'cansenelda', 'nonofrio', 'lalzatev', 'clarksm', 'hctest4', 'bmsutton', 'polina.aleks', 'bhaley', 'bermel', 'chunyuli', 'zooley', 'dkearney', None, 'kaimiao', 'davgumo', 'clarksnano', 'markarios345', 'mmh', 'hctest3', 'fang85', 'kennell', 'nanohueb', 'njtsh', 'msakano', 'wangyide92', 'gah']",56,"['dbenham', 'pmeunier', 'valencid', 'jiruotong', 'rafatulfaria', 'vdiep', 'schcats', 'woodswims', 'edantillon', 'prasadsarang', 'sdhaka', 'jpalsdot', 'ywang90', 'robin198', 'ukamran', 'light2', 'apps', 'e722m355', 'lin382', 'mullen6', 'swoop', 'mathur7', 'htabatab', 'sganguly', 'jy009', 'liuzixuan199508', 'cansenelda', 'jduritsc95', 'nonofrio', 'lalzatev', 'clarksm', 'hctest4', 'bmsutton', 'polina.aleks', 'bhaley', 'bermel', 'chunyuli', 'zooley', 'dkearney', None, 'kearneyd', 'kaimiao', 'li1114', 'davgumo', 'clarksnano', 'markarios345', 'mmh', 'hctest3', 'fang85', 'kennell', 'nanohueb', 'njtsh', 'msakano', 'glassd', 'wangyide92', 'gah']"
54,231,11,21,8,"['s3499389', 's3383281', 'patrickrossiter', 's3330480', 's3525533', 's3495868', 's3472907', 's3285100']",2,"['s2007579', 'sathyanarayanan.chandrasekharan']",13,"['harshini', 's3526390', 'neeragmodi', 's3522008', 's3525659', 's3498837', 's3495790', 'josegomezdavila14', 's3416825', 'rosscap', 's3513955', None, 's3333177']",23,"['harshini', 's3526390', 's3499389', 's3383281', 's3498837', 's3416825', 's3525533', 'rosscap', 's3333177', None, 's3525659', 'neeragmodi', 's3522008', 's2007579', 'patrickrossiter', 's3495790', 'josegomezdavila14', 's3330480', 's3495868', 'sathyanarayanan.chandrasekharan', 's3513955', 's3472907', 's3285100']"
54,232,11,9,7,"['s3499389', 's3383281', 'patrickrossiter', 's3330480', 's3525533', 's3495868', 's3285100']",3,"['s3472907', 's2007579', 'sathyanarayanan.chandrasekharan']",2,"[None, 's3526390']",12,"['s3526390', 's3499389', 's3383281', 's3525533', None, 's2007579', 'patrickrossiter', 's3330480', 's3495868', 'sathyanarayanan.chandrasekharan', 's3472907', 's3285100']"
56,11,11,78,4,"['mikeandike5374', 'kahill2', 'jeremy.chew', 'ajgordon']",6,"['skoushik', 'fahdam', 'sarahswarthair', 'igorjosafa16', 'miladi', 'gccomunications']",74,"['spshah6', 'amango4', 'billli1996', 'achoi121', 'cory93', 'remlevin', 'kote.deepa', 'cullenglasgow', 'tjweber2', 'angelaxbaby93', 'sarahresarf', 'jjiang14', 'hmtaylo2', 'yyang10', 'lbward93', 'isaacehoffman2', 'hylin2', 'janeyoo34', 'dkwok2', 'julia.zuo', 'myeoh2', 'cledesma2331', 'masiyi9406', 'jmmille6', 'mrhennek', 'dlitt2', 'spmurra2', 'beng3', 'kfeng', 'carolgu2', 'lolipopcarolwang', 'xli121', 'earthy', 'palchec2', 'jake.kornacker', 'ruining2', 'xiasang2', 'mantianxue0101', 'wem5637', 'lfirpo', 'dman5505', 'yyang132', 'csbaile2', 'ryba.konrad', 'pbhatta2', 'bpgolfguy92', 'grober.dan', 'eprzyby2', 'ntxuby', 'melissagoetter', 'mkbaile2', 'tara.cullerton', 'allysonv10', 'gvelard2edu', 'jiechen94', 'wlarson2', 'dagapit2', 'kjcsport1', 'scpiper2', 'ntsherm2', 'jefrin', 'dwchris2', None, 'curtis.c.baker', 'meher.bharucha', 'klwells2', 'jtcohen2', 'sho1123', 'ahli2', 'me1291441', 'hank.liu.180', 'anna.mast2', 'werkkdy2', 'knipfer2']",84,"['spshah6', 'amango4', 'billli1996', 'achoi121', 'cory93', 'remlevin', 'kote.deepa', 'cullenglasgow', 'sarahswarthair', 'igorjosafa16', 'tjweber2', 'angelaxbaby93', 'sarahresarf', 'jjiang14', 'hmtaylo2', 'yyang10', 'lbward93', 'isaacehoffman2', 'hylin2', 'janeyoo34', 'dkwok2', 'kahill2', 'julia.zuo', 'mikeandike5374', 'myeoh2', 'cledesma2331', 'masiyi9406', 'jmmille6', 'mrhennek', 'dlitt2', 'spmurra2', 'beng3', 'kfeng', 'carolgu2', 'lolipopcarolwang', 'xli121', 'earthy', 'palchec2', 'jake.kornacker', 'ruining2', 'xiasang2', 'mantianxue0101', 'wem5637', 'lfirpo', 'dman5505', 'yyang132', 'csbaile2', 'ryba.konrad', 'pbhatta2', 'bpgolfguy92', 'grober.dan', 'eprzyby2', 'ntxuby', 'melissagoetter', 'mkbaile2', 'tara.cullerton', 'miladi', 'ajgordon', 'allysonv10', 'gvelard2edu', 'jiechen94', 'wlarson2', 'fahdam', 'skoushik', 'dagapit2', 'kjcsport1', 'scpiper2', 'gccomunications', 'jeremy.chew', 'ntsherm2', 'jefrin', 'dwchris2', None, 'curtis.c.baker', 'meher.bharucha', 'klwells2', 'jtcohen2', 'sho1123', 'ahli2', 'me1291441', 'hank.liu.180', 'anna.mast2', 'werkkdy2', 'knipfer2']"
58,3,10,27,9,"['dianamg', 'lufecobe', 'mariap.diazc', 'leon241254', 'javierchurtadov', 'mariae.rueda.718', 'sebas1501', 'maleja95', 'darwindubay']",0,[],18,"['lucy.bernarodriguez', 'josesusatama', 'waltercruz', 'edwinf.sarriar', 'juan93andres', 'prmjuan', 'jeissonj.loaizam', 'monicavelasquez140', 'larrottanatalia', 'sebastianam', 'stefy.barrero', 'carlosalejo979', 'gisselle.ramos.21', 'marialesalamanca94', None, 'patriciae.navarrop', 'karenr.torresm', 'angiek.foreroe']",27,"['lufecobe', 'mariap.diazc', 'juan93andres', 'javierchurtadov', 'mariae.rueda.718', 'darwindubay', 'lucy.bernarodriguez', 'waltercruz', 'sebastianam', 'patriciae.navarrop', 'maleja95', 'dianamg', 'edwinf.sarriar', 'prmjuan', 'jeissonj.loaizam', 'stefy.barrero', 'gisselle.ramos.21', 'sebas1501', None, 'angiek.foreroe', 'josesusatama', 'leon241254', 'monicavelasquez140', 'carlosalejo979', 'marialesalamanca94', 'karenr.torresm', 'larrottanatalia']"
58,51,10,9,5,"['leon241254', 'javierchurtadov', 'mariae.rueda.718', 'sebas1501', 'darwindubay']",4,"['lufecobe', 'mariap.diazc', 'maleja95', 'dianamg']",4,"['lorenaclc95', None, 'patriciae.navarrop', 'juans']",13,"['dianamg', 'lufecobe', 'mariap.diazc', 'leon241254', 'javierchurtadov', None, 'juans', 'mariae.rueda.718', 'lorenaclc95', 'sebas1501', 'patriciae.navarrop', 'maleja95', 'darwindubay']"
58,53,10,9,6,"['dianamg', 'mariap.diazc', 'leon241254', 'javierchurtadov', 'sebas1501', 'maleja95']",3,"['lufecobe', 'mariae.rueda.718', 'darwindubay']",3,"['jeissonj.loaizam', 'patriciae.navarrop', None]",12,"['dianamg', 'lufecobe', 'mariap.diazc', 'leon241254', 'javierchurtadov', None, 'mariae.rueda.718', 'jeissonj.loaizam', 'sebas1501', 'patriciae.navarrop', 'maleja95', 'darwindubay']"
59,50,10,86,2,"['mohsin.nusrat', 'umair.mallick93']",7,"['fadi_benj', 'ahmedsalman2309', 'silva.andregomes', 'dlgicu', 'mike.franky', 'walkinginwater', 'bardella']",84,"['1993daniyal', 'saadmohsinsiddiqui', 'saqib.dastagir', 'hiraimtiaz', 'tayyabsiddiqui19', 'zainzia', 'nabeelahmed956', 'jazibabidi', 's102', 'ramal.jafri', 'aq.mahmoodqadri', 'arooj.fayyaz.9', 'mahrukhasghar', 'mzp482', 'farheenjahan66', 'arqamkhan', 'el83el85', 'el43', 'sabamalik000111', 'sameer.ansari786', 'shanno447', 'mammadsiddiqui15', 'mdaniyalmansoor', 'yusra_ammara', 'arwakhuzema93', 'saadhussainconquer', 'nedian.tahir', 'khudaijasaleem', 'el301el302', 'ruk_tuk', 'abdulbasitdhedhi', 'faizamoazzam8', 'maheenjd', 'nabeel.ahmed.79219', 'atiyab', 'mariamchoudry', 'nageenkhatri', 'mehshar', 'juniman29', 'urooj.fatima.3745', 'fizza.shamim', 'nedianbilal', 'el93_el96', 'humi1245', 'usmansiddiqui316', 'faizansalehshaikh', 'anm_92', 'muhammad.usama.shakil', 'tab1', 'hmf1492', 'daneylpasha', 'tubafaizan', 'zohaib.khan.16752754', 'sidra2020', 'mahrukh.asghar2120', 'wasif.engineer', 'hajra16', 'aliirfan13', 'khwaja.nabeel', 'sumbul', 'esaleem71', 'faizan_bajwa13', 'samreenasmara', 'basrahafeez2000', 'sanam_sarwar', 'sidra30', 'alishahvadsaria', 'iframoid', 'alifyah1', None, 'najmafaiza', 'talha.aly', 'm1', '1ooie', 'malihaashraf05', 'sanafaiza', 'x_man', 'erumnida', 'hiraamjad028', 'malinawaz345', 'sameer786', 'risik', 'ali.mubashir2993', 'jalal.shahab.brothers']",93,"['fadi_benj', '1993daniyal', 'saadmohsinsiddiqui', 'saqib.dastagir', 'hiraimtiaz', 'tayyabsiddiqui19', 'dlgicu', 'zainzia', 'nabeelahmed956', 'jazibabidi', 's102', 'ramal.jafri', 'aq.mahmoodqadri', 'bardella', 'arooj.fayyaz.9', 'mahrukhasghar', 'mzp482', 'umair.mallick93', 'farheenjahan66', 'arqamkhan', 'el83el85', 'el43', 'sabamalik000111', 'ahmedsalman2309', 'sameer.ansari786', 'shanno447', 'mammadsiddiqui15', 'mdaniyalmansoor', 'yusra_ammara', 'arwakhuzema93', 'saadhussainconquer', 'nedian.tahir', 'khudaijasaleem', 'el301el302', 'ruk_tuk', 'abdulbasitdhedhi', 'faizamoazzam8', 'maheenjd', 'nabeel.ahmed.79219', 'atiyab', 'mariamchoudry', 'nageenkhatri', 'mehshar', 'juniman29', 'urooj.fatima.3745', 'fizza.shamim', 'nedianbilal', 'el93_el96', 'humi1245', 'silva.andregomes', 'usmansiddiqui316', 'faizansalehshaikh', 'anm_92', 'muhammad.usama.shakil', 'tab1', 'hmf1492', 'daneylpasha', 'tubafaizan', 'zohaib.khan.16752754', 'sidra2020', 'mahrukh.asghar2120', 'wasif.engineer', 'hajra16', 'walkinginwater', 'aliirfan13', 'khwaja.nabeel', 'sumbul', 'esaleem71', 'faizan_bajwa13', 'samreenasmara', 'basrahafeez2000', 'sanam_sarwar', 'sidra30', 'alishahvadsaria', 'iframoid', 'alifyah1', None, 'najmafaiza', 'talha.aly', 'm1', '1ooie', 'malihaashraf05', 'sanafaiza', 'x_man', 'erumnida', 'hiraamjad028', 'malinawaz345', 'sameer786', 'mohsin.nusrat', 'risik', 'mike.franky', 'ali.mubashir2993', 'jalal.shahab.brothers']"
60,94,10,10,9,"['vicorral92', 'josephyi', 'lewong27', 'kara.e.mccloskey', 'rachelhatano', 'sindelar_ashley', 'zaynluv00', 'mbrooks8', 'dr.sreyes']",0,[],1,[None],10,"['vicorral92', 'josephyi', 'kara.e.mccloskey', 'rachelhatano', 'zaynluv00', None, 'mbrooks8', 'dr.sreyes', 'lewong27', 'sindelar_ashley']"
60,258,10,10,9,"['vicorral92', 'josephyi', 'lewong27', 'kara.e.mccloskey', 'rachelhatano', 'sindelar_ashley', 'zaynluv00', 'mbrooks8', 'dr.sreyes']",0,[],1,[None],10,"['vicorral92', 'josephyi', 'kara.e.mccloskey', 'rachelhatano', 'zaynluv00', None, 'mbrooks8', 'dr.sreyes', 'lewong27', 'sindelar_ashley']"
61,268,10,55,8,"['leavittm0', 'dtisdale', 'glhinkle', 'matthew.l.binkley', 'haller1', 'fernandd63', 'ljc99', 'campb122']",1,['green109'],47,"['dacapo007', 'lopez86', 'alaimana', 'nspear17', 'kim383', 'sawa', 'posta', 'zhu431', 'tictonk', 'paulleonc', 'azzedinr', 'jcassady30', 'robin198', 'adithyabhattachar', 'horner4', 'xphuah', 'jfschrad', 'gflesner', 'astronut95', 'cohen.jakedavid', 'tbruttom', 'czy121301', 'parsonsm', 'hallowj', 'kaiser17', 'smithjared1994', 'peachrings', 'mmckinne', 'richa201', 'vganapa', 'redwing', None, 'ahmed49', 'ramirez28', 'sullivaf', 'jtrouba', 'sboes95', 'jackie0212', 'fiferj', 'thoma386', 'pspagnolo72', 'ajana', 'woodsh', 'lim154', 'ross_piedmonte', 'gu97', 'tcurtiss']",56,"['nspear17', 'fernandd63', 'paulleonc', 'azzedinr', 'horner4', 'jfschrad', 'czy121301', 'campb122', 'hallowj', 'smithjared1994', 'mmckinne', 'vganapa', 'redwing', 'ahmed49', 'ramirez28', 'green109', 'sullivaf', 'sboes95', 'jackie0212', 'glhinkle', 'matthew.l.binkley', 'pspagnolo72', 'ajana', 'woodsh', 'ross_piedmonte', 'gu97', 'dacapo007', 'lopez86', 'dtisdale', 'kim383', 'sawa', 'posta', 'zhu431', 'tictonk', 'jcassady30', 'robin198', 'adithyabhattachar', 'ljc99', 'xphuah', 'gflesner', 'astronut95', 'cohen.jakedavid', 'tbruttom', 'lim154', 'parsonsm', 'kaiser17', 'leavittm0', 'peachrings', 'haller1', 'richa201', None, 'jtrouba', 'fiferj', 'thoma386', 'alaimana', 'tcurtiss']"
61,267,10,39,5,"['dtisdale', 'matthew.l.binkley', 'haller1', 'fernandd63', 'ljc99']",4,"['glhinkle', 'green109', 'campb122', 'leavittm0']",34,"['lopez86', 'nspear17', 'sawa', 'posta', 'zhu431', 'azzedinr', 'robin198', 'adithyabhattachar', 'horner4', 'xphuah', 'gflesner', 'cohen.jakedavid', 'tbruttom', 'theresa.saenz.1', 'czy121301', 'parsonsm', 'kaiser17', 'hallowj', 'smithjared1994', 'mmckinne', 'lucas.ray.169', 'redwing', None, 'ahmed49', 'sullivaf', 'jtrouba', 'sboes95', 'jackie0212', 'fiferj', 'pspagnolo72', 'woodsh', 'alaimana', 'ross_piedmonte', 'tcurtiss']",43,"['lopez86', 'nspear17', 'dtisdale', 'sawa', 'fernandd63', 'posta', 'zhu431', 'azzedinr', 'robin198', 'adithyabhattachar', 'horner4', 'ljc99', 'xphuah', 'gflesner', 'cohen.jakedavid', 'tbruttom', 'theresa.saenz.1', 'czy121301', 'parsonsm', 'campb122', 'hallowj', 'kaiser17', 'smithjared1994', 'leavittm0', 'mmckinne', 'haller1', 'lucas.ray.169', 'redwing', None, 'ahmed49', 'green109', 'sullivaf', 'jtrouba', 'sboes95', 'jackie0212', 'glhinkle', 'matthew.l.binkley', 'fiferj', 'pspagnolo72', 'woodsh', 'alaimana', 'ross_piedmonte', 'tcurtiss']"
61,262,10,37,6,"['dtisdale', 'glhinkle', 'matthew.l.binkley', 'fernandd63', 'ljc99', 'campb122']",3,"['haller1', 'green109', 'leavittm0']",31,"['lopez86', 'nspear17', 'kim383', 'raphaelkimme', 'sawa', 'posta', 'robin198', 'adithyabhattachar', 'horner4', 'gflesner', 'astronut95', 'cohen.jakedavid', 'tbruttom', 'theresa.saenz.1', 'czy121301', 'parsonsm', 'kaiser17', 'hallowj', 'smithjared1994', 'richa201', 'vganapa', 'redwing', None, 'ahmed49', 'jtrouba', 'cvieira', 'woodsh', 'alaimana', 'ross_piedmonte', 'glinvill', 'tcurtiss']",40,"['lopez86', 'nspear17', 'dtisdale', 'kim383', 'raphaelkimme', 'sawa', 'fernandd63', 'posta', 'robin198', 'adithyabhattachar', 'horner4', 'ljc99', 'gflesner', 'astronut95', 'cohen.jakedavid', 'tbruttom', 'theresa.saenz.1', 'czy121301', 'parsonsm', 'campb122', 'hallowj', 'kaiser17', 'smithjared1994', 'leavittm0', 'haller1', 'richa201', 'vganapa', 'redwing', None, 'ahmed49', 'green109', 'jtrouba', 'glhinkle', 'cvieira', 'matthew.l.binkley', 'woodsh', 'alaimana', 'ross_piedmonte', 'glinvill', 'tcurtiss']"
61,264,10,12,2,"['leavittm0', 'matthew.l.binkley']",7,"['green109', 'dtisdale', 'glhinkle', 'haller1', 'fernandd63', 'ljc99', 'campb122']",10,"['smithjared1994', 'li1470', 'cvieira', 'woodsh', 'azzedinr', 'pangb1', 'vganapa', 'alaimana', 'jinghan1022', None]",19,"['smithjared1994', 'leavittm0', 'dtisdale', 'li1470', 'haller1', 'fernandd63', 'pangb1', 'azzedinr', 'vganapa', 'jinghan1022', 'ljc99', None, 'green109', 'glhinkle', 'cvieira', 'matthew.l.binkley', 'woodsh', 'alaimana', 'campb122']"
61,263,10,9,6,"['dtisdale', 'glhinkle', 'matthew.l.binkley', 'fernandd63', 'ljc99', 'campb122']",3,"['haller1', 'green109', 'leavittm0']",3,"['raphaelkimme', 'redwing', None]",12,"['green109', 'leavittm0', 'dtisdale', 'glhinkle', 'raphaelkimme', None, 'matthew.l.binkley', 'haller1', 'fernandd63', 'redwing', 'ljc99', 'campb122']"
62,132,10,14,9,"['jfernandeztoribio', 'aeromexico12', 'afernando240', 'irenujamc', 'naiavazquez', 'claudia92', 'brigitt3b', 'jufrancisco', 'danigonzalezarmesto']",0,[],5,"['soragorn91', 'mfrr3', 'dlx_ares_sp', 'jacopo.repossi', None]",14,"['jfernandeztoribio', 'soragorn91', 'jacopo.repossi', 'dlx_ares_sp', None, 'danigonzalezarmesto', 'afernando240', 'aeromexico12', 'irenujamc', 'naiavazquez', 'mfrr3', 'claudia92', 'brigitt3b', 'jufrancisco']"
62,89,10,13,9,"['jfernandeztoribio', 'aeromexico12', 'afernando240', 'irenujamc', 'naiavazquez', 'claudia92', 'brigitt3b', 'jufrancisco', 'danigonzalezarmesto']",0,[],4,"['dlx_ares_sp', 'jacopo.repossi', 'soragorn91', None]",13,"['jfernandeztoribio', 'soragorn91', 'jacopo.repossi', 'dlx_ares_sp', None, 'danigonzalezarmesto', 'afernando240', 'aeromexico12', 'irenujamc', 'naiavazquez', 'claudia92', 'brigitt3b', 'jufrancisco']"
62,90,10,13,8,"['jfernandeztoribio', 'aeromexico12', 'afernando240', 'naiavazquez', 'claudia92', 'brigitt3b', 'jufrancisco', 'danigonzalezarmesto']",1,['irenujamc'],5,"['jpedros100', 'soragorn91', 'dlx_ares_sp', 'jacopo.repossi', None]",14,"['jfernandeztoribio', 'soragorn91', 'jacopo.repossi', 'dlx_ares_sp', None, 'danigonzalezarmesto', 'jpedros100', 'afernando240', 'aeromexico12', 'irenujamc', 'naiavazquez', 'claudia92', 'brigitt3b', 'jufrancisco']"
62,119,10,13,9,"['jfernandeztoribio', 'aeromexico12', 'afernando240', 'irenujamc', 'naiavazquez', 'claudia92', 'brigitt3b', 'jufrancisco', 'danigonzalezarmesto']",0,[],4,"['dlx_ares_sp', 'jacopo.repossi', 'soragorn91', None]",13,"['jfernandeztoribio', 'soragorn91', 'jacopo.repossi', 'dlx_ares_sp', None, 'danigonzalezarmesto', 'afernando240', 'aeromexico12', 'irenujamc', 'naiavazquez', 'claudia92', 'brigitt3b', 'jufrancisco']"
62,122,10,13,9,"['jfernandeztoribio', 'aeromexico12', 'afernando240', 'irenujamc', 'naiavazquez', 'claudia92', 'brigitt3b', 'jufrancisco', 'danigonzalezarmesto']",0,[],4,"['dlx_ares_sp', 'jacopo.repossi', None, 'mfrr3']",13,"['jfernandeztoribio', 'jacopo.repossi', 'dlx_ares_sp', None, 'danigonzalezarmesto', 'afernando240', 'aeromexico12', 'irenujamc', 'naiavazquez', 'mfrr3', 'claudia92', 'brigitt3b', 'jufrancisco']"
62,131,10,13,9,"['jfernandeztoribio', 'aeromexico12', 'afernando240', 'irenujamc', 'naiavazquez', 'claudia92', 'brigitt3b', 'jufrancisco', 'danigonzalezarmesto']",0,[],4,"['dlx_ares_sp', 'jacopo.repossi', 'soragorn91', None]",13,"['jfernandeztoribio', 'soragorn91', 'jacopo.repossi', 'dlx_ares_sp', None, 'danigonzalezarmesto', 'afernando240', 'aeromexico12', 'irenujamc', 'naiavazquez', 'claudia92', 'brigitt3b', 'jufrancisco']"
62,91,10,12,7,"['jfernandeztoribio', 'afernando240', 'irenujamc', 'naiavazquez', 'claudia92', 'jufrancisco', 'danigonzalezarmesto']",2,"['brigitt3b', 'aeromexico12']",5,"['jpedros100', 'soragorn91', 'dlx_ares_sp', 'jacopo.repossi', None]",14,"['jfernandeztoribio', 'soragorn91', 'jacopo.repossi', 'dlx_ares_sp', None, 'danigonzalezarmesto', 'jpedros100', 'afernando240', 'aeromexico12', 'irenujamc', 'naiavazquez', 'claudia92', 'brigitt3b', 'jufrancisco']"
62,124,10,10,7,"['jfernandeztoribio', 'afernando240', 'irenujamc', 'naiavazquez', 'claudia92', 'jufrancisco', 'danigonzalezarmesto']",2,"['brigitt3b', 'aeromexico12']",3,"['dlx_ares_sp', 'jacopo.repossi', None]",12,"['jfernandeztoribio', 'jacopo.repossi', 'dlx_ares_sp', None, 'danigonzalezarmesto', 'afernando240', 'aeromexico12', 'irenujamc', 'naiavazquez', 'claudia92', 'brigitt3b', 'jufrancisco']"
62,256,10,10,7,"['jfernandeztoribio', 'afernando240', 'irenujamc', 'naiavazquez', 'claudia92', 'brigitt3b', 'jufrancisco']",2,"['danigonzalezarmesto', 'aeromexico12']",3,"['dlx_ares_sp', 'jacopo.repossi', None]",12,"['jfernandeztoribio', 'jacopo.repossi', 'dlx_ares_sp', None, 'danigonzalezarmesto', 'afernando240', 'aeromexico12', 'irenujamc', 'naiavazquez', 'claudia92', 'brigitt3b', 'jufrancisco']"
62,92,10,8,5,"['jfernandeztoribio', 'claudia92', 'brigitt3b', 'jufrancisco', 'danigonzalezarmesto']",4,"['irenujamc', 'aeromexico12', 'naiavazquez', 'afernando240']",3,"['dlx_ares_sp', None, 'soragorn91']",12,"['jfernandeztoribio', 'afernando240', 'aeromexico12', 'soragorn91', None, 'irenujamc', 'naiavazquez', 'dlx_ares_sp', 'claudia92', 'brigitt3b', 'jufrancisco', 'danigonzalezarmesto']"
63,102,10,8,7,"['jab10190', 'yingjie.liu1989', 'wileyds', 'yingjie.liu.925', 'em.slimking', 'friendd1', 'anpham184']",2,"['tiago.botari', 'chrisfitz']",1,[None],10,"['jab10190', 'yingjie.liu1989', 'chrisfitz', 'wileyds', 'yingjie.liu.925', 'tiago.botari', 'em.slimking', None, 'friendd1', 'anpham184']"
64,133,10,7,6,"['tanchi69', 'mintz026', 'macve004', 'baier043', 'schmo025', 'samrobinson.g']",3,"['chan0979', 'pete8303', 'iloshwdgac']",1,[None],10,"['tanchi69', 'mintz026', 'macve004', 'chan0979', 'iloshwdgac', 'baier043', 'schmo025', None, 'pete8303', 'samrobinson.g']"
66,160,9,8,7,"['choys2012', 'joonhanyi', 'changjo19', 'nobellant215', 'daehyeon.kim.585', 'hamsin1011', 'chony1637']",1,['haohni'],1,[None],9,"['choys2012', 'joonhanyi', 'changjo19', 'nobellant215', 'daehyeon.kim.585', 'hamsin1011', 'haohni', 'chony1637', None]"
67,257,9,25,7,"['wangj879', 'williamzhao1107', 'c1059217', 'leidanqi92518', 'schen62', 'c786605443', 'xuanmingzhao']",1,['jasonlp11'],18,"['nhleo0028', 'prindaria', 'zhaoxm1107', 'handsomeking', 'yuwei.li.39', 'cs24451', 'jessie7shi', 'jwang70', 'wangjunshu1003', 'long7guo', 'cguo7', 'l_lopez645', 'qiushi1', 'luopeng901223', 'dlei3', 'niuyinxun', None, 'niuniuniu']",26,"['nhleo0028', 'jasonlp11', 'cs24451', 'qiushi1', 'niuyinxun', 'prindaria', 'williamzhao1107', 'wangjunshu1003', 'niuniuniu', 'wangj879', 'zhaoxm1107', 'jessie7shi', 'c1059217', 'jwang70', 'cguo7', 'luopeng901223', 'handsomeking', 'xuanmingzhao', None, 'yuwei.li.39', 'leidanqi92518', 'long7guo', 'l_lopez645', 'schen62', 'c786605443', 'dlei3']"
67,146,9,21,7,"['wangj879', 'williamzhao1107', 'c1059217', 'leidanqi92518', 'schen62', 'c786605443', 'xuanmingzhao']",1,['jasonlp11'],14,"['nhleo0028', 'yuwei.li.39', 'pzheng7', 'wqs1992930', 'cs24451', 'jessie7shi', 'jwang70', 'zhengpuguangsjtu', 'wangjunshu1003', 'cguo7', 'luopeng901223', 'dlei3', 'niuyinxun', None]",22,"['wangj879', 'nhleo0028', 'jasonlp11', 'cs24451', 'jessie7shi', 'c1059217', 'jwang70', 'cguo7', 'luopeng901223', 'xuanmingzhao', 'niuyinxun', None, 'yuwei.li.39', 'pzheng7', 'wqs1992930', 'williamzhao1107', 'leidanqi92518', 'wangjunshu1003', 'schen62', 'c786605443', 'dlei3', 'zhengpuguangsjtu']"
67,145,9,7,2,"['c1059217', 'jasonlp11']",6,"['wangj879', 'williamzhao1107', 'leidanqi92518', 'schen62', 'c786605443', 'xuanmingzhao']",5,"['wj271503', 'matthewpatchen', 'mohdsyahrinamri.mohdnoh28', 'msamohdnoh1', None]",13,"['wangj879', 'wj271503', 'williamzhao1107', 'jasonlp11', 'matthewpatchen', 'c1059217', 'mohdsyahrinamri.mohdnoh28', 'leidanqi92518', 'msamohdnoh1', 'schen62', 'c786605443', 'xuanmingzhao', None]"
68,239,9,9,8,"['vanessajarbo', 'mrkowalsky', 'jingtang', 'pjmanso2', 'jesulek', 'meganmazzella1', 'cclement093', 'smikhail93']",0,[],1,[None],9,"['vanessajarbo', 'mrkowalsky', 'jingtang', 'pjmanso2', 'jesulek', 'meganmazzella1', 'cclement093', None, 'smikhail93']"
69,165,9,38,7,"['michael.e2005', 'ericdodgers3', 'felipe.sanchez.127', 'pfrodriguez', 'thisoneworked', 'rm.mutz', 'rocolo14']",1,['ttowner94'],31,"['donnadel', 'jledesma5', 'itarin08', 'ecarodelcastillo93', 'eddierocha79', 'mariana_quantum', 'steese2000', 'icorral', 'antonl09', 'jrfarinas13', 'gjesparza', 'oring5express', 'fandrade5', 'boniljor', 'scampolla5', 'tmaldo22', 'alfredo.gonzalezflores', 'aeron17', 'stella', 'carmen.adel.56', None, 'fernando.torres.906', 'dedeniega', 'supersaok666', 'gabriel00274', 'raymundo.delarosa1', 'jamartinez16111982', 'andres.medina.79219', 'jperez35', 'flsilva', 'hugo.solorzanocampos']",39,"['donnadel', 'jledesma5', 'itarin08', 'rm.mutz', 'ecarodelcastillo93', 'felipe.sanchez.127', 'eddierocha79', 'mariana_quantum', 'steese2000', 'icorral', 'antonl09', 'jrfarinas13', 'gjesparza', 'oring5express', 'rocolo14', 'fandrade5', 'boniljor', 'scampolla5', 'tmaldo22', 'pfrodriguez', 'alfredo.gonzalezflores', 'aeron17', 'stella', 'carmen.adel.56', None, 'fernando.torres.906', 'dedeniega', 'michael.e2005', 'ttowner94', 'supersaok666', 'gabriel00274', 'ericdodgers3', 'thisoneworked', 'raymundo.delarosa1', 'jamartinez16111982', 'andres.medina.79219', 'jperez35', 'flsilva', 'hugo.solorzanocampos']"
69,203,9,35,8,"['michael.e2005', 'ttowner94', 'ericdodgers3', 'felipe.sanchez.127', 'pfrodriguez', 'thisoneworked', 'rm.mutz', 'rocolo14']",0,[],27,"['donnadel', 'jledesma5', 'ecarodelcastillo93', 'eddierocha79', 'mariana_quantum', 'steese2000', 'jrfarinas13', 'gwsimmons', 'gjesparza', 'fandrade5', 'oring5express', 'boniljor', 'scampolla5', 'tmaldo22', 'alfredo.gonzalezflores', 'stella', None, 'fernando.torres.906', 'dedeniega', 'gabriel00274', 'ilzee.tarin', 'jamartinez16111982', 'raymundo.delarosa1', 'andres.medina.79219', 'josueperezcoello', 'flsilva', 'hugo.solorzanocampos']",35,"['donnadel', 'jledesma5', 'rm.mutz', 'ecarodelcastillo93', 'felipe.sanchez.127', 'eddierocha79', 'mariana_quantum', 'steese2000', 'jrfarinas13', 'gwsimmons', 'oring5express', 'fandrade5', 'rocolo14', 'gjesparza', 'boniljor', 'scampolla5', 'tmaldo22', 'pfrodriguez', 'alfredo.gonzalezflores', 'stella', None, 'fernando.torres.906', 'dedeniega', 'michael.e2005', 'ttowner94', 'gabriel00274', 'ericdodgers3', 'ilzee.tarin', 'thisoneworked', 'raymundo.delarosa1', 'jamartinez16111982', 'andres.medina.79219', 'josueperezcoello', 'flsilva', 'hugo.solorzanocampos']"
69,228,9,30,8,"['michael.e2005', 'ttowner94', 'ericdodgers3', 'felipe.sanchez.127', 'pfrodriguez', 'thisoneworked', 'rm.mutz', 'rocolo14']",0,[],22,"['donnadel', 'jledesma5', 'ecarodelcastillo93', 'mariana_quantum', 'xabyblack', 'icorral', 'antonl09', 'jrfarinas13', 'gjesparza', 'fandrade5', 'aeron17', 'alfredo.gonzalezflores', 'amypaulinamedina', 'carmen.adel.56', 'stella', 'clubitup', None, 'fernando.torres.906', 'gabriel00274', 'flsilva', 'josueperezcoello', 'gregorio.simmons']",30,"['donnadel', 'jledesma5', 'rm.mutz', 'ecarodelcastillo93', 'felipe.sanchez.127', 'mariana_quantum', 'xabyblack', 'icorral', 'antonl09', 'jrfarinas13', 'fandrade5', 'gjesparza', 'rocolo14', 'pfrodriguez', 'aeron17', 'alfredo.gonzalezflores', 'amypaulinamedina', 'carmen.adel.56', 'stella', 'clubitup', None, 'fernando.torres.906', 'michael.e2005', 'ttowner94', 'gabriel00274', 'ericdodgers3', 'thisoneworked', 'flsilva', 'josueperezcoello', 'gregorio.simmons']"
69,214,9,29,8,"['michael.e2005', 'ttowner94', 'ericdodgers3', 'felipe.sanchez.127', 'pfrodriguez', 'thisoneworked', 'rm.mutz', 'rocolo14']",0,[],21,"['jledesma5', 'itarin08', 'eddierocha79', 'steese2000', 'uriel.samaniego.3', 'jrfarinas13', 'gwsimmons', 'fandrade5', 'gjesparza', 'scampolla5', 'aeron17', 'alfredo.gonzalezflores', 'carmen.adel.56', None, 'fernando.torres.906', 'gabriel00274', 'raymundo.delarosa1', 'andres.medina.79219', 'josueperezcoello', 'flsilva', 'hugo.solorzanocampos']",29,"['jledesma5', 'itarin08', 'rm.mutz', 'felipe.sanchez.127', 'eddierocha79', 'steese2000', 'uriel.samaniego.3', 'jrfarinas13', 'gwsimmons', 'gjesparza', 'fandrade5', 'rocolo14', 'scampolla5', 'pfrodriguez', 'alfredo.gonzalezflores', 'aeron17', 'carmen.adel.56', None, 'fernando.torres.906', 'michael.e2005', 'ttowner94', 'gabriel00274', 'ericdodgers3', 'thisoneworked', 'raymundo.delarosa1', 'andres.medina.79219', 'josueperezcoello', 'flsilva', 'hugo.solorzanocampos']"
69,79,9,23,7,"['michael.e2005', 'ericdodgers3', 'felipe.sanchez.127', 'pfrodriguez', 'thisoneworked', 'rm.mutz', 'rocolo14']",1,['ttowner94'],16,"['dedeniega', 'gjesparza', 'donnadel', 'supersaok666', 'eddierocha79', 'mariana_quantum', 'jamartinez16111982', 'steese2000', 'flsilva', 'ecarodelcastillo93', 'antonl09', 'clubitup', None, 'fandrade5', 'fernando.torres.906', 'jrfarinas13']",24,"['donnadel', 'pfrodriguez', 'rm.mutz', 'ecarodelcastillo93', 'clubitup', None, 'felipe.sanchez.127', 'fernando.torres.906', 'dedeniega', 'michael.e2005', 'gjesparza', 'ttowner94', 'supersaok666', 'ericdodgers3', 'thisoneworked', 'eddierocha79', 'mariana_quantum', 'jamartinez16111982', 'steese2000', 'flsilva', 'antonl09', 'fandrade5', 'rocolo14', 'jrfarinas13']"
69,40,9,15,6,"['michael.e2005', 'ericdodgers3', 'felipe.sanchez.127', 'pfrodriguez', 'rm.mutz', 'rocolo14']",2,"['thisoneworked', 'ttowner94']",9,"['donnadel', 'mariana_quantum', 'ecarodelcastillo93', 'flsilva', 'stella', 'antonl09', None, 'fandrade5', 'jrfarinas13']",17,"['donnadel', 'pfrodriguez', 'rm.mutz', 'stella', 'ecarodelcastillo93', None, 'felipe.sanchez.127', 'michael.e2005', 'ttowner94', 'ericdodgers3', 'thisoneworked', 'mariana_quantum', 'flsilva', 'antonl09', 'fandrade5', 'rocolo14', 'jrfarinas13']"
70,126,9,9,8,"['azamat', 'cthulhuchgk', 'stas', 'ozeum', 'eugene.buntov', 'julia', 'sergeevandrew', 'n.s.begun']",0,[],1,[None],9,"['azamat', 'cthulhuchgk', 'stas', 'ozeum', 'eugene.buntov', 'julia', 'sergeevandrew', None, 'n.s.begun']"
70,215,9,9,7,"['azamat', 'cthulhuchgk', 'stas', 'ozeum', 'julia', 'sergeevandrew', 'n.s.begun']",1,['eugene.buntov'],2,"[None, 'nikitadaianov']",10,"['azamat', 'cthulhuchgk', 'stas', 'ozeum', 'eugene.buntov', 'nikitadaianov', 'julia', 'sergeevandrew', None, 'n.s.begun']"
74,115,8,10,7,"['amnsawaby', 'abdelrahmansf', 'krepton', 'karim.mohsen.1984', 'amr1992ahmed', 'abdelrahman.heikal', 'eng.mustafa.k']",0,[],3,"[None, 'eng.raghda2011', 'eng.samehfares']",10,"['krepton', 'karim.mohsen.1984', 'amr1992ahmed', None, 'eng.raghda2011', 'amnsawaby', 'abdelrahmansf', 'abdelrahman.heikal', 'eng.mustafa.k', 'eng.samehfares']"
74,158,8,7,5,"['amnsawaby', 'abdelrahmansf', 'krepton', 'amr1992ahmed', 'abdelrahman.heikal']",2,"['karim.mohsen.1984', 'eng.mustafa.k']",2,"[None, 'eng.raghda2011']",9,"['eng.raghda2011', 'amnsawaby', 'abdelrahmansf', 'krepton', 'karim.mohsen.1984', 'amr1992ahmed', 'abdelrahman.heikal', None, 'eng.mustafa.k']"
75,107,8,32,5,"['vojtisek', 'xvalik00', 'xbosti03', 'springer.radek', 'junekji']",2,"['js12', 'ga']",27,"['xkrcma12', 'gr4viton', 'xnohaj00', 'vetrelec', 'xsebes15', 'chlad.miloslav', 'martin.stusek', 'xhulav00', 'dusouuaa', 'zoidbergus', 'xhajek29', 'johnymichal', 'rhrdina', 'sfence', 'xkrejs02', 'radek1234', 'honza03', None, 'xdusek19', 'elektronix', 'chlupatej', 'xhavel04', 'xbarin06', 'mahor12', 'coarser', 'lucky99', 'xkrasn04']",34,"['xkrcma12', 'gr4viton', 'xnohaj00', 'xvalik00', 'springer.radek', 'vetrelec', 'xsebes15', 'chlad.miloslav', 'martin.stusek', 'xhulav00', 'vojtisek', 'dusouuaa', 'zoidbergus', 'ga', 'xhajek29', 'johnymichal', 'rhrdina', 'sfence', 'xkrejs02', 'xbosti03', 'js12', 'radek1234', 'honza03', 'junekji', None, 'xdusek19', 'elektronix', 'chlupatej', 'xhavel04', 'xbarin06', 'mahor12', 'coarser', 'lucky99', 'xkrasn04']"
76,60,8,15,7,"['bettysu1992', 'jakesong2015', 'olk335', 'starwyx', 'dadiliyi', 'weizhaozhang2014', 'elizabethdebenedictis2014']",0,[],8,"['dhs007', 'ajer95', 'sel314', 'jiantingh', 'shiyi12cn', 'epd878', None, 'aribenjamin2014']",15,"['ajer95', 'olk335', 'jiantingh', 'shiyi12cn', 'starwyx', 'weizhaozhang2014', 'epd878', None, 'elizabethdebenedictis2014', 'aribenjamin2014', 'dhs007', 'bettysu1992', 'jakesong2015', 'sel314', 'dadiliyi']"
76,49,8,13,6,"['bettysu1992', 'olk335', 'starwyx', 'dadiliyi', 'weizhaozhang2014', 'elizabethdebenedictis2014']",1,['jakesong2015'],7,"['ajer95', 'keten', 'jiantingh', 'sifflammable', 'shiyi12cn', None, 'aribenjamin2014']",14,"['ajer95', 'olk335', 'jiantingh', 'shiyi12cn', 'starwyx', 'weizhaozhang2014', None, 'elizabethdebenedictis2014', 'aribenjamin2014', 'keten', 'bettysu1992', 'jakesong2015', 'sifflammable', 'dadiliyi']"
77,46,8,31,3,"['martin666', 'tomasjasnu', 'justme']",4,"['jiamingl', 'chaotsuc', 'liljeroth', 'sarajames01']",28,"['gr4viton', 'xnohaj00', 'vetrelec', 'xsebes15', 'chlad.miloslav', 'martin.stusek', 'vojta.moravec', 'xhulav00', 'dusouuaa', 'zoidbergus', 'xhajek29', 'johnymichal', 'xtesar27', 'rhrdina', 'nomad.007', 'gottwald9', 'xkrejs02', 'radek1234', 'lebeda', None, 'xdusek19', 'elektronix', 'xhavel04', 'mahor12', 'coarser', 'dohnalosobni', 'dudamichal1992', 'martin7334']",35,"['gr4viton', 'xnohaj00', 'vetrelec', 'xsebes15', 'chlad.miloslav', 'liljeroth', 'sarajames01', 'martin.stusek', 'vojta.moravec', 'martin666', 'xhulav00', 'dusouuaa', 'zoidbergus', 'xhajek29', 'xtesar27', 'johnymichal', 'rhrdina', 'nomad.007', 'gottwald9', 'xkrejs02', 'radek1234', 'lebeda', 'tomasjasnu', None, 'xdusek19', 'elektronix', 'xhavel04', 'mahor12', 'justme', 'coarser', 'dohnalosobni', 'dudamichal1992', 'martin7334', 'jiamingl', 'chaotsuc']"
78,67,8,20,7,"['sesulliv', 'kritim20', 'hangbui', 'mmsadeghi', 'ghartma', 'jcoolpepper', 'boyer2424']",0,[],13,"['melbahr5', 'haleys', 'kruanlei', 'sewsulliv', 'ehrmicha', 'tushar.chitrakar', 'tianfeiliu90', 'pakles', 'ebfleming', 'myungsuk1020', 'bryantsugg', None, 'aweathers']",20,"['kruanlei', 'sesulliv', 'sewsulliv', 'ehrmicha', 'hangbui', 'tianfeiliu90', 'pakles', 'ebfleming', 'myungsuk1020', 'jcoolpepper', None, 'melbahr5', 'haleys', 'kritim20', 'tushar.chitrakar', 'mmsadeghi', 'ghartma', 'bryantsugg', 'aweathers', 'boyer2424']"
78,236,8,9,7,"['sesulliv', 'kritim20', 'hangbui', 'mmsadeghi', 'ghartma', 'jcoolpepper', 'boyer2424']",0,[],2,"[None, 'pakles']",9,"['sesulliv', 'hangbui', 'pakles', 'jcoolpepper', None, 'kritim20', 'mmsadeghi', 'ghartma', 'boyer2424']"
79,50,8,86,2,"['arwakhuzema93', 'sameer.ansari786']",5,"['jacquelinemj', 'tristan.cox2', 'rateofsound', 'beeraiahp', 'huda.parvez']",84,"['1993daniyal', 'saadmohsinsiddiqui', 'saqib.dastagir', 'hiraimtiaz', 'tayyabsiddiqui19', 'zainzia', 'nabeelahmed956', 'jazibabidi', 's102', 'ramal.jafri', 'aq.mahmoodqadri', 'arooj.fayyaz.9', 'mahrukhasghar', 'mzp482', 'farheenjahan66', 'arqamkhan', 'umair.mallick93', 'el83el85', 'el43', 'sabamalik000111', 'shanno447', 'mammadsiddiqui15', 'mdaniyalmansoor', 'yusra_ammara', 'saadhussainconquer', 'nedian.tahir', 'khudaijasaleem', 'el301el302', 'ruk_tuk', 'abdulbasitdhedhi', 'faizamoazzam8', 'maheenjd', 'nabeel.ahmed.79219', 'atiyab', 'mariamchoudry', 'nageenkhatri', 'mehshar', 'juniman29', 'urooj.fatima.3745', 'fizza.shamim', 'nedianbilal', 'el93_el96', 'humi1245', 'usmansiddiqui316', 'faizansalehshaikh', 'anm_92', 'muhammad.usama.shakil', 'tab1', 'hmf1492', 'daneylpasha', 'tubafaizan', 'zohaib.khan.16752754', 'sidra2020', 'mahrukh.asghar2120', 'wasif.engineer', 'hajra16', 'aliirfan13', 'khwaja.nabeel', 'sumbul', 'esaleem71', 'faizan_bajwa13', 'samreenasmara', 'basrahafeez2000', 'sanam_sarwar', 'sidra30', 'alishahvadsaria', 'iframoid', 'alifyah1', None, 'najmafaiza', 'talha.aly', 'm1', '1ooie', 'malihaashraf05', 'sanafaiza', 'x_man', 'erumnida', 'hiraamjad028', 'malinawaz345', 'sameer786', 'mohsin.nusrat', 'risik', 'ali.mubashir2993', 'jalal.shahab.brothers']",91,"['1993daniyal', 'saadmohsinsiddiqui', 'saqib.dastagir', 'hiraimtiaz', 'tayyabsiddiqui19', 'zainzia', 'nabeelahmed956', 'jazibabidi', 's102', 'ramal.jafri', 'aq.mahmoodqadri', 'arooj.fayyaz.9', 'mahrukhasghar', 'mzp482', 'farheenjahan66', 'arqamkhan', 'umair.mallick93', 'el83el85', 'el43', 'sabamalik000111', 'sameer.ansari786', 'shanno447', 'beeraiahp', 'mammadsiddiqui15', 'mdaniyalmansoor', 'arwakhuzema93', 'yusra_ammara', 'saadhussainconquer', 'nedian.tahir', 'khudaijasaleem', 'el301el302', 'ruk_tuk', 'abdulbasitdhedhi', 'faizamoazzam8', 'maheenjd', 'nabeel.ahmed.79219', 'atiyab', 'mariamchoudry', 'nageenkhatri', 'mehshar', 'juniman29', 'urooj.fatima.3745', 'huda.parvez', 'fizza.shamim', 'nedianbilal', 'el93_el96', 'humi1245', 'usmansiddiqui316', 'faizansalehshaikh', 'anm_92', 'muhammad.usama.shakil', 'rateofsound', 'tab1', 'hmf1492', 'daneylpasha', 'tubafaizan', 'zohaib.khan.16752754', 'sidra2020', 'mahrukh.asghar2120', 'wasif.engineer', 'hajra16', 'aliirfan13', 'khwaja.nabeel', 'sumbul', 'jacquelinemj', 'tristan.cox2', 'faizan_bajwa13', 'esaleem71', 'samreenasmara', 'basrahafeez2000', 'sanam_sarwar', 'sidra30', 'alishahvadsaria', 'iframoid', 'alifyah1', None, 'najmafaiza', 'talha.aly', 'm1', '1ooie', 'malihaashraf05', 'sanafaiza', 'x_man', 'erumnida', 'hiraamjad028', 'malinawaz345', 'sameer786', 'mohsin.nusrat', 'risik', 'ali.mubashir2993', 'jalal.shahab.brothers']"
81,150,8,11,6,"['mjb18', 'enelson1', 'cainecole', 'bananobunch', 'stl4', 'snowjm22']",1,['bmonster88'],5,"['amf8', 'rlh5', 'brc3', None, 'dlipke']",12,"['mjb18', 'enelson1', 'rlh5', None, 'dlipke', 'bmonster88', 'cainecole', 'amf8', 'bananobunch', 'brc3', 'stl4', 'snowjm22']"
81,152,8,10,7,"['mjb18', 'enelson1', 'bmonster88', 'cainecole', 'bananobunch', 'stl4', 'snowjm22']",0,[],3,"['amf8', None, 'rlh5']",10,"['mjb18', 'enelson1', 'rlh5', None, 'bmonster88', 'cainecole', 'amf8', 'bananobunch', 'stl4', 'snowjm22']"
81,48,8,6,4,"['mjb18', 'enelson1', 'snowjm22', 'bananobunch']",3,"['stl4', 'bmonster88', 'cainecole']",2,"[None, 'dlipke']",9,"['mjb18', 'enelson1', 'bmonster88', 'cainecole', 'bananobunch', 'stl4', None, 'snowjm22', 'dlipke']"
83,93,8,10,7,"['pg3', 'ryandempsey', 'bmc2531', 'greniray', 'twp3', 'wendy2015', 'hkamat']",0,[],3,"['trevynhey', None, 'dlipke']",10,"['pg3', 'trevynhey', 'wendy2015', None, 'dlipke', 'ryandempsey', 'bmc2531', 'greniray', 'twp3', 'hkamat']"
83,266,8,8,6,"['pg3', 'bmc2531', 'greniray', 'twp3', 'wendy2015', 'hkamat']",1,['ryandempsey'],2,"['trevynhey', None]",9,"['pg3', 'trevynhey', 'ryandempsey', 'bmc2531', 'greniray', 'twp3', 'wendy2015', 'hkamat', None]"
83,265,8,6,5,"['pg3', 'bmc2531', 'greniray', 'wendy2015', 'hkamat']",2,"['ryandempsey', 'twp3']",1,[None],8,"['pg3', 'ryandempsey', 'bmc2531', 'greniray', 'twp3', 'wendy2015', 'hkamat', None]"
92,98,7,9,6,"['melshal24', 'mcginnis84', 'rpromyoo', 'bywolfe', 'rocky.hossain1990', 'john.flowers.5']",0,[],3,"[None, 'ashitamohile', 'gmbankar37']",9,"['melshal24', 'mcginnis84', 'rpromyoo', 'bywolfe', 'ashitamohile', 'gmbankar37', 'rocky.hossain1990', None, 'john.flowers.5']"
93,228,7,30,2,"['xabyblack', 'gregorio.simmons']",4,"['asmelkav', 'gp.salazar1970', 'afpimi', 'tronicdcam']",28,"['donnadel', 'jledesma5', 'aeron17', 'alfredo.gonzalezflores', 'pfrodriguez', 'amypaulinamedina', 'rm.mutz', 'ecarodelcastillo93', 'carmen.adel.56', 'stella', 'clubitup', None, 'felipe.sanchez.127', 'fernando.torres.906', 'gjesparza', 'michael.e2005', 'ttowner94', 'gabriel00274', 'ericdodgers3', 'thisoneworked', 'mariana_quantum', 'flsilva', 'josueperezcoello', 'icorral', 'antonl09', 'fandrade5', 'rocolo14', 'jrfarinas13']",34,"['gp.salazar1970', 'donnadel', 'jledesma5', 'rm.mutz', 'ecarodelcastillo93', 'felipe.sanchez.127', 'afpimi', 'mariana_quantum', 'xabyblack', 'icorral', 'antonl09', 'jrfarinas13', 'fandrade5', 'gjesparza', 'rocolo14', 'asmelkav', 'aeron17', 'alfredo.gonzalezflores', 'pfrodriguez', 'amypaulinamedina', 'carmen.adel.56', 'stella', 'clubitup', None, 'fernando.torres.906', 'michael.e2005', 'ttowner94', 'gabriel00274', 'tronicdcam', 'ericdodgers3', 'thisoneworked', 'flsilva', 'josueperezcoello', 'gregorio.simmons']"
93,227,7,20,4,"['asmelkav', 'gp.salazar1970', 'afpimi', 'tronicdcam']",2,"['xabyblack', 'gregorio.simmons']",16,"['pa.guerrero2498', 'edrevelo10', 'dluna16', 'jezl8', 'slinanromero', 'msantiagobp88', 'franz', 'ja.martinez1423', 's.mendez10', 'wmrey', 'sue.pernett', 'ticesa', 'prietonico', 'bestkira', 'qwertyuiopq1', None]",22,"['gp.salazar1970', 'edrevelo10', 'slinanromero', 'msantiagobp88', 'franz', 'ja.martinez1423', 's.mendez10', 'wmrey', 'sue.pernett', 'ticesa', 'prietonico', 'bestkira', 'dluna16', 'qwertyuiopq1', None, 'afpimi', 'pa.guerrero2498', 'tronicdcam', 'jezl8', 'xabyblack', 'gregorio.simmons', 'asmelkav']"
95,50,7,86,6,"['mzp482', 'hiraimtiaz', 'faizan_bajwa13', 'mehshar', 'alishahvadsaria', 'hmf1492']",0,[],80,"['1993daniyal', 'saadmohsinsiddiqui', 'saqib.dastagir', 'tayyabsiddiqui19', 'zainzia', 'nabeelahmed956', 'jazibabidi', 's102', 'ramal.jafri', 'aq.mahmoodqadri', 'arooj.fayyaz.9', 'mahrukhasghar', 'farheenjahan66', 'arqamkhan', 'umair.mallick93', 'el83el85', 'el43', 'sabamalik000111', 'sameer.ansari786', 'shanno447', 'mammadsiddiqui15', 'mdaniyalmansoor', 'yusra_ammara', 'arwakhuzema93', 'saadhussainconquer', 'nedian.tahir', 'khudaijasaleem', 'el301el302', 'ruk_tuk', 'abdulbasitdhedhi', 'faizamoazzam8', 'maheenjd', 'nabeel.ahmed.79219', 'atiyab', 'mariamchoudry', 'nageenkhatri', 'juniman29', 'urooj.fatima.3745', 'fizza.shamim', 'nedianbilal', 'el93_el96', 'humi1245', 'usmansiddiqui316', 'faizansalehshaikh', 'anm_92', 'muhammad.usama.shakil', 'tab1', 'daneylpasha', 'tubafaizan', 'zohaib.khan.16752754', 'sidra2020', 'mahrukh.asghar2120', 'wasif.engineer', 'hajra16', 'aliirfan13', 'khwaja.nabeel', 'sumbul', 'esaleem71', 'samreenasmara', 'basrahafeez2000', 'sanam_sarwar', 'sidra30', 'iframoid', 'alifyah1', None, 'najmafaiza', 'talha.aly', 'm1', '1ooie', 'malihaashraf05', 'sanafaiza', 'x_man', 'erumnida', 'hiraamjad028', 'malinawaz345', 'sameer786', 'mohsin.nusrat', 'risik', 'ali.mubashir2993', 'jalal.shahab.brothers']",86,"['1993daniyal', 'saadmohsinsiddiqui', 'saqib.dastagir', 'hiraimtiaz', 'tayyabsiddiqui19', 'zainzia', 'nabeelahmed956', 'jazibabidi', 's102', 'ramal.jafri', 'aq.mahmoodqadri', 'arooj.fayyaz.9', 'mahrukhasghar', 'mzp482', 'farheenjahan66', 'arqamkhan', 'umair.mallick93', 'el83el85', 'el43', 'sabamalik000111', 'sameer.ansari786', 'shanno447', 'mammadsiddiqui15', 'mdaniyalmansoor', 'yusra_ammara', 'arwakhuzema93', 'saadhussainconquer', 'nedian.tahir', 'khudaijasaleem', 'el301el302', 'ruk_tuk', 'abdulbasitdhedhi', 'faizamoazzam8', 'maheenjd', 'nabeel.ahmed.79219', 'atiyab', 'mariamchoudry', 'nageenkhatri', 'mehshar', 'juniman29', 'urooj.fatima.3745', 'fizza.shamim', 'nedianbilal', 'el93_el96', 'humi1245', 'usmansiddiqui316', 'faizansalehshaikh', 'anm_92', 'muhammad.usama.shakil', 'tab1', 'hmf1492', 'daneylpasha', 'tubafaizan', 'zohaib.khan.16752754', 'sidra2020', 'mahrukh.asghar2120', 'wasif.engineer', 'hajra16', 'aliirfan13', 'khwaja.nabeel', 'sumbul', 'esaleem71', 'faizan_bajwa13', 'samreenasmara', 'basrahafeez2000', 'sanam_sarwar', 'alishahvadsaria', 'sidra30', 'iframoid', 'alifyah1', None, 'najmafaiza', 'talha.aly', 'm1', '1ooie', 'malihaashraf05', 'sanafaiza', 'x_man', 'erumnida', 'hiraamjad028', 'malinawaz345', 'sameer786', 'mohsin.nusrat', 'risik', 'ali.mubashir2993', 'jalal.shahab.brothers']"
95,85,7,43,4,"['faizan_bajwa13', 'hiraimtiaz', 'alishahvadsaria', 'hmf1492']",2,"['mzp482', 'mehshar']",39,"['el93_el96', 'faizansalehshaikh', 'tehreemzehra', 'saqib.dastagir', 'anm_92', 'ali.mubashir2993', 'tayyabsiddiqui19', 'babar.siddique2', 's102', 'ramal.jafri', 'aq.mahmoodqadri', 'daneylpasha', 'tubafaizan', 'mahrukh.asghar2120', 'el83el85', 'aliirfan13', 'khwaja.nabeel', 'sumbul', 'samreenasmara', 'yusra_ammara', 'sidra30', 'alifyah1', 'sana_shaukat2005', None, 'saadhussainconquer', 'm1', 'el301el302', 'ruk_tuk', 'maheenjd', 'malihaashraf05', 'atiyab', 'x_man', 'erumnida', 'mariamchoudry', 'nageenkhatri', 'sanafaiza', 'sameer786', 'fizza.shamim', 'tab1']",45,"['el93_el96', 'faizansalehshaikh', 'tehreemzehra', 'saqib.dastagir', 'anm_92', 'hiraimtiaz', 'tab1', 'tayyabsiddiqui19', 'babar.siddique2', 'hmf1492', 's102', 'ramal.jafri', 'aq.mahmoodqadri', 'daneylpasha', 'tubafaizan', 'mzp482', 'mahrukh.asghar2120', 'el83el85', 'aliirfan13', 'khwaja.nabeel', 'sumbul', 'faizan_bajwa13', 'samreenasmara', 'yusra_ammara', 'alishahvadsaria', 'sidra30', 'alifyah1', 'sana_shaukat2005', None, 'saadhussainconquer', 'm1', 'el301el302', 'ruk_tuk', 'maheenjd', 'malihaashraf05', 'atiyab', 'x_man', 'erumnida', 'mariamchoudry', 'nageenkhatri', 'sanafaiza', 'sameer786', 'mehshar', 'fizza.shamim', 'ali.mubashir2993']"
95,80,7,34,2,"['hiraimtiaz', 'hmf1492']",4,"['mzp482', 'mehshar', 'alishahvadsaria', 'faizan_bajwa13']",32,"['el93_el96', 'hannanwildfire', 'anm_92', 'ahsansag93', 'tayyabsiddiqui19', 'zainzia', 'ramal.jafri', 'aq.mahmoodqadri', 'tubafaizan', 'sidra2020', 'el83el85', 'aliirfan13', 'khwaja.nabeel', 'babarchacher', 'sumbul', 'esaleem71', 'samreenasmara', 'alifyah1', None, 'najmafaiza', 'saadhussainconquer', 'm1', 'ruk_tuk', 'faizamoazzam8', 'x_man', 'erumnida', 'mariamchoudry', 'sameer786', 'urooj.fatima.3745', 'risik', 'fizza.shamim', 'ali.mubashir2993']",38,"['el93_el96', 'hannanwildfire', 'anm_92', 'hiraimtiaz', 'ahsansag93', 'tayyabsiddiqui19', 'zainzia', 'hmf1492', 'ramal.jafri', 'aq.mahmoodqadri', 'tubafaizan', 'mzp482', 'sidra2020', 'el83el85', 'aliirfan13', 'khwaja.nabeel', 'babarchacher', 'sumbul', 'esaleem71', 'faizan_bajwa13', 'samreenasmara', 'alishahvadsaria', 'alifyah1', None, 'najmafaiza', 'saadhussainconquer', 'm1', 'ruk_tuk', 'faizamoazzam8', 'x_man', 'erumnida', 'mariamchoudry', 'sameer786', 'mehshar', 'urooj.fatima.3745', 'risik', 'fizza.shamim', 'ali.mubashir2993']"
96,238,7,7,5,"['rafikasari', 'keti', 'robieths', 'firasatqiya', 'yusufhakimw']",1,['saritaskayahan'],2,"['mrsm1l3yz', None]",8,"['mrsm1l3yz', 'rafikasari', 'saritaskayahan', 'keti', 'robieths', 'firasatqiya', 'yusufhakimw', None]"
98,174,7,36,4,"['shohdy', 'amr_taha_93', 'shosho.khaled.710', 'kareem.waseem']",2,"['amremad', 'mariam500']",32,"['yousra.azab.9', 'nadine_atef', 'a94', 'felfelflafely', 'yasmin.adel.ya', 'tifa.madboly', 'reemakhaled', 'yasmin.atef3', 'dola47', 'ahmed.tariq.94.10', 'salma.ghobara', 'hos.mohammed', 'salma.elshamy.754', 'electro.ahmed', 'sherouknasr24', 'jerome.mourad', 'lailamo95', 'usfmohy', 'midomatrixrb10', 'jessica.joussa', None, 'hassanism', 'ebram.bero.92', 'harvey.hany.71', 'andrrrew', 'hala.adel.142', 'ahmad.wael.165', 'hashem.emad', 'king27med', 'lydia.alfred93', 'ahmedkhaled93', 'riru94']",38,"['yousra.azab.9', 'riru94', 'mariam500', 'nadine_atef', 'a94', 'amr_taha_93', 'felfelflafely', 'yasmin.adel.ya', 'tifa.madboly', 'reemakhaled', 'shohdy', 'dola47', 'ahmed.tariq.94.10', 'amremad', 'salma.ghobara', 'hos.mohammed', 'salma.elshamy.754', 'kareem.waseem', 'electro.ahmed', 'sherouknasr24', 'jerome.mourad', 'lailamo95', 'shosho.khaled.710', 'usfmohy', 'midomatrixrb10', 'jessica.joussa', None, 'hassanism', 'ebram.bero.92', 'harvey.hany.71', 'andrrrew', 'hala.adel.142', 'ahmad.wael.165', 'hashem.emad', 'king27med', 'lydia.alfred93', 'ahmedkhaled93', 'yasmin.atef3']"
98,4,7,29,1,['amremad'],5,"['shohdy', 'mariam500', 'amr_taha_93', 'shosho.khaled.710', 'kareem.waseem']",28,"['abdelsalamadel', 'shahira.mohamed.22', 'carket23', 'omnia', 'safeddin', 'sammikhail', 'ahmedelswify', 'mostafa.kamel.8989', 'ahmedcoolman', 'amgad.fekry.3', 'rana_karem', '3omariotareq', 'vanavinoo', None, 'nadinehelmy1', 'menna.khaled.925', 'hodashadi', 'binospop', 'dinatarek', 'ramsiscomm2014', 'magedaziz2011', 'sara.hanafy.752', 'ali.elmaraghy.7', 'halafadl94', 'asmaamohamed94', 'ayam.alaa', 'jocian.jemy', 'na3na3333']",34,"['mariam500', 'abdelsalamadel', 'shahira.mohamed.22', 'amr_taha_93', 'omnia', 'ahmedcoolman', 'amgad.fekry.3', '3omariotareq', 'shohdy', 'menna.khaled.925', 'magedaziz2011', 'sara.hanafy.752', 'ali.elmaraghy.7', 'amremad', 'asmaamohamed94', 'ayam.alaa', 'kareem.waseem', 'carket23', 'safeddin', 'sammikhail', 'ahmedelswify', 'mostafa.kamel.8989', 'shosho.khaled.710', 'rana_karem', 'vanavinoo', None, 'nadinehelmy1', 'hodashadi', 'binospop', 'dinatarek', 'ramsiscomm2014', 'halafadl94', 'jocian.jemy', 'na3na3333']"
101,50,6,86,1,['hiraamjad028'],4,"['aiden.martin', 'zuzula', 'bbg82', 'cake.wangusi']",85,"['1993daniyal', 'saadmohsinsiddiqui', 'saqib.dastagir', 'hiraimtiaz', 'tayyabsiddiqui19', 'zainzia', 'nabeelahmed956', 'jazibabidi', 's102', 'ramal.jafri', 'aq.mahmoodqadri', 'arooj.fayyaz.9', 'mahrukhasghar', 'mzp482', 'farheenjahan66', 'arqamkhan', 'umair.mallick93', 'el83el85', 'el43', 'sabamalik000111', 'sameer.ansari786', 'shanno447', 'mammadsiddiqui15', 'mdaniyalmansoor', 'yusra_ammara', 'arwakhuzema93', 'saadhussainconquer', 'nedian.tahir', 'khudaijasaleem', 'el301el302', 'ruk_tuk', 'abdulbasitdhedhi', 'faizamoazzam8', 'maheenjd', 'nabeel.ahmed.79219', 'atiyab', 'mariamchoudry', 'nageenkhatri', 'mehshar', 'juniman29', 'urooj.fatima.3745', 'fizza.shamim', 'nedianbilal', 'el93_el96', 'humi1245', 'usmansiddiqui316', 'faizansalehshaikh', 'anm_92', 'muhammad.usama.shakil', 'tab1', 'hmf1492', 'daneylpasha', 'tubafaizan', 'zohaib.khan.16752754', 'sidra2020', 'mahrukh.asghar2120', 'wasif.engineer', 'hajra16', 'aliirfan13', 'khwaja.nabeel', 'sumbul', 'esaleem71', 'faizan_bajwa13', 'samreenasmara', 'basrahafeez2000', 'sanam_sarwar', 'sidra30', 'alishahvadsaria', 'iframoid', 'alifyah1', None, 'najmafaiza', 'talha.aly', 'm1', '1ooie', 'malihaashraf05', 'sanafaiza', 'x_man', 'erumnida', 'malinawaz345', 'sameer786', 'mohsin.nusrat', 'risik', 'ali.mubashir2993', 'jalal.shahab.brothers']",90,"['1993daniyal', 'saadmohsinsiddiqui', 'saqib.dastagir', 'hiraimtiaz', 'tayyabsiddiqui19', 'zainzia', 'nabeelahmed956', 'jazibabidi', 's102', 'zuzula', 'ramal.jafri', 'aq.mahmoodqadri', 'arooj.fayyaz.9', 'aiden.martin', 'mahrukhasghar', 'mzp482', 'farheenjahan66', 'arqamkhan', 'umair.mallick93', 'el83el85', 'el43', 'sabamalik000111', 'sameer.ansari786', 'shanno447', 'mammadsiddiqui15', 'mdaniyalmansoor', 'yusra_ammara', 'arwakhuzema93', 'saadhussainconquer', 'nedian.tahir', 'khudaijasaleem', 'el301el302', 'ruk_tuk', 'abdulbasitdhedhi', 'faizamoazzam8', 'maheenjd', 'nabeel.ahmed.79219', 'atiyab', 'mariamchoudry', 'nageenkhatri', 'mehshar', 'juniman29', 'urooj.fatima.3745', 'fizza.shamim', 'nedianbilal', 'bbg82', 'el93_el96', 'humi1245', 'usmansiddiqui316', 'faizansalehshaikh', 'anm_92', 'muhammad.usama.shakil', 'tab1', 'hmf1492', 'daneylpasha', 'tubafaizan', 'zohaib.khan.16752754', 'sidra2020', 'mahrukh.asghar2120', 'wasif.engineer', 'hajra16', 'aliirfan13', 'khwaja.nabeel', 'sumbul', 'esaleem71', 'faizan_bajwa13', 'cake.wangusi', 'samreenasmara', 'basrahafeez2000', 'sanam_sarwar', 'sidra30', 'alishahvadsaria', 'iframoid', 'alifyah1', None, 'najmafaiza', 'talha.aly', 'm1', '1ooie', 'malihaashraf05', 'sanafaiza', 'x_man', 'hiraamjad028', 'erumnida', 'malinawaz345', 'sameer786', 'mohsin.nusrat', 'risik', 'ali.mubashir2993', 'jalal.shahab.brothers']"
103,19,6,28,1,['mjis14'],4,"['meeravishwanathan', 'munawar123', 'dloverde', 'tordenspyd']",27,"['dreameryss', 'ys5449', 'jungmin.lee.14268', 'primeevir', 'qwdf29', 'gog40', 'rtow1', 'hwh7980', 'poby', 'jaypark5769', 'dico7717', None, 'hihibyebye', 'qwer29', 'woo0069', 'jyarika', 'jjk00122', 'rohsh67', 'hodori90', 'dreameryss777', 'guheak92', 'fasterthan88', 'jwh0114', 'ehdrms3204', 'cjrlfrlf', 'skky9977', 'alenldkr']",32,"['dreameryss', 'meeravishwanathan', 'ys5449', 'jungmin.lee.14268', 'hwh7980', 'poby', 'jaypark5769', 'tordenspyd', 'hihibyebye', 'woo0069', 'munawar123', 'fasterthan88', 'jwh0114', 'dreameryss777', 'cjrlfrlf', 'ehdrms3204', 'skky9977', 'mjis14', 'primeevir', 'qwdf29', 'gog40', 'rtow1', 'dico7717', None, 'qwer29', 'jyarika', 'jjk00122', 'rohsh67', 'hodori90', 'guheak92', 'dloverde', 'alenldkr']"
104,50,6,86,4,"['nedian.tahir', 'wasif.engineer', 'usmansiddiqui316', 'malinawaz345']",1,['c.d.white18426'],82,"['1993daniyal', 'saadmohsinsiddiqui', 'saqib.dastagir', 'hiraimtiaz', 'tayyabsiddiqui19', 'zainzia', 'nabeelahmed956', 'jazibabidi', 's102', 'ramal.jafri', 'aq.mahmoodqadri', 'arooj.fayyaz.9', 'mahrukhasghar', 'mzp482', 'farheenjahan66', 'arqamkhan', 'umair.mallick93', 'el83el85', 'el43', 'sabamalik000111', 'sameer.ansari786', 'shanno447', 'mammadsiddiqui15', 'mdaniyalmansoor', 'yusra_ammara', 'arwakhuzema93', 'saadhussainconquer', 'khudaijasaleem', 'el301el302', 'ruk_tuk', 'abdulbasitdhedhi', 'faizamoazzam8', 'maheenjd', 'nabeel.ahmed.79219', 'atiyab', 'mariamchoudry', 'nageenkhatri', 'mehshar', 'juniman29', 'urooj.fatima.3745', 'fizza.shamim', 'nedianbilal', 'el93_el96', 'humi1245', 'faizansalehshaikh', 'anm_92', 'muhammad.usama.shakil', 'tab1', 'hmf1492', 'daneylpasha', 'tubafaizan', 'zohaib.khan.16752754', 'sidra2020', 'mahrukh.asghar2120', 'hajra16', 'aliirfan13', 'khwaja.nabeel', 'sumbul', 'esaleem71', 'faizan_bajwa13', 'samreenasmara', 'basrahafeez2000', 'sanam_sarwar', 'sidra30', 'alishahvadsaria', 'iframoid', 'alifyah1', None, 'najmafaiza', 'talha.aly', 'm1', '1ooie', 'malihaashraf05', 'sanafaiza', 'x_man', 'erumnida', 'hiraamjad028', 'sameer786', 'mohsin.nusrat', 'risik', 'ali.mubashir2993', 'jalal.shahab.brothers']",87,"['1993daniyal', 'saadmohsinsiddiqui', 'saqib.dastagir', 'hiraimtiaz', 'tayyabsiddiqui19', 'zainzia', 'nabeelahmed956', 'jazibabidi', 's102', 'ramal.jafri', 'aq.mahmoodqadri', 'arooj.fayyaz.9', 'mahrukhasghar', 'mzp482', 'farheenjahan66', 'arqamkhan', 'umair.mallick93', 'el83el85', 'el43', 'sabamalik000111', 'sameer.ansari786', 'shanno447', 'mammadsiddiqui15', 'mdaniyalmansoor', 'yusra_ammara', 'arwakhuzema93', 'nedian.tahir', 'saadhussainconquer', 'khudaijasaleem', 'el301el302', 'ruk_tuk', 'abdulbasitdhedhi', 'faizamoazzam8', 'maheenjd', 'nabeel.ahmed.79219', 'atiyab', 'mariamchoudry', 'nageenkhatri', 'mehshar', 'juniman29', 'urooj.fatima.3745', 'fizza.shamim', 'nedianbilal', 'el93_el96', 'humi1245', 'usmansiddiqui316', 'faizansalehshaikh', 'anm_92', 'c.d.white18426', 'muhammad.usama.shakil', 'tab1', 'hmf1492', 'daneylpasha', 'tubafaizan', 'zohaib.khan.16752754', 'sidra2020', 'mahrukh.asghar2120', 'wasif.engineer', 'hajra16', 'aliirfan13', 'khwaja.nabeel', 'sumbul', 'esaleem71', 'faizan_bajwa13', 'samreenasmara', 'basrahafeez2000', 'sanam_sarwar', 'sidra30', 'alishahvadsaria', 'iframoid', 'alifyah1', None, 'najmafaiza', 'talha.aly', 'm1', '1ooie', 'malihaashraf05', 'sanafaiza', 'x_man', 'erumnida', 'malinawaz345', 'hiraamjad028', 'sameer786', 'mohsin.nusrat', 'risik', 'ali.mubashir2993', 'jalal.shahab.brothers']"
105,14,6,7,5,"['mariaelena.fuentesmontero', 'rh.aguirre15', 'arnold.gonzalez', 'villalobosp.eduardo', 'diana.burciaga']",0,[],2,"[None, 'napolesd']",7,"['mariaelena.fuentesmontero', 'rh.aguirre15', 'arnold.gonzalez', 'villalobosp.eduardo', None, 'diana.burciaga', 'napolesd']"
107,18,6,6,5,"['kwop1237', 'hjy100444', 'jklprotoss', 'gihyun.tae', 'daesung']",0,[],1,[None],6,"['kwop1237', 'hjy100444', 'jklprotoss', 'gihyun.tae', None, 'daesung']"
109,32,6,32,5,"['xnohaj00', 'coarser', 'dudamichal1992', 'xtesar27', 'vojta.moravec']",0,[],27,"['gr4viton', 'jakub.kastner.79', 'vetrelec', 'xvozar02', 'chlad.miloslav', 'xvasko09', 'martin.stusek', 'xhulav00', 'dusouuaa', 'xmucha05', 'rhrdina', 'sfence', 'xkrejs02', 'radek1234', 'dddddaviddddd', 'dubrma', None, 'xdusek19', 'ondrejpijacek', 'xhavel04', 'xbarin06', 'mahor12', 'dohnalosobni', 'lucky99', 'xkrasn04', 'martin7334', 'budysvk']",32,"['gr4viton', 'jakub.kastner.79', 'xnohaj00', 'vetrelec', 'xvozar02', 'chlad.miloslav', 'xvasko09', 'vojta.moravec', 'martin.stusek', 'xhulav00', 'dusouuaa', 'xmucha05', 'xtesar27', 'rhrdina', 'sfence', 'xkrejs02', 'radek1234', 'dddddaviddddd', 'dubrma', None, 'xdusek19', 'ondrejpijacek', 'xhavel04', 'xbarin06', 'mahor12', 'coarser', 'dohnalosobni', 'lucky99', 'dudamichal1992', 'xkrasn04', 'martin7334', 'budysvk']"
109,107,6,32,2,"['coarser', 'xnohaj00']",3,"['vojta.moravec', 'dudamichal1992', 'xtesar27']",30,"['xkrcma12', 'gr4viton', 'xvalik00', 'vetrelec', 'springer.radek', 'xsebes15', 'chlad.miloslav', 'martin.stusek', 'xhulav00', 'vojtisek', 'dusouuaa', 'zoidbergus', 'xhajek29', 'johnymichal', 'rhrdina', 'sfence', 'xkrejs02', 'xbosti03', 'radek1234', 'honza03', 'junekji', None, 'xdusek19', 'elektronix', 'chlupatej', 'xhavel04', 'xbarin06', 'mahor12', 'lucky99', 'xkrasn04']",35,"['xkrcma12', 'gr4viton', 'xnohaj00', 'xvalik00', 'vetrelec', 'springer.radek', 'xsebes15', 'chlad.miloslav', 'vojta.moravec', 'martin.stusek', 'xhulav00', 'vojtisek', 'dusouuaa', 'zoidbergus', 'xhajek29', 'xtesar27', 'johnymichal', 'rhrdina', 'sfence', 'xkrejs02', 'xbosti03', 'radek1234', 'honza03', 'junekji', None, 'xdusek19', 'elektronix', 'chlupatej', 'xhavel04', 'xbarin06', 'mahor12', 'coarser', 'lucky99', 'dudamichal1992', 'xkrasn04']"
109,46,6,31,5,"['xnohaj00', 'coarser', 'dudamichal1992', 'xtesar27', 'vojta.moravec']",0,[],26,"['gr4viton', 'gottwald9', 'xkrejs02', 'vetrelec', 'xsebes15', 'chlad.miloslav', 'radek1234', 'lebeda', 'martin.stusek', 'tomasjasnu', 'xhulav00', 'martin666', None, 'xdusek19', 'johnymichal', 'elektronix', 'xhavel04', 'dusouuaa', 'mahor12', 'justme', 'zoidbergus', 'dohnalosobni', 'xhajek29', 'martin7334', 'rhrdina', 'nomad.007']",31,"['gr4viton', 'xnohaj00', 'vetrelec', 'xsebes15', 'chlad.miloslav', 'vojta.moravec', 'martin.stusek', 'xhulav00', 'martin666', 'dusouuaa', 'zoidbergus', 'xhajek29', 'xtesar27', 'johnymichal', 'rhrdina', 'nomad.007', 'gottwald9', 'xkrejs02', 'radek1234', 'lebeda', 'tomasjasnu', None, 'xdusek19', 'elektronix', 'xhavel04', 'mahor12', 'justme', 'coarser', 'dohnalosobni', 'dudamichal1992', 'martin7334']"
109,201,6,25,5,"['xnohaj00', 'coarser', 'dudamichal1992', 'xtesar27', 'vojta.moravec']",0,[],20,"['xkrcma12', 'xzmesk04', 'sfence', 'radek1234', 'martin.stusek', None, 'xdusek19', 'xarbos', 'elektronix', 'xbarin06', 'xhavel04', 'dusouuaa', 'nomaxx', 'mahor12', 'lucky99', 'xhajek29', 'xjelin36', 'xkrasn04', 'nomad.007', 'budysvk']",25,"['xkrcma12', 'xzmesk04', 'sfence', 'xnohaj00', 'radek1234', 'vojta.moravec', 'martin.stusek', None, 'xdusek19', 'xarbos', 'elektronix', 'xbarin06', 'xhavel04', 'dusouuaa', 'nomaxx', 'coarser', 'mahor12', 'lucky99', 'xhajek29', 'xjelin36', 'dudamichal1992', 'xkrasn04', 'xtesar27', 'nomad.007', 'budysvk']"
109,211,6,13,4,"['dudamichal1992', 'coarser', 'xnohaj00', 'vojta.moravec']",1,['xtesar27'],9,"['sfence', 'xarbos', 'chlad.miloslav', 'zoidbergus', 'xhajek29', 'xzahra18', 'lebeda', None, 'rhrdina']",14,"['sfence', 'xnohaj00', 'chlad.miloslav', 'xzahra18', 'lebeda', 'vojta.moravec', None, 'xarbos', 'coarser', 'zoidbergus', 'xhajek29', 'dudamichal1992', 'xtesar27', 'rhrdina']"
109,213,6,6,1,['xtesar27'],4,"['dudamichal1992', 'coarser', 'xnohaj00', 'vojta.moravec']",5,"['gottwald9', 'lucky99', 'honza03', 'xjelin36', None]",10,"['gottwald9', 'xnohaj00', 'coarser', 'lucky99', 'honza03', 'xjelin36', 'dudamichal1992', 'xtesar27', None, 'vojta.moravec']"
109,230,6,6,1,['xtesar27'],4,"['dudamichal1992', 'coarser', 'xnohaj00', 'vojta.moravec']",5,"['gottwald9', 'lucky99', 'honza03', 'xjelin36', None]",10,"['gottwald9', 'xnohaj00', 'coarser', 'lucky99', 'honza03', 'xjelin36', 'dudamichal1992', 'xtesar27', None, 'vojta.moravec']"
113,106,6,19,2,"['petr.stastny.94', 'machacek.jan2']",3,"['banaful.paul', 'daniel2073', 'quintero']",17,"['xkopul02', 'kalab', 'zdenek.hrebicek', 'martintatak', 'xskals01', 'markoshappy001', 'lukas.janic', 'kozmos', 'demeter.kykolka', 'peterson91x', 'josip23', '36tiger63', 'kapoo', 'richardjanac', 'mmod', 'd.pamanek', None]",22,"['kalab', 'kozmos', 'quintero', 'demeter.kykolka', 'peterson91x', 'kapoo', 'richardjanac', '36tiger63', None, 'xkopul02', 'banaful.paul', 'petr.stastny.94', 'zdenek.hrebicek', 'martintatak', 'xskals01', 'markoshappy001', 'machacek.jan2', 'lukas.janic', 'josip23', 'mmod', 'd.pamanek', 'daniel2073']"
