MClusterID,XClusterID,MClusterSize,XClusterSize,OverlapSize,OverlapMembers,MOnlySize,MOnlyMembers,XOnlySize,XOnlyMembers,CombinedSize,CombinedMembers
1,38,196,176,125,"['t0rse95', 'priyanka.chavan.s.pc', 'nimita.singh', 'vesitd16b', 'sshelar01', 'aksh1995', 'sarprashasti21', 'patilmonika681', 'gaikar.shubhada888', 'smsayali79', 'devanandkb', 'raghu.shirodkar', 'heenal0708', 'sanjay.devan.ranstad', 'reubenalexander2010', 'ashwinnumbrat94', 'satya_mishra', 'pranjali.borkar', 'richard.noronha', 'jadhavadhiraj', 'pratikkavale11', 'spawar10', 'abhishek.shinde', 'rakeshchrs87', 'harshada.patankar', 'smhatre08', 'dalviakshata12', 'mayurgaikwad1293', 'devang19.shah', 'pritish.das', 'gajakosh.sneha54', 'suyash.karle', 'milu21111994', 'takalesusmita', 'pranjali2610', 'cyberclan.xd', 'snehavardhini', 'nishanth1101', 'salil.vaidya', 'nitiiinbaranwal', 'naren.ambwani', 'seemamishra', 'trupti.vaity19', 'zak1010', 'lokhanderaj55', 'dlaxmanc59', 'narenambwani04', 'yamkarki', 'arsh.raina', 'vinu.sunny1994.vs', 'shubhampnkr', 'kaushik_gaikwad', 'sumaiyya.kazi94', 'abhishek291', 'muktat20', 'suraj348', 'govind9867129531', 'vijayaher0211', 'karna1995.kj', 'sneha.kutal', 'maradiyadhaval92', 'thefreeliar18', 'ksurgade', 'ascharyaskumar', 'deepuvijaya1806', 'ibrahimarif950', 'shrimohite13', 'mrinalini20.shah', 'darpan.bagwale', 'gokisush9', 'anirudh2442', 'syadav05', 'ranjanjadhav1234', 'vejalporia1994', 'kiran.pawar1611', 'anirudh0000', 'tawadesiddhesh1994', 'priyankajamdade23', 'sapnabhandary31', 'zalakdodecha', 'aayushjain27894', 'nikhiljadhav.jadhav40', 'sapte01', 'ranju.raj18', 'chisimeybijimchigmomin', 'prajaktasjoshi911', 'dubalprasad04', 'omkar.bane13', 'kalpeshshukla11', 'sumitkarmokar', 'nshambhuraje', 'parabmahadev34', 'prathmeshgurunathparab', 'shashanksingh4000', 'abhijeetchavan', 'ashijadhav20', 'swapneil.hirulkar', 'paresh761', 'dung_master24', 'shreyasnaravane', 'ambicavenkatesh2009', 'rajkumar.kalantri', 'kuldeeppatil201093', 'shreenathdalvi1994', 'pankajsalunkhe23', 'amitmadgi15', 'smackthatjohn', 'sanika.pandharkar', 'omkar12345', 'akshaysharma', 'jmen1993', 'manishakolekar1994', 'sagarbisen50', 'pralim', 'sharvaridalvi301', 'sayli.shevade', 'rgole02', 'thoravekalpesh', 'asudha', 'palashmak067', 'ruchita9523', 'abhishek.singh', 'ryadav03', 'devendrashinde1995', 'gharat789']",71,"['vivianmascarenhas1994', 'shashankrane12', 'sj.shruti95', 'chintanrlimbani', 'aamod1996', 'rwaghela51', 'ashishtonge94', 'greatabhi.jathar', 'kanchipoddar', 'ajinkyapadwad', 'udayanyarya', 'rohan21', 'mewadayash', 'umang.parekh30', 'mananmehta95', 'rutuja1122', 'mannapatil', 'shashwatssanghavi', 'g.s.siddhant', 'patelmeeti1995', 'divyapawar39', 'amoghmorye', 'kedarthale', 'niharikasarode', 'vj280395', 'ghosh.arjun97', 'roberto.orio', 'savitashetty111', 'tejomayi.wandhile', 'rautsayli10', 'ameysv22', 'gurnani.nikita999', 'saurabhmangeshkar', 'arunimavarma20', 'mrhbtiwari', 'preeti.suryawanshi', 'yrsarvankar', 'bhujangmethe', 'rohanshah611', 'chinmayhejmadi', 'desaimaanil2', 'pritidhandrut25', 'amol.dhanvij10', 'mayur.agarwadekar', 'ranji7685', 'priyanka.kulkarni', 'barnik_1993', 'akajadhav1', 'dishantmehta1993', 'ssatam23dps', 'aka_jadhav', 'nishant.joshi42', 'vaibhavvadia', 'mns.dinu', 'dakshata', 'rohanbandal93', 'architagoyal', 'jharupesh440', 'aj.shahare', 'somesh.kumar', 'sonali2', 'prasadchachad20', 'karan.dhareshwar', 'ads_fission', 'roshninilam', 'deepashrisane2203', 'rajpareshshah14', 'sharan.raikhangar', 'qwdf29', 'dj.dharmik', 'vvalduga']",51,"['vedarthsave80', 'aishhhh', 'yash_iyengar27', 'shaikhkarnekar', 'aakash3194', 'swapnalimakdey25', 'mmodi296', 'pratham201294', 'jatinshende25', 'adityasawant93', 'hit.kamble', 'rupali1891994', 'kanchan.phadtare', 'ankushlagad4', 'mugdhapv8', 'pendkeomkar', 'mehta.krish', 'krusha14', 'rohan.ranshinge', 's.aditya.ghadiali', 'dkbathe29', 'chabhadiariddhi', 'a.b.surgade', 'ishmeetsingh', 'borse84kiran', 'ashish123', 'kanchangorde15', 'suyash.chopra', 'fruitywithmonty', 'jeniljain1008', 'manali', 'kumar.amit156', 'stylechicanki', 'pranali.kokate9', 'rupali.patil', 'amitpoojary94', 'amey.2994', 'ruprane296', 'isaurabhbhirud7', 'advaitchuri', 'tuscanowtsheryl128', 'nilesh2551994', 'mkshirke94', 'jidvaze', 'inderjitsingh87', 'karanshh30', 'anut730', 'chinmay', 'juvika1994', 'hrishikeshtawade', 'amol.marathe93']",247,"['t0rse95', 'shashankrane12', 'shaikhkarnekar', 'vesitd16b', 'rohan21', 'patilmonika681', 'kedarthale', 'tejomayi.wandhile', 'mehta.krish', 'yrsarvankar', 'raghu.shirodkar', 'reubenalexander2010', 'barnik_1993', 'ashwinnumbrat94', 'satya_mishra', 'pratikkavale11', 'mns.dinu', 'amitpoojary94', 'harshada.patankar', 'karan.dhareshwar', 'dalviakshata12', 'mayurgaikwad1293', 'sharan.raikhangar', 'dj.dharmik', 'pritish.das', 'gajakosh.sneha54', 'milu21111994', 'takalesusmita', 'pranjali2610', 'cyberclan.xd', 'snehavardhini', 'mewadayash', 'salil.vaidya', 'shashwatssanghavi', 'nitiiinbaranwal', 'naren.ambwani', 'vj280395', 'ankushlagad4', 'lokhanderaj55', 'ghosh.arjun97', 'narenambwani04', 'gurnani.nikita999', 'arsh.raina', 'preeti.suryawanshi', 'desaimaanil2', 'vinu.sunny1994.vs', 'kaushik_gaikwad', 'a.b.surgade', 'abhishek291', 'dakshata', 'suraj348', 'vijayaher0211', 'ruprane296', 'sneha.kutal', 'maradiyadhaval92', 'thefreeliar18', 'ksurgade', 'ascharyaskumar', 'shrimohite13', 'juvika1994', 'mrinalini20.shah', 'amol.marathe93', 'darpan.bagwale', 'aishhhh', 'aamod1996', 'gokisush9', 'kanchipoddar', 'aakash3194', 'swapnalimakdey25', 'syadav05', 'ranjanjadhav1234', 'rutuja1122', 'jatinshende25', 'vejalporia1994', 'hit.kamble', 'anirudh0000', 'tawadesiddhesh1994', 'mugdhapv8', 'dkbathe29', 'zalakdodecha', 'nikhiljadhav.jadhav40', 'sapte01', 'ranju.raj18', 'priyanka.kulkarni', 'pranali.kokate9', 'omkar.bane13', 'amey.2994', 'sumitkarmokar', 'nshambhuraje', 'advaitchuri', 'mkshirke94', 'parabmahadev34', 'shashanksingh4000', 'kanchangorde15', 'sj.shruti95', 'ashijadhav20', 'ajinkyapadwad', 'paresh761', 'dung_master24', 'shreyasnaravane', 'umang.parekh30', 'ambicavenkatesh2009', 'rajkumar.kalantri', 'mananmehta95', 'kuldeeppatil201093', 'shreenathdalvi1994', 'smackthatjohn', 'krusha14', 'sanika.pandharkar', 'omkar12345', 'rohanshah611', 'amol.dhanvij10', 'akshaysharma', 'sagarbisen50', 'pralim', 'sayli.shevade', 'akajadhav1', 'borse84kiran', 'thoravekalpesh', 'asudha', 'rupali.patil', 'jharupesh440', 'palashmak067', 'jidvaze', 'inderjitsingh87', 'abhishek.singh', 'ssatam23dps', 'vivianmascarenhas1994', 'priyanka.chavan.s.pc', 'nimita.singh', 'sshelar01', 'aksh1995', 'sarprashasti21', 'adityasawant93', 'patelmeeti1995', 'gaikar.shubhada888', 'g.s.siddhant', 'smsayali79', 'rohan.ranshinge', 'ameysv22', 'devanandkb', 'mrhbtiwari', 'bhujangmethe', 'chinmayhejmadi', 'heenal0708', 'sanjay.devan.ranstad', 'dishantmehta1993', 'pranjali.borkar', 'richard.noronha', 'fruitywithmonty', 'jadhavadhiraj', 'suyash.chopra', 'spawar10', 'architagoyal', 'abhishek.shinde', 'rakeshchrs87', 'nilesh2551994', 'smhatre08', 'deepashrisane2203', 'devang19.shah', 'vvalduga', 'suyash.karle', 'vedarthsave80', 'ashishtonge94', 'yash_iyengar27', 'nishanth1101', 'divyapawar39', 'rupali1891994', 'seemamishra', 'trupti.vaity19', 'zak1010', 'niharikasarode', 'dlaxmanc59', 'roberto.orio', 'savitashetty111', 'rautsayli10', 's.aditya.ghadiali', 'yamkarki', 'pritidhandrut25', 'ranji7685', 'shubhampnkr', 'aka_jadhav', 'nishant.joshi42', 'sumaiyya.kazi94', 'muktat20', 'stylechicanki', 'govind9867129531', 'karna1995.kj', 'tuscanowtsheryl128', 'somesh.kumar', 'sonali2', 'deepuvijaya1806', 'ads_fission', 'ibrahimarif950', 'rajpareshshah14', 'qwdf29', 'chinmay', 'anirudh2442', 'greatabhi.jathar', 'mmodi296', 'pratham201294', 'mannapatil', 'kiran.pawar1611', 'kanchan.phadtare', 'priyankajamdade23', 'sapnabhandary31', 'saurabhmangeshkar', 'chabhadiariddhi', 'arunimavarma20', 'aayushjain27894', 'chisimeybijimchigmomin', 'manali', 'prajaktasjoshi911', 'kumar.amit156', 'dubalprasad04', 'kalpeshshukla11', 'prasadchachad20', 'prathmeshgurunathparab', 'karanshh30', 'anut730', 'chintanrlimbani', 'rwaghela51', 'abhijeetchavan', 'swapneil.hirulkar', 'udayanyarya', 'amoghmorye', 'pankajsalunkhe23', 'amitmadgi15', 'pendkeomkar', 'mayur.agarwadekar', 'jmen1993', 'manishakolekar1994', 'sharvaridalvi301', 'ishmeetsingh', 'rgole02', 'ashish123', 'vaibhavvadia', 'jeniljain1008', 'isaurabhbhirud7', 'rohanbandal93', 'aj.shahare', 'roshninilam', 'ruchita9523', 'ryadav03', 'devendrashinde1995', 'gharat789', 'hrishikeshtawade']"
1,35,196,135,36,"['sj.shruti95', 'chintanrlimbani', 'abhijeetchavan', 'aamod1996', 'rwaghela51', 'kanchipoddar', 'udayanyarya', 'rohan21', 'mewadayash', 'umang.parekh30', 'rutuja1122', 'shashwatssanghavi', 'divyapawar39', 'patelmeeti1995', 'vj280395', 'niharikasarode', 'ghosh.arjun97', 'tejomayi.wandhile', 'ameysv22', 'saurabhmangeshkar', 'rohanshah611', 'desaimaanil2', 'chinmayhejmadi', 'akajadhav1', 'aka_jadhav', 'vaibhavvadia', 'dakshata', 'architagoyal', 'jharupesh440', 'aj.shahare', 'sonali2', 'prasadchachad20', 'karan.dhareshwar', 'roshninilam', 'deepashrisane2203', 'rajpareshshah14']",160,"['t0rse95', 'vivianmascarenhas1994', 'shashankrane12', 'priyanka.chavan.s.pc', 'nimita.singh', 'vesitd16b', 'sshelar01', 'aksh1995', 'sarprashasti21', 'g.s.siddhant', 'patilmonika681', 'gaikar.shubhada888', 'smsayali79', 'kedarthale', 'devanandkb', 'mrhbtiwari', 'bhujangmethe', 'yrsarvankar', 'raghu.shirodkar', 'heenal0708', 'sanjay.devan.ranstad', 'reubenalexander2010', 'barnik_1993', 'ashwinnumbrat94', 'dishantmehta1993', 'satya_mishra', 'pranjali.borkar', 'richard.noronha', 'jadhavadhiraj', 'pratikkavale11', 'mns.dinu', 'spawar10', 'abhishek.shinde', 'rakeshchrs87', 'harshada.patankar', 'smhatre08', 'dalviakshata12', 'mayurgaikwad1293', 'sharan.raikhangar', 'devang19.shah', 'dj.dharmik', 'pritish.das', 'gajakosh.sneha54', 'vvalduga', 'suyash.karle', 'milu21111994', 'takalesusmita', 'pranjali2610', 'ashishtonge94', 'cyberclan.xd', 'snehavardhini', 'nishanth1101', 'salil.vaidya', 'nitiiinbaranwal', 'naren.ambwani', 'seemamishra', 'trupti.vaity19', 'zak1010', 'lokhanderaj55', 'dlaxmanc59', 'narenambwani04', 'roberto.orio', 'savitashetty111', 'rautsayli10', 'gurnani.nikita999', 'yamkarki', 'arsh.raina', 'preeti.suryawanshi', 'pritidhandrut25', 'vinu.sunny1994.vs', 'ranji7685', 'shubhampnkr', 'kaushik_gaikwad', 'nishant.joshi42', 'abhishek291', 'sumaiyya.kazi94', 'muktat20', 'suraj348', 'govind9867129531', 'vijayaher0211', 'karna1995.kj', 'sneha.kutal', 'maradiyadhaval92', 'thefreeliar18', 'somesh.kumar', 'ksurgade', 'ascharyaskumar', 'deepuvijaya1806', 'ads_fission', 'ibrahimarif950', 'shrimohite13', 'qwdf29', 'mrinalini20.shah', 'darpan.bagwale', 'gokisush9', 'anirudh2442', 'greatabhi.jathar', 'syadav05', 'ranjanjadhav1234', 'vejalporia1994', 'mannapatil', 'kiran.pawar1611', 'anirudh0000', 'tawadesiddhesh1994', 'priyankajamdade23', 'sapnabhandary31', 'zalakdodecha', 'arunimavarma20', 'aayushjain27894', 'nikhiljadhav.jadhav40', 'sapte01', 'ranju.raj18', 'chisimeybijimchigmomin', 'priyanka.kulkarni', 'prajaktasjoshi911', 'dubalprasad04', 'omkar.bane13', 'kalpeshshukla11', 'sumitkarmokar', 'nshambhuraje', 'parabmahadev34', 'shashanksingh4000', 'prathmeshgurunathparab', 'ashijadhav20', 'ajinkyapadwad', 'swapneil.hirulkar', 'paresh761', 'dung_master24', 'shreyasnaravane', 'ambicavenkatesh2009', 'rajkumar.kalantri', 'mananmehta95', 'kuldeeppatil201093', 'shreenathdalvi1994', 'amoghmorye', 'pankajsalunkhe23', 'amitmadgi15', 'smackthatjohn', 'sanika.pandharkar', 'omkar12345', 'amol.dhanvij10', 'akshaysharma', 'mayur.agarwadekar', 'jmen1993', 'manishakolekar1994', 'sagarbisen50', 'pralim', 'sharvaridalvi301', 'sayli.shevade', 'rgole02', 'thoravekalpesh', 'asudha', 'rohanbandal93', 'palashmak067', 'ruchita9523', 'abhishek.singh', 'ryadav03', 'devendrashinde1995', 'gharat789', 'ssatam23dps']",99,"['kalpitnarvekar', 'linusassao974', 'komalkolekar95', 'lakshoza', 'tanmaypatil18', 'shamika', 'mehta.krish', 'bhoglet', 'sayaliw212', 'sonal.02031995', 'pomkar55', 'shahajichinchole', 'mrinalivyas1', 'mohiteruchir29', 'aksha0103', 'modyjash', 'kodagakshay26', 'himanshu21rasam', 'vanitashingwa1995', 'tushardmaske', 'imushaikh007', 'rp92555', 'hegde.aniket94.ah', 'dal30', 'mehakkoul1994', 'aniketvidyalankar', 'gohel.mitesh91', 'ansi7794', 'deepakjain.dj2', 'supriya.mangalpalli', 'ajoshi1996', 'hemantsonar93', 'sunilpoojary27', 'a.b.surgade', 'sammeetthosar', 'sangeetamjoshi', 'stylechicanki', 'basher00992', 'chaudharilatika02', 'satishlovesmom123', 'ruprane296', 'rahulstary', 'tuscanowtsheryl128', 'pb9298', 'adityasingh8394', 'shubham.mohite7', 'chinmay', 'gidayegirish', 'shraddha0306', 'sagnikpal3495', 'prasadbhujbal28', 'mmodi296', 'mengaderutuja369', 'ganeshmukund10', 'rsarmajrt', 'chabhadiariddhi', 'deepti.bhosale189', 'saurabh.medhekar18', 'akash.jadhav', 'hemantjathar7', 'pallavighogare1994', 'ganjirajini277', 'kumar.amit156', 'krishna.jhuma17', 'nilesh15394', 'aljo.joy22', 'ankitashere04', 'mayuresh20', 'kirandarade133', 'sagar2bhujbal', 'karanshh30', 'kanchangorde15', 'rushabkarani', 'jyotibhosale8483', 'samira2308', 'ayy1892', 'shivachandran.nadar15', 'prachipatil', 'qaspfu', 'ayushgupta11031996', 'tripathipavan10', 'sonaltambe32', 'sagar.mujpara99', 'mvedant29', 'borse84kiran', 'anujkolvalkar1', 'arcanetech12', 'darshanlukhi25', 'surajmore009', 'amitsunildhamne', 'redorchid029', 'nikinsaw', 'sunilkavatkar', 'phadsujata59', 'shetty1995pranoy', 'akshaykharat563', None, 'amaya.pethe', 'inderjitsingh87']",295,"['t0rse95', 'shashankrane12', 'kalpitnarvekar', 'vesitd16b', 'rohan21', 'komalkolekar95', 'patilmonika681', 'kedarthale', 'lakshoza', 'tejomayi.wandhile', 'mehta.krish', 'sayaliw212', 'yrsarvankar', 'raghu.shirodkar', 'reubenalexander2010', 'shahajichinchole', 'barnik_1993', 'ashwinnumbrat94', 'satya_mishra', 'pratikkavale11', 'mns.dinu', 'aksha0103', 'harshada.patankar', 'karan.dhareshwar', 'dalviakshata12', 'mayurgaikwad1293', 'sharan.raikhangar', 'dj.dharmik', 'pritish.das', 'gajakosh.sneha54', 'milu21111994', 'takalesusmita', 'pranjali2610', 'cyberclan.xd', 'snehavardhini', 'rp92555', 'mewadayash', 'salil.vaidya', 'shashwatssanghavi', 'nitiiinbaranwal', 'aniketvidyalankar', 'naren.ambwani', 'vj280395', 'lokhanderaj55', 'ghosh.arjun97', 'narenambwani04', 'deepakjain.dj2', 'gurnani.nikita999', 'supriya.mangalpalli', 'arsh.raina', 'preeti.suryawanshi', 'ajoshi1996', 'desaimaanil2', 'hemantsonar93', 'sunilpoojary27', 'vinu.sunny1994.vs', 'kaushik_gaikwad', 'a.b.surgade', 'abhishek291', 'basher00992', 'satishlovesmom123', 'dakshata', 'suraj348', 'vijayaher0211', 'ruprane296', 'sneha.kutal', 'maradiyadhaval92', 'thefreeliar18', 'ksurgade', 'ascharyaskumar', 'pb9298', 'shrimohite13', 'adityasingh8394', 'shubham.mohite7', 'mrinalini20.shah', 'shraddha0306', 'darpan.bagwale', 'aamod1996', 'gokisush9', 'kanchipoddar', 'sagnikpal3495', 'prasadbhujbal28', 'syadav05', 'ranjanjadhav1234', 'rutuja1122', 'mengaderutuja369', 'vejalporia1994', 'anirudh0000', 'tawadesiddhesh1994', 'rsarmajrt', 'zalakdodecha', 'nikhiljadhav.jadhav40', 'sapte01', 'deepti.bhosale189', 'ranju.raj18', 'saurabh.medhekar18', 'priyanka.kulkarni', 'hemantjathar7', 'ganjirajini277', 'omkar.bane13', 'sumitkarmokar', 'mayuresh20', 'nshambhuraje', 'parabmahadev34', 'shashanksingh4000', 'kanchangorde15', 'rushabkarani', 'sj.shruti95', 'ashijadhav20', 'ajinkyapadwad', 'paresh761', 'dung_master24', 'shreyasnaravane', 'umang.parekh30', 'ambicavenkatesh2009', 'rajkumar.kalantri', 'mananmehta95', 'samira2308', 'kuldeeppatil201093', 'shivachandran.nadar15', 'shreenathdalvi1994', 'smackthatjohn', 'ayushgupta11031996', 'tripathipavan10', 'sonaltambe32', 'sanika.pandharkar', 'omkar12345', 'rohanshah611', 'amol.dhanvij10', 'akshaysharma', 'sagarbisen50', 'pralim', 'sayli.shevade', 'akajadhav1', 'borse84kiran', 'thoravekalpesh', 'anujkolvalkar1', 'asudha', 'darshanlukhi25', 'redorchid029', 'nikinsaw', 'shetty1995pranoy', 'jharupesh440', 'amaya.pethe', 'palashmak067', 'inderjitsingh87', 'abhishek.singh', 'ssatam23dps', 'vivianmascarenhas1994', 'priyanka.chavan.s.pc', 'nimita.singh', 'sshelar01', 'aksh1995', 'linusassao974', 'sarprashasti21', 'patelmeeti1995', 'gaikar.shubhada888', 'g.s.siddhant', 'smsayali79', 'tanmaypatil18', 'shamika', 'ameysv22', 'devanandkb', 'bhoglet', 'mrhbtiwari', 'bhujangmethe', 'chinmayhejmadi', 'sonal.02031995', 'pomkar55', 'heenal0708', 'sanjay.devan.ranstad', 'dishantmehta1993', 'pranjali.borkar', 'richard.noronha', 'jadhavadhiraj', 'mrinalivyas1', 'spawar10', 'mohiteruchir29', 'architagoyal', 'modyjash', 'abhishek.shinde', 'rakeshchrs87', 'kodagakshay26', 'smhatre08', 'himanshu21rasam', 'deepashrisane2203', 'vanitashingwa1995', 'devang19.shah', 'vvalduga', 'suyash.karle', 'tushardmaske', 'ashishtonge94', 'imushaikh007', 'hegde.aniket94.ah', 'nishanth1101', 'dal30', 'mehakkoul1994', 'divyapawar39', 'gohel.mitesh91', 'ansi7794', 'seemamishra', 'trupti.vaity19', 'zak1010', 'niharikasarode', 'dlaxmanc59', 'roberto.orio', 'savitashetty111', 'rautsayli10', 'yamkarki', 'pritidhandrut25', 'ranji7685', 'shubhampnkr', 'aka_jadhav', 'nishant.joshi42', 'sumaiyya.kazi94', 'sammeetthosar', 'muktat20', 'sangeetamjoshi', 'stylechicanki', 'chaudharilatika02', 'govind9867129531', 'rahulstary', 'karna1995.kj', 'tuscanowtsheryl128', 'somesh.kumar', 'sonali2', 'deepuvijaya1806', 'ads_fission', 'ibrahimarif950', 'rajpareshshah14', 'qwdf29', 'chinmay', 'gidayegirish', 'anirudh2442', 'greatabhi.jathar', 'mmodi296', 'ganeshmukund10', 'mannapatil', 'kiran.pawar1611', 'priyankajamdade23', 'sapnabhandary31', 'saurabhmangeshkar', 'chabhadiariddhi', 'arunimavarma20', 'aayushjain27894', 'chisimeybijimchigmomin', 'akash.jadhav', 'pallavighogare1994', 'prajaktasjoshi911', 'kumar.amit156', 'krishna.jhuma17', 'nilesh15394', 'dubalprasad04', 'aljo.joy22', 'ankitashere04', 'kalpeshshukla11', 'kirandarade133', 'sagar2bhujbal', 'prasadchachad20', 'prathmeshgurunathparab', 'karanshh30', 'chintanrlimbani', 'rwaghela51', 'abhijeetchavan', 'swapneil.hirulkar', 'udayanyarya', 'jyotibhosale8483', 'ayy1892', 'amoghmorye', 'pankajsalunkhe23', 'amitmadgi15', 'prachipatil', 'qaspfu', 'mayur.agarwadekar', 'sagar.mujpara99', 'jmen1993', 'manishakolekar1994', 'sharvaridalvi301', 'mvedant29', 'rgole02', 'arcanetech12', 'vaibhavvadia', 'surajmore009', 'amitsunildhamne', 'sunilkavatkar', 'phadsujata59', 'rohanbandal93', 'akshaykharat563', None, 'aj.shahare', 'roshninilam', 'ruchita9523', 'ryadav03', 'devendrashinde1995', 'gharat789']"
1,42,196,69,20,"['vivianmascarenhas1994', 'nimita.singh', 'greatabhi.jathar', 'mewadayash', 'mananmehta95', 'mannapatil', 'shashwatssanghavi', 'kedarthale', 'tejomayi.wandhile', 'sanika.pandharkar', 'gurnani.nikita999', 'mrhbtiwari', 'amol.dhanvij10', 'pritidhandrut25', 'priyanka.kulkarni', 'rohanbandal93', 'sonali2', 'sharan.raikhangar', 'dj.dharmik', 'ssatam23dps']",176,"['t0rse95', 'shashankrane12', 'priyanka.chavan.s.pc', 'vesitd16b', 'sshelar01', 'aksh1995', 'rohan21', 'sarprashasti21', 'gaikar.shubhada888', 'g.s.siddhant', 'patilmonika681', 'patelmeeti1995', 'smsayali79', 'ameysv22', 'devanandkb', 'bhujangmethe', 'yrsarvankar', 'raghu.shirodkar', 'chinmayhejmadi', 'heenal0708', 'sanjay.devan.ranstad', 'reubenalexander2010', 'barnik_1993', 'ashwinnumbrat94', 'dishantmehta1993', 'satya_mishra', 'pranjali.borkar', 'richard.noronha', 'jadhavadhiraj', 'pratikkavale11', 'mns.dinu', 'spawar10', 'architagoyal', 'abhishek.shinde', 'rakeshchrs87', 'harshada.patankar', 'karan.dhareshwar', 'smhatre08', 'dalviakshata12', 'deepashrisane2203', 'mayurgaikwad1293', 'devang19.shah', 'pritish.das', 'gajakosh.sneha54', 'vvalduga', 'suyash.karle', 'milu21111994', 'takalesusmita', 'pranjali2610', 'ashishtonge94', 'cyberclan.xd', 'snehavardhini', 'nishanth1101', 'salil.vaidya', 'nitiiinbaranwal', 'divyapawar39', 'naren.ambwani', 'seemamishra', 'trupti.vaity19', 'zak1010', 'lokhanderaj55', 'niharikasarode', 'vj280395', 'dlaxmanc59', 'narenambwani04', 'roberto.orio', 'ghosh.arjun97', 'savitashetty111', 'rautsayli10', 'yamkarki', 'arsh.raina', 'preeti.suryawanshi', 'desaimaanil2', 'vinu.sunny1994.vs', 'ranji7685', 'shubhampnkr', 'kaushik_gaikwad', 'aka_jadhav', 'nishant.joshi42', 'abhishek291', 'sumaiyya.kazi94', 'muktat20', 'dakshata', 'govind9867129531', 'vijayaher0211', 'suraj348', 'karna1995.kj', 'sneha.kutal', 'maradiyadhaval92', 'thefreeliar18', 'somesh.kumar', 'ksurgade', 'ascharyaskumar', 'deepuvijaya1806', 'ads_fission', 'ibrahimarif950', 'shrimohite13', 'rajpareshshah14', 'qwdf29', 'mrinalini20.shah', 'darpan.bagwale', 'aamod1996', 'gokisush9', 'anirudh2442', 'kanchipoddar', 'syadav05', 'ranjanjadhav1234', 'rutuja1122', 'vejalporia1994', 'kiran.pawar1611', 'anirudh0000', 'tawadesiddhesh1994', 'priyankajamdade23', 'sapnabhandary31', 'saurabhmangeshkar', 'zalakdodecha', 'arunimavarma20', 'aayushjain27894', 'nikhiljadhav.jadhav40', 'sapte01', 'ranju.raj18', 'chisimeybijimchigmomin', 'prajaktasjoshi911', 'dubalprasad04', 'omkar.bane13', 'kalpeshshukla11', 'sumitkarmokar', 'nshambhuraje', 'parabmahadev34', 'prasadchachad20', 'shashanksingh4000', 'prathmeshgurunathparab', 'sj.shruti95', 'chintanrlimbani', 'rwaghela51', 'abhijeetchavan', 'ashijadhav20', 'ajinkyapadwad', 'swapneil.hirulkar', 'paresh761', 'udayanyarya', 'dung_master24', 'shreyasnaravane', 'umang.parekh30', 'ambicavenkatesh2009', 'rajkumar.kalantri', 'kuldeeppatil201093', 'shreenathdalvi1994', 'amoghmorye', 'pankajsalunkhe23', 'amitmadgi15', 'smackthatjohn', 'omkar12345', 'rohanshah611', 'mayur.agarwadekar', 'akshaysharma', 'jmen1993', 'manishakolekar1994', 'sagarbisen50', 'pralim', 'sharvaridalvi301', 'sayli.shevade', 'akajadhav1', 'rgole02', 'thoravekalpesh', 'vaibhavvadia', 'asudha', 'jharupesh440', 'aj.shahare', 'palashmak067', 'roshninilam', 'ruchita9523', 'abhishek.singh', 'ryadav03', 'devendrashinde1995', 'gharat789']",49,"['akshaykatkar', 'abha08', 'adithyamohan', 'aakash3194', 'swapnalimakdey25', 'linusassao974', 'jitusawant10', 'prathuhatode', 'kanchan.phadtare', 'sahilkolwankar', 'chiragpooniwala', 'pbandewar', 'shamika', 'ankushlagad4', 'varsha.jagadale188.vj', 'mehta.krish', 'krusha14', 'rohan.ranshinge', 's.aditya.ghadiali', 'karthik.radhakrishna022', 'sagar.mujpara99', 'kapsesainath', 'mandavkarnidhi', 'a.b.surgade', 'mvedant29', 'tanmaykadam', 'giridharsh1', 'fruitywithmonty', 'rupali.patil', 'pranali.kokate9', 'sushmakodagali', 'abhay.kshirsagar', 'sunilkavatkar', 'payalsaldur', None, 'ramjighatala7', 'ajit.gaikwad325', 'neetika.k10', 'pushkarvaity', 'vishalvb04', 'ghaisas.atharv', 'ashishjamdade72', 'mohit951995', 'jidvaze', 'shruti.ganjoo97', 'inderjitsingh87', 'nachi.2605', 'juvika1994', 'shraddha0306']",245,"['t0rse95', 'vivianmascarenhas1994', 'shashankrane12', 'priyanka.chavan.s.pc', 'nimita.singh', 'vesitd16b', 'sshelar01', 'aksh1995', 'rohan21', 'linusassao974', 'sarprashasti21', 'patelmeeti1995', 'gaikar.shubhada888', 'g.s.siddhant', 'patilmonika681', 'kedarthale', 'smsayali79', 'prathuhatode', 'chiragpooniwala', 'shamika', 'tejomayi.wandhile', 'mehta.krish', 'rohan.ranshinge', 'ameysv22', 'devanandkb', 'karthik.radhakrishna022', 'mrhbtiwari', 'bhujangmethe', 'yrsarvankar', 'chinmayhejmadi', 'raghu.shirodkar', 'heenal0708', 'sanjay.devan.ranstad', 'reubenalexander2010', 'barnik_1993', 'ashwinnumbrat94', 'dishantmehta1993', 'satya_mishra', 'tanmaykadam', 'pranjali.borkar', 'richard.noronha', 'giridharsh1', 'jadhavadhiraj', 'pratikkavale11', 'fruitywithmonty', 'spawar10', 'payalsaldur', 'architagoyal', 'ajit.gaikwad325', 'abhishek.shinde', 'rakeshchrs87', 'harshada.patankar', 'vishalvb04', 'karan.dhareshwar', 'smhatre08', 'mohit951995', 'dalviakshata12', 'deepashrisane2203', 'nachi.2605', 'mayurgaikwad1293', 'sharan.raikhangar', 'devang19.shah', 'dj.dharmik', 'pritish.das', 'gajakosh.sneha54', 'vvalduga', 'suyash.karle', 'akshaykatkar', 'milu21111994', 'abha08', 'takalesusmita', 'pranjali2610', 'ashishtonge94', 'cyberclan.xd', 'adithyamohan', 'snehavardhini', 'mewadayash', 'nishanth1101', 'salil.vaidya', 'shashwatssanghavi', 'nitiiinbaranwal', 'divyapawar39', 'naren.ambwani', 'seemamishra', 'trupti.vaity19', 'zak1010', 'niharikasarode', 'vj280395', 'dlaxmanc59', 'narenambwani04', 'roberto.orio', 'ghosh.arjun97', 'savitashetty111', 'rautsayli10', 'lokhanderaj55', 's.aditya.ghadiali', 'gurnani.nikita999', 'yamkarki', 'arsh.raina', 'preeti.suryawanshi', 'desaimaanil2', 'pritidhandrut25', 'vinu.sunny1994.vs', 'ranji7685', 'shubhampnkr', 'ankushlagad4', 'kaushik_gaikwad', 'mandavkarnidhi', 'a.b.surgade', 'aka_jadhav', 'nishant.joshi42', 'abhishek291', 'sumaiyya.kazi94', 'muktat20', 'dakshata', 'govind9867129531', 'vijayaher0211', 'suraj348', 'karna1995.kj', 'sneha.kutal', 'maradiyadhaval92', 'thefreeliar18', 'somesh.kumar', 'ksurgade', 'sonali2', 'ascharyaskumar', 'deepuvijaya1806', 'ads_fission', 'shruti.ganjoo97', 'ibrahimarif950', 'shrimohite13', 'rajpareshshah14', 'qwdf29', 'juvika1994', 'mrinalini20.shah', 'shraddha0306', 'darpan.bagwale', 'aamod1996', 'gokisush9', 'anirudh2442', 'greatabhi.jathar', 'kanchipoddar', 'aakash3194', 'swapnalimakdey25', 'syadav05', 'ranjanjadhav1234', 'rutuja1122', 'vejalporia1994', 'mannapatil', 'kiran.pawar1611', 'anirudh0000', 'kanchan.phadtare', 'tawadesiddhesh1994', 'priyankajamdade23', 'varsha.jagadale188.vj', 'sapnabhandary31', 'saurabhmangeshkar', 'zalakdodecha', 'arunimavarma20', 'aayushjain27894', 'nikhiljadhav.jadhav40', 'sapte01', 'ranju.raj18', 'chisimeybijimchigmomin', 'priyanka.kulkarni', 'kapsesainath', 'pbandewar', 'prajaktasjoshi911', 'pranali.kokate9', 'devendrashinde1995', 'dubalprasad04', 'omkar.bane13', 'kalpeshshukla11', 'sumitkarmokar', 'nshambhuraje', 'neetika.k10', 'parabmahadev34', 'prasadchachad20', 'shashanksingh4000', 'prathmeshgurunathparab', 'sj.shruti95', 'chintanrlimbani', 'rwaghela51', 'abhijeetchavan', 'ashijadhav20', 'ajinkyapadwad', 'swapneil.hirulkar', 'paresh761', 'udayanyarya', 'dung_master24', 'shreyasnaravane', 'umang.parekh30', 'ambicavenkatesh2009', 'rajkumar.kalantri', 'mananmehta95', 'jitusawant10', 'kuldeeppatil201093', 'shreenathdalvi1994', 'amoghmorye', 'pankajsalunkhe23', 'sahilkolwankar', 'amitmadgi15', 'smackthatjohn', 'krusha14', 'sanika.pandharkar', 'omkar12345', 'rohanshah611', 'amol.dhanvij10', 'akshaysharma', 'mayur.agarwadekar', 'jmen1993', 'manishakolekar1994', 'sagarbisen50', 'pralim', 'sagar.mujpara99', 'sharvaridalvi301', 'sayli.shevade', 'akajadhav1', 'mvedant29', 'rgole02', 'thoravekalpesh', 'vaibhavvadia', 'asudha', 'rupali.patil', 'sushmakodagali', 'abhay.kshirsagar', 'sunilkavatkar', None, 'rohanbandal93', 'jharupesh440', 'ramjighatala7', 'aj.shahare', 'palashmak067', 'pushkarvaity', 'roshninilam', 'ghaisas.atharv', 'ashishjamdade72', 'jidvaze', 'ruchita9523', 'abhishek.singh', 'ryadav03', 'inderjitsingh87', 'mns.dinu', 'gharat789', 'ssatam23dps']"
1,45,196,34,13,"['rwaghela51', 'ghosh.arjun97', 'nishant.joshi42', 'karan.dhareshwar', 'udayanyarya', 'rohan21', 'ameysv22', 'mewadayash', 'mananmehta95', 'rohanshah611', 'chinmayhejmadi', 'patelmeeti1995', 'jharupesh440']",183,"['t0rse95', 'vivianmascarenhas1994', 'shashankrane12', 'priyanka.chavan.s.pc', 'nimita.singh', 'vesitd16b', 'sshelar01', 'aksh1995', 'sarprashasti21', 'gaikar.shubhada888', 'g.s.siddhant', 'patilmonika681', 'kedarthale', 'smsayali79', 'tejomayi.wandhile', 'devanandkb', 'mrhbtiwari', 'bhujangmethe', 'yrsarvankar', 'raghu.shirodkar', 'heenal0708', 'sanjay.devan.ranstad', 'reubenalexander2010', 'barnik_1993', 'ashwinnumbrat94', 'dishantmehta1993', 'satya_mishra', 'pranjali.borkar', 'richard.noronha', 'jadhavadhiraj', 'pratikkavale11', 'spawar10', 'architagoyal', 'abhishek.shinde', 'rakeshchrs87', 'harshada.patankar', 'smhatre08', 'dalviakshata12', 'deepashrisane2203', 'mayurgaikwad1293', 'sharan.raikhangar', 'devang19.shah', 'dj.dharmik', 'pritish.das', 'gajakosh.sneha54', 'vvalduga', 'suyash.karle', 'milu21111994', 'takalesusmita', 'pranjali2610', 'ashishtonge94', 'cyberclan.xd', 'snehavardhini', 'nishanth1101', 'salil.vaidya', 'shashwatssanghavi', 'nitiiinbaranwal', 'divyapawar39', 'naren.ambwani', 'seemamishra', 'trupti.vaity19', 'zak1010', 'niharikasarode', 'vj280395', 'dlaxmanc59', 'narenambwani04', 'roberto.orio', 'savitashetty111', 'rautsayli10', 'lokhanderaj55', 'gurnani.nikita999', 'yamkarki', 'arsh.raina', 'preeti.suryawanshi', 'desaimaanil2', 'pritidhandrut25', 'vinu.sunny1994.vs', 'ranji7685', 'shubhampnkr', 'kaushik_gaikwad', 'aka_jadhav', 'abhishek291', 'sumaiyya.kazi94', 'muktat20', 'dakshata', 'govind9867129531', 'vijayaher0211', 'suraj348', 'karna1995.kj', 'sneha.kutal', 'maradiyadhaval92', 'thefreeliar18', 'somesh.kumar', 'ksurgade', 'sonali2', 'ascharyaskumar', 'deepuvijaya1806', 'ads_fission', 'ibrahimarif950', 'shrimohite13', 'rajpareshshah14', 'qwdf29', 'mrinalini20.shah', 'darpan.bagwale', 'aamod1996', 'gokisush9', 'anirudh2442', 'greatabhi.jathar', 'kanchipoddar', 'syadav05', 'ranjanjadhav1234', 'rutuja1122', 'vejalporia1994', 'mannapatil', 'kiran.pawar1611', 'anirudh0000', 'tawadesiddhesh1994', 'priyankajamdade23', 'sapnabhandary31', 'saurabhmangeshkar', 'zalakdodecha', 'arunimavarma20', 'aayushjain27894', 'nikhiljadhav.jadhav40', 'sapte01', 'ranju.raj18', 'chisimeybijimchigmomin', 'priyanka.kulkarni', 'prajaktasjoshi911', 'devendrashinde1995', 'dubalprasad04', 'omkar.bane13', 'kalpeshshukla11', 'sumitkarmokar', 'nshambhuraje', 'parabmahadev34', 'prasadchachad20', 'shashanksingh4000', 'prathmeshgurunathparab', 'sj.shruti95', 'chintanrlimbani', 'abhijeetchavan', 'ashijadhav20', 'ajinkyapadwad', 'swapneil.hirulkar', 'paresh761', 'dung_master24', 'shreyasnaravane', 'umang.parekh30', 'ambicavenkatesh2009', 'rajkumar.kalantri', 'kuldeeppatil201093', 'shreenathdalvi1994', 'amoghmorye', 'pankajsalunkhe23', 'amitmadgi15', 'smackthatjohn', 'sanika.pandharkar', 'omkar12345', 'amol.dhanvij10', 'akshaysharma', 'mayur.agarwadekar', 'jmen1993', 'manishakolekar1994', 'sagarbisen50', 'pralim', 'sharvaridalvi301', 'sayli.shevade', 'akajadhav1', 'rgole02', 'thoravekalpesh', 'vaibhavvadia', 'asudha', 'rohanbandal93', 'aj.shahare', 'palashmak067', 'roshninilam', 'ruchita9523', 'abhishek.singh', 'ryadav03', 'mns.dinu', 'gharat789', 'ssatam23dps']",21,"['daiwikb', 'siddhant', 'tzatakia', 'doshipayal1996', 'narkheden', 'karishmamehta34', 'manishaagam999', 'ritugupta1102.rg97', 'meet.muchhala95', 'rohancontractor.rc', 'helloworld1', 'kothari.dhruvin.dk', 'ruchawaghulde', None, 'vora.jai1', 'thosarm', 'riteshrajput381', 'aryakanika31', 'azazeljam', 'vandortshakti', 'chinmay']",217,"['t0rse95', 'vivianmascarenhas1994', 'shashankrane12', 'daiwikb', 'doshipayal1996', 'priyanka.chavan.s.pc', 'nimita.singh', 'vesitd16b', 'sshelar01', 'aksh1995', 'rohan21', 'sarprashasti21', 'patelmeeti1995', 'gaikar.shubhada888', 'g.s.siddhant', 'patilmonika681', 'kedarthale', 'smsayali79', 'meet.muchhala95', 'tejomayi.wandhile', 'rohancontractor.rc', 'ameysv22', 'devanandkb', 'mrhbtiwari', 'bhujangmethe', 'yrsarvankar', 'chinmayhejmadi', 'raghu.shirodkar', 'heenal0708', 'sanjay.devan.ranstad', 'reubenalexander2010', 'barnik_1993', 'ashwinnumbrat94', 'dishantmehta1993', 'satya_mishra', 'pranjali.borkar', 'richard.noronha', 'jadhavadhiraj', 'pratikkavale11', 'spawar10', 'vora.jai1', 'architagoyal', 'riteshrajput381', 'abhishek.shinde', 'aryakanika31', 'azazeljam', 'rakeshchrs87', 'harshada.patankar', 'karan.dhareshwar', 'smhatre08', 'dalviakshata12', 'deepashrisane2203', 'mayurgaikwad1293', 'sharan.raikhangar', 'vandortshakti', 'devang19.shah', 'dj.dharmik', 'pritish.das', 'gajakosh.sneha54', 'vvalduga', 'suyash.karle', 'milu21111994', 'takalesusmita', 'pranjali2610', 'ashishtonge94', 'cyberclan.xd', 'snehavardhini', 'mewadayash', 'nishanth1101', 'salil.vaidya', 'shashwatssanghavi', 'nitiiinbaranwal', 'divyapawar39', 'naren.ambwani', 'seemamishra', 'trupti.vaity19', 'zak1010', 'niharikasarode', 'vj280395', 'dlaxmanc59', 'narenambwani04', 'roberto.orio', 'ghosh.arjun97', 'savitashetty111', 'rautsayli10', 'lokhanderaj55', 'gurnani.nikita999', 'yamkarki', 'arsh.raina', 'preeti.suryawanshi', 'desaimaanil2', 'pritidhandrut25', 'vinu.sunny1994.vs', 'ranji7685', 'shubhampnkr', 'kaushik_gaikwad', 'aka_jadhav', 'nishant.joshi42', 'abhishek291', 'sumaiyya.kazi94', 'muktat20', 'dakshata', 'govind9867129531', 'vijayaher0211', 'suraj348', 'karna1995.kj', 'sneha.kutal', 'maradiyadhaval92', 'thefreeliar18', 'somesh.kumar', 'ksurgade', 'sonali2', 'ascharyaskumar', 'deepuvijaya1806', 'ads_fission', 'ibrahimarif950', 'shrimohite13', 'rajpareshshah14', 'qwdf29', 'chinmay', 'mrinalini20.shah', 'darpan.bagwale', 'aamod1996', 'gokisush9', 'anirudh2442', 'greatabhi.jathar', 'kanchipoddar', 'syadav05', 'ranjanjadhav1234', 'rutuja1122', 'vejalporia1994', 'mannapatil', 'kiran.pawar1611', 'anirudh0000', 'karishmamehta34', 'tawadesiddhesh1994', 'priyankajamdade23', 'ritugupta1102.rg97', 'sapnabhandary31', 'saurabhmangeshkar', 'zalakdodecha', 'arunimavarma20', 'aayushjain27894', 'nikhiljadhav.jadhav40', 'sapte01', 'ranju.raj18', 'chisimeybijimchigmomin', 'priyanka.kulkarni', 'prajaktasjoshi911', 'kothari.dhruvin.dk', 'devendrashinde1995', 'dubalprasad04', 'omkar.bane13', 'kalpeshshukla11', 'sumitkarmokar', 'thosarm', 'nshambhuraje', 'parabmahadev34', 'prasadchachad20', 'shashanksingh4000', 'prathmeshgurunathparab', 'sj.shruti95', 'chintanrlimbani', 'rwaghela51', 'abhijeetchavan', 'tzatakia', 'ashijadhav20', 'ajinkyapadwad', 'swapneil.hirulkar', 'narkheden', 'siddhant', 'paresh761', 'udayanyarya', 'dung_master24', 'shreyasnaravane', 'umang.parekh30', 'ambicavenkatesh2009', 'rajkumar.kalantri', 'mananmehta95', 'kuldeeppatil201093', 'shreenathdalvi1994', 'amoghmorye', 'pankajsalunkhe23', 'amitmadgi15', 'manishaagam999', 'smackthatjohn', 'sanika.pandharkar', 'omkar12345', 'rohanshah611', 'amol.dhanvij10', 'akshaysharma', 'mayur.agarwadekar', 'jmen1993', 'manishakolekar1994', 'sagarbisen50', 'pralim', 'sharvaridalvi301', 'sayli.shevade', 'akajadhav1', 'helloworld1', 'rgole02', 'thoravekalpesh', 'vaibhavvadia', 'asudha', 'ruchawaghulde', None, 'rohanbandal93', 'jharupesh440', 'aj.shahare', 'palashmak067', 'roshninilam', 'ruchita9523', 'abhishek.singh', 'ryadav03', 'mns.dinu', 'gharat789', 'ssatam23dps']"
1,41,196,21,10,"['trupti.vaity19', 'ssatam23dps', 'ashishtonge94', 'sonali2', 'arunimavarma20', 'amol.dhanvij10', 'mns.dinu', 'raghu.shirodkar', 'dj.dharmik', 'g.s.siddhant']",186,"['t0rse95', 'vivianmascarenhas1994', 'shashankrane12', 'priyanka.chavan.s.pc', 'nimita.singh', 'vesitd16b', 'sshelar01', 'aksh1995', 'rohan21', 'sarprashasti21', 'patelmeeti1995', 'gaikar.shubhada888', 'patilmonika681', 'kedarthale', 'smsayali79', 'tejomayi.wandhile', 'ameysv22', 'devanandkb', 'mrhbtiwari', 'bhujangmethe', 'yrsarvankar', 'chinmayhejmadi', 'heenal0708', 'sanjay.devan.ranstad', 'reubenalexander2010', 'barnik_1993', 'ashwinnumbrat94', 'dishantmehta1993', 'satya_mishra', 'pranjali.borkar', 'richard.noronha', 'jadhavadhiraj', 'pratikkavale11', 'spawar10', 'architagoyal', 'abhishek.shinde', 'rakeshchrs87', 'harshada.patankar', 'karan.dhareshwar', 'smhatre08', 'dalviakshata12', 'deepashrisane2203', 'mayurgaikwad1293', 'sharan.raikhangar', 'devang19.shah', 'pritish.das', 'gajakosh.sneha54', 'vvalduga', 'suyash.karle', 'milu21111994', 'takalesusmita', 'pranjali2610', 'cyberclan.xd', 'snehavardhini', 'mewadayash', 'nishanth1101', 'salil.vaidya', 'shashwatssanghavi', 'nitiiinbaranwal', 'divyapawar39', 'naren.ambwani', 'seemamishra', 'zak1010', 'niharikasarode', 'vj280395', 'dlaxmanc59', 'narenambwani04', 'roberto.orio', 'ghosh.arjun97', 'savitashetty111', 'rautsayli10', 'lokhanderaj55', 'gurnani.nikita999', 'yamkarki', 'arsh.raina', 'preeti.suryawanshi', 'desaimaanil2', 'pritidhandrut25', 'vinu.sunny1994.vs', 'ranji7685', 'shubhampnkr', 'kaushik_gaikwad', 'aka_jadhav', 'nishant.joshi42', 'abhishek291', 'sumaiyya.kazi94', 'muktat20', 'dakshata', 'govind9867129531', 'vijayaher0211', 'suraj348', 'karna1995.kj', 'sneha.kutal', 'maradiyadhaval92', 'thefreeliar18', 'somesh.kumar', 'ksurgade', 'ascharyaskumar', 'deepuvijaya1806', 'ads_fission', 'ibrahimarif950', 'shrimohite13', 'rajpareshshah14', 'qwdf29', 'mrinalini20.shah', 'darpan.bagwale', 'aamod1996', 'gokisush9', 'anirudh2442', 'greatabhi.jathar', 'kanchipoddar', 'syadav05', 'ranjanjadhav1234', 'rutuja1122', 'vejalporia1994', 'mannapatil', 'kiran.pawar1611', 'anirudh0000', 'tawadesiddhesh1994', 'priyankajamdade23', 'sapnabhandary31', 'saurabhmangeshkar', 'zalakdodecha', 'aayushjain27894', 'nikhiljadhav.jadhav40', 'sapte01', 'ranju.raj18', 'chisimeybijimchigmomin', 'priyanka.kulkarni', 'prajaktasjoshi911', 'devendrashinde1995', 'dubalprasad04', 'omkar.bane13', 'kalpeshshukla11', 'sumitkarmokar', 'nshambhuraje', 'parabmahadev34', 'prasadchachad20', 'shashanksingh4000', 'prathmeshgurunathparab', 'sj.shruti95', 'chintanrlimbani', 'rwaghela51', 'abhijeetchavan', 'ashijadhav20', 'ajinkyapadwad', 'swapneil.hirulkar', 'paresh761', 'udayanyarya', 'dung_master24', 'shreyasnaravane', 'umang.parekh30', 'ambicavenkatesh2009', 'rajkumar.kalantri', 'mananmehta95', 'kuldeeppatil201093', 'shreenathdalvi1994', 'amoghmorye', 'pankajsalunkhe23', 'amitmadgi15', 'smackthatjohn', 'sanika.pandharkar', 'omkar12345', 'rohanshah611', 'akshaysharma', 'mayur.agarwadekar', 'jmen1993', 'manishakolekar1994', 'sagarbisen50', 'pralim', 'sharvaridalvi301', 'sayli.shevade', 'akajadhav1', 'rgole02', 'thoravekalpesh', 'vaibhavvadia', 'asudha', 'rohanbandal93', 'jharupesh440', 'aj.shahare', 'palashmak067', 'roshninilam', 'ruchita9523', 'abhishek.singh', 'ryadav03', 'gharat789']",11,"['chiragpooniwala', 'fruitywithmonty', 'swapnalimakdey25', 'manali', 'jidvaze', 'prasadbhujbal28', 'sushmakodagali', 'inderjitsingh87', 'samira2308', None, 'sonali.bhujbal1']",207,"['t0rse95', 'vivianmascarenhas1994', 'shashankrane12', 'priyanka.chavan.s.pc', 'nimita.singh', 'vesitd16b', 'sshelar01', 'aksh1995', 'rohan21', 'sarprashasti21', 'patelmeeti1995', 'gaikar.shubhada888', 'g.s.siddhant', 'patilmonika681', 'kedarthale', 'smsayali79', 'chiragpooniwala', 'tejomayi.wandhile', 'ameysv22', 'devanandkb', 'mrhbtiwari', 'bhujangmethe', 'yrsarvankar', 'chinmayhejmadi', 'raghu.shirodkar', 'heenal0708', 'sanjay.devan.ranstad', 'reubenalexander2010', 'barnik_1993', 'ashwinnumbrat94', 'dishantmehta1993', 'satya_mishra', 'pranjali.borkar', 'richard.noronha', 'fruitywithmonty', 'jadhavadhiraj', 'pratikkavale11', 'spawar10', 'sonali.bhujbal1', 'architagoyal', 'abhishek.shinde', 'rakeshchrs87', 'harshada.patankar', 'karan.dhareshwar', 'smhatre08', 'dalviakshata12', 'deepashrisane2203', 'mayurgaikwad1293', 'sharan.raikhangar', 'devang19.shah', 'dj.dharmik', 'pritish.das', 'gajakosh.sneha54', 'vvalduga', 'suyash.karle', 'milu21111994', 'takalesusmita', 'pranjali2610', 'ashishtonge94', 'cyberclan.xd', 'snehavardhini', 'mewadayash', 'nishanth1101', 'salil.vaidya', 'shashwatssanghavi', 'nitiiinbaranwal', 'divyapawar39', 'naren.ambwani', 'seemamishra', 'trupti.vaity19', 'zak1010', 'niharikasarode', 'vj280395', 'dlaxmanc59', 'narenambwani04', 'roberto.orio', 'ghosh.arjun97', 'savitashetty111', 'rautsayli10', 'lokhanderaj55', 'gurnani.nikita999', 'yamkarki', 'arsh.raina', 'preeti.suryawanshi', 'desaimaanil2', 'pritidhandrut25', 'vinu.sunny1994.vs', 'ranji7685', 'shubhampnkr', 'kaushik_gaikwad', 'aka_jadhav', 'nishant.joshi42', 'abhishek291', 'sumaiyya.kazi94', 'muktat20', 'dakshata', 'govind9867129531', 'vijayaher0211', 'suraj348', 'karna1995.kj', 'sneha.kutal', 'maradiyadhaval92', 'thefreeliar18', 'somesh.kumar', 'ksurgade', 'sonali2', 'ascharyaskumar', 'deepuvijaya1806', 'ads_fission', 'ibrahimarif950', 'shrimohite13', 'rajpareshshah14', 'qwdf29', 'mrinalini20.shah', 'darpan.bagwale', 'aamod1996', 'gokisush9', 'anirudh2442', 'greatabhi.jathar', 'kanchipoddar', 'swapnalimakdey25', 'prasadbhujbal28', 'syadav05', 'ranjanjadhav1234', 'rutuja1122', 'vejalporia1994', 'mannapatil', 'kiran.pawar1611', 'anirudh0000', 'tawadesiddhesh1994', 'priyankajamdade23', 'sapnabhandary31', 'saurabhmangeshkar', 'zalakdodecha', 'arunimavarma20', 'aayushjain27894', 'nikhiljadhav.jadhav40', 'sapte01', 'ranju.raj18', 'chisimeybijimchigmomin', 'priyanka.kulkarni', 'manali', 'prajaktasjoshi911', 'devendrashinde1995', 'dubalprasad04', 'omkar.bane13', 'kalpeshshukla11', 'sumitkarmokar', 'nshambhuraje', 'parabmahadev34', 'prasadchachad20', 'shashanksingh4000', 'prathmeshgurunathparab', 'sj.shruti95', 'chintanrlimbani', 'rwaghela51', 'abhijeetchavan', 'ashijadhav20', 'ajinkyapadwad', 'swapneil.hirulkar', 'paresh761', 'udayanyarya', 'dung_master24', 'shreyasnaravane', 'umang.parekh30', 'ambicavenkatesh2009', 'rajkumar.kalantri', 'mananmehta95', 'samira2308', 'kuldeeppatil201093', 'shreenathdalvi1994', 'amoghmorye', 'pankajsalunkhe23', 'amitmadgi15', 'smackthatjohn', 'sanika.pandharkar', 'omkar12345', 'rohanshah611', 'amol.dhanvij10', 'akshaysharma', 'mayur.agarwadekar', 'jmen1993', 'manishakolekar1994', 'sagarbisen50', 'pralim', 'sharvaridalvi301', 'sayli.shevade', 'akajadhav1', 'rgole02', 'thoravekalpesh', 'vaibhavvadia', 'asudha', 'sushmakodagali', None, 'rohanbandal93', 'jharupesh440', 'aj.shahare', 'palashmak067', 'roshninilam', 'jidvaze', 'ruchita9523', 'abhishek.singh', 'ryadav03', 'inderjitsingh87', 'mns.dinu', 'gharat789', 'ssatam23dps']"
1,39,196,16,3,"['nishant.joshi42', 'savitashetty111', 'rautsayli10']",193,"['t0rse95', 'vivianmascarenhas1994', 'shashankrane12', 'priyanka.chavan.s.pc', 'nimita.singh', 'vesitd16b', 'sshelar01', 'aksh1995', 'rohan21', 'sarprashasti21', 'patelmeeti1995', 'gaikar.shubhada888', 'g.s.siddhant', 'patilmonika681', 'kedarthale', 'smsayali79', 'tejomayi.wandhile', 'ameysv22', 'devanandkb', 'mrhbtiwari', 'bhujangmethe', 'yrsarvankar', 'chinmayhejmadi', 'raghu.shirodkar', 'heenal0708', 'sanjay.devan.ranstad', 'reubenalexander2010', 'barnik_1993', 'ashwinnumbrat94', 'dishantmehta1993', 'satya_mishra', 'pranjali.borkar', 'richard.noronha', 'jadhavadhiraj', 'pratikkavale11', 'spawar10', 'architagoyal', 'abhishek.shinde', 'rakeshchrs87', 'harshada.patankar', 'karan.dhareshwar', 'smhatre08', 'dalviakshata12', 'deepashrisane2203', 'mayurgaikwad1293', 'sharan.raikhangar', 'devang19.shah', 'dj.dharmik', 'pritish.das', 'gajakosh.sneha54', 'vvalduga', 'suyash.karle', 'milu21111994', 'takalesusmita', 'pranjali2610', 'ashishtonge94', 'cyberclan.xd', 'snehavardhini', 'mewadayash', 'nishanth1101', 'salil.vaidya', 'shashwatssanghavi', 'nitiiinbaranwal', 'divyapawar39', 'naren.ambwani', 'seemamishra', 'trupti.vaity19', 'zak1010', 'niharikasarode', 'vj280395', 'dlaxmanc59', 'narenambwani04', 'roberto.orio', 'ghosh.arjun97', 'lokhanderaj55', 'gurnani.nikita999', 'yamkarki', 'arsh.raina', 'preeti.suryawanshi', 'desaimaanil2', 'pritidhandrut25', 'vinu.sunny1994.vs', 'ranji7685', 'shubhampnkr', 'kaushik_gaikwad', 'aka_jadhav', 'abhishek291', 'sumaiyya.kazi94', 'muktat20', 'dakshata', 'govind9867129531', 'vijayaher0211', 'suraj348', 'karna1995.kj', 'sneha.kutal', 'maradiyadhaval92', 'thefreeliar18', 'somesh.kumar', 'ksurgade', 'sonali2', 'ascharyaskumar', 'deepuvijaya1806', 'ads_fission', 'ibrahimarif950', 'shrimohite13', 'rajpareshshah14', 'qwdf29', 'mrinalini20.shah', 'darpan.bagwale', 'aamod1996', 'gokisush9', 'anirudh2442', 'greatabhi.jathar', 'kanchipoddar', 'syadav05', 'ranjanjadhav1234', 'rutuja1122', 'vejalporia1994', 'mannapatil', 'kiran.pawar1611', 'anirudh0000', 'tawadesiddhesh1994', 'priyankajamdade23', 'sapnabhandary31', 'saurabhmangeshkar', 'zalakdodecha', 'arunimavarma20', 'aayushjain27894', 'nikhiljadhav.jadhav40', 'sapte01', 'ranju.raj18', 'chisimeybijimchigmomin', 'priyanka.kulkarni', 'prajaktasjoshi911', 'devendrashinde1995', 'dubalprasad04', 'omkar.bane13', 'kalpeshshukla11', 'sumitkarmokar', 'nshambhuraje', 'parabmahadev34', 'prasadchachad20', 'shashanksingh4000', 'prathmeshgurunathparab', 'sj.shruti95', 'chintanrlimbani', 'rwaghela51', 'abhijeetchavan', 'ashijadhav20', 'ajinkyapadwad', 'swapneil.hirulkar', 'paresh761', 'udayanyarya', 'dung_master24', 'shreyasnaravane', 'umang.parekh30', 'ambicavenkatesh2009', 'rajkumar.kalantri', 'mananmehta95', 'kuldeeppatil201093', 'shreenathdalvi1994', 'amoghmorye', 'pankajsalunkhe23', 'amitmadgi15', 'smackthatjohn', 'sanika.pandharkar', 'omkar12345', 'rohanshah611', 'amol.dhanvij10', 'akshaysharma', 'mayur.agarwadekar', 'jmen1993', 'manishakolekar1994', 'sagarbisen50', 'pralim', 'sharvaridalvi301', 'sayli.shevade', 'akajadhav1', 'rgole02', 'thoravekalpesh', 'vaibhavvadia', 'asudha', 'rohanbandal93', 'jharupesh440', 'aj.shahare', 'palashmak067', 'roshninilam', 'ruchita9523', 'abhishek.singh', 'ryadav03', 'mns.dinu', 'gharat789', 'ssatam23dps']",13,"['akshaykshitija', 'shraddha0306', 'singhchetna01', 'rutu.balure', None, 'pb9298', 'sushmakodagali', 'basher00992', 'inderjitsingh87', 'sayaliw212', 'kanchangorde15', 'ajinkyamhatre', 'anetha123']",209,"['t0rse95', 'vivianmascarenhas1994', 'shashankrane12', 'priyanka.chavan.s.pc', 'nimita.singh', 'vesitd16b', 'sshelar01', 'aksh1995', 'rohan21', 'sarprashasti21', 'patelmeeti1995', 'gaikar.shubhada888', 'g.s.siddhant', 'patilmonika681', 'kedarthale', 'smsayali79', 'tejomayi.wandhile', 'ameysv22', 'devanandkb', 'sayaliw212', 'mrhbtiwari', 'bhujangmethe', 'yrsarvankar', 'chinmayhejmadi', 'raghu.shirodkar', 'heenal0708', 'sanjay.devan.ranstad', 'reubenalexander2010', 'barnik_1993', 'ashwinnumbrat94', 'dishantmehta1993', 'satya_mishra', 'pranjali.borkar', 'richard.noronha', 'jadhavadhiraj', 'pratikkavale11', 'spawar10', 'architagoyal', 'abhishek.shinde', 'rakeshchrs87', 'harshada.patankar', 'karan.dhareshwar', 'smhatre08', 'dalviakshata12', 'deepashrisane2203', 'mayurgaikwad1293', 'sharan.raikhangar', 'devang19.shah', 'dj.dharmik', 'pritish.das', 'gajakosh.sneha54', 'vvalduga', 'suyash.karle', 'milu21111994', 'takalesusmita', 'pranjali2610', 'ashishtonge94', 'cyberclan.xd', 'snehavardhini', 'mewadayash', 'nishanth1101', 'salil.vaidya', 'shashwatssanghavi', 'nitiiinbaranwal', 'divyapawar39', 'naren.ambwani', 'seemamishra', 'trupti.vaity19', 'zak1010', 'niharikasarode', 'vj280395', 'dlaxmanc59', 'narenambwani04', 'roberto.orio', 'ghosh.arjun97', 'savitashetty111', 'rautsayli10', 'lokhanderaj55', 'singhchetna01', 'gurnani.nikita999', 'yamkarki', 'arsh.raina', 'preeti.suryawanshi', 'desaimaanil2', 'pritidhandrut25', 'vinu.sunny1994.vs', 'ranji7685', 'shubhampnkr', 'kaushik_gaikwad', 'aka_jadhav', 'nishant.joshi42', 'abhishek291', 'sumaiyya.kazi94', 'muktat20', 'basher00992', 'dakshata', 'govind9867129531', 'vijayaher0211', 'suraj348', 'karna1995.kj', 'sneha.kutal', 'maradiyadhaval92', 'thefreeliar18', 'somesh.kumar', 'ksurgade', 'sonali2', 'ascharyaskumar', 'deepuvijaya1806', 'ads_fission', 'pb9298', 'ibrahimarif950', 'shrimohite13', 'rajpareshshah14', 'qwdf29', 'mrinalini20.shah', 'shraddha0306', 'darpan.bagwale', 'aamod1996', 'gokisush9', 'anirudh2442', 'greatabhi.jathar', 'kanchipoddar', 'syadav05', 'ranjanjadhav1234', 'rutuja1122', 'vejalporia1994', 'mannapatil', 'kiran.pawar1611', 'anirudh0000', 'tawadesiddhesh1994', 'priyankajamdade23', 'sapnabhandary31', 'saurabhmangeshkar', 'zalakdodecha', 'arunimavarma20', 'aayushjain27894', 'nikhiljadhav.jadhav40', 'sapte01', 'ranju.raj18', 'chisimeybijimchigmomin', 'priyanka.kulkarni', 'rutu.balure', 'prajaktasjoshi911', 'devendrashinde1995', 'dubalprasad04', 'omkar.bane13', 'kalpeshshukla11', 'sumitkarmokar', 'nshambhuraje', 'parabmahadev34', 'prasadchachad20', 'shashanksingh4000', 'prathmeshgurunathparab', 'kanchangorde15', 'anetha123', 'akshaykshitija', 'sj.shruti95', 'chintanrlimbani', 'rwaghela51', 'abhijeetchavan', 'ashijadhav20', 'ajinkyapadwad', 'swapneil.hirulkar', 'paresh761', 'udayanyarya', 'dung_master24', 'shreyasnaravane', 'umang.parekh30', 'ambicavenkatesh2009', 'rajkumar.kalantri', 'mananmehta95', 'kuldeeppatil201093', 'ajinkyamhatre', 'shreenathdalvi1994', 'amoghmorye', 'pankajsalunkhe23', 'amitmadgi15', 'smackthatjohn', 'sanika.pandharkar', 'omkar12345', 'rohanshah611', 'amol.dhanvij10', 'akshaysharma', 'mayur.agarwadekar', 'jmen1993', 'manishakolekar1994', 'sagarbisen50', 'pralim', 'sharvaridalvi301', 'sayli.shevade', 'akajadhav1', 'rgole02', 'thoravekalpesh', 'vaibhavvadia', 'asudha', 'sushmakodagali', None, 'rohanbandal93', 'jharupesh440', 'aj.shahare', 'palashmak067', 'roshninilam', 'ruchita9523', 'abhishek.singh', 'ryadav03', 'inderjitsingh87', 'mns.dinu', 'gharat789', 'ssatam23dps']"
1,46,196,16,4,"['umang.parekh30', 'vaibhavvadia', 'aamod1996', 'mananmehta95']",192,"['t0rse95', 'vivianmascarenhas1994', 'shashankrane12', 'priyanka.chavan.s.pc', 'nimita.singh', 'vesitd16b', 'sshelar01', 'aksh1995', 'rohan21', 'sarprashasti21', 'patelmeeti1995', 'gaikar.shubhada888', 'g.s.siddhant', 'patilmonika681', 'kedarthale', 'smsayali79', 'tejomayi.wandhile', 'ameysv22', 'devanandkb', 'mrhbtiwari', 'bhujangmethe', 'yrsarvankar', 'chinmayhejmadi', 'raghu.shirodkar', 'heenal0708', 'sanjay.devan.ranstad', 'reubenalexander2010', 'barnik_1993', 'ashwinnumbrat94', 'dishantmehta1993', 'satya_mishra', 'pranjali.borkar', 'richard.noronha', 'jadhavadhiraj', 'pratikkavale11', 'spawar10', 'architagoyal', 'abhishek.shinde', 'rakeshchrs87', 'harshada.patankar', 'karan.dhareshwar', 'smhatre08', 'dalviakshata12', 'deepashrisane2203', 'mayurgaikwad1293', 'sharan.raikhangar', 'devang19.shah', 'dj.dharmik', 'pritish.das', 'gajakosh.sneha54', 'vvalduga', 'suyash.karle', 'milu21111994', 'takalesusmita', 'pranjali2610', 'ashishtonge94', 'cyberclan.xd', 'snehavardhini', 'mewadayash', 'nishanth1101', 'salil.vaidya', 'shashwatssanghavi', 'nitiiinbaranwal', 'divyapawar39', 'naren.ambwani', 'seemamishra', 'trupti.vaity19', 'zak1010', 'niharikasarode', 'vj280395', 'dlaxmanc59', 'narenambwani04', 'roberto.orio', 'ghosh.arjun97', 'savitashetty111', 'rautsayli10', 'lokhanderaj55', 'gurnani.nikita999', 'yamkarki', 'arsh.raina', 'preeti.suryawanshi', 'desaimaanil2', 'pritidhandrut25', 'vinu.sunny1994.vs', 'ranji7685', 'shubhampnkr', 'kaushik_gaikwad', 'aka_jadhav', 'nishant.joshi42', 'abhishek291', 'sumaiyya.kazi94', 'muktat20', 'dakshata', 'govind9867129531', 'vijayaher0211', 'suraj348', 'karna1995.kj', 'sneha.kutal', 'maradiyadhaval92', 'thefreeliar18', 'somesh.kumar', 'ksurgade', 'sonali2', 'ascharyaskumar', 'deepuvijaya1806', 'ads_fission', 'ibrahimarif950', 'shrimohite13', 'rajpareshshah14', 'qwdf29', 'mrinalini20.shah', 'darpan.bagwale', 'gokisush9', 'anirudh2442', 'greatabhi.jathar', 'kanchipoddar', 'syadav05', 'ranjanjadhav1234', 'rutuja1122', 'vejalporia1994', 'mannapatil', 'kiran.pawar1611', 'anirudh0000', 'tawadesiddhesh1994', 'priyankajamdade23', 'sapnabhandary31', 'saurabhmangeshkar', 'zalakdodecha', 'arunimavarma20', 'aayushjain27894', 'nikhiljadhav.jadhav40', 'sapte01', 'ranju.raj18', 'chisimeybijimchigmomin', 'priyanka.kulkarni', 'prajaktasjoshi911', 'devendrashinde1995', 'dubalprasad04', 'omkar.bane13', 'kalpeshshukla11', 'sumitkarmokar', 'nshambhuraje', 'parabmahadev34', 'prasadchachad20', 'shashanksingh4000', 'prathmeshgurunathparab', 'sj.shruti95', 'chintanrlimbani', 'rwaghela51', 'abhijeetchavan', 'ashijadhav20', 'ajinkyapadwad', 'swapneil.hirulkar', 'paresh761', 'udayanyarya', 'dung_master24', 'shreyasnaravane', 'ambicavenkatesh2009', 'rajkumar.kalantri', 'kuldeeppatil201093', 'shreenathdalvi1994', 'amoghmorye', 'pankajsalunkhe23', 'amitmadgi15', 'smackthatjohn', 'sanika.pandharkar', 'omkar12345', 'rohanshah611', 'amol.dhanvij10', 'akshaysharma', 'mayur.agarwadekar', 'jmen1993', 'manishakolekar1994', 'sagarbisen50', 'pralim', 'sharvaridalvi301', 'sayli.shevade', 'akajadhav1', 'rgole02', 'thoravekalpesh', 'asudha', 'rohanbandal93', 'jharupesh440', 'aj.shahare', 'palashmak067', 'roshninilam', 'ruchita9523', 'abhishek.singh', 'ryadav03', 'mns.dinu', 'gharat789', 'ssatam23dps']",12,"['riteshrajput381', 'helloworld1', 'tzatakia', 'vora.jai1', 'geetgandhi96', 'mayureshvartak30', 'kothari.dhruvin.dk', 'sankheneel', 'vishwanathan.anirudh', 'harshvardhandave1112', None, 'djeskay27']",208,"['t0rse95', 'vivianmascarenhas1994', 'shashankrane12', 'priyanka.chavan.s.pc', 'nimita.singh', 'vesitd16b', 'sshelar01', 'aksh1995', 'rohan21', 'sarprashasti21', 'patelmeeti1995', 'gaikar.shubhada888', 'g.s.siddhant', 'patilmonika681', 'kedarthale', 'smsayali79', 'tejomayi.wandhile', 'ameysv22', 'devanandkb', 'mrhbtiwari', 'bhujangmethe', 'yrsarvankar', 'chinmayhejmadi', 'raghu.shirodkar', 'heenal0708', 'sanjay.devan.ranstad', 'reubenalexander2010', 'barnik_1993', 'ashwinnumbrat94', 'dishantmehta1993', 'satya_mishra', 'pranjali.borkar', 'richard.noronha', 'jadhavadhiraj', 'pratikkavale11', 'spawar10', 'harshvardhandave1112', 'vora.jai1', 'architagoyal', 'riteshrajput381', 'abhishek.shinde', 'rakeshchrs87', 'harshada.patankar', 'karan.dhareshwar', 'smhatre08', 'dalviakshata12', 'deepashrisane2203', 'mayurgaikwad1293', 'sharan.raikhangar', 'devang19.shah', 'dj.dharmik', 'pritish.das', 'gajakosh.sneha54', 'vvalduga', 'suyash.karle', 'milu21111994', 'takalesusmita', 'pranjali2610', 'ashishtonge94', 'cyberclan.xd', 'snehavardhini', 'mewadayash', 'nishanth1101', 'salil.vaidya', 'shashwatssanghavi', 'nitiiinbaranwal', 'divyapawar39', 'naren.ambwani', 'seemamishra', 'trupti.vaity19', 'zak1010', 'niharikasarode', 'vj280395', 'dlaxmanc59', 'narenambwani04', 'roberto.orio', 'ghosh.arjun97', 'savitashetty111', 'rautsayli10', 'lokhanderaj55', 'geetgandhi96', 'gurnani.nikita999', 'yamkarki', 'arsh.raina', 'preeti.suryawanshi', 'desaimaanil2', 'pritidhandrut25', 'vinu.sunny1994.vs', 'ranji7685', 'shubhampnkr', 'kaushik_gaikwad', 'aka_jadhav', 'nishant.joshi42', 'abhishek291', 'sumaiyya.kazi94', 'muktat20', 'dakshata', 'govind9867129531', 'vijayaher0211', 'suraj348', 'karna1995.kj', 'sneha.kutal', 'maradiyadhaval92', 'thefreeliar18', 'somesh.kumar', 'ksurgade', 'sonali2', 'ascharyaskumar', 'deepuvijaya1806', 'ads_fission', 'mayureshvartak30', 'ibrahimarif950', 'shrimohite13', 'rajpareshshah14', 'qwdf29', 'vishwanathan.anirudh', 'mrinalini20.shah', 'darpan.bagwale', 'aamod1996', 'gokisush9', 'anirudh2442', 'greatabhi.jathar', 'kanchipoddar', 'syadav05', 'ranjanjadhav1234', 'rutuja1122', 'vejalporia1994', 'mannapatil', 'sankheneel', 'kiran.pawar1611', 'anirudh0000', 'tawadesiddhesh1994', 'priyankajamdade23', 'sapnabhandary31', 'saurabhmangeshkar', 'zalakdodecha', 'arunimavarma20', 'aayushjain27894', 'nikhiljadhav.jadhav40', 'sapte01', 'ranju.raj18', 'chisimeybijimchigmomin', 'priyanka.kulkarni', 'prajaktasjoshi911', 'kothari.dhruvin.dk', 'devendrashinde1995', 'dubalprasad04', 'omkar.bane13', 'kalpeshshukla11', 'sumitkarmokar', 'djeskay27', 'nshambhuraje', 'parabmahadev34', 'prasadchachad20', 'shashanksingh4000', 'prathmeshgurunathparab', 'sj.shruti95', 'chintanrlimbani', 'rwaghela51', 'abhijeetchavan', 'tzatakia', 'ashijadhav20', 'ajinkyapadwad', 'swapneil.hirulkar', 'paresh761', 'udayanyarya', 'dung_master24', 'shreyasnaravane', 'umang.parekh30', 'ambicavenkatesh2009', 'rajkumar.kalantri', 'mananmehta95', 'kuldeeppatil201093', 'shreenathdalvi1994', 'amoghmorye', 'pankajsalunkhe23', 'amitmadgi15', 'smackthatjohn', 'sanika.pandharkar', 'omkar12345', 'rohanshah611', 'amol.dhanvij10', 'akshaysharma', 'mayur.agarwadekar', 'jmen1993', 'manishakolekar1994', 'sagarbisen50', 'pralim', 'sharvaridalvi301', 'sayli.shevade', 'akajadhav1', 'helloworld1', 'rgole02', 'thoravekalpesh', 'vaibhavvadia', 'asudha', None, 'rohanbandal93', 'jharupesh440', 'aj.shahare', 'palashmak067', 'roshninilam', 'ruchita9523', 'abhishek.singh', 'ryadav03', 'mns.dinu', 'gharat789', 'ssatam23dps']"
1,43,196,12,5,"['bhujangmethe', 'ashishtonge94', 'ajinkyapadwad', 'mayur.agarwadekar', 'yrsarvankar']",191,"['t0rse95', 'vivianmascarenhas1994', 'shashankrane12', 'priyanka.chavan.s.pc', 'nimita.singh', 'vesitd16b', 'sshelar01', 'aksh1995', 'rohan21', 'sarprashasti21', 'patelmeeti1995', 'gaikar.shubhada888', 'g.s.siddhant', 'patilmonika681', 'kedarthale', 'smsayali79', 'tejomayi.wandhile', 'ameysv22', 'devanandkb', 'mrhbtiwari', 'chinmayhejmadi', 'raghu.shirodkar', 'heenal0708', 'sanjay.devan.ranstad', 'reubenalexander2010', 'barnik_1993', 'ashwinnumbrat94', 'dishantmehta1993', 'satya_mishra', 'pranjali.borkar', 'richard.noronha', 'jadhavadhiraj', 'pratikkavale11', 'spawar10', 'architagoyal', 'abhishek.shinde', 'rakeshchrs87', 'harshada.patankar', 'karan.dhareshwar', 'smhatre08', 'dalviakshata12', 'deepashrisane2203', 'mayurgaikwad1293', 'sharan.raikhangar', 'devang19.shah', 'dj.dharmik', 'pritish.das', 'gajakosh.sneha54', 'vvalduga', 'suyash.karle', 'milu21111994', 'takalesusmita', 'pranjali2610', 'cyberclan.xd', 'snehavardhini', 'mewadayash', 'nishanth1101', 'salil.vaidya', 'shashwatssanghavi', 'nitiiinbaranwal', 'divyapawar39', 'naren.ambwani', 'seemamishra', 'trupti.vaity19', 'zak1010', 'niharikasarode', 'vj280395', 'dlaxmanc59', 'narenambwani04', 'roberto.orio', 'ghosh.arjun97', 'savitashetty111', 'rautsayli10', 'lokhanderaj55', 'gurnani.nikita999', 'yamkarki', 'arsh.raina', 'preeti.suryawanshi', 'desaimaanil2', 'pritidhandrut25', 'vinu.sunny1994.vs', 'ranji7685', 'shubhampnkr', 'kaushik_gaikwad', 'aka_jadhav', 'nishant.joshi42', 'abhishek291', 'sumaiyya.kazi94', 'muktat20', 'dakshata', 'govind9867129531', 'vijayaher0211', 'suraj348', 'karna1995.kj', 'sneha.kutal', 'maradiyadhaval92', 'thefreeliar18', 'somesh.kumar', 'ksurgade', 'sonali2', 'ascharyaskumar', 'deepuvijaya1806', 'ads_fission', 'ibrahimarif950', 'shrimohite13', 'rajpareshshah14', 'qwdf29', 'mrinalini20.shah', 'darpan.bagwale', 'aamod1996', 'gokisush9', 'anirudh2442', 'greatabhi.jathar', 'kanchipoddar', 'syadav05', 'ranjanjadhav1234', 'rutuja1122', 'vejalporia1994', 'mannapatil', 'kiran.pawar1611', 'anirudh0000', 'tawadesiddhesh1994', 'priyankajamdade23', 'sapnabhandary31', 'saurabhmangeshkar', 'zalakdodecha', 'arunimavarma20', 'aayushjain27894', 'nikhiljadhav.jadhav40', 'sapte01', 'ranju.raj18', 'chisimeybijimchigmomin', 'priyanka.kulkarni', 'prajaktasjoshi911', 'devendrashinde1995', 'dubalprasad04', 'omkar.bane13', 'kalpeshshukla11', 'sumitkarmokar', 'nshambhuraje', 'parabmahadev34', 'prasadchachad20', 'shashanksingh4000', 'prathmeshgurunathparab', 'sj.shruti95', 'chintanrlimbani', 'rwaghela51', 'abhijeetchavan', 'ashijadhav20', 'swapneil.hirulkar', 'paresh761', 'udayanyarya', 'dung_master24', 'shreyasnaravane', 'umang.parekh30', 'ambicavenkatesh2009', 'rajkumar.kalantri', 'mananmehta95', 'kuldeeppatil201093', 'shreenathdalvi1994', 'amoghmorye', 'pankajsalunkhe23', 'amitmadgi15', 'smackthatjohn', 'sanika.pandharkar', 'omkar12345', 'rohanshah611', 'amol.dhanvij10', 'akshaysharma', 'jmen1993', 'manishakolekar1994', 'sagarbisen50', 'pralim', 'sharvaridalvi301', 'sayli.shevade', 'akajadhav1', 'rgole02', 'thoravekalpesh', 'vaibhavvadia', 'asudha', 'rohanbandal93', 'jharupesh440', 'aj.shahare', 'palashmak067', 'roshninilam', 'ruchita9523', 'abhishek.singh', 'ryadav03', 'mns.dinu', 'gharat789', 'ssatam23dps']",7,"['ishmeetsingh', 'aishhhh', 'kalyani.aye93', 'pushkarvaity', None, 'juvika1994', 'isaurabhbhirud7']",203,"['t0rse95', 'vivianmascarenhas1994', 'shashankrane12', 'priyanka.chavan.s.pc', 'nimita.singh', 'vesitd16b', 'sshelar01', 'aksh1995', 'rohan21', 'sarprashasti21', 'patelmeeti1995', 'gaikar.shubhada888', 'g.s.siddhant', 'patilmonika681', 'kedarthale', 'smsayali79', 'tejomayi.wandhile', 'ameysv22', 'devanandkb', 'mrhbtiwari', 'bhujangmethe', 'yrsarvankar', 'chinmayhejmadi', 'raghu.shirodkar', 'heenal0708', 'sanjay.devan.ranstad', 'reubenalexander2010', 'barnik_1993', 'ashwinnumbrat94', 'dishantmehta1993', 'satya_mishra', 'pranjali.borkar', 'richard.noronha', 'jadhavadhiraj', 'pratikkavale11', 'spawar10', 'architagoyal', 'abhishek.shinde', 'rakeshchrs87', 'harshada.patankar', 'karan.dhareshwar', 'smhatre08', 'dalviakshata12', 'deepashrisane2203', 'mayurgaikwad1293', 'sharan.raikhangar', 'devang19.shah', 'dj.dharmik', 'pritish.das', 'gajakosh.sneha54', 'vvalduga', 'suyash.karle', 'milu21111994', 'takalesusmita', 'pranjali2610', 'ashishtonge94', 'cyberclan.xd', 'snehavardhini', 'mewadayash', 'nishanth1101', 'salil.vaidya', 'shashwatssanghavi', 'nitiiinbaranwal', 'divyapawar39', 'naren.ambwani', 'seemamishra', 'trupti.vaity19', 'zak1010', 'niharikasarode', 'vj280395', 'dlaxmanc59', 'narenambwani04', 'roberto.orio', 'ghosh.arjun97', 'savitashetty111', 'rautsayli10', 'lokhanderaj55', 'gurnani.nikita999', 'yamkarki', 'arsh.raina', 'preeti.suryawanshi', 'desaimaanil2', 'pritidhandrut25', 'vinu.sunny1994.vs', 'ranji7685', 'shubhampnkr', 'kaushik_gaikwad', 'aka_jadhav', 'nishant.joshi42', 'abhishek291', 'sumaiyya.kazi94', 'muktat20', 'dakshata', 'govind9867129531', 'vijayaher0211', 'suraj348', 'karna1995.kj', 'sneha.kutal', 'maradiyadhaval92', 'thefreeliar18', 'somesh.kumar', 'ksurgade', 'sonali2', 'ascharyaskumar', 'deepuvijaya1806', 'ads_fission', 'ibrahimarif950', 'shrimohite13', 'rajpareshshah14', 'qwdf29', 'juvika1994', 'mrinalini20.shah', 'darpan.bagwale', 'aishhhh', 'aamod1996', 'gokisush9', 'anirudh2442', 'greatabhi.jathar', 'kalyani.aye93', 'kanchipoddar', 'syadav05', 'ranjanjadhav1234', 'rutuja1122', 'vejalporia1994', 'mannapatil', 'kiran.pawar1611', 'anirudh0000', 'tawadesiddhesh1994', 'priyankajamdade23', 'sapnabhandary31', 'saurabhmangeshkar', 'zalakdodecha', 'arunimavarma20', 'aayushjain27894', 'nikhiljadhav.jadhav40', 'sapte01', 'ranju.raj18', 'chisimeybijimchigmomin', 'priyanka.kulkarni', 'prajaktasjoshi911', 'devendrashinde1995', 'dubalprasad04', 'omkar.bane13', 'kalpeshshukla11', 'sumitkarmokar', 'nshambhuraje', 'parabmahadev34', 'prasadchachad20', 'shashanksingh4000', 'prathmeshgurunathparab', 'sj.shruti95', 'chintanrlimbani', 'rwaghela51', 'abhijeetchavan', 'ashijadhav20', 'ajinkyapadwad', 'swapneil.hirulkar', 'paresh761', 'udayanyarya', 'dung_master24', 'shreyasnaravane', 'umang.parekh30', 'ambicavenkatesh2009', 'rajkumar.kalantri', 'mananmehta95', 'kuldeeppatil201093', 'shreenathdalvi1994', 'amoghmorye', 'pankajsalunkhe23', 'amitmadgi15', 'smackthatjohn', 'sanika.pandharkar', 'omkar12345', 'rohanshah611', 'amol.dhanvij10', 'akshaysharma', 'mayur.agarwadekar', 'jmen1993', 'manishakolekar1994', 'sagarbisen50', 'pralim', 'sharvaridalvi301', 'sayli.shevade', 'akajadhav1', 'ishmeetsingh', 'rgole02', 'thoravekalpesh', 'vaibhavvadia', 'asudha', 'isaurabhbhirud7', 'rohanbandal93', None, 'jharupesh440', 'aj.shahare', 'palashmak067', 'pushkarvaity', 'roshninilam', 'ruchita9523', 'abhishek.singh', 'ryadav03', 'mns.dinu', 'gharat789', 'ssatam23dps']"
1,44,196,8,2,"['rohan21', 'abhijeetchavan']",194,"['t0rse95', 'vivianmascarenhas1994', 'shashankrane12', 'priyanka.chavan.s.pc', 'nimita.singh', 'vesitd16b', 'sshelar01', 'aksh1995', 'sarprashasti21', 'patelmeeti1995', 'gaikar.shubhada888', 'g.s.siddhant', 'patilmonika681', 'kedarthale', 'smsayali79', 'tejomayi.wandhile', 'ameysv22', 'devanandkb', 'mrhbtiwari', 'bhujangmethe', 'yrsarvankar', 'chinmayhejmadi', 'raghu.shirodkar', 'heenal0708', 'sanjay.devan.ranstad', 'reubenalexander2010', 'barnik_1993', 'ashwinnumbrat94', 'dishantmehta1993', 'satya_mishra', 'pranjali.borkar', 'richard.noronha', 'jadhavadhiraj', 'pratikkavale11', 'spawar10', 'architagoyal', 'abhishek.shinde', 'rakeshchrs87', 'harshada.patankar', 'karan.dhareshwar', 'smhatre08', 'dalviakshata12', 'deepashrisane2203', 'mayurgaikwad1293', 'sharan.raikhangar', 'devang19.shah', 'dj.dharmik', 'pritish.das', 'gajakosh.sneha54', 'vvalduga', 'suyash.karle', 'milu21111994', 'takalesusmita', 'pranjali2610', 'ashishtonge94', 'cyberclan.xd', 'snehavardhini', 'mewadayash', 'nishanth1101', 'salil.vaidya', 'shashwatssanghavi', 'nitiiinbaranwal', 'divyapawar39', 'naren.ambwani', 'seemamishra', 'trupti.vaity19', 'zak1010', 'niharikasarode', 'vj280395', 'dlaxmanc59', 'narenambwani04', 'roberto.orio', 'ghosh.arjun97', 'savitashetty111', 'rautsayli10', 'lokhanderaj55', 'gurnani.nikita999', 'yamkarki', 'arsh.raina', 'preeti.suryawanshi', 'desaimaanil2', 'pritidhandrut25', 'vinu.sunny1994.vs', 'ranji7685', 'shubhampnkr', 'kaushik_gaikwad', 'aka_jadhav', 'nishant.joshi42', 'abhishek291', 'sumaiyya.kazi94', 'muktat20', 'dakshata', 'govind9867129531', 'vijayaher0211', 'suraj348', 'karna1995.kj', 'sneha.kutal', 'maradiyadhaval92', 'thefreeliar18', 'somesh.kumar', 'ksurgade', 'sonali2', 'ascharyaskumar', 'deepuvijaya1806', 'ads_fission', 'ibrahimarif950', 'shrimohite13', 'rajpareshshah14', 'qwdf29', 'mrinalini20.shah', 'darpan.bagwale', 'aamod1996', 'gokisush9', 'anirudh2442', 'greatabhi.jathar', 'kanchipoddar', 'syadav05', 'ranjanjadhav1234', 'rutuja1122', 'vejalporia1994', 'mannapatil', 'kiran.pawar1611', 'anirudh0000', 'tawadesiddhesh1994', 'priyankajamdade23', 'sapnabhandary31', 'saurabhmangeshkar', 'zalakdodecha', 'arunimavarma20', 'aayushjain27894', 'nikhiljadhav.jadhav40', 'sapte01', 'ranju.raj18', 'chisimeybijimchigmomin', 'priyanka.kulkarni', 'prajaktasjoshi911', 'devendrashinde1995', 'dubalprasad04', 'omkar.bane13', 'kalpeshshukla11', 'sumitkarmokar', 'nshambhuraje', 'parabmahadev34', 'prasadchachad20', 'shashanksingh4000', 'prathmeshgurunathparab', 'sj.shruti95', 'chintanrlimbani', 'rwaghela51', 'ashijadhav20', 'ajinkyapadwad', 'swapneil.hirulkar', 'paresh761', 'udayanyarya', 'dung_master24', 'shreyasnaravane', 'umang.parekh30', 'ambicavenkatesh2009', 'rajkumar.kalantri', 'mananmehta95', 'kuldeeppatil201093', 'shreenathdalvi1994', 'amoghmorye', 'pankajsalunkhe23', 'amitmadgi15', 'smackthatjohn', 'sanika.pandharkar', 'omkar12345', 'rohanshah611', 'amol.dhanvij10', 'akshaysharma', 'mayur.agarwadekar', 'jmen1993', 'manishakolekar1994', 'sagarbisen50', 'pralim', 'sharvaridalvi301', 'sayli.shevade', 'akajadhav1', 'rgole02', 'thoravekalpesh', 'vaibhavvadia', 'asudha', 'rohanbandal93', 'jharupesh440', 'aj.shahare', 'palashmak067', 'roshninilam', 'ruchita9523', 'abhishek.singh', 'ryadav03', 'mns.dinu', 'gharat789', 'ssatam23dps']",6,"['azazeljam', 'doshipayal1996', 'narkheden', 'shubham.lunawat', 'vandortshakti', None]",202,"['t0rse95', 'vivianmascarenhas1994', 'shashankrane12', 'doshipayal1996', 'priyanka.chavan.s.pc', 'nimita.singh', 'shubham.lunawat', 'vesitd16b', 'sshelar01', 'aksh1995', 'rohan21', 'sarprashasti21', 'patelmeeti1995', 'gaikar.shubhada888', 'g.s.siddhant', 'patilmonika681', 'kedarthale', 'smsayali79', 'tejomayi.wandhile', 'ameysv22', 'devanandkb', 'mrhbtiwari', 'bhujangmethe', 'yrsarvankar', 'chinmayhejmadi', 'raghu.shirodkar', 'heenal0708', 'sanjay.devan.ranstad', 'reubenalexander2010', 'barnik_1993', 'ashwinnumbrat94', 'dishantmehta1993', 'satya_mishra', 'pranjali.borkar', 'richard.noronha', 'jadhavadhiraj', 'pratikkavale11', 'spawar10', 'architagoyal', 'abhishek.shinde', 'azazeljam', 'rakeshchrs87', 'harshada.patankar', 'karan.dhareshwar', 'smhatre08', 'dalviakshata12', 'deepashrisane2203', 'mayurgaikwad1293', 'sharan.raikhangar', 'vandortshakti', 'devang19.shah', 'dj.dharmik', 'pritish.das', 'gajakosh.sneha54', 'vvalduga', 'suyash.karle', 'milu21111994', 'takalesusmita', 'pranjali2610', 'ashishtonge94', 'cyberclan.xd', 'snehavardhini', 'mewadayash', 'nishanth1101', 'salil.vaidya', 'shashwatssanghavi', 'nitiiinbaranwal', 'divyapawar39', 'naren.ambwani', 'seemamishra', 'trupti.vaity19', 'zak1010', 'niharikasarode', 'vj280395', 'dlaxmanc59', 'narenambwani04', 'roberto.orio', 'ghosh.arjun97', 'savitashetty111', 'rautsayli10', 'lokhanderaj55', 'gurnani.nikita999', 'yamkarki', 'arsh.raina', 'preeti.suryawanshi', 'desaimaanil2', 'pritidhandrut25', 'vinu.sunny1994.vs', 'ranji7685', 'shubhampnkr', 'kaushik_gaikwad', 'aka_jadhav', 'nishant.joshi42', 'abhishek291', 'sumaiyya.kazi94', 'muktat20', 'dakshata', 'govind9867129531', 'vijayaher0211', 'suraj348', 'karna1995.kj', 'sneha.kutal', 'maradiyadhaval92', 'thefreeliar18', 'somesh.kumar', 'ksurgade', 'sonali2', 'ascharyaskumar', 'deepuvijaya1806', 'ads_fission', 'ibrahimarif950', 'shrimohite13', 'rajpareshshah14', 'qwdf29', 'mrinalini20.shah', 'darpan.bagwale', 'aamod1996', 'gokisush9', 'anirudh2442', 'greatabhi.jathar', 'kanchipoddar', 'syadav05', 'ranjanjadhav1234', 'rutuja1122', 'vejalporia1994', 'mannapatil', 'kiran.pawar1611', 'anirudh0000', 'tawadesiddhesh1994', 'priyankajamdade23', 'sapnabhandary31', 'saurabhmangeshkar', 'zalakdodecha', 'arunimavarma20', 'aayushjain27894', 'nikhiljadhav.jadhav40', 'sapte01', 'ranju.raj18', 'chisimeybijimchigmomin', 'priyanka.kulkarni', 'prajaktasjoshi911', 'devendrashinde1995', 'dubalprasad04', 'omkar.bane13', 'kalpeshshukla11', 'sumitkarmokar', 'nshambhuraje', 'parabmahadev34', 'prasadchachad20', 'shashanksingh4000', 'prathmeshgurunathparab', 'sj.shruti95', 'chintanrlimbani', 'rwaghela51', 'abhijeetchavan', 'narkheden', 'ashijadhav20', 'ajinkyapadwad', 'swapneil.hirulkar', 'paresh761', 'udayanyarya', 'dung_master24', 'shreyasnaravane', 'umang.parekh30', 'ambicavenkatesh2009', 'rajkumar.kalantri', 'mananmehta95', 'kuldeeppatil201093', 'shreenathdalvi1994', 'amoghmorye', 'pankajsalunkhe23', 'amitmadgi15', 'smackthatjohn', 'sanika.pandharkar', 'omkar12345', 'rohanshah611', 'amol.dhanvij10', 'akshaysharma', 'mayur.agarwadekar', 'jmen1993', 'manishakolekar1994', 'sagarbisen50', 'pralim', 'sharvaridalvi301', 'sayli.shevade', 'akajadhav1', 'rgole02', 'thoravekalpesh', 'vaibhavvadia', 'asudha', None, 'rohanbandal93', 'jharupesh440', 'aj.shahare', 'palashmak067', 'roshninilam', 'ruchita9523', 'abhishek.singh', 'ryadav03', 'mns.dinu', 'gharat789', 'ssatam23dps']"
1,208,196,8,3,"['desaimaanil2', 'chinmayhejmadi', 'mananmehta95']",193,"['t0rse95', 'vivianmascarenhas1994', 'shashankrane12', 'priyanka.chavan.s.pc', 'nimita.singh', 'vesitd16b', 'sshelar01', 'aksh1995', 'rohan21', 'sarprashasti21', 'patelmeeti1995', 'gaikar.shubhada888', 'g.s.siddhant', 'patilmonika681', 'kedarthale', 'smsayali79', 'tejomayi.wandhile', 'ameysv22', 'devanandkb', 'mrhbtiwari', 'bhujangmethe', 'yrsarvankar', 'raghu.shirodkar', 'heenal0708', 'sanjay.devan.ranstad', 'reubenalexander2010', 'barnik_1993', 'ashwinnumbrat94', 'dishantmehta1993', 'satya_mishra', 'pranjali.borkar', 'richard.noronha', 'jadhavadhiraj', 'pratikkavale11', 'spawar10', 'architagoyal', 'abhishek.shinde', 'rakeshchrs87', 'harshada.patankar', 'karan.dhareshwar', 'smhatre08', 'dalviakshata12', 'deepashrisane2203', 'mayurgaikwad1293', 'sharan.raikhangar', 'devang19.shah', 'dj.dharmik', 'pritish.das', 'gajakosh.sneha54', 'vvalduga', 'suyash.karle', 'milu21111994', 'takalesusmita', 'pranjali2610', 'ashishtonge94', 'cyberclan.xd', 'snehavardhini', 'mewadayash', 'nishanth1101', 'salil.vaidya', 'shashwatssanghavi', 'nitiiinbaranwal', 'divyapawar39', 'naren.ambwani', 'seemamishra', 'trupti.vaity19', 'zak1010', 'niharikasarode', 'vj280395', 'dlaxmanc59', 'narenambwani04', 'roberto.orio', 'ghosh.arjun97', 'savitashetty111', 'rautsayli10', 'lokhanderaj55', 'gurnani.nikita999', 'yamkarki', 'arsh.raina', 'preeti.suryawanshi', 'pritidhandrut25', 'vinu.sunny1994.vs', 'ranji7685', 'shubhampnkr', 'kaushik_gaikwad', 'aka_jadhav', 'nishant.joshi42', 'abhishek291', 'sumaiyya.kazi94', 'muktat20', 'dakshata', 'govind9867129531', 'vijayaher0211', 'suraj348', 'karna1995.kj', 'sneha.kutal', 'maradiyadhaval92', 'thefreeliar18', 'somesh.kumar', 'ksurgade', 'sonali2', 'ascharyaskumar', 'deepuvijaya1806', 'ads_fission', 'ibrahimarif950', 'shrimohite13', 'rajpareshshah14', 'qwdf29', 'mrinalini20.shah', 'darpan.bagwale', 'aamod1996', 'gokisush9', 'anirudh2442', 'greatabhi.jathar', 'kanchipoddar', 'syadav05', 'ranjanjadhav1234', 'rutuja1122', 'vejalporia1994', 'mannapatil', 'kiran.pawar1611', 'anirudh0000', 'tawadesiddhesh1994', 'priyankajamdade23', 'sapnabhandary31', 'saurabhmangeshkar', 'zalakdodecha', 'arunimavarma20', 'aayushjain27894', 'nikhiljadhav.jadhav40', 'sapte01', 'ranju.raj18', 'chisimeybijimchigmomin', 'priyanka.kulkarni', 'prajaktasjoshi911', 'devendrashinde1995', 'dubalprasad04', 'omkar.bane13', 'kalpeshshukla11', 'sumitkarmokar', 'nshambhuraje', 'parabmahadev34', 'prasadchachad20', 'shashanksingh4000', 'prathmeshgurunathparab', 'sj.shruti95', 'chintanrlimbani', 'rwaghela51', 'abhijeetchavan', 'ashijadhav20', 'ajinkyapadwad', 'swapneil.hirulkar', 'paresh761', 'udayanyarya', 'dung_master24', 'shreyasnaravane', 'umang.parekh30', 'ambicavenkatesh2009', 'rajkumar.kalantri', 'kuldeeppatil201093', 'shreenathdalvi1994', 'amoghmorye', 'pankajsalunkhe23', 'amitmadgi15', 'smackthatjohn', 'sanika.pandharkar', 'omkar12345', 'rohanshah611', 'amol.dhanvij10', 'akshaysharma', 'mayur.agarwadekar', 'jmen1993', 'manishakolekar1994', 'sagarbisen50', 'pralim', 'sharvaridalvi301', 'sayli.shevade', 'akajadhav1', 'rgole02', 'thoravekalpesh', 'vaibhavvadia', 'asudha', 'rohanbandal93', 'jharupesh440', 'aj.shahare', 'palashmak067', 'roshninilam', 'ruchita9523', 'abhishek.singh', 'ryadav03', 'mns.dinu', 'gharat789', 'ssatam23dps']",5,"['ramuamt', 'kothari.dhruvin.dk', 'redorchid029', None, 'ramjighatala7']",201,"['t0rse95', 'vivianmascarenhas1994', 'shashankrane12', 'priyanka.chavan.s.pc', 'nimita.singh', 'vesitd16b', 'sshelar01', 'aksh1995', 'rohan21', 'sarprashasti21', 'patelmeeti1995', 'gaikar.shubhada888', 'g.s.siddhant', 'patilmonika681', 'kedarthale', 'smsayali79', 'tejomayi.wandhile', 'ameysv22', 'devanandkb', 'mrhbtiwari', 'bhujangmethe', 'yrsarvankar', 'chinmayhejmadi', 'raghu.shirodkar', 'heenal0708', 'sanjay.devan.ranstad', 'reubenalexander2010', 'barnik_1993', 'ashwinnumbrat94', 'dishantmehta1993', 'satya_mishra', 'pranjali.borkar', 'richard.noronha', 'jadhavadhiraj', 'pratikkavale11', 'spawar10', 'architagoyal', 'abhishek.shinde', 'rakeshchrs87', 'harshada.patankar', 'karan.dhareshwar', 'smhatre08', 'dalviakshata12', 'deepashrisane2203', 'mayurgaikwad1293', 'sharan.raikhangar', 'devang19.shah', 'dj.dharmik', 'pritish.das', 'gajakosh.sneha54', 'vvalduga', 'suyash.karle', 'milu21111994', 'takalesusmita', 'pranjali2610', 'ashishtonge94', 'cyberclan.xd', 'snehavardhini', 'mewadayash', 'nishanth1101', 'salil.vaidya', 'shashwatssanghavi', 'nitiiinbaranwal', 'divyapawar39', 'naren.ambwani', 'seemamishra', 'trupti.vaity19', 'zak1010', 'niharikasarode', 'vj280395', 'dlaxmanc59', 'narenambwani04', 'roberto.orio', 'ghosh.arjun97', 'savitashetty111', 'rautsayli10', 'lokhanderaj55', 'gurnani.nikita999', 'yamkarki', 'arsh.raina', 'preeti.suryawanshi', 'desaimaanil2', 'pritidhandrut25', 'vinu.sunny1994.vs', 'ranji7685', 'shubhampnkr', 'kaushik_gaikwad', 'aka_jadhav', 'nishant.joshi42', 'abhishek291', 'sumaiyya.kazi94', 'muktat20', 'dakshata', 'govind9867129531', 'vijayaher0211', 'suraj348', 'karna1995.kj', 'sneha.kutal', 'maradiyadhaval92', 'thefreeliar18', 'somesh.kumar', 'ksurgade', 'sonali2', 'ascharyaskumar', 'deepuvijaya1806', 'ads_fission', 'ibrahimarif950', 'shrimohite13', 'rajpareshshah14', 'qwdf29', 'mrinalini20.shah', 'darpan.bagwale', 'aamod1996', 'gokisush9', 'anirudh2442', 'greatabhi.jathar', 'kanchipoddar', 'syadav05', 'ranjanjadhav1234', 'rutuja1122', 'vejalporia1994', 'mannapatil', 'kiran.pawar1611', 'anirudh0000', 'tawadesiddhesh1994', 'priyankajamdade23', 'sapnabhandary31', 'saurabhmangeshkar', 'zalakdodecha', 'arunimavarma20', 'aayushjain27894', 'nikhiljadhav.jadhav40', 'sapte01', 'ranju.raj18', 'chisimeybijimchigmomin', 'priyanka.kulkarni', 'prajaktasjoshi911', 'ramuamt', 'kothari.dhruvin.dk', 'devendrashinde1995', 'dubalprasad04', 'omkar.bane13', 'kalpeshshukla11', 'sumitkarmokar', 'nshambhuraje', 'parabmahadev34', 'prasadchachad20', 'shashanksingh4000', 'prathmeshgurunathparab', 'sj.shruti95', 'chintanrlimbani', 'rwaghela51', 'abhijeetchavan', 'ashijadhav20', 'ajinkyapadwad', 'swapneil.hirulkar', 'paresh761', 'udayanyarya', 'dung_master24', 'shreyasnaravane', 'umang.parekh30', 'ambicavenkatesh2009', 'rajkumar.kalantri', 'mananmehta95', 'kuldeeppatil201093', 'shreenathdalvi1994', 'amoghmorye', 'pankajsalunkhe23', 'amitmadgi15', 'smackthatjohn', 'sanika.pandharkar', 'omkar12345', 'rohanshah611', 'amol.dhanvij10', 'akshaysharma', 'mayur.agarwadekar', 'jmen1993', 'manishakolekar1994', 'sagarbisen50', 'pralim', 'sharvaridalvi301', 'sayli.shevade', 'akajadhav1', 'rgole02', 'thoravekalpesh', 'vaibhavvadia', 'asudha', 'redorchid029', None, 'rohanbandal93', 'jharupesh440', 'ramjighatala7', 'aj.shahare', 'palashmak067', 'roshninilam', 'ruchita9523', 'abhishek.singh', 'ryadav03', 'mns.dinu', 'gharat789', 'ssatam23dps']"
2,15,169,68,66,"['yosif_diaa', 'fady', 'nanohub168', 'ayahelmy_122', 'yolyana.zekry', 'dyaanasser2014', 'mido_2010_amr94', 'nohabassem93', 'caboelkady94', 'hisham', 'halim', 'ahmednaser7000', 'ossamakhalil60', 'k1l4ny', 'nourhan', 'elec.eng.heba', 'bishoy.medhat.elraheb', 'aa.maherr', 'karimosama1610', 'm_osama_asu', 'yugy_mody2010', 'mhassan090944', 'mahmoudyoussif95', 'engmahmoud', 'ahmed_gamal1401', 'bassantalhawary', 'elmohnds.terika', 'ahmedakram9393', 'zemo_22', 'marmar8250', 'kirollos_ernest', 'mennafarafero', 'm.fouad.allam', 'mh', 'noor333aldeen333alkfree', 'hassan_elzahar', '4omanko', 'mraafat', 'nourhanmohamed', 'shadyreda', 'hadeermansour242', 'mohabmagdyyoussef', 'nadayoussef795', 'rananader', 'mostafasabri466', 'mikel.24.hour', 'lamiselhady7', 'amrmeto', 'tarekali1000', 'amedo_emad', 'mina', 'mahmoudsaid471', 'bashabisho_94', 'ahmedyasso93', 'marwa.khaled.eng', 'reham.a.gad', 'yasserramadan940', 'waleedsmz94', 'hazem1', 'miro.marawan', 'ahmed_7000naser', 'noha1skeleton', 'wissamismailgp7', 'ahmedhossiny', 'ahmed94hamed', 'amr_m.attya']",102,"['jvanjari', 'ayaaa.f.a', 'noryhankotb12', 'ahmedelectricity1993y', 'omarkhaledh95', 'mora.sameh2009', 'anan_alaa_95', 'bondo2a31193', 'mina_sameh95', 'onedaymuer', 'muhammadatef100', 'aymanalaadin4', 'dondonetoiseau', 'mohmed_rf', 'wilhelm.piao.3', 'screem_love3', 'mohamed_adel6222', 'elfaramawytalaat', 'besesh55', 'saraalaa', 'mina_mwgs', 'ayamostafa978', 'hoda_morshed375', 'shamellotfy1966', 'flederico', 'mimo_tm17', 'nouranalmorshedy', 'reallyanyidwuddo', 'omar.abdulaziz94', 'nadowafa20', 'sh900301', 'shorta', 'srishti.d19', 'jbai14', 'ahmedhisham1993', 'yasso_ahmed93', 'mernaroshdy95', 'amirmrashad2', 'emaan.ehaab', 'hany1166', 'michaelhany33', 'sossa', 'tmnietzold', 'mahmoud.said1919', 'ossedeek95', 'yomnamahmoud7', 'aveerai1', 'mahmoudsalah20114', 'houjingyi2015', 'unjhenyj', 'shaikhsaif', 'siddheshgajare91', 'jcollie8', 'mhakmd', 'kholoud.ayman', 'kouki', 'hatem2030.hh', 'yifuliu', 'saeeed3', 'mohd.samaha', 'omar_moataz13', 'rebo14101995', 'dkadiyal', 'shinobi', 'wilhelmpiao', 'eman2015', 'ibrahimelsayed999', 'patseo', 'mark_fayez.95', 'm_menna_95', 'mariana.mounir', 'rmenon6', 'monyemoemy', 'zxiong5', 'mnaguib345', 'arwaabdelaziz90', 'usufer', 'tuliphany', 'anwar.alkallas', 'nadahafez1672', 'mh009966', 'bassem2006', 'tnietzol', 'beda_2010', 'geme3600', 'a7medelhelaly', 'mai_hegab', 'fatma.mouawad', 'mohamedaymanabdelsatar', 'ewais', 'shorrrta', 'fatma_batota', 'ninad.chamele', 'djjohn22', 'david.farag', 'eng.aalaa50', 'sergey.golovynskyi', 'jzuo5', 'ma_go20092000', 'rimoz95', 'sandrasamirs3', 'amrmohamedreda94']",2,"['samehmostafa', None]",170,"['nanohub168', 'mido_2010_amr94', 'yolyana.zekry', 'jvanjari', 'ayaaa.f.a', 'noryhankotb12', 'ahmednaser7000', 'nourhan', 'aa.maherr', 'ahmedelectricity1993y', 'mora.sameh2009', 'omarkhaledh95', 'm_osama_asu', 'ahmed_gamal1401', 'anan_alaa_95', 'bondo2a31193', 'mina_sameh95', 'kirollos_ernest', 'm.fouad.allam', 'hassan_elzahar', 'onedaymuer', 'muhammadatef100', 'shadyreda', 'mohabmagdyyoussef', 'aymanalaadin4', 'dondonetoiseau', 'mohmed_rf', 'wilhelm.piao.3', 'mikel.24.hour', 'lamiselhady7', 'screem_love3', 'mina', 'mohamed_adel6222', 'elfaramawytalaat', 'marwa.khaled.eng', 'reham.a.gad', 'yasserramadan940', 'saraalaa', 'waleedsmz94', 'besesh55', 'mina_mwgs', 'ayamostafa978', 'hoda_morshed375', 'wissamismailgp7', 'shamellotfy1966', 'flederico', 'fady', 'ayahelmy_122', 'mimo_tm17', 'nouranalmorshedy', 'ossamakhalil60', 'elec.eng.heba', 'bishoy.medhat.elraheb', 'karimosama1610', 'reallyanyidwuddo', 'mahmoudyoussif95', 'omar.abdulaziz94', 'nadowafa20', 'sh900301', 'mennafarafero', 'shorta', 'srishti.d19', 'jbai14', '4omanko', 'mraafat', 'ahmedhisham1993', 'yasso_ahmed93', 'mernaroshdy95', 'rananader', 'mostafasabri466', 'tarekali1000', 'amirmrashad2', 'amrmeto', 'hany1166', 'emaan.ehaab', 'michaelhany33', 'sossa', 'tmnietzold', 'miro.marawan', 'mahmoudsaid471', 'mahmoud.said1919', 'ossedeek95', 'yomnamahmoud7', 'aveerai1', 'mahmoudsalah20114', 'houjingyi2015', 'unjhenyj', 'dyaanasser2014', 'caboelkady94', 'nohabassem93', 'shaikhsaif', 'siddheshgajare91', 'jcollie8', 'k1l4ny', 'mhakmd', 'kholoud.ayman', 'yugy_mody2010', 'mhassan090944', 'bassantalhawary', 'ahmedakram9393', 'marmar8250', 'kouki', 'noor333aldeen333alkfree', 'hatem2030.hh', 'yifuliu', 'nourhanmohamed', 'saeeed3', 'mohd.samaha', 'hadeermansour242', 'omar_moataz13', 'rebo14101995', 'dkadiyal', 'shinobi', 'ahmedyasso93', 'wilhelmpiao', 'eman2015', 'hazem1', 'ibrahimelsayed999', 'noha1skeleton', 'mark_fayez.95', 'patseo', 'm_menna_95', 'ahmed94hamed', 'mariana.mounir', 'rmenon6', 'monyemoemy', 'yosif_diaa', 'zxiong5', 'halim', 'hisham', 'mnaguib345', 'arwaabdelaziz90', 'usufer', 'samehmostafa', 'engmahmoud', 'tuliphany', 'anwar.alkallas', 'elmohnds.terika', 'zemo_22', 'nadahafez1672', 'mh009966', 'mh', 'bassem2006', 'tnietzol', 'beda_2010', 'geme3600', 'a7medelhelaly', 'mai_hegab', 'fatma.mouawad', 'mohamedaymanabdelsatar', 'ewais', 'shorrrta', 'fatma_batota', 'nadayoussef795', 'ninad.chamele', 'djjohn22', 'david.farag', 'eng.aalaa50', 'sergey.golovynskyi', 'amedo_emad', None, 'jzuo5', 'ma_go20092000', 'rimoz95', 'bashabisho_94', 'sandrasamirs3', 'ahmed_7000naser', 'ahmedhossiny', 'amrmohamedreda94', 'amr_m.attya']"
2,8,169,61,54,"['hisham', 'ayaaa.f.a', 'mnaguib345', 'elec.eng.heba', 'aa.maherr', 'mhakmd', 'kholoud.ayman', 'omarkhaledh95', 'mahmoudyoussif95', 'omar.abdulaziz94', 'engmahmoud', 'ahmed_gamal1401', 'tuliphany', 'anwar.alkallas', 'nadowafa20', 'kirollos_ernest', 'shorta', 'mh009966', 'm.fouad.allam', 'muhammadatef100', 'nourhanmohamed', 'geme3600', 'shadyreda', 'a7medelhelaly', 'fatma.mouawad', 'mohamedaymanabdelsatar', 'fatma_batota', 'aymanalaadin4', 'shorrrta', 'rebo14101995', 'omar_moataz13', 'dondonetoiseau', 'mernaroshdy95', 'mohmed_rf', 'david.farag', 'eng.aalaa50', 'tarekali1000', 'amrmeto', 'amedo_emad', 'michaelhany33', 'mina', 'rimoz95', 'sossa', 'besesh55', 'saraalaa', 'waleedsmz94', 'ibrahimelsayed999', 'mina_mwgs', 'hoda_morshed375', 'wissamismailgp7', 'mahmoudsaid471', 'yomnamahmoud7', 'amrmohamedreda94', 'amr_m.attya']",114,"['nanohub168', 'mido_2010_amr94', 'yolyana.zekry', 'jvanjari', 'noryhankotb12', 'ahmednaser7000', 'nourhan', 'ahmedelectricity1993y', 'mora.sameh2009', 'm_osama_asu', 'anan_alaa_95', 'bondo2a31193', 'mina_sameh95', 'hassan_elzahar', 'onedaymuer', 'mohabmagdyyoussef', 'wilhelm.piao.3', 'mikel.24.hour', 'lamiselhady7', 'screem_love3', 'mohamed_adel6222', 'elfaramawytalaat', 'marwa.khaled.eng', 'reham.a.gad', 'yasserramadan940', 'ayamostafa978', 'shamellotfy1966', 'flederico', 'fady', 'ayahelmy_122', 'mimo_tm17', 'nouranalmorshedy', 'ossamakhalil60', 'bishoy.medhat.elraheb', 'karimosama1610', 'reallyanyidwuddo', 'sh900301', 'mennafarafero', 'srishti.d19', 'jbai14', '4omanko', 'mraafat', 'ahmedhisham1993', 'yasso_ahmed93', 'rananader', 'mostafasabri466', 'amirmrashad2', 'emaan.ehaab', 'hany1166', 'tmnietzold', 'miro.marawan', 'mahmoud.said1919', 'ossedeek95', 'aveerai1', 'mahmoudsalah20114', 'houjingyi2015', 'unjhenyj', 'dyaanasser2014', 'caboelkady94', 'nohabassem93', 'shaikhsaif', 'siddheshgajare91', 'jcollie8', 'k1l4ny', 'yugy_mody2010', 'mhassan090944', 'bassantalhawary', 'ahmedakram9393', 'marmar8250', 'kouki', 'noor333aldeen333alkfree', 'hatem2030.hh', 'yifuliu', 'saeeed3', 'mohd.samaha', 'hadeermansour242', 'dkadiyal', 'shinobi', 'ahmedyasso93', 'wilhelmpiao', 'eman2015', 'hazem1', 'noha1skeleton', 'mark_fayez.95', 'patseo', 'm_menna_95', 'ahmed94hamed', 'mariana.mounir', 'rmenon6', 'monyemoemy', 'yosif_diaa', 'zxiong5', 'halim', 'arwaabdelaziz90', 'usufer', 'elmohnds.terika', 'zemo_22', 'nadahafez1672', 'mh', 'bassem2006', 'tnietzol', 'beda_2010', 'mai_hegab', 'ewais', 'nadayoussef795', 'ninad.chamele', 'djjohn22', 'sergey.golovynskyi', 'jzuo5', 'ma_go20092000', 'bashabisho_94', 'sandrasamirs3', 'ahmed_7000naser', 'ahmedhossiny']",7,"['michael_riad', 'dinawalid95', 'justdalia', 'merna.salahh', 'threem', 'totti', None]",175,"['nanohub168', 'mido_2010_amr94', 'yolyana.zekry', 'jvanjari', 'ayaaa.f.a', 'noryhankotb12', 'ahmednaser7000', 'nourhan', 'aa.maherr', 'ahmedelectricity1993y', 'mora.sameh2009', 'omarkhaledh95', 'm_osama_asu', 'ahmed_gamal1401', 'anan_alaa_95', 'bondo2a31193', 'mina_sameh95', 'kirollos_ernest', 'm.fouad.allam', 'hassan_elzahar', 'onedaymuer', 'muhammadatef100', 'shadyreda', 'mohabmagdyyoussef', 'aymanalaadin4', 'dondonetoiseau', 'mohmed_rf', 'wilhelm.piao.3', 'mikel.24.hour', 'lamiselhady7', 'screem_love3', 'mina', 'mohamed_adel6222', 'michael_riad', 'elfaramawytalaat', 'marwa.khaled.eng', 'reham.a.gad', 'yasserramadan940', 'saraalaa', 'waleedsmz94', 'besesh55', 'mina_mwgs', 'ayamostafa978', 'hoda_morshed375', 'totti', 'wissamismailgp7', 'shamellotfy1966', 'flederico', 'fady', 'ayahelmy_122', 'mimo_tm17', 'nouranalmorshedy', 'threem', 'ossamakhalil60', 'elec.eng.heba', 'bishoy.medhat.elraheb', 'karimosama1610', 'reallyanyidwuddo', 'mahmoudyoussif95', 'omar.abdulaziz94', 'justdalia', 'nadowafa20', 'sh900301', 'mennafarafero', 'shorta', 'srishti.d19', 'jbai14', '4omanko', 'mraafat', 'ahmedhisham1993', 'yasso_ahmed93', 'mernaroshdy95', 'rananader', 'mostafasabri466', 'tarekali1000', 'amirmrashad2', 'amrmeto', 'hany1166', 'emaan.ehaab', 'michaelhany33', 'sossa', 'tmnietzold', 'miro.marawan', 'mahmoudsaid471', 'mahmoud.said1919', 'ossedeek95', 'yomnamahmoud7', 'aveerai1', 'mahmoudsalah20114', 'houjingyi2015', 'unjhenyj', 'dyaanasser2014', 'caboelkady94', 'nohabassem93', 'shaikhsaif', 'siddheshgajare91', 'jcollie8', 'k1l4ny', 'mhakmd', 'kholoud.ayman', 'yugy_mody2010', 'mhassan090944', 'bassantalhawary', 'ahmedakram9393', 'marmar8250', 'kouki', 'noor333aldeen333alkfree', 'hatem2030.hh', 'yifuliu', 'nourhanmohamed', 'saeeed3', 'mohd.samaha', 'hadeermansour242', 'omar_moataz13', 'rebo14101995', 'merna.salahh', 'dkadiyal', 'shinobi', 'ahmedyasso93', 'wilhelmpiao', 'eman2015', 'hazem1', 'ibrahimelsayed999', 'noha1skeleton', 'mark_fayez.95', 'patseo', 'm_menna_95', 'ahmed94hamed', 'mariana.mounir', 'rmenon6', 'monyemoemy', 'yosif_diaa', 'dinawalid95', 'zxiong5', 'halim', 'hisham', 'mnaguib345', 'arwaabdelaziz90', 'usufer', 'engmahmoud', 'tuliphany', 'anwar.alkallas', 'elmohnds.terika', 'zemo_22', 'nadahafez1672', 'mh009966', 'mh', 'bassem2006', 'tnietzol', 'beda_2010', 'geme3600', 'a7medelhelaly', 'mai_hegab', 'fatma.mouawad', 'mohamedaymanabdelsatar', 'ewais', 'shorrrta', 'fatma_batota', 'nadayoussef795', 'ninad.chamele', 'djjohn22', 'david.farag', 'eng.aalaa50', 'sergey.golovynskyi', 'amedo_emad', None, 'jzuo5', 'ma_go20092000', 'rimoz95', 'bashabisho_94', 'sandrasamirs3', 'ahmed_7000naser', 'ahmedhossiny', 'amrmohamedreda94', 'amr_m.attya']"
2,7,169,23,1,['unjhenyj'],167,"['nanohub168', 'mido_2010_amr94', 'yolyana.zekry', 'jvanjari', 'ayaaa.f.a', 'noryhankotb12', 'ahmednaser7000', 'nourhan', 'aa.maherr', 'ahmedelectricity1993y', 'mora.sameh2009', 'omarkhaledh95', 'm_osama_asu', 'ahmed_gamal1401', 'anan_alaa_95', 'bondo2a31193', 'mina_sameh95', 'kirollos_ernest', 'm.fouad.allam', 'hassan_elzahar', 'onedaymuer', 'muhammadatef100', 'shadyreda', 'mohabmagdyyoussef', 'aymanalaadin4', 'dondonetoiseau', 'mohmed_rf', 'wilhelm.piao.3', 'mikel.24.hour', 'lamiselhady7', 'screem_love3', 'mina', 'mohamed_adel6222', 'elfaramawytalaat', 'marwa.khaled.eng', 'reham.a.gad', 'yasserramadan940', 'saraalaa', 'waleedsmz94', 'besesh55', 'mina_mwgs', 'ayamostafa978', 'hoda_morshed375', 'wissamismailgp7', 'shamellotfy1966', 'flederico', 'fady', 'ayahelmy_122', 'mimo_tm17', 'nouranalmorshedy', 'ossamakhalil60', 'elec.eng.heba', 'bishoy.medhat.elraheb', 'karimosama1610', 'reallyanyidwuddo', 'mahmoudyoussif95', 'omar.abdulaziz94', 'nadowafa20', 'sh900301', 'mennafarafero', 'shorta', 'srishti.d19', 'jbai14', '4omanko', 'mraafat', 'ahmedhisham1993', 'yasso_ahmed93', 'mernaroshdy95', 'rananader', 'mostafasabri466', 'tarekali1000', 'amirmrashad2', 'amrmeto', 'hany1166', 'emaan.ehaab', 'michaelhany33', 'sossa', 'tmnietzold', 'miro.marawan', 'mahmoudsaid471', 'mahmoud.said1919', 'ossedeek95', 'yomnamahmoud7', 'aveerai1', 'mahmoudsalah20114', 'houjingyi2015', 'dyaanasser2014', 'caboelkady94', 'nohabassem93', 'shaikhsaif', 'siddheshgajare91', 'jcollie8', 'k1l4ny', 'mhakmd', 'kholoud.ayman', 'yugy_mody2010', 'mhassan090944', 'bassantalhawary', 'ahmedakram9393', 'marmar8250', 'kouki', 'noor333aldeen333alkfree', 'hatem2030.hh', 'yifuliu', 'nourhanmohamed', 'saeeed3', 'mohd.samaha', 'hadeermansour242', 'omar_moataz13', 'rebo14101995', 'dkadiyal', 'shinobi', 'ahmedyasso93', 'wilhelmpiao', 'eman2015', 'hazem1', 'ibrahimelsayed999', 'noha1skeleton', 'mark_fayez.95', 'patseo', 'm_menna_95', 'ahmed94hamed', 'mariana.mounir', 'rmenon6', 'monyemoemy', 'yosif_diaa', 'zxiong5', 'halim', 'hisham', 'mnaguib345', 'arwaabdelaziz90', 'usufer', 'engmahmoud', 'tuliphany', 'anwar.alkallas', 'elmohnds.terika', 'zemo_22', 'nadahafez1672', 'mh009966', 'mh', 'bassem2006', 'tnietzol', 'beda_2010', 'geme3600', 'a7medelhelaly', 'mai_hegab', 'fatma.mouawad', 'mohamedaymanabdelsatar', 'ewais', 'shorrrta', 'fatma_batota', 'nadayoussef795', 'ninad.chamele', 'djjohn22', 'david.farag', 'eng.aalaa50', 'sergey.golovynskyi', 'amedo_emad', 'jzuo5', 'ma_go20092000', 'rimoz95', 'bashabisho_94', 'sandrasamirs3', 'ahmed_7000naser', 'ahmedhossiny', 'amrmohamedreda94', 'amr_m.attya']",22,"['jwp0530', 'redsky93', 'eyounseok', 'rkdals726', 'cat90129', 'ghddlsrl91', 'qw1w2we2e3', 'jwooka', 'mkkim693', 'evev45', 'dae792', 'kimyeonjin94', 'redviola', None, 'taehojung', 'clsdnfwwkd', 'secumjyp', 'hcho0529', 'eug92', 'lhjlke', 'becksha2307', 'joungh023']",190,"['nanohub168', 'eyounseok', 'mido_2010_amr94', 'yolyana.zekry', 'jvanjari', 'ayaaa.f.a', 'noryhankotb12', 'ahmednaser7000', 'nourhan', 'aa.maherr', 'ahmedelectricity1993y', 'mora.sameh2009', 'omarkhaledh95', 'm_osama_asu', 'ghddlsrl91', 'ahmed_gamal1401', 'anan_alaa_95', 'bondo2a31193', 'mina_sameh95', 'kirollos_ernest', 'm.fouad.allam', 'hassan_elzahar', 'onedaymuer', 'muhammadatef100', 'shadyreda', 'mohabmagdyyoussef', 'aymanalaadin4', 'dondonetoiseau', 'mohmed_rf', 'wilhelm.piao.3', 'mikel.24.hour', 'lamiselhady7', 'redviola', 'screem_love3', 'mina', 'mohamed_adel6222', 'elfaramawytalaat', 'marwa.khaled.eng', 'reham.a.gad', 'yasserramadan940', 'saraalaa', 'waleedsmz94', 'besesh55', 'eug92', 'mina_mwgs', 'ayamostafa978', 'hoda_morshed375', 'wissamismailgp7', 'shamellotfy1966', 'flederico', 'fady', 'ayahelmy_122', 'mimo_tm17', 'nouranalmorshedy', 'rkdals726', 'ossamakhalil60', 'elec.eng.heba', 'bishoy.medhat.elraheb', 'karimosama1610', 'reallyanyidwuddo', 'mahmoudyoussif95', 'omar.abdulaziz94', 'qw1w2we2e3', 'nadowafa20', 'sh900301', 'mennafarafero', 'shorta', 'srishti.d19', 'jwooka', 'jbai14', '4omanko', 'mraafat', 'ahmedhisham1993', 'yasso_ahmed93', 'mernaroshdy95', 'rananader', 'dae792', 'mostafasabri466', 'tarekali1000', 'amirmrashad2', 'amrmeto', 'hany1166', 'emaan.ehaab', 'michaelhany33', 'sossa', 'tmnietzold', 'miro.marawan', 'becksha2307', 'mahmoudsaid471', 'mahmoud.said1919', 'ossedeek95', 'yomnamahmoud7', 'aveerai1', 'mahmoudsalah20114', 'houjingyi2015', 'unjhenyj', 'dyaanasser2014', 'caboelkady94', 'nohabassem93', 'shaikhsaif', 'siddheshgajare91', 'jcollie8', 'k1l4ny', 'mhakmd', 'kholoud.ayman', 'cat90129', 'yugy_mody2010', 'mhassan090944', 'bassantalhawary', 'ahmedakram9393', 'marmar8250', 'kouki', 'mkkim693', 'noor333aldeen333alkfree', 'hatem2030.hh', 'yifuliu', 'nourhanmohamed', 'saeeed3', 'mohd.samaha', 'evev45', 'hadeermansour242', 'omar_moataz13', 'rebo14101995', 'kimyeonjin94', 'dkadiyal', 'shinobi', 'clsdnfwwkd', 'ahmedyasso93', 'secumjyp', 'wilhelmpiao', 'eman2015', 'hazem1', 'ibrahimelsayed999', 'lhjlke', 'noha1skeleton', 'mark_fayez.95', 'patseo', 'm_menna_95', 'ahmed94hamed', 'mariana.mounir', 'rmenon6', 'monyemoemy', 'yosif_diaa', 'jwp0530', 'redsky93', 'zxiong5', 'halim', 'hisham', 'mnaguib345', 'arwaabdelaziz90', 'usufer', 'engmahmoud', 'tuliphany', 'anwar.alkallas', 'elmohnds.terika', 'zemo_22', 'nadahafez1672', 'mh009966', 'mh', 'bassem2006', 'tnietzol', 'beda_2010', 'geme3600', 'a7medelhelaly', 'mai_hegab', 'fatma.mouawad', 'mohamedaymanabdelsatar', 'ewais', 'shorrrta', 'fatma_batota', 'nadayoussef795', 'ninad.chamele', 'djjohn22', 'david.farag', 'eng.aalaa50', 'sergey.golovynskyi', 'amedo_emad', None, 'jzuo5', 'ma_go20092000', 'taehojung', 'rimoz95', 'bashabisho_94', 'sandrasamirs3', 'ahmed_7000naser', 'hcho0529', 'joungh023', 'ahmedhossiny', 'amrmohamedreda94', 'amr_m.attya']"
2,12,169,20,15,"['rmenon6', 'houjingyi2015', 'jvanjari', 'ninad.chamele', 'zxiong5', 'shaikhsaif', 'siddheshgajare91', 'djjohn22', 'jcollie8', 'srishti.d19', 'tnietzol', 'jbai14', 'onedaymuer', 'jzuo5', 'yifuliu']",153,"['nanohub168', 'mido_2010_amr94', 'yolyana.zekry', 'ayaaa.f.a', 'noryhankotb12', 'ahmednaser7000', 'nourhan', 'aa.maherr', 'ahmedelectricity1993y', 'mora.sameh2009', 'omarkhaledh95', 'm_osama_asu', 'ahmed_gamal1401', 'anan_alaa_95', 'bondo2a31193', 'mina_sameh95', 'kirollos_ernest', 'm.fouad.allam', 'hassan_elzahar', 'muhammadatef100', 'shadyreda', 'mohabmagdyyoussef', 'aymanalaadin4', 'dondonetoiseau', 'mohmed_rf', 'wilhelm.piao.3', 'mikel.24.hour', 'lamiselhady7', 'screem_love3', 'mina', 'mohamed_adel6222', 'elfaramawytalaat', 'marwa.khaled.eng', 'reham.a.gad', 'yasserramadan940', 'saraalaa', 'waleedsmz94', 'besesh55', 'mina_mwgs', 'ayamostafa978', 'hoda_morshed375', 'wissamismailgp7', 'shamellotfy1966', 'flederico', 'fady', 'ayahelmy_122', 'mimo_tm17', 'nouranalmorshedy', 'ossamakhalil60', 'elec.eng.heba', 'bishoy.medhat.elraheb', 'karimosama1610', 'reallyanyidwuddo', 'mahmoudyoussif95', 'omar.abdulaziz94', 'nadowafa20', 'sh900301', 'mennafarafero', 'shorta', '4omanko', 'mraafat', 'ahmedhisham1993', 'yasso_ahmed93', 'mernaroshdy95', 'rananader', 'mostafasabri466', 'tarekali1000', 'amirmrashad2', 'amrmeto', 'hany1166', 'emaan.ehaab', 'michaelhany33', 'sossa', 'tmnietzold', 'miro.marawan', 'mahmoudsaid471', 'mahmoud.said1919', 'ossedeek95', 'yomnamahmoud7', 'aveerai1', 'mahmoudsalah20114', 'unjhenyj', 'dyaanasser2014', 'caboelkady94', 'nohabassem93', 'k1l4ny', 'mhakmd', 'kholoud.ayman', 'yugy_mody2010', 'mhassan090944', 'bassantalhawary', 'ahmedakram9393', 'marmar8250', 'kouki', 'noor333aldeen333alkfree', 'hatem2030.hh', 'nourhanmohamed', 'saeeed3', 'mohd.samaha', 'hadeermansour242', 'omar_moataz13', 'rebo14101995', 'dkadiyal', 'shinobi', 'ahmedyasso93', 'wilhelmpiao', 'eman2015', 'hazem1', 'ibrahimelsayed999', 'noha1skeleton', 'mark_fayez.95', 'patseo', 'm_menna_95', 'ahmed94hamed', 'mariana.mounir', 'monyemoemy', 'yosif_diaa', 'halim', 'hisham', 'mnaguib345', 'arwaabdelaziz90', 'usufer', 'engmahmoud', 'tuliphany', 'anwar.alkallas', 'elmohnds.terika', 'zemo_22', 'nadahafez1672', 'mh009966', 'mh', 'bassem2006', 'beda_2010', 'geme3600', 'a7medelhelaly', 'mai_hegab', 'fatma.mouawad', 'mohamedaymanabdelsatar', 'ewais', 'shorrrta', 'fatma_batota', 'nadayoussef795', 'david.farag', 'eng.aalaa50', 'sergey.golovynskyi', 'amedo_emad', 'ma_go20092000', 'rimoz95', 'bashabisho_94', 'sandrasamirs3', 'ahmed_7000naser', 'ahmedhossiny', 'amrmohamedreda94', 'amr_m.attya']",5,"['shivang.ghetia', 'nrm2194', None, 'harshjain2691', 'sgajare']",173,"['nanohub168', 'mido_2010_amr94', 'yolyana.zekry', 'jvanjari', 'ayaaa.f.a', 'noryhankotb12', 'ahmednaser7000', 'nourhan', 'aa.maherr', 'ahmedelectricity1993y', 'mora.sameh2009', 'omarkhaledh95', 'm_osama_asu', 'ahmed_gamal1401', 'anan_alaa_95', 'bondo2a31193', 'mina_sameh95', 'kirollos_ernest', 'm.fouad.allam', 'hassan_elzahar', 'onedaymuer', 'muhammadatef100', 'shadyreda', 'mohabmagdyyoussef', 'aymanalaadin4', 'dondonetoiseau', 'mohmed_rf', 'wilhelm.piao.3', 'mikel.24.hour', 'lamiselhady7', 'screem_love3', 'mina', 'mohamed_adel6222', 'elfaramawytalaat', 'marwa.khaled.eng', 'reham.a.gad', 'yasserramadan940', 'saraalaa', 'waleedsmz94', 'besesh55', 'mina_mwgs', 'ayamostafa978', 'hoda_morshed375', 'wissamismailgp7', 'shamellotfy1966', 'harshjain2691', 'flederico', 'shivang.ghetia', 'fady', 'ayahelmy_122', 'mimo_tm17', 'nouranalmorshedy', 'ossamakhalil60', 'elec.eng.heba', 'bishoy.medhat.elraheb', 'karimosama1610', 'reallyanyidwuddo', 'sgajare', 'mahmoudyoussif95', 'omar.abdulaziz94', 'nadowafa20', 'sh900301', 'mennafarafero', 'shorta', 'srishti.d19', 'jbai14', '4omanko', 'mraafat', 'ahmedhisham1993', 'yasso_ahmed93', 'mernaroshdy95', 'rananader', 'mostafasabri466', 'tarekali1000', 'amirmrashad2', 'amrmeto', 'hany1166', 'emaan.ehaab', 'michaelhany33', 'sossa', 'tmnietzold', 'miro.marawan', 'mahmoudsaid471', 'mahmoud.said1919', 'ossedeek95', 'yomnamahmoud7', 'aveerai1', 'mahmoudsalah20114', 'houjingyi2015', 'unjhenyj', 'dyaanasser2014', 'caboelkady94', 'nohabassem93', 'shaikhsaif', 'siddheshgajare91', 'jcollie8', 'k1l4ny', 'mhakmd', 'kholoud.ayman', 'yugy_mody2010', 'mhassan090944', 'bassantalhawary', 'ahmedakram9393', 'marmar8250', 'kouki', 'noor333aldeen333alkfree', 'hatem2030.hh', 'yifuliu', 'nourhanmohamed', 'saeeed3', 'mohd.samaha', 'hadeermansour242', 'omar_moataz13', 'rebo14101995', 'dkadiyal', 'shinobi', 'ahmedyasso93', 'wilhelmpiao', 'eman2015', 'hazem1', 'ibrahimelsayed999', 'nrm2194', 'noha1skeleton', 'mark_fayez.95', 'patseo', 'm_menna_95', 'ahmed94hamed', 'mariana.mounir', 'rmenon6', 'monyemoemy', 'yosif_diaa', 'zxiong5', 'halim', 'hisham', 'mnaguib345', 'arwaabdelaziz90', 'usufer', 'engmahmoud', 'tuliphany', 'anwar.alkallas', 'elmohnds.terika', 'zemo_22', 'nadahafez1672', 'mh009966', 'mh', 'bassem2006', 'tnietzol', 'beda_2010', 'geme3600', 'a7medelhelaly', 'mai_hegab', 'fatma.mouawad', 'mohamedaymanabdelsatar', 'ewais', 'shorrrta', 'fatma_batota', 'nadayoussef795', 'ninad.chamele', 'djjohn22', 'david.farag', 'eng.aalaa50', 'sergey.golovynskyi', 'amedo_emad', None, 'jzuo5', 'ma_go20092000', 'rimoz95', 'bashabisho_94', 'sandrasamirs3', 'ahmed_7000naser', 'ahmedhossiny', 'amrmohamedreda94', 'amr_m.attya']"
2,218,169,19,4,"['hazem1', 'elmohnds.terika', 'nourhan', 'rananader']",164,"['nanohub168', 'mido_2010_amr94', 'yolyana.zekry', 'jvanjari', 'ayaaa.f.a', 'noryhankotb12', 'ahmednaser7000', 'aa.maherr', 'ahmedelectricity1993y', 'mora.sameh2009', 'omarkhaledh95', 'm_osama_asu', 'ahmed_gamal1401', 'anan_alaa_95', 'bondo2a31193', 'mina_sameh95', 'kirollos_ernest', 'm.fouad.allam', 'hassan_elzahar', 'onedaymuer', 'muhammadatef100', 'shadyreda', 'mohabmagdyyoussef', 'aymanalaadin4', 'dondonetoiseau', 'mohmed_rf', 'wilhelm.piao.3', 'mikel.24.hour', 'lamiselhady7', 'screem_love3', 'mina', 'mohamed_adel6222', 'elfaramawytalaat', 'marwa.khaled.eng', 'reham.a.gad', 'yasserramadan940', 'saraalaa', 'waleedsmz94', 'besesh55', 'mina_mwgs', 'ayamostafa978', 'hoda_morshed375', 'wissamismailgp7', 'shamellotfy1966', 'flederico', 'fady', 'ayahelmy_122', 'mimo_tm17', 'nouranalmorshedy', 'ossamakhalil60', 'elec.eng.heba', 'bishoy.medhat.elraheb', 'karimosama1610', 'reallyanyidwuddo', 'mahmoudyoussif95', 'omar.abdulaziz94', 'nadowafa20', 'sh900301', 'mennafarafero', 'shorta', 'srishti.d19', 'jbai14', '4omanko', 'mraafat', 'ahmedhisham1993', 'yasso_ahmed93', 'mernaroshdy95', 'mostafasabri466', 'tarekali1000', 'amirmrashad2', 'amrmeto', 'hany1166', 'emaan.ehaab', 'michaelhany33', 'sossa', 'tmnietzold', 'miro.marawan', 'mahmoudsaid471', 'mahmoud.said1919', 'ossedeek95', 'yomnamahmoud7', 'aveerai1', 'mahmoudsalah20114', 'houjingyi2015', 'unjhenyj', 'dyaanasser2014', 'caboelkady94', 'nohabassem93', 'shaikhsaif', 'siddheshgajare91', 'jcollie8', 'k1l4ny', 'mhakmd', 'kholoud.ayman', 'yugy_mody2010', 'mhassan090944', 'bassantalhawary', 'ahmedakram9393', 'marmar8250', 'kouki', 'noor333aldeen333alkfree', 'hatem2030.hh', 'yifuliu', 'nourhanmohamed', 'saeeed3', 'mohd.samaha', 'hadeermansour242', 'omar_moataz13', 'rebo14101995', 'dkadiyal', 'shinobi', 'ahmedyasso93', 'wilhelmpiao', 'eman2015', 'ibrahimelsayed999', 'noha1skeleton', 'mark_fayez.95', 'patseo', 'm_menna_95', 'ahmed94hamed', 'mariana.mounir', 'rmenon6', 'monyemoemy', 'yosif_diaa', 'zxiong5', 'halim', 'hisham', 'mnaguib345', 'arwaabdelaziz90', 'usufer', 'engmahmoud', 'tuliphany', 'anwar.alkallas', 'zemo_22', 'nadahafez1672', 'mh009966', 'mh', 'bassem2006', 'tnietzol', 'beda_2010', 'geme3600', 'a7medelhelaly', 'mai_hegab', 'fatma.mouawad', 'mohamedaymanabdelsatar', 'ewais', 'shorrrta', 'fatma_batota', 'nadayoussef795', 'ninad.chamele', 'djjohn22', 'david.farag', 'eng.aalaa50', 'sergey.golovynskyi', 'amedo_emad', 'jzuo5', 'ma_go20092000', 'rimoz95', 'bashabisho_94', 'sandrasamirs3', 'ahmed_7000naser', 'ahmedhossiny', 'amrmohamedreda94', 'amr_m.attya']",15,"['mohsenraafat', 'mazenahmed09', 'serag', 'johnjoeee524', 'ahmedhatemelkady', 'monaahmed', 'ahmed_refaat', 'a.hesham', 'sherif__hosny', 'esraa', 'marinamedhat', 'ayamohamed12030', 'raniaosama2015', 'patyessam', None]",183,"['mohsenraafat', 'nanohub168', 'mido_2010_amr94', 'yolyana.zekry', 'jvanjari', 'monaahmed', 'ayaaa.f.a', 'noryhankotb12', 'ahmednaser7000', 'nourhan', 'aa.maherr', 'ahmedelectricity1993y', 'mora.sameh2009', 'omarkhaledh95', 'm_osama_asu', 'ahmed_gamal1401', 'anan_alaa_95', 'bondo2a31193', 'mina_sameh95', 'kirollos_ernest', 'sherif__hosny', 'm.fouad.allam', 'hassan_elzahar', 'onedaymuer', 'muhammadatef100', 'shadyreda', 'mohabmagdyyoussef', 'aymanalaadin4', 'dondonetoiseau', 'mohmed_rf', 'wilhelm.piao.3', 'mikel.24.hour', 'lamiselhady7', 'screem_love3', 'mina', 'mohamed_adel6222', 'elfaramawytalaat', 'marwa.khaled.eng', 'reham.a.gad', 'yasserramadan940', 'saraalaa', 'waleedsmz94', 'besesh55', 'mina_mwgs', 'ayamostafa978', 'hoda_morshed375', 'wissamismailgp7', 'shamellotfy1966', 'flederico', 'fady', 'ayahelmy_122', 'mimo_tm17', 'nouranalmorshedy', 'ossamakhalil60', 'esraa', 'elec.eng.heba', 'bishoy.medhat.elraheb', 'karimosama1610', 'reallyanyidwuddo', 'mahmoudyoussif95', 'omar.abdulaziz94', 'nadowafa20', 'sh900301', 'mennafarafero', 'shorta', 'srishti.d19', 'jbai14', '4omanko', 'mraafat', 'mazenahmed09', 'ahmedhisham1993', 'ahmedhatemelkady', 'yasso_ahmed93', 'mernaroshdy95', 'rananader', 'mostafasabri466', 'tarekali1000', 'amirmrashad2', 'amrmeto', 'hany1166', 'emaan.ehaab', 'michaelhany33', 'patyessam', 'sossa', 'tmnietzold', 'miro.marawan', 'mahmoudsaid471', 'mahmoud.said1919', 'ossedeek95', 'yomnamahmoud7', 'aveerai1', 'mahmoudsalah20114', 'houjingyi2015', 'johnjoeee524', 'unjhenyj', 'dyaanasser2014', 'caboelkady94', 'nohabassem93', 'shaikhsaif', 'siddheshgajare91', 'jcollie8', 'k1l4ny', 'raniaosama2015', 'mhakmd', 'kholoud.ayman', 'yugy_mody2010', 'mhassan090944', 'bassantalhawary', 'ahmedakram9393', 'ahmed_refaat', 'marmar8250', 'kouki', 'noor333aldeen333alkfree', 'hatem2030.hh', 'yifuliu', 'nourhanmohamed', 'saeeed3', 'mohd.samaha', 'hadeermansour242', 'serag', 'omar_moataz13', 'rebo14101995', 'dkadiyal', 'shinobi', 'ahmedyasso93', 'wilhelmpiao', 'eman2015', 'hazem1', 'ibrahimelsayed999', 'noha1skeleton', 'ayamohamed12030', 'mark_fayez.95', 'patseo', 'm_menna_95', 'ahmed94hamed', 'mariana.mounir', 'rmenon6', 'monyemoemy', 'yosif_diaa', 'zxiong5', 'halim', 'hisham', 'mnaguib345', 'arwaabdelaziz90', 'usufer', 'engmahmoud', 'tuliphany', 'anwar.alkallas', 'elmohnds.terika', 'zemo_22', 'a.hesham', 'nadahafez1672', 'mh009966', 'mh', 'bassem2006', 'tnietzol', 'beda_2010', 'geme3600', 'a7medelhelaly', 'mai_hegab', 'fatma.mouawad', 'mohamedaymanabdelsatar', 'ewais', 'shorrrta', 'fatma_batota', 'nadayoussef795', 'ninad.chamele', 'djjohn22', 'david.farag', 'marinamedhat', 'eng.aalaa50', 'sergey.golovynskyi', 'amedo_emad', None, 'jzuo5', 'ma_go20092000', 'rimoz95', 'bashabisho_94', 'sandrasamirs3', 'ahmed_7000naser', 'ahmedhossiny', 'amrmohamedreda94', 'amr_m.attya']"
2,16,169,13,11,"['elfaramawytalaat', 'ahmedhisham1993', 'yasso_ahmed93', 'nouranalmorshedy', 'noha1skeleton', 'nourhan', 'bassem2006', 'hany1166', 'hatem2030.hh', 'shamellotfy1966', 'karimosama1610']",157,"['nanohub168', 'mido_2010_amr94', 'yolyana.zekry', 'jvanjari', 'ayaaa.f.a', 'noryhankotb12', 'ahmednaser7000', 'aa.maherr', 'ahmedelectricity1993y', 'mora.sameh2009', 'omarkhaledh95', 'm_osama_asu', 'ahmed_gamal1401', 'anan_alaa_95', 'bondo2a31193', 'mina_sameh95', 'kirollos_ernest', 'm.fouad.allam', 'hassan_elzahar', 'onedaymuer', 'muhammadatef100', 'shadyreda', 'mohabmagdyyoussef', 'aymanalaadin4', 'dondonetoiseau', 'mohmed_rf', 'wilhelm.piao.3', 'mikel.24.hour', 'lamiselhady7', 'screem_love3', 'mina', 'mohamed_adel6222', 'marwa.khaled.eng', 'reham.a.gad', 'yasserramadan940', 'saraalaa', 'waleedsmz94', 'besesh55', 'mina_mwgs', 'ayamostafa978', 'hoda_morshed375', 'wissamismailgp7', 'flederico', 'fady', 'ayahelmy_122', 'mimo_tm17', 'ossamakhalil60', 'elec.eng.heba', 'bishoy.medhat.elraheb', 'reallyanyidwuddo', 'mahmoudyoussif95', 'omar.abdulaziz94', 'nadowafa20', 'sh900301', 'mennafarafero', 'shorta', 'srishti.d19', 'jbai14', '4omanko', 'mraafat', 'mernaroshdy95', 'rananader', 'mostafasabri466', 'tarekali1000', 'amirmrashad2', 'amrmeto', 'emaan.ehaab', 'michaelhany33', 'sossa', 'tmnietzold', 'miro.marawan', 'mahmoudsaid471', 'mahmoud.said1919', 'ossedeek95', 'yomnamahmoud7', 'aveerai1', 'mahmoudsalah20114', 'houjingyi2015', 'unjhenyj', 'dyaanasser2014', 'caboelkady94', 'nohabassem93', 'shaikhsaif', 'siddheshgajare91', 'jcollie8', 'k1l4ny', 'mhakmd', 'kholoud.ayman', 'yugy_mody2010', 'mhassan090944', 'bassantalhawary', 'ahmedakram9393', 'marmar8250', 'kouki', 'noor333aldeen333alkfree', 'yifuliu', 'nourhanmohamed', 'saeeed3', 'mohd.samaha', 'hadeermansour242', 'omar_moataz13', 'rebo14101995', 'dkadiyal', 'shinobi', 'ahmedyasso93', 'wilhelmpiao', 'eman2015', 'hazem1', 'ibrahimelsayed999', 'mark_fayez.95', 'patseo', 'm_menna_95', 'ahmed94hamed', 'mariana.mounir', 'rmenon6', 'monyemoemy', 'yosif_diaa', 'zxiong5', 'halim', 'hisham', 'mnaguib345', 'arwaabdelaziz90', 'usufer', 'engmahmoud', 'tuliphany', 'anwar.alkallas', 'elmohnds.terika', 'zemo_22', 'nadahafez1672', 'mh009966', 'mh', 'tnietzol', 'beda_2010', 'geme3600', 'a7medelhelaly', 'mai_hegab', 'fatma.mouawad', 'mohamedaymanabdelsatar', 'ewais', 'shorrrta', 'fatma_batota', 'nadayoussef795', 'ninad.chamele', 'djjohn22', 'david.farag', 'eng.aalaa50', 'sergey.golovynskyi', 'amedo_emad', 'jzuo5', 'ma_go20092000', 'rimoz95', 'bashabisho_94', 'sandrasamirs3', 'ahmed_7000naser', 'ahmedhossiny', 'amrmohamedreda94', 'amr_m.attya']",2,"['egamal777', None]",170,"['nanohub168', 'egamal777', 'mido_2010_amr94', 'yolyana.zekry', 'jvanjari', 'ayaaa.f.a', 'noryhankotb12', 'ahmednaser7000', 'nourhan', 'aa.maherr', 'ahmedelectricity1993y', 'mora.sameh2009', 'omarkhaledh95', 'm_osama_asu', 'ahmed_gamal1401', 'anan_alaa_95', 'bondo2a31193', 'mina_sameh95', 'kirollos_ernest', 'm.fouad.allam', 'hassan_elzahar', 'onedaymuer', 'muhammadatef100', 'shadyreda', 'mohabmagdyyoussef', 'aymanalaadin4', 'dondonetoiseau', 'mohmed_rf', 'wilhelm.piao.3', 'mikel.24.hour', 'lamiselhady7', 'screem_love3', 'mina', 'mohamed_adel6222', 'elfaramawytalaat', 'marwa.khaled.eng', 'reham.a.gad', 'yasserramadan940', 'saraalaa', 'waleedsmz94', 'besesh55', 'mina_mwgs', 'ayamostafa978', 'hoda_morshed375', 'wissamismailgp7', 'shamellotfy1966', 'flederico', 'fady', 'ayahelmy_122', 'mimo_tm17', 'nouranalmorshedy', 'ossamakhalil60', 'elec.eng.heba', 'bishoy.medhat.elraheb', 'karimosama1610', 'reallyanyidwuddo', 'mahmoudyoussif95', 'omar.abdulaziz94', 'nadowafa20', 'sh900301', 'mennafarafero', 'shorta', 'srishti.d19', 'jbai14', '4omanko', 'mraafat', 'ahmedhisham1993', 'yasso_ahmed93', 'mernaroshdy95', 'rananader', 'mostafasabri466', 'tarekali1000', 'amirmrashad2', 'amrmeto', 'hany1166', 'emaan.ehaab', 'michaelhany33', 'sossa', 'tmnietzold', 'miro.marawan', 'mahmoudsaid471', 'mahmoud.said1919', 'ossedeek95', 'yomnamahmoud7', 'aveerai1', 'mahmoudsalah20114', 'houjingyi2015', 'unjhenyj', 'dyaanasser2014', 'caboelkady94', 'nohabassem93', 'shaikhsaif', 'siddheshgajare91', 'jcollie8', 'k1l4ny', 'mhakmd', 'kholoud.ayman', 'yugy_mody2010', 'mhassan090944', 'bassantalhawary', 'ahmedakram9393', 'marmar8250', 'kouki', 'noor333aldeen333alkfree', 'hatem2030.hh', 'yifuliu', 'nourhanmohamed', 'saeeed3', 'mohd.samaha', 'hadeermansour242', 'omar_moataz13', 'rebo14101995', 'dkadiyal', 'shinobi', 'ahmedyasso93', 'wilhelmpiao', 'eman2015', 'hazem1', 'ibrahimelsayed999', 'noha1skeleton', 'mark_fayez.95', 'patseo', 'm_menna_95', 'ahmed94hamed', 'mariana.mounir', 'rmenon6', 'monyemoemy', 'yosif_diaa', 'zxiong5', 'halim', 'hisham', 'mnaguib345', 'arwaabdelaziz90', 'usufer', 'engmahmoud', 'tuliphany', 'anwar.alkallas', 'elmohnds.terika', 'zemo_22', 'nadahafez1672', 'mh009966', 'mh', 'bassem2006', 'tnietzol', 'beda_2010', 'geme3600', 'a7medelhelaly', 'mai_hegab', 'fatma.mouawad', 'mohamedaymanabdelsatar', 'ewais', 'shorrrta', 'fatma_batota', 'nadayoussef795', 'ninad.chamele', 'djjohn22', 'david.farag', 'eng.aalaa50', 'sergey.golovynskyi', 'amedo_emad', None, 'jzuo5', 'ma_go20092000', 'rimoz95', 'bashabisho_94', 'sandrasamirs3', 'ahmed_7000naser', 'ahmedhossiny', 'amrmohamedreda94', 'amr_m.attya']"
2,13,169,11,10,"['shinobi', 'omar.abdulaziz94', 'dondonetoiseau', 'anan_alaa_95', 'nouranalmorshedy', 'sandrasamirs3', 'mina_sameh95', 'kouki', 'nadahafez1672', 'mora.sameh2009']",158,"['nanohub168', 'mido_2010_amr94', 'yolyana.zekry', 'jvanjari', 'ayaaa.f.a', 'noryhankotb12', 'ahmednaser7000', 'nourhan', 'aa.maherr', 'ahmedelectricity1993y', 'omarkhaledh95', 'm_osama_asu', 'ahmed_gamal1401', 'bondo2a31193', 'kirollos_ernest', 'm.fouad.allam', 'hassan_elzahar', 'onedaymuer', 'muhammadatef100', 'shadyreda', 'mohabmagdyyoussef', 'aymanalaadin4', 'mohmed_rf', 'wilhelm.piao.3', 'mikel.24.hour', 'lamiselhady7', 'screem_love3', 'mina', 'mohamed_adel6222', 'elfaramawytalaat', 'marwa.khaled.eng', 'reham.a.gad', 'yasserramadan940', 'saraalaa', 'waleedsmz94', 'besesh55', 'mina_mwgs', 'ayamostafa978', 'hoda_morshed375', 'wissamismailgp7', 'shamellotfy1966', 'flederico', 'fady', 'ayahelmy_122', 'mimo_tm17', 'ossamakhalil60', 'elec.eng.heba', 'bishoy.medhat.elraheb', 'karimosama1610', 'reallyanyidwuddo', 'mahmoudyoussif95', 'nadowafa20', 'sh900301', 'mennafarafero', 'shorta', 'srishti.d19', 'jbai14', '4omanko', 'mraafat', 'ahmedhisham1993', 'yasso_ahmed93', 'mernaroshdy95', 'rananader', 'mostafasabri466', 'tarekali1000', 'amirmrashad2', 'amrmeto', 'hany1166', 'emaan.ehaab', 'michaelhany33', 'sossa', 'tmnietzold', 'miro.marawan', 'mahmoudsaid471', 'mahmoud.said1919', 'ossedeek95', 'yomnamahmoud7', 'aveerai1', 'mahmoudsalah20114', 'houjingyi2015', 'unjhenyj', 'dyaanasser2014', 'caboelkady94', 'nohabassem93', 'shaikhsaif', 'siddheshgajare91', 'jcollie8', 'k1l4ny', 'mhakmd', 'kholoud.ayman', 'yugy_mody2010', 'mhassan090944', 'bassantalhawary', 'ahmedakram9393', 'marmar8250', 'noor333aldeen333alkfree', 'hatem2030.hh', 'yifuliu', 'nourhanmohamed', 'saeeed3', 'mohd.samaha', 'hadeermansour242', 'omar_moataz13', 'rebo14101995', 'dkadiyal', 'ahmedyasso93', 'wilhelmpiao', 'eman2015', 'hazem1', 'ibrahimelsayed999', 'noha1skeleton', 'mark_fayez.95', 'patseo', 'm_menna_95', 'ahmed94hamed', 'mariana.mounir', 'rmenon6', 'monyemoemy', 'yosif_diaa', 'zxiong5', 'halim', 'hisham', 'mnaguib345', 'arwaabdelaziz90', 'usufer', 'engmahmoud', 'tuliphany', 'anwar.alkallas', 'elmohnds.terika', 'zemo_22', 'mh009966', 'mh', 'bassem2006', 'tnietzol', 'beda_2010', 'geme3600', 'a7medelhelaly', 'mai_hegab', 'fatma.mouawad', 'mohamedaymanabdelsatar', 'ewais', 'shorrrta', 'fatma_batota', 'nadayoussef795', 'ninad.chamele', 'djjohn22', 'david.farag', 'eng.aalaa50', 'sergey.golovynskyi', 'amedo_emad', 'jzuo5', 'ma_go20092000', 'rimoz95', 'bashabisho_94', 'ahmed_7000naser', 'ahmedhossiny', 'amrmohamedreda94', 'amr_m.attya']",1,[None],169,"['nanohub168', 'mido_2010_amr94', 'yolyana.zekry', 'jvanjari', 'ayaaa.f.a', 'noryhankotb12', 'ahmednaser7000', 'nourhan', 'aa.maherr', 'ahmedelectricity1993y', 'mora.sameh2009', 'omarkhaledh95', 'm_osama_asu', 'ahmed_gamal1401', 'anan_alaa_95', 'bondo2a31193', 'mina_sameh95', 'kirollos_ernest', 'm.fouad.allam', 'hassan_elzahar', 'onedaymuer', 'muhammadatef100', 'shadyreda', 'mohabmagdyyoussef', 'aymanalaadin4', 'dondonetoiseau', 'mohmed_rf', 'wilhelm.piao.3', 'mikel.24.hour', 'lamiselhady7', 'screem_love3', 'mina', 'mohamed_adel6222', 'elfaramawytalaat', 'marwa.khaled.eng', 'reham.a.gad', 'yasserramadan940', 'saraalaa', 'waleedsmz94', 'besesh55', 'mina_mwgs', 'ayamostafa978', 'hoda_morshed375', 'wissamismailgp7', 'shamellotfy1966', 'flederico', 'fady', 'ayahelmy_122', 'mimo_tm17', 'nouranalmorshedy', 'ossamakhalil60', 'elec.eng.heba', 'bishoy.medhat.elraheb', 'karimosama1610', 'reallyanyidwuddo', 'mahmoudyoussif95', 'omar.abdulaziz94', 'nadowafa20', 'sh900301', 'mennafarafero', 'shorta', 'srishti.d19', 'jbai14', '4omanko', 'mraafat', 'ahmedhisham1993', 'yasso_ahmed93', 'mernaroshdy95', 'rananader', 'mostafasabri466', 'tarekali1000', 'amirmrashad2', 'amrmeto', 'hany1166', 'emaan.ehaab', 'michaelhany33', 'sossa', 'tmnietzold', 'miro.marawan', 'mahmoudsaid471', 'mahmoud.said1919', 'ossedeek95', 'yomnamahmoud7', 'aveerai1', 'mahmoudsalah20114', 'houjingyi2015', 'unjhenyj', 'dyaanasser2014', 'caboelkady94', 'nohabassem93', 'shaikhsaif', 'siddheshgajare91', 'jcollie8', 'k1l4ny', 'mhakmd', 'kholoud.ayman', 'yugy_mody2010', 'mhassan090944', 'bassantalhawary', 'ahmedakram9393', 'marmar8250', 'kouki', 'noor333aldeen333alkfree', 'hatem2030.hh', 'yifuliu', 'nourhanmohamed', 'saeeed3', 'mohd.samaha', 'hadeermansour242', 'omar_moataz13', 'rebo14101995', 'dkadiyal', 'shinobi', 'ahmedyasso93', 'wilhelmpiao', 'eman2015', 'hazem1', 'ibrahimelsayed999', 'noha1skeleton', 'mark_fayez.95', 'patseo', 'm_menna_95', 'ahmed94hamed', 'mariana.mounir', 'rmenon6', 'monyemoemy', 'yosif_diaa', 'zxiong5', 'halim', 'hisham', 'mnaguib345', 'arwaabdelaziz90', 'usufer', 'engmahmoud', 'tuliphany', 'anwar.alkallas', 'elmohnds.terika', 'zemo_22', 'nadahafez1672', 'mh009966', 'mh', 'bassem2006', 'tnietzol', 'beda_2010', 'geme3600', 'a7medelhelaly', 'mai_hegab', 'fatma.mouawad', 'mohamedaymanabdelsatar', 'ewais', 'shorrrta', 'fatma_batota', 'nadayoussef795', 'ninad.chamele', 'djjohn22', 'david.farag', 'eng.aalaa50', 'sergey.golovynskyi', 'amedo_emad', None, 'jzuo5', 'ma_go20092000', 'rimoz95', 'bashabisho_94', 'sandrasamirs3', 'ahmed_7000naser', 'ahmedhossiny', 'amrmohamedreda94', 'amr_m.attya']"
2,216,169,11,2,"['mnaguib345', 'eman2015']",166,"['nanohub168', 'mido_2010_amr94', 'yolyana.zekry', 'jvanjari', 'ayaaa.f.a', 'noryhankotb12', 'ahmednaser7000', 'nourhan', 'aa.maherr', 'ahmedelectricity1993y', 'mora.sameh2009', 'omarkhaledh95', 'm_osama_asu', 'ahmed_gamal1401', 'anan_alaa_95', 'bondo2a31193', 'mina_sameh95', 'kirollos_ernest', 'm.fouad.allam', 'hassan_elzahar', 'onedaymuer', 'muhammadatef100', 'shadyreda', 'mohabmagdyyoussef', 'aymanalaadin4', 'dondonetoiseau', 'mohmed_rf', 'wilhelm.piao.3', 'mikel.24.hour', 'lamiselhady7', 'screem_love3', 'mina', 'mohamed_adel6222', 'elfaramawytalaat', 'marwa.khaled.eng', 'reham.a.gad', 'yasserramadan940', 'saraalaa', 'waleedsmz94', 'besesh55', 'mina_mwgs', 'ayamostafa978', 'hoda_morshed375', 'wissamismailgp7', 'shamellotfy1966', 'flederico', 'fady', 'ayahelmy_122', 'mimo_tm17', 'nouranalmorshedy', 'ossamakhalil60', 'elec.eng.heba', 'bishoy.medhat.elraheb', 'karimosama1610', 'reallyanyidwuddo', 'mahmoudyoussif95', 'omar.abdulaziz94', 'nadowafa20', 'sh900301', 'mennafarafero', 'shorta', 'srishti.d19', 'jbai14', '4omanko', 'mraafat', 'ahmedhisham1993', 'yasso_ahmed93', 'mernaroshdy95', 'rananader', 'mostafasabri466', 'tarekali1000', 'amirmrashad2', 'amrmeto', 'hany1166', 'emaan.ehaab', 'michaelhany33', 'sossa', 'tmnietzold', 'miro.marawan', 'mahmoudsaid471', 'mahmoud.said1919', 'ossedeek95', 'yomnamahmoud7', 'aveerai1', 'mahmoudsalah20114', 'houjingyi2015', 'unjhenyj', 'dyaanasser2014', 'caboelkady94', 'nohabassem93', 'shaikhsaif', 'siddheshgajare91', 'jcollie8', 'k1l4ny', 'mhakmd', 'kholoud.ayman', 'yugy_mody2010', 'mhassan090944', 'bassantalhawary', 'ahmedakram9393', 'marmar8250', 'kouki', 'noor333aldeen333alkfree', 'hatem2030.hh', 'yifuliu', 'nourhanmohamed', 'saeeed3', 'mohd.samaha', 'hadeermansour242', 'omar_moataz13', 'rebo14101995', 'dkadiyal', 'shinobi', 'ahmedyasso93', 'wilhelmpiao', 'hazem1', 'ibrahimelsayed999', 'noha1skeleton', 'mark_fayez.95', 'patseo', 'm_menna_95', 'ahmed94hamed', 'mariana.mounir', 'rmenon6', 'monyemoemy', 'yosif_diaa', 'zxiong5', 'halim', 'hisham', 'arwaabdelaziz90', 'usufer', 'engmahmoud', 'tuliphany', 'anwar.alkallas', 'elmohnds.terika', 'zemo_22', 'nadahafez1672', 'mh009966', 'mh', 'bassem2006', 'tnietzol', 'beda_2010', 'geme3600', 'a7medelhelaly', 'mai_hegab', 'fatma.mouawad', 'mohamedaymanabdelsatar', 'ewais', 'shorrrta', 'fatma_batota', 'nadayoussef795', 'ninad.chamele', 'djjohn22', 'david.farag', 'eng.aalaa50', 'sergey.golovynskyi', 'amedo_emad', 'jzuo5', 'ma_go20092000', 'rimoz95', 'bashabisho_94', 'sandrasamirs3', 'ahmed_7000naser', 'ahmedhossiny', 'amrmohamedreda94', 'amr_m.attya']",9,"['moaz', 'shaher146', 'faisal_hussien', 'kareemchicharito14', 'marinamedhat', 'omarko.kamel', 'ayamohamed12030', 'moustafa.eldesouky', None]",177,"['nanohub168', 'mido_2010_amr94', 'yolyana.zekry', 'jvanjari', 'ayaaa.f.a', 'noryhankotb12', 'ahmednaser7000', 'nourhan', 'aa.maherr', 'ahmedelectricity1993y', 'mora.sameh2009', 'omarkhaledh95', 'm_osama_asu', 'ahmed_gamal1401', 'anan_alaa_95', 'bondo2a31193', 'mina_sameh95', 'kirollos_ernest', 'm.fouad.allam', 'hassan_elzahar', 'onedaymuer', 'muhammadatef100', 'shadyreda', 'mohabmagdyyoussef', 'aymanalaadin4', 'dondonetoiseau', 'mohmed_rf', 'faisal_hussien', 'wilhelm.piao.3', 'mikel.24.hour', 'lamiselhady7', 'screem_love3', 'mina', 'mohamed_adel6222', 'shaher146', 'elfaramawytalaat', 'marwa.khaled.eng', 'reham.a.gad', 'yasserramadan940', 'saraalaa', 'waleedsmz94', 'besesh55', 'mina_mwgs', 'ayamostafa978', 'hoda_morshed375', 'wissamismailgp7', 'shamellotfy1966', 'flederico', 'moaz', 'fady', 'ayahelmy_122', 'mimo_tm17', 'nouranalmorshedy', 'ossamakhalil60', 'elec.eng.heba', 'bishoy.medhat.elraheb', 'karimosama1610', 'reallyanyidwuddo', 'mahmoudyoussif95', 'omar.abdulaziz94', 'nadowafa20', 'sh900301', 'mennafarafero', 'shorta', 'srishti.d19', 'jbai14', '4omanko', 'mraafat', 'ahmedhisham1993', 'yasso_ahmed93', 'mernaroshdy95', 'rananader', 'mostafasabri466', 'tarekali1000', 'amirmrashad2', 'amrmeto', 'hany1166', 'emaan.ehaab', 'michaelhany33', 'sossa', 'tmnietzold', 'miro.marawan', 'omarko.kamel', 'mahmoudsaid471', 'mahmoud.said1919', 'ossedeek95', 'yomnamahmoud7', 'aveerai1', 'mahmoudsalah20114', 'houjingyi2015', 'unjhenyj', 'dyaanasser2014', 'caboelkady94', 'nohabassem93', 'shaikhsaif', 'siddheshgajare91', 'jcollie8', 'k1l4ny', 'mhakmd', 'moustafa.eldesouky', 'kholoud.ayman', 'yugy_mody2010', 'mhassan090944', 'bassantalhawary', 'ahmedakram9393', 'marmar8250', 'kouki', 'noor333aldeen333alkfree', 'hatem2030.hh', 'yifuliu', 'nourhanmohamed', 'saeeed3', 'mohd.samaha', 'hadeermansour242', 'omar_moataz13', 'rebo14101995', 'kareemchicharito14', 'dkadiyal', 'shinobi', 'ahmedyasso93', 'wilhelmpiao', 'eman2015', 'hazem1', 'ibrahimelsayed999', 'noha1skeleton', 'ayamohamed12030', 'mark_fayez.95', 'patseo', 'm_menna_95', 'ahmed94hamed', 'mariana.mounir', 'rmenon6', 'monyemoemy', 'yosif_diaa', 'zxiong5', 'halim', 'hisham', 'mnaguib345', 'arwaabdelaziz90', 'usufer', 'engmahmoud', 'tuliphany', 'anwar.alkallas', 'elmohnds.terika', 'zemo_22', 'nadahafez1672', 'mh009966', 'mh', 'bassem2006', 'tnietzol', 'beda_2010', 'geme3600', 'a7medelhelaly', 'mai_hegab', 'fatma.mouawad', 'mohamedaymanabdelsatar', 'ewais', 'shorrrta', 'fatma_batota', 'nadayoussef795', 'ninad.chamele', 'djjohn22', 'david.farag', 'marinamedhat', 'eng.aalaa50', 'sergey.golovynskyi', 'amedo_emad', None, 'jzuo5', 'ma_go20092000', 'rimoz95', 'bashabisho_94', 'sandrasamirs3', 'ahmed_7000naser', 'ahmedhossiny', 'amrmohamedreda94', 'amr_m.attya']"
2,153,169,9,7,"['mahmoudsalah20114', 'bassantalhawary', 'ayahelmy_122', 'reham.a.gad', 'marmar8250', 'mennafarafero', 'karimosama1610']",161,"['nanohub168', 'mido_2010_amr94', 'yolyana.zekry', 'jvanjari', 'ayaaa.f.a', 'noryhankotb12', 'ahmednaser7000', 'nourhan', 'aa.maherr', 'ahmedelectricity1993y', 'mora.sameh2009', 'omarkhaledh95', 'm_osama_asu', 'ahmed_gamal1401', 'anan_alaa_95', 'bondo2a31193', 'mina_sameh95', 'kirollos_ernest', 'm.fouad.allam', 'hassan_elzahar', 'onedaymuer', 'muhammadatef100', 'shadyreda', 'mohabmagdyyoussef', 'aymanalaadin4', 'dondonetoiseau', 'mohmed_rf', 'wilhelm.piao.3', 'mikel.24.hour', 'lamiselhady7', 'screem_love3', 'mina', 'mohamed_adel6222', 'elfaramawytalaat', 'marwa.khaled.eng', 'yasserramadan940', 'saraalaa', 'waleedsmz94', 'besesh55', 'mina_mwgs', 'ayamostafa978', 'hoda_morshed375', 'wissamismailgp7', 'shamellotfy1966', 'flederico', 'fady', 'mimo_tm17', 'nouranalmorshedy', 'ossamakhalil60', 'elec.eng.heba', 'bishoy.medhat.elraheb', 'reallyanyidwuddo', 'mahmoudyoussif95', 'omar.abdulaziz94', 'nadowafa20', 'sh900301', 'shorta', 'srishti.d19', 'jbai14', '4omanko', 'mraafat', 'ahmedhisham1993', 'yasso_ahmed93', 'mernaroshdy95', 'rananader', 'mostafasabri466', 'tarekali1000', 'amirmrashad2', 'amrmeto', 'hany1166', 'emaan.ehaab', 'michaelhany33', 'sossa', 'tmnietzold', 'miro.marawan', 'mahmoudsaid471', 'mahmoud.said1919', 'ossedeek95', 'yomnamahmoud7', 'aveerai1', 'houjingyi2015', 'unjhenyj', 'dyaanasser2014', 'caboelkady94', 'nohabassem93', 'shaikhsaif', 'siddheshgajare91', 'jcollie8', 'k1l4ny', 'mhakmd', 'kholoud.ayman', 'yugy_mody2010', 'mhassan090944', 'ahmedakram9393', 'kouki', 'noor333aldeen333alkfree', 'hatem2030.hh', 'yifuliu', 'nourhanmohamed', 'saeeed3', 'mohd.samaha', 'hadeermansour242', 'omar_moataz13', 'rebo14101995', 'dkadiyal', 'shinobi', 'ahmedyasso93', 'wilhelmpiao', 'eman2015', 'hazem1', 'ibrahimelsayed999', 'noha1skeleton', 'mark_fayez.95', 'patseo', 'm_menna_95', 'ahmed94hamed', 'mariana.mounir', 'rmenon6', 'monyemoemy', 'yosif_diaa', 'zxiong5', 'halim', 'hisham', 'mnaguib345', 'arwaabdelaziz90', 'usufer', 'engmahmoud', 'tuliphany', 'anwar.alkallas', 'elmohnds.terika', 'zemo_22', 'nadahafez1672', 'mh009966', 'mh', 'bassem2006', 'tnietzol', 'beda_2010', 'geme3600', 'a7medelhelaly', 'mai_hegab', 'fatma.mouawad', 'mohamedaymanabdelsatar', 'ewais', 'shorrrta', 'fatma_batota', 'nadayoussef795', 'ninad.chamele', 'djjohn22', 'david.farag', 'eng.aalaa50', 'sergey.golovynskyi', 'amedo_emad', 'jzuo5', 'ma_go20092000', 'rimoz95', 'bashabisho_94', 'sandrasamirs3', 'ahmed_7000naser', 'ahmedhossiny', 'amrmohamedreda94', 'amr_m.attya']",2,"['samehmostafa', None]",170,"['nanohub168', 'mido_2010_amr94', 'yolyana.zekry', 'jvanjari', 'ayaaa.f.a', 'noryhankotb12', 'ahmednaser7000', 'nourhan', 'aa.maherr', 'ahmedelectricity1993y', 'mora.sameh2009', 'omarkhaledh95', 'm_osama_asu', 'ahmed_gamal1401', 'anan_alaa_95', 'bondo2a31193', 'mina_sameh95', 'kirollos_ernest', 'm.fouad.allam', 'hassan_elzahar', 'onedaymuer', 'muhammadatef100', 'shadyreda', 'mohabmagdyyoussef', 'aymanalaadin4', 'dondonetoiseau', 'mohmed_rf', 'wilhelm.piao.3', 'mikel.24.hour', 'lamiselhady7', 'screem_love3', 'mina', 'mohamed_adel6222', 'elfaramawytalaat', 'marwa.khaled.eng', 'reham.a.gad', 'yasserramadan940', 'saraalaa', 'waleedsmz94', 'besesh55', 'mina_mwgs', 'ayamostafa978', 'hoda_morshed375', 'wissamismailgp7', 'shamellotfy1966', 'flederico', 'fady', 'ayahelmy_122', 'mimo_tm17', 'nouranalmorshedy', 'ossamakhalil60', 'elec.eng.heba', 'bishoy.medhat.elraheb', 'karimosama1610', 'reallyanyidwuddo', 'mahmoudyoussif95', 'omar.abdulaziz94', 'nadowafa20', 'sh900301', 'mennafarafero', 'shorta', 'srishti.d19', 'jbai14', '4omanko', 'mraafat', 'ahmedhisham1993', 'yasso_ahmed93', 'mernaroshdy95', 'rananader', 'mostafasabri466', 'tarekali1000', 'amirmrashad2', 'amrmeto', 'hany1166', 'emaan.ehaab', 'michaelhany33', 'sossa', 'tmnietzold', 'miro.marawan', 'mahmoudsaid471', 'mahmoud.said1919', 'ossedeek95', 'yomnamahmoud7', 'aveerai1', 'mahmoudsalah20114', 'houjingyi2015', 'unjhenyj', 'dyaanasser2014', 'caboelkady94', 'nohabassem93', 'shaikhsaif', 'siddheshgajare91', 'jcollie8', 'k1l4ny', 'mhakmd', 'kholoud.ayman', 'yugy_mody2010', 'mhassan090944', 'bassantalhawary', 'ahmedakram9393', 'marmar8250', 'kouki', 'noor333aldeen333alkfree', 'hatem2030.hh', 'yifuliu', 'nourhanmohamed', 'saeeed3', 'mohd.samaha', 'hadeermansour242', 'omar_moataz13', 'rebo14101995', 'dkadiyal', 'shinobi', 'ahmedyasso93', 'wilhelmpiao', 'eman2015', 'hazem1', 'ibrahimelsayed999', 'noha1skeleton', 'mark_fayez.95', 'patseo', 'm_menna_95', 'ahmed94hamed', 'mariana.mounir', 'rmenon6', 'monyemoemy', 'yosif_diaa', 'zxiong5', 'halim', 'hisham', 'mnaguib345', 'arwaabdelaziz90', 'usufer', 'samehmostafa', 'engmahmoud', 'tuliphany', 'anwar.alkallas', 'elmohnds.terika', 'zemo_22', 'nadahafez1672', 'mh009966', 'mh', 'bassem2006', 'tnietzol', 'beda_2010', 'geme3600', 'a7medelhelaly', 'mai_hegab', 'fatma.mouawad', 'mohamedaymanabdelsatar', 'ewais', 'shorrrta', 'fatma_batota', 'nadayoussef795', 'ninad.chamele', 'djjohn22', 'david.farag', 'eng.aalaa50', 'sergey.golovynskyi', 'amedo_emad', None, 'jzuo5', 'ma_go20092000', 'rimoz95', 'bashabisho_94', 'sandrasamirs3', 'ahmed_7000naser', 'ahmedhossiny', 'amrmohamedreda94', 'amr_m.attya']"
2,9,169,8,4,"['tnietzol', 'jvanjari', 'jcollie8', 'tmnietzold']",164,"['nanohub168', 'mido_2010_amr94', 'yolyana.zekry', 'ayaaa.f.a', 'noryhankotb12', 'ahmednaser7000', 'nourhan', 'aa.maherr', 'ahmedelectricity1993y', 'mora.sameh2009', 'omarkhaledh95', 'm_osama_asu', 'ahmed_gamal1401', 'anan_alaa_95', 'bondo2a31193', 'mina_sameh95', 'kirollos_ernest', 'm.fouad.allam', 'hassan_elzahar', 'onedaymuer', 'muhammadatef100', 'shadyreda', 'mohabmagdyyoussef', 'aymanalaadin4', 'dondonetoiseau', 'mohmed_rf', 'wilhelm.piao.3', 'mikel.24.hour', 'lamiselhady7', 'screem_love3', 'mina', 'mohamed_adel6222', 'elfaramawytalaat', 'marwa.khaled.eng', 'reham.a.gad', 'yasserramadan940', 'saraalaa', 'waleedsmz94', 'besesh55', 'mina_mwgs', 'ayamostafa978', 'hoda_morshed375', 'wissamismailgp7', 'shamellotfy1966', 'flederico', 'fady', 'ayahelmy_122', 'mimo_tm17', 'nouranalmorshedy', 'ossamakhalil60', 'elec.eng.heba', 'bishoy.medhat.elraheb', 'karimosama1610', 'reallyanyidwuddo', 'mahmoudyoussif95', 'omar.abdulaziz94', 'nadowafa20', 'sh900301', 'mennafarafero', 'shorta', 'srishti.d19', 'jbai14', '4omanko', 'mraafat', 'ahmedhisham1993', 'yasso_ahmed93', 'mernaroshdy95', 'rananader', 'mostafasabri466', 'tarekali1000', 'amirmrashad2', 'amrmeto', 'hany1166', 'emaan.ehaab', 'michaelhany33', 'sossa', 'miro.marawan', 'mahmoudsaid471', 'mahmoud.said1919', 'ossedeek95', 'yomnamahmoud7', 'aveerai1', 'mahmoudsalah20114', 'houjingyi2015', 'unjhenyj', 'dyaanasser2014', 'caboelkady94', 'nohabassem93', 'shaikhsaif', 'siddheshgajare91', 'k1l4ny', 'mhakmd', 'kholoud.ayman', 'yugy_mody2010', 'mhassan090944', 'bassantalhawary', 'ahmedakram9393', 'marmar8250', 'kouki', 'noor333aldeen333alkfree', 'hatem2030.hh', 'yifuliu', 'nourhanmohamed', 'saeeed3', 'mohd.samaha', 'hadeermansour242', 'omar_moataz13', 'rebo14101995', 'dkadiyal', 'shinobi', 'ahmedyasso93', 'wilhelmpiao', 'eman2015', 'hazem1', 'ibrahimelsayed999', 'noha1skeleton', 'mark_fayez.95', 'patseo', 'm_menna_95', 'ahmed94hamed', 'mariana.mounir', 'rmenon6', 'monyemoemy', 'yosif_diaa', 'zxiong5', 'halim', 'hisham', 'mnaguib345', 'arwaabdelaziz90', 'usufer', 'engmahmoud', 'tuliphany', 'anwar.alkallas', 'elmohnds.terika', 'zemo_22', 'nadahafez1672', 'mh009966', 'mh', 'bassem2006', 'beda_2010', 'geme3600', 'a7medelhelaly', 'mai_hegab', 'fatma.mouawad', 'mohamedaymanabdelsatar', 'ewais', 'shorrrta', 'fatma_batota', 'nadayoussef795', 'ninad.chamele', 'djjohn22', 'david.farag', 'eng.aalaa50', 'sergey.golovynskyi', 'amedo_emad', 'jzuo5', 'ma_go20092000', 'rimoz95', 'bashabisho_94', 'sandrasamirs3', 'ahmed_7000naser', 'ahmedhossiny', 'amrmohamedreda94', 'amr_m.attya']",4,"['ferry', None, 'harshjain2691', 'sgajare']",172,"['nanohub168', 'mido_2010_amr94', 'yolyana.zekry', 'jvanjari', 'ayaaa.f.a', 'noryhankotb12', 'ahmednaser7000', 'nourhan', 'aa.maherr', 'ahmedelectricity1993y', 'mora.sameh2009', 'omarkhaledh95', 'm_osama_asu', 'ahmed_gamal1401', 'anan_alaa_95', 'bondo2a31193', 'mina_sameh95', 'kirollos_ernest', 'm.fouad.allam', 'hassan_elzahar', 'onedaymuer', 'muhammadatef100', 'shadyreda', 'mohabmagdyyoussef', 'aymanalaadin4', 'dondonetoiseau', 'mohmed_rf', 'wilhelm.piao.3', 'mikel.24.hour', 'lamiselhady7', 'screem_love3', 'mina', 'mohamed_adel6222', 'elfaramawytalaat', 'marwa.khaled.eng', 'reham.a.gad', 'yasserramadan940', 'saraalaa', 'waleedsmz94', 'besesh55', 'mina_mwgs', 'ayamostafa978', 'hoda_morshed375', 'wissamismailgp7', 'shamellotfy1966', 'harshjain2691', 'flederico', 'fady', 'ayahelmy_122', 'mimo_tm17', 'nouranalmorshedy', 'ossamakhalil60', 'elec.eng.heba', 'bishoy.medhat.elraheb', 'karimosama1610', 'reallyanyidwuddo', 'sgajare', 'mahmoudyoussif95', 'omar.abdulaziz94', 'nadowafa20', 'sh900301', 'mennafarafero', 'shorta', 'srishti.d19', 'jbai14', '4omanko', 'mraafat', 'ahmedhisham1993', 'yasso_ahmed93', 'mernaroshdy95', 'rananader', 'mostafasabri466', 'tarekali1000', 'amirmrashad2', 'amrmeto', 'hany1166', 'emaan.ehaab', 'michaelhany33', 'sossa', 'tmnietzold', 'miro.marawan', 'mahmoudsaid471', 'mahmoud.said1919', 'ossedeek95', 'yomnamahmoud7', 'aveerai1', 'mahmoudsalah20114', 'houjingyi2015', 'unjhenyj', 'dyaanasser2014', 'caboelkady94', 'nohabassem93', 'shaikhsaif', 'siddheshgajare91', 'jcollie8', 'k1l4ny', 'mhakmd', 'kholoud.ayman', 'yugy_mody2010', 'mhassan090944', 'bassantalhawary', 'ahmedakram9393', 'marmar8250', 'kouki', 'noor333aldeen333alkfree', 'hatem2030.hh', 'yifuliu', 'nourhanmohamed', 'saeeed3', 'mohd.samaha', 'hadeermansour242', 'omar_moataz13', 'rebo14101995', 'dkadiyal', 'shinobi', 'ahmedyasso93', 'wilhelmpiao', 'eman2015', 'hazem1', 'ibrahimelsayed999', 'noha1skeleton', 'mark_fayez.95', 'patseo', 'm_menna_95', 'ahmed94hamed', 'mariana.mounir', 'rmenon6', 'monyemoemy', 'yosif_diaa', 'zxiong5', 'halim', 'hisham', 'mnaguib345', 'arwaabdelaziz90', 'usufer', 'engmahmoud', 'tuliphany', 'anwar.alkallas', 'elmohnds.terika', 'zemo_22', 'nadahafez1672', 'mh009966', 'mh', 'bassem2006', 'tnietzol', 'beda_2010', 'geme3600', 'a7medelhelaly', 'mai_hegab', 'fatma.mouawad', 'mohamedaymanabdelsatar', 'ewais', 'shorrrta', 'fatma_batota', 'nadayoussef795', 'ninad.chamele', 'djjohn22', 'ferry', 'david.farag', 'eng.aalaa50', 'sergey.golovynskyi', 'amedo_emad', None, 'jzuo5', 'ma_go20092000', 'rimoz95', 'bashabisho_94', 'sandrasamirs3', 'ahmed_7000naser', 'ahmedhossiny', 'amrmohamedreda94', 'amr_m.attya']"
2,17,169,8,7,"['mai_hegab', 'ewais', 'elmohnds.terika', 'bondo2a31193', 'amirmrashad2', 'ahmedelectricity1993y', 'm_menna_95']",161,"['nanohub168', 'mido_2010_amr94', 'yolyana.zekry', 'jvanjari', 'ayaaa.f.a', 'noryhankotb12', 'ahmednaser7000', 'nourhan', 'aa.maherr', 'mora.sameh2009', 'omarkhaledh95', 'm_osama_asu', 'ahmed_gamal1401', 'anan_alaa_95', 'mina_sameh95', 'kirollos_ernest', 'm.fouad.allam', 'hassan_elzahar', 'onedaymuer', 'muhammadatef100', 'shadyreda', 'mohabmagdyyoussef', 'aymanalaadin4', 'dondonetoiseau', 'mohmed_rf', 'wilhelm.piao.3', 'mikel.24.hour', 'lamiselhady7', 'screem_love3', 'mina', 'mohamed_adel6222', 'elfaramawytalaat', 'marwa.khaled.eng', 'reham.a.gad', 'yasserramadan940', 'saraalaa', 'waleedsmz94', 'besesh55', 'mina_mwgs', 'ayamostafa978', 'hoda_morshed375', 'wissamismailgp7', 'shamellotfy1966', 'flederico', 'fady', 'ayahelmy_122', 'mimo_tm17', 'nouranalmorshedy', 'ossamakhalil60', 'elec.eng.heba', 'bishoy.medhat.elraheb', 'karimosama1610', 'reallyanyidwuddo', 'mahmoudyoussif95', 'omar.abdulaziz94', 'nadowafa20', 'sh900301', 'mennafarafero', 'shorta', 'srishti.d19', 'jbai14', '4omanko', 'mraafat', 'ahmedhisham1993', 'yasso_ahmed93', 'mernaroshdy95', 'rananader', 'mostafasabri466', 'tarekali1000', 'amrmeto', 'hany1166', 'emaan.ehaab', 'michaelhany33', 'sossa', 'tmnietzold', 'miro.marawan', 'mahmoudsaid471', 'mahmoud.said1919', 'ossedeek95', 'yomnamahmoud7', 'aveerai1', 'mahmoudsalah20114', 'houjingyi2015', 'unjhenyj', 'dyaanasser2014', 'caboelkady94', 'nohabassem93', 'shaikhsaif', 'siddheshgajare91', 'jcollie8', 'k1l4ny', 'mhakmd', 'kholoud.ayman', 'yugy_mody2010', 'mhassan090944', 'bassantalhawary', 'ahmedakram9393', 'marmar8250', 'kouki', 'noor333aldeen333alkfree', 'hatem2030.hh', 'yifuliu', 'nourhanmohamed', 'saeeed3', 'mohd.samaha', 'hadeermansour242', 'omar_moataz13', 'rebo14101995', 'dkadiyal', 'shinobi', 'ahmedyasso93', 'wilhelmpiao', 'eman2015', 'hazem1', 'ibrahimelsayed999', 'noha1skeleton', 'mark_fayez.95', 'patseo', 'ahmed94hamed', 'mariana.mounir', 'rmenon6', 'monyemoemy', 'yosif_diaa', 'zxiong5', 'halim', 'hisham', 'mnaguib345', 'arwaabdelaziz90', 'usufer', 'engmahmoud', 'tuliphany', 'anwar.alkallas', 'zemo_22', 'nadahafez1672', 'mh009966', 'mh', 'bassem2006', 'tnietzol', 'beda_2010', 'geme3600', 'a7medelhelaly', 'fatma.mouawad', 'mohamedaymanabdelsatar', 'shorrrta', 'fatma_batota', 'nadayoussef795', 'ninad.chamele', 'djjohn22', 'david.farag', 'eng.aalaa50', 'sergey.golovynskyi', 'amedo_emad', 'jzuo5', 'ma_go20092000', 'rimoz95', 'bashabisho_94', 'sandrasamirs3', 'ahmed_7000naser', 'ahmedhossiny', 'amrmohamedreda94', 'amr_m.attya']",1,[None],169,"['nanohub168', 'mido_2010_amr94', 'yolyana.zekry', 'jvanjari', 'ayaaa.f.a', 'noryhankotb12', 'ahmednaser7000', 'nourhan', 'aa.maherr', 'ahmedelectricity1993y', 'mora.sameh2009', 'omarkhaledh95', 'm_osama_asu', 'ahmed_gamal1401', 'anan_alaa_95', 'bondo2a31193', 'mina_sameh95', 'kirollos_ernest', 'm.fouad.allam', 'hassan_elzahar', 'onedaymuer', 'muhammadatef100', 'shadyreda', 'mohabmagdyyoussef', 'aymanalaadin4', 'dondonetoiseau', 'mohmed_rf', 'wilhelm.piao.3', 'mikel.24.hour', 'lamiselhady7', 'screem_love3', 'mina', 'mohamed_adel6222', 'elfaramawytalaat', 'marwa.khaled.eng', 'reham.a.gad', 'yasserramadan940', 'saraalaa', 'waleedsmz94', 'besesh55', 'mina_mwgs', 'ayamostafa978', 'hoda_morshed375', 'wissamismailgp7', 'shamellotfy1966', 'flederico', 'fady', 'ayahelmy_122', 'mimo_tm17', 'nouranalmorshedy', 'ossamakhalil60', 'elec.eng.heba', 'bishoy.medhat.elraheb', 'karimosama1610', 'reallyanyidwuddo', 'mahmoudyoussif95', 'omar.abdulaziz94', 'nadowafa20', 'sh900301', 'mennafarafero', 'shorta', 'srishti.d19', 'jbai14', '4omanko', 'mraafat', 'ahmedhisham1993', 'yasso_ahmed93', 'mernaroshdy95', 'rananader', 'mostafasabri466', 'tarekali1000', 'amirmrashad2', 'amrmeto', 'hany1166', 'emaan.ehaab', 'michaelhany33', 'sossa', 'tmnietzold', 'miro.marawan', 'mahmoudsaid471', 'mahmoud.said1919', 'ossedeek95', 'yomnamahmoud7', 'aveerai1', 'mahmoudsalah20114', 'houjingyi2015', 'unjhenyj', 'dyaanasser2014', 'caboelkady94', 'nohabassem93', 'shaikhsaif', 'siddheshgajare91', 'jcollie8', 'k1l4ny', 'mhakmd', 'kholoud.ayman', 'yugy_mody2010', 'mhassan090944', 'bassantalhawary', 'ahmedakram9393', 'marmar8250', 'kouki', 'noor333aldeen333alkfree', 'hatem2030.hh', 'yifuliu', 'nourhanmohamed', 'saeeed3', 'mohd.samaha', 'hadeermansour242', 'omar_moataz13', 'rebo14101995', 'dkadiyal', 'shinobi', 'ahmedyasso93', 'wilhelmpiao', 'eman2015', 'hazem1', 'ibrahimelsayed999', 'noha1skeleton', 'mark_fayez.95', 'patseo', 'm_menna_95', 'ahmed94hamed', 'mariana.mounir', 'rmenon6', 'monyemoemy', 'yosif_diaa', 'zxiong5', 'halim', 'hisham', 'mnaguib345', 'arwaabdelaziz90', 'usufer', 'engmahmoud', 'tuliphany', 'anwar.alkallas', 'elmohnds.terika', 'zemo_22', 'nadahafez1672', 'mh009966', 'mh', 'bassem2006', 'tnietzol', 'beda_2010', 'geme3600', 'a7medelhelaly', 'mai_hegab', 'fatma.mouawad', 'mohamedaymanabdelsatar', 'ewais', 'shorrrta', 'fatma_batota', 'nadayoussef795', 'ninad.chamele', 'djjohn22', 'david.farag', 'eng.aalaa50', 'sergey.golovynskyi', 'amedo_emad', None, 'jzuo5', 'ma_go20092000', 'rimoz95', 'bashabisho_94', 'sandrasamirs3', 'ahmed_7000naser', 'ahmedhossiny', 'amrmohamedreda94', 'amr_m.attya']"
2,10,169,7,5,"['jvanjari', 'shaikhsaif', 'jcollie8', 'tnietzol', 'jbai14']",163,"['nanohub168', 'mido_2010_amr94', 'yolyana.zekry', 'ayaaa.f.a', 'noryhankotb12', 'ahmednaser7000', 'nourhan', 'aa.maherr', 'ahmedelectricity1993y', 'mora.sameh2009', 'omarkhaledh95', 'm_osama_asu', 'ahmed_gamal1401', 'anan_alaa_95', 'bondo2a31193', 'mina_sameh95', 'kirollos_ernest', 'm.fouad.allam', 'hassan_elzahar', 'onedaymuer', 'muhammadatef100', 'shadyreda', 'mohabmagdyyoussef', 'aymanalaadin4', 'dondonetoiseau', 'mohmed_rf', 'wilhelm.piao.3', 'mikel.24.hour', 'lamiselhady7', 'screem_love3', 'mina', 'mohamed_adel6222', 'elfaramawytalaat', 'marwa.khaled.eng', 'reham.a.gad', 'yasserramadan940', 'saraalaa', 'waleedsmz94', 'besesh55', 'mina_mwgs', 'ayamostafa978', 'hoda_morshed375', 'wissamismailgp7', 'shamellotfy1966', 'flederico', 'fady', 'ayahelmy_122', 'mimo_tm17', 'nouranalmorshedy', 'ossamakhalil60', 'elec.eng.heba', 'bishoy.medhat.elraheb', 'karimosama1610', 'reallyanyidwuddo', 'mahmoudyoussif95', 'omar.abdulaziz94', 'nadowafa20', 'sh900301', 'mennafarafero', 'shorta', 'srishti.d19', '4omanko', 'mraafat', 'ahmedhisham1993', 'yasso_ahmed93', 'mernaroshdy95', 'rananader', 'mostafasabri466', 'tarekali1000', 'amirmrashad2', 'amrmeto', 'hany1166', 'emaan.ehaab', 'michaelhany33', 'sossa', 'tmnietzold', 'miro.marawan', 'mahmoudsaid471', 'mahmoud.said1919', 'ossedeek95', 'yomnamahmoud7', 'aveerai1', 'mahmoudsalah20114', 'houjingyi2015', 'unjhenyj', 'dyaanasser2014', 'caboelkady94', 'nohabassem93', 'siddheshgajare91', 'k1l4ny', 'mhakmd', 'kholoud.ayman', 'yugy_mody2010', 'mhassan090944', 'bassantalhawary', 'ahmedakram9393', 'marmar8250', 'kouki', 'noor333aldeen333alkfree', 'hatem2030.hh', 'yifuliu', 'nourhanmohamed', 'saeeed3', 'mohd.samaha', 'hadeermansour242', 'omar_moataz13', 'rebo14101995', 'dkadiyal', 'shinobi', 'ahmedyasso93', 'wilhelmpiao', 'eman2015', 'hazem1', 'ibrahimelsayed999', 'noha1skeleton', 'mark_fayez.95', 'patseo', 'm_menna_95', 'ahmed94hamed', 'mariana.mounir', 'rmenon6', 'monyemoemy', 'yosif_diaa', 'zxiong5', 'halim', 'hisham', 'mnaguib345', 'arwaabdelaziz90', 'usufer', 'engmahmoud', 'tuliphany', 'anwar.alkallas', 'elmohnds.terika', 'zemo_22', 'nadahafez1672', 'mh009966', 'mh', 'bassem2006', 'beda_2010', 'geme3600', 'a7medelhelaly', 'mai_hegab', 'fatma.mouawad', 'mohamedaymanabdelsatar', 'ewais', 'shorrrta', 'fatma_batota', 'nadayoussef795', 'ninad.chamele', 'djjohn22', 'david.farag', 'eng.aalaa50', 'sergey.golovynskyi', 'amedo_emad', 'jzuo5', 'ma_go20092000', 'rimoz95', 'bashabisho_94', 'sandrasamirs3', 'ahmed_7000naser', 'ahmedhossiny', 'amrmohamedreda94', 'amr_m.attya']",2,"[None, 'harshjain2691']",170,"['nanohub168', 'mido_2010_amr94', 'yolyana.zekry', 'jvanjari', 'ayaaa.f.a', 'noryhankotb12', 'ahmednaser7000', 'nourhan', 'aa.maherr', 'ahmedelectricity1993y', 'mora.sameh2009', 'omarkhaledh95', 'm_osama_asu', 'ahmed_gamal1401', 'anan_alaa_95', 'bondo2a31193', 'mina_sameh95', 'kirollos_ernest', 'm.fouad.allam', 'hassan_elzahar', 'onedaymuer', 'muhammadatef100', 'shadyreda', 'mohabmagdyyoussef', 'aymanalaadin4', 'dondonetoiseau', 'mohmed_rf', 'wilhelm.piao.3', 'mikel.24.hour', 'lamiselhady7', 'screem_love3', 'mina', 'mohamed_adel6222', 'elfaramawytalaat', 'marwa.khaled.eng', 'reham.a.gad', 'yasserramadan940', 'saraalaa', 'waleedsmz94', 'besesh55', 'mina_mwgs', 'ayamostafa978', 'hoda_morshed375', 'wissamismailgp7', 'shamellotfy1966', 'harshjain2691', 'flederico', 'fady', 'ayahelmy_122', 'mimo_tm17', 'nouranalmorshedy', 'ossamakhalil60', 'elec.eng.heba', 'bishoy.medhat.elraheb', 'karimosama1610', 'reallyanyidwuddo', 'mahmoudyoussif95', 'omar.abdulaziz94', 'nadowafa20', 'sh900301', 'mennafarafero', 'shorta', 'srishti.d19', 'jbai14', '4omanko', 'mraafat', 'ahmedhisham1993', 'yasso_ahmed93', 'mernaroshdy95', 'rananader', 'mostafasabri466', 'tarekali1000', 'amirmrashad2', 'amrmeto', 'hany1166', 'emaan.ehaab', 'michaelhany33', 'sossa', 'tmnietzold', 'miro.marawan', 'mahmoudsaid471', 'mahmoud.said1919', 'ossedeek95', 'yomnamahmoud7', 'aveerai1', 'mahmoudsalah20114', 'houjingyi2015', 'unjhenyj', 'dyaanasser2014', 'caboelkady94', 'nohabassem93', 'shaikhsaif', 'siddheshgajare91', 'jcollie8', 'k1l4ny', 'mhakmd', 'kholoud.ayman', 'yugy_mody2010', 'mhassan090944', 'bassantalhawary', 'ahmedakram9393', 'marmar8250', 'kouki', 'noor333aldeen333alkfree', 'hatem2030.hh', 'yifuliu', 'nourhanmohamed', 'saeeed3', 'mohd.samaha', 'hadeermansour242', 'omar_moataz13', 'rebo14101995', 'dkadiyal', 'shinobi', 'ahmedyasso93', 'wilhelmpiao', 'eman2015', 'hazem1', 'ibrahimelsayed999', 'noha1skeleton', 'mark_fayez.95', 'patseo', 'm_menna_95', 'ahmed94hamed', 'mariana.mounir', 'rmenon6', 'monyemoemy', 'yosif_diaa', 'zxiong5', 'halim', 'hisham', 'mnaguib345', 'arwaabdelaziz90', 'usufer', 'engmahmoud', 'tuliphany', 'anwar.alkallas', 'elmohnds.terika', 'zemo_22', 'nadahafez1672', 'mh009966', 'mh', 'bassem2006', 'tnietzol', 'beda_2010', 'geme3600', 'a7medelhelaly', 'mai_hegab', 'fatma.mouawad', 'mohamedaymanabdelsatar', 'ewais', 'shorrrta', 'fatma_batota', 'nadayoussef795', 'ninad.chamele', 'djjohn22', 'david.farag', 'eng.aalaa50', 'sergey.golovynskyi', 'amedo_emad', None, 'jzuo5', 'ma_go20092000', 'rimoz95', 'bashabisho_94', 'sandrasamirs3', 'ahmed_7000naser', 'ahmedhossiny', 'amrmohamedreda94', 'amr_m.attya']"
2,11,169,7,5,"['mora.sameh2009', 'anan_alaa_95', 'dondonetoiseau', 'kouki', 'shinobi']",163,"['nanohub168', 'mido_2010_amr94', 'yolyana.zekry', 'jvanjari', 'ayaaa.f.a', 'noryhankotb12', 'ahmednaser7000', 'nourhan', 'aa.maherr', 'ahmedelectricity1993y', 'omarkhaledh95', 'm_osama_asu', 'ahmed_gamal1401', 'bondo2a31193', 'mina_sameh95', 'kirollos_ernest', 'm.fouad.allam', 'hassan_elzahar', 'onedaymuer', 'muhammadatef100', 'shadyreda', 'mohabmagdyyoussef', 'aymanalaadin4', 'mohmed_rf', 'wilhelm.piao.3', 'mikel.24.hour', 'lamiselhady7', 'screem_love3', 'mina', 'mohamed_adel6222', 'elfaramawytalaat', 'marwa.khaled.eng', 'reham.a.gad', 'yasserramadan940', 'saraalaa', 'waleedsmz94', 'besesh55', 'mina_mwgs', 'ayamostafa978', 'hoda_morshed375', 'wissamismailgp7', 'shamellotfy1966', 'flederico', 'fady', 'ayahelmy_122', 'mimo_tm17', 'nouranalmorshedy', 'ossamakhalil60', 'elec.eng.heba', 'bishoy.medhat.elraheb', 'karimosama1610', 'reallyanyidwuddo', 'mahmoudyoussif95', 'omar.abdulaziz94', 'nadowafa20', 'sh900301', 'mennafarafero', 'shorta', 'srishti.d19', 'jbai14', '4omanko', 'mraafat', 'ahmedhisham1993', 'yasso_ahmed93', 'mernaroshdy95', 'rananader', 'mostafasabri466', 'tarekali1000', 'amirmrashad2', 'amrmeto', 'hany1166', 'emaan.ehaab', 'michaelhany33', 'sossa', 'tmnietzold', 'miro.marawan', 'mahmoudsaid471', 'mahmoud.said1919', 'ossedeek95', 'yomnamahmoud7', 'aveerai1', 'mahmoudsalah20114', 'houjingyi2015', 'unjhenyj', 'dyaanasser2014', 'caboelkady94', 'nohabassem93', 'shaikhsaif', 'siddheshgajare91', 'jcollie8', 'k1l4ny', 'mhakmd', 'kholoud.ayman', 'yugy_mody2010', 'mhassan090944', 'bassantalhawary', 'ahmedakram9393', 'marmar8250', 'noor333aldeen333alkfree', 'hatem2030.hh', 'yifuliu', 'nourhanmohamed', 'saeeed3', 'mohd.samaha', 'hadeermansour242', 'omar_moataz13', 'rebo14101995', 'dkadiyal', 'ahmedyasso93', 'wilhelmpiao', 'eman2015', 'hazem1', 'ibrahimelsayed999', 'noha1skeleton', 'mark_fayez.95', 'patseo', 'm_menna_95', 'ahmed94hamed', 'mariana.mounir', 'rmenon6', 'monyemoemy', 'yosif_diaa', 'zxiong5', 'halim', 'hisham', 'mnaguib345', 'arwaabdelaziz90', 'usufer', 'engmahmoud', 'tuliphany', 'anwar.alkallas', 'elmohnds.terika', 'zemo_22', 'nadahafez1672', 'mh009966', 'mh', 'bassem2006', 'tnietzol', 'beda_2010', 'geme3600', 'a7medelhelaly', 'mai_hegab', 'fatma.mouawad', 'mohamedaymanabdelsatar', 'ewais', 'shorrrta', 'fatma_batota', 'nadayoussef795', 'ninad.chamele', 'djjohn22', 'david.farag', 'eng.aalaa50', 'sergey.golovynskyi', 'amedo_emad', 'jzuo5', 'ma_go20092000', 'rimoz95', 'bashabisho_94', 'sandrasamirs3', 'ahmed_7000naser', 'ahmedhossiny', 'amrmohamedreda94', 'amr_m.attya']",2,"[None, 'merna.salahh']",170,"['nanohub168', 'mido_2010_amr94', 'yolyana.zekry', 'jvanjari', 'ayaaa.f.a', 'noryhankotb12', 'ahmednaser7000', 'nourhan', 'aa.maherr', 'ahmedelectricity1993y', 'mora.sameh2009', 'omarkhaledh95', 'm_osama_asu', 'ahmed_gamal1401', 'anan_alaa_95', 'bondo2a31193', 'mina_sameh95', 'kirollos_ernest', 'm.fouad.allam', 'hassan_elzahar', 'onedaymuer', 'muhammadatef100', 'shadyreda', 'mohabmagdyyoussef', 'aymanalaadin4', 'dondonetoiseau', 'mohmed_rf', 'wilhelm.piao.3', 'mikel.24.hour', 'lamiselhady7', 'screem_love3', 'mina', 'mohamed_adel6222', 'elfaramawytalaat', 'marwa.khaled.eng', 'reham.a.gad', 'yasserramadan940', 'saraalaa', 'waleedsmz94', 'besesh55', 'mina_mwgs', 'ayamostafa978', 'hoda_morshed375', 'wissamismailgp7', 'shamellotfy1966', 'flederico', 'fady', 'ayahelmy_122', 'mimo_tm17', 'nouranalmorshedy', 'ossamakhalil60', 'elec.eng.heba', 'bishoy.medhat.elraheb', 'karimosama1610', 'reallyanyidwuddo', 'mahmoudyoussif95', 'omar.abdulaziz94', 'nadowafa20', 'sh900301', 'mennafarafero', 'shorta', 'srishti.d19', 'jbai14', '4omanko', 'mraafat', 'ahmedhisham1993', 'yasso_ahmed93', 'mernaroshdy95', 'rananader', 'mostafasabri466', 'tarekali1000', 'amirmrashad2', 'amrmeto', 'hany1166', 'emaan.ehaab', 'michaelhany33', 'sossa', 'tmnietzold', 'miro.marawan', 'mahmoudsaid471', 'mahmoud.said1919', 'ossedeek95', 'yomnamahmoud7', 'aveerai1', 'mahmoudsalah20114', 'houjingyi2015', 'unjhenyj', 'dyaanasser2014', 'caboelkady94', 'nohabassem93', 'shaikhsaif', 'siddheshgajare91', 'jcollie8', 'k1l4ny', 'mhakmd', 'kholoud.ayman', 'yugy_mody2010', 'mhassan090944', 'bassantalhawary', 'ahmedakram9393', 'marmar8250', 'kouki', 'noor333aldeen333alkfree', 'hatem2030.hh', 'yifuliu', 'nourhanmohamed', 'saeeed3', 'mohd.samaha', 'hadeermansour242', 'omar_moataz13', 'rebo14101995', 'merna.salahh', 'dkadiyal', 'shinobi', 'ahmedyasso93', 'wilhelmpiao', 'eman2015', 'hazem1', 'ibrahimelsayed999', 'noha1skeleton', 'mark_fayez.95', 'patseo', 'm_menna_95', 'ahmed94hamed', 'mariana.mounir', 'rmenon6', 'monyemoemy', 'yosif_diaa', 'zxiong5', 'halim', 'hisham', 'mnaguib345', 'arwaabdelaziz90', 'usufer', 'engmahmoud', 'tuliphany', 'anwar.alkallas', 'elmohnds.terika', 'zemo_22', 'nadahafez1672', 'mh009966', 'mh', 'bassem2006', 'tnietzol', 'beda_2010', 'geme3600', 'a7medelhelaly', 'mai_hegab', 'fatma.mouawad', 'mohamedaymanabdelsatar', 'ewais', 'shorrrta', 'fatma_batota', 'nadayoussef795', 'ninad.chamele', 'djjohn22', 'david.farag', 'eng.aalaa50', 'sergey.golovynskyi', 'amedo_emad', None, 'jzuo5', 'ma_go20092000', 'rimoz95', 'bashabisho_94', 'sandrasamirs3', 'ahmed_7000naser', 'ahmedhossiny', 'amrmohamedreda94', 'amr_m.attya']"
2,14,169,7,5,"['mahmoudsalah20114', 'omar.abdulaziz94', 'anan_alaa_95', 'dondonetoiseau', 'nouranalmorshedy']",163,"['nanohub168', 'mido_2010_amr94', 'yolyana.zekry', 'jvanjari', 'ayaaa.f.a', 'noryhankotb12', 'ahmednaser7000', 'nourhan', 'aa.maherr', 'ahmedelectricity1993y', 'mora.sameh2009', 'omarkhaledh95', 'm_osama_asu', 'ahmed_gamal1401', 'bondo2a31193', 'mina_sameh95', 'kirollos_ernest', 'm.fouad.allam', 'hassan_elzahar', 'onedaymuer', 'muhammadatef100', 'shadyreda', 'mohabmagdyyoussef', 'aymanalaadin4', 'mohmed_rf', 'wilhelm.piao.3', 'mikel.24.hour', 'lamiselhady7', 'screem_love3', 'mina', 'mohamed_adel6222', 'elfaramawytalaat', 'marwa.khaled.eng', 'reham.a.gad', 'yasserramadan940', 'saraalaa', 'waleedsmz94', 'besesh55', 'mina_mwgs', 'ayamostafa978', 'hoda_morshed375', 'wissamismailgp7', 'shamellotfy1966', 'flederico', 'fady', 'ayahelmy_122', 'mimo_tm17', 'ossamakhalil60', 'elec.eng.heba', 'bishoy.medhat.elraheb', 'karimosama1610', 'reallyanyidwuddo', 'mahmoudyoussif95', 'nadowafa20', 'sh900301', 'mennafarafero', 'shorta', 'srishti.d19', 'jbai14', '4omanko', 'mraafat', 'ahmedhisham1993', 'yasso_ahmed93', 'mernaroshdy95', 'rananader', 'mostafasabri466', 'tarekali1000', 'amirmrashad2', 'amrmeto', 'hany1166', 'emaan.ehaab', 'michaelhany33', 'sossa', 'tmnietzold', 'miro.marawan', 'mahmoudsaid471', 'mahmoud.said1919', 'ossedeek95', 'yomnamahmoud7', 'aveerai1', 'houjingyi2015', 'unjhenyj', 'dyaanasser2014', 'caboelkady94', 'nohabassem93', 'shaikhsaif', 'siddheshgajare91', 'jcollie8', 'k1l4ny', 'mhakmd', 'kholoud.ayman', 'yugy_mody2010', 'mhassan090944', 'bassantalhawary', 'ahmedakram9393', 'marmar8250', 'kouki', 'noor333aldeen333alkfree', 'hatem2030.hh', 'yifuliu', 'nourhanmohamed', 'saeeed3', 'mohd.samaha', 'hadeermansour242', 'omar_moataz13', 'rebo14101995', 'dkadiyal', 'shinobi', 'ahmedyasso93', 'wilhelmpiao', 'eman2015', 'hazem1', 'ibrahimelsayed999', 'noha1skeleton', 'mark_fayez.95', 'patseo', 'm_menna_95', 'ahmed94hamed', 'mariana.mounir', 'rmenon6', 'monyemoemy', 'yosif_diaa', 'zxiong5', 'halim', 'hisham', 'mnaguib345', 'arwaabdelaziz90', 'usufer', 'engmahmoud', 'tuliphany', 'anwar.alkallas', 'elmohnds.terika', 'zemo_22', 'nadahafez1672', 'mh009966', 'mh', 'bassem2006', 'tnietzol', 'beda_2010', 'geme3600', 'a7medelhelaly', 'mai_hegab', 'fatma.mouawad', 'mohamedaymanabdelsatar', 'ewais', 'shorrrta', 'fatma_batota', 'nadayoussef795', 'ninad.chamele', 'djjohn22', 'david.farag', 'eng.aalaa50', 'sergey.golovynskyi', 'amedo_emad', 'jzuo5', 'ma_go20092000', 'rimoz95', 'bashabisho_94', 'sandrasamirs3', 'ahmed_7000naser', 'ahmedhossiny', 'amrmohamedreda94', 'amr_m.attya']",2,"['egamal777', None]",170,"['nanohub168', 'egamal777', 'mido_2010_amr94', 'yolyana.zekry', 'jvanjari', 'ayaaa.f.a', 'noryhankotb12', 'ahmednaser7000', 'nourhan', 'aa.maherr', 'ahmedelectricity1993y', 'mora.sameh2009', 'omarkhaledh95', 'm_osama_asu', 'ahmed_gamal1401', 'anan_alaa_95', 'bondo2a31193', 'mina_sameh95', 'kirollos_ernest', 'm.fouad.allam', 'hassan_elzahar', 'onedaymuer', 'muhammadatef100', 'shadyreda', 'mohabmagdyyoussef', 'aymanalaadin4', 'dondonetoiseau', 'mohmed_rf', 'wilhelm.piao.3', 'mikel.24.hour', 'lamiselhady7', 'screem_love3', 'mina', 'mohamed_adel6222', 'elfaramawytalaat', 'marwa.khaled.eng', 'reham.a.gad', 'yasserramadan940', 'saraalaa', 'waleedsmz94', 'besesh55', 'mina_mwgs', 'ayamostafa978', 'hoda_morshed375', 'wissamismailgp7', 'shamellotfy1966', 'flederico', 'fady', 'ayahelmy_122', 'mimo_tm17', 'nouranalmorshedy', 'ossamakhalil60', 'elec.eng.heba', 'bishoy.medhat.elraheb', 'karimosama1610', 'reallyanyidwuddo', 'mahmoudyoussif95', 'omar.abdulaziz94', 'nadowafa20', 'sh900301', 'mennafarafero', 'shorta', 'srishti.d19', 'jbai14', '4omanko', 'mraafat', 'ahmedhisham1993', 'yasso_ahmed93', 'mernaroshdy95', 'rananader', 'mostafasabri466', 'tarekali1000', 'amirmrashad2', 'amrmeto', 'hany1166', 'emaan.ehaab', 'michaelhany33', 'sossa', 'tmnietzold', 'miro.marawan', 'mahmoudsaid471', 'mahmoud.said1919', 'ossedeek95', 'yomnamahmoud7', 'aveerai1', 'mahmoudsalah20114', 'houjingyi2015', 'unjhenyj', 'dyaanasser2014', 'caboelkady94', 'nohabassem93', 'shaikhsaif', 'siddheshgajare91', 'jcollie8', 'k1l4ny', 'mhakmd', 'kholoud.ayman', 'yugy_mody2010', 'mhassan090944', 'bassantalhawary', 'ahmedakram9393', 'marmar8250', 'kouki', 'noor333aldeen333alkfree', 'hatem2030.hh', 'yifuliu', 'nourhanmohamed', 'saeeed3', 'mohd.samaha', 'hadeermansour242', 'omar_moataz13', 'rebo14101995', 'dkadiyal', 'shinobi', 'ahmedyasso93', 'wilhelmpiao', 'eman2015', 'hazem1', 'ibrahimelsayed999', 'noha1skeleton', 'mark_fayez.95', 'patseo', 'm_menna_95', 'ahmed94hamed', 'mariana.mounir', 'rmenon6', 'monyemoemy', 'yosif_diaa', 'zxiong5', 'halim', 'hisham', 'mnaguib345', 'arwaabdelaziz90', 'usufer', 'engmahmoud', 'tuliphany', 'anwar.alkallas', 'elmohnds.terika', 'zemo_22', 'nadahafez1672', 'mh009966', 'mh', 'bassem2006', 'tnietzol', 'beda_2010', 'geme3600', 'a7medelhelaly', 'mai_hegab', 'fatma.mouawad', 'mohamedaymanabdelsatar', 'ewais', 'shorrrta', 'fatma_batota', 'nadayoussef795', 'ninad.chamele', 'djjohn22', 'david.farag', 'eng.aalaa50', 'sergey.golovynskyi', 'amedo_emad', None, 'jzuo5', 'ma_go20092000', 'rimoz95', 'bashabisho_94', 'sandrasamirs3', 'ahmed_7000naser', 'ahmedhossiny', 'amrmohamedreda94', 'amr_m.attya']"
2,217,169,7,1,['hazem1'],167,"['nanohub168', 'mido_2010_amr94', 'yolyana.zekry', 'jvanjari', 'ayaaa.f.a', 'noryhankotb12', 'ahmednaser7000', 'nourhan', 'aa.maherr', 'ahmedelectricity1993y', 'mora.sameh2009', 'omarkhaledh95', 'm_osama_asu', 'ahmed_gamal1401', 'anan_alaa_95', 'bondo2a31193', 'mina_sameh95', 'kirollos_ernest', 'm.fouad.allam', 'hassan_elzahar', 'onedaymuer', 'muhammadatef100', 'shadyreda', 'mohabmagdyyoussef', 'aymanalaadin4', 'dondonetoiseau', 'mohmed_rf', 'wilhelm.piao.3', 'mikel.24.hour', 'lamiselhady7', 'screem_love3', 'mina', 'mohamed_adel6222', 'elfaramawytalaat', 'marwa.khaled.eng', 'reham.a.gad', 'yasserramadan940', 'saraalaa', 'waleedsmz94', 'besesh55', 'mina_mwgs', 'ayamostafa978', 'hoda_morshed375', 'wissamismailgp7', 'shamellotfy1966', 'flederico', 'fady', 'ayahelmy_122', 'mimo_tm17', 'nouranalmorshedy', 'ossamakhalil60', 'elec.eng.heba', 'bishoy.medhat.elraheb', 'karimosama1610', 'reallyanyidwuddo', 'mahmoudyoussif95', 'omar.abdulaziz94', 'nadowafa20', 'sh900301', 'mennafarafero', 'shorta', 'srishti.d19', 'jbai14', '4omanko', 'mraafat', 'ahmedhisham1993', 'yasso_ahmed93', 'mernaroshdy95', 'rananader', 'mostafasabri466', 'tarekali1000', 'amirmrashad2', 'amrmeto', 'hany1166', 'emaan.ehaab', 'michaelhany33', 'sossa', 'tmnietzold', 'miro.marawan', 'mahmoudsaid471', 'mahmoud.said1919', 'ossedeek95', 'yomnamahmoud7', 'aveerai1', 'mahmoudsalah20114', 'houjingyi2015', 'unjhenyj', 'dyaanasser2014', 'caboelkady94', 'nohabassem93', 'shaikhsaif', 'siddheshgajare91', 'jcollie8', 'k1l4ny', 'mhakmd', 'kholoud.ayman', 'yugy_mody2010', 'mhassan090944', 'bassantalhawary', 'ahmedakram9393', 'marmar8250', 'kouki', 'noor333aldeen333alkfree', 'hatem2030.hh', 'yifuliu', 'nourhanmohamed', 'saeeed3', 'mohd.samaha', 'hadeermansour242', 'omar_moataz13', 'rebo14101995', 'dkadiyal', 'shinobi', 'ahmedyasso93', 'wilhelmpiao', 'eman2015', 'ibrahimelsayed999', 'noha1skeleton', 'mark_fayez.95', 'patseo', 'm_menna_95', 'ahmed94hamed', 'mariana.mounir', 'rmenon6', 'monyemoemy', 'yosif_diaa', 'zxiong5', 'halim', 'hisham', 'mnaguib345', 'arwaabdelaziz90', 'usufer', 'engmahmoud', 'tuliphany', 'anwar.alkallas', 'elmohnds.terika', 'zemo_22', 'nadahafez1672', 'mh009966', 'mh', 'bassem2006', 'tnietzol', 'beda_2010', 'geme3600', 'a7medelhelaly', 'mai_hegab', 'fatma.mouawad', 'mohamedaymanabdelsatar', 'ewais', 'shorrrta', 'fatma_batota', 'nadayoussef795', 'ninad.chamele', 'djjohn22', 'david.farag', 'eng.aalaa50', 'sergey.golovynskyi', 'amedo_emad', 'jzuo5', 'ma_go20092000', 'rimoz95', 'bashabisho_94', 'sandrasamirs3', 'ahmed_7000naser', 'ahmedhossiny', 'amrmohamedreda94', 'amr_m.attya']",6,"['kareemchicharito14', 'marinamedhat', 'ayamohamed12030', 'raniaosama2015', 'patyessam', None]",174,"['nanohub168', 'mido_2010_amr94', 'yolyana.zekry', 'jvanjari', 'ayaaa.f.a', 'noryhankotb12', 'ahmednaser7000', 'nourhan', 'aa.maherr', 'ahmedelectricity1993y', 'mora.sameh2009', 'omarkhaledh95', 'm_osama_asu', 'ahmed_gamal1401', 'anan_alaa_95', 'bondo2a31193', 'mina_sameh95', 'kirollos_ernest', 'm.fouad.allam', 'hassan_elzahar', 'onedaymuer', 'muhammadatef100', 'shadyreda', 'mohabmagdyyoussef', 'aymanalaadin4', 'dondonetoiseau', 'mohmed_rf', 'wilhelm.piao.3', 'mikel.24.hour', 'lamiselhady7', 'screem_love3', 'mina', 'mohamed_adel6222', 'elfaramawytalaat', 'marwa.khaled.eng', 'reham.a.gad', 'yasserramadan940', 'saraalaa', 'waleedsmz94', 'besesh55', 'mina_mwgs', 'ayamostafa978', 'hoda_morshed375', 'wissamismailgp7', 'shamellotfy1966', 'flederico', 'fady', 'ayahelmy_122', 'mimo_tm17', 'nouranalmorshedy', 'ossamakhalil60', 'elec.eng.heba', 'bishoy.medhat.elraheb', 'karimosama1610', 'reallyanyidwuddo', 'mahmoudyoussif95', 'omar.abdulaziz94', 'nadowafa20', 'sh900301', 'mennafarafero', 'shorta', 'srishti.d19', 'jbai14', '4omanko', 'mraafat', 'ahmedhisham1993', 'yasso_ahmed93', 'mernaroshdy95', 'rananader', 'mostafasabri466', 'tarekali1000', 'amirmrashad2', 'amrmeto', 'hany1166', 'emaan.ehaab', 'michaelhany33', 'patyessam', 'sossa', 'tmnietzold', 'miro.marawan', 'mahmoudsaid471', 'mahmoud.said1919', 'ossedeek95', 'yomnamahmoud7', 'aveerai1', 'mahmoudsalah20114', 'houjingyi2015', 'unjhenyj', 'dyaanasser2014', 'caboelkady94', 'nohabassem93', 'shaikhsaif', 'siddheshgajare91', 'jcollie8', 'k1l4ny', 'raniaosama2015', 'mhakmd', 'kholoud.ayman', 'yugy_mody2010', 'mhassan090944', 'bassantalhawary', 'ahmedakram9393', 'marmar8250', 'kouki', 'noor333aldeen333alkfree', 'hatem2030.hh', 'yifuliu', 'nourhanmohamed', 'saeeed3', 'mohd.samaha', 'hadeermansour242', 'omar_moataz13', 'rebo14101995', 'kareemchicharito14', 'dkadiyal', 'shinobi', 'ahmedyasso93', 'wilhelmpiao', 'eman2015', 'hazem1', 'ibrahimelsayed999', 'noha1skeleton', 'ayamohamed12030', 'mark_fayez.95', 'patseo', 'm_menna_95', 'ahmed94hamed', 'mariana.mounir', 'rmenon6', 'monyemoemy', 'yosif_diaa', 'zxiong5', 'halim', 'hisham', 'mnaguib345', 'arwaabdelaziz90', 'usufer', 'engmahmoud', 'tuliphany', 'anwar.alkallas', 'elmohnds.terika', 'zemo_22', 'nadahafez1672', 'mh009966', 'mh', 'bassem2006', 'tnietzol', 'beda_2010', 'geme3600', 'a7medelhelaly', 'mai_hegab', 'fatma.mouawad', 'mohamedaymanabdelsatar', 'ewais', 'shorrrta', 'fatma_batota', 'nadayoussef795', 'ninad.chamele', 'djjohn22', 'david.farag', 'marinamedhat', 'eng.aalaa50', 'sergey.golovynskyi', 'amedo_emad', None, 'jzuo5', 'ma_go20092000', 'rimoz95', 'bashabisho_94', 'sandrasamirs3', 'ahmed_7000naser', 'ahmedhossiny', 'amrmohamedreda94', 'amr_m.attya']"
3,35,133,135,1,['ayushgupta11031996'],131,"['geno1024', 'sachuthan95', 'justgonnausethisonce', 'baldur.kristoffer', 'oaq1982', 'mosuji', 'ontiveros', 'gawlick', 'claire.726', 'anantgugi2009', 'rhbrammall', 'brandonstrickland', 'nonabuh', 'tommylau94', 'steven.petteruti', 'dorae48', 'kred', 'drpepper', 'ruthne', 'fishtoufu', 'jsomer15', 'zxs70789', 'kwmuth', 'echoonge', 'sdwpearson', 'gjarvis', 'dtiamzon', 'jsetow', 'mrlau', 'kkcbyas', 'wjftndjqt', 'rcocomello', 'erewalk', 'nicolesuba', 'evelynlhu', 'darrenxu2011', 'eric.rodrigo', 'ranesh', 'james.soober', 'masheehan', 'enyao', 'dukeruy', 'ryan7926', 'michealmaalouly', 'rhmmoosa', 'albertchau369', 'dddmmmvvv', 'yannick.3.5', 'szsalim', 'ubc', 'xiaoyangharvard', 'yandersen', 'mmcintosh', 'swaugh', 'brp181', 'zahraalbu', 'mcarmack', 'harrystone', 'hardikganatra20', 'tgmcnamara', 'joloo', 'jpricci', 'jdscharf', 'nbobbs', 'moo', 'd213', 'dylanmunro', '6383tewarid', 'jasreen4', 'jbonk', 'itisishan', 'tgm929', 'jamcavoy', 'lettycastrejonbarron', 'yanrayli', 'sbermudez', 'thayerwade', 'sandlee', 'antvapour', 'mamohamed', 'meghancockcroft', 'mikemai512', 'wycnano', 'tingzhou', 'sanu.bhide', 'charansri1994', 'prateekbindra', 'heinen', 'kothari.dhruvin.dk', 'zuhairsn', 'slthomas', 'ekcole', 'michaelhaaf', 'rogerluo_dsc1995', 'h9u9a', 'smanivanh', 'ar923', 'shaheer.aamir', 'pearsedoolin', 'nikolascable', 'npontiv9', 'xiaoyangxiaoyang', 'knite9510', 'mmcintosh1227', 'yongchengwang', 'julian.mele', 'essie.mutinda', 'abs0o', 'mac156', 'ldarrick', 'cyj667', 'ikreisz', 'jplatt', 'dkwok', 'jrandallzl', 'zhougnan', 'andy_lau604', 'javier.laitue', 'sen120nikhil', 'tsui054', 'mitchellho94', 'pcui00', 'oweeparadkar', 'bmabetha', 'grahamjdd', 'mozer', 'rafael95', 'fraps', 'angelazhou', 'derek.yuteng.chen', 'ktomlee']",134,"['kalpitnarvekar', 'rohan21', 'linusassao974', 'komalkolekar95', 'patelmeeti1995', 'lakshoza', 'tanmaypatil18', 'shamika', 'mehta.krish', 'tejomayi.wandhile', 'bhoglet', 'ameysv22', 'sayaliw212', 'sonal.02031995', 'chinmayhejmadi', 'pomkar55', 'shahajichinchole', 'mrinalivyas1', 'mohiteruchir29', 'aksha0103', 'architagoyal', 'modyjash', 'kodagakshay26', 'karan.dhareshwar', 'himanshu21rasam', 'deepashrisane2203', 'vanitashingwa1995', 'tushardmaske', 'imushaikh007', 'rp92555', 'hegde.aniket94.ah', 'mewadayash', 'dal30', 'mehakkoul1994', 'shashwatssanghavi', 'aniketvidyalankar', 'gohel.mitesh91', 'divyapawar39', 'ansi7794', 'vj280395', 'niharikasarode', 'ghosh.arjun97', 'deepakjain.dj2', 'supriya.mangalpalli', 'ajoshi1996', 'desaimaanil2', 'hemantsonar93', 'sunilpoojary27', 'a.b.surgade', 'aka_jadhav', 'sammeetthosar', 'sangeetamjoshi', 'stylechicanki', 'basher00992', 'chaudharilatika02', 'satishlovesmom123', 'dakshata', 'ruprane296', 'rahulstary', 'tuscanowtsheryl128', 'sonali2', 'pb9298', 'adityasingh8394', 'rajpareshshah14', 'shubham.mohite7', 'chinmay', 'gidayegirish', 'shraddha0306', 'aamod1996', 'kanchipoddar', 'sagnikpal3495', 'prasadbhujbal28', 'mmodi296', 'mengaderutuja369', 'ganeshmukund10', 'rutuja1122', 'rsarmajrt', 'saurabhmangeshkar', 'chabhadiariddhi', 'deepti.bhosale189', 'saurabh.medhekar18', 'akash.jadhav', 'hemantjathar7', 'pallavighogare1994', 'ganjirajini277', 'kumar.amit156', 'krishna.jhuma17', 'nilesh15394', 'aljo.joy22', 'ankitashere04', 'mayuresh20', 'kirandarade133', 'sagar2bhujbal', 'prasadchachad20', 'karanshh30', 'kanchangorde15', 'rushabkarani', 'sj.shruti95', 'chintanrlimbani', 'abhijeetchavan', 'rwaghela51', 'udayanyarya', 'jyotibhosale8483', 'umang.parekh30', 'samira2308', 'ayy1892', 'shivachandran.nadar15', 'prachipatil', 'qaspfu', 'tripathipavan10', 'sonaltambe32', 'rohanshah611', 'sagar.mujpara99', 'akajadhav1', 'mvedant29', 'borse84kiran', 'anujkolvalkar1', 'arcanetech12', 'vaibhavvadia', 'darshanlukhi25', 'surajmore009', 'amitsunildhamne', 'redorchid029', 'nikinsaw', 'sunilkavatkar', 'phadsujata59', 'shetty1995pranoy', 'akshaykharat563', 'jharupesh440', None, 'aj.shahare', 'amaya.pethe', 'roshninilam', 'inderjitsingh87']",266,"['geno1024', 'sachuthan95', 'kalpitnarvekar', 'justgonnausethisonce', 'baldur.kristoffer', 'rohan21', 'linusassao974', 'komalkolekar95', 'oaq1982', 'mosuji', 'gawlick', 'ontiveros', 'patelmeeti1995', 'lakshoza', 'tanmaypatil18', 'shamika', 'claire.726', 'anantgugi2009', 'mehta.krish', 'tejomayi.wandhile', 'rhbrammall', 'bhoglet', 'ameysv22', 'sayaliw212', 'brandonstrickland', 'nonabuh', 'tommylau94', 'chinmayhejmadi', 'sonal.02031995', 'pomkar55', 'steven.petteruti', 'dorae48', 'kred', 'shahajichinchole', 'drpepper', 'ruthne', 'fishtoufu', 'jsomer15', 'mrinalivyas1', 'zxs70789', 'mohiteruchir29', 'aksha0103', 'architagoyal', 'modyjash', 'kodagakshay26', 'kwmuth', 'karan.dhareshwar', 'echoonge', 'sdwpearson', 'gjarvis', 'dtiamzon', 'himanshu21rasam', 'deepashrisane2203', 'vanitashingwa1995', 'jsetow', 'mrlau', 'kkcbyas', 'tushardmaske', 'wjftndjqt', 'rcocomello', 'erewalk', 'imushaikh007', 'nicolesuba', 'rp92555', 'hegde.aniket94.ah', 'mewadayash', 'evelynlhu', 'dal30', 'darrenxu2011', 'mehakkoul1994', 'eric.rodrigo', 'shashwatssanghavi', 'ranesh', 'james.soober', 'aniketvidyalankar', 'gohel.mitesh91', 'divyapawar39', 'ansi7794', 'masheehan', 'vj280395', 'niharikasarode', 'enyao', 'ghosh.arjun97', 'dukeruy', 'ryan7926', 'michealmaalouly', 'deepakjain.dj2', 'rhmmoosa', 'supriya.mangalpalli', 'ajoshi1996', 'desaimaanil2', 'hemantsonar93', 'albertchau369', 'sunilpoojary27', 'dddmmmvvv', 'a.b.surgade', 'yannick.3.5', 'aka_jadhav', 'szsalim', 'sammeetthosar', 'ubc', 'xiaoyangharvard', 'yandersen', 'mmcintosh', 'swaugh', 'sangeetamjoshi', 'brp181', 'stylechicanki', 'basher00992', 'chaudharilatika02', 'satishlovesmom123', 'zahraalbu', 'dakshata', 'mcarmack', 'harrystone', 'ruprane296', 'hardikganatra20', 'rahulstary', 'tuscanowtsheryl128', 'tgmcnamara', 'sonali2', 'pb9298', 'adityasingh8394', 'rajpareshshah14', 'shubham.mohite7', 'chinmay', 'gidayegirish', 'joloo', 'shraddha0306', 'jpricci', 'jdscharf', 'nbobbs', 'moo', 'd213', 'dylanmunro', 'aamod1996', '6383tewarid', 'kanchipoddar', 'sagnikpal3495', 'prasadbhujbal28', 'mmodi296', 'mengaderutuja369', 'jasreen4', 'jbonk', 'itisishan', 'ganeshmukund10', 'rutuja1122', 'tgm929', 'jamcavoy', 'lettycastrejonbarron', 'yanrayli', 'sbermudez', 'rsarmajrt', 'thayerwade', 'sandlee', 'saurabhmangeshkar', 'chabhadiariddhi', 'antvapour', 'mamohamed', 'deepti.bhosale189', 'meghancockcroft', 'mikemai512', 'saurabh.medhekar18', 'wycnano', 'tingzhou', 'sanu.bhide', 'charansri1994', 'akash.jadhav', 'hemantjathar7', 'pallavighogare1994', 'ganjirajini277', 'prateekbindra', 'heinen', 'kumar.amit156', 'kothari.dhruvin.dk', 'krishna.jhuma17', 'nilesh15394', 'zuhairsn', 'slthomas', 'aljo.joy22', 'ankitashere04', 'ekcole', 'mayuresh20', 'kirandarade133', 'michaelhaaf', 'sagar2bhujbal', 'rogerluo_dsc1995', 'h9u9a', 'prasadchachad20', 'smanivanh', 'karanshh30', 'ar923', 'shaheer.aamir', 'kanchangorde15', 'rushabkarani', 'pearsedoolin', 'nikolascable', 'npontiv9', 'sj.shruti95', 'chintanrlimbani', 'abhijeetchavan', 'rwaghela51', 'xiaoyangxiaoyang', 'udayanyarya', 'knite9510', 'mmcintosh1227', 'yongchengwang', 'julian.mele', 'jyotibhosale8483', 'umang.parekh30', 'essie.mutinda', 'samira2308', 'ayy1892', 'shivachandran.nadar15', 'abs0o', 'prachipatil', 'mac156', 'qaspfu', 'ayushgupta11031996', 'tripathipavan10', 'sonaltambe32', 'ldarrick', 'cyj667', 'rohanshah611', 'ikreisz', 'sagar.mujpara99', 'jplatt', 'akajadhav1', 'mvedant29', 'borse84kiran', 'dkwok', 'jrandallzl', 'anujkolvalkar1', 'arcanetech12', 'vaibhavvadia', 'darshanlukhi25', 'zhougnan', 'andy_lau604', 'javier.laitue', 'surajmore009', 'amitsunildhamne', 'sen120nikhil', 'redorchid029', 'nikinsaw', 'sunilkavatkar', 'tsui054', 'mitchellho94', 'phadsujata59', 'shetty1995pranoy', 'akshaykharat563', 'jharupesh440', None, 'aj.shahare', 'amaya.pethe', 'pcui00', 'oweeparadkar', 'roshninilam', 'bmabetha', 'grahamjdd', 'mozer', 'inderjitsingh87', 'rafael95', 'fraps', 'angelazhou', 'derek.yuteng.chen', 'ktomlee']"
3,210,133,62,54,"['justgonnausethisonce', '6383tewarid', 'wjftndjqt', 'knite9510', 'nicolesuba', 'essie.mutinda', 'jasreen4', 'gawlick', 'oaq1982', 'ranesh', 'james.soober', 'mac156', 'enyao', 'yanrayli', 'dukeruy', 'claire.726', 'anantgugi2009', 'ryan7926', 'rhmmoosa', 'ldarrick', 'brandonstrickland', 'nonabuh', 'antvapour', 'tommylau94', 'albertchau369', 'meghancockcroft', 'mikemai512', 'dorae48', 'yannick.3.5', 'andy_lau604', 'swaugh', 'drpepper', 'zuhairsn', 'ruthne', 'fishtoufu', 'jsomer15', 'zxs70789', 'mitchellho94', 'michaelhaaf', 'rogerluo_dsc1995', 'h9u9a', 'ktomlee', 'mozer', 'sdwpearson', 'grahamjdd', 'fraps', 'rafael95', 'ar923', 'shaheer.aamir', 'gjarvis', 'angelazhou', 'derek.yuteng.chen', 'pearsedoolin', 'mrlau']",78,"['geno1024', 'sachuthan95', 'baldur.kristoffer', 'mosuji', 'ontiveros', 'rhbrammall', 'steven.petteruti', 'kred', 'kwmuth', 'echoonge', 'dtiamzon', 'jsetow', 'kkcbyas', 'rcocomello', 'erewalk', 'evelynlhu', 'darrenxu2011', 'eric.rodrigo', 'masheehan', 'michealmaalouly', 'dddmmmvvv', 'szsalim', 'ubc', 'xiaoyangharvard', 'yandersen', 'mmcintosh', 'brp181', 'zahraalbu', 'mcarmack', 'harrystone', 'hardikganatra20', 'tgmcnamara', 'joloo', 'jpricci', 'jdscharf', 'nbobbs', 'moo', 'd213', 'dylanmunro', 'itisishan', 'jbonk', 'tgm929', 'jamcavoy', 'lettycastrejonbarron', 'sbermudez', 'thayerwade', 'sandlee', 'mamohamed', 'wycnano', 'tingzhou', 'sanu.bhide', 'charansri1994', 'prateekbindra', 'heinen', 'kothari.dhruvin.dk', 'slthomas', 'ekcole', 'smanivanh', 'nikolascable', 'npontiv9', 'xiaoyangxiaoyang', 'mmcintosh1227', 'yongchengwang', 'julian.mele', 'abs0o', 'ayushgupta11031996', 'cyj667', 'ikreisz', 'jplatt', 'dkwok', 'jrandallzl', 'zhougnan', 'javier.laitue', 'sen120nikhil', 'tsui054', 'pcui00', 'oweeparadkar', 'bmabetha']",8,"['smarangk', 'reubenpaul34', 'muygun', 'chucknorris1', 'kjxijk', 'mengda_yu', 'pompay95', None]",140,"['geno1024', 'sachuthan95', 'justgonnausethisonce', 'baldur.kristoffer', 'oaq1982', 'mosuji', 'gawlick', 'ontiveros', 'mengda_yu', 'claire.726', 'anantgugi2009', 'rhbrammall', 'brandonstrickland', 'nonabuh', 'tommylau94', 'steven.petteruti', 'dorae48', 'kred', 'chucknorris1', 'drpepper', 'ruthne', 'fishtoufu', 'jsomer15', 'zxs70789', 'kwmuth', 'echoonge', 'sdwpearson', 'gjarvis', 'dtiamzon', 'jsetow', 'mrlau', 'kkcbyas', 'muygun', 'wjftndjqt', 'rcocomello', 'erewalk', 'nicolesuba', 'evelynlhu', 'darrenxu2011', 'eric.rodrigo', 'ranesh', 'james.soober', 'masheehan', 'enyao', 'dukeruy', 'ryan7926', 'michealmaalouly', 'rhmmoosa', 'albertchau369', 'dddmmmvvv', 'yannick.3.5', 'szsalim', 'ubc', 'xiaoyangharvard', 'yandersen', 'mmcintosh', 'swaugh', 'brp181', 'zahraalbu', 'mcarmack', 'harrystone', 'hardikganatra20', 'reubenpaul34', 'tgmcnamara', 'joloo', 'jpricci', 'jdscharf', 'nbobbs', 'moo', 'd213', 'dylanmunro', '6383tewarid', 'jasreen4', 'jbonk', 'itisishan', 'tgm929', 'jamcavoy', 'lettycastrejonbarron', 'yanrayli', 'sbermudez', 'kjxijk', 'thayerwade', 'sandlee', 'antvapour', 'mamohamed', 'meghancockcroft', 'mikemai512', 'wycnano', 'tingzhou', 'sanu.bhide', 'charansri1994', 'prateekbindra', 'heinen', 'kothari.dhruvin.dk', 'zuhairsn', 'slthomas', 'ekcole', 'smarangk', 'michaelhaaf', 'rogerluo_dsc1995', 'h9u9a', 'smanivanh', 'pompay95', 'ar923', 'shaheer.aamir', 'pearsedoolin', 'nikolascable', 'npontiv9', 'xiaoyangxiaoyang', 'knite9510', 'mmcintosh1227', 'yongchengwang', 'julian.mele', 'essie.mutinda', 'abs0o', 'mac156', 'ayushgupta11031996', 'ldarrick', 'cyj667', 'ikreisz', 'jplatt', 'dkwok', 'jrandallzl', 'zhougnan', 'andy_lau604', 'javier.laitue', 'sen120nikhil', 'tsui054', 'mitchellho94', None, 'pcui00', 'oweeparadkar', 'bmabetha', 'grahamjdd', 'mozer', 'rafael95', 'fraps', 'angelazhou', 'derek.yuteng.chen', 'ktomlee']"
3,209,133,37,32,"['kkcbyas', 'nbobbs', 'dylanmunro', 'xiaoyangxiaoyang', 'erewalk', 'mmcintosh1227', 'yongchengwang', 'evelynlhu', 'itisishan', 'ontiveros', 'darrenxu2011', 'eric.rodrigo', 'mosuji', 'tgm929', 'sbermudez', 'thayerwade', 'michealmaalouly', 'steven.petteruti', 'wycnano', 'tingzhou', 'dkwok', 'szsalim', 'xiaoyangharvard', 'yandersen', 'mmcintosh', 'mcarmack', 'harrystone', 'tgmcnamara', 'bmabetha', 'smanivanh', 'nikolascable', 'npontiv9']",100,"['geno1024', 'sachuthan95', 'justgonnausethisonce', 'baldur.kristoffer', 'oaq1982', 'gawlick', 'claire.726', 'anantgugi2009', 'rhbrammall', 'brandonstrickland', 'nonabuh', 'tommylau94', 'kred', 'dorae48', 'drpepper', 'ruthne', 'fishtoufu', 'jsomer15', 'zxs70789', 'kwmuth', 'echoonge', 'sdwpearson', 'gjarvis', 'dtiamzon', 'jsetow', 'mrlau', 'wjftndjqt', 'rcocomello', 'nicolesuba', 'ranesh', 'james.soober', 'masheehan', 'enyao', 'dukeruy', 'ryan7926', 'rhmmoosa', 'albertchau369', 'dddmmmvvv', 'yannick.3.5', 'ubc', 'swaugh', 'brp181', 'zahraalbu', 'hardikganatra20', 'joloo', 'jpricci', 'jdscharf', 'moo', 'd213', '6383tewarid', 'jasreen4', 'jbonk', 'jamcavoy', 'lettycastrejonbarron', 'yanrayli', 'sandlee', 'antvapour', 'mamohamed', 'meghancockcroft', 'mikemai512', 'sanu.bhide', 'charansri1994', 'prateekbindra', 'heinen', 'kothari.dhruvin.dk', 'zuhairsn', 'slthomas', 'ekcole', 'michaelhaaf', 'rogerluo_dsc1995', 'h9u9a', 'ar923', 'shaheer.aamir', 'pearsedoolin', 'knite9510', 'julian.mele', 'essie.mutinda', 'abs0o', 'mac156', 'ayushgupta11031996', 'ldarrick', 'cyj667', 'ikreisz', 'jplatt', 'jrandallzl', 'zhougnan', 'andy_lau604', 'javier.laitue', 'sen120nikhil', 'tsui054', 'mitchellho94', 'pcui00', 'oweeparadkar', 'grahamjdd', 'mozer', 'rafael95', 'fraps', 'angelazhou', 'derek.yuteng.chen', 'ktomlee']",5,"['csun01', 'michelmaalouly', 'scottsun', None, 'linboshao']",137,"['geno1024', 'sachuthan95', 'justgonnausethisonce', 'baldur.kristoffer', 'oaq1982', 'mosuji', 'gawlick', 'ontiveros', 'linboshao', 'claire.726', 'anantgugi2009', 'rhbrammall', 'brandonstrickland', 'nonabuh', 'tommylau94', 'steven.petteruti', 'dorae48', 'kred', 'drpepper', 'ruthne', 'fishtoufu', 'jsomer15', 'zxs70789', 'kwmuth', 'echoonge', 'sdwpearson', 'gjarvis', 'dtiamzon', 'jsetow', 'mrlau', 'kkcbyas', 'wjftndjqt', 'rcocomello', 'erewalk', 'nicolesuba', 'evelynlhu', 'michelmaalouly', 'darrenxu2011', 'eric.rodrigo', 'ranesh', 'james.soober', 'masheehan', 'enyao', 'dukeruy', 'ryan7926', 'michealmaalouly', 'rhmmoosa', 'csun01', 'albertchau369', 'dddmmmvvv', 'yannick.3.5', 'szsalim', 'ubc', 'xiaoyangharvard', 'yandersen', 'mmcintosh', 'swaugh', 'brp181', 'zahraalbu', 'mcarmack', 'harrystone', 'hardikganatra20', 'tgmcnamara', 'scottsun', 'joloo', 'jpricci', 'jdscharf', 'nbobbs', 'moo', 'd213', 'dylanmunro', '6383tewarid', 'jasreen4', 'jbonk', 'itisishan', 'tgm929', 'jamcavoy', 'lettycastrejonbarron', 'yanrayli', 'sbermudez', 'thayerwade', 'sandlee', 'antvapour', 'mamohamed', 'meghancockcroft', 'mikemai512', 'wycnano', 'tingzhou', 'sanu.bhide', 'charansri1994', 'prateekbindra', 'heinen', 'kothari.dhruvin.dk', 'zuhairsn', 'slthomas', 'ekcole', 'michaelhaaf', 'rogerluo_dsc1995', 'h9u9a', 'smanivanh', 'ar923', 'shaheer.aamir', 'pearsedoolin', 'nikolascable', 'npontiv9', 'xiaoyangxiaoyang', 'knite9510', 'mmcintosh1227', 'yongchengwang', 'julian.mele', 'essie.mutinda', 'abs0o', 'mac156', 'ayushgupta11031996', 'ldarrick', 'cyj667', 'ikreisz', 'jplatt', 'dkwok', 'jrandallzl', 'zhougnan', 'andy_lau604', 'javier.laitue', 'sen120nikhil', 'tsui054', 'mitchellho94', None, 'pcui00', 'oweeparadkar', 'bmabetha', 'grahamjdd', 'mozer', 'rafael95', 'fraps', 'angelazhou', 'derek.yuteng.chen', 'ktomlee']"
3,45,133,34,1,['kothari.dhruvin.dk'],131,"['geno1024', 'sachuthan95', 'justgonnausethisonce', 'baldur.kristoffer', 'oaq1982', 'mosuji', 'ontiveros', 'gawlick', 'claire.726', 'anantgugi2009', 'rhbrammall', 'brandonstrickland', 'nonabuh', 'tommylau94', 'steven.petteruti', 'dorae48', 'kred', 'drpepper', 'ruthne', 'fishtoufu', 'jsomer15', 'zxs70789', 'kwmuth', 'echoonge', 'sdwpearson', 'gjarvis', 'dtiamzon', 'jsetow', 'mrlau', 'kkcbyas', 'wjftndjqt', 'rcocomello', 'erewalk', 'nicolesuba', 'evelynlhu', 'darrenxu2011', 'eric.rodrigo', 'ranesh', 'james.soober', 'masheehan', 'enyao', 'dukeruy', 'ryan7926', 'michealmaalouly', 'rhmmoosa', 'albertchau369', 'dddmmmvvv', 'yannick.3.5', 'szsalim', 'ubc', 'xiaoyangharvard', 'yandersen', 'mmcintosh', 'swaugh', 'brp181', 'zahraalbu', 'mcarmack', 'harrystone', 'hardikganatra20', 'tgmcnamara', 'joloo', 'jpricci', 'jdscharf', 'nbobbs', 'moo', 'd213', 'dylanmunro', '6383tewarid', 'jasreen4', 'jbonk', 'itisishan', 'tgm929', 'jamcavoy', 'lettycastrejonbarron', 'yanrayli', 'sbermudez', 'thayerwade', 'sandlee', 'antvapour', 'mamohamed', 'meghancockcroft', 'mikemai512', 'wycnano', 'tingzhou', 'sanu.bhide', 'charansri1994', 'prateekbindra', 'heinen', 'zuhairsn', 'slthomas', 'ekcole', 'michaelhaaf', 'rogerluo_dsc1995', 'h9u9a', 'smanivanh', 'ar923', 'shaheer.aamir', 'pearsedoolin', 'nikolascable', 'npontiv9', 'xiaoyangxiaoyang', 'knite9510', 'mmcintosh1227', 'yongchengwang', 'julian.mele', 'essie.mutinda', 'abs0o', 'mac156', 'ayushgupta11031996', 'ldarrick', 'cyj667', 'ikreisz', 'jplatt', 'dkwok', 'jrandallzl', 'zhougnan', 'andy_lau604', 'javier.laitue', 'sen120nikhil', 'tsui054', 'mitchellho94', 'pcui00', 'oweeparadkar', 'bmabetha', 'grahamjdd', 'mozer', 'rafael95', 'fraps', 'angelazhou', 'derek.yuteng.chen', 'ktomlee']",33,"['daiwikb', 'tzatakia', 'rwaghela51', 'doshipayal1996', 'narkheden', 'siddhant', 'udayanyarya', 'rohan21', 'mewadayash', 'mananmehta95', 'patelmeeti1995', 'karishmamehta34', 'manishaagam999', 'ritugupta1102.rg97', 'meet.muchhala95', 'ghosh.arjun97', 'rohancontractor.rc', 'ameysv22', 'rohanshah611', 'chinmayhejmadi', 'helloworld1', 'nishant.joshi42', 'ruchawaghulde', None, 'thosarm', 'vora.jai1', 'jharupesh440', 'riteshrajput381', 'aryakanika31', 'azazeljam', 'karan.dhareshwar', 'vandortshakti', 'chinmay']",165,"['geno1024', 'sachuthan95', 'daiwikb', 'doshipayal1996', 'justgonnausethisonce', 'baldur.kristoffer', 'rohan21', 'oaq1982', 'mosuji', 'gawlick', 'ontiveros', 'patelmeeti1995', 'meet.muchhala95', 'claire.726', 'anantgugi2009', 'rohancontractor.rc', 'rhbrammall', 'ameysv22', 'brandonstrickland', 'nonabuh', 'tommylau94', 'chinmayhejmadi', 'steven.petteruti', 'dorae48', 'kred', 'drpepper', 'ruthne', 'fishtoufu', 'jsomer15', 'zxs70789', 'vora.jai1', 'riteshrajput381', 'aryakanika31', 'azazeljam', 'kwmuth', 'karan.dhareshwar', 'echoonge', 'sdwpearson', 'gjarvis', 'dtiamzon', 'vandortshakti', 'jsetow', 'mrlau', 'kkcbyas', 'wjftndjqt', 'rcocomello', 'erewalk', 'nicolesuba', 'mewadayash', 'evelynlhu', 'darrenxu2011', 'eric.rodrigo', 'ranesh', 'james.soober', 'masheehan', 'enyao', 'ghosh.arjun97', 'dukeruy', 'ryan7926', 'michealmaalouly', 'rhmmoosa', 'albertchau369', 'dddmmmvvv', 'yannick.3.5', 'szsalim', 'nishant.joshi42', 'ubc', 'xiaoyangharvard', 'yandersen', 'mmcintosh', 'swaugh', 'brp181', 'zahraalbu', 'mcarmack', 'harrystone', 'hardikganatra20', 'tgmcnamara', 'chinmay', 'joloo', 'jpricci', 'jdscharf', 'nbobbs', 'moo', 'd213', 'dylanmunro', '6383tewarid', 'jasreen4', 'jbonk', 'itisishan', 'tgm929', 'jamcavoy', 'karishmamehta34', 'lettycastrejonbarron', 'yanrayli', 'ritugupta1102.rg97', 'sbermudez', 'thayerwade', 'sandlee', 'antvapour', 'mamohamed', 'meghancockcroft', 'mikemai512', 'wycnano', 'tingzhou', 'sanu.bhide', 'charansri1994', 'prateekbindra', 'heinen', 'kothari.dhruvin.dk', 'zuhairsn', 'slthomas', 'ekcole', 'thosarm', 'michaelhaaf', 'rogerluo_dsc1995', 'h9u9a', 'smanivanh', 'ar923', 'shaheer.aamir', 'pearsedoolin', 'nikolascable', 'npontiv9', 'rwaghela51', 'tzatakia', 'narkheden', 'siddhant', 'xiaoyangxiaoyang', 'udayanyarya', 'knite9510', 'mmcintosh1227', 'yongchengwang', 'julian.mele', 'essie.mutinda', 'mananmehta95', 'abs0o', 'mac156', 'manishaagam999', 'ayushgupta11031996', 'ldarrick', 'cyj667', 'rohanshah611', 'ikreisz', 'jplatt', 'helloworld1', 'dkwok', 'jrandallzl', 'zhougnan', 'andy_lau604', 'javier.laitue', 'ruchawaghulde', 'sen120nikhil', 'tsui054', 'mitchellho94', None, 'jharupesh440', 'pcui00', 'oweeparadkar', 'bmabetha', 'grahamjdd', 'mozer', 'rafael95', 'fraps', 'angelazhou', 'derek.yuteng.chen', 'ktomlee']"
3,200,133,21,1,['cyj667'],131,"['geno1024', 'sachuthan95', 'justgonnausethisonce', 'baldur.kristoffer', 'oaq1982', 'mosuji', 'gawlick', 'ontiveros', 'claire.726', 'anantgugi2009', 'rhbrammall', 'brandonstrickland', 'nonabuh', 'tommylau94', 'steven.petteruti', 'dorae48', 'kred', 'drpepper', 'ruthne', 'fishtoufu', 'jsomer15', 'zxs70789', 'kwmuth', 'echoonge', 'sdwpearson', 'gjarvis', 'dtiamzon', 'jsetow', 'mrlau', 'kkcbyas', 'wjftndjqt', 'rcocomello', 'erewalk', 'nicolesuba', 'evelynlhu', 'darrenxu2011', 'eric.rodrigo', 'ranesh', 'james.soober', 'masheehan', 'enyao', 'dukeruy', 'ryan7926', 'michealmaalouly', 'rhmmoosa', 'albertchau369', 'dddmmmvvv', 'yannick.3.5', 'szsalim', 'ubc', 'xiaoyangharvard', 'yandersen', 'mmcintosh', 'swaugh', 'brp181', 'zahraalbu', 'mcarmack', 'harrystone', 'hardikganatra20', 'tgmcnamara', 'joloo', 'jpricci', 'jdscharf', 'nbobbs', 'moo', 'd213', 'dylanmunro', '6383tewarid', 'jasreen4', 'jbonk', 'itisishan', 'tgm929', 'jamcavoy', 'lettycastrejonbarron', 'yanrayli', 'sbermudez', 'thayerwade', 'sandlee', 'antvapour', 'mamohamed', 'meghancockcroft', 'mikemai512', 'wycnano', 'tingzhou', 'sanu.bhide', 'charansri1994', 'prateekbindra', 'heinen', 'kothari.dhruvin.dk', 'zuhairsn', 'slthomas', 'ekcole', 'michaelhaaf', 'rogerluo_dsc1995', 'h9u9a', 'smanivanh', 'ar923', 'shaheer.aamir', 'pearsedoolin', 'nikolascable', 'npontiv9', 'xiaoyangxiaoyang', 'knite9510', 'mmcintosh1227', 'yongchengwang', 'julian.mele', 'essie.mutinda', 'abs0o', 'mac156', 'ayushgupta11031996', 'ldarrick', 'ikreisz', 'jplatt', 'dkwok', 'jrandallzl', 'zhougnan', 'andy_lau604', 'javier.laitue', 'sen120nikhil', 'tsui054', 'mitchellho94', 'pcui00', 'oweeparadkar', 'bmabetha', 'grahamjdd', 'mozer', 'rafael95', 'fraps', 'angelazhou', 'derek.yuteng.chen', 'ktomlee']",20,"['jwp0530', 'eyounseok', 'cat90129', 'ghddlsrl91', 'qw1w2we2e3', 'k4610316', 'mkkim693', 'dae792', 'tlsaudrbs', 'kimyeonjin94', 'jongho7950', None, 'taehojung', 'seo7yeon0320', 'secumjyp', 'bolmaejay', 'eug92', 'gostja808', 'becksha2307', 'joungh023']",152,"['geno1024', 'sachuthan95', 'justgonnausethisonce', 'eyounseok', 'baldur.kristoffer', 'oaq1982', 'mosuji', 'gawlick', 'ontiveros', 'ghddlsrl91', 'claire.726', 'anantgugi2009', 'rhbrammall', 'brandonstrickland', 'nonabuh', 'tommylau94', 'steven.petteruti', 'dorae48', 'kred', 'drpepper', 'tlsaudrbs', 'ruthne', 'fishtoufu', 'jsomer15', 'zxs70789', 'kwmuth', 'echoonge', 'eug92', 'sdwpearson', 'gjarvis', 'dtiamzon', 'jsetow', 'mrlau', 'kkcbyas', 'wjftndjqt', 'rcocomello', 'erewalk', 'nicolesuba', 'evelynlhu', 'darrenxu2011', 'eric.rodrigo', 'ranesh', 'james.soober', 'masheehan', 'enyao', 'qw1w2we2e3', 'dukeruy', 'ryan7926', 'michealmaalouly', 'k4610316', 'rhmmoosa', 'albertchau369', 'dddmmmvvv', 'yannick.3.5', 'szsalim', 'ubc', 'xiaoyangharvard', 'yandersen', 'mmcintosh', 'swaugh', 'dae792', 'brp181', 'zahraalbu', 'mcarmack', 'harrystone', 'hardikganatra20', 'seo7yeon0320', 'tgmcnamara', 'gostja808', 'becksha2307', 'joloo', 'jpricci', 'jdscharf', 'nbobbs', 'moo', 'd213', 'dylanmunro', '6383tewarid', 'jasreen4', 'jbonk', 'itisishan', 'tgm929', 'jamcavoy', 'cat90129', 'lettycastrejonbarron', 'yanrayli', 'sbermudez', 'thayerwade', 'sandlee', 'antvapour', 'mkkim693', 'mamohamed', 'meghancockcroft', 'mikemai512', 'wycnano', 'tingzhou', 'sanu.bhide', 'charansri1994', 'prateekbindra', 'heinen', 'kothari.dhruvin.dk', 'kimyeonjin94', 'zuhairsn', 'slthomas', 'ekcole', 'jongho7950', 'michaelhaaf', 'secumjyp', 'rogerluo_dsc1995', 'h9u9a', 'smanivanh', 'ar923', 'shaheer.aamir', 'pearsedoolin', 'nikolascable', 'npontiv9', 'jwp0530', 'xiaoyangxiaoyang', 'knite9510', 'mmcintosh1227', 'yongchengwang', 'julian.mele', 'essie.mutinda', 'abs0o', 'mac156', 'ayushgupta11031996', 'ldarrick', 'cyj667', 'ikreisz', 'jplatt', 'dkwok', 'jrandallzl', 'zhougnan', 'andy_lau604', 'javier.laitue', 'sen120nikhil', 'tsui054', 'mitchellho94', None, 'taehojung', 'bolmaejay', 'pcui00', 'oweeparadkar', 'bmabetha', 'grahamjdd', 'mozer', 'rafael95', 'fraps', 'joungh023', 'angelazhou', 'derek.yuteng.chen', 'ktomlee']"
3,211,133,19,15,"['jdscharf', 'moo', 'masheehan', 'sandlee', 'rcocomello', 'dtiamzon', 'jplatt', 'jbonk', 'ikreisz', 'slthomas', 'ekcole', 'jsetow', 'mamohamed', 'jamcavoy', 'jpricci']",117,"['geno1024', 'sachuthan95', 'justgonnausethisonce', 'baldur.kristoffer', 'oaq1982', 'mosuji', 'gawlick', 'ontiveros', 'claire.726', 'anantgugi2009', 'rhbrammall', 'brandonstrickland', 'nonabuh', 'tommylau94', 'steven.petteruti', 'dorae48', 'kred', 'drpepper', 'ruthne', 'fishtoufu', 'jsomer15', 'zxs70789', 'kwmuth', 'echoonge', 'sdwpearson', 'gjarvis', 'mrlau', 'kkcbyas', 'wjftndjqt', 'erewalk', 'nicolesuba', 'evelynlhu', 'darrenxu2011', 'eric.rodrigo', 'ranesh', 'james.soober', 'enyao', 'dukeruy', 'ryan7926', 'michealmaalouly', 'rhmmoosa', 'albertchau369', 'dddmmmvvv', 'yannick.3.5', 'szsalim', 'ubc', 'xiaoyangharvard', 'yandersen', 'mmcintosh', 'swaugh', 'brp181', 'zahraalbu', 'mcarmack', 'harrystone', 'hardikganatra20', 'tgmcnamara', 'joloo', 'nbobbs', 'd213', 'dylanmunro', '6383tewarid', 'jasreen4', 'itisishan', 'tgm929', 'lettycastrejonbarron', 'yanrayli', 'sbermudez', 'thayerwade', 'antvapour', 'meghancockcroft', 'mikemai512', 'wycnano', 'tingzhou', 'sanu.bhide', 'charansri1994', 'prateekbindra', 'heinen', 'kothari.dhruvin.dk', 'zuhairsn', 'michaelhaaf', 'rogerluo_dsc1995', 'h9u9a', 'smanivanh', 'ar923', 'shaheer.aamir', 'pearsedoolin', 'nikolascable', 'npontiv9', 'xiaoyangxiaoyang', 'knite9510', 'mmcintosh1227', 'yongchengwang', 'julian.mele', 'essie.mutinda', 'abs0o', 'mac156', 'ayushgupta11031996', 'ldarrick', 'cyj667', 'dkwok', 'jrandallzl', 'zhougnan', 'andy_lau604', 'javier.laitue', 'sen120nikhil', 'tsui054', 'mitchellho94', 'pcui00', 'oweeparadkar', 'bmabetha', 'grahamjdd', 'mozer', 'rafael95', 'fraps', 'angelazhou', 'derek.yuteng.chen', 'ktomlee']",4,"['bgalaske', None, 'jmgallant', 'jkestyn']",136,"['geno1024', 'sachuthan95', 'justgonnausethisonce', 'baldur.kristoffer', 'oaq1982', 'mosuji', 'gawlick', 'ontiveros', 'claire.726', 'anantgugi2009', 'rhbrammall', 'brandonstrickland', 'nonabuh', 'tommylau94', 'steven.petteruti', 'dorae48', 'kred', 'drpepper', 'ruthne', 'fishtoufu', 'jsomer15', 'zxs70789', 'kwmuth', 'echoonge', 'sdwpearson', 'gjarvis', 'dtiamzon', 'jsetow', 'mrlau', 'kkcbyas', 'wjftndjqt', 'rcocomello', 'erewalk', 'bgalaske', 'nicolesuba', 'evelynlhu', 'darrenxu2011', 'eric.rodrigo', 'ranesh', 'james.soober', 'masheehan', 'enyao', 'dukeruy', 'ryan7926', 'michealmaalouly', 'rhmmoosa', 'albertchau369', 'dddmmmvvv', 'yannick.3.5', 'szsalim', 'ubc', 'xiaoyangharvard', 'yandersen', 'mmcintosh', 'swaugh', 'brp181', 'zahraalbu', 'mcarmack', 'harrystone', 'hardikganatra20', 'tgmcnamara', 'joloo', 'jpricci', 'jdscharf', 'nbobbs', 'moo', 'd213', 'dylanmunro', '6383tewarid', 'jasreen4', 'jbonk', 'itisishan', 'tgm929', 'jamcavoy', 'lettycastrejonbarron', 'jkestyn', 'yanrayli', 'sbermudez', 'thayerwade', 'sandlee', 'antvapour', 'mamohamed', 'meghancockcroft', 'mikemai512', 'wycnano', 'tingzhou', 'sanu.bhide', 'charansri1994', 'prateekbindra', 'heinen', 'kothari.dhruvin.dk', 'zuhairsn', 'slthomas', 'ekcole', 'jmgallant', 'michaelhaaf', 'rogerluo_dsc1995', 'h9u9a', 'smanivanh', 'ar923', 'shaheer.aamir', 'pearsedoolin', 'nikolascable', 'npontiv9', 'xiaoyangxiaoyang', 'knite9510', 'mmcintosh1227', 'yongchengwang', 'julian.mele', 'essie.mutinda', 'abs0o', 'mac156', 'ayushgupta11031996', 'ldarrick', 'cyj667', 'ikreisz', 'jplatt', 'dkwok', 'jrandallzl', 'zhougnan', 'andy_lau604', 'javier.laitue', 'sen120nikhil', 'tsui054', 'mitchellho94', None, 'pcui00', 'oweeparadkar', 'bmabetha', 'grahamjdd', 'mozer', 'rafael95', 'fraps', 'angelazhou', 'derek.yuteng.chen', 'ktomlee']"
3,36,133,18,1,['ayushgupta11031996'],131,"['geno1024', 'sachuthan95', 'justgonnausethisonce', 'baldur.kristoffer', 'oaq1982', 'mosuji', 'gawlick', 'ontiveros', 'claire.726', 'anantgugi2009', 'rhbrammall', 'brandonstrickland', 'nonabuh', 'tommylau94', 'steven.petteruti', 'dorae48', 'kred', 'drpepper', 'ruthne', 'fishtoufu', 'jsomer15', 'zxs70789', 'kwmuth', 'echoonge', 'sdwpearson', 'gjarvis', 'dtiamzon', 'jsetow', 'mrlau', 'kkcbyas', 'wjftndjqt', 'rcocomello', 'erewalk', 'nicolesuba', 'evelynlhu', 'darrenxu2011', 'eric.rodrigo', 'ranesh', 'james.soober', 'masheehan', 'enyao', 'dukeruy', 'ryan7926', 'michealmaalouly', 'rhmmoosa', 'albertchau369', 'dddmmmvvv', 'yannick.3.5', 'szsalim', 'ubc', 'xiaoyangharvard', 'yandersen', 'mmcintosh', 'swaugh', 'brp181', 'zahraalbu', 'mcarmack', 'harrystone', 'hardikganatra20', 'tgmcnamara', 'joloo', 'jpricci', 'jdscharf', 'nbobbs', 'moo', 'd213', 'dylanmunro', '6383tewarid', 'jasreen4', 'jbonk', 'itisishan', 'tgm929', 'jamcavoy', 'lettycastrejonbarron', 'yanrayli', 'sbermudez', 'thayerwade', 'sandlee', 'antvapour', 'mamohamed', 'meghancockcroft', 'mikemai512', 'wycnano', 'tingzhou', 'sanu.bhide', 'charansri1994', 'prateekbindra', 'heinen', 'kothari.dhruvin.dk', 'zuhairsn', 'slthomas', 'ekcole', 'michaelhaaf', 'rogerluo_dsc1995', 'h9u9a', 'smanivanh', 'ar923', 'shaheer.aamir', 'pearsedoolin', 'nikolascable', 'npontiv9', 'xiaoyangxiaoyang', 'knite9510', 'mmcintosh1227', 'yongchengwang', 'julian.mele', 'essie.mutinda', 'abs0o', 'mac156', 'ldarrick', 'cyj667', 'ikreisz', 'jplatt', 'dkwok', 'jrandallzl', 'zhougnan', 'andy_lau604', 'javier.laitue', 'sen120nikhil', 'tsui054', 'mitchellho94', 'pcui00', 'oweeparadkar', 'bmabetha', 'grahamjdd', 'mozer', 'rafael95', 'fraps', 'angelazhou', 'derek.yuteng.chen', 'ktomlee']",17,"['pappumerijaan', 'shamika', 'shreyasshah14', 'mhatreravindra11', 'sayalimhatre7195', 'khan.nabed65', 'komalkolekar95', 'nilesh15394', 'inderjitsingh87', 'mrinalivyas1', 'karthik.radhakrishna022', 'nakshay07', 'ektaramani8', 'ajoshi1996', 'harshmhatre975', 'harshpatel201996', None]",149,"['geno1024', 'sachuthan95', 'justgonnausethisonce', 'baldur.kristoffer', 'komalkolekar95', 'oaq1982', 'mosuji', 'gawlick', 'ontiveros', 'shamika', 'claire.726', 'anantgugi2009', 'rhbrammall', 'karthik.radhakrishna022', 'brandonstrickland', 'nonabuh', 'tommylau94', 'steven.petteruti', 'dorae48', 'kred', 'drpepper', 'ruthne', 'fishtoufu', 'jsomer15', 'mrinalivyas1', 'zxs70789', 'kwmuth', 'echoonge', 'sdwpearson', 'gjarvis', 'dtiamzon', 'nakshay07', 'ektaramani8', 'jsetow', 'mrlau', 'kkcbyas', 'wjftndjqt', 'rcocomello', 'erewalk', 'nicolesuba', 'evelynlhu', 'darrenxu2011', 'eric.rodrigo', 'ranesh', 'james.soober', 'masheehan', 'enyao', 'dukeruy', 'ryan7926', 'michealmaalouly', 'rhmmoosa', 'ajoshi1996', 'albertchau369', 'dddmmmvvv', 'yannick.3.5', 'szsalim', 'sayalimhatre7195', 'ubc', 'xiaoyangharvard', 'yandersen', 'mmcintosh', 'swaugh', 'brp181', 'zahraalbu', 'mcarmack', 'harrystone', 'khan.nabed65', 'hardikganatra20', 'tgmcnamara', 'harshpatel201996', 'joloo', 'jpricci', 'jdscharf', 'nbobbs', 'moo', 'd213', 'dylanmunro', '6383tewarid', 'jasreen4', 'jbonk', 'itisishan', 'tgm929', 'jamcavoy', 'lettycastrejonbarron', 'yanrayli', 'sbermudez', 'thayerwade', 'sandlee', 'mhatreravindra11', 'antvapour', 'mamohamed', 'meghancockcroft', 'mikemai512', 'wycnano', 'tingzhou', 'sanu.bhide', 'charansri1994', 'shreyasshah14', 'prateekbindra', 'heinen', 'kothari.dhruvin.dk', 'nilesh15394', 'zuhairsn', 'slthomas', 'ekcole', 'harshmhatre975', 'pappumerijaan', 'michaelhaaf', 'rogerluo_dsc1995', 'h9u9a', 'smanivanh', 'ar923', 'shaheer.aamir', 'pearsedoolin', 'nikolascable', 'npontiv9', 'xiaoyangxiaoyang', 'knite9510', 'mmcintosh1227', 'yongchengwang', 'julian.mele', 'essie.mutinda', 'abs0o', 'mac156', 'ayushgupta11031996', 'ldarrick', 'cyj667', 'ikreisz', 'jplatt', 'dkwok', 'jrandallzl', 'zhougnan', 'andy_lau604', 'javier.laitue', 'sen120nikhil', 'tsui054', 'mitchellho94', None, 'pcui00', 'oweeparadkar', 'bmabetha', 'grahamjdd', 'mozer', 'inderjitsingh87', 'rafael95', 'fraps', 'angelazhou', 'derek.yuteng.chen', 'ktomlee']"
3,46,133,16,1,['kothari.dhruvin.dk'],131,"['geno1024', 'sachuthan95', 'justgonnausethisonce', 'baldur.kristoffer', 'oaq1982', 'mosuji', 'gawlick', 'ontiveros', 'claire.726', 'anantgugi2009', 'rhbrammall', 'brandonstrickland', 'nonabuh', 'tommylau94', 'steven.petteruti', 'dorae48', 'kred', 'drpepper', 'ruthne', 'fishtoufu', 'jsomer15', 'zxs70789', 'kwmuth', 'echoonge', 'sdwpearson', 'gjarvis', 'dtiamzon', 'jsetow', 'mrlau', 'kkcbyas', 'wjftndjqt', 'rcocomello', 'erewalk', 'nicolesuba', 'evelynlhu', 'darrenxu2011', 'eric.rodrigo', 'ranesh', 'james.soober', 'masheehan', 'enyao', 'dukeruy', 'ryan7926', 'michealmaalouly', 'rhmmoosa', 'albertchau369', 'dddmmmvvv', 'yannick.3.5', 'szsalim', 'ubc', 'xiaoyangharvard', 'yandersen', 'mmcintosh', 'swaugh', 'brp181', 'zahraalbu', 'mcarmack', 'harrystone', 'hardikganatra20', 'tgmcnamara', 'joloo', 'jpricci', 'jdscharf', 'nbobbs', 'moo', 'd213', 'dylanmunro', '6383tewarid', 'jasreen4', 'jbonk', 'itisishan', 'tgm929', 'jamcavoy', 'lettycastrejonbarron', 'yanrayli', 'sbermudez', 'thayerwade', 'sandlee', 'antvapour', 'mamohamed', 'meghancockcroft', 'mikemai512', 'wycnano', 'tingzhou', 'sanu.bhide', 'charansri1994', 'prateekbindra', 'heinen', 'zuhairsn', 'slthomas', 'ekcole', 'michaelhaaf', 'rogerluo_dsc1995', 'h9u9a', 'smanivanh', 'ar923', 'shaheer.aamir', 'pearsedoolin', 'nikolascable', 'npontiv9', 'xiaoyangxiaoyang', 'knite9510', 'mmcintosh1227', 'yongchengwang', 'julian.mele', 'essie.mutinda', 'abs0o', 'mac156', 'ayushgupta11031996', 'ldarrick', 'cyj667', 'ikreisz', 'jplatt', 'dkwok', 'jrandallzl', 'zhougnan', 'andy_lau604', 'javier.laitue', 'sen120nikhil', 'tsui054', 'mitchellho94', 'pcui00', 'oweeparadkar', 'bmabetha', 'grahamjdd', 'mozer', 'rafael95', 'fraps', 'angelazhou', 'derek.yuteng.chen', 'ktomlee']",15,"['riteshrajput381', 'helloworld1', 'tzatakia', 'aamod1996', 'vora.jai1', 'geetgandhi96', 'vaibhavvadia', 'mayureshvartak30', 'umang.parekh30', 'mananmehta95', 'sankheneel', 'vishwanathan.anirudh', 'harshvardhandave1112', None, 'djeskay27']",147,"['geno1024', 'sachuthan95', 'justgonnausethisonce', 'baldur.kristoffer', 'oaq1982', 'mosuji', 'gawlick', 'ontiveros', 'claire.726', 'anantgugi2009', 'rhbrammall', 'brandonstrickland', 'nonabuh', 'tommylau94', 'steven.petteruti', 'dorae48', 'kred', 'drpepper', 'ruthne', 'fishtoufu', 'jsomer15', 'zxs70789', 'harshvardhandave1112', 'vora.jai1', 'riteshrajput381', 'kwmuth', 'echoonge', 'sdwpearson', 'gjarvis', 'dtiamzon', 'jsetow', 'mrlau', 'kkcbyas', 'wjftndjqt', 'rcocomello', 'erewalk', 'nicolesuba', 'evelynlhu', 'darrenxu2011', 'eric.rodrigo', 'ranesh', 'james.soober', 'masheehan', 'enyao', 'dukeruy', 'geetgandhi96', 'ryan7926', 'michealmaalouly', 'rhmmoosa', 'albertchau369', 'dddmmmvvv', 'yannick.3.5', 'szsalim', 'ubc', 'xiaoyangharvard', 'yandersen', 'mmcintosh', 'swaugh', 'brp181', 'zahraalbu', 'mcarmack', 'harrystone', 'hardikganatra20', 'tgmcnamara', 'mayureshvartak30', 'vishwanathan.anirudh', 'joloo', 'jpricci', 'jdscharf', 'nbobbs', 'moo', 'd213', 'dylanmunro', 'aamod1996', '6383tewarid', 'jasreen4', 'jbonk', 'itisishan', 'sankheneel', 'tgm929', 'jamcavoy', 'lettycastrejonbarron', 'yanrayli', 'sbermudez', 'thayerwade', 'sandlee', 'antvapour', 'mamohamed', 'meghancockcroft', 'mikemai512', 'wycnano', 'tingzhou', 'sanu.bhide', 'charansri1994', 'prateekbindra', 'heinen', 'kothari.dhruvin.dk', 'zuhairsn', 'slthomas', 'ekcole', 'djeskay27', 'michaelhaaf', 'rogerluo_dsc1995', 'h9u9a', 'smanivanh', 'ar923', 'shaheer.aamir', 'pearsedoolin', 'nikolascable', 'npontiv9', 'tzatakia', 'xiaoyangxiaoyang', 'knite9510', 'mmcintosh1227', 'yongchengwang', 'julian.mele', 'umang.parekh30', 'essie.mutinda', 'mananmehta95', 'abs0o', 'mac156', 'ayushgupta11031996', 'ldarrick', 'cyj667', 'ikreisz', 'jplatt', 'helloworld1', 'dkwok', 'jrandallzl', 'vaibhavvadia', 'zhougnan', 'andy_lau604', 'javier.laitue', 'sen120nikhil', 'tsui054', 'mitchellho94', None, 'pcui00', 'oweeparadkar', 'bmabetha', 'grahamjdd', 'mozer', 'rafael95', 'fraps', 'angelazhou', 'derek.yuteng.chen', 'ktomlee']"
3,152,133,16,5,"['moo', 'sandlee', 'rcocomello', 'ekcole', 'mamohamed']",127,"['geno1024', 'sachuthan95', 'justgonnausethisonce', 'baldur.kristoffer', 'oaq1982', 'mosuji', 'gawlick', 'ontiveros', 'claire.726', 'anantgugi2009', 'rhbrammall', 'brandonstrickland', 'nonabuh', 'tommylau94', 'steven.petteruti', 'dorae48', 'kred', 'drpepper', 'ruthne', 'fishtoufu', 'jsomer15', 'zxs70789', 'kwmuth', 'echoonge', 'sdwpearson', 'gjarvis', 'dtiamzon', 'jsetow', 'mrlau', 'kkcbyas', 'wjftndjqt', 'erewalk', 'nicolesuba', 'evelynlhu', 'darrenxu2011', 'eric.rodrigo', 'ranesh', 'james.soober', 'masheehan', 'enyao', 'dukeruy', 'ryan7926', 'michealmaalouly', 'rhmmoosa', 'albertchau369', 'dddmmmvvv', 'yannick.3.5', 'szsalim', 'ubc', 'xiaoyangharvard', 'yandersen', 'mmcintosh', 'swaugh', 'brp181', 'zahraalbu', 'mcarmack', 'harrystone', 'hardikganatra20', 'tgmcnamara', 'joloo', 'jpricci', 'jdscharf', 'nbobbs', 'd213', 'dylanmunro', '6383tewarid', 'jasreen4', 'jbonk', 'itisishan', 'tgm929', 'jamcavoy', 'lettycastrejonbarron', 'yanrayli', 'sbermudez', 'thayerwade', 'antvapour', 'meghancockcroft', 'mikemai512', 'wycnano', 'tingzhou', 'sanu.bhide', 'charansri1994', 'prateekbindra', 'heinen', 'kothari.dhruvin.dk', 'zuhairsn', 'slthomas', 'michaelhaaf', 'rogerluo_dsc1995', 'h9u9a', 'smanivanh', 'ar923', 'shaheer.aamir', 'pearsedoolin', 'nikolascable', 'npontiv9', 'xiaoyangxiaoyang', 'knite9510', 'mmcintosh1227', 'yongchengwang', 'julian.mele', 'essie.mutinda', 'abs0o', 'mac156', 'ayushgupta11031996', 'ldarrick', 'cyj667', 'ikreisz', 'jplatt', 'dkwok', 'jrandallzl', 'zhougnan', 'andy_lau604', 'javier.laitue', 'sen120nikhil', 'tsui054', 'mitchellho94', 'pcui00', 'oweeparadkar', 'bmabetha', 'grahamjdd', 'mozer', 'rafael95', 'fraps', 'angelazhou', 'derek.yuteng.chen', 'ktomlee']",11,"['eadachi', 'aksamija', 'sjlucey', 'jkestyn', 'bmarszalkows', 'bgalaske', 'sauwerda', 'steve0022', 'jmgallant', None, 'spalmer5521']",143,"['geno1024', 'sachuthan95', 'sjlucey', 'justgonnausethisonce', 'baldur.kristoffer', 'oaq1982', 'mosuji', 'gawlick', 'ontiveros', 'spalmer5521', 'claire.726', 'anantgugi2009', 'rhbrammall', 'brandonstrickland', 'nonabuh', 'tommylau94', 'steven.petteruti', 'dorae48', 'kred', 'drpepper', 'ruthne', 'fishtoufu', 'jsomer15', 'zxs70789', 'kwmuth', 'echoonge', 'sdwpearson', 'gjarvis', 'dtiamzon', 'jsetow', 'mrlau', 'kkcbyas', 'wjftndjqt', 'rcocomello', 'erewalk', 'bgalaske', 'nicolesuba', 'evelynlhu', 'darrenxu2011', 'eric.rodrigo', 'ranesh', 'james.soober', 'masheehan', 'enyao', 'dukeruy', 'ryan7926', 'michealmaalouly', 'rhmmoosa', 'albertchau369', 'dddmmmvvv', 'yannick.3.5', 'szsalim', 'ubc', 'xiaoyangharvard', 'yandersen', 'mmcintosh', 'swaugh', 'brp181', 'zahraalbu', 'mcarmack', 'harrystone', 'hardikganatra20', 'tgmcnamara', 'bmarszalkows', 'joloo', 'jpricci', 'jdscharf', 'nbobbs', 'moo', 'd213', 'dylanmunro', '6383tewarid', 'jasreen4', 'jbonk', 'itisishan', 'tgm929', 'jamcavoy', 'lettycastrejonbarron', 'jkestyn', 'yanrayli', 'sbermudez', 'thayerwade', 'sandlee', 'antvapour', 'mamohamed', 'meghancockcroft', 'mikemai512', 'wycnano', 'tingzhou', 'sanu.bhide', 'charansri1994', 'prateekbindra', 'heinen', 'sauwerda', 'kothari.dhruvin.dk', 'zuhairsn', 'slthomas', 'ekcole', 'jmgallant', 'michaelhaaf', 'rogerluo_dsc1995', 'h9u9a', 'smanivanh', 'ar923', 'shaheer.aamir', 'pearsedoolin', 'nikolascable', 'npontiv9', 'aksamija', 'xiaoyangxiaoyang', 'knite9510', 'mmcintosh1227', 'yongchengwang', 'julian.mele', 'essie.mutinda', 'abs0o', 'eadachi', 'mac156', 'ayushgupta11031996', 'ldarrick', 'cyj667', 'ikreisz', 'jplatt', 'dkwok', 'jrandallzl', 'zhougnan', 'andy_lau604', 'javier.laitue', 'steve0022', 'sen120nikhil', 'tsui054', 'mitchellho94', None, 'pcui00', 'oweeparadkar', 'bmabetha', 'grahamjdd', 'mozer', 'rafael95', 'fraps', 'angelazhou', 'derek.yuteng.chen', 'ktomlee']"
3,212,133,10,8,"['sanu.bhide', 'pcui00', 'kwmuth', 'ubc', 'rhbrammall', 'jasreen4', 'fishtoufu', 'tsui054']",124,"['geno1024', 'sachuthan95', 'justgonnausethisonce', 'baldur.kristoffer', 'oaq1982', 'mosuji', 'gawlick', 'ontiveros', 'claire.726', 'anantgugi2009', 'brandonstrickland', 'nonabuh', 'tommylau94', 'steven.petteruti', 'dorae48', 'kred', 'drpepper', 'ruthne', 'jsomer15', 'zxs70789', 'echoonge', 'sdwpearson', 'gjarvis', 'dtiamzon', 'jsetow', 'mrlau', 'kkcbyas', 'wjftndjqt', 'rcocomello', 'erewalk', 'nicolesuba', 'evelynlhu', 'darrenxu2011', 'eric.rodrigo', 'ranesh', 'james.soober', 'masheehan', 'enyao', 'dukeruy', 'ryan7926', 'michealmaalouly', 'rhmmoosa', 'albertchau369', 'dddmmmvvv', 'yannick.3.5', 'szsalim', 'xiaoyangharvard', 'yandersen', 'mmcintosh', 'swaugh', 'brp181', 'zahraalbu', 'mcarmack', 'harrystone', 'hardikganatra20', 'tgmcnamara', 'joloo', 'jpricci', 'jdscharf', 'nbobbs', 'moo', 'd213', 'dylanmunro', '6383tewarid', 'jbonk', 'itisishan', 'tgm929', 'jamcavoy', 'lettycastrejonbarron', 'yanrayli', 'sbermudez', 'thayerwade', 'sandlee', 'antvapour', 'mamohamed', 'meghancockcroft', 'mikemai512', 'wycnano', 'tingzhou', 'charansri1994', 'prateekbindra', 'heinen', 'kothari.dhruvin.dk', 'zuhairsn', 'slthomas', 'ekcole', 'michaelhaaf', 'rogerluo_dsc1995', 'h9u9a', 'smanivanh', 'ar923', 'shaheer.aamir', 'pearsedoolin', 'nikolascable', 'npontiv9', 'xiaoyangxiaoyang', 'knite9510', 'mmcintosh1227', 'yongchengwang', 'julian.mele', 'essie.mutinda', 'abs0o', 'mac156', 'ayushgupta11031996', 'ldarrick', 'cyj667', 'ikreisz', 'jplatt', 'dkwok', 'jrandallzl', 'zhougnan', 'andy_lau604', 'javier.laitue', 'sen120nikhil', 'mitchellho94', 'oweeparadkar', 'bmabetha', 'grahamjdd', 'mozer', 'rafael95', 'fraps', 'angelazhou', 'derek.yuteng.chen', 'ktomlee']",2,"[None, 'pompay95']",134,"['geno1024', 'sachuthan95', 'justgonnausethisonce', 'baldur.kristoffer', 'oaq1982', 'mosuji', 'gawlick', 'ontiveros', 'claire.726', 'anantgugi2009', 'rhbrammall', 'brandonstrickland', 'nonabuh', 'tommylau94', 'steven.petteruti', 'dorae48', 'kred', 'drpepper', 'ruthne', 'fishtoufu', 'jsomer15', 'zxs70789', 'kwmuth', 'echoonge', 'sdwpearson', 'gjarvis', 'dtiamzon', 'jsetow', 'mrlau', 'kkcbyas', 'wjftndjqt', 'rcocomello', 'erewalk', 'nicolesuba', 'evelynlhu', 'darrenxu2011', 'eric.rodrigo', 'ranesh', 'james.soober', 'masheehan', 'enyao', 'dukeruy', 'ryan7926', 'michealmaalouly', 'rhmmoosa', 'albertchau369', 'dddmmmvvv', 'yannick.3.5', 'szsalim', 'ubc', 'xiaoyangharvard', 'yandersen', 'mmcintosh', 'swaugh', 'brp181', 'zahraalbu', 'mcarmack', 'harrystone', 'hardikganatra20', 'tgmcnamara', 'joloo', 'jpricci', 'jdscharf', 'nbobbs', 'moo', 'd213', 'dylanmunro', '6383tewarid', 'jasreen4', 'jbonk', 'itisishan', 'tgm929', 'jamcavoy', 'lettycastrejonbarron', 'yanrayli', 'sbermudez', 'thayerwade', 'sandlee', 'antvapour', 'mamohamed', 'meghancockcroft', 'mikemai512', 'wycnano', 'tingzhou', 'sanu.bhide', 'charansri1994', 'prateekbindra', 'heinen', 'kothari.dhruvin.dk', 'zuhairsn', 'slthomas', 'ekcole', 'michaelhaaf', 'rogerluo_dsc1995', 'h9u9a', 'smanivanh', 'pompay95', 'ar923', 'shaheer.aamir', 'pearsedoolin', 'nikolascable', 'npontiv9', 'xiaoyangxiaoyang', 'knite9510', 'mmcintosh1227', 'yongchengwang', 'julian.mele', 'essie.mutinda', 'abs0o', 'mac156', 'ayushgupta11031996', 'ldarrick', 'cyj667', 'ikreisz', 'jplatt', 'dkwok', 'jrandallzl', 'zhougnan', 'andy_lau604', 'javier.laitue', 'sen120nikhil', 'tsui054', 'mitchellho94', None, 'pcui00', 'oweeparadkar', 'bmabetha', 'grahamjdd', 'mozer', 'rafael95', 'fraps', 'angelazhou', 'derek.yuteng.chen', 'ktomlee']"
3,208,133,8,1,['kothari.dhruvin.dk'],131,"['geno1024', 'sachuthan95', 'justgonnausethisonce', 'baldur.kristoffer', 'oaq1982', 'mosuji', 'gawlick', 'ontiveros', 'claire.726', 'anantgugi2009', 'rhbrammall', 'brandonstrickland', 'nonabuh', 'tommylau94', 'steven.petteruti', 'dorae48', 'kred', 'drpepper', 'ruthne', 'fishtoufu', 'jsomer15', 'zxs70789', 'kwmuth', 'echoonge', 'sdwpearson', 'gjarvis', 'dtiamzon', 'jsetow', 'mrlau', 'kkcbyas', 'wjftndjqt', 'rcocomello', 'erewalk', 'nicolesuba', 'evelynlhu', 'darrenxu2011', 'eric.rodrigo', 'ranesh', 'james.soober', 'masheehan', 'enyao', 'dukeruy', 'ryan7926', 'michealmaalouly', 'rhmmoosa', 'albertchau369', 'dddmmmvvv', 'yannick.3.5', 'szsalim', 'ubc', 'xiaoyangharvard', 'yandersen', 'mmcintosh', 'swaugh', 'brp181', 'zahraalbu', 'mcarmack', 'harrystone', 'hardikganatra20', 'tgmcnamara', 'joloo', 'jpricci', 'jdscharf', 'nbobbs', 'moo', 'd213', 'dylanmunro', '6383tewarid', 'jasreen4', 'jbonk', 'itisishan', 'tgm929', 'jamcavoy', 'lettycastrejonbarron', 'yanrayli', 'sbermudez', 'thayerwade', 'sandlee', 'antvapour', 'mamohamed', 'meghancockcroft', 'mikemai512', 'wycnano', 'tingzhou', 'sanu.bhide', 'charansri1994', 'prateekbindra', 'heinen', 'zuhairsn', 'slthomas', 'ekcole', 'michaelhaaf', 'rogerluo_dsc1995', 'h9u9a', 'smanivanh', 'ar923', 'shaheer.aamir', 'pearsedoolin', 'nikolascable', 'npontiv9', 'xiaoyangxiaoyang', 'knite9510', 'mmcintosh1227', 'yongchengwang', 'julian.mele', 'essie.mutinda', 'abs0o', 'mac156', 'ayushgupta11031996', 'ldarrick', 'cyj667', 'ikreisz', 'jplatt', 'dkwok', 'jrandallzl', 'zhougnan', 'andy_lau604', 'javier.laitue', 'sen120nikhil', 'tsui054', 'mitchellho94', 'pcui00', 'oweeparadkar', 'bmabetha', 'grahamjdd', 'mozer', 'rafael95', 'fraps', 'angelazhou', 'derek.yuteng.chen', 'ktomlee']",7,"['desaimaanil2', 'ramuamt', 'redorchid029', 'mananmehta95', 'chinmayhejmadi', None, 'ramjighatala7']",139,"['geno1024', 'sachuthan95', 'justgonnausethisonce', 'baldur.kristoffer', 'oaq1982', 'mosuji', 'gawlick', 'ontiveros', 'claire.726', 'anantgugi2009', 'rhbrammall', 'brandonstrickland', 'nonabuh', 'tommylau94', 'chinmayhejmadi', 'steven.petteruti', 'dorae48', 'kred', 'drpepper', 'ruthne', 'fishtoufu', 'jsomer15', 'zxs70789', 'kwmuth', 'echoonge', 'sdwpearson', 'gjarvis', 'dtiamzon', 'jsetow', 'mrlau', 'kkcbyas', 'wjftndjqt', 'rcocomello', 'erewalk', 'nicolesuba', 'evelynlhu', 'darrenxu2011', 'eric.rodrigo', 'ranesh', 'james.soober', 'masheehan', 'enyao', 'dukeruy', 'ryan7926', 'michealmaalouly', 'rhmmoosa', 'desaimaanil2', 'albertchau369', 'dddmmmvvv', 'yannick.3.5', 'szsalim', 'ubc', 'xiaoyangharvard', 'yandersen', 'mmcintosh', 'swaugh', 'brp181', 'zahraalbu', 'mcarmack', 'harrystone', 'hardikganatra20', 'tgmcnamara', 'joloo', 'jpricci', 'jdscharf', 'nbobbs', 'moo', 'd213', 'dylanmunro', '6383tewarid', 'jasreen4', 'jbonk', 'itisishan', 'tgm929', 'jamcavoy', 'lettycastrejonbarron', 'yanrayli', 'sbermudez', 'thayerwade', 'sandlee', 'antvapour', 'mamohamed', 'meghancockcroft', 'mikemai512', 'wycnano', 'tingzhou', 'sanu.bhide', 'charansri1994', 'prateekbindra', 'heinen', 'ramuamt', 'kothari.dhruvin.dk', 'zuhairsn', 'slthomas', 'ekcole', 'michaelhaaf', 'rogerluo_dsc1995', 'h9u9a', 'smanivanh', 'ar923', 'shaheer.aamir', 'pearsedoolin', 'nikolascable', 'npontiv9', 'xiaoyangxiaoyang', 'knite9510', 'mmcintosh1227', 'yongchengwang', 'julian.mele', 'essie.mutinda', 'mananmehta95', 'abs0o', 'mac156', 'ayushgupta11031996', 'ldarrick', 'cyj667', 'ikreisz', 'jplatt', 'dkwok', 'jrandallzl', 'zhougnan', 'andy_lau604', 'javier.laitue', 'redorchid029', 'sen120nikhil', 'tsui054', 'mitchellho94', None, 'ramjighatala7', 'pcui00', 'oweeparadkar', 'bmabetha', 'grahamjdd', 'mozer', 'rafael95', 'fraps', 'angelazhou', 'derek.yuteng.chen', 'ktomlee']"
3,199,133,6,3,"['abs0o', 'kred', 'zahraalbu']",129,"['geno1024', 'sachuthan95', 'justgonnausethisonce', 'baldur.kristoffer', 'oaq1982', 'mosuji', 'gawlick', 'ontiveros', 'claire.726', 'anantgugi2009', 'rhbrammall', 'brandonstrickland', 'nonabuh', 'tommylau94', 'steven.petteruti', 'dorae48', 'drpepper', 'ruthne', 'fishtoufu', 'jsomer15', 'zxs70789', 'kwmuth', 'echoonge', 'sdwpearson', 'gjarvis', 'dtiamzon', 'jsetow', 'mrlau', 'kkcbyas', 'wjftndjqt', 'rcocomello', 'erewalk', 'nicolesuba', 'evelynlhu', 'darrenxu2011', 'eric.rodrigo', 'ranesh', 'james.soober', 'masheehan', 'enyao', 'dukeruy', 'ryan7926', 'michealmaalouly', 'rhmmoosa', 'albertchau369', 'dddmmmvvv', 'yannick.3.5', 'szsalim', 'ubc', 'xiaoyangharvard', 'yandersen', 'mmcintosh', 'swaugh', 'brp181', 'mcarmack', 'harrystone', 'hardikganatra20', 'tgmcnamara', 'joloo', 'jpricci', 'jdscharf', 'nbobbs', 'moo', 'd213', 'dylanmunro', '6383tewarid', 'jasreen4', 'jbonk', 'itisishan', 'tgm929', 'jamcavoy', 'lettycastrejonbarron', 'yanrayli', 'sbermudez', 'thayerwade', 'sandlee', 'antvapour', 'mamohamed', 'meghancockcroft', 'mikemai512', 'wycnano', 'tingzhou', 'sanu.bhide', 'charansri1994', 'prateekbindra', 'heinen', 'kothari.dhruvin.dk', 'zuhairsn', 'slthomas', 'ekcole', 'michaelhaaf', 'rogerluo_dsc1995', 'h9u9a', 'smanivanh', 'ar923', 'shaheer.aamir', 'pearsedoolin', 'nikolascable', 'npontiv9', 'xiaoyangxiaoyang', 'knite9510', 'mmcintosh1227', 'yongchengwang', 'julian.mele', 'essie.mutinda', 'mac156', 'ayushgupta11031996', 'ldarrick', 'cyj667', 'ikreisz', 'jplatt', 'dkwok', 'jrandallzl', 'zhougnan', 'andy_lau604', 'javier.laitue', 'sen120nikhil', 'tsui054', 'mitchellho94', 'pcui00', 'oweeparadkar', 'bmabetha', 'grahamjdd', 'mozer', 'rafael95', 'fraps', 'angelazhou', 'derek.yuteng.chen', 'ktomlee']",3,"['mtgho', 'mahmoud.alshamrani', None]",135,"['geno1024', 'sachuthan95', 'justgonnausethisonce', 'baldur.kristoffer', 'oaq1982', 'mosuji', 'gawlick', 'ontiveros', 'claire.726', 'anantgugi2009', 'rhbrammall', 'brandonstrickland', 'nonabuh', 'tommylau94', 'steven.petteruti', 'dorae48', 'kred', 'drpepper', 'ruthne', 'fishtoufu', 'jsomer15', 'zxs70789', 'kwmuth', 'echoonge', 'sdwpearson', 'gjarvis', 'dtiamzon', 'jsetow', 'mrlau', 'kkcbyas', 'wjftndjqt', 'rcocomello', 'erewalk', 'nicolesuba', 'evelynlhu', 'darrenxu2011', 'eric.rodrigo', 'ranesh', 'james.soober', 'masheehan', 'enyao', 'dukeruy', 'ryan7926', 'michealmaalouly', 'rhmmoosa', 'albertchau369', 'dddmmmvvv', 'yannick.3.5', 'szsalim', 'ubc', 'xiaoyangharvard', 'yandersen', 'mmcintosh', 'swaugh', 'brp181', 'zahraalbu', 'mcarmack', 'harrystone', 'hardikganatra20', 'tgmcnamara', 'joloo', 'jpricci', 'jdscharf', 'nbobbs', 'moo', 'd213', 'dylanmunro', '6383tewarid', 'jasreen4', 'jbonk', 'itisishan', 'tgm929', 'jamcavoy', 'lettycastrejonbarron', 'yanrayli', 'sbermudez', 'thayerwade', 'sandlee', 'antvapour', 'mamohamed', 'mtgho', 'meghancockcroft', 'mikemai512', 'wycnano', 'tingzhou', 'sanu.bhide', 'charansri1994', 'prateekbindra', 'heinen', 'kothari.dhruvin.dk', 'zuhairsn', 'slthomas', 'ekcole', 'michaelhaaf', 'rogerluo_dsc1995', 'h9u9a', 'smanivanh', 'ar923', 'shaheer.aamir', 'pearsedoolin', 'nikolascable', 'npontiv9', 'xiaoyangxiaoyang', 'knite9510', 'mmcintosh1227', 'yongchengwang', 'julian.mele', 'essie.mutinda', 'abs0o', 'mac156', 'ayushgupta11031996', 'ldarrick', 'cyj667', 'ikreisz', 'jplatt', 'mahmoud.alshamrani', 'dkwok', 'jrandallzl', 'zhougnan', 'andy_lau604', 'javier.laitue', 'sen120nikhil', 'tsui054', 'mitchellho94', None, 'pcui00', 'oweeparadkar', 'bmabetha', 'grahamjdd', 'mozer', 'rafael95', 'fraps', 'angelazhou', 'derek.yuteng.chen', 'ktomlee']"
4,74,129,53,49,"['jtherber', 'holmano', 'nbasnet', 'xalmeida11', 'zhuber6', 'dillons', 'cody.campana', 'mtomas', 'nakhoa92', 'jhseto', 'brockhaft1994', 'joshemminger', '2muchswag93', 'klefevre20', 'eapost', 'jcarriola0118', 'pzinni', 'xiangl19', 'afifeh91', 'csteeno15', 'kiddevin', 'jdmart22', 'nrodkey', 'adireddevil712', 'kanguye1', 'rlin11', 'toamikel', 'jshwilams767', 'skykeeper0', 'jmhern16', 'sdshiladitya', 'pandapot', 'bsankar2', 'sayedserhan', 'zdrummon', 'jayjay1122', 'zkiefer', 'mvcortez', 'drcornel', 'jwbrown1210', 'hongbin.yu', 'rdbaca', 'mtmunir', 'eszelech', 'djorivco', 'jdull', 'alucas3', 'pkoswatt', 'jzia1']",79,"['tmccrack', 'black89', 'ashapiee', 'j.andregon15', 'mariae.ballesterosg', 'taniacordoba1', 'rinoop6', 'ikukokitamura', 'briangoldn', 'camilaaa', 'samaher_salem', 'donjb2007', 'sourabh.mnit12', 'danielesparza', 'alshamrani', 'cpotdevin', 'swasti9', 'sergionemoga', 'praterj', 'swinart', 'cnietovesga9510', 'kearrnz', 'jf.guerrero10', 'lizethj.perezr', 'eap.rodriguez', 'kwisbroc', 'yaceved1', 'hkdavis3', 'edavilae', 'materiales', 'walke149', 'alborg93', 'simpkns2', 'dannycardenas48', 'arosner', 'joshpaige', 'sylee', 'swarnadipm', 'wbloebau', 'akramkarimi1036', 'sergiocamilo97', 'akr123', 'laura.arias', 'asad.6064', 'lbassett', 'tnagulu', 'tcollins2', 'timdonnelly92', 'js.woodcock2202', 'zgossage88', 'msinani', 'johnr.duranr', 'shresthaanmol', 'js.rgalan', 'vcravens333', 'lufelaar', 'faisal4ff', 'nickzea', 'khalelop', 'aogentil10', 'jennypaolagalan', 'joefrag9', 'dapino06', 'sebastian0722', 'kharken1', 'jonnya.gaitanb1', 'mvandeput', 'mcshin', 'anthonyrb', 'eruzombe', 'julien419', 'loganr94', 'yingsu001', 'cheng159', 'zhou502', 'bardella', 'mateocastaneda', 'kcrain', 'astridmejiat']",4,"['navnano1034', None, 'harshjain2691', 'kvirgen']",132,"['tmccrack', 'black89', 'ashapiee', 'dillons', 'j.andregon15', 'nakhoa92', '2muchswag93', 'brockhaft1994', 'mariae.ballesterosg', 'klefevre20', 'taniacordoba1', 'rinoop6', 'ikukokitamura', 'csteeno15', 'briangoldn', 'camilaaa', 'samaher_salem', 'donjb2007', 'sourabh.mnit12', 'danielesparza', 'alshamrani', 'cpotdevin', 'swasti9', 'sergionemoga', 'sayedserhan', 'jayjay1122', 'mvcortez', 'drcornel', 'mtmunir', 'jwbrown1210', 'rdbaca', 'praterj', 'djorivco', 'jdull', 'swinart', 'cnietovesga9510', 'harshjain2691', 'kearrnz', 'jf.guerrero10', 'xalmeida11', 'lizethj.perezr', 'eap.rodriguez', 'jhseto', 'joshemminger', 'kwisbroc', 'yaceved1', 'hkdavis3', 'edavilae', 'materiales', 'kiddevin', 'walke149', 'alborg93', 'jdmart22', 'adireddevil712', 'simpkns2', 'skykeeper0', 'dannycardenas48', 'arosner', 'joshpaige', 'sylee', 'zkiefer', 'swarnadipm', 'wbloebau', 'akramkarimi1036', 'kvirgen', 'alucas3', 'jzia1', 'holmano', 'sergiocamilo97', 'nbasnet', 'akr123', 'laura.arias', 'asad.6064', 'zhuber6', 'cody.campana', 'lbassett', 'tnagulu', 'tcollins2', 'timdonnelly92', 'pzinni', 'js.woodcock2202', 'xiangl19', 'zgossage88', 'msinani', 'johnr.duranr', 'nrodkey', 'shresthaanmol', 'js.rgalan', 'sdshiladitya', 'vcravens333', 'lufelaar', 'faisal4ff', 'nickzea', 'khalelop', 'aogentil10', 'hongbin.yu', 'jennypaolagalan', 'navnano1034', 'joefrag9', 'dapino06', 'sebastian0722', 'kharken1', 'jtherber', 'jonnya.gaitanb1', 'mvandeput', 'mtomas', 'mcshin', 'eapost', 'jcarriola0118', 'anthonyrb', 'afifeh91', 'eruzombe', 'julien419', 'loganr94', 'kanguye1', 'rlin11', 'yingsu001', 'toamikel', 'jshwilams767', 'cheng159', 'jmhern16', 'bsankar2', 'pandapot', 'zhou502', None, 'bardella', 'zdrummon', 'mateocastaneda', 'eszelech', 'pkoswatt', 'kcrain', 'astridmejiat']"
4,75,129,45,2,"['hkdavis3', 'samaher_salem']",126,"['tmccrack', 'black89', 'ashapiee', 'dillons', 'j.andregon15', 'nakhoa92', '2muchswag93', 'brockhaft1994', 'klefevre20', 'mariae.ballesterosg', 'taniacordoba1', 'rinoop6', 'ikukokitamura', 'csteeno15', 'briangoldn', 'camilaaa', 'donjb2007', 'sourabh.mnit12', 'danielesparza', 'alshamrani', 'cpotdevin', 'swasti9', 'sergionemoga', 'sayedserhan', 'jayjay1122', 'mvcortez', 'drcornel', 'mtmunir', 'jwbrown1210', 'rdbaca', 'praterj', 'swinart', 'djorivco', 'jdull', 'cnietovesga9510', 'kearrnz', 'jf.guerrero10', 'xalmeida11', 'lizethj.perezr', 'eap.rodriguez', 'jhseto', 'joshemminger', 'kwisbroc', 'yaceved1', 'edavilae', 'materiales', 'kiddevin', 'walke149', 'alborg93', 'jdmart22', 'adireddevil712', 'simpkns2', 'skykeeper0', 'dannycardenas48', 'arosner', 'joshpaige', 'sylee', 'zkiefer', 'swarnadipm', 'wbloebau', 'akramkarimi1036', 'alucas3', 'jzia1', 'holmano', 'sergiocamilo97', 'nbasnet', 'akr123', 'laura.arias', 'asad.6064', 'zhuber6', 'cody.campana', 'lbassett', 'tnagulu', 'tcollins2', 'timdonnelly92', 'pzinni', 'js.woodcock2202', 'xiangl19', 'zgossage88', 'msinani', 'johnr.duranr', 'nrodkey', 'shresthaanmol', 'js.rgalan', 'sdshiladitya', 'vcravens333', 'lufelaar', 'faisal4ff', 'nickzea', 'khalelop', 'aogentil10', 'hongbin.yu', 'jennypaolagalan', 'joefrag9', 'dapino06', 'sebastian0722', 'kharken1', 'jtherber', 'jonnya.gaitanb1', 'mvandeput', 'mtomas', 'mcshin', 'eapost', 'jcarriola0118', 'anthonyrb', 'afifeh91', 'eruzombe', 'julien419', 'loganr94', 'kanguye1', 'rlin11', 'yingsu001', 'toamikel', 'jshwilams767', 'cheng159', 'jmhern16', 'bsankar2', 'pandapot', 'zhou502', 'bardella', 'zdrummon', 'mateocastaneda', 'eszelech', 'pkoswatt', 'kcrain', 'astridmejiat']",43,"['jlrigdon', 'jmalle10', 'kmfrink', 'abbaldwi', 'apkellih', 'jaingra2', 'blenin1', 'bmtrevis', 'edeaster', '94tfcwhite', 'kasmit19', 'sufczynski', 'skidwel', 'jlhumph4', 'mmkasper', 'jongkindjoe', 'cngallag', 'cmmetz', 'yyue94', 'msmorave', 'awsmall', 'jhgillen', 'mpbenbow', 'brennerncsuedu', 'jakuhne', 'zzfelemb', 'graham.marshall.9889', 'jlin16', 'npcarlto', 'ijowsian', 'mfreardo', None, 'abloutha', 'elucas', 'secarmea', 'prnolan', 'kbbarbou', 'gthauser', 'bepeter2', 'jtjordan', 'camooney', 'bxruther', 'rjlarrab']",171,"['jlrigdon', 'tmccrack', 'jmalle10', 'black89', 'ashapiee', 'dillons', 'j.andregon15', 'nakhoa92', '2muchswag93', 'brockhaft1994', 'mariae.ballesterosg', 'klefevre20', 'sufczynski', 'taniacordoba1', 'mmkasper', 'rinoop6', 'cngallag', 'msmorave', 'jhgillen', 'ikukokitamura', 'csteeno15', 'briangoldn', 'mpbenbow', 'camilaaa', 'samaher_salem', 'donjb2007', 'jakuhne', 'sourabh.mnit12', 'danielesparza', 'alshamrani', 'cpotdevin', 'swasti9', 'sergionemoga', 'sayedserhan', 'prnolan', 'jayjay1122', 'mvcortez', 'drcornel', 'mtmunir', 'jwbrown1210', 'rdbaca', 'praterj', 'djorivco', 'jdull', 'swinart', 'cnietovesga9510', 'abbaldwi', 'kearrnz', 'blenin1', 'jf.guerrero10', 'xalmeida11', 'lizethj.perezr', 'eap.rodriguez', 'skidwel', 'jhseto', 'joshemminger', 'jlhumph4', 'kwisbroc', 'yaceved1', 'hkdavis3', 'edavilae', 'materiales', 'kiddevin', 'walke149', 'alborg93', 'jdmart22', 'adireddevil712', 'graham.marshall.9889', 'simpkns2', 'jlin16', 'skykeeper0', 'dannycardenas48', 'ijowsian', 'arosner', 'abloutha', 'joshpaige', 'sylee', 'zkiefer', 'swarnadipm', 'gthauser', 'wbloebau', 'akramkarimi1036', 'alucas3', 'rjlarrab', 'jzia1', 'holmano', 'kmfrink', 'sergiocamilo97', 'nbasnet', 'apkellih', 'akr123', 'laura.arias', 'asad.6064', 'zhuber6', 'cody.campana', 'lbassett', 'edeaster', '94tfcwhite', 'tnagulu', 'tcollins2', 'cmmetz', 'timdonnelly92', 'pzinni', 'js.woodcock2202', 'xiangl19', 'zgossage88', 'yyue94', 'msinani', 'johnr.duranr', 'nrodkey', 'shresthaanmol', 'js.rgalan', 'sdshiladitya', 'mfreardo', 'vcravens333', 'lufelaar', 'elucas', 'faisal4ff', 'kbbarbou', 'nickzea', 'khalelop', 'aogentil10', 'hongbin.yu', 'bepeter2', 'jtjordan', 'jennypaolagalan', 'joefrag9', 'bxruther', 'dapino06', 'sebastian0722', 'kharken1', 'jtherber', 'jonnya.gaitanb1', 'jaingra2', 'mvandeput', 'bmtrevis', 'mtomas', 'kasmit19', 'mcshin', 'eapost', 'jongkindjoe', 'jcarriola0118', 'anthonyrb', 'afifeh91', 'eruzombe', 'awsmall', 'brennerncsuedu', 'julien419', 'loganr94', 'zzfelemb', 'kanguye1', 'rlin11', 'yingsu001', 'toamikel', 'jshwilams767', 'npcarlto', 'cheng159', 'jmhern16', 'bsankar2', 'pandapot', 'zhou502', None, 'bardella', 'zdrummon', 'secarmea', 'mateocastaneda', 'eszelech', 'camooney', 'pkoswatt', 'kcrain', 'astridmejiat']"
4,76,129,44,13,"['sebastian0722', 'taniacordoba1', 'lufelaar', 'jonnya.gaitanb1', 'mateocastaneda', 'laura.arias', 'johnr.duranr', 'jennypaolagalan', 'dannycardenas48', 'sergionemoga', 'lizethj.perezr', 'mariae.ballesterosg', 'astridmejiat']",115,"['tmccrack', 'black89', 'ashapiee', 'dillons', 'j.andregon15', 'nakhoa92', '2muchswag93', 'brockhaft1994', 'klefevre20', 'rinoop6', 'ikukokitamura', 'csteeno15', 'briangoldn', 'camilaaa', 'samaher_salem', 'donjb2007', 'sourabh.mnit12', 'danielesparza', 'alshamrani', 'cpotdevin', 'swasti9', 'sayedserhan', 'jayjay1122', 'mvcortez', 'drcornel', 'mtmunir', 'jwbrown1210', 'rdbaca', 'praterj', 'swinart', 'djorivco', 'jdull', 'cnietovesga9510', 'kearrnz', 'jf.guerrero10', 'xalmeida11', 'eap.rodriguez', 'jhseto', 'joshemminger', 'kwisbroc', 'yaceved1', 'hkdavis3', 'edavilae', 'materiales', 'kiddevin', 'walke149', 'alborg93', 'jdmart22', 'adireddevil712', 'simpkns2', 'skykeeper0', 'arosner', 'joshpaige', 'sylee', 'zkiefer', 'swarnadipm', 'wbloebau', 'akramkarimi1036', 'alucas3', 'jzia1', 'holmano', 'sergiocamilo97', 'nbasnet', 'akr123', 'asad.6064', 'zhuber6', 'cody.campana', 'lbassett', 'tnagulu', 'tcollins2', 'timdonnelly92', 'pzinni', 'js.woodcock2202', 'xiangl19', 'zgossage88', 'msinani', 'nrodkey', 'shresthaanmol', 'js.rgalan', 'sdshiladitya', 'vcravens333', 'faisal4ff', 'nickzea', 'khalelop', 'aogentil10', 'hongbin.yu', 'joefrag9', 'dapino06', 'kharken1', 'jtherber', 'mvandeput', 'mtomas', 'mcshin', 'eapost', 'jcarriola0118', 'anthonyrb', 'afifeh91', 'eruzombe', 'julien419', 'loganr94', 'kanguye1', 'rlin11', 'yingsu001', 'toamikel', 'jshwilams767', 'cheng159', 'jmhern16', 'bsankar2', 'pandapot', 'zhou502', 'bardella', 'zdrummon', 'eszelech', 'pkoswatt', 'kcrain']",31,"['michaels.bravob', 'mariaa.montoyam', 'haroldy.herreraa', 'afelipe.blopez', 'juans.torresa', 'maruchale92', 'laurad.sanchezv', 'yedyp.buitragom', 'carolr.delgadol', 'santiagoaninoc', 'luisaf.laraa', 'leidyc.hernandezp', 'soniac.lizcanoc', 'angieespitia1996', 'angieg', 'cindyl.leong', None, 'jonathany.polaniab', 'jhona.gomezd1', 'laurac.porrasb', 'jessicap.contrerasa', 'pips0289', 'hernand.abrilm', 'paulatsanchezt', 'julianai.sanchezc', 'katherinem', 'dianaccabrerac', 'mariac.hernandezq', 'ingridp.rodriguezr', 'luis.reya', 'angiearismendi']",159,"['tmccrack', 'black89', 'ashapiee', 'afelipe.blopez', 'dillons', 'j.andregon15', 'nakhoa92', '2muchswag93', 'brockhaft1994', 'mariae.ballesterosg', 'klefevre20', 'taniacordoba1', 'rinoop6', 'ikukokitamura', 'csteeno15', 'briangoldn', 'camilaaa', 'samaher_salem', 'santiagoaninoc', 'donjb2007', 'sourabh.mnit12', 'danielesparza', 'soniac.lizcanoc', 'angieespitia1996', 'alshamrani', 'cpotdevin', 'swasti9', 'sergionemoga', 'sayedserhan', 'jayjay1122', 'pips0289', 'mvcortez', 'drcornel', 'mtmunir', 'jwbrown1210', 'rdbaca', 'paulatsanchezt', 'katherinem', 'praterj', 'djorivco', 'jdull', 'swinart', 'cnietovesga9510', 'kearrnz', 'michaels.bravob', 'mariaa.montoyam', 'jf.guerrero10', 'xalmeida11', 'lizethj.perezr', 'eap.rodriguez', 'jhseto', 'joshemminger', 'kwisbroc', 'yaceved1', 'hkdavis3', 'edavilae', 'materiales', 'kiddevin', 'walke149', 'alborg93', 'luisaf.laraa', 'jdmart22', 'leidyc.hernandezp', 'adireddevil712', 'simpkns2', 'skykeeper0', 'dannycardenas48', 'cindyl.leong', 'arosner', 'joshpaige', 'sylee', 'hernand.abrilm', 'zkiefer', 'swarnadipm', 'julianai.sanchezc', 'wbloebau', 'mariac.hernandezq', 'luis.reya', 'akramkarimi1036', 'angiearismendi', 'alucas3', 'jzia1', 'holmano', 'sergiocamilo97', 'nbasnet', 'akr123', 'laura.arias', 'haroldy.herreraa', 'asad.6064', 'zhuber6', 'juans.torresa', 'cody.campana', 'lbassett', 'tnagulu', 'tcollins2', 'timdonnelly92', 'pzinni', 'maruchale92', 'js.woodcock2202', 'xiangl19', 'zgossage88', 'laurad.sanchezv', 'yedyp.buitragom', 'carolr.delgadol', 'msinani', 'johnr.duranr', 'nrodkey', 'shresthaanmol', 'js.rgalan', 'sdshiladitya', 'vcravens333', 'lufelaar', 'jonathany.polaniab', 'faisal4ff', 'jhona.gomezd1', 'nickzea', 'khalelop', 'jessicap.contrerasa', 'aogentil10', 'hongbin.yu', 'dianaccabrerac', 'jennypaolagalan', 'joefrag9', 'dapino06', 'sebastian0722', 'kharken1', 'jtherber', 'jonnya.gaitanb1', 'mvandeput', 'mtomas', 'mcshin', 'eapost', 'jcarriola0118', 'anthonyrb', 'afifeh91', 'eruzombe', 'julien419', 'loganr94', 'kanguye1', 'rlin11', 'yingsu001', 'toamikel', 'jshwilams767', 'angieg', 'cheng159', 'jmhern16', 'bsankar2', 'pandapot', 'zhou502', None, 'bardella', 'zdrummon', 'mateocastaneda', 'laurac.porrasb', 'ingridp.rodriguezr', 'eszelech', 'pkoswatt', 'kcrain', 'astridmejiat']"
4,72,129,36,13,"['sergiocamilo97', 'js.woodcock2202', 'js.rgalan', 'nickzea', 'aogentil10', 'cpotdevin', 'jf.guerrero10', 'materiales', 'camilaaa', 'j.andregon15', 'cnietovesga9510', 'eap.rodriguez', 'dapino06']",115,"['tmccrack', 'black89', 'ashapiee', 'dillons', 'nakhoa92', '2muchswag93', 'brockhaft1994', 'klefevre20', 'mariae.ballesterosg', 'taniacordoba1', 'rinoop6', 'ikukokitamura', 'csteeno15', 'briangoldn', 'samaher_salem', 'donjb2007', 'sourabh.mnit12', 'danielesparza', 'alshamrani', 'swasti9', 'sergionemoga', 'sayedserhan', 'jayjay1122', 'mvcortez', 'drcornel', 'mtmunir', 'jwbrown1210', 'rdbaca', 'praterj', 'swinart', 'djorivco', 'jdull', 'kearrnz', 'xalmeida11', 'lizethj.perezr', 'jhseto', 'joshemminger', 'kwisbroc', 'yaceved1', 'hkdavis3', 'edavilae', 'kiddevin', 'walke149', 'alborg93', 'jdmart22', 'adireddevil712', 'simpkns2', 'skykeeper0', 'dannycardenas48', 'arosner', 'joshpaige', 'sylee', 'zkiefer', 'swarnadipm', 'wbloebau', 'akramkarimi1036', 'alucas3', 'jzia1', 'holmano', 'nbasnet', 'akr123', 'laura.arias', 'asad.6064', 'zhuber6', 'cody.campana', 'lbassett', 'tnagulu', 'tcollins2', 'timdonnelly92', 'pzinni', 'xiangl19', 'zgossage88', 'msinani', 'johnr.duranr', 'nrodkey', 'shresthaanmol', 'sdshiladitya', 'vcravens333', 'lufelaar', 'faisal4ff', 'khalelop', 'hongbin.yu', 'jennypaolagalan', 'joefrag9', 'sebastian0722', 'kharken1', 'jtherber', 'jonnya.gaitanb1', 'mvandeput', 'mtomas', 'mcshin', 'eapost', 'jcarriola0118', 'anthonyrb', 'afifeh91', 'eruzombe', 'julien419', 'loganr94', 'kanguye1', 'rlin11', 'yingsu001', 'toamikel', 'jshwilams767', 'cheng159', 'jmhern16', 'bsankar2', 'pandapot', 'zhou502', 'bardella', 'zdrummon', 'mateocastaneda', 'eszelech', 'pkoswatt', 'kcrain', 'astridmejiat']",23,"['duranmarco96', 'jecvmm', 'juanma.lovera', 'cd.florez10', 'af.almanza10', 'jairomisterio', 'toromateoc', 'andfe', 'n2ea', 'crisdavbed08', 'davidparra131', 'henryr9708', 'juancopp97', 'sereta27', 'caliche_764', 'jasive', None, 'fabiant970', 'jassonmolina', 'valentinasandovalb', 'paannamo97', 'wolfangguio07', 'diego_romero_97']",151,"['tmccrack', 'black89', 'ashapiee', 'dillons', 'j.andregon15', 'nakhoa92', '2muchswag93', 'brockhaft1994', 'mariae.ballesterosg', 'klefevre20', 'taniacordoba1', 'rinoop6', 'n2ea', 'ikukokitamura', 'csteeno15', 'briangoldn', 'camilaaa', 'samaher_salem', 'donjb2007', 'sourabh.mnit12', 'danielesparza', 'alshamrani', 'cpotdevin', 'swasti9', 'sergionemoga', 'sayedserhan', 'jayjay1122', 'mvcortez', 'drcornel', 'mtmunir', 'jwbrown1210', 'rdbaca', 'praterj', 'djorivco', 'jdull', 'swinart', 'cnietovesga9510', 'duranmarco96', 'juanma.lovera', 'kearrnz', 'af.almanza10', 'jf.guerrero10', 'xalmeida11', 'lizethj.perezr', 'eap.rodriguez', 'jhseto', 'joshemminger', 'kwisbroc', 'yaceved1', 'hkdavis3', 'edavilae', 'davidparra131', 'materiales', 'kiddevin', 'walke149', 'alborg93', 'sereta27', 'jdmart22', 'adireddevil712', 'simpkns2', 'diego_romero_97', 'skykeeper0', 'dannycardenas48', 'arosner', 'fabiant970', 'joshpaige', 'sylee', 'zkiefer', 'swarnadipm', 'wbloebau', 'akramkarimi1036', 'alucas3', 'wolfangguio07', 'jzia1', 'holmano', 'sergiocamilo97', 'nbasnet', 'akr123', 'laura.arias', 'cd.florez10', 'asad.6064', 'toromateoc', 'zhuber6', 'cody.campana', 'lbassett', 'tnagulu', 'tcollins2', 'andfe', 'timdonnelly92', 'pzinni', 'js.woodcock2202', 'xiangl19', 'zgossage88', 'henryr9708', 'msinani', 'johnr.duranr', 'nrodkey', 'caliche_764', 'shresthaanmol', 'js.rgalan', 'sdshiladitya', 'jasive', 'vcravens333', 'lufelaar', 'faisal4ff', 'nickzea', 'khalelop', 'aogentil10', 'hongbin.yu', 'jennypaolagalan', 'joefrag9', 'dapino06', 'sebastian0722', 'kharken1', 'jtherber', 'jonnya.gaitanb1', 'jecvmm', 'jairomisterio', 'mvandeput', 'mtomas', 'mcshin', 'eapost', 'jcarriola0118', 'anthonyrb', 'crisdavbed08', 'afifeh91', 'eruzombe', 'juancopp97', 'julien419', 'loganr94', 'kanguye1', 'rlin11', 'yingsu001', 'toamikel', 'jshwilams767', 'cheng159', 'jmhern16', 'bsankar2', 'pandapot', 'zhou502', None, 'bardella', 'zdrummon', 'jassonmolina', 'mateocastaneda', 'valentinasandovalb', 'paannamo97', 'eszelech', 'pkoswatt', 'kcrain', 'astridmejiat']"
4,237,129,14,1,['j.andregon15'],127,"['tmccrack', 'black89', 'ashapiee', 'dillons', 'nakhoa92', '2muchswag93', 'brockhaft1994', 'mariae.ballesterosg', 'klefevre20', 'taniacordoba1', 'rinoop6', 'ikukokitamura', 'csteeno15', 'briangoldn', 'camilaaa', 'samaher_salem', 'donjb2007', 'sourabh.mnit12', 'danielesparza', 'alshamrani', 'cpotdevin', 'swasti9', 'sergionemoga', 'sayedserhan', 'jayjay1122', 'mvcortez', 'drcornel', 'mtmunir', 'jwbrown1210', 'rdbaca', 'praterj', 'djorivco', 'jdull', 'swinart', 'cnietovesga9510', 'kearrnz', 'jf.guerrero10', 'xalmeida11', 'lizethj.perezr', 'eap.rodriguez', 'jhseto', 'joshemminger', 'kwisbroc', 'yaceved1', 'hkdavis3', 'edavilae', 'materiales', 'kiddevin', 'walke149', 'alborg93', 'jdmart22', 'adireddevil712', 'simpkns2', 'skykeeper0', 'dannycardenas48', 'arosner', 'joshpaige', 'sylee', 'zkiefer', 'swarnadipm', 'wbloebau', 'akramkarimi1036', 'alucas3', 'jzia1', 'holmano', 'sergiocamilo97', 'nbasnet', 'akr123', 'laura.arias', 'asad.6064', 'zhuber6', 'cody.campana', 'lbassett', 'tnagulu', 'tcollins2', 'timdonnelly92', 'pzinni', 'js.woodcock2202', 'xiangl19', 'zgossage88', 'msinani', 'johnr.duranr', 'nrodkey', 'shresthaanmol', 'js.rgalan', 'sdshiladitya', 'vcravens333', 'lufelaar', 'faisal4ff', 'nickzea', 'khalelop', 'aogentil10', 'hongbin.yu', 'jennypaolagalan', 'joefrag9', 'dapino06', 'sebastian0722', 'kharken1', 'jtherber', 'jonnya.gaitanb1', 'mvandeput', 'mtomas', 'mcshin', 'eapost', 'jcarriola0118', 'anthonyrb', 'afifeh91', 'eruzombe', 'julien419', 'loganr94', 'kanguye1', 'rlin11', 'yingsu001', 'toamikel', 'jshwilams767', 'cheng159', 'jmhern16', 'bsankar2', 'pandapot', 'zhou502', 'bardella', 'zdrummon', 'mateocastaneda', 'eszelech', 'pkoswatt', 'kcrain', 'astridmejiat']",13,"['a.quinto10', 'd.suspes2053', 'gj.diaz10', 'duranmarco96', 'elfenomeno', 'la.avendano10', 'tasmaniabull', 'davidparra131', 'ha.tapia10', 'jgangeli', 'orionsebastian', None, 'diego_romero_97']",141,"['tmccrack', 'black89', 'ashapiee', 'dillons', 'j.andregon15', 'nakhoa92', '2muchswag93', 'brockhaft1994', 'mariae.ballesterosg', 'klefevre20', 'taniacordoba1', 'rinoop6', 'ikukokitamura', 'csteeno15', 'briangoldn', 'camilaaa', 'samaher_salem', 'donjb2007', 'sourabh.mnit12', 'danielesparza', 'alshamrani', 'cpotdevin', 'swasti9', 'sergionemoga', 'sayedserhan', 'jayjay1122', 'mvcortez', 'drcornel', 'mtmunir', 'jwbrown1210', 'rdbaca', 'praterj', 'djorivco', 'jdull', 'swinart', 'cnietovesga9510', 'duranmarco96', 'kearrnz', 'jf.guerrero10', 'xalmeida11', 'orionsebastian', 'lizethj.perezr', 'eap.rodriguez', 'jhseto', 'joshemminger', 'kwisbroc', 'yaceved1', 'hkdavis3', 'edavilae', 'davidparra131', 'materiales', 'kiddevin', 'walke149', 'alborg93', 'jdmart22', 'tasmaniabull', 'adireddevil712', 'a.quinto10', 'd.suspes2053', 'simpkns2', 'la.avendano10', 'diego_romero_97', 'skykeeper0', 'ha.tapia10', 'dannycardenas48', 'arosner', 'joshpaige', 'sylee', 'zkiefer', 'swarnadipm', 'wbloebau', 'akramkarimi1036', 'alucas3', 'jzia1', 'gj.diaz10', 'holmano', 'sergiocamilo97', 'nbasnet', 'akr123', 'laura.arias', 'asad.6064', 'zhuber6', 'cody.campana', 'lbassett', 'tnagulu', 'tcollins2', 'timdonnelly92', 'pzinni', 'js.woodcock2202', 'xiangl19', 'zgossage88', 'msinani', 'johnr.duranr', 'nrodkey', 'shresthaanmol', 'js.rgalan', 'sdshiladitya', 'vcravens333', 'lufelaar', 'faisal4ff', 'nickzea', 'khalelop', 'aogentil10', 'hongbin.yu', 'jennypaolagalan', 'joefrag9', 'dapino06', 'sebastian0722', 'kharken1', 'jtherber', 'jonnya.gaitanb1', 'mvandeput', 'jgangeli', 'mtomas', 'mcshin', 'eapost', 'jcarriola0118', 'anthonyrb', 'afifeh91', 'eruzombe', 'julien419', 'loganr94', 'kanguye1', 'rlin11', 'elfenomeno', 'yingsu001', 'toamikel', 'jshwilams767', 'cheng159', 'jmhern16', 'bsankar2', 'pandapot', 'zhou502', None, 'bardella', 'zdrummon', 'mateocastaneda', 'eszelech', 'pkoswatt', 'kcrain', 'astridmejiat']"
4,73,129,8,6,"['kearrnz', 'edavilae', 'cheng159', 'ashapiee', 'swinart', 'zhou502']",122,"['tmccrack', 'black89', 'dillons', 'j.andregon15', 'nakhoa92', '2muchswag93', 'brockhaft1994', 'mariae.ballesterosg', 'klefevre20', 'taniacordoba1', 'rinoop6', 'ikukokitamura', 'csteeno15', 'briangoldn', 'camilaaa', 'samaher_salem', 'donjb2007', 'sourabh.mnit12', 'danielesparza', 'alshamrani', 'cpotdevin', 'swasti9', 'sergionemoga', 'sayedserhan', 'jayjay1122', 'mvcortez', 'drcornel', 'mtmunir', 'jwbrown1210', 'rdbaca', 'praterj', 'djorivco', 'jdull', 'cnietovesga9510', 'jf.guerrero10', 'xalmeida11', 'lizethj.perezr', 'eap.rodriguez', 'jhseto', 'joshemminger', 'kwisbroc', 'yaceved1', 'hkdavis3', 'materiales', 'kiddevin', 'walke149', 'alborg93', 'jdmart22', 'adireddevil712', 'simpkns2', 'skykeeper0', 'dannycardenas48', 'arosner', 'joshpaige', 'sylee', 'zkiefer', 'swarnadipm', 'wbloebau', 'akramkarimi1036', 'alucas3', 'jzia1', 'holmano', 'sergiocamilo97', 'nbasnet', 'akr123', 'laura.arias', 'asad.6064', 'zhuber6', 'cody.campana', 'lbassett', 'tnagulu', 'tcollins2', 'timdonnelly92', 'pzinni', 'js.woodcock2202', 'xiangl19', 'zgossage88', 'msinani', 'johnr.duranr', 'nrodkey', 'shresthaanmol', 'js.rgalan', 'sdshiladitya', 'vcravens333', 'lufelaar', 'faisal4ff', 'nickzea', 'khalelop', 'aogentil10', 'hongbin.yu', 'jennypaolagalan', 'joefrag9', 'dapino06', 'sebastian0722', 'kharken1', 'jtherber', 'jonnya.gaitanb1', 'mvandeput', 'mtomas', 'mcshin', 'eapost', 'jcarriola0118', 'anthonyrb', 'afifeh91', 'eruzombe', 'julien419', 'loganr94', 'kanguye1', 'rlin11', 'yingsu001', 'toamikel', 'jshwilams767', 'jmhern16', 'bsankar2', 'pandapot', 'bardella', 'zdrummon', 'mateocastaneda', 'eszelech', 'pkoswatt', 'kcrain', 'astridmejiat']",2,"[None, 'yanglingming']",130,"['tmccrack', 'black89', 'ashapiee', 'dillons', 'j.andregon15', 'nakhoa92', '2muchswag93', 'brockhaft1994', 'mariae.ballesterosg', 'klefevre20', 'taniacordoba1', 'rinoop6', 'ikukokitamura', 'csteeno15', 'briangoldn', 'camilaaa', 'samaher_salem', 'donjb2007', 'sourabh.mnit12', 'danielesparza', 'alshamrani', 'cpotdevin', 'swasti9', 'sergionemoga', 'sayedserhan', 'jayjay1122', 'mvcortez', 'drcornel', 'mtmunir', 'jwbrown1210', 'rdbaca', 'praterj', 'djorivco', 'jdull', 'swinart', 'cnietovesga9510', 'kearrnz', 'jf.guerrero10', 'xalmeida11', 'lizethj.perezr', 'eap.rodriguez', 'jhseto', 'joshemminger', 'kwisbroc', 'yaceved1', 'hkdavis3', 'edavilae', 'materiales', 'kiddevin', 'walke149', 'alborg93', 'jdmart22', 'adireddevil712', 'simpkns2', 'skykeeper0', 'dannycardenas48', 'arosner', 'joshpaige', 'sylee', 'zkiefer', 'swarnadipm', 'wbloebau', 'akramkarimi1036', 'alucas3', 'jzia1', 'holmano', 'sergiocamilo97', 'nbasnet', 'akr123', 'laura.arias', 'asad.6064', 'zhuber6', 'cody.campana', 'lbassett', 'tnagulu', 'tcollins2', 'timdonnelly92', 'pzinni', 'js.woodcock2202', 'xiangl19', 'zgossage88', 'msinani', 'johnr.duranr', 'nrodkey', 'shresthaanmol', 'js.rgalan', 'sdshiladitya', 'vcravens333', 'lufelaar', 'faisal4ff', 'nickzea', 'khalelop', 'aogentil10', 'hongbin.yu', 'jennypaolagalan', 'joefrag9', 'dapino06', 'sebastian0722', 'kharken1', 'jtherber', 'jonnya.gaitanb1', 'mvandeput', 'mtomas', 'mcshin', 'eapost', 'jcarriola0118', 'anthonyrb', 'afifeh91', 'eruzombe', 'julien419', 'loganr94', 'kanguye1', 'rlin11', 'yingsu001', 'toamikel', 'jshwilams767', 'cheng159', 'jmhern16', 'bsankar2', 'pandapot', 'zhou502', None, 'bardella', 'zdrummon', 'yanglingming', 'mateocastaneda', 'eszelech', 'pkoswatt', 'kcrain', 'astridmejiat']"
4,77,129,7,6,"['kwisbroc', 'kharken1', 'danielesparza', 'yaceved1', 'wbloebau', 'arosner']",122,"['tmccrack', 'black89', 'ashapiee', 'dillons', 'j.andregon15', 'nakhoa92', '2muchswag93', 'brockhaft1994', 'mariae.ballesterosg', 'klefevre20', 'taniacordoba1', 'rinoop6', 'ikukokitamura', 'csteeno15', 'briangoldn', 'camilaaa', 'samaher_salem', 'donjb2007', 'sourabh.mnit12', 'alshamrani', 'cpotdevin', 'swasti9', 'sergionemoga', 'sayedserhan', 'jayjay1122', 'mvcortez', 'drcornel', 'mtmunir', 'jwbrown1210', 'rdbaca', 'praterj', 'djorivco', 'jdull', 'swinart', 'cnietovesga9510', 'kearrnz', 'jf.guerrero10', 'xalmeida11', 'lizethj.perezr', 'eap.rodriguez', 'jhseto', 'joshemminger', 'hkdavis3', 'edavilae', 'materiales', 'kiddevin', 'walke149', 'alborg93', 'jdmart22', 'adireddevil712', 'simpkns2', 'skykeeper0', 'dannycardenas48', 'joshpaige', 'sylee', 'zkiefer', 'swarnadipm', 'akramkarimi1036', 'alucas3', 'jzia1', 'holmano', 'sergiocamilo97', 'nbasnet', 'akr123', 'laura.arias', 'asad.6064', 'zhuber6', 'cody.campana', 'lbassett', 'tnagulu', 'tcollins2', 'timdonnelly92', 'pzinni', 'js.woodcock2202', 'xiangl19', 'zgossage88', 'msinani', 'johnr.duranr', 'nrodkey', 'shresthaanmol', 'js.rgalan', 'sdshiladitya', 'vcravens333', 'lufelaar', 'faisal4ff', 'nickzea', 'khalelop', 'aogentil10', 'hongbin.yu', 'jennypaolagalan', 'joefrag9', 'dapino06', 'sebastian0722', 'jtherber', 'jonnya.gaitanb1', 'mvandeput', 'mtomas', 'mcshin', 'eapost', 'jcarriola0118', 'anthonyrb', 'afifeh91', 'eruzombe', 'julien419', 'loganr94', 'kanguye1', 'rlin11', 'yingsu001', 'toamikel', 'jshwilams767', 'cheng159', 'jmhern16', 'bsankar2', 'pandapot', 'zhou502', 'bardella', 'zdrummon', 'mateocastaneda', 'eszelech', 'pkoswatt', 'kcrain', 'astridmejiat']",1,[None],129,"['tmccrack', 'black89', 'ashapiee', 'dillons', 'j.andregon15', 'nakhoa92', '2muchswag93', 'brockhaft1994', 'mariae.ballesterosg', 'klefevre20', 'taniacordoba1', 'rinoop6', 'ikukokitamura', 'csteeno15', 'briangoldn', 'camilaaa', 'samaher_salem', 'donjb2007', 'sourabh.mnit12', 'danielesparza', 'alshamrani', 'cpotdevin', 'swasti9', 'sergionemoga', 'sayedserhan', 'jayjay1122', 'mvcortez', 'drcornel', 'mtmunir', 'jwbrown1210', 'rdbaca', 'praterj', 'djorivco', 'jdull', 'swinart', 'cnietovesga9510', 'kearrnz', 'jf.guerrero10', 'xalmeida11', 'lizethj.perezr', 'eap.rodriguez', 'jhseto', 'joshemminger', 'kwisbroc', 'yaceved1', 'hkdavis3', 'edavilae', 'materiales', 'kiddevin', 'walke149', 'alborg93', 'jdmart22', 'adireddevil712', 'simpkns2', 'skykeeper0', 'dannycardenas48', 'arosner', 'joshpaige', 'sylee', 'zkiefer', 'swarnadipm', 'wbloebau', 'akramkarimi1036', 'alucas3', 'jzia1', 'holmano', 'sergiocamilo97', 'nbasnet', 'akr123', 'laura.arias', 'asad.6064', 'zhuber6', 'cody.campana', 'lbassett', 'tnagulu', 'tcollins2', 'timdonnelly92', 'pzinni', 'js.woodcock2202', 'xiangl19', 'zgossage88', 'msinani', 'johnr.duranr', 'nrodkey', 'shresthaanmol', 'js.rgalan', 'sdshiladitya', 'vcravens333', 'lufelaar', 'faisal4ff', 'nickzea', 'khalelop', 'aogentil10', 'hongbin.yu', 'jennypaolagalan', 'joefrag9', 'dapino06', 'sebastian0722', 'kharken1', 'jtherber', 'jonnya.gaitanb1', 'mvandeput', 'mtomas', 'mcshin', 'eapost', 'jcarriola0118', 'anthonyrb', 'afifeh91', 'eruzombe', 'julien419', 'loganr94', 'kanguye1', 'rlin11', 'yingsu001', 'toamikel', 'jshwilams767', 'cheng159', 'jmhern16', 'bsankar2', 'pandapot', 'zhou502', None, 'bardella', 'zdrummon', 'mateocastaneda', 'eszelech', 'pkoswatt', 'kcrain', 'astridmejiat']"
5,91,111,38,36,"['echoma', 'hzhan126', 'sbumbles96', 'esapsford', 'jzhan142', 'rovegno2', 'trentcalderone', 'aoaoxiao', 'crickettay13', 'jacquelinethardin', 'thiruve2', 'caitlyndeegs', 'keaberglund', 'jackylu2', 'amogharavi1', 'bkwok2', 'nayung36', 'johnmead17', 'listeru2', 'zjz.jiklint', 'pfcookiemonster', 'wtroth2', 'pross4', 'alanaalfeche', 'balung2', 'bygland2', 'slee503', 'minnie725', 'zohair2', 'allenyao95', 'akim102', 'lizzie.jones13', 'hannahmeiselman', 'kjnnngs2', 'bernskwok', 'aravndr2']",74,"['zjbergstrom', 'chandraveer', 'tinal797', 'jmpolese', 'momo646', 'saseepan19', 'lromero', 'csluss', 'yuqiuwu2', 'lhhh8', 'acao5', 'carterb5', 'ddvalles', 'kothar.017', 'rhoalpha', 'teresab', 'yinghua', 'jskraska998182483', 'calvmoes', 'tbgarcia', 'dexterballou', 'rvchop', 'anvasiliev52', 'cfoste4', 'aokisang', 'camason', 'kkquan', 'lxu20', 'nknipfe2', 'dcschmi2', 'gurjotd', 'mscknvpavr', 'joel', 'mohitkumar', 'batemanj', 'shalloran0', 'pengxudong7', 'gserrano', 'mloyd1', 'ajdiebner', 'adancini', 'stmartin', 'cbrow144', 'ug415371', 'sg630', 'zhangmh', 'radhiali', 'kurtafus', 'jmock3', 'bojanmiljkovic', 'reningermatthew', 'melshazly', 'kaseman7', 'haoge.sun', 'cuiteng', 'dashbarr', 'shankar99', 'amulcahey', 'lsparker', 'jamesbateman17', 'ngcross', 'scapil3', 'petar.lachkov', 'zzhan134', 'jdcunha', 'c4stewart', 'bwolf2', 'vinson.truong', 'mehan', 'junnanshangguan', 'ericxxlin', 'gwalters', 'erickyu1', 'bermude8']",2,"['tmolley2', None]",112,"['tmolley2', 'hzhan126', 'momo646', 'esapsford', 'saseepan19', 'lromero', 'csluss', 'lhhh8', 'yuqiuwu2', 'acao5', 'jacquelinethardin', 'ddvalles', 'kothar.017', 'thiruve2', 'rhoalpha', 'bkwok2', 'tbgarcia', 'rvchop', 'kkquan', 'listeru2', 'lxu20', 'nknipfe2', 'dcschmi2', 'zjz.jiklint', 'gurjotd', 'pfcookiemonster', 'joel', 'mohitkumar', 'shalloran0', 'pross4', 'gserrano', 'bojanmiljkovic', 'radhiali', 'kurtafus', 'jmock3', 'slee503', 'minnie725', 'reningermatthew', 'bygland2', 'haoge.sun', 'dashbarr', 'shankar99', 'zohair2', 'akim102', 'ngcross', 'petar.lachkov', 'zzhan134', 'jdcunha', 'vinson.truong', 'bernskwok', 'gwalters', 'aoaoxiao', 'aravndr2', 'bermude8', 'zjbergstrom', 'chandraveer', 'jskraska998182483', 'echoma', 'tinal797', 'jmpolese', 'sbumbles96', 'jzhan142', 'rovegno2', 'trentcalderone', 'crickettay13', 'carterb5', 'caitlyndeegs', 'keaberglund', 'teresab', 'yinghua', 'jackylu2', 'amogharavi1', 'calvmoes', 'dexterballou', 'anvasiliev52', 'nayung36', 'cfoste4', 'aokisang', 'camason', 'johnmead17', 'mscknvpavr', 'wtroth2', 'batemanj', 'ajdiebner', 'pengxudong7', 'adancini', 'mloyd1', 'stmartin', 'alanaalfeche', 'balung2', 'cbrow144', 'ug415371', 'sg630', 'zhangmh', 'melshazly', 'kaseman7', None, 'cuiteng', 'amulcahey', 'allenyao95', 'lsparker', 'jamesbateman17', 'lizzie.jones13', 'hannahmeiselman', 'scapil3', 'c4stewart', 'bwolf2', 'kjnnngs2', 'mehan', 'junnanshangguan', 'ericxxlin', 'erickyu1']"
5,92,111,27,23,"['chandraveer', 'saseepan19', 'kothar.017', 'rhoalpha', 'teresab', 'calvmoes', 'gurjotd', 'batemanj', 'pengxudong7', 'melshazly', 'bojanmiljkovic', 'radhiali', 'haoge.sun', 'cuiteng', 'jamesbateman17', 'petar.lachkov', 'jdcunha', 'c4stewart', 'vinson.truong', 'junnanshangguan', 'gwalters', 'mohitkumar', 'bermude8']",87,"['momo646', 'esapsford', 'lhhh8', 'acao5', 'ddvalles', 'kkquan', 'listeru2', 'nknipfe2', 'dcschmi2', 'zjz.jiklint', 'pfcookiemonster', 'shalloran0', 'kurtafus', 'jmock3', 'dashbarr', 'shankar99', 'zohair2', 'bernskwok', 'aoaoxiao', 'zjbergstrom', 'echoma', 'trentcalderone', 'caitlyndeegs', 'yinghua', 'jackylu2', 'anvasiliev52', 'nayung36', 'camason', 'johnmead17', 'wtroth2', 'mloyd1', 'balung2', 'cbrow144', 'ug415371', 'zhangmh', 'amulcahey', 'lizzie.jones13', 'hannahmeiselman', 'ericxxlin', 'erickyu1', 'hzhan126', 'lromero', 'csluss', 'yuqiuwu2', 'jacquelinethardin', 'thiruve2', 'bkwok2', 'tbgarcia', 'rvchop', 'lxu20', 'joel', 'pross4', 'gserrano', 'bygland2', 'slee503', 'minnie725', 'reningermatthew', 'akim102', 'ngcross', 'zzhan134', 'aravndr2', 'jskraska998182483', 'tinal797', 'jmpolese', 'sbumbles96', 'jzhan142', 'rovegno2', 'crickettay13', 'carterb5', 'keaberglund', 'amogharavi1', 'dexterballou', 'cfoste4', 'aokisang', 'mscknvpavr', 'ajdiebner', 'adancini', 'stmartin', 'alanaalfeche', 'sg630', 'kaseman7', 'allenyao95', 'lsparker', 'scapil3', 'bwolf2', 'mehan', 'kjnnngs2']",4,"['fadzilsharol', None, 'rprinja', 'shizhe2']",114,"['hzhan126', 'momo646', 'esapsford', 'saseepan19', 'lromero', 'csluss', 'lhhh8', 'yuqiuwu2', 'rprinja', 'acao5', 'jacquelinethardin', 'ddvalles', 'kothar.017', 'thiruve2', 'rhoalpha', 'bkwok2', 'tbgarcia', 'rvchop', 'kkquan', 'listeru2', 'lxu20', 'nknipfe2', 'dcschmi2', 'zjz.jiklint', 'gurjotd', 'pfcookiemonster', 'joel', 'mohitkumar', 'shalloran0', 'pross4', 'gserrano', 'bojanmiljkovic', 'radhiali', 'kurtafus', 'jmock3', 'slee503', 'minnie725', 'reningermatthew', 'bygland2', 'haoge.sun', 'dashbarr', 'shankar99', 'zohair2', 'akim102', 'ngcross', 'petar.lachkov', 'zzhan134', 'jdcunha', 'vinson.truong', 'bernskwok', 'gwalters', 'aoaoxiao', 'aravndr2', 'bermude8', 'zjbergstrom', 'chandraveer', 'jskraska998182483', 'fadzilsharol', 'echoma', 'tinal797', 'jmpolese', 'sbumbles96', 'jzhan142', 'rovegno2', 'trentcalderone', 'crickettay13', 'carterb5', 'caitlyndeegs', 'keaberglund', 'teresab', 'yinghua', 'jackylu2', 'amogharavi1', 'calvmoes', 'dexterballou', 'anvasiliev52', 'nayung36', 'cfoste4', 'aokisang', 'camason', 'johnmead17', 'mscknvpavr', 'wtroth2', 'batemanj', 'ajdiebner', 'pengxudong7', 'adancini', 'mloyd1', 'stmartin', 'alanaalfeche', 'balung2', 'shizhe2', 'cbrow144', 'ug415371', 'sg630', 'zhangmh', 'melshazly', 'kaseman7', None, 'cuiteng', 'amulcahey', 'allenyao95', 'lsparker', 'jamesbateman17', 'lizzie.jones13', 'hannahmeiselman', 'scapil3', 'c4stewart', 'bwolf2', 'kjnnngs2', 'mehan', 'junnanshangguan', 'ericxxlin', 'erickyu1']"
5,93,111,23,22,"['tinal797', 'jmpolese', 'momo646', 'lromero', 'lhhh8', 'carterb5', 'ddvalles', 'yinghua', 'tbgarcia', 'camason', 'kkquan', 'joel', 'ajdiebner', 'adancini', 'gserrano', 'zhangmh', 'kaseman7', 'dashbarr', 'lsparker', 'mehan', 'erickyu1', 'jskraska998182483']",88,"['hzhan126', 'esapsford', 'saseepan19', 'csluss', 'yuqiuwu2', 'acao5', 'jacquelinethardin', 'kothar.017', 'thiruve2', 'rhoalpha', 'bkwok2', 'rvchop', 'listeru2', 'lxu20', 'nknipfe2', 'dcschmi2', 'zjz.jiklint', 'gurjotd', 'pfcookiemonster', 'mohitkumar', 'shalloran0', 'pross4', 'bojanmiljkovic', 'radhiali', 'kurtafus', 'jmock3', 'slee503', 'minnie725', 'reningermatthew', 'bygland2', 'haoge.sun', 'shankar99', 'zohair2', 'akim102', 'ngcross', 'petar.lachkov', 'zzhan134', 'jdcunha', 'vinson.truong', 'bernskwok', 'gwalters', 'aoaoxiao', 'aravndr2', 'bermude8', 'zjbergstrom', 'chandraveer', 'echoma', 'sbumbles96', 'jzhan142', 'rovegno2', 'trentcalderone', 'crickettay13', 'caitlyndeegs', 'keaberglund', 'teresab', 'jackylu2', 'amogharavi1', 'calvmoes', 'dexterballou', 'anvasiliev52', 'nayung36', 'cfoste4', 'aokisang', 'johnmead17', 'mscknvpavr', 'wtroth2', 'batemanj', 'pengxudong7', 'mloyd1', 'stmartin', 'alanaalfeche', 'balung2', 'cbrow144', 'ug415371', 'sg630', 'melshazly', 'cuiteng', 'amulcahey', 'allenyao95', 'jamesbateman17', 'lizzie.jones13', 'hannahmeiselman', 'scapil3', 'c4stewart', 'bwolf2', 'kjnnngs2', 'junnanshangguan', 'ericxxlin']",1,[None],111,"['hzhan126', 'momo646', 'esapsford', 'saseepan19', 'lromero', 'csluss', 'lhhh8', 'yuqiuwu2', 'acao5', 'jacquelinethardin', 'ddvalles', 'kothar.017', 'thiruve2', 'rhoalpha', 'bkwok2', 'tbgarcia', 'rvchop', 'kkquan', 'listeru2', 'lxu20', 'nknipfe2', 'dcschmi2', 'zjz.jiklint', 'gurjotd', 'pfcookiemonster', 'joel', 'mohitkumar', 'shalloran0', 'pross4', 'gserrano', 'bojanmiljkovic', 'radhiali', 'kurtafus', 'jmock3', 'slee503', 'minnie725', 'reningermatthew', 'bygland2', 'haoge.sun', 'dashbarr', 'shankar99', 'zohair2', 'akim102', 'ngcross', 'petar.lachkov', 'zzhan134', 'jdcunha', 'vinson.truong', 'bernskwok', 'gwalters', 'aoaoxiao', 'aravndr2', 'bermude8', 'zjbergstrom', 'chandraveer', 'jskraska998182483', 'echoma', 'tinal797', 'jmpolese', 'sbumbles96', 'jzhan142', 'rovegno2', 'trentcalderone', 'crickettay13', 'carterb5', 'caitlyndeegs', 'keaberglund', 'teresab', 'yinghua', 'jackylu2', 'amogharavi1', 'calvmoes', 'dexterballou', 'anvasiliev52', 'nayung36', 'cfoste4', 'aokisang', 'camason', 'johnmead17', 'mscknvpavr', 'wtroth2', 'batemanj', 'ajdiebner', 'pengxudong7', 'adancini', 'mloyd1', 'stmartin', 'alanaalfeche', 'balung2', 'cbrow144', 'ug415371', 'sg630', 'zhangmh', 'melshazly', 'kaseman7', None, 'cuiteng', 'amulcahey', 'allenyao95', 'lsparker', 'jamesbateman17', 'lizzie.jones13', 'hannahmeiselman', 'scapil3', 'c4stewart', 'bwolf2', 'kjnnngs2', 'mehan', 'junnanshangguan', 'ericxxlin', 'erickyu1']"
5,90,111,12,9,"['shalloran0', 'scapil3', 'balung2', 'dexterballou', 'acao5', 'bygland2', 'nayung36', 'aokisang', 'ericxxlin']",101,"['hzhan126', 'momo646', 'esapsford', 'saseepan19', 'lromero', 'csluss', 'lhhh8', 'yuqiuwu2', 'jacquelinethardin', 'ddvalles', 'kothar.017', 'thiruve2', 'rhoalpha', 'bkwok2', 'tbgarcia', 'rvchop', 'kkquan', 'listeru2', 'lxu20', 'nknipfe2', 'dcschmi2', 'zjz.jiklint', 'gurjotd', 'pfcookiemonster', 'joel', 'mohitkumar', 'pross4', 'gserrano', 'bojanmiljkovic', 'radhiali', 'kurtafus', 'jmock3', 'slee503', 'minnie725', 'reningermatthew', 'haoge.sun', 'dashbarr', 'shankar99', 'zohair2', 'akim102', 'ngcross', 'petar.lachkov', 'zzhan134', 'jdcunha', 'vinson.truong', 'bernskwok', 'gwalters', 'aoaoxiao', 'aravndr2', 'bermude8', 'zjbergstrom', 'chandraveer', 'jskraska998182483', 'echoma', 'tinal797', 'jmpolese', 'sbumbles96', 'jzhan142', 'rovegno2', 'trentcalderone', 'crickettay13', 'carterb5', 'caitlyndeegs', 'keaberglund', 'teresab', 'yinghua', 'jackylu2', 'amogharavi1', 'calvmoes', 'anvasiliev52', 'cfoste4', 'camason', 'johnmead17', 'mscknvpavr', 'wtroth2', 'batemanj', 'ajdiebner', 'pengxudong7', 'adancini', 'mloyd1', 'stmartin', 'alanaalfeche', 'cbrow144', 'ug415371', 'sg630', 'zhangmh', 'melshazly', 'kaseman7', 'cuiteng', 'amulcahey', 'allenyao95', 'lsparker', 'jamesbateman17', 'lizzie.jones13', 'hannahmeiselman', 'c4stewart', 'bwolf2', 'kjnnngs2', 'mehan', 'junnanshangguan', 'erickyu1']",3,"['ramansbach', 'tmolley2', None]",113,"['tmolley2', 'hzhan126', 'momo646', 'esapsford', 'saseepan19', 'lromero', 'csluss', 'lhhh8', 'yuqiuwu2', 'acao5', 'jacquelinethardin', 'ddvalles', 'kothar.017', 'thiruve2', 'rhoalpha', 'bkwok2', 'tbgarcia', 'rvchop', 'kkquan', 'listeru2', 'lxu20', 'nknipfe2', 'dcschmi2', 'zjz.jiklint', 'gurjotd', 'pfcookiemonster', 'joel', 'mohitkumar', 'shalloran0', 'pross4', 'gserrano', 'bojanmiljkovic', 'radhiali', 'kurtafus', 'jmock3', 'slee503', 'minnie725', 'reningermatthew', 'bygland2', 'haoge.sun', 'dashbarr', 'shankar99', 'zohair2', 'akim102', 'ngcross', 'petar.lachkov', 'zzhan134', 'jdcunha', 'vinson.truong', 'bernskwok', 'gwalters', 'aoaoxiao', 'aravndr2', 'bermude8', 'zjbergstrom', 'chandraveer', 'jskraska998182483', 'echoma', 'tinal797', 'jmpolese', 'sbumbles96', 'jzhan142', 'rovegno2', 'trentcalderone', 'crickettay13', 'carterb5', 'caitlyndeegs', 'keaberglund', 'teresab', 'yinghua', 'jackylu2', 'amogharavi1', 'calvmoes', 'ramansbach', 'dexterballou', 'anvasiliev52', 'nayung36', 'cfoste4', 'aokisang', 'camason', 'johnmead17', 'mscknvpavr', 'wtroth2', 'batemanj', 'ajdiebner', 'pengxudong7', 'adancini', 'mloyd1', 'stmartin', 'alanaalfeche', 'balung2', 'cbrow144', 'ug415371', 'sg630', 'zhangmh', 'melshazly', 'kaseman7', None, 'cuiteng', 'amulcahey', 'allenyao95', 'lsparker', 'jamesbateman17', 'lizzie.jones13', 'hannahmeiselman', 'scapil3', 'c4stewart', 'bwolf2', 'kjnnngs2', 'mehan', 'junnanshangguan', 'ericxxlin', 'erickyu1']"
5,94,111,9,8,"['csluss', 'ngcross', 'mloyd1', 'bwolf2', 'cbrow144', 'kurtafus', 'cfoste4', 'lxu20']",102,"['hzhan126', 'momo646', 'esapsford', 'saseepan19', 'lromero', 'lhhh8', 'yuqiuwu2', 'acao5', 'jacquelinethardin', 'ddvalles', 'kothar.017', 'thiruve2', 'rhoalpha', 'bkwok2', 'tbgarcia', 'rvchop', 'kkquan', 'listeru2', 'nknipfe2', 'dcschmi2', 'zjz.jiklint', 'gurjotd', 'pfcookiemonster', 'joel', 'mohitkumar', 'shalloran0', 'pross4', 'gserrano', 'bojanmiljkovic', 'radhiali', 'jmock3', 'slee503', 'minnie725', 'reningermatthew', 'bygland2', 'haoge.sun', 'dashbarr', 'shankar99', 'zohair2', 'akim102', 'petar.lachkov', 'zzhan134', 'jdcunha', 'vinson.truong', 'bernskwok', 'gwalters', 'aoaoxiao', 'aravndr2', 'bermude8', 'zjbergstrom', 'chandraveer', 'jskraska998182483', 'echoma', 'tinal797', 'jmpolese', 'sbumbles96', 'jzhan142', 'rovegno2', 'trentcalderone', 'crickettay13', 'carterb5', 'caitlyndeegs', 'keaberglund', 'teresab', 'yinghua', 'jackylu2', 'amogharavi1', 'calvmoes', 'dexterballou', 'anvasiliev52', 'nayung36', 'aokisang', 'camason', 'johnmead17', 'mscknvpavr', 'wtroth2', 'batemanj', 'ajdiebner', 'pengxudong7', 'adancini', 'stmartin', 'alanaalfeche', 'balung2', 'ug415371', 'sg630', 'zhangmh', 'melshazly', 'kaseman7', 'cuiteng', 'amulcahey', 'allenyao95', 'lsparker', 'jamesbateman17', 'lizzie.jones13', 'hannahmeiselman', 'scapil3', 'c4stewart', 'kjnnngs2', 'mehan', 'junnanshangguan', 'ericxxlin', 'erickyu1']",1,[None],111,"['hzhan126', 'momo646', 'esapsford', 'saseepan19', 'lromero', 'csluss', 'lhhh8', 'yuqiuwu2', 'acao5', 'jacquelinethardin', 'ddvalles', 'kothar.017', 'thiruve2', 'rhoalpha', 'bkwok2', 'tbgarcia', 'rvchop', 'kkquan', 'listeru2', 'lxu20', 'nknipfe2', 'dcschmi2', 'zjz.jiklint', 'gurjotd', 'pfcookiemonster', 'joel', 'mohitkumar', 'shalloran0', 'pross4', 'gserrano', 'bojanmiljkovic', 'radhiali', 'kurtafus', 'jmock3', 'slee503', 'minnie725', 'reningermatthew', 'bygland2', 'haoge.sun', 'dashbarr', 'shankar99', 'zohair2', 'akim102', 'ngcross', 'petar.lachkov', 'zzhan134', 'jdcunha', 'vinson.truong', 'bernskwok', 'gwalters', 'aoaoxiao', 'aravndr2', 'bermude8', 'zjbergstrom', 'chandraveer', 'jskraska998182483', 'echoma', 'tinal797', 'jmpolese', 'sbumbles96', 'jzhan142', 'rovegno2', 'trentcalderone', 'crickettay13', 'carterb5', 'caitlyndeegs', 'keaberglund', 'teresab', 'yinghua', 'jackylu2', 'amogharavi1', 'calvmoes', 'dexterballou', 'anvasiliev52', 'nayung36', 'cfoste4', 'aokisang', 'camason', 'johnmead17', 'mscknvpavr', 'wtroth2', 'batemanj', 'ajdiebner', 'pengxudong7', 'adancini', 'mloyd1', 'stmartin', 'alanaalfeche', 'balung2', 'cbrow144', 'ug415371', 'sg630', 'zhangmh', 'melshazly', 'kaseman7', None, 'cuiteng', 'amulcahey', 'allenyao95', 'lsparker', 'jamesbateman17', 'lizzie.jones13', 'hannahmeiselman', 'scapil3', 'c4stewart', 'bwolf2', 'kjnnngs2', 'mehan', 'junnanshangguan', 'ericxxlin', 'erickyu1']"
5,95,111,8,7,"['nknipfe2', 'amulcahey', 'zjbergstrom', 'tinal797', 'yuqiuwu2', 'zzhan134', 'jmock3']",103,"['hzhan126', 'momo646', 'esapsford', 'saseepan19', 'lromero', 'csluss', 'lhhh8', 'acao5', 'jacquelinethardin', 'ddvalles', 'kothar.017', 'thiruve2', 'rhoalpha', 'bkwok2', 'tbgarcia', 'rvchop', 'kkquan', 'listeru2', 'lxu20', 'dcschmi2', 'zjz.jiklint', 'gurjotd', 'pfcookiemonster', 'joel', 'mohitkumar', 'shalloran0', 'pross4', 'gserrano', 'bojanmiljkovic', 'radhiali', 'kurtafus', 'slee503', 'minnie725', 'reningermatthew', 'bygland2', 'haoge.sun', 'dashbarr', 'shankar99', 'zohair2', 'akim102', 'ngcross', 'petar.lachkov', 'jdcunha', 'vinson.truong', 'bernskwok', 'gwalters', 'aoaoxiao', 'aravndr2', 'bermude8', 'chandraveer', 'jskraska998182483', 'echoma', 'jmpolese', 'sbumbles96', 'jzhan142', 'rovegno2', 'trentcalderone', 'crickettay13', 'carterb5', 'caitlyndeegs', 'keaberglund', 'teresab', 'yinghua', 'jackylu2', 'amogharavi1', 'calvmoes', 'dexterballou', 'anvasiliev52', 'nayung36', 'cfoste4', 'aokisang', 'camason', 'johnmead17', 'mscknvpavr', 'wtroth2', 'batemanj', 'ajdiebner', 'pengxudong7', 'adancini', 'mloyd1', 'stmartin', 'alanaalfeche', 'balung2', 'cbrow144', 'ug415371', 'sg630', 'zhangmh', 'melshazly', 'kaseman7', 'cuiteng', 'allenyao95', 'lsparker', 'jamesbateman17', 'lizzie.jones13', 'hannahmeiselman', 'scapil3', 'c4stewart', 'bwolf2', 'kjnnngs2', 'mehan', 'junnanshangguan', 'ericxxlin', 'erickyu1']",1,[None],111,"['hzhan126', 'momo646', 'esapsford', 'saseepan19', 'lromero', 'csluss', 'lhhh8', 'yuqiuwu2', 'acao5', 'jacquelinethardin', 'ddvalles', 'kothar.017', 'thiruve2', 'rhoalpha', 'bkwok2', 'tbgarcia', 'rvchop', 'kkquan', 'listeru2', 'lxu20', 'nknipfe2', 'dcschmi2', 'zjz.jiklint', 'gurjotd', 'pfcookiemonster', 'joel', 'mohitkumar', 'shalloran0', 'pross4', 'gserrano', 'bojanmiljkovic', 'radhiali', 'kurtafus', 'jmock3', 'slee503', 'minnie725', 'reningermatthew', 'bygland2', 'haoge.sun', 'dashbarr', 'shankar99', 'zohair2', 'akim102', 'ngcross', 'petar.lachkov', 'zzhan134', 'jdcunha', 'vinson.truong', 'bernskwok', 'gwalters', 'aoaoxiao', 'aravndr2', 'bermude8', 'zjbergstrom', 'chandraveer', 'jskraska998182483', 'echoma', 'tinal797', 'jmpolese', 'sbumbles96', 'jzhan142', 'rovegno2', 'trentcalderone', 'crickettay13', 'carterb5', 'caitlyndeegs', 'keaberglund', 'teresab', 'yinghua', 'jackylu2', 'amogharavi1', 'calvmoes', 'dexterballou', 'anvasiliev52', 'nayung36', 'cfoste4', 'aokisang', 'camason', 'johnmead17', 'mscknvpavr', 'wtroth2', 'batemanj', 'ajdiebner', 'pengxudong7', 'adancini', 'mloyd1', 'stmartin', 'alanaalfeche', 'balung2', 'cbrow144', 'ug415371', 'sg630', 'zhangmh', 'melshazly', 'kaseman7', None, 'cuiteng', 'amulcahey', 'allenyao95', 'lsparker', 'jamesbateman17', 'lizzie.jones13', 'hannahmeiselman', 'scapil3', 'c4stewart', 'bwolf2', 'kjnnngs2', 'mehan', 'junnanshangguan', 'ericxxlin', 'erickyu1']"
6,259,96,156,59,"['clarksnano', 'kennedym', 'chang305', 'nczapla', 'ajebakum', 'murtuza.shergadwala', 'emorin', 'dstechma', 'simon38', 'boron1618', 'gdesam', 'aanghelus', 'allredt', 'lou23', 'gwilfong', 'utsavac', 'ashishmc', 'felbr', 'jbeale', 'tongyangshi', 'btanasoi', 'jseaton', 'nljacobs5', 'odary', 'jmcgough', 'nmenglin', 'xiaoshenwang', 'akshaydeshpande', 'jmethel', 'jhollkam', 'kcidkcid1992', 'yang912', 'bartos', 'choi350', 'kumar167', 'mbedard', 'robisonj', 'zhou523', 'djcarr', 'tseng1', 'woods41', 'zyf', 'richa203', 'claytok', 'baker251', 'zhuangxinghao', 'shruti1205', 'nin', 'jung164', 'hranjan', 'ma319', 'agarw103', 'vos', 'chen1720', 'xliu123', 'giggerota', 'liu1512', 'pyles', 'thelmus']",36,"['robya', 'wallacjn', 'chuiespe', 'turnqjm', 'rgeorge', 'rvanden', 'kamaram_munira', 'jiaweiiii', 'ward99', 'ymeibb00', 'buckr', 'shawnwhitman', 'erciyuanwd', 'saranokiseki', 'xie215', 'asherr', 'awillenb1', 'tsambor', 'meyers18', 'xinweiguo', 'lee1022', 'nmdenison', 'mnissim', 'jakeeppehimer', 'txvwxyz', 'leslie4', 'graber0', 'chaolei', 'tthomasg', 'kingston', 'zhang824', 'xiaoyifu', 'cai157', 'glover19', 'wu937', 'liu915']",97,"['sharma55', 'ben.helfrecht', 'gah', 'pmeunier', 'dienstfrey', 'valencid', 'mcclurr', 'ewilson000', 'cao42', 'jy009', 'scaskey', 'adithyabhattachar', 'kwojo314', 'clarksm', 'mike409', 'ckatinas', 'kevin60105', 'kluitjoh', 'anepak123', 'wang159', 'prasadsarang', 'jgeng', 'ssjadeguardian', 'li1114', 'marisol', 'pikus', 'kmao', 'hu341', 'puttha.math', 'chuyuanchen', 'cempekardan', 'borgesebastiao', 'hctest4', 'pastabasta8', 'song405', 'gramchan123', 'swoop', 'kaiser1711', 'pseiler', 'turkstra', 'colley', 'jmynhier', 'ebilionis', 'davgumo', 'jduritsc95', 'tarekameen', 'bhaley', 'liang.dai', 'hctest3', 'polina.aleks', 'nanohueb', 'mmh', 'mpelleg', 'wayneisaacuy', 'light2', 'ldelgass', 'chen1164', 'dkearney', 'kaimiao', 'atankas', 'mischke', 'glassd', 'woodswims', 'edantillon', 'kennell', 'fpena', 'bmsutton', 'araz.hashemi', 'bermel', 'denphi', 'ahinkle5', 'wood67', 'samikm', 'apps', 'trungnguyen', 'piyush100078', 'ekayser', 'schcats', 'porter28', 'kuehnel', 'fang85', 'jiruotong', 'wsanche2', 'enassakr', 'robin198', 'mbeason', 'luizescalco', 'kmargata', 'markarios345', 'njtsh', None, 'dnaragan', 'chinyi', '10gauravpatankar', 'mullen6', 'strachan', 'glin75']",192,"['nczapla', 'murtuza.shergadwala', 'sharma55', 'dstechma', 'gdesam', 'ben.helfrecht', 'chuiespe', 'gwilfong', 'utsavac', 'gah', 'turnqjm', 'btanasoi', 'pmeunier', 'nljacobs5', 'rgeorge', 'rvanden', 'dienstfrey', 'valencid', 'kcidkcid1992', 'ymeibb00', 'yang912', 'mcclurr', 'ewilson000', 'awillenb1', 'cao42', 'tsambor', 'jy009', 'tseng1', 'woods41', 'scaskey', 'adithyabhattachar', 'kwojo314', 'baker251', 'clarksm', 'ckatinas', 'kevin60105', 'shruti1205', 'kluitjoh', 'mike409', 'anepak123', 'wang159', 'prasadsarang', 'jgeng', 'leslie4', 'ssjadeguardian', 'li1114', 'marisol', 'pikus', 'hu341', 'kmao', 'kennedym', 'puttha.math', 'wallacjn', 'chuyuanchen', 'cempekardan', 'simon38', 'aanghelus', 'borgesebastiao', 'jbeale', 'jseaton', 'hctest4', 'nmenglin', 'jiaweiiii', 'xiaoshenwang', 'akshaydeshpande', 'pastabasta8', 'song405', 'gramchan123', 'swoop', 'kaiser1711', 'choi350', 'asherr', 'pseiler', 'turkstra', 'colley', 'jmynhier', 'ebilionis', 'jakeeppehimer', 'richa203', 'davgumo', 'jduritsc95', 'nin', 'jung164', 'hranjan', 'tarekameen', 'bhaley', 'liang.dai', 'hctest3', 'polina.aleks', 'agarw103', 'nanohueb', 'xliu123', 'mmh', 'mpelleg', 'wayneisaacuy', 'wu937', 'light2', 'ldelgass', 'thelmus', 'robya', 'chen1164', 'emorin', 'dkearney', 'kaimiao', 'boron1618', 'atankas', 'ashishmc', 'mischke', 'glassd', 'odary', 'jmcgough', 'kamaram_munira', 'woodswims', 'edantillon', 'ward99', 'kennell', 'fpena', 'bmsutton', 'araz.hashemi', 'xinweiguo', 'nmdenison', 'zyf', 'bermel', 'claytok', 'denphi', 'txvwxyz', 'graber0', 'chen1720', 'ahinkle5', 'giggerota', 'liu1512', 'pyles', 'wood67', 'samikm', 'clarksnano', 'chang305', 'ajebakum', 'apps', 'allredt', 'lou23', 'trungnguyen', 'felbr', 'tongyangshi', 'ekayser', 'piyush100078', 'schcats', 'porter28', 'kuehnel', 'fang85', 'jmethel', 'jiruotong', 'jhollkam', 'buckr', 'shawnwhitman', 'bartos', 'saranokiseki', 'xie215', 'kumar167', 'erciyuanwd', 'mbedard', 'wsanche2', 'robisonj', 'liu915', 'zhou523', 'djcarr', 'enassakr', 'meyers18', 'lee1022', 'mnissim', 'robin198', 'mbeason', 'zhuangxinghao', 'luizescalco', 'kmargata', 'markarios345', 'njtsh', None, 'ma319', 'dnaragan', 'chaolei', 'chinyi', '10gauravpatankar', 'tthomasg', 'vos', 'kingston', 'mullen6', 'xiaoyifu', 'cai157', 'glover19', 'strachan', 'zhang824', 'glin75']"
6,265,96,21,8,"['kennedym', 'jmcgough', 'claytok', 'xliu123', 'giggerota', 'nin', 'pyles', 'hranjan']",87,"['robya', 'nczapla', 'murtuza.shergadwala', 'emorin', 'dstechma', 'boron1618', 'gdesam', 'chuiespe', 'gwilfong', 'utsavac', 'ashishmc', 'turnqjm', 'btanasoi', 'odary', 'nljacobs5', 'rgeorge', 'rvanden', 'kamaram_munira', 'ward99', 'kcidkcid1992', 'ymeibb00', 'yang912', 'awillenb1', 'tsambor', 'xinweiguo', 'nmdenison', 'tseng1', 'woods41', 'zyf', 'baker251', 'shruti1205', 'txvwxyz', 'leslie4', 'graber0', 'chen1720', 'zhang824', 'liu1512', 'clarksnano', 'chang305', 'wallacjn', 'ajebakum', 'simon38', 'allredt', 'aanghelus', 'lou23', 'felbr', 'jbeale', 'tongyangshi', 'jseaton', 'nmenglin', 'jiaweiiii', 'xiaoshenwang', 'akshaydeshpande', 'jmethel', 'jhollkam', 'buckr', 'choi350', 'shawnwhitman', 'bartos', 'saranokiseki', 'xie215', 'kumar167', 'asherr', 'erciyuanwd', 'mbedard', 'robisonj', 'zhou523', 'djcarr', 'meyers18', 'lee1022', 'mnissim', 'jakeeppehimer', 'richa203', 'zhuangxinghao', 'jung164', 'ma319', 'chaolei', 'agarw103', 'tthomasg', 'vos', 'kingston', 'xiaoyifu', 'cai157', 'glover19', 'wu937', 'liu915', 'thelmus']",13,"['hopkin12', 'russo6', 'jrosa', 'chinyi', 'bkusler', 'cvaughn0121', None, 'jpalsdot', 'joydeep.loveuall', 'atankas', 'cao42', 'quintero', 'fukuda555']",108,"['robya', 'nczapla', 'murtuza.shergadwala', 'emorin', 'dstechma', 'jpalsdot', 'boron1618', 'gdesam', 'chuiespe', 'gwilfong', 'utsavac', 'ashishmc', 'atankas', 'turnqjm', 'btanasoi', 'odary', 'nljacobs5', 'rgeorge', 'rvanden', 'jmcgough', 'quintero', 'kamaram_munira', 'cvaughn0121', 'ward99', 'kcidkcid1992', 'ymeibb00', 'yang912', 'awillenb1', 'cao42', 'tsambor', 'xinweiguo', 'bkusler', 'nmdenison', 'tseng1', 'woods41', 'zyf', 'claytok', 'joydeep.loveuall', 'baker251', 'shruti1205', 'txvwxyz', 'leslie4', 'graber0', 'chen1720', 'zhang824', 'giggerota', 'liu1512', 'pyles', 'clarksnano', 'kennedym', 'chang305', 'hopkin12', 'wallacjn', 'ajebakum', 'simon38', 'allredt', 'aanghelus', 'lou23', 'felbr', 'jbeale', 'tongyangshi', 'jseaton', 'nmenglin', 'jiaweiiii', 'xiaoshenwang', 'akshaydeshpande', 'jmethel', 'jhollkam', 'buckr', 'choi350', 'shawnwhitman', 'bartos', 'saranokiseki', 'xie215', 'kumar167', 'asherr', 'erciyuanwd', 'mbedard', 'robisonj', 'zhou523', 'djcarr', 'meyers18', 'lee1022', 'mnissim', 'jakeeppehimer', 'richa203', 'zhuangxinghao', 'nin', 'jung164', 'hranjan', None, 'ma319', 'fukuda555', 'russo6', 'jrosa', 'chaolei', 'chinyi', 'agarw103', 'tthomasg', 'vos', 'kingston', 'xliu123', 'xiaoyifu', 'cai157', 'glover19', 'wu937', 'liu915', 'thelmus']"
6,268,96,20,14,"['rgeorge', 'wallacjn', 'agarw103', 'vos', 'zhuangxinghao', 'kingston', 'gdesam', 'cai157', 'shruti1205', 'erciyuanwd', 'xie215', 'wu937', 'txvwxyz', 'btanasoi']",81,"['robya', 'nczapla', 'murtuza.shergadwala', 'emorin', 'dstechma', 'boron1618', 'chuiespe', 'gwilfong', 'utsavac', 'ashishmc', 'turnqjm', 'odary', 'nljacobs5', 'rvanden', 'jmcgough', 'kamaram_munira', 'ward99', 'kcidkcid1992', 'ymeibb00', 'yang912', 'awillenb1', 'tsambor', 'xinweiguo', 'nmdenison', 'tseng1', 'woods41', 'zyf', 'claytok', 'baker251', 'leslie4', 'graber0', 'chen1720', 'zhang824', 'giggerota', 'liu1512', 'pyles', 'clarksnano', 'kennedym', 'chang305', 'ajebakum', 'simon38', 'allredt', 'aanghelus', 'lou23', 'felbr', 'jbeale', 'tongyangshi', 'jseaton', 'nmenglin', 'jiaweiiii', 'xiaoshenwang', 'akshaydeshpande', 'jmethel', 'jhollkam', 'buckr', 'choi350', 'shawnwhitman', 'bartos', 'saranokiseki', 'kumar167', 'asherr', 'mbedard', 'robisonj', 'zhou523', 'djcarr', 'meyers18', 'lee1022', 'mnissim', 'jakeeppehimer', 'richa203', 'nin', 'jung164', 'hranjan', 'ma319', 'chaolei', 'tthomasg', 'xliu123', 'xiaoyifu', 'glover19', 'liu915', 'thelmus']",6,"['blackfire962', 'mbeason', 'jduritsc95', 'yilunyang', None, 'jnarkar']",101,"['robya', 'nczapla', 'murtuza.shergadwala', 'emorin', 'dstechma', 'boron1618', 'gdesam', 'chuiespe', 'gwilfong', 'utsavac', 'ashishmc', 'turnqjm', 'btanasoi', 'odary', 'nljacobs5', 'rgeorge', 'rvanden', 'jmcgough', 'blackfire962', 'kamaram_munira', 'ward99', 'kcidkcid1992', 'ymeibb00', 'yang912', 'awillenb1', 'jnarkar', 'tsambor', 'xinweiguo', 'nmdenison', 'tseng1', 'woods41', 'zyf', 'claytok', 'baker251', 'shruti1205', 'txvwxyz', 'leslie4', 'graber0', 'chen1720', 'zhang824', 'giggerota', 'liu1512', 'pyles', 'clarksnano', 'kennedym', 'chang305', 'wallacjn', 'ajebakum', 'simon38', 'allredt', 'aanghelus', 'lou23', 'felbr', 'jbeale', 'tongyangshi', 'jseaton', 'nmenglin', 'jiaweiiii', 'xiaoshenwang', 'akshaydeshpande', 'jmethel', 'jhollkam', 'buckr', 'choi350', 'shawnwhitman', 'bartos', 'saranokiseki', 'xie215', 'kumar167', 'asherr', 'erciyuanwd', 'mbedard', 'robisonj', 'zhou523', 'djcarr', 'meyers18', 'lee1022', 'mnissim', 'mbeason', 'jakeeppehimer', 'richa203', 'zhuangxinghao', 'jduritsc95', 'nin', 'jung164', 'yilunyang', 'hranjan', None, 'ma319', 'chaolei', 'agarw103', 'tthomasg', 'vos', 'kingston', 'xliu123', 'xiaoyifu', 'cai157', 'glover19', 'wu937', 'liu915', 'thelmus']"
6,270,96,19,15,"['rgeorge', 'meyers18', 'wallacjn', 'agarw103', 'vos', 'zhuangxinghao', 'kingston', 'gdesam', 'cai157', 'shruti1205', 'erciyuanwd', 'wu937', 'zhang824', 'txvwxyz', 'btanasoi']",80,"['robya', 'nczapla', 'murtuza.shergadwala', 'emorin', 'dstechma', 'boron1618', 'chuiespe', 'gwilfong', 'utsavac', 'ashishmc', 'turnqjm', 'odary', 'nljacobs5', 'rvanden', 'jmcgough', 'kamaram_munira', 'ward99', 'kcidkcid1992', 'ymeibb00', 'yang912', 'awillenb1', 'tsambor', 'xinweiguo', 'nmdenison', 'tseng1', 'woods41', 'zyf', 'claytok', 'baker251', 'leslie4', 'graber0', 'chen1720', 'giggerota', 'liu1512', 'pyles', 'clarksnano', 'kennedym', 'chang305', 'ajebakum', 'simon38', 'allredt', 'aanghelus', 'lou23', 'felbr', 'jbeale', 'tongyangshi', 'jseaton', 'nmenglin', 'jiaweiiii', 'xiaoshenwang', 'akshaydeshpande', 'jmethel', 'jhollkam', 'buckr', 'choi350', 'shawnwhitman', 'bartos', 'saranokiseki', 'xie215', 'kumar167', 'asherr', 'mbedard', 'robisonj', 'zhou523', 'djcarr', 'lee1022', 'mnissim', 'jakeeppehimer', 'richa203', 'nin', 'jung164', 'hranjan', 'ma319', 'chaolei', 'tthomasg', 'xliu123', 'xiaoyifu', 'glover19', 'liu915', 'thelmus']",4,"['yilunyang', 'ldelgass', None, 'jnarkar']",99,"['robya', 'nczapla', 'murtuza.shergadwala', 'emorin', 'dstechma', 'boron1618', 'gdesam', 'chuiespe', 'gwilfong', 'utsavac', 'ashishmc', 'turnqjm', 'btanasoi', 'odary', 'nljacobs5', 'rgeorge', 'rvanden', 'jmcgough', 'kamaram_munira', 'ward99', 'kcidkcid1992', 'ymeibb00', 'yang912', 'awillenb1', 'jnarkar', 'tsambor', 'xinweiguo', 'nmdenison', 'tseng1', 'woods41', 'zyf', 'claytok', 'baker251', 'shruti1205', 'txvwxyz', 'leslie4', 'graber0', 'chen1720', 'zhang824', 'giggerota', 'liu1512', 'pyles', 'clarksnano', 'kennedym', 'chang305', 'wallacjn', 'ajebakum', 'simon38', 'allredt', 'aanghelus', 'lou23', 'felbr', 'jbeale', 'tongyangshi', 'jseaton', 'nmenglin', 'jiaweiiii', 'xiaoshenwang', 'akshaydeshpande', 'jmethel', 'jhollkam', 'buckr', 'choi350', 'shawnwhitman', 'bartos', 'saranokiseki', 'xie215', 'kumar167', 'asherr', 'erciyuanwd', 'mbedard', 'robisonj', 'zhou523', 'djcarr', 'meyers18', 'lee1022', 'mnissim', 'jakeeppehimer', 'richa203', 'zhuangxinghao', 'nin', 'jung164', 'yilunyang', 'hranjan', None, 'ma319', 'chaolei', 'agarw103', 'tthomasg', 'vos', 'kingston', 'xliu123', 'xiaoyifu', 'cai157', 'glover19', 'wu937', 'liu915', 'ldelgass', 'thelmus']"
6,267,96,18,11,"['tsambor', 'kennedym', 'xinweiguo', 'tthomasg', 'claytok', 'baker251', 'giggerota', 'kcidkcid1992', 'utsavac', 'xie215', 'hranjan']",84,"['robya', 'nczapla', 'murtuza.shergadwala', 'emorin', 'dstechma', 'boron1618', 'gdesam', 'chuiespe', 'gwilfong', 'ashishmc', 'turnqjm', 'btanasoi', 'odary', 'nljacobs5', 'rgeorge', 'rvanden', 'jmcgough', 'kamaram_munira', 'ward99', 'ymeibb00', 'yang912', 'awillenb1', 'nmdenison', 'tseng1', 'woods41', 'zyf', 'shruti1205', 'txvwxyz', 'leslie4', 'graber0', 'chen1720', 'zhang824', 'liu1512', 'pyles', 'clarksnano', 'chang305', 'wallacjn', 'ajebakum', 'simon38', 'allredt', 'aanghelus', 'lou23', 'felbr', 'jbeale', 'tongyangshi', 'jseaton', 'nmenglin', 'jiaweiiii', 'xiaoshenwang', 'akshaydeshpande', 'jmethel', 'jhollkam', 'buckr', 'choi350', 'shawnwhitman', 'bartos', 'saranokiseki', 'kumar167', 'asherr', 'erciyuanwd', 'mbedard', 'robisonj', 'zhou523', 'djcarr', 'meyers18', 'lee1022', 'mnissim', 'jakeeppehimer', 'richa203', 'zhuangxinghao', 'nin', 'jung164', 'ma319', 'chaolei', 'agarw103', 'vos', 'kingston', 'xliu123', 'xiaoyifu', 'cai157', 'glover19', 'wu937', 'liu915', 'thelmus']",7,"['hopkin12', 'carbaker', 'atankas', 'piyush100078', None, 'tiom99', 'cao42']",102,"['robya', 'nczapla', 'murtuza.shergadwala', 'emorin', 'carbaker', 'dstechma', 'boron1618', 'gdesam', 'chuiespe', 'gwilfong', 'utsavac', 'ashishmc', 'atankas', 'turnqjm', 'tiom99', 'btanasoi', 'odary', 'nljacobs5', 'rgeorge', 'rvanden', 'jmcgough', 'kamaram_munira', 'ward99', 'kcidkcid1992', 'ymeibb00', 'yang912', 'awillenb1', 'cao42', 'tsambor', 'xinweiguo', 'nmdenison', 'tseng1', 'woods41', 'zyf', 'claytok', 'baker251', 'shruti1205', 'txvwxyz', 'leslie4', 'graber0', 'chen1720', 'zhang824', 'giggerota', 'liu1512', 'pyles', 'clarksnano', 'kennedym', 'chang305', 'hopkin12', 'wallacjn', 'ajebakum', 'simon38', 'allredt', 'aanghelus', 'lou23', 'felbr', 'jbeale', 'tongyangshi', 'piyush100078', 'jseaton', 'nmenglin', 'jiaweiiii', 'xiaoshenwang', 'akshaydeshpande', 'jmethel', 'jhollkam', 'buckr', 'choi350', 'shawnwhitman', 'bartos', 'saranokiseki', 'xie215', 'kumar167', 'asherr', 'erciyuanwd', 'mbedard', 'robisonj', 'zhou523', 'djcarr', 'meyers18', 'lee1022', 'mnissim', 'jakeeppehimer', 'richa203', 'zhuangxinghao', 'nin', 'jung164', 'hranjan', None, 'ma319', 'chaolei', 'agarw103', 'tthomasg', 'vos', 'kingston', 'xliu123', 'xiaoyifu', 'cai157', 'glover19', 'wu937', 'liu915', 'thelmus']"
6,264,96,17,9,"['rgeorge', 'meyers18', 'nczapla', 'agarw103', 'tseng1', 'vos', 'gdesam', 'erciyuanwd', 'zhang824']",86,"['robya', 'murtuza.shergadwala', 'emorin', 'dstechma', 'boron1618', 'chuiespe', 'gwilfong', 'utsavac', 'ashishmc', 'turnqjm', 'btanasoi', 'odary', 'nljacobs5', 'rvanden', 'jmcgough', 'kamaram_munira', 'ward99', 'kcidkcid1992', 'ymeibb00', 'yang912', 'awillenb1', 'tsambor', 'xinweiguo', 'nmdenison', 'woods41', 'zyf', 'claytok', 'baker251', 'shruti1205', 'txvwxyz', 'leslie4', 'graber0', 'chen1720', 'giggerota', 'liu1512', 'pyles', 'clarksnano', 'kennedym', 'chang305', 'wallacjn', 'ajebakum', 'simon38', 'allredt', 'aanghelus', 'lou23', 'felbr', 'jbeale', 'tongyangshi', 'jseaton', 'nmenglin', 'jiaweiiii', 'xiaoshenwang', 'akshaydeshpande', 'jmethel', 'jhollkam', 'buckr', 'choi350', 'shawnwhitman', 'bartos', 'saranokiseki', 'xie215', 'kumar167', 'asherr', 'mbedard', 'robisonj', 'zhou523', 'djcarr', 'lee1022', 'mnissim', 'jakeeppehimer', 'richa203', 'zhuangxinghao', 'nin', 'jung164', 'hranjan', 'ma319', 'chaolei', 'tthomasg', 'kingston', 'xliu123', 'xiaoyifu', 'cai157', 'glover19', 'wu937', 'liu915', 'thelmus']",8,"['datta0', 'jduritsc95', 'gshivkum', 'fanchen', 'mlokanat', 'yilunyang', None, 'tiom99']",103,"['robya', 'nczapla', 'murtuza.shergadwala', 'emorin', 'dstechma', 'boron1618', 'gdesam', 'chuiespe', 'gwilfong', 'utsavac', 'ashishmc', 'mlokanat', 'turnqjm', 'tiom99', 'btanasoi', 'odary', 'nljacobs5', 'rgeorge', 'rvanden', 'jmcgough', 'kamaram_munira', 'ward99', 'kcidkcid1992', 'ymeibb00', 'yang912', 'awillenb1', 'tsambor', 'xinweiguo', 'nmdenison', 'tseng1', 'woods41', 'zyf', 'claytok', 'baker251', 'shruti1205', 'txvwxyz', 'leslie4', 'graber0', 'chen1720', 'zhang824', 'giggerota', 'liu1512', 'gshivkum', 'pyles', 'clarksnano', 'kennedym', 'chang305', 'wallacjn', 'ajebakum', 'simon38', 'allredt', 'aanghelus', 'lou23', 'fanchen', 'felbr', 'jbeale', 'tongyangshi', 'jseaton', 'nmenglin', 'jiaweiiii', 'xiaoshenwang', 'akshaydeshpande', 'jmethel', 'jhollkam', 'buckr', 'choi350', 'shawnwhitman', 'bartos', 'saranokiseki', 'xie215', 'kumar167', 'asherr', 'erciyuanwd', 'mbedard', 'robisonj', 'zhou523', 'djcarr', 'meyers18', 'lee1022', 'mnissim', 'jakeeppehimer', 'richa203', 'zhuangxinghao', 'jduritsc95', 'nin', 'jung164', 'yilunyang', 'hranjan', None, 'ma319', 'chaolei', 'agarw103', 'tthomasg', 'vos', 'datta0', 'kingston', 'xliu123', 'xiaoyifu', 'cai157', 'glover19', 'wu937', 'liu915', 'thelmus']"
6,271,96,15,13,"['kennedym', 'jmcgough', 'xinweiguo', 'akshaydeshpande', 'claytok', 'simon38', 'gdesam', 'giggerota', 'utsavac', 'nin', 'ashishmc', 'pyles', 'hranjan']",82,"['robya', 'nczapla', 'murtuza.shergadwala', 'emorin', 'dstechma', 'boron1618', 'chuiespe', 'gwilfong', 'turnqjm', 'btanasoi', 'odary', 'nljacobs5', 'rgeorge', 'rvanden', 'kamaram_munira', 'ward99', 'kcidkcid1992', 'ymeibb00', 'yang912', 'awillenb1', 'tsambor', 'nmdenison', 'tseng1', 'woods41', 'zyf', 'baker251', 'shruti1205', 'txvwxyz', 'leslie4', 'graber0', 'chen1720', 'zhang824', 'liu1512', 'clarksnano', 'chang305', 'wallacjn', 'ajebakum', 'allredt', 'aanghelus', 'lou23', 'felbr', 'jbeale', 'tongyangshi', 'jseaton', 'nmenglin', 'jiaweiiii', 'xiaoshenwang', 'jmethel', 'jhollkam', 'buckr', 'choi350', 'shawnwhitman', 'bartos', 'saranokiseki', 'xie215', 'kumar167', 'asherr', 'erciyuanwd', 'mbedard', 'robisonj', 'zhou523', 'djcarr', 'meyers18', 'lee1022', 'mnissim', 'jakeeppehimer', 'richa203', 'zhuangxinghao', 'jung164', 'ma319', 'chaolei', 'agarw103', 'tthomasg', 'vos', 'kingston', 'xliu123', 'xiaoyifu', 'cai157', 'glover19', 'wu937', 'liu915', 'thelmus']",2,"['russo6', None]",97,"['robya', 'nczapla', 'murtuza.shergadwala', 'emorin', 'dstechma', 'boron1618', 'gdesam', 'chuiespe', 'gwilfong', 'utsavac', 'ashishmc', 'turnqjm', 'btanasoi', 'odary', 'nljacobs5', 'rgeorge', 'rvanden', 'jmcgough', 'kamaram_munira', 'ward99', 'kcidkcid1992', 'ymeibb00', 'yang912', 'awillenb1', 'tsambor', 'xinweiguo', 'nmdenison', 'tseng1', 'woods41', 'zyf', 'claytok', 'baker251', 'shruti1205', 'txvwxyz', 'leslie4', 'graber0', 'chen1720', 'zhang824', 'giggerota', 'liu1512', 'pyles', 'clarksnano', 'kennedym', 'chang305', 'wallacjn', 'ajebakum', 'simon38', 'allredt', 'aanghelus', 'lou23', 'felbr', 'jbeale', 'tongyangshi', 'jseaton', 'nmenglin', 'jiaweiiii', 'xiaoshenwang', 'akshaydeshpande', 'jmethel', 'jhollkam', 'buckr', 'choi350', 'shawnwhitman', 'bartos', 'saranokiseki', 'xie215', 'kumar167', 'asherr', 'erciyuanwd', 'mbedard', 'robisonj', 'zhou523', 'djcarr', 'meyers18', 'lee1022', 'mnissim', 'jakeeppehimer', 'richa203', 'zhuangxinghao', 'nin', 'jung164', 'hranjan', None, 'ma319', 'russo6', 'chaolei', 'agarw103', 'tthomasg', 'vos', 'kingston', 'xliu123', 'xiaoyifu', 'cai157', 'glover19', 'wu937', 'liu915', 'thelmus']"
6,273,96,13,9,"['kennedym', 'xinweiguo', 'agarw103', 'claytok', 'simon38', 'baker251', 'giggerota', 'pyles', 'hranjan']",86,"['robya', 'nczapla', 'murtuza.shergadwala', 'emorin', 'dstechma', 'boron1618', 'gdesam', 'chuiespe', 'gwilfong', 'utsavac', 'ashishmc', 'turnqjm', 'btanasoi', 'odary', 'nljacobs5', 'rgeorge', 'rvanden', 'jmcgough', 'kamaram_munira', 'ward99', 'kcidkcid1992', 'ymeibb00', 'yang912', 'awillenb1', 'tsambor', 'nmdenison', 'tseng1', 'woods41', 'zyf', 'shruti1205', 'txvwxyz', 'leslie4', 'graber0', 'chen1720', 'zhang824', 'liu1512', 'clarksnano', 'chang305', 'wallacjn', 'ajebakum', 'allredt', 'aanghelus', 'lou23', 'felbr', 'jbeale', 'tongyangshi', 'jseaton', 'nmenglin', 'jiaweiiii', 'xiaoshenwang', 'akshaydeshpande', 'jmethel', 'jhollkam', 'buckr', 'choi350', 'shawnwhitman', 'bartos', 'saranokiseki', 'xie215', 'kumar167', 'asherr', 'erciyuanwd', 'mbedard', 'robisonj', 'zhou523', 'djcarr', 'meyers18', 'lee1022', 'mnissim', 'jakeeppehimer', 'richa203', 'zhuangxinghao', 'nin', 'jung164', 'ma319', 'chaolei', 'tthomasg', 'vos', 'kingston', 'xliu123', 'xiaoyifu', 'cai157', 'glover19', 'wu937', 'liu915', 'thelmus']",4,"['russo6', None, 'tadmor', 'clarksm']",99,"['robya', 'nczapla', 'murtuza.shergadwala', 'emorin', 'dstechma', 'boron1618', 'gdesam', 'chuiespe', 'gwilfong', 'utsavac', 'ashishmc', 'turnqjm', 'btanasoi', 'odary', 'nljacobs5', 'rgeorge', 'rvanden', 'jmcgough', 'kamaram_munira', 'ward99', 'kcidkcid1992', 'ymeibb00', 'yang912', 'awillenb1', 'tsambor', 'xinweiguo', 'nmdenison', 'tseng1', 'woods41', 'zyf', 'claytok', 'baker251', 'clarksm', 'shruti1205', 'txvwxyz', 'leslie4', 'graber0', 'chen1720', 'zhang824', 'giggerota', 'liu1512', 'pyles', 'clarksnano', 'kennedym', 'chang305', 'wallacjn', 'ajebakum', 'simon38', 'allredt', 'aanghelus', 'tadmor', 'lou23', 'felbr', 'jbeale', 'tongyangshi', 'jseaton', 'nmenglin', 'jiaweiiii', 'xiaoshenwang', 'akshaydeshpande', 'jmethel', 'jhollkam', 'buckr', 'choi350', 'shawnwhitman', 'bartos', 'saranokiseki', 'xie215', 'kumar167', 'asherr', 'erciyuanwd', 'mbedard', 'robisonj', 'zhou523', 'djcarr', 'meyers18', 'lee1022', 'mnissim', 'jakeeppehimer', 'richa203', 'zhuangxinghao', 'nin', 'jung164', 'hranjan', None, 'ma319', 'russo6', 'chaolei', 'agarw103', 'tthomasg', 'vos', 'kingston', 'xliu123', 'xiaoyifu', 'cai157', 'glover19', 'wu937', 'liu915', 'thelmus']"
6,274,96,13,11,"['rgeorge', 'meyers18', 'tseng1', 'zhuangxinghao', 'kingston', 'cai157', 'shruti1205', 'erciyuanwd', 'wu937', 'zhang824', 'txvwxyz']",84,"['robya', 'nczapla', 'murtuza.shergadwala', 'emorin', 'dstechma', 'boron1618', 'gdesam', 'chuiespe', 'gwilfong', 'utsavac', 'ashishmc', 'turnqjm', 'btanasoi', 'odary', 'nljacobs5', 'rvanden', 'jmcgough', 'kamaram_munira', 'ward99', 'kcidkcid1992', 'ymeibb00', 'yang912', 'awillenb1', 'tsambor', 'xinweiguo', 'nmdenison', 'woods41', 'zyf', 'claytok', 'baker251', 'leslie4', 'graber0', 'chen1720', 'giggerota', 'liu1512', 'pyles', 'clarksnano', 'kennedym', 'chang305', 'wallacjn', 'ajebakum', 'simon38', 'allredt', 'aanghelus', 'lou23', 'felbr', 'jbeale', 'tongyangshi', 'jseaton', 'nmenglin', 'jiaweiiii', 'xiaoshenwang', 'akshaydeshpande', 'jmethel', 'jhollkam', 'buckr', 'choi350', 'shawnwhitman', 'bartos', 'saranokiseki', 'xie215', 'kumar167', 'asherr', 'mbedard', 'robisonj', 'zhou523', 'djcarr', 'lee1022', 'mnissim', 'jakeeppehimer', 'richa203', 'nin', 'jung164', 'hranjan', 'ma319', 'chaolei', 'agarw103', 'tthomasg', 'vos', 'xliu123', 'xiaoyifu', 'glover19', 'liu915', 'thelmus']",2,"['fanchen', None]",97,"['robya', 'nczapla', 'murtuza.shergadwala', 'emorin', 'dstechma', 'boron1618', 'gdesam', 'chuiespe', 'gwilfong', 'utsavac', 'ashishmc', 'turnqjm', 'btanasoi', 'odary', 'nljacobs5', 'rgeorge', 'rvanden', 'jmcgough', 'kamaram_munira', 'ward99', 'kcidkcid1992', 'ymeibb00', 'yang912', 'awillenb1', 'tsambor', 'xinweiguo', 'nmdenison', 'tseng1', 'woods41', 'zyf', 'claytok', 'baker251', 'shruti1205', 'txvwxyz', 'leslie4', 'graber0', 'chen1720', 'zhang824', 'giggerota', 'liu1512', 'pyles', 'clarksnano', 'kennedym', 'chang305', 'wallacjn', 'ajebakum', 'simon38', 'allredt', 'aanghelus', 'lou23', 'fanchen', 'felbr', 'jbeale', 'tongyangshi', 'jseaton', 'nmenglin', 'jiaweiiii', 'xiaoshenwang', 'akshaydeshpande', 'jmethel', 'jhollkam', 'buckr', 'choi350', 'shawnwhitman', 'bartos', 'saranokiseki', 'xie215', 'kumar167', 'asherr', 'erciyuanwd', 'mbedard', 'robisonj', 'zhou523', 'djcarr', 'meyers18', 'lee1022', 'mnissim', 'jakeeppehimer', 'richa203', 'zhuangxinghao', 'nin', 'jung164', 'hranjan', None, 'ma319', 'chaolei', 'agarw103', 'tthomasg', 'vos', 'kingston', 'xliu123', 'xiaoyifu', 'cai157', 'glover19', 'wu937', 'liu915', 'thelmus']"
6,272,96,12,10,"['rgeorge', 'meyers18', 'vos', 'zhuangxinghao', 'gdesam', 'cai157', 'erciyuanwd', 'wu937', 'zhang824', 'txvwxyz']",85,"['robya', 'nczapla', 'murtuza.shergadwala', 'emorin', 'dstechma', 'boron1618', 'chuiespe', 'gwilfong', 'utsavac', 'ashishmc', 'turnqjm', 'btanasoi', 'odary', 'nljacobs5', 'rvanden', 'jmcgough', 'kamaram_munira', 'ward99', 'kcidkcid1992', 'ymeibb00', 'yang912', 'awillenb1', 'tsambor', 'xinweiguo', 'nmdenison', 'tseng1', 'woods41', 'zyf', 'claytok', 'baker251', 'shruti1205', 'leslie4', 'graber0', 'chen1720', 'giggerota', 'liu1512', 'pyles', 'clarksnano', 'kennedym', 'chang305', 'wallacjn', 'ajebakum', 'simon38', 'allredt', 'aanghelus', 'lou23', 'felbr', 'jbeale', 'tongyangshi', 'jseaton', 'nmenglin', 'jiaweiiii', 'xiaoshenwang', 'akshaydeshpande', 'jmethel', 'jhollkam', 'buckr', 'choi350', 'shawnwhitman', 'bartos', 'saranokiseki', 'xie215', 'kumar167', 'asherr', 'mbedard', 'robisonj', 'zhou523', 'djcarr', 'lee1022', 'mnissim', 'jakeeppehimer', 'richa203', 'nin', 'jung164', 'hranjan', 'ma319', 'chaolei', 'agarw103', 'tthomasg', 'kingston', 'xliu123', 'xiaoyifu', 'glover19', 'liu915', 'thelmus']",2,"[None, 'tejerina']",97,"['robya', 'nczapla', 'murtuza.shergadwala', 'emorin', 'dstechma', 'boron1618', 'gdesam', 'chuiespe', 'gwilfong', 'utsavac', 'ashishmc', 'turnqjm', 'btanasoi', 'odary', 'nljacobs5', 'rgeorge', 'rvanden', 'jmcgough', 'kamaram_munira', 'ward99', 'kcidkcid1992', 'ymeibb00', 'yang912', 'awillenb1', 'tsambor', 'xinweiguo', 'nmdenison', 'tseng1', 'woods41', 'zyf', 'claytok', 'baker251', 'shruti1205', 'txvwxyz', 'leslie4', 'graber0', 'chen1720', 'zhang824', 'giggerota', 'liu1512', 'pyles', 'clarksnano', 'kennedym', 'chang305', 'wallacjn', 'ajebakum', 'simon38', 'allredt', 'aanghelus', 'lou23', 'tejerina', 'felbr', 'jbeale', 'tongyangshi', 'jseaton', 'nmenglin', 'jiaweiiii', 'xiaoshenwang', 'akshaydeshpande', 'jmethel', 'jhollkam', 'buckr', 'choi350', 'shawnwhitman', 'bartos', 'saranokiseki', 'xie215', 'kumar167', 'asherr', 'erciyuanwd', 'mbedard', 'robisonj', 'zhou523', 'djcarr', 'meyers18', 'lee1022', 'mnissim', 'jakeeppehimer', 'richa203', 'zhuangxinghao', 'nin', 'jung164', 'hranjan', None, 'ma319', 'chaolei', 'agarw103', 'tthomasg', 'vos', 'kingston', 'xliu123', 'xiaoyifu', 'cai157', 'glover19', 'wu937', 'liu915', 'thelmus']"
6,276,96,11,10,"['rgeorge', 'meyers18', 'wallacjn', 'zhuangxinghao', 'allredt', 'cai157', 'shruti1205', 'erciyuanwd', 'wu937', 'txvwxyz']",85,"['robya', 'nczapla', 'murtuza.shergadwala', 'emorin', 'dstechma', 'boron1618', 'gdesam', 'chuiespe', 'gwilfong', 'utsavac', 'ashishmc', 'turnqjm', 'btanasoi', 'odary', 'nljacobs5', 'rvanden', 'jmcgough', 'kamaram_munira', 'ward99', 'kcidkcid1992', 'ymeibb00', 'yang912', 'awillenb1', 'tsambor', 'xinweiguo', 'nmdenison', 'tseng1', 'woods41', 'zyf', 'claytok', 'baker251', 'leslie4', 'graber0', 'chen1720', 'zhang824', 'giggerota', 'liu1512', 'pyles', 'clarksnano', 'kennedym', 'chang305', 'ajebakum', 'simon38', 'aanghelus', 'lou23', 'felbr', 'jbeale', 'tongyangshi', 'jseaton', 'nmenglin', 'jiaweiiii', 'xiaoshenwang', 'akshaydeshpande', 'jmethel', 'jhollkam', 'buckr', 'choi350', 'shawnwhitman', 'bartos', 'saranokiseki', 'xie215', 'kumar167', 'asherr', 'mbedard', 'robisonj', 'zhou523', 'djcarr', 'lee1022', 'mnissim', 'jakeeppehimer', 'richa203', 'nin', 'jung164', 'hranjan', 'ma319', 'chaolei', 'agarw103', 'tthomasg', 'vos', 'kingston', 'xliu123', 'xiaoyifu', 'glover19', 'liu915', 'thelmus']",1,[None],96,"['robya', 'nczapla', 'murtuza.shergadwala', 'emorin', 'dstechma', 'boron1618', 'gdesam', 'chuiespe', 'gwilfong', 'utsavac', 'ashishmc', 'turnqjm', 'btanasoi', 'odary', 'nljacobs5', 'rgeorge', 'rvanden', 'jmcgough', 'kamaram_munira', 'ward99', 'kcidkcid1992', 'ymeibb00', 'yang912', 'awillenb1', 'tsambor', 'xinweiguo', 'nmdenison', 'tseng1', 'woods41', 'zyf', 'claytok', 'baker251', 'shruti1205', 'txvwxyz', 'leslie4', 'graber0', 'chen1720', 'zhang824', 'giggerota', 'liu1512', 'pyles', 'clarksnano', 'kennedym', 'chang305', 'wallacjn', 'ajebakum', 'simon38', 'allredt', 'aanghelus', 'lou23', 'felbr', 'jbeale', 'tongyangshi', 'jseaton', 'nmenglin', 'jiaweiiii', 'xiaoshenwang', 'akshaydeshpande', 'jmethel', 'jhollkam', 'buckr', 'choi350', 'shawnwhitman', 'bartos', 'saranokiseki', 'xie215', 'kumar167', 'asherr', 'erciyuanwd', 'mbedard', 'robisonj', 'zhou523', 'djcarr', 'meyers18', 'lee1022', 'mnissim', 'jakeeppehimer', 'richa203', 'zhuangxinghao', 'nin', 'jung164', 'hranjan', None, 'ma319', 'chaolei', 'agarw103', 'tthomasg', 'vos', 'kingston', 'xliu123', 'xiaoyifu', 'cai157', 'glover19', 'wu937', 'liu915', 'thelmus']"
6,275,96,10,9,"['rgeorge', 'meyers18', 'zhuangxinghao', 'kingston', 'gdesam', 'cai157', 'erciyuanwd', 'wu937', 'txvwxyz']",86,"['robya', 'nczapla', 'murtuza.shergadwala', 'emorin', 'dstechma', 'boron1618', 'chuiespe', 'gwilfong', 'utsavac', 'ashishmc', 'turnqjm', 'btanasoi', 'odary', 'nljacobs5', 'rvanden', 'jmcgough', 'kamaram_munira', 'ward99', 'kcidkcid1992', 'ymeibb00', 'yang912', 'awillenb1', 'tsambor', 'xinweiguo', 'nmdenison', 'tseng1', 'woods41', 'zyf', 'claytok', 'baker251', 'shruti1205', 'leslie4', 'graber0', 'chen1720', 'zhang824', 'giggerota', 'liu1512', 'pyles', 'clarksnano', 'kennedym', 'chang305', 'wallacjn', 'ajebakum', 'simon38', 'allredt', 'aanghelus', 'lou23', 'felbr', 'jbeale', 'tongyangshi', 'jseaton', 'nmenglin', 'jiaweiiii', 'xiaoshenwang', 'akshaydeshpande', 'jmethel', 'jhollkam', 'buckr', 'choi350', 'shawnwhitman', 'bartos', 'saranokiseki', 'xie215', 'kumar167', 'asherr', 'mbedard', 'robisonj', 'zhou523', 'djcarr', 'lee1022', 'mnissim', 'jakeeppehimer', 'richa203', 'nin', 'jung164', 'hranjan', 'ma319', 'chaolei', 'agarw103', 'tthomasg', 'vos', 'xliu123', 'xiaoyifu', 'glover19', 'liu915', 'thelmus']",1,[None],96,"['robya', 'nczapla', 'murtuza.shergadwala', 'emorin', 'dstechma', 'boron1618', 'gdesam', 'chuiespe', 'gwilfong', 'utsavac', 'ashishmc', 'turnqjm', 'btanasoi', 'odary', 'nljacobs5', 'rgeorge', 'rvanden', 'jmcgough', 'kamaram_munira', 'ward99', 'kcidkcid1992', 'ymeibb00', 'yang912', 'awillenb1', 'tsambor', 'xinweiguo', 'nmdenison', 'tseng1', 'woods41', 'zyf', 'claytok', 'baker251', 'shruti1205', 'txvwxyz', 'leslie4', 'graber0', 'chen1720', 'zhang824', 'giggerota', 'liu1512', 'pyles', 'clarksnano', 'kennedym', 'chang305', 'wallacjn', 'ajebakum', 'simon38', 'allredt', 'aanghelus', 'lou23', 'felbr', 'jbeale', 'tongyangshi', 'jseaton', 'nmenglin', 'jiaweiiii', 'xiaoshenwang', 'akshaydeshpande', 'jmethel', 'jhollkam', 'buckr', 'choi350', 'shawnwhitman', 'bartos', 'saranokiseki', 'xie215', 'kumar167', 'asherr', 'erciyuanwd', 'mbedard', 'robisonj', 'zhou523', 'djcarr', 'meyers18', 'lee1022', 'mnissim', 'jakeeppehimer', 'richa203', 'zhuangxinghao', 'nin', 'jung164', 'hranjan', None, 'ma319', 'chaolei', 'agarw103', 'tthomasg', 'vos', 'kingston', 'xliu123', 'xiaoyifu', 'cai157', 'glover19', 'wu937', 'liu915', 'thelmus']"
6,266,96,6,2,"['xiaoyifu', 'liu915']",93,"['robya', 'nczapla', 'murtuza.shergadwala', 'emorin', 'dstechma', 'boron1618', 'gdesam', 'chuiespe', 'gwilfong', 'utsavac', 'ashishmc', 'turnqjm', 'btanasoi', 'odary', 'nljacobs5', 'rgeorge', 'rvanden', 'jmcgough', 'kamaram_munira', 'ward99', 'kcidkcid1992', 'ymeibb00', 'yang912', 'awillenb1', 'tsambor', 'xinweiguo', 'nmdenison', 'tseng1', 'woods41', 'zyf', 'claytok', 'baker251', 'shruti1205', 'txvwxyz', 'leslie4', 'graber0', 'chen1720', 'zhang824', 'giggerota', 'liu1512', 'pyles', 'clarksnano', 'kennedym', 'chang305', 'wallacjn', 'ajebakum', 'simon38', 'allredt', 'aanghelus', 'lou23', 'felbr', 'jbeale', 'tongyangshi', 'jseaton', 'nmenglin', 'jiaweiiii', 'xiaoshenwang', 'akshaydeshpande', 'jmethel', 'jhollkam', 'buckr', 'choi350', 'shawnwhitman', 'bartos', 'saranokiseki', 'xie215', 'kumar167', 'asherr', 'erciyuanwd', 'mbedard', 'robisonj', 'zhou523', 'djcarr', 'meyers18', 'lee1022', 'mnissim', 'jakeeppehimer', 'richa203', 'zhuangxinghao', 'nin', 'jung164', 'hranjan', 'ma319', 'chaolei', 'agarw103', 'tthomasg', 'vos', 'kingston', 'xliu123', 'cai157', 'glover19', 'wu937', 'thelmus']",4,"['pburgeso', None, 'zhou6510', 'cr88']",99,"['robya', 'nczapla', 'murtuza.shergadwala', 'emorin', 'dstechma', 'boron1618', 'gdesam', 'chuiespe', 'gwilfong', 'utsavac', 'ashishmc', 'turnqjm', 'btanasoi', 'odary', 'nljacobs5', 'rgeorge', 'rvanden', 'jmcgough', 'kamaram_munira', 'zhou6510', 'ward99', 'kcidkcid1992', 'ymeibb00', 'yang912', 'awillenb1', 'tsambor', 'xinweiguo', 'nmdenison', 'tseng1', 'woods41', 'zyf', 'claytok', 'baker251', 'cr88', 'shruti1205', 'txvwxyz', 'leslie4', 'graber0', 'chen1720', 'zhang824', 'giggerota', 'liu1512', 'pyles', 'clarksnano', 'kennedym', 'chang305', 'wallacjn', 'ajebakum', 'simon38', 'allredt', 'aanghelus', 'lou23', 'felbr', 'jbeale', 'tongyangshi', 'jseaton', 'pburgeso', 'nmenglin', 'jiaweiiii', 'xiaoshenwang', 'akshaydeshpande', 'jmethel', 'jhollkam', 'buckr', 'choi350', 'shawnwhitman', 'bartos', 'saranokiseki', 'xie215', 'kumar167', 'asherr', 'erciyuanwd', 'mbedard', 'robisonj', 'zhou523', 'djcarr', 'meyers18', 'lee1022', 'mnissim', 'jakeeppehimer', 'richa203', 'zhuangxinghao', 'nin', 'jung164', 'hranjan', None, 'ma319', 'chaolei', 'agarw103', 'tthomasg', 'vos', 'kingston', 'xliu123', 'xiaoyifu', 'cai157', 'glover19', 'wu937', 'liu915', 'thelmus']"
6,269,96,6,4,"['liu915', 'liu1512', 'xiaoyifu', 'xie215']",91,"['robya', 'nczapla', 'murtuza.shergadwala', 'emorin', 'dstechma', 'boron1618', 'gdesam', 'chuiespe', 'gwilfong', 'utsavac', 'ashishmc', 'turnqjm', 'btanasoi', 'odary', 'nljacobs5', 'rgeorge', 'rvanden', 'jmcgough', 'kamaram_munira', 'ward99', 'kcidkcid1992', 'ymeibb00', 'yang912', 'awillenb1', 'tsambor', 'xinweiguo', 'nmdenison', 'tseng1', 'woods41', 'zyf', 'claytok', 'baker251', 'shruti1205', 'txvwxyz', 'leslie4', 'graber0', 'chen1720', 'zhang824', 'giggerota', 'pyles', 'clarksnano', 'kennedym', 'chang305', 'wallacjn', 'ajebakum', 'simon38', 'allredt', 'aanghelus', 'lou23', 'felbr', 'jbeale', 'tongyangshi', 'jseaton', 'nmenglin', 'jiaweiiii', 'xiaoshenwang', 'akshaydeshpande', 'jmethel', 'jhollkam', 'buckr', 'choi350', 'shawnwhitman', 'bartos', 'saranokiseki', 'kumar167', 'asherr', 'erciyuanwd', 'mbedard', 'robisonj', 'zhou523', 'djcarr', 'meyers18', 'lee1022', 'mnissim', 'jakeeppehimer', 'richa203', 'zhuangxinghao', 'nin', 'jung164', 'hranjan', 'ma319', 'chaolei', 'agarw103', 'tthomasg', 'vos', 'kingston', 'xliu123', 'cai157', 'glover19', 'wu937', 'thelmus']",2,"[None, 'jseymour']",97,"['robya', 'nczapla', 'murtuza.shergadwala', 'emorin', 'dstechma', 'boron1618', 'gdesam', 'chuiespe', 'gwilfong', 'utsavac', 'ashishmc', 'turnqjm', 'btanasoi', 'odary', 'nljacobs5', 'rgeorge', 'rvanden', 'jmcgough', 'kamaram_munira', 'ward99', 'kcidkcid1992', 'ymeibb00', 'yang912', 'awillenb1', 'tsambor', 'xinweiguo', 'nmdenison', 'tseng1', 'woods41', 'zyf', 'claytok', 'baker251', 'shruti1205', 'txvwxyz', 'leslie4', 'graber0', 'chen1720', 'zhang824', 'giggerota', 'liu1512', 'pyles', 'clarksnano', 'kennedym', 'chang305', 'wallacjn', 'ajebakum', 'simon38', 'allredt', 'aanghelus', 'lou23', 'felbr', 'jbeale', 'tongyangshi', 'jseaton', 'nmenglin', 'jiaweiiii', 'xiaoshenwang', 'akshaydeshpande', 'jmethel', 'jhollkam', 'buckr', 'choi350', 'shawnwhitman', 'bartos', 'saranokiseki', 'xie215', 'kumar167', 'asherr', 'erciyuanwd', 'mbedard', 'robisonj', 'zhou523', 'djcarr', 'meyers18', 'lee1022', 'mnissim', 'jakeeppehimer', 'richa203', 'zhuangxinghao', 'nin', 'jung164', 'jseymour', 'hranjan', None, 'ma319', 'chaolei', 'agarw103', 'tthomasg', 'vos', 'kingston', 'xliu123', 'xiaoyifu', 'cai157', 'glover19', 'wu937', 'liu915', 'thelmus']"
7,74,75,53,1,['kvirgen'],73,"['kevinf92', 'jmalle10', 'liuxiaov', 'jlrigdon', 'kmfrink', 'abbaldwi', 'ems427', 'apkellih', 'jaingra2', 'blenin1', 'ablandmly', 'pbeaucage', 'rachelsteinhardt', 'bmtrevis', 'jmpolz', 'shuoli1', 'mozi_zyr', 'edeaster', '94tfcwhite', 'sufczynski', 'kasmit19', 'skidwel', 'trigonography', 'jlhumph4', 'mmkasper', 'qz224', 'jongkindjoe', 'cmmetz', 'cngallag', 'cliddell1', 'yyue94', 'msmorave', 'kgmingay', 'ff232', 'jhgillen', 'awsmall', 'mpbenbow', 'b_motevalli_62', 'mp868', 'erictea', 'jakuhne', 'awn32', 'zzfelemb', 'dpavlik1', 'memays2', 'graham.marshall.9889', 'jlin16', 'npcarlto', 'alicia.cintora', 'bellucci', 'yongfeiji', 'asd0210a', 'reumscott', 'ijowsian', 'mfreardo', 'blasuberuaga', 'abloutha', 'elucas', 'secarmea', 'jddicker', 'kbbarbou', 'prnolan', 'rjlarrab', 'gthauser', 'menghuang', 'bepeter2', 'zhqi927', 'zl453', 'celhin', 'camooney', 'bxruther', 'wtbrown2', 'tjoweida']",52,"['jtherber', 'holmano', 'nbasnet', 'xalmeida11', 'zhuber6', 'dillons', 'cody.campana', 'mtomas', 'nakhoa92', 'jhseto', 'brockhaft1994', 'joshemminger', '2muchswag93', 'klefevre20', 'eapost', 'jcarriola0118', 'pzinni', 'xiangl19', 'afifeh91', 'csteeno15', 'kiddevin', 'jdmart22', 'nrodkey', 'adireddevil712', 'kanguye1', 'rlin11', 'toamikel', 'jshwilams767', 'skykeeper0', 'jmhern16', 'sdshiladitya', 'pandapot', 'bsankar2', 'sayedserhan', None, 'zdrummon', 'jayjay1122', 'zkiefer', 'mvcortez', 'drcornel', 'jwbrown1210', 'hongbin.yu', 'rdbaca', 'mtmunir', 'navnano1034', 'eszelech', 'djorivco', 'jdull', 'alucas3', 'pkoswatt', 'harshjain2691', 'jzia1']",126,"['kevinf92', 'jmalle10', 'jlrigdon', 'holmano', 'kmfrink', 'nbasnet', 'apkellih', 'rachelsteinhardt', 'zhuber6', 'dillons', 'cody.campana', 'mozi_zyr', 'edeaster', '94tfcwhite', 'sufczynski', 'nakhoa92', '2muchswag93', 'brockhaft1994', 'klefevre20', 'mmkasper', 'cmmetz', 'cngallag', 'pzinni', 'yyue94', 'xiangl19', 'msmorave', 'jhgillen', 'csteeno15', 'mpbenbow', 'b_motevalli_62', 'jakuhne', 'nrodkey', 'dpavlik1', 'memays2', 'bellucci', 'asd0210a', 'sdshiladitya', 'reumscott', 'mfreardo', 'sayedserhan', 'elucas', 'jddicker', 'kbbarbou', 'prnolan', 'jayjay1122', 'mvcortez', 'drcornel', 'jwbrown1210', 'bepeter2', 'hongbin.yu', 'zhqi927', 'rdbaca', 'mtmunir', 'navnano1034', 'djorivco', 'jdull', 'bxruther', 'harshjain2691', 'liuxiaov', 'jzia1', 'jtherber', 'abbaldwi', 'ems427', 'jaingra2', 'blenin1', 'ablandmly', 'xalmeida11', 'pbeaucage', 'bmtrevis', 'jmpolz', 'shuoli1', 'mtomas', 'kasmit19', 'skidwel', 'trigonography', 'joshemminger', 'jhseto', 'jlhumph4', 'qz224', 'jongkindjoe', 'cliddell1', 'eapost', 'jcarriola0118', 'kgmingay', 'ff232', 'afifeh91', 'awsmall', 'mp868', 'erictea', 'kiddevin', 'jdmart22', 'awn32', 'adireddevil712', 'zzfelemb', 'kanguye1', 'graham.marshall.9889', 'rlin11', 'jlin16', 'pkoswatt', 'toamikel', 'jshwilams767', 'npcarlto', 'alicia.cintora', 'yongfeiji', 'skykeeper0', 'jmhern16', 'ijowsian', 'pandapot', 'bsankar2', 'blasuberuaga', None, 'abloutha', 'zdrummon', 'secarmea', 'rjlarrab', 'zkiefer', 'gthauser', 'menghuang', 'zl453', 'celhin', 'camooney', 'kvirgen', 'eszelech', 'alucas3', 'wtbrown2', 'tjoweida']"
7,75,75,45,40,"['jlrigdon', 'jmalle10', 'kmfrink', 'abbaldwi', 'apkellih', 'jaingra2', 'blenin1', 'bmtrevis', 'edeaster', '94tfcwhite', 'kasmit19', 'sufczynski', 'skidwel', 'jlhumph4', 'mmkasper', 'jongkindjoe', 'cngallag', 'cmmetz', 'yyue94', 'msmorave', 'awsmall', 'jhgillen', 'mpbenbow', 'jakuhne', 'zzfelemb', 'graham.marshall.9889', 'jlin16', 'npcarlto', 'ijowsian', 'mfreardo', 'abloutha', 'elucas', 'secarmea', 'prnolan', 'kbbarbou', 'gthauser', 'bepeter2', 'camooney', 'bxruther', 'rjlarrab']",34,"['kevinf92', 'liuxiaov', 'ems427', 'ablandmly', 'pbeaucage', 'rachelsteinhardt', 'jmpolz', 'shuoli1', 'mozi_zyr', 'trigonography', 'qz224', 'cliddell1', 'kgmingay', 'ff232', 'b_motevalli_62', 'mp868', 'erictea', 'awn32', 'dpavlik1', 'memays2', 'alicia.cintora', 'bellucci', 'yongfeiji', 'asd0210a', 'reumscott', 'blasuberuaga', 'jddicker', 'menghuang', 'zhqi927', 'zl453', 'celhin', 'kvirgen', 'wtbrown2', 'tjoweida']",5,"['brennerncsuedu', 'hkdavis3', 'jtjordan', 'samaher_salem', None]",79,"['kevinf92', 'jmalle10', 'jlrigdon', 'kmfrink', 'apkellih', 'rachelsteinhardt', 'mozi_zyr', 'edeaster', '94tfcwhite', 'sufczynski', 'mmkasper', 'cmmetz', 'cngallag', 'yyue94', 'msmorave', 'jhgillen', 'mpbenbow', 'b_motevalli_62', 'samaher_salem', 'jakuhne', 'dpavlik1', 'memays2', 'bellucci', 'asd0210a', 'reumscott', 'mfreardo', 'elucas', 'jddicker', 'kbbarbou', 'prnolan', 'bepeter2', 'jtjordan', 'zhqi927', 'bxruther', 'liuxiaov', 'abbaldwi', 'ems427', 'jaingra2', 'blenin1', 'ablandmly', 'pbeaucage', 'bmtrevis', 'jmpolz', 'shuoli1', 'kasmit19', 'skidwel', 'trigonography', 'jlhumph4', 'qz224', 'jongkindjoe', 'cliddell1', 'kgmingay', 'ff232', 'hkdavis3', 'awsmall', 'mp868', 'erictea', 'brennerncsuedu', 'awn32', 'zzfelemb', 'graham.marshall.9889', 'jlin16', 'npcarlto', 'alicia.cintora', 'yongfeiji', 'ijowsian', 'blasuberuaga', None, 'abloutha', 'secarmea', 'rjlarrab', 'gthauser', 'menghuang', 'zl453', 'celhin', 'camooney', 'kvirgen', 'wtbrown2', 'tjoweida']"
7,277,75,43,41,"['jlrigdon', 'jmalle10', 'kmfrink', 'abbaldwi', 'apkellih', 'blenin1', 'jmpolz', 'bmtrevis', 'edeaster', '94tfcwhite', 'kasmit19', 'sufczynski', 'skidwel', 'jlhumph4', 'jongkindjoe', 'cngallag', 'cmmetz', 'yyue94', 'msmorave', 'kgmingay', 'awsmall', 'jhgillen', 'mpbenbow', 'jakuhne', 'zzfelemb', 'graham.marshall.9889', 'jlin16', 'npcarlto', 'ijowsian', 'mfreardo', 'abloutha', 'elucas', 'secarmea', 'prnolan', 'kbbarbou', 'gthauser', 'bepeter2', 'camooney', 'bxruther', 'rjlarrab', 'tjoweida']",33,"['kevinf92', 'liuxiaov', 'ems427', 'jaingra2', 'ablandmly', 'pbeaucage', 'rachelsteinhardt', 'shuoli1', 'mozi_zyr', 'trigonography', 'mmkasper', 'qz224', 'cliddell1', 'ff232', 'b_motevalli_62', 'mp868', 'erictea', 'awn32', 'dpavlik1', 'memays2', 'alicia.cintora', 'bellucci', 'yongfeiji', 'asd0210a', 'reumscott', 'blasuberuaga', 'jddicker', 'menghuang', 'zhqi927', 'zl453', 'celhin', 'kvirgen', 'wtbrown2']",2,"[None, 'jtjordan']",76,"['kevinf92', 'jmalle10', 'jlrigdon', 'kmfrink', 'apkellih', 'rachelsteinhardt', 'mozi_zyr', 'edeaster', '94tfcwhite', 'sufczynski', 'mmkasper', 'cmmetz', 'cngallag', 'yyue94', 'msmorave', 'jhgillen', 'mpbenbow', 'b_motevalli_62', 'jakuhne', 'dpavlik1', 'memays2', 'bellucci', 'asd0210a', 'reumscott', 'mfreardo', 'elucas', 'jddicker', 'kbbarbou', 'prnolan', 'bepeter2', 'jtjordan', 'zhqi927', 'bxruther', 'liuxiaov', 'abbaldwi', 'ems427', 'jaingra2', 'blenin1', 'ablandmly', 'pbeaucage', 'bmtrevis', 'jmpolz', 'shuoli1', 'kasmit19', 'skidwel', 'trigonography', 'jlhumph4', 'qz224', 'jongkindjoe', 'cliddell1', 'kgmingay', 'ff232', 'awsmall', 'mp868', 'erictea', 'awn32', 'zzfelemb', 'graham.marshall.9889', 'jlin16', 'npcarlto', 'alicia.cintora', 'yongfeiji', 'ijowsian', 'blasuberuaga', None, 'abloutha', 'secarmea', 'rjlarrab', 'gthauser', 'menghuang', 'zl453', 'celhin', 'camooney', 'kvirgen', 'wtbrown2', 'tjoweida']"
7,279,75,20,19,"['kevinf92', 'liuxiaov', 'ems427', 'ablandmly', 'pbeaucage', 'rachelsteinhardt', 'shuoli1', 'mozi_zyr', 'qz224', 'cliddell1', 'ff232', 'mp868', 'awn32', 'dpavlik1', 'alicia.cintora', 'reumscott', 'menghuang', 'zhqi927', 'zl453']",55,"['jmalle10', 'jlrigdon', 'kmfrink', 'abbaldwi', 'apkellih', 'jaingra2', 'blenin1', 'bmtrevis', 'jmpolz', 'edeaster', 'skidwel', 'kasmit19', 'sufczynski', '94tfcwhite', 'trigonography', 'jlhumph4', 'mmkasper', 'jongkindjoe', 'cmmetz', 'cngallag', 'yyue94', 'msmorave', 'kgmingay', 'jhgillen', 'awsmall', 'mpbenbow', 'b_motevalli_62', 'erictea', 'jakuhne', 'zzfelemb', 'memays2', 'graham.marshall.9889', 'jlin16', 'npcarlto', 'bellucci', 'yongfeiji', 'asd0210a', 'ijowsian', 'mfreardo', 'blasuberuaga', 'abloutha', 'elucas', 'secarmea', 'jddicker', 'kbbarbou', 'prnolan', 'rjlarrab', 'gthauser', 'bepeter2', 'celhin', 'camooney', 'kvirgen', 'bxruther', 'wtbrown2', 'tjoweida']",1,[None],75,"['kevinf92', 'jmalle10', 'jlrigdon', 'kmfrink', 'apkellih', 'rachelsteinhardt', 'mozi_zyr', 'edeaster', '94tfcwhite', 'sufczynski', 'mmkasper', 'cmmetz', 'cngallag', 'yyue94', 'msmorave', 'jhgillen', 'mpbenbow', 'b_motevalli_62', 'jakuhne', 'dpavlik1', 'memays2', 'bellucci', 'asd0210a', 'reumscott', 'mfreardo', 'elucas', 'jddicker', 'kbbarbou', 'prnolan', 'bepeter2', 'zhqi927', 'bxruther', 'liuxiaov', 'abbaldwi', 'ems427', 'jaingra2', 'blenin1', 'ablandmly', 'pbeaucage', 'bmtrevis', 'jmpolz', 'shuoli1', 'kasmit19', 'skidwel', 'trigonography', 'jlhumph4', 'qz224', 'jongkindjoe', 'cliddell1', 'kgmingay', 'ff232', 'awsmall', 'mp868', 'erictea', 'awn32', 'zzfelemb', 'graham.marshall.9889', 'jlin16', 'npcarlto', 'alicia.cintora', 'yongfeiji', 'ijowsian', 'blasuberuaga', None, 'abloutha', 'secarmea', 'rjlarrab', 'gthauser', 'menghuang', 'zl453', 'celhin', 'camooney', 'kvirgen', 'wtbrown2', 'tjoweida']"
7,278,75,8,6,"['dpavlik1', 'cliddell1', 'liuxiaov', 'zhqi927', 'pbeaucage', 'reumscott']",68,"['kevinf92', 'jmalle10', 'jlrigdon', 'kmfrink', 'apkellih', 'rachelsteinhardt', 'mozi_zyr', 'edeaster', '94tfcwhite', 'sufczynski', 'mmkasper', 'cmmetz', 'cngallag', 'yyue94', 'msmorave', 'jhgillen', 'mpbenbow', 'b_motevalli_62', 'jakuhne', 'memays2', 'bellucci', 'asd0210a', 'mfreardo', 'elucas', 'jddicker', 'kbbarbou', 'prnolan', 'bepeter2', 'bxruther', 'abbaldwi', 'ems427', 'jaingra2', 'blenin1', 'ablandmly', 'bmtrevis', 'jmpolz', 'shuoli1', 'kasmit19', 'skidwel', 'trigonography', 'jlhumph4', 'qz224', 'jongkindjoe', 'kgmingay', 'ff232', 'awsmall', 'mp868', 'erictea', 'awn32', 'zzfelemb', 'graham.marshall.9889', 'jlin16', 'npcarlto', 'alicia.cintora', 'yongfeiji', 'ijowsian', 'blasuberuaga', 'abloutha', 'secarmea', 'rjlarrab', 'gthauser', 'menghuang', 'zl453', 'celhin', 'camooney', 'kvirgen', 'wtbrown2', 'tjoweida']",2,"['rs963', None]",76,"['kevinf92', 'jmalle10', 'jlrigdon', 'kmfrink', 'apkellih', 'rachelsteinhardt', 'mozi_zyr', 'edeaster', '94tfcwhite', 'sufczynski', 'mmkasper', 'cmmetz', 'cngallag', 'yyue94', 'msmorave', 'jhgillen', 'mpbenbow', 'b_motevalli_62', 'jakuhne', 'dpavlik1', 'memays2', 'bellucci', 'asd0210a', 'reumscott', 'mfreardo', 'elucas', 'jddicker', 'kbbarbou', 'prnolan', 'bepeter2', 'zhqi927', 'bxruther', 'liuxiaov', 'abbaldwi', 'ems427', 'jaingra2', 'blenin1', 'ablandmly', 'pbeaucage', 'bmtrevis', 'jmpolz', 'shuoli1', 'kasmit19', 'skidwel', 'trigonography', 'jlhumph4', 'qz224', 'jongkindjoe', 'cliddell1', 'kgmingay', 'ff232', 'awsmall', 'mp868', 'erictea', 'rs963', 'awn32', 'zzfelemb', 'graham.marshall.9889', 'jlin16', 'npcarlto', 'alicia.cintora', 'yongfeiji', 'ijowsian', 'blasuberuaga', None, 'abloutha', 'secarmea', 'rjlarrab', 'gthauser', 'menghuang', 'zl453', 'celhin', 'camooney', 'kvirgen', 'wtbrown2', 'tjoweida']"
8,180,74,58,55,"['elenageorgiou', 'sethings', 'luke.maestro', 'lm1zra', 'shila.sultana', 'michaelwall', 'matthew1.odoherty', 'j.seymour1994', 'ramzdog', 'liam2501', 'rose.b5', 'chris2dyt', 'joshwilliamrobinson', 'zg011124', 'chemiati', 'humaira94', 'singhgk2202', 'joshtruswell', 'qwertyuiopzxcvbnm', 'cib123', 'noornia', 'annafreya363', 'robwelsh', 'connor1996', 'alicemcook', 'saher19', 'roisinhazell', 'lbtaye', 'thomjenns', 'qw003594', 'rachelmclaren', 'blueribena3', 'nashio', 'dc011158', 'ryan.duplock', 'dimpypandya18', 'gracevarughese95', 'jjmartin', 'andrewkearns', 'pringlecode', 'fsmall', 'hollyabell', 'shreya.mashru', 'austing96', 'danielhewes1996', 'miccos14', 'greeneey1', 'hkww2006', 'bilalhassan142004', 'missgraciabahati', 'robmaidment', 'aemelia1', 'gn009686', 'adowning', 'michael_nguyen123']",18,"['samburton93', 'cameron001374', 'sams1714', 'heikearnolds', 'czeleny', 'joefitch', 'kglynn95', 'matthew.edwards040506', 'matt.hagreen', 'zh014259', 'arthur140', 'ksim634', 'w.attwood', 'jarlan', 'betsy.cb23', 'rkas', 'josephbrehm', 'mask93']",3,"[None, 'andypocock34', 'hannah.leggatt']",76,"['elenageorgiou', 'cameron001374', 'luke.maestro', 'michaelwall', 'zh014259', 'chris2dyt', 'chemiati', 'singhgk2202', 'joshtruswell', 'sams1714', 'noornia', 'joefitch', 'annafreya363', 'robwelsh', 'connor1996', 'andypocock34', 'alicemcook', 'w.attwood', 'saher19', 'betsy.cb23', 'nashio', 'samburton93', 'blueribena3', 'dimpypandya18', 'jjmartin', 'kglynn95', 'andrewkearns', 'pringlecode', 'hollyabell', 'danielhewes1996', 'hkww2006', 'missgraciabahati', 'arthur140', 'michael_nguyen123', 'sethings', 'lm1zra', 'shila.sultana', 'matthew1.odoherty', 'j.seymour1994', 'ramzdog', 'joshwilliamrobinson', 'liam2501', 'rose.b5', 'ksim634', 'zg011124', 'humaira94', 'qwertyuiopzxcvbnm', 'cib123', 'czeleny', 'roisinhazell', 'lbtaye', 'rkas', 'thomjenns', 'mask93', 'rachelmclaren', 'qw003594', 'dc011158', 'heikearnolds', 'ryan.duplock', 'gracevarughese95', 'matthew.edwards040506', 'matt.hagreen', 'fsmall', None, 'jarlan', 'josephbrehm', 'shreya.mashru', 'austing96', 'miccos14', 'greeneey1', 'bilalhassan142004', 'robmaidment', 'aemelia1', 'gn009686', 'hannah.leggatt', 'adowning']"
8,182,74,8,6,"['michaelwall', 'zh014259', 'robmaidment', 'aemelia1', 'ksim634', 'saher19']",67,"['elenageorgiou', 'cameron001374', 'luke.maestro', 'chris2dyt', 'chemiati', 'singhgk2202', 'joshtruswell', 'sams1714', 'noornia', 'joefitch', 'annafreya363', 'robwelsh', 'connor1996', 'alicemcook', 'w.attwood', 'betsy.cb23', 'nashio', 'samburton93', 'blueribena3', 'dimpypandya18', 'jjmartin', 'kglynn95', 'andrewkearns', 'pringlecode', 'hollyabell', 'danielhewes1996', 'hkww2006', 'missgraciabahati', 'arthur140', 'michael_nguyen123', 'sethings', 'lm1zra', 'shila.sultana', 'matthew1.odoherty', 'j.seymour1994', 'ramzdog', 'joshwilliamrobinson', 'liam2501', 'rose.b5', 'zg011124', 'humaira94', 'qwertyuiopzxcvbnm', 'cib123', 'czeleny', 'roisinhazell', 'lbtaye', 'rkas', 'thomjenns', 'mask93', 'rachelmclaren', 'qw003594', 'dc011158', 'heikearnolds', 'ryan.duplock', 'gracevarughese95', 'matthew.edwards040506', 'matt.hagreen', 'fsmall', 'jarlan', 'josephbrehm', 'shreya.mashru', 'austing96', 'miccos14', 'greeneey1', 'bilalhassan142004', 'gn009686', 'adowning']",2,"[None, 'andypocock34']",75,"['elenageorgiou', 'cameron001374', 'luke.maestro', 'michaelwall', 'zh014259', 'chris2dyt', 'chemiati', 'singhgk2202', 'joshtruswell', 'sams1714', 'noornia', 'joefitch', 'annafreya363', 'robwelsh', 'connor1996', 'andypocock34', 'alicemcook', 'w.attwood', 'saher19', 'betsy.cb23', 'nashio', 'samburton93', 'blueribena3', 'dimpypandya18', 'jjmartin', 'kglynn95', 'andrewkearns', 'pringlecode', 'hollyabell', 'danielhewes1996', 'hkww2006', 'missgraciabahati', 'arthur140', 'michael_nguyen123', 'sethings', 'lm1zra', 'shila.sultana', 'matthew1.odoherty', 'j.seymour1994', 'ramzdog', 'joshwilliamrobinson', 'liam2501', 'rose.b5', 'ksim634', 'zg011124', 'humaira94', 'qwertyuiopzxcvbnm', 'cib123', 'czeleny', 'roisinhazell', 'lbtaye', 'rkas', 'thomjenns', 'mask93', 'rachelmclaren', 'qw003594', 'dc011158', 'heikearnolds', 'ryan.duplock', 'gracevarughese95', 'matthew.edwards040506', 'matt.hagreen', 'fsmall', None, 'jarlan', 'josephbrehm', 'shreya.mashru', 'austing96', 'miccos14', 'greeneey1', 'bilalhassan142004', 'robmaidment', 'aemelia1', 'gn009686', 'adowning']"
8,181,74,7,6,"['qwertyuiopzxcvbnm', 'samburton93', 'missgraciabahati', 'j.seymour1994', 'w.attwood', 'hollyabell']",67,"['elenageorgiou', 'cameron001374', 'luke.maestro', 'michaelwall', 'zh014259', 'chris2dyt', 'chemiati', 'singhgk2202', 'joshtruswell', 'sams1714', 'noornia', 'joefitch', 'annafreya363', 'robwelsh', 'connor1996', 'alicemcook', 'saher19', 'betsy.cb23', 'nashio', 'blueribena3', 'dimpypandya18', 'jjmartin', 'kglynn95', 'andrewkearns', 'pringlecode', 'danielhewes1996', 'hkww2006', 'arthur140', 'michael_nguyen123', 'sethings', 'lm1zra', 'shila.sultana', 'matthew1.odoherty', 'ramzdog', 'joshwilliamrobinson', 'liam2501', 'rose.b5', 'ksim634', 'zg011124', 'humaira94', 'cib123', 'czeleny', 'roisinhazell', 'lbtaye', 'rkas', 'thomjenns', 'mask93', 'rachelmclaren', 'qw003594', 'dc011158', 'heikearnolds', 'ryan.duplock', 'gracevarughese95', 'matthew.edwards040506', 'matt.hagreen', 'fsmall', 'jarlan', 'josephbrehm', 'shreya.mashru', 'austing96', 'miccos14', 'greeneey1', 'bilalhassan142004', 'robmaidment', 'aemelia1', 'gn009686', 'adowning']",1,[None],74,"['elenageorgiou', 'cameron001374', 'luke.maestro', 'michaelwall', 'zh014259', 'chris2dyt', 'chemiati', 'singhgk2202', 'joshtruswell', 'sams1714', 'noornia', 'joefitch', 'annafreya363', 'robwelsh', 'connor1996', 'alicemcook', 'w.attwood', 'saher19', 'betsy.cb23', 'nashio', 'samburton93', 'blueribena3', 'dimpypandya18', 'jjmartin', 'kglynn95', 'andrewkearns', 'pringlecode', 'hollyabell', 'danielhewes1996', 'hkww2006', 'missgraciabahati', 'arthur140', 'michael_nguyen123', 'sethings', 'lm1zra', 'shila.sultana', 'matthew1.odoherty', 'j.seymour1994', 'ramzdog', 'joshwilliamrobinson', 'liam2501', 'rose.b5', 'ksim634', 'zg011124', 'humaira94', 'qwertyuiopzxcvbnm', 'cib123', 'czeleny', 'roisinhazell', 'lbtaye', 'rkas', 'thomjenns', 'mask93', 'rachelmclaren', 'qw003594', 'dc011158', 'heikearnolds', 'ryan.duplock', 'gracevarughese95', 'matthew.edwards040506', 'matt.hagreen', 'fsmall', None, 'jarlan', 'josephbrehm', 'shreya.mashru', 'austing96', 'miccos14', 'greeneey1', 'bilalhassan142004', 'robmaidment', 'aemelia1', 'gn009686', 'adowning']"
9,183,69,100,60,"['cnlopes12', 'sali12', 'buhl2', 'knipfer2', 'ecyoung', 'asimha2', 'dpfoste2', 'sdschmi2', 'reisber2', 'vasyltheonly', 'dshi10', 'ahjames2', 'aln', 'mchu5', 'zhensun5', 'pakelti2', 'ed.tir.1', 'mcheng94', 'ywada3', 'hhardin2', 'zwu27', 'laurentaylor', 'shoppe3', 'alvinlvalysa', 'brgschn2', 'jbeta95', 'cwojtan', 'jaikarnik95', 'statar2', 'tianshu2', 'dsch33', 'slbecke2', 'sloneil21994', 'amango4', 'yifanyao', 'whu14', 'junehan1', 'jxiong7', 'echo93924', 'dli29', 'mpunuk', 'mingye.gao', 'hwang281', 'chunxu2', 'jedrals2', 'mantianxue0101', 'billli1996', 'ntxuby', 'dkuai2', 'warpins2', 'qinglin2', 'joylin0806', 'mbmoy2', 'lin.joanna.y', 'jdray2', 'sikaufm2', 'ruining2', 'avelard2', 'jkim561', 'nlee17']",8,"['17staru', 'sshan362', 'sdhanak1', 'rmaass', 'szhang87', 'mlandi6', 'cglasgo2', 'fangguanhua2013']",40,"['lachwsk2', 'liupufan', 'melissagoetter', 'shenxinrusue', 'pjnick300', 'dlitt2', 'brendaneng1', 'halstar9', 'ruining22', 'slipperyjack007', 'jefrin', 'wosabi95', 'kagebei2', 'zhensun_5', 'crosent2', 'eaallen', 'gracepakeltis', 'elindgren', 'bacchanalianomark', 'charmisuk', 'yliu181', 'dman5505', 'zuojulia', 'werkkdy2', 'emfoley14', 'dianeluvsart', None, 'jacobcamp1', 'zshen15', 'sniperzx13', 'antony.huang.129', 'samsrajer', 'yyao13', 'sho1123', 'carolgu', 'mmkurth2', 'adbrown3', 'rishychacko', 'fpkelly2', 'zhoffm']",108,"['sali12', 'buhl2', 'knipfer2', 'dlitt2', 'reisber2', 'brendaneng1', 'pakelti2', 'halstar9', 'ruining22', 'wosabi95', 'sshan362', 'hhardin2', 'shoppe3', 'gracepakeltis', 'jaikarnik95', 'tianshu2', 'zuojulia', 'junehan1', 'werkkdy2', 'jxiong7', 'dianeluvsart', 'dkuai2', 'warpins2', 'samsrajer', 'jdray2', 'avelard2', 'fpkelly2', 'lachwsk2', 'dpfoste2', 'dshi10', 'mchu5', 'zhensun5', 'aln', 'crosent2', 'mlandi6', 'fangguanhua2013', 'statar2', 'dman5505', 'sloneil21994', 'amango4', 'yifanyao', 'dli29', 'jacobcamp1', 'sniperzx13', 'antony.huang.129', 'mbmoy2', 'yyao13', 'sho1123', 'lin.joanna.y', 'ruining2', 'kagebei2', 'nlee17', 'rmaass', 'zhoffm', 'cnlopes12', 'liupufan', 'ecyoung', 'asimha2', 'szhang87', 'ahjames2', 'ed.tir.1', 'jefrin', 'zhensun_5', 'eaallen', 'alvinlvalysa', 'brgschn2', 'jbeta95', 'elindgren', 'charmisuk', 'yliu181', 'sdhanak1', 'whu14', 'mpunuk', 'mingye.gao', 'hwang281', 'cglasgo2', 'jedrals2', 'mantianxue0101', 'zshen15', 'qinglin2', 'carolgu', 'rishychacko', 'dsch33', 'melissagoetter', 'shenxinrusue', 'pjnick300', 'sdschmi2', 'vasyltheonly', 'slipperyjack007', '17staru', 'mcheng94', 'ywada3', 'zwu27', 'laurentaylor', 'cwojtan', 'bacchanalianomark', 'slbecke2', 'echo93924', 'chunxu2', 'emfoley14', None, 'billli1996', 'ntxuby', 'joylin0806', 'mmkurth2', 'sikaufm2', 'adbrown3', 'jkim561']"
9,185,69,92,65,"['cnlopes12', 'sali12', 'buhl2', 'knipfer2', 'ecyoung', 'asimha2', 'dpfoste2', 'sdschmi2', 'reisber2', 'szhang87', 'vasyltheonly', 'dshi10', 'ahjames2', 'aln', 'mchu5', 'zhensun5', 'pakelti2', 'ed.tir.1', '17staru', 'mcheng94', 'ywada3', 'hhardin2', 'zwu27', 'laurentaylor', 'shoppe3', 'mlandi6', 'alvinlvalysa', 'brgschn2', 'jbeta95', 'cwojtan', 'jaikarnik95', 'statar2', 'tianshu2', 'dsch33', 'slbecke2', 'sdhanak1', 'sloneil21994', 'amango4', 'yifanyao', 'whu14', 'junehan1', 'jxiong7', 'echo93924', 'dli29', 'mpunuk', 'mingye.gao', 'hwang281', 'chunxu2', 'jedrals2', 'mantianxue0101', 'billli1996', 'ntxuby', 'dkuai2', 'warpins2', 'qinglin2', 'joylin0806', 'mbmoy2', 'lin.joanna.y', 'jdray2', 'sikaufm2', 'ruining2', 'avelard2', 'jkim561', 'nlee17', 'rmaass']",3,"['sshan362', 'cglasgo2', 'fangguanhua2013']",27,"['fpkelly2', 'lachwsk2', 'melissagoetter', 'a_kuzni2', 'dlitt2', 'liuyuting1006', 'eswu2', 'julia.zuo', 'brendaneng1', 'ewe2', 'hsp6634', 'jefrin', 'edeutsch90', 'ramansbach', 'hzhou30', 'shamaleeg1', 'werkkdy2', 'emfoley14', 'elindgr2', None, 'zhan.shi.106', 'antony.huang.129', 'samsrajer', 'shoughton625', 'kagebei2', 'ndunlap2', 'zhoffm']",95,"['sali12', 'buhl2', 'knipfer2', 'dlitt2', 'reisber2', 'eswu2', 'brendaneng1', 'ewe2', 'pakelti2', 'sshan362', 'hhardin2', 'shoppe3', 'jaikarnik95', 'tianshu2', 'shamaleeg1', 'junehan1', 'werkkdy2', 'jxiong7', 'elindgr2', 'dkuai2', 'warpins2', 'samsrajer', 'jdray2', 'avelard2', 'shoughton625', 'fpkelly2', 'ndunlap2', 'lachwsk2', 'dpfoste2', 'liuyuting1006', 'dshi10', 'mchu5', 'zhensun5', 'aln', 'hsp6634', 'edeutsch90', 'mlandi6', 'fangguanhua2013', 'statar2', 'sloneil21994', 'amango4', 'yifanyao', 'dli29', 'antony.huang.129', 'mbmoy2', 'lin.joanna.y', 'ruining2', 'kagebei2', 'nlee17', 'rmaass', 'zhoffm', 'cnlopes12', 'ecyoung', 'asimha2', 'szhang87', 'ahjames2', 'julia.zuo', 'ed.tir.1', 'jefrin', 'alvinlvalysa', 'brgschn2', 'jbeta95', 'hzhou30', 'sdhanak1', 'whu14', 'mpunuk', 'mingye.gao', 'hwang281', 'cglasgo2', 'jedrals2', 'mantianxue0101', 'qinglin2', 'dsch33', 'melissagoetter', 'a_kuzni2', 'sdschmi2', 'vasyltheonly', '17staru', 'mcheng94', 'ywada3', 'zwu27', 'laurentaylor', 'ramansbach', 'cwojtan', 'slbecke2', 'echo93924', 'chunxu2', 'emfoley14', None, 'zhan.shi.106', 'billli1996', 'ntxuby', 'joylin0806', 'sikaufm2', 'jkim561']"
10,2,57,127,16,"['saisatwickyadav', 'dpl', 'anoopreddy1993', 'shreeyash', 'satyen1401', 'anoopreddy1992', 'trinath90', 'satish6688', 'rzaragoza91', 'aru1204', 'jpangan', 'kavyadhanala567', 'mohammed18', 'mallesh2890', 'priyankareddy', 'sandychinna90']",40,"['sunjeet95', 'mschalken', 'jellis', 'ajayvishy', 'threem', 'gmooney', 'theharshit', 'robin.hw.wang', 'wlawrie', 'jtmailed', 'sgajare', 'aragorn.hb', 'pishvaei', 'slillie', 'justdalia', 'tsaia', 'javiermeronpino', 'kirsams', 'wfulgenzi', 'harishreddynn4', 'sbprasad2112', 'tisilverit', 'jrklein', 'aquinobn', 'silicano', 'rdegille', 'amalkaba', 'poyanimehta92', 'rohin', 'deepu.patel092', 'furqanshaikh', 'dhanu2k13', 'gawalirohit25', 'siddharth_gupta', 'wessam.badr', 'madhavip516', 'shinigamiasuka', 'vzarinov', 'natalia_o', 'pottsy1994']",111,"['ravikiran19', 'mekalamanishyadav', 'ramisetty12', 'p.rathod', 'manojbukka', 'shilpa1992', 'swetang22', 'nicoramirez', 'sandeepx99', 'jayakrishna440', 'mit1993', 'sunil2308', 'mturi', 'sanjaymenaria', 'pavan.malay', 'namratha.siddappa', 'kajal', 'narapa', 'kishan7172', 'christxran', 'parikhchirag29', 'chandusravanthi', 'saladi0293', 'shobhavaddineni', 'nagasai', 'mvenu2', 'pavan51', 'sathiriv', 'himali_dhaduk2493', 'santhoshnn134', 'muralisaiavinash', 'jzherrera', 'santhosh.y', 'makwanasameer007', 'mani477', 'meen83', 'patel.akash102', 'jrriddley1355', 'rathodpriyank', 'poyani_mehta', 'dhruvil', 'deepakengineer', 'kashyap09ec71', 'pallugullu', 'nikhilshinde', 'kruthiperumalla', 'muralikrishna41', 'kevinharish40', 'fardad.falahati', 'yaminikrishna', 'teju2710', 'perumallakavya', 'loveena1902', 'manojtalluri.93', 'dharanidar123', 'vanimerugu', 'anish69052', 'kszumowski', 'maheshedururi', 'nawaz316', 'aartipatel', 'swetang1992', 'manalipatel', 'ya9mehta', 'haritha93', 'sachitanandraj', 'georgeayoub11', 'tejasri13293', '802769935jj', 'furquan', 'kavya.dhanala', 'rahulenukonda525', 'nishat1801', 'rakeshyadav', 'kancharla0113', 'kushalvasoya558', 'eedupuganti07', 'suneel8055', 'dipali.shatavara', 'reetu0610', 'james54', 'sha6070sha', 'ritvik03', 'teja999', 'dhanala.kavya123', 'anveshkankanala', 'parita11', 'veeru', 'harshpathak', 'kunda93', 'harshavardhanvarmavegesna', 'pritipatel59', 'venkateah', 'akshaya1512', 'slim.severnick', 'poojatrivedi', 'trodas1287', 'hem.metalia', 'binayb175', 'rawadhilal', 'purna24', 'dipal.ptl', None, 'pallavi90', 'bansari21', 'deeppatel092', 'nvnreddy418', 'nikhila_banda', 'marneni01', 'chinthalapally13', 'kavyathokala']",167,"['mschalken', 'ravikiran19', 'ajayvishy', 'theharshit', 'ramisetty12', 'mekalamanishyadav', 'p.rathod', 'manojbukka', 'saisatwickyadav', 'shilpa1992', 'swetang22', 'nicoramirez', 'shreeyash', 'sandeepx99', 'tsaia', 'jayakrishna440', 'mit1993', 'sunil2308', 'mturi', 'sanjaymenaria', 'pavan.malay', 'namratha.siddappa', 'kajal', 'narapa', 'kishan7172', 'christxran', 'dhanu2k13', 'parikhchirag29', 'siddharth_gupta', 'chandusravanthi', 'saladi0293', 'shobhavaddineni', 'nagasai', 'mvenu2', 'shinigamiasuka', 'vzarinov', 'pottsy1994', 'anoopreddy1993', 'pavan51', 'sathiriv', 'himali_dhaduk2493', 'aru1204', 'threem', 'gmooney', 'santhoshnn134', 'jtmailed', 'aragorn.hb', 'sgajare', 'muralisaiavinash', 'jzherrera', 'slillie', 'justdalia', 'santhosh.y', 'makwanasameer007', 'mani477', 'meen83', 'tisilverit', 'patel.akash102', 'jrklein', 'silicano', 'jrriddley1355', 'rdegille', 'rathodpriyank', 'poyani_mehta', 'dhruvil', 'rohin', 'deepakengineer', 'kashyap09ec71', 'pallugullu', 'nikhilshinde', 'kruthiperumalla', 'madhavip516', 'muralikrishna41', 'natalia_o', 'kevinharish40', 'fardad.falahati', 'yaminikrishna', 'anoopreddy1992', 'teju2710', 'dpl', 'loveena1902', 'manojtalluri.93', 'perumallakavya', 'trinath90', 'jellis', 'dharanidar123', 'vanimerugu', 'anish69052', 'kszumowski', 'maheshedururi', 'sandychinna90', 'nawaz316', 'aartipatel', 'pishvaei', 'swetang1992', 'manalipatel', 'ya9mehta', 'jpangan', 'haritha93', 'wfulgenzi', 'sachitanandraj', 'georgeayoub11', 'mallesh2890', 'satish6688', 'tejasri13293', '802769935jj', 'satyen1401', 'deepu.patel092', 'furquan', 'mohammed18', 'gawalirohit25', 'kavya.dhanala', 'rahulenukonda525', 'nishat1801', 'rakeshyadav', 'kancharla0113', 'kushalvasoya558', 'eedupuganti07', 'rzaragoza91', 'suneel8055', 'dipali.shatavara', 'reetu0610', 'sunjeet95', 'james54', 'sha6070sha', 'ritvik03', 'teja999', 'dhanala.kavya123', 'anveshkankanala', 'parita11', 'kavyadhanala567', 'robin.hw.wang', 'priyankareddy', 'wlawrie', 'veeru', 'harshpathak', 'kunda93', 'harshavardhanvarmavegesna', 'pritipatel59', 'venkateah', 'akshaya1512', 'javiermeronpino', 'kirsams', 'harishreddynn4', 'slim.severnick', 'sbprasad2112', 'poojatrivedi', 'trodas1287', 'aquinobn', 'hem.metalia', 'binayb175', 'amalkaba', 'rawadhilal', 'poyanimehta92', 'furqanshaikh', 'purna24', 'dipal.ptl', None, 'wessam.badr', 'pallavi90', 'bansari21', 'deeppatel092', 'nvnreddy418', 'nikhila_banda', 'marneni01', 'chinthalapally13', 'kavyathokala']"
10,3,57,113,10,"['saisatwickyadav', 'shreeyash', 'trinath90', 'satish6688', 'rzaragoza91', 'poyanimehta92', 'deepu.patel092', 'jpangan', 'mallesh2890', 'priyankareddy']",46,"['sunjeet95', 'dpl', 'mschalken', 'jellis', 'ajayvishy', 'aru1204', 'threem', 'kavyadhanala567', 'gmooney', 'theharshit', 'robin.hw.wang', 'wlawrie', 'jtmailed', 'aragorn.hb', 'sgajare', 'sandychinna90', 'pishvaei', 'slillie', 'justdalia', 'tsaia', 'javiermeronpino', 'kirsams', 'wfulgenzi', 'harishreddynn4', 'sbprasad2112', 'tisilverit', 'jrklein', 'aquinobn', 'silicano', 'rdegille', 'satyen1401', 'amalkaba', 'rohin', 'furqanshaikh', 'dhanu2k13', 'mohammed18', 'gawalirohit25', 'siddharth_gupta', 'wessam.badr', 'madhavip516', 'shinigamiasuka', 'vzarinov', 'natalia_o', 'pottsy1994', 'anoopreddy1992', 'anoopreddy1993']",103,"['ravikiran19', 'p.rathod', 'manojbukka', 'shilpa1992', 'swetang22', 'nicoramirez', 'sandeepx99', 'jayakrishna440', 'mit1993', 'sunil2308', 'mturi', 'sanjaymenaria', 'pavan.malay', 'namratha.siddappa', 'kajal', 'narapa', 'kishan7172', 'christxran', 'parikhchirag29', 'shobhavaddineni', 'saladi0293', 'nagasai', 'mvenu2', 'sathiriv', 'himali_dhaduk2493', 'santhoshnn134', 'mpangan1128', 'muralisaiavinash', 'jzherrera', 'makwanasameer007', 'mani477', 'meen83', 'patel.akash102', 'jrriddley1355', 'rathodpriyank', 'poyani_mehta', 'dhruvil', 'deepakengineer', 'kashyap09ec71', 'pallugullu', 'nikhilshinde', 'kruthiperumalla', 'thedmutz24', 'kevinharish40', 'fardad.falahati', 'yaminikrishna', 'teju2710', 'perumallakavya', 'loveena1902', 'manojtalluri.93', 'dharanidar123', 'vanimerugu', 'kszumowski', 'maheshedururi', 'nawaz316', 'aartipatel', 'swetang1992', 'manalipatel', 'ya9mehta', 'haritha93', 'sachitanandraj', 'georgeayoub11', 'pallavivenkatesh', '802769935jj', 'furquan', 'anoop1992', 'kavya.dhanala', 'rahulenukonda525', 'nishat1801', 'rakeshyadav', 'kancharla0113', 'kushalvasoya558', 'eedupuganti07', 'dipali.shatavara', 'reetu0610', 'james54', 'sha6070sha', 'ritvik03', 'teja999', 'pritipatel', 'anveshkankanala', 'veeru', 'kunda93', 'harshavardhanvarmavegesna', 'pritipatel59', 'venkateah', 'akshaya1512', 'poojatrivedi', 'trodas1287', 'hem.metalia', 'binayb175', 'rawadhilal', 'purna24', 'shreeyash6', None, 'pallavi90', 'bansari21', 'deeppatel092', 'nvnreddy418', 'nikhila_banda', 'marneni01', 'chinthalapally13', 'kavyathokala']",159,"['mschalken', 'ravikiran19', 'ajayvishy', 'theharshit', 'p.rathod', 'manojbukka', 'saisatwickyadav', 'shilpa1992', 'swetang22', 'nicoramirez', 'shreeyash', 'sandeepx99', 'tsaia', 'jayakrishna440', 'mit1993', 'sunil2308', 'mturi', 'sanjaymenaria', 'pavan.malay', 'namratha.siddappa', 'kajal', 'narapa', 'kishan7172', 'christxran', 'dhanu2k13', 'parikhchirag29', 'siddharth_gupta', 'shobhavaddineni', 'saladi0293', 'nagasai', 'mvenu2', 'shinigamiasuka', 'vzarinov', 'pottsy1994', 'anoopreddy1993', 'sathiriv', 'himali_dhaduk2493', 'aru1204', 'threem', 'gmooney', 'santhoshnn134', 'jtmailed', 'aragorn.hb', 'sgajare', 'mpangan1128', 'muralisaiavinash', 'jzherrera', 'slillie', 'justdalia', 'makwanasameer007', 'mani477', 'meen83', 'tisilverit', 'patel.akash102', 'jrklein', 'silicano', 'jrriddley1355', 'rdegille', 'rathodpriyank', 'poyani_mehta', 'dhruvil', 'rohin', 'deepakengineer', 'kashyap09ec71', 'pallugullu', 'nikhilshinde', 'kruthiperumalla', 'madhavip516', 'natalia_o', 'thedmutz24', 'kevinharish40', 'fardad.falahati', 'yaminikrishna', 'anoopreddy1992', 'teju2710', 'dpl', 'perumallakavya', 'loveena1902', 'manojtalluri.93', 'trinath90', 'jellis', 'dharanidar123', 'vanimerugu', 'kszumowski', 'maheshedururi', 'sandychinna90', 'nawaz316', 'aartipatel', 'pishvaei', 'swetang1992', 'manalipatel', 'ya9mehta', 'jpangan', 'haritha93', 'wfulgenzi', 'sachitanandraj', 'georgeayoub11', 'mallesh2890', 'satish6688', 'pallavivenkatesh', '802769935jj', 'satyen1401', 'deepu.patel092', 'furquan', 'mohammed18', 'gawalirohit25', 'anoop1992', 'kavya.dhanala', 'rahulenukonda525', 'nishat1801', 'rakeshyadav', 'kancharla0113', 'kushalvasoya558', 'eedupuganti07', 'rzaragoza91', 'dipali.shatavara', 'reetu0610', 'sunjeet95', 'james54', 'sha6070sha', 'ritvik03', 'teja999', 'pritipatel', 'anveshkankanala', 'kavyadhanala567', 'robin.hw.wang', 'priyankareddy', 'wlawrie', 'veeru', 'kunda93', 'harshavardhanvarmavegesna', 'pritipatel59', 'venkateah', 'akshaya1512', 'javiermeronpino', 'kirsams', 'harishreddynn4', 'sbprasad2112', 'poojatrivedi', 'trodas1287', 'aquinobn', 'hem.metalia', 'binayb175', 'amalkaba', 'rawadhilal', 'poyanimehta92', 'furqanshaikh', 'purna24', 'shreeyash6', None, 'wessam.badr', 'pallavi90', 'bansari21', 'deeppatel092', 'nvnreddy418', 'nikhila_banda', 'marneni01', 'chinthalapally13', 'kavyathokala']"
10,8,57,61,2,"['threem', 'justdalia']",54,"['sunjeet95', 'dpl', 'mschalken', 'trinath90', 'jellis', 'ajayvishy', 'aru1204', 'kavyadhanala567', 'gmooney', 'theharshit', 'robin.hw.wang', 'priyankareddy', 'wlawrie', 'jtmailed', 'sandychinna90', 'aragorn.hb', 'saisatwickyadav', 'sgajare', 'pishvaei', 'shreeyash', 'slillie', 'tsaia', 'anoopreddy1992', 'javiermeronpino', 'jpangan', 'kirsams', 'wfulgenzi', 'harishreddynn4', 'sbprasad2112', 'mallesh2890', 'tisilverit', 'satish6688', 'jrklein', 'aquinobn', 'silicano', 'rdegille', 'satyen1401', 'amalkaba', 'poyanimehta92', 'rohin', 'deepu.patel092', 'furqanshaikh', 'dhanu2k13', 'mohammed18', 'gawalirohit25', 'siddharth_gupta', 'wessam.badr', 'madhavip516', 'shinigamiasuka', 'vzarinov', 'natalia_o', 'pottsy1994', 'rzaragoza91', 'anoopreddy1993']",59,"['dinawalid95', 'hisham', 'ayaaa.f.a', 'mnaguib345', 'elec.eng.heba', 'aa.maherr', 'mhakmd', 'kholoud.ayman', 'omarkhaledh95', 'mahmoudyoussif95', 'omar.abdulaziz94', 'engmahmoud', 'ahmed_gamal1401', 'tuliphany', 'anwar.alkallas', 'nadowafa20', 'kirollos_ernest', 'shorta', 'mh009966', 'm.fouad.allam', 'muhammadatef100', 'nourhanmohamed', 'geme3600', 'shadyreda', 'a7medelhelaly', 'fatma.mouawad', 'mohamedaymanabdelsatar', 'fatma_batota', 'aymanalaadin4', 'shorrrta', 'rebo14101995', 'omar_moataz13', 'dondonetoiseau', 'merna.salahh', 'mernaroshdy95', 'mohmed_rf', 'david.farag', 'eng.aalaa50', 'tarekali1000', 'amrmeto', 'amedo_emad', 'michaelhany33', None, 'mina', 'michael_riad', 'rimoz95', 'sossa', 'besesh55', 'saraalaa', 'waleedsmz94', 'ibrahimelsayed999', 'mina_mwgs', 'totti', 'hoda_morshed375', 'wissamismailgp7', 'mahmoudsaid471', 'yomnamahmoud7', 'amrmohamedreda94', 'amr_m.attya']",115,"['dpl', 'mschalken', 'trinath90', 'jellis', 'ajayvishy', 'ayaaa.f.a', 'theharshit', 'aa.maherr', 'mhakmd', 'kholoud.ayman', 'omarkhaledh95', 'sandychinna90', 'saisatwickyadav', 'pishvaei', 'ahmed_gamal1401', 'shreeyash', 'tsaia', 'kirollos_ernest', 'jpangan', 'wfulgenzi', 'm.fouad.allam', 'mallesh2890', 'satish6688', 'muhammadatef100', 'nourhanmohamed', 'shadyreda', 'satyen1401', 'aymanalaadin4', 'omar_moataz13', 'rebo14101995', 'dondonetoiseau', 'mohmed_rf', 'merna.salahh', 'deepu.patel092', 'dhanu2k13', 'mohammed18', 'gawalirohit25', 'siddharth_gupta', 'mina', 'michael_riad', 'shinigamiasuka', 'vzarinov', 'pottsy1994', 'besesh55', 'saraalaa', 'waleedsmz94', 'ibrahimelsayed999', 'mina_mwgs', 'totti', 'hoda_morshed375', 'wissamismailgp7', 'rzaragoza91', 'anoopreddy1993', 'sunjeet95', 'dinawalid95', 'hisham', 'aru1204', 'threem', 'mnaguib345', 'kavyadhanala567', 'gmooney', 'elec.eng.heba', 'robin.hw.wang', 'priyankareddy', 'wlawrie', 'jtmailed', 'aragorn.hb', 'sgajare', 'mahmoudyoussif95', 'omar.abdulaziz94', 'engmahmoud', 'tuliphany', 'slillie', 'justdalia', 'anwar.alkallas', 'nadowafa20', 'javiermeronpino', 'shorta', 'kirsams', 'harishreddynn4', 'mh009966', 'sbprasad2112', 'tisilverit', 'jrklein', 'aquinobn', 'silicano', 'geme3600', 'rdegille', 'a7medelhelaly', 'fatma.mouawad', 'mohamedaymanabdelsatar', 'fatma_batota', 'shorrrta', 'amalkaba', 'poyanimehta92', 'mernaroshdy95', 'rohin', 'furqanshaikh', 'david.farag', 'eng.aalaa50', 'tarekali1000', 'amrmeto', 'amedo_emad', 'michaelhany33', None, 'wessam.badr', 'madhavip516', 'rimoz95', 'sossa', 'natalia_o', 'mahmoudsaid471', 'anoopreddy1992', 'yomnamahmoud7', 'amrmohamedreda94', 'amr_m.attya']"
10,119,57,22,1,['trinath90'],55,"['sunjeet95', 'dpl', 'mschalken', 'jellis', 'ajayvishy', 'aru1204', 'threem', 'kavyadhanala567', 'gmooney', 'theharshit', 'robin.hw.wang', 'priyankareddy', 'wlawrie', 'jtmailed', 'sandychinna90', 'aragorn.hb', 'saisatwickyadav', 'sgajare', 'pishvaei', 'shreeyash', 'slillie', 'justdalia', 'tsaia', 'anoopreddy1992', 'javiermeronpino', 'jpangan', 'kirsams', 'wfulgenzi', 'harishreddynn4', 'sbprasad2112', 'mallesh2890', 'tisilverit', 'satish6688', 'jrklein', 'aquinobn', 'silicano', 'rdegille', 'satyen1401', 'amalkaba', 'poyanimehta92', 'rohin', 'deepu.patel092', 'furqanshaikh', 'dhanu2k13', 'mohammed18', 'gawalirohit25', 'siddharth_gupta', 'wessam.badr', 'madhavip516', 'shinigamiasuka', 'vzarinov', 'natalia_o', 'pottsy1994', 'rzaragoza91', 'anoopreddy1993']",21,"['pavan51', 'loveena1902', 'teja999', 'veeru', 'shilpa1992', 'aartipatel', 'venkateah', 'meen83', 'binayb175', 'namratha.siddappa', 'poyani_mehta', None, 'pallugullu', 'pallavi90', 'nagasai', 'bansari21', 'kancharla0113', 'marneni01', 'teju2710', 'rtvgs999', 'reetu0610']",77,"['dpl', 'mschalken', 'loveena1902', 'trinath90', 'jellis', 'ajayvishy', 'theharshit', 'sandychinna90', 'saisatwickyadav', 'shilpa1992', 'pishvaei', 'aartipatel', 'shreeyash', 'tsaia', 'jpangan', 'wfulgenzi', 'mallesh2890', 'satish6688', 'namratha.siddappa', 'satyen1401', 'deepu.patel092', 'dhanu2k13', 'mohammed18', 'gawalirohit25', 'siddharth_gupta', 'nagasai', 'shinigamiasuka', 'vzarinov', 'pottsy1994', 'kancharla0113', 'rzaragoza91', 'rtvgs999', 'anoopreddy1993', 'reetu0610', 'sunjeet95', 'pavan51', 'teja999', 'aru1204', 'threem', 'kavyadhanala567', 'gmooney', 'robin.hw.wang', 'priyankareddy', 'wlawrie', 'jtmailed', 'veeru', 'aragorn.hb', 'sgajare', 'marneni01', 'slillie', 'justdalia', 'venkateah', 'javiermeronpino', 'kirsams', 'harishreddynn4', 'sbprasad2112', 'meen83', 'tisilverit', 'jrklein', 'aquinobn', 'silicano', 'binayb175', 'rdegille', 'poyani_mehta', 'amalkaba', 'poyanimehta92', 'rohin', 'furqanshaikh', None, 'wessam.badr', 'pallavi90', 'pallugullu', 'madhavip516', 'natalia_o', 'bansari21', 'anoopreddy1992', 'teju2710']"
10,12,57,20,1,['sgajare'],55,"['sunjeet95', 'dpl', 'mschalken', 'trinath90', 'jellis', 'ajayvishy', 'aru1204', 'threem', 'kavyadhanala567', 'gmooney', 'theharshit', 'robin.hw.wang', 'priyankareddy', 'wlawrie', 'jtmailed', 'sandychinna90', 'aragorn.hb', 'saisatwickyadav', 'pishvaei', 'shreeyash', 'slillie', 'justdalia', 'tsaia', 'anoopreddy1992', 'javiermeronpino', 'jpangan', 'kirsams', 'wfulgenzi', 'harishreddynn4', 'sbprasad2112', 'mallesh2890', 'tisilverit', 'satish6688', 'jrklein', 'aquinobn', 'silicano', 'rdegille', 'satyen1401', 'amalkaba', 'poyanimehta92', 'rohin', 'deepu.patel092', 'furqanshaikh', 'dhanu2k13', 'mohammed18', 'gawalirohit25', 'siddharth_gupta', 'wessam.badr', 'madhavip516', 'shinigamiasuka', 'vzarinov', 'natalia_o', 'pottsy1994', 'rzaragoza91', 'anoopreddy1993']",19,"['rmenon6', 'shivang.ghetia', 'houjingyi2015', 'jvanjari', 'zxiong5', 'shaikhsaif', 'siddheshgajare91', 'jcollie8', 'srishti.d19', 'tnietzol', 'jbai14', 'onedaymuer', 'yifuliu', 'ninad.chamele', 'djjohn22', None, 'jzuo5', 'nrm2194', 'harshjain2691']",75,"['rmenon6', 'sunjeet95', 'dpl', 'mschalken', 'shivang.ghetia', 'houjingyi2015', 'jvanjari', 'trinath90', 'jellis', 'ajayvishy', 'zxiong5', 'aru1204', 'threem', 'shaikhsaif', 'siddheshgajare91', 'kavyadhanala567', 'gmooney', 'theharshit', 'jcollie8', 'robin.hw.wang', 'priyankareddy', 'wlawrie', 'jtmailed', 'sandychinna90', 'aragorn.hb', 'saisatwickyadav', 'sgajare', 'pishvaei', 'shreeyash', 'slillie', 'justdalia', 'tsaia', 'javiermeronpino', 'rzaragoza91', 'jpangan', 'srishti.d19', 'kirsams', 'wfulgenzi', 'harishreddynn4', 'sbprasad2112', 'mallesh2890', 'tisilverit', 'satish6688', 'tnietzol', 'jbai14', 'onedaymuer', 'yifuliu', 'jrklein', 'aquinobn', 'silicano', 'rdegille', 'satyen1401', 'amalkaba', 'ninad.chamele', 'poyanimehta92', 'djjohn22', 'rohin', 'deepu.patel092', 'furqanshaikh', 'dhanu2k13', 'mohammed18', 'gawalirohit25', 'siddharth_gupta', None, 'jzuo5', 'wessam.badr', 'madhavip516', 'shinigamiasuka', 'vzarinov', 'natalia_o', 'pottsy1994', 'nrm2194', 'anoopreddy1992', 'harshjain2691', 'anoopreddy1993']"
10,5,57,17,13,"['jrklein', 'silicano', 'mschalken', 'slillie', 'pottsy1994', 'tsaia', 'jellis', 'wfulgenzi', 'gmooney', 'robin.hw.wang', 'wlawrie', 'jtmailed', 'wessam.badr']",43,"['sunjeet95', 'dpl', 'trinath90', 'ajayvishy', 'aru1204', 'threem', 'kavyadhanala567', 'theharshit', 'priyankareddy', 'aragorn.hb', 'sgajare', 'saisatwickyadav', 'sandychinna90', 'pishvaei', 'shreeyash', 'justdalia', 'anoopreddy1992', 'javiermeronpino', 'jpangan', 'kirsams', 'harishreddynn4', 'sbprasad2112', 'mallesh2890', 'tisilverit', 'satish6688', 'aquinobn', 'rdegille', 'satyen1401', 'amalkaba', 'poyanimehta92', 'rohin', 'deepu.patel092', 'furqanshaikh', 'dhanu2k13', 'mohammed18', 'gawalirohit25', 'siddharth_gupta', 'madhavip516', 'shinigamiasuka', 'vzarinov', 'natalia_o', 'rzaragoza91', 'anoopreddy1993']",4,"['jeffreym', 'ryantrevorah', None, 'hbowers']",60,"['sunjeet95', 'dpl', 'mschalken', 'trinath90', 'jellis', 'ajayvishy', 'aru1204', 'threem', 'kavyadhanala567', 'gmooney', 'theharshit', 'robin.hw.wang', 'priyankareddy', 'wlawrie', 'jtmailed', 'sandychinna90', 'aragorn.hb', 'saisatwickyadav', 'sgajare', 'pishvaei', 'hbowers', 'shreeyash', 'slillie', 'justdalia', 'tsaia', 'ryantrevorah', 'javiermeronpino', 'rzaragoza91', 'jpangan', 'kirsams', 'wfulgenzi', 'harishreddynn4', 'sbprasad2112', 'mallesh2890', 'tisilverit', 'satish6688', 'jrklein', 'aquinobn', 'silicano', 'rdegille', 'satyen1401', 'jeffreym', 'amalkaba', 'poyanimehta92', 'rohin', 'deepu.patel092', 'furqanshaikh', 'dhanu2k13', 'mohammed18', 'gawalirohit25', 'siddharth_gupta', None, 'wessam.badr', 'madhavip516', 'shinigamiasuka', 'vzarinov', 'natalia_o', 'pottsy1994', 'anoopreddy1992', 'anoopreddy1993']"
10,148,57,9,1,['satish6688'],55,"['sunjeet95', 'dpl', 'mschalken', 'trinath90', 'jellis', 'ajayvishy', 'aru1204', 'threem', 'kavyadhanala567', 'gmooney', 'theharshit', 'robin.hw.wang', 'priyankareddy', 'wlawrie', 'jtmailed', 'sandychinna90', 'aragorn.hb', 'saisatwickyadav', 'sgajare', 'pishvaei', 'shreeyash', 'slillie', 'justdalia', 'tsaia', 'javiermeronpino', 'rzaragoza91', 'jpangan', 'kirsams', 'wfulgenzi', 'harishreddynn4', 'sbprasad2112', 'mallesh2890', 'tisilverit', 'jrklein', 'aquinobn', 'silicano', 'rdegille', 'satyen1401', 'amalkaba', 'poyanimehta92', 'rohin', 'deepu.patel092', 'furqanshaikh', 'dhanu2k13', 'mohammed18', 'gawalirohit25', 'siddharth_gupta', 'wessam.badr', 'madhavip516', 'shinigamiasuka', 'vzarinov', 'natalia_o', 'pottsy1994', 'anoopreddy1992', 'anoopreddy1993']",8,"['802769935jj', 'swetang1992', 'nvnreddy418', 'kancharla0113', 'purna24', 'kushalvasoya558', 'chinthalapally13', None]",64,"['sunjeet95', 'dpl', 'mschalken', 'trinath90', 'jellis', 'ajayvishy', 'aru1204', 'threem', 'kavyadhanala567', 'gmooney', 'theharshit', 'robin.hw.wang', 'priyankareddy', 'wlawrie', 'jtmailed', 'sandychinna90', 'aragorn.hb', 'saisatwickyadav', 'sgajare', 'pishvaei', 'shreeyash', 'slillie', 'justdalia', 'tsaia', 'swetang1992', 'javiermeronpino', 'rzaragoza91', 'jpangan', 'kirsams', 'wfulgenzi', 'harishreddynn4', 'sbprasad2112', 'mallesh2890', 'tisilverit', 'satish6688', 'jrklein', 'aquinobn', 'silicano', '802769935jj', 'rdegille', 'satyen1401', 'amalkaba', 'poyanimehta92', 'rohin', 'deepu.patel092', 'furqanshaikh', 'purna24', 'dhanu2k13', 'mohammed18', 'gawalirohit25', 'siddharth_gupta', None, 'wessam.badr', 'madhavip516', 'shinigamiasuka', 'vzarinov', 'natalia_o', 'pottsy1994', 'nvnreddy418', 'kancharla0113', 'kushalvasoya558', 'anoopreddy1992', 'chinthalapally13', 'anoopreddy1993']"
10,149,57,9,2,"['satish6688', 'priyankareddy']",54,"['sunjeet95', 'dpl', 'mschalken', 'trinath90', 'jellis', 'ajayvishy', 'aru1204', 'threem', 'kavyadhanala567', 'gmooney', 'theharshit', 'robin.hw.wang', 'wlawrie', 'jtmailed', 'sandychinna90', 'aragorn.hb', 'saisatwickyadav', 'sgajare', 'pishvaei', 'shreeyash', 'slillie', 'justdalia', 'tsaia', 'javiermeronpino', 'rzaragoza91', 'jpangan', 'kirsams', 'wfulgenzi', 'harishreddynn4', 'sbprasad2112', 'mallesh2890', 'tisilverit', 'jrklein', 'aquinobn', 'silicano', 'rdegille', 'satyen1401', 'amalkaba', 'poyanimehta92', 'rohin', 'deepu.patel092', 'furqanshaikh', 'dhanu2k13', 'mohammed18', 'gawalirohit25', 'siddharth_gupta', 'wessam.badr', 'madhavip516', 'shinigamiasuka', 'vzarinov', 'natalia_o', 'pottsy1994', 'anoopreddy1992', 'anoopreddy1993']",7,"['802769935jj', 'swetang22', 'nvnreddy418', 'kushalvasoya558', None, 'pallugullu', 'reetu0610']",63,"['sunjeet95', 'dpl', 'mschalken', 'trinath90', 'jellis', 'ajayvishy', 'aru1204', 'threem', 'kavyadhanala567', 'gmooney', 'theharshit', 'robin.hw.wang', 'priyankareddy', 'wlawrie', 'jtmailed', 'sandychinna90', 'aragorn.hb', 'saisatwickyadav', 'sgajare', 'pishvaei', 'swetang22', 'shreeyash', 'slillie', 'justdalia', 'tsaia', 'javiermeronpino', 'rzaragoza91', 'jpangan', 'kirsams', 'wfulgenzi', 'harishreddynn4', 'sbprasad2112', 'reetu0610', 'mallesh2890', 'tisilverit', 'satish6688', 'jrklein', 'aquinobn', 'silicano', '802769935jj', 'rdegille', 'satyen1401', 'amalkaba', 'poyanimehta92', 'rohin', 'deepu.patel092', 'furqanshaikh', 'dhanu2k13', 'mohammed18', 'gawalirohit25', 'siddharth_gupta', None, 'wessam.badr', 'pallugullu', 'madhavip516', 'shinigamiasuka', 'vzarinov', 'natalia_o', 'pottsy1994', 'nvnreddy418', 'kushalvasoya558', 'anoopreddy1992', 'anoopreddy1993']"
10,9,57,8,1,['sgajare'],55,"['sunjeet95', 'dpl', 'mschalken', 'trinath90', 'jellis', 'ajayvishy', 'aru1204', 'threem', 'kavyadhanala567', 'gmooney', 'theharshit', 'robin.hw.wang', 'priyankareddy', 'wlawrie', 'jtmailed', 'sandychinna90', 'aragorn.hb', 'saisatwickyadav', 'pishvaei', 'shreeyash', 'slillie', 'justdalia', 'tsaia', 'javiermeronpino', 'rzaragoza91', 'jpangan', 'kirsams', 'wfulgenzi', 'harishreddynn4', 'sbprasad2112', 'mallesh2890', 'tisilverit', 'satish6688', 'jrklein', 'aquinobn', 'silicano', 'rdegille', 'satyen1401', 'amalkaba', 'poyanimehta92', 'rohin', 'deepu.patel092', 'furqanshaikh', 'dhanu2k13', 'mohammed18', 'gawalirohit25', 'siddharth_gupta', 'wessam.badr', 'madhavip516', 'shinigamiasuka', 'vzarinov', 'natalia_o', 'pottsy1994', 'anoopreddy1992', 'anoopreddy1993']",7,"['tmnietzold', 'jvanjari', 'ferry', 'jcollie8', 'tnietzol', None, 'harshjain2691']",63,"['sunjeet95', 'dpl', 'mschalken', 'jvanjari', 'trinath90', 'jellis', 'ajayvishy', 'aru1204', 'threem', 'jcollie8', 'kavyadhanala567', 'gmooney', 'theharshit', 'robin.hw.wang', 'priyankareddy', 'wlawrie', 'jtmailed', 'sandychinna90', 'aragorn.hb', 'saisatwickyadav', 'sgajare', 'pishvaei', 'shreeyash', 'slillie', 'justdalia', 'tsaia', 'javiermeronpino', 'rzaragoza91', 'jpangan', 'kirsams', 'wfulgenzi', 'harishreddynn4', 'sbprasad2112', 'mallesh2890', 'tisilverit', 'satish6688', 'tnietzol', 'jrklein', 'aquinobn', 'silicano', 'rdegille', 'satyen1401', 'amalkaba', 'ferry', 'poyanimehta92', 'rohin', 'deepu.patel092', 'furqanshaikh', 'dhanu2k13', 'mohammed18', 'gawalirohit25', 'siddharth_gupta', None, 'wessam.badr', 'madhavip516', 'shinigamiasuka', 'vzarinov', 'natalia_o', 'tmnietzold', 'pottsy1994', 'anoopreddy1992', 'harshjain2691', 'anoopreddy1993']"
11,38,53,176,2,"['kumar.amit156', 'stylechicanki']",50,"['tushardmaske', 'imushaikh007', 'rp92555', 'hegde.aniket94.ah', 'jyotibhosale8483', 'prasadbhujbal28', 'dal30', 'solnze', 'shivachandran.nadar15', 'kyg927', 'qaspfu', 'tanmaypatil18', 'lakshoza', 'mhatreravindra11', 'sonaltambe32', 'supriya.mangalpalli', 'ajoshi1996', 'gaouravv', 'deepti.bhosale189', 'sunilpoojary27', 'akash.jadhav', 'hemantjathar7', 'sammeetthosar', 'shreyasshah14', 'anujkolvalkar1', 'sayalimhatre7195', 'darshanlukhi25', 'chaudharilatika02', 'satishlovesmom123', 'mrinalivyas1', 'ankitashere04', 'pbborole', 'mayuresh20', 'rahulstary', 'harshmhatre975', 'khan.nabed65', 'akshaykharat563', 'shetty1995pranoy', 'aksha0103', 'modyjash', 'pappumerijaan', 'phadsujata59', 'amaya.pethe', 'pb9298', 'himanshu21rasam', 'adityasingh8394', 'ektaramani8', 'rushabkarani', 'harshpatel201996', 'gidayegirish']",174,"['t0rse95', 'priyanka.chavan.s.pc', 'nimita.singh', 'shaikhkarnekar', 'vesitd16b', 'sshelar01', 'aksh1995', 'sarprashasti21', 'adityasawant93', 'patilmonika681', 'gaikar.shubhada888', 'smsayali79', 'mehta.krish', 'rohan.ranshinge', 'devanandkb', 'raghu.shirodkar', 'heenal0708', 'sanjay.devan.ranstad', 'reubenalexander2010', 'ashwinnumbrat94', 'satya_mishra', 'pranjali.borkar', 'richard.noronha', 'fruitywithmonty', 'jadhavadhiraj', 'pratikkavale11', 'suyash.chopra', 'amitpoojary94', 'spawar10', 'abhishek.shinde', 'rakeshchrs87', 'harshada.patankar', 'nilesh2551994', 'smhatre08', 'dalviakshata12', 'mayurgaikwad1293', 'devang19.shah', 'pritish.das', 'gajakosh.sneha54', 'suyash.karle', 'milu21111994', 'vedarthsave80', 'takalesusmita', 'pranjali2610', 'yash_iyengar27', 'cyberclan.xd', 'snehavardhini', 'nishanth1101', 'salil.vaidya', 'nitiiinbaranwal', 'rupali1891994', 'naren.ambwani', 'seemamishra', 'trupti.vaity19', 'zak1010', 'lokhanderaj55', 'ankushlagad4', 'dlaxmanc59', 'narenambwani04', 's.aditya.ghadiali', 'yamkarki', 'arsh.raina', 'vinu.sunny1994.vs', 'shubhampnkr', 'a.b.surgade', 'kaushik_gaikwad', 'sumaiyya.kazi94', 'abhishek291', 'muktat20', 'suraj348', 'govind9867129531', 'vijayaher0211', 'ruprane296', 'karna1995.kj', 'sneha.kutal', 'maradiyadhaval92', 'tuscanowtsheryl128', 'thefreeliar18', 'ksurgade', 'ascharyaskumar', 'deepuvijaya1806', 'ibrahimarif950', 'shrimohite13', 'chinmay', 'juvika1994', 'mrinalini20.shah', 'amol.marathe93', 'darpan.bagwale', 'aishhhh', 'gokisush9', 'anirudh2442', 'aakash3194', 'swapnalimakdey25', 'mmodi296', 'pratham201294', 'jatinshende25', 'ranjanjadhav1234', 'syadav05', 'hit.kamble', 'vejalporia1994', 'kiran.pawar1611', 'anirudh0000', 'kanchan.phadtare', 'tawadesiddhesh1994', 'priyankajamdade23', 'mugdhapv8', 'sapnabhandary31', 'dkbathe29', 'zalakdodecha', 'chabhadiariddhi', 'aayushjain27894', 'nikhiljadhav.jadhav40', 'sapte01', 'ranju.raj18', 'chisimeybijimchigmomin', 'manali', 'prajaktasjoshi911', 'pranali.kokate9', 'dubalprasad04', 'omkar.bane13', 'kalpeshshukla11', 'amey.2994', 'sumitkarmokar', 'advaitchuri', 'nshambhuraje', 'mkshirke94', 'parabmahadev34', 'prathmeshgurunathparab', 'shashanksingh4000', 'karanshh30', 'anut730', 'kanchangorde15', 'abhijeetchavan', 'ashijadhav20', 'swapneil.hirulkar', 'paresh761', 'dung_master24', 'shreyasnaravane', 'ambicavenkatesh2009', 'rajkumar.kalantri', 'kuldeeppatil201093', 'shreenathdalvi1994', 'pankajsalunkhe23', 'amitmadgi15', 'smackthatjohn', 'pendkeomkar', 'krusha14', 'sanika.pandharkar', 'omkar12345', 'akshaysharma', 'jmen1993', 'manishakolekar1994', 'sagarbisen50', 'pralim', 'sharvaridalvi301', 'sayli.shevade', 'ishmeetsingh', 'borse84kiran', 'ashish123', 'rgole02', 'thoravekalpesh', 'asudha', 'jeniljain1008', 'rupali.patil', 'isaurabhbhirud7', 'palashmak067', 'jidvaze', 'ruchita9523', 'inderjitsingh87', 'ryadav03', 'abhishek.singh', 'devendrashinde1995', 'gharat789', 'hrishikeshtawade']",226,"['t0rse95', 'priyanka.chavan.s.pc', 'nimita.singh', 'shaikhkarnekar', 'vesitd16b', 'sshelar01', 'aksh1995', 'sarprashasti21', 'adityasawant93', 'gaikar.shubhada888', 'patilmonika681', 'smsayali79', 'tanmaypatil18', 'lakshoza', 'mehta.krish', 'rohan.ranshinge', 'devanandkb', 'raghu.shirodkar', 'heenal0708', 'sanjay.devan.ranstad', 'reubenalexander2010', 'ashwinnumbrat94', 'satya_mishra', 'pranjali.borkar', 'richard.noronha', 'fruitywithmonty', 'jadhavadhiraj', 'pratikkavale11', 'suyash.chopra', 'mrinalivyas1', 'amitpoojary94', 'spawar10', 'aksha0103', 'modyjash', 'abhishek.shinde', 'rakeshchrs87', 'harshada.patankar', 'nilesh2551994', 'smhatre08', 'dalviakshata12', 'himanshu21rasam', 'mayurgaikwad1293', 'ektaramani8', 'devang19.shah', 'pritish.das', 'gajakosh.sneha54', 'suyash.karle', 'milu21111994', 'tushardmaske', 'vedarthsave80', 'takalesusmita', 'pranjali2610', 'yash_iyengar27', 'cyberclan.xd', 'snehavardhini', 'imushaikh007', 'rp92555', 'hegde.aniket94.ah', 'dal30', 'nishanth1101', 'salil.vaidya', 'nitiiinbaranwal', 'kyg927', 'rupali1891994', 'naren.ambwani', 'seemamishra', 'trupti.vaity19', 'zak1010', 'lokhanderaj55', 'ankushlagad4', 'dlaxmanc59', 'narenambwani04', 's.aditya.ghadiali', 'yamkarki', 'supriya.mangalpalli', 'arsh.raina', 'ajoshi1996', 'gaouravv', 'sunilpoojary27', 'vinu.sunny1994.vs', 'shubhampnkr', 'a.b.surgade', 'kaushik_gaikwad', 'sammeetthosar', 'sumaiyya.kazi94', 'abhishek291', 'muktat20', 'sayalimhatre7195', 'stylechicanki', 'chaudharilatika02', 'satishlovesmom123', 'suraj348', 'govind9867129531', 'vijayaher0211', 'rahulstary', 'khan.nabed65', 'ruprane296', 'karna1995.kj', 'sneha.kutal', 'maradiyadhaval92', 'tuscanowtsheryl128', 'thefreeliar18', 'ksurgade', 'ascharyaskumar', 'deepuvijaya1806', 'pb9298', 'adityasingh8394', 'ibrahimarif950', 'shrimohite13', 'chinmay', 'juvika1994', 'harshpatel201996', 'gidayegirish', 'mrinalini20.shah', 'amol.marathe93', 'darpan.bagwale', 'aishhhh', 'gokisush9', 'anirudh2442', 'aakash3194', 'swapnalimakdey25', 'prasadbhujbal28', 'solnze', 'mmodi296', 'pratham201294', 'jatinshende25', 'ranjanjadhav1234', 'syadav05', 'hit.kamble', 'vejalporia1994', 'kiran.pawar1611', 'anirudh0000', 'kanchan.phadtare', 'tawadesiddhesh1994', 'priyankajamdade23', 'mugdhapv8', 'mhatreravindra11', 'sapnabhandary31', 'dkbathe29', 'zalakdodecha', 'chabhadiariddhi', 'aayushjain27894', 'nikhiljadhav.jadhav40', 'sapte01', 'deepti.bhosale189', 'ranju.raj18', 'chisimeybijimchigmomin', 'akash.jadhav', 'hemantjathar7', 'shreyasshah14', 'manali', 'kumar.amit156', 'prajaktasjoshi911', 'pranali.kokate9', 'dubalprasad04', 'ankitashere04', 'omkar.bane13', 'kalpeshshukla11', 'amey.2994', 'mayuresh20', 'harshmhatre975', 'sumitkarmokar', 'advaitchuri', 'nshambhuraje', 'pappumerijaan', 'mkshirke94', 'parabmahadev34', 'prathmeshgurunathparab', 'shashanksingh4000', 'karanshh30', 'anut730', 'kanchangorde15', 'rushabkarani', 'abhijeetchavan', 'ashijadhav20', 'swapneil.hirulkar', 'paresh761', 'dung_master24', 'shreyasnaravane', 'jyotibhosale8483', 'ambicavenkatesh2009', 'rajkumar.kalantri', 'shivachandran.nadar15', 'kuldeeppatil201093', 'shreenathdalvi1994', 'pankajsalunkhe23', 'amitmadgi15', 'qaspfu', 'smackthatjohn', 'pendkeomkar', 'krusha14', 'sonaltambe32', 'sanika.pandharkar', 'omkar12345', 'akshaysharma', 'jmen1993', 'manishakolekar1994', 'sagarbisen50', 'pralim', 'sharvaridalvi301', 'sayli.shevade', 'ishmeetsingh', 'borse84kiran', 'ashish123', 'rgole02', 'thoravekalpesh', 'anujkolvalkar1', 'asudha', 'jeniljain1008', 'darshanlukhi25', 'rupali.patil', 'pbborole', 'phadsujata59', 'akshaykharat563', 'shetty1995pranoy', 'isaurabhbhirud7', 'amaya.pethe', 'palashmak067', 'jidvaze', 'ruchita9523', 'inderjitsingh87', 'ryadav03', 'abhishek.singh', 'devendrashinde1995', 'gharat789', 'hrishikeshtawade']"
11,35,53,135,40,"['tushardmaske', 'imushaikh007', 'rp92555', 'hegde.aniket94.ah', 'jyotibhosale8483', 'prasadbhujbal28', 'dal30', 'shivachandran.nadar15', 'qaspfu', 'tanmaypatil18', 'lakshoza', 'sonaltambe32', 'supriya.mangalpalli', 'ajoshi1996', 'deepti.bhosale189', 'sunilpoojary27', 'akash.jadhav', 'hemantjathar7', 'sammeetthosar', 'anujkolvalkar1', 'darshanlukhi25', 'kumar.amit156', 'stylechicanki', 'chaudharilatika02', 'satishlovesmom123', 'mrinalivyas1', 'ankitashere04', 'mayuresh20', 'rahulstary', 'phadsujata59', 'akshaykharat563', 'shetty1995pranoy', 'aksha0103', 'modyjash', 'amaya.pethe', 'pb9298', 'himanshu21rasam', 'adityasingh8394', 'rushabkarani', 'gidayegirish']",12,"['pappumerijaan', 'shreyasshah14', 'mhatreravindra11', 'sayalimhatre7195', 'harshpatel201996', 'ektaramani8', 'solnze', 'pbborole', 'harshmhatre975', 'khan.nabed65', 'gaouravv', 'kyg927']",95,"['kalpitnarvekar', 'rohan21', 'linusassao974', 'komalkolekar95', 'patelmeeti1995', 'shamika', 'mehta.krish', 'tejomayi.wandhile', 'bhoglet', 'ameysv22', 'sayaliw212', 'sonal.02031995', 'chinmayhejmadi', 'pomkar55', 'shahajichinchole', 'mohiteruchir29', 'architagoyal', 'kodagakshay26', 'karan.dhareshwar', 'deepashrisane2203', 'vanitashingwa1995', 'mewadayash', 'mehakkoul1994', 'shashwatssanghavi', 'aniketvidyalankar', 'gohel.mitesh91', 'divyapawar39', 'ansi7794', 'vj280395', 'niharikasarode', 'ghosh.arjun97', 'deepakjain.dj2', 'desaimaanil2', 'hemantsonar93', 'a.b.surgade', 'aka_jadhav', 'sangeetamjoshi', 'basher00992', 'dakshata', 'ruprane296', 'tuscanowtsheryl128', 'sonali2', 'rajpareshshah14', 'shubham.mohite7', 'chinmay', 'shraddha0306', 'aamod1996', 'kanchipoddar', 'sagnikpal3495', 'mmodi296', 'mengaderutuja369', 'ganeshmukund10', 'rutuja1122', 'rsarmajrt', 'saurabhmangeshkar', 'chabhadiariddhi', 'saurabh.medhekar18', 'pallavighogare1994', 'ganjirajini277', 'krishna.jhuma17', 'nilesh15394', 'aljo.joy22', 'kirandarade133', 'sagar2bhujbal', 'prasadchachad20', 'karanshh30', 'kanchangorde15', 'sj.shruti95', 'chintanrlimbani', 'abhijeetchavan', 'rwaghela51', 'udayanyarya', 'umang.parekh30', 'samira2308', 'ayy1892', 'prachipatil', 'ayushgupta11031996', 'tripathipavan10', 'rohanshah611', 'sagar.mujpara99', 'akajadhav1', 'mvedant29', 'borse84kiran', 'arcanetech12', 'vaibhavvadia', 'surajmore009', 'amitsunildhamne', 'redorchid029', 'nikinsaw', 'sunilkavatkar', None, 'jharupesh440', 'aj.shahare', 'roshninilam', 'inderjitsingh87']",147,"['kalpitnarvekar', 'rohan21', 'linusassao974', 'komalkolekar95', 'patelmeeti1995', 'tanmaypatil18', 'lakshoza', 'shamika', 'mehta.krish', 'tejomayi.wandhile', 'bhoglet', 'ameysv22', 'sayaliw212', 'chinmayhejmadi', 'sonal.02031995', 'pomkar55', 'shahajichinchole', 'mrinalivyas1', 'mohiteruchir29', 'aksha0103', 'architagoyal', 'modyjash', 'kodagakshay26', 'karan.dhareshwar', 'himanshu21rasam', 'deepashrisane2203', 'vanitashingwa1995', 'ektaramani8', 'tushardmaske', 'imushaikh007', 'rp92555', 'hegde.aniket94.ah', 'mewadayash', 'dal30', 'mehakkoul1994', 'shashwatssanghavi', 'aniketvidyalankar', 'kyg927', 'gohel.mitesh91', 'divyapawar39', 'ansi7794', 'vj280395', 'niharikasarode', 'ghosh.arjun97', 'deepakjain.dj2', 'supriya.mangalpalli', 'ajoshi1996', 'desaimaanil2', 'hemantsonar93', 'gaouravv', 'sunilpoojary27', 'a.b.surgade', 'aka_jadhav', 'sammeetthosar', 'sayalimhatre7195', 'sangeetamjoshi', 'stylechicanki', 'chaudharilatika02', 'basher00992', 'satishlovesmom123', 'dakshata', 'rahulstary', 'khan.nabed65', 'ruprane296', 'tuscanowtsheryl128', 'sonali2', 'pb9298', 'adityasingh8394', 'rajpareshshah14', 'shubham.mohite7', 'chinmay', 'harshpatel201996', 'gidayegirish', 'shraddha0306', 'aamod1996', 'kanchipoddar', 'sagnikpal3495', 'prasadbhujbal28', 'solnze', 'mmodi296', 'mengaderutuja369', 'ganeshmukund10', 'rutuja1122', 'rsarmajrt', 'mhatreravindra11', 'saurabhmangeshkar', 'chabhadiariddhi', 'deepti.bhosale189', 'saurabh.medhekar18', 'akash.jadhav', 'hemantjathar7', 'pallavighogare1994', 'ganjirajini277', 'shreyasshah14', 'kumar.amit156', 'krishna.jhuma17', 'nilesh15394', 'aljo.joy22', 'ankitashere04', 'mayuresh20', 'harshmhatre975', 'pappumerijaan', 'kirandarade133', 'sagar2bhujbal', 'prasadchachad20', 'karanshh30', 'kanchangorde15', 'rushabkarani', 'sj.shruti95', 'chintanrlimbani', 'abhijeetchavan', 'rwaghela51', 'udayanyarya', 'jyotibhosale8483', 'umang.parekh30', 'samira2308', 'ayy1892', 'shivachandran.nadar15', 'prachipatil', 'qaspfu', 'ayushgupta11031996', 'tripathipavan10', 'sonaltambe32', 'rohanshah611', 'sagar.mujpara99', 'akajadhav1', 'mvedant29', 'borse84kiran', 'anujkolvalkar1', 'arcanetech12', 'vaibhavvadia', 'darshanlukhi25', 'surajmore009', 'amitsunildhamne', 'redorchid029', 'nikinsaw', 'sunilkavatkar', 'pbborole', 'phadsujata59', 'akshaykharat563', 'shetty1995pranoy', 'jharupesh440', None, 'aj.shahare', 'amaya.pethe', 'roshninilam', 'inderjitsingh87']"
11,41,53,21,1,['prasadbhujbal28'],51,"['tushardmaske', 'imushaikh007', 'rp92555', 'hegde.aniket94.ah', 'jyotibhosale8483', 'solnze', 'dal30', 'shivachandran.nadar15', 'kyg927', 'qaspfu', 'tanmaypatil18', 'lakshoza', 'mhatreravindra11', 'sonaltambe32', 'supriya.mangalpalli', 'ajoshi1996', 'gaouravv', 'deepti.bhosale189', 'sunilpoojary27', 'akash.jadhav', 'hemantjathar7', 'sammeetthosar', 'shreyasshah14', 'anujkolvalkar1', 'sayalimhatre7195', 'darshanlukhi25', 'kumar.amit156', 'stylechicanki', 'chaudharilatika02', 'satishlovesmom123', 'mrinalivyas1', 'ankitashere04', 'pbborole', 'mayuresh20', 'rahulstary', 'harshmhatre975', 'khan.nabed65', 'akshaykharat563', 'shetty1995pranoy', 'aksha0103', 'modyjash', 'pappumerijaan', 'phadsujata59', 'amaya.pethe', 'pb9298', 'himanshu21rasam', 'adityasingh8394', 'ektaramani8', 'rushabkarani', 'harshpatel201996', 'gidayegirish']",20,"['ashishtonge94', 'swapnalimakdey25', 'samira2308', 'g.s.siddhant', 'chiragpooniwala', 'trupti.vaity19', 'arunimavarma20', 'amol.dhanvij10', 'raghu.shirodkar', 'fruitywithmonty', 'manali', 'sushmakodagali', None, 'sonali.bhujbal1', 'sonali2', 'jidvaze', 'inderjitsingh87', 'mns.dinu', 'dj.dharmik', 'ssatam23dps']",72,"['tushardmaske', 'ashishtonge94', 'dj.dharmik', 'imushaikh007', 'rp92555', 'swapnalimakdey25', 'hegde.aniket94.ah', 'jyotibhosale8483', 'prasadbhujbal28', 'dal30', 'solnze', 'samira2308', 'shivachandran.nadar15', 'kyg927', 'g.s.siddhant', 'chiragpooniwala', 'qaspfu', 'tanmaypatil18', 'lakshoza', 'trupti.vaity19', 'mhatreravindra11', 'sonaltambe32', 'supriya.mangalpalli', 'arunimavarma20', 'amol.dhanvij10', 'ajoshi1996', 'raghu.shirodkar', 'gaouravv', 'deepti.bhosale189', 'sunilpoojary27', 'akash.jadhav', 'hemantjathar7', 'sammeetthosar', 'shreyasshah14', 'anujkolvalkar1', 'sayalimhatre7195', 'darshanlukhi25', 'fruitywithmonty', 'kumar.amit156', 'stylechicanki', 'chaudharilatika02', 'manali', 'satishlovesmom123', 'mrinalivyas1', 'ankitashere04', 'sushmakodagali', 'pbborole', 'mayuresh20', 'rahulstary', 'harshmhatre975', 'khan.nabed65', 'akshaykharat563', 'shetty1995pranoy', 'aksha0103', 'modyjash', 'pappumerijaan', 'phadsujata59', None, 'sonali.bhujbal1', 'amaya.pethe', 'sonali2', 'pb9298', 'jidvaze', 'inderjitsingh87', 'himanshu21rasam', 'adityasingh8394', 'mns.dinu', 'ektaramani8', 'rushabkarani', 'harshpatel201996', 'gidayegirish', 'ssatam23dps']"
11,36,53,18,10,"['pappumerijaan', 'shreyasshah14', 'mhatreravindra11', 'sayalimhatre7195', 'khan.nabed65', 'mrinalivyas1', 'ajoshi1996', 'ektaramani8', 'harshmhatre975', 'harshpatel201996']",42,"['tushardmaske', 'imushaikh007', 'rp92555', 'hegde.aniket94.ah', 'jyotibhosale8483', 'prasadbhujbal28', 'dal30', 'solnze', 'shivachandran.nadar15', 'kyg927', 'qaspfu', 'tanmaypatil18', 'lakshoza', 'sonaltambe32', 'supriya.mangalpalli', 'gaouravv', 'deepti.bhosale189', 'sunilpoojary27', 'akash.jadhav', 'hemantjathar7', 'sammeetthosar', 'anujkolvalkar1', 'darshanlukhi25', 'kumar.amit156', 'stylechicanki', 'chaudharilatika02', 'satishlovesmom123', 'ankitashere04', 'pbborole', 'mayuresh20', 'rahulstary', 'phadsujata59', 'akshaykharat563', 'shetty1995pranoy', 'aksha0103', 'modyjash', 'amaya.pethe', 'pb9298', 'himanshu21rasam', 'adityasingh8394', 'rushabkarani', 'gidayegirish']",8,"['shamika', 'ayushgupta11031996', 'komalkolekar95', 'nilesh15394', 'inderjitsingh87', 'karthik.radhakrishna022', 'nakshay07', None]",60,"['tushardmaske', 'imushaikh007', 'rp92555', 'hegde.aniket94.ah', 'jyotibhosale8483', 'prasadbhujbal28', 'dal30', 'solnze', 'komalkolekar95', 'shivachandran.nadar15', 'kyg927', 'qaspfu', 'tanmaypatil18', 'lakshoza', 'shamika', 'ayushgupta11031996', 'mhatreravindra11', 'sonaltambe32', 'karthik.radhakrishna022', 'supriya.mangalpalli', 'ajoshi1996', 'gaouravv', 'deepti.bhosale189', 'sunilpoojary27', 'akash.jadhav', 'hemantjathar7', 'sammeetthosar', 'shreyasshah14', 'anujkolvalkar1', 'sayalimhatre7195', 'darshanlukhi25', 'kumar.amit156', 'stylechicanki', 'chaudharilatika02', 'nilesh15394', 'satishlovesmom123', 'mrinalivyas1', 'ankitashere04', 'pbborole', 'mayuresh20', 'rahulstary', 'harshmhatre975', 'khan.nabed65', 'akshaykharat563', 'shetty1995pranoy', 'aksha0103', 'modyjash', 'pappumerijaan', 'phadsujata59', None, 'amaya.pethe', 'pb9298', 'inderjitsingh87', 'himanshu21rasam', 'adityasingh8394', 'nakshay07', 'ektaramani8', 'rushabkarani', 'harshpatel201996', 'gidayegirish']"
11,39,53,16,1,['pb9298'],51,"['tushardmaske', 'imushaikh007', 'rp92555', 'hegde.aniket94.ah', 'jyotibhosale8483', 'prasadbhujbal28', 'dal30', 'solnze', 'shivachandran.nadar15', 'kyg927', 'qaspfu', 'tanmaypatil18', 'lakshoza', 'mhatreravindra11', 'sonaltambe32', 'supriya.mangalpalli', 'ajoshi1996', 'gaouravv', 'deepti.bhosale189', 'sunilpoojary27', 'akash.jadhav', 'hemantjathar7', 'sammeetthosar', 'shreyasshah14', 'anujkolvalkar1', 'sayalimhatre7195', 'darshanlukhi25', 'kumar.amit156', 'stylechicanki', 'chaudharilatika02', 'satishlovesmom123', 'mrinalivyas1', 'ankitashere04', 'pbborole', 'mayuresh20', 'rahulstary', 'harshmhatre975', 'khan.nabed65', 'akshaykharat563', 'shetty1995pranoy', 'aksha0103', 'modyjash', 'pappumerijaan', 'phadsujata59', 'amaya.pethe', 'himanshu21rasam', 'adityasingh8394', 'ektaramani8', 'rushabkarani', 'harshpatel201996', 'gidayegirish']",15,"['akshaykshitija', 'shraddha0306', 'singhchetna01', 'nishant.joshi42', 'savitashetty111', 'rutu.balure', None, 'rautsayli10', 'sushmakodagali', 'basher00992', 'inderjitsingh87', 'sayaliw212', 'kanchangorde15', 'ajinkyamhatre', 'anetha123']",67,"['akshaykshitija', 'tushardmaske', 'imushaikh007', 'rp92555', 'hegde.aniket94.ah', 'jyotibhosale8483', 'prasadbhujbal28', 'dal30', 'solnze', 'shivachandran.nadar15', 'ajinkyamhatre', 'kyg927', 'qaspfu', 'tanmaypatil18', 'lakshoza', 'singhchetna01', 'savitashetty111', 'mhatreravindra11', 'rautsayli10', 'sonaltambe32', 'sayaliw212', 'supriya.mangalpalli', 'ajoshi1996', 'gaouravv', 'deepti.bhosale189', 'sunilpoojary27', 'shraddha0306', 'akash.jadhav', 'hemantjathar7', 'sammeetthosar', 'nishant.joshi42', 'shreyasshah14', 'anujkolvalkar1', 'sayalimhatre7195', 'darshanlukhi25', 'rutu.balure', 'kumar.amit156', 'stylechicanki', 'chaudharilatika02', 'sushmakodagali', 'satishlovesmom123', 'mrinalivyas1', 'ankitashere04', 'basher00992', 'pbborole', 'mayuresh20', 'rahulstary', 'harshmhatre975', 'khan.nabed65', 'akshaykharat563', 'shetty1995pranoy', 'aksha0103', 'modyjash', 'pappumerijaan', 'phadsujata59', None, 'amaya.pethe', 'pb9298', 'inderjitsingh87', 'himanshu21rasam', 'adityasingh8394', 'ektaramani8', 'kanchangorde15', 'rushabkarani', 'harshpatel201996', 'gidayegirish', 'anetha123']"
12,113,51,50,48,"['g1315126', 'sou1107', 'g1315095', 'saradadada888', 'g1315114', 'dal0825', 'tbmriver', 'kendama565', 'tsuki', 'g1315047', 'g1315121', 'g1315018', 'g1315127', 'g1315060', 'g046', 'kakeneji.024', 'g1315129', 'fukuoka', 'matsumoto283', 'g1315124', 'g1315069', 'g1315052', 'shohei', 'g1315133', 'g1315132', 'dds7001.no', 'g1315109', 'kumakamo', 'g1315073', 'tyimaios', 'pokotawan', 'g1315021', 'g1315106', 'happykonata', 'g1215019', 'rein24', 'g1315045', 'g1315100', 'g1115087', 'g1215017', 'mskt.taskman01', 'yu610', 'reizou', 'g1315075', 'g1315057', 'g1315118', 'g1315094', 'yokhrd']",2,"['sushmitadandeliya', 'biboyanov']",2,"[None, 'marui']",52,"['sou1107', 'saradadada888', 'tbmriver', 'g1315127', 'sushmitadandeliya', 'g1315129', 'matsumoto283', 'marui', 'g1315069', 'shohei', 'g1315133', 'g1315132', 'dds7001.no', 'g1315021', 'g1315100', 'g1115087', 'g1215017', 'g1315057', 'yokhrd', 'g1315126', 'g1315095', 'g1315114', 'dal0825', 'kendama565', 'tsuki', 'g1315047', 'g1315121', 'g1315018', 'g1315060', 'g046', 'kakeneji.024', 'biboyanov', 'fukuoka', 'g1315124', 'g1315052', 'g1315109', 'kumakamo', 'g1315073', 'tyimaios', 'pokotawan', 'g1315106', 'happykonata', 'g1215019', 'rein24', 'g1315045', None, 'mskt.taskman01', 'yu610', 'reizou', 'g1315075', 'g1315118', 'g1315094']"
13,38,48,176,7,"['aakash3194', 'krusha14', 's.aditya.ghadiali', 'amey.2994', 'chinmay', 'isaurabhbhirud7', 'kanchan.phadtare']",40,"['daiwikb', 'siddhant', 'abha08', 'doshipayal1996', 'shubham.lunawat', 'tzatakia', 'narkheden', 'sankheneel', 'bhavana.djs19', 'karishmamehta34', 'pbandewar', 'manishaagam999', 'meet.muchhala95', 'geetgandhi96', 'gog40', 'rohancontractor.rc', 'nittu.arsenal', 'kapsesainath', 'helloworld1', 'nagateja.vlsi', 'shah.shivani1702', 'vrushabhdesai007', 'ruchawaghulde', 'djeskay27', 'harshvardhandave1112', 'thosarm', 'ps22ghule', 'tikikikik', 'riteshrajput381', 'aryakanika31', 'vora.jai1', 'azazeljam', 'pushkarvaity', 'guheak92', 'daminivyas9', 'shashankgangrade', 'mayureshvartak30', 'scapall', 'vandortshakti', 'vishwanathan.anirudh']",169,"['t0rse95', 'priyanka.chavan.s.pc', 'nimita.singh', 'shaikhkarnekar', 'vesitd16b', 'sshelar01', 'aksh1995', 'sarprashasti21', 'adityasawant93', 'patilmonika681', 'gaikar.shubhada888', 'smsayali79', 'mehta.krish', 'rohan.ranshinge', 'devanandkb', 'raghu.shirodkar', 'heenal0708', 'sanjay.devan.ranstad', 'reubenalexander2010', 'ashwinnumbrat94', 'satya_mishra', 'pranjali.borkar', 'richard.noronha', 'fruitywithmonty', 'jadhavadhiraj', 'pratikkavale11', 'suyash.chopra', 'amitpoojary94', 'spawar10', 'abhishek.shinde', 'rakeshchrs87', 'harshada.patankar', 'nilesh2551994', 'smhatre08', 'dalviakshata12', 'mayurgaikwad1293', 'devang19.shah', 'pritish.das', 'gajakosh.sneha54', 'suyash.karle', 'milu21111994', 'vedarthsave80', 'takalesusmita', 'pranjali2610', 'yash_iyengar27', 'cyberclan.xd', 'snehavardhini', 'nishanth1101', 'salil.vaidya', 'nitiiinbaranwal', 'rupali1891994', 'naren.ambwani', 'seemamishra', 'trupti.vaity19', 'zak1010', 'lokhanderaj55', 'ankushlagad4', 'dlaxmanc59', 'narenambwani04', 'yamkarki', 'arsh.raina', 'vinu.sunny1994.vs', 'shubhampnkr', 'a.b.surgade', 'kaushik_gaikwad', 'sumaiyya.kazi94', 'abhishek291', 'muktat20', 'stylechicanki', 'suraj348', 'govind9867129531', 'vijayaher0211', 'ruprane296', 'karna1995.kj', 'sneha.kutal', 'maradiyadhaval92', 'tuscanowtsheryl128', 'thefreeliar18', 'ksurgade', 'ascharyaskumar', 'deepuvijaya1806', 'ibrahimarif950', 'shrimohite13', 'juvika1994', 'mrinalini20.shah', 'amol.marathe93', 'darpan.bagwale', 'aishhhh', 'gokisush9', 'anirudh2442', 'swapnalimakdey25', 'mmodi296', 'pratham201294', 'jatinshende25', 'ranjanjadhav1234', 'syadav05', 'hit.kamble', 'vejalporia1994', 'kiran.pawar1611', 'anirudh0000', 'tawadesiddhesh1994', 'priyankajamdade23', 'mugdhapv8', 'sapnabhandary31', 'dkbathe29', 'zalakdodecha', 'chabhadiariddhi', 'aayushjain27894', 'nikhiljadhav.jadhav40', 'sapte01', 'ranju.raj18', 'chisimeybijimchigmomin', 'manali', 'kumar.amit156', 'prajaktasjoshi911', 'pranali.kokate9', 'dubalprasad04', 'omkar.bane13', 'kalpeshshukla11', 'sumitkarmokar', 'advaitchuri', 'nshambhuraje', 'mkshirke94', 'parabmahadev34', 'prathmeshgurunathparab', 'shashanksingh4000', 'karanshh30', 'anut730', 'kanchangorde15', 'abhijeetchavan', 'ashijadhav20', 'swapneil.hirulkar', 'paresh761', 'dung_master24', 'shreyasnaravane', 'ambicavenkatesh2009', 'rajkumar.kalantri', 'kuldeeppatil201093', 'shreenathdalvi1994', 'pankajsalunkhe23', 'amitmadgi15', 'smackthatjohn', 'pendkeomkar', 'sanika.pandharkar', 'omkar12345', 'akshaysharma', 'jmen1993', 'manishakolekar1994', 'sagarbisen50', 'pralim', 'sharvaridalvi301', 'sayli.shevade', 'ishmeetsingh', 'borse84kiran', 'ashish123', 'rgole02', 'thoravekalpesh', 'asudha', 'jeniljain1008', 'rupali.patil', 'palashmak067', 'jidvaze', 'ruchita9523', 'inderjitsingh87', 'ryadav03', 'abhishek.singh', 'devendrashinde1995', 'gharat789', 'hrishikeshtawade']",216,"['t0rse95', 'daiwikb', 'doshipayal1996', 'priyanka.chavan.s.pc', 'shubham.lunawat', 'nimita.singh', 'shaikhkarnekar', 'vesitd16b', 'sshelar01', 'aksh1995', 'sarprashasti21', 'adityasawant93', 'gaikar.shubhada888', 'patilmonika681', 'smsayali79', 'meet.muchhala95', 'mehta.krish', 'gog40', 'rohancontractor.rc', 'rohan.ranshinge', 'devanandkb', 'raghu.shirodkar', 'heenal0708', 'sanjay.devan.ranstad', 'reubenalexander2010', 'ashwinnumbrat94', 'shah.shivani1702', 'satya_mishra', 'pranjali.borkar', 'richard.noronha', 'fruitywithmonty', 'jadhavadhiraj', 'pratikkavale11', 'suyash.chopra', 'amitpoojary94', 'spawar10', 'harshvardhandave1112', 'vora.jai1', 'riteshrajput381', 'aryakanika31', 'abhishek.shinde', 'azazeljam', 'rakeshchrs87', 'harshada.patankar', 'nilesh2551994', 'smhatre08', 'dalviakshata12', 'vandortshakti', 'mayurgaikwad1293', 'devang19.shah', 'pritish.das', 'gajakosh.sneha54', 'suyash.karle', 'milu21111994', 'abha08', 'vedarthsave80', 'takalesusmita', 'pranjali2610', 'yash_iyengar27', 'cyberclan.xd', 'snehavardhini', 'nishanth1101', 'salil.vaidya', 'nitiiinbaranwal', 'rupali1891994', 'pbandewar', 'naren.ambwani', 'seemamishra', 'trupti.vaity19', 'zak1010', 'lokhanderaj55', 'ankushlagad4', 'dlaxmanc59', 'geetgandhi96', 'narenambwani04', 's.aditya.ghadiali', 'yamkarki', 'arsh.raina', 'nittu.arsenal', 'vinu.sunny1994.vs', 'shubhampnkr', 'nagateja.vlsi', 'a.b.surgade', 'kaushik_gaikwad', 'sumaiyya.kazi94', 'abhishek291', 'muktat20', 'vrushabhdesai007', 'stylechicanki', 'suraj348', 'govind9867129531', 'vijayaher0211', 'ruprane296', 'karna1995.kj', 'sneha.kutal', 'maradiyadhaval92', 'tuscanowtsheryl128', 'thefreeliar18', 'ksurgade', 'shashankgangrade', 'ascharyaskumar', 'deepuvijaya1806', 'mayureshvartak30', 'scapall', 'ibrahimarif950', 'shrimohite13', 'chinmay', 'juvika1994', 'vishwanathan.anirudh', 'mrinalini20.shah', 'amol.marathe93', 'darpan.bagwale', 'aishhhh', 'gokisush9', 'anirudh2442', 'aakash3194', 'swapnalimakdey25', 'mmodi296', 'pratham201294', 'jatinshende25', 'ranjanjadhav1234', 'syadav05', 'hit.kamble', 'sankheneel', 'vejalporia1994', 'kiran.pawar1611', 'anirudh0000', 'kanchan.phadtare', 'karishmamehta34', 'tawadesiddhesh1994', 'priyankajamdade23', 'mugdhapv8', 'sapnabhandary31', 'dkbathe29', 'zalakdodecha', 'chabhadiariddhi', 'aayushjain27894', 'nikhiljadhav.jadhav40', 'sapte01', 'ranju.raj18', 'chisimeybijimchigmomin', 'kapsesainath', 'manali', 'kumar.amit156', 'prajaktasjoshi911', 'pranali.kokate9', 'dubalprasad04', 'omkar.bane13', 'amey.2994', 'kalpeshshukla11', 'sumitkarmokar', 'djeskay27', 'thosarm', 'advaitchuri', 'tikikikik', 'nshambhuraje', 'mkshirke94', 'parabmahadev34', 'prathmeshgurunathparab', 'shashanksingh4000', 'karanshh30', 'anut730', 'kanchangorde15', 'siddhant', 'tzatakia', 'narkheden', 'abhijeetchavan', 'ashijadhav20', 'swapneil.hirulkar', 'paresh761', 'dung_master24', 'shreyasnaravane', 'ambicavenkatesh2009', 'rajkumar.kalantri', 'kuldeeppatil201093', 'bhavana.djs19', 'shreenathdalvi1994', 'pankajsalunkhe23', 'amitmadgi15', 'manishaagam999', 'smackthatjohn', 'pendkeomkar', 'krusha14', 'sanika.pandharkar', 'omkar12345', 'akshaysharma', 'jmen1993', 'manishakolekar1994', 'sagarbisen50', 'pralim', 'helloworld1', 'sharvaridalvi301', 'sayli.shevade', 'ishmeetsingh', 'borse84kiran', 'ashish123', 'rgole02', 'thoravekalpesh', 'asudha', 'jeniljain1008', 'rupali.patil', 'ruchawaghulde', 'isaurabhbhirud7', 'ps22ghule', 'pushkarvaity', 'guheak92', 'daminivyas9', 'palashmak067', 'jidvaze', 'ruchita9523', 'inderjitsingh87', 'ryadav03', 'abhishek.singh', 'devendrashinde1995', 'gharat789', 'hrishikeshtawade']"
13,35,48,135,1,['chinmay'],46,"['daiwikb', 'siddhant', 'abha08', 'doshipayal1996', 'shubham.lunawat', 'tzatakia', 'narkheden', 'aakash3194', 'sankheneel', 'bhavana.djs19', 'kanchan.phadtare', 'karishmamehta34', 'pbandewar', 'manishaagam999', 'meet.muchhala95', 'geetgandhi96', 'krusha14', 'gog40', 'rohancontractor.rc', 's.aditya.ghadiali', 'nittu.arsenal', 'kapsesainath', 'helloworld1', 'nagateja.vlsi', 'shah.shivani1702', 'vrushabhdesai007', 'ruchawaghulde', 'amey.2994', 'djeskay27', 'harshvardhandave1112', 'isaurabhbhirud7', 'thosarm', 'ps22ghule', 'tikikikik', 'riteshrajput381', 'aryakanika31', 'vora.jai1', 'azazeljam', 'pushkarvaity', 'guheak92', 'daminivyas9', 'shashankgangrade', 'mayureshvartak30', 'scapall', 'vandortshakti', 'vishwanathan.anirudh']",134,"['kalpitnarvekar', 'rohan21', 'linusassao974', 'komalkolekar95', 'patelmeeti1995', 'lakshoza', 'tanmaypatil18', 'shamika', 'mehta.krish', 'tejomayi.wandhile', 'bhoglet', 'ameysv22', 'sayaliw212', 'sonal.02031995', 'chinmayhejmadi', 'pomkar55', 'shahajichinchole', 'mrinalivyas1', 'mohiteruchir29', 'aksha0103', 'architagoyal', 'modyjash', 'kodagakshay26', 'karan.dhareshwar', 'himanshu21rasam', 'deepashrisane2203', 'vanitashingwa1995', 'tushardmaske', 'imushaikh007', 'rp92555', 'hegde.aniket94.ah', 'mewadayash', 'dal30', 'mehakkoul1994', 'shashwatssanghavi', 'aniketvidyalankar', 'gohel.mitesh91', 'divyapawar39', 'ansi7794', 'vj280395', 'niharikasarode', 'ghosh.arjun97', 'deepakjain.dj2', 'supriya.mangalpalli', 'ajoshi1996', 'desaimaanil2', 'hemantsonar93', 'sunilpoojary27', 'a.b.surgade', 'aka_jadhav', 'sammeetthosar', 'sangeetamjoshi', 'stylechicanki', 'basher00992', 'chaudharilatika02', 'satishlovesmom123', 'dakshata', 'ruprane296', 'rahulstary', 'tuscanowtsheryl128', 'sonali2', 'pb9298', 'adityasingh8394', 'rajpareshshah14', 'shubham.mohite7', 'gidayegirish', 'shraddha0306', 'aamod1996', 'kanchipoddar', 'sagnikpal3495', 'prasadbhujbal28', 'mmodi296', 'mengaderutuja369', 'ganeshmukund10', 'rutuja1122', 'rsarmajrt', 'saurabhmangeshkar', 'chabhadiariddhi', 'deepti.bhosale189', 'saurabh.medhekar18', 'akash.jadhav', 'hemantjathar7', 'pallavighogare1994', 'ganjirajini277', 'kumar.amit156', 'krishna.jhuma17', 'nilesh15394', 'aljo.joy22', 'ankitashere04', 'mayuresh20', 'kirandarade133', 'sagar2bhujbal', 'prasadchachad20', 'karanshh30', 'kanchangorde15', 'rushabkarani', 'sj.shruti95', 'chintanrlimbani', 'abhijeetchavan', 'rwaghela51', 'udayanyarya', 'jyotibhosale8483', 'umang.parekh30', 'samira2308', 'ayy1892', 'shivachandran.nadar15', 'prachipatil', 'qaspfu', 'ayushgupta11031996', 'tripathipavan10', 'sonaltambe32', 'rohanshah611', 'sagar.mujpara99', 'akajadhav1', 'mvedant29', 'borse84kiran', 'anujkolvalkar1', 'arcanetech12', 'vaibhavvadia', 'darshanlukhi25', 'surajmore009', 'amitsunildhamne', 'redorchid029', 'nikinsaw', 'sunilkavatkar', 'phadsujata59', 'shetty1995pranoy', 'akshaykharat563', 'jharupesh440', None, 'aj.shahare', 'amaya.pethe', 'roshninilam', 'inderjitsingh87']",181,"['daiwikb', 'doshipayal1996', 'kalpitnarvekar', 'shubham.lunawat', 'rohan21', 'linusassao974', 'komalkolekar95', 'patelmeeti1995', 'lakshoza', 'tanmaypatil18', 'shamika', 'meet.muchhala95', 'mehta.krish', 'tejomayi.wandhile', 'gog40', 'rohancontractor.rc', 'bhoglet', 'ameysv22', 'sayaliw212', 'chinmayhejmadi', 'sonal.02031995', 'pomkar55', 'shahajichinchole', 'shah.shivani1702', 'mrinalivyas1', 'harshvardhandave1112', 'mohiteruchir29', 'vora.jai1', 'aksha0103', 'architagoyal', 'riteshrajput381', 'aryakanika31', 'modyjash', 'azazeljam', 'kodagakshay26', 'karan.dhareshwar', 'himanshu21rasam', 'deepashrisane2203', 'vandortshakti', 'vanitashingwa1995', 'tushardmaske', 'abha08', 'imushaikh007', 'rp92555', 'hegde.aniket94.ah', 'mewadayash', 'dal30', 'mehakkoul1994', 'shashwatssanghavi', 'aniketvidyalankar', 'gohel.mitesh91', 'divyapawar39', 'ansi7794', 'pbandewar', 'vj280395', 'niharikasarode', 'ghosh.arjun97', 'geetgandhi96', 'deepakjain.dj2', 's.aditya.ghadiali', 'supriya.mangalpalli', 'ajoshi1996', 'nittu.arsenal', 'desaimaanil2', 'hemantsonar93', 'sunilpoojary27', 'nagateja.vlsi', 'a.b.surgade', 'aka_jadhav', 'sammeetthosar', 'vrushabhdesai007', 'sangeetamjoshi', 'stylechicanki', 'basher00992', 'chaudharilatika02', 'satishlovesmom123', 'dakshata', 'ruprane296', 'rahulstary', 'tuscanowtsheryl128', 'sonali2', 'shashankgangrade', 'pb9298', 'mayureshvartak30', 'scapall', 'adityasingh8394', 'rajpareshshah14', 'shubham.mohite7', 'chinmay', 'vishwanathan.anirudh', 'gidayegirish', 'shraddha0306', 'aamod1996', 'kanchipoddar', 'aakash3194', 'sagnikpal3495', 'prasadbhujbal28', 'mmodi296', 'mengaderutuja369', 'ganeshmukund10', 'rutuja1122', 'sankheneel', 'kanchan.phadtare', 'karishmamehta34', 'rsarmajrt', 'saurabhmangeshkar', 'chabhadiariddhi', 'deepti.bhosale189', 'saurabh.medhekar18', 'kapsesainath', 'akash.jadhav', 'hemantjathar7', 'pallavighogare1994', 'ganjirajini277', 'kumar.amit156', 'krishna.jhuma17', 'nilesh15394', 'aljo.joy22', 'ankitashere04', 'amey.2994', 'mayuresh20', 'djeskay27', 'thosarm', 'tikikikik', 'kirandarade133', 'sagar2bhujbal', 'prasadchachad20', 'karanshh30', 'kanchangorde15', 'rushabkarani', 'sj.shruti95', 'chintanrlimbani', 'siddhant', 'tzatakia', 'narkheden', 'abhijeetchavan', 'rwaghela51', 'udayanyarya', 'jyotibhosale8483', 'umang.parekh30', 'samira2308', 'ayy1892', 'shivachandran.nadar15', 'bhavana.djs19', 'prachipatil', 'qaspfu', 'manishaagam999', 'ayushgupta11031996', 'tripathipavan10', 'krusha14', 'sonaltambe32', 'rohanshah611', 'sagar.mujpara99', 'helloworld1', 'akajadhav1', 'mvedant29', 'borse84kiran', 'anujkolvalkar1', 'arcanetech12', 'vaibhavvadia', 'darshanlukhi25', 'ruchawaghulde', 'surajmore009', 'amitsunildhamne', 'redorchid029', 'nikinsaw', 'sunilkavatkar', 'isaurabhbhirud7', 'phadsujata59', 'ps22ghule', 'shetty1995pranoy', 'akshaykharat563', 'jharupesh440', None, 'aj.shahare', 'amaya.pethe', 'pushkarvaity', 'guheak92', 'daminivyas9', 'roshninilam', 'inderjitsingh87']"
13,42,48,69,8,"['kapsesainath', 'pbandewar', 'abha08', 'pushkarvaity', 'aakash3194', 'krusha14', 's.aditya.ghadiali', 'kanchan.phadtare']",39,"['daiwikb', 'tzatakia', 'siddhant', 'doshipayal1996', 'shubham.lunawat', 'narkheden', 'sankheneel', 'bhavana.djs19', 'karishmamehta34', 'manishaagam999', 'meet.muchhala95', 'geetgandhi96', 'gog40', 'rohancontractor.rc', 'nittu.arsenal', 'helloworld1', 'nagateja.vlsi', 'shah.shivani1702', 'vrushabhdesai007', 'ruchawaghulde', 'amey.2994', 'djeskay27', 'harshvardhandave1112', 'isaurabhbhirud7', 'thosarm', 'ps22ghule', 'tikikikik', 'riteshrajput381', 'aryakanika31', 'vora.jai1', 'azazeljam', 'guheak92', 'daminivyas9', 'shashankgangrade', 'mayureshvartak30', 'scapall', 'vandortshakti', 'chinmay', 'vishwanathan.anirudh']",61,"['akshaykatkar', 'vivianmascarenhas1994', 'nimita.singh', 'greatabhi.jathar', 'adithyamohan', 'swapnalimakdey25', 'linusassao974', 'mewadayash', 'jitusawant10', 'mananmehta95', 'mannapatil', 'shashwatssanghavi', 'prathuhatode', 'kedarthale', 'chiragpooniwala', 'sahilkolwankar', 'shamika', 'ankushlagad4', 'varsha.jagadale188.vj', 'tejomayi.wandhile', 'mehta.krish', 'rohan.ranshinge', 'sanika.pandharkar', 'gurnani.nikita999', 'karthik.radhakrishna022', 'mrhbtiwari', 'amol.dhanvij10', 'sagar.mujpara99', 'pritidhandrut25', 'shraddha0306', 'priyanka.kulkarni', 'mandavkarnidhi', 'a.b.surgade', 'mvedant29', 'tanmaykadam', 'giridharsh1', 'fruitywithmonty', 'rupali.patil', 'pranali.kokate9', 'sushmakodagali', 'abhay.kshirsagar', 'sunilkavatkar', 'payalsaldur', None, 'rohanbandal93', 'ramjighatala7', 'ajit.gaikwad325', 'neetika.k10', 'sonali2', 'vishalvb04', 'ghaisas.atharv', 'ashishjamdade72', 'mohit951995', 'jidvaze', 'shruti.ganjoo97', 'inderjitsingh87', 'nachi.2605', 'sharan.raikhangar', 'juvika1994', 'dj.dharmik', 'ssatam23dps']",108,"['vivianmascarenhas1994', 'daiwikb', 'doshipayal1996', 'shubham.lunawat', 'nimita.singh', 'greatabhi.jathar', 'aakash3194', 'swapnalimakdey25', 'linusassao974', 'sankheneel', 'mannapatil', 'prathuhatode', 'kanchan.phadtare', 'karishmamehta34', 'kedarthale', 'chiragpooniwala', 'shamika', 'meet.muchhala95', 'varsha.jagadale188.vj', 'tejomayi.wandhile', 'mehta.krish', 'gog40', 'rohancontractor.rc', 'rohan.ranshinge', 'karthik.radhakrishna022', 'mrhbtiwari', 'priyanka.kulkarni', 'kapsesainath', 'shah.shivani1702', 'tanmaykadam', 'giridharsh1', 'fruitywithmonty', 'pranali.kokate9', 'amey.2994', 'djeskay27', 'harshvardhandave1112', 'payalsaldur', 'thosarm', 'vora.jai1', 'tikikikik', 'riteshrajput381', 'aryakanika31', 'ajit.gaikwad325', 'neetika.k10', 'azazeljam', 'vishalvb04', 'mohit951995', 'nachi.2605', 'vandortshakti', 'sharan.raikhangar', 'dj.dharmik', 'akshaykatkar', 'abha08', 'siddhant', 'tzatakia', 'narkheden', 'adithyamohan', 'mewadayash', 'jitusawant10', 'mananmehta95', 'shashwatssanghavi', 'bhavana.djs19', 'sahilkolwankar', 'pbandewar', 'manishaagam999', 'ankushlagad4', 'geetgandhi96', 'krusha14', 's.aditya.ghadiali', 'sanika.pandharkar', 'gurnani.nikita999', 'amol.dhanvij10', 'sagar.mujpara99', 'nittu.arsenal', 'pritidhandrut25', 'shraddha0306', 'helloworld1', 'nagateja.vlsi', 'mandavkarnidhi', 'a.b.surgade', 'mvedant29', 'rupali.patil', 'vrushabhdesai007', 'sushmakodagali', 'ruchawaghulde', 'abhay.kshirsagar', 'sunilkavatkar', 'isaurabhbhirud7', None, 'ps22ghule', 'rohanbandal93', 'ramjighatala7', 'pushkarvaity', 'guheak92', 'daminivyas9', 'shashankgangrade', 'sonali2', 'ghaisas.atharv', 'mayureshvartak30', 'scapall', 'ashishjamdade72', 'jidvaze', 'shruti.ganjoo97', 'inderjitsingh87', 'chinmay', 'juvika1994', 'vishwanathan.anirudh', 'ssatam23dps']"
13,45,48,34,18,"['riteshrajput381', 'karishmamehta34', 'daiwikb', 'helloworld1', 'siddhant', 'tzatakia', 'doshipayal1996', 'narkheden', 'manishaagam999', 'meet.muchhala95', 'vora.jai1', 'azazeljam', 'rohancontractor.rc', 'ruchawaghulde', 'vandortshakti', 'chinmay', 'aryakanika31', 'thosarm']",29,"['abha08', 'shubham.lunawat', 'aakash3194', 'sankheneel', 'bhavana.djs19', 'kanchan.phadtare', 'pbandewar', 'geetgandhi96', 'krusha14', 'gog40', 's.aditya.ghadiali', 'nittu.arsenal', 'kapsesainath', 'nagateja.vlsi', 'shah.shivani1702', 'vrushabhdesai007', 'amey.2994', 'djeskay27', 'harshvardhandave1112', 'isaurabhbhirud7', 'ps22ghule', 'tikikikik', 'pushkarvaity', 'guheak92', 'daminivyas9', 'shashankgangrade', 'mayureshvartak30', 'scapall', 'vishwanathan.anirudh']",16,"['rwaghela51', 'ritugupta1102.rg97', 'ghosh.arjun97', 'nishant.joshi42', 'karan.dhareshwar', 'udayanyarya', 'rohan21', 'ameysv22', 'mewadayash', 'kothari.dhruvin.dk', 'mananmehta95', 'rohanshah611', 'chinmayhejmadi', None, 'patelmeeti1995', 'jharupesh440']",63,"['daiwikb', 'doshipayal1996', 'shubham.lunawat', 'aakash3194', 'rohan21', 'sankheneel', 'patelmeeti1995', 'kanchan.phadtare', 'karishmamehta34', 'ritugupta1102.rg97', 'meet.muchhala95', 'gog40', 'rohancontractor.rc', 'ameysv22', 'chinmayhejmadi', 'kapsesainath', 'shah.shivani1702', 'kothari.dhruvin.dk', 'amey.2994', 'djeskay27', 'harshvardhandave1112', 'thosarm', 'vora.jai1', 'tikikikik', 'riteshrajput381', 'aryakanika31', 'azazeljam', 'karan.dhareshwar', 'vandortshakti', 'abha08', 'siddhant', 'tzatakia', 'narkheden', 'rwaghela51', 'udayanyarya', 'mewadayash', 'mananmehta95', 'bhavana.djs19', 'pbandewar', 'manishaagam999', 'ghosh.arjun97', 'geetgandhi96', 'krusha14', 's.aditya.ghadiali', 'rohanshah611', 'nittu.arsenal', 'helloworld1', 'nagateja.vlsi', 'nishant.joshi42', 'vrushabhdesai007', 'ruchawaghulde', 'isaurabhbhirud7', None, 'ps22ghule', 'jharupesh440', 'pushkarvaity', 'guheak92', 'daminivyas9', 'shashankgangrade', 'mayureshvartak30', 'scapall', 'chinmay', 'vishwanathan.anirudh']"
13,46,48,16,10,"['riteshrajput381', 'helloworld1', 'tzatakia', 'vora.jai1', 'geetgandhi96', 'mayureshvartak30', 'sankheneel', 'vishwanathan.anirudh', 'harshvardhandave1112', 'djeskay27']",37,"['daiwikb', 'siddhant', 'abha08', 'doshipayal1996', 'shubham.lunawat', 'narkheden', 'aakash3194', 'bhavana.djs19', 'kanchan.phadtare', 'karishmamehta34', 'pbandewar', 'manishaagam999', 'meet.muchhala95', 'krusha14', 'gog40', 'rohancontractor.rc', 's.aditya.ghadiali', 'nittu.arsenal', 'kapsesainath', 'nagateja.vlsi', 'shah.shivani1702', 'vrushabhdesai007', 'ruchawaghulde', 'amey.2994', 'isaurabhbhirud7', 'thosarm', 'ps22ghule', 'tikikikik', 'aryakanika31', 'azazeljam', 'pushkarvaity', 'guheak92', 'daminivyas9', 'shashankgangrade', 'scapall', 'vandortshakti', 'chinmay']",6,"['aamod1996', 'vaibhavvadia', 'kothari.dhruvin.dk', 'umang.parekh30', 'mananmehta95', None]",53,"['daiwikb', 'abha08', 'doshipayal1996', 'siddhant', 'shubham.lunawat', 'tzatakia', 'narkheden', 'aamod1996', 'aakash3194', 'umang.parekh30', 'mananmehta95', 'sankheneel', 'bhavana.djs19', 'kanchan.phadtare', 'karishmamehta34', 'pbandewar', 'manishaagam999', 'meet.muchhala95', 'geetgandhi96', 'krusha14', 'gog40', 'rohancontractor.rc', 's.aditya.ghadiali', 'nittu.arsenal', 'kapsesainath', 'helloworld1', 'nagateja.vlsi', 'shah.shivani1702', 'vaibhavvadia', 'vrushabhdesai007', 'kothari.dhruvin.dk', 'ruchawaghulde', 'amey.2994', 'djeskay27', 'harshvardhandave1112', 'isaurabhbhirud7', 'thosarm', 'ps22ghule', 'tikikikik', 'riteshrajput381', 'aryakanika31', 'vora.jai1', None, 'azazeljam', 'pushkarvaity', 'guheak92', 'daminivyas9', 'shashankgangrade', 'mayureshvartak30', 'scapall', 'vandortshakti', 'chinmay', 'vishwanathan.anirudh']"
13,43,48,12,2,"['isaurabhbhirud7', 'pushkarvaity']",45,"['daiwikb', 'siddhant', 'abha08', 'doshipayal1996', 'shubham.lunawat', 'tzatakia', 'narkheden', 'aakash3194', 'sankheneel', 'bhavana.djs19', 'kanchan.phadtare', 'karishmamehta34', 'pbandewar', 'manishaagam999', 'meet.muchhala95', 'geetgandhi96', 'krusha14', 'gog40', 'rohancontractor.rc', 's.aditya.ghadiali', 'nittu.arsenal', 'kapsesainath', 'helloworld1', 'nagateja.vlsi', 'shah.shivani1702', 'vrushabhdesai007', 'ruchawaghulde', 'amey.2994', 'djeskay27', 'harshvardhandave1112', 'thosarm', 'ps22ghule', 'tikikikik', 'riteshrajput381', 'aryakanika31', 'vora.jai1', 'azazeljam', 'guheak92', 'daminivyas9', 'shashankgangrade', 'mayureshvartak30', 'scapall', 'vandortshakti', 'chinmay', 'vishwanathan.anirudh']",10,"['ishmeetsingh', 'aishhhh', 'kalyani.aye93', 'ashishtonge94', 'ajinkyapadwad', 'yrsarvankar', 'mayur.agarwadekar', 'bhujangmethe', 'juvika1994', None]",57,"['daiwikb', 'abha08', 'doshipayal1996', 'siddhant', 'shubham.lunawat', 'tzatakia', 'narkheden', 'aishhhh', 'kalyani.aye93', 'aakash3194', 'ashishtonge94', 'ajinkyapadwad', 'sankheneel', 'bhavana.djs19', 'kanchan.phadtare', 'karishmamehta34', 'pbandewar', 'manishaagam999', 'meet.muchhala95', 'geetgandhi96', 'krusha14', 'gog40', 'rohancontractor.rc', 's.aditya.ghadiali', 'mayur.agarwadekar', 'bhujangmethe', 'yrsarvankar', 'nittu.arsenal', 'kapsesainath', 'helloworld1', 'nagateja.vlsi', 'ishmeetsingh', 'shah.shivani1702', 'vrushabhdesai007', 'ruchawaghulde', 'amey.2994', 'djeskay27', 'harshvardhandave1112', 'isaurabhbhirud7', 'thosarm', 'ps22ghule', 'tikikikik', 'riteshrajput381', 'aryakanika31', 'vora.jai1', None, 'azazeljam', 'pushkarvaity', 'guheak92', 'daminivyas9', 'shashankgangrade', 'mayureshvartak30', 'scapall', 'vandortshakti', 'chinmay', 'juvika1994', 'vishwanathan.anirudh']"
13,44,48,8,5,"['azazeljam', 'doshipayal1996', 'narkheden', 'shubham.lunawat', 'vandortshakti']",42,"['daiwikb', 'abha08', 'siddhant', 'tzatakia', 'aakash3194', 'sankheneel', 'bhavana.djs19', 'kanchan.phadtare', 'karishmamehta34', 'pbandewar', 'manishaagam999', 'meet.muchhala95', 'geetgandhi96', 'krusha14', 'gog40', 'rohancontractor.rc', 's.aditya.ghadiali', 'nittu.arsenal', 'kapsesainath', 'helloworld1', 'nagateja.vlsi', 'shah.shivani1702', 'vrushabhdesai007', 'ruchawaghulde', 'amey.2994', 'djeskay27', 'harshvardhandave1112', 'isaurabhbhirud7', 'thosarm', 'ps22ghule', 'tikikikik', 'riteshrajput381', 'aryakanika31', 'vora.jai1', 'pushkarvaity', 'guheak92', 'daminivyas9', 'shashankgangrade', 'mayureshvartak30', 'scapall', 'chinmay', 'vishwanathan.anirudh']",3,"['rohan21', None, 'abhijeetchavan']",50,"['daiwikb', 'abha08', 'doshipayal1996', 'siddhant', 'shubham.lunawat', 'tzatakia', 'narkheden', 'abhijeetchavan', 'aakash3194', 'rohan21', 'sankheneel', 'bhavana.djs19', 'kanchan.phadtare', 'karishmamehta34', 'pbandewar', 'manishaagam999', 'meet.muchhala95', 'geetgandhi96', 'krusha14', 'gog40', 'rohancontractor.rc', 's.aditya.ghadiali', 'nittu.arsenal', 'kapsesainath', 'helloworld1', 'nagateja.vlsi', 'shah.shivani1702', 'vrushabhdesai007', 'ruchawaghulde', 'amey.2994', 'djeskay27', 'harshvardhandave1112', 'isaurabhbhirud7', 'thosarm', 'ps22ghule', 'tikikikik', 'riteshrajput381', 'aryakanika31', 'vora.jai1', None, 'azazeljam', 'pushkarvaity', 'guheak92', 'daminivyas9', 'shashankgangrade', 'mayureshvartak30', 'scapall', 'vandortshakti', 'chinmay', 'vishwanathan.anirudh']"
14,219,42,32,24,"['marlin', 'sherihannour', 'ahmed.deeb5862', 'ahmed.mohamed1281996', 'zeinab.ali96', 'omar.aadel58', 'michaeluhu', 'hagar26hossam', 'abdalrahman_gamal', 'abdovit54', 'rimon', 'ra', 'tasneemasememam', 'tote641', 'vamosrafa199795', 'aya.noby', 'minafadel', 'mayarmahmoud', 'rizkengin', 'sinderila030', 'nadoda3', 'salmakhaled248', 'shepherd_96', 'maudi126']",17,"['manar.ashraf373', 'has19xx', 'abanoubharby', 'bluerose', 'ahmedghoniem57', 'yasserm.ali1', 'omar_khaled880', 'josephsafwat', 'omarhamdy1995', 'omarfouad2410', 'abdo96ali', 'charanreddy68', 'eleia2796', 'akramestta', 'mo7amed_gawad', 'junheena', 'm.samir12345']",8,"['abdo.koban', 'areeg', 'safaa_ahmed', 'ayaghobashy', 'maiwaleed0611', 'mostafaadel24', 'marinamedhat', None]",49,"['abdo.koban', 'bluerose', 'marlin', 'akramestta', 'sherihannour', 'ahmed.deeb5862', 'ahmed.mohamed1281996', 'junheena', 'zeinab.ali96', 'omar.aadel58', 'ayaghobashy', 'yasserm.ali1', 'michaeluhu', 'maiwaleed0611', 'omarhamdy1995', 'abdo96ali', 'charanreddy68', 'hagar26hossam', 'abdalrahman_gamal', 'abdovit54', 'has19xx', 'manar.ashraf373', 'areeg', 'rimon', 'ra', 'tasneemasememam', 'omar_khaled880', 'omarfouad2410', 'tote641', 'mostafaadel24', 'vamosrafa199795', 'eleia2796', 'marinamedhat', 'aya.noby', 'minafadel', 'mayarmahmoud', None, 'abanoubharby', 'safaa_ahmed', 'rizkengin', 'sinderila030', 'ahmedghoniem57', 'josephsafwat', 'nadoda3', 'mo7amed_gawad', 'salmakhaled248', 'shepherd_96', 'maudi126', 'm.samir12345']"
15,204,42,42,24,"['gsoto5', 'ldvillasenor01', 'christinagonzalez47', 'daramos5', 'knatera', 'aldom92', 'm.albert82', 'underdahl8', 'dgsalgadochavez', 'mlmoreck', 'eapalacioleos', 'elopez32', 'camendoza7', 'monkeybushes', 'jguerrero14', 'andres.medina.79219', 'santana1_77', 'priscilla.dls5', 'marcoscobos3', 'fonzeman23', 'jalapeno512', 'iou.0475', 'mjalvarezcomas', 'fernie_915']",17,"['eliraekerjordan', 'ibrahimelchami', 'rosaura_mm', 'bjk019', 'jp068', 'sindhubalaraju', 'joceydunn2', 'dmb058', 'mxcom88', 'rajeshmullangi', 'bimmel', 'fcmdf001', 'balaraju', 'jdr033', 'bgardeamesta', 'atreyo.mukherjee2011', 'hibarazmi']",18,"['alexmtz125', 'antonl09', 'valdezkevin41', 'drhodges', 'chrismacias37', 'memojr4444', 'mon.asia91', 'lambros41', 'victor10jimenez', 'raenriquezavalos', 'amartinez141', 'robjaquez11', 'galejandroca', 'gtcarranza2', 'jajurado3', None, 'rivera82', 'jcorona']",59,"['christinagonzalez47', 'bjk019', 'jp068', 'amartinez141', 'fcmdf001', 'robjaquez11', 'aldom92', 'm.albert82', 'underdahl8', 'dgsalgadochavez', 'dmb058', 'mlmoreck', 'eapalacioleos', 'elopez32', 'monkeybushes', 'jguerrero14', 'bgardeamesta', 'andres.medina.79219', 'ibrahimelchami', 'antonl09', 'valdezkevin41', 'memojr4444', 'mon.asia91', 'raenriquezavalos', 'balaraju', 'jdr033', 'victor10jimenez', 'priscilla.dls5', 'marcoscobos3', 'mjalvarezcomas', 'rajeshmullangi', 'galejandroca', 'gtcarranza2', 'jajurado3', 'gsoto5', 'ldvillasenor01', 'alexmtz125', 'daramos5', 'knatera', 'bimmel', 'eliraekerjordan', 'rosaura_mm', 'sindhubalaraju', 'joceydunn2', 'mxcom88', 'camendoza7', 'atreyo.mukherjee2011', 'hibarazmi', 'jcorona', 'santana1_77', 'drhodges', None, 'fonzeman23', 'jalapeno512', 'chrismacias37', 'iou.0475', 'lambros41', 'fernie_915', 'rivera82']"
15,201,42,16,1,['atreyo.mukherjee2011'],40,"['gsoto5', 'ldvillasenor01', 'christinagonzalez47', 'bjk019', 'jp068', 'daramos5', 'knatera', 'bimmel', 'fcmdf001', 'aldom92', 'eliraekerjordan', 'm.albert82', 'rosaura_mm', 'underdahl8', 'dgsalgadochavez', 'sindhubalaraju', 'joceydunn2', 'dmb058', 'mlmoreck', 'eapalacioleos', 'mxcom88', 'elopez32', 'monkeybushes', 'jguerrero14', 'bgardeamesta', 'camendoza7', 'andres.medina.79219', 'hibarazmi', 'santana1_77', 'ibrahimelchami', 'balaraju', 'jdr033', 'priscilla.dls5', 'marcoscobos3', 'fonzeman23', 'jalapeno512', 'iou.0475', 'mjalvarezcomas', 'fernie_915', 'rajeshmullangi']",15,"['debolt', 'nliu26', 'pyjang', 'nmaududi', 'sp1ke01', 'xuzblair', 'tulika91', 'max.cotton.71', 'houqiang1', 'navnano1034', 'am7155', 'wwhhxq', 'walka', 'asiddhan', None]",56,"['debolt', 'gsoto5', 'ldvillasenor01', 'nliu26', 'nmaududi', 'christinagonzalez47', 'bjk019', 'jp068', 'daramos5', 'knatera', 'max.cotton.71', 'bimmel', 'fcmdf001', 'aldom92', 'asiddhan', 'eliraekerjordan', 'm.albert82', 'rosaura_mm', 'underdahl8', 'dgsalgadochavez', 'sindhubalaraju', 'joceydunn2', 'dmb058', 'mlmoreck', 'eapalacioleos', 'mxcom88', 'elopez32', 'walka', 'monkeybushes', 'jguerrero14', 'bgardeamesta', 'camendoza7', 'atreyo.mukherjee2011', 'hibarazmi', 'andres.medina.79219', 'santana1_77', 'ibrahimelchami', 'pyjang', 'sp1ke01', 'xuzblair', 'tulika91', 'houqiang1', 'balaraju', 'jdr033', None, 'priscilla.dls5', 'marcoscobos3', 'fonzeman23', 'jalapeno512', 'iou.0475', 'mjalvarezcomas', 'navnano1034', 'am7155', 'fernie_915', 'rajeshmullangi', 'wwhhxq']"
15,207,42,11,6,"['eliraekerjordan', 'bjk019', 'jp068', 'dmb058', 'fcmdf001', 'jdr033']",35,"['gsoto5', 'ldvillasenor01', 'christinagonzalez47', 'daramos5', 'knatera', 'bimmel', 'aldom92', 'm.albert82', 'rosaura_mm', 'underdahl8', 'dgsalgadochavez', 'sindhubalaraju', 'joceydunn2', 'mlmoreck', 'eapalacioleos', 'mxcom88', 'elopez32', 'monkeybushes', 'jguerrero14', 'bgardeamesta', 'camendoza7', 'atreyo.mukherjee2011', 'hibarazmi', 'andres.medina.79219', 'santana1_77', 'ibrahimelchami', 'balaraju', 'priscilla.dls5', 'marcoscobos3', 'fonzeman23', 'jalapeno512', 'iou.0475', 'mjalvarezcomas', 'fernie_915', 'rajeshmullangi']",5,"['basicresearcher', None, 'lbv001', 'rhf015', 'ler017']",46,"['gsoto5', 'ldvillasenor01', 'christinagonzalez47', 'bjk019', 'jp068', 'daramos5', 'knatera', 'bimmel', 'fcmdf001', 'rhf015', 'aldom92', 'eliraekerjordan', 'm.albert82', 'rosaura_mm', 'basicresearcher', 'underdahl8', 'dgsalgadochavez', 'sindhubalaraju', 'joceydunn2', 'dmb058', 'mlmoreck', 'eapalacioleos', 'mxcom88', 'elopez32', 'monkeybushes', 'jguerrero14', 'bgardeamesta', 'camendoza7', 'atreyo.mukherjee2011', 'hibarazmi', 'andres.medina.79219', 'santana1_77', 'ibrahimelchami', 'balaraju', 'jdr033', None, 'priscilla.dls5', 'marcoscobos3', 'fonzeman23', 'jalapeno512', 'iou.0475', 'lbv001', 'mjalvarezcomas', 'fernie_915', 'rajeshmullangi', 'ler017']"
16,136,40,28,26,"['jgidzinski93', 'johnnywatts92', 'theempire192', 'eag65', 'katelyn.n.kavanaugh', 'madeline.a.bouchard', 'peo26', 'cpnano', 'nicholasmicheal16', 'paulcheung64', 'noverbeck', 'triplethreat4ha', 'atyler2', 'ghb28', 'fberg.david', 'david.m.pearson', 'cmh429', 'rsamost', 'asc74', 'wcm39', 'mwr365', 'tcw43', 'catania.ryan4', 'lallan', 'laine1028', 'dlewisv44']",13,"['fuma', 'kiwolf2', 'sayeedmohammed449', 'ckcamy1216', 'nihanth1209', 'brgaire', 'hmansour5', 'rg6', 'ntloving', 'nimmyloving', 'moralist', 'jrmwriting', 'errfreem']",2,"['gtucker', None]",41,"['fuma', 'kiwolf2', 'jgidzinski93', 'ckcamy1216', 'johnnywatts92', 'theempire192', 'hmansour5', 'eag65', 'katelyn.n.kavanaugh', 'madeline.a.bouchard', 'sayeedmohammed449', 'peo26', 'cpnano', 'gtucker', 'nicholasmicheal16', 'paulcheung64', 'moralist', 'noverbeck', 'triplethreat4ha', 'atyler2', 'errfreem', 'ghb28', 'david.m.pearson', 'cmh429', 'fberg.david', 'rsamost', 'asc74', 'jrmwriting', None, 'wcm39', 'mwr365', 'nihanth1209', 'brgaire', 'lallan', 'catania.ryan4', 'tcw43', 'ntloving', 'nimmyloving', 'laine1028', 'rg6', 'dlewisv44']"
16,134,40,7,1,['fuma'],38,"['kiwolf2', 'jgidzinski93', 'ckcamy1216', 'johnnywatts92', 'theempire192', 'hmansour5', 'eag65', 'katelyn.n.kavanaugh', 'madeline.a.bouchard', 'sayeedmohammed449', 'peo26', 'cpnano', 'nicholasmicheal16', 'paulcheung64', 'moralist', 'noverbeck', 'triplethreat4ha', 'atyler2', 'errfreem', 'ghb28', 'david.m.pearson', 'cmh429', 'fberg.david', 'rsamost', 'asc74', 'jrmwriting', 'wcm39', 'mwr365', 'nihanth1209', 'brgaire', 'lallan', 'catania.ryan4', 'tcw43', 'ntloving', 'nimmyloving', 'laine1028', 'rg6', 'dlewisv44']",6,"['goranka', 'banivana5', 'josipaugustin', 'ivicakicic', None, 'marko.barbancic']",45,"['fuma', 'kiwolf2', 'jgidzinski93', 'ckcamy1216', 'johnnywatts92', 'theempire192', 'hmansour5', 'banivana5', 'eag65', 'josipaugustin', 'katelyn.n.kavanaugh', 'madeline.a.bouchard', 'sayeedmohammed449', 'peo26', 'cpnano', 'nicholasmicheal16', 'marko.barbancic', 'paulcheung64', 'moralist', 'noverbeck', 'triplethreat4ha', 'atyler2', 'errfreem', 'ivicakicic', 'ghb28', 'david.m.pearson', 'cmh429', 'fberg.david', 'rsamost', 'asc74', 'jrmwriting', 'goranka', None, 'wcm39', 'mwr365', 'nihanth1209', 'brgaire', 'lallan', 'catania.ryan4', 'tcw43', 'ntloving', 'nimmyloving', 'laine1028', 'rg6', 'dlewisv44']"
16,135,40,7,1,['fuma'],38,"['kiwolf2', 'jgidzinski93', 'ckcamy1216', 'johnnywatts92', 'theempire192', 'hmansour5', 'eag65', 'katelyn.n.kavanaugh', 'madeline.a.bouchard', 'sayeedmohammed449', 'peo26', 'cpnano', 'nicholasmicheal16', 'paulcheung64', 'moralist', 'noverbeck', 'triplethreat4ha', 'atyler2', 'errfreem', 'ghb28', 'david.m.pearson', 'cmh429', 'fberg.david', 'rsamost', 'asc74', 'jrmwriting', 'wcm39', 'mwr365', 'nihanth1209', 'brgaire', 'lallan', 'catania.ryan4', 'tcw43', 'ntloving', 'nimmyloving', 'laine1028', 'rg6', 'dlewisv44']",6,"['goranka', 'banivana5', 'jobakula', 'josipaugustin', None, 'marko.barbancic']",45,"['fuma', 'kiwolf2', 'jgidzinski93', 'ckcamy1216', 'johnnywatts92', 'theempire192', 'hmansour5', 'banivana5', 'eag65', 'josipaugustin', 'katelyn.n.kavanaugh', 'madeline.a.bouchard', 'sayeedmohammed449', 'peo26', 'cpnano', 'nicholasmicheal16', 'marko.barbancic', 'jobakula', 'paulcheung64', 'moralist', 'noverbeck', 'triplethreat4ha', 'atyler2', 'errfreem', 'ghb28', 'david.m.pearson', 'cmh429', 'fberg.david', 'rsamost', 'asc74', 'jrmwriting', 'goranka', None, 'wcm39', 'mwr365', 'nihanth1209', 'brgaire', 'lallan', 'catania.ryan4', 'tcw43', 'ntloving', 'nimmyloving', 'laine1028', 'rg6', 'dlewisv44']"
16,132,40,6,1,['fuma'],38,"['kiwolf2', 'jgidzinski93', 'ckcamy1216', 'johnnywatts92', 'theempire192', 'hmansour5', 'eag65', 'katelyn.n.kavanaugh', 'madeline.a.bouchard', 'sayeedmohammed449', 'peo26', 'cpnano', 'nicholasmicheal16', 'paulcheung64', 'moralist', 'noverbeck', 'triplethreat4ha', 'atyler2', 'errfreem', 'ghb28', 'david.m.pearson', 'cmh429', 'fberg.david', 'rsamost', 'asc74', 'jrmwriting', 'wcm39', 'mwr365', 'nihanth1209', 'brgaire', 'lallan', 'catania.ryan4', 'tcw43', 'ntloving', 'nimmyloving', 'laine1028', 'rg6', 'dlewisv44']",5,"['banivana5', 'josipaugustin', 'ivicakicic', None, 'marko.barbancic']",44,"['fuma', 'kiwolf2', 'jgidzinski93', 'ckcamy1216', 'johnnywatts92', 'theempire192', 'hmansour5', 'banivana5', 'eag65', 'josipaugustin', 'katelyn.n.kavanaugh', 'madeline.a.bouchard', 'sayeedmohammed449', 'peo26', 'cpnano', 'nicholasmicheal16', 'marko.barbancic', 'paulcheung64', 'moralist', 'noverbeck', 'triplethreat4ha', 'atyler2', 'errfreem', 'ivicakicic', 'ghb28', 'david.m.pearson', 'cmh429', 'fberg.david', 'rsamost', 'asc74', 'jrmwriting', None, 'wcm39', 'mwr365', 'nihanth1209', 'brgaire', 'lallan', 'catania.ryan4', 'tcw43', 'ntloving', 'nimmyloving', 'laine1028', 'rg6', 'dlewisv44']"
17,221,38,43,34,"['jtdath', 'jsinibaldi', 'tuhlich', 'nickjcu', 'sidneygolliher', 'antonygillette', 'gaboth22', 'jtraub91', 'sammymhowe', 'zobeldavid', 'jbocinsky', 'david4101', 'coreyrn8', 'mronda', 'kstultz15', 'vsoliz', 'kristianlegcevic', 'jacksonecarroll', 'sten621', 'andrew_lemx', 'abarbeite', 'fengshui', 'docta', 'abkrepacki', 'slapeyre1993', 'guybrush', 'uchaudhry', 'bbanksg7', 'bkelly2014', 'mikesanchezuf', 'cmann0917', 'michael.correia', 'astainsby', 'ianmcodom']",3,"['abrandt94', 'chrislai95', 'mellotth']",9,"['joshuaagarth', 'jagnese', 'msciullo2010', 'adrianj95', 'alexdukes17', 'timothyjaggernauth305', 'charlelotfalla', 'klborowski', None]",46,"['tuhlich', 'antonygillette', 'gaboth22', 'jtraub91', 'klborowski', 'jbocinsky', 'chrislai95', 'kstultz15', 'jacksonecarroll', 'msciullo2010', 'mellotth', 'charlelotfalla', 'docta', 'joshuaagarth', 'adrianj95', 'uchaudhry', 'bkelly2014', 'abrandt94', 'mikesanchezuf', 'cmann0917', 'michael.correia', 'jtdath', 'jsinibaldi', 'sidneygolliher', 'nickjcu', 'sammymhowe', 'zobeldavid', 'david4101', 'coreyrn8', 'mronda', 'vsoliz', 'jagnese', 'kristianlegcevic', 'sten621', 'andrew_lemx', 'abarbeite', 'fengshui', 'abkrepacki', 'slapeyre1993', 'guybrush', 'bbanksg7', 'alexdukes17', None, 'astainsby', 'timothyjaggernauth305', 'ianmcodom']"
17,51,38,42,32,"['jtdath', 'jsinibaldi', 'tuhlich', 'nickjcu', 'sidneygolliher', 'antonygillette', 'gaboth22', 'jtraub91', 'zobeldavid', 'jbocinsky', 'david4101', 'coreyrn8', 'mronda', 'kstultz15', 'vsoliz', 'kristianlegcevic', 'jacksonecarroll', 'sten621', 'andrew_lemx', 'fengshui', 'docta', 'abkrepacki', 'slapeyre1993', 'guybrush', 'uchaudhry', 'bbanksg7', 'bkelly2014', 'mikesanchezuf', 'cmann0917', 'michael.correia', 'astainsby', 'ianmcodom']",5,"['chrislai95', 'mellotth', 'abarbeite', 'sammymhowe', 'abrandt94']",10,"['tjaggernauth305', 'jagnese', 'adrianj95', 'wanrunlai', 'guoj', 'charlelotfalla', 'klborowski', None, 'adrianj25', 'jagarth']",47,"['tuhlich', 'antonygillette', 'gaboth22', 'jtraub91', 'klborowski', 'jbocinsky', 'chrislai95', 'kstultz15', 'jacksonecarroll', 'mellotth', 'charlelotfalla', 'docta', 'adrianj95', 'uchaudhry', 'bkelly2014', 'abrandt94', 'mikesanchezuf', 'cmann0917', 'michael.correia', 'wanrunlai', 'guoj', 'tjaggernauth305', 'adrianj25', 'jtdath', 'jsinibaldi', 'sidneygolliher', 'nickjcu', 'sammymhowe', 'zobeldavid', 'david4101', 'coreyrn8', 'mronda', 'vsoliz', 'jagnese', 'kristianlegcevic', 'sten621', 'andrew_lemx', 'abarbeite', 'fengshui', 'abkrepacki', 'slapeyre1993', 'guybrush', 'bbanksg7', None, 'jagarth', 'astainsby', 'ianmcodom']"
17,151,38,40,36,"['jtdath', 'jsinibaldi', 'tuhlich', 'nickjcu', 'sidneygolliher', 'antonygillette', 'gaboth22', 'jtraub91', 'sammymhowe', 'zobeldavid', 'jbocinsky', 'david4101', 'coreyrn8', 'mronda', 'chrislai95', 'kstultz15', 'vsoliz', 'kristianlegcevic', 'jacksonecarroll', 'sten621', 'andrew_lemx', 'abarbeite', 'fengshui', 'docta', 'abkrepacki', 'slapeyre1993', 'guybrush', 'uchaudhry', 'bbanksg7', 'bkelly2014', 'abrandt94', 'mikesanchezuf', 'cmann0917', 'michael.correia', 'astainsby', 'ianmcodom']",1,['mellotth'],4,"['joshuaagarth', None, 'dukesalex17', 'adrianj25']",41,"['tuhlich', 'antonygillette', 'gaboth22', 'jtraub91', 'jbocinsky', 'chrislai95', 'kstultz15', 'jacksonecarroll', 'mellotth', 'docta', 'joshuaagarth', 'dukesalex17', 'uchaudhry', 'bkelly2014', 'abrandt94', 'mikesanchezuf', 'cmann0917', 'michael.correia', 'adrianj25', 'jtdath', 'jsinibaldi', 'sidneygolliher', 'nickjcu', 'sammymhowe', 'zobeldavid', 'david4101', 'coreyrn8', 'mronda', 'vsoliz', 'kristianlegcevic', 'sten621', 'andrew_lemx', 'abarbeite', 'fengshui', 'abkrepacki', 'slapeyre1993', 'guybrush', 'bbanksg7', None, 'astainsby', 'ianmcodom']"
18,259,37,156,6,"['scaskey', 'song405', 'gramchan123', 'mcclurr', 'mpelleg', 'porter28']",30,"['hopkin12', 'f1sch3r88', 'mhodgson', 'mlokanat', 'tiom99', 'pburgeso', 'weckman', 'zhou6510', 'cvaughn0121', 'cheng109', 'jnarkar', 'bennet42', 'trevorzook', 'bkusler', 'simms3', 'pjaron', 'cr88', 'jguncheo', 'jseymour', 'pparitos', 'ee14mtech11023', 'benbrowne', 'russo6', 'liujiawei', 'liu1460', 'datta0', 'adeutchm', 'mwasilew', 'gshivkum', 'mchinnic']",150,"['nczapla', 'murtuza.shergadwala', 'sharma55', 'dstechma', 'gdesam', 'ben.helfrecht', 'gwilfong', 'utsavac', 'gah', 'btanasoi', 'pmeunier', 'nljacobs5', 'dienstfrey', 'valencid', 'kcidkcid1992', 'yang912', 'ewilson000', 'cao42', 'jy009', 'tseng1', 'adithyabhattachar', 'woods41', 'kwojo314', 'clarksm', 'baker251', 'ckatinas', 'kevin60105', 'shruti1205', 'kluitjoh', 'mike409', 'anepak123', 'wang159', 'prasadsarang', 'jgeng', 'ssjadeguardian', 'li1114', 'marisol', 'pikus', 'hu341', 'kmao', 'kennedym', 'puttha.math', 'chuyuanchen', 'cempekardan', 'simon38', 'aanghelus', 'borgesebastiao', 'jbeale', 'jseaton', 'hctest4', 'nmenglin', 'akshaydeshpande', 'xiaoshenwang', 'pastabasta8', 'swoop', 'kaiser1711', 'choi350', 'pseiler', 'turkstra', 'colley', 'jmynhier', 'ebilionis', 'richa203', 'davgumo', 'jduritsc95', 'nin', 'jung164', 'hranjan', 'tarekameen', 'bhaley', 'liang.dai', 'hctest3', 'polina.aleks', 'agarw103', 'nanohueb', 'xliu123', 'mmh', 'wayneisaacuy', 'light2', 'ldelgass', 'thelmus', 'chen1164', 'emorin', 'dkearney', 'kaimiao', 'boron1618', 'atankas', 'ashishmc', 'mischke', 'glassd', 'odary', 'jmcgough', 'woodswims', 'edantillon', 'kennell', 'fpena', 'bmsutton', 'araz.hashemi', 'zyf', 'bermel', 'claytok', 'denphi', 'chen1720', 'ahinkle5', 'giggerota', 'liu1512', 'pyles', 'wood67', 'samikm', 'clarksnano', 'chang305', 'apps', 'ajebakum', 'allredt', 'lou23', 'trungnguyen', 'felbr', 'tongyangshi', 'ekayser', 'piyush100078', 'schcats', 'kuehnel', 'fang85', 'jiruotong', 'jmethel', 'jhollkam', 'bartos', 'kumar167', 'wsanche2', 'mbedard', 'robisonj', 'zhou523', 'enassakr', 'djcarr', 'robin198', 'mbeason', 'zhuangxinghao', 'luizescalco', 'kmargata', 'markarios345', 'njtsh', None, 'ma319', 'dnaragan', 'chinyi', '10gauravpatankar', 'vos', 'mullen6', 'strachan', 'glin75']",186,"['nczapla', 'murtuza.shergadwala', 'sharma55', 'dstechma', 'gdesam', 'mhodgson', 'ben.helfrecht', 'gwilfong', 'utsavac', 'gah', 'btanasoi', 'pmeunier', 'nljacobs5', 'zhou6510', 'dienstfrey', 'valencid', 'kcidkcid1992', 'mcclurr', 'yang912', 'ewilson000', 'cao42', 'jy009', 'tseng1', 'scaskey', 'adithyabhattachar', 'woods41', 'kwojo314', 'cr88', 'clarksm', 'baker251', 'ckatinas', 'kevin60105', 'shruti1205', 'kluitjoh', 'pparitos', 'mike409', 'anepak123', 'wang159', 'prasadsarang', 'jgeng', 'ssjadeguardian', 'li1114', 'marisol', 'mchinnic', 'pikus', 'hu341', 'kmao', 'hopkin12', 'kennedym', 'puttha.math', 'chuyuanchen', 'cempekardan', 'simon38', 'aanghelus', 'borgesebastiao', 'jbeale', 'jseaton', 'pburgeso', 'hctest4', 'weckman', 'nmenglin', 'akshaydeshpande', 'xiaoshenwang', 'pastabasta8', 'gramchan123', 'song405', 'swoop', 'kaiser1711', 'choi350', 'pseiler', 'turkstra', 'colley', 'jmynhier', 'ebilionis', 'richa203', 'pjaron', 'davgumo', 'jduritsc95', 'jguncheo', 'nin', 'jung164', 'benbrowne', 'hranjan', 'tarekameen', 'bhaley', 'liang.dai', 'hctest3', 'polina.aleks', 'liu1460', 'agarw103', 'adeutchm', 'nanohueb', 'xliu123', 'mmh', 'mpelleg', 'wayneisaacuy', 'light2', 'ldelgass', 'thelmus', 'chen1164', 'emorin', 'dkearney', 'kaimiao', 'f1sch3r88', 'boron1618', 'mlokanat', 'atankas', 'ashishmc', 'mischke', 'glassd', 'tiom99', 'odary', 'jmcgough', 'woodswims', 'edantillon', 'cvaughn0121', 'kennell', 'fpena', 'jnarkar', 'bmsutton', 'araz.hashemi', 'trevorzook', 'bkusler', 'simms3', 'zyf', 'bermel', 'claytok', 'ee14mtech11023', 'denphi', 'liujiawei', 'chen1720', 'mwasilew', 'ahinkle5', 'gshivkum', 'giggerota', 'liu1512', 'pyles', 'wood67', 'samikm', 'clarksnano', 'chang305', 'apps', 'ajebakum', 'allredt', 'lou23', 'trungnguyen', 'felbr', 'tongyangshi', 'ekayser', 'porter28', 'piyush100078', 'schcats', 'kuehnel', 'fang85', 'jiruotong', 'jmethel', 'jhollkam', 'bartos', 'kumar167', 'wsanche2', 'mbedard', 'cheng109', 'robisonj', 'zhou523', 'enassakr', 'djcarr', 'bennet42', 'robin198', 'mbeason', 'zhuangxinghao', 'luizescalco', 'jseymour', 'kmargata', 'markarios345', 'njtsh', None, 'ma319', 'dnaragan', 'russo6', 'chinyi', '10gauravpatankar', 'datta0', 'vos', 'mullen6', 'strachan', 'glin75']"
18,265,37,21,4,"['bkusler', 'hopkin12', 'russo6', 'cvaughn0121']",32,"['f1sch3r88', 'mhodgson', 'mlokanat', 'porter28', 'tiom99', 'pburgeso', 'weckman', 'zhou6510', 'gramchan123', 'song405', 'mcclurr', 'cheng109', 'jnarkar', 'bennet42', 'trevorzook', 'simms3', 'scaskey', 'pjaron', 'cr88', 'jguncheo', 'jseymour', 'pparitos', 'ee14mtech11023', 'benbrowne', 'liujiawei', 'liu1460', 'datta0', 'adeutchm', 'mwasilew', 'gshivkum', 'mpelleg', 'mchinnic']",17,"['kennedym', 'jmcgough', 'jrosa', 'chinyi', None, 'jpalsdot', 'claytok', 'joydeep.loveuall', 'xliu123', 'giggerota', 'hranjan', 'atankas', 'nin', 'pyles', 'cao42', 'quintero', 'fukuda555']",53,"['hopkin12', 'kennedym', 'f1sch3r88', 'jpalsdot', 'mhodgson', 'mlokanat', 'atankas', 'porter28', 'tiom99', 'quintero', 'pburgeso', 'jmcgough', 'weckman', 'zhou6510', 'cvaughn0121', 'gramchan123', 'song405', 'mcclurr', 'cheng109', 'cao42', 'jnarkar', 'bennet42', 'trevorzook', 'bkusler', 'simms3', 'scaskey', 'claytok', 'pjaron', 'cr88', 'joydeep.loveuall', 'jguncheo', 'jseymour', 'pparitos', 'ee14mtech11023', 'nin', 'benbrowne', None, 'hranjan', 'fukuda555', 'russo6', 'jrosa', 'liujiawei', 'chinyi', 'liu1460', 'datta0', 'adeutchm', 'mwasilew', 'gshivkum', 'xliu123', 'giggerota', 'mpelleg', 'pyles', 'mchinnic']"
18,268,37,20,1,['jnarkar'],35,"['hopkin12', 'f1sch3r88', 'mhodgson', 'mlokanat', 'tiom99', 'porter28', 'pburgeso', 'weckman', 'zhou6510', 'cvaughn0121', 'gramchan123', 'song405', 'mcclurr', 'cheng109', 'bennet42', 'trevorzook', 'bkusler', 'simms3', 'scaskey', 'pjaron', 'cr88', 'jguncheo', 'jseymour', 'pparitos', 'ee14mtech11023', 'benbrowne', 'russo6', 'liujiawei', 'liu1460', 'datta0', 'adeutchm', 'mwasilew', 'gshivkum', 'mpelleg', 'mchinnic']",19,"['wallacjn', 'gdesam', 'btanasoi', 'rgeorge', 'blackfire962', 'erciyuanwd', 'xie215', 'mbeason', 'zhuangxinghao', 'jduritsc95', 'shruti1205', 'yilunyang', None, 'txvwxyz', 'agarw103', 'vos', 'kingston', 'cai157', 'wu937']",55,"['hopkin12', 'wallacjn', 'f1sch3r88', 'gdesam', 'mhodgson', 'mlokanat', 'porter28', 'tiom99', 'btanasoi', 'pburgeso', 'rgeorge', 'weckman', 'zhou6510', 'blackfire962', 'cvaughn0121', 'gramchan123', 'song405', 'mcclurr', 'erciyuanwd', 'xie215', 'cheng109', 'jnarkar', 'bennet42', 'trevorzook', 'bkusler', 'simms3', 'scaskey', 'mbeason', 'zhuangxinghao', 'pjaron', 'cr88', 'jduritsc95', 'jguncheo', 'shruti1205', 'jseymour', 'pparitos', 'ee14mtech11023', 'yilunyang', 'benbrowne', None, 'txvwxyz', 'russo6', 'liujiawei', 'liu1460', 'agarw103', 'datta0', 'vos', 'adeutchm', 'mwasilew', 'kingston', 'gshivkum', 'cai157', 'mpelleg', 'wu937', 'mchinnic']"
18,270,37,19,1,['jnarkar'],35,"['hopkin12', 'f1sch3r88', 'mhodgson', 'mlokanat', 'tiom99', 'porter28', 'pburgeso', 'weckman', 'zhou6510', 'cvaughn0121', 'gramchan123', 'song405', 'mcclurr', 'cheng109', 'bennet42', 'trevorzook', 'bkusler', 'simms3', 'scaskey', 'pjaron', 'cr88', 'jguncheo', 'jseymour', 'pparitos', 'ee14mtech11023', 'benbrowne', 'russo6', 'liujiawei', 'liu1460', 'datta0', 'adeutchm', 'mwasilew', 'gshivkum', 'mpelleg', 'mchinnic']",18,"['rgeorge', 'meyers18', 'wallacjn', 'agarw103', 'ldelgass', 'vos', 'zhuangxinghao', 'kingston', 'gdesam', 'cai157', 'shruti1205', 'erciyuanwd', 'wu937', 'yilunyang', 'zhang824', None, 'txvwxyz', 'btanasoi']",54,"['hopkin12', 'wallacjn', 'f1sch3r88', 'gdesam', 'mhodgson', 'mlokanat', 'porter28', 'tiom99', 'btanasoi', 'pburgeso', 'rgeorge', 'weckman', 'zhou6510', 'cvaughn0121', 'gramchan123', 'song405', 'mcclurr', 'erciyuanwd', 'cheng109', 'jnarkar', 'bennet42', 'meyers18', 'trevorzook', 'bkusler', 'simms3', 'scaskey', 'zhuangxinghao', 'pjaron', 'cr88', 'jguncheo', 'shruti1205', 'jseymour', 'pparitos', 'ee14mtech11023', 'yilunyang', 'benbrowne', None, 'txvwxyz', 'russo6', 'liujiawei', 'liu1460', 'agarw103', 'datta0', 'vos', 'adeutchm', 'mwasilew', 'kingston', 'gshivkum', 'cai157', 'mpelleg', 'wu937', 'zhang824', 'mchinnic', 'ldelgass']"
18,267,37,18,2,"['hopkin12', 'tiom99']",34,"['f1sch3r88', 'mhodgson', 'mlokanat', 'porter28', 'pburgeso', 'weckman', 'zhou6510', 'cvaughn0121', 'gramchan123', 'song405', 'mcclurr', 'cheng109', 'jnarkar', 'bennet42', 'trevorzook', 'bkusler', 'simms3', 'scaskey', 'pjaron', 'cr88', 'jguncheo', 'jseymour', 'pparitos', 'ee14mtech11023', 'benbrowne', 'russo6', 'liujiawei', 'liu1460', 'datta0', 'adeutchm', 'mwasilew', 'gshivkum', 'mpelleg', 'mchinnic']",16,"['tsambor', 'kennedym', 'xinweiguo', 'tthomasg', None, 'carbaker', 'claytok', 'baker251', 'giggerota', 'kcidkcid1992', 'utsavac', 'atankas', 'xie215', 'piyush100078', 'hranjan', 'cao42']",52,"['hopkin12', 'kennedym', 'carbaker', 'f1sch3r88', 'mhodgson', 'mlokanat', 'utsavac', 'atankas', 'piyush100078', 'porter28', 'tiom99', 'pburgeso', 'weckman', 'zhou6510', 'cvaughn0121', 'gramchan123', 'song405', 'kcidkcid1992', 'mcclurr', 'xie215', 'cheng109', 'cao42', 'jnarkar', 'tsambor', 'bennet42', 'trevorzook', 'xinweiguo', 'bkusler', 'simms3', 'scaskey', 'claytok', 'pjaron', 'cr88', 'baker251', 'jguncheo', 'jseymour', 'pparitos', 'ee14mtech11023', 'benbrowne', 'hranjan', None, 'russo6', 'liujiawei', 'liu1460', 'tthomasg', 'datta0', 'adeutchm', 'mwasilew', 'gshivkum', 'giggerota', 'mpelleg', 'mchinnic']"
18,264,37,17,4,"['gshivkum', 'mlokanat', 'datta0', 'tiom99']",32,"['hopkin12', 'f1sch3r88', 'mhodgson', 'porter28', 'pburgeso', 'weckman', 'zhou6510', 'cvaughn0121', 'gramchan123', 'song405', 'mcclurr', 'cheng109', 'jnarkar', 'bennet42', 'trevorzook', 'bkusler', 'simms3', 'scaskey', 'pjaron', 'cr88', 'jguncheo', 'jseymour', 'pparitos', 'ee14mtech11023', 'benbrowne', 'russo6', 'liujiawei', 'liu1460', 'adeutchm', 'mwasilew', 'mpelleg', 'mchinnic']",13,"['rgeorge', 'meyers18', 'nczapla', 'agarw103', 'tseng1', 'vos', 'jduritsc95', 'gdesam', 'fanchen', 'erciyuanwd', 'yilunyang', 'zhang824', None]",49,"['hopkin12', 'nczapla', 'f1sch3r88', 'gdesam', 'mhodgson', 'fanchen', 'mlokanat', 'porter28', 'tiom99', 'pburgeso', 'rgeorge', 'weckman', 'zhou6510', 'cvaughn0121', 'gramchan123', 'song405', 'mcclurr', 'erciyuanwd', 'cheng109', 'jnarkar', 'bennet42', 'meyers18', 'trevorzook', 'bkusler', 'simms3', 'scaskey', 'tseng1', 'pjaron', 'cr88', 'jduritsc95', 'jguncheo', 'jseymour', 'pparitos', 'ee14mtech11023', 'yilunyang', 'benbrowne', None, 'russo6', 'liujiawei', 'liu1460', 'agarw103', 'datta0', 'vos', 'adeutchm', 'mwasilew', 'gshivkum', 'mpelleg', 'zhang824', 'mchinnic']"
18,271,37,15,1,['russo6'],35,"['hopkin12', 'f1sch3r88', 'mhodgson', 'mlokanat', 'tiom99', 'porter28', 'pburgeso', 'weckman', 'zhou6510', 'cvaughn0121', 'gramchan123', 'song405', 'mcclurr', 'cheng109', 'jnarkar', 'bennet42', 'trevorzook', 'bkusler', 'simms3', 'scaskey', 'pjaron', 'cr88', 'jguncheo', 'jseymour', 'pparitos', 'ee14mtech11023', 'benbrowne', 'liujiawei', 'liu1460', 'datta0', 'adeutchm', 'mwasilew', 'gshivkum', 'mpelleg', 'mchinnic']",14,"['kennedym', 'jmcgough', 'xinweiguo', 'akshaydeshpande', None, 'claytok', 'simon38', 'gdesam', 'giggerota', 'utsavac', 'nin', 'ashishmc', 'pyles', 'hranjan']",50,"['hopkin12', 'kennedym', 'f1sch3r88', 'simon38', 'gdesam', 'mhodgson', 'mlokanat', 'utsavac', 'ashishmc', 'porter28', 'tiom99', 'pburgeso', 'jmcgough', 'weckman', 'zhou6510', 'cvaughn0121', 'akshaydeshpande', 'gramchan123', 'song405', 'mcclurr', 'cheng109', 'jnarkar', 'bennet42', 'trevorzook', 'xinweiguo', 'bkusler', 'simms3', 'scaskey', 'claytok', 'pjaron', 'cr88', 'jguncheo', 'jseymour', 'pparitos', 'ee14mtech11023', 'nin', 'benbrowne', 'hranjan', None, 'russo6', 'liujiawei', 'liu1460', 'datta0', 'adeutchm', 'mwasilew', 'gshivkum', 'giggerota', 'mpelleg', 'pyles', 'mchinnic']"
18,273,37,13,1,['russo6'],35,"['hopkin12', 'f1sch3r88', 'mhodgson', 'mlokanat', 'tiom99', 'porter28', 'pburgeso', 'weckman', 'zhou6510', 'cvaughn0121', 'gramchan123', 'song405', 'mcclurr', 'cheng109', 'jnarkar', 'bennet42', 'trevorzook', 'bkusler', 'simms3', 'scaskey', 'pjaron', 'cr88', 'jguncheo', 'jseymour', 'pparitos', 'ee14mtech11023', 'benbrowne', 'liujiawei', 'liu1460', 'datta0', 'adeutchm', 'mwasilew', 'gshivkum', 'mpelleg', 'mchinnic']",12,"['kennedym', 'xinweiguo', 'agarw103', None, 'claytok', 'tadmor', 'simon38', 'baker251', 'clarksm', 'giggerota', 'pyles', 'hranjan']",48,"['hopkin12', 'kennedym', 'f1sch3r88', 'tadmor', 'simon38', 'mhodgson', 'mlokanat', 'porter28', 'tiom99', 'pburgeso', 'weckman', 'zhou6510', 'cvaughn0121', 'gramchan123', 'song405', 'mcclurr', 'cheng109', 'jnarkar', 'bennet42', 'trevorzook', 'xinweiguo', 'bkusler', 'simms3', 'scaskey', 'claytok', 'pjaron', 'cr88', 'baker251', 'clarksm', 'jguncheo', 'jseymour', 'pparitos', 'ee14mtech11023', 'benbrowne', 'hranjan', None, 'russo6', 'liujiawei', 'liu1460', 'agarw103', 'datta0', 'adeutchm', 'mwasilew', 'gshivkum', 'giggerota', 'mpelleg', 'pyles', 'mchinnic']"
18,266,37,6,3,"['pburgeso', 'zhou6510', 'cr88']",33,"['hopkin12', 'f1sch3r88', 'mhodgson', 'mlokanat', 'porter28', 'tiom99', 'weckman', 'cvaughn0121', 'gramchan123', 'song405', 'mcclurr', 'cheng109', 'jnarkar', 'bennet42', 'trevorzook', 'bkusler', 'simms3', 'scaskey', 'pjaron', 'jguncheo', 'jseymour', 'pparitos', 'ee14mtech11023', 'benbrowne', 'russo6', 'liujiawei', 'liu1460', 'datta0', 'adeutchm', 'mwasilew', 'gshivkum', 'mpelleg', 'mchinnic']",3,"['xiaoyifu', None, 'liu915']",39,"['hopkin12', 'f1sch3r88', 'mhodgson', 'mlokanat', 'porter28', 'tiom99', 'pburgeso', 'weckman', 'zhou6510', 'cvaughn0121', 'gramchan123', 'song405', 'mcclurr', 'cheng109', 'jnarkar', 'bennet42', 'trevorzook', 'bkusler', 'simms3', 'scaskey', 'pjaron', 'cr88', 'jguncheo', 'jseymour', 'pparitos', 'ee14mtech11023', 'benbrowne', None, 'russo6', 'liujiawei', 'liu1460', 'datta0', 'adeutchm', 'mwasilew', 'gshivkum', 'xiaoyifu', 'mpelleg', 'liu915', 'mchinnic']"
18,269,37,6,1,['jseymour'],35,"['hopkin12', 'f1sch3r88', 'mhodgson', 'mlokanat', 'porter28', 'tiom99', 'pburgeso', 'weckman', 'zhou6510', 'cvaughn0121', 'gramchan123', 'song405', 'mcclurr', 'cheng109', 'jnarkar', 'bennet42', 'trevorzook', 'bkusler', 'simms3', 'scaskey', 'pjaron', 'cr88', 'jguncheo', 'pparitos', 'ee14mtech11023', 'benbrowne', 'russo6', 'liujiawei', 'liu1460', 'datta0', 'adeutchm', 'mwasilew', 'gshivkum', 'mpelleg', 'mchinnic']",5,"['liu1512', 'xiaoyifu', 'xie215', 'liu915', None]",41,"['hopkin12', 'f1sch3r88', 'mhodgson', 'mlokanat', 'porter28', 'tiom99', 'pburgeso', 'weckman', 'zhou6510', 'cvaughn0121', 'gramchan123', 'song405', 'mcclurr', 'xie215', 'cheng109', 'jnarkar', 'bennet42', 'trevorzook', 'bkusler', 'simms3', 'scaskey', 'pjaron', 'cr88', 'jguncheo', 'jseymour', 'pparitos', 'ee14mtech11023', 'benbrowne', None, 'russo6', 'liujiawei', 'liu1460', 'datta0', 'adeutchm', 'mwasilew', 'gshivkum', 'liu1512', 'xiaoyifu', 'mpelleg', 'liu915', 'mchinnic']"
19,258,34,41,24,"['mjankowicz', 'dollarboy', 'mroux', 'schonbri', 'zhan1193', 'rhein', 'dblomek', 'zeng31purdue', 'lyeh1234', 'obrien70', 'liu991', 'love20', 'sdeschai', 'eholtzho', 'havins', 'rwilmes', 'duvall0', 'yang463', 'garrettwass', 'song223', 'jackie0212', 'spschriver', 'jordanterrell6161', 'butler34']",9,"['bkads1163', 'mtoomey', 'jcassady30', 'hhwan', 'song218', 'cdymond', 'abcazaz22', 'soltys', 'rencheck']",17,"['ckwok144', 'sun272', 'qlewis', 'wang1640', 'port', 'haojiex', 'jcompara', 'cshang', 'silverpick', 'tennocrama', 'tictonk', 'du21', 'gscofiel', None, 'hmacdon', 'krane', 'liquidxskull']",50,"['wang1640', 'jcompara', 'cshang', 'rencheck', 'hmacdon', 'mjankowicz', 'dollarboy', 'port', 'mroux', 'schonbri', 'jcassady30', 'zhan1193', 'haojiex', 'rhein', 'dblomek', 'zeng31purdue', 'silverpick', 'tictonk', 'cdymond', 'abcazaz22', 'gscofiel', 'soltys', 'lyeh1234', 'obrien70', 'liu991', 'love20', 'liquidxskull', 'bkads1163', 'jordanterrell6161', 'eholtzho', 'havins', 'hhwan', 'rwilmes', 'song218', 'duvall0', 'yang463', 'du21', None, 'garrettwass', 'song223', 'ckwok144', 'sun272', 'qlewis', 'mtoomey', 'jackie0212', 'spschriver', 'tennocrama', 'sdeschai', 'butler34', 'krane']"
20,258,33,41,12,"['ckwok144', 'sun272', 'qlewis', 'wang1640', 'port', 'haojiex', 'jcompara', 'tictonk', 'du21', 'gscofiel', 'hmacdon', 'liquidxskull']",20,"['ascaldwell', 'woodford', 'jonwuanu', 'sun530', 'jdesmon', 'zhang791', 'nagaalla', 'tang186', 'heeguneom', 'vacaal', 'mramazan', 'jandler', 'chen2086', 'chatter6', 'harneet159', 'xu666', 'adams265', 'jag06dish', 'rao34', 'luizescalco2']",29,"['cshang', 'mjankowicz', 'dollarboy', 'mroux', 'schonbri', 'zhan1193', 'rhein', 'silverpick', 'dblomek', 'zeng31purdue', 'lyeh1234', 'obrien70', 'liu991', 'love20', 'sdeschai', 'eholtzho', 'havins', 'rwilmes', 'duvall0', 'yang463', None, 'garrettwass', 'song223', 'jackie0212', 'spschriver', 'tennocrama', 'jordanterrell6161', 'butler34', 'krane']",61,"['ascaldwell', 'woodford', 'wang1640', 'jcompara', 'sun530', 'jonwuanu', 'cshang', 'jdesmon', 'zhang791', 'nagaalla', 'hmacdon', 'mjankowicz', 'tang186', 'dollarboy', 'heeguneom', 'vacaal', 'port', 'haojiex', 'mroux', 'schonbri', 'zhan1193', 'rhein', 'silverpick', 'dblomek', 'zeng31purdue', 'tictonk', 'gscofiel', 'lyeh1234', 'obrien70', 'liu991', 'liquidxskull', 'mramazan', 'love20', 'sdeschai', 'jordanterrell6161', 'jandler', 'eholtzho', 'chen2086', 'havins', 'butler34', 'rwilmes', 'chatter6', 'du21', 'harneet159', 'duvall0', 'yang463', 'xu666', None, 'garrettwass', 'song223', 'adams265', 'ckwok144', 'qlewis', 'jag06dish', 'jackie0212', 'spschriver', 'tennocrama', 'rao34', 'luizescalco2', 'sun272', 'krane']"
20,109,33,28,17,"['ascaldwell', 'qlewis', 'wang1640', 'jandler', 'haojiex', 'chen2086', 'mramazan', 'jcompara', 'sun530', 'jdesmon', 'chatter6', 'xu666', 'tictonk', 'du21', 'gscofiel', 'nagaalla', 'tang186']",15,"['adams265', 'ckwok144', 'sun272', 'heeguneom', 'woodford', 'vacaal', 'port', 'jonwuanu', 'jag06dish', 'rao34', 'harneet159', 'zhang791', 'luizescalco2', 'hmacdon', 'liquidxskull']",11,"['redwing', 'ajana', 'ksnvikrant', 'adithyabhattachar', 'cshang', 'kwojo314', 'luizescalco', 'ben.helfrecht', 'alcaraz', 'tsaha', None]",43,"['ascaldwell', 'woodford', 'wang1640', 'ajana', 'jcompara', 'sun530', 'jonwuanu', 'cshang', 'jdesmon', 'ben.helfrecht', 'zhang791', 'nagaalla', 'hmacdon', 'tang186', 'heeguneom', 'vacaal', 'port', 'haojiex', 'ksnvikrant', 'tictonk', 'alcaraz', 'gscofiel', 'liquidxskull', 'mramazan', 'redwing', 'jandler', 'chen2086', 'adithyabhattachar', 'kwojo314', 'chatter6', 'luizescalco', 'du21', 'harneet159', 'xu666', 'tsaha', None, 'adams265', 'ckwok144', 'qlewis', 'jag06dish', 'rao34', 'luizescalco2', 'sun272']"
21,157,31,43,27,"['carolinekittle', 'kevin950720', 'jiayu.shen', 'drw28', 'marialopes03', 'chenxi101', 'connor.garet', 'fishcaoru', 'chanwook128', 'cgdantoin', 'sunnyownage', 'charlesxu1995', 'amckee3', 'michaelyang95', 'zyl1024', 'henry.yuen', 'oo_its_kevin', 'varpra1', 'rex', 'lara_sonmez', 'flipflyfall', 'esonmez', 'kevinvan', 'tsengsation', 'yiranzhu1994', 'afrankl', 'rmanchenella']",3,"['deep112890', 'nasttyneel', 'kyiin']",16,"['cassidee.kido', 'henryyan829', 'anika.radiya', 'clx', 'mjy62004', 'veraxrl', 'johnny', 'dakotabrinkman', 'ahua710', 'chinjielim', 'juanpablogf95', 'earnedkibbles', 'mym987', 'jrl48', None, 'radithya93']",46,"['kevin950720', 'jiayu.shen', 'drw28', 'earnedkibbles', 'nasttyneel', 'cassidee.kido', 'chanwook128', 'mym987', 'amckee3', 'zyl1024', 'varpra1', 'rex', 'lara_sonmez', 'jrl48', 'yiranzhu1994', 'ahua710', 'afrankl', 'rmanchenella', 'radithya93', 'carolinekittle', 'johnny', 'deep112890', 'marialopes03', 'kyiin', 'mjy62004', 'chenxi101', 'veraxrl', 'connor.garet', 'dakotabrinkman', 'fishcaoru', 'cgdantoin', 'juanpablogf95', 'sunnyownage', 'michaelyang95', 'henryyan829', 'anika.radiya', 'henry.yuen', 'oo_its_kevin', 'flipflyfall', 'esonmez', 'kevinvan', None, 'tsengsation', 'clx', 'chinjielim', 'charlesxu1995']"
22,226,31,24,20,"['suwanan_bum38', 'joker_5248', 'tawareet0', 'mn_cream21x', 'atomlek.za123', 'earn', 'aoy.sasithorn.som.jiupra', 'k.parnkham', 'thiti', 'liverpool_criss_dek_hong', 'namoiy_minho', 'kamon.99.f', 'cheekwang.jokcup', 'hohohooo1', 'phat95', 'manuschanok.music', 'ja_mint', 'hirotex.msn05', 'i_am_kaew', 'cm.cream6554']",10,"['seanmkelley11', 'sanlikose', 'squadteam', 'pornjira.v', 'minning_nidkan', 'mocona_13', 'lacoste14462006', 'selvamaninano', 'hanover.daniel', 'hi.porag']",4,"['gift_29121995', None, 'tawareet', 'yuttaana123']",34,"['suwanan_bum38', 'seanmkelley11', 'joker_5248', 'tawareet0', 'pornjira.v', 'mocona_13', 'hanover.daniel', 'mn_cream21x', 'yuttaana123', 'atomlek.za123', 'earn', 'aoy.sasithorn.som.jiupra', 'k.parnkham', 'minning_nidkan', 'thiti', 'gift_29121995', 'tawareet', 'liverpool_criss_dek_hong', 'squadteam', 'namoiy_minho', 'hi.porag', None, 'kamon.99.f', 'cheekwang.jokcup', 'hohohooo1', 'phat95', 'sanlikose', 'manuschanok.music', 'ja_mint', 'hirotex.msn05', 'cm.cream6554', 'i_am_kaew', 'lacoste14462006', 'selvamaninano']"
22,224,31,15,13,"['cheekwang.jokcup', 'mn_cream21x', 'hohohooo1', 'phat95', 'manuschanok.music', 'pornjira.v', 'i_am_kaew', 'namoiy_minho', 'minning_nidkan', 'mocona_13', 'earn', 'thiti', 'kamon.99.f']",17,"['suwanan_bum38', 'seanmkelley11', 'liverpool_criss_dek_hong', 'joker_5248', 'sanlikose', 'tawareet0', 'squadteam', 'ja_mint', 'hirotex.msn05', 'atomlek.za123', 'aoy.sasithorn.som.jiupra', 'cm.cream6554', 'k.parnkham', 'lacoste14462006', 'selvamaninano', 'hanover.daniel', 'hi.porag']",2,"['tpuangmali', None]",32,"['suwanan_bum38', 'seanmkelley11', 'joker_5248', 'tawareet0', 'pornjira.v', 'mocona_13', 'hanover.daniel', 'mn_cream21x', 'tpuangmali', 'atomlek.za123', 'earn', 'aoy.sasithorn.som.jiupra', 'k.parnkham', 'minning_nidkan', 'thiti', 'liverpool_criss_dek_hong', 'squadteam', 'namoiy_minho', 'hi.porag', None, 'kamon.99.f', 'cheekwang.jokcup', 'hohohooo1', 'phat95', 'sanlikose', 'manuschanok.music', 'ja_mint', 'hirotex.msn05', 'cm.cream6554', 'i_am_kaew', 'lacoste14462006', 'selvamaninano']"
22,225,31,14,11,"['hohohooo1', 'liverpool_criss_dek_hong', 'squadteam', 'pornjira.v', 'hirotex.msn05', 'atomlek.za123', 'minning_nidkan', 'mocona_13', 'aoy.sasithorn.som.jiupra', 'thiti', 'kamon.99.f']",19,"['suwanan_bum38', 'seanmkelley11', 'joker_5248', 'tawareet0', 'hanover.daniel', 'mn_cream21x', 'earn', 'k.parnkham', 'namoiy_minho', 'hi.porag', 'cheekwang.jokcup', 'phat95', 'sanlikose', 'manuschanok.music', 'ja_mint', 'cm.cream6554', 'i_am_kaew', 'lacoste14462006', 'selvamaninano']",3,"['gift_29121995', None, 'tawareet']",33,"['suwanan_bum38', 'seanmkelley11', 'joker_5248', 'tawareet0', 'pornjira.v', 'mocona_13', 'hanover.daniel', 'mn_cream21x', 'atomlek.za123', 'earn', 'aoy.sasithorn.som.jiupra', 'k.parnkham', 'minning_nidkan', 'thiti', 'gift_29121995', 'tawareet', 'liverpool_criss_dek_hong', 'squadteam', 'namoiy_minho', 'hi.porag', None, 'kamon.99.f', 'cheekwang.jokcup', 'hohohooo1', 'phat95', 'sanlikose', 'manuschanok.music', 'ja_mint', 'hirotex.msn05', 'cm.cream6554', 'i_am_kaew', 'lacoste14462006', 'selvamaninano']"
23,183,30,100,23,"['liupufan', 'shenxinrusue', 'halstar9', 'ruining22', 'slipperyjack007', 'wosabi95', 'zhensun_5', 'crosent2', 'eaallen', 'elindgren', 'gracepakeltis', 'bacchanalianomark', 'charmisuk', 'yliu181', 'dman5505', 'zuojulia', 'dianeluvsart', 'zshen15', 'sniperzx13', 'carolgu', 'yyao13', 'sho1123', 'mmkurth2']",6,"['25.kushagra', 'shenyuwu94', 'dannyc', 'johnny23', 'woo4', 'gooneti2']",77,"['sali12', 'knipfer2', 'buhl2', 'dlitt2', 'reisber2', 'brendaneng1', 'pakelti2', 'hhardin2', 'shoppe3', 'jaikarnik95', 'tianshu2', 'junehan1', 'werkkdy2', 'jxiong7', 'dkuai2', 'warpins2', 'samsrajer', 'jdray2', 'avelard2', 'fpkelly2', 'lachwsk2', 'dpfoste2', 'dshi10', 'mchu5', 'aln', 'zhensun5', 'statar2', 'sloneil21994', 'amango4', 'yifanyao', 'dli29', 'jacobcamp1', 'antony.huang.129', 'mbmoy2', 'lin.joanna.y', 'ruining2', 'kagebei2', 'zhoffm', 'nlee17', 'cnlopes12', 'ecyoung', 'asimha2', 'ahjames2', 'ed.tir.1', 'jefrin', 'brgschn2', 'alvinlvalysa', 'jbeta95', 'whu14', 'mpunuk', 'mingye.gao', 'hwang281', 'jedrals2', 'mantianxue0101', 'qinglin2', 'rishychacko', 'dsch33', 'melissagoetter', 'pjnick300', 'sdschmi2', 'vasyltheonly', 'mcheng94', 'ywada3', 'zwu27', 'laurentaylor', 'cwojtan', 'slbecke2', 'echo93924', 'emfoley14', 'chunxu2', None, 'billli1996', 'ntxuby', 'joylin0806', 'sikaufm2', 'adbrown3', 'jkim561']",106,"['sali12', 'knipfer2', 'buhl2', 'dlitt2', 'reisber2', 'dannyc', 'brendaneng1', 'pakelti2', 'halstar9', 'ruining22', 'wosabi95', 'hhardin2', 'shoppe3', 'gracepakeltis', 'jaikarnik95', 'tianshu2', 'zuojulia', 'junehan1', 'werkkdy2', 'jxiong7', 'dianeluvsart', 'gooneti2', '25.kushagra', 'dkuai2', 'warpins2', 'samsrajer', 'jdray2', 'avelard2', 'fpkelly2', 'lachwsk2', 'dpfoste2', 'dshi10', 'mchu5', 'aln', 'zhensun5', 'crosent2', 'statar2', 'dman5505', 'sloneil21994', 'amango4', 'yifanyao', 'dli29', 'jacobcamp1', 'sniperzx13', 'antony.huang.129', 'mbmoy2', 'yyao13', 'sho1123', 'lin.joanna.y', 'ruining2', 'kagebei2', 'nlee17', 'zhoffm', 'cnlopes12', 'liupufan', 'ecyoung', 'asimha2', 'ahjames2', 'ed.tir.1', 'jefrin', 'zhensun_5', 'woo4', 'eaallen', 'brgschn2', 'alvinlvalysa', 'jbeta95', 'elindgren', 'charmisuk', 'yliu181', 'shenyuwu94', 'whu14', 'mpunuk', 'mingye.gao', 'hwang281', 'jedrals2', 'mantianxue0101', 'zshen15', 'qinglin2', 'carolgu', 'rishychacko', 'dsch33', 'melissagoetter', 'shenxinrusue', 'pjnick300', 'sdschmi2', 'johnny23', 'vasyltheonly', 'slipperyjack007', 'mcheng94', 'ywada3', 'zwu27', 'laurentaylor', 'cwojtan', 'bacchanalianomark', 'slbecke2', 'echo93924', 'emfoley14', 'chunxu2', None, 'billli1996', 'ntxuby', 'joylin0806', 'mmkurth2', 'sikaufm2', 'adbrown3', 'jkim561']"
24,27,29,19,17,"['charpeterson', 'tdr7715', 'shehab.hamadi', 'geoffrey.a.munkvold', 'packerfan1991', 'robertmakin3', 'mojtaba.h.aljaffar', 'jacobtdean', 'djrozsi', 'smhaver221', 'munkvold91', 'mashayulanova', '7shortcircuits', 'mbj2428', 'borkowman6000', 'hasanihomayoun', 'isbrown0123']",11,"['zeinabjamalkhan', 'mariumw', 'usman92', 'mohsinawan91', 'mbilaljaffar', 'qhali', 'ahsansarwarrana', 'colllljay', 'konsbabo1993', 'gwn8867', 'umer9261']",2,"['frankseg', None]",30,"['zeinabjamalkhan', 'packerfan1991', 'mojtaba.h.aljaffar', 'qhali', 'mbilaljaffar', 'djrozsi', 'colllljay', 'ahsansarwarrana', 'smhaver221', 'umer9261', 'isbrown0123', 'tdr7715', 'usman92', 'munkvold91', 'konsbabo1993', 'gwn8867', '7shortcircuits', 'borkowman6000', 'hasanihomayoun', 'robertmakin3', 'mohsinawan91', 'mbj2428', 'mariumw', None, 'charpeterson', 'shehab.hamadi', 'geoffrey.a.munkvold', 'jacobtdean', 'mashayulanova', 'frankseg']"
24,23,29,11,7,"['zeinabjamalkhan', 'usman92', 'mohsinawan91', 'mbilaljaffar', 'qhali', 'mariumw', 'umer9261']",21,"['packerfan1991', 'mojtaba.h.aljaffar', 'ahsansarwarrana', 'colllljay', 'djrozsi', 'smhaver221', 'isbrown0123', 'tdr7715', 'munkvold91', 'konsbabo1993', 'gwn8867', '7shortcircuits', 'borkowman6000', 'hasanihomayoun', 'robertmakin3', 'mbj2428', 'charpeterson', 'shehab.hamadi', 'geoffrey.a.munkvold', 'jacobtdean', 'mashayulanova']",4,"['nbutt', 'sunny.nust', None, 'roha.ansari']",32,"['zeinabjamalkhan', 'sunny.nust', 'packerfan1991', 'mojtaba.h.aljaffar', 'qhali', 'mbilaljaffar', 'djrozsi', 'colllljay', 'ahsansarwarrana', 'smhaver221', 'umer9261', 'isbrown0123', 'tdr7715', 'usman92', 'munkvold91', 'konsbabo1993', 'gwn8867', '7shortcircuits', 'borkowman6000', 'hasanihomayoun', 'robertmakin3', 'mohsinawan91', 'mbj2428', 'mariumw', None, 'charpeterson', 'shehab.hamadi', 'geoffrey.a.munkvold', 'roha.ansari', 'jacobtdean', 'mashayulanova', 'nbutt']"
24,26,29,8,4,"['mariumw', 'umer9261', 'mbilaljaffar', 'qhali']",24,"['zeinabjamalkhan', 'packerfan1991', 'mojtaba.h.aljaffar', 'djrozsi', 'colllljay', 'ahsansarwarrana', 'smhaver221', 'isbrown0123', 'tdr7715', 'usman92', 'munkvold91', 'konsbabo1993', 'gwn8867', '7shortcircuits', 'borkowman6000', 'hasanihomayoun', 'robertmakin3', 'mohsinawan91', 'mbj2428', 'charpeterson', 'shehab.hamadi', 'geoffrey.a.munkvold', 'jacobtdean', 'mashayulanova']",4,"['nbutt', 'sunny.nust', None, 'roha.ansari']",32,"['zeinabjamalkhan', 'sunny.nust', 'packerfan1991', 'robertmakin3', 'mojtaba.h.aljaffar', 'mohsinawan91', 'qhali', 'mbilaljaffar', 'djrozsi', 'colllljay', 'ahsansarwarrana', 'smhaver221', 'hasanihomayoun', 'mbj2428', 'umer9261', 'mariumw', None, 'isbrown0123', 'charpeterson', 'tdr7715', 'shehab.hamadi', 'usman92', 'geoffrey.a.munkvold', 'roha.ansari', 'jacobtdean', 'munkvold91', 'mashayulanova', 'nbutt', 'konsbabo1993', 'gwn8867', 'borkowman6000', '7shortcircuits']"
24,24,29,7,3,"['zeinabjamalkhan', 'mohsinawan91', 'usman92']",25,"['packerfan1991', 'mojtaba.h.aljaffar', 'mbilaljaffar', 'qhali', 'djrozsi', 'colllljay', 'ahsansarwarrana', 'smhaver221', 'umer9261', 'isbrown0123', 'tdr7715', 'munkvold91', 'konsbabo1993', 'gwn8867', '7shortcircuits', 'borkowman6000', 'hasanihomayoun', 'robertmakin3', 'mbj2428', 'mariumw', 'charpeterson', 'shehab.hamadi', 'geoffrey.a.munkvold', 'jacobtdean', 'mashayulanova']",4,"['nbutt', 'sunny.nust', None, 'roha.ansari']",32,"['zeinabjamalkhan', 'sunny.nust', 'packerfan1991', 'robertmakin3', 'mojtaba.h.aljaffar', 'mohsinawan91', 'qhali', 'mbilaljaffar', 'djrozsi', 'colllljay', 'ahsansarwarrana', 'smhaver221', 'hasanihomayoun', 'mbj2428', 'umer9261', 'mariumw', None, 'isbrown0123', 'charpeterson', 'tdr7715', 'shehab.hamadi', 'usman92', 'geoffrey.a.munkvold', 'roha.ansari', 'jacobtdean', 'munkvold91', 'mashayulanova', 'nbutt', 'konsbabo1993', 'gwn8867', 'borkowman6000', '7shortcircuits']"
24,25,29,7,4,"['umer9261', 'zeinabjamalkhan', 'mbilaljaffar', 'usman92']",24,"['packerfan1991', 'mojtaba.h.aljaffar', 'qhali', 'djrozsi', 'colllljay', 'ahsansarwarrana', 'smhaver221', 'isbrown0123', 'tdr7715', 'munkvold91', 'konsbabo1993', 'gwn8867', '7shortcircuits', 'borkowman6000', 'hasanihomayoun', 'robertmakin3', 'mohsinawan91', 'mariumw', 'mbj2428', 'charpeterson', 'shehab.hamadi', 'geoffrey.a.munkvold', 'jacobtdean', 'mashayulanova']",3,"['sunny.nust', None, 'roha.ansari']",31,"['zeinabjamalkhan', 'sunny.nust', 'packerfan1991', 'robertmakin3', 'mojtaba.h.aljaffar', 'mohsinawan91', 'qhali', 'mbilaljaffar', 'djrozsi', 'colllljay', 'ahsansarwarrana', 'smhaver221', 'hasanihomayoun', 'mbj2428', 'umer9261', 'mariumw', None, 'isbrown0123', 'charpeterson', 'tdr7715', 'shehab.hamadi', 'usman92', 'geoffrey.a.munkvold', 'roha.ansari', 'jacobtdean', 'munkvold91', 'mashayulanova', 'konsbabo1993', 'gwn8867', 'borkowman6000', '7shortcircuits']"
25,256,29,27,25,"['wuzecheng2', 'littlepandayan', 'sxy4869', 'nanbo8', 'demose', 'lhao1', 'lksh1993', 'hswyxym', 'wizardnumber', 'zulhilmymohamed', 'wli34', 'sunrish', 'arthurfteelee', 'jianzhao', 'q1091551527', 'elp15sbs', 'nawal1516', 'liuhao901008', 'ykn2814', 'xuhao1209', 'bxu11', 'jzf132696254', 'ading1', 'wangshuo0514', 'elp15yn']",3,"['zqingtian2', 'nanochemgen', 'priyaank03']",2,"[None, 'premlal']",30,"['wuzecheng2', 'littlepandayan', 'priyaank03', 'sxy4869', 'nanbo8', 'zqingtian2', 'demose', 'premlal', 'lhao1', 'lksh1993', 'hswyxym', 'wizardnumber', 'nanochemgen', 'wli34', 'zulhilmymohamed', 'sunrish', 'arthurfteelee', 'jianzhao', 'q1091551527', 'elp15sbs', 'nawal1516', None, 'liuhao901008', 'ykn2814', 'xuhao1209', 'bxu11', 'jzf132696254', 'ading1', 'wangshuo0514', 'elp15yn']"
25,255,29,19,16,"['wuzecheng2', 'zulhilmymohamed', 'elp15yn', 'littlepandayan', 'ykn2814', 'xuhao1209', 'bxu11', 'arthurfteelee', 'lksh1993', 'sxy4869', 'ading1', 'nanbo8', 'demose', 'elp15sbs', 'wizardnumber', 'nawal1516']",12,"['nanochemgen', 'wli34', 'lhao1', 'liuhao901008', 'priyaank03', 'sunrish', 'q1091551527', 'wangshuo0514', 'jzf132696254', 'jianzhao', 'zqingtian2', 'hswyxym']",3,"['echoecho', None, 'ashz8888']",31,"['wuzecheng2', 'littlepandayan', 'priyaank03', 'sxy4869', 'nanbo8', 'zqingtian2', 'demose', 'lhao1', 'lksh1993', 'hswyxym', 'wizardnumber', 'nanochemgen', 'wli34', 'zulhilmymohamed', 'sunrish', 'arthurfteelee', 'jianzhao', 'q1091551527', 'echoecho', 'elp15sbs', 'nawal1516', None, 'liuhao901008', 'ykn2814', 'xuhao1209', 'bxu11', 'jzf132696254', 'ading1', 'ashz8888', 'wangshuo0514', 'elp15yn']"
26,259,28,156,5,"['puttha.math', 'araz.hashemi', 'pastabasta8', 'mike409', 'wayneisaacuy']",22,"['mbj117', 'zeadnws', 'weifufang', 'sungkwang', 'carla.estridge', 'kgarrity', 'jsturnfield', 'trosch', 'buzzard', 'linglewang', 'nathan.l.gibson', 'yannick.congo', 'blaiszik', 'spiyush1002', 'samuel.j.tucker', 'jeffrey.sanders', 'tkprasad2006', 'vonschwerin', 'roz36088', 'ralphsmith', 'sromanov412', 'ceduardo']",151,"['nczapla', 'murtuza.shergadwala', 'sharma55', 'dstechma', 'gdesam', 'ben.helfrecht', 'gwilfong', 'utsavac', 'gah', 'btanasoi', 'pmeunier', 'nljacobs5', 'dienstfrey', 'valencid', 'kcidkcid1992', 'yang912', 'mcclurr', 'ewilson000', 'cao42', 'jy009', 'tseng1', 'scaskey', 'adithyabhattachar', 'woods41', 'kwojo314', 'clarksm', 'baker251', 'ckatinas', 'kevin60105', 'shruti1205', 'kluitjoh', 'anepak123', 'wang159', 'prasadsarang', 'jgeng', 'ssjadeguardian', 'li1114', 'marisol', 'pikus', 'hu341', 'kmao', 'kennedym', 'chuyuanchen', 'cempekardan', 'simon38', 'aanghelus', 'borgesebastiao', 'jbeale', 'jseaton', 'hctest4', 'nmenglin', 'akshaydeshpande', 'xiaoshenwang', 'song405', 'gramchan123', 'swoop', 'kaiser1711', 'choi350', 'pseiler', 'turkstra', 'colley', 'jmynhier', 'ebilionis', 'richa203', 'davgumo', 'jduritsc95', 'nin', 'jung164', 'hranjan', 'tarekameen', 'bhaley', 'liang.dai', 'hctest3', 'polina.aleks', 'agarw103', 'nanohueb', 'xliu123', 'mmh', 'mpelleg', 'light2', 'ldelgass', 'thelmus', 'chen1164', 'emorin', 'dkearney', 'kaimiao', 'boron1618', 'atankas', 'ashishmc', 'mischke', 'glassd', 'odary', 'jmcgough', 'woodswims', 'edantillon', 'kennell', 'fpena', 'bmsutton', 'zyf', 'bermel', 'claytok', 'denphi', 'chen1720', 'ahinkle5', 'giggerota', 'liu1512', 'pyles', 'wood67', 'samikm', 'clarksnano', 'chang305', 'apps', 'ajebakum', 'allredt', 'lou23', 'trungnguyen', 'felbr', 'tongyangshi', 'ekayser', 'piyush100078', 'schcats', 'porter28', 'kuehnel', 'fang85', 'jiruotong', 'jmethel', 'jhollkam', 'bartos', 'kumar167', 'wsanche2', 'mbedard', 'robisonj', 'zhou523', 'enassakr', 'djcarr', 'robin198', 'mbeason', 'zhuangxinghao', 'luizescalco', 'kmargata', 'markarios345', 'njtsh', None, 'ma319', 'dnaragan', 'chinyi', '10gauravpatankar', 'vos', 'mullen6', 'strachan', 'glin75']",178,"['nczapla', 'murtuza.shergadwala', 'sharma55', 'dstechma', 'gdesam', 'ben.helfrecht', 'gwilfong', 'weifufang', 'utsavac', 'gah', 'sungkwang', 'kgarrity', 'btanasoi', 'pmeunier', 'nljacobs5', 'dienstfrey', 'valencid', 'kcidkcid1992', 'yang912', 'mcclurr', 'ewilson000', 'cao42', 'jy009', 'tseng1', 'scaskey', 'adithyabhattachar', 'woods41', 'mike409', 'kwojo314', 'nathan.l.gibson', 'clarksm', 'baker251', 'ckatinas', 'kevin60105', 'shruti1205', 'kluitjoh', 'anepak123', 'wang159', 'yannick.congo', 'prasadsarang', 'jgeng', 'ssjadeguardian', 'spiyush1002', 'li1114', 'marisol', 'tkprasad2006', 'pikus', 'hu341', 'kmao', 'kennedym', 'mbj117', 'puttha.math', 'chuyuanchen', 'cempekardan', 'simon38', 'aanghelus', 'borgesebastiao', 'carla.estridge', 'jbeale', 'jsturnfield', 'jseaton', 'hctest4', 'nmenglin', 'akshaydeshpande', 'pastabasta8', 'xiaoshenwang', 'song405', 'gramchan123', 'swoop', 'kaiser1711', 'choi350', 'linglewang', 'pseiler', 'turkstra', 'colley', 'jmynhier', 'ebilionis', 'richa203', 'davgumo', 'jduritsc95', 'nin', 'jung164', 'hranjan', 'tarekameen', 'bhaley', 'liang.dai', 'hctest3', 'polina.aleks', 'agarw103', 'nanohueb', 'jeffrey.sanders', 'xliu123', 'mmh', 'vonschwerin', 'wayneisaacuy', 'mpelleg', 'ceduardo', 'light2', 'ldelgass', 'thelmus', 'chen1164', 'emorin', 'dkearney', 'kaimiao', 'boron1618', 'atankas', 'ashishmc', 'mischke', 'glassd', 'odary', 'jmcgough', 'woodswims', 'edantillon', 'kennell', 'buzzard', 'fpena', 'bmsutton', 'araz.hashemi', 'zyf', 'bermel', 'claytok', 'denphi', 'chen1720', 'ahinkle5', 'giggerota', 'liu1512', 'roz36088', 'ralphsmith', 'sromanov412', 'pyles', 'wood67', 'samikm', 'clarksnano', 'chang305', 'apps', 'ajebakum', 'allredt', 'zeadnws', 'lou23', 'trungnguyen', 'felbr', 'tongyangshi', 'ekayser', 'piyush100078', 'schcats', 'porter28', 'trosch', 'kuehnel', 'fang85', 'jiruotong', 'jmethel', 'jhollkam', 'bartos', 'kumar167', 'wsanche2', 'mbedard', 'robisonj', 'zhou523', 'enassakr', 'djcarr', 'robin198', 'mbeason', 'zhuangxinghao', 'luizescalco', 'kmargata', 'markarios345', 'njtsh', None, 'ma319', 'dnaragan', 'blaiszik', 'chinyi', '10gauravpatankar', 'samuel.j.tucker', 'vos', 'mullen6', 'strachan', 'glin75']"
26,263,28,24,13,"['mbj117', 'samuel.j.tucker', 'pastabasta8', 'mike409', 'jeffrey.sanders', 'zeadnws', 'nathan.l.gibson', 'tkprasad2006', 'roz36088', 'weifufang', 'ceduardo', 'carla.estridge', 'kgarrity']",14,"['trosch', 'yannick.congo', 'puttha.math', 'araz.hashemi', 'blaiszik', 'spiyush1002', 'buzzard', 'vonschwerin', 'wayneisaacuy', 'linglewang', 'ralphsmith', 'sungkwang', 'sromanov412', 'jsturnfield']",11,"['cguarini', 'dienstfrey', 'markbenedict', 'sdhaka', 'khuston', 'kiettipong1', 'adamatandia', 'mathewni', 'nawalgao', None, 'ukamran']",38,"['mbj117', 'puttha.math', 'zeadnws', 'sdhaka', 'weifufang', 'sungkwang', 'carla.estridge', 'kgarrity', 'jsturnfield', 'trosch', 'pastabasta8', 'dienstfrey', 'markbenedict', 'khuston', 'buzzard', 'adamatandia', 'linglewang', 'nawalgao', 'cguarini', 'araz.hashemi', 'mike409', 'nathan.l.gibson', None, 'yannick.congo', 'blaiszik', 'spiyush1002', 'samuel.j.tucker', 'jeffrey.sanders', 'kiettipong1', 'vonschwerin', 'wayneisaacuy', 'roz36088', 'ralphsmith', 'sromanov412', 'ceduardo', 'tkprasad2006', 'mathewni', 'ukamran']"
26,243,28,7,4,"['samuel.j.tucker', 'mbj117', 'carla.estridge', 'weifufang']",23,"['puttha.math', 'zeadnws', 'sungkwang', 'kgarrity', 'jsturnfield', 'trosch', 'pastabasta8', 'buzzard', 'linglewang', 'araz.hashemi', 'mike409', 'nathan.l.gibson', 'yannick.congo', 'blaiszik', 'spiyush1002', 'jeffrey.sanders', 'tkprasad2006', 'vonschwerin', 'wayneisaacuy', 'roz36088', 'ralphsmith', 'sromanov412', 'ceduardo']",3,"['khuston', None, 'mathewni']",30,"['mbj117', 'puttha.math', 'araz.hashemi', 'mike409', 'zeadnws', 'nathan.l.gibson', 'weifufang', 'sungkwang', 'carla.estridge', 'kgarrity', None, 'jsturnfield', 'trosch', 'yannick.congo', 'blaiszik', 'spiyush1002', 'samuel.j.tucker', 'pastabasta8', 'jeffrey.sanders', 'khuston', 'tkprasad2006', 'buzzard', 'vonschwerin', 'wayneisaacuy', 'roz36088', 'linglewang', 'ralphsmith', 'sromanov412', 'ceduardo', 'mathewni']"
26,262,28,7,1,['pastabasta8'],26,"['mbj117', 'puttha.math', 'zeadnws', 'weifufang', 'sungkwang', 'carla.estridge', 'kgarrity', 'jsturnfield', 'trosch', 'buzzard', 'linglewang', 'araz.hashemi', 'mike409', 'nathan.l.gibson', 'yannick.congo', 'blaiszik', 'spiyush1002', 'samuel.j.tucker', 'jeffrey.sanders', 'tkprasad2006', 'vonschwerin', 'wayneisaacuy', 'roz36088', 'ralphsmith', 'sromanov412', 'ceduardo']",6,"['cguarini', 'sdhaka', 'sobh1', 'scthakk2', None, 'ukamran']",33,"['cguarini', 'mbj117', 'puttha.math', 'araz.hashemi', 'mike409', 'zeadnws', 'nathan.l.gibson', 'sdhaka', 'sobh1', 'weifufang', 'sungkwang', 'carla.estridge', 'scthakk2', 'kgarrity', None, 'jsturnfield', 'trosch', 'yannick.congo', 'blaiszik', 'spiyush1002', 'samuel.j.tucker', 'pastabasta8', 'jeffrey.sanders', 'tkprasad2006', 'buzzard', 'vonschwerin', 'wayneisaacuy', 'roz36088', 'linglewang', 'ralphsmith', 'sromanov412', 'ceduardo', 'ukamran']"
26,57,28,6,4,"['samuel.j.tucker', 'mbj117', 'carla.estridge', 'weifufang']",23,"['puttha.math', 'zeadnws', 'sungkwang', 'kgarrity', 'jsturnfield', 'trosch', 'pastabasta8', 'buzzard', 'linglewang', 'araz.hashemi', 'mike409', 'nathan.l.gibson', 'yannick.congo', 'blaiszik', 'spiyush1002', 'jeffrey.sanders', 'tkprasad2006', 'vonschwerin', 'wayneisaacuy', 'roz36088', 'ralphsmith', 'sromanov412', 'ceduardo']",2,"['khuston', None]",29,"['mbj117', 'puttha.math', 'araz.hashemi', 'mike409', 'zeadnws', 'nathan.l.gibson', 'weifufang', 'sungkwang', 'carla.estridge', 'kgarrity', None, 'jsturnfield', 'trosch', 'yannick.congo', 'blaiszik', 'spiyush1002', 'samuel.j.tucker', 'pastabasta8', 'jeffrey.sanders', 'khuston', 'tkprasad2006', 'buzzard', 'vonschwerin', 'wayneisaacuy', 'roz36088', 'linglewang', 'ralphsmith', 'sromanov412', 'ceduardo']"
26,261,28,6,1,['pastabasta8'],26,"['mbj117', 'puttha.math', 'zeadnws', 'weifufang', 'sungkwang', 'carla.estridge', 'kgarrity', 'jsturnfield', 'trosch', 'buzzard', 'linglewang', 'araz.hashemi', 'mike409', 'nathan.l.gibson', 'yannick.congo', 'blaiszik', 'spiyush1002', 'samuel.j.tucker', 'jeffrey.sanders', 'tkprasad2006', 'vonschwerin', 'wayneisaacuy', 'roz36088', 'ralphsmith', 'sromanov412', 'ceduardo']",5,"['cguarini', 'sdhaka', 'sobh1', None, 'ukamran']",32,"['cguarini', 'mbj117', 'puttha.math', 'araz.hashemi', 'mike409', 'zeadnws', 'nathan.l.gibson', 'sdhaka', 'sobh1', 'weifufang', 'sungkwang', 'carla.estridge', 'kgarrity', None, 'jsturnfield', 'trosch', 'yannick.congo', 'blaiszik', 'spiyush1002', 'samuel.j.tucker', 'pastabasta8', 'jeffrey.sanders', 'tkprasad2006', 'buzzard', 'vonschwerin', 'wayneisaacuy', 'roz36088', 'linglewang', 'ralphsmith', 'sromanov412', 'ceduardo', 'ukamran']"
27,178,28,23,21,"['mark320', 'xhy0118', 'hmcrockett', 'cekimberly', 'jakean.wmchem', 'ptsmith01', 'igalty', 'kshenke', 'gayala', 'keborden', 'jcperkins23', 'naudell', 'hahamama', 'mkdullum', 'hshenouda', 'bmfortman', 'jpcassidy', 'hesmith02', 'carolyn_hartley', 'wanjizhang', 'jatan']",6,"['golomakol', 'vladimirlabynko', 'nawfelmieplot', 'burloslava', 'chouaibplasmon', 'larosny']",2,"['mrlntheamazing', None]",29,"['mark320', 'mrlntheamazing', 'nawfelmieplot', 'xhy0118', 'cekimberly', 'golomakol', 'jakean.wmchem', 'ptsmith01', 'igalty', 'larosny', 'kshenke', 'gayala', 'keborden', 'hesmith02', 'jcperkins23', 'burloslava', 'naudell', 'chouaibplasmon', 'hahamama', None, 'mkdullum', 'hshenouda', 'bmfortman', 'vladimirlabynko', 'jpcassidy', 'hmcrockett', 'carolyn_hartley', 'wanjizhang', 'jatan']"
28,172,28,25,22,"['natalie.j.burgos', 'ning2', 'imclucke', 'welch31', 'kadair', 'zhan1823', 'hobson7', 'eprussac', 'kkingdon', 'ncain3', 'humphre4', 'flash7teen', 'ouyang6', 'briaralan', 'andrew27', 'fbokhari', 'davis635', 'djaxx5', 'wmorton', 'an49', 'logan8', 'pjgordon']",5,"['nmacke', 'jtrouba', 'elizabethrtopi', 'pan112', 'yang837']",3,"['aislingcoughlan', None, 'davgumo']",30,"['aislingcoughlan', 'natalie.j.burgos', 'ning2', 'imclucke', 'elizabethrtopi', 'pan112', 'welch31', 'kadair', 'zhan1823', 'hobson7', 'eprussac', 'kkingdon', 'nmacke', 'ncain3', 'humphre4', 'davgumo', 'flash7teen', 'ouyang6', 'briaralan', 'andrew27', 'fbokhari', None, 'davis635', 'jtrouba', 'djaxx5', 'wmorton', 'an49', 'logan8', 'pjgordon', 'yang837']"
28,173,28,16,9,"['hobson7', 'nmacke', 'jtrouba', 'ning2', 'elizabethrtopi', 'pan112', 'an49', 'ouyang6', 'yang837']",18,"['zhan1823', 'natalie.j.burgos', 'ncain3', 'imclucke', 'humphre4', 'eprussac', 'kkingdon', 'andrew27', 'djaxx5', 'wmorton', 'flash7teen', 'welch31', 'briaralan', 'logan8', 'kadair', 'fbokhari', 'pjgordon', 'davis635']",7,"['abeckle', 'mviers', 'beggs', 'teeads', 'brendenh88', 'mcapestr', None]",34,"['natalie.j.burgos', 'ning2', 'brendenh88', 'imclucke', 'elizabethrtopi', 'pan112', 'welch31', 'kadair', 'zhan1823', 'teeads', 'hobson7', 'eprussac', 'mcapestr', 'kkingdon', 'abeckle', 'mviers', 'nmacke', 'ncain3', 'humphre4', 'flash7teen', 'ouyang6', 'briaralan', 'beggs', 'andrew27', 'fbokhari', None, 'davis635', 'jtrouba', 'djaxx5', 'wmorton', 'an49', 'logan8', 'pjgordon', 'yang837']"
29,38,26,176,17,"['tuscanowtsheryl128', 'ankushlagad4', 'shaikhkarnekar', 'mugdhapv8', 'pendkeomkar', 'mkshirke94', 'fruitywithmonty', 'nilesh2551994', 'manali', 'mmodi296', 'chabhadiariddhi', 'anut730', 'adityasawant93', 'amitpoojary94', 'amol.marathe93', 'hrishikeshtawade', 'advaitchuri']",8,"['chiragpooniwala', 'mvedant29', 'kalyani.aye93', 'karthik.radhakrishna022', 'nachi.2605', 'sagar.mujpara99', 'samira2308', 'pomkar55']",159,"['t0rse95', 'priyanka.chavan.s.pc', 'nimita.singh', 'vesitd16b', 'sshelar01', 'aksh1995', 'sarprashasti21', 'gaikar.shubhada888', 'patilmonika681', 'smsayali79', 'mehta.krish', 'rohan.ranshinge', 'devanandkb', 'raghu.shirodkar', 'heenal0708', 'sanjay.devan.ranstad', 'reubenalexander2010', 'ashwinnumbrat94', 'satya_mishra', 'pranjali.borkar', 'richard.noronha', 'jadhavadhiraj', 'pratikkavale11', 'suyash.chopra', 'spawar10', 'abhishek.shinde', 'rakeshchrs87', 'harshada.patankar', 'smhatre08', 'dalviakshata12', 'mayurgaikwad1293', 'devang19.shah', 'pritish.das', 'gajakosh.sneha54', 'suyash.karle', 'milu21111994', 'vedarthsave80', 'takalesusmita', 'pranjali2610', 'yash_iyengar27', 'cyberclan.xd', 'snehavardhini', 'nishanth1101', 'salil.vaidya', 'nitiiinbaranwal', 'rupali1891994', 'naren.ambwani', 'seemamishra', 'trupti.vaity19', 'zak1010', 'lokhanderaj55', 'dlaxmanc59', 'narenambwani04', 's.aditya.ghadiali', 'yamkarki', 'arsh.raina', 'vinu.sunny1994.vs', 'shubhampnkr', 'a.b.surgade', 'kaushik_gaikwad', 'sumaiyya.kazi94', 'abhishek291', 'muktat20', 'stylechicanki', 'suraj348', 'govind9867129531', 'vijayaher0211', 'ruprane296', 'karna1995.kj', 'sneha.kutal', 'maradiyadhaval92', 'thefreeliar18', 'ksurgade', 'ascharyaskumar', 'deepuvijaya1806', 'ibrahimarif950', 'shrimohite13', 'chinmay', 'juvika1994', 'mrinalini20.shah', 'darpan.bagwale', 'aishhhh', 'gokisush9', 'anirudh2442', 'aakash3194', 'swapnalimakdey25', 'pratham201294', 'jatinshende25', 'ranjanjadhav1234', 'syadav05', 'hit.kamble', 'vejalporia1994', 'kiran.pawar1611', 'anirudh0000', 'kanchan.phadtare', 'tawadesiddhesh1994', 'priyankajamdade23', 'sapnabhandary31', 'dkbathe29', 'zalakdodecha', 'aayushjain27894', 'nikhiljadhav.jadhav40', 'sapte01', 'ranju.raj18', 'chisimeybijimchigmomin', 'kumar.amit156', 'prajaktasjoshi911', 'pranali.kokate9', 'dubalprasad04', 'omkar.bane13', 'kalpeshshukla11', 'amey.2994', 'sumitkarmokar', 'nshambhuraje', 'parabmahadev34', 'prathmeshgurunathparab', 'shashanksingh4000', 'karanshh30', 'kanchangorde15', 'abhijeetchavan', 'ashijadhav20', 'swapneil.hirulkar', 'paresh761', 'dung_master24', 'shreyasnaravane', 'ambicavenkatesh2009', 'rajkumar.kalantri', 'kuldeeppatil201093', 'shreenathdalvi1994', 'pankajsalunkhe23', 'amitmadgi15', 'smackthatjohn', 'krusha14', 'sanika.pandharkar', 'omkar12345', 'akshaysharma', 'jmen1993', 'manishakolekar1994', 'sagarbisen50', 'pralim', 'sharvaridalvi301', 'sayli.shevade', 'ishmeetsingh', 'borse84kiran', 'ashish123', 'rgole02', 'thoravekalpesh', 'asudha', 'jeniljain1008', 'rupali.patil', 'isaurabhbhirud7', 'palashmak067', 'jidvaze', 'ruchita9523', 'inderjitsingh87', 'ryadav03', 'abhishek.singh', 'devendrashinde1995', 'gharat789']",184,"['t0rse95', 'priyanka.chavan.s.pc', 'nimita.singh', 'shaikhkarnekar', 'vesitd16b', 'sshelar01', 'aksh1995', 'sarprashasti21', 'adityasawant93', 'gaikar.shubhada888', 'patilmonika681', 'smsayali79', 'chiragpooniwala', 'mehta.krish', 'rohan.ranshinge', 'devanandkb', 'karthik.radhakrishna022', 'raghu.shirodkar', 'pomkar55', 'heenal0708', 'sanjay.devan.ranstad', 'reubenalexander2010', 'ashwinnumbrat94', 'satya_mishra', 'pranjali.borkar', 'richard.noronha', 'fruitywithmonty', 'jadhavadhiraj', 'pratikkavale11', 'suyash.chopra', 'amitpoojary94', 'spawar10', 'abhishek.shinde', 'rakeshchrs87', 'harshada.patankar', 'nilesh2551994', 'smhatre08', 'dalviakshata12', 'nachi.2605', 'mayurgaikwad1293', 'devang19.shah', 'pritish.das', 'gajakosh.sneha54', 'suyash.karle', 'milu21111994', 'vedarthsave80', 'takalesusmita', 'pranjali2610', 'yash_iyengar27', 'cyberclan.xd', 'snehavardhini', 'nishanth1101', 'salil.vaidya', 'nitiiinbaranwal', 'rupali1891994', 'naren.ambwani', 'seemamishra', 'ankushlagad4', 'trupti.vaity19', 'zak1010', 'lokhanderaj55', 'dlaxmanc59', 'narenambwani04', 's.aditya.ghadiali', 'yamkarki', 'arsh.raina', 'vinu.sunny1994.vs', 'shubhampnkr', 'a.b.surgade', 'kaushik_gaikwad', 'sumaiyya.kazi94', 'abhishek291', 'muktat20', 'stylechicanki', 'suraj348', 'govind9867129531', 'vijayaher0211', 'ruprane296', 'karna1995.kj', 'sneha.kutal', 'maradiyadhaval92', 'tuscanowtsheryl128', 'thefreeliar18', 'ksurgade', 'ascharyaskumar', 'deepuvijaya1806', 'ibrahimarif950', 'shrimohite13', 'chinmay', 'juvika1994', 'mrinalini20.shah', 'amol.marathe93', 'darpan.bagwale', 'aishhhh', 'kalyani.aye93', 'gokisush9', 'anirudh2442', 'aakash3194', 'swapnalimakdey25', 'mmodi296', 'pratham201294', 'jatinshende25', 'ranjanjadhav1234', 'syadav05', 'hit.kamble', 'vejalporia1994', 'kiran.pawar1611', 'anirudh0000', 'kanchan.phadtare', 'tawadesiddhesh1994', 'priyankajamdade23', 'mugdhapv8', 'sapnabhandary31', 'dkbathe29', 'chabhadiariddhi', 'zalakdodecha', 'aayushjain27894', 'nikhiljadhav.jadhav40', 'sapte01', 'ranju.raj18', 'chisimeybijimchigmomin', 'manali', 'kumar.amit156', 'prajaktasjoshi911', 'pranali.kokate9', 'dubalprasad04', 'omkar.bane13', 'kalpeshshukla11', 'amey.2994', 'sumitkarmokar', 'advaitchuri', 'nshambhuraje', 'mkshirke94', 'parabmahadev34', 'prathmeshgurunathparab', 'shashanksingh4000', 'anut730', 'karanshh30', 'kanchangorde15', 'abhijeetchavan', 'ashijadhav20', 'swapneil.hirulkar', 'paresh761', 'dung_master24', 'shreyasnaravane', 'ambicavenkatesh2009', 'rajkumar.kalantri', 'samira2308', 'kuldeeppatil201093', 'shreenathdalvi1994', 'pankajsalunkhe23', 'amitmadgi15', 'smackthatjohn', 'pendkeomkar', 'krusha14', 'sanika.pandharkar', 'omkar12345', 'akshaysharma', 'sagar.mujpara99', 'jmen1993', 'manishakolekar1994', 'sagarbisen50', 'pralim', 'sharvaridalvi301', 'sayli.shevade', 'mvedant29', 'ishmeetsingh', 'borse84kiran', 'ashish123', 'rgole02', 'thoravekalpesh', 'asudha', 'jeniljain1008', 'rupali.patil', 'isaurabhbhirud7', 'palashmak067', 'jidvaze', 'ruchita9523', 'inderjitsingh87', 'ryadav03', 'abhishek.singh', 'devendrashinde1995', 'gharat789', 'hrishikeshtawade']"
29,35,26,135,7,"['tuscanowtsheryl128', 'mvedant29', 'mmodi296', 'chabhadiariddhi', 'sagar.mujpara99', 'samira2308', 'pomkar55']",18,"['chiragpooniwala', 'kalyani.aye93', 'ankushlagad4', 'shaikhkarnekar', 'mugdhapv8', 'pendkeomkar', 'mkshirke94', 'fruitywithmonty', 'nilesh2551994', 'manali', 'karthik.radhakrishna022', 'amol.marathe93', 'anut730', 'adityasawant93', 'amitpoojary94', 'nachi.2605', 'hrishikeshtawade', 'advaitchuri']",128,"['kalpitnarvekar', 'rohan21', 'linusassao974', 'komalkolekar95', 'patelmeeti1995', 'lakshoza', 'tanmaypatil18', 'shamika', 'mehta.krish', 'tejomayi.wandhile', 'bhoglet', 'ameysv22', 'sayaliw212', 'chinmayhejmadi', 'sonal.02031995', 'shahajichinchole', 'mrinalivyas1', 'mohiteruchir29', 'aksha0103', 'architagoyal', 'modyjash', 'kodagakshay26', 'karan.dhareshwar', 'himanshu21rasam', 'deepashrisane2203', 'vanitashingwa1995', 'tushardmaske', 'imushaikh007', 'rp92555', 'hegde.aniket94.ah', 'mewadayash', 'dal30', 'mehakkoul1994', 'shashwatssanghavi', 'aniketvidyalankar', 'gohel.mitesh91', 'divyapawar39', 'ansi7794', 'vj280395', 'niharikasarode', 'ghosh.arjun97', 'deepakjain.dj2', 'supriya.mangalpalli', 'ajoshi1996', 'desaimaanil2', 'hemantsonar93', 'sunilpoojary27', 'a.b.surgade', 'aka_jadhav', 'sammeetthosar', 'sangeetamjoshi', 'stylechicanki', 'basher00992', 'chaudharilatika02', 'satishlovesmom123', 'dakshata', 'ruprane296', 'rahulstary', 'sonali2', 'pb9298', 'adityasingh8394', 'rajpareshshah14', 'shubham.mohite7', 'chinmay', 'gidayegirish', 'shraddha0306', 'aamod1996', 'kanchipoddar', 'sagnikpal3495', 'prasadbhujbal28', 'mengaderutuja369', 'ganeshmukund10', 'rutuja1122', 'rsarmajrt', 'saurabhmangeshkar', 'deepti.bhosale189', 'saurabh.medhekar18', 'akash.jadhav', 'hemantjathar7', 'pallavighogare1994', 'ganjirajini277', 'kumar.amit156', 'krishna.jhuma17', 'nilesh15394', 'aljo.joy22', 'ankitashere04', 'mayuresh20', 'kirandarade133', 'sagar2bhujbal', 'prasadchachad20', 'karanshh30', 'kanchangorde15', 'rushabkarani', 'sj.shruti95', 'chintanrlimbani', 'abhijeetchavan', 'rwaghela51', 'udayanyarya', 'jyotibhosale8483', 'umang.parekh30', 'ayy1892', 'shivachandran.nadar15', 'prachipatil', 'qaspfu', 'ayushgupta11031996', 'tripathipavan10', 'sonaltambe32', 'rohanshah611', 'akajadhav1', 'borse84kiran', 'anujkolvalkar1', 'arcanetech12', 'vaibhavvadia', 'darshanlukhi25', 'surajmore009', 'amitsunildhamne', 'redorchid029', 'nikinsaw', 'sunilkavatkar', 'phadsujata59', 'shetty1995pranoy', 'akshaykharat563', 'jharupesh440', None, 'aj.shahare', 'amaya.pethe', 'roshninilam', 'inderjitsingh87']",153,"['kalpitnarvekar', 'shaikhkarnekar', 'rohan21', 'linusassao974', 'komalkolekar95', 'adityasawant93', 'patelmeeti1995', 'chiragpooniwala', 'lakshoza', 'tanmaypatil18', 'shamika', 'mehta.krish', 'tejomayi.wandhile', 'bhoglet', 'ameysv22', 'karthik.radhakrishna022', 'sayaliw212', 'chinmayhejmadi', 'sonal.02031995', 'pomkar55', 'shahajichinchole', 'fruitywithmonty', 'amitpoojary94', 'mrinalivyas1', 'mohiteruchir29', 'aksha0103', 'architagoyal', 'modyjash', 'kodagakshay26', 'nilesh2551994', 'karan.dhareshwar', 'himanshu21rasam', 'deepashrisane2203', 'nachi.2605', 'vanitashingwa1995', 'tushardmaske', 'imushaikh007', 'rp92555', 'hegde.aniket94.ah', 'mewadayash', 'dal30', 'mehakkoul1994', 'shashwatssanghavi', 'aniketvidyalankar', 'gohel.mitesh91', 'divyapawar39', 'ansi7794', 'ankushlagad4', 'vj280395', 'niharikasarode', 'ghosh.arjun97', 'deepakjain.dj2', 'supriya.mangalpalli', 'ajoshi1996', 'desaimaanil2', 'hemantsonar93', 'sunilpoojary27', 'a.b.surgade', 'aka_jadhav', 'sammeetthosar', 'sangeetamjoshi', 'stylechicanki', 'basher00992', 'chaudharilatika02', 'satishlovesmom123', 'dakshata', 'ruprane296', 'rahulstary', 'tuscanowtsheryl128', 'sonali2', 'pb9298', 'adityasingh8394', 'rajpareshshah14', 'shubham.mohite7', 'chinmay', 'gidayegirish', 'amol.marathe93', 'shraddha0306', 'kalyani.aye93', 'aamod1996', 'kanchipoddar', 'sagnikpal3495', 'prasadbhujbal28', 'mmodi296', 'mengaderutuja369', 'ganeshmukund10', 'rutuja1122', 'mugdhapv8', 'rsarmajrt', 'saurabhmangeshkar', 'chabhadiariddhi', 'deepti.bhosale189', 'saurabh.medhekar18', 'akash.jadhav', 'hemantjathar7', 'pallavighogare1994', 'ganjirajini277', 'manali', 'kumar.amit156', 'krishna.jhuma17', 'nilesh15394', 'aljo.joy22', 'ankitashere04', 'mayuresh20', 'advaitchuri', 'kirandarade133', 'sagar2bhujbal', 'mkshirke94', 'prasadchachad20', 'anut730', 'karanshh30', 'kanchangorde15', 'rushabkarani', 'sj.shruti95', 'chintanrlimbani', 'abhijeetchavan', 'rwaghela51', 'udayanyarya', 'jyotibhosale8483', 'umang.parekh30', 'samira2308', 'ayy1892', 'shivachandran.nadar15', 'prachipatil', 'qaspfu', 'pendkeomkar', 'ayushgupta11031996', 'tripathipavan10', 'sonaltambe32', 'rohanshah611', 'sagar.mujpara99', 'akajadhav1', 'mvedant29', 'borse84kiran', 'anujkolvalkar1', 'arcanetech12', 'vaibhavvadia', 'darshanlukhi25', 'surajmore009', 'amitsunildhamne', 'redorchid029', 'nikinsaw', 'sunilkavatkar', 'phadsujata59', 'shetty1995pranoy', 'akshaykharat563', 'jharupesh440', None, 'aj.shahare', 'amaya.pethe', 'roshninilam', 'inderjitsingh87', 'hrishikeshtawade']"
29,42,26,69,7,"['chiragpooniwala', 'mvedant29', 'ankushlagad4', 'fruitywithmonty', 'karthik.radhakrishna022', 'nachi.2605', 'sagar.mujpara99']",18,"['tuscanowtsheryl128', 'kalyani.aye93', 'shaikhkarnekar', 'mugdhapv8', 'pendkeomkar', 'mkshirke94', 'nilesh2551994', 'manali', 'hrishikeshtawade', 'mmodi296', 'chabhadiariddhi', 'anut730', 'adityasawant93', 'amitpoojary94', 'amol.marathe93', 'samira2308', 'pomkar55', 'advaitchuri']",62,"['akshaykatkar', 'vivianmascarenhas1994', 'abha08', 'nimita.singh', 'greatabhi.jathar', 'adithyamohan', 'aakash3194', 'swapnalimakdey25', 'linusassao974', 'mewadayash', 'jitusawant10', 'mananmehta95', 'mannapatil', 'shashwatssanghavi', 'prathuhatode', 'kanchan.phadtare', 'kedarthale', 'sahilkolwankar', 'pbandewar', 'shamika', 'varsha.jagadale188.vj', 'tejomayi.wandhile', 'mehta.krish', 'rohan.ranshinge', 'krusha14', 's.aditya.ghadiali', 'sanika.pandharkar', 'gurnani.nikita999', 'mrhbtiwari', 'amol.dhanvij10', 'pritidhandrut25', 'shraddha0306', 'priyanka.kulkarni', 'kapsesainath', 'mandavkarnidhi', 'a.b.surgade', 'tanmaykadam', 'giridharsh1', 'rupali.patil', 'pranali.kokate9', 'sushmakodagali', 'abhay.kshirsagar', 'sunilkavatkar', 'payalsaldur', None, 'rohanbandal93', 'ramjighatala7', 'ajit.gaikwad325', 'neetika.k10', 'pushkarvaity', 'sonali2', 'vishalvb04', 'ghaisas.atharv', 'ashishjamdade72', 'mohit951995', 'jidvaze', 'shruti.ganjoo97', 'inderjitsingh87', 'sharan.raikhangar', 'juvika1994', 'dj.dharmik', 'ssatam23dps']",87,"['vivianmascarenhas1994', 'kalyani.aye93', 'nimita.singh', 'greatabhi.jathar', 'shaikhkarnekar', 'aakash3194', 'swapnalimakdey25', 'linusassao974', 'mmodi296', 'adityasawant93', 'mannapatil', 'prathuhatode', 'kanchan.phadtare', 'kedarthale', 'chiragpooniwala', 'shamika', 'mugdhapv8', 'varsha.jagadale188.vj', 'tejomayi.wandhile', 'mehta.krish', 'rohan.ranshinge', 'karthik.radhakrishna022', 'chabhadiariddhi', 'mrhbtiwari', 'pomkar55', 'priyanka.kulkarni', 'kapsesainath', 'tanmaykadam', 'giridharsh1', 'fruitywithmonty', 'manali', 'pranali.kokate9', 'amitpoojary94', 'payalsaldur', 'advaitchuri', 'ajit.gaikwad325', 'neetika.k10', 'mkshirke94', 'nilesh2551994', 'vishalvb04', 'mohit951995', 'anut730', 'nachi.2605', 'sharan.raikhangar', 'dj.dharmik', 'akshaykatkar', 'abha08', 'adithyamohan', 'mewadayash', 'jitusawant10', 'mananmehta95', 'samira2308', 'shashwatssanghavi', 'sahilkolwankar', 'pbandewar', 'ankushlagad4', 'pendkeomkar', 'krusha14', 's.aditya.ghadiali', 'sanika.pandharkar', 'gurnani.nikita999', 'amol.dhanvij10', 'sagar.mujpara99', 'pritidhandrut25', 'shraddha0306', 'mandavkarnidhi', 'a.b.surgade', 'mvedant29', 'ssatam23dps', 'rupali.patil', 'sushmakodagali', 'abhay.kshirsagar', 'sunilkavatkar', None, 'rohanbandal93', 'ramjighatala7', 'tuscanowtsheryl128', 'pushkarvaity', 'sonali2', 'ghaisas.atharv', 'ashishjamdade72', 'jidvaze', 'shruti.ganjoo97', 'inderjitsingh87', 'juvika1994', 'hrishikeshtawade', 'amol.marathe93']"
29,41,26,21,4,"['samira2308', 'chiragpooniwala', 'fruitywithmonty', 'manali']",21,"['kalyani.aye93', 'shaikhkarnekar', 'mmodi296', 'adityasawant93', 'ankushlagad4', 'mugdhapv8', 'pendkeomkar', 'karthik.radhakrishna022', 'chabhadiariddhi', 'sagar.mujpara99', 'pomkar55', 'mvedant29', 'amitpoojary94', 'advaitchuri', 'tuscanowtsheryl128', 'mkshirke94', 'nilesh2551994', 'anut730', 'nachi.2605', 'hrishikeshtawade', 'amol.marathe93']",17,"['trupti.vaity19', 'ssatam23dps', 'ashishtonge94', 'sonali2', 'swapnalimakdey25', 'jidvaze', 'prasadbhujbal28', 'sushmakodagali', 'inderjitsingh87', 'arunimavarma20', 'amol.dhanvij10', 'mns.dinu', 'raghu.shirodkar', 'dj.dharmik', None, 'sonali.bhujbal1', 'g.s.siddhant']",42,"['kalyani.aye93', 'ashishtonge94', 'shaikhkarnekar', 'swapnalimakdey25', 'prasadbhujbal28', 'mmodi296', 'adityasawant93', 'samira2308', 'g.s.siddhant', 'chiragpooniwala', 'ankushlagad4', 'trupti.vaity19', 'mugdhapv8', 'pendkeomkar', 'karthik.radhakrishna022', 'chabhadiariddhi', 'arunimavarma20', 'amol.dhanvij10', 'sagar.mujpara99', 'raghu.shirodkar', 'pomkar55', 'mvedant29', 'ssatam23dps', 'fruitywithmonty', 'manali', 'sushmakodagali', 'amitpoojary94', None, 'sonali.bhujbal1', 'advaitchuri', 'tuscanowtsheryl128', 'sonali2', 'mkshirke94', 'nilesh2551994', 'jidvaze', 'inderjitsingh87', 'anut730', 'nachi.2605', 'mns.dinu', 'dj.dharmik', 'hrishikeshtawade', 'amol.marathe93']"
29,115,26,20,12,"['tuscanowtsheryl128', 'mugdhapv8', 'fruitywithmonty', 'mmodi296', 'chabhadiariddhi', 'anut730', 'adityasawant93', 'amitpoojary94', 'amol.marathe93', 'samira2308', 'hrishikeshtawade', 'advaitchuri']",13,"['chiragpooniwala', 'mvedant29', 'kalyani.aye93', 'ankushlagad4', 'shaikhkarnekar', 'pendkeomkar', 'mkshirke94', 'nilesh2551994', 'manali', 'karthik.radhakrishna022', 'nachi.2605', 'sagar.mujpara99', 'pomkar55']",8,"['aishhhh', 'juvika1994', 'mehta.krish', 'dkbathe29', 'inderjitsingh87', 'ptari04', 'cs7', None]",33,"['aishhhh', 'kalyani.aye93', 'shaikhkarnekar', 'mmodi296', 'adityasawant93', 'samira2308', 'chiragpooniwala', 'ankushlagad4', 'mugdhapv8', 'pendkeomkar', 'mehta.krish', 'karthik.radhakrishna022', 'chabhadiariddhi', 'dkbathe29', 'sagar.mujpara99', 'ptari04', 'cs7', 'pomkar55', 'mvedant29', 'fruitywithmonty', 'manali', 'amitpoojary94', None, 'advaitchuri', 'tuscanowtsheryl128', 'mkshirke94', 'nilesh2551994', 'inderjitsingh87', 'anut730', 'nachi.2605', 'juvika1994', 'hrishikeshtawade', 'amol.marathe93']"
29,36,26,18,1,['karthik.radhakrishna022'],24,"['kalyani.aye93', 'shaikhkarnekar', 'mmodi296', 'adityasawant93', 'samira2308', 'chiragpooniwala', 'ankushlagad4', 'mugdhapv8', 'pendkeomkar', 'chabhadiariddhi', 'sagar.mujpara99', 'pomkar55', 'mvedant29', 'fruitywithmonty', 'manali', 'amitpoojary94', 'advaitchuri', 'tuscanowtsheryl128', 'mkshirke94', 'nilesh2551994', 'anut730', 'nachi.2605', 'hrishikeshtawade', 'amol.marathe93']",17,"['pappumerijaan', 'shamika', 'shreyasshah14', 'ayushgupta11031996', 'sayalimhatre7195', 'mhatreravindra11', 'khan.nabed65', 'komalkolekar95', 'nilesh15394', 'inderjitsingh87', 'mrinalivyas1', 'nakshay07', 'ajoshi1996', 'ektaramani8', 'harshmhatre975', 'harshpatel201996', None]",42,"['kalyani.aye93', 'shaikhkarnekar', 'mmodi296', 'komalkolekar95', 'adityasawant93', 'samira2308', 'chiragpooniwala', 'ankushlagad4', 'shamika', 'mugdhapv8', 'pendkeomkar', 'ayushgupta11031996', 'mhatreravindra11', 'karthik.radhakrishna022', 'chabhadiariddhi', 'ajoshi1996', 'sagar.mujpara99', 'pomkar55', 'mvedant29', 'shreyasshah14', 'fruitywithmonty', 'sayalimhatre7195', 'manali', 'nilesh15394', 'amitpoojary94', 'mrinalivyas1', 'harshmhatre975', 'khan.nabed65', None, 'advaitchuri', 'pappumerijaan', 'tuscanowtsheryl128', 'mkshirke94', 'nilesh2551994', 'inderjitsingh87', 'nakshay07', 'anut730', 'nachi.2605', 'ektaramani8', 'harshpatel201996', 'hrishikeshtawade', 'amol.marathe93']"
29,116,26,13,7,"['mvedant29', 'mkshirke94', 'nilesh2551994', 'manali', 'karthik.radhakrishna022', 'nachi.2605', 'sagar.mujpara99']",18,"['chiragpooniwala', 'tuscanowtsheryl128', 'kalyani.aye93', 'ankushlagad4', 'shaikhkarnekar', 'mugdhapv8', 'pendkeomkar', 'fruitywithmonty', 'hrishikeshtawade', 'mmodi296', 'chabhadiariddhi', 'anut730', 'adityasawant93', 'amitpoojary94', 'amol.marathe93', 'samira2308', 'pomkar55', 'advaitchuri']",6,"['rohan.ranshinge', 'swapnalimakdey25', 'linusassao974', 'inderjitsingh87', 'likita94', None]",31,"['kalyani.aye93', 'shaikhkarnekar', 'swapnalimakdey25', 'linusassao974', 'mmodi296', 'adityasawant93', 'samira2308', 'chiragpooniwala', 'ankushlagad4', 'mugdhapv8', 'pendkeomkar', 'rohan.ranshinge', 'karthik.radhakrishna022', 'chabhadiariddhi', 'sagar.mujpara99', 'pomkar55', 'mvedant29', 'fruitywithmonty', 'manali', 'amitpoojary94', 'likita94', None, 'advaitchuri', 'tuscanowtsheryl128', 'mkshirke94', 'nilesh2551994', 'inderjitsingh87', 'anut730', 'nachi.2605', 'hrishikeshtawade', 'amol.marathe93']"
29,43,26,12,1,['kalyani.aye93'],24,"['shaikhkarnekar', 'mmodi296', 'adityasawant93', 'samira2308', 'chiragpooniwala', 'ankushlagad4', 'mugdhapv8', 'pendkeomkar', 'karthik.radhakrishna022', 'chabhadiariddhi', 'sagar.mujpara99', 'pomkar55', 'mvedant29', 'fruitywithmonty', 'manali', 'amitpoojary94', 'advaitchuri', 'tuscanowtsheryl128', 'mkshirke94', 'nilesh2551994', 'anut730', 'nachi.2605', 'hrishikeshtawade', 'amol.marathe93']",11,"['ishmeetsingh', 'aishhhh', 'pushkarvaity', 'ashishtonge94', 'ajinkyapadwad', None, 'yrsarvankar', 'mayur.agarwadekar', 'bhujangmethe', 'juvika1994', 'isaurabhbhirud7']",36,"['ishmeetsingh', 'mvedant29', 'kalyani.aye93', 'aishhhh', 'juvika1994', 'ashishtonge94', 'shaikhkarnekar', 'ajinkyapadwad', 'fruitywithmonty', 'manali', 'hrishikeshtawade', 'mmodi296', 'adityasawant93', 'amitpoojary94', 'samira2308', 'isaurabhbhirud7', None, 'advaitchuri', 'chiragpooniwala', 'tuscanowtsheryl128', 'ankushlagad4', 'pushkarvaity', 'mugdhapv8', 'pendkeomkar', 'mkshirke94', 'nilesh2551994', 'karthik.radhakrishna022', 'chabhadiariddhi', 'anut730', 'nachi.2605', 'mayur.agarwadekar', 'bhujangmethe', 'sagar.mujpara99', 'yrsarvankar', 'pomkar55', 'amol.marathe93']"
29,118,26,6,1,['chiragpooniwala'],24,"['kalyani.aye93', 'shaikhkarnekar', 'mmodi296', 'adityasawant93', 'samira2308', 'ankushlagad4', 'mugdhapv8', 'pendkeomkar', 'karthik.radhakrishna022', 'chabhadiariddhi', 'sagar.mujpara99', 'pomkar55', 'mvedant29', 'fruitywithmonty', 'manali', 'amitpoojary94', 'advaitchuri', 'tuscanowtsheryl128', 'mkshirke94', 'nilesh2551994', 'anut730', 'nachi.2605', 'hrishikeshtawade', 'amol.marathe93']",5,"['rohan.ranshinge', 'inderjitsingh87', 'juvika1994', 'likita94', None]",30,"['mvedant29', 'kalyani.aye93', 'shaikhkarnekar', 'fruitywithmonty', 'manali', 'hrishikeshtawade', 'mmodi296', 'adityasawant93', 'amitpoojary94', 'samira2308', 'likita94', None, 'advaitchuri', 'chiragpooniwala', 'tuscanowtsheryl128', 'ankushlagad4', 'mugdhapv8', 'pendkeomkar', 'mkshirke94', 'nilesh2551994', 'rohan.ranshinge', 'karthik.radhakrishna022', 'chabhadiariddhi', 'anut730', 'nachi.2605', 'inderjitsingh87', 'sagar.mujpara99', 'juvika1994', 'pomkar55', 'amol.marathe93']"
30,171,25,27,24,"['stanisz2', 'dmirabe2', 'daghrty2', 'mrhafizurrahman101', 'altisha01', 'vhughes2', 'vonklei2', 'marsh1717', 'taperez2', 'evan.bujak', 'kosela2', 'toglitt2', 'andypeterman', 'cetrone2', 'erfan453', 'rflore24', 'moss8', 'yhan29', 'aaarmst2', 'monica.ngo', 'ccastnd2', 'lydia.bakalova', 'audet2', 'bujak2']",0,[],3,"['zberent', 'ecurrier0', None]",27,"['stanisz2', 'dmirabe2', 'daghrty2', 'mrhafizurrahman101', 'altisha01', 'vhughes2', 'vonklei2', 'marsh1717', 'ecurrier0', 'taperez2', 'evan.bujak', 'kosela2', None, 'toglitt2', 'andypeterman', 'cetrone2', 'zberent', 'erfan453', 'rflore24', 'moss8', 'yhan29', 'aaarmst2', 'monica.ngo', 'ccastnd2', 'lydia.bakalova', 'audet2', 'bujak2']"
30,123,25,24,22,"['stanisz2', 'dmirabe2', 'daghrty2', 'mrhafizurrahman101', 'altisha01', 'vhughes2', 'vonklei2', 'marsh1717', 'taperez2', 'evan.bujak', 'kosela2', 'toglitt2', 'cetrone2', 'erfan453', 'rflore24', 'moss8', 'yhan29', 'aaarmst2', 'monica.ngo', 'ccastnd2', 'lydia.bakalova', 'audet2']",2,"['andypeterman', 'bujak2']",2,"['zberent', None]",26,"['stanisz2', 'dmirabe2', 'daghrty2', 'mrhafizurrahman101', 'altisha01', 'vhughes2', 'vonklei2', 'marsh1717', 'taperez2', 'evan.bujak', 'kosela2', None, 'toglitt2', 'andypeterman', 'cetrone2', 'zberent', 'erfan453', 'rflore24', 'moss8', 'yhan29', 'aaarmst2', 'monica.ngo', 'ccastnd2', 'lydia.bakalova', 'audet2', 'bujak2']"
31,64,23,27,21,"['neilmacfarlane', 'mlopez15', 'dmichae2', 'oclevela', 'cjudge2', 'cpeter17', 'jharri46', 'byoo1', 'cborows', 'msantovasi', 'kheidema', 'blu3bunni321', 'wpowick', 'tmccorm4', 'smachi', 'morganeck12', 'bhildyard', 'tylerturelli9559', 'vwalsh2', 'bbrown20', 'schwizz180']",1,['frubi93'],6,"['mjupina', 'nrotylia', 'bsakhuja', 'wturbett', None, 'mjanny1']",28,"['neilmacfarlane', 'mjupina', 'mlopez15', 'dmichae2', 'oclevela', 'cjudge2', 'bsakhuja', 'cpeter17', 'jharri46', 'byoo1', 'cborows', 'msantovasi', 'mjanny1', 'kheidema', 'blu3bunni321', 'wpowick', 'tmccorm4', 'smachi', 'morganeck12', 'bhildyard', 'nrotylia', 'frubi93', 'tylerturelli9559', 'vwalsh2', None, 'bbrown20', 'wturbett', 'schwizz180']"
31,229,23,24,22,"['neilmacfarlane', 'mlopez15', 'dmichae2', 'oclevela', 'cjudge2', 'cpeter17', 'jharri46', 'byoo1', 'cborows', 'msantovasi', 'kheidema', 'blu3bunni321', 'wpowick', 'tmccorm4', 'smachi', 'morganeck12', 'bhildyard', 'frubi93', 'tylerturelli9559', 'vwalsh2', 'bbrown20', 'schwizz180']",0,[],2,"[None, 'mjanny1']",24,"['neilmacfarlane', 'mlopez15', 'dmichae2', 'oclevela', 'cjudge2', 'cpeter17', 'jharri46', 'byoo1', 'cborows', 'msantovasi', 'mjanny1', 'kheidema', 'blu3bunni321', 'wpowick', 'tmccorm4', 'smachi', 'morganeck12', 'bhildyard', 'frubi93', 'tylerturelli9559', 'vwalsh2', None, 'bbrown20', 'schwizz180']"
31,189,23,23,18,"['kheidema', 'blu3bunni321', 'cpeter17', 'neilmacfarlane', 'wpowick', 'mlopez15', 'byoo1', 'bbrown20', 'tmccorm4', 'dmichae2', 'oclevela', 'cborows', 'bhildyard', 'cjudge2', 'msantovasi', 'morganeck12', 'frubi93', 'vwalsh2']",4,"['schwizz180', 'smachi', 'tylerturelli9559', 'jharri46']",5,"['mounthas9', 'mjupina', 'wturbett', None, 'mjanny1']",27,"['neilmacfarlane', 'mounthas9', 'mlopez15', 'mjupina', 'dmichae2', 'oclevela', 'cjudge2', 'cpeter17', 'jharri46', 'byoo1', 'cborows', 'msantovasi', 'mjanny1', 'kheidema', 'blu3bunni321', 'wpowick', 'tmccorm4', 'smachi', 'morganeck12', 'bhildyard', 'frubi93', 'tylerturelli9559', 'vwalsh2', None, 'bbrown20', 'wturbett', 'schwizz180']"
31,191,23,17,16,"['wpowick', 'kheidema', 'frubi93', 'neilmacfarlane', 'jharri46', 'byoo1', 'tmccorm4', 'dmichae2', 'oclevela', 'cborows', 'smachi', 'cjudge2', 'morganeck12', 'schwizz180', 'tylerturelli9559', 'vwalsh2']",6,"['blu3bunni321', 'cpeter17', 'mlopez15', 'bbrown20', 'bhildyard', 'msantovasi']",1,[None],23,"['neilmacfarlane', 'mlopez15', 'dmichae2', 'oclevela', 'cjudge2', 'cpeter17', 'jharri46', 'byoo1', 'cborows', 'msantovasi', 'kheidema', 'blu3bunni321', 'wpowick', 'tmccorm4', 'smachi', 'morganeck12', 'bhildyard', 'frubi93', 'tylerturelli9559', 'vwalsh2', None, 'bbrown20', 'schwizz180']"
31,66,23,8,7,"['mlopez15', 'byoo1', 'jharri46', 'oclevela', 'cborows', 'msantovasi', 'cjudge2']",15,"['kheidema', 'blu3bunni321', 'cpeter17', 'neilmacfarlane', 'wpowick', 'bbrown20', 'tmccorm4', 'dmichae2', 'smachi', 'morganeck12', 'bhildyard', 'schwizz180', 'frubi93', 'tylerturelli9559', 'vwalsh2']",1,[None],23,"['kheidema', 'blu3bunni321', 'wpowick', 'neilmacfarlane', 'mlopez15', 'tmccorm4', 'dmichae2', 'oclevela', 'smachi', 'cjudge2', 'morganeck12', 'bhildyard', 'frubi93', 'tylerturelli9559', 'vwalsh2', None, 'cpeter17', 'jharri46', 'byoo1', 'bbrown20', 'cborows', 'msantovasi', 'schwizz180']"
32,196,22,47,21,"['santibustoscastro', 'avilaalba', 'agentil', 'alexmurcia96', 'jphc64', 'azambrano13', 'anfepe_12', 'davidj.2111', 'sergiocamilo97111', 'sabinachocolate', 'oso_nana_96', 'angie_ayobi95', 'juanfdo96', 'juansesosaajedrez', 'juanswoodcock40', 'jorgem93', 'mangomela', 'k.santiagor06', 'ngomezgg.18', 'paula.osorio2222', 'davidan_pino']",0,[],26,"['duranmarco96', 'jecvmm', 'juanma.lovera', 'cd.florez10', 'jairomisterio', 'camidoka1212', 'af.almanza10', 'toromateoc', 'orionsebastian', 'andfe', 'n2ea', 'crisdavbed08', 'davidparra131', 'henryr9708', 'juancopp97', 'sereta27', 'andrez.tc', 'jasive', 'fabiant970', None, 'jassonmolina', 'valentinasandovalb', 'paannamo97', 'wolfangguio07', 'psbustos10', 'diego_romero_97']",47,"['santibustoscastro', 'avilaalba', 'cd.florez10', 'toromateoc', 'jphc64', 'anfepe_12', 'azambrano13', 'davidj.2111', 'andfe', 'sergiocamilo97111', 'sabinachocolate', 'n2ea', 'oso_nana_96', 'juanfdo96', 'juansesosaajedrez', 'henryr9708', 'juanswoodcock40', 'jorgem93', 'andrez.tc', 'jasive', 'ngomezgg.18', 'paula.osorio2222', 'davidan_pino', 'duranmarco96', 'jecvmm', 'juanma.lovera', 'agentil', 'jairomisterio', 'camidoka1212', 'af.almanza10', 'alexmurcia96', 'orionsebastian', 'angie_ayobi95', 'crisdavbed08', 'davidparra131', 'juancopp97', 'sereta27', 'mangomela', 'k.santiagor06', 'fabiant970', None, 'jassonmolina', 'valentinasandovalb', 'paannamo97', 'wolfangguio07', 'psbustos10', 'diego_romero_97']"
33,140,22,19,16,"['abhijitgholap75', 'rohitrrk22', 'rohit.upadhyay017', 'tanmay19195', 'sandeepkmbl136', 'harish1001', 'akshatagage51', 'bhagyashrikanade134', 'richa.chandra94', 'tejaswitabhanu', 'snehashikhare06', 'asmitababar123', 'ashwinichatuphale', 'adingorkar', 'avdhut.bhogale94', 'shettysachin824']",5,"['dipali.todkar', 'aneesoman', 'mohitingale5', 'wanisuraj16', 'vedesh']",3,"[None, 'pranitkadam', 'akkisk1992']",24,"['rohitrrk22', 'aneesoman', 'wanisuraj16', 'tejaswitabhanu', 'snehashikhare06', 'akkisk1992', 'pranitkadam', 'rohit.upadhyay017', 'akshatagage51', 'richa.chandra94', 'vedesh', 'avdhut.bhogale94', 'dipali.todkar', 'tanmay19195', 'sandeepkmbl136', 'asmitababar123', 'ashwinichatuphale', 'shettysachin824', None, 'abhijitgholap75', 'mohitingale5', 'bhagyashrikanade134', 'harish1001', 'adingorkar']"
33,141,22,15,12,"['abhijitgholap75', 'rohitrrk22', 'dipali.todkar', 'aneesoman', 'rohit.upadhyay017', 'tanmay19195', 'mohitingale5', 'akshatagage51', 'wanisuraj16', 'richa.chandra94', 'vedesh', 'shettysachin824']",9,"['sandeepkmbl136', 'harish1001', 'bhagyashrikanade134', 'tejaswitabhanu', 'snehashikhare06', 'asmitababar123', 'ashwinichatuphale', 'adingorkar', 'avdhut.bhogale94']",3,"[None, 'pranitkadam', 'akkisk1992']",24,"['rohitrrk22', 'dipali.todkar', 'aneesoman', 'tanmay19195', 'sandeepkmbl136', 'wanisuraj16', 'tejaswitabhanu', 'snehashikhare06', 'asmitababar123', 'ashwinichatuphale', 'akkisk1992', 'shettysachin824', 'pranitkadam', None, 'abhijitgholap75', 'rohit.upadhyay017', 'mohitingale5', 'akshatagage51', 'bhagyashrikanade134', 'harish1001', 'richa.chandra94', 'adingorkar', 'vedesh', 'avdhut.bhogale94']"
34,251,22,33,18,"['leticiasmonteiro', 'festivarian', 'ziyadbinsulaiman', 'carterwarren12', 'soccor.ghuy', 'alineelquist', 'robertturner1', 'dineiarantes', 'rhunt', 'cwalker', 'johnpaulstroud', 'lucasnukayahead', 'robertturner253', 'stevejohns', 'daniellenichols', 'megbern', 'majeed', 'jordanvandegrift']",3,"['arthurribe', 'egraugnard', 'michaellarge']",15,"['lnukayaheady', 'teamreidy', 'bephuonganh', 'aaronbartz', 'alexanderregner', 'sublimn', 'sierraludwig', None, 'trentonvleisides', 'meganfrary', 'crobertson7861', 'lanlibsu2', 'kinneybradh', 'lanlibsu', 'andybaldwin']",36,"['teamreidy', 'aaronbartz', 'soccor.ghuy', 'trentonvleisides', 'dineiarantes', 'crobertson7861', 'lanlibsu2', 'megbern', 'leticiasmonteiro', 'ziyadbinsulaiman', 'michaellarge', 'meganfrary', 'johnpaulstroud', 'egraugnard', 'robertturner253', 'daniellenichols', 'jordanvandegrift', 'bephuonganh', 'festivarian', 'sublimn', 'carterwarren12', 'lucasnukayahead', 'kinneybradh', 'lanlibsu', None, 'rhunt', 'alexanderregner', 'sierraludwig', 'alineelquist', 'robertturner1', 'cwalker', 'stevejohns', 'arthurribe', 'lnukayaheady', 'majeed', 'andybaldwin']"
34,248,22,30,20,"['soccor.ghuy', 'dineiarantes', 'megbern', 'leticiasmonteiro', 'ziyadbinsulaiman', 'michaellarge', 'johnpaulstroud', 'egraugnard', 'robertturner253', 'daniellenichols', 'jordanvandegrift', 'festivarian', 'carterwarren12', 'lucasnukayahead', 'rhunt', 'alineelquist', 'cwalker', 'stevejohns', 'arthurribe', 'majeed']",1,['robertturner1'],10,"['teamreidy', 'bephuonganh', 'aaronbartz', 'sierraludwig', 'changjiandeng', 'kinneybradh', 'drasman123', None, 'lanlibsu', 'andybaldwin']",31,"['teamreidy', 'aaronbartz', 'soccor.ghuy', 'dineiarantes', 'changjiandeng', 'drasman123', 'megbern', 'leticiasmonteiro', 'ziyadbinsulaiman', 'michaellarge', 'johnpaulstroud', 'egraugnard', 'robertturner253', 'daniellenichols', 'jordanvandegrift', 'bephuonganh', 'festivarian', 'carterwarren12', 'lucasnukayahead', None, 'kinneybradh', 'lanlibsu', 'rhunt', 'sierraludwig', 'alineelquist', 'robertturner1', 'cwalker', 'stevejohns', 'arthurribe', 'majeed', 'andybaldwin']"
34,252,22,26,19,"['soccor.ghuy', 'dineiarantes', 'megbern', 'leticiasmonteiro', 'ziyadbinsulaiman', 'michaellarge', 'johnpaulstroud', 'daniellenichols', 'jordanvandegrift', 'festivarian', 'carterwarren12', 'lucasnukayahead', 'rhunt', 'alineelquist', 'robertturner1', 'cwalker', 'stevejohns', 'arthurribe', 'majeed']",2,"['egraugnard', 'robertturner253']",7,"['teamreidy', 'bephuonganh', 'sierraludwig', 'kinneybradh', None, 'lanlibsu', 'andybaldwin']",28,"['teamreidy', 'soccor.ghuy', 'dineiarantes', 'megbern', 'leticiasmonteiro', 'ziyadbinsulaiman', 'michaellarge', 'johnpaulstroud', 'egraugnard', 'robertturner253', 'daniellenichols', 'jordanvandegrift', 'bephuonganh', 'festivarian', 'carterwarren12', 'lucasnukayahead', None, 'kinneybradh', 'lanlibsu', 'rhunt', 'sierraludwig', 'alineelquist', 'robertturner1', 'cwalker', 'stevejohns', 'arthurribe', 'majeed', 'andybaldwin']"
34,253,22,26,19,"['dineiarantes', 'megbern', 'leticiasmonteiro', 'ziyadbinsulaiman', 'michaellarge', 'johnpaulstroud', 'egraugnard', 'robertturner253', 'daniellenichols', 'jordanvandegrift', 'festivarian', 'carterwarren12', 'lucasnukayahead', 'rhunt', 'alineelquist', 'cwalker', 'stevejohns', 'arthurribe', 'majeed']",2,"['soccor.ghuy', 'robertturner1']",7,"['teamreidy', 'bephuonganh', 'sierraludwig', 'kinneybradh', None, 'lanlibsu', 'andybaldwin']",28,"['teamreidy', 'soccor.ghuy', 'dineiarantes', 'megbern', 'leticiasmonteiro', 'ziyadbinsulaiman', 'michaellarge', 'johnpaulstroud', 'egraugnard', 'robertturner253', 'daniellenichols', 'jordanvandegrift', 'bephuonganh', 'festivarian', 'carterwarren12', 'lucasnukayahead', None, 'kinneybradh', 'lanlibsu', 'rhunt', 'sierraludwig', 'alineelquist', 'robertturner1', 'cwalker', 'stevejohns', 'arthurribe', 'majeed', 'andybaldwin']"
34,249,22,23,16,"['leticiasmonteiro', 'festivarian', 'alineelquist', 'robertturner1', 'dineiarantes', 'michaellarge', 'rhunt', 'cwalker', 'johnpaulstroud', 'lucasnukayahead', 'stevejohns', 'arthurribe', 'daniellenichols', 'megbern', 'majeed', 'jordanvandegrift']",5,"['ziyadbinsulaiman', 'carterwarren12', 'soccor.ghuy', 'egraugnard', 'robertturner253']",7,"['bephuonganh', 'sierraludwig', 'changjiandeng', 'kinneybradh', None, 'lanlibsu', 'andybaldwin']",28,"['soccor.ghuy', 'dineiarantes', 'changjiandeng', 'megbern', 'leticiasmonteiro', 'ziyadbinsulaiman', 'michaellarge', 'johnpaulstroud', 'egraugnard', 'robertturner253', 'daniellenichols', 'jordanvandegrift', 'bephuonganh', 'festivarian', 'carterwarren12', 'lucasnukayahead', None, 'kinneybradh', 'lanlibsu', 'rhunt', 'sierraludwig', 'alineelquist', 'robertturner1', 'cwalker', 'stevejohns', 'arthurribe', 'majeed', 'andybaldwin']"
34,250,22,18,12,"['ziyadbinsulaiman', 'soccor.ghuy', 'alineelquist', 'robertturner1', 'cwalker', 'michaellarge', 'lucasnukayahead', 'johnpaulstroud', 'egraugnard', 'daniellenichols', 'majeed', 'rhunt']",9,"['leticiasmonteiro', 'festivarian', 'carterwarren12', 'dineiarantes', 'stevejohns', 'robertturner253', 'arthurribe', 'megbern', 'jordanvandegrift']",6,"['bephuonganh', 'sierraludwig', 'lanlibsu2', None, 'lanlibsu', 'andybaldwin']",27,"['soccor.ghuy', 'dineiarantes', 'lanlibsu2', 'megbern', 'leticiasmonteiro', 'ziyadbinsulaiman', 'michaellarge', 'johnpaulstroud', 'egraugnard', 'robertturner253', 'daniellenichols', 'jordanvandegrift', 'bephuonganh', 'festivarian', 'carterwarren12', 'lucasnukayahead', None, 'lanlibsu', 'rhunt', 'sierraludwig', 'alineelquist', 'robertturner1', 'cwalker', 'stevejohns', 'arthurribe', 'majeed', 'andybaldwin']"
34,121,22,17,12,"['festivarian', 'ziyadbinsulaiman', 'carterwarren12', 'soccor.ghuy', 'alineelquist', 'rhunt', 'lucasnukayahead', 'johnpaulstroud', 'stevejohns', 'daniellenichols', 'megbern', 'jordanvandegrift']",9,"['leticiasmonteiro', 'robertturner1', 'dineiarantes', 'michaellarge', 'cwalker', 'egraugnard', 'robertturner253', 'arthurribe', 'majeed']",5,"['teamreidy', 'bephuonganh', 'sierraludwig', None, 'lanlibsu']",26,"['teamreidy', 'soccor.ghuy', 'dineiarantes', 'megbern', 'leticiasmonteiro', 'ziyadbinsulaiman', 'michaellarge', 'johnpaulstroud', 'egraugnard', 'robertturner253', 'daniellenichols', 'jordanvandegrift', 'bephuonganh', 'festivarian', 'carterwarren12', 'lucasnukayahead', None, 'lanlibsu', 'rhunt', 'sierraludwig', 'alineelquist', 'robertturner1', 'cwalker', 'stevejohns', 'arthurribe', 'majeed']"
34,122,22,16,12,"['festivarian', 'carterwarren12', 'jordanvandegrift', 'soccor.ghuy', 'alineelquist', 'michaellarge', 'lucasnukayahead', 'stevejohns', 'daniellenichols', 'megbern', 'majeed', 'rhunt']",9,"['leticiasmonteiro', 'ziyadbinsulaiman', 'robertturner1', 'dineiarantes', 'cwalker', 'egraugnard', 'johnpaulstroud', 'robertturner253', 'arthurribe']",4,"['bephuonganh', None, 'sierraludwig', 'andybaldwin']",25,"['bephuonganh', 'festivarian', 'arthurribe', 'carterwarren12', 'soccor.ghuy', 'andybaldwin', 'dineiarantes', 'lucasnukayahead', 'megbern', None, 'rhunt', 'leticiasmonteiro', 'sierraludwig', 'ziyadbinsulaiman', 'alineelquist', 'robertturner1', 'cwalker', 'michaellarge', 'johnpaulstroud', 'egraugnard', 'robertturner253', 'stevejohns', 'daniellenichols', 'majeed', 'jordanvandegrift']"
35,257,21,22,18,"['mls272', 'rlm152', 'bdg33', 'nqh', 'cwm58', 'pasinika10', 'aea43', 'krm90', 'nws20', 'gpb23', 'cjl94', 'kds65', 'ceo11235', 'ejh101', 'formaterials', 'jmh267', 'maw170', 'ricardo_baco']",2,"['candreasen', 'sieme']",4,"['jmv50', None, 'bhavanaswaminathan', 'mdh80']",24,"['pasinika10', 'aea43', 'bhavanaswaminathan', 'candreasen', 'kds65', 'mls272', 'cjl94', 'sieme', 'nqh', 'cwm58', 'gpb23', 'ceo11235', 'ricardo_baco', 'rlm152', 'bdg33', 'krm90', 'ejh101', 'formaterials', 'jmh267', None, 'jmv50', 'nws20', 'maw170', 'mdh80']"
35,101,21,20,16,"['rlm152', 'bdg33', 'cwm58', 'pasinika10', 'aea43', 'krm90', 'candreasen', 'gpb23', 'cjl94', 'mls272', 'kds65', 'ejh101', 'ceo11235', 'formaterials', 'jmh267', 'maw170']",4,"['ricardo_baco', 'nws20', 'nqh', 'sieme']",4,"['jmv50', None, 'mdh80', 'reb121']",24,"['pasinika10', 'aea43', 'candreasen', 'kds65', 'mls272', 'cjl94', 'reb121', 'sieme', 'nqh', 'cwm58', 'gpb23', 'ceo11235', 'ricardo_baco', 'rlm152', 'bdg33', 'krm90', 'ejh101', 'formaterials', 'jmh267', None, 'jmv50', 'nws20', 'maw170', 'mdh80']"
36,183,21,100,1,['pjnick300'],19,"['mdsalahuddin', 'npant', 'hestrof2', 'couvert2', 'ewe2', 'mouche1', 'edeutsch90', 'smccorm2', 'kjabon2', 'jlin43', 'nmeeks2', 'bjanice2', 'gowthamsriram', 'choicexu', 'sslone2', 'f2012415', 'congx4', 'semurray', 'alf']",99,"['cnlopes12', 'sali12', 'liupufan', 'knipfer2', 'buhl2', 'ecyoung', 'asimha2', 'dlitt2', 'reisber2', 'ahjames2', 'brendaneng1', 'pakelti2', 'halstar9', 'ruining22', 'ed.tir.1', 'jefrin', 'wosabi95', 'zhensun_5', 'hhardin2', 'shoppe3', 'eaallen', 'brgschn2', 'alvinlvalysa', 'jbeta95', 'gracepakeltis', 'elindgren', 'jaikarnik95', 'charmisuk', 'tianshu2', 'yliu181', 'zuojulia', 'junehan1', 'werkkdy2', 'jxiong7', 'whu14', 'mpunuk', 'mingye.gao', 'hwang281', 'dianeluvsart', 'zhoffm', 'jedrals2', 'mantianxue0101', 'zshen15', 'dkuai2', 'warpins2', 'samsrajer', 'qinglin2', 'carolgu', 'jdray2', 'avelard2', 'rishychacko', 'fpkelly2', 'dsch33', 'lachwsk2', 'melissagoetter', 'shenxinrusue', 'dpfoste2', 'sdschmi2', 'dshi10', 'vasyltheonly', 'mchu5', 'aln', 'zhensun5', 'slipperyjack007', 'mcheng94', 'ywada3', 'zwu27', 'laurentaylor', 'crosent2', 'cwojtan', 'bacchanalianomark', 'statar2', 'slbecke2', 'dman5505', 'sloneil21994', 'amango4', 'yifanyao', 'echo93924', 'dli29', 'emfoley14', 'chunxu2', None, 'jacobcamp1', 'billli1996', 'sniperzx13', 'antony.huang.129', 'ntxuby', 'joylin0806', 'mbmoy2', 'yyao13', 'sho1123', 'mmkurth2', 'lin.joanna.y', 'ruining2', 'sikaufm2', 'adbrown3', 'jkim561', 'kagebei2', 'nlee17']",119,"['cnlopes12', 'mdsalahuddin', 'npant', 'sali12', 'liupufan', 'knipfer2', 'buhl2', 'ecyoung', 'asimha2', 'dlitt2', 'reisber2', 'couvert2', 'ahjames2', 'brendaneng1', 'ewe2', 'pakelti2', 'halstar9', 'ruining22', 'ed.tir.1', 'jefrin', 'mouche1', 'wosabi95', 'zhensun_5', 'hhardin2', 'shoppe3', 'eaallen', 'brgschn2', 'alvinlvalysa', 'jbeta95', 'gracepakeltis', 'elindgren', 'jaikarnik95', 'charmisuk', 'tianshu2', 'yliu181', 'zuojulia', 'junehan1', 'werkkdy2', 'jxiong7', 'whu14', 'mpunuk', 'mingye.gao', 'hwang281', 'smccorm2', 'dianeluvsart', 'zhoffm', 'jedrals2', 'kjabon2', 'mantianxue0101', 'zshen15', 'bjanice2', 'gowthamsriram', 'dkuai2', 'warpins2', 'samsrajer', 'qinglin2', 'carolgu', 'sslone2', 'f2012415', 'jdray2', 'jkim561', 'avelard2', 'rishychacko', 'fpkelly2', 'dsch33', 'alf', 'lachwsk2', 'melissagoetter', 'shenxinrusue', 'pjnick300', 'dpfoste2', 'hestrof2', 'sdschmi2', 'dshi10', 'vasyltheonly', 'mchu5', 'aln', 'zhensun5', 'slipperyjack007', 'mcheng94', 'edeutsch90', 'ywada3', 'zwu27', 'laurentaylor', 'crosent2', 'cwojtan', 'bacchanalianomark', 'statar2', 'slbecke2', 'dman5505', 'sloneil21994', 'amango4', 'yifanyao', 'echo93924', 'dli29', 'emfoley14', 'chunxu2', None, 'jacobcamp1', 'billli1996', 'sniperzx13', 'antony.huang.129', 'jlin43', 'nmeeks2', 'ntxuby', 'joylin0806', 'mbmoy2', 'choicexu', 'yyao13', 'congx4', 'sho1123', 'lin.joanna.y', 'ruining2', 'mmkurth2', 'sikaufm2', 'adbrown3', 'semurray', 'kagebei2', 'nlee17']"
36,185,21,92,2,"['edeutsch90', 'ewe2']",18,"['kjabon2', 'mouche1', 'mdsalahuddin', 'npant', 'jlin43', 'nmeeks2', 'bjanice2', 'pjnick300', 'gowthamsriram', 'hestrof2', 'choicexu', 'couvert2', 'sslone2', 'f2012415', 'congx4', 'semurray', 'smccorm2', 'alf']",90,"['cnlopes12', 'sali12', 'knipfer2', 'buhl2', 'ecyoung', 'asimha2', 'dlitt2', 'reisber2', 'szhang87', 'eswu2', 'ahjames2', 'julia.zuo', 'brendaneng1', 'pakelti2', 'ed.tir.1', 'jefrin', 'hhardin2', 'shoppe3', 'brgschn2', 'alvinlvalysa', 'jbeta95', 'jaikarnik95', 'hzhou30', 'tianshu2', 'shamaleeg1', 'sdhanak1', 'junehan1', 'werkkdy2', 'jxiong7', 'whu14', 'mpunuk', 'mingye.gao', 'hwang281', 'elindgr2', 'zhoffm', 'jedrals2', 'mantianxue0101', 'dkuai2', 'warpins2', 'samsrajer', 'qinglin2', 'jdray2', 'avelard2', 'shoughton625', 'fpkelly2', 'ndunlap2', 'dsch33', 'lachwsk2', 'melissagoetter', 'a_kuzni2', 'dpfoste2', 'sdschmi2', 'liuyuting1006', 'dshi10', 'vasyltheonly', 'aln', 'mchu5', 'hsp6634', 'zhensun5', 'mcheng94', '17staru', 'ywada3', 'zwu27', 'ramansbach', 'laurentaylor', 'mlandi6', 'cwojtan', 'statar2', 'slbecke2', 'sloneil21994', 'amango4', 'yifanyao', 'echo93924', 'dli29', 'emfoley14', 'chunxu2', None, 'zhan.shi.106', 'billli1996', 'antony.huang.129', 'ntxuby', 'joylin0806', 'mbmoy2', 'lin.joanna.y', 'ruining2', 'sikaufm2', 'jkim561', 'kagebei2', 'nlee17', 'rmaass']",110,"['cnlopes12', 'mdsalahuddin', 'npant', 'sali12', 'knipfer2', 'buhl2', 'ecyoung', 'asimha2', 'dlitt2', 'reisber2', 'couvert2', 'szhang87', 'eswu2', 'ahjames2', 'julia.zuo', 'brendaneng1', 'ewe2', 'pakelti2', 'ed.tir.1', 'jefrin', 'mouche1', 'hhardin2', 'shoppe3', 'brgschn2', 'alvinlvalysa', 'jbeta95', 'jaikarnik95', 'hzhou30', 'tianshu2', 'shamaleeg1', 'sdhanak1', 'junehan1', 'werkkdy2', 'jxiong7', 'whu14', 'mpunuk', 'mingye.gao', 'hwang281', 'elindgr2', 'smccorm2', 'zhoffm', 'jedrals2', 'kjabon2', 'mantianxue0101', 'bjanice2', 'gowthamsriram', 'dkuai2', 'warpins2', 'samsrajer', 'qinglin2', 'sslone2', 'f2012415', 'jdray2', 'avelard2', 'shoughton625', 'fpkelly2', 'ndunlap2', 'dsch33', 'alf', 'lachwsk2', 'melissagoetter', 'a_kuzni2', 'pjnick300', 'dpfoste2', 'hestrof2', 'sdschmi2', 'liuyuting1006', 'dshi10', 'vasyltheonly', 'aln', 'mchu5', 'hsp6634', 'zhensun5', 'mcheng94', '17staru', 'edeutsch90', 'ywada3', 'zwu27', 'ramansbach', 'laurentaylor', 'mlandi6', 'cwojtan', 'statar2', 'slbecke2', 'sloneil21994', 'amango4', 'yifanyao', 'echo93924', 'dli29', 'emfoley14', 'chunxu2', None, 'zhan.shi.106', 'billli1996', 'antony.huang.129', 'jlin43', 'nmeeks2', 'ntxuby', 'joylin0806', 'mbmoy2', 'choicexu', 'congx4', 'lin.joanna.y', 'ruining2', 'sikaufm2', 'jkim561', 'semurray', 'kagebei2', 'nlee17', 'rmaass']"
36,184,21,22,16,"['kjabon2', 'mouche1', 'npant', 'jlin43', 'edeutsch90', 'nmeeks2', 'bjanice2', 'gowthamsriram', 'hestrof2', 'couvert2', 'sslone2', 'congx4', 'semurray', 'ewe2', 'smccorm2', 'alf']",4,"['f2012415', 'mdsalahuddin', 'pjnick300', 'choicexu']",6,"['bkorn2', 'khsiao3', 'bomcdon2', 'cutefuzzypenguin', 'yshao11', None]",26,"['mdsalahuddin', 'npant', 'pjnick300', 'hestrof2', 'couvert2', 'cutefuzzypenguin', 'ewe2', 'mouche1', 'bkorn2', 'edeutsch90', 'bomcdon2', 'yshao11', 'smccorm2', None, 'kjabon2', 'jlin43', 'nmeeks2', 'bjanice2', 'gowthamsriram', 'choicexu', 'sslone2', 'f2012415', 'congx4', 'semurray', 'khsiao3', 'alf']"
37,112,20,30,15,"['bjarach2', 'firpo2', 'alburuni', 'yap6', 'xkok2', 'choquett', 'han109', 'acastag2', 'galbrea2', 'knguye32', 'johnsimo95', 'tcoyle2', 'thephiltsai', 'goelakshay2', 'rocilez2']",4,"['hlee156', 'simonts2', 'jacks4jokers', 'waltbt']",15,"['basa2', 'cho135', 'samsrajer', 'ahassan4', 'kennethhau', 'barshad2', 'walt', 'ssharm16', 'kdhau2', 'bmin5', 'ydong14', 'agbaje2', 'brendaneng1', 'ashlesha08', None]",34,"['cho135', 'yap6', 'simonts2', 'bmin5', 'brendaneng1', 'rocilez2', 'agbaje2', 'basa2', 'ahassan4', 'choquett', 'waltbt', 'han109', 'walt', 'galbrea2', 'ssharm16', 'bjarach2', 'alburuni', 'xkok2', 'acastag2', 'kdhau2', 'johnsimo95', 'tcoyle2', 'goelakshay2', 'ashlesha08', None, 'jacks4jokers', 'firpo2', 'samsrajer', 'kennethhau', 'barshad2', 'knguye32', 'ydong14', 'thephiltsai', 'hlee156']"
37,89,20,25,14,"['bjarach2', 'firpo2', 'yap6', 'xkok2', 'han109', 'acastag2', 'galbrea2', 'knguye32', 'johnsimo95', 'tcoyle2', 'thephiltsai', 'goelakshay2', 'rocilez2', 'jacks4jokers']",5,"['alburuni', 'choquett', 'waltbt', 'simonts2', 'hlee156']",11,"['cho135', 'abaddon2mist', None, 'samsrajer', 'ydong119', 'barshad2', 'bmin5', 'agbaje2', 'brendaneng1', 'ashlesha08', 'lgoddard']",30,"['cho135', 'yap6', 'simonts2', 'bmin5', 'brendaneng1', 'rocilez2', 'lgoddard', 'agbaje2', 'abaddon2mist', 'choquett', 'waltbt', 'han109', 'galbrea2', 'bjarach2', 'alburuni', 'xkok2', 'acastag2', 'johnsimo95', 'tcoyle2', 'goelakshay2', 'ashlesha08', None, 'jacks4jokers', 'firpo2', 'samsrajer', 'ydong119', 'barshad2', 'knguye32', 'thephiltsai', 'hlee156']"
38,151,20,40,1,['dukesalex17'],18,"['jschoelz', 'lucasaas_94', 'maridamm', 'jhaveri', 'r2arthu', 'fabio.principato', 'guojingdrum', 'yao', 'dtmccormick', 'mario.pparra', 'hanruiruigoing', 'bouscher', 'pablopblazquez', 'albers7915', 'cjk2137', 'aandest', 'garylim', 'janam']",39,"['jtdath', 'jsinibaldi', 'tuhlich', 'nickjcu', 'sidneygolliher', 'antonygillette', 'gaboth22', 'jtraub91', 'sammymhowe', 'zobeldavid', 'david4101', 'jbocinsky', 'coreyrn8', 'mronda', 'kstultz15', 'vsoliz', 'chrislai95', 'kristianlegcevic', 'jacksonecarroll', 'sten621', 'andrew_lemx', 'abarbeite', 'fengshui', 'joshuaagarth', 'docta', 'abkrepacki', 'slapeyre1993', 'guybrush', 'bbanksg7', 'uchaudhry', 'bkelly2014', None, 'abrandt94', 'mikesanchezuf', 'cmann0917', 'michael.correia', 'astainsby', 'ianmcodom', 'adrianj25']",58,"['jschoelz', 'jtdath', 'jsinibaldi', 'tuhlich', 'nickjcu', 'sidneygolliher', 'antonygillette', 'gaboth22', 'jtraub91', 'sammymhowe', 'cjk2137', 'zobeldavid', 'david4101', 'jbocinsky', 'coreyrn8', 'mronda', 'kstultz15', 'jhaveri', 'vsoliz', 'chrislai95', 'kristianlegcevic', 'jacksonecarroll', 'guojingdrum', 'sten621', 'hanruiruigoing', 'andrew_lemx', 'abarbeite', 'garylim', 'fengshui', 'lucasaas_94', 'joshuaagarth', 'docta', 'abkrepacki', 'r2arthu', 'slapeyre1993', 'dukesalex17', 'fabio.principato', 'guybrush', 'bbanksg7', 'mario.pparra', 'uchaudhry', 'bkelly2014', 'adrianj25', 'bouscher', None, 'abrandt94', 'mikesanchezuf', 'cmann0917', 'maridamm', 'michael.correia', 'yao', 'dtmccormick', 'astainsby', 'pablopblazquez', 'albers7915', 'ianmcodom', 'aandest', 'janam']"
38,150,20,27,1,['cjk2137'],18,"['jschoelz', 'lucasaas_94', 'maridamm', 'jhaveri', 'r2arthu', 'dukesalex17', 'guojingdrum', 'fabio.principato', 'yao', 'mario.pparra', 'dtmccormick', 'hanruiruigoing', 'bouscher', 'pablopblazquez', 'albers7915', 'aandest', 'garylim', 'janam']",26,"['nds2123', 'amusa92695', 'emh2230', 'bugosjason', 'jns2146', 'cc3920', 'at2910', 'klei7', 'hjs2143', 'clk2142', 'sm3773', 'eze2102', 'pc2671', 'mhq2101', 'ew2315', 'jmv2164', 'djs2240', 'scm2173', None, 'jp3492', 'mka2145', 'wfc2111', 'zlhalex', 'amd2254', 'durukah', 'johnkym']",45,"['jschoelz', 'nds2123', 'amusa92695', 'cjk2137', 'bugosjason', 'emh2230', 'jns2146', 'jhaveri', 'cc3920', 'at2910', 'klei7', 'guojingdrum', 'hjs2143', 'clk2142', 'hanruiruigoing', 'sm3773', 'eze2102', 'pc2671', 'mhq2101', 'ew2315', 'garylim', 'jmv2164', 'lucasaas_94', 'djs2240', 'r2arthu', 'scm2173', 'dukesalex17', 'fabio.principato', 'mario.pparra', 'bouscher', None, 'jp3492', 'mka2145', 'wfc2111', 'zlhalex', 'maridamm', 'amd2254', 'yao', 'dtmccormick', 'durukah', 'johnkym', 'pablopblazquez', 'albers7915', 'aandest', 'janam']"
39,235,19,23,16,"['fhismail', 'vashist1', 'akgoyal2', 'duncanzhang1', 'hbhatia2', 'kfeng', 'garyliu2', 'kinney2', 'meroy', 'pengjiang4', 'jhzayed2', 'foreverlea', 'eguzman6', 'mliu41', 'dyrock', 'khou2']",2,"['dkong6', 'mnxmq125guo']",7,"['rnconra2', 'andersonpaac', 'dlitt2', 'tampubo2', 'belkhad1', 'hiddename39', None]",25,"['fhismail', 'andersonpaac', 'dlitt2', 'garyliu2', 'dkong6', 'foreverlea', 'rnconra2', 'mliu41', 'khou2', 'duncanzhang1', 'kinney2', 'eguzman6', 'belkhad1', 'hiddename39', None, 'dyrock', 'vashist1', 'akgoyal2', 'mnxmq125guo', 'hbhatia2', 'kfeng', 'meroy', 'pengjiang4', 'tampubo2', 'jhzayed2']"
39,88,19,22,16,"['vashist1', 'akgoyal2', 'duncanzhang1', 'mnxmq125guo', 'hbhatia2', 'kfeng', 'garyliu2', 'kinney2', 'meroy', 'pengjiang4', 'dkong6', 'eguzman6', 'mliu41', 'foreverlea', 'dyrock', 'khou2']",2,"['fhismail', 'jhzayed2']",6,"['mnxmq125', 'kherzig', 'yulunwu3', 'dlitt2', 'dutrow2', None]",24,"['fhismail', 'kherzig', 'yulunwu3', 'dlitt2', 'garyliu2', 'dkong6', 'foreverlea', 'mnxmq125', 'mliu41', 'khou2', 'duncanzhang1', 'kinney2', 'eguzman6', 'dutrow2', None, 'dyrock', 'vashist1', 'akgoyal2', 'mnxmq125guo', 'hbhatia2', 'kfeng', 'meroy', 'pengjiang4', 'jhzayed2']"
40,198,19,12,9,"['alkanderiii', 'anfal.ayed.94', 'dalalalhindal', 'nawafr', 'bassamnn', 'rayooma94', 'shoq', 'sara12', 'fatma.b']",9,"['maresjw', 'jaykg37', 'joaoaresende', 'rahulghosh5', 'yamakei122432', 'jill.schlaak', 'shawn', 'philippkeller', 'mingyenlu']",3,"[None, 'ta_helpers', 'falsejari3']",21,"['jaykg37', 'joaoaresende', 'alkanderiii', 'rahulghosh5', 'dalalalhindal', 'nawafr', 'bassamnn', 'jill.schlaak', 'shawn', 'sara12', None, 'maresjw', 'falsejari3', 'ta_helpers', 'yamakei122432', 'anfal.ayed.94', 'rayooma94', 'shoq', 'philippkeller', 'mingyenlu', 'fatma.b']"
40,197,19,10,6,"['dalalalhindal', 'anfal.ayed.94', 'nawafr', 'shoq', 'sara12', 'fatma.b']",12,"['maresjw', 'jaykg37', 'joaoaresende', 'alkanderiii', 'rahulghosh5', 'yamakei122432', 'bassamnn', 'rayooma94', 'jill.schlaak', 'shawn', 'philippkeller', 'mingyenlu']",4,"['omar1900', 'ta_helpers', None, 'fatoom']",22,"['jaykg37', 'joaoaresende', 'alkanderiii', 'rahulghosh5', 'dalalalhindal', 'nawafr', 'bassamnn', 'jill.schlaak', 'shawn', 'sara12', None, 'maresjw', 'ta_helpers', 'yamakei122432', 'anfal.ayed.94', 'fatoom', 'rayooma94', 'shoq', 'philippkeller', 'omar1900', 'mingyenlu', 'fatma.b']"
41,193,19,19,14,"['meteor_sized_hail', 'martinsanchez09', 'whk623502280', 'jaweldon', 'apologia107', 'erikv15', 'wdavon24', 'trreed', 'jeromelaw291', 'jkfrancis7', 'asepulveda', 'yungdeesh', 'riacarnations', 'angelal']",4,"['asflores', 'liuangela1991', 'tylorellard', 'mmgloudeman']",5,"['xxpepchaoticxx', 'kennychung1993', 'mgloudeman11', 'arsmall', None]",23,"['xxpepchaoticxx', 'whk623502280', 'mmgloudeman', 'jaweldon', 'jeromelaw291', 'asflores', 'asepulveda', None, 'yungdeesh', 'trreed', 'riacarnations', 'meteor_sized_hail', 'angelal', 'martinsanchez09', 'apologia107', 'erikv15', 'wdavon24', 'kennychung1993', 'mgloudeman11', 'arsmall', 'liuangela1991', 'jkfrancis7', 'tylorellard']"
41,194,19,17,16,"['whk623502280', 'martinsanchez09', 'mmgloudeman', 'jaweldon', 'erikv15', 'apologia107', 'wdavon24', 'yungdeesh', 'jeromelaw291', 'asflores', 'liuangela1991', 'jkfrancis7', 'trreed', 'tylorellard', 'riacarnations', 'angelal']",2,"['meteor_sized_hail', 'asepulveda']",1,[None],19,"['whk623502280', 'mmgloudeman', 'jaweldon', 'jeromelaw291', 'asflores', 'asepulveda', None, 'yungdeesh', 'trreed', 'riacarnations', 'meteor_sized_hail', 'angelal', 'martinsanchez09', 'apologia107', 'erikv15', 'wdavon24', 'liuangela1991', 'jkfrancis7', 'tylorellard']"
42,146,18,18,17,"['casper16', 'liu16', 'soj16', 'wellnitz16', 'travanti16', 'nguyenh16', 'parkerhalcomb', 'arlint16', 'inan16', 'bernhofe18', 'chener16', 'hutson16', 'hildebra16', 'devon.arreola', 'shin16', 'osterberg', 'reidbuchanan']",0,[],1,[None],18,"['travanti16', 'bernhofe18', 'hutson16', None, 'osterberg', 'casper16', 'liu16', 'soj16', 'wellnitz16', 'nguyenh16', 'parkerhalcomb', 'arlint16', 'inan16', 'chener16', 'hildebra16', 'devon.arreola', 'shin16', 'reidbuchanan']"
43,49,18,15,5,"['ammusanal', 'premnath', 'aparna2', 'ashutosh723', 'chaudharinikhil02']",12,"['pawarrajwardhan.madhukar2015', 'ranibarkha', 'sasiponnam', 'tmshen', 'caru_88', 'surensurendar7', 'sreemoyee07', 'santhoshravi', 'seeker16', 'muralisudha', 'srsitaaramanmtech', 'cpchiu']",10,"['darshanrv', 'nikita2', 'charushila3', 'aswathyushamohan2', 'mntvit92', 'visheshmk', 'esathiyacnr', 'steffy30', 'rjpatil19', None]",27,"['darshanrv', 'nikita2', 'tmshen', 'premnath', 'charushila3', 'aswathyushamohan2', 'santhoshravi', 'seeker16', 'esathiyacnr', 'rjpatil19', 'srsitaaramanmtech', None, 'chaudharinikhil02', 'pawarrajwardhan.madhukar2015', 'ammusanal', 'ranibarkha', 'sasiponnam', 'aparna2', 'caru_88', 'surensurendar7', 'sreemoyee07', 'muralisudha', 'mntvit92', 'visheshmk', 'steffy30', 'ashutosh723', 'cpchiu']"
43,54,18,13,7,"['ranibarkha', 'sasiponnam', 'surensurendar7', 'muralisudha', 'sreemoyee07', 'santhoshravi', 'srsitaaramanmtech']",10,"['pawarrajwardhan.madhukar2015', 'ammusanal', 'tmshen', 'premnath', 'aparna2', 'caru_88', 'seeker16', 'ashutosh723', 'cpchiu', 'chaudharinikhil02']",6,"['satyaprakash', 'kabhishek744', 'aswathyushamohan2', 'mntvit92', 'esathiyacnr', None]",23,"['tmshen', 'premnath', 'kabhishek744', 'aswathyushamohan2', 'santhoshravi', 'seeker16', 'esathiyacnr', 'srsitaaramanmtech', None, 'chaudharinikhil02', 'pawarrajwardhan.madhukar2015', 'ammusanal', 'satyaprakash', 'ranibarkha', 'sasiponnam', 'aparna2', 'caru_88', 'surensurendar7', 'sreemoyee07', 'muralisudha', 'mntvit92', 'ashutosh723', 'cpchiu']"
43,50,18,12,4,"['ashutosh723', 'premnath', 'aparna2', 'chaudharinikhil02']",13,"['pawarrajwardhan.madhukar2015', 'ammusanal', 'ranibarkha', 'sasiponnam', 'tmshen', 'caru_88', 'surensurendar7', 'sreemoyee07', 'santhoshravi', 'seeker16', 'muralisudha', 'srsitaaramanmtech', 'cpchiu']",8,"['darshanrv', 'charushila3', 'aswathyushamohan2', 'mntvit92', 'esathiyacnr', 'steffy30', 'rjpatil19', None]",25,"['darshanrv', 'tmshen', 'premnath', 'charushila3', 'aswathyushamohan2', 'santhoshravi', 'seeker16', 'esathiyacnr', 'rjpatil19', 'srsitaaramanmtech', None, 'chaudharinikhil02', 'pawarrajwardhan.madhukar2015', 'ammusanal', 'ranibarkha', 'sasiponnam', 'aparna2', 'caru_88', 'surensurendar7', 'sreemoyee07', 'muralisudha', 'mntvit92', 'steffy30', 'ashutosh723', 'cpchiu']"
43,56,18,11,6,"['ammusanal', 'premnath', 'aparna2', 'surensurendar7', 'ashutosh723', 'srsitaaramanmtech']",11,"['pawarrajwardhan.madhukar2015', 'ranibarkha', 'sasiponnam', 'tmshen', 'caru_88', 'muralisudha', 'sreemoyee07', 'santhoshravi', 'seeker16', 'cpchiu', 'chaudharinikhil02']",5,"['rohitnimje', 'charushila3', 'aswathyushamohan2', 'mntvit92', None]",22,"['rohitnimje', 'tmshen', 'premnath', 'charushila3', 'aswathyushamohan2', 'santhoshravi', 'seeker16', 'srsitaaramanmtech', None, 'chaudharinikhil02', 'pawarrajwardhan.madhukar2015', 'ammusanal', 'ranibarkha', 'sasiponnam', 'aparna2', 'caru_88', 'surensurendar7', 'sreemoyee07', 'muralisudha', 'mntvit92', 'ashutosh723', 'cpchiu']"
43,53,18,10,7,"['sasiponnam', 'ranibarkha', 'surensurendar7', 'muralisudha', 'sreemoyee07', 'santhoshravi', 'srsitaaramanmtech']",10,"['pawarrajwardhan.madhukar2015', 'ammusanal', 'tmshen', 'premnath', 'aparna2', 'caru_88', 'seeker16', 'ashutosh723', 'cpchiu', 'chaudharinikhil02']",3,"['kabhishek744', None, 'marbaniangjosh123']",20,"['tmshen', 'premnath', 'kabhishek744', 'santhoshravi', 'seeker16', 'srsitaaramanmtech', None, 'chaudharinikhil02', 'pawarrajwardhan.madhukar2015', 'marbaniangjosh123', 'ammusanal', 'ranibarkha', 'sasiponnam', 'aparna2', 'caru_88', 'surensurendar7', 'sreemoyee07', 'muralisudha', 'ashutosh723', 'cpchiu']"
43,55,18,9,7,"['pawarrajwardhan.madhukar2015', 'premnath', 'aparna2', 'sreemoyee07', 'santhoshravi', 'srsitaaramanmtech', 'chaudharinikhil02']",10,"['ammusanal', 'ranibarkha', 'sasiponnam', 'tmshen', 'caru_88', 'surensurendar7', 'muralisudha', 'seeker16', 'ashutosh723', 'cpchiu']",2,"['mntvit92', None]",19,"['tmshen', 'premnath', 'santhoshravi', 'seeker16', 'srsitaaramanmtech', None, 'chaudharinikhil02', 'pawarrajwardhan.madhukar2015', 'ammusanal', 'ranibarkha', 'sasiponnam', 'aparna2', 'caru_88', 'surensurendar7', 'sreemoyee07', 'muralisudha', 'mntvit92', 'ashutosh723', 'cpchiu']"
44,78,17,28,15,"['f94524048', 'kcopenhagen', 'palejandg', 'scif.ucmerced', 'alelicampbell', 'm.gilbert', 'gracegu89', 'ellisbradley92', 'justicemason06', 'eshen2210', 'iancberg', 'bbayram', 'xuanli0121', 'amacedoandrade', 'peter.schnatz']",1,['hyppolite88'],13,"['runa.sabiha', 'eldumett', 'aacun', 'jeremysmith244', 'sarahwhite603', 'rdhrishya', 'shinjinwoo', 'ttonmoy', 'jzamora', 'carlotta.borsoi', 'mtsukamoto', None, 'devette2']",29,"['f94524048', 'scif.ucmerced', 'm.gilbert', 'ttonmoy', 'eshen2210', 'bbayram', 'kcopenhagen', 'peter.schnatz', 'aacun', 'sarahwhite603', 'rdhrishya', 'shinjinwoo', 'palejandg', 'ellisbradley92', 'xuanli0121', 'mtsukamoto', 'devette2', 'alelicampbell', 'jzamora', None, 'runa.sabiha', 'eldumett', 'jeremysmith244', 'gracegu89', 'hyppolite88', 'justicemason06', 'carlotta.borsoi', 'iancberg', 'amacedoandrade']"
44,84,17,22,15,"['f94524048', 'kcopenhagen', 'palejandg', 'scif.ucmerced', 'alelicampbell', 'm.gilbert', 'gracegu89', 'ellisbradley92', 'justicemason06', 'eshen2210', 'iancberg', 'bbayram', 'xuanli0121', 'amacedoandrade', 'peter.schnatz']",1,['hyppolite88'],7,"['jeremysmith244', 'sarahwhite603', 'indranath', 'jzamora', 'mtsukamoto', None, 'devette2']",23,"['f94524048', 'scif.ucmerced', 'm.gilbert', 'eshen2210', 'bbayram', 'kcopenhagen', 'peter.schnatz', 'sarahwhite603', 'indranath', 'palejandg', 'ellisbradley92', 'xuanli0121', 'mtsukamoto', 'devette2', 'alelicampbell', 'jzamora', None, 'jeremysmith244', 'gracegu89', 'hyppolite88', 'justicemason06', 'iancberg', 'amacedoandrade']"
45,157,17,43,15,"['henryyan829', 'cassidee.kido', 'anika.radiya', 'clx', 'mjy62004', 'veraxrl', 'johnny', 'dakotabrinkman', 'ahua710', 'chinjielim', 'juanpablogf95', 'earnedkibbles', 'mym987', 'jrl48', 'radithya93']",1,['err2147'],28,"['carolinekittle', 'kevin950720', 'jiayu.shen', 'drw28', 'marialopes03', 'chenxi101', 'connor.garet', 'fishcaoru', 'chanwook128', 'cgdantoin', 'sunnyownage', 'charlesxu1995', 'amckee3', 'michaelyang95', 'zyl1024', 'henry.yuen', 'oo_its_kevin', 'varpra1', 'rex', 'lara_sonmez', 'flipflyfall', 'esonmez', 'kevinvan', None, 'tsengsation', 'yiranzhu1994', 'afrankl', 'rmanchenella']",44,"['rmanchenella', 'carolinekittle', 'kevin950720', 'johnny', 'jiayu.shen', 'drw28', 'earnedkibbles', 'marialopes03', 'cassidee.kido', 'mjy62004', 'veraxrl', 'chenxi101', 'connor.garet', 'dakotabrinkman', 'fishcaoru', 'chanwook128', 'cgdantoin', 'juanpablogf95', 'mym987', 'sunnyownage', 'charlesxu1995', 'amckee3', 'michaelyang95', 'henryyan829', 'anika.radiya', 'zyl1024', 'henry.yuen', 'oo_its_kevin', 'varpra1', 'rex', 'lara_sonmez', 'flipflyfall', 'jrl48', 'esonmez', 'kevinvan', None, 'tsengsation', 'yiranzhu1994', 'clx', 'err2147', 'ahua710', 'chinjielim', 'afrankl', 'radithya93']"
45,239,17,29,1,['err2147'],15,"['henryyan829', 'cassidee.kido', 'anika.radiya', 'clx', 'mjy62004', 'veraxrl', 'johnny', 'dakotabrinkman', 'ahua710', 'chinjielim', 'juanpablogf95', 'earnedkibbles', 'mym987', 'jrl48', 'radithya93']",28,"['nds2123', 'mojeda1004', 'amusa92695', 'bugosjason', 'emh2230', 'db2808', 'jns2146', 'cc3920', 'at2910', 'klei7', 'hjs2143', 'clk2142', 'sm3773', 'eze2102', 'ag3529', 'ew2315', 'jmv2164', 'djs2240', 'scm2173', 'ajh2186', 'ib2348', 'mka2145', 'jp3492', None, 'zlhalex', 'wfc2111', 'amd2254', 'durukah']",44,"['nds2123', 'johnny', 'earnedkibbles', 'mojeda1004', 'amusa92695', 'emh2230', 'bugosjason', 'db2808', 'cassidee.kido', 'jns2146', 'cc3920', 'mjy62004', 'veraxrl', 'at2910', 'klei7', 'dakotabrinkman', 'hjs2143', 'clk2142', 'juanpablogf95', 'mym987', 'sm3773', 'eze2102', 'ag3529', 'ew2315', 'jmv2164', 'henryyan829', 'anika.radiya', 'djs2240', 'scm2173', 'jrl48', 'ajh2186', 'ib2348', 'mka2145', 'jp3492', None, 'zlhalex', 'wfc2111', 'clx', 'amd2254', 'err2147', 'durukah', 'ahua710', 'chinjielim', 'radithya93']"
45,158,17,26,2,"['chinjielim', 'err2147']",14,"['henryyan829', 'cassidee.kido', 'anika.radiya', 'clx', 'mjy62004', 'veraxrl', 'johnny', 'dakotabrinkman', 'ahua710', 'juanpablogf95', 'earnedkibbles', 'mym987', 'jrl48', 'radithya93']",24,"['nds2123', 'amusa92695', 'emh2230', 'bugosjason', 'jns2146', 'cc3920', 'at2910', 'klei7', 'hjs2143', 'clk2142', 'sm3773', 'eze2102', 'ag3529', 'mhq2101', 'djs2240', 'scm2173', None, 'jp3492', 'mka2145', 'wfc2111', 'zlhalex', 'amd2254', 'durukah', 'johnkym']",40,"['nds2123', 'johnny', 'earnedkibbles', 'amusa92695', 'bugosjason', 'emh2230', 'cassidee.kido', 'jns2146', 'cc3920', 'mjy62004', 'veraxrl', 'at2910', 'klei7', 'dakotabrinkman', 'hjs2143', 'clk2142', 'juanpablogf95', 'mym987', 'sm3773', 'eze2102', 'ag3529', 'mhq2101', 'henryyan829', 'anika.radiya', 'djs2240', 'scm2173', 'jrl48', 'mka2145', None, 'jp3492', 'wfc2111', 'zlhalex', 'clx', 'amd2254', 'err2147', 'durukah', 'ahua710', 'chinjielim', 'johnkym', 'radithya93']"
45,240,17,24,1,['err2147'],15,"['henryyan829', 'cassidee.kido', 'anika.radiya', 'clx', 'mjy62004', 'veraxrl', 'johnny', 'dakotabrinkman', 'ahua710', 'chinjielim', 'juanpablogf95', 'earnedkibbles', 'mym987', 'jrl48', 'radithya93']",23,"['nds2123', 'amusa92695', 'emh2230', 'bugosjason', 'jns2146', 'cc3920', 'at2910', 'klei7', 'hjs2143', 'clk2142', 'sm3773', 'eze2102', 'ew2315', 'djs2240', 'scm2173', 'ajh2186', 'ib2348', 'jp3492', None, 'wfc2111', 'zlhalex', 'amd2254', 'durukah']",39,"['nds2123', 'johnny', 'earnedkibbles', 'amusa92695', 'bugosjason', 'emh2230', 'cassidee.kido', 'jns2146', 'cc3920', 'mjy62004', 'veraxrl', 'at2910', 'klei7', 'dakotabrinkman', 'hjs2143', 'clk2142', 'juanpablogf95', 'mym987', 'sm3773', 'eze2102', 'ew2315', 'henryyan829', 'anika.radiya', 'djs2240', 'scm2173', 'jrl48', 'ajh2186', None, 'jp3492', 'ib2348', 'wfc2111', 'zlhalex', 'clx', 'amd2254', 'err2147', 'durukah', 'ahua710', 'chinjielim', 'radithya93']"
45,164,17,15,14,"['henryyan829', 'cassidee.kido', 'anika.radiya', 'clx', 'mjy62004', 'veraxrl', 'dakotabrinkman', 'johnny', 'ahua710', 'juanpablogf95', 'earnedkibbles', 'mym987', 'jrl48', 'radithya93']",2,"['chinjielim', 'err2147']",1,[None],17,"['henryyan829', 'anika.radiya', 'johnny', 'earnedkibbles', 'jrl48', None, 'cassidee.kido', 'clx', 'mjy62004', 'veraxrl', 'err2147', 'dakotabrinkman', 'ahua710', 'chinjielim', 'juanpablogf95', 'mym987', 'radithya93']"
45,165,17,9,2,"['chinjielim', 'err2147']",14,"['henryyan829', 'cassidee.kido', 'anika.radiya', 'clx', 'mjy62004', 'veraxrl', 'johnny', 'dakotabrinkman', 'ahua710', 'juanpablogf95', 'earnedkibbles', 'mym987', 'jrl48', 'radithya93']",7,"['amd2254', None, 'johnkym', 'sm3773', 'amusa92695', 'jp3492', 'bugosjason']",23,"['henryyan829', 'anika.radiya', 'johnny', 'earnedkibbles', 'jrl48', 'amusa92695', 'jp3492', None, 'bugosjason', 'cassidee.kido', 'clx', 'amd2254', 'mjy62004', 'veraxrl', 'err2147', 'dakotabrinkman', 'ahua710', 'chinjielim', 'johnkym', 'juanpablogf95', 'mym987', 'sm3773', 'radithya93']"
46,239,17,29,16,"['zlhalex', 'nds2123', 'amusa92695', 'cc3920', 'djs2240', 'scm2173', 'amd2254', 'at2910', 'klei7', 'emh2230', 'hjs2143', 'clk2142', 'eze2102', 'mka2145', 'wfc2111', 'bugosjason']",0,[],13,"['jmv2164', 'jns2146', 'err2147', None, 'durukah', 'jp3492', 'mojeda1004', 'sm3773', 'ag3529', 'ajh2186', 'ib2348', 'ew2315', 'db2808']",29,"['nds2123', 'mojeda1004', 'amusa92695', 'bugosjason', 'emh2230', 'db2808', 'jns2146', 'cc3920', 'at2910', 'klei7', 'hjs2143', 'clk2142', 'sm3773', 'eze2102', 'ag3529', 'ew2315', 'jmv2164', 'djs2240', 'scm2173', 'ajh2186', 'mka2145', 'wfc2111', 'ib2348', 'jp3492', 'zlhalex', None, 'amd2254', 'err2147', 'durukah']"
46,150,17,27,16,"['zlhalex', 'nds2123', 'amusa92695', 'cc3920', 'djs2240', 'scm2173', 'amd2254', 'at2910', 'klei7', 'emh2230', 'hjs2143', 'clk2142', 'eze2102', 'mka2145', 'wfc2111', 'bugosjason']",0,[],11,"['jmv2164', 'jns2146', 'durukah', 'johnkym', 'jp3492', 'sm3773', 'pc2671', 'mhq2101', 'cjk2137', None, 'ew2315']",27,"['nds2123', 'amusa92695', 'cjk2137', 'bugosjason', 'emh2230', 'jns2146', 'cc3920', 'at2910', 'klei7', 'hjs2143', 'clk2142', 'sm3773', 'eze2102', 'pc2671', 'mhq2101', 'ew2315', 'jmv2164', 'djs2240', 'scm2173', 'mka2145', 'wfc2111', None, 'jp3492', 'zlhalex', 'amd2254', 'durukah', 'johnkym']"
46,158,17,26,16,"['zlhalex', 'nds2123', 'amusa92695', 'cc3920', 'djs2240', 'scm2173', 'amd2254', 'at2910', 'klei7', 'emh2230', 'hjs2143', 'clk2142', 'eze2102', 'mka2145', 'wfc2111', 'bugosjason']",0,[],10,"['jns2146', 'err2147', 'durukah', 'chinjielim', 'johnkym', 'jp3492', 'sm3773', 'ag3529', 'mhq2101', None]",26,"['nds2123', 'amusa92695', 'bugosjason', 'emh2230', 'jns2146', 'cc3920', 'at2910', 'klei7', 'hjs2143', 'clk2142', 'sm3773', 'eze2102', 'ag3529', 'mhq2101', 'djs2240', 'scm2173', 'mka2145', 'wfc2111', None, 'jp3492', 'zlhalex', 'amd2254', 'err2147', 'durukah', 'chinjielim', 'johnkym']"
46,240,17,24,15,"['zlhalex', 'nds2123', 'amusa92695', 'cc3920', 'djs2240', 'scm2173', 'amd2254', 'at2910', 'klei7', 'emh2230', 'hjs2143', 'clk2142', 'eze2102', 'wfc2111', 'bugosjason']",1,['mka2145'],9,"['jns2146', 'err2147', 'ib2348', 'durukah', 'jp3492', 'sm3773', 'ajh2186', None, 'ew2315']",25,"['nds2123', 'amusa92695', 'bugosjason', 'emh2230', 'jns2146', 'cc3920', 'at2910', 'klei7', 'hjs2143', 'clk2142', 'sm3773', 'eze2102', 'ew2315', 'djs2240', 'scm2173', 'ajh2186', 'mka2145', 'wfc2111', None, 'jp3492', 'zlhalex', 'ib2348', 'amd2254', 'err2147', 'durukah']"
46,203,17,22,14,"['zlhalex', 'nds2123', 'amusa92695', 'cc3920', 'djs2240', 'scm2173', 'amd2254', 'at2910', 'klei7', 'hjs2143', 'clk2142', 'eze2102', 'wfc2111', 'emh2230']",2,"['mka2145', 'bugosjason']",8,"['jmv2164', 'jns2146', 'durukah', 'johnkym', 'jp3492', 'sm3773', 'ag3529', None]",24,"['nds2123', 'amusa92695', 'bugosjason', 'emh2230', 'jns2146', 'cc3920', 'at2910', 'klei7', 'hjs2143', 'clk2142', 'sm3773', 'eze2102', 'ag3529', 'jmv2164', 'djs2240', 'scm2173', 'mka2145', 'wfc2111', None, 'jp3492', 'zlhalex', 'amd2254', 'durukah', 'johnkym']"
46,213,17,14,12,"['zlhalex', 'djs2240', 'amd2254', 'scm2173', 'at2910', 'klei7', 'cc3920', 'hjs2143', 'clk2142', 'amusa92695', 'wfc2111', 'bugosjason']",4,"['eze2102', 'nds2123', 'mka2145', 'emh2230']",2,"[None, 'jp3492']",18,"['nds2123', 'djs2240', 'scm2173', 'amusa92695', 'mka2145', 'wfc2111', 'bugosjason', 'emh2230', 'zlhalex', 'jp3492', None, 'cc3920', 'amd2254', 'at2910', 'klei7', 'hjs2143', 'clk2142', 'eze2102']"
46,63,17,13,10,"['nds2123', 'amd2254', 'at2910', 'klei7', 'hjs2143', 'clk2142', 'amusa92695', 'mka2145', 'wfc2111', 'bugosjason']",6,"['zlhalex', 'cc3920', 'djs2240', 'scm2173', 'eze2102', 'emh2230']",3,"['jp3492', None, 'sm3773']",19,"['nds2123', 'djs2240', 'scm2173', 'amusa92695', 'mka2145', 'wfc2111', 'bugosjason', 'emh2230', 'zlhalex', None, 'jp3492', 'cc3920', 'amd2254', 'at2910', 'klei7', 'hjs2143', 'clk2142', 'sm3773', 'eze2102']"
46,215,17,10,7,"['nds2123', 'amusa92695', 'djs2240', 'scm2173', 'eze2102', 'mka2145', 'emh2230']",9,"['zlhalex', 'amd2254', 'cc3920', 'at2910', 'klei7', 'hjs2143', 'clk2142', 'wfc2111', 'bugosjason']",3,"['mhq2101', None, 'jp3492']",19,"['nds2123', 'djs2240', 'scm2173', 'amusa92695', 'mka2145', 'wfc2111', 'bugosjason', 'emh2230', 'zlhalex', 'jp3492', None, 'cc3920', 'amd2254', 'at2910', 'klei7', 'hjs2143', 'clk2142', 'eze2102', 'mhq2101']"
46,165,17,9,3,"['amusa92695', 'amd2254', 'bugosjason']",13,"['zlhalex', 'nds2123', 'cc3920', 'djs2240', 'scm2173', 'at2910', 'klei7', 'hjs2143', 'clk2142', 'eze2102', 'mka2145', 'wfc2111', 'emh2230']",6,"['err2147', None, 'chinjielim', 'johnkym', 'sm3773', 'jp3492']",22,"['nds2123', 'djs2240', 'scm2173', 'amusa92695', 'mka2145', 'wfc2111', 'bugosjason', 'emh2230', 'zlhalex', 'jp3492', None, 'cc3920', 'amd2254', 'at2910', 'klei7', 'err2147', 'hjs2143', 'clk2142', 'chinjielim', 'johnkym', 'sm3773', 'eze2102']"
46,205,17,7,4,"['hjs2143', 'amusa92695', 'djs2240', 'emh2230']",12,"['zlhalex', 'nds2123', 'cc3920', 'amd2254', 'scm2173', 'at2910', 'klei7', 'clk2142', 'eze2102', 'mka2145', 'wfc2111', 'bugosjason']",3,"['johnkym', 'jp3492', None]",19,"['nds2123', 'djs2240', 'scm2173', 'amusa92695', 'mka2145', 'wfc2111', 'bugosjason', 'emh2230', 'zlhalex', None, 'jp3492', 'cc3920', 'amd2254', 'at2910', 'klei7', 'hjs2143', 'clk2142', 'johnkym', 'eze2102']"
47,34,17,20,15,"['kumardaulatyadav', 'chaudharilaxman1', 'guptasuraj908', 'aishwarya.wahane', 'aditya.trivedi94', 'kiranabgul318', 'lorrainelobo290', 'pankajlade110', 'prkpatel49', 'tabhishek608', 'mukeshnishad49', 'kaapsvartak', 'niwarasadan', 'swapnilnipasee', 'whitetigervipin']",1,['bardelinkes'],5,"['jeniljain1008', 'abhay.kshirsagar', 'hit.kamble', None, 'rathod_spce']",21,"['kumardaulatyadav', 'chaudharilaxman1', 'guptasuraj908', 'aishwarya.wahane', 'jeniljain1008', 'abhay.kshirsagar', 'kaapsvartak', 'niwarasadan', 'hit.kamble', 'pankajlade110', None, 'rathod_spce', 'whitetigervipin', 'aditya.trivedi94', 'kiranabgul318', 'lorrainelobo290', 'bardelinkes', 'prkpatel49', 'tabhishek608', 'mukeshnishad49', 'swapnilnipasee']"
49,2,17,127,2,"['harshpathak', 'chandusravanthi']",14,"['jonathan.polaniab', 'lsylves1', 'juliad.gonzalezm', 'kevins.lopezs', 'danielly', 'jorgevc', 'sohel.1', 'dzogra', 'david.mosqueral', 'david_millar29', 'wagenschenke', 'juanmontealegre', 'sen9', 'taniar.romerob1']",125,"['dpl', 'ravikiran19', 'loveena1902', 'manojtalluri.93', 'perumallakavya', 'trinath90', 'dharanidar123', 'vanimerugu', 'anish69052', 'ramisetty12', 'mekalamanishyadav', 'p.rathod', 'manojbukka', 'kszumowski', 'maheshedururi', 'sandychinna90', 'saisatwickyadav', 'shilpa1992', 'swetang22', 'nawaz316', 'nicoramirez', 'shreeyash', 'sandeepx99', 'aartipatel', 'swetang1992', 'manalipatel', 'jayakrishna440', 'mit1993', 'sunil2308', 'mturi', 'ya9mehta', 'jpangan', 'haritha93', 'sanjaymenaria', 'sachitanandraj', 'georgeayoub11', 'pavan.malay', 'mallesh2890', 'satish6688', 'tejasri13293', '802769935jj', 'namratha.siddappa', 'satyen1401', 'kajal', 'narapa', 'kishan7172', 'christxran', 'furquan', 'mohammed18', 'parikhchirag29', 'saladi0293', 'shobhavaddineni', 'kavya.dhanala', 'nagasai', 'mvenu2', 'rahulenukonda525', 'nishat1801', 'rakeshyadav', 'kancharla0113', 'kushalvasoya558', 'eedupuganti07', 'rzaragoza91', 'suneel8055', 'dipali.shatavara', 'anoopreddy1993', 'reetu0610', 'pavan51', 'sathiriv', 'himali_dhaduk2493', 'james54', 'sha6070sha', 'ritvik03', 'teja999', 'aru1204', 'dhanala.kavya123', 'anveshkankanala', 'parita11', 'kavyadhanala567', 'santhoshnn134', 'priyankareddy', 'veeru', 'kunda93', 'marneni01', 'harshavardhanvarmavegesna', 'muralisaiavinash', 'jzherrera', 'pritipatel59', 'venkateah', 'akshaya1512', 'santhosh.y', 'makwanasameer007', 'mani477', 'slim.severnick', 'meen83', 'patel.akash102', 'poojatrivedi', 'trodas1287', 'hem.metalia', 'jrriddley1355', 'binayb175', 'rathodpriyank', 'poyani_mehta', 'rawadhilal', 'dhruvil', 'deepakengineer', 'purna24', 'kashyap09ec71', 'dipal.ptl', None, 'pallugullu', 'nikhilshinde', 'pallavi90', 'kruthiperumalla', 'muralikrishna41', 'bansari21', 'deeppatel092', 'nvnreddy418', 'kevinharish40', 'fardad.falahati', 'nikhila_banda', 'yaminikrishna', 'anoopreddy1992', 'chinthalapally13', 'teju2710', 'kavyathokala']",141,"['ravikiran19', 'ramisetty12', 'mekalamanishyadav', 'juanmontealegre', 'p.rathod', 'manojbukka', 'saisatwickyadav', 'shilpa1992', 'swetang22', 'nicoramirez', 'shreeyash', 'sandeepx99', 'juliad.gonzalezm', 'jorgevc', 'jayakrishna440', 'mit1993', 'sunil2308', 'mturi', 'sanjaymenaria', 'pavan.malay', 'namratha.siddappa', 'kajal', 'narapa', 'kishan7172', 'christxran', 'parikhchirag29', 'chandusravanthi', 'saladi0293', 'shobhavaddineni', 'nagasai', 'mvenu2', 'danielly', 'anoopreddy1993', 'pavan51', 'sathiriv', 'himali_dhaduk2493', 'aru1204', 'santhoshnn134', 'muralisaiavinash', 'lsylves1', 'jzherrera', 'santhosh.y', 'wagenschenke', 'makwanasameer007', 'mani477', 'meen83', 'patel.akash102', 'jrriddley1355', 'rathodpriyank', 'poyani_mehta', 'dhruvil', 'deepakengineer', 'kashyap09ec71', 'pallugullu', 'nikhilshinde', 'kruthiperumalla', 'muralikrishna41', 'kevinharish40', 'fardad.falahati', 'yaminikrishna', 'anoopreddy1992', 'teju2710', 'dpl', 'loveena1902', 'manojtalluri.93', 'perumallakavya', 'trinath90', 'dharanidar123', 'vanimerugu', 'anish69052', 'kszumowski', 'maheshedururi', 'sandychinna90', 'nawaz316', 'aartipatel', 'jonathan.polaniab', 'swetang1992', 'manalipatel', 'ya9mehta', 'jpangan', 'haritha93', 'sachitanandraj', 'georgeayoub11', 'mallesh2890', 'satish6688', 'tejasri13293', '802769935jj', 'satyen1401', 'dzogra', 'furquan', 'mohammed18', 'sen9', 'kavya.dhanala', 'rahulenukonda525', 'nishat1801', 'rakeshyadav', 'kancharla0113', 'kushalvasoya558', 'eedupuganti07', 'rzaragoza91', 'suneel8055', 'taniar.romerob1', 'dipali.shatavara', 'reetu0610', 'james54', 'sha6070sha', 'ritvik03', 'teja999', 'david.mosqueral', 'dhanala.kavya123', 'anveshkankanala', 'parita11', 'kavyadhanala567', 'priyankareddy', 'veeru', 'harshpathak', 'kunda93', 'harshavardhanvarmavegesna', 'pritipatel59', 'venkateah', 'akshaya1512', 'sohel.1', 'david_millar29', 'slim.severnick', 'poojatrivedi', 'trodas1287', 'hem.metalia', 'binayb175', 'kevins.lopezs', 'rawadhilal', 'purna24', 'dipal.ptl', None, 'pallavi90', 'bansari21', 'deeppatel092', 'nvnreddy418', 'nikhila_banda', 'marneni01', 'chinthalapally13', 'kavyathokala']"
49,1,17,41,8,"['jonathan.polaniab', 'kevins.lopezs', 'juliad.gonzalezm', 'danielly', 'jorgevc', 'juanmontealegre', 'david.mosqueral', 'taniar.romerob1']",8,"['lsylves1', 'sohel.1', 'dzogra', 'david_millar29', 'wagenschenke', 'sen9', 'harshpathak', 'chandusravanthi']",33,"['mariaa.montoyam', 'haroldy.herreraa', 'juans.torresa', 'afelipe.blopez', 'maruchale92', 'luisaarcos', 'laurad.sanchezv', 'stephania.navarretel', 'ivandaniloef', 'andream.bravof', 'yedyp.buitragom', 'daniela14', 'leidyc.hernandezp', 'soniac.lizcanoc', 'angieg', None, 'jonathany.polaniab', 'jhona.gomezd1', 'laurac.porrasb', 'jessicap.contrerasa', 'pips0289', 'hernand.abrilm', 'katherinem', 'julianai.sanchezc', 'paulatsanchezt', 'dianaccabrerac', 'leidycarolina', 'ingridp.rodriguezr', 'mariac.hernandezq', 'luis.reya', 'jorcanas', 'angiearismendi', 'maloryd.gutierrezd']",49,"['mariaa.montoyam', 'david.mosqueral', 'haroldy.herreraa', 'afelipe.blopez', 'juans.torresa', 'juanmontealegre', 'harshpathak', 'jonathan.polaniab', 'maruchale92', 'lsylves1', 'juliad.gonzalezm', 'luisaarcos', 'jorgevc', 'sohel.1', 'laurad.sanchezv', 'david_millar29', 'stephania.navarretel', 'wagenschenke', 'ivandaniloef', 'andream.bravof', 'yedyp.buitragom', 'daniela14', 'leidyc.hernandezp', 'kevins.lopezs', 'soniac.lizcanoc', 'dzogra', 'angieg', 'sen9', None, 'chandusravanthi', 'jonathany.polaniab', 'jhona.gomezd1', 'laurac.porrasb', 'jessicap.contrerasa', 'danielly', 'pips0289', 'hernand.abrilm', 'katherinem', 'julianai.sanchezc', 'paulatsanchezt', 'dianaccabrerac', 'leidycarolina', 'ingridp.rodriguezr', 'mariac.hernandezq', 'luis.reya', 'jorcanas', 'angiearismendi', 'taniar.romerob1', 'maloryd.gutierrezd']"
50,155,17,21,14,"['sw3023', 'dianapotter93', 'sjkim2206', 'shs2171', 'jr3360', 'jz2605', 'yl3284', 'sm4088', 'dw2647', 'sm4067', 'gcruzatto', 'ckp2117', 'dn2367', 'damla.dimlioglu']",2,"['candicezhu0317', 'gayathriraj']",7,"['psb2134', 'yutuo529', 'fq2129', 'ipshitadatta', 'pc2671', 'jd3137', None]",23,"['dianapotter93', 'gayathriraj', 'shs2171', 'jr3360', 'jd3137', 'yl3284', 'sm4088', 'ipshitadatta', 'candicezhu0317', 'sw3023', None, 'damla.dimlioglu', 'psb2134', 'yutuo529', 'sjkim2206', 'jz2605', 'dw2647', 'fq2129', 'sm4067', 'pc2671', 'gcruzatto', 'ckp2117', 'dn2367']"
50,167,17,18,14,"['dianapotter93', 'gayathriraj', 'sjkim2206', 'shs2171', 'jr3360', 'jz2605', 'yl3284', 'sm4088', 'dw2647', 'sm4067', 'gcruzatto', 'ckp2117', 'dn2367', 'damla.dimlioglu']",2,"['candicezhu0317', 'sw3023']",4,"['yutuo529', 'jd3137', 'psb2134', None]",20,"['dianapotter93', 'gayathriraj', 'shs2171', 'jr3360', 'jd3137', 'yl3284', 'sm4088', 'candicezhu0317', 'sw3023', None, 'damla.dimlioglu', 'psb2134', 'yutuo529', 'sjkim2206', 'jz2605', 'dw2647', 'sm4067', 'gcruzatto', 'ckp2117', 'dn2367']"
50,156,17,10,6,"['gayathriraj', 'sjkim2206', 'shs2171', 'jz2605', 'sm4088', 'damla.dimlioglu']",10,"['sw3023', 'dianapotter93', 'jr3360', 'yl3284', 'dw2647', 'sm4067', 'candicezhu0317', 'gcruzatto', 'ckp2117', 'dn2367']",4,"['yutuo529', 'aksasatkut', None, 'jd3137']",20,"['dianapotter93', 'gayathriraj', 'shs2171', 'jr3360', 'jd3137', 'yl3284', 'sm4088', 'candicezhu0317', 'sw3023', None, 'damla.dimlioglu', 'aksasatkut', 'yutuo529', 'sjkim2206', 'jz2605', 'dw2647', 'sm4067', 'gcruzatto', 'ckp2117', 'dn2367']"
50,163,17,8,4,"['jr3360', 'sm4067', 'dn2367', 'dianapotter93']",12,"['sw3023', 'gayathriraj', 'sjkim2206', 'shs2171', 'jz2605', 'yl3284', 'sm4088', 'dw2647', 'candicezhu0317', 'gcruzatto', 'ckp2117', 'damla.dimlioglu']",4,"['yutuo529', 'jd3137', 'psb2134', None]",20,"['dianapotter93', 'gayathriraj', 'shs2171', 'jr3360', 'jd3137', 'yl3284', 'sm4088', 'candicezhu0317', 'sw3023', None, 'damla.dimlioglu', 'psb2134', 'yutuo529', 'sjkim2206', 'jz2605', 'dw2647', 'sm4067', 'gcruzatto', 'ckp2117', 'dn2367']"
50,162,17,7,5,"['dianapotter93', 'yl3284', 'dw2647', 'sw3023', 'dn2367']",11,"['gayathriraj', 'sjkim2206', 'shs2171', 'jr3360', 'jz2605', 'sm4088', 'sm4067', 'candicezhu0317', 'gcruzatto', 'ckp2117', 'damla.dimlioglu']",2,"['jd3137', None]",18,"['dianapotter93', 'gayathriraj', 'shs2171', 'jr3360', 'jd3137', 'yl3284', 'sm4088', 'candicezhu0317', 'sw3023', None, 'damla.dimlioglu', 'sjkim2206', 'jz2605', 'dw2647', 'sm4067', 'gcruzatto', 'ckp2117', 'dn2367']"
51,131,15,10,9,"['rolchigo', 'aayushsharmaju', 'mjkenney', 'agosai', 'osanchez', 'shajilar', 'srilok.srinivasan', 'imangh', 'srilok']",5,"['jardelsbelo', 'kodywilk', 'ccking', 'sommerd', 'bfuchsswimsthefly']",1,[None],15,"['jardelsbelo', 'rolchigo', 'kodywilk', 'agosai', 'osanchez', 'ccking', 'imangh', 'sommerd', 'srilok', None, 'aayushsharmaju', 'mjkenney', 'shajilar', 'srilok.srinivasan', 'bfuchsswimsthefly']"
52,125,15,20,9,"['debolt', 'nliu26', 'sp1ke01', 'xuzblair', 'am7155', 'wwhhxq', 'walka', 'tbalaraj', 'akstempl']",5,"['mkatmore', 'nmaududi', 'supadhye', 'rkapoor7', 'anjali.sruju']",11,"['pyjang', 'kiran93eswar', 'vasileska', 'adicool04', 'tulika91', 'max.cotton.71', 'navnano1034', 'asiddhan', 'shujianxue', None, 'sneha.jayaprakash']",25,"['debolt', 'nliu26', 'nmaududi', 'rkapoor7', 'max.cotton.71', 'asiddhan', 'shujianxue', 'sneha.jayaprakash', 'supadhye', 'walka', 'mkatmore', 'pyjang', 'sp1ke01', 'xuzblair', 'kiran93eswar', 'tulika91', 'anjali.sruju', None, 'adicool04', 'navnano1034', 'am7155', 'wwhhxq', 'tbalaraj', 'akstempl', 'vasileska']"
52,190,15,18,8,"['debolt', 'nliu26', 'sp1ke01', 'xuzblair', 'am7155', 'wwhhxq', 'walka', 'akstempl']",6,"['mkatmore', 'nmaududi', 'supadhye', 'rkapoor7', 'anjali.sruju', 'tbalaraj']",10,"['pyjang', 'kiran93eswar', 'adicool04', 'tulika91', 'max.cotton.71', 'zhengxu1', 'navnano1034', 'shujianxue', None, 'vasileska']",24,"['debolt', 'nliu26', 'nmaududi', 'rkapoor7', 'max.cotton.71', 'zhengxu1', 'shujianxue', 'supadhye', 'walka', 'mkatmore', 'pyjang', 'sp1ke01', 'xuzblair', 'kiran93eswar', 'tulika91', 'anjali.sruju', None, 'adicool04', 'navnano1034', 'am7155', 'wwhhxq', 'tbalaraj', 'akstempl', 'vasileska']"
52,52,15,17,9,"['debolt', 'nliu26', 'nmaududi', 'sp1ke01', 'xuzblair', 'wwhhxq', 'walka', 'tbalaraj', 'akstempl']",5,"['mkatmore', 'supadhye', 'am7155', 'anjali.sruju', 'rkapoor7']",8,"['pyjang', 'kiran93eswar', 'adicool04', 'navnano1034', 'max.cotton.71', 'shujianxue', None, 'vasileska']",22,"['mkatmore', 'debolt', 'nliu26', 'pyjang', 'nmaududi', 'sp1ke01', 'xuzblair', 'kiran93eswar', 'rkapoor7', 'anjali.sruju', 'max.cotton.71', 'shujianxue', None, 'supadhye', 'adicool04', 'navnano1034', 'am7155', 'wwhhxq', 'walka', 'tbalaraj', 'akstempl', 'vasileska']"
52,201,15,16,8,"['debolt', 'nliu26', 'nmaududi', 'sp1ke01', 'xuzblair', 'am7155', 'wwhhxq', 'walka']",6,"['mkatmore', 'supadhye', 'rkapoor7', 'anjali.sruju', 'tbalaraj', 'akstempl']",8,"['pyjang', 'tulika91', 'max.cotton.71', 'houqiang1', 'navnano1034', 'asiddhan', None, 'atreyo.mukherjee2011']",22,"['mkatmore', 'debolt', 'nliu26', 'pyjang', 'nmaududi', 'sp1ke01', 'xuzblair', 'tulika91', 'rkapoor7', 'anjali.sruju', 'max.cotton.71', 'houqiang1', 'asiddhan', None, 'supadhye', 'navnano1034', 'am7155', 'wwhhxq', 'walka', 'tbalaraj', 'atreyo.mukherjee2011', 'akstempl']"
52,234,15,15,8,"['nliu26', 'nmaududi', 'sp1ke01', 'xuzblair', 'am7155', 'wwhhxq', 'walka', 'akstempl']",6,"['mkatmore', 'debolt', 'supadhye', 'rkapoor7', 'anjali.sruju', 'tbalaraj']",7,"['adebolt', 'auxedyn', 'adicool04', 'navnano1034', 'houqiang1', 'asiddhan', None]",21,"['mkatmore', 'debolt', 'nliu26', 'nmaududi', 'sp1ke01', 'auxedyn', 'xuzblair', 'rkapoor7', 'anjali.sruju', 'houqiang1', 'asiddhan', None, 'adebolt', 'supadhye', 'adicool04', 'navnano1034', 'am7155', 'wwhhxq', 'walka', 'tbalaraj', 'akstempl']"
53,219,15,32,3,"['areeg', 'maiwaleed0611', 'ayaghobashy']",11,"['alirose12', 'raja_waseem12', 'alessandro.pilotto', 'funny_nonaaa', 'faisal_hussien', 'kareemchicharito14', 'mkrysicki', 'mkrysickiirtm', 'daveestrada12', 'lux1990', 'jtroot']",29,"['abdo.koban', 'marlin', 'sherihannour', 'ahmed.deeb5862', 'ahmed.mohamed1281996', 'zeinab.ali96', 'omar.aadel58', 'michaeluhu', 'hagar26hossam', 'abdalrahman_gamal', 'abdovit54', 'rimon', 'ra', 'tasneemasememam', 'tote641', 'mostafaadel24', 'vamosrafa199795', 'marinamedhat', 'aya.noby', 'minafadel', 'mayarmahmoud', None, 'safaa_ahmed', 'rizkengin', 'sinderila030', 'nadoda3', 'salmakhaled248', 'shepherd_96', 'maudi126']",43,"['abdo.koban', 'marlin', 'sherihannour', 'daveestrada12', 'ahmed.deeb5862', 'ahmed.mohamed1281996', 'zeinab.ali96', 'omar.aadel58', 'ayaghobashy', 'raja_waseem12', 'michaeluhu', 'alessandro.pilotto', 'funny_nonaaa', 'maiwaleed0611', 'mkrysicki', 'hagar26hossam', 'mkrysickiirtm', 'jtroot', 'abdalrahman_gamal', 'abdovit54', 'areeg', 'rimon', 'ra', 'tasneemasememam', 'faisal_hussien', 'tote641', 'kareemchicharito14', 'mostafaadel24', 'vamosrafa199795', 'marinamedhat', 'lux1990', 'aya.noby', 'minafadel', 'mayarmahmoud', None, 'alirose12', 'safaa_ahmed', 'rizkengin', 'sinderila030', 'nadoda3', 'salmakhaled248', 'shepherd_96', 'maudi126']"
53,216,15,11,2,"['faisal_hussien', 'kareemchicharito14']",12,"['alirose12', 'areeg', 'ayaghobashy', 'raja_waseem12', 'alessandro.pilotto', 'funny_nonaaa', 'maiwaleed0611', 'mkrysicki', 'mkrysickiirtm', 'daveestrada12', 'lux1990', 'jtroot']",9,"['moaz', 'shaher146', 'eman2015', 'mnaguib345', 'marinamedhat', 'omarko.kamel', 'ayamohamed12030', 'moustafa.eldesouky', None]",23,"['areeg', 'moaz', 'faisal_hussien', 'kareemchicharito14', 'mnaguib345', 'marinamedhat', 'daveestrada12', 'lux1990', 'moustafa.eldesouky', None, 'alirose12', 'ayaghobashy', 'raja_waseem12', 'shaher146', 'alessandro.pilotto', 'funny_nonaaa', 'maiwaleed0611', 'eman2015', 'mkrysicki', 'mkrysickiirtm', 'omarko.kamel', 'ayamohamed12030', 'jtroot']"
53,217,15,7,1,['kareemchicharito14'],13,"['alirose12', 'areeg', 'ayaghobashy', 'raja_waseem12', 'alessandro.pilotto', 'funny_nonaaa', 'faisal_hussien', 'maiwaleed0611', 'mkrysicki', 'mkrysickiirtm', 'daveestrada12', 'lux1990', 'jtroot']",6,"['hazem1', 'marinamedhat', 'ayamohamed12030', 'raniaosama2015', 'patyessam', None]",20,"['areeg', 'faisal_hussien', 'kareemchicharito14', 'marinamedhat', 'daveestrada12', 'lux1990', 'raniaosama2015', 'patyessam', None, 'alirose12', 'ayaghobashy', 'raja_waseem12', 'alessandro.pilotto', 'funny_nonaaa', 'maiwaleed0611', 'hazem1', 'mkrysicki', 'mkrysickiirtm', 'ayamohamed12030', 'jtroot']"
54,221,14,43,1,['timothyjaggernauth305'],12,"['zinkx030', 'vuexx310', 'dougl196', 'swapa001', 'robil024', 'sandhyanadipalli', 'alvar235', 'jennybai', 'naturis0', 'modug001', 'weidl003', 'shivateja92']",42,"['jtdath', 'jsinibaldi', 'tuhlich', 'nickjcu', 'sidneygolliher', 'antonygillette', 'gaboth22', 'jtraub91', 'klborowski', 'sammymhowe', 'zobeldavid', 'david4101', 'jbocinsky', 'coreyrn8', 'jagnese', 'kstultz15', 'vsoliz', 'mronda', 'kristianlegcevic', 'jacksonecarroll', 'msciullo2010', 'sten621', 'charlelotfalla', 'abarbeite', 'andrew_lemx', 'fengshui', 'joshuaagarth', 'docta', 'abkrepacki', 'slapeyre1993', 'adrianj95', 'guybrush', 'alexdukes17', 'bbanksg7', 'uchaudhry', 'bkelly2014', None, 'mikesanchezuf', 'cmann0917', 'michael.correia', 'astainsby', 'ianmcodom']",55,"['jtdath', 'jsinibaldi', 'tuhlich', 'nickjcu', 'sidneygolliher', 'antonygillette', 'gaboth22', 'jtraub91', 'klborowski', 'sammymhowe', 'zobeldavid', 'modug001', 'shivateja92', 'david4101', 'jbocinsky', 'coreyrn8', 'jagnese', 'kstultz15', 'vsoliz', 'mronda', 'kristianlegcevic', 'jacksonecarroll', 'msciullo2010', 'sten621', 'charlelotfalla', 'abarbeite', 'andrew_lemx', 'naturis0', 'fengshui', 'joshuaagarth', 'docta', 'dougl196', 'abkrepacki', 'slapeyre1993', 'robil024', 'adrianj95', 'guybrush', 'alexdukes17', 'bbanksg7', 'uchaudhry', 'bkelly2014', None, 'weidl003', 'mikesanchezuf', 'cmann0917', 'zinkx030', 'vuexx310', 'alvar235', 'swapa001', 'sandhyanadipalli', 'michael.correia', 'astainsby', 'jennybai', 'timothyjaggernauth305', 'ianmcodom']"
54,222,14,8,7,"['dougl196', 'alvar235', 'sandhyanadipalli', 'robil024', 'modug001', 'weidl003', 'shivateja92']",6,"['zinkx030', 'vuexx310', 'swapa001', 'jennybai', 'timothyjaggernauth305', 'naturis0']",1,[None],14,"['dougl196', 'robil024', None, 'modug001', 'shivateja92', 'weidl003', 'zinkx030', 'vuexx310', 'alvar235', 'swapa001', 'sandhyanadipalli', 'jennybai', 'timothyjaggernauth305', 'naturis0']"
54,223,14,7,6,"['zinkx030', 'vuexx310', 'swapa001', 'naturis0', 'modug001', 'weidl003']",7,"['dougl196', 'alvar235', 'robil024', 'sandhyanadipalli', 'jennybai', 'timothyjaggernauth305', 'shivateja92']",1,[None],14,"['dougl196', 'robil024', None, 'modug001', 'shivateja92', 'weidl003', 'zinkx030', 'vuexx310', 'alvar235', 'swapa001', 'sandhyanadipalli', 'jennybai', 'timothyjaggernauth305', 'naturis0']"
55,202,14,26,10,"['secumjyp', 'jwp0530', 'eyounseok', 'eug92', 'rkdals726', 'kimyeonjin94', 'becksha2307', 'cat90129', 'mkkim693', 'ghddlsrl91']",3,"['dae792', 'joungh023', 'qw1w2we2e3']",16,"['looky403', 'evev45', 'hdwoo777', 'seo7yeon0320', 'clsdnfwwkd', 'wert1632', 'redsky93', 'gcie1991', 'bolmaejay', 'wyj115', 'lhjlke', 'jwooka', '24isking', 'redviola', None, 'lwg8181']",29,"['jwp0530', 'redsky93', 'eyounseok', 'gcie1991', 'rkdals726', '24isking', 'ghddlsrl91', 'cat90129', 'looky403', 'qw1w2we2e3', 'jwooka', 'mkkim693', 'lwg8181', 'evev45', 'hdwoo777', 'wert1632', 'dae792', 'kimyeonjin94', 'redviola', None, 'seo7yeon0320', 'secumjyp', 'clsdnfwwkd', 'bolmaejay', 'wyj115', 'eug92', 'lhjlke', 'becksha2307', 'joungh023']"
55,7,14,23,13,"['secumjyp', 'jwp0530', 'qw1w2we2e3', 'eyounseok', 'eug92', 'dae792', 'rkdals726', 'kimyeonjin94', 'becksha2307', 'cat90129', 'joungh023', 'mkkim693', 'ghddlsrl91']",0,[],10,"['evev45', 'taehojung', 'clsdnfwwkd', 'redsky93', 'unjhenyj', 'hcho0529', 'lhjlke', 'jwooka', 'redviola', None]",23,"['jwp0530', 'redsky93', 'eyounseok', 'unjhenyj', 'rkdals726', 'ghddlsrl91', 'cat90129', 'qw1w2we2e3', 'jwooka', 'mkkim693', 'evev45', 'dae792', 'kimyeonjin94', 'redviola', None, 'taehojung', 'secumjyp', 'clsdnfwwkd', 'eug92', 'hcho0529', 'lhjlke', 'becksha2307', 'joungh023']"
55,200,14,21,12,"['secumjyp', 'jwp0530', 'qw1w2we2e3', 'eyounseok', 'eug92', 'dae792', 'kimyeonjin94', 'becksha2307', 'cat90129', 'joungh023', 'mkkim693', 'ghddlsrl91']",1,['rkdals726'],9,"['taehojung', 'seo7yeon0320', 'bolmaejay', 'k4610316', 'tlsaudrbs', 'gostja808', 'cyj667', 'jongho7950', None]",22,"['jwp0530', 'eyounseok', 'rkdals726', 'ghddlsrl91', 'cat90129', 'qw1w2we2e3', 'k4610316', 'cyj667', 'mkkim693', 'dae792', 'tlsaudrbs', 'kimyeonjin94', 'jongho7950', None, 'taehojung', 'seo7yeon0320', 'secumjyp', 'bolmaejay', 'eug92', 'gostja808', 'becksha2307', 'joungh023']"
56,49,13,15,4,"['mntvit92', 'esathiyacnr', 'charushila3', 'aswathyushamohan2']",8,"['vitghoshsourav', 'satyaprakash', 'rohitnimje', 'varunece.89', 'rajshekar.vlsi', 'echchen', 'anisha2', 'saurabhd']",11,"['darshanrv', 'ammusanal', 'nikita2', 'premnath', 'aparna2', 'visheshmk', 'steffy30', 'ashutosh723', 'rjpatil19', None, 'chaudharinikhil02']",23,"['darshanrv', 'vitghoshsourav', 'nikita2', 'rohitnimje', 'premnath', 'charushila3', 'aswathyushamohan2', 'rajshekar.vlsi', 'esathiyacnr', 'rjpatil19', 'saurabhd', None, 'chaudharinikhil02', 'ammusanal', 'satyaprakash', 'aparna2', 'varunece.89', 'mntvit92', 'visheshmk', 'echchen', 'steffy30', 'ashutosh723', 'anisha2']"
56,48,13,13,10,"['vitghoshsourav', 'satyaprakash', 'rohitnimje', 'aswathyushamohan2', 'varunece.89', 'rajshekar.vlsi', 'esathiyacnr', 'mntvit92', 'anisha2', 'saurabhd']",2,"['charushila3', 'echchen']",3,"['nikita2', 'visheshmk', None]",15,"['vitghoshsourav', 'nikita2', 'rohitnimje', 'charushila3', 'aswathyushamohan2', 'rajshekar.vlsi', 'esathiyacnr', 'saurabhd', None, 'satyaprakash', 'varunece.89', 'mntvit92', 'visheshmk', 'echchen', 'anisha2']"
56,54,13,13,4,"['satyaprakash', 'mntvit92', 'esathiyacnr', 'aswathyushamohan2']",8,"['vitghoshsourav', 'rohitnimje', 'charushila3', 'varunece.89', 'rajshekar.vlsi', 'echchen', 'anisha2', 'saurabhd']",9,"['ranibarkha', 'sasiponnam', 'kabhishek744', 'surensurendar7', 'muralisudha', 'sreemoyee07', 'santhoshravi', 'srsitaaramanmtech', None]",21,"['vitghoshsourav', 'rohitnimje', 'charushila3', 'kabhishek744', 'aswathyushamohan2', 'rajshekar.vlsi', 'esathiyacnr', 'santhoshravi', 'srsitaaramanmtech', 'saurabhd', None, 'satyaprakash', 'ranibarkha', 'sasiponnam', 'surensurendar7', 'varunece.89', 'mntvit92', 'muralisudha', 'sreemoyee07', 'echchen', 'anisha2']"
56,47,13,12,10,"['vitghoshsourav', 'satyaprakash', 'rohitnimje', 'aswathyushamohan2', 'varunece.89', 'rajshekar.vlsi', 'esathiyacnr', 'mntvit92', 'anisha2', 'saurabhd']",2,"['charushila3', 'echchen']",2,"['nikita2', None]",14,"['vitghoshsourav', 'nikita2', 'rohitnimje', 'charushila3', 'aswathyushamohan2', 'rajshekar.vlsi', 'esathiyacnr', 'saurabhd', None, 'satyaprakash', 'varunece.89', 'mntvit92', 'echchen', 'anisha2']"
56,50,13,12,4,"['mntvit92', 'esathiyacnr', 'charushila3', 'aswathyushamohan2']",8,"['vitghoshsourav', 'satyaprakash', 'rohitnimje', 'varunece.89', 'rajshekar.vlsi', 'echchen', 'anisha2', 'saurabhd']",8,"['darshanrv', 'premnath', 'aparna2', 'steffy30', 'ashutosh723', 'rjpatil19', None, 'chaudharinikhil02']",20,"['darshanrv', 'vitghoshsourav', 'rohitnimje', 'premnath', 'charushila3', 'aswathyushamohan2', 'rajshekar.vlsi', 'esathiyacnr', 'rjpatil19', 'saurabhd', None, 'chaudharinikhil02', 'satyaprakash', 'aparna2', 'varunece.89', 'mntvit92', 'echchen', 'steffy30', 'ashutosh723', 'anisha2']"
56,56,13,11,4,"['mntvit92', 'rohitnimje', 'charushila3', 'aswathyushamohan2']",8,"['vitghoshsourav', 'satyaprakash', 'varunece.89', 'rajshekar.vlsi', 'esathiyacnr', 'echchen', 'anisha2', 'saurabhd']",7,"['ammusanal', 'premnath', 'aparna2', 'surensurendar7', 'ashutosh723', 'srsitaaramanmtech', None]",19,"['vitghoshsourav', 'rohitnimje', 'premnath', 'charushila3', 'aswathyushamohan2', 'rajshekar.vlsi', 'esathiyacnr', 'srsitaaramanmtech', 'saurabhd', None, 'ammusanal', 'satyaprakash', 'aparna2', 'surensurendar7', 'varunece.89', 'mntvit92', 'echchen', 'ashutosh723', 'anisha2']"
56,55,13,9,1,['mntvit92'],11,"['vitghoshsourav', 'satyaprakash', 'rohitnimje', 'charushila3', 'aswathyushamohan2', 'varunece.89', 'rajshekar.vlsi', 'esathiyacnr', 'echchen', 'anisha2', 'saurabhd']",8,"['pawarrajwardhan.madhukar2015', 'premnath', 'aparna2', 'sreemoyee07', 'santhoshravi', 'srsitaaramanmtech', None, 'chaudharinikhil02']",20,"['vitghoshsourav', 'rohitnimje', 'premnath', 'charushila3', 'aswathyushamohan2', 'rajshekar.vlsi', 'esathiyacnr', 'santhoshravi', 'srsitaaramanmtech', 'saurabhd', None, 'chaudharinikhil02', 'pawarrajwardhan.madhukar2015', 'satyaprakash', 'aparna2', 'varunece.89', 'mntvit92', 'sreemoyee07', 'echchen', 'anisha2']"
57,242,13,32,11,"['a.quinto10', 'cduplat', 'miguelo0119', 'camilom', 'jorgeasantaella', 'ia.hernandez11', 'af.otero10', 'camidoka12', 'jgangeli', 'dianajg', 'nan123214']",1,['pepe_lancheros'],21,"['danikat', 'af.almanza10', 'orionsebastian', 'miguel738', 'fmj.durango10', 'juancopp97', 'sebastiancelis', 'caliche_764', 'la.avendano10', 'andres.alvear', 'damartinez15', 'ha.tapia10', 'jd.botero320', None, 'juanbaquero', 'sm.alvarez10', 'alexei22', 'gili_star', 'jassonmolina', 'abcdfg', 'diego_romero_97']",33,"['miguelo0119', 'danikat', 'ia.hernandez11', 'af.almanza10', 'jgangeli', 'orionsebastian', 'miguel738', 'fmj.durango10', 'camilom', 'pepe_lancheros', 'juancopp97', 'a.quinto10', 'cduplat', 'sebastiancelis', 'caliche_764', 'jorgeasantaella', 'la.avendano10', 'camidoka12', 'andres.alvear', 'damartinez15', 'ha.tapia10', 'jd.botero320', 'dianajg', None, 'juanbaquero', 'sm.alvarez10', 'alexei22', 'gili_star', 'jassonmolina', 'af.otero10', 'nan123214', 'abcdfg', 'diego_romero_97']"
57,145,13,24,6,"['a.quinto10', 'cduplat', 'miguelo0119', 'jorgeasantaella', 'camidoka12', 'nan123214']",6,"['camilom', 'ia.hernandez11', 'af.otero10', 'pepe_lancheros', 'jgangeli', 'dianajg']",18,"['sm.alvarez10', 'sebastiancelis', 'alexei22', 'danikat', 'jassonmolina', 'juanbaquero', 'sereta27', 'la.avendano10', 'diego_romero_97', 'af.almanza10', 'andres.alvear', 'damartinez15', 'juancopp97', 'jd.botero320', 'orionsebastian', None, 'abcdfg', 'miguel738']",30,"['miguelo0119', 'danikat', 'ia.hernandez11', 'af.almanza10', 'jgangeli', 'orionsebastian', 'miguel738', 'camilom', 'pepe_lancheros', 'juancopp97', 'sereta27', 'a.quinto10', 'cduplat', 'sebastiancelis', 'jorgeasantaella', 'la.avendano10', 'camidoka12', 'andres.alvear', 'damartinez15', 'jd.botero320', 'dianajg', None, 'juanbaquero', 'sm.alvarez10', 'alexei22', 'jassonmolina', 'af.otero10', 'nan123214', 'abcdfg', 'diego_romero_97']"
57,236,13,14,8,"['cduplat', 'miguelo0119', 'camilom', 'jorgeasantaella', 'ia.hernandez11', 'camidoka12', 'dianajg', 'nan123214']",4,"['a.quinto10', 'pepe_lancheros', 'af.otero10', 'jgangeli']",6,"['sm.alvarez10', 'sebastiancelis', 'jassonmolina', 'danikat', None, 'miguel738']",18,"['a.quinto10', 'cduplat', 'miguelo0119', 'sebastiancelis', 'danikat', 'jorgeasantaella', 'ia.hernandez11', 'camidoka12', 'jgangeli', 'dianajg', None, 'miguel738', 'sm.alvarez10', 'camilom', 'jassonmolina', 'af.otero10', 'pepe_lancheros', 'nan123214']"
57,237,13,14,2,"['a.quinto10', 'jgangeli']",10,"['cduplat', 'miguelo0119', 'camilom', 'jorgeasantaella', 'ia.hernandez11', 'af.otero10', 'camidoka12', 'pepe_lancheros', 'dianajg', 'nan123214']",12,"['d.suspes2053', 'gj.diaz10', 'duranmarco96', 'elfenomeno', 'la.avendano10', 'tasmaniabull', 'davidparra131', 'ha.tapia10', 'j.andregon15', 'orionsebastian', None, 'diego_romero_97']",24,"['a.quinto10', 'cduplat', 'miguelo0119', 'gj.diaz10', 'duranmarco96', 'elfenomeno', 'jorgeasantaella', 'ia.hernandez11', 'la.avendano10', 'camidoka12', 'tasmaniabull', 'ha.tapia10', 'jgangeli', 'orionsebastian', 'dianajg', 'j.andregon15', None, 'd.suspes2053', 'camilom', 'af.otero10', 'pepe_lancheros', 'davidparra131', 'nan123214', 'diego_romero_97']"
57,61,13,6,1,['ia.hernandez11'],11,"['a.quinto10', 'cduplat', 'miguelo0119', 'camilom', 'jorgeasantaella', 'af.otero10', 'camidoka12', 'pepe_lancheros', 'jgangeli', 'dianajg', 'nan123214']",5,"['sebastiancelis', 'gj.diaz10', 'la.avendano10', 'ha.tapia10', None]",17,"['a.quinto10', 'cduplat', 'miguelo0119', 'sebastiancelis', 'camilom', 'gj.diaz10', 'jorgeasantaella', 'ia.hernandez11', 'la.avendano10', 'af.otero10', 'camidoka12', None, 'ha.tapia10', 'pepe_lancheros', 'jgangeli', 'dianajg', 'nan123214']"
58,22,12,13,10,"['dfong', 'ymzhang', 'raneshku', 'lanbing715', 'jackalo', 'kyuk', 'jayzhu0323', 'rram', 'silman', 'jdmarrs']",1,['ars21031960'],3,"['jhihath', None, 'jcgarris']",14,"['dfong', 'jhihath', 'lanbing715', 'jackalo', 'ymzhang', None, 'silman', 'jdmarrs', 'raneshku', 'ars21031960', 'kyuk', 'jayzhu0323', 'jcgarris', 'rram']"
58,67,12,12,10,"['dfong', 'ymzhang', 'raneshku', 'lanbing715', 'jackalo', 'kyuk', 'jayzhu0323', 'rram', 'silman', 'jdmarrs']",1,['ars21031960'],2,"[None, 'mashari']",13,"['dfong', 'lanbing715', 'jackalo', 'ymzhang', None, 'silman', 'jdmarrs', 'raneshku', 'ars21031960', 'kyuk', 'jayzhu0323', 'mashari', 'rram']"
59,70,11,19,7,"['amrutapatil100', 'manasihuparikar06', 'kajal.gchougale', 'pritam.snst', 'kamblepriyankan95', 'sunilpatil4488', 'dhavaleru']",3,"['mskmskmsk', 'ishara.ratnayake', 'pashterohan7']",12,"['ruturajpatil6640', 'waghmareswapnali161', 'rahultk9464', 'mujawarashif786', 'vijaykaradesnst', 'tukaram', 'tawadeanitak94', 'pritilatajadhav', 'kalakesonalisnst', 'malidhanashreem95', None, 'moresuraj222']",22,"['amrutapatil100', 'manasihuparikar06', 'kajal.gchougale', 'pritam.snst', 'ruturajpatil6640', 'mujawarashif786', 'pashterohan7', 'kamblepriyankan95', 'sunilpatil4488', 'dhavaleru', 'kalakesonalisnst', None, 'ishara.ratnayake', 'mskmskmsk', 'waghmareswapnali161', 'rahultk9464', 'vijaykaradesnst', 'tukaram', 'tawadeanitak94', 'pritilatajadhav', 'malidhanashreem95', 'moresuraj222']"
60,76,11,44,9,"['jonathany.polaniab', 'jhona.gomezd1', 'laurac.porrasb', 'katherinem', 'haroldy.herreraa', 'angieg', 'yedyp.buitragom', 'luis.reya', 'juans.torresa']",1,['leidycarolina'],35,"['sebastian0722', 'jonnya.gaitanb1', 'michaels.bravob', 'mariaa.montoyam', 'laura.arias', 'afelipe.blopez', 'lizethj.perezr', 'mariae.ballesterosg', 'taniacordoba1', 'maruchale92', 'laurad.sanchezv', 'carolr.delgadol', 'santiagoaninoc', 'luisaf.laraa', 'johnr.duranr', 'leidyc.hernandezp', 'soniac.lizcanoc', 'angieespitia1996', 'dannycardenas48', 'cindyl.leong', 'sergionemoga', None, 'lufelaar', 'mateocastaneda', 'jessicap.contrerasa', 'pips0289', 'hernand.abrilm', 'paulatsanchezt', 'julianai.sanchezc', 'dianaccabrerac', 'mariac.hernandezq', 'ingridp.rodriguezr', 'jennypaolagalan', 'angiearismendi', 'astridmejiat']",45,"['sebastian0722', 'jonnya.gaitanb1', 'michaels.bravob', 'mariaa.montoyam', 'laura.arias', 'haroldy.herreraa', 'juans.torresa', 'afelipe.blopez', 'lizethj.perezr', 'mariae.ballesterosg', 'taniacordoba1', 'maruchale92', 'laurad.sanchezv', 'yedyp.buitragom', 'carolr.delgadol', 'santiagoaninoc', 'luisaf.laraa', 'johnr.duranr', 'leidyc.hernandezp', 'soniac.lizcanoc', 'angieespitia1996', 'angieg', 'dannycardenas48', 'cindyl.leong', 'sergionemoga', None, 'lufelaar', 'jonathany.polaniab', 'jhona.gomezd1', 'laurac.porrasb', 'mateocastaneda', 'jessicap.contrerasa', 'pips0289', 'hernand.abrilm', 'katherinem', 'paulatsanchezt', 'julianai.sanchezc', 'dianaccabrerac', 'leidycarolina', 'luis.reya', 'mariac.hernandezq', 'ingridp.rodriguezr', 'jennypaolagalan', 'angiearismendi', 'astridmejiat']"
60,1,11,41,10,"['jonathany.polaniab', 'jhona.gomezd1', 'laurac.porrasb', 'katherinem', 'haroldy.herreraa', 'angieg', 'yedyp.buitragom', 'luis.reya', 'leidycarolina', 'juans.torresa']",0,[],31,"['mariaa.montoyam', 'david.mosqueral', 'afelipe.blopez', 'juanmontealegre', 'jonathan.polaniab', 'maruchale92', 'luisaarcos', 'juliad.gonzalezm', 'jorgevc', 'laurad.sanchezv', 'stephania.navarretel', 'ivandaniloef', 'andream.bravof', 'daniela14', 'leidyc.hernandezp', 'kevins.lopezs', 'soniac.lizcanoc', None, 'jessicap.contrerasa', 'pips0289', 'danielly', 'hernand.abrilm', 'paulatsanchezt', 'julianai.sanchezc', 'dianaccabrerac', 'ingridp.rodriguezr', 'mariac.hernandezq', 'jorcanas', 'angiearismendi', 'taniar.romerob1', 'maloryd.gutierrezd']",41,"['mariaa.montoyam', 'david.mosqueral', 'haroldy.herreraa', 'juans.torresa', 'afelipe.blopez', 'juanmontealegre', 'jonathan.polaniab', 'maruchale92', 'luisaarcos', 'juliad.gonzalezm', 'jorgevc', 'laurad.sanchezv', 'stephania.navarretel', 'ivandaniloef', 'andream.bravof', 'yedyp.buitragom', 'daniela14', 'leidyc.hernandezp', 'kevins.lopezs', 'soniac.lizcanoc', 'angieg', None, 'jonathany.polaniab', 'jhona.gomezd1', 'laurac.porrasb', 'jessicap.contrerasa', 'pips0289', 'danielly', 'hernand.abrilm', 'katherinem', 'julianai.sanchezc', 'paulatsanchezt', 'dianaccabrerac', 'leidycarolina', 'luis.reya', 'ingridp.rodriguezr', 'mariac.hernandezq', 'jorcanas', 'angiearismendi', 'taniar.romerob1', 'maloryd.gutierrezd']"
61,130,11,6,4,"['jiamanhe', 'richa201', 'chen1451', 'aianlo']",6,"['campb122', 'johnwkeil', 'zachweidner', 'figuero3', 'mbodziak', 'kmkolasinski']",2,"[None, 'zhu431']",12,"['campb122', 'zhu431', 'johnwkeil', 'zachweidner', 'aianlo', 'figuero3', 'chen1451', 'richa201', 'jiamanhe', None, 'mbodziak', 'kmkolasinski']"
62,35,11,135,9,"['pallavighogare1994', 'kodagakshay26', 'bhoglet', 'sagnikpal3495', 'ganeshmukund10', 'shubham.mohite7', 'vanitashingwa1995', 'aniketvidyalankar', 'saurabh.medhekar18']",1,['amitmishrasep22'],126,"['kalpitnarvekar', 'rohan21', 'linusassao974', 'komalkolekar95', 'patelmeeti1995', 'lakshoza', 'tanmaypatil18', 'shamika', 'mehta.krish', 'tejomayi.wandhile', 'ameysv22', 'sayaliw212', 'chinmayhejmadi', 'sonal.02031995', 'pomkar55', 'shahajichinchole', 'mrinalivyas1', 'mohiteruchir29', 'aksha0103', 'architagoyal', 'modyjash', 'karan.dhareshwar', 'himanshu21rasam', 'deepashrisane2203', 'tushardmaske', 'imushaikh007', 'rp92555', 'hegde.aniket94.ah', 'mewadayash', 'dal30', 'mehakkoul1994', 'shashwatssanghavi', 'gohel.mitesh91', 'divyapawar39', 'ansi7794', 'vj280395', 'niharikasarode', 'ghosh.arjun97', 'deepakjain.dj2', 'supriya.mangalpalli', 'ajoshi1996', 'desaimaanil2', 'hemantsonar93', 'sunilpoojary27', 'a.b.surgade', 'aka_jadhav', 'sammeetthosar', 'sangeetamjoshi', 'stylechicanki', 'basher00992', 'chaudharilatika02', 'satishlovesmom123', 'dakshata', 'ruprane296', 'rahulstary', 'tuscanowtsheryl128', 'sonali2', 'pb9298', 'adityasingh8394', 'rajpareshshah14', 'chinmay', 'gidayegirish', 'shraddha0306', 'aamod1996', 'kanchipoddar', 'prasadbhujbal28', 'mmodi296', 'mengaderutuja369', 'rutuja1122', 'rsarmajrt', 'saurabhmangeshkar', 'chabhadiariddhi', 'deepti.bhosale189', 'akash.jadhav', 'hemantjathar7', 'ganjirajini277', 'kumar.amit156', 'krishna.jhuma17', 'nilesh15394', 'aljo.joy22', 'ankitashere04', 'mayuresh20', 'kirandarade133', 'sagar2bhujbal', 'prasadchachad20', 'karanshh30', 'kanchangorde15', 'rushabkarani', 'sj.shruti95', 'chintanrlimbani', 'abhijeetchavan', 'rwaghela51', 'udayanyarya', 'jyotibhosale8483', 'umang.parekh30', 'samira2308', 'ayy1892', 'shivachandran.nadar15', 'prachipatil', 'qaspfu', 'ayushgupta11031996', 'tripathipavan10', 'sonaltambe32', 'rohanshah611', 'sagar.mujpara99', 'akajadhav1', 'mvedant29', 'borse84kiran', 'anujkolvalkar1', 'arcanetech12', 'vaibhavvadia', 'darshanlukhi25', 'surajmore009', 'amitsunildhamne', 'redorchid029', 'nikinsaw', 'sunilkavatkar', 'phadsujata59', 'shetty1995pranoy', 'akshaykharat563', 'jharupesh440', None, 'aj.shahare', 'amaya.pethe', 'roshninilam', 'inderjitsingh87']",136,"['kalpitnarvekar', 'rohan21', 'linusassao974', 'komalkolekar95', 'patelmeeti1995', 'lakshoza', 'tanmaypatil18', 'shamika', 'mehta.krish', 'tejomayi.wandhile', 'bhoglet', 'ameysv22', 'sayaliw212', 'chinmayhejmadi', 'sonal.02031995', 'pomkar55', 'shahajichinchole', 'mrinalivyas1', 'mohiteruchir29', 'aksha0103', 'architagoyal', 'modyjash', 'kodagakshay26', 'karan.dhareshwar', 'himanshu21rasam', 'deepashrisane2203', 'vanitashingwa1995', 'tushardmaske', 'imushaikh007', 'rp92555', 'hegde.aniket94.ah', 'mewadayash', 'dal30', 'mehakkoul1994', 'shashwatssanghavi', 'aniketvidyalankar', 'gohel.mitesh91', 'divyapawar39', 'ansi7794', 'vj280395', 'niharikasarode', 'ghosh.arjun97', 'deepakjain.dj2', 'supriya.mangalpalli', 'ajoshi1996', 'desaimaanil2', 'hemantsonar93', 'sunilpoojary27', 'a.b.surgade', 'aka_jadhav', 'sammeetthosar', 'sangeetamjoshi', 'stylechicanki', 'basher00992', 'chaudharilatika02', 'satishlovesmom123', 'dakshata', 'ruprane296', 'rahulstary', 'tuscanowtsheryl128', 'sonali2', 'pb9298', 'adityasingh8394', 'rajpareshshah14', 'shubham.mohite7', 'chinmay', 'gidayegirish', 'shraddha0306', 'aamod1996', 'kanchipoddar', 'sagnikpal3495', 'prasadbhujbal28', 'mmodi296', 'mengaderutuja369', 'ganeshmukund10', 'rutuja1122', 'rsarmajrt', 'saurabhmangeshkar', 'chabhadiariddhi', 'deepti.bhosale189', 'saurabh.medhekar18', 'akash.jadhav', 'hemantjathar7', 'pallavighogare1994', 'ganjirajini277', 'kumar.amit156', 'krishna.jhuma17', 'nilesh15394', 'aljo.joy22', 'ankitashere04', 'mayuresh20', 'kirandarade133', 'sagar2bhujbal', 'prasadchachad20', 'karanshh30', 'kanchangorde15', 'rushabkarani', 'sj.shruti95', 'chintanrlimbani', 'abhijeetchavan', 'rwaghela51', 'udayanyarya', 'jyotibhosale8483', 'umang.parekh30', 'samira2308', 'amitmishrasep22', 'ayy1892', 'shivachandran.nadar15', 'prachipatil', 'qaspfu', 'ayushgupta11031996', 'tripathipavan10', 'sonaltambe32', 'rohanshah611', 'sagar.mujpara99', 'akajadhav1', 'mvedant29', 'borse84kiran', 'anujkolvalkar1', 'arcanetech12', 'vaibhavvadia', 'darshanlukhi25', 'surajmore009', 'amitsunildhamne', 'redorchid029', 'nikinsaw', 'sunilkavatkar', 'phadsujata59', 'shetty1995pranoy', 'akshaykharat563', 'jharupesh440', None, 'aj.shahare', 'amaya.pethe', 'roshninilam', 'inderjitsingh87']"
64,81,10,11,4,"['aherman2', 'zyang39', 'jsmit244', 'chemistry.sathi']",5,"['jenniferjlien', 'mqsu', 'nanofast.lit', 'mengqisue', 'jshin63']",7,"['jeremysmith244', 'sathi88', 'indranath', 'indranath.iitm', 'cy11d060', 'indra123', None]",16,"['aherman2', 'indranath.iitm', 'zyang39', 'mqsu', 'nanofast.lit', 'chemistry.sathi', 'jsmit244', 'cy11d060', 'indra123', None, 'jenniferjlien', 'jeremysmith244', 'sathi88', 'indranath', 'mengqisue', 'jshin63']"
64,83,10,9,2,"['jsmit244', 'chemistry.sathi']",7,"['aherman2', 'jenniferjlien', 'zyang39', 'mqsu', 'nanofast.lit', 'mengqisue', 'jshin63']",7,"['jeremysmith244', 'sathi88', 'indranath', 'indranath.iitm', 'cy11d060', 'indra123', None]",16,"['aherman2', 'jenniferjlien', 'jeremysmith244', 'sathi88', 'zyang39', 'mqsu', 'nanofast.lit', 'indranath', 'indranath.iitm', 'chemistry.sathi', 'jsmit244', 'cy11d060', 'indra123', 'mengqisue', None, 'jshin63']"
64,80,10,7,1,['jsmit244'],8,"['aherman2', 'jenniferjlien', 'zyang39', 'mqsu', 'nanofast.lit', 'chemistry.sathi', 'mengqisue', 'jshin63']",6,"['jeremysmith244', 'indranath.iitm', 'indranath', 'sathi88', 'cy11d060', None]",15,"['aherman2', 'jenniferjlien', 'jeremysmith244', 'indranath.iitm', 'zyang39', 'mqsu', 'nanofast.lit', 'sathi88', 'indranath', 'chemistry.sathi', 'jsmit244', 'cy11d060', 'mengqisue', None, 'jshin63']"
64,82,10,6,4,"['mengqisue', 'mqsu', 'jenniferjlien', 'nanofast.lit']",5,"['aherman2', 'zyang39', 'chemistry.sathi', 'jsmit244', 'jshin63']",2,"[None, 'jlien']",11,"['aherman2', 'jenniferjlien', 'jlien', 'zyang39', 'mqsu', 'nanofast.lit', 'chemistry.sathi', 'jsmit244', 'mengqisue', None, 'jshin63']"
65,254,10,11,8,"['felicityzhao125', 'joseph.liping', 'abolhasani84', 'ivance', 'semuller', 'joseph.d.hill', 'beberry', 's.omid.s']",1,['matthewpaulbrownell'],3,"['dxf04', None, 'nair']",12,"['felicityzhao125', 'joseph.liping', 'dxf04', 'abolhasani84', 'semuller', 'beberry', None, 'matthewpaulbrownell', 'ivance', 'nair', 'joseph.d.hill', 's.omid.s']"
65,87,10,10,9,"['felicityzhao125', 'joseph.liping', 'matthewpaulbrownell', 'abolhasani84', 'ivance', 'semuller', 'joseph.d.hill', 'beberry', 's.omid.s']",0,[],1,[None],10,"['felicityzhao125', 'joseph.liping', 'abolhasani84', 'semuller', 'beberry', None, 'matthewpaulbrownell', 'ivance', 'joseph.d.hill', 's.omid.s']"
65,246,10,10,9,"['felicityzhao125', 'joseph.liping', 'matthewpaulbrownell', 'abolhasani84', 'ivance', 'semuller', 'joseph.d.hill', 'beberry', 's.omid.s']",0,[],1,[None],10,"['felicityzhao125', 'joseph.liping', 'abolhasani84', 'semuller', 'beberry', None, 'matthewpaulbrownell', 'ivance', 'joseph.d.hill', 's.omid.s']"
65,86,10,9,6,"['felicityzhao125', 'joseph.liping', 'semuller', 'joseph.d.hill', 'beberry', 's.omid.s']",3,"['abolhasani84', 'ivance', 'matthewpaulbrownell']",3,"['dxf04', None, 'nair']",12,"['felicityzhao125', 'joseph.liping', 'dxf04', 'matthewpaulbrownell', 'abolhasani84', 'ivance', 'semuller', 'nair', 'joseph.d.hill', 'beberry', 's.omid.s', None]"
65,247,10,9,8,"['felicityzhao125', 'matthewpaulbrownell', 'abolhasani84', 'ivance', 'semuller', 'joseph.d.hill', 'beberry', 's.omid.s']",1,['joseph.liping'],1,[None],10,"['felicityzhao125', 'joseph.liping', 'matthewpaulbrownell', 'abolhasani84', 'ivance', 'semuller', 'joseph.d.hill', 'beberry', 's.omid.s', None]"
65,245,10,8,5,"['felicityzhao125', 'joseph.liping', 'semuller', 'beberry', 's.omid.s']",4,"['joseph.d.hill', 'abolhasani84', 'ivance', 'matthewpaulbrownell']",3,"['dxf04', None, 'nair']",12,"['felicityzhao125', 'joseph.liping', 'dxf04', 'matthewpaulbrownell', 'abolhasani84', 'ivance', 'semuller', 'nair', 'joseph.d.hill', 'beberry', 's.omid.s', None]"
66,196,10,47,8,"['jecvmm', 'juanma.lovera', 'n2ea', 'crisdavbed08', 'jasive', 'henryr9708', 'sereta27', 'andfe']",1,['mparsa'],39,"['duranmarco96', 'santibustoscastro', 'avilaalba', 'agentil', 'cd.florez10', 'jairomisterio', 'camidoka1212', 'af.almanza10', 'toromateoc', 'alexmurcia96', 'jphc64', 'orionsebastian', 'azambrano13', 'anfepe_12', 'davidj.2111', 'sergiocamilo97111', 'sabinachocolate', 'oso_nana_96', 'angie_ayobi95', 'juanfdo96', 'juansesosaajedrez', 'davidparra131', 'juancopp97', 'juanswoodcock40', 'jorgem93', 'andrez.tc', 'k.santiagor06', 'mangomela', 'ngomezgg.18', 'fabiant970', None, 'jassonmolina', 'paula.osorio2222', 'valentinasandovalb', 'paannamo97', 'wolfangguio07', 'davidan_pino', 'psbustos10', 'diego_romero_97']",48,"['duranmarco96', 'santibustoscastro', 'avilaalba', 'jecvmm', 'juanma.lovera', 'agentil', 'cd.florez10', 'jairomisterio', 'camidoka1212', 'af.almanza10', 'toromateoc', 'alexmurcia96', 'jphc64', 'orionsebastian', 'azambrano13', 'anfepe_12', 'andfe', 'davidj.2111', 'sergiocamilo97111', 'sabinachocolate', 'n2ea', 'oso_nana_96', 'angie_ayobi95', 'crisdavbed08', 'juanfdo96', 'juansesosaajedrez', 'davidparra131', 'henryr9708', 'juancopp97', 'sereta27', 'juanswoodcock40', 'jorgem93', 'andrez.tc', 'k.santiagor06', 'jasive', 'mangomela', 'ngomezgg.18', 'fabiant970', None, 'jassonmolina', 'mparsa', 'paula.osorio2222', 'valentinasandovalb', 'paannamo97', 'wolfangguio07', 'davidan_pino', 'psbustos10', 'diego_romero_97']"
66,72,10,36,8,"['jecvmm', 'juanma.lovera', 'n2ea', 'crisdavbed08', 'jasive', 'henryr9708', 'sereta27', 'andfe']",1,['mparsa'],28,"['duranmarco96', 'sergiocamilo97', 'jairomisterio', 'cd.florez10', 'af.almanza10', 'jf.guerrero10', 'toromateoc', 'j.andregon15', 'eap.rodriguez', 'js.woodcock2202', 'davidparra131', 'juancopp97', 'materiales', 'camilaaa', 'caliche_764', 'js.rgalan', 'cpotdevin', None, 'fabiant970', 'jassonmolina', 'nickzea', 'aogentil10', 'valentinasandovalb', 'paannamo97', 'cnietovesga9510', 'wolfangguio07', 'dapino06', 'diego_romero_97']",37,"['duranmarco96', 'sergiocamilo97', 'jecvmm', 'juanma.lovera', 'cd.florez10', 'af.almanza10', 'jairomisterio', 'jf.guerrero10', 'toromateoc', 'j.andregon15', 'eap.rodriguez', 'andfe', 'n2ea', 'js.woodcock2202', 'crisdavbed08', 'davidparra131', 'henryr9708', 'juancopp97', 'materiales', 'camilaaa', 'sereta27', 'caliche_764', 'js.rgalan', 'cpotdevin', 'jasive', 'fabiant970', None, 'jassonmolina', 'mparsa', 'nickzea', 'aogentil10', 'valentinasandovalb', 'paannamo97', 'cnietovesga9510', 'wolfangguio07', 'dapino06', 'diego_romero_97']"
66,145,10,24,1,['sereta27'],8,"['mparsa', 'jecvmm', 'juanma.lovera', 'n2ea', 'crisdavbed08', 'henryr9708', 'jasive', 'andfe']",23,"['miguelo0119', 'danikat', 'af.almanza10', 'orionsebastian', 'miguel738', 'juancopp97', 'a.quinto10', 'cduplat', 'sebastiancelis', 'jorgeasantaella', 'la.avendano10', 'camidoka12', 'andres.alvear', 'damartinez15', 'jd.botero320', None, 'juanbaquero', 'sm.alvarez10', 'alexei22', 'jassonmolina', 'nan123214', 'abcdfg', 'diego_romero_97']",32,"['miguelo0119', 'danikat', 'jecvmm', 'juanma.lovera', 'af.almanza10', 'orionsebastian', 'andfe', 'miguel738', 'n2ea', 'crisdavbed08', 'henryr9708', 'juancopp97', 'sereta27', 'a.quinto10', 'cduplat', 'sebastiancelis', 'jorgeasantaella', 'la.avendano10', 'camidoka12', 'andres.alvear', 'damartinez15', 'jd.botero320', 'jasive', None, 'juanbaquero', 'sm.alvarez10', 'alexei22', 'jassonmolina', 'mparsa', 'nan123214', 'abcdfg', 'diego_romero_97']"
70,35,10,135,5,"['shahajichinchole', 'prachipatil', 'sagar2bhujbal', 'aljo.joy22', 'gohel.mitesh91']",4,"['akshaykshitija', 'adithyamohan', 'vishalvb04', 'kpiyushbhirud']",130,"['kalpitnarvekar', 'rohan21', 'linusassao974', 'komalkolekar95', 'patelmeeti1995', 'lakshoza', 'tanmaypatil18', 'shamika', 'mehta.krish', 'tejomayi.wandhile', 'bhoglet', 'ameysv22', 'sayaliw212', 'chinmayhejmadi', 'sonal.02031995', 'pomkar55', 'mrinalivyas1', 'mohiteruchir29', 'aksha0103', 'architagoyal', 'modyjash', 'kodagakshay26', 'karan.dhareshwar', 'himanshu21rasam', 'deepashrisane2203', 'vanitashingwa1995', 'tushardmaske', 'imushaikh007', 'rp92555', 'hegde.aniket94.ah', 'mewadayash', 'dal30', 'mehakkoul1994', 'shashwatssanghavi', 'aniketvidyalankar', 'divyapawar39', 'ansi7794', 'vj280395', 'niharikasarode', 'ghosh.arjun97', 'deepakjain.dj2', 'supriya.mangalpalli', 'ajoshi1996', 'desaimaanil2', 'hemantsonar93', 'sunilpoojary27', 'a.b.surgade', 'aka_jadhav', 'sammeetthosar', 'sangeetamjoshi', 'stylechicanki', 'basher00992', 'chaudharilatika02', 'satishlovesmom123', 'dakshata', 'ruprane296', 'rahulstary', 'tuscanowtsheryl128', 'sonali2', 'pb9298', 'adityasingh8394', 'rajpareshshah14', 'shubham.mohite7', 'chinmay', 'gidayegirish', 'shraddha0306', 'aamod1996', 'kanchipoddar', 'sagnikpal3495', 'prasadbhujbal28', 'mmodi296', 'mengaderutuja369', 'ganeshmukund10', 'rutuja1122', 'rsarmajrt', 'saurabhmangeshkar', 'chabhadiariddhi', 'deepti.bhosale189', 'saurabh.medhekar18', 'akash.jadhav', 'hemantjathar7', 'pallavighogare1994', 'ganjirajini277', 'kumar.amit156', 'krishna.jhuma17', 'nilesh15394', 'ankitashere04', 'mayuresh20', 'kirandarade133', 'prasadchachad20', 'karanshh30', 'kanchangorde15', 'rushabkarani', 'sj.shruti95', 'chintanrlimbani', 'abhijeetchavan', 'rwaghela51', 'udayanyarya', 'jyotibhosale8483', 'umang.parekh30', 'samira2308', 'ayy1892', 'shivachandran.nadar15', 'qaspfu', 'ayushgupta11031996', 'tripathipavan10', 'sonaltambe32', 'rohanshah611', 'sagar.mujpara99', 'akajadhav1', 'mvedant29', 'borse84kiran', 'anujkolvalkar1', 'arcanetech12', 'vaibhavvadia', 'darshanlukhi25', 'surajmore009', 'amitsunildhamne', 'redorchid029', 'nikinsaw', 'sunilkavatkar', 'phadsujata59', 'shetty1995pranoy', 'akshaykharat563', 'jharupesh440', None, 'aj.shahare', 'amaya.pethe', 'roshninilam', 'inderjitsingh87']",139,"['kalpitnarvekar', 'rohan21', 'linusassao974', 'komalkolekar95', 'patelmeeti1995', 'lakshoza', 'tanmaypatil18', 'shamika', 'mehta.krish', 'tejomayi.wandhile', 'bhoglet', 'ameysv22', 'sayaliw212', 'chinmayhejmadi', 'sonal.02031995', 'pomkar55', 'shahajichinchole', 'mrinalivyas1', 'kpiyushbhirud', 'mohiteruchir29', 'aksha0103', 'architagoyal', 'modyjash', 'kodagakshay26', 'vishalvb04', 'karan.dhareshwar', 'himanshu21rasam', 'deepashrisane2203', 'vanitashingwa1995', 'tushardmaske', 'adithyamohan', 'imushaikh007', 'rp92555', 'hegde.aniket94.ah', 'mewadayash', 'dal30', 'mehakkoul1994', 'shashwatssanghavi', 'aniketvidyalankar', 'gohel.mitesh91', 'divyapawar39', 'ansi7794', 'vj280395', 'niharikasarode', 'ghosh.arjun97', 'deepakjain.dj2', 'supriya.mangalpalli', 'ajoshi1996', 'desaimaanil2', 'hemantsonar93', 'sunilpoojary27', 'a.b.surgade', 'aka_jadhav', 'sammeetthosar', 'sangeetamjoshi', 'stylechicanki', 'basher00992', 'chaudharilatika02', 'satishlovesmom123', 'dakshata', 'ruprane296', 'rahulstary', 'tuscanowtsheryl128', 'sonali2', 'pb9298', 'adityasingh8394', 'rajpareshshah14', 'shubham.mohite7', 'chinmay', 'gidayegirish', 'shraddha0306', 'aamod1996', 'kanchipoddar', 'sagnikpal3495', 'prasadbhujbal28', 'mmodi296', 'mengaderutuja369', 'ganeshmukund10', 'rutuja1122', 'rsarmajrt', 'saurabhmangeshkar', 'chabhadiariddhi', 'deepti.bhosale189', 'saurabh.medhekar18', 'akash.jadhav', 'hemantjathar7', 'pallavighogare1994', 'ganjirajini277', 'kumar.amit156', 'krishna.jhuma17', 'aljo.joy22', 'nilesh15394', 'ankitashere04', 'mayuresh20', 'kirandarade133', 'sagar2bhujbal', 'prasadchachad20', 'karanshh30', 'kanchangorde15', 'rushabkarani', 'akshaykshitija', 'sj.shruti95', 'chintanrlimbani', 'abhijeetchavan', 'rwaghela51', 'udayanyarya', 'jyotibhosale8483', 'umang.parekh30', 'samira2308', 'ayy1892', 'shivachandran.nadar15', 'prachipatil', 'qaspfu', 'ayushgupta11031996', 'tripathipavan10', 'sonaltambe32', 'rohanshah611', 'sagar.mujpara99', 'akajadhav1', 'mvedant29', 'borse84kiran', 'anujkolvalkar1', 'arcanetech12', 'vaibhavvadia', 'darshanlukhi25', 'surajmore009', 'amitsunildhamne', 'redorchid029', 'nikinsaw', 'sunilkavatkar', 'phadsujata59', 'shetty1995pranoy', 'akshaykharat563', 'jharupesh440', None, 'aj.shahare', 'amaya.pethe', 'roshninilam', 'inderjitsingh87']"
70,42,10,69,2,"['adithyamohan', 'vishalvb04']",7,"['akshaykshitija', 'shahajichinchole', 'prachipatil', 'sagar2bhujbal', 'aljo.joy22', 'kpiyushbhirud', 'gohel.mitesh91']",67,"['vivianmascarenhas1994', 'nimita.singh', 'greatabhi.jathar', 'aakash3194', 'swapnalimakdey25', 'linusassao974', 'mannapatil', 'prathuhatode', 'kanchan.phadtare', 'kedarthale', 'chiragpooniwala', 'shamika', 'varsha.jagadale188.vj', 'tejomayi.wandhile', 'mehta.krish', 'rohan.ranshinge', 'karthik.radhakrishna022', 'mrhbtiwari', 'priyanka.kulkarni', 'kapsesainath', 'tanmaykadam', 'giridharsh1', 'fruitywithmonty', 'pranali.kokate9', 'payalsaldur', 'ajit.gaikwad325', 'neetika.k10', 'mohit951995', 'nachi.2605', 'sharan.raikhangar', 'dj.dharmik', 'akshaykatkar', 'abha08', 'mewadayash', 'jitusawant10', 'mananmehta95', 'shashwatssanghavi', 'sahilkolwankar', 'pbandewar', 'ankushlagad4', 'krusha14', 's.aditya.ghadiali', 'sanika.pandharkar', 'gurnani.nikita999', 'amol.dhanvij10', 'sagar.mujpara99', 'pritidhandrut25', 'shraddha0306', 'mandavkarnidhi', 'a.b.surgade', 'mvedant29', 'rupali.patil', 'sushmakodagali', 'abhay.kshirsagar', 'sunilkavatkar', None, 'rohanbandal93', 'ramjighatala7', 'pushkarvaity', 'sonali2', 'ghaisas.atharv', 'ashishjamdade72', 'jidvaze', 'shruti.ganjoo97', 'inderjitsingh87', 'juvika1994', 'ssatam23dps']",76,"['vivianmascarenhas1994', 'nimita.singh', 'greatabhi.jathar', 'aakash3194', 'swapnalimakdey25', 'linusassao974', 'mannapatil', 'prathuhatode', 'kanchan.phadtare', 'kedarthale', 'chiragpooniwala', 'shamika', 'varsha.jagadale188.vj', 'tejomayi.wandhile', 'mehta.krish', 'rohan.ranshinge', 'karthik.radhakrishna022', 'mrhbtiwari', 'priyanka.kulkarni', 'shahajichinchole', 'kapsesainath', 'tanmaykadam', 'giridharsh1', 'fruitywithmonty', 'pranali.kokate9', 'aljo.joy22', 'payalsaldur', 'kpiyushbhirud', 'ajit.gaikwad325', 'neetika.k10', 'sagar2bhujbal', 'vishalvb04', 'mohit951995', 'nachi.2605', 'sharan.raikhangar', 'dj.dharmik', 'akshaykshitija', 'akshaykatkar', 'abha08', 'adithyamohan', 'mewadayash', 'jitusawant10', 'mananmehta95', 'shashwatssanghavi', 'gohel.mitesh91', 'sahilkolwankar', 'prachipatil', 'pbandewar', 'ankushlagad4', 'krusha14', 's.aditya.ghadiali', 'sanika.pandharkar', 'gurnani.nikita999', 'amol.dhanvij10', 'sagar.mujpara99', 'pritidhandrut25', 'shraddha0306', 'mandavkarnidhi', 'a.b.surgade', 'mvedant29', 'rupali.patil', 'sushmakodagali', 'abhay.kshirsagar', 'sunilkavatkar', None, 'rohanbandal93', 'ramjighatala7', 'pushkarvaity', 'sonali2', 'ghaisas.atharv', 'ashishjamdade72', 'jidvaze', 'shruti.ganjoo97', 'inderjitsingh87', 'juvika1994', 'ssatam23dps']"
70,170,10,30,3,"['aljo.joy22', 'vishalvb04', 'gohel.mitesh91']",6,"['akshaykshitija', 'shahajichinchole', 'prachipatil', 'sagar2bhujbal', 'adithyamohan', 'kpiyushbhirud']",27,"['akshaykatkar', 'vedarthsave80', 'sagarpaarcha', 'swapnalimakdey25', 'prathuhatode', 'sahilkolwankar', 'shamika', 'reema.karmokar17', 'varsha.jagadale188.vj', 'sayaliw212', 'a.b.surgade', 'kurhekar_abha', 'borse84kiran', 'tanmaykadam', 'sangeetamjoshi', 'surajmore009', 'nilesh15394', 'payalsaldur', None, 'ajit.gaikwad325', 'neetika.k10', 'ghaisas.atharv', 'ashishjamdade72', 'mohit951995', 'jidvaze', 'arunsamuel2002', 'shraddha0306']",36,"['akshaykshitija', 'akshaykatkar', 'vedarthsave80', 'sagarpaarcha', 'adithyamohan', 'swapnalimakdey25', 'gohel.mitesh91', 'prathuhatode', 'sahilkolwankar', 'prachipatil', 'shamika', 'reema.karmokar17', 'varsha.jagadale188.vj', 'sayaliw212', 'shahajichinchole', 'a.b.surgade', 'kurhekar_abha', 'borse84kiran', 'tanmaykadam', 'sangeetamjoshi', 'aljo.joy22', 'surajmore009', 'nilesh15394', 'payalsaldur', 'kpiyushbhirud', None, 'ajit.gaikwad325', 'neetika.k10', 'sagar2bhujbal', 'vishalvb04', 'ghaisas.atharv', 'ashishjamdade72', 'mohit951995', 'jidvaze', 'arunsamuel2002', 'shraddha0306']"
70,168,10,29,9,"['akshaykshitija', 'shahajichinchole', 'prachipatil', 'sagar2bhujbal', 'adithyamohan', 'vishalvb04', 'aljo.joy22', 'kpiyushbhirud', 'gohel.mitesh91']",0,[],20,"['mehakkoul1994', 'shweta_rajguru', 'ayy1892', 'ajinkyamhatre', 'anmol1993', 'avinashpatil0291', 'tripathipavan10', 'dineshbhairi', 'jyotiwayal', 'asup148', 'johnsmith.earth1', 'kurhekar_abha', 'arcanetech12', 'darshanahir11', 'basher00992', None, 'pinkpanther', 'yashashreelonandkar', 'gaurang123', 'shraddha0306']",29,"['akshaykshitija', 'adithyamohan', 'mehakkoul1994', 'shweta_rajguru', 'ayy1892', 'ajinkyamhatre', 'anmol1993', 'gohel.mitesh91', 'avinashpatil0291', 'prachipatil', 'tripathipavan10', 'jyotiwayal', 'dineshbhairi', 'asup148', 'shahajichinchole', 'johnsmith.earth1', 'kurhekar_abha', 'arcanetech12', 'darshanahir11', 'basher00992', 'aljo.joy22', 'kpiyushbhirud', None, 'sagar2bhujbal', 'pinkpanther', 'yashashreelonandkar', 'vishalvb04', 'gaurang123', 'shraddha0306']"
70,174,10,25,9,"['akshaykshitija', 'shahajichinchole', 'prachipatil', 'sagar2bhujbal', 'adithyamohan', 'vishalvb04', 'aljo.joy22', 'kpiyushbhirud', 'gohel.mitesh91']",0,[],16,"['avinashpatil0291', 'johnsmith.earth1', 'pinkpanther', 'shraddha0306', 'jyotiwayal', 'yashashreelonandkar', 'b1', 'tripathipavan10', 'basher00992', 'mehakkoul1994', 'khushboooooo', 'dineshbhairi', 'shweta_rajguru', None, 'gaurang123', 'asup148']",25,"['akshaykshitija', 'adithyamohan', 'mehakkoul1994', 'shweta_rajguru', 'gohel.mitesh91', 'avinashpatil0291', 'prachipatil', 'tripathipavan10', 'dineshbhairi', 'jyotiwayal', 'asup148', 'shahajichinchole', 'johnsmith.earth1', 'b1', 'basher00992', 'aljo.joy22', 'khushboooooo', 'kpiyushbhirud', None, 'sagar2bhujbal', 'pinkpanther', 'yashashreelonandkar', 'vishalvb04', 'gaurang123', 'shraddha0306']"
70,40,10,18,7,"['akshaykshitija', 'shahajichinchole', 'sagar2bhujbal', 'adithyamohan', 'vishalvb04', 'aljo.joy22', 'kpiyushbhirud']",2,"['prachipatil', 'gohel.mitesh91']",11,"['johnsmith.earth1', 'pinkpanther', 'b1', 'darshanahir11', 'basher00992', 'khushboooooo', 'dineshbhairi', 'shweta_rajguru', None, 'gaurang123', 'shraddha0306']",20,"['akshaykshitija', 'shahajichinchole', 'johnsmith.earth1', 'adithyamohan', 'b1', 'darshanahir11', 'basher00992', 'aljo.joy22', 'khushboooooo', 'shweta_rajguru', 'kpiyushbhirud', None, 'gohel.mitesh91', 'prachipatil', 'sagar2bhujbal', 'pinkpanther', 'vishalvb04', 'dineshbhairi', 'gaurang123', 'shraddha0306']"
70,169,10,17,1,['gohel.mitesh91'],8,"['akshaykshitija', 'shahajichinchole', 'prachipatil', 'sagar2bhujbal', 'adithyamohan', 'vishalvb04', 'aljo.joy22', 'kpiyushbhirud']",16,"['a.b.surgade', 'vedarthsave80', 'shamika', 'borse84kiran', 'deeps94devkar', 'sagarpaarcha', 'hiteshbhaskarshirsat', 'shruti93patil', 'surajmore009', 'nilesh15394', 'pranali.kokate9', 'shruti.ganjoo97', 'arunsamuel2002', 'sayaliw212', None, 'durgadole42']",25,"['akshaykshitija', 'shahajichinchole', 'a.b.surgade', 'vedarthsave80', 'borse84kiran', 'sagarpaarcha', 'adithyamohan', 'shruti93patil', 'aljo.joy22', 'surajmore009', 'nilesh15394', 'pranali.kokate9', 'deeps94devkar', 'kpiyushbhirud', None, 'gohel.mitesh91', 'prachipatil', 'sagar2bhujbal', 'shamika', 'vishalvb04', 'hiteshbhaskarshirsat', 'shruti.ganjoo97', 'sayaliw212', 'arunsamuel2002', 'durgadole42']"
70,39,10,16,1,['akshaykshitija'],8,"['shahajichinchole', 'prachipatil', 'sagar2bhujbal', 'adithyamohan', 'vishalvb04', 'aljo.joy22', 'kpiyushbhirud', 'gohel.mitesh91']",15,"['shraddha0306', 'singhchetna01', 'nishant.joshi42', 'savitashetty111', 'rutu.balure', None, 'pb9298', 'rautsayli10', 'sushmakodagali', 'basher00992', 'inderjitsingh87', 'sayaliw212', 'kanchangorde15', 'ajinkyamhatre', 'anetha123']",24,"['akshaykshitija', 'shahajichinchole', 'shraddha0306', 'nishant.joshi42', 'adithyamohan', 'rutu.balure', 'sushmakodagali', 'aljo.joy22', 'basher00992', 'kpiyushbhirud', 'ajinkyamhatre', None, 'gohel.mitesh91', 'prachipatil', 'sagar2bhujbal', 'singhchetna01', 'savitashetty111', 'vishalvb04', 'pb9298', 'rautsayli10', 'inderjitsingh87', 'sayaliw212', 'kanchangorde15', 'anetha123']"
70,175,10,13,1,['aljo.joy22'],8,"['akshaykshitija', 'shahajichinchole', 'prachipatil', 'sagar2bhujbal', 'adithyamohan', 'vishalvb04', 'kpiyushbhirud', 'gohel.mitesh91']",12,"['ajit.gaikwad325', 'neetika.k10', 'sahilkolwankar', 'akshaykatkar', 'tanmaykadam', 'varsha.jagadale188.vj', 'ashishjamdade72', 'mohit951995', 'prathuhatode', 'payalsaldur', None, 'shraddha0306']",21,"['akshaykshitija', 'shahajichinchole', 'akshaykatkar', 'tanmaykadam', 'adithyamohan', 'aljo.joy22', 'payalsaldur', 'kpiyushbhirud', None, 'gohel.mitesh91', 'prathuhatode', 'ajit.gaikwad325', 'neetika.k10', 'sahilkolwankar', 'prachipatil', 'sagar2bhujbal', 'vishalvb04', 'varsha.jagadale188.vj', 'ashishjamdade72', 'mohit951995', 'shraddha0306']"
71,218,10,19,8,"['mohsenraafat', 'mazenahmed09', 'ahmedhatemelkady', 'monaahmed', 'ahmed_refaat', 'a.hesham', 'sherif__hosny', 'raniaosama2015']",1,['moaz'],11,"['serag', 'johnjoeee524', 'elmohnds.terika', 'hazem1', 'rananader', 'marinamedhat', 'esraa', 'nourhan', 'ayamohamed12030', 'patyessam', None]",20,"['mohsenraafat', 'moaz', 'mazenahmed09', 'serag', 'johnjoeee524', 'ahmedhatemelkady', 'monaahmed', 'rananader', 'marinamedhat', 'esraa', 'nourhan', 'raniaosama2015', 'patyessam', None, 'elmohnds.terika', 'hazem1', 'ahmed_refaat', 'a.hesham', 'sherif__hosny', 'ayamohamed12030']"
71,161,10,11,8,"['mohsenraafat', 'moaz', 'mazenahmed09', 'ahmedhatemelkady', 'monaahmed', 'ahmed_refaat', 'a.hesham', 'sherif__hosny']",1,['raniaosama2015'],3,"[None, 'moustafa.eldesouky', 'esraa']",12,"['mohsenraafat', 'moaz', 'mazenahmed09', 'ahmedhatemelkady', 'monaahmed', 'esraa', 'raniaosama2015', 'moustafa.eldesouky', None, 'ahmed_refaat', 'a.hesham', 'sherif__hosny']"
71,216,10,11,1,['moaz'],8,"['mohsenraafat', 'mazenahmed09', 'ahmedhatemelkady', 'monaahmed', 'ahmed_refaat', 'a.hesham', 'sherif__hosny', 'raniaosama2015']",10,"['shaher146', 'faisal_hussien', 'eman2015', 'kareemchicharito14', 'mnaguib345', 'marinamedhat', 'omarko.kamel', 'ayamohamed12030', 'moustafa.eldesouky', None]",19,"['mohsenraafat', 'moaz', 'mazenahmed09', 'ahmedhatemelkady', 'faisal_hussien', 'monaahmed', 'kareemchicharito14', 'mnaguib345', 'marinamedhat', 'raniaosama2015', 'moustafa.eldesouky', None, 'shaher146', 'eman2015', 'ahmed_refaat', 'a.hesham', 'sherif__hosny', 'omarko.kamel', 'ayamohamed12030']"
71,188,10,7,6,"['mohsenraafat', 'mazenahmed09', 'ahmedhatemelkady', 'a.hesham', 'ahmed_refaat', 'sherif__hosny']",3,"['moaz', 'monaahmed', 'raniaosama2015']",1,[None],10,"['mohsenraafat', 'moaz', 'mazenahmed09', 'ahmedhatemelkady', 'monaahmed', 'ahmed_refaat', 'a.hesham', 'sherif__hosny', 'raniaosama2015', None]"
71,217,10,7,1,['raniaosama2015'],8,"['mohsenraafat', 'moaz', 'mazenahmed09', 'ahmedhatemelkady', 'monaahmed', 'ahmed_refaat', 'a.hesham', 'sherif__hosny']",6,"['hazem1', 'kareemchicharito14', 'marinamedhat', 'ayamohamed12030', 'patyessam', None]",15,"['mohsenraafat', 'moaz', 'mazenahmed09', 'ahmedhatemelkady', 'monaahmed', 'hazem1', 'ahmed_refaat', 'a.hesham', 'kareemchicharito14', 'sherif__hosny', 'marinamedhat', 'ayamohamed12030', 'raniaosama2015', 'patyessam', None]"
72,21,9,9,8,"['cseiler16', 'mykytheman1', 'memeiselandi', 'priyank247', 'abenadia', 'souto.alan', 'sammyyo1998', 'garrettmonroe98']",0,[],1,[None],9,"['cseiler16', 'sammyyo1998', 'mykytheman1', 'memeiselandi', 'abenadia', None, 'souto.alan', 'priyank247', 'garrettmonroe98']"
72,144,9,9,8,"['cseiler16', 'mykytheman1', 'memeiselandi', 'priyank247', 'abenadia', 'souto.alan', 'sammyyo1998', 'garrettmonroe98']",0,[],1,[None],9,"['cseiler16', 'sammyyo1998', 'mykytheman1', 'memeiselandi', 'abenadia', None, 'souto.alan', 'priyank247', 'garrettmonroe98']"
73,110,9,8,7,"['giulio777', '19sanjana92', 'ylliu', 'chernand', 'shidelet', 'bsparta', 'youfangcao']",1,['ncokergordon'],1,[None],9,"['19sanjana92', 'giulio777', 'ncokergordon', None, 'chernand', 'ylliu', 'shidelet', 'bsparta', 'youfangcao']"
74,78,9,28,7,"['runa.sabiha', 'eldumett', 'aacun', 'rdhrishya', 'shinjinwoo', 'ttonmoy', 'carlotta.borsoi']",1,['michal.kotkowiak'],21,"['f94524048', 'scif.ucmerced', 'm.gilbert', 'eshen2210', 'kcopenhagen', 'peter.schnatz', 'bbayram', 'sarahwhite603', 'palejandg', 'ellisbradley92', 'mtsukamoto', 'devette2', 'alelicampbell', 'jzamora', 'justicemason06', None, 'jeremysmith244', 'gracegu89', 'iancberg', 'xuanli0121', 'amacedoandrade']",29,"['f94524048', 'scif.ucmerced', 'm.gilbert', 'ttonmoy', 'eshen2210', 'bbayram', 'peter.schnatz', 'kcopenhagen', 'aacun', 'sarahwhite603', 'rdhrishya', 'shinjinwoo', 'palejandg', 'ellisbradley92', 'xuanli0121', 'mtsukamoto', 'devette2', 'michal.kotkowiak', 'alelicampbell', 'jzamora', None, 'runa.sabiha', 'eldumett', 'jeremysmith244', 'gracegu89', 'justicemason06', 'carlotta.borsoi', 'iancberg', 'amacedoandrade']"
75,70,9,19,8,"['waghmareswapnali161', 'ruturajpatil6640', 'mujawarashif786', 'vijaykaradesnst', 'tawadeanitak94', 'pritilatajadhav', 'kalakesonalisnst', 'malidhanashreem95']",0,[],11,"['amrutapatil100', 'kajal.gchougale', 'manasihuparikar06', 'pritam.snst', 'rahultk9464', 'kamblepriyankan95', 'tukaram', 'sunilpatil4488', 'dhavaleru', None, 'moresuraj222']",19,"['amrutapatil100', 'kajal.gchougale', 'manasihuparikar06', 'pritam.snst', 'ruturajpatil6640', 'mujawarashif786', 'kamblepriyankan95', 'sunilpatil4488', 'dhavaleru', 'kalakesonalisnst', None, 'waghmareswapnali161', 'rahultk9464', 'vijaykaradesnst', 'tukaram', 'tawadeanitak94', 'pritilatajadhav', 'malidhanashreem95', 'moresuraj222']"
76,101,9,20,1,['reb121'],7,"['eduardoserralta', 'wilber.silva', 'nima8888', 'tonialencar', 'engahmedamin88', 'thomazin91', 'godistance']",19,"['pasinika10', 'aea43', 'candreasen', 'cjl94', 'mls272', 'kds65', 'cwm58', 'gpb23', 'ceo11235', 'rlm152', 'bdg33', 'krm90', 'ejh101', 'formaterials', 'jmh267', None, 'jmv50', 'maw170', 'mdh80']",27,"['rlm152', 'bdg33', 'pasinika10', 'nima8888', 'aea43', 'tonialencar', 'engahmedamin88', 'krm90', 'candreasen', 'cjl94', 'reb121', 'mls272', 'kds65', 'ejh101', 'formaterials', None, 'jmh267', 'eduardoserralta', 'cwm58', 'jmv50', 'wilber.silva', 'gpb23', 'ceo11235', 'mdh80', 'maw170', 'thomazin91', 'godistance']"
76,100,9,14,1,['godistance'],7,"['eduardoserralta', 'wilber.silva', 'nima8888', 'tonialencar', 'engahmedamin88', 'reb121', 'thomazin91']",13,"['skazemi', 'angokoro', 'boningqu', 'ecburges', 'briandm', 'etdiloreto', 'dcjones.012', 'rgspurn', 'yuxiangz', 'boningqu1993', 'grierson', None, 'ycollin']",21,"['skazemi', 'angokoro', 'briandm', 'nima8888', 'tonialencar', 'engahmedamin88', 'etdiloreto', 'reb121', 'grierson', None, 'ycollin', 'eduardoserralta', 'boningqu', 'ecburges', 'wilber.silva', 'dcjones.012', 'rgspurn', 'boningqu1993', 'yuxiangz', 'thomazin91', 'godistance']"
76,103,9,6,1,['engahmedamin88'],7,"['eduardoserralta', 'wilber.silva', 'nima8888', 'tonialencar', 'reb121', 'thomazin91', 'godistance']",5,"['herediamichelle1', 'wayneyang05', 'mazoots', 'alirezaa66', None]",13,"['herediamichelle1', 'wayneyang05', 'mazoots', 'wilber.silva', 'nima8888', 'tonialencar', 'engahmedamin88', 'alirezaa66', 'reb121', 'thomazin91', None, 'eduardoserralta', 'godistance']"
78,38,9,176,3,"['vedarthsave80', 'rupali.patil', 'jidvaze']",5,"['reema.karmokar17', 'arcanetech12', 'ghaisas.atharv', 'darshanahir11', 'ajinkyamhatre']",173,"['t0rse95', 'priyanka.chavan.s.pc', 'nimita.singh', 'shaikhkarnekar', 'vesitd16b', 'sshelar01', 'aksh1995', 'sarprashasti21', 'adityasawant93', 'gaikar.shubhada888', 'patilmonika681', 'smsayali79', 'mehta.krish', 'rohan.ranshinge', 'devanandkb', 'raghu.shirodkar', 'heenal0708', 'sanjay.devan.ranstad', 'reubenalexander2010', 'ashwinnumbrat94', 'satya_mishra', 'pranjali.borkar', 'richard.noronha', 'fruitywithmonty', 'jadhavadhiraj', 'pratikkavale11', 'suyash.chopra', 'amitpoojary94', 'spawar10', 'abhishek.shinde', 'rakeshchrs87', 'harshada.patankar', 'nilesh2551994', 'smhatre08', 'dalviakshata12', 'mayurgaikwad1293', 'devang19.shah', 'pritish.das', 'gajakosh.sneha54', 'suyash.karle', 'milu21111994', 'takalesusmita', 'pranjali2610', 'yash_iyengar27', 'cyberclan.xd', 'snehavardhini', 'nishanth1101', 'salil.vaidya', 'nitiiinbaranwal', 'rupali1891994', 'naren.ambwani', 'seemamishra', 'trupti.vaity19', 'zak1010', 'lokhanderaj55', 'ankushlagad4', 'dlaxmanc59', 'narenambwani04', 's.aditya.ghadiali', 'yamkarki', 'arsh.raina', 'vinu.sunny1994.vs', 'shubhampnkr', 'a.b.surgade', 'kaushik_gaikwad', 'sumaiyya.kazi94', 'abhishek291', 'muktat20', 'stylechicanki', 'suraj348', 'govind9867129531', 'vijayaher0211', 'ruprane296', 'karna1995.kj', 'sneha.kutal', 'maradiyadhaval92', 'tuscanowtsheryl128', 'thefreeliar18', 'ksurgade', 'ascharyaskumar', 'deepuvijaya1806', 'ibrahimarif950', 'shrimohite13', 'chinmay', 'juvika1994', 'mrinalini20.shah', 'amol.marathe93', 'darpan.bagwale', 'aishhhh', 'gokisush9', 'anirudh2442', 'aakash3194', 'swapnalimakdey25', 'mmodi296', 'pratham201294', 'jatinshende25', 'ranjanjadhav1234', 'syadav05', 'hit.kamble', 'vejalporia1994', 'kiran.pawar1611', 'anirudh0000', 'kanchan.phadtare', 'tawadesiddhesh1994', 'priyankajamdade23', 'mugdhapv8', 'sapnabhandary31', 'dkbathe29', 'zalakdodecha', 'chabhadiariddhi', 'aayushjain27894', 'nikhiljadhav.jadhav40', 'sapte01', 'ranju.raj18', 'chisimeybijimchigmomin', 'manali', 'kumar.amit156', 'prajaktasjoshi911', 'pranali.kokate9', 'dubalprasad04', 'omkar.bane13', 'kalpeshshukla11', 'amey.2994', 'sumitkarmokar', 'advaitchuri', 'nshambhuraje', 'mkshirke94', 'parabmahadev34', 'prathmeshgurunathparab', 'shashanksingh4000', 'karanshh30', 'anut730', 'kanchangorde15', 'abhijeetchavan', 'ashijadhav20', 'swapneil.hirulkar', 'paresh761', 'dung_master24', 'shreyasnaravane', 'ambicavenkatesh2009', 'rajkumar.kalantri', 'kuldeeppatil201093', 'shreenathdalvi1994', 'pankajsalunkhe23', 'amitmadgi15', 'smackthatjohn', 'pendkeomkar', 'krusha14', 'sanika.pandharkar', 'omkar12345', 'akshaysharma', 'jmen1993', 'manishakolekar1994', 'sagarbisen50', 'pralim', 'sharvaridalvi301', 'sayli.shevade', 'ishmeetsingh', 'borse84kiran', 'ashish123', 'rgole02', 'thoravekalpesh', 'asudha', 'jeniljain1008', 'isaurabhbhirud7', 'palashmak067', 'ruchita9523', 'inderjitsingh87', 'ryadav03', 'abhishek.singh', 'devendrashinde1995', 'gharat789', 'hrishikeshtawade']",181,"['t0rse95', 'priyanka.chavan.s.pc', 'nimita.singh', 'shaikhkarnekar', 'vesitd16b', 'sshelar01', 'aksh1995', 'sarprashasti21', 'adityasawant93', 'gaikar.shubhada888', 'patilmonika681', 'smsayali79', 'mehta.krish', 'rohan.ranshinge', 'devanandkb', 'raghu.shirodkar', 'heenal0708', 'sanjay.devan.ranstad', 'reubenalexander2010', 'ashwinnumbrat94', 'satya_mishra', 'pranjali.borkar', 'richard.noronha', 'fruitywithmonty', 'jadhavadhiraj', 'darshanahir11', 'pratikkavale11', 'suyash.chopra', 'amitpoojary94', 'spawar10', 'abhishek.shinde', 'rakeshchrs87', 'harshada.patankar', 'nilesh2551994', 'smhatre08', 'dalviakshata12', 'mayurgaikwad1293', 'devang19.shah', 'pritish.das', 'gajakosh.sneha54', 'suyash.karle', 'milu21111994', 'vedarthsave80', 'takalesusmita', 'pranjali2610', 'yash_iyengar27', 'cyberclan.xd', 'snehavardhini', 'nishanth1101', 'salil.vaidya', 'nitiiinbaranwal', 'rupali1891994', 'naren.ambwani', 'seemamishra', 'trupti.vaity19', 'zak1010', 'lokhanderaj55', 'ankushlagad4', 'dlaxmanc59', 'narenambwani04', 'reema.karmokar17', 's.aditya.ghadiali', 'yamkarki', 'arsh.raina', 'vinu.sunny1994.vs', 'shubhampnkr', 'a.b.surgade', 'kaushik_gaikwad', 'sumaiyya.kazi94', 'abhishek291', 'muktat20', 'stylechicanki', 'suraj348', 'govind9867129531', 'vijayaher0211', 'ruprane296', 'karna1995.kj', 'sneha.kutal', 'maradiyadhaval92', 'tuscanowtsheryl128', 'thefreeliar18', 'ksurgade', 'ascharyaskumar', 'deepuvijaya1806', 'ibrahimarif950', 'shrimohite13', 'chinmay', 'juvika1994', 'mrinalini20.shah', 'amol.marathe93', 'darpan.bagwale', 'aishhhh', 'gokisush9', 'anirudh2442', 'aakash3194', 'swapnalimakdey25', 'mmodi296', 'pratham201294', 'jatinshende25', 'ranjanjadhav1234', 'syadav05', 'hit.kamble', 'vejalporia1994', 'kiran.pawar1611', 'anirudh0000', 'kanchan.phadtare', 'tawadesiddhesh1994', 'priyankajamdade23', 'mugdhapv8', 'sapnabhandary31', 'dkbathe29', 'zalakdodecha', 'chabhadiariddhi', 'aayushjain27894', 'nikhiljadhav.jadhav40', 'sapte01', 'ranju.raj18', 'chisimeybijimchigmomin', 'manali', 'kumar.amit156', 'prajaktasjoshi911', 'pranali.kokate9', 'dubalprasad04', 'omkar.bane13', 'kalpeshshukla11', 'amey.2994', 'sumitkarmokar', 'advaitchuri', 'nshambhuraje', 'mkshirke94', 'parabmahadev34', 'prathmeshgurunathparab', 'shashanksingh4000', 'karanshh30', 'anut730', 'kanchangorde15', 'abhijeetchavan', 'ashijadhav20', 'swapneil.hirulkar', 'paresh761', 'dung_master24', 'shreyasnaravane', 'ambicavenkatesh2009', 'rajkumar.kalantri', 'kuldeeppatil201093', 'ajinkyamhatre', 'shreenathdalvi1994', 'pankajsalunkhe23', 'amitmadgi15', 'smackthatjohn', 'pendkeomkar', 'krusha14', 'sanika.pandharkar', 'omkar12345', 'akshaysharma', 'jmen1993', 'manishakolekar1994', 'sagarbisen50', 'pralim', 'sharvaridalvi301', 'sayli.shevade', 'ishmeetsingh', 'borse84kiran', 'ashish123', 'rgole02', 'thoravekalpesh', 'arcanetech12', 'asudha', 'rupali.patil', 'jeniljain1008', 'isaurabhbhirud7', 'palashmak067', 'ghaisas.atharv', 'jidvaze', 'ruchita9523', 'inderjitsingh87', 'ryadav03', 'abhishek.singh', 'devendrashinde1995', 'gharat789', 'hrishikeshtawade']"
78,35,9,135,1,['arcanetech12'],7,"['vedarthsave80', 'reema.karmokar17', 'ghaisas.atharv', 'rupali.patil', 'darshanahir11', 'jidvaze', 'ajinkyamhatre']",134,"['kalpitnarvekar', 'rohan21', 'linusassao974', 'komalkolekar95', 'patelmeeti1995', 'lakshoza', 'tanmaypatil18', 'shamika', 'mehta.krish', 'tejomayi.wandhile', 'bhoglet', 'ameysv22', 'sayaliw212', 'chinmayhejmadi', 'sonal.02031995', 'pomkar55', 'shahajichinchole', 'mrinalivyas1', 'mohiteruchir29', 'aksha0103', 'architagoyal', 'modyjash', 'kodagakshay26', 'karan.dhareshwar', 'himanshu21rasam', 'deepashrisane2203', 'vanitashingwa1995', 'tushardmaske', 'imushaikh007', 'rp92555', 'hegde.aniket94.ah', 'mewadayash', 'dal30', 'mehakkoul1994', 'shashwatssanghavi', 'aniketvidyalankar', 'gohel.mitesh91', 'divyapawar39', 'ansi7794', 'vj280395', 'niharikasarode', 'ghosh.arjun97', 'deepakjain.dj2', 'supriya.mangalpalli', 'ajoshi1996', 'desaimaanil2', 'hemantsonar93', 'sunilpoojary27', 'a.b.surgade', 'aka_jadhav', 'sammeetthosar', 'sangeetamjoshi', 'stylechicanki', 'basher00992', 'chaudharilatika02', 'satishlovesmom123', 'dakshata', 'ruprane296', 'rahulstary', 'tuscanowtsheryl128', 'sonali2', 'pb9298', 'adityasingh8394', 'rajpareshshah14', 'shubham.mohite7', 'chinmay', 'gidayegirish', 'shraddha0306', 'aamod1996', 'kanchipoddar', 'sagnikpal3495', 'prasadbhujbal28', 'mmodi296', 'mengaderutuja369', 'ganeshmukund10', 'rutuja1122', 'rsarmajrt', 'saurabhmangeshkar', 'chabhadiariddhi', 'deepti.bhosale189', 'saurabh.medhekar18', 'akash.jadhav', 'hemantjathar7', 'pallavighogare1994', 'ganjirajini277', 'kumar.amit156', 'krishna.jhuma17', 'nilesh15394', 'aljo.joy22', 'ankitashere04', 'mayuresh20', 'kirandarade133', 'sagar2bhujbal', 'prasadchachad20', 'karanshh30', 'kanchangorde15', 'rushabkarani', 'sj.shruti95', 'chintanrlimbani', 'abhijeetchavan', 'rwaghela51', 'udayanyarya', 'jyotibhosale8483', 'umang.parekh30', 'samira2308', 'ayy1892', 'shivachandran.nadar15', 'prachipatil', 'qaspfu', 'ayushgupta11031996', 'tripathipavan10', 'sonaltambe32', 'rohanshah611', 'sagar.mujpara99', 'akajadhav1', 'mvedant29', 'borse84kiran', 'anujkolvalkar1', 'vaibhavvadia', 'darshanlukhi25', 'surajmore009', 'amitsunildhamne', 'redorchid029', 'nikinsaw', 'sunilkavatkar', 'phadsujata59', 'shetty1995pranoy', 'akshaykharat563', 'jharupesh440', None, 'aj.shahare', 'amaya.pethe', 'roshninilam', 'inderjitsingh87']",142,"['kalpitnarvekar', 'rohan21', 'linusassao974', 'komalkolekar95', 'patelmeeti1995', 'lakshoza', 'tanmaypatil18', 'shamika', 'mehta.krish', 'tejomayi.wandhile', 'bhoglet', 'ameysv22', 'sayaliw212', 'chinmayhejmadi', 'sonal.02031995', 'pomkar55', 'shahajichinchole', 'darshanahir11', 'mrinalivyas1', 'mohiteruchir29', 'aksha0103', 'architagoyal', 'modyjash', 'kodagakshay26', 'karan.dhareshwar', 'himanshu21rasam', 'deepashrisane2203', 'vanitashingwa1995', 'tushardmaske', 'vedarthsave80', 'imushaikh007', 'rp92555', 'hegde.aniket94.ah', 'mewadayash', 'dal30', 'mehakkoul1994', 'shashwatssanghavi', 'aniketvidyalankar', 'gohel.mitesh91', 'divyapawar39', 'ansi7794', 'vj280395', 'niharikasarode', 'ghosh.arjun97', 'reema.karmokar17', 'deepakjain.dj2', 'supriya.mangalpalli', 'ajoshi1996', 'desaimaanil2', 'hemantsonar93', 'sunilpoojary27', 'a.b.surgade', 'aka_jadhav', 'sammeetthosar', 'sangeetamjoshi', 'stylechicanki', 'basher00992', 'chaudharilatika02', 'satishlovesmom123', 'dakshata', 'ruprane296', 'rahulstary', 'tuscanowtsheryl128', 'sonali2', 'pb9298', 'adityasingh8394', 'rajpareshshah14', 'shubham.mohite7', 'chinmay', 'gidayegirish', 'shraddha0306', 'aamod1996', 'kanchipoddar', 'sagnikpal3495', 'prasadbhujbal28', 'mmodi296', 'mengaderutuja369', 'ganeshmukund10', 'rutuja1122', 'rsarmajrt', 'saurabhmangeshkar', 'chabhadiariddhi', 'deepti.bhosale189', 'saurabh.medhekar18', 'akash.jadhav', 'hemantjathar7', 'pallavighogare1994', 'ganjirajini277', 'kumar.amit156', 'krishna.jhuma17', 'nilesh15394', 'aljo.joy22', 'ankitashere04', 'mayuresh20', 'kirandarade133', 'sagar2bhujbal', 'prasadchachad20', 'karanshh30', 'kanchangorde15', 'rushabkarani', 'sj.shruti95', 'chintanrlimbani', 'abhijeetchavan', 'rwaghela51', 'udayanyarya', 'jyotibhosale8483', 'umang.parekh30', 'samira2308', 'ayy1892', 'shivachandran.nadar15', 'ajinkyamhatre', 'prachipatil', 'qaspfu', 'ayushgupta11031996', 'tripathipavan10', 'sonaltambe32', 'rohanshah611', 'sagar.mujpara99', 'akajadhav1', 'mvedant29', 'borse84kiran', 'arcanetech12', 'anujkolvalkar1', 'rupali.patil', 'vaibhavvadia', 'darshanlukhi25', 'surajmore009', 'amitsunildhamne', 'redorchid029', 'nikinsaw', 'sunilkavatkar', 'phadsujata59', 'shetty1995pranoy', 'akshaykharat563', 'jharupesh440', None, 'aj.shahare', 'amaya.pethe', 'ghaisas.atharv', 'roshninilam', 'jidvaze', 'inderjitsingh87']"
78,42,9,69,3,"['ghaisas.atharv', 'rupali.patil', 'jidvaze']",5,"['vedarthsave80', 'reema.karmokar17', 'arcanetech12', 'darshanahir11', 'ajinkyamhatre']",66,"['vivianmascarenhas1994', 'nimita.singh', 'greatabhi.jathar', 'aakash3194', 'swapnalimakdey25', 'linusassao974', 'mannapatil', 'prathuhatode', 'kanchan.phadtare', 'kedarthale', 'chiragpooniwala', 'shamika', 'varsha.jagadale188.vj', 'tejomayi.wandhile', 'mehta.krish', 'rohan.ranshinge', 'karthik.radhakrishna022', 'mrhbtiwari', 'priyanka.kulkarni', 'kapsesainath', 'tanmaykadam', 'giridharsh1', 'fruitywithmonty', 'pranali.kokate9', 'payalsaldur', 'ajit.gaikwad325', 'neetika.k10', 'vishalvb04', 'mohit951995', 'nachi.2605', 'sharan.raikhangar', 'dj.dharmik', 'akshaykatkar', 'abha08', 'adithyamohan', 'mewadayash', 'jitusawant10', 'mananmehta95', 'shashwatssanghavi', 'sahilkolwankar', 'pbandewar', 'ankushlagad4', 'krusha14', 's.aditya.ghadiali', 'sanika.pandharkar', 'gurnani.nikita999', 'amol.dhanvij10', 'sagar.mujpara99', 'pritidhandrut25', 'shraddha0306', 'mandavkarnidhi', 'a.b.surgade', 'mvedant29', 'sushmakodagali', 'abhay.kshirsagar', 'sunilkavatkar', None, 'rohanbandal93', 'ramjighatala7', 'pushkarvaity', 'sonali2', 'ashishjamdade72', 'shruti.ganjoo97', 'inderjitsingh87', 'juvika1994', 'ssatam23dps']",74,"['vivianmascarenhas1994', 'nimita.singh', 'greatabhi.jathar', 'aakash3194', 'swapnalimakdey25', 'linusassao974', 'mannapatil', 'prathuhatode', 'kanchan.phadtare', 'kedarthale', 'chiragpooniwala', 'shamika', 'varsha.jagadale188.vj', 'tejomayi.wandhile', 'mehta.krish', 'rohan.ranshinge', 'karthik.radhakrishna022', 'mrhbtiwari', 'priyanka.kulkarni', 'kapsesainath', 'tanmaykadam', 'giridharsh1', 'fruitywithmonty', 'darshanahir11', 'pranali.kokate9', 'payalsaldur', 'ajit.gaikwad325', 'neetika.k10', 'vishalvb04', 'mohit951995', 'nachi.2605', 'sharan.raikhangar', 'dj.dharmik', 'akshaykatkar', 'vedarthsave80', 'abha08', 'adithyamohan', 'mewadayash', 'jitusawant10', 'mananmehta95', 'shashwatssanghavi', 'ajinkyamhatre', 'sahilkolwankar', 'pbandewar', 'ankushlagad4', 'reema.karmokar17', 'krusha14', 's.aditya.ghadiali', 'sanika.pandharkar', 'gurnani.nikita999', 'amol.dhanvij10', 'sagar.mujpara99', 'pritidhandrut25', 'shraddha0306', 'mandavkarnidhi', 'a.b.surgade', 'mvedant29', 'arcanetech12', 'rupali.patil', 'sushmakodagali', 'abhay.kshirsagar', 'sunilkavatkar', None, 'rohanbandal93', 'ramjighatala7', 'pushkarvaity', 'sonali2', 'ghaisas.atharv', 'ashishjamdade72', 'jidvaze', 'shruti.ganjoo97', 'inderjitsingh87', 'juvika1994', 'ssatam23dps']"
78,170,9,30,4,"['reema.karmokar17', 'vedarthsave80', 'ghaisas.atharv', 'jidvaze']",4,"['arcanetech12', 'ajinkyamhatre', 'rupali.patil', 'darshanahir11']",26,"['akshaykatkar', 'sagarpaarcha', 'swapnalimakdey25', 'prathuhatode', 'gohel.mitesh91', 'sahilkolwankar', 'shamika', 'varsha.jagadale188.vj', 'sayaliw212', 'a.b.surgade', 'kurhekar_abha', 'borse84kiran', 'tanmaykadam', 'sangeetamjoshi', 'surajmore009', 'nilesh15394', 'aljo.joy22', 'payalsaldur', None, 'ajit.gaikwad325', 'neetika.k10', 'vishalvb04', 'ashishjamdade72', 'mohit951995', 'arunsamuel2002', 'shraddha0306']",34,"['akshaykatkar', 'vedarthsave80', 'sagarpaarcha', 'swapnalimakdey25', 'ajinkyamhatre', 'prathuhatode', 'gohel.mitesh91', 'sahilkolwankar', 'shamika', 'reema.karmokar17', 'varsha.jagadale188.vj', 'sayaliw212', 'a.b.surgade', 'kurhekar_abha', 'borse84kiran', 'tanmaykadam', 'arcanetech12', 'rupali.patil', 'darshanahir11', 'sangeetamjoshi', 'surajmore009', 'nilesh15394', 'aljo.joy22', 'payalsaldur', None, 'ajit.gaikwad325', 'neetika.k10', 'vishalvb04', 'ghaisas.atharv', 'ashishjamdade72', 'jidvaze', 'mohit951995', 'arunsamuel2002', 'shraddha0306']"
78,168,9,29,3,"['arcanetech12', 'ajinkyamhatre', 'darshanahir11']",5,"['vedarthsave80', 'reema.karmokar17', 'ghaisas.atharv', 'rupali.patil', 'jidvaze']",26,"['akshaykshitija', 'adithyamohan', 'mehakkoul1994', 'shweta_rajguru', 'ayy1892', 'anmol1993', 'gohel.mitesh91', 'avinashpatil0291', 'prachipatil', 'tripathipavan10', 'dineshbhairi', 'jyotiwayal', 'asup148', 'shahajichinchole', 'johnsmith.earth1', 'kurhekar_abha', 'basher00992', 'aljo.joy22', 'kpiyushbhirud', None, 'sagar2bhujbal', 'pinkpanther', 'yashashreelonandkar', 'vishalvb04', 'gaurang123', 'shraddha0306']",34,"['akshaykshitija', 'vedarthsave80', 'adithyamohan', 'mehakkoul1994', 'shweta_rajguru', 'ayy1892', 'ajinkyamhatre', 'anmol1993', 'gohel.mitesh91', 'avinashpatil0291', 'prachipatil', 'reema.karmokar17', 'tripathipavan10', 'jyotiwayal', 'dineshbhairi', 'asup148', 'shahajichinchole', 'johnsmith.earth1', 'kurhekar_abha', 'arcanetech12', 'rupali.patil', 'darshanahir11', 'basher00992', 'aljo.joy22', 'kpiyushbhirud', None, 'sagar2bhujbal', 'pinkpanther', 'yashashreelonandkar', 'vishalvb04', 'ghaisas.atharv', 'jidvaze', 'gaurang123', 'shraddha0306']"
78,41,9,21,1,['jidvaze'],7,"['vedarthsave80', 'reema.karmokar17', 'arcanetech12', 'ghaisas.atharv', 'rupali.patil', 'darshanahir11', 'ajinkyamhatre']",20,"['ashishtonge94', 'swapnalimakdey25', 'prasadbhujbal28', 'samira2308', 'g.s.siddhant', 'chiragpooniwala', 'trupti.vaity19', 'arunimavarma20', 'amol.dhanvij10', 'raghu.shirodkar', 'fruitywithmonty', 'manali', 'sushmakodagali', None, 'sonali.bhujbal1', 'sonali2', 'inderjitsingh87', 'mns.dinu', 'dj.dharmik', 'ssatam23dps']",28,"['vedarthsave80', 'ashishtonge94', 'arcanetech12', 'rupali.patil', 'swapnalimakdey25', 'darshanahir11', 'fruitywithmonty', 'prasadbhujbal28', 'manali', 'sushmakodagali', 'samira2308', 'ajinkyamhatre', None, 'g.s.siddhant', 'sonali.bhujbal1', 'chiragpooniwala', 'trupti.vaity19', 'sonali2', 'reema.karmokar17', 'ghaisas.atharv', 'jidvaze', 'inderjitsingh87', 'arunimavarma20', 'amol.dhanvij10', 'mns.dinu', 'raghu.shirodkar', 'dj.dharmik', 'ssatam23dps']"
78,40,9,18,1,['darshanahir11'],7,"['vedarthsave80', 'reema.karmokar17', 'arcanetech12', 'ghaisas.atharv', 'rupali.patil', 'jidvaze', 'ajinkyamhatre']",17,"['akshaykshitija', 'shahajichinchole', 'johnsmith.earth1', 'sagar2bhujbal', 'pinkpanther', 'adithyamohan', 'b1', 'vishalvb04', 'basher00992', 'aljo.joy22', 'khushboooooo', 'dineshbhairi', 'shweta_rajguru', 'kpiyushbhirud', None, 'gaurang123', 'shraddha0306']",25,"['akshaykshitija', 'shahajichinchole', 'johnsmith.earth1', 'vedarthsave80', 'adithyamohan', 'arcanetech12', 'b1', 'rupali.patil', 'darshanahir11', 'basher00992', 'aljo.joy22', 'khushboooooo', 'shweta_rajguru', 'kpiyushbhirud', 'ajinkyamhatre', None, 'sagar2bhujbal', 'pinkpanther', 'reema.karmokar17', 'vishalvb04', 'ghaisas.atharv', 'jidvaze', 'dineshbhairi', 'gaurang123', 'shraddha0306']"
78,169,9,17,1,['vedarthsave80'],7,"['reema.karmokar17', 'arcanetech12', 'ghaisas.atharv', 'rupali.patil', 'darshanahir11', 'jidvaze', 'ajinkyamhatre']",16,"['a.b.surgade', 'deeps94devkar', 'shamika', 'borse84kiran', 'sagarpaarcha', 'gohel.mitesh91', 'hiteshbhaskarshirsat', 'shruti93patil', 'surajmore009', 'nilesh15394', 'pranali.kokate9', 'shruti.ganjoo97', 'arunsamuel2002', 'sayaliw212', None, 'durgadole42']",24,"['a.b.surgade', 'vedarthsave80', 'borse84kiran', 'sagarpaarcha', 'arcanetech12', 'rupali.patil', 'darshanahir11', 'shruti93patil', 'surajmore009', 'nilesh15394', 'pranali.kokate9', 'deeps94devkar', 'ajinkyamhatre', None, 'gohel.mitesh91', 'shamika', 'reema.karmokar17', 'ghaisas.atharv', 'hiteshbhaskarshirsat', 'jidvaze', 'shruti.ganjoo97', 'sayaliw212', 'arunsamuel2002', 'durgadole42']"
78,39,9,16,1,['ajinkyamhatre'],7,"['vedarthsave80', 'reema.karmokar17', 'arcanetech12', 'ghaisas.atharv', 'rupali.patil', 'darshanahir11', 'jidvaze']",15,"['akshaykshitija', 'shraddha0306', 'singhchetna01', 'nishant.joshi42', 'savitashetty111', 'rutu.balure', 'pb9298', 'rautsayli10', 'sushmakodagali', 'basher00992', 'inderjitsingh87', 'sayaliw212', 'kanchangorde15', None, 'anetha123']",23,"['akshaykshitija', 'vedarthsave80', 'shraddha0306', 'nishant.joshi42', 'arcanetech12', 'rutu.balure', 'rupali.patil', 'darshanahir11', 'sushmakodagali', 'basher00992', 'ajinkyamhatre', None, 'singhchetna01', 'savitashetty111', 'reema.karmokar17', 'ghaisas.atharv', 'pb9298', 'jidvaze', 'rautsayli10', 'inderjitsingh87', 'sayaliw212', 'kanchangorde15', 'anetha123']"
79,31,8,9,7,"['teslacheng', 'tfis112', 'cmwoods717', 'yuhiaikyo', 'naivednmy', 'aditi.dighe20', 'yaying.atlantis']",0,[],2,"['khyland1031', None]",9,"['tfis112', 'cmwoods717', 'yuhiaikyo', 'aditi.dighe20', 'teslacheng', 'yaying.atlantis', 'khyland1031', None, 'naivednmy']"
79,32,8,9,6,"['teslacheng', 'cmwoods717', 'yuhiaikyo', 'naivednmy', 'aditi.dighe20', 'yaying.atlantis']",1,['tfis112'],3,"[None, 'khyland1031', 'kaeso']",10,"['tfis112', 'cmwoods717', 'yuhiaikyo', 'aditi.dighe20', 'kaeso', 'teslacheng', 'yaying.atlantis', 'khyland1031', None, 'naivednmy']"
79,33,8,9,7,"['teslacheng', 'tfis112', 'cmwoods717', 'yuhiaikyo', 'naivednmy', 'aditi.dighe20', 'yaying.atlantis']",0,[],2,"[None, 'pherr123']",9,"['tfis112', 'cmwoods717', 'yuhiaikyo', 'aditi.dighe20', 'teslacheng', 'yaying.atlantis', None, 'naivednmy', 'pherr123']"
80,105,8,8,6,"['pxyg', 'fengnieqinxi', 'yma', 'x.guo82', 'nanpanshi2', 'changyuling1989']",1,['sri_physics'],2,"['krishnakomerla', None]",9,"['sri_physics', 'pxyg', 'fengnieqinxi', 'yma', 'krishnakomerla', 'x.guo82', 'nanpanshi2', 'changyuling1989', None]"
81,185,8,92,7,"['hzhou30', 'zhan.shi.106', 'liuyuting1006', 'julia.zuo', 'elindgr2', 'hsp6634', 'ndunlap2']",0,[],85,"['cnlopes12', 'sali12', 'knipfer2', 'buhl2', 'ecyoung', 'asimha2', 'dlitt2', 'reisber2', 'szhang87', 'eswu2', 'ahjames2', 'brendaneng1', 'ewe2', 'pakelti2', 'ed.tir.1', 'jefrin', 'hhardin2', 'shoppe3', 'brgschn2', 'alvinlvalysa', 'jbeta95', 'jaikarnik95', 'tianshu2', 'shamaleeg1', 'sdhanak1', 'junehan1', 'werkkdy2', 'jxiong7', 'whu14', 'mpunuk', 'mingye.gao', 'hwang281', 'zhoffm', 'jedrals2', 'mantianxue0101', 'dkuai2', 'warpins2', 'samsrajer', 'qinglin2', 'jdray2', 'avelard2', 'shoughton625', 'fpkelly2', 'dsch33', 'lachwsk2', 'melissagoetter', 'a_kuzni2', 'dpfoste2', 'sdschmi2', 'dshi10', 'vasyltheonly', 'aln', 'mchu5', 'zhensun5', 'mcheng94', '17staru', 'edeutsch90', 'ywada3', 'zwu27', 'ramansbach', 'laurentaylor', 'mlandi6', 'cwojtan', 'statar2', 'slbecke2', 'sloneil21994', 'amango4', 'yifanyao', 'echo93924', 'dli29', 'emfoley14', 'chunxu2', None, 'billli1996', 'antony.huang.129', 'ntxuby', 'joylin0806', 'mbmoy2', 'lin.joanna.y', 'ruining2', 'sikaufm2', 'jkim561', 'kagebei2', 'nlee17', 'rmaass']",92,"['cnlopes12', 'sali12', 'knipfer2', 'buhl2', 'ecyoung', 'asimha2', 'dlitt2', 'reisber2', 'szhang87', 'eswu2', 'ahjames2', 'julia.zuo', 'brendaneng1', 'ewe2', 'pakelti2', 'ed.tir.1', 'jefrin', 'hhardin2', 'shoppe3', 'brgschn2', 'alvinlvalysa', 'jbeta95', 'jaikarnik95', 'hzhou30', 'tianshu2', 'shamaleeg1', 'sdhanak1', 'junehan1', 'werkkdy2', 'jxiong7', 'whu14', 'mpunuk', 'mingye.gao', 'hwang281', 'elindgr2', 'zhoffm', 'jedrals2', 'mantianxue0101', 'dkuai2', 'warpins2', 'samsrajer', 'qinglin2', 'jdray2', 'avelard2', 'shoughton625', 'fpkelly2', 'ndunlap2', 'dsch33', 'lachwsk2', 'melissagoetter', 'a_kuzni2', 'dpfoste2', 'sdschmi2', 'liuyuting1006', 'dshi10', 'vasyltheonly', 'aln', 'mchu5', 'hsp6634', 'zhensun5', 'mcheng94', '17staru', 'edeutsch90', 'ywada3', 'zwu27', 'ramansbach', 'laurentaylor', 'mlandi6', 'cwojtan', 'statar2', 'slbecke2', 'sloneil21994', 'amango4', 'yifanyao', 'echo93924', 'dli29', 'emfoley14', 'chunxu2', None, 'zhan.shi.106', 'billli1996', 'antony.huang.129', 'ntxuby', 'joylin0806', 'mbmoy2', 'lin.joanna.y', 'ruining2', 'sikaufm2', 'jkim561', 'kagebei2', 'nlee17', 'rmaass']"
82,218,8,19,1,['patyessam'],6,"['eadachi', 'sjlucey', 'kevin4fet', 'steve0022', 'markohol93prozent', 'spalmer5521']",18,"['mohsenraafat', 'mazenahmed09', 'serag', 'johnjoeee524', 'ahmedhatemelkady', 'elmohnds.terika', 'monaahmed', 'hazem1', 'ahmed_refaat', 'a.hesham', 'rananader', 'sherif__hosny', 'esraa', 'nourhan', 'marinamedhat', 'raniaosama2015', 'ayamohamed12030', None]",25,"['mohsenraafat', 'mazenahmed09', 'sjlucey', 'serag', 'johnjoeee524', 'ahmedhatemelkady', 'monaahmed', 'kevin4fet', 'rananader', 'steve0022', 'marinamedhat', 'esraa', 'markohol93prozent', 'nourhan', 'raniaosama2015', 'patyessam', None, 'spalmer5521', 'eadachi', 'elmohnds.terika', 'hazem1', 'ahmed_refaat', 'a.hesham', 'sherif__hosny', 'ayamohamed12030']"
82,152,8,16,4,"['steve0022', 'eadachi', 'sjlucey', 'spalmer5521']",3,"['patyessam', 'markohol93prozent', 'kevin4fet']",12,"['aksamija', 'jmgallant', 'moo', 'jkestyn', 'sandlee', 'rcocomello', 'bmarszalkows', 'bgalaske', 'sauwerda', 'ekcole', 'mamohamed', None]",19,"['aksamija', 'sjlucey', 'moo', 'rcocomello', 'kevin4fet', 'bgalaske', 'sauwerda', 'steve0022', 'markohol93prozent', 'ekcole', 'patyessam', 'jmgallant', 'spalmer5521', None, 'eadachi', 'jkestyn', 'sandlee', 'bmarszalkows', 'mamohamed']"
82,217,8,7,1,['patyessam'],6,"['eadachi', 'sjlucey', 'kevin4fet', 'steve0022', 'markohol93prozent', 'spalmer5521']",6,"['hazem1', 'kareemchicharito14', 'marinamedhat', 'ayamohamed12030', 'raniaosama2015', None]",13,"['eadachi', 'sjlucey', 'hazem1', 'kareemchicharito14', 'kevin4fet', 'steve0022', 'marinamedhat', 'markohol93prozent', 'ayamohamed12030', 'raniaosama2015', 'patyessam', None, 'spalmer5521']"
83,51,8,42,2,"['tjaggernauth305', 'jagarth']",5,"['jrdath', 'rajtheking01', 'marbaniangjosh123', 'dweinstein0', 'kreg001']",40,"['jtdath', 'jsinibaldi', 'tuhlich', 'nickjcu', 'sidneygolliher', 'antonygillette', 'gaboth22', 'jtraub91', 'klborowski', 'zobeldavid', 'david4101', 'jbocinsky', 'coreyrn8', 'jagnese', 'kstultz15', 'vsoliz', 'mronda', 'kristianlegcevic', 'jacksonecarroll', 'sten621', 'charlelotfalla', 'andrew_lemx', 'fengshui', 'docta', 'abkrepacki', 'slapeyre1993', 'adrianj95', 'guybrush', 'bbanksg7', 'uchaudhry', 'bkelly2014', None, 'mikesanchezuf', 'cmann0917', 'michael.correia', 'wanrunlai', 'astainsby', 'guoj', 'ianmcodom', 'adrianj25']",47,"['jtdath', 'jsinibaldi', 'tuhlich', 'nickjcu', 'sidneygolliher', 'antonygillette', 'gaboth22', 'dweinstein0', 'jtraub91', 'klborowski', 'zobeldavid', 'david4101', 'jbocinsky', 'coreyrn8', 'jagnese', 'marbaniangjosh123', 'kstultz15', 'vsoliz', 'mronda', 'kristianlegcevic', 'jacksonecarroll', 'sten621', 'charlelotfalla', 'andrew_lemx', 'fengshui', 'docta', 'jrdath', 'abkrepacki', 'slapeyre1993', 'adrianj95', 'guybrush', 'bbanksg7', 'uchaudhry', 'bkelly2014', None, 'kreg001', 'jagarth', 'mikesanchezuf', 'cmann0917', 'rajtheking01', 'michael.correia', 'wanrunlai', 'astainsby', 'guoj', 'ianmcodom', 'tjaggernauth305', 'adrianj25']"
83,53,8,10,1,['marbaniangjosh123'],6,"['jrdath', 'rajtheking01', 'kreg001', 'dweinstein0', 'tjaggernauth305', 'jagarth']",9,"['sasiponnam', 'ranibarkha', 'kabhishek744', 'surensurendar7', 'muralisudha', 'sreemoyee07', 'santhoshravi', 'srsitaaramanmtech', None]",16,"['jrdath', 'kabhishek744', 'santhoshravi', 'dweinstein0', 'srsitaaramanmtech', None, 'kreg001', 'jagarth', 'rajtheking01', 'marbaniangjosh123', 'sasiponnam', 'ranibarkha', 'surensurendar7', 'muralisudha', 'sreemoyee07', 'tjaggernauth305']"
84,112,8,30,4,"['walt', 'kdhau2', 'ydong14', 'ahassan4']",3,"['saeedg', 'metler2', 'mckeown3']",26,"['cho135', 'yap6', 'thephiltsai', 'bmin5', 'brendaneng1', 'rocilez2', 'basa2', 'choquett', 'han109', 'ssharm16', 'galbrea2', 'bjarach2', 'alburuni', 'xkok2', 'acastag2', 'johnsimo95', 'tcoyle2', 'goelakshay2', 'ashlesha08', None, 'firpo2', 'samsrajer', 'kennethhau', 'barshad2', 'knguye32', 'agbaje2']",33,"['cho135', 'yap6', 'thephiltsai', 'bmin5', 'brendaneng1', 'rocilez2', 'basa2', 'ahassan4', 'choquett', 'han109', 'walt', 'ssharm16', 'galbrea2', 'mckeown3', 'bjarach2', 'metler2', 'saeedg', 'alburuni', 'xkok2', 'acastag2', 'kdhau2', 'johnsimo95', 'tcoyle2', 'goelakshay2', 'ashlesha08', None, 'firpo2', 'samsrajer', 'kennethhau', 'barshad2', 'knguye32', 'ydong14', 'agbaje2']"
85,221,7,43,5,"['jagnese', 'adrianj95', 'alexdukes17', 'charlelotfalla', 'klborowski']",1,['guoj'],38,"['jtdath', 'jsinibaldi', 'tuhlich', 'nickjcu', 'sidneygolliher', 'antonygillette', 'gaboth22', 'jtraub91', 'sammymhowe', 'zobeldavid', 'david4101', 'jbocinsky', 'coreyrn8', 'kstultz15', 'vsoliz', 'mronda', 'kristianlegcevic', 'jacksonecarroll', 'msciullo2010', 'sten621', 'abarbeite', 'andrew_lemx', 'fengshui', 'joshuaagarth', 'docta', 'abkrepacki', 'slapeyre1993', 'guybrush', 'bbanksg7', 'uchaudhry', 'bkelly2014', None, 'mikesanchezuf', 'cmann0917', 'michael.correia', 'astainsby', 'timothyjaggernauth305', 'ianmcodom']",44,"['jtdath', 'jsinibaldi', 'tuhlich', 'nickjcu', 'sidneygolliher', 'antonygillette', 'gaboth22', 'jtraub91', 'klborowski', 'sammymhowe', 'zobeldavid', 'david4101', 'jbocinsky', 'coreyrn8', 'jagnese', 'kstultz15', 'vsoliz', 'mronda', 'kristianlegcevic', 'jacksonecarroll', 'msciullo2010', 'sten621', 'charlelotfalla', 'abarbeite', 'andrew_lemx', 'fengshui', 'joshuaagarth', 'docta', 'abkrepacki', 'slapeyre1993', 'adrianj95', 'guybrush', 'alexdukes17', 'bbanksg7', 'uchaudhry', 'bkelly2014', None, 'mikesanchezuf', 'cmann0917', 'michael.correia', 'astainsby', 'guoj', 'timothyjaggernauth305', 'ianmcodom']"
85,51,7,42,5,"['jagnese', 'adrianj95', 'guoj', 'charlelotfalla', 'klborowski']",1,['alexdukes17'],37,"['jtdath', 'jsinibaldi', 'tuhlich', 'nickjcu', 'sidneygolliher', 'antonygillette', 'gaboth22', 'jtraub91', 'zobeldavid', 'david4101', 'jbocinsky', 'coreyrn8', 'kstultz15', 'vsoliz', 'mronda', 'kristianlegcevic', 'jacksonecarroll', 'sten621', 'andrew_lemx', 'fengshui', 'docta', 'abkrepacki', 'slapeyre1993', 'guybrush', 'bbanksg7', 'uchaudhry', 'bkelly2014', None, 'jagarth', 'mikesanchezuf', 'cmann0917', 'michael.correia', 'wanrunlai', 'astainsby', 'ianmcodom', 'tjaggernauth305', 'adrianj25']",43,"['jtdath', 'jsinibaldi', 'tuhlich', 'nickjcu', 'sidneygolliher', 'antonygillette', 'gaboth22', 'jtraub91', 'klborowski', 'zobeldavid', 'david4101', 'jbocinsky', 'coreyrn8', 'jagnese', 'kstultz15', 'vsoliz', 'mronda', 'kristianlegcevic', 'jacksonecarroll', 'sten621', 'charlelotfalla', 'andrew_lemx', 'fengshui', 'docta', 'abkrepacki', 'slapeyre1993', 'adrianj95', 'guybrush', 'alexdukes17', 'bbanksg7', 'uchaudhry', 'bkelly2014', None, 'jagarth', 'mikesanchezuf', 'cmann0917', 'michael.correia', 'wanrunlai', 'astainsby', 'guoj', 'ianmcodom', 'tjaggernauth305', 'adrianj25']"
86,42,7,69,6,"['akshaykatkar', 'neetika.k10', 'sahilkolwankar', 'tanmaykadam', 'varsha.jagadale188.vj', 'ashishjamdade72']",0,[],63,"['vivianmascarenhas1994', 'nimita.singh', 'greatabhi.jathar', 'aakash3194', 'swapnalimakdey25', 'linusassao974', 'mannapatil', 'prathuhatode', 'kanchan.phadtare', 'kedarthale', 'chiragpooniwala', 'shamika', 'tejomayi.wandhile', 'mehta.krish', 'rohan.ranshinge', 'karthik.radhakrishna022', 'mrhbtiwari', 'priyanka.kulkarni', 'kapsesainath', 'giridharsh1', 'fruitywithmonty', 'pranali.kokate9', 'payalsaldur', 'ajit.gaikwad325', 'vishalvb04', 'mohit951995', 'nachi.2605', 'sharan.raikhangar', 'dj.dharmik', 'abha08', 'adithyamohan', 'mewadayash', 'jitusawant10', 'mananmehta95', 'shashwatssanghavi', 'pbandewar', 'ankushlagad4', 'krusha14', 's.aditya.ghadiali', 'sanika.pandharkar', 'gurnani.nikita999', 'amol.dhanvij10', 'sagar.mujpara99', 'pritidhandrut25', 'shraddha0306', 'mandavkarnidhi', 'a.b.surgade', 'mvedant29', 'rupali.patil', 'sushmakodagali', 'abhay.kshirsagar', 'sunilkavatkar', None, 'rohanbandal93', 'ramjighatala7', 'pushkarvaity', 'sonali2', 'ghaisas.atharv', 'jidvaze', 'shruti.ganjoo97', 'inderjitsingh87', 'juvika1994', 'ssatam23dps']",69,"['vivianmascarenhas1994', 'nimita.singh', 'greatabhi.jathar', 'aakash3194', 'swapnalimakdey25', 'linusassao974', 'mannapatil', 'prathuhatode', 'kanchan.phadtare', 'kedarthale', 'chiragpooniwala', 'shamika', 'varsha.jagadale188.vj', 'tejomayi.wandhile', 'mehta.krish', 'rohan.ranshinge', 'karthik.radhakrishna022', 'mrhbtiwari', 'priyanka.kulkarni', 'kapsesainath', 'tanmaykadam', 'giridharsh1', 'fruitywithmonty', 'pranali.kokate9', 'payalsaldur', 'ajit.gaikwad325', 'neetika.k10', 'vishalvb04', 'mohit951995', 'nachi.2605', 'sharan.raikhangar', 'dj.dharmik', 'akshaykatkar', 'abha08', 'adithyamohan', 'mewadayash', 'jitusawant10', 'mananmehta95', 'shashwatssanghavi', 'sahilkolwankar', 'pbandewar', 'ankushlagad4', 'krusha14', 's.aditya.ghadiali', 'sanika.pandharkar', 'gurnani.nikita999', 'amol.dhanvij10', 'sagar.mujpara99', 'pritidhandrut25', 'shraddha0306', 'mandavkarnidhi', 'a.b.surgade', 'mvedant29', 'rupali.patil', 'sushmakodagali', 'abhay.kshirsagar', 'sunilkavatkar', None, 'rohanbandal93', 'ramjighatala7', 'pushkarvaity', 'sonali2', 'ghaisas.atharv', 'ashishjamdade72', 'jidvaze', 'shruti.ganjoo97', 'inderjitsingh87', 'juvika1994', 'ssatam23dps']"
86,170,7,30,6,"['akshaykatkar', 'neetika.k10', 'sahilkolwankar', 'tanmaykadam', 'varsha.jagadale188.vj', 'ashishjamdade72']",0,[],24,"['a.b.surgade', 'vedarthsave80', 'kurhekar_abha', 'borse84kiran', 'sagarpaarcha', 'swapnalimakdey25', 'sangeetamjoshi', 'surajmore009', 'nilesh15394', 'aljo.joy22', 'payalsaldur', None, 'prathuhatode', 'gohel.mitesh91', 'ajit.gaikwad325', 'shamika', 'reema.karmokar17', 'vishalvb04', 'ghaisas.atharv', 'mohit951995', 'jidvaze', 'sayaliw212', 'arunsamuel2002', 'shraddha0306']",30,"['akshaykatkar', 'vedarthsave80', 'sagarpaarcha', 'swapnalimakdey25', 'prathuhatode', 'gohel.mitesh91', 'sahilkolwankar', 'shamika', 'varsha.jagadale188.vj', 'reema.karmokar17', 'sayaliw212', 'a.b.surgade', 'kurhekar_abha', 'borse84kiran', 'tanmaykadam', 'sangeetamjoshi', 'surajmore009', 'nilesh15394', 'aljo.joy22', 'payalsaldur', None, 'ajit.gaikwad325', 'neetika.k10', 'vishalvb04', 'ghaisas.atharv', 'ashishjamdade72', 'mohit951995', 'jidvaze', 'arunsamuel2002', 'shraddha0306']"
86,175,7,13,6,"['akshaykatkar', 'neetika.k10', 'sahilkolwankar', 'tanmaykadam', 'varsha.jagadale188.vj', 'ashishjamdade72']",0,[],7,"['ajit.gaikwad325', 'mohit951995', 'aljo.joy22', 'prathuhatode', 'payalsaldur', None, 'shraddha0306']",13,"['akshaykatkar', 'tanmaykadam', 'aljo.joy22', 'payalsaldur', None, 'prathuhatode', 'ajit.gaikwad325', 'neetika.k10', 'sahilkolwankar', 'varsha.jagadale188.vj', 'ashishjamdade72', 'mohit951995', 'shraddha0306']"
87,114,7,8,6,"['amit.banda', 'gaitondeakshay', 'anumolsasi69', 'paragbhandarkar', 'ghatulnikhil118', 'lokeshk93']",0,[],2,"[None, 'jagrutinagaonkar']",8,"['amit.banda', 'gaitondeakshay', 'jagrutinagaonkar', 'anumolsasi69', 'paragbhandarkar', 'ghatulnikhil118', 'lokeshk93', None]"
88,30,7,12,5,"['smatheos', 'ejsanch2', 'adevonpo', 'sdbrock', 'ajvillan']",1,['khyland1031'],7,"['hibbenjordan', 'cwilp', 'ferry', 'ghaywood', 'jacarde4', 'thomas901', None]",13,"['hibbenjordan', 'ferry', 'cwilp', 'ghaywood', 'sdbrock', 'khyland1031', None, 'smatheos', 'ejsanch2', 'adevonpo', 'jacarde4', 'ajvillan', 'thomas901']"
88,65,7,10,4,"['adevonpo', 'ajvillan', 'ejsanch2', 'sdbrock']",2,"['smatheos', 'khyland1031']",6,"['hibbenjordan', 'cwilp', 'ghaywood', 'jacarde4', 'thomas901', None]",12,"['hibbenjordan', 'cwilp', 'ghaywood', 'sdbrock', 'khyland1031', None, 'smatheos', 'ejsanch2', 'adevonpo', 'jacarde4', 'ajvillan', 'thomas901']"
88,31,7,9,1,['khyland1031'],5,"['smatheos', 'ejsanch2', 'adevonpo', 'sdbrock', 'ajvillan']",8,"['tfis112', 'cmwoods717', 'yaying.atlantis', 'yuhiaikyo', 'naivednmy', 'aditi.dighe20', 'teslacheng', None]",14,"['teslacheng', 'smatheos', 'tfis112', 'ejsanch2', 'cmwoods717', 'yaying.atlantis', 'yuhiaikyo', 'adevonpo', 'khyland1031', 'naivednmy', 'aditi.dighe20', 'sdbrock', 'ajvillan', None]"
88,32,7,9,1,['khyland1031'],5,"['smatheos', 'ejsanch2', 'adevonpo', 'sdbrock', 'ajvillan']",8,"['yaying.atlantis', 'cmwoods717', 'yuhiaikyo', 'naivednmy', 'aditi.dighe20', 'kaeso', 'teslacheng', None]",14,"['teslacheng', 'smatheos', 'cmwoods717', 'ejsanch2', 'yaying.atlantis', 'yuhiaikyo', 'adevonpo', 'khyland1031', 'naivednmy', 'aditi.dighe20', 'kaeso', 'sdbrock', 'ajvillan', None]"
89,241,7,20,5,"['jamil.elhelou', 'abdulaziz.almarzouqi', 'andrewmorkos', 'anas.salem', 'abdulrahman.alzahid']",1,['sara.muwahid'],15,"['yogesh.manglani', 'wafic.chehab', 'raed.k92', 'anubro', 'ccostario', 'israsaeed', 'nour', 'karim.mankarious', 'antoni.karam', 'pangraci', 'doxo14', None, 'nooranasser', 'nikita.shatravka', 'canis2012']",21,"['wafic.chehab', 'jamil.elhelou', 'abdulaziz.almarzouqi', 'nour', 'antoni.karam', 'pangraci', 'ccostario', 'anubro', None, 'nikita.shatravka', 'yogesh.manglani', 'raed.k92', 'andrewmorkos', 'anas.salem', 'israsaeed', 'sara.muwahid', 'karim.mankarious', 'abdulrahman.alzahid', 'doxo14', 'nooranasser', 'canis2012']"
89,206,7,17,5,"['abdulaziz.almarzouqi', 'andrewmorkos', 'anas.salem', 'sara.muwahid', 'abdulrahman.alzahid']",1,['jamil.elhelou'],12,"['wafic.chehab', 'pangraci', 'ccostario', 'israsaeed', 'nour', 'karim.mankarious', 'antoni.karam', 'anubro', None, 'nooranasser', 'nikita.shatravka', 'canis2012']",18,"['wafic.chehab', 'jamil.elhelou', 'abdulaziz.almarzouqi', 'nour', 'antoni.karam', 'ccostario', 'anubro', 'pangraci', None, 'nikita.shatravka', 'andrewmorkos', 'anas.salem', 'israsaeed', 'sara.muwahid', 'karim.mankarious', 'abdulrahman.alzahid', 'nooranasser', 'canis2012']"
92,235,7,23,4,"['tampubo2', 'rnconra2', 'hiddename39', 'belkhad1']",2,"['danek2', 'beholla2']",19,"['fhismail', 'andersonpaac', 'dlitt2', 'garyliu2', 'foreverlea', 'mliu41', 'khou2', 'duncanzhang1', 'kinney2', 'eguzman6', None, 'dyrock', 'vashist1', 'akgoyal2', 'hbhatia2', 'kfeng', 'meroy', 'pengjiang4', 'jhzayed2']",25,"['fhismail', 'duncanzhang1', 'andersonpaac', 'dlitt2', 'garyliu2', 'kinney2', 'foreverlea', 'belkhad1', 'hiddename39', 'eguzman6', None, 'jhzayed2', 'mliu41', 'dyrock', 'rnconra2', 'vashist1', 'akgoyal2', 'hbhatia2', 'kfeng', 'meroy', 'pengjiang4', 'beholla2', 'tampubo2', 'danek2', 'khou2']"
93,68,7,23,4,"['sunnova', 'cbechberger123', 'alaepormaria', 'stuartjmurray']",2,"['abmenhaj', 'snu404']",19,"['alymitha', 'tse.jwt', 'kissan.mistry', 'jeremyv25', 'nsnano', 'jeonghun0727', 'rahulp28', 'spacejockey8', 'kavish.kaup', 'chart496', 'wnbcui', None, 'henhaocang', 'b.dang93', 'jakerochman93', 'b2workma', 'pasgores16', 'ngel1914', 'j294lee']",25,"['stuartjmurray', 'alymitha', 'kavish.kaup', 'chart496', 'wnbcui', 'cbechberger123', 'tse.jwt', 'ngel1914', 'kissan.mistry', 'alaepormaria', 'jeremyv25', 'nsnano', 'abmenhaj', None, 'henhaocang', 'sunnova', 'b.dang93', 'snu404', 'jakerochman93', 'b2workma', 'pasgores16', 'jeonghun0727', 'j294lee', 'rahulp28', 'spacejockey8']"
100,173,6,16,5,"['abeckle', 'mviers', 'beggs', 'teeads', 'mcapestr']",0,[],11,"['hobson7', 'nmacke', 'jtrouba', 'brendenh88', 'ning2', 'elizabethrtopi', 'pan112', 'an49', 'ouyang6', None, 'yang837']",16,"['abeckle', 'mviers', 'nmacke', 'ning2', 'brendenh88', 'elizabethrtopi', 'pan112', 'ouyang6', 'beggs', None, 'teeads', 'hobson7', 'jtrouba', 'an49', 'mcapestr', 'yang837']"
101,88,6,22,3,"['dutrow2', 'yulunwu3', 'mnxmq125']",2,"['icecyl', 'mantrarushh']",19,"['kherzig', 'dlitt2', 'garyliu2', 'dkong6', 'foreverlea', 'mliu41', 'khou2', 'duncanzhang1', 'kinney2', 'eguzman6', None, 'dyrock', 'vashist1', 'akgoyal2', 'mnxmq125guo', 'hbhatia2', 'kfeng', 'meroy', 'pengjiang4']",24,"['duncanzhang1', 'kherzig', 'yulunwu3', 'dlitt2', 'garyliu2', 'kinney2', 'dkong6', 'dutrow2', 'foreverlea', 'eguzman6', None, 'dyrock', 'icecyl', 'mnxmq125', 'vashist1', 'akgoyal2', 'mnxmq125guo', 'hbhatia2', 'kfeng', 'meroy', 'pengjiang4', 'mliu41', 'mantrarushh', 'khou2']"
105,263,6,24,1,['nawalgao'],4,"['jubinhazra.iem', 'linds360', 'zhaoermosi', 'ee12d203']",23,"['cguarini', 'mbj117', 'mike409', 'sdhaka', 'zeadnws', 'nathan.l.gibson', 'weifufang', 'carla.estridge', 'kgarrity', None, 'samuel.j.tucker', 'pastabasta8', 'dienstfrey', 'jeffrey.sanders', 'markbenedict', 'khuston', 'kiettipong1', 'tkprasad2006', 'adamatandia', 'roz36088', 'mathewni', 'ceduardo', 'ukamran']",28,"['cguarini', 'mbj117', 'mike409', 'sdhaka', 'zeadnws', 'nathan.l.gibson', 'weifufang', 'carla.estridge', 'zhaoermosi', 'kgarrity', None, 'linds360', 'samuel.j.tucker', 'pastabasta8', 'ee12d203', 'dienstfrey', 'jeffrey.sanders', 'markbenedict', 'jubinhazra.iem', 'khuston', 'kiettipong1', 'tkprasad2006', 'adamatandia', 'roz36088', 'mathewni', 'ceduardo', 'nawalgao', 'ukamran']"
108,231,6,7,1,['idoflymark'],4,"['k788170', 'liang1034', 'xcduan', 'minsoo429']",6,"['johnny.wen.182', 'jack.622', 'tsaimingli', 'honey011745', 'leoplct', None]",11,"['johnny.wen.182', 'liang1034', 'jack.622', 'minsoo429', 'xcduan', 'idoflymark', 'tsaimingli', 'honey011745', 'k788170', 'leoplct', None]"
108,232,6,6,1,['idoflymark'],4,"['k788170', 'liang1034', 'xcduan', 'minsoo429']",5,"['johnny.wen.182', 'tsaimingli', 'honey011745', 'leoplct', None]",10,"['johnny.wen.182', 'liang1034', 'minsoo429', 'xcduan', 'idoflymark', 'tsaimingli', 'honey011745', 'k788170', 'leoplct', None]"
109,241,6,20,5,"['wafic.chehab', 'israsaeed', 'karim.mankarious', 'nikita.shatravka', 'canis2012']",0,[],15,"['yogesh.manglani', 'jamil.elhelou', 'abdulaziz.almarzouqi', 'raed.k92', 'andrewmorkos', 'anubro', 'anas.salem', 'ccostario', 'nour', 'antoni.karam', 'abdulrahman.alzahid', 'pangraci', 'doxo14', None, 'nooranasser']",20,"['wafic.chehab', 'jamil.elhelou', 'abdulaziz.almarzouqi', 'nour', 'antoni.karam', 'pangraci', 'ccostario', 'anubro', None, 'nikita.shatravka', 'yogesh.manglani', 'raed.k92', 'andrewmorkos', 'anas.salem', 'israsaeed', 'karim.mankarious', 'abdulrahman.alzahid', 'doxo14', 'nooranasser', 'canis2012']"
109,206,6,17,5,"['wafic.chehab', 'israsaeed', 'karim.mankarious', 'nikita.shatravka', 'canis2012']",0,[],12,"['abdulaziz.almarzouqi', 'pangraci', 'andrewmorkos', 'anas.salem', 'ccostario', 'sara.muwahid', 'nour', 'antoni.karam', 'abdulrahman.alzahid', 'anubro', None, 'nooranasser']",17,"['wafic.chehab', 'abdulaziz.almarzouqi', 'nour', 'antoni.karam', 'ccostario', 'anubro', 'pangraci', None, 'nikita.shatravka', 'andrewmorkos', 'anas.salem', 'israsaeed', 'sara.muwahid', 'karim.mankarious', 'abdulrahman.alzahid', 'nooranasser', 'canis2012']"
109,160,6,6,5,"['wafic.chehab', 'israsaeed', 'karim.mankarious', 'nikita.shatravka', 'canis2012']",0,[],1,[None],6,"['wafic.chehab', 'israsaeed', 'karim.mankarious', None, 'nikita.shatravka', 'canis2012']"
110,2,6,127,5,"['aartipatel', 'pavan51', 'narapa', 'meen83', 'shobhavaddineni']",0,[],122,"['dpl', 'ravikiran19', 'loveena1902', 'manojtalluri.93', 'perumallakavya', 'trinath90', 'dharanidar123', 'vanimerugu', 'anish69052', 'ramisetty12', 'mekalamanishyadav', 'p.rathod', 'manojbukka', 'kszumowski', 'maheshedururi', 'sandychinna90', 'saisatwickyadav', 'shilpa1992', 'swetang22', 'nawaz316', 'nicoramirez', 'shreeyash', 'sandeepx99', 'swetang1992', 'manalipatel', 'jayakrishna440', 'mit1993', 'sunil2308', 'mturi', 'ya9mehta', 'jpangan', 'haritha93', 'sanjaymenaria', 'sachitanandraj', 'georgeayoub11', 'pavan.malay', 'mallesh2890', 'satish6688', 'tejasri13293', '802769935jj', 'namratha.siddappa', 'satyen1401', 'kajal', 'kishan7172', 'christxran', 'furquan', 'mohammed18', 'parikhchirag29', 'chandusravanthi', 'saladi0293', 'kavya.dhanala', 'nagasai', 'mvenu2', 'rahulenukonda525', 'nishat1801', 'rakeshyadav', 'kancharla0113', 'kushalvasoya558', 'eedupuganti07', 'rzaragoza91', 'suneel8055', 'dipali.shatavara', 'anoopreddy1993', 'reetu0610', 'sathiriv', 'himali_dhaduk2493', 'james54', 'sha6070sha', 'ritvik03', 'teja999', 'aru1204', 'dhanala.kavya123', 'anveshkankanala', 'parita11', 'kavyadhanala567', 'santhoshnn134', 'priyankareddy', 'veeru', 'harshpathak', 'kunda93', 'marneni01', 'harshavardhanvarmavegesna', 'muralisaiavinash', 'jzherrera', 'pritipatel59', 'venkateah', 'akshaya1512', 'santhosh.y', 'makwanasameer007', 'mani477', 'slim.severnick', 'patel.akash102', 'poojatrivedi', 'trodas1287', 'hem.metalia', 'jrriddley1355', 'binayb175', 'rathodpriyank', 'poyani_mehta', 'rawadhilal', 'dhruvil', 'deepakengineer', 'purna24', 'kashyap09ec71', 'dipal.ptl', None, 'pallugullu', 'nikhilshinde', 'pallavi90', 'kruthiperumalla', 'muralikrishna41', 'bansari21', 'deeppatel092', 'nvnreddy418', 'kevinharish40', 'fardad.falahati', 'nikhila_banda', 'yaminikrishna', 'anoopreddy1992', 'chinthalapally13', 'teju2710', 'kavyathokala']",127,"['ravikiran19', 'ramisetty12', 'mekalamanishyadav', 'p.rathod', 'manojbukka', 'saisatwickyadav', 'shilpa1992', 'swetang22', 'nicoramirez', 'shreeyash', 'sandeepx99', 'jayakrishna440', 'mit1993', 'sunil2308', 'mturi', 'sanjaymenaria', 'pavan.malay', 'namratha.siddappa', 'kajal', 'narapa', 'kishan7172', 'christxran', 'parikhchirag29', 'shobhavaddineni', 'chandusravanthi', 'saladi0293', 'nagasai', 'mvenu2', 'anoopreddy1993', 'pavan51', 'sathiriv', 'himali_dhaduk2493', 'aru1204', 'santhoshnn134', 'muralisaiavinash', 'jzherrera', 'santhosh.y', 'makwanasameer007', 'mani477', 'meen83', 'patel.akash102', 'jrriddley1355', 'rathodpriyank', 'poyani_mehta', 'dhruvil', 'deepakengineer', 'kashyap09ec71', 'pallugullu', 'nikhilshinde', 'kruthiperumalla', 'muralikrishna41', 'kevinharish40', 'fardad.falahati', 'yaminikrishna', 'anoopreddy1992', 'teju2710', 'dpl', 'loveena1902', 'manojtalluri.93', 'perumallakavya', 'trinath90', 'dharanidar123', 'vanimerugu', 'anish69052', 'kszumowski', 'maheshedururi', 'sandychinna90', 'nawaz316', 'aartipatel', 'swetang1992', 'manalipatel', 'ya9mehta', 'jpangan', 'haritha93', 'sachitanandraj', 'georgeayoub11', 'mallesh2890', 'satish6688', 'tejasri13293', '802769935jj', 'satyen1401', 'furquan', 'mohammed18', 'kavya.dhanala', 'rahulenukonda525', 'nishat1801', 'rakeshyadav', 'kancharla0113', 'kushalvasoya558', 'eedupuganti07', 'rzaragoza91', 'suneel8055', 'dipali.shatavara', 'reetu0610', 'james54', 'sha6070sha', 'ritvik03', 'teja999', 'dhanala.kavya123', 'anveshkankanala', 'parita11', 'kavyadhanala567', 'priyankareddy', 'veeru', 'harshpathak', 'kunda93', 'harshavardhanvarmavegesna', 'pritipatel59', 'venkateah', 'akshaya1512', 'slim.severnick', 'poojatrivedi', 'trodas1287', 'hem.metalia', 'binayb175', 'rawadhilal', 'purna24', 'dipal.ptl', None, 'pallavi90', 'bansari21', 'deeppatel092', 'nvnreddy418', 'nikhila_banda', 'marneni01', 'chinthalapally13', 'kavyathokala']"
110,3,6,113,4,"['meen83', 'aartipatel', 'narapa', 'shobhavaddineni']",1,['pavan51'],109,"['perumallakavya', 'ravikiran19', 'loveena1902', 'manojtalluri.93', 'trinath90', 'dharanidar123', 'vanimerugu', 'p.rathod', 'kszumowski', 'manojbukka', 'maheshedururi', 'nawaz316', 'saisatwickyadav', 'shilpa1992', 'swetang22', 'nicoramirez', 'shreeyash', 'sandeepx99', 'swetang1992', 'manalipatel', 'jayakrishna440', 'mit1993', 'sunil2308', 'mturi', 'ya9mehta', 'jpangan', 'haritha93', 'sanjaymenaria', 'sachitanandraj', 'georgeayoub11', 'pavan.malay', 'mallesh2890', 'satish6688', 'pallavivenkatesh', '802769935jj', 'namratha.siddappa', 'kajal', 'kishan7172', 'christxran', 'deepu.patel092', 'furquan', 'parikhchirag29', 'anoop1992', 'saladi0293', 'kavya.dhanala', 'nagasai', 'mvenu2', 'rahulenukonda525', 'nishat1801', 'rakeshyadav', 'kancharla0113', 'kushalvasoya558', 'eedupuganti07', 'rzaragoza91', 'dipali.shatavara', 'reetu0610', 'sathiriv', 'himali_dhaduk2493', 'james54', 'sha6070sha', 'ritvik03', 'teja999', 'pritipatel', 'anveshkankanala', 'santhoshnn134', 'priyankareddy', 'veeru', 'kunda93', 'mpangan1128', 'harshavardhanvarmavegesna', 'muralisaiavinash', 'jzherrera', 'pritipatel59', 'venkateah', 'akshaya1512', 'makwanasameer007', 'mani477', 'patel.akash102', 'poojatrivedi', 'trodas1287', 'hem.metalia', 'jrriddley1355', 'binayb175', 'rathodpriyank', 'poyani_mehta', 'rawadhilal', 'dhruvil', 'poyanimehta92', 'deepakengineer', 'purna24', 'kashyap09ec71', 'shreeyash6', None, 'pallugullu', 'nikhilshinde', 'pallavi90', 'kruthiperumalla', 'bansari21', 'deeppatel092', 'nvnreddy418', 'thedmutz24', 'kevinharish40', 'fardad.falahati', 'nikhila_banda', 'yaminikrishna', 'marneni01', 'chinthalapally13', 'teju2710', 'kavyathokala']",114,"['perumallakavya', 'ravikiran19', 'loveena1902', 'manojtalluri.93', 'trinath90', 'dharanidar123', 'vanimerugu', 'p.rathod', 'kszumowski', 'manojbukka', 'maheshedururi', 'nawaz316', 'saisatwickyadav', 'aartipatel', 'shilpa1992', 'swetang22', 'nicoramirez', 'shreeyash', 'sandeepx99', 'swetang1992', 'manalipatel', 'jayakrishna440', 'mit1993', 'sunil2308', 'mturi', 'ya9mehta', 'jpangan', 'haritha93', 'sanjaymenaria', 'sachitanandraj', 'georgeayoub11', 'pavan.malay', 'mallesh2890', 'satish6688', 'pallavivenkatesh', '802769935jj', 'namratha.siddappa', 'kajal', 'narapa', 'kishan7172', 'christxran', 'deepu.patel092', 'furquan', 'parikhchirag29', 'anoop1992', 'shobhavaddineni', 'saladi0293', 'kavya.dhanala', 'nagasai', 'mvenu2', 'rahulenukonda525', 'nishat1801', 'rakeshyadav', 'kancharla0113', 'kushalvasoya558', 'eedupuganti07', 'rzaragoza91', 'dipali.shatavara', 'reetu0610', 'pavan51', 'sathiriv', 'himali_dhaduk2493', 'james54', 'sha6070sha', 'ritvik03', 'teja999', 'pritipatel', 'anveshkankanala', 'santhoshnn134', 'priyankareddy', 'veeru', 'kunda93', 'mpangan1128', 'harshavardhanvarmavegesna', 'muralisaiavinash', 'jzherrera', 'pritipatel59', 'venkateah', 'akshaya1512', 'makwanasameer007', 'mani477', 'meen83', 'patel.akash102', 'poojatrivedi', 'trodas1287', 'hem.metalia', 'jrriddley1355', 'binayb175', 'rathodpriyank', 'poyani_mehta', 'rawadhilal', 'dhruvil', 'poyanimehta92', 'deepakengineer', 'purna24', 'kashyap09ec71', 'shreeyash6', None, 'pallugullu', 'nikhilshinde', 'pallavi90', 'kruthiperumalla', 'bansari21', 'deeppatel092', 'nvnreddy418', 'thedmutz24', 'kevinharish40', 'fardad.falahati', 'nikhila_banda', 'yaminikrishna', 'marneni01', 'chinthalapally13', 'teju2710', 'kavyathokala']"
110,137,6,58,4,"['meen83', 'pavan51', 'narapa', 'shobhavaddineni']",1,['aartipatel'],54,"['ravikiran19', 'loveena1902', 'himali_dhaduk2493', 'manojtalluri.93', 'sha6070sha', 'manalipatel26', 'teja999', '91rzaragoza1', 'parita11', 'dharanidar123', 'anish69052', 'vanimerugu', 'mekalamanishyadav', 'ramisetty12', 'veeru', 'manojbukka', 'maheshedururi', 'kunda93', 'nawaz316', 'harshavardhanvarmavegesna', 'muralisaiavinash', 'mit1993', 'ya9mehta', 'santhosh.y', 'haritha93', 'engpeacock', 'makwanasameer007', 'mani477', 'patel.akash102', 'rawadhilal', 'kishan7172', 'christxran', 'purna24', 'kashyap09ec71', 'dipal.ptl', 'parikhchirag29', 'anoop1992', None, 'saladi0293', 'kruthiperumalla', 'muralikrishna41', 'nikhilshinde06', 'deeppatel092', 'nvnreddy418', 'kancharla0113', 'engahmedsajit', 'fardad.falahati', 'kushalvasoya558', 'nikhila_banda', 'yaminikrishna', 'marneni01', 'chinthalapally13', 'kavyathokala', 'reetu0610']",59,"['pavan51', 'ravikiran19', 'loveena1902', 'himali_dhaduk2493', 'manojtalluri.93', 'sha6070sha', 'manalipatel26', 'teja999', '91rzaragoza1', 'parita11', 'dharanidar123', 'anish69052', 'vanimerugu', 'mekalamanishyadav', 'ramisetty12', 'veeru', 'manojbukka', 'maheshedururi', 'kunda93', 'nawaz316', 'aartipatel', 'harshavardhanvarmavegesna', 'muralisaiavinash', 'mit1993', 'ya9mehta', 'santhosh.y', 'haritha93', 'engpeacock', 'makwanasameer007', 'mani477', 'meen83', 'patel.akash102', 'narapa', 'rawadhilal', 'kishan7172', 'christxran', 'purna24', 'kashyap09ec71', 'dipal.ptl', 'parikhchirag29', 'anoop1992', None, 'shobhavaddineni', 'saladi0293', 'kruthiperumalla', 'muralikrishna41', 'nikhilshinde06', 'deeppatel092', 'nvnreddy418', 'kancharla0113', 'engahmedsajit', 'fardad.falahati', 'kushalvasoya558', 'nikhila_banda', 'yaminikrishna', 'marneni01', 'chinthalapally13', 'kavyathokala', 'reetu0610']"
110,19,6,32,5,"['aartipatel', 'pavan51', 'narapa', 'meen83', 'shobhavaddineni']",0,[],27,"['loveena1902', 'himali_dhaduk2493', 'ravikiran19', 'sha6070sha', 'teja999', 'anveshkankanala', '91rzaragoza1', 'vanimerugu', 'mekalamanishyadav', 'veeru', 'kunda93', 'pavan.malay', 'patel.akash102', 'binayb175', 'namratha.siddappa', 'anoop1992', None, 'pallugullu', 'pallavi90', 'saladi0293', 'bansari21', 'deeppatel092', 'kancharla0113', 'eedupuganti07', 'yaminikrishna', 'teju2710', 'rtvgs999']",32,"['pavan51', 'loveena1902', 'himali_dhaduk2493', 'ravikiran19', 'sha6070sha', 'teja999', 'anveshkankanala', '91rzaragoza1', 'vanimerugu', 'mekalamanishyadav', 'veeru', 'kunda93', 'aartipatel', 'pavan.malay', 'meen83', 'patel.akash102', 'binayb175', 'namratha.siddappa', 'narapa', 'anoop1992', None, 'shobhavaddineni', 'pallugullu', 'pallavi90', 'saladi0293', 'bansari21', 'deeppatel092', 'kancharla0113', 'eedupuganti07', 'yaminikrishna', 'teju2710', 'rtvgs999']"
110,119,6,22,3,"['meen83', 'aartipatel', 'pavan51']",2,"['narapa', 'shobhavaddineni']",19,"['loveena1902', 'teja999', 'trinath90', 'veeru', 'shilpa1992', 'venkateah', 'binayb175', 'namratha.siddappa', 'poyani_mehta', None, 'pallugullu', 'pallavi90', 'nagasai', 'bansari21', 'kancharla0113', 'marneni01', 'teju2710', 'rtvgs999', 'reetu0610']",24,"['pavan51', 'binayb175', 'loveena1902', 'namratha.siddappa', 'poyani_mehta', 'narapa', 'teja999', 'trinath90', 'veeru', None, 'shobhavaddineni', 'pallavi90', 'pallugullu', 'aartipatel', 'shilpa1992', 'nagasai', 'bansari21', 'venkateah', 'kancharla0113', 'meen83', 'marneni01', 'teju2710', 'rtvgs999', 'reetu0610']"
110,71,6,19,5,"['aartipatel', 'pavan51', 'narapa', 'meen83', 'shobhavaddineni']",0,[],14,"['nagasai', 'marneni01', 'harshavardhanvarmavegesna', 'nikhilshinde06', 'sha6070sha', None, 'kancharla0113', 'santhosh.y', 'parita11', 'patel.akash102', 'mekalamanishyadav', 'anoop1992', 'pallavi90', 'reetu0610']",19,"['pavan51', 'sha6070sha', 'narapa', 'parita11', 'mekalamanishyadav', 'anoop1992', None, 'shobhavaddineni', 'pallavi90', 'aartipatel', 'nagasai', 'harshavardhanvarmavegesna', 'marneni01', 'nikhilshinde06', 'kancharla0113', 'santhosh.y', 'meen83', 'patel.akash102', 'reetu0610']"
110,138,6,13,3,"['meen83', 'narapa', 'shobhavaddineni']",2,"['aartipatel', 'pavan51']",10,"['harshavardhanvarmavegesna', 'pallavi90', 'deeppatel092', 'sha6070sha', None, 'kancharla0113', 'patel.akash102', 'anoop1992', 'pallugullu', 'reetu0610']",15,"['pavan51', 'sha6070sha', 'narapa', 'anoop1992', None, 'shobhavaddineni', 'pallugullu', 'pallavi90', 'aartipatel', 'harshavardhanvarmavegesna', 'deeppatel092', 'kancharla0113', 'meen83', 'patel.akash102', 'reetu0610']"
110,18,6,10,3,"['meen83', 'narapa', 'shobhavaddineni']",2,"['aartipatel', 'pavan51']",7,"['deeppatel092', 'sha6070sha', None, 'kancharla0113', 'patel.akash102', 'anoop1992', 'reetu0610']",12,"['aartipatel', 'pavan51', 'deeppatel092', 'sha6070sha', None, 'narapa', 'kancharla0113', 'meen83', 'patel.akash102', 'anoop1992', 'shobhavaddineni', 'reetu0610']"
