MClusterID,XClusterID,MClusterSize,XClusterSize,OverlapSize,OverlapMembers,MOnlySize,MOnlyMembers,XOnlySize,XOnlyMembers,CombinedSize,CombinedMembers
1,9,250,149,123,"['appa9731532495', 'jayasuryach3', 'vandit93', 'antoniocarrera', 'gandhali', 'skyp0620', 'saisupraj', 'chandana1', 'spittips101', '12kj', 'shaila', 'vaibhao14', 'karthikeya', 'jdilig27', 'saisupraj1', 'razavi_nader', 'jonilsoni92', 'skyp0720', 'mitdalal', 'jinad803068899', 'jpneha', '7adamzaheer7', 'ireymond1', 'shubham.kale27', '802730911manisha', 'tippu70099', 'santhosh1', 'gandhali4', 'mitdalal15', '802964544_abdul', 'ramyanaine11', 'akshay12', 'southbound280', 'harkishangrewal', 'cwid805705746', '556research2015', 'valgiadicerto', 'munagalavinod', 'surabhikhadke77', 'vikrant23', 'mehta.rohan77', 'priyanka456', 'saeed1368', 'rohith1234', 'eds3293', 'saraheisenkolb', 'jayasuryach4', 'tippu7002', 'revanthkumar29', 'mirza_baig338', 'ireymond0', 'rajeshgoudvatnala1', 'jeetendaveusa', 'shiva1702', 'kpc.pardhu', 'jonilsoni', 'shweka147', 'yusun3', 'paruvelli.chandana', 'deeksha893', 'hatimkp63', 'azadehfamili', 'saisupraj1994', 'segomez1304', 'chaxul', 'id889632394', 'rohits2509', 'mturi', 'pavkou123', 'mirza338', 'seg2597', 'munagalavinodreddy', 'mahalepriyaja', 'heli', 'datdang', 'yubai', 'niketkothari92', 'venkat92', 'divya1537', 'rakeshrvndra', 'aakashmhankale1234', 'astillmaker', 'f_alshammari', 'mvikasraj123', 'jeet.shah2223', 'munagalavinod.r', 'jeet_shah_2223', 'ramyakonidhala', 'ppetros', 'jeetendave259', 'ceoelkers1995', 'aditya09', 'bhagatsingh91', 'arlarson99', 'jinadpatel919', 'tippu70193', '008dilip', 'antoniocarrera96', 'naviraja', 'tatikonda', 'haseeb.aktar123', 'mirjivarsha', 'varsham22', 'dhvanish17', 'keescueta', 'zub12345', 'bawischus', 'raymondbach1', 'grubbies01', 'pranampranu', 'sasuveja950', 'cvarner81', 'calvinly', 'pablopelayo', 'priya.r', 'shiva0193', 'cwid805670197', 'hgrewal', 'gulwelling', 'gitanshu', 'jeetshah23', 'sindhoor', 'neeturaj']",127,"['sarath31', 'deep16', 'jiangy1', 'jagaamaa11', 'elpaglia', 'marcofratus', 'whenriquez', 'rko2saurav', 'antroy.rc', 'vineethvinny1997', 'pourushsood', 'sairohith', 'pkrishnapritish', 'kumarvineeth14', 'celetldci', 'dipanjandas1996', 'shreshta.0594', 'dishankyadav96', 'raveyjsn', 'amruthamma1998', 'danbutman', 'rohitpetkar.r', 'balu8108', 'anirudhaga', 'harsh12041997', 'kunalkhadke97', 'nirajj100', 'ishapadia', 'rushee2911', 'davide93', 'sim_ks', 'stella.s01', '2010ee179', 'manuelsalva182', 'hardikagrawal545', 'anjanmandal58', 'satakarni_amirneni', 'sittun.swayam', 'nanoprodigy', 'evineeth97', 'sayantan2502iitkgp', 'xybiju', 'charankoushik', 'gberk2016', 'dineshkota007', 'mrcogito', 'agrawa64', 'kandalavamshi111', 'sreevardhan25', 'saranyu', 'pukd56', 'askarmakar07', 'akshay13m', 'rayudhajit', 'yazayaga', 'yuvsamratuday1997', 'sobriquet', 'shraddha.mhapralkar91', 'abinashsena', 'manohub', 'varadkardeep96', 'rsagrawal.avanti', 'agkonale', 'gopa_97', 'morry458', 'sachindaniel', 'sgu201201146', 'vickygood15', 'rajdeep.biswas2010', 'bksaif', 'anushreedavbhagalpur', 'rajanamit2', 'shathorn', 'mandars222', 'hmelia', 'sgu20111560', 'kishorbhosale', 'kk55singh', 'pdoak', 'anushka.4353.bansal', 'cmvdv', 'joshuapeterebenezer', 'krithish13', 'baldassimassimo', 'gholamvz', 'jar2267', 'nagapradeep97', 'arunganesh', 'bharat123', 'deepthireddyparvatham12', 'yyao46', 'ray_arka', 'prudvi1258', 'revanthreddy207', 'beena11', 'arupsamanta', 'rakesh207', 'manikanta1773', 'mekkaoui', 'rahulkr.1531', 'kagitanikhil', 'sudzsharma', 'tummalabalakrishna48', 'gijsv', 'justin.tan', 'nikhiliated', 'chaitanypaikara', 'shanka', 'chrislew14', 'abhi1singh2', 'samueltayishere', 'simrobson', 'shravanisistla1998', 'karankantharia', 'lovkeshrishab', 'amrithav', 'singhmanohar360', 'cjwestri', 'nanohubsocial', 'kalyan4112', 'roryvang299', 'nitinkush16', 'acabhi07', 'mayankpalaria', 'manishasa', 'prudvi125', 'rkrahi9']",26,"['geethesh', 'smshah', 'revanthkumar', 'chaxul611', 'vishal_mistry40', 'mohammed18', 'bhagatsingh.91', 'dnega', 'azadefamili', 'nareshmangali186', 'harshcse99', 'idutcih', 'kellysnguyen13', 'adirocks.tumsare', 'elango', 'summerleaf', 'peterfink89', 'priyaa5', 'sanketdesai91', None, 'naviraj1801', 'sandeep893430892', 'siddiq', 'venki09443', 'bhargavi8922', 'gulshankumar']",276,"['appa9731532495', 'jayasuryach3', 'deep16', 'jiangy1', 'jagaamaa11', 'vandit93', 'gandhali', 'antoniocarrera', 'marcofratus', 'revanthkumar', 'whenriquez', 'spittips101', 'antroy.rc', 'pourushsood', 'vaibhao14', 'dipanjandas1996', 'karthikeya', 'shreshta.0594', 'raveyjsn', 'razavi_nader', 'jonilsoni92', 'naviraj1801', 'mitdalal', 'jpneha', 'rohitpetkar.r', 'tippu70099', '802730911manisha', 'anirudhaga', 'santhosh1', 'harsh12041997', 'smshah', '802964544_abdul', 'ramyanaine11', 'sim_ks', 'manuelsalva182', 'hardikagrawal545', 'anjanmandal58', 'akshay12', 'sittun.swayam', 'nanoprodigy', 'valgiadicerto', 'evineeth97', 'xybiju', 'charankoushik', 'gberk2016', 'kellysnguyen13', 'elango', 'dineshkota007', 'mrcogito', 'agrawa64', 'priyanka456', 'askarmakar07', 'akshay13m', 'rayudhajit', 'saeed1368', 'rohith1234', 'eds3293', 'ireymond0', 'revanthkumar29', 'sobriquet', 'jeetendaveusa', 'abinashsena', 'yusun3', 'paruvelli.chandana', 'agkonale', 'gopa_97', 'morry458', 'segomez1304', 'azadehfamili', 'saisupraj1994', 'sgu201201146', 'vickygood15', 'mturi', 'anushreedavbhagalpur', 'azadefamili', 'mandars222', 'hmelia', 'rajanamit2', 'sgu20111560', 'kishorbhosale', 'mirza338', 'kk55singh', 'munagalavinodreddy', 'adirocks.tumsare', 'pdoak', 'heli', 'anushka.4353.bansal', 'peterfink89', 'sanketdesai91', 'krithish13', 'baldassimassimo', 'gholamvz', 'datdang', 'yubai', 'jar2267', 'venkat92', 'niketkothari92', 'sandeep893430892', 'rakeshrvndra', 'aakashmhankale1234', 'venki09443', 'ray_arka', 'mvikasraj123', 'revanthreddy207', 'beena11', 'rakesh207', 'jeet_shah_2223', 'ceoelkers1995', 'sudzsharma', 'bhagatsingh91', 'tummalabalakrishna48', 'arlarson99', 'vishal_mistry40', 'mohammed18', 'jinadpatel919', 'justin.tan', 'nikhiliated', 'chaitanypaikara', '008dilip', 'antoniocarrera96', 'naviraja', 'chrislew14', 'tatikonda', 'haseeb.aktar123', 'simrobson', 'mirjivarsha', 'varsham22', 'dhvanish17', 'shravanisistla1998', 'summerleaf', 'zub12345', 'lovkeshrishab', 'raymondbach1', 'bawischus', 'pranampranu', 'sasuveja950', None, 'calvinly', 'cvarner81', 'amrithav', 'siddiq', 'shiva0193', 'singhmanohar360', 'cwid805670197', 'cjwestri', 'hgrewal', 'gitanshu', 'nitinkush16', 'neeturaj', 'mayankpalaria', 'manishasa', 'rkrahi9', 'sarath31', 'elpaglia', 'skyp0620', 'saisupraj', 'rko2saurav', 'chandana1', 'bhagatsingh.91', 'dnega', 'vineethvinny1997', '12kj', 'sairohith', 'pkrishnapritish', 'kumarvineeth14', 'celetldci', 'shaila', 'dishankyadav96', 'jdilig27', 'saisupraj1', 'skyp0720', 'amruthamma1998', 'jinad803068899', 'danbutman', '7adamzaheer7', 'ireymond1', 'shubham.kale27', 'balu8108', 'gandhali4', 'kunalkhadke97', 'nirajj100', 'ishapadia', 'mitdalal15', 'rushee2911', 'davide93', 'stella.s01', '2010ee179', 'nareshmangali186', 'satakarni_amirneni', 'southbound280', 'cwid805705746', '556research2015', 'harkishangrewal', 'munagalavinod', 'surabhikhadke77', 'sayantan2502iitkgp', 'vikrant23', 'mehta.rohan77', 'kandalavamshi111', 'sreevardhan25', 'saranyu', 'pukd56', 'yazayaga', 'yuvsamratuday1997', 'saraheisenkolb', 'jayasuryach4', 'tippu7002', 'mirza_baig338', 'rajeshgoudvatnala1', 'bhargavi8922', 'shraddha.mhapralkar91', 'shiva1702', 'kpc.pardhu', 'jonilsoni', 'manohub', 'varadkardeep96', 'shweka147', 'geethesh', 'rsagrawal.avanti', 'deeksha893', 'hatimkp63', 'sachindaniel', 'chaxul611', 'chaxul', 'id889632394', 'rohits2509', 'rajdeep.biswas2010', 'bksaif', 'pavkou123', 'shathorn', 'harshcse99', 'seg2597', 'idutcih', 'mahalepriyaja', 'cmvdv', 'joshuapeterebenezer', 'nagapradeep97', 'divya1537', 'arunganesh', 'bharat123', 'deepthireddyparvatham12', 'yyao46', 'astillmaker', 'prudvi1258', 'f_alshammari', 'gulshankumar', 'jeet.shah2223', 'arupsamanta', 'munagalavinod.r', 'manikanta1773', 'mekkaoui', 'ramyakonidhala', 'jeetendave259', 'ppetros', 'rahulkr.1531', 'kagitanikhil', 'aditya09', 'gijsv', 'tippu70193', 'shanka', 'abhi1singh2', 'samueltayishere', 'keescueta', 'karankantharia', 'priyaa5', 'grubbies01', 'pablopelayo', 'priya.r', 'nanohubsocial', 'gulwelling', 'roryvang299', 'kalyan4112', 'jeetshah23', 'acabhi07', 'sindhoor', 'prudvi125']"
1,12,250,93,61,"['anirudhaga', 'kunalkhadke97', 'beena11', 'rakesh207', 'nirajj100', 'sarath31', 'deep16', 'rahulkr.1531', 'gopa_97', 'rushee2911', 'abinashsena', 'sim_ks', 'kagitanikhil', 'sudzsharma', 'tummalabalakrishna48', 'vickygood15', 'rajdeep.biswas2010', 'rko2saurav', 'revanthreddy207', 'anushreedavbhagalpur', 'vineethvinny1997', 'antroy.rc', 'hardikagrawal545', 'anjanmandal58', 'nikhiliated', 'satakarni_amirneni', 'sairohith', 'pkrishnapritish', 'chaitanypaikara', 'sittun.swayam', 'shanka', 'kumarvineeth14', 'kk55singh', 'abhi1singh2', 'evineeth97', 'sayantan2502iitkgp', 'xybiju', 'charankoushik', 'shravanisistla1998', 'dipanjandas1996', 'lovkeshrishab', 'joshuapeterebenezer', 'dishankyadav96', 'kandalavamshi111', 'sreevardhan25', 'saranyu', 'askarmakar07', 'amruthamma1998', 'nagapradeep97', 'rayudhajit', 'arunganesh', 'deepthireddyparvatham12', 'yuvsamratuday1997', 'kalyan4112', 'nitinkush16', 'acabhi07', 'ray_arka', 'mayankpalaria', 'prudvi1258', 'manishasa', 'balu8108']",189,"['appa9731532495', 'jayasuryach3', 'jiangy1', 'jagaamaa11', 'vandit93', 'elpaglia', 'gandhali', 'antoniocarrera', 'marcofratus', 'whenriquez', 'skyp0620', 'saisupraj', 'chandana1', 'spittips101', '12kj', 'pourushsood', 'celetldci', 'shaila', 'vaibhao14', 'karthikeya', 'shreshta.0594', 'jdilig27', 'raveyjsn', 'saisupraj1', 'razavi_nader', 'jonilsoni92', 'skyp0720', 'mitdalal', 'jinad803068899', 'jpneha', 'danbutman', '7adamzaheer7', 'ireymond1', 'shubham.kale27', 'rohitpetkar.r', 'tippu70099', '802730911manisha', 'gandhali4', 'santhosh1', 'harsh12041997', 'ishapadia', 'mitdalal15', '802964544_abdul', 'ramyanaine11', 'davide93', 'stella.s01', '2010ee179', 'manuelsalva182', 'akshay12', 'southbound280', 'cwid805705746', '556research2015', 'harkishangrewal', 'nanoprodigy', 'valgiadicerto', 'munagalavinod', 'surabhikhadke77', 'gberk2016', 'vikrant23', 'dineshkota007', 'mrcogito', 'agrawa64', 'mehta.rohan77', 'priyanka456', 'pukd56', 'akshay13m', 'saeed1368', 'rohith1234', 'yazayaga', 'eds3293', 'saraheisenkolb', 'jayasuryach4', 'ireymond0', 'revanthkumar29', 'mirza_baig338', 'rajeshgoudvatnala1', 'tippu7002', 'sobriquet', 'jeetendaveusa', 'shraddha.mhapralkar91', 'shiva1702', 'kpc.pardhu', 'jonilsoni', 'manohub', 'varadkardeep96', 'shweka147', 'yusun3', 'paruvelli.chandana', 'rsagrawal.avanti', 'deeksha893', 'agkonale', 'morry458', 'hatimkp63', 'sachindaniel', 'segomez1304', 'azadehfamili', 'saisupraj1994', 'chaxul', 'sgu201201146', 'id889632394', 'rohits2509', 'bksaif', 'mturi', 'pavkou123', 'shathorn', 'mandars222', 'hmelia', 'sgu20111560', 'rajanamit2', 'kishorbhosale', 'mirza338', 'seg2597', 'munagalavinodreddy', 'mahalepriyaja', 'pdoak', 'heli', 'anushka.4353.bansal', 'cmvdv', 'krithish13', 'baldassimassimo', 'gholamvz', 'datdang', 'yubai', 'jar2267', 'venkat92', 'divya1537', 'niketkothari92', 'bharat123', 'yyao46', 'rakeshrvndra', 'aakashmhankale1234', 'astillmaker', 'f_alshammari', 'mvikasraj123', 'jeet.shah2223', 'arupsamanta', 'munagalavinod.r', 'manikanta1773', 'mekkaoui', 'jeet_shah_2223', 'ramyakonidhala', 'jeetendave259', 'ppetros', 'ceoelkers1995', 'bhagatsingh91', 'gijsv', 'arlarson99', 'aditya09', 'jinadpatel919', 'justin.tan', 'tippu70193', '008dilip', 'antoniocarrera96', 'naviraja', 'chrislew14', 'tatikonda', 'haseeb.aktar123', 'samueltayishere', 'mirjivarsha', 'simrobson', 'varsham22', 'dhvanish17', 'zub12345', 'keescueta', 'karankantharia', 'raymondbach1', 'bawischus', 'grubbies01', 'pranampranu', 'sasuveja950', 'calvinly', 'cvarner81', 'pablopelayo', 'amrithav', 'priya.r', 'shiva0193', 'singhmanohar360', 'cwid805670197', 'cjwestri', 'hgrewal', 'nanohubsocial', 'gitanshu', 'roryvang299', 'gulwelling', 'jeetshah23', 'sindhoor', 'neeturaj', 'prudvi125', 'rkrahi9']",32,"['hemanth297', 'kaustav1407', 'sid89014', 'arijitmandal1994', 'muralikorada55', 'nupurbhaisare24', 'niharika25', 'kgoel', 'ksai0378', 'p.geminisiva1998', 'anirudhrachamalla', 'rajeswarim81', 'sameer786007', 'avinabsaha2018', 'shubhra_19', 'saivineethkumar', 'ram2606', 'asif123', 'parag.ydv23', 'mriganksh', 'sumit53', 'keerthana_bhogi', 'abhi123', 'harshit.roy30014', 'ankitkp4056', 'sumitarya1310', None, '2209sandeep', 'shanmukh17', 'siripranitha', 'swarnabha1997', 'rohitrajeev128']",282,"['appa9731532495', 'jayasuryach3', 'deep16', 'jiangy1', 'jagaamaa11', 'vandit93', 'gandhali', 'antoniocarrera', 'marcofratus', 'whenriquez', 'ksai0378', 'p.geminisiva1998', 'spittips101', 'antroy.rc', 'pourushsood', 'saivineethkumar', 'vaibhao14', 'sumit53', 'dipanjandas1996', 'karthikeya', 'shreshta.0594', 'raveyjsn', 'harshit.roy30014', 'razavi_nader', 'jonilsoni92', 'mitdalal', 'jpneha', 'rohitpetkar.r', 'tippu70099', '802730911manisha', 'anirudhaga', 'santhosh1', 'harsh12041997', 'nupurbhaisare24', '802964544_abdul', 'ramyanaine11', 'sim_ks', 'manuelsalva182', 'hardikagrawal545', 'anjanmandal58', 'akshay12', 'sittun.swayam', 'nanoprodigy', 'valgiadicerto', 'evineeth97', 'xybiju', 'charankoushik', 'gberk2016', 'dineshkota007', 'mrcogito', 'agrawa64', 'priyanka456', 'askarmakar07', 'akshay13m', 'rayudhajit', 'saeed1368', 'rohith1234', 'eds3293', 'siripranitha', 'ireymond0', 'revanthkumar29', 'sobriquet', 'jeetendaveusa', 'rohitrajeev128', 'abinashsena', 'kaustav1407', 'yusun3', 'paruvelli.chandana', 'agkonale', 'gopa_97', 'morry458', 'segomez1304', 'azadehfamili', 'saisupraj1994', 'sgu201201146', 'vickygood15', 'mturi', 'anushreedavbhagalpur', 'mandars222', 'hmelia', 'rajanamit2', 'avinabsaha2018', 'sgu20111560', 'kishorbhosale', 'mirza338', 'kk55singh', 'munagalavinodreddy', 'ram2606', 'pdoak', 'heli', 'anushka.4353.bansal', 'krithish13', 'baldassimassimo', 'gholamvz', 'ankitkp4056', 'datdang', 'yubai', 'jar2267', 'venkat92', 'niketkothari92', 'shanmukh17', 'rakeshrvndra', 'aakashmhankale1234', 'ray_arka', 'mvikasraj123', 'revanthreddy207', 'sid89014', 'beena11', 'rakesh207', 'jeet_shah_2223', 'ceoelkers1995', 'sudzsharma', 'bhagatsingh91', 'tummalabalakrishna48', 'arlarson99', 'jinadpatel919', 'justin.tan', 'nikhiliated', 'chaitanypaikara', '008dilip', 'antoniocarrera96', 'naviraja', 'chrislew14', 'tatikonda', 'haseeb.aktar123', 'simrobson', 'mirjivarsha', 'varsham22', 'mriganksh', 'dhvanish17', 'shravanisistla1998', 'zub12345', 'lovkeshrishab', 'raymondbach1', 'bawischus', 'abhi123', 'pranampranu', 'sasuveja950', None, 'calvinly', 'cvarner81', 'amrithav', 'shiva0193', 'singhmanohar360', 'cwid805670197', 'cjwestri', 'hgrewal', 'gitanshu', 'nitinkush16', 'neeturaj', 'mayankpalaria', 'manishasa', 'rkrahi9', 'sarath31', 'elpaglia', 'kgoel', 'skyp0620', 'anirudhrachamalla', 'saisupraj', 'rko2saurav', 'chandana1', 'rajeswarim81', 'vineethvinny1997', '12kj', 'sairohith', 'pkrishnapritish', 'kumarvineeth14', 'celetldci', 'shaila', 'parag.ydv23', 'dishankyadav96', 'jdilig27', 'saisupraj1', 'sumitarya1310', 'skyp0720', 'amruthamma1998', 'jinad803068899', 'danbutman', '7adamzaheer7', 'ireymond1', 'shubham.kale27', 'balu8108', 'gandhali4', 'kunalkhadke97', 'nirajj100', 'muralikorada55', 'ishapadia', 'mitdalal15', 'rushee2911', 'davide93', 'stella.s01', '2010ee179', 'sameer786007', 'satakarni_amirneni', 'southbound280', 'cwid805705746', '556research2015', 'harkishangrewal', 'shubhra_19', 'munagalavinod', 'surabhikhadke77', 'sayantan2502iitkgp', 'asif123', 'vikrant23', 'mehta.rohan77', 'kandalavamshi111', 'sreevardhan25', 'saranyu', 'pukd56', '2209sandeep', 'yazayaga', 'yuvsamratuday1997', 'saraheisenkolb', 'jayasuryach4', 'tippu7002', 'mirza_baig338', 'rajeshgoudvatnala1', 'swarnabha1997', 'shraddha.mhapralkar91', 'shiva1702', 'kpc.pardhu', 'jonilsoni', 'manohub', 'varadkardeep96', 'shweka147', 'hemanth297', 'arijitmandal1994', 'rsagrawal.avanti', 'deeksha893', 'hatimkp63', 'sachindaniel', 'chaxul', 'id889632394', 'rohits2509', 'rajdeep.biswas2010', 'bksaif', 'pavkou123', 'shathorn', 'seg2597', 'mahalepriyaja', 'cmvdv', 'joshuapeterebenezer', 'nagapradeep97', 'divya1537', 'arunganesh', 'bharat123', 'deepthireddyparvatham12', 'yyao46', 'astillmaker', 'prudvi1258', 'f_alshammari', 'jeet.shah2223', 'arupsamanta', 'munagalavinod.r', 'manikanta1773', 'mekkaoui', 'ramyakonidhala', 'jeetendave259', 'ppetros', 'rahulkr.1531', 'niharika25', 'kagitanikhil', 'aditya09', 'gijsv', 'tippu70193', 'shanka', 'abhi1singh2', 'samueltayishere', 'keescueta', 'karankantharia', 'keerthana_bhogi', 'grubbies01', 'pablopelayo', 'priya.r', 'nanohubsocial', 'gulwelling', 'roryvang299', 'kalyan4112', 'jeetshah23', 'acabhi07', 'sindhoor', 'prudvi125']"
1,288,250,83,45,"['anirudhaga', 'harsh12041997', 'kunalkhadke97', 'rakesh207', 'nirajj100', 'sarath31', 'rsagrawal.avanti', 'rahulkr.1531', 'gopa_97', 'abinashsena', 'sim_ks', 'sudzsharma', 'tummalabalakrishna48', 'rajdeep.biswas2010', 'rko2saurav', 'revanthreddy207', 'vineethvinny1997', 'antroy.rc', 'hardikagrawal545', 'anjanmandal58', 'nikhiliated', 'pourushsood', 'sairohith', 'chaitanypaikara', 'sittun.swayam', 'shanka', 'kumarvineeth14', 'sayantan2502iitkgp', 'xybiju', 'shravanisistla1998', 'lovkeshrishab', 'joshuapeterebenezer', 'saranyu', 'nagapradeep97', 'amruthamma1998', 'rayudhajit', 'arunganesh', 'deepthireddyparvatham12', 'kalyan4112', 'nitinkush16', 'acabhi07', 'ray_arka', 'mayankpalaria', 'manishasa', 'balu8108']",205,"['appa9731532495', 'jayasuryach3', 'jiangy1', 'deep16', 'jagaamaa11', 'vandit93', 'elpaglia', 'gandhali', 'antoniocarrera', 'marcofratus', 'whenriquez', 'skyp0620', 'saisupraj', 'chandana1', 'spittips101', '12kj', 'pkrishnapritish', 'celetldci', 'shaila', 'vaibhao14', 'dipanjandas1996', 'karthikeya', 'shreshta.0594', 'dishankyadav96', 'jdilig27', 'raveyjsn', 'saisupraj1', 'razavi_nader', 'jonilsoni92', 'skyp0720', 'mitdalal', 'jinad803068899', 'jpneha', 'danbutman', '7adamzaheer7', 'ireymond1', 'shubham.kale27', 'rohitpetkar.r', 'tippu70099', '802730911manisha', 'gandhali4', 'santhosh1', 'ishapadia', 'mitdalal15', '802964544_abdul', 'ramyanaine11', 'davide93', 'rushee2911', 'stella.s01', '2010ee179', 'manuelsalva182', 'satakarni_amirneni', 'akshay12', 'cwid805705746', '556research2015', 'harkishangrewal', 'southbound280', 'nanoprodigy', 'valgiadicerto', 'munagalavinod', 'evineeth97', 'surabhikhadke77', 'charankoushik', 'gberk2016', 'vikrant23', 'dineshkota007', 'mrcogito', 'agrawa64', 'mehta.rohan77', 'kandalavamshi111', 'priyanka456', 'sreevardhan25', 'pukd56', 'askarmakar07', 'akshay13m', 'saeed1368', 'rohith1234', 'yazayaga', 'eds3293', 'yuvsamratuday1997', 'saraheisenkolb', 'jayasuryach4', 'ireymond0', 'revanthkumar29', 'mirza_baig338', 'rajeshgoudvatnala1', 'tippu7002', 'sobriquet', 'jeetendaveusa', 'shraddha.mhapralkar91', 'shiva1702', 'kpc.pardhu', 'jonilsoni', 'manohub', 'varadkardeep96', 'shweka147', 'yusun3', 'paruvelli.chandana', 'deeksha893', 'agkonale', 'morry458', 'hatimkp63', 'sachindaniel', 'segomez1304', 'azadehfamili', 'saisupraj1994', 'chaxul', 'sgu201201146', 'vickygood15', 'id889632394', 'rohits2509', 'bksaif', 'mturi', 'anushreedavbhagalpur', 'pavkou123', 'shathorn', 'mandars222', 'hmelia', 'sgu20111560', 'rajanamit2', 'kishorbhosale', 'mirza338', 'kk55singh', 'seg2597', 'munagalavinodreddy', 'mahalepriyaja', 'pdoak', 'heli', 'anushka.4353.bansal', 'cmvdv', 'krithish13', 'baldassimassimo', 'gholamvz', 'datdang', 'yubai', 'jar2267', 'venkat92', 'divya1537', 'niketkothari92', 'bharat123', 'yyao46', 'rakeshrvndra', 'aakashmhankale1234', 'astillmaker', 'prudvi1258', 'f_alshammari', 'mvikasraj123', 'jeet.shah2223', 'beena11', 'munagalavinod.r', 'arupsamanta', 'manikanta1773', 'jeet_shah_2223', 'mekkaoui', 'ramyakonidhala', 'jeetendave259', 'ppetros', 'kagitanikhil', 'ceoelkers1995', 'bhagatsingh91', 'gijsv', 'arlarson99', 'aditya09', 'jinadpatel919', 'justin.tan', 'tippu70193', '008dilip', 'antoniocarrera96', 'naviraja', 'chrislew14', 'tatikonda', 'abhi1singh2', 'haseeb.aktar123', 'samueltayishere', 'mirjivarsha', 'simrobson', 'varsham22', 'dhvanish17', 'zub12345', 'keescueta', 'karankantharia', 'raymondbach1', 'bawischus', 'grubbies01', 'pranampranu', 'sasuveja950', 'calvinly', 'cvarner81', 'pablopelayo', 'amrithav', 'priya.r', 'shiva0193', 'singhmanohar360', 'cwid805670197', 'cjwestri', 'hgrewal', 'nanohubsocial', 'gitanshu', 'roryvang299', 'gulwelling', 'jeetshah23', 'sindhoor', 'neeturaj', 'prudvi125', 'rkrahi9']",38,"['hemanth297', 'kaustav1407', 'sid89014', 'nivedprakash1996', 'muralikorada55', 'nupurbhaisare24', 'niharika25', 'kgoel', 'ksai0378', 'anirudhrachamalla', 'rajeswarim81', 'sameer786007', 'avinabsaha2018', 'utshobmazumder0909', 'saurabhjai97', 'madhugurram', 'saivineethkumar', 'ram2606', 'asif123', 'mriganksh', 'sumit53', 'keerthana_bhogi', 'abhi123', 'harshit.roy30014', 'harshit123', 'ankitkp4056', 'kshitizgoel', 'saikumar8814', 'sumitarya1310', None, '2209sandeep', 'shanmukh17', 'siripranitha', 'rayudhajit1', 'utki.07', 'sm13497', 'swarnabha1997', 'rohitrajeev128']",288,"['appa9731532495', 'jayasuryach3', 'deep16', 'jiangy1', 'jagaamaa11', 'vandit93', 'gandhali', 'antoniocarrera', 'marcofratus', 'whenriquez', 'ksai0378', 'spittips101', 'antroy.rc', 'pourushsood', 'saivineethkumar', 'vaibhao14', 'sumit53', 'dipanjandas1996', 'karthikeya', 'shreshta.0594', 'raveyjsn', 'harshit.roy30014', 'harshit123', 'razavi_nader', 'jonilsoni92', 'mitdalal', 'jpneha', 'rohitpetkar.r', 'tippu70099', '802730911manisha', 'anirudhaga', 'santhosh1', 'harsh12041997', 'nupurbhaisare24', '802964544_abdul', 'ramyanaine11', 'sim_ks', 'manuelsalva182', 'hardikagrawal545', 'anjanmandal58', 'akshay12', 'sittun.swayam', 'nanoprodigy', 'valgiadicerto', 'saurabhjai97', 'evineeth97', 'madhugurram', 'xybiju', 'charankoushik', 'gberk2016', 'dineshkota007', 'mrcogito', 'agrawa64', 'priyanka456', 'askarmakar07', 'akshay13m', 'rayudhajit', 'saeed1368', 'rohith1234', 'eds3293', 'siripranitha', 'ireymond0', 'revanthkumar29', 'sm13497', 'sobriquet', 'saikumar8814', 'jeetendaveusa', 'rohitrajeev128', 'abinashsena', 'kaustav1407', 'yusun3', 'paruvelli.chandana', 'agkonale', 'gopa_97', 'morry458', 'segomez1304', 'azadehfamili', 'saisupraj1994', 'sgu201201146', 'vickygood15', 'mturi', 'anushreedavbhagalpur', 'mandars222', 'hmelia', 'rajanamit2', 'avinabsaha2018', 'sgu20111560', 'kishorbhosale', 'mirza338', 'kk55singh', 'munagalavinodreddy', 'ram2606', 'pdoak', 'heli', 'anushka.4353.bansal', 'krithish13', 'baldassimassimo', 'gholamvz', 'ankitkp4056', 'datdang', 'yubai', 'jar2267', 'venkat92', 'niketkothari92', 'shanmukh17', 'rakeshrvndra', 'rayudhajit1', 'aakashmhankale1234', 'ray_arka', 'mvikasraj123', 'revanthreddy207', 'sid89014', 'beena11', 'rakesh207', 'jeet_shah_2223', 'ceoelkers1995', 'sudzsharma', 'bhagatsingh91', 'tummalabalakrishna48', 'arlarson99', 'jinadpatel919', 'justin.tan', 'nikhiliated', 'chaitanypaikara', '008dilip', 'antoniocarrera96', 'naviraja', 'chrislew14', 'tatikonda', 'haseeb.aktar123', 'simrobson', 'mirjivarsha', 'varsham22', 'mriganksh', 'dhvanish17', 'shravanisistla1998', 'zub12345', 'lovkeshrishab', 'raymondbach1', 'bawischus', 'abhi123', 'pranampranu', 'sasuveja950', None, 'calvinly', 'cvarner81', 'amrithav', 'shiva0193', 'singhmanohar360', 'cwid805670197', 'cjwestri', 'hgrewal', 'gitanshu', 'nitinkush16', 'neeturaj', 'mayankpalaria', 'manishasa', 'rkrahi9', 'sarath31', 'elpaglia', 'kgoel', 'skyp0620', 'anirudhrachamalla', 'saisupraj', 'rko2saurav', 'chandana1', 'rajeswarim81', 'vineethvinny1997', '12kj', 'sairohith', 'pkrishnapritish', 'kumarvineeth14', 'celetldci', 'shaila', 'dishankyadav96', 'jdilig27', 'saisupraj1', 'sumitarya1310', 'skyp0720', 'amruthamma1998', 'jinad803068899', 'danbutman', '7adamzaheer7', 'ireymond1', 'shubham.kale27', 'utki.07', 'balu8108', 'gandhali4', 'kunalkhadke97', 'nirajj100', 'muralikorada55', 'ishapadia', 'mitdalal15', 'rushee2911', 'davide93', 'stella.s01', '2010ee179', 'sameer786007', 'satakarni_amirneni', 'southbound280', 'cwid805705746', '556research2015', 'harkishangrewal', 'utshobmazumder0909', 'munagalavinod', 'surabhikhadke77', 'sayantan2502iitkgp', 'asif123', 'vikrant23', 'mehta.rohan77', 'kandalavamshi111', 'sreevardhan25', 'saranyu', 'kshitizgoel', 'pukd56', '2209sandeep', 'yazayaga', 'yuvsamratuday1997', 'saraheisenkolb', 'jayasuryach4', 'tippu7002', 'mirza_baig338', 'rajeshgoudvatnala1', 'swarnabha1997', 'shraddha.mhapralkar91', 'shiva1702', 'kpc.pardhu', 'jonilsoni', 'manohub', 'varadkardeep96', 'shweka147', 'hemanth297', 'nivedprakash1996', 'rsagrawal.avanti', 'deeksha893', 'hatimkp63', 'sachindaniel', 'chaxul', 'id889632394', 'rohits2509', 'rajdeep.biswas2010', 'bksaif', 'pavkou123', 'shathorn', 'seg2597', 'mahalepriyaja', 'cmvdv', 'joshuapeterebenezer', 'nagapradeep97', 'divya1537', 'arunganesh', 'bharat123', 'deepthireddyparvatham12', 'yyao46', 'astillmaker', 'prudvi1258', 'f_alshammari', 'jeet.shah2223', 'arupsamanta', 'munagalavinod.r', 'manikanta1773', 'mekkaoui', 'ramyakonidhala', 'jeetendave259', 'ppetros', 'rahulkr.1531', 'niharika25', 'kagitanikhil', 'aditya09', 'gijsv', 'tippu70193', 'shanka', 'abhi1singh2', 'samueltayishere', 'keescueta', 'karankantharia', 'keerthana_bhogi', 'grubbies01', 'pablopelayo', 'priya.r', 'nanohubsocial', 'gulwelling', 'roryvang299', 'kalyan4112', 'jeetshah23', 'acabhi07', 'sindhoor', 'prudvi125']"
1,17,250,54,38,"['anirudhaga', 'kunalkhadke97', 'beena11', 'rakesh207', 'nirajj100', 'deep16', 'gopa_97', 'kagitanikhil', 'sim_ks', 'tummalabalakrishna48', 'rajdeep.biswas2010', 'revanthreddy207', 'antroy.rc', 'anjanmandal58', 'pourushsood', 'satakarni_amirneni', 'pkrishnapritish', 'sittun.swayam', 'shanka', 'kumarvineeth14', 'kk55singh', 'xybiju', 'charankoushik', 'shravanisistla1998', 'dipanjandas1996', 'joshuapeterebenezer', 'kandalavamshi111', 'sreevardhan25', 'saranyu', 'rayudhajit', 'arunganesh', 'deepthireddyparvatham12', 'yuvsamratuday1997', 'nitinkush16', 'ray_arka', 'mayankpalaria', 'prudvi1258', 'abinashsena']",212,"['appa9731532495', 'jayasuryach3', 'sarath31', 'jiangy1', 'jagaamaa11', 'vandit93', 'elpaglia', 'gandhali', 'antoniocarrera', 'marcofratus', 'whenriquez', 'skyp0620', 'saisupraj', 'rko2saurav', 'chandana1', 'spittips101', 'vineethvinny1997', '12kj', 'sairohith', 'celetldci', 'shaila', 'vaibhao14', 'karthikeya', 'shreshta.0594', 'dishankyadav96', 'jdilig27', 'raveyjsn', 'saisupraj1', 'razavi_nader', 'jonilsoni92', 'skyp0720', 'mitdalal', 'jinad803068899', 'amruthamma1998', 'jpneha', 'danbutman', '7adamzaheer7', 'ireymond1', 'shubham.kale27', 'rohitpetkar.r', 'tippu70099', '802730911manisha', 'balu8108', 'gandhali4', 'santhosh1', 'harsh12041997', 'ishapadia', 'mitdalal15', '802964544_abdul', 'ramyanaine11', 'davide93', 'stella.s01', 'rushee2911', '2010ee179', 'manuelsalva182', 'hardikagrawal545', 'akshay12', 'cwid805705746', '556research2015', 'harkishangrewal', 'nanoprodigy', 'valgiadicerto', 'southbound280', 'munagalavinod', 'evineeth97', 'surabhikhadke77', 'sayantan2502iitkgp', 'gberk2016', 'vikrant23', 'dineshkota007', 'mrcogito', 'agrawa64', 'mehta.rohan77', 'priyanka456', 'pukd56', 'askarmakar07', 'akshay13m', 'saeed1368', 'rohith1234', 'yazayaga', 'eds3293', 'saraheisenkolb', 'jayasuryach4', 'ireymond0', 'revanthkumar29', 'mirza_baig338', 'rajeshgoudvatnala1', 'tippu7002', 'sobriquet', 'jeetendaveusa', 'shraddha.mhapralkar91', 'shiva1702', 'kpc.pardhu', 'jonilsoni', 'manohub', 'varadkardeep96', 'shweka147', 'yusun3', 'paruvelli.chandana', 'rsagrawal.avanti', 'deeksha893', 'agkonale', 'morry458', 'hatimkp63', 'sachindaniel', 'segomez1304', 'azadehfamili', 'saisupraj1994', 'chaxul', 'sgu201201146', 'vickygood15', 'id889632394', 'rohits2509', 'bksaif', 'mturi', 'anushreedavbhagalpur', 'pavkou123', 'shathorn', 'mandars222', 'hmelia', 'sgu20111560', 'rajanamit2', 'kishorbhosale', 'mirza338', 'seg2597', 'munagalavinodreddy', 'mahalepriyaja', 'pdoak', 'heli', 'anushka.4353.bansal', 'cmvdv', 'krithish13', 'baldassimassimo', 'gholamvz', 'datdang', 'yubai', 'nagapradeep97', 'jar2267', 'divya1537', 'venkat92', 'niketkothari92', 'bharat123', 'yyao46', 'rakeshrvndra', 'aakashmhankale1234', 'astillmaker', 'f_alshammari', 'mvikasraj123', 'jeet.shah2223', 'munagalavinod.r', 'arupsamanta', 'jeet_shah_2223', 'manikanta1773', 'mekkaoui', 'ramyakonidhala', 'jeetendave259', 'ppetros', 'rahulkr.1531', 'ceoelkers1995', 'sudzsharma', 'bhagatsingh91', 'gijsv', 'arlarson99', 'aditya09', 'jinadpatel919', 'justin.tan', 'nikhiliated', 'tippu70193', 'chaitanypaikara', '008dilip', 'antoniocarrera96', 'naviraja', 'chrislew14', 'tatikonda', 'abhi1singh2', 'haseeb.aktar123', 'samueltayishere', 'mirjivarsha', 'simrobson', 'varsham22', 'dhvanish17', 'zub12345', 'keescueta', 'karankantharia', 'lovkeshrishab', 'raymondbach1', 'bawischus', 'grubbies01', 'pranampranu', 'sasuveja950', 'calvinly', 'cvarner81', 'pablopelayo', 'amrithav', 'priya.r', 'shiva0193', 'singhmanohar360', 'cwid805670197', 'cjwestri', 'hgrewal', 'nanohubsocial', 'gitanshu', 'roryvang299', 'gulwelling', 'jeetshah23', 'acabhi07', 'sindhoor', 'kalyan4112', 'neeturaj', 'manishasa', 'prudvi125', 'rkrahi9']",16,"['mriganksh', 'rajeswarim81', 'hemanth297', 'nivedprakash1996', 'keerthana_bhogi', 'arijitmandal1994', 'muralikorada55', 'avinabsaha2018', None, 'srinivasramkumar', 'niharika25', 'harshit.roy30014', 'ankitkp4056', 'surya.veeragani7', 'p.geminisiva1998', 'saivineethkumar']",266,"['appa9731532495', 'jayasuryach3', 'sarath31', 'deep16', 'jiangy1', 'jagaamaa11', 'vandit93', 'elpaglia', 'gandhali', 'antoniocarrera', 'marcofratus', 'whenriquez', 'p.geminisiva1998', 'skyp0620', 'saisupraj', 'rko2saurav', 'chandana1', 'spittips101', 'rajeswarim81', 'antroy.rc', 'vineethvinny1997', '12kj', 'pourushsood', 'sairohith', 'pkrishnapritish', 'kumarvineeth14', 'celetldci', 'shaila', 'saivineethkumar', 'vaibhao14', 'dipanjandas1996', 'karthikeya', 'shreshta.0594', 'dishankyadav96', 'jdilig27', 'raveyjsn', 'harshit.roy30014', 'saisupraj1', 'razavi_nader', 'jonilsoni92', 'skyp0720', 'mitdalal', 'jinad803068899', 'amruthamma1998', 'jpneha', 'danbutman', '7adamzaheer7', 'ireymond1', 'shubham.kale27', 'rohitpetkar.r', 'tippu70099', '802730911manisha', 'balu8108', 'anirudhaga', 'gandhali4', 'santhosh1', 'kunalkhadke97', 'harsh12041997', 'nirajj100', 'muralikorada55', 'ishapadia', 'mitdalal15', '802964544_abdul', 'ramyanaine11', 'davide93', 'sim_ks', 'stella.s01', 'rushee2911', '2010ee179', 'manuelsalva182', 'hardikagrawal545', 'anjanmandal58', 'satakarni_amirneni', 'akshay12', 'cwid805705746', '556research2015', 'harkishangrewal', 'sittun.swayam', 'nanoprodigy', 'valgiadicerto', 'southbound280', 'munagalavinod', 'evineeth97', 'surabhikhadke77', 'sayantan2502iitkgp', 'xybiju', 'charankoushik', 'gberk2016', 'vikrant23', 'dineshkota007', 'mrcogito', 'agrawa64', 'mehta.rohan77', 'kandalavamshi111', 'priyanka456', 'sreevardhan25', 'saranyu', 'pukd56', 'askarmakar07', 'akshay13m', 'rayudhajit', 'saeed1368', 'rohith1234', 'yazayaga', 'eds3293', 'yuvsamratuday1997', 'saraheisenkolb', 'jayasuryach4', 'ireymond0', 'revanthkumar29', 'mirza_baig338', 'rajeshgoudvatnala1', 'tippu7002', 'sobriquet', 'jeetendaveusa', 'shraddha.mhapralkar91', 'abinashsena', 'shiva1702', 'kpc.pardhu', 'jonilsoni', 'manohub', 'varadkardeep96', 'shweka147', 'hemanth297', 'yusun3', 'nivedprakash1996', 'arijitmandal1994', 'paruvelli.chandana', 'rsagrawal.avanti', 'deeksha893', 'agkonale', 'gopa_97', 'morry458', 'hatimkp63', 'sachindaniel', 'segomez1304', 'azadehfamili', 'saisupraj1994', 'chaxul', 'sgu201201146', 'vickygood15', 'id889632394', 'rajdeep.biswas2010', 'rohits2509', 'bksaif', 'mturi', 'anushreedavbhagalpur', 'pavkou123', 'shathorn', 'mandars222', 'hmelia', 'sgu20111560', 'rajanamit2', 'kishorbhosale', 'mirza338', 'avinabsaha2018', 'kk55singh', 'seg2597', 'munagalavinodreddy', 'mahalepriyaja', 'pdoak', 'heli', 'anushka.4353.bansal', 'cmvdv', 'joshuapeterebenezer', 'krithish13', 'baldassimassimo', 'gholamvz', 'ankitkp4056', 'datdang', 'yubai', 'nagapradeep97', 'jar2267', 'divya1537', 'venkat92', 'arunganesh', 'niketkothari92', 'bharat123', 'deepthireddyparvatham12', 'yyao46', 'rakeshrvndra', 'aakashmhankale1234', 'astillmaker', 'ray_arka', 'prudvi1258', 'f_alshammari', 'surya.veeragani7', 'mvikasraj123', 'revanthreddy207', 'jeet.shah2223', 'beena11', 'munagalavinod.r', 'arupsamanta', 'rakesh207', 'jeet_shah_2223', 'manikanta1773', 'mekkaoui', 'ramyakonidhala', 'jeetendave259', 'ppetros', 'rahulkr.1531', 'srinivasramkumar', 'niharika25', 'kagitanikhil', 'ceoelkers1995', 'sudzsharma', 'bhagatsingh91', 'gijsv', 'tummalabalakrishna48', 'arlarson99', 'aditya09', 'jinadpatel919', 'justin.tan', 'nikhiliated', 'tippu70193', 'chaitanypaikara', '008dilip', 'antoniocarrera96', 'naviraja', 'shanka', 'chrislew14', 'tatikonda', 'abhi1singh2', 'haseeb.aktar123', 'samueltayishere', 'mirjivarsha', 'simrobson', 'varsham22', 'mriganksh', 'dhvanish17', 'shravanisistla1998', 'zub12345', 'keescueta', 'karankantharia', 'lovkeshrishab', 'raymondbach1', 'bawischus', 'keerthana_bhogi', 'grubbies01', 'pranampranu', 'sasuveja950', None, 'calvinly', 'cvarner81', 'pablopelayo', 'amrithav', 'priya.r', 'shiva0193', 'singhmanohar360', 'cwid805670197', 'cjwestri', 'hgrewal', 'nanohubsocial', 'gitanshu', 'roryvang299', 'gulwelling', 'jeetshah23', 'nitinkush16', 'acabhi07', 'sindhoor', 'kalyan4112', 'neeturaj', 'mayankpalaria', 'manishasa', 'prudvi125', 'rkrahi9']"
1,13,250,31,20,"['anirudhaga', 'harsh12041997', 'deep16', 'rsagrawal.avanti', 'rahulkr.1531', 'tummalabalakrishna48', 'rajdeep.biswas2010', 'antroy.rc', 'pourushsood', 'sairohith', 'pkrishnapritish', 'charankoushik', 'shravanisistla1998', 'kandalavamshi111', 'saranyu', 'bharat123', 'deepthireddyparvatham12', 'nitinkush16', 'ray_arka', 'mayankpalaria']",230,"['appa9731532495', 'jayasuryach3', 'sarath31', 'jiangy1', 'jagaamaa11', 'vandit93', 'elpaglia', 'gandhali', 'antoniocarrera', 'marcofratus', 'whenriquez', 'skyp0620', 'saisupraj', 'rko2saurav', 'chandana1', 'spittips101', 'vineethvinny1997', '12kj', 'kumarvineeth14', 'celetldci', 'shaila', 'vaibhao14', 'dipanjandas1996', 'karthikeya', 'shreshta.0594', 'dishankyadav96', 'jdilig27', 'raveyjsn', 'saisupraj1', 'razavi_nader', 'jonilsoni92', 'skyp0720', 'mitdalal', 'jinad803068899', 'amruthamma1998', 'jpneha', 'danbutman', '7adamzaheer7', 'ireymond1', 'shubham.kale27', 'rohitpetkar.r', 'tippu70099', '802730911manisha', 'balu8108', 'gandhali4', 'santhosh1', 'kunalkhadke97', 'nirajj100', 'ishapadia', 'mitdalal15', '802964544_abdul', 'ramyanaine11', 'davide93', 'sim_ks', 'stella.s01', 'rushee2911', '2010ee179', 'manuelsalva182', 'hardikagrawal545', 'anjanmandal58', 'satakarni_amirneni', 'akshay12', 'cwid805705746', '556research2015', 'harkishangrewal', 'sittun.swayam', 'nanoprodigy', 'valgiadicerto', 'southbound280', 'munagalavinod', 'evineeth97', 'surabhikhadke77', 'sayantan2502iitkgp', 'xybiju', 'gberk2016', 'vikrant23', 'dineshkota007', 'mrcogito', 'agrawa64', 'mehta.rohan77', 'priyanka456', 'sreevardhan25', 'pukd56', 'askarmakar07', 'akshay13m', 'rayudhajit', 'saeed1368', 'rohith1234', 'yazayaga', 'eds3293', 'yuvsamratuday1997', 'saraheisenkolb', 'jayasuryach4', 'ireymond0', 'revanthkumar29', 'mirza_baig338', 'rajeshgoudvatnala1', 'tippu7002', 'sobriquet', 'jeetendaveusa', 'shraddha.mhapralkar91', 'abinashsena', 'shiva1702', 'kpc.pardhu', 'jonilsoni', 'manohub', 'varadkardeep96', 'shweka147', 'yusun3', 'paruvelli.chandana', 'deeksha893', 'agkonale', 'gopa_97', 'morry458', 'hatimkp63', 'sachindaniel', 'segomez1304', 'azadehfamili', 'saisupraj1994', 'chaxul', 'sgu201201146', 'vickygood15', 'id889632394', 'rohits2509', 'bksaif', 'mturi', 'anushreedavbhagalpur', 'pavkou123', 'shathorn', 'mandars222', 'hmelia', 'sgu20111560', 'rajanamit2', 'kishorbhosale', 'mirza338', 'kk55singh', 'seg2597', 'munagalavinodreddy', 'mahalepriyaja', 'pdoak', 'heli', 'anushka.4353.bansal', 'cmvdv', 'joshuapeterebenezer', 'krithish13', 'baldassimassimo', 'gholamvz', 'datdang', 'yubai', 'nagapradeep97', 'jar2267', 'divya1537', 'venkat92', 'arunganesh', 'niketkothari92', 'yyao46', 'rakeshrvndra', 'aakashmhankale1234', 'astillmaker', 'prudvi1258', 'f_alshammari', 'mvikasraj123', 'revanthreddy207', 'jeet.shah2223', 'beena11', 'munagalavinod.r', 'arupsamanta', 'rakesh207', 'jeet_shah_2223', 'manikanta1773', 'mekkaoui', 'ramyakonidhala', 'jeetendave259', 'ppetros', 'kagitanikhil', 'ceoelkers1995', 'sudzsharma', 'bhagatsingh91', 'gijsv', 'arlarson99', 'aditya09', 'jinadpatel919', 'justin.tan', 'nikhiliated', 'tippu70193', 'chaitanypaikara', '008dilip', 'antoniocarrera96', 'naviraja', 'shanka', 'chrislew14', 'tatikonda', 'abhi1singh2', 'haseeb.aktar123', 'samueltayishere', 'mirjivarsha', 'simrobson', 'varsham22', 'dhvanish17', 'zub12345', 'keescueta', 'karankantharia', 'lovkeshrishab', 'raymondbach1', 'bawischus', 'grubbies01', 'pranampranu', 'sasuveja950', 'calvinly', 'cvarner81', 'pablopelayo', 'amrithav', 'priya.r', 'shiva0193', 'singhmanohar360', 'cwid805670197', 'cjwestri', 'hgrewal', 'nanohubsocial', 'gitanshu', 'roryvang299', 'gulwelling', 'jeetshah23', 'acabhi07', 'sindhoor', 'kalyan4112', 'neeturaj', 'manishasa', 'prudvi125', 'rkrahi9']",11,"['hemanth297', 'shanmukh17', 'nivedprakash1996', 'keerthana_bhogi', 'muralikorada55', 'abhi123', 'shubhra_19', 'swarnabha1997', 'p.geminisiva1998', None, 'ram2606']",261,"['appa9731532495', 'jayasuryach3', 'sarath31', 'deep16', 'jiangy1', 'jagaamaa11', 'vandit93', 'elpaglia', 'gandhali', 'antoniocarrera', 'marcofratus', 'whenriquez', 'p.geminisiva1998', 'skyp0620', 'saisupraj', 'rko2saurav', 'chandana1', 'spittips101', 'antroy.rc', 'vineethvinny1997', '12kj', 'pourushsood', 'sairohith', 'pkrishnapritish', 'kumarvineeth14', 'celetldci', 'shaila', 'vaibhao14', 'dipanjandas1996', 'karthikeya', 'shreshta.0594', 'dishankyadav96', 'jdilig27', 'raveyjsn', 'saisupraj1', 'razavi_nader', 'jonilsoni92', 'skyp0720', 'mitdalal', 'jinad803068899', 'amruthamma1998', 'jpneha', 'danbutman', '7adamzaheer7', 'ireymond1', 'shubham.kale27', 'rohitpetkar.r', 'tippu70099', '802730911manisha', 'balu8108', 'anirudhaga', 'gandhali4', 'santhosh1', 'kunalkhadke97', 'harsh12041997', 'nirajj100', 'muralikorada55', 'ishapadia', 'mitdalal15', '802964544_abdul', 'ramyanaine11', 'davide93', 'sim_ks', 'stella.s01', 'rushee2911', '2010ee179', 'manuelsalva182', 'hardikagrawal545', 'anjanmandal58', 'satakarni_amirneni', 'akshay12', 'cwid805705746', '556research2015', 'harkishangrewal', 'sittun.swayam', 'nanoprodigy', 'valgiadicerto', 'southbound280', 'shubhra_19', 'munagalavinod', 'evineeth97', 'surabhikhadke77', 'sayantan2502iitkgp', 'xybiju', 'charankoushik', 'gberk2016', 'vikrant23', 'dineshkota007', 'mrcogito', 'agrawa64', 'mehta.rohan77', 'kandalavamshi111', 'priyanka456', 'sreevardhan25', 'saranyu', 'pukd56', 'askarmakar07', 'akshay13m', 'rayudhajit', 'saeed1368', 'rohith1234', 'yazayaga', 'eds3293', 'yuvsamratuday1997', 'saraheisenkolb', 'jayasuryach4', 'ireymond0', 'revanthkumar29', 'mirza_baig338', 'rajeshgoudvatnala1', 'tippu7002', 'sobriquet', 'swarnabha1997', 'jeetendaveusa', 'shraddha.mhapralkar91', 'abinashsena', 'shiva1702', 'kpc.pardhu', 'jonilsoni', 'manohub', 'varadkardeep96', 'shweka147', 'hemanth297', 'yusun3', 'nivedprakash1996', 'paruvelli.chandana', 'rsagrawal.avanti', 'deeksha893', 'agkonale', 'gopa_97', 'morry458', 'hatimkp63', 'sachindaniel', 'segomez1304', 'azadehfamili', 'saisupraj1994', 'chaxul', 'sgu201201146', 'vickygood15', 'id889632394', 'rajdeep.biswas2010', 'rohits2509', 'bksaif', 'mturi', 'anushreedavbhagalpur', 'pavkou123', 'shathorn', 'mandars222', 'hmelia', 'sgu20111560', 'rajanamit2', 'kishorbhosale', 'mirza338', 'kk55singh', 'seg2597', 'munagalavinodreddy', 'ram2606', 'mahalepriyaja', 'pdoak', 'heli', 'anushka.4353.bansal', 'cmvdv', 'joshuapeterebenezer', 'krithish13', 'baldassimassimo', 'gholamvz', 'datdang', 'yubai', 'nagapradeep97', 'jar2267', 'divya1537', 'venkat92', 'arunganesh', 'niketkothari92', 'bharat123', 'shanmukh17', 'deepthireddyparvatham12', 'yyao46', 'rakeshrvndra', 'aakashmhankale1234', 'astillmaker', 'ray_arka', 'prudvi1258', 'f_alshammari', 'mvikasraj123', 'revanthreddy207', 'jeet.shah2223', 'beena11', 'munagalavinod.r', 'arupsamanta', 'rakesh207', 'jeet_shah_2223', 'manikanta1773', 'mekkaoui', 'ramyakonidhala', 'jeetendave259', 'ppetros', 'rahulkr.1531', 'kagitanikhil', 'ceoelkers1995', 'sudzsharma', 'bhagatsingh91', 'gijsv', 'tummalabalakrishna48', 'arlarson99', 'aditya09', 'jinadpatel919', 'justin.tan', 'nikhiliated', 'tippu70193', 'chaitanypaikara', '008dilip', 'antoniocarrera96', 'naviraja', 'shanka', 'chrislew14', 'tatikonda', 'abhi1singh2', 'haseeb.aktar123', 'samueltayishere', 'mirjivarsha', 'simrobson', 'varsham22', 'dhvanish17', 'shravanisistla1998', 'zub12345', 'keescueta', 'karankantharia', 'lovkeshrishab', 'raymondbach1', 'bawischus', 'keerthana_bhogi', 'abhi123', 'grubbies01', 'pranampranu', 'sasuveja950', None, 'calvinly', 'cvarner81', 'pablopelayo', 'amrithav', 'priya.r', 'shiva0193', 'singhmanohar360', 'cwid805670197', 'cjwestri', 'hgrewal', 'nanohubsocial', 'gitanshu', 'roryvang299', 'gulwelling', 'jeetshah23', 'nitinkush16', 'acabhi07', 'sindhoor', 'kalyan4112', 'neeturaj', 'mayankpalaria', 'manishasa', 'prudvi125', 'rkrahi9']"
1,289,250,30,14,"['anirudhaga', 'beena11', 'hardikagrawal545', 'joshuapeterebenezer', 'anjanmandal58', 'deepthireddyparvatham12', 'nitinkush16', 'rahulkr.1531', 'kandalavamshi111', 'shanka', 'ray_arka', 'mayankpalaria', 'saranyu', 'tummalabalakrishna48']",236,"['appa9731532495', 'jayasuryach3', 'sarath31', 'deep16', 'jiangy1', 'jagaamaa11', 'vandit93', 'elpaglia', 'gandhali', 'antoniocarrera', 'marcofratus', 'whenriquez', 'skyp0620', 'saisupraj', 'rko2saurav', 'chandana1', 'spittips101', 'antroy.rc', 'vineethvinny1997', '12kj', 'pourushsood', 'sairohith', 'pkrishnapritish', 'kumarvineeth14', 'celetldci', 'shaila', 'vaibhao14', 'dipanjandas1996', 'karthikeya', 'shreshta.0594', 'dishankyadav96', 'jdilig27', 'raveyjsn', 'saisupraj1', 'razavi_nader', 'jonilsoni92', 'skyp0720', 'mitdalal', 'jinad803068899', 'amruthamma1998', 'jpneha', 'danbutman', '7adamzaheer7', 'ireymond1', 'shubham.kale27', 'rohitpetkar.r', 'tippu70099', '802730911manisha', 'balu8108', 'gandhali4', 'santhosh1', 'kunalkhadke97', 'harsh12041997', 'nirajj100', 'ishapadia', 'mitdalal15', '802964544_abdul', 'ramyanaine11', 'davide93', 'sim_ks', 'stella.s01', 'rushee2911', '2010ee179', 'manuelsalva182', 'satakarni_amirneni', 'akshay12', 'cwid805705746', '556research2015', 'harkishangrewal', 'sittun.swayam', 'nanoprodigy', 'valgiadicerto', 'southbound280', 'munagalavinod', 'evineeth97', 'surabhikhadke77', 'sayantan2502iitkgp', 'xybiju', 'charankoushik', 'gberk2016', 'vikrant23', 'dineshkota007', 'mrcogito', 'agrawa64', 'mehta.rohan77', 'priyanka456', 'sreevardhan25', 'pukd56', 'askarmakar07', 'akshay13m', 'rayudhajit', 'saeed1368', 'rohith1234', 'yazayaga', 'eds3293', 'yuvsamratuday1997', 'saraheisenkolb', 'jayasuryach4', 'ireymond0', 'revanthkumar29', 'mirza_baig338', 'rajeshgoudvatnala1', 'tippu7002', 'sobriquet', 'jeetendaveusa', 'shraddha.mhapralkar91', 'abinashsena', 'shiva1702', 'kpc.pardhu', 'jonilsoni', 'manohub', 'varadkardeep96', 'shweka147', 'yusun3', 'paruvelli.chandana', 'rsagrawal.avanti', 'deeksha893', 'agkonale', 'gopa_97', 'morry458', 'hatimkp63', 'sachindaniel', 'segomez1304', 'azadehfamili', 'saisupraj1994', 'chaxul', 'sgu201201146', 'vickygood15', 'id889632394', 'rajdeep.biswas2010', 'rohits2509', 'bksaif', 'mturi', 'anushreedavbhagalpur', 'pavkou123', 'shathorn', 'mandars222', 'hmelia', 'sgu20111560', 'rajanamit2', 'kishorbhosale', 'mirza338', 'kk55singh', 'seg2597', 'munagalavinodreddy', 'mahalepriyaja', 'pdoak', 'heli', 'anushka.4353.bansal', 'cmvdv', 'krithish13', 'baldassimassimo', 'gholamvz', 'datdang', 'yubai', 'nagapradeep97', 'jar2267', 'divya1537', 'venkat92', 'arunganesh', 'niketkothari92', 'bharat123', 'yyao46', 'rakeshrvndra', 'aakashmhankale1234', 'astillmaker', 'prudvi1258', 'f_alshammari', 'mvikasraj123', 'revanthreddy207', 'jeet.shah2223', 'munagalavinod.r', 'arupsamanta', 'rakesh207', 'jeet_shah_2223', 'manikanta1773', 'mekkaoui', 'ramyakonidhala', 'jeetendave259', 'ppetros', 'kagitanikhil', 'ceoelkers1995', 'sudzsharma', 'bhagatsingh91', 'gijsv', 'arlarson99', 'aditya09', 'jinadpatel919', 'justin.tan', 'nikhiliated', 'tippu70193', 'chaitanypaikara', '008dilip', 'antoniocarrera96', 'naviraja', 'chrislew14', 'tatikonda', 'abhi1singh2', 'haseeb.aktar123', 'samueltayishere', 'mirjivarsha', 'simrobson', 'varsham22', 'dhvanish17', 'shravanisistla1998', 'zub12345', 'keescueta', 'karankantharia', 'lovkeshrishab', 'raymondbach1', 'bawischus', 'grubbies01', 'pranampranu', 'sasuveja950', 'calvinly', 'cvarner81', 'pablopelayo', 'amrithav', 'priya.r', 'shiva0193', 'singhmanohar360', 'cwid805670197', 'cjwestri', 'hgrewal', 'nanohubsocial', 'gitanshu', 'roryvang299', 'gulwelling', 'jeetshah23', 'acabhi07', 'sindhoor', 'kalyan4112', 'neeturaj', 'manishasa', 'prudvi125', 'rkrahi9']",16,"['rajeswarim81', 'kaustav1407', 'sumitarya1310', 'shanmukh17', 'keerthana_bhogi', 'siddharth.saharan96', 'siripranitha', 'utki.07', 'saurabhjai97', 'sm13497', 'swarnabha1997', 'pranju.0207', None, 'saivineethkumar', 'anirudhrachamalla', 'nupurbhaisare25']",266,"['appa9731532495', 'jayasuryach3', 'sarath31', 'deep16', 'jiangy1', 'jagaamaa11', 'vandit93', 'elpaglia', 'gandhali', 'antoniocarrera', 'marcofratus', 'whenriquez', 'skyp0620', 'anirudhrachamalla', 'saisupraj', 'rko2saurav', 'chandana1', 'spittips101', 'rajeswarim81', 'antroy.rc', 'vineethvinny1997', '12kj', 'pourushsood', 'sairohith', 'pkrishnapritish', 'kumarvineeth14', 'celetldci', 'shaila', 'saivineethkumar', 'vaibhao14', 'dipanjandas1996', 'karthikeya', 'shreshta.0594', 'dishankyadav96', 'jdilig27', 'raveyjsn', 'saisupraj1', 'razavi_nader', 'pranju.0207', 'jonilsoni92', 'sumitarya1310', 'skyp0720', 'mitdalal', 'jinad803068899', 'amruthamma1998', 'jpneha', 'danbutman', '7adamzaheer7', 'ireymond1', 'shubham.kale27', 'rohitpetkar.r', 'tippu70099', '802730911manisha', 'utki.07', 'balu8108', 'anirudhaga', 'gandhali4', 'santhosh1', 'kunalkhadke97', 'harsh12041997', 'nirajj100', 'ishapadia', 'mitdalal15', '802964544_abdul', 'ramyanaine11', 'davide93', 'sim_ks', 'stella.s01', 'rushee2911', '2010ee179', 'manuelsalva182', 'hardikagrawal545', 'anjanmandal58', 'satakarni_amirneni', 'akshay12', 'cwid805705746', '556research2015', 'harkishangrewal', 'sittun.swayam', 'nanoprodigy', 'valgiadicerto', 'southbound280', 'saurabhjai97', 'munagalavinod', 'evineeth97', 'surabhikhadke77', 'sayantan2502iitkgp', 'xybiju', 'charankoushik', 'gberk2016', 'vikrant23', 'dineshkota007', 'mrcogito', 'agrawa64', 'mehta.rohan77', 'kandalavamshi111', 'priyanka456', 'sreevardhan25', 'saranyu', 'pukd56', 'askarmakar07', 'akshay13m', 'rayudhajit', 'saeed1368', 'rohith1234', 'yazayaga', 'eds3293', 'yuvsamratuday1997', 'saraheisenkolb', 'siripranitha', 'jayasuryach4', 'ireymond0', 'revanthkumar29', 'mirza_baig338', 'rajeshgoudvatnala1', 'tippu7002', 'sobriquet', 'sm13497', 'swarnabha1997', 'jeetendaveusa', 'shraddha.mhapralkar91', 'siddharth.saharan96', 'abinashsena', 'shiva1702', 'kpc.pardhu', 'jonilsoni', 'manohub', 'varadkardeep96', 'shweka147', 'kaustav1407', 'yusun3', 'paruvelli.chandana', 'rsagrawal.avanti', 'deeksha893', 'agkonale', 'gopa_97', 'morry458', 'hatimkp63', 'sachindaniel', 'segomez1304', 'azadehfamili', 'saisupraj1994', 'chaxul', 'sgu201201146', 'vickygood15', 'id889632394', 'rajdeep.biswas2010', 'rohits2509', 'bksaif', 'mturi', 'anushreedavbhagalpur', 'pavkou123', 'shathorn', 'mandars222', 'hmelia', 'sgu20111560', 'rajanamit2', 'kishorbhosale', 'mirza338', 'kk55singh', 'seg2597', 'munagalavinodreddy', 'mahalepriyaja', 'pdoak', 'heli', 'anushka.4353.bansal', 'cmvdv', 'joshuapeterebenezer', 'krithish13', 'baldassimassimo', 'gholamvz', 'datdang', 'yubai', 'nagapradeep97', 'jar2267', 'divya1537', 'venkat92', 'arunganesh', 'niketkothari92', 'bharat123', 'shanmukh17', 'deepthireddyparvatham12', 'yyao46', 'rakeshrvndra', 'aakashmhankale1234', 'astillmaker', 'ray_arka', 'prudvi1258', 'f_alshammari', 'mvikasraj123', 'revanthreddy207', 'jeet.shah2223', 'beena11', 'munagalavinod.r', 'arupsamanta', 'rakesh207', 'jeet_shah_2223', 'manikanta1773', 'mekkaoui', 'ramyakonidhala', 'jeetendave259', 'ppetros', 'rahulkr.1531', 'kagitanikhil', 'ceoelkers1995', 'sudzsharma', 'bhagatsingh91', 'gijsv', 'tummalabalakrishna48', 'arlarson99', 'aditya09', 'jinadpatel919', 'justin.tan', 'nikhiliated', 'tippu70193', 'chaitanypaikara', '008dilip', 'antoniocarrera96', 'naviraja', 'shanka', 'chrislew14', 'tatikonda', 'abhi1singh2', 'haseeb.aktar123', 'samueltayishere', 'mirjivarsha', 'simrobson', 'varsham22', 'nupurbhaisare25', 'dhvanish17', 'shravanisistla1998', 'zub12345', 'keescueta', 'karankantharia', 'lovkeshrishab', 'raymondbach1', 'bawischus', 'keerthana_bhogi', 'grubbies01', 'pranampranu', 'sasuveja950', None, 'calvinly', 'cvarner81', 'pablopelayo', 'amrithav', 'priya.r', 'shiva0193', 'singhmanohar360', 'cwid805670197', 'cjwestri', 'hgrewal', 'nanohubsocial', 'gitanshu', 'roryvang299', 'gulwelling', 'jeetshah23', 'nitinkush16', 'acabhi07', 'sindhoor', 'kalyan4112', 'neeturaj', 'mayankpalaria', 'manishasa', 'prudvi125', 'rkrahi9']"
1,19,250,25,19,"['kunalkhadke97', 'beena11', 'rakesh207', 'kagitanikhil', 'sim_ks', 'sudzsharma', 'antroy.rc', 'hardikagrawal545', 'vineethvinny1997', 'pourushsood', 'sairohith', 'satakarni_amirneni', 'kumarvineeth14', 'dipanjandas1996', 'joshuapeterebenezer', 'dishankyadav96', 'deepthireddyparvatham12', 'nitinkush16', 'mayankpalaria']",231,"['appa9731532495', 'jayasuryach3', 'sarath31', 'deep16', 'jiangy1', 'jagaamaa11', 'vandit93', 'elpaglia', 'gandhali', 'antoniocarrera', 'marcofratus', 'whenriquez', 'skyp0620', 'saisupraj', 'rko2saurav', 'chandana1', 'spittips101', '12kj', 'pkrishnapritish', 'celetldci', 'shaila', 'vaibhao14', 'karthikeya', 'shreshta.0594', 'jdilig27', 'raveyjsn', 'saisupraj1', 'razavi_nader', 'jonilsoni92', 'skyp0720', 'mitdalal', 'jinad803068899', 'amruthamma1998', 'jpneha', 'danbutman', '7adamzaheer7', 'ireymond1', 'shubham.kale27', 'rohitpetkar.r', 'tippu70099', '802730911manisha', 'balu8108', 'anirudhaga', 'gandhali4', 'santhosh1', 'harsh12041997', 'nirajj100', 'ishapadia', 'mitdalal15', '802964544_abdul', 'ramyanaine11', 'davide93', 'stella.s01', 'rushee2911', '2010ee179', 'manuelsalva182', 'anjanmandal58', 'akshay12', 'cwid805705746', '556research2015', 'harkishangrewal', 'sittun.swayam', 'nanoprodigy', 'valgiadicerto', 'southbound280', 'munagalavinod', 'evineeth97', 'surabhikhadke77', 'sayantan2502iitkgp', 'xybiju', 'charankoushik', 'gberk2016', 'vikrant23', 'dineshkota007', 'mrcogito', 'agrawa64', 'mehta.rohan77', 'kandalavamshi111', 'priyanka456', 'sreevardhan25', 'saranyu', 'pukd56', 'askarmakar07', 'akshay13m', 'rayudhajit', 'saeed1368', 'rohith1234', 'yazayaga', 'eds3293', 'yuvsamratuday1997', 'saraheisenkolb', 'jayasuryach4', 'ireymond0', 'revanthkumar29', 'mirza_baig338', 'rajeshgoudvatnala1', 'tippu7002', 'sobriquet', 'jeetendaveusa', 'shraddha.mhapralkar91', 'abinashsena', 'shiva1702', 'kpc.pardhu', 'jonilsoni', 'manohub', 'varadkardeep96', 'shweka147', 'yusun3', 'paruvelli.chandana', 'rsagrawal.avanti', 'deeksha893', 'agkonale', 'gopa_97', 'morry458', 'hatimkp63', 'sachindaniel', 'segomez1304', 'azadehfamili', 'saisupraj1994', 'chaxul', 'sgu201201146', 'vickygood15', 'id889632394', 'rajdeep.biswas2010', 'rohits2509', 'bksaif', 'mturi', 'anushreedavbhagalpur', 'pavkou123', 'shathorn', 'mandars222', 'hmelia', 'sgu20111560', 'rajanamit2', 'kishorbhosale', 'mirza338', 'kk55singh', 'seg2597', 'munagalavinodreddy', 'mahalepriyaja', 'pdoak', 'heli', 'anushka.4353.bansal', 'cmvdv', 'krithish13', 'baldassimassimo', 'gholamvz', 'datdang', 'yubai', 'nagapradeep97', 'jar2267', 'divya1537', 'venkat92', 'arunganesh', 'niketkothari92', 'bharat123', 'yyao46', 'rakeshrvndra', 'aakashmhankale1234', 'astillmaker', 'ray_arka', 'prudvi1258', 'f_alshammari', 'mvikasraj123', 'revanthreddy207', 'jeet.shah2223', 'munagalavinod.r', 'arupsamanta', 'jeet_shah_2223', 'manikanta1773', 'mekkaoui', 'ramyakonidhala', 'jeetendave259', 'ppetros', 'rahulkr.1531', 'ceoelkers1995', 'bhagatsingh91', 'gijsv', 'tummalabalakrishna48', 'arlarson99', 'aditya09', 'jinadpatel919', 'justin.tan', 'nikhiliated', 'tippu70193', 'chaitanypaikara', '008dilip', 'antoniocarrera96', 'naviraja', 'shanka', 'chrislew14', 'tatikonda', 'abhi1singh2', 'haseeb.aktar123', 'samueltayishere', 'mirjivarsha', 'simrobson', 'varsham22', 'dhvanish17', 'shravanisistla1998', 'zub12345', 'keescueta', 'karankantharia', 'lovkeshrishab', 'raymondbach1', 'bawischus', 'grubbies01', 'pranampranu', 'sasuveja950', 'calvinly', 'cvarner81', 'pablopelayo', 'amrithav', 'priya.r', 'shiva0193', 'singhmanohar360', 'cwid805670197', 'cjwestri', 'hgrewal', 'nanohubsocial', 'gitanshu', 'roryvang299', 'gulwelling', 'jeetshah23', 'acabhi07', 'sindhoor', 'kalyan4112', 'neeturaj', 'manishasa', 'prudvi125', 'rkrahi9']",6,"['mriganksh', 'nivedprakash1996', 'keerthana_bhogi', 'niharika25', 'saumopal1997', None]",256,"['appa9731532495', 'jayasuryach3', 'sarath31', 'deep16', 'jiangy1', 'jagaamaa11', 'vandit93', 'elpaglia', 'gandhali', 'antoniocarrera', 'marcofratus', 'whenriquez', 'skyp0620', 'saisupraj', 'rko2saurav', 'chandana1', 'spittips101', 'antroy.rc', 'vineethvinny1997', '12kj', 'pourushsood', 'sairohith', 'pkrishnapritish', 'kumarvineeth14', 'celetldci', 'shaila', 'vaibhao14', 'dipanjandas1996', 'karthikeya', 'shreshta.0594', 'dishankyadav96', 'jdilig27', 'raveyjsn', 'saisupraj1', 'razavi_nader', 'jonilsoni92', 'skyp0720', 'mitdalal', 'jinad803068899', 'amruthamma1998', 'jpneha', 'danbutman', '7adamzaheer7', 'ireymond1', 'shubham.kale27', 'rohitpetkar.r', 'tippu70099', '802730911manisha', 'balu8108', 'anirudhaga', 'gandhali4', 'santhosh1', 'kunalkhadke97', 'harsh12041997', 'nirajj100', 'ishapadia', 'mitdalal15', '802964544_abdul', 'ramyanaine11', 'davide93', 'sim_ks', 'stella.s01', 'rushee2911', '2010ee179', 'manuelsalva182', 'hardikagrawal545', 'anjanmandal58', 'satakarni_amirneni', 'akshay12', 'cwid805705746', '556research2015', 'harkishangrewal', 'sittun.swayam', 'nanoprodigy', 'valgiadicerto', 'southbound280', 'munagalavinod', 'evineeth97', 'surabhikhadke77', 'sayantan2502iitkgp', 'xybiju', 'charankoushik', 'gberk2016', 'vikrant23', 'dineshkota007', 'mrcogito', 'agrawa64', 'mehta.rohan77', 'kandalavamshi111', 'priyanka456', 'sreevardhan25', 'saranyu', 'pukd56', 'askarmakar07', 'akshay13m', 'rayudhajit', 'saeed1368', 'rohith1234', 'yazayaga', 'eds3293', 'yuvsamratuday1997', 'saraheisenkolb', 'jayasuryach4', 'ireymond0', 'revanthkumar29', 'mirza_baig338', 'rajeshgoudvatnala1', 'tippu7002', 'sobriquet', 'jeetendaveusa', 'shraddha.mhapralkar91', 'abinashsena', 'shiva1702', 'kpc.pardhu', 'jonilsoni', 'manohub', 'varadkardeep96', 'shweka147', 'yusun3', 'nivedprakash1996', 'paruvelli.chandana', 'rsagrawal.avanti', 'deeksha893', 'agkonale', 'gopa_97', 'morry458', 'hatimkp63', 'sachindaniel', 'segomez1304', 'azadehfamili', 'saisupraj1994', 'chaxul', 'sgu201201146', 'vickygood15', 'id889632394', 'rajdeep.biswas2010', 'rohits2509', 'bksaif', 'mturi', 'anushreedavbhagalpur', 'pavkou123', 'shathorn', 'mandars222', 'hmelia', 'sgu20111560', 'rajanamit2', 'kishorbhosale', 'mirza338', 'kk55singh', 'seg2597', 'munagalavinodreddy', 'mahalepriyaja', 'pdoak', 'heli', 'anushka.4353.bansal', 'cmvdv', 'joshuapeterebenezer', 'krithish13', 'baldassimassimo', 'saumopal1997', 'gholamvz', 'datdang', 'yubai', 'nagapradeep97', 'jar2267', 'divya1537', 'venkat92', 'arunganesh', 'niketkothari92', 'bharat123', 'deepthireddyparvatham12', 'yyao46', 'rakeshrvndra', 'aakashmhankale1234', 'astillmaker', 'ray_arka', 'prudvi1258', 'f_alshammari', 'mvikasraj123', 'revanthreddy207', 'jeet.shah2223', 'beena11', 'munagalavinod.r', 'arupsamanta', 'rakesh207', 'jeet_shah_2223', 'manikanta1773', 'mekkaoui', 'ramyakonidhala', 'jeetendave259', 'ppetros', 'rahulkr.1531', 'niharika25', 'kagitanikhil', 'ceoelkers1995', 'sudzsharma', 'bhagatsingh91', 'gijsv', 'tummalabalakrishna48', 'arlarson99', 'aditya09', 'jinadpatel919', 'justin.tan', 'nikhiliated', 'tippu70193', 'chaitanypaikara', '008dilip', 'antoniocarrera96', 'naviraja', 'shanka', 'chrislew14', 'tatikonda', 'abhi1singh2', 'haseeb.aktar123', 'samueltayishere', 'mirjivarsha', 'simrobson', 'varsham22', 'mriganksh', 'dhvanish17', 'shravanisistla1998', 'zub12345', 'keescueta', 'karankantharia', 'lovkeshrishab', 'raymondbach1', 'bawischus', 'keerthana_bhogi', 'grubbies01', 'pranampranu', 'sasuveja950', None, 'calvinly', 'cvarner81', 'pablopelayo', 'amrithav', 'priya.r', 'shiva0193', 'singhmanohar360', 'cwid805670197', 'cjwestri', 'hgrewal', 'nanohubsocial', 'gitanshu', 'roryvang299', 'gulwelling', 'jeetshah23', 'nitinkush16', 'acabhi07', 'sindhoor', 'kalyan4112', 'neeturaj', 'mayankpalaria', 'manishasa', 'prudvi125', 'rkrahi9']"
1,15,250,18,17,"['kpc.pardhu', 'venkat92', 'shweka147', 'zub12345', 'manikanta1773', 'cjwestri', 'akshay12', 'ramyakonidhala', 'gitanshu', '008dilip', 'antoniocarrera96', 'sindhoor', 'tatikonda', 'antoniocarrera', '802964544_abdul', 'ramyanaine11', 'datdang']",233,"['appa9731532495', 'jayasuryach3', 'sarath31', 'deep16', 'jiangy1', 'jagaamaa11', 'vandit93', 'elpaglia', 'gandhali', 'marcofratus', 'whenriquez', 'skyp0620', 'saisupraj', 'rko2saurav', 'chandana1', 'spittips101', 'antroy.rc', 'vineethvinny1997', '12kj', 'pourushsood', 'sairohith', 'pkrishnapritish', 'kumarvineeth14', 'celetldci', 'shaila', 'vaibhao14', 'dipanjandas1996', 'karthikeya', 'shreshta.0594', 'dishankyadav96', 'jdilig27', 'raveyjsn', 'saisupraj1', 'razavi_nader', 'jonilsoni92', 'skyp0720', 'mitdalal', 'jinad803068899', 'amruthamma1998', 'jpneha', 'danbutman', '7adamzaheer7', 'ireymond1', 'shubham.kale27', 'rohitpetkar.r', 'tippu70099', '802730911manisha', 'balu8108', 'anirudhaga', 'gandhali4', 'santhosh1', 'kunalkhadke97', 'harsh12041997', 'nirajj100', 'ishapadia', 'mitdalal15', 'davide93', 'sim_ks', 'stella.s01', 'rushee2911', '2010ee179', 'manuelsalva182', 'hardikagrawal545', 'anjanmandal58', 'satakarni_amirneni', 'cwid805705746', '556research2015', 'harkishangrewal', 'sittun.swayam', 'nanoprodigy', 'valgiadicerto', 'southbound280', 'munagalavinod', 'evineeth97', 'surabhikhadke77', 'sayantan2502iitkgp', 'xybiju', 'charankoushik', 'gberk2016', 'vikrant23', 'dineshkota007', 'mrcogito', 'agrawa64', 'mehta.rohan77', 'kandalavamshi111', 'priyanka456', 'sreevardhan25', 'saranyu', 'pukd56', 'askarmakar07', 'akshay13m', 'rayudhajit', 'saeed1368', 'rohith1234', 'yazayaga', 'eds3293', 'yuvsamratuday1997', 'saraheisenkolb', 'jayasuryach4', 'ireymond0', 'revanthkumar29', 'mirza_baig338', 'rajeshgoudvatnala1', 'tippu7002', 'sobriquet', 'jeetendaveusa', 'shraddha.mhapralkar91', 'abinashsena', 'shiva1702', 'jonilsoni', 'manohub', 'varadkardeep96', 'yusun3', 'paruvelli.chandana', 'rsagrawal.avanti', 'deeksha893', 'agkonale', 'gopa_97', 'morry458', 'hatimkp63', 'sachindaniel', 'segomez1304', 'azadehfamili', 'saisupraj1994', 'chaxul', 'sgu201201146', 'vickygood15', 'id889632394', 'rajdeep.biswas2010', 'rohits2509', 'bksaif', 'mturi', 'anushreedavbhagalpur', 'pavkou123', 'shathorn', 'mandars222', 'hmelia', 'sgu20111560', 'rajanamit2', 'kishorbhosale', 'mirza338', 'kk55singh', 'seg2597', 'munagalavinodreddy', 'mahalepriyaja', 'pdoak', 'heli', 'anushka.4353.bansal', 'cmvdv', 'joshuapeterebenezer', 'krithish13', 'baldassimassimo', 'gholamvz', 'yubai', 'nagapradeep97', 'jar2267', 'divya1537', 'arunganesh', 'niketkothari92', 'bharat123', 'deepthireddyparvatham12', 'yyao46', 'rakeshrvndra', 'aakashmhankale1234', 'astillmaker', 'ray_arka', 'prudvi1258', 'f_alshammari', 'mvikasraj123', 'revanthreddy207', 'jeet.shah2223', 'beena11', 'munagalavinod.r', 'arupsamanta', 'rakesh207', 'jeet_shah_2223', 'mekkaoui', 'jeetendave259', 'ppetros', 'rahulkr.1531', 'kagitanikhil', 'ceoelkers1995', 'sudzsharma', 'bhagatsingh91', 'gijsv', 'tummalabalakrishna48', 'arlarson99', 'aditya09', 'jinadpatel919', 'justin.tan', 'nikhiliated', 'tippu70193', 'chaitanypaikara', 'naviraja', 'shanka', 'chrislew14', 'abhi1singh2', 'haseeb.aktar123', 'samueltayishere', 'mirjivarsha', 'simrobson', 'varsham22', 'dhvanish17', 'shravanisistla1998', 'keescueta', 'karankantharia', 'lovkeshrishab', 'raymondbach1', 'bawischus', 'grubbies01', 'pranampranu', 'sasuveja950', 'calvinly', 'cvarner81', 'pablopelayo', 'amrithav', 'priya.r', 'shiva0193', 'singhmanohar360', 'cwid805670197', 'hgrewal', 'nanohubsocial', 'roryvang299', 'gulwelling', 'jeetshah23', 'nitinkush16', 'acabhi07', 'kalyan4112', 'neeturaj', 'mayankpalaria', 'manishasa', 'prudvi125', 'rkrahi9']",1,[None],251,"['appa9731532495', 'jayasuryach3', 'sarath31', 'deep16', 'jiangy1', 'jagaamaa11', 'vandit93', 'elpaglia', 'gandhali', 'antoniocarrera', 'marcofratus', 'whenriquez', 'skyp0620', 'saisupraj', 'rko2saurav', 'chandana1', 'spittips101', 'antroy.rc', 'vineethvinny1997', '12kj', 'pourushsood', 'sairohith', 'pkrishnapritish', 'kumarvineeth14', 'celetldci', 'shaila', 'vaibhao14', 'dipanjandas1996', 'karthikeya', 'shreshta.0594', 'dishankyadav96', 'jdilig27', 'raveyjsn', 'saisupraj1', 'razavi_nader', 'jonilsoni92', 'skyp0720', 'mitdalal', 'jinad803068899', 'amruthamma1998', 'jpneha', 'danbutman', '7adamzaheer7', 'ireymond1', 'shubham.kale27', 'rohitpetkar.r', 'tippu70099', '802730911manisha', 'balu8108', 'anirudhaga', 'gandhali4', 'santhosh1', 'kunalkhadke97', 'harsh12041997', 'nirajj100', 'ishapadia', 'mitdalal15', '802964544_abdul', 'ramyanaine11', 'davide93', 'sim_ks', 'stella.s01', 'rushee2911', '2010ee179', 'manuelsalva182', 'hardikagrawal545', 'anjanmandal58', 'satakarni_amirneni', 'akshay12', 'cwid805705746', '556research2015', 'harkishangrewal', 'sittun.swayam', 'nanoprodigy', 'valgiadicerto', 'southbound280', 'munagalavinod', 'evineeth97', 'surabhikhadke77', 'sayantan2502iitkgp', 'xybiju', 'charankoushik', 'gberk2016', 'vikrant23', 'dineshkota007', 'mrcogito', 'agrawa64', 'mehta.rohan77', 'kandalavamshi111', 'priyanka456', 'sreevardhan25', 'saranyu', 'pukd56', 'askarmakar07', 'akshay13m', 'rayudhajit', 'saeed1368', 'rohith1234', 'yazayaga', 'eds3293', 'yuvsamratuday1997', 'saraheisenkolb', 'jayasuryach4', 'ireymond0', 'revanthkumar29', 'mirza_baig338', 'rajeshgoudvatnala1', 'tippu7002', 'sobriquet', 'jeetendaveusa', 'shraddha.mhapralkar91', 'abinashsena', 'shiva1702', 'kpc.pardhu', 'jonilsoni', 'manohub', 'varadkardeep96', 'shweka147', 'yusun3', 'paruvelli.chandana', 'rsagrawal.avanti', 'deeksha893', 'agkonale', 'gopa_97', 'morry458', 'hatimkp63', 'sachindaniel', 'segomez1304', 'azadehfamili', 'saisupraj1994', 'chaxul', 'sgu201201146', 'vickygood15', 'id889632394', 'rajdeep.biswas2010', 'rohits2509', 'bksaif', 'mturi', 'anushreedavbhagalpur', 'pavkou123', 'shathorn', 'mandars222', 'hmelia', 'sgu20111560', 'rajanamit2', 'kishorbhosale', 'mirza338', 'kk55singh', 'seg2597', 'munagalavinodreddy', 'mahalepriyaja', 'pdoak', 'heli', 'anushka.4353.bansal', 'cmvdv', 'joshuapeterebenezer', 'krithish13', 'baldassimassimo', 'gholamvz', 'datdang', 'yubai', 'nagapradeep97', 'jar2267', 'divya1537', 'venkat92', 'arunganesh', 'niketkothari92', 'bharat123', 'deepthireddyparvatham12', 'yyao46', 'rakeshrvndra', 'aakashmhankale1234', 'astillmaker', 'ray_arka', 'prudvi1258', 'f_alshammari', 'mvikasraj123', 'revanthreddy207', 'jeet.shah2223', 'beena11', 'munagalavinod.r', 'arupsamanta', 'rakesh207', 'jeet_shah_2223', 'manikanta1773', 'mekkaoui', 'ramyakonidhala', 'jeetendave259', 'ppetros', 'rahulkr.1531', 'kagitanikhil', 'ceoelkers1995', 'sudzsharma', 'bhagatsingh91', 'gijsv', 'tummalabalakrishna48', 'arlarson99', 'aditya09', 'jinadpatel919', 'justin.tan', 'nikhiliated', 'tippu70193', 'chaitanypaikara', '008dilip', 'antoniocarrera96', 'naviraja', 'shanka', 'chrislew14', 'tatikonda', 'abhi1singh2', 'haseeb.aktar123', 'samueltayishere', 'mirjivarsha', 'simrobson', 'varsham22', 'dhvanish17', 'shravanisistla1998', 'zub12345', 'keescueta', 'karankantharia', 'lovkeshrishab', 'raymondbach1', 'bawischus', 'grubbies01', 'pranampranu', 'sasuveja950', None, 'calvinly', 'cvarner81', 'pablopelayo', 'amrithav', 'priya.r', 'shiva0193', 'singhmanohar360', 'cwid805670197', 'cjwestri', 'hgrewal', 'nanohubsocial', 'gitanshu', 'roryvang299', 'gulwelling', 'jeetshah23', 'nitinkush16', 'acabhi07', 'sindhoor', 'kalyan4112', 'neeturaj', 'mayankpalaria', 'manishasa', 'prudvi125', 'rkrahi9']"
1,7,250,15,11,"['gberk2016', 'justin.tan', 'hmelia', 'mrcogito', 'roryvang299', 'jiangy1', 'sobriquet', 'chrislew14', 'simrobson', 'stella.s01', 'gijsv']",239,"['appa9731532495', 'jayasuryach3', 'sarath31', 'deep16', 'jagaamaa11', 'vandit93', 'elpaglia', 'gandhali', 'antoniocarrera', 'marcofratus', 'whenriquez', 'skyp0620', 'saisupraj', 'rko2saurav', 'chandana1', 'spittips101', 'antroy.rc', 'vineethvinny1997', '12kj', 'pourushsood', 'sairohith', 'pkrishnapritish', 'kumarvineeth14', 'celetldci', 'shaila', 'vaibhao14', 'dipanjandas1996', 'karthikeya', 'shreshta.0594', 'dishankyadav96', 'jdilig27', 'raveyjsn', 'saisupraj1', 'razavi_nader', 'jonilsoni92', 'skyp0720', 'mitdalal', 'jinad803068899', 'amruthamma1998', 'jpneha', 'danbutman', '7adamzaheer7', 'ireymond1', 'shubham.kale27', 'rohitpetkar.r', 'tippu70099', '802730911manisha', 'balu8108', 'anirudhaga', 'gandhali4', 'santhosh1', 'kunalkhadke97', 'harsh12041997', 'nirajj100', 'ishapadia', 'mitdalal15', '802964544_abdul', 'ramyanaine11', 'davide93', 'sim_ks', 'rushee2911', '2010ee179', 'manuelsalva182', 'hardikagrawal545', 'anjanmandal58', 'satakarni_amirneni', 'akshay12', 'cwid805705746', '556research2015', 'harkishangrewal', 'sittun.swayam', 'nanoprodigy', 'valgiadicerto', 'southbound280', 'munagalavinod', 'evineeth97', 'surabhikhadke77', 'sayantan2502iitkgp', 'xybiju', 'charankoushik', 'vikrant23', 'dineshkota007', 'agrawa64', 'mehta.rohan77', 'kandalavamshi111', 'priyanka456', 'sreevardhan25', 'saranyu', 'pukd56', 'askarmakar07', 'akshay13m', 'rayudhajit', 'saeed1368', 'rohith1234', 'yazayaga', 'eds3293', 'yuvsamratuday1997', 'saraheisenkolb', 'jayasuryach4', 'ireymond0', 'revanthkumar29', 'mirza_baig338', 'rajeshgoudvatnala1', 'tippu7002', 'jeetendaveusa', 'shraddha.mhapralkar91', 'abinashsena', 'shiva1702', 'kpc.pardhu', 'jonilsoni', 'manohub', 'varadkardeep96', 'shweka147', 'yusun3', 'paruvelli.chandana', 'rsagrawal.avanti', 'deeksha893', 'agkonale', 'gopa_97', 'morry458', 'hatimkp63', 'sachindaniel', 'segomez1304', 'azadehfamili', 'saisupraj1994', 'chaxul', 'sgu201201146', 'vickygood15', 'id889632394', 'rajdeep.biswas2010', 'rohits2509', 'bksaif', 'mturi', 'anushreedavbhagalpur', 'pavkou123', 'shathorn', 'mandars222', 'sgu20111560', 'rajanamit2', 'kishorbhosale', 'mirza338', 'kk55singh', 'seg2597', 'munagalavinodreddy', 'mahalepriyaja', 'pdoak', 'heli', 'anushka.4353.bansal', 'cmvdv', 'joshuapeterebenezer', 'krithish13', 'baldassimassimo', 'gholamvz', 'datdang', 'yubai', 'nagapradeep97', 'jar2267', 'divya1537', 'venkat92', 'arunganesh', 'niketkothari92', 'bharat123', 'deepthireddyparvatham12', 'yyao46', 'rakeshrvndra', 'aakashmhankale1234', 'astillmaker', 'ray_arka', 'prudvi1258', 'f_alshammari', 'mvikasraj123', 'revanthreddy207', 'jeet.shah2223', 'beena11', 'munagalavinod.r', 'arupsamanta', 'rakesh207', 'jeet_shah_2223', 'manikanta1773', 'mekkaoui', 'ramyakonidhala', 'jeetendave259', 'ppetros', 'rahulkr.1531', 'kagitanikhil', 'ceoelkers1995', 'sudzsharma', 'bhagatsingh91', 'tummalabalakrishna48', 'arlarson99', 'aditya09', 'jinadpatel919', 'nikhiliated', 'tippu70193', 'chaitanypaikara', '008dilip', 'antoniocarrera96', 'naviraja', 'shanka', 'tatikonda', 'abhi1singh2', 'haseeb.aktar123', 'samueltayishere', 'mirjivarsha', 'varsham22', 'dhvanish17', 'shravanisistla1998', 'zub12345', 'keescueta', 'karankantharia', 'lovkeshrishab', 'raymondbach1', 'bawischus', 'grubbies01', 'pranampranu', 'sasuveja950', 'calvinly', 'cvarner81', 'pablopelayo', 'amrithav', 'priya.r', 'shiva0193', 'singhmanohar360', 'cwid805670197', 'cjwestri', 'hgrewal', 'nanohubsocial', 'gitanshu', 'gulwelling', 'jeetshah23', 'nitinkush16', 'acabhi07', 'sindhoor', 'kalyan4112', 'neeturaj', 'mayankpalaria', 'manishasa', 'prudvi125', 'rkrahi9']",4,"['mmatsuoka899', None, 'jeffreym', 'htsunimelb']",254,"['appa9731532495', 'jayasuryach3', 'sarath31', 'deep16', 'jiangy1', 'jagaamaa11', 'vandit93', 'elpaglia', 'gandhali', 'antoniocarrera', 'marcofratus', 'whenriquez', 'skyp0620', 'saisupraj', 'rko2saurav', 'chandana1', 'spittips101', 'antroy.rc', 'vineethvinny1997', '12kj', 'pourushsood', 'sairohith', 'pkrishnapritish', 'kumarvineeth14', 'celetldci', 'shaila', 'vaibhao14', 'dipanjandas1996', 'karthikeya', 'shreshta.0594', 'dishankyadav96', 'jdilig27', 'raveyjsn', 'saisupraj1', 'razavi_nader', 'jonilsoni92', 'skyp0720', 'mitdalal', 'jinad803068899', 'amruthamma1998', 'jpneha', 'danbutman', '7adamzaheer7', 'ireymond1', 'shubham.kale27', 'rohitpetkar.r', 'tippu70099', '802730911manisha', 'balu8108', 'anirudhaga', 'gandhali4', 'santhosh1', 'kunalkhadke97', 'harsh12041997', 'nirajj100', 'ishapadia', 'mitdalal15', 'jeffreym', '802964544_abdul', 'ramyanaine11', 'davide93', 'sim_ks', 'stella.s01', 'rushee2911', '2010ee179', 'manuelsalva182', 'hardikagrawal545', 'anjanmandal58', 'satakarni_amirneni', 'akshay12', 'cwid805705746', '556research2015', 'harkishangrewal', 'sittun.swayam', 'nanoprodigy', 'valgiadicerto', 'southbound280', 'munagalavinod', 'evineeth97', 'surabhikhadke77', 'sayantan2502iitkgp', 'xybiju', 'charankoushik', 'gberk2016', 'vikrant23', 'dineshkota007', 'mrcogito', 'agrawa64', 'mehta.rohan77', 'kandalavamshi111', 'priyanka456', 'sreevardhan25', 'saranyu', 'pukd56', 'askarmakar07', 'akshay13m', 'rayudhajit', 'saeed1368', 'rohith1234', 'yazayaga', 'eds3293', 'yuvsamratuday1997', 'saraheisenkolb', 'jayasuryach4', 'ireymond0', 'revanthkumar29', 'mirza_baig338', 'rajeshgoudvatnala1', 'tippu7002', 'sobriquet', 'jeetendaveusa', 'shraddha.mhapralkar91', 'abinashsena', 'shiva1702', 'kpc.pardhu', 'jonilsoni', 'manohub', 'varadkardeep96', 'shweka147', 'yusun3', 'paruvelli.chandana', 'rsagrawal.avanti', 'deeksha893', 'agkonale', 'gopa_97', 'morry458', 'hatimkp63', 'sachindaniel', 'segomez1304', 'azadehfamili', 'saisupraj1994', 'chaxul', 'sgu201201146', 'vickygood15', 'id889632394', 'rajdeep.biswas2010', 'rohits2509', 'bksaif', 'mturi', 'anushreedavbhagalpur', 'pavkou123', 'shathorn', 'mandars222', 'hmelia', 'sgu20111560', 'rajanamit2', 'kishorbhosale', 'mirza338', 'kk55singh', 'seg2597', 'munagalavinodreddy', 'mahalepriyaja', 'pdoak', 'heli', 'anushka.4353.bansal', 'cmvdv', 'joshuapeterebenezer', 'htsunimelb', 'krithish13', 'baldassimassimo', 'gholamvz', 'datdang', 'yubai', 'nagapradeep97', 'jar2267', 'divya1537', 'venkat92', 'arunganesh', 'niketkothari92', 'bharat123', 'deepthireddyparvatham12', 'yyao46', 'rakeshrvndra', 'aakashmhankale1234', 'astillmaker', 'ray_arka', 'prudvi1258', 'f_alshammari', 'mvikasraj123', 'revanthreddy207', 'jeet.shah2223', 'beena11', 'munagalavinod.r', 'arupsamanta', 'rakesh207', 'jeet_shah_2223', 'manikanta1773', 'mekkaoui', 'ramyakonidhala', 'jeetendave259', 'ppetros', 'rahulkr.1531', 'kagitanikhil', 'ceoelkers1995', 'sudzsharma', 'bhagatsingh91', 'gijsv', 'tummalabalakrishna48', 'arlarson99', 'aditya09', 'jinadpatel919', 'justin.tan', 'nikhiliated', 'tippu70193', 'chaitanypaikara', '008dilip', 'antoniocarrera96', 'naviraja', 'shanka', 'chrislew14', 'tatikonda', 'abhi1singh2', 'haseeb.aktar123', 'samueltayishere', 'mirjivarsha', 'simrobson', 'varsham22', 'dhvanish17', 'shravanisistla1998', 'zub12345', 'keescueta', 'karankantharia', 'lovkeshrishab', 'raymondbach1', 'bawischus', 'grubbies01', 'pranampranu', 'mmatsuoka899', 'sasuveja950', None, 'calvinly', 'cvarner81', 'pablopelayo', 'amrithav', 'priya.r', 'shiva0193', 'singhmanohar360', 'cwid805670197', 'cjwestri', 'hgrewal', 'nanohubsocial', 'gitanshu', 'roryvang299', 'gulwelling', 'jeetshah23', 'nitinkush16', 'acabhi07', 'sindhoor', 'kalyan4112', 'neeturaj', 'mayankpalaria', 'manishasa', 'prudvi125', 'rkrahi9']"
1,8,250,13,2,"['sgu201201146', 'sgu20111560']",248,"['appa9731532495', 'jayasuryach3', 'sarath31', 'deep16', 'jiangy1', 'jagaamaa11', 'vandit93', 'elpaglia', 'gandhali', 'antoniocarrera', 'marcofratus', 'whenriquez', 'skyp0620', 'saisupraj', 'rko2saurav', 'chandana1', 'spittips101', 'antroy.rc', 'vineethvinny1997', '12kj', 'pourushsood', 'sairohith', 'pkrishnapritish', 'kumarvineeth14', 'celetldci', 'shaila', 'vaibhao14', 'dipanjandas1996', 'karthikeya', 'shreshta.0594', 'dishankyadav96', 'jdilig27', 'raveyjsn', 'saisupraj1', 'razavi_nader', 'jonilsoni92', 'skyp0720', 'mitdalal', 'jinad803068899', 'amruthamma1998', 'jpneha', 'danbutman', '7adamzaheer7', 'ireymond1', 'shubham.kale27', 'rohitpetkar.r', 'tippu70099', '802730911manisha', 'balu8108', 'anirudhaga', 'gandhali4', 'santhosh1', 'kunalkhadke97', 'harsh12041997', 'nirajj100', 'ishapadia', 'mitdalal15', '802964544_abdul', 'ramyanaine11', 'davide93', 'sim_ks', 'stella.s01', 'rushee2911', '2010ee179', 'manuelsalva182', 'hardikagrawal545', 'anjanmandal58', 'satakarni_amirneni', 'akshay12', 'cwid805705746', '556research2015', 'harkishangrewal', 'sittun.swayam', 'nanoprodigy', 'valgiadicerto', 'southbound280', 'munagalavinod', 'evineeth97', 'surabhikhadke77', 'sayantan2502iitkgp', 'xybiju', 'charankoushik', 'gberk2016', 'vikrant23', 'dineshkota007', 'mrcogito', 'agrawa64', 'mehta.rohan77', 'kandalavamshi111', 'priyanka456', 'sreevardhan25', 'saranyu', 'pukd56', 'askarmakar07', 'akshay13m', 'rayudhajit', 'saeed1368', 'rohith1234', 'yazayaga', 'eds3293', 'yuvsamratuday1997', 'saraheisenkolb', 'jayasuryach4', 'ireymond0', 'revanthkumar29', 'mirza_baig338', 'rajeshgoudvatnala1', 'tippu7002', 'sobriquet', 'jeetendaveusa', 'shraddha.mhapralkar91', 'abinashsena', 'shiva1702', 'kpc.pardhu', 'jonilsoni', 'manohub', 'varadkardeep96', 'shweka147', 'yusun3', 'paruvelli.chandana', 'rsagrawal.avanti', 'deeksha893', 'agkonale', 'gopa_97', 'morry458', 'hatimkp63', 'sachindaniel', 'segomez1304', 'azadehfamili', 'saisupraj1994', 'chaxul', 'vickygood15', 'id889632394', 'rajdeep.biswas2010', 'rohits2509', 'bksaif', 'mturi', 'anushreedavbhagalpur', 'pavkou123', 'shathorn', 'mandars222', 'hmelia', 'rajanamit2', 'kishorbhosale', 'mirza338', 'kk55singh', 'seg2597', 'munagalavinodreddy', 'mahalepriyaja', 'pdoak', 'heli', 'anushka.4353.bansal', 'cmvdv', 'joshuapeterebenezer', 'krithish13', 'baldassimassimo', 'gholamvz', 'datdang', 'yubai', 'nagapradeep97', 'jar2267', 'divya1537', 'venkat92', 'arunganesh', 'niketkothari92', 'bharat123', 'deepthireddyparvatham12', 'yyao46', 'rakeshrvndra', 'aakashmhankale1234', 'astillmaker', 'ray_arka', 'prudvi1258', 'f_alshammari', 'mvikasraj123', 'revanthreddy207', 'jeet.shah2223', 'beena11', 'munagalavinod.r', 'arupsamanta', 'rakesh207', 'jeet_shah_2223', 'manikanta1773', 'mekkaoui', 'ramyakonidhala', 'jeetendave259', 'ppetros', 'rahulkr.1531', 'kagitanikhil', 'ceoelkers1995', 'sudzsharma', 'bhagatsingh91', 'gijsv', 'tummalabalakrishna48', 'arlarson99', 'aditya09', 'jinadpatel919', 'justin.tan', 'nikhiliated', 'tippu70193', 'chaitanypaikara', '008dilip', 'antoniocarrera96', 'naviraja', 'shanka', 'chrislew14', 'tatikonda', 'abhi1singh2', 'haseeb.aktar123', 'samueltayishere', 'mirjivarsha', 'simrobson', 'varsham22', 'dhvanish17', 'shravanisistla1998', 'zub12345', 'keescueta', 'karankantharia', 'lovkeshrishab', 'raymondbach1', 'bawischus', 'grubbies01', 'pranampranu', 'sasuveja950', 'calvinly', 'cvarner81', 'pablopelayo', 'amrithav', 'priya.r', 'shiva0193', 'singhmanohar360', 'cwid805670197', 'cjwestri', 'hgrewal', 'nanohubsocial', 'gitanshu', 'roryvang299', 'gulwelling', 'jeetshah23', 'nitinkush16', 'acabhi07', 'sindhoor', 'kalyan4112', 'neeturaj', 'mayankpalaria', 'manishasa', 'prudvi125', 'rkrahi9']",11,"['sgu20111577', 'sgu20131480', 'sgu20121450', 'sgu20121468', 'sgu20111399', 'guheak92', 'dogp27', 'sgu20111478', 'sgu20121481', None, 'carjehee']",261,"['appa9731532495', 'jayasuryach3', 'sarath31', 'deep16', 'jiangy1', 'jagaamaa11', 'vandit93', 'elpaglia', 'gandhali', 'antoniocarrera', 'marcofratus', 'whenriquez', 'skyp0620', 'saisupraj', 'rko2saurav', 'chandana1', 'spittips101', 'antroy.rc', 'vineethvinny1997', '12kj', 'pourushsood', 'sairohith', 'pkrishnapritish', 'sgu20121468', 'kumarvineeth14', 'celetldci', 'shaila', 'vaibhao14', 'dipanjandas1996', 'karthikeya', 'shreshta.0594', 'dishankyadav96', 'sgu20131480', 'jdilig27', 'raveyjsn', 'saisupraj1', 'razavi_nader', 'jonilsoni92', 'skyp0720', 'mitdalal', 'jinad803068899', 'amruthamma1998', 'sgu20111577', 'jpneha', 'danbutman', '7adamzaheer7', 'ireymond1', 'shubham.kale27', 'rohitpetkar.r', 'tippu70099', '802730911manisha', 'balu8108', 'anirudhaga', 'gandhali4', 'santhosh1', 'kunalkhadke97', 'harsh12041997', 'nirajj100', 'ishapadia', 'mitdalal15', '802964544_abdul', 'ramyanaine11', 'davide93', 'sim_ks', 'stella.s01', 'rushee2911', '2010ee179', 'manuelsalva182', 'hardikagrawal545', 'anjanmandal58', 'satakarni_amirneni', 'akshay12', 'cwid805705746', '556research2015', 'harkishangrewal', 'sittun.swayam', 'nanoprodigy', 'valgiadicerto', 'southbound280', 'sgu20111399', 'sgu20111478', 'munagalavinod', 'evineeth97', 'surabhikhadke77', 'sayantan2502iitkgp', 'xybiju', 'sgu20121481', 'charankoushik', 'gberk2016', 'vikrant23', 'dineshkota007', 'mrcogito', 'agrawa64', 'mehta.rohan77', 'kandalavamshi111', 'priyanka456', 'sreevardhan25', 'dogp27', 'saranyu', 'pukd56', 'askarmakar07', 'akshay13m', 'rayudhajit', 'saeed1368', 'rohith1234', 'yazayaga', 'eds3293', 'yuvsamratuday1997', 'saraheisenkolb', 'jayasuryach4', 'ireymond0', 'revanthkumar29', 'mirza_baig338', 'rajeshgoudvatnala1', 'tippu7002', 'sobriquet', 'jeetendaveusa', 'shraddha.mhapralkar91', 'abinashsena', 'shiva1702', 'kpc.pardhu', 'jonilsoni', 'manohub', 'varadkardeep96', 'shweka147', 'yusun3', 'paruvelli.chandana', 'rsagrawal.avanti', 'deeksha893', 'agkonale', 'gopa_97', 'morry458', 'hatimkp63', 'sachindaniel', 'segomez1304', 'azadehfamili', 'saisupraj1994', 'chaxul', 'sgu201201146', 'vickygood15', 'id889632394', 'rajdeep.biswas2010', 'rohits2509', 'bksaif', 'mturi', 'anushreedavbhagalpur', 'pavkou123', 'shathorn', 'mandars222', 'hmelia', 'sgu20111560', 'rajanamit2', 'kishorbhosale', 'mirza338', 'kk55singh', 'seg2597', 'munagalavinodreddy', 'mahalepriyaja', 'carjehee', 'pdoak', 'heli', 'anushka.4353.bansal', 'cmvdv', 'joshuapeterebenezer', 'krithish13', 'baldassimassimo', 'gholamvz', 'guheak92', 'datdang', 'yubai', 'nagapradeep97', 'jar2267', 'divya1537', 'venkat92', 'arunganesh', 'niketkothari92', 'bharat123', 'deepthireddyparvatham12', 'yyao46', 'rakeshrvndra', 'sgu20121450', 'aakashmhankale1234', 'astillmaker', 'ray_arka', 'prudvi1258', 'f_alshammari', 'mvikasraj123', 'revanthreddy207', 'jeet.shah2223', 'beena11', 'munagalavinod.r', 'arupsamanta', 'rakesh207', 'jeet_shah_2223', 'manikanta1773', 'mekkaoui', 'ramyakonidhala', 'jeetendave259', 'ppetros', 'rahulkr.1531', 'kagitanikhil', 'ceoelkers1995', 'sudzsharma', 'bhagatsingh91', 'gijsv', 'tummalabalakrishna48', 'arlarson99', 'aditya09', 'jinadpatel919', 'justin.tan', 'nikhiliated', 'tippu70193', 'chaitanypaikara', '008dilip', 'antoniocarrera96', 'naviraja', 'shanka', 'chrislew14', 'tatikonda', 'abhi1singh2', 'haseeb.aktar123', 'samueltayishere', 'mirjivarsha', 'simrobson', 'varsham22', 'dhvanish17', 'shravanisistla1998', 'zub12345', 'keescueta', 'karankantharia', 'lovkeshrishab', 'raymondbach1', 'bawischus', 'grubbies01', 'pranampranu', 'sasuveja950', None, 'calvinly', 'cvarner81', 'pablopelayo', 'amrithav', 'priya.r', 'shiva0193', 'singhmanohar360', 'cwid805670197', 'cjwestri', 'hgrewal', 'nanohubsocial', 'gitanshu', 'roryvang299', 'gulwelling', 'jeetshah23', 'nitinkush16', 'acabhi07', 'sindhoor', 'kalyan4112', 'neeturaj', 'mayankpalaria', 'manishasa', 'prudvi125', 'rkrahi9']"
1,14,250,12,6,"['manohub', 'manuelsalva182', 'krithish13', 'baldassimassimo', 'elpaglia', 'davide93']",244,"['appa9731532495', 'jayasuryach3', 'sarath31', 'deep16', 'jiangy1', 'jagaamaa11', 'vandit93', 'gandhali', 'antoniocarrera', 'marcofratus', 'whenriquez', 'skyp0620', 'saisupraj', 'rko2saurav', 'chandana1', 'spittips101', 'antroy.rc', 'vineethvinny1997', '12kj', 'pourushsood', 'sairohith', 'pkrishnapritish', 'kumarvineeth14', 'celetldci', 'shaila', 'vaibhao14', 'dipanjandas1996', 'karthikeya', 'shreshta.0594', 'dishankyadav96', 'jdilig27', 'raveyjsn', 'saisupraj1', 'razavi_nader', 'jonilsoni92', 'skyp0720', 'mitdalal', 'jinad803068899', 'amruthamma1998', 'jpneha', 'danbutman', '7adamzaheer7', 'ireymond1', 'shubham.kale27', 'rohitpetkar.r', 'tippu70099', '802730911manisha', 'balu8108', 'anirudhaga', 'gandhali4', 'santhosh1', 'kunalkhadke97', 'harsh12041997', 'nirajj100', 'ishapadia', 'mitdalal15', '802964544_abdul', 'ramyanaine11', 'sim_ks', 'stella.s01', 'rushee2911', '2010ee179', 'hardikagrawal545', 'anjanmandal58', 'satakarni_amirneni', 'akshay12', 'cwid805705746', '556research2015', 'harkishangrewal', 'sittun.swayam', 'nanoprodigy', 'valgiadicerto', 'southbound280', 'munagalavinod', 'evineeth97', 'surabhikhadke77', 'sayantan2502iitkgp', 'xybiju', 'charankoushik', 'gberk2016', 'vikrant23', 'dineshkota007', 'mrcogito', 'agrawa64', 'mehta.rohan77', 'kandalavamshi111', 'priyanka456', 'sreevardhan25', 'saranyu', 'pukd56', 'askarmakar07', 'akshay13m', 'rayudhajit', 'saeed1368', 'rohith1234', 'yazayaga', 'eds3293', 'yuvsamratuday1997', 'saraheisenkolb', 'jayasuryach4', 'ireymond0', 'revanthkumar29', 'mirza_baig338', 'rajeshgoudvatnala1', 'tippu7002', 'sobriquet', 'jeetendaveusa', 'shraddha.mhapralkar91', 'abinashsena', 'shiva1702', 'kpc.pardhu', 'jonilsoni', 'varadkardeep96', 'shweka147', 'yusun3', 'paruvelli.chandana', 'rsagrawal.avanti', 'deeksha893', 'agkonale', 'gopa_97', 'morry458', 'hatimkp63', 'sachindaniel', 'segomez1304', 'azadehfamili', 'saisupraj1994', 'chaxul', 'sgu201201146', 'vickygood15', 'id889632394', 'rajdeep.biswas2010', 'rohits2509', 'bksaif', 'mturi', 'anushreedavbhagalpur', 'pavkou123', 'shathorn', 'mandars222', 'hmelia', 'sgu20111560', 'rajanamit2', 'kishorbhosale', 'mirza338', 'kk55singh', 'seg2597', 'munagalavinodreddy', 'mahalepriyaja', 'pdoak', 'heli', 'anushka.4353.bansal', 'cmvdv', 'joshuapeterebenezer', 'gholamvz', 'datdang', 'yubai', 'nagapradeep97', 'jar2267', 'divya1537', 'venkat92', 'arunganesh', 'niketkothari92', 'bharat123', 'deepthireddyparvatham12', 'yyao46', 'rakeshrvndra', 'aakashmhankale1234', 'astillmaker', 'ray_arka', 'prudvi1258', 'f_alshammari', 'mvikasraj123', 'revanthreddy207', 'jeet.shah2223', 'beena11', 'munagalavinod.r', 'arupsamanta', 'rakesh207', 'jeet_shah_2223', 'manikanta1773', 'mekkaoui', 'ramyakonidhala', 'jeetendave259', 'ppetros', 'rahulkr.1531', 'kagitanikhil', 'ceoelkers1995', 'sudzsharma', 'bhagatsingh91', 'gijsv', 'tummalabalakrishna48', 'arlarson99', 'aditya09', 'jinadpatel919', 'justin.tan', 'nikhiliated', 'tippu70193', 'chaitanypaikara', '008dilip', 'antoniocarrera96', 'naviraja', 'shanka', 'chrislew14', 'tatikonda', 'abhi1singh2', 'haseeb.aktar123', 'samueltayishere', 'mirjivarsha', 'simrobson', 'varsham22', 'dhvanish17', 'shravanisistla1998', 'zub12345', 'keescueta', 'karankantharia', 'lovkeshrishab', 'raymondbach1', 'bawischus', 'grubbies01', 'pranampranu', 'sasuveja950', 'calvinly', 'cvarner81', 'pablopelayo', 'amrithav', 'priya.r', 'shiva0193', 'singhmanohar360', 'cwid805670197', 'cjwestri', 'hgrewal', 'nanohubsocial', 'gitanshu', 'roryvang299', 'gulwelling', 'jeetshah23', 'nitinkush16', 'acabhi07', 'sindhoor', 'kalyan4112', 'neeturaj', 'mayankpalaria', 'manishasa', 'prudvi125', 'rkrahi9']",6,"['gionaroder', 'giovannibortolin', 'matt.sav', None, 'mattiahub', 'riccardo5436']",256,"['appa9731532495', 'jayasuryach3', 'sarath31', 'deep16', 'jiangy1', 'jagaamaa11', 'vandit93', 'elpaglia', 'gandhali', 'antoniocarrera', 'marcofratus', 'whenriquez', 'skyp0620', 'saisupraj', 'rko2saurav', 'chandana1', 'spittips101', 'antroy.rc', 'vineethvinny1997', '12kj', 'pourushsood', 'sairohith', 'pkrishnapritish', 'kumarvineeth14', 'celetldci', 'shaila', 'vaibhao14', 'dipanjandas1996', 'karthikeya', 'shreshta.0594', 'dishankyadav96', 'jdilig27', 'raveyjsn', 'saisupraj1', 'razavi_nader', 'jonilsoni92', 'skyp0720', 'mitdalal', 'jinad803068899', 'amruthamma1998', 'jpneha', 'danbutman', '7adamzaheer7', 'ireymond1', 'shubham.kale27', 'rohitpetkar.r', 'tippu70099', '802730911manisha', 'balu8108', 'anirudhaga', 'gandhali4', 'santhosh1', 'kunalkhadke97', 'harsh12041997', 'nirajj100', 'ishapadia', 'mitdalal15', '802964544_abdul', 'ramyanaine11', 'davide93', 'sim_ks', 'stella.s01', 'rushee2911', '2010ee179', 'manuelsalva182', 'hardikagrawal545', 'anjanmandal58', 'satakarni_amirneni', 'akshay12', 'cwid805705746', '556research2015', 'harkishangrewal', 'sittun.swayam', 'nanoprodigy', 'valgiadicerto', 'southbound280', 'munagalavinod', 'evineeth97', 'surabhikhadke77', 'sayantan2502iitkgp', 'xybiju', 'charankoushik', 'gberk2016', 'vikrant23', 'dineshkota007', 'mrcogito', 'agrawa64', 'mehta.rohan77', 'kandalavamshi111', 'priyanka456', 'sreevardhan25', 'saranyu', 'pukd56', 'askarmakar07', 'akshay13m', 'rayudhajit', 'saeed1368', 'rohith1234', 'yazayaga', 'eds3293', 'yuvsamratuday1997', 'saraheisenkolb', 'jayasuryach4', 'ireymond0', 'revanthkumar29', 'mirza_baig338', 'rajeshgoudvatnala1', 'tippu7002', 'sobriquet', 'jeetendaveusa', 'shraddha.mhapralkar91', 'abinashsena', 'shiva1702', 'kpc.pardhu', 'jonilsoni', 'manohub', 'varadkardeep96', 'shweka147', 'yusun3', 'paruvelli.chandana', 'rsagrawal.avanti', 'deeksha893', 'agkonale', 'gopa_97', 'morry458', 'hatimkp63', 'sachindaniel', 'segomez1304', 'azadehfamili', 'saisupraj1994', 'chaxul', 'sgu201201146', 'vickygood15', 'id889632394', 'rajdeep.biswas2010', 'rohits2509', 'bksaif', 'gionaroder', 'mturi', 'anushreedavbhagalpur', 'pavkou123', 'shathorn', 'mandars222', 'hmelia', 'sgu20111560', 'rajanamit2', 'kishorbhosale', 'mirza338', 'matt.sav', 'kk55singh', 'seg2597', 'mattiahub', 'munagalavinodreddy', 'mahalepriyaja', 'pdoak', 'heli', 'anushka.4353.bansal', 'cmvdv', 'joshuapeterebenezer', 'krithish13', 'baldassimassimo', 'gholamvz', 'datdang', 'yubai', 'nagapradeep97', 'jar2267', 'divya1537', 'venkat92', 'arunganesh', 'niketkothari92', 'bharat123', 'deepthireddyparvatham12', 'yyao46', 'rakeshrvndra', 'aakashmhankale1234', 'astillmaker', 'ray_arka', 'prudvi1258', 'f_alshammari', 'mvikasraj123', 'revanthreddy207', 'jeet.shah2223', 'beena11', 'munagalavinod.r', 'arupsamanta', 'rakesh207', 'jeet_shah_2223', 'manikanta1773', 'mekkaoui', 'ramyakonidhala', 'jeetendave259', 'ppetros', 'rahulkr.1531', 'kagitanikhil', 'ceoelkers1995', 'sudzsharma', 'bhagatsingh91', 'gijsv', 'tummalabalakrishna48', 'arlarson99', 'aditya09', 'jinadpatel919', 'justin.tan', 'nikhiliated', 'tippu70193', 'chaitanypaikara', '008dilip', 'antoniocarrera96', 'naviraja', 'shanka', 'chrislew14', 'tatikonda', 'abhi1singh2', 'haseeb.aktar123', 'samueltayishere', 'mirjivarsha', 'simrobson', 'varsham22', 'dhvanish17', 'shravanisistla1998', 'giovannibortolin', 'zub12345', 'keescueta', 'karankantharia', 'lovkeshrishab', 'raymondbach1', 'bawischus', 'grubbies01', 'pranampranu', 'sasuveja950', 'riccardo5436', None, 'calvinly', 'cvarner81', 'pablopelayo', 'amrithav', 'priya.r', 'shiva0193', 'singhmanohar360', 'cwid805670197', 'cjwestri', 'hgrewal', 'nanohubsocial', 'gitanshu', 'roryvang299', 'gulwelling', 'jeetshah23', 'nitinkush16', 'acabhi07', 'sindhoor', 'kalyan4112', 'neeturaj', 'mayankpalaria', 'manishasa', 'prudvi125', 'rkrahi9']"
1,265,250,12,4,"['amruthamma1998', 'rko2saurav', 'sayantan2502iitkgp', 'kunalkhadke97']",246,"['appa9731532495', 'jayasuryach3', 'sarath31', 'deep16', 'jiangy1', 'jagaamaa11', 'vandit93', 'elpaglia', 'gandhali', 'antoniocarrera', 'marcofratus', 'whenriquez', 'skyp0620', 'saisupraj', 'chandana1', 'spittips101', 'antroy.rc', 'vineethvinny1997', '12kj', 'pourushsood', 'sairohith', 'pkrishnapritish', 'kumarvineeth14', 'celetldci', 'shaila', 'vaibhao14', 'dipanjandas1996', 'karthikeya', 'shreshta.0594', 'dishankyadav96', 'jdilig27', 'raveyjsn', 'saisupraj1', 'razavi_nader', 'jonilsoni92', 'skyp0720', 'mitdalal', 'jinad803068899', 'jpneha', 'danbutman', '7adamzaheer7', 'ireymond1', 'shubham.kale27', 'rohitpetkar.r', 'tippu70099', '802730911manisha', 'balu8108', 'anirudhaga', 'gandhali4', 'santhosh1', 'harsh12041997', 'nirajj100', 'ishapadia', 'mitdalal15', '802964544_abdul', 'ramyanaine11', 'davide93', 'sim_ks', 'stella.s01', 'rushee2911', '2010ee179', 'manuelsalva182', 'hardikagrawal545', 'anjanmandal58', 'satakarni_amirneni', 'akshay12', 'cwid805705746', '556research2015', 'harkishangrewal', 'sittun.swayam', 'nanoprodigy', 'valgiadicerto', 'southbound280', 'munagalavinod', 'evineeth97', 'surabhikhadke77', 'xybiju', 'charankoushik', 'gberk2016', 'vikrant23', 'dineshkota007', 'mrcogito', 'agrawa64', 'mehta.rohan77', 'kandalavamshi111', 'priyanka456', 'sreevardhan25', 'saranyu', 'pukd56', 'askarmakar07', 'akshay13m', 'rayudhajit', 'saeed1368', 'rohith1234', 'yazayaga', 'eds3293', 'yuvsamratuday1997', 'saraheisenkolb', 'jayasuryach4', 'ireymond0', 'revanthkumar29', 'mirza_baig338', 'rajeshgoudvatnala1', 'tippu7002', 'sobriquet', 'jeetendaveusa', 'shraddha.mhapralkar91', 'abinashsena', 'shiva1702', 'kpc.pardhu', 'jonilsoni', 'manohub', 'varadkardeep96', 'shweka147', 'yusun3', 'paruvelli.chandana', 'rsagrawal.avanti', 'deeksha893', 'agkonale', 'gopa_97', 'morry458', 'hatimkp63', 'sachindaniel', 'segomez1304', 'azadehfamili', 'saisupraj1994', 'chaxul', 'sgu201201146', 'vickygood15', 'id889632394', 'rajdeep.biswas2010', 'rohits2509', 'bksaif', 'mturi', 'anushreedavbhagalpur', 'pavkou123', 'shathorn', 'mandars222', 'hmelia', 'sgu20111560', 'rajanamit2', 'kishorbhosale', 'mirza338', 'kk55singh', 'seg2597', 'munagalavinodreddy', 'mahalepriyaja', 'pdoak', 'heli', 'anushka.4353.bansal', 'cmvdv', 'joshuapeterebenezer', 'krithish13', 'baldassimassimo', 'gholamvz', 'datdang', 'yubai', 'nagapradeep97', 'jar2267', 'divya1537', 'venkat92', 'arunganesh', 'niketkothari92', 'bharat123', 'deepthireddyparvatham12', 'yyao46', 'rakeshrvndra', 'aakashmhankale1234', 'astillmaker', 'ray_arka', 'prudvi1258', 'f_alshammari', 'mvikasraj123', 'revanthreddy207', 'jeet.shah2223', 'beena11', 'munagalavinod.r', 'arupsamanta', 'rakesh207', 'jeet_shah_2223', 'manikanta1773', 'mekkaoui', 'ramyakonidhala', 'jeetendave259', 'ppetros', 'rahulkr.1531', 'kagitanikhil', 'ceoelkers1995', 'sudzsharma', 'bhagatsingh91', 'gijsv', 'tummalabalakrishna48', 'arlarson99', 'aditya09', 'jinadpatel919', 'justin.tan', 'nikhiliated', 'tippu70193', 'chaitanypaikara', '008dilip', 'antoniocarrera96', 'naviraja', 'shanka', 'chrislew14', 'tatikonda', 'abhi1singh2', 'haseeb.aktar123', 'samueltayishere', 'mirjivarsha', 'simrobson', 'varsham22', 'dhvanish17', 'shravanisistla1998', 'zub12345', 'keescueta', 'karankantharia', 'lovkeshrishab', 'raymondbach1', 'bawischus', 'grubbies01', 'pranampranu', 'sasuveja950', 'calvinly', 'cvarner81', 'pablopelayo', 'amrithav', 'priya.r', 'shiva0193', 'singhmanohar360', 'cwid805670197', 'cjwestri', 'hgrewal', 'nanohubsocial', 'gitanshu', 'roryvang299', 'gulwelling', 'jeetshah23', 'nitinkush16', 'acabhi07', 'sindhoor', 'kalyan4112', 'neeturaj', 'mayankpalaria', 'manishasa', 'prudvi125', 'rkrahi9']",8,"['sameer786007', 'rajeswarim81', 'avinabsaha2018', 'saurabhjai97', 'sm13497', 'ankitkp4056', None, 'sumitarya1310']",258,"['appa9731532495', 'jayasuryach3', 'sarath31', 'deep16', 'jiangy1', 'jagaamaa11', 'vandit93', 'elpaglia', 'gandhali', 'antoniocarrera', 'marcofratus', 'whenriquez', 'skyp0620', 'saisupraj', 'rko2saurav', 'chandana1', 'spittips101', 'rajeswarim81', 'antroy.rc', 'vineethvinny1997', '12kj', 'pourushsood', 'sairohith', 'pkrishnapritish', 'kumarvineeth14', 'celetldci', 'shaila', 'vaibhao14', 'dipanjandas1996', 'karthikeya', 'shreshta.0594', 'dishankyadav96', 'jdilig27', 'raveyjsn', 'saisupraj1', 'razavi_nader', 'jonilsoni92', 'sumitarya1310', 'skyp0720', 'mitdalal', 'jinad803068899', 'amruthamma1998', 'jpneha', 'danbutman', '7adamzaheer7', 'ireymond1', 'shubham.kale27', 'rohitpetkar.r', 'tippu70099', '802730911manisha', 'balu8108', 'anirudhaga', 'gandhali4', 'santhosh1', 'kunalkhadke97', 'harsh12041997', 'nirajj100', 'ishapadia', 'mitdalal15', '802964544_abdul', 'ramyanaine11', 'davide93', 'sim_ks', 'stella.s01', 'rushee2911', '2010ee179', 'sameer786007', 'manuelsalva182', 'hardikagrawal545', 'anjanmandal58', 'satakarni_amirneni', 'akshay12', 'cwid805705746', '556research2015', 'harkishangrewal', 'sittun.swayam', 'nanoprodigy', 'valgiadicerto', 'southbound280', 'saurabhjai97', 'munagalavinod', 'evineeth97', 'surabhikhadke77', 'sayantan2502iitkgp', 'xybiju', 'charankoushik', 'gberk2016', 'vikrant23', 'dineshkota007', 'mrcogito', 'agrawa64', 'mehta.rohan77', 'kandalavamshi111', 'priyanka456', 'sreevardhan25', 'saranyu', 'pukd56', 'askarmakar07', 'akshay13m', 'rayudhajit', 'saeed1368', 'rohith1234', 'yazayaga', 'eds3293', 'yuvsamratuday1997', 'saraheisenkolb', 'jayasuryach4', 'ireymond0', 'revanthkumar29', 'mirza_baig338', 'rajeshgoudvatnala1', 'tippu7002', 'sobriquet', 'sm13497', 'jeetendaveusa', 'shraddha.mhapralkar91', 'abinashsena', 'shiva1702', 'kpc.pardhu', 'jonilsoni', 'manohub', 'varadkardeep96', 'shweka147', 'yusun3', 'paruvelli.chandana', 'rsagrawal.avanti', 'deeksha893', 'agkonale', 'gopa_97', 'morry458', 'hatimkp63', 'sachindaniel', 'segomez1304', 'azadehfamili', 'saisupraj1994', 'chaxul', 'sgu201201146', 'vickygood15', 'id889632394', 'rajdeep.biswas2010', 'rohits2509', 'bksaif', 'mturi', 'anushreedavbhagalpur', 'pavkou123', 'shathorn', 'mandars222', 'hmelia', 'sgu20111560', 'rajanamit2', 'kishorbhosale', 'mirza338', 'avinabsaha2018', 'kk55singh', 'seg2597', 'munagalavinodreddy', 'mahalepriyaja', 'pdoak', 'heli', 'anushka.4353.bansal', 'cmvdv', 'joshuapeterebenezer', 'krithish13', 'baldassimassimo', 'gholamvz', 'ankitkp4056', 'datdang', 'yubai', 'nagapradeep97', 'jar2267', 'divya1537', 'venkat92', 'arunganesh', 'niketkothari92', 'bharat123', 'deepthireddyparvatham12', 'yyao46', 'rakeshrvndra', 'aakashmhankale1234', 'astillmaker', 'ray_arka', 'prudvi1258', 'f_alshammari', 'mvikasraj123', 'revanthreddy207', 'jeet.shah2223', 'beena11', 'munagalavinod.r', 'arupsamanta', 'rakesh207', 'jeet_shah_2223', 'manikanta1773', 'mekkaoui', 'ramyakonidhala', 'jeetendave259', 'ppetros', 'rahulkr.1531', 'kagitanikhil', 'ceoelkers1995', 'sudzsharma', 'bhagatsingh91', 'gijsv', 'tummalabalakrishna48', 'arlarson99', 'aditya09', 'jinadpatel919', 'justin.tan', 'nikhiliated', 'tippu70193', 'chaitanypaikara', '008dilip', 'antoniocarrera96', 'naviraja', 'shanka', 'chrislew14', 'tatikonda', 'abhi1singh2', 'haseeb.aktar123', 'samueltayishere', 'mirjivarsha', 'simrobson', 'varsham22', 'dhvanish17', 'shravanisistla1998', 'zub12345', 'keescueta', 'karankantharia', 'lovkeshrishab', 'raymondbach1', 'bawischus', 'grubbies01', 'pranampranu', 'sasuveja950', None, 'calvinly', 'cvarner81', 'pablopelayo', 'amrithav', 'priya.r', 'shiva0193', 'singhmanohar360', 'cwid805670197', 'cjwestri', 'hgrewal', 'nanohubsocial', 'gitanshu', 'roryvang299', 'gulwelling', 'jeetshah23', 'nitinkush16', 'acabhi07', 'sindhoor', 'kalyan4112', 'neeturaj', 'mayankpalaria', 'manishasa', 'prudvi125', 'rkrahi9']"
1,10,250,11,9,"['akshay13m', 'karankantharia', 'singhmanohar360', 'mandars222', 'rohitpetkar.r', 'ishapadia', 'kishorbhosale', 'agkonale', 'shraddha.mhapralkar91']",241,"['appa9731532495', 'jayasuryach3', 'sarath31', 'deep16', 'jiangy1', 'jagaamaa11', 'vandit93', 'elpaglia', 'gandhali', 'antoniocarrera', 'marcofratus', 'whenriquez', 'skyp0620', 'saisupraj', 'rko2saurav', 'chandana1', 'spittips101', 'antroy.rc', 'vineethvinny1997', '12kj', 'pourushsood', 'sairohith', 'pkrishnapritish', 'kumarvineeth14', 'celetldci', 'shaila', 'vaibhao14', 'dipanjandas1996', 'karthikeya', 'shreshta.0594', 'dishankyadav96', 'jdilig27', 'raveyjsn', 'saisupraj1', 'razavi_nader', 'jonilsoni92', 'skyp0720', 'mitdalal', 'jinad803068899', 'amruthamma1998', 'jpneha', 'danbutman', '7adamzaheer7', 'ireymond1', 'shubham.kale27', 'tippu70099', '802730911manisha', 'balu8108', 'anirudhaga', 'gandhali4', 'santhosh1', 'kunalkhadke97', 'harsh12041997', 'nirajj100', 'mitdalal15', '802964544_abdul', 'ramyanaine11', 'davide93', 'sim_ks', 'stella.s01', 'rushee2911', '2010ee179', 'manuelsalva182', 'hardikagrawal545', 'anjanmandal58', 'satakarni_amirneni', 'akshay12', 'cwid805705746', '556research2015', 'harkishangrewal', 'sittun.swayam', 'nanoprodigy', 'valgiadicerto', 'southbound280', 'munagalavinod', 'evineeth97', 'surabhikhadke77', 'sayantan2502iitkgp', 'xybiju', 'charankoushik', 'gberk2016', 'vikrant23', 'dineshkota007', 'mrcogito', 'agrawa64', 'mehta.rohan77', 'kandalavamshi111', 'priyanka456', 'sreevardhan25', 'saranyu', 'pukd56', 'askarmakar07', 'rayudhajit', 'saeed1368', 'rohith1234', 'yazayaga', 'eds3293', 'yuvsamratuday1997', 'saraheisenkolb', 'jayasuryach4', 'ireymond0', 'revanthkumar29', 'mirza_baig338', 'rajeshgoudvatnala1', 'tippu7002', 'sobriquet', 'jeetendaveusa', 'abinashsena', 'shiva1702', 'kpc.pardhu', 'jonilsoni', 'manohub', 'varadkardeep96', 'shweka147', 'yusun3', 'paruvelli.chandana', 'rsagrawal.avanti', 'deeksha893', 'gopa_97', 'morry458', 'hatimkp63', 'sachindaniel', 'segomez1304', 'azadehfamili', 'saisupraj1994', 'chaxul', 'sgu201201146', 'vickygood15', 'id889632394', 'rajdeep.biswas2010', 'rohits2509', 'bksaif', 'mturi', 'anushreedavbhagalpur', 'pavkou123', 'shathorn', 'hmelia', 'sgu20111560', 'rajanamit2', 'mirza338', 'kk55singh', 'seg2597', 'munagalavinodreddy', 'mahalepriyaja', 'pdoak', 'heli', 'anushka.4353.bansal', 'cmvdv', 'joshuapeterebenezer', 'krithish13', 'baldassimassimo', 'gholamvz', 'datdang', 'yubai', 'nagapradeep97', 'jar2267', 'divya1537', 'venkat92', 'arunganesh', 'niketkothari92', 'bharat123', 'deepthireddyparvatham12', 'yyao46', 'rakeshrvndra', 'aakashmhankale1234', 'astillmaker', 'ray_arka', 'prudvi1258', 'f_alshammari', 'mvikasraj123', 'revanthreddy207', 'jeet.shah2223', 'beena11', 'munagalavinod.r', 'arupsamanta', 'rakesh207', 'jeet_shah_2223', 'manikanta1773', 'mekkaoui', 'ramyakonidhala', 'jeetendave259', 'ppetros', 'rahulkr.1531', 'kagitanikhil', 'ceoelkers1995', 'sudzsharma', 'bhagatsingh91', 'gijsv', 'tummalabalakrishna48', 'arlarson99', 'aditya09', 'jinadpatel919', 'justin.tan', 'nikhiliated', 'tippu70193', 'chaitanypaikara', '008dilip', 'antoniocarrera96', 'naviraja', 'shanka', 'chrislew14', 'tatikonda', 'abhi1singh2', 'haseeb.aktar123', 'samueltayishere', 'mirjivarsha', 'simrobson', 'varsham22', 'dhvanish17', 'shravanisistla1998', 'zub12345', 'keescueta', 'lovkeshrishab', 'raymondbach1', 'bawischus', 'grubbies01', 'pranampranu', 'sasuveja950', 'calvinly', 'cvarner81', 'pablopelayo', 'amrithav', 'priya.r', 'shiva0193', 'cwid805670197', 'cjwestri', 'hgrewal', 'nanohubsocial', 'gitanshu', 'roryvang299', 'gulwelling', 'jeetshah23', 'nitinkush16', 'acabhi07', 'sindhoor', 'kalyan4112', 'neeturaj', 'mayankpalaria', 'manishasa', 'prudvi125', 'rkrahi9']",2,"['pawaskarsonali', None]",252,"['appa9731532495', 'jayasuryach3', 'sarath31', 'deep16', 'jiangy1', 'jagaamaa11', 'vandit93', 'elpaglia', 'gandhali', 'antoniocarrera', 'marcofratus', 'whenriquez', 'skyp0620', 'saisupraj', 'rko2saurav', 'chandana1', 'spittips101', 'antroy.rc', 'vineethvinny1997', '12kj', 'pourushsood', 'sairohith', 'pkrishnapritish', 'kumarvineeth14', 'celetldci', 'shaila', 'vaibhao14', 'dipanjandas1996', 'karthikeya', 'shreshta.0594', 'dishankyadav96', 'jdilig27', 'raveyjsn', 'saisupraj1', 'razavi_nader', 'jonilsoni92', 'skyp0720', 'mitdalal', 'jinad803068899', 'amruthamma1998', 'jpneha', 'danbutman', '7adamzaheer7', 'ireymond1', 'shubham.kale27', 'rohitpetkar.r', 'tippu70099', '802730911manisha', 'balu8108', 'anirudhaga', 'gandhali4', 'santhosh1', 'kunalkhadke97', 'harsh12041997', 'nirajj100', 'ishapadia', 'mitdalal15', '802964544_abdul', 'ramyanaine11', 'davide93', 'sim_ks', 'stella.s01', 'rushee2911', '2010ee179', 'manuelsalva182', 'hardikagrawal545', 'anjanmandal58', 'satakarni_amirneni', 'akshay12', 'cwid805705746', '556research2015', 'harkishangrewal', 'sittun.swayam', 'nanoprodigy', 'valgiadicerto', 'southbound280', 'munagalavinod', 'evineeth97', 'surabhikhadke77', 'sayantan2502iitkgp', 'xybiju', 'charankoushik', 'gberk2016', 'vikrant23', 'dineshkota007', 'mrcogito', 'agrawa64', 'mehta.rohan77', 'kandalavamshi111', 'priyanka456', 'sreevardhan25', 'saranyu', 'pukd56', 'askarmakar07', 'akshay13m', 'rayudhajit', 'saeed1368', 'rohith1234', 'yazayaga', 'eds3293', 'yuvsamratuday1997', 'saraheisenkolb', 'jayasuryach4', 'ireymond0', 'revanthkumar29', 'mirza_baig338', 'rajeshgoudvatnala1', 'tippu7002', 'sobriquet', 'jeetendaveusa', 'shraddha.mhapralkar91', 'abinashsena', 'shiva1702', 'kpc.pardhu', 'jonilsoni', 'manohub', 'varadkardeep96', 'shweka147', 'yusun3', 'paruvelli.chandana', 'rsagrawal.avanti', 'deeksha893', 'agkonale', 'gopa_97', 'morry458', 'hatimkp63', 'sachindaniel', 'segomez1304', 'azadehfamili', 'saisupraj1994', 'chaxul', 'sgu201201146', 'vickygood15', 'id889632394', 'rajdeep.biswas2010', 'rohits2509', 'bksaif', 'pawaskarsonali', 'mturi', 'anushreedavbhagalpur', 'pavkou123', 'shathorn', 'mandars222', 'hmelia', 'sgu20111560', 'rajanamit2', 'kishorbhosale', 'mirza338', 'kk55singh', 'seg2597', 'munagalavinodreddy', 'mahalepriyaja', 'pdoak', 'heli', 'anushka.4353.bansal', 'cmvdv', 'joshuapeterebenezer', 'krithish13', 'baldassimassimo', 'gholamvz', 'datdang', 'yubai', 'nagapradeep97', 'jar2267', 'divya1537', 'venkat92', 'arunganesh', 'niketkothari92', 'bharat123', 'deepthireddyparvatham12', 'yyao46', 'rakeshrvndra', 'aakashmhankale1234', 'astillmaker', 'ray_arka', 'prudvi1258', 'f_alshammari', 'mvikasraj123', 'revanthreddy207', 'jeet.shah2223', 'beena11', 'munagalavinod.r', 'arupsamanta', 'rakesh207', 'jeet_shah_2223', 'manikanta1773', 'mekkaoui', 'ramyakonidhala', 'jeetendave259', 'ppetros', 'rahulkr.1531', 'kagitanikhil', 'ceoelkers1995', 'sudzsharma', 'bhagatsingh91', 'gijsv', 'tummalabalakrishna48', 'arlarson99', 'aditya09', 'jinadpatel919', 'justin.tan', 'nikhiliated', 'tippu70193', 'chaitanypaikara', '008dilip', 'antoniocarrera96', 'naviraja', 'shanka', 'chrislew14', 'tatikonda', 'abhi1singh2', 'haseeb.aktar123', 'samueltayishere', 'mirjivarsha', 'simrobson', 'varsham22', 'dhvanish17', 'shravanisistla1998', 'zub12345', 'keescueta', 'karankantharia', 'lovkeshrishab', 'raymondbach1', 'bawischus', 'grubbies01', 'pranampranu', 'sasuveja950', None, 'calvinly', 'cvarner81', 'pablopelayo', 'amrithav', 'priya.r', 'shiva0193', 'singhmanohar360', 'cwid805670197', 'cjwestri', 'hgrewal', 'nanohubsocial', 'gitanshu', 'roryvang299', 'gulwelling', 'jeetshah23', 'nitinkush16', 'acabhi07', 'sindhoor', 'kalyan4112', 'neeturaj', 'mayankpalaria', 'manishasa', 'prudvi125', 'rkrahi9']"
1,3,250,8,6,"['justin.tan', 'hmelia', 'jiangy1', 'sobriquet', 'chrislew14', 'simrobson']",244,"['appa9731532495', 'jayasuryach3', 'sarath31', 'deep16', 'jagaamaa11', 'vandit93', 'elpaglia', 'gandhali', 'antoniocarrera', 'marcofratus', 'whenriquez', 'skyp0620', 'saisupraj', 'rko2saurav', 'chandana1', 'spittips101', 'antroy.rc', 'vineethvinny1997', '12kj', 'pourushsood', 'sairohith', 'pkrishnapritish', 'kumarvineeth14', 'celetldci', 'shaila', 'vaibhao14', 'dipanjandas1996', 'karthikeya', 'shreshta.0594', 'dishankyadav96', 'jdilig27', 'raveyjsn', 'saisupraj1', 'razavi_nader', 'jonilsoni92', 'skyp0720', 'mitdalal', 'jinad803068899', 'amruthamma1998', 'jpneha', 'danbutman', '7adamzaheer7', 'ireymond1', 'shubham.kale27', 'rohitpetkar.r', 'tippu70099', '802730911manisha', 'balu8108', 'anirudhaga', 'gandhali4', 'santhosh1', 'kunalkhadke97', 'harsh12041997', 'nirajj100', 'ishapadia', 'mitdalal15', '802964544_abdul', 'ramyanaine11', 'davide93', 'sim_ks', 'stella.s01', 'rushee2911', '2010ee179', 'manuelsalva182', 'hardikagrawal545', 'anjanmandal58', 'satakarni_amirneni', 'akshay12', 'cwid805705746', '556research2015', 'harkishangrewal', 'sittun.swayam', 'nanoprodigy', 'valgiadicerto', 'southbound280', 'munagalavinod', 'evineeth97', 'surabhikhadke77', 'sayantan2502iitkgp', 'xybiju', 'charankoushik', 'gberk2016', 'vikrant23', 'dineshkota007', 'mrcogito', 'agrawa64', 'mehta.rohan77', 'kandalavamshi111', 'priyanka456', 'sreevardhan25', 'saranyu', 'pukd56', 'askarmakar07', 'akshay13m', 'rayudhajit', 'saeed1368', 'rohith1234', 'yazayaga', 'eds3293', 'yuvsamratuday1997', 'saraheisenkolb', 'jayasuryach4', 'ireymond0', 'revanthkumar29', 'mirza_baig338', 'rajeshgoudvatnala1', 'tippu7002', 'jeetendaveusa', 'shraddha.mhapralkar91', 'abinashsena', 'shiva1702', 'kpc.pardhu', 'jonilsoni', 'manohub', 'varadkardeep96', 'shweka147', 'yusun3', 'paruvelli.chandana', 'rsagrawal.avanti', 'deeksha893', 'agkonale', 'gopa_97', 'morry458', 'hatimkp63', 'sachindaniel', 'segomez1304', 'azadehfamili', 'saisupraj1994', 'chaxul', 'sgu201201146', 'vickygood15', 'id889632394', 'rajdeep.biswas2010', 'rohits2509', 'bksaif', 'mturi', 'anushreedavbhagalpur', 'pavkou123', 'shathorn', 'mandars222', 'sgu20111560', 'rajanamit2', 'kishorbhosale', 'mirza338', 'kk55singh', 'seg2597', 'munagalavinodreddy', 'mahalepriyaja', 'pdoak', 'heli', 'anushka.4353.bansal', 'cmvdv', 'joshuapeterebenezer', 'krithish13', 'baldassimassimo', 'gholamvz', 'datdang', 'yubai', 'nagapradeep97', 'jar2267', 'divya1537', 'venkat92', 'arunganesh', 'niketkothari92', 'bharat123', 'deepthireddyparvatham12', 'yyao46', 'rakeshrvndra', 'aakashmhankale1234', 'astillmaker', 'ray_arka', 'prudvi1258', 'f_alshammari', 'mvikasraj123', 'revanthreddy207', 'jeet.shah2223', 'beena11', 'munagalavinod.r', 'arupsamanta', 'rakesh207', 'jeet_shah_2223', 'manikanta1773', 'mekkaoui', 'ramyakonidhala', 'jeetendave259', 'ppetros', 'rahulkr.1531', 'kagitanikhil', 'ceoelkers1995', 'sudzsharma', 'bhagatsingh91', 'gijsv', 'tummalabalakrishna48', 'arlarson99', 'aditya09', 'jinadpatel919', 'nikhiliated', 'tippu70193', 'chaitanypaikara', '008dilip', 'antoniocarrera96', 'naviraja', 'shanka', 'tatikonda', 'abhi1singh2', 'haseeb.aktar123', 'samueltayishere', 'mirjivarsha', 'varsham22', 'dhvanish17', 'shravanisistla1998', 'zub12345', 'keescueta', 'karankantharia', 'lovkeshrishab', 'raymondbach1', 'bawischus', 'grubbies01', 'pranampranu', 'sasuveja950', 'calvinly', 'cvarner81', 'pablopelayo', 'amrithav', 'priya.r', 'shiva0193', 'singhmanohar360', 'cwid805670197', 'cjwestri', 'hgrewal', 'nanohubsocial', 'gitanshu', 'roryvang299', 'gulwelling', 'jeetshah23', 'nitinkush16', 'acabhi07', 'sindhoor', 'kalyan4112', 'neeturaj', 'mayankpalaria', 'manishasa', 'prudvi125', 'rkrahi9']",2,"[None, 'htsunimelb']",252,"['appa9731532495', 'jayasuryach3', 'sarath31', 'deep16', 'jiangy1', 'jagaamaa11', 'vandit93', 'elpaglia', 'gandhali', 'antoniocarrera', 'marcofratus', 'whenriquez', 'skyp0620', 'saisupraj', 'rko2saurav', 'chandana1', 'spittips101', 'antroy.rc', 'vineethvinny1997', '12kj', 'pourushsood', 'sairohith', 'pkrishnapritish', 'kumarvineeth14', 'celetldci', 'shaila', 'vaibhao14', 'dipanjandas1996', 'karthikeya', 'shreshta.0594', 'dishankyadav96', 'jdilig27', 'raveyjsn', 'saisupraj1', 'razavi_nader', 'jonilsoni92', 'skyp0720', 'mitdalal', 'jinad803068899', 'amruthamma1998', 'jpneha', 'danbutman', '7adamzaheer7', 'ireymond1', 'shubham.kale27', 'rohitpetkar.r', 'tippu70099', '802730911manisha', 'balu8108', 'anirudhaga', 'gandhali4', 'santhosh1', 'kunalkhadke97', 'harsh12041997', 'nirajj100', 'ishapadia', 'mitdalal15', '802964544_abdul', 'ramyanaine11', 'davide93', 'sim_ks', 'stella.s01', 'rushee2911', '2010ee179', 'manuelsalva182', 'hardikagrawal545', 'anjanmandal58', 'satakarni_amirneni', 'akshay12', 'cwid805705746', '556research2015', 'harkishangrewal', 'sittun.swayam', 'nanoprodigy', 'valgiadicerto', 'southbound280', 'munagalavinod', 'evineeth97', 'surabhikhadke77', 'sayantan2502iitkgp', 'xybiju', 'charankoushik', 'gberk2016', 'vikrant23', 'dineshkota007', 'mrcogito', 'agrawa64', 'mehta.rohan77', 'kandalavamshi111', 'priyanka456', 'sreevardhan25', 'saranyu', 'pukd56', 'askarmakar07', 'akshay13m', 'rayudhajit', 'saeed1368', 'rohith1234', 'yazayaga', 'eds3293', 'yuvsamratuday1997', 'saraheisenkolb', 'jayasuryach4', 'ireymond0', 'revanthkumar29', 'mirza_baig338', 'rajeshgoudvatnala1', 'tippu7002', 'sobriquet', 'jeetendaveusa', 'shraddha.mhapralkar91', 'abinashsena', 'shiva1702', 'kpc.pardhu', 'jonilsoni', 'manohub', 'varadkardeep96', 'shweka147', 'yusun3', 'paruvelli.chandana', 'rsagrawal.avanti', 'deeksha893', 'agkonale', 'gopa_97', 'morry458', 'hatimkp63', 'sachindaniel', 'segomez1304', 'azadehfamili', 'saisupraj1994', 'chaxul', 'sgu201201146', 'vickygood15', 'id889632394', 'rajdeep.biswas2010', 'rohits2509', 'bksaif', 'mturi', 'anushreedavbhagalpur', 'pavkou123', 'shathorn', 'mandars222', 'hmelia', 'sgu20111560', 'rajanamit2', 'kishorbhosale', 'mirza338', 'kk55singh', 'seg2597', 'munagalavinodreddy', 'mahalepriyaja', 'pdoak', 'heli', 'anushka.4353.bansal', 'cmvdv', 'joshuapeterebenezer', 'htsunimelb', 'krithish13', 'baldassimassimo', 'gholamvz', 'datdang', 'yubai', 'nagapradeep97', 'jar2267', 'divya1537', 'venkat92', 'arunganesh', 'niketkothari92', 'bharat123', 'deepthireddyparvatham12', 'yyao46', 'rakeshrvndra', 'aakashmhankale1234', 'astillmaker', 'ray_arka', 'prudvi1258', 'f_alshammari', 'mvikasraj123', 'revanthreddy207', 'jeet.shah2223', 'beena11', 'munagalavinod.r', 'arupsamanta', 'rakesh207', 'jeet_shah_2223', 'manikanta1773', 'mekkaoui', 'ramyakonidhala', 'jeetendave259', 'ppetros', 'rahulkr.1531', 'kagitanikhil', 'ceoelkers1995', 'sudzsharma', 'bhagatsingh91', 'gijsv', 'tummalabalakrishna48', 'arlarson99', 'aditya09', 'jinadpatel919', 'justin.tan', 'nikhiliated', 'tippu70193', 'chaitanypaikara', '008dilip', 'antoniocarrera96', 'naviraja', 'shanka', 'chrislew14', 'tatikonda', 'abhi1singh2', 'haseeb.aktar123', 'samueltayishere', 'mirjivarsha', 'simrobson', 'varsham22', 'dhvanish17', 'shravanisistla1998', 'zub12345', 'keescueta', 'karankantharia', 'lovkeshrishab', 'raymondbach1', 'bawischus', 'grubbies01', 'pranampranu', 'sasuveja950', None, 'calvinly', 'cvarner81', 'pablopelayo', 'amrithav', 'priya.r', 'shiva0193', 'singhmanohar360', 'cwid805670197', 'cjwestri', 'hgrewal', 'nanohubsocial', 'gitanshu', 'roryvang299', 'gulwelling', 'jeetshah23', 'nitinkush16', 'acabhi07', 'sindhoor', 'kalyan4112', 'neeturaj', 'mayankpalaria', 'manishasa', 'prudvi125', 'rkrahi9']"
1,2,250,7,4,"['gberk2016', 'chrislew14', 'simrobson', 'jiangy1']",246,"['appa9731532495', 'jayasuryach3', 'sarath31', 'deep16', 'jagaamaa11', 'vandit93', 'elpaglia', 'gandhali', 'antoniocarrera', 'marcofratus', 'whenriquez', 'skyp0620', 'saisupraj', 'rko2saurav', 'chandana1', 'spittips101', 'antroy.rc', 'vineethvinny1997', '12kj', 'pourushsood', 'sairohith', 'pkrishnapritish', 'kumarvineeth14', 'celetldci', 'shaila', 'vaibhao14', 'dipanjandas1996', 'karthikeya', 'shreshta.0594', 'dishankyadav96', 'jdilig27', 'raveyjsn', 'saisupraj1', 'razavi_nader', 'jonilsoni92', 'skyp0720', 'mitdalal', 'jinad803068899', 'amruthamma1998', 'jpneha', 'danbutman', '7adamzaheer7', 'ireymond1', 'shubham.kale27', 'rohitpetkar.r', 'tippu70099', '802730911manisha', 'balu8108', 'anirudhaga', 'gandhali4', 'santhosh1', 'kunalkhadke97', 'harsh12041997', 'nirajj100', 'ishapadia', 'mitdalal15', '802964544_abdul', 'ramyanaine11', 'davide93', 'sim_ks', 'stella.s01', 'rushee2911', '2010ee179', 'manuelsalva182', 'hardikagrawal545', 'anjanmandal58', 'satakarni_amirneni', 'akshay12', 'cwid805705746', '556research2015', 'harkishangrewal', 'sittun.swayam', 'nanoprodigy', 'valgiadicerto', 'southbound280', 'munagalavinod', 'evineeth97', 'surabhikhadke77', 'sayantan2502iitkgp', 'xybiju', 'charankoushik', 'vikrant23', 'dineshkota007', 'mrcogito', 'agrawa64', 'mehta.rohan77', 'kandalavamshi111', 'priyanka456', 'sreevardhan25', 'saranyu', 'pukd56', 'askarmakar07', 'akshay13m', 'rayudhajit', 'saeed1368', 'rohith1234', 'yazayaga', 'eds3293', 'yuvsamratuday1997', 'saraheisenkolb', 'jayasuryach4', 'ireymond0', 'revanthkumar29', 'mirza_baig338', 'rajeshgoudvatnala1', 'tippu7002', 'sobriquet', 'jeetendaveusa', 'shraddha.mhapralkar91', 'abinashsena', 'shiva1702', 'kpc.pardhu', 'jonilsoni', 'manohub', 'varadkardeep96', 'shweka147', 'yusun3', 'paruvelli.chandana', 'rsagrawal.avanti', 'deeksha893', 'agkonale', 'gopa_97', 'morry458', 'hatimkp63', 'sachindaniel', 'segomez1304', 'azadehfamili', 'saisupraj1994', 'chaxul', 'sgu201201146', 'vickygood15', 'id889632394', 'rajdeep.biswas2010', 'rohits2509', 'bksaif', 'mturi', 'anushreedavbhagalpur', 'pavkou123', 'shathorn', 'mandars222', 'hmelia', 'sgu20111560', 'rajanamit2', 'kishorbhosale', 'mirza338', 'kk55singh', 'seg2597', 'munagalavinodreddy', 'mahalepriyaja', 'pdoak', 'heli', 'anushka.4353.bansal', 'cmvdv', 'joshuapeterebenezer', 'krithish13', 'baldassimassimo', 'gholamvz', 'datdang', 'yubai', 'nagapradeep97', 'jar2267', 'divya1537', 'venkat92', 'arunganesh', 'niketkothari92', 'bharat123', 'deepthireddyparvatham12', 'yyao46', 'rakeshrvndra', 'aakashmhankale1234', 'astillmaker', 'ray_arka', 'prudvi1258', 'f_alshammari', 'mvikasraj123', 'revanthreddy207', 'jeet.shah2223', 'beena11', 'munagalavinod.r', 'arupsamanta', 'rakesh207', 'jeet_shah_2223', 'manikanta1773', 'mekkaoui', 'ramyakonidhala', 'jeetendave259', 'ppetros', 'rahulkr.1531', 'kagitanikhil', 'ceoelkers1995', 'sudzsharma', 'bhagatsingh91', 'gijsv', 'tummalabalakrishna48', 'arlarson99', 'aditya09', 'jinadpatel919', 'justin.tan', 'nikhiliated', 'tippu70193', 'chaitanypaikara', '008dilip', 'antoniocarrera96', 'naviraja', 'shanka', 'tatikonda', 'abhi1singh2', 'haseeb.aktar123', 'samueltayishere', 'mirjivarsha', 'varsham22', 'dhvanish17', 'shravanisistla1998', 'zub12345', 'keescueta', 'karankantharia', 'lovkeshrishab', 'raymondbach1', 'bawischus', 'grubbies01', 'pranampranu', 'sasuveja950', 'calvinly', 'cvarner81', 'pablopelayo', 'amrithav', 'priya.r', 'shiva0193', 'singhmanohar360', 'cwid805670197', 'cjwestri', 'hgrewal', 'nanohubsocial', 'gitanshu', 'roryvang299', 'gulwelling', 'jeetshah23', 'nitinkush16', 'acabhi07', 'sindhoor', 'kalyan4112', 'neeturaj', 'mayankpalaria', 'manishasa', 'prudvi125', 'rkrahi9']",3,"[None, 'firielnxd', 'mmatsuoka899']",253,"['appa9731532495', 'jayasuryach3', 'sarath31', 'deep16', 'jiangy1', 'jagaamaa11', 'vandit93', 'elpaglia', 'gandhali', 'antoniocarrera', 'marcofratus', 'whenriquez', 'skyp0620', 'saisupraj', 'rko2saurav', 'chandana1', 'spittips101', 'antroy.rc', 'vineethvinny1997', '12kj', 'pourushsood', 'sairohith', 'pkrishnapritish', 'kumarvineeth14', 'celetldci', 'shaila', 'vaibhao14', 'dipanjandas1996', 'karthikeya', 'shreshta.0594', 'dishankyadav96', 'jdilig27', 'raveyjsn', 'saisupraj1', 'razavi_nader', 'jonilsoni92', 'skyp0720', 'mitdalal', 'jinad803068899', 'amruthamma1998', 'jpneha', 'danbutman', '7adamzaheer7', 'ireymond1', 'shubham.kale27', 'rohitpetkar.r', 'tippu70099', '802730911manisha', 'balu8108', 'anirudhaga', 'gandhali4', 'santhosh1', 'kunalkhadke97', 'harsh12041997', 'nirajj100', 'ishapadia', 'mitdalal15', '802964544_abdul', 'ramyanaine11', 'davide93', 'sim_ks', 'stella.s01', 'rushee2911', '2010ee179', 'manuelsalva182', 'hardikagrawal545', 'anjanmandal58', 'satakarni_amirneni', 'akshay12', 'cwid805705746', '556research2015', 'harkishangrewal', 'sittun.swayam', 'nanoprodigy', 'valgiadicerto', 'southbound280', 'munagalavinod', 'evineeth97', 'surabhikhadke77', 'sayantan2502iitkgp', 'xybiju', 'charankoushik', 'gberk2016', 'vikrant23', 'firielnxd', 'dineshkota007', 'mrcogito', 'agrawa64', 'mehta.rohan77', 'kandalavamshi111', 'priyanka456', 'sreevardhan25', 'saranyu', 'pukd56', 'askarmakar07', 'akshay13m', 'rayudhajit', 'saeed1368', 'rohith1234', 'yazayaga', 'eds3293', 'yuvsamratuday1997', 'saraheisenkolb', 'jayasuryach4', 'ireymond0', 'revanthkumar29', 'mirza_baig338', 'rajeshgoudvatnala1', 'tippu7002', 'sobriquet', 'jeetendaveusa', 'shraddha.mhapralkar91', 'abinashsena', 'shiva1702', 'kpc.pardhu', 'jonilsoni', 'manohub', 'varadkardeep96', 'shweka147', 'yusun3', 'paruvelli.chandana', 'rsagrawal.avanti', 'deeksha893', 'agkonale', 'gopa_97', 'morry458', 'hatimkp63', 'sachindaniel', 'segomez1304', 'azadehfamili', 'saisupraj1994', 'chaxul', 'sgu201201146', 'vickygood15', 'id889632394', 'rajdeep.biswas2010', 'rohits2509', 'bksaif', 'mturi', 'anushreedavbhagalpur', 'pavkou123', 'shathorn', 'mandars222', 'hmelia', 'sgu20111560', 'rajanamit2', 'kishorbhosale', 'mirza338', 'kk55singh', 'seg2597', 'munagalavinodreddy', 'mahalepriyaja', 'pdoak', 'heli', 'anushka.4353.bansal', 'cmvdv', 'joshuapeterebenezer', 'krithish13', 'baldassimassimo', 'gholamvz', 'datdang', 'yubai', 'nagapradeep97', 'jar2267', 'divya1537', 'venkat92', 'arunganesh', 'niketkothari92', 'bharat123', 'deepthireddyparvatham12', 'yyao46', 'rakeshrvndra', 'aakashmhankale1234', 'astillmaker', 'ray_arka', 'prudvi1258', 'f_alshammari', 'mvikasraj123', 'revanthreddy207', 'jeet.shah2223', 'beena11', 'munagalavinod.r', 'arupsamanta', 'rakesh207', 'jeet_shah_2223', 'manikanta1773', 'mekkaoui', 'ramyakonidhala', 'jeetendave259', 'ppetros', 'rahulkr.1531', 'kagitanikhil', 'ceoelkers1995', 'sudzsharma', 'bhagatsingh91', 'gijsv', 'tummalabalakrishna48', 'arlarson99', 'aditya09', 'jinadpatel919', 'justin.tan', 'nikhiliated', 'tippu70193', 'chaitanypaikara', '008dilip', 'antoniocarrera96', 'naviraja', 'shanka', 'chrislew14', 'tatikonda', 'abhi1singh2', 'haseeb.aktar123', 'samueltayishere', 'mirjivarsha', 'simrobson', 'varsham22', 'dhvanish17', 'shravanisistla1998', 'zub12345', 'keescueta', 'karankantharia', 'lovkeshrishab', 'raymondbach1', 'bawischus', 'grubbies01', 'pranampranu', 'mmatsuoka899', 'sasuveja950', None, 'calvinly', 'cvarner81', 'pablopelayo', 'amrithav', 'priya.r', 'shiva0193', 'singhmanohar360', 'cwid805670197', 'cjwestri', 'hgrewal', 'nanohubsocial', 'gitanshu', 'roryvang299', 'gulwelling', 'jeetshah23', 'nitinkush16', 'acabhi07', 'sindhoor', 'kalyan4112', 'neeturaj', 'mayankpalaria', 'manishasa', 'prudvi125', 'rkrahi9']"
1,292,250,7,3,"['rahulkr.1531', 'nirajj100', 'sim_ks']",247,"['appa9731532495', 'jayasuryach3', 'sarath31', 'deep16', 'jiangy1', 'jagaamaa11', 'vandit93', 'elpaglia', 'gandhali', 'antoniocarrera', 'marcofratus', 'whenriquez', 'skyp0620', 'saisupraj', 'rko2saurav', 'chandana1', 'spittips101', 'antroy.rc', 'vineethvinny1997', '12kj', 'pourushsood', 'sairohith', 'pkrishnapritish', 'kumarvineeth14', 'celetldci', 'shaila', 'vaibhao14', 'dipanjandas1996', 'karthikeya', 'shreshta.0594', 'dishankyadav96', 'jdilig27', 'raveyjsn', 'saisupraj1', 'razavi_nader', 'jonilsoni92', 'skyp0720', 'mitdalal', 'jinad803068899', 'amruthamma1998', 'jpneha', 'danbutman', '7adamzaheer7', 'ireymond1', 'shubham.kale27', 'rohitpetkar.r', 'tippu70099', '802730911manisha', 'balu8108', 'anirudhaga', 'gandhali4', 'santhosh1', 'kunalkhadke97', 'harsh12041997', 'ishapadia', 'mitdalal15', '802964544_abdul', 'ramyanaine11', 'davide93', 'stella.s01', 'rushee2911', '2010ee179', 'manuelsalva182', 'hardikagrawal545', 'anjanmandal58', 'satakarni_amirneni', 'akshay12', 'cwid805705746', '556research2015', 'harkishangrewal', 'sittun.swayam', 'nanoprodigy', 'valgiadicerto', 'southbound280', 'munagalavinod', 'evineeth97', 'surabhikhadke77', 'sayantan2502iitkgp', 'xybiju', 'charankoushik', 'gberk2016', 'vikrant23', 'dineshkota007', 'mrcogito', 'agrawa64', 'mehta.rohan77', 'kandalavamshi111', 'priyanka456', 'sreevardhan25', 'saranyu', 'pukd56', 'askarmakar07', 'akshay13m', 'rayudhajit', 'saeed1368', 'rohith1234', 'yazayaga', 'eds3293', 'yuvsamratuday1997', 'saraheisenkolb', 'jayasuryach4', 'ireymond0', 'revanthkumar29', 'mirza_baig338', 'rajeshgoudvatnala1', 'tippu7002', 'sobriquet', 'jeetendaveusa', 'shraddha.mhapralkar91', 'abinashsena', 'shiva1702', 'kpc.pardhu', 'jonilsoni', 'manohub', 'varadkardeep96', 'shweka147', 'yusun3', 'paruvelli.chandana', 'rsagrawal.avanti', 'deeksha893', 'agkonale', 'gopa_97', 'morry458', 'hatimkp63', 'sachindaniel', 'segomez1304', 'azadehfamili', 'saisupraj1994', 'chaxul', 'sgu201201146', 'vickygood15', 'id889632394', 'rajdeep.biswas2010', 'rohits2509', 'bksaif', 'mturi', 'anushreedavbhagalpur', 'pavkou123', 'shathorn', 'mandars222', 'hmelia', 'sgu20111560', 'rajanamit2', 'kishorbhosale', 'mirza338', 'kk55singh', 'seg2597', 'munagalavinodreddy', 'mahalepriyaja', 'pdoak', 'heli', 'anushka.4353.bansal', 'cmvdv', 'joshuapeterebenezer', 'krithish13', 'baldassimassimo', 'gholamvz', 'datdang', 'yubai', 'nagapradeep97', 'jar2267', 'divya1537', 'venkat92', 'arunganesh', 'niketkothari92', 'bharat123', 'deepthireddyparvatham12', 'yyao46', 'rakeshrvndra', 'aakashmhankale1234', 'astillmaker', 'ray_arka', 'prudvi1258', 'f_alshammari', 'mvikasraj123', 'revanthreddy207', 'jeet.shah2223', 'beena11', 'munagalavinod.r', 'arupsamanta', 'rakesh207', 'jeet_shah_2223', 'manikanta1773', 'mekkaoui', 'ramyakonidhala', 'jeetendave259', 'ppetros', 'kagitanikhil', 'ceoelkers1995', 'sudzsharma', 'bhagatsingh91', 'gijsv', 'tummalabalakrishna48', 'arlarson99', 'aditya09', 'jinadpatel919', 'justin.tan', 'nikhiliated', 'tippu70193', 'chaitanypaikara', '008dilip', 'antoniocarrera96', 'naviraja', 'shanka', 'chrislew14', 'tatikonda', 'abhi1singh2', 'haseeb.aktar123', 'samueltayishere', 'mirjivarsha', 'simrobson', 'varsham22', 'dhvanish17', 'shravanisistla1998', 'zub12345', 'keescueta', 'karankantharia', 'lovkeshrishab', 'raymondbach1', 'bawischus', 'grubbies01', 'pranampranu', 'sasuveja950', 'calvinly', 'cvarner81', 'pablopelayo', 'amrithav', 'priya.r', 'shiva0193', 'singhmanohar360', 'cwid805670197', 'cjwestri', 'hgrewal', 'nanohubsocial', 'gitanshu', 'roryvang299', 'gulwelling', 'jeetshah23', 'nitinkush16', 'acabhi07', 'sindhoor', 'kalyan4112', 'neeturaj', 'mayankpalaria', 'manishasa', 'prudvi125', 'rkrahi9']",4,"['nivedprakash1996', 'srinivasramkumar', None, 'surya.veeragani7']",254,"['appa9731532495', 'jayasuryach3', 'sarath31', 'deep16', 'jiangy1', 'jagaamaa11', 'vandit93', 'elpaglia', 'gandhali', 'antoniocarrera', 'marcofratus', 'whenriquez', 'skyp0620', 'saisupraj', 'rko2saurav', 'chandana1', 'spittips101', 'antroy.rc', 'vineethvinny1997', '12kj', 'pourushsood', 'sairohith', 'pkrishnapritish', 'kumarvineeth14', 'celetldci', 'shaila', 'vaibhao14', 'dipanjandas1996', 'karthikeya', 'shreshta.0594', 'dishankyadav96', 'jdilig27', 'raveyjsn', 'saisupraj1', 'razavi_nader', 'jonilsoni92', 'skyp0720', 'mitdalal', 'jinad803068899', 'amruthamma1998', 'jpneha', 'danbutman', '7adamzaheer7', 'ireymond1', 'shubham.kale27', 'rohitpetkar.r', 'tippu70099', '802730911manisha', 'balu8108', 'anirudhaga', 'gandhali4', 'santhosh1', 'kunalkhadke97', 'harsh12041997', 'nirajj100', 'ishapadia', 'mitdalal15', '802964544_abdul', 'ramyanaine11', 'davide93', 'sim_ks', 'stella.s01', 'rushee2911', '2010ee179', 'manuelsalva182', 'hardikagrawal545', 'anjanmandal58', 'satakarni_amirneni', 'akshay12', 'cwid805705746', '556research2015', 'harkishangrewal', 'sittun.swayam', 'nanoprodigy', 'valgiadicerto', 'southbound280', 'munagalavinod', 'evineeth97', 'surabhikhadke77', 'sayantan2502iitkgp', 'xybiju', 'charankoushik', 'gberk2016', 'vikrant23', 'dineshkota007', 'mrcogito', 'agrawa64', 'mehta.rohan77', 'kandalavamshi111', 'priyanka456', 'sreevardhan25', 'saranyu', 'pukd56', 'askarmakar07', 'akshay13m', 'rayudhajit', 'saeed1368', 'rohith1234', 'yazayaga', 'eds3293', 'yuvsamratuday1997', 'saraheisenkolb', 'jayasuryach4', 'ireymond0', 'revanthkumar29', 'mirza_baig338', 'rajeshgoudvatnala1', 'tippu7002', 'sobriquet', 'jeetendaveusa', 'shraddha.mhapralkar91', 'abinashsena', 'shiva1702', 'kpc.pardhu', 'jonilsoni', 'manohub', 'varadkardeep96', 'shweka147', 'yusun3', 'nivedprakash1996', 'paruvelli.chandana', 'rsagrawal.avanti', 'deeksha893', 'agkonale', 'gopa_97', 'morry458', 'hatimkp63', 'sachindaniel', 'segomez1304', 'azadehfamili', 'saisupraj1994', 'chaxul', 'sgu201201146', 'vickygood15', 'id889632394', 'rajdeep.biswas2010', 'rohits2509', 'bksaif', 'mturi', 'anushreedavbhagalpur', 'pavkou123', 'shathorn', 'mandars222', 'hmelia', 'sgu20111560', 'rajanamit2', 'kishorbhosale', 'mirza338', 'kk55singh', 'seg2597', 'munagalavinodreddy', 'mahalepriyaja', 'pdoak', 'heli', 'anushka.4353.bansal', 'cmvdv', 'joshuapeterebenezer', 'krithish13', 'baldassimassimo', 'gholamvz', 'datdang', 'yubai', 'nagapradeep97', 'jar2267', 'divya1537', 'venkat92', 'arunganesh', 'niketkothari92', 'bharat123', 'deepthireddyparvatham12', 'yyao46', 'rakeshrvndra', 'aakashmhankale1234', 'astillmaker', 'ray_arka', 'prudvi1258', 'f_alshammari', 'surya.veeragani7', 'mvikasraj123', 'revanthreddy207', 'jeet.shah2223', 'beena11', 'munagalavinod.r', 'arupsamanta', 'rakesh207', 'jeet_shah_2223', 'manikanta1773', 'mekkaoui', 'ramyakonidhala', 'jeetendave259', 'ppetros', 'rahulkr.1531', 'srinivasramkumar', 'kagitanikhil', 'ceoelkers1995', 'sudzsharma', 'bhagatsingh91', 'gijsv', 'tummalabalakrishna48', 'arlarson99', 'aditya09', 'jinadpatel919', 'justin.tan', 'nikhiliated', 'tippu70193', 'chaitanypaikara', '008dilip', 'antoniocarrera96', 'naviraja', 'shanka', 'chrislew14', 'tatikonda', 'abhi1singh2', 'haseeb.aktar123', 'samueltayishere', 'mirjivarsha', 'simrobson', 'varsham22', 'dhvanish17', 'shravanisistla1998', 'zub12345', 'keescueta', 'karankantharia', 'lovkeshrishab', 'raymondbach1', 'bawischus', 'grubbies01', 'pranampranu', 'sasuveja950', None, 'calvinly', 'cvarner81', 'pablopelayo', 'amrithav', 'priya.r', 'shiva0193', 'singhmanohar360', 'cwid805670197', 'cjwestri', 'hgrewal', 'nanohubsocial', 'gitanshu', 'roryvang299', 'gulwelling', 'jeetshah23', 'nitinkush16', 'acabhi07', 'sindhoor', 'kalyan4112', 'neeturaj', 'mayankpalaria', 'manishasa', 'prudvi125', 'rkrahi9']"
2,47,195,207,1,['aparnaahari95'],193,"['eng.esraahafez2013', 'omaramer', 'yeahia14', 'karom1990', 'joseph_hana94', 'bosbos_fafy22xx', 'hussammurad5', 'morsizodiac123', 'ashraf1', 'mostafaanas99', 'beko', 'ardorhee', 'peteremil', 'daniel.boshra', 'ahmadashiekh', 'raghdaezzatnole', 'muhadou95', 'zlzzlz008', 'simo88ud', 'binpda4', 'ahmedsaad96', 'hitman47222', 'baga96', 'tarik10kv', 'islam2141', 'mhelsawaf', 'basmaa.shawkyy203', 'hassanshehata', 'p9012', 'marwamostafa5050', 'alaahussein50', 'moonblack868', 'eng.ahmad.m.z', 'mariam95', 'arashgoodday', 'omarn4sser', 'abdurhmanalaaaldaly', 'nadahemid95', 'ali96saad', 'nourelrayes', 'stressed_student', 'shaggykemo', 'doniahassan999', 'noon486', 'bido', 'kamal24041996', 'eng.nohasaeed94', 'mohabahmedseif', 'mostafakhallaf100', 'kimo11mk', 'mraba1111', 'ahmadawad.fue66', 'muhammed_shaban99', 'omardemos25', 'mohamedrefaeiii', 'eldragon823', 'en.amr_mohamed', 'bbbty6064', 'noon48', 'parkchanwoo7', 'ahmedkhalilelsayed', 'doha_taher135', 'minafouad', 'miragee85', 'marwa96', 'mai.elmoslmany95', 'hendkholeif', 'mohamedsoliman', 'ahmedabdelsalam12', 'youstinafayezfouad', 'ahmedmaged2318', 'butaflekaahlan', 'ahmedelgeneral00', 'mahmoud_33744', 'ahmed_khaledammar', 'mistanbullu', 'farahbayomi103', 'keithlyu', 'zakaria182', 'nadaamrarafa55', 'm2k2017', 'engineermskm', 'theinstructive_man', 'tarek.almowafy', 'ahmed.hassanen', 'osaka', 'mariame', 'mahmoud123', 'ahmed0raafat', 'saeeed3', 'mykel', 'nancyammar', 'rawannshehab', 'yasmineelgogary', 'muhammed.shaban99.franky', 'eng.moaz.morsy', 'reem.hesham819', 'mero.ayman50', 'echoonge', 'krishnajha', '11parasarya', 'a.asmaasalem', 'shahir', 'mernamoneer_bombom', 'ahmed.allam86', 'omniya96', 'm7mdosama3000', 'rodyahmed1995', 'jangsungin', 'mohammedosama', 'engy95', 'asfora', 'nouranekhaled95', 'thasty', 'mohammedmahmoudmahgoub', 'ahmedelalfy', 'youstinanassiflatif95', 'he18911', 'ahmedtarek5155', 'yahialdeeb', 'emadhamdy', 'ezzeddinabdullah', 'hossam.hassan2090', 'ahmedsamybeda', 'xuhan', 'maiuoymohamed.2011', 'maihossam', 'basaseko_208', 'ann_nona1995', 'mohamed_mandour212', 'amrghoniem94', 'saumopal1997', 'hgk', 'mh14039295', 'mohamedelbaga96', 'nadine.a.bahr95', 'mr_taha11', 'khalid_eissa', 'huda_96', 'momensaeed', 'radwahegazy95', 'mernamagdy118', 'louran_1995', 'yarahamdy', 'hatemmohammed', 'mohamedg327', 'mark.h.nabil', 'remonadly06', 'nourhantaha', 'dohaalqaisi1', 'hassan.ayman2006', 'amrelsobky20', 'mayar31995', 'habiba_ashraf_96', 'ahmed.saad9772', 'daycock', 'sharara123', 'minasamuel', 'veroniayaman96', 'abdelrahman.khelshamy', 'mohamedghamad', 'hossam_eldin_khaled_youssef', 'nerminemohamed15', 'ea', 'hoba201140', 'hedy_20072000', 'tadrous96', 'phantomx21', 'mennatallahwageehhassan', 'nadine.maghawry', 'engamr95', 'ozcomert.2', 'peternady', 'mehmettas', 'alizorg4', 'muhlasheen', 'niznkl', 'reham.a.mahmoud', 'maryam.nasser', 'mayar_ashraf', 'nana_girgis2009', 'mohamedali915', 'mirna31eldebeky', 'ahmadhany201696', 'esraaahmed95', 'rowaidaelawam', 'mmmahgoub', 'kyoussef', 'human101', 'mahmoud.salem432', 'ahmed755', 'abdelaziz', 'aisilfarnardo95']",206,"['nitingurme', 'kadamk008', 'bhavesh3422', 'aniket187', 'rehansonarkar784', 'jainamshah202', 'aimomajy', 'nrkhara', 'ajay.raghuwanshi', 'krittikaranga', 'trija68', 'rajdeepd', 'brian200495', 'shraddhad', 'rananeetika3', 'mehtajinal3101', 'vinit95vasudevan', 'gujarathikshitij', 'zkoyande', 'minalsawant1108', 'neha.utekar2608', 'email.harsh0811', 'himanshuphatak98', 'arpit32', 'nikitarane245', 'bhoomee.sheth', 'abhishek1996', 'obalgi3095', 'kambe302', 'lakhanmodani1811', 'simran123', 'rajwaje44', 'jayjadav08', 'neelam.chaudhari27', '22diptinikalje', 'sebastian007', 'tanvikalan', 'harshilmehta1995', 'komal31p', 'poojashetty', 'darshanadaund27', 'sam234bryant', 'nagateja.vlsi', 'bhumivora1995', 'geeta.kavitake', 'mapethe', 'sid.rane95', 'suraj.taigade', 'jaidevdalvi', 'monish.kapadia', 'ratsthegreat', 'ajinkyachadha', 'divya.upalekar', 'rsawant2895', 'ninad41195', 'purva.desai', 'msumit95', 'patil.rushal825', 'chinmayaniket4052', 'anujakhose94', 'rupali.patil', 'pathanabdulrazzak9524', 'viveky803', 'kpiyushbhirud', 'tejasshinde8055', 'siddhesh401', 'sanika.dongre', 'manasi.shinde008', 'bhavikashenoy95', 'dhvanilmandalia29', 'anasnaik9987', 'mokshada', 'alohomora7', 'pranilraut17', 'suryatejachitturi', 'avinashninawe', 'apoorvasundaresan', 'aditya.apte3', 'prachi.more', 'shivanisharaf15', 'sonawane.akshayak', 'akanksha0196', 'shubhamj95', 'aeyjd', 'luke676', 'monish.nene', 'spooja.1430', 'purva.satpute', 'adwait.sable10', 'pragatinarnaware', 'gsawant999', 'nehadingankar', 'deepikachaman3', 'patelu997', 'mshirali23', 'nikhildubey02051996', 'shwecchajain', 'akshata.kulkarni', 'kadamrupesh1996', 'shweta1811', 'stanabk', 'rohankhollamkar', 'upadhyechinmay', 'cooldudeakshu', 'juhi.manglani', 'vaishnavi.sambrekar', 'komalbapna.kb', 'ritesh.shukla', 'mugdha.dalvi', 'amanpal56', 'gupta.ravi1996', 'dipmads', 'rajatkedia95', 'ankurbhagwat8', 'harshal.dangat1', 'florence9344', 'shubham.gaikwad', 'sanjana.advani', 'priyuk', 'priyeshd', 'tanvi.rane1995', 'ambani', 'umeshdarade77', 'tanayshinde21', 'cvvedesh', 'karan.dadlani', 'pravin45', 'tejaskanagal95', 'doshishrut1995', 'kondekar23', 'poojamenon16.pm', 'mihirsawant17', 'rahul4peace', 'rahul1995', 'rhea.ann.95', 'rawletanmayee46', 'ajthamke40', 'rashuidiot', 'minal.patil', 'chaitanyakhachane95', 'johebshaikh', 'harshada123', 'mahajanabhi2201', 'abhishekpatkar1796', 'abhihadshi', 'bharathi.pedapudi', 'lakshmi.nair', 'gauravrajeshmehta', 'mudbidrijay', 'rutvij.supekar', 'codekidx', 'pbrahmapurkar', 'pathakrohan18', 'shreyasvkul', 'mananmehta7', 'chirag184', 'prathameshptkr4', 'tarak.shah', 'mervyn.fernandes', 'ashishmohite1996', 'akshayshinde101095', 'manavtrivedi03', 'vivek12195', 'nikhilgade', 'arvindlandge', 'anasnaik25', 'akshay21', 'mukul.kulkarni', 'sardesai.kirti18', 'shraddhag', 'vishaakn', 'amrsha.srivastava', 'apurva.patil', 'bhavesh.singh', 'omkardalvi409', 'shriya.sharma', 'lakumveer', 'shreyamath95', 'dhruv.gajaria95', 'mohak11jan', 'parthiv.parikh', 'sandipani1995', 'akashspawar148', 'khannamansi312', 'vishakha1805', 'yashgumaste', 'nileshkartik95', 'neilmundhe', 'shreya.mahajan', 'jainam49', 'jakhererahul42', 'dattaram.gawade781', 'tejaschaudhary1996', 'vaibhav.gangan7', 'ankita.rahate', 'shamikabachal', 'swapkaru123', 'saheli.konde', 'prashant.baperkar', 'suman28pandit', 'rakeshmaity', 'aakashgangolli3112', 'pavitra.iyer', 'rohanchavan', 'guptesoham95', 'ptrimukhe32']",400,"['eng.esraahafez2013', 'omaramer', 'karom1990', 'joseph_hana94', 'morsizodiac123', 'kadamk008', 'ashraf1', 'ardorhee', 'beko', 'raghdaezzatnole', 'rehansonarkar784', 'muhadou95', 'aimomajy', 'ajay.raghuwanshi', 'trija68', 'brian200495', 'rananeetika3', 'binpda4', 'vinit95vasudevan', 'gujarathikshitij', 'zkoyande', 'tarik10kv', 'minalsawant1108', 'islam2141', 'neha.utekar2608', 'mhelsawaf', 'email.harsh0811', 'hassanshehata', 'moonblack868', 'eng.ahmad.m.z', 'arashgoodday', 'bhoomee.sheth', 'omarn4sser', 'abdurhmanalaaaldaly', 'abhishek1996', 'obalgi3095', 'nourelrayes', 'rajwaje44', 'jayjadav08', '22diptinikalje', 'harshilmehta1995', 'komal31p', 'darshanadaund27', 'kamal24041996', 'mohabahmedseif', 'mostafakhallaf100', 'bhumivora1995', 'mapethe', 'kimo11mk', 'mraba1111', 'jaidevdalvi', 'monish.kapadia', 'mohamedrefaeiii', 'omardemos25', 'ratsthegreat', 'ajinkyachadha', 'eldragon823', 'en.amr_mohamed', 'noon48', 'parkchanwoo7', 'ahmedkhalilelsayed', 'doha_taher135', 'chinmayaniket4052', 'anujakhose94', 'rupali.patil', 'minafouad', 'miragee85', 'pathanabdulrazzak9524', 'viveky803', 'marwa96', 'hendkholeif', 'siddhesh401', 'sanika.dongre', 'ahmedabdelsalam12', 'manasi.shinde008', 'butaflekaahlan', 'bhavikashenoy95', 'mahmoud_33744', 'dhvanilmandalia29', 'anasnaik9987', 'mokshada', 'alohomora7', 'avinashninawe', 'zakaria182', 'shivanisharaf15', 'engineermskm', 'spooja.1430', 'theinstructive_man', 'tarek.almowafy', 'pragatinarnaware', 'osaka', 'deepikachaman3', 'patelu997', 'mariame', 'shwecchajain', 'kadamrupesh1996', 'ahmed0raafat', 'mykel', 'nancyammar', 'rawannshehab', 'shweta1811', 'rohankhollamkar', 'yasmineelgogary', 'eng.moaz.morsy', 'mero.ayman50', 'vaishnavi.sambrekar', 'komalbapna.kb', 'krishnajha', 'mugdha.dalvi', 'a.asmaasalem', 'shahir', 'rajatkedia95', 'ankurbhagwat8', 'harshal.dangat1', 'mernamoneer_bombom', 'omniya96', 'shubham.gaikwad', 'sanjana.advani', 'priyeshd', 'm7mdosama3000', 'tanvi.rane1995', 'ambani', 'cvvedesh', 'pravin45', 'engy95', 'asfora', 'nouranekhaled95', 'mohammedmahmoudmahgoub', 'ahmedelalfy', 'youstinanassiflatif95', 'poojamenon16.pm', 'rahul4peace', 'ahmedtarek5155', 'ezzeddinabdullah', 'rawletanmayee46', 'ajthamke40', 'rashuidiot', 'minal.patil', 'chaitanyakhachane95', 'hossam.hassan2090', 'ahmedsamybeda', 'xuhan', 'ann_nona1995', 'basaseko_208', 'saumopal1997', 'mohamed_mandour212', 'harshada123', 'amrghoniem94', 'abhihadshi', 'mohamedelbaga96', 'nadine.a.bahr95', 'bharathi.pedapudi', 'mr_taha11', 'huda_96', 'gauravrajeshmehta', 'mernamagdy118', 'louran_1995', 'mohamedg327', 'mark.h.nabil', 'pbrahmapurkar', 'pathakrohan18', 'shreyasvkul', 'mananmehta7', 'chirag184', 'nourhantaha', 'hassan.ayman2006', 'ashishmohite1996', 'manavtrivedi03', 'nikhilgade', 'arvindlandge', 'anasnaik25', 'mukul.kulkarni', 'sardesai.kirti18', 'ahmed.saad9772', 'daycock', 'sharara123', 'minasamuel', 'veroniayaman96', 'vishaakn', 'abdelrahman.khelshamy', 'amrsha.srivastava', 'tadrous96', 'shriya.sharma', 'lakumveer', 'mohak11jan', 'nadine.maghawry', 'engamr95', 'ozcomert.2', 'vishakha1805', 'yashgumaste', 'nileshkartik95', 'mehmettas', 'neilmundhe', 'jakhererahul42', 'dattaram.gawade781', 'reham.a.mahmoud', 'maryam.nasser', 'tejaschaudhary1996', 'vaibhav.gangan7', 'nana_girgis2009', 'shamikabachal', 'kyoussef', 'saheli.konde', 'prashant.baperkar', 'aakashgangolli3112', 'ahmed755', 'prachi.more', 'abdelaziz', 'rohanchavan', 'yeahia14', 'bosbos_fafy22xx', 'hussammurad5', 'nitingurme', 'bhavesh3422', 'mostafaanas99', 'aniket187', 'jainamshah202', 'peteremil', 'daniel.boshra', 'ahmadashiekh', 'nrkhara', 'krittikaranga', 'rajdeepd', 'zlzzlz008', 'shraddhad', 'simo88ud', 'mehtajinal3101', 'ahmedsaad96', 'hitman47222', 'baga96', 'basmaa.shawkyy203', 'himanshuphatak98', 'p9012', 'marwamostafa5050', 'alaahussein50', 'mariam95', 'arpit32', 'nikitarane245', 'nadahemid95', 'kambe302', 'ali96saad', 'lakhanmodani1811', 'stressed_student', 'simran123', 'tanvikalan', 'shaggykemo', 'neelam.chaudhari27', 'sebastian007', 'doniahassan999', 'poojashetty', 'noon486', 'bido', 'eng.nohasaeed94', 'sam234bryant', 'nagateja.vlsi', 'geeta.kavitake', 'sid.rane95', 'ahmadawad.fue66', 'muhammed_shaban99', 'suraj.taigade', 'divya.upalekar', 'rsawant2895', 'bbbty6064', 'ninad41195', 'purva.desai', 'msumit95', 'guptesoham95', 'patil.rushal825', 'mai.elmoslmany95', 'kpiyushbhirud', 'tejasshinde8055', 'mohamedsoliman', 'youstinafayezfouad', 'ahmedmaged2318', 'ahmedelgeneral00', 'ahmed_khaledammar', 'mistanbullu', 'farahbayomi103', 'keithlyu', 'pranilraut17', 'suryatejachitturi', 'apoorvasundaresan', 'aditya.apte3', 'nadaamrarafa55', 'm2k2017', 'sonawane.akshayak', 'akanksha0196', 'shubhamj95', 'aeyjd', 'luke676', 'monish.nene', 'purva.satpute', 'adwait.sable10', 'nehadingankar', 'ahmed.hassanen', 'gsawant999', 'mshirali23', 'nikhildubey02051996', 'akshata.kulkarni', 'mahmoud123', 'saeeed3', 'stanabk', 'upadhyechinmay', 'cooldudeakshu', 'juhi.manglani', 'muhammed.shaban99.franky', 'reem.hesham819', 'echoonge', 'ritesh.shukla', '11parasarya', 'amanpal56', 'gupta.ravi1996', 'dipmads', 'ahmed.allam86', 'florence9344', 'priyuk', 'rodyahmed1995', 'umeshdarade77', 'tanayshinde21', 'karan.dadlani', 'jangsungin', 'tejaskanagal95', 'mohammedosama', 'doshishrut1995', 'thasty', 'kondekar23', 'mihirsawant17', 'he18911', 'rahul1995', 'yahialdeeb', 'emadhamdy', 'rhea.ann.95', 'johebshaikh', 'maiuoymohamed.2011', 'mahajanabhi2201', 'maihossam', 'abhishekpatkar1796', 'hgk', 'mh14039295', 'lakshmi.nair', 'khalid_eissa', 'radwahegazy95', 'momensaeed', 'rutvij.supekar', 'hatemmohammed', 'mudbidrijay', 'yarahamdy', 'codekidx', 'prathameshptkr4', 'aparnaahari95', 'remonadly06', 'dohaalqaisi1', 'tarak.shah', 'mervyn.fernandes', 'akshayshinde101095', 'vivek12195', 'amrelsobky20', 'mayar31995', 'akshay21', 'habiba_ashraf_96', 'shraddhag', 'mohamedghamad', 'apurva.patil', 'hossam_eldin_khaled_youssef', 'nerminemohamed15', 'ea', 'hoba201140', 'bhavesh.singh', 'hedy_20072000', 'omkardalvi409', 'phantomx21', 'shreyamath95', 'mennatallahwageehhassan', 'dhruv.gajaria95', 'parthiv.parikh', 'sandipani1995', 'akashspawar148', 'peternady', 'khannamansi312', 'jainam49', 'alizorg4', 'shreya.mahajan', 'muhlasheen', 'niznkl', 'mayar_ashraf', 'ankita.rahate', 'mohamedali915', 'mirna31eldebeky', 'ahmadhany201696', 'esraaahmed95', 'rowaidaelawam', 'mmmahgoub', 'swapkaru123', 'human101', 'mahmoud.salem432', 'suman28pandit', 'rakeshmaity', 'pavitra.iyer', 'aisilfarnardo95', 'ptrimukhe32']"
2,22,195,159,145,"['omaramer', 'joseph_hana94', 'bosbos_fafy22xx', 'hussammurad5', 'morsizodiac123', 'ashraf1', 'raghdaezzatnole', 'mostafaanas99', 'beko', 'peteremil', 'daniel.boshra', 'ahmadashiekh', 'muhadou95', 'binpda4', 'ahmedsaad96', 'baga96', 'hitman47222', 'tarik10kv', 'islam2141', 'basmaa.shawkyy203', 'hassanshehata', 'p9012', 'marwamostafa5050', 'alaahussein50', 'moonblack868', 'mariam95', 'omarn4sser', 'abdurhmanalaaaldaly', 'ali96saad', 'stressed_student', 'nourelrayes', 'shaggykemo', 'doniahassan999', 'bido', 'eng.nohasaeed94', 'mostafakhallaf100', 'mohabahmedseif', 'kimo11mk', 'mohamedrefaeiii', 'en.amr_mohamed', 'ahmedkhalilelsayed', 'doha_taher135', 'minafouad', 'miragee85', 'mai.elmoslmany95', 'marwa96', 'hendkholeif', 'mohamedsoliman', 'ahmedabdelsalam12', 'youstinafayezfouad', 'ahmedmaged2318', 'ahmedelgeneral00', 'butaflekaahlan', 'mahmoud_33744', 'ahmed_khaledammar', 'farahbayomi103', 'zakaria182', 'nadaamrarafa55', 'm2k2017', 'engineermskm', 'theinstructive_man', 'tarek.almowafy', 'ahmed.hassanen', 'osaka', 'mahmoud123', 'ahmed0raafat', 'mykel', 'nancyammar', 'rawannshehab', 'yasmineelgogary', 'eng.moaz.morsy', 'reem.hesham819', 'mero.ayman50', 'a.asmaasalem', 'shahir', 'mernamoneer_bombom', 'omniya96', 'm7mdosama3000', 'rodyahmed1995', 'mohammedosama', 'engy95', 'mohammedmahmoudmahgoub', 'asfora', 'youstinanassiflatif95', 'ahmedtarek5155', 'yahialdeeb', 'emadhamdy', 'ezzeddinabdullah', 'hossam.hassan2090', 'maiuoymohamed.2011', 'ahmedsamybeda', 'ann_nona1995', 'maihossam', 'mohamed_mandour212', 'amrghoniem94', 'hgk', 'nadine.a.bahr95', 'mohamedelbaga96', 'khalid_eissa', 'mr_taha11', 'huda_96', 'radwahegazy95', 'momensaeed', 'mernamagdy118', 'louran_1995', 'yarahamdy', 'hatemmohammed', 'mohamedg327', 'mark.h.nabil', 'remonadly06', 'nourhantaha', 'dohaalqaisi1', 'amrelsobky20', 'mayar31995', 'habiba_ashraf_96', 'ahmed.saad9772', 'minasamuel', 'veroniayaman96', 'mohamedghamad', 'hossam_eldin_khaled_youssef', 'nerminemohamed15', 'ea', 'hoba201140', 'hedy_20072000', 'tadrous96', 'mennatallahwageehhassan', 'nadine.maghawry', 'engamr95', 'peternady', 'alizorg4', 'muhlasheen', 'reham.a.mahmoud', 'maryam.nasser', 'mayar_ashraf', 'nana_girgis2009', 'mohamedali915', 'mirna31eldebeky', 'ahmadhany201696', 'rowaidaelawam', 'mmmahgoub', 'human101', 'mahmoud.salem432', 'ahmed755', 'abdelaziz', 'aisilfarnardo95']",49,"['muhammed.shaban99.franky', 'eldragon823', 'eng.esraahafez2013', 'yeahia14', 'karom1990', 'echoonge', 'bbbty6064', 'hassan.ayman2006', 'krishnajha', 'noon48', 'parkchanwoo7', '11parasarya', 'ardorhee', 'daycock', 'sharara123', 'ahmed.allam86', 'zlzzlz008', 'abdelrahman.khelshamy', 'simo88ud', 'jangsungin', 'nouranekhaled95', 'thasty', 'ahmedelalfy', 'mhelsawaf', 'phantomx21', 'mraba1111', 'he18911', 'mistanbullu', 'keithlyu', 'eng.ahmad.m.z', 'arashgoodday', 'ozcomert.2', 'nadahemid95', 'xuhan', 'saumopal1997', 'basaseko_208', 'mehmettas', 'mh14039295', 'niznkl', 'mariame', 'esraaahmed95', 'noon486', 'kamal24041996', 'saeeed3', 'kyoussef', 'aparnaahari95', 'ahmadawad.fue66', 'muhammed_shaban99', 'omardemos25']",14,"['emadomda', 'sal96', 'marmoramickey', 'mayarahmed', 'amr_salah', 'firesword_007', 'sondos', 'kareem1994', 'nourhan.ahmed', 'mona_gamal', None, 'hagerali139', 'bishoobishbish', 'yahiazakria']",208,"['eng.esraahafez2013', 'omaramer', 'karom1990', 'joseph_hana94', 'morsizodiac123', 'ashraf1', 'ardorhee', 'beko', 'raghdaezzatnole', 'muhadou95', 'binpda4', 'tarik10kv', 'islam2141', 'mhelsawaf', 'hassanshehata', 'moonblack868', 'eng.ahmad.m.z', 'arashgoodday', 'omarn4sser', 'abdurhmanalaaaldaly', 'nourelrayes', 'kamal24041996', 'mohabahmedseif', 'mostafakhallaf100', 'kimo11mk', 'mraba1111', 'mohamedrefaeiii', 'omardemos25', 'eldragon823', 'en.amr_mohamed', 'noon48', 'parkchanwoo7', 'ahmedkhalilelsayed', 'doha_taher135', 'minafouad', 'miragee85', 'marwa96', 'hendkholeif', 'ahmedabdelsalam12', 'butaflekaahlan', 'mahmoud_33744', 'zakaria182', 'engineermskm', 'theinstructive_man', 'tarek.almowafy', 'osaka', 'mariame', 'ahmed0raafat', 'mykel', 'nancyammar', 'rawannshehab', 'yasmineelgogary', 'eng.moaz.morsy', 'mero.ayman50', 'krishnajha', 'a.asmaasalem', 'kareem1994', 'shahir', 'mernamoneer_bombom', 'omniya96', 'm7mdosama3000', 'engy95', 'asfora', 'nouranekhaled95', 'mohammedmahmoudmahgoub', 'ahmedelalfy', 'youstinanassiflatif95', 'ahmedtarek5155', 'ezzeddinabdullah', 'firesword_007', 'hossam.hassan2090', 'ahmedsamybeda', 'xuhan', 'ann_nona1995', 'basaseko_208', 'saumopal1997', 'mohamed_mandour212', 'amrghoniem94', 'mohamedelbaga96', 'nadine.a.bahr95', 'mr_taha11', 'huda_96', 'mernamagdy118', 'louran_1995', 'mohamedg327', 'mark.h.nabil', 'nourhantaha', 'hassan.ayman2006', 'sondos', 'ahmed.saad9772', 'daycock', 'sharara123', 'minasamuel', 'veroniayaman96', 'abdelrahman.khelshamy', 'mayarahmed', 'nourhan.ahmed', 'tadrous96', 'nadine.maghawry', 'engamr95', 'ozcomert.2', 'mehmettas', 'mona_gamal', None, 'reham.a.mahmoud', 'maryam.nasser', 'nana_girgis2009', 'kyoussef', 'ahmed755', 'abdelaziz', 'yeahia14', 'bosbos_fafy22xx', 'hussammurad5', 'mostafaanas99', 'peteremil', 'daniel.boshra', 'ahmadashiekh', 'zlzzlz008', 'simo88ud', 'ahmedsaad96', 'hitman47222', 'baga96', 'basmaa.shawkyy203', 'p9012', 'marwamostafa5050', 'alaahussein50', 'mariam95', 'nadahemid95', 'ali96saad', 'stressed_student', 'shaggykemo', 'doniahassan999', 'noon486', 'bido', 'eng.nohasaeed94', 'ahmadawad.fue66', 'muhammed_shaban99', 'bbbty6064', 'mai.elmoslmany95', 'mohamedsoliman', 'youstinafayezfouad', 'ahmedmaged2318', 'ahmedelgeneral00', 'ahmed_khaledammar', 'mistanbullu', 'farahbayomi103', 'keithlyu', 'marmoramickey', 'nadaamrarafa55', 'm2k2017', 'ahmed.hassanen', 'mahmoud123', 'saeeed3', 'muhammed.shaban99.franky', 'emadomda', 'reem.hesham819', 'echoonge', '11parasarya', 'ahmed.allam86', 'rodyahmed1995', 'jangsungin', 'mohammedosama', 'thasty', 'bishoobishbish', 'he18911', 'yahialdeeb', 'emadhamdy', 'maiuoymohamed.2011', 'maihossam', 'hgk', 'mh14039295', 'khalid_eissa', 'radwahegazy95', 'momensaeed', 'hatemmohammed', 'yarahamdy', 'aparnaahari95', 'remonadly06', 'dohaalqaisi1', 'amrelsobky20', 'mayar31995', 'habiba_ashraf_96', 'sal96', 'mohamedghamad', 'hossam_eldin_khaled_youssef', 'nerminemohamed15', 'ea', 'hoba201140', 'hedy_20072000', 'phantomx21', 'mennatallahwageehhassan', 'peternady', 'alizorg4', 'muhlasheen', 'hagerali139', 'niznkl', 'mayar_ashraf', 'mohamedali915', 'mirna31eldebeky', 'ahmadhany201696', 'esraaahmed95', 'rowaidaelawam', 'mmmahgoub', 'amr_salah', 'human101', 'mahmoud.salem432', 'aisilfarnardo95', 'yahiazakria']"
2,24,195,102,5,"['bbbty6064', 'noon486', 'parkchanwoo7', 'noon48', 'jangsungin']",189,"['eng.esraahafez2013', 'omaramer', 'yeahia14', 'karom1990', 'joseph_hana94', 'bosbos_fafy22xx', 'hussammurad5', 'morsizodiac123', 'ashraf1', 'mostafaanas99', 'beko', 'ardorhee', 'peteremil', 'daniel.boshra', 'ahmadashiekh', 'raghdaezzatnole', 'muhadou95', 'zlzzlz008', 'simo88ud', 'binpda4', 'ahmedsaad96', 'hitman47222', 'baga96', 'tarik10kv', 'islam2141', 'mhelsawaf', 'basmaa.shawkyy203', 'hassanshehata', 'p9012', 'marwamostafa5050', 'alaahussein50', 'moonblack868', 'eng.ahmad.m.z', 'mariam95', 'arashgoodday', 'omarn4sser', 'abdurhmanalaaaldaly', 'nadahemid95', 'ali96saad', 'nourelrayes', 'stressed_student', 'shaggykemo', 'doniahassan999', 'bido', 'kamal24041996', 'eng.nohasaeed94', 'mohabahmedseif', 'mostafakhallaf100', 'kimo11mk', 'mraba1111', 'ahmadawad.fue66', 'muhammed_shaban99', 'omardemos25', 'mohamedrefaeiii', 'eldragon823', 'en.amr_mohamed', 'ahmedkhalilelsayed', 'doha_taher135', 'minafouad', 'miragee85', 'marwa96', 'mai.elmoslmany95', 'hendkholeif', 'mohamedsoliman', 'ahmedabdelsalam12', 'youstinafayezfouad', 'ahmedmaged2318', 'butaflekaahlan', 'ahmedelgeneral00', 'mahmoud_33744', 'ahmed_khaledammar', 'mistanbullu', 'farahbayomi103', 'keithlyu', 'zakaria182', 'nadaamrarafa55', 'm2k2017', 'engineermskm', 'theinstructive_man', 'tarek.almowafy', 'ahmed.hassanen', 'osaka', 'mariame', 'mahmoud123', 'ahmed0raafat', 'saeeed3', 'mykel', 'nancyammar', 'rawannshehab', 'yasmineelgogary', 'muhammed.shaban99.franky', 'eng.moaz.morsy', 'reem.hesham819', 'mero.ayman50', 'echoonge', 'krishnajha', '11parasarya', 'a.asmaasalem', 'shahir', 'mernamoneer_bombom', 'ahmed.allam86', 'omniya96', 'm7mdosama3000', 'rodyahmed1995', 'mohammedosama', 'engy95', 'asfora', 'nouranekhaled95', 'thasty', 'mohammedmahmoudmahgoub', 'ahmedelalfy', 'youstinanassiflatif95', 'he18911', 'ahmedtarek5155', 'yahialdeeb', 'emadhamdy', 'ezzeddinabdullah', 'hossam.hassan2090', 'ahmedsamybeda', 'xuhan', 'maiuoymohamed.2011', 'maihossam', 'basaseko_208', 'ann_nona1995', 'mohamed_mandour212', 'amrghoniem94', 'saumopal1997', 'hgk', 'mh14039295', 'mohamedelbaga96', 'nadine.a.bahr95', 'mr_taha11', 'khalid_eissa', 'huda_96', 'momensaeed', 'radwahegazy95', 'mernamagdy118', 'louran_1995', 'yarahamdy', 'hatemmohammed', 'mohamedg327', 'mark.h.nabil', 'aparnaahari95', 'remonadly06', 'nourhantaha', 'dohaalqaisi1', 'hassan.ayman2006', 'amrelsobky20', 'mayar31995', 'habiba_ashraf_96', 'ahmed.saad9772', 'daycock', 'sharara123', 'minasamuel', 'veroniayaman96', 'abdelrahman.khelshamy', 'mohamedghamad', 'hossam_eldin_khaled_youssef', 'nerminemohamed15', 'ea', 'hoba201140', 'hedy_20072000', 'tadrous96', 'phantomx21', 'mennatallahwageehhassan', 'nadine.maghawry', 'engamr95', 'ozcomert.2', 'peternady', 'mehmettas', 'alizorg4', 'muhlasheen', 'niznkl', 'reham.a.mahmoud', 'maryam.nasser', 'mayar_ashraf', 'nana_girgis2009', 'mohamedali915', 'mirna31eldebeky', 'ahmadhany201696', 'esraaahmed95', 'rowaidaelawam', 'mmmahgoub', 'kyoussef', 'human101', 'mahmoud.salem432', 'ahmed755', 'abdelaziz', 'aisilfarnardo95']",97,"['hhnn1229', 'sks911017', 'kimjunsu112', 'tjrwodl2000', 'bluegil92', 'skzl34', 'nnoonn4488', 'jwh0114', 'sgu20121451', 'jkorad2843', 'sgu20131480', 'sgu20121465', 'wjdgns22222', 'woghks927', 'awdwadw12341', 'bonghyuk', 'kdj406', 'k910716kim', 'kym1122', 'sgu20111577', 'dlrjswo', 'akstn34', 'sgu20111450', 'krleesd92', 'sgu20121469', 'sgu20121546', 'shoho214', 'drog0311', 'vhwkd308', 'lilydh511', 'kshbig0425', 'whq456', 'gohny0115', 'sgu20111399', 'road', 'dangshiggy', 'sgu20111478', 'tksfoqlt', 'm109a6', 'dogp27', 'sgu20121507', 'gugusj', 'angyi90', 'poby', 'honnyou', 'thenopi10', 'sgu20101328', 'lsh0307', 'dudxo9273', 'sgu20141467', 'dongjin225', 'gwoo7057', 'mrlee', 'cyc2490', 'pisces9231', 'qkrwhdgkr', 'kan7470', 'mygime92', 'carjehee', 'sgu20111505', 'ghghrkdlgh', 'sdy9333', 'dbrhksan88', 'rnfnqnfn', 'sgu20121479', 'sgu20121526', 'sgu20121514', 'sgu20141426', 'sicpan12', 'fredhan89', 'gkakfhdlem', 'sgu20121450', 'jsa6580', 'sgu20121541', 'qkdgywp', 'bbbty60', 'sgug20160008', 'kigg1124', 'hun0307', 'mrcsm200', 'whj1130', 'kissheyo1004', 'ccjswlgh', 'sgu20121540', 'gordius92', 'ghdud0351', 'sjg1779', 'lkm9200', 'injahgi', 'box1916', None, 'oyj95', 'kiddyu1991', 'sgu20141482', 'sgu20102047', 'dnlwd09', 'jjo2824']",291,"['eng.esraahafez2013', 'omaramer', 'yeahia14', 'karom1990', 'joseph_hana94', 'bosbos_fafy22xx', 'hussammurad5', 'morsizodiac123', 'ashraf1', 'hhnn1229', 'mostafaanas99', 'beko', 'ardorhee', 'peteremil', 'daniel.boshra', 'ahmadashiekh', 'raghdaezzatnole', 'muhadou95', 'sks911017', 'kimjunsu112', 'zlzzlz008', 'simo88ud', 'binpda4', 'ahmedsaad96', 'tjrwodl2000', 'hitman47222', 'baga96', 'tarik10kv', 'islam2141', 'mhelsawaf', 'basmaa.shawkyy203', 'bluegil92', 'hassanshehata', 'p9012', 'skzl34', 'marwamostafa5050', 'alaahussein50', 'nnoonn4488', 'moonblack868', 'eng.ahmad.m.z', 'mariam95', 'arashgoodday', 'omarn4sser', 'abdurhmanalaaaldaly', 'sgu20121451', 'jkorad2843', 'sgu20131480', 'nadahemid95', 'sgu20121465', 'ali96saad', 'wjdgns22222', 'woghks927', 'nourelrayes', 'stressed_student', 'awdwadw12341', 'shaggykemo', 'bonghyuk', 'kdj406', 'k910716kim', 'kym1122', 'sgu20111577', 'doniahassan999', 'dlrjswo', 'noon486', 'bido', 'kamal24041996', 'eng.nohasaeed94', 'akstn34', 'mohabahmedseif', 'mostafakhallaf100', 'sgu20111450', 'kimo11mk', 'ahmadawad.fue66', 'mraba1111', 'muhammed_shaban99', 'krleesd92', 'mohamedrefaeiii', 'omardemos25', 'sgu20121469', 'eldragon823', 'en.amr_mohamed', 'sgu20121546', 'shoho214', 'bbbty6064', 'noon48', 'parkchanwoo7', 'ahmedkhalilelsayed', 'doha_taher135', 'drog0311', 'vhwkd308', 'minafouad', 'miragee85', 'marwa96', 'mai.elmoslmany95', 'lilydh511', 'kshbig0425', 'hendkholeif', 'mohamedsoliman', 'ahmedabdelsalam12', 'dnlwd09', 'youstinafayezfouad', 'ahmedmaged2318', 'butaflekaahlan', 'ahmedelgeneral00', 'whq456', 'gohny0115', 'sgu20111399', 'mahmoud_33744', 'road', 'dangshiggy', 'sgu20111478', 'ahmed_khaledammar', 'mistanbullu', 'farahbayomi103', 'keithlyu', 'tksfoqlt', 'zakaria182', 'nadaamrarafa55', 'm2k2017', 'engineermskm', 'm109a6', 'theinstructive_man', 'tarek.almowafy', 'dogp27', 'sgu20121507', 'ahmed.hassanen', 'osaka', 'gugusj', 'angyi90', 'poby', 'honnyou', 'mariame', 'mahmoud123', 'ahmed0raafat', 'saeeed3', 'mykel', 'nancyammar', 'rawannshehab', 'yasmineelgogary', 'thenopi10', 'sgu20101328', 'muhammed.shaban99.franky', 'lsh0307', 'eng.moaz.morsy', 'reem.hesham819', 'mero.ayman50', 'echoonge', 'dudxo9273', 'krishnajha', '11parasarya', 'sgu20141467', 'dongjin225', 'a.asmaasalem', 'shahir', 'gwoo7057', 'mrlee', 'cyc2490', 'mernamoneer_bombom', 'ahmed.allam86', 'omniya96', 'm7mdosama3000', 'rodyahmed1995', 'jwh0114', 'jangsungin', 'mohammedosama', 'engy95', 'asfora', 'nouranekhaled95', 'thasty', 'mohammedmahmoudmahgoub', 'ahmedelalfy', 'youstinanassiflatif95', 'pisces9231', 'qkrwhdgkr', 'kan7470', 'mygime92', 'carjehee', 'he18911', 'sgu20111505', 'ahmedtarek5155', 'yahialdeeb', 'emadhamdy', 'ezzeddinabdullah', 'ghghrkdlgh', 'sdy9333', 'dbrhksan88', 'rnfnqnfn', 'sgu20121479', 'sgu20121526', 'sgu20121514', 'hossam.hassan2090', 'ahmedsamybeda', 'xuhan', 'maiuoymohamed.2011', 'maihossam', 'basaseko_208', 'ann_nona1995', 'mohamed_mandour212', 'amrghoniem94', 'saumopal1997', 'hgk', 'sicpan12', 'mh14039295', 'mohamedelbaga96', 'nadine.a.bahr95', 'mr_taha11', 'khalid_eissa', 'huda_96', 'momensaeed', 'radwahegazy95', 'mernamagdy118', 'louran_1995', 'yarahamdy', 'hatemmohammed', 'mohamedg327', 'mark.h.nabil', 'fredhan89', 'gkakfhdlem', 'sgu20121450', 'jsa6580', 'aparnaahari95', 'remonadly06', 'nourhantaha', 'dohaalqaisi1', 'sgu20121541', 'qkdgywp', 'hassan.ayman2006', 'amrelsobky20', 'bbbty60', 'mayar31995', 'habiba_ashraf_96', 'ahmed.saad9772', 'daycock', 'sharara123', 'sgug20160008', 'kigg1124', 'minasamuel', 'veroniayaman96', 'hun0307', 'abdelrahman.khelshamy', 'mrcsm200', 'whj1130', 'mohamedghamad', 'hossam_eldin_khaled_youssef', 'nerminemohamed15', 'ea', 'hoba201140', 'kissheyo1004', 'hedy_20072000', 'tadrous96', 'phantomx21', 'ccjswlgh', 'mennatallahwageehhassan', 'sgu20121540', 'nadine.maghawry', 'engamr95', 'gordius92', 'ozcomert.2', 'ghdud0351', 'sjg1779', 'lkm9200', 'peternady', 'injahgi', 'sgu20141426', 'mehmettas', 'alizorg4', 'muhlasheen', 'box1916', None, 'oyj95', 'niznkl', 'reham.a.mahmoud', 'maryam.nasser', 'mayar_ashraf', 'nana_girgis2009', 'mohamedali915', 'mirna31eldebeky', 'ahmadhany201696', 'esraaahmed95', 'rowaidaelawam', 'mmmahgoub', 'kyoussef', 'human101', 'mahmoud.salem432', 'kiddyu1991', 'sgu20141482', 'ahmed755', 'sgu20102047', 'abdelaziz', 'aisilfarnardo95', 'jjo2824']"
2,272,195,43,10,"['mai.elmoslmany95', 'khalid_eissa', 'ahmadhany201696', 'peternady', 'ahmedkhalilelsayed', 'ahmedelgeneral00', 'asfora', 'mayar31995', 'mhelsawaf', 'amrghoniem94']",184,"['eng.esraahafez2013', 'omaramer', 'yeahia14', 'karom1990', 'joseph_hana94', 'bosbos_fafy22xx', 'hussammurad5', 'morsizodiac123', 'ashraf1', 'mostafaanas99', 'beko', 'ardorhee', 'peteremil', 'daniel.boshra', 'ahmadashiekh', 'raghdaezzatnole', 'muhadou95', 'zlzzlz008', 'simo88ud', 'binpda4', 'ahmedsaad96', 'hitman47222', 'baga96', 'tarik10kv', 'islam2141', 'basmaa.shawkyy203', 'hassanshehata', 'p9012', 'marwamostafa5050', 'alaahussein50', 'moonblack868', 'eng.ahmad.m.z', 'mariam95', 'arashgoodday', 'omarn4sser', 'abdurhmanalaaaldaly', 'nadahemid95', 'ali96saad', 'nourelrayes', 'stressed_student', 'shaggykemo', 'doniahassan999', 'noon486', 'bido', 'kamal24041996', 'eng.nohasaeed94', 'mohabahmedseif', 'mostafakhallaf100', 'kimo11mk', 'ahmadawad.fue66', 'mraba1111', 'muhammed_shaban99', 'mohamedrefaeiii', 'omardemos25', 'eldragon823', 'en.amr_mohamed', 'bbbty6064', 'noon48', 'parkchanwoo7', 'doha_taher135', 'minafouad', 'miragee85', 'marwa96', 'hendkholeif', 'mohamedsoliman', 'ahmedabdelsalam12', 'youstinafayezfouad', 'ahmedmaged2318', 'butaflekaahlan', 'mahmoud_33744', 'ahmed_khaledammar', 'mistanbullu', 'farahbayomi103', 'keithlyu', 'zakaria182', 'nadaamrarafa55', 'm2k2017', 'engineermskm', 'theinstructive_man', 'tarek.almowafy', 'ahmed.hassanen', 'osaka', 'mariame', 'mahmoud123', 'ahmed0raafat', 'saeeed3', 'mykel', 'nancyammar', 'rawannshehab', 'yasmineelgogary', 'muhammed.shaban99.franky', 'eng.moaz.morsy', 'reem.hesham819', 'mero.ayman50', 'echoonge', 'krishnajha', '11parasarya', 'a.asmaasalem', 'shahir', 'mernamoneer_bombom', 'ahmed.allam86', 'omniya96', 'm7mdosama3000', 'rodyahmed1995', 'jangsungin', 'mohammedosama', 'engy95', 'nouranekhaled95', 'thasty', 'mohammedmahmoudmahgoub', 'ahmedelalfy', 'youstinanassiflatif95', 'he18911', 'ahmedtarek5155', 'yahialdeeb', 'emadhamdy', 'ezzeddinabdullah', 'hossam.hassan2090', 'ahmedsamybeda', 'xuhan', 'maiuoymohamed.2011', 'maihossam', 'basaseko_208', 'ann_nona1995', 'mohamed_mandour212', 'saumopal1997', 'hgk', 'mh14039295', 'mohamedelbaga96', 'nadine.a.bahr95', 'mr_taha11', 'huda_96', 'momensaeed', 'radwahegazy95', 'mernamagdy118', 'louran_1995', 'yarahamdy', 'hatemmohammed', 'mohamedg327', 'mark.h.nabil', 'aparnaahari95', 'remonadly06', 'nourhantaha', 'dohaalqaisi1', 'hassan.ayman2006', 'amrelsobky20', 'habiba_ashraf_96', 'ahmed.saad9772', 'daycock', 'sharara123', 'minasamuel', 'veroniayaman96', 'abdelrahman.khelshamy', 'mohamedghamad', 'hossam_eldin_khaled_youssef', 'nerminemohamed15', 'ea', 'hoba201140', 'hedy_20072000', 'tadrous96', 'phantomx21', 'mennatallahwageehhassan', 'nadine.maghawry', 'engamr95', 'ozcomert.2', 'mehmettas', 'alizorg4', 'muhlasheen', 'niznkl', 'reham.a.mahmoud', 'maryam.nasser', 'mayar_ashraf', 'nana_girgis2009', 'mohamedali915', 'mirna31eldebeky', 'esraaahmed95', 'rowaidaelawam', 'mmmahgoub', 'kyoussef', 'human101', 'mahmoud.salem432', 'ahmed755', 'abdelaziz', 'aisilfarnardo95']",33,"['hassan93', 'ziadelmehy', 'abdulrahman.elmashed', 'noureentarek96', 'mohamedelhewehy', 'reem15_5', 'ahmed9891', 'sal96', 'devices', 'omar_ahmed_95', 'momohamada_2010', 'medo', 'deena.ahmed.omar', 'omar44', 'nourhan.ahmed', 'omnia96', 'gemi.mansour1995', 'mohamedfathyzaiton', 'ahhamed93', 'mahmoudsherif2010', 'smelectronics43', 'mohamed.maher', 'fatmaayman', 'amir426', 'm.kamel.m.h', 'shaybob', 'mona_gamal', None, 'hebasamir', 'omarkhaledsebak', '3amona', 'sheehab.khaled', 'ahmedredahassanahmed']",227,"['eng.esraahafez2013', 'omaramer', 'yeahia14', 'karom1990', 'joseph_hana94', 'bosbos_fafy22xx', 'hussammurad5', 'morsizodiac123', 'noureentarek96', 'ashraf1', 'mostafaanas99', 'beko', 'ardorhee', 'peteremil', 'daniel.boshra', 'ahmadashiekh', 'raghdaezzatnole', 'muhadou95', 'zlzzlz008', 'simo88ud', 'binpda4', 'ahmedsaad96', 'hitman47222', 'baga96', 'medo', 'tarik10kv', 'islam2141', 'mhelsawaf', 'basmaa.shawkyy203', 'hassanshehata', 'p9012', 'mohamedfathyzaiton', 'marwamostafa5050', 'alaahussein50', 'ahhamed93', 'moonblack868', 'eng.ahmad.m.z', 'mariam95', 'arashgoodday', 'omarn4sser', 'abdurhmanalaaaldaly', 'nadahemid95', 'mohamed.maher', 'fatmaayman', 'ali96saad', 'nourelrayes', 'stressed_student', 'shaggykemo', 'doniahassan999', 'shaybob', 'noon486', 'bido', 'kamal24041996', 'eng.nohasaeed94', 'mohabahmedseif', 'mostafakhallaf100', 'omarkhaledsebak', 'kimo11mk', 'ahmadawad.fue66', 'mraba1111', 'muhammed_shaban99', 'mohamedrefaeiii', 'omardemos25', 'eldragon823', 'en.amr_mohamed', 'abdulrahman.elmashed', 'bbbty6064', 'noon48', 'parkchanwoo7', 'ahmedkhalilelsayed', 'doha_taher135', 'ahmed9891', 'minafouad', 'miragee85', 'marwa96', 'mai.elmoslmany95', 'hendkholeif', 'omar_ahmed_95', 'mohamedsoliman', 'momohamada_2010', 'ahmedabdelsalam12', 'youstinafayezfouad', 'ahmedmaged2318', 'butaflekaahlan', 'ahmedelgeneral00', 'mahmoud_33744', 'gemi.mansour1995', 'ahmed_khaledammar', 'mistanbullu', 'farahbayomi103', 'keithlyu', 'zakaria182', 'nadaamrarafa55', 'm2k2017', 'engineermskm', 'theinstructive_man', 'tarek.almowafy', 'ahmed.hassanen', 'osaka', 'mariame', 'mahmoud123', 'ahmed0raafat', 'saeeed3', 'mykel', 'nancyammar', 'rawannshehab', '3amona', 'yasmineelgogary', 'muhammed.shaban99.franky', 'eng.moaz.morsy', 'ziadelmehy', 'reem.hesham819', 'mero.ayman50', 'echoonge', 'krishnajha', '11parasarya', 'a.asmaasalem', 'shahir', 'reem15_5', 'mernamoneer_bombom', 'ahmed.allam86', 'omniya96', 'm7mdosama3000', 'rodyahmed1995', 'deena.ahmed.omar', 'omar44', 'jangsungin', 'mohammedosama', 'engy95', 'asfora', 'nouranekhaled95', 'thasty', 'mohammedmahmoudmahgoub', 'ahmedelalfy', 'youstinanassiflatif95', 'omnia96', 'he18911', 'ahmedtarek5155', 'yahialdeeb', 'emadhamdy', 'ezzeddinabdullah', 'smelectronics43', 'hossam.hassan2090', 'ahmedsamybeda', 'xuhan', 'maiuoymohamed.2011', 'maihossam', 'basaseko_208', 'ann_nona1995', 'mohamed_mandour212', 'amrghoniem94', 'saumopal1997', 'hgk', 'm.kamel.m.h', 'mh14039295', 'mohamedelbaga96', 'nadine.a.bahr95', 'mr_taha11', 'khalid_eissa', 'huda_96', 'momensaeed', 'radwahegazy95', 'mernamagdy118', 'louran_1995', 'yarahamdy', 'hatemmohammed', 'mohamedg327', 'mark.h.nabil', 'aparnaahari95', 'remonadly06', 'ahmedredahassanahmed', 'nourhantaha', 'hassan93', 'dohaalqaisi1', 'hassan.ayman2006', 'amrelsobky20', 'mohamedelhewehy', 'mayar31995', 'habiba_ashraf_96', 'ahmed.saad9772', 'daycock', 'sharara123', 'minasamuel', 'veroniayaman96', 'sal96', 'abdelrahman.khelshamy', 'devices', 'mohamedghamad', 'hossam_eldin_khaled_youssef', 'nerminemohamed15', 'ea', 'hoba201140', 'hedy_20072000', 'tadrous96', 'phantomx21', 'nourhan.ahmed', 'mennatallahwageehhassan', 'nadine.maghawry', 'engamr95', 'ozcomert.2', 'mahmoudsherif2010', 'peternady', 'amir426', 'mehmettas', 'alizorg4', 'muhlasheen', 'mona_gamal', None, 'niznkl', 'reham.a.mahmoud', 'maryam.nasser', 'mayar_ashraf', 'nana_girgis2009', 'mohamedali915', 'mirna31eldebeky', 'ahmadhany201696', 'esraaahmed95', 'rowaidaelawam', 'mmmahgoub', 'kyoussef', 'human101', 'mahmoud.salem432', 'hebasamir', 'sheehab.khaled', 'ahmed755', 'abdelaziz', 'aisilfarnardo95']"
2,16,195,29,1,['ardorhee'],193,"['eng.esraahafez2013', 'omaramer', 'yeahia14', 'karom1990', 'joseph_hana94', 'bosbos_fafy22xx', 'hussammurad5', 'morsizodiac123', 'ashraf1', 'mostafaanas99', 'beko', 'peteremil', 'daniel.boshra', 'ahmadashiekh', 'raghdaezzatnole', 'muhadou95', 'zlzzlz008', 'simo88ud', 'binpda4', 'ahmedsaad96', 'hitman47222', 'baga96', 'tarik10kv', 'islam2141', 'mhelsawaf', 'basmaa.shawkyy203', 'hassanshehata', 'p9012', 'marwamostafa5050', 'alaahussein50', 'moonblack868', 'eng.ahmad.m.z', 'mariam95', 'arashgoodday', 'omarn4sser', 'abdurhmanalaaaldaly', 'nadahemid95', 'ali96saad', 'nourelrayes', 'stressed_student', 'shaggykemo', 'doniahassan999', 'noon486', 'bido', 'kamal24041996', 'eng.nohasaeed94', 'mohabahmedseif', 'mostafakhallaf100', 'kimo11mk', 'ahmadawad.fue66', 'mraba1111', 'muhammed_shaban99', 'mohamedrefaeiii', 'omardemos25', 'eldragon823', 'en.amr_mohamed', 'bbbty6064', 'noon48', 'parkchanwoo7', 'ahmedkhalilelsayed', 'doha_taher135', 'minafouad', 'miragee85', 'marwa96', 'mai.elmoslmany95', 'hendkholeif', 'mohamedsoliman', 'ahmedabdelsalam12', 'youstinafayezfouad', 'ahmedmaged2318', 'butaflekaahlan', 'ahmedelgeneral00', 'mahmoud_33744', 'ahmed_khaledammar', 'mistanbullu', 'farahbayomi103', 'keithlyu', 'zakaria182', 'nadaamrarafa55', 'm2k2017', 'engineermskm', 'theinstructive_man', 'tarek.almowafy', 'ahmed.hassanen', 'osaka', 'mariame', 'mahmoud123', 'ahmed0raafat', 'saeeed3', 'mykel', 'nancyammar', 'rawannshehab', 'yasmineelgogary', 'muhammed.shaban99.franky', 'eng.moaz.morsy', 'reem.hesham819', 'mero.ayman50', 'echoonge', 'krishnajha', '11parasarya', 'a.asmaasalem', 'shahir', 'mernamoneer_bombom', 'ahmed.allam86', 'omniya96', 'm7mdosama3000', 'rodyahmed1995', 'jangsungin', 'mohammedosama', 'engy95', 'asfora', 'nouranekhaled95', 'thasty', 'mohammedmahmoudmahgoub', 'ahmedelalfy', 'youstinanassiflatif95', 'he18911', 'ahmedtarek5155', 'yahialdeeb', 'emadhamdy', 'ezzeddinabdullah', 'hossam.hassan2090', 'ahmedsamybeda', 'xuhan', 'maiuoymohamed.2011', 'maihossam', 'basaseko_208', 'ann_nona1995', 'mohamed_mandour212', 'amrghoniem94', 'saumopal1997', 'hgk', 'mh14039295', 'mohamedelbaga96', 'nadine.a.bahr95', 'mr_taha11', 'khalid_eissa', 'huda_96', 'momensaeed', 'radwahegazy95', 'mernamagdy118', 'louran_1995', 'yarahamdy', 'hatemmohammed', 'mohamedg327', 'mark.h.nabil', 'aparnaahari95', 'remonadly06', 'nourhantaha', 'dohaalqaisi1', 'hassan.ayman2006', 'amrelsobky20', 'mayar31995', 'habiba_ashraf_96', 'ahmed.saad9772', 'daycock', 'sharara123', 'minasamuel', 'veroniayaman96', 'abdelrahman.khelshamy', 'mohamedghamad', 'hossam_eldin_khaled_youssef', 'nerminemohamed15', 'ea', 'hoba201140', 'hedy_20072000', 'tadrous96', 'phantomx21', 'mennatallahwageehhassan', 'nadine.maghawry', 'engamr95', 'ozcomert.2', 'peternady', 'mehmettas', 'alizorg4', 'muhlasheen', 'niznkl', 'reham.a.mahmoud', 'maryam.nasser', 'mayar_ashraf', 'nana_girgis2009', 'mohamedali915', 'mirna31eldebeky', 'ahmadhany201696', 'esraaahmed95', 'rowaidaelawam', 'mmmahgoub', 'kyoussef', 'human101', 'mahmoud.salem432', 'ahmed755', 'abdelaziz', 'aisilfarnardo95']",28,"['sgu20121541', 'sgu20121546', 'sgu20131438', 'sgu20141467', 'sgug20160008', 'road', 'sgu20111478', 'sgu20121540', 'sgu20121484', 'sgu20111505', 'sgu20121451', 'carjehee', 'sgu20131480', 'sgu20121526', 'sgu20121465', 'sgu20141426', 'dogp27', 'gugusj', None, 'sgu20111577', 'sgu20121517', 'sgu20111493', 'sgu20121450', 'sgu20141482', 'sgu20102047', 'sgu20121467', 'thenopi10', 'sgu20101328']",222,"['eng.esraahafez2013', 'omaramer', 'yeahia14', 'karom1990', 'joseph_hana94', 'bosbos_fafy22xx', 'hussammurad5', 'morsizodiac123', 'sgu20131438', 'ashraf1', 'mostafaanas99', 'beko', 'ardorhee', 'peteremil', 'daniel.boshra', 'ahmadashiekh', 'raghdaezzatnole', 'muhadou95', 'zlzzlz008', 'simo88ud', 'binpda4', 'ahmedsaad96', 'hitman47222', 'baga96', 'tarik10kv', 'islam2141', 'mhelsawaf', 'basmaa.shawkyy203', 'sgu20121484', 'hassanshehata', 'p9012', 'marwamostafa5050', 'alaahussein50', 'sgu20121451', 'moonblack868', 'eng.ahmad.m.z', 'mariam95', 'arashgoodday', 'omarn4sser', 'abdurhmanalaaaldaly', 'sgu20131480', 'nadahemid95', 'sgu20121465', 'ali96saad', 'nourelrayes', 'stressed_student', 'shaggykemo', 'sgu20111577', 'doniahassan999', 'noon486', 'bido', 'kamal24041996', 'eng.nohasaeed94', 'mohabahmedseif', 'mostafakhallaf100', 'kimo11mk', 'ahmadawad.fue66', 'mraba1111', 'muhammed_shaban99', 'mohamedrefaeiii', 'omardemos25', 'eldragon823', 'en.amr_mohamed', 'sgu20121546', 'bbbty6064', 'noon48', 'parkchanwoo7', 'ahmedkhalilelsayed', 'doha_taher135', 'minafouad', 'miragee85', 'marwa96', 'mai.elmoslmany95', 'hendkholeif', 'mohamedsoliman', 'ahmedabdelsalam12', 'youstinafayezfouad', 'ahmedmaged2318', 'butaflekaahlan', 'ahmedelgeneral00', 'mahmoud_33744', 'road', 'sgu20111478', 'ahmed_khaledammar', 'mistanbullu', 'farahbayomi103', 'keithlyu', 'zakaria182', 'nadaamrarafa55', 'm2k2017', 'engineermskm', 'dogp27', 'theinstructive_man', 'tarek.almowafy', 'gugusj', 'ahmed.hassanen', 'osaka', 'mariame', 'mahmoud123', 'ahmed0raafat', 'saeeed3', 'mykel', 'nancyammar', 'rawannshehab', 'sgu20121517', 'yasmineelgogary', 'thenopi10', 'sgu20101328', 'muhammed.shaban99.franky', 'eng.moaz.morsy', 'reem.hesham819', 'mero.ayman50', 'echoonge', 'krishnajha', '11parasarya', 'sgu20141467', 'a.asmaasalem', 'shahir', 'mernamoneer_bombom', 'ahmed.allam86', 'omniya96', 'm7mdosama3000', 'rodyahmed1995', 'jangsungin', 'mohammedosama', 'engy95', 'asfora', 'nouranekhaled95', 'thasty', 'mohammedmahmoudmahgoub', 'ahmedelalfy', 'youstinanassiflatif95', 'carjehee', 'he18911', 'sgu20111505', 'ahmedtarek5155', 'yahialdeeb', 'emadhamdy', 'ezzeddinabdullah', 'sgu20121526', 'hossam.hassan2090', 'ahmedsamybeda', 'xuhan', 'maiuoymohamed.2011', 'maihossam', 'basaseko_208', 'ann_nona1995', 'mohamed_mandour212', 'amrghoniem94', 'saumopal1997', 'hgk', 'mh14039295', 'mohamedelbaga96', 'nadine.a.bahr95', 'mr_taha11', 'khalid_eissa', 'huda_96', 'momensaeed', 'radwahegazy95', 'mernamagdy118', 'louran_1995', 'yarahamdy', 'hatemmohammed', 'mohamedg327', 'mark.h.nabil', 'sgu20111493', 'sgu20121450', 'aparnaahari95', 'remonadly06', 'nourhantaha', 'dohaalqaisi1', 'sgu20121541', 'hassan.ayman2006', 'amrelsobky20', 'mayar31995', 'habiba_ashraf_96', 'ahmed.saad9772', 'daycock', 'sharara123', 'sgug20160008', 'minasamuel', 'veroniayaman96', 'abdelrahman.khelshamy', 'mohamedghamad', 'hossam_eldin_khaled_youssef', 'nerminemohamed15', 'ea', 'hoba201140', 'hedy_20072000', 'tadrous96', 'phantomx21', 'mennatallahwageehhassan', 'sgu20121540', 'nadine.maghawry', 'engamr95', 'ozcomert.2', 'peternady', 'sgu20141426', 'mehmettas', 'alizorg4', 'muhlasheen', None, 'niznkl', 'reham.a.mahmoud', 'maryam.nasser', 'mayar_ashraf', 'nana_girgis2009', 'mohamedali915', 'mirna31eldebeky', 'ahmadhany201696', 'esraaahmed95', 'rowaidaelawam', 'mmmahgoub', 'kyoussef', 'human101', 'mahmoud.salem432', 'sgu20141482', 'ahmed755', 'sgu20102047', 'abdelaziz', 'sgu20121467', 'aisilfarnardo95']"
2,23,195,27,25,"['muhammed.shaban99.franky', 'eldragon823', 'hassan.ayman2006', 'ashraf1', 'beko', 'sharara123', 'mernamoneer_bombom', 'minasamuel', 'abdelrahman.khelshamy', 'ahmedabdelsalam12', 'hossam_eldin_khaled_youssef', 'mohammedosama', 'ahmedelalfy', 'phantomx21', 'ezzeddinabdullah', 'basaseko_208', 'nadine.a.bahr95', 'maryam.nasser', 'mariame', 'esraaahmed95', 'mernamagdy118', 'human101', 'muhammed_shaban99', 'aisilfarnardo95', 'omardemos25']",169,"['eng.esraahafez2013', 'omaramer', 'yeahia14', 'karom1990', 'joseph_hana94', 'bosbos_fafy22xx', 'hussammurad5', 'morsizodiac123', 'mostafaanas99', 'ardorhee', 'peteremil', 'daniel.boshra', 'ahmadashiekh', 'raghdaezzatnole', 'muhadou95', 'zlzzlz008', 'simo88ud', 'binpda4', 'ahmedsaad96', 'hitman47222', 'baga96', 'tarik10kv', 'islam2141', 'mhelsawaf', 'basmaa.shawkyy203', 'hassanshehata', 'p9012', 'marwamostafa5050', 'alaahussein50', 'moonblack868', 'eng.ahmad.m.z', 'mariam95', 'arashgoodday', 'omarn4sser', 'abdurhmanalaaaldaly', 'nadahemid95', 'ali96saad', 'nourelrayes', 'stressed_student', 'shaggykemo', 'doniahassan999', 'noon486', 'bido', 'kamal24041996', 'eng.nohasaeed94', 'mohabahmedseif', 'mostafakhallaf100', 'kimo11mk', 'ahmadawad.fue66', 'mraba1111', 'mohamedrefaeiii', 'en.amr_mohamed', 'bbbty6064', 'noon48', 'parkchanwoo7', 'ahmedkhalilelsayed', 'doha_taher135', 'minafouad', 'miragee85', 'marwa96', 'mai.elmoslmany95', 'hendkholeif', 'mohamedsoliman', 'youstinafayezfouad', 'ahmedmaged2318', 'butaflekaahlan', 'ahmedelgeneral00', 'mahmoud_33744', 'ahmed_khaledammar', 'mistanbullu', 'farahbayomi103', 'keithlyu', 'zakaria182', 'nadaamrarafa55', 'm2k2017', 'engineermskm', 'theinstructive_man', 'tarek.almowafy', 'ahmed.hassanen', 'osaka', 'mahmoud123', 'ahmed0raafat', 'saeeed3', 'mykel', 'nancyammar', 'rawannshehab', 'yasmineelgogary', 'eng.moaz.morsy', 'reem.hesham819', 'mero.ayman50', 'echoonge', 'krishnajha', '11parasarya', 'a.asmaasalem', 'shahir', 'ahmed.allam86', 'omniya96', 'm7mdosama3000', 'rodyahmed1995', 'jangsungin', 'engy95', 'asfora', 'nouranekhaled95', 'thasty', 'mohammedmahmoudmahgoub', 'youstinanassiflatif95', 'he18911', 'ahmedtarek5155', 'yahialdeeb', 'emadhamdy', 'hossam.hassan2090', 'ahmedsamybeda', 'xuhan', 'maiuoymohamed.2011', 'maihossam', 'ann_nona1995', 'mohamed_mandour212', 'amrghoniem94', 'saumopal1997', 'hgk', 'mh14039295', 'mohamedelbaga96', 'mr_taha11', 'khalid_eissa', 'huda_96', 'momensaeed', 'radwahegazy95', 'louran_1995', 'yarahamdy', 'hatemmohammed', 'mohamedg327', 'mark.h.nabil', 'aparnaahari95', 'remonadly06', 'nourhantaha', 'dohaalqaisi1', 'amrelsobky20', 'mayar31995', 'habiba_ashraf_96', 'ahmed.saad9772', 'daycock', 'veroniayaman96', 'mohamedghamad', 'nerminemohamed15', 'ea', 'hoba201140', 'hedy_20072000', 'tadrous96', 'mennatallahwageehhassan', 'nadine.maghawry', 'engamr95', 'ozcomert.2', 'peternady', 'mehmettas', 'alizorg4', 'muhlasheen', 'niznkl', 'reham.a.mahmoud', 'mayar_ashraf', 'nana_girgis2009', 'mohamedali915', 'mirna31eldebeky', 'ahmadhany201696', 'rowaidaelawam', 'mmmahgoub', 'kyoussef', 'mahmoud.salem432', 'ahmed755', 'abdelaziz']",2,"[None, 'selma_ashraf']",196,"['eng.esraahafez2013', 'omaramer', 'yeahia14', 'karom1990', 'joseph_hana94', 'bosbos_fafy22xx', 'hussammurad5', 'morsizodiac123', 'ashraf1', 'mostafaanas99', 'beko', 'ardorhee', 'peteremil', 'daniel.boshra', 'ahmadashiekh', 'raghdaezzatnole', 'muhadou95', 'zlzzlz008', 'simo88ud', 'selma_ashraf', 'binpda4', 'ahmedsaad96', 'hitman47222', 'baga96', 'tarik10kv', 'islam2141', 'mhelsawaf', 'basmaa.shawkyy203', 'hassanshehata', 'p9012', 'marwamostafa5050', 'alaahussein50', 'moonblack868', 'eng.ahmad.m.z', 'mariam95', 'arashgoodday', 'omarn4sser', 'abdurhmanalaaaldaly', 'nadahemid95', 'ali96saad', 'nourelrayes', 'stressed_student', 'shaggykemo', 'doniahassan999', 'noon486', 'bido', 'kamal24041996', 'eng.nohasaeed94', 'mohabahmedseif', 'mostafakhallaf100', 'kimo11mk', 'ahmadawad.fue66', 'mraba1111', 'muhammed_shaban99', 'mohamedrefaeiii', 'omardemos25', 'eldragon823', 'en.amr_mohamed', 'bbbty6064', 'noon48', 'parkchanwoo7', 'ahmedkhalilelsayed', 'doha_taher135', 'minafouad', 'miragee85', 'marwa96', 'mai.elmoslmany95', 'hendkholeif', 'mohamedsoliman', 'ahmedabdelsalam12', 'youstinafayezfouad', 'ahmedmaged2318', 'butaflekaahlan', 'ahmedelgeneral00', 'mahmoud_33744', 'ahmed_khaledammar', 'mistanbullu', 'farahbayomi103', 'keithlyu', 'zakaria182', 'nadaamrarafa55', 'm2k2017', 'engineermskm', 'theinstructive_man', 'tarek.almowafy', 'ahmed.hassanen', 'osaka', 'mariame', 'mahmoud123', 'ahmed0raafat', 'saeeed3', 'mykel', 'nancyammar', 'rawannshehab', 'yasmineelgogary', 'muhammed.shaban99.franky', 'eng.moaz.morsy', 'reem.hesham819', 'mero.ayman50', 'echoonge', 'krishnajha', '11parasarya', 'a.asmaasalem', 'shahir', 'mernamoneer_bombom', 'ahmed.allam86', 'omniya96', 'm7mdosama3000', 'rodyahmed1995', 'jangsungin', 'mohammedosama', 'engy95', 'asfora', 'nouranekhaled95', 'thasty', 'mohammedmahmoudmahgoub', 'ahmedelalfy', 'youstinanassiflatif95', 'he18911', 'ahmedtarek5155', 'yahialdeeb', 'emadhamdy', 'ezzeddinabdullah', 'hossam.hassan2090', 'ahmedsamybeda', 'xuhan', 'maiuoymohamed.2011', 'maihossam', 'basaseko_208', 'ann_nona1995', 'mohamed_mandour212', 'amrghoniem94', 'saumopal1997', 'hgk', 'mh14039295', 'mohamedelbaga96', 'nadine.a.bahr95', 'mr_taha11', 'khalid_eissa', 'huda_96', 'momensaeed', 'radwahegazy95', 'mernamagdy118', 'louran_1995', 'yarahamdy', 'hatemmohammed', 'mohamedg327', 'mark.h.nabil', 'aparnaahari95', 'remonadly06', 'nourhantaha', 'dohaalqaisi1', 'hassan.ayman2006', 'amrelsobky20', 'mayar31995', 'habiba_ashraf_96', 'ahmed.saad9772', 'daycock', 'sharara123', 'minasamuel', 'veroniayaman96', 'abdelrahman.khelshamy', 'mohamedghamad', 'hossam_eldin_khaled_youssef', 'nerminemohamed15', 'ea', 'hoba201140', 'hedy_20072000', 'tadrous96', 'phantomx21', 'mennatallahwageehhassan', 'nadine.maghawry', 'engamr95', 'ozcomert.2', 'peternady', 'mehmettas', 'alizorg4', 'muhlasheen', None, 'niznkl', 'reham.a.mahmoud', 'maryam.nasser', 'mayar_ashraf', 'nana_girgis2009', 'mohamedali915', 'mirna31eldebeky', 'ahmadhany201696', 'esraaahmed95', 'rowaidaelawam', 'mmmahgoub', 'kyoussef', 'human101', 'mahmoud.salem432', 'ahmed755', 'abdelaziz', 'aisilfarnardo95']"
2,19,195,25,1,['saumopal1997'],193,"['eng.esraahafez2013', 'omaramer', 'yeahia14', 'karom1990', 'joseph_hana94', 'bosbos_fafy22xx', 'hussammurad5', 'morsizodiac123', 'ashraf1', 'mostafaanas99', 'beko', 'ardorhee', 'peteremil', 'daniel.boshra', 'ahmadashiekh', 'raghdaezzatnole', 'muhadou95', 'zlzzlz008', 'simo88ud', 'binpda4', 'ahmedsaad96', 'hitman47222', 'baga96', 'tarik10kv', 'islam2141', 'mhelsawaf', 'basmaa.shawkyy203', 'hassanshehata', 'p9012', 'marwamostafa5050', 'alaahussein50', 'moonblack868', 'eng.ahmad.m.z', 'mariam95', 'arashgoodday', 'omarn4sser', 'abdurhmanalaaaldaly', 'nadahemid95', 'ali96saad', 'nourelrayes', 'stressed_student', 'shaggykemo', 'doniahassan999', 'noon486', 'bido', 'kamal24041996', 'eng.nohasaeed94', 'mohabahmedseif', 'mostafakhallaf100', 'kimo11mk', 'ahmadawad.fue66', 'mraba1111', 'muhammed_shaban99', 'mohamedrefaeiii', 'omardemos25', 'eldragon823', 'en.amr_mohamed', 'bbbty6064', 'noon48', 'parkchanwoo7', 'ahmedkhalilelsayed', 'doha_taher135', 'minafouad', 'miragee85', 'marwa96', 'mai.elmoslmany95', 'hendkholeif', 'mohamedsoliman', 'ahmedabdelsalam12', 'youstinafayezfouad', 'ahmedmaged2318', 'butaflekaahlan', 'ahmedelgeneral00', 'mahmoud_33744', 'ahmed_khaledammar', 'mistanbullu', 'farahbayomi103', 'keithlyu', 'zakaria182', 'nadaamrarafa55', 'm2k2017', 'engineermskm', 'theinstructive_man', 'tarek.almowafy', 'ahmed.hassanen', 'osaka', 'mariame', 'mahmoud123', 'ahmed0raafat', 'saeeed3', 'mykel', 'nancyammar', 'rawannshehab', 'yasmineelgogary', 'muhammed.shaban99.franky', 'eng.moaz.morsy', 'reem.hesham819', 'mero.ayman50', 'echoonge', 'krishnajha', '11parasarya', 'a.asmaasalem', 'shahir', 'mernamoneer_bombom', 'ahmed.allam86', 'omniya96', 'm7mdosama3000', 'rodyahmed1995', 'jangsungin', 'mohammedosama', 'engy95', 'asfora', 'nouranekhaled95', 'thasty', 'mohammedmahmoudmahgoub', 'ahmedelalfy', 'youstinanassiflatif95', 'he18911', 'ahmedtarek5155', 'yahialdeeb', 'emadhamdy', 'ezzeddinabdullah', 'hossam.hassan2090', 'ahmedsamybeda', 'xuhan', 'maiuoymohamed.2011', 'maihossam', 'basaseko_208', 'ann_nona1995', 'mohamed_mandour212', 'amrghoniem94', 'hgk', 'mh14039295', 'mohamedelbaga96', 'nadine.a.bahr95', 'mr_taha11', 'khalid_eissa', 'huda_96', 'momensaeed', 'radwahegazy95', 'mernamagdy118', 'louran_1995', 'yarahamdy', 'hatemmohammed', 'mohamedg327', 'mark.h.nabil', 'aparnaahari95', 'remonadly06', 'nourhantaha', 'dohaalqaisi1', 'hassan.ayman2006', 'amrelsobky20', 'mayar31995', 'habiba_ashraf_96', 'ahmed.saad9772', 'daycock', 'sharara123', 'minasamuel', 'veroniayaman96', 'abdelrahman.khelshamy', 'mohamedghamad', 'hossam_eldin_khaled_youssef', 'nerminemohamed15', 'ea', 'hoba201140', 'hedy_20072000', 'tadrous96', 'phantomx21', 'mennatallahwageehhassan', 'nadine.maghawry', 'engamr95', 'ozcomert.2', 'peternady', 'mehmettas', 'alizorg4', 'muhlasheen', 'niznkl', 'reham.a.mahmoud', 'maryam.nasser', 'mayar_ashraf', 'nana_girgis2009', 'mohamedali915', 'mirna31eldebeky', 'ahmadhany201696', 'esraaahmed95', 'rowaidaelawam', 'mmmahgoub', 'kyoussef', 'human101', 'mahmoud.salem432', 'ahmed755', 'abdelaziz', 'aisilfarnardo95']",24,"['kunalkhadke97', 'beena11', 'nivedprakash1996', 'rakesh207', 'niharika25', 'kagitanikhil', 'sim_ks', 'sudzsharma', 'antroy.rc', 'hardikagrawal545', 'vineethvinny1997', 'pourushsood', 'sairohith', 'satakarni_amirneni', 'kumarvineeth14', 'mriganksh', 'dipanjandas1996', 'keerthana_bhogi', 'joshuapeterebenezer', 'dishankyadav96', None, 'deepthireddyparvatham12', 'nitinkush16', 'mayankpalaria']",218,"['eng.esraahafez2013', 'omaramer', 'yeahia14', 'karom1990', 'joseph_hana94', 'bosbos_fafy22xx', 'hussammurad5', 'morsizodiac123', 'ashraf1', 'mostafaanas99', 'beko', 'ardorhee', 'peteremil', 'daniel.boshra', 'ahmadashiekh', 'raghdaezzatnole', 'muhadou95', 'mayankpalaria', 'zlzzlz008', 'simo88ud', 'antroy.rc', 'binpda4', 'ahmedsaad96', 'vineethvinny1997', 'hitman47222', 'baga96', 'pourushsood', 'sairohith', 'tarik10kv', 'kumarvineeth14', 'islam2141', 'mhelsawaf', 'basmaa.shawkyy203', 'hassanshehata', 'p9012', 'marwamostafa5050', 'alaahussein50', 'moonblack868', 'eng.ahmad.m.z', 'mariam95', 'arashgoodday', 'omarn4sser', 'abdurhmanalaaaldaly', 'dipanjandas1996', 'dishankyadav96', 'nadahemid95', 'ali96saad', 'nourelrayes', 'stressed_student', 'shaggykemo', 'doniahassan999', 'noon486', 'bido', 'kamal24041996', 'eng.nohasaeed94', 'mohabahmedseif', 'mostafakhallaf100', 'kimo11mk', 'ahmadawad.fue66', 'mraba1111', 'muhammed_shaban99', 'mohamedrefaeiii', 'omardemos25', 'eldragon823', 'en.amr_mohamed', 'kunalkhadke97', 'bbbty6064', 'noon48', 'parkchanwoo7', 'ahmedkhalilelsayed', 'doha_taher135', 'sim_ks', 'minafouad', 'miragee85', 'marwa96', 'mai.elmoslmany95', 'hardikagrawal545', 'hendkholeif', 'mohamedsoliman', 'satakarni_amirneni', 'ahmedabdelsalam12', 'youstinafayezfouad', 'ahmedmaged2318', 'butaflekaahlan', 'ahmedelgeneral00', 'mahmoud_33744', 'ahmed_khaledammar', 'mistanbullu', 'farahbayomi103', 'keithlyu', 'zakaria182', 'nadaamrarafa55', 'm2k2017', 'engineermskm', 'theinstructive_man', 'tarek.almowafy', 'ahmed.hassanen', 'osaka', 'mariame', 'mahmoud123', 'ahmed0raafat', 'saeeed3', 'mykel', 'nancyammar', 'rawannshehab', 'yasmineelgogary', 'muhammed.shaban99.franky', 'eng.moaz.morsy', 'reem.hesham819', 'mero.ayman50', 'echoonge', 'nivedprakash1996', 'krishnajha', '11parasarya', 'a.asmaasalem', 'shahir', 'mernamoneer_bombom', 'ahmed.allam86', 'omniya96', 'm7mdosama3000', 'rodyahmed1995', 'jangsungin', 'mohammedosama', 'engy95', 'asfora', 'nouranekhaled95', 'thasty', 'mohammedmahmoudmahgoub', 'ahmedelalfy', 'youstinanassiflatif95', 'he18911', 'ahmedtarek5155', 'yahialdeeb', 'emadhamdy', 'ezzeddinabdullah', 'joshuapeterebenezer', 'hossam.hassan2090', 'ahmedsamybeda', 'xuhan', 'maiuoymohamed.2011', 'maihossam', 'basaseko_208', 'ann_nona1995', 'mohamed_mandour212', 'amrghoniem94', 'saumopal1997', 'hgk', 'mh14039295', 'mohamedelbaga96', 'nadine.a.bahr95', 'mr_taha11', 'khalid_eissa', 'huda_96', 'momensaeed', 'radwahegazy95', 'mernamagdy118', 'louran_1995', 'yarahamdy', 'hatemmohammed', 'mohamedg327', 'mark.h.nabil', 'deepthireddyparvatham12', 'aparnaahari95', 'remonadly06', 'nourhantaha', 'dohaalqaisi1', 'beena11', 'rakesh207', 'hassan.ayman2006', 'amrelsobky20', 'niharika25', 'mayar31995', 'kagitanikhil', 'sudzsharma', 'habiba_ashraf_96', 'ahmed.saad9772', 'daycock', 'sharara123', 'minasamuel', 'veroniayaman96', 'abdelrahman.khelshamy', 'mohamedghamad', 'hossam_eldin_khaled_youssef', 'nerminemohamed15', 'ea', 'hoba201140', 'hedy_20072000', 'tadrous96', 'phantomx21', 'mennatallahwageehhassan', 'nadine.maghawry', 'engamr95', 'mriganksh', 'ozcomert.2', 'keerthana_bhogi', 'peternady', 'mehmettas', 'alizorg4', 'muhlasheen', None, 'niznkl', 'reham.a.mahmoud', 'maryam.nasser', 'mayar_ashraf', 'nana_girgis2009', 'mohamedali915', 'mirna31eldebeky', 'ahmadhany201696', 'esraaahmed95', 'rowaidaelawam', 'mmmahgoub', 'kyoussef', 'human101', 'mahmoud.salem432', 'nitinkush16', 'ahmed755', 'abdelaziz', 'aisilfarnardo95']"
2,20,195,12,8,"['stressed_student', 'rodyahmed1995', 'saeeed3', 'tadrous96', 'phantomx21', 'hgk', 'ahmed.saad9772', 'hassanshehata']",186,"['eng.esraahafez2013', 'omaramer', 'yeahia14', 'karom1990', 'joseph_hana94', 'bosbos_fafy22xx', 'hussammurad5', 'morsizodiac123', 'ashraf1', 'mostafaanas99', 'beko', 'ardorhee', 'peteremil', 'daniel.boshra', 'ahmadashiekh', 'raghdaezzatnole', 'muhadou95', 'zlzzlz008', 'simo88ud', 'binpda4', 'ahmedsaad96', 'hitman47222', 'baga96', 'tarik10kv', 'islam2141', 'mhelsawaf', 'basmaa.shawkyy203', 'p9012', 'marwamostafa5050', 'alaahussein50', 'moonblack868', 'eng.ahmad.m.z', 'mariam95', 'arashgoodday', 'omarn4sser', 'abdurhmanalaaaldaly', 'nadahemid95', 'ali96saad', 'nourelrayes', 'shaggykemo', 'doniahassan999', 'noon486', 'bido', 'kamal24041996', 'eng.nohasaeed94', 'mohabahmedseif', 'mostafakhallaf100', 'kimo11mk', 'ahmadawad.fue66', 'mraba1111', 'muhammed_shaban99', 'mohamedrefaeiii', 'omardemos25', 'eldragon823', 'en.amr_mohamed', 'bbbty6064', 'noon48', 'parkchanwoo7', 'ahmedkhalilelsayed', 'doha_taher135', 'minafouad', 'miragee85', 'marwa96', 'mai.elmoslmany95', 'hendkholeif', 'mohamedsoliman', 'ahmedabdelsalam12', 'youstinafayezfouad', 'ahmedmaged2318', 'butaflekaahlan', 'ahmedelgeneral00', 'mahmoud_33744', 'ahmed_khaledammar', 'mistanbullu', 'farahbayomi103', 'keithlyu', 'zakaria182', 'nadaamrarafa55', 'm2k2017', 'engineermskm', 'theinstructive_man', 'tarek.almowafy', 'ahmed.hassanen', 'osaka', 'mariame', 'mahmoud123', 'ahmed0raafat', 'mykel', 'nancyammar', 'rawannshehab', 'yasmineelgogary', 'muhammed.shaban99.franky', 'eng.moaz.morsy', 'reem.hesham819', 'mero.ayman50', 'echoonge', 'krishnajha', '11parasarya', 'a.asmaasalem', 'shahir', 'mernamoneer_bombom', 'ahmed.allam86', 'omniya96', 'm7mdosama3000', 'jangsungin', 'mohammedosama', 'engy95', 'asfora', 'nouranekhaled95', 'thasty', 'mohammedmahmoudmahgoub', 'ahmedelalfy', 'youstinanassiflatif95', 'he18911', 'ahmedtarek5155', 'yahialdeeb', 'emadhamdy', 'ezzeddinabdullah', 'hossam.hassan2090', 'ahmedsamybeda', 'xuhan', 'maiuoymohamed.2011', 'maihossam', 'basaseko_208', 'ann_nona1995', 'mohamed_mandour212', 'amrghoniem94', 'saumopal1997', 'mh14039295', 'mohamedelbaga96', 'nadine.a.bahr95', 'mr_taha11', 'khalid_eissa', 'huda_96', 'momensaeed', 'radwahegazy95', 'mernamagdy118', 'louran_1995', 'yarahamdy', 'hatemmohammed', 'mohamedg327', 'mark.h.nabil', 'aparnaahari95', 'remonadly06', 'nourhantaha', 'dohaalqaisi1', 'hassan.ayman2006', 'amrelsobky20', 'mayar31995', 'habiba_ashraf_96', 'daycock', 'sharara123', 'minasamuel', 'veroniayaman96', 'abdelrahman.khelshamy', 'mohamedghamad', 'hossam_eldin_khaled_youssef', 'nerminemohamed15', 'ea', 'hoba201140', 'hedy_20072000', 'mennatallahwageehhassan', 'nadine.maghawry', 'engamr95', 'ozcomert.2', 'peternady', 'mehmettas', 'alizorg4', 'muhlasheen', 'niznkl', 'reham.a.mahmoud', 'maryam.nasser', 'mayar_ashraf', 'nana_girgis2009', 'mohamedali915', 'mirna31eldebeky', 'ahmadhany201696', 'esraaahmed95', 'rowaidaelawam', 'mmmahgoub', 'kyoussef', 'human101', 'mahmoud.salem432', 'ahmed755', 'abdelaziz', 'aisilfarnardo95']",4,"['14p3090', 'amr_salah', 'persons58', None]",198,"['eng.esraahafez2013', 'omaramer', 'yeahia14', 'karom1990', 'joseph_hana94', 'bosbos_fafy22xx', 'hussammurad5', 'morsizodiac123', 'ashraf1', 'mostafaanas99', 'beko', 'ardorhee', 'peteremil', 'daniel.boshra', 'ahmadashiekh', 'raghdaezzatnole', 'muhadou95', 'zlzzlz008', 'simo88ud', 'binpda4', 'ahmedsaad96', 'hitman47222', 'baga96', 'tarik10kv', 'islam2141', 'mhelsawaf', 'basmaa.shawkyy203', 'hassanshehata', 'p9012', 'marwamostafa5050', 'alaahussein50', 'moonblack868', 'eng.ahmad.m.z', 'mariam95', 'arashgoodday', 'omarn4sser', 'abdurhmanalaaaldaly', 'nadahemid95', 'ali96saad', 'nourelrayes', 'stressed_student', 'shaggykemo', 'doniahassan999', 'noon486', 'bido', 'kamal24041996', 'eng.nohasaeed94', 'mohabahmedseif', 'mostafakhallaf100', 'kimo11mk', 'ahmadawad.fue66', 'mraba1111', 'muhammed_shaban99', 'mohamedrefaeiii', 'omardemos25', 'eldragon823', 'en.amr_mohamed', 'bbbty6064', 'noon48', 'parkchanwoo7', 'ahmedkhalilelsayed', 'doha_taher135', 'minafouad', 'miragee85', 'marwa96', 'mai.elmoslmany95', 'hendkholeif', 'mohamedsoliman', 'ahmedabdelsalam12', 'youstinafayezfouad', 'ahmedmaged2318', 'butaflekaahlan', 'ahmedelgeneral00', '14p3090', 'mahmoud_33744', 'ahmed_khaledammar', 'mistanbullu', 'farahbayomi103', 'keithlyu', 'zakaria182', 'nadaamrarafa55', 'm2k2017', 'engineermskm', 'theinstructive_man', 'tarek.almowafy', 'ahmed.hassanen', 'osaka', 'mariame', 'mahmoud123', 'ahmed0raafat', 'saeeed3', 'mykel', 'nancyammar', 'rawannshehab', 'yasmineelgogary', 'muhammed.shaban99.franky', 'eng.moaz.morsy', 'reem.hesham819', 'mero.ayman50', 'echoonge', 'krishnajha', '11parasarya', 'a.asmaasalem', 'shahir', 'mernamoneer_bombom', 'ahmed.allam86', 'omniya96', 'm7mdosama3000', 'rodyahmed1995', 'jangsungin', 'mohammedosama', 'engy95', 'asfora', 'nouranekhaled95', 'thasty', 'mohammedmahmoudmahgoub', 'ahmedelalfy', 'youstinanassiflatif95', 'he18911', 'ahmedtarek5155', 'yahialdeeb', 'emadhamdy', 'ezzeddinabdullah', 'persons58', 'hossam.hassan2090', 'ahmedsamybeda', 'xuhan', 'maiuoymohamed.2011', 'maihossam', 'basaseko_208', 'ann_nona1995', 'mohamed_mandour212', 'amrghoniem94', 'saumopal1997', 'hgk', 'mh14039295', 'mohamedelbaga96', 'nadine.a.bahr95', 'mr_taha11', 'khalid_eissa', 'huda_96', 'momensaeed', 'radwahegazy95', 'mernamagdy118', 'louran_1995', 'yarahamdy', 'hatemmohammed', 'mohamedg327', 'mark.h.nabil', 'aparnaahari95', 'remonadly06', 'nourhantaha', 'dohaalqaisi1', 'hassan.ayman2006', 'amrelsobky20', 'mayar31995', 'habiba_ashraf_96', 'ahmed.saad9772', 'daycock', 'sharara123', 'minasamuel', 'veroniayaman96', 'abdelrahman.khelshamy', 'mohamedghamad', 'hossam_eldin_khaled_youssef', 'nerminemohamed15', 'ea', 'hoba201140', 'hedy_20072000', 'tadrous96', 'phantomx21', 'mennatallahwageehhassan', 'nadine.maghawry', 'engamr95', 'ozcomert.2', 'peternady', 'mehmettas', 'alizorg4', 'muhlasheen', None, 'niznkl', 'reham.a.mahmoud', 'maryam.nasser', 'mayar_ashraf', 'nana_girgis2009', 'mohamedali915', 'mirna31eldebeky', 'ahmadhany201696', 'esraaahmed95', 'rowaidaelawam', 'mmmahgoub', 'kyoussef', 'human101', 'mahmoud.salem432', 'amr_salah', 'ahmed755', 'abdelaziz', 'aisilfarnardo95']"
2,54,195,6,1,['aparnaahari95'],193,"['eng.esraahafez2013', 'omaramer', 'yeahia14', 'karom1990', 'joseph_hana94', 'bosbos_fafy22xx', 'hussammurad5', 'morsizodiac123', 'ashraf1', 'mostafaanas99', 'beko', 'ardorhee', 'peteremil', 'daniel.boshra', 'ahmadashiekh', 'raghdaezzatnole', 'muhadou95', 'zlzzlz008', 'simo88ud', 'binpda4', 'ahmedsaad96', 'hitman47222', 'baga96', 'tarik10kv', 'islam2141', 'mhelsawaf', 'basmaa.shawkyy203', 'hassanshehata', 'p9012', 'marwamostafa5050', 'alaahussein50', 'moonblack868', 'eng.ahmad.m.z', 'mariam95', 'arashgoodday', 'omarn4sser', 'abdurhmanalaaaldaly', 'nadahemid95', 'ali96saad', 'nourelrayes', 'stressed_student', 'shaggykemo', 'doniahassan999', 'noon486', 'bido', 'kamal24041996', 'eng.nohasaeed94', 'mohabahmedseif', 'mostafakhallaf100', 'kimo11mk', 'ahmadawad.fue66', 'mraba1111', 'muhammed_shaban99', 'mohamedrefaeiii', 'omardemos25', 'eldragon823', 'en.amr_mohamed', 'bbbty6064', 'noon48', 'parkchanwoo7', 'ahmedkhalilelsayed', 'doha_taher135', 'minafouad', 'miragee85', 'marwa96', 'mai.elmoslmany95', 'hendkholeif', 'mohamedsoliman', 'ahmedabdelsalam12', 'youstinafayezfouad', 'ahmedmaged2318', 'butaflekaahlan', 'ahmedelgeneral00', 'mahmoud_33744', 'ahmed_khaledammar', 'mistanbullu', 'farahbayomi103', 'keithlyu', 'zakaria182', 'nadaamrarafa55', 'm2k2017', 'engineermskm', 'theinstructive_man', 'tarek.almowafy', 'ahmed.hassanen', 'osaka', 'mariame', 'mahmoud123', 'ahmed0raafat', 'saeeed3', 'mykel', 'nancyammar', 'rawannshehab', 'yasmineelgogary', 'muhammed.shaban99.franky', 'eng.moaz.morsy', 'reem.hesham819', 'mero.ayman50', 'echoonge', 'krishnajha', '11parasarya', 'a.asmaasalem', 'shahir', 'mernamoneer_bombom', 'ahmed.allam86', 'omniya96', 'm7mdosama3000', 'rodyahmed1995', 'jangsungin', 'mohammedosama', 'engy95', 'asfora', 'nouranekhaled95', 'thasty', 'mohammedmahmoudmahgoub', 'ahmedelalfy', 'youstinanassiflatif95', 'he18911', 'ahmedtarek5155', 'yahialdeeb', 'emadhamdy', 'ezzeddinabdullah', 'hossam.hassan2090', 'ahmedsamybeda', 'xuhan', 'maiuoymohamed.2011', 'maihossam', 'basaseko_208', 'ann_nona1995', 'mohamed_mandour212', 'amrghoniem94', 'saumopal1997', 'hgk', 'mh14039295', 'mohamedelbaga96', 'nadine.a.bahr95', 'mr_taha11', 'khalid_eissa', 'huda_96', 'momensaeed', 'radwahegazy95', 'mernamagdy118', 'louran_1995', 'yarahamdy', 'hatemmohammed', 'mohamedg327', 'mark.h.nabil', 'remonadly06', 'nourhantaha', 'dohaalqaisi1', 'hassan.ayman2006', 'amrelsobky20', 'mayar31995', 'habiba_ashraf_96', 'ahmed.saad9772', 'daycock', 'sharara123', 'minasamuel', 'veroniayaman96', 'abdelrahman.khelshamy', 'mohamedghamad', 'hossam_eldin_khaled_youssef', 'nerminemohamed15', 'ea', 'hoba201140', 'hedy_20072000', 'tadrous96', 'phantomx21', 'mennatallahwageehhassan', 'nadine.maghawry', 'engamr95', 'ozcomert.2', 'peternady', 'mehmettas', 'alizorg4', 'muhlasheen', 'niznkl', 'reham.a.mahmoud', 'maryam.nasser', 'mayar_ashraf', 'nana_girgis2009', 'mohamedali915', 'mirna31eldebeky', 'ahmadhany201696', 'esraaahmed95', 'rowaidaelawam', 'mmmahgoub', 'kyoussef', 'human101', 'mahmoud.salem432', 'ahmed755', 'abdelaziz', 'aisilfarnardo95']",5,"['nijamkureshi2894', 'suryatejachitturi', 'spooja.1430', 'abarge31', None]",199,"['eng.esraahafez2013', 'omaramer', 'yeahia14', 'karom1990', 'joseph_hana94', 'bosbos_fafy22xx', 'hussammurad5', 'morsizodiac123', 'ashraf1', 'mostafaanas99', 'beko', 'ardorhee', 'peteremil', 'daniel.boshra', 'ahmadashiekh', 'raghdaezzatnole', 'muhadou95', 'zlzzlz008', 'simo88ud', 'binpda4', 'ahmedsaad96', 'hitman47222', 'baga96', 'tarik10kv', 'islam2141', 'mhelsawaf', 'basmaa.shawkyy203', 'hassanshehata', 'p9012', 'marwamostafa5050', 'alaahussein50', 'moonblack868', 'eng.ahmad.m.z', 'mariam95', 'arashgoodday', 'omarn4sser', 'abdurhmanalaaaldaly', 'nadahemid95', 'ali96saad', 'nourelrayes', 'stressed_student', 'shaggykemo', 'doniahassan999', 'noon486', 'bido', 'kamal24041996', 'eng.nohasaeed94', 'mohabahmedseif', 'mostafakhallaf100', 'kimo11mk', 'ahmadawad.fue66', 'mraba1111', 'muhammed_shaban99', 'mohamedrefaeiii', 'omardemos25', 'eldragon823', 'en.amr_mohamed', 'bbbty6064', 'noon48', 'parkchanwoo7', 'ahmedkhalilelsayed', 'doha_taher135', 'minafouad', 'miragee85', 'marwa96', 'mai.elmoslmany95', 'hendkholeif', 'mohamedsoliman', 'ahmedabdelsalam12', 'youstinafayezfouad', 'ahmedmaged2318', 'butaflekaahlan', 'ahmedelgeneral00', 'mahmoud_33744', 'ahmed_khaledammar', 'mistanbullu', 'farahbayomi103', 'keithlyu', 'nijamkureshi2894', 'suryatejachitturi', 'zakaria182', 'nadaamrarafa55', 'm2k2017', 'engineermskm', 'spooja.1430', 'theinstructive_man', 'tarek.almowafy', 'ahmed.hassanen', 'osaka', 'mariame', 'mahmoud123', 'ahmed0raafat', 'saeeed3', 'mykel', 'nancyammar', 'rawannshehab', 'yasmineelgogary', 'muhammed.shaban99.franky', 'eng.moaz.morsy', 'reem.hesham819', 'mero.ayman50', 'echoonge', 'krishnajha', '11parasarya', 'a.asmaasalem', 'shahir', 'mernamoneer_bombom', 'ahmed.allam86', 'omniya96', 'm7mdosama3000', 'rodyahmed1995', 'jangsungin', 'mohammedosama', 'engy95', 'asfora', 'nouranekhaled95', 'thasty', 'mohammedmahmoudmahgoub', 'ahmedelalfy', 'youstinanassiflatif95', 'abarge31', 'he18911', 'ahmedtarek5155', 'yahialdeeb', 'emadhamdy', 'ezzeddinabdullah', 'hossam.hassan2090', 'ahmedsamybeda', 'xuhan', 'maiuoymohamed.2011', 'maihossam', 'basaseko_208', 'ann_nona1995', 'mohamed_mandour212', 'amrghoniem94', 'saumopal1997', 'hgk', 'mh14039295', 'mohamedelbaga96', 'nadine.a.bahr95', 'mr_taha11', 'khalid_eissa', 'huda_96', 'momensaeed', 'radwahegazy95', 'mernamagdy118', 'louran_1995', 'yarahamdy', 'hatemmohammed', 'mohamedg327', 'mark.h.nabil', 'aparnaahari95', 'remonadly06', 'nourhantaha', 'dohaalqaisi1', 'hassan.ayman2006', 'amrelsobky20', 'mayar31995', 'habiba_ashraf_96', 'ahmed.saad9772', 'daycock', 'sharara123', 'minasamuel', 'veroniayaman96', 'abdelrahman.khelshamy', 'mohamedghamad', 'hossam_eldin_khaled_youssef', 'nerminemohamed15', 'ea', 'hoba201140', 'hedy_20072000', 'tadrous96', 'phantomx21', 'mennatallahwageehhassan', 'nadine.maghawry', 'engamr95', 'ozcomert.2', 'peternady', 'mehmettas', 'alizorg4', 'muhlasheen', None, 'niznkl', 'reham.a.mahmoud', 'maryam.nasser', 'mayar_ashraf', 'nana_girgis2009', 'mohamedali915', 'mirna31eldebeky', 'ahmadhany201696', 'esraaahmed95', 'rowaidaelawam', 'mmmahgoub', 'kyoussef', 'human101', 'mahmoud.salem432', 'ahmed755', 'abdelaziz', 'aisilfarnardo95']"
3,22,147,159,3,"['sal96', 'nourhan.ahmed', 'mona_gamal']",143,"['moatazmedhat', 'jyhuang09', 'shusky2010', 'kezi25', 'arraafizworld', 'abdo.m.sha', 'm2d1s', 'noureentarek96', 'araun521', 'taviawalsh', 'varunswadia', 'petercoan', 'selma_ashraf', 'aaron.congo', 'jackkelly18', 'medo', 'youbz', 'squidsareevil', 'mohamedfathyzaiton', 'calver', 'ahhamed93', 'kintango', 'mohamed.maher', 'fatmaayman', 'sandhyajois', 'isabel87', 'rlartigue', 'drift117', 'matthewwat', 'varellej', 'navelugassi', 'jhyunl', 'daannieuwenhuizen', 'rmiller1291', 'hajiesmaili', 'epatheria', 'jfherrm', 'omarkhaledsebak', 'chahalsunmeet', 'roodabeh', 'tianyuntony', 'tore.kanstad', 'mohamedabdelgwad14', 'shaizaib', 'abdulrahman.elmashed', 'dgalindonavarro18', 'jgschlichting', 'shrijitm10', 'madi95e', 'mahirt3', 'omar_ahmed_95', 'andrew.james.hollister', 'jysaa5', 'gemi.mansour1995', 'idkidkidk', 'dubose', 'parampreet123456', 'k3vinwu25', 'cherpeng.goh.canada', 'yuanv', 'sauravchoudhury007', 'sohum', 'lazar17', '3amona', 'nsreeram101', 'anushka', 'ziadelmehy', 'twong1985', 'gavinslim', 'pmuralid', 'galejandroca', 'sapergur', 'szehanwu', 'liangnie0127', 'reem15_5', 'colin.g.paterson', 'berg.lind.dk', 'omar44', 'deena.ahmed.omar', 'ignaciobayardo27', 'todd.darcie', 'ongangel', 'omnia96', 'sanketmittal21', 'student789', 'scarr', 'afellin', 'asdfth', 'smelectronics43', 'ashwin124', 'jg34', 'm.kamel.m.h', 'shaybob', 'jonking', 'manalighorpade07', 'levizak', 'aniruddha14797', 'jannickepearkes', 'luaan', 'nicolaschevalier', 'nitinaturdsk', 'ahmedredahassanahmed', 'pavkalyan100', 'ninadkny', 'buinm', 'hassan93', 'btaran', 'aidanh14', 'djs2240', 'gihoonyu', 't.lee.1', 'xwei1031', 'omerdnmz', 'mohamedelhewehy', 'krishanbhardwaj740', 'dharmeshchauhan9197', 'johncanfield', 'ngjosh', 'potlul', 'devices', 'sarah.dreischer', 'lishucong', 'lalaluye', 'pakshalshah123', 'ahmedyasser', 'mahmoudsherif2010', 'ldw', 'amir426', 'moh_badr', 'shvartsmanp', 'azzaismail1995', 'alinaacosta', 'danielruan', 'hesham97', 'gradenster', 'clrlun', 'wongsw93', 'joannachung1', 'sheehab.khaled', 'tsyskakis', 'nainishatanna', 'bhenderson25', 'vincentlin0131']",156,"['omaramer', 'joseph_hana94', 'bosbos_fafy22xx', 'hussammurad5', 'morsizodiac123', 'ashraf1', 'raghdaezzatnole', 'mostafaanas99', 'beko', 'peteremil', 'daniel.boshra', 'ahmadashiekh', 'muhadou95', 'binpda4', 'ahmedsaad96', 'baga96', 'hitman47222', 'tarik10kv', 'islam2141', 'basmaa.shawkyy203', 'hassanshehata', 'p9012', 'marwamostafa5050', 'alaahussein50', 'moonblack868', 'mariam95', 'omarn4sser', 'abdurhmanalaaaldaly', 'ali96saad', 'stressed_student', 'nourelrayes', 'shaggykemo', 'doniahassan999', 'bido', 'eng.nohasaeed94', 'mostafakhallaf100', 'mohabahmedseif', 'kimo11mk', 'mohamedrefaeiii', 'en.amr_mohamed', 'ahmedkhalilelsayed', 'doha_taher135', 'minafouad', 'miragee85', 'mai.elmoslmany95', 'marwa96', 'hendkholeif', 'mohamedsoliman', 'ahmedabdelsalam12', 'youstinafayezfouad', 'ahmedmaged2318', 'ahmedelgeneral00', 'butaflekaahlan', 'mahmoud_33744', 'ahmed_khaledammar', 'farahbayomi103', 'marmoramickey', 'zakaria182', 'nadaamrarafa55', 'm2k2017', 'engineermskm', 'theinstructive_man', 'tarek.almowafy', 'ahmed.hassanen', 'osaka', 'mahmoud123', 'ahmed0raafat', 'mykel', 'nancyammar', 'rawannshehab', 'yasmineelgogary', 'emadomda', 'eng.moaz.morsy', 'reem.hesham819', 'mero.ayman50', 'a.asmaasalem', 'kareem1994', 'shahir', 'mernamoneer_bombom', 'omniya96', 'm7mdosama3000', 'rodyahmed1995', 'mohammedosama', 'engy95', 'mohammedmahmoudmahgoub', 'asfora', 'youstinanassiflatif95', 'bishoobishbish', 'ahmedtarek5155', 'yahialdeeb', 'emadhamdy', 'ezzeddinabdullah', 'firesword_007', 'hossam.hassan2090', 'maiuoymohamed.2011', 'ahmedsamybeda', 'ann_nona1995', 'maihossam', 'mohamed_mandour212', 'amrghoniem94', 'hgk', 'nadine.a.bahr95', 'mohamedelbaga96', 'khalid_eissa', 'mr_taha11', 'huda_96', 'radwahegazy95', 'momensaeed', 'mernamagdy118', 'louran_1995', 'yarahamdy', 'hatemmohammed', 'mohamedg327', 'mark.h.nabil', 'remonadly06', 'nourhantaha', 'dohaalqaisi1', 'amrelsobky20', 'sondos', 'mayar31995', 'habiba_ashraf_96', 'ahmed.saad9772', 'minasamuel', 'veroniayaman96', 'mayarahmed', 'mohamedghamad', 'hossam_eldin_khaled_youssef', 'nerminemohamed15', 'ea', 'hoba201140', 'hedy_20072000', 'tadrous96', 'mennatallahwageehhassan', 'nadine.maghawry', 'engamr95', 'peternady', 'alizorg4', 'muhlasheen', 'hagerali139', None, 'reham.a.mahmoud', 'maryam.nasser', 'mayar_ashraf', 'nana_girgis2009', 'mohamedali915', 'mirna31eldebeky', 'amr_salah', 'ahmadhany201696', 'rowaidaelawam', 'mmmahgoub', 'human101', 'mahmoud.salem432', 'ahmed755', 'abdelaziz', 'aisilfarnardo95', 'yahiazakria']",302,"['jyhuang09', 'moatazmedhat', 'shusky2010', 'kezi25', 'omaramer', 'joseph_hana94', 'bosbos_fafy22xx', 'hussammurad5', 'arraafizworld', 'morsizodiac123', 'abdo.m.sha', 'm2d1s', 'noureentarek96', 'ashraf1', 'araun521', 'taviawalsh', 'raghdaezzatnole', 'varunswadia', 'mostafaanas99', 'beko', 'peteremil', 'daniel.boshra', 'ahmadashiekh', 'muhadou95', 'petercoan', 'selma_ashraf', 'aaron.congo', 'binpda4', 'jackkelly18', 'ahmedsaad96', 'medo', 'baga96', 'hitman47222', 'tarik10kv', 'youbz', 'islam2141', 'squidsareevil', 'basmaa.shawkyy203', 'hassanshehata', 'mohamedfathyzaiton', 'p9012', 'calver', 'ahhamed93', 'marwamostafa5050', 'alaahussein50', 'moonblack868', 'kintango', 'mariam95', 'omarn4sser', 'abdurhmanalaaaldaly', 'mohamed.maher', 'fatmaayman', 'sandhyajois', 'isabel87', 'rlartigue', 'ali96saad', 'drift117', 'matthewwat', 'stressed_student', 'nourelrayes', 'varellej', 'navelugassi', 'shaggykemo', 'jhyunl', 'daannieuwenhuizen', 'rmiller1291', 'doniahassan999', 'bido', 'hajiesmaili', 'epatheria', 'eng.nohasaeed94', 'mostafakhallaf100', 'mohabahmedseif', 'jfherrm', 'omarkhaledsebak', 'kimo11mk', 'chahalsunmeet', 'tianyuntony', 'roodabeh', 'mohamedrefaeiii', 'tore.kanstad', 'mohamedabdelgwad14', 'en.amr_mohamed', 'shaizaib', 'abdulrahman.elmashed', 'dgalindonavarro18', 'ahmedkhalilelsayed', 'doha_taher135', 'jgschlichting', 'shrijitm10', 'madi95e', 'minafouad', 'miragee85', 'mahirt3', 'mai.elmoslmany95', 'marwa96', 'omar_ahmed_95', 'hendkholeif', 'mohamedsoliman', 'ahmedabdelsalam12', 'youstinafayezfouad', 'ahmedmaged2318', 'ahmedelgeneral00', 'butaflekaahlan', 'andrew.james.hollister', 'jysaa5', 'mahmoud_33744', 'gemi.mansour1995', 'idkidkidk', 'ahmed_khaledammar', 'dubose', 'parampreet123456', 'farahbayomi103', 'ahmed755', 'k3vinwu25', 'marmoramickey', 'zakaria182', 'nadaamrarafa55', 'cherpeng.goh.canada', 'yuanv', 'm2k2017', 'sauravchoudhury007', 'engineermskm', 'theinstructive_man', 'tarek.almowafy', 'ahmed.hassanen', 'osaka', 'sohum', 'lazar17', 'mahmoud123', 'ahmed0raafat', 'mykel', 'nancyammar', 'rawannshehab', '3amona', 'nsreeram101', 'yasmineelgogary', 'anushka', 'emadomda', 'ziadelmehy', 'twong1985', 'eng.moaz.morsy', 'reem.hesham819', 'mero.ayman50', 'gavinslim', 'pmuralid', 'galejandroca', 'sapergur', 'szehanwu', 'a.asmaasalem', 'kareem1994', 'liangnie0127', 'shahir', 'reem15_5', 'colin.g.paterson', 'mernamoneer_bombom', 'omniya96', 'berg.lind.dk', 'm7mdosama3000', 'rodyahmed1995', 'omar44', 'deena.ahmed.omar', 'ignaciobayardo27', 'todd.darcie', 'ongangel', 'mohammedosama', 'engy95', 'mohammedmahmoudmahgoub', 'omnia96', 'sanketmittal21', 'asfora', 'youstinanassiflatif95', 'student789', 'bishoobishbish', 'scarr', 'ahmedtarek5155', 'yahialdeeb', 'emadhamdy', 'ezzeddinabdullah', 'afellin', 'asdfth', 'smelectronics43', 'firesword_007', 'ashwin124', 'bhenderson25', 'jg34', 'hossam.hassan2090', 'maiuoymohamed.2011', 'm.kamel.m.h', 'shaybob', 'jonking', 'manalighorpade07', 'ahmedsamybeda', 'ann_nona1995', 'maihossam', 'mohamed_mandour212', 'amrghoniem94', 'hgk', 'nadine.a.bahr95', 'mohamedelbaga96', 'levizak', 'khalid_eissa', 'mr_taha11', 'huda_96', 'radwahegazy95', 'aniruddha14797', 'jannickepearkes', 'momensaeed', 'mernamagdy118', 'louran_1995', 'yarahamdy', 'hatemmohammed', 'mohamedg327', 'mark.h.nabil', 'luaan', 'nicolaschevalier', 'nitinaturdsk', 'ahmedredahassanahmed', 'remonadly06', 'pavkalyan100', 'nourhantaha', 'ninadkny', 'buinm', 'hassan93', 'btaran', 'aidanh14', 'djs2240', 'gihoonyu', 't.lee.1', 'dohaalqaisi1', 'xwei1031', 'omerdnmz', 'amrelsobky20', 'sondos', 'mohamedelhewehy', 'krishanbhardwaj740', 'mayar31995', 'habiba_ashraf_96', 'ahmed.saad9772', 'dharmeshchauhan9197', 'johncanfield', 'potlul', 'sal96', 'minasamuel', 'veroniayaman96', 'devices', 'mayarahmed', 'sarah.dreischer', 'mohamedghamad', 'hossam_eldin_khaled_youssef', 'lishucong', 'nerminemohamed15', 'ea', 'hoba201140', 'lalaluye', 'nourhan.ahmed', 'hedy_20072000', 'tadrous96', 'mennatallahwageehhassan', 'pakshalshah123', 'nadine.maghawry', 'engamr95', 'ahmedyasser', 'mahmoudsherif2010', 'peternady', 'ldw', 'amir426', 'moh_badr', 'alizorg4', 'muhlasheen', 'shvartsmanp', 'mona_gamal', 'azzaismail1995', 'alinaacosta', 'hagerali139', None, 'reham.a.mahmoud', 'maryam.nasser', 'mayar_ashraf', 'danielruan', 'hesham97', 'nana_girgis2009', 'mohamedali915', 'gradenster', 'clrlun', 'wongsw93', 'mirna31eldebeky', 'amr_salah', 'ahmadhany201696', 'rowaidaelawam', 'mmmahgoub', 'human101', 'mahmoud.salem432', 'joannachung1', 'sheehab.khaled', 'tsyskakis', 'nainishatanna', 'abdelaziz', 'aisilfarnardo95', 'ngjosh', 'vincentlin0131', 'yahiazakria']"
3,273,147,54,53,"['buinm', 'aidanh14', 'btaran', 'tore.kanstad', 'twong1985', 'gihoonyu', 'shaizaib', 'gavinslim', 'arraafizworld', 'sapergur', 'm2d1s', 'szehanwu', 'krishanbhardwaj740', 'liangnie0127', 'taviawalsh', 'colin.g.paterson', 'madi95e', 'mahirt3', 'petercoan', 'berg.lind.dk', 'sarah.dreischer', 'aaron.congo', 'todd.darcie', 'andrew.james.hollister', 'lalaluye', 'ongangel', 'sanketmittal21', 'idkidkidk', 'parampreet123456', 'anushka', 'k3vinwu25', 'afellin', 'asdfth', 'cherpeng.goh.canada', 'yuanv', 'ldw', 'jg34', 'drift117', 'jonking', 'varellej', 'levizak', 'jhyunl', 'danielruan', 'hesham97', 'jannickepearkes', 'gradenster', 'lazar17', 'luaan', 'chahalsunmeet', 'tianyuntony', 'ngjosh', 'vincentlin0131', 't.lee.1']",93,"['moatazmedhat', 'jyhuang09', 'shusky2010', 'kezi25', 'abdo.m.sha', 'noureentarek96', 'araun521', 'varunswadia', 'selma_ashraf', 'jackkelly18', 'medo', 'youbz', 'squidsareevil', 'mohamedfathyzaiton', 'calver', 'ahhamed93', 'kintango', 'mohamed.maher', 'fatmaayman', 'sandhyajois', 'isabel87', 'rlartigue', 'matthewwat', 'navelugassi', 'daannieuwenhuizen', 'rmiller1291', 'hajiesmaili', 'epatheria', 'jfherrm', 'omarkhaledsebak', 'roodabeh', 'mohamedabdelgwad14', 'abdulrahman.elmashed', 'dgalindonavarro18', 'jgschlichting', 'shrijitm10', 'omar_ahmed_95', 'jysaa5', 'gemi.mansour1995', 'dubose', 'sauravchoudhury007', 'sohum', '3amona', 'nsreeram101', 'ziadelmehy', 'pmuralid', 'galejandroca', 'reem15_5', 'omar44', 'deena.ahmed.omar', 'ignaciobayardo27', 'omnia96', 'student789', 'scarr', 'smelectronics43', 'ashwin124', 'm.kamel.m.h', 'shaybob', 'manalighorpade07', 'aniruddha14797', 'nicolaschevalier', 'nitinaturdsk', 'ahmedredahassanahmed', 'pavkalyan100', 'djs2240', 'hassan93', 'ninadkny', 'xwei1031', 'omerdnmz', 'mohamedelhewehy', 'dharmeshchauhan9197', 'johncanfield', 'potlul', 'sal96', 'devices', 'lishucong', 'nourhan.ahmed', 'pakshalshah123', 'ahmedyasser', 'mahmoudsherif2010', 'amir426', 'moh_badr', 'shvartsmanp', 'mona_gamal', 'azzaismail1995', 'alinaacosta', 'wongsw93', 'clrlun', 'joannachung1', 'sheehab.khaled', 'tsyskakis', 'nainishatanna', 'bhenderson25']",1,[None],147,"['jyhuang09', 'moatazmedhat', 'shusky2010', 'kezi25', 'arraafizworld', 'abdo.m.sha', 'm2d1s', 'noureentarek96', 'araun521', 'taviawalsh', 'varunswadia', 'petercoan', 'selma_ashraf', 'aaron.congo', 'jackkelly18', 'medo', 'youbz', 'squidsareevil', 'mohamedfathyzaiton', 'calver', 'ahhamed93', 'kintango', 'mohamed.maher', 'fatmaayman', 'sandhyajois', 'isabel87', 'rlartigue', 'drift117', 'matthewwat', 'varellej', 'navelugassi', 'jhyunl', 'daannieuwenhuizen', 'rmiller1291', 'hajiesmaili', 'epatheria', 'jfherrm', 'omarkhaledsebak', 'chahalsunmeet', 'tianyuntony', 'roodabeh', 'tore.kanstad', 'mohamedabdelgwad14', 'shaizaib', 'abdulrahman.elmashed', 'dgalindonavarro18', 'jgschlichting', 'shrijitm10', 'madi95e', 'mahirt3', 'omar_ahmed_95', 'andrew.james.hollister', 'jysaa5', 'gemi.mansour1995', 'idkidkidk', 'dubose', 'parampreet123456', 'k3vinwu25', 'cherpeng.goh.canada', 'yuanv', 'sauravchoudhury007', 'sohum', 'lazar17', '3amona', 'nsreeram101', 'anushka', 'ziadelmehy', 'twong1985', 'gavinslim', 'pmuralid', 'galejandroca', 'sapergur', 'szehanwu', 'liangnie0127', 'reem15_5', 'colin.g.paterson', 'berg.lind.dk', 'omar44', 'deena.ahmed.omar', 'ignaciobayardo27', 'todd.darcie', 'ongangel', 'omnia96', 'sanketmittal21', 'student789', 'scarr', 'afellin', 'asdfth', 'smelectronics43', 'ashwin124', 'bhenderson25', 'jg34', 'm.kamel.m.h', 'shaybob', 'jonking', 'manalighorpade07', 'levizak', 'aniruddha14797', 'jannickepearkes', 'luaan', 'nicolaschevalier', 'nitinaturdsk', 'ahmedredahassanahmed', 'pavkalyan100', 'ninadkny', 'buinm', 'hassan93', 'btaran', 'aidanh14', 'djs2240', 'gihoonyu', 't.lee.1', 'xwei1031', 'omerdnmz', 'mohamedelhewehy', 'krishanbhardwaj740', 'dharmeshchauhan9197', 'johncanfield', 'potlul', 'sal96', 'devices', 'sarah.dreischer', 'lishucong', 'lalaluye', 'nourhan.ahmed', 'pakshalshah123', 'ahmedyasser', 'mahmoudsherif2010', 'ldw', 'amir426', 'moh_badr', 'shvartsmanp', 'mona_gamal', 'azzaismail1995', 'alinaacosta', None, 'danielruan', 'hesham97', 'gradenster', 'clrlun', 'wongsw93', 'joannachung1', 'sheehab.khaled', 'tsyskakis', 'nainishatanna', 'ngjosh', 'vincentlin0131']"
3,272,147,43,29,"['hassan93', 'ziadelmehy', 'abdulrahman.elmashed', 'noureentarek96', 'mohamedelhewehy', 'reem15_5', 'sal96', 'devices', 'omar_ahmed_95', 'medo', 'deena.ahmed.omar', 'omar44', 'nourhan.ahmed', 'omnia96', 'gemi.mansour1995', 'mohamedfathyzaiton', 'ahhamed93', 'mahmoudsherif2010', 'smelectronics43', 'mohamed.maher', 'fatmaayman', 'amir426', 'm.kamel.m.h', 'shaybob', 'mona_gamal', 'omarkhaledsebak', '3amona', 'sheehab.khaled', 'ahmedredahassanahmed']",117,"['moatazmedhat', 'jyhuang09', 'shusky2010', 'kezi25', 'arraafizworld', 'abdo.m.sha', 'm2d1s', 'araun521', 'taviawalsh', 'varunswadia', 'petercoan', 'selma_ashraf', 'aaron.congo', 'jackkelly18', 'youbz', 'squidsareevil', 'calver', 'kintango', 'sandhyajois', 'rlartigue', 'isabel87', 'drift117', 'matthewwat', 'varellej', 'navelugassi', 'jhyunl', 'daannieuwenhuizen', 'rmiller1291', 'hajiesmaili', 'epatheria', 'jfherrm', 'chahalsunmeet', 'roodabeh', 'tianyuntony', 'tore.kanstad', 'mohamedabdelgwad14', 'shaizaib', 'dgalindonavarro18', 'jgschlichting', 'shrijitm10', 'madi95e', 'mahirt3', 'andrew.james.hollister', 'jysaa5', 'idkidkidk', 'dubose', 'parampreet123456', 'k3vinwu25', 'cherpeng.goh.canada', 'yuanv', 'sauravchoudhury007', 'sohum', 'lazar17', 'nsreeram101', 'anushka', 'twong1985', 'gavinslim', 'pmuralid', 'galejandroca', 'sapergur', 'szehanwu', 'liangnie0127', 'colin.g.paterson', 'berg.lind.dk', 'ignaciobayardo27', 'todd.darcie', 'ongangel', 'sanketmittal21', 'student789', 'scarr', 'afellin', 'asdfth', 'ashwin124', 'jg34', 'jonking', 'manalighorpade07', 'levizak', 'aniruddha14797', 'jannickepearkes', 'luaan', 'nicolaschevalier', 'nitinaturdsk', 'pavkalyan100', 'ninadkny', 'buinm', 'aidanh14', 'btaran', 'djs2240', 't.lee.1', 'gihoonyu', 'xwei1031', 'omerdnmz', 'krishanbhardwaj740', 'dharmeshchauhan9197', 'johncanfield', 'ngjosh', 'potlul', 'sarah.dreischer', 'lishucong', 'lalaluye', 'pakshalshah123', 'ahmedyasser', 'ldw', 'moh_badr', 'shvartsmanp', 'azzaismail1995', 'alinaacosta', 'danielruan', 'hesham97', 'gradenster', 'clrlun', 'wongsw93', 'joannachung1', 'nainishatanna', 'tsyskakis', 'bhenderson25', 'vincentlin0131']",14,"['mai.elmoslmany95', 'khalid_eissa', 'ahmadhany201696', 'momohamada_2010', 'peternady', 'ahmedkhalilelsayed', 'ahmedelgeneral00', 'hebasamir', 'asfora', 'mayar31995', 'mhelsawaf', 'amrghoniem94', None, 'ahmed9891']",160,"['jyhuang09', 'moatazmedhat', 'shusky2010', 'kezi25', 'arraafizworld', 'abdo.m.sha', 'm2d1s', 'noureentarek96', 'araun521', 'taviawalsh', 'varunswadia', 'petercoan', 'selma_ashraf', 'aaron.congo', 'jackkelly18', 'medo', 'youbz', 'mhelsawaf', 'squidsareevil', 'mohamedfathyzaiton', 'calver', 'ahhamed93', 'kintango', 'mohamed.maher', 'fatmaayman', 'sandhyajois', 'isabel87', 'rlartigue', 'drift117', 'matthewwat', 'varellej', 'navelugassi', 'jhyunl', 'daannieuwenhuizen', 'rmiller1291', 'hajiesmaili', 'epatheria', 'jfherrm', 'omarkhaledsebak', 'chahalsunmeet', 'tianyuntony', 'roodabeh', 'tore.kanstad', 'mohamedabdelgwad14', 'shaizaib', 'abdulrahman.elmashed', 'dgalindonavarro18', 'ahmedkhalilelsayed', 'jgschlichting', 'shrijitm10', 'ahmed9891', 'madi95e', 'mahirt3', 'mai.elmoslmany95', 'omar_ahmed_95', 'momohamada_2010', 'ahmedelgeneral00', 'andrew.james.hollister', 'jysaa5', 'gemi.mansour1995', 'idkidkidk', 'dubose', 'parampreet123456', 'k3vinwu25', 'cherpeng.goh.canada', 'yuanv', 'sauravchoudhury007', 'sohum', 'lazar17', '3amona', 'nsreeram101', 'anushka', 'ziadelmehy', 'twong1985', 'gavinslim', 'pmuralid', 'galejandroca', 'sapergur', 'szehanwu', 'liangnie0127', 'reem15_5', 'colin.g.paterson', 'berg.lind.dk', 'omar44', 'deena.ahmed.omar', 'ignaciobayardo27', 'todd.darcie', 'ongangel', 'asfora', 'omnia96', 'sanketmittal21', 'student789', 'scarr', 'afellin', 'asdfth', 'smelectronics43', 'ashwin124', 'bhenderson25', 'jg34', 'm.kamel.m.h', 'shaybob', 'jonking', 'manalighorpade07', 'amrghoniem94', 'levizak', 'khalid_eissa', 'aniruddha14797', 'jannickepearkes', 'luaan', 'nicolaschevalier', 'nitinaturdsk', 'ahmedredahassanahmed', 'pavkalyan100', 'ninadkny', 'buinm', 'hassan93', 'btaran', 'aidanh14', 'djs2240', 'gihoonyu', 't.lee.1', 'xwei1031', 'omerdnmz', 'mohamedelhewehy', 'krishanbhardwaj740', 'mayar31995', 'dharmeshchauhan9197', 'johncanfield', 'potlul', 'sal96', 'devices', 'sarah.dreischer', 'lishucong', 'lalaluye', 'nourhan.ahmed', 'pakshalshah123', 'ahmedyasser', 'mahmoudsherif2010', 'peternady', 'ldw', 'amir426', 'moh_badr', 'shvartsmanp', 'mona_gamal', 'azzaismail1995', 'alinaacosta', None, 'danielruan', 'hesham97', 'ahmadhany201696', 'gradenster', 'clrlun', 'wongsw93', 'hebasamir', 'joannachung1', 'sheehab.khaled', 'tsyskakis', 'nainishatanna', 'ngjosh', 'vincentlin0131']"
3,23,147,27,1,['selma_ashraf'],145,"['jyhuang09', 'moatazmedhat', 'shusky2010', 'kezi25', 'arraafizworld', 'abdo.m.sha', 'm2d1s', 'noureentarek96', 'araun521', 'taviawalsh', 'varunswadia', 'petercoan', 'aaron.congo', 'jackkelly18', 'medo', 'youbz', 'squidsareevil', 'mohamedfathyzaiton', 'calver', 'ahhamed93', 'kintango', 'mohamed.maher', 'fatmaayman', 'sandhyajois', 'isabel87', 'rlartigue', 'drift117', 'matthewwat', 'varellej', 'navelugassi', 'jhyunl', 'daannieuwenhuizen', 'rmiller1291', 'hajiesmaili', 'epatheria', 'jfherrm', 'omarkhaledsebak', 'chahalsunmeet', 'tianyuntony', 'roodabeh', 'tore.kanstad', 'mohamedabdelgwad14', 'shaizaib', 'abdulrahman.elmashed', 'dgalindonavarro18', 'jgschlichting', 'shrijitm10', 'madi95e', 'mahirt3', 'omar_ahmed_95', 'andrew.james.hollister', 'jysaa5', 'gemi.mansour1995', 'idkidkidk', 'dubose', 'parampreet123456', 'k3vinwu25', 'cherpeng.goh.canada', 'yuanv', 'sauravchoudhury007', 'sohum', 'lazar17', '3amona', 'nsreeram101', 'anushka', 'ziadelmehy', 'twong1985', 'gavinslim', 'pmuralid', 'galejandroca', 'sapergur', 'szehanwu', 'liangnie0127', 'reem15_5', 'colin.g.paterson', 'berg.lind.dk', 'omar44', 'deena.ahmed.omar', 'ignaciobayardo27', 'todd.darcie', 'ongangel', 'omnia96', 'sanketmittal21', 'student789', 'scarr', 'afellin', 'asdfth', 'smelectronics43', 'ashwin124', 'bhenderson25', 'jg34', 'm.kamel.m.h', 'shaybob', 'jonking', 'manalighorpade07', 'levizak', 'aniruddha14797', 'jannickepearkes', 'luaan', 'nicolaschevalier', 'nitinaturdsk', 'ahmedredahassanahmed', 'pavkalyan100', 'ninadkny', 'buinm', 'hassan93', 'btaran', 'aidanh14', 'djs2240', 'gihoonyu', 't.lee.1', 'xwei1031', 'omerdnmz', 'mohamedelhewehy', 'krishanbhardwaj740', 'dharmeshchauhan9197', 'johncanfield', 'potlul', 'sal96', 'devices', 'sarah.dreischer', 'lishucong', 'lalaluye', 'nourhan.ahmed', 'pakshalshah123', 'ahmedyasser', 'mahmoudsherif2010', 'ldw', 'amir426', 'moh_badr', 'shvartsmanp', 'mona_gamal', 'azzaismail1995', 'alinaacosta', 'danielruan', 'hesham97', 'gradenster', 'clrlun', 'wongsw93', 'joannachung1', 'sheehab.khaled', 'tsyskakis', 'nainishatanna', 'ngjosh', 'vincentlin0131']",26,"['muhammed.shaban99.franky', 'eldragon823', 'hassan.ayman2006', 'ashraf1', 'beko', 'sharara123', 'mernamoneer_bombom', 'minasamuel', 'abdelrahman.khelshamy', 'ahmedabdelsalam12', 'hossam_eldin_khaled_youssef', 'mohammedosama', 'ahmedelalfy', 'phantomx21', 'ezzeddinabdullah', 'basaseko_208', None, 'nadine.a.bahr95', 'maryam.nasser', 'mariame', 'esraaahmed95', 'mernamagdy118', 'human101', 'muhammed_shaban99', 'aisilfarnardo95', 'omardemos25']",172,"['jyhuang09', 'moatazmedhat', 'shusky2010', 'kezi25', 'arraafizworld', 'abdo.m.sha', 'm2d1s', 'noureentarek96', 'ashraf1', 'araun521', 'taviawalsh', 'beko', 'varunswadia', 'petercoan', 'selma_ashraf', 'aaron.congo', 'jackkelly18', 'medo', 'youbz', 'squidsareevil', 'mohamedfathyzaiton', 'calver', 'ahhamed93', 'kintango', 'mohamed.maher', 'fatmaayman', 'sandhyajois', 'isabel87', 'rlartigue', 'drift117', 'matthewwat', 'varellej', 'navelugassi', 'jhyunl', 'daannieuwenhuizen', 'rmiller1291', 'hajiesmaili', 'epatheria', 'jfherrm', 'omarkhaledsebak', 'chahalsunmeet', 'tianyuntony', 'roodabeh', 'muhammed_shaban99', 'omardemos25', 'tore.kanstad', 'eldragon823', 'mohamedabdelgwad14', 'shaizaib', 'abdulrahman.elmashed', 'dgalindonavarro18', 'jgschlichting', 'shrijitm10', 'madi95e', 'mahirt3', 'omar_ahmed_95', 'ahmedabdelsalam12', 'andrew.james.hollister', 'jysaa5', 'gemi.mansour1995', 'idkidkidk', 'dubose', 'parampreet123456', 'k3vinwu25', 'cherpeng.goh.canada', 'yuanv', 'sauravchoudhury007', 'mariame', 'sohum', 'lazar17', '3amona', 'nsreeram101', 'anushka', 'muhammed.shaban99.franky', 'ziadelmehy', 'twong1985', 'gavinslim', 'pmuralid', 'galejandroca', 'sapergur', 'szehanwu', 'liangnie0127', 'reem15_5', 'colin.g.paterson', 'mernamoneer_bombom', 'berg.lind.dk', 'omar44', 'deena.ahmed.omar', 'ignaciobayardo27', 'todd.darcie', 'ongangel', 'mohammedosama', 'ahmedelalfy', 'omnia96', 'sanketmittal21', 'student789', 'scarr', 'ezzeddinabdullah', 'afellin', 'asdfth', 'smelectronics43', 'ashwin124', 'bhenderson25', 'jg34', 'm.kamel.m.h', 'shaybob', 'jonking', 'manalighorpade07', 'basaseko_208', 'nadine.a.bahr95', 'levizak', 'aniruddha14797', 'jannickepearkes', 'mernamagdy118', 'luaan', 'nicolaschevalier', 'nitinaturdsk', 'ahmedredahassanahmed', 'pavkalyan100', 'ninadkny', 'buinm', 'hassan93', 'btaran', 'aidanh14', 'djs2240', 'gihoonyu', 't.lee.1', 'xwei1031', 'omerdnmz', 'hassan.ayman2006', 'mohamedelhewehy', 'krishanbhardwaj740', 'dharmeshchauhan9197', 'johncanfield', 'sharara123', 'potlul', 'sal96', 'minasamuel', 'abdelrahman.khelshamy', 'devices', 'sarah.dreischer', 'hossam_eldin_khaled_youssef', 'lishucong', 'lalaluye', 'nourhan.ahmed', 'phantomx21', 'pakshalshah123', 'ahmedyasser', 'mahmoudsherif2010', 'ldw', 'amir426', 'moh_badr', 'shvartsmanp', 'mona_gamal', 'azzaismail1995', 'alinaacosta', None, 'maryam.nasser', 'danielruan', 'hesham97', 'gradenster', 'clrlun', 'wongsw93', 'esraaahmed95', 'human101', 'joannachung1', 'sheehab.khaled', 'tsyskakis', 'nainishatanna', 'aisilfarnardo95', 'ngjosh', 'vincentlin0131']"
3,268,147,25,20,"['jyhuang09', 'kezi25', 'dgalindonavarro18', 'jgschlichting', 'araun521', 'jackkelly18', 'ignaciobayardo27', 'youbz', 'squidsareevil', 'scarr', 'calver', 'dubose', 'kintango', 'alinaacosta', 'sohum', 'hajiesmaili', 'epatheria', 'jfherrm', 'joannachung1', 'bhenderson25']",126,"['moatazmedhat', 'shusky2010', 'arraafizworld', 'abdo.m.sha', 'm2d1s', 'noureentarek96', 'taviawalsh', 'varunswadia', 'petercoan', 'selma_ashraf', 'aaron.congo', 'medo', 'mohamedfathyzaiton', 'ahhamed93', 'mohamed.maher', 'fatmaayman', 'sandhyajois', 'isabel87', 'rlartigue', 'drift117', 'matthewwat', 'varellej', 'navelugassi', 'jhyunl', 'daannieuwenhuizen', 'rmiller1291', 'omarkhaledsebak', 'chahalsunmeet', 'tianyuntony', 'roodabeh', 'tore.kanstad', 'mohamedabdelgwad14', 'shaizaib', 'abdulrahman.elmashed', 'shrijitm10', 'madi95e', 'mahirt3', 'omar_ahmed_95', 'andrew.james.hollister', 'jysaa5', 'gemi.mansour1995', 'idkidkidk', 'parampreet123456', 'k3vinwu25', 'cherpeng.goh.canada', 'yuanv', 'sauravchoudhury007', 'lazar17', '3amona', 'nsreeram101', 'anushka', 'ziadelmehy', 'twong1985', 'gavinslim', 'pmuralid', 'galejandroca', 'sapergur', 'szehanwu', 'liangnie0127', 'reem15_5', 'colin.g.paterson', 'berg.lind.dk', 'omar44', 'deena.ahmed.omar', 'todd.darcie', 'ongangel', 'omnia96', 'sanketmittal21', 'student789', 'afellin', 'asdfth', 'smelectronics43', 'ashwin124', 'jg34', 'm.kamel.m.h', 'shaybob', 'jonking', 'manalighorpade07', 'levizak', 'aniruddha14797', 'jannickepearkes', 'luaan', 'nicolaschevalier', 'nitinaturdsk', 'ahmedredahassanahmed', 'pavkalyan100', 'ninadkny', 'buinm', 'hassan93', 'btaran', 'aidanh14', 'djs2240', 'gihoonyu', 't.lee.1', 'xwei1031', 'omerdnmz', 'mohamedelhewehy', 'krishanbhardwaj740', 'dharmeshchauhan9197', 'johncanfield', 'potlul', 'sal96', 'devices', 'sarah.dreischer', 'lishucong', 'lalaluye', 'nourhan.ahmed', 'pakshalshah123', 'ahmedyasser', 'mahmoudsherif2010', 'ldw', 'amir426', 'moh_badr', 'shvartsmanp', 'mona_gamal', 'azzaismail1995', 'danielruan', 'hesham97', 'gradenster', 'clrlun', 'wongsw93', 'sheehab.khaled', 'tsyskakis', 'nainishatanna', 'ngjosh', 'vincentlin0131']",5,"['shaandesai', 'ryandavey', 'messiri', 'simingma', None]",151,"['jyhuang09', 'moatazmedhat', 'shusky2010', 'kezi25', 'arraafizworld', 'abdo.m.sha', 'm2d1s', 'noureentarek96', 'simingma', 'araun521', 'taviawalsh', 'varunswadia', 'petercoan', 'selma_ashraf', 'aaron.congo', 'jackkelly18', 'medo', 'youbz', 'squidsareevil', 'mohamedfathyzaiton', 'calver', 'ahhamed93', 'kintango', 'mohamed.maher', 'fatmaayman', 'sandhyajois', 'isabel87', 'rlartigue', 'drift117', 'matthewwat', 'varellej', 'navelugassi', 'jhyunl', 'daannieuwenhuizen', 'rmiller1291', 'hajiesmaili', 'epatheria', 'jfherrm', 'omarkhaledsebak', 'chahalsunmeet', 'tianyuntony', 'roodabeh', 'tore.kanstad', 'mohamedabdelgwad14', 'shaizaib', 'abdulrahman.elmashed', 'dgalindonavarro18', 'jgschlichting', 'shrijitm10', 'madi95e', 'mahirt3', 'omar_ahmed_95', 'andrew.james.hollister', 'jysaa5', 'gemi.mansour1995', 'idkidkidk', 'dubose', 'parampreet123456', 'k3vinwu25', 'cherpeng.goh.canada', 'yuanv', 'sauravchoudhury007', 'sohum', 'lazar17', '3amona', 'nsreeram101', 'anushka', 'ziadelmehy', 'twong1985', 'gavinslim', 'pmuralid', 'galejandroca', 'sapergur', 'szehanwu', 'liangnie0127', 'reem15_5', 'colin.g.paterson', 'berg.lind.dk', 'omar44', 'deena.ahmed.omar', 'ryandavey', 'ignaciobayardo27', 'todd.darcie', 'ongangel', 'omnia96', 'sanketmittal21', 'student789', 'scarr', 'afellin', 'asdfth', 'smelectronics43', 'ashwin124', 'bhenderson25', 'jg34', 'messiri', 'm.kamel.m.h', 'shaybob', 'jonking', 'manalighorpade07', 'levizak', 'aniruddha14797', 'jannickepearkes', 'luaan', 'nicolaschevalier', 'nitinaturdsk', 'ahmedredahassanahmed', 'pavkalyan100', 'ninadkny', 'buinm', 'hassan93', 'btaran', 'aidanh14', 'djs2240', 'gihoonyu', 't.lee.1', 'shaandesai', 'xwei1031', 'omerdnmz', 'mohamedelhewehy', 'krishanbhardwaj740', 'dharmeshchauhan9197', 'johncanfield', 'potlul', 'sal96', 'devices', 'sarah.dreischer', 'lishucong', 'lalaluye', 'nourhan.ahmed', 'pakshalshah123', 'ahmedyasser', 'mahmoudsherif2010', 'ldw', 'amir426', 'moh_badr', 'shvartsmanp', 'mona_gamal', 'azzaismail1995', 'alinaacosta', None, 'danielruan', 'hesham97', 'gradenster', 'clrlun', 'wongsw93', 'joannachung1', 'sheehab.khaled', 'tsyskakis', 'nainishatanna', 'ngjosh', 'vincentlin0131']"
3,267,147,23,17,"['calver', 'dubose', 'jyhuang09', 'kezi25', 'kintango', 'sohum', 'dgalindonavarro18', 'jackkelly18', 'hajiesmaili', 'epatheria', 'lishucong', 'youbz', 'araun521', 'jfherrm', 'joannachung1', 'bhenderson25', 'scarr']",129,"['moatazmedhat', 'shusky2010', 'arraafizworld', 'abdo.m.sha', 'm2d1s', 'noureentarek96', 'taviawalsh', 'varunswadia', 'petercoan', 'selma_ashraf', 'aaron.congo', 'medo', 'squidsareevil', 'mohamedfathyzaiton', 'ahhamed93', 'mohamed.maher', 'fatmaayman', 'sandhyajois', 'isabel87', 'rlartigue', 'drift117', 'matthewwat', 'varellej', 'navelugassi', 'jhyunl', 'daannieuwenhuizen', 'rmiller1291', 'omarkhaledsebak', 'chahalsunmeet', 'tianyuntony', 'roodabeh', 'tore.kanstad', 'mohamedabdelgwad14', 'shaizaib', 'abdulrahman.elmashed', 'jgschlichting', 'shrijitm10', 'madi95e', 'mahirt3', 'omar_ahmed_95', 'andrew.james.hollister', 'jysaa5', 'gemi.mansour1995', 'idkidkidk', 'parampreet123456', 'k3vinwu25', 'cherpeng.goh.canada', 'yuanv', 'sauravchoudhury007', 'lazar17', '3amona', 'nsreeram101', 'anushka', 'ziadelmehy', 'twong1985', 'gavinslim', 'pmuralid', 'galejandroca', 'sapergur', 'szehanwu', 'liangnie0127', 'reem15_5', 'colin.g.paterson', 'berg.lind.dk', 'omar44', 'deena.ahmed.omar', 'ignaciobayardo27', 'todd.darcie', 'ongangel', 'omnia96', 'sanketmittal21', 'student789', 'afellin', 'asdfth', 'smelectronics43', 'ashwin124', 'jg34', 'm.kamel.m.h', 'shaybob', 'jonking', 'manalighorpade07', 'levizak', 'aniruddha14797', 'jannickepearkes', 'luaan', 'nicolaschevalier', 'nitinaturdsk', 'ahmedredahassanahmed', 'pavkalyan100', 'ninadkny', 'buinm', 'hassan93', 'btaran', 'aidanh14', 'djs2240', 'gihoonyu', 't.lee.1', 'xwei1031', 'omerdnmz', 'mohamedelhewehy', 'krishanbhardwaj740', 'dharmeshchauhan9197', 'johncanfield', 'potlul', 'sal96', 'devices', 'sarah.dreischer', 'lalaluye', 'nourhan.ahmed', 'pakshalshah123', 'ahmedyasser', 'mahmoudsherif2010', 'ldw', 'amir426', 'moh_badr', 'shvartsmanp', 'mona_gamal', 'azzaismail1995', 'alinaacosta', 'danielruan', 'hesham97', 'gradenster', 'clrlun', 'wongsw93', 'sheehab.khaled', 'tsyskakis', 'nainishatanna', 'ngjosh', 'vincentlin0131']",6,"['shaandesai', 'ryandavey', 'messiri', 'simingma', 'xian20944358', None]",152,"['jyhuang09', 'moatazmedhat', 'shusky2010', 'kezi25', 'arraafizworld', 'abdo.m.sha', 'm2d1s', 'noureentarek96', 'simingma', 'araun521', 'taviawalsh', 'varunswadia', 'petercoan', 'selma_ashraf', 'aaron.congo', 'jackkelly18', 'medo', 'youbz', 'squidsareevil', 'mohamedfathyzaiton', 'calver', 'ahhamed93', 'kintango', 'mohamed.maher', 'fatmaayman', 'sandhyajois', 'isabel87', 'rlartigue', 'drift117', 'matthewwat', 'varellej', 'navelugassi', 'jhyunl', 'daannieuwenhuizen', 'rmiller1291', 'hajiesmaili', 'epatheria', 'jfherrm', 'omarkhaledsebak', 'chahalsunmeet', 'tianyuntony', 'roodabeh', 'tore.kanstad', 'mohamedabdelgwad14', 'shaizaib', 'abdulrahman.elmashed', 'dgalindonavarro18', 'jgschlichting', 'shrijitm10', 'madi95e', 'mahirt3', 'omar_ahmed_95', 'andrew.james.hollister', 'jysaa5', 'gemi.mansour1995', 'idkidkidk', 'dubose', 'parampreet123456', 'k3vinwu25', 'cherpeng.goh.canada', 'yuanv', 'sauravchoudhury007', 'sohum', 'lazar17', '3amona', 'nsreeram101', 'anushka', 'ziadelmehy', 'twong1985', 'gavinslim', 'pmuralid', 'galejandroca', 'sapergur', 'szehanwu', 'liangnie0127', 'reem15_5', 'colin.g.paterson', 'berg.lind.dk', 'omar44', 'deena.ahmed.omar', 'ryandavey', 'ignaciobayardo27', 'todd.darcie', 'ongangel', 'xian20944358', 'omnia96', 'sanketmittal21', 'student789', 'scarr', 'afellin', 'asdfth', 'smelectronics43', 'ashwin124', 'bhenderson25', 'jg34', 'messiri', 'm.kamel.m.h', 'shaybob', 'jonking', 'manalighorpade07', 'levizak', 'aniruddha14797', 'jannickepearkes', 'luaan', 'nicolaschevalier', 'nitinaturdsk', 'ahmedredahassanahmed', 'pavkalyan100', 'ninadkny', 'buinm', 'hassan93', 'btaran', 'aidanh14', 'djs2240', 'gihoonyu', 't.lee.1', 'shaandesai', 'xwei1031', 'omerdnmz', 'mohamedelhewehy', 'krishanbhardwaj740', 'dharmeshchauhan9197', 'johncanfield', 'potlul', 'sal96', 'devices', 'sarah.dreischer', 'lishucong', 'lalaluye', 'nourhan.ahmed', 'pakshalshah123', 'ahmedyasser', 'mahmoudsherif2010', 'ldw', 'amir426', 'moh_badr', 'shvartsmanp', 'mona_gamal', 'azzaismail1995', 'alinaacosta', None, 'danielruan', 'hesham97', 'gradenster', 'clrlun', 'wongsw93', 'joannachung1', 'sheehab.khaled', 'tsyskakis', 'nainishatanna', 'ngjosh', 'vincentlin0131']"
3,269,147,21,1,['djs2240'],145,"['jyhuang09', 'moatazmedhat', 'shusky2010', 'kezi25', 'arraafizworld', 'abdo.m.sha', 'm2d1s', 'noureentarek96', 'araun521', 'taviawalsh', 'varunswadia', 'petercoan', 'selma_ashraf', 'aaron.congo', 'jackkelly18', 'medo', 'youbz', 'squidsareevil', 'mohamedfathyzaiton', 'calver', 'ahhamed93', 'kintango', 'mohamed.maher', 'fatmaayman', 'sandhyajois', 'isabel87', 'rlartigue', 'drift117', 'matthewwat', 'varellej', 'navelugassi', 'jhyunl', 'daannieuwenhuizen', 'rmiller1291', 'hajiesmaili', 'epatheria', 'jfherrm', 'omarkhaledsebak', 'chahalsunmeet', 'tianyuntony', 'roodabeh', 'tore.kanstad', 'mohamedabdelgwad14', 'shaizaib', 'abdulrahman.elmashed', 'dgalindonavarro18', 'jgschlichting', 'shrijitm10', 'madi95e', 'mahirt3', 'omar_ahmed_95', 'andrew.james.hollister', 'jysaa5', 'gemi.mansour1995', 'idkidkidk', 'dubose', 'parampreet123456', 'k3vinwu25', 'cherpeng.goh.canada', 'yuanv', 'sauravchoudhury007', 'sohum', 'lazar17', '3amona', 'nsreeram101', 'anushka', 'ziadelmehy', 'twong1985', 'gavinslim', 'pmuralid', 'galejandroca', 'sapergur', 'szehanwu', 'liangnie0127', 'reem15_5', 'colin.g.paterson', 'berg.lind.dk', 'omar44', 'deena.ahmed.omar', 'ignaciobayardo27', 'todd.darcie', 'ongangel', 'omnia96', 'sanketmittal21', 'student789', 'scarr', 'afellin', 'asdfth', 'smelectronics43', 'ashwin124', 'bhenderson25', 'jg34', 'm.kamel.m.h', 'shaybob', 'jonking', 'manalighorpade07', 'levizak', 'aniruddha14797', 'jannickepearkes', 'luaan', 'nicolaschevalier', 'nitinaturdsk', 'ahmedredahassanahmed', 'pavkalyan100', 'ninadkny', 'buinm', 'hassan93', 'btaran', 'aidanh14', 'gihoonyu', 't.lee.1', 'xwei1031', 'omerdnmz', 'mohamedelhewehy', 'krishanbhardwaj740', 'dharmeshchauhan9197', 'johncanfield', 'potlul', 'sal96', 'devices', 'sarah.dreischer', 'lishucong', 'lalaluye', 'nourhan.ahmed', 'pakshalshah123', 'ahmedyasser', 'mahmoudsherif2010', 'ldw', 'amir426', 'moh_badr', 'shvartsmanp', 'mona_gamal', 'azzaismail1995', 'alinaacosta', 'danielruan', 'hesham97', 'gradenster', 'clrlun', 'wongsw93', 'joannachung1', 'sheehab.khaled', 'tsyskakis', 'nainishatanna', 'ngjosh', 'vincentlin0131']",20,"['in2198', 'dr2891', 'jhy2116', 'ss4754', 'jkk2128', 'jd3171', 'grk2114', 'jj2883', 'np2588', 'rmm2242', 'ls3221', 'akr2145', 'ldl2115', 'dra2127', 'jx2248', None, 'smt2175', 'tjh2152', 'teann.chen', 'gaojinao']",166,"['jyhuang09', 'moatazmedhat', 'shusky2010', 'kezi25', 'in2198', 'arraafizworld', 'dr2891', 'abdo.m.sha', 'm2d1s', 'noureentarek96', 'araun521', 'taviawalsh', 'varunswadia', 'petercoan', 'selma_ashraf', 'aaron.congo', 'jackkelly18', 'medo', 'ls3221', 'youbz', 'squidsareevil', 'mohamedfathyzaiton', 'calver', 'ahhamed93', 'kintango', 'mohamed.maher', 'fatmaayman', 'sandhyajois', 'isabel87', 'rlartigue', 'drift117', 'matthewwat', 'jx2248', 'varellej', 'navelugassi', 'jhyunl', 'daannieuwenhuizen', 'rmiller1291', 'hajiesmaili', 'epatheria', 'tjh2152', 'teann.chen', 'jfherrm', 'omarkhaledsebak', 'chahalsunmeet', 'tianyuntony', 'roodabeh', 'tore.kanstad', 'mohamedabdelgwad14', 'shaizaib', 'abdulrahman.elmashed', 'dgalindonavarro18', 'jgschlichting', 'shrijitm10', 'madi95e', 'mahirt3', 'omar_ahmed_95', 'andrew.james.hollister', 'jysaa5', 'gemi.mansour1995', 'idkidkidk', 'dubose', 'parampreet123456', 'ldl2115', 'k3vinwu25', 'cherpeng.goh.canada', 'dra2127', 'yuanv', 'sauravchoudhury007', 'sohum', 'lazar17', '3amona', 'nsreeram101', 'gaojinao', 'anushka', 'ziadelmehy', 'twong1985', 'gavinslim', 'pmuralid', 'galejandroca', 'sapergur', 'ss4754', 'jkk2128', 'szehanwu', 'jd3171', 'liangnie0127', 'reem15_5', 'colin.g.paterson', 'grk2114', 'jj2883', 'berg.lind.dk', 'np2588', 'rmm2242', 'omar44', 'deena.ahmed.omar', 'ignaciobayardo27', 'todd.darcie', 'ongangel', 'omnia96', 'sanketmittal21', 'student789', 'scarr', 'afellin', 'asdfth', 'smelectronics43', 'ashwin124', 'bhenderson25', 'jg34', 'm.kamel.m.h', 'shaybob', 'jonking', 'manalighorpade07', 'smt2175', 'levizak', 'aniruddha14797', 'jannickepearkes', 'luaan', 'nicolaschevalier', 'nitinaturdsk', 'ahmedredahassanahmed', 'pavkalyan100', 'ninadkny', 'buinm', 'hassan93', 'btaran', 'aidanh14', 'djs2240', 'gihoonyu', 't.lee.1', 'xwei1031', 'omerdnmz', 'jhy2116', 'mohamedelhewehy', 'krishanbhardwaj740', 'dharmeshchauhan9197', 'johncanfield', 'potlul', 'sal96', 'devices', 'sarah.dreischer', 'lishucong', 'lalaluye', 'nourhan.ahmed', 'pakshalshah123', 'akr2145', 'ahmedyasser', 'mahmoudsherif2010', 'ldw', 'amir426', 'moh_badr', 'shvartsmanp', 'mona_gamal', 'azzaismail1995', 'alinaacosta', None, 'danielruan', 'hesham97', 'gradenster', 'clrlun', 'wongsw93', 'joannachung1', 'sheehab.khaled', 'tsyskakis', 'nainishatanna', 'ngjosh', 'vincentlin0131']"
3,274,147,10,9,"['potlul', 'gihoonyu', 'ninadkny', 'xwei1031', 'sauravchoudhury007', 'matthewwat', 'tsyskakis', 'student789', 'madi95e']",137,"['jyhuang09', 'moatazmedhat', 'shusky2010', 'kezi25', 'arraafizworld', 'abdo.m.sha', 'm2d1s', 'noureentarek96', 'araun521', 'taviawalsh', 'varunswadia', 'petercoan', 'selma_ashraf', 'aaron.congo', 'jackkelly18', 'medo', 'youbz', 'squidsareevil', 'mohamedfathyzaiton', 'calver', 'ahhamed93', 'kintango', 'mohamed.maher', 'fatmaayman', 'sandhyajois', 'isabel87', 'rlartigue', 'drift117', 'varellej', 'navelugassi', 'jhyunl', 'daannieuwenhuizen', 'rmiller1291', 'hajiesmaili', 'epatheria', 'jfherrm', 'omarkhaledsebak', 'chahalsunmeet', 'tianyuntony', 'roodabeh', 'tore.kanstad', 'mohamedabdelgwad14', 'shaizaib', 'abdulrahman.elmashed', 'dgalindonavarro18', 'jgschlichting', 'shrijitm10', 'mahirt3', 'omar_ahmed_95', 'andrew.james.hollister', 'jysaa5', 'gemi.mansour1995', 'idkidkidk', 'dubose', 'parampreet123456', 'k3vinwu25', 'cherpeng.goh.canada', 'yuanv', 'sohum', 'lazar17', '3amona', 'nsreeram101', 'anushka', 'ziadelmehy', 'twong1985', 'gavinslim', 'pmuralid', 'galejandroca', 'sapergur', 'szehanwu', 'liangnie0127', 'reem15_5', 'colin.g.paterson', 'berg.lind.dk', 'omar44', 'deena.ahmed.omar', 'ignaciobayardo27', 'todd.darcie', 'ongangel', 'omnia96', 'sanketmittal21', 'scarr', 'afellin', 'asdfth', 'smelectronics43', 'ashwin124', 'bhenderson25', 'jg34', 'm.kamel.m.h', 'shaybob', 'jonking', 'manalighorpade07', 'levizak', 'aniruddha14797', 'jannickepearkes', 'luaan', 'nicolaschevalier', 'nitinaturdsk', 'ahmedredahassanahmed', 'pavkalyan100', 'buinm', 'hassan93', 'btaran', 'aidanh14', 'djs2240', 't.lee.1', 'omerdnmz', 'mohamedelhewehy', 'krishanbhardwaj740', 'dharmeshchauhan9197', 'johncanfield', 'sal96', 'devices', 'sarah.dreischer', 'lishucong', 'lalaluye', 'nourhan.ahmed', 'pakshalshah123', 'ahmedyasser', 'mahmoudsherif2010', 'ldw', 'amir426', 'moh_badr', 'shvartsmanp', 'mona_gamal', 'azzaismail1995', 'alinaacosta', 'danielruan', 'hesham97', 'gradenster', 'clrlun', 'wongsw93', 'joannachung1', 'sheehab.khaled', 'nainishatanna', 'ngjosh', 'vincentlin0131']",1,[None],147,"['jyhuang09', 'moatazmedhat', 'shusky2010', 'kezi25', 'arraafizworld', 'abdo.m.sha', 'm2d1s', 'noureentarek96', 'araun521', 'taviawalsh', 'varunswadia', 'petercoan', 'selma_ashraf', 'aaron.congo', 'jackkelly18', 'medo', 'youbz', 'squidsareevil', 'mohamedfathyzaiton', 'calver', 'ahhamed93', 'kintango', 'mohamed.maher', 'fatmaayman', 'sandhyajois', 'isabel87', 'rlartigue', 'drift117', 'matthewwat', 'varellej', 'navelugassi', 'jhyunl', 'daannieuwenhuizen', 'rmiller1291', 'hajiesmaili', 'epatheria', 'jfherrm', 'omarkhaledsebak', 'chahalsunmeet', 'tianyuntony', 'roodabeh', 'tore.kanstad', 'mohamedabdelgwad14', 'shaizaib', 'abdulrahman.elmashed', 'dgalindonavarro18', 'jgschlichting', 'shrijitm10', 'madi95e', 'mahirt3', 'omar_ahmed_95', 'andrew.james.hollister', 'jysaa5', 'gemi.mansour1995', 'idkidkidk', 'dubose', 'parampreet123456', 'k3vinwu25', 'cherpeng.goh.canada', 'yuanv', 'sauravchoudhury007', 'sohum', 'lazar17', '3amona', 'nsreeram101', 'anushka', 'ziadelmehy', 'twong1985', 'gavinslim', 'pmuralid', 'galejandroca', 'sapergur', 'szehanwu', 'liangnie0127', 'reem15_5', 'colin.g.paterson', 'berg.lind.dk', 'omar44', 'deena.ahmed.omar', 'ignaciobayardo27', 'todd.darcie', 'ongangel', 'omnia96', 'sanketmittal21', 'student789', 'scarr', 'afellin', 'asdfth', 'smelectronics43', 'ashwin124', 'bhenderson25', 'jg34', 'm.kamel.m.h', 'shaybob', 'jonking', 'manalighorpade07', 'levizak', 'aniruddha14797', 'jannickepearkes', 'luaan', 'nicolaschevalier', 'nitinaturdsk', 'ahmedredahassanahmed', 'pavkalyan100', 'ninadkny', 'buinm', 'hassan93', 'btaran', 'aidanh14', 'djs2240', 'gihoonyu', 't.lee.1', 'xwei1031', 'omerdnmz', 'mohamedelhewehy', 'krishanbhardwaj740', 'dharmeshchauhan9197', 'johncanfield', 'potlul', 'sal96', 'devices', 'sarah.dreischer', 'lishucong', 'lalaluye', 'nourhan.ahmed', 'pakshalshah123', 'ahmedyasser', 'mahmoudsherif2010', 'ldw', 'amir426', 'moh_badr', 'shvartsmanp', 'mona_gamal', 'azzaismail1995', 'alinaacosta', None, 'danielruan', 'hesham97', 'gradenster', 'clrlun', 'wongsw93', 'joannachung1', 'sheehab.khaled', 'tsyskakis', 'nainishatanna', 'ngjosh', 'vincentlin0131']"
3,57,147,9,1,['varunswadia'],145,"['jyhuang09', 'moatazmedhat', 'shusky2010', 'kezi25', 'arraafizworld', 'abdo.m.sha', 'm2d1s', 'noureentarek96', 'araun521', 'taviawalsh', 'petercoan', 'selma_ashraf', 'aaron.congo', 'jackkelly18', 'medo', 'youbz', 'squidsareevil', 'mohamedfathyzaiton', 'calver', 'ahhamed93', 'kintango', 'mohamed.maher', 'fatmaayman', 'sandhyajois', 'isabel87', 'rlartigue', 'drift117', 'matthewwat', 'varellej', 'navelugassi', 'jhyunl', 'daannieuwenhuizen', 'rmiller1291', 'hajiesmaili', 'epatheria', 'jfherrm', 'omarkhaledsebak', 'chahalsunmeet', 'tianyuntony', 'roodabeh', 'tore.kanstad', 'mohamedabdelgwad14', 'shaizaib', 'abdulrahman.elmashed', 'dgalindonavarro18', 'jgschlichting', 'shrijitm10', 'madi95e', 'mahirt3', 'omar_ahmed_95', 'andrew.james.hollister', 'jysaa5', 'gemi.mansour1995', 'idkidkidk', 'dubose', 'parampreet123456', 'k3vinwu25', 'cherpeng.goh.canada', 'yuanv', 'sauravchoudhury007', 'sohum', 'lazar17', '3amona', 'nsreeram101', 'anushka', 'ziadelmehy', 'twong1985', 'gavinslim', 'pmuralid', 'galejandroca', 'sapergur', 'szehanwu', 'liangnie0127', 'reem15_5', 'colin.g.paterson', 'berg.lind.dk', 'omar44', 'deena.ahmed.omar', 'ignaciobayardo27', 'todd.darcie', 'ongangel', 'omnia96', 'sanketmittal21', 'student789', 'scarr', 'afellin', 'asdfth', 'smelectronics43', 'ashwin124', 'bhenderson25', 'jg34', 'm.kamel.m.h', 'shaybob', 'jonking', 'manalighorpade07', 'levizak', 'aniruddha14797', 'jannickepearkes', 'luaan', 'nicolaschevalier', 'nitinaturdsk', 'ahmedredahassanahmed', 'pavkalyan100', 'ninadkny', 'buinm', 'hassan93', 'btaran', 'aidanh14', 'djs2240', 'gihoonyu', 't.lee.1', 'xwei1031', 'omerdnmz', 'mohamedelhewehy', 'krishanbhardwaj740', 'dharmeshchauhan9197', 'johncanfield', 'potlul', 'sal96', 'devices', 'sarah.dreischer', 'lishucong', 'lalaluye', 'nourhan.ahmed', 'pakshalshah123', 'ahmedyasser', 'mahmoudsherif2010', 'ldw', 'amir426', 'moh_badr', 'shvartsmanp', 'mona_gamal', 'azzaismail1995', 'alinaacosta', 'danielruan', 'hesham97', 'gradenster', 'clrlun', 'wongsw93', 'joannachung1', 'sheehab.khaled', 'tsyskakis', 'nainishatanna', 'ngjosh', 'vincentlin0131']",8,"['mananshah30137', 'riddhis2411', 'roycefernandes80', 'jaysawant2', 'yashdani90', None, 'auraproductions786', '1jyotsna1']",154,"['jyhuang09', 'moatazmedhat', 'shusky2010', 'kezi25', 'arraafizworld', 'abdo.m.sha', 'm2d1s', 'noureentarek96', 'araun521', 'taviawalsh', 'varunswadia', 'petercoan', 'selma_ashraf', 'aaron.congo', 'jackkelly18', 'medo', 'youbz', 'squidsareevil', 'mohamedfathyzaiton', 'calver', 'ahhamed93', 'kintango', 'mohamed.maher', 'fatmaayman', 'sandhyajois', 'isabel87', 'rlartigue', 'drift117', 'matthewwat', 'varellej', 'navelugassi', 'jhyunl', 'daannieuwenhuizen', 'rmiller1291', 'jaysawant2', 'hajiesmaili', 'epatheria', 'jfherrm', 'omarkhaledsebak', 'chahalsunmeet', 'tianyuntony', 'roodabeh', 'tore.kanstad', 'mohamedabdelgwad14', 'riddhis2411', 'shaizaib', 'abdulrahman.elmashed', 'dgalindonavarro18', 'jgschlichting', 'shrijitm10', 'madi95e', 'mahirt3', 'omar_ahmed_95', 'andrew.james.hollister', 'jysaa5', 'yashdani90', 'gemi.mansour1995', 'idkidkidk', 'auraproductions786', '1jyotsna1', 'dubose', 'parampreet123456', 'k3vinwu25', 'cherpeng.goh.canada', 'yuanv', 'sauravchoudhury007', 'sohum', 'lazar17', '3amona', 'nsreeram101', 'anushka', 'ziadelmehy', 'twong1985', 'gavinslim', 'pmuralid', 'galejandroca', 'sapergur', 'szehanwu', 'liangnie0127', 'mananshah30137', 'reem15_5', 'colin.g.paterson', 'berg.lind.dk', 'omar44', 'deena.ahmed.omar', 'ignaciobayardo27', 'todd.darcie', 'ongangel', 'omnia96', 'sanketmittal21', 'student789', 'scarr', 'afellin', 'asdfth', 'smelectronics43', 'ashwin124', 'bhenderson25', 'jg34', 'm.kamel.m.h', 'shaybob', 'jonking', 'manalighorpade07', 'levizak', 'aniruddha14797', 'jannickepearkes', 'luaan', 'nicolaschevalier', 'nitinaturdsk', 'ahmedredahassanahmed', 'pavkalyan100', 'ninadkny', 'buinm', 'hassan93', 'btaran', 'aidanh14', 'djs2240', 'gihoonyu', 't.lee.1', 'xwei1031', 'omerdnmz', 'mohamedelhewehy', 'krishanbhardwaj740', 'dharmeshchauhan9197', 'johncanfield', 'potlul', 'sal96', 'devices', 'sarah.dreischer', 'lishucong', 'lalaluye', 'nourhan.ahmed', 'pakshalshah123', 'ahmedyasser', 'mahmoudsherif2010', 'ldw', 'amir426', 'moh_badr', 'shvartsmanp', 'mona_gamal', 'azzaismail1995', 'alinaacosta', None, 'danielruan', 'hesham97', 'gradenster', 'clrlun', 'wongsw93', 'joannachung1', 'sheehab.khaled', 'tsyskakis', 'nainishatanna', 'roycefernandes80', 'ngjosh', 'vincentlin0131']"
4,47,124,207,63,"['rsawant2895', 'vivek12195', 'msumit95', 'manavtrivedi03', 'stanabk', 'patil.rushal825', 'dipmads', 'jainamshah202', 'rajatkedia95', 'mukul.kulkarni', 'nrkhara', 'ajay.raghuwanshi', 'priyuk', 'shubham.gaikwad', 'ambani', 'mehtajinal3101', 'umeshdarade77', 'tanvi.rane1995', 'siddhesh401', 'sanika.dongre', 'karan.dadlani', 'amrsha.srivastava', 'apurva.patil', 'doshishrut1995', 'minalsawant1108', 'shriya.sharma', 'email.harsh0811', 'dhruv.gajaria95', 'poojamenon16.pm', 'rahul4peace', 'bhoomee.sheth', 'parthiv.parikh', 'apoorvasundaresan', 'avinashninawe', 'aditya.apte3', 'rashuidiot', 'obalgi3095', 'khannamansi312', 'shivanisharaf15', 'akanksha0196', 'monish.nene', 'nileshkartik95', 'jainam49', 'purva.satpute', 'spooja.1430', 'shreya.mahajan', 'jakhererahul42', 'tanvikalan', 'jayjadav08', 'neelam.chaudhari27', 'mshirali23', 'harshilmehta1995', 'komal31p', 'shwecchajain', 'ankita.rahate', 'poojashetty', 'darshanadaund27', 'sam234bryant', 'bhumivora1995', 'jaidevdalvi', 'rohankhollamkar', 'monish.kapadia', 'juhi.manglani']",60,"['ishita.choudhary', 'riddhis2411', 'raheela', 'danishdewani112795', 'nimisha.nimisha.agarwal', 'strikerfv68', 'arunnambiar66', 'evanmartin', 'maithili010', 'raku1109', 'jogichetan96', 'akshaybangera95', 'sjunghareakshay', 'suthar.kalpesh57', 'smithnano15', 'soorajdinesan27', 'harshit0610', 'smallik', 'beelex1617', 'ckargutkar96', 'pankajvyas967', 'trishapatkar19', 'alisha.alice.panicker', 'apoorvakraut', 'zeuswinchester456', 'luanco1', 'jonathantripi', 'priyankapandya19', 'nivipetkar', 'jcastrocalvo', 'walden95', 'jayeshkhandagle123', 'nickcrane6117', 'shukla.pawan249', 'sarveshgrao', 'kanchan.sawant17', 'praveen99', 'anuragshyam1026', 'akshay1995', 'ayyappakonar', 'kidongp', 'ttanmay.telang75', 'myuk83', 'shrinathnair', 'sahil8rai', 'amey.m.mangutkar', 'varadmeradost', 'mchakkalamuri', 'helmin50469', 'anand_5', 'srishti.shriyan96', 'mosfet7777', 'tejask2610', 'ee12d018', 'vivek.sakinala', 'jenna', 'joijodegauri7', 'roycefernandes80', 'dishakulkarni25', 'cnconnery']",144,"['nitingurme', 'kadamk008', 'bhavesh3422', 'aniket187', 'rehansonarkar784', 'aimomajy', 'krittikaranga', 'trija68', 'rajdeepd', 'brian200495', 'shraddhad', 'rananeetika3', 'vinit95vasudevan', 'gujarathikshitij', 'zkoyande', 'neha.utekar2608', 'himanshuphatak98', 'arpit32', 'nikitarane245', 'abhishek1996', 'kambe302', 'lakhanmodani1811', 'simran123', 'rajwaje44', '22diptinikalje', 'sebastian007', 'nagateja.vlsi', 'geeta.kavitake', 'mapethe', 'sid.rane95', 'suraj.taigade', 'ratsthegreat', 'ajinkyachadha', 'divya.upalekar', 'purva.desai', 'ninad41195', 'chinmayaniket4052', 'anujakhose94', 'rupali.patil', 'pathanabdulrazzak9524', 'viveky803', 'kpiyushbhirud', 'tejasshinde8055', 'manasi.shinde008', 'bhavikashenoy95', 'dhvanilmandalia29', 'anasnaik9987', 'mokshada', 'alohomora7', 'pranilraut17', 'suryatejachitturi', 'prachi.more', 'sonawane.akshayak', 'aeyjd', 'shubhamj95', 'luke676', 'adwait.sable10', 'pragatinarnaware', 'gsawant999', 'nehadingankar', 'deepikachaman3', 'patelu997', 'nikhildubey02051996', 'akshata.kulkarni', 'kadamrupesh1996', 'shweta1811', 'upadhyechinmay', 'cooldudeakshu', 'vaishnavi.sambrekar', 'komalbapna.kb', 'ritesh.shukla', 'mugdha.dalvi', 'amanpal56', 'gupta.ravi1996', 'ankurbhagwat8', 'harshal.dangat1', 'florence9344', 'sanjana.advani', 'priyeshd', 'tanayshinde21', 'cvvedesh', 'pravin45', 'tejaskanagal95', 'kondekar23', 'mihirsawant17', 'rahul1995', 'rhea.ann.95', 'rawletanmayee46', 'ajthamke40', 'minal.patil', 'chaitanyakhachane95', 'johebshaikh', 'harshada123', 'mahajanabhi2201', 'abhishekpatkar1796', 'abhihadshi', 'bharathi.pedapudi', 'lakshmi.nair', 'gauravrajeshmehta', 'mudbidrijay', 'rutvij.supekar', 'codekidx', 'pbrahmapurkar', 'pathakrohan18', 'shreyasvkul', 'mananmehta7', 'chirag184', 'prathameshptkr4', 'aparnaahari95', 'tarak.shah', 'mervyn.fernandes', 'ashishmohite1996', 'akshayshinde101095', 'nikhilgade', 'arvindlandge', 'anasnaik25', 'akshay21', 'sardesai.kirti18', 'shraddhag', 'vishaakn', 'bhavesh.singh', 'omkardalvi409', 'lakumveer', 'shreyamath95', 'mohak11jan', 'sandipani1995', 'akashspawar148', 'vishakha1805', 'yashgumaste', 'neilmundhe', 'dattaram.gawade781', 'tejaschaudhary1996', 'vaibhav.gangan7', 'shamikabachal', 'swapkaru123', 'saheli.konde', 'prashant.baperkar', 'suman28pandit', 'rakeshmaity', 'aakashgangolli3112', 'pavitra.iyer', 'rohanchavan', 'guptesoham95', 'ptrimukhe32']",267,"['kadamk008', 'raku1109', 'jogichetan96', 'rehansonarkar784', 'aimomajy', 'ajay.raghuwanshi', 'trija68', 'beelex1617', 'brian200495', 'rananeetika3', 'apoorvakraut', 'vinit95vasudevan', 'gujarathikshitij', 'jonathantripi', 'zkoyande', 'minalsawant1108', 'neha.utekar2608', 'email.harsh0811', 'bhoomee.sheth', 'abhishek1996', 'anuragshyam1026', 'akshay1995', 'obalgi3095', 'kidongp', 'rajwaje44', 'jayjadav08', '22diptinikalje', 'harshilmehta1995', 'varadmeradost', 'komal31p', 'darshanadaund27', 'bhumivora1995', 'mapethe', 'vivek.sakinala', 'jaidevdalvi', 'monish.kapadia', 'ratsthegreat', 'cnconnery', 'ajinkyachadha', 'riddhis2411', 'chinmayaniket4052', 'anujakhose94', 'rupali.patil', 'pathanabdulrazzak9524', 'viveky803', 'siddhesh401', 'sanika.dongre', 'manasi.shinde008', 'bhavikashenoy95', 'walden95', 'dhvanilmandalia29', 'anasnaik9987', 'mokshada', 'alohomora7', 'avinashninawe', 'shivanisharaf15', 'spooja.1430', 'pragatinarnaware', 'deepikachaman3', 'patelu997', 'mchakkalamuri', 'helmin50469', 'shwecchajain', 'kadamrupesh1996', 'shweta1811', 'rohankhollamkar', 'vaishnavi.sambrekar', 'komalbapna.kb', 'strikerfv68', 'mugdha.dalvi', 'sjunghareakshay', 'rajatkedia95', 'ankurbhagwat8', 'harshal.dangat1', 'shubham.gaikwad', 'sanjana.advani', 'priyeshd', 'ambani', 'tanvi.rane1995', 'cvvedesh', 'pravin45', 'jayeshkhandagle123', 'poojamenon16.pm', 'rahul4peace', 'praveen99', 'rawletanmayee46', 'ajthamke40', 'rashuidiot', 'minal.patil', 'chaitanyakhachane95', 'harshada123', 'abhihadshi', 'sahil8rai', 'bharathi.pedapudi', 'gauravrajeshmehta', 'pbrahmapurkar', 'pathakrohan18', 'mosfet7777', 'shreyasvkul', 'mananmehta7', 'chirag184', 'ishita.choudhary', 'ashishmohite1996', 'manavtrivedi03', 'nikhilgade', 'arunnambiar66', 'arvindlandge', 'anasnaik25', 'akshaybangera95', 'suthar.kalpesh57', 'mukul.kulkarni', 'smithnano15', 'sardesai.kirti18', 'soorajdinesan27', 'trishapatkar19', 'vishaakn', 'amrsha.srivastava', 'shriya.sharma', 'lakumveer', 'shukla.pawan249', 'mohak11jan', 'vishakha1805', 'yashgumaste', 'nileshkartik95', 'neilmundhe', 'ttanmay.telang75', 'jakhererahul42', 'dattaram.gawade781', 'amey.m.mangutkar', 'tejaschaudhary1996', 'vaibhav.gangan7', 'shamikabachal', 'srishti.shriyan96', 'saheli.konde', 'prashant.baperkar', 'aakashgangolli3112', 'prachi.more', 'rohanchavan', 'roycefernandes80', 'raheela', 'nitingurme', 'bhavesh3422', 'jainamshah202', 'aniket187', 'nrkhara', 'krittikaranga', 'smallik', 'rajdeepd', 'pankajvyas967', 'shraddhad', 'mehtajinal3101', 'luanco1', 'jcastrocalvo', 'nickcrane6117', 'himanshuphatak98', 'arpit32', 'nikitarane245', 'kambe302', 'lakhanmodani1811', 'simran123', 'tanvikalan', 'neelam.chaudhari27', 'sebastian007', 'anand_5', 'poojashetty', 'sam234bryant', 'nagateja.vlsi', 'ee12d018', 'geeta.kavitake', 'sid.rane95', 'suraj.taigade', 'divya.upalekar', 'rsawant2895', 'ninad41195', 'msumit95', 'purva.desai', 'evanmartin', 'patil.rushal825', 'maithili010', 'ckargutkar96', 'kpiyushbhirud', 'tejasshinde8055', 'priyankapandya19', 'nivipetkar', 'kanchan.sawant17', 'pranilraut17', 'suryatejachitturi', 'apoorvasundaresan', 'aditya.apte3', 'akanksha0196', 'ayyappakonar', 'monish.nene', 'sonawane.akshayak', 'shubhamj95', 'purva.satpute', 'aeyjd', 'luke676', 'adwait.sable10', 'nehadingankar', 'gsawant999', 'mshirali23', 'nikhildubey02051996', 'akshata.kulkarni', 'stanabk', 'upadhyechinmay', 'joijodegauri7', 'cooldudeakshu', 'juhi.manglani', 'ritesh.shukla', 'amanpal56', 'dipmads', 'gupta.ravi1996', 'florence9344', 'priyuk', 'umeshdarade77', 'tanayshinde21', 'karan.dadlani', 'doshishrut1995', 'tejaskanagal95', 'kondekar23', 'mihirsawant17', 'rahul1995', 'rhea.ann.95', 'johebshaikh', 'mahajanabhi2201', 'abhishekpatkar1796', 'myuk83', 'lakshmi.nair', 'rutvij.supekar', 'mudbidrijay', 'codekidx', 'prathameshptkr4', 'aparnaahari95', 'jenna', 'danishdewani112795', 'nimisha.nimisha.agarwal', 'tarak.shah', 'vivek12195', 'mervyn.fernandes', 'akshayshinde101095', 'akshay21', 'harshit0610', 'shraddhag', 'alisha.alice.panicker', 'zeuswinchester456', 'apurva.patil', 'bhavesh.singh', 'omkardalvi409', 'shreyamath95', 'dhruv.gajaria95', 'sarveshgrao', 'parthiv.parikh', 'sandipani1995', 'akashspawar148', 'khannamansi312', 'jainam49', 'shreya.mahajan', 'shrinathnair', 'ankita.rahate', 'swapkaru123', 'tejask2610', 'suman28pandit', 'rakeshmaity', 'pavitra.iyer', 'guptesoham95', 'dishakulkarni25', 'ptrimukhe32']"
4,207,124,132,1,['spooja.1430'],122,"['raheela', 'raku1109', 'jainamshah202', 'jogichetan96', 'nrkhara', 'ajay.raghuwanshi', 'smallik', 'beelex1617', 'pankajvyas967', 'mehtajinal3101', 'apoorvakraut', 'luanco1', 'jonathantripi', 'minalsawant1108', 'jcastrocalvo', 'nickcrane6117', 'email.harsh0811', 'bhoomee.sheth', 'anuragshyam1026', 'akshay1995', 'obalgi3095', 'kidongp', 'tanvikalan', 'jayjadav08', 'neelam.chaudhari27', 'harshilmehta1995', 'varadmeradost', 'komal31p', 'anand_5', 'poojashetty', 'darshanadaund27', 'sam234bryant', 'bhumivora1995', 'ee12d018', 'vivek.sakinala', 'jaidevdalvi', 'monish.kapadia', 'cnconnery', 'riddhis2411', 'rsawant2895', 'msumit95', 'evanmartin', 'patil.rushal825', 'maithili010', 'ckargutkar96', 'siddhesh401', 'sanika.dongre', 'priyankapandya19', 'nivipetkar', 'walden95', 'kanchan.sawant17', 'apoorvasundaresan', 'avinashninawe', 'aditya.apte3', 'shivanisharaf15', 'akanksha0196', 'ayyappakonar', 'monish.nene', 'purva.satpute', 'mshirali23', 'mchakkalamuri', 'helmin50469', 'shwecchajain', 'stanabk', 'rohankhollamkar', 'joijodegauri7', 'juhi.manglani', 'strikerfv68', 'dipmads', 'sjunghareakshay', 'rajatkedia95', 'priyuk', 'shubham.gaikwad', 'ambani', 'umeshdarade77', 'tanvi.rane1995', 'karan.dadlani', 'doshishrut1995', 'jayeshkhandagle123', 'poojamenon16.pm', 'rahul4peace', 'praveen99', 'rashuidiot', 'myuk83', 'sahil8rai', 'mosfet7777', 'jenna', 'ishita.choudhary', 'danishdewani112795', 'nimisha.nimisha.agarwal', 'vivek12195', 'manavtrivedi03', 'arunnambiar66', 'akshaybangera95', 'suthar.kalpesh57', 'mukul.kulkarni', 'smithnano15', 'soorajdinesan27', 'harshit0610', 'trishapatkar19', 'alisha.alice.panicker', 'zeuswinchester456', 'amrsha.srivastava', 'apurva.patil', 'shriya.sharma', 'shukla.pawan249', 'dhruv.gajaria95', 'sarveshgrao', 'parthiv.parikh', 'khannamansi312', 'nileshkartik95', 'jainam49', 'ttanmay.telang75', 'shreya.mahajan', 'jakhererahul42', 'shrinathnair', 'amey.m.mangutkar', 'ankita.rahate', 'srishti.shriyan96', 'tejask2610', 'roycefernandes80', 'dishakulkarni25']",131,"['dalvisayli', 'ektarathod786', 'niraj901', 'khadekunal1', 'dikshabafna1995', 'kadamk008', 'omkarn049', 'sagar.pawar35418', 'ahire.monali07', 'brian200495', 'infinite2205', 'vinit95vasudevan', 'dhartinano19', 'saurabh.gharat96', 'nehah95', 'suyogk.1995', 'sailee.mohite', 'chaudharipayal50', 'dandekarmd73', 'tanayshinde123', 'sangeetamjoshi', 'mudrasjuee', 'sebastian007', 'nikhildabholkar4', 'praju.avhad', 'rakshu.gade', 'snehawaghe21', 'sid.rane95', 'sonalipawar589', 'ratsthegreat', 'oma1811', 'rahulmhapsekar7', 'sumedh_patil', 'a.j.yadav2395', 'chiragc9494', 'hbg2112', 'bhakti961', 'kumarrahul050892', 'viveky803', 'yashapeejay', 'sandeeprock023', 'manasi.shinde008', 'chaudharisuyash7', 'ru1795', 'deven199570', 'priyagajakosh1', 'aashish.yadav94', 'ambeskaradvait', 'spranav3004', 'jatin.dhande1008', 'priyankakamble', 'manalihedaoo4', 'pranilraut17', 'shivamchaube', 'sonawane.akshayak', 'mongya00', 'dattaramkolekar', 'sagarpawar', 'nikitamalvade', 'nikhildubey02051996', 'mitesh.dangle', 'danish.dev.007', 'saylishirodkar58', 'sayalipatil4545', 'aishwaryamardhekar.24595', 'cooldudeakshu', 'snehakudtarkar315', 'komalbapna.kb', 'viprajapatil', 'aniketmane42', 'akshaybadhiye04', 'iabhishek555', 'susmitaahirrao', 'pravin45', 'tejaskanagal95', 'aniketkulaye618', 'bk357357', 'oindri.c', 'kondekar23', 'poojavagre12', 'mihirsawant17', 'adigame18', 'parmitbanga1995', 'shahyash027', 'ajthamke40', 'mishrahenry007', 'shreyashpawar96', 'abhihadshi', 'pratikkhanore95', 'srikalaprabhu', 'gidayegirish', 'gauravrajeshmehta', 'codekidx', 'pbrahmapurkar', 'vinodgadge95', 'shubhambeldar547', 'prathameshptkr4', 'saurabhmangeshkar', 'mukulsathe1995', 'priyankaingle18', 'palswati0309', 'bondreanup007', 'rohitbaliyan53', 'manishashetye1295', 'abhishek.thavare', 'sardesai.kirti18', 'amritamukeshb', 'shakyanandk', 'ramaprde2296', 'rushabh.fegade', 'ameypatil29', 'sahilshaikh827', 'vishakha1805', 'abhishekm2861996', 'dattaram.gawade781', None, 'salman23011996', 'ssy506804', 'vaibhav.gangan7', 'sawantgaurig25', 'rohinipatil404', 'siddhiambre111', 'sagarbhagat43', 'kaustubhgudekar9', 'namrata05', 'suman28pandit', 'chandraman.patil', 'rakeshmaity', 'pranay9.ithawar', 'rohanchavan', 'vaibhavgaikar62']",254,"['raheela', 'dalvisayli', 'niraj901', 'ektarathod786', 'khadekunal1', 'dikshabafna1995', 'kadamk008', 'omkarn049', 'sagar.pawar35418', 'raku1109', 'jainamshah202', 'jogichetan96', 'nrkhara', 'ajay.raghuwanshi', 'ahire.monali07', 'smallik', 'beelex1617', 'brian200495', 'pankajvyas967', 'mehtajinal3101', 'apoorvakraut', 'infinite2205', 'vinit95vasudevan', 'luanco1', 'jonathantripi', 'dhartinano19', 'saurabh.gharat96', 'minalsawant1108', 'jcastrocalvo', 'nickcrane6117', 'email.harsh0811', 'sailee.mohite', 'suyogk.1995', 'nehah95', 'bhoomee.sheth', 'anuragshyam1026', 'chaudharipayal50', 'akshay1995', 'dandekarmd73', 'obalgi3095', 'tanayshinde123', 'sangeetamjoshi', 'kidongp', 'mudrasjuee', 'tanvikalan', 'jayjadav08', 'neelam.chaudhari27', 'sebastian007', 'harshilmehta1995', 'varadmeradost', 'komal31p', 'nikhildabholkar4', 'praju.avhad', 'anand_5', 'poojashetty', 'darshanadaund27', 'rakshu.gade', 'sam234bryant', 'bhumivora1995', 'ee12d018', 'snehawaghe21', 'vivek.sakinala', 'sid.rane95', 'jaidevdalvi', 'sonalipawar589', 'monish.kapadia', 'ratsthegreat', 'cnconnery', 'oma1811', 'riddhis2411', 'rsawant2895', 'rahulmhapsekar7', 'msumit95', 'sumedh_patil', 'a.j.yadav2395', 'chiragc9494', 'evanmartin', 'patil.rushal825', 'maithili010', 'hbg2112', 'bhakti961', 'kumarrahul050892', 'ckargutkar96', 'viveky803', 'yashapeejay', 'siddhesh401', 'sanika.dongre', 'sandeeprock023', 'priyankapandya19', 'manasi.shinde008', 'nivipetkar', 'chaudharisuyash7', 'ru1795', 'deven199570', 'priyagajakosh1', 'aashish.yadav94', 'walden95', 'ambeskaradvait', 'spranav3004', 'jatin.dhande1008', 'priyankakamble', 'manalihedaoo4', 'kanchan.sawant17', 'pranilraut17', 'apoorvasundaresan', 'avinashninawe', 'aditya.apte3', 'shivamchaube', 'shivanisharaf15', 'akanksha0196', 'ayyappakonar', 'monish.nene', 'sonawane.akshayak', 'purva.satpute', 'spooja.1430', 'mongya00', 'dattaramkolekar', 'sagarpawar', 'nikitamalvade', 'mshirali23', 'mchakkalamuri', 'helmin50469', 'shwecchajain', 'nikhildubey02051996', 'mitesh.dangle', 'danish.dev.007', 'saylishirodkar58', 'stanabk', 'rohankhollamkar', 'joijodegauri7', 'sayalipatil4545', 'aishwaryamardhekar.24595', 'cooldudeakshu', 'juhi.manglani', 'snehakudtarkar315', 'komalbapna.kb', 'strikerfv68', 'dipmads', 'viprajapatil', 'sjunghareakshay', 'rajatkedia95', 'aniketmane42', 'priyuk', 'shubham.gaikwad', 'akshaybadhiye04', 'iabhishek555', 'ambani', 'umeshdarade77', 'tanvi.rane1995', 'susmitaahirrao', 'karan.dadlani', 'pravin45', 'doshishrut1995', 'tejaskanagal95', 'aniketkulaye618', 'bk357357', 'jayeshkhandagle123', 'oindri.c', 'kondekar23', 'poojavagre12', 'poojamenon16.pm', 'vaibhavgaikar62', 'mihirsawant17', 'rahul4peace', 'adigame18', 'praveen99', 'parmitbanga1995', 'shahyash027', 'ajthamke40', 'rashuidiot', 'mishrahenry007', 'shreyashpawar96', 'myuk83', 'abhihadshi', 'pratikkhanore95', 'sahil8rai', 'srikalaprabhu', 'gidayegirish', 'gauravrajeshmehta', 'codekidx', 'pbrahmapurkar', 'mosfet7777', 'vinodgadge95', 'shubhambeldar547', 'prathameshptkr4', 'jenna', 'saurabhmangeshkar', 'ishita.choudhary', 'danishdewani112795', 'nimisha.nimisha.agarwal', 'mukulsathe1995', 'vivek12195', 'priyankaingle18', 'manavtrivedi03', 'palswati0309', 'bondreanup007', 'rohitbaliyan53', 'arunnambiar66', 'akshaybangera95', 'manishashetye1295', 'suthar.kalpesh57', 'mukul.kulkarni', 'abhishek.thavare', 'smithnano15', 'sardesai.kirti18', 'soorajdinesan27', 'harshit0610', 'trishapatkar19', 'alisha.alice.panicker', 'zeuswinchester456', 'amrsha.srivastava', 'apurva.patil', 'amritamukeshb', 'shriya.sharma', 'shukla.pawan249', 'dhruv.gajaria95', 'sarveshgrao', 'shakyanandk', 'ramaprde2296', 'parthiv.parikh', 'rushabh.fegade', 'khannamansi312', 'ameypatil29', 'sahilshaikh827', 'vishakha1805', 'abhishekm2861996', 'nileshkartik95', 'jainam49', 'ttanmay.telang75', 'shreya.mahajan', 'jakhererahul42', 'dattaram.gawade781', None, 'shrinathnair', 'amey.m.mangutkar', 'salman23011996', 'ssy506804', 'vaibhav.gangan7', 'sawantgaurig25', 'ankita.rahate', 'rohinipatil404', 'siddhiambre111', 'sagarbhagat43', 'kaustubhgudekar9', 'srishti.shriyan96', 'namrata05', 'tejask2610', 'suman28pandit', 'chandraman.patil', 'rakeshmaity', 'pranay9.ithawar', 'rohanchavan', 'roycefernandes80', 'dishakulkarni25']"
4,42,124,114,3,"['sam234bryant', 'umeshdarade77', 'rsawant2895']",120,"['raheela', 'raku1109', 'jainamshah202', 'jogichetan96', 'nrkhara', 'ajay.raghuwanshi', 'smallik', 'beelex1617', 'pankajvyas967', 'mehtajinal3101', 'apoorvakraut', 'luanco1', 'jonathantripi', 'minalsawant1108', 'jcastrocalvo', 'nickcrane6117', 'email.harsh0811', 'bhoomee.sheth', 'anuragshyam1026', 'akshay1995', 'obalgi3095', 'kidongp', 'tanvikalan', 'jayjadav08', 'neelam.chaudhari27', 'harshilmehta1995', 'varadmeradost', 'komal31p', 'anand_5', 'poojashetty', 'darshanadaund27', 'bhumivora1995', 'ee12d018', 'vivek.sakinala', 'jaidevdalvi', 'monish.kapadia', 'cnconnery', 'riddhis2411', 'msumit95', 'evanmartin', 'patil.rushal825', 'maithili010', 'ckargutkar96', 'siddhesh401', 'sanika.dongre', 'priyankapandya19', 'nivipetkar', 'walden95', 'kanchan.sawant17', 'apoorvasundaresan', 'avinashninawe', 'aditya.apte3', 'shivanisharaf15', 'akanksha0196', 'ayyappakonar', 'monish.nene', 'purva.satpute', 'spooja.1430', 'mshirali23', 'mchakkalamuri', 'helmin50469', 'shwecchajain', 'stanabk', 'rohankhollamkar', 'joijodegauri7', 'juhi.manglani', 'strikerfv68', 'dipmads', 'sjunghareakshay', 'rajatkedia95', 'priyuk', 'shubham.gaikwad', 'ambani', 'tanvi.rane1995', 'karan.dadlani', 'doshishrut1995', 'jayeshkhandagle123', 'poojamenon16.pm', 'rahul4peace', 'praveen99', 'rashuidiot', 'myuk83', 'sahil8rai', 'mosfet7777', 'jenna', 'ishita.choudhary', 'danishdewani112795', 'nimisha.nimisha.agarwal', 'vivek12195', 'manavtrivedi03', 'arunnambiar66', 'akshaybangera95', 'suthar.kalpesh57', 'mukul.kulkarni', 'smithnano15', 'soorajdinesan27', 'harshit0610', 'trishapatkar19', 'alisha.alice.panicker', 'zeuswinchester456', 'amrsha.srivastava', 'apurva.patil', 'shriya.sharma', 'shukla.pawan249', 'dhruv.gajaria95', 'sarveshgrao', 'parthiv.parikh', 'khannamansi312', 'nileshkartik95', 'jainam49', 'ttanmay.telang75', 'shreya.mahajan', 'jakhererahul42', 'shrinathnair', 'amey.m.mangutkar', 'ankita.rahate', 'srishti.shriyan96', 'tejask2610', 'roycefernandes80', 'dishakulkarni25']",111,"['sankpalami', 'shrutikayadav2oct', 'dalvisayli', 'ektarathod786', 'niraj901', 'dikshabafna1995', 'adipatil37', 'niteshnarkar712', 'omkarn049', 'sahilsk7', 'ahire.monali07', 'vinit95vasudevan', 'minalsawant143', 'chaudharipayal50', 'shraddha0306', 'sangeetamjoshi', 'mudrasjuee', 'vijaybhargude2', 'sebastian007', 'ashwini12rajput', 'praju.avhad', 'rakshu.gade', 'sonalipawar589', 'ratsthegreat', 'oma1811', 'sumedh_patil', 'a.j.yadav2395', 'chiragc9494', 'hbg2112', 'varadrajnanaware7', 'viveky803', 'tejasshinde8055', 'chaudharisuyash7', 'ru1795', 'deven199570', 'priyagajakosh1', 'aashish.yadav94', 'pratikthorat10', 'jatin.dhande1008', 'aniket2602', 'aditya1818', 'sonawane.akshayak', 'sagarpawar', 'gsawant999', 'prajaktachapte2', 'nikhildubey02051996', 'danish.dev.007', 'saylishirodkar58', 'sayalipatil4545', 'aishwaryamardhekar.24595', 'cooldudeakshu', 'komalbapna.kb', 'akshaybadhiye04', 'iabhishek555', 'pankajpawar1515', 'susmitaahirrao', 'tanayshinde21', 'infinite1309', 'pravin45', 'tejaskanagal95', 'oindri.c', 'abarge31', 'shahyash027', 'rawletanmayee46', 'mahajanabhi2201', 'advenraju', 'abhihadshi', 'supu1796', 'pratikkhanore95', 'preetywagh95', 'gidayegirish', 'shrikantnimse14', 'gauravrajeshmehta', 'pbrahmapurkar', 'swati123', 'saurabhmangeshkar', 'shrutisundar019', 'ravina.chavan42', 'mukulsathe1995', 'tarak.shah', 'priyankaingle18', 'bondreanup007', 'rohitbaliyan53', 'tanyabaptist05', 'bkadam357', 'manishashetye1295', 'abhishek.thavare', 'sardesai.kirti18', 'sammit1844', 'sanketsalvi03', 'sandesh29', 'amritamukeshb', 'lakumveer', 'shakyanandk', 'ramaprde2296', 'rushabh.fegade', 'akashspawar148', 'cpatil152', 'abhishekm2861996', 'ritesh.parulekar231194', 'vishakha1805', 'dattaram.gawade781', None, 'sagarbhagat43', 'kaustubhgudekar9', 'prashant.baperkar', 'suman28pandit', 'rakeshmaity', 'rohanchavan', 'bimal.biswas8', 'ptrimukhe32']",234,"['sankpalami', 'shrutikayadav2oct', 'raheela', 'dalvisayli', 'niraj901', 'ektarathod786', 'dikshabafna1995', 'adipatil37', 'niteshnarkar712', 'omkarn049', 'raku1109', 'jainamshah202', 'jogichetan96', 'sahilsk7', 'nrkhara', 'ajay.raghuwanshi', 'ahire.monali07', 'smallik', 'beelex1617', 'pankajvyas967', 'mehtajinal3101', 'apoorvakraut', 'vinit95vasudevan', 'luanco1', 'jonathantripi', 'minalsawant1108', 'minalsawant143', 'jcastrocalvo', 'nickcrane6117', 'email.harsh0811', 'bhoomee.sheth', 'anuragshyam1026', 'chaudharipayal50', 'akshay1995', 'shraddha0306', 'obalgi3095', 'sangeetamjoshi', 'kidongp', 'mudrasjuee', 'vijaybhargude2', 'tanvikalan', 'jayjadav08', 'neelam.chaudhari27', 'sebastian007', 'harshilmehta1995', 'varadmeradost', 'komal31p', 'ashwini12rajput', 'praju.avhad', 'anand_5', 'poojashetty', 'darshanadaund27', 'rakshu.gade', 'sam234bryant', 'bhumivora1995', 'ee12d018', 'vivek.sakinala', 'jaidevdalvi', 'sonalipawar589', 'monish.kapadia', 'ratsthegreat', 'cnconnery', 'oma1811', 'riddhis2411', 'rsawant2895', 'msumit95', 'sumedh_patil', 'a.j.yadav2395', 'chiragc9494', 'evanmartin', 'patil.rushal825', 'maithili010', 'hbg2112', 'varadrajnanaware7', 'ckargutkar96', 'viveky803', 'tejasshinde8055', 'siddhesh401', 'sanika.dongre', 'priyankapandya19', 'chaudharisuyash7', 'nivipetkar', 'ru1795', 'deven199570', 'priyagajakosh1', 'aashish.yadav94', 'walden95', 'pratikthorat10', 'jatin.dhande1008', 'aniket2602', 'aditya1818', 'kanchan.sawant17', 'apoorvasundaresan', 'avinashninawe', 'aditya.apte3', 'shivanisharaf15', 'akanksha0196', 'ayyappakonar', 'monish.nene', 'sonawane.akshayak', 'purva.satpute', 'spooja.1430', 'sagarpawar', 'gsawant999', 'prajaktachapte2', 'mshirali23', 'mchakkalamuri', 'helmin50469', 'shwecchajain', 'nikhildubey02051996', 'danish.dev.007', 'saylishirodkar58', 'stanabk', 'rohankhollamkar', 'joijodegauri7', 'sayalipatil4545', 'aishwaryamardhekar.24595', 'cooldudeakshu', 'juhi.manglani', 'komalbapna.kb', 'strikerfv68', 'dipmads', 'sjunghareakshay', 'rajatkedia95', 'priyuk', 'shubham.gaikwad', 'akshaybadhiye04', 'iabhishek555', 'ambani', 'umeshdarade77', 'tanvi.rane1995', 'pankajpawar1515', 'susmitaahirrao', 'tanayshinde21', 'karan.dadlani', 'infinite1309', 'pravin45', 'doshishrut1995', 'tejaskanagal95', 'jayeshkhandagle123', 'oindri.c', 'abarge31', 'poojamenon16.pm', 'rahul4peace', 'praveen99', 'shahyash027', 'rawletanmayee46', 'rashuidiot', 'mahajanabhi2201', 'myuk83', 'advenraju', 'abhihadshi', 'supu1796', 'pratikkhanore95', 'sahil8rai', 'preetywagh95', 'gidayegirish', 'shrikantnimse14', 'gauravrajeshmehta', 'pbrahmapurkar', 'mosfet7777', 'swati123', 'jenna', 'saurabhmangeshkar', 'shrutisundar019', 'ravina.chavan42', 'ishita.choudhary', 'danishdewani112795', 'nimisha.nimisha.agarwal', 'mukulsathe1995', 'tarak.shah', 'vivek12195', 'priyankaingle18', 'manavtrivedi03', 'bondreanup007', 'rohitbaliyan53', 'tanyabaptist05', 'arunnambiar66', 'bkadam357', 'akshaybangera95', 'manishashetye1295', 'suthar.kalpesh57', 'mukul.kulkarni', 'abhishek.thavare', 'smithnano15', 'sardesai.kirti18', 'soorajdinesan27', 'sammit1844', 'harshit0610', 'trishapatkar19', 'alisha.alice.panicker', 'zeuswinchester456', 'amrsha.srivastava', 'apurva.patil', 'sanketsalvi03', 'sandesh29', 'amritamukeshb', 'shriya.sharma', 'lakumveer', 'shukla.pawan249', 'dhruv.gajaria95', 'sarveshgrao', 'shakyanandk', 'ramaprde2296', 'parthiv.parikh', 'rushabh.fegade', 'akashspawar148', 'khannamansi312', 'cpatil152', 'abhishekm2861996', 'ritesh.parulekar231194', 'vishakha1805', 'nileshkartik95', 'jainam49', 'ttanmay.telang75', 'shreya.mahajan', 'jakhererahul42', 'dattaram.gawade781', None, 'shrinathnair', 'amey.m.mangutkar', 'ankita.rahate', 'sagarbhagat43', 'kaustubhgudekar9', 'srishti.shriyan96', 'prashant.baperkar', 'tejask2610', 'suman28pandit', 'rakeshmaity', 'rohanchavan', 'bimal.biswas8', 'roycefernandes80', 'dishakulkarni25', 'ptrimukhe32']"
4,51,124,67,39,"['danishdewani112795', 'ishita.choudhary', 'arunnambiar66', 'maithili010', 'raku1109', 'jogichetan96', 'akshaybangera95', 'suthar.kalpesh57', 'sjunghareakshay', 'soorajdinesan27', 'harshit0610', 'trishapatkar19', 'alisha.alice.panicker', 'apoorvakraut', 'zeuswinchester456', 'priyankapandya19', 'nivipetkar', 'doshishrut1995', 'jayeshkhandagle123', 'shukla.pawan249', 'jaidevdalvi', 'sarveshgrao', 'kanchan.sawant17', 'anuragshyam1026', 'akshay1995', 'rashuidiot', 'akanksha0196', 'ayyappakonar', 'ttanmay.telang75', 'shrinathnair', 'sahil8rai', 'varadmeradost', 'darshanadaund27', 'srishti.shriyan96', 'tejask2610', 'vivek.sakinala', 'jenna', 'joijodegauri7', 'dishakulkarni25']",84,"['raheela', 'jainamshah202', 'nrkhara', 'ajay.raghuwanshi', 'smallik', 'beelex1617', 'pankajvyas967', 'mehtajinal3101', 'luanco1', 'jonathantripi', 'minalsawant1108', 'jcastrocalvo', 'nickcrane6117', 'email.harsh0811', 'bhoomee.sheth', 'obalgi3095', 'kidongp', 'tanvikalan', 'jayjadav08', 'neelam.chaudhari27', 'harshilmehta1995', 'komal31p', 'anand_5', 'poojashetty', 'sam234bryant', 'bhumivora1995', 'ee12d018', 'monish.kapadia', 'cnconnery', 'riddhis2411', 'rsawant2895', 'msumit95', 'evanmartin', 'patil.rushal825', 'ckargutkar96', 'siddhesh401', 'sanika.dongre', 'walden95', 'apoorvasundaresan', 'avinashninawe', 'aditya.apte3', 'shivanisharaf15', 'monish.nene', 'purva.satpute', 'spooja.1430', 'mshirali23', 'mchakkalamuri', 'helmin50469', 'shwecchajain', 'stanabk', 'rohankhollamkar', 'juhi.manglani', 'strikerfv68', 'dipmads', 'rajatkedia95', 'priyuk', 'shubham.gaikwad', 'ambani', 'umeshdarade77', 'tanvi.rane1995', 'karan.dadlani', 'poojamenon16.pm', 'rahul4peace', 'praveen99', 'myuk83', 'mosfet7777', 'nimisha.nimisha.agarwal', 'vivek12195', 'manavtrivedi03', 'mukul.kulkarni', 'smithnano15', 'amrsha.srivastava', 'apurva.patil', 'shriya.sharma', 'dhruv.gajaria95', 'parthiv.parikh', 'khannamansi312', 'nileshkartik95', 'jainam49', 'shreya.mahajan', 'jakhererahul42', 'amey.m.mangutkar', 'ankita.rahate', 'roycefernandes80']",28,"['rushabh.soni', 'chiragc9494', 'karantank97', 'shraddhakharde01', 'akashmore456', 'omkardalvi409', 'shubhamjambhe8', 'manisha.shetty07', 'kiranrelekar412', 'dhvanilmandalia29', 'varma096', 'himanshuphatak98', 'ranjuvarughese', 'shubhangi.matey', 'rhea.ann.95', 'pranilraut17', 'ajthamke40', 'jitesh.10', 'kambe302', 'shafaanbhai', None, 'shevekarrohan', 'deepikachaman3', 'd.shenoy', 'salman23011996', 'asingh12', 'chandramani.yadav43', 'upadhyechinmay']",151,"['raheela', 'raku1109', 'jainamshah202', 'jogichetan96', 'nrkhara', 'ajay.raghuwanshi', 'smallik', 'beelex1617', 'pankajvyas967', 'mehtajinal3101', 'apoorvakraut', 'luanco1', 'jonathantripi', 'minalsawant1108', 'jcastrocalvo', 'nickcrane6117', 'email.harsh0811', 'ranjuvarughese', 'himanshuphatak98', 'bhoomee.sheth', 'anuragshyam1026', 'akshay1995', 'jitesh.10', 'obalgi3095', 'kambe302', 'kidongp', 'tanvikalan', 'jayjadav08', 'neelam.chaudhari27', 'harshilmehta1995', 'varadmeradost', 'komal31p', 'anand_5', 'poojashetty', 'darshanadaund27', 'sam234bryant', 'bhumivora1995', 'ee12d018', 'vivek.sakinala', 'jaidevdalvi', 'monish.kapadia', 'cnconnery', 'riddhis2411', 'rsawant2895', 'msumit95', 'chiragc9494', 'evanmartin', 'patil.rushal825', 'maithili010', 'ckargutkar96', 'siddhesh401', 'sanika.dongre', 'priyankapandya19', 'nivipetkar', 'walden95', 'dhvanilmandalia29', 'varma096', 'kanchan.sawant17', 'shubhangi.matey', 'pranilraut17', 'apoorvasundaresan', 'avinashninawe', 'aditya.apte3', 'shivanisharaf15', 'akanksha0196', 'ayyappakonar', 'monish.nene', 'purva.satpute', 'spooja.1430', 'deepikachaman3', 'mshirali23', 'mchakkalamuri', 'helmin50469', 'shwecchajain', 'chandramani.yadav43', 'stanabk', 'rohankhollamkar', 'joijodegauri7', 'upadhyechinmay', 'juhi.manglani', 'strikerfv68', 'dipmads', 'sjunghareakshay', 'rajatkedia95', 'priyuk', 'shubham.gaikwad', 'ambani', 'umeshdarade77', 'tanvi.rane1995', 'karan.dadlani', 'shraddhakharde01', 'doshishrut1995', 'jayeshkhandagle123', 'manisha.shetty07', 'poojamenon16.pm', 'rahul4peace', 'praveen99', 'rhea.ann.95', 'ajthamke40', 'rashuidiot', 'shafaanbhai', 'myuk83', 'sahil8rai', 'asingh12', 'mosfet7777', 'jenna', 'ishita.choudhary', 'danishdewani112795', 'nimisha.nimisha.agarwal', 'vivek12195', 'rushabh.soni', 'manavtrivedi03', 'arunnambiar66', 'akshaybangera95', 'suthar.kalpesh57', 'mukul.kulkarni', 'smithnano15', 'soorajdinesan27', 'harshit0610', 'trishapatkar19', 'alisha.alice.panicker', 'zeuswinchester456', 'amrsha.srivastava', 'karantank97', 'apurva.patil', 'akashmore456', 'omkardalvi409', 'shubhamjambhe8', 'shriya.sharma', 'kiranrelekar412', 'shukla.pawan249', 'dhruv.gajaria95', 'sarveshgrao', 'parthiv.parikh', 'khannamansi312', 'nileshkartik95', 'jainam49', 'ttanmay.telang75', 'shreya.mahajan', 'jakhererahul42', None, 'shevekarrohan', 'shrinathnair', 'd.shenoy', 'amey.m.mangutkar', 'salman23011996', 'ankita.rahate', 'srishti.shriyan96', 'tejask2610', 'roycefernandes80', 'dishakulkarni25']"
4,138,124,35,7,"['danishdewani112795', 'amey.m.mangutkar', 'pankajvyas967', 'alisha.alice.panicker', 'raku1109', 'suthar.kalpesh57', 'dishakulkarni25']",116,"['raheela', 'jainamshah202', 'jogichetan96', 'nrkhara', 'ajay.raghuwanshi', 'smallik', 'beelex1617', 'mehtajinal3101', 'apoorvakraut', 'luanco1', 'jonathantripi', 'minalsawant1108', 'jcastrocalvo', 'nickcrane6117', 'email.harsh0811', 'bhoomee.sheth', 'anuragshyam1026', 'akshay1995', 'obalgi3095', 'kidongp', 'tanvikalan', 'jayjadav08', 'neelam.chaudhari27', 'harshilmehta1995', 'varadmeradost', 'komal31p', 'anand_5', 'poojashetty', 'darshanadaund27', 'sam234bryant', 'bhumivora1995', 'ee12d018', 'vivek.sakinala', 'jaidevdalvi', 'monish.kapadia', 'cnconnery', 'riddhis2411', 'rsawant2895', 'msumit95', 'evanmartin', 'patil.rushal825', 'maithili010', 'ckargutkar96', 'siddhesh401', 'sanika.dongre', 'priyankapandya19', 'nivipetkar', 'walden95', 'kanchan.sawant17', 'apoorvasundaresan', 'avinashninawe', 'aditya.apte3', 'shivanisharaf15', 'akanksha0196', 'ayyappakonar', 'monish.nene', 'purva.satpute', 'spooja.1430', 'mshirali23', 'mchakkalamuri', 'helmin50469', 'shwecchajain', 'stanabk', 'rohankhollamkar', 'joijodegauri7', 'juhi.manglani', 'strikerfv68', 'dipmads', 'sjunghareakshay', 'rajatkedia95', 'priyuk', 'shubham.gaikwad', 'ambani', 'umeshdarade77', 'tanvi.rane1995', 'karan.dadlani', 'doshishrut1995', 'jayeshkhandagle123', 'poojamenon16.pm', 'rahul4peace', 'praveen99', 'rashuidiot', 'myuk83', 'sahil8rai', 'mosfet7777', 'jenna', 'ishita.choudhary', 'nimisha.nimisha.agarwal', 'vivek12195', 'manavtrivedi03', 'arunnambiar66', 'akshaybangera95', 'mukul.kulkarni', 'smithnano15', 'soorajdinesan27', 'harshit0610', 'trishapatkar19', 'zeuswinchester456', 'amrsha.srivastava', 'apurva.patil', 'shriya.sharma', 'shukla.pawan249', 'dhruv.gajaria95', 'sarveshgrao', 'parthiv.parikh', 'khannamansi312', 'nileshkartik95', 'jainam49', 'ttanmay.telang75', 'shreya.mahajan', 'jakhererahul42', 'shrinathnair', 'ankita.rahate', 'srishti.shriyan96', 'tejask2610', 'roycefernandes80']",28,"['pratikdongrikar', 'shubhamsurya449', 'samson.sd28', 'tanyabaptist05', 'minkscdl', 'dms.dms786', 'ankit.kp', 'shubhamjambhe8', 'manisha.shetty07', 'kiranrelekar412', 'ranjuvarughese', 'palak1012', 'shubhangi.matey', 'basil11031996', 'jitesh.10', 'shafaanbhai', 'burhansnaim', 'rutujanare', None, 'rashika.t', 'd.shenoy', 'parag.choughule', 'nilesh.delekar', 'hemadevi.b', 'ishaan.sathe', 'vishalchelimela11', 'upadhyechinmay', 'krishna96']",151,"['raheela', 'pratikdongrikar', 'raku1109', 'jainamshah202', 'jogichetan96', 'minkscdl', 'nrkhara', 'ajay.raghuwanshi', 'smallik', 'beelex1617', 'pankajvyas967', 'ankit.kp', 'mehtajinal3101', 'apoorvakraut', 'luanco1', 'jonathantripi', 'minalsawant1108', 'jcastrocalvo', 'nickcrane6117', 'email.harsh0811', 'ranjuvarughese', 'basil11031996', 'bhoomee.sheth', 'anuragshyam1026', 'akshay1995', 'jitesh.10', 'obalgi3095', 'kidongp', 'rutujanare', 'tanvikalan', 'jayjadav08', 'neelam.chaudhari27', 'harshilmehta1995', 'varadmeradost', 'komal31p', 'hemadevi.b', 'anand_5', 'poojashetty', 'darshanadaund27', 'sam234bryant', 'ishaan.sathe', 'bhumivora1995', 'ee12d018', 'vivek.sakinala', 'jaidevdalvi', 'monish.kapadia', 'cnconnery', 'riddhis2411', 'rsawant2895', 'msumit95', 'shubhamsurya449', 'evanmartin', 'patil.rushal825', 'maithili010', 'dms.dms786', 'ckargutkar96', 'siddhesh401', 'sanika.dongre', 'priyankapandya19', 'nivipetkar', 'walden95', 'kanchan.sawant17', 'shubhangi.matey', 'apoorvasundaresan', 'avinashninawe', 'aditya.apte3', 'shivanisharaf15', 'akanksha0196', 'ayyappakonar', 'monish.nene', 'purva.satpute', 'spooja.1430', 'mshirali23', 'mchakkalamuri', 'helmin50469', 'shwecchajain', 'nilesh.delekar', 'stanabk', 'rohankhollamkar', 'joijodegauri7', 'upadhyechinmay', 'juhi.manglani', 'strikerfv68', 'samson.sd28', 'dipmads', 'sjunghareakshay', 'rajatkedia95', 'priyuk', 'shubham.gaikwad', 'ambani', 'umeshdarade77', 'tanvi.rane1995', 'karan.dadlani', 'doshishrut1995', 'jayeshkhandagle123', 'manisha.shetty07', 'poojamenon16.pm', 'rahul4peace', 'praveen99', 'rashuidiot', 'shafaanbhai', 'myuk83', 'rashika.t', 'sahil8rai', 'parag.choughule', 'mosfet7777', 'vishalchelimela11', 'jenna', 'krishna96', 'ishita.choudhary', 'danishdewani112795', 'nimisha.nimisha.agarwal', 'vivek12195', 'manavtrivedi03', 'tanyabaptist05', 'arunnambiar66', 'akshaybangera95', 'suthar.kalpesh57', 'mukul.kulkarni', 'smithnano15', 'soorajdinesan27', 'harshit0610', 'trishapatkar19', 'alisha.alice.panicker', 'zeuswinchester456', 'amrsha.srivastava', 'apurva.patil', 'shubhamjambhe8', 'shriya.sharma', 'kiranrelekar412', 'shukla.pawan249', 'dhruv.gajaria95', 'palak1012', 'sarveshgrao', 'parthiv.parikh', 'khannamansi312', 'nileshkartik95', 'jainam49', 'ttanmay.telang75', 'shreya.mahajan', 'burhansnaim', 'jakhererahul42', None, 'shrinathnair', 'd.shenoy', 'amey.m.mangutkar', 'ankita.rahate', 'srishti.shriyan96', 'tejask2610', 'roycefernandes80', 'dishakulkarni25']"
4,59,124,22,3,"['ckargutkar96', 'nimisha.nimisha.agarwal', 'poojamenon16.pm']",120,"['raheela', 'strikerfv68', 'dipmads', 'raku1109', 'jainamshah202', 'jogichetan96', 'sjunghareakshay', 'rajatkedia95', 'nrkhara', 'ajay.raghuwanshi', 'smallik', 'beelex1617', 'priyuk', 'pankajvyas967', 'shubham.gaikwad', 'ambani', 'mehtajinal3101', 'apoorvakraut', 'umeshdarade77', 'tanvi.rane1995', 'luanco1', 'jonathantripi', 'karan.dadlani', 'doshishrut1995', 'minalsawant1108', 'jcastrocalvo', 'jayeshkhandagle123', 'nickcrane6117', 'email.harsh0811', 'rahul4peace', 'praveen99', 'bhoomee.sheth', 'anuragshyam1026', 'akshay1995', 'rashuidiot', 'obalgi3095', 'kidongp', 'myuk83', 'tanvikalan', 'jayjadav08', 'neelam.chaudhari27', 'sahil8rai', 'harshilmehta1995', 'varadmeradost', 'komal31p', 'anand_5', 'poojashetty', 'darshanadaund27', 'sam234bryant', 'mosfet7777', 'bhumivora1995', 'ee12d018', 'vivek.sakinala', 'jaidevdalvi', 'jenna', 'monish.kapadia', 'cnconnery', 'ishita.choudhary', 'riddhis2411', 'danishdewani112795', 'rsawant2895', 'vivek12195', 'msumit95', 'manavtrivedi03', 'arunnambiar66', 'evanmartin', 'patil.rushal825', 'maithili010', 'akshaybangera95', 'suthar.kalpesh57', 'mukul.kulkarni', 'smithnano15', 'soorajdinesan27', 'harshit0610', 'trishapatkar19', 'alisha.alice.panicker', 'zeuswinchester456', 'amrsha.srivastava', 'siddhesh401', 'sanika.dongre', 'apurva.patil', 'priyankapandya19', 'nivipetkar', 'walden95', 'shriya.sharma', 'shukla.pawan249', 'dhruv.gajaria95', 'sarveshgrao', 'kanchan.sawant17', 'parthiv.parikh', 'apoorvasundaresan', 'avinashninawe', 'aditya.apte3', 'khannamansi312', 'shivanisharaf15', 'akanksha0196', 'ayyappakonar', 'monish.nene', 'nileshkartik95', 'jainam49', 'purva.satpute', 'spooja.1430', 'ttanmay.telang75', 'shreya.mahajan', 'jakhererahul42', 'shrinathnair', 'mshirali23', 'amey.m.mangutkar', 'mchakkalamuri', 'helmin50469', 'shwecchajain', 'ankita.rahate', 'srishti.shriyan96', 'tejask2610', 'stanabk', 'rohankhollamkar', 'joijodegauri7', 'roycefernandes80', 'dishakulkarni25', 'juhi.manglani']",19,"['doshi.kavisha16', 'yashsavle', 'mpethe22', 'janhvi.vora97', 'sonihetvi10', 'adwaitvajpe', 'adityamodi009', '1jyotsna1', 'vijaykothari97', 'bangasunain', None, 'smonica498', 'arawal14.ar', 'meetgopani616', 'prp23dec', 'jaysawant2', 'tanuj.udani', 'agarwal.gagan5101', 'varun1997']",142,"['raheela', 'yashsavle', 'mpethe22', 'strikerfv68', 'dipmads', 'raku1109', 'jainamshah202', 'jogichetan96', 'sjunghareakshay', 'rajatkedia95', 'nrkhara', 'ajay.raghuwanshi', 'smallik', 'beelex1617', 'priyuk', 'pankajvyas967', 'shubham.gaikwad', 'ambani', 'mehtajinal3101', 'apoorvakraut', 'umeshdarade77', 'tanvi.rane1995', 'luanco1', 'jonathantripi', 'karan.dadlani', 'doshishrut1995', 'minalsawant1108', 'jcastrocalvo', 'jayeshkhandagle123', 'nickcrane6117', 'email.harsh0811', 'poojamenon16.pm', 'rahul4peace', 'praveen99', 'bhoomee.sheth', 'vijaykothari97', 'anuragshyam1026', 'akshay1995', 'rashuidiot', 'obalgi3095', 'kidongp', 'myuk83', 'tanvikalan', 'jayjadav08', 'neelam.chaudhari27', 'varun1997', 'sahil8rai', 'smonica498', 'arawal14.ar', 'harshilmehta1995', 'varadmeradost', 'komal31p', 'anand_5', 'poojashetty', 'darshanadaund27', 'jaysawant2', 'tanuj.udani', 'sam234bryant', 'mosfet7777', 'bhumivora1995', 'ee12d018', 'vivek.sakinala', 'jaidevdalvi', 'jenna', 'monish.kapadia', 'cnconnery', 'doshi.kavisha16', 'ishita.choudhary', 'riddhis2411', 'danishdewani112795', 'nimisha.nimisha.agarwal', 'rsawant2895', 'vivek12195', 'msumit95', 'manavtrivedi03', 'janhvi.vora97', 'sonihetvi10', 'arunnambiar66', 'evanmartin', 'patil.rushal825', 'maithili010', 'akshaybangera95', 'suthar.kalpesh57', 'mukul.kulkarni', 'smithnano15', 'soorajdinesan27', 'harshit0610', 'adwaitvajpe', 'ckargutkar96', 'trishapatkar19', 'alisha.alice.panicker', 'adityamodi009', 'zeuswinchester456', 'amrsha.srivastava', 'siddhesh401', 'sanika.dongre', 'apurva.patil', 'priyankapandya19', 'nivipetkar', 'walden95', 'shriya.sharma', 'shukla.pawan249', 'dhruv.gajaria95', 'sarveshgrao', '1jyotsna1', 'kanchan.sawant17', 'parthiv.parikh', 'apoorvasundaresan', 'avinashninawe', 'aditya.apte3', 'bangasunain', 'khannamansi312', 'shivanisharaf15', 'akanksha0196', 'ayyappakonar', 'monish.nene', 'nileshkartik95', 'jainam49', 'purva.satpute', 'spooja.1430', 'ttanmay.telang75', 'shreya.mahajan', 'jakhererahul42', None, 'shrinathnair', 'mshirali23', 'amey.m.mangutkar', 'meetgopani616', 'mchakkalamuri', 'helmin50469', 'shwecchajain', 'ankita.rahate', 'prp23dec', 'srishti.shriyan96', 'agarwal.gagan5101', 'tejask2610', 'stanabk', 'rohankhollamkar', 'joijodegauri7', 'roycefernandes80', 'dishakulkarni25', 'juhi.manglani']"
4,52,124,17,10,"['helmin50469', 'mchakkalamuri', 'jonathantripi', 'strikerfv68', 'evanmartin', 'walden95', 'jcastrocalvo', 'myuk83', 'nickcrane6117', 'cnconnery']",113,"['raheela', 'dipmads', 'raku1109', 'jainamshah202', 'jogichetan96', 'sjunghareakshay', 'rajatkedia95', 'nrkhara', 'ajay.raghuwanshi', 'smallik', 'beelex1617', 'priyuk', 'pankajvyas967', 'shubham.gaikwad', 'ambani', 'mehtajinal3101', 'apoorvakraut', 'umeshdarade77', 'tanvi.rane1995', 'luanco1', 'karan.dadlani', 'doshishrut1995', 'minalsawant1108', 'jayeshkhandagle123', 'email.harsh0811', 'poojamenon16.pm', 'rahul4peace', 'praveen99', 'bhoomee.sheth', 'anuragshyam1026', 'akshay1995', 'rashuidiot', 'obalgi3095', 'kidongp', 'tanvikalan', 'jayjadav08', 'neelam.chaudhari27', 'sahil8rai', 'harshilmehta1995', 'varadmeradost', 'komal31p', 'anand_5', 'poojashetty', 'darshanadaund27', 'sam234bryant', 'mosfet7777', 'bhumivora1995', 'ee12d018', 'vivek.sakinala', 'jaidevdalvi', 'jenna', 'monish.kapadia', 'ishita.choudhary', 'riddhis2411', 'danishdewani112795', 'nimisha.nimisha.agarwal', 'rsawant2895', 'vivek12195', 'msumit95', 'manavtrivedi03', 'arunnambiar66', 'patil.rushal825', 'maithili010', 'akshaybangera95', 'suthar.kalpesh57', 'mukul.kulkarni', 'smithnano15', 'soorajdinesan27', 'harshit0610', 'ckargutkar96', 'trishapatkar19', 'alisha.alice.panicker', 'zeuswinchester456', 'amrsha.srivastava', 'siddhesh401', 'sanika.dongre', 'apurva.patil', 'priyankapandya19', 'nivipetkar', 'shriya.sharma', 'shukla.pawan249', 'dhruv.gajaria95', 'sarveshgrao', 'kanchan.sawant17', 'parthiv.parikh', 'apoorvasundaresan', 'avinashninawe', 'aditya.apte3', 'khannamansi312', 'shivanisharaf15', 'akanksha0196', 'ayyappakonar', 'monish.nene', 'nileshkartik95', 'jainam49', 'purva.satpute', 'spooja.1430', 'ttanmay.telang75', 'shreya.mahajan', 'jakhererahul42', 'shrinathnair', 'mshirali23', 'amey.m.mangutkar', 'shwecchajain', 'ankita.rahate', 'srishti.shriyan96', 'tejask2610', 'stanabk', 'rohankhollamkar', 'joijodegauri7', 'roycefernandes80', 'dishakulkarni25', 'juhi.manglani']",7,"['ctamma', 'ndp732', 'eliasmagallanesjr17', 'm.janik1031', 'calvinl', None, 'tomwentworth']",130,"['raheela', 'eliasmagallanesjr17', 'strikerfv68', 'dipmads', 'raku1109', 'jainamshah202', 'jogichetan96', 'sjunghareakshay', 'rajatkedia95', 'nrkhara', 'ajay.raghuwanshi', 'smallik', 'beelex1617', 'priyuk', 'pankajvyas967', 'shubham.gaikwad', 'ambani', 'mehtajinal3101', 'apoorvakraut', 'umeshdarade77', 'tanvi.rane1995', 'luanco1', 'jonathantripi', 'karan.dadlani', 'ctamma', 'doshishrut1995', 'calvinl', 'minalsawant1108', 'jcastrocalvo', 'jayeshkhandagle123', 'nickcrane6117', 'email.harsh0811', 'poojamenon16.pm', 'tomwentworth', 'rahul4peace', 'praveen99', 'bhoomee.sheth', 'anuragshyam1026', 'akshay1995', 'rashuidiot', 'm.janik1031', 'obalgi3095', 'kidongp', 'myuk83', 'tanvikalan', 'jayjadav08', 'neelam.chaudhari27', 'sahil8rai', 'harshilmehta1995', 'varadmeradost', 'komal31p', 'anand_5', 'poojashetty', 'darshanadaund27', 'sam234bryant', 'mosfet7777', 'bhumivora1995', 'ee12d018', 'vivek.sakinala', 'jaidevdalvi', 'jenna', 'monish.kapadia', 'cnconnery', 'ishita.choudhary', 'riddhis2411', 'danishdewani112795', 'nimisha.nimisha.agarwal', 'ndp732', 'rsawant2895', 'vivek12195', 'msumit95', 'manavtrivedi03', 'arunnambiar66', 'evanmartin', 'patil.rushal825', 'maithili010', 'akshaybangera95', 'suthar.kalpesh57', 'mukul.kulkarni', 'smithnano15', 'soorajdinesan27', 'harshit0610', 'ckargutkar96', 'trishapatkar19', 'alisha.alice.panicker', 'zeuswinchester456', 'amrsha.srivastava', 'siddhesh401', 'sanika.dongre', 'apurva.patil', 'priyankapandya19', 'nivipetkar', 'walden95', 'shriya.sharma', 'shukla.pawan249', 'dhruv.gajaria95', 'sarveshgrao', 'kanchan.sawant17', 'parthiv.parikh', 'apoorvasundaresan', 'avinashninawe', 'aditya.apte3', 'khannamansi312', 'shivanisharaf15', 'akanksha0196', 'ayyappakonar', 'monish.nene', 'nileshkartik95', 'jainam49', 'purva.satpute', 'spooja.1430', 'ttanmay.telang75', 'shreya.mahajan', 'jakhererahul42', None, 'shrinathnair', 'mshirali23', 'amey.m.mangutkar', 'mchakkalamuri', 'helmin50469', 'shwecchajain', 'ankita.rahate', 'srishti.shriyan96', 'tejask2610', 'stanabk', 'rohankhollamkar', 'joijodegauri7', 'roycefernandes80', 'dishakulkarni25', 'juhi.manglani']"
4,136,124,15,3,"['raku1109', 'beelex1617', 'pankajvyas967']",120,"['raheela', 'strikerfv68', 'dipmads', 'jainamshah202', 'jogichetan96', 'sjunghareakshay', 'rajatkedia95', 'nrkhara', 'ajay.raghuwanshi', 'smallik', 'priyuk', 'shubham.gaikwad', 'ambani', 'mehtajinal3101', 'apoorvakraut', 'umeshdarade77', 'tanvi.rane1995', 'luanco1', 'jonathantripi', 'karan.dadlani', 'doshishrut1995', 'minalsawant1108', 'jcastrocalvo', 'jayeshkhandagle123', 'nickcrane6117', 'email.harsh0811', 'poojamenon16.pm', 'rahul4peace', 'praveen99', 'bhoomee.sheth', 'anuragshyam1026', 'akshay1995', 'rashuidiot', 'obalgi3095', 'kidongp', 'myuk83', 'tanvikalan', 'jayjadav08', 'neelam.chaudhari27', 'sahil8rai', 'harshilmehta1995', 'varadmeradost', 'komal31p', 'anand_5', 'poojashetty', 'darshanadaund27', 'sam234bryant', 'mosfet7777', 'bhumivora1995', 'ee12d018', 'vivek.sakinala', 'jaidevdalvi', 'jenna', 'monish.kapadia', 'cnconnery', 'ishita.choudhary', 'riddhis2411', 'danishdewani112795', 'nimisha.nimisha.agarwal', 'rsawant2895', 'vivek12195', 'msumit95', 'manavtrivedi03', 'arunnambiar66', 'evanmartin', 'patil.rushal825', 'maithili010', 'akshaybangera95', 'suthar.kalpesh57', 'mukul.kulkarni', 'smithnano15', 'soorajdinesan27', 'harshit0610', 'ckargutkar96', 'trishapatkar19', 'alisha.alice.panicker', 'zeuswinchester456', 'amrsha.srivastava', 'siddhesh401', 'sanika.dongre', 'apurva.patil', 'priyankapandya19', 'nivipetkar', 'walden95', 'shriya.sharma', 'shukla.pawan249', 'dhruv.gajaria95', 'sarveshgrao', 'kanchan.sawant17', 'parthiv.parikh', 'apoorvasundaresan', 'avinashninawe', 'aditya.apte3', 'khannamansi312', 'shivanisharaf15', 'akanksha0196', 'ayyappakonar', 'monish.nene', 'nileshkartik95', 'jainam49', 'purva.satpute', 'spooja.1430', 'ttanmay.telang75', 'shreya.mahajan', 'jakhererahul42', 'shrinathnair', 'mshirali23', 'amey.m.mangutkar', 'mchakkalamuri', 'helmin50469', 'shwecchajain', 'ankita.rahate', 'srishti.shriyan96', 'tejask2610', 'stanabk', 'rohankhollamkar', 'joijodegauri7', 'roycefernandes80', 'dishakulkarni25', 'juhi.manglani']",12,"['shubhangi.matey', 'omprakashjha24', 'vinayrane96', 'swapnalimakdey25', 'shubhamsurya449', 'hrishikeshmoghe1331995', 'manisha.shetty07', 'kiranrelekar412', 'sarmatejas1006', None, 'razorrajeev', 'n160165']",135,"['raheela', 'strikerfv68', 'dipmads', 'raku1109', 'jainamshah202', 'jogichetan96', 'sjunghareakshay', 'rajatkedia95', 'razorrajeev', 'nrkhara', 'ajay.raghuwanshi', 'smallik', 'beelex1617', 'priyuk', 'pankajvyas967', 'shubham.gaikwad', 'ambani', 'mehtajinal3101', 'apoorvakraut', 'umeshdarade77', 'tanvi.rane1995', 'luanco1', 'jonathantripi', 'karan.dadlani', 'swapnalimakdey25', 'doshishrut1995', 'hrishikeshmoghe1331995', 'minalsawant1108', 'jcastrocalvo', 'jayeshkhandagle123', 'manisha.shetty07', 'nickcrane6117', 'email.harsh0811', 'poojamenon16.pm', 'rahul4peace', 'praveen99', 'bhoomee.sheth', 'anuragshyam1026', 'akshay1995', 'rashuidiot', 'obalgi3095', 'kidongp', 'myuk83', 'sarmatejas1006', 'tanvikalan', 'jayjadav08', 'neelam.chaudhari27', 'sahil8rai', 'harshilmehta1995', 'varadmeradost', 'komal31p', 'anand_5', 'poojashetty', 'darshanadaund27', 'sam234bryant', 'mosfet7777', 'bhumivora1995', 'ee12d018', 'vivek.sakinala', 'jaidevdalvi', 'jenna', 'monish.kapadia', 'vinayrane96', 'cnconnery', 'n160165', 'ishita.choudhary', 'riddhis2411', 'danishdewani112795', 'nimisha.nimisha.agarwal', 'rsawant2895', 'vivek12195', 'msumit95', 'manavtrivedi03', 'shubhamsurya449', 'arunnambiar66', 'evanmartin', 'patil.rushal825', 'maithili010', 'akshaybangera95', 'suthar.kalpesh57', 'mukul.kulkarni', 'smithnano15', 'soorajdinesan27', 'harshit0610', 'ckargutkar96', 'trishapatkar19', 'alisha.alice.panicker', 'zeuswinchester456', 'amrsha.srivastava', 'siddhesh401', 'sanika.dongre', 'apurva.patil', 'priyankapandya19', 'nivipetkar', 'walden95', 'shriya.sharma', 'kiranrelekar412', 'shukla.pawan249', 'dhruv.gajaria95', 'sarveshgrao', 'kanchan.sawant17', 'shubhangi.matey', 'parthiv.parikh', 'apoorvasundaresan', 'avinashninawe', 'aditya.apte3', 'khannamansi312', 'shivanisharaf15', 'akanksha0196', 'ayyappakonar', 'monish.nene', 'nileshkartik95', 'jainam49', 'purva.satpute', 'spooja.1430', 'ttanmay.telang75', 'shreya.mahajan', 'jakhererahul42', None, 'shrinathnair', 'mshirali23', 'amey.m.mangutkar', 'mchakkalamuri', 'helmin50469', 'shwecchajain', 'ankita.rahate', 'omprakashjha24', 'srishti.shriyan96', 'tejask2610', 'stanabk', 'rohankhollamkar', 'joijodegauri7', 'roycefernandes80', 'dishakulkarni25', 'juhi.manglani']"
4,53,124,14,8,"['mchakkalamuri', 'helmin50469', 'jonathantripi', 'walden95', 'jcastrocalvo', 'myuk83', 'nickcrane6117', 'cnconnery']",115,"['raheela', 'strikerfv68', 'dipmads', 'raku1109', 'jainamshah202', 'jogichetan96', 'sjunghareakshay', 'rajatkedia95', 'nrkhara', 'ajay.raghuwanshi', 'smallik', 'beelex1617', 'priyuk', 'pankajvyas967', 'shubham.gaikwad', 'ambani', 'mehtajinal3101', 'apoorvakraut', 'umeshdarade77', 'tanvi.rane1995', 'luanco1', 'karan.dadlani', 'doshishrut1995', 'minalsawant1108', 'jayeshkhandagle123', 'email.harsh0811', 'poojamenon16.pm', 'rahul4peace', 'praveen99', 'bhoomee.sheth', 'anuragshyam1026', 'akshay1995', 'rashuidiot', 'obalgi3095', 'kidongp', 'tanvikalan', 'jayjadav08', 'neelam.chaudhari27', 'sahil8rai', 'harshilmehta1995', 'varadmeradost', 'komal31p', 'anand_5', 'poojashetty', 'darshanadaund27', 'sam234bryant', 'mosfet7777', 'bhumivora1995', 'ee12d018', 'vivek.sakinala', 'jaidevdalvi', 'jenna', 'monish.kapadia', 'ishita.choudhary', 'riddhis2411', 'danishdewani112795', 'nimisha.nimisha.agarwal', 'rsawant2895', 'vivek12195', 'msumit95', 'manavtrivedi03', 'arunnambiar66', 'evanmartin', 'patil.rushal825', 'maithili010', 'akshaybangera95', 'suthar.kalpesh57', 'mukul.kulkarni', 'smithnano15', 'soorajdinesan27', 'harshit0610', 'ckargutkar96', 'trishapatkar19', 'alisha.alice.panicker', 'zeuswinchester456', 'amrsha.srivastava', 'siddhesh401', 'sanika.dongre', 'apurva.patil', 'priyankapandya19', 'nivipetkar', 'shriya.sharma', 'shukla.pawan249', 'dhruv.gajaria95', 'sarveshgrao', 'kanchan.sawant17', 'parthiv.parikh', 'apoorvasundaresan', 'avinashninawe', 'aditya.apte3', 'khannamansi312', 'shivanisharaf15', 'akanksha0196', 'ayyappakonar', 'monish.nene', 'nileshkartik95', 'jainam49', 'purva.satpute', 'spooja.1430', 'ttanmay.telang75', 'shreya.mahajan', 'jakhererahul42', 'shrinathnair', 'mshirali23', 'amey.m.mangutkar', 'shwecchajain', 'ankita.rahate', 'srishti.shriyan96', 'tejask2610', 'stanabk', 'rohankhollamkar', 'joijodegauri7', 'roycefernandes80', 'dishakulkarni25', 'juhi.manglani']",6,"['ndp732', 'eliasmagallanesjr17', 'm.janik1031', 'calvinl', None, 'tomwentworth']",129,"['raheela', 'eliasmagallanesjr17', 'strikerfv68', 'dipmads', 'raku1109', 'jainamshah202', 'jogichetan96', 'sjunghareakshay', 'rajatkedia95', 'nrkhara', 'ajay.raghuwanshi', 'smallik', 'beelex1617', 'priyuk', 'pankajvyas967', 'shubham.gaikwad', 'ambani', 'mehtajinal3101', 'apoorvakraut', 'umeshdarade77', 'tanvi.rane1995', 'luanco1', 'jonathantripi', 'karan.dadlani', 'doshishrut1995', 'calvinl', 'minalsawant1108', 'jcastrocalvo', 'jayeshkhandagle123', 'nickcrane6117', 'email.harsh0811', 'poojamenon16.pm', 'tomwentworth', 'rahul4peace', 'praveen99', 'bhoomee.sheth', 'anuragshyam1026', 'akshay1995', 'rashuidiot', 'm.janik1031', 'obalgi3095', 'kidongp', 'myuk83', 'tanvikalan', 'jayjadav08', 'neelam.chaudhari27', 'sahil8rai', 'harshilmehta1995', 'varadmeradost', 'komal31p', 'anand_5', 'poojashetty', 'darshanadaund27', 'sam234bryant', 'mosfet7777', 'bhumivora1995', 'ee12d018', 'vivek.sakinala', 'jaidevdalvi', 'jenna', 'monish.kapadia', 'cnconnery', 'ishita.choudhary', 'riddhis2411', 'danishdewani112795', 'nimisha.nimisha.agarwal', 'ndp732', 'rsawant2895', 'vivek12195', 'msumit95', 'manavtrivedi03', 'arunnambiar66', 'evanmartin', 'patil.rushal825', 'maithili010', 'akshaybangera95', 'suthar.kalpesh57', 'mukul.kulkarni', 'smithnano15', 'soorajdinesan27', 'harshit0610', 'ckargutkar96', 'trishapatkar19', 'alisha.alice.panicker', 'zeuswinchester456', 'amrsha.srivastava', 'siddhesh401', 'sanika.dongre', 'apurva.patil', 'priyankapandya19', 'nivipetkar', 'walden95', 'shriya.sharma', 'shukla.pawan249', 'dhruv.gajaria95', 'sarveshgrao', 'kanchan.sawant17', 'parthiv.parikh', 'apoorvasundaresan', 'avinashninawe', 'aditya.apte3', 'khannamansi312', 'shivanisharaf15', 'akanksha0196', 'ayyappakonar', 'monish.nene', 'nileshkartik95', 'jainam49', 'purva.satpute', 'spooja.1430', 'ttanmay.telang75', 'shreya.mahajan', 'jakhererahul42', None, 'shrinathnair', 'mshirali23', 'amey.m.mangutkar', 'mchakkalamuri', 'helmin50469', 'shwecchajain', 'ankita.rahate', 'srishti.shriyan96', 'tejask2610', 'stanabk', 'rohankhollamkar', 'joijodegauri7', 'roycefernandes80', 'dishakulkarni25', 'juhi.manglani']"
4,139,124,13,12,"['rahul4peace', 'harshilmehta1995', 'komal31p', 'ambani', 'obalgi3095', 'khannamansi312', 'doshishrut1995', 'nileshkartik95', 'dipmads', 'jaidevdalvi', 'rajatkedia95', 'dhruv.gajaria95']",111,"['raheela', 'strikerfv68', 'raku1109', 'jainamshah202', 'jogichetan96', 'sjunghareakshay', 'nrkhara', 'ajay.raghuwanshi', 'smallik', 'beelex1617', 'priyuk', 'pankajvyas967', 'shubham.gaikwad', 'mehtajinal3101', 'apoorvakraut', 'umeshdarade77', 'tanvi.rane1995', 'luanco1', 'jonathantripi', 'karan.dadlani', 'minalsawant1108', 'jcastrocalvo', 'jayeshkhandagle123', 'nickcrane6117', 'email.harsh0811', 'poojamenon16.pm', 'praveen99', 'bhoomee.sheth', 'anuragshyam1026', 'akshay1995', 'rashuidiot', 'kidongp', 'myuk83', 'tanvikalan', 'jayjadav08', 'neelam.chaudhari27', 'sahil8rai', 'varadmeradost', 'anand_5', 'poojashetty', 'darshanadaund27', 'sam234bryant', 'mosfet7777', 'bhumivora1995', 'ee12d018', 'vivek.sakinala', 'jenna', 'monish.kapadia', 'cnconnery', 'ishita.choudhary', 'riddhis2411', 'danishdewani112795', 'nimisha.nimisha.agarwal', 'rsawant2895', 'vivek12195', 'msumit95', 'manavtrivedi03', 'arunnambiar66', 'evanmartin', 'patil.rushal825', 'maithili010', 'akshaybangera95', 'suthar.kalpesh57', 'mukul.kulkarni', 'smithnano15', 'soorajdinesan27', 'harshit0610', 'ckargutkar96', 'trishapatkar19', 'alisha.alice.panicker', 'zeuswinchester456', 'amrsha.srivastava', 'siddhesh401', 'sanika.dongre', 'apurva.patil', 'priyankapandya19', 'nivipetkar', 'walden95', 'shriya.sharma', 'shukla.pawan249', 'sarveshgrao', 'kanchan.sawant17', 'parthiv.parikh', 'apoorvasundaresan', 'avinashninawe', 'aditya.apte3', 'shivanisharaf15', 'akanksha0196', 'ayyappakonar', 'monish.nene', 'jainam49', 'purva.satpute', 'spooja.1430', 'ttanmay.telang75', 'shreya.mahajan', 'jakhererahul42', 'shrinathnair', 'mshirali23', 'amey.m.mangutkar', 'mchakkalamuri', 'helmin50469', 'shwecchajain', 'ankita.rahate', 'srishti.shriyan96', 'tejask2610', 'stanabk', 'rohankhollamkar', 'joijodegauri7', 'roycefernandes80', 'dishakulkarni25', 'juhi.manglani']",1,[None],124,"['raheela', 'strikerfv68', 'dipmads', 'raku1109', 'jainamshah202', 'jogichetan96', 'sjunghareakshay', 'rajatkedia95', 'nrkhara', 'ajay.raghuwanshi', 'smallik', 'beelex1617', 'priyuk', 'pankajvyas967', 'shubham.gaikwad', 'ambani', 'mehtajinal3101', 'apoorvakraut', 'umeshdarade77', 'tanvi.rane1995', 'luanco1', 'jonathantripi', 'karan.dadlani', 'doshishrut1995', 'minalsawant1108', 'jcastrocalvo', 'jayeshkhandagle123', 'nickcrane6117', 'email.harsh0811', 'poojamenon16.pm', 'rahul4peace', 'praveen99', 'bhoomee.sheth', 'anuragshyam1026', 'akshay1995', 'rashuidiot', 'obalgi3095', 'kidongp', 'myuk83', 'tanvikalan', 'jayjadav08', 'neelam.chaudhari27', 'sahil8rai', 'harshilmehta1995', 'varadmeradost', 'komal31p', 'anand_5', 'poojashetty', 'darshanadaund27', 'sam234bryant', 'mosfet7777', 'bhumivora1995', 'ee12d018', 'vivek.sakinala', 'jaidevdalvi', 'jenna', 'monish.kapadia', 'cnconnery', 'ishita.choudhary', 'riddhis2411', 'danishdewani112795', 'nimisha.nimisha.agarwal', 'rsawant2895', 'vivek12195', 'msumit95', 'manavtrivedi03', 'arunnambiar66', 'evanmartin', 'patil.rushal825', 'maithili010', 'akshaybangera95', 'suthar.kalpesh57', 'mukul.kulkarni', 'smithnano15', 'soorajdinesan27', 'harshit0610', 'ckargutkar96', 'trishapatkar19', 'alisha.alice.panicker', 'zeuswinchester456', 'amrsha.srivastava', 'siddhesh401', 'sanika.dongre', 'apurva.patil', 'priyankapandya19', 'nivipetkar', 'walden95', 'shriya.sharma', 'shukla.pawan249', 'dhruv.gajaria95', 'sarveshgrao', 'kanchan.sawant17', 'parthiv.parikh', 'apoorvasundaresan', 'avinashninawe', 'aditya.apte3', 'khannamansi312', 'shivanisharaf15', 'akanksha0196', 'ayyappakonar', 'monish.nene', 'nileshkartik95', 'jainam49', 'purva.satpute', 'spooja.1430', 'ttanmay.telang75', 'shreya.mahajan', 'jakhererahul42', None, 'shrinathnair', 'mshirali23', 'amey.m.mangutkar', 'mchakkalamuri', 'helmin50469', 'shwecchajain', 'ankita.rahate', 'srishti.shriyan96', 'tejask2610', 'stanabk', 'rohankhollamkar', 'joijodegauri7', 'roycefernandes80', 'dishakulkarni25', 'juhi.manglani']"
4,49,124,10,2,"['amey.m.mangutkar', 'raku1109']",121,"['raheela', 'strikerfv68', 'dipmads', 'jainamshah202', 'jogichetan96', 'sjunghareakshay', 'rajatkedia95', 'nrkhara', 'ajay.raghuwanshi', 'smallik', 'beelex1617', 'priyuk', 'pankajvyas967', 'shubham.gaikwad', 'ambani', 'mehtajinal3101', 'apoorvakraut', 'umeshdarade77', 'tanvi.rane1995', 'luanco1', 'jonathantripi', 'karan.dadlani', 'doshishrut1995', 'minalsawant1108', 'jcastrocalvo', 'jayeshkhandagle123', 'nickcrane6117', 'email.harsh0811', 'poojamenon16.pm', 'rahul4peace', 'praveen99', 'bhoomee.sheth', 'anuragshyam1026', 'akshay1995', 'rashuidiot', 'obalgi3095', 'kidongp', 'myuk83', 'tanvikalan', 'jayjadav08', 'neelam.chaudhari27', 'sahil8rai', 'harshilmehta1995', 'varadmeradost', 'komal31p', 'anand_5', 'poojashetty', 'darshanadaund27', 'sam234bryant', 'mosfet7777', 'bhumivora1995', 'ee12d018', 'vivek.sakinala', 'jaidevdalvi', 'jenna', 'monish.kapadia', 'cnconnery', 'ishita.choudhary', 'riddhis2411', 'danishdewani112795', 'nimisha.nimisha.agarwal', 'rsawant2895', 'vivek12195', 'msumit95', 'manavtrivedi03', 'arunnambiar66', 'evanmartin', 'patil.rushal825', 'maithili010', 'akshaybangera95', 'suthar.kalpesh57', 'mukul.kulkarni', 'smithnano15', 'soorajdinesan27', 'harshit0610', 'ckargutkar96', 'trishapatkar19', 'alisha.alice.panicker', 'zeuswinchester456', 'amrsha.srivastava', 'siddhesh401', 'sanika.dongre', 'apurva.patil', 'priyankapandya19', 'nivipetkar', 'walden95', 'shriya.sharma', 'shukla.pawan249', 'dhruv.gajaria95', 'sarveshgrao', 'kanchan.sawant17', 'parthiv.parikh', 'apoorvasundaresan', 'avinashninawe', 'aditya.apte3', 'khannamansi312', 'shivanisharaf15', 'akanksha0196', 'ayyappakonar', 'monish.nene', 'nileshkartik95', 'jainam49', 'purva.satpute', 'spooja.1430', 'ttanmay.telang75', 'shreya.mahajan', 'jakhererahul42', 'shrinathnair', 'mshirali23', 'mchakkalamuri', 'helmin50469', 'shwecchajain', 'ankita.rahate', 'srishti.shriyan96', 'tejask2610', 'stanabk', 'rohankhollamkar', 'joijodegauri7', 'roycefernandes80', 'dishakulkarni25', 'juhi.manglani']",8,"['dkbathe29', 'arshinavirani', 'shubhamsurya449', 'tanyabaptist05', 'ishaan.sathe', 'manisha.shetty07', None, 'shethyatri']",131,"['raheela', 'strikerfv68', 'dipmads', 'raku1109', 'jainamshah202', 'jogichetan96', 'sjunghareakshay', 'rajatkedia95', 'shethyatri', 'nrkhara', 'ajay.raghuwanshi', 'smallik', 'beelex1617', 'priyuk', 'pankajvyas967', 'shubham.gaikwad', 'ambani', 'mehtajinal3101', 'apoorvakraut', 'umeshdarade77', 'tanvi.rane1995', 'luanco1', 'jonathantripi', 'karan.dadlani', 'doshishrut1995', 'minalsawant1108', 'jcastrocalvo', 'jayeshkhandagle123', 'manisha.shetty07', 'nickcrane6117', 'email.harsh0811', 'poojamenon16.pm', 'rahul4peace', 'praveen99', 'bhoomee.sheth', 'anuragshyam1026', 'akshay1995', 'rashuidiot', 'arshinavirani', 'obalgi3095', 'kidongp', 'myuk83', 'tanvikalan', 'jayjadav08', 'neelam.chaudhari27', 'sahil8rai', 'harshilmehta1995', 'varadmeradost', 'komal31p', 'anand_5', 'poojashetty', 'darshanadaund27', 'sam234bryant', 'mosfet7777', 'bhumivora1995', 'ee12d018', 'ishaan.sathe', 'vivek.sakinala', 'jaidevdalvi', 'jenna', 'monish.kapadia', 'cnconnery', 'ishita.choudhary', 'riddhis2411', 'danishdewani112795', 'nimisha.nimisha.agarwal', 'rsawant2895', 'vivek12195', 'msumit95', 'manavtrivedi03', 'shubhamsurya449', 'tanyabaptist05', 'arunnambiar66', 'evanmartin', 'patil.rushal825', 'maithili010', 'akshaybangera95', 'suthar.kalpesh57', 'mukul.kulkarni', 'smithnano15', 'soorajdinesan27', 'harshit0610', 'ckargutkar96', 'trishapatkar19', 'alisha.alice.panicker', 'zeuswinchester456', 'amrsha.srivastava', 'siddhesh401', 'sanika.dongre', 'apurva.patil', 'priyankapandya19', 'nivipetkar', 'walden95', 'shriya.sharma', 'shukla.pawan249', 'dhruv.gajaria95', 'sarveshgrao', 'kanchan.sawant17', 'parthiv.parikh', 'dkbathe29', 'apoorvasundaresan', 'avinashninawe', 'aditya.apte3', 'khannamansi312', 'shivanisharaf15', 'akanksha0196', 'ayyappakonar', 'monish.nene', 'nileshkartik95', 'jainam49', 'purva.satpute', 'spooja.1430', 'ttanmay.telang75', 'shreya.mahajan', 'jakhererahul42', None, 'shrinathnair', 'mshirali23', 'amey.m.mangutkar', 'mchakkalamuri', 'helmin50469', 'shwecchajain', 'ankita.rahate', 'srishti.shriyan96', 'tejask2610', 'stanabk', 'rohankhollamkar', 'joijodegauri7', 'roycefernandes80', 'dishakulkarni25', 'juhi.manglani']"
4,57,124,9,2,"['riddhis2411', 'roycefernandes80']",121,"['raheela', 'strikerfv68', 'dipmads', 'raku1109', 'jainamshah202', 'jogichetan96', 'sjunghareakshay', 'rajatkedia95', 'nrkhara', 'ajay.raghuwanshi', 'smallik', 'beelex1617', 'priyuk', 'pankajvyas967', 'shubham.gaikwad', 'ambani', 'mehtajinal3101', 'apoorvakraut', 'umeshdarade77', 'tanvi.rane1995', 'luanco1', 'jonathantripi', 'karan.dadlani', 'doshishrut1995', 'minalsawant1108', 'jcastrocalvo', 'jayeshkhandagle123', 'nickcrane6117', 'email.harsh0811', 'poojamenon16.pm', 'rahul4peace', 'praveen99', 'bhoomee.sheth', 'anuragshyam1026', 'akshay1995', 'rashuidiot', 'obalgi3095', 'kidongp', 'myuk83', 'tanvikalan', 'jayjadav08', 'neelam.chaudhari27', 'sahil8rai', 'harshilmehta1995', 'varadmeradost', 'komal31p', 'anand_5', 'poojashetty', 'darshanadaund27', 'sam234bryant', 'mosfet7777', 'bhumivora1995', 'ee12d018', 'vivek.sakinala', 'jaidevdalvi', 'jenna', 'monish.kapadia', 'cnconnery', 'ishita.choudhary', 'danishdewani112795', 'nimisha.nimisha.agarwal', 'rsawant2895', 'vivek12195', 'msumit95', 'manavtrivedi03', 'arunnambiar66', 'evanmartin', 'patil.rushal825', 'maithili010', 'akshaybangera95', 'suthar.kalpesh57', 'mukul.kulkarni', 'smithnano15', 'soorajdinesan27', 'harshit0610', 'ckargutkar96', 'trishapatkar19', 'alisha.alice.panicker', 'zeuswinchester456', 'amrsha.srivastava', 'siddhesh401', 'sanika.dongre', 'apurva.patil', 'priyankapandya19', 'nivipetkar', 'walden95', 'shriya.sharma', 'shukla.pawan249', 'dhruv.gajaria95', 'sarveshgrao', 'kanchan.sawant17', 'parthiv.parikh', 'apoorvasundaresan', 'avinashninawe', 'aditya.apte3', 'khannamansi312', 'shivanisharaf15', 'akanksha0196', 'ayyappakonar', 'monish.nene', 'nileshkartik95', 'jainam49', 'purva.satpute', 'spooja.1430', 'ttanmay.telang75', 'shreya.mahajan', 'jakhererahul42', 'shrinathnair', 'mshirali23', 'amey.m.mangutkar', 'mchakkalamuri', 'helmin50469', 'shwecchajain', 'ankita.rahate', 'srishti.shriyan96', 'tejask2610', 'stanabk', 'rohankhollamkar', 'joijodegauri7', 'dishakulkarni25', 'juhi.manglani']",7,"['mananshah30137', 'jaysawant2', 'yashdani90', 'varunswadia', None, 'auraproductions786', '1jyotsna1']",130,"['raheela', 'strikerfv68', 'dipmads', 'raku1109', 'jainamshah202', 'jogichetan96', 'sjunghareakshay', 'rajatkedia95', 'mananshah30137', 'varunswadia', 'nrkhara', 'ajay.raghuwanshi', 'smallik', 'beelex1617', 'priyuk', 'pankajvyas967', 'shubham.gaikwad', 'ambani', 'mehtajinal3101', 'apoorvakraut', 'umeshdarade77', 'tanvi.rane1995', 'luanco1', 'jonathantripi', 'karan.dadlani', 'doshishrut1995', 'minalsawant1108', 'jcastrocalvo', 'jayeshkhandagle123', 'nickcrane6117', 'email.harsh0811', 'poojamenon16.pm', 'rahul4peace', 'praveen99', 'bhoomee.sheth', 'anuragshyam1026', 'akshay1995', 'rashuidiot', 'obalgi3095', 'kidongp', 'myuk83', 'tanvikalan', 'jayjadav08', 'neelam.chaudhari27', 'sahil8rai', 'harshilmehta1995', 'varadmeradost', 'komal31p', 'anand_5', 'poojashetty', 'darshanadaund27', 'jaysawant2', 'sam234bryant', 'mosfet7777', 'bhumivora1995', 'ee12d018', 'vivek.sakinala', 'jaidevdalvi', 'jenna', 'monish.kapadia', 'cnconnery', 'ishita.choudhary', 'riddhis2411', 'danishdewani112795', 'nimisha.nimisha.agarwal', 'rsawant2895', 'vivek12195', 'msumit95', 'manavtrivedi03', 'arunnambiar66', 'evanmartin', 'patil.rushal825', 'maithili010', 'akshaybangera95', 'suthar.kalpesh57', 'mukul.kulkarni', 'smithnano15', 'soorajdinesan27', 'harshit0610', 'ckargutkar96', 'trishapatkar19', 'alisha.alice.panicker', 'zeuswinchester456', 'amrsha.srivastava', 'siddhesh401', 'sanika.dongre', 'apurva.patil', 'priyankapandya19', 'nivipetkar', 'walden95', 'shriya.sharma', 'yashdani90', 'shukla.pawan249', 'dhruv.gajaria95', 'auraproductions786', 'sarveshgrao', '1jyotsna1', 'kanchan.sawant17', 'parthiv.parikh', 'apoorvasundaresan', 'avinashninawe', 'aditya.apte3', 'khannamansi312', 'shivanisharaf15', 'akanksha0196', 'ayyappakonar', 'monish.nene', 'nileshkartik95', 'jainam49', 'purva.satpute', 'spooja.1430', 'ttanmay.telang75', 'shreya.mahajan', 'jakhererahul42', None, 'shrinathnair', 'mshirali23', 'amey.m.mangutkar', 'mchakkalamuri', 'helmin50469', 'shwecchajain', 'ankita.rahate', 'srishti.shriyan96', 'tejask2610', 'stanabk', 'rohankhollamkar', 'joijodegauri7', 'roycefernandes80', 'dishakulkarni25', 'juhi.manglani']"
4,61,124,8,3,"['jenna', 'riddhis2411', 'smithnano15']",120,"['raheela', 'strikerfv68', 'dipmads', 'raku1109', 'jainamshah202', 'jogichetan96', 'sjunghareakshay', 'rajatkedia95', 'nrkhara', 'ajay.raghuwanshi', 'smallik', 'beelex1617', 'priyuk', 'pankajvyas967', 'shubham.gaikwad', 'ambani', 'mehtajinal3101', 'apoorvakraut', 'umeshdarade77', 'tanvi.rane1995', 'luanco1', 'jonathantripi', 'karan.dadlani', 'doshishrut1995', 'minalsawant1108', 'jcastrocalvo', 'jayeshkhandagle123', 'nickcrane6117', 'email.harsh0811', 'poojamenon16.pm', 'rahul4peace', 'praveen99', 'bhoomee.sheth', 'anuragshyam1026', 'akshay1995', 'rashuidiot', 'obalgi3095', 'kidongp', 'myuk83', 'tanvikalan', 'jayjadav08', 'neelam.chaudhari27', 'sahil8rai', 'harshilmehta1995', 'varadmeradost', 'komal31p', 'anand_5', 'poojashetty', 'darshanadaund27', 'sam234bryant', 'mosfet7777', 'bhumivora1995', 'ee12d018', 'vivek.sakinala', 'jaidevdalvi', 'monish.kapadia', 'cnconnery', 'ishita.choudhary', 'danishdewani112795', 'nimisha.nimisha.agarwal', 'rsawant2895', 'vivek12195', 'msumit95', 'manavtrivedi03', 'arunnambiar66', 'evanmartin', 'patil.rushal825', 'maithili010', 'akshaybangera95', 'suthar.kalpesh57', 'mukul.kulkarni', 'soorajdinesan27', 'harshit0610', 'ckargutkar96', 'trishapatkar19', 'alisha.alice.panicker', 'zeuswinchester456', 'amrsha.srivastava', 'siddhesh401', 'sanika.dongre', 'apurva.patil', 'priyankapandya19', 'nivipetkar', 'walden95', 'shriya.sharma', 'shukla.pawan249', 'dhruv.gajaria95', 'sarveshgrao', 'kanchan.sawant17', 'parthiv.parikh', 'apoorvasundaresan', 'avinashninawe', 'aditya.apte3', 'khannamansi312', 'shivanisharaf15', 'akanksha0196', 'ayyappakonar', 'monish.nene', 'nileshkartik95', 'jainam49', 'purva.satpute', 'spooja.1430', 'ttanmay.telang75', 'shreya.mahajan', 'jakhererahul42', 'shrinathnair', 'mshirali23', 'amey.m.mangutkar', 'mchakkalamuri', 'helmin50469', 'shwecchajain', 'ankita.rahate', 'srishti.shriyan96', 'tejask2610', 'stanabk', 'rohankhollamkar', 'joijodegauri7', 'roycefernandes80', 'dishakulkarni25', 'juhi.manglani']",5,"['varun1997', 'yashdani96', 'shriya.h.joshi', None, 'singhshashank97']",128,"['raheela', 'strikerfv68', 'dipmads', 'raku1109', 'jainamshah202', 'jogichetan96', 'sjunghareakshay', 'rajatkedia95', 'nrkhara', 'ajay.raghuwanshi', 'smallik', 'beelex1617', 'priyuk', 'pankajvyas967', 'shubham.gaikwad', 'ambani', 'mehtajinal3101', 'apoorvakraut', 'umeshdarade77', 'tanvi.rane1995', 'luanco1', 'jonathantripi', 'karan.dadlani', 'doshishrut1995', 'minalsawant1108', 'jcastrocalvo', 'jayeshkhandagle123', 'nickcrane6117', 'email.harsh0811', 'poojamenon16.pm', 'rahul4peace', 'praveen99', 'bhoomee.sheth', 'anuragshyam1026', 'akshay1995', 'rashuidiot', 'obalgi3095', 'kidongp', 'yashdani96', 'myuk83', 'tanvikalan', 'jayjadav08', 'neelam.chaudhari27', 'varun1997', 'sahil8rai', 'harshilmehta1995', 'varadmeradost', 'komal31p', 'anand_5', 'poojashetty', 'darshanadaund27', 'sam234bryant', 'mosfet7777', 'bhumivora1995', 'ee12d018', 'vivek.sakinala', 'jaidevdalvi', 'jenna', 'monish.kapadia', 'cnconnery', 'ishita.choudhary', 'riddhis2411', 'danishdewani112795', 'nimisha.nimisha.agarwal', 'singhshashank97', 'rsawant2895', 'vivek12195', 'msumit95', 'manavtrivedi03', 'arunnambiar66', 'evanmartin', 'patil.rushal825', 'maithili010', 'akshaybangera95', 'suthar.kalpesh57', 'mukul.kulkarni', 'shriya.h.joshi', 'smithnano15', 'soorajdinesan27', 'harshit0610', 'ckargutkar96', 'trishapatkar19', 'alisha.alice.panicker', 'zeuswinchester456', 'amrsha.srivastava', 'siddhesh401', 'sanika.dongre', 'apurva.patil', 'priyankapandya19', 'nivipetkar', 'walden95', 'shriya.sharma', 'shukla.pawan249', 'dhruv.gajaria95', 'sarveshgrao', 'kanchan.sawant17', 'parthiv.parikh', 'apoorvasundaresan', 'avinashninawe', 'aditya.apte3', 'khannamansi312', 'shivanisharaf15', 'akanksha0196', 'ayyappakonar', 'monish.nene', 'nileshkartik95', 'jainam49', 'purva.satpute', 'spooja.1430', 'ttanmay.telang75', 'shreya.mahajan', 'jakhererahul42', None, 'shrinathnair', 'mshirali23', 'amey.m.mangutkar', 'mchakkalamuri', 'helmin50469', 'shwecchajain', 'ankita.rahate', 'srishti.shriyan96', 'tejask2610', 'stanabk', 'rohankhollamkar', 'joijodegauri7', 'roycefernandes80', 'dishakulkarni25', 'juhi.manglani']"
4,55,124,7,1,['shukla.pawan249'],122,"['raheela', 'strikerfv68', 'dipmads', 'raku1109', 'jainamshah202', 'jogichetan96', 'sjunghareakshay', 'rajatkedia95', 'nrkhara', 'ajay.raghuwanshi', 'smallik', 'beelex1617', 'priyuk', 'pankajvyas967', 'shubham.gaikwad', 'ambani', 'mehtajinal3101', 'apoorvakraut', 'umeshdarade77', 'tanvi.rane1995', 'luanco1', 'jonathantripi', 'karan.dadlani', 'doshishrut1995', 'minalsawant1108', 'jcastrocalvo', 'jayeshkhandagle123', 'nickcrane6117', 'email.harsh0811', 'poojamenon16.pm', 'rahul4peace', 'praveen99', 'bhoomee.sheth', 'anuragshyam1026', 'akshay1995', 'rashuidiot', 'obalgi3095', 'kidongp', 'myuk83', 'tanvikalan', 'jayjadav08', 'neelam.chaudhari27', 'sahil8rai', 'harshilmehta1995', 'varadmeradost', 'komal31p', 'anand_5', 'poojashetty', 'darshanadaund27', 'sam234bryant', 'mosfet7777', 'bhumivora1995', 'ee12d018', 'vivek.sakinala', 'jaidevdalvi', 'jenna', 'monish.kapadia', 'cnconnery', 'ishita.choudhary', 'riddhis2411', 'danishdewani112795', 'nimisha.nimisha.agarwal', 'rsawant2895', 'vivek12195', 'msumit95', 'manavtrivedi03', 'arunnambiar66', 'evanmartin', 'patil.rushal825', 'maithili010', 'akshaybangera95', 'suthar.kalpesh57', 'mukul.kulkarni', 'smithnano15', 'soorajdinesan27', 'harshit0610', 'ckargutkar96', 'trishapatkar19', 'alisha.alice.panicker', 'zeuswinchester456', 'amrsha.srivastava', 'siddhesh401', 'sanika.dongre', 'apurva.patil', 'priyankapandya19', 'nivipetkar', 'walden95', 'shriya.sharma', 'dhruv.gajaria95', 'sarveshgrao', 'kanchan.sawant17', 'parthiv.parikh', 'apoorvasundaresan', 'avinashninawe', 'aditya.apte3', 'khannamansi312', 'shivanisharaf15', 'akanksha0196', 'ayyappakonar', 'monish.nene', 'nileshkartik95', 'jainam49', 'purva.satpute', 'spooja.1430', 'ttanmay.telang75', 'shreya.mahajan', 'jakhererahul42', 'shrinathnair', 'mshirali23', 'amey.m.mangutkar', 'mchakkalamuri', 'helmin50469', 'shwecchajain', 'ankita.rahate', 'srishti.shriyan96', 'tejask2610', 'stanabk', 'rohankhollamkar', 'joijodegauri7', 'roycefernandes80', 'dishakulkarni25', 'juhi.manglani']",6,"['mervyn.fernandes', 'ishaan.sathe', 'tejashree.gore', None, 'somil910', 'pyami95']",129,"['raheela', 'strikerfv68', 'dipmads', 'raku1109', 'jainamshah202', 'jogichetan96', 'sjunghareakshay', 'rajatkedia95', 'nrkhara', 'ajay.raghuwanshi', 'smallik', 'beelex1617', 'priyuk', 'pankajvyas967', 'shubham.gaikwad', 'ambani', 'mehtajinal3101', 'apoorvakraut', 'umeshdarade77', 'tanvi.rane1995', 'luanco1', 'jonathantripi', 'karan.dadlani', 'doshishrut1995', 'minalsawant1108', 'jcastrocalvo', 'jayeshkhandagle123', 'nickcrane6117', 'email.harsh0811', 'poojamenon16.pm', 'pyami95', 'rahul4peace', 'praveen99', 'bhoomee.sheth', 'anuragshyam1026', 'akshay1995', 'rashuidiot', 'obalgi3095', 'kidongp', 'myuk83', 'tanvikalan', 'jayjadav08', 'neelam.chaudhari27', 'sahil8rai', 'harshilmehta1995', 'varadmeradost', 'komal31p', 'anand_5', 'poojashetty', 'darshanadaund27', 'sam234bryant', 'mosfet7777', 'bhumivora1995', 'ee12d018', 'ishaan.sathe', 'vivek.sakinala', 'jaidevdalvi', 'jenna', 'monish.kapadia', 'somil910', 'cnconnery', 'ishita.choudhary', 'riddhis2411', 'danishdewani112795', 'nimisha.nimisha.agarwal', 'rsawant2895', 'vivek12195', 'msumit95', 'manavtrivedi03', 'mervyn.fernandes', 'arunnambiar66', 'evanmartin', 'patil.rushal825', 'maithili010', 'akshaybangera95', 'suthar.kalpesh57', 'mukul.kulkarni', 'smithnano15', 'soorajdinesan27', 'harshit0610', 'ckargutkar96', 'trishapatkar19', 'alisha.alice.panicker', 'zeuswinchester456', 'amrsha.srivastava', 'siddhesh401', 'sanika.dongre', 'apurva.patil', 'priyankapandya19', 'nivipetkar', 'walden95', 'shriya.sharma', 'shukla.pawan249', 'dhruv.gajaria95', 'sarveshgrao', 'kanchan.sawant17', 'parthiv.parikh', 'apoorvasundaresan', 'avinashninawe', 'aditya.apte3', 'khannamansi312', 'shivanisharaf15', 'akanksha0196', 'ayyappakonar', 'monish.nene', 'nileshkartik95', 'jainam49', 'purva.satpute', 'spooja.1430', 'ttanmay.telang75', 'shreya.mahajan', 'jakhererahul42', None, 'shrinathnair', 'mshirali23', 'amey.m.mangutkar', 'mchakkalamuri', 'helmin50469', 'shwecchajain', 'ankita.rahate', 'srishti.shriyan96', 'tejask2610', 'tejashree.gore', 'stanabk', 'rohankhollamkar', 'joijodegauri7', 'roycefernandes80', 'dishakulkarni25', 'juhi.manglani']"
4,137,124,7,1,['raku1109'],122,"['raheela', 'strikerfv68', 'dipmads', 'jainamshah202', 'jogichetan96', 'sjunghareakshay', 'rajatkedia95', 'nrkhara', 'ajay.raghuwanshi', 'smallik', 'beelex1617', 'priyuk', 'pankajvyas967', 'shubham.gaikwad', 'ambani', 'mehtajinal3101', 'apoorvakraut', 'umeshdarade77', 'tanvi.rane1995', 'luanco1', 'jonathantripi', 'karan.dadlani', 'doshishrut1995', 'minalsawant1108', 'jcastrocalvo', 'jayeshkhandagle123', 'nickcrane6117', 'email.harsh0811', 'poojamenon16.pm', 'rahul4peace', 'praveen99', 'bhoomee.sheth', 'anuragshyam1026', 'akshay1995', 'rashuidiot', 'obalgi3095', 'kidongp', 'myuk83', 'tanvikalan', 'jayjadav08', 'neelam.chaudhari27', 'sahil8rai', 'harshilmehta1995', 'varadmeradost', 'komal31p', 'anand_5', 'poojashetty', 'darshanadaund27', 'sam234bryant', 'mosfet7777', 'bhumivora1995', 'ee12d018', 'vivek.sakinala', 'jaidevdalvi', 'jenna', 'monish.kapadia', 'cnconnery', 'ishita.choudhary', 'riddhis2411', 'danishdewani112795', 'nimisha.nimisha.agarwal', 'rsawant2895', 'vivek12195', 'msumit95', 'manavtrivedi03', 'arunnambiar66', 'evanmartin', 'patil.rushal825', 'maithili010', 'akshaybangera95', 'suthar.kalpesh57', 'mukul.kulkarni', 'smithnano15', 'soorajdinesan27', 'harshit0610', 'ckargutkar96', 'trishapatkar19', 'alisha.alice.panicker', 'zeuswinchester456', 'amrsha.srivastava', 'siddhesh401', 'sanika.dongre', 'apurva.patil', 'priyankapandya19', 'nivipetkar', 'walden95', 'shriya.sharma', 'shukla.pawan249', 'dhruv.gajaria95', 'sarveshgrao', 'kanchan.sawant17', 'parthiv.parikh', 'apoorvasundaresan', 'avinashninawe', 'aditya.apte3', 'khannamansi312', 'shivanisharaf15', 'akanksha0196', 'ayyappakonar', 'monish.nene', 'nileshkartik95', 'jainam49', 'purva.satpute', 'spooja.1430', 'ttanmay.telang75', 'shreya.mahajan', 'jakhererahul42', 'shrinathnair', 'mshirali23', 'amey.m.mangutkar', 'mchakkalamuri', 'helmin50469', 'shwecchajain', 'ankita.rahate', 'srishti.shriyan96', 'tejask2610', 'stanabk', 'rohankhollamkar', 'joijodegauri7', 'roycefernandes80', 'dishakulkarni25', 'juhi.manglani']",6,"['dkbathe29', 'arshinavirani', 'shubhamsurya449', 'shethyatri', None, 'minkscdl']",129,"['raheela', 'strikerfv68', 'dipmads', 'raku1109', 'jainamshah202', 'jogichetan96', 'sjunghareakshay', 'rajatkedia95', 'minkscdl', 'shethyatri', 'nrkhara', 'ajay.raghuwanshi', 'smallik', 'beelex1617', 'priyuk', 'pankajvyas967', 'shubham.gaikwad', 'ambani', 'mehtajinal3101', 'apoorvakraut', 'umeshdarade77', 'tanvi.rane1995', 'luanco1', 'jonathantripi', 'karan.dadlani', 'doshishrut1995', 'minalsawant1108', 'jcastrocalvo', 'jayeshkhandagle123', 'nickcrane6117', 'email.harsh0811', 'poojamenon16.pm', 'rahul4peace', 'praveen99', 'bhoomee.sheth', 'anuragshyam1026', 'akshay1995', 'rashuidiot', 'arshinavirani', 'obalgi3095', 'kidongp', 'myuk83', 'tanvikalan', 'jayjadav08', 'neelam.chaudhari27', 'sahil8rai', 'harshilmehta1995', 'varadmeradost', 'komal31p', 'anand_5', 'poojashetty', 'darshanadaund27', 'sam234bryant', 'mosfet7777', 'bhumivora1995', 'ee12d018', 'vivek.sakinala', 'jaidevdalvi', 'jenna', 'monish.kapadia', 'cnconnery', 'ishita.choudhary', 'riddhis2411', 'danishdewani112795', 'nimisha.nimisha.agarwal', 'rsawant2895', 'vivek12195', 'msumit95', 'manavtrivedi03', 'shubhamsurya449', 'arunnambiar66', 'evanmartin', 'patil.rushal825', 'maithili010', 'akshaybangera95', 'suthar.kalpesh57', 'mukul.kulkarni', 'smithnano15', 'soorajdinesan27', 'harshit0610', 'ckargutkar96', 'trishapatkar19', 'alisha.alice.panicker', 'zeuswinchester456', 'amrsha.srivastava', 'siddhesh401', 'sanika.dongre', 'apurva.patil', 'priyankapandya19', 'nivipetkar', 'walden95', 'shriya.sharma', 'shukla.pawan249', 'dhruv.gajaria95', 'sarveshgrao', 'kanchan.sawant17', 'parthiv.parikh', 'dkbathe29', 'apoorvasundaresan', 'avinashninawe', 'aditya.apte3', 'khannamansi312', 'shivanisharaf15', 'akanksha0196', 'ayyappakonar', 'monish.nene', 'nileshkartik95', 'jainam49', 'purva.satpute', 'spooja.1430', 'ttanmay.telang75', 'shreya.mahajan', 'jakhererahul42', None, 'shrinathnair', 'mshirali23', 'amey.m.mangutkar', 'mchakkalamuri', 'helmin50469', 'shwecchajain', 'ankita.rahate', 'srishti.shriyan96', 'tejask2610', 'stanabk', 'rohankhollamkar', 'joijodegauri7', 'roycefernandes80', 'dishakulkarni25', 'juhi.manglani']"
4,50,124,6,2,"['pankajvyas967', 'alisha.alice.panicker']",121,"['raheela', 'strikerfv68', 'dipmads', 'raku1109', 'jainamshah202', 'jogichetan96', 'sjunghareakshay', 'rajatkedia95', 'nrkhara', 'ajay.raghuwanshi', 'smallik', 'beelex1617', 'priyuk', 'shubham.gaikwad', 'ambani', 'mehtajinal3101', 'apoorvakraut', 'umeshdarade77', 'tanvi.rane1995', 'luanco1', 'jonathantripi', 'karan.dadlani', 'doshishrut1995', 'minalsawant1108', 'jcastrocalvo', 'jayeshkhandagle123', 'nickcrane6117', 'email.harsh0811', 'poojamenon16.pm', 'rahul4peace', 'praveen99', 'bhoomee.sheth', 'anuragshyam1026', 'akshay1995', 'rashuidiot', 'obalgi3095', 'kidongp', 'myuk83', 'tanvikalan', 'jayjadav08', 'neelam.chaudhari27', 'sahil8rai', 'harshilmehta1995', 'varadmeradost', 'komal31p', 'anand_5', 'poojashetty', 'darshanadaund27', 'sam234bryant', 'mosfet7777', 'bhumivora1995', 'ee12d018', 'vivek.sakinala', 'jaidevdalvi', 'jenna', 'monish.kapadia', 'cnconnery', 'ishita.choudhary', 'riddhis2411', 'danishdewani112795', 'nimisha.nimisha.agarwal', 'rsawant2895', 'vivek12195', 'msumit95', 'manavtrivedi03', 'arunnambiar66', 'evanmartin', 'patil.rushal825', 'maithili010', 'akshaybangera95', 'suthar.kalpesh57', 'mukul.kulkarni', 'smithnano15', 'soorajdinesan27', 'harshit0610', 'ckargutkar96', 'trishapatkar19', 'zeuswinchester456', 'amrsha.srivastava', 'siddhesh401', 'sanika.dongre', 'apurva.patil', 'priyankapandya19', 'nivipetkar', 'walden95', 'shriya.sharma', 'shukla.pawan249', 'dhruv.gajaria95', 'sarveshgrao', 'kanchan.sawant17', 'parthiv.parikh', 'apoorvasundaresan', 'avinashninawe', 'aditya.apte3', 'khannamansi312', 'shivanisharaf15', 'akanksha0196', 'ayyappakonar', 'monish.nene', 'nileshkartik95', 'jainam49', 'purva.satpute', 'spooja.1430', 'ttanmay.telang75', 'shreya.mahajan', 'jakhererahul42', 'shrinathnair', 'mshirali23', 'amey.m.mangutkar', 'mchakkalamuri', 'helmin50469', 'shwecchajain', 'ankita.rahate', 'srishti.shriyan96', 'tejask2610', 'stanabk', 'rohankhollamkar', 'joijodegauri7', 'roycefernandes80', 'dishakulkarni25', 'juhi.manglani']",4,"['tanyabaptist05', None, 'razorrajeev', 'kiranrelekar412']",127,"['raheela', 'strikerfv68', 'dipmads', 'raku1109', 'jainamshah202', 'jogichetan96', 'sjunghareakshay', 'rajatkedia95', 'razorrajeev', 'nrkhara', 'ajay.raghuwanshi', 'smallik', 'beelex1617', 'priyuk', 'pankajvyas967', 'shubham.gaikwad', 'ambani', 'mehtajinal3101', 'apoorvakraut', 'umeshdarade77', 'tanvi.rane1995', 'luanco1', 'jonathantripi', 'karan.dadlani', 'doshishrut1995', 'minalsawant1108', 'jcastrocalvo', 'jayeshkhandagle123', 'nickcrane6117', 'email.harsh0811', 'poojamenon16.pm', 'rahul4peace', 'praveen99', 'bhoomee.sheth', 'anuragshyam1026', 'akshay1995', 'rashuidiot', 'obalgi3095', 'kidongp', 'myuk83', 'tanvikalan', 'jayjadav08', 'neelam.chaudhari27', 'sahil8rai', 'harshilmehta1995', 'varadmeradost', 'komal31p', 'anand_5', 'poojashetty', 'darshanadaund27', 'sam234bryant', 'mosfet7777', 'bhumivora1995', 'ee12d018', 'vivek.sakinala', 'jaidevdalvi', 'jenna', 'monish.kapadia', 'cnconnery', 'ishita.choudhary', 'riddhis2411', 'danishdewani112795', 'nimisha.nimisha.agarwal', 'rsawant2895', 'vivek12195', 'msumit95', 'manavtrivedi03', 'tanyabaptist05', 'arunnambiar66', 'evanmartin', 'patil.rushal825', 'maithili010', 'akshaybangera95', 'suthar.kalpesh57', 'mukul.kulkarni', 'smithnano15', 'soorajdinesan27', 'harshit0610', 'ckargutkar96', 'trishapatkar19', 'alisha.alice.panicker', 'zeuswinchester456', 'amrsha.srivastava', 'siddhesh401', 'sanika.dongre', 'apurva.patil', 'priyankapandya19', 'nivipetkar', 'walden95', 'shriya.sharma', 'kiranrelekar412', 'shukla.pawan249', 'dhruv.gajaria95', 'sarveshgrao', 'kanchan.sawant17', 'parthiv.parikh', 'apoorvasundaresan', 'avinashninawe', 'aditya.apte3', 'khannamansi312', 'shivanisharaf15', 'akanksha0196', 'ayyappakonar', 'monish.nene', 'nileshkartik95', 'jainam49', 'purva.satpute', 'spooja.1430', 'ttanmay.telang75', 'shreya.mahajan', 'jakhererahul42', None, 'shrinathnair', 'mshirali23', 'amey.m.mangutkar', 'mchakkalamuri', 'helmin50469', 'shwecchajain', 'ankita.rahate', 'srishti.shriyan96', 'tejask2610', 'stanabk', 'rohankhollamkar', 'joijodegauri7', 'roycefernandes80', 'dishakulkarni25', 'juhi.manglani']"
4,54,124,6,1,['spooja.1430'],122,"['raheela', 'strikerfv68', 'dipmads', 'raku1109', 'jainamshah202', 'jogichetan96', 'sjunghareakshay', 'rajatkedia95', 'nrkhara', 'ajay.raghuwanshi', 'smallik', 'beelex1617', 'priyuk', 'pankajvyas967', 'shubham.gaikwad', 'ambani', 'mehtajinal3101', 'apoorvakraut', 'umeshdarade77', 'tanvi.rane1995', 'luanco1', 'jonathantripi', 'karan.dadlani', 'doshishrut1995', 'minalsawant1108', 'jcastrocalvo', 'jayeshkhandagle123', 'nickcrane6117', 'email.harsh0811', 'poojamenon16.pm', 'rahul4peace', 'praveen99', 'bhoomee.sheth', 'anuragshyam1026', 'akshay1995', 'rashuidiot', 'obalgi3095', 'kidongp', 'myuk83', 'tanvikalan', 'jayjadav08', 'neelam.chaudhari27', 'sahil8rai', 'harshilmehta1995', 'varadmeradost', 'komal31p', 'anand_5', 'poojashetty', 'darshanadaund27', 'sam234bryant', 'mosfet7777', 'bhumivora1995', 'ee12d018', 'vivek.sakinala', 'jaidevdalvi', 'jenna', 'monish.kapadia', 'cnconnery', 'ishita.choudhary', 'riddhis2411', 'danishdewani112795', 'nimisha.nimisha.agarwal', 'rsawant2895', 'vivek12195', 'msumit95', 'manavtrivedi03', 'arunnambiar66', 'evanmartin', 'patil.rushal825', 'maithili010', 'akshaybangera95', 'suthar.kalpesh57', 'mukul.kulkarni', 'smithnano15', 'soorajdinesan27', 'harshit0610', 'ckargutkar96', 'trishapatkar19', 'alisha.alice.panicker', 'zeuswinchester456', 'amrsha.srivastava', 'siddhesh401', 'sanika.dongre', 'apurva.patil', 'priyankapandya19', 'nivipetkar', 'walden95', 'shriya.sharma', 'shukla.pawan249', 'dhruv.gajaria95', 'sarveshgrao', 'kanchan.sawant17', 'parthiv.parikh', 'apoorvasundaresan', 'avinashninawe', 'aditya.apte3', 'khannamansi312', 'shivanisharaf15', 'akanksha0196', 'ayyappakonar', 'monish.nene', 'nileshkartik95', 'jainam49', 'purva.satpute', 'ttanmay.telang75', 'shreya.mahajan', 'jakhererahul42', 'shrinathnair', 'mshirali23', 'amey.m.mangutkar', 'mchakkalamuri', 'helmin50469', 'shwecchajain', 'ankita.rahate', 'srishti.shriyan96', 'tejask2610', 'stanabk', 'rohankhollamkar', 'joijodegauri7', 'roycefernandes80', 'dishakulkarni25', 'juhi.manglani']",5,"['nijamkureshi2894', 'suryatejachitturi', 'aparnaahari95', 'abarge31', None]",128,"['raheela', 'strikerfv68', 'dipmads', 'raku1109', 'jainamshah202', 'jogichetan96', 'sjunghareakshay', 'rajatkedia95', 'nrkhara', 'ajay.raghuwanshi', 'smallik', 'beelex1617', 'priyuk', 'pankajvyas967', 'shubham.gaikwad', 'ambani', 'mehtajinal3101', 'apoorvakraut', 'umeshdarade77', 'tanvi.rane1995', 'luanco1', 'jonathantripi', 'karan.dadlani', 'doshishrut1995', 'minalsawant1108', 'jcastrocalvo', 'jayeshkhandagle123', 'nickcrane6117', 'email.harsh0811', 'abarge31', 'poojamenon16.pm', 'rahul4peace', 'praveen99', 'bhoomee.sheth', 'anuragshyam1026', 'akshay1995', 'rashuidiot', 'obalgi3095', 'kidongp', 'myuk83', 'tanvikalan', 'jayjadav08', 'neelam.chaudhari27', 'sahil8rai', 'harshilmehta1995', 'varadmeradost', 'komal31p', 'anand_5', 'poojashetty', 'darshanadaund27', 'sam234bryant', 'mosfet7777', 'bhumivora1995', 'ee12d018', 'vivek.sakinala', 'aparnaahari95', 'jaidevdalvi', 'jenna', 'monish.kapadia', 'cnconnery', 'ishita.choudhary', 'riddhis2411', 'danishdewani112795', 'nimisha.nimisha.agarwal', 'rsawant2895', 'vivek12195', 'msumit95', 'manavtrivedi03', 'arunnambiar66', 'evanmartin', 'patil.rushal825', 'maithili010', 'akshaybangera95', 'suthar.kalpesh57', 'mukul.kulkarni', 'smithnano15', 'soorajdinesan27', 'harshit0610', 'ckargutkar96', 'trishapatkar19', 'alisha.alice.panicker', 'zeuswinchester456', 'amrsha.srivastava', 'siddhesh401', 'sanika.dongre', 'apurva.patil', 'priyankapandya19', 'nivipetkar', 'walden95', 'shriya.sharma', 'shukla.pawan249', 'dhruv.gajaria95', 'sarveshgrao', 'kanchan.sawant17', 'nijamkureshi2894', 'parthiv.parikh', 'suryatejachitturi', 'apoorvasundaresan', 'avinashninawe', 'aditya.apte3', 'khannamansi312', 'shivanisharaf15', 'akanksha0196', 'ayyappakonar', 'monish.nene', 'nileshkartik95', 'jainam49', 'purva.satpute', 'spooja.1430', 'ttanmay.telang75', 'shreya.mahajan', 'jakhererahul42', None, 'shrinathnair', 'mshirali23', 'amey.m.mangutkar', 'mchakkalamuri', 'helmin50469', 'shwecchajain', 'ankita.rahate', 'srishti.shriyan96', 'tejask2610', 'stanabk', 'rohankhollamkar', 'joijodegauri7', 'roycefernandes80', 'dishakulkarni25', 'juhi.manglani']"
4,58,124,6,2,"['ckargutkar96', 'poojamenon16.pm']",121,"['raheela', 'strikerfv68', 'dipmads', 'raku1109', 'jainamshah202', 'jogichetan96', 'sjunghareakshay', 'rajatkedia95', 'nrkhara', 'ajay.raghuwanshi', 'smallik', 'beelex1617', 'priyuk', 'pankajvyas967', 'shubham.gaikwad', 'ambani', 'mehtajinal3101', 'apoorvakraut', 'umeshdarade77', 'tanvi.rane1995', 'luanco1', 'jonathantripi', 'karan.dadlani', 'doshishrut1995', 'minalsawant1108', 'jcastrocalvo', 'jayeshkhandagle123', 'nickcrane6117', 'email.harsh0811', 'rahul4peace', 'praveen99', 'bhoomee.sheth', 'anuragshyam1026', 'akshay1995', 'rashuidiot', 'obalgi3095', 'kidongp', 'myuk83', 'tanvikalan', 'jayjadav08', 'neelam.chaudhari27', 'sahil8rai', 'harshilmehta1995', 'varadmeradost', 'komal31p', 'anand_5', 'poojashetty', 'darshanadaund27', 'sam234bryant', 'mosfet7777', 'bhumivora1995', 'ee12d018', 'vivek.sakinala', 'jaidevdalvi', 'jenna', 'monish.kapadia', 'cnconnery', 'ishita.choudhary', 'riddhis2411', 'danishdewani112795', 'nimisha.nimisha.agarwal', 'rsawant2895', 'vivek12195', 'msumit95', 'manavtrivedi03', 'arunnambiar66', 'evanmartin', 'patil.rushal825', 'maithili010', 'akshaybangera95', 'suthar.kalpesh57', 'mukul.kulkarni', 'smithnano15', 'soorajdinesan27', 'harshit0610', 'trishapatkar19', 'alisha.alice.panicker', 'zeuswinchester456', 'amrsha.srivastava', 'siddhesh401', 'sanika.dongre', 'apurva.patil', 'priyankapandya19', 'nivipetkar', 'walden95', 'shriya.sharma', 'shukla.pawan249', 'dhruv.gajaria95', 'sarveshgrao', 'kanchan.sawant17', 'parthiv.parikh', 'apoorvasundaresan', 'avinashninawe', 'aditya.apte3', 'khannamansi312', 'shivanisharaf15', 'akanksha0196', 'ayyappakonar', 'monish.nene', 'nileshkartik95', 'jainam49', 'purva.satpute', 'spooja.1430', 'ttanmay.telang75', 'shreya.mahajan', 'jakhererahul42', 'shrinathnair', 'mshirali23', 'amey.m.mangutkar', 'mchakkalamuri', 'helmin50469', 'shwecchajain', 'ankita.rahate', 'srishti.shriyan96', 'tejask2610', 'stanabk', 'rohankhollamkar', 'joijodegauri7', 'roycefernandes80', 'dishakulkarni25', 'juhi.manglani']",4,"['smonica498', 'inderjitsingh87', None, 'sahilsg.1995']",127,"['raheela', 'strikerfv68', 'dipmads', 'raku1109', 'jainamshah202', 'jogichetan96', 'sjunghareakshay', 'rajatkedia95', 'nrkhara', 'ajay.raghuwanshi', 'smallik', 'beelex1617', 'priyuk', 'pankajvyas967', 'shubham.gaikwad', 'ambani', 'mehtajinal3101', 'apoorvakraut', 'umeshdarade77', 'tanvi.rane1995', 'luanco1', 'jonathantripi', 'karan.dadlani', 'doshishrut1995', 'inderjitsingh87', 'minalsawant1108', 'jcastrocalvo', 'jayeshkhandagle123', 'nickcrane6117', 'email.harsh0811', 'poojamenon16.pm', 'rahul4peace', 'praveen99', 'bhoomee.sheth', 'anuragshyam1026', 'akshay1995', 'rashuidiot', 'obalgi3095', 'kidongp', 'myuk83', 'tanvikalan', 'jayjadav08', 'neelam.chaudhari27', 'sahil8rai', 'smonica498', 'harshilmehta1995', 'varadmeradost', 'komal31p', 'anand_5', 'poojashetty', 'darshanadaund27', 'sam234bryant', 'mosfet7777', 'bhumivora1995', 'ee12d018', 'vivek.sakinala', 'jaidevdalvi', 'jenna', 'monish.kapadia', 'cnconnery', 'ishita.choudhary', 'riddhis2411', 'danishdewani112795', 'nimisha.nimisha.agarwal', 'rsawant2895', 'vivek12195', 'msumit95', 'manavtrivedi03', 'arunnambiar66', 'evanmartin', 'patil.rushal825', 'maithili010', 'akshaybangera95', 'suthar.kalpesh57', 'mukul.kulkarni', 'smithnano15', 'soorajdinesan27', 'harshit0610', 'ckargutkar96', 'trishapatkar19', 'alisha.alice.panicker', 'zeuswinchester456', 'amrsha.srivastava', 'siddhesh401', 'sanika.dongre', 'apurva.patil', 'priyankapandya19', 'sahilsg.1995', 'nivipetkar', 'walden95', 'shriya.sharma', 'shukla.pawan249', 'dhruv.gajaria95', 'sarveshgrao', 'kanchan.sawant17', 'parthiv.parikh', 'apoorvasundaresan', 'avinashninawe', 'aditya.apte3', 'khannamansi312', 'shivanisharaf15', 'akanksha0196', 'ayyappakonar', 'monish.nene', 'nileshkartik95', 'jainam49', 'purva.satpute', 'spooja.1430', 'ttanmay.telang75', 'shreya.mahajan', 'jakhererahul42', None, 'shrinathnair', 'mshirali23', 'amey.m.mangutkar', 'mchakkalamuri', 'helmin50469', 'shwecchajain', 'ankita.rahate', 'srishti.shriyan96', 'tejask2610', 'stanabk', 'rohankhollamkar', 'joijodegauri7', 'roycefernandes80', 'dishakulkarni25', 'juhi.manglani']"
4,184,124,6,1,['smithnano15'],122,"['raheela', 'strikerfv68', 'dipmads', 'raku1109', 'jainamshah202', 'jogichetan96', 'sjunghareakshay', 'rajatkedia95', 'nrkhara', 'ajay.raghuwanshi', 'smallik', 'beelex1617', 'priyuk', 'pankajvyas967', 'shubham.gaikwad', 'ambani', 'mehtajinal3101', 'apoorvakraut', 'umeshdarade77', 'tanvi.rane1995', 'luanco1', 'jonathantripi', 'karan.dadlani', 'doshishrut1995', 'minalsawant1108', 'jcastrocalvo', 'jayeshkhandagle123', 'nickcrane6117', 'email.harsh0811', 'poojamenon16.pm', 'rahul4peace', 'praveen99', 'bhoomee.sheth', 'anuragshyam1026', 'akshay1995', 'rashuidiot', 'obalgi3095', 'kidongp', 'myuk83', 'tanvikalan', 'jayjadav08', 'neelam.chaudhari27', 'sahil8rai', 'harshilmehta1995', 'varadmeradost', 'komal31p', 'anand_5', 'poojashetty', 'darshanadaund27', 'sam234bryant', 'mosfet7777', 'bhumivora1995', 'ee12d018', 'vivek.sakinala', 'jaidevdalvi', 'jenna', 'monish.kapadia', 'cnconnery', 'ishita.choudhary', 'riddhis2411', 'danishdewani112795', 'nimisha.nimisha.agarwal', 'rsawant2895', 'vivek12195', 'msumit95', 'manavtrivedi03', 'arunnambiar66', 'evanmartin', 'patil.rushal825', 'maithili010', 'akshaybangera95', 'suthar.kalpesh57', 'mukul.kulkarni', 'soorajdinesan27', 'harshit0610', 'ckargutkar96', 'trishapatkar19', 'alisha.alice.panicker', 'zeuswinchester456', 'amrsha.srivastava', 'siddhesh401', 'sanika.dongre', 'apurva.patil', 'priyankapandya19', 'nivipetkar', 'walden95', 'shriya.sharma', 'shukla.pawan249', 'dhruv.gajaria95', 'sarveshgrao', 'kanchan.sawant17', 'parthiv.parikh', 'apoorvasundaresan', 'avinashninawe', 'aditya.apte3', 'khannamansi312', 'shivanisharaf15', 'akanksha0196', 'ayyappakonar', 'monish.nene', 'nileshkartik95', 'jainam49', 'purva.satpute', 'spooja.1430', 'ttanmay.telang75', 'shreya.mahajan', 'jakhererahul42', 'shrinathnair', 'mshirali23', 'amey.m.mangutkar', 'mchakkalamuri', 'helmin50469', 'shwecchajain', 'ankita.rahate', 'srishti.shriyan96', 'tejask2610', 'stanabk', 'rohankhollamkar', 'joijodegauri7', 'roycefernandes80', 'dishakulkarni25', 'juhi.manglani']",5,"['anikaghone', 'durgeshtodankar97', 'kadamprajakta', None, 'rupaliozare']",128,"['raheela', 'strikerfv68', 'dipmads', 'raku1109', 'jainamshah202', 'jogichetan96', 'sjunghareakshay', 'rajatkedia95', 'nrkhara', 'rupaliozare', 'ajay.raghuwanshi', 'smallik', 'beelex1617', 'priyuk', 'pankajvyas967', 'shubham.gaikwad', 'ambani', 'mehtajinal3101', 'apoorvakraut', 'umeshdarade77', 'tanvi.rane1995', 'luanco1', 'jonathantripi', 'karan.dadlani', 'doshishrut1995', 'minalsawant1108', 'jcastrocalvo', 'jayeshkhandagle123', 'nickcrane6117', 'email.harsh0811', 'poojamenon16.pm', 'rahul4peace', 'praveen99', 'bhoomee.sheth', 'anuragshyam1026', 'akshay1995', 'rashuidiot', 'obalgi3095', 'kidongp', 'myuk83', 'tanvikalan', 'jayjadav08', 'neelam.chaudhari27', 'sahil8rai', 'harshilmehta1995', 'varadmeradost', 'komal31p', 'anand_5', 'poojashetty', 'darshanadaund27', 'sam234bryant', 'mosfet7777', 'bhumivora1995', 'ee12d018', 'vivek.sakinala', 'durgeshtodankar97', 'jaidevdalvi', 'jenna', 'monish.kapadia', 'cnconnery', 'ishita.choudhary', 'riddhis2411', 'danishdewani112795', 'nimisha.nimisha.agarwal', 'rsawant2895', 'vivek12195', 'msumit95', 'manavtrivedi03', 'arunnambiar66', 'evanmartin', 'patil.rushal825', 'maithili010', 'akshaybangera95', 'suthar.kalpesh57', 'mukul.kulkarni', 'smithnano15', 'soorajdinesan27', 'harshit0610', 'ckargutkar96', 'trishapatkar19', 'alisha.alice.panicker', 'zeuswinchester456', 'amrsha.srivastava', 'siddhesh401', 'sanika.dongre', 'apurva.patil', 'priyankapandya19', 'nivipetkar', 'walden95', 'shriya.sharma', 'shukla.pawan249', 'dhruv.gajaria95', 'sarveshgrao', 'kanchan.sawant17', 'parthiv.parikh', 'apoorvasundaresan', 'avinashninawe', 'aditya.apte3', 'khannamansi312', 'shivanisharaf15', 'akanksha0196', 'ayyappakonar', 'monish.nene', 'nileshkartik95', 'jainam49', 'purva.satpute', 'spooja.1430', 'ttanmay.telang75', 'shreya.mahajan', 'jakhererahul42', 'kadamprajakta', None, 'shrinathnair', 'mshirali23', 'amey.m.mangutkar', 'mchakkalamuri', 'helmin50469', 'shwecchajain', 'ankita.rahate', 'srishti.shriyan96', 'tejask2610', 'anikaghone', 'stanabk', 'rohankhollamkar', 'joijodegauri7', 'roycefernandes80', 'dishakulkarni25', 'juhi.manglani']"
5,97,85,60,4,"['ztledfor', 'hcboaz', 'mmalsaft123', 'ajlountz']",80,"['stevecampbell', 'mjlowin', 'diego930302', 'malhotr0', 'indrajakn205', 'xu514', 'srinath2951', 'sajidniaz300', 'nhdan1501', 'mount18', 'liang142', 'estebandido3512', 'myh', 'sebastian.valero', 'felipe_97', 'wannafight', 'tsentz95', 'arash2342', 'mtobtn', 'adityap', 'devilal65', 'jbcolema', 'okhandel', 'wuil69', 'karajp', 'tinny93s', 'shanthan25', 'pengsherry119', 'hamel7', 'juandaaa3', 'preshmas', 'sogalss', 'jprokop77', 'ma287', 'elkiinriiascos', 'llop2821', 'shruti1412', 'slowriver322', 'titus.sandu', 'samlocke37', 'yzou0426', 'ddmckay', 'wdhv3', 'pawara', 'jtulcan29', 'fanel312', 'rueschhl', 'huozhongyu', 'camilo192000', 'todd.krauss.tk', 'oscarandresdc', 'sharma.amrit93', 'ca.criollo99', 'lin411977008', 'son13', 'samina.amanullah', 'manabolu', 'sunxiantian123', 'yilmarbenavides1', 'mateobotina96', 'tedy06', 'cho182', 'iivanvallejo', 'dgaines2', 'robertdieme', 'zhan1671', 'david.0108', 'yilver0894', 'madana', 'maria12', 'huboxgo', 'sridhar4', 'gosman', 'carlitos962013', 'ppxxyy1109', 'colegiannotti', 'huntdj', 'duvanbenavides2', 's22johanmolinar', 'jhonsteven1397']",56,"['amcorbe2', 'djblivin', 'emalhajj', 'ajrigby', 'cthudso3', 'ajcoon', 'obartman', 'agshin', 'brennerncsuedu', 'wkharri3', 'taleona3', 'gwcrego', 'abharga5', 'tnpardue', 'schlenker', 'mfschaef', 'mdbrewis', 'mkmoody', 'sjfigurs', 'gredden', 'kjcody', 'alisadeq', 'zlholme2', 'hsoewar', 'tsavey', 'jlbrodie', 'abmcginn', 'atberg', 'hahsain', 'zgdavis', 'kjkronk', 'ajsquire', 'syan4', 'npschult', 'cecipria', 'matthewrowley', 'rjnagley', 'saba96', 'nrhawes12', 'tbhubble', 'alcostin', 'khalil2316', 'jagibson', 'vrkumar', 'edhill3', 'jwfrenc2', 'mmalsaft', None, 'ahochstetler711', 'seklug', 'faisa1k', 'jnchestnut4943', 'ajmillir', 'emmills', 'jrmcgarr', 'yzhang59']",140,"['stevecampbell', 'djblivin', 'emalhajj', 'ajrigby', 'llop2821', 'ajcoon', 'ztledfor', 'mjlowin', 'shruti1412', 'brennerncsuedu', 'wkharri3', 'slowriver322', 'titus.sandu', 'taleona3', 'samlocke37', 'yzou0426', 'gwcrego', 'diego930302', 'tnpardue', 'mfschaef', 'ddmckay', 'mdbrewis', 'wdhv3', 'malhotr0', 'indrajakn205', 'hcboaz', 'pawara', 'jtulcan29', 'gredden', 'kjcody', 'xu514', 'alisadeq', 'srinath2951', 'tsavey', 'abmcginn', 'sajidniaz300', 'hahsain', 'kjkronk', 'fanel312', 'rueschhl', 'syan4', 'npschult', 'cecipria', 'nrhawes12', 'tbhubble', 'nhdan1501', 'jagibson', 'huozhongyu', 'camilo192000', 'jwfrenc2', 'mount18', 'ahochstetler711', 'seklug', 'liang142', 'todd.krauss.tk', 'faisa1k', 'jnchestnut4943', 'estebandido3512', 'myh', 'oscarandresdc', 'emmills', 'sharma.amrit93', 'jrmcgarr', 'ca.criollo99', 'sebastian.valero', 'amcorbe2', 'felipe_97', 'lin411977008', 'wannafight', 'son13', 'samina.amanullah', 'cthudso3', 'manabolu', 'sunxiantian123', 'tsentz95', 'yilmarbenavides1', 'obartman', 'agshin', 'arash2342', 'mtobtn', 'abharga5', 'adityap', 'mateobotina96', 'tedy06', 'devilal65', 'schlenker', 'cho182', 'mkmoody', 'sjfigurs', 'iivanvallejo', 'mmalsaft123', 'dgaines2', 'jbcolema', 'zlholme2', 'hsoewar', 'ajlountz', 'okhandel', 'jlbrodie', 'robertdieme', 'zgdavis', 'atberg', 'zhan1671', 'david.0108', 'ajsquire', 'wuil69', 'yilver0894', 'madana', 'matthewrowley', 'karajp', 'maria12', 'huboxgo', 'tinny93s', 'sridhar4', 'rjnagley', 'saba96', 'shanthan25', 'pengsherry119', 'hamel7', 'juandaaa3', 'alcostin', 'khalil2316', 'vrkumar', 'preshmas', 'edhill3', 'gosman', 'mmalsaft', None, 'sogalss', 'jprokop77', 'carlitos962013', 'ppxxyy1109', 'ma287', 'colegiannotti', 'ajmillir', 'elkiinriiascos', 'huntdj', 'duvanbenavides2', 's22johanmolinar', 'jhonsteven1397', 'yzhang59']"
5,96,85,56,19,"['son13', 'sunxiantian123', 'tsentz95', 'arash2342', 'samlocke37', 'adityap', 'malhotr0', 'pawara', 'jbcolema', 'okhandel', 'madana', 'sridhar4', 'tinny93s', 'pengsherry119', 'gosman', 'mount18', 'ppxxyy1109', 'colegiannotti', 'ma287']",65,"['stevecampbell', 'felipe_97', 'lin411977008', 'wannafight', 'samina.amanullah', 'llop2821', 'ztledfor', 'manabolu', 'yilmarbenavides1', 'mjlowin', 'shruti1412', 'slowriver322', 'titus.sandu', 'mtobtn', 'yzou0426', 'mateobotina96', 'diego930302', 'tedy06', 'devilal65', 'ddmckay', 'cho182', 'wdhv3', 'indrajakn205', 'hcboaz', 'iivanvallejo', 'jtulcan29', 'mmalsaft123', 'dgaines2', 'xu514', 'srinath2951', 'ajlountz', 'sajidniaz300', 'robertdieme', 'jhonsteven1397', 'zhan1671', 'fanel312', 'david.0108', 'rueschhl', 'wuil69', 'yilver0894', 'karajp', 'maria12', 'huboxgo', 'shanthan25', 'nhdan1501', 'hamel7', 'juandaaa3', 'preshmas', 'huozhongyu', 'camilo192000', 'sogalss', 'jprokop77', 'carlitos962013', 'liang142', 'todd.krauss.tk', 'estebandido3512', 'elkiinriiascos', 'myh', 'oscarandresdc', 'huntdj', 'duvanbenavides2', 's22johanmolinar', 'sharma.amrit93', 'ca.criollo99', 'sebastian.valero']",37,"['huang502', 'upton0', 'ukamran', 'sentz', 'pgilliat', 'apadget', 'lletner', 'bshilson', 'vwerner', 'goldmandrummer', 'lawrence.lee2222', 'zhan1820', 'tpathak', 'fishe128', 'yang764', 'bcarterwhs13', 'blissm95', 'munjuncho182', 'amassat', 'mhagag', 'maxbrown112', 'zhu340', 'gdykes', 'ajbruns2160', 'bermel', 'servinb', 'dhoch', 'ebartusi', 'smit2257', None, 'mferoz', 'schowdhury', 'jyshi', 'qzmdtc1993', 'cho133', 'corbeta', 'roy48']",121,"['stevecampbell', 'huang502', 'pgilliat', 'llop2821', 'apadget', 'ztledfor', 'mjlowin', 'shruti1412', 'vwerner', 'slowriver322', 'titus.sandu', 'lawrence.lee2222', 'samlocke37', 'yzou0426', 'tpathak', 'fishe128', 'diego930302', 'ddmckay', 'wdhv3', 'malhotr0', 'indrajakn205', 'hcboaz', 'pawara', 'jtulcan29', 'xu514', 'blissm95', 'srinath2951', 'sajidniaz300', 'gdykes', 'fanel312', 'rueschhl', 'bermel', 'servinb', 'dhoch', 'ebartusi', 'nhdan1501', 'huozhongyu', 'camilo192000', 'mferoz', 'mount18', 'schowdhury', 'liang142', 'todd.krauss.tk', 'qzmdtc1993', 'estebandido3512', 'myh', 'oscarandresdc', 'cho133', 'sharma.amrit93', 'corbeta', 'ca.criollo99', 'roy48', 'sebastian.valero', 'upton0', 'felipe_97', 'lin411977008', 'ukamran', 'sentz', 'wannafight', 'son13', 'samina.amanullah', 'manabolu', 'sunxiantian123', 'tsentz95', 'yilmarbenavides1', 'bshilson', 'lletner', 'goldmandrummer', 'zhan1820', 'arash2342', 'mtobtn', 'adityap', 'mateobotina96', 'tedy06', 'devilal65', 'yang764', 'cho182', 'iivanvallejo', 'mmalsaft123', 'bcarterwhs13', 'dgaines2', 'munjuncho182', 'jbcolema', 'amassat', 'mhagag', 'ajlountz', 'okhandel', 'robertdieme', 'maxbrown112', 'zhu340', 'zhan1671', 'david.0108', 'wuil69', 'yilver0894', 'madana', 'ajbruns2160', 'karajp', 'maria12', 'huboxgo', 'tinny93s', 'sridhar4', 'shanthan25', 'pengsherry119', 'hamel7', 'smit2257', 'juandaaa3', None, 'preshmas', 'gosman', 'sogalss', 'jprokop77', 'carlitos962013', 'jyshi', 'ppxxyy1109', 'ma287', 'colegiannotti', 'elkiinriiascos', 'huntdj', 'duvanbenavides2', 's22johanmolinar', 'jhonsteven1397']"
5,95,85,21,20,"['felipe_97', 'yilmarbenavides1', 'mateobotina96', 'tedy06', 'diego930302', 'iivanvallejo', 'jtulcan29', 'fanel312', 'yilver0894', 'huboxgo', 'hamel7', 'juandaaa3', 'camilo192000', 'sogalss', 'carlitos962013', 'oscarandresdc', 'duvanbenavides2', 's22johanmolinar', 'jhonsteven1397', 'ca.criollo99']",64,"['stevecampbell', 'lin411977008', 'wannafight', 'son13', 'samina.amanullah', 'llop2821', 'ztledfor', 'manabolu', 'tsentz95', 'mjlowin', 'shruti1412', 'sunxiantian123', 'slowriver322', 'titus.sandu', 'arash2342', 'mtobtn', 'samlocke37', 'yzou0426', 'adityap', 'devilal65', 'ddmckay', 'cho182', 'wdhv3', 'malhotr0', 'indrajakn205', 'hcboaz', 'pawara', 'mmalsaft123', 'dgaines2', 'xu514', 'srinath2951', 'jbcolema', 'ajlountz', 'okhandel', 'sajidniaz300', 'robertdieme', 'zhan1671', 'david.0108', 'rueschhl', 'wuil69', 'madana', 'karajp', 'maria12', 'sridhar4', 'tinny93s', 'shanthan25', 'pengsherry119', 'nhdan1501', 'preshmas', 'huozhongyu', 'gosman', 'mount18', 'jprokop77', 'liang142', 'todd.krauss.tk', 'ppxxyy1109', 'estebandido3512', 'ma287', 'colegiannotti', 'elkiinriiascos', 'myh', 'huntdj', 'sharma.amrit93', 'sebastian.valero']",1,[None],85,"['stevecampbell', 'llop2821', 'ztledfor', 'mjlowin', 'shruti1412', 'slowriver322', 'titus.sandu', 'samlocke37', 'yzou0426', 'diego930302', 'ddmckay', 'wdhv3', 'malhotr0', 'indrajakn205', 'hcboaz', 'pawara', 'jtulcan29', 'xu514', 'srinath2951', 'sajidniaz300', 'fanel312', 'rueschhl', 'nhdan1501', 'huozhongyu', 'camilo192000', 'mount18', 'liang142', 'todd.krauss.tk', 'estebandido3512', 'myh', 'oscarandresdc', 'sharma.amrit93', 'ca.criollo99', 'sebastian.valero', 'felipe_97', 'lin411977008', 'wannafight', 'son13', 'samina.amanullah', 'manabolu', 'sunxiantian123', 'tsentz95', 'yilmarbenavides1', 'arash2342', 'mtobtn', 'adityap', 'mateobotina96', 'tedy06', 'devilal65', 'cho182', 'iivanvallejo', 'mmalsaft123', 'dgaines2', 'jbcolema', 'ajlountz', 'okhandel', 'robertdieme', 'zhan1671', 'david.0108', 'wuil69', 'yilver0894', 'madana', 'karajp', 'maria12', 'huboxgo', 'tinny93s', 'sridhar4', 'shanthan25', 'pengsherry119', 'hamel7', 'juandaaa3', None, 'preshmas', 'gosman', 'sogalss', 'jprokop77', 'carlitos962013', 'ppxxyy1109', 'ma287', 'colegiannotti', 'elkiinriiascos', 'huntdj', 'duvanbenavides2', 's22johanmolinar', 'jhonsteven1397']"
5,99,85,11,10,"['carlitos962013', 'iivanvallejo', 'tedy06', 'jtulcan29', 'huboxgo', 'sebastian.valero', 'yilmarbenavides1', 'hamel7', 'jhonsteven1397', 'diego930302']",74,"['stevecampbell', 'llop2821', 'ztledfor', 'mjlowin', 'shruti1412', 'slowriver322', 'titus.sandu', 'samlocke37', 'yzou0426', 'ddmckay', 'wdhv3', 'malhotr0', 'indrajakn205', 'hcboaz', 'pawara', 'xu514', 'srinath2951', 'sajidniaz300', 'fanel312', 'rueschhl', 'nhdan1501', 'huozhongyu', 'camilo192000', 'mount18', 'liang142', 'todd.krauss.tk', 'estebandido3512', 'myh', 'oscarandresdc', 'sharma.amrit93', 'ca.criollo99', 'felipe_97', 'lin411977008', 'wannafight', 'son13', 'samina.amanullah', 'manabolu', 'sunxiantian123', 'tsentz95', 'arash2342', 'mtobtn', 'adityap', 'mateobotina96', 'devilal65', 'cho182', 'mmalsaft123', 'dgaines2', 'jbcolema', 'ajlountz', 'okhandel', 'robertdieme', 'zhan1671', 'david.0108', 'wuil69', 'yilver0894', 'madana', 'karajp', 'maria12', 'tinny93s', 'sridhar4', 'shanthan25', 'pengsherry119', 'juandaaa3', 'preshmas', 'gosman', 'sogalss', 'jprokop77', 'ppxxyy1109', 'ma287', 'colegiannotti', 'elkiinriiascos', 'huntdj', 'duvanbenavides2', 's22johanmolinar']",1,[None],85,"['stevecampbell', 'llop2821', 'ztledfor', 'mjlowin', 'shruti1412', 'slowriver322', 'titus.sandu', 'samlocke37', 'yzou0426', 'diego930302', 'ddmckay', 'wdhv3', 'malhotr0', 'indrajakn205', 'hcboaz', 'pawara', 'jtulcan29', 'xu514', 'srinath2951', 'sajidniaz300', 'fanel312', 'rueschhl', 'nhdan1501', 'huozhongyu', 'camilo192000', 'mount18', 'liang142', 'todd.krauss.tk', 'estebandido3512', 'myh', 'oscarandresdc', 'sharma.amrit93', 'ca.criollo99', 'sebastian.valero', 'felipe_97', 'lin411977008', 'wannafight', 'son13', 'samina.amanullah', 'manabolu', 'sunxiantian123', 'tsentz95', 'yilmarbenavides1', 'arash2342', 'mtobtn', 'adityap', 'mateobotina96', 'tedy06', 'devilal65', 'cho182', 'iivanvallejo', 'mmalsaft123', 'dgaines2', 'jbcolema', 'ajlountz', 'okhandel', 'robertdieme', 'zhan1671', 'david.0108', 'wuil69', 'yilver0894', 'madana', 'karajp', 'maria12', 'huboxgo', 'tinny93s', 'sridhar4', 'shanthan25', 'pengsherry119', 'hamel7', 'juandaaa3', None, 'preshmas', 'gosman', 'sogalss', 'jprokop77', 'carlitos962013', 'ppxxyy1109', 'ma287', 'colegiannotti', 'elkiinriiascos', 'huntdj', 'duvanbenavides2', 's22johanmolinar', 'jhonsteven1397']"
5,98,85,8,1,['liang142'],83,"['stevecampbell', 'llop2821', 'ztledfor', 'mjlowin', 'shruti1412', 'slowriver322', 'titus.sandu', 'samlocke37', 'yzou0426', 'diego930302', 'ddmckay', 'wdhv3', 'malhotr0', 'indrajakn205', 'hcboaz', 'pawara', 'jtulcan29', 'xu514', 'srinath2951', 'sajidniaz300', 'fanel312', 'rueschhl', 'nhdan1501', 'huozhongyu', 'camilo192000', 'mount18', 'todd.krauss.tk', 'estebandido3512', 'myh', 'oscarandresdc', 'sharma.amrit93', 'ca.criollo99', 'sebastian.valero', 'felipe_97', 'lin411977008', 'wannafight', 'son13', 'samina.amanullah', 'manabolu', 'sunxiantian123', 'tsentz95', 'yilmarbenavides1', 'arash2342', 'mtobtn', 'adityap', 'mateobotina96', 'tedy06', 'devilal65', 'cho182', 'iivanvallejo', 'mmalsaft123', 'dgaines2', 'jbcolema', 'ajlountz', 'okhandel', 'robertdieme', 'zhan1671', 'david.0108', 'wuil69', 'yilver0894', 'madana', 'karajp', 'maria12', 'huboxgo', 'tinny93s', 'sridhar4', 'shanthan25', 'pengsherry119', 'hamel7', 'juandaaa3', 'preshmas', 'gosman', 'sogalss', 'jprokop77', 'carlitos962013', 'ppxxyy1109', 'ma287', 'colegiannotti', 'elkiinriiascos', 'huntdj', 'duvanbenavides2', 's22johanmolinar', 'jhonsteven1397']",7,"['servinb', 'klturne5', 'zhao546', 'jclaussen27', 'zhai312313', None, 'jiang330']",91,"['stevecampbell', 'llop2821', 'ztledfor', 'mjlowin', 'shruti1412', 'slowriver322', 'titus.sandu', 'samlocke37', 'yzou0426', 'diego930302', 'ddmckay', 'wdhv3', 'malhotr0', 'indrajakn205', 'hcboaz', 'pawara', 'jtulcan29', 'xu514', 'srinath2951', 'sajidniaz300', 'fanel312', 'rueschhl', 'servinb', 'nhdan1501', 'huozhongyu', 'camilo192000', 'mount18', 'liang142', 'todd.krauss.tk', 'estebandido3512', 'klturne5', 'myh', 'oscarandresdc', 'zhao546', 'sharma.amrit93', 'ca.criollo99', 'sebastian.valero', 'felipe_97', 'lin411977008', 'wannafight', 'son13', 'samina.amanullah', 'manabolu', 'sunxiantian123', 'tsentz95', 'yilmarbenavides1', 'arash2342', 'mtobtn', 'adityap', 'mateobotina96', 'tedy06', 'devilal65', 'cho182', 'iivanvallejo', 'mmalsaft123', 'dgaines2', 'jbcolema', 'ajlountz', 'okhandel', 'robertdieme', 'zhan1671', 'jiang330', 'david.0108', 'wuil69', 'yilver0894', 'madana', 'karajp', 'maria12', 'huboxgo', 'tinny93s', 'sridhar4', 'zhai312313', 'shanthan25', 'pengsherry119', 'jclaussen27', 'hamel7', 'juandaaa3', None, 'preshmas', 'gosman', 'sogalss', 'jprokop77', 'carlitos962013', 'ppxxyy1109', 'ma287', 'colegiannotti', 'elkiinriiascos', 'huntdj', 'duvanbenavides2', 's22johanmolinar', 'jhonsteven1397']"
6,147,84,84,75,"['avichai', 'ytsach', 'yakir.hit', 'kiril.lain', 'eliranbar', 'kobideri88', 'banchi32', 'sean2102', 'may56563', 'benkedem', 'nissimsh1', 'ironlion23', 'chen3', 'sahar6909', 'jonathan.barcan', 'benbachar1990', 'sharik172', 'yogevlevin', 'navelug203', 'elidorrr', 'gal13.private', 'mitelbar', 'brk', 'benmaymon', 'hadars', 'titiel', 'shakshuka14', 'eliavmoryoussef', 'arikottt', 'sagivy89', 'amitsunay790', 'meyt.1991', 'henshu4000', 'reutmor1988', 'danamalka17', 'orkadosh007', 'omrilahav3', 'bar.ovadia18', 'nofaratia', 'snazarov', 'ibdd007', 'rotemza12349', 'slimjohnny', 'inbarush1991', 'blablablabla', 'katiashevchenko90', 'ofirk1271', 'ofer91', 'avimiz101', 'dad5388211', 'jackiesofir1989', 'almogtz', 'sapir271192', 'orshinfeld12', 'shimon.kaplan91', 'ozabar', 'ofir1103', 'itziks', 'aviomri', 'team847', 'oz65689', 'barak.derei', 'lihayashraf', 'danifn6', 'ohadc26', 'radiksaif', 'dsegal5', 'dida1988', 'liron411', 'roei10', 'tomerz', 'elect2014.hit', 'erez.bnd', 'ariellevy88', 'sapirshemri']",8,"['tk1990', 'alexwrx', 'ozbenhamo1', 'nishant.ghosh.mtech', 'albert.antechamber', 'thealbert', 'milanaa5', 'yoav.b']",9,"['ohana.niv', 'moshehalfon90', 'tzion.1987', 'yonigel', 'michal.balberg', 'zzz777', 'ab12343', None, 'coopi']",92,"['avichai', 'ytsach', 'ironlion23', 'chen3', 'nissimsh1', 'ohana.niv', 'benbachar1990', 'jonathan.barcan', 'mitelbar', 'titiel', 'reutmor1988', 'bar.ovadia18', 'snazarov', 'blablablabla', 'katiashevchenko90', 'ofirk1271', 'orshinfeld12', 'ohadc26', 'albert.antechamber', 'roei10', 'erez.bnd', 'benkedem', 'yakir.hit', 'kiril.lain', 'kobideri88', 'coopi', 'gal13.private', 'brk', 'thealbert', 'shakshuka14', 'michal.balberg', 'sagivy89', 'danamalka17', 'inbarush1991', 'almogtz', 'ofir1103', 'aviomri', 'team847', 'moshehalfon90', 'liron411', 'tomerz', 'yonigel', 'ariellevy88', 'yoav.b', 'eliranbar', 'tzion.1987', 'sharik172', 'yogevlevin', 'tk1990', 'ozbenhamo1', 'benmaymon', 'eliavmoryoussef', 'meyt.1991', 'henshu4000', 'nofaratia', 'slimjohnny', 'ofer91', 'avimiz101', 'sapir271192', 'zzz777', 'shimon.kaplan91', 'ozabar', 'itziks', 'oz65689', 'dsegal5', 'elect2014.hit', 'sapirshemri', 'banchi32', 'sean2102', 'may56563', 'sahar6909', 'navelug203', 'alexwrx', 'nishant.ghosh.mtech', 'hadars', 'arikottt', 'amitsunay790', 'orkadosh007', 'omrilahav3', 'ibdd007', 'rotemza12349', 'dad5388211', 'jackiesofir1989', 'milanaa5', None, 'barak.derei', 'lihayashraf', 'danifn6', 'radiksaif', 'dida1988', 'elidorrr', 'ab12343']"
6,148,84,9,8,"['ibdd007', 'tk1990', 'yakir.hit', 'barak.derei', 'ozbenhamo1', 'elidorrr', 'milanaa5', 'ofir1103']",75,"['avichai', 'ytsach', 'eliranbar', 'ironlion23', 'chen3', 'nissimsh1', 'benbachar1990', 'jonathan.barcan', 'sharik172', 'yogevlevin', 'mitelbar', 'benmaymon', 'titiel', 'eliavmoryoussef', 'meyt.1991', 'henshu4000', 'reutmor1988', 'bar.ovadia18', 'nofaratia', 'snazarov', 'slimjohnny', 'blablablabla', 'katiashevchenko90', 'ofirk1271', 'ofer91', 'avimiz101', 'sapir271192', 'orshinfeld12', 'shimon.kaplan91', 'ozabar', 'itziks', 'oz65689', 'ohadc26', 'albert.antechamber', 'dsegal5', 'roei10', 'elect2014.hit', 'erez.bnd', 'benkedem', 'sapirshemri', 'banchi32', 'kiril.lain', 'kobideri88', 'sean2102', 'may56563', 'sahar6909', 'navelug203', 'gal13.private', 'alexwrx', 'nishant.ghosh.mtech', 'brk', 'hadars', 'thealbert', 'shakshuka14', 'arikottt', 'sagivy89', 'amitsunay790', 'orkadosh007', 'omrilahav3', 'danamalka17', 'rotemza12349', 'inbarush1991', 'dad5388211', 'jackiesofir1989', 'almogtz', 'aviomri', 'team847', 'lihayashraf', 'danifn6', 'radiksaif', 'dida1988', 'liron411', 'tomerz', 'ariellevy88', 'yoav.b']",1,[None],84,"['avichai', 'ytsach', 'eliranbar', 'ironlion23', 'chen3', 'nissimsh1', 'benbachar1990', 'jonathan.barcan', 'sharik172', 'yogevlevin', 'tk1990', 'elidorrr', 'ozbenhamo1', 'mitelbar', 'benmaymon', 'titiel', 'eliavmoryoussef', 'meyt.1991', 'henshu4000', 'reutmor1988', 'bar.ovadia18', 'nofaratia', 'snazarov', 'slimjohnny', 'blablablabla', 'katiashevchenko90', 'ofirk1271', 'ofer91', 'avimiz101', 'sapir271192', 'orshinfeld12', 'shimon.kaplan91', 'ozabar', 'itziks', 'oz65689', 'ohadc26', 'albert.antechamber', 'dsegal5', 'roei10', 'elect2014.hit', 'erez.bnd', 'benkedem', 'sapirshemri', 'banchi32', 'yakir.hit', 'kiril.lain', 'kobideri88', 'sean2102', 'may56563', 'sahar6909', 'navelug203', 'gal13.private', 'alexwrx', 'nishant.ghosh.mtech', 'brk', 'hadars', 'thealbert', 'shakshuka14', 'arikottt', 'sagivy89', 'amitsunay790', 'orkadosh007', 'omrilahav3', 'danamalka17', 'ibdd007', 'rotemza12349', 'inbarush1991', 'dad5388211', 'jackiesofir1989', 'almogtz', 'milanaa5', None, 'ofir1103', 'aviomri', 'team847', 'barak.derei', 'lihayashraf', 'danifn6', 'radiksaif', 'dida1988', 'liron411', 'tomerz', 'ariellevy88', 'yoav.b']"
7,242,83,96,67,"['sbumbles96', 'mepaul2', 'dpapanicolas', 'prhogan2', 'yaoyao5', 'dfrosen2', 'balung18', 'ychu18', 'zzhan134', 'zhaber2', 'zohair2', 'goszkow2', 'slohman2', 'yuqiuwu2', 'cwang112', 'hzhan126', 'cnsteve2', 'kote.deepa', 'berglun2', 'aokisang', 'reningr2', 'jacob.dutler', 'crickettay13', 'jdlin4', 'thiruve2', 'maggana2', 'hmajith2', 'ychen254', 'cmander4', 'krithikp', 'mtschro3', 'arovgno', 'meiselm2', 'jeroach2', 'toriyam2', 'akim102', 'jhbaker3', 'tcalder2', 'trskwsk2', 'jackylu2', 'jcselle2', 'ajfrank3', 'ychen375', 'deepakcmani', 'nuanes2', 'echoma', 'rwlandi2', 'rzhang80', 'aladd2', 'jeoneil6', 'scorchnoxap', 'yiyue.luo.9', 'tmolley2', 'zjcszzl0615', 'kjnnngs2', 'jhmead2', 'pbehera2', 'drew.wise.10', 'pross4', 'mclawso2', 'mchang14', 'zlong4', 'yhuan127', 'jonbaebae', 'jsshin3', 'zafar3', 'cdeegan2']",15,"['xlz.287', 'tomkenic', 'joylin0806', 'tianshu2', 'ruining2', 'tziegler12', 'dcschmi2', 'mingye.gao', 'junehan1', 'zhan1823', 'pshetty3', 'zhan.shi.106', 'eswu2', 'cssmith4', 'andrew.robertson99987']",29,"['gngpdhy2', 'nkim74', 'reningermatthew', 'jdray2', 'alfeche2', 'saphknight', 'amir89', 'lxing3', 'jakrogst', 'xsun45', 'vkhanna3', 'liamkennynanohub', 'amland2', 'dexterballou', 'zwang173', 'icharri2', 'akononov', 'alanwu3', 'smpatel8', None, 'katarukaamrita', 'anleen20', 'jlayers2', 'clarasmile', 'jzhan142', 'kmckillop', 'wtroth2', 'jshi3120', 'dzhang37']",111,"['nkim74', 'dpapanicolas', 'tianshu2', 'cwang112', 'alfeche2', 'saphknight', 'amland2', 'liamkennynanohub', 'dexterballou', 'ychen254', 'krithikp', 'arovgno', 'alanwu3', 'jackylu2', 'jcselle2', 'smpatel8', 'ychen375', 'deepakcmani', 'rzhang80', 'aladd2', 'katarukaamrita', 'kjnnngs2', 'clarasmile', 'pbehera2', 'drew.wise.10', 'dcschmi2', 'jsshin3', 'zafar3', 'scorchnoxap', 'cdeegan2', 'dzhang37', 'gngpdhy2', 'sbumbles96', 'ruining2', 'mingye.gao', 'zhaber2', 'reningermatthew', 'hzhan126', 'cssmith4', 'kote.deepa', 'crickettay13', 'jdlin4', 'hmajith2', 'meiselm2', 'akim102', 'tcalder2', 'trskwsk2', 'junehan1', 'zhan1823', 'nuanes2', 'jeoneil6', 'anleen20', 'kmckillop', 'yiyue.luo.9', 'echoma', 'jhbaker3', 'mepaul2', 'prhogan2', 'yaoyao5', 'dfrosen2', 'balung18', 'ychu18', 'zzhan134', 'zohair2', 'yuqiuwu2', 'jdray2', 'andrew.robertson99987', 'cnsteve2', 'berglun2', 'amir89', 'aokisang', 'thiruve2', 'vkhanna3', 'zhan.shi.106', 'icharri2', 'jonbaebae', 'toriyam2', 'tziegler12', 'ajfrank3', 'rwlandi2', 'tmolley2', 'joylin0806', 'jhmead2', 'jlayers2', 'jzhan142', 'mchang14', 'wtroth2', 'goszkow2', 'slohman2', 'eswu2', 'lxing3', 'reningr2', 'jakrogst', 'xsun45', 'jacob.dutler', 'maggana2', 'pshetty3', 'cmander4', 'zwang173', 'mtschro3', 'jeroach2', 'tomkenic', None, 'zjcszzl0615', 'mclawso2', 'zlong4', 'yhuan127', 'jshi3120', 'pross4', 'xlz.287', 'akononov']"
7,246,83,83,70,"['sbumbles96', 'mepaul2', 'tianshu2', 'ruining2', 'prhogan2', 'yaoyao5', 'mingye.gao', 'dfrosen2', 'balung18', 'ychu18', 'zhaber2', 'zzhan134', 'zohair2', 'goszkow2', 'yuqiuwu2', 'cwang112', 'slohman2', 'hzhan126', 'cssmith4', 'kote.deepa', 'berglun2', 'aokisang', 'reningr2', 'jacob.dutler', 'crickettay13', 'jdlin4', 'thiruve2', 'maggana2', 'hmajith2', 'pshetty3', 'ychen254', 'cmander4', 'krithikp', 'mtschro3', 'arovgno', 'meiselm2', 'jeroach2', 'akim102', 'jhbaker3', 'tcalder2', 'trskwsk2', 'junehan1', 'jackylu2', 'jcselle2', 'ajfrank3', 'ychen375', 'deepakcmani', 'nuanes2', 'echoma', 'rwlandi2', 'aladd2', 'jeoneil6', 'zafar3', 'yiyue.luo.9', 'tmolley2', 'zjcszzl0615', 'kjnnngs2', 'jhmead2', 'pbehera2', 'drew.wise.10', 'pross4', 'mclawso2', 'mchang14', 'zlong4', 'yhuan127', 'jonbaebae', 'xlz.287', 'jsshin3', 'scorchnoxap', 'cdeegan2']",12,"['toriyam2', 'tomkenic', 'joylin0806', 'dpapanicolas', 'tziegler12', 'cnsteve2', 'dcschmi2', 'zhan1823', 'zhan.shi.106', 'eswu2', 'andrew.robertson99987', 'rzhang80']",13,"['dli29', 'katarukaamrita', 'dlitt2', 'mckillo2', 'jqian10', 'awlong2', 'wtroth2', 'harrisian84', 'amber.snil', None, 'alfeche2', 'akononov', 'junetheyula']",95,"['dpapanicolas', 'tianshu2', 'cwang112', 'alfeche2', 'ychen254', 'krithikp', 'arovgno', 'jackylu2', 'jcselle2', 'ychen375', 'deepakcmani', 'rzhang80', 'aladd2', 'junetheyula', 'dli29', 'katarukaamrita', 'kjnnngs2', 'pbehera2', 'drew.wise.10', 'dcschmi2', 'jsshin3', 'zafar3', 'scorchnoxap', 'cdeegan2', 'sbumbles96', 'jqian10', 'ruining2', 'mingye.gao', 'zhaber2', 'hzhan126', 'cssmith4', 'kote.deepa', 'crickettay13', 'jdlin4', 'hmajith2', 'meiselm2', 'akim102', 'tcalder2', 'trskwsk2', 'junehan1', 'zhan1823', 'nuanes2', 'jeoneil6', 'yiyue.luo.9', 'echoma', 'jhbaker3', 'mepaul2', 'prhogan2', 'yaoyao5', 'dfrosen2', 'balung18', 'ychu18', 'zzhan134', 'zohair2', 'yuqiuwu2', 'andrew.robertson99987', 'cnsteve2', 'berglun2', 'aokisang', 'thiruve2', 'zhan.shi.106', 'jonbaebae', 'toriyam2', 'tziegler12', 'ajfrank3', 'amber.snil', 'rwlandi2', 'dlitt2', 'tmolley2', 'joylin0806', 'jhmead2', 'mchang14', 'wtroth2', 'harrisian84', 'goszkow2', 'slohman2', 'awlong2', 'eswu2', 'reningr2', 'jacob.dutler', 'maggana2', 'pshetty3', 'cmander4', 'mtschro3', 'jeroach2', 'tomkenic', 'mckillo2', None, 'zjcszzl0615', 'mclawso2', 'zlong4', 'yhuan127', 'pross4', 'xlz.287', 'akononov']"
7,244,83,24,11,"['xlz.287', 'joylin0806', 'tianshu2', 'ruining2', 'mingye.gao', 'pshetty3', 'junehan1', 'zhan.shi.106', 'krithikp', 'eswu2', 'cssmith4']",71,"['sbumbles96', 'mepaul2', 'dpapanicolas', 'prhogan2', 'yaoyao5', 'dfrosen2', 'balung18', 'ychu18', 'zzhan134', 'zhaber2', 'zohair2', 'goszkow2', 'slohman2', 'yuqiuwu2', 'cwang112', 'hzhan126', 'andrew.robertson99987', 'cnsteve2', 'kote.deepa', 'berglun2', 'aokisang', 'reningr2', 'jacob.dutler', 'crickettay13', 'jdlin4', 'thiruve2', 'maggana2', 'hmajith2', 'ychen254', 'cmander4', 'mtschro3', 'arovgno', 'meiselm2', 'jeroach2', 'toriyam2', 'tomkenic', 'akim102', 'jhbaker3', 'tziegler12', 'tcalder2', 'trskwsk2', 'jackylu2', 'zhan1823', 'jcselle2', 'ajfrank3', 'ychen375', 'deepakcmani', 'nuanes2', 'echoma', 'rwlandi2', 'rzhang80', 'aladd2', 'jeoneil6', 'scorchnoxap', 'yiyue.luo.9', 'tmolley2', 'zjcszzl0615', 'kjnnngs2', 'jhmead2', 'pbehera2', 'drew.wise.10', 'dcschmi2', 'pross4', 'mclawso2', 'mchang14', 'zlong4', 'yhuan127', 'jonbaebae', 'jsshin3', 'zafar3', 'cdeegan2']",13,"['dli29', 'wchen94', 'yliu181', 'katarukaamrita', 'dlitt2', 'dorothy3', 'samhalpern58', 'alf', 'gowthamsriram', 'shenyuwu94', None, 'alfeche2', 'bridgette.lafaye']",95,"['mepaul2', 'prhogan2', 'dpapanicolas', 'tianshu2', 'yaoyao5', 'dfrosen2', 'balung18', 'ychu18', 'zzhan134', 'zohair2', 'yuqiuwu2', 'cwang112', 'andrew.robertson99987', 'alfeche2', 'cnsteve2', 'berglun2', 'aokisang', 'thiruve2', 'zhan.shi.106', 'ychen254', 'krithikp', 'arovgno', 'yliu181', 'toriyam2', 'tziegler12', 'jackylu2', 'jcselle2', 'ajfrank3', 'ychen375', 'deepakcmani', 'rwlandi2', 'rzhang80', 'aladd2', 'dli29', 'katarukaamrita', 'dlitt2', 'tmolley2', 'joylin0806', 'kjnnngs2', 'jhmead2', 'pbehera2', 'drew.wise.10', 'dcschmi2', 'mchang14', 'shenyuwu94', 'jsshin3', 'zafar3', 'scorchnoxap', 'cdeegan2', 'sbumbles96', 'dorothy3', 'ruining2', 'mingye.gao', 'goszkow2', 'zhaber2', 'slohman2', 'alf', 'gowthamsriram', 'eswu2', 'hzhan126', 'cssmith4', 'kote.deepa', 'wchen94', 'reningr2', 'jacob.dutler', 'crickettay13', 'jdlin4', 'maggana2', 'pshetty3', 'hmajith2', 'cmander4', 'mtschro3', 'meiselm2', 'jeroach2', 'bridgette.lafaye', 'tomkenic', 'akim102', 'tcalder2', 'trskwsk2', 'junehan1', 'zhan1823', 'nuanes2', 'echoma', None, 'jeoneil6', 'zjcszzl0615', 'pross4', 'samhalpern58', 'mclawso2', 'zlong4', 'yhuan127', 'jonbaebae', 'xlz.287', 'yiyue.luo.9', 'jhbaker3']"
7,245,83,24,11,"['xlz.287', 'joylin0806', 'dpapanicolas', 'ruining2', 'tianshu2', 'mingye.gao', 'pshetty3', 'zhan.shi.106', 'krithikp', 'eswu2', 'cssmith4']",71,"['sbumbles96', 'mepaul2', 'prhogan2', 'yaoyao5', 'dfrosen2', 'balung18', 'ychu18', 'zzhan134', 'zhaber2', 'zohair2', 'goszkow2', 'slohman2', 'yuqiuwu2', 'cwang112', 'hzhan126', 'andrew.robertson99987', 'cnsteve2', 'kote.deepa', 'berglun2', 'aokisang', 'reningr2', 'jacob.dutler', 'crickettay13', 'jdlin4', 'thiruve2', 'maggana2', 'hmajith2', 'ychen254', 'cmander4', 'mtschro3', 'arovgno', 'meiselm2', 'jeroach2', 'toriyam2', 'tomkenic', 'akim102', 'jhbaker3', 'tziegler12', 'tcalder2', 'trskwsk2', 'junehan1', 'jackylu2', 'zhan1823', 'jcselle2', 'ajfrank3', 'ychen375', 'deepakcmani', 'nuanes2', 'echoma', 'rwlandi2', 'rzhang80', 'aladd2', 'jeoneil6', 'scorchnoxap', 'yiyue.luo.9', 'tmolley2', 'zjcszzl0615', 'kjnnngs2', 'jhmead2', 'pbehera2', 'drew.wise.10', 'dcschmi2', 'pross4', 'mclawso2', 'mchang14', 'zlong4', 'yhuan127', 'jonbaebae', 'jsshin3', 'zafar3', 'cdeegan2']",13,"['wchen94', 'yliu181', 'katarukaamrita', 'dlitt2', 'dorothy3', 'liuyuting1006', 'amber.snil', 'jli118', None, 'alfeche2', 'akononov', 'yutingliu', 'bridgette.lafaye']",95,"['mepaul2', 'prhogan2', 'dpapanicolas', 'tianshu2', 'yaoyao5', 'dfrosen2', 'balung18', 'ychu18', 'zzhan134', 'zohair2', 'yuqiuwu2', 'cwang112', 'andrew.robertson99987', 'alfeche2', 'cnsteve2', 'berglun2', 'aokisang', 'thiruve2', 'zhan.shi.106', 'ychen254', 'krithikp', 'arovgno', 'akononov', 'yliu181', 'toriyam2', 'tziegler12', 'jackylu2', 'jcselle2', 'ajfrank3', 'ychen375', 'deepakcmani', 'amber.snil', 'rwlandi2', 'rzhang80', 'aladd2', 'katarukaamrita', 'dlitt2', 'tmolley2', 'joylin0806', 'kjnnngs2', 'jhmead2', 'pbehera2', 'drew.wise.10', 'dcschmi2', 'mchang14', 'jsshin3', 'zafar3', 'scorchnoxap', 'cdeegan2', 'sbumbles96', 'dorothy3', 'ruining2', 'mingye.gao', 'goszkow2', 'zhaber2', 'slohman2', 'eswu2', 'hzhan126', 'cssmith4', 'kote.deepa', 'wchen94', 'reningr2', 'jacob.dutler', 'crickettay13', 'jdlin4', 'maggana2', 'pshetty3', 'hmajith2', 'liuyuting1006', 'cmander4', 'mtschro3', 'meiselm2', 'jeroach2', 'bridgette.lafaye', 'tomkenic', 'akim102', 'tcalder2', 'trskwsk2', 'junehan1', 'zhan1823', 'nuanes2', 'jli118', 'echoma', None, 'jeoneil6', 'zjcszzl0615', 'pross4', 'mclawso2', 'zlong4', 'yhuan127', 'jonbaebae', 'xlz.287', 'yiyue.luo.9', 'jhbaker3', 'yutingliu']"
8,316,81,85,64,"['aashka13', 'adlt96', 'kesli', 'avrod2210', 'tonyrtoribio', 'kbjeppes', 'samadsen', 'jotap1234', 'aleejay112', 'ospotash', 'calcarb', 'timelesserax', 'jotap123', 'funnpun', 'bearman1000', 'sfoster15', 'jyperez', 'mtlyons11231', 'carlost88', 'smejia97', 'jorinna96', 'yharotorres', 'askittrell77', 'hzampaglione', 'alexis01', 'djlindsay', 'rychu18', 'grantlee9956', 'rvmathew', 'dechristensen', 'achoi96', 'rakeil', 'meganlo', 'jazvicmil', 'hzhhong', 'aparrish', 'jsullan', 'jon22345', 'huimin96', 'dudewhat', 'amberpulido16', 'vuthtyra', 'kimiigrlz', 'karols.ginting', 'erikoo', 'aychan24', 'justinm767', 'jonthomas', 'bryan23', 'nmuthusa', 'chanceps', 'clairelee', '1tzm', 'agchaveznavarro', 'lizzhop', 'aphuynh', 'becloud', 'qinw', 'chrispatino', 'slidzbar', 'captaint', 'panhaoting19', 'wendell', 'spatank']",16,"['jmchristiansensalameh', 'young260', 'cooleys', 'areoman850', 'clary0', 'zadeel', 'brettrasmus', 'astubber2016', 'ssher', 'naholte', 'springchicken', 'lschroer24', 'hrowlan', 'hweldy', 'kohlerc', 'lclondon']",21,"['znlin', 'darrensun963', 'fxyzhuo', 'suparay', 'vuthtyrayong', 'sg630', 'cmharvey', 'prgraham', 'roonloe', 'aca5tr09', 'ohone', None, 'phamgk', 'ekitamura', 'jmizutan', 'malgarcia', 'ajs9515', 'dlbrisen', 'rsrrrrr', 'aromero3', 'pmrau']",101,"['kesli', 'darrensun963', 'fxyzhuo', 'suparay', 'brettrasmus', 'bearman1000', 'jorinna96', 'roonloe', 'astubber2016', 'hzhhong', 'kimiigrlz', 'karols.ginting', 'zadeel', 'bryan23', 'nmuthusa', 'agchaveznavarro', 'lizzhop', 'aromero3', 'wendell', 'adlt96', 'znlin', 'tonyrtoribio', 'jotap1234', 'vuthtyrayong', 'jotap123', 'cmharvey', 'mtlyons11231', 'carlost88', 'askittrell77', 'alexis01', 'prgraham', 'rychu18', 'grantlee9956', 'achoi96', 'meganlo', 'aca5tr09', 'ssher', 'jsullan', 'jon22345', 'huimin96', 'ohone', 'kohlerc', 'amberpulido16', 'justinm767', 'ekitamura', 'chanceps', 'jmizutan', 'aphuynh', 'becloud', 'ajs9515', 'qinw', 'captaint', 'spatank', 'jmchristiansensalameh', 'aashka13', 'avrod2210', 'kbjeppes', 'samadsen', 'ospotash', 'hrowlan', 'funnpun', 'sg630', 'sfoster15', 'smejia97', 'yharotorres', 'djlindsay', 'rvmathew', 'jazvicmil', 'aparrish', 'lschroer24', 'clary0', 'chrispatino', 'panhaoting19', 'hweldy', 'pmrau', 'young260', 'areoman850', 'aleejay112', 'calcarb', 'timelesserax', 'jyperez', 'cooleys', 'naholte', 'hzampaglione', 'dechristensen', 'rakeil', 'springchicken', 'dudewhat', 'vuthtyra', None, 'erikoo', 'phamgk', 'jonthomas', 'clairelee', '1tzm', 'malgarcia', 'slidzbar', 'dlbrisen', 'rsrrrrr', 'aychan24', 'lclondon']"
8,222,81,39,6,"['young260', 'clary0', 'astubber2016', 'lschroer24', 'hrowlan', 'hweldy']",74,"['jmchristiansensalameh', 'adlt96', 'aashka13', 'areoman850', 'kesli', 'avrod2210', 'tonyrtoribio', 'kbjeppes', 'samadsen', 'jotap1234', 'aleejay112', 'ospotash', 'calcarb', 'timelesserax', 'jotap123', 'funnpun', 'brettrasmus', 'bearman1000', 'sfoster15', 'jyperez', 'cooleys', 'mtlyons11231', 'carlost88', 'smejia97', 'jorinna96', 'naholte', 'yharotorres', 'askittrell77', 'hzampaglione', 'alexis01', 'djlindsay', 'rychu18', 'grantlee9956', 'rvmathew', 'dechristensen', 'achoi96', 'rakeil', 'meganlo', 'jazvicmil', 'hzhhong', 'ssher', 'aparrish', 'springchicken', 'jsullan', 'jon22345', 'huimin96', 'dudewhat', 'kohlerc', 'amberpulido16', 'vuthtyra', 'kimiigrlz', 'karols.ginting', 'erikoo', 'aychan24', 'justinm767', 'zadeel', 'jonthomas', 'bryan23', 'nmuthusa', 'chanceps', 'clairelee', '1tzm', 'agchaveznavarro', 'lizzhop', 'aphuynh', 'becloud', 'qinw', 'chrispatino', 'slidzbar', 'captaint', 'panhaoting19', 'wendell', 'lclondon', 'spatank']",33,"['selazab', 'emeiner', 'campb122', 'aman0', 'ghinkle', 'ibrahim7', 'harribas', 'jscharre', 'kirby8', 'gfukumot', 'cmeisel', 'abusker', 'wang2621', 'mcconneb', 'long182', 'kcrew08', 'mgolm', 'acorda', 'mkrane', 'tstegall', None, 'jeinterz', 'ramos39', 'pkabra', 'srajesh10', 'grayfiel', 'bbattas', 'hdebose', 'kfortie', 'ngaurav', 'kdecocke', 'warren56', 'miramont']",113,"['jmchristiansensalameh', 'aashka13', 'kesli', 'avrod2210', 'kbjeppes', 'campb122', 'aman0', 'samadsen', 'miramont', 'ospotash', 'hrowlan', 'harribas', 'jscharre', 'funnpun', 'brettrasmus', 'bearman1000', 'sfoster15', 'smejia97', 'jorinna96', 'yharotorres', 'gfukumot', 'cmeisel', 'djlindsay', 'wang2621', 'rvmathew', 'kcrew08', 'jazvicmil', 'astubber2016', 'hzhhong', 'aparrish', 'lschroer24', 'mkrane', 'tstegall', 'kimiigrlz', 'karols.ginting', 'ramos39', 'clary0', 'zadeel', 'bryan23', 'nmuthusa', 'agchaveznavarro', 'lizzhop', 'grayfiel', 'chrispatino', 'bbattas', 'panhaoting19', 'hweldy', 'wendell', 'adlt96', 'young260', 'areoman850', 'selazab', 'tonyrtoribio', 'emeiner', 'ghinkle', 'jotap1234', 'aleejay112', 'calcarb', 'timelesserax', 'ibrahim7', 'jotap123', 'jyperez', 'cooleys', 'mtlyons11231', 'carlost88', 'naholte', 'kirby8', 'askittrell77', 'hzampaglione', 'abusker', 'alexis01', 'rychu18', 'grantlee9956', 'dechristensen', 'achoi96', 'mcconneb', 'rakeil', 'long182', 'meganlo', 'mgolm', 'acorda', 'ssher', 'springchicken', 'jsullan', 'jon22345', 'huimin96', 'dudewhat', 'kohlerc', 'amberpulido16', 'vuthtyra', None, 'jeinterz', 'erikoo', 'justinm767', 'jonthomas', 'pkabra', 'chanceps', 'clairelee', '1tzm', 'srajesh10', 'aphuynh', 'becloud', 'qinw', 'slidzbar', 'hdebose', 'captaint', 'aychan24', 'kfortie', 'ngaurav', 'kdecocke', 'warren56', 'lclondon', 'spatank']"
8,221,81,21,1,['hweldy'],79,"['kesli', 'brettrasmus', 'bearman1000', 'jorinna96', 'astubber2016', 'hzhhong', 'kimiigrlz', 'karols.ginting', 'zadeel', 'bryan23', 'nmuthusa', 'agchaveznavarro', 'lizzhop', 'wendell', 'adlt96', 'tonyrtoribio', 'jotap1234', 'jotap123', 'mtlyons11231', 'carlost88', 'askittrell77', 'alexis01', 'rychu18', 'grantlee9956', 'achoi96', 'meganlo', 'ssher', 'jsullan', 'jon22345', 'huimin96', 'kohlerc', 'amberpulido16', 'justinm767', 'chanceps', 'aphuynh', 'becloud', 'qinw', 'captaint', 'spatank', 'jmchristiansensalameh', 'aashka13', 'avrod2210', 'kbjeppes', 'samadsen', 'ospotash', 'hrowlan', 'funnpun', 'sfoster15', 'smejia97', 'yharotorres', 'djlindsay', 'rvmathew', 'jazvicmil', 'aparrish', 'lschroer24', 'clary0', 'chrispatino', 'panhaoting19', 'young260', 'areoman850', 'aleejay112', 'calcarb', 'timelesserax', 'jyperez', 'cooleys', 'naholte', 'hzampaglione', 'dechristensen', 'rakeil', 'springchicken', 'dudewhat', 'vuthtyra', 'erikoo', 'jonthomas', 'clairelee', '1tzm', 'slidzbar', 'aychan24', 'lclondon']",20,"['harribas', 'kkm11102000', 'bconners', 'sreeve', 'kirby8', 'akrawec', 'hvaught', 'mcconneb', 'ander677', 'chaua', 'warren56', 'park710', None, 'ainaa_aisyaa', 'ramos39', 'hdebose', 'ngaurav', 'cochrad', 'mokuniew', 'miramont']",100,"['jmchristiansensalameh', 'aashka13', 'kesli', 'avrod2210', 'kbjeppes', 'samadsen', 'miramont', 'ospotash', 'hrowlan', 'harribas', 'funnpun', 'brettrasmus', 'bearman1000', 'sfoster15', 'sreeve', 'smejia97', 'jorinna96', 'yharotorres', 'akrawec', 'mokuniew', 'djlindsay', 'rvmathew', 'jazvicmil', 'astubber2016', 'hzhhong', 'aparrish', 'chaua', 'lschroer24', 'park710', 'kimiigrlz', 'karols.ginting', 'ainaa_aisyaa', 'ramos39', 'clary0', 'zadeel', 'bryan23', 'nmuthusa', 'agchaveznavarro', 'lizzhop', 'chrispatino', 'panhaoting19', 'hweldy', 'wendell', 'adlt96', 'young260', 'areoman850', 'tonyrtoribio', 'jotap1234', 'aleejay112', 'calcarb', 'timelesserax', 'kkm11102000', 'jotap123', 'jyperez', 'cooleys', 'bconners', 'mtlyons11231', 'carlost88', 'naholte', 'kirby8', 'askittrell77', 'hzampaglione', 'alexis01', 'rychu18', 'grantlee9956', 'dechristensen', 'hvaught', 'achoi96', 'mcconneb', 'rakeil', 'ander677', 'meganlo', 'ssher', 'springchicken', 'jsullan', 'jon22345', 'huimin96', 'dudewhat', 'kohlerc', 'amberpulido16', 'vuthtyra', None, 'erikoo', 'justinm767', 'jonthomas', 'chanceps', 'clairelee', '1tzm', 'aphuynh', 'becloud', 'qinw', 'slidzbar', 'hdebose', 'captaint', 'aychan24', 'ngaurav', 'cochrad', 'warren56', 'lclondon', 'spatank']"
8,315,81,15,10,"['young260', 'cooleys', 'clary0', 'zadeel', 'astubber2016', 'kohlerc', 'lschroer24', 'hrowlan', 'hweldy', 'brettrasmus']",70,"['jmchristiansensalameh', 'aashka13', 'kesli', 'avrod2210', 'kbjeppes', 'samadsen', 'ospotash', 'funnpun', 'bearman1000', 'sfoster15', 'smejia97', 'jorinna96', 'yharotorres', 'djlindsay', 'rvmathew', 'jazvicmil', 'hzhhong', 'aparrish', 'kimiigrlz', 'karols.ginting', 'bryan23', 'nmuthusa', 'agchaveznavarro', 'lizzhop', 'chrispatino', 'panhaoting19', 'wendell', 'adlt96', 'areoman850', 'tonyrtoribio', 'jotap1234', 'aleejay112', 'calcarb', 'timelesserax', 'jotap123', 'jyperez', 'mtlyons11231', 'carlost88', 'naholte', 'askittrell77', 'hzampaglione', 'alexis01', 'rychu18', 'grantlee9956', 'dechristensen', 'achoi96', 'rakeil', 'meganlo', 'ssher', 'springchicken', 'jsullan', 'jon22345', 'huimin96', 'dudewhat', 'amberpulido16', 'vuthtyra', 'erikoo', 'justinm767', 'jonthomas', 'chanceps', 'clairelee', '1tzm', 'aphuynh', 'becloud', 'qinw', 'slidzbar', 'captaint', 'aychan24', 'lclondon', 'spatank']",5,"['redwing', 'wzongshuo', 'shermang', None, 'hasan10']",85,"['jmchristiansensalameh', 'aashka13', 'kesli', 'avrod2210', 'kbjeppes', 'samadsen', 'ospotash', 'hrowlan', 'funnpun', 'brettrasmus', 'bearman1000', 'sfoster15', 'smejia97', 'jorinna96', 'yharotorres', 'shermang', 'djlindsay', 'rvmathew', 'jazvicmil', 'astubber2016', 'hzhhong', 'aparrish', 'lschroer24', 'kimiigrlz', 'karols.ginting', 'clary0', 'zadeel', 'bryan23', 'nmuthusa', 'wzongshuo', 'agchaveznavarro', 'lizzhop', 'chrispatino', 'panhaoting19', 'hweldy', 'wendell', 'adlt96', 'young260', 'areoman850', 'tonyrtoribio', 'jotap1234', 'aleejay112', 'calcarb', 'timelesserax', 'jotap123', 'jyperez', 'cooleys', 'mtlyons11231', 'carlost88', 'naholte', 'askittrell77', 'hzampaglione', 'alexis01', 'rychu18', 'grantlee9956', 'dechristensen', 'hasan10', 'achoi96', 'rakeil', 'meganlo', 'ssher', 'springchicken', 'jsullan', 'jon22345', 'huimin96', 'dudewhat', 'kohlerc', 'amberpulido16', 'vuthtyra', None, 'erikoo', 'justinm767', 'jonthomas', 'redwing', 'chanceps', 'clairelee', '1tzm', 'aphuynh', 'becloud', 'qinw', 'slidzbar', 'captaint', 'aychan24', 'lclondon', 'spatank']"
8,317,81,14,8,"['cooleys', 'clary0', 'zadeel', 'astubber2016', 'lschroer24', 'hrowlan', 'hweldy', 'brettrasmus']",72,"['jmchristiansensalameh', 'aashka13', 'kesli', 'avrod2210', 'kbjeppes', 'samadsen', 'ospotash', 'funnpun', 'bearman1000', 'sfoster15', 'smejia97', 'jorinna96', 'yharotorres', 'djlindsay', 'rvmathew', 'jazvicmil', 'hzhhong', 'aparrish', 'kimiigrlz', 'karols.ginting', 'bryan23', 'nmuthusa', 'agchaveznavarro', 'lizzhop', 'chrispatino', 'panhaoting19', 'wendell', 'adlt96', 'young260', 'areoman850', 'tonyrtoribio', 'jotap1234', 'aleejay112', 'calcarb', 'timelesserax', 'jotap123', 'jyperez', 'mtlyons11231', 'carlost88', 'naholte', 'askittrell77', 'hzampaglione', 'alexis01', 'rychu18', 'grantlee9956', 'dechristensen', 'achoi96', 'rakeil', 'meganlo', 'ssher', 'springchicken', 'jsullan', 'jon22345', 'huimin96', 'dudewhat', 'kohlerc', 'amberpulido16', 'vuthtyra', 'erikoo', 'justinm767', 'jonthomas', 'chanceps', 'clairelee', '1tzm', 'aphuynh', 'becloud', 'qinw', 'slidzbar', 'captaint', 'aychan24', 'lclondon', 'spatank']",6,"['redwing', 'wzongshuo', 'etopi', 'shermang', None, 'hasan10']",86,"['jmchristiansensalameh', 'aashka13', 'kesli', 'avrod2210', 'kbjeppes', 'samadsen', 'ospotash', 'hrowlan', 'funnpun', 'brettrasmus', 'bearman1000', 'sfoster15', 'smejia97', 'jorinna96', 'yharotorres', 'shermang', 'djlindsay', 'rvmathew', 'jazvicmil', 'astubber2016', 'hzhhong', 'aparrish', 'lschroer24', 'kimiigrlz', 'karols.ginting', 'clary0', 'zadeel', 'bryan23', 'nmuthusa', 'wzongshuo', 'agchaveznavarro', 'lizzhop', 'chrispatino', 'panhaoting19', 'hweldy', 'wendell', 'adlt96', 'young260', 'areoman850', 'tonyrtoribio', 'etopi', 'jotap1234', 'aleejay112', 'calcarb', 'timelesserax', 'jotap123', 'jyperez', 'cooleys', 'mtlyons11231', 'carlost88', 'naholte', 'askittrell77', 'hzampaglione', 'alexis01', 'rychu18', 'grantlee9956', 'dechristensen', 'hasan10', 'achoi96', 'rakeil', 'meganlo', 'ssher', 'springchicken', 'jsullan', 'jon22345', 'huimin96', 'dudewhat', 'kohlerc', 'amberpulido16', 'vuthtyra', None, 'erikoo', 'justinm767', 'jonthomas', 'redwing', 'chanceps', 'clairelee', '1tzm', 'aphuynh', 'becloud', 'qinw', 'slidzbar', 'captaint', 'aychan24', 'lclondon', 'spatank']"
9,47,75,207,28,"['komalbapna.kb', 'kadamk008', 'rehansonarkar784', 'sardesai.kirti18', 'viveky803', 'brian200495', 'vinit95vasudevan', 'pravin45', 'manasi.shinde008', 'lakumveer', 'kondekar23', 'ratsthegreat', 'mihirsawant17', 'ajthamke40', 'sonawane.akshayak', 'vishakha1805', 'dattaram.gawade781', 'abhihadshi', 'vaibhav.gangan7', 'nikhildubey02051996', 'gauravrajeshmehta', 'codekidx', 'pbrahmapurkar', 'suman28pandit', 'rakeshmaity', 'prathameshptkr4', 'rohanchavan', 'cooldudeakshu']",46,"['mukulsathe1995', 'dalvisayli', 'niraj901', 'ektarathod786', 'priyankaingle18', 'dikshabafna1995', 'sumedh_patil', 'bondreanup007', 'a.j.yadav2395', 'omkarn049', 'chiragc9494', 'hbg2112', 'manishashetye1295', 'abhishek.thavare', 'ahire.monali07', 'akshaybadhiye04', 'susmitaahirrao', 'chaudharisuyash7', 'ru1795', 'amritamukeshb', 'deven199570', 'aashish.yadav94', 'priyagajakosh1', 'oindri.c', 'jatin.dhande1008', 'shakyanandk', 'parmitbanga1995', 'ramaprde2296', 'rushabh.fegade', 'chaudharipayal50', 'shahyash027', 'abhishekm2861996', 'sangeetamjoshi', 'mudrasjuee', 'sagarpawar', 'pratikkhanore95', 'salman23011996', 'praju.avhad', 'sagarbhagat43', 'kaustubhgudekar9', 'rakshu.gade', 'danish.dev.007', 'saylishirodkar58', 'sonalipawar589', 'aishwaryamardhekar.24595', 'oma1811']",179,"['nitingurme', 'bhavesh3422', 'jainamshah202', 'aniket187', 'aimomajy', 'nrkhara', 'ajay.raghuwanshi', 'krittikaranga', 'trija68', 'rajdeepd', 'shraddhad', 'rananeetika3', 'mehtajinal3101', 'gujarathikshitij', 'zkoyande', 'minalsawant1108', 'neha.utekar2608', 'himanshuphatak98', 'email.harsh0811', 'arpit32', 'nikitarane245', 'bhoomee.sheth', 'abhishek1996', 'obalgi3095', 'kambe302', 'lakhanmodani1811', 'simran123', 'rajwaje44', 'jayjadav08', 'neelam.chaudhari27', '22diptinikalje', 'sebastian007', 'tanvikalan', 'harshilmehta1995', 'komal31p', 'poojashetty', 'darshanadaund27', 'sam234bryant', 'nagateja.vlsi', 'bhumivora1995', 'geeta.kavitake', 'mapethe', 'sid.rane95', 'suraj.taigade', 'jaidevdalvi', 'monish.kapadia', 'ajinkyachadha', 'divya.upalekar', 'rsawant2895', 'ninad41195', 'purva.desai', 'msumit95', 'patil.rushal825', 'chinmayaniket4052', 'anujakhose94', 'rupali.patil', 'pathanabdulrazzak9524', 'kpiyushbhirud', 'tejasshinde8055', 'siddhesh401', 'sanika.dongre', 'bhavikashenoy95', 'dhvanilmandalia29', 'anasnaik9987', 'mokshada', 'alohomora7', 'pranilraut17', 'suryatejachitturi', 'avinashninawe', 'apoorvasundaresan', 'aditya.apte3', 'prachi.more', 'shivanisharaf15', 'akanksha0196', 'aeyjd', 'shubhamj95', 'monish.nene', 'luke676', 'purva.satpute', 'spooja.1430', 'adwait.sable10', 'pragatinarnaware', 'gsawant999', 'nehadingankar', 'deepikachaman3', 'patelu997', 'mshirali23', 'shwecchajain', 'akshata.kulkarni', 'kadamrupesh1996', 'shweta1811', 'stanabk', 'rohankhollamkar', 'upadhyechinmay', 'juhi.manglani', 'vaishnavi.sambrekar', 'ritesh.shukla', 'mugdha.dalvi', 'amanpal56', 'gupta.ravi1996', 'dipmads', 'rajatkedia95', 'ankurbhagwat8', 'harshal.dangat1', 'florence9344', 'shubham.gaikwad', 'sanjana.advani', 'priyuk', 'priyeshd', 'tanvi.rane1995', 'ambani', 'umeshdarade77', 'tanayshinde21', 'cvvedesh', 'karan.dadlani', 'tejaskanagal95', 'doshishrut1995', 'poojamenon16.pm', 'rahul4peace', 'rahul1995', 'rhea.ann.95', 'rawletanmayee46', 'chaitanyakhachane95', 'rashuidiot', 'minal.patil', 'johebshaikh', 'harshada123', 'mahajanabhi2201', 'abhishekpatkar1796', 'bharathi.pedapudi', 'lakshmi.nair', 'rutvij.supekar', 'mudbidrijay', 'pathakrohan18', 'shreyasvkul', 'mananmehta7', 'chirag184', 'aparnaahari95', 'tarak.shah', 'mervyn.fernandes', 'ashishmohite1996', 'akshayshinde101095', 'manavtrivedi03', 'vivek12195', 'nikhilgade', 'arvindlandge', 'anasnaik25', 'akshay21', 'mukul.kulkarni', 'shraddhag', 'vishaakn', 'amrsha.srivastava', 'apurva.patil', 'bhavesh.singh', 'omkardalvi409', 'shriya.sharma', 'shreyamath95', 'dhruv.gajaria95', 'mohak11jan', 'parthiv.parikh', 'sandipani1995', 'akashspawar148', 'khannamansi312', 'yashgumaste', 'nileshkartik95', 'neilmundhe', 'shreya.mahajan', 'jainam49', 'jakhererahul42', 'tejaschaudhary1996', 'ankita.rahate', 'shamikabachal', 'swapkaru123', 'saheli.konde', 'prashant.baperkar', 'aakashgangolli3112', 'pavitra.iyer', 'guptesoham95', 'ptrimukhe32']",253,"['dikshabafna1995', 'kadamk008', 'rehansonarkar784', 'aimomajy', 'ahire.monali07', 'ajay.raghuwanshi', 'trija68', 'brian200495', 'rananeetika3', 'vinit95vasudevan', 'gujarathikshitij', 'zkoyande', 'minalsawant1108', 'neha.utekar2608', 'email.harsh0811', 'bhoomee.sheth', 'abhishek1996', 'obalgi3095', 'sangeetamjoshi', 'mudrasjuee', 'rajwaje44', 'jayjadav08', '22diptinikalje', 'harshilmehta1995', 'komal31p', 'darshanadaund27', 'bhumivora1995', 'mapethe', 'jaidevdalvi', 'monish.kapadia', 'ratsthegreat', 'ajinkyachadha', 'hbg2112', 'chinmayaniket4052', 'anujakhose94', 'rupali.patil', 'pathanabdulrazzak9524', 'viveky803', 'siddhesh401', 'sanika.dongre', 'chaudharisuyash7', 'manasi.shinde008', 'deven199570', 'bhavikashenoy95', 'dhvanilmandalia29', 'anasnaik9987', 'mokshada', 'alohomora7', 'avinashninawe', 'shivanisharaf15', 'spooja.1430', 'pragatinarnaware', 'deepikachaman3', 'patelu997', 'shwecchajain', 'kadamrupesh1996', 'danish.dev.007', 'shweta1811', 'saylishirodkar58', 'rohankhollamkar', 'aishwaryamardhekar.24595', 'vaishnavi.sambrekar', 'komalbapna.kb', 'mugdha.dalvi', 'rajatkedia95', 'ankurbhagwat8', 'harshal.dangat1', 'shubham.gaikwad', 'sanjana.advani', 'akshaybadhiye04', 'priyeshd', 'tanvi.rane1995', 'susmitaahirrao', 'ambani', 'cvvedesh', 'pravin45', 'oindri.c', 'poojamenon16.pm', 'rahul4peace', 'shahyash027', 'rawletanmayee46', 'ajthamke40', 'rashuidiot', 'minal.patil', 'chaitanyakhachane95', 'harshada123', 'abhihadshi', 'pratikkhanore95', 'bharathi.pedapudi', 'gauravrajeshmehta', 'pbrahmapurkar', 'pathakrohan18', 'shreyasvkul', 'mananmehta7', 'chirag184', 'mukulsathe1995', 'ashishmohite1996', 'manavtrivedi03', 'nikhilgade', 'arvindlandge', 'anasnaik25', 'manishashetye1295', 'mukul.kulkarni', 'sardesai.kirti18', 'vishaakn', 'amrsha.srivastava', 'shriya.sharma', 'lakumveer', 'mohak11jan', 'ramaprde2296', 'rushabh.fegade', 'vishakha1805', 'yashgumaste', 'nileshkartik95', 'neilmundhe', 'jakhererahul42', 'dattaram.gawade781', 'tejaschaudhary1996', 'vaibhav.gangan7', 'shamikabachal', 'kaustubhgudekar9', 'saheli.konde', 'prashant.baperkar', 'aakashgangolli3112', 'prachi.more', 'rohanchavan', 'dalvisayli', 'ektarathod786', 'niraj901', 'nitingurme', 'bhavesh3422', 'omkarn049', 'aniket187', 'jainamshah202', 'nrkhara', 'krittikaranga', 'rajdeepd', 'shraddhad', 'mehtajinal3101', 'himanshuphatak98', 'arpit32', 'nikitarane245', 'chaudharipayal50', 'kambe302', 'lakhanmodani1811', 'simran123', 'tanvikalan', 'neelam.chaudhari27', 'sebastian007', 'praju.avhad', 'poojashetty', 'rakshu.gade', 'sam234bryant', 'nagateja.vlsi', 'geeta.kavitake', 'sid.rane95', 'sonalipawar589', 'suraj.taigade', 'oma1811', 'divya.upalekar', 'rsawant2895', 'ninad41195', 'purva.desai', 'msumit95', 'sumedh_patil', 'a.j.yadav2395', 'chiragc9494', 'patil.rushal825', 'kpiyushbhirud', 'tejasshinde8055', 'ru1795', 'priyagajakosh1', 'aashish.yadav94', 'jatin.dhande1008', 'pranilraut17', 'suryatejachitturi', 'apoorvasundaresan', 'aditya.apte3', 'sonawane.akshayak', 'akanksha0196', 'shubhamj95', 'aeyjd', 'luke676', 'monish.nene', 'purva.satpute', 'adwait.sable10', 'sagarpawar', 'gsawant999', 'nehadingankar', 'mshirali23', 'nikhildubey02051996', 'akshata.kulkarni', 'stanabk', 'upadhyechinmay', 'cooldudeakshu', 'juhi.manglani', 'ritesh.shukla', 'amanpal56', 'gupta.ravi1996', 'dipmads', 'florence9344', 'priyuk', 'umeshdarade77', 'tanayshinde21', 'karan.dadlani', 'tejaskanagal95', 'doshishrut1995', 'kondekar23', 'mihirsawant17', 'rahul1995', 'parmitbanga1995', 'rhea.ann.95', 'johebshaikh', 'mahajanabhi2201', 'abhishekpatkar1796', 'lakshmi.nair', 'rutvij.supekar', 'mudbidrijay', 'codekidx', 'prathameshptkr4', 'aparnaahari95', 'tarak.shah', 'mervyn.fernandes', 'priyankaingle18', 'akshayshinde101095', 'vivek12195', 'bondreanup007', 'abhishek.thavare', 'akshay21', 'shraddhag', 'apurva.patil', 'amritamukeshb', 'bhavesh.singh', 'omkardalvi409', 'shreyamath95', 'dhruv.gajaria95', 'shakyanandk', 'parthiv.parikh', 'sandipani1995', 'akashspawar148', 'khannamansi312', 'abhishekm2861996', 'jainam49', 'shreya.mahajan', 'salman23011996', 'ankita.rahate', 'swapkaru123', 'sagarbhagat43', 'suman28pandit', 'rakeshmaity', 'pavitra.iyer', 'guptesoham95', 'ptrimukhe32']"
9,38,75,170,1,['ratsthegreat'],73,"['mukulsathe1995', 'dalvisayli', 'niraj901', 'komalbapna.kb', 'ektarathod786', 'priyankaingle18', 'dikshabafna1995', 'sumedh_patil', 'kadamk008', 'bondreanup007', 'a.j.yadav2395', 'omkarn049', 'chiragc9494', 'hbg2112', 'manishashetye1295', 'rehansonarkar784', 'abhishek.thavare', 'sardesai.kirti18', 'ahire.monali07', 'viveky803', 'brian200495', 'akshaybadhiye04', 'susmitaahirrao', 'vinit95vasudevan', 'pravin45', 'chaudharisuyash7', 'manasi.shinde008', 'ru1795', 'amritamukeshb', 'deven199570', 'aashish.yadav94', 'priyagajakosh1', 'oindri.c', 'lakumveer', 'jatin.dhande1008', 'kondekar23', 'mihirsawant17', 'shakyanandk', 'parmitbanga1995', 'ramaprde2296', 'rushabh.fegade', 'chaudharipayal50', 'shahyash027', 'ajthamke40', 'abhishekm2861996', 'sonawane.akshayak', 'sangeetamjoshi', 'vishakha1805', 'mudrasjuee', 'dattaram.gawade781', 'abhihadshi', 'sagarpawar', 'pratikkhanore95', 'salman23011996', 'vaibhav.gangan7', 'nikhildubey02051996', 'praju.avhad', 'gauravrajeshmehta', 'codekidx', 'sagarbhagat43', 'kaustubhgudekar9', 'pbrahmapurkar', 'rakshu.gade', 'suman28pandit', 'danish.dev.007', 'rakeshmaity', 'prathameshptkr4', 'saylishirodkar58', 'sonalipawar589', 'rohanchavan', 'aishwaryamardhekar.24595', 'cooldudeakshu', 'oma1811']",169,"['jigneshk2994', 'yashsavle', 'tejuliman74', 'harshitbangera', 'ishmeetsingh', 'sanketh728', 'swatimane176', 'karan.marketkar', 'rushikeshjoshi285', 'rnair15', 'shreyasawant95', 'viraktdoshi19', 'udayyewale17', 'karan.gondalia', 'patilroshan1128', 'kumarvivek017', 'rohitpuri.g', 'gurmukhsingh0108', 'amit.dutta', 'sush81194', 'rishabh4745', 'tambeneha94', 'rukhsrd', 'nair19shruti', 'happyridermrk', 'gadhiyakenil16', 'abauti608', 'sadiqqureshi393', 'rutu123', 'jiteshkjsp', 'aniketshelar79', 'sachimalkan', 'sgat3451', 'jaysawant2', 'ykhedikar', 'ishaan.sathe', 'mapethe', 'amruteshpatil', 'pateltejash96', 'tandelsneha15', 'doshi.kavisha16', 'tajpara.nikhil', 'miteshmohokar', 'g3jithinn', 'kapilaherkar755', 'sweta151945', 'dhairyagada1997', 'pruthavi.c', 'akansha319892', 'vjseedan', 'vishal.chavda', 'nairprasad007', 'joshua0667', 'hardrider95', 'ankitferry123', 'priyankadeshpande177', 'hardik.upadhyay', '1jyotsna1', 'prasad.m', 'parmarmayur05', 'nikj816', 'smajumdar', 'rrnair291293', 'nikuldengada493', 'ankur.shah', 'princeporje98', 'suraj6111994', 'yogeshwar21121995', 'parthkaushikdave', 'nilesh.delekar', 'ameymalotkar1', 'pareshnaik1995', 'gopal.singh', 'nehaaltawade1', 's.jadeja', 'melchiznadar', 'poojaparab9035', 'nikhil4241307', 'pdeshpande', 'peshinakash', 'kiranjadhav050994', 'abinbenny8', 'ashupalambe1992', 'abinaya67006', 'ajitjadhav', 'machalke92', 'yogi.6692', 'devyani.salvi1028', 'qwertynishit', 'verma.amitkumar95', 'florence9344', 'anuradha.d', 'satya_mishra', 'shraddhakharde01', 'inderjitsingh87', 'kypptl', 'lino2296', 'sharma.ayushi8c', 'sbodke', 'aqudas29', 'khedikaryash8', 'tgpatil22791', 'vijaykothari97', 'pranithsuvarna1', 'mauryashubham564', 'vijaya', 'shaminakunnel', 'rahulbadekar', 'arawal14.ar', 'raoashish96', 'parag.choughule', 'asingh12', 'parag16593', 'jigar', 'shivam_cr7', 'udit.shah', 'vishakha', 'tdholpuria', 'atoraskar12', 'mkadam03', 'walavalkarmayur79', 'ankitagharat93', 'somil910', 'aanugraha', 'shubhrapatil77', 'gkapil45', 'rushabh.soni', 'mayuripatil3095', 'tanujudani865', 'sonihetvi10', 'aniketa.yelave49', 'jadhavankita9969', 'sujataredkar', 'rautt59', 'rjoshi02', 'karankyp', 'adwaitvajpe', 'anevrekar', 'yayatipawar601', 'akash.mali3477', 'karantank97', 'akashmore456', 'surajkarade.2', 'pranav.gori', 'patilvarad2011', 'palak1012', 'apekshapawar', 'ramanujsingh004', 'keyur.gajjar', 'pranilghogale', 'pripatil285', 'desaivighnesh95', None, 'burhan.naim', 'd.shenoy', 'ashish.mrya1', 'ankith89', 'priyanka.bhangre', 'rutwijajoshi10', 'karanshah30', 'agarwal.gagan5101', 'anshujha95', 'vedy1811', 'chaitanyakhane999', 'tushar.gaikwad', 'gaurav.gadre', 'sourabhbelose', 'varun1997', 'abhiramibp95']",243,"['jigneshk2994', 'dalvisayli', 'yashsavle', 'ektarathod786', 'niraj901', 'dikshabafna1995', 'tejuliman74', 'kadamk008', 'harshitbangera', 'omkarn049', 'ishmeetsingh', 'rehansonarkar784', 'sanketh728', 'swatimane176', 'ahire.monali07', 'karan.marketkar', 'brian200495', 'rushikeshjoshi285', 'rnair15', 'shreyasawant95', 'viraktdoshi19', 'vinit95vasudevan', 'udayyewale17', 'karan.gondalia', 'patilroshan1128', 'kumarvivek017', 'rohitpuri.g', 'gurmukhsingh0108', 'amit.dutta', 'sush81194', 'rishabh4745', 'tambeneha94', 'rukhsrd', 'nair19shruti', 'happyridermrk', 'chaudharipayal50', 'gadhiyakenil16', 'abauti608', 'sangeetamjoshi', 'mudrasjuee', 'hardik.upadhyay', 'sadiqqureshi393', 'rutu123', 'jiteshkjsp', 'aniketshelar79', 'sachimalkan', 'praju.avhad', 'sgat3451', 'jaysawant2', 'ykhedikar', 'rakshu.gade', 'ishaan.sathe', 'mapethe', 'sonalipawar589', 'amruteshpatil', 'pateltejash96', 'ratsthegreat', 'oma1811', 'tandelsneha15', 'doshi.kavisha16', 'tajpara.nikhil', 'miteshmohokar', 'g3jithinn', 'sumedh_patil', 'kapilaherkar755', 'sweta151945', 'a.j.yadav2395', 'chiragc9494', 'hbg2112', 'dhairyagada1997', 'pruthavi.c', 'akansha319892', 'viveky803', 'vjseedan', 'vishal.chavda', 'chaudharisuyash7', 'manasi.shinde008', 'ru1795', 'nairprasad007', 'deven199570', 'priyagajakosh1', 'aashish.yadav94', 'joshua0667', 'hardrider95', 'jatin.dhande1008', 'ankitferry123', 'priyankadeshpande177', '1jyotsna1', 'prasad.m', 'parmarmayur05', 'nikj816', 'smajumdar', 'rrnair291293', 'sonawane.akshayak', 'nikuldengada493', 'ankur.shah', 'sagarpawar', 'princeporje98', 'suraj6111994', 'yogeshwar21121995', 'parthkaushikdave', 'nilesh.delekar', 'nikhildubey02051996', 'ameymalotkar1', 'pareshnaik1995', 'gopal.singh', 'nehaaltawade1', 's.jadeja', 'melchiznadar', 'poojaparab9035', 'nikhil4241307', 'danish.dev.007', 'pdeshpande', 'peshinakash', 'saylishirodkar58', 'kiranjadhav050994', 'abinbenny8', 'aishwaryamardhekar.24595', 'ashupalambe1992', 'abinaya67006', 'cooldudeakshu', 'ajitjadhav', 'machalke92', 'komalbapna.kb', 'yogi.6692', 'devyani.salvi1028', 'qwertynishit', 'verma.amitkumar95', 'florence9344', 'akshaybadhiye04', 'anuradha.d', 'satya_mishra', 'susmitaahirrao', 'shraddhakharde01', 'pravin45', 'inderjitsingh87', 'kypptl', 'lino2296', 'sharma.ayushi8c', 'oindri.c', 'sbodke', 'kondekar23', 'aqudas29', 'khedikaryash8', 'mihirsawant17', 'tgpatil22791', 'parmitbanga1995', 'vijaykothari97', 'shahyash027', 'pranithsuvarna1', 'ajthamke40', 'mauryashubham564', 'vijaya', 'abhihadshi', 'shaminakunnel', 'pratikkhanore95', 'rahulbadekar', 'arawal14.ar', 'raoashish96', 'parag.choughule', 'gauravrajeshmehta', 'asingh12', 'parag16593', 'codekidx', 'jigar', 'shivam_cr7', 'pbrahmapurkar', 'udit.shah', 'vishakha', 'prathameshptkr4', 'tdholpuria', 'atoraskar12', 'mkadam03', 'walavalkarmayur79', 'ankitagharat93', 'somil910', 'aanugraha', 'mukulsathe1995', 'shubhrapatil77', 'gkapil45', 'rushabh.soni', 'priyankaingle18', 'mayuripatil3095', 'tanujudani865', 'sonihetvi10', 'bondreanup007', 'aniketa.yelave49', 'jadhavankita9969', 'sujataredkar', 'manishashetye1295', 'rautt59', 'rjoshi02', 'abhishek.thavare', 'sardesai.kirti18', 'karankyp', 'adwaitvajpe', 'anevrekar', 'yayatipawar601', 'akash.mali3477', 'karantank97', 'akashmore456', 'amritamukeshb', 'surajkarade.2', 'lakumveer', 'pranav.gori', 'patilvarad2011', 'palak1012', 'apekshapawar', 'shakyanandk', 'ramaprde2296', 'ramanujsingh004', 'rushabh.fegade', 'abhishekm2861996', 'vishakha1805', 'keyur.gajjar', 'pranilghogale', 'pripatil285', 'dattaram.gawade781', 'desaivighnesh95', None, 'burhan.naim', 'd.shenoy', 'salman23011996', 'vaibhav.gangan7', 'ashish.mrya1', 'ankith89', 'sagarbhagat43', 'kaustubhgudekar9', 'priyanka.bhangre', 'rutwijajoshi10', 'suman28pandit', 'karanshah30', 'agarwal.gagan5101', 'rakeshmaity', 'anshujha95', 'vedy1811', 'chaitanyakhane999', 'tushar.gaikwad', 'gaurav.gadre', 'rohanchavan', 'sourabhbelose', 'varun1997', 'abhiramibp95']"
9,207,75,132,72,"['mukulsathe1995', 'dalvisayli', 'niraj901', 'komalbapna.kb', 'ektarathod786', 'priyankaingle18', 'dikshabafna1995', 'sumedh_patil', 'kadamk008', 'bondreanup007', 'a.j.yadav2395', 'omkarn049', 'chiragc9494', 'hbg2112', 'manishashetye1295', 'abhishek.thavare', 'sardesai.kirti18', 'ahire.monali07', 'viveky803', 'brian200495', 'akshaybadhiye04', 'susmitaahirrao', 'vinit95vasudevan', 'pravin45', 'chaudharisuyash7', 'manasi.shinde008', 'ru1795', 'amritamukeshb', 'deven199570', 'aashish.yadav94', 'priyagajakosh1', 'oindri.c', 'jatin.dhande1008', 'kondekar23', 'ratsthegreat', 'mihirsawant17', 'shakyanandk', 'parmitbanga1995', 'ramaprde2296', 'rushabh.fegade', 'chaudharipayal50', 'shahyash027', 'ajthamke40', 'abhishekm2861996', 'sonawane.akshayak', 'sangeetamjoshi', 'vishakha1805', 'mudrasjuee', 'dattaram.gawade781', 'abhihadshi', 'sagarpawar', 'pratikkhanore95', 'salman23011996', 'vaibhav.gangan7', 'nikhildubey02051996', 'praju.avhad', 'gauravrajeshmehta', 'codekidx', 'sagarbhagat43', 'kaustubhgudekar9', 'pbrahmapurkar', 'rakshu.gade', 'suman28pandit', 'danish.dev.007', 'rakeshmaity', 'prathameshptkr4', 'saylishirodkar58', 'sonalipawar589', 'rohanchavan', 'aishwaryamardhekar.24595', 'cooldudeakshu', 'oma1811']",2,"['lakumveer', 'rehansonarkar784']",60,"['snehakudtarkar315', 'rahulmhapsekar7', 'khadekunal1', 'palswati0309', 'rohitbaliyan53', 'sagar.pawar35418', 'bhakti961', 'viprajapatil', 'kumarrahul050892', 'aniketmane42', 'iabhishek555', 'infinite2205', 'dhartinano19', 'yashapeejay', 'sandeeprock023', 'saurabh.gharat96', 'tejaskanagal95', 'aniketkulaye618', 'ambeskaradvait', 'spranav3004', 'priyankakamble', 'bk357357', 'manalihedaoo4', 'poojavagre12', 'nehah95', 'suyogk.1995', 'sailee.mohite', 'adigame18', 'pranilraut17', 'dandekarmd73', 'shivamchaube', 'ameypatil29', 'sahilshaikh827', 'tanayshinde123', 'mishrahenry007', 'shreyashpawar96', 'spooja.1430', 'mongya00', 'dattaramkolekar', 'nikitamalvade', None, 'sebastian007', 'srikalaprabhu', 'ssy506804', 'gidayegirish', 'nikhildabholkar4', 'sawantgaurig25', 'rohinipatil404', 'siddhiambre111', 'mitesh.dangle', 'namrata05', 'vinodgadge95', 'snehawaghe21', 'chandraman.patil', 'shubhambeldar547', 'pranay9.ithawar', 'sid.rane95', 'sayalipatil4545', 'saurabhmangeshkar', 'vaibhavgaikar62']",134,"['dalvisayli', 'ektarathod786', 'niraj901', 'khadekunal1', 'dikshabafna1995', 'kadamk008', 'omkarn049', 'sagar.pawar35418', 'rehansonarkar784', 'ahire.monali07', 'brian200495', 'vinit95vasudevan', 'infinite2205', 'dhartinano19', 'saurabh.gharat96', 'sailee.mohite', 'suyogk.1995', 'nehah95', 'chaudharipayal50', 'dandekarmd73', 'tanayshinde123', 'sangeetamjoshi', 'mudrasjuee', 'sebastian007', 'nikhildabholkar4', 'praju.avhad', 'rakshu.gade', 'snehawaghe21', 'sid.rane95', 'sonalipawar589', 'ratsthegreat', 'oma1811', 'rahulmhapsekar7', 'sumedh_patil', 'a.j.yadav2395', 'chiragc9494', 'hbg2112', 'bhakti961', 'kumarrahul050892', 'viveky803', 'yashapeejay', 'sandeeprock023', 'chaudharisuyash7', 'manasi.shinde008', 'ru1795', 'deven199570', 'priyagajakosh1', 'aashish.yadav94', 'ambeskaradvait', 'spranav3004', 'jatin.dhande1008', 'priyankakamble', 'manalihedaoo4', 'pranilraut17', 'shivamchaube', 'sonawane.akshayak', 'spooja.1430', 'mongya00', 'dattaramkolekar', 'sagarpawar', 'nikitamalvade', 'nikhildubey02051996', 'mitesh.dangle', 'danish.dev.007', 'saylishirodkar58', 'sayalipatil4545', 'aishwaryamardhekar.24595', 'cooldudeakshu', 'snehakudtarkar315', 'komalbapna.kb', 'viprajapatil', 'aniketmane42', 'akshaybadhiye04', 'iabhishek555', 'susmitaahirrao', 'pravin45', 'tejaskanagal95', 'aniketkulaye618', 'bk357357', 'oindri.c', 'kondekar23', 'poojavagre12', 'mihirsawant17', 'adigame18', 'parmitbanga1995', 'shahyash027', 'ajthamke40', 'mishrahenry007', 'shreyashpawar96', 'abhihadshi', 'pratikkhanore95', 'srikalaprabhu', 'gidayegirish', 'gauravrajeshmehta', 'codekidx', 'pbrahmapurkar', 'vinodgadge95', 'prathameshptkr4', 'shubhambeldar547', 'saurabhmangeshkar', 'mukulsathe1995', 'priyankaingle18', 'palswati0309', 'bondreanup007', 'rohitbaliyan53', 'manishashetye1295', 'abhishek.thavare', 'sardesai.kirti18', 'amritamukeshb', 'lakumveer', 'shakyanandk', 'ramaprde2296', 'rushabh.fegade', 'abhishekm2861996', 'ameypatil29', 'vishakha1805', 'sahilshaikh827', 'dattaram.gawade781', None, 'salman23011996', 'ssy506804', 'vaibhav.gangan7', 'sawantgaurig25', 'rohinipatil404', 'siddhiambre111', 'sagarbhagat43', 'kaustubhgudekar9', 'namrata05', 'suman28pandit', 'chandraman.patil', 'rakeshmaity', 'pranay9.ithawar', 'rohanchavan', 'vaibhavgaikar62']"
9,42,75,114,62,"['mukulsathe1995', 'dalvisayli', 'niraj901', 'komalbapna.kb', 'ektarathod786', 'priyankaingle18', 'dikshabafna1995', 'sumedh_patil', 'bondreanup007', 'a.j.yadav2395', 'omkarn049', 'chiragc9494', 'hbg2112', 'manishashetye1295', 'abhishek.thavare', 'sardesai.kirti18', 'ahire.monali07', 'viveky803', 'akshaybadhiye04', 'susmitaahirrao', 'vinit95vasudevan', 'pravin45', 'chaudharisuyash7', 'ru1795', 'amritamukeshb', 'deven199570', 'aashish.yadav94', 'priyagajakosh1', 'oindri.c', 'lakumveer', 'jatin.dhande1008', 'ratsthegreat', 'shakyanandk', 'ramaprde2296', 'rushabh.fegade', 'chaudharipayal50', 'shahyash027', 'abhishekm2861996', 'sonawane.akshayak', 'sangeetamjoshi', 'vishakha1805', 'mudrasjuee', 'dattaram.gawade781', 'abhihadshi', 'sagarpawar', 'pratikkhanore95', 'nikhildubey02051996', 'praju.avhad', 'gauravrajeshmehta', 'sagarbhagat43', 'kaustubhgudekar9', 'pbrahmapurkar', 'rakshu.gade', 'suman28pandit', 'danish.dev.007', 'rakeshmaity', 'saylishirodkar58', 'sonalipawar589', 'rohanchavan', 'aishwaryamardhekar.24595', 'cooldudeakshu', 'oma1811']",12,"['salman23011996', 'brian200495', 'parmitbanga1995', 'vaibhav.gangan7', 'ajthamke40', 'codekidx', 'manasi.shinde008', 'kadamk008', 'prathameshptkr4', 'rehansonarkar784', 'kondekar23', 'mihirsawant17']",52,"['sankpalami', 'shrutikayadav2oct', 'tarak.shah', 'rsawant2895', 'adipatil37', 'niteshnarkar712', 'rohitbaliyan53', 'tanyabaptist05', 'bkadam357', 'sahilsk7', 'varadrajnanaware7', 'sammit1844', 'iabhishek555', 'tejasshinde8055', 'pankajpawar1515', 'umeshdarade77', 'tanayshinde21', 'infinite1309', 'sanketsalvi03', 'sandesh29', 'tejaskanagal95', 'minalsawant143', 'pratikthorat10', 'aniket2602', 'aditya1818', 'abarge31', 'rawletanmayee46', 'akashspawar148', 'shraddha0306', 'cpatil152', 'ravina.chavan42', 'ritesh.parulekar231194', 'mahajanabhi2201', 'vijaybhargude2', 'advenraju', 'gsawant999', 'supu1796', None, 'sebastian007', 'preetywagh95', 'prajaktachapte2', 'gidayegirish', 'ashwini12rajput', 'shrikantnimse14', 'prashant.baperkar', 'sam234bryant', 'swati123', 'sayalipatil4545', 'saurabhmangeshkar', 'bimal.biswas8', 'shrutisundar019', 'ptrimukhe32']",126,"['sankpalami', 'shrutikayadav2oct', 'dalvisayli', 'ektarathod786', 'niraj901', 'dikshabafna1995', 'kadamk008', 'adipatil37', 'niteshnarkar712', 'omkarn049', 'rehansonarkar784', 'sahilsk7', 'ahire.monali07', 'brian200495', 'vinit95vasudevan', 'minalsawant143', 'chaudharipayal50', 'shraddha0306', 'sangeetamjoshi', 'mudrasjuee', 'vijaybhargude2', 'sebastian007', 'ashwini12rajput', 'praju.avhad', 'rakshu.gade', 'sam234bryant', 'sonalipawar589', 'ratsthegreat', 'oma1811', 'rsawant2895', 'sumedh_patil', 'a.j.yadav2395', 'chiragc9494', 'hbg2112', 'varadrajnanaware7', 'viveky803', 'tejasshinde8055', 'chaudharisuyash7', 'manasi.shinde008', 'ru1795', 'deven199570', 'priyagajakosh1', 'aashish.yadav94', 'pratikthorat10', 'jatin.dhande1008', 'aniket2602', 'aditya1818', 'sonawane.akshayak', 'sagarpawar', 'gsawant999', 'prajaktachapte2', 'nikhildubey02051996', 'danish.dev.007', 'saylishirodkar58', 'sayalipatil4545', 'aishwaryamardhekar.24595', 'cooldudeakshu', 'komalbapna.kb', 'akshaybadhiye04', 'iabhishek555', 'pankajpawar1515', 'susmitaahirrao', 'umeshdarade77', 'tanayshinde21', 'infinite1309', 'pravin45', 'tejaskanagal95', 'oindri.c', 'kondekar23', 'abarge31', 'mihirsawant17', 'parmitbanga1995', 'shahyash027', 'rawletanmayee46', 'ajthamke40', 'mahajanabhi2201', 'advenraju', 'abhihadshi', 'supu1796', 'pratikkhanore95', 'preetywagh95', 'gidayegirish', 'shrikantnimse14', 'gauravrajeshmehta', 'codekidx', 'pbrahmapurkar', 'prathameshptkr4', 'swati123', 'saurabhmangeshkar', 'shrutisundar019', 'ravina.chavan42', 'mukulsathe1995', 'tarak.shah', 'priyankaingle18', 'bondreanup007', 'rohitbaliyan53', 'tanyabaptist05', 'bkadam357', 'manishashetye1295', 'abhishek.thavare', 'sardesai.kirti18', 'sammit1844', 'sanketsalvi03', 'sandesh29', 'amritamukeshb', 'lakumveer', 'shakyanandk', 'ramaprde2296', 'rushabh.fegade', 'akashspawar148', 'cpatil152', 'abhishekm2861996', 'ritesh.parulekar231194', 'vishakha1805', 'dattaram.gawade781', None, 'salman23011996', 'vaibhav.gangan7', 'sagarbhagat43', 'kaustubhgudekar9', 'prashant.baperkar', 'suman28pandit', 'rakeshmaity', 'rohanchavan', 'bimal.biswas8', 'ptrimukhe32']"
9,51,75,67,3,"['ajthamke40', 'chiragc9494', 'salman23011996']",71,"['mukulsathe1995', 'dalvisayli', 'niraj901', 'komalbapna.kb', 'ektarathod786', 'priyankaingle18', 'dikshabafna1995', 'sumedh_patil', 'kadamk008', 'bondreanup007', 'a.j.yadav2395', 'omkarn049', 'hbg2112', 'manishashetye1295', 'rehansonarkar784', 'abhishek.thavare', 'sardesai.kirti18', 'ahire.monali07', 'viveky803', 'brian200495', 'akshaybadhiye04', 'susmitaahirrao', 'vinit95vasudevan', 'pravin45', 'chaudharisuyash7', 'manasi.shinde008', 'ru1795', 'amritamukeshb', 'deven199570', 'aashish.yadav94', 'priyagajakosh1', 'oindri.c', 'lakumveer', 'jatin.dhande1008', 'kondekar23', 'ratsthegreat', 'mihirsawant17', 'shakyanandk', 'parmitbanga1995', 'ramaprde2296', 'rushabh.fegade', 'chaudharipayal50', 'shahyash027', 'abhishekm2861996', 'sonawane.akshayak', 'sangeetamjoshi', 'vishakha1805', 'mudrasjuee', 'dattaram.gawade781', 'abhihadshi', 'sagarpawar', 'pratikkhanore95', 'vaibhav.gangan7', 'nikhildubey02051996', 'praju.avhad', 'gauravrajeshmehta', 'codekidx', 'sagarbhagat43', 'kaustubhgudekar9', 'pbrahmapurkar', 'rakshu.gade', 'suman28pandit', 'danish.dev.007', 'rakeshmaity', 'prathameshptkr4', 'saylishirodkar58', 'sonalipawar589', 'rohanchavan', 'aishwaryamardhekar.24595', 'cooldudeakshu', 'oma1811']",64,"['danishdewani112795', 'ishita.choudhary', 'rushabh.soni', 'arunnambiar66', 'maithili010', 'raku1109', 'jogichetan96', 'akshaybangera95', 'suthar.kalpesh57', 'sjunghareakshay', 'soorajdinesan27', 'harshit0610', 'trishapatkar19', 'alisha.alice.panicker', 'apoorvakraut', 'zeuswinchester456', 'karantank97', 'shraddhakharde01', 'priyankapandya19', 'nivipetkar', 'doshishrut1995', 'akashmore456', 'omkardalvi409', 'shubhamjambhe8', 'manisha.shetty07', 'jayeshkhandagle123', 'kiranrelekar412', 'dhvanilmandalia29', 'varma096', 'ranjuvarughese', 'himanshuphatak98', 'shukla.pawan249', 'jaidevdalvi', 'sarveshgrao', 'kanchan.sawant17', 'rhea.ann.95', 'shubhangi.matey', 'pranilraut17', 'anuragshyam1026', 'jitesh.10', 'rashuidiot', 'akshay1995', 'kambe302', 'akanksha0196', 'ayyappakonar', 'jenna', 'shafaanbhai', 'ttanmay.telang75', None, 'shevekarrohan', 'shrinathnair', 'sahil8rai', 'deepikachaman3', 'd.shenoy', 'varadmeradost', 'asingh12', 'chandramani.yadav43', 'darshanadaund27', 'srishti.shriyan96', 'tejask2610', 'vivek.sakinala', 'upadhyechinmay', 'joijodegauri7', 'dishakulkarni25']",138,"['dalvisayli', 'ektarathod786', 'komalbapna.kb', 'niraj901', 'dikshabafna1995', 'kadamk008', 'omkarn049', 'raku1109', 'jogichetan96', 'rehansonarkar784', 'sjunghareakshay', 'ahire.monali07', 'brian200495', 'akshaybadhiye04', 'susmitaahirrao', 'vinit95vasudevan', 'apoorvakraut', 'shraddhakharde01', 'pravin45', 'doshishrut1995', 'oindri.c', 'manisha.shetty07', 'jayeshkhandagle123', 'kondekar23', 'ranjuvarughese', 'himanshuphatak98', 'mihirsawant17', 'rhea.ann.95', 'parmitbanga1995', 'chaudharipayal50', 'shahyash027', 'ajthamke40', 'anuragshyam1026', 'rashuidiot', 'jitesh.10', 'akshay1995', 'kambe302', 'sangeetamjoshi', 'joijodegauri7', 'mudrasjuee', 'shafaanbhai', 'abhihadshi', 'pratikkhanore95', 'sahil8rai', 'varadmeradost', 'praju.avhad', 'gauravrajeshmehta', 'asingh12', 'codekidx', 'darshanadaund27', 'pbrahmapurkar', 'rakshu.gade', 'prathameshptkr4', 'vivek.sakinala', 'sonalipawar589', 'jenna', 'jaidevdalvi', 'ratsthegreat', 'oma1811', 'mukulsathe1995', 'danishdewani112795', 'ishita.choudhary', 'rushabh.soni', 'priyankaingle18', 'sumedh_patil', 'bondreanup007', 'a.j.yadav2395', 'chiragc9494', 'hbg2112', 'arunnambiar66', 'maithili010', 'manishashetye1295', 'akshaybangera95', 'suthar.kalpesh57', 'abhishek.thavare', 'sardesai.kirti18', 'soorajdinesan27', 'harshit0610', 'viveky803', 'trishapatkar19', 'alisha.alice.panicker', 'zeuswinchester456', 'karantank97', 'chaudharisuyash7', 'manasi.shinde008', 'ru1795', 'priyankapandya19', 'amritamukeshb', 'deven199570', 'aashish.yadav94', 'priyagajakosh1', 'nivipetkar', 'lakumveer', 'jatin.dhande1008', 'akashmore456', 'omkardalvi409', 'shubhamjambhe8', 'kiranrelekar412', 'dhvanilmandalia29', 'varma096', 'shukla.pawan249', 'shakyanandk', 'sarveshgrao', 'kanchan.sawant17', 'ramaprde2296', 'shubhangi.matey', 'pranilraut17', 'rushabh.fegade', 'abhishekm2861996', 'sonawane.akshayak', 'vishakha1805', 'akanksha0196', 'ayyappakonar', 'ttanmay.telang75', 'dattaram.gawade781', 'sagarpawar', None, 'shevekarrohan', 'shrinathnair', 'deepikachaman3', 'd.shenoy', 'salman23011996', 'vaibhav.gangan7', 'nikhildubey02051996', 'chandramani.yadav43', 'sagarbhagat43', 'kaustubhgudekar9', 'srishti.shriyan96', 'suman28pandit', 'danish.dev.007', 'tejask2610', 'rakeshmaity', 'saylishirodkar58', 'upadhyechinmay', 'rohanchavan', 'aishwaryamardhekar.24595', 'dishakulkarni25', 'cooldudeakshu']"
9,40,75,30,9,"['shakyanandk', 'mukulsathe1995', 'parmitbanga1995', 'akshaybadhiye04', 'bondreanup007', 'a.j.yadav2395', 'hbg2112', 'sagarpawar', 'ratsthegreat']",65,"['dalvisayli', 'niraj901', 'komalbapna.kb', 'ektarathod786', 'priyankaingle18', 'dikshabafna1995', 'sumedh_patil', 'kadamk008', 'omkarn049', 'chiragc9494', 'manishashetye1295', 'rehansonarkar784', 'abhishek.thavare', 'sardesai.kirti18', 'ahire.monali07', 'viveky803', 'brian200495', 'susmitaahirrao', 'vinit95vasudevan', 'pravin45', 'chaudharisuyash7', 'manasi.shinde008', 'ru1795', 'amritamukeshb', 'deven199570', 'aashish.yadav94', 'priyagajakosh1', 'oindri.c', 'lakumveer', 'jatin.dhande1008', 'kondekar23', 'mihirsawant17', 'ramaprde2296', 'rushabh.fegade', 'chaudharipayal50', 'shahyash027', 'ajthamke40', 'abhishekm2861996', 'sonawane.akshayak', 'sangeetamjoshi', 'vishakha1805', 'mudrasjuee', 'dattaram.gawade781', 'abhihadshi', 'pratikkhanore95', 'salman23011996', 'vaibhav.gangan7', 'nikhildubey02051996', 'praju.avhad', 'gauravrajeshmehta', 'codekidx', 'sagarbhagat43', 'kaustubhgudekar9', 'pbrahmapurkar', 'rakshu.gade', 'suman28pandit', 'danish.dev.007', 'rakeshmaity', 'prathameshptkr4', 'saylishirodkar58', 'sonalipawar589', 'rohanchavan', 'aishwaryamardhekar.24595', 'cooldudeakshu', 'oma1811']",21,"['tanyabaptist05', 'anasnaik25', 'shriya.h.joshi', 'anujakhose94', 'iabhishek555', 'sanketsalvi03', 'shreyamath95', 'arpit32', 'shraddha0306', 'ritesh.parulekar231194', 'vaibhavghare94', 'neilmundhe', 'heramb10', None, 'sebastian007', 'smonica498', 'prajaktachapte2', 'patelu997', 'prp23dec', 'mohiteashwin7', 'mapethe']",95,"['dalvisayli', 'ektarathod786', 'komalbapna.kb', 'niraj901', 'dikshabafna1995', 'kadamk008', 'omkarn049', 'rehansonarkar784', 'ahire.monali07', 'brian200495', 'akshaybadhiye04', 'iabhishek555', 'susmitaahirrao', 'vinit95vasudevan', 'pravin45', 'oindri.c', 'kondekar23', 'mihirsawant17', 'parmitbanga1995', 'arpit32', 'chaudharipayal50', 'shahyash027', 'ajthamke40', 'shraddha0306', 'sangeetamjoshi', 'mudrasjuee', 'heramb10', 'abhihadshi', 'pratikkhanore95', 'sebastian007', 'smonica498', 'praju.avhad', 'gauravrajeshmehta', 'codekidx', 'pbrahmapurkar', 'rakshu.gade', 'prathameshptkr4', 'mapethe', 'sonalipawar589', 'ratsthegreat', 'oma1811', 'mukulsathe1995', 'priyankaingle18', 'sumedh_patil', 'bondreanup007', 'a.j.yadav2395', 'chiragc9494', 'hbg2112', 'tanyabaptist05', 'anasnaik25', 'manishashetye1295', 'abhishek.thavare', 'shriya.h.joshi', 'sardesai.kirti18', 'anujakhose94', 'viveky803', 'chaudharisuyash7', 'manasi.shinde008', 'ru1795', 'sanketsalvi03', 'amritamukeshb', 'deven199570', 'aashish.yadav94', 'priyagajakosh1', 'lakumveer', 'jatin.dhande1008', 'shreyamath95', 'shakyanandk', 'ramaprde2296', 'rushabh.fegade', 'abhishekm2861996', 'ritesh.parulekar231194', 'sonawane.akshayak', 'vishakha1805', 'vaibhavghare94', 'neilmundhe', 'dattaram.gawade781', 'sagarpawar', None, 'prajaktachapte2', 'salman23011996', 'patelu997', 'vaibhav.gangan7', 'nikhildubey02051996', 'prp23dec', 'sagarbhagat43', 'kaustubhgudekar9', 'mohiteashwin7', 'suman28pandit', 'danish.dev.007', 'rakeshmaity', 'saylishirodkar58', 'rohanchavan', 'aishwaryamardhekar.24595', 'cooldudeakshu']"
9,209,75,12,7,"['gauravrajeshmehta', 'sumedh_patil', 'pravin45', 'pbrahmapurkar', 'suman28pandit', 'rakeshmaity', 'dattaram.gawade781']",67,"['dalvisayli', 'ektarathod786', 'komalbapna.kb', 'niraj901', 'dikshabafna1995', 'kadamk008', 'omkarn049', 'rehansonarkar784', 'ahire.monali07', 'brian200495', 'akshaybadhiye04', 'susmitaahirrao', 'vinit95vasudevan', 'oindri.c', 'kondekar23', 'mihirsawant17', 'parmitbanga1995', 'chaudharipayal50', 'shahyash027', 'ajthamke40', 'sangeetamjoshi', 'mudrasjuee', 'abhihadshi', 'pratikkhanore95', 'praju.avhad', 'codekidx', 'rakshu.gade', 'prathameshptkr4', 'sonalipawar589', 'ratsthegreat', 'oma1811', 'mukulsathe1995', 'priyankaingle18', 'bondreanup007', 'a.j.yadav2395', 'chiragc9494', 'hbg2112', 'manishashetye1295', 'abhishek.thavare', 'sardesai.kirti18', 'viveky803', 'chaudharisuyash7', 'manasi.shinde008', 'ru1795', 'amritamukeshb', 'deven199570', 'aashish.yadav94', 'priyagajakosh1', 'lakumveer', 'jatin.dhande1008', 'shakyanandk', 'ramaprde2296', 'rushabh.fegade', 'abhishekm2861996', 'sonawane.akshayak', 'vishakha1805', 'sagarpawar', 'salman23011996', 'vaibhav.gangan7', 'nikhildubey02051996', 'sagarbhagat43', 'kaustubhgudekar9', 'danish.dev.007', 'saylishirodkar58', 'rohanchavan', 'aishwaryamardhekar.24595', 'cooldudeakshu']",5,"['tanayshinde123', 'tejaskanagal95', 'chandraman.patil', 'anicaptaincool', None]",79,"['dalvisayli', 'ektarathod786', 'komalbapna.kb', 'niraj901', 'dikshabafna1995', 'kadamk008', 'omkarn049', 'rehansonarkar784', 'ahire.monali07', 'brian200495', 'akshaybadhiye04', 'susmitaahirrao', 'vinit95vasudevan', 'pravin45', 'tejaskanagal95', 'oindri.c', 'kondekar23', 'mihirsawant17', 'parmitbanga1995', 'chaudharipayal50', 'shahyash027', 'ajthamke40', 'tanayshinde123', 'sangeetamjoshi', 'mudrasjuee', 'anicaptaincool', 'abhihadshi', 'pratikkhanore95', 'praju.avhad', 'gauravrajeshmehta', 'codekidx', 'pbrahmapurkar', 'rakshu.gade', 'prathameshptkr4', 'sonalipawar589', 'ratsthegreat', 'oma1811', 'mukulsathe1995', 'priyankaingle18', 'sumedh_patil', 'bondreanup007', 'a.j.yadav2395', 'chiragc9494', 'hbg2112', 'manishashetye1295', 'abhishek.thavare', 'sardesai.kirti18', 'viveky803', 'chaudharisuyash7', 'manasi.shinde008', 'ru1795', 'amritamukeshb', 'deven199570', 'aashish.yadav94', 'priyagajakosh1', 'lakumveer', 'jatin.dhande1008', 'shakyanandk', 'ramaprde2296', 'rushabh.fegade', 'abhishekm2861996', 'sonawane.akshayak', 'vishakha1805', 'dattaram.gawade781', 'sagarpawar', None, 'salman23011996', 'vaibhav.gangan7', 'nikhildubey02051996', 'sagarbhagat43', 'kaustubhgudekar9', 'suman28pandit', 'danish.dev.007', 'chandraman.patil', 'rakeshmaity', 'saylishirodkar58', 'rohanchavan', 'aishwaryamardhekar.24595', 'cooldudeakshu']"
9,43,75,10,1,['ratsthegreat'],73,"['dalvisayli', 'ektarathod786', 'komalbapna.kb', 'niraj901', 'dikshabafna1995', 'kadamk008', 'omkarn049', 'rehansonarkar784', 'ahire.monali07', 'brian200495', 'akshaybadhiye04', 'susmitaahirrao', 'vinit95vasudevan', 'pravin45', 'oindri.c', 'kondekar23', 'mihirsawant17', 'parmitbanga1995', 'chaudharipayal50', 'shahyash027', 'ajthamke40', 'sangeetamjoshi', 'mudrasjuee', 'abhihadshi', 'pratikkhanore95', 'praju.avhad', 'gauravrajeshmehta', 'codekidx', 'pbrahmapurkar', 'rakshu.gade', 'prathameshptkr4', 'sonalipawar589', 'oma1811', 'mukulsathe1995', 'priyankaingle18', 'sumedh_patil', 'bondreanup007', 'a.j.yadav2395', 'chiragc9494', 'hbg2112', 'manishashetye1295', 'abhishek.thavare', 'sardesai.kirti18', 'viveky803', 'chaudharisuyash7', 'manasi.shinde008', 'ru1795', 'amritamukeshb', 'deven199570', 'aashish.yadav94', 'priyagajakosh1', 'lakumveer', 'jatin.dhande1008', 'shakyanandk', 'ramaprde2296', 'rushabh.fegade', 'abhishekm2861996', 'sonawane.akshayak', 'vishakha1805', 'dattaram.gawade781', 'sagarpawar', 'salman23011996', 'vaibhav.gangan7', 'nikhildubey02051996', 'sagarbhagat43', 'kaustubhgudekar9', 'suman28pandit', 'danish.dev.007', 'rakeshmaity', 'saylishirodkar58', 'rohanchavan', 'aishwaryamardhekar.24595', 'cooldudeakshu']",9,"['parag.choughule', 'navneetmishra021', 'happyridermrk', 'akashmore456', 'pripatil285', 'atul.20909', 'aniket2602', None, 'somil910']",83,"['dalvisayli', 'ektarathod786', 'komalbapna.kb', 'niraj901', 'dikshabafna1995', 'kadamk008', 'omkarn049', 'rehansonarkar784', 'atul.20909', 'ahire.monali07', 'brian200495', 'akshaybadhiye04', 'susmitaahirrao', 'vinit95vasudevan', 'pravin45', 'oindri.c', 'kondekar23', 'mihirsawant17', 'parmitbanga1995', 'happyridermrk', 'chaudharipayal50', 'shahyash027', 'ajthamke40', 'sangeetamjoshi', 'mudrasjuee', 'abhihadshi', 'pratikkhanore95', 'parag.choughule', 'praju.avhad', 'gauravrajeshmehta', 'codekidx', 'pbrahmapurkar', 'rakshu.gade', 'prathameshptkr4', 'sonalipawar589', 'ratsthegreat', 'oma1811', 'mukulsathe1995', 'priyankaingle18', 'sumedh_patil', 'bondreanup007', 'a.j.yadav2395', 'chiragc9494', 'hbg2112', 'manishashetye1295', 'abhishek.thavare', 'sardesai.kirti18', 'viveky803', 'chaudharisuyash7', 'manasi.shinde008', 'ru1795', 'akashmore456', 'amritamukeshb', 'deven199570', 'aashish.yadav94', 'priyagajakosh1', 'lakumveer', 'jatin.dhande1008', 'aniket2602', 'shakyanandk', 'ramaprde2296', 'navneetmishra021', 'rushabh.fegade', 'abhishekm2861996', 'sonawane.akshayak', 'vishakha1805', 'pripatil285', 'dattaram.gawade781', 'sagarpawar', None, 'salman23011996', 'vaibhav.gangan7', 'nikhildubey02051996', 'sagarbhagat43', 'kaustubhgudekar9', 'suman28pandit', 'danish.dev.007', 'rakeshmaity', 'saylishirodkar58', 'rohanchavan', 'aishwaryamardhekar.24595', 'somil910', 'cooldudeakshu']"
9,210,75,10,6,"['shahyash027', 'gauravrajeshmehta', 'vinit95vasudevan', 'suman28pandit', 'rehansonarkar784', 'mihirsawant17']",68,"['dalvisayli', 'ektarathod786', 'komalbapna.kb', 'niraj901', 'dikshabafna1995', 'kadamk008', 'omkarn049', 'ahire.monali07', 'brian200495', 'akshaybadhiye04', 'susmitaahirrao', 'pravin45', 'oindri.c', 'kondekar23', 'parmitbanga1995', 'chaudharipayal50', 'ajthamke40', 'sangeetamjoshi', 'mudrasjuee', 'abhihadshi', 'pratikkhanore95', 'praju.avhad', 'codekidx', 'pbrahmapurkar', 'rakshu.gade', 'prathameshptkr4', 'sonalipawar589', 'ratsthegreat', 'oma1811', 'mukulsathe1995', 'priyankaingle18', 'sumedh_patil', 'bondreanup007', 'a.j.yadav2395', 'chiragc9494', 'hbg2112', 'manishashetye1295', 'abhishek.thavare', 'sardesai.kirti18', 'viveky803', 'chaudharisuyash7', 'manasi.shinde008', 'ru1795', 'amritamukeshb', 'deven199570', 'aashish.yadav94', 'priyagajakosh1', 'lakumveer', 'jatin.dhande1008', 'shakyanandk', 'ramaprde2296', 'rushabh.fegade', 'abhishekm2861996', 'sonawane.akshayak', 'vishakha1805', 'dattaram.gawade781', 'sagarpawar', 'salman23011996', 'vaibhav.gangan7', 'nikhildubey02051996', 'sagarbhagat43', 'kaustubhgudekar9', 'danish.dev.007', 'rakeshmaity', 'saylishirodkar58', 'rohanchavan', 'aishwaryamardhekar.24595', 'cooldudeakshu']",4,"['tejaskanagal95', None, 'rucha1795', 'namrata05']",78,"['dalvisayli', 'ektarathod786', 'komalbapna.kb', 'niraj901', 'dikshabafna1995', 'kadamk008', 'omkarn049', 'rehansonarkar784', 'ahire.monali07', 'brian200495', 'akshaybadhiye04', 'susmitaahirrao', 'vinit95vasudevan', 'pravin45', 'tejaskanagal95', 'oindri.c', 'kondekar23', 'mihirsawant17', 'parmitbanga1995', 'chaudharipayal50', 'shahyash027', 'ajthamke40', 'sangeetamjoshi', 'mudrasjuee', 'abhihadshi', 'pratikkhanore95', 'rucha1795', 'praju.avhad', 'gauravrajeshmehta', 'codekidx', 'pbrahmapurkar', 'rakshu.gade', 'prathameshptkr4', 'sonalipawar589', 'ratsthegreat', 'oma1811', 'mukulsathe1995', 'priyankaingle18', 'sumedh_patil', 'bondreanup007', 'a.j.yadav2395', 'chiragc9494', 'hbg2112', 'manishashetye1295', 'abhishek.thavare', 'sardesai.kirti18', 'viveky803', 'chaudharisuyash7', 'manasi.shinde008', 'ru1795', 'amritamukeshb', 'deven199570', 'aashish.yadav94', 'priyagajakosh1', 'lakumveer', 'jatin.dhande1008', 'shakyanandk', 'ramaprde2296', 'rushabh.fegade', 'abhishekm2861996', 'sonawane.akshayak', 'vishakha1805', 'dattaram.gawade781', 'sagarpawar', None, 'salman23011996', 'vaibhav.gangan7', 'nikhildubey02051996', 'sagarbhagat43', 'kaustubhgudekar9', 'namrata05', 'suman28pandit', 'danish.dev.007', 'rakeshmaity', 'saylishirodkar58', 'rohanchavan', 'aishwaryamardhekar.24595', 'cooldudeakshu']"
9,208,75,7,2,"['sumedh_patil', 'pravin45']",72,"['dalvisayli', 'ektarathod786', 'komalbapna.kb', 'niraj901', 'dikshabafna1995', 'kadamk008', 'omkarn049', 'rehansonarkar784', 'ahire.monali07', 'brian200495', 'akshaybadhiye04', 'susmitaahirrao', 'vinit95vasudevan', 'oindri.c', 'kondekar23', 'mihirsawant17', 'parmitbanga1995', 'chaudharipayal50', 'shahyash027', 'ajthamke40', 'sangeetamjoshi', 'mudrasjuee', 'abhihadshi', 'pratikkhanore95', 'praju.avhad', 'gauravrajeshmehta', 'codekidx', 'pbrahmapurkar', 'rakshu.gade', 'prathameshptkr4', 'sonalipawar589', 'ratsthegreat', 'oma1811', 'mukulsathe1995', 'priyankaingle18', 'bondreanup007', 'a.j.yadav2395', 'chiragc9494', 'hbg2112', 'manishashetye1295', 'abhishek.thavare', 'sardesai.kirti18', 'viveky803', 'chaudharisuyash7', 'manasi.shinde008', 'ru1795', 'amritamukeshb', 'deven199570', 'aashish.yadav94', 'priyagajakosh1', 'lakumveer', 'jatin.dhande1008', 'shakyanandk', 'ramaprde2296', 'rushabh.fegade', 'abhishekm2861996', 'sonawane.akshayak', 'vishakha1805', 'dattaram.gawade781', 'sagarpawar', 'salman23011996', 'vaibhav.gangan7', 'nikhildubey02051996', 'sagarbhagat43', 'kaustubhgudekar9', 'suman28pandit', 'danish.dev.007', 'rakeshmaity', 'saylishirodkar58', 'rohanchavan', 'aishwaryamardhekar.24595', 'cooldudeakshu']",5,"['dhartinano19', 'tejaskanagal95', 'chandraman.patil', 'sid.rane95', None]",79,"['dalvisayli', 'ektarathod786', 'komalbapna.kb', 'niraj901', 'dikshabafna1995', 'kadamk008', 'omkarn049', 'rehansonarkar784', 'ahire.monali07', 'brian200495', 'akshaybadhiye04', 'susmitaahirrao', 'vinit95vasudevan', 'dhartinano19', 'pravin45', 'tejaskanagal95', 'oindri.c', 'kondekar23', 'mihirsawant17', 'parmitbanga1995', 'chaudharipayal50', 'shahyash027', 'ajthamke40', 'sangeetamjoshi', 'mudrasjuee', 'abhihadshi', 'pratikkhanore95', 'praju.avhad', 'gauravrajeshmehta', 'codekidx', 'pbrahmapurkar', 'rakshu.gade', 'prathameshptkr4', 'sid.rane95', 'sonalipawar589', 'ratsthegreat', 'oma1811', 'mukulsathe1995', 'priyankaingle18', 'sumedh_patil', 'bondreanup007', 'a.j.yadav2395', 'chiragc9494', 'hbg2112', 'manishashetye1295', 'abhishek.thavare', 'sardesai.kirti18', 'viveky803', 'chaudharisuyash7', 'manasi.shinde008', 'ru1795', 'amritamukeshb', 'deven199570', 'aashish.yadav94', 'priyagajakosh1', 'lakumveer', 'jatin.dhande1008', 'shakyanandk', 'ramaprde2296', 'rushabh.fegade', 'abhishekm2861996', 'sonawane.akshayak', 'vishakha1805', 'dattaram.gawade781', 'sagarpawar', None, 'salman23011996', 'vaibhav.gangan7', 'nikhildubey02051996', 'sagarbhagat43', 'kaustubhgudekar9', 'suman28pandit', 'danish.dev.007', 'chandraman.patil', 'rakeshmaity', 'saylishirodkar58', 'rohanchavan', 'aishwaryamardhekar.24595', 'cooldudeakshu']"
10,239,72,68,67,"['ohays64', 'bdelgado', 'noushinsikder', 'lolheppster', 'djthompson233', 'lwarren300', 'hubamarton1996', 'amyxmatt1997', 'shawn0894', 'saba.siddiqui84', 'klcarvey', 'papagal_87', 'uzsamad', 'thorn', 'specialfred41', 'joshball', 'legallaissw', 'garthax', 'martingilmour1', 'hk004390', 'caritawilliams1', 'dipu_grg', 'eden', 'jdavies54', 'farazrahimi4', 'ashimgauchan1', 'ernestdemontford', 'carolinechitera', 'ryan18597', 'conorryan969', 'samburton93', 'jordd04', 'ravinder3265', 'adamwoollett', 'jakeequalsgunmaster', 'rablackall17', 'danskelson', 'sam.dearman96', 'yw027175', 'jack.s.nicholls', 'mathildahb', 'meganmorris27', 'h.rahman_96', 'georgiagc', 'apolywka93', 'cameron_haylock', 'habiddinoppo', 'naomiacooper96', 'emmagorrell', 'tonyshak', 's.reeves12', 's2009051', 'gohland', 'nikhal96', 'rebekah10', 'connoryates1996', 'simrenbhandal', 'eleonoremason', 'kathleen.burns', 'alishaleighbarfield', 'alex.wall', 'jackmcauliffe96', 'floracampoccio', 'ameliapb', 'gaietta', 'lataczseb', 'abi.loges127']",4,"['ioannagregoriou97', 'ekhooblall', 'kspear', 'demonstrate1']",1,[None],72,"['noushinsikder', 'ohays64', 'djthompson233', 'amyxmatt1997', 'uzsamad', 'specialfred41', 'legallaissw', 'garthax', 'martingilmour1', 'hk004390', 'jdavies54', 'farazrahimi4', 'ernestdemontford', 'ashimgauchan1', 'carolinechitera', 'ravinder3265', 'jordd04', 'samburton93', 'jakeequalsgunmaster', 'rablackall17', 'sam.dearman96', 'danskelson', 'yw027175', 'jack.s.nicholls', 'meganmorris27', 'naomiacooper96', 'tonyshak', 's.reeves12', 's2009051', 'rebekah10', 'ekhooblall', 'alishaleighbarfield', 'alex.wall', 'floracampoccio', 'gaietta', 'abi.loges127', 'bdelgado', 'lolheppster', 'lwarren300', 'hubamarton1996', 'shawn0894', 'saba.siddiqui84', 'klcarvey', 'papagal_87', 'thorn', 'joshball', 'dipu_grg', 'caritawilliams1', 'eden', 'ryan18597', 'conorryan969', 'ioannagregoriou97', 'adamwoollett', 'mathildahb', 'h.rahman_96', 'georgiagc', 'apolywka93', 'cameron_haylock', 'habiddinoppo', None, 'emmagorrell', 'gohland', 'nikhal96', 'kathleen.burns', 'simrenbhandal', 'eleonoremason', 'connoryates1996', 'kspear', 'jackmcauliffe96', 'ameliapb', 'lataczseb', 'demonstrate1']"
11,336,57,64,56,"['amcorbe2', 'emalhajj', 'ajrigby', 'cthudso3', 'ajcoon', 'obartman', 'agshin', 'jpadams', 'wkharri3', 'taleona3', 'gwcrego', 'abharga5', 'schlenker', 'tnpardue', 'mfschaef', 'mdbrewis', 'mkmoody', 'sjfigurs', 'gredden', 'kjcody', 'alisadeq', 'zlholme2', 'hsoewar', 'tsavey', 'abmcginn', 'jlbrodie', 'atberg', 'hahsain', 'zgdavis', 'kjkronk', 'ajsquire', 'syan4', 'npschult', 'cecipria', 'matthewrowley', 'rjnagley', 'saba96', 'emharri5', 'nrhawes12', 'tbhubble', 'khalil2316', 'jagibson', 'edhill3', 'vrkumar', 'alcostin', 'jwfrenc2', 'mmalsaft', 'ahochstetler711', 'seklug', 'faisa1k', 'jnchestnut4943', 'ajmillir', 'klturne5', 'emmills', 'jrmcgarr', 'yzhang59']",0,[],8,"['jfendri', 'djblivin', 'scledbet', 'jaconno2', 'rljacks4', 'earodrig', None, 'bfgsweeper']",64,"['djblivin', 'emalhajj', 'scledbet', 'ajrigby', 'ajcoon', 'jpadams', 'wkharri3', 'taleona3', 'gwcrego', 'tnpardue', 'mfschaef', 'mdbrewis', 'gredden', 'kjcody', 'alisadeq', 'tsavey', 'abmcginn', 'hahsain', 'kjkronk', 'syan4', 'npschult', 'cecipria', 'jaconno2', 'nrhawes12', 'rljacks4', 'tbhubble', 'jagibson', 'bfgsweeper', 'jwfrenc2', 'jfendri', 'ahochstetler711', 'seklug', 'faisa1k', 'jnchestnut4943', 'klturne5', 'emmills', 'earodrig', 'jrmcgarr', 'emharri5', 'amcorbe2', 'cthudso3', 'obartman', 'agshin', 'abharga5', 'schlenker', 'mkmoody', 'sjfigurs', 'zlholme2', 'hsoewar', 'jlbrodie', 'atberg', 'zgdavis', 'ajsquire', 'matthewrowley', 'rjnagley', 'saba96', 'khalil2316', 'alcostin', 'edhill3', 'vrkumar', 'mmalsaft', None, 'ajmillir', 'yzhang59']"
11,97,57,60,53,"['amcorbe2', 'emalhajj', 'ajrigby', 'cthudso3', 'ajcoon', 'obartman', 'agshin', 'wkharri3', 'taleona3', 'gwcrego', 'abharga5', 'schlenker', 'tnpardue', 'mfschaef', 'mdbrewis', 'mkmoody', 'sjfigurs', 'gredden', 'kjcody', 'alisadeq', 'zlholme2', 'hsoewar', 'tsavey', 'abmcginn', 'jlbrodie', 'atberg', 'hahsain', 'zgdavis', 'kjkronk', 'ajsquire', 'syan4', 'npschult', 'cecipria', 'matthewrowley', 'rjnagley', 'saba96', 'nrhawes12', 'tbhubble', 'khalil2316', 'jagibson', 'edhill3', 'vrkumar', 'alcostin', 'jwfrenc2', 'mmalsaft', 'ahochstetler711', 'seklug', 'faisa1k', 'jnchestnut4943', 'ajmillir', 'emmills', 'jrmcgarr', 'yzhang59']",3,"['klturne5', 'emharri5', 'jpadams']",7,"['djblivin', 'hcboaz', 'mmalsaft123', 'ztledfor', 'brennerncsuedu', 'ajlountz', None]",63,"['djblivin', 'emalhajj', 'ajrigby', 'ajcoon', 'ztledfor', 'jpadams', 'brennerncsuedu', 'wkharri3', 'taleona3', 'gwcrego', 'tnpardue', 'mfschaef', 'mdbrewis', 'hcboaz', 'gredden', 'kjcody', 'alisadeq', 'tsavey', 'abmcginn', 'hahsain', 'kjkronk', 'syan4', 'npschult', 'cecipria', 'nrhawes12', 'tbhubble', 'jagibson', 'jwfrenc2', 'ahochstetler711', 'seklug', 'faisa1k', 'jnchestnut4943', 'klturne5', 'emmills', 'jrmcgarr', 'emharri5', 'amcorbe2', 'cthudso3', 'obartman', 'agshin', 'abharga5', 'schlenker', 'mkmoody', 'sjfigurs', 'mmalsaft123', 'zlholme2', 'hsoewar', 'jlbrodie', 'atberg', 'ajlountz', 'zgdavis', 'ajsquire', 'matthewrowley', 'rjnagley', 'saba96', 'khalil2316', 'alcostin', 'edhill3', 'vrkumar', 'mmalsaft', None, 'ajmillir', 'yzhang59']"
11,100,57,11,5,"['jwfrenc2', 'mkmoody', 'abmcginn', 'taleona3', 'gwcrego']",51,"['amcorbe2', 'emalhajj', 'ajrigby', 'cthudso3', 'ajcoon', 'obartman', 'agshin', 'jpadams', 'wkharri3', 'abharga5', 'tnpardue', 'schlenker', 'yzhang59', 'mfschaef', 'mdbrewis', 'sjfigurs', 'gredden', 'kjcody', 'alisadeq', 'zlholme2', 'hsoewar', 'tsavey', 'jlbrodie', 'atberg', 'hahsain', 'zgdavis', 'kjkronk', 'ajsquire', 'syan4', 'npschult', 'cecipria', 'matthewrowley', 'rjnagley', 'saba96', 'nrhawes12', 'tbhubble', 'khalil2316', 'jagibson', 'edhill3', 'vrkumar', 'alcostin', 'mmalsaft', 'ahochstetler711', 'seklug', 'faisa1k', 'jnchestnut4943', 'ajmillir', 'klturne5', 'emmills', 'jrmcgarr', 'emharri5']",6,"['liffland', 'djblivin', 'eklump', 'jaconno2', 'brennerncsuedu', None]",62,"['amcorbe2', 'djblivin', 'emalhajj', 'ajrigby', 'cthudso3', 'ajcoon', 'eklump', 'obartman', 'agshin', 'jpadams', 'brennerncsuedu', 'wkharri3', 'taleona3', 'gwcrego', 'abharga5', 'tnpardue', 'schlenker', 'yzhang59', 'mfschaef', 'mdbrewis', 'mkmoody', 'sjfigurs', 'gredden', 'kjcody', 'alisadeq', 'zlholme2', 'hsoewar', 'tsavey', 'abmcginn', 'jlbrodie', 'atberg', 'hahsain', 'zgdavis', 'kjkronk', 'liffland', 'ajsquire', 'syan4', 'npschult', 'cecipria', 'matthewrowley', 'rjnagley', 'saba96', 'jaconno2', 'nrhawes12', 'tbhubble', 'khalil2316', 'jagibson', 'edhill3', 'vrkumar', 'alcostin', 'jwfrenc2', 'mmalsaft', None, 'ahochstetler711', 'seklug', 'faisa1k', 'jnchestnut4943', 'ajmillir', 'klturne5', 'emmills', 'jrmcgarr', 'emharri5']"
11,98,57,8,1,['klturne5'],55,"['amcorbe2', 'emalhajj', 'ajrigby', 'cthudso3', 'ajcoon', 'obartman', 'agshin', 'jpadams', 'wkharri3', 'taleona3', 'gwcrego', 'abharga5', 'tnpardue', 'schlenker', 'yzhang59', 'mfschaef', 'mdbrewis', 'mkmoody', 'sjfigurs', 'gredden', 'kjcody', 'alisadeq', 'zlholme2', 'hsoewar', 'tsavey', 'abmcginn', 'jlbrodie', 'atberg', 'hahsain', 'zgdavis', 'kjkronk', 'ajsquire', 'syan4', 'npschult', 'cecipria', 'matthewrowley', 'rjnagley', 'saba96', 'nrhawes12', 'tbhubble', 'khalil2316', 'jagibson', 'edhill3', 'vrkumar', 'alcostin', 'jwfrenc2', 'mmalsaft', 'ahochstetler711', 'seklug', 'faisa1k', 'jnchestnut4943', 'ajmillir', 'emmills', 'jrmcgarr', 'emharri5']",7,"['liang142', 'servinb', 'zhao546', 'jclaussen27', 'zhai312313', None, 'jiang330']",63,"['amcorbe2', 'emalhajj', 'ajrigby', 'cthudso3', 'ajcoon', 'obartman', 'agshin', 'jpadams', 'wkharri3', 'taleona3', 'gwcrego', 'abharga5', 'tnpardue', 'schlenker', 'yzhang59', 'mfschaef', 'mdbrewis', 'mkmoody', 'sjfigurs', 'gredden', 'kjcody', 'alisadeq', 'zlholme2', 'hsoewar', 'tsavey', 'abmcginn', 'jlbrodie', 'atberg', 'hahsain', 'zgdavis', 'kjkronk', 'jiang330', 'ajsquire', 'syan4', 'npschult', 'cecipria', 'matthewrowley', 'rjnagley', 'saba96', 'servinb', 'nrhawes12', 'jclaussen27', 'tbhubble', 'khalil2316', 'jagibson', 'edhill3', 'vrkumar', 'alcostin', 'jwfrenc2', 'mmalsaft', None, 'ahochstetler711', 'seklug', 'liang142', 'faisa1k', 'jnchestnut4943', 'ajmillir', 'klturne5', 'zhao546', 'emmills', 'zhai312313', 'jrmcgarr', 'emharri5']"
12,279,57,44,43,"['phornpan.kawee', 'maylovelymak', 'bosslovechompoo', 'pimmada', 'tpuangmali', 'gade.999', 'thnida133', 'apiwan_nanoha', 'surachetanansuwanchai', 'mali', 'ra1341100295068', 'rewat.m', 'bay.zx123', 'ruchira_nachaiboon', 'spoy', 'padudong', 'amsom_sm', 'sirineenamfon', 'mysuperstarza', 'gamchatchaya', 'bosschompoo', 'hataipat', 'sopha', 'nut.jutharat', 'ter_jirasak', 'tandysckku', 'surachet', 'rirakkuma79.wn', 'yuphaphorn', 'tanatporn.ch', 'pimlada.sazpp', 'nattha.cyp', 'matita', 'onnapa', 'jirasakpdd', 'namfonjj', 'pearpawanrat', 'sirinee', 'poomza555yo', 'rewatmsr', 'ter6511', 'arter623', 'jetsrudchaneewun']",13,"['mahas.syed', 'mynewphysics', 'salim.berrada.b', 'mghulman', 'arifhossain.nt', 'igor.kashkin2016', 'farhanaanwar09', 'shuilan', 'wenfei', 'forestinsnow', 'mejaz', 'mouche1', 'rezshahab']",1,[None],57,"['tpuangmali', 'shuilan', 'forestinsnow', 'surachetanansuwanchai', 'mali', 'rewat.m', 'ruchira_nachaiboon', 'arifhossain.nt', 'sirineenamfon', 'mysuperstarza', 'ter_jirasak', 'yuphaphorn', 'pimlada.sazpp', 'nattha.cyp', 'matita', 'namfonjj', 'mahas.syed', 'sirinee', 'igor.kashkin2016', 'poomza555yo', 'rewatmsr', 'bosslovechompoo', 'maylovelymak', 'phornpan.kawee', 'pimmada', 'gade.999', 'thnida133', 'apiwan_nanoha', 'ra1341100295068', 'mejaz', 'bay.zx123', 'spoy', 'mynewphysics', 'padudong', 'amsom_sm', 'gamchatchaya', 'mouche1', 'bosschompoo', 'hataipat', 'sopha', 'rezshahab', 'nut.jutharat', 'tandysckku', 'surachet', 'rirakkuma79.wn', 'tanatporn.ch', 'wenfei', 'onnapa', 'jirasakpdd', None, 'pearpawanrat', 'salim.berrada.b', 'mghulman', 'farhanaanwar09', 'ter6511', 'arter623', 'jetsrudchaneewun']"
13,242,56,96,23,"['gngpdhy2', 'nkim74', 'reningermatthew', 'jdray2', 'saphknight', 'amir89', 'lxing3', 'xsun45', 'vkhanna3', 'liamkennynanohub', 'amland2', 'dexterballou', 'zwang173', 'icharri2', 'alanwu3', 'smpatel8', 'anleen20', 'jlayers2', 'clarasmile', 'jzhan142', 'kmckillop', 'jshi3120', 'dzhang37']",32,"['ltsmith2', 'prathyush963', 'davestupple', 'mdsalahuddin', 'dorothy3', 'alf', 'abhiks', 'ravi8', 'werkkdy2', 'wchen94', 'khuang31', 'sikaufm2', 'hzhou30', 'vasyltheonly', 'liuyuting1006', 'kagebei2', 'bridgette.lafaye', 'yliu181', 'fkeppner', 'npant', 'jacobcamp0', 'hwhsiao2', 'shoppe3', 'tliu46', 'davefarqhuit', 'yxia10', 'fpkelly2', 'zhanshi333', 'jinpeng.zhuo', 'sloneil21994', 'wifsysinc', 'yutingliu']",73,"['sbumbles96', 'mepaul2', 'dpapanicolas', 'prhogan2', 'yaoyao5', 'balung18', 'dfrosen2', 'ychu18', 'zzhan134', 'zhaber2', 'zohair2', 'goszkow2', 'slohman2', 'yuqiuwu2', 'cwang112', 'hzhan126', 'alfeche2', 'cnsteve2', 'kote.deepa', 'berglun2', 'aokisang', 'reningr2', 'jakrogst', 'jacob.dutler', 'crickettay13', 'jdlin4', 'thiruve2', 'maggana2', 'hmajith2', 'ychen254', 'cmander4', 'krithikp', 'mtschro3', 'arovgno', 'meiselm2', 'jeroach2', 'jonbaebae', 'akononov', 'toriyam2', 'akim102', 'jhbaker3', 'tcalder2', 'trskwsk2', 'jackylu2', 'jcselle2', 'ajfrank3', 'deepakcmani', 'ychen375', 'nuanes2', 'echoma', 'rwlandi2', None, 'rzhang80', 'aladd2', 'jeoneil6', 'katarukaamrita', 'zafar3', 'yiyue.luo.9', 'tmolley2', 'kjnnngs2', 'jhmead2', 'pbehera2', 'drew.wise.10', 'zjcszzl0615', 'mclawso2', 'wtroth2', 'mchang14', 'zlong4', 'yhuan127', 'pross4', 'jsshin3', 'scorchnoxap', 'cdeegan2']",128,"['davestupple', 'nkim74', 'dpapanicolas', 'cwang112', 'saphknight', 'alfeche2', 'sikaufm2', 'liamkennynanohub', 'amland2', 'hzhou30', 'dexterballou', 'ychen254', 'krithikp', 'arovgno', 'alanwu3', 'jackylu2', 'jcselle2', 'smpatel8', 'deepakcmani', 'ychen375', 'tliu46', 'rzhang80', 'aladd2', 'katarukaamrita', 'kjnnngs2', 'clarasmile', 'pbehera2', 'drew.wise.10', 'sloneil21994', 'wifsysinc', 'dzhang37', 'jsshin3', 'scorchnoxap', 'zafar3', 'cdeegan2', 'gngpdhy2', 'sbumbles96', 'zhaber2', 'reningermatthew', 'werkkdy2', 'hzhan126', 'khuang31', 'kote.deepa', 'crickettay13', 'jdlin4', 'hmajith2', 'liuyuting1006', 'meiselm2', 'bridgette.lafaye', 'fkeppner', 'akim102', 'tcalder2', 'trskwsk2', 'nuanes2', 'yxia10', 'zhanshi333', 'jeoneil6', 'anleen20', 'kmckillop', 'yiyue.luo.9', 'echoma', 'yutingliu', 'jhbaker3', 'ltsmith2', 'prathyush963', 'mepaul2', 'prhogan2', 'yaoyao5', 'balung18', 'dfrosen2', 'ychu18', 'zzhan134', 'zohair2', 'yuqiuwu2', 'ravi8', 'jdray2', 'cnsteve2', 'berglun2', 'amir89', 'aokisang', 'vkhanna3', 'thiruve2', 'vasyltheonly', 'kagebei2', 'icharri2', 'jonbaebae', 'yliu181', 'toriyam2', 'npant', 'ajfrank3', 'hwhsiao2', 'shoppe3', 'rwlandi2', 'fpkelly2', 'tmolley2', 'jlayers2', 'jhmead2', 'jzhan142', 'wtroth2', 'mchang14', 'mdsalahuddin', 'dorothy3', 'goszkow2', 'slohman2', 'alf', 'abhiks', 'wchen94', 'lxing3', 'reningr2', 'jakrogst', 'xsun45', 'jacob.dutler', 'maggana2', 'cmander4', 'zwang173', 'mtschro3', 'jeroach2', 'jacobcamp0', 'davefarqhuit', None, 'zjcszzl0615', 'jinpeng.zhuo', 'mclawso2', 'zlong4', 'jshi3120', 'yhuan127', 'pross4', 'akononov']"
13,243,56,25,22,"['ltsmith2', 'ravi8', 'jdray2', 'werkkdy2', 'khuang31', 'sikaufm2', 'amland2', 'hzhou30', 'vasyltheonly', 'liuyuting1006', 'kagebei2', 'yliu181', 'npant', 'jacobcamp0', 'hwhsiao2', 'shoppe3', 'tliu46', 'yxia10', 'zhanshi333', 'jinpeng.zhuo', 'sloneil21994', 'yutingliu']",33,"['gngpdhy2', 'davestupple', 'mdsalahuddin', 'prathyush963', 'nkim74', 'dorothy3', 'alf', 'abhiks', 'reningermatthew', 'saphknight', 'wchen94', 'amir89', 'lxing3', 'xsun45', 'vkhanna3', 'liamkennynanohub', 'dexterballou', 'zwang173', 'icharri2', 'bridgette.lafaye', 'fkeppner', 'alanwu3', 'smpatel8', 'davefarqhuit', 'fpkelly2', 'anleen20', 'jlayers2', 'clarasmile', 'jzhan142', 'kmckillop', 'jshi3120', 'wifsysinc', 'dzhang37']",3,"['akononov', None, 'katarukaamrita']",58,"['ltsmith2', 'davestupple', 'prathyush963', 'nkim74', 'ravi8', 'jdray2', 'saphknight', 'amir89', 'sikaufm2', 'vkhanna3', 'liamkennynanohub', 'amland2', 'hzhou30', 'vasyltheonly', 'dexterballou', 'kagebei2', 'icharri2', 'yliu181', 'alanwu3', 'npant', 'hwhsiao2', 'shoppe3', 'smpatel8', 'tliu46', 'fpkelly2', 'katarukaamrita', 'jlayers2', 'clarasmile', 'jzhan142', 'sloneil21994', 'wifsysinc', 'dzhang37', 'gngpdhy2', 'mdsalahuddin', 'dorothy3', 'alf', 'abhiks', 'reningermatthew', 'werkkdy2', 'wchen94', 'khuang31', 'lxing3', 'xsun45', 'liuyuting1006', 'zwang173', 'bridgette.lafaye', 'fkeppner', 'jacobcamp0', 'davefarqhuit', 'yxia10', None, 'zhanshi333', 'anleen20', 'jinpeng.zhuo', 'kmckillop', 'jshi3120', 'akononov', 'yutingliu']"
13,244,56,24,5,"['wchen94', 'yliu181', 'dorothy3', 'alf', 'bridgette.lafaye']",50,"['gngpdhy2', 'ltsmith2', 'prathyush963', 'davestupple', 'nkim74', 'mdsalahuddin', 'abhiks', 'reningermatthew', 'ravi8', 'jdray2', 'werkkdy2', 'saphknight', 'khuang31', 'amir89', 'lxing3', 'sikaufm2', 'xsun45', 'vkhanna3', 'liamkennynanohub', 'amland2', 'hzhou30', 'vasyltheonly', 'liuyuting1006', 'dexterballou', 'zwang173', 'kagebei2', 'icharri2', 'fkeppner', 'alanwu3', 'npant', 'jacobcamp0', 'hwhsiao2', 'shoppe3', 'smpatel8', 'tliu46', 'davefarqhuit', 'yxia10', 'fpkelly2', 'zhanshi333', 'anleen20', 'jlayers2', 'jinpeng.zhuo', 'clarasmile', 'jzhan142', 'sloneil21994', 'kmckillop', 'jshi3120', 'wifsysinc', 'dzhang37', 'yutingliu']",19,"['tianshu2', 'ruining2', 'mingye.gao', 'gowthamsriram', 'eswu2', 'cssmith4', 'alfeche2', 'pshetty3', 'zhan.shi.106', 'krithikp', 'junehan1', None, 'dli29', 'katarukaamrita', 'dlitt2', 'joylin0806', 'samhalpern58', 'shenyuwu94', 'xlz.287']",74,"['ltsmith2', 'davestupple', 'prathyush963', 'nkim74', 'tianshu2', 'ravi8', 'jdray2', 'saphknight', 'alfeche2', 'amir89', 'sikaufm2', 'vkhanna3', 'liamkennynanohub', 'amland2', 'hzhou30', 'vasyltheonly', 'dexterballou', 'zhan.shi.106', 'krithikp', 'kagebei2', 'icharri2', 'yliu181', 'alanwu3', 'npant', 'hwhsiao2', 'shoppe3', 'smpatel8', 'tliu46', 'dli29', 'fpkelly2', 'katarukaamrita', 'dlitt2', 'joylin0806', 'jlayers2', 'clarasmile', 'jzhan142', 'sloneil21994', 'shenyuwu94', 'wifsysinc', 'dzhang37', 'gngpdhy2', 'mdsalahuddin', 'dorothy3', 'ruining2', 'mingye.gao', 'alf', 'abhiks', 'reningermatthew', 'gowthamsriram', 'eswu2', 'werkkdy2', 'cssmith4', 'wchen94', 'khuang31', 'lxing3', 'xsun45', 'pshetty3', 'liuyuting1006', 'zwang173', 'bridgette.lafaye', 'fkeppner', 'junehan1', 'jacobcamp0', 'davefarqhuit', 'yxia10', None, 'zhanshi333', 'anleen20', 'jinpeng.zhuo', 'kmckillop', 'samhalpern58', 'jshi3120', 'xlz.287', 'yutingliu']"
13,245,56,24,6,"['wchen94', 'yliu181', 'dorothy3', 'liuyuting1006', 'yutingliu', 'bridgette.lafaye']",49,"['gngpdhy2', 'ltsmith2', 'prathyush963', 'davestupple', 'nkim74', 'mdsalahuddin', 'alf', 'abhiks', 'reningermatthew', 'ravi8', 'jdray2', 'werkkdy2', 'saphknight', 'khuang31', 'amir89', 'lxing3', 'sikaufm2', 'xsun45', 'vkhanna3', 'liamkennynanohub', 'amland2', 'hzhou30', 'vasyltheonly', 'dexterballou', 'zwang173', 'kagebei2', 'icharri2', 'fkeppner', 'alanwu3', 'npant', 'jacobcamp0', 'hwhsiao2', 'shoppe3', 'smpatel8', 'tliu46', 'davefarqhuit', 'yxia10', 'fpkelly2', 'zhanshi333', 'anleen20', 'jlayers2', 'jinpeng.zhuo', 'clarasmile', 'jzhan142', 'sloneil21994', 'kmckillop', 'jshi3120', 'wifsysinc', 'dzhang37']",18,"['xlz.287', 'katarukaamrita', 'dlitt2', 'joylin0806', 'dpapanicolas', 'ruining2', 'tianshu2', 'mingye.gao', 'pshetty3', 'jli118', 'zhan.shi.106', 'amber.snil', 'krithikp', 'eswu2', 'cssmith4', None, 'alfeche2', 'akononov']",73,"['ltsmith2', 'davestupple', 'prathyush963', 'nkim74', 'dpapanicolas', 'tianshu2', 'ravi8', 'jdray2', 'saphknight', 'alfeche2', 'amir89', 'sikaufm2', 'vkhanna3', 'liamkennynanohub', 'amland2', 'hzhou30', 'vasyltheonly', 'dexterballou', 'zhan.shi.106', 'krithikp', 'kagebei2', 'icharri2', 'yliu181', 'alanwu3', 'npant', 'hwhsiao2', 'shoppe3', 'smpatel8', 'amber.snil', 'tliu46', 'fpkelly2', 'katarukaamrita', 'dlitt2', 'joylin0806', 'jlayers2', 'clarasmile', 'jzhan142', 'sloneil21994', 'wifsysinc', 'dzhang37', 'gngpdhy2', 'mdsalahuddin', 'dorothy3', 'ruining2', 'mingye.gao', 'alf', 'abhiks', 'reningermatthew', 'eswu2', 'werkkdy2', 'cssmith4', 'wchen94', 'khuang31', 'lxing3', 'xsun45', 'pshetty3', 'liuyuting1006', 'zwang173', 'bridgette.lafaye', 'fkeppner', 'jacobcamp0', 'jli118', 'davefarqhuit', 'yxia10', None, 'zhanshi333', 'anleen20', 'jinpeng.zhuo', 'kmckillop', 'jshi3120', 'xlz.287', 'akononov', 'yutingliu']"
14,149,52,67,49,"['tbaim', 'tianxinchen', 'mbolognese', 'haoxianlin', 'davidchen123', 'stevenmcgrat', 'jasonnguyen', 'kgeorgadarel5', 'wkoski', 'ctimmerman', 'abecirovic', 'amajee', 'jkline', 'saswatiswain', 'gbayides', 'tdcosta', 'xiaobinliu', 'chunkaiwong', 'mgerhardson', 'coleman.j.ryan', 'ethan402', 'dmathieu', 'asjogren', 'mzeimbekakis', 'yujiahuo', 'cwijesundara', 'ajabraha', 'mamohamed', 'daviddowns', 'nspaine', 'jpetrovick', 'ssproviero', 'nkorniyenko', 'sdanielson', 'tkoopman', 'matthewdonne141', 'rsarge', 'lluchetti', 'nbrayer', 'egrimaldi', 'emailhot', 'eajenkins', 'mshliselberg', 'inwilliams', 'suoangao', 'bifisher', 'jjpenney', 'siyuwu', 'mpool']",2,"['ajfitzpatric', 'jgordon']",18,"['bbayarsaikha', 'rward', 'sjpatel', 'jmhiggins', 'aksamija', 'ece344', 'clemonias', 'bvo', 'dvnguyen', 'jlagasse', 'cblewis', 'weihuang', 'ebryce', 'dkurpaska', None, 'bivaldi', 'astam', 'aarshjain']",69,"['tianxinchen', 'stevenmcgrat', 'kgeorgadarel5', 'wkoski', 'abecirovic', 'dkurpaska', 'bivaldi', 'gbayides', 'ajfitzpatric', 'clemonias', 'ethan402', 'ajabraha', 'cwijesundara', 'mamohamed', 'daviddowns', 'jlagasse', 'ssproviero', 'nkorniyenko', 'tkoopman', 'ebryce', 'rsarge', 'nbrayer', 'egrimaldi', 'emailhot', 'mshliselberg', 'suoangao', 'jjpenney', 'sjpatel', 'tbaim', 'mbolognese', 'haoxianlin', 'davidchen123', 'jasonnguyen', 'ctimmerman', 'amajee', 'jgordon', 'jkline', 'astam', 'saswatiswain', 'jmhiggins', 'aksamija', 'tdcosta', 'xiaobinliu', 'chunkaiwong', 'mgerhardson', 'bvo', 'coleman.j.ryan', 'cblewis', 'dmathieu', 'asjogren', 'mzeimbekakis', 'yujiahuo', 'rward', 'nspaine', 'dvnguyen', 'jpetrovick', 'weihuang', 'sdanielson', None, 'matthewdonne141', 'bbayarsaikha', 'lluchetti', 'eajenkins', 'ece344', 'inwilliams', 'bifisher', 'siyuwu', 'mpool', 'aarshjain']"
14,266,52,52,43,"['tbaim', 'tianxinchen', 'mbolognese', 'haoxianlin', 'davidchen123', 'stevenmcgrat', 'jasonnguyen', 'kgeorgadarel5', 'wkoski', 'ctimmerman', 'abecirovic', 'amajee', 'jgordon', 'jkline', 'saswatiswain', 'gbayides', 'ajfitzpatric', 'tdcosta', 'xiaobinliu', 'chunkaiwong', 'coleman.j.ryan', 'ethan402', 'dmathieu', 'asjogren', 'mzeimbekakis', 'yujiahuo', 'cwijesundara', 'ajabraha', 'mamohamed', 'daviddowns', 'nspaine', 'jpetrovick', 'ssproviero', 'sdanielson', 'tkoopman', 'rsarge', 'egrimaldi', 'emailhot', 'mshliselberg', 'suoangao', 'bifisher', 'siyuwu', 'mpool']",8,"['lluchetti', 'nbrayer', 'eajenkins', 'inwilliams', 'mgerhardson', 'jjpenney', 'nkorniyenko', 'matthewdonne141']",9,"['bbayarsaikha', 'cmwong', 'rward', 'sjpatel', 'clemonias', 'dvnguyen', 'weihuang', None, 'astam']",60,"['tianxinchen', 'stevenmcgrat', 'kgeorgadarel5', 'wkoski', 'abecirovic', 'gbayides', 'ajfitzpatric', 'clemonias', 'ethan402', 'ajabraha', 'cwijesundara', 'mamohamed', 'daviddowns', 'ssproviero', 'nkorniyenko', 'tkoopman', 'rsarge', 'nbrayer', 'egrimaldi', 'emailhot', 'mshliselberg', 'suoangao', 'jjpenney', 'sjpatel', 'tbaim', 'mbolognese', 'haoxianlin', 'davidchen123', 'jasonnguyen', 'ctimmerman', 'amajee', 'jgordon', 'jkline', 'astam', 'saswatiswain', 'tdcosta', 'xiaobinliu', 'chunkaiwong', 'mgerhardson', 'coleman.j.ryan', 'dmathieu', 'asjogren', 'mzeimbekakis', 'yujiahuo', 'cmwong', 'rward', 'nspaine', 'dvnguyen', 'jpetrovick', 'weihuang', 'sdanielson', None, 'matthewdonne141', 'bbayarsaikha', 'lluchetti', 'eajenkins', 'inwilliams', 'bifisher', 'siyuwu', 'mpool']"
14,166,52,51,44,"['tbaim', 'tianxinchen', 'mbolognese', 'haoxianlin', 'davidchen123', 'stevenmcgrat', 'kgeorgadarel5', 'wkoski', 'ctimmerman', 'abecirovic', 'amajee', 'jgordon', 'jkline', 'saswatiswain', 'gbayides', 'ajfitzpatric', 'tdcosta', 'xiaobinliu', 'chunkaiwong', 'ethan402', 'dmathieu', 'asjogren', 'mzeimbekakis', 'mamohamed', 'cwijesundara', 'ajabraha', 'yujiahuo', 'daviddowns', 'nspaine', 'jpetrovick', 'ssproviero', 'sdanielson', 'tkoopman', 'matthewdonne141', 'rsarge', 'lluchetti', 'egrimaldi', 'emailhot', 'mshliselberg', 'inwilliams', 'jjpenney', 'bifisher', 'siyuwu', 'mpool']",7,"['nbrayer', 'eajenkins', 'jasonnguyen', 'mgerhardson', 'suoangao', 'coleman.j.ryan', 'nkorniyenko']",7,"['aksamija', 'bvo', 'dvnguyen', 'jlagasse', None, 'bivaldi', 'astam']",58,"['tianxinchen', 'stevenmcgrat', 'kgeorgadarel5', 'wkoski', 'abecirovic', 'bivaldi', 'gbayides', 'ajfitzpatric', 'ethan402', 'ajabraha', 'cwijesundara', 'mamohamed', 'daviddowns', 'jlagasse', 'ssproviero', 'nkorniyenko', 'tkoopman', 'rsarge', 'nbrayer', 'egrimaldi', 'emailhot', 'mshliselberg', 'suoangao', 'jjpenney', 'tbaim', 'mbolognese', 'haoxianlin', 'davidchen123', 'jasonnguyen', 'ctimmerman', 'amajee', 'jgordon', 'jkline', 'astam', 'saswatiswain', 'aksamija', 'tdcosta', 'xiaobinliu', 'chunkaiwong', 'mgerhardson', 'bvo', 'coleman.j.ryan', 'dmathieu', 'asjogren', 'mzeimbekakis', 'yujiahuo', 'nspaine', 'dvnguyen', 'jpetrovick', 'sdanielson', None, 'matthewdonne141', 'lluchetti', 'eajenkins', 'inwilliams', 'bifisher', 'siyuwu', 'mpool']"
14,102,52,49,35,"['tbaim', 'tianxinchen', 'haoxianlin', 'davidchen123', 'stevenmcgrat', 'jasonnguyen', 'kgeorgadarel5', 'ctimmerman', 'abecirovic', 'amajee', 'jkline', 'gbayides', 'tdcosta', 'chunkaiwong', 'coleman.j.ryan', 'dmathieu', 'mzeimbekakis', 'ajabraha', 'cwijesundara', 'daviddowns', 'nspaine', 'jpetrovick', 'nkorniyenko', 'ssproviero', 'matthewdonne141', 'lluchetti', 'emailhot', 'mshliselberg', 'eajenkins', 'inwilliams', 'suoangao', 'jjpenney', 'bifisher', 'siyuwu', 'mpool']",16,"['rsarge', 'mbolognese', 'saswatiswain', 'nbrayer', 'egrimaldi', 'ajfitzpatric', 'xiaobinliu', 'mgerhardson', 'yujiahuo', 'wkoski', 'ethan402', 'sdanielson', 'asjogren', 'jgordon', 'mamohamed', 'tkoopman']",14,"['sjpatel', 'rward', 'aksamija', 'cpandiscio', 'dvnguyen', 'fsaifullah', 'jlagasse', 'cblewis', 'j.joshuayang', 'raghidnaji1', 'dkurpaska', None, 'bivaldi', 'astam']",65,"['tianxinchen', 'stevenmcgrat', 'kgeorgadarel5', 'fsaifullah', 'wkoski', 'abecirovic', 'dkurpaska', 'bivaldi', 'gbayides', 'ajfitzpatric', 'ethan402', 'raghidnaji1', 'ajabraha', 'cwijesundara', 'mamohamed', 'daviddowns', 'jlagasse', 'ssproviero', 'nkorniyenko', 'tkoopman', 'rsarge', 'nbrayer', 'egrimaldi', 'emailhot', 'mshliselberg', 'suoangao', 'jjpenney', 'sjpatel', 'tbaim', 'mbolognese', 'haoxianlin', 'davidchen123', 'jasonnguyen', 'ctimmerman', 'amajee', 'jgordon', 'jkline', 'astam', 'saswatiswain', 'aksamija', 'tdcosta', 'xiaobinliu', 'chunkaiwong', 'mgerhardson', 'coleman.j.ryan', 'cblewis', 'dmathieu', 'asjogren', 'mzeimbekakis', 'yujiahuo', 'rward', 'nspaine', 'dvnguyen', 'jpetrovick', 'sdanielson', None, 'matthewdonne141', 'lluchetti', 'eajenkins', 'inwilliams', 'bifisher', 'siyuwu', 'mpool', 'j.joshuayang', 'cpandiscio']"
14,68,52,40,33,"['tbaim', 'mbolognese', 'stevenmcgrat', 'jasonnguyen', 'kgeorgadarel5', 'wkoski', 'amajee', 'jgordon', 'ajfitzpatric', 'tdcosta', 'chunkaiwong', 'ethan402', 'dmathieu', 'asjogren', 'mzeimbekakis', 'ajabraha', 'yujiahuo', 'cwijesundara', 'mamohamed', 'daviddowns', 'jpetrovick', 'ssproviero', 'sdanielson', 'tkoopman', 'matthewdonne141', 'rsarge', 'egrimaldi', 'emailhot', 'mshliselberg', 'inwilliams', 'bifisher', 'siyuwu', 'mpool']",18,"['tianxinchen', 'saswatiswain', 'lluchetti', 'haoxianlin', 'gbayides', 'davidchen123', 'nbrayer', 'eajenkins', 'xiaobinliu', 'nspaine', 'mgerhardson', 'suoangao', 'coleman.j.ryan', 'jjpenney', 'nkorniyenko', 'ctimmerman', 'abecirovic', 'jkline']",7,"['sjpatel', 'jmhiggins', 'aksamija', 'komminiadithya', 'dvnguyen', None, 'astam']",58,"['tianxinchen', 'stevenmcgrat', 'kgeorgadarel5', 'wkoski', 'abecirovic', 'gbayides', 'ajfitzpatric', 'ethan402', 'ajabraha', 'cwijesundara', 'mamohamed', 'daviddowns', 'ssproviero', 'nkorniyenko', 'tkoopman', 'rsarge', 'nbrayer', 'egrimaldi', 'emailhot', 'mshliselberg', 'suoangao', 'jjpenney', 'sjpatel', 'tbaim', 'mbolognese', 'haoxianlin', 'davidchen123', 'jasonnguyen', 'komminiadithya', 'ctimmerman', 'amajee', 'jgordon', 'jkline', 'astam', 'saswatiswain', 'jmhiggins', 'aksamija', 'tdcosta', 'xiaobinliu', 'chunkaiwong', 'mgerhardson', 'coleman.j.ryan', 'dmathieu', 'asjogren', 'mzeimbekakis', 'yujiahuo', 'nspaine', 'dvnguyen', 'jpetrovick', 'sdanielson', None, 'matthewdonne141', 'lluchetti', 'eajenkins', 'inwilliams', 'bifisher', 'siyuwu', 'mpool']"
14,176,52,40,35,"['tbaim', 'tianxinchen', 'mbolognese', 'stevenmcgrat', 'jasonnguyen', 'wkoski', 'ctimmerman', 'abecirovic', 'amajee', 'jgordon', 'jkline', 'gbayides', 'tdcosta', 'xiaobinliu', 'coleman.j.ryan', 'ethan402', 'dmathieu', 'asjogren', 'mzeimbekakis', 'ajabraha', 'cwijesundara', 'yujiahuo', 'daviddowns', 'nspaine', 'jpetrovick', 'nkorniyenko', 'ssproviero', 'sdanielson', 'matthewdonne141', 'mshliselberg', 'inwilliams', 'suoangao', 'bifisher', 'siyuwu', 'mpool']",16,"['rsarge', 'saswatiswain', 'lluchetti', 'haoxianlin', 'nbrayer', 'davidchen123', 'egrimaldi', 'ajfitzpatric', 'chunkaiwong', 'emailhot', 'eajenkins', 'kgeorgadarel5', 'mgerhardson', 'jjpenney', 'mamohamed', 'tkoopman']",5,"['bbayarsaikha', 'weihuang', None, 'sjpatel', 'astam']",56,"['tianxinchen', 'stevenmcgrat', 'kgeorgadarel5', 'wkoski', 'abecirovic', 'gbayides', 'ajfitzpatric', 'ethan402', 'ajabraha', 'cwijesundara', 'mamohamed', 'daviddowns', 'ssproviero', 'nkorniyenko', 'tkoopman', 'rsarge', 'nbrayer', 'egrimaldi', 'emailhot', 'mshliselberg', 'suoangao', 'jjpenney', 'sjpatel', 'tbaim', 'mbolognese', 'haoxianlin', 'davidchen123', 'jasonnguyen', 'ctimmerman', 'amajee', 'jgordon', 'jkline', 'astam', 'saswatiswain', 'tdcosta', 'xiaobinliu', 'chunkaiwong', 'mgerhardson', 'coleman.j.ryan', 'dmathieu', 'asjogren', 'mzeimbekakis', 'yujiahuo', 'nspaine', 'jpetrovick', 'weihuang', 'sdanielson', None, 'matthewdonne141', 'bbayarsaikha', 'lluchetti', 'eajenkins', 'inwilliams', 'bifisher', 'siyuwu', 'mpool']"
14,271,52,37,32,"['tbaim', 'haoxianlin', 'davidchen123', 'jasonnguyen', 'kgeorgadarel5', 'wkoski', 'abecirovic', 'amajee', 'saswatiswain', 'gbayides', 'xiaobinliu', 'coleman.j.ryan', 'dmathieu', 'asjogren', 'mzeimbekakis', 'yujiahuo', 'ajabraha', 'cwijesundara', 'daviddowns', 'nspaine', 'jpetrovick', 'matthewdonne141', 'rsarge', 'lluchetti', 'egrimaldi', 'emailhot', 'mshliselberg', 'inwilliams', 'suoangao', 'bifisher', 'siyuwu', 'mpool']",19,"['tianxinchen', 'mbolognese', 'stevenmcgrat', 'ctimmerman', 'jgordon', 'jkline', 'ajfitzpatric', 'tdcosta', 'chunkaiwong', 'mgerhardson', 'ethan402', 'mamohamed', 'ssproviero', 'nkorniyenko', 'sdanielson', 'tkoopman', 'nbrayer', 'eajenkins', 'jjpenney']",5,"['clemonias', 'weihuang', None, 'astam', 'aarshjain']",56,"['tianxinchen', 'stevenmcgrat', 'kgeorgadarel5', 'wkoski', 'abecirovic', 'gbayides', 'ajfitzpatric', 'clemonias', 'ethan402', 'ajabraha', 'cwijesundara', 'mamohamed', 'daviddowns', 'ssproviero', 'nkorniyenko', 'tkoopman', 'rsarge', 'nbrayer', 'egrimaldi', 'emailhot', 'mshliselberg', 'suoangao', 'jjpenney', 'tbaim', 'mbolognese', 'haoxianlin', 'davidchen123', 'jasonnguyen', 'ctimmerman', 'amajee', 'jgordon', 'jkline', 'astam', 'saswatiswain', 'tdcosta', 'xiaobinliu', 'chunkaiwong', 'mgerhardson', 'coleman.j.ryan', 'dmathieu', 'asjogren', 'mzeimbekakis', 'yujiahuo', 'nspaine', 'jpetrovick', 'weihuang', 'sdanielson', None, 'matthewdonne141', 'lluchetti', 'eajenkins', 'inwilliams', 'bifisher', 'siyuwu', 'mpool', 'aarshjain']"
14,270,52,12,10,"['ajfitzpatric', 'tdcosta', 'stevenmcgrat', 'xiaobinliu', 'jjpenney', 'jpetrovick', 'ethan402', 'sdanielson', 'amajee', 'tkoopman']",41,"['tbaim', 'tianxinchen', 'mbolognese', 'haoxianlin', 'davidchen123', 'jasonnguyen', 'kgeorgadarel5', 'wkoski', 'ctimmerman', 'abecirovic', 'jgordon', 'jkline', 'saswatiswain', 'gbayides', 'chunkaiwong', 'mgerhardson', 'coleman.j.ryan', 'dmathieu', 'asjogren', 'mzeimbekakis', 'yujiahuo', 'cwijesundara', 'ajabraha', 'mamohamed', 'daviddowns', 'nspaine', 'ssproviero', 'nkorniyenko', 'matthewdonne141', 'rsarge', 'lluchetti', 'nbrayer', 'egrimaldi', 'emailhot', 'eajenkins', 'mshliselberg', 'inwilliams', 'suoangao', 'bifisher', 'siyuwu', 'mpool']",2,"[None, 'aarshjain']",53,"['tbaim', 'tianxinchen', 'mbolognese', 'haoxianlin', 'davidchen123', 'stevenmcgrat', 'jasonnguyen', 'kgeorgadarel5', 'wkoski', 'ctimmerman', 'abecirovic', 'amajee', 'jgordon', 'jkline', 'saswatiswain', 'gbayides', 'ajfitzpatric', 'tdcosta', 'xiaobinliu', 'chunkaiwong', 'mgerhardson', 'coleman.j.ryan', 'ethan402', 'dmathieu', 'asjogren', 'mzeimbekakis', 'yujiahuo', 'cwijesundara', 'ajabraha', 'mamohamed', 'daviddowns', 'nspaine', 'jpetrovick', 'ssproviero', 'nkorniyenko', 'sdanielson', 'tkoopman', 'matthewdonne141', None, 'rsarge', 'lluchetti', 'nbrayer', 'egrimaldi', 'emailhot', 'eajenkins', 'mshliselberg', 'inwilliams', 'suoangao', 'bifisher', 'jjpenney', 'siyuwu', 'mpool', 'aarshjain']"
15,322,51,60,32,"['zamzam90', 'linnaduan', 'li1651', 'runvacheck', 'sunyx1223', 'akhilvijay', 'ariados88', 'zhao731', 'ahmadi1', 'rajagopv', 'schcats', 'thoma501', 'skarumur', 'jain205', 'guimingchen', 'infi0508', 'nanoquan2016', 'ye173', 'matthe18', 'jing1995', 'hdhandap', 'pranavj186', 'roysoumya', 'turkstra', 'ma462', 'bradneym', 'alaverni', 'awilbee', 'jenkin50', 'ewares', 'shen338', 'yu207']",18,"['yyb0576', 'nspoentgen', 'vvivekan', 'harshil', 'xu399', 'revati27', 'lnimmaga', 'adandeka', 'smungamu', 'hezitao', 'orthm', 'pkolis', 'selvara0', 'naik.pratik', 'vvswarup88', 'rice', 'fang58', 'lijiarui1115']",28,"['zhongy92', 'ben.helfrecht', 'li1724', 'liushunyu', 'pmeunier', 'anur.bhat', 'zdang', 'jcondori', 'mshisheh', 'bhaley', 'pratik.chawla42', 'msakano', 'xihao', 'abaruah', 'arobiso', 'misra4', 'tian53', 'prasadsarang', 'ge24', 'denphi', None, 'rafatulfaria', 'enassakr', 'zooley', 'ujash', 'ewilson000', 'ayanhazra2007', 'talee94']",78,"['yyb0576', 'zamzam90', 'zhongy92', 'linnaduan', 'ben.helfrecht', 'runvacheck', 'rice', 'harshil', 'adandeka', 'hezitao', 'mshisheh', 'selvara0', 'schcats', 'bhaley', 'pratik.chawla42', 'xihao', 'jain205', 'smungamu', 'misra4', 'tian53', 'prasadsarang', 'enassakr', 'zooley', 'alaverni', 'ujash', 'vvswarup88', 'ewares', 'ayanhazra2007', 'shen338', 'fang58', 'yu207', 'talee94', 'nspoentgen', 'li1651', 'li1724', 'sunyx1223', 'akhilvijay', 'ariados88', 'liushunyu', 'lijiarui1115', 'pmeunier', 'zhao731', 'vvivekan', 'anur.bhat', 'zdang', 'orthm', 'ahmadi1', 'rajagopv', 'jcondori', 'thoma501', 'msakano', 'skarumur', 'abaruah', 'guimingchen', 'infi0508', 'nanoquan2016', 'xu399', 'ye173', 'arobiso', 'matthe18', 'jing1995', 'pkolis', 'hdhandap', 'pranavj186', 'ge24', 'denphi', 'roysoumya', None, 'rafatulfaria', 'revati27', 'turkstra', 'lnimmaga', 'ma462', 'bradneym', 'awilbee', 'jenkin50', 'naik.pratik', 'ewilson000']"
15,321,51,36,16,"['nspoentgen', 'vvivekan', 'revati27', 'xu399', 'lnimmaga', 'ewares', 'adandeka', 'smungamu', 'ahmadi1', 'selvara0', 'jenkin50', 'vvswarup88', 'pranavj186', 'rice', 'fang58', 'lijiarui1115']",34,"['yyb0576', 'zamzam90', 'linnaduan', 'li1651', 'runvacheck', 'sunyx1223', 'akhilvijay', 'ariados88', 'zhao731', 'harshil', 'hezitao', 'orthm', 'rajagopv', 'schcats', 'thoma501', 'skarumur', 'jain205', 'guimingchen', 'infi0508', 'nanoquan2016', 'ye173', 'matthe18', 'jing1995', 'pkolis', 'hdhandap', 'roysoumya', 'turkstra', 'ma462', 'bradneym', 'alaverni', 'awilbee', 'naik.pratik', 'shen338', 'yu207']",20,"['rwarburt', 'tshivam4', 'ben.helfrecht', 'venkat77', 'zeng133', 'biswas19', 'bcbukows', 'yash.hurkat1994', 'patel718', 'armen1', 'misra4', 'mo26', 'irislee050', None, 'zhan2331', 'yanliang', 'jefonseca', 'wangruisong24', 'ujash', 'abhi.reddy525']",70,"['yyb0576', 'zamzam90', 'linnaduan', 'ben.helfrecht', 'runvacheck', 'zeng133', 'rice', 'harshil', 'adandeka', 'hezitao', 'selvara0', 'schcats', 'yash.hurkat1994', 'jain205', 'patel718', 'smungamu', 'armen1', 'misra4', 'jefonseca', 'alaverni', 'ujash', 'vvswarup88', 'ewares', 'shen338', 'fang58', 'yu207', 'abhi.reddy525', 'rwarburt', 'nspoentgen', 'tshivam4', 'li1651', 'sunyx1223', 'venkat77', 'akhilvijay', 'ariados88', 'biswas19', 'lijiarui1115', 'zhao731', 'vvivekan', 'orthm', 'ahmadi1', 'rajagopv', 'bcbukows', 'thoma501', 'skarumur', 'guimingchen', 'infi0508', 'nanoquan2016', 'xu399', 'ye173', 'matthe18', 'jing1995', 'pkolis', 'hdhandap', 'mo26', 'irislee050', 'pranavj186', 'roysoumya', None, 'zhan2331', 'yanliang', 'revati27', 'turkstra', 'lnimmaga', 'ma462', 'wangruisong24', 'bradneym', 'awilbee', 'jenkin50', 'naik.pratik']"
15,333,51,34,30,"['zamzam90', 'linnaduan', 'runvacheck', 'sunyx1223', 'akhilvijay', 'ariados88', 'zhao731', 'harshil', 'adandeka', 'hezitao', 'ahmadi1', 'rajagopv', 'schcats', 'thoma501', 'jain205', 'guimingchen', 'infi0508', 'nanoquan2016', 'xu399', 'ye173', 'matthe18', 'jing1995', 'hdhandap', 'roysoumya', 'turkstra', 'ma462', 'alaverni', 'awilbee', 'jenkin50', 'yu207']",20,"['yyb0576', 'nspoentgen', 'li1651', 'rice', 'lijiarui1115', 'vvivekan', 'orthm', 'selvara0', 'vvswarup88', 'skarumur', 'smungamu', 'pkolis', 'pranavj186', 'revati27', 'lnimmaga', 'bradneym', 'naik.pratik', 'ewares', 'shen338', 'fang58']",4,"[None, 'sreeve', 'amrshahat', 'wang159']",54,"['yyb0576', 'zamzam90', 'linnaduan', 'runvacheck', 'rice', 'sreeve', 'harshil', 'adandeka', 'hezitao', 'selvara0', 'schcats', 'jain205', 'smungamu', 'alaverni', 'vvswarup88', 'ewares', 'shen338', 'fang58', 'yu207', 'nspoentgen', 'li1651', 'amrshahat', 'sunyx1223', 'akhilvijay', 'ariados88', 'lijiarui1115', 'zhao731', 'vvivekan', 'orthm', 'ahmadi1', 'rajagopv', 'thoma501', 'skarumur', 'guimingchen', 'infi0508', 'nanoquan2016', 'xu399', 'ye173', 'matthe18', 'jing1995', 'pkolis', 'hdhandap', 'pranavj186', 'roysoumya', None, 'revati27', 'turkstra', 'lnimmaga', 'ma462', 'bradneym', 'awilbee', 'jenkin50', 'naik.pratik', 'wang159']"
15,324,51,28,21,"['zamzam90', 'ariados88', 'zhao731', 'ahmadi1', 'rajagopv', 'schcats', 'thoma501', 'skarumur', 'jain205', 'nanoquan2016', 'xu399', 'matthe18', 'jing1995', 'hdhandap', 'pranavj186', 'roysoumya', 'turkstra', 'alaverni', 'bradneym', 'jenkin50', 'yu207']",29,"['yyb0576', 'nspoentgen', 'linnaduan', 'ewares', 'li1651', 'runvacheck', 'sunyx1223', 'akhilvijay', 'rice', 'lijiarui1115', 'vvivekan', 'harshil', 'adandeka', 'hezitao', 'orthm', 'selvara0', 'guimingchen', 'infi0508', 'ye173', 'smungamu', 'pkolis', 'revati27', 'lnimmaga', 'ma462', 'awilbee', 'naik.pratik', 'vvswarup88', 'shen338', 'fang58']",7,"['enassakr', 'apps', 'tian53', 'denphi', None, 'pmeunier', 'hvr']",57,"['yyb0576', 'zamzam90', 'linnaduan', 'runvacheck', 'rice', 'harshil', 'adandeka', 'hezitao', 'selvara0', 'schcats', 'jain205', 'smungamu', 'tian53', 'enassakr', 'alaverni', 'vvswarup88', 'ewares', 'shen338', 'fang58', 'yu207', 'nspoentgen', 'li1651', 'sunyx1223', 'akhilvijay', 'ariados88', 'lijiarui1115', 'pmeunier', 'zhao731', 'vvivekan', 'orthm', 'ahmadi1', 'rajagopv', 'thoma501', 'skarumur', 'guimingchen', 'infi0508', 'nanoquan2016', 'xu399', 'ye173', 'matthe18', 'jing1995', 'pkolis', 'hdhandap', 'pranavj186', 'denphi', 'roysoumya', None, 'hvr', 'revati27', 'turkstra', 'apps', 'lnimmaga', 'ma462', 'bradneym', 'awilbee', 'jenkin50', 'naik.pratik']"
15,327,51,27,18,"['zamzam90', 'harshil', 'ma462', 'alaverni', 'hezitao', 'runvacheck', 'matthe18', 'ahmadi1', 'rajagopv', 'jing1995', 'thoma501', 'hdhandap', 'pranavj186', 'vvswarup88', 'ariados88', 'roysoumya', 'jain205', 'shen338']",32,"['yyb0576', 'nspoentgen', 'linnaduan', 'li1651', 'sunyx1223', 'akhilvijay', 'rice', 'lijiarui1115', 'zhao731', 'vvivekan', 'adandeka', 'orthm', 'selvara0', 'schcats', 'skarumur', 'guimingchen', 'infi0508', 'nanoquan2016', 'xu399', 'ye173', 'smungamu', 'pkolis', 'revati27', 'turkstra', 'lnimmaga', 'bradneym', 'awilbee', 'jenkin50', 'naik.pratik', 'ewares', 'fang58', 'yu207']",9,"['nanohueb', 'zhongy92', 'enassakr', 'nkissebe', 'atankas', 'clarksm', None, 'pmeunier', 'larsmusland']",59,"['yyb0576', 'zamzam90', 'zhongy92', 'nanohueb', 'linnaduan', 'runvacheck', 'rice', 'harshil', 'adandeka', 'hezitao', 'selvara0', 'schcats', 'jain205', 'larsmusland', 'smungamu', 'nkissebe', 'enassakr', 'alaverni', 'vvswarup88', 'ewares', 'shen338', 'fang58', 'yu207', 'nspoentgen', 'li1651', 'sunyx1223', 'akhilvijay', 'ariados88', 'lijiarui1115', 'pmeunier', 'zhao731', 'vvivekan', 'orthm', 'ahmadi1', 'rajagopv', 'thoma501', 'skarumur', 'guimingchen', 'infi0508', 'nanoquan2016', 'xu399', 'ye173', 'matthe18', 'jing1995', 'pkolis', 'hdhandap', 'pranavj186', 'clarksm', 'roysoumya', None, 'revati27', 'turkstra', 'lnimmaga', 'ma462', 'bradneym', 'awilbee', 'jenkin50', 'naik.pratik', 'atankas']"
15,330,51,26,21,"['zamzam90', 'runvacheck', 'sunyx1223', 'akhilvijay', 'ariados88', 'hezitao', 'ahmadi1', 'rajagopv', 'jain205', 'ye173', 'matthe18', 'jing1995', 'hdhandap', 'pranavj186', 'roysoumya', 'turkstra', 'ma462', 'awilbee', 'vvswarup88', 'shen338', 'yu207']",29,"['yyb0576', 'nspoentgen', 'linnaduan', 'li1651', 'rice', 'lijiarui1115', 'zhao731', 'vvivekan', 'harshil', 'adandeka', 'orthm', 'selvara0', 'schcats', 'thoma501', 'skarumur', 'guimingchen', 'infi0508', 'nanoquan2016', 'xu399', 'smungamu', 'pkolis', 'revati27', 'lnimmaga', 'bradneym', 'alaverni', 'jenkin50', 'naik.pratik', 'ewares', 'fang58']",5,"['enassakr', 'ukamran', 'mshisheh', 'abdou', None]",55,"['yyb0576', 'zamzam90', 'nspoentgen', 'linnaduan', 'ukamran', 'li1651', 'runvacheck', 'sunyx1223', 'akhilvijay', 'rice', 'ariados88', 'lijiarui1115', 'zhao731', 'vvivekan', 'harshil', 'adandeka', 'hezitao', 'orthm', 'ahmadi1', 'rajagopv', 'schcats', 'thoma501', 'selvara0', 'skarumur', 'vvswarup88', 'mshisheh', 'jain205', 'guimingchen', 'infi0508', 'nanoquan2016', 'xu399', 'ye173', 'smungamu', 'matthe18', 'jing1995', 'pkolis', 'hdhandap', 'abdou', 'pranavj186', 'roysoumya', None, 'enassakr', 'revati27', 'turkstra', 'lnimmaga', 'ma462', 'bradneym', 'alaverni', 'awilbee', 'jenkin50', 'naik.pratik', 'ewares', 'shen338', 'fang58', 'yu207']"
15,320,51,25,1,['turkstra'],49,"['yyb0576', 'zamzam90', 'nspoentgen', 'linnaduan', 'ewares', 'li1651', 'runvacheck', 'sunyx1223', 'akhilvijay', 'rice', 'ariados88', 'lijiarui1115', 'zhao731', 'vvivekan', 'harshil', 'adandeka', 'hezitao', 'orthm', 'ahmadi1', 'rajagopv', 'schcats', 'thoma501', 'selvara0', 'skarumur', 'jain205', 'guimingchen', 'infi0508', 'nanoquan2016', 'xu399', 'ye173', 'smungamu', 'matthe18', 'jing1995', 'pkolis', 'hdhandap', 'pranavj186', 'roysoumya', 'revati27', 'lnimmaga', 'ma462', 'bradneym', 'alaverni', 'awilbee', 'jenkin50', 'naik.pratik', 'vvswarup88', 'shen338', 'fang58', 'yu207']",24,"['nanohueb', 'davgumo', 'lefeizhang913', 'blissm95', 'mshisheh', 'hctest3', 'bhaley', 'a222utumn', 'fernan94', 'nraghav', 'dkearney', 'bermel', 'hesam', 'tian53', 'chenyiyi44', 'denphi', 'mmh', None, 'rafatulfaria', 'hctest4', 'enassakr', 'samikm', 'ddelhoyotorres', 'pantho012']",74,"['yyb0576', 'zamzam90', 'nspoentgen', 'nanohueb', 'linnaduan', 'li1651', 'runvacheck', 'davgumo', 'sunyx1223', 'akhilvijay', 'rice', 'ariados88', 'lefeizhang913', 'lijiarui1115', 'zhao731', 'vvivekan', 'harshil', 'adandeka', 'hezitao', 'blissm95', 'orthm', 'ahmadi1', 'rajagopv', 'schcats', 'thoma501', 'selvara0', 'skarumur', 'vvswarup88', 'mshisheh', 'hctest3', 'bhaley', 'a222utumn', 'jain205', 'guimingchen', 'fernan94', 'infi0508', 'nanoquan2016', 'xu399', 'ye173', 'nraghav', 'dkearney', 'smungamu', 'bermel', 'matthe18', 'hesam', 'jing1995', 'pkolis', 'hdhandap', 'tian53', 'pranavj186', 'chenyiyi44', 'denphi', 'roysoumya', 'mmh', None, 'rafatulfaria', 'hctest4', 'enassakr', 'revati27', 'turkstra', 'samikm', 'lnimmaga', 'ma462', 'bradneym', 'alaverni', 'ddelhoyotorres', 'awilbee', 'jenkin50', 'naik.pratik', 'pantho012', 'ewares', 'shen338', 'fang58', 'yu207']"
15,334,51,16,13,"['zamzam90', 'turkstra', 'harshil', 'hezitao', 'jing1995', 'ahmadi1', 'hdhandap', 'rajagopv', 'akhilvijay', 'thoma501', 'ariados88', 'shen338', 'yu207']",37,"['yyb0576', 'nspoentgen', 'linnaduan', 'ewares', 'li1651', 'runvacheck', 'sunyx1223', 'rice', 'lijiarui1115', 'zhao731', 'vvivekan', 'adandeka', 'orthm', 'selvara0', 'schcats', 'skarumur', 'jain205', 'guimingchen', 'infi0508', 'nanoquan2016', 'xu399', 'ye173', 'smungamu', 'matthe18', 'pkolis', 'pranavj186', 'roysoumya', 'revati27', 'lnimmaga', 'ma462', 'bradneym', 'alaverni', 'awilbee', 'jenkin50', 'naik.pratik', 'vvswarup88', 'fang58']",3,"[None, 'wang159', 'amrshahat']",53,"['yyb0576', 'zamzam90', 'nspoentgen', 'linnaduan', 'li1651', 'amrshahat', 'runvacheck', 'sunyx1223', 'akhilvijay', 'rice', 'ariados88', 'lijiarui1115', 'zhao731', 'vvivekan', 'harshil', 'adandeka', 'hezitao', 'orthm', 'ahmadi1', 'rajagopv', 'schcats', 'thoma501', 'selvara0', 'skarumur', 'vvswarup88', 'jain205', 'guimingchen', 'infi0508', 'nanoquan2016', 'xu399', 'ye173', 'smungamu', 'matthe18', 'jing1995', 'pkolis', 'hdhandap', 'pranavj186', 'roysoumya', None, 'revati27', 'turkstra', 'lnimmaga', 'ma462', 'bradneym', 'alaverni', 'awilbee', 'jenkin50', 'naik.pratik', 'wang159', 'ewares', 'shen338', 'fang58', 'yu207']"
15,331,51,11,10,"['vvivekan', 'revati27', 'nspoentgen', 'lnimmaga', 'lijiarui1115', 'selvara0', 'skarumur', 'pranavj186', 'vvswarup88', 'fang58']",40,"['yyb0576', 'zamzam90', 'linnaduan', 'li1651', 'runvacheck', 'sunyx1223', 'akhilvijay', 'rice', 'ariados88', 'zhao731', 'harshil', 'adandeka', 'hezitao', 'orthm', 'ahmadi1', 'rajagopv', 'schcats', 'thoma501', 'jain205', 'guimingchen', 'infi0508', 'nanoquan2016', 'xu399', 'ye173', 'smungamu', 'matthe18', 'jing1995', 'pkolis', 'hdhandap', 'roysoumya', 'turkstra', 'ma462', 'bradneym', 'alaverni', 'awilbee', 'jenkin50', 'naik.pratik', 'ewares', 'shen338', 'yu207']",1,[None],51,"['yyb0576', 'zamzam90', 'nspoentgen', 'linnaduan', 'li1651', 'runvacheck', 'sunyx1223', 'akhilvijay', 'rice', 'ariados88', 'lijiarui1115', 'zhao731', 'vvivekan', 'harshil', 'adandeka', 'hezitao', 'orthm', 'ahmadi1', 'rajagopv', 'schcats', 'thoma501', 'selvara0', 'skarumur', 'vvswarup88', 'jain205', 'guimingchen', 'infi0508', 'nanoquan2016', 'xu399', 'ye173', 'smungamu', 'matthe18', 'jing1995', 'pkolis', 'hdhandap', 'pranavj186', 'roysoumya', None, 'revati27', 'turkstra', 'lnimmaga', 'ma462', 'bradneym', 'alaverni', 'awilbee', 'jenkin50', 'naik.pratik', 'ewares', 'shen338', 'fang58', 'yu207']"
15,326,51,10,1,['li1651'],49,"['yyb0576', 'zamzam90', 'nspoentgen', 'linnaduan', 'runvacheck', 'sunyx1223', 'akhilvijay', 'rice', 'ariados88', 'lijiarui1115', 'zhao731', 'vvivekan', 'harshil', 'adandeka', 'hezitao', 'orthm', 'ahmadi1', 'rajagopv', 'schcats', 'thoma501', 'selvara0', 'skarumur', 'vvswarup88', 'jain205', 'guimingchen', 'infi0508', 'nanoquan2016', 'xu399', 'ye173', 'smungamu', 'matthe18', 'jing1995', 'pkolis', 'hdhandap', 'pranavj186', 'roysoumya', 'revati27', 'turkstra', 'lnimmaga', 'ma462', 'bradneym', 'alaverni', 'awilbee', 'jenkin50', 'naik.pratik', 'ewares', 'shen338', 'fang58', 'yu207']",9,"['enassakr', 'kolispeter', 'valencid', 'sunxingshu', 'tian53', 'clarksm', None, 'pmeunier', 'larsmusland']",59,"['yyb0576', 'zamzam90', 'nspoentgen', 'linnaduan', 'li1651', 'runvacheck', 'sunyx1223', 'akhilvijay', 'rice', 'ariados88', 'lijiarui1115', 'pmeunier', 'zhao731', 'vvivekan', 'harshil', 'adandeka', 'hezitao', 'orthm', 'ahmadi1', 'rajagopv', 'schcats', 'thoma501', 'selvara0', 'skarumur', 'vvswarup88', 'jain205', 'guimingchen', 'larsmusland', 'infi0508', 'nanoquan2016', 'xu399', 'ye173', 'smungamu', 'matthe18', 'sunxingshu', 'jing1995', 'pkolis', 'hdhandap', 'tian53', 'pranavj186', 'clarksm', 'roysoumya', None, 'enassakr', 'revati27', 'turkstra', 'lnimmaga', 'ma462', 'kolispeter', 'valencid', 'bradneym', 'alaverni', 'awilbee', 'jenkin50', 'naik.pratik', 'ewares', 'shen338', 'fang58', 'yu207']"
15,332,51,10,9,"['vvivekan', 'revati27', 'nspoentgen', 'lnimmaga', 'selvara0', 'skarumur', 'pranavj186', 'ewares', 'fang58']",41,"['yyb0576', 'zamzam90', 'linnaduan', 'li1651', 'runvacheck', 'sunyx1223', 'akhilvijay', 'rice', 'ariados88', 'lijiarui1115', 'zhao731', 'harshil', 'adandeka', 'hezitao', 'orthm', 'ahmadi1', 'rajagopv', 'schcats', 'thoma501', 'vvswarup88', 'jain205', 'guimingchen', 'infi0508', 'nanoquan2016', 'xu399', 'ye173', 'smungamu', 'matthe18', 'jing1995', 'pkolis', 'hdhandap', 'roysoumya', 'turkstra', 'ma462', 'bradneym', 'alaverni', 'awilbee', 'jenkin50', 'naik.pratik', 'shen338', 'yu207']",1,[None],51,"['yyb0576', 'zamzam90', 'nspoentgen', 'linnaduan', 'li1651', 'runvacheck', 'sunyx1223', 'akhilvijay', 'rice', 'ariados88', 'lijiarui1115', 'zhao731', 'vvivekan', 'harshil', 'adandeka', 'hezitao', 'orthm', 'ahmadi1', 'rajagopv', 'schcats', 'thoma501', 'selvara0', 'skarumur', 'vvswarup88', 'jain205', 'guimingchen', 'infi0508', 'nanoquan2016', 'xu399', 'ye173', 'smungamu', 'matthe18', 'jing1995', 'pkolis', 'hdhandap', 'pranavj186', 'roysoumya', None, 'revati27', 'turkstra', 'lnimmaga', 'ma462', 'bradneym', 'alaverni', 'awilbee', 'jenkin50', 'naik.pratik', 'ewares', 'shen338', 'fang58', 'yu207']"
15,328,51,9,8,"['nspoentgen', 'revati27', 'lnimmaga', 'adandeka', 'skarumur', 'vvswarup88', 'rice', 'fang58']",42,"['yyb0576', 'zamzam90', 'linnaduan', 'li1651', 'runvacheck', 'sunyx1223', 'akhilvijay', 'ariados88', 'lijiarui1115', 'zhao731', 'vvivekan', 'harshil', 'hezitao', 'orthm', 'ahmadi1', 'rajagopv', 'schcats', 'thoma501', 'selvara0', 'jain205', 'guimingchen', 'infi0508', 'nanoquan2016', 'xu399', 'ye173', 'smungamu', 'matthe18', 'jing1995', 'pkolis', 'hdhandap', 'pranavj186', 'roysoumya', 'turkstra', 'ma462', 'bradneym', 'alaverni', 'awilbee', 'jenkin50', 'naik.pratik', 'ewares', 'shen338', 'yu207']",1,[None],51,"['yyb0576', 'zamzam90', 'nspoentgen', 'linnaduan', 'li1651', 'runvacheck', 'sunyx1223', 'akhilvijay', 'rice', 'ariados88', 'lijiarui1115', 'zhao731', 'vvivekan', 'harshil', 'adandeka', 'hezitao', 'orthm', 'ahmadi1', 'rajagopv', 'schcats', 'thoma501', 'selvara0', 'skarumur', 'vvswarup88', 'jain205', 'guimingchen', 'infi0508', 'nanoquan2016', 'xu399', 'ye173', 'smungamu', 'matthe18', 'jing1995', 'pkolis', 'hdhandap', 'pranavj186', 'roysoumya', None, 'revati27', 'turkstra', 'lnimmaga', 'ma462', 'bradneym', 'alaverni', 'awilbee', 'jenkin50', 'naik.pratik', 'ewares', 'shen338', 'fang58', 'yu207']"
15,323,51,7,2,"['turkstra', 'runvacheck']",48,"['yyb0576', 'zamzam90', 'nspoentgen', 'linnaduan', 'li1651', 'sunyx1223', 'akhilvijay', 'rice', 'ariados88', 'lijiarui1115', 'zhao731', 'vvivekan', 'harshil', 'adandeka', 'hezitao', 'orthm', 'ahmadi1', 'rajagopv', 'schcats', 'thoma501', 'selvara0', 'skarumur', 'vvswarup88', 'jain205', 'guimingchen', 'infi0508', 'nanoquan2016', 'xu399', 'ye173', 'smungamu', 'matthe18', 'jing1995', 'pkolis', 'hdhandap', 'pranavj186', 'roysoumya', 'revati27', 'lnimmaga', 'ma462', 'bradneym', 'alaverni', 'awilbee', 'jenkin50', 'naik.pratik', 'ewares', 'shen338', 'fang58', 'yu207']",5,"['enassakr', 'tian53', 'denphi', None, 'hvr']",55,"['yyb0576', 'zamzam90', 'nspoentgen', 'linnaduan', 'li1651', 'runvacheck', 'sunyx1223', 'akhilvijay', 'rice', 'ariados88', 'lijiarui1115', 'zhao731', 'vvivekan', 'harshil', 'adandeka', 'hezitao', 'orthm', 'ahmadi1', 'rajagopv', 'schcats', 'thoma501', 'selvara0', 'skarumur', 'vvswarup88', 'jain205', 'guimingchen', 'infi0508', 'nanoquan2016', 'xu399', 'ye173', 'smungamu', 'matthe18', 'jing1995', 'pkolis', 'hdhandap', 'tian53', 'pranavj186', 'denphi', 'roysoumya', None, 'hvr', 'enassakr', 'revati27', 'turkstra', 'lnimmaga', 'ma462', 'bradneym', 'alaverni', 'awilbee', 'jenkin50', 'naik.pratik', 'ewares', 'shen338', 'fang58', 'yu207']"
15,325,51,7,5,"['nspoentgen', 'revati27', 'vvswarup88', 'rice', 'fang58']",45,"['yyb0576', 'zamzam90', 'linnaduan', 'li1651', 'runvacheck', 'sunyx1223', 'akhilvijay', 'ariados88', 'lijiarui1115', 'zhao731', 'vvivekan', 'harshil', 'adandeka', 'hezitao', 'orthm', 'ahmadi1', 'rajagopv', 'schcats', 'thoma501', 'selvara0', 'skarumur', 'jain205', 'guimingchen', 'infi0508', 'nanoquan2016', 'xu399', 'ye173', 'smungamu', 'matthe18', 'jing1995', 'pkolis', 'hdhandap', 'pranavj186', 'roysoumya', 'turkstra', 'lnimmaga', 'ma462', 'bradneym', 'alaverni', 'awilbee', 'jenkin50', 'naik.pratik', 'ewares', 'shen338', 'yu207']",2,"[None, 'wangruisong24']",52,"['yyb0576', 'zamzam90', 'nspoentgen', 'linnaduan', 'li1651', 'runvacheck', 'sunyx1223', 'akhilvijay', 'rice', 'ariados88', 'lijiarui1115', 'zhao731', 'vvivekan', 'harshil', 'adandeka', 'hezitao', 'orthm', 'ahmadi1', 'rajagopv', 'schcats', 'thoma501', 'selvara0', 'skarumur', 'vvswarup88', 'jain205', 'guimingchen', 'infi0508', 'nanoquan2016', 'xu399', 'ye173', 'smungamu', 'matthe18', 'jing1995', 'pkolis', 'hdhandap', 'pranavj186', 'roysoumya', None, 'revati27', 'turkstra', 'lnimmaga', 'ma462', 'wangruisong24', 'bradneym', 'alaverni', 'awilbee', 'jenkin50', 'naik.pratik', 'ewares', 'shen338', 'fang58', 'yu207']"
15,329,51,6,1,['alaverni'],49,"['yyb0576', 'zamzam90', 'nspoentgen', 'linnaduan', 'li1651', 'runvacheck', 'sunyx1223', 'akhilvijay', 'rice', 'ariados88', 'lijiarui1115', 'zhao731', 'vvivekan', 'harshil', 'adandeka', 'hezitao', 'orthm', 'ahmadi1', 'rajagopv', 'schcats', 'thoma501', 'selvara0', 'skarumur', 'vvswarup88', 'jain205', 'guimingchen', 'infi0508', 'nanoquan2016', 'xu399', 'ye173', 'smungamu', 'matthe18', 'jing1995', 'pkolis', 'hdhandap', 'pranavj186', 'roysoumya', 'revati27', 'turkstra', 'lnimmaga', 'ma462', 'bradneym', 'awilbee', 'jenkin50', 'naik.pratik', 'ewares', 'shen338', 'fang58', 'yu207']",5,"['enassakr', 'apps', 'wang159', 'clarksm', None]",55,"['yyb0576', 'zamzam90', 'nspoentgen', 'linnaduan', 'li1651', 'runvacheck', 'sunyx1223', 'akhilvijay', 'rice', 'ariados88', 'lijiarui1115', 'zhao731', 'vvivekan', 'harshil', 'adandeka', 'hezitao', 'orthm', 'ahmadi1', 'rajagopv', 'schcats', 'thoma501', 'selvara0', 'skarumur', 'vvswarup88', 'jain205', 'guimingchen', 'infi0508', 'nanoquan2016', 'xu399', 'ye173', 'smungamu', 'matthe18', 'jing1995', 'pkolis', 'hdhandap', 'pranavj186', 'clarksm', 'roysoumya', None, 'enassakr', 'revati27', 'turkstra', 'apps', 'lnimmaga', 'ma462', 'bradneym', 'alaverni', 'awilbee', 'jenkin50', 'naik.pratik', 'wang159', 'ewares', 'shen338', 'fang58', 'yu207']"
16,96,49,56,29,"['huang502', 'upton0', 'sentz', 'pgilliat', 'apadget', 'lletner', 'bshilson', 'vwerner', 'goldmandrummer', 'lawrence.lee2222', 'zhan1820', 'tpathak', 'fishe128', 'yang764', 'bcarterwhs13', 'munjuncho182', 'amassat', 'maxbrown112', 'zhu340', 'gdykes', 'ajbruns2160', 'servinb', 'dhoch', 'ebartusi', 'smit2257', 'mferoz', 'cho133', 'corbeta', 'roy48']",19,"['chenxi9577', 'vigneshsivaprakasam', 'lee607', 'ninthjoseph', 'fang177', 'shively0', 'aswamina', 'yang872', 'jpmahony4', 'jiang330', 'hdas', 'nupton', 'ho55', 'lu385', 'sun357950810', 'jclaussen27', 'kuhn2', 'zhao546', 'zhai312313']",27,"['ukamran', 'son13', 'sunxiantian123', 'tsentz95', 'arash2342', 'samlocke37', 'adityap', 'malhotr0', 'pawara', 'blissm95', 'jbcolema', 'mhagag', 'okhandel', 'madana', 'bermel', 'sridhar4', 'tinny93s', 'pengsherry119', None, 'gosman', 'mount18', 'schowdhury', 'jyshi', 'ppxxyy1109', 'qzmdtc1993', 'colegiannotti', 'ma287']",75,"['huang502', 'pgilliat', 'vigneshsivaprakasam', 'apadget', 'lee607', 'vwerner', 'fang177', 'lawrence.lee2222', 'tpathak', 'shively0', 'fishe128', 'samlocke37', 'aswamina', 'yang872', 'malhotr0', 'pawara', 'blissm95', 'jpmahony4', 'gdykes', 'hdas', 'nupton', 'bermel', 'servinb', 'dhoch', 'ebartusi', 'sun357950810', 'mferoz', 'mount18', 'schowdhury', 'qzmdtc1993', 'zhao546', 'cho133', 'corbeta', 'roy48', 'upton0', 'ukamran', 'sentz', 'chenxi9577', 'son13', 'lletner', 'bshilson', 'goldmandrummer', 'sunxiantian123', 'tsentz95', 'ninthjoseph', 'zhan1820', 'arash2342', 'adityap', 'yang764', 'bcarterwhs13', 'munjuncho182', 'jbcolema', 'amassat', 'mhagag', 'okhandel', 'maxbrown112', 'zhu340', 'jiang330', 'madana', 'ajbruns2160', 'ho55', 'sridhar4', 'tinny93s', 'lu385', 'pengsherry119', 'jclaussen27', 'smit2257', None, 'gosman', 'jyshi', 'ppxxyy1109', 'kuhn2', 'colegiannotti', 'ma287', 'zhai312313']"
16,85,49,21,17,"['mferoz', 'upton0', 'ajbruns2160', 'sentz', 'bcarterwhs13', 'pgilliat', 'munjuncho182', 'lletner', 'goldmandrummer', 'vwerner', 'ebartusi', 'cho133', 'lawrence.lee2222', 'tpathak', 'shively0', 'maxbrown112', 'gdykes']",31,"['huang502', 'chenxi9577', 'vigneshsivaprakasam', 'apadget', 'lee607', 'bshilson', 'ninthjoseph', 'fang177', 'zhan1820', 'fishe128', 'yang764', 'aswamina', 'yang872', 'amassat', 'jpmahony4', 'zhu340', 'jiang330', 'hdas', 'nupton', 'ho55', 'servinb', 'zhai312313', 'dhoch', 'lu385', 'sun357950810', 'jclaussen27', 'smit2257', 'kuhn2', 'zhao546', 'corbeta', 'roy48']",4,"['slocke', None, 'ramachav', 'blissm95']",52,"['huang502', 'upton0', 'ramachav', 'sentz', 'chenxi9577', 'pgilliat', 'vigneshsivaprakasam', 'apadget', 'lee607', 'bshilson', 'lletner', 'vwerner', 'goldmandrummer', 'ninthjoseph', 'fang177', 'lawrence.lee2222', 'zhan1820', 'shively0', 'tpathak', 'fishe128', 'yang764', 'aswamina', 'yang872', 'bcarterwhs13', 'munjuncho182', 'blissm95', 'corbeta', 'amassat', 'jpmahony4', 'maxbrown112', 'zhu340', 'gdykes', 'jiang330', 'hdas', 'nupton', 'ajbruns2160', 'ho55', 'servinb', 'dhoch', 'lu385', 'ebartusi', 'sun357950810', 'jclaussen27', 'smit2257', None, 'slocke', 'mferoz', 'kuhn2', 'zhao546', 'cho133', 'zhai312313', 'roy48']"
16,98,49,8,5,"['servinb', 'zhao546', 'jclaussen27', 'zhai312313', 'jiang330']",43,"['huang502', 'upton0', 'sentz', 'chenxi9577', 'pgilliat', 'vigneshsivaprakasam', 'apadget', 'lee607', 'bshilson', 'lletner', 'vwerner', 'goldmandrummer', 'ninthjoseph', 'fang177', 'lawrence.lee2222', 'zhan1820', 'shively0', 'tpathak', 'fishe128', 'yang764', 'aswamina', 'yang872', 'bcarterwhs13', 'munjuncho182', 'corbeta', 'amassat', 'jpmahony4', 'maxbrown112', 'zhu340', 'gdykes', 'hdas', 'nupton', 'ajbruns2160', 'ho55', 'dhoch', 'lu385', 'ebartusi', 'sun357950810', 'smit2257', 'mferoz', 'kuhn2', 'cho133', 'roy48']",3,"['liang142', 'klturne5', None]",51,"['huang502', 'upton0', 'sentz', 'chenxi9577', 'pgilliat', 'vigneshsivaprakasam', 'apadget', 'lee607', 'bshilson', 'lletner', 'vwerner', 'goldmandrummer', 'ninthjoseph', 'fang177', 'lawrence.lee2222', 'zhan1820', 'shively0', 'tpathak', 'fishe128', 'yang764', 'aswamina', 'yang872', 'bcarterwhs13', 'munjuncho182', 'corbeta', 'amassat', 'jpmahony4', 'maxbrown112', 'zhu340', 'gdykes', 'jiang330', 'hdas', 'nupton', 'ajbruns2160', 'ho55', 'servinb', 'dhoch', 'lu385', 'ebartusi', 'sun357950810', 'jclaussen27', 'smit2257', None, 'mferoz', 'liang142', 'kuhn2', 'klturne5', 'zhao546', 'cho133', 'zhai312313', 'roy48']"
17,319,43,33,29,"['thoma386', 'pspagnolo72', 'xphuah', 'kint', 'ahmed64', 'czy121301', 'parsonsm', 'mmckinne', 'ramirez28', 'alaimana', 'theresa.saenz.1', 'haller1', 'astronut95', 'chen1451', 'dacapo007', 'woodsh', 'lim154', 'zhu431', 'jiamanhe', 'jinghan1022', 'clandon01', 'pangb1', 'aianlo', 'posta', 'nspear17', 'kim383', 'lopez86', 'sgundala', 'tcurtiss']",13,"['ross_piedmonte', 'horner4', 'glinvill', 'hallowj', 'paulleonc', 'sawa', 'kaiser17', 'jenni.fifer.3', 'vganapa', 'jfschrad', 'cohen.jakedavid', 'smithjared1994', 'richa201']",4,"['campb122', None, 'azzedinr', 'robin198']",46,"['thoma386', 'horner4', 'glinvill', 'pspagnolo72', 'hallowj', 'paulleonc', 'campb122', 'kint', 'xphuah', 'ahmed64', 'robin198', 'jenni.fifer.3', 'czy121301', 'parsonsm', 'mmckinne', 'ramirez28', 'alaimana', 'kaiser17', 'theresa.saenz.1', 'haller1', 'astronut95', 'chen1451', 'dacapo007', 'smithjared1994', 'richa201', 'woodsh', 'lim154', 'zhu431', 'jiamanhe', 'jinghan1022', 'clandon01', 'azzedinr', 'vganapa', 'jfschrad', 'aianlo', 'cohen.jakedavid', 'pangb1', None, 'sawa', 'posta', 'ross_piedmonte', 'nspear17', 'kim383', 'lopez86', 'sgundala', 'tcurtiss']"
17,318,43,17,16,"['thoma386', 'lim154', 'paulleonc', 'xphuah', 'kint', 'ramirez28', 'alaimana', 'kaiser17', 'lopez86', 'jenni.fifer.3', 'astronut95', 'vganapa', 'jfschrad', 'aianlo', 'tcurtiss', 'smithjared1994']",26,"['horner4', 'glinvill', 'pspagnolo72', 'hallowj', 'ahmed64', 'czy121301', 'parsonsm', 'mmckinne', 'theresa.saenz.1', 'haller1', 'chen1451', 'dacapo007', 'woodsh', 'richa201', 'zhu431', 'jiamanhe', 'jinghan1022', 'clandon01', 'pangb1', 'cohen.jakedavid', 'sawa', 'posta', 'ross_piedmonte', 'nspear17', 'kim383', 'sgundala']",1,[None],43,"['thoma386', 'horner4', 'glinvill', 'pspagnolo72', 'hallowj', 'paulleonc', 'kint', 'xphuah', 'ahmed64', 'jenni.fifer.3', 'czy121301', 'parsonsm', 'mmckinne', 'ramirez28', 'alaimana', 'kaiser17', 'theresa.saenz.1', 'haller1', 'astronut95', 'chen1451', 'dacapo007', 'smithjared1994', 'richa201', 'woodsh', 'lim154', 'zhu431', 'jiamanhe', 'jinghan1022', 'clandon01', 'vganapa', 'jfschrad', 'aianlo', 'cohen.jakedavid', 'pangb1', None, 'sawa', 'posta', 'ross_piedmonte', 'nspear17', 'kim383', 'lopez86', 'sgundala', 'tcurtiss']"
17,220,43,15,1,['tcurtiss'],41,"['thoma386', 'horner4', 'glinvill', 'pspagnolo72', 'hallowj', 'paulleonc', 'kint', 'xphuah', 'ahmed64', 'jenni.fifer.3', 'czy121301', 'parsonsm', 'mmckinne', 'ramirez28', 'alaimana', 'kaiser17', 'theresa.saenz.1', 'haller1', 'astronut95', 'chen1451', 'dacapo007', 'smithjared1994', 'richa201', 'woodsh', 'lim154', 'zhu431', 'jiamanhe', 'jinghan1022', 'clandon01', 'vganapa', 'jfschrad', 'aianlo', 'cohen.jakedavid', 'pangb1', 'sawa', 'posta', 'ross_piedmonte', 'nspear17', 'kim383', 'lopez86', 'sgundala']",14,"['taw', 'sreeve', 'davidjohnson', 'faltens', 'spschriver', 'dmohant', 'mkephart', 'sritapaswi2007', 'zheng338', 'cspecty', 'caduartec', 'erich1016', None, 'smatsun']",56,"['thoma386', 'horner4', 'glinvill', 'pspagnolo72', 'davidjohnson', 'taw', 'hallowj', 'paulleonc', 'faltens', 'kint', 'xphuah', 'ahmed64', 'dmohant', 'jenni.fifer.3', 'czy121301', 'parsonsm', 'sreeve', 'mmckinne', 'ramirez28', 'mkephart', 'alaimana', 'kaiser17', 'theresa.saenz.1', 'haller1', 'zheng338', 'astronut95', 'chen1451', 'dacapo007', 'erich1016', 'smatsun', 'smithjared1994', 'richa201', 'woodsh', 'cspecty', 'lim154', 'zhu431', 'spschriver', 'jiamanhe', 'jinghan1022', 'clandon01', 'vganapa', 'jfschrad', 'aianlo', 'cohen.jakedavid', 'pangb1', 'caduartec', 'sawa', None, 'posta', 'ross_piedmonte', 'nspear17', 'kim383', 'lopez86', 'sgundala', 'sritapaswi2007', 'tcurtiss']"
18,222,42,39,29,"['selazab', 'aman0', 'ghinkle', 'ibrahim7', 'harribas', 'jscharre', 'kirby8', 'gfukumot', 'cmeisel', 'abusker', 'wang2621', 'mcconneb', 'long182', 'kcrew08', 'mgolm', 'mkrane', 'tstegall', 'jeinterz', 'ramos39', 'pkabra', 'srajesh10', 'grayfiel', 'bbattas', 'hdebose', 'kfortie', 'ngaurav', 'kdecocke', 'warren56', 'miramont']",12,"['bconners', 'ainaa_aisyaa', 'ander677', 'chaua', 'park710', 'akrawec', 'wildm', 'kkm11102000', 'kim1797', 'cochrad', 'mokuniew', 'hvaught']",10,"['young260', 'clary0', 'emeiner', 'campb122', 'acorda', 'astubber2016', 'lschroer24', 'hrowlan', 'hweldy', None]",51,"['campb122', 'aman0', 'jscharre', 'harribas', 'hrowlan', 'gfukumot', 'cmeisel', 'akrawec', 'mokuniew', 'wang2621', 'kcrew08', 'chaua', 'astubber2016', 'lschroer24', 'mkrane', 'kim1797', 'park710', 'tstegall', 'ainaa_aisyaa', 'ramos39', 'clary0', 'grayfiel', 'bbattas', 'hweldy', 'young260', 'selazab', 'emeiner', 'ghinkle', 'ibrahim7', 'kkm11102000', 'bconners', 'kirby8', 'abusker', 'hvaught', 'mcconneb', 'long182', 'ander677', 'mgolm', 'acorda', None, 'jeinterz', 'pkabra', 'srajesh10', 'wildm', 'kdecocke', 'kfortie', 'hdebose', 'ngaurav', 'cochrad', 'warren56', 'miramont']"
18,221,42,21,18,"['mcconneb', 'bconners', 'ainaa_aisyaa', 'ramos39', 'ander677', 'chaua', 'kirby8', 'akrawec', 'harribas', 'hdebose', 'kkm11102000', 'ngaurav', 'mokuniew', 'park710', 'cochrad', 'warren56', 'miramont', 'hvaught']",23,"['selazab', 'aman0', 'ghinkle', 'jscharre', 'ibrahim7', 'gfukumot', 'cmeisel', 'abusker', 'wang2621', 'long182', 'kcrew08', 'mgolm', 'mkrane', 'kim1797', 'tstegall', 'jeinterz', 'pkabra', 'srajesh10', 'grayfiel', 'wildm', 'bbattas', 'kdecocke', 'kfortie']",3,"['sreeve', None, 'hweldy']",44,"['selazab', 'aman0', 'ghinkle', 'ibrahim7', 'harribas', 'jscharre', 'kkm11102000', 'bconners', 'sreeve', 'kirby8', 'gfukumot', 'cmeisel', 'akrawec', 'abusker', 'wang2621', 'hvaught', 'mcconneb', 'long182', 'ander677', 'kcrew08', 'mgolm', 'chaua', 'warren56', 'mkrane', 'kim1797', 'park710', 'tstegall', None, 'jeinterz', 'ainaa_aisyaa', 'ramos39', 'pkabra', 'srajesh10', 'grayfiel', 'wildm', 'bbattas', 'kdecocke', 'kfortie', 'hdebose', 'ngaurav', 'hweldy', 'cochrad', 'mokuniew', 'miramont']"
18,223,42,9,6,"['kcrew08', 'aman0', 'ghinkle', 'mkrane', 'tstegall', 'wang2621']",35,"['selazab', 'ibrahim7', 'harribas', 'jscharre', 'kkm11102000', 'bconners', 'kirby8', 'gfukumot', 'cmeisel', 'akrawec', 'abusker', 'hvaught', 'mcconneb', 'long182', 'ander677', 'mgolm', 'chaua', 'warren56', 'kim1797', 'park710', 'jeinterz', 'ainaa_aisyaa', 'ramos39', 'pkabra', 'srajesh10', 'grayfiel', 'wildm', 'bbattas', 'kdecocke', 'kfortie', 'hdebose', 'ngaurav', 'cochrad', 'mokuniew', 'miramont']",3,"['sreeve', None, 'acorda']",44,"['selazab', 'aman0', 'ghinkle', 'ibrahim7', 'harribas', 'jscharre', 'kkm11102000', 'bconners', 'sreeve', 'kirby8', 'gfukumot', 'cmeisel', 'akrawec', 'abusker', 'wang2621', 'hvaught', 'mcconneb', 'long182', 'ander677', 'kcrew08', 'mgolm', 'chaua', 'acorda', 'warren56', 'mkrane', 'kim1797', 'park710', 'tstegall', None, 'jeinterz', 'ainaa_aisyaa', 'ramos39', 'pkabra', 'srajesh10', 'grayfiel', 'wildm', 'bbattas', 'kdecocke', 'kfortie', 'hdebose', 'ngaurav', 'cochrad', 'mokuniew', 'miramont']"
19,218,40,41,35,"['mrapple2', 'elizabethrenee.livingston', 'mbettinardi', 'westjoh95', 'nsalaz3', 'son0930', 'yavuzsavsatli', 'ajschil2', 'altunnesra', 'nthomps6', 'sschuh2', 'sgoldsm2', 'misurac2', 'zhayani2', 'zanders2', 'pbruno2', 'zberent', 'hsong41', 'egreenw2', 'yzhao112', 'dupont2', 'muckati2', 'lp2240', 'zhichao3', 'shalvor2', 'kvolkma2', 'emedwar2', 'esecor2', 'sscully2', 'cyan5', 'jrlund2', 'jshanle2', 'brpulle2', 'ycx250250', 'westjoh2']",4,"['jinder2103', 'erfan453', 'dlopez381', 'gdligunas']",6,"['bkwiatk2', 'jsherwi2', 'brandon994.bk', 'bkwiatk3', 'olbrich2', None]",45,"['mrapple2', 'westjoh95', 'yavuzsavsatli', 'ajschil2', 'altunnesra', 'sschuh2', 'misurac2', 'zhayani2', 'gdligunas', 'egreenw2', 'yzhao112', 'brandon994.bk', 'dupont2', 'muckati2', 'lp2240', 'kvolkma2', 'emedwar2', 'esecor2', 'brpulle2', 'jrlund2', 'ycx250250', 'dlopez381', 'westjoh2', 'elizabethrenee.livingston', 'mbettinardi', 'nsalaz3', 'bkwiatk3', 'olbrich2', 'son0930', 'bkwiatk2', 'nthomps6', 'sgoldsm2', 'zanders2', 'pbruno2', 'zberent', 'hsong41', 'erfan453', 'zhichao3', 'shalvor2', None, 'jsherwi2', 'sscully2', 'cyan5', 'jshanle2', 'jinder2103']"
19,145,40,38,35,"['mrapple2', 'elizabethrenee.livingston', 'mbettinardi', 'westjoh95', 'nsalaz3', 'son0930', 'yavuzsavsatli', 'ajschil2', 'altunnesra', 'nthomps6', 'sschuh2', 'sgoldsm2', 'misurac2', 'zhayani2', 'zanders2', 'pbruno2', 'zberent', 'hsong41', 'egreenw2', 'yzhao112', 'dupont2', 'muckati2', 'lp2240', 'zhichao3', 'shalvor2', 'kvolkma2', 'emedwar2', 'esecor2', 'sscully2', 'brpulle2', 'cyan5', 'jrlund2', 'jshanle2', 'ycx250250', 'westjoh2']",4,"['jinder2103', 'erfan453', 'dlopez381', 'gdligunas']",3,"['bkwiatk2', 'olbrich2', None]",42,"['mrapple2', 'westjoh95', 'yavuzsavsatli', 'ajschil2', 'altunnesra', 'sschuh2', 'misurac2', 'zhayani2', 'gdligunas', 'egreenw2', 'yzhao112', 'dupont2', 'muckati2', 'lp2240', 'kvolkma2', 'emedwar2', 'esecor2', 'brpulle2', 'jrlund2', 'ycx250250', 'dlopez381', 'westjoh2', 'elizabethrenee.livingston', 'mbettinardi', 'nsalaz3', 'olbrich2', 'son0930', 'bkwiatk2', 'nthomps6', 'sgoldsm2', 'zanders2', 'pbruno2', 'zberent', 'hsong41', 'erfan453', 'zhichao3', 'shalvor2', None, 'sscully2', 'cyan5', 'jshanle2', 'jinder2103']"
19,146,40,19,2,"['jinder2103', 'gdligunas']",37,"['mrapple2', 'elizabethrenee.livingston', 'mbettinardi', 'westjoh95', 'nsalaz3', 'son0930', 'yavuzsavsatli', 'ajschil2', 'altunnesra', 'nthomps6', 'sschuh2', 'sgoldsm2', 'misurac2', 'zhayani2', 'zanders2', 'pbruno2', 'zberent', 'hsong41', 'egreenw2', 'yzhao112', 'erfan453', 'dupont2', 'muckati2', 'lp2240', 'zhichao3', 'westjoh2', 'shalvor2', 'kvolkma2', 'emedwar2', 'esecor2', 'sscully2', 'cyan5', 'jrlund2', 'jshanle2', 'brpulle2', 'ycx250250', 'dlopez381']",17,"['chalinomendez', 'vgallardo2', 'chimera4373', 'jezamora92', 'rnava', 'reefaldayafleh', 'jeffreynambayan', 'jesikasaucedo00927', 'alexnguyen259', 'closecombat58', 'bleavy94', 'lewong27', 'dmartinez4', 'allan.chio', None, 'abains5', 'joshuacernas']",56,"['vgallardo2', 'mrapple2', 'elizabethrenee.livingston', 'mbettinardi', 'westjoh95', 'nsalaz3', 'reefaldayafleh', 'son0930', 'yavuzsavsatli', 'ajschil2', 'abains5', 'joshuacernas', 'altunnesra', 'nthomps6', 'sschuh2', 'dlopez381', 'sgoldsm2', 'misurac2', 'zhayani2', 'jesikasaucedo00927', 'gdligunas', 'zanders2', 'allan.chio', 'pbruno2', 'zberent', 'hsong41', 'egreenw2', 'yzhao112', 'erfan453', 'chimera4373', 'jezamora92', 'dupont2', 'rnava', 'jeffreynambayan', 'alexnguyen259', 'muckati2', 'lp2240', 'closecombat58', 'zhichao3', 'westjoh2', 'shalvor2', 'bleavy94', 'lewong27', None, 'chalinomendez', 'kvolkma2', 'emedwar2', 'esecor2', 'dmartinez4', 'sscully2', 'cyan5', 'jrlund2', 'jshanle2', 'brpulle2', 'ycx250250', 'jinder2103']"
20,24,40,102,36,"['lsh0307', 'qkdgywp', 'dudxo9273', 'bbbty60', 'dongjin225', 'vhwkd308', 'gwoo7057', 'mrlee', 'cyc2490', 'hun0307', 'whj1130', 'kshbig0425', 'kissheyo1004', 'pisces9231', 'qkrwhdgkr', 'kan7470', 'bluegil92', 'mygime92', 'nnoonn4488', 'ghghrkdlgh', 'gordius92', 'rnfnqnfn', 'dbrhksan88', 'sdy9333', 'lkm9200', 'injahgi', 'awdwadw12341', 'box1916', 'oyj95', 'angyi90', 'bonghyuk', 'k910716kim', 'kym1122', 'kiddyu1991', 'gkakfhdlem', 'krleesd92']",3,"['jung0hun', 'rhwnstjd', 'silver457']",66,"['sgu20121541', 'sgu20121546', 'shoho214', 'bbbty6064', 'noon48', 'parkchanwoo7', 'sgu20141467', 'drog0311', 'hhnn1229', 'sks911017', 'kimjunsu112', 'sgug20160008', 'kigg1124', 'lilydh511', 'mrcsm200', 'tjrwodl2000', 'jangsungin', 'whq456', 'gohny0115', 'sgu20111399', 'road', 'dangshiggy', 'sgu20111478', 'ccjswlgh', 'sgu20121540', 'skzl34', 'jwh0114', 'sgu20121451', 'carjehee', 'sgu20111505', 'jkorad2843', 'tksfoqlt', 'sgu20121479', 'ghdud0351', 'sgu20131480', 'sgu20121526', 'sjg1779', 'sgu20121465', 'wjdgns22222', 'sgu20121514', 'sgu20141426', 'sicpan12', 'jjo2824', 'woghks927', 'm109a6', 'dogp27', 'sgu20121507', 'gugusj', None, 'kdj406', 'poby', 'honnyou', 'sgu20111577', 'dlrjswo', 'noon486', 'akstn34', 'fredhan89', 'sgu20121450', 'sgu20141482', 'sgu20111450', 'jsa6580', 'sgu20102047', 'dnlwd09', 'thenopi10', 'sgu20121469', 'sgu20101328']",105,"['hhnn1229', 'sks911017', 'kimjunsu112', 'tjrwodl2000', 'bluegil92', 'nnoonn4488', 'skzl34', 'jwh0114', 'sgu20121451', 'jkorad2843', 'sgu20131480', 'sgu20121465', 'wjdgns22222', 'woghks927', 'awdwadw12341', 'bonghyuk', 'kdj406', 'k910716kim', 'kym1122', 'sgu20111577', 'dlrjswo', 'noon486', 'akstn34', 'sgu20111450', 'krleesd92', 'sgu20121469', 'sgu20121546', 'shoho214', 'bbbty6064', 'noon48', 'parkchanwoo7', 'drog0311', 'vhwkd308', 'lilydh511', 'kshbig0425', 'whq456', 'gohny0115', 'sgu20111399', 'road', 'dangshiggy', 'sgu20111478', 'tksfoqlt', 'm109a6', 'dogp27', 'sgu20121507', 'gugusj', 'angyi90', 'poby', 'honnyou', 'thenopi10', 'sgu20101328', 'lsh0307', 'dudxo9273', 'dongjin225', 'sgu20141467', 'gwoo7057', 'mrlee', 'cyc2490', 'jangsungin', 'pisces9231', 'qkrwhdgkr', 'kan7470', 'mygime92', 'carjehee', 'sgu20111505', 'ghghrkdlgh', 'rnfnqnfn', 'dbrhksan88', 'sdy9333', 'sgu20121479', 'sgu20121526', 'sgu20121514', 'sgu20141426', 'sicpan12', 'fredhan89', 'gkakfhdlem', 'sgu20121450', 'jsa6580', 'sgu20121541', 'qkdgywp', 'bbbty60', 'jung0hun', 'sgug20160008', 'kigg1124', 'hun0307', 'whj1130', 'mrcsm200', 'kissheyo1004', 'ccjswlgh', 'sgu20121540', 'gordius92', 'rhwnstjd', 'silver457', 'ghdud0351', 'sjg1779', 'lkm9200', 'injahgi', 'box1916', None, 'oyj95', 'kiddyu1991', 'sgu20141482', 'sgu20102047', 'dnlwd09', 'jjo2824']"
20,132,40,42,39,"['lsh0307', 'qkdgywp', 'dudxo9273', 'bbbty60', 'dongjin225', 'jung0hun', 'vhwkd308', 'gwoo7057', 'mrlee', 'cyc2490', 'hun0307', 'whj1130', 'kshbig0425', 'kissheyo1004', 'pisces9231', 'qkrwhdgkr', 'kan7470', 'bluegil92', 'mygime92', 'nnoonn4488', 'ghghrkdlgh', 'gordius92', 'rnfnqnfn', 'dbrhksan88', 'rhwnstjd', 'silver457', 'sdy9333', 'lkm9200', 'injahgi', 'awdwadw12341', 'box1916', 'oyj95', 'angyi90', 'bonghyuk', 'k910716kim', 'kym1122', 'kiddyu1991', 'gkakfhdlem', 'krleesd92']",0,[],3,"['honnyou', None, 'skzl34']",42,"['lsh0307', 'dudxo9273', 'dongjin225', 'gwoo7057', 'mrlee', 'cyc2490', 'pisces9231', 'qkrwhdgkr', 'kan7470', 'bluegil92', 'mygime92', 'nnoonn4488', 'skzl34', 'ghghrkdlgh', 'rnfnqnfn', 'dbrhksan88', 'sdy9333', 'awdwadw12341', 'bonghyuk', 'k910716kim', 'kym1122', 'gkakfhdlem', 'krleesd92', 'qkdgywp', 'bbbty60', 'jung0hun', 'vhwkd308', 'hun0307', 'whj1130', 'kshbig0425', 'kissheyo1004', 'gordius92', 'rhwnstjd', 'silver457', 'lkm9200', 'injahgi', 'box1916', None, 'oyj95', 'angyi90', 'honnyou', 'kiddyu1991']"
20,21,40,40,7,"['kan7470', 'ghghrkdlgh', 'rnfnqnfn', 'k910716kim', 'whj1130', 'vhwkd308', 'krleesd92']",32,"['lsh0307', 'qkdgywp', 'dudxo9273', 'bbbty60', 'dongjin225', 'jung0hun', 'gwoo7057', 'mrlee', 'cyc2490', 'hun0307', 'kshbig0425', 'kissheyo1004', 'pisces9231', 'qkrwhdgkr', 'bluegil92', 'mygime92', 'nnoonn4488', 'gordius92', 'sdy9333', 'dbrhksan88', 'rhwnstjd', 'silver457', 'lkm9200', 'injahgi', 'awdwadw12341', 'box1916', 'oyj95', 'angyi90', 'bonghyuk', 'kym1122', 'kiddyu1991', 'gkakfhdlem']",33,"['sgu20121541', 'sgu20121546', 'sgu20141467', 'sgu20111399', 'ccjswlgh', 'dangshiggy', 'road', 'sgu20111478', 'sgu20121540', 'sgu20121484', 'jwh0114', 'sgu20121451', 'carjehee', 'sgu20111505', 'sgu20121526', 'sgu20131480', 'sgu20121465', 'sgu20141426', 'dogp27', 'gugusj', 'sgu20121507', None, 'poby', 'honnyou', 'sgu20111577', 'sgu20111493', 'sgu20121450', 'sgu20141482', 'sgu20141447', 'sgu20102047', 'sgu20121517', 'thenopi10', 'sgu20101328']",72,"['lsh0307', 'dudxo9273', 'dongjin225', 'sgu20141467', 'gwoo7057', 'mrlee', 'cyc2490', 'pisces9231', 'qkrwhdgkr', 'kan7470', 'bluegil92', 'mygime92', 'nnoonn4488', 'sgu20121484', 'sgu20111505', 'sgu20121451', 'carjehee', 'ghghrkdlgh', 'jwh0114', 'rnfnqnfn', 'dbrhksan88', 'sdy9333', 'sgu20121526', 'sgu20131480', 'sgu20121465', 'sgu20141426', 'awdwadw12341', 'bonghyuk', 'k910716kim', 'kym1122', 'sgu20111577', 'sgu20111493', 'sgu20121450', 'gkakfhdlem', 'sgu20141447', 'krleesd92', 'sgu20121541', 'qkdgywp', 'sgu20121546', 'bbbty60', 'jung0hun', 'vhwkd308', 'hun0307', 'whj1130', 'kshbig0425', 'kissheyo1004', 'sgu20111399', 'ccjswlgh', 'dangshiggy', 'road', 'sgu20111478', 'sgu20121540', 'gordius92', 'rhwnstjd', 'silver457', 'lkm9200', 'injahgi', 'dogp27', 'gugusj', 'box1916', 'sgu20121507', 'oyj95', 'angyi90', None, 'poby', 'honnyou', 'kiddyu1991', 'sgu20141482', 'sgu20102047', 'sgu20121517', 'thenopi10', 'sgu20101328']"
20,70,40,34,16,"['lsh0307', 'ghghrkdlgh', 'qkdgywp', 'rnfnqnfn', 'dbrhksan88', 'dudxo9273', 'kiddyu1991', 'injahgi', 'dongjin225', 'kissheyo1004', 'pisces9231', 'krleesd92', 'bonghyuk', 'gwoo7057', 'mygime92', 'nnoonn4488']",23,"['bbbty60', 'jung0hun', 'vhwkd308', 'mrlee', 'cyc2490', 'hun0307', 'whj1130', 'kshbig0425', 'qkrwhdgkr', 'kan7470', 'bluegil92', 'gordius92', 'sdy9333', 'rhwnstjd', 'silver457', 'lkm9200', 'awdwadw12341', 'box1916', 'oyj95', 'angyi90', 'k910716kim', 'kym1122', 'gkakfhdlem']",18,"['kdj406', 'kokyeol0320', 'jangyy12', 'brewnac', 'kshotrm', 'gksmfdlekt90', 'rarami55', 'hikim95', 'yhw910', 'dwm0530.mj', 'zxzxzx1216', 'yuivb0614', 'lswchs522', 'hyeonsu7479', 'hbean', None, 'skzl34', 'carlcll3']",57,"['lsh0307', 'kokyeol0320', 'qkdgywp', 'brewnac', 'dudxo9273', 'bbbty60', 'dongjin225', 'jung0hun', 'zxzxzx1216', 'vhwkd308', 'gwoo7057', 'mrlee', 'cyc2490', 'hun0307', 'kshotrm', 'whj1130', 'kshbig0425', 'kissheyo1004', 'pisces9231', 'dwm0530.mj', 'qkrwhdgkr', 'kan7470', 'bluegil92', 'mygime92', 'nnoonn4488', 'skzl34', 'carlcll3', 'ghghrkdlgh', 'gordius92', 'rnfnqnfn', 'dbrhksan88', 'rhwnstjd', 'silver457', 'sdy9333', 'jangyy12', 'rarami55', 'lkm9200', 'hikim95', 'injahgi', 'yuivb0614', 'lswchs522', 'hyeonsu7479', 'awdwadw12341', 'hbean', 'box1916', None, 'oyj95', 'angyi90', 'bonghyuk', 'kdj406', 'k910716kim', 'kym1122', 'kiddyu1991', 'gksmfdlekt90', 'gkakfhdlem', 'yhw910', 'krleesd92']"
20,67,40,19,7,"['ghghrkdlgh', 'qkdgywp', 'rnfnqnfn', 'dongjin225', 'pisces9231', 'vhwkd308', 'krleesd92']",32,"['lsh0307', 'dudxo9273', 'bbbty60', 'jung0hun', 'gwoo7057', 'mrlee', 'cyc2490', 'hun0307', 'whj1130', 'kshbig0425', 'kissheyo1004', 'qkrwhdgkr', 'kan7470', 'bluegil92', 'mygime92', 'nnoonn4488', 'gordius92', 'sdy9333', 'dbrhksan88', 'rhwnstjd', 'silver457', 'lkm9200', 'injahgi', 'awdwadw12341', 'box1916', 'oyj95', 'angyi90', 'bonghyuk', 'k910716kim', 'kym1122', 'kiddyu1991', 'gkakfhdlem']",12,"['jylee432', 'dksquddhr123', 'jdh940130', 'vocasuki', 'mlg6060', 'yuivb0614', 'lswchs522', 'ccjswlgh', 'dangshiggy', None, 'skzl34', 'jwh0114']",51,"['lsh0307', 'qkdgywp', 'jylee432', 'dudxo9273', 'bbbty60', 'dongjin225', 'jung0hun', 'vhwkd308', 'gwoo7057', 'mrlee', 'cyc2490', 'hun0307', 'whj1130', 'kshbig0425', 'dksquddhr123', 'kissheyo1004', 'pisces9231', 'qkrwhdgkr', 'ccjswlgh', 'kan7470', 'dangshiggy', 'bluegil92', 'mygime92', 'nnoonn4488', 'skzl34', 'jwh0114', 'ghghrkdlgh', 'gordius92', 'rnfnqnfn', 'dbrhksan88', 'rhwnstjd', 'silver457', 'sdy9333', 'lkm9200', 'jdh940130', 'injahgi', 'yuivb0614', 'lswchs522', 'awdwadw12341', 'box1916', None, 'oyj95', 'angyi90', 'bonghyuk', 'k910716kim', 'kym1122', 'kiddyu1991', 'gkakfhdlem', 'vocasuki', 'mlg6060', 'krleesd92']"
20,130,40,10,6,"['k910716kim', 'ghghrkdlgh', 'rnfnqnfn', 'whj1130', 'vhwkd308', 'krleesd92']",33,"['lsh0307', 'qkdgywp', 'dudxo9273', 'bbbty60', 'dongjin225', 'jung0hun', 'gwoo7057', 'mrlee', 'cyc2490', 'hun0307', 'kshbig0425', 'kissheyo1004', 'pisces9231', 'qkrwhdgkr', 'kan7470', 'bluegil92', 'mygime92', 'nnoonn4488', 'gordius92', 'sdy9333', 'dbrhksan88', 'rhwnstjd', 'silver457', 'lkm9200', 'injahgi', 'awdwadw12341', 'box1916', 'oyj95', 'angyi90', 'bonghyuk', 'kym1122', 'kiddyu1991', 'gkakfhdlem']",4,"['ccjswlgh', None, 'lilydh511', 'skzl34']",43,"['lsh0307', 'qkdgywp', 'dudxo9273', 'bbbty60', 'dongjin225', 'jung0hun', 'vhwkd308', 'gwoo7057', 'mrlee', 'cyc2490', 'hun0307', 'lilydh511', 'whj1130', 'kshbig0425', 'kissheyo1004', 'pisces9231', 'qkrwhdgkr', 'ccjswlgh', 'kan7470', 'bluegil92', 'mygime92', 'nnoonn4488', 'skzl34', 'ghghrkdlgh', 'gordius92', 'rnfnqnfn', 'dbrhksan88', 'rhwnstjd', 'silver457', 'sdy9333', 'lkm9200', 'injahgi', 'awdwadw12341', 'box1916', None, 'oyj95', 'angyi90', 'bonghyuk', 'k910716kim', 'kym1122', 'kiddyu1991', 'gkakfhdlem', 'krleesd92']"
20,131,40,8,4,"['gkakfhdlem', 'krleesd92', 'kym1122', 'vhwkd308']",35,"['lsh0307', 'qkdgywp', 'dudxo9273', 'bbbty60', 'dongjin225', 'jung0hun', 'gwoo7057', 'mrlee', 'cyc2490', 'hun0307', 'whj1130', 'kshbig0425', 'kissheyo1004', 'pisces9231', 'qkrwhdgkr', 'kan7470', 'bluegil92', 'mygime92', 'nnoonn4488', 'ghghrkdlgh', 'gordius92', 'rnfnqnfn', 'dbrhksan88', 'rhwnstjd', 'silver457', 'sdy9333', 'lkm9200', 'injahgi', 'awdwadw12341', 'box1916', 'oyj95', 'angyi90', 'bonghyuk', 'k910716kim', 'kiddyu1991']",4,"['ccjswlgh', None, 'lilydh511', 'skzl34']",43,"['lsh0307', 'qkdgywp', 'dudxo9273', 'bbbty60', 'dongjin225', 'jung0hun', 'vhwkd308', 'gwoo7057', 'mrlee', 'cyc2490', 'hun0307', 'lilydh511', 'whj1130', 'kshbig0425', 'kissheyo1004', 'pisces9231', 'qkrwhdgkr', 'ccjswlgh', 'kan7470', 'bluegil92', 'mygime92', 'nnoonn4488', 'skzl34', 'ghghrkdlgh', 'gordius92', 'rnfnqnfn', 'dbrhksan88', 'rhwnstjd', 'silver457', 'sdy9333', 'lkm9200', 'injahgi', 'awdwadw12341', 'box1916', None, 'oyj95', 'angyi90', 'bonghyuk', 'k910716kim', 'kym1122', 'kiddyu1991', 'gkakfhdlem', 'krleesd92']"
21,38,40,170,38,"['devyani.salvi1028', 'sujataredkar', 'rautt59', 'qwertynishit', 'vjseedan', 'udayyewale17', 'hardrider95', 'rohitpuri.g', 'kypptl', 'lino2296', 'priyankadeshpande177', 'rishabh4745', 'aqudas29', 'khedikaryash8', 'apekshapawar', 'ramanujsingh004', 'prasad.m', 'rukhsrd', 'parmarmayur05', 'pranithsuvarna1', 'rrnair291293', 'vijaya', 'pranilghogale', 'shaminakunnel', 'sadiqqureshi393', 'jiteshkjsp', 'rahulbadekar', 'aniketshelar79', 'parag16593', 'nehaaltawade1', 'ykhedikar', 'priyanka.bhangre', 'karanshah30', 'nikhil4241307', 'sourabhbelose', 'peshinakash', 'atoraskar12', 'walavalkarmayur79']",1,['imayocam'],132,"['jigneshk2994', 'yashsavle', 'tejuliman74', 'harshitbangera', 'ishmeetsingh', 'sanketh728', 'swatimane176', 'karan.marketkar', 'rushikeshjoshi285', 'rnair15', 'shreyasawant95', 'viraktdoshi19', 'karan.gondalia', 'patilroshan1128', 'kumarvivek017', 'gurmukhsingh0108', 'amit.dutta', 'sush81194', 'tambeneha94', 'nair19shruti', 'happyridermrk', 'gadhiyakenil16', 'abauti608', 'rutu123', 'varun1997', 'sachimalkan', 'sgat3451', 'jaysawant2', 'ishaan.sathe', 'mapethe', 'amruteshpatil', 'pateltejash96', 'ratsthegreat', 'tandelsneha15', 'doshi.kavisha16', 'tajpara.nikhil', 'miteshmohokar', 'g3jithinn', 'kapilaherkar755', 'sweta151945', 'dhairyagada1997', 'pruthavi.c', 'akansha319892', 'vishal.chavda', 'nairprasad007', 'joshua0667', 'ankitferry123', 'hardik.upadhyay', '1jyotsna1', 'nikj816', 'smajumdar', 'nikuldengada493', 'ankur.shah', 'princeporje98', 'suraj6111994', 'yogeshwar21121995', 'parthkaushikdave', 'nilesh.delekar', 'ameymalotkar1', 'pareshnaik1995', 'gopal.singh', 's.jadeja', 'melchiznadar', 'poojaparab9035', 'pdeshpande', 'kiranjadhav050994', 'abinbenny8', 'ashupalambe1992', 'abinaya67006', 'ajitjadhav', 'machalke92', 'yogi.6692', 'verma.amitkumar95', 'florence9344', 'anuradha.d', 'satya_mishra', 'shraddhakharde01', 'inderjitsingh87', 'sharma.ayushi8c', 'sbodke', 'tgpatil22791', 'vijaykothari97', 'mauryashubham564', 'arawal14.ar', 'raoashish96', 'parag.choughule', 'asingh12', 'jigar', 'shivam_cr7', 'udit.shah', 'vishakha', 'tdholpuria', 'mkadam03', 'ankitagharat93', 'aanugraha', 'shubhrapatil77', 'gkapil45', 'rushabh.soni', 'mayuripatil3095', 'tanujudani865', 'sonihetvi10', 'aniketa.yelave49', 'jadhavankita9969', 'rjoshi02', 'karankyp', 'adwaitvajpe', 'anevrekar', 'yayatipawar601', 'akash.mali3477', 'karantank97', 'akashmore456', 'surajkarade.2', 'pranav.gori', 'patilvarad2011', 'palak1012', 'keyur.gajjar', 'pripatil285', 'desaivighnesh95', None, 'burhan.naim', 'd.shenoy', 'ashish.mrya1', 'ankith89', 'rutwijajoshi10', 'agarwal.gagan5101', 'anshujha95', 'vedy1811', 'chaitanyakhane999', 'tushar.gaikwad', 'gaurav.gadre', 'somil910', 'abhiramibp95']",171,"['jigneshk2994', 'yashsavle', 'tejuliman74', 'harshitbangera', 'ishmeetsingh', 'sanketh728', 'swatimane176', 'karan.marketkar', 'rushikeshjoshi285', 'rnair15', 'shreyasawant95', 'viraktdoshi19', 'udayyewale17', 'karan.gondalia', 'patilroshan1128', 'kumarvivek017', 'rohitpuri.g', 'gurmukhsingh0108', 'amit.dutta', 'sush81194', 'rishabh4745', 'tambeneha94', 'rukhsrd', 'nair19shruti', 'happyridermrk', 'gadhiyakenil16', 'abauti608', 'sadiqqureshi393', 'rutu123', 'jiteshkjsp', 'aniketshelar79', 'sachimalkan', 'sgat3451', 'jaysawant2', 'ykhedikar', 'ishaan.sathe', 'mapethe', 'amruteshpatil', 'pateltejash96', 'ratsthegreat', 'tandelsneha15', 'doshi.kavisha16', 'tajpara.nikhil', 'miteshmohokar', 'g3jithinn', 'kapilaherkar755', 'sweta151945', 'dhairyagada1997', 'pruthavi.c', 'vjseedan', 'akansha319892', 'vishal.chavda', 'nairprasad007', 'hardrider95', 'joshua0667', 'ankitferry123', 'priyankadeshpande177', 'hardik.upadhyay', '1jyotsna1', 'prasad.m', 'parmarmayur05', 'nikj816', 'smajumdar', 'rrnair291293', 'nikuldengada493', 'ankur.shah', 'princeporje98', 'suraj6111994', 'yogeshwar21121995', 'parthkaushikdave', 'nilesh.delekar', 'ameymalotkar1', 'pareshnaik1995', 'gopal.singh', 'nehaaltawade1', 's.jadeja', 'melchiznadar', 'poojaparab9035', 'nikhil4241307', 'pdeshpande', 'peshinakash', 'kiranjadhav050994', 'abinbenny8', 'ashupalambe1992', 'abinaya67006', 'ajitjadhav', 'machalke92', 'yogi.6692', 'devyani.salvi1028', 'qwertynishit', 'verma.amitkumar95', 'florence9344', 'anuradha.d', 'satya_mishra', 'shraddhakharde01', 'kypptl', 'inderjitsingh87', 'lino2296', 'sharma.ayushi8c', 'sbodke', 'aqudas29', 'khedikaryash8', 'tgpatil22791', 'pranithsuvarna1', 'vijaykothari97', 'mauryashubham564', 'vijaya', 'shaminakunnel', 'rahulbadekar', 'arawal14.ar', 'raoashish96', 'parag.choughule', 'parag16593', 'asingh12', 'jigar', 'shivam_cr7', 'udit.shah', 'vishakha', 'tdholpuria', 'atoraskar12', 'mkadam03', 'walavalkarmayur79', 'ankitagharat93', 'somil910', 'aanugraha', 'shubhrapatil77', 'gkapil45', 'rushabh.soni', 'mayuripatil3095', 'tanujudani865', 'sonihetvi10', 'aniketa.yelave49', 'jadhavankita9969', 'sujataredkar', 'rautt59', 'rjoshi02', 'karankyp', 'adwaitvajpe', 'anevrekar', 'yayatipawar601', 'akash.mali3477', 'karantank97', 'akashmore456', 'surajkarade.2', 'pranav.gori', 'patilvarad2011', 'palak1012', 'apekshapawar', 'ramanujsingh004', 'keyur.gajjar', 'pranilghogale', 'pripatil285', 'desaivighnesh95', None, 'burhan.naim', 'd.shenoy', 'ashish.mrya1', 'ankith89', 'priyanka.bhangre', 'karanshah30', 'rutwijajoshi10', 'agarwal.gagan5101', 'anshujha95', 'vedy1811', 'imayocam', 'chaitanyakhane999', 'sourabhbelose', 'tushar.gaikwad', 'gaurav.gadre', 'varun1997', 'abhiramibp95']"
22,187,36,41,31,"['techcrystal', 'ras70', 'c1coollguy', 'jakemullettwv', 'nathanielbrooke', 'minhtran', 'entropy.tony', 'belaltaher8', 'someonebob156', 'assaadserge', 'kaylaschulz', 'gauri_prasad', 'parkerpearson', 'niyazi.sarah', 'at200', 'zhamx1995', 'yi.yan.tay', 'eric6.song', 'jihane', 'suzhou', 'gwd3', 'zhewang828', 'emilyshannon95', 'mtran97', 'narendly', 'jcorey018', 'paulcruz74', 'aditya.srinivasan', 'williamma0823', 'chengshunzhang', 'meb100']",4,"['caitlin.rochford', 'kadamprajakta', 's.mailoorkar', 'as577']",10,"['jimmyshackford', 'vishnu.gottiparthy', 'cassidee.kido', 'wxy961105', 'mbognar', 'davidhzheng', 'abuilding', 'starlight8910', None, 'melhorowitz']",45,"['jimmyshackford', 'techcrystal', 'ras70', 'wxy961105', 'mbognar', 'c1coollguy', 'jakemullettwv', 'nathanielbrooke', 's.mailoorkar', 'melhorowitz', 'caitlin.rochford', 'minhtran', 'entropy.tony', 'vishnu.gottiparthy', 'belaltaher8', 'someonebob156', 'assaadserge', 'kaylaschulz', 'gauri_prasad', 'parkerpearson', 'niyazi.sarah', 'at200', 'zhamx1995', 'yi.yan.tay', 'eric6.song', 'as577', 'jihane', 'suzhou', 'gwd3', 'zhewang828', 'abuilding', 'emilyshannon95', 'mtran97', 'kadamprajakta', 'narendly', 'jcorey018', 'davidhzheng', None, 'paulcruz74', 'cassidee.kido', 'aditya.srinivasan', 'williamma0823', 'chengshunzhang', 'starlight8910', 'meb100']"
22,186,36,29,2,"['as577', 'techcrystal']",33,"['ras70', 'c1coollguy', 'jakemullettwv', 'nathanielbrooke', 's.mailoorkar', 'caitlin.rochford', 'minhtran', 'entropy.tony', 'belaltaher8', 'someonebob156', 'assaadserge', 'kaylaschulz', 'gauri_prasad', 'parkerpearson', 'niyazi.sarah', 'at200', 'zhamx1995', 'yi.yan.tay', 'eric6.song', 'jihane', 'suzhou', 'gwd3', 'zhewang828', 'emilyshannon95', 'mtran97', 'kadamprajakta', 'narendly', 'jcorey018', 'paulcruz74', 'aditya.srinivasan', 'williamma0823', 'chengshunzhang', 'meb100']",27,"['in2198', 'dr2891', 'jhy2116', 'ss4754', 'jd3171', 'xw2463', 'grk2114', 'johnkym', 'jj2883', 'asf2170', 'np2588', 'bqn2000', 'rmm2242', 'ryan.davies11', 'ls3221', 'akr2145', 'ldl2115', 'joseanb', 'dra2127', 'jx2248', None, 'smt2175', 'ib2348', 'bvf2104', 'tjh2152', 'teann.chen', 'gaojinao']",62,"['in2198', 'techcrystal', 'ras70', 'dr2891', 'jhy2116', 'c1coollguy', 'ss4754', 'jd3171', 'jakemullettwv', 'xw2463', 'nathanielbrooke', 's.mailoorkar', 'grk2114', 'caitlin.rochford', 'minhtran', 'johnkym', 'jj2883', 'entropy.tony', 'asf2170', 'np2588', 'bqn2000', 'belaltaher8', 'rmm2242', 'someonebob156', 'ryan.davies11', 'ls3221', 'assaadserge', 'kaylaschulz', 'gauri_prasad', 'parkerpearson', 'niyazi.sarah', 'akr2145', 'ldl2115', 'at200', 'zhamx1995', 'yi.yan.tay', 'joseanb', 'eric6.song', 'as577', 'jihane', 'dra2127', 'suzhou', 'gwd3', 'zhewang828', 'emilyshannon95', 'jx2248', 'mtran97', 'kadamprajakta', 'narendly', 'jcorey018', None, 'paulcruz74', 'smt2175', 'ib2348', 'bvf2104', 'aditya.srinivasan', 'williamma0823', 'chengshunzhang', 'tjh2152', 'teann.chen', 'gaojinao', 'meb100']"
22,185,36,10,1,['kadamprajakta'],34,"['techcrystal', 'ras70', 'c1coollguy', 'jakemullettwv', 'nathanielbrooke', 's.mailoorkar', 'caitlin.rochford', 'minhtran', 'entropy.tony', 'belaltaher8', 'someonebob156', 'assaadserge', 'kaylaschulz', 'gauri_prasad', 'parkerpearson', 'niyazi.sarah', 'at200', 'zhamx1995', 'yi.yan.tay', 'eric6.song', 'as577', 'jihane', 'suzhou', 'gwd3', 'zhewang828', 'emilyshannon95', 'mtran97', 'narendly', 'jcorey018', 'paulcruz74', 'aditya.srinivasan', 'williamma0823', 'chengshunzhang', 'meb100']",9,"['jayshiralkar', 'torne.aniket', 'mounikasl', 'nisha23', 'anikaghone', 'durgeshtodankar97', 'sagarbhor', None, 'rupaliozare']",44,"['techcrystal', 'ras70', 'c1coollguy', 'jakemullettwv', 'nathanielbrooke', 's.mailoorkar', 'rupaliozare', 'caitlin.rochford', 'minhtran', 'torne.aniket', 'entropy.tony', 'belaltaher8', 'someonebob156', 'assaadserge', 'kaylaschulz', 'gauri_prasad', 'parkerpearson', 'niyazi.sarah', 'jayshiralkar', 'mounikasl', 'at200', 'zhamx1995', 'yi.yan.tay', 'eric6.song', 'as577', 'jihane', 'nisha23', 'suzhou', 'gwd3', 'zhewang828', 'emilyshannon95', 'mtran97', 'kadamprajakta', 'narendly', 'jcorey018', None, 'paulcruz74', 'aditya.srinivasan', 'williamma0823', 'chengshunzhang', 'anikaghone', 'durgeshtodankar97', 'sagarbhor', 'meb100']"
22,184,36,6,1,['kadamprajakta'],34,"['techcrystal', 'ras70', 'c1coollguy', 'jakemullettwv', 'nathanielbrooke', 's.mailoorkar', 'caitlin.rochford', 'minhtran', 'entropy.tony', 'belaltaher8', 'someonebob156', 'assaadserge', 'kaylaschulz', 'gauri_prasad', 'parkerpearson', 'niyazi.sarah', 'at200', 'zhamx1995', 'yi.yan.tay', 'eric6.song', 'as577', 'jihane', 'suzhou', 'gwd3', 'zhewang828', 'emilyshannon95', 'mtran97', 'narendly', 'jcorey018', 'paulcruz74', 'aditya.srinivasan', 'williamma0823', 'chengshunzhang', 'meb100']",5,"['anikaghone', 'durgeshtodankar97', 'smithnano15', None, 'rupaliozare']",40,"['techcrystal', 'ras70', 'c1coollguy', 'jakemullettwv', 'nathanielbrooke', 's.mailoorkar', 'smithnano15', 'rupaliozare', 'caitlin.rochford', 'minhtran', 'entropy.tony', 'belaltaher8', 'someonebob156', 'assaadserge', 'kaylaschulz', 'gauri_prasad', 'parkerpearson', 'niyazi.sarah', 'at200', 'zhamx1995', 'yi.yan.tay', 'eric6.song', 'as577', 'jihane', 'suzhou', 'gwd3', 'zhewang828', 'emilyshannon95', 'mtran97', 'kadamprajakta', 'narendly', 'jcorey018', None, 'paulcruz74', 'aditya.srinivasan', 'williamma0823', 'chengshunzhang', 'anikaghone', 'durgeshtodankar97', 'meb100']"
23,248,36,24,23,"['palbright7', 'horizon.keegan11', 'hollettjacobs', 'noelle_1999', 'ethanbradberry', 'sunlinyin', 'rjv5599', 'santiago.180999', 'calebwbnjones', 'adamf', 'alextaskov', 'matthew375', 'kys', 'andrea.mariette', 'trevor1999', 'nathan6230', 'nassersa', 'tenmyouji', 'sclark17', 'imran54', 'albiorix', '2017.christopher.shallal', 'sherchi']",12,"['astronomersiddharth', 'protikdas', 'sara.gh', 'balamut', 'funan', 'mapi2919', 'ylwang16', 'aezak5', 'mazin00', 'zoya', 'awysocki', 'mariusvolmer']",1,[None],36,"['astronomersiddharth', 'palbright7', 'sara.gh', 'horizon.keegan11', 'hollettjacobs', 'noelle_1999', 'mazin00', 'ethanbradberry', 'sunlinyin', 'santiago.180999', 'rjv5599', 'protikdas', 'calebwbnjones', 'funan', 'adamf', 'alextaskov', 'matthew375', 'kys', 'balamut', 'andrea.mariette', 'trevor1999', 'mapi2919', 'ylwang16', 'nathan6230', None, 'awysocki', 'mariusvolmer', 'nassersa', 'tenmyouji', 'sclark17', 'imran54', 'albiorix', 'aezak5', '2017.christopher.shallal', 'zoya', 'sherchi']"
24,116,34,27,25,"['wboldman', 'yongtliu', 'rkamath', 'dmarti67', 'kurtafus', 'kejianqu', 'sdavari', 'mkirkegaard', 'gaiden22', 'maran1990', 'aervin3', 'jbisho25', 'tianyu8452', 'yajiezhao1994', 'wcureton', 'gesirui001', 'cdelzer', 'bmusico95', 'rcollet1', 'zac10sim', 'cliu74', 'jduran2', 'hn348590429', 'siavash1369', 'ericoquinn']",8,"['whf4psu', 'wangxue.dlut', 'brickpaul65', 'alamjhilam', 'jose.ramirezla92', 'zellaleo', 'andresreynoso', 'josharnold93']",2,"[None, 'hongxzhang1968']",35,"['brickpaul65', 'alamjhilam', 'zellaleo', 'wboldman', 'yongtliu', 'rkamath', 'dmarti67', 'kurtafus', 'kejianqu', 'sdavari', 'mkirkegaard', 'hongxzhang1968', 'gaiden22', 'maran1990', 'whf4psu', 'aervin3', 'wangxue.dlut', 'jbisho25', 'jose.ramirezla92', 'yajiezhao1994', 'andresreynoso', 'wcureton', 'tianyu8452', 'gesirui001', 'cdelzer', 'bmusico95', None, 'josharnold93', 'rcollet1', 'zac10sim', 'cliu74', 'jduran2', 'hn348590429', 'siavash1369', 'ericoquinn']"
25,157,34,45,25,"['shenjw5', 'mp_vanguard', 'madongyu', 'liangzhh29', 'aaronda', 'ray2016', 'junky', 'wangguangyu', 'liuzy26', 'a394096511', 'srxh', 'volcano9669', 'liuzzh5', 'fakerss', 'qwn19970728', 'raven00', 'lneng', 'zhongguogdgz', 'sweety1031', 'a731618814', 'seiro', 'zp14344045', 'qunimadejihuoma', 'zjy14341045', 'dujw']",8,"['youyouyu', 'mi18819251871', 'fenglking', 'lewisspecial', 'tomvictor', 'tangxy8', 'xuxiangphysics', 'q950316']",20,"['lily26', 'zhaodd3', 'lintx233', 'phoenixfly', 'c2010555', 'kenwwy', 'zjt173720', 'focmsphyliu', 'neptuneli', 'xingzy3', 'weny2016', 'xwx', 'mancigbb', None, 'mouseeatcat', 'focms', 'tanjm32', 'jiangyf8', 'hexf', 'tangzy6']",53,"['shenjw5', 'lily26', 'lintx233', 'tangxy8', 'ray2016', 'junky', 'liuzy26', 'a394096511', 'volcano9669', 'fakerss', 'fenglking', 'focmsphyliu', 'lneng', 'neptuneli', 'zhongguogdgz', 'sweety1031', 'weny2016', 'xwx', 'mancigbb', 'a731618814', 'mouseeatcat', 'mi18819251871', 'tanjm32', 'jiangyf8', 'xuxiangphysics', 'zjy14341045', 'tangzy6', 'dujw', 'mp_vanguard', 'madongyu', 'zhaodd3', 'liangzhh29', 'phoenixfly', 'aaronda', 'q950316', 'wangguangyu', 'c2010555', 'srxh', 'kenwwy', 'zjt173720', 'liuzzh5', 'lewisspecial', 'qwn19970728', 'raven00', 'youyouyu', 'xingzy3', None, 'seiro', 'focms', 'zp14344045', 'qunimadejihuoma', 'tomvictor', 'hexf']"
25,229,34,45,31,"['shenjw5', 'mp_vanguard', 'madongyu', 'liangzhh29', 'aaronda', 'junky', 'wangguangyu', 'q950316', 'a394096511', 'liuzy26', 'srxh', 'volcano9669', 'liuzzh5', 'fakerss', 'fenglking', 'lewisspecial', 'qwn19970728', 'raven00', 'lneng', 'youyouyu', 'zhongguogdgz', 'sweety1031', 'a731618814', 'seiro', 'mi18819251871', 'zp14344045', 'qunimadejihuoma', 'tomvictor', 'xuxiangphysics', 'zjy14341045', 'dujw']",2,"['ray2016', 'tangxy8']",14,"['kenwwy', 'czczm', 'zjt173720', 'focms', 'xingzy3', 'tanjm32', 'zs14344042', 'focmsphyliu', 'weny2016', 'jiangyf8', 'hexf', 'mancigbb', None, 'tangzy6']",47,"['shenjw5', 'czczm', 'tangxy8', 'ray2016', 'junky', 'liuzy26', 'a394096511', 'volcano9669', 'fakerss', 'fenglking', 'focmsphyliu', 'lneng', 'zhongguogdgz', 'sweety1031', 'weny2016', 'mancigbb', 'a731618814', 'mi18819251871', 'tanjm32', 'jiangyf8', 'xuxiangphysics', 'zjy14341045', 'tangzy6', 'dujw', 'mp_vanguard', 'madongyu', 'liangzhh29', 'aaronda', 'q950316', 'wangguangyu', 'srxh', 'kenwwy', 'zjt173720', 'liuzzh5', 'lewisspecial', 'zs14344042', 'qwn19970728', 'raven00', 'youyouyu', 'xingzy3', None, 'seiro', 'focms', 'zp14344045', 'qunimadejihuoma', 'tomvictor', 'hexf']"
25,153,34,42,30,"['shenjw5', 'mp_vanguard', 'madongyu', 'liangzhh29', 'aaronda', 'junky', 'wangguangyu', 'q950316', 'a394096511', 'liuzy26', 'srxh', 'volcano9669', 'liuzzh5', 'fenglking', 'lewisspecial', 'qwn19970728', 'raven00', 'lneng', 'youyouyu', 'zhongguogdgz', 'sweety1031', 'a731618814', 'seiro', 'mi18819251871', 'zp14344045', 'qunimadejihuoma', 'tomvictor', 'xuxiangphysics', 'zjy14341045', 'dujw']",3,"['ray2016', 'fakerss', 'tangxy8']",12,"['czczm', 'zjt173720', 'focms', 'xingzy3', 'tanjm32', 'weny2016', 'focmsphyliu', 'jiangyf8', 'hexf', 'mancigbb', None, 'tangzy6']",45,"['shenjw5', 'mp_vanguard', 'madongyu', 'czczm', 'liangzhh29', 'aaronda', 'tangxy8', 'ray2016', 'junky', 'q950316', 'wangguangyu', 'a394096511', 'liuzy26', 'srxh', 'volcano9669', 'liuzzh5', 'fakerss', 'zjt173720', 'fenglking', 'lewisspecial', 'focmsphyliu', 'qwn19970728', 'tangzy6', 'raven00', 'lneng', 'youyouyu', 'zhongguogdgz', 'sweety1031', 'xingzy3', 'weny2016', 'mancigbb', 'a731618814', None, 'seiro', 'mi18819251871', 'focms', 'tanjm32', 'zp14344045', 'qunimadejihuoma', 'jiangyf8', 'tomvictor', 'hexf', 'xuxiangphysics', 'zjy14341045', 'dujw']"
25,161,34,38,23,"['mp_vanguard', 'madongyu', 'liangzhh29', 'tangxy8', 'aaronda', 'ray2016', 'wangguangyu', 'a394096511', 'volcano9669', 'liuzzh5', 'fakerss', 'lewisspecial', 'raven00', 'lneng', 'a731618814', 'seiro', 'mi18819251871', 'zp14344045', 'qunimadejihuoma', 'tomvictor', 'xuxiangphysics', 'zjy14341045', 'dujw']",10,"['shenjw5', 'srxh', 'youyouyu', 'zhongguogdgz', 'sweety1031', 'fenglking', 'qwn19970728', 'junky', 'q950316', 'liuzy26']",15,"['c2010555', 'lily26', 'kenwwy', 'czczm', 'zhaodd3', 'zjt173720', 'lintx233', 'tanjm32', 'zs14344042', 'weny2016', 'jiangyf8', 'phoenixfly', 'xwx', None, 'neptuneli']",48,"['shenjw5', 'mp_vanguard', 'lily26', 'madongyu', 'zhaodd3', 'czczm', 'lintx233', 'liangzhh29', 'phoenixfly', 'aaronda', 'tangxy8', 'ray2016', 'junky', 'q950316', 'wangguangyu', 'a394096511', 'liuzy26', 'srxh', 'c2010555', 'kenwwy', 'volcano9669', 'liuzzh5', 'fakerss', 'zjt173720', 'fenglking', 'lewisspecial', 'zs14344042', 'qwn19970728', 'raven00', 'lneng', 'neptuneli', 'youyouyu', 'zhongguogdgz', 'sweety1031', 'weny2016', 'xwx', 'a731618814', None, 'seiro', 'mi18819251871', 'tanjm32', 'zp14344045', 'qunimadejihuoma', 'jiangyf8', 'tomvictor', 'xuxiangphysics', 'zjy14341045', 'dujw']"
25,122,34,27,17,"['shenjw5', 'mp_vanguard', 'madongyu', 'volcano9669', 'liuzzh5', 'sweety1031', 'fenglking', 'lewisspecial', 'qunimadejihuoma', 'liangzhh29', 'tomvictor', 'aaronda', 'a731618814', 'xuxiangphysics', 'zjy14341045', 'wangguangyu', 'liuzy26']",16,"['a394096511', 'srxh', 'youyouyu', 'seiro', 'zhongguogdgz', 'mi18819251871', 'fakerss', 'lneng', 'zp14344045', 'qwn19970728', 'tangxy8', 'raven00', 'ray2016', 'junky', 'q950316', 'dujw']",10,"['kenwwy', 'czczm', 'zjt173720', 'focms', 'xingzy3', 'zs14344042', 'weny2016', 'jiangyf8', None, 'tangzy6']",43,"['shenjw5', 'mp_vanguard', 'madongyu', 'czczm', 'liangzhh29', 'aaronda', 'tangxy8', 'ray2016', 'junky', 'q950316', 'wangguangyu', 'a394096511', 'liuzy26', 'srxh', 'kenwwy', 'volcano9669', 'liuzzh5', 'fakerss', 'zjt173720', 'fenglking', 'lewisspecial', 'zs14344042', 'qwn19970728', 'tangzy6', 'raven00', 'lneng', 'youyouyu', 'zhongguogdgz', 'sweety1031', 'xingzy3', 'weny2016', 'a731618814', None, 'seiro', 'mi18819251871', 'focms', 'zp14344045', 'qunimadejihuoma', 'jiangyf8', 'tomvictor', 'xuxiangphysics', 'zjy14341045', 'dujw']"
25,158,34,9,3,"['xuxiangphysics', 'fenglking', 'tangxy8']",30,"['shenjw5', 'mp_vanguard', 'madongyu', 'liangzhh29', 'aaronda', 'ray2016', 'junky', 'wangguangyu', 'q950316', 'a394096511', 'liuzy26', 'srxh', 'volcano9669', 'liuzzh5', 'fakerss', 'lewisspecial', 'qwn19970728', 'raven00', 'lneng', 'youyouyu', 'zhongguogdgz', 'sweety1031', 'a731618814', 'seiro', 'mi18819251871', 'zp14344045', 'qunimadejihuoma', 'tomvictor', 'zjy14341045', 'dujw']",6,"['c2010555', 'focms', 'xingzy3', 'jjgoooo', 'hvvvh', None]",39,"['shenjw5', 'mp_vanguard', 'madongyu', 'liangzhh29', 'hvvvh', 'aaronda', 'tangxy8', 'ray2016', 'junky', 'q950316', 'wangguangyu', 'a394096511', 'liuzy26', 'srxh', 'c2010555', 'volcano9669', 'liuzzh5', 'fakerss', 'jjgoooo', 'fenglking', 'lewisspecial', 'qwn19970728', 'raven00', 'lneng', 'youyouyu', 'zhongguogdgz', 'sweety1031', 'xingzy3', 'a731618814', None, 'seiro', 'mi18819251871', 'focms', 'zp14344045', 'qunimadejihuoma', 'tomvictor', 'xuxiangphysics', 'zjy14341045', 'dujw']"
25,123,34,7,4,"['ray2016', 'fenglking', 'zhongguogdgz', 'tangxy8']",29,"['shenjw5', 'mp_vanguard', 'madongyu', 'liangzhh29', 'aaronda', 'junky', 'q950316', 'wangguangyu', 'a394096511', 'liuzy26', 'srxh', 'volcano9669', 'liuzzh5', 'fakerss', 'lewisspecial', 'qwn19970728', 'raven00', 'lneng', 'youyouyu', 'sweety1031', 'a731618814', 'seiro', 'mi18819251871', 'zp14344045', 'qunimadejihuoma', 'tomvictor', 'xuxiangphysics', 'zjy14341045', 'dujw']",3,"['focms', None, 'hvvvh']",36,"['shenjw5', 'mp_vanguard', 'madongyu', 'liangzhh29', 'hvvvh', 'aaronda', 'tangxy8', 'ray2016', 'junky', 'q950316', 'wangguangyu', 'a394096511', 'liuzy26', 'srxh', 'volcano9669', 'liuzzh5', 'fakerss', 'fenglking', 'lewisspecial', 'qwn19970728', 'raven00', 'lneng', 'youyouyu', 'zhongguogdgz', 'sweety1031', 'a731618814', None, 'seiro', 'mi18819251871', 'focms', 'zp14344045', 'qunimadejihuoma', 'tomvictor', 'xuxiangphysics', 'zjy14341045', 'dujw']"
25,230,34,7,4,"['ray2016', 'fenglking', 'zhongguogdgz', 'tangxy8']",29,"['shenjw5', 'mp_vanguard', 'madongyu', 'liangzhh29', 'aaronda', 'junky', 'q950316', 'wangguangyu', 'a394096511', 'liuzy26', 'srxh', 'volcano9669', 'liuzzh5', 'fakerss', 'lewisspecial', 'qwn19970728', 'raven00', 'lneng', 'youyouyu', 'sweety1031', 'a731618814', 'seiro', 'mi18819251871', 'zp14344045', 'qunimadejihuoma', 'tomvictor', 'xuxiangphysics', 'zjy14341045', 'dujw']",3,"['focms', None, 'hvvvh']",36,"['shenjw5', 'mp_vanguard', 'madongyu', 'liangzhh29', 'hvvvh', 'aaronda', 'tangxy8', 'ray2016', 'junky', 'q950316', 'wangguangyu', 'a394096511', 'liuzy26', 'srxh', 'volcano9669', 'liuzzh5', 'fakerss', 'fenglking', 'lewisspecial', 'qwn19970728', 'raven00', 'lneng', 'youyouyu', 'zhongguogdgz', 'sweety1031', 'a731618814', None, 'seiro', 'mi18819251871', 'focms', 'zp14344045', 'qunimadejihuoma', 'tomvictor', 'xuxiangphysics', 'zjy14341045', 'dujw']"
26,202,32,37,31,"['sekchingren', 'jingyan96', 'shinee.agus0', 'shahrul_iqmal', 'thinkhui23', 'vindice1996', 'kevintan', 'soonli950201', 'liewderek7', 'wongyt2222', 'dayangmaisarahh', 'yuenpengwah.dayao', 'ccteh0196', 'khng96', 'zhenyu0425', 'ksyew9', 'liong.yuling', 'aqil_azman', 'nikayuni2012', 'shengyong0908', '1heluckyrocketeer2', 'sutherdrogba', 'dyanahatta01', 'fatinfaranishaa', 'csauniverse', 'haniszyqa', 'shenvern1105', 'marinahjosli', 'samteejs', 'hlmahming0213', 'wani.qisteena']",0,[],6,"['chaicl9504', 'gunakaladevi', 'melsonmoses', 'syazwanie2907', None, 'sharifah_fatmadiana']",37,"['sekchingren', 'vindice1996', 'thinkhui23', 'soonli950201', 'liewderek7', 'gunakaladevi', 'dayangmaisarahh', 'yuenpengwah.dayao', 'ccteh0196', 'khng96', 'aqil_azman', 'nikayuni2012', 'fatinfaranishaa', 'csauniverse', 'haniszyqa', 'marinahjosli', 'syazwanie2907', 'samteejs', 'hlmahming0213', 'jingyan96', 'shinee.agus0', 'sharifah_fatmadiana', 'shahrul_iqmal', 'kevintan', 'wongyt2222', 'ksyew9', 'zhenyu0425', 'liong.yuling', 'melsonmoses', 'shengyong0908', '1heluckyrocketeer2', 'sutherdrogba', 'dyanahatta01', None, 'chaicl9504', 'shenvern1105', 'wani.qisteena']"
27,152,32,26,25,"['u0706044', 'jrpieper77', 'radrock13', 'u0801993', 'u0582222', 'jacobher1986', 'rjkal2008', 'hschwab', 'phillybeasley', 'artc9394', 'jsmithslcc', 'theedrapes1', 'stephensauve', 'dgeddes20', 'leprechaun28', 'mmroz', 'djengelby', 'bradman69', 'u0770904', 'maniromo', 'jn.waterpark', 'mynewhaircut69', 'phil_beasley', 'jlf0036', 'tjgoates']",6,"['wyshply', 'alexwei', 'u0814825', 'avant1john', 'vsp_ali', 'u0546722']",1,[None],32,"['u0706044', 'jrpieper77', 'u0801993', 'radrock13', 'u0582222', 'jacobher1986', 'alexwei', 'rjkal2008', 'u0546722', 'hschwab', 'phillybeasley', 'artc9394', 'wyshply', 'jsmithslcc', 'theedrapes1', 'stephensauve', 'avant1john', 'dgeddes20', 'leprechaun28', 'mmroz', None, 'djengelby', 'bradman69', 'maniromo', 'u0770904', 'u0814825', 'jn.waterpark', 'mynewhaircut69', 'phil_beasley', 'tjgoates', 'vsp_ali', 'jlf0036']"
28,28,32,26,23,"['ljkapnick', 'mgn1478', 'nboswell789', 'pbk2359', 'mrtison', 'climber057', 'jonkellogg2011', 'skseng', 'shanesopel', 'zww2246', 'jschwigs9', 'equinox92', 'buddaniel', 'jonnyk2011', 'jmd4996', 'mzh1343', 'brad_beerman', 'mrr7298', 'dcb0963', 'stevesuter', 'kvargo77', 'dyv4622', 'seanhuber9']",8,"['atg94', 'hacard', 'qutab006', 'saafa13', 'guerinrowland', 'sdurbin', 'alexredinger', 'usamarao']",3,"[None, 'nandan2805', 'jjt2105']",34,"['ljkapnick', 'mgn1478', 'nboswell789', 'alexredinger', 'mrtison', 'pbk2359', 'atg94', 'climber057', 'jonkellogg2011', 'skseng', 'shanesopel', 'guerinrowland', 'jjt2105', 'zww2246', 'sdurbin', 'jschwigs9', 'equinox92', 'buddaniel', 'jonnyk2011', 'jmd4996', 'qutab006', 'mzh1343', None, 'usamarao', 'nandan2805', 'brad_beerman', 'mrr7298', 'dcb0963', 'stevesuter', 'hacard', 'kvargo77', 'saafa13', 'dyv4622', 'seanhuber9']"
29,322,32,60,9,"['zhongy92', 'arobiso', 'zdang', 'jcondori', 'pratik.chawla42', 'xihao', 'ayanhazra2007', 'abaruah', 'talee94']",22,"['wu780', 'bbishnoi', 'venkat77', 'shakibreza', 'zeng133', 'kibech', 'rohantibrewala', 'yash.hurkat1994', 'addison1001', 'patel718', 'sukshitha_achar', 'mo26', 'nkharche', 'jeanpierre1030', 'zhan2331', 'manoj_seeram', 'karl0100', 'yanliang', 'wangruisong24', 'robertsz', 'xu666', 'abhi.reddy525']",51,"['zamzam90', 'linnaduan', 'ben.helfrecht', 'li1724', 'li1651', 'runvacheck', 'sunyx1223', 'akhilvijay', 'ariados88', 'liushunyu', 'pmeunier', 'zhao731', 'anur.bhat', 'mshisheh', 'ahmadi1', 'rajagopv', 'bhaley', 'schcats', 'msakano', 'skarumur', 'thoma501', 'jain205', 'guimingchen', 'infi0508', 'nanoquan2016', 'ye173', 'matthe18', 'misra4', 'jing1995', 'tian53', 'hdhandap', 'prasadsarang', 'pranavj186', 'ge24', 'denphi', 'roysoumya', None, 'rafatulfaria', 'enassakr', 'zooley', 'turkstra', 'ma462', 'alaverni', 'bradneym', 'ujash', 'jenkin50', 'ewilson000', 'awilbee', 'ewares', 'shen338', 'yu207']",82,"['zamzam90', 'zhongy92', 'linnaduan', 'ben.helfrecht', 'runvacheck', 'shakibreza', 'zeng133', 'kibech', 'rohantibrewala', 'mshisheh', 'bhaley', 'pratik.chawla42', 'schcats', 'xihao', 'yash.hurkat1994', 'jain205', 'addison1001', 'patel718', 'misra4', 'tian53', 'prasadsarang', 'enassakr', 'zooley', 'alaverni', 'ujash', 'robertsz', 'ewares', 'ayanhazra2007', 'shen338', 'abhi.reddy525', 'talee94', 'yu207', 'wu780', 'bbishnoi', 'li1724', 'li1651', 'venkat77', 'sunyx1223', 'akhilvijay', 'liushunyu', 'ariados88', 'pmeunier', 'zhao731', 'anur.bhat', 'zdang', 'jcondori', 'ahmadi1', 'rajagopv', 'thoma501', 'msakano', 'skarumur', 'abaruah', 'guimingchen', 'infi0508', 'nanoquan2016', 'ye173', 'arobiso', 'sukshitha_achar', 'matthe18', 'mo26', 'nkharche', 'jing1995', 'hdhandap', 'pranavj186', 'jeanpierre1030', 'ge24', 'denphi', 'roysoumya', None, 'zhan2331', 'manoj_seeram', 'karl0100', 'yanliang', 'rafatulfaria', 'turkstra', 'ma462', 'wangruisong24', 'bradneym', 'awilbee', 'jenkin50', 'ewilson000', 'xu666']"
29,321,32,36,9,"['yanliang', 'patel718', 'zhan2331', 'wangruisong24', 'mo26', 'venkat77', 'zeng133', 'yash.hurkat1994', 'abhi.reddy525']",22,"['zhongy92', 'wu780', 'bbishnoi', 'shakibreza', 'kibech', 'rohantibrewala', 'zdang', 'jcondori', 'pratik.chawla42', 'xihao', 'abaruah', 'addison1001', 'arobiso', 'sukshitha_achar', 'nkharche', 'jeanpierre1030', 'manoj_seeram', 'karl0100', 'robertsz', 'xu666', 'ayanhazra2007', 'talee94']",27,"['rwarburt', 'nspoentgen', 'ewares', 'tshivam4', 'ben.helfrecht', 'rice', 'biswas19', 'lijiarui1115', 'vvivekan', 'adandeka', 'ahmadi1', 'selvara0', 'bcbukows', 'xu399', 'smungamu', 'armen1', 'misra4', 'irislee050', 'pranavj186', None, 'jefonseca', 'revati27', 'lnimmaga', 'ujash', 'jenkin50', 'vvswarup88', 'fang58']",58,"['zhongy92', 'ben.helfrecht', 'shakibreza', 'zeng133', 'rice', 'kibech', 'rohantibrewala', 'adandeka', 'selvara0', 'pratik.chawla42', 'xihao', 'yash.hurkat1994', 'addison1001', 'patel718', 'smungamu', 'armen1', 'misra4', 'jefonseca', 'ujash', 'robertsz', 'vvswarup88', 'ewares', 'ayanhazra2007', 'abhi.reddy525', 'talee94', 'fang58', 'rwarburt', 'nspoentgen', 'wu780', 'tshivam4', 'bbishnoi', 'venkat77', 'biswas19', 'lijiarui1115', 'vvivekan', 'zdang', 'jcondori', 'ahmadi1', 'bcbukows', 'abaruah', 'xu399', 'arobiso', 'sukshitha_achar', 'mo26', 'nkharche', 'irislee050', 'pranavj186', 'jeanpierre1030', None, 'zhan2331', 'manoj_seeram', 'karl0100', 'yanliang', 'revati27', 'lnimmaga', 'wangruisong24', 'jenkin50', 'xu666']"
29,327,32,27,1,['zhongy92'],30,"['wu780', 'bbishnoi', 'venkat77', 'shakibreza', 'zeng133', 'kibech', 'rohantibrewala', 'zdang', 'jcondori', 'pratik.chawla42', 'xihao', 'yash.hurkat1994', 'abaruah', 'addison1001', 'patel718', 'arobiso', 'sukshitha_achar', 'mo26', 'nkharche', 'jeanpierre1030', 'zhan2331', 'manoj_seeram', 'karl0100', 'yanliang', 'talee94', 'wangruisong24', 'robertsz', 'xu666', 'ayanhazra2007', 'abhi.reddy525']",26,"['zamzam90', 'nanohueb', 'runvacheck', 'ariados88', 'pmeunier', 'harshil', 'hezitao', 'ahmadi1', 'rajagopv', 'thoma501', 'jain205', 'larsmusland', 'nkissebe', 'matthe18', 'jing1995', 'atankas', 'hdhandap', 'pranavj186', 'clarksm', 'roysoumya', None, 'enassakr', 'ma462', 'alaverni', 'vvswarup88', 'shen338']",57,"['zamzam90', 'zhongy92', 'nanohueb', 'wu780', 'bbishnoi', 'runvacheck', 'venkat77', 'shakibreza', 'zeng133', 'ariados88', 'pmeunier', 'kibech', 'rohantibrewala', 'harshil', 'zdang', 'hezitao', 'jcondori', 'ahmadi1', 'rajagopv', 'pratik.chawla42', 'thoma501', 'xihao', 'yash.hurkat1994', 'abaruah', 'jain205', 'addison1001', 'larsmusland', 'patel718', 'arobiso', 'sukshitha_achar', 'nkissebe', 'matthe18', 'mo26', 'nkharche', 'jing1995', 'hdhandap', 'atankas', 'pranavj186', 'jeanpierre1030', 'clarksm', 'roysoumya', None, 'zhan2331', 'manoj_seeram', 'karl0100', 'yanliang', 'enassakr', 'ma462', 'talee94', 'wangruisong24', 'alaverni', 'robertsz', 'xu666', 'vvswarup88', 'ayanhazra2007', 'shen338', 'abhi.reddy525']"
29,325,32,7,1,['wangruisong24'],30,"['zhongy92', 'wu780', 'bbishnoi', 'venkat77', 'shakibreza', 'zeng133', 'kibech', 'rohantibrewala', 'zdang', 'jcondori', 'pratik.chawla42', 'xihao', 'yash.hurkat1994', 'abaruah', 'addison1001', 'patel718', 'arobiso', 'sukshitha_achar', 'mo26', 'nkharche', 'jeanpierre1030', 'zhan2331', 'manoj_seeram', 'karl0100', 'yanliang', 'talee94', 'robertsz', 'xu666', 'ayanhazra2007', 'abhi.reddy525']",6,"['nspoentgen', 'revati27', 'vvswarup88', 'rice', None, 'fang58']",37,"['zhongy92', 'nspoentgen', 'wu780', 'bbishnoi', 'venkat77', 'shakibreza', 'zeng133', 'rice', 'kibech', 'rohantibrewala', 'zdang', 'jcondori', 'pratik.chawla42', 'xihao', 'yash.hurkat1994', 'abaruah', 'addison1001', 'patel718', 'arobiso', 'sukshitha_achar', 'mo26', 'nkharche', 'jeanpierre1030', 'fang58', None, 'zhan2331', 'manoj_seeram', 'karl0100', 'yanliang', 'revati27', 'talee94', 'wangruisong24', 'robertsz', 'xu666', 'vvswarup88', 'ayanhazra2007', 'abhi.reddy525']"
30,129,32,25,24,"['dghirsc2', 'ddong4', 'jhryan3', 'garrettd', 'morris754', 'zhoffm', 'peterxcx', 'okijose2', 'dywong2', 'lpb2', 'charlie.hummel2', 'jjhwang3', 'oyedele2', 'dcgarre2', 'isuldew', 'wmercad2', 'jaekwak2', 'ywang359', 'tkim142', 'palusza2', 'clin80', 'dgarrett', 'mophead6868', 'dannyyi2']",7,"['vmaxwel2', 'si008', 'rjc043', 'amalkaba', 'pzhou07920', 'ericchesek', 'tsunakata']",1,[None],32,"['dghirsc2', 'ddong4', 'jhryan3', 'amalkaba', 'pzhou07920', 'garrettd', 'morris754', 'zhoffm', 'peterxcx', 'dywong2', 'okijose2', 'lpb2', 'charlie.hummel2', 'oyedele2', 'jjhwang3', 'ericchesek', 'dcgarre2', 'vmaxwel2', 'isuldew', 'wmercad2', 'jaekwak2', None, 'ywang359', 'si008', 'tkim142', 'palusza2', 'clin80', 'rjc043', 'dgarrett', 'mophead6868', 'dannyyi2', 'tsunakata']"
30,113,32,18,14,"['dghirsc2', 'morris754', 'palusza2', 'peterxcx', 'jhryan3', 'isuldew', 'clin80', 'okijose2', 'lpb2', 'dywong2', 'garrettd', 'jjhwang3', 'mophead6868', 'dannyyi2']",17,"['zhoffm', 'vmaxwel2', 'si008', 'ddong4', 'tkim142', 'rjc043', 'amalkaba', 'charlie.hummel2', 'wmercad2', 'pzhou07920', 'jaekwak2', 'dgarrett', 'oyedele2', 'dcgarre2', 'ericchesek', 'ywang359', 'tsunakata']",4,"['scremen2', 'teddkim', 'mwbrady2', None]",35,"['dghirsc2', 'ddong4', 'jhryan3', 'amalkaba', 'pzhou07920', 'garrettd', 'mwbrady2', 'morris754', 'zhoffm', 'teddkim', 'peterxcx', 'dywong2', 'okijose2', 'lpb2', 'charlie.hummel2', 'oyedele2', 'jjhwang3', 'ericchesek', 'dcgarre2', 'scremen2', 'vmaxwel2', 'isuldew', 'wmercad2', 'jaekwak2', None, 'ywang359', 'si008', 'tkim142', 'palusza2', 'clin80', 'rjc043', 'dgarrett', 'mophead6868', 'dannyyi2', 'tsunakata']"
31,38,32,170,23,"['miteshmohokar', 'ajitjadhav', 'mayuripatil3095', 'tanujudani865', 'ishmeetsingh', 'verma.amitkumar95', 'karan.marketkar', 'rnair15', 'nairprasad007', 'hardik.upadhyay', 'ankitferry123', 'gurmukhsingh0108', 'amit.dutta', 'palak1012', 'happyridermrk', 'ankur.shah', 'pripatil285', 'princeporje98', 'rutu123', 'parthkaushikdave', 'ashish.mrya1', 'pareshnaik1995', 'poojaparab9035']",8,"['ramizmahaboob124', 'prajaktachapte2', 'shraddhaindulkar96', 'anisha', 'ritesh.parulekar231194', 'sanketsalvi03', 'nidhi.n.gujarathi', 'heramb10']",147,"['jigneshk2994', 'yashsavle', 'tejuliman74', 'harshitbangera', 'sanketh728', 'swatimane176', 'rushikeshjoshi285', 'shreyasawant95', 'viraktdoshi19', 'udayyewale17', 'karan.gondalia', 'patilroshan1128', 'kumarvivek017', 'rohitpuri.g', 'sush81194', 'rishabh4745', 'tambeneha94', 'rukhsrd', 'nair19shruti', 'gadhiyakenil16', 'abauti608', 'sadiqqureshi393', 'jiteshkjsp', 'varun1997', 'aniketshelar79', 'sachimalkan', 'sgat3451', 'jaysawant2', 'ykhedikar', 'ishaan.sathe', 'mapethe', 'amruteshpatil', 'pateltejash96', 'ratsthegreat', 'tandelsneha15', 'doshi.kavisha16', 'tajpara.nikhil', 'g3jithinn', 'kapilaherkar755', 'sweta151945', 'dhairyagada1997', 'pruthavi.c', 'akansha319892', 'vjseedan', 'vishal.chavda', 'joshua0667', 'hardrider95', 'priyankadeshpande177', '1jyotsna1', 'prasad.m', 'parmarmayur05', 'nikj816', 'smajumdar', 'rrnair291293', 'nikuldengada493', 'suraj6111994', 'yogeshwar21121995', 'nilesh.delekar', 'ameymalotkar1', 'gopal.singh', 'nehaaltawade1', 's.jadeja', 'melchiznadar', 'nikhil4241307', 'pdeshpande', 'peshinakash', 'kiranjadhav050994', 'abinbenny8', 'ashupalambe1992', 'abinaya67006', 'machalke92', 'yogi.6692', 'devyani.salvi1028', 'qwertynishit', 'florence9344', 'anuradha.d', 'satya_mishra', 'shraddhakharde01', 'inderjitsingh87', 'kypptl', 'lino2296', 'sharma.ayushi8c', 'sbodke', 'aqudas29', 'khedikaryash8', 'tgpatil22791', 'vijaykothari97', 'pranithsuvarna1', 'mauryashubham564', 'vijaya', 'shaminakunnel', 'rahulbadekar', 'arawal14.ar', 'raoashish96', 'parag.choughule', 'asingh12', 'parag16593', 'jigar', 'shivam_cr7', 'udit.shah', 'vishakha', 'tdholpuria', 'atoraskar12', 'mkadam03', 'walavalkarmayur79', 'ankitagharat93', 'aanugraha', 'shubhrapatil77', 'gkapil45', 'rushabh.soni', 'sonihetvi10', 'aniketa.yelave49', 'jadhavankita9969', 'sujataredkar', 'rautt59', 'rjoshi02', 'karankyp', 'adwaitvajpe', 'anevrekar', 'yayatipawar601', 'akash.mali3477', 'karantank97', 'akashmore456', 'surajkarade.2', 'pranav.gori', 'patilvarad2011', 'apekshapawar', 'ramanujsingh004', 'keyur.gajjar', 'pranilghogale', 'desaivighnesh95', None, 'burhan.naim', 'd.shenoy', 'ankith89', 'priyanka.bhangre', 'rutwijajoshi10', 'karanshah30', 'agarwal.gagan5101', 'anshujha95', 'vedy1811', 'chaitanyakhane999', 'tushar.gaikwad', 'gaurav.gadre', 'sourabhbelose', 'somil910', 'abhiramibp95']",178,"['jigneshk2994', 'yashsavle', 'tejuliman74', 'harshitbangera', 'ishmeetsingh', 'sanketh728', 'swatimane176', 'karan.marketkar', 'rnair15', 'rushikeshjoshi285', 'shreyasawant95', 'viraktdoshi19', 'udayyewale17', 'karan.gondalia', 'patilroshan1128', 'kumarvivek017', 'rohitpuri.g', 'gurmukhsingh0108', 'amit.dutta', 'sush81194', 'rishabh4745', 'tambeneha94', 'ramizmahaboob124', 'rukhsrd', 'happyridermrk', 'nair19shruti', 'gadhiyakenil16', 'abauti608', 'sadiqqureshi393', 'rutu123', 'jiteshkjsp', 'aniketshelar79', 'shraddhaindulkar96', 'sachimalkan', 'sgat3451', 'jaysawant2', 'ykhedikar', 'ishaan.sathe', 'mapethe', 'amruteshpatil', 'pateltejash96', 'ratsthegreat', 'tandelsneha15', 'doshi.kavisha16', 'tajpara.nikhil', 'miteshmohokar', 'g3jithinn', 'kapilaherkar755', 'sweta151945', 'dhairyagada1997', 'pruthavi.c', 'akansha319892', 'vjseedan', 'vishal.chavda', 'nairprasad007', 'joshua0667', 'hardik.upadhyay', 'ankitferry123', 'hardrider95', 'priyankadeshpande177', '1jyotsna1', 'prasad.m', 'parmarmayur05', 'nikj816', 'smajumdar', 'rrnair291293', 'nikuldengada493', 'ankur.shah', 'princeporje98', 'suraj6111994', 'prajaktachapte2', 'yogeshwar21121995', 'parthkaushikdave', 'nilesh.delekar', 'ameymalotkar1', 'pareshnaik1995', 'poojaparab9035', 'gopal.singh', 'nehaaltawade1', 's.jadeja', 'melchiznadar', 'nikhil4241307', 'pdeshpande', 'peshinakash', 'kiranjadhav050994', 'abinbenny8', 'ashupalambe1992', 'abinaya67006', 'ajitjadhav', 'machalke92', 'anisha', 'yogi.6692', 'devyani.salvi1028', 'qwertynishit', 'verma.amitkumar95', 'florence9344', 'anuradha.d', 'satya_mishra', 'shraddhakharde01', 'inderjitsingh87', 'kypptl', 'lino2296', 'sharma.ayushi8c', 'sbodke', 'aqudas29', 'khedikaryash8', 'tgpatil22791', 'vijaykothari97', 'pranithsuvarna1', 'mauryashubham564', 'vijaya', 'nidhi.n.gujarathi', 'heramb10', 'shaminakunnel', 'rahulbadekar', 'arawal14.ar', 'raoashish96', 'parag.choughule', 'asingh12', 'parag16593', 'jigar', 'shivam_cr7', 'udit.shah', 'vishakha', 'tdholpuria', 'atoraskar12', 'mkadam03', 'walavalkarmayur79', 'ankitagharat93', 'somil910', 'aanugraha', 'shubhrapatil77', 'gkapil45', 'mayuripatil3095', 'rushabh.soni', 'tanujudani865', 'sonihetvi10', 'aniketa.yelave49', 'jadhavankita9969', 'sujataredkar', 'rautt59', 'rjoshi02', 'karankyp', 'adwaitvajpe', 'anevrekar', 'yayatipawar601', 'akash.mali3477', 'karantank97', 'sanketsalvi03', 'akashmore456', 'surajkarade.2', 'pranav.gori', 'palak1012', 'patilvarad2011', 'apekshapawar', 'ramanujsingh004', 'ritesh.parulekar231194', 'keyur.gajjar', 'pranilghogale', 'pripatil285', 'desaivighnesh95', None, 'burhan.naim', 'd.shenoy', 'ashish.mrya1', 'ankith89', 'priyanka.bhangre', 'rutwijajoshi10', 'karanshah30', 'agarwal.gagan5101', 'anshujha95', 'vedy1811', 'chaitanyakhane999', 'tushar.gaikwad', 'gaurav.gadre', 'sourabhbelose', 'varun1997', 'abhiramibp95']"
31,42,32,114,3,"['prajaktachapte2', 'ritesh.parulekar231194', 'sanketsalvi03']",28,"['miteshmohokar', 'ajitjadhav', 'mayuripatil3095', 'anisha', 'tanujudani865', 'ishmeetsingh', 'verma.amitkumar95', 'karan.marketkar', 'rnair15', 'nairprasad007', 'hardik.upadhyay', 'ankitferry123', 'gurmukhsingh0108', 'amit.dutta', 'palak1012', 'ramizmahaboob124', 'happyridermrk', 'nidhi.n.gujarathi', 'ankur.shah', 'pripatil285', 'heramb10', 'princeporje98', 'rutu123', 'parthkaushikdave', 'shraddhaindulkar96', 'ashish.mrya1', 'pareshnaik1995', 'poojaparab9035']",111,"['sankpalami', 'shrutikayadav2oct', 'dalvisayli', 'ektarathod786', 'niraj901', 'dikshabafna1995', 'adipatil37', 'niteshnarkar712', 'omkarn049', 'sahilsk7', 'ahire.monali07', 'vinit95vasudevan', 'minalsawant143', 'chaudharipayal50', 'shraddha0306', 'sangeetamjoshi', 'mudrasjuee', 'vijaybhargude2', 'sebastian007', 'ashwini12rajput', 'praju.avhad', 'rakshu.gade', 'sam234bryant', 'sonalipawar589', 'ratsthegreat', 'oma1811', 'rsawant2895', 'sumedh_patil', 'a.j.yadav2395', 'chiragc9494', 'hbg2112', 'varadrajnanaware7', 'viveky803', 'tejasshinde8055', 'chaudharisuyash7', 'ru1795', 'deven199570', 'priyagajakosh1', 'aashish.yadav94', 'pratikthorat10', 'jatin.dhande1008', 'aniket2602', 'aditya1818', 'sonawane.akshayak', 'sagarpawar', 'gsawant999', 'nikhildubey02051996', 'danish.dev.007', 'saylishirodkar58', 'sayalipatil4545', 'aishwaryamardhekar.24595', 'cooldudeakshu', 'komalbapna.kb', 'akshaybadhiye04', 'iabhishek555', 'pankajpawar1515', 'susmitaahirrao', 'umeshdarade77', 'tanayshinde21', 'infinite1309', 'pravin45', 'tejaskanagal95', 'oindri.c', 'abarge31', 'shahyash027', 'rawletanmayee46', 'mahajanabhi2201', 'advenraju', 'abhihadshi', 'supu1796', 'pratikkhanore95', 'preetywagh95', 'gidayegirish', 'shrikantnimse14', 'gauravrajeshmehta', 'pbrahmapurkar', 'swati123', 'saurabhmangeshkar', 'shrutisundar019', 'ravina.chavan42', 'mukulsathe1995', 'tarak.shah', 'priyankaingle18', 'bondreanup007', 'rohitbaliyan53', 'tanyabaptist05', 'bkadam357', 'manishashetye1295', 'abhishek.thavare', 'sardesai.kirti18', 'sammit1844', 'sandesh29', 'amritamukeshb', 'lakumveer', 'shakyanandk', 'ramaprde2296', 'rushabh.fegade', 'akashspawar148', 'cpatil152', 'abhishekm2861996', 'vishakha1805', 'dattaram.gawade781', None, 'sagarbhagat43', 'kaustubhgudekar9', 'prashant.baperkar', 'suman28pandit', 'rakeshmaity', 'rohanchavan', 'bimal.biswas8', 'ptrimukhe32']",142,"['sankpalami', 'shrutikayadav2oct', 'dalvisayli', 'niraj901', 'ektarathod786', 'dikshabafna1995', 'adipatil37', 'niteshnarkar712', 'omkarn049', 'ishmeetsingh', 'sahilsk7', 'ahire.monali07', 'karan.marketkar', 'rnair15', 'vinit95vasudevan', 'gurmukhsingh0108', 'amit.dutta', 'minalsawant143', 'ramizmahaboob124', 'happyridermrk', 'chaudharipayal50', 'shraddha0306', 'sangeetamjoshi', 'mudrasjuee', 'vijaybhargude2', 'rutu123', 'sebastian007', 'ashwini12rajput', 'shraddhaindulkar96', 'praju.avhad', 'rakshu.gade', 'sam234bryant', 'sonalipawar589', 'ratsthegreat', 'oma1811', 'miteshmohokar', 'rsawant2895', 'sumedh_patil', 'a.j.yadav2395', 'chiragc9494', 'hbg2112', 'varadrajnanaware7', 'viveky803', 'tejasshinde8055', 'nairprasad007', 'chaudharisuyash7', 'hardik.upadhyay', 'ankitferry123', 'ru1795', 'deven199570', 'priyagajakosh1', 'aashish.yadav94', 'pratikthorat10', 'jatin.dhande1008', 'aniket2602', 'aditya1818', 'sonawane.akshayak', 'ankur.shah', 'sagarpawar', 'princeporje98', 'gsawant999', 'prajaktachapte2', 'parthkaushikdave', 'nikhildubey02051996', 'pareshnaik1995', 'poojaparab9035', 'danish.dev.007', 'saylishirodkar58', 'sayalipatil4545', 'aishwaryamardhekar.24595', 'cooldudeakshu', 'ajitjadhav', 'komalbapna.kb', 'anisha', 'verma.amitkumar95', 'akshaybadhiye04', 'iabhishek555', 'pankajpawar1515', 'susmitaahirrao', 'umeshdarade77', 'tanayshinde21', 'infinite1309', 'pravin45', 'tejaskanagal95', 'oindri.c', 'abarge31', 'shahyash027', 'rawletanmayee46', 'nidhi.n.gujarathi', 'mahajanabhi2201', 'heramb10', 'advenraju', 'abhihadshi', 'supu1796', 'pratikkhanore95', 'preetywagh95', 'gidayegirish', 'shrikantnimse14', 'gauravrajeshmehta', 'pbrahmapurkar', 'swati123', 'saurabhmangeshkar', 'shrutisundar019', 'ravina.chavan42', 'mukulsathe1995', 'tarak.shah', 'mayuripatil3095', 'priyankaingle18', 'tanujudani865', 'bondreanup007', 'rohitbaliyan53', 'tanyabaptist05', 'bkadam357', 'manishashetye1295', 'abhishek.thavare', 'sardesai.kirti18', 'sammit1844', 'sanketsalvi03', 'sandesh29', 'amritamukeshb', 'lakumveer', 'palak1012', 'shakyanandk', 'ramaprde2296', 'rushabh.fegade', 'akashspawar148', 'cpatil152', 'abhishekm2861996', 'ritesh.parulekar231194', 'vishakha1805', 'pripatil285', 'dattaram.gawade781', None, 'ashish.mrya1', 'sagarbhagat43', 'kaustubhgudekar9', 'prashant.baperkar', 'suman28pandit', 'rakeshmaity', 'rohanchavan', 'bimal.biswas8', 'ptrimukhe32']"
31,138,32,35,1,['palak1012'],30,"['miteshmohokar', 'ajitjadhav', 'mayuripatil3095', 'anisha', 'tanujudani865', 'ishmeetsingh', 'verma.amitkumar95', 'karan.marketkar', 'rnair15', 'nairprasad007', 'sanketsalvi03', 'hardik.upadhyay', 'ankitferry123', 'gurmukhsingh0108', 'amit.dutta', 'ramizmahaboob124', 'happyridermrk', 'ritesh.parulekar231194', 'nidhi.n.gujarathi', 'ankur.shah', 'pripatil285', 'heramb10', 'princeporje98', 'rutu123', 'prajaktachapte2', 'parthkaushikdave', 'shraddhaindulkar96', 'ashish.mrya1', 'pareshnaik1995', 'poojaparab9035']",34,"['danishdewani112795', 'pratikdongrikar', 'shubhamsurya449', 'samson.sd28', 'tanyabaptist05', 'raku1109', 'suthar.kalpesh57', 'minkscdl', 'dms.dms786', 'alisha.alice.panicker', 'ankit.kp', 'pankajvyas967', 'shubhamjambhe8', 'manisha.shetty07', 'kiranrelekar412', 'ranjuvarughese', 'shubhangi.matey', 'basil11031996', 'jitesh.10', 'shafaanbhai', 'burhansnaim', 'rutujanare', None, 'rashika.t', 'd.shenoy', 'parag.choughule', 'amey.m.mangutkar', 'nilesh.delekar', 'hemadevi.b', 'ishaan.sathe', 'vishalchelimela11', 'upadhyechinmay', 'krishna96', 'dishakulkarni25']",65,"['ajitjadhav', 'anisha', 'pratikdongrikar', 'samson.sd28', 'raku1109', 'ishmeetsingh', 'minkscdl', 'verma.amitkumar95', 'karan.marketkar', 'rnair15', 'ankit.kp', 'pankajvyas967', 'gurmukhsingh0108', 'amit.dutta', 'manisha.shetty07', 'ranjuvarughese', 'ramizmahaboob124', 'basil11031996', 'happyridermrk', 'jitesh.10', 'nidhi.n.gujarathi', 'shafaanbhai', 'rutujanare', 'heramb10', 'rutu123', 'rashika.t', 'parag.choughule', 'shraddhaindulkar96', 'hemadevi.b', 'ishaan.sathe', 'vishalchelimela11', 'krishna96', 'danishdewani112795', 'miteshmohokar', 'mayuripatil3095', 'tanujudani865', 'shubhamsurya449', 'tanyabaptist05', 'suthar.kalpesh57', 'dms.dms786', 'alisha.alice.panicker', 'nairprasad007', 'sanketsalvi03', 'hardik.upadhyay', 'ankitferry123', 'shubhamjambhe8', 'kiranrelekar412', 'palak1012', 'shubhangi.matey', 'ritesh.parulekar231194', 'ankur.shah', 'pripatil285', 'burhansnaim', 'princeporje98', None, 'd.shenoy', 'prajaktachapte2', 'amey.m.mangutkar', 'parthkaushikdave', 'nilesh.delekar', 'ashish.mrya1', 'pareshnaik1995', 'poojaparab9035', 'upadhyechinmay', 'dishakulkarni25']"
31,40,32,30,4,"['heramb10', 'prajaktachapte2', 'ritesh.parulekar231194', 'sanketsalvi03']",27,"['miteshmohokar', 'ajitjadhav', 'mayuripatil3095', 'anisha', 'tanujudani865', 'ishmeetsingh', 'verma.amitkumar95', 'karan.marketkar', 'rnair15', 'nairprasad007', 'hardik.upadhyay', 'ankitferry123', 'gurmukhsingh0108', 'amit.dutta', 'palak1012', 'ramizmahaboob124', 'happyridermrk', 'nidhi.n.gujarathi', 'ankur.shah', 'pripatil285', 'princeporje98', 'rutu123', 'parthkaushikdave', 'shraddhaindulkar96', 'ashish.mrya1', 'pareshnaik1995', 'poojaparab9035']",26,"['mukulsathe1995', 'bondreanup007', 'tanyabaptist05', 'a.j.yadav2395', 'hbg2112', 'anasnaik25', 'shriya.h.joshi', 'anujakhose94', 'akshaybadhiye04', 'iabhishek555', 'shreyamath95', 'shakyanandk', 'arpit32', 'parmitbanga1995', 'shraddha0306', 'vaibhavghare94', 'neilmundhe', 'sagarpawar', None, 'sebastian007', 'smonica498', 'patelu997', 'prp23dec', 'mohiteashwin7', 'mapethe', 'ratsthegreat']",57,"['mukulsathe1995', 'miteshmohokar', 'ajitjadhav', 'mayuripatil3095', 'anisha', 'tanujudani865', 'bondreanup007', 'tanyabaptist05', 'a.j.yadav2395', 'hbg2112', 'anasnaik25', 'ishmeetsingh', 'shriya.h.joshi', 'anujakhose94', 'verma.amitkumar95', 'karan.marketkar', 'akshaybadhiye04', 'rnair15', 'iabhishek555', 'nairprasad007', 'sanketsalvi03', 'hardik.upadhyay', 'ankitferry123', 'gurmukhsingh0108', 'amit.dutta', 'shreyamath95', 'palak1012', 'ramizmahaboob124', 'shakyanandk', 'arpit32', 'happyridermrk', 'parmitbanga1995', 'shraddha0306', 'ritesh.parulekar231194', 'vaibhavghare94', 'neilmundhe', 'nidhi.n.gujarathi', 'ankur.shah', 'pripatil285', 'heramb10', 'sagarpawar', 'princeporje98', 'rutu123', None, 'sebastian007', 'prajaktachapte2', 'smonica498', 'parthkaushikdave', 'patelu997', 'shraddhaindulkar96', 'ashish.mrya1', 'prp23dec', 'pareshnaik1995', 'poojaparab9035', 'mohiteashwin7', 'mapethe', 'ratsthegreat']"
31,39,32,23,2,"['heramb10', 'poojaparab9035']",29,"['miteshmohokar', 'ajitjadhav', 'mayuripatil3095', 'anisha', 'tanujudani865', 'ishmeetsingh', 'verma.amitkumar95', 'karan.marketkar', 'rnair15', 'nairprasad007', 'sanketsalvi03', 'hardik.upadhyay', 'ankitferry123', 'gurmukhsingh0108', 'amit.dutta', 'palak1012', 'ramizmahaboob124', 'happyridermrk', 'ritesh.parulekar231194', 'nidhi.n.gujarathi', 'ankur.shah', 'pripatil285', 'princeporje98', 'rutu123', 'prajaktachapte2', 'parthkaushikdave', 'shraddhaindulkar96', 'ashish.mrya1', 'pareshnaik1995']",21,"['doshi.kavisha16', 'kenilgadhiya', 'adityamodi009', 'viraktdoshi19', 'inderjitsingh87', 'kailashpatel0000', 'naval29', '1jyotsna1', 'dhruvinacharya19', 'aayushtiwari16', 'raj010rocks', 'gadhiyakenil16', 'jigar.ramin786', None, 'vaibhav206rsm', 'malharvyas17.mv', 'tanuj.udani', 'varunj331', 'mapethe', 'siddhantssangal', 'singhshashank97']",52,"['doshi.kavisha16', 'kenilgadhiya', 'miteshmohokar', 'ajitjadhav', 'mayuripatil3095', 'anisha', 'tanujudani865', 'ishmeetsingh', 'verma.amitkumar95', 'karan.marketkar', 'rnair15', 'adityamodi009', 'viraktdoshi19', 'nairprasad007', 'sanketsalvi03', 'hardik.upadhyay', 'ankitferry123', 'inderjitsingh87', 'gurmukhsingh0108', 'amit.dutta', 'kailashpatel0000', 'palak1012', '1jyotsna1', 'ramizmahaboob124', 'naval29', 'happyridermrk', 'dhruvinacharya19', 'aayushtiwari16', 'raj010rocks', 'gadhiyakenil16', 'jigar.ramin786', 'ritesh.parulekar231194', 'nidhi.n.gujarathi', 'ankur.shah', 'pripatil285', 'heramb10', 'princeporje98', 'rutu123', None, 'prajaktachapte2', 'vaibhav206rsm', 'parthkaushikdave', 'shraddhaindulkar96', 'ashish.mrya1', 'pareshnaik1995', 'poojaparab9035', 'malharvyas17.mv', 'tanuj.udani', 'varunj331', 'mapethe', 'siddhantssangal', 'singhshashank97']"
31,41,32,18,1,['shraddhaindulkar96'],30,"['miteshmohokar', 'ajitjadhav', 'mayuripatil3095', 'anisha', 'tanujudani865', 'ishmeetsingh', 'verma.amitkumar95', 'karan.marketkar', 'rnair15', 'nairprasad007', 'sanketsalvi03', 'hardik.upadhyay', 'ankitferry123', 'gurmukhsingh0108', 'amit.dutta', 'palak1012', 'ramizmahaboob124', 'happyridermrk', 'ritesh.parulekar231194', 'nidhi.n.gujarathi', 'ankur.shah', 'pripatil285', 'heramb10', 'princeporje98', 'rutu123', 'prajaktachapte2', 'parthkaushikdave', 'ashish.mrya1', 'pareshnaik1995', 'poojaparab9035']",17,"['guptasantosh7896', 'megha2206', 'shubhangi.matey', 'jitesh.10', 'n160165', 'santoshdudhal0', 'tanyabaptist05', 'aakashgangolli3112', 'arpit0071995', 'darshankikani64', 'tbhoir24', 'vishalchelimela11', 'rasikardamushte', None, 'minkscdl', 'razorrajeev', 'manishjadhav1001']",48,"['miteshmohokar', 'ajitjadhav', 'mayuripatil3095', 'anisha', 'tanujudani865', 'santoshdudhal0', 'tanyabaptist05', 'ishmeetsingh', 'minkscdl', 'razorrajeev', 'verma.amitkumar95', 'karan.marketkar', 'rnair15', 'nairprasad007', 'sanketsalvi03', 'hardik.upadhyay', 'ankitferry123', 'gurmukhsingh0108', 'amit.dutta', 'rasikardamushte', 'palak1012', 'manishjadhav1001', 'ramizmahaboob124', 'guptasantosh7896', 'megha2206', 'shubhangi.matey', 'happyridermrk', 'jitesh.10', 'ritesh.parulekar231194', 'nidhi.n.gujarathi', 'ankur.shah', 'darshankikani64', 'pripatil285', 'heramb10', 'princeporje98', 'rutu123', None, 'prajaktachapte2', 'parthkaushikdave', 'shraddhaindulkar96', 'ashish.mrya1', 'pareshnaik1995', 'poojaparab9035', 'aakashgangolli3112', 'arpit0071995', 'tbhoir24', 'vishalchelimela11', 'n160165']"
31,43,32,10,2,"['happyridermrk', 'pripatil285']",29,"['miteshmohokar', 'ajitjadhav', 'mayuripatil3095', 'anisha', 'tanujudani865', 'ishmeetsingh', 'verma.amitkumar95', 'karan.marketkar', 'rnair15', 'nairprasad007', 'sanketsalvi03', 'hardik.upadhyay', 'ankitferry123', 'gurmukhsingh0108', 'amit.dutta', 'palak1012', 'ramizmahaboob124', 'ritesh.parulekar231194', 'nidhi.n.gujarathi', 'ankur.shah', 'heramb10', 'princeporje98', 'rutu123', 'prajaktachapte2', 'parthkaushikdave', 'shraddhaindulkar96', 'ashish.mrya1', 'pareshnaik1995', 'poojaparab9035']",8,"['parag.choughule', 'navneetmishra021', 'akashmore456', 'atul.20909', 'aniket2602', None, 'somil910', 'ratsthegreat']",39,"['miteshmohokar', 'ajitjadhav', 'mayuripatil3095', 'anisha', 'tanujudani865', 'ishmeetsingh', 'atul.20909', 'verma.amitkumar95', 'karan.marketkar', 'rnair15', 'nairprasad007', 'sanketsalvi03', 'hardik.upadhyay', 'ankitferry123', 'akashmore456', 'gurmukhsingh0108', 'amit.dutta', 'aniket2602', 'palak1012', 'ramizmahaboob124', 'navneetmishra021', 'happyridermrk', 'ritesh.parulekar231194', 'nidhi.n.gujarathi', 'ankur.shah', 'pripatil285', 'heramb10', 'princeporje98', 'rutu123', None, 'prajaktachapte2', 'parag.choughule', 'parthkaushikdave', 'shraddhaindulkar96', 'ashish.mrya1', 'pareshnaik1995', 'poojaparab9035', 'somil910', 'ratsthegreat']"
31,45,32,6,2,"['happyridermrk', 'pripatil285']",29,"['ramizmahaboob124', 'miteshmohokar', 'ajitjadhav', 'mayuripatil3095', 'anisha', 'tanujudani865', 'ritesh.parulekar231194', 'nidhi.n.gujarathi', 'ankur.shah', 'ishmeetsingh', 'heramb10', 'princeporje98', 'rutu123', 'verma.amitkumar95', 'prajaktachapte2', 'karan.marketkar', 'parthkaushikdave', 'rnair15', 'shraddhaindulkar96', 'ashish.mrya1', 'pareshnaik1995', 'poojaparab9035', 'nairprasad007', 'sanketsalvi03', 'hardik.upadhyay', 'ankitferry123', 'gurmukhsingh0108', 'amit.dutta', 'palak1012']",4,"['aniket2602', 'akashmore456', 'tanayshinde21', None]",35,"['ramizmahaboob124', 'miteshmohokar', 'ajitjadhav', 'happyridermrk', 'mayuripatil3095', 'anisha', 'tanujudani865', 'ritesh.parulekar231194', 'nidhi.n.gujarathi', 'ankur.shah', 'ishmeetsingh', 'pripatil285', 'heramb10', 'princeporje98', 'rutu123', None, 'verma.amitkumar95', 'prajaktachapte2', 'karan.marketkar', 'parthkaushikdave', 'rnair15', 'shraddhaindulkar96', 'ashish.mrya1', 'pareshnaik1995', 'poojaparab9035', 'tanayshinde21', 'nairprasad007', 'sanketsalvi03', 'hardik.upadhyay', 'ankitferry123', 'akashmore456', 'gurmukhsingh0108', 'amit.dutta', 'aniket2602', 'palak1012']"
31,204,32,6,1,['rnair15'],30,"['ramizmahaboob124', 'miteshmohokar', 'ajitjadhav', 'happyridermrk', 'mayuripatil3095', 'anisha', 'tanujudani865', 'ritesh.parulekar231194', 'nidhi.n.gujarathi', 'ankur.shah', 'ishmeetsingh', 'pripatil285', 'heramb10', 'princeporje98', 'rutu123', 'verma.amitkumar95', 'prajaktachapte2', 'karan.marketkar', 'parthkaushikdave', 'shraddhaindulkar96', 'ashish.mrya1', 'pareshnaik1995', 'poojaparab9035', 'nairprasad007', 'sanketsalvi03', 'hardik.upadhyay', 'ankitferry123', 'gurmukhsingh0108', 'amit.dutta', 'palak1012']",5,"['rushikeshjoshi285', 'sgat3451', 'pdeshpande', None, 'aanugraha']",36,"['ramizmahaboob124', 'miteshmohokar', 'ajitjadhav', 'happyridermrk', 'mayuripatil3095', 'anisha', 'tanujudani865', 'ritesh.parulekar231194', 'nidhi.n.gujarathi', 'ankur.shah', 'ishmeetsingh', 'pripatil285', 'heramb10', 'princeporje98', 'rutu123', None, 'verma.amitkumar95', 'prajaktachapte2', 'karan.marketkar', 'parthkaushikdave', 'rnair15', 'shraddhaindulkar96', 'ashish.mrya1', 'rushikeshjoshi285', 'pareshnaik1995', 'poojaparab9035', 'sgat3451', 'nairprasad007', 'sanketsalvi03', 'hardik.upadhyay', 'ankitferry123', 'gurmukhsingh0108', 'amit.dutta', 'pdeshpande', 'palak1012', 'aanugraha']"
32,157,31,45,3,"['lily26', 'phoenixfly', 'zhaodd3']",27,"['hpc29', 'blickley', 'alb8ef', 'ss3726', 'bphud3', 'kvs36', 'christouartemis', 'gabriel.gorelick', 'sarychevaasia', 'tcm6309', 'gplummer317', 'gtucker', 'stephenbady', '14pwest', 'ssr49', 'rgn24', 'kas572', 'gabriellasiryj', 'lshanna1', 'dd659', 'angelica.a.connor', 'langenstein1', 'xdrngy', 'mikecarey', 'pb456', 'asiasarycheva', 'samzkulesa']",42,"['shenjw5', 'mp_vanguard', 'madongyu', 'lintx233', 'liangzhh29', 'aaronda', 'ray2016', 'junky', 'wangguangyu', 'liuzy26', 'c2010555', 'a394096511', 'srxh', 'kenwwy', 'zjt173720', 'volcano9669', 'fakerss', 'liuzzh5', 'focmsphyliu', 'qwn19970728', 'tangzy6', 'raven00', 'neptuneli', 'lneng', 'zhongguogdgz', 'sweety1031', 'xingzy3', 'weny2016', 'xwx', 'mancigbb', 'a731618814', None, 'mouseeatcat', 'seiro', 'focms', 'tanjm32', 'zp14344045', 'qunimadejihuoma', 'jiangyf8', 'hexf', 'zjy14341045', 'dujw']",72,"['shenjw5', 'lily26', 'hpc29', 'lintx233', 'bphud3', 'ray2016', 'junky', 'liuzy26', 'a394096511', 'volcano9669', 'fakerss', 'gabriel.gorelick', 'sarychevaasia', 'tcm6309', 'gplummer317', 'focmsphyliu', 'stephenbady', 'neptuneli', 'lneng', 'ssr49', 'rgn24', 'kas572', 'zhongguogdgz', 'sweety1031', 'gabriellasiryj', 'weny2016', 'lshanna1', 'xwx', 'dd659', 'mancigbb', 'a731618814', 'angelica.a.connor', 'xdrngy', 'mouseeatcat', 'tanjm32', 'jiangyf8', 'samzkulesa', 'zjy14341045', 'tangzy6', 'dujw', 'mp_vanguard', 'zhaodd3', 'blickley', 'madongyu', 'alb8ef', 'ss3726', 'liangzhh29', 'phoenixfly', 'aaronda', 'kvs36', 'wangguangyu', 'c2010555', 'srxh', 'kenwwy', 'zjt173720', 'liuzzh5', 'christouartemis', 'qwn19970728', 'gtucker', 'raven00', '14pwest', 'xingzy3', None, 'langenstein1', 'seiro', 'mikecarey', 'focms', 'zp14344045', 'pb456', 'qunimadejihuoma', 'asiasarycheva', 'hexf']"
32,161,31,38,3,"['lily26', 'phoenixfly', 'zhaodd3']",27,"['hpc29', 'blickley', 'alb8ef', 'ss3726', 'bphud3', 'kvs36', 'christouartemis', 'gabriel.gorelick', 'sarychevaasia', 'tcm6309', 'gplummer317', 'gtucker', 'stephenbady', '14pwest', 'ssr49', 'rgn24', 'kas572', 'gabriellasiryj', 'lshanna1', 'dd659', 'angelica.a.connor', 'langenstein1', 'xdrngy', 'mikecarey', 'pb456', 'asiasarycheva', 'samzkulesa']",35,"['mp_vanguard', 'madongyu', 'czczm', 'lintx233', 'liangzhh29', 'aaronda', 'tangxy8', 'ray2016', 'wangguangyu', 'c2010555', 'a394096511', 'kenwwy', 'zjt173720', 'volcano9669', 'liuzzh5', 'fakerss', 'lewisspecial', 'zs14344042', 'raven00', 'neptuneli', 'lneng', 'weny2016', 'xwx', 'a731618814', None, 'seiro', 'mi18819251871', 'tanjm32', 'zp14344045', 'qunimadejihuoma', 'jiangyf8', 'tomvictor', 'xuxiangphysics', 'zjy14341045', 'dujw']",65,"['lily26', 'hpc29', 'czczm', 'lintx233', 'tangxy8', 'bphud3', 'ray2016', 'a394096511', 'volcano9669', 'fakerss', 'gabriel.gorelick', 'sarychevaasia', 'tcm6309', 'gplummer317', 'stephenbady', 'neptuneli', 'lneng', 'ssr49', 'rgn24', 'kas572', 'gabriellasiryj', 'weny2016', 'lshanna1', 'xwx', 'dd659', 'a731618814', 'angelica.a.connor', 'xdrngy', 'mi18819251871', 'tanjm32', 'jiangyf8', 'xuxiangphysics', 'samzkulesa', 'zjy14341045', 'dujw', 'mp_vanguard', 'zhaodd3', 'blickley', 'madongyu', 'alb8ef', 'ss3726', 'liangzhh29', 'phoenixfly', 'aaronda', 'kvs36', 'wangguangyu', 'c2010555', 'kenwwy', 'zjt173720', 'liuzzh5', 'christouartemis', 'lewisspecial', 'zs14344042', 'gtucker', 'raven00', '14pwest', None, 'langenstein1', 'seiro', 'mikecarey', 'zp14344045', 'pb456', 'qunimadejihuoma', 'asiasarycheva', 'tomvictor']"
32,160,31,29,26,"['hpc29', 'blickley', 'alb8ef', 'ss3726', 'bphud3', 'kvs36', 'christouartemis', 'gabriel.gorelick', 'tcm6309', 'sarychevaasia', 'gplummer317', 'gtucker', '14pwest', 'ssr49', 'rgn24', 'kas572', 'gabriellasiryj', 'lshanna1', 'dd659', 'angelica.a.connor', 'langenstein1', 'xdrngy', 'mikecarey', 'pb456', 'asiasarycheva', 'samzkulesa']",4,"['stephenbady', 'lily26', 'phoenixfly', 'zhaodd3']",3,"[None, 'ajf326', 'nordinsgroup']",33,"['lily26', 'hpc29', 'blickley', 'zhaodd3', 'alb8ef', 'ss3726', 'phoenixfly', 'ajf326', 'bphud3', 'kvs36', 'christouartemis', 'gabriel.gorelick', 'sarychevaasia', 'tcm6309', 'gplummer317', 'gtucker', 'stephenbady', '14pwest', 'ssr49', 'rgn24', 'kas572', 'gabriellasiryj', 'lshanna1', 'dd659', 'angelica.a.connor', None, 'langenstein1', 'xdrngy', 'nordinsgroup', 'mikecarey', 'pb456', 'asiasarycheva', 'samzkulesa']"
33,24,31,102,20,"['shoho214', 'drog0311', 'hhnn1229', 'kigg1124', 'mrcsm200', 'tjrwodl2000', 'gohny0115', 'jwh0114', 'tksfoqlt', 'ghdud0351', 'sjg1779', 'wjdgns22222', 'sicpan12', 'woghks927', 'm109a6', 'kdj406', 'dlrjswo', 'akstn34', 'fredhan89', 'jsa6580']",10,"['jkjk0411', 'vngkgkrhdwn', 'mong929', 'k01022707621', 'glzpr1598', 'inbo7979', 'aaa4199', 'sosn1211', 'c1o1n1n1e1r', 'hussienfayed']",82,"['sks911017', 'kimjunsu112', 'bluegil92', 'skzl34', 'nnoonn4488', 'sgu20121451', 'jkorad2843', 'sgu20131480', 'sgu20121465', 'awdwadw12341', 'bonghyuk', 'k910716kim', 'kym1122', 'sgu20111577', 'noon486', 'sgu20111450', 'krleesd92', 'sgu20121469', 'sgu20121546', 'bbbty6064', 'noon48', 'parkchanwoo7', 'vhwkd308', 'lilydh511', 'kshbig0425', 'whq456', 'sgu20111399', 'road', 'dangshiggy', 'sgu20111478', 'dogp27', 'sgu20121507', 'gugusj', 'angyi90', 'poby', 'honnyou', 'thenopi10', 'sgu20101328', 'lsh0307', 'dudxo9273', 'sgu20141467', 'dongjin225', 'gwoo7057', 'mrlee', 'cyc2490', 'jangsungin', 'pisces9231', 'qkrwhdgkr', 'kan7470', 'mygime92', 'carjehee', 'sgu20111505', 'ghghrkdlgh', 'sdy9333', 'dbrhksan88', 'rnfnqnfn', 'sgu20121479', 'sgu20121526', 'sgu20121514', 'sgu20141426', 'sgu20121450', 'gkakfhdlem', 'sgu20121541', 'qkdgywp', 'bbbty60', 'sgug20160008', 'hun0307', 'whj1130', 'kissheyo1004', 'ccjswlgh', 'sgu20121540', 'gordius92', 'lkm9200', 'injahgi', 'box1916', None, 'oyj95', 'kiddyu1991', 'sgu20141482', 'sgu20102047', 'dnlwd09', 'jjo2824']",112,"['hhnn1229', 'sks911017', 'kimjunsu112', 'vngkgkrhdwn', 'tjrwodl2000', 'bluegil92', 'skzl34', 'nnoonn4488', 'jwh0114', 'jkjk0411', 'sgu20121451', 'mong929', 'k01022707621', 'jkorad2843', 'sgu20131480', 'sgu20121465', 'wjdgns22222', 'woghks927', 'awdwadw12341', 'bonghyuk', 'kdj406', 'k910716kim', 'kym1122', 'sgu20111577', 'dlrjswo', 'noon486', 'akstn34', 'sgu20111450', 'krleesd92', 'hussienfayed', 'sgu20121469', 'sgu20121546', 'shoho214', 'bbbty6064', 'noon48', 'parkchanwoo7', 'drog0311', 'vhwkd308', 'lilydh511', 'kshbig0425', 'inbo7979', 'whq456', 'gohny0115', 'sgu20111399', 'road', 'dangshiggy', 'sgu20111478', 'tksfoqlt', 'm109a6', 'dogp27', 'sgu20121507', 'gugusj', 'angyi90', 'poby', 'honnyou', 'thenopi10', 'sgu20101328', 'lsh0307', 'dudxo9273', 'sgu20141467', 'dongjin225', 'gwoo7057', 'mrlee', 'cyc2490', 'sosn1211', 'jangsungin', 'pisces9231', 'qkrwhdgkr', 'kan7470', 'mygime92', 'carjehee', 'sgu20111505', 'ghghrkdlgh', 'sdy9333', 'dbrhksan88', 'rnfnqnfn', 'sgu20121479', 'sgu20121526', 'sgu20121514', 'sgu20141426', 'sicpan12', 'glzpr1598', 'fredhan89', 'gkakfhdlem', 'sgu20121450', 'jsa6580', 'sgu20121541', 'qkdgywp', 'bbbty60', 'sgug20160008', 'kigg1124', 'hun0307', 'mrcsm200', 'whj1130', 'aaa4199', 'kissheyo1004', 'ccjswlgh', 'sgu20121540', 'gordius92', 'ghdud0351', 'sjg1779', 'lkm9200', 'injahgi', 'c1o1n1n1e1r', 'box1916', None, 'oyj95', 'kiddyu1991', 'sgu20141482', 'sgu20102047', 'dnlwd09', 'jjo2824']"
33,191,31,55,26,"['shoho214', 'drog0311', 'hhnn1229', 'kigg1124', 'vngkgkrhdwn', 'mrcsm200', 'inbo7979', 'tjrwodl2000', 'sosn1211', 'aaa4199', 'gohny0115', 'jkjk0411', 'mong929', 'k01022707621', 'tksfoqlt', 'ghdud0351', 'sjg1779', 'wjdgns22222', 'sicpan12', 'woghks927', 'm109a6', 'kdj406', 'dlrjswo', 'akstn34', 'fredhan89', 'jsa6580']",4,"['glzpr1598', 'c1o1n1n1e1r', 'hussienfayed', 'jwh0114']",29,"['rnlgur9192', 'jylee432', 'sgu20121442', 'tmdrms34', 'lsjleelsj', 'sks911017', 'kimjunsu112', 'sogang1536', 'sgu20121468', 'whq456', 'taehojung', 'dangshiggy', 'dino900925', 'sgu20121481', 'jkorad2843', 'sgu20121479', 'high_sky_up', 'sgu20121503', 'rarami55', 'sgu20131480', 'sgu20121514', 'jjo2824', 'sgu20101584', None, 'sgu20121476', 'sgu20141447', 'dnlwd09', 'sgu20121467', 'sgu20121469']",59,"['rnlgur9192', 'sgu20121442', 'hhnn1229', 'sks911017', 'kimjunsu112', 'vngkgkrhdwn', 'tjrwodl2000', 'sosn1211', 'sgu20121468', 'dino900925', 'jwh0114', 'jkjk0411', 'mong929', 'k01022707621', 'sgu20121479', 'jkorad2843', 'high_sky_up', 'rarami55', 'sgu20131480', 'wjdgns22222', 'sgu20121514', 'sicpan12', 'woghks927', 'kdj406', 'glzpr1598', 'dlrjswo', 'akstn34', 'fredhan89', 'jsa6580', 'sgu20141447', 'hussienfayed', 'sgu20121469', 'sogang1536', 'jylee432', 'tmdrms34', 'shoho214', 'lsjleelsj', 'drog0311', 'kigg1124', 'mrcsm200', 'inbo7979', 'aaa4199', 'whq456', 'gohny0115', 'taehojung', 'dangshiggy', 'sgu20121481', 'tksfoqlt', 'sgu20121503', 'ghdud0351', 'sjg1779', 'm109a6', 'sgu20101584', 'c1o1n1n1e1r', None, 'sgu20121476', 'dnlwd09', 'sgu20121467', 'jjo2824']"
33,21,31,40,1,['jwh0114'],29,"['shoho214', 'drog0311', 'hhnn1229', 'kigg1124', 'vngkgkrhdwn', 'mrcsm200', 'inbo7979', 'tjrwodl2000', 'sosn1211', 'aaa4199', 'gohny0115', 'jkjk0411', 'mong929', 'k01022707621', 'tksfoqlt', 'ghdud0351', 'sjg1779', 'wjdgns22222', 'sicpan12', 'woghks927', 'm109a6', 'c1o1n1n1e1r', 'kdj406', 'glzpr1598', 'dlrjswo', 'akstn34', 'fredhan89', 'jsa6580', 'hussienfayed']",39,"['sgu20121541', 'sgu20121546', 'sgu20141467', 'vhwkd308', 'whj1130', 'sgu20111399', 'ccjswlgh', 'dangshiggy', 'kan7470', 'road', 'sgu20111478', 'sgu20121540', 'sgu20121484', 'carjehee', 'sgu20121451', 'sgu20111505', 'ghghrkdlgh', 'rnfnqnfn', 'sgu20121526', 'sgu20131480', 'sgu20121465', 'sgu20141426', 'dogp27', 'gugusj', 'sgu20121507', None, 'poby', 'k910716kim', 'honnyou', 'sgu20111577', 'sgu20121517', 'sgu20111493', 'sgu20121450', 'sgu20141482', 'sgu20141447', 'sgu20102047', 'krleesd92', 'thenopi10', 'sgu20101328']",69,"['sgu20141467', 'hhnn1229', 'vngkgkrhdwn', 'tjrwodl2000', 'sosn1211', 'kan7470', 'sgu20121484', 'jwh0114', 'jkjk0411', 'sgu20111505', 'sgu20121451', 'mong929', 'k01022707621', 'carjehee', 'ghghrkdlgh', 'rnfnqnfn', 'sgu20121526', 'sgu20131480', 'sgu20121465', 'wjdgns22222', 'sgu20141426', 'sicpan12', 'woghks927', 'kdj406', 'k910716kim', 'sgu20111577', 'glzpr1598', 'dlrjswo', 'sgu20111493', 'akstn34', 'fredhan89', 'sgu20121450', 'jsa6580', 'sgu20141447', 'krleesd92', 'hussienfayed', 'sgu20121541', 'sgu20121546', 'shoho214', 'drog0311', 'vhwkd308', 'kigg1124', 'mrcsm200', 'whj1130', 'inbo7979', 'aaa4199', 'gohny0115', 'sgu20111399', 'ccjswlgh', 'dangshiggy', 'road', 'sgu20111478', 'sgu20121540', 'tksfoqlt', 'ghdud0351', 'sjg1779', 'm109a6', 'dogp27', 'c1o1n1n1e1r', 'gugusj', 'sgu20121507', None, 'poby', 'honnyou', 'sgu20141482', 'sgu20102047', 'sgu20121517', 'thenopi10', 'sgu20101328']"
33,70,31,34,1,['kdj406'],29,"['shoho214', 'drog0311', 'hhnn1229', 'kigg1124', 'vngkgkrhdwn', 'mrcsm200', 'inbo7979', 'tjrwodl2000', 'sosn1211', 'aaa4199', 'gohny0115', 'jwh0114', 'jkjk0411', 'mong929', 'k01022707621', 'tksfoqlt', 'ghdud0351', 'sjg1779', 'wjdgns22222', 'sicpan12', 'woghks927', 'm109a6', 'c1o1n1n1e1r', 'glzpr1598', 'dlrjswo', 'akstn34', 'fredhan89', 'jsa6580', 'hussienfayed']",33,"['lsh0307', 'kokyeol0320', 'brewnac', 'qkdgywp', 'dudxo9273', 'dongjin225', 'zxzxzx1216', 'gwoo7057', 'kshotrm', 'kissheyo1004', 'pisces9231', 'dwm0530.mj', 'mygime92', 'carlcll3', 'skzl34', 'nnoonn4488', 'ghghrkdlgh', 'jangyy12', 'rnfnqnfn', 'dbrhksan88', 'rarami55', 'hikim95', 'injahgi', 'yuivb0614', 'lswchs522', 'hyeonsu7479', 'hbean', None, 'bonghyuk', 'kiddyu1991', 'gksmfdlekt90', 'yhw910', 'krleesd92']",63,"['lsh0307', 'kokyeol0320', 'dudxo9273', 'dongjin225', 'hhnn1229', 'zxzxzx1216', 'gwoo7057', 'vngkgkrhdwn', 'tjrwodl2000', 'sosn1211', 'pisces9231', 'skzl34', 'mygime92', 'nnoonn4488', 'jwh0114', 'jkjk0411', 'carlcll3', 'ghghrkdlgh', 'mong929', 'k01022707621', 'rnfnqnfn', 'dbrhksan88', 'rarami55', 'hikim95', 'wjdgns22222', 'sicpan12', 'woghks927', 'hyeonsu7479', 'bonghyuk', 'kdj406', 'glzpr1598', 'dlrjswo', 'akstn34', 'fredhan89', 'jsa6580', 'yhw910', 'krleesd92', 'hussienfayed', 'brewnac', 'qkdgywp', 'shoho214', 'drog0311', 'kigg1124', 'kshotrm', 'mrcsm200', 'inbo7979', 'aaa4199', 'kissheyo1004', 'gohny0115', 'dwm0530.mj', 'jangyy12', 'tksfoqlt', 'ghdud0351', 'sjg1779', 'injahgi', 'yuivb0614', 'lswchs522', 'm109a6', 'hbean', 'c1o1n1n1e1r', None, 'kiddyu1991', 'gksmfdlekt90']"
33,67,31,19,1,['jwh0114'],29,"['shoho214', 'drog0311', 'hhnn1229', 'kigg1124', 'vngkgkrhdwn', 'mrcsm200', 'inbo7979', 'tjrwodl2000', 'sosn1211', 'aaa4199', 'gohny0115', 'jkjk0411', 'mong929', 'k01022707621', 'tksfoqlt', 'ghdud0351', 'sjg1779', 'wjdgns22222', 'sicpan12', 'woghks927', 'm109a6', 'c1o1n1n1e1r', 'kdj406', 'glzpr1598', 'dlrjswo', 'akstn34', 'fredhan89', 'jsa6580', 'hussienfayed']",18,"['ghghrkdlgh', 'qkdgywp', 'jylee432', 'rnfnqnfn', 'dksquddhr123', 'jdh940130', 'dongjin225', 'vocasuki', 'pisces9231', 'yuivb0614', 'lswchs522', 'ccjswlgh', 'dangshiggy', 'vhwkd308', 'mlg6060', 'krleesd92', None, 'skzl34']",48,"['qkdgywp', 'jylee432', 'shoho214', 'dongjin225', 'drog0311', 'hhnn1229', 'vhwkd308', 'kigg1124', 'vngkgkrhdwn', 'mrcsm200', 'inbo7979', 'tjrwodl2000', 'dksquddhr123', 'sosn1211', 'aaa4199', 'pisces9231', 'gohny0115', 'ccjswlgh', 'dangshiggy', 'skzl34', 'jwh0114', 'jkjk0411', 'ghghrkdlgh', 'mong929', 'k01022707621', 'tksfoqlt', 'rnfnqnfn', 'ghdud0351', 'sjg1779', 'jdh940130', 'wjdgns22222', 'sicpan12', 'yuivb0614', 'woghks927', 'm109a6', 'lswchs522', 'c1o1n1n1e1r', None, 'kdj406', 'glzpr1598', 'dlrjswo', 'akstn34', 'fredhan89', 'vocasuki', 'mlg6060', 'jsa6580', 'krleesd92', 'hussienfayed']"
33,189,31,6,1,['hhnn1229'],29,"['jkjk0411', 'mong929', 'k01022707621', 'tksfoqlt', 'shoho214', 'ghdud0351', 'sjg1779', 'wjdgns22222', 'drog0311', 'sicpan12', 'woghks927', 'm109a6', 'c1o1n1n1e1r', 'kigg1124', 'vngkgkrhdwn', 'kdj406', 'mrcsm200', 'glzpr1598', 'inbo7979', 'dlrjswo', 'tjrwodl2000', 'akstn34', 'fredhan89', 'sosn1211', 'aaa4199', 'gohny0115', 'jsa6580', 'hussienfayed', 'jwh0114']",5,"['jkorad2843', 'diner13', 'taehojung', 'dangshiggy', None]",35,"['jkjk0411', 'mong929', 'k01022707621', 'tksfoqlt', 'jkorad2843', 'shoho214', 'ghdud0351', 'sjg1779', 'wjdgns22222', 'drog0311', 'sicpan12', 'hhnn1229', 'woghks927', 'm109a6', 'c1o1n1n1e1r', None, 'kigg1124', 'vngkgkrhdwn', 'kdj406', 'mrcsm200', 'glzpr1598', 'inbo7979', 'dlrjswo', 'tjrwodl2000', 'akstn34', 'fredhan89', 'sosn1211', 'aaa4199', 'diner13', 'gohny0115', 'jsa6580', 'taehojung', 'dangshiggy', 'hussienfayed', 'jwh0114']"
33,190,31,6,2,"['hhnn1229', 'fredhan89']",28,"['jkjk0411', 'mong929', 'k01022707621', 'tksfoqlt', 'shoho214', 'ghdud0351', 'sjg1779', 'wjdgns22222', 'drog0311', 'sicpan12', 'woghks927', 'm109a6', 'c1o1n1n1e1r', 'kigg1124', 'vngkgkrhdwn', 'kdj406', 'mrcsm200', 'glzpr1598', 'inbo7979', 'dlrjswo', 'tjrwodl2000', 'akstn34', 'sosn1211', 'aaa4199', 'gohny0115', 'jsa6580', 'hussienfayed', 'jwh0114']",4,"[None, 'jkorad2843', 'jylee432', 'dangshiggy']",34,"['jkjk0411', 'mong929', 'k01022707621', 'tksfoqlt', 'jkorad2843', 'jylee432', 'shoho214', 'ghdud0351', 'sjg1779', 'wjdgns22222', 'drog0311', 'sicpan12', 'hhnn1229', 'woghks927', 'm109a6', 'c1o1n1n1e1r', None, 'kigg1124', 'vngkgkrhdwn', 'kdj406', 'mrcsm200', 'glzpr1598', 'inbo7979', 'dlrjswo', 'tjrwodl2000', 'akstn34', 'fredhan89', 'sosn1211', 'aaa4199', 'gohny0115', 'jsa6580', 'dangshiggy', 'hussienfayed', 'jwh0114']"
34,47,29,207,24,"['vaishnavi.sambrekar', 'divya.upalekar', 'mervyn.fernandes', 'ashishmohite1996', 'ritesh.shukla', 'anujakhose94', 'rananeetika3', 'tejasshinde8055', 'cvvedesh', 'zkoyande', 'bhavesh.singh', 'bhavikashenoy95', 'neha.utekar2608', 'mokshada', 'rahul1995', 'akashspawar148', 'johebshaikh', 'pragatinarnaware', 'nehadingankar', 'rutvij.supekar', 'mudbidrijay', 'akshata.kulkarni', 'chirag184', 'suraj.taigade']",4,"['calvinl', 'eliasmagallanesjr17', 'shrutisundar019', 'swati123']",183,"['nitingurme', 'kadamk008', 'bhavesh3422', 'aniket187', 'rehansonarkar784', 'jainamshah202', 'aimomajy', 'nrkhara', 'ajay.raghuwanshi', 'krittikaranga', 'trija68', 'rajdeepd', 'brian200495', 'shraddhad', 'mehtajinal3101', 'vinit95vasudevan', 'gujarathikshitij', 'minalsawant1108', 'email.harsh0811', 'himanshuphatak98', 'arpit32', 'nikitarane245', 'bhoomee.sheth', 'abhishek1996', 'obalgi3095', 'kambe302', 'lakhanmodani1811', 'simran123', 'rajwaje44', 'jayjadav08', 'neelam.chaudhari27', '22diptinikalje', 'sebastian007', 'tanvikalan', 'harshilmehta1995', 'komal31p', 'poojashetty', 'darshanadaund27', 'sam234bryant', 'nagateja.vlsi', 'bhumivora1995', 'geeta.kavitake', 'mapethe', 'sid.rane95', 'jaidevdalvi', 'monish.kapadia', 'ratsthegreat', 'ajinkyachadha', 'rsawant2895', 'ninad41195', 'purva.desai', 'msumit95', 'patil.rushal825', 'chinmayaniket4052', 'rupali.patil', 'pathanabdulrazzak9524', 'viveky803', 'kpiyushbhirud', 'siddhesh401', 'sanika.dongre', 'manasi.shinde008', 'dhvanilmandalia29', 'anasnaik9987', 'alohomora7', 'pranilraut17', 'suryatejachitturi', 'avinashninawe', 'apoorvasundaresan', 'aditya.apte3', 'shivanisharaf15', 'sonawane.akshayak', 'akanksha0196', 'shubhamj95', 'aeyjd', 'luke676', 'monish.nene', 'spooja.1430', 'purva.satpute', 'adwait.sable10', 'gsawant999', 'deepikachaman3', 'patelu997', 'mshirali23', 'nikhildubey02051996', 'shwecchajain', 'kadamrupesh1996', 'shweta1811', 'stanabk', 'rohankhollamkar', 'upadhyechinmay', 'cooldudeakshu', 'juhi.manglani', 'komalbapna.kb', 'mugdha.dalvi', 'amanpal56', 'gupta.ravi1996', 'dipmads', 'rajatkedia95', 'ankurbhagwat8', 'harshal.dangat1', 'florence9344', 'shubham.gaikwad', 'sanjana.advani', 'priyuk', 'priyeshd', 'tanvi.rane1995', 'ambani', 'umeshdarade77', 'tanayshinde21', 'karan.dadlani', 'pravin45', 'tejaskanagal95', 'doshishrut1995', 'kondekar23', 'poojamenon16.pm', 'mihirsawant17', 'rahul4peace', 'rhea.ann.95', 'rawletanmayee46', 'ajthamke40', 'rashuidiot', 'minal.patil', 'chaitanyakhachane95', 'harshada123', 'mahajanabhi2201', 'abhishekpatkar1796', 'abhihadshi', 'bharathi.pedapudi', 'lakshmi.nair', 'gauravrajeshmehta', 'codekidx', 'pbrahmapurkar', 'pathakrohan18', 'shreyasvkul', 'mananmehta7', 'prathameshptkr4', 'aparnaahari95', 'tarak.shah', 'akshayshinde101095', 'manavtrivedi03', 'vivek12195', 'nikhilgade', 'arvindlandge', 'anasnaik25', 'akshay21', 'mukul.kulkarni', 'sardesai.kirti18', 'shraddhag', 'vishaakn', 'amrsha.srivastava', 'apurva.patil', 'omkardalvi409', 'shriya.sharma', 'lakumveer', 'shreyamath95', 'dhruv.gajaria95', 'mohak11jan', 'parthiv.parikh', 'sandipani1995', 'khannamansi312', 'vishakha1805', 'yashgumaste', 'nileshkartik95', 'neilmundhe', 'shreya.mahajan', 'jainam49', 'jakhererahul42', 'dattaram.gawade781', 'pavitra.iyer', 'tejaschaudhary1996', 'vaibhav.gangan7', 'ankita.rahate', 'shamikabachal', 'swapkaru123', 'saheli.konde', 'prashant.baperkar', 'suman28pandit', 'rakeshmaity', 'aakashgangolli3112', 'prachi.more', 'rohanchavan', 'guptesoham95', 'ptrimukhe32']",211,"['nitingurme', 'kadamk008', 'bhavesh3422', 'aniket187', 'rehansonarkar784', 'jainamshah202', 'aimomajy', 'nrkhara', 'ajay.raghuwanshi', 'krittikaranga', 'trija68', 'rajdeepd', 'brian200495', 'rananeetika3', 'shraddhad', 'mehtajinal3101', 'vinit95vasudevan', 'gujarathikshitij', 'zkoyande', 'calvinl', 'minalsawant1108', 'neha.utekar2608', 'email.harsh0811', 'himanshuphatak98', 'arpit32', 'nikitarane245', 'bhoomee.sheth', 'abhishek1996', 'obalgi3095', 'kambe302', 'lakhanmodani1811', 'simran123', 'rajwaje44', 'jayjadav08', 'neelam.chaudhari27', '22diptinikalje', 'sebastian007', 'tanvikalan', 'harshilmehta1995', 'komal31p', 'poojashetty', 'darshanadaund27', 'sam234bryant', 'nagateja.vlsi', 'bhumivora1995', 'geeta.kavitake', 'mapethe', 'sid.rane95', 'suraj.taigade', 'jaidevdalvi', 'monish.kapadia', 'ratsthegreat', 'ajinkyachadha', 'divya.upalekar', 'rsawant2895', 'ninad41195', 'purva.desai', 'msumit95', 'patil.rushal825', 'chinmayaniket4052', 'anujakhose94', 'rupali.patil', 'pathanabdulrazzak9524', 'viveky803', 'kpiyushbhirud', 'tejasshinde8055', 'siddhesh401', 'sanika.dongre', 'manasi.shinde008', 'bhavikashenoy95', 'dhvanilmandalia29', 'mokshada', 'anasnaik9987', 'alohomora7', 'pranilraut17', 'suryatejachitturi', 'avinashninawe', 'apoorvasundaresan', 'aditya.apte3', 'prachi.more', 'shivanisharaf15', 'sonawane.akshayak', 'akanksha0196', 'shubhamj95', 'aeyjd', 'luke676', 'monish.nene', 'spooja.1430', 'purva.satpute', 'adwait.sable10', 'nehadingankar', 'pragatinarnaware', 'gsawant999', 'deepikachaman3', 'patelu997', 'mshirali23', 'nikhildubey02051996', 'shwecchajain', 'akshata.kulkarni', 'kadamrupesh1996', 'shweta1811', 'stanabk', 'rohankhollamkar', 'upadhyechinmay', 'cooldudeakshu', 'juhi.manglani', 'vaishnavi.sambrekar', 'komalbapna.kb', 'eliasmagallanesjr17', 'ritesh.shukla', 'mugdha.dalvi', 'amanpal56', 'gupta.ravi1996', 'dipmads', 'rajatkedia95', 'ankurbhagwat8', 'harshal.dangat1', 'florence9344', 'shubham.gaikwad', 'sanjana.advani', 'priyuk', 'priyeshd', 'tanvi.rane1995', 'ambani', 'umeshdarade77', 'tanayshinde21', 'cvvedesh', 'karan.dadlani', 'pravin45', 'tejaskanagal95', 'doshishrut1995', 'kondekar23', 'poojamenon16.pm', 'mihirsawant17', 'rahul4peace', 'rahul1995', 'rhea.ann.95', 'rawletanmayee46', 'ajthamke40', 'rashuidiot', 'minal.patil', 'chaitanyakhachane95', 'johebshaikh', 'harshada123', 'mahajanabhi2201', 'abhishekpatkar1796', 'abhihadshi', 'bharathi.pedapudi', 'lakshmi.nair', 'rutvij.supekar', 'mudbidrijay', 'gauravrajeshmehta', 'codekidx', 'pbrahmapurkar', 'pathakrohan18', 'shreyasvkul', 'mananmehta7', 'chirag184', 'prathameshptkr4', 'swati123', 'aparnaahari95', 'shrutisundar019', 'tarak.shah', 'mervyn.fernandes', 'ashishmohite1996', 'akshayshinde101095', 'manavtrivedi03', 'vivek12195', 'nikhilgade', 'arvindlandge', 'anasnaik25', 'akshay21', 'mukul.kulkarni', 'sardesai.kirti18', 'shraddhag', 'vishaakn', 'amrsha.srivastava', 'apurva.patil', 'bhavesh.singh', 'omkardalvi409', 'shriya.sharma', 'lakumveer', 'shreyamath95', 'dhruv.gajaria95', 'mohak11jan', 'parthiv.parikh', 'sandipani1995', 'akashspawar148', 'khannamansi312', 'vishakha1805', 'yashgumaste', 'nileshkartik95', 'neilmundhe', 'shreya.mahajan', 'jainam49', 'jakhererahul42', 'dattaram.gawade781', 'tejaschaudhary1996', 'vaibhav.gangan7', 'ankita.rahate', 'shamikabachal', 'swapkaru123', 'saheli.konde', 'prashant.baperkar', 'suman28pandit', 'rakeshmaity', 'aakashgangolli3112', 'pavitra.iyer', 'rohanchavan', 'guptesoham95', 'ptrimukhe32']"
34,42,29,114,4,"['akashspawar148', 'shrutisundar019', 'swati123', 'tejasshinde8055']",24,"['vaishnavi.sambrekar', 'divya.upalekar', 'mervyn.fernandes', 'ashishmohite1996', 'eliasmagallanesjr17', 'ritesh.shukla', 'anujakhose94', 'rananeetika3', 'cvvedesh', 'zkoyande', 'calvinl', 'bhavesh.singh', 'bhavikashenoy95', 'neha.utekar2608', 'mokshada', 'rahul1995', 'johebshaikh', 'pragatinarnaware', 'nehadingankar', 'rutvij.supekar', 'mudbidrijay', 'akshata.kulkarni', 'chirag184', 'suraj.taigade']",110,"['sankpalami', 'shrutikayadav2oct', 'dalvisayli', 'ektarathod786', 'niraj901', 'dikshabafna1995', 'adipatil37', 'niteshnarkar712', 'omkarn049', 'sahilsk7', 'ahire.monali07', 'vinit95vasudevan', 'minalsawant143', 'chaudharipayal50', 'shraddha0306', 'sangeetamjoshi', 'mudrasjuee', 'vijaybhargude2', 'sebastian007', 'ashwini12rajput', 'praju.avhad', 'rakshu.gade', 'sam234bryant', 'sonalipawar589', 'ratsthegreat', 'oma1811', 'rsawant2895', 'sumedh_patil', 'a.j.yadav2395', 'chiragc9494', 'hbg2112', 'varadrajnanaware7', 'viveky803', 'chaudharisuyash7', 'ru1795', 'deven199570', 'priyagajakosh1', 'aashish.yadav94', 'pratikthorat10', 'jatin.dhande1008', 'aniket2602', 'aditya1818', 'sonawane.akshayak', 'sagarpawar', 'gsawant999', 'prajaktachapte2', 'nikhildubey02051996', 'danish.dev.007', 'saylishirodkar58', 'sayalipatil4545', 'aishwaryamardhekar.24595', 'cooldudeakshu', 'komalbapna.kb', 'akshaybadhiye04', 'iabhishek555', 'pankajpawar1515', 'susmitaahirrao', 'umeshdarade77', 'tanayshinde21', 'infinite1309', 'pravin45', 'tejaskanagal95', 'oindri.c', 'abarge31', 'shahyash027', 'rawletanmayee46', 'mahajanabhi2201', 'advenraju', 'abhihadshi', 'supu1796', 'pratikkhanore95', 'preetywagh95', 'gidayegirish', 'shrikantnimse14', 'gauravrajeshmehta', 'pbrahmapurkar', 'saurabhmangeshkar', 'ravina.chavan42', 'mukulsathe1995', 'tarak.shah', 'priyankaingle18', 'bondreanup007', 'rohitbaliyan53', 'tanyabaptist05', 'bkadam357', 'manishashetye1295', 'abhishek.thavare', 'sardesai.kirti18', 'sammit1844', 'sanketsalvi03', 'sandesh29', 'amritamukeshb', 'lakumveer', 'shakyanandk', 'ramaprde2296', 'rushabh.fegade', 'cpatil152', 'abhishekm2861996', 'ritesh.parulekar231194', 'vishakha1805', 'dattaram.gawade781', None, 'sagarbhagat43', 'kaustubhgudekar9', 'prashant.baperkar', 'suman28pandit', 'rakeshmaity', 'rohanchavan', 'bimal.biswas8', 'ptrimukhe32']",138,"['sankpalami', 'shrutikayadav2oct', 'dalvisayli', 'niraj901', 'ektarathod786', 'dikshabafna1995', 'adipatil37', 'niteshnarkar712', 'omkarn049', 'sahilsk7', 'ahire.monali07', 'rananeetika3', 'vinit95vasudevan', 'zkoyande', 'calvinl', 'neha.utekar2608', 'minalsawant143', 'chaudharipayal50', 'shraddha0306', 'sangeetamjoshi', 'mudrasjuee', 'vijaybhargude2', 'sebastian007', 'ashwini12rajput', 'praju.avhad', 'rakshu.gade', 'sam234bryant', 'suraj.taigade', 'sonalipawar589', 'ratsthegreat', 'oma1811', 'divya.upalekar', 'rsawant2895', 'sumedh_patil', 'a.j.yadav2395', 'chiragc9494', 'hbg2112', 'varadrajnanaware7', 'anujakhose94', 'viveky803', 'tejasshinde8055', 'chaudharisuyash7', 'ru1795', 'bhavikashenoy95', 'deven199570', 'priyagajakosh1', 'aashish.yadav94', 'pratikthorat10', 'jatin.dhande1008', 'aniket2602', 'aditya1818', 'mokshada', 'sonawane.akshayak', 'nehadingankar', 'pragatinarnaware', 'sagarpawar', 'gsawant999', 'prajaktachapte2', 'nikhildubey02051996', 'akshata.kulkarni', 'danish.dev.007', 'saylishirodkar58', 'sayalipatil4545', 'aishwaryamardhekar.24595', 'cooldudeakshu', 'vaishnavi.sambrekar', 'komalbapna.kb', 'eliasmagallanesjr17', 'ritesh.shukla', 'akshaybadhiye04', 'iabhishek555', 'pankajpawar1515', 'susmitaahirrao', 'umeshdarade77', 'tanayshinde21', 'cvvedesh', 'infinite1309', 'pravin45', 'tejaskanagal95', 'oindri.c', 'abarge31', 'rahul1995', 'shahyash027', 'rawletanmayee46', 'johebshaikh', 'mahajanabhi2201', 'advenraju', 'abhihadshi', 'supu1796', 'pratikkhanore95', 'preetywagh95', 'gidayegirish', 'shrikantnimse14', 'rutvij.supekar', 'mudbidrijay', 'gauravrajeshmehta', 'pbrahmapurkar', 'chirag184', 'swati123', 'saurabhmangeshkar', 'shrutisundar019', 'ravina.chavan42', 'mukulsathe1995', 'tarak.shah', 'mervyn.fernandes', 'ashishmohite1996', 'priyankaingle18', 'bondreanup007', 'rohitbaliyan53', 'tanyabaptist05', 'bkadam357', 'manishashetye1295', 'abhishek.thavare', 'sardesai.kirti18', 'sammit1844', 'sanketsalvi03', 'sandesh29', 'bhavesh.singh', 'amritamukeshb', 'lakumveer', 'shakyanandk', 'ramaprde2296', 'rushabh.fegade', 'akashspawar148', 'cpatil152', 'abhishekm2861996', 'ritesh.parulekar231194', 'vishakha1805', 'dattaram.gawade781', None, 'sagarbhagat43', 'kaustubhgudekar9', 'prashant.baperkar', 'suman28pandit', 'rakeshmaity', 'rohanchavan', 'bimal.biswas8', 'ptrimukhe32']"
34,214,29,59,17,"['rahul1995', 'vaishnavi.sambrekar', 'divya.upalekar', 'tejasshinde8055', 'mervyn.fernandes', 'ashishmohite1996', 'ritesh.shukla', 'rutvij.supekar', 'johebshaikh', 'mudbidrijay', 'akshata.kulkarni', 'bhavesh.singh', 'bhavikashenoy95', 'neha.utekar2608', 'suraj.taigade', 'nehadingankar', 'mokshada']",11,"['rananeetika3', 'akashspawar148', 'eliasmagallanesjr17', 'cvvedesh', 'zkoyande', 'calvinl', 'chirag184', 'swati123', 'pragatinarnaware', 'anujakhose94', 'shrutisundar019']",42,"['purva.desai', 'ninad41195', 'nikhilgade', 'mugdha.dalvi', 'bhavesh3422', 'arvindlandge', 'anasnaik25', 'aniket187', 'ankurbhagwat8', 'harshal.dangat1', 'shraddhag', 'pathanabdulrazzak9524', 'krittikaranga', 'rajdeepd', 'nehasankeshi', 'kpiyushbhirud', 'shraddhad', 'vishaakn', 'abhishekg95', 'gujarathikshitij', 'shreyamath95', 'arpit32', 'abhishek1996', 'minal.patil', 'aeyjd', 'yashgumaste', 'lakhanmodani1811', 'simran123', 'pavitra.iyer', 'gsawant999', None, '22diptinikalje', 'patelu997', 'tejaschaudhary1996', 'lakshmi.nair', 'swapkaru123', 'saheli.konde', 'pathakrohan18', 'mananmehta7', 'geeta.kavitake', 'prachi.more', 'guptesoham95']",70,"['vaishnavi.sambrekar', 'eliasmagallanesjr17', 'ritesh.shukla', 'bhavesh3422', 'mugdha.dalvi', 'aniket187', 'ankurbhagwat8', 'harshal.dangat1', 'krittikaranga', 'rajdeepd', 'rananeetika3', 'shraddhad', 'abhishekg95', 'gujarathikshitij', 'cvvedesh', 'zkoyande', 'calvinl', 'neha.utekar2608', 'rahul1995', 'arpit32', 'abhishek1996', 'minal.patil', 'johebshaikh', 'lakhanmodani1811', 'simran123', '22diptinikalje', 'lakshmi.nair', 'rutvij.supekar', 'mudbidrijay', 'pathakrohan18', 'mananmehta7', 'chirag184', 'geeta.kavitake', 'swati123', 'suraj.taigade', 'nehasankeshi', 'shrutisundar019', 'divya.upalekar', 'purva.desai', 'mervyn.fernandes', 'ashishmohite1996', 'ninad41195', 'nikhilgade', 'arvindlandge', 'anasnaik25', 'anujakhose94', 'shraddhag', 'pathanabdulrazzak9524', 'kpiyushbhirud', 'vishaakn', 'tejasshinde8055', 'bhavesh.singh', 'bhavikashenoy95', 'shreyamath95', 'mokshada', 'akashspawar148', 'aeyjd', 'yashgumaste', 'pavitra.iyer', 'nehadingankar', 'pragatinarnaware', 'gsawant999', None, 'patelu997', 'tejaschaudhary1996', 'akshata.kulkarni', 'swapkaru123', 'saheli.konde', 'prachi.more', 'guptesoham95']"
34,40,29,30,1,['anujakhose94'],27,"['vaishnavi.sambrekar', 'divya.upalekar', 'mervyn.fernandes', 'ashishmohite1996', 'eliasmagallanesjr17', 'ritesh.shukla', 'rananeetika3', 'tejasshinde8055', 'cvvedesh', 'zkoyande', 'calvinl', 'bhavesh.singh', 'bhavikashenoy95', 'neha.utekar2608', 'mokshada', 'rahul1995', 'akashspawar148', 'johebshaikh', 'nehadingankar', 'pragatinarnaware', 'rutvij.supekar', 'mudbidrijay', 'akshata.kulkarni', 'chirag184', 'swati123', 'suraj.taigade', 'shrutisundar019']",29,"['mukulsathe1995', 'bondreanup007', 'tanyabaptist05', 'a.j.yadav2395', 'hbg2112', 'anasnaik25', 'shriya.h.joshi', 'akshaybadhiye04', 'iabhishek555', 'sanketsalvi03', 'shreyamath95', 'shakyanandk', 'arpit32', 'parmitbanga1995', 'shraddha0306', 'ritesh.parulekar231194', 'vaibhavghare94', 'neilmundhe', 'heramb10', 'sagarpawar', None, 'sebastian007', 'smonica498', 'prajaktachapte2', 'patelu997', 'prp23dec', 'mohiteashwin7', 'mapethe', 'ratsthegreat']",57,"['mukulsathe1995', 'vaishnavi.sambrekar', 'divya.upalekar', 'mervyn.fernandes', 'ashishmohite1996', 'eliasmagallanesjr17', 'ritesh.shukla', 'bondreanup007', 'tanyabaptist05', 'a.j.yadav2395', 'hbg2112', 'anasnaik25', 'shriya.h.joshi', 'anujakhose94', 'akshaybadhiye04', 'rananeetika3', 'iabhishek555', 'tejasshinde8055', 'cvvedesh', 'zkoyande', 'sanketsalvi03', 'calvinl', 'bhavesh.singh', 'bhavikashenoy95', 'neha.utekar2608', 'shreyamath95', 'mokshada', 'shakyanandk', 'rahul1995', 'arpit32', 'parmitbanga1995', 'akashspawar148', 'shraddha0306', 'johebshaikh', 'ritesh.parulekar231194', 'vaibhavghare94', 'neilmundhe', 'heramb10', 'nehadingankar', 'pragatinarnaware', 'sagarpawar', None, 'sebastian007', 'smonica498', 'prajaktachapte2', 'patelu997', 'rutvij.supekar', 'mudbidrijay', 'akshata.kulkarni', 'prp23dec', 'mohiteashwin7', 'chirag184', 'mapethe', 'swati123', 'suraj.taigade', 'shrutisundar019', 'ratsthegreat']"
34,52,29,17,2,"['calvinl', 'eliasmagallanesjr17']",26,"['vaishnavi.sambrekar', 'divya.upalekar', 'mervyn.fernandes', 'ashishmohite1996', 'ritesh.shukla', 'anujakhose94', 'rananeetika3', 'tejasshinde8055', 'cvvedesh', 'zkoyande', 'bhavesh.singh', 'bhavikashenoy95', 'neha.utekar2608', 'mokshada', 'rahul1995', 'akashspawar148', 'johebshaikh', 'pragatinarnaware', 'nehadingankar', 'rutvij.supekar', 'mudbidrijay', 'akshata.kulkarni', 'chirag184', 'swati123', 'suraj.taigade', 'shrutisundar019']",15,"['helmin50469', 'ctamma', 'mchakkalamuri', 'ndp732', 'm.janik1031', 'jonathantripi', 'strikerfv68', 'evanmartin', 'walden95', 'jcastrocalvo', 'myuk83', 'nickcrane6117', None, 'tomwentworth', 'cnconnery']",43,"['vaishnavi.sambrekar', 'ndp732', 'divya.upalekar', 'mervyn.fernandes', 'ashishmohite1996', 'eliasmagallanesjr17', 'ritesh.shukla', 'strikerfv68', 'evanmartin', 'anujakhose94', 'rananeetika3', 'ctamma', 'tejasshinde8055', 'cvvedesh', 'zkoyande', 'jonathantripi', 'calvinl', 'bhavesh.singh', 'bhavikashenoy95', 'neha.utekar2608', 'walden95', 'jcastrocalvo', 'nickcrane6117', 'mokshada', 'tomwentworth', 'rahul1995', 'akashspawar148', 'm.janik1031', 'johebshaikh', 'myuk83', 'nehadingankar', 'pragatinarnaware', None, 'mchakkalamuri', 'helmin50469', 'rutvij.supekar', 'mudbidrijay', 'akshata.kulkarni', 'chirag184', 'swati123', 'suraj.taigade', 'shrutisundar019', 'cnconnery']"
34,53,29,14,2,"['calvinl', 'eliasmagallanesjr17']",26,"['vaishnavi.sambrekar', 'divya.upalekar', 'mervyn.fernandes', 'ashishmohite1996', 'ritesh.shukla', 'anujakhose94', 'rananeetika3', 'tejasshinde8055', 'cvvedesh', 'zkoyande', 'bhavesh.singh', 'bhavikashenoy95', 'neha.utekar2608', 'mokshada', 'rahul1995', 'akashspawar148', 'johebshaikh', 'pragatinarnaware', 'nehadingankar', 'rutvij.supekar', 'mudbidrijay', 'akshata.kulkarni', 'chirag184', 'swati123', 'suraj.taigade', 'shrutisundar019']",12,"['mchakkalamuri', 'helmin50469', 'ndp732', 'm.janik1031', 'jonathantripi', 'walden95', 'jcastrocalvo', 'myuk83', 'nickcrane6117', None, 'tomwentworth', 'cnconnery']",40,"['vaishnavi.sambrekar', 'ndp732', 'divya.upalekar', 'mervyn.fernandes', 'ashishmohite1996', 'eliasmagallanesjr17', 'ritesh.shukla', 'anujakhose94', 'rananeetika3', 'tejasshinde8055', 'cvvedesh', 'zkoyande', 'jonathantripi', 'calvinl', 'bhavesh.singh', 'bhavikashenoy95', 'neha.utekar2608', 'walden95', 'jcastrocalvo', 'nickcrane6117', 'mokshada', 'tomwentworth', 'rahul1995', 'akashspawar148', 'm.janik1031', 'johebshaikh', 'myuk83', 'nehadingankar', 'pragatinarnaware', None, 'helmin50469', 'mchakkalamuri', 'rutvij.supekar', 'mudbidrijay', 'akshata.kulkarni', 'chirag184', 'swati123', 'suraj.taigade', 'shrutisundar019', 'cnconnery']"
34,212,29,8,2,"['shrutisundar019', 'swati123']",26,"['vaishnavi.sambrekar', 'divya.upalekar', 'mervyn.fernandes', 'ashishmohite1996', 'eliasmagallanesjr17', 'ritesh.shukla', 'anujakhose94', 'rananeetika3', 'tejasshinde8055', 'cvvedesh', 'zkoyande', 'calvinl', 'bhavesh.singh', 'bhavikashenoy95', 'neha.utekar2608', 'mokshada', 'rahul1995', 'akashspawar148', 'johebshaikh', 'nehadingankar', 'pragatinarnaware', 'rutvij.supekar', 'mudbidrijay', 'akshata.kulkarni', 'chirag184', 'suraj.taigade']",6,"['ashwini12rajput', 'crmalgundkar', 'umesh897', 'aniket2602', 'aniketkadale', None]",34,"['rahul1995', 'vaishnavi.sambrekar', 'divya.upalekar', 'akashspawar148', 'mervyn.fernandes', 'ashishmohite1996', 'eliasmagallanesjr17', 'ritesh.shukla', 'johebshaikh', 'nehadingankar', 'pragatinarnaware', 'anujakhose94', 'aniketkadale', None, 'rananeetika3', 'ashwini12rajput', 'tejasshinde8055', 'rutvij.supekar', 'mudbidrijay', 'akshata.kulkarni', 'cvvedesh', 'zkoyande', 'calvinl', 'bhavesh.singh', 'bhavikashenoy95', 'chirag184', 'neha.utekar2608', 'swati123', 'crmalgundkar', 'suraj.taigade', 'umesh897', 'aniket2602', 'shrutisundar019', 'mokshada']"
34,213,29,8,6,"['tejasshinde8055', 'cvvedesh', 'zkoyande', 'bhavikashenoy95', 'chirag184', 'anujakhose94']",22,"['vaishnavi.sambrekar', 'divya.upalekar', 'mervyn.fernandes', 'ashishmohite1996', 'eliasmagallanesjr17', 'ritesh.shukla', 'rananeetika3', 'calvinl', 'bhavesh.singh', 'neha.utekar2608', 'mokshada', 'rahul1995', 'akashspawar148', 'johebshaikh', 'pragatinarnaware', 'nehadingankar', 'rutvij.supekar', 'mudbidrijay', 'akshata.kulkarni', 'swati123', 'suraj.taigade', 'shrutisundar019']",2,"['gsawant999', None]",30,"['rahul1995', 'vaishnavi.sambrekar', 'divya.upalekar', 'akashspawar148', 'mervyn.fernandes', 'ashishmohite1996', 'eliasmagallanesjr17', 'ritesh.shukla', 'johebshaikh', 'nehadingankar', 'pragatinarnaware', 'anujakhose94', 'gsawant999', None, 'rananeetika3', 'tejasshinde8055', 'rutvij.supekar', 'mudbidrijay', 'akshata.kulkarni', 'cvvedesh', 'zkoyande', 'calvinl', 'bhavesh.singh', 'bhavikashenoy95', 'chirag184', 'neha.utekar2608', 'swati123', 'suraj.taigade', 'shrutisundar019', 'mokshada']"
34,55,29,7,1,['mervyn.fernandes'],27,"['vaishnavi.sambrekar', 'divya.upalekar', 'ashishmohite1996', 'eliasmagallanesjr17', 'ritesh.shukla', 'anujakhose94', 'rananeetika3', 'tejasshinde8055', 'cvvedesh', 'zkoyande', 'calvinl', 'bhavesh.singh', 'bhavikashenoy95', 'neha.utekar2608', 'mokshada', 'rahul1995', 'akashspawar148', 'johebshaikh', 'nehadingankar', 'pragatinarnaware', 'rutvij.supekar', 'mudbidrijay', 'akshata.kulkarni', 'chirag184', 'swati123', 'suraj.taigade', 'shrutisundar019']",6,"['ishaan.sathe', 'tejashree.gore', 'shukla.pawan249', None, 'somil910', 'pyami95']",34,"['rahul1995', 'vaishnavi.sambrekar', 'divya.upalekar', 'akashspawar148', 'mervyn.fernandes', 'ashishmohite1996', 'eliasmagallanesjr17', 'ritesh.shukla', 'johebshaikh', 'nehadingankar', 'pragatinarnaware', 'anujakhose94', None, 'rananeetika3', 'tejasshinde8055', 'rutvij.supekar', 'mudbidrijay', 'akshata.kulkarni', 'pyami95', 'cvvedesh', 'zkoyande', 'calvinl', 'bhavesh.singh', 'bhavikashenoy95', 'chirag184', 'neha.utekar2608', 'swati123', 'ishaan.sathe', 'suraj.taigade', 'tejashree.gore', 'shukla.pawan249', 'somil910', 'shrutisundar019', 'mokshada']"
34,211,29,6,5,"['rananeetika3', 'cvvedesh', 'zkoyande', 'chirag184', 'anujakhose94']",23,"['rahul1995', 'vaishnavi.sambrekar', 'divya.upalekar', 'akashspawar148', 'mervyn.fernandes', 'ashishmohite1996', 'eliasmagallanesjr17', 'ritesh.shukla', 'johebshaikh', 'nehadingankar', 'pragatinarnaware', 'tejasshinde8055', 'rutvij.supekar', 'mudbidrijay', 'akshata.kulkarni', 'calvinl', 'bhavesh.singh', 'bhavikashenoy95', 'neha.utekar2608', 'swati123', 'suraj.taigade', 'shrutisundar019', 'mokshada']",1,[None],29,"['rahul1995', 'vaishnavi.sambrekar', 'divya.upalekar', 'akashspawar148', 'mervyn.fernandes', 'ashishmohite1996', 'eliasmagallanesjr17', 'ritesh.shukla', 'johebshaikh', 'nehadingankar', 'pragatinarnaware', 'anujakhose94', None, 'rananeetika3', 'tejasshinde8055', 'rutvij.supekar', 'mudbidrijay', 'akshata.kulkarni', 'cvvedesh', 'zkoyande', 'calvinl', 'bhavesh.singh', 'bhavikashenoy95', 'chirag184', 'neha.utekar2608', 'swati123', 'suraj.taigade', 'shrutisundar019', 'mokshada']"
35,303,29,23,19,"['jordanvandegrift', 'jacobstein22ee', 'kinneybradh', 'lucasnukayahead', 'festivarian', 'stevejohns', 'jennidomski', 'scottbrown7', 'alineelquist', 'megbern', 'aaronbartz', 'carterwarren12', 'teamreidy', 'johnpaulstroud', 'rhunt', 'ktakkis', 'alexrbenz', 'bknowlton', 'daniellenichols']",9,"['spahng', 'damonsisk', 'thiago_natalrn', 'simon163zlin', 'irfandiv22', 'ng13', 'guoluan87', 'marian1999grig', 'kalirajan']",4,"['mitchellleibowitz', None, 'twinklepandhi', 'lanlibsu']",32,"['jordanvandegrift', 'jacobstein22ee', 'kinneybradh', 'lucasnukayahead', 'irfandiv22', 'guoluan87', 'festivarian', 'lanlibsu', 'stevejohns', 'damonsisk', 'alineelquist', 'scottbrown7', 'jennidomski', 'megbern', 'carterwarren12', 'aaronbartz', 'teamreidy', 'mitchellleibowitz', 'marian1999grig', 'spahng', 'simon163zlin', 'johnpaulstroud', None, 'rhunt', 'thiago_natalrn', 'ktakkis', 'alexrbenz', 'bknowlton', 'daniellenichols', 'ng13', 'kalirajan', 'twinklepandhi']"
35,305,29,8,1,['spahng'],27,"['jordanvandegrift', 'jacobstein22ee', 'kinneybradh', 'lucasnukayahead', 'irfandiv22', 'guoluan87', 'festivarian', 'stevejohns', 'damonsisk', 'alineelquist', 'scottbrown7', 'jennidomski', 'megbern', 'aaronbartz', 'carterwarren12', 'teamreidy', 'marian1999grig', 'simon163zlin', 'johnpaulstroud', 'rhunt', 'thiago_natalrn', 'ktakkis', 'alexrbenz', 'bknowlton', 'daniellenichols', 'ng13', 'kalirajan']",7,"['li.yue', 'niko1028', 'yuanzi11s', 'yvonneoafriyie', 'zhangyz0216', None, 'che16']",35,"['spahng', 'jordanvandegrift', 'jacobstein22ee', 'li.yue', 'kinneybradh', 'lucasnukayahead', 'yuanzi11s', 'simon163zlin', 'yvonneoafriyie', 'irfandiv22', 'carterwarren12', 'guoluan87', 'festivarian', 'johnpaulstroud', None, 'rhunt', 'zhangyz0216', 'stevejohns', 'damonsisk', 'alineelquist', 'scottbrown7', 'jennidomski', 'thiago_natalrn', 'niko1028', 'ktakkis', 'alexrbenz', 'bknowlton', 'megbern', 'aaronbartz', 'daniellenichols', 'teamreidy', 'ng13', 'marian1999grig', 'kalirajan', 'che16']"
36,64,28,42,27,"['kstaton6', 'bbosley', 'webera', 'jihkim23', 'perlargarcia99', 'krea', 'juliedsilvers', 'egk818', 'chris5175', 'jarebmendez', 'jabier41', 'danielclayton0', 'kolek', 'awcolumbie', 'xxlancet', 'mltillman', 'vhabic16', 'tpank', 'crsileo', 'yelnamdivad92', 'pbouyounes', 'insua86', 'vdubinin2', 'cam.jackson', 'jaredhines', 'stevenjwilliams', 'vpirie']",0,[],15,"['jjacobsen6', 'sten621', 'cheuser', 'ukarell001', 'eugenesg1ddin', 'fengshui', 'ulisses.k22', 'suresh7', 'rbillings', 'megan0529', 'andrew_lemx', 'guoj', None, 'pgarcia1999', 'bfieldson']",42,"['bbosley', 'webera', 'jihkim23', 'perlargarcia99', 'egk818', 'danielclayton0', 'guoj', 'mltillman', 'vhabic16', 'bfieldson', 'ukarell001', 'eugenesg1ddin', 'insua86', 'jaredhines', 'sten621', 'cheuser', 'vpirie', 'jjacobsen6', 'kstaton6', 'ulisses.k22', 'suresh7', 'megan0529', 'krea', 'pgarcia1999', 'juliedsilvers', 'chris5175', 'jarebmendez', 'jabier41', 'andrew_lemx', 'kolek', 'awcolumbie', 'xxlancet', 'tpank', 'crsileo', 'yelnamdivad92', 'pbouyounes', None, 'vdubinin2', 'cam.jackson', 'stevenjwilliams', 'fengshui', 'rbillings']"
36,175,28,35,25,"['kstaton6', 'bbosley', 'webera', 'jihkim23', 'perlargarcia99', 'krea', 'juliedsilvers', 'egk818', 'chris5175', 'jabier41', 'danielclayton0', 'awcolumbie', 'xxlancet', 'mltillman', 'vhabic16', 'tpank', 'crsileo', 'yelnamdivad92', 'pbouyounes', 'insua86', 'vdubinin2', 'cam.jackson', 'jaredhines', 'stevenjwilliams', 'vpirie']",2,"['jarebmendez', 'kolek']",10,"['ukarell001', 'jej1994', 'fengshui', 'rbillings', 'megan0529', 'andrew_lemx', 'ssookraj', None, 'pgarcia1999', 'carlosniko']",37,"['kstaton6', 'bbosley', 'webera', 'megan0529', 'jihkim23', 'perlargarcia99', 'krea', 'pgarcia1999', 'juliedsilvers', 'egk818', 'jej1994', 'chris5175', 'jarebmendez', 'jabier41', 'danielclayton0', 'andrew_lemx', 'kolek', 'awcolumbie', 'xxlancet', 'mltillman', 'vhabic16', 'tpank', 'crsileo', 'ukarell001', 'yelnamdivad92', 'pbouyounes', 'ssookraj', 'insua86', 'carlosniko', None, 'vdubinin2', 'cam.jackson', 'jaredhines', 'stevenjwilliams', 'fengshui', 'vpirie', 'rbillings']"
36,275,28,34,26,"['kstaton6', 'bbosley', 'webera', 'jihkim23', 'krea', 'juliedsilvers', 'egk818', 'chris5175', 'jarebmendez', 'jabier41', 'danielclayton0', 'kolek', 'awcolumbie', 'xxlancet', 'mltillman', 'vhabic16', 'tpank', 'crsileo', 'yelnamdivad92', 'pbouyounes', 'insua86', 'vdubinin2', 'cam.jackson', 'jaredhines', 'stevenjwilliams', 'vpirie']",1,['perlargarcia99'],8,"['cheuser', 'eugenesg1ddin', 'jej1994', 'ulisses.k22', 'suresh7', 'rbillings', 'megan_0529', None]",35,"['kstaton6', 'bbosley', 'ulisses.k22', 'suresh7', 'webera', 'megan_0529', 'jihkim23', 'perlargarcia99', 'krea', 'juliedsilvers', 'egk818', 'jej1994', 'chris5175', 'jarebmendez', 'jabier41', 'danielclayton0', 'kolek', 'awcolumbie', 'xxlancet', 'mltillman', 'vhabic16', 'tpank', 'crsileo', 'eugenesg1ddin', 'yelnamdivad92', 'pbouyounes', 'insua86', None, 'vdubinin2', 'cam.jackson', 'jaredhines', 'cheuser', 'stevenjwilliams', 'vpirie', 'rbillings']"
37,24,24,102,20,"['sgu20121541', 'sgu20121546', 'sgu20141467', 'sgug20160008', 'road', 'sgu20111478', 'sgu20121540', 'sgu20111505', 'sgu20121451', 'sgu20121526', 'sgu20121465', 'sgu20141426', 'dogp27', 'gugusj', 'sgu20121507', 'sgu20111577', 'sgu20121450', 'sgu20141482', 'sgu20102047', 'thenopi10']",3,"['sgu20121517', 'p.geminisiva1998', 'sgu20111493']",82,"['lsh0307', 'dudxo9273', 'dongjin225', 'hhnn1229', 'sks911017', 'kimjunsu112', 'gwoo7057', 'mrlee', 'cyc2490', 'tjrwodl2000', 'jangsungin', 'pisces9231', 'qkrwhdgkr', 'kan7470', 'bluegil92', 'skzl34', 'nnoonn4488', 'mygime92', 'jwh0114', 'carjehee', 'jkorad2843', 'ghghrkdlgh', 'sdy9333', 'dbrhksan88', 'rnfnqnfn', 'sgu20121479', 'sgu20131480', 'wjdgns22222', 'sgu20121514', 'sicpan12', 'woghks927', 'awdwadw12341', 'bonghyuk', 'kdj406', 'k910716kim', 'kym1122', 'dlrjswo', 'noon486', 'akstn34', 'fredhan89', 'gkakfhdlem', 'sgu20111450', 'jsa6580', 'krleesd92', 'sgu20121469', 'qkdgywp', 'shoho214', 'bbbty6064', 'noon48', 'parkchanwoo7', 'bbbty60', 'drog0311', 'vhwkd308', 'kigg1124', 'hun0307', 'lilydh511', 'mrcsm200', 'kshbig0425', 'whj1130', 'whq456', 'kissheyo1004', 'gohny0115', 'sgu20111399', 'dangshiggy', 'ccjswlgh', 'gordius92', 'tksfoqlt', 'ghdud0351', 'sjg1779', 'lkm9200', 'injahgi', 'm109a6', 'box1916', None, 'angyi90', 'oyj95', 'poby', 'honnyou', 'kiddyu1991', 'dnlwd09', 'jjo2824', 'sgu20101328']",105,"['lsh0307', 'dudxo9273', 'sgu20141467', 'dongjin225', 'hhnn1229', 'sks911017', 'kimjunsu112', 'gwoo7057', 'p.geminisiva1998', 'mrlee', 'cyc2490', 'tjrwodl2000', 'jangsungin', 'pisces9231', 'qkrwhdgkr', 'kan7470', 'bluegil92', 'skzl34', 'nnoonn4488', 'mygime92', 'sgu20111505', 'sgu20121451', 'jwh0114', 'carjehee', 'jkorad2843', 'ghghrkdlgh', 'sdy9333', 'dbrhksan88', 'rnfnqnfn', 'sgu20121479', 'sgu20121526', 'sgu20131480', 'sgu20121465', 'wjdgns22222', 'sgu20141426', 'sgu20121514', 'sicpan12', 'woghks927', 'awdwadw12341', 'bonghyuk', 'kdj406', 'k910716kim', 'kym1122', 'sgu20111577', 'dlrjswo', 'sgu20111493', 'noon486', 'akstn34', 'sgu20121450', 'fredhan89', 'gkakfhdlem', 'sgu20111450', 'jsa6580', 'krleesd92', 'sgu20121469', 'sgu20121541', 'qkdgywp', 'sgu20121546', 'shoho214', 'bbbty6064', 'noon48', 'parkchanwoo7', 'bbbty60', 'drog0311', 'vhwkd308', 'sgug20160008', 'kigg1124', 'hun0307', 'lilydh511', 'mrcsm200', 'kshbig0425', 'whj1130', 'whq456', 'kissheyo1004', 'gohny0115', 'sgu20111399', 'road', 'sgu20111478', 'dangshiggy', 'ccjswlgh', 'sgu20121540', 'gordius92', 'tksfoqlt', 'ghdud0351', 'sjg1779', 'lkm9200', 'injahgi', 'dogp27', 'm109a6', 'sgu20121507', 'gugusj', 'box1916', None, 'angyi90', 'oyj95', 'poby', 'honnyou', 'kiddyu1991', 'sgu20141482', 'sgu20102047', 'dnlwd09', 'sgu20121517', 'thenopi10', 'jjo2824', 'sgu20101328']"
37,12,24,93,1,['p.geminisiva1998'],22,"['sgu20121541', 'sgu20121546', 'sgu20141467', 'sgug20160008', 'road', 'sgu20111478', 'sgu20121540', 'sgu20111505', 'sgu20121451', 'sgu20121526', 'sgu20121465', 'sgu20141426', 'dogp27', 'gugusj', 'sgu20121507', 'sgu20111577', 'sgu20111493', 'sgu20121450', 'sgu20141482', 'sgu20102047', 'sgu20121517', 'thenopi10']",92,"['sarath31', 'deep16', 'kgoel', 'ksai0378', 'anirudhrachamalla', 'rajeswarim81', 'rko2saurav', 'antroy.rc', 'vineethvinny1997', 'sairohith', 'pkrishnapritish', 'kumarvineeth14', 'saivineethkumar', 'parag.ydv23', 'sumit53', 'dipanjandas1996', 'dishankyadav96', 'harshit.roy30014', 'sumitarya1310', 'amruthamma1998', 'balu8108', 'anirudhaga', 'kunalkhadke97', 'nirajj100', 'muralikorada55', 'nupurbhaisare24', 'rushee2911', 'sim_ks', 'sameer786007', 'hardikagrawal545', 'anjanmandal58', 'satakarni_amirneni', 'sittun.swayam', 'shubhra_19', 'evineeth97', 'sayantan2502iitkgp', 'xybiju', 'charankoushik', 'asif123', 'kandalavamshi111', 'sreevardhan25', 'saranyu', 'askarmakar07', 'rayudhajit', '2209sandeep', 'yuvsamratuday1997', 'siripranitha', 'swarnabha1997', 'rohitrajeev128', 'abinashsena', 'hemanth297', 'kaustav1407', 'arijitmandal1994', 'gopa_97', 'vickygood15', 'rajdeep.biswas2010', 'anushreedavbhagalpur', 'avinabsaha2018', 'kk55singh', 'ram2606', 'joshuapeterebenezer', 'ankitkp4056', 'nagapradeep97', 'arunganesh', 'shanmukh17', 'deepthireddyparvatham12', 'ray_arka', 'prudvi1258', 'revanthreddy207', 'sid89014', 'beena11', 'rakesh207', 'rahulkr.1531', 'niharika25', 'kagitanikhil', 'sudzsharma', 'tummalabalakrishna48', 'nikhiliated', 'chaitanypaikara', 'shanka', 'abhi1singh2', 'mriganksh', 'shravanisistla1998', 'lovkeshrishab', 'keerthana_bhogi', 'abhi123', None, 'kalyan4112', 'nitinkush16', 'acabhi07', 'mayankpalaria', 'manishasa']",115,"['hemanth297', 'kaustav1407', 'sarath31', 'arijitmandal1994', 'deep16', 'sgu20141467', 'gopa_97', 'kgoel', 'ksai0378', 'p.geminisiva1998', 'anirudhrachamalla', 'vickygood15', 'rajeswarim81', 'rko2saurav', 'rajdeep.biswas2010', 'mayankpalaria', 'anushreedavbhagalpur', 'antroy.rc', 'vineethvinny1997', 'sairohith', 'pkrishnapritish', 'avinabsaha2018', 'kumarvineeth14', 'kk55singh', 'saivineethkumar', 'ram2606', 'sgu20111505', 'sgu20121451', 'parag.ydv23', 'sumit53', 'dipanjandas1996', 'joshuapeterebenezer', 'sgu20121526', 'dishankyadav96', 'sgu20121465', 'sgu20141426', 'harshit.roy30014', 'ankitkp4056', 'sumitarya1310', 'nagapradeep97', 'amruthamma1998', 'arunganesh', 'sgu20111577', 'shanmukh17', 'deepthireddyparvatham12', 'sgu20111493', 'sgu20121450', 'ray_arka', 'prudvi1258', 'balu8108', 'revanthreddy207', 'anirudhaga', 'sgu20121541', 'sid89014', 'kunalkhadke97', 'sgu20121546', 'beena11', 'rakesh207', 'nirajj100', 'muralikorada55', 'nupurbhaisare24', 'rahulkr.1531', 'niharika25', 'rushee2911', 'kagitanikhil', 'sim_ks', 'sudzsharma', 'tummalabalakrishna48', 'sgug20160008', 'sameer786007', 'hardikagrawal545', 'anjanmandal58', 'nikhiliated', 'satakarni_amirneni', 'chaitanypaikara', 'sittun.swayam', 'shanka', 'shubhra_19', 'road', 'sgu20111478', 'abhi1singh2', 'evineeth97', 'sgu20121540', 'sayantan2502iitkgp', 'xybiju', 'charankoushik', 'asif123', 'mriganksh', 'shravanisistla1998', 'lovkeshrishab', 'keerthana_bhogi', 'abhi123', 'kandalavamshi111', 'dogp27', 'sreevardhan25', 'sgu20121507', 'gugusj', 'saranyu', None, 'askarmakar07', 'rayudhajit', '2209sandeep', 'yuvsamratuday1997', 'siripranitha', 'kalyan4112', 'nitinkush16', 'sgu20141482', 'acabhi07', 'swarnabha1997', 'sgu20102047', 'sgu20121517', 'rohitrajeev128', 'thenopi10', 'manishasa', 'abinashsena']"
37,17,24,54,1,['p.geminisiva1998'],22,"['sgu20121541', 'sgu20121546', 'sgu20141467', 'sgug20160008', 'road', 'sgu20111478', 'sgu20121540', 'sgu20111505', 'sgu20121451', 'sgu20121526', 'sgu20121465', 'sgu20141426', 'dogp27', 'gugusj', 'sgu20121507', 'sgu20111577', 'sgu20111493', 'sgu20121450', 'sgu20141482', 'sgu20102047', 'sgu20121517', 'thenopi10']",53,"['anirudhaga', 'hemanth297', 'surya.veeragani7', 'kunalkhadke97', 'beena11', 'nivedprakash1996', 'rakesh207', 'arijitmandal1994', 'nirajj100', 'deep16', 'muralikorada55', 'srinivasramkumar', 'niharika25', 'gopa_97', 'kagitanikhil', 'sim_ks', 'tummalabalakrishna48', 'rajeswarim81', 'rajdeep.biswas2010', 'revanthreddy207', 'antroy.rc', 'anjanmandal58', 'pourushsood', 'satakarni_amirneni', 'avinabsaha2018', 'pkrishnapritish', 'sittun.swayam', 'shanka', 'kumarvineeth14', 'kk55singh', 'xybiju', 'saivineethkumar', 'charankoushik', 'mriganksh', 'shravanisistla1998', 'dipanjandas1996', 'keerthana_bhogi', 'joshuapeterebenezer', 'kandalavamshi111', 'harshit.roy30014', 'ankitkp4056', 'sreevardhan25', 'saranyu', None, 'rayudhajit', 'arunganesh', 'deepthireddyparvatham12', 'yuvsamratuday1997', 'nitinkush16', 'ray_arka', 'mayankpalaria', 'prudvi1258', 'abinashsena']",76,"['hemanth297', 'nivedprakash1996', 'arijitmandal1994', 'deep16', 'sgu20141467', 'gopa_97', 'p.geminisiva1998', 'rajeswarim81', 'rajdeep.biswas2010', 'antroy.rc', 'pourushsood', 'avinabsaha2018', 'pkrishnapritish', 'kumarvineeth14', 'kk55singh', 'saivineethkumar', 'sgu20111505', 'sgu20121451', 'dipanjandas1996', 'joshuapeterebenezer', 'sgu20121526', 'sgu20121465', 'sgu20141426', 'harshit.roy30014', 'ankitkp4056', 'arunganesh', 'sgu20111577', 'deepthireddyparvatham12', 'sgu20111493', 'sgu20121450', 'ray_arka', 'prudvi1258', 'surya.veeragani7', 'revanthreddy207', 'anirudhaga', 'sgu20121541', 'kunalkhadke97', 'sgu20121546', 'beena11', 'rakesh207', 'nirajj100', 'muralikorada55', 'srinivasramkumar', 'niharika25', 'kagitanikhil', 'sim_ks', 'tummalabalakrishna48', 'sgug20160008', 'anjanmandal58', 'satakarni_amirneni', 'sittun.swayam', 'shanka', 'road', 'sgu20111478', 'sgu20121540', 'xybiju', 'charankoushik', 'mriganksh', 'shravanisistla1998', 'keerthana_bhogi', 'kandalavamshi111', 'dogp27', 'sreevardhan25', 'sgu20121507', 'gugusj', 'saranyu', None, 'rayudhajit', 'yuvsamratuday1997', 'nitinkush16', 'sgu20141482', 'mayankpalaria', 'sgu20102047', 'sgu20121517', 'thenopi10', 'abinashsena']"
37,21,24,40,21,"['sgu20121541', 'sgu20121546', 'sgu20141467', 'road', 'sgu20111478', 'sgu20121540', 'sgu20111505', 'sgu20121451', 'sgu20121526', 'sgu20121465', 'sgu20141426', 'dogp27', 'gugusj', 'sgu20121507', 'sgu20111577', 'sgu20111493', 'sgu20121450', 'sgu20141482', 'sgu20102047', 'sgu20121517', 'thenopi10']",2,"['p.geminisiva1998', 'sgug20160008']",19,"['vhwkd308', 'whj1130', 'sgu20111399', 'ccjswlgh', 'dangshiggy', 'kan7470', 'sgu20121484', 'jwh0114', 'carjehee', 'ghghrkdlgh', 'rnfnqnfn', 'sgu20131480', None, 'poby', 'k910716kim', 'honnyou', 'sgu20141447', 'krleesd92', 'sgu20101328']",42,"['sgu20121541', 'sgu20121546', 'sgu20141467', 'vhwkd308', 'p.geminisiva1998', 'sgug20160008', 'whj1130', 'sgu20111399', 'road', 'sgu20111478', 'ccjswlgh', 'dangshiggy', 'kan7470', 'sgu20121540', 'sgu20121484', 'sgu20111505', 'sgu20121451', 'carjehee', 'ghghrkdlgh', 'jwh0114', 'rnfnqnfn', 'sgu20121526', 'sgu20131480', 'sgu20121465', 'sgu20141426', 'dogp27', 'sgu20121507', 'gugusj', None, 'poby', 'k910716kim', 'honnyou', 'sgu20111577', 'sgu20111493', 'sgu20121450', 'sgu20141482', 'sgu20141447', 'krleesd92', 'sgu20102047', 'sgu20121517', 'thenopi10', 'sgu20101328']"
37,11,24,35,22,"['sgu20121541', 'sgu20121546', 'sgu20141467', 'sgug20160008', 'road', 'sgu20111478', 'sgu20121540', 'sgu20111505', 'sgu20121451', 'sgu20121526', 'sgu20121465', 'sgu20141426', 'dogp27', 'gugusj', 'sgu20121507', 'sgu20111577', 'sgu20111493', 'sgu20121450', 'sgu20141482', 'sgu20102047', 'sgu20121517', 'thenopi10']",1,['p.geminisiva1998'],13,"['sgu20121442', 'high_sky_up', 'sgu20131480', 'sgu20131438', 'sgu20111399', 'guheak92', 'sgu20111450', 'sgu20141447', 'sgu20121467', None, 'sgu20121484', 'sgu20121469', 'carjehee']",36,"['sgu20121541', 'sgu20121442', 'sgu20121546', 'sgu20131438', 'sgu20141467', 'p.geminisiva1998', 'sgug20160008', 'sgu20111399', 'road', 'sgu20111478', 'sgu20121540', 'sgu20121484', 'sgu20111505', 'sgu20121451', 'carjehee', 'high_sky_up', 'sgu20121526', 'sgu20131480', 'sgu20121465', 'sgu20141426', 'sgu20121467', 'guheak92', 'dogp27', 'sgu20121507', 'gugusj', None, 'sgu20111577', 'sgu20111493', 'sgu20121450', 'sgu20141482', 'sgu20111450', 'sgu20141447', 'sgu20102047', 'sgu20121517', 'thenopi10', 'sgu20121469']"
37,13,24,31,1,['p.geminisiva1998'],22,"['sgu20121541', 'sgu20121546', 'sgu20141467', 'sgug20160008', 'road', 'sgu20111478', 'sgu20121540', 'sgu20111505', 'sgu20121451', 'sgu20121526', 'sgu20121465', 'sgu20141426', 'dogp27', 'gugusj', 'sgu20121507', 'sgu20111577', 'sgu20111493', 'sgu20121450', 'sgu20141482', 'sgu20102047', 'sgu20121517', 'thenopi10']",30,"['anirudhaga', 'hemanth297', 'harsh12041997', 'nivedprakash1996', 'muralikorada55', 'deep16', 'rsagrawal.avanti', 'rahulkr.1531', 'tummalabalakrishna48', 'rajdeep.biswas2010', 'antroy.rc', 'pourushsood', 'sairohith', 'pkrishnapritish', 'shubhra_19', 'ram2606', 'charankoushik', 'shravanisistla1998', 'keerthana_bhogi', 'abhi123', 'kandalavamshi111', 'saranyu', None, 'bharat123', 'shanmukh17', 'deepthireddyparvatham12', 'swarnabha1997', 'nitinkush16', 'ray_arka', 'mayankpalaria']",53,"['anirudhaga', 'sgu20121541', 'hemanth297', 'harsh12041997', 'sgu20121546', 'nivedprakash1996', 'muralikorada55', 'deep16', 'rsagrawal.avanti', 'sgu20141467', 'rahulkr.1531', 'p.geminisiva1998', 'tummalabalakrishna48', 'sgug20160008', 'rajdeep.biswas2010', 'antroy.rc', 'pourushsood', 'sairohith', 'pkrishnapritish', 'shubhra_19', 'road', 'sgu20111478', 'sgu20121540', 'ram2606', 'sgu20111505', 'sgu20121451', 'charankoushik', 'shravanisistla1998', 'keerthana_bhogi', 'sgu20121526', 'abhi123', 'sgu20121465', 'kandalavamshi111', 'sgu20141426', 'dogp27', 'sgu20121507', 'gugusj', 'saranyu', None, 'bharat123', 'sgu20111577', 'shanmukh17', 'deepthireddyparvatham12', 'sgu20111493', 'swarnabha1997', 'nitinkush16', 'sgu20121450', 'sgu20141482', 'ray_arka', 'mayankpalaria', 'sgu20102047', 'sgu20121517', 'thenopi10']"
37,16,24,29,21,"['sgu20121541', 'sgu20121546', 'sgu20141467', 'sgug20160008', 'road', 'sgu20111478', 'sgu20121540', 'sgu20111505', 'sgu20121451', 'sgu20121526', 'sgu20121465', 'sgu20141426', 'dogp27', 'gugusj', 'sgu20111577', 'sgu20111493', 'sgu20121450', 'sgu20141482', 'sgu20102047', 'sgu20121517', 'thenopi10']",2,"['sgu20121507', 'p.geminisiva1998']",8,"['sgu20131480', 'sgu20131438', 'ardorhee', 'sgu20121467', None, 'sgu20121484', 'sgu20101328', 'carjehee']",31,"['sgu20121541', 'sgu20121546', 'sgu20131438', 'sgu20141467', 'ardorhee', 'p.geminisiva1998', 'sgug20160008', 'road', 'sgu20111478', 'sgu20121540', 'sgu20121484', 'sgu20111505', 'sgu20121451', 'carjehee', 'sgu20121526', 'sgu20131480', 'sgu20121465', 'sgu20141426', 'sgu20121467', 'dogp27', 'sgu20121507', 'gugusj', None, 'sgu20111577', 'sgu20111493', 'sgu20121450', 'sgu20141482', 'sgu20102047', 'sgu20121517', 'thenopi10', 'sgu20101328']"
37,193,24,15,1,['sgu20111493'],22,"['sgu20121541', 'sgu20121546', 'sgu20141467', 'p.geminisiva1998', 'sgug20160008', 'road', 'sgu20111478', 'sgu20121540', 'sgu20111505', 'sgu20121451', 'sgu20121526', 'sgu20121465', 'sgu20141426', 'dogp27', 'gugusj', 'sgu20121507', 'sgu20111577', 'sgu20121450', 'sgu20141482', 'sgu20102047', 'sgu20121517', 'thenopi10']",14,"['sgu20121442', 'sgu20121503', 'high_sky_up', 'sgu20121481', 'sgu20131480', 'lsjleelsj', 'sgu20121476', 'sgu20131438', 'sgu20121468', 'sgu20111450', 'sgu20141447', 'sogang1536', 'sgu20121467', None]",37,"['sgu20121541', 'sgu20121442', 'sgu20121546', 'lsjleelsj', 'sgu20131438', 'sgu20141467', 'p.geminisiva1998', 'sgug20160008', 'sgu20121468', 'road', 'sgu20111478', 'sgu20121481', 'sgu20121540', 'sgu20111505', 'sgu20121451', 'high_sky_up', 'sgu20121503', 'sgu20121526', 'sgu20131480', 'sgu20121465', 'sgu20141426', 'sgu20121467', 'dogp27', 'sgu20121507', 'gugusj', None, 'sgu20111577', 'sgu20111493', 'sgu20121476', 'sgu20121450', 'sgu20141482', 'sgu20111450', 'sgu20141447', 'sgu20102047', 'sogang1536', 'sgu20121517', 'thenopi10']"
37,259,24,15,2,"['sgu20121541', 'sgu20121540']",21,"['sgu20121546', 'sgu20141467', 'p.geminisiva1998', 'sgug20160008', 'road', 'sgu20111478', 'sgu20111505', 'sgu20121451', 'sgu20121526', 'sgu20121465', 'sgu20141426', 'dogp27', 'gugusj', 'sgu20121507', 'sgu20111577', 'sgu20111493', 'sgu20121450', 'sgu20141482', 'sgu20102047', 'sgu20121517', 'thenopi10']",13,"['sgu20121552', 'kwonhyugsu', 'moook159', 'sgu20121479', 'woojungtae', 'sgu20121476', 'sgu20121514', 'sgu20121468', 'sogang1536', 'sgu20121481', None, 'sgu20121446', 'sgu20121522']",36,"['sgu20121541', 'sgu20121546', 'sgu20141467', 'p.geminisiva1998', 'sgug20160008', 'kwonhyugsu', 'woojungtae', 'sgu20121468', 'road', 'sgu20111478', 'sgu20121446', 'sgu20121481', 'sgu20121540', 'sgu20121522', 'sgu20111505', 'sgu20121451', 'sgu20121479', 'sgu20121526', 'sgu20121465', 'sgu20121514', 'sgu20141426', 'dogp27', 'sgu20121507', 'gugusj', None, 'sgu20121552', 'sgu20111577', 'moook159', 'sgu20111493', 'sgu20121476', 'sgu20121450', 'sgu20141482', 'sgu20102047', 'sogang1536', 'sgu20121517', 'thenopi10']"
37,8,24,13,4,"['sgu20111478', 'sgu20111577', 'dogp27', 'sgu20121450']",19,"['sgu20121541', 'sgu20121546', 'sgu20141467', 'p.geminisiva1998', 'sgug20160008', 'road', 'sgu20121540', 'sgu20111505', 'sgu20121451', 'sgu20121526', 'sgu20121465', 'sgu20141426', 'gugusj', 'sgu20121507', 'sgu20111493', 'sgu20141482', 'sgu20102047', 'sgu20121517', 'thenopi10']",9,"['sgu20131480', 'sgu20111560', 'sgu20121468', 'sgu20111399', 'guheak92', 'sgu20121481', None, 'sgu201201146', 'carjehee']",32,"['sgu20121451', 'sgu20121541', 'sgu20121546', 'sgu20121481', 'sgu20121526', 'sgu20131480', 'sgu20121465', 'sgu20141467', 'sgu20141426', 'guheak92', 'dogp27', 'carjehee', 'sgu20121507', 'p.geminisiva1998', 'gugusj', None, 'sgu201201146', 'sgug20160008', 'sgu20111577', 'sgu20111493', 'sgu20121450', 'sgu20141482', 'sgu20111560', 'sgu20121468', 'sgu20111399', 'road', 'sgu20111478', 'sgu20102047', 'sgu20121517', 'sgu20121540', 'thenopi10', 'sgu20111505']"
37,6,24,7,1,['sgu20121526'],22,"['sgu20121541', 'sgu20121546', 'sgu20141467', 'p.geminisiva1998', 'sgug20160008', 'road', 'sgu20111478', 'sgu20121540', 'sgu20111505', 'sgu20121451', 'sgu20121465', 'sgu20141426', 'dogp27', 'gugusj', 'sgu20121507', 'sgu20111577', 'sgu20111493', 'sgu20121450', 'sgu20141482', 'sgu20102047', 'sgu20121517', 'thenopi10']",6,"['sgu201201176', 'high_sky_up', 'sgu20121476', 'taehojung', 'claritas', None]",29,"['sgu20121451', 'sgu20121541', 'sgu201201176', 'sgu20121546', 'high_sky_up', 'sgu20121526', 'sgu20121465', 'sgu20141467', 'sgu20141426', 'dogp27', 'claritas', 'sgu20121507', 'p.geminisiva1998', 'gugusj', None, 'sgug20160008', 'sgu20111577', 'sgu20111493', 'sgu20121476', 'sgu20121450', 'sgu20141482', 'road', 'sgu20111478', 'sgu20102047', 'taehojung', 'sgu20121517', 'sgu20121540', 'thenopi10', 'sgu20111505']"
37,25,24,6,1,['sgu20111493'],22,"['sgu20121541', 'sgu20121546', 'sgu20141467', 'p.geminisiva1998', 'sgug20160008', 'road', 'sgu20111478', 'sgu20121540', 'sgu20111505', 'sgu20121451', 'sgu20121526', 'sgu20121465', 'sgu20141426', 'dogp27', 'gugusj', 'sgu20121507', 'sgu20111577', 'sgu20121450', 'sgu20141482', 'sgu20102047', 'sgu20121517', 'thenopi10']",5,"['sgu20131480', 'sgu20111450', 'sgu20141447', 'sgu20121467', None]",28,"['sgu20121451', 'sgu20121541', 'sgu20121546', 'sgu20121526', 'sgu20131480', 'sgu20121465', 'sgu20141467', 'sgu20141426', 'sgu20121467', 'dogp27', 'sgu20121507', 'p.geminisiva1998', 'gugusj', None, 'sgug20160008', 'sgu20111577', 'sgu20111493', 'sgu20121450', 'sgu20141482', 'sgu20111450', 'sgu20141447', 'road', 'sgu20111478', 'sgu20102047', 'sgu20121517', 'sgu20121540', 'thenopi10', 'sgu20111505']"
38,80,24,29,22,"['vdipuccio', 'silics', 'crhicks', 'kdeignan2', 'sony702', 'that1russia', 'buia2', 'abera', 'behdad', 'gutie284', 'prador', 'papandr2', 'nikitawanjale', 'lgcrotea', 'ebuenk', 'ml736305773763', 'nikitawanjale3010', 'papandr1', 'darkcharade', 'garci325', 'sanjanadas.nitdgp', 'stoutr1']",1,['m18091990'],7,"['tlatoani80', 'aldanaa5', 'nguyec3', 'fchico24', 'ksegler', 'eeprofessor', None]",30,"['vdipuccio', 'silics', 'crhicks', 'kdeignan2', 'm18091990', 'sony702', 'that1russia', 'buia2', 'abera', 'behdad', 'gutie284', 'prador', 'papandr2', 'tlatoani80', 'nikitawanjale', 'lgcrotea', 'ebuenk', 'ml736305773763', None, 'nikitawanjale3010', 'papandr1', 'aldanaa5', 'nguyec3', 'fchico24', 'ksegler', 'darkcharade', 'garci325', 'eeprofessor', 'sanjanadas.nitdgp', 'stoutr1']"
38,4,24,26,21,"['vdipuccio', 'silics', 'crhicks', 'kdeignan2', 'sony702', 'buia2', 'abera', 'behdad', 'gutie284', 'prador', 'papandr2', 'nikitawanjale', 'lgcrotea', 'ebuenk', 'ml736305773763', 'nikitawanjale3010', 'papandr1', 'darkcharade', 'garci325', 'sanjanadas.nitdgp', 'stoutr1']",2,"['that1russia', 'm18091990']",5,"['nguyec3', 'fchico24', 'eeprofessor', 'ksegler', None]",28,"['vdipuccio', 'silics', 'crhicks', 'kdeignan2', 'm18091990', 'sony702', 'that1russia', 'buia2', 'abera', 'behdad', 'gutie284', 'prador', 'papandr2', 'nikitawanjale', 'lgcrotea', 'ebuenk', 'ml736305773763', None, 'nikitawanjale3010', 'papandr1', 'nguyec3', 'fchico24', 'ksegler', 'darkcharade', 'garci325', 'eeprofessor', 'sanjanadas.nitdgp', 'stoutr1']"
38,151,24,11,6,"['silics', 'kdeignan2', 'that1russia', 'abera', 'gutie284', 'garci325']",17,"['papandr2', 'vdipuccio', 'crhicks', 'm18091990', 'sony702', 'buia2', 'nikitawanjale3010', 'nikitawanjale', 'papandr1', 'lgcrotea', 'ebuenk', 'ml736305773763', 'darkcharade', 'prador', 'sanjanadas.nitdgp', 'behdad', 'stoutr1']",5,"['tlatoani80', 'fchico24', 'eeprofessor', 'ksegler', None]",28,"['papandr2', 'vdipuccio', 'silics', 'crhicks', 'kdeignan2', 'm18091990', 'sony702', 'tlatoani80', 'that1russia', 'buia2', 'abera', 'nikitawanjale', 'lgcrotea', 'ebuenk', 'ml736305773763', None, 'behdad', 'nikitawanjale3010', 'papandr1', 'fchico24', 'gutie284', 'darkcharade', 'garci325', 'prador', 'sanjanadas.nitdgp', 'ksegler', 'eeprofessor', 'stoutr1']"
38,150,24,8,5,"['silics', 'kdeignan2', 'ebuenk', 'prador', 'behdad']",18,"['papandr2', 'vdipuccio', 'crhicks', 'm18091990', 'sony702', 'that1russia', 'buia2', 'nikitawanjale3010', 'abera', 'nikitawanjale', 'papandr1', 'darkcharade', 'lgcrotea', 'gutie284', 'ml736305773763', 'garci325', 'sanjanadas.nitdgp', 'stoutr1']",3,"['nguyec3', None, 'eeprofessor']",26,"['papandr2', 'vdipuccio', 'silics', 'crhicks', 'kdeignan2', 'm18091990', 'sony702', 'that1russia', 'buia2', 'abera', 'nikitawanjale', 'lgcrotea', 'ebuenk', 'ml736305773763', None, 'behdad', 'nikitawanjale3010', 'papandr1', 'nguyec3', 'gutie284', 'darkcharade', 'garci325', 'prador', 'sanjanadas.nitdgp', 'eeprofessor', 'stoutr1']"
39,86,23,34,22,"['rutuja.27rrm', 'moreshilpa0910', 'vchavan1993', 'poojahalagale', 'madhurisunilpatil', 'somnath2025', 'donolikarpratiksha', 'priteeka.suryawanshi', 'bhagyashreeshewale9', 'priyanka.sathe77', 'shetakeni3', 'tejaswinipowar07', 'shekharpatil1167', 'sagarjadhav19951', 'susha.nikam31', 'anujaharel13', 'snehalpatil5588', '95pawarsayali', 'jyoti15thanekar', 'anujakolekar9614', 'mmkhot55', 'rutujagumathannavar11']",0,[],12,"['pranita08', 'vijaychavan4901', 'thankyougod999.rk', 'shamalshingte677', 'anujarananavare12', 'ojus1993', 'suhasyadav22', 'prashantkambare', 'diptimore3181996', 'pratikshasakhare', 'krantishewale17', None]",34,"['thankyougod999.rk', 'shamalshingte677', 'rutuja.27rrm', 'suhasyadav22', 'moreshilpa0910', 'vchavan1993', 'madhurisunilpatil', 'poojahalagale', 'somnath2025', 'priteeka.suryawanshi', 'donolikarpratiksha', 'pranita08', 'bhagyashreeshewale9', 'priyanka.sathe77', 'shetakeni3', 'krantishewale17', 'tejaswinipowar07', 'shekharpatil1167', 'vijaychavan4901', 'ojus1993', 'prashantkambare', 'sagarjadhav19951', None, 'anujarananavare12', 'susha.nikam31', 'anujaharel13', 'snehalpatil5588', 'diptimore3181996', '95pawarsayali', 'jyoti15thanekar', 'anujakolekar9614', 'pratikshasakhare', 'mmkhot55', 'rutujagumathannavar11']"
40,37,23,12,9,"['sianwow2', 'mercydry2695', 'santhy0697', 'kestephany29', 'lmp_ryu', 'sianwow', 'mercysmc.2695', 'danososcompany', 'nancymendoza']",13,"['alexjavier_paucar', 'jhonyjx16', 'johnalex', 'cristianremache1993', 'will.j.y.93', 'carlos_david1995', 'dany', 'ekindig1', 'guaillazaca', 'guaillazaca24', 'brayutum95', 'bhawkin3', 'sebastiansb2']",3,"['paucarcarrilloluis', None, 'wilmerluismorales']",25,"['alexjavier_paucar', 'sianwow2', 'santhy0697', 'kestephany29', 'johnalex', 'lmp_ryu', 'guaillazaca', 'brayutum95', 'bhawkin3', None, 'sebastiansb2', 'nancymendoza', 'paucarcarrilloluis', 'mercydry2695', 'jhonyjx16', 'cristianremache1993', 'will.j.y.93', 'carlos_david1995', 'dany', 'ekindig1', 'guaillazaca24', 'wilmerluismorales', 'sianwow', 'mercysmc.2695', 'danososcompany']"
40,36,23,11,7,"['alexjavier_paucar', 'cristianremache1993', 'lmp_ryu', 'dany', 'guaillazaca', 'guaillazaca24', 'sebastiansb2']",15,"['sianwow2', 'santhy0697', 'jhonyjx16', 'mercydry2695', 'kestephany29', 'johnalex', 'will.j.y.93', 'carlos_david1995', 'ekindig1', 'brayutum95', 'sianwow', 'bhawkin3', 'mercysmc.2695', 'danososcompany', 'nancymendoza']",4,"[None, 'jlrapter', 'cristhian.fajardo', 'ronaldbm93']",26,"['alexjavier_paucar', 'sianwow2', 'santhy0697', 'kestephany29', 'johnalex', 'jlrapter', 'lmp_ryu', 'ronaldbm93', 'guaillazaca', 'brayutum95', 'bhawkin3', None, 'sebastiansb2', 'nancymendoza', 'mercydry2695', 'jhonyjx16', 'cristianremache1993', 'will.j.y.93', 'carlos_david1995', 'dany', 'ekindig1', 'guaillazaca24', 'sianwow', 'mercysmc.2695', 'danososcompany', 'cristhian.fajardo']"
40,35,23,7,4,"['nancymendoza', 'jhonyjx16', 'johnalex', 'carlos_david1995']",18,"['alexjavier_paucar', 'sianwow2', 'santhy0697', 'mercydry2695', 'kestephany29', 'cristianremache1993', 'lmp_ryu', 'will.j.y.93', 'dany', 'guaillazaca', 'ekindig1', 'guaillazaca24', 'brayutum95', 'sianwow', 'bhawkin3', 'mercysmc.2695', 'danososcompany', 'sebastiansb2']",3,"[None, 'jlrapter', 'jefre996']",25,"['alexjavier_paucar', 'sianwow2', 'santhy0697', 'kestephany29', 'johnalex', 'jlrapter', 'lmp_ryu', 'guaillazaca', 'brayutum95', 'jefre996', 'bhawkin3', None, 'sebastiansb2', 'nancymendoza', 'mercydry2695', 'jhonyjx16', 'cristianremache1993', 'will.j.y.93', 'carlos_david1995', 'dany', 'ekindig1', 'guaillazaca24', 'sianwow', 'mercysmc.2695', 'danososcompany']"
41,124,22,27,17,"['atmat', 'afashwhi', 'njvaughn', 'ymhuang', 'umjihgl', 'keyicai', 'huxiaoer', 'jenningd', 'erowell', 'ywwoo', 'greyholm', 'jibecker', 'yangpan', 'kavaidya', 'cmbaums', 'kige', 'mbnicola']",4,"['chenyi.li', '4gbaldin', 'hamza.maizhadjahmed.1', 'xavierwlhr']",10,"['afchadwi', 'kryrin', None, 'zzhiheng126', 'masonab', 'casansmi', 'lworyk', 'zzhiheng123', 'zzhiheng', 'rickfreedom']",31,"['atmat', 'njvaughn', 'kryrin', 'huxiaoer', 'erowell', 'greyholm', 'kavaidya', 'cmbaums', 'xavierwlhr', 'zzhiheng', 'kige', 'afchadwi', 'ymhuang', 'umjihgl', '4gbaldin', 'ywwoo', 'jibecker', 'rickfreedom', 'mbnicola', 'chenyi.li', 'casansmi', 'zzhiheng123', None, 'masonab', 'hamza.maizhadjahmed.1', 'afashwhi', 'keyicai', 'lworyk', 'jenningd', 'zzhiheng126', 'yangpan']"
41,247,22,16,11,"['kavaidya', 'njvaughn', 'keyicai', 'ymhuang', 'ywwoo', 'greyholm', 'jibecker', 'yangpan', 'jenningd', 'cmbaums', 'kige']",10,"['atmat', 'afashwhi', 'umjihgl', 'chenyi.li', 'huxiaoer', '4gbaldin', 'erowell', 'hamza.maizhadjahmed.1', 'xavierwlhr', 'mbnicola']",5,"['zzumich', 'kryrin', 'casansmi', None, 'rickfreedom']",26,"['atmat', 'zzumich', 'njvaughn', 'kryrin', 'huxiaoer', 'jenningd', 'rickfreedom', 'erowell', 'greyholm', 'casansmi', 'kavaidya', 'cmbaums', 'xavierwlhr', None, 'kige', 'hamza.maizhadjahmed.1', 'afashwhi', 'ymhuang', 'umjihgl', 'keyicai', '4gbaldin', 'ywwoo', 'jibecker', 'mbnicola', 'yangpan', 'chenyi.li']"
41,155,22,11,8,"['atmat', 'ymhuang', 'umjihgl', 'keyicai', 'erowell', 'kavaidya', 'cmbaums', 'mbnicola']",13,"['afashwhi', 'njvaughn', 'huxiaoer', '4gbaldin', 'jenningd', 'ywwoo', 'hamza.maizhadjahmed.1', 'greyholm', 'jibecker', 'yangpan', 'xavierwlhr', 'kige', 'chenyi.li']",3,"[None, 'lworyk', 'casansmi']",24,"['atmat', 'njvaughn', 'huxiaoer', 'jenningd', 'erowell', 'greyholm', 'casansmi', 'kavaidya', 'cmbaums', 'xavierwlhr', None, 'kige', 'hamza.maizhadjahmed.1', 'afashwhi', 'ymhuang', 'umjihgl', 'keyicai', '4gbaldin', 'ywwoo', 'jibecker', 'lworyk', 'mbnicola', 'yangpan', 'chenyi.li']"
42,300,21,19,18,"['isawa', 'eminamitani', 'hogehoge29', 'sterben0524', 'naka', 'shonenjiseminar.e25', 'naoya2016', 'uesmuts1tfldr', 'natsu', 'yokomura', 'keiichi4040', 'shozemi', 'jagmaster255963', 'sek0810', 'yuuga018.rokoroko', 'junekoga', 'nirvana9716', 'alsk']",2,"['bkkim60', 'mikemike']",1,[None],21,"['shonenjiseminar.e25', 'bkkim60', 'yokomura', 'keiichi4040', 'sek0810', 'junekoga', 'nirvana9716', 'eminamitani', 'isawa', 'naoya2016', 'sterben0524', 'hogehoge29', 'uesmuts1tfldr', 'natsu', 'jagmaster255963', None, 'naka', 'shozemi', 'yuuga018.rokoroko', 'mikemike', 'alsk']"
43,117,21,28,19,"['scs85', 'ath45', 'jml241', 'njn31', 'jql', 'dgrosh1', 'rxj167', 'cilling', 'bdh58', 'nws24', 'bwp16', 'summersxia2201', 'rsk77', 'axc549', 'bnc8', 'wxc292', 'myk16', 'jennak_41', 'jrmcginnity']",1,['liz_ikasingh'],9,"['b.w.pappas378', 'jiarenkai', 'seaglass418', 'summersxia220194', 'bxd159', 'jnk41', None, 'jwc137', 'nsteinway']",29,"['scs85', 'ath45', 'jiarenkai', 'jml241', 'njn31', 'bxd159', 'jql', 'dgrosh1', 'seaglass418', 'rxj167', 'summersxia220194', 'cilling', 'bdh58', 'nws24', 'jwc137', 'nsteinway', 'b.w.pappas378', 'bwp16', 'summersxia2201', 'rsk77', 'axc549', None, 'bnc8', 'wxc292', 'myk16', 'liz_ikasingh', 'jnk41', 'jennak_41', 'jrmcginnity']"
43,314,21,21,20,"['scs85', 'ath45', 'jml241', 'njn31', 'jql', 'dgrosh1', 'rxj167', 'cilling', 'bdh58', 'nws24', 'bwp16', 'summersxia2201', 'rsk77', 'axc549', 'bnc8', 'wxc292', 'myk16', 'liz_ikasingh', 'jennak_41', 'jrmcginnity']",0,[],1,[None],21,"['scs85', 'ath45', 'jml241', 'njn31', 'jql', 'dgrosh1', 'rxj167', 'cilling', 'bdh58', 'nws24', 'bwp16', 'summersxia2201', 'rsk77', 'axc549', None, 'bnc8', 'wxc292', 'myk16', 'liz_ikasingh', 'jennak_41', 'jrmcginnity']"
43,119,21,20,18,"['scs85', 'wxc292', 'dgrosh1', 'ath45', 'bwp16', 'jml241', 'njn31', 'summersxia2201', 'myk16', 'cilling', 'liz_ikasingh', 'bdh58', 'jennak_41', 'axc549', 'nws24', 'jql', 'bnc8', 'jrmcginnity']",2,"['rxj167', 'rsk77']",2,"[None, 'jwc137']",22,"['scs85', 'ath45', 'jml241', 'njn31', 'jql', 'dgrosh1', 'rxj167', 'cilling', 'bdh58', 'nws24', 'jwc137', 'bwp16', 'summersxia2201', 'rsk77', 'axc549', None, 'bnc8', 'wxc292', 'myk16', 'liz_ikasingh', 'jennak_41', 'jrmcginnity']"
44,68,21,40,1,['komminiadithya'],19,"['kokyeol0320', 'brewnac', 'zxzxzx1216', 'kshotrm', 'dksquddhr123', 'dwm0530.mj', 'carlcll3', 'jangyy12', 'hikim95', 'jisek0', 'jdh940130', 'yuivb0614', 'lswchs522', 'hyeonsu7479', 'hbean', 'gksmfdlekt90', 'vocasuki', 'mlg6060', 'yhw910']",39,"['tbaim', 'mbolognese', 'stevenmcgrat', 'jasonnguyen', 'kgeorgadarel5', 'wkoski', 'amajee', 'jgordon', 'astam', 'jmhiggins', 'ajfitzpatric', 'tdcosta', 'chunkaiwong', 'aksamija', 'ethan402', 'dmathieu', 'asjogren', 'mzeimbekakis', 'mamohamed', 'cwijesundara', 'ajabraha', 'yujiahuo', 'daviddowns', 'dvnguyen', 'jpetrovick', 'ssproviero', 'sdanielson', 'tkoopman', 'matthewdonne141', None, 'rsarge', 'egrimaldi', 'emailhot', 'mshliselberg', 'inwilliams', 'bifisher', 'siyuwu', 'mpool', 'sjpatel']",59,"['kokyeol0320', 'tbaim', 'brewnac', 'mbolognese', 'stevenmcgrat', 'jasonnguyen', 'komminiadithya', 'kgeorgadarel5', 'wkoski', 'zxzxzx1216', 'amajee', 'jgordon', 'astam', 'kshotrm', 'jmhiggins', 'ajfitzpatric', 'tdcosta', 'chunkaiwong', 'aksamija', 'dksquddhr123', 'dwm0530.mj', 'ethan402', 'dmathieu', 'asjogren', 'mzeimbekakis', 'carlcll3', 'mamohamed', 'cwijesundara', 'ajabraha', 'yujiahuo', 'jangyy12', 'daviddowns', 'hikim95', 'jisek0', 'jdh940130', 'dvnguyen', 'jpetrovick', 'yuivb0614', 'lswchs522', 'hyeonsu7479', 'ssproviero', 'hbean', 'sdanielson', 'tkoopman', 'matthewdonne141', None, 'rsarge', 'egrimaldi', 'gksmfdlekt90', 'emailhot', 'mshliselberg', 'inwilliams', 'vocasuki', 'bifisher', 'mlg6060', 'siyuwu', 'mpool', 'yhw910', 'sjpatel']"
44,70,21,34,14,"['kokyeol0320', 'jangyy12', 'brewnac', 'kshotrm', 'gksmfdlekt90', 'hikim95', 'yhw910', 'dwm0530.mj', 'zxzxzx1216', 'yuivb0614', 'lswchs522', 'hyeonsu7479', 'hbean', 'carlcll3']",6,"['jisek0', 'jdh940130', 'komminiadithya', 'dksquddhr123', 'vocasuki', 'mlg6060']",20,"['lsh0307', 'qkdgywp', 'dudxo9273', 'dongjin225', 'gwoo7057', 'kissheyo1004', 'pisces9231', 'mygime92', 'skzl34', 'nnoonn4488', 'ghghrkdlgh', 'rnfnqnfn', 'dbrhksan88', 'rarami55', 'injahgi', None, 'bonghyuk', 'kdj406', 'kiddyu1991', 'krleesd92']",40,"['lsh0307', 'kokyeol0320', 'brewnac', 'qkdgywp', 'dudxo9273', 'komminiadithya', 'dongjin225', 'zxzxzx1216', 'gwoo7057', 'kshotrm', 'dksquddhr123', 'kissheyo1004', 'pisces9231', 'dwm0530.mj', 'carlcll3', 'skzl34', 'mygime92', 'nnoonn4488', 'jangyy12', 'ghghrkdlgh', 'rnfnqnfn', 'dbrhksan88', 'rarami55', 'hikim95', 'jisek0', 'jdh940130', 'injahgi', 'yuivb0614', 'lswchs522', 'hyeonsu7479', 'hbean', None, 'bonghyuk', 'kdj406', 'gksmfdlekt90', 'kiddyu1991', 'vocasuki', 'mlg6060', 'yhw910', 'krleesd92']"
44,67,21,19,6,"['jdh940130', 'dksquddhr123', 'vocasuki', 'mlg6060', 'yuivb0614', 'lswchs522']",14,"['kokyeol0320', 'jangyy12', 'brewnac', 'kshotrm', 'gksmfdlekt90', 'hikim95', 'komminiadithya', 'jisek0', 'yhw910', 'dwm0530.mj', 'zxzxzx1216', 'hyeonsu7479', 'hbean', 'carlcll3']",13,"['ghghrkdlgh', 'qkdgywp', 'jylee432', 'rnfnqnfn', 'dongjin225', 'pisces9231', 'ccjswlgh', 'dangshiggy', 'vhwkd308', 'krleesd92', None, 'skzl34', 'jwh0114']",33,"['kokyeol0320', 'brewnac', 'qkdgywp', 'jylee432', 'komminiadithya', 'dongjin225', 'zxzxzx1216', 'vhwkd308', 'kshotrm', 'dksquddhr123', 'pisces9231', 'dwm0530.mj', 'ccjswlgh', 'dangshiggy', 'carlcll3', 'skzl34', 'jwh0114', 'jangyy12', 'ghghrkdlgh', 'rnfnqnfn', 'hikim95', 'jisek0', 'jdh940130', 'yuivb0614', 'lswchs522', 'hyeonsu7479', 'hbean', None, 'gksmfdlekt90', 'vocasuki', 'mlg6060', 'yhw910', 'krleesd92']"
44,71,21,6,4,"['gksmfdlekt90', 'hbean', 'yuivb0614', 'zxzxzx1216']",16,"['kokyeol0320', 'jangyy12', 'brewnac', 'kshotrm', 'hikim95', 'komminiadithya', 'dksquddhr123', 'jisek0', 'jdh940130', 'vocasuki', 'mlg6060', 'dwm0530.mj', 'lswchs522', 'hyeonsu7479', 'yhw910', 'carlcll3']",2,"[None, 'tmdrms34']",22,"['kokyeol0320', 'jangyy12', 'brewnac', 'tmdrms34', 'hikim95', 'komminiadithya', 'jisek0', 'jdh940130', 'yuivb0614', 'zxzxzx1216', 'lswchs522', 'hyeonsu7479', 'hbean', None, 'kshotrm', 'gksmfdlekt90', 'dksquddhr123', 'vocasuki', 'mlg6060', 'dwm0530.mj', 'yhw910', 'carlcll3']"
45,47,21,207,18,"['patelu997', 'rajdeepd', 'arpit32', 'nikhilgade', 'bhavesh3422', 'yashgumaste', 'arvindlandge', 'anasnaik25', 'pathakrohan18', 'mananmehta7', 'aniket187', 'simran123', 'shreyamath95', 'geeta.kavitake', 'ankurbhagwat8', 'gsawant999', 'shweta1811', 'harshal.dangat1']",2,"['aniket2602', 'ashwini12rajput']",189,"['nitingurme', 'kadamk008', 'rehansonarkar784', 'jainamshah202', 'aimomajy', 'nrkhara', 'ajay.raghuwanshi', 'krittikaranga', 'trija68', 'brian200495', 'shraddhad', 'rananeetika3', 'mehtajinal3101', 'vinit95vasudevan', 'gujarathikshitij', 'zkoyande', 'minalsawant1108', 'neha.utekar2608', 'email.harsh0811', 'himanshuphatak98', 'nikitarane245', 'bhoomee.sheth', 'abhishek1996', 'obalgi3095', 'kambe302', 'lakhanmodani1811', 'rajwaje44', 'jayjadav08', 'neelam.chaudhari27', '22diptinikalje', 'sebastian007', 'tanvikalan', 'harshilmehta1995', 'komal31p', 'poojashetty', 'darshanadaund27', 'sam234bryant', 'nagateja.vlsi', 'bhumivora1995', 'mapethe', 'sid.rane95', 'jaidevdalvi', 'suraj.taigade', 'monish.kapadia', 'ratsthegreat', 'ajinkyachadha', 'divya.upalekar', 'rsawant2895', 'ninad41195', 'purva.desai', 'msumit95', 'patil.rushal825', 'chinmayaniket4052', 'anujakhose94', 'rupali.patil', 'pathanabdulrazzak9524', 'viveky803', 'kpiyushbhirud', 'tejasshinde8055', 'siddhesh401', 'sanika.dongre', 'manasi.shinde008', 'bhavikashenoy95', 'dhvanilmandalia29', 'anasnaik9987', 'mokshada', 'alohomora7', 'pranilraut17', 'suryatejachitturi', 'avinashninawe', 'apoorvasundaresan', 'aditya.apte3', 'shivanisharaf15', 'sonawane.akshayak', 'akanksha0196', 'shubhamj95', 'aeyjd', 'luke676', 'monish.nene', 'spooja.1430', 'purva.satpute', 'adwait.sable10', 'pragatinarnaware', 'nehadingankar', 'deepikachaman3', 'mshirali23', 'nikhildubey02051996', 'shwecchajain', 'akshata.kulkarni', 'kadamrupesh1996', 'stanabk', 'rohankhollamkar', 'upadhyechinmay', 'cooldudeakshu', 'juhi.manglani', 'vaishnavi.sambrekar', 'komalbapna.kb', 'ritesh.shukla', 'mugdha.dalvi', 'amanpal56', 'gupta.ravi1996', 'dipmads', 'rajatkedia95', 'florence9344', 'shubham.gaikwad', 'sanjana.advani', 'priyuk', 'priyeshd', 'tanvi.rane1995', 'ambani', 'umeshdarade77', 'tanayshinde21', 'cvvedesh', 'karan.dadlani', 'pravin45', 'tejaskanagal95', 'doshishrut1995', 'kondekar23', 'poojamenon16.pm', 'mihirsawant17', 'rahul4peace', 'rahul1995', 'rhea.ann.95', 'rawletanmayee46', 'ajthamke40', 'rashuidiot', 'minal.patil', 'chaitanyakhachane95', 'johebshaikh', 'harshada123', 'mahajanabhi2201', 'abhishekpatkar1796', 'abhihadshi', 'bharathi.pedapudi', 'lakshmi.nair', 'gauravrajeshmehta', 'mudbidrijay', 'rutvij.supekar', 'codekidx', 'pbrahmapurkar', 'shreyasvkul', 'chirag184', 'prathameshptkr4', 'aparnaahari95', 'tarak.shah', 'mervyn.fernandes', 'ashishmohite1996', 'akshayshinde101095', 'manavtrivedi03', 'vivek12195', 'akshay21', 'mukul.kulkarni', 'sardesai.kirti18', 'shraddhag', 'vishaakn', 'amrsha.srivastava', 'apurva.patil', 'bhavesh.singh', 'omkardalvi409', 'shriya.sharma', 'lakumveer', 'dhruv.gajaria95', 'mohak11jan', 'parthiv.parikh', 'sandipani1995', 'akashspawar148', 'khannamansi312', 'vishakha1805', 'nileshkartik95', 'neilmundhe', 'shreya.mahajan', 'jainam49', 'jakhererahul42', 'dattaram.gawade781', 'pavitra.iyer', 'tejaschaudhary1996', 'vaibhav.gangan7', 'ankita.rahate', 'shamikabachal', 'swapkaru123', 'saheli.konde', 'prashant.baperkar', 'suman28pandit', 'rakeshmaity', 'aakashgangolli3112', 'prachi.more', 'rohanchavan', 'guptesoham95', 'ptrimukhe32']",209,"['nitingurme', 'kadamk008', 'bhavesh3422', 'aniket187', 'rehansonarkar784', 'jainamshah202', 'aimomajy', 'nrkhara', 'ajay.raghuwanshi', 'krittikaranga', 'rajdeepd', 'trija68', 'brian200495', 'shraddhad', 'rananeetika3', 'mehtajinal3101', 'vinit95vasudevan', 'gujarathikshitij', 'zkoyande', 'minalsawant1108', 'neha.utekar2608', 'email.harsh0811', 'himanshuphatak98', 'arpit32', 'nikitarane245', 'bhoomee.sheth', 'abhishek1996', 'obalgi3095', 'kambe302', 'lakhanmodani1811', 'simran123', 'rajwaje44', 'jayjadav08', 'neelam.chaudhari27', '22diptinikalje', 'sebastian007', 'tanvikalan', 'harshilmehta1995', 'ashwini12rajput', 'komal31p', 'poojashetty', 'darshanadaund27', 'sam234bryant', 'nagateja.vlsi', 'bhumivora1995', 'geeta.kavitake', 'mapethe', 'sid.rane95', 'jaidevdalvi', 'suraj.taigade', 'monish.kapadia', 'ratsthegreat', 'ajinkyachadha', 'divya.upalekar', 'rsawant2895', 'ninad41195', 'purva.desai', 'msumit95', 'patil.rushal825', 'chinmayaniket4052', 'anujakhose94', 'rupali.patil', 'pathanabdulrazzak9524', 'viveky803', 'kpiyushbhirud', 'tejasshinde8055', 'siddhesh401', 'sanika.dongre', 'manasi.shinde008', 'bhavikashenoy95', 'dhvanilmandalia29', 'aniket2602', 'anasnaik9987', 'mokshada', 'alohomora7', 'pranilraut17', 'suryatejachitturi', 'avinashninawe', 'apoorvasundaresan', 'aditya.apte3', 'prachi.more', 'shivanisharaf15', 'sonawane.akshayak', 'akanksha0196', 'shubhamj95', 'aeyjd', 'luke676', 'monish.nene', 'spooja.1430', 'purva.satpute', 'adwait.sable10', 'pragatinarnaware', 'gsawant999', 'nehadingankar', 'deepikachaman3', 'patelu997', 'mshirali23', 'nikhildubey02051996', 'shwecchajain', 'akshata.kulkarni', 'kadamrupesh1996', 'shweta1811', 'stanabk', 'rohankhollamkar', 'upadhyechinmay', 'cooldudeakshu', 'juhi.manglani', 'vaishnavi.sambrekar', 'komalbapna.kb', 'ritesh.shukla', 'mugdha.dalvi', 'amanpal56', 'gupta.ravi1996', 'dipmads', 'rajatkedia95', 'ankurbhagwat8', 'harshal.dangat1', 'florence9344', 'shubham.gaikwad', 'sanjana.advani', 'priyuk', 'priyeshd', 'tanvi.rane1995', 'ambani', 'umeshdarade77', 'tanayshinde21', 'cvvedesh', 'karan.dadlani', 'pravin45', 'tejaskanagal95', 'doshishrut1995', 'kondekar23', 'poojamenon16.pm', 'mihirsawant17', 'rahul4peace', 'rahul1995', 'rhea.ann.95', 'rawletanmayee46', 'ajthamke40', 'rashuidiot', 'minal.patil', 'chaitanyakhachane95', 'johebshaikh', 'harshada123', 'mahajanabhi2201', 'abhishekpatkar1796', 'abhihadshi', 'bharathi.pedapudi', 'lakshmi.nair', 'gauravrajeshmehta', 'mudbidrijay', 'rutvij.supekar', 'codekidx', 'pbrahmapurkar', 'pathakrohan18', 'shreyasvkul', 'mananmehta7', 'chirag184', 'prathameshptkr4', 'aparnaahari95', 'tarak.shah', 'mervyn.fernandes', 'ashishmohite1996', 'akshayshinde101095', 'manavtrivedi03', 'vivek12195', 'nikhilgade', 'arvindlandge', 'anasnaik25', 'akshay21', 'mukul.kulkarni', 'sardesai.kirti18', 'shraddhag', 'vishaakn', 'amrsha.srivastava', 'apurva.patil', 'bhavesh.singh', 'omkardalvi409', 'shriya.sharma', 'lakumveer', 'shreyamath95', 'dhruv.gajaria95', 'mohak11jan', 'parthiv.parikh', 'sandipani1995', 'akashspawar148', 'khannamansi312', 'vishakha1805', 'yashgumaste', 'nileshkartik95', 'neilmundhe', 'shreya.mahajan', 'jainam49', 'jakhererahul42', 'dattaram.gawade781', 'tejaschaudhary1996', 'vaibhav.gangan7', 'ankita.rahate', 'shamikabachal', 'swapkaru123', 'saheli.konde', 'prashant.baperkar', 'suman28pandit', 'rakeshmaity', 'aakashgangolli3112', 'pavitra.iyer', 'rohanchavan', 'guptesoham95', 'ptrimukhe32']"
45,42,21,114,3,"['aniket2602', 'gsawant999', 'ashwini12rajput']",17,"['patelu997', 'rajdeepd', 'arpit32', 'nikhilgade', 'bhavesh3422', 'yashgumaste', 'arvindlandge', 'anasnaik25', 'pathakrohan18', 'mananmehta7', 'aniket187', 'simran123', 'shreyamath95', 'geeta.kavitake', 'ankurbhagwat8', 'shweta1811', 'harshal.dangat1']",111,"['sankpalami', 'shrutikayadav2oct', 'dalvisayli', 'niraj901', 'ektarathod786', 'komalbapna.kb', 'dikshabafna1995', 'adipatil37', 'niteshnarkar712', 'omkarn049', 'sahilsk7', 'ahire.monali07', 'akshaybadhiye04', 'iabhishek555', 'pankajpawar1515', 'susmitaahirrao', 'vinit95vasudevan', 'umeshdarade77', 'tanayshinde21', 'infinite1309', 'pravin45', 'tejaskanagal95', 'minalsawant143', 'oindri.c', 'abarge31', 'chaudharipayal50', 'shahyash027', 'rawletanmayee46', 'shraddha0306', 'sangeetamjoshi', 'mahajanabhi2201', 'mudrasjuee', 'vijaybhargude2', 'advenraju', 'abhihadshi', 'supu1796', 'sebastian007', 'pratikkhanore95', 'preetywagh95', 'gidayegirish', 'shrikantnimse14', 'praju.avhad', 'gauravrajeshmehta', 'pbrahmapurkar', 'rakshu.gade', 'sam234bryant', 'swati123', 'sonalipawar589', 'saurabhmangeshkar', 'shrutisundar019', 'ratsthegreat', 'oma1811', 'ravina.chavan42', 'mukulsathe1995', 'bimal.biswas8', 'tarak.shah', 'rsawant2895', 'priyankaingle18', 'sumedh_patil', 'bondreanup007', 'rohitbaliyan53', 'a.j.yadav2395', 'chiragc9494', 'hbg2112', 'tanyabaptist05', 'bkadam357', 'manishashetye1295', 'abhishek.thavare', 'varadrajnanaware7', 'sardesai.kirti18', 'sammit1844', 'viveky803', 'tejasshinde8055', 'chaudharisuyash7', 'ru1795', 'sanketsalvi03', 'sandesh29', 'deven199570', 'priyagajakosh1', 'aashish.yadav94', 'amritamukeshb', 'pratikthorat10', 'jatin.dhande1008', 'lakumveer', 'aditya1818', 'shakyanandk', 'ramaprde2296', 'rushabh.fegade', 'akashspawar148', 'cpatil152', 'abhishekm2861996', 'ritesh.parulekar231194', 'sonawane.akshayak', 'vishakha1805', 'ptrimukhe32', 'dattaram.gawade781', 'sagarpawar', None, 'prajaktachapte2', 'nikhildubey02051996', 'sagarbhagat43', 'kaustubhgudekar9', 'prashant.baperkar', 'suman28pandit', 'danish.dev.007', 'rakeshmaity', 'saylishirodkar58', 'sayalipatil4545', 'rohanchavan', 'aishwaryamardhekar.24595', 'cooldudeakshu']",131,"['sankpalami', 'shrutikayadav2oct', 'dalvisayli', 'niraj901', 'ektarathod786', 'dikshabafna1995', 'bhavesh3422', 'adipatil37', 'niteshnarkar712', 'omkarn049', 'aniket187', 'sahilsk7', 'ahire.monali07', 'rajdeepd', 'vinit95vasudevan', 'minalsawant143', 'arpit32', 'chaudharipayal50', 'shraddha0306', 'sangeetamjoshi', 'mudrasjuee', 'simran123', 'vijaybhargude2', 'sebastian007', 'ashwini12rajput', 'praju.avhad', 'rakshu.gade', 'sam234bryant', 'geeta.kavitake', 'sonalipawar589', 'ratsthegreat', 'oma1811', 'rsawant2895', 'sumedh_patil', 'a.j.yadav2395', 'chiragc9494', 'hbg2112', 'varadrajnanaware7', 'viveky803', 'tejasshinde8055', 'chaudharisuyash7', 'ru1795', 'deven199570', 'priyagajakosh1', 'aashish.yadav94', 'pratikthorat10', 'jatin.dhande1008', 'aniket2602', 'aditya1818', 'sonawane.akshayak', 'sagarpawar', 'gsawant999', 'prajaktachapte2', 'patelu997', 'nikhildubey02051996', 'danish.dev.007', 'shweta1811', 'saylishirodkar58', 'sayalipatil4545', 'aishwaryamardhekar.24595', 'cooldudeakshu', 'komalbapna.kb', 'ankurbhagwat8', 'harshal.dangat1', 'akshaybadhiye04', 'iabhishek555', 'pankajpawar1515', 'susmitaahirrao', 'umeshdarade77', 'tanayshinde21', 'infinite1309', 'pravin45', 'tejaskanagal95', 'oindri.c', 'abarge31', 'shahyash027', 'rawletanmayee46', 'mahajanabhi2201', 'advenraju', 'abhihadshi', 'supu1796', 'pratikkhanore95', 'preetywagh95', 'gidayegirish', 'shrikantnimse14', 'gauravrajeshmehta', 'pbrahmapurkar', 'pathakrohan18', 'mananmehta7', 'swati123', 'saurabhmangeshkar', 'shrutisundar019', 'ravina.chavan42', 'mukulsathe1995', 'tarak.shah', 'priyankaingle18', 'bondreanup007', 'nikhilgade', 'rohitbaliyan53', 'tanyabaptist05', 'arvindlandge', 'anasnaik25', 'bkadam357', 'manishashetye1295', 'abhishek.thavare', 'sardesai.kirti18', 'sammit1844', 'sanketsalvi03', 'sandesh29', 'amritamukeshb', 'lakumveer', 'shreyamath95', 'shakyanandk', 'ramaprde2296', 'rushabh.fegade', 'akashspawar148', 'cpatil152', 'abhishekm2861996', 'ritesh.parulekar231194', 'vishakha1805', 'yashgumaste', 'dattaram.gawade781', None, 'sagarbhagat43', 'kaustubhgudekar9', 'prashant.baperkar', 'suman28pandit', 'rakeshmaity', 'rohanchavan', 'bimal.biswas8', 'ptrimukhe32']"
45,214,21,59,17,"['patelu997', 'rajdeepd', 'arpit32', 'nikhilgade', 'bhavesh3422', 'yashgumaste', 'arvindlandge', 'anasnaik25', 'pathakrohan18', 'mananmehta7', 'aniket187', 'simran123', 'shreyamath95', 'geeta.kavitake', 'ankurbhagwat8', 'gsawant999', 'harshal.dangat1']",3,"['shweta1811', 'aniket2602', 'ashwini12rajput']",42,"['vaishnavi.sambrekar', 'purva.desai', 'divya.upalekar', 'ninad41195', 'ashishmohite1996', 'ritesh.shukla', 'mervyn.fernandes', 'mugdha.dalvi', 'shraddhag', 'pathanabdulrazzak9524', 'krittikaranga', 'nehasankeshi', 'kpiyushbhirud', 'shraddhad', 'tejasshinde8055', 'vishaakn', 'abhishekg95', 'gujarathikshitij', 'bhavesh.singh', 'bhavikashenoy95', 'neha.utekar2608', 'mokshada', 'rahul1995', 'abhishek1996', 'prachi.more', 'minal.patil', 'johebshaikh', 'aeyjd', 'lakhanmodani1811', 'pavitra.iyer', 'nehadingankar', None, '22diptinikalje', 'tejaschaudhary1996', 'lakshmi.nair', 'rutvij.supekar', 'mudbidrijay', 'akshata.kulkarni', 'swapkaru123', 'saheli.konde', 'suraj.taigade', 'guptesoham95']",62,"['vaishnavi.sambrekar', 'ritesh.shukla', 'bhavesh3422', 'mugdha.dalvi', 'aniket187', 'ankurbhagwat8', 'harshal.dangat1', 'krittikaranga', 'rajdeepd', 'shraddhad', 'abhishekg95', 'gujarathikshitij', 'neha.utekar2608', 'rahul1995', 'arpit32', 'abhishek1996', 'minal.patil', 'johebshaikh', 'lakhanmodani1811', 'simran123', '22diptinikalje', 'lakshmi.nair', 'ashwini12rajput', 'rutvij.supekar', 'mudbidrijay', 'pathakrohan18', 'mananmehta7', 'geeta.kavitake', 'suraj.taigade', 'nehasankeshi', 'divya.upalekar', 'purva.desai', 'ninad41195', 'ashishmohite1996', 'mervyn.fernandes', 'nikhilgade', 'arvindlandge', 'anasnaik25', 'shraddhag', 'pathanabdulrazzak9524', 'kpiyushbhirud', 'vishaakn', 'tejasshinde8055', 'bhavesh.singh', 'bhavikashenoy95', 'shreyamath95', 'aniket2602', 'mokshada', 'aeyjd', 'yashgumaste', 'pavitra.iyer', 'nehadingankar', 'gsawant999', None, 'patelu997', 'tejaschaudhary1996', 'akshata.kulkarni', 'swapkaru123', 'saheli.konde', 'shweta1811', 'prachi.more', 'guptesoham95']"
45,40,21,30,4,"['shreyamath95', 'patelu997', 'arpit32', 'anasnaik25']",16,"['rajdeepd', 'ashwini12rajput', 'aniket2602', 'nikhilgade', 'bhavesh3422', 'yashgumaste', 'arvindlandge', 'pathakrohan18', 'mananmehta7', 'geeta.kavitake', 'aniket187', 'simran123', 'shweta1811', 'ankurbhagwat8', 'gsawant999', 'harshal.dangat1']",26,"['mukulsathe1995', 'bondreanup007', 'tanyabaptist05', 'a.j.yadav2395', 'hbg2112', 'shriya.h.joshi', 'anujakhose94', 'akshaybadhiye04', 'iabhishek555', 'sanketsalvi03', 'shakyanandk', 'parmitbanga1995', 'shraddha0306', 'ritesh.parulekar231194', 'vaibhavghare94', 'neilmundhe', 'heramb10', 'sagarpawar', None, 'sebastian007', 'smonica498', 'prajaktachapte2', 'prp23dec', 'mohiteashwin7', 'mapethe', 'ratsthegreat']",46,"['mukulsathe1995', 'bondreanup007', 'bhavesh3422', 'nikhilgade', 'tanyabaptist05', 'arvindlandge', 'anasnaik25', 'a.j.yadav2395', 'hbg2112', 'aniket187', 'ankurbhagwat8', 'shriya.h.joshi', 'anujakhose94', 'harshal.dangat1', 'rajdeepd', 'akshaybadhiye04', 'iabhishek555', 'sanketsalvi03', 'shreyamath95', 'aniket2602', 'shakyanandk', 'arpit32', 'parmitbanga1995', 'shraddha0306', 'ritesh.parulekar231194', 'vaibhavghare94', 'yashgumaste', 'neilmundhe', 'simran123', 'heramb10', 'sagarpawar', 'gsawant999', None, 'sebastian007', 'smonica498', 'patelu997', 'prajaktachapte2', 'ashwini12rajput', 'prp23dec', 'mohiteashwin7', 'pathakrohan18', 'mananmehta7', 'geeta.kavitake', 'shweta1811', 'mapethe', 'ratsthegreat']"
45,225,21,30,13,"['patelu997', 'rajdeepd', 'arpit32', 'nikhilgade', 'yashgumaste', 'pathakrohan18', 'arvindlandge', 'anasnaik25', 'mananmehta7', 'geeta.kavitake', 'simran123', 'shreyamath95', 'ankurbhagwat8']",7,"['ashwini12rajput', 'bhavesh3422', 'shweta1811', 'aniket187', 'aniket2602', 'gsawant999', 'harshal.dangat1']",17,"['naikraj490', 'priyeshd', 'kpiyushbhirud', 'shraddha.vispute.in', 'shraddha0306', 'mohiteashwin7', 'vickswagh146', 'vrajesh915', 'harshada123', 'neilmundhe', 'mahajanabhi2201', 'nikitagaikwad594', 'pratikthorat10', 'nehasankeshi', 'sahilsk7', None, '22diptinikalje']",37,"['bhavesh3422', 'nikhilgade', 'vickswagh146', 'arvindlandge', 'anasnaik25', 'aniket187', 'ankurbhagwat8', 'sahilsk7', 'harshal.dangat1', 'rajdeepd', 'kpiyushbhirud', 'priyeshd', 'shraddha.vispute.in', 'pratikthorat10', 'shreyamath95', 'aniket2602', 'arpit32', 'shraddha0306', 'yashgumaste', 'vrajesh915', 'harshada123', 'neilmundhe', 'mahajanabhi2201', 'simran123', 'gsawant999', None, 'naikraj490', '22diptinikalje', 'patelu997', 'ashwini12rajput', 'mohiteashwin7', 'pathakrohan18', 'nikitagaikwad594', 'mananmehta7', 'geeta.kavitake', 'shweta1811', 'nehasankeshi']"
45,226,21,11,1,['patelu997'],19,"['nikhilgade', 'bhavesh3422', 'arvindlandge', 'anasnaik25', 'aniket187', 'ankurbhagwat8', 'harshal.dangat1', 'rajdeepd', 'shreyamath95', 'aniket2602', 'arpit32', 'yashgumaste', 'simran123', 'gsawant999', 'ashwini12rajput', 'pathakrohan18', 'mananmehta7', 'geeta.kavitake', 'shweta1811']",10,"['shraddha.vispute.in', 'shraddha0306', 'mohiteashwin7', 'vickswagh146', 'vrajesh915', 'nikitagaikwad594', 'pratikthorat10', 'sahilsk7', None, 'naikraj490']",30,"['arpit32', 'shraddha0306', 'bhavesh3422', 'nikhilgade', 'yashgumaste', 'arvindlandge', 'anasnaik25', 'vickswagh146', 'vrajesh915', 'aniket187', 'simran123', 'ankurbhagwat8', 'gsawant999', 'naikraj490', 'harshal.dangat1', 'sahilsk7', None, 'patelu997', 'rajdeepd', 'ashwini12rajput', 'shraddha.vispute.in', 'mohiteashwin7', 'pathakrohan18', 'nikitagaikwad594', 'mananmehta7', 'geeta.kavitake', 'shweta1811', 'pratikthorat10', 'shreyamath95', 'aniket2602']"
45,43,21,10,1,['aniket2602'],19,"['nikhilgade', 'bhavesh3422', 'arvindlandge', 'anasnaik25', 'aniket187', 'ankurbhagwat8', 'harshal.dangat1', 'rajdeepd', 'shreyamath95', 'arpit32', 'yashgumaste', 'simran123', 'gsawant999', 'patelu997', 'ashwini12rajput', 'pathakrohan18', 'mananmehta7', 'geeta.kavitake', 'shweta1811']",9,"['parag.choughule', 'navneetmishra021', 'happyridermrk', 'akashmore456', 'pripatil285', 'atul.20909', None, 'somil910', 'ratsthegreat']",29,"['arpit32', 'navneetmishra021', 'happyridermrk', 'bhavesh3422', 'nikhilgade', 'yashgumaste', 'arvindlandge', 'anasnaik25', 'aniket187', 'simran123', 'pripatil285', 'atul.20909', 'ankurbhagwat8', 'gsawant999', None, 'harshal.dangat1', 'patelu997', 'rajdeepd', 'parag.choughule', 'ashwini12rajput', 'pathakrohan18', 'akashmore456', 'mananmehta7', 'geeta.kavitake', 'shweta1811', 'shreyamath95', 'aniket2602', 'somil910', 'ratsthegreat']"
45,212,21,8,2,"['aniket2602', 'ashwini12rajput']",18,"['patelu997', 'rajdeepd', 'arpit32', 'nikhilgade', 'bhavesh3422', 'yashgumaste', 'arvindlandge', 'anasnaik25', 'pathakrohan18', 'mananmehta7', 'aniket187', 'simran123', 'shreyamath95', 'geeta.kavitake', 'ankurbhagwat8', 'gsawant999', 'shweta1811', 'harshal.dangat1']",6,"['crmalgundkar', 'umesh897', 'swati123', 'aniketkadale', None, 'shrutisundar019']",26,"['arpit32', 'bhavesh3422', 'nikhilgade', 'yashgumaste', 'arvindlandge', 'anasnaik25', 'aniket187', 'simran123', 'ankurbhagwat8', 'gsawant999', 'aniketkadale', 'harshal.dangat1', None, 'patelu997', 'rajdeepd', 'ashwini12rajput', 'pathakrohan18', 'mananmehta7', 'crmalgundkar', 'geeta.kavitake', 'shweta1811', 'umesh897', 'swati123', 'shreyamath95', 'aniket2602', 'shrutisundar019']"
45,213,21,8,1,['gsawant999'],19,"['nikhilgade', 'bhavesh3422', 'arvindlandge', 'anasnaik25', 'aniket187', 'ankurbhagwat8', 'harshal.dangat1', 'rajdeepd', 'shreyamath95', 'aniket2602', 'arpit32', 'yashgumaste', 'simran123', 'patelu997', 'ashwini12rajput', 'pathakrohan18', 'mananmehta7', 'geeta.kavitake', 'shweta1811']",7,"['tejasshinde8055', 'cvvedesh', 'zkoyande', 'bhavikashenoy95', 'chirag184', None, 'anujakhose94']",27,"['arpit32', 'bhavesh3422', 'nikhilgade', 'yashgumaste', 'arvindlandge', 'anasnaik25', 'aniket187', 'simran123', 'ankurbhagwat8', 'gsawant999', 'anujakhose94', 'harshal.dangat1', None, 'patelu997', 'rajdeepd', 'ashwini12rajput', 'tejasshinde8055', 'cvvedesh', 'zkoyande', 'pathakrohan18', 'mananmehta7', 'bhavikashenoy95', 'geeta.kavitake', 'shweta1811', 'chirag184', 'shreyamath95', 'aniket2602']"
45,45,21,6,1,['aniket2602'],19,"['nikhilgade', 'bhavesh3422', 'arvindlandge', 'anasnaik25', 'aniket187', 'ankurbhagwat8', 'harshal.dangat1', 'rajdeepd', 'shreyamath95', 'arpit32', 'yashgumaste', 'simran123', 'gsawant999', 'patelu997', 'ashwini12rajput', 'pathakrohan18', 'mananmehta7', 'geeta.kavitake', 'shweta1811']",5,"['happyridermrk', 'tanayshinde21', 'akashmore456', 'pripatil285', None]",25,"['arpit32', 'happyridermrk', 'bhavesh3422', 'nikhilgade', 'yashgumaste', 'arvindlandge', 'anasnaik25', 'aniket187', 'simran123', 'pripatil285', 'ankurbhagwat8', 'gsawant999', None, 'harshal.dangat1', 'patelu997', 'rajdeepd', 'ashwini12rajput', 'tanayshinde21', 'pathakrohan18', 'akashmore456', 'mananmehta7', 'geeta.kavitake', 'shweta1811', 'shreyamath95', 'aniket2602']"
45,227,21,6,4,"['yashgumaste', 'harshal.dangat1', 'aniket187', 'bhavesh3422']",16,"['patelu997', 'rajdeepd', 'arpit32', 'ashwini12rajput', 'aniket2602', 'nikhilgade', 'pathakrohan18', 'arvindlandge', 'anasnaik25', 'mananmehta7', 'geeta.kavitake', 'shweta1811', 'simran123', 'shreyamath95', 'ankurbhagwat8', 'gsawant999']",2,"['nehasankeshi', None]",22,"['arpit32', 'bhavesh3422', 'nikhilgade', 'yashgumaste', 'arvindlandge', 'anasnaik25', 'aniket187', 'simran123', 'ankurbhagwat8', 'gsawant999', None, 'harshal.dangat1', 'patelu997', 'rajdeepd', 'nehasankeshi', 'ashwini12rajput', 'pathakrohan18', 'mananmehta7', 'geeta.kavitake', 'shweta1811', 'shreyamath95', 'aniket2602']"
46,309,21,29,15,"['arminmirahcic', 'devankarsann', 'bmw92', 'nickcarter', 'jakesoares', 'yaizarodriguezortego', 'williamburdge', 'codylynde', 'alondraperez', 'strcroft', 'georgewarren', 'nickkempf', 'riccardotorsi', 'josephspinuzzi', 'twinters']",5,"['williamcrow', 'berna_u', 'addielupercio', 'seanokelley', 'kojh1782']",14,"['samuelpedersen', 'petebarnes3', 'nate.stephon', 'jfreilich', 'andrescorrea', 'donaldkellis', 'andrewarmstrong858', 'egraugnard', 'marissahondros16', 'binayjoshi', 'mitchellleibowitz', 'arvincunningham', None, 'lanlibsu']",34,"['samuelpedersen', 'petebarnes3', 'andrescorrea', 'bmw92', 'nickcarter', 'alondraperez', 'strcroft', 'josephspinuzzi', 'lanlibsu', 'williamcrow', 'nate.stephon', 'donaldkellis', 'jakesoares', 'addielupercio', 'seanokelley', 'yaizarodriguezortego', 'kojh1782', 'georgewarren', 'mitchellleibowitz', 'arvincunningham', 'devankarsann', 'egraugnard', 'williamburdge', 'marissahondros16', 'codylynde', 'binayjoshi', 'nickkempf', None, 'twinters', 'arminmirahcic', 'jfreilich', 'andrewarmstrong858', 'berna_u', 'riccardotorsi']"
46,294,21,23,18,"['williamcrow', 'arminmirahcic', 'devankarsann', 'bmw92', 'nickcarter', 'jakesoares', 'addielupercio', 'seanokelley', 'yaizarodriguezortego', 'williamburdge', 'alondraperez', 'strcroft', 'georgewarren', 'codylynde', 'nickkempf', 'riccardotorsi', 'josephspinuzzi', 'twinters']",2,"['kojh1782', 'berna_u']",5,"['jfreilich', 'brettmward', 'mitchellleibowitz', 'arvincunningham', None]",25,"['bmw92', 'nickcarter', 'alondraperez', 'strcroft', 'josephspinuzzi', 'williamcrow', 'brettmward', 'jakesoares', 'addielupercio', 'seanokelley', 'yaizarodriguezortego', 'kojh1782', 'georgewarren', 'mitchellleibowitz', 'arvincunningham', 'devankarsann', 'williamburdge', 'codylynde', 'nickkempf', None, 'twinters', 'arminmirahcic', 'jfreilich', 'berna_u', 'riccardotorsi']"
46,143,21,22,11,"['williamcrow', 'arminmirahcic', 'devankarsann', 'nickcarter', 'jakesoares', 'addielupercio', 'seanokelley', 'codylynde', 'riccardotorsi', 'strcroft', 'twinters']",9,"['bmw92', 'berna_u', 'yaizarodriguezortego', 'williamburdge', 'kojh1782', 'alondraperez', 'georgewarren', 'nickkempf', 'josephspinuzzi']",11,"['jfreilich', 'andrescorrea', 'ziyadbinsulaiman', 'cwalker', 'bradygarringer', 'alejandromontoya', 'majeed', 'mitchellleibowitz', 'arvincunningham', None, 'melissabranagan']",31,"['andrescorrea', 'bmw92', 'nickcarter', 'alondraperez', 'strcroft', 'majeed', 'josephspinuzzi', 'williamcrow', 'jakesoares', 'addielupercio', 'seanokelley', 'yaizarodriguezortego', 'kojh1782', 'alejandromontoya', 'georgewarren', 'mitchellleibowitz', 'arvincunningham', 'ziyadbinsulaiman', 'melissabranagan', 'devankarsann', 'williamburdge', 'codylynde', 'cwalker', 'bradygarringer', 'nickkempf', None, 'twinters', 'arminmirahcic', 'jfreilich', 'berna_u', 'riccardotorsi']"
46,141,21,12,9,"['arminmirahcic', 'devankarsann', 'bmw92', 'jakesoares', 'addielupercio', 'yaizarodriguezortego', 'riccardotorsi', 'strcroft', 'twinters']",11,"['williamcrow', 'nickcarter', 'berna_u', 'seanokelley', 'williamburdge', 'kojh1782', 'alondraperez', 'georgewarren', 'codylynde', 'nickkempf', 'josephspinuzzi']",3,"['arvincunningham', 'jfreilich', None]",23,"['devankarsann', 'bmw92', 'nickcarter', 'williamburdge', 'codylynde', 'alondraperez', 'strcroft', 'nickkempf', 'josephspinuzzi', None, 'twinters', 'williamcrow', 'arminmirahcic', 'jfreilich', 'jakesoares', 'addielupercio', 'berna_u', 'seanokelley', 'yaizarodriguezortego', 'kojh1782', 'riccardotorsi', 'georgewarren', 'arvincunningham']"
46,295,21,10,8,"['arminmirahcic', 'devankarsann', 'bmw92', 'seanokelley', 'riccardotorsi', 'nickkempf', 'georgewarren', 'twinters']",12,"['williamcrow', 'nickcarter', 'jakesoares', 'addielupercio', 'berna_u', 'yaizarodriguezortego', 'williamburdge', 'kojh1782', 'alondraperez', 'strcroft', 'codylynde', 'josephspinuzzi']",2,"['arvincunningham', None]",22,"['devankarsann', 'bmw92', 'nickcarter', 'williamburdge', 'codylynde', 'alondraperez', 'strcroft', 'nickkempf', 'josephspinuzzi', None, 'twinters', 'williamcrow', 'arminmirahcic', 'jakesoares', 'addielupercio', 'berna_u', 'seanokelley', 'yaizarodriguezortego', 'kojh1782', 'riccardotorsi', 'georgewarren', 'arvincunningham']"
46,308,21,7,1,['kojh1782'],19,"['bmw92', 'nickcarter', 'alondraperez', 'strcroft', 'josephspinuzzi', 'williamcrow', 'jakesoares', 'addielupercio', 'seanokelley', 'yaizarodriguezortego', 'georgewarren', 'devankarsann', 'williamburdge', 'codylynde', 'nickkempf', 'twinters', 'arminmirahcic', 'berna_u', 'riccardotorsi']",6,"['02junho', 'hsjun7766', 'taemin0912', 'hyeonah612', None, 'kojh17821']",26,"['devankarsann', 'hsjun7766', 'bmw92', 'nickcarter', 'williamburdge', 'codylynde', 'alondraperez', 'strcroft', 'hyeonah612', 'nickkempf', 'josephspinuzzi', None, 'kojh17821', 'twinters', 'williamcrow', 'arminmirahcic', '02junho', 'taemin0912', 'jakesoares', 'addielupercio', 'berna_u', 'seanokelley', 'yaizarodriguezortego', 'kojh1782', 'riccardotorsi', 'georgewarren']"
46,307,21,6,3,"['devankarsann', 'williamburdge', 'josephspinuzzi']",17,"['williamcrow', 'arminmirahcic', 'bmw92', 'nickcarter', 'jakesoares', 'addielupercio', 'seanokelley', 'yaizarodriguezortego', 'kojh1782', 'alondraperez', 'strcroft', 'codylynde', 'nickkempf', 'berna_u', 'riccardotorsi', 'georgewarren', 'twinters']",3,"['mitchellleibowitz', 'jfreilich', None]",23,"['devankarsann', 'bmw92', 'nickcarter', 'williamburdge', 'codylynde', 'alondraperez', 'strcroft', 'nickkempf', 'josephspinuzzi', None, 'twinters', 'williamcrow', 'arminmirahcic', 'jfreilich', 'jakesoares', 'addielupercio', 'berna_u', 'seanokelley', 'yaizarodriguezortego', 'kojh1782', 'riccardotorsi', 'georgewarren', 'mitchellleibowitz']"
47,312,20,20,17,"['wcf778', 'lxhwbd1234', 'usoppo', 'uos', 'leya', 'ashz8888', 'wentao7', 'jliu85', 'faasiri', 'samkam', 'grace8699', 'xunhaowang', 'zxi1', 'wttuestc', 'williamtian93', 'jhsu1', 'zlu19']",2,"['mwakram', 'simonszalai']",3,"['wangruntao', 'zliu26', None]",22,"['wcf778', 'lxhwbd1234', 'ashz8888', 'simonszalai', 'zxi1', 'wttuestc', 'usoppo', 'uos', 'zliu26', 'jliu85', 'xunhaowang', 'jhsu1', 'mwakram', 'wentao7', 'faasiri', 'samkam', 'grace8699', None, 'zlu19', 'wangruntao', 'leya', 'williamtian93']"
48,167,20,19,18,"['gtxaloha', 'samalam182', 'mykelup', 'paulmcint', 'weird_ninja13', 'jasonalthouse', 'schneidm17', 'osterberg', 'laul17', 'qward', 'foxisda', 'thomasblatner', 'walkerfrank', 'schibel50', 'goldey17', 'snailsforbreakfast', 'n.quyen10', 'bennettm17']",1,['kamyar.ghofrani'],1,[None],20,"['gtxaloha', 'mykelup', 'paulmcint', 'weird_ninja13', 'jasonalthouse', 'foxisda', 'thomasblatner', 'goldey17', 'samalam182', 'laul17', 'kamyar.ghofrani', 'n.quyen10', 'bennettm17', 'schneidm17', 'osterberg', 'qward', None, 'walkerfrank', 'schibel50', 'snailsforbreakfast']"
49,38,20,170,11,"['doshi.kavisha16', 'arawal14.ar', 'yashsavle', 'vijaykothari97', 'karantank97', 'jaysawant2', 'sonihetvi10', 'dhairyagada1997', 'inderjitsingh87', 'varun1997', '1jyotsna1']",8,"['smonica498', 'adityamodi009', 'prp23dec', 'malharvyas17.mv', 'tanuj.udani', 'abarge31', 'singhshashank97', 'naval29']",159,"['jigneshk2994', 'tejuliman74', 'harshitbangera', 'ishmeetsingh', 'sanketh728', 'swatimane176', 'karan.marketkar', 'rushikeshjoshi285', 'rnair15', 'shreyasawant95', 'viraktdoshi19', 'udayyewale17', 'karan.gondalia', 'patilroshan1128', 'kumarvivek017', 'rohitpuri.g', 'gurmukhsingh0108', 'amit.dutta', 'sush81194', 'rishabh4745', 'tambeneha94', 'rukhsrd', 'nair19shruti', 'happyridermrk', 'gadhiyakenil16', 'abauti608', 'sadiqqureshi393', 'rutu123', 'jiteshkjsp', 'aniketshelar79', 'sachimalkan', 'sgat3451', 'ykhedikar', 'ishaan.sathe', 'mapethe', 'amruteshpatil', 'pateltejash96', 'ratsthegreat', 'tandelsneha15', 'tajpara.nikhil', 'miteshmohokar', 'g3jithinn', 'kapilaherkar755', 'sweta151945', 'pruthavi.c', 'akansha319892', 'vjseedan', 'vishal.chavda', 'nairprasad007', 'joshua0667', 'hardrider95', 'ankitferry123', 'priyankadeshpande177', 'hardik.upadhyay', 'prasad.m', 'parmarmayur05', 'nikj816', 'smajumdar', 'rrnair291293', 'nikuldengada493', 'ankur.shah', 'princeporje98', 'suraj6111994', 'yogeshwar21121995', 'parthkaushikdave', 'nilesh.delekar', 'ameymalotkar1', 'pareshnaik1995', 'gopal.singh', 'nehaaltawade1', 's.jadeja', 'melchiznadar', 'poojaparab9035', 'nikhil4241307', 'pdeshpande', 'peshinakash', 'kiranjadhav050994', 'abinbenny8', 'ashupalambe1992', 'abinaya67006', 'ajitjadhav', 'machalke92', 'yogi.6692', 'devyani.salvi1028', 'qwertynishit', 'verma.amitkumar95', 'florence9344', 'anuradha.d', 'satya_mishra', 'shraddhakharde01', 'kypptl', 'lino2296', 'sharma.ayushi8c', 'sbodke', 'aqudas29', 'khedikaryash8', 'tgpatil22791', 'pranithsuvarna1', 'mauryashubham564', 'vijaya', 'shaminakunnel', 'rahulbadekar', 'raoashish96', 'parag.choughule', 'asingh12', 'parag16593', 'jigar', 'shivam_cr7', 'udit.shah', 'vishakha', 'tdholpuria', 'atoraskar12', 'mkadam03', 'walavalkarmayur79', 'ankitagharat93', 'aanugraha', 'shubhrapatil77', 'gkapil45', 'rushabh.soni', 'mayuripatil3095', 'tanujudani865', 'aniketa.yelave49', 'jadhavankita9969', 'sujataredkar', 'rautt59', 'rjoshi02', 'karankyp', 'adwaitvajpe', 'anevrekar', 'yayatipawar601', 'akash.mali3477', 'akashmore456', 'surajkarade.2', 'pranav.gori', 'patilvarad2011', 'palak1012', 'apekshapawar', 'ramanujsingh004', 'keyur.gajjar', 'pranilghogale', 'pripatil285', 'desaivighnesh95', None, 'burhan.naim', 'd.shenoy', 'ashish.mrya1', 'ankith89', 'priyanka.bhangre', 'rutwijajoshi10', 'karanshah30', 'agarwal.gagan5101', 'anshujha95', 'vedy1811', 'chaitanyakhane999', 'tushar.gaikwad', 'gaurav.gadre', 'sourabhbelose', 'somil910', 'abhiramibp95']",178,"['jigneshk2994', 'yashsavle', 'tejuliman74', 'harshitbangera', 'ishmeetsingh', 'sanketh728', 'swatimane176', 'karan.marketkar', 'rushikeshjoshi285', 'rnair15', 'shreyasawant95', 'viraktdoshi19', 'udayyewale17', 'karan.gondalia', 'patilroshan1128', 'kumarvivek017', 'rohitpuri.g', 'gurmukhsingh0108', 'amit.dutta', 'sush81194', 'rishabh4745', 'tambeneha94', 'rukhsrd', 'nair19shruti', 'happyridermrk', 'gadhiyakenil16', 'abauti608', 'sadiqqureshi393', 'rutu123', 'jiteshkjsp', 'aniketshelar79', 'sachimalkan', 'sgat3451', 'jaysawant2', 'tanuj.udani', 'ykhedikar', 'ishaan.sathe', 'mapethe', 'amruteshpatil', 'pateltejash96', 'ratsthegreat', 'tandelsneha15', 'doshi.kavisha16', 'tajpara.nikhil', 'miteshmohokar', 'g3jithinn', 'kapilaherkar755', 'sweta151945', 'dhairyagada1997', 'pruthavi.c', 'akansha319892', 'vjseedan', 'adityamodi009', 'vishal.chavda', 'nairprasad007', 'joshua0667', 'hardrider95', 'ankitferry123', 'priyankadeshpande177', 'hardik.upadhyay', '1jyotsna1', 'prasad.m', 'parmarmayur05', 'nikj816', 'smajumdar', 'rrnair291293', 'nikuldengada493', 'ankur.shah', 'princeporje98', 'suraj6111994', 'yogeshwar21121995', 'parthkaushikdave', 'nilesh.delekar', 'ameymalotkar1', 'prp23dec', 'pareshnaik1995', 'gopal.singh', 'nehaaltawade1', 's.jadeja', 'melchiznadar', 'poojaparab9035', 'nikhil4241307', 'pdeshpande', 'peshinakash', 'kiranjadhav050994', 'abinbenny8', 'ashupalambe1992', 'singhshashank97', 'abinaya67006', 'ajitjadhav', 'machalke92', 'yogi.6692', 'devyani.salvi1028', 'qwertynishit', 'verma.amitkumar95', 'florence9344', 'anuradha.d', 'satya_mishra', 'shraddhakharde01', 'inderjitsingh87', 'kypptl', 'lino2296', 'sharma.ayushi8c', 'sbodke', 'abarge31', 'aqudas29', 'khedikaryash8', 'naval29', 'tgpatil22791', 'vijaykothari97', 'pranithsuvarna1', 'mauryashubham564', 'vijaya', 'shaminakunnel', 'rahulbadekar', 'smonica498', 'arawal14.ar', 'raoashish96', 'parag.choughule', 'asingh12', 'parag16593', 'jigar', 'shivam_cr7', 'udit.shah', 'vishakha', 'tdholpuria', 'atoraskar12', 'mkadam03', 'walavalkarmayur79', 'ankitagharat93', 'somil910', 'aanugraha', 'shubhrapatil77', 'gkapil45', 'rushabh.soni', 'mayuripatil3095', 'tanujudani865', 'sonihetvi10', 'aniketa.yelave49', 'jadhavankita9969', 'sujataredkar', 'rautt59', 'rjoshi02', 'karankyp', 'adwaitvajpe', 'anevrekar', 'yayatipawar601', 'karantank97', 'akash.mali3477', 'akashmore456', 'surajkarade.2', 'pranav.gori', 'patilvarad2011', 'palak1012', 'apekshapawar', 'ramanujsingh004', 'keyur.gajjar', 'pranilghogale', 'pripatil285', 'desaivighnesh95', None, 'burhan.naim', 'd.shenoy', 'ashish.mrya1', 'malharvyas17.mv', 'ankith89', 'priyanka.bhangre', 'rutwijajoshi10', 'karanshah30', 'agarwal.gagan5101', 'anshujha95', 'vedy1811', 'chaitanyakhane999', 'tushar.gaikwad', 'gaurav.gadre', 'sourabhbelose', 'varun1997', 'abhiramibp95']"
49,42,20,114,1,['abarge31'],18,"['doshi.kavisha16', 'smonica498', 'arawal14.ar', 'varun1997', 'yashsavle', 'naval29', 'adityamodi009', 'vijaykothari97', 'prp23dec', 'malharvyas17.mv', 'karantank97', 'jaysawant2', 'sonihetvi10', 'tanuj.udani', 'dhairyagada1997', 'inderjitsingh87', 'singhshashank97', '1jyotsna1']",113,"['sankpalami', 'shrutikayadav2oct', 'dalvisayli', 'niraj901', 'ektarathod786', 'komalbapna.kb', 'dikshabafna1995', 'adipatil37', 'niteshnarkar712', 'omkarn049', 'sahilsk7', 'ahire.monali07', 'akshaybadhiye04', 'iabhishek555', 'pankajpawar1515', 'susmitaahirrao', 'vinit95vasudevan', 'umeshdarade77', 'tanayshinde21', 'infinite1309', 'pravin45', 'tejaskanagal95', 'minalsawant143', 'oindri.c', 'chaudharipayal50', 'shahyash027', 'rawletanmayee46', 'shraddha0306', 'sangeetamjoshi', 'mahajanabhi2201', 'mudrasjuee', 'vijaybhargude2', 'advenraju', 'abhihadshi', 'supu1796', 'sebastian007', 'pratikkhanore95', 'preetywagh95', 'gidayegirish', 'ashwini12rajput', 'shrikantnimse14', 'praju.avhad', 'gauravrajeshmehta', 'pbrahmapurkar', 'rakshu.gade', 'sam234bryant', 'swati123', 'sonalipawar589', 'saurabhmangeshkar', 'shrutisundar019', 'ratsthegreat', 'oma1811', 'ravina.chavan42', 'mukulsathe1995', 'bimal.biswas8', 'tarak.shah', 'rsawant2895', 'priyankaingle18', 'sumedh_patil', 'bondreanup007', 'rohitbaliyan53', 'a.j.yadav2395', 'chiragc9494', 'hbg2112', 'tanyabaptist05', 'bkadam357', 'manishashetye1295', 'abhishek.thavare', 'varadrajnanaware7', 'sardesai.kirti18', 'sammit1844', 'viveky803', 'tejasshinde8055', 'chaudharisuyash7', 'ru1795', 'sanketsalvi03', 'sandesh29', 'deven199570', 'priyagajakosh1', 'aashish.yadav94', 'amritamukeshb', 'pratikthorat10', 'jatin.dhande1008', 'lakumveer', 'aniket2602', 'aditya1818', 'shakyanandk', 'ramaprde2296', 'rushabh.fegade', 'akashspawar148', 'cpatil152', 'abhishekm2861996', 'ritesh.parulekar231194', 'sonawane.akshayak', 'vishakha1805', 'ptrimukhe32', 'dattaram.gawade781', 'sagarpawar', 'gsawant999', None, 'prajaktachapte2', 'nikhildubey02051996', 'sagarbhagat43', 'kaustubhgudekar9', 'prashant.baperkar', 'suman28pandit', 'danish.dev.007', 'rakeshmaity', 'saylishirodkar58', 'sayalipatil4545', 'rohanchavan', 'aishwaryamardhekar.24595', 'cooldudeakshu']",132,"['sankpalami', 'shrutikayadav2oct', 'yashsavle', 'dalvisayli', 'niraj901', 'ektarathod786', 'dikshabafna1995', 'adipatil37', 'niteshnarkar712', 'omkarn049', 'sahilsk7', 'ahire.monali07', 'vinit95vasudevan', 'minalsawant143', 'chaudharipayal50', 'shraddha0306', 'sangeetamjoshi', 'mudrasjuee', 'vijaybhargude2', 'sebastian007', 'ashwini12rajput', 'praju.avhad', 'jaysawant2', 'tanuj.udani', 'rakshu.gade', 'sam234bryant', 'sonalipawar589', 'ratsthegreat', 'oma1811', 'doshi.kavisha16', 'rsawant2895', 'sumedh_patil', 'a.j.yadav2395', 'dhairyagada1997', 'chiragc9494', 'hbg2112', 'varadrajnanaware7', 'viveky803', 'adityamodi009', 'tejasshinde8055', 'chaudharisuyash7', 'ru1795', 'deven199570', 'priyagajakosh1', 'aashish.yadav94', 'pratikthorat10', 'jatin.dhande1008', 'aniket2602', 'aditya1818', '1jyotsna1', 'sonawane.akshayak', 'sagarpawar', 'gsawant999', 'prajaktachapte2', 'nikhildubey02051996', 'prp23dec', 'danish.dev.007', 'saylishirodkar58', 'sayalipatil4545', 'aishwaryamardhekar.24595', 'singhshashank97', 'cooldudeakshu', 'komalbapna.kb', 'akshaybadhiye04', 'iabhishek555', 'pankajpawar1515', 'susmitaahirrao', 'umeshdarade77', 'tanayshinde21', 'infinite1309', 'pravin45', 'tejaskanagal95', 'inderjitsingh87', 'oindri.c', 'abarge31', 'naval29', 'vijaykothari97', 'shahyash027', 'rawletanmayee46', 'mahajanabhi2201', 'advenraju', 'abhihadshi', 'supu1796', 'pratikkhanore95', 'preetywagh95', 'smonica498', 'arawal14.ar', 'gidayegirish', 'shrikantnimse14', 'gauravrajeshmehta', 'pbrahmapurkar', 'swati123', 'saurabhmangeshkar', 'shrutisundar019', 'ravina.chavan42', 'mukulsathe1995', 'tarak.shah', 'priyankaingle18', 'sonihetvi10', 'bondreanup007', 'rohitbaliyan53', 'tanyabaptist05', 'bkadam357', 'manishashetye1295', 'abhishek.thavare', 'sardesai.kirti18', 'sammit1844', 'karantank97', 'sanketsalvi03', 'sandesh29', 'amritamukeshb', 'lakumveer', 'shakyanandk', 'ramaprde2296', 'rushabh.fegade', 'akashspawar148', 'cpatil152', 'abhishekm2861996', 'ritesh.parulekar231194', 'vishakha1805', 'dattaram.gawade781', None, 'malharvyas17.mv', 'sagarbhagat43', 'kaustubhgudekar9', 'prashant.baperkar', 'suman28pandit', 'rakeshmaity', 'rohanchavan', 'bimal.biswas8', 'varun1997', 'ptrimukhe32']"
49,51,20,67,1,['karantank97'],18,"['doshi.kavisha16', 'smonica498', 'arawal14.ar', 'varun1997', 'yashsavle', 'naval29', 'adityamodi009', 'vijaykothari97', 'prp23dec', 'malharvyas17.mv', 'jaysawant2', 'sonihetvi10', 'tanuj.udani', 'dhairyagada1997', 'inderjitsingh87', 'abarge31', 'singhshashank97', '1jyotsna1']",66,"['danishdewani112795', 'ishita.choudhary', 'rushabh.soni', 'chiragc9494', 'arunnambiar66', 'maithili010', 'raku1109', 'jogichetan96', 'akshaybangera95', 'suthar.kalpesh57', 'sjunghareakshay', 'soorajdinesan27', 'harshit0610', 'trishapatkar19', 'alisha.alice.panicker', 'apoorvakraut', 'zeuswinchester456', 'shraddhakharde01', 'priyankapandya19', 'nivipetkar', 'doshishrut1995', 'akashmore456', 'omkardalvi409', 'shubhamjambhe8', 'manisha.shetty07', 'jayeshkhandagle123', 'kiranrelekar412', 'dhvanilmandalia29', 'varma096', 'ranjuvarughese', 'himanshuphatak98', 'shukla.pawan249', 'jaidevdalvi', 'sarveshgrao', 'kanchan.sawant17', 'rhea.ann.95', 'shubhangi.matey', 'pranilraut17', 'anuragshyam1026', 'ajthamke40', 'rashuidiot', 'jitesh.10', 'akshay1995', 'kambe302', 'akanksha0196', 'ayyappakonar', 'jenna', 'shafaanbhai', 'ttanmay.telang75', None, 'shevekarrohan', 'shrinathnair', 'sahil8rai', 'deepikachaman3', 'd.shenoy', 'salman23011996', 'varadmeradost', 'asingh12', 'chandramani.yadav43', 'darshanadaund27', 'srishti.shriyan96', 'tejask2610', 'vivek.sakinala', 'upadhyechinmay', 'joijodegauri7', 'dishakulkarni25']",85,"['yashsavle', 'raku1109', 'jogichetan96', 'sjunghareakshay', 'apoorvakraut', 'shraddhakharde01', 'doshishrut1995', 'inderjitsingh87', 'manisha.shetty07', 'jayeshkhandagle123', 'abarge31', 'ranjuvarughese', 'himanshuphatak98', 'naval29', 'rhea.ann.95', 'vijaykothari97', 'anuragshyam1026', 'ajthamke40', 'rashuidiot', 'jitesh.10', 'akshay1995', 'kambe302', 'shafaanbhai', 'sahil8rai', 'smonica498', 'arawal14.ar', 'varadmeradost', 'asingh12', 'jaysawant2', 'tanuj.udani', 'darshanadaund27', 'vivek.sakinala', 'jenna', 'jaidevdalvi', 'doshi.kavisha16', 'danishdewani112795', 'ishita.choudhary', 'singhshashank97', 'rushabh.soni', 'sonihetvi10', 'dhairyagada1997', 'arunnambiar66', 'chiragc9494', 'maithili010', 'akshaybangera95', 'suthar.kalpesh57', 'soorajdinesan27', 'harshit0610', 'trishapatkar19', 'alisha.alice.panicker', 'adityamodi009', 'zeuswinchester456', 'karantank97', 'priyankapandya19', 'nivipetkar', 'akashmore456', 'omkardalvi409', 'shubhamjambhe8', 'kiranrelekar412', 'dhvanilmandalia29', 'varma096', 'shukla.pawan249', '1jyotsna1', 'sarveshgrao', 'kanchan.sawant17', 'shubhangi.matey', 'pranilraut17', 'akanksha0196', 'ayyappakonar', 'ttanmay.telang75', None, 'shevekarrohan', 'shrinathnair', 'deepikachaman3', 'd.shenoy', 'salman23011996', 'prp23dec', 'malharvyas17.mv', 'chandramani.yadav43', 'srishti.shriyan96', 'tejask2610', 'upadhyechinmay', 'joijodegauri7', 'varun1997', 'dishakulkarni25']"
49,40,20,30,2,"['smonica498', 'prp23dec']",17,"['doshi.kavisha16', 'arawal14.ar', 'varun1997', 'yashsavle', 'naval29', 'adityamodi009', 'vijaykothari97', 'malharvyas17.mv', 'karantank97', 'jaysawant2', 'sonihetvi10', 'tanuj.udani', 'dhairyagada1997', 'inderjitsingh87', 'abarge31', 'singhshashank97', '1jyotsna1']",28,"['mukulsathe1995', 'bondreanup007', 'tanyabaptist05', 'a.j.yadav2395', 'hbg2112', 'anasnaik25', 'shriya.h.joshi', 'anujakhose94', 'akshaybadhiye04', 'iabhishek555', 'sanketsalvi03', 'shreyamath95', 'shakyanandk', 'arpit32', 'parmitbanga1995', 'shraddha0306', 'ritesh.parulekar231194', 'vaibhavghare94', 'neilmundhe', 'heramb10', 'sagarpawar', None, 'sebastian007', 'prajaktachapte2', 'patelu997', 'mohiteashwin7', 'mapethe', 'ratsthegreat']",47,"['doshi.kavisha16', 'mukulsathe1995', 'yashsavle', 'singhshashank97', 'sonihetvi10', 'bondreanup007', 'tanyabaptist05', 'dhairyagada1997', 'a.j.yadav2395', 'hbg2112', 'anasnaik25', 'shriya.h.joshi', 'anujakhose94', 'akshaybadhiye04', 'adityamodi009', 'iabhishek555', 'karantank97', 'sanketsalvi03', 'inderjitsingh87', 'shreyamath95', 'abarge31', 'naval29', '1jyotsna1', 'shakyanandk', 'arpit32', 'parmitbanga1995', 'vijaykothari97', 'shraddha0306', 'ritesh.parulekar231194', 'vaibhavghare94', 'neilmundhe', 'heramb10', 'sagarpawar', None, 'sebastian007', 'smonica498', 'arawal14.ar', 'prajaktachapte2', 'patelu997', 'prp23dec', 'malharvyas17.mv', 'jaysawant2', 'tanuj.udani', 'mohiteashwin7', 'mapethe', 'varun1997', 'ratsthegreat']"
49,39,20,23,8,"['doshi.kavisha16', 'naval29', 'adityamodi009', 'malharvyas17.mv', 'tanuj.udani', 'inderjitsingh87', 'singhshashank97', '1jyotsna1']",11,"['smonica498', 'arawal14.ar', 'yashsavle', 'vijaykothari97', 'prp23dec', 'karantank97', 'jaysawant2', 'sonihetvi10', 'dhairyagada1997', 'abarge31', 'varun1997']",15,"['kenilgadhiya', 'vaibhav206rsm', 'dhruvinacharya19', 'aayushtiwari16', 'viraktdoshi19', 'raj010rocks', 'gadhiyakenil16', 'poojaparab9035', 'jigar.ramin786', 'varunj331', 'mapethe', 'kailashpatel0000', 'heramb10', 'siddhantssangal', None]",34,"['doshi.kavisha16', 'kenilgadhiya', 'yashsavle', 'singhshashank97', 'sonihetvi10', 'dhairyagada1997', 'adityamodi009', 'viraktdoshi19', 'karantank97', 'inderjitsingh87', 'kailashpatel0000', 'abarge31', 'naval29', '1jyotsna1', 'dhruvinacharya19', 'aayushtiwari16', 'vijaykothari97', 'raj010rocks', 'gadhiyakenil16', 'jigar.ramin786', 'heramb10', None, 'smonica498', 'arawal14.ar', 'vaibhav206rsm', 'prp23dec', 'malharvyas17.mv', 'poojaparab9035', 'jaysawant2', 'tanuj.udani', 'varunj331', 'mapethe', 'siddhantssangal', 'varun1997']"
49,59,20,22,12,"['doshi.kavisha16', 'smonica498', 'arawal14.ar', 'yashsavle', 'adityamodi009', 'vijaykothari97', 'prp23dec', 'jaysawant2', 'sonihetvi10', 'tanuj.udani', 'varun1997', '1jyotsna1']",7,"['malharvyas17.mv', 'karantank97', 'dhairyagada1997', 'inderjitsingh87', 'abarge31', 'singhshashank97', 'naval29']",10,"['adwaitvajpe', 'ckargutkar96', 'nimisha.nimisha.agarwal', 'meetgopani616', 'mpethe22', 'janhvi.vora97', 'bangasunain', 'agarwal.gagan5101', None, 'poojamenon16.pm']",29,"['doshi.kavisha16', 'nimisha.nimisha.agarwal', 'yashsavle', 'singhshashank97', 'mpethe22', 'janhvi.vora97', 'sonihetvi10', 'dhairyagada1997', 'adwaitvajpe', 'ckargutkar96', 'adityamodi009', 'karantank97', 'inderjitsingh87', 'abarge31', 'poojamenon16.pm', 'naval29', '1jyotsna1', 'vijaykothari97', 'bangasunain', None, 'smonica498', 'arawal14.ar', 'meetgopani616', 'prp23dec', 'malharvyas17.mv', 'jaysawant2', 'tanuj.udani', 'agarwal.gagan5101', 'varun1997']"
49,57,20,9,2,"['jaysawant2', '1jyotsna1']",17,"['doshi.kavisha16', 'smonica498', 'arawal14.ar', 'varun1997', 'yashsavle', 'adityamodi009', 'vijaykothari97', 'prp23dec', 'malharvyas17.mv', 'karantank97', 'sonihetvi10', 'tanuj.udani', 'dhairyagada1997', 'inderjitsingh87', 'abarge31', 'singhshashank97', 'naval29']",7,"['mananshah30137', 'riddhis2411', 'roycefernandes80', 'yashdani90', 'varunswadia', None, 'auraproductions786']",26,"['doshi.kavisha16', 'riddhis2411', 'yashsavle', 'naval29', 'vijaykothari97', 'roycefernandes80', 'sonihetvi10', 'dhairyagada1997', 'mananshah30137', 'varunswadia', 'varun1997', None, 'smonica498', 'arawal14.ar', 'adityamodi009', 'prp23dec', 'malharvyas17.mv', 'karantank97', 'jaysawant2', 'tanuj.udani', 'inderjitsingh87', 'yashdani90', 'abarge31', 'singhshashank97', 'auraproductions786', '1jyotsna1']"
49,61,20,8,2,"['singhshashank97', 'varun1997']",17,"['doshi.kavisha16', 'smonica498', 'arawal14.ar', 'yashsavle', 'naval29', 'adityamodi009', 'vijaykothari97', 'prp23dec', 'malharvyas17.mv', 'karantank97', 'jaysawant2', 'sonihetvi10', 'tanuj.udani', 'dhairyagada1997', 'inderjitsingh87', 'abarge31', '1jyotsna1']",6,"['riddhis2411', 'yashdani96', 'jenna', 'shriya.h.joshi', 'smithnano15', None]",25,"['doshi.kavisha16', 'riddhis2411', 'yashsavle', 'naval29', 'vijaykothari97', 'sonihetvi10', 'dhairyagada1997', 'yashdani96', 'shriya.h.joshi', 'smithnano15', 'varun1997', None, 'smonica498', 'arawal14.ar', 'adityamodi009', 'prp23dec', 'malharvyas17.mv', 'karantank97', 'jaysawant2', 'tanuj.udani', 'inderjitsingh87', 'jenna', 'abarge31', 'singhshashank97', '1jyotsna1']"
49,54,20,6,1,['abarge31'],18,"['doshi.kavisha16', 'smonica498', 'arawal14.ar', 'varun1997', 'yashsavle', 'naval29', 'adityamodi009', 'vijaykothari97', 'prp23dec', 'malharvyas17.mv', 'karantank97', 'jaysawant2', 'sonihetvi10', 'tanuj.udani', 'dhairyagada1997', 'inderjitsingh87', 'singhshashank97', '1jyotsna1']",5,"['nijamkureshi2894', 'suryatejachitturi', 'spooja.1430', 'aparnaahari95', None]",24,"['doshi.kavisha16', 'nijamkureshi2894', 'yashsavle', 'naval29', 'vijaykothari97', 'suryatejachitturi', 'sonihetvi10', 'dhairyagada1997', 'spooja.1430', 'varun1997', None, 'smonica498', 'arawal14.ar', 'adityamodi009', 'prp23dec', 'malharvyas17.mv', 'karantank97', 'jaysawant2', 'tanuj.udani', 'inderjitsingh87', 'aparnaahari95', 'abarge31', 'singhshashank97', '1jyotsna1']"
49,58,20,6,2,"['smonica498', 'inderjitsingh87']",17,"['doshi.kavisha16', 'arawal14.ar', 'varun1997', 'yashsavle', 'naval29', 'adityamodi009', 'vijaykothari97', 'prp23dec', 'malharvyas17.mv', 'karantank97', 'jaysawant2', 'sonihetvi10', 'tanuj.udani', 'dhairyagada1997', 'abarge31', 'singhshashank97', '1jyotsna1']",4,"['ckargutkar96', None, 'poojamenon16.pm', 'sahilsg.1995']",23,"['doshi.kavisha16', 'yashsavle', 'naval29', 'vijaykothari97', 'sonihetvi10', 'dhairyagada1997', 'varun1997', None, 'smonica498', 'arawal14.ar', 'ckargutkar96', 'adityamodi009', 'prp23dec', 'malharvyas17.mv', 'karantank97', 'jaysawant2', 'tanuj.udani', 'sahilsg.1995', 'inderjitsingh87', 'abarge31', 'singhshashank97', 'poojamenon16.pm', '1jyotsna1']"
50,252,20,38,16,"['izak.baranowski', 'achakr19', 'lunajlt', 'vasu_hermy', 'airuday1', 'mhan25', 'mdhumwad', 'lawrencedk716', 'aveerai1', 'bonecrusher', 'shaikhsaif', 'mpattana', 'shiladityadas19', 'txun1', 'hbalaji', 'maggiezhu0907']",3,"['akesturs', 'bulkyblue1', 'jchen224']",22,"['saketharamv', 'ionman1968', 'morugant23', 'minaldhumwad', 'aphrodite9825', 'ayadav17', 'hemanth90eee', 'apeter18', 'cwang239', 'pryan2', 'stummal3', 'gdasari', 'abhinanoasu', None, 'morugant', 'amsharm1', 'svarade', 'ninad.chamele', 'dvasileska', 'navnano1034', 'appellizzaro0002', 'vramarat']",41,"['saketharamv', 'vasu_hermy', 'ionman1968', 'mhan25', 'mdhumwad', 'bonecrusher', 'mpattana', 'shiladityadas19', 'bulkyblue1', 'hbalaji', 'morugant23', 'izak.baranowski', 'minaldhumwad', 'airuday1', 'aphrodite9825', 'ayadav17', 'hemanth90eee', 'apeter18', 'cwang239', 'pryan2', 'stummal3', 'lunajlt', 'gdasari', 'lawrencedk716', 'akesturs', 'abhinanoasu', 'txun1', 'jchen224', 'maggiezhu0907', None, 'morugant', 'achakr19', 'amsharm1', 'svarade', 'aveerai1', 'shaikhsaif', 'ninad.chamele', 'dvasileska', 'navnano1034', 'appellizzaro0002', 'vramarat']"
50,286,20,20,14,"['izak.baranowski', 'achakr19', 'vasu_hermy', 'airuday1', 'mhan25', 'mdhumwad', 'lawrencedk716', 'aveerai1', 'bonecrusher', 'mpattana', 'shiladityadas19', 'txun1', 'hbalaji', 'maggiezhu0907']",5,"['lunajlt', 'akesturs', 'shaikhsaif', 'bulkyblue1', 'jchen224']",6,"['amsharm1', 'svarade', 'ilivings2016', 'aphrodite9825', None, 'cwang239']",25,"['vasu_hermy', 'mhan25', 'mdhumwad', 'bonecrusher', 'mpattana', 'shiladityadas19', 'bulkyblue1', 'hbalaji', 'izak.baranowski', 'airuday1', 'aphrodite9825', 'cwang239', 'lunajlt', 'lawrencedk716', 'ilivings2016', 'akesturs', 'txun1', 'jchen224', 'maggiezhu0907', None, 'achakr19', 'amsharm1', 'aveerai1', 'shaikhsaif', 'svarade']"
51,293,19,24,15,"['valentinasandovalb', 'sergioalvarez12', 'juanma.lovera', 'lufergo127', 'jfsalcedo10', 'materiales', 'calopo', 'ddprojas11', 'david.paez1997', 'jzorroperez', 'jairomisterio', 'julianvelasquez96', 'mangomela', 'jj.garcia10', 'henryr9708']",3,"['cd.florez10', 'korkies22', 's.arevalo26']",9,"['jorge_iguaran97', 'dapabon10', 'jvalderram28', 'paannamo97', 'maespinosa0794', 'federicoalvarez1226', 'camon93', 'orionsebastian', None]",27,"['juanma.lovera', 'jvalderram28', 'david.paez1997', 'federicoalvarez1226', 'dapabon10', 'jfsalcedo10', 'lufergo127', 'paannamo97', 'maespinosa0794', 'mangomela', 'jj.garcia10', 'henryr9708', 's.arevalo26', 'korkies22', 'materiales', 'camon93', 'jairomisterio', 'orionsebastian', None, 'jorge_iguaran97', 'valentinasandovalb', 'sergioalvarez12', 'calopo', 'ddprojas11', 'cd.florez10', 'jzorroperez', 'julianvelasquez96']"
51,165,19,22,16,"['valentinasandovalb', 'sergioalvarez12', 'juanma.lovera', 'lufergo127', 'jfsalcedo10', 'materiales', 'calopo', 'ddprojas11', 'david.paez1997', 'cd.florez10', 'jzorroperez', 'jairomisterio', 'julianvelasquez96', 'mangomela', 'jj.garcia10', 'henryr9708']",2,"['korkies22', 's.arevalo26']",6,"['jorge_iguaran97', 'jvalderram28', 'davidan_pino', 'camon93', None, 'f.m.durangouribe']",24,"['juanma.lovera', 'jvalderram28', 'david.paez1997', 'f.m.durangouribe', 'jfsalcedo10', 'lufergo127', 'mangomela', 'jj.garcia10', 'henryr9708', 's.arevalo26', 'korkies22', 'materiales', 'davidan_pino', 'camon93', 'jairomisterio', None, 'jorge_iguaran97', 'valentinasandovalb', 'sergioalvarez12', 'calopo', 'ddprojas11', 'cd.florez10', 'jzorroperez', 'julianvelasquez96']"
52,65,19,13,11,"['armen27', 'monibanwar', 'daiki.k.1211.graupel', 'sam.sum41', 'robinhood15031503', 'carlvtreskow', 'tianheran', 'jobuc', 'chuanc', 'bjornchristensen', 'emrichely']",7,"['jinchoi87', 'lricci', 'bestkaktarua', 'hasanm', 'phywangx', 'carlvt', 'akoshelev']",2,"['yasun', None]",20,"['armen27', 'bestkaktarua', 'daiki.k.1211.graupel', 'yasun', 'carlvt', 'carlvtreskow', 'tianheran', 'chuanc', 'emrichely', None, 'jinchoi87', 'lricci', 'monibanwar', 'hasanm', 'phywangx', 'sam.sum41', 'robinhood15031503', 'jobuc', 'bjornchristensen', 'akoshelev']"
53,102,19,49,4,"['j.joshuayang', 'raghidnaji1', 'fsaifullah', 'cpandiscio']",14,"['ravikumarkunchala48', 'kkeskinbora', 'carrillo', 'pmrv', 'anvasiliev52', 'zuoanwuwu', 'danymeza96', 'jgiouse2', 'edgestormer', 'anselme900', 'cjiitb', 'echo_rashad', 'sfu2', 'ricko1990']",45,"['tbaim', 'tianxinchen', 'haoxianlin', 'davidchen123', 'stevenmcgrat', 'jasonnguyen', 'kgeorgadarel5', 'ctimmerman', 'abecirovic', 'dkurpaska', 'amajee', 'bivaldi', 'astam', 'jkline', 'gbayides', 'aksamija', 'tdcosta', 'chunkaiwong', 'coleman.j.ryan', 'cblewis', 'dmathieu', 'mzeimbekakis', 'ajabraha', 'cwijesundara', 'rward', 'daviddowns', 'nspaine', 'dvnguyen', 'jlagasse', 'nkorniyenko', 'ssproviero', 'jpetrovick', None, 'matthewdonne141', 'lluchetti', 'emailhot', 'mshliselberg', 'eajenkins', 'inwilliams', 'suoangao', 'jjpenney', 'bifisher', 'siyuwu', 'mpool', 'sjpatel']",63,"['tianxinchen', 'pmrv', 'stevenmcgrat', 'kgeorgadarel5', 'fsaifullah', 'cjiitb', 'abecirovic', 'dkurpaska', 'bivaldi', 'ricko1990', 'gbayides', 'raghidnaji1', 'ajabraha', 'cwijesundara', 'daviddowns', 'kkeskinbora', 'zuoanwuwu', 'danymeza96', 'jlagasse', 'nkorniyenko', 'ssproviero', 'ravikumarkunchala48', 'emailhot', 'mshliselberg', 'suoangao', 'jjpenney', 'sjpatel', 'tbaim', 'haoxianlin', 'davidchen123', 'jasonnguyen', 'jgiouse2', 'ctimmerman', 'amajee', 'jkline', 'astam', 'aksamija', 'anvasiliev52', 'tdcosta', 'chunkaiwong', 'coleman.j.ryan', 'anselme900', 'cblewis', 'dmathieu', 'mzeimbekakis', 'rward', 'carrillo', 'nspaine', 'dvnguyen', 'edgestormer', 'jpetrovick', None, 'matthewdonne141', 'lluchetti', 'eajenkins', 'inwilliams', 'bifisher', 'siyuwu', 'mpool', 'j.joshuayang', 'cpandiscio', 'echo_rashad', 'sfu2']"
54,146,18,19,15,"['chalinomendez', 'vgallardo2', 'chimera4373', 'jezamora92', 'rnava', 'reefaldayafleh', 'bleavy94', 'closecombat58', 'jeffreynambayan', 'alexnguyen259', 'dmartinez4', 'jesikasaucedo00927', 'allan.chio', 'abains5', 'joshuacernas']",2,"['alisamae23', 'mpatel26']",4,"['jinder2103', None, 'lewong27', 'gdligunas']",21,"['vgallardo2', 'chimera4373', 'jezamora92', 'rnava', 'reefaldayafleh', 'bleavy94', 'closecombat58', 'jeffreynambayan', 'alexnguyen259', 'lewong27', 'alisamae23', 'abains5', 'joshuacernas', None, 'chalinomendez', 'dmartinez4', 'jesikasaucedo00927', 'gdligunas', 'allan.chio', 'mpatel26', 'jinder2103']"
55,133,18,33,17,"['narasaka', 'miyagi', 'g1415078', 'yoyossi22', 'y.shimizu', 'im_prame_', 'deepdive', 'yosiki', 'g1315091', 'marui', 'niiken1995', 'g1415007', 'ebi', 'g1415037', 'g1315098', 'g1415104', 'ny0602']",0,[],16,"['sora1415', 'g1415109', 'hira1', 'g1415090', 'seninnn', 'naturally.curly.hair.ken', 'yuutazaku', 'ducniisan', 'g1415064', 'g1415105', 'g1415070', 'arcadia5580', None, 'inumarugyakuten11', 'g1415106', 'g1415026']",33,"['yoyossi22', 'g1415090', 'g1315091', 'yosiki', 'marui', 'ducniisan', 'ebi', 'g1415106', 'sora1415', 'g1415109', 'g1415105', 'niiken1995', 'g1415070', 'arcadia5580', 'g1315098', 'g1415026', 'narasaka', 'miyagi', 'g1415078', 'seninnn', 'im_prame_', 'deepdive', 'g1415007', 'g1415037', None, 'ny0602', 'hira1', 'y.shimizu', 'naturally.curly.hair.ken', 'yuutazaku', 'g1415064', 'g1415104', 'inumarugyakuten11']"
55,255,18,28,17,"['narasaka', 'miyagi', 'g1415078', 'yoyossi22', 'y.shimizu', 'im_prame_', 'deepdive', 'yosiki', 'g1315091', 'marui', 'niiken1995', 'g1415007', 'ebi', 'g1415037', 'g1315098', 'g1415104', 'ny0602']",0,[],11,"['sora1415', 'g1415109', 'g1415090', 'naturally.curly.hair.ken', 'yuutazaku', 'ducniisan', 'g1415070', 'arcadia5580', None, 'inumarugyakuten11', 'g1415106']",28,"['yoyossi22', 'g1415090', 'g1315091', 'yosiki', 'marui', 'ducniisan', 'ebi', 'g1415106', 'sora1415', 'g1415109', 'niiken1995', 'g1415070', 'arcadia5580', 'g1315098', 'narasaka', 'miyagi', 'g1415078', 'im_prame_', 'deepdive', 'g1415007', 'g1415037', None, 'ny0602', 'y.shimizu', 'naturally.curly.hair.ken', 'yuutazaku', 'g1415104', 'inumarugyakuten11']"
55,114,18,20,17,"['narasaka', 'miyagi', 'g1415078', 'yoyossi22', 'y.shimizu', 'im_prame_', 'deepdive', 'yosiki', 'g1315091', 'marui', 'niiken1995', 'g1415007', 'ebi', 'g1415037', 'g1315098', 'g1415104', 'ny0602']",0,[],3,"['hira1', 'g1415109', None]",20,"['narasaka', 'yoyossi22', 'miyagi', 'g1415078', 'im_prame_', 'deepdive', 'yosiki', 'g1315091', 'marui', 'g1415007', 'ebi', 'g1415037', None, 'ny0602', 'hira1', 'g1415109', 'y.shimizu', 'niiken1995', 'g1315098', 'g1415104']"
56,100,18,11,1,['liffland'],16,"['jeweldsa', 'iassiddhartha001', 'vishpbharadwaj', 'kjmosier62', 'kgish', 'jie7', 'smihirranjan', 'rbnmthw62', 'sxiexie', 'manju.kohalli08', 'vveralla', 'alf2000', 'cindylu0501', 'u13194242', 'zweinrich', 'raallen4']",10,"['jwfrenc2', 'mkmoody', 'djblivin', 'eklump', 'jaconno2', 'brennerncsuedu', 'abmcginn', 'taleona3', None, 'gwcrego']",27,"['vishpbharadwaj', 'liffland', 'djblivin', 'jie7', 'smihirranjan', 'rbnmthw62', 'sxiexie', 'vveralla', 'eklump', 'jaconno2', 'brennerncsuedu', 'cindylu0501', 'u13194242', 'taleona3', 'zweinrich', 'gwcrego', None, 'jeweldsa', 'jwfrenc2', 'iassiddhartha001', 'mkmoody', 'kjmosier62', 'kgish', 'manju.kohalli08', 'alf2000', 'abmcginn', 'raallen4']"
57,207,17,132,16,"['adigame18', 'nikhildabholkar4', 'rohinipatil404', 'infinite2205', 'khadekunal1', 'sandeeprock023', 'sahilshaikh827', 'shreyashpawar96', 'sagar.pawar35418', 'mongya00', 'dattaramkolekar', 'shubhambeldar547', 'aniketkulaye618', 'bk357357', 'ambeskaradvait', 'vaibhavgaikar62']",0,[],116,"['dalvisayli', 'niraj901', 'ektarathod786', 'dikshabafna1995', 'kadamk008', 'omkarn049', 'ahire.monali07', 'brian200495', 'vinit95vasudevan', 'dhartinano19', 'saurabh.gharat96', 'sailee.mohite', 'suyogk.1995', 'nehah95', 'chaudharipayal50', 'dandekarmd73', 'tanayshinde123', 'sangeetamjoshi', 'mudrasjuee', 'sebastian007', 'praju.avhad', 'rakshu.gade', 'snehawaghe21', 'sid.rane95', 'sonalipawar589', 'ratsthegreat', 'oma1811', 'rahulmhapsekar7', 'sumedh_patil', 'a.j.yadav2395', 'chiragc9494', 'hbg2112', 'bhakti961', 'kumarrahul050892', 'viveky803', 'yashapeejay', 'manasi.shinde008', 'chaudharisuyash7', 'ru1795', 'deven199570', 'priyagajakosh1', 'aashish.yadav94', 'spranav3004', 'jatin.dhande1008', 'priyankakamble', 'manalihedaoo4', 'pranilraut17', 'shivamchaube', 'sonawane.akshayak', 'spooja.1430', 'sagarpawar', 'nikitamalvade', 'nikhildubey02051996', 'mitesh.dangle', 'danish.dev.007', 'saylishirodkar58', 'sayalipatil4545', 'aishwaryamardhekar.24595', 'cooldudeakshu', 'snehakudtarkar315', 'komalbapna.kb', 'viprajapatil', 'aniketmane42', 'akshaybadhiye04', 'iabhishek555', 'susmitaahirrao', 'pravin45', 'tejaskanagal95', 'oindri.c', 'kondekar23', 'poojavagre12', 'mihirsawant17', 'parmitbanga1995', 'shahyash027', 'ajthamke40', 'mishrahenry007', 'abhihadshi', 'pratikkhanore95', 'srikalaprabhu', 'gidayegirish', 'gauravrajeshmehta', 'codekidx', 'pbrahmapurkar', 'vinodgadge95', 'prathameshptkr4', 'saurabhmangeshkar', 'mukulsathe1995', 'priyankaingle18', 'palswati0309', 'bondreanup007', 'rohitbaliyan53', 'manishashetye1295', 'abhishek.thavare', 'sardesai.kirti18', 'amritamukeshb', 'shakyanandk', 'ramaprde2296', 'rushabh.fegade', 'ameypatil29', 'vishakha1805', 'abhishekm2861996', 'dattaram.gawade781', None, 'salman23011996', 'ssy506804', 'vaibhav.gangan7', 'sawantgaurig25', 'siddhiambre111', 'sagarbhagat43', 'kaustubhgudekar9', 'namrata05', 'suman28pandit', 'chandraman.patil', 'rakeshmaity', 'pranay9.ithawar', 'rohanchavan']",132,"['dalvisayli', 'niraj901', 'ektarathod786', 'khadekunal1', 'dikshabafna1995', 'kadamk008', 'omkarn049', 'sagar.pawar35418', 'ahire.monali07', 'brian200495', 'infinite2205', 'vinit95vasudevan', 'dhartinano19', 'saurabh.gharat96', 'sailee.mohite', 'suyogk.1995', 'nehah95', 'chaudharipayal50', 'dandekarmd73', 'tanayshinde123', 'sangeetamjoshi', 'mudrasjuee', 'sebastian007', 'nikhildabholkar4', 'praju.avhad', 'rakshu.gade', 'snehawaghe21', 'sid.rane95', 'sonalipawar589', 'ratsthegreat', 'oma1811', 'rahulmhapsekar7', 'sumedh_patil', 'a.j.yadav2395', 'chiragc9494', 'hbg2112', 'bhakti961', 'kumarrahul050892', 'viveky803', 'sandeeprock023', 'yashapeejay', 'manasi.shinde008', 'chaudharisuyash7', 'ru1795', 'deven199570', 'priyagajakosh1', 'aashish.yadav94', 'ambeskaradvait', 'spranav3004', 'jatin.dhande1008', 'priyankakamble', 'manalihedaoo4', 'pranilraut17', 'shivamchaube', 'sonawane.akshayak', 'mongya00', 'dattaramkolekar', 'spooja.1430', 'sagarpawar', 'nikitamalvade', 'nikhildubey02051996', 'mitesh.dangle', 'danish.dev.007', 'saylishirodkar58', 'sayalipatil4545', 'aishwaryamardhekar.24595', 'cooldudeakshu', 'snehakudtarkar315', 'komalbapna.kb', 'viprajapatil', 'aniketmane42', 'akshaybadhiye04', 'iabhishek555', 'susmitaahirrao', 'pravin45', 'tejaskanagal95', 'aniketkulaye618', 'bk357357', 'oindri.c', 'kondekar23', 'poojavagre12', 'mihirsawant17', 'adigame18', 'parmitbanga1995', 'shahyash027', 'ajthamke40', 'mishrahenry007', 'shreyashpawar96', 'abhihadshi', 'pratikkhanore95', 'srikalaprabhu', 'gidayegirish', 'gauravrajeshmehta', 'codekidx', 'pbrahmapurkar', 'vinodgadge95', 'shubhambeldar547', 'prathameshptkr4', 'saurabhmangeshkar', 'mukulsathe1995', 'priyankaingle18', 'palswati0309', 'bondreanup007', 'rohitbaliyan53', 'manishashetye1295', 'abhishek.thavare', 'sardesai.kirti18', 'amritamukeshb', 'shakyanandk', 'ramaprde2296', 'rushabh.fegade', 'sahilshaikh827', 'ameypatil29', 'vishakha1805', 'abhishekm2861996', 'dattaram.gawade781', None, 'salman23011996', 'ssy506804', 'vaibhav.gangan7', 'sawantgaurig25', 'rohinipatil404', 'siddhiambre111', 'sagarbhagat43', 'kaustubhgudekar9', 'namrata05', 'suman28pandit', 'chandraman.patil', 'rakeshmaity', 'pranay9.ithawar', 'rohanchavan', 'vaibhavgaikar62']"
58,241,17,17,16,"['19af34966', 'josiereed123', 'catherineott', 'maggie.shutts', 'emg15', 'kesan2018', 'aliciarepka', 'ambered', 'sarah33', 'jjmcgormley', 'mtanna', 'dunya', 'micluebbers11', 'arenee', 'eliannaqk', 'laurenris7539']",0,[],1,[None],17,"['maggie.shutts', 'jjmcgormley', 'micluebbers11', 'arenee', None, 'eliannaqk', '19af34966', 'josiereed123', 'catherineott', 'emg15', 'kesan2018', 'aliciarepka', 'ambered', 'sarah33', 'mtanna', 'dunya', 'laurenris7539']"
59,311,17,7,6,"['seanblanford', 'stephenarndt', 'eg', 'vwinter', 'nashw', 'xloving']",10,"['zfalender', 'noa7akk', 'maljaran', 'zfisk94', 'brown804', 'jordi.fraxedas', 'rkordana', 'jain131', 'grote1', 'craftt']",1,[None],17,"['zfalender', 'noa7akk', 'maljaran', 'zfisk94', 'jordi.fraxedas', 'grote1', 'stephenarndt', 'vwinter', 'xloving', None, 'seanblanford', 'brown804', 'eg', 'rkordana', 'jain131', 'nashw', 'craftt']"
60,72,17,24,15,"['savs413', 'dcfreak77', 'vryan', 'oclevela', 'kgresko', 'st0212jones', 'jharri54.villanova', 'wpahiakos', 'fmarti13', 'mevans33', 'glopez4', 'talgarin', 'ryangreen52', 'besposi1', 'frazer34']",1,['jwong13'],9,"['chris_teti', 'bconte', 'mjupina', 'pragti.narang', 'dbruno6', 'chartig1', 'achandec', None, 'jgaliano']",25,"['chris_teti', 'achandec', 'wpahiakos', 'mevans33', 'savs413', 'talgarin', 'kgresko', 'frazer34', 'st0212jones', 'mjupina', 'pragti.narang', 'besposi1', 'jgaliano', 'vryan', 'oclevela', 'bconte', 'chartig1', None, 'ryangreen52', 'dcfreak77', 'jharri54.villanova', 'jwong13', 'fmarti13', 'dbruno6', 'glopez4']"
60,77,17,22,16,"['savs413', 'dcfreak77', 'vryan', 'oclevela', 'kgresko', 'st0212jones', 'jharri54.villanova', 'wpahiakos', 'jwong13', 'fmarti13', 'mevans33', 'glopez4', 'talgarin', 'ryangreen52', 'besposi1', 'frazer34']",0,[],6,"['chris_teti', 'deanbruno', 'bconte8', 'chartig1', 'pritpals', None]",22,"['chris_teti', 'wpahiakos', 'mevans33', 'savs413', 'talgarin', 'kgresko', 'frazer34', 'deanbruno', 'st0212jones', 'pritpals', 'besposi1', 'vryan', 'oclevela', 'bconte8', 'chartig1', None, 'ryangreen52', 'dcfreak77', 'jharri54.villanova', 'jwong13', 'fmarti13', 'glopez4']"
60,282,17,20,16,"['savs413', 'dcfreak77', 'vryan', 'oclevela', 'kgresko', 'st0212jones', 'jharri54.villanova', 'wpahiakos', 'jwong13', 'fmarti13', 'mevans33', 'glopez4', 'talgarin', 'ryangreen52', 'besposi1', 'frazer34']",0,[],4,"[None, 'chris_teti', 'deanbruno', 'mjupina']",20,"['chris_teti', 'vryan', 'oclevela', 'wpahiakos', 'mevans33', 'savs413', 'talgarin', None, 'ryangreen52', 'kgresko', 'frazer34', 'deanbruno', 'dcfreak77', 'st0212jones', 'jharri54.villanova', 'mjupina', 'jwong13', 'fmarti13', 'glopez4', 'besposi1']"
60,253,17,19,15,"['savs413', 'dcfreak77', 'vryan', 'oclevela', 'kgresko', 'jharri54.villanova', 'wpahiakos', 'jwong13', 'fmarti13', 'mevans33', 'glopez4', 'talgarin', 'ryangreen52', 'besposi1', 'frazer34']",1,['st0212jones'],4,"['achandec', None, 'dbruno6', 'mjupina']",20,"['achandec', 'vryan', 'oclevela', 'wpahiakos', 'mevans33', 'savs413', 'talgarin', None, 'ryangreen52', 'kgresko', 'frazer34', 'dcfreak77', 'st0212jones', 'jharri54.villanova', 'mjupina', 'jwong13', 'fmarti13', 'dbruno6', 'glopez4', 'besposi1']"
60,254,17,17,14,"['savs413', 'dcfreak77', 'oclevela', 'kgresko', 'st0212jones', 'jharri54.villanova', 'wpahiakos', 'jwong13', 'fmarti13', 'mevans33', 'glopez4', 'ryangreen52', 'besposi1', 'frazer34']",2,"['talgarin', 'vryan']",3,"['chris_teti', None, 'mjupina']",19,"['chris_teti', 'vryan', 'oclevela', 'wpahiakos', 'mevans33', 'savs413', 'talgarin', None, 'ryangreen52', 'kgresko', 'frazer34', 'dcfreak77', 'st0212jones', 'jharri54.villanova', 'mjupina', 'jwong13', 'fmarti13', 'glopez4', 'besposi1']"
60,281,17,7,6,"['vryan', 'oclevela', 'mevans33', 'talgarin', 'ryangreen52', 'frazer34']",10,"['dcfreak77', 'st0212jones', 'jharri54.villanova', 'wpahiakos', 'jwong13', 'fmarti13', 'savs413', 'glopez4', 'kgresko', 'besposi1']",1,[None],17,"['vryan', 'oclevela', 'wpahiakos', 'mevans33', 'savs413', 'talgarin', None, 'ryangreen52', 'kgresko', 'frazer34', 'dcfreak77', 'st0212jones', 'jharri54.villanova', 'jwong13', 'fmarti13', 'glopez4', 'besposi1']"
61,42,16,114,12,"['sankpalami', 'shrutikayadav2oct', 'supu1796', 'shrikantnimse14', 'infinite1309', 'sandesh29', 'adipatil37', 'minalsawant143', 'vijaybhargude2', 'aditya1818', 'varadrajnanaware7', 'ravina.chavan42']",3,"['jmuench', 'atul.20909', 'navneetmishra021']",102,"['dalvisayli', 'niraj901', 'ektarathod786', 'komalbapna.kb', 'dikshabafna1995', 'niteshnarkar712', 'omkarn049', 'sahilsk7', 'ahire.monali07', 'akshaybadhiye04', 'iabhishek555', 'pankajpawar1515', 'susmitaahirrao', 'vinit95vasudevan', 'umeshdarade77', 'tanayshinde21', 'pravin45', 'tejaskanagal95', 'oindri.c', 'abarge31', 'chaudharipayal50', 'shahyash027', 'rawletanmayee46', 'shraddha0306', 'sangeetamjoshi', 'mahajanabhi2201', 'mudrasjuee', 'advenraju', 'abhihadshi', 'sebastian007', 'pratikkhanore95', 'preetywagh95', 'gidayegirish', 'ashwini12rajput', 'praju.avhad', 'gauravrajeshmehta', 'pbrahmapurkar', 'rakshu.gade', 'sam234bryant', 'swati123', 'sonalipawar589', 'saurabhmangeshkar', 'shrutisundar019', 'ratsthegreat', 'oma1811', 'mukulsathe1995', 'bimal.biswas8', 'tarak.shah', 'rsawant2895', 'priyankaingle18', 'sumedh_patil', 'bondreanup007', 'rohitbaliyan53', 'a.j.yadav2395', 'chiragc9494', 'hbg2112', 'tanyabaptist05', 'bkadam357', 'manishashetye1295', 'abhishek.thavare', 'sardesai.kirti18', 'sammit1844', 'viveky803', 'tejasshinde8055', 'chaudharisuyash7', 'ru1795', 'sanketsalvi03', 'deven199570', 'priyagajakosh1', 'aashish.yadav94', 'amritamukeshb', 'pratikthorat10', 'jatin.dhande1008', 'lakumveer', 'aniket2602', 'shakyanandk', 'ramaprde2296', 'rushabh.fegade', 'akashspawar148', 'cpatil152', 'abhishekm2861996', 'ritesh.parulekar231194', 'sonawane.akshayak', 'vishakha1805', 'ptrimukhe32', 'dattaram.gawade781', 'sagarpawar', 'gsawant999', None, 'prajaktachapte2', 'nikhildubey02051996', 'sagarbhagat43', 'kaustubhgudekar9', 'prashant.baperkar', 'suman28pandit', 'danish.dev.007', 'rakeshmaity', 'saylishirodkar58', 'sayalipatil4545', 'rohanchavan', 'aishwaryamardhekar.24595', 'cooldudeakshu']",117,"['sankpalami', 'shrutikayadav2oct', 'dalvisayli', 'niraj901', 'ektarathod786', 'dikshabafna1995', 'adipatil37', 'niteshnarkar712', 'omkarn049', 'sahilsk7', 'ahire.monali07', 'vinit95vasudevan', 'minalsawant143', 'chaudharipayal50', 'shraddha0306', 'sangeetamjoshi', 'mudrasjuee', 'vijaybhargude2', 'sebastian007', 'ashwini12rajput', 'praju.avhad', 'rakshu.gade', 'sam234bryant', 'sonalipawar589', 'ratsthegreat', 'oma1811', 'rsawant2895', 'sumedh_patil', 'a.j.yadav2395', 'chiragc9494', 'hbg2112', 'varadrajnanaware7', 'viveky803', 'tejasshinde8055', 'chaudharisuyash7', 'ru1795', 'deven199570', 'priyagajakosh1', 'aashish.yadav94', 'pratikthorat10', 'jatin.dhande1008', 'aditya1818', 'aniket2602', 'sonawane.akshayak', 'sagarpawar', 'gsawant999', 'prajaktachapte2', 'nikhildubey02051996', 'danish.dev.007', 'saylishirodkar58', 'sayalipatil4545', 'aishwaryamardhekar.24595', 'cooldudeakshu', 'komalbapna.kb', 'atul.20909', 'akshaybadhiye04', 'iabhishek555', 'pankajpawar1515', 'susmitaahirrao', 'umeshdarade77', 'tanayshinde21', 'infinite1309', 'pravin45', 'tejaskanagal95', 'oindri.c', 'abarge31', 'shahyash027', 'rawletanmayee46', 'mahajanabhi2201', 'advenraju', 'abhihadshi', 'supu1796', 'pratikkhanore95', 'preetywagh95', 'gidayegirish', 'shrikantnimse14', 'gauravrajeshmehta', 'pbrahmapurkar', 'swati123', 'saurabhmangeshkar', 'ravina.chavan42', 'shrutisundar019', 'mukulsathe1995', 'tarak.shah', 'priyankaingle18', 'bondreanup007', 'rohitbaliyan53', 'tanyabaptist05', 'bkadam357', 'manishashetye1295', 'abhishek.thavare', 'sardesai.kirti18', 'sammit1844', 'sandesh29', 'sanketsalvi03', 'amritamukeshb', 'lakumveer', 'jmuench', 'shakyanandk', 'navneetmishra021', 'ramaprde2296', 'rushabh.fegade', 'akashspawar148', 'cpatil152', 'abhishekm2861996', 'ritesh.parulekar231194', 'vishakha1805', 'dattaram.gawade781', None, 'sagarbhagat43', 'kaustubhgudekar9', 'prashant.baperkar', 'suman28pandit', 'rakeshmaity', 'rohanchavan', 'bimal.biswas8', 'ptrimukhe32']"
61,43,16,10,2,"['atul.20909', 'navneetmishra021']",13,"['sankpalami', 'shrutikayadav2oct', 'jmuench', 'supu1796', 'shrikantnimse14', 'infinite1309', 'sandesh29', 'adipatil37', 'minalsawant143', 'vijaybhargude2', 'aditya1818', 'varadrajnanaware7', 'ravina.chavan42']",8,"['parag.choughule', 'happyridermrk', 'akashmore456', 'pripatil285', 'aniket2602', None, 'somil910', 'ratsthegreat']",23,"['sankpalami', 'shrutikayadav2oct', 'jmuench', 'navneetmishra021', 'happyridermrk', 'aniket2602', 'adipatil37', 'vijaybhargude2', 'pripatil285', 'atul.20909', 'varadrajnanaware7', 'supu1796', None, 'parag.choughule', 'shrikantnimse14', 'infinite1309', 'sandesh29', 'akashmore456', 'minalsawant143', 'aditya1818', 'somil910', 'ravina.chavan42', 'ratsthegreat']"
62,186,16,29,15,"['ldl2115', 'jj2883', 'np2588', 'bvf2104', 'rmm2242', 'dr2891', 'jhy2116', 'ss4754', 'jd3171', 'tjh2152', 'ls3221', 'teann.chen', 'jx2248', 'gaojinao', 'smt2175']",0,[],14,"['johnkym', 'akr2145', 'ib2348', 'in2198', 'asf2170', 'bqn2000', 'techcrystal', 'joseanb', 'as577', 'dra2127', 'ryan.davies11', 'xw2463', None, 'grk2114']",29,"['in2198', 'techcrystal', 'dr2891', 'jhy2116', 'ss4754', 'jd3171', 'xw2463', 'grk2114', 'johnkym', 'jj2883', 'asf2170', 'np2588', 'bqn2000', 'rmm2242', 'ryan.davies11', 'ls3221', 'akr2145', 'ldl2115', 'joseanb', 'as577', 'dra2127', 'jx2248', None, 'smt2175', 'ib2348', 'bvf2104', 'tjh2152', 'teann.chen', 'gaojinao']"
62,287,16,29,15,"['ldl2115', 'jj2883', 'np2588', 'bvf2104', 'rmm2242', 'dr2891', 'jhy2116', 'ss4754', 'jd3171', 'tjh2152', 'ls3221', 'teann.chen', 'jx2248', 'gaojinao', 'smt2175']",0,[],14,"['akr2145', 'bhupathirajumanasa', 'atv2109', 'in2198', 'asf2170', 'bqn2000', 'joseanb', 'ib2348', 'dra2127', 'jkk2128', 'xw2463', 'kjs2164', None, 'grk2114']",29,"['bhupathirajumanasa', 'in2198', 'dr2891', 'jhy2116', 'ss4754', 'jd3171', 'jkk2128', 'xw2463', 'grk2114', 'jj2883', 'asf2170', 'np2588', 'bqn2000', 'rmm2242', 'ls3221', 'akr2145', 'ldl2115', 'atv2109', 'joseanb', 'dra2127', 'jx2248', 'kjs2164', None, 'smt2175', 'ib2348', 'bvf2104', 'tjh2152', 'teann.chen', 'gaojinao']"
62,168,16,26,15,"['ldl2115', 'jj2883', 'np2588', 'bvf2104', 'rmm2242', 'dr2891', 'jhy2116', 'ss4754', 'jd3171', 'tjh2152', 'ls3221', 'teann.chen', 'jx2248', 'gaojinao', 'smt2175']",0,[],11,"['akr2145', 'in2198', 'asf2170', 'bqn2000', 'joseanb', 'dra2127', 'jkk2128', 'xw2463', None, 'atvera', 'grk2114']",26,"['in2198', 'dr2891', 'jhy2116', 'ss4754', 'jd3171', 'jkk2128', 'xw2463', 'atvera', 'grk2114', 'jj2883', 'asf2170', 'np2588', 'bqn2000', 'rmm2242', 'ls3221', 'akr2145', 'ldl2115', 'joseanb', 'dra2127', 'jx2248', None, 'smt2175', 'bvf2104', 'tjh2152', 'teann.chen', 'gaojinao']"
62,261,16,26,15,"['ldl2115', 'jj2883', 'np2588', 'bvf2104', 'rmm2242', 'dr2891', 'jhy2116', 'ss4754', 'jd3171', 'tjh2152', 'ls3221', 'teann.chen', 'jx2248', 'gaojinao', 'smt2175']",0,[],11,"['akr2145', 'bhupathirajumanasa', 'ib2348', 'in2198', 'asf2170', 'bqn2000', 'dra2127', 'xw2463', None, 'atvera', 'grk2114']",26,"['bhupathirajumanasa', 'in2198', 'dr2891', 'jhy2116', 'ss4754', 'jd3171', 'xw2463', 'atvera', 'grk2114', 'jj2883', 'asf2170', 'np2588', 'bqn2000', 'rmm2242', 'ls3221', 'akr2145', 'ldl2115', 'dra2127', 'jx2248', None, 'smt2175', 'ib2348', 'bvf2104', 'tjh2152', 'teann.chen', 'gaojinao']"
62,269,16,21,14,"['ldl2115', 'jj2883', 'np2588', 'rmm2242', 'dr2891', 'jhy2116', 'ss4754', 'jd3171', 'tjh2152', 'ls3221', 'teann.chen', 'jx2248', 'gaojinao', 'smt2175']",1,['bvf2104'],7,"['akr2145', 'in2198', 'dra2127', 'jkk2128', 'djs2240', None, 'grk2114']",22,"['in2198', 'dr2891', 'jhy2116', 'ss4754', 'jd3171', 'jkk2128', 'grk2114', 'jj2883', 'np2588', 'rmm2242', 'ls3221', 'akr2145', 'ldl2115', 'dra2127', 'jx2248', None, 'smt2175', 'bvf2104', 'tjh2152', 'teann.chen', 'gaojinao', 'djs2240']"
62,169,16,20,11,"['ldl2115', 'jj2883', 'np2588', 'rmm2242', 'dr2891', 'jhy2116', 'tjh2152', 'jd3171', 'teann.chen', 'jx2248', 'smt2175']",4,"['ss4754', 'ls3221', 'gaojinao', 'bvf2104']",9,"['ib2348', 'in2198', 'asf2170', 'bqn2000', 'dra2127', 'ryan.davies11', 'xw2463', None, 'grk2114']",24,"['in2198', 'dr2891', 'jhy2116', 'ss4754', 'jd3171', 'xw2463', 'grk2114', 'jj2883', 'asf2170', 'np2588', 'bqn2000', 'rmm2242', 'ryan.davies11', 'ls3221', 'ldl2115', 'dra2127', 'jx2248', None, 'smt2175', 'ib2348', 'bvf2104', 'tjh2152', 'teann.chen', 'gaojinao']"
62,69,16,19,13,"['ldl2115', 'np2588', 'bvf2104', 'dr2891', 'jhy2116', 'ss4754', 'jd3171', 'tjh2152', 'ls3221', 'teann.chen', 'jx2248', 'gaojinao', 'smt2175']",2,"['rmm2242', 'jj2883']",6,"['akr2145', 'asf2170', 'bqn2000', 'jkk2128', None, 'grk2114']",21,"['dr2891', 'jhy2116', 'ss4754', 'jd3171', 'jkk2128', 'grk2114', 'jj2883', 'asf2170', 'np2588', 'bqn2000', 'rmm2242', 'ls3221', 'akr2145', 'ldl2115', 'jx2248', None, 'smt2175', 'bvf2104', 'tjh2152', 'teann.chen', 'gaojinao']"
63,252,16,38,13,"['pryan2', 'saketharamv', 'minaldhumwad', 'gdasari', 'ionman1968', 'ayadav17', 'hemanth90eee', 'abhinanoasu', 'ninad.chamele', 'apeter18', 'appellizzaro0002', 'morugant', 'vramarat']",2,"['mserdaro', 'thboosoo']",25,"['vasu_hermy', 'mhan25', 'mdhumwad', 'bonecrusher', 'mpattana', 'shiladityadas19', 'hbalaji', 'morugant23', 'izak.baranowski', 'airuday1', 'aphrodite9825', 'cwang239', 'stummal3', 'lunajlt', 'lawrencedk716', 'txun1', 'maggiezhu0907', None, 'achakr19', 'amsharm1', 'aveerai1', 'shaikhsaif', 'dvasileska', 'navnano1034', 'svarade']",40,"['saketharamv', 'vasu_hermy', 'ionman1968', 'mhan25', 'mdhumwad', 'bonecrusher', 'mpattana', 'shiladityadas19', 'hbalaji', 'morugant23', 'izak.baranowski', 'minaldhumwad', 'airuday1', 'ayadav17', 'hemanth90eee', 'aphrodite9825', 'apeter18', 'cwang239', 'pryan2', 'stummal3', 'lunajlt', 'thboosoo', 'gdasari', 'lawrencedk716', 'abhinanoasu', 'txun1', 'maggiezhu0907', None, 'morugant', 'achakr19', 'amsharm1', 'mserdaro', 'svarade', 'aveerai1', 'shaikhsaif', 'ninad.chamele', 'dvasileska', 'navnano1034', 'appellizzaro0002', 'vramarat']"
64,86,16,34,3,"['ojus1993', 'prashantkambare', 'suhasyadav22']",12,"['sw2576', 'wheureka', 'seekjordan', 'lrpowell', 'yoooncho', 'mahananda925458', 'samsmith', 'ang1', 'wzshan', 'stratego94', 'serxho', 'radio4612']",31,"['thankyougod999.rk', 'shamalshingte677', 'rutuja.27rrm', 'moreshilpa0910', 'vchavan1993', 'poojahalagale', 'madhurisunilpatil', 'somnath2025', 'priteeka.suryawanshi', 'donolikarpratiksha', 'pranita08', 'bhagyashreeshewale9', 'priyanka.sathe77', 'shetakeni3', 'krantishewale17', 'tejaswinipowar07', 'shekharpatil1167', 'vijaychavan4901', 'sagarjadhav19951', None, 'anujarananavare12', 'susha.nikam31', 'anujaharel13', 'snehalpatil5588', 'diptimore3181996', '95pawarsayali', 'jyoti15thanekar', 'anujakolekar9614', 'pratikshasakhare', 'mmkhot55', 'rutujagumathannavar11']",46,"['sw2576', 'thankyougod999.rk', 'seekjordan', 'shamalshingte677', 'lrpowell', 'rutuja.27rrm', 'suhasyadav22', 'moreshilpa0910', 'vchavan1993', 'stratego94', 'madhurisunilpatil', 'poojahalagale', 'somnath2025', 'radio4612', 'donolikarpratiksha', 'priteeka.suryawanshi', 'pranita08', 'bhagyashreeshewale9', 'priyanka.sathe77', 'shetakeni3', 'krantishewale17', 'tejaswinipowar07', 'shekharpatil1167', 'vijaychavan4901', 'ojus1993', 'prashantkambare', 'ang1', 'wzshan', 'sagarjadhav19951', None, 'wheureka', 'anujarananavare12', 'susha.nikam31', 'yoooncho', 'mahananda925458', 'anujaharel13', 'samsmith', 'snehalpatil5588', 'diptimore3181996', '95pawarsayali', 'jyoti15thanekar', 'anujakolekar9614', 'pratikshasakhare', 'mmkhot55', 'serxho', 'rutujagumathannavar11']"
64,88,16,19,1,['serxho'],14,"['sw2576', 'wheureka', 'seekjordan', 'lrpowell', 'ojus1993', 'prashantkambare', 'suhasyadav22', 'yoooncho', 'mahananda925458', 'samsmith', 'ang1', 'wzshan', 'stratego94', 'radio4612']",18,"['tellerius', 'matng94', 'bradvk7', 'casimirkuzyk', 'jjlee', 'xuhan844', 'lucas.zeer', 'diask', 'mattcourtney19', 'sebslaman', 'pkanhaiy', 'sportsrlife5', 'abdullahsaud', 'cleonard', 'oberondixon94', None, 'ngel1914', 'supavannan']",33,"['sw2576', 'matng94', 'seekjordan', 'lrpowell', 'suhasyadav22', 'xuhan844', 'sebslaman', 'stratego94', 'radio4612', 'diask', 'mattcourtney19', 'ngel1914', 'tellerius', 'bradvk7', 'ojus1993', 'prashantkambare', 'lucas.zeer', 'ang1', 'wzshan', None, 'supavannan', 'wheureka', 'casimirkuzyk', 'jjlee', 'yoooncho', 'mahananda925458', 'pkanhaiy', 'samsmith', 'sportsrlife5', 'abdullahsaud', 'cleonard', 'oberondixon94', 'serxho']"
65,316,15,85,13,"['cmharvey', 'phamgk', 'znlin', 'darrensun963', 'aca5tr09', 'jmizutan', 'ajs9515', 'dlbrisen', 'prgraham', 'rsrrrrr', 'aromero3', 'ohone', 'roonloe']",1,['cahutchinson'],72,"['aashka13', 'kesli', 'avrod2210', 'kbjeppes', 'fxyzhuo', 'samadsen', 'suparay', 'ospotash', 'funnpun', 'sg630', 'bearman1000', 'sfoster15', 'smejia97', 'jorinna96', 'yharotorres', 'djlindsay', 'rvmathew', 'jazvicmil', 'hzhhong', 'aparrish', 'kimiigrlz', 'karols.ginting', 'nmuthusa', 'bryan23', 'agchaveznavarro', 'lizzhop', 'chrispatino', 'panhaoting19', 'pmrau', 'wendell', 'adlt96', 'tonyrtoribio', 'jotap1234', 'aleejay112', 'vuthtyrayong', 'calcarb', 'timelesserax', 'jotap123', 'jyperez', 'mtlyons11231', 'carlost88', 'askittrell77', 'hzampaglione', 'alexis01', 'rychu18', 'grantlee9956', 'dechristensen', 'achoi96', 'rakeil', 'meganlo', 'jsullan', 'huimin96', 'jon22345', 'dudewhat', 'amberpulido16', 'vuthtyra', None, 'erikoo', 'justinm767', 'ekitamura', 'chanceps', 'jonthomas', 'clairelee', '1tzm', 'malgarcia', 'aphuynh', 'becloud', 'qinw', 'slidzbar', 'captaint', 'aychan24', 'spatank']",86,"['aashka13', 'kesli', 'avrod2210', 'kbjeppes', 'darrensun963', 'fxyzhuo', 'samadsen', 'suparay', 'ospotash', 'funnpun', 'sg630', 'bearman1000', 'sfoster15', 'smejia97', 'jorinna96', 'yharotorres', 'djlindsay', 'roonloe', 'rvmathew', 'jazvicmil', 'hzhhong', 'aparrish', 'kimiigrlz', 'karols.ginting', 'cahutchinson', 'nmuthusa', 'bryan23', 'agchaveznavarro', 'lizzhop', 'chrispatino', 'aromero3', 'panhaoting19', 'pmrau', 'wendell', 'adlt96', 'znlin', 'tonyrtoribio', 'jotap1234', 'aleejay112', 'vuthtyrayong', 'calcarb', 'timelesserax', 'jotap123', 'cmharvey', 'jyperez', 'mtlyons11231', 'carlost88', 'askittrell77', 'hzampaglione', 'alexis01', 'prgraham', 'rychu18', 'grantlee9956', 'dechristensen', 'achoi96', 'rakeil', 'meganlo', 'aca5tr09', 'jsullan', 'huimin96', 'jon22345', 'dudewhat', 'ohone', 'amberpulido16', 'vuthtyra', None, 'erikoo', 'phamgk', 'justinm767', 'ekitamura', 'chanceps', 'jonthomas', 'clairelee', 'jmizutan', '1tzm', 'malgarcia', 'aphuynh', 'ajs9515', 'becloud', 'dlbrisen', 'qinw', 'slidzbar', 'rsrrrrr', 'captaint', 'aychan24', 'spatank']"
65,126,15,15,12,"['cmharvey', 'phamgk', 'znlin', 'darrensun963', 'aca5tr09', 'jmizutan', 'ajs9515', 'dlbrisen', 'rsrrrrr', 'aromero3', 'prgraham', 'roonloe']",2,"['ohone', 'cahutchinson']",3,"['suparay', None, 'malgarcia']",17,"['znlin', 'darrensun963', 'aca5tr09', 'suparay', 'ohone', None, 'cmharvey', 'phamgk', 'cahutchinson', 'jmizutan', 'malgarcia', 'ajs9515', 'dlbrisen', 'rsrrrrr', 'aromero3', 'prgraham', 'roonloe']"
66,174,15,8,1,['guptashubham38'],13,"['priyaraiufl', 'sepideh', 'roniwinik', 'yingruiji', 'sampad1206074', 'karishmae105', 'pluscloud1015', 'hjs2143', 'mahfuzakhatun', 'starcraft1029', 'sumedhagandharava', 'robertivans', 'njmclean']",7,"['sumit53', 'nupurbhaisare24', 'ankitkp4056', 'harshit123', 'swarnabha1997', None, 'ram2606']",21,"['sumit53', 'guptashubham38', 'sepideh', 'roniwinik', 'sampad1206074', 'nupurbhaisare24', 'hjs2143', 'harshit123', 'ankitkp4056', None, 'pluscloud1015', 'yingruiji', 'ram2606', 'priyaraiufl', 'swarnabha1997', 'karishmae105', 'mahfuzakhatun', 'starcraft1029', 'sumedhagandharava', 'robertivans', 'njmclean']"
66,172,15,7,6,"['sepideh', 'karishmae105', 'mahfuzakhatun', 'sumedhagandharava', 'robertivans', 'njmclean']",8,"['priyaraiufl', 'guptashubham38', 'roniwinik', 'yingruiji', 'sampad1206074', 'hjs2143', 'starcraft1029', 'pluscloud1015']",1,[None],15,"['guptashubham38', 'sepideh', 'roniwinik', 'sampad1206074', 'hjs2143', None, 'pluscloud1015', 'yingruiji', 'priyaraiufl', 'karishmae105', 'mahfuzakhatun', 'starcraft1029', 'sumedhagandharava', 'robertivans', 'njmclean']"
66,173,15,6,4,"['robertivans', 'njmclean', 'karishmae105', 'mahfuzakhatun']",10,"['priyaraiufl', 'guptashubham38', 'roniwinik', 'sepideh', 'yingruiji', 'sampad1206074', 'hjs2143', 'starcraft1029', 'sumedhagandharava', 'pluscloud1015']",2,"['kcantley', None]",16,"['guptashubham38', 'sepideh', 'roniwinik', 'kcantley', 'sampad1206074', 'hjs2143', None, 'pluscloud1015', 'yingruiji', 'priyaraiufl', 'karishmae105', 'mahfuzakhatun', 'starcraft1029', 'sumedhagandharava', 'robertivans', 'njmclean']"
68,38,14,170,3,"['sachimalkan', 'gaurav.gadre', 'gkapil45']",10,"['kenilgadhiya', 'dhruvinacharya19', 'ferrum379', 'aayushtiwari16', 'raj010rocks', 'jigar.ramin786', 'rajatsinha', 'varunj331', 'kailashpatel0000', 'siddhantssangal']",167,"['jigneshk2994', 'yashsavle', 'tejuliman74', 'harshitbangera', 'ishmeetsingh', 'sanketh728', 'swatimane176', 'karan.marketkar', 'rushikeshjoshi285', 'rnair15', 'shreyasawant95', 'viraktdoshi19', 'udayyewale17', 'karan.gondalia', 'patilroshan1128', 'kumarvivek017', 'rohitpuri.g', 'gurmukhsingh0108', 'amit.dutta', 'sush81194', 'rishabh4745', 'tambeneha94', 'rukhsrd', 'nair19shruti', 'happyridermrk', 'gadhiyakenil16', 'abauti608', 'sadiqqureshi393', 'rutu123', 'jiteshkjsp', 'varun1997', 'aniketshelar79', 'sgat3451', 'jaysawant2', 'ykhedikar', 'ishaan.sathe', 'mapethe', 'amruteshpatil', 'pateltejash96', 'ratsthegreat', 'tandelsneha15', 'doshi.kavisha16', 'tajpara.nikhil', 'miteshmohokar', 'g3jithinn', 'kapilaherkar755', 'sweta151945', 'dhairyagada1997', 'pruthavi.c', 'akansha319892', 'vjseedan', 'vishal.chavda', 'nairprasad007', 'joshua0667', 'hardrider95', 'ankitferry123', 'priyankadeshpande177', 'hardik.upadhyay', '1jyotsna1', 'prasad.m', 'parmarmayur05', 'nikj816', 'smajumdar', 'rrnair291293', 'nikuldengada493', 'ankur.shah', 'princeporje98', 'suraj6111994', 'yogeshwar21121995', 'parthkaushikdave', 'nilesh.delekar', 'ameymalotkar1', 'pareshnaik1995', 'gopal.singh', 'nehaaltawade1', 's.jadeja', 'melchiznadar', 'poojaparab9035', 'nikhil4241307', 'pdeshpande', 'peshinakash', 'kiranjadhav050994', 'abinbenny8', 'ashupalambe1992', 'abinaya67006', 'ajitjadhav', 'machalke92', 'yogi.6692', 'devyani.salvi1028', 'qwertynishit', 'verma.amitkumar95', 'florence9344', 'anuradha.d', 'satya_mishra', 'shraddhakharde01', 'inderjitsingh87', 'kypptl', 'lino2296', 'sharma.ayushi8c', 'sbodke', 'aqudas29', 'khedikaryash8', 'tgpatil22791', 'vijaykothari97', 'pranithsuvarna1', 'mauryashubham564', 'vijaya', 'shaminakunnel', 'rahulbadekar', 'arawal14.ar', 'raoashish96', 'parag.choughule', 'asingh12', 'parag16593', 'jigar', 'shivam_cr7', 'udit.shah', 'vishakha', 'tdholpuria', 'atoraskar12', 'mkadam03', 'walavalkarmayur79', 'ankitagharat93', 'aanugraha', 'shubhrapatil77', 'rushabh.soni', 'mayuripatil3095', 'tanujudani865', 'sonihetvi10', 'aniketa.yelave49', 'jadhavankita9969', 'sujataredkar', 'rautt59', 'rjoshi02', 'karankyp', 'adwaitvajpe', 'anevrekar', 'yayatipawar601', 'akash.mali3477', 'karantank97', 'akashmore456', 'surajkarade.2', 'pranav.gori', 'patilvarad2011', 'palak1012', 'apekshapawar', 'ramanujsingh004', 'keyur.gajjar', 'pranilghogale', 'pripatil285', 'desaivighnesh95', None, 'burhan.naim', 'd.shenoy', 'ashish.mrya1', 'ankith89', 'priyanka.bhangre', 'rutwijajoshi10', 'karanshah30', 'agarwal.gagan5101', 'anshujha95', 'vedy1811', 'chaitanyakhane999', 'tushar.gaikwad', 'sourabhbelose', 'somil910', 'abhiramibp95']",180,"['jigneshk2994', 'yashsavle', 'tejuliman74', 'harshitbangera', 'ishmeetsingh', 'sanketh728', 'swatimane176', 'karan.marketkar', 'rushikeshjoshi285', 'rnair15', 'shreyasawant95', 'viraktdoshi19', 'udayyewale17', 'karan.gondalia', 'patilroshan1128', 'kumarvivek017', 'rohitpuri.g', 'gurmukhsingh0108', 'amit.dutta', 'kailashpatel0000', 'sush81194', 'rishabh4745', 'tambeneha94', 'rukhsrd', 'nair19shruti', 'happyridermrk', 'gadhiyakenil16', 'abauti608', 'sadiqqureshi393', 'rutu123', 'jiteshkjsp', 'aniketshelar79', 'sachimalkan', 'sgat3451', 'jaysawant2', 'ykhedikar', 'ishaan.sathe', 'mapethe', 'amruteshpatil', 'pateltejash96', 'ratsthegreat', 'tandelsneha15', 'doshi.kavisha16', 'tajpara.nikhil', 'miteshmohokar', 'g3jithinn', 'kapilaherkar755', 'sweta151945', 'dhairyagada1997', 'pruthavi.c', 'akansha319892', 'vjseedan', 'vishal.chavda', 'nairprasad007', 'joshua0667', 'hardrider95', 'ankitferry123', 'priyankadeshpande177', 'hardik.upadhyay', '1jyotsna1', 'prasad.m', 'parmarmayur05', 'nikj816', 'smajumdar', 'rrnair291293', 'nikuldengada493', 'ankur.shah', 'princeporje98', 'suraj6111994', 'yogeshwar21121995', 'parthkaushikdave', 'nilesh.delekar', 'ameymalotkar1', 'pareshnaik1995', 'gopal.singh', 'nehaaltawade1', 's.jadeja', 'melchiznadar', 'poojaparab9035', 'nikhil4241307', 'pdeshpande', 'peshinakash', 'kiranjadhav050994', 'abinbenny8', 'ashupalambe1992', 'abinaya67006', 'kenilgadhiya', 'ajitjadhav', 'machalke92', 'yogi.6692', 'rajatsinha', 'devyani.salvi1028', 'qwertynishit', 'verma.amitkumar95', 'florence9344', 'ferrum379', 'anuradha.d', 'satya_mishra', 'shraddhakharde01', 'inderjitsingh87', 'kypptl', 'lino2296', 'sharma.ayushi8c', 'sbodke', 'aqudas29', 'khedikaryash8', 'tgpatil22791', 'dhruvinacharya19', 'vijaykothari97', 'pranithsuvarna1', 'jigar.ramin786', 'mauryashubham564', 'vijaya', 'shaminakunnel', 'rahulbadekar', 'arawal14.ar', 'raoashish96', 'parag.choughule', 'asingh12', 'parag16593', 'jigar', 'shivam_cr7', 'udit.shah', 'vishakha', 'tdholpuria', 'atoraskar12', 'mkadam03', 'walavalkarmayur79', 'ankitagharat93', 'somil910', 'aanugraha', 'shubhrapatil77', 'gkapil45', 'rushabh.soni', 'mayuripatil3095', 'tanujudani865', 'sonihetvi10', 'aniketa.yelave49', 'jadhavankita9969', 'sujataredkar', 'rautt59', 'rjoshi02', 'karankyp', 'adwaitvajpe', 'anevrekar', 'yayatipawar601', 'akash.mali3477', 'karantank97', 'akashmore456', 'surajkarade.2', 'pranav.gori', 'patilvarad2011', 'palak1012', 'apekshapawar', 'ramanujsingh004', 'aayushtiwari16', 'raj010rocks', 'keyur.gajjar', 'pranilghogale', 'pripatil285', 'desaivighnesh95', None, 'burhan.naim', 'd.shenoy', 'ashish.mrya1', 'ankith89', 'priyanka.bhangre', 'rutwijajoshi10', 'karanshah30', 'agarwal.gagan5101', 'anshujha95', 'varunj331', 'vedy1811', 'chaitanyakhane999', 'gaurav.gadre', 'tushar.gaikwad', 'sourabhbelose', 'siddhantssangal', 'varun1997', 'abhiramibp95']"
68,39,14,23,8,"['kenilgadhiya', 'dhruvinacharya19', 'aayushtiwari16', 'raj010rocks', 'jigar.ramin786', 'varunj331', 'kailashpatel0000', 'siddhantssangal']",5,"['ferrum379', 'sachimalkan', 'gkapil45', 'rajatsinha', 'gaurav.gadre']",15,"['doshi.kavisha16', 'vaibhav206rsm', 'singhshashank97', 'naval29', 'adityamodi009', 'viraktdoshi19', 'gadhiyakenil16', 'poojaparab9035', 'malharvyas17.mv', 'tanuj.udani', 'inderjitsingh87', 'mapethe', 'heramb10', None, '1jyotsna1']",28,"['kenilgadhiya', 'doshi.kavisha16', 'gkapil45', 'rajatsinha', 'ferrum379', 'adityamodi009', 'viraktdoshi19', 'inderjitsingh87', 'kailashpatel0000', '1jyotsna1', 'naval29', 'dhruvinacharya19', 'aayushtiwari16', 'raj010rocks', 'gadhiyakenil16', 'jigar.ramin786', 'heramb10', None, 'vaibhav206rsm', 'sachimalkan', 'poojaparab9035', 'malharvyas17.mv', 'tanuj.udani', 'varunj331', 'mapethe', 'gaurav.gadre', 'siddhantssangal', 'singhshashank97']"
69,228,14,9,6,"['jubujjamer', 'montielgonzalo1985', 'leobena08', 'nico.lopezabdala', 'andrepetelski', 'aangie.ramirez']",7,"['aries.tata10', 'rjf.7474', 'bwuillebille', 'nicosaggion', 'kie_25may', 'bossetti_90', 'nico.abdala']",3,"['sophie.dulhoste', None, 'florortega.28']",16,"['aries.tata10', 'rjf.7474', 'bwuillebille', 'jubujjamer', 'montielgonzalo1985', 'bossetti_90', 'leobena08', 'nico.lopezabdala', None, 'andrepetelski', 'nico.abdala', 'nicosaggion', 'florortega.28', 'kie_25may', 'sophie.dulhoste', 'aangie.ramirez']"
70,220,13,15,8,"['taw', 'spschriver', 'dmohant', 'zheng338', 'cspecty', 'caduartec', 'sritapaswi2007', 'smatsun']",4,"['imcadams', 'chen2086', 'nguye228', 'thoma659']",7,"['sreeve', 'davidjohnson', 'faltens', 'mkephart', 'tcurtiss', 'erich1016', None]",19,"['chen2086', 'taw', 'davidjohnson', 'spschriver', 'faltens', 'imcadams', 'dmohant', 'thoma659', 'caduartec', 'nguye228', None, 'sreeve', 'erich1016', 'mkephart', 'zheng338', 'tcurtiss', 'cspecty', 'sritapaswi2007', 'smatsun']"
71,18,13,11,9,"['chitragupta046', 'souravbanerjee616', 'raktim.ds', 'jainswloke', 'thakuria.b21', 'prsingh441', 'asmitasamanta04', 'akash775', 'ayanc68']",3,"['anteridi', 'r.k.debnath', 'moulinagold']",2,"['nagateja.vlsi', None]",14,"['chitragupta046', 'raktim.ds', 'souravbanerjee616', 'prsingh441', 'moulinagold', 'r.k.debnath', 'ayanc68', None, 'anteridi', 'jainswloke', 'thakuria.b21', 'nagateja.vlsi', 'asmitasamanta04', 'akash775']"
72,207,13,132,11,"['snehakudtarkar315', 'ssy506804', 'sawantgaurig25', 'rahulmhapsekar7', 'siddhiambre111', 'palswati0309', 'nehah95', 'pranay9.ithawar', 'bhakti961', 'sailee.mohite', 'srikalaprabhu']",1,['yasir'],121,"['dalvisayli', 'niraj901', 'ektarathod786', 'khadekunal1', 'dikshabafna1995', 'kadamk008', 'omkarn049', 'sagar.pawar35418', 'ahire.monali07', 'brian200495', 'infinite2205', 'vinit95vasudevan', 'dhartinano19', 'saurabh.gharat96', 'suyogk.1995', 'chaudharipayal50', 'dandekarmd73', 'tanayshinde123', 'sangeetamjoshi', 'mudrasjuee', 'sebastian007', 'nikhildabholkar4', 'praju.avhad', 'rakshu.gade', 'snehawaghe21', 'sid.rane95', 'sonalipawar589', 'ratsthegreat', 'oma1811', 'sumedh_patil', 'a.j.yadav2395', 'chiragc9494', 'hbg2112', 'kumarrahul050892', 'viveky803', 'yashapeejay', 'sandeeprock023', 'manasi.shinde008', 'chaudharisuyash7', 'ru1795', 'deven199570', 'priyagajakosh1', 'aashish.yadav94', 'ambeskaradvait', 'spranav3004', 'jatin.dhande1008', 'priyankakamble', 'manalihedaoo4', 'pranilraut17', 'shivamchaube', 'sonawane.akshayak', 'spooja.1430', 'mongya00', 'dattaramkolekar', 'sagarpawar', 'nikitamalvade', 'nikhildubey02051996', 'mitesh.dangle', 'danish.dev.007', 'saylishirodkar58', 'sayalipatil4545', 'aishwaryamardhekar.24595', 'cooldudeakshu', 'komalbapna.kb', 'viprajapatil', 'aniketmane42', 'akshaybadhiye04', 'iabhishek555', 'susmitaahirrao', 'pravin45', 'tejaskanagal95', 'aniketkulaye618', 'bk357357', 'oindri.c', 'kondekar23', 'poojavagre12', 'mihirsawant17', 'adigame18', 'parmitbanga1995', 'shahyash027', 'ajthamke40', 'mishrahenry007', 'shreyashpawar96', 'abhihadshi', 'pratikkhanore95', 'gidayegirish', 'gauravrajeshmehta', 'codekidx', 'pbrahmapurkar', 'vinodgadge95', 'shubhambeldar547', 'prathameshptkr4', 'saurabhmangeshkar', 'mukulsathe1995', 'priyankaingle18', 'bondreanup007', 'rohitbaliyan53', 'manishashetye1295', 'abhishek.thavare', 'sardesai.kirti18', 'amritamukeshb', 'shakyanandk', 'ramaprde2296', 'rushabh.fegade', 'ameypatil29', 'sahilshaikh827', 'vishakha1805', 'abhishekm2861996', 'dattaram.gawade781', None, 'salman23011996', 'vaibhav.gangan7', 'rohinipatil404', 'sagarbhagat43', 'kaustubhgudekar9', 'namrata05', 'suman28pandit', 'chandraman.patil', 'rakeshmaity', 'rohanchavan', 'vaibhavgaikar62']",133,"['dalvisayli', 'niraj901', 'ektarathod786', 'khadekunal1', 'dikshabafna1995', 'kadamk008', 'omkarn049', 'sagar.pawar35418', 'ahire.monali07', 'brian200495', 'yasir', 'infinite2205', 'vinit95vasudevan', 'dhartinano19', 'saurabh.gharat96', 'sailee.mohite', 'nehah95', 'suyogk.1995', 'chaudharipayal50', 'dandekarmd73', 'tanayshinde123', 'sangeetamjoshi', 'mudrasjuee', 'sebastian007', 'nikhildabholkar4', 'praju.avhad', 'rakshu.gade', 'snehawaghe21', 'sid.rane95', 'sonalipawar589', 'ratsthegreat', 'oma1811', 'rahulmhapsekar7', 'sumedh_patil', 'a.j.yadav2395', 'chiragc9494', 'hbg2112', 'bhakti961', 'kumarrahul050892', 'viveky803', 'yashapeejay', 'sandeeprock023', 'manasi.shinde008', 'chaudharisuyash7', 'ru1795', 'deven199570', 'priyagajakosh1', 'aashish.yadav94', 'ambeskaradvait', 'spranav3004', 'jatin.dhande1008', 'priyankakamble', 'manalihedaoo4', 'pranilraut17', 'shivamchaube', 'sonawane.akshayak', 'spooja.1430', 'mongya00', 'dattaramkolekar', 'sagarpawar', 'nikitamalvade', 'nikhildubey02051996', 'mitesh.dangle', 'danish.dev.007', 'saylishirodkar58', 'sayalipatil4545', 'aishwaryamardhekar.24595', 'cooldudeakshu', 'snehakudtarkar315', 'komalbapna.kb', 'viprajapatil', 'aniketmane42', 'akshaybadhiye04', 'iabhishek555', 'susmitaahirrao', 'pravin45', 'tejaskanagal95', 'aniketkulaye618', 'bk357357', 'oindri.c', 'kondekar23', 'poojavagre12', 'mihirsawant17', 'adigame18', 'parmitbanga1995', 'shahyash027', 'ajthamke40', 'mishrahenry007', 'shreyashpawar96', 'abhihadshi', 'pratikkhanore95', 'srikalaprabhu', 'gidayegirish', 'gauravrajeshmehta', 'codekidx', 'pbrahmapurkar', 'vinodgadge95', 'shubhambeldar547', 'prathameshptkr4', 'saurabhmangeshkar', 'mukulsathe1995', 'priyankaingle18', 'palswati0309', 'bondreanup007', 'rohitbaliyan53', 'manishashetye1295', 'abhishek.thavare', 'sardesai.kirti18', 'amritamukeshb', 'shakyanandk', 'ramaprde2296', 'rushabh.fegade', 'ameypatil29', 'sahilshaikh827', 'vishakha1805', 'abhishekm2861996', 'dattaram.gawade781', None, 'salman23011996', 'ssy506804', 'vaibhav.gangan7', 'sawantgaurig25', 'rohinipatil404', 'siddhiambre111', 'sagarbhagat43', 'kaustubhgudekar9', 'namrata05', 'suman28pandit', 'chandraman.patil', 'rakeshmaity', 'pranay9.ithawar', 'rohanchavan', 'vaibhavgaikar62']"
73,47,13,207,9,"['rhea.ann.95', 'trija68', 'nitingurme', 'kadamrupesh1996', 'shubhamj95', 'amanpal56', 'chinmayaniket4052', 'himanshuphatak98', 'rajwaje44']",3,"['arul7', 'andrewdickens', 'xuejunxu']",198,"['kadamk008', 'bhavesh3422', 'aniket187', 'rehansonarkar784', 'jainamshah202', 'aimomajy', 'nrkhara', 'ajay.raghuwanshi', 'krittikaranga', 'rajdeepd', 'brian200495', 'shraddhad', 'rananeetika3', 'mehtajinal3101', 'vinit95vasudevan', 'gujarathikshitij', 'zkoyande', 'minalsawant1108', 'neha.utekar2608', 'email.harsh0811', 'arpit32', 'nikitarane245', 'bhoomee.sheth', 'abhishek1996', 'obalgi3095', 'kambe302', 'lakhanmodani1811', 'simran123', 'jayjadav08', 'neelam.chaudhari27', '22diptinikalje', 'sebastian007', 'tanvikalan', 'harshilmehta1995', 'komal31p', 'poojashetty', 'darshanadaund27', 'sam234bryant', 'nagateja.vlsi', 'bhumivora1995', 'geeta.kavitake', 'mapethe', 'sid.rane95', 'jaidevdalvi', 'suraj.taigade', 'monish.kapadia', 'ratsthegreat', 'ajinkyachadha', 'divya.upalekar', 'rsawant2895', 'ninad41195', 'purva.desai', 'msumit95', 'patil.rushal825', 'anujakhose94', 'rupali.patil', 'pathanabdulrazzak9524', 'viveky803', 'kpiyushbhirud', 'tejasshinde8055', 'siddhesh401', 'sanika.dongre', 'manasi.shinde008', 'bhavikashenoy95', 'dhvanilmandalia29', 'anasnaik9987', 'mokshada', 'alohomora7', 'pranilraut17', 'suryatejachitturi', 'avinashninawe', 'apoorvasundaresan', 'aditya.apte3', 'shivanisharaf15', 'sonawane.akshayak', 'akanksha0196', 'aeyjd', 'luke676', 'monish.nene', 'spooja.1430', 'purva.satpute', 'adwait.sable10', 'pragatinarnaware', 'gsawant999', 'nehadingankar', 'deepikachaman3', 'patelu997', 'mshirali23', 'nikhildubey02051996', 'shwecchajain', 'akshata.kulkarni', 'shweta1811', 'stanabk', 'rohankhollamkar', 'upadhyechinmay', 'cooldudeakshu', 'juhi.manglani', 'vaishnavi.sambrekar', 'komalbapna.kb', 'ritesh.shukla', 'mugdha.dalvi', 'gupta.ravi1996', 'dipmads', 'rajatkedia95', 'ankurbhagwat8', 'harshal.dangat1', 'florence9344', 'shubham.gaikwad', 'sanjana.advani', 'priyuk', 'priyeshd', 'tanvi.rane1995', 'ambani', 'umeshdarade77', 'tanayshinde21', 'cvvedesh', 'karan.dadlani', 'pravin45', 'tejaskanagal95', 'doshishrut1995', 'kondekar23', 'poojamenon16.pm', 'mihirsawant17', 'rahul4peace', 'rahul1995', 'rawletanmayee46', 'ajthamke40', 'rashuidiot', 'minal.patil', 'chaitanyakhachane95', 'johebshaikh', 'harshada123', 'mahajanabhi2201', 'abhishekpatkar1796', 'abhihadshi', 'bharathi.pedapudi', 'lakshmi.nair', 'gauravrajeshmehta', 'mudbidrijay', 'rutvij.supekar', 'codekidx', 'pbrahmapurkar', 'pathakrohan18', 'shreyasvkul', 'mananmehta7', 'chirag184', 'prathameshptkr4', 'aparnaahari95', 'tarak.shah', 'mervyn.fernandes', 'ashishmohite1996', 'akshayshinde101095', 'manavtrivedi03', 'vivek12195', 'nikhilgade', 'arvindlandge', 'anasnaik25', 'akshay21', 'mukul.kulkarni', 'sardesai.kirti18', 'shraddhag', 'vishaakn', 'amrsha.srivastava', 'apurva.patil', 'bhavesh.singh', 'omkardalvi409', 'shriya.sharma', 'lakumveer', 'shreyamath95', 'dhruv.gajaria95', 'mohak11jan', 'parthiv.parikh', 'sandipani1995', 'akashspawar148', 'khannamansi312', 'vishakha1805', 'yashgumaste', 'nileshkartik95', 'neilmundhe', 'shreya.mahajan', 'jainam49', 'jakhererahul42', 'dattaram.gawade781', 'pavitra.iyer', 'tejaschaudhary1996', 'vaibhav.gangan7', 'ankita.rahate', 'shamikabachal', 'swapkaru123', 'saheli.konde', 'prashant.baperkar', 'suman28pandit', 'rakeshmaity', 'aakashgangolli3112', 'prachi.more', 'rohanchavan', 'guptesoham95', 'ptrimukhe32']",210,"['nitingurme', 'kadamk008', 'bhavesh3422', 'aniket187', 'rehansonarkar784', 'jainamshah202', 'aimomajy', 'nrkhara', 'ajay.raghuwanshi', 'krittikaranga', 'trija68', 'rajdeepd', 'brian200495', 'shraddhad', 'rananeetika3', 'mehtajinal3101', 'vinit95vasudevan', 'gujarathikshitij', 'zkoyande', 'minalsawant1108', 'neha.utekar2608', 'himanshuphatak98', 'email.harsh0811', 'andrewdickens', 'arpit32', 'nikitarane245', 'bhoomee.sheth', 'abhishek1996', 'obalgi3095', 'kambe302', 'lakhanmodani1811', 'simran123', 'rajwaje44', 'jayjadav08', 'neelam.chaudhari27', '22diptinikalje', 'sebastian007', 'tanvikalan', 'harshilmehta1995', 'komal31p', 'poojashetty', 'darshanadaund27', 'sam234bryant', 'nagateja.vlsi', 'bhumivora1995', 'geeta.kavitake', 'mapethe', 'sid.rane95', 'jaidevdalvi', 'suraj.taigade', 'monish.kapadia', 'ratsthegreat', 'ajinkyachadha', 'divya.upalekar', 'rsawant2895', 'ninad41195', 'purva.desai', 'msumit95', 'chinmayaniket4052', 'patil.rushal825', 'anujakhose94', 'rupali.patil', 'pathanabdulrazzak9524', 'viveky803', 'kpiyushbhirud', 'tejasshinde8055', 'siddhesh401', 'sanika.dongre', 'manasi.shinde008', 'bhavikashenoy95', 'dhvanilmandalia29', 'anasnaik9987', 'mokshada', 'alohomora7', 'pranilraut17', 'suryatejachitturi', 'avinashninawe', 'apoorvasundaresan', 'aditya.apte3', 'prachi.more', 'shivanisharaf15', 'sonawane.akshayak', 'akanksha0196', 'shubhamj95', 'aeyjd', 'luke676', 'monish.nene', 'spooja.1430', 'purva.satpute', 'adwait.sable10', 'pragatinarnaware', 'gsawant999', 'nehadingankar', 'deepikachaman3', 'patelu997', 'mshirali23', 'nikhildubey02051996', 'shwecchajain', 'akshata.kulkarni', 'kadamrupesh1996', 'shweta1811', 'stanabk', 'rohankhollamkar', 'upadhyechinmay', 'cooldudeakshu', 'juhi.manglani', 'vaishnavi.sambrekar', 'komalbapna.kb', 'ritesh.shukla', 'mugdha.dalvi', 'amanpal56', 'gupta.ravi1996', 'dipmads', 'rajatkedia95', 'ankurbhagwat8', 'harshal.dangat1', 'florence9344', 'shubham.gaikwad', 'sanjana.advani', 'priyuk', 'xuejunxu', 'priyeshd', 'tanvi.rane1995', 'ambani', 'umeshdarade77', 'tanayshinde21', 'cvvedesh', 'karan.dadlani', 'pravin45', 'tejaskanagal95', 'doshishrut1995', 'kondekar23', 'poojamenon16.pm', 'mihirsawant17', 'rahul4peace', 'rhea.ann.95', 'rahul1995', 'rawletanmayee46', 'ajthamke40', 'rashuidiot', 'minal.patil', 'chaitanyakhachane95', 'johebshaikh', 'harshada123', 'mahajanabhi2201', 'abhishekpatkar1796', 'abhihadshi', 'bharathi.pedapudi', 'lakshmi.nair', 'gauravrajeshmehta', 'mudbidrijay', 'rutvij.supekar', 'codekidx', 'pbrahmapurkar', 'pathakrohan18', 'shreyasvkul', 'mananmehta7', 'chirag184', 'prathameshptkr4', 'aparnaahari95', 'tarak.shah', 'mervyn.fernandes', 'ashishmohite1996', 'akshayshinde101095', 'manavtrivedi03', 'vivek12195', 'nikhilgade', 'arvindlandge', 'anasnaik25', 'akshay21', 'mukul.kulkarni', 'sardesai.kirti18', 'shraddhag', 'vishaakn', 'amrsha.srivastava', 'apurva.patil', 'bhavesh.singh', 'omkardalvi409', 'shriya.sharma', 'lakumveer', 'shreyamath95', 'dhruv.gajaria95', 'mohak11jan', 'parthiv.parikh', 'sandipani1995', 'akashspawar148', 'khannamansi312', 'vishakha1805', 'yashgumaste', 'nileshkartik95', 'neilmundhe', 'shreya.mahajan', 'jainam49', 'jakhererahul42', 'dattaram.gawade781', 'tejaschaudhary1996', 'vaibhav.gangan7', 'ankita.rahate', 'shamikabachal', 'swapkaru123', 'saheli.konde', 'prashant.baperkar', 'suman28pandit', 'rakeshmaity', 'aakashgangolli3112', 'arul7', 'pavitra.iyer', 'rohanchavan', 'guptesoham95', 'ptrimukhe32']"
73,51,13,67,2,"['rhea.ann.95', 'himanshuphatak98']",10,"['trija68', 'xuejunxu', 'nitingurme', 'kadamrupesh1996', 'shubhamj95', 'amanpal56', 'chinmayaniket4052', 'arul7', 'rajwaje44', 'andrewdickens']",65,"['raku1109', 'jogichetan96', 'sjunghareakshay', 'apoorvakraut', 'shraddhakharde01', 'doshishrut1995', 'manisha.shetty07', 'jayeshkhandagle123', 'ranjuvarughese', 'anuragshyam1026', 'ajthamke40', 'rashuidiot', 'jitesh.10', 'akshay1995', 'kambe302', 'shafaanbhai', 'sahil8rai', 'varadmeradost', 'asingh12', 'darshanadaund27', 'vivek.sakinala', 'jenna', 'jaidevdalvi', 'danishdewani112795', 'ishita.choudhary', 'rushabh.soni', 'arunnambiar66', 'chiragc9494', 'maithili010', 'akshaybangera95', 'suthar.kalpesh57', 'soorajdinesan27', 'harshit0610', 'trishapatkar19', 'alisha.alice.panicker', 'zeuswinchester456', 'karantank97', 'priyankapandya19', 'nivipetkar', 'akashmore456', 'omkardalvi409', 'shubhamjambhe8', 'kiranrelekar412', 'dhvanilmandalia29', 'varma096', 'shukla.pawan249', 'sarveshgrao', 'kanchan.sawant17', 'shubhangi.matey', 'pranilraut17', 'akanksha0196', 'ayyappakonar', 'ttanmay.telang75', None, 'shevekarrohan', 'shrinathnair', 'deepikachaman3', 'd.shenoy', 'salman23011996', 'chandramani.yadav43', 'srishti.shriyan96', 'tejask2610', 'upadhyechinmay', 'joijodegauri7', 'dishakulkarni25']",77,"['nitingurme', 'amanpal56', 'raku1109', 'jogichetan96', 'sjunghareakshay', 'trija68', 'xuejunxu', 'apoorvakraut', 'shraddhakharde01', 'doshishrut1995', 'manisha.shetty07', 'jayeshkhandagle123', 'himanshuphatak98', 'ranjuvarughese', 'andrewdickens', 'rhea.ann.95', 'anuragshyam1026', 'ajthamke40', 'rashuidiot', 'jitesh.10', 'akshay1995', 'kambe302', 'shafaanbhai', 'rajwaje44', 'sahil8rai', 'varadmeradost', 'asingh12', 'darshanadaund27', 'vivek.sakinala', 'jenna', 'jaidevdalvi', 'danishdewani112795', 'ishita.choudhary', 'rushabh.soni', 'arunnambiar66', 'chiragc9494', 'chinmayaniket4052', 'maithili010', 'akshaybangera95', 'suthar.kalpesh57', 'soorajdinesan27', 'harshit0610', 'trishapatkar19', 'alisha.alice.panicker', 'zeuswinchester456', 'karantank97', 'priyankapandya19', 'nivipetkar', 'akashmore456', 'omkardalvi409', 'shubhamjambhe8', 'kiranrelekar412', 'dhvanilmandalia29', 'varma096', 'shukla.pawan249', 'sarveshgrao', 'kanchan.sawant17', 'shubhangi.matey', 'pranilraut17', 'akanksha0196', 'ayyappakonar', 'shubhamj95', 'ttanmay.telang75', None, 'shevekarrohan', 'shrinathnair', 'deepikachaman3', 'd.shenoy', 'salman23011996', 'chandramani.yadav43', 'kadamrupesh1996', 'srishti.shriyan96', 'tejask2610', 'arul7', 'upadhyechinmay', 'joijodegauri7', 'dishakulkarni25']"
74,206,13,15,11,"['pjs2189', 'aa3559', 'damla.dimlioglu', 'temple215', 'an2758', 'kb2902', 'vm2447', 'ss4974', 'fungedean', 'ms5313', 'cy2392']",1,['baldeosharansharma'],4,"[None, 'lilusysu', 'avm2117', 'bl2584']",16,"['pjs2189', 'damla.dimlioglu', 'kb2902', 'vm2447', 'ss4974', 'ms5313', 'cy2392', 'bl2584', 'lilusysu', None, 'aa3559', 'temple215', 'an2758', 'baldeosharansharma', 'fungedean', 'avm2117']"
74,183,13,13,11,"['pjs2189', 'aa3559', 'damla.dimlioglu', 'temple215', 'an2758', 'kb2902', 'vm2447', 'ss4974', 'fungedean', 'ms5313', 'cy2392']",1,['baldeosharansharma'],2,"['lilusysu', None]",14,"['pjs2189', 'damla.dimlioglu', 'kb2902', 'vm2447', 'ss4974', 'ms5313', 'cy2392', 'lilusysu', None, 'aa3559', 'temple215', 'an2758', 'baldeosharansharma', 'fungedean']"
74,182,13,8,7,"['pjs2189', 'aa3559', 'kb2902', 'vm2447', 'fungedean', 'ms5313', 'cy2392']",5,"['damla.dimlioglu', 'temple215', 'an2758', 'baldeosharansharma', 'ss4974']",1,[None],13,"['pjs2189', 'damla.dimlioglu', 'kb2902', 'vm2447', 'ss4974', 'ms5313', 'cy2392', None, 'aa3559', 'temple215', 'an2758', 'baldeosharansharma', 'fungedean']"
75,140,13,16,9,"['naraeyoon92', 'sigrid1995', 'ymmeow', 'kms92313', 'lixintong026', 'rhe292', 'colin.g.elder', 'sarmstrong104', 'nblanc4']",3,"['alirezafarizan', 'staffordhutchins', 'aalquras']",7,"['lzx92', 'zhichengxiao', 'wangxiao', 'hasibdalim', 'abriggs', 'polinp0p0', None]",19,"['ymmeow', 'hasibdalim', 'abriggs', 'alirezafarizan', 'rhe292', 'sarmstrong104', 'zhichengxiao', None, 'aalquras', 'lzx92', 'naraeyoon92', 'sigrid1995', 'kms92313', 'wangxiao', 'lixintong026', 'colin.g.elder', 'polinp0p0', 'staffordhutchins', 'nblanc4']"
76,47,13,207,12,"['shraddhag', 'krittikaranga', 'tejaschaudhary1996', 'lakshmi.nair', 'vishaakn', 'ninad41195', 'saheli.konde', 'aeyjd', 'lakhanmodani1811', 'prachi.more', 'pavitra.iyer', 'guptesoham95']",0,[],195,"['nitingurme', 'kadamk008', 'bhavesh3422', 'aniket187', 'rehansonarkar784', 'jainamshah202', 'aimomajy', 'nrkhara', 'ajay.raghuwanshi', 'trija68', 'rajdeepd', 'brian200495', 'shraddhad', 'rananeetika3', 'mehtajinal3101', 'vinit95vasudevan', 'gujarathikshitij', 'zkoyande', 'minalsawant1108', 'neha.utekar2608', 'email.harsh0811', 'himanshuphatak98', 'arpit32', 'nikitarane245', 'bhoomee.sheth', 'abhishek1996', 'obalgi3095', 'kambe302', 'simran123', 'rajwaje44', 'jayjadav08', 'neelam.chaudhari27', '22diptinikalje', 'sebastian007', 'tanvikalan', 'harshilmehta1995', 'komal31p', 'poojashetty', 'darshanadaund27', 'sam234bryant', 'nagateja.vlsi', 'bhumivora1995', 'geeta.kavitake', 'mapethe', 'sid.rane95', 'jaidevdalvi', 'suraj.taigade', 'monish.kapadia', 'ratsthegreat', 'ajinkyachadha', 'divya.upalekar', 'rsawant2895', 'purva.desai', 'msumit95', 'patil.rushal825', 'chinmayaniket4052', 'anujakhose94', 'rupali.patil', 'pathanabdulrazzak9524', 'viveky803', 'kpiyushbhirud', 'tejasshinde8055', 'siddhesh401', 'sanika.dongre', 'manasi.shinde008', 'bhavikashenoy95', 'dhvanilmandalia29', 'anasnaik9987', 'mokshada', 'alohomora7', 'pranilraut17', 'suryatejachitturi', 'avinashninawe', 'apoorvasundaresan', 'aditya.apte3', 'shivanisharaf15', 'sonawane.akshayak', 'akanksha0196', 'shubhamj95', 'luke676', 'monish.nene', 'spooja.1430', 'purva.satpute', 'adwait.sable10', 'pragatinarnaware', 'gsawant999', 'nehadingankar', 'deepikachaman3', 'patelu997', 'mshirali23', 'nikhildubey02051996', 'shwecchajain', 'akshata.kulkarni', 'kadamrupesh1996', 'shweta1811', 'stanabk', 'rohankhollamkar', 'upadhyechinmay', 'cooldudeakshu', 'juhi.manglani', 'vaishnavi.sambrekar', 'komalbapna.kb', 'ritesh.shukla', 'mugdha.dalvi', 'amanpal56', 'gupta.ravi1996', 'dipmads', 'rajatkedia95', 'ankurbhagwat8', 'harshal.dangat1', 'florence9344', 'shubham.gaikwad', 'sanjana.advani', 'priyuk', 'priyeshd', 'tanvi.rane1995', 'ambani', 'umeshdarade77', 'tanayshinde21', 'cvvedesh', 'karan.dadlani', 'pravin45', 'tejaskanagal95', 'doshishrut1995', 'kondekar23', 'poojamenon16.pm', 'mihirsawant17', 'rahul4peace', 'rahul1995', 'rhea.ann.95', 'rawletanmayee46', 'ajthamke40', 'rashuidiot', 'minal.patil', 'chaitanyakhachane95', 'johebshaikh', 'harshada123', 'mahajanabhi2201', 'abhishekpatkar1796', 'abhihadshi', 'bharathi.pedapudi', 'gauravrajeshmehta', 'mudbidrijay', 'rutvij.supekar', 'codekidx', 'pbrahmapurkar', 'pathakrohan18', 'shreyasvkul', 'mananmehta7', 'chirag184', 'prathameshptkr4', 'aparnaahari95', 'tarak.shah', 'mervyn.fernandes', 'ashishmohite1996', 'akshayshinde101095', 'manavtrivedi03', 'vivek12195', 'nikhilgade', 'arvindlandge', 'anasnaik25', 'akshay21', 'mukul.kulkarni', 'sardesai.kirti18', 'amrsha.srivastava', 'apurva.patil', 'bhavesh.singh', 'omkardalvi409', 'shriya.sharma', 'lakumveer', 'shreyamath95', 'dhruv.gajaria95', 'mohak11jan', 'parthiv.parikh', 'sandipani1995', 'akashspawar148', 'khannamansi312', 'vishakha1805', 'yashgumaste', 'nileshkartik95', 'neilmundhe', 'shreya.mahajan', 'jainam49', 'jakhererahul42', 'dattaram.gawade781', 'vaibhav.gangan7', 'ankita.rahate', 'shamikabachal', 'swapkaru123', 'prashant.baperkar', 'suman28pandit', 'rakeshmaity', 'aakashgangolli3112', 'rohanchavan', 'ptrimukhe32']",207,"['nitingurme', 'kadamk008', 'bhavesh3422', 'aniket187', 'rehansonarkar784', 'jainamshah202', 'aimomajy', 'nrkhara', 'krittikaranga', 'ajay.raghuwanshi', 'trija68', 'rajdeepd', 'brian200495', 'shraddhad', 'rananeetika3', 'mehtajinal3101', 'vinit95vasudevan', 'gujarathikshitij', 'zkoyande', 'minalsawant1108', 'neha.utekar2608', 'email.harsh0811', 'himanshuphatak98', 'arpit32', 'nikitarane245', 'bhoomee.sheth', 'abhishek1996', 'obalgi3095', 'lakhanmodani1811', 'kambe302', 'simran123', 'rajwaje44', 'jayjadav08', 'neelam.chaudhari27', '22diptinikalje', 'sebastian007', 'tanvikalan', 'harshilmehta1995', 'komal31p', 'poojashetty', 'darshanadaund27', 'sam234bryant', 'nagateja.vlsi', 'bhumivora1995', 'geeta.kavitake', 'mapethe', 'sid.rane95', 'jaidevdalvi', 'suraj.taigade', 'monish.kapadia', 'ratsthegreat', 'ajinkyachadha', 'divya.upalekar', 'rsawant2895', 'ninad41195', 'purva.desai', 'msumit95', 'patil.rushal825', 'chinmayaniket4052', 'anujakhose94', 'rupali.patil', 'pathanabdulrazzak9524', 'viveky803', 'kpiyushbhirud', 'tejasshinde8055', 'siddhesh401', 'sanika.dongre', 'manasi.shinde008', 'bhavikashenoy95', 'dhvanilmandalia29', 'anasnaik9987', 'mokshada', 'alohomora7', 'pranilraut17', 'suryatejachitturi', 'avinashninawe', 'apoorvasundaresan', 'aditya.apte3', 'shivanisharaf15', 'aeyjd', 'sonawane.akshayak', 'akanksha0196', 'shubhamj95', 'luke676', 'monish.nene', 'spooja.1430', 'purva.satpute', 'adwait.sable10', 'pragatinarnaware', 'gsawant999', 'nehadingankar', 'deepikachaman3', 'patelu997', 'mshirali23', 'nikhildubey02051996', 'shwecchajain', 'akshata.kulkarni', 'kadamrupesh1996', 'shweta1811', 'stanabk', 'rohankhollamkar', 'upadhyechinmay', 'cooldudeakshu', 'juhi.manglani', 'vaishnavi.sambrekar', 'komalbapna.kb', 'ritesh.shukla', 'mugdha.dalvi', 'amanpal56', 'gupta.ravi1996', 'dipmads', 'rajatkedia95', 'ankurbhagwat8', 'harshal.dangat1', 'florence9344', 'shubham.gaikwad', 'sanjana.advani', 'priyuk', 'priyeshd', 'tanvi.rane1995', 'ambani', 'umeshdarade77', 'tanayshinde21', 'cvvedesh', 'karan.dadlani', 'pravin45', 'tejaskanagal95', 'doshishrut1995', 'kondekar23', 'poojamenon16.pm', 'mihirsawant17', 'rahul4peace', 'rahul1995', 'rhea.ann.95', 'rawletanmayee46', 'ajthamke40', 'rashuidiot', 'minal.patil', 'chaitanyakhachane95', 'johebshaikh', 'harshada123', 'mahajanabhi2201', 'abhishekpatkar1796', 'abhihadshi', 'lakshmi.nair', 'bharathi.pedapudi', 'gauravrajeshmehta', 'mudbidrijay', 'rutvij.supekar', 'codekidx', 'pbrahmapurkar', 'pathakrohan18', 'shreyasvkul', 'mananmehta7', 'chirag184', 'prathameshptkr4', 'aparnaahari95', 'tarak.shah', 'mervyn.fernandes', 'ashishmohite1996', 'akshayshinde101095', 'manavtrivedi03', 'vivek12195', 'nikhilgade', 'arvindlandge', 'anasnaik25', 'akshay21', 'mukul.kulkarni', 'sardesai.kirti18', 'shraddhag', 'vishaakn', 'amrsha.srivastava', 'apurva.patil', 'bhavesh.singh', 'omkardalvi409', 'shriya.sharma', 'lakumveer', 'shreyamath95', 'dhruv.gajaria95', 'mohak11jan', 'parthiv.parikh', 'sandipani1995', 'akashspawar148', 'khannamansi312', 'vishakha1805', 'yashgumaste', 'nileshkartik95', 'neilmundhe', 'shreya.mahajan', 'jainam49', 'jakhererahul42', 'pavitra.iyer', 'dattaram.gawade781', 'tejaschaudhary1996', 'vaibhav.gangan7', 'ankita.rahate', 'shamikabachal', 'swapkaru123', 'saheli.konde', 'prashant.baperkar', 'suman28pandit', 'rakeshmaity', 'aakashgangolli3112', 'prachi.more', 'rohanchavan', 'guptesoham95', 'ptrimukhe32']"
76,214,13,59,12,"['shraddhag', 'krittikaranga', 'tejaschaudhary1996', 'lakshmi.nair', 'vishaakn', 'ninad41195', 'saheli.konde', 'aeyjd', 'lakhanmodani1811', 'prachi.more', 'pavitra.iyer', 'guptesoham95']",0,[],47,"['vaishnavi.sambrekar', 'divya.upalekar', 'purva.desai', 'ashishmohite1996', 'ritesh.shukla', 'mervyn.fernandes', 'bhavesh3422', 'mugdha.dalvi', 'nikhilgade', 'arvindlandge', 'anasnaik25', 'aniket187', 'ankurbhagwat8', 'harshal.dangat1', 'pathanabdulrazzak9524', 'rajdeepd', 'kpiyushbhirud', 'shraddhad', 'tejasshinde8055', 'abhishekg95', 'gujarathikshitij', 'suraj.taigade', 'bhavesh.singh', 'bhavikashenoy95', 'neha.utekar2608', 'shreyamath95', 'mokshada', 'rahul1995', 'arpit32', 'abhishek1996', 'minal.patil', 'johebshaikh', 'yashgumaste', 'simran123', 'nehadingankar', 'gsawant999', None, '22diptinikalje', 'patelu997', 'rutvij.supekar', 'mudbidrijay', 'akshata.kulkarni', 'swapkaru123', 'pathakrohan18', 'mananmehta7', 'geeta.kavitake', 'nehasankeshi']",59,"['vaishnavi.sambrekar', 'ritesh.shukla', 'bhavesh3422', 'mugdha.dalvi', 'aniket187', 'ankurbhagwat8', 'harshal.dangat1', 'krittikaranga', 'rajdeepd', 'shraddhad', 'abhishekg95', 'gujarathikshitij', 'neha.utekar2608', 'rahul1995', 'arpit32', 'abhishek1996', 'minal.patil', 'johebshaikh', 'lakhanmodani1811', 'simran123', '22diptinikalje', 'lakshmi.nair', 'rutvij.supekar', 'mudbidrijay', 'pathakrohan18', 'mananmehta7', 'geeta.kavitake', 'suraj.taigade', 'nehasankeshi', 'divya.upalekar', 'purva.desai', 'ninad41195', 'ashishmohite1996', 'mervyn.fernandes', 'nikhilgade', 'arvindlandge', 'anasnaik25', 'shraddhag', 'pathanabdulrazzak9524', 'vishaakn', 'kpiyushbhirud', 'tejasshinde8055', 'bhavesh.singh', 'bhavikashenoy95', 'shreyamath95', 'mokshada', 'aeyjd', 'yashgumaste', 'pavitra.iyer', 'nehadingankar', 'gsawant999', None, 'patelu997', 'tejaschaudhary1996', 'akshata.kulkarni', 'swapkaru123', 'saheli.konde', 'prachi.more', 'guptesoham95']"
78,246,13,83,3,"['jqian10', 'mckillo2', 'harrisian84']",9,"['zzumich', 'khonds', 'kryrin', 'alanmshaw', 'krouf', 'yogeshjasra', 'smsvklut', 'jbajofranklin', 'rickfreedom']",80,"['mepaul2', 'prhogan2', 'tianshu2', 'yaoyao5', 'balung18', 'dfrosen2', 'ychu18', 'zzhan134', 'zohair2', 'yuqiuwu2', 'cwang112', 'alfeche2', 'berglun2', 'aokisang', 'thiruve2', 'ychen254', 'krithikp', 'arovgno', 'jonbaebae', 'akononov', 'jackylu2', 'jcselle2', 'ajfrank3', 'deepakcmani', 'ychen375', 'amber.snil', 'rwlandi2', 'aladd2', 'junetheyula', 'dli29', 'katarukaamrita', 'dlitt2', 'tmolley2', 'kjnnngs2', 'jhmead2', 'pbehera2', 'drew.wise.10', 'wtroth2', 'mchang14', 'jsshin3', 'scorchnoxap', 'zafar3', 'cdeegan2', 'sbumbles96', 'ruining2', 'mingye.gao', 'goszkow2', 'zhaber2', 'slohman2', 'awlong2', 'hzhan126', 'cssmith4', 'kote.deepa', 'reningr2', 'jacob.dutler', 'crickettay13', 'jdlin4', 'maggana2', 'pshetty3', 'hmajith2', 'cmander4', 'mtschro3', 'meiselm2', 'jeroach2', 'akim102', 'jhbaker3', 'tcalder2', 'trskwsk2', 'junehan1', 'nuanes2', None, 'jeoneil6', 'zjcszzl0615', 'mclawso2', 'zlong4', 'yhuan127', 'pross4', 'xlz.287', 'yiyue.luo.9', 'echoma']",92,"['mepaul2', 'prhogan2', 'tianshu2', 'kryrin', 'yaoyao5', 'balung18', 'dfrosen2', 'ychu18', 'zzhan134', 'yogeshjasra', 'zohair2', 'yuqiuwu2', 'cwang112', 'alfeche2', 'berglun2', 'aokisang', 'thiruve2', 'ychen254', 'krithikp', 'arovgno', 'jonbaebae', 'akononov', 'jackylu2', 'jcselle2', 'ajfrank3', 'smsvklut', 'deepakcmani', 'ychen375', 'amber.snil', 'rwlandi2', 'aladd2', 'junetheyula', 'dli29', 'katarukaamrita', 'dlitt2', 'tmolley2', 'kjnnngs2', 'jhmead2', 'pbehera2', 'drew.wise.10', 'krouf', 'wtroth2', 'mchang14', 'harrisian84', 'jsshin3', 'scorchnoxap', 'zafar3', 'cdeegan2', 'sbumbles96', 'jqian10', 'ruining2', 'mingye.gao', 'goszkow2', 'zhaber2', 'slohman2', 'awlong2', 'hzhan126', 'cssmith4', 'khonds', 'kote.deepa', 'reningr2', 'jacob.dutler', 'crickettay13', 'jdlin4', 'maggana2', 'pshetty3', 'hmajith2', 'cmander4', 'mtschro3', 'meiselm2', 'rickfreedom', 'jeroach2', 'zzumich', 'mckillo2', 'akim102', 'jhbaker3', 'tcalder2', 'alanmshaw', 'trskwsk2', 'junehan1', 'nuanes2', 'jbajofranklin', None, 'jeoneil6', 'zjcszzl0615', 'mclawso2', 'zlong4', 'yhuan127', 'pross4', 'xlz.287', 'yiyue.luo.9', 'echoma']"
78,124,13,27,2,"['kryrin', 'rickfreedom']",10,"['zzumich', 'khonds', 'mckillo2', 'jqian10', 'alanmshaw', 'krouf', 'yogeshjasra', 'smsvklut', 'harrisian84', 'jbajofranklin']",25,"['atmat', 'njvaughn', 'huxiaoer', 'erowell', 'greyholm', 'kavaidya', 'cmbaums', 'zzhiheng', 'kige', 'afchadwi', 'ymhuang', 'umjihgl', 'ywwoo', 'jibecker', 'jenningd', 'casansmi', 'zzhiheng123', None, 'masonab', 'afashwhi', 'keyicai', 'lworyk', 'mbnicola', 'zzhiheng126', 'yangpan']",37,"['atmat', 'njvaughn', 'jqian10', 'kryrin', 'huxiaoer', 'erowell', 'yogeshjasra', 'greyholm', 'kavaidya', 'cmbaums', 'zzhiheng', 'kige', 'khonds', 'afchadwi', 'ymhuang', 'umjihgl', 'ywwoo', 'jibecker', 'rickfreedom', 'zzumich', 'mckillo2', 'jenningd', 'alanmshaw', 'smsvklut', 'casansmi', 'jbajofranklin', 'zzhiheng123', None, 'masonab', 'afashwhi', 'keyicai', 'krouf', 'harrisian84', 'mbnicola', 'lworyk', 'zzhiheng126', 'yangpan']"
78,247,13,16,3,"['zzumich', 'kryrin', 'rickfreedom']",9,"['khonds', 'mckillo2', 'jqian10', 'alanmshaw', 'krouf', 'yogeshjasra', 'smsvklut', 'harrisian84', 'jbajofranklin']",13,"['kavaidya', 'njvaughn', 'keyicai', 'ymhuang', 'ywwoo', 'greyholm', 'jibecker', 'casansmi', 'jenningd', 'cmbaums', 'yangpan', None, 'kige']",25,"['zzumich', 'njvaughn', 'mckillo2', 'jqian10', 'kryrin', 'alanmshaw', 'yogeshjasra', 'greyholm', 'smsvklut', 'casansmi', 'jbajofranklin', 'kavaidya', 'cmbaums', 'yangpan', None, 'kige', 'khonds', 'ymhuang', 'keyicai', 'krouf', 'ywwoo', 'jibecker', 'harrisian84', 'jenningd', 'rickfreedom']"
79,107,12,31,9,"['avc213', 'hliyanag', 'kimys6553', 'sichen10', 'monanafari', 'knikolaidou', 'hpsingh', 'pedramnano', 'sheida.r85']",2,"['jdogzz.g5', 'bramvi']",22,"['gayatrik123', 'alabastri85', 'akadata90', 'rene.nome', 'somsarang1990', 'mbartolo', 'bbrahmbh', 'hublt', 'ianmhill1', 'jflemineur', 'qishengjiang', 'rubehub', 'sirimuvva', 'asrael', 'sobh1', None, 'sonu86', 'ryan.wangzheyu', 'alqadi2', 'xzhang10', 'ctc809', 'wilsonaj']",33,"['avc213', 'gayatrik123', 'alabastri85', 'akadata90', 'somsarang1990', 'rene.nome', 'mbartolo', 'bbrahmbh', 'kimys6553', 'hublt', 'monanafari', 'knikolaidou', 'bramvi', 'sheida.r85', 'jflemineur', 'ianmhill1', 'qishengjiang', 'jdogzz.g5', 'rubehub', 'sirimuvva', 'hpsingh', 'pedramnano', 'asrael', 'sobh1', None, 'sonu86', 'ryan.wangzheyu', 'hliyanag', 'sichen10', 'alqadi2', 'xzhang10', 'ctc809', 'wilsonaj']"
79,251,12,28,9,"['avc213', 'hliyanag', 'kimys6553', 'sichen10', 'monanafari', 'knikolaidou', 'hpsingh', 'pedramnano', 'sheida.r85']",2,"['jdogzz.g5', 'bramvi']",19,"['gayatrik123', 'alabastri85', 'somsarang1990', 'mbartolo', 'bbrahmbh', 'hublt', 'ianmhill1', 'jflemineur', 'qishengjiang', 'rubehub', 'sirimuvva', 'asrael', 'sobh1', None, 'ryan.wangzheyu', 'alqadi2', 'xzhang10', 'ctc809', 'wilsonaj']",30,"['avc213', 'gayatrik123', 'alabastri85', 'somsarang1990', 'mbartolo', 'bbrahmbh', 'kimys6553', 'hublt', 'monanafari', 'knikolaidou', 'bramvi', 'sheida.r85', 'jflemineur', 'ianmhill1', 'qishengjiang', 'jdogzz.g5', 'rubehub', 'sirimuvva', 'hpsingh', 'pedramnano', 'asrael', 'sobh1', None, 'ryan.wangzheyu', 'hliyanag', 'sichen10', 'alqadi2', 'xzhang10', 'ctc809', 'wilsonaj']"
80,203,12,12,9,"['yousfalshatti', 'halajmi', 'abudi.14.k', 'fahadshtail', 'noura', 'sarahqht', 'yousef.alsha6y', 'reemalajmii', 'tomba7ala']",2,"['deyh', 'sonalibj8']",3,"['swairalh', 'ndhafeeri', None]",14,"['swairalh', 'halajmi', 'abudi.14.k', 'deyh', 'noura', 'sonalibj8', None, 'yousfalshatti', 'fahadshtail', 'ndhafeeri', 'sarahqht', 'yousef.alsha6y', 'reemalajmii', 'tomba7ala']"
81,259,12,15,1,['moook159'],10,"['nidhikapuria6', 'mahmoudrefaat84', 'dsli', 'ps994788', 'shah.kv', 'mwcarmody', 'jairaj.jangle', 'alexandrgntp', 'anton.dys', 'siu853965041']",14,"['sgu20121552', 'sgu20121541', 'kwonhyugsu', 'sgu20121479', 'woojungtae', 'sgu20121476', 'sgu20121514', 'sgu20121468', None, 'sogang1536', 'sgu20121481', 'sgu20121540', 'sgu20121446', 'sgu20121522']",25,"['nidhikapuria6', 'sgu20121541', 'mahmoudrefaat84', 'sgu20121479', 'sgu20121481', 'ps994788', 'alexandrgntp', 'jairaj.jangle', 'sgu20121514', None, 'sgu20121522', 'sgu20121552', 'kwonhyugsu', 'moook159', 'dsli', 'shah.kv', 'mwcarmody', 'woojungtae', 'sgu20121476', 'sgu20121468', 'anton.dys', 'siu853965041', 'sgu20121540', 'sgu20121446', 'sogang1536']"
81,260,12,14,2,"['nidhikapuria6', 'shah.kv']",9,"['mahmoudrefaat84', 'moook159', 'dsli', 'ps994788', 'mwcarmody', 'alexandrgntp', 'jairaj.jangle', 'anton.dys', 'siu853965041']",12,"['manthan.thakkar', 'harshil.makwana', 'rutuj.t', 'abhishek09', 'akshay.bharadwaj', 'priya.pujara', 'ajish.nair', 'hem.s', 'tushar.bait', 'prabaha31', None, 'chaitanya09pandya']",23,"['nidhikapuria6', 'mahmoudrefaat84', 'rutuj.t', 'ps994788', 'alexandrgntp', 'jairaj.jangle', 'priya.pujara', 'tushar.bait', 'prabaha31', None, 'moook159', 'dsli', 'manthan.thakkar', 'harshil.makwana', 'abhishek09', 'shah.kv', 'mwcarmody', 'akshay.bharadwaj', 'ajish.nair', 'hem.s', 'anton.dys', 'siu853965041', 'chaitanya09pandya']"
82,100,12,11,1,['eklump'],10,"['sebastianb1612', 'junwei', 'mag13', 'zanajk', 'smatth3125', 'skoester2010', 'lrl11496', 'rohunp', 'cjacobcaldera', 'annieshaider']",10,"['jwfrenc2', 'mkmoody', 'liffland', 'djblivin', 'jaconno2', 'brennerncsuedu', 'abmcginn', 'taleona3', None, 'gwcrego']",21,"['liffland', 'djblivin', 'eklump', 'jaconno2', 'brennerncsuedu', 'zanajk', 'smatth3125', 'taleona3', 'gwcrego', 'cjacobcaldera', None, 'jwfrenc2', 'sebastianb1612', 'mkmoody', 'junwei', 'mag13', 'abmcginn', 'rohunp', 'skoester2010', 'lrl11496', 'annieshaider']"
82,101,12,7,3,"['lrl11496', 'zanajk', 'rohunp']",8,"['sebastianb1612', 'junwei', 'mag13', 'eklump', 'smatth3125', 'skoester2010', 'cjacobcaldera', 'annieshaider']",4,"['yonicooper3', None, 'trishar', 'lbassett']",15,"['yonicooper3', 'sebastianb1612', 'annieshaider', 'trishar', 'lbassett', 'junwei', 'mag13', 'eklump', 'zanajk', 'smatth3125', 'skoester2010', 'lrl11496', None, 'cjacobcaldera', 'rohunp']"
83,47,12,207,9,"['alohomora7', 'sanjana.advani', 'bharathi.pedapudi', 'mohak11jan', 'abhishekpatkar1796', 'adwait.sable10', 'aimomajy', 'anasnaik9987', 'ajinkyachadha']",2,"['yagamirane', 'suyogingle93']",198,"['nitingurme', 'kadamk008', 'bhavesh3422', 'aniket187', 'rehansonarkar784', 'jainamshah202', 'nrkhara', 'ajay.raghuwanshi', 'krittikaranga', 'trija68', 'rajdeepd', 'brian200495', 'shraddhad', 'rananeetika3', 'mehtajinal3101', 'vinit95vasudevan', 'gujarathikshitij', 'zkoyande', 'minalsawant1108', 'neha.utekar2608', 'email.harsh0811', 'himanshuphatak98', 'arpit32', 'nikitarane245', 'bhoomee.sheth', 'abhishek1996', 'obalgi3095', 'kambe302', 'lakhanmodani1811', 'simran123', 'rajwaje44', 'jayjadav08', 'neelam.chaudhari27', '22diptinikalje', 'sebastian007', 'tanvikalan', 'harshilmehta1995', 'komal31p', 'poojashetty', 'darshanadaund27', 'sam234bryant', 'nagateja.vlsi', 'bhumivora1995', 'geeta.kavitake', 'mapethe', 'sid.rane95', 'jaidevdalvi', 'suraj.taigade', 'monish.kapadia', 'ratsthegreat', 'divya.upalekar', 'rsawant2895', 'ninad41195', 'purva.desai', 'msumit95', 'patil.rushal825', 'chinmayaniket4052', 'anujakhose94', 'rupali.patil', 'pathanabdulrazzak9524', 'viveky803', 'kpiyushbhirud', 'tejasshinde8055', 'siddhesh401', 'sanika.dongre', 'manasi.shinde008', 'bhavikashenoy95', 'dhvanilmandalia29', 'mokshada', 'pranilraut17', 'suryatejachitturi', 'avinashninawe', 'apoorvasundaresan', 'aditya.apte3', 'shivanisharaf15', 'sonawane.akshayak', 'akanksha0196', 'shubhamj95', 'aeyjd', 'luke676', 'monish.nene', 'spooja.1430', 'purva.satpute', 'pragatinarnaware', 'gsawant999', 'nehadingankar', 'deepikachaman3', 'patelu997', 'mshirali23', 'nikhildubey02051996', 'shwecchajain', 'akshata.kulkarni', 'kadamrupesh1996', 'shweta1811', 'stanabk', 'rohankhollamkar', 'upadhyechinmay', 'cooldudeakshu', 'juhi.manglani', 'vaishnavi.sambrekar', 'komalbapna.kb', 'ritesh.shukla', 'mugdha.dalvi', 'amanpal56', 'gupta.ravi1996', 'dipmads', 'rajatkedia95', 'ankurbhagwat8', 'harshal.dangat1', 'florence9344', 'shubham.gaikwad', 'priyuk', 'priyeshd', 'tanvi.rane1995', 'ambani', 'umeshdarade77', 'tanayshinde21', 'cvvedesh', 'karan.dadlani', 'pravin45', 'tejaskanagal95', 'doshishrut1995', 'kondekar23', 'poojamenon16.pm', 'mihirsawant17', 'rahul4peace', 'rahul1995', 'rhea.ann.95', 'rawletanmayee46', 'ajthamke40', 'rashuidiot', 'minal.patil', 'chaitanyakhachane95', 'johebshaikh', 'harshada123', 'mahajanabhi2201', 'abhihadshi', 'lakshmi.nair', 'gauravrajeshmehta', 'mudbidrijay', 'rutvij.supekar', 'codekidx', 'pbrahmapurkar', 'pathakrohan18', 'shreyasvkul', 'mananmehta7', 'chirag184', 'prathameshptkr4', 'aparnaahari95', 'tarak.shah', 'mervyn.fernandes', 'ashishmohite1996', 'akshayshinde101095', 'manavtrivedi03', 'vivek12195', 'nikhilgade', 'arvindlandge', 'anasnaik25', 'akshay21', 'mukul.kulkarni', 'sardesai.kirti18', 'shraddhag', 'vishaakn', 'amrsha.srivastava', 'apurva.patil', 'bhavesh.singh', 'omkardalvi409', 'shriya.sharma', 'lakumveer', 'shreyamath95', 'dhruv.gajaria95', 'parthiv.parikh', 'sandipani1995', 'akashspawar148', 'khannamansi312', 'vishakha1805', 'yashgumaste', 'nileshkartik95', 'neilmundhe', 'shreya.mahajan', 'jainam49', 'jakhererahul42', 'dattaram.gawade781', 'pavitra.iyer', 'tejaschaudhary1996', 'vaibhav.gangan7', 'ankita.rahate', 'shamikabachal', 'swapkaru123', 'saheli.konde', 'prashant.baperkar', 'suman28pandit', 'rakeshmaity', 'aakashgangolli3112', 'prachi.more', 'rohanchavan', 'guptesoham95', 'ptrimukhe32']",209,"['nitingurme', 'kadamk008', 'bhavesh3422', 'aniket187', 'rehansonarkar784', 'jainamshah202', 'aimomajy', 'nrkhara', 'ajay.raghuwanshi', 'krittikaranga', 'trija68', 'rajdeepd', 'brian200495', 'shraddhad', 'rananeetika3', 'mehtajinal3101', 'vinit95vasudevan', 'gujarathikshitij', 'zkoyande', 'minalsawant1108', 'neha.utekar2608', 'email.harsh0811', 'himanshuphatak98', 'arpit32', 'nikitarane245', 'bhoomee.sheth', 'abhishek1996', 'obalgi3095', 'kambe302', 'lakhanmodani1811', 'simran123', 'rajwaje44', 'jayjadav08', 'neelam.chaudhari27', '22diptinikalje', 'sebastian007', 'tanvikalan', 'harshilmehta1995', 'komal31p', 'poojashetty', 'darshanadaund27', 'sam234bryant', 'nagateja.vlsi', 'bhumivora1995', 'geeta.kavitake', 'mapethe', 'sid.rane95', 'jaidevdalvi', 'suraj.taigade', 'monish.kapadia', 'ratsthegreat', 'ajinkyachadha', 'divya.upalekar', 'rsawant2895', 'ninad41195', 'purva.desai', 'msumit95', 'patil.rushal825', 'chinmayaniket4052', 'anujakhose94', 'rupali.patil', 'pathanabdulrazzak9524', 'viveky803', 'kpiyushbhirud', 'tejasshinde8055', 'siddhesh401', 'sanika.dongre', 'manasi.shinde008', 'bhavikashenoy95', 'dhvanilmandalia29', 'anasnaik9987', 'mokshada', 'alohomora7', 'pranilraut17', 'suryatejachitturi', 'avinashninawe', 'apoorvasundaresan', 'aditya.apte3', 'prachi.more', 'shivanisharaf15', 'sonawane.akshayak', 'akanksha0196', 'shubhamj95', 'aeyjd', 'luke676', 'monish.nene', 'spooja.1430', 'purva.satpute', 'adwait.sable10', 'pragatinarnaware', 'gsawant999', 'nehadingankar', 'deepikachaman3', 'patelu997', 'mshirali23', 'nikhildubey02051996', 'shwecchajain', 'akshata.kulkarni', 'kadamrupesh1996', 'shweta1811', 'stanabk', 'rohankhollamkar', 'upadhyechinmay', 'cooldudeakshu', 'juhi.manglani', 'vaishnavi.sambrekar', 'komalbapna.kb', 'ritesh.shukla', 'mugdha.dalvi', 'amanpal56', 'gupta.ravi1996', 'dipmads', 'rajatkedia95', 'ankurbhagwat8', 'harshal.dangat1', 'florence9344', 'shubham.gaikwad', 'sanjana.advani', 'priyuk', 'priyeshd', 'tanvi.rane1995', 'ambani', 'umeshdarade77', 'tanayshinde21', 'cvvedesh', 'karan.dadlani', 'pravin45', 'tejaskanagal95', 'doshishrut1995', 'kondekar23', 'poojamenon16.pm', 'mihirsawant17', 'rahul4peace', 'rahul1995', 'rhea.ann.95', 'rawletanmayee46', 'ajthamke40', 'rashuidiot', 'minal.patil', 'chaitanyakhachane95', 'johebshaikh', 'harshada123', 'mahajanabhi2201', 'suyogingle93', 'abhishekpatkar1796', 'abhihadshi', 'bharathi.pedapudi', 'lakshmi.nair', 'gauravrajeshmehta', 'mudbidrijay', 'rutvij.supekar', 'codekidx', 'pbrahmapurkar', 'pathakrohan18', 'shreyasvkul', 'mananmehta7', 'chirag184', 'prathameshptkr4', 'aparnaahari95', 'tarak.shah', 'mervyn.fernandes', 'ashishmohite1996', 'akshayshinde101095', 'manavtrivedi03', 'vivek12195', 'nikhilgade', 'yagamirane', 'arvindlandge', 'anasnaik25', 'akshay21', 'mukul.kulkarni', 'sardesai.kirti18', 'shraddhag', 'vishaakn', 'amrsha.srivastava', 'apurva.patil', 'bhavesh.singh', 'omkardalvi409', 'shriya.sharma', 'lakumveer', 'shreyamath95', 'dhruv.gajaria95', 'mohak11jan', 'parthiv.parikh', 'sandipani1995', 'akashspawar148', 'khannamansi312', 'vishakha1805', 'yashgumaste', 'nileshkartik95', 'neilmundhe', 'shreya.mahajan', 'jainam49', 'jakhererahul42', 'dattaram.gawade781', 'tejaschaudhary1996', 'vaibhav.gangan7', 'ankita.rahate', 'shamikabachal', 'swapkaru123', 'saheli.konde', 'prashant.baperkar', 'suman28pandit', 'rakeshmaity', 'aakashgangolli3112', 'pavitra.iyer', 'rohanchavan', 'guptesoham95', 'ptrimukhe32']"
84,120,11,21,9,"['shanehwa', 'haoxian', 'amalsubh', 'dangeunk', 'njskinner', 'carangel', 'carterb25', 'ksilva', 'long6659']",1,['jftraynor'],12,"['lltrinh', 'jbrizzy', 'awestle', 'rvchop', 'bmsuen', 'ddvalles', None, 'eabeeman', 'ezdude', 'rjbunk', 'alexm', 'myang96']",22,"['lltrinh', 'rvchop', 'haoxian', 'bmsuen', 'amalsubh', 'dangeunk', 'awestle', 'eabeeman', 'ezdude', 'rjbunk', 'ksilva', 'alexm', None, 'shanehwa', 'jbrizzy', 'jftraynor', 'ddvalles', 'njskinner', 'carangel', 'carterb25', 'myang96', 'long6659']"
85,120,11,21,10,"['lltrinh', 'jbrizzy', 'awestle', 'ddvalles', 'bmsuen', 'eabeeman', 'ezdude', 'rjbunk', 'alexm', 'myang96']",0,[],11,"['shanehwa', 'rvchop', 'haoxian', 'amalsubh', 'dangeunk', 'njskinner', 'carangel', 'carterb25', 'ksilva', None, 'long6659']",21,"['lltrinh', 'rvchop', 'bmsuen', 'haoxian', 'amalsubh', 'dangeunk', 'eabeeman', 'awestle', 'ezdude', 'rjbunk', 'alexm', 'ksilva', None, 'shanehwa', 'jbrizzy', 'ddvalles', 'njskinner', 'carangel', 'carterb25', 'myang96', 'long6659']"
87,143,10,22,4,"['cwalker', 'bradygarringer', 'alejandromontoya', 'majeed']",5,"['greenfish1308', 'slezionad', 'erikjensen1984', 'meganfrary', 'mstan']",18,"['williamcrow', 'arminmirahcic', 'jfreilich', 'andrescorrea', 'devankarsann', 'ziyadbinsulaiman', 'nickcarter', 'jakesoares', 'addielupercio', 'seanokelley', 'codylynde', 'riccardotorsi', 'strcroft', 'mitchellleibowitz', 'arvincunningham', None, 'melissabranagan', 'twinters']",27,"['andrescorrea', 'devankarsann', 'nickcarter', 'cwalker', 'codylynde', 'strcroft', 'bradygarringer', 'majeed', 'mstan', None, 'twinters', 'williamcrow', 'arminmirahcic', 'jfreilich', 'ziyadbinsulaiman', 'jakesoares', 'greenfish1308', 'slezionad', 'addielupercio', 'seanokelley', 'erikjensen1984', 'riccardotorsi', 'alejandromontoya', 'meganfrary', 'mitchellleibowitz', 'arvincunningham', 'melissabranagan']"
87,142,10,10,7,"['greenfish1308', 'cwalker', 'erikjensen1984', 'bradygarringer', 'alejandromontoya', 'majeed', 'meganfrary']",2,"['mstan', 'slezionad']",3,"['ziyadbinsulaiman', None, 'andrescorrea']",12,"['andrescorrea', 'cwalker', 'bradygarringer', 'majeed', 'mstan', None, 'greenfish1308', 'slezionad', 'erikjensen1984', 'alejandromontoya', 'meganfrary', 'ziyadbinsulaiman']"
88,249,10,11,1,['anylook'],8,"['sauberyang', 'mjdonahue', 'paulajanusonis', 'yihengrao', 'lijuan_qian', 'ip558', 'mcskj', 'buspinboun']",10,"['zhiweiren321', 'maglabf', 'mag3718', 'mag2046', 'mag189', 'banmeng', 'haidiyou', 'anyint', None, 'malab']",19,"['mag3718', 'mag2046', 'mag189', 'anylook', 'yihengrao', 'banmeng', 'haidiyou', 'anyint', 'lijuan_qian', 'ip558', 'mcskj', None, 'zhiweiren321', 'maglabf', 'sauberyang', 'mjdonahue', 'paulajanusonis', 'malab', 'buspinboun']"
89,107,10,31,9,"['ryan.wangzheyu', 'bbrahmbh', 'hublt', 'sirimuvva', 'somsarang1990', 'ianmhill1', 'mbartolo', 'qishengjiang', 'wilsonaj']",0,[],22,"['avc213', 'gayatrik123', 'alabastri85', 'akadata90', 'rene.nome', 'kimys6553', 'monanafari', 'knikolaidou', 'sheida.r85', 'jflemineur', 'rubehub', 'hpsingh', 'pedramnano', 'asrael', 'sobh1', None, 'sonu86', 'hliyanag', 'sichen10', 'alqadi2', 'xzhang10', 'ctc809']",31,"['avc213', 'gayatrik123', 'alabastri85', 'akadata90', 'somsarang1990', 'rene.nome', 'mbartolo', 'bbrahmbh', 'hublt', 'kimys6553', 'monanafari', 'knikolaidou', 'ianmhill1', 'jflemineur', 'qishengjiang', 'sheida.r85', 'rubehub', 'sirimuvva', 'hpsingh', 'pedramnano', 'asrael', 'sobh1', None, 'sonu86', 'ryan.wangzheyu', 'hliyanag', 'sichen10', 'alqadi2', 'xzhang10', 'ctc809', 'wilsonaj']"
89,251,10,28,9,"['ryan.wangzheyu', 'bbrahmbh', 'hublt', 'sirimuvva', 'somsarang1990', 'ianmhill1', 'mbartolo', 'qishengjiang', 'wilsonaj']",0,[],19,"['avc213', 'gayatrik123', 'alabastri85', 'kimys6553', 'monanafari', 'knikolaidou', 'sheida.r85', 'jflemineur', 'rubehub', 'hpsingh', 'pedramnano', 'asrael', 'sobh1', None, 'hliyanag', 'sichen10', 'alqadi2', 'xzhang10', 'ctc809']",28,"['avc213', 'gayatrik123', 'alabastri85', 'somsarang1990', 'mbartolo', 'bbrahmbh', 'hublt', 'kimys6553', 'monanafari', 'knikolaidou', 'ianmhill1', 'jflemineur', 'qishengjiang', 'sheida.r85', 'rubehub', 'sirimuvva', 'hpsingh', 'pedramnano', 'asrael', 'sobh1', None, 'ryan.wangzheyu', 'hliyanag', 'sichen10', 'alqadi2', 'xzhang10', 'ctc809', 'wilsonaj']"
89,105,10,12,9,"['ryan.wangzheyu', 'bbrahmbh', 'hublt', 'sirimuvva', 'somsarang1990', 'ianmhill1', 'mbartolo', 'qishengjiang', 'wilsonaj']",0,[],3,"['akadata90', None, 'xzhang10']",12,"['sirimuvva', 'akadata90', 'somsarang1990', 'mbartolo', None, 'ryan.wangzheyu', 'bbrahmbh', 'hublt', 'xzhang10', 'ianmhill1', 'qishengjiang', 'wilsonaj']"
90,133,10,33,9,"['sora1415', 'g1415090', 'naturally.curly.hair.ken', 'yuutazaku', 'ducniisan', 'g1415070', 'arcadia5580', 'inumarugyakuten11', 'g1415106']",0,[],24,"['yoyossi22', 'g1315091', 'yosiki', 'marui', 'ebi', 'g1415109', 'g1415105', 'niiken1995', 'g1315098', 'g1415026', 'narasaka', 'miyagi', 'g1415078', 'seninnn', 'im_prame_', 'deepdive', 'g1415007', 'g1415037', None, 'ny0602', 'hira1', 'y.shimizu', 'g1415064', 'g1415104']",33,"['yoyossi22', 'g1415090', 'ducniisan', 'yosiki', 'marui', 'g1315091', 'ebi', 'g1415106', 'sora1415', 'g1415109', 'g1415105', 'niiken1995', 'g1415070', 'arcadia5580', 'g1315098', 'g1415026', 'narasaka', 'miyagi', 'g1415078', 'seninnn', 'im_prame_', 'deepdive', 'g1415007', 'g1415037', None, 'ny0602', 'hira1', 'y.shimizu', 'naturally.curly.hair.ken', 'yuutazaku', 'g1415064', 'g1415104', 'inumarugyakuten11']"
90,255,10,28,9,"['sora1415', 'g1415090', 'naturally.curly.hair.ken', 'yuutazaku', 'ducniisan', 'g1415070', 'arcadia5580', 'inumarugyakuten11', 'g1415106']",0,[],19,"['yoyossi22', 'g1315091', 'yosiki', 'marui', 'ebi', 'g1415109', 'niiken1995', 'g1315098', 'narasaka', 'miyagi', 'g1415078', 'im_prame_', 'deepdive', 'g1415007', 'g1415037', None, 'ny0602', 'y.shimizu', 'g1415104']",28,"['yoyossi22', 'g1415090', 'ducniisan', 'yosiki', 'marui', 'g1315091', 'ebi', 'g1415106', 'sora1415', 'g1415109', 'niiken1995', 'g1415070', 'arcadia5580', 'g1315098', 'narasaka', 'miyagi', 'g1415078', 'im_prame_', 'deepdive', 'g1415007', 'g1415037', None, 'ny0602', 'y.shimizu', 'naturally.curly.hair.ken', 'yuutazaku', 'g1415104', 'inumarugyakuten11']"
91,127,10,11,9,"['janie.byrum', 'wtgrayunc12', 'pmlynarc', 'seanaller', 'mauliknariya', 'leshriver', 'kpslav99', 'bronsonw', 'rorybrittain']",0,[],2,"['youfangcao', None]",11,"['janie.byrum', 'youfangcao', 'pmlynarc', 'seanaller', 'kpslav99', None, 'wtgrayunc12', 'mauliknariya', 'leshriver', 'bronsonw', 'rorybrittain']"
92,302,10,20,9,"['nev1953', 'ap2009', 'blcale93', 'jwk28', 'kppalpa6', 'patrick002', 'mon2015', 'psimanjuntak', 'lim0722']",0,[],11,"['mr5442', 'shfiqul2997', 'zid07', 'bithi2015', 'tamzid_frcs', 'sakidja', 'mbulak92', 'krishnaharsh123', 'mb2357', 'tam07', None]",20,"['shfiqul2997', 'nev1953', 'blcale93', 'zid07', 'mbulak92', 'kppalpa6', 'mb2357', 'krishnaharsh123', 'mon2015', 'tamzid_frcs', 'psimanjuntak', 'patrick002', 'ap2009', 'lim0722', None, 'mr5442', 'bithi2015', 'jwk28', 'sakidja', 'tam07']"
92,306,10,20,9,"['nev1953', 'ap2009', 'blcale93', 'jwk28', 'kppalpa6', 'patrick002', 'mon2015', 'psimanjuntak', 'lim0722']",0,[],11,"['samiul001', 'mr5442', 'shfiqul2997', 'zid07', 'apelton2009', 'sakidja', 'mbulak92', 'krishnaharsh123', 'mb2357', 'tam07', None]",20,"['samiul001', 'shfiqul2997', 'nev1953', 'blcale93', 'zid07', 'mbulak92', 'kppalpa6', 'mb2357', 'krishnaharsh123', 'mon2015', None, 'psimanjuntak', 'patrick002', 'ap2009', 'lim0722', 'mr5442', 'jwk28', 'apelton2009', 'sakidja', 'tam07']"
92,301,10,19,9,"['nev1953', 'ap2009', 'blcale93', 'jwk28', 'kppalpa6', 'patrick002', 'mon2015', 'psimanjuntak', 'lim0722']",0,[],10,"['samiul001', 'mr5442', 'shfiqul2997', 'zid07', 'tamzid_frcs', 'sakidja', 'mbulak92', 'krishnaharsh123', 'mb2357', None]",19,"['samiul001', 'shfiqul2997', 'nev1953', 'blcale93', 'zid07', 'mbulak92', 'kppalpa6', 'mb2357', 'krishnaharsh123', 'mon2015', 'tamzid_frcs', 'psimanjuntak', 'patrick002', 'ap2009', 'lim0722', None, 'mr5442', 'jwk28', 'sakidja']"
92,125,10,15,8,"['ap2009', 'blcale93', 'jwk28', 'kppalpa6', 'mon2015', 'lim0722', 'patrick002', 'psimanjuntak']",1,['nev1953'],7,"['mr5442', 'zid07', 'apelton2009', 'mbulak92', 'sakidja', 'tam07', None]",16,"['nev1953', 'blcale93', 'zid07', 'mbulak92', 'kppalpa6', 'mon2015', None, 'psimanjuntak', 'patrick002', 'ap2009', 'lim0722', 'mr5442', 'jwk28', 'apelton2009', 'sakidja', 'tam07']"
92,304,10,15,9,"['nev1953', 'ap2009', 'blcale93', 'jwk28', 'kppalpa6', 'patrick002', 'mon2015', 'psimanjuntak', 'lim0722']",0,[],6,"['mb2357', 'mbulak92', 'krishnaharsh123', 'sakidja', 'tam07', None]",15,"['nev1953', 'blcale93', 'mbulak92', 'kppalpa6', 'krishnaharsh123', 'mb2357', 'mon2015', None, 'psimanjuntak', 'patrick002', 'ap2009', 'lim0722', 'jwk28', 'sakidja', 'tam07']"
92,121,10,14,9,"['nev1953', 'ap2009', 'blcale93', 'jwk28', 'kppalpa6', 'patrick002', 'mon2015', 'psimanjuntak', 'lim0722']",0,[],5,"['mb2357', 'krishnaharsh123', 'sakidja', 'tam07', None]",14,"['nev1953', 'blcale93', 'kppalpa6', 'krishnaharsh123', 'mb2357', 'mon2015', None, 'psimanjuntak', 'patrick002', 'ap2009', 'lim0722', 'jwk28', 'sakidja', 'tam07']"
93,187,10,41,9,"['jimmyshackford', 'vishnu.gottiparthy', 'cassidee.kido', 'wxy961105', 'mbognar', 'melhorowitz', 'abuilding', 'starlight8910', 'davidhzheng']",0,[],32,"['techcrystal', 'ras70', 'c1coollguy', 'jakemullettwv', 'nathanielbrooke', 'minhtran', 'entropy.tony', 'belaltaher8', 'someonebob156', 'kaylaschulz', 'assaadserge', 'gauri_prasad', 'parkerpearson', 'niyazi.sarah', 'at200', 'zhamx1995', 'yi.yan.tay', 'eric6.song', 'jihane', 'suzhou', 'gwd3', 'zhewang828', 'emilyshannon95', 'mtran97', 'jcorey018', 'narendly', None, 'paulcruz74', 'aditya.srinivasan', 'williamma0823', 'chengshunzhang', 'meb100']",41,"['jimmyshackford', 'techcrystal', 'ras70', 'wxy961105', 'mbognar', 'c1coollguy', 'jakemullettwv', 'nathanielbrooke', 'melhorowitz', 'minhtran', 'entropy.tony', 'vishnu.gottiparthy', 'belaltaher8', 'someonebob156', 'kaylaschulz', 'assaadserge', 'gauri_prasad', 'parkerpearson', 'niyazi.sarah', 'at200', 'zhamx1995', 'yi.yan.tay', 'eric6.song', 'jihane', 'suzhou', 'gwd3', 'abuilding', 'zhewang828', 'emilyshannon95', 'mtran97', 'jcorey018', 'narendly', 'davidhzheng', None, 'paulcruz74', 'cassidee.kido', 'aditya.srinivasan', 'williamma0823', 'chengshunzhang', 'starlight8910', 'meb100']"
93,199,10,10,9,"['jimmyshackford', 'vishnu.gottiparthy', 'cassidee.kido', 'wxy961105', 'mbognar', 'melhorowitz', 'abuilding', 'starlight8910', 'davidhzheng']",0,[],1,[None],10,"['jimmyshackford', 'wxy961105', 'mbognar', 'abuilding', 'davidhzheng', 'melhorowitz', None, 'vishnu.gottiparthy', 'cassidee.kido', 'starlight8910']"
94,157,10,45,8,"['zjt173720', 'xingzy3', 'tanjm32', 'weny2016', 'focmsphyliu', 'jiangyf8', 'hexf', 'mancigbb']",1,['hvvvh'],37,"['shenjw5', 'mp_vanguard', 'lily26', 'zhaodd3', 'madongyu', 'lintx233', 'liangzhh29', 'phoenixfly', 'aaronda', 'ray2016', 'zjy14341045', 'junky', 'wangguangyu', 'liuzy26', 'c2010555', 'a394096511', 'srxh', 'kenwwy', 'volcano9669', 'fakerss', 'liuzzh5', 'qwn19970728', 'raven00', 'neptuneli', 'lneng', 'zhongguogdgz', 'sweety1031', 'xwx', 'a731618814', None, 'mouseeatcat', 'seiro', 'focms', 'zp14344045', 'qunimadejihuoma', 'tangzy6', 'dujw']",46,"['shenjw5', 'mp_vanguard', 'lily26', 'zhaodd3', 'madongyu', 'lintx233', 'liangzhh29', 'hvvvh', 'phoenixfly', 'aaronda', 'ray2016', 'junky', 'wangguangyu', 'liuzy26', 'c2010555', 'a394096511', 'srxh', 'kenwwy', 'zjt173720', 'volcano9669', 'fakerss', 'liuzzh5', 'focmsphyliu', 'qwn19970728', 'tangzy6', 'raven00', 'neptuneli', 'lneng', 'zhongguogdgz', 'sweety1031', 'xingzy3', 'weny2016', 'xwx', 'mancigbb', 'a731618814', None, 'mouseeatcat', 'seiro', 'focms', 'tanjm32', 'zp14344045', 'qunimadejihuoma', 'jiangyf8', 'hexf', 'zjy14341045', 'dujw']"
94,229,10,45,8,"['zjt173720', 'xingzy3', 'tanjm32', 'weny2016', 'focmsphyliu', 'jiangyf8', 'hexf', 'mancigbb']",1,['hvvvh'],37,"['shenjw5', 'mp_vanguard', 'czczm', 'madongyu', 'liangzhh29', 'aaronda', 'junky', 'wangguangyu', 'q950316', 'a394096511', 'liuzy26', 'srxh', 'kenwwy', 'volcano9669', 'liuzzh5', 'fakerss', 'fenglking', 'lewisspecial', 'zs14344042', 'qwn19970728', 'tangzy6', 'raven00', 'lneng', 'youyouyu', 'zhongguogdgz', 'sweety1031', 'a731618814', None, 'seiro', 'mi18819251871', 'focms', 'zp14344045', 'qunimadejihuoma', 'tomvictor', 'xuxiangphysics', 'zjy14341045', 'dujw']",46,"['shenjw5', 'mp_vanguard', 'czczm', 'madongyu', 'liangzhh29', 'hvvvh', 'aaronda', 'zjy14341045', 'junky', 'wangguangyu', 'q950316', 'a394096511', 'liuzy26', 'srxh', 'kenwwy', 'zjt173720', 'volcano9669', 'liuzzh5', 'fakerss', 'fenglking', 'lewisspecial', 'zs14344042', 'focmsphyliu', 'qwn19970728', 'raven00', 'lneng', 'youyouyu', 'zhongguogdgz', 'sweety1031', 'xingzy3', 'weny2016', 'mancigbb', 'a731618814', None, 'seiro', 'mi18819251871', 'focms', 'tanjm32', 'zp14344045', 'qunimadejihuoma', 'jiangyf8', 'tomvictor', 'hexf', 'xuxiangphysics', 'tangzy6', 'dujw']"
94,153,10,42,8,"['zjt173720', 'xingzy3', 'tanjm32', 'weny2016', 'focmsphyliu', 'jiangyf8', 'hexf', 'mancigbb']",1,['hvvvh'],34,"['shenjw5', 'mp_vanguard', 'czczm', 'madongyu', 'liangzhh29', 'aaronda', 'zjy14341045', 'junky', 'q950316', 'wangguangyu', 'a394096511', 'liuzy26', 'srxh', 'volcano9669', 'liuzzh5', 'fenglking', 'lewisspecial', 'qwn19970728', 'raven00', 'lneng', 'youyouyu', 'zhongguogdgz', 'sweety1031', 'a731618814', None, 'seiro', 'mi18819251871', 'focms', 'zp14344045', 'qunimadejihuoma', 'tomvictor', 'xuxiangphysics', 'tangzy6', 'dujw']",43,"['shenjw5', 'mp_vanguard', 'czczm', 'madongyu', 'liangzhh29', 'hvvvh', 'aaronda', 'junky', 'q950316', 'wangguangyu', 'a394096511', 'liuzy26', 'srxh', 'zjt173720', 'volcano9669', 'liuzzh5', 'fenglking', 'lewisspecial', 'focmsphyliu', 'qwn19970728', 'tangzy6', 'raven00', 'lneng', 'youyouyu', 'zhongguogdgz', 'sweety1031', 'xingzy3', 'weny2016', 'mancigbb', 'a731618814', None, 'seiro', 'mi18819251871', 'focms', 'tanjm32', 'zp14344045', 'qunimadejihuoma', 'jiangyf8', 'tomvictor', 'hexf', 'xuxiangphysics', 'zjy14341045', 'dujw']"
94,161,10,38,4,"['zjt173720', 'jiangyf8', 'tanjm32', 'weny2016']",5,"['xingzy3', 'focmsphyliu', 'hvvvh', 'hexf', 'mancigbb']",34,"['mp_vanguard', 'lily26', 'madongyu', 'czczm', 'zhaodd3', 'lintx233', 'liangzhh29', 'phoenixfly', 'aaronda', 'tangxy8', 'ray2016', 'wangguangyu', 'c2010555', 'a394096511', 'kenwwy', 'volcano9669', 'liuzzh5', 'fakerss', 'lewisspecial', 'zs14344042', 'raven00', 'neptuneli', 'lneng', 'xwx', 'a731618814', None, 'seiro', 'mi18819251871', 'zp14344045', 'qunimadejihuoma', 'tomvictor', 'xuxiangphysics', 'zjy14341045', 'dujw']",43,"['mp_vanguard', 'lily26', 'zhaodd3', 'czczm', 'madongyu', 'lintx233', 'liangzhh29', 'hvvvh', 'phoenixfly', 'aaronda', 'tangxy8', 'ray2016', 'wangguangyu', 'c2010555', 'a394096511', 'kenwwy', 'zjt173720', 'volcano9669', 'liuzzh5', 'fakerss', 'lewisspecial', 'zs14344042', 'focmsphyliu', 'raven00', 'neptuneli', 'lneng', 'xingzy3', 'weny2016', 'xwx', 'mancigbb', 'a731618814', None, 'seiro', 'mi18819251871', 'tanjm32', 'zp14344045', 'qunimadejihuoma', 'jiangyf8', 'tomvictor', 'hexf', 'xuxiangphysics', 'zjy14341045', 'dujw']"
94,122,10,27,4,"['zjt173720', 'xingzy3', 'weny2016', 'jiangyf8']",5,"['tanjm32', 'focmsphyliu', 'hvvvh', 'hexf', 'mancigbb']",23,"['shenjw5', 'mp_vanguard', 'madongyu', 'czczm', 'liangzhh29', 'aaronda', 'wangguangyu', 'liuzy26', 'kenwwy', 'volcano9669', 'liuzzh5', 'fenglking', 'lewisspecial', 'zs14344042', 'tangzy6', 'sweety1031', 'a731618814', None, 'focms', 'qunimadejihuoma', 'tomvictor', 'xuxiangphysics', 'zjy14341045']",32,"['shenjw5', 'mp_vanguard', 'czczm', 'madongyu', 'liangzhh29', 'hvvvh', 'aaronda', 'wangguangyu', 'liuzy26', 'kenwwy', 'zjt173720', 'liuzzh5', 'volcano9669', 'fenglking', 'lewisspecial', 'zs14344042', 'focmsphyliu', 'tangzy6', 'sweety1031', 'xingzy3', 'weny2016', 'mancigbb', 'a731618814', None, 'focms', 'tanjm32', 'qunimadejihuoma', 'jiangyf8', 'tomvictor', 'hexf', 'xuxiangphysics', 'zjy14341045']"
94,158,10,9,2,"['xingzy3', 'hvvvh']",7,"['zjt173720', 'tanjm32', 'weny2016', 'focmsphyliu', 'jiangyf8', 'hexf', 'mancigbb']",7,"['c2010555', 'focms', 'jjgoooo', 'fenglking', 'tangxy8', 'xuxiangphysics', None]",16,"['c2010555', 'zjt173720', 'focms', 'xingzy3', 'tanjm32', 'jjgoooo', 'fenglking', 'weny2016', 'focmsphyliu', 'jiangyf8', 'hvvvh', 'hexf', 'mancigbb', 'tangxy8', 'xuxiangphysics', None]"
94,231,10,9,6,"['zjt173720', 'xingzy3', 'tanjm32', 'jiangyf8', 'hvvvh', 'mancigbb']",3,"['weny2016', 'focmsphyliu', 'hexf']",3,"['mouseeatcat', None, 'kenwwy']",12,"['mouseeatcat', 'kenwwy', 'zjt173720', 'xingzy3', 'tanjm32', 'weny2016', 'focmsphyliu', 'jiangyf8', 'hvvvh', 'hexf', 'mancigbb', None]"
94,123,10,7,1,['hvvvh'],8,"['zjt173720', 'xingzy3', 'tanjm32', 'weny2016', 'focmsphyliu', 'jiangyf8', 'hexf', 'mancigbb']",6,"['zhongguogdgz', 'focms', 'fenglking', 'tangxy8', 'ray2016', None]",15,"['zhongguogdgz', 'zjt173720', 'focms', 'xingzy3', 'tanjm32', 'fenglking', 'weny2016', 'focmsphyliu', 'jiangyf8', 'hvvvh', 'hexf', 'mancigbb', 'tangxy8', 'ray2016', None]"
94,230,10,7,1,['hvvvh'],8,"['zjt173720', 'xingzy3', 'tanjm32', 'weny2016', 'focmsphyliu', 'jiangyf8', 'hexf', 'mancigbb']",6,"['zhongguogdgz', 'focms', 'fenglking', 'tangxy8', 'ray2016', None]",15,"['zhongguogdgz', 'zjt173720', 'focms', 'xingzy3', 'tanjm32', 'fenglking', 'weny2016', 'focmsphyliu', 'jiangyf8', 'hvvvh', 'hexf', 'mancigbb', 'tangxy8', 'ray2016', None]"
95,104,10,18,9,"['mopaak', 'lukasinkovic', 'canjugaa09', 'teenagewasteland93', 'pgrozic', 'pudovii', 'maja.belacic', 'rope.planb', 'pimperlajz']",0,[],9,"['luka.vanjur', 'goranka', 'mrs.sanja.radonic', 'zvonimir.boby', 'ivamatkovic93', 'glenmil01', 'isimunjak', 'threshold91', None]",18,"['mopaak', 'lukasinkovic', 'teenagewasteland93', 'mrs.sanja.radonic', 'ivamatkovic93', 'glenmil01', 'pgrozic', 'maja.belacic', 'isimunjak', 'rope.planb', None, 'luka.vanjur', 'canjugaa09', 'goranka', 'zvonimir.boby', 'pudovii', 'threshold91', 'pimperlajz']"
95,296,10,18,9,"['mopaak', 'lukasinkovic', 'canjugaa09', 'teenagewasteland93', 'pgrozic', 'pudovii', 'maja.belacic', 'rope.planb', 'pimperlajz']",0,[],9,"['luka.vanjur', 'goranka', 'mrs.sanja.radonic', 'zvonimir.boby', 'ivamatkovic93', 'glenmil01', 'isimunjak', 'threshold91', None]",18,"['mopaak', 'lukasinkovic', 'teenagewasteland93', 'mrs.sanja.radonic', 'ivamatkovic93', 'glenmil01', 'pgrozic', 'maja.belacic', 'isimunjak', 'rope.planb', None, 'luka.vanjur', 'canjugaa09', 'goranka', 'zvonimir.boby', 'pudovii', 'threshold91', 'pimperlajz']"
95,159,10,15,9,"['mopaak', 'lukasinkovic', 'canjugaa09', 'teenagewasteland93', 'pgrozic', 'pudovii', 'maja.belacic', 'rope.planb', 'pimperlajz']",0,[],6,"['luka.vanjur', 'zvonimir.boby', 'ivamatkovic93', 'glenmil01', 'isimunjak', None]",15,"['mopaak', 'lukasinkovic', 'teenagewasteland93', 'ivamatkovic93', 'glenmil01', 'pgrozic', 'maja.belacic', 'isimunjak', 'rope.planb', None, 'luka.vanjur', 'canjugaa09', 'zvonimir.boby', 'pudovii', 'pimperlajz']"
95,27,10,12,7,"['mopaak', 'lukasinkovic', 'canjugaa09', 'teenagewasteland93', 'pgrozic', 'maja.belacic', 'rope.planb']",2,"['pimperlajz', 'pudovii']",5,"['zvonimir.boby', 'glenmil01', 'isimunjak', 'vjadrisko', None]",14,"['mopaak', 'lukasinkovic', 'teenagewasteland93', 'glenmil01', 'pgrozic', 'maja.belacic', 'isimunjak', 'rope.planb', None, 'canjugaa09', 'zvonimir.boby', 'pudovii', 'vjadrisko', 'pimperlajz']"
95,154,10,12,8,"['mopaak', 'lukasinkovic', 'canjugaa09', 'teenagewasteland93', 'pgrozic', 'maja.belacic', 'rope.planb', 'pimperlajz']",1,['pudovii'],4,"[None, 'goranka', 'glenmil01', 'mrs.sanja.radonic']",13,"['mopaak', 'lukasinkovic', 'teenagewasteland93', 'mrs.sanja.radonic', 'glenmil01', 'pgrozic', 'maja.belacic', 'rope.planb', None, 'canjugaa09', 'goranka', 'pudovii', 'pimperlajz']"
95,156,10,9,4,"['mopaak', 'canjugaa09', 'pimperlajz', 'pudovii']",5,"['lukasinkovic', 'teenagewasteland93', 'pgrozic', 'maja.belacic', 'rope.planb']",5,"['luka.vanjur', 'goranka', 'zvonimir.boby', 'glenmil01', None]",14,"['mopaak', 'lukasinkovic', 'canjugaa09', 'teenagewasteland93', 'luka.vanjur', 'goranka', 'zvonimir.boby', 'glenmil01', 'pgrozic', 'pudovii', 'maja.belacic', 'rope.planb', None, 'pimperlajz']"
95,310,10,7,5,"['mopaak', 'teenagewasteland93', 'canjugaa09', 'rope.planb', 'pimperlajz']",4,"['lukasinkovic', 'maja.belacic', 'pgrozic', 'pudovii']",2,"[None, 'glenmil01']",11,"['mopaak', 'lukasinkovic', 'canjugaa09', 'teenagewasteland93', 'glenmil01', 'pgrozic', 'pudovii', 'maja.belacic', 'rope.planb', None, 'pimperlajz']"
95,26,10,6,4,"['rope.planb', 'teenagewasteland93', 'canjugaa09', 'pimperlajz']",5,"['mopaak', 'lukasinkovic', 'pgrozic', 'pudovii', 'maja.belacic']",2,"['vjadrisko', None]",11,"['mopaak', 'lukasinkovic', 'canjugaa09', 'teenagewasteland93', 'pgrozic', 'pudovii', 'maja.belacic', 'rope.planb', 'vjadrisko', None, 'pimperlajz']"
97,89,10,11,8,"['areid52', 'sweetweina', 'ethanmross92', 'ethakur', 'mgreenie', 'nsayresm', 'asahu1', 'mkocherg']",1,['innagozhik'],3,"['cgeorg14', None, 'kryptos']",12,"['ethanmross92', 'ethakur', 'mgreenie', 'nsayresm', 'areid52', None, 'kryptos', 'mkocherg', 'innagozhik', 'sweetweina', 'cgeorg14', 'asahu1']"
97,280,10,11,7,"['areid52', 'sweetweina', 'ethanmross92', 'mgreenie', 'nsayresm', 'asahu1', 'mkocherg']",2,"['innagozhik', 'ethakur']",4,"['dbeasock', None, 'cgeorg14', 'kryptos']",13,"['ethanmross92', 'ethakur', 'mgreenie', 'nsayresm', 'dbeasock', 'areid52', None, 'kryptos', 'mkocherg', 'innagozhik', 'sweetweina', 'cgeorg14', 'asahu1']"
97,94,10,9,8,"['areid52', 'sweetweina', 'ethanmross92', 'ethakur', 'mgreenie', 'nsayresm', 'asahu1', 'mkocherg']",1,['innagozhik'],1,[None],10,"['innagozhik', 'sweetweina', 'ethanmross92', 'asahu1', 'ethakur', 'mgreenie', 'nsayresm', 'areid52', None, 'mkocherg']"
99,263,9,15,5,"['priya.joshi', 'aniket.n', 'vaisakh.h', 'd.barapatre', 'vdama38']",3,"['danieljmeador', 'matthewdibi', 'knyquist']",10,"['pranitkumar.d', 'a.madhusudanan', 'prabaha31', 'shubham11', 'harsh.talati', 'tejas.prajapati', 'hemil1012', 'fenil', None, 'dnyaneshwar.s']",18,"['priya.joshi', 'vaisakh.h', 'harsh.talati', 'tejas.prajapati', 'knyquist', 'prabaha31', 'fenil', None, 'dnyaneshwar.s', 'aniket.n', 'pranitkumar.d', 'a.madhusudanan', 'danieljmeador', 'matthewdibi', 'shubham11', 'd.barapatre', 'hemil1012', 'vdama38']"
100,64,9,42,3,"['jjacobsen6', 'sten621', 'bfieldson']",5,"['fufl', 'rrbiswas', 'jrr330', 'b.craig', 'pamelajurczak']",39,"['kstaton6', 'bbosley', 'ulisses.k22', 'suresh7', 'webera', 'megan0529', 'jihkim23', 'perlargarcia99', 'krea', 'pgarcia1999', 'juliedsilvers', 'egk818', 'chris5175', 'jarebmendez', 'jabier41', 'danielclayton0', 'andrew_lemx', 'guoj', 'kolek', 'awcolumbie', 'vhabic16', 'mltillman', 'xxlancet', 'tpank', 'crsileo', 'ukarell001', 'eugenesg1ddin', 'yelnamdivad92', 'pbouyounes', 'insua86', None, 'vdubinin2', 'cam.jackson', 'jaredhines', 'cheuser', 'stevenjwilliams', 'fengshui', 'vpirie', 'rbillings']",47,"['jjacobsen6', 'kstaton6', 'bbosley', 'ulisses.k22', 'suresh7', 'webera', 'megan0529', 'b.craig', 'jihkim23', 'perlargarcia99', 'krea', 'pgarcia1999', 'juliedsilvers', 'egk818', 'chris5175', 'jarebmendez', 'jabier41', 'danielclayton0', 'andrew_lemx', 'guoj', 'kolek', 'awcolumbie', 'vhabic16', 'mltillman', 'bfieldson', 'xxlancet', 'tpank', 'crsileo', 'ukarell001', 'eugenesg1ddin', 'fufl', 'rrbiswas', 'jrr330', 'yelnamdivad92', 'pbouyounes', 'insua86', None, 'pamelajurczak', 'vdubinin2', 'cam.jackson', 'jaredhines', 'sten621', 'cheuser', 'stevenjwilliams', 'fengshui', 'vpirie', 'rbillings']"
101,86,9,34,8,"['pranita08', 'vijaychavan4901', 'thankyougod999.rk', 'shamalshingte677', 'anujarananavare12', 'diptimore3181996', 'pratikshasakhare', 'krantishewale17']",0,[],26,"['rutuja.27rrm', 'suhasyadav22', 'moreshilpa0910', 'vchavan1993', 'poojahalagale', 'madhurisunilpatil', 'somnath2025', 'priteeka.suryawanshi', 'donolikarpratiksha', 'bhagyashreeshewale9', 'priyanka.sathe77', 'shetakeni3', 'tejaswinipowar07', 'shekharpatil1167', 'ojus1993', 'prashantkambare', 'sagarjadhav19951', None, 'susha.nikam31', 'anujaharel13', 'snehalpatil5588', '95pawarsayali', 'jyoti15thanekar', 'anujakolekar9614', 'mmkhot55', 'rutujagumathannavar11']",34,"['thankyougod999.rk', 'shamalshingte677', 'rutuja.27rrm', 'suhasyadav22', 'moreshilpa0910', 'vchavan1993', 'madhurisunilpatil', 'poojahalagale', 'somnath2025', 'donolikarpratiksha', 'priteeka.suryawanshi', 'pranita08', 'bhagyashreeshewale9', 'priyanka.sathe77', 'shetakeni3', 'krantishewale17', 'tejaswinipowar07', 'vijaychavan4901', 'shekharpatil1167', 'ojus1993', 'prashantkambare', 'sagarjadhav19951', None, 'anujarananavare12', 'susha.nikam31', 'anujaharel13', 'snehalpatil5588', 'diptimore3181996', '95pawarsayali', 'jyoti15thanekar', 'anujakolekar9614', 'pratikshasakhare', 'mmkhot55', 'rutujagumathannavar11']"
101,90,9,11,7,"['vijaychavan4901', 'thankyougod999.rk', 'shamalshingte677', 'anujarananavare12', 'diptimore3181996', 'pratikshasakhare', 'krantishewale17']",1,['pranita08'],4,"['aishusarode600', 'manepatilpoonam111', None, 'snehalbhosale421']",12,"['vijaychavan4901', 'thankyougod999.rk', 'shamalshingte677', 'manepatilpoonam111', 'snehalbhosale421', 'aishusarode600', None, 'pranita08', 'anujarananavare12', 'diptimore3181996', 'pratikshasakhare', 'krantishewale17']"
102,83,9,12,8,"['vondrak2', 'fsheikh2', 'tsong', 'nphan9', 'dchite2', 'philmichaelmeyer', 'zzhou35', 'gcgreen2']",0,[],4,"['hjchien2', 'qianma3', None, 'lmarlow2']",12,"['qianma3', 'dchite2', 'lmarlow2', 'philmichaelmeyer', 'zzhou35', 'hjchien2', None, 'gcgreen2', 'vondrak2', 'fsheikh2', 'tsong', 'nphan9']"
104,276,9,7,6,"['al_bekkala', 'bourg037', 'boyap001', 'lorxx342', 'vish2111995', 'linda157']",2,"['owlxx002', 'leex5620']",1,[None],9,"['al_bekkala', 'bourg037', 'boyap001', 'lorxx342', 'vish2111995', 'leex5620', 'linda157', 'owlxx002', None]"
105,312,9,20,1,['wangruntao'],7,"['appliedpetro', 'niloyacharjeebuet', 'julien419', 'emran.eee.buet', 'premlal', 'emraneee11', 'emran.ark']",19,"['lxhwbd1234', 'wcf778', 'ashz8888', 'zxi1', 'wttuestc', 'uos', 'usoppo', 'zliu26', 'jliu85', 'xunhaowang', 'jhsu1', 'wentao7', 'faasiri', 'samkam', 'grace8699', None, 'zlu19', 'leya', 'williamtian93']",27,"['lxhwbd1234', 'niloyacharjeebuet', 'wcf778', 'ashz8888', 'wentao7', 'jhsu1', 'faasiri', 'samkam', 'grace8699', 'zxi1', 'wttuestc', 'emran.ark', None, 'zlu19', 'wangruntao', 'appliedpetro', 'uos', 'usoppo', 'leya', 'zliu26', 'jliu85', 'julien419', 'emran.eee.buet', 'xunhaowang', 'premlal', 'williamtian93', 'emraneee11']"
106,48,8,14,7,"['hyeoni93', 'suhwanking', 'rudwn0502', 'tmdguq9147', 'muderzz', 's59', 'leechanghyeon']",0,[],7,"['rnlgur9192', 'hihibyebye', 'woojungtae', 'acac555', 'gur771', 'guheak92', None]",14,"['hyeoni93', 'rnlgur9192', 'hihibyebye', 'suhwanking', 'guheak92', 'tmdguq9147', None, 'woojungtae', 'rudwn0502', 'acac555', 'gur771', 'muderzz', 's59', 'leechanghyeon']"
106,63,8,13,6,"['suhwanking', 'rudwn0502', 'tmdguq9147', 'muderzz', 's59', 'leechanghyeon']",1,['hyeoni93'],7,"['hihibyebye', 'woojungtae', 'acac555', 'gur771', 'jk99043', 'guheak92', None]",14,"['hyeoni93', 'hihibyebye', 'suhwanking', 'jk99043', 'guheak92', 'tmdguq9147', None, 'woojungtae', 'rudwn0502', 'acac555', 'gur771', 'muderzz', 's59', 'leechanghyeon']"
106,56,8,11,6,"['suhwanking', 'rudwn0502', 'tmdguq9147', 'muderzz', 's59', 'leechanghyeon']",1,['hyeoni93'],5,"['rnlgur9192', 'woojungtae', 'acac555', 'guheak92', None]",12,"['hyeoni93', 'rnlgur9192', 'suhwanking', 'guheak92', 'tmdguq9147', None, 'woojungtae', 'rudwn0502', 'acac555', 'muderzz', 's59', 'leechanghyeon']"
106,46,8,10,5,"['suhwanking', 'rudwn0502', 'tmdguq9147', 'muderzz', 's59']",2,"['hyeoni93', 'leechanghyeon']",5,"['rnlgur9192', 'hihibyebye', 'acac555', 'gur771', None]",12,"['hyeoni93', 'rnlgur9192', 'hihibyebye', 'suhwanking', 'tmdguq9147', None, 'rudwn0502', 'acac555', 'gur771', 'muderzz', 's59', 'leechanghyeon']"
106,62,8,10,6,"['suhwanking', 'rudwn0502', 'tmdguq9147', 'muderzz', 's59', 'leechanghyeon']",1,['hyeoni93'],4,"['woojungtae', None, 'guheak92', 'acac555']",11,"['hyeoni93', 'suhwanking', 'guheak92', 'tmdguq9147', None, 'woojungtae', 'rudwn0502', 'acac555', 'muderzz', 's59', 'leechanghyeon']"
106,60,8,9,5,"['suhwanking', 'rudwn0502', 'muderzz', 's59', 'leechanghyeon']",2,"['hyeoni93', 'tmdguq9147']",4,"['woojungtae', 'rnlgur9192', None, 'acac555']",11,"['hyeoni93', 'rnlgur9192', 'suhwanking', 'tmdguq9147', None, 'woojungtae', 'rudwn0502', 'acac555', 'muderzz', 's59', 'leechanghyeon']"
107,38,8,170,6,"['shubhrapatil77', 'yayatipawar601', 'melchiznadar', 'mauryashubham564', 'swatimane176', 'patilvarad2011']",1,['i100rbh'],164,"['jigneshk2994', 'yashsavle', 'tejuliman74', 'harshitbangera', 'ishmeetsingh', 'sanketh728', 'karan.marketkar', 'rushikeshjoshi285', 'rnair15', 'shreyasawant95', 'viraktdoshi19', 'udayyewale17', 'karan.gondalia', 'patilroshan1128', 'kumarvivek017', 'rohitpuri.g', 'gurmukhsingh0108', 'amit.dutta', 'sush81194', 'rishabh4745', 'tambeneha94', 'rukhsrd', 'nair19shruti', 'happyridermrk', 'gadhiyakenil16', 'abauti608', 'sadiqqureshi393', 'rutu123', 'jiteshkjsp', 'varun1997', 'aniketshelar79', 'sachimalkan', 'sgat3451', 'jaysawant2', 'ykhedikar', 'ishaan.sathe', 'mapethe', 'amruteshpatil', 'pateltejash96', 'ratsthegreat', 'tandelsneha15', 'doshi.kavisha16', 'tajpara.nikhil', 'miteshmohokar', 'g3jithinn', 'kapilaherkar755', 'sweta151945', 'dhairyagada1997', 'pruthavi.c', 'akansha319892', 'vjseedan', 'vishal.chavda', 'nairprasad007', 'joshua0667', 'hardrider95', 'ankitferry123', 'priyankadeshpande177', 'hardik.upadhyay', '1jyotsna1', 'prasad.m', 'parmarmayur05', 'nikj816', 'smajumdar', 'rrnair291293', 'nikuldengada493', 'ankur.shah', 'princeporje98', 'suraj6111994', 'yogeshwar21121995', 'parthkaushikdave', 'nilesh.delekar', 'ameymalotkar1', 'pareshnaik1995', 'gopal.singh', 'nehaaltawade1', 's.jadeja', 'poojaparab9035', 'nikhil4241307', 'pdeshpande', 'peshinakash', 'kiranjadhav050994', 'abinbenny8', 'ashupalambe1992', 'abinaya67006', 'ajitjadhav', 'machalke92', 'yogi.6692', 'devyani.salvi1028', 'qwertynishit', 'verma.amitkumar95', 'florence9344', 'anuradha.d', 'satya_mishra', 'shraddhakharde01', 'inderjitsingh87', 'kypptl', 'lino2296', 'sharma.ayushi8c', 'sbodke', 'aqudas29', 'khedikaryash8', 'tgpatil22791', 'vijaykothari97', 'pranithsuvarna1', 'vijaya', 'shaminakunnel', 'rahulbadekar', 'arawal14.ar', 'raoashish96', 'parag.choughule', 'asingh12', 'parag16593', 'jigar', 'shivam_cr7', 'udit.shah', 'vishakha', 'tdholpuria', 'atoraskar12', 'mkadam03', 'walavalkarmayur79', 'ankitagharat93', 'aanugraha', 'gkapil45', 'rushabh.soni', 'mayuripatil3095', 'tanujudani865', 'sonihetvi10', 'aniketa.yelave49', 'jadhavankita9969', 'sujataredkar', 'rautt59', 'rjoshi02', 'karankyp', 'adwaitvajpe', 'anevrekar', 'akash.mali3477', 'karantank97', 'akashmore456', 'surajkarade.2', 'pranav.gori', 'palak1012', 'apekshapawar', 'ramanujsingh004', 'keyur.gajjar', 'pranilghogale', 'pripatil285', 'desaivighnesh95', None, 'burhan.naim', 'd.shenoy', 'ashish.mrya1', 'ankith89', 'priyanka.bhangre', 'rutwijajoshi10', 'karanshah30', 'agarwal.gagan5101', 'anshujha95', 'vedy1811', 'chaitanyakhane999', 'tushar.gaikwad', 'gaurav.gadre', 'sourabhbelose', 'somil910', 'abhiramibp95']",171,"['jigneshk2994', 'yashsavle', 'tejuliman74', 'harshitbangera', 'ishmeetsingh', 'sanketh728', 'swatimane176', 'karan.marketkar', 'rushikeshjoshi285', 'rnair15', 'shreyasawant95', 'viraktdoshi19', 'udayyewale17', 'karan.gondalia', 'patilroshan1128', 'kumarvivek017', 'rohitpuri.g', 'gurmukhsingh0108', 'amit.dutta', 'sush81194', 'rishabh4745', 'tambeneha94', 'rukhsrd', 'nair19shruti', 'happyridermrk', 'gadhiyakenil16', 'abauti608', 'sadiqqureshi393', 'rutu123', 'jiteshkjsp', 'aniketshelar79', 'sachimalkan', 'sgat3451', 'jaysawant2', 'ykhedikar', 'ishaan.sathe', 'mapethe', 'amruteshpatil', 'pateltejash96', 'ratsthegreat', 'tandelsneha15', 'doshi.kavisha16', 'tajpara.nikhil', 'miteshmohokar', 'g3jithinn', 'kapilaherkar755', 'sweta151945', 'dhairyagada1997', 'pruthavi.c', 'akansha319892', 'vjseedan', 'vishal.chavda', 'nairprasad007', 'joshua0667', 'hardrider95', 'ankitferry123', 'priyankadeshpande177', 'hardik.upadhyay', '1jyotsna1', 'prasad.m', 'parmarmayur05', 'nikj816', 'smajumdar', 'rrnair291293', 'nikuldengada493', 'ankur.shah', 'princeporje98', 'suraj6111994', 'yogeshwar21121995', 'parthkaushikdave', 'nilesh.delekar', 'ameymalotkar1', 'pareshnaik1995', 'gopal.singh', 'nehaaltawade1', 's.jadeja', 'melchiznadar', 'poojaparab9035', 'nikhil4241307', 'pdeshpande', 'peshinakash', 'kiranjadhav050994', 'abinbenny8', 'ashupalambe1992', 'abinaya67006', 'ajitjadhav', 'machalke92', 'yogi.6692', 'devyani.salvi1028', 'qwertynishit', 'verma.amitkumar95', 'florence9344', 'anuradha.d', 'satya_mishra', 'shraddhakharde01', 'inderjitsingh87', 'kypptl', 'lino2296', 'sharma.ayushi8c', 'sbodke', 'aqudas29', 'khedikaryash8', 'tgpatil22791', 'vijaykothari97', 'pranithsuvarna1', 'mauryashubham564', 'vijaya', 'shaminakunnel', 'rahulbadekar', 'arawal14.ar', 'raoashish96', 'parag.choughule', 'asingh12', 'parag16593', 'jigar', 'shivam_cr7', 'udit.shah', 'vishakha', 'tdholpuria', 'atoraskar12', 'mkadam03', 'walavalkarmayur79', 'ankitagharat93', 'somil910', 'aanugraha', 'shubhrapatil77', 'gkapil45', 'rushabh.soni', 'mayuripatil3095', 'tanujudani865', 'sonihetvi10', 'aniketa.yelave49', 'jadhavankita9969', 'sujataredkar', 'rautt59', 'rjoshi02', 'i100rbh', 'karankyp', 'adwaitvajpe', 'anevrekar', 'yayatipawar601', 'akash.mali3477', 'karantank97', 'akashmore456', 'surajkarade.2', 'pranav.gori', 'patilvarad2011', 'palak1012', 'apekshapawar', 'ramanujsingh004', 'keyur.gajjar', 'pranilghogale', 'pripatil285', 'desaivighnesh95', None, 'burhan.naim', 'd.shenoy', 'ashish.mrya1', 'ankith89', 'priyanka.bhangre', 'rutwijajoshi10', 'karanshah30', 'agarwal.gagan5101', 'anshujha95', 'vedy1811', 'chaitanyakhane999', 'tushar.gaikwad', 'gaurav.gadre', 'sourabhbelose', 'varun1997', 'abhiramibp95']"
110,59,8,22,4,"['bangasunain', 'mpethe22', 'meetgopani616', 'janhvi.vora97']",3,"['yashdani96', 'namantaneja97', 'koppinen']",18,"['doshi.kavisha16', 'adwaitvajpe', 'ckargutkar96', 'nimisha.nimisha.agarwal', 'yashsavle', 'smonica498', 'adityamodi009', 'vijaykothari97', 'arawal14.ar', 'prp23dec', 'jaysawant2', 'sonihetvi10', 'tanuj.udani', 'agarwal.gagan5101', 'varun1997', None, 'poojamenon16.pm', '1jyotsna1']",25,"['doshi.kavisha16', 'nimisha.nimisha.agarwal', 'yashsavle', 'vijaykothari97', 'koppinen', 'bangasunain', 'mpethe22', 'janhvi.vora97', 'namantaneja97', 'sonihetvi10', 'yashdani96', None, 'smonica498', 'adwaitvajpe', 'ckargutkar96', 'arawal14.ar', 'meetgopani616', 'adityamodi009', 'prp23dec', 'jaysawant2', 'tanuj.udani', 'agarwal.gagan5101', 'varun1997', 'poojamenon16.pm', '1jyotsna1']"
110,61,8,8,1,['yashdani96'],6,"['meetgopani616', 'koppinen', 'bangasunain', 'mpethe22', 'janhvi.vora97', 'namantaneja97']",7,"['varun1997', 'riddhis2411', None, 'jenna', 'shriya.h.joshi', 'smithnano15', 'singhshashank97']",14,"['riddhis2411', 'meetgopani616', 'singhshashank97', 'koppinen', 'bangasunain', 'mpethe22', 'janhvi.vora97', 'namantaneja97', None, 'yashdani96', 'jenna', 'shriya.h.joshi', 'smithnano15', 'varun1997']"
113,320,8,25,3,"['hctest3', 'hctest4', 'a222utumn']",4,"['hctest1', 'rohit.o.goel', 'wyj2446', 'hctest2']",22,"['nanohueb', 'davgumo', 'lefeizhang913', 'blissm95', 'mshisheh', 'bhaley', 'fernan94', 'nraghav', 'dkearney', 'bermel', 'hesam', 'tian53', 'chenyiyi44', 'denphi', 'mmh', None, 'rafatulfaria', 'enassakr', 'samikm', 'turkstra', 'ddelhoyotorres', 'pantho012']",29,"['nanohueb', 'davgumo', 'hctest1', 'rohit.o.goel', 'lefeizhang913', 'hctest2', 'blissm95', 'hctest3', 'mshisheh', 'bhaley', 'a222utumn', 'wyj2446', 'fernan94', 'nraghav', 'dkearney', 'bermel', 'hesam', 'tian53', 'chenyiyi44', 'denphi', 'mmh', None, 'rafatulfaria', 'hctest4', 'enassakr', 'samikm', 'turkstra', 'ddelhoyotorres', 'pantho012']"
114,207,8,132,5,"['suyogk.1995', 'dandekarmd73', 'tanayshinde123', 'vinodgadge95', 'kumarrahul050892']",2,"['ashish123', 'vinay3524']",127,"['dalvisayli', 'niraj901', 'ektarathod786', 'khadekunal1', 'dikshabafna1995', 'kadamk008', 'omkarn049', 'sagar.pawar35418', 'ahire.monali07', 'brian200495', 'infinite2205', 'vinit95vasudevan', 'dhartinano19', 'saurabh.gharat96', 'sailee.mohite', 'nehah95', 'chaudharipayal50', 'sangeetamjoshi', 'mudrasjuee', 'sebastian007', 'nikhildabholkar4', 'praju.avhad', 'rakshu.gade', 'snehawaghe21', 'sid.rane95', 'sonalipawar589', 'ratsthegreat', 'oma1811', 'rahulmhapsekar7', 'sumedh_patil', 'a.j.yadav2395', 'chiragc9494', 'hbg2112', 'bhakti961', 'viveky803', 'yashapeejay', 'sandeeprock023', 'manasi.shinde008', 'chaudharisuyash7', 'ru1795', 'deven199570', 'priyagajakosh1', 'aashish.yadav94', 'ambeskaradvait', 'spranav3004', 'jatin.dhande1008', 'priyankakamble', 'manalihedaoo4', 'pranilraut17', 'shivamchaube', 'sonawane.akshayak', 'spooja.1430', 'mongya00', 'dattaramkolekar', 'sagarpawar', 'nikitamalvade', 'nikhildubey02051996', 'mitesh.dangle', 'danish.dev.007', 'saylishirodkar58', 'sayalipatil4545', 'aishwaryamardhekar.24595', 'cooldudeakshu', 'snehakudtarkar315', 'komalbapna.kb', 'viprajapatil', 'aniketmane42', 'akshaybadhiye04', 'iabhishek555', 'susmitaahirrao', 'pravin45', 'tejaskanagal95', 'aniketkulaye618', 'bk357357', 'oindri.c', 'kondekar23', 'poojavagre12', 'mihirsawant17', 'adigame18', 'parmitbanga1995', 'shahyash027', 'ajthamke40', 'mishrahenry007', 'shreyashpawar96', 'abhihadshi', 'pratikkhanore95', 'srikalaprabhu', 'gidayegirish', 'gauravrajeshmehta', 'codekidx', 'pbrahmapurkar', 'shubhambeldar547', 'prathameshptkr4', 'saurabhmangeshkar', 'mukulsathe1995', 'priyankaingle18', 'palswati0309', 'bondreanup007', 'rohitbaliyan53', 'manishashetye1295', 'abhishek.thavare', 'sardesai.kirti18', 'amritamukeshb', 'shakyanandk', 'ramaprde2296', 'rushabh.fegade', 'ameypatil29', 'sahilshaikh827', 'vishakha1805', 'abhishekm2861996', 'dattaram.gawade781', None, 'salman23011996', 'ssy506804', 'vaibhav.gangan7', 'sawantgaurig25', 'rohinipatil404', 'siddhiambre111', 'sagarbhagat43', 'kaustubhgudekar9', 'namrata05', 'suman28pandit', 'chandraman.patil', 'rakeshmaity', 'pranay9.ithawar', 'rohanchavan', 'vaibhavgaikar62']",134,"['dalvisayli', 'niraj901', 'ektarathod786', 'khadekunal1', 'dikshabafna1995', 'kadamk008', 'omkarn049', 'sagar.pawar35418', 'ahire.monali07', 'brian200495', 'infinite2205', 'vinit95vasudevan', 'dhartinano19', 'saurabh.gharat96', 'sailee.mohite', 'suyogk.1995', 'nehah95', 'chaudharipayal50', 'dandekarmd73', 'tanayshinde123', 'sangeetamjoshi', 'mudrasjuee', 'sebastian007', 'nikhildabholkar4', 'praju.avhad', 'rakshu.gade', 'snehawaghe21', 'sid.rane95', 'sonalipawar589', 'ratsthegreat', 'oma1811', 'rahulmhapsekar7', 'sumedh_patil', 'a.j.yadav2395', 'chiragc9494', 'hbg2112', 'bhakti961', 'kumarrahul050892', 'viveky803', 'yashapeejay', 'sandeeprock023', 'manasi.shinde008', 'chaudharisuyash7', 'ru1795', 'deven199570', 'priyagajakosh1', 'aashish.yadav94', 'ambeskaradvait', 'spranav3004', 'jatin.dhande1008', 'priyankakamble', 'manalihedaoo4', 'pranilraut17', 'shivamchaube', 'sonawane.akshayak', 'spooja.1430', 'mongya00', 'dattaramkolekar', 'sagarpawar', 'nikitamalvade', 'nikhildubey02051996', 'mitesh.dangle', 'danish.dev.007', 'saylishirodkar58', 'sayalipatil4545', 'aishwaryamardhekar.24595', 'cooldudeakshu', 'snehakudtarkar315', 'komalbapna.kb', 'viprajapatil', 'aniketmane42', 'akshaybadhiye04', 'iabhishek555', 'susmitaahirrao', 'pravin45', 'tejaskanagal95', 'aniketkulaye618', 'bk357357', 'oindri.c', 'kondekar23', 'poojavagre12', 'mihirsawant17', 'adigame18', 'parmitbanga1995', 'shahyash027', 'ajthamke40', 'vinay3524', 'mishrahenry007', 'shreyashpawar96', 'abhihadshi', 'pratikkhanore95', 'srikalaprabhu', 'gidayegirish', 'gauravrajeshmehta', 'codekidx', 'pbrahmapurkar', 'vinodgadge95', 'shubhambeldar547', 'prathameshptkr4', 'saurabhmangeshkar', 'ashish123', 'mukulsathe1995', 'priyankaingle18', 'palswati0309', 'bondreanup007', 'rohitbaliyan53', 'manishashetye1295', 'abhishek.thavare', 'sardesai.kirti18', 'amritamukeshb', 'shakyanandk', 'ramaprde2296', 'rushabh.fegade', 'ameypatil29', 'sahilshaikh827', 'vishakha1805', 'abhishekm2861996', 'dattaram.gawade781', None, 'salman23011996', 'ssy506804', 'vaibhav.gangan7', 'sawantgaurig25', 'rohinipatil404', 'siddhiambre111', 'sagarbhagat43', 'kaustubhgudekar9', 'namrata05', 'suman28pandit', 'chandraman.patil', 'rakeshmaity', 'pranay9.ithawar', 'rohanchavan', 'vaibhavgaikar62']"
114,209,8,12,1,['tanayshinde123'],6,"['suyogk.1995', 'dandekarmd73', 'vinay3524', 'vinodgadge95', 'ashish123', 'kumarrahul050892']",11,"['anicaptaincool', 'gauravrajeshmehta', 'sumedh_patil', 'pravin45', 'pbrahmapurkar', 'suman28pandit', 'tejaskanagal95', 'chandraman.patil', 'rakeshmaity', 'dattaram.gawade781', None]",18,"['suyogk.1995', 'dandekarmd73', 'sumedh_patil', 'vinay3524', 'tanayshinde123', 'dattaram.gawade781', 'anicaptaincool', None, 'kumarrahul050892', 'gauravrajeshmehta', 'pbrahmapurkar', 'pravin45', 'suman28pandit', 'vinodgadge95', 'chandraman.patil', 'rakeshmaity', 'tejaskanagal95', 'ashish123']"
116,249,8,11,5,"['mag3718', 'maglabf', 'mag2046', 'banmeng', 'haidiyou']",2,"['sdutta14', 'nuaajsh']",6,"['zhiweiren321', 'mag189', 'anylook', 'anyint', None, 'malab']",13,"['mag3718', 'mag2046', 'mag189', 'anylook', 'banmeng', 'haidiyou', 'anyint', 'nuaajsh', None, 'sdutta14', 'maglabf', 'zhiweiren321', 'malab']"
121,336,7,64,5,"['jfendri', 'scledbet', 'rljacks4', 'earodrig', 'bfgsweeper']",1,['bolu45'],59,"['djblivin', 'emalhajj', 'ajrigby', 'ajcoon', 'jpadams', 'wkharri3', 'taleona3', 'gwcrego', 'tnpardue', 'mfschaef', 'mdbrewis', 'gredden', 'kjcody', 'alisadeq', 'tsavey', 'abmcginn', 'hahsain', 'kjkronk', 'syan4', 'npschult', 'cecipria', 'jaconno2', 'nrhawes12', 'tbhubble', 'jagibson', 'jwfrenc2', 'ahochstetler711', 'seklug', 'faisa1k', 'jnchestnut4943', 'klturne5', 'emmills', 'jrmcgarr', 'emharri5', 'amcorbe2', 'cthudso3', 'obartman', 'agshin', 'abharga5', 'schlenker', 'mkmoody', 'sjfigurs', 'zlholme2', 'hsoewar', 'jlbrodie', 'atberg', 'zgdavis', 'ajsquire', 'matthewrowley', 'rjnagley', 'saba96', None, 'alcostin', 'khalil2316', 'vrkumar', 'edhill3', 'mmalsaft', 'ajmillir', 'yzhang59']",65,"['djblivin', 'scledbet', 'emalhajj', 'ajrigby', 'ajcoon', 'jpadams', 'wkharri3', 'taleona3', 'gwcrego', 'tnpardue', 'mfschaef', 'mdbrewis', 'gredden', 'kjcody', 'alisadeq', 'tsavey', 'abmcginn', 'hahsain', 'kjkronk', 'syan4', 'npschult', 'cecipria', 'jaconno2', 'nrhawes12', 'rljacks4', 'tbhubble', 'bfgsweeper', 'jagibson', 'jwfrenc2', 'jfendri', 'ahochstetler711', 'seklug', 'faisa1k', 'jnchestnut4943', 'klturne5', 'emmills', 'earodrig', 'jrmcgarr', 'emharri5', 'amcorbe2', 'cthudso3', 'obartman', 'agshin', 'abharga5', 'schlenker', 'mkmoody', 'sjfigurs', 'zlholme2', 'hsoewar', 'jlbrodie', 'atberg', 'zgdavis', 'bolu45', 'ajsquire', 'matthewrowley', 'rjnagley', 'saba96', None, 'alcostin', 'khalil2316', 'vrkumar', 'edhill3', 'mmalsaft', 'ajmillir', 'yzhang59']"
122,42,7,114,6,"['pankajpawar1515', 'cpatil152', 'niteshnarkar712', 'bkadam357', 'advenraju', 'bimal.biswas8']",0,[],108,"['sankpalami', 'shrutikayadav2oct', 'dalvisayli', 'niraj901', 'ektarathod786', 'komalbapna.kb', 'dikshabafna1995', 'adipatil37', 'omkarn049', 'sahilsk7', 'ahire.monali07', 'akshaybadhiye04', 'iabhishek555', 'susmitaahirrao', 'vinit95vasudevan', 'umeshdarade77', 'tanayshinde21', 'infinite1309', 'pravin45', 'tejaskanagal95', 'minalsawant143', 'oindri.c', 'abarge31', 'chaudharipayal50', 'shahyash027', 'rawletanmayee46', 'shraddha0306', 'sangeetamjoshi', 'mahajanabhi2201', 'mudrasjuee', 'vijaybhargude2', 'abhihadshi', 'supu1796', 'sebastian007', 'pratikkhanore95', 'preetywagh95', 'gidayegirish', 'ashwini12rajput', 'shrikantnimse14', 'praju.avhad', 'gauravrajeshmehta', 'pbrahmapurkar', 'rakshu.gade', 'sam234bryant', 'swati123', 'sonalipawar589', 'saurabhmangeshkar', 'shrutisundar019', 'ratsthegreat', 'oma1811', 'ravina.chavan42', 'mukulsathe1995', 'tarak.shah', 'rsawant2895', 'priyankaingle18', 'sumedh_patil', 'bondreanup007', 'rohitbaliyan53', 'a.j.yadav2395', 'chiragc9494', 'hbg2112', 'tanyabaptist05', 'manishashetye1295', 'abhishek.thavare', 'varadrajnanaware7', 'sardesai.kirti18', 'sammit1844', 'viveky803', 'tejasshinde8055', 'chaudharisuyash7', 'ru1795', 'sanketsalvi03', 'sandesh29', 'deven199570', 'priyagajakosh1', 'aashish.yadav94', 'amritamukeshb', 'pratikthorat10', 'jatin.dhande1008', 'lakumveer', 'aniket2602', 'aditya1818', 'shakyanandk', 'ramaprde2296', 'rushabh.fegade', 'akashspawar148', 'abhishekm2861996', 'ritesh.parulekar231194', 'sonawane.akshayak', 'vishakha1805', 'ptrimukhe32', 'dattaram.gawade781', 'sagarpawar', 'gsawant999', None, 'prajaktachapte2', 'nikhildubey02051996', 'sagarbhagat43', 'kaustubhgudekar9', 'prashant.baperkar', 'suman28pandit', 'danish.dev.007', 'rakeshmaity', 'saylishirodkar58', 'sayalipatil4545', 'rohanchavan', 'aishwaryamardhekar.24595', 'cooldudeakshu']",114,"['sankpalami', 'shrutikayadav2oct', 'dalvisayli', 'niraj901', 'ektarathod786', 'komalbapna.kb', 'aishwaryamardhekar.24595', 'dikshabafna1995', 'adipatil37', 'niteshnarkar712', 'omkarn049', 'sahilsk7', 'ahire.monali07', 'akshaybadhiye04', 'iabhishek555', 'pankajpawar1515', 'susmitaahirrao', 'vinit95vasudevan', 'umeshdarade77', 'tanayshinde21', 'infinite1309', 'pravin45', 'tejaskanagal95', 'minalsawant143', 'oindri.c', 'abarge31', 'chaudharipayal50', 'shahyash027', 'rawletanmayee46', 'shraddha0306', 'sangeetamjoshi', 'mahajanabhi2201', 'mudrasjuee', 'vijaybhargude2', 'advenraju', 'abhihadshi', 'supu1796', 'sebastian007', 'pratikkhanore95', 'preetywagh95', 'gidayegirish', 'ashwini12rajput', 'shrikantnimse14', 'praju.avhad', 'gauravrajeshmehta', 'pbrahmapurkar', 'rakshu.gade', 'sam234bryant', 'swati123', 'sonalipawar589', 'saurabhmangeshkar', 'shrutisundar019', 'ratsthegreat', 'oma1811', 'ravina.chavan42', 'mukulsathe1995', 'tarak.shah', 'rsawant2895', 'priyankaingle18', 'sumedh_patil', 'bondreanup007', 'rohitbaliyan53', 'a.j.yadav2395', 'bkadam357', 'chiragc9494', 'hbg2112', 'tanyabaptist05', 'manishashetye1295', 'abhishek.thavare', 'varadrajnanaware7', 'sardesai.kirti18', 'sammit1844', 'viveky803', 'tejasshinde8055', 'chaudharisuyash7', 'ru1795', 'sanketsalvi03', 'sandesh29', 'deven199570', 'priyagajakosh1', 'aashish.yadav94', 'amritamukeshb', 'pratikthorat10', 'jatin.dhande1008', 'lakumveer', 'aniket2602', 'aditya1818', 'shakyanandk', 'ramaprde2296', 'rushabh.fegade', 'akashspawar148', 'cpatil152', 'abhishekm2861996', 'ritesh.parulekar231194', 'sonawane.akshayak', 'vishakha1805', 'ptrimukhe32', 'dattaram.gawade781', 'sagarpawar', 'gsawant999', None, 'prajaktachapte2', 'nikhildubey02051996', 'sagarbhagat43', 'kaustubhgudekar9', 'prashant.baperkar', 'suman28pandit', 'danish.dev.007', 'rakeshmaity', 'saylishirodkar58', 'sayalipatil4545', 'rohanchavan', 'bimal.biswas8', 'cooldudeakshu']"
123,164,7,8,6,"['nikitakokne95', 'rg8655285873', 'nikhilkumthekar1994', 'sheetal.n441', 'aamodrisbud4', 'adsid29']",0,[],2,"[None, 'akshay.vesp']",8,"['nikitakokne95', 'rg8655285873', 'nikhilkumthekar1994', 'sheetal.n441', 'aamodrisbud4', 'akshay.vesp', 'adsid29', None]"
124,268,7,25,1,['shaandesai'],5,"['a410711510', 'alessandro.pilotto', 'xian20944358', 'exciter', 'kaan.taskin.06']",24,"['jyhuang09', 'kezi25', 'dgalindonavarro18', 'jgschlichting', 'simingma', 'araun521', 'jackkelly18', 'ryandavey', 'ignaciobayardo27', 'youbz', 'squidsareevil', 'scarr', 'calver', 'dubose', 'kintango', 'messiri', 'alinaacosta', None, 'sohum', 'hajiesmaili', 'epatheria', 'jfherrm', 'joannachung1', 'bhenderson25']",30,"['calver', 'shaandesai', 'dubose', 'jyhuang09', 'kezi25', 'kintango', 'dgalindonavarro18', 'jgschlichting', 'simingma', 'messiri', 'a410711510', 'araun521', 'alinaacosta', None, 'sohum', 'jackkelly18', 'ryandavey', 'hajiesmaili', 'ignaciobayardo27', 'epatheria', 'youbz', 'jfherrm', 'xian20944358', 'alessandro.pilotto', 'exciter', 'squidsareevil', 'joannachung1', 'kaan.taskin.06', 'bhenderson25', 'scarr']"
124,267,7,23,2,"['shaandesai', 'xian20944358']",4,"['exciter', 'kaan.taskin.06', 'a410711510', 'alessandro.pilotto']",21,"['jyhuang09', 'kezi25', 'dgalindonavarro18', 'simingma', 'araun521', 'jackkelly18', 'ryandavey', 'lishucong', 'youbz', 'scarr', 'calver', 'dubose', 'kintango', 'messiri', None, 'sohum', 'hajiesmaili', 'epatheria', 'jfherrm', 'joannachung1', 'bhenderson25']",27,"['calver', 'shaandesai', 'dubose', 'jyhuang09', 'kezi25', 'kintango', 'dgalindonavarro18', 'simingma', 'messiri', 'a410711510', 'araun521', None, 'sohum', 'jackkelly18', 'ryandavey', 'hajiesmaili', 'lishucong', 'epatheria', 'youbz', 'jfherrm', 'xian20944358', 'alessandro.pilotto', 'exciter', 'joannachung1', 'kaan.taskin.06', 'bhenderson25', 'scarr']"
128,277,7,9,4,"['ranireddy1997j20', 'yaswanthsai', 'sheebhareddy777', 'shaikdy.pdtr']",2,"['reshma.rey18', 'pooja.mehta']",5,"['deepthirao902', 'naveenraju', 'vangireddyindrasenareddy', 'subhash.sannapureddy', None]",11,"['deepthirao902', 'yaswanthsai', 'sheebhareddy777', 'pooja.mehta', 'shaikdy.pdtr', 'reshma.rey18', 'naveenraju', 'vangireddyindrasenareddy', 'ranireddy1997j20', 'subhash.sannapureddy', None]"
129,201,7,9,4,"['brendan_keller94', 'siu851289667', 'wcedmonds95', 'siu852071219']",2,"['shivamkundan', 'jacobmbell96']",5,"['siu850694682', 'cf7', 'mohammed301', 'btisler21', None]",11,"['siu850694682', 'jacobmbell96', 'siu851289667', 'brendan_keller94', 'cf7', 'mohammed301', 'btisler21', 'siu852071219', 'shivamkundan', None, 'wcedmonds95']"
131,47,7,207,1,['neilmundhe'],5,"['s.jadeja', 'mohiteashwin7', 'pratikthorat10', 'sahilsk7', 'burhan.naim']",206,"['nitingurme', 'kadamk008', 'bhavesh3422', 'aniket187', 'rehansonarkar784', 'jainamshah202', 'aimomajy', 'nrkhara', 'ajay.raghuwanshi', 'krittikaranga', 'trija68', 'rajdeepd', 'brian200495', 'shraddhad', 'rananeetika3', 'mehtajinal3101', 'vinit95vasudevan', 'gujarathikshitij', 'zkoyande', 'minalsawant1108', 'neha.utekar2608', 'email.harsh0811', 'himanshuphatak98', 'arpit32', 'nikitarane245', 'bhoomee.sheth', 'abhishek1996', 'obalgi3095', 'kambe302', 'lakhanmodani1811', 'simran123', 'rajwaje44', 'jayjadav08', 'neelam.chaudhari27', '22diptinikalje', 'sebastian007', 'tanvikalan', 'harshilmehta1995', 'komal31p', 'poojashetty', 'darshanadaund27', 'sam234bryant', 'nagateja.vlsi', 'bhumivora1995', 'geeta.kavitake', 'mapethe', 'sid.rane95', 'jaidevdalvi', 'suraj.taigade', 'monish.kapadia', 'ratsthegreat', 'ajinkyachadha', 'divya.upalekar', 'rsawant2895', 'ninad41195', 'purva.desai', 'msumit95', 'patil.rushal825', 'chinmayaniket4052', 'anujakhose94', 'rupali.patil', 'pathanabdulrazzak9524', 'viveky803', 'kpiyushbhirud', 'tejasshinde8055', 'siddhesh401', 'sanika.dongre', 'manasi.shinde008', 'bhavikashenoy95', 'dhvanilmandalia29', 'anasnaik9987', 'mokshada', 'alohomora7', 'pranilraut17', 'suryatejachitturi', 'avinashninawe', 'apoorvasundaresan', 'aditya.apte3', 'shivanisharaf15', 'sonawane.akshayak', 'akanksha0196', 'shubhamj95', 'aeyjd', 'luke676', 'monish.nene', 'spooja.1430', 'purva.satpute', 'adwait.sable10', 'pragatinarnaware', 'gsawant999', 'nehadingankar', 'deepikachaman3', 'patelu997', 'mshirali23', 'nikhildubey02051996', 'shwecchajain', 'akshata.kulkarni', 'kadamrupesh1996', 'shweta1811', 'stanabk', 'rohankhollamkar', 'upadhyechinmay', 'cooldudeakshu', 'juhi.manglani', 'vaishnavi.sambrekar', 'komalbapna.kb', 'ritesh.shukla', 'mugdha.dalvi', 'amanpal56', 'gupta.ravi1996', 'dipmads', 'rajatkedia95', 'ankurbhagwat8', 'harshal.dangat1', 'florence9344', 'shubham.gaikwad', 'sanjana.advani', 'priyuk', 'priyeshd', 'tanvi.rane1995', 'ambani', 'umeshdarade77', 'tanayshinde21', 'cvvedesh', 'karan.dadlani', 'pravin45', 'tejaskanagal95', 'doshishrut1995', 'kondekar23', 'poojamenon16.pm', 'mihirsawant17', 'rahul4peace', 'rahul1995', 'rhea.ann.95', 'rawletanmayee46', 'ajthamke40', 'rashuidiot', 'minal.patil', 'chaitanyakhachane95', 'johebshaikh', 'harshada123', 'mahajanabhi2201', 'abhishekpatkar1796', 'abhihadshi', 'bharathi.pedapudi', 'lakshmi.nair', 'gauravrajeshmehta', 'mudbidrijay', 'rutvij.supekar', 'codekidx', 'pbrahmapurkar', 'pathakrohan18', 'shreyasvkul', 'mananmehta7', 'chirag184', 'prathameshptkr4', 'aparnaahari95', 'tarak.shah', 'mervyn.fernandes', 'ashishmohite1996', 'akshayshinde101095', 'manavtrivedi03', 'vivek12195', 'nikhilgade', 'arvindlandge', 'anasnaik25', 'akshay21', 'mukul.kulkarni', 'sardesai.kirti18', 'shraddhag', 'vishaakn', 'amrsha.srivastava', 'apurva.patil', 'bhavesh.singh', 'omkardalvi409', 'shriya.sharma', 'lakumveer', 'shreyamath95', 'dhruv.gajaria95', 'mohak11jan', 'parthiv.parikh', 'sandipani1995', 'akashspawar148', 'khannamansi312', 'vishakha1805', 'yashgumaste', 'nileshkartik95', 'shreya.mahajan', 'jainam49', 'jakhererahul42', 'dattaram.gawade781', 'pavitra.iyer', 'tejaschaudhary1996', 'vaibhav.gangan7', 'ankita.rahate', 'shamikabachal', 'swapkaru123', 'saheli.konde', 'prashant.baperkar', 'suman28pandit', 'rakeshmaity', 'aakashgangolli3112', 'prachi.more', 'rohanchavan', 'guptesoham95', 'ptrimukhe32']",212,"['nitingurme', 'kadamk008', 'bhavesh3422', 'aniket187', 'rehansonarkar784', 'jainamshah202', 'sahilsk7', 'aimomajy', 'nrkhara', 'ajay.raghuwanshi', 'krittikaranga', 'trija68', 'rajdeepd', 'brian200495', 'shraddhad', 'rananeetika3', 'mehtajinal3101', 'vinit95vasudevan', 'gujarathikshitij', 'zkoyande', 'minalsawant1108', 'neha.utekar2608', 'email.harsh0811', 'himanshuphatak98', 'arpit32', 'nikitarane245', 'bhoomee.sheth', 'abhishek1996', 'obalgi3095', 'kambe302', 'lakhanmodani1811', 'simran123', 'rajwaje44', 'jayjadav08', 'neelam.chaudhari27', '22diptinikalje', 'sebastian007', 'tanvikalan', 'harshilmehta1995', 'komal31p', 'poojashetty', 'darshanadaund27', 'sam234bryant', 'nagateja.vlsi', 'bhumivora1995', 'geeta.kavitake', 'mapethe', 'sid.rane95', 'jaidevdalvi', 'suraj.taigade', 'monish.kapadia', 'ratsthegreat', 'ajinkyachadha', 'divya.upalekar', 'rsawant2895', 'ninad41195', 'purva.desai', 'msumit95', 'patil.rushal825', 'chinmayaniket4052', 'anujakhose94', 'rupali.patil', 'pathanabdulrazzak9524', 'viveky803', 'kpiyushbhirud', 'tejasshinde8055', 'siddhesh401', 'sanika.dongre', 'manasi.shinde008', 'bhavikashenoy95', 'pratikthorat10', 'dhvanilmandalia29', 'anasnaik9987', 'mokshada', 'alohomora7', 'pranilraut17', 'suryatejachitturi', 'avinashninawe', 'apoorvasundaresan', 'aditya.apte3', 'prachi.more', 'shivanisharaf15', 'sonawane.akshayak', 'akanksha0196', 'shubhamj95', 'aeyjd', 'luke676', 'monish.nene', 'spooja.1430', 'purva.satpute', 'adwait.sable10', 'pragatinarnaware', 'gsawant999', 'nehadingankar', 'deepikachaman3', 'patelu997', 'mshirali23', 'nikhildubey02051996', 'shwecchajain', 'akshata.kulkarni', 's.jadeja', 'mohiteashwin7', 'kadamrupesh1996', 'shweta1811', 'stanabk', 'rohankhollamkar', 'upadhyechinmay', 'cooldudeakshu', 'juhi.manglani', 'vaishnavi.sambrekar', 'komalbapna.kb', 'ritesh.shukla', 'mugdha.dalvi', 'amanpal56', 'gupta.ravi1996', 'dipmads', 'rajatkedia95', 'ankurbhagwat8', 'harshal.dangat1', 'florence9344', 'shubham.gaikwad', 'sanjana.advani', 'priyuk', 'priyeshd', 'tanvi.rane1995', 'ambani', 'umeshdarade77', 'tanayshinde21', 'cvvedesh', 'karan.dadlani', 'pravin45', 'tejaskanagal95', 'doshishrut1995', 'kondekar23', 'poojamenon16.pm', 'mihirsawant17', 'rahul4peace', 'rahul1995', 'rhea.ann.95', 'rawletanmayee46', 'ajthamke40', 'rashuidiot', 'minal.patil', 'chaitanyakhachane95', 'johebshaikh', 'harshada123', 'mahajanabhi2201', 'abhishekpatkar1796', 'abhihadshi', 'bharathi.pedapudi', 'lakshmi.nair', 'gauravrajeshmehta', 'mudbidrijay', 'rutvij.supekar', 'codekidx', 'pbrahmapurkar', 'pathakrohan18', 'shreyasvkul', 'mananmehta7', 'chirag184', 'prathameshptkr4', 'aparnaahari95', 'tarak.shah', 'mervyn.fernandes', 'ashishmohite1996', 'akshayshinde101095', 'manavtrivedi03', 'vivek12195', 'nikhilgade', 'arvindlandge', 'anasnaik25', 'akshay21', 'mukul.kulkarni', 'sardesai.kirti18', 'shraddhag', 'vishaakn', 'amrsha.srivastava', 'apurva.patil', 'bhavesh.singh', 'omkardalvi409', 'shriya.sharma', 'lakumveer', 'shreyamath95', 'dhruv.gajaria95', 'mohak11jan', 'parthiv.parikh', 'sandipani1995', 'akashspawar148', 'khannamansi312', 'vishakha1805', 'yashgumaste', 'nileshkartik95', 'neilmundhe', 'shreya.mahajan', 'jainam49', 'jakhererahul42', 'dattaram.gawade781', 'burhan.naim', 'tejaschaudhary1996', 'vaibhav.gangan7', 'ankita.rahate', 'shamikabachal', 'swapkaru123', 'saheli.konde', 'prashant.baperkar', 'suman28pandit', 'rakeshmaity', 'aakashgangolli3112', 'pavitra.iyer', 'rohanchavan', 'guptesoham95', 'ptrimukhe32']"
131,38,7,170,2,"['s.jadeja', 'burhan.naim']",4,"['sahilsk7', 'neilmundhe', 'mohiteashwin7', 'pratikthorat10']",168,"['jigneshk2994', 'yashsavle', 'tejuliman74', 'harshitbangera', 'ishmeetsingh', 'sanketh728', 'swatimane176', 'karan.marketkar', 'rushikeshjoshi285', 'rnair15', 'shreyasawant95', 'viraktdoshi19', 'udayyewale17', 'karan.gondalia', 'patilroshan1128', 'kumarvivek017', 'rohitpuri.g', 'gurmukhsingh0108', 'amit.dutta', 'sush81194', 'rishabh4745', 'tambeneha94', 'rukhsrd', 'nair19shruti', 'happyridermrk', 'gadhiyakenil16', 'abauti608', 'sadiqqureshi393', 'rutu123', 'jiteshkjsp', 'varun1997', 'aniketshelar79', 'sachimalkan', 'sgat3451', 'jaysawant2', 'ykhedikar', 'ishaan.sathe', 'mapethe', 'amruteshpatil', 'pateltejash96', 'ratsthegreat', 'tandelsneha15', 'doshi.kavisha16', 'tajpara.nikhil', 'miteshmohokar', 'g3jithinn', 'kapilaherkar755', 'sweta151945', 'dhairyagada1997', 'pruthavi.c', 'akansha319892', 'vjseedan', 'vishal.chavda', 'nairprasad007', 'joshua0667', 'hardrider95', 'ankitferry123', 'priyankadeshpande177', 'hardik.upadhyay', '1jyotsna1', 'prasad.m', 'parmarmayur05', 'nikj816', 'smajumdar', 'rrnair291293', 'nikuldengada493', 'ankur.shah', 'princeporje98', 'suraj6111994', 'yogeshwar21121995', 'parthkaushikdave', 'nilesh.delekar', 'ameymalotkar1', 'pareshnaik1995', 'gopal.singh', 'nehaaltawade1', 'melchiznadar', 'poojaparab9035', 'nikhil4241307', 'pdeshpande', 'peshinakash', 'kiranjadhav050994', 'abinbenny8', 'ashupalambe1992', 'abinaya67006', 'ajitjadhav', 'machalke92', 'yogi.6692', 'devyani.salvi1028', 'qwertynishit', 'verma.amitkumar95', 'florence9344', 'anuradha.d', 'satya_mishra', 'shraddhakharde01', 'inderjitsingh87', 'kypptl', 'lino2296', 'sharma.ayushi8c', 'sbodke', 'aqudas29', 'khedikaryash8', 'tgpatil22791', 'vijaykothari97', 'pranithsuvarna1', 'mauryashubham564', 'vijaya', 'shaminakunnel', 'rahulbadekar', 'arawal14.ar', 'raoashish96', 'parag.choughule', 'asingh12', 'parag16593', 'jigar', 'shivam_cr7', 'udit.shah', 'vishakha', 'tdholpuria', 'atoraskar12', 'mkadam03', 'walavalkarmayur79', 'ankitagharat93', 'aanugraha', 'shubhrapatil77', 'gkapil45', 'rushabh.soni', 'mayuripatil3095', 'tanujudani865', 'sonihetvi10', 'aniketa.yelave49', 'jadhavankita9969', 'sujataredkar', 'rautt59', 'rjoshi02', 'karankyp', 'adwaitvajpe', 'anevrekar', 'yayatipawar601', 'akash.mali3477', 'karantank97', 'akashmore456', 'surajkarade.2', 'pranav.gori', 'patilvarad2011', 'palak1012', 'apekshapawar', 'ramanujsingh004', 'keyur.gajjar', 'pranilghogale', 'pripatil285', 'desaivighnesh95', None, 'd.shenoy', 'ashish.mrya1', 'ankith89', 'priyanka.bhangre', 'rutwijajoshi10', 'karanshah30', 'agarwal.gagan5101', 'anshujha95', 'vedy1811', 'chaitanyakhane999', 'tushar.gaikwad', 'gaurav.gadre', 'sourabhbelose', 'somil910', 'abhiramibp95']",174,"['jigneshk2994', 'yashsavle', 'tejuliman74', 'harshitbangera', 'ishmeetsingh', 'sanketh728', 'sahilsk7', 'swatimane176', 'karan.marketkar', 'rushikeshjoshi285', 'rnair15', 'shreyasawant95', 'viraktdoshi19', 'udayyewale17', 'karan.gondalia', 'patilroshan1128', 'kumarvivek017', 'rohitpuri.g', 'gurmukhsingh0108', 'amit.dutta', 'sush81194', 'rishabh4745', 'tambeneha94', 'rukhsrd', 'nair19shruti', 'happyridermrk', 'gadhiyakenil16', 'abauti608', 'sadiqqureshi393', 'rutu123', 'jiteshkjsp', 'aniketshelar79', 'sachimalkan', 'sgat3451', 'jaysawant2', 'ykhedikar', 'ishaan.sathe', 'mapethe', 'amruteshpatil', 'pateltejash96', 'ratsthegreat', 'tandelsneha15', 'doshi.kavisha16', 'tajpara.nikhil', 'miteshmohokar', 'g3jithinn', 'kapilaherkar755', 'sweta151945', 'dhairyagada1997', 'pruthavi.c', 'akansha319892', 'vjseedan', 'vishal.chavda', 'nairprasad007', 'joshua0667', 'hardrider95', 'ankitferry123', 'priyankadeshpande177', 'hardik.upadhyay', 'pratikthorat10', '1jyotsna1', 'prasad.m', 'parmarmayur05', 'nikj816', 'smajumdar', 'rrnair291293', 'nikuldengada493', 'ankur.shah', 'princeporje98', 'suraj6111994', 'yogeshwar21121995', 'parthkaushikdave', 'nilesh.delekar', 'ameymalotkar1', 'pareshnaik1995', 'gopal.singh', 'nehaaltawade1', 's.jadeja', 'mohiteashwin7', 'melchiznadar', 'poojaparab9035', 'nikhil4241307', 'pdeshpande', 'peshinakash', 'kiranjadhav050994', 'abinbenny8', 'ashupalambe1992', 'abinaya67006', 'ajitjadhav', 'machalke92', 'yogi.6692', 'devyani.salvi1028', 'qwertynishit', 'verma.amitkumar95', 'florence9344', 'anuradha.d', 'satya_mishra', 'shraddhakharde01', 'inderjitsingh87', 'kypptl', 'lino2296', 'sharma.ayushi8c', 'sbodke', 'aqudas29', 'khedikaryash8', 'tgpatil22791', 'vijaykothari97', 'pranithsuvarna1', 'mauryashubham564', 'vijaya', 'shaminakunnel', 'rahulbadekar', 'arawal14.ar', 'raoashish96', 'parag.choughule', 'asingh12', 'parag16593', 'jigar', 'shivam_cr7', 'udit.shah', 'vishakha', 'tdholpuria', 'atoraskar12', 'mkadam03', 'walavalkarmayur79', 'ankitagharat93', 'somil910', 'aanugraha', 'shubhrapatil77', 'gkapil45', 'rushabh.soni', 'mayuripatil3095', 'tanujudani865', 'sonihetvi10', 'aniketa.yelave49', 'jadhavankita9969', 'sujataredkar', 'rautt59', 'rjoshi02', 'karankyp', 'adwaitvajpe', 'anevrekar', 'yayatipawar601', 'akash.mali3477', 'karantank97', 'akashmore456', 'surajkarade.2', 'pranav.gori', 'patilvarad2011', 'palak1012', 'apekshapawar', 'ramanujsingh004', 'keyur.gajjar', 'neilmundhe', 'pranilghogale', 'pripatil285', 'desaivighnesh95', None, 'burhan.naim', 'd.shenoy', 'ashish.mrya1', 'ankith89', 'priyanka.bhangre', 'rutwijajoshi10', 'karanshah30', 'agarwal.gagan5101', 'anshujha95', 'vedy1811', 'chaitanyakhane999', 'tushar.gaikwad', 'gaurav.gadre', 'sourabhbelose', 'varun1997', 'abhiramibp95']"
131,42,7,114,2,"['sahilsk7', 'pratikthorat10']",4,"['s.jadeja', 'neilmundhe', 'mohiteashwin7', 'burhan.naim']",112,"['sankpalami', 'shrutikayadav2oct', 'dalvisayli', 'niraj901', 'ektarathod786', 'komalbapna.kb', 'dikshabafna1995', 'adipatil37', 'niteshnarkar712', 'omkarn049', 'ahire.monali07', 'akshaybadhiye04', 'iabhishek555', 'pankajpawar1515', 'susmitaahirrao', 'vinit95vasudevan', 'umeshdarade77', 'tanayshinde21', 'infinite1309', 'pravin45', 'tejaskanagal95', 'minalsawant143', 'oindri.c', 'abarge31', 'chaudharipayal50', 'shahyash027', 'rawletanmayee46', 'shraddha0306', 'sangeetamjoshi', 'mahajanabhi2201', 'mudrasjuee', 'vijaybhargude2', 'advenraju', 'abhihadshi', 'supu1796', 'sebastian007', 'pratikkhanore95', 'preetywagh95', 'gidayegirish', 'ashwini12rajput', 'shrikantnimse14', 'praju.avhad', 'gauravrajeshmehta', 'pbrahmapurkar', 'rakshu.gade', 'sam234bryant', 'swati123', 'sonalipawar589', 'saurabhmangeshkar', 'shrutisundar019', 'ratsthegreat', 'oma1811', 'ravina.chavan42', 'mukulsathe1995', 'bimal.biswas8', 'tarak.shah', 'rsawant2895', 'priyankaingle18', 'sumedh_patil', 'bondreanup007', 'rohitbaliyan53', 'a.j.yadav2395', 'chiragc9494', 'hbg2112', 'tanyabaptist05', 'bkadam357', 'manishashetye1295', 'abhishek.thavare', 'varadrajnanaware7', 'sardesai.kirti18', 'sammit1844', 'viveky803', 'tejasshinde8055', 'chaudharisuyash7', 'ru1795', 'sanketsalvi03', 'sandesh29', 'deven199570', 'priyagajakosh1', 'aashish.yadav94', 'amritamukeshb', 'jatin.dhande1008', 'lakumveer', 'aniket2602', 'aditya1818', 'shakyanandk', 'ramaprde2296', 'rushabh.fegade', 'akashspawar148', 'cpatil152', 'abhishekm2861996', 'ritesh.parulekar231194', 'sonawane.akshayak', 'vishakha1805', 'ptrimukhe32', 'dattaram.gawade781', 'sagarpawar', 'gsawant999', None, 'prajaktachapte2', 'nikhildubey02051996', 'sagarbhagat43', 'kaustubhgudekar9', 'prashant.baperkar', 'suman28pandit', 'danish.dev.007', 'rakeshmaity', 'saylishirodkar58', 'sayalipatil4545', 'rohanchavan', 'aishwaryamardhekar.24595', 'cooldudeakshu']",118,"['sankpalami', 'shrutikayadav2oct', 'dalvisayli', 'niraj901', 'ektarathod786', 'komalbapna.kb', 'dikshabafna1995', 'adipatil37', 'niteshnarkar712', 'omkarn049', 'sahilsk7', 'ahire.monali07', 'akshaybadhiye04', 'iabhishek555', 'pankajpawar1515', 'susmitaahirrao', 'vinit95vasudevan', 'umeshdarade77', 'tanayshinde21', 'infinite1309', 'pravin45', 'tejaskanagal95', 'minalsawant143', 'oindri.c', 'abarge31', 'chaudharipayal50', 'shahyash027', 'rawletanmayee46', 'shraddha0306', 'sangeetamjoshi', 'mahajanabhi2201', 'mudrasjuee', 'vijaybhargude2', 'advenraju', 'abhihadshi', 'supu1796', 'sebastian007', 'pratikkhanore95', 'preetywagh95', 'gidayegirish', 'ashwini12rajput', 'shrikantnimse14', 'praju.avhad', 'gauravrajeshmehta', 'pbrahmapurkar', 'rakshu.gade', 'sam234bryant', 'swati123', 'sonalipawar589', 'saurabhmangeshkar', 'shrutisundar019', 'ratsthegreat', 'oma1811', 'ravina.chavan42', 'mukulsathe1995', 'bimal.biswas8', 'tarak.shah', 'rsawant2895', 'priyankaingle18', 'sumedh_patil', 'bondreanup007', 'rohitbaliyan53', 'a.j.yadav2395', 'chiragc9494', 'hbg2112', 'tanyabaptist05', 'bkadam357', 'manishashetye1295', 'abhishek.thavare', 'varadrajnanaware7', 'sardesai.kirti18', 'sammit1844', 'viveky803', 'tejasshinde8055', 'chaudharisuyash7', 'ru1795', 'sanketsalvi03', 'sandesh29', 'deven199570', 'priyagajakosh1', 'aashish.yadav94', 'amritamukeshb', 'pratikthorat10', 'jatin.dhande1008', 'lakumveer', 'aniket2602', 'aditya1818', 'shakyanandk', 'ramaprde2296', 'rushabh.fegade', 'akashspawar148', 'cpatil152', 'abhishekm2861996', 'ritesh.parulekar231194', 'sonawane.akshayak', 'vishakha1805', 'neilmundhe', 'ptrimukhe32', 'dattaram.gawade781', 'sagarpawar', 'gsawant999', None, 'burhan.naim', 'prajaktachapte2', 'nikhildubey02051996', 'sagarbhagat43', 's.jadeja', 'mohiteashwin7', 'kaustubhgudekar9', 'prashant.baperkar', 'danish.dev.007', 'suman28pandit', 'rakeshmaity', 'saylishirodkar58', 'sayalipatil4545', 'rohanchavan', 'aishwaryamardhekar.24595', 'cooldudeakshu']"
131,40,7,30,2,"['neilmundhe', 'mohiteashwin7']",4,"['sahilsk7', 'burhan.naim', 's.jadeja', 'pratikthorat10']",28,"['shakyanandk', 'mukulsathe1995', 'arpit32', 'parmitbanga1995', 'shraddha0306', 'bondreanup007', 'ritesh.parulekar231194', 'vaibhavghare94', 'tanyabaptist05', 'a.j.yadav2395', 'hbg2112', 'anasnaik25', 'heramb10', 'shriya.h.joshi', 'sagarpawar', 'anujakhose94', None, 'sebastian007', 'smonica498', 'prajaktachapte2', 'patelu997', 'akshaybadhiye04', 'iabhishek555', 'prp23dec', 'sanketsalvi03', 'mapethe', 'shreyamath95', 'ratsthegreat']",34,"['mukulsathe1995', 'bondreanup007', 'tanyabaptist05', 'a.j.yadav2395', 'hbg2112', 'anasnaik25', 'sahilsk7', 'shriya.h.joshi', 'anujakhose94', 'akshaybadhiye04', 'iabhishek555', 'sanketsalvi03', 'pratikthorat10', 'shreyamath95', 'shakyanandk', 'arpit32', 'parmitbanga1995', 'shraddha0306', 'ritesh.parulekar231194', 'vaibhavghare94', 'neilmundhe', 'heramb10', 'sagarpawar', None, 'burhan.naim', 'sebastian007', 'smonica498', 'prajaktachapte2', 'patelu997', 'prp23dec', 's.jadeja', 'mohiteashwin7', 'mapethe', 'ratsthegreat']"
131,225,7,30,4,"['sahilsk7', 'neilmundhe', 'mohiteashwin7', 'pratikthorat10']",2,"['s.jadeja', 'burhan.naim']",26,"['arpit32', 'shraddha0306', 'nikhilgade', 'vickswagh146', 'yashgumaste', 'arvindlandge', 'anasnaik25', 'vrajesh915', 'harshada123', 'mahajanabhi2201', 'simran123', 'ankurbhagwat8', None, 'naikraj490', '22diptinikalje', 'patelu997', 'rajdeepd', 'nehasankeshi', 'kpiyushbhirud', 'priyeshd', 'shraddha.vispute.in', 'pathakrohan18', 'nikitagaikwad594', 'mananmehta7', 'geeta.kavitake', 'shreyamath95']",32,"['nikhilgade', 'vickswagh146', 'arvindlandge', 'anasnaik25', 'sahilsk7', 'ankurbhagwat8', 'rajdeepd', 'kpiyushbhirud', 'priyeshd', 'shraddha.vispute.in', 'pratikthorat10', 'shreyamath95', 'arpit32', 'shraddha0306', 'yashgumaste', 'vrajesh915', 'harshada123', 'neilmundhe', 'mahajanabhi2201', 'simran123', None, 'naikraj490', 'burhan.naim', '22diptinikalje', 'patelu997', 's.jadeja', 'mohiteashwin7', 'pathakrohan18', 'nikitagaikwad594', 'mananmehta7', 'geeta.kavitake', 'nehasankeshi']"
131,226,7,11,3,"['sahilsk7', 'mohiteashwin7', 'pratikthorat10']",3,"['neilmundhe', 's.jadeja', 'burhan.naim']",8,"['patelu997', 'shraddha.vispute.in', 'shraddha0306', 'vickswagh146', 'vrajesh915', 'nikitagaikwad594', None, 'naikraj490']",14,"['shraddha0306', 'vickswagh146', 'vrajesh915', 'neilmundhe', 'sahilsk7', 'naikraj490', None, 'burhan.naim', 'patelu997', 'shraddha.vispute.in', 's.jadeja', 'mohiteashwin7', 'nikitagaikwad594', 'pratikthorat10']"
132,117,7,28,6,"['b.w.pappas378', 'seaglass418', 'summersxia220194', 'bxd159', 'jnk41', 'nsteinway']",0,[],22,"['scs85', 'ath45', 'bwp16', 'jiarenkai', 'jml241', 'njn31', 'summersxia2201', 'rsk77', 'axc549', 'jql', None, 'bnc8', 'wxc292', 'dgrosh1', 'rxj167', 'myk16', 'cilling', 'bdh58', 'jennak_41', 'nws24', 'jwc137', 'jrmcginnity']",28,"['scs85', 'ath45', 'jiarenkai', 'jml241', 'njn31', 'bxd159', 'jql', 'dgrosh1', 'seaglass418', 'rxj167', 'summersxia220194', 'cilling', 'bdh58', 'nws24', 'jwc137', 'nsteinway', 'b.w.pappas378', 'bwp16', 'summersxia2201', 'rsk77', 'axc549', None, 'bnc8', 'wxc292', 'myk16', 'jnk41', 'jennak_41', 'jrmcginnity']"
133,305,6,8,4,"['yuanzi11s', 'niko1028', 'che16', 'li.yue']",1,['yiluntong'],4,"['spahng', 'zhangyz0216', 'yvonneoafriyie', None]",9,"['spahng', 'li.yue', 'niko1028', 'yuanzi11s', 'yvonneoafriyie', 'yiluntong', 'zhangyz0216', None, 'che16']"
134,124,6,27,4,"['afchadwi', 'zzhiheng123', 'zzhiheng126', 'zzhiheng']",1,['totonben'],23,"['atmat', 'njvaughn', 'kryrin', 'huxiaoer', 'jenningd', 'erowell', 'greyholm', 'casansmi', 'kavaidya', 'cmbaums', 'yangpan', None, 'kige', 'masonab', 'afashwhi', 'ymhuang', 'umjihgl', 'keyicai', 'ywwoo', 'jibecker', 'lworyk', 'mbnicola', 'rickfreedom']",28,"['atmat', 'njvaughn', 'kryrin', 'huxiaoer', 'erowell', 'greyholm', 'kavaidya', 'cmbaums', 'zzhiheng', 'kige', 'afchadwi', 'ymhuang', 'umjihgl', 'ywwoo', 'jibecker', 'rickfreedom', 'jenningd', 'casansmi', 'zzhiheng123', None, 'masonab', 'afashwhi', 'keyicai', 'totonben', 'lworyk', 'mbnicola', 'zzhiheng126', 'yangpan']"
135,180,6,35,4,"['rutuj.t', 'hem.s', 'tushar.bait', 'manthan.thakkar']",1,['abhishek09'],31,"['ajinkya.a', 'apurava.j', 'prit96k', 'viranchi.lotia', 'm.panjwani', 'meet.siddhapura', 'sajanjain', 'chaitanya.pandya', 'prajakta.ahire', 'oshinranpise39', 'poonam.sangole', 'shiro123', 'karan_b24', 'kanchansuryawanshi1996', 'dhruv.sm', 'karancvshah', 'shashank.tiwari', 'nidhi.kapuria', 'dhruvmehta377424', 'pandya.k', 'vaibhavi', 'shahjaini5', 'meet.sagaliya', 'divya.sawool', 'rishi.p', None, 'tushar.h', 'shailesh.k', 'vaishnavidsahu', 'jaypanchal1415', 'palasra12']",36,"['ajinkya.a', 'apurava.j', 'prit96k', 'viranchi.lotia', 'm.panjwani', 'meet.siddhapura', 'sajanjain', 'chaitanya.pandya', 'prajakta.ahire', 'oshinranpise39', 'poonam.sangole', 'shiro123', 'karan_b24', 'hem.s', 'kanchansuryawanshi1996', 'dhruv.sm', 'karancvshah', 'shashank.tiwari', 'nidhi.kapuria', 'dhruvmehta377424', 'pandya.k', 'rutuj.t', 'vaibhavi', 'shahjaini5', 'tushar.bait', 'meet.sagaliya', 'divya.sawool', 'rishi.p', None, 'tushar.h', 'shailesh.k', 'manthan.thakkar', 'vaishnavidsahu', 'abhishek09', 'jaypanchal1415', 'palasra12']"
135,194,6,28,4,"['rutuj.t', 'hem.s', 'tushar.bait', 'manthan.thakkar']",1,['abhishek09'],24,"['pandya.k', 'ajinkya.a', 'apurava.j', 'viranchi.lotia', 'm.panjwani', 'vaibhavi', 'meet.siddhapura', 'shahjaini5', 'chaitanya.pandya', 'meet.sagaliya', 'rishi.p', None, 'prajakta.ahire', 'divya.sawool', 'tushar.h', 'shailesh.k', 'poonam.sangole', 'karan_b24', 'dhruv.sm', 'shashank.tiwari', 'jaypanchal1415', 'nidhi.kapuria', 'dhruvmehta377424', 'palasra12']",29,"['ajinkya.a', 'apurava.j', 'viranchi.lotia', 'm.panjwani', 'meet.siddhapura', 'chaitanya.pandya', 'prajakta.ahire', 'poonam.sangole', 'karan_b24', 'hem.s', 'dhruv.sm', 'shashank.tiwari', 'nidhi.kapuria', 'dhruvmehta377424', 'pandya.k', 'rutuj.t', 'vaibhavi', 'shahjaini5', 'tushar.bait', 'meet.sagaliya', 'rishi.p', None, 'divya.sawool', 'tushar.h', 'shailesh.k', 'manthan.thakkar', 'abhishek09', 'jaypanchal1415', 'palasra12']"
135,260,6,14,5,"['manthan.thakkar', 'rutuj.t', 'abhishek09', 'hem.s', 'tushar.bait']",0,[],9,"['nidhikapuria6', 'harshil.makwana', 'shah.kv', 'akshay.bharadwaj', 'priya.pujara', 'ajish.nair', 'prabaha31', None, 'chaitanya09pandya']",14,"['nidhikapuria6', 'rutuj.t', 'priya.pujara', 'tushar.bait', 'prabaha31', None, 'manthan.thakkar', 'harshil.makwana', 'abhishek09', 'shah.kv', 'akshay.bharadwaj', 'ajish.nair', 'hem.s', 'chaitanya09pandya']"
135,181,6,6,1,['abhishek09'],4,"['rutuj.t', 'hem.s', 'tushar.bait', 'manthan.thakkar']",5,"['apurava.j', 'niraj.dhinoja', 'viranchi.lotia', 'divya.sawool', None]",10,"['manthan.thakkar', 'rutuj.t', 'abhishek09', 'apurava.j', 'niraj.dhinoja', 'viranchi.lotia', 'hem.s', 'tushar.bait', 'divya.sawool', None]"
135,198,6,6,1,['abhishek09'],4,"['rutuj.t', 'hem.s', 'tushar.bait', 'manthan.thakkar']",5,"['apurava.j', 'niraj.dhinoja', 'viranchi.lotia', 'divya.sawool', None]",10,"['manthan.thakkar', 'rutuj.t', 'abhishek09', 'apurava.j', 'niraj.dhinoja', 'viranchi.lotia', 'hem.s', 'tushar.bait', 'divya.sawool', None]"
136,288,6,83,3,"['madhugurram', 'saikumar8814', 'rayudhajit1']",2,"['pranju.0207', 'siddharth.saharan96']",80,"['hemanth297', 'kaustav1407', 'nivedprakash1996', 'sarath31', 'rsagrawal.avanti', 'gopa_97', 'kgoel', 'ksai0378', 'anirudhrachamalla', 'rajeswarim81', 'rko2saurav', 'rajdeep.biswas2010', 'mayankpalaria', 'antroy.rc', 'vineethvinny1997', 'pourushsood', 'sairohith', 'avinabsaha2018', 'kumarvineeth14', 'saivineethkumar', 'ram2606', 'sumit53', 'joshuapeterebenezer', 'harshit.roy30014', 'harshit123', 'ankitkp4056', 'sumitarya1310', 'nagapradeep97', 'amruthamma1998', 'arunganesh', 'shanmukh17', 'deepthireddyparvatham12', 'utki.07', 'ray_arka', 'balu8108', 'revanthreddy207', 'anirudhaga', 'sid89014', 'harsh12041997', 'kunalkhadke97', 'rakesh207', 'nirajj100', 'muralikorada55', 'nupurbhaisare24', 'rahulkr.1531', 'niharika25', 'sim_ks', 'sudzsharma', 'tummalabalakrishna48', 'sameer786007', 'hardikagrawal545', 'anjanmandal58', 'nikhiliated', 'chaitanypaikara', 'utshobmazumder0909', 'sittun.swayam', 'saurabhjai97', 'shanka', 'sayantan2502iitkgp', 'xybiju', 'asif123', 'mriganksh', 'shravanisistla1998', 'lovkeshrishab', 'keerthana_bhogi', 'abhi123', 'kshitizgoel', 'saranyu', None, 'rayudhajit', '2209sandeep', 'siripranitha', 'kalyan4112', 'nitinkush16', 'acabhi07', 'sm13497', 'swarnabha1997', 'rohitrajeev128', 'manishasa', 'abinashsena']",85,"['hemanth297', 'kaustav1407', 'nivedprakash1996', 'sarath31', 'rsagrawal.avanti', 'gopa_97', 'kgoel', 'ksai0378', 'anirudhrachamalla', 'rajeswarim81', 'rko2saurav', 'rajdeep.biswas2010', 'mayankpalaria', 'antroy.rc', 'vineethvinny1997', 'pourushsood', 'sairohith', 'avinabsaha2018', 'kumarvineeth14', 'saivineethkumar', 'ram2606', 'sumit53', 'joshuapeterebenezer', 'harshit.roy30014', 'harshit123', 'ankitkp4056', 'pranju.0207', 'sumitarya1310', 'nagapradeep97', 'amruthamma1998', 'arunganesh', 'shanmukh17', 'deepthireddyparvatham12', 'rayudhajit1', 'utki.07', 'ray_arka', 'balu8108', 'revanthreddy207', 'anirudhaga', 'sid89014', 'harsh12041997', 'kunalkhadke97', 'rakesh207', 'nirajj100', 'muralikorada55', 'nupurbhaisare24', 'rahulkr.1531', 'niharika25', 'sim_ks', 'sudzsharma', 'tummalabalakrishna48', 'sameer786007', 'hardikagrawal545', 'anjanmandal58', 'nikhiliated', 'chaitanypaikara', 'utshobmazumder0909', 'sittun.swayam', 'saurabhjai97', 'shanka', 'madhugurram', 'sayantan2502iitkgp', 'xybiju', 'asif123', 'mriganksh', 'shravanisistla1998', 'lovkeshrishab', 'keerthana_bhogi', 'abhi123', 'kshitizgoel', 'saranyu', None, 'rayudhajit', '2209sandeep', 'siripranitha', 'swarnabha1997', 'kalyan4112', 'nitinkush16', 'acabhi07', 'sm13497', 'saikumar8814', 'siddharth.saharan96', 'rohitrajeev128', 'manishasa', 'abinashsena']"
136,289,6,30,2,"['pranju.0207', 'siddharth.saharan96']",3,"['madhugurram', 'saikumar8814', 'rayudhajit1']",28,"['anirudhaga', 'kaustav1407', 'beena11', 'keerthana_bhogi', 'joshuapeterebenezer', 'rahulkr.1531', 'kandalavamshi111', 'tummalabalakrishna48', 'saranyu', None, 'anirudhrachamalla', 'sumitarya1310', 'rajeswarim81', 'shanmukh17', 'hardikagrawal545', 'deepthireddyparvatham12', 'anjanmandal58', 'siripranitha', 'swarnabha1997', 'nitinkush16', 'utki.07', 'saurabhjai97', 'shanka', 'sm13497', 'ray_arka', 'mayankpalaria', 'saivineethkumar', 'nupurbhaisare25']",33,"['anirudhaga', 'kaustav1407', 'beena11', 'rahulkr.1531', 'tummalabalakrishna48', 'anirudhrachamalla', 'rajeswarim81', 'mayankpalaria', 'hardikagrawal545', 'anjanmandal58', 'saurabhjai97', 'shanka', 'madhugurram', 'saivineethkumar', 'nupurbhaisare25', 'keerthana_bhogi', 'joshuapeterebenezer', 'kandalavamshi111', 'pranju.0207', 'saranyu', None, 'sumitarya1310', 'shanmukh17', 'deepthireddyparvatham12', 'siripranitha', 'swarnabha1997', 'nitinkush16', 'rayudhajit1', 'utki.07', 'sm13497', 'ray_arka', 'saikumar8814', 'siddharth.saharan96']"
140,232,6,7,5,"['hubnano2', 'philiph', 'philiph111', 'nanooutlook', 'erichzann']",0,[],2,"[None, 'torben']",7,"['hubnano2', 'philiph', 'philiph111', 'nanooutlook', 'erichzann', 'torben', None]"
140,233,6,7,5,"['hubnano2', 'philiph', 'philiph111', 'nanooutlook', 'erichzann']",0,[],2,"[None, 'torben']",7,"['hubnano2', 'philiph', 'philiph111', 'nanooutlook', 'erichzann', 'torben', None]"
140,234,6,7,5,"['hubnano2', 'philiph', 'philiph111', 'nanooutlook', 'erichzann']",0,[],2,"[None, 'torben']",7,"['hubnano2', 'philiph', 'philiph111', 'nanooutlook', 'erichzann', 'torben', None]"
140,235,6,7,5,"['hubnano2', 'philiph', 'philiph111', 'nanooutlook', 'erichzann']",0,[],2,"[None, 'torben']",7,"['hubnano2', 'philiph', 'philiph111', 'nanooutlook', 'erichzann', 'torben', None]"
140,236,6,7,5,"['hubnano2', 'philiph', 'philiph111', 'nanooutlook', 'erichzann']",0,[],2,"[None, 'torben']",7,"['hubnano2', 'philiph', 'philiph111', 'nanooutlook', 'erichzann', 'torben', None]"
140,237,6,7,5,"['hubnano2', 'philiph', 'philiph111', 'nanooutlook', 'erichzann']",0,[],2,"[None, 'torben']",7,"['hubnano2', 'philiph', 'philiph111', 'nanooutlook', 'erichzann', 'torben', None]"
140,238,6,7,4,"['nanooutlook', 'hubnano2', 'philiph111', 'philiph']",1,['erichzann'],3,"['torben', None, 'backe124']",8,"['hubnano2', 'philiph', 'philiph111', 'backe124', 'nanooutlook', 'erichzann', 'torben', None]"
141,64,6,42,5,"['ukarell001', 'fengshui', 'megan0529', 'andrew_lemx', 'pgarcia1999']",0,[],37,"['jjacobsen6', 'kstaton6', 'bbosley', 'ulisses.k22', 'suresh7', 'webera', 'jihkim23', 'perlargarcia99', 'krea', 'juliedsilvers', 'egk818', 'chris5175', 'jarebmendez', 'jabier41', 'danielclayton0', 'guoj', 'kolek', 'awcolumbie', 'vhabic16', 'mltillman', 'bfieldson', 'xxlancet', 'tpank', 'crsileo', 'eugenesg1ddin', 'yelnamdivad92', 'pbouyounes', 'insua86', None, 'vdubinin2', 'cam.jackson', 'jaredhines', 'sten621', 'cheuser', 'stevenjwilliams', 'vpirie', 'rbillings']",42,"['jjacobsen6', 'kstaton6', 'bbosley', 'ulisses.k22', 'suresh7', 'webera', 'megan0529', 'jihkim23', 'perlargarcia99', 'krea', 'pgarcia1999', 'juliedsilvers', 'egk818', 'chris5175', 'jarebmendez', 'jabier41', 'danielclayton0', 'andrew_lemx', 'guoj', 'kolek', 'awcolumbie', 'vhabic16', 'mltillman', 'bfieldson', 'xxlancet', 'tpank', 'ukarell001', 'crsileo', 'eugenesg1ddin', 'yelnamdivad92', 'pbouyounes', 'insua86', None, 'vdubinin2', 'cam.jackson', 'jaredhines', 'sten621', 'cheuser', 'stevenjwilliams', 'fengshui', 'vpirie', 'rbillings']"
141,175,6,35,5,"['ukarell001', 'fengshui', 'megan0529', 'andrew_lemx', 'pgarcia1999']",0,[],30,"['kstaton6', 'bbosley', 'webera', 'jihkim23', 'perlargarcia99', 'krea', 'juliedsilvers', 'egk818', 'jej1994', 'chris5175', 'jabier41', 'danielclayton0', 'awcolumbie', 'vhabic16', 'xxlancet', 'mltillman', 'tpank', 'crsileo', 'yelnamdivad92', 'pbouyounes', 'ssookraj', 'insua86', 'carlosniko', None, 'vdubinin2', 'cam.jackson', 'jaredhines', 'stevenjwilliams', 'vpirie', 'rbillings']",35,"['kstaton6', 'bbosley', 'webera', 'megan0529', 'jihkim23', 'perlargarcia99', 'krea', 'pgarcia1999', 'juliedsilvers', 'egk818', 'jej1994', 'chris5175', 'jabier41', 'danielclayton0', 'andrew_lemx', 'awcolumbie', 'vhabic16', 'xxlancet', 'mltillman', 'tpank', 'ukarell001', 'crsileo', 'yelnamdivad92', 'pbouyounes', 'ssookraj', 'insua86', 'carlosniko', None, 'vdubinin2', 'cam.jackson', 'jaredhines', 'stevenjwilliams', 'fengshui', 'vpirie', 'rbillings']"
142,309,6,29,5,"['samuelpedersen', 'nate.stephon', 'andrewarmstrong858', 'marissahondros16', 'binayjoshi']",0,[],24,"['petebarnes3', 'andrescorrea', 'devankarsann', 'bmw92', 'nickcarter', 'egraugnard', 'williamburdge', 'codylynde', 'alondraperez', 'strcroft', 'nickkempf', 'josephspinuzzi', None, 'lanlibsu', 'twinters', 'arminmirahcic', 'jfreilich', 'donaldkellis', 'jakesoares', 'yaizarodriguezortego', 'riccardotorsi', 'georgewarren', 'mitchellleibowitz', 'arvincunningham']",29,"['samuelpedersen', 'petebarnes3', 'andrescorrea', 'bmw92', 'nickcarter', 'alondraperez', 'strcroft', 'josephspinuzzi', 'lanlibsu', 'nate.stephon', 'donaldkellis', 'jakesoares', 'yaizarodriguezortego', 'georgewarren', 'mitchellleibowitz', 'arvincunningham', 'devankarsann', 'egraugnard', 'marissahondros16', 'williamburdge', 'codylynde', 'binayjoshi', 'nickkempf', None, 'twinters', 'arminmirahcic', 'jfreilich', 'andrewarmstrong858', 'riccardotorsi']"
142,144,6,7,5,"['samuelpedersen', 'nate.stephon', 'andrewarmstrong858', 'marissahondros16', 'binayjoshi']",0,[],2,"[None, 'lanlibsu']",7,"['samuelpedersen', 'nate.stephon', 'andrewarmstrong858', 'marissahondros16', 'binayjoshi', None, 'lanlibsu']"
143,110,6,8,4,"['chrisyang0808', 'jin7881178', 'pollohuang', 'laputa07']",1,['qinzhao'],4,"['mitfs', None, 'king123456789', 'daaa']",9,"['chrisyang0808', 'pollohuang', 'king123456789', 'jin7881178', 'daaa', 'qinzhao', 'mitfs', None, 'laputa07']"
144,283,6,11,5,"['aakashpandit366', 'mehulhariya268', 'gaurangkalgutkar', 'mhatre.saurabh8', 'sanjajt']",0,[],6,"['ashish.tambadkar333', 'jd7ani', 'variaraj16', 'aniketkumbhar20', None, 'amishkeniya333']",11,"['aakashpandit366', 'mehulhariya268', 'mhatre.saurabh8', None, 'ashish.tambadkar333', 'jd7ani', 'variaraj16', 'gaurangkalgutkar', 'aniketkumbhar20', 'amishkeniya333', 'sanjajt']"
144,284,6,10,3,"['aakashpandit366', 'mehulhariya268', 'sanjajt']",2,"['gaurangkalgutkar', 'mhatre.saurabh8']",7,"['luxcozibaniyan', 'jd7ani', 'sanika02', 'aniketkumbhar20', 'naikabhijeet.a', None, 'pranali7010']",12,"['pranali7010', 'luxcozibaniyan', 'jd7ani', 'aakashpandit366', 'sanika02', 'mehulhariya268', 'gaurangkalgutkar', 'aniketkumbhar20', 'mhatre.saurabh8', 'naikabhijeet.a', None, 'sanjajt']"
144,205,6,9,5,"['aakashpandit366', 'mehulhariya268', 'gaurangkalgutkar', 'mhatre.saurabh8', 'sanjajt']",0,[],4,"['aniketkumbhar20', 'sanika02', None, 'pranali7010']",9,"['pranali7010', 'aakashpandit366', 'sanika02', 'mehulhariya268', 'gaurangkalgutkar', 'aniketkumbhar20', 'mhatre.saurabh8', None, 'sanjajt']"
145,140,6,16,4,"['lzx92', 'abriggs', 'polinp0p0', 'hasibdalim']",1,['abhayajoseph273'],12,"['naraeyoon92', 'sigrid1995', 'ymmeow', 'kms92313', 'wangxiao', 'lixintong026', 'rhe292', 'colin.g.elder', 'sarmstrong104', 'zhichengxiao', None, 'nblanc4']",17,"['ymmeow', 'hasibdalim', 'abriggs', 'rhe292', 'sarmstrong104', 'zhichengxiao', None, 'lzx92', 'naraeyoon92', 'sigrid1995', 'abhayajoseph273', 'kms92313', 'wangxiao', 'lixintong026', 'colin.g.elder', 'polinp0p0', 'nblanc4']"
146,268,6,25,2,"['messiri', 'ryandavey']",3,"['hossein1985', 'yujiexia0127', 'tarek.ismail']",23,"['calver', 'shaandesai', 'dubose', 'jyhuang09', 'kezi25', 'kintango', 'dgalindonavarro18', 'jgschlichting', 'simingma', 'araun521', 'alinaacosta', None, 'sohum', 'jackkelly18', 'hajiesmaili', 'ignaciobayardo27', 'epatheria', 'youbz', 'jfherrm', 'joannachung1', 'squidsareevil', 'bhenderson25', 'scarr']",28,"['calver', 'shaandesai', 'dubose', 'jyhuang09', 'kezi25', 'kintango', 'dgalindonavarro18', 'jgschlichting', 'messiri', 'simingma', 'araun521', 'alinaacosta', 'hossein1985', None, 'tarek.ismail', 'sohum', 'jackkelly18', 'ryandavey', 'hajiesmaili', 'ignaciobayardo27', 'yujiexia0127', 'epatheria', 'youbz', 'jfherrm', 'joannachung1', 'squidsareevil', 'bhenderson25', 'scarr']"
146,267,6,23,2,"['messiri', 'ryandavey']",3,"['hossein1985', 'yujiexia0127', 'tarek.ismail']",21,"['shaandesai', 'jyhuang09', 'kezi25', 'dgalindonavarro18', 'simingma', 'araun521', 'jackkelly18', 'lishucong', 'youbz', 'xian20944358', 'scarr', 'calver', 'dubose', 'kintango', None, 'sohum', 'hajiesmaili', 'epatheria', 'jfherrm', 'joannachung1', 'bhenderson25']",26,"['calver', 'shaandesai', 'dubose', 'jyhuang09', 'kezi25', 'kintango', 'dgalindonavarro18', 'messiri', 'simingma', 'araun521', 'hossein1985', None, 'tarek.ismail', 'sohum', 'jackkelly18', 'ryandavey', 'hajiesmaili', 'lishucong', 'yujiexia0127', 'epatheria', 'youbz', 'jfherrm', 'xian20944358', 'joannachung1', 'bhenderson25', 'scarr']"
148,41,6,18,5,"['santoshdudhal0', 'arpit0071995', 'darshankikani64', 'tbhoir24', 'manishjadhav1001']",0,[],13,"['guptasantosh7896', 'megha2206', 'shubhangi.matey', 'shraddhaindulkar96', 'jitesh.10', 'tanyabaptist05', 'aakashgangolli3112', 'vishalchelimela11', 'rasikardamushte', None, 'minkscdl', 'razorrajeev', 'n160165']",18,"['guptasantosh7896', 'megha2206', 'shubhangi.matey', 'jitesh.10', 'n160165', 'santoshdudhal0', 'tanyabaptist05', 'darshankikani64', 'minkscdl', None, 'razorrajeev', 'shraddhaindulkar96', 'arpit0071995', 'aakashgangolli3112', 'tbhoir24', 'vishalchelimela11', 'rasikardamushte', 'manishjadhav1001']"
148,135,6,17,5,"['santoshdudhal0', 'arpit0071995', 'darshankikani64', 'tbhoir24', 'manishjadhav1001']",0,[],12,"['guptasantosh7896', 'megha2206', 'shubhangi.matey', 'jitesh.10', 'tanyabaptist05', 'aakashgangolli3112', 'vishalchelimela11', 'rasikardamushte', None, 'minkscdl', 'razorrajeev', 'n160165']",17,"['guptasantosh7896', 'megha2206', 'shubhangi.matey', 'jitesh.10', 'n160165', 'santoshdudhal0', 'tanyabaptist05', 'darshankikani64', 'minkscdl', None, 'razorrajeev', 'arpit0071995', 'aakashgangolli3112', 'tbhoir24', 'vishalchelimela11', 'rasikardamushte', 'manishjadhav1001']"
150,202,6,37,5,"['chaicl9504', 'gunakaladevi', 'syazwanie2907', 'melsonmoses', 'sharifah_fatmadiana']",0,[],32,"['sekchingren', 'jingyan96', 'shinee.agus0', 'shahrul_iqmal', 'vindice1996', 'thinkhui23', 'kevintan', 'soonli950201', 'liewderek7', 'wongyt2222', 'dayangmaisarahh', 'yuenpengwah.dayao', 'ccteh0196', 'khng96', 'zhenyu0425', 'ksyew9', 'liong.yuling', 'aqil_azman', 'nikayuni2012', 'shengyong0908', '1heluckyrocketeer2', 'dyanahatta01', 'sutherdrogba', None, 'fatinfaranishaa', 'csauniverse', 'haniszyqa', 'shenvern1105', 'marinahjosli', 'samteejs', 'hlmahming0213', 'wani.qisteena']",37,"['sekchingren', 'jingyan96', 'shinee.agus0', 'sharifah_fatmadiana', 'shahrul_iqmal', 'vindice1996', 'thinkhui23', 'kevintan', 'soonli950201', 'gunakaladevi', 'liewderek7', 'wongyt2222', 'dayangmaisarahh', 'yuenpengwah.dayao', 'ccteh0196', 'khng96', 'zhenyu0425', 'ksyew9', 'liong.yuling', 'aqil_azman', 'melsonmoses', 'nikayuni2012', 'shengyong0908', '1heluckyrocketeer2', 'dyanahatta01', 'sutherdrogba', None, 'fatinfaranishaa', 'csauniverse', 'chaicl9504', 'haniszyqa', 'shenvern1105', 'marinahjosli', 'syazwanie2907', 'samteejs', 'hlmahming0213', 'wani.qisteena']"
151,57,6,9,3,"['yashdani90', 'auraproductions786', 'mananshah30137']",2,"['squaretaper', 'mikecool']",6,"['riddhis2411', 'roycefernandes80', 'jaysawant2', 'varunswadia', None, '1jyotsna1']",11,"['riddhis2411', 'roycefernandes80', 'jaysawant2', 'mikecool', 'squaretaper', 'mananshah30137', 'varunswadia', 'yashdani90', None, 'auraproductions786', '1jyotsna1']"
155,37,6,12,1,['paucarcarrilloluis'],4,"['christian07', 'adrilofi5', 'itslm.3fima.bautistajonathan', 'ronaldbm93']",11,"['sianwow2', 'mercydry2695', 'santhy0697', 'kestephany29', 'lmp_ryu', 'wilmerluismorales', 'sianwow', 'mercysmc.2695', 'danososcompany', None, 'nancymendoza']",16,"['sianwow2', 'santhy0697', 'kestephany29', 'ronaldbm93', 'lmp_ryu', 'itslm.3fima.bautistajonathan', 'christian07', None, 'nancymendoza', 'adrilofi5', 'paucarcarrilloluis', 'mercydry2695', 'wilmerluismorales', 'sianwow', 'mercysmc.2695', 'danososcompany']"
155,36,6,11,1,['ronaldbm93'],4,"['christian07', 'adrilofi5', 'itslm.3fima.bautistajonathan', 'paucarcarrilloluis']",10,"['alexjavier_paucar', 'jlrapter', 'cristianremache1993', 'lmp_ryu', 'dany', 'guaillazaca', 'guaillazaca24', None, 'cristhian.fajardo', 'sebastiansb2']",15,"['alexjavier_paucar', 'jlrapter', 'ronaldbm93', 'lmp_ryu', 'itslm.3fima.bautistajonathan', 'guaillazaca', 'christian07', None, 'sebastiansb2', 'adrilofi5', 'paucarcarrilloluis', 'cristianremache1993', 'dany', 'guaillazaca24', 'cristhian.fajardo']"
156,37,6,12,1,['wilmerluismorales'],4,"['jlrapter', 'alok.kesari4535', 'jefre996', 'cristhian.fajardo']",11,"['paucarcarrilloluis', 'sianwow2', 'mercydry2695', 'santhy0697', 'kestephany29', 'lmp_ryu', 'sianwow', 'mercysmc.2695', 'danososcompany', None, 'nancymendoza']",16,"['sianwow2', 'santhy0697', 'jlrapter', 'alok.kesari4535', 'kestephany29', 'lmp_ryu', 'jefre996', None, 'nancymendoza', 'paucarcarrilloluis', 'mercydry2695', 'wilmerluismorales', 'sianwow', 'mercysmc.2695', 'danososcompany', 'cristhian.fajardo']"
156,36,6,11,2,"['jlrapter', 'cristhian.fajardo']",3,"['alok.kesari4535', 'jefre996', 'wilmerluismorales']",9,"['alexjavier_paucar', 'cristianremache1993', 'ronaldbm93', 'lmp_ryu', 'dany', 'guaillazaca', 'guaillazaca24', None, 'sebastiansb2']",14,"['alexjavier_paucar', 'jlrapter', 'alok.kesari4535', 'ronaldbm93', 'lmp_ryu', 'guaillazaca', 'jefre996', None, 'sebastiansb2', 'cristianremache1993', 'dany', 'guaillazaca24', 'wilmerluismorales', 'cristhian.fajardo']"
156,35,6,7,2,"['jlrapter', 'jefre996']",3,"['alok.kesari4535', 'cristhian.fajardo', 'wilmerluismorales']",5,"['jhonyjx16', 'johnalex', 'carlos_david1995', None, 'nancymendoza']",10,"['jhonyjx16', 'jlrapter', 'alok.kesari4535', 'johnalex', 'carlos_david1995', 'jefre996', 'wilmerluismorales', None, 'cristhian.fajardo', 'nancymendoza']"
157,207,6,132,5,"['mitesh.dangle', 'ameypatil29', 'saurabh.gharat96', 'priyankakamble', 'nikitamalvade']",0,[],127,"['dalvisayli', 'niraj901', 'ektarathod786', 'khadekunal1', 'dikshabafna1995', 'kadamk008', 'omkarn049', 'sagar.pawar35418', 'ahire.monali07', 'brian200495', 'infinite2205', 'vinit95vasudevan', 'dhartinano19', 'sailee.mohite', 'suyogk.1995', 'nehah95', 'chaudharipayal50', 'dandekarmd73', 'tanayshinde123', 'sangeetamjoshi', 'mudrasjuee', 'sebastian007', 'nikhildabholkar4', 'praju.avhad', 'rakshu.gade', 'snehawaghe21', 'sid.rane95', 'sonalipawar589', 'ratsthegreat', 'oma1811', 'rahulmhapsekar7', 'sumedh_patil', 'a.j.yadav2395', 'chiragc9494', 'hbg2112', 'bhakti961', 'kumarrahul050892', 'viveky803', 'yashapeejay', 'sandeeprock023', 'manasi.shinde008', 'chaudharisuyash7', 'ru1795', 'deven199570', 'priyagajakosh1', 'aashish.yadav94', 'ambeskaradvait', 'spranav3004', 'jatin.dhande1008', 'manalihedaoo4', 'pranilraut17', 'shivamchaube', 'sonawane.akshayak', 'spooja.1430', 'mongya00', 'dattaramkolekar', 'sagarpawar', 'nikhildubey02051996', 'danish.dev.007', 'saylishirodkar58', 'sayalipatil4545', 'aishwaryamardhekar.24595', 'cooldudeakshu', 'snehakudtarkar315', 'komalbapna.kb', 'viprajapatil', 'aniketmane42', 'akshaybadhiye04', 'iabhishek555', 'susmitaahirrao', 'pravin45', 'tejaskanagal95', 'aniketkulaye618', 'bk357357', 'oindri.c', 'kondekar23', 'poojavagre12', 'mihirsawant17', 'adigame18', 'parmitbanga1995', 'shahyash027', 'ajthamke40', 'mishrahenry007', 'shreyashpawar96', 'abhihadshi', 'pratikkhanore95', 'srikalaprabhu', 'gidayegirish', 'gauravrajeshmehta', 'codekidx', 'pbrahmapurkar', 'vinodgadge95', 'shubhambeldar547', 'prathameshptkr4', 'saurabhmangeshkar', 'mukulsathe1995', 'priyankaingle18', 'palswati0309', 'bondreanup007', 'rohitbaliyan53', 'manishashetye1295', 'abhishek.thavare', 'sardesai.kirti18', 'amritamukeshb', 'shakyanandk', 'ramaprde2296', 'rushabh.fegade', 'sahilshaikh827', 'vishakha1805', 'abhishekm2861996', 'dattaram.gawade781', None, 'salman23011996', 'ssy506804', 'vaibhav.gangan7', 'sawantgaurig25', 'rohinipatil404', 'siddhiambre111', 'sagarbhagat43', 'kaustubhgudekar9', 'namrata05', 'suman28pandit', 'chandraman.patil', 'rakeshmaity', 'pranay9.ithawar', 'rohanchavan', 'vaibhavgaikar62']",132,"['dalvisayli', 'niraj901', 'ektarathod786', 'khadekunal1', 'dikshabafna1995', 'kadamk008', 'omkarn049', 'sagar.pawar35418', 'ahire.monali07', 'brian200495', 'infinite2205', 'vinit95vasudevan', 'dhartinano19', 'saurabh.gharat96', 'sailee.mohite', 'suyogk.1995', 'nehah95', 'chaudharipayal50', 'dandekarmd73', 'tanayshinde123', 'sangeetamjoshi', 'mudrasjuee', 'sebastian007', 'nikhildabholkar4', 'praju.avhad', 'rakshu.gade', 'snehawaghe21', 'sid.rane95', 'sonalipawar589', 'ratsthegreat', 'oma1811', 'rahulmhapsekar7', 'sumedh_patil', 'a.j.yadav2395', 'chiragc9494', 'hbg2112', 'bhakti961', 'kumarrahul050892', 'viveky803', 'yashapeejay', 'sandeeprock023', 'manasi.shinde008', 'chaudharisuyash7', 'ru1795', 'deven199570', 'priyagajakosh1', 'aashish.yadav94', 'ambeskaradvait', 'priyankakamble', 'spranav3004', 'jatin.dhande1008', 'manalihedaoo4', 'pranilraut17', 'shivamchaube', 'sonawane.akshayak', 'spooja.1430', 'mongya00', 'dattaramkolekar', 'sagarpawar', 'nikitamalvade', 'nikhildubey02051996', 'mitesh.dangle', 'danish.dev.007', 'saylishirodkar58', 'sayalipatil4545', 'aishwaryamardhekar.24595', 'cooldudeakshu', 'snehakudtarkar315', 'komalbapna.kb', 'viprajapatil', 'aniketmane42', 'akshaybadhiye04', 'iabhishek555', 'susmitaahirrao', 'pravin45', 'tejaskanagal95', 'aniketkulaye618', 'bk357357', 'oindri.c', 'kondekar23', 'poojavagre12', 'mihirsawant17', 'adigame18', 'parmitbanga1995', 'shahyash027', 'ajthamke40', 'mishrahenry007', 'shreyashpawar96', 'abhihadshi', 'pratikkhanore95', 'srikalaprabhu', 'gidayegirish', 'gauravrajeshmehta', 'codekidx', 'pbrahmapurkar', 'vinodgadge95', 'shubhambeldar547', 'prathameshptkr4', 'saurabhmangeshkar', 'mukulsathe1995', 'priyankaingle18', 'palswati0309', 'bondreanup007', 'rohitbaliyan53', 'manishashetye1295', 'abhishek.thavare', 'sardesai.kirti18', 'amritamukeshb', 'shakyanandk', 'ramaprde2296', 'rushabh.fegade', 'ameypatil29', 'sahilshaikh827', 'vishakha1805', 'abhishekm2861996', 'dattaram.gawade781', None, 'salman23011996', 'ssy506804', 'vaibhav.gangan7', 'sawantgaurig25', 'rohinipatil404', 'siddhiambre111', 'sagarbhagat43', 'kaustubhgudekar9', 'namrata05', 'suman28pandit', 'chandraman.patil', 'rakeshmaity', 'pranay9.ithawar', 'rohanchavan', 'vaibhavgaikar62']"
158,101,6,7,2,"['yonicooper3', 'trishar']",3,"['kzanaj', 'jiejiejie', 'semiconductors321']",5,"['lbassett', 'zanajk', 'lrl11496', None, 'rohunp']",10,"['yonicooper3', 'lrl11496', 'lbassett', 'kzanaj', 'jiejiejie', 'zanajk', 'rohunp', 'trishar', None, 'semiconductors321']"
158,291,6,7,5,"['yonicooper3', 'kzanaj', 'jiejiejie', 'trishar', 'semiconductors321']",0,[],2,"['rohunp1', None]",7,"['yonicooper3', 'rohunp1', 'kzanaj', 'jiejiejie', 'trishar', None, 'semiconductors321']"
