MClusterID,XClusterID,MClusterSize,XClusterSize,OverlapSize,OverlapMembers,MOnlySize,MOnlyMembers,XOnlySize,XOnlyMembers,CombinedSize,CombinedMembers
1,306,391,80,67,"['swadhasanghvi4', 'sanidhya27', 'nishagb04', 'yojit105', 'dimplekochar3', 'pmmadhumita9', 'harsh05september', 'mustafaali12', 'lakshyakumarsingh', 'akashminato1', 'himanshuaswani123', 'kritikamna23', 'sudhiriitb', 'hegdeananthar', 'ksselhi', 'sucheta317', 'jitendraiitb', 'narendrarai1812', 'bagrania385', 'khandelwalsanyam87', 'neharikajali', 'devanshu', 'rashmiravindranath', 'shashiadi', 'anshulvermaiitb', 'shauryasindhu', 'ajitzote', 'arbaz', 'aspruha.samal', 'sethabhinav89', 'navnitkumar1224', 'nemadepsn', 'sahilkumar1900', 'bhuyashi.deka', 'neildalal', 'archiki', 'pratyushragini', 'shubhangb97', 'saarthak', 'akashmunda12345', 'qwerty56', 'kaki.krish15', 'pandeykratvesh', 'ak83229', 'aniketbhatia2107', 'rishikkumar18', 'singhalanirudh18', 'apoorv0', 'ishitadas1998', 'anirudh.singhal', 'vineetkotariya', 'ghanshyam.iitb', 'snjkhatri34', 'anonymousbuggy', 'abhikanse', 'aniketsl', 'kumaradarsh', 'neeraj.chimankar', 'vivekkandeyang97', '16d070026', 'kumar_ashutosh', 'ydidwania', 'tanmaypatil1598', 'navoj98', 'max2aneeb', 'pirojiwalasubham', 'acrylonitrile']",324,"['hasanaltintas', 'remsatkan', 'hakan_bicer_96', 'yagaat.smellypitts', 'trinath', 'brekgungor', 'music20011', 'jajung89', 'ozlemsila1', 'shaimaamohamed61195', 'ezgibicak', 'nuri', 'salma_hesham', 'abduljalilahmed94', 'covarrubiasjaz05', 'ozlemkrms', 'mhyavuz', 'erenkeskin95', 'chingyinglu89', 'woooney', 'ahmetkaangecer', 'aldoalcantara1', 'arthurxavier.engineer', 'zoz', 'joelrc', 'kbkadir', 'mguillen6', 'mohamed3ssam', 'b10104023', 'kzm_dmrlnk', 'senaydogn26', 'kemreakkas', 'ali.solak.1996', 'aliercn964', 'julio_c1712', 'alshareefabdulmajeed', 'austinsams', 'mark.hogg131', 'denizcango', 'ahmetdemir', 'eng.walaagomaaali', 'ps5014', 'perihansherif', 'groever', 'hsncnyhn', 'michaelconnors', 'caner.baydan', 'jhorton19', 'ahmed_devices', 'highlander2475', 'louiscolson', 'hakanburakbalamir1', 'aavasquez2', 'drhodges', 'eggacher', 'ryanwood98', 'tugay95', 'bhu01', 'ccheng852', 'simingma', 'phili180296', 'beraatyigit26', 'mattchuaruiyan', 'areeba123', 'dskartal16', 'feruiz2', 'silicongo7', 'mjmartinez283', 'kewang.ritsumei', 'shangdi1214', 'ezgii0088', 'amira123', 'mwong', 'yarenturker12', 'shaynesmq', 'jazzminesaif66', 'luisggranadost98', 'coolzach999', 'cngzbdr', 'ayesharashid', 'ssdominguez', 'ingrammyles8', 'gunny.balakrishnan', 'mohamedabdelsalam', 'kubraciloglu', 'manar.ibraheem', 'makyz', 'terryyouknow988', 'acostadavid', 'daliahalmy', 'th3prince', 'esraaahmedabdelaal', 'menginaslan', 'tlordello', 'mustafaenesgner', 'liubenliang', 'baranoncul', 'shashankti111', 'avinashkmry', 'deraz96', 'alejandro.juvera', 'yassinmahdy', 'saisireesha', 'nado.mahmoud1995', 'fvasquez6', 'wdang', 'hatem.rashwany', 'fang59', 'z.a.guzzardo', 'mcsalasnava', 'jesus_aguirre2000', 'timothyobrien', 'safelix', 'yusuf61', 'caranfatma', 'nourhangamal', 'allisontsay', 'omar.handy.96', 'abdurrahmanonuraydin', 'aesanchez6', 'noel19419', 'rz2405', 'mrryzen', 'calebringkob', 'anaselsabagh', 'mgthway', 'mehmetdayioglu', 'duenes957', 'mrinalrao1810', 'osmancanylmz1996', 'liuyuan', 'niamhmulholland', 'hobuobi', 'mauriciofalleiros', 'axsalomon', 'annasp', 'gonzalez.gaston', 'mayur777', 'resuliseri', 'bekirisgor', 'yerenayas', 'mertsen96', 'dirodriguez4', 'zeyneb', 'darivera3', 'dohaga95', 'elpaglia', 'enesbas', 'halil26', 'ismailkemal', 'zzhanghuang', 'karimaboelmakarem', 'elijahbarrett22', 'manny2750', 'abdelrahmanahmedabdelghany', 'demetguull', 'emirhan', 'afrahm104', 'virtuspro', 'yukseltugba14', 'jafar.vafaee', 'raaul.09', 'wassupyo412', 'mrtypc1539', 'mmoody.cma', 'aymanbakr1984.1', 'shiz', 'yigitcilce', 'emilyirisdahl', 'byminc', 'jmclean', 'janmol', 'jasmine1323', 'korhan', 'ahmed.r.elhanafy', 'rapacheco', 'nagidal146', 'joeeesalah', 'kirbye1101', 'mdj', 'snnnnnnnnnnnn', 'ozgeozdamarr', 'vishwas1020', 'ahmedsayedeng1', 'ahmetsurucu', 'maged7423', 'eltonlossner', 'srycvk26', 'apoorvaudikeri', 'danielgetega', 'skucukarabaci', 'adam.kwiatkowski', 'mb141', 'mwood', 'nanomelis1996', 'marcusle', 'camakk', 'revez_tmr', 'ibrahimethemtemel', 'saboueleinen', 'betkahraman', 'mohamedabdelmaksoud1096', 'ayane123', 'cigo', 'esraa7725334', 'saqibalisidd', 'feyzas26', 'steve.meraz', 'moises.navarro0423', 'glenpyeldho', 'guray.izmir95', 'dmertkeskin', 'abdelrahman_magdy', 'lovelyever17', 'love465944', 'belmaci', 'violantium5', 'edlucero25', 'rsalgado19', 'zzhiye', 'dm94', 'gparra3', 'nicolekf', 'bahadirsonmezisik', 'tugcemekci', 'melikekorkmaz94', 'wdoeme93', 'cahidpolat', 'djcastillo', 'ehealey', 'bugrahansoylu', 'x.ganerdene', 'cacortespliego', 'abdullahaksoy26', 'asrivastava98', 'ibraheemgalal7', 'menaalfread', 'abeischaos', 'ruohanjiang7', 'marissasaenger', 'mohammed123', 'hakanburakbalamir', 'monicaadelfahim', 'muratkoc503', 'rodriguez.joaquin.jesus', 'gabatres', 'mahe19851117', 'serhatgn', 'yaoweixie', 'havanbhavsar03', 'hasibeodak', 'shikhar1799', 'charanadipudi', 'ealvarez44', 'manarnegm', 'uygarelmali', 'mail.d', 'sukruardali', 'gao401', 'eslamamr', 'aydinturkkan44', 'saqibali', 'aengingokce', 'ahmed_moustafa_94', 'burcuakts', 'jacobmeyerson', 'mernaosama40', 'kasapreyizz', 'gunesa96', 'eng.baristatar', 'siber', 'aimenevse', 'beratcandan', 'bilginper24', 'cshwethanayak', 'rekharavindrar', 'mrmamos31', 'methemfaik', 'timobrien', 'nora171296', 'sezerguven', 'refiktuzakli', 'betildiz', 'jajurado3', 'nagranados', 'makala.bailey', 'bilgesukaymaz', 'haydartaskaya', 'mehmetock777', 'mbrk747', 'liamfitzgerald', 'keszler', 'havich', 'seg915ept', 'jblopez2', 'shehab', 'ibrahimyararoglu', 'riosdaniel2014', 'gokay.yilmaz', 'roy.mustang.eb', 'minatarek', 'ryckmonster', 'ccamarillo6732', 'hazalciftcioglu94', 'fdirisaglik', 'rabin401', 'abdorady', 'djcruz', 'nadakoga', 'sandor.one', 'juliadavis19', 'ewoudvissers', 'jsproviero', 'mguillen7', 'johnrahill1', 'mustafaozic42', 'rushib97', 'ethwong', 'brsyldrn', 'ahmed.star2025', 'iaaguilera', 'tskroezen', 'sven.siegmund', 'gizemuysal']",13,"['devesh1102', 'arishinam123', None, 'guptasheetal436', 'keshariaayesha', 'sudhanshum2014', 'nilesh8', 'ishank', 'anilk', 'prnair', 'gb42', 'ghanshyam.techfest', '28dhruv.varshney']",404,"['hasanaltintas', 'remsatkan', 'hakan_bicer_96', 'yagaat.smellypitts', 'kritikamna23', 'trinath', 'brekgungor', 'music20011', 'jajung89', 'ozlemsila1', 'shaimaamohamed61195', 'ezgibicak', 'nuri', 'neharikajali', 'nilesh8', 'salma_hesham', 'abduljalilahmed94', 'covarrubiasjaz05', 'ozlemkrms', 'mhyavuz', 'erenkeskin95', 'chingyinglu89', 'arishinam123', 'woooney', 'ahmetkaangecer', 'aldoalcantara1', 'arthurxavier.engineer', 'zoz', 'joelrc', 'kbkadir', 'mguillen6', 'aniketbhatia2107', 'mohamed3ssam', 'b10104023', 'singhalanirudh18', 'kzm_dmrlnk', 'senaydogn26', 'kemreakkas', 'ali.solak.1996', 'aliercn964', 'julio_c1712', 'alshareefabdulmajeed', 'austinsams', 'mark.hogg131', 'pirojiwalasubham', 'denizcango', 'ahmetdemir', 'acrylonitrile', 'eng.walaagomaaali', 'yojit105', 'ps5014', 'perihansherif', 'harsh05september', 'groever', 'hsncnyhn', 'akashminato1', 'sudhiriitb', 'michaelconnors', 'caner.baydan', 'jhorton19', 'ahmed_devices', 'highlander2475', 'louiscolson', 'hakanburakbalamir1', 'aavasquez2', 'drhodges', 'shashiadi', 'eggacher', 'ryanwood98', 'tugay95', 'bhu01', 'nemadepsn', 'ccheng852', 'simingma', 'phili180296', 'beraatyigit26', 'mattchuaruiyan', 'areeba123', 'dskartal16', 'neildalal', 'feruiz2', 'silicongo7', 'mjmartinez283', 'shubhangb97', 'kewang.ritsumei', 'ghanshyam.techfest', 'shangdi1214', 'ezgii0088', 'amira123', 'abhikanse', 'mwong', 'yarenturker12', 'shaynesmq', 'kumar_ashutosh', 'jazzminesaif66', 'luisggranadost98', 'coolzach999', 'sanidhya27', 'cngzbdr', 'ayesharashid', 'ssdominguez', 'ingrammyles8', 'gunny.balakrishnan', 'mohamedabdelsalam', 'kubraciloglu', 'manar.ibraheem', 'ishank', 'makyz', 'terryyouknow988', 'acostadavid', 'daliahalmy', 'th3prince', 'esraaahmedabdelaal', 'menginaslan', 'tlordello', 'guptasheetal436', 'mustafaenesgner', 'liubenliang', 'khandelwalsanyam87', 'baranoncul', 'shashankti111', 'avinashkmry', 'deraz96', 'alejandro.juvera', 'yassinmahdy', 'saisireesha', 'nado.mahmoud1995', 'fvasquez6', 'wdang', 'gb42', 'hatem.rashwany', 'fang59', 'z.a.guzzardo', 'mcsalasnava', 'jesus_aguirre2000', 'timothyobrien', 'safelix', 'yusuf61', 'caranfatma', 'nourhangamal', 'allisontsay', 'omar.handy.96', 'ak83229', 'anonymousbuggy', 'abdurrahmanonuraydin', 'snjkhatri34', 'aesanchez6', 'vivekkandeyang97', 'noel19419', 'ydidwania', 'rz2405', 'mrryzen', 'nishagb04', 'calebringkob', 'anaselsabagh', 'mgthway', 'mustafaali12', 'mehmetdayioglu', 'lakshyakumarsingh', 'duenes957', 'mrinalrao1810', 'osmancanylmz1996', 'liuyuan', 'niamhmulholland', 'hobuobi', 'keshariaayesha', 'mauriciofalleiros', 'narendrarai1812', 'axsalomon', 'annasp', 'gonzalez.gaston', 'mayur777', 'resuliseri', 'bekirisgor', 'yerenayas', 'mertsen96', 'dirodriguez4', 'zeyneb', 'darivera3', 'dohaga95', 'elpaglia', 'saarthak', 'enesbas', 'halil26', 'ismailkemal', 'zzhanghuang', 'prnair', 'karimaboelmakarem', 'elijahbarrett22', 'ghanshyam.iitb', 'manny2750', 'sudhanshum2014', 'abdelrahmanahmedabdelghany', 'demetguull', 'emirhan', 'afrahm104', 'virtuspro', 'yukseltugba14', 'jafar.vafaee', 'swadhasanghvi4', 'raaul.09', 'wassupyo412', 'mrtypc1539', 'mmoody.cma', 'aymanbakr1984.1', 'shiz', 'yigitcilce', 'emilyirisdahl', 'byminc', 'jmclean', 'janmol', 'jasmine1323', 'korhan', 'ahmed.r.elhanafy', 'rapacheco', 'nagidal146', 'bagrania385', 'joeeesalah', 'kirbye1101', 'rashmiravindranath', 'mdj', 'snnnnnnnnnnnn', 'ozgeozdamarr', 'vishwas1020', 'ajitzote', 'ahmedsayedeng1', 'ahmetsurucu', 'maged7423', 'eltonlossner', 'archiki', 'srycvk26', 'anilk', 'akashmunda12345', 'apoorvaudikeri', 'danielgetega', 'skucukarabaci', 'adam.kwiatkowski', 'mb141', 'mwood', 'nanomelis1996', 'marcusle', 'camakk', 'revez_tmr', '16d070026', 'ibrahimethemtemel', 'saboueleinen', 'betkahraman', 'devesh1102', 'mohamedabdelmaksoud1096', 'ayane123', 'cigo', 'pmmadhumita9', 'esraa7725334', 'saqibalisidd', 'feyzas26', 'ksselhi', 'steve.meraz', 'moises.navarro0423', 'glenpyeldho', 'guray.izmir95', 'dmertkeskin', 'anshulvermaiitb', 'aspruha.samal', 'sethabhinav89', 'abdelrahman_magdy', 'lovelyever17', 'love465944', 'sahilkumar1900', 'bhuyashi.deka', 'belmaci', 'violantium5', 'edlucero25', 'rsalgado19', 'zzhiye', 'dm94', 'gparra3', 'nicolekf', 'bahadirsonmezisik', 'tugcemekci', 'melikekorkmaz94', 'kaki.krish15', None, 'wdoeme93', 'cahidpolat', 'djcastillo', 'ehealey', 'ishitadas1998', 'bugrahansoylu', 'x.ganerdene', 'cacortespliego', 'abdullahaksoy26', 'asrivastava98', 'apoorv0', 'anirudh.singhal', 'ibraheemgalal7', 'menaalfread', 'abeischaos', 'ruohanjiang7', 'marissasaenger', 'mohammed123', 'hakanburakbalamir', 'monicaadelfahim', 'muratkoc503', 'rodriguez.joaquin.jesus', 'gabatres', 'mahe19851117', 'serhatgn', 'yaoweixie', 'havanbhavsar03', 'hasibeodak', 'shikhar1799', 'charanadipudi', 'ealvarez44', 'manarnegm', 'uygarelmali', 'hegdeananthar', 'jitendraiitb', 'mail.d', 'sukruardali', 'gao401', 'eslamamr', 'aydinturkkan44', 'saqibali', 'aengingokce', 'ahmed_moustafa_94', 'burcuakts', 'arbaz', 'jacobmeyerson', 'mernaosama40', 'kasapreyizz', 'gunesa96', 'eng.baristatar', 'siber', 'aimenevse', 'beratcandan', 'bilginper24', 'cshwethanayak', 'pandeykratvesh', '28dhruv.varshney', 'rekharavindrar', 'mrmamos31', 'methemfaik', 'timobrien', 'nora171296', 'vineetkotariya', 'sezerguven', 'refiktuzakli', 'betildiz', 'jajurado3', 'kumaradarsh', 'nagranados', 'makala.bailey', 'bilgesukaymaz', 'neeraj.chimankar', 'tanmaypatil1598', 'haydartaskaya', 'mehmetock777', 'mbrk747', 'liamfitzgerald', 'dimplekochar3', 'keszler', 'havich', 'himanshuaswani123', 'seg915ept', 'sucheta317', 'jblopez2', 'shehab', 'ibrahimyararoglu', 'riosdaniel2014', 'devanshu', 'gokay.yilmaz', 'roy.mustang.eb', 'minatarek', 'ryckmonster', 'shauryasindhu', 'ccamarillo6732', 'hazalciftcioglu94', 'fdirisaglik', 'navnitkumar1224', 'rabin401', 'abdorady', 'djcruz', 'nadakoga', 'sandor.one', 'juliadavis19', 'pratyushragini', 'ewoudvissers', 'qwerty56', 'jsproviero', 'mguillen7', 'johnrahill1', 'rishikkumar18', 'mustafaozic42', 'rushib97', 'ethwong', 'brsyldrn', 'ahmed.star2025', 'iaaguilera', 'tskroezen', 'aniketsl', 'sven.siegmund', 'max2aneeb', 'navoj98', 'gizemuysal']"
1,34,391,54,5,"['abdorady', 'mernaosama40', 'mohamedabdelmaksoud1096', 'perihansherif', 'nourhangamal']",386,"['hasanaltintas', 'remsatkan', 'hakan_bicer_96', 'yagaat.smellypitts', 'kritikamna23', 'trinath', 'brekgungor', 'music20011', 'jajung89', 'ozlemsila1', 'shaimaamohamed61195', 'ezgibicak', 'nuri', 'neharikajali', 'salma_hesham', 'abduljalilahmed94', 'covarrubiasjaz05', 'ozlemkrms', 'mhyavuz', 'erenkeskin95', 'chingyinglu89', 'woooney', 'ahmetkaangecer', 'aldoalcantara1', 'arthurxavier.engineer', 'zoz', 'joelrc', 'kbkadir', 'mguillen6', 'aniketbhatia2107', 'mohamed3ssam', 'b10104023', 'singhalanirudh18', 'kzm_dmrlnk', 'senaydogn26', 'kemreakkas', 'ali.solak.1996', 'aliercn964', 'julio_c1712', 'alshareefabdulmajeed', 'austinsams', 'mark.hogg131', 'pirojiwalasubham', 'denizcango', 'ahmetdemir', 'acrylonitrile', 'eng.walaagomaaali', 'yojit105', 'ps5014', 'harsh05september', 'groever', 'hsncnyhn', 'akashminato1', 'sudhiriitb', 'michaelconnors', 'caner.baydan', 'jhorton19', 'ahmed_devices', 'highlander2475', 'louiscolson', 'hakanburakbalamir1', 'aavasquez2', 'drhodges', 'shashiadi', 'eggacher', 'ryanwood98', 'tugay95', 'bhu01', 'nemadepsn', 'ccheng852', 'simingma', 'phili180296', 'beraatyigit26', 'mattchuaruiyan', 'areeba123', 'dskartal16', 'neildalal', 'feruiz2', 'silicongo7', 'mjmartinez283', 'shubhangb97', 'kewang.ritsumei', 'shangdi1214', 'ezgii0088', 'amira123', 'abhikanse', 'mwong', 'yarenturker12', 'shaynesmq', 'kumar_ashutosh', 'jazzminesaif66', 'luisggranadost98', 'coolzach999', 'sanidhya27', 'cngzbdr', 'ayesharashid', 'ssdominguez', 'ingrammyles8', 'gunny.balakrishnan', 'mohamedabdelsalam', 'kubraciloglu', 'manar.ibraheem', 'makyz', 'terryyouknow988', 'acostadavid', 'daliahalmy', 'th3prince', 'esraaahmedabdelaal', 'menginaslan', 'tlordello', 'mustafaenesgner', 'liubenliang', 'khandelwalsanyam87', 'baranoncul', 'shashankti111', 'avinashkmry', 'deraz96', 'alejandro.juvera', 'yassinmahdy', 'saisireesha', 'nado.mahmoud1995', 'fvasquez6', 'wdang', 'hatem.rashwany', 'fang59', 'z.a.guzzardo', 'mcsalasnava', 'jesus_aguirre2000', 'timothyobrien', 'safelix', 'yusuf61', 'caranfatma', 'allisontsay', 'omar.handy.96', 'ak83229', 'anonymousbuggy', 'abdurrahmanonuraydin', 'snjkhatri34', 'aesanchez6', 'vivekkandeyang97', 'noel19419', 'ydidwania', 'rz2405', 'mrryzen', 'nishagb04', 'calebringkob', 'anaselsabagh', 'mgthway', 'mustafaali12', 'mehmetdayioglu', 'lakshyakumarsingh', 'duenes957', 'mrinalrao1810', 'osmancanylmz1996', 'liuyuan', 'niamhmulholland', 'hobuobi', 'mauriciofalleiros', 'narendrarai1812', 'axsalomon', 'annasp', 'gonzalez.gaston', 'mayur777', 'resuliseri', 'bekirisgor', 'yerenayas', 'mertsen96', 'dirodriguez4', 'zeyneb', 'darivera3', 'dohaga95', 'elpaglia', 'saarthak', 'enesbas', 'halil26', 'ismailkemal', 'zzhanghuang', 'karimaboelmakarem', 'elijahbarrett22', 'ghanshyam.iitb', 'manny2750', 'abdelrahmanahmedabdelghany', 'demetguull', 'emirhan', 'afrahm104', 'virtuspro', 'yukseltugba14', 'jafar.vafaee', 'swadhasanghvi4', 'raaul.09', 'wassupyo412', 'mrtypc1539', 'mmoody.cma', 'aymanbakr1984.1', 'shiz', 'yigitcilce', 'emilyirisdahl', 'byminc', 'jmclean', 'janmol', 'jasmine1323', 'korhan', 'ahmed.r.elhanafy', 'rapacheco', 'nagidal146', 'bagrania385', 'joeeesalah', 'kirbye1101', 'rashmiravindranath', 'mdj', 'snnnnnnnnnnnn', 'ozgeozdamarr', 'vishwas1020', 'ajitzote', 'ahmedsayedeng1', 'ahmetsurucu', 'maged7423', 'eltonlossner', 'archiki', 'srycvk26', 'akashmunda12345', 'apoorvaudikeri', 'danielgetega', 'skucukarabaci', 'adam.kwiatkowski', 'mb141', 'mwood', 'nanomelis1996', 'marcusle', 'camakk', 'revez_tmr', '16d070026', 'ibrahimethemtemel', 'saboueleinen', 'betkahraman', 'ayane123', 'cigo', 'pmmadhumita9', 'esraa7725334', 'saqibalisidd', 'feyzas26', 'ksselhi', 'steve.meraz', 'moises.navarro0423', 'glenpyeldho', 'guray.izmir95', 'dmertkeskin', 'anshulvermaiitb', 'aspruha.samal', 'sethabhinav89', 'abdelrahman_magdy', 'lovelyever17', 'love465944', 'sahilkumar1900', 'bhuyashi.deka', 'belmaci', 'violantium5', 'edlucero25', 'rsalgado19', 'zzhiye', 'dm94', 'gparra3', 'nicolekf', 'bahadirsonmezisik', 'tugcemekci', 'melikekorkmaz94', 'kaki.krish15', 'wdoeme93', 'cahidpolat', 'djcastillo', 'ehealey', 'ishitadas1998', 'bugrahansoylu', 'x.ganerdene', 'cacortespliego', 'abdullahaksoy26', 'asrivastava98', 'apoorv0', 'anirudh.singhal', 'ibraheemgalal7', 'menaalfread', 'abeischaos', 'ruohanjiang7', 'marissasaenger', 'mohammed123', 'hakanburakbalamir', 'monicaadelfahim', 'muratkoc503', 'rodriguez.joaquin.jesus', 'gabatres', 'mahe19851117', 'serhatgn', 'yaoweixie', 'havanbhavsar03', 'hasibeodak', 'shikhar1799', 'charanadipudi', 'ealvarez44', 'manarnegm', 'uygarelmali', 'hegdeananthar', 'jitendraiitb', 'mail.d', 'sukruardali', 'gao401', 'eslamamr', 'aydinturkkan44', 'saqibali', 'aengingokce', 'ahmed_moustafa_94', 'burcuakts', 'arbaz', 'jacobmeyerson', 'kasapreyizz', 'gunesa96', 'eng.baristatar', 'siber', 'aimenevse', 'beratcandan', 'bilginper24', 'cshwethanayak', 'pandeykratvesh', 'rekharavindrar', 'mrmamos31', 'methemfaik', 'timobrien', 'nora171296', 'vineetkotariya', 'sezerguven', 'refiktuzakli', 'betildiz', 'jajurado3', 'kumaradarsh', 'nagranados', 'makala.bailey', 'bilgesukaymaz', 'neeraj.chimankar', 'tanmaypatil1598', 'haydartaskaya', 'mehmetock777', 'mbrk747', 'liamfitzgerald', 'dimplekochar3', 'keszler', 'havich', 'himanshuaswani123', 'seg915ept', 'sucheta317', 'jblopez2', 'shehab', 'ibrahimyararoglu', 'riosdaniel2014', 'devanshu', 'gokay.yilmaz', 'roy.mustang.eb', 'minatarek', 'ryckmonster', 'shauryasindhu', 'ccamarillo6732', 'hazalciftcioglu94', 'fdirisaglik', 'navnitkumar1224', 'rabin401', 'djcruz', 'nadakoga', 'sandor.one', 'juliadavis19', 'pratyushragini', 'ewoudvissers', 'qwerty56', 'jsproviero', 'mguillen7', 'johnrahill1', 'rishikkumar18', 'mustafaozic42', 'rushib97', 'ethwong', 'brsyldrn', 'ahmed.star2025', 'iaaguilera', 'tskroezen', 'aniketsl', 'sven.siegmund', 'max2aneeb', 'navoj98', 'gizemuysal']",49,"['rehamkandel', 'karimelmeligy', 'youstinamamdouh', 'shrouk_mahmoud', 'mahmoudtarek313', 'mostafanazim1', 'ahmedreda0', 'jljhgjvlm', 'shimaaezz149', 'yumnafmoussa', 'yehia', 'sararadwan', 'ranaahmed96', 'passantali', 'jailanosamaa', 'mosa_nosa', 'shimaaezz1495', 'fatma_aly2010', 'yaraahmeed7777', 'sara.saso9686', 'yehiafarouk.asurt', 'abdo1703', 'esraaezzzz', 'abdelrhman', 'mahmoudtarak51', 'hadilmazen10', 'menna_sarhan97', 'monmon', 'yehiaafaroukk', 'mustafa.maged95', 'hager.mostafa14.ah', 'mostafasami1996', 'mustafamagdy2020', 'youstina1996mamdouh', 'ahmedashrafalaaser', 'tyo78790', None, 'sara_khaled1997', 'karim.tera1', 'sandy_sameh', 'abdelrahmanmagdy2022', 'manarahmeed', 'habib1996', 'mohamedtarek.mt450', 'nada_y', 'youssefemad', 'abdelrahmanelmy96', 'mnorhan1997', 'wa7sh19962013']",440,"['rehamkandel', 'hasanaltintas', 'remsatkan', 'hakan_bicer_96', 'yagaat.smellypitts', 'kritikamna23', 'trinath', 'brekgungor', 'music20011', 'jajung89', 'ozlemsila1', 'shimaaezz149', 'sararadwan', 'shaimaamohamed61195', 'ezgibicak', 'nuri', 'neharikajali', 'salma_hesham', 'abduljalilahmed94', 'covarrubiasjaz05', 'ozlemkrms', 'mhyavuz', 'erenkeskin95', 'chingyinglu89', 'woooney', 'yehiaafaroukk', 'ahmetkaangecer', 'aldoalcantara1', 'mustafamagdy2020', 'arthurxavier.engineer', 'zoz', 'joelrc', 'kbkadir', 'mguillen6', 'aniketbhatia2107', 'mohamed3ssam', 'b10104023', 'singhalanirudh18', 'kzm_dmrlnk', 'senaydogn26', 'kemreakkas', 'ali.solak.1996', 'aliercn964', 'julio_c1712', 'alshareefabdulmajeed', 'austinsams', 'mark.hogg131', 'abdelrahmanelmy96', 'pirojiwalasubham', 'denizcango', 'ahmetdemir', 'acrylonitrile', 'eng.walaagomaaali', 'yojit105', 'ps5014', 'perihansherif', 'harsh05september', 'groever', 'shrouk_mahmoud', 'hsncnyhn', 'mahmoudtarek313', 'akashminato1', 'sudhiriitb', 'michaelconnors', 'caner.baydan', 'jhorton19', 'ahmed_devices', 'highlander2475', 'yehia', 'louiscolson', 'yumnafmoussa', 'hakanburakbalamir1', 'aavasquez2', 'drhodges', 'shashiadi', 'eggacher', 'ryanwood98', 'tugay95', 'bhu01', 'nemadepsn', 'ccheng852', 'simingma', 'phili180296', 'beraatyigit26', 'mattchuaruiyan', 'areeba123', 'dskartal16', 'neildalal', 'feruiz2', 'silicongo7', 'mustafa.maged95', 'mjmartinez283', 'shubhangb97', 'kewang.ritsumei', 'ahmedashrafalaaser', 'shangdi1214', 'ezgii0088', 'amira123', 'abhikanse', 'mwong', 'habib1996', 'yarenturker12', 'shaynesmq', 'kumar_ashutosh', 'jazzminesaif66', 'luisggranadost98', 'coolzach999', 'sanidhya27', 'cngzbdr', 'ayesharashid', 'ssdominguez', 'ingrammyles8', 'gunny.balakrishnan', 'mohamedabdelsalam', 'kubraciloglu', 'mostafanazim1', 'manar.ibraheem', 'ahmedreda0', 'makyz', 'terryyouknow988', 'acostadavid', 'daliahalmy', 'th3prince', 'esraaahmedabdelaal', 'menginaslan', 'tlordello', 'mustafaenesgner', 'liubenliang', 'passantali', 'khandelwalsanyam87', 'baranoncul', 'shashankti111', 'avinashkmry', 'deraz96', 'mosa_nosa', 'shimaaezz1495', 'alejandro.juvera', 'yassinmahdy', 'saisireesha', 'nado.mahmoud1995', 'fvasquez6', 'wdang', 'hatem.rashwany', 'fang59', 'z.a.guzzardo', 'mcsalasnava', 'jesus_aguirre2000', 'timothyobrien', 'safelix', 'yusuf61', 'hager.mostafa14.ah', 'caranfatma', 'nourhangamal', 'allisontsay', 'omar.handy.96', 'ak83229', 'anonymousbuggy', 'abdurrahmanonuraydin', 'snjkhatri34', 'aesanchez6', 'youssefemad', 'vivekkandeyang97', 'noel19419', 'ydidwania', 'rz2405', 'mnorhan1997', 'mrryzen', 'nishagb04', 'calebringkob', 'anaselsabagh', 'mgthway', 'mustafaali12', 'mehmetdayioglu', 'lakshyakumarsingh', 'duenes957', 'mrinalrao1810', 'osmancanylmz1996', 'jljhgjvlm', 'liuyuan', 'niamhmulholland', 'hobuobi', 'ranaahmed96', 'mauriciofalleiros', 'narendrarai1812', 'axsalomon', 'annasp', 'gonzalez.gaston', 'mayur777', 'resuliseri', 'bekirisgor', 'yerenayas', 'mertsen96', 'dirodriguez4', 'zeyneb', 'darivera3', 'hadilmazen10', 'dohaga95', 'elpaglia', 'saarthak', 'enesbas', 'halil26', 'ismailkemal', 'zzhanghuang', 'karimaboelmakarem', 'elijahbarrett22', 'ghanshyam.iitb', 'manny2750', 'karim.tera1', 'abdelrahmanahmedabdelghany', 'nada_y', 'demetguull', 'emirhan', 'afrahm104', 'virtuspro', 'yukseltugba14', 'jafar.vafaee', 'swadhasanghvi4', 'raaul.09', 'wassupyo412', 'mrtypc1539', 'mmoody.cma', 'aymanbakr1984.1', 'shiz', 'yigitcilce', 'emilyirisdahl', 'byminc', 'jmclean', 'janmol', 'jasmine1323', 'korhan', 'ahmed.r.elhanafy', 'rapacheco', 'nagidal146', 'bagrania385', 'joeeesalah', 'kirbye1101', 'yaraahmeed7777', 'rashmiravindranath', 'mdj', 'snnnnnnnnnnnn', 'ozgeozdamarr', 'yehiafarouk.asurt', 'esraaezzzz', 'vishwas1020', 'ajitzote', 'ahmedsayedeng1', 'mahmoudtarak51', 'ahmetsurucu', 'maged7423', 'eltonlossner', 'monmon', 'archiki', 'srycvk26', 'akashmunda12345', 'apoorvaudikeri', 'danielgetega', 'skucukarabaci', 'adam.kwiatkowski', 'mb141', 'mwood', 'nanomelis1996', 'marcusle', 'sandy_sameh', 'camakk', 'revez_tmr', '16d070026', 'ibrahimethemtemel', 'saboueleinen', 'betkahraman', 'karimelmeligy', 'mohamedabdelmaksoud1096', 'ayane123', 'cigo', 'pmmadhumita9', 'esraa7725334', 'saqibalisidd', 'feyzas26', 'ksselhi', 'steve.meraz', 'moises.navarro0423', 'fatma_aly2010', 'glenpyeldho', 'guray.izmir95', 'dmertkeskin', 'anshulvermaiitb', 'aspruha.samal', 'sethabhinav89', 'abdelrahman_magdy', 'lovelyever17', 'love465944', 'sahilkumar1900', 'bhuyashi.deka', 'menna_sarhan97', 'belmaci', 'violantium5', 'edlucero25', 'rsalgado19', 'zzhiye', 'dm94', 'gparra3', 'nicolekf', 'bahadirsonmezisik', 'tugcemekci', 'melikekorkmaz94', 'kaki.krish15', 'youstina1996mamdouh', None, 'wdoeme93', 'cahidpolat', 'djcastillo', 'ehealey', 'ishitadas1998', 'bugrahansoylu', 'x.ganerdene', 'cacortespliego', 'abdullahaksoy26', 'asrivastava98', 'apoorv0', 'anirudh.singhal', 'ibraheemgalal7', 'menaalfread', 'abeischaos', 'sara_khaled1997', 'abdelrahmanmagdy2022', 'mohamedtarek.mt450', 'ruohanjiang7', 'marissasaenger', 'mohammed123', 'hakanburakbalamir', 'monicaadelfahim', 'muratkoc503', 'rodriguez.joaquin.jesus', 'gabatres', 'mahe19851117', 'serhatgn', 'yaoweixie', 'havanbhavsar03', 'hasibeodak', 'shikhar1799', 'charanadipudi', 'ealvarez44', 'manarnegm', 'uygarelmali', 'hegdeananthar', 'jitendraiitb', 'mail.d', 'sukruardali', 'gao401', 'eslamamr', 'aydinturkkan44', 'saqibali', 'aengingokce', 'sara.saso9686', 'ahmed_moustafa_94', 'abdo1703', 'burcuakts', 'arbaz', 'jacobmeyerson', 'abdelrhman', 'mernaosama40', 'kasapreyizz', 'gunesa96', 'eng.baristatar', 'siber', 'aimenevse', 'beratcandan', 'bilginper24', 'cshwethanayak', 'pandeykratvesh', 'tyo78790', 'rekharavindrar', 'mrmamos31', 'methemfaik', 'timobrien', 'nora171296', 'vineetkotariya', 'sezerguven', 'refiktuzakli', 'betildiz', 'jajurado3', 'kumaradarsh', 'nagranados', 'makala.bailey', 'bilgesukaymaz', 'neeraj.chimankar', 'tanmaypatil1598', 'haydartaskaya', 'mehmetock777', 'mbrk747', 'wa7sh19962013', 'liamfitzgerald', 'youstinamamdouh', 'dimplekochar3', 'keszler', 'havich', 'himanshuaswani123', 'seg915ept', 'sucheta317', 'jblopez2', 'shehab', 'ibrahimyararoglu', 'jailanosamaa', 'riosdaniel2014', 'devanshu', 'gokay.yilmaz', 'roy.mustang.eb', 'minatarek', 'ryckmonster', 'shauryasindhu', 'ccamarillo6732', 'hazalciftcioglu94', 'fdirisaglik', 'navnitkumar1224', 'rabin401', 'abdorady', 'djcruz', 'nadakoga', 'sandor.one', 'juliadavis19', 'pratyushragini', 'mostafasami1996', 'ewoudvissers', 'qwerty56', 'jsproviero', 'mguillen7', 'johnrahill1', 'rishikkumar18', 'mustafaozic42', 'rushib97', 'ethwong', 'brsyldrn', 'ahmed.star2025', 'iaaguilera', 'manarahmeed', 'tskroezen', 'aniketsl', 'sven.siegmund', 'max2aneeb', 'navoj98', 'gizemuysal']"
1,317,391,52,50,"['raaul.09', 'rodriguez.joaquin.jesus', 'mrryzen', 'gabatres', 'ssdominguez', 'havich', 'duenes957', 'acostadavid', 'ealvarez44', 'music20011', 'highlander2475', 'steve.meraz', 'jblopez2', 'axsalomon', 'rapacheco', 'moises.navarro0423', 'riosdaniel2014', 'kirbye1101', 'aavasquez2', 'fvasquez6', 'dirodriguez4', 'ccamarillo6732', 'z.a.guzzardo', 'mcsalasnava', 'djcruz', 'darivera3', 'jesus_aguirre2000', 'safelix', 'feruiz2', 'siber', 'mjmartinez283', 'rsalgado19', 'zzhiye', 'edlucero25', 'gparra3', 'arthurxavier.engineer', 'mguillen7', 'wdoeme93', 'mwood', 'cacortespliego', 'abeischaos', 'aesanchez6', 'iaaguilera', 'jajurado3', 'julio_c1712', 'alshareefabdulmajeed', 'noel19419', 'zzhanghuang', 'mohammed123', 'luisggranadost98']",341,"['hasanaltintas', 'remsatkan', 'hakan_bicer_96', 'yagaat.smellypitts', 'kritikamna23', 'trinath', 'brekgungor', 'jajung89', 'ozlemsila1', 'shaimaamohamed61195', 'ezgibicak', 'nuri', 'neharikajali', 'salma_hesham', 'abduljalilahmed94', 'covarrubiasjaz05', 'ozlemkrms', 'mhyavuz', 'erenkeskin95', 'chingyinglu89', 'woooney', 'ahmetkaangecer', 'aldoalcantara1', 'zoz', 'joelrc', 'kbkadir', 'mguillen6', 'aniketbhatia2107', 'mohamed3ssam', 'b10104023', 'singhalanirudh18', 'kzm_dmrlnk', 'senaydogn26', 'kemreakkas', 'ali.solak.1996', 'aliercn964', 'austinsams', 'mark.hogg131', 'pirojiwalasubham', 'denizcango', 'ahmetdemir', 'acrylonitrile', 'eng.walaagomaaali', 'yojit105', 'ps5014', 'perihansherif', 'harsh05september', 'groever', 'hsncnyhn', 'akashminato1', 'sudhiriitb', 'michaelconnors', 'caner.baydan', 'jhorton19', 'ahmed_devices', 'louiscolson', 'hakanburakbalamir1', 'drhodges', 'shashiadi', 'eggacher', 'ryanwood98', 'tugay95', 'bhu01', 'nemadepsn', 'ccheng852', 'simingma', 'phili180296', 'beraatyigit26', 'mattchuaruiyan', 'areeba123', 'dskartal16', 'neildalal', 'silicongo7', 'shubhangb97', 'kewang.ritsumei', 'shangdi1214', 'ezgii0088', 'amira123', 'abhikanse', 'mwong', 'yarenturker12', 'shaynesmq', 'kumar_ashutosh', 'jazzminesaif66', 'coolzach999', 'sanidhya27', 'cngzbdr', 'ayesharashid', 'ingrammyles8', 'gunny.balakrishnan', 'mohamedabdelsalam', 'kubraciloglu', 'manar.ibraheem', 'makyz', 'terryyouknow988', 'daliahalmy', 'th3prince', 'esraaahmedabdelaal', 'menginaslan', 'tlordello', 'mustafaenesgner', 'liubenliang', 'khandelwalsanyam87', 'baranoncul', 'shashankti111', 'avinashkmry', 'deraz96', 'alejandro.juvera', 'yassinmahdy', 'saisireesha', 'nado.mahmoud1995', 'wdang', 'hatem.rashwany', 'fang59', 'timothyobrien', 'yusuf61', 'caranfatma', 'nourhangamal', 'allisontsay', 'omar.handy.96', 'ak83229', 'anonymousbuggy', 'abdurrahmanonuraydin', 'snjkhatri34', 'vivekkandeyang97', 'ydidwania', 'rz2405', 'nishagb04', 'calebringkob', 'anaselsabagh', 'mgthway', 'mustafaali12', 'mehmetdayioglu', 'lakshyakumarsingh', 'mrinalrao1810', 'osmancanylmz1996', 'liuyuan', 'niamhmulholland', 'hobuobi', 'mauriciofalleiros', 'narendrarai1812', 'annasp', 'gonzalez.gaston', 'mayur777', 'resuliseri', 'bekirisgor', 'yerenayas', 'mertsen96', 'zeyneb', 'dohaga95', 'elpaglia', 'saarthak', 'enesbas', 'halil26', 'ismailkemal', 'karimaboelmakarem', 'elijahbarrett22', 'ghanshyam.iitb', 'manny2750', 'abdelrahmanahmedabdelghany', 'demetguull', 'emirhan', 'afrahm104', 'virtuspro', 'yukseltugba14', 'jafar.vafaee', 'swadhasanghvi4', 'wassupyo412', 'mrtypc1539', 'mmoody.cma', 'aymanbakr1984.1', 'shiz', 'yigitcilce', 'emilyirisdahl', 'byminc', 'jmclean', 'janmol', 'jasmine1323', 'korhan', 'ahmed.r.elhanafy', 'nagidal146', 'bagrania385', 'joeeesalah', 'rashmiravindranath', 'mdj', 'snnnnnnnnnnnn', 'ozgeozdamarr', 'vishwas1020', 'ajitzote', 'ahmedsayedeng1', 'ahmetsurucu', 'maged7423', 'eltonlossner', 'archiki', 'srycvk26', 'akashmunda12345', 'apoorvaudikeri', 'danielgetega', 'skucukarabaci', 'adam.kwiatkowski', 'mb141', 'nanomelis1996', 'marcusle', 'camakk', 'revez_tmr', '16d070026', 'ibrahimethemtemel', 'saboueleinen', 'betkahraman', 'mohamedabdelmaksoud1096', 'ayane123', 'cigo', 'pmmadhumita9', 'esraa7725334', 'saqibalisidd', 'feyzas26', 'ksselhi', 'glenpyeldho', 'guray.izmir95', 'dmertkeskin', 'anshulvermaiitb', 'aspruha.samal', 'sethabhinav89', 'abdelrahman_magdy', 'lovelyever17', 'love465944', 'sahilkumar1900', 'bhuyashi.deka', 'belmaci', 'violantium5', 'dm94', 'nicolekf', 'bahadirsonmezisik', 'tugcemekci', 'melikekorkmaz94', 'kaki.krish15', 'cahidpolat', 'djcastillo', 'ehealey', 'ishitadas1998', 'bugrahansoylu', 'x.ganerdene', 'abdullahaksoy26', 'asrivastava98', 'apoorv0', 'anirudh.singhal', 'ibraheemgalal7', 'menaalfread', 'ruohanjiang7', 'marissasaenger', 'hakanburakbalamir', 'monicaadelfahim', 'muratkoc503', 'mahe19851117', 'serhatgn', 'yaoweixie', 'havanbhavsar03', 'hasibeodak', 'shikhar1799', 'charanadipudi', 'manarnegm', 'uygarelmali', 'hegdeananthar', 'jitendraiitb', 'mail.d', 'sukruardali', 'gao401', 'eslamamr', 'aydinturkkan44', 'saqibali', 'aengingokce', 'ahmed_moustafa_94', 'burcuakts', 'arbaz', 'jacobmeyerson', 'mernaosama40', 'kasapreyizz', 'gunesa96', 'eng.baristatar', 'aimenevse', 'beratcandan', 'bilginper24', 'cshwethanayak', 'pandeykratvesh', 'rekharavindrar', 'mrmamos31', 'methemfaik', 'timobrien', 'nora171296', 'vineetkotariya', 'sezerguven', 'refiktuzakli', 'betildiz', 'kumaradarsh', 'nagranados', 'makala.bailey', 'bilgesukaymaz', 'neeraj.chimankar', 'tanmaypatil1598', 'haydartaskaya', 'mehmetock777', 'mbrk747', 'liamfitzgerald', 'dimplekochar3', 'keszler', 'himanshuaswani123', 'seg915ept', 'sucheta317', 'shehab', 'ibrahimyararoglu', 'devanshu', 'gokay.yilmaz', 'roy.mustang.eb', 'minatarek', 'ryckmonster', 'shauryasindhu', 'hazalciftcioglu94', 'fdirisaglik', 'navnitkumar1224', 'rabin401', 'abdorady', 'nadakoga', 'sandor.one', 'juliadavis19', 'pratyushragini', 'ewoudvissers', 'qwerty56', 'jsproviero', 'johnrahill1', 'rishikkumar18', 'mustafaozic42', 'rushib97', 'ethwong', 'brsyldrn', 'ahmed.star2025', 'tskroezen', 'aniketsl', 'sven.siegmund', 'max2aneeb', 'navoj98', 'gizemuysal']",2,"['sal080294', None]",393,"['hasanaltintas', 'remsatkan', 'hakan_bicer_96', 'yagaat.smellypitts', 'kritikamna23', 'trinath', 'brekgungor', 'music20011', 'jajung89', 'ozlemsila1', 'shaimaamohamed61195', 'ezgibicak', 'nuri', 'neharikajali', 'salma_hesham', 'abduljalilahmed94', 'covarrubiasjaz05', 'ozlemkrms', 'mhyavuz', 'erenkeskin95', 'chingyinglu89', 'woooney', 'ahmetkaangecer', 'aldoalcantara1', 'arthurxavier.engineer', 'zoz', 'joelrc', 'kbkadir', 'mguillen6', 'aniketbhatia2107', 'mohamed3ssam', 'b10104023', 'singhalanirudh18', 'kzm_dmrlnk', 'senaydogn26', 'kemreakkas', 'ali.solak.1996', 'aliercn964', 'julio_c1712', 'alshareefabdulmajeed', 'austinsams', 'mark.hogg131', 'pirojiwalasubham', 'denizcango', 'ahmetdemir', 'acrylonitrile', 'eng.walaagomaaali', 'yojit105', 'ps5014', 'perihansherif', 'harsh05september', 'groever', 'hsncnyhn', 'akashminato1', 'sudhiriitb', 'michaelconnors', 'caner.baydan', 'jhorton19', 'ahmed_devices', 'highlander2475', 'louiscolson', 'hakanburakbalamir1', 'aavasquez2', 'drhodges', 'shashiadi', 'eggacher', 'sal080294', 'ryanwood98', 'tugay95', 'bhu01', 'nemadepsn', 'ccheng852', 'simingma', 'phili180296', 'beraatyigit26', 'mattchuaruiyan', 'areeba123', 'dskartal16', 'neildalal', 'feruiz2', 'silicongo7', 'mjmartinez283', 'shubhangb97', 'kewang.ritsumei', 'shangdi1214', 'ezgii0088', 'amira123', 'abhikanse', 'mwong', 'yarenturker12', 'shaynesmq', 'kumar_ashutosh', 'jazzminesaif66', 'luisggranadost98', 'coolzach999', 'sanidhya27', 'cngzbdr', 'ayesharashid', 'ssdominguez', 'ingrammyles8', 'gunny.balakrishnan', 'mohamedabdelsalam', 'kubraciloglu', 'manar.ibraheem', 'makyz', 'terryyouknow988', 'acostadavid', 'daliahalmy', 'th3prince', 'esraaahmedabdelaal', 'menginaslan', 'tlordello', 'mustafaenesgner', 'liubenliang', 'khandelwalsanyam87', 'baranoncul', 'shashankti111', 'avinashkmry', 'deraz96', 'alejandro.juvera', 'yassinmahdy', 'saisireesha', 'nado.mahmoud1995', 'fvasquez6', 'wdang', 'hatem.rashwany', 'fang59', 'z.a.guzzardo', 'mcsalasnava', 'jesus_aguirre2000', 'timothyobrien', 'safelix', 'yusuf61', 'caranfatma', 'nourhangamal', 'allisontsay', 'omar.handy.96', 'ak83229', 'anonymousbuggy', 'abdurrahmanonuraydin', 'snjkhatri34', 'aesanchez6', 'vivekkandeyang97', 'noel19419', 'ydidwania', 'rz2405', 'mrryzen', 'nishagb04', 'calebringkob', 'anaselsabagh', 'mgthway', 'mustafaali12', 'mehmetdayioglu', 'lakshyakumarsingh', 'duenes957', 'mrinalrao1810', 'osmancanylmz1996', 'liuyuan', 'niamhmulholland', 'hobuobi', 'mauriciofalleiros', 'narendrarai1812', 'axsalomon', 'annasp', 'gonzalez.gaston', 'mayur777', 'resuliseri', 'bekirisgor', 'yerenayas', 'mertsen96', 'dirodriguez4', 'zeyneb', 'darivera3', 'dohaga95', 'elpaglia', 'saarthak', 'enesbas', 'halil26', 'ismailkemal', 'zzhanghuang', 'karimaboelmakarem', 'elijahbarrett22', 'ghanshyam.iitb', 'manny2750', 'abdelrahmanahmedabdelghany', 'demetguull', 'emirhan', 'afrahm104', 'virtuspro', 'yukseltugba14', 'jafar.vafaee', 'swadhasanghvi4', 'raaul.09', 'wassupyo412', 'mrtypc1539', 'mmoody.cma', 'aymanbakr1984.1', 'shiz', 'yigitcilce', 'emilyirisdahl', 'byminc', 'jmclean', 'janmol', 'jasmine1323', 'korhan', 'ahmed.r.elhanafy', 'rapacheco', 'nagidal146', 'bagrania385', 'joeeesalah', 'kirbye1101', 'rashmiravindranath', 'mdj', 'snnnnnnnnnnnn', 'ozgeozdamarr', 'vishwas1020', 'ajitzote', 'ahmedsayedeng1', 'ahmetsurucu', 'maged7423', 'eltonlossner', 'archiki', 'srycvk26', 'akashmunda12345', 'apoorvaudikeri', 'danielgetega', 'skucukarabaci', 'adam.kwiatkowski', 'mb141', 'mwood', 'nanomelis1996', 'marcusle', 'camakk', 'revez_tmr', '16d070026', 'ibrahimethemtemel', 'saboueleinen', 'betkahraman', 'mohamedabdelmaksoud1096', 'ayane123', 'cigo', 'pmmadhumita9', 'esraa7725334', 'saqibalisidd', 'feyzas26', 'ksselhi', 'steve.meraz', 'moises.navarro0423', 'glenpyeldho', 'guray.izmir95', 'dmertkeskin', 'anshulvermaiitb', 'aspruha.samal', 'sethabhinav89', 'abdelrahman_magdy', 'lovelyever17', 'love465944', 'sahilkumar1900', 'bhuyashi.deka', 'belmaci', 'violantium5', 'edlucero25', 'rsalgado19', 'zzhiye', 'dm94', 'gparra3', 'nicolekf', 'bahadirsonmezisik', 'tugcemekci', 'melikekorkmaz94', 'kaki.krish15', None, 'wdoeme93', 'cahidpolat', 'djcastillo', 'ehealey', 'ishitadas1998', 'bugrahansoylu', 'x.ganerdene', 'cacortespliego', 'abdullahaksoy26', 'asrivastava98', 'apoorv0', 'anirudh.singhal', 'ibraheemgalal7', 'menaalfread', 'abeischaos', 'ruohanjiang7', 'marissasaenger', 'mohammed123', 'hakanburakbalamir', 'monicaadelfahim', 'muratkoc503', 'rodriguez.joaquin.jesus', 'gabatres', 'mahe19851117', 'serhatgn', 'yaoweixie', 'havanbhavsar03', 'hasibeodak', 'shikhar1799', 'charanadipudi', 'ealvarez44', 'manarnegm', 'uygarelmali', 'hegdeananthar', 'jitendraiitb', 'mail.d', 'sukruardali', 'gao401', 'eslamamr', 'aydinturkkan44', 'saqibali', 'aengingokce', 'ahmed_moustafa_94', 'burcuakts', 'arbaz', 'jacobmeyerson', 'mernaosama40', 'kasapreyizz', 'gunesa96', 'eng.baristatar', 'siber', 'aimenevse', 'beratcandan', 'bilginper24', 'cshwethanayak', 'pandeykratvesh', 'rekharavindrar', 'mrmamos31', 'methemfaik', 'timobrien', 'nora171296', 'vineetkotariya', 'sezerguven', 'refiktuzakli', 'betildiz', 'jajurado3', 'kumaradarsh', 'nagranados', 'makala.bailey', 'bilgesukaymaz', 'neeraj.chimankar', 'tanmaypatil1598', 'haydartaskaya', 'mehmetock777', 'mbrk747', 'liamfitzgerald', 'dimplekochar3', 'keszler', 'havich', 'himanshuaswani123', 'seg915ept', 'sucheta317', 'jblopez2', 'shehab', 'ibrahimyararoglu', 'riosdaniel2014', 'devanshu', 'gokay.yilmaz', 'roy.mustang.eb', 'minatarek', 'ryckmonster', 'shauryasindhu', 'ccamarillo6732', 'hazalciftcioglu94', 'fdirisaglik', 'navnitkumar1224', 'rabin401', 'abdorady', 'djcruz', 'nadakoga', 'sandor.one', 'juliadavis19', 'pratyushragini', 'ewoudvissers', 'qwerty56', 'jsproviero', 'mguillen7', 'johnrahill1', 'rishikkumar18', 'mustafaozic42', 'rushib97', 'ethwong', 'brsyldrn', 'ahmed.star2025', 'iaaguilera', 'tskroezen', 'aniketsl', 'sven.siegmund', 'max2aneeb', 'navoj98', 'gizemuysal']"
1,311,391,49,47,"['cngzbdr', 'mrtypc1539', 'hsncnyhn', 'mehmetdayioglu', 'osmancanylmz1996', 'yigitcilce', 'feyzas26', 'menginaslan', 'sukruardali', 'mustafaenesgner', 'baranoncul', 'resuliseri', 'bekirisgor', 'ozgeozdamarr', 'yerenayas', 'mertsen96', 'dmertkeskin', 'fdirisaglik', 'zeyneb', 'tugay95', 'beraatyigit26', 'kasapreyizz', 'gunesa96', 'eng.baristatar', 'srycvk26', 'enesbas', 'halil26', 'ismailkemal', 'bilginper24', 'skucukarabaci', 'bahadirsonmezisik', 'kbkadir', 'mustafaozic42', 'sezerguven', 'methemfaik', 'ezgii0088', 'bugrahansoylu', 'kemreakkas', 'ali.solak.1996', 'yarenturker12', 'demetguull', 'emirhan', 'yukseltugba14', 'betkahraman', 'mbrk747', 'denizcango', 'mehmetock777']",344,"['hasanaltintas', 'remsatkan', 'hakan_bicer_96', 'yagaat.smellypitts', 'kritikamna23', 'trinath', 'brekgungor', 'music20011', 'jajung89', 'ozlemsila1', 'shaimaamohamed61195', 'ezgibicak', 'nuri', 'neharikajali', 'salma_hesham', 'abduljalilahmed94', 'covarrubiasjaz05', 'ozlemkrms', 'mhyavuz', 'erenkeskin95', 'chingyinglu89', 'woooney', 'ahmetkaangecer', 'aldoalcantara1', 'arthurxavier.engineer', 'zoz', 'joelrc', 'mguillen6', 'aniketbhatia2107', 'mohamed3ssam', 'b10104023', 'singhalanirudh18', 'kzm_dmrlnk', 'senaydogn26', 'aliercn964', 'julio_c1712', 'alshareefabdulmajeed', 'austinsams', 'mark.hogg131', 'pirojiwalasubham', 'ahmetdemir', 'acrylonitrile', 'eng.walaagomaaali', 'yojit105', 'ps5014', 'perihansherif', 'harsh05september', 'groever', 'akashminato1', 'sudhiriitb', 'michaelconnors', 'caner.baydan', 'jhorton19', 'ahmed_devices', 'highlander2475', 'louiscolson', 'hakanburakbalamir1', 'aavasquez2', 'drhodges', 'shashiadi', 'eggacher', 'ryanwood98', 'bhu01', 'nemadepsn', 'ccheng852', 'simingma', 'phili180296', 'mattchuaruiyan', 'areeba123', 'dskartal16', 'neildalal', 'feruiz2', 'silicongo7', 'mjmartinez283', 'shubhangb97', 'kewang.ritsumei', 'shangdi1214', 'amira123', 'abhikanse', 'mwong', 'shaynesmq', 'kumar_ashutosh', 'jazzminesaif66', 'luisggranadost98', 'coolzach999', 'sanidhya27', 'ayesharashid', 'ssdominguez', 'ingrammyles8', 'gunny.balakrishnan', 'mohamedabdelsalam', 'kubraciloglu', 'manar.ibraheem', 'makyz', 'terryyouknow988', 'acostadavid', 'daliahalmy', 'th3prince', 'esraaahmedabdelaal', 'tlordello', 'liubenliang', 'khandelwalsanyam87', 'shashankti111', 'avinashkmry', 'deraz96', 'alejandro.juvera', 'yassinmahdy', 'saisireesha', 'nado.mahmoud1995', 'fvasquez6', 'wdang', 'hatem.rashwany', 'fang59', 'z.a.guzzardo', 'mcsalasnava', 'jesus_aguirre2000', 'timothyobrien', 'safelix', 'yusuf61', 'caranfatma', 'nourhangamal', 'allisontsay', 'omar.handy.96', 'ak83229', 'anonymousbuggy', 'abdurrahmanonuraydin', 'snjkhatri34', 'aesanchez6', 'vivekkandeyang97', 'noel19419', 'ydidwania', 'rz2405', 'mrryzen', 'nishagb04', 'calebringkob', 'anaselsabagh', 'mgthway', 'mustafaali12', 'lakshyakumarsingh', 'duenes957', 'mrinalrao1810', 'liuyuan', 'niamhmulholland', 'hobuobi', 'mauriciofalleiros', 'narendrarai1812', 'axsalomon', 'annasp', 'gonzalez.gaston', 'mayur777', 'dirodriguez4', 'darivera3', 'dohaga95', 'elpaglia', 'saarthak', 'zzhanghuang', 'karimaboelmakarem', 'elijahbarrett22', 'ghanshyam.iitb', 'manny2750', 'abdelrahmanahmedabdelghany', 'afrahm104', 'virtuspro', 'jafar.vafaee', 'swadhasanghvi4', 'raaul.09', 'wassupyo412', 'mmoody.cma', 'aymanbakr1984.1', 'shiz', 'emilyirisdahl', 'byminc', 'jmclean', 'janmol', 'jasmine1323', 'korhan', 'ahmed.r.elhanafy', 'rapacheco', 'nagidal146', 'bagrania385', 'joeeesalah', 'kirbye1101', 'rashmiravindranath', 'mdj', 'snnnnnnnnnnnn', 'vishwas1020', 'ajitzote', 'ahmedsayedeng1', 'ahmetsurucu', 'maged7423', 'eltonlossner', 'archiki', 'akashmunda12345', 'apoorvaudikeri', 'danielgetega', 'adam.kwiatkowski', 'mb141', 'mwood', 'nanomelis1996', 'marcusle', 'camakk', 'revez_tmr', '16d070026', 'ibrahimethemtemel', 'saboueleinen', 'mohamedabdelmaksoud1096', 'ayane123', 'cigo', 'pmmadhumita9', 'esraa7725334', 'saqibalisidd', 'ksselhi', 'steve.meraz', 'moises.navarro0423', 'glenpyeldho', 'guray.izmir95', 'anshulvermaiitb', 'aspruha.samal', 'sethabhinav89', 'abdelrahman_magdy', 'lovelyever17', 'love465944', 'sahilkumar1900', 'bhuyashi.deka', 'belmaci', 'violantium5', 'edlucero25', 'rsalgado19', 'zzhiye', 'dm94', 'gparra3', 'nicolekf', 'tugcemekci', 'melikekorkmaz94', 'kaki.krish15', 'wdoeme93', 'cahidpolat', 'djcastillo', 'ehealey', 'ishitadas1998', 'x.ganerdene', 'cacortespliego', 'abdullahaksoy26', 'asrivastava98', 'apoorv0', 'anirudh.singhal', 'ibraheemgalal7', 'menaalfread', 'abeischaos', 'ruohanjiang7', 'marissasaenger', 'mohammed123', 'hakanburakbalamir', 'monicaadelfahim', 'muratkoc503', 'rodriguez.joaquin.jesus', 'gabatres', 'mahe19851117', 'serhatgn', 'yaoweixie', 'havanbhavsar03', 'hasibeodak', 'shikhar1799', 'charanadipudi', 'ealvarez44', 'manarnegm', 'uygarelmali', 'hegdeananthar', 'jitendraiitb', 'mail.d', 'gao401', 'eslamamr', 'aydinturkkan44', 'saqibali', 'aengingokce', 'ahmed_moustafa_94', 'burcuakts', 'arbaz', 'jacobmeyerson', 'mernaosama40', 'siber', 'aimenevse', 'beratcandan', 'cshwethanayak', 'pandeykratvesh', 'rekharavindrar', 'mrmamos31', 'timobrien', 'nora171296', 'vineetkotariya', 'refiktuzakli', 'betildiz', 'jajurado3', 'kumaradarsh', 'nagranados', 'makala.bailey', 'bilgesukaymaz', 'neeraj.chimankar', 'tanmaypatil1598', 'haydartaskaya', 'liamfitzgerald', 'dimplekochar3', 'keszler', 'havich', 'himanshuaswani123', 'seg915ept', 'sucheta317', 'jblopez2', 'shehab', 'ibrahimyararoglu', 'riosdaniel2014', 'devanshu', 'gokay.yilmaz', 'roy.mustang.eb', 'minatarek', 'ryckmonster', 'shauryasindhu', 'ccamarillo6732', 'hazalciftcioglu94', 'navnitkumar1224', 'rabin401', 'abdorady', 'djcruz', 'nadakoga', 'sandor.one', 'juliadavis19', 'pratyushragini', 'ewoudvissers', 'qwerty56', 'jsproviero', 'mguillen7', 'johnrahill1', 'rishikkumar18', 'rushib97', 'ethwong', 'brsyldrn', 'ahmed.star2025', 'iaaguilera', 'tskroezen', 'aniketsl', 'sven.siegmund', 'max2aneeb', 'navoj98', 'gizemuysal']",2,"['burak.uznn115', None]",393,"['hasanaltintas', 'remsatkan', 'hakan_bicer_96', 'yagaat.smellypitts', 'kritikamna23', 'trinath', 'brekgungor', 'music20011', 'jajung89', 'ozlemsila1', 'shaimaamohamed61195', 'ezgibicak', 'nuri', 'neharikajali', 'salma_hesham', 'abduljalilahmed94', 'covarrubiasjaz05', 'ozlemkrms', 'mhyavuz', 'erenkeskin95', 'chingyinglu89', 'woooney', 'ahmetkaangecer', 'aldoalcantara1', 'arthurxavier.engineer', 'zoz', 'joelrc', 'kbkadir', 'mguillen6', 'aniketbhatia2107', 'mohamed3ssam', 'b10104023', 'singhalanirudh18', 'kzm_dmrlnk', 'senaydogn26', 'kemreakkas', 'ali.solak.1996', 'aliercn964', 'julio_c1712', 'alshareefabdulmajeed', 'austinsams', 'mark.hogg131', 'pirojiwalasubham', 'denizcango', 'ahmetdemir', 'acrylonitrile', 'eng.walaagomaaali', 'yojit105', 'ps5014', 'perihansherif', 'harsh05september', 'groever', 'hsncnyhn', 'akashminato1', 'sudhiriitb', 'michaelconnors', 'caner.baydan', 'jhorton19', 'ahmed_devices', 'highlander2475', 'louiscolson', 'hakanburakbalamir1', 'aavasquez2', 'drhodges', 'shashiadi', 'eggacher', 'ryanwood98', 'tugay95', 'bhu01', 'nemadepsn', 'ccheng852', 'simingma', 'phili180296', 'beraatyigit26', 'mattchuaruiyan', 'areeba123', 'dskartal16', 'neildalal', 'feruiz2', 'silicongo7', 'mjmartinez283', 'shubhangb97', 'kewang.ritsumei', 'shangdi1214', 'ezgii0088', 'amira123', 'abhikanse', 'mwong', 'yarenturker12', 'shaynesmq', 'kumar_ashutosh', 'jazzminesaif66', 'luisggranadost98', 'coolzach999', 'sanidhya27', 'cngzbdr', 'ayesharashid', 'ssdominguez', 'ingrammyles8', 'gunny.balakrishnan', 'mohamedabdelsalam', 'kubraciloglu', 'manar.ibraheem', 'makyz', 'terryyouknow988', 'acostadavid', 'daliahalmy', 'th3prince', 'esraaahmedabdelaal', 'menginaslan', 'tlordello', 'mustafaenesgner', 'liubenliang', 'khandelwalsanyam87', 'baranoncul', 'shashankti111', 'avinashkmry', 'deraz96', 'alejandro.juvera', 'yassinmahdy', 'saisireesha', 'nado.mahmoud1995', 'fvasquez6', 'wdang', 'hatem.rashwany', 'fang59', 'z.a.guzzardo', 'mcsalasnava', 'jesus_aguirre2000', 'timothyobrien', 'safelix', 'yusuf61', 'caranfatma', 'nourhangamal', 'allisontsay', 'omar.handy.96', 'ak83229', 'anonymousbuggy', 'abdurrahmanonuraydin', 'snjkhatri34', 'aesanchez6', 'vivekkandeyang97', 'noel19419', 'ydidwania', 'rz2405', 'mrryzen', 'nishagb04', 'calebringkob', 'anaselsabagh', 'mgthway', 'mustafaali12', 'mehmetdayioglu', 'lakshyakumarsingh', 'duenes957', 'mrinalrao1810', 'osmancanylmz1996', 'liuyuan', 'niamhmulholland', 'hobuobi', 'mauriciofalleiros', 'narendrarai1812', 'axsalomon', 'annasp', 'gonzalez.gaston', 'mayur777', 'resuliseri', 'bekirisgor', 'yerenayas', 'mertsen96', 'dirodriguez4', 'zeyneb', 'darivera3', 'dohaga95', 'elpaglia', 'saarthak', 'enesbas', 'halil26', 'ismailkemal', 'zzhanghuang', 'karimaboelmakarem', 'elijahbarrett22', 'ghanshyam.iitb', 'manny2750', 'abdelrahmanahmedabdelghany', 'demetguull', 'emirhan', 'afrahm104', 'virtuspro', 'yukseltugba14', 'jafar.vafaee', 'swadhasanghvi4', 'raaul.09', 'wassupyo412', 'mrtypc1539', 'mmoody.cma', 'aymanbakr1984.1', 'shiz', 'yigitcilce', 'emilyirisdahl', 'byminc', 'jmclean', 'janmol', 'jasmine1323', 'korhan', 'ahmed.r.elhanafy', 'rapacheco', 'nagidal146', 'bagrania385', 'joeeesalah', 'kirbye1101', 'rashmiravindranath', 'mdj', 'snnnnnnnnnnnn', 'ozgeozdamarr', 'vishwas1020', 'ajitzote', 'ahmedsayedeng1', 'ahmetsurucu', 'maged7423', 'eltonlossner', 'archiki', 'srycvk26', 'akashmunda12345', 'apoorvaudikeri', 'danielgetega', 'skucukarabaci', 'adam.kwiatkowski', 'mb141', 'mwood', 'nanomelis1996', 'marcusle', 'camakk', 'revez_tmr', '16d070026', 'ibrahimethemtemel', 'saboueleinen', 'betkahraman', 'mohamedabdelmaksoud1096', 'ayane123', 'cigo', 'pmmadhumita9', 'esraa7725334', 'saqibalisidd', 'feyzas26', 'ksselhi', 'steve.meraz', 'moises.navarro0423', 'glenpyeldho', 'guray.izmir95', 'dmertkeskin', 'anshulvermaiitb', 'aspruha.samal', 'sethabhinav89', 'abdelrahman_magdy', 'lovelyever17', 'love465944', 'sahilkumar1900', 'bhuyashi.deka', 'belmaci', 'violantium5', 'edlucero25', 'rsalgado19', 'zzhiye', 'dm94', 'gparra3', 'nicolekf', 'bahadirsonmezisik', 'tugcemekci', 'melikekorkmaz94', 'kaki.krish15', None, 'wdoeme93', 'cahidpolat', 'djcastillo', 'ehealey', 'ishitadas1998', 'bugrahansoylu', 'x.ganerdene', 'cacortespliego', 'abdullahaksoy26', 'asrivastava98', 'apoorv0', 'anirudh.singhal', 'ibraheemgalal7', 'menaalfread', 'abeischaos', 'ruohanjiang7', 'marissasaenger', 'mohammed123', 'hakanburakbalamir', 'monicaadelfahim', 'muratkoc503', 'rodriguez.joaquin.jesus', 'gabatres', 'mahe19851117', 'serhatgn', 'yaoweixie', 'havanbhavsar03', 'hasibeodak', 'shikhar1799', 'charanadipudi', 'ealvarez44', 'manarnegm', 'uygarelmali', 'hegdeananthar', 'jitendraiitb', 'mail.d', 'sukruardali', 'gao401', 'eslamamr', 'aydinturkkan44', 'saqibali', 'aengingokce', 'ahmed_moustafa_94', 'burcuakts', 'arbaz', 'jacobmeyerson', 'mernaosama40', 'kasapreyizz', 'gunesa96', 'eng.baristatar', 'siber', 'aimenevse', 'beratcandan', 'bilginper24', 'cshwethanayak', 'pandeykratvesh', 'rekharavindrar', 'mrmamos31', 'methemfaik', 'timobrien', 'nora171296', 'vineetkotariya', 'sezerguven', 'refiktuzakli', 'betildiz', 'jajurado3', 'kumaradarsh', 'nagranados', 'makala.bailey', 'bilgesukaymaz', 'neeraj.chimankar', 'tanmaypatil1598', 'haydartaskaya', 'mehmetock777', 'mbrk747', 'liamfitzgerald', 'dimplekochar3', 'keszler', 'havich', 'himanshuaswani123', 'seg915ept', 'sucheta317', 'burak.uznn115', 'jblopez2', 'shehab', 'ibrahimyararoglu', 'riosdaniel2014', 'devanshu', 'gokay.yilmaz', 'roy.mustang.eb', 'minatarek', 'ryckmonster', 'shauryasindhu', 'ccamarillo6732', 'hazalciftcioglu94', 'fdirisaglik', 'navnitkumar1224', 'rabin401', 'abdorady', 'djcruz', 'nadakoga', 'sandor.one', 'juliadavis19', 'pratyushragini', 'ewoudvissers', 'qwerty56', 'jsproviero', 'mguillen7', 'johnrahill1', 'rishikkumar18', 'mustafaozic42', 'rushib97', 'ethwong', 'brsyldrn', 'ahmed.star2025', 'iaaguilera', 'tskroezen', 'aniketsl', 'sven.siegmund', 'max2aneeb', 'navoj98', 'gizemuysal']"
1,322,391,46,40,"['eng.walaagomaaali', 'mohamedabdelmaksoud1096', 'perihansherif', 'mohamedabdelsalam', 'esraa7725334', 'manar.ibraheem', 'manarnegm', 'daliahalmy', 'ahmed_devices', 'th3prince', 'esraaahmedabdelaal', 'ahmed.r.elhanafy', 'shaimaamohamed61195', 'shehab', 'eslamamr', 'deraz96', 'joeeesalah', 'salma_hesham', 'abduljalilahmed94', 'snnnnnnnnnnnn', 'ahmed_moustafa_94', 'hatem.rashwany', 'ahmedsayedeng1', 'abdelrahman_magdy', 'abdorady', 'nadakoga', 'mernaosama40', 'maged7423', 'dohaga95', 'zoz', 'omar.handy.96', 'karimaboelmakarem', 'ahmed.star2025', 'mohamed3ssam', 'amira123', 'nora171296', 'ibraheemgalal7', 'menaalfread', 'jazzminesaif66', 'monicaadelfahim']",351,"['hasanaltintas', 'remsatkan', 'hakan_bicer_96', 'yagaat.smellypitts', 'kritikamna23', 'trinath', 'brekgungor', 'music20011', 'jajung89', 'ozlemsila1', 'ezgibicak', 'nuri', 'neharikajali', 'covarrubiasjaz05', 'ozlemkrms', 'mhyavuz', 'erenkeskin95', 'chingyinglu89', 'woooney', 'ahmetkaangecer', 'aldoalcantara1', 'arthurxavier.engineer', 'joelrc', 'kbkadir', 'mguillen6', 'aniketbhatia2107', 'b10104023', 'singhalanirudh18', 'kzm_dmrlnk', 'senaydogn26', 'kemreakkas', 'ali.solak.1996', 'aliercn964', 'julio_c1712', 'alshareefabdulmajeed', 'austinsams', 'mark.hogg131', 'pirojiwalasubham', 'denizcango', 'ahmetdemir', 'acrylonitrile', 'yojit105', 'ps5014', 'harsh05september', 'groever', 'hsncnyhn', 'akashminato1', 'sudhiriitb', 'michaelconnors', 'caner.baydan', 'jhorton19', 'highlander2475', 'louiscolson', 'hakanburakbalamir1', 'aavasquez2', 'drhodges', 'shashiadi', 'eggacher', 'ryanwood98', 'tugay95', 'bhu01', 'nemadepsn', 'ccheng852', 'simingma', 'phili180296', 'beraatyigit26', 'mattchuaruiyan', 'areeba123', 'dskartal16', 'neildalal', 'feruiz2', 'silicongo7', 'mjmartinez283', 'shubhangb97', 'kewang.ritsumei', 'shangdi1214', 'ezgii0088', 'abhikanse', 'mwong', 'yarenturker12', 'shaynesmq', 'kumar_ashutosh', 'luisggranadost98', 'coolzach999', 'sanidhya27', 'cngzbdr', 'ayesharashid', 'ssdominguez', 'ingrammyles8', 'gunny.balakrishnan', 'kubraciloglu', 'makyz', 'terryyouknow988', 'acostadavid', 'menginaslan', 'tlordello', 'mustafaenesgner', 'liubenliang', 'khandelwalsanyam87', 'baranoncul', 'shashankti111', 'avinashkmry', 'alejandro.juvera', 'yassinmahdy', 'saisireesha', 'nado.mahmoud1995', 'fvasquez6', 'wdang', 'fang59', 'z.a.guzzardo', 'mcsalasnava', 'jesus_aguirre2000', 'timothyobrien', 'safelix', 'yusuf61', 'caranfatma', 'nourhangamal', 'allisontsay', 'ak83229', 'anonymousbuggy', 'abdurrahmanonuraydin', 'snjkhatri34', 'aesanchez6', 'vivekkandeyang97', 'noel19419', 'ydidwania', 'rz2405', 'mrryzen', 'nishagb04', 'calebringkob', 'anaselsabagh', 'mgthway', 'mustafaali12', 'mehmetdayioglu', 'lakshyakumarsingh', 'duenes957', 'mrinalrao1810', 'osmancanylmz1996', 'liuyuan', 'niamhmulholland', 'hobuobi', 'mauriciofalleiros', 'narendrarai1812', 'axsalomon', 'annasp', 'gonzalez.gaston', 'mayur777', 'resuliseri', 'bekirisgor', 'yerenayas', 'mertsen96', 'dirodriguez4', 'zeyneb', 'darivera3', 'elpaglia', 'saarthak', 'enesbas', 'halil26', 'ismailkemal', 'zzhanghuang', 'elijahbarrett22', 'ghanshyam.iitb', 'manny2750', 'abdelrahmanahmedabdelghany', 'demetguull', 'emirhan', 'afrahm104', 'virtuspro', 'yukseltugba14', 'jafar.vafaee', 'swadhasanghvi4', 'raaul.09', 'wassupyo412', 'mrtypc1539', 'mmoody.cma', 'aymanbakr1984.1', 'shiz', 'yigitcilce', 'emilyirisdahl', 'byminc', 'jmclean', 'janmol', 'jasmine1323', 'korhan', 'rapacheco', 'nagidal146', 'bagrania385', 'kirbye1101', 'rashmiravindranath', 'mdj', 'ozgeozdamarr', 'vishwas1020', 'ajitzote', 'ahmetsurucu', 'eltonlossner', 'archiki', 'srycvk26', 'akashmunda12345', 'apoorvaudikeri', 'danielgetega', 'skucukarabaci', 'adam.kwiatkowski', 'mb141', 'mwood', 'nanomelis1996', 'marcusle', 'camakk', 'revez_tmr', '16d070026', 'ibrahimethemtemel', 'saboueleinen', 'betkahraman', 'ayane123', 'cigo', 'pmmadhumita9', 'saqibalisidd', 'feyzas26', 'ksselhi', 'steve.meraz', 'moises.navarro0423', 'glenpyeldho', 'guray.izmir95', 'dmertkeskin', 'anshulvermaiitb', 'aspruha.samal', 'sethabhinav89', 'lovelyever17', 'love465944', 'sahilkumar1900', 'bhuyashi.deka', 'belmaci', 'violantium5', 'edlucero25', 'rsalgado19', 'zzhiye', 'dm94', 'gparra3', 'nicolekf', 'bahadirsonmezisik', 'tugcemekci', 'melikekorkmaz94', 'kaki.krish15', 'wdoeme93', 'cahidpolat', 'djcastillo', 'ehealey', 'ishitadas1998', 'bugrahansoylu', 'x.ganerdene', 'cacortespliego', 'abdullahaksoy26', 'asrivastava98', 'apoorv0', 'anirudh.singhal', 'abeischaos', 'ruohanjiang7', 'marissasaenger', 'mohammed123', 'hakanburakbalamir', 'muratkoc503', 'rodriguez.joaquin.jesus', 'gabatres', 'mahe19851117', 'serhatgn', 'yaoweixie', 'havanbhavsar03', 'hasibeodak', 'shikhar1799', 'charanadipudi', 'ealvarez44', 'uygarelmali', 'hegdeananthar', 'jitendraiitb', 'mail.d', 'sukruardali', 'gao401', 'aydinturkkan44', 'saqibali', 'aengingokce', 'burcuakts', 'arbaz', 'jacobmeyerson', 'kasapreyizz', 'gunesa96', 'eng.baristatar', 'siber', 'aimenevse', 'beratcandan', 'bilginper24', 'cshwethanayak', 'pandeykratvesh', 'rekharavindrar', 'mrmamos31', 'methemfaik', 'timobrien', 'vineetkotariya', 'sezerguven', 'refiktuzakli', 'betildiz', 'jajurado3', 'kumaradarsh', 'nagranados', 'makala.bailey', 'bilgesukaymaz', 'neeraj.chimankar', 'tanmaypatil1598', 'haydartaskaya', 'mehmetock777', 'mbrk747', 'liamfitzgerald', 'dimplekochar3', 'keszler', 'havich', 'himanshuaswani123', 'seg915ept', 'sucheta317', 'jblopez2', 'ibrahimyararoglu', 'riosdaniel2014', 'devanshu', 'gokay.yilmaz', 'roy.mustang.eb', 'minatarek', 'ryckmonster', 'shauryasindhu', 'ccamarillo6732', 'hazalciftcioglu94', 'fdirisaglik', 'navnitkumar1224', 'rabin401', 'djcruz', 'sandor.one', 'juliadavis19', 'pratyushragini', 'ewoudvissers', 'qwerty56', 'jsproviero', 'mguillen7', 'johnrahill1', 'rishikkumar18', 'mustafaozic42', 'rushib97', 'ethwong', 'brsyldrn', 'iaaguilera', 'tskroezen', 'aniketsl', 'sven.siegmund', 'max2aneeb', 'navoj98', 'gizemuysal']",6,"['passantali', 'mohamedtarek.mt450', 'habib1996', 'nody_elsaadany', 'abdo1703', None]",397,"['hasanaltintas', 'remsatkan', 'hakan_bicer_96', 'yagaat.smellypitts', 'kritikamna23', 'trinath', 'brekgungor', 'music20011', 'jajung89', 'ozlemsila1', 'shaimaamohamed61195', 'ezgibicak', 'nuri', 'neharikajali', 'salma_hesham', 'abduljalilahmed94', 'covarrubiasjaz05', 'ozlemkrms', 'mhyavuz', 'erenkeskin95', 'chingyinglu89', 'woooney', 'ahmetkaangecer', 'aldoalcantara1', 'arthurxavier.engineer', 'zoz', 'joelrc', 'kbkadir', 'mguillen6', 'aniketbhatia2107', 'mohamed3ssam', 'b10104023', 'singhalanirudh18', 'kzm_dmrlnk', 'senaydogn26', 'kemreakkas', 'ali.solak.1996', 'aliercn964', 'julio_c1712', 'alshareefabdulmajeed', 'austinsams', 'mark.hogg131', 'pirojiwalasubham', 'denizcango', 'ahmetdemir', 'acrylonitrile', 'eng.walaagomaaali', 'yojit105', 'ps5014', 'perihansherif', 'harsh05september', 'groever', 'hsncnyhn', 'akashminato1', 'sudhiriitb', 'michaelconnors', 'caner.baydan', 'jhorton19', 'ahmed_devices', 'highlander2475', 'louiscolson', 'hakanburakbalamir1', 'aavasquez2', 'drhodges', 'shashiadi', 'eggacher', 'ryanwood98', 'tugay95', 'bhu01', 'nemadepsn', 'ccheng852', 'simingma', 'phili180296', 'beraatyigit26', 'mattchuaruiyan', 'areeba123', 'dskartal16', 'neildalal', 'feruiz2', 'silicongo7', 'mjmartinez283', 'shubhangb97', 'kewang.ritsumei', 'shangdi1214', 'ezgii0088', 'amira123', 'abhikanse', 'mwong', 'habib1996', 'yarenturker12', 'shaynesmq', 'kumar_ashutosh', 'jazzminesaif66', 'luisggranadost98', 'coolzach999', 'sanidhya27', 'cngzbdr', 'ayesharashid', 'ssdominguez', 'ingrammyles8', 'gunny.balakrishnan', 'mohamedabdelsalam', 'kubraciloglu', 'manar.ibraheem', 'makyz', 'terryyouknow988', 'acostadavid', 'daliahalmy', 'th3prince', 'esraaahmedabdelaal', 'menginaslan', 'tlordello', 'mustafaenesgner', 'liubenliang', 'passantali', 'khandelwalsanyam87', 'baranoncul', 'shashankti111', 'avinashkmry', 'deraz96', 'alejandro.juvera', 'yassinmahdy', 'saisireesha', 'nado.mahmoud1995', 'fvasquez6', 'wdang', 'hatem.rashwany', 'fang59', 'z.a.guzzardo', 'mcsalasnava', 'jesus_aguirre2000', 'timothyobrien', 'safelix', 'yusuf61', 'caranfatma', 'nourhangamal', 'allisontsay', 'omar.handy.96', 'ak83229', 'anonymousbuggy', 'abdurrahmanonuraydin', 'snjkhatri34', 'aesanchez6', 'vivekkandeyang97', 'noel19419', 'ydidwania', 'rz2405', 'mrryzen', 'nishagb04', 'calebringkob', 'anaselsabagh', 'mgthway', 'mustafaali12', 'mehmetdayioglu', 'lakshyakumarsingh', 'duenes957', 'mrinalrao1810', 'osmancanylmz1996', 'liuyuan', 'niamhmulholland', 'hobuobi', 'mauriciofalleiros', 'narendrarai1812', 'axsalomon', 'annasp', 'gonzalez.gaston', 'mayur777', 'resuliseri', 'bekirisgor', 'nody_elsaadany', 'yerenayas', 'mertsen96', 'dirodriguez4', 'zeyneb', 'darivera3', 'dohaga95', 'elpaglia', 'saarthak', 'enesbas', 'halil26', 'ismailkemal', 'zzhanghuang', 'karimaboelmakarem', 'elijahbarrett22', 'ghanshyam.iitb', 'manny2750', 'abdelrahmanahmedabdelghany', 'demetguull', 'emirhan', 'afrahm104', 'virtuspro', 'yukseltugba14', 'jafar.vafaee', 'swadhasanghvi4', 'raaul.09', 'wassupyo412', 'mrtypc1539', 'mmoody.cma', 'aymanbakr1984.1', 'shiz', 'yigitcilce', 'emilyirisdahl', 'byminc', 'jmclean', 'janmol', 'jasmine1323', 'korhan', 'ahmed.r.elhanafy', 'rapacheco', 'nagidal146', 'bagrania385', 'joeeesalah', 'kirbye1101', 'rashmiravindranath', 'mdj', 'snnnnnnnnnnnn', 'ozgeozdamarr', 'vishwas1020', 'ajitzote', 'ahmedsayedeng1', 'ahmetsurucu', 'maged7423', 'eltonlossner', 'archiki', 'srycvk26', 'akashmunda12345', 'apoorvaudikeri', 'danielgetega', 'skucukarabaci', 'adam.kwiatkowski', 'mb141', 'mwood', 'nanomelis1996', 'marcusle', 'camakk', 'revez_tmr', '16d070026', 'ibrahimethemtemel', 'saboueleinen', 'betkahraman', 'mohamedabdelmaksoud1096', 'ayane123', 'cigo', 'pmmadhumita9', 'esraa7725334', 'saqibalisidd', 'feyzas26', 'ksselhi', 'steve.meraz', 'moises.navarro0423', 'glenpyeldho', 'guray.izmir95', 'dmertkeskin', 'anshulvermaiitb', 'aspruha.samal', 'sethabhinav89', 'abdelrahman_magdy', 'lovelyever17', 'love465944', 'sahilkumar1900', 'bhuyashi.deka', 'belmaci', 'violantium5', 'edlucero25', 'rsalgado19', 'zzhiye', 'dm94', 'gparra3', 'nicolekf', 'bahadirsonmezisik', 'tugcemekci', 'melikekorkmaz94', 'kaki.krish15', None, 'wdoeme93', 'cahidpolat', 'djcastillo', 'ehealey', 'ishitadas1998', 'bugrahansoylu', 'x.ganerdene', 'cacortespliego', 'abdullahaksoy26', 'asrivastava98', 'apoorv0', 'anirudh.singhal', 'ibraheemgalal7', 'menaalfread', 'abeischaos', 'mohamedtarek.mt450', 'ruohanjiang7', 'marissasaenger', 'mohammed123', 'hakanburakbalamir', 'monicaadelfahim', 'muratkoc503', 'rodriguez.joaquin.jesus', 'gabatres', 'mahe19851117', 'serhatgn', 'yaoweixie', 'havanbhavsar03', 'hasibeodak', 'shikhar1799', 'charanadipudi', 'ealvarez44', 'manarnegm', 'uygarelmali', 'hegdeananthar', 'jitendraiitb', 'mail.d', 'sukruardali', 'gao401', 'eslamamr', 'aydinturkkan44', 'saqibali', 'aengingokce', 'ahmed_moustafa_94', 'abdo1703', 'burcuakts', 'arbaz', 'jacobmeyerson', 'mernaosama40', 'kasapreyizz', 'gunesa96', 'eng.baristatar', 'siber', 'aimenevse', 'beratcandan', 'bilginper24', 'cshwethanayak', 'pandeykratvesh', 'rekharavindrar', 'mrmamos31', 'methemfaik', 'timobrien', 'nora171296', 'vineetkotariya', 'sezerguven', 'refiktuzakli', 'betildiz', 'jajurado3', 'kumaradarsh', 'nagranados', 'makala.bailey', 'bilgesukaymaz', 'neeraj.chimankar', 'tanmaypatil1598', 'haydartaskaya', 'mehmetock777', 'mbrk747', 'liamfitzgerald', 'dimplekochar3', 'keszler', 'havich', 'himanshuaswani123', 'seg915ept', 'sucheta317', 'jblopez2', 'shehab', 'ibrahimyararoglu', 'riosdaniel2014', 'devanshu', 'gokay.yilmaz', 'roy.mustang.eb', 'minatarek', 'ryckmonster', 'shauryasindhu', 'ccamarillo6732', 'hazalciftcioglu94', 'fdirisaglik', 'navnitkumar1224', 'rabin401', 'abdorady', 'djcruz', 'nadakoga', 'sandor.one', 'juliadavis19', 'pratyushragini', 'ewoudvissers', 'qwerty56', 'jsproviero', 'mguillen7', 'johnrahill1', 'rishikkumar18', 'mustafaozic42', 'rushib97', 'ethwong', 'brsyldrn', 'ahmed.star2025', 'iaaguilera', 'tskroezen', 'aniketsl', 'sven.siegmund', 'max2aneeb', 'navoj98', 'gizemuysal']"
1,313,391,40,39,"['ayane123', 'calebringkob', 'mmoody.cma', 'ingrammyles8', 'groever', 'keszler', 'shiz', 'michaelconnors', 'emilyirisdahl', 'jhorton19', 'jmclean', 'niamhmulholland', 'hobuobi', 'louiscolson', 'jasmine1323', 'annasp', 'bhu01', 'jacobmeyerson', 'ryanwood98', 'ccheng852', 'simingma', 'juliadavis19', 'timothyobrien', 'eltonlossner', 'silicongo7', 'nicolekf', 'danielgetega', 'allisontsay', 'johnrahill1', 'ethwong', 'asrivastava98', 'ehealey', 'mwong', 'camakk', 'austinsams', 'afrahm104', 'saboueleinen', 'marissasaenger', 'liamfitzgerald']",352,"['hasanaltintas', 'remsatkan', 'hakan_bicer_96', 'yagaat.smellypitts', 'kritikamna23', 'trinath', 'brekgungor', 'music20011', 'jajung89', 'ozlemsila1', 'shaimaamohamed61195', 'ezgibicak', 'nuri', 'neharikajali', 'salma_hesham', 'abduljalilahmed94', 'covarrubiasjaz05', 'ozlemkrms', 'mhyavuz', 'erenkeskin95', 'chingyinglu89', 'woooney', 'ahmetkaangecer', 'aldoalcantara1', 'arthurxavier.engineer', 'zoz', 'joelrc', 'kbkadir', 'mguillen6', 'aniketbhatia2107', 'mohamed3ssam', 'b10104023', 'singhalanirudh18', 'kzm_dmrlnk', 'senaydogn26', 'kemreakkas', 'ali.solak.1996', 'aliercn964', 'julio_c1712', 'alshareefabdulmajeed', 'mark.hogg131', 'pirojiwalasubham', 'denizcango', 'ahmetdemir', 'acrylonitrile', 'eng.walaagomaaali', 'yojit105', 'ps5014', 'perihansherif', 'harsh05september', 'hsncnyhn', 'akashminato1', 'sudhiriitb', 'caner.baydan', 'ahmed_devices', 'highlander2475', 'hakanburakbalamir1', 'aavasquez2', 'drhodges', 'shashiadi', 'eggacher', 'tugay95', 'nemadepsn', 'phili180296', 'beraatyigit26', 'mattchuaruiyan', 'areeba123', 'dskartal16', 'neildalal', 'feruiz2', 'mjmartinez283', 'shubhangb97', 'kewang.ritsumei', 'shangdi1214', 'ezgii0088', 'amira123', 'abhikanse', 'yarenturker12', 'shaynesmq', 'kumar_ashutosh', 'jazzminesaif66', 'luisggranadost98', 'coolzach999', 'sanidhya27', 'cngzbdr', 'ayesharashid', 'ssdominguez', 'gunny.balakrishnan', 'mohamedabdelsalam', 'kubraciloglu', 'manar.ibraheem', 'makyz', 'terryyouknow988', 'acostadavid', 'daliahalmy', 'th3prince', 'esraaahmedabdelaal', 'menginaslan', 'tlordello', 'mustafaenesgner', 'liubenliang', 'khandelwalsanyam87', 'baranoncul', 'shashankti111', 'avinashkmry', 'deraz96', 'alejandro.juvera', 'yassinmahdy', 'saisireesha', 'nado.mahmoud1995', 'fvasquez6', 'wdang', 'hatem.rashwany', 'fang59', 'z.a.guzzardo', 'mcsalasnava', 'jesus_aguirre2000', 'safelix', 'yusuf61', 'caranfatma', 'nourhangamal', 'omar.handy.96', 'ak83229', 'anonymousbuggy', 'abdurrahmanonuraydin', 'snjkhatri34', 'aesanchez6', 'vivekkandeyang97', 'noel19419', 'ydidwania', 'rz2405', 'mrryzen', 'nishagb04', 'anaselsabagh', 'mgthway', 'mustafaali12', 'mehmetdayioglu', 'lakshyakumarsingh', 'duenes957', 'mrinalrao1810', 'osmancanylmz1996', 'liuyuan', 'mauriciofalleiros', 'narendrarai1812', 'axsalomon', 'gonzalez.gaston', 'mayur777', 'resuliseri', 'bekirisgor', 'yerenayas', 'mertsen96', 'dirodriguez4', 'zeyneb', 'darivera3', 'dohaga95', 'elpaglia', 'saarthak', 'enesbas', 'halil26', 'ismailkemal', 'zzhanghuang', 'karimaboelmakarem', 'elijahbarrett22', 'ghanshyam.iitb', 'manny2750', 'abdelrahmanahmedabdelghany', 'demetguull', 'emirhan', 'virtuspro', 'yukseltugba14', 'jafar.vafaee', 'swadhasanghvi4', 'raaul.09', 'wassupyo412', 'mrtypc1539', 'aymanbakr1984.1', 'yigitcilce', 'byminc', 'janmol', 'korhan', 'ahmed.r.elhanafy', 'rapacheco', 'nagidal146', 'bagrania385', 'joeeesalah', 'kirbye1101', 'rashmiravindranath', 'mdj', 'snnnnnnnnnnnn', 'ozgeozdamarr', 'vishwas1020', 'ajitzote', 'ahmedsayedeng1', 'ahmetsurucu', 'maged7423', 'archiki', 'srycvk26', 'akashmunda12345', 'apoorvaudikeri', 'skucukarabaci', 'adam.kwiatkowski', 'mb141', 'mwood', 'nanomelis1996', 'marcusle', 'revez_tmr', '16d070026', 'ibrahimethemtemel', 'betkahraman', 'mohamedabdelmaksoud1096', 'cigo', 'pmmadhumita9', 'esraa7725334', 'saqibalisidd', 'feyzas26', 'ksselhi', 'steve.meraz', 'moises.navarro0423', 'glenpyeldho', 'guray.izmir95', 'dmertkeskin', 'anshulvermaiitb', 'aspruha.samal', 'sethabhinav89', 'abdelrahman_magdy', 'lovelyever17', 'love465944', 'sahilkumar1900', 'bhuyashi.deka', 'belmaci', 'violantium5', 'edlucero25', 'rsalgado19', 'zzhiye', 'dm94', 'gparra3', 'bahadirsonmezisik', 'tugcemekci', 'melikekorkmaz94', 'kaki.krish15', 'wdoeme93', 'cahidpolat', 'djcastillo', 'ishitadas1998', 'bugrahansoylu', 'x.ganerdene', 'cacortespliego', 'abdullahaksoy26', 'apoorv0', 'anirudh.singhal', 'ibraheemgalal7', 'menaalfread', 'abeischaos', 'ruohanjiang7', 'mohammed123', 'hakanburakbalamir', 'monicaadelfahim', 'muratkoc503', 'rodriguez.joaquin.jesus', 'gabatres', 'mahe19851117', 'serhatgn', 'yaoweixie', 'havanbhavsar03', 'hasibeodak', 'shikhar1799', 'charanadipudi', 'ealvarez44', 'manarnegm', 'uygarelmali', 'hegdeananthar', 'jitendraiitb', 'mail.d', 'sukruardali', 'gao401', 'eslamamr', 'aydinturkkan44', 'saqibali', 'aengingokce', 'ahmed_moustafa_94', 'burcuakts', 'arbaz', 'mernaosama40', 'kasapreyizz', 'gunesa96', 'eng.baristatar', 'siber', 'aimenevse', 'beratcandan', 'bilginper24', 'cshwethanayak', 'pandeykratvesh', 'rekharavindrar', 'mrmamos31', 'methemfaik', 'timobrien', 'nora171296', 'vineetkotariya', 'sezerguven', 'refiktuzakli', 'betildiz', 'jajurado3', 'kumaradarsh', 'nagranados', 'makala.bailey', 'bilgesukaymaz', 'neeraj.chimankar', 'tanmaypatil1598', 'haydartaskaya', 'mehmetock777', 'mbrk747', 'dimplekochar3', 'havich', 'himanshuaswani123', 'seg915ept', 'sucheta317', 'jblopez2', 'shehab', 'ibrahimyararoglu', 'riosdaniel2014', 'devanshu', 'gokay.yilmaz', 'roy.mustang.eb', 'minatarek', 'ryckmonster', 'shauryasindhu', 'ccamarillo6732', 'hazalciftcioglu94', 'fdirisaglik', 'navnitkumar1224', 'rabin401', 'abdorady', 'djcruz', 'nadakoga', 'sandor.one', 'pratyushragini', 'ewoudvissers', 'qwerty56', 'jsproviero', 'mguillen7', 'rishikkumar18', 'mustafaozic42', 'rushib97', 'brsyldrn', 'ahmed.star2025', 'iaaguilera', 'tskroezen', 'aniketsl', 'sven.siegmund', 'max2aneeb', 'navoj98', 'gizemuysal']",1,[None],392,"['hasanaltintas', 'remsatkan', 'hakan_bicer_96', 'yagaat.smellypitts', 'kritikamna23', 'trinath', 'brekgungor', 'music20011', 'jajung89', 'ozlemsila1', 'shaimaamohamed61195', 'ezgibicak', 'nuri', 'neharikajali', 'salma_hesham', 'abduljalilahmed94', 'covarrubiasjaz05', 'ozlemkrms', 'mhyavuz', 'erenkeskin95', 'chingyinglu89', 'woooney', 'ahmetkaangecer', 'aldoalcantara1', 'arthurxavier.engineer', 'zoz', 'joelrc', 'kbkadir', 'mguillen6', 'aniketbhatia2107', 'mohamed3ssam', 'b10104023', 'singhalanirudh18', 'kzm_dmrlnk', 'senaydogn26', 'kemreakkas', 'ali.solak.1996', 'aliercn964', 'julio_c1712', 'alshareefabdulmajeed', 'austinsams', 'mark.hogg131', 'pirojiwalasubham', 'denizcango', 'ahmetdemir', 'acrylonitrile', 'eng.walaagomaaali', 'yojit105', 'ps5014', 'perihansherif', 'harsh05september', 'groever', 'hsncnyhn', 'akashminato1', 'sudhiriitb', 'michaelconnors', 'caner.baydan', 'jhorton19', 'ahmed_devices', 'highlander2475', 'louiscolson', 'hakanburakbalamir1', 'aavasquez2', 'drhodges', 'shashiadi', 'eggacher', 'ryanwood98', 'tugay95', 'bhu01', 'nemadepsn', 'ccheng852', 'simingma', 'phili180296', 'beraatyigit26', 'mattchuaruiyan', 'areeba123', 'dskartal16', 'neildalal', 'feruiz2', 'silicongo7', 'mjmartinez283', 'shubhangb97', 'kewang.ritsumei', 'shangdi1214', 'ezgii0088', 'amira123', 'abhikanse', 'mwong', 'yarenturker12', 'shaynesmq', 'kumar_ashutosh', 'jazzminesaif66', 'luisggranadost98', 'coolzach999', 'sanidhya27', 'cngzbdr', 'ayesharashid', 'ssdominguez', 'ingrammyles8', 'gunny.balakrishnan', 'mohamedabdelsalam', 'kubraciloglu', 'manar.ibraheem', 'makyz', 'terryyouknow988', 'acostadavid', 'daliahalmy', 'th3prince', 'esraaahmedabdelaal', 'menginaslan', 'tlordello', 'mustafaenesgner', 'liubenliang', 'khandelwalsanyam87', 'baranoncul', 'shashankti111', 'avinashkmry', 'deraz96', 'alejandro.juvera', 'yassinmahdy', 'saisireesha', 'nado.mahmoud1995', 'fvasquez6', 'wdang', 'hatem.rashwany', 'fang59', 'z.a.guzzardo', 'mcsalasnava', 'jesus_aguirre2000', 'timothyobrien', 'safelix', 'yusuf61', 'caranfatma', 'nourhangamal', 'allisontsay', 'omar.handy.96', 'ak83229', 'anonymousbuggy', 'abdurrahmanonuraydin', 'snjkhatri34', 'aesanchez6', 'vivekkandeyang97', 'noel19419', 'ydidwania', 'rz2405', 'mrryzen', 'nishagb04', 'calebringkob', 'anaselsabagh', 'mgthway', 'mustafaali12', 'mehmetdayioglu', 'lakshyakumarsingh', 'duenes957', 'mrinalrao1810', 'osmancanylmz1996', 'liuyuan', 'niamhmulholland', 'hobuobi', 'mauriciofalleiros', 'narendrarai1812', 'axsalomon', 'annasp', 'gonzalez.gaston', 'mayur777', 'resuliseri', 'bekirisgor', 'yerenayas', 'mertsen96', 'dirodriguez4', 'zeyneb', 'darivera3', 'dohaga95', 'elpaglia', 'saarthak', 'enesbas', 'halil26', 'ismailkemal', 'zzhanghuang', 'karimaboelmakarem', 'elijahbarrett22', 'ghanshyam.iitb', 'manny2750', 'abdelrahmanahmedabdelghany', 'demetguull', 'emirhan', 'afrahm104', 'virtuspro', 'yukseltugba14', 'jafar.vafaee', 'swadhasanghvi4', 'raaul.09', 'wassupyo412', 'mrtypc1539', 'mmoody.cma', 'aymanbakr1984.1', 'shiz', 'yigitcilce', 'emilyirisdahl', 'byminc', 'jmclean', 'janmol', 'jasmine1323', 'korhan', 'ahmed.r.elhanafy', 'rapacheco', 'nagidal146', 'bagrania385', 'joeeesalah', 'kirbye1101', 'rashmiravindranath', 'mdj', 'snnnnnnnnnnnn', 'ozgeozdamarr', 'vishwas1020', 'ajitzote', 'ahmedsayedeng1', 'ahmetsurucu', 'maged7423', 'eltonlossner', 'archiki', 'srycvk26', 'akashmunda12345', 'apoorvaudikeri', 'danielgetega', 'skucukarabaci', 'adam.kwiatkowski', 'mb141', 'mwood', 'nanomelis1996', 'marcusle', 'camakk', 'revez_tmr', '16d070026', 'ibrahimethemtemel', 'saboueleinen', 'betkahraman', 'mohamedabdelmaksoud1096', 'ayane123', 'cigo', 'pmmadhumita9', 'esraa7725334', 'saqibalisidd', 'feyzas26', 'ksselhi', 'steve.meraz', 'moises.navarro0423', 'glenpyeldho', 'guray.izmir95', 'dmertkeskin', 'anshulvermaiitb', 'aspruha.samal', 'sethabhinav89', 'abdelrahman_magdy', 'lovelyever17', 'love465944', 'sahilkumar1900', 'bhuyashi.deka', 'belmaci', 'violantium5', 'edlucero25', 'rsalgado19', 'zzhiye', 'dm94', 'gparra3', 'nicolekf', 'bahadirsonmezisik', 'tugcemekci', 'melikekorkmaz94', 'kaki.krish15', None, 'wdoeme93', 'cahidpolat', 'djcastillo', 'ehealey', 'ishitadas1998', 'bugrahansoylu', 'x.ganerdene', 'cacortespliego', 'abdullahaksoy26', 'asrivastava98', 'apoorv0', 'anirudh.singhal', 'ibraheemgalal7', 'menaalfread', 'abeischaos', 'ruohanjiang7', 'marissasaenger', 'mohammed123', 'hakanburakbalamir', 'monicaadelfahim', 'muratkoc503', 'rodriguez.joaquin.jesus', 'gabatres', 'mahe19851117', 'serhatgn', 'yaoweixie', 'havanbhavsar03', 'hasibeodak', 'shikhar1799', 'charanadipudi', 'ealvarez44', 'manarnegm', 'uygarelmali', 'hegdeananthar', 'jitendraiitb', 'mail.d', 'sukruardali', 'gao401', 'eslamamr', 'aydinturkkan44', 'saqibali', 'aengingokce', 'ahmed_moustafa_94', 'burcuakts', 'arbaz', 'jacobmeyerson', 'mernaosama40', 'kasapreyizz', 'gunesa96', 'eng.baristatar', 'siber', 'aimenevse', 'beratcandan', 'bilginper24', 'cshwethanayak', 'pandeykratvesh', 'rekharavindrar', 'mrmamos31', 'methemfaik', 'timobrien', 'nora171296', 'vineetkotariya', 'sezerguven', 'refiktuzakli', 'betildiz', 'jajurado3', 'kumaradarsh', 'nagranados', 'makala.bailey', 'bilgesukaymaz', 'neeraj.chimankar', 'tanmaypatil1598', 'haydartaskaya', 'mehmetock777', 'mbrk747', 'liamfitzgerald', 'dimplekochar3', 'keszler', 'havich', 'himanshuaswani123', 'seg915ept', 'sucheta317', 'jblopez2', 'shehab', 'ibrahimyararoglu', 'riosdaniel2014', 'devanshu', 'gokay.yilmaz', 'roy.mustang.eb', 'minatarek', 'ryckmonster', 'shauryasindhu', 'ccamarillo6732', 'hazalciftcioglu94', 'fdirisaglik', 'navnitkumar1224', 'rabin401', 'abdorady', 'djcruz', 'nadakoga', 'sandor.one', 'juliadavis19', 'pratyushragini', 'ewoudvissers', 'qwerty56', 'jsproviero', 'mguillen7', 'johnrahill1', 'rishikkumar18', 'mustafaozic42', 'rushib97', 'ethwong', 'brsyldrn', 'ahmed.star2025', 'iaaguilera', 'tskroezen', 'aniketsl', 'sven.siegmund', 'max2aneeb', 'navoj98', 'gizemuysal']"
1,301,391,36,2,"['ayesharashid', 'saqibalisidd']",389,"['hasanaltintas', 'remsatkan', 'hakan_bicer_96', 'yagaat.smellypitts', 'kritikamna23', 'trinath', 'brekgungor', 'music20011', 'jajung89', 'ozlemsila1', 'shaimaamohamed61195', 'ezgibicak', 'nuri', 'neharikajali', 'salma_hesham', 'abduljalilahmed94', 'covarrubiasjaz05', 'ozlemkrms', 'mhyavuz', 'erenkeskin95', 'chingyinglu89', 'woooney', 'ahmetkaangecer', 'aldoalcantara1', 'arthurxavier.engineer', 'zoz', 'joelrc', 'kbkadir', 'mguillen6', 'aniketbhatia2107', 'mohamed3ssam', 'b10104023', 'singhalanirudh18', 'kzm_dmrlnk', 'senaydogn26', 'kemreakkas', 'ali.solak.1996', 'aliercn964', 'julio_c1712', 'alshareefabdulmajeed', 'austinsams', 'mark.hogg131', 'pirojiwalasubham', 'denizcango', 'ahmetdemir', 'acrylonitrile', 'eng.walaagomaaali', 'yojit105', 'ps5014', 'perihansherif', 'harsh05september', 'groever', 'hsncnyhn', 'akashminato1', 'sudhiriitb', 'michaelconnors', 'caner.baydan', 'jhorton19', 'ahmed_devices', 'highlander2475', 'louiscolson', 'hakanburakbalamir1', 'aavasquez2', 'drhodges', 'shashiadi', 'eggacher', 'ryanwood98', 'tugay95', 'bhu01', 'nemadepsn', 'ccheng852', 'simingma', 'phili180296', 'beraatyigit26', 'mattchuaruiyan', 'areeba123', 'dskartal16', 'neildalal', 'feruiz2', 'silicongo7', 'mjmartinez283', 'shubhangb97', 'kewang.ritsumei', 'shangdi1214', 'ezgii0088', 'amira123', 'abhikanse', 'mwong', 'yarenturker12', 'shaynesmq', 'kumar_ashutosh', 'jazzminesaif66', 'luisggranadost98', 'coolzach999', 'sanidhya27', 'cngzbdr', 'ssdominguez', 'ingrammyles8', 'gunny.balakrishnan', 'mohamedabdelsalam', 'kubraciloglu', 'manar.ibraheem', 'makyz', 'terryyouknow988', 'acostadavid', 'daliahalmy', 'th3prince', 'esraaahmedabdelaal', 'menginaslan', 'tlordello', 'mustafaenesgner', 'liubenliang', 'khandelwalsanyam87', 'baranoncul', 'shashankti111', 'avinashkmry', 'deraz96', 'alejandro.juvera', 'yassinmahdy', 'saisireesha', 'nado.mahmoud1995', 'fvasquez6', 'wdang', 'hatem.rashwany', 'fang59', 'z.a.guzzardo', 'mcsalasnava', 'jesus_aguirre2000', 'timothyobrien', 'safelix', 'yusuf61', 'caranfatma', 'nourhangamal', 'allisontsay', 'omar.handy.96', 'ak83229', 'anonymousbuggy', 'abdurrahmanonuraydin', 'snjkhatri34', 'aesanchez6', 'vivekkandeyang97', 'noel19419', 'ydidwania', 'rz2405', 'mrryzen', 'nishagb04', 'calebringkob', 'anaselsabagh', 'mgthway', 'mustafaali12', 'mehmetdayioglu', 'lakshyakumarsingh', 'duenes957', 'mrinalrao1810', 'osmancanylmz1996', 'liuyuan', 'niamhmulholland', 'hobuobi', 'mauriciofalleiros', 'narendrarai1812', 'axsalomon', 'annasp', 'gonzalez.gaston', 'mayur777', 'resuliseri', 'bekirisgor', 'yerenayas', 'mertsen96', 'dirodriguez4', 'zeyneb', 'darivera3', 'dohaga95', 'elpaglia', 'saarthak', 'enesbas', 'halil26', 'ismailkemal', 'zzhanghuang', 'karimaboelmakarem', 'elijahbarrett22', 'ghanshyam.iitb', 'manny2750', 'abdelrahmanahmedabdelghany', 'demetguull', 'emirhan', 'afrahm104', 'virtuspro', 'yukseltugba14', 'jafar.vafaee', 'swadhasanghvi4', 'raaul.09', 'wassupyo412', 'mrtypc1539', 'mmoody.cma', 'aymanbakr1984.1', 'shiz', 'yigitcilce', 'emilyirisdahl', 'byminc', 'jmclean', 'janmol', 'jasmine1323', 'korhan', 'ahmed.r.elhanafy', 'rapacheco', 'nagidal146', 'bagrania385', 'joeeesalah', 'kirbye1101', 'rashmiravindranath', 'mdj', 'snnnnnnnnnnnn', 'ozgeozdamarr', 'vishwas1020', 'ajitzote', 'ahmedsayedeng1', 'ahmetsurucu', 'maged7423', 'eltonlossner', 'archiki', 'srycvk26', 'akashmunda12345', 'apoorvaudikeri', 'danielgetega', 'skucukarabaci', 'adam.kwiatkowski', 'mb141', 'mwood', 'nanomelis1996', 'marcusle', 'camakk', 'revez_tmr', '16d070026', 'ibrahimethemtemel', 'saboueleinen', 'betkahraman', 'mohamedabdelmaksoud1096', 'ayane123', 'cigo', 'pmmadhumita9', 'esraa7725334', 'feyzas26', 'ksselhi', 'steve.meraz', 'moises.navarro0423', 'glenpyeldho', 'guray.izmir95', 'dmertkeskin', 'anshulvermaiitb', 'aspruha.samal', 'sethabhinav89', 'abdelrahman_magdy', 'lovelyever17', 'love465944', 'sahilkumar1900', 'bhuyashi.deka', 'belmaci', 'violantium5', 'edlucero25', 'rsalgado19', 'zzhiye', 'dm94', 'gparra3', 'nicolekf', 'bahadirsonmezisik', 'tugcemekci', 'melikekorkmaz94', 'kaki.krish15', 'wdoeme93', 'cahidpolat', 'djcastillo', 'ehealey', 'ishitadas1998', 'bugrahansoylu', 'x.ganerdene', 'cacortespliego', 'abdullahaksoy26', 'asrivastava98', 'apoorv0', 'anirudh.singhal', 'ibraheemgalal7', 'menaalfread', 'abeischaos', 'ruohanjiang7', 'marissasaenger', 'mohammed123', 'hakanburakbalamir', 'monicaadelfahim', 'muratkoc503', 'rodriguez.joaquin.jesus', 'gabatres', 'mahe19851117', 'serhatgn', 'yaoweixie', 'havanbhavsar03', 'hasibeodak', 'shikhar1799', 'charanadipudi', 'ealvarez44', 'manarnegm', 'uygarelmali', 'hegdeananthar', 'jitendraiitb', 'mail.d', 'sukruardali', 'gao401', 'eslamamr', 'aydinturkkan44', 'saqibali', 'aengingokce', 'ahmed_moustafa_94', 'burcuakts', 'arbaz', 'jacobmeyerson', 'mernaosama40', 'kasapreyizz', 'gunesa96', 'eng.baristatar', 'siber', 'aimenevse', 'beratcandan', 'bilginper24', 'cshwethanayak', 'pandeykratvesh', 'rekharavindrar', 'mrmamos31', 'methemfaik', 'timobrien', 'nora171296', 'vineetkotariya', 'sezerguven', 'refiktuzakli', 'betildiz', 'jajurado3', 'kumaradarsh', 'nagranados', 'makala.bailey', 'bilgesukaymaz', 'neeraj.chimankar', 'tanmaypatil1598', 'haydartaskaya', 'mehmetock777', 'mbrk747', 'liamfitzgerald', 'dimplekochar3', 'keszler', 'havich', 'himanshuaswani123', 'seg915ept', 'sucheta317', 'jblopez2', 'shehab', 'ibrahimyararoglu', 'riosdaniel2014', 'devanshu', 'gokay.yilmaz', 'roy.mustang.eb', 'minatarek', 'ryckmonster', 'shauryasindhu', 'ccamarillo6732', 'hazalciftcioglu94', 'fdirisaglik', 'navnitkumar1224', 'rabin401', 'abdorady', 'djcruz', 'nadakoga', 'sandor.one', 'juliadavis19', 'pratyushragini', 'ewoudvissers', 'qwerty56', 'jsproviero', 'mguillen7', 'johnrahill1', 'rishikkumar18', 'mustafaozic42', 'rushib97', 'ethwong', 'brsyldrn', 'ahmed.star2025', 'iaaguilera', 'tskroezen', 'aniketsl', 'sven.siegmund', 'max2aneeb', 'navoj98', 'gizemuysal']",34,"['mishaim', 'hamzaaleem1', 'nidayousuf25', 'aqsakhan', 'namrahkhan', 'munamfarooqui2244', 'ayeshakhan.2907', 'wajeehaiqbal5', 'wardaishrat', 'naseerhakeem8', 'arubarashid123', 'hassam', 'abdurrehman', 'ramshaiqbal3', 'aroomah', 'farooque73', 'sajadali001', 'actec', 'ssd2017', 'faizan_ned', 'azkahaq', 'naihapervez', 'aqsanaz444657', None, 'rabat', 'aymenbatool98', 'rimal.ozair16', 'iffatiqbal', 'arooba', 'shriya17', 'misbah', 'jamalamasil2612', 'mavarakamal', 'arifali013']",425,"['hasanaltintas', 'remsatkan', 'hakan_bicer_96', 'yagaat.smellypitts', 'kritikamna23', 'trinath', 'brekgungor', 'music20011', 'jajung89', 'ozlemsila1', 'shaimaamohamed61195', 'ezgibicak', 'nuri', 'neharikajali', 'salma_hesham', 'abduljalilahmed94', 'covarrubiasjaz05', 'arubarashid123', 'ozlemkrms', 'mhyavuz', 'erenkeskin95', 'chingyinglu89', 'aroomah', 'ssd2017', 'woooney', 'ahmetkaangecer', 'naihapervez', 'aldoalcantara1', 'arthurxavier.engineer', 'zoz', 'joelrc', 'kbkadir', 'mguillen6', 'aniketbhatia2107', 'mohamed3ssam', 'b10104023', 'singhalanirudh18', 'iffatiqbal', 'kzm_dmrlnk', 'senaydogn26', 'kemreakkas', 'ali.solak.1996', 'aliercn964', 'julio_c1712', 'alshareefabdulmajeed', 'austinsams', 'mark.hogg131', 'pirojiwalasubham', 'denizcango', 'ahmetdemir', 'acrylonitrile', 'hamzaaleem1', 'eng.walaagomaaali', 'yojit105', 'ps5014', 'perihansherif', 'harsh05september', 'groever', 'hsncnyhn', 'akashminato1', 'ayeshakhan.2907', 'sudhiriitb', 'michaelconnors', 'caner.baydan', 'jhorton19', 'ahmed_devices', 'highlander2475', 'louiscolson', 'hakanburakbalamir1', 'naseerhakeem8', 'aavasquez2', 'drhodges', 'shashiadi', 'eggacher', 'ryanwood98', 'tugay95', 'bhu01', 'nemadepsn', 'ccheng852', 'simingma', 'phili180296', 'beraatyigit26', 'mattchuaruiyan', 'areeba123', 'dskartal16', 'neildalal', 'actec', 'feruiz2', 'silicongo7', 'azkahaq', 'mjmartinez283', 'shubhangb97', 'kewang.ritsumei', 'shangdi1214', 'ezgii0088', 'amira123', 'abhikanse', 'mwong', 'yarenturker12', 'shaynesmq', 'kumar_ashutosh', 'jazzminesaif66', 'arifali013', 'luisggranadost98', 'coolzach999', 'sanidhya27', 'cngzbdr', 'ayesharashid', 'ssdominguez', 'ingrammyles8', 'gunny.balakrishnan', 'mohamedabdelsalam', 'kubraciloglu', 'manar.ibraheem', 'makyz', 'terryyouknow988', 'acostadavid', 'daliahalmy', 'th3prince', 'esraaahmedabdelaal', 'menginaslan', 'tlordello', 'mustafaenesgner', 'liubenliang', 'khandelwalsanyam87', 'baranoncul', 'shashankti111', 'avinashkmry', 'deraz96', 'wardaishrat', 'alejandro.juvera', 'yassinmahdy', 'saisireesha', 'nado.mahmoud1995', 'fvasquez6', 'wdang', 'hatem.rashwany', 'fang59', 'z.a.guzzardo', 'mcsalasnava', 'sajadali001', 'jesus_aguirre2000', 'timothyobrien', 'safelix', 'yusuf61', 'caranfatma', 'nourhangamal', 'allisontsay', 'omar.handy.96', 'ak83229', 'anonymousbuggy', 'abdurrahmanonuraydin', 'snjkhatri34', 'aesanchez6', 'vivekkandeyang97', 'noel19419', 'ydidwania', 'rz2405', 'mrryzen', 'nishagb04', 'calebringkob', 'anaselsabagh', 'mgthway', 'mustafaali12', 'mehmetdayioglu', 'lakshyakumarsingh', 'duenes957', 'mrinalrao1810', 'osmancanylmz1996', 'liuyuan', 'niamhmulholland', 'hobuobi', 'mauriciofalleiros', 'narendrarai1812', 'axsalomon', 'annasp', 'gonzalez.gaston', 'mayur777', 'resuliseri', 'bekirisgor', 'yerenayas', 'mertsen96', 'dirodriguez4', 'zeyneb', 'darivera3', 'dohaga95', 'elpaglia', 'saarthak', 'enesbas', 'halil26', 'ismailkemal', 'zzhanghuang', 'karimaboelmakarem', 'aqsanaz444657', 'aymenbatool98', 'rimal.ozair16', 'elijahbarrett22', 'misbah', 'ghanshyam.iitb', 'manny2750', 'abdelrahmanahmedabdelghany', 'demetguull', 'emirhan', 'afrahm104', 'virtuspro', 'yukseltugba14', 'jafar.vafaee', 'swadhasanghvi4', 'raaul.09', 'wassupyo412', 'mrtypc1539', 'mmoody.cma', 'aqsakhan', 'aymanbakr1984.1', 'shiz', 'yigitcilce', 'emilyirisdahl', 'byminc', 'jmclean', 'janmol', 'jasmine1323', 'korhan', 'ahmed.r.elhanafy', 'rapacheco', 'nagidal146', 'bagrania385', 'joeeesalah', 'kirbye1101', 'rashmiravindranath', 'mdj', 'snnnnnnnnnnnn', 'ozgeozdamarr', 'abdurrehman', 'ramshaiqbal3', 'vishwas1020', 'ajitzote', 'ahmedsayedeng1', 'farooque73', 'ahmetsurucu', 'maged7423', 'faizan_ned', 'eltonlossner', 'archiki', 'srycvk26', 'akashmunda12345', 'apoorvaudikeri', 'danielgetega', 'skucukarabaci', 'adam.kwiatkowski', 'mb141', 'mwood', 'nanomelis1996', 'marcusle', 'camakk', 'jamalamasil2612', 'revez_tmr', '16d070026', 'ibrahimethemtemel', 'saboueleinen', 'betkahraman', 'mohamedabdelmaksoud1096', 'ayane123', 'cigo', 'pmmadhumita9', 'esraa7725334', 'saqibalisidd', 'feyzas26', 'ksselhi', 'steve.meraz', 'moises.navarro0423', 'glenpyeldho', 'hassam', 'guray.izmir95', 'dmertkeskin', 'anshulvermaiitb', 'aspruha.samal', 'sethabhinav89', 'abdelrahman_magdy', 'lovelyever17', 'love465944', 'sahilkumar1900', 'bhuyashi.deka', 'belmaci', 'violantium5', 'edlucero25', 'rsalgado19', 'zzhiye', 'dm94', 'gparra3', 'nicolekf', 'bahadirsonmezisik', 'tugcemekci', 'melikekorkmaz94', 'kaki.krish15', None, 'wdoeme93', 'cahidpolat', 'djcastillo', 'ehealey', 'ishitadas1998', 'bugrahansoylu', 'x.ganerdene', 'cacortespliego', 'abdullahaksoy26', 'asrivastava98', 'apoorv0', 'anirudh.singhal', 'ibraheemgalal7', 'menaalfread', 'abeischaos', 'ruohanjiang7', 'marissasaenger', 'mohammed123', 'hakanburakbalamir', 'monicaadelfahim', 'muratkoc503', 'mishaim', 'rodriguez.joaquin.jesus', 'gabatres', 'namrahkhan', 'mahe19851117', 'serhatgn', 'munamfarooqui2244', 'yaoweixie', 'havanbhavsar03', 'hasibeodak', 'shikhar1799', 'charanadipudi', 'ealvarez44', 'manarnegm', 'uygarelmali', 'hegdeananthar', 'jitendraiitb', 'mail.d', 'sukruardali', 'gao401', 'eslamamr', 'aydinturkkan44', 'saqibali', 'aengingokce', 'ahmed_moustafa_94', 'burcuakts', 'arbaz', 'jacobmeyerson', 'mernaosama40', 'kasapreyizz', 'gunesa96', 'eng.baristatar', 'siber', 'aimenevse', 'beratcandan', 'bilginper24', 'cshwethanayak', 'pandeykratvesh', 'rekharavindrar', 'arooba', 'mrmamos31', 'methemfaik', 'timobrien', 'nora171296', 'vineetkotariya', 'sezerguven', 'refiktuzakli', 'betildiz', 'jajurado3', 'shriya17', 'kumaradarsh', 'nagranados', 'makala.bailey', 'bilgesukaymaz', 'neeraj.chimankar', 'tanmaypatil1598', 'haydartaskaya', 'mehmetock777', 'mbrk747', 'liamfitzgerald', 'nidayousuf25', 'dimplekochar3', 'keszler', 'havich', 'himanshuaswani123', 'wajeehaiqbal5', 'seg915ept', 'sucheta317', 'jblopez2', 'shehab', 'ibrahimyararoglu', 'riosdaniel2014', 'devanshu', 'gokay.yilmaz', 'roy.mustang.eb', 'minatarek', 'ryckmonster', 'shauryasindhu', 'ccamarillo6732', 'hazalciftcioglu94', 'fdirisaglik', 'navnitkumar1224', 'rabin401', 'abdorady', 'djcruz', 'nadakoga', 'sandor.one', 'juliadavis19', 'pratyushragini', 'ewoudvissers', 'qwerty56', 'jsproviero', 'mguillen7', 'johnrahill1', 'rishikkumar18', 'mustafaozic42', 'rushib97', 'ethwong', 'brsyldrn', 'ahmed.star2025', 'rabat', 'iaaguilera', 'tskroezen', 'aniketsl', 'sven.siegmund', 'mavarakamal', 'max2aneeb', 'navoj98', 'gizemuysal']"
1,130,391,30,1,['yaoweixie'],390,"['hasanaltintas', 'remsatkan', 'hakan_bicer_96', 'yagaat.smellypitts', 'kritikamna23', 'trinath', 'brekgungor', 'music20011', 'jajung89', 'ozlemsila1', 'shaimaamohamed61195', 'ezgibicak', 'nuri', 'neharikajali', 'salma_hesham', 'abduljalilahmed94', 'covarrubiasjaz05', 'ozlemkrms', 'mhyavuz', 'erenkeskin95', 'chingyinglu89', 'woooney', 'ahmetkaangecer', 'aldoalcantara1', 'arthurxavier.engineer', 'zoz', 'joelrc', 'kbkadir', 'mguillen6', 'aniketbhatia2107', 'mohamed3ssam', 'b10104023', 'singhalanirudh18', 'kzm_dmrlnk', 'senaydogn26', 'kemreakkas', 'ali.solak.1996', 'aliercn964', 'julio_c1712', 'alshareefabdulmajeed', 'austinsams', 'mark.hogg131', 'pirojiwalasubham', 'denizcango', 'ahmetdemir', 'acrylonitrile', 'eng.walaagomaaali', 'yojit105', 'ps5014', 'perihansherif', 'harsh05september', 'groever', 'hsncnyhn', 'akashminato1', 'sudhiriitb', 'michaelconnors', 'caner.baydan', 'jhorton19', 'ahmed_devices', 'highlander2475', 'louiscolson', 'hakanburakbalamir1', 'aavasquez2', 'drhodges', 'shashiadi', 'eggacher', 'ryanwood98', 'tugay95', 'bhu01', 'nemadepsn', 'ccheng852', 'simingma', 'phili180296', 'beraatyigit26', 'mattchuaruiyan', 'areeba123', 'dskartal16', 'neildalal', 'feruiz2', 'silicongo7', 'mjmartinez283', 'shubhangb97', 'kewang.ritsumei', 'shangdi1214', 'ezgii0088', 'amira123', 'abhikanse', 'mwong', 'yarenturker12', 'shaynesmq', 'kumar_ashutosh', 'jazzminesaif66', 'luisggranadost98', 'coolzach999', 'sanidhya27', 'cngzbdr', 'ayesharashid', 'ssdominguez', 'ingrammyles8', 'gunny.balakrishnan', 'mohamedabdelsalam', 'kubraciloglu', 'manar.ibraheem', 'makyz', 'terryyouknow988', 'acostadavid', 'daliahalmy', 'th3prince', 'esraaahmedabdelaal', 'menginaslan', 'tlordello', 'mustafaenesgner', 'liubenliang', 'khandelwalsanyam87', 'baranoncul', 'shashankti111', 'avinashkmry', 'deraz96', 'alejandro.juvera', 'yassinmahdy', 'saisireesha', 'nado.mahmoud1995', 'fvasquez6', 'wdang', 'hatem.rashwany', 'fang59', 'z.a.guzzardo', 'mcsalasnava', 'jesus_aguirre2000', 'timothyobrien', 'safelix', 'yusuf61', 'caranfatma', 'nourhangamal', 'allisontsay', 'omar.handy.96', 'ak83229', 'anonymousbuggy', 'abdurrahmanonuraydin', 'snjkhatri34', 'aesanchez6', 'vivekkandeyang97', 'noel19419', 'ydidwania', 'rz2405', 'mrryzen', 'nishagb04', 'calebringkob', 'anaselsabagh', 'mgthway', 'mustafaali12', 'mehmetdayioglu', 'lakshyakumarsingh', 'duenes957', 'mrinalrao1810', 'osmancanylmz1996', 'liuyuan', 'niamhmulholland', 'hobuobi', 'mauriciofalleiros', 'narendrarai1812', 'axsalomon', 'annasp', 'gonzalez.gaston', 'mayur777', 'resuliseri', 'bekirisgor', 'yerenayas', 'mertsen96', 'dirodriguez4', 'zeyneb', 'darivera3', 'dohaga95', 'elpaglia', 'saarthak', 'enesbas', 'halil26', 'ismailkemal', 'zzhanghuang', 'karimaboelmakarem', 'elijahbarrett22', 'ghanshyam.iitb', 'manny2750', 'abdelrahmanahmedabdelghany', 'demetguull', 'emirhan', 'afrahm104', 'virtuspro', 'yukseltugba14', 'jafar.vafaee', 'swadhasanghvi4', 'raaul.09', 'wassupyo412', 'mrtypc1539', 'mmoody.cma', 'aymanbakr1984.1', 'shiz', 'yigitcilce', 'emilyirisdahl', 'byminc', 'jmclean', 'janmol', 'jasmine1323', 'korhan', 'ahmed.r.elhanafy', 'rapacheco', 'nagidal146', 'bagrania385', 'joeeesalah', 'kirbye1101', 'rashmiravindranath', 'mdj', 'snnnnnnnnnnnn', 'ozgeozdamarr', 'vishwas1020', 'ajitzote', 'ahmedsayedeng1', 'ahmetsurucu', 'maged7423', 'eltonlossner', 'archiki', 'srycvk26', 'akashmunda12345', 'apoorvaudikeri', 'danielgetega', 'skucukarabaci', 'adam.kwiatkowski', 'mb141', 'mwood', 'nanomelis1996', 'marcusle', 'camakk', 'revez_tmr', '16d070026', 'ibrahimethemtemel', 'saboueleinen', 'betkahraman', 'mohamedabdelmaksoud1096', 'ayane123', 'cigo', 'pmmadhumita9', 'esraa7725334', 'saqibalisidd', 'feyzas26', 'ksselhi', 'steve.meraz', 'moises.navarro0423', 'glenpyeldho', 'guray.izmir95', 'dmertkeskin', 'anshulvermaiitb', 'aspruha.samal', 'sethabhinav89', 'abdelrahman_magdy', 'lovelyever17', 'love465944', 'sahilkumar1900', 'bhuyashi.deka', 'belmaci', 'violantium5', 'edlucero25', 'rsalgado19', 'zzhiye', 'dm94', 'gparra3', 'nicolekf', 'bahadirsonmezisik', 'tugcemekci', 'melikekorkmaz94', 'kaki.krish15', 'wdoeme93', 'cahidpolat', 'djcastillo', 'ehealey', 'ishitadas1998', 'bugrahansoylu', 'x.ganerdene', 'cacortespliego', 'abdullahaksoy26', 'asrivastava98', 'apoorv0', 'anirudh.singhal', 'ibraheemgalal7', 'menaalfread', 'abeischaos', 'ruohanjiang7', 'marissasaenger', 'mohammed123', 'hakanburakbalamir', 'monicaadelfahim', 'muratkoc503', 'rodriguez.joaquin.jesus', 'gabatres', 'mahe19851117', 'serhatgn', 'havanbhavsar03', 'hasibeodak', 'shikhar1799', 'charanadipudi', 'ealvarez44', 'manarnegm', 'uygarelmali', 'hegdeananthar', 'jitendraiitb', 'mail.d', 'sukruardali', 'gao401', 'eslamamr', 'aydinturkkan44', 'saqibali', 'aengingokce', 'ahmed_moustafa_94', 'burcuakts', 'arbaz', 'jacobmeyerson', 'mernaosama40', 'kasapreyizz', 'gunesa96', 'eng.baristatar', 'siber', 'aimenevse', 'beratcandan', 'bilginper24', 'cshwethanayak', 'pandeykratvesh', 'rekharavindrar', 'mrmamos31', 'methemfaik', 'timobrien', 'nora171296', 'vineetkotariya', 'sezerguven', 'refiktuzakli', 'betildiz', 'jajurado3', 'kumaradarsh', 'nagranados', 'makala.bailey', 'bilgesukaymaz', 'neeraj.chimankar', 'tanmaypatil1598', 'haydartaskaya', 'mehmetock777', 'mbrk747', 'liamfitzgerald', 'dimplekochar3', 'keszler', 'havich', 'himanshuaswani123', 'seg915ept', 'sucheta317', 'jblopez2', 'shehab', 'ibrahimyararoglu', 'riosdaniel2014', 'devanshu', 'gokay.yilmaz', 'roy.mustang.eb', 'minatarek', 'ryckmonster', 'shauryasindhu', 'ccamarillo6732', 'hazalciftcioglu94', 'fdirisaglik', 'navnitkumar1224', 'rabin401', 'abdorady', 'djcruz', 'nadakoga', 'sandor.one', 'juliadavis19', 'pratyushragini', 'ewoudvissers', 'qwerty56', 'jsproviero', 'mguillen7', 'johnrahill1', 'rishikkumar18', 'mustafaozic42', 'rushib97', 'ethwong', 'brsyldrn', 'ahmed.star2025', 'iaaguilera', 'tskroezen', 'aniketsl', 'sven.siegmund', 'max2aneeb', 'navoj98', 'gizemuysal']",29,"['dkurpaska', 'ztoscanini', 'jhennessey', 'lemerson', 'mdelude', 'jrlacroix', 'rmcauliffe11', 'cpeter', 'rtam', 'ricardohenri', 'aksamija', 'lucasguertin', 'eliasphillip', 'oyacteen', 'akaluzny', 'pjaswal', 'rkornitsky', 'markgillespi', 'ctheriault', None, 'dgage', 'liamarasta', 'matthewsarge', 'sgilani', 'komminiadithya', 'nshattuck', 'nmsheridan', 'jpweber', 'ougorji']",420,"['hasanaltintas', 'remsatkan', 'hakan_bicer_96', 'yagaat.smellypitts', 'kritikamna23', 'trinath', 'brekgungor', 'music20011', 'jajung89', 'ozlemsila1', 'shaimaamohamed61195', 'ricardohenri', 'ezgibicak', 'nuri', 'neharikajali', 'salma_hesham', 'abduljalilahmed94', 'covarrubiasjaz05', 'ozlemkrms', 'mhyavuz', 'erenkeskin95', 'chingyinglu89', 'woooney', 'ahmetkaangecer', 'rkornitsky', 'aldoalcantara1', 'markgillespi', 'arthurxavier.engineer', 'zoz', 'joelrc', 'kbkadir', 'mguillen6', 'aniketbhatia2107', 'mohamed3ssam', 'b10104023', 'singhalanirudh18', 'kzm_dmrlnk', 'senaydogn26', 'kemreakkas', 'ali.solak.1996', 'aliercn964', 'julio_c1712', 'alshareefabdulmajeed', 'nmsheridan', 'austinsams', 'mark.hogg131', 'pirojiwalasubham', 'denizcango', 'ahmetdemir', 'acrylonitrile', 'eng.walaagomaaali', 'yojit105', 'ps5014', 'perihansherif', 'harsh05september', 'groever', 'hsncnyhn', 'akashminato1', 'sudhiriitb', 'michaelconnors', 'caner.baydan', 'jhorton19', 'ahmed_devices', 'highlander2475', 'louiscolson', 'rtam', 'hakanburakbalamir1', 'aavasquez2', 'drhodges', 'shashiadi', 'eggacher', 'ryanwood98', 'tugay95', 'bhu01', 'nemadepsn', 'ccheng852', 'simingma', 'phili180296', 'beraatyigit26', 'mattchuaruiyan', 'areeba123', 'dskartal16', 'neildalal', 'feruiz2', 'silicongo7', 'mjmartinez283', 'shubhangb97', 'kewang.ritsumei', 'shangdi1214', 'ezgii0088', 'amira123', 'abhikanse', 'mwong', 'nshattuck', 'yarenturker12', 'shaynesmq', 'kumar_ashutosh', 'jazzminesaif66', 'luisggranadost98', 'coolzach999', 'sanidhya27', 'cngzbdr', 'ayesharashid', 'ssdominguez', 'ingrammyles8', 'gunny.balakrishnan', 'mohamedabdelsalam', 'kubraciloglu', 'manar.ibraheem', 'makyz', 'terryyouknow988', 'acostadavid', 'daliahalmy', 'th3prince', 'esraaahmedabdelaal', 'menginaslan', 'tlordello', 'mustafaenesgner', 'liubenliang', 'khandelwalsanyam87', 'baranoncul', 'shashankti111', 'avinashkmry', 'deraz96', 'alejandro.juvera', 'yassinmahdy', 'saisireesha', 'nado.mahmoud1995', 'fvasquez6', 'wdang', 'hatem.rashwany', 'eliasphillip', 'fang59', 'z.a.guzzardo', 'mcsalasnava', 'akaluzny', 'jesus_aguirre2000', 'timothyobrien', 'safelix', 'yusuf61', 'caranfatma', 'nourhangamal', 'allisontsay', 'omar.handy.96', 'ak83229', 'matthewsarge', 'anonymousbuggy', 'abdurrahmanonuraydin', 'snjkhatri34', 'aesanchez6', 'vivekkandeyang97', 'noel19419', 'ydidwania', 'ougorji', 'rz2405', 'mrryzen', 'nishagb04', 'calebringkob', 'anaselsabagh', 'mgthway', 'mustafaali12', 'mehmetdayioglu', 'lakshyakumarsingh', 'duenes957', 'jhennessey', 'mrinalrao1810', 'osmancanylmz1996', 'liuyuan', 'niamhmulholland', 'hobuobi', 'mauriciofalleiros', 'narendrarai1812', 'axsalomon', 'annasp', 'gonzalez.gaston', 'mayur777', 'resuliseri', 'bekirisgor', 'yerenayas', 'mertsen96', 'dirodriguez4', 'zeyneb', 'darivera3', 'dohaga95', 'elpaglia', 'saarthak', 'enesbas', 'halil26', 'ismailkemal', 'zzhanghuang', 'karimaboelmakarem', 'elijahbarrett22', 'ghanshyam.iitb', 'manny2750', 'abdelrahmanahmedabdelghany', 'demetguull', 'emirhan', 'afrahm104', 'virtuspro', 'yukseltugba14', 'jafar.vafaee', 'swadhasanghvi4', 'raaul.09', 'wassupyo412', 'dkurpaska', 'ztoscanini', 'mrtypc1539', 'mmoody.cma', 'aymanbakr1984.1', 'shiz', 'yigitcilce', 'emilyirisdahl', 'byminc', 'jmclean', 'janmol', 'jasmine1323', 'korhan', 'ahmed.r.elhanafy', 'rapacheco', 'nagidal146', 'bagrania385', 'dgage', 'joeeesalah', 'kirbye1101', 'rashmiravindranath', 'mdj', 'snnnnnnnnnnnn', 'ozgeozdamarr', 'vishwas1020', 'ajitzote', 'ahmedsayedeng1', 'oyacteen', 'ahmetsurucu', 'maged7423', 'eltonlossner', 'archiki', 'srycvk26', 'akashmunda12345', 'apoorvaudikeri', 'danielgetega', 'skucukarabaci', 'adam.kwiatkowski', 'liamarasta', 'mb141', 'mwood', 'nanomelis1996', 'marcusle', 'camakk', 'revez_tmr', '16d070026', 'ibrahimethemtemel', 'saboueleinen', 'betkahraman', 'mohamedabdelmaksoud1096', 'ayane123', 'cigo', 'pmmadhumita9', 'esraa7725334', 'saqibalisidd', 'feyzas26', 'ksselhi', 'steve.meraz', 'moises.navarro0423', 'glenpyeldho', 'guray.izmir95', 'dmertkeskin', 'anshulvermaiitb', 'aspruha.samal', 'sethabhinav89', 'abdelrahman_magdy', 'lovelyever17', 'love465944', 'sahilkumar1900', 'bhuyashi.deka', 'belmaci', 'violantium5', 'edlucero25', 'rsalgado19', 'zzhiye', 'dm94', 'gparra3', 'nicolekf', 'bahadirsonmezisik', 'tugcemekci', 'melikekorkmaz94', 'kaki.krish15', 'ctheriault', None, 'wdoeme93', 'cahidpolat', 'djcastillo', 'ehealey', 'ishitadas1998', 'bugrahansoylu', 'x.ganerdene', 'cacortespliego', 'abdullahaksoy26', 'asrivastava98', 'apoorv0', 'anirudh.singhal', 'ibraheemgalal7', 'menaalfread', 'abeischaos', 'jpweber', 'ruohanjiang7', 'marissasaenger', 'mohammed123', 'hakanburakbalamir', 'monicaadelfahim', 'muratkoc503', 'rodriguez.joaquin.jesus', 'gabatres', 'mahe19851117', 'serhatgn', 'yaoweixie', 'havanbhavsar03', 'hasibeodak', 'shikhar1799', 'charanadipudi', 'ealvarez44', 'manarnegm', 'uygarelmali', 'hegdeananthar', 'jrlacroix', 'jitendraiitb', 'mail.d', 'sukruardali', 'gao401', 'eslamamr', 'aydinturkkan44', 'aksamija', 'saqibali', 'aengingokce', 'ahmed_moustafa_94', 'burcuakts', 'arbaz', 'jacobmeyerson', 'mernaosama40', 'pjaswal', 'kasapreyizz', 'gunesa96', 'eng.baristatar', 'siber', 'aimenevse', 'beratcandan', 'bilginper24', 'cshwethanayak', 'pandeykratvesh', 'rekharavindrar', 'mrmamos31', 'methemfaik', 'timobrien', 'nora171296', 'vineetkotariya', 'sezerguven', 'refiktuzakli', 'betildiz', 'jajurado3', 'kumaradarsh', 'nagranados', 'makala.bailey', 'bilgesukaymaz', 'neeraj.chimankar', 'tanmaypatil1598', 'haydartaskaya', 'mehmetock777', 'mbrk747', 'liamfitzgerald', 'dimplekochar3', 'keszler', 'havich', 'himanshuaswani123', 'lemerson', 'mdelude', 'seg915ept', 'sucheta317', 'rmcauliffe11', 'jblopez2', 'cpeter', 'shehab', 'ibrahimyararoglu', 'riosdaniel2014', 'lucasguertin', 'devanshu', 'gokay.yilmaz', 'roy.mustang.eb', 'minatarek', 'ryckmonster', 'shauryasindhu', 'ccamarillo6732', 'hazalciftcioglu94', 'fdirisaglik', 'navnitkumar1224', 'rabin401', 'abdorady', 'djcruz', 'nadakoga', 'sandor.one', 'juliadavis19', 'pratyushragini', 'ewoudvissers', 'qwerty56', 'jsproviero', 'mguillen7', 'johnrahill1', 'rishikkumar18', 'mustafaozic42', 'rushib97', 'ethwong', 'brsyldrn', 'ahmed.star2025', 'iaaguilera', 'sgilani', 'tskroezen', 'aniketsl', 'sven.siegmund', 'komminiadithya', 'max2aneeb', 'navoj98', 'gizemuysal']"
1,318,391,30,3,"['coolzach999', 'timobrien', 'rz2405']",388,"['hasanaltintas', 'remsatkan', 'hakan_bicer_96', 'yagaat.smellypitts', 'kritikamna23', 'trinath', 'brekgungor', 'music20011', 'jajung89', 'ozlemsila1', 'shaimaamohamed61195', 'ezgibicak', 'nuri', 'neharikajali', 'salma_hesham', 'abduljalilahmed94', 'covarrubiasjaz05', 'ozlemkrms', 'mhyavuz', 'erenkeskin95', 'chingyinglu89', 'woooney', 'ahmetkaangecer', 'aldoalcantara1', 'arthurxavier.engineer', 'zoz', 'joelrc', 'kbkadir', 'mguillen6', 'aniketbhatia2107', 'mohamed3ssam', 'b10104023', 'singhalanirudh18', 'kzm_dmrlnk', 'senaydogn26', 'kemreakkas', 'ali.solak.1996', 'aliercn964', 'julio_c1712', 'alshareefabdulmajeed', 'austinsams', 'mark.hogg131', 'pirojiwalasubham', 'denizcango', 'ahmetdemir', 'acrylonitrile', 'eng.walaagomaaali', 'yojit105', 'ps5014', 'perihansherif', 'harsh05september', 'groever', 'hsncnyhn', 'akashminato1', 'sudhiriitb', 'michaelconnors', 'caner.baydan', 'jhorton19', 'ahmed_devices', 'highlander2475', 'louiscolson', 'hakanburakbalamir1', 'aavasquez2', 'drhodges', 'shashiadi', 'eggacher', 'ryanwood98', 'tugay95', 'bhu01', 'nemadepsn', 'ccheng852', 'simingma', 'phili180296', 'beraatyigit26', 'mattchuaruiyan', 'areeba123', 'dskartal16', 'neildalal', 'feruiz2', 'silicongo7', 'mjmartinez283', 'shubhangb97', 'kewang.ritsumei', 'shangdi1214', 'ezgii0088', 'amira123', 'abhikanse', 'mwong', 'yarenturker12', 'shaynesmq', 'kumar_ashutosh', 'jazzminesaif66', 'luisggranadost98', 'sanidhya27', 'cngzbdr', 'ayesharashid', 'ssdominguez', 'ingrammyles8', 'gunny.balakrishnan', 'mohamedabdelsalam', 'kubraciloglu', 'manar.ibraheem', 'makyz', 'terryyouknow988', 'acostadavid', 'daliahalmy', 'th3prince', 'esraaahmedabdelaal', 'menginaslan', 'tlordello', 'mustafaenesgner', 'liubenliang', 'khandelwalsanyam87', 'baranoncul', 'shashankti111', 'avinashkmry', 'deraz96', 'alejandro.juvera', 'yassinmahdy', 'saisireesha', 'nado.mahmoud1995', 'fvasquez6', 'wdang', 'hatem.rashwany', 'fang59', 'z.a.guzzardo', 'mcsalasnava', 'jesus_aguirre2000', 'timothyobrien', 'safelix', 'yusuf61', 'caranfatma', 'nourhangamal', 'allisontsay', 'omar.handy.96', 'ak83229', 'anonymousbuggy', 'abdurrahmanonuraydin', 'snjkhatri34', 'aesanchez6', 'vivekkandeyang97', 'noel19419', 'ydidwania', 'mrryzen', 'nishagb04', 'calebringkob', 'anaselsabagh', 'mgthway', 'mustafaali12', 'mehmetdayioglu', 'lakshyakumarsingh', 'duenes957', 'mrinalrao1810', 'osmancanylmz1996', 'liuyuan', 'niamhmulholland', 'hobuobi', 'mauriciofalleiros', 'narendrarai1812', 'axsalomon', 'annasp', 'gonzalez.gaston', 'mayur777', 'resuliseri', 'bekirisgor', 'yerenayas', 'mertsen96', 'dirodriguez4', 'zeyneb', 'darivera3', 'dohaga95', 'elpaglia', 'saarthak', 'enesbas', 'halil26', 'ismailkemal', 'zzhanghuang', 'karimaboelmakarem', 'elijahbarrett22', 'ghanshyam.iitb', 'manny2750', 'abdelrahmanahmedabdelghany', 'demetguull', 'emirhan', 'afrahm104', 'virtuspro', 'yukseltugba14', 'jafar.vafaee', 'swadhasanghvi4', 'raaul.09', 'wassupyo412', 'mrtypc1539', 'mmoody.cma', 'aymanbakr1984.1', 'shiz', 'yigitcilce', 'emilyirisdahl', 'byminc', 'jmclean', 'janmol', 'jasmine1323', 'korhan', 'ahmed.r.elhanafy', 'rapacheco', 'nagidal146', 'bagrania385', 'joeeesalah', 'kirbye1101', 'rashmiravindranath', 'mdj', 'snnnnnnnnnnnn', 'ozgeozdamarr', 'vishwas1020', 'ajitzote', 'ahmedsayedeng1', 'ahmetsurucu', 'maged7423', 'eltonlossner', 'archiki', 'srycvk26', 'akashmunda12345', 'apoorvaudikeri', 'danielgetega', 'skucukarabaci', 'adam.kwiatkowski', 'mb141', 'mwood', 'nanomelis1996', 'marcusle', 'camakk', 'revez_tmr', '16d070026', 'ibrahimethemtemel', 'saboueleinen', 'betkahraman', 'mohamedabdelmaksoud1096', 'ayane123', 'cigo', 'pmmadhumita9', 'esraa7725334', 'saqibalisidd', 'feyzas26', 'ksselhi', 'steve.meraz', 'moises.navarro0423', 'glenpyeldho', 'guray.izmir95', 'dmertkeskin', 'anshulvermaiitb', 'aspruha.samal', 'sethabhinav89', 'abdelrahman_magdy', 'lovelyever17', 'love465944', 'sahilkumar1900', 'bhuyashi.deka', 'belmaci', 'violantium5', 'edlucero25', 'rsalgado19', 'zzhiye', 'dm94', 'gparra3', 'nicolekf', 'bahadirsonmezisik', 'tugcemekci', 'melikekorkmaz94', 'kaki.krish15', 'wdoeme93', 'cahidpolat', 'djcastillo', 'ehealey', 'ishitadas1998', 'bugrahansoylu', 'x.ganerdene', 'cacortespliego', 'abdullahaksoy26', 'asrivastava98', 'apoorv0', 'anirudh.singhal', 'ibraheemgalal7', 'menaalfread', 'abeischaos', 'ruohanjiang7', 'marissasaenger', 'mohammed123', 'hakanburakbalamir', 'monicaadelfahim', 'muratkoc503', 'rodriguez.joaquin.jesus', 'gabatres', 'mahe19851117', 'serhatgn', 'yaoweixie', 'havanbhavsar03', 'hasibeodak', 'shikhar1799', 'charanadipudi', 'ealvarez44', 'manarnegm', 'uygarelmali', 'hegdeananthar', 'jitendraiitb', 'mail.d', 'sukruardali', 'gao401', 'eslamamr', 'aydinturkkan44', 'saqibali', 'aengingokce', 'ahmed_moustafa_94', 'burcuakts', 'arbaz', 'jacobmeyerson', 'mernaosama40', 'kasapreyizz', 'gunesa96', 'eng.baristatar', 'siber', 'aimenevse', 'beratcandan', 'bilginper24', 'cshwethanayak', 'pandeykratvesh', 'rekharavindrar', 'mrmamos31', 'methemfaik', 'nora171296', 'vineetkotariya', 'sezerguven', 'refiktuzakli', 'betildiz', 'jajurado3', 'kumaradarsh', 'nagranados', 'makala.bailey', 'bilgesukaymaz', 'neeraj.chimankar', 'tanmaypatil1598', 'haydartaskaya', 'mehmetock777', 'mbrk747', 'liamfitzgerald', 'dimplekochar3', 'keszler', 'havich', 'himanshuaswani123', 'seg915ept', 'sucheta317', 'jblopez2', 'shehab', 'ibrahimyararoglu', 'riosdaniel2014', 'devanshu', 'gokay.yilmaz', 'roy.mustang.eb', 'minatarek', 'ryckmonster', 'shauryasindhu', 'ccamarillo6732', 'hazalciftcioglu94', 'fdirisaglik', 'navnitkumar1224', 'rabin401', 'abdorady', 'djcruz', 'nadakoga', 'sandor.one', 'juliadavis19', 'pratyushragini', 'ewoudvissers', 'qwerty56', 'jsproviero', 'mguillen7', 'johnrahill1', 'rishikkumar18', 'mustafaozic42', 'rushib97', 'ethwong', 'brsyldrn', 'ahmed.star2025', 'iaaguilera', 'tskroezen', 'aniketsl', 'sven.siegmund', 'max2aneeb', 'navoj98', 'gizemuysal']",27,"['johnnyliinfo', 'jer2201', 'agutierrez', 'mak2254', 'asg2189', 'wdm2114', 'mm4764', 'hl3114', 'ibk2110', 'jon2104', 'jp3747', 'mag2293', 'jw3350', 'jg3910', 'ds3628', 'pcf2111', 'st3113', 'ldp2128', 'bab2210', 'nrs2156', None, 'mab2397', 'laf2175', 'mh14532', 'cs3647', 'ra2910', 'jm4304']",418,"['hasanaltintas', 'remsatkan', 'hakan_bicer_96', 'yagaat.smellypitts', 'kritikamna23', 'trinath', 'brekgungor', 'music20011', 'jajung89', 'ozlemsila1', 'shaimaamohamed61195', 'ezgibicak', 'nuri', 'neharikajali', 'salma_hesham', 'abduljalilahmed94', 'covarrubiasjaz05', 'ozlemkrms', 'jw3350', 'mhyavuz', 'erenkeskin95', 'chingyinglu89', 'pcf2111', 'woooney', 'ahmetkaangecer', 'aldoalcantara1', 'arthurxavier.engineer', 'zoz', 'joelrc', 'kbkadir', 'mguillen6', 'aniketbhatia2107', 'mohamed3ssam', 'b10104023', 'singhalanirudh18', 'kzm_dmrlnk', 'senaydogn26', 'kemreakkas', 'ali.solak.1996', 'aliercn964', 'julio_c1712', 'alshareefabdulmajeed', 'mh14532', 'austinsams', 'mark.hogg131', 'pirojiwalasubham', 'denizcango', 'ahmetdemir', 'acrylonitrile', 'eng.walaagomaaali', 'yojit105', 'ps5014', 'perihansherif', 'harsh05september', 'groever', 'hsncnyhn', 'akashminato1', 'hl3114', 'sudhiriitb', 'michaelconnors', 'caner.baydan', 'jhorton19', 'ahmed_devices', 'highlander2475', 'louiscolson', 'hakanburakbalamir1', 'aavasquez2', 'drhodges', 'shashiadi', 'eggacher', 'ryanwood98', 'tugay95', 'bhu01', 'nemadepsn', 'ccheng852', 'simingma', 'phili180296', 'beraatyigit26', 'mattchuaruiyan', 'areeba123', 'dskartal16', 'neildalal', 'st3113', 'feruiz2', 'silicongo7', 'mjmartinez283', 'shubhangb97', 'kewang.ritsumei', 'mab2397', 'shangdi1214', 'ezgii0088', 'amira123', 'abhikanse', 'mwong', 'yarenturker12', 'ra2910', 'shaynesmq', 'kumar_ashutosh', 'jazzminesaif66', 'luisggranadost98', 'coolzach999', 'sanidhya27', 'cngzbdr', 'ayesharashid', 'ssdominguez', 'ingrammyles8', 'gunny.balakrishnan', 'mohamedabdelsalam', 'kubraciloglu', 'asg2189', 'manar.ibraheem', 'makyz', 'terryyouknow988', 'acostadavid', 'daliahalmy', 'th3prince', 'esraaahmedabdelaal', 'menginaslan', 'tlordello', 'mustafaenesgner', 'liubenliang', 'khandelwalsanyam87', 'baranoncul', 'shashankti111', 'avinashkmry', 'deraz96', 'alejandro.juvera', 'yassinmahdy', 'mag2293', 'saisireesha', 'nado.mahmoud1995', 'fvasquez6', 'wdang', 'hatem.rashwany', 'fang59', 'z.a.guzzardo', 'mcsalasnava', 'jesus_aguirre2000', 'timothyobrien', 'safelix', 'yusuf61', 'ldp2128', 'caranfatma', 'nourhangamal', 'allisontsay', 'omar.handy.96', 'ak83229', 'anonymousbuggy', 'abdurrahmanonuraydin', 'snjkhatri34', 'aesanchez6', 'vivekkandeyang97', 'noel19419', 'ydidwania', 'rz2405', 'jm4304', 'mrryzen', 'nishagb04', 'calebringkob', 'anaselsabagh', 'mgthway', 'agutierrez', 'mustafaali12', 'mehmetdayioglu', 'lakshyakumarsingh', 'duenes957', 'mrinalrao1810', 'osmancanylmz1996', 'liuyuan', 'niamhmulholland', 'hobuobi', 'mauriciofalleiros', 'narendrarai1812', 'axsalomon', 'annasp', 'gonzalez.gaston', 'mayur777', 'resuliseri', 'bekirisgor', 'yerenayas', 'mertsen96', 'dirodriguez4', 'zeyneb', 'darivera3', 'dohaga95', 'bab2210', 'elpaglia', 'saarthak', 'enesbas', 'halil26', 'ismailkemal', 'zzhanghuang', 'nrs2156', 'karimaboelmakarem', 'elijahbarrett22', 'ghanshyam.iitb', 'manny2750', 'abdelrahmanahmedabdelghany', 'demetguull', 'emirhan', 'afrahm104', 'virtuspro', 'yukseltugba14', 'jafar.vafaee', 'swadhasanghvi4', 'raaul.09', 'wassupyo412', 'mrtypc1539', 'mmoody.cma', 'aymanbakr1984.1', 'shiz', 'yigitcilce', 'emilyirisdahl', 'byminc', 'jmclean', 'janmol', 'jasmine1323', 'korhan', 'ahmed.r.elhanafy', 'rapacheco', 'nagidal146', 'bagrania385', 'joeeesalah', 'kirbye1101', 'rashmiravindranath', 'mdj', 'snnnnnnnnnnnn', 'ozgeozdamarr', 'vishwas1020', 'ajitzote', 'ahmedsayedeng1', 'ds3628', 'ahmetsurucu', 'maged7423', 'eltonlossner', 'archiki', 'srycvk26', 'akashmunda12345', 'apoorvaudikeri', 'danielgetega', 'skucukarabaci', 'adam.kwiatkowski', 'mb141', 'mwood', 'nanomelis1996', 'marcusle', 'camakk', 'revez_tmr', '16d070026', 'ibrahimethemtemel', 'saboueleinen', 'betkahraman', 'johnnyliinfo', 'jer2201', 'mohamedabdelmaksoud1096', 'ayane123', 'mak2254', 'cigo', 'pmmadhumita9', 'esraa7725334', 'mm4764', 'saqibalisidd', 'feyzas26', 'ksselhi', 'steve.meraz', 'moises.navarro0423', 'jp3747', 'glenpyeldho', 'guray.izmir95', 'dmertkeskin', 'anshulvermaiitb', 'jg3910', 'aspruha.samal', 'sethabhinav89', 'abdelrahman_magdy', 'lovelyever17', 'love465944', 'sahilkumar1900', 'bhuyashi.deka', 'belmaci', 'violantium5', 'edlucero25', 'rsalgado19', 'zzhiye', 'dm94', 'gparra3', 'nicolekf', 'bahadirsonmezisik', 'tugcemekci', 'melikekorkmaz94', 'kaki.krish15', None, 'wdoeme93', 'cahidpolat', 'djcastillo', 'ehealey', 'ishitadas1998', 'bugrahansoylu', 'x.ganerdene', 'cacortespliego', 'abdullahaksoy26', 'asrivastava98', 'apoorv0', 'anirudh.singhal', 'ibraheemgalal7', 'menaalfread', 'abeischaos', 'ruohanjiang7', 'marissasaenger', 'mohammed123', 'hakanburakbalamir', 'laf2175', 'monicaadelfahim', 'muratkoc503', 'rodriguez.joaquin.jesus', 'gabatres', 'mahe19851117', 'serhatgn', 'yaoweixie', 'havanbhavsar03', 'hasibeodak', 'shikhar1799', 'charanadipudi', 'ealvarez44', 'manarnegm', 'uygarelmali', 'hegdeananthar', 'jitendraiitb', 'ibk2110', 'mail.d', 'sukruardali', 'gao401', 'eslamamr', 'aydinturkkan44', 'saqibali', 'aengingokce', 'ahmed_moustafa_94', 'burcuakts', 'arbaz', 'jacobmeyerson', 'mernaosama40', 'kasapreyizz', 'gunesa96', 'eng.baristatar', 'siber', 'aimenevse', 'beratcandan', 'bilginper24', 'cshwethanayak', 'pandeykratvesh', 'rekharavindrar', 'mrmamos31', 'methemfaik', 'timobrien', 'nora171296', 'vineetkotariya', 'sezerguven', 'refiktuzakli', 'betildiz', 'jajurado3', 'kumaradarsh', 'cs3647', 'nagranados', 'makala.bailey', 'bilgesukaymaz', 'neeraj.chimankar', 'tanmaypatil1598', 'haydartaskaya', 'mehmetock777', 'mbrk747', 'liamfitzgerald', 'dimplekochar3', 'keszler', 'havich', 'himanshuaswani123', 'wdm2114', 'seg915ept', 'sucheta317', 'jblopez2', 'shehab', 'jon2104', 'ibrahimyararoglu', 'riosdaniel2014', 'devanshu', 'gokay.yilmaz', 'roy.mustang.eb', 'minatarek', 'ryckmonster', 'shauryasindhu', 'ccamarillo6732', 'hazalciftcioglu94', 'fdirisaglik', 'navnitkumar1224', 'rabin401', 'abdorady', 'djcruz', 'nadakoga', 'sandor.one', 'juliadavis19', 'pratyushragini', 'ewoudvissers', 'qwerty56', 'jsproviero', 'mguillen7', 'johnrahill1', 'rishikkumar18', 'mustafaozic42', 'rushib97', 'ethwong', 'brsyldrn', 'ahmed.star2025', 'iaaguilera', 'tskroezen', 'aniketsl', 'sven.siegmund', 'max2aneeb', 'navoj98', 'gizemuysal']"
1,233,391,29,24,"['swadhasanghvi4', 'sanidhya27', 'nishagb04', 'dimplekochar3', 'harsh05september', 'lakshyakumarsingh', 'sudhiriitb', 'ksselhi', 'jitendraiitb', 'khandelwalsanyam87', 'devanshu', 'anshulvermaiitb', 'nemadepsn', 'sahilkumar1900', 'neildalal', 'shubhangb97', 'qwerty56', 'ak83229', 'aniketbhatia2107', 'ishitadas1998', 'anirudh.singhal', 'vineetkotariya', 'abhikanse', 'navoj98']",367,"['hasanaltintas', 'remsatkan', 'hakan_bicer_96', 'yagaat.smellypitts', 'kritikamna23', 'trinath', 'brekgungor', 'music20011', 'jajung89', 'ozlemsila1', 'shaimaamohamed61195', 'ezgibicak', 'nuri', 'neharikajali', 'salma_hesham', 'abduljalilahmed94', 'covarrubiasjaz05', 'ozlemkrms', 'mhyavuz', 'erenkeskin95', 'chingyinglu89', 'woooney', 'ahmetkaangecer', 'aldoalcantara1', 'arthurxavier.engineer', 'zoz', 'joelrc', 'kbkadir', 'mguillen6', 'mohamed3ssam', 'b10104023', 'singhalanirudh18', 'kzm_dmrlnk', 'senaydogn26', 'kemreakkas', 'ali.solak.1996', 'aliercn964', 'julio_c1712', 'alshareefabdulmajeed', 'austinsams', 'mark.hogg131', 'pirojiwalasubham', 'denizcango', 'ahmetdemir', 'acrylonitrile', 'eng.walaagomaaali', 'yojit105', 'ps5014', 'perihansherif', 'groever', 'hsncnyhn', 'akashminato1', 'michaelconnors', 'caner.baydan', 'jhorton19', 'ahmed_devices', 'highlander2475', 'louiscolson', 'hakanburakbalamir1', 'aavasquez2', 'drhodges', 'shashiadi', 'eggacher', 'ryanwood98', 'tugay95', 'bhu01', 'ccheng852', 'simingma', 'phili180296', 'beraatyigit26', 'mattchuaruiyan', 'areeba123', 'dskartal16', 'feruiz2', 'silicongo7', 'mjmartinez283', 'kewang.ritsumei', 'shangdi1214', 'ezgii0088', 'amira123', 'mwong', 'yarenturker12', 'shaynesmq', 'kumar_ashutosh', 'jazzminesaif66', 'luisggranadost98', 'coolzach999', 'cngzbdr', 'ayesharashid', 'ssdominguez', 'ingrammyles8', 'gunny.balakrishnan', 'mohamedabdelsalam', 'kubraciloglu', 'manar.ibraheem', 'makyz', 'terryyouknow988', 'acostadavid', 'daliahalmy', 'th3prince', 'esraaahmedabdelaal', 'menginaslan', 'tlordello', 'mustafaenesgner', 'liubenliang', 'baranoncul', 'shashankti111', 'avinashkmry', 'deraz96', 'alejandro.juvera', 'yassinmahdy', 'saisireesha', 'nado.mahmoud1995', 'fvasquez6', 'wdang', 'hatem.rashwany', 'fang59', 'z.a.guzzardo', 'mcsalasnava', 'jesus_aguirre2000', 'timothyobrien', 'safelix', 'yusuf61', 'caranfatma', 'nourhangamal', 'allisontsay', 'omar.handy.96', 'anonymousbuggy', 'abdurrahmanonuraydin', 'snjkhatri34', 'aesanchez6', 'vivekkandeyang97', 'noel19419', 'ydidwania', 'rz2405', 'mrryzen', 'calebringkob', 'anaselsabagh', 'mgthway', 'mustafaali12', 'mehmetdayioglu', 'duenes957', 'mrinalrao1810', 'osmancanylmz1996', 'liuyuan', 'niamhmulholland', 'hobuobi', 'mauriciofalleiros', 'narendrarai1812', 'axsalomon', 'annasp', 'gonzalez.gaston', 'mayur777', 'resuliseri', 'bekirisgor', 'yerenayas', 'mertsen96', 'dirodriguez4', 'zeyneb', 'darivera3', 'dohaga95', 'elpaglia', 'saarthak', 'enesbas', 'halil26', 'ismailkemal', 'zzhanghuang', 'karimaboelmakarem', 'elijahbarrett22', 'ghanshyam.iitb', 'manny2750', 'abdelrahmanahmedabdelghany', 'demetguull', 'emirhan', 'afrahm104', 'virtuspro', 'yukseltugba14', 'jafar.vafaee', 'raaul.09', 'wassupyo412', 'mrtypc1539', 'mmoody.cma', 'aymanbakr1984.1', 'shiz', 'yigitcilce', 'emilyirisdahl', 'byminc', 'jmclean', 'janmol', 'jasmine1323', 'korhan', 'ahmed.r.elhanafy', 'rapacheco', 'nagidal146', 'bagrania385', 'joeeesalah', 'kirbye1101', 'rashmiravindranath', 'mdj', 'snnnnnnnnnnnn', 'ozgeozdamarr', 'vishwas1020', 'ajitzote', 'ahmedsayedeng1', 'ahmetsurucu', 'maged7423', 'eltonlossner', 'archiki', 'srycvk26', 'akashmunda12345', 'apoorvaudikeri', 'danielgetega', 'skucukarabaci', 'adam.kwiatkowski', 'mb141', 'mwood', 'nanomelis1996', 'marcusle', 'camakk', 'revez_tmr', '16d070026', 'ibrahimethemtemel', 'saboueleinen', 'betkahraman', 'mohamedabdelmaksoud1096', 'ayane123', 'cigo', 'pmmadhumita9', 'esraa7725334', 'saqibalisidd', 'feyzas26', 'steve.meraz', 'moises.navarro0423', 'glenpyeldho', 'guray.izmir95', 'dmertkeskin', 'aspruha.samal', 'sethabhinav89', 'abdelrahman_magdy', 'lovelyever17', 'love465944', 'bhuyashi.deka', 'belmaci', 'violantium5', 'edlucero25', 'rsalgado19', 'zzhiye', 'dm94', 'gparra3', 'nicolekf', 'bahadirsonmezisik', 'tugcemekci', 'melikekorkmaz94', 'kaki.krish15', 'wdoeme93', 'cahidpolat', 'djcastillo', 'ehealey', 'bugrahansoylu', 'x.ganerdene', 'cacortespliego', 'abdullahaksoy26', 'asrivastava98', 'apoorv0', 'ibraheemgalal7', 'menaalfread', 'abeischaos', 'ruohanjiang7', 'marissasaenger', 'mohammed123', 'hakanburakbalamir', 'monicaadelfahim', 'muratkoc503', 'rodriguez.joaquin.jesus', 'gabatres', 'mahe19851117', 'serhatgn', 'yaoweixie', 'havanbhavsar03', 'hasibeodak', 'shikhar1799', 'charanadipudi', 'ealvarez44', 'manarnegm', 'uygarelmali', 'hegdeananthar', 'mail.d', 'sukruardali', 'gao401', 'eslamamr', 'aydinturkkan44', 'saqibali', 'aengingokce', 'ahmed_moustafa_94', 'burcuakts', 'arbaz', 'jacobmeyerson', 'mernaosama40', 'kasapreyizz', 'gunesa96', 'eng.baristatar', 'siber', 'aimenevse', 'beratcandan', 'bilginper24', 'cshwethanayak', 'pandeykratvesh', 'rekharavindrar', 'mrmamos31', 'methemfaik', 'timobrien', 'nora171296', 'sezerguven', 'refiktuzakli', 'betildiz', 'jajurado3', 'kumaradarsh', 'nagranados', 'makala.bailey', 'bilgesukaymaz', 'neeraj.chimankar', 'tanmaypatil1598', 'haydartaskaya', 'mehmetock777', 'mbrk747', 'liamfitzgerald', 'keszler', 'havich', 'himanshuaswani123', 'seg915ept', 'sucheta317', 'jblopez2', 'shehab', 'ibrahimyararoglu', 'riosdaniel2014', 'gokay.yilmaz', 'roy.mustang.eb', 'minatarek', 'ryckmonster', 'shauryasindhu', 'ccamarillo6732', 'hazalciftcioglu94', 'fdirisaglik', 'navnitkumar1224', 'rabin401', 'abdorady', 'djcruz', 'nadakoga', 'sandor.one', 'juliadavis19', 'pratyushragini', 'ewoudvissers', 'jsproviero', 'mguillen7', 'johnrahill1', 'rishikkumar18', 'mustafaozic42', 'rushib97', 'ethwong', 'brsyldrn', 'ahmed.star2025', 'iaaguilera', 'tskroezen', 'aniketsl', 'sven.siegmund', 'max2aneeb', 'gizemuysal']",5,"['devesh1102', 'ishank', 'prnair', None, '28dhruv.varshney']",396,"['hasanaltintas', 'remsatkan', 'hakan_bicer_96', 'yagaat.smellypitts', 'kritikamna23', 'trinath', 'brekgungor', 'music20011', 'jajung89', 'ozlemsila1', 'shaimaamohamed61195', 'ezgibicak', 'nuri', 'neharikajali', 'salma_hesham', 'abduljalilahmed94', 'covarrubiasjaz05', 'ozlemkrms', 'mhyavuz', 'erenkeskin95', 'chingyinglu89', 'woooney', 'ahmetkaangecer', 'aldoalcantara1', 'arthurxavier.engineer', 'zoz', 'joelrc', 'kbkadir', 'mguillen6', 'aniketbhatia2107', 'mohamed3ssam', 'b10104023', 'singhalanirudh18', 'kzm_dmrlnk', 'senaydogn26', 'kemreakkas', 'ali.solak.1996', 'aliercn964', 'julio_c1712', 'alshareefabdulmajeed', 'austinsams', 'mark.hogg131', 'pirojiwalasubham', 'denizcango', 'ahmetdemir', 'acrylonitrile', 'eng.walaagomaaali', 'yojit105', 'ps5014', 'perihansherif', 'harsh05september', 'groever', 'hsncnyhn', 'akashminato1', 'sudhiriitb', 'michaelconnors', 'caner.baydan', 'jhorton19', 'ahmed_devices', 'highlander2475', 'louiscolson', 'hakanburakbalamir1', 'aavasquez2', 'drhodges', 'shashiadi', 'eggacher', 'ryanwood98', 'tugay95', 'bhu01', 'nemadepsn', 'ccheng852', 'simingma', 'phili180296', 'beraatyigit26', 'mattchuaruiyan', 'areeba123', 'dskartal16', 'neildalal', 'feruiz2', 'silicongo7', 'mjmartinez283', 'shubhangb97', 'kewang.ritsumei', 'shangdi1214', 'ezgii0088', 'amira123', 'abhikanse', 'mwong', 'yarenturker12', 'shaynesmq', 'kumar_ashutosh', 'jazzminesaif66', 'luisggranadost98', 'coolzach999', 'sanidhya27', 'cngzbdr', 'ayesharashid', 'ssdominguez', 'ingrammyles8', 'gunny.balakrishnan', 'mohamedabdelsalam', 'kubraciloglu', 'manar.ibraheem', 'ishank', 'makyz', 'terryyouknow988', 'acostadavid', 'daliahalmy', 'th3prince', 'esraaahmedabdelaal', 'menginaslan', 'tlordello', 'mustafaenesgner', 'liubenliang', 'khandelwalsanyam87', 'baranoncul', 'shashankti111', 'avinashkmry', 'deraz96', 'alejandro.juvera', 'yassinmahdy', 'saisireesha', 'nado.mahmoud1995', 'fvasquez6', 'wdang', 'hatem.rashwany', 'fang59', 'z.a.guzzardo', 'mcsalasnava', 'jesus_aguirre2000', 'timothyobrien', 'safelix', 'yusuf61', 'caranfatma', 'nourhangamal', 'allisontsay', 'omar.handy.96', 'ak83229', 'anonymousbuggy', 'abdurrahmanonuraydin', 'snjkhatri34', 'aesanchez6', 'vivekkandeyang97', 'noel19419', 'ydidwania', 'rz2405', 'mrryzen', 'nishagb04', 'calebringkob', 'anaselsabagh', 'mgthway', 'mustafaali12', 'mehmetdayioglu', 'lakshyakumarsingh', 'duenes957', 'mrinalrao1810', 'osmancanylmz1996', 'liuyuan', 'niamhmulholland', 'hobuobi', 'mauriciofalleiros', 'narendrarai1812', 'axsalomon', 'annasp', 'gonzalez.gaston', 'mayur777', 'resuliseri', 'bekirisgor', 'yerenayas', 'mertsen96', 'dirodriguez4', 'zeyneb', 'darivera3', 'dohaga95', 'elpaglia', 'saarthak', 'enesbas', 'halil26', 'ismailkemal', 'zzhanghuang', 'prnair', 'karimaboelmakarem', 'elijahbarrett22', 'ghanshyam.iitb', 'manny2750', 'abdelrahmanahmedabdelghany', 'demetguull', 'emirhan', 'afrahm104', 'virtuspro', 'yukseltugba14', 'jafar.vafaee', 'swadhasanghvi4', 'raaul.09', 'wassupyo412', 'mrtypc1539', 'mmoody.cma', 'aymanbakr1984.1', 'shiz', 'yigitcilce', 'emilyirisdahl', 'byminc', 'jmclean', 'janmol', 'jasmine1323', 'korhan', 'ahmed.r.elhanafy', 'rapacheco', 'nagidal146', 'bagrania385', 'joeeesalah', 'kirbye1101', 'rashmiravindranath', 'mdj', 'snnnnnnnnnnnn', 'ozgeozdamarr', 'vishwas1020', 'ajitzote', 'ahmedsayedeng1', 'ahmetsurucu', 'maged7423', 'eltonlossner', 'archiki', 'srycvk26', 'akashmunda12345', 'apoorvaudikeri', 'danielgetega', 'skucukarabaci', 'adam.kwiatkowski', 'mb141', 'mwood', 'nanomelis1996', 'marcusle', 'camakk', 'revez_tmr', '16d070026', 'ibrahimethemtemel', 'saboueleinen', 'betkahraman', 'devesh1102', 'mohamedabdelmaksoud1096', 'ayane123', 'cigo', 'pmmadhumita9', 'esraa7725334', 'saqibalisidd', 'feyzas26', 'ksselhi', 'steve.meraz', 'moises.navarro0423', 'glenpyeldho', 'guray.izmir95', 'dmertkeskin', 'anshulvermaiitb', 'aspruha.samal', 'sethabhinav89', 'abdelrahman_magdy', 'lovelyever17', 'love465944', 'sahilkumar1900', 'bhuyashi.deka', 'belmaci', 'violantium5', 'edlucero25', 'rsalgado19', 'zzhiye', 'dm94', 'gparra3', 'nicolekf', 'bahadirsonmezisik', 'tugcemekci', 'melikekorkmaz94', 'kaki.krish15', None, 'wdoeme93', 'cahidpolat', 'djcastillo', 'ehealey', 'ishitadas1998', 'bugrahansoylu', 'x.ganerdene', 'cacortespliego', 'abdullahaksoy26', 'asrivastava98', 'apoorv0', 'anirudh.singhal', 'ibraheemgalal7', 'menaalfread', 'abeischaos', 'ruohanjiang7', 'marissasaenger', 'mohammed123', 'hakanburakbalamir', 'monicaadelfahim', 'muratkoc503', 'rodriguez.joaquin.jesus', 'gabatres', 'mahe19851117', 'serhatgn', 'yaoweixie', 'havanbhavsar03', 'hasibeodak', 'shikhar1799', 'charanadipudi', 'ealvarez44', 'manarnegm', 'uygarelmali', 'hegdeananthar', 'jitendraiitb', 'mail.d', 'sukruardali', 'gao401', 'eslamamr', 'aydinturkkan44', 'saqibali', 'aengingokce', 'ahmed_moustafa_94', 'burcuakts', 'arbaz', 'jacobmeyerson', 'mernaosama40', 'kasapreyizz', 'gunesa96', 'eng.baristatar', 'siber', 'aimenevse', 'beratcandan', 'bilginper24', 'cshwethanayak', 'pandeykratvesh', '28dhruv.varshney', 'rekharavindrar', 'mrmamos31', 'methemfaik', 'timobrien', 'nora171296', 'vineetkotariya', 'sezerguven', 'refiktuzakli', 'betildiz', 'jajurado3', 'kumaradarsh', 'nagranados', 'makala.bailey', 'bilgesukaymaz', 'neeraj.chimankar', 'tanmaypatil1598', 'haydartaskaya', 'mehmetock777', 'mbrk747', 'liamfitzgerald', 'dimplekochar3', 'keszler', 'havich', 'himanshuaswani123', 'seg915ept', 'sucheta317', 'jblopez2', 'shehab', 'ibrahimyararoglu', 'riosdaniel2014', 'devanshu', 'gokay.yilmaz', 'roy.mustang.eb', 'minatarek', 'ryckmonster', 'shauryasindhu', 'ccamarillo6732', 'hazalciftcioglu94', 'fdirisaglik', 'navnitkumar1224', 'rabin401', 'abdorady', 'djcruz', 'nadakoga', 'sandor.one', 'juliadavis19', 'pratyushragini', 'ewoudvissers', 'qwerty56', 'jsproviero', 'mguillen7', 'johnrahill1', 'rishikkumar18', 'mustafaozic42', 'rushib97', 'ethwong', 'brsyldrn', 'ahmed.star2025', 'iaaguilera', 'tskroezen', 'aniketsl', 'sven.siegmund', 'max2aneeb', 'navoj98', 'gizemuysal']"
1,310,391,27,25,"['hasanaltintas', 'cngzbdr', 'remsatkan', 'serhatgn', 'kubraciloglu', 'uygarelmali', 'caner.baydan', 'aydinturkkan44', 'ozlemkrms', 'hazalciftcioglu94', 'zeyneb', 'erenkeskin95', 'ahmetsurucu', 'kasapreyizz', 'yusuf61', 'enesbas', 'cahidpolat', 'sezerguven', 'virtuspro', 'aliercn964', 'bilgesukaymaz', 'ibrahimethemtemel', 'yukseltugba14', 'gizemuysal', 'hakanburakbalamir']",366,"['hakan_bicer_96', 'yagaat.smellypitts', 'kritikamna23', 'trinath', 'brekgungor', 'music20011', 'jajung89', 'ozlemsila1', 'shaimaamohamed61195', 'ezgibicak', 'nuri', 'neharikajali', 'salma_hesham', 'abduljalilahmed94', 'covarrubiasjaz05', 'mhyavuz', 'chingyinglu89', 'woooney', 'ahmetkaangecer', 'aldoalcantara1', 'arthurxavier.engineer', 'zoz', 'joelrc', 'kbkadir', 'mguillen6', 'aniketbhatia2107', 'mohamed3ssam', 'b10104023', 'singhalanirudh18', 'kzm_dmrlnk', 'senaydogn26', 'kemreakkas', 'ali.solak.1996', 'julio_c1712', 'alshareefabdulmajeed', 'austinsams', 'mark.hogg131', 'pirojiwalasubham', 'denizcango', 'ahmetdemir', 'acrylonitrile', 'eng.walaagomaaali', 'yojit105', 'ps5014', 'perihansherif', 'harsh05september', 'groever', 'hsncnyhn', 'akashminato1', 'sudhiriitb', 'michaelconnors', 'jhorton19', 'ahmed_devices', 'highlander2475', 'louiscolson', 'hakanburakbalamir1', 'aavasquez2', 'drhodges', 'shashiadi', 'eggacher', 'ryanwood98', 'tugay95', 'bhu01', 'nemadepsn', 'ccheng852', 'simingma', 'phili180296', 'beraatyigit26', 'mattchuaruiyan', 'areeba123', 'dskartal16', 'neildalal', 'feruiz2', 'silicongo7', 'mjmartinez283', 'shubhangb97', 'kewang.ritsumei', 'shangdi1214', 'ezgii0088', 'amira123', 'abhikanse', 'mwong', 'yarenturker12', 'shaynesmq', 'kumar_ashutosh', 'jazzminesaif66', 'luisggranadost98', 'coolzach999', 'sanidhya27', 'ayesharashid', 'ssdominguez', 'ingrammyles8', 'gunny.balakrishnan', 'mohamedabdelsalam', 'manar.ibraheem', 'makyz', 'terryyouknow988', 'acostadavid', 'daliahalmy', 'th3prince', 'esraaahmedabdelaal', 'menginaslan', 'tlordello', 'mustafaenesgner', 'liubenliang', 'khandelwalsanyam87', 'baranoncul', 'shashankti111', 'avinashkmry', 'deraz96', 'alejandro.juvera', 'yassinmahdy', 'saisireesha', 'nado.mahmoud1995', 'fvasquez6', 'wdang', 'hatem.rashwany', 'fang59', 'z.a.guzzardo', 'mcsalasnava', 'jesus_aguirre2000', 'timothyobrien', 'safelix', 'caranfatma', 'nourhangamal', 'allisontsay', 'omar.handy.96', 'ak83229', 'anonymousbuggy', 'abdurrahmanonuraydin', 'snjkhatri34', 'aesanchez6', 'vivekkandeyang97', 'noel19419', 'ydidwania', 'rz2405', 'mrryzen', 'nishagb04', 'calebringkob', 'anaselsabagh', 'mgthway', 'mustafaali12', 'mehmetdayioglu', 'lakshyakumarsingh', 'duenes957', 'mrinalrao1810', 'osmancanylmz1996', 'liuyuan', 'niamhmulholland', 'hobuobi', 'mauriciofalleiros', 'narendrarai1812', 'axsalomon', 'annasp', 'gonzalez.gaston', 'mayur777', 'resuliseri', 'bekirisgor', 'yerenayas', 'mertsen96', 'dirodriguez4', 'darivera3', 'dohaga95', 'elpaglia', 'saarthak', 'halil26', 'ismailkemal', 'zzhanghuang', 'karimaboelmakarem', 'elijahbarrett22', 'ghanshyam.iitb', 'manny2750', 'abdelrahmanahmedabdelghany', 'demetguull', 'emirhan', 'afrahm104', 'jafar.vafaee', 'swadhasanghvi4', 'raaul.09', 'wassupyo412', 'mrtypc1539', 'mmoody.cma', 'aymanbakr1984.1', 'shiz', 'yigitcilce', 'emilyirisdahl', 'byminc', 'jmclean', 'janmol', 'jasmine1323', 'korhan', 'ahmed.r.elhanafy', 'rapacheco', 'nagidal146', 'bagrania385', 'joeeesalah', 'kirbye1101', 'rashmiravindranath', 'mdj', 'snnnnnnnnnnnn', 'ozgeozdamarr', 'vishwas1020', 'ajitzote', 'ahmedsayedeng1', 'maged7423', 'eltonlossner', 'archiki', 'srycvk26', 'akashmunda12345', 'apoorvaudikeri', 'danielgetega', 'skucukarabaci', 'adam.kwiatkowski', 'mb141', 'mwood', 'nanomelis1996', 'marcusle', 'camakk', 'revez_tmr', '16d070026', 'saboueleinen', 'betkahraman', 'mohamedabdelmaksoud1096', 'ayane123', 'cigo', 'pmmadhumita9', 'esraa7725334', 'saqibalisidd', 'feyzas26', 'ksselhi', 'steve.meraz', 'moises.navarro0423', 'glenpyeldho', 'guray.izmir95', 'dmertkeskin', 'anshulvermaiitb', 'aspruha.samal', 'sethabhinav89', 'abdelrahman_magdy', 'lovelyever17', 'love465944', 'sahilkumar1900', 'bhuyashi.deka', 'belmaci', 'violantium5', 'edlucero25', 'rsalgado19', 'zzhiye', 'dm94', 'gparra3', 'nicolekf', 'bahadirsonmezisik', 'tugcemekci', 'melikekorkmaz94', 'kaki.krish15', 'wdoeme93', 'djcastillo', 'ehealey', 'ishitadas1998', 'bugrahansoylu', 'x.ganerdene', 'cacortespliego', 'abdullahaksoy26', 'asrivastava98', 'apoorv0', 'anirudh.singhal', 'ibraheemgalal7', 'menaalfread', 'abeischaos', 'ruohanjiang7', 'marissasaenger', 'mohammed123', 'monicaadelfahim', 'muratkoc503', 'rodriguez.joaquin.jesus', 'gabatres', 'mahe19851117', 'yaoweixie', 'havanbhavsar03', 'hasibeodak', 'shikhar1799', 'charanadipudi', 'ealvarez44', 'manarnegm', 'hegdeananthar', 'jitendraiitb', 'mail.d', 'sukruardali', 'gao401', 'eslamamr', 'saqibali', 'aengingokce', 'ahmed_moustafa_94', 'burcuakts', 'arbaz', 'jacobmeyerson', 'mernaosama40', 'gunesa96', 'eng.baristatar', 'siber', 'aimenevse', 'beratcandan', 'bilginper24', 'cshwethanayak', 'pandeykratvesh', 'rekharavindrar', 'mrmamos31', 'methemfaik', 'timobrien', 'nora171296', 'vineetkotariya', 'refiktuzakli', 'betildiz', 'jajurado3', 'kumaradarsh', 'nagranados', 'makala.bailey', 'neeraj.chimankar', 'tanmaypatil1598', 'haydartaskaya', 'mehmetock777', 'mbrk747', 'liamfitzgerald', 'dimplekochar3', 'keszler', 'havich', 'himanshuaswani123', 'seg915ept', 'sucheta317', 'jblopez2', 'shehab', 'ibrahimyararoglu', 'riosdaniel2014', 'devanshu', 'gokay.yilmaz', 'roy.mustang.eb', 'minatarek', 'ryckmonster', 'shauryasindhu', 'ccamarillo6732', 'fdirisaglik', 'navnitkumar1224', 'rabin401', 'abdorady', 'djcruz', 'nadakoga', 'sandor.one', 'juliadavis19', 'pratyushragini', 'ewoudvissers', 'qwerty56', 'jsproviero', 'mguillen7', 'johnrahill1', 'rishikkumar18', 'mustafaozic42', 'rushib97', 'ethwong', 'brsyldrn', 'ahmed.star2025', 'iaaguilera', 'tskroezen', 'aniketsl', 'sven.siegmund', 'max2aneeb', 'navoj98']",2,"['machaff', None]",393,"['hasanaltintas', 'remsatkan', 'hakan_bicer_96', 'yagaat.smellypitts', 'kritikamna23', 'trinath', 'brekgungor', 'music20011', 'jajung89', 'ozlemsila1', 'shaimaamohamed61195', 'ezgibicak', 'nuri', 'neharikajali', 'salma_hesham', 'abduljalilahmed94', 'covarrubiasjaz05', 'ozlemkrms', 'mhyavuz', 'erenkeskin95', 'chingyinglu89', 'woooney', 'ahmetkaangecer', 'aldoalcantara1', 'arthurxavier.engineer', 'zoz', 'joelrc', 'kbkadir', 'mguillen6', 'aniketbhatia2107', 'mohamed3ssam', 'b10104023', 'singhalanirudh18', 'kzm_dmrlnk', 'senaydogn26', 'kemreakkas', 'ali.solak.1996', 'aliercn964', 'julio_c1712', 'alshareefabdulmajeed', 'austinsams', 'mark.hogg131', 'pirojiwalasubham', 'denizcango', 'ahmetdemir', 'acrylonitrile', 'eng.walaagomaaali', 'yojit105', 'ps5014', 'perihansherif', 'harsh05september', 'groever', 'hsncnyhn', 'akashminato1', 'sudhiriitb', 'michaelconnors', 'caner.baydan', 'jhorton19', 'ahmed_devices', 'highlander2475', 'louiscolson', 'hakanburakbalamir1', 'aavasquez2', 'drhodges', 'shashiadi', 'eggacher', 'ryanwood98', 'tugay95', 'bhu01', 'nemadepsn', 'ccheng852', 'simingma', 'phili180296', 'beraatyigit26', 'mattchuaruiyan', 'areeba123', 'dskartal16', 'neildalal', 'feruiz2', 'silicongo7', 'mjmartinez283', 'shubhangb97', 'kewang.ritsumei', 'shangdi1214', 'ezgii0088', 'amira123', 'abhikanse', 'mwong', 'yarenturker12', 'shaynesmq', 'kumar_ashutosh', 'jazzminesaif66', 'luisggranadost98', 'coolzach999', 'sanidhya27', 'cngzbdr', 'ayesharashid', 'ssdominguez', 'ingrammyles8', 'gunny.balakrishnan', 'mohamedabdelsalam', 'kubraciloglu', 'manar.ibraheem', 'makyz', 'terryyouknow988', 'acostadavid', 'daliahalmy', 'th3prince', 'esraaahmedabdelaal', 'menginaslan', 'tlordello', 'mustafaenesgner', 'liubenliang', 'khandelwalsanyam87', 'baranoncul', 'shashankti111', 'avinashkmry', 'deraz96', 'alejandro.juvera', 'yassinmahdy', 'saisireesha', 'nado.mahmoud1995', 'fvasquez6', 'wdang', 'hatem.rashwany', 'fang59', 'z.a.guzzardo', 'mcsalasnava', 'jesus_aguirre2000', 'timothyobrien', 'safelix', 'yusuf61', 'caranfatma', 'nourhangamal', 'allisontsay', 'omar.handy.96', 'ak83229', 'anonymousbuggy', 'abdurrahmanonuraydin', 'snjkhatri34', 'aesanchez6', 'vivekkandeyang97', 'noel19419', 'ydidwania', 'rz2405', 'mrryzen', 'nishagb04', 'calebringkob', 'anaselsabagh', 'mgthway', 'mustafaali12', 'mehmetdayioglu', 'lakshyakumarsingh', 'duenes957', 'mrinalrao1810', 'osmancanylmz1996', 'liuyuan', 'niamhmulholland', 'hobuobi', 'mauriciofalleiros', 'narendrarai1812', 'axsalomon', 'annasp', 'gonzalez.gaston', 'mayur777', 'resuliseri', 'bekirisgor', 'yerenayas', 'mertsen96', 'dirodriguez4', 'zeyneb', 'darivera3', 'dohaga95', 'elpaglia', 'saarthak', 'enesbas', 'halil26', 'ismailkemal', 'zzhanghuang', 'karimaboelmakarem', 'elijahbarrett22', 'ghanshyam.iitb', 'manny2750', 'abdelrahmanahmedabdelghany', 'demetguull', 'emirhan', 'afrahm104', 'virtuspro', 'yukseltugba14', 'jafar.vafaee', 'swadhasanghvi4', 'raaul.09', 'wassupyo412', 'mrtypc1539', 'mmoody.cma', 'aymanbakr1984.1', 'shiz', 'yigitcilce', 'emilyirisdahl', 'byminc', 'jmclean', 'janmol', 'jasmine1323', 'korhan', 'ahmed.r.elhanafy', 'rapacheco', 'nagidal146', 'bagrania385', 'joeeesalah', 'kirbye1101', 'rashmiravindranath', 'mdj', 'snnnnnnnnnnnn', 'ozgeozdamarr', 'vishwas1020', 'ajitzote', 'ahmedsayedeng1', 'ahmetsurucu', 'maged7423', 'eltonlossner', 'archiki', 'srycvk26', 'akashmunda12345', 'apoorvaudikeri', 'danielgetega', 'skucukarabaci', 'adam.kwiatkowski', 'mb141', 'mwood', 'nanomelis1996', 'marcusle', 'camakk', 'revez_tmr', '16d070026', 'ibrahimethemtemel', 'saboueleinen', 'betkahraman', 'mohamedabdelmaksoud1096', 'ayane123', 'cigo', 'pmmadhumita9', 'esraa7725334', 'saqibalisidd', 'feyzas26', 'ksselhi', 'steve.meraz', 'moises.navarro0423', 'glenpyeldho', 'guray.izmir95', 'dmertkeskin', 'anshulvermaiitb', 'aspruha.samal', 'sethabhinav89', 'abdelrahman_magdy', 'lovelyever17', 'love465944', 'sahilkumar1900', 'bhuyashi.deka', 'belmaci', 'violantium5', 'edlucero25', 'rsalgado19', 'zzhiye', 'dm94', 'gparra3', 'nicolekf', 'bahadirsonmezisik', 'tugcemekci', 'melikekorkmaz94', 'kaki.krish15', None, 'wdoeme93', 'cahidpolat', 'djcastillo', 'ehealey', 'ishitadas1998', 'bugrahansoylu', 'x.ganerdene', 'cacortespliego', 'abdullahaksoy26', 'asrivastava98', 'apoorv0', 'anirudh.singhal', 'ibraheemgalal7', 'menaalfread', 'abeischaos', 'ruohanjiang7', 'marissasaenger', 'mohammed123', 'hakanburakbalamir', 'monicaadelfahim', 'muratkoc503', 'rodriguez.joaquin.jesus', 'gabatres', 'mahe19851117', 'serhatgn', 'yaoweixie', 'havanbhavsar03', 'hasibeodak', 'shikhar1799', 'charanadipudi', 'ealvarez44', 'manarnegm', 'uygarelmali', 'hegdeananthar', 'jitendraiitb', 'mail.d', 'sukruardali', 'gao401', 'eslamamr', 'aydinturkkan44', 'saqibali', 'aengingokce', 'ahmed_moustafa_94', 'burcuakts', 'arbaz', 'jacobmeyerson', 'mernaosama40', 'kasapreyizz', 'gunesa96', 'eng.baristatar', 'siber', 'aimenevse', 'beratcandan', 'bilginper24', 'cshwethanayak', 'pandeykratvesh', 'rekharavindrar', 'mrmamos31', 'methemfaik', 'timobrien', 'nora171296', 'vineetkotariya', 'sezerguven', 'refiktuzakli', 'betildiz', 'jajurado3', 'kumaradarsh', 'nagranados', 'makala.bailey', 'bilgesukaymaz', 'neeraj.chimankar', 'tanmaypatil1598', 'haydartaskaya', 'mehmetock777', 'mbrk747', 'liamfitzgerald', 'dimplekochar3', 'keszler', 'havich', 'machaff', 'himanshuaswani123', 'seg915ept', 'sucheta317', 'jblopez2', 'shehab', 'ibrahimyararoglu', 'riosdaniel2014', 'devanshu', 'gokay.yilmaz', 'roy.mustang.eb', 'minatarek', 'ryckmonster', 'shauryasindhu', 'ccamarillo6732', 'hazalciftcioglu94', 'fdirisaglik', 'navnitkumar1224', 'rabin401', 'abdorady', 'djcruz', 'nadakoga', 'sandor.one', 'juliadavis19', 'pratyushragini', 'ewoudvissers', 'qwerty56', 'jsproviero', 'mguillen7', 'johnrahill1', 'rishikkumar18', 'mustafaozic42', 'rushib97', 'ethwong', 'brsyldrn', 'ahmed.star2025', 'iaaguilera', 'tskroezen', 'aniketsl', 'sven.siegmund', 'max2aneeb', 'navoj98', 'gizemuysal']"
1,107,391,26,1,['jajung89'],390,"['hasanaltintas', 'remsatkan', 'hakan_bicer_96', 'yagaat.smellypitts', 'kritikamna23', 'trinath', 'brekgungor', 'music20011', 'ozlemsila1', 'shaimaamohamed61195', 'ezgibicak', 'nuri', 'neharikajali', 'salma_hesham', 'abduljalilahmed94', 'covarrubiasjaz05', 'ozlemkrms', 'mhyavuz', 'erenkeskin95', 'chingyinglu89', 'woooney', 'ahmetkaangecer', 'aldoalcantara1', 'arthurxavier.engineer', 'zoz', 'joelrc', 'kbkadir', 'mguillen6', 'aniketbhatia2107', 'mohamed3ssam', 'b10104023', 'singhalanirudh18', 'kzm_dmrlnk', 'senaydogn26', 'kemreakkas', 'ali.solak.1996', 'aliercn964', 'julio_c1712', 'alshareefabdulmajeed', 'austinsams', 'mark.hogg131', 'pirojiwalasubham', 'denizcango', 'ahmetdemir', 'acrylonitrile', 'eng.walaagomaaali', 'yojit105', 'ps5014', 'perihansherif', 'harsh05september', 'groever', 'hsncnyhn', 'akashminato1', 'sudhiriitb', 'michaelconnors', 'caner.baydan', 'jhorton19', 'ahmed_devices', 'highlander2475', 'louiscolson', 'hakanburakbalamir1', 'aavasquez2', 'drhodges', 'shashiadi', 'eggacher', 'ryanwood98', 'tugay95', 'bhu01', 'nemadepsn', 'ccheng852', 'simingma', 'phili180296', 'beraatyigit26', 'mattchuaruiyan', 'areeba123', 'dskartal16', 'neildalal', 'feruiz2', 'silicongo7', 'mjmartinez283', 'shubhangb97', 'kewang.ritsumei', 'shangdi1214', 'ezgii0088', 'amira123', 'abhikanse', 'mwong', 'yarenturker12', 'shaynesmq', 'kumar_ashutosh', 'jazzminesaif66', 'luisggranadost98', 'coolzach999', 'sanidhya27', 'cngzbdr', 'ayesharashid', 'ssdominguez', 'ingrammyles8', 'gunny.balakrishnan', 'mohamedabdelsalam', 'kubraciloglu', 'manar.ibraheem', 'makyz', 'terryyouknow988', 'acostadavid', 'daliahalmy', 'th3prince', 'esraaahmedabdelaal', 'menginaslan', 'tlordello', 'mustafaenesgner', 'liubenliang', 'khandelwalsanyam87', 'baranoncul', 'shashankti111', 'avinashkmry', 'deraz96', 'alejandro.juvera', 'yassinmahdy', 'saisireesha', 'nado.mahmoud1995', 'fvasquez6', 'wdang', 'hatem.rashwany', 'fang59', 'z.a.guzzardo', 'mcsalasnava', 'jesus_aguirre2000', 'timothyobrien', 'safelix', 'yusuf61', 'caranfatma', 'nourhangamal', 'allisontsay', 'omar.handy.96', 'ak83229', 'anonymousbuggy', 'abdurrahmanonuraydin', 'snjkhatri34', 'aesanchez6', 'vivekkandeyang97', 'noel19419', 'ydidwania', 'rz2405', 'mrryzen', 'nishagb04', 'calebringkob', 'anaselsabagh', 'mgthway', 'mustafaali12', 'mehmetdayioglu', 'lakshyakumarsingh', 'duenes957', 'mrinalrao1810', 'osmancanylmz1996', 'liuyuan', 'niamhmulholland', 'hobuobi', 'mauriciofalleiros', 'narendrarai1812', 'axsalomon', 'annasp', 'gonzalez.gaston', 'mayur777', 'resuliseri', 'bekirisgor', 'yerenayas', 'mertsen96', 'dirodriguez4', 'zeyneb', 'darivera3', 'dohaga95', 'elpaglia', 'saarthak', 'enesbas', 'halil26', 'ismailkemal', 'zzhanghuang', 'karimaboelmakarem', 'elijahbarrett22', 'ghanshyam.iitb', 'manny2750', 'abdelrahmanahmedabdelghany', 'demetguull', 'emirhan', 'afrahm104', 'virtuspro', 'yukseltugba14', 'jafar.vafaee', 'swadhasanghvi4', 'raaul.09', 'wassupyo412', 'mrtypc1539', 'mmoody.cma', 'aymanbakr1984.1', 'shiz', 'yigitcilce', 'emilyirisdahl', 'byminc', 'jmclean', 'janmol', 'jasmine1323', 'korhan', 'ahmed.r.elhanafy', 'rapacheco', 'nagidal146', 'bagrania385', 'joeeesalah', 'kirbye1101', 'rashmiravindranath', 'mdj', 'snnnnnnnnnnnn', 'ozgeozdamarr', 'vishwas1020', 'ajitzote', 'ahmedsayedeng1', 'ahmetsurucu', 'maged7423', 'eltonlossner', 'archiki', 'srycvk26', 'akashmunda12345', 'apoorvaudikeri', 'danielgetega', 'skucukarabaci', 'adam.kwiatkowski', 'mb141', 'mwood', 'nanomelis1996', 'marcusle', 'camakk', 'revez_tmr', '16d070026', 'ibrahimethemtemel', 'saboueleinen', 'betkahraman', 'mohamedabdelmaksoud1096', 'ayane123', 'cigo', 'pmmadhumita9', 'esraa7725334', 'saqibalisidd', 'feyzas26', 'ksselhi', 'steve.meraz', 'moises.navarro0423', 'glenpyeldho', 'guray.izmir95', 'dmertkeskin', 'anshulvermaiitb', 'aspruha.samal', 'sethabhinav89', 'abdelrahman_magdy', 'lovelyever17', 'love465944', 'sahilkumar1900', 'bhuyashi.deka', 'belmaci', 'violantium5', 'edlucero25', 'rsalgado19', 'zzhiye', 'dm94', 'gparra3', 'nicolekf', 'bahadirsonmezisik', 'tugcemekci', 'melikekorkmaz94', 'kaki.krish15', 'wdoeme93', 'cahidpolat', 'djcastillo', 'ehealey', 'ishitadas1998', 'bugrahansoylu', 'x.ganerdene', 'cacortespliego', 'abdullahaksoy26', 'asrivastava98', 'apoorv0', 'anirudh.singhal', 'ibraheemgalal7', 'menaalfread', 'abeischaos', 'ruohanjiang7', 'marissasaenger', 'mohammed123', 'hakanburakbalamir', 'monicaadelfahim', 'muratkoc503', 'rodriguez.joaquin.jesus', 'gabatres', 'mahe19851117', 'serhatgn', 'yaoweixie', 'havanbhavsar03', 'hasibeodak', 'shikhar1799', 'charanadipudi', 'ealvarez44', 'manarnegm', 'uygarelmali', 'hegdeananthar', 'jitendraiitb', 'mail.d', 'sukruardali', 'gao401', 'eslamamr', 'aydinturkkan44', 'saqibali', 'aengingokce', 'ahmed_moustafa_94', 'burcuakts', 'arbaz', 'jacobmeyerson', 'mernaosama40', 'kasapreyizz', 'gunesa96', 'eng.baristatar', 'siber', 'aimenevse', 'beratcandan', 'bilginper24', 'cshwethanayak', 'pandeykratvesh', 'rekharavindrar', 'mrmamos31', 'methemfaik', 'timobrien', 'nora171296', 'vineetkotariya', 'sezerguven', 'refiktuzakli', 'betildiz', 'jajurado3', 'kumaradarsh', 'nagranados', 'makala.bailey', 'bilgesukaymaz', 'neeraj.chimankar', 'tanmaypatil1598', 'haydartaskaya', 'mehmetock777', 'mbrk747', 'liamfitzgerald', 'dimplekochar3', 'keszler', 'havich', 'himanshuaswani123', 'seg915ept', 'sucheta317', 'jblopez2', 'shehab', 'ibrahimyararoglu', 'riosdaniel2014', 'devanshu', 'gokay.yilmaz', 'roy.mustang.eb', 'minatarek', 'ryckmonster', 'shauryasindhu', 'ccamarillo6732', 'hazalciftcioglu94', 'fdirisaglik', 'navnitkumar1224', 'rabin401', 'abdorady', 'djcruz', 'nadakoga', 'sandor.one', 'juliadavis19', 'pratyushragini', 'ewoudvissers', 'qwerty56', 'jsproviero', 'mguillen7', 'johnrahill1', 'rishikkumar18', 'mustafaozic42', 'rushib97', 'ethwong', 'brsyldrn', 'ahmed.star2025', 'iaaguilera', 'tskroezen', 'aniketsl', 'sven.siegmund', 'max2aneeb', 'navoj98', 'gizemuysal']",25,"['aly.hassan9', 'matthewmartz', 's2dhamij', 'jachiang', 'make_it_true42', 'jdchan', 'dh2lam', 'nelsawah', 'qihao', 'adamw1995', 'almutairi', 'tdunlop', 'noahdebrincat', 'joshuaawicks', 'g2joe', 'k2muruga', None, 'millsrlm', 'adam.r.tetreault', 'ngel1914', 'kvslaughter', 'mlbsmith', 't_coathup', 'dbekah22', 'akshayaag']",416,"['hasanaltintas', 'remsatkan', 'hakan_bicer_96', 'yagaat.smellypitts', 'kritikamna23', 'trinath', 'brekgungor', 'music20011', 'jajung89', 'ozlemsila1', 'shaimaamohamed61195', 'ezgibicak', 'make_it_true42', 'nuri', 'neharikajali', 'salma_hesham', 'abduljalilahmed94', 'covarrubiasjaz05', 'ozlemkrms', 'qihao', 'mhyavuz', 'erenkeskin95', 'chingyinglu89', 'woooney', 'ahmetkaangecer', 'almutairi', 'aldoalcantara1', 'arthurxavier.engineer', 'zoz', 'joelrc', 'kbkadir', 'mguillen6', 'aniketbhatia2107', 'mohamed3ssam', 'b10104023', 'singhalanirudh18', 'ngel1914', 'kzm_dmrlnk', 'senaydogn26', 'kemreakkas', 'ali.solak.1996', 'aliercn964', 'julio_c1712', 'alshareefabdulmajeed', 'austinsams', 'mark.hogg131', 'pirojiwalasubham', 'denizcango', 'ahmetdemir', 'acrylonitrile', 'eng.walaagomaaali', 'yojit105', 'ps5014', 'perihansherif', 'harsh05september', 'groever', 'hsncnyhn', 'akashminato1', 'sudhiriitb', 'michaelconnors', 'caner.baydan', 'jhorton19', 'ahmed_devices', 'highlander2475', 'louiscolson', 'hakanburakbalamir1', 'aavasquez2', 'drhodges', 'shashiadi', 'eggacher', 'ryanwood98', 'tugay95', 'bhu01', 'nemadepsn', 'ccheng852', 'simingma', 'phili180296', 'beraatyigit26', 'mattchuaruiyan', 'areeba123', 'dskartal16', 'neildalal', 'feruiz2', 'silicongo7', 'mjmartinez283', 'shubhangb97', 'kewang.ritsumei', 'shangdi1214', 'kvslaughter', 'ezgii0088', 'amira123', 'abhikanse', 'mwong', 'mlbsmith', 'yarenturker12', 'shaynesmq', 'kumar_ashutosh', 'jazzminesaif66', 'luisggranadost98', 'coolzach999', 'sanidhya27', 'aly.hassan9', 'cngzbdr', 'ayesharashid', 'ssdominguez', 'ingrammyles8', 'gunny.balakrishnan', 'mohamedabdelsalam', 'kubraciloglu', 'manar.ibraheem', 'makyz', 'terryyouknow988', 'acostadavid', 'daliahalmy', 'th3prince', 'esraaahmedabdelaal', 'menginaslan', 'tlordello', 'mustafaenesgner', 'liubenliang', 'khandelwalsanyam87', 'baranoncul', 'shashankti111', 'avinashkmry', 'deraz96', 'alejandro.juvera', 'yassinmahdy', 'saisireesha', 'nado.mahmoud1995', 'fvasquez6', 'wdang', 'hatem.rashwany', 'fang59', 'z.a.guzzardo', 'mcsalasnava', 'adamw1995', 'jesus_aguirre2000', 'timothyobrien', 'safelix', 'yusuf61', 'caranfatma', 'nourhangamal', 'joshuaawicks', 'k2muruga', 'allisontsay', 'omar.handy.96', 'ak83229', 'anonymousbuggy', 'abdurrahmanonuraydin', 'snjkhatri34', 'aesanchez6', 'vivekkandeyang97', 'noel19419', 'ydidwania', 'rz2405', 'mrryzen', 'nishagb04', 'calebringkob', 'anaselsabagh', 'mgthway', 'mustafaali12', 'mehmetdayioglu', 'lakshyakumarsingh', 'duenes957', 'mrinalrao1810', 'osmancanylmz1996', 'liuyuan', 'niamhmulholland', 'hobuobi', 'mauriciofalleiros', 'narendrarai1812', 'axsalomon', 'jachiang', 'annasp', 'gonzalez.gaston', 'mayur777', 'resuliseri', 'dh2lam', 'bekirisgor', 'yerenayas', 'mertsen96', 'dirodriguez4', 'zeyneb', 'darivera3', 'dohaga95', 'elpaglia', 'saarthak', 'enesbas', 'halil26', 'ismailkemal', 'zzhanghuang', 'g2joe', 'karimaboelmakarem', 'adam.r.tetreault', 'elijahbarrett22', 'ghanshyam.iitb', 'manny2750', 'abdelrahmanahmedabdelghany', 'demetguull', 'emirhan', 'afrahm104', 'virtuspro', 'yukseltugba14', 'jafar.vafaee', 'akshayaag', 'swadhasanghvi4', 'raaul.09', 'wassupyo412', 'mrtypc1539', 'mmoody.cma', 'aymanbakr1984.1', 'shiz', 'yigitcilce', 'emilyirisdahl', 'byminc', 'jmclean', 'janmol', 'jasmine1323', 'korhan', 'ahmed.r.elhanafy', 'rapacheco', 'nagidal146', 'bagrania385', 'joeeesalah', 'kirbye1101', 'rashmiravindranath', 'mdj', 'nelsawah', 'snnnnnnnnnnnn', 'ozgeozdamarr', 'vishwas1020', 'ajitzote', 'ahmedsayedeng1', 'ahmetsurucu', 'maged7423', 'eltonlossner', 'noahdebrincat', 'archiki', 'srycvk26', 'akashmunda12345', 'apoorvaudikeri', 'danielgetega', 'skucukarabaci', 'adam.kwiatkowski', 'mb141', 'mwood', 'nanomelis1996', 'marcusle', 'camakk', 't_coathup', 'revez_tmr', '16d070026', 'ibrahimethemtemel', 'saboueleinen', 'betkahraman', 'mohamedabdelmaksoud1096', 'ayane123', 'cigo', 'pmmadhumita9', 'esraa7725334', 's2dhamij', 'saqibalisidd', 'feyzas26', 'ksselhi', 'steve.meraz', 'moises.navarro0423', 'glenpyeldho', 'guray.izmir95', 'dmertkeskin', 'anshulvermaiitb', 'aspruha.samal', 'sethabhinav89', 'abdelrahman_magdy', 'lovelyever17', 'love465944', 'sahilkumar1900', 'bhuyashi.deka', 'belmaci', 'violantium5', 'tdunlop', 'edlucero25', 'rsalgado19', 'zzhiye', 'dm94', 'gparra3', 'nicolekf', 'bahadirsonmezisik', 'tugcemekci', 'melikekorkmaz94', 'kaki.krish15', None, 'millsrlm', 'wdoeme93', 'cahidpolat', 'djcastillo', 'ehealey', 'ishitadas1998', 'bugrahansoylu', 'x.ganerdene', 'cacortespliego', 'abdullahaksoy26', 'asrivastava98', 'apoorv0', 'anirudh.singhal', 'ibraheemgalal7', 'menaalfread', 'abeischaos', 'ruohanjiang7', 'marissasaenger', 'mohammed123', 'dbekah22', 'hakanburakbalamir', 'monicaadelfahim', 'muratkoc503', 'rodriguez.joaquin.jesus', 'gabatres', 'mahe19851117', 'serhatgn', 'matthewmartz', 'yaoweixie', 'havanbhavsar03', 'hasibeodak', 'shikhar1799', 'charanadipudi', 'ealvarez44', 'manarnegm', 'uygarelmali', 'hegdeananthar', 'jitendraiitb', 'mail.d', 'sukruardali', 'gao401', 'eslamamr', 'aydinturkkan44', 'saqibali', 'aengingokce', 'ahmed_moustafa_94', 'burcuakts', 'arbaz', 'jacobmeyerson', 'mernaosama40', 'kasapreyizz', 'gunesa96', 'eng.baristatar', 'siber', 'aimenevse', 'beratcandan', 'bilginper24', 'cshwethanayak', 'pandeykratvesh', 'rekharavindrar', 'mrmamos31', 'methemfaik', 'timobrien', 'nora171296', 'vineetkotariya', 'sezerguven', 'refiktuzakli', 'betildiz', 'jajurado3', 'kumaradarsh', 'nagranados', 'makala.bailey', 'bilgesukaymaz', 'neeraj.chimankar', 'tanmaypatil1598', 'haydartaskaya', 'mehmetock777', 'mbrk747', 'liamfitzgerald', 'dimplekochar3', 'keszler', 'havich', 'himanshuaswani123', 'seg915ept', 'sucheta317', 'jblopez2', 'shehab', 'ibrahimyararoglu', 'jdchan', 'riosdaniel2014', 'devanshu', 'gokay.yilmaz', 'roy.mustang.eb', 'minatarek', 'ryckmonster', 'shauryasindhu', 'ccamarillo6732', 'hazalciftcioglu94', 'fdirisaglik', 'navnitkumar1224', 'rabin401', 'abdorady', 'djcruz', 'nadakoga', 'sandor.one', 'juliadavis19', 'pratyushragini', 'ewoudvissers', 'qwerty56', 'jsproviero', 'mguillen7', 'johnrahill1', 'rishikkumar18', 'mustafaozic42', 'rushib97', 'ethwong', 'brsyldrn', 'ahmed.star2025', 'iaaguilera', 'tskroezen', 'aniketsl', 'sven.siegmund', 'max2aneeb', 'navoj98', 'gizemuysal']"
1,319,391,25,4,"['jsproviero', 'wdang', 'yaoweixie', 'marcusle']",387,"['hasanaltintas', 'remsatkan', 'hakan_bicer_96', 'yagaat.smellypitts', 'kritikamna23', 'trinath', 'brekgungor', 'music20011', 'jajung89', 'ozlemsila1', 'shaimaamohamed61195', 'ezgibicak', 'nuri', 'neharikajali', 'salma_hesham', 'abduljalilahmed94', 'covarrubiasjaz05', 'ozlemkrms', 'mhyavuz', 'erenkeskin95', 'chingyinglu89', 'woooney', 'ahmetkaangecer', 'aldoalcantara1', 'arthurxavier.engineer', 'zoz', 'joelrc', 'kbkadir', 'mguillen6', 'aniketbhatia2107', 'mohamed3ssam', 'b10104023', 'singhalanirudh18', 'kzm_dmrlnk', 'senaydogn26', 'kemreakkas', 'ali.solak.1996', 'aliercn964', 'julio_c1712', 'alshareefabdulmajeed', 'austinsams', 'mark.hogg131', 'pirojiwalasubham', 'denizcango', 'ahmetdemir', 'acrylonitrile', 'eng.walaagomaaali', 'yojit105', 'ps5014', 'perihansherif', 'harsh05september', 'groever', 'hsncnyhn', 'akashminato1', 'sudhiriitb', 'michaelconnors', 'caner.baydan', 'jhorton19', 'ahmed_devices', 'highlander2475', 'louiscolson', 'hakanburakbalamir1', 'aavasquez2', 'drhodges', 'shashiadi', 'eggacher', 'ryanwood98', 'tugay95', 'bhu01', 'nemadepsn', 'ccheng852', 'simingma', 'phili180296', 'beraatyigit26', 'mattchuaruiyan', 'areeba123', 'dskartal16', 'neildalal', 'feruiz2', 'silicongo7', 'mjmartinez283', 'shubhangb97', 'kewang.ritsumei', 'shangdi1214', 'ezgii0088', 'amira123', 'abhikanse', 'mwong', 'yarenturker12', 'shaynesmq', 'kumar_ashutosh', 'jazzminesaif66', 'luisggranadost98', 'coolzach999', 'sanidhya27', 'cngzbdr', 'ayesharashid', 'ssdominguez', 'ingrammyles8', 'gunny.balakrishnan', 'mohamedabdelsalam', 'kubraciloglu', 'manar.ibraheem', 'makyz', 'terryyouknow988', 'acostadavid', 'daliahalmy', 'th3prince', 'esraaahmedabdelaal', 'menginaslan', 'tlordello', 'mustafaenesgner', 'liubenliang', 'khandelwalsanyam87', 'baranoncul', 'shashankti111', 'avinashkmry', 'deraz96', 'alejandro.juvera', 'yassinmahdy', 'saisireesha', 'nado.mahmoud1995', 'fvasquez6', 'hatem.rashwany', 'fang59', 'z.a.guzzardo', 'mcsalasnava', 'jesus_aguirre2000', 'timothyobrien', 'safelix', 'yusuf61', 'caranfatma', 'nourhangamal', 'allisontsay', 'omar.handy.96', 'ak83229', 'anonymousbuggy', 'abdurrahmanonuraydin', 'snjkhatri34', 'aesanchez6', 'vivekkandeyang97', 'noel19419', 'ydidwania', 'rz2405', 'mrryzen', 'nishagb04', 'calebringkob', 'anaselsabagh', 'mgthway', 'mustafaali12', 'mehmetdayioglu', 'lakshyakumarsingh', 'duenes957', 'mrinalrao1810', 'osmancanylmz1996', 'liuyuan', 'niamhmulholland', 'hobuobi', 'mauriciofalleiros', 'narendrarai1812', 'axsalomon', 'annasp', 'gonzalez.gaston', 'mayur777', 'resuliseri', 'bekirisgor', 'yerenayas', 'mertsen96', 'dirodriguez4', 'zeyneb', 'darivera3', 'dohaga95', 'elpaglia', 'saarthak', 'enesbas', 'halil26', 'ismailkemal', 'zzhanghuang', 'karimaboelmakarem', 'elijahbarrett22', 'ghanshyam.iitb', 'manny2750', 'abdelrahmanahmedabdelghany', 'demetguull', 'emirhan', 'afrahm104', 'virtuspro', 'yukseltugba14', 'jafar.vafaee', 'swadhasanghvi4', 'raaul.09', 'wassupyo412', 'mrtypc1539', 'mmoody.cma', 'aymanbakr1984.1', 'shiz', 'yigitcilce', 'emilyirisdahl', 'byminc', 'jmclean', 'janmol', 'jasmine1323', 'korhan', 'ahmed.r.elhanafy', 'rapacheco', 'nagidal146', 'bagrania385', 'joeeesalah', 'kirbye1101', 'rashmiravindranath', 'mdj', 'snnnnnnnnnnnn', 'ozgeozdamarr', 'vishwas1020', 'ajitzote', 'ahmedsayedeng1', 'ahmetsurucu', 'maged7423', 'eltonlossner', 'archiki', 'srycvk26', 'akashmunda12345', 'apoorvaudikeri', 'danielgetega', 'skucukarabaci', 'adam.kwiatkowski', 'mb141', 'mwood', 'nanomelis1996', 'camakk', 'revez_tmr', '16d070026', 'ibrahimethemtemel', 'saboueleinen', 'betkahraman', 'mohamedabdelmaksoud1096', 'ayane123', 'cigo', 'pmmadhumita9', 'esraa7725334', 'saqibalisidd', 'feyzas26', 'ksselhi', 'steve.meraz', 'moises.navarro0423', 'glenpyeldho', 'guray.izmir95', 'dmertkeskin', 'anshulvermaiitb', 'aspruha.samal', 'sethabhinav89', 'abdelrahman_magdy', 'lovelyever17', 'love465944', 'sahilkumar1900', 'bhuyashi.deka', 'belmaci', 'violantium5', 'edlucero25', 'rsalgado19', 'zzhiye', 'dm94', 'gparra3', 'nicolekf', 'bahadirsonmezisik', 'tugcemekci', 'melikekorkmaz94', 'kaki.krish15', 'wdoeme93', 'cahidpolat', 'djcastillo', 'ehealey', 'ishitadas1998', 'bugrahansoylu', 'x.ganerdene', 'cacortespliego', 'abdullahaksoy26', 'asrivastava98', 'apoorv0', 'anirudh.singhal', 'ibraheemgalal7', 'menaalfread', 'abeischaos', 'ruohanjiang7', 'marissasaenger', 'mohammed123', 'hakanburakbalamir', 'monicaadelfahim', 'muratkoc503', 'rodriguez.joaquin.jesus', 'gabatres', 'mahe19851117', 'serhatgn', 'havanbhavsar03', 'hasibeodak', 'shikhar1799', 'charanadipudi', 'ealvarez44', 'manarnegm', 'uygarelmali', 'hegdeananthar', 'jitendraiitb', 'mail.d', 'sukruardali', 'gao401', 'eslamamr', 'aydinturkkan44', 'saqibali', 'aengingokce', 'ahmed_moustafa_94', 'burcuakts', 'arbaz', 'jacobmeyerson', 'mernaosama40', 'kasapreyizz', 'gunesa96', 'eng.baristatar', 'siber', 'aimenevse', 'beratcandan', 'bilginper24', 'cshwethanayak', 'pandeykratvesh', 'rekharavindrar', 'mrmamos31', 'methemfaik', 'timobrien', 'nora171296', 'vineetkotariya', 'sezerguven', 'refiktuzakli', 'betildiz', 'jajurado3', 'kumaradarsh', 'nagranados', 'makala.bailey', 'bilgesukaymaz', 'neeraj.chimankar', 'tanmaypatil1598', 'haydartaskaya', 'mehmetock777', 'mbrk747', 'liamfitzgerald', 'dimplekochar3', 'keszler', 'havich', 'himanshuaswani123', 'seg915ept', 'sucheta317', 'jblopez2', 'shehab', 'ibrahimyararoglu', 'riosdaniel2014', 'devanshu', 'gokay.yilmaz', 'roy.mustang.eb', 'minatarek', 'ryckmonster', 'shauryasindhu', 'ccamarillo6732', 'hazalciftcioglu94', 'fdirisaglik', 'navnitkumar1224', 'rabin401', 'abdorady', 'djcruz', 'nadakoga', 'sandor.one', 'juliadavis19', 'pratyushragini', 'ewoudvissers', 'qwerty56', 'mguillen7', 'johnrahill1', 'rishikkumar18', 'mustafaozic42', 'rushib97', 'ethwong', 'brsyldrn', 'ahmed.star2025', 'iaaguilera', 'tskroezen', 'aniketsl', 'sven.siegmund', 'max2aneeb', 'navoj98', 'gizemuysal']",21,"['ztoscanini', 'jhennessey', 'lemerson', 'mdelude', 'jrlacroix', 'cpeter', 'nmccarthy', 'rtam', 'aksamija', 'eliasphillip', 'samuelburges', 'akaluzny', 'pjaswal', 'rkornitsky', 'markgillespi', 'ctheriault', None, 'dgage', 'sguha', 'komminiadithya', 'nmsheridan']",412,"['hasanaltintas', 'remsatkan', 'hakan_bicer_96', 'yagaat.smellypitts', 'kritikamna23', 'trinath', 'brekgungor', 'music20011', 'jajung89', 'ozlemsila1', 'shaimaamohamed61195', 'ezgibicak', 'nuri', 'neharikajali', 'salma_hesham', 'abduljalilahmed94', 'covarrubiasjaz05', 'ozlemkrms', 'mhyavuz', 'erenkeskin95', 'chingyinglu89', 'woooney', 'ahmetkaangecer', 'rkornitsky', 'aldoalcantara1', 'markgillespi', 'arthurxavier.engineer', 'zoz', 'joelrc', 'kbkadir', 'mguillen6', 'aniketbhatia2107', 'mohamed3ssam', 'b10104023', 'singhalanirudh18', 'kzm_dmrlnk', 'senaydogn26', 'kemreakkas', 'ali.solak.1996', 'aliercn964', 'julio_c1712', 'alshareefabdulmajeed', 'nmsheridan', 'austinsams', 'mark.hogg131', 'pirojiwalasubham', 'denizcango', 'ahmetdemir', 'acrylonitrile', 'eng.walaagomaaali', 'yojit105', 'ps5014', 'perihansherif', 'harsh05september', 'groever', 'hsncnyhn', 'akashminato1', 'sudhiriitb', 'michaelconnors', 'caner.baydan', 'jhorton19', 'ahmed_devices', 'highlander2475', 'louiscolson', 'rtam', 'hakanburakbalamir1', 'aavasquez2', 'drhodges', 'shashiadi', 'eggacher', 'ryanwood98', 'tugay95', 'bhu01', 'nemadepsn', 'ccheng852', 'simingma', 'phili180296', 'beraatyigit26', 'mattchuaruiyan', 'areeba123', 'dskartal16', 'neildalal', 'feruiz2', 'silicongo7', 'mjmartinez283', 'shubhangb97', 'kewang.ritsumei', 'shangdi1214', 'ezgii0088', 'amira123', 'abhikanse', 'mwong', 'yarenturker12', 'shaynesmq', 'kumar_ashutosh', 'jazzminesaif66', 'luisggranadost98', 'coolzach999', 'sanidhya27', 'cngzbdr', 'ayesharashid', 'ssdominguez', 'ingrammyles8', 'gunny.balakrishnan', 'mohamedabdelsalam', 'kubraciloglu', 'manar.ibraheem', 'makyz', 'terryyouknow988', 'acostadavid', 'daliahalmy', 'th3prince', 'esraaahmedabdelaal', 'menginaslan', 'tlordello', 'mustafaenesgner', 'liubenliang', 'khandelwalsanyam87', 'baranoncul', 'shashankti111', 'avinashkmry', 'deraz96', 'alejandro.juvera', 'yassinmahdy', 'saisireesha', 'nado.mahmoud1995', 'fvasquez6', 'wdang', 'hatem.rashwany', 'eliasphillip', 'fang59', 'z.a.guzzardo', 'mcsalasnava', 'akaluzny', 'jesus_aguirre2000', 'timothyobrien', 'safelix', 'yusuf61', 'caranfatma', 'nourhangamal', 'allisontsay', 'omar.handy.96', 'ak83229', 'anonymousbuggy', 'abdurrahmanonuraydin', 'snjkhatri34', 'aesanchez6', 'vivekkandeyang97', 'noel19419', 'ydidwania', 'rz2405', 'mrryzen', 'nishagb04', 'calebringkob', 'anaselsabagh', 'mgthway', 'mustafaali12', 'mehmetdayioglu', 'lakshyakumarsingh', 'duenes957', 'jhennessey', 'mrinalrao1810', 'osmancanylmz1996', 'liuyuan', 'niamhmulholland', 'hobuobi', 'nmccarthy', 'mauriciofalleiros', 'narendrarai1812', 'axsalomon', 'annasp', 'gonzalez.gaston', 'mayur777', 'resuliseri', 'bekirisgor', 'yerenayas', 'mertsen96', 'dirodriguez4', 'zeyneb', 'samuelburges', 'darivera3', 'dohaga95', 'elpaglia', 'saarthak', 'enesbas', 'halil26', 'ismailkemal', 'zzhanghuang', 'karimaboelmakarem', 'elijahbarrett22', 'sguha', 'ghanshyam.iitb', 'manny2750', 'abdelrahmanahmedabdelghany', 'demetguull', 'emirhan', 'afrahm104', 'virtuspro', 'yukseltugba14', 'jafar.vafaee', 'swadhasanghvi4', 'raaul.09', 'wassupyo412', 'ztoscanini', 'mrtypc1539', 'mmoody.cma', 'aymanbakr1984.1', 'shiz', 'yigitcilce', 'emilyirisdahl', 'byminc', 'jmclean', 'janmol', 'jasmine1323', 'korhan', 'ahmed.r.elhanafy', 'rapacheco', 'nagidal146', 'bagrania385', 'dgage', 'joeeesalah', 'kirbye1101', 'rashmiravindranath', 'mdj', 'snnnnnnnnnnnn', 'ozgeozdamarr', 'vishwas1020', 'ajitzote', 'ahmedsayedeng1', 'ahmetsurucu', 'maged7423', 'eltonlossner', 'archiki', 'srycvk26', 'akashmunda12345', 'apoorvaudikeri', 'danielgetega', 'skucukarabaci', 'adam.kwiatkowski', 'mb141', 'mwood', 'nanomelis1996', 'marcusle', 'camakk', 'revez_tmr', '16d070026', 'ibrahimethemtemel', 'saboueleinen', 'betkahraman', 'mohamedabdelmaksoud1096', 'ayane123', 'cigo', 'pmmadhumita9', 'esraa7725334', 'saqibalisidd', 'feyzas26', 'ksselhi', 'steve.meraz', 'moises.navarro0423', 'glenpyeldho', 'guray.izmir95', 'dmertkeskin', 'anshulvermaiitb', 'aspruha.samal', 'sethabhinav89', 'abdelrahman_magdy', 'lovelyever17', 'love465944', 'sahilkumar1900', 'bhuyashi.deka', 'belmaci', 'violantium5', 'edlucero25', 'rsalgado19', 'zzhiye', 'dm94', 'gparra3', 'nicolekf', 'bahadirsonmezisik', 'tugcemekci', 'melikekorkmaz94', 'kaki.krish15', 'ctheriault', None, 'wdoeme93', 'cahidpolat', 'djcastillo', 'ehealey', 'ishitadas1998', 'bugrahansoylu', 'x.ganerdene', 'cacortespliego', 'abdullahaksoy26', 'asrivastava98', 'apoorv0', 'anirudh.singhal', 'ibraheemgalal7', 'menaalfread', 'abeischaos', 'ruohanjiang7', 'marissasaenger', 'mohammed123', 'hakanburakbalamir', 'monicaadelfahim', 'muratkoc503', 'rodriguez.joaquin.jesus', 'gabatres', 'mahe19851117', 'serhatgn', 'yaoweixie', 'havanbhavsar03', 'hasibeodak', 'shikhar1799', 'charanadipudi', 'ealvarez44', 'manarnegm', 'uygarelmali', 'hegdeananthar', 'jrlacroix', 'jitendraiitb', 'mail.d', 'sukruardali', 'gao401', 'eslamamr', 'aydinturkkan44', 'aksamija', 'saqibali', 'aengingokce', 'ahmed_moustafa_94', 'burcuakts', 'arbaz', 'jacobmeyerson', 'mernaosama40', 'pjaswal', 'kasapreyizz', 'gunesa96', 'eng.baristatar', 'siber', 'aimenevse', 'beratcandan', 'bilginper24', 'cshwethanayak', 'pandeykratvesh', 'rekharavindrar', 'mrmamos31', 'methemfaik', 'timobrien', 'nora171296', 'vineetkotariya', 'sezerguven', 'refiktuzakli', 'betildiz', 'jajurado3', 'kumaradarsh', 'nagranados', 'makala.bailey', 'bilgesukaymaz', 'neeraj.chimankar', 'tanmaypatil1598', 'haydartaskaya', 'mehmetock777', 'mbrk747', 'liamfitzgerald', 'dimplekochar3', 'keszler', 'havich', 'himanshuaswani123', 'lemerson', 'mdelude', 'seg915ept', 'sucheta317', 'jblopez2', 'cpeter', 'shehab', 'ibrahimyararoglu', 'riosdaniel2014', 'devanshu', 'gokay.yilmaz', 'roy.mustang.eb', 'minatarek', 'ryckmonster', 'shauryasindhu', 'ccamarillo6732', 'hazalciftcioglu94', 'fdirisaglik', 'navnitkumar1224', 'rabin401', 'abdorady', 'djcruz', 'nadakoga', 'sandor.one', 'juliadavis19', 'pratyushragini', 'ewoudvissers', 'qwerty56', 'jsproviero', 'mguillen7', 'johnrahill1', 'rishikkumar18', 'mustafaozic42', 'rushib97', 'ethwong', 'brsyldrn', 'ahmed.star2025', 'iaaguilera', 'tskroezen', 'aniketsl', 'sven.siegmund', 'komminiadithya', 'max2aneeb', 'navoj98', 'gizemuysal']"
1,321,391,18,16,"['muratkoc503', 'brsyldrn', 'korhan', 'senaydogn26', 'dskartal16', 'ezgibicak', 'abdullahaksoy26', 'ahmetkaangecer', 'betildiz', 'aimenevse', 'dm94', 'yigitcilce', 'yerenayas', 'guray.izmir95', 'melikekorkmaz94', 'mehmetock777']",375,"['hasanaltintas', 'remsatkan', 'hakan_bicer_96', 'yagaat.smellypitts', 'kritikamna23', 'trinath', 'brekgungor', 'music20011', 'jajung89', 'ozlemsila1', 'shaimaamohamed61195', 'nuri', 'neharikajali', 'salma_hesham', 'abduljalilahmed94', 'covarrubiasjaz05', 'ozlemkrms', 'mhyavuz', 'erenkeskin95', 'chingyinglu89', 'woooney', 'aldoalcantara1', 'arthurxavier.engineer', 'zoz', 'joelrc', 'kbkadir', 'mguillen6', 'aniketbhatia2107', 'mohamed3ssam', 'b10104023', 'singhalanirudh18', 'kzm_dmrlnk', 'kemreakkas', 'ali.solak.1996', 'aliercn964', 'julio_c1712', 'alshareefabdulmajeed', 'austinsams', 'mark.hogg131', 'pirojiwalasubham', 'denizcango', 'ahmetdemir', 'acrylonitrile', 'eng.walaagomaaali', 'yojit105', 'ps5014', 'perihansherif', 'harsh05september', 'groever', 'hsncnyhn', 'akashminato1', 'sudhiriitb', 'michaelconnors', 'caner.baydan', 'jhorton19', 'ahmed_devices', 'highlander2475', 'louiscolson', 'hakanburakbalamir1', 'aavasquez2', 'drhodges', 'shashiadi', 'eggacher', 'ryanwood98', 'tugay95', 'bhu01', 'nemadepsn', 'ccheng852', 'simingma', 'phili180296', 'beraatyigit26', 'mattchuaruiyan', 'areeba123', 'neildalal', 'feruiz2', 'silicongo7', 'mjmartinez283', 'shubhangb97', 'kewang.ritsumei', 'shangdi1214', 'ezgii0088', 'amira123', 'abhikanse', 'mwong', 'yarenturker12', 'shaynesmq', 'kumar_ashutosh', 'jazzminesaif66', 'luisggranadost98', 'coolzach999', 'sanidhya27', 'cngzbdr', 'ayesharashid', 'ssdominguez', 'ingrammyles8', 'gunny.balakrishnan', 'mohamedabdelsalam', 'kubraciloglu', 'manar.ibraheem', 'makyz', 'terryyouknow988', 'acostadavid', 'daliahalmy', 'th3prince', 'esraaahmedabdelaal', 'menginaslan', 'tlordello', 'mustafaenesgner', 'liubenliang', 'khandelwalsanyam87', 'baranoncul', 'shashankti111', 'avinashkmry', 'deraz96', 'alejandro.juvera', 'yassinmahdy', 'saisireesha', 'nado.mahmoud1995', 'fvasquez6', 'wdang', 'hatem.rashwany', 'fang59', 'z.a.guzzardo', 'mcsalasnava', 'jesus_aguirre2000', 'timothyobrien', 'safelix', 'yusuf61', 'caranfatma', 'nourhangamal', 'allisontsay', 'omar.handy.96', 'ak83229', 'anonymousbuggy', 'abdurrahmanonuraydin', 'snjkhatri34', 'aesanchez6', 'vivekkandeyang97', 'noel19419', 'ydidwania', 'rz2405', 'mrryzen', 'nishagb04', 'calebringkob', 'anaselsabagh', 'mgthway', 'mustafaali12', 'mehmetdayioglu', 'lakshyakumarsingh', 'duenes957', 'mrinalrao1810', 'osmancanylmz1996', 'liuyuan', 'niamhmulholland', 'hobuobi', 'mauriciofalleiros', 'narendrarai1812', 'axsalomon', 'annasp', 'gonzalez.gaston', 'mayur777', 'resuliseri', 'bekirisgor', 'mertsen96', 'dirodriguez4', 'zeyneb', 'darivera3', 'dohaga95', 'elpaglia', 'saarthak', 'enesbas', 'halil26', 'ismailkemal', 'zzhanghuang', 'karimaboelmakarem', 'elijahbarrett22', 'ghanshyam.iitb', 'manny2750', 'abdelrahmanahmedabdelghany', 'demetguull', 'emirhan', 'afrahm104', 'virtuspro', 'yukseltugba14', 'jafar.vafaee', 'swadhasanghvi4', 'raaul.09', 'wassupyo412', 'mrtypc1539', 'mmoody.cma', 'aymanbakr1984.1', 'shiz', 'emilyirisdahl', 'byminc', 'jmclean', 'janmol', 'jasmine1323', 'ahmed.r.elhanafy', 'rapacheco', 'nagidal146', 'bagrania385', 'joeeesalah', 'kirbye1101', 'rashmiravindranath', 'mdj', 'snnnnnnnnnnnn', 'ozgeozdamarr', 'vishwas1020', 'ajitzote', 'ahmedsayedeng1', 'ahmetsurucu', 'maged7423', 'eltonlossner', 'archiki', 'srycvk26', 'akashmunda12345', 'apoorvaudikeri', 'danielgetega', 'skucukarabaci', 'adam.kwiatkowski', 'mb141', 'mwood', 'nanomelis1996', 'marcusle', 'camakk', 'revez_tmr', '16d070026', 'ibrahimethemtemel', 'saboueleinen', 'betkahraman', 'mohamedabdelmaksoud1096', 'ayane123', 'cigo', 'pmmadhumita9', 'esraa7725334', 'saqibalisidd', 'feyzas26', 'ksselhi', 'steve.meraz', 'moises.navarro0423', 'glenpyeldho', 'dmertkeskin', 'anshulvermaiitb', 'aspruha.samal', 'sethabhinav89', 'abdelrahman_magdy', 'lovelyever17', 'love465944', 'sahilkumar1900', 'bhuyashi.deka', 'belmaci', 'violantium5', 'edlucero25', 'rsalgado19', 'zzhiye', 'gparra3', 'nicolekf', 'bahadirsonmezisik', 'tugcemekci', 'kaki.krish15', 'wdoeme93', 'cahidpolat', 'djcastillo', 'ehealey', 'ishitadas1998', 'bugrahansoylu', 'x.ganerdene', 'cacortespliego', 'asrivastava98', 'apoorv0', 'anirudh.singhal', 'ibraheemgalal7', 'menaalfread', 'abeischaos', 'ruohanjiang7', 'marissasaenger', 'mohammed123', 'hakanburakbalamir', 'monicaadelfahim', 'rodriguez.joaquin.jesus', 'gabatres', 'mahe19851117', 'serhatgn', 'yaoweixie', 'havanbhavsar03', 'hasibeodak', 'shikhar1799', 'charanadipudi', 'ealvarez44', 'manarnegm', 'uygarelmali', 'hegdeananthar', 'jitendraiitb', 'mail.d', 'sukruardali', 'gao401', 'eslamamr', 'aydinturkkan44', 'saqibali', 'aengingokce', 'ahmed_moustafa_94', 'burcuakts', 'arbaz', 'jacobmeyerson', 'mernaosama40', 'kasapreyizz', 'gunesa96', 'eng.baristatar', 'siber', 'beratcandan', 'bilginper24', 'cshwethanayak', 'pandeykratvesh', 'rekharavindrar', 'mrmamos31', 'methemfaik', 'timobrien', 'nora171296', 'vineetkotariya', 'sezerguven', 'refiktuzakli', 'jajurado3', 'kumaradarsh', 'nagranados', 'makala.bailey', 'bilgesukaymaz', 'neeraj.chimankar', 'tanmaypatil1598', 'haydartaskaya', 'mbrk747', 'liamfitzgerald', 'dimplekochar3', 'keszler', 'havich', 'himanshuaswani123', 'seg915ept', 'sucheta317', 'jblopez2', 'shehab', 'ibrahimyararoglu', 'riosdaniel2014', 'devanshu', 'gokay.yilmaz', 'roy.mustang.eb', 'minatarek', 'ryckmonster', 'shauryasindhu', 'ccamarillo6732', 'hazalciftcioglu94', 'fdirisaglik', 'navnitkumar1224', 'rabin401', 'abdorady', 'djcruz', 'nadakoga', 'sandor.one', 'juliadavis19', 'pratyushragini', 'ewoudvissers', 'qwerty56', 'jsproviero', 'mguillen7', 'johnrahill1', 'rishikkumar18', 'mustafaozic42', 'rushib97', 'ethwong', 'ahmed.star2025', 'iaaguilera', 'tskroezen', 'aniketsl', 'sven.siegmund', 'max2aneeb', 'navoj98', 'gizemuysal']",2,"[None, 'hakan.orngl']",393,"['hasanaltintas', 'remsatkan', 'hakan_bicer_96', 'yagaat.smellypitts', 'kritikamna23', 'trinath', 'brekgungor', 'music20011', 'jajung89', 'ozlemsila1', 'shaimaamohamed61195', 'ezgibicak', 'nuri', 'neharikajali', 'salma_hesham', 'abduljalilahmed94', 'covarrubiasjaz05', 'ozlemkrms', 'mhyavuz', 'erenkeskin95', 'chingyinglu89', 'woooney', 'ahmetkaangecer', 'aldoalcantara1', 'arthurxavier.engineer', 'zoz', 'joelrc', 'kbkadir', 'mguillen6', 'aniketbhatia2107', 'mohamed3ssam', 'b10104023', 'singhalanirudh18', 'kzm_dmrlnk', 'senaydogn26', 'kemreakkas', 'ali.solak.1996', 'aliercn964', 'julio_c1712', 'alshareefabdulmajeed', 'austinsams', 'mark.hogg131', 'pirojiwalasubham', 'denizcango', 'ahmetdemir', 'acrylonitrile', 'eng.walaagomaaali', 'yojit105', 'ps5014', 'perihansherif', 'harsh05september', 'groever', 'hsncnyhn', 'akashminato1', 'sudhiriitb', 'michaelconnors', 'caner.baydan', 'jhorton19', 'ahmed_devices', 'highlander2475', 'louiscolson', 'hakanburakbalamir1', 'aavasquez2', 'drhodges', 'shashiadi', 'eggacher', 'ryanwood98', 'tugay95', 'bhu01', 'nemadepsn', 'ccheng852', 'simingma', 'phili180296', 'beraatyigit26', 'mattchuaruiyan', 'areeba123', 'dskartal16', 'neildalal', 'feruiz2', 'silicongo7', 'mjmartinez283', 'shubhangb97', 'kewang.ritsumei', 'shangdi1214', 'ezgii0088', 'amira123', 'abhikanse', 'mwong', 'yarenturker12', 'shaynesmq', 'kumar_ashutosh', 'jazzminesaif66', 'luisggranadost98', 'coolzach999', 'sanidhya27', 'cngzbdr', 'ayesharashid', 'ssdominguez', 'ingrammyles8', 'gunny.balakrishnan', 'mohamedabdelsalam', 'kubraciloglu', 'manar.ibraheem', 'makyz', 'terryyouknow988', 'acostadavid', 'daliahalmy', 'th3prince', 'esraaahmedabdelaal', 'menginaslan', 'tlordello', 'mustafaenesgner', 'liubenliang', 'khandelwalsanyam87', 'baranoncul', 'shashankti111', 'avinashkmry', 'deraz96', 'alejandro.juvera', 'yassinmahdy', 'saisireesha', 'nado.mahmoud1995', 'fvasquez6', 'wdang', 'hatem.rashwany', 'fang59', 'z.a.guzzardo', 'mcsalasnava', 'jesus_aguirre2000', 'timothyobrien', 'safelix', 'yusuf61', 'caranfatma', 'nourhangamal', 'allisontsay', 'omar.handy.96', 'ak83229', 'anonymousbuggy', 'abdurrahmanonuraydin', 'snjkhatri34', 'aesanchez6', 'vivekkandeyang97', 'noel19419', 'ydidwania', 'rz2405', 'mrryzen', 'nishagb04', 'calebringkob', 'anaselsabagh', 'mgthway', 'mustafaali12', 'mehmetdayioglu', 'lakshyakumarsingh', 'duenes957', 'mrinalrao1810', 'osmancanylmz1996', 'liuyuan', 'niamhmulholland', 'hobuobi', 'mauriciofalleiros', 'narendrarai1812', 'axsalomon', 'annasp', 'gonzalez.gaston', 'mayur777', 'resuliseri', 'bekirisgor', 'yerenayas', 'mertsen96', 'dirodriguez4', 'zeyneb', 'darivera3', 'dohaga95', 'elpaglia', 'saarthak', 'enesbas', 'halil26', 'ismailkemal', 'zzhanghuang', 'karimaboelmakarem', 'elijahbarrett22', 'ghanshyam.iitb', 'manny2750', 'abdelrahmanahmedabdelghany', 'demetguull', 'emirhan', 'afrahm104', 'virtuspro', 'yukseltugba14', 'jafar.vafaee', 'swadhasanghvi4', 'raaul.09', 'wassupyo412', 'mrtypc1539', 'mmoody.cma', 'aymanbakr1984.1', 'shiz', 'yigitcilce', 'emilyirisdahl', 'byminc', 'jmclean', 'janmol', 'jasmine1323', 'korhan', 'ahmed.r.elhanafy', 'rapacheco', 'nagidal146', 'bagrania385', 'joeeesalah', 'kirbye1101', 'rashmiravindranath', 'mdj', 'snnnnnnnnnnnn', 'ozgeozdamarr', 'vishwas1020', 'ajitzote', 'ahmedsayedeng1', 'ahmetsurucu', 'maged7423', 'eltonlossner', 'archiki', 'srycvk26', 'akashmunda12345', 'apoorvaudikeri', 'danielgetega', 'skucukarabaci', 'adam.kwiatkowski', 'mb141', 'mwood', 'nanomelis1996', 'marcusle', 'camakk', 'revez_tmr', '16d070026', 'ibrahimethemtemel', 'saboueleinen', 'betkahraman', 'mohamedabdelmaksoud1096', 'ayane123', 'cigo', 'pmmadhumita9', 'esraa7725334', 'saqibalisidd', 'feyzas26', 'ksselhi', 'steve.meraz', 'moises.navarro0423', 'glenpyeldho', 'guray.izmir95', 'dmertkeskin', 'anshulvermaiitb', 'aspruha.samal', 'sethabhinav89', 'abdelrahman_magdy', 'lovelyever17', 'love465944', 'sahilkumar1900', 'bhuyashi.deka', 'belmaci', 'violantium5', 'edlucero25', 'rsalgado19', 'zzhiye', 'dm94', 'gparra3', 'nicolekf', 'bahadirsonmezisik', 'tugcemekci', 'melikekorkmaz94', 'kaki.krish15', None, 'wdoeme93', 'cahidpolat', 'djcastillo', 'ehealey', 'ishitadas1998', 'bugrahansoylu', 'x.ganerdene', 'cacortespliego', 'abdullahaksoy26', 'asrivastava98', 'apoorv0', 'anirudh.singhal', 'ibraheemgalal7', 'menaalfread', 'abeischaos', 'ruohanjiang7', 'marissasaenger', 'mohammed123', 'hakanburakbalamir', 'monicaadelfahim', 'muratkoc503', 'rodriguez.joaquin.jesus', 'gabatres', 'mahe19851117', 'serhatgn', 'yaoweixie', 'havanbhavsar03', 'hasibeodak', 'shikhar1799', 'charanadipudi', 'ealvarez44', 'manarnegm', 'uygarelmali', 'hegdeananthar', 'jitendraiitb', 'mail.d', 'sukruardali', 'gao401', 'eslamamr', 'aydinturkkan44', 'hakan.orngl', 'saqibali', 'aengingokce', 'ahmed_moustafa_94', 'burcuakts', 'arbaz', 'jacobmeyerson', 'mernaosama40', 'kasapreyizz', 'gunesa96', 'eng.baristatar', 'siber', 'aimenevse', 'beratcandan', 'bilginper24', 'cshwethanayak', 'pandeykratvesh', 'rekharavindrar', 'mrmamos31', 'methemfaik', 'timobrien', 'nora171296', 'vineetkotariya', 'sezerguven', 'refiktuzakli', 'betildiz', 'jajurado3', 'kumaradarsh', 'nagranados', 'makala.bailey', 'bilgesukaymaz', 'neeraj.chimankar', 'tanmaypatil1598', 'haydartaskaya', 'mehmetock777', 'mbrk747', 'liamfitzgerald', 'dimplekochar3', 'keszler', 'havich', 'himanshuaswani123', 'seg915ept', 'sucheta317', 'jblopez2', 'shehab', 'ibrahimyararoglu', 'riosdaniel2014', 'devanshu', 'gokay.yilmaz', 'roy.mustang.eb', 'minatarek', 'ryckmonster', 'shauryasindhu', 'ccamarillo6732', 'hazalciftcioglu94', 'fdirisaglik', 'navnitkumar1224', 'rabin401', 'abdorady', 'djcruz', 'nadakoga', 'sandor.one', 'juliadavis19', 'pratyushragini', 'ewoudvissers', 'qwerty56', 'jsproviero', 'mguillen7', 'johnrahill1', 'rishikkumar18', 'mustafaozic42', 'rushib97', 'ethwong', 'brsyldrn', 'ahmed.star2025', 'iaaguilera', 'tskroezen', 'aniketsl', 'sven.siegmund', 'max2aneeb', 'navoj98', 'gizemuysal']"
1,20,391,15,1,['x.ganerdene'],390,"['hasanaltintas', 'remsatkan', 'hakan_bicer_96', 'yagaat.smellypitts', 'kritikamna23', 'trinath', 'brekgungor', 'music20011', 'jajung89', 'ozlemsila1', 'shaimaamohamed61195', 'ezgibicak', 'nuri', 'neharikajali', 'salma_hesham', 'abduljalilahmed94', 'covarrubiasjaz05', 'ozlemkrms', 'mhyavuz', 'erenkeskin95', 'chingyinglu89', 'woooney', 'ahmetkaangecer', 'aldoalcantara1', 'arthurxavier.engineer', 'zoz', 'joelrc', 'kbkadir', 'mguillen6', 'aniketbhatia2107', 'mohamed3ssam', 'b10104023', 'singhalanirudh18', 'kzm_dmrlnk', 'senaydogn26', 'kemreakkas', 'ali.solak.1996', 'aliercn964', 'julio_c1712', 'alshareefabdulmajeed', 'austinsams', 'mark.hogg131', 'pirojiwalasubham', 'denizcango', 'ahmetdemir', 'acrylonitrile', 'eng.walaagomaaali', 'yojit105', 'ps5014', 'perihansherif', 'harsh05september', 'groever', 'hsncnyhn', 'akashminato1', 'sudhiriitb', 'michaelconnors', 'caner.baydan', 'jhorton19', 'ahmed_devices', 'highlander2475', 'louiscolson', 'hakanburakbalamir1', 'aavasquez2', 'drhodges', 'shashiadi', 'eggacher', 'ryanwood98', 'tugay95', 'bhu01', 'nemadepsn', 'ccheng852', 'simingma', 'phili180296', 'beraatyigit26', 'mattchuaruiyan', 'areeba123', 'dskartal16', 'neildalal', 'feruiz2', 'silicongo7', 'mjmartinez283', 'shubhangb97', 'kewang.ritsumei', 'shangdi1214', 'ezgii0088', 'amira123', 'abhikanse', 'mwong', 'yarenturker12', 'shaynesmq', 'kumar_ashutosh', 'jazzminesaif66', 'luisggranadost98', 'coolzach999', 'sanidhya27', 'cngzbdr', 'ayesharashid', 'ssdominguez', 'ingrammyles8', 'gunny.balakrishnan', 'mohamedabdelsalam', 'kubraciloglu', 'manar.ibraheem', 'makyz', 'terryyouknow988', 'acostadavid', 'daliahalmy', 'th3prince', 'esraaahmedabdelaal', 'menginaslan', 'tlordello', 'mustafaenesgner', 'liubenliang', 'khandelwalsanyam87', 'baranoncul', 'shashankti111', 'avinashkmry', 'deraz96', 'alejandro.juvera', 'yassinmahdy', 'saisireesha', 'nado.mahmoud1995', 'fvasquez6', 'wdang', 'hatem.rashwany', 'fang59', 'z.a.guzzardo', 'mcsalasnava', 'jesus_aguirre2000', 'timothyobrien', 'safelix', 'yusuf61', 'caranfatma', 'nourhangamal', 'allisontsay', 'omar.handy.96', 'ak83229', 'anonymousbuggy', 'abdurrahmanonuraydin', 'snjkhatri34', 'aesanchez6', 'vivekkandeyang97', 'noel19419', 'ydidwania', 'rz2405', 'mrryzen', 'nishagb04', 'calebringkob', 'anaselsabagh', 'mgthway', 'mustafaali12', 'mehmetdayioglu', 'lakshyakumarsingh', 'duenes957', 'mrinalrao1810', 'osmancanylmz1996', 'liuyuan', 'niamhmulholland', 'hobuobi', 'mauriciofalleiros', 'narendrarai1812', 'axsalomon', 'annasp', 'gonzalez.gaston', 'mayur777', 'resuliseri', 'bekirisgor', 'yerenayas', 'mertsen96', 'dirodriguez4', 'zeyneb', 'darivera3', 'dohaga95', 'elpaglia', 'saarthak', 'enesbas', 'halil26', 'ismailkemal', 'zzhanghuang', 'karimaboelmakarem', 'elijahbarrett22', 'ghanshyam.iitb', 'manny2750', 'abdelrahmanahmedabdelghany', 'demetguull', 'emirhan', 'afrahm104', 'virtuspro', 'yukseltugba14', 'jafar.vafaee', 'swadhasanghvi4', 'raaul.09', 'wassupyo412', 'mrtypc1539', 'mmoody.cma', 'aymanbakr1984.1', 'shiz', 'yigitcilce', 'emilyirisdahl', 'byminc', 'jmclean', 'janmol', 'jasmine1323', 'korhan', 'ahmed.r.elhanafy', 'rapacheco', 'nagidal146', 'bagrania385', 'joeeesalah', 'kirbye1101', 'rashmiravindranath', 'mdj', 'snnnnnnnnnnnn', 'ozgeozdamarr', 'vishwas1020', 'ajitzote', 'ahmedsayedeng1', 'ahmetsurucu', 'maged7423', 'eltonlossner', 'archiki', 'srycvk26', 'akashmunda12345', 'apoorvaudikeri', 'danielgetega', 'skucukarabaci', 'adam.kwiatkowski', 'mb141', 'mwood', 'nanomelis1996', 'marcusle', 'camakk', 'revez_tmr', '16d070026', 'ibrahimethemtemel', 'saboueleinen', 'betkahraman', 'mohamedabdelmaksoud1096', 'ayane123', 'cigo', 'pmmadhumita9', 'esraa7725334', 'saqibalisidd', 'feyzas26', 'ksselhi', 'steve.meraz', 'moises.navarro0423', 'glenpyeldho', 'guray.izmir95', 'dmertkeskin', 'anshulvermaiitb', 'aspruha.samal', 'sethabhinav89', 'abdelrahman_magdy', 'lovelyever17', 'love465944', 'sahilkumar1900', 'bhuyashi.deka', 'belmaci', 'violantium5', 'edlucero25', 'rsalgado19', 'zzhiye', 'dm94', 'gparra3', 'nicolekf', 'bahadirsonmezisik', 'tugcemekci', 'melikekorkmaz94', 'kaki.krish15', 'wdoeme93', 'cahidpolat', 'djcastillo', 'ehealey', 'ishitadas1998', 'bugrahansoylu', 'cacortespliego', 'abdullahaksoy26', 'asrivastava98', 'apoorv0', 'anirudh.singhal', 'ibraheemgalal7', 'menaalfread', 'abeischaos', 'ruohanjiang7', 'marissasaenger', 'mohammed123', 'hakanburakbalamir', 'monicaadelfahim', 'muratkoc503', 'rodriguez.joaquin.jesus', 'gabatres', 'mahe19851117', 'serhatgn', 'yaoweixie', 'havanbhavsar03', 'hasibeodak', 'shikhar1799', 'charanadipudi', 'ealvarez44', 'manarnegm', 'uygarelmali', 'hegdeananthar', 'jitendraiitb', 'mail.d', 'sukruardali', 'gao401', 'eslamamr', 'aydinturkkan44', 'saqibali', 'aengingokce', 'ahmed_moustafa_94', 'burcuakts', 'arbaz', 'jacobmeyerson', 'mernaosama40', 'kasapreyizz', 'gunesa96', 'eng.baristatar', 'siber', 'aimenevse', 'beratcandan', 'bilginper24', 'cshwethanayak', 'pandeykratvesh', 'rekharavindrar', 'mrmamos31', 'methemfaik', 'timobrien', 'nora171296', 'vineetkotariya', 'sezerguven', 'refiktuzakli', 'betildiz', 'jajurado3', 'kumaradarsh', 'nagranados', 'makala.bailey', 'bilgesukaymaz', 'neeraj.chimankar', 'tanmaypatil1598', 'haydartaskaya', 'mehmetock777', 'mbrk747', 'liamfitzgerald', 'dimplekochar3', 'keszler', 'havich', 'himanshuaswani123', 'seg915ept', 'sucheta317', 'jblopez2', 'shehab', 'ibrahimyararoglu', 'riosdaniel2014', 'devanshu', 'gokay.yilmaz', 'roy.mustang.eb', 'minatarek', 'ryckmonster', 'shauryasindhu', 'ccamarillo6732', 'hazalciftcioglu94', 'fdirisaglik', 'navnitkumar1224', 'rabin401', 'abdorady', 'djcruz', 'nadakoga', 'sandor.one', 'juliadavis19', 'pratyushragini', 'ewoudvissers', 'qwerty56', 'jsproviero', 'mguillen7', 'johnrahill1', 'rishikkumar18', 'mustafaozic42', 'rushib97', 'ethwong', 'brsyldrn', 'ahmed.star2025', 'iaaguilera', 'tskroezen', 'aniketsl', 'sven.siegmund', 'max2aneeb', 'navoj98', 'gizemuysal']",14,"['ulaankhuu95', 'slize9995', None, 'banzragch', 'seiko_anarjin', 'baagii_homie', 'djtumenjargal', 'anudari', 'ganzo_0306', 'ulaankhuu72', 'bil_marbel', 'luvsantseren_0329', 'choijamts.choijoo', 'gunsnroses.0219']",405,"['hasanaltintas', 'remsatkan', 'hakan_bicer_96', 'yagaat.smellypitts', 'kritikamna23', 'trinath', 'brekgungor', 'music20011', 'jajung89', 'ozlemsila1', 'shaimaamohamed61195', 'ezgibicak', 'nuri', 'neharikajali', 'salma_hesham', 'abduljalilahmed94', 'covarrubiasjaz05', 'ozlemkrms', 'mhyavuz', 'erenkeskin95', 'chingyinglu89', 'woooney', 'ahmetkaangecer', 'aldoalcantara1', 'arthurxavier.engineer', 'zoz', 'joelrc', 'kbkadir', 'mguillen6', 'aniketbhatia2107', 'mohamed3ssam', 'b10104023', 'singhalanirudh18', 'kzm_dmrlnk', 'senaydogn26', 'kemreakkas', 'ali.solak.1996', 'aliercn964', 'julio_c1712', 'alshareefabdulmajeed', 'austinsams', 'ganzo_0306', 'mark.hogg131', 'pirojiwalasubham', 'denizcango', 'ahmetdemir', 'acrylonitrile', 'eng.walaagomaaali', 'yojit105', 'ps5014', 'perihansherif', 'harsh05september', 'groever', 'hsncnyhn', 'akashminato1', 'sudhiriitb', 'michaelconnors', 'caner.baydan', 'jhorton19', 'ahmed_devices', 'highlander2475', 'louiscolson', 'ulaankhuu95', 'hakanburakbalamir1', 'aavasquez2', 'drhodges', 'shashiadi', 'eggacher', 'ryanwood98', 'tugay95', 'bhu01', 'nemadepsn', 'ccheng852', 'simingma', 'phili180296', 'beraatyigit26', 'mattchuaruiyan', 'areeba123', 'dskartal16', 'neildalal', 'feruiz2', 'silicongo7', 'mjmartinez283', 'shubhangb97', 'kewang.ritsumei', 'ulaankhuu72', 'shangdi1214', 'ezgii0088', 'amira123', 'abhikanse', 'mwong', 'yarenturker12', 'shaynesmq', 'kumar_ashutosh', 'jazzminesaif66', 'luisggranadost98', 'coolzach999', 'sanidhya27', 'cngzbdr', 'ayesharashid', 'ssdominguez', 'ingrammyles8', 'gunny.balakrishnan', 'mohamedabdelsalam', 'kubraciloglu', 'manar.ibraheem', 'makyz', 'terryyouknow988', 'acostadavid', 'daliahalmy', 'th3prince', 'esraaahmedabdelaal', 'menginaslan', 'tlordello', 'mustafaenesgner', 'liubenliang', 'banzragch', 'khandelwalsanyam87', 'baranoncul', 'shashankti111', 'avinashkmry', 'deraz96', 'alejandro.juvera', 'yassinmahdy', 'saisireesha', 'nado.mahmoud1995', 'fvasquez6', 'wdang', 'hatem.rashwany', 'fang59', 'z.a.guzzardo', 'mcsalasnava', 'jesus_aguirre2000', 'timothyobrien', 'safelix', 'yusuf61', 'caranfatma', 'nourhangamal', 'allisontsay', 'omar.handy.96', 'ak83229', 'anonymousbuggy', 'abdurrahmanonuraydin', 'snjkhatri34', 'aesanchez6', 'vivekkandeyang97', 'noel19419', 'ydidwania', 'rz2405', 'mrryzen', 'nishagb04', 'calebringkob', 'anaselsabagh', 'mgthway', 'mustafaali12', 'mehmetdayioglu', 'lakshyakumarsingh', 'duenes957', 'mrinalrao1810', 'osmancanylmz1996', 'liuyuan', 'niamhmulholland', 'hobuobi', 'mauriciofalleiros', 'narendrarai1812', 'axsalomon', 'annasp', 'gonzalez.gaston', 'mayur777', 'resuliseri', 'bekirisgor', 'luvsantseren_0329', 'yerenayas', 'mertsen96', 'dirodriguez4', 'zeyneb', 'darivera3', 'dohaga95', 'elpaglia', 'saarthak', 'enesbas', 'halil26', 'ismailkemal', 'zzhanghuang', 'karimaboelmakarem', 'elijahbarrett22', 'ghanshyam.iitb', 'manny2750', 'abdelrahmanahmedabdelghany', 'demetguull', 'emirhan', 'afrahm104', 'virtuspro', 'yukseltugba14', 'jafar.vafaee', 'swadhasanghvi4', 'raaul.09', 'wassupyo412', 'mrtypc1539', 'mmoody.cma', 'aymanbakr1984.1', 'shiz', 'djtumenjargal', 'yigitcilce', 'emilyirisdahl', 'byminc', 'jmclean', 'janmol', 'jasmine1323', 'korhan', 'ahmed.r.elhanafy', 'rapacheco', 'nagidal146', 'bagrania385', 'joeeesalah', 'kirbye1101', 'rashmiravindranath', 'mdj', 'snnnnnnnnnnnn', 'ozgeozdamarr', 'vishwas1020', 'ajitzote', 'ahmedsayedeng1', 'slize9995', 'ahmetsurucu', 'maged7423', 'eltonlossner', 'archiki', 'srycvk26', 'akashmunda12345', 'apoorvaudikeri', 'danielgetega', 'skucukarabaci', 'adam.kwiatkowski', 'mb141', 'mwood', 'nanomelis1996', 'marcusle', 'camakk', 'revez_tmr', '16d070026', 'ibrahimethemtemel', 'saboueleinen', 'betkahraman', 'mohamedabdelmaksoud1096', 'ayane123', 'cigo', 'pmmadhumita9', 'esraa7725334', 'saqibalisidd', 'feyzas26', 'ksselhi', 'steve.meraz', 'seiko_anarjin', 'moises.navarro0423', 'glenpyeldho', 'guray.izmir95', 'bil_marbel', 'dmertkeskin', 'anshulvermaiitb', 'aspruha.samal', 'sethabhinav89', 'abdelrahman_magdy', 'lovelyever17', 'love465944', 'sahilkumar1900', 'bhuyashi.deka', 'belmaci', 'violantium5', 'edlucero25', 'rsalgado19', 'zzhiye', 'dm94', 'gparra3', 'nicolekf', 'bahadirsonmezisik', 'tugcemekci', 'melikekorkmaz94', 'kaki.krish15', None, 'wdoeme93', 'cahidpolat', 'djcastillo', 'ehealey', 'ishitadas1998', 'bugrahansoylu', 'x.ganerdene', 'cacortespliego', 'abdullahaksoy26', 'asrivastava98', 'apoorv0', 'anirudh.singhal', 'ibraheemgalal7', 'menaalfread', 'abeischaos', 'ruohanjiang7', 'marissasaenger', 'mohammed123', 'hakanburakbalamir', 'monicaadelfahim', 'muratkoc503', 'rodriguez.joaquin.jesus', 'gabatres', 'mahe19851117', 'serhatgn', 'yaoweixie', 'havanbhavsar03', 'hasibeodak', 'shikhar1799', 'charanadipudi', 'ealvarez44', 'manarnegm', 'uygarelmali', 'hegdeananthar', 'jitendraiitb', 'mail.d', 'sukruardali', 'gao401', 'eslamamr', 'aydinturkkan44', 'saqibali', 'aengingokce', 'ahmed_moustafa_94', 'burcuakts', 'arbaz', 'jacobmeyerson', 'mernaosama40', 'kasapreyizz', 'gunesa96', 'eng.baristatar', 'anudari', 'siber', 'aimenevse', 'beratcandan', 'bilginper24', 'cshwethanayak', 'choijamts.choijoo', 'pandeykratvesh', 'rekharavindrar', 'mrmamos31', 'methemfaik', 'timobrien', 'nora171296', 'vineetkotariya', 'sezerguven', 'refiktuzakli', 'betildiz', 'jajurado3', 'kumaradarsh', 'nagranados', 'makala.bailey', 'bilgesukaymaz', 'neeraj.chimankar', 'tanmaypatil1598', 'haydartaskaya', 'mehmetock777', 'mbrk747', 'liamfitzgerald', 'dimplekochar3', 'keszler', 'havich', 'himanshuaswani123', 'seg915ept', 'sucheta317', 'jblopez2', 'shehab', 'ibrahimyararoglu', 'baagii_homie', 'riosdaniel2014', 'devanshu', 'gokay.yilmaz', 'roy.mustang.eb', 'minatarek', 'ryckmonster', 'shauryasindhu', 'ccamarillo6732', 'hazalciftcioglu94', 'fdirisaglik', 'navnitkumar1224', 'gunsnroses.0219', 'rabin401', 'abdorady', 'djcruz', 'nadakoga', 'sandor.one', 'juliadavis19', 'pratyushragini', 'ewoudvissers', 'qwerty56', 'jsproviero', 'mguillen7', 'johnrahill1', 'rishikkumar18', 'mustafaozic42', 'rushib97', 'ethwong', 'brsyldrn', 'ahmed.star2025', 'iaaguilera', 'tskroezen', 'aniketsl', 'sven.siegmund', 'max2aneeb', 'navoj98', 'gizemuysal']"
1,235,391,15,2,"['wdang', 'marcusle']",389,"['hasanaltintas', 'remsatkan', 'hakan_bicer_96', 'yagaat.smellypitts', 'kritikamna23', 'trinath', 'brekgungor', 'music20011', 'jajung89', 'ozlemsila1', 'shaimaamohamed61195', 'ezgibicak', 'nuri', 'neharikajali', 'salma_hesham', 'abduljalilahmed94', 'covarrubiasjaz05', 'ozlemkrms', 'mhyavuz', 'erenkeskin95', 'chingyinglu89', 'woooney', 'ahmetkaangecer', 'aldoalcantara1', 'arthurxavier.engineer', 'zoz', 'joelrc', 'kbkadir', 'mguillen6', 'aniketbhatia2107', 'mohamed3ssam', 'b10104023', 'singhalanirudh18', 'kzm_dmrlnk', 'senaydogn26', 'kemreakkas', 'ali.solak.1996', 'aliercn964', 'julio_c1712', 'alshareefabdulmajeed', 'austinsams', 'mark.hogg131', 'pirojiwalasubham', 'denizcango', 'ahmetdemir', 'acrylonitrile', 'eng.walaagomaaali', 'yojit105', 'ps5014', 'perihansherif', 'harsh05september', 'groever', 'hsncnyhn', 'akashminato1', 'sudhiriitb', 'michaelconnors', 'caner.baydan', 'jhorton19', 'ahmed_devices', 'highlander2475', 'louiscolson', 'hakanburakbalamir1', 'aavasquez2', 'drhodges', 'shashiadi', 'eggacher', 'ryanwood98', 'tugay95', 'bhu01', 'nemadepsn', 'ccheng852', 'simingma', 'phili180296', 'beraatyigit26', 'mattchuaruiyan', 'areeba123', 'dskartal16', 'neildalal', 'feruiz2', 'silicongo7', 'mjmartinez283', 'shubhangb97', 'kewang.ritsumei', 'shangdi1214', 'ezgii0088', 'amira123', 'abhikanse', 'mwong', 'yarenturker12', 'shaynesmq', 'kumar_ashutosh', 'jazzminesaif66', 'luisggranadost98', 'coolzach999', 'sanidhya27', 'cngzbdr', 'ayesharashid', 'ssdominguez', 'ingrammyles8', 'gunny.balakrishnan', 'mohamedabdelsalam', 'kubraciloglu', 'manar.ibraheem', 'makyz', 'terryyouknow988', 'acostadavid', 'daliahalmy', 'th3prince', 'esraaahmedabdelaal', 'menginaslan', 'tlordello', 'mustafaenesgner', 'liubenliang', 'khandelwalsanyam87', 'baranoncul', 'shashankti111', 'avinashkmry', 'deraz96', 'alejandro.juvera', 'yassinmahdy', 'saisireesha', 'nado.mahmoud1995', 'fvasquez6', 'hatem.rashwany', 'fang59', 'z.a.guzzardo', 'mcsalasnava', 'jesus_aguirre2000', 'timothyobrien', 'safelix', 'yusuf61', 'caranfatma', 'nourhangamal', 'allisontsay', 'omar.handy.96', 'ak83229', 'anonymousbuggy', 'abdurrahmanonuraydin', 'snjkhatri34', 'aesanchez6', 'vivekkandeyang97', 'noel19419', 'ydidwania', 'rz2405', 'mrryzen', 'nishagb04', 'calebringkob', 'anaselsabagh', 'mgthway', 'mustafaali12', 'mehmetdayioglu', 'lakshyakumarsingh', 'duenes957', 'mrinalrao1810', 'osmancanylmz1996', 'liuyuan', 'niamhmulholland', 'hobuobi', 'mauriciofalleiros', 'narendrarai1812', 'axsalomon', 'annasp', 'gonzalez.gaston', 'mayur777', 'resuliseri', 'bekirisgor', 'yerenayas', 'mertsen96', 'dirodriguez4', 'zeyneb', 'darivera3', 'dohaga95', 'elpaglia', 'saarthak', 'enesbas', 'halil26', 'ismailkemal', 'zzhanghuang', 'karimaboelmakarem', 'elijahbarrett22', 'ghanshyam.iitb', 'manny2750', 'abdelrahmanahmedabdelghany', 'demetguull', 'emirhan', 'afrahm104', 'virtuspro', 'yukseltugba14', 'jafar.vafaee', 'swadhasanghvi4', 'raaul.09', 'wassupyo412', 'mrtypc1539', 'mmoody.cma', 'aymanbakr1984.1', 'shiz', 'yigitcilce', 'emilyirisdahl', 'byminc', 'jmclean', 'janmol', 'jasmine1323', 'korhan', 'ahmed.r.elhanafy', 'rapacheco', 'nagidal146', 'bagrania385', 'joeeesalah', 'kirbye1101', 'rashmiravindranath', 'mdj', 'snnnnnnnnnnnn', 'ozgeozdamarr', 'vishwas1020', 'ajitzote', 'ahmedsayedeng1', 'ahmetsurucu', 'maged7423', 'eltonlossner', 'archiki', 'srycvk26', 'akashmunda12345', 'apoorvaudikeri', 'danielgetega', 'skucukarabaci', 'adam.kwiatkowski', 'mb141', 'mwood', 'nanomelis1996', 'camakk', 'revez_tmr', '16d070026', 'ibrahimethemtemel', 'saboueleinen', 'betkahraman', 'mohamedabdelmaksoud1096', 'ayane123', 'cigo', 'pmmadhumita9', 'esraa7725334', 'saqibalisidd', 'feyzas26', 'ksselhi', 'steve.meraz', 'moises.navarro0423', 'glenpyeldho', 'guray.izmir95', 'dmertkeskin', 'anshulvermaiitb', 'aspruha.samal', 'sethabhinav89', 'abdelrahman_magdy', 'lovelyever17', 'love465944', 'sahilkumar1900', 'bhuyashi.deka', 'belmaci', 'violantium5', 'edlucero25', 'rsalgado19', 'zzhiye', 'dm94', 'gparra3', 'nicolekf', 'bahadirsonmezisik', 'tugcemekci', 'melikekorkmaz94', 'kaki.krish15', 'wdoeme93', 'cahidpolat', 'djcastillo', 'ehealey', 'ishitadas1998', 'bugrahansoylu', 'x.ganerdene', 'cacortespliego', 'abdullahaksoy26', 'asrivastava98', 'apoorv0', 'anirudh.singhal', 'ibraheemgalal7', 'menaalfread', 'abeischaos', 'ruohanjiang7', 'marissasaenger', 'mohammed123', 'hakanburakbalamir', 'monicaadelfahim', 'muratkoc503', 'rodriguez.joaquin.jesus', 'gabatres', 'mahe19851117', 'serhatgn', 'yaoweixie', 'havanbhavsar03', 'hasibeodak', 'shikhar1799', 'charanadipudi', 'ealvarez44', 'manarnegm', 'uygarelmali', 'hegdeananthar', 'jitendraiitb', 'mail.d', 'sukruardali', 'gao401', 'eslamamr', 'aydinturkkan44', 'saqibali', 'aengingokce', 'ahmed_moustafa_94', 'burcuakts', 'arbaz', 'jacobmeyerson', 'mernaosama40', 'kasapreyizz', 'gunesa96', 'eng.baristatar', 'siber', 'aimenevse', 'beratcandan', 'bilginper24', 'cshwethanayak', 'pandeykratvesh', 'rekharavindrar', 'mrmamos31', 'methemfaik', 'timobrien', 'nora171296', 'vineetkotariya', 'sezerguven', 'refiktuzakli', 'betildiz', 'jajurado3', 'kumaradarsh', 'nagranados', 'makala.bailey', 'bilgesukaymaz', 'neeraj.chimankar', 'tanmaypatil1598', 'haydartaskaya', 'mehmetock777', 'mbrk747', 'liamfitzgerald', 'dimplekochar3', 'keszler', 'havich', 'himanshuaswani123', 'seg915ept', 'sucheta317', 'jblopez2', 'shehab', 'ibrahimyararoglu', 'riosdaniel2014', 'devanshu', 'gokay.yilmaz', 'roy.mustang.eb', 'minatarek', 'ryckmonster', 'shauryasindhu', 'ccamarillo6732', 'hazalciftcioglu94', 'fdirisaglik', 'navnitkumar1224', 'rabin401', 'abdorady', 'djcruz', 'nadakoga', 'sandor.one', 'juliadavis19', 'pratyushragini', 'ewoudvissers', 'qwerty56', 'jsproviero', 'mguillen7', 'johnrahill1', 'rishikkumar18', 'mustafaozic42', 'rushib97', 'ethwong', 'brsyldrn', 'ahmed.star2025', 'iaaguilera', 'tskroezen', 'aniketsl', 'sven.siegmund', 'max2aneeb', 'navoj98', 'gizemuysal']",13,"['akaluzny', 'dkurpaska', 'ztoscanini', 'aksamija', 'hubertlin', 'lucasguertin', 'rkornitsky', 'markgillespi', 'lemerson', 'ewlee', None, 'dgage', 'oyacteen']",404,"['hasanaltintas', 'remsatkan', 'hakan_bicer_96', 'yagaat.smellypitts', 'kritikamna23', 'trinath', 'brekgungor', 'music20011', 'jajung89', 'ozlemsila1', 'shaimaamohamed61195', 'ezgibicak', 'nuri', 'neharikajali', 'salma_hesham', 'abduljalilahmed94', 'covarrubiasjaz05', 'ozlemkrms', 'mhyavuz', 'erenkeskin95', 'chingyinglu89', 'woooney', 'ahmetkaangecer', 'rkornitsky', 'aldoalcantara1', 'markgillespi', 'arthurxavier.engineer', 'zoz', 'joelrc', 'kbkadir', 'mguillen6', 'aniketbhatia2107', 'mohamed3ssam', 'b10104023', 'singhalanirudh18', 'kzm_dmrlnk', 'senaydogn26', 'kemreakkas', 'ali.solak.1996', 'aliercn964', 'julio_c1712', 'alshareefabdulmajeed', 'austinsams', 'mark.hogg131', 'pirojiwalasubham', 'denizcango', 'ahmetdemir', 'acrylonitrile', 'eng.walaagomaaali', 'yojit105', 'ps5014', 'perihansherif', 'harsh05september', 'groever', 'hsncnyhn', 'akashminato1', 'sudhiriitb', 'michaelconnors', 'caner.baydan', 'jhorton19', 'ahmed_devices', 'highlander2475', 'louiscolson', 'hakanburakbalamir1', 'aavasquez2', 'drhodges', 'shashiadi', 'eggacher', 'ryanwood98', 'tugay95', 'bhu01', 'nemadepsn', 'ccheng852', 'simingma', 'phili180296', 'beraatyigit26', 'mattchuaruiyan', 'areeba123', 'dskartal16', 'neildalal', 'feruiz2', 'silicongo7', 'mjmartinez283', 'shubhangb97', 'kewang.ritsumei', 'shangdi1214', 'ezgii0088', 'amira123', 'abhikanse', 'mwong', 'yarenturker12', 'shaynesmq', 'kumar_ashutosh', 'jazzminesaif66', 'luisggranadost98', 'coolzach999', 'sanidhya27', 'cngzbdr', 'ayesharashid', 'ssdominguez', 'ingrammyles8', 'gunny.balakrishnan', 'mohamedabdelsalam', 'kubraciloglu', 'manar.ibraheem', 'makyz', 'terryyouknow988', 'acostadavid', 'daliahalmy', 'th3prince', 'esraaahmedabdelaal', 'menginaslan', 'tlordello', 'mustafaenesgner', 'liubenliang', 'khandelwalsanyam87', 'baranoncul', 'shashankti111', 'avinashkmry', 'deraz96', 'alejandro.juvera', 'yassinmahdy', 'saisireesha', 'nado.mahmoud1995', 'fvasquez6', 'wdang', 'hatem.rashwany', 'fang59', 'z.a.guzzardo', 'mcsalasnava', 'akaluzny', 'jesus_aguirre2000', 'timothyobrien', 'safelix', 'yusuf61', 'caranfatma', 'nourhangamal', 'allisontsay', 'omar.handy.96', 'ak83229', 'anonymousbuggy', 'abdurrahmanonuraydin', 'snjkhatri34', 'aesanchez6', 'vivekkandeyang97', 'noel19419', 'ydidwania', 'rz2405', 'mrryzen', 'nishagb04', 'calebringkob', 'anaselsabagh', 'mgthway', 'mustafaali12', 'mehmetdayioglu', 'lakshyakumarsingh', 'duenes957', 'mrinalrao1810', 'osmancanylmz1996', 'liuyuan', 'niamhmulholland', 'hobuobi', 'mauriciofalleiros', 'narendrarai1812', 'axsalomon', 'annasp', 'gonzalez.gaston', 'mayur777', 'resuliseri', 'bekirisgor', 'yerenayas', 'mertsen96', 'dirodriguez4', 'zeyneb', 'darivera3', 'dohaga95', 'elpaglia', 'saarthak', 'enesbas', 'halil26', 'ismailkemal', 'zzhanghuang', 'karimaboelmakarem', 'elijahbarrett22', 'ghanshyam.iitb', 'manny2750', 'abdelrahmanahmedabdelghany', 'demetguull', 'emirhan', 'afrahm104', 'virtuspro', 'yukseltugba14', 'jafar.vafaee', 'swadhasanghvi4', 'raaul.09', 'wassupyo412', 'dkurpaska', 'ztoscanini', 'mrtypc1539', 'mmoody.cma', 'aymanbakr1984.1', 'shiz', 'yigitcilce', 'emilyirisdahl', 'byminc', 'jmclean', 'janmol', 'jasmine1323', 'korhan', 'ahmed.r.elhanafy', 'rapacheco', 'nagidal146', 'bagrania385', 'joeeesalah', 'kirbye1101', 'rashmiravindranath', 'mdj', 'snnnnnnnnnnnn', 'ozgeozdamarr', 'vishwas1020', 'ajitzote', 'ahmedsayedeng1', 'oyacteen', 'ahmetsurucu', 'maged7423', 'eltonlossner', 'archiki', 'srycvk26', 'akashmunda12345', 'apoorvaudikeri', 'danielgetega', 'skucukarabaci', 'adam.kwiatkowski', 'mb141', 'mwood', 'nanomelis1996', 'marcusle', 'camakk', 'revez_tmr', '16d070026', 'ibrahimethemtemel', 'saboueleinen', 'betkahraman', 'mohamedabdelmaksoud1096', 'ayane123', 'cigo', 'pmmadhumita9', 'esraa7725334', 'saqibalisidd', 'feyzas26', 'ksselhi', 'steve.meraz', 'moises.navarro0423', 'glenpyeldho', 'guray.izmir95', 'dmertkeskin', 'anshulvermaiitb', 'aspruha.samal', 'sethabhinav89', 'abdelrahman_magdy', 'lovelyever17', 'love465944', 'sahilkumar1900', 'bhuyashi.deka', 'belmaci', 'violantium5', 'edlucero25', 'rsalgado19', 'zzhiye', 'dm94', 'gparra3', 'nicolekf', 'bahadirsonmezisik', 'tugcemekci', 'melikekorkmaz94', 'kaki.krish15', None, 'dgage', 'wdoeme93', 'cahidpolat', 'djcastillo', 'ehealey', 'ishitadas1998', 'bugrahansoylu', 'x.ganerdene', 'cacortespliego', 'abdullahaksoy26', 'asrivastava98', 'apoorv0', 'anirudh.singhal', 'ibraheemgalal7', 'menaalfread', 'abeischaos', 'ruohanjiang7', 'marissasaenger', 'mohammed123', 'hakanburakbalamir', 'monicaadelfahim', 'muratkoc503', 'rodriguez.joaquin.jesus', 'gabatres', 'mahe19851117', 'serhatgn', 'yaoweixie', 'havanbhavsar03', 'hasibeodak', 'shikhar1799', 'charanadipudi', 'ealvarez44', 'manarnegm', 'uygarelmali', 'hegdeananthar', 'ewlee', 'jitendraiitb', 'mail.d', 'sukruardali', 'gao401', 'eslamamr', 'aydinturkkan44', 'aksamija', 'saqibali', 'aengingokce', 'ahmed_moustafa_94', 'burcuakts', 'arbaz', 'jacobmeyerson', 'mernaosama40', 'kasapreyizz', 'gunesa96', 'eng.baristatar', 'siber', 'aimenevse', 'beratcandan', 'bilginper24', 'cshwethanayak', 'pandeykratvesh', 'rekharavindrar', 'mrmamos31', 'methemfaik', 'timobrien', 'nora171296', 'vineetkotariya', 'sezerguven', 'refiktuzakli', 'betildiz', 'jajurado3', 'kumaradarsh', 'nagranados', 'makala.bailey', 'bilgesukaymaz', 'neeraj.chimankar', 'tanmaypatil1598', 'haydartaskaya', 'mehmetock777', 'mbrk747', 'liamfitzgerald', 'dimplekochar3', 'keszler', 'havich', 'himanshuaswani123', 'lemerson', 'seg915ept', 'sucheta317', 'jblopez2', 'shehab', 'ibrahimyararoglu', 'hubertlin', 'riosdaniel2014', 'lucasguertin', 'devanshu', 'gokay.yilmaz', 'roy.mustang.eb', 'minatarek', 'ryckmonster', 'shauryasindhu', 'ccamarillo6732', 'hazalciftcioglu94', 'fdirisaglik', 'navnitkumar1224', 'rabin401', 'abdorady', 'djcruz', 'nadakoga', 'sandor.one', 'juliadavis19', 'pratyushragini', 'ewoudvissers', 'qwerty56', 'jsproviero', 'mguillen7', 'johnrahill1', 'rishikkumar18', 'mustafaozic42', 'rushib97', 'ethwong', 'brsyldrn', 'ahmed.star2025', 'iaaguilera', 'tskroezen', 'aniketsl', 'sven.siegmund', 'max2aneeb', 'navoj98', 'gizemuysal']"
1,320,391,11,10,"['kzm_dmrlnk', 'abdurrahmanonuraydin', 'hakanburakbalamir1', 'kubraciloglu', 'beratcandan', 'revez_tmr', 'guray.izmir95', 'burcuakts', 'fdirisaglik', 'ahmetdemir']",381,"['hasanaltintas', 'remsatkan', 'hakan_bicer_96', 'yagaat.smellypitts', 'kritikamna23', 'trinath', 'brekgungor', 'music20011', 'jajung89', 'ozlemsila1', 'shaimaamohamed61195', 'ezgibicak', 'nuri', 'neharikajali', 'salma_hesham', 'abduljalilahmed94', 'covarrubiasjaz05', 'ozlemkrms', 'mhyavuz', 'erenkeskin95', 'chingyinglu89', 'woooney', 'ahmetkaangecer', 'aldoalcantara1', 'arthurxavier.engineer', 'zoz', 'joelrc', 'kbkadir', 'mguillen6', 'aniketbhatia2107', 'mohamed3ssam', 'b10104023', 'singhalanirudh18', 'senaydogn26', 'kemreakkas', 'ali.solak.1996', 'aliercn964', 'julio_c1712', 'alshareefabdulmajeed', 'austinsams', 'mark.hogg131', 'pirojiwalasubham', 'denizcango', 'acrylonitrile', 'eng.walaagomaaali', 'yojit105', 'ps5014', 'perihansherif', 'harsh05september', 'groever', 'hsncnyhn', 'akashminato1', 'sudhiriitb', 'michaelconnors', 'caner.baydan', 'jhorton19', 'ahmed_devices', 'highlander2475', 'louiscolson', 'aavasquez2', 'drhodges', 'shashiadi', 'eggacher', 'ryanwood98', 'tugay95', 'bhu01', 'nemadepsn', 'ccheng852', 'simingma', 'phili180296', 'beraatyigit26', 'mattchuaruiyan', 'areeba123', 'dskartal16', 'neildalal', 'feruiz2', 'silicongo7', 'mjmartinez283', 'shubhangb97', 'kewang.ritsumei', 'shangdi1214', 'ezgii0088', 'amira123', 'abhikanse', 'mwong', 'yarenturker12', 'shaynesmq', 'kumar_ashutosh', 'jazzminesaif66', 'luisggranadost98', 'coolzach999', 'sanidhya27', 'cngzbdr', 'ayesharashid', 'ssdominguez', 'ingrammyles8', 'gunny.balakrishnan', 'mohamedabdelsalam', 'manar.ibraheem', 'makyz', 'terryyouknow988', 'acostadavid', 'daliahalmy', 'th3prince', 'esraaahmedabdelaal', 'menginaslan', 'tlordello', 'mustafaenesgner', 'liubenliang', 'khandelwalsanyam87', 'baranoncul', 'shashankti111', 'avinashkmry', 'deraz96', 'alejandro.juvera', 'yassinmahdy', 'saisireesha', 'nado.mahmoud1995', 'fvasquez6', 'wdang', 'hatem.rashwany', 'fang59', 'z.a.guzzardo', 'mcsalasnava', 'jesus_aguirre2000', 'timothyobrien', 'safelix', 'yusuf61', 'caranfatma', 'nourhangamal', 'allisontsay', 'omar.handy.96', 'ak83229', 'anonymousbuggy', 'snjkhatri34', 'aesanchez6', 'vivekkandeyang97', 'noel19419', 'ydidwania', 'rz2405', 'mrryzen', 'nishagb04', 'calebringkob', 'anaselsabagh', 'mgthway', 'mustafaali12', 'mehmetdayioglu', 'lakshyakumarsingh', 'duenes957', 'mrinalrao1810', 'osmancanylmz1996', 'liuyuan', 'niamhmulholland', 'hobuobi', 'mauriciofalleiros', 'narendrarai1812', 'axsalomon', 'annasp', 'gonzalez.gaston', 'mayur777', 'resuliseri', 'bekirisgor', 'yerenayas', 'mertsen96', 'dirodriguez4', 'zeyneb', 'darivera3', 'dohaga95', 'elpaglia', 'saarthak', 'enesbas', 'halil26', 'ismailkemal', 'zzhanghuang', 'karimaboelmakarem', 'elijahbarrett22', 'ghanshyam.iitb', 'manny2750', 'abdelrahmanahmedabdelghany', 'demetguull', 'emirhan', 'afrahm104', 'virtuspro', 'yukseltugba14', 'jafar.vafaee', 'swadhasanghvi4', 'raaul.09', 'wassupyo412', 'mrtypc1539', 'mmoody.cma', 'aymanbakr1984.1', 'shiz', 'yigitcilce', 'emilyirisdahl', 'byminc', 'jmclean', 'janmol', 'jasmine1323', 'korhan', 'ahmed.r.elhanafy', 'rapacheco', 'nagidal146', 'bagrania385', 'joeeesalah', 'kirbye1101', 'rashmiravindranath', 'mdj', 'snnnnnnnnnnnn', 'ozgeozdamarr', 'vishwas1020', 'ajitzote', 'ahmedsayedeng1', 'ahmetsurucu', 'maged7423', 'eltonlossner', 'archiki', 'srycvk26', 'akashmunda12345', 'apoorvaudikeri', 'danielgetega', 'skucukarabaci', 'adam.kwiatkowski', 'mb141', 'mwood', 'nanomelis1996', 'marcusle', 'camakk', '16d070026', 'ibrahimethemtemel', 'saboueleinen', 'betkahraman', 'mohamedabdelmaksoud1096', 'ayane123', 'cigo', 'pmmadhumita9', 'esraa7725334', 'saqibalisidd', 'feyzas26', 'ksselhi', 'steve.meraz', 'moises.navarro0423', 'glenpyeldho', 'dmertkeskin', 'anshulvermaiitb', 'aspruha.samal', 'sethabhinav89', 'abdelrahman_magdy', 'lovelyever17', 'love465944', 'sahilkumar1900', 'bhuyashi.deka', 'belmaci', 'violantium5', 'edlucero25', 'rsalgado19', 'zzhiye', 'dm94', 'gparra3', 'nicolekf', 'bahadirsonmezisik', 'tugcemekci', 'melikekorkmaz94', 'kaki.krish15', 'wdoeme93', 'cahidpolat', 'djcastillo', 'ehealey', 'ishitadas1998', 'bugrahansoylu', 'x.ganerdene', 'cacortespliego', 'abdullahaksoy26', 'asrivastava98', 'apoorv0', 'anirudh.singhal', 'ibraheemgalal7', 'menaalfread', 'abeischaos', 'ruohanjiang7', 'marissasaenger', 'mohammed123', 'hakanburakbalamir', 'monicaadelfahim', 'muratkoc503', 'rodriguez.joaquin.jesus', 'gabatres', 'mahe19851117', 'serhatgn', 'yaoweixie', 'havanbhavsar03', 'hasibeodak', 'shikhar1799', 'charanadipudi', 'ealvarez44', 'manarnegm', 'uygarelmali', 'hegdeananthar', 'jitendraiitb', 'mail.d', 'sukruardali', 'gao401', 'eslamamr', 'aydinturkkan44', 'saqibali', 'aengingokce', 'ahmed_moustafa_94', 'arbaz', 'jacobmeyerson', 'mernaosama40', 'kasapreyizz', 'gunesa96', 'eng.baristatar', 'siber', 'aimenevse', 'bilginper24', 'cshwethanayak', 'pandeykratvesh', 'rekharavindrar', 'mrmamos31', 'methemfaik', 'timobrien', 'nora171296', 'vineetkotariya', 'sezerguven', 'refiktuzakli', 'betildiz', 'jajurado3', 'kumaradarsh', 'nagranados', 'makala.bailey', 'bilgesukaymaz', 'neeraj.chimankar', 'tanmaypatil1598', 'haydartaskaya', 'mehmetock777', 'mbrk747', 'liamfitzgerald', 'dimplekochar3', 'keszler', 'havich', 'himanshuaswani123', 'seg915ept', 'sucheta317', 'jblopez2', 'shehab', 'ibrahimyararoglu', 'riosdaniel2014', 'devanshu', 'gokay.yilmaz', 'roy.mustang.eb', 'minatarek', 'ryckmonster', 'shauryasindhu', 'ccamarillo6732', 'hazalciftcioglu94', 'navnitkumar1224', 'rabin401', 'abdorady', 'djcruz', 'nadakoga', 'sandor.one', 'juliadavis19', 'pratyushragini', 'ewoudvissers', 'qwerty56', 'jsproviero', 'mguillen7', 'johnrahill1', 'rishikkumar18', 'mustafaozic42', 'rushib97', 'ethwong', 'brsyldrn', 'ahmed.star2025', 'iaaguilera', 'tskroezen', 'aniketsl', 'sven.siegmund', 'max2aneeb', 'navoj98', 'gizemuysal']",1,[None],392,"['hasanaltintas', 'remsatkan', 'hakan_bicer_96', 'yagaat.smellypitts', 'kritikamna23', 'trinath', 'brekgungor', 'music20011', 'jajung89', 'ozlemsila1', 'shaimaamohamed61195', 'ezgibicak', 'nuri', 'neharikajali', 'salma_hesham', 'abduljalilahmed94', 'covarrubiasjaz05', 'ozlemkrms', 'mhyavuz', 'erenkeskin95', 'chingyinglu89', 'woooney', 'ahmetkaangecer', 'aldoalcantara1', 'arthurxavier.engineer', 'zoz', 'joelrc', 'kbkadir', 'mguillen6', 'aniketbhatia2107', 'mohamed3ssam', 'b10104023', 'singhalanirudh18', 'kzm_dmrlnk', 'senaydogn26', 'kemreakkas', 'ali.solak.1996', 'aliercn964', 'julio_c1712', 'alshareefabdulmajeed', 'austinsams', 'mark.hogg131', 'pirojiwalasubham', 'denizcango', 'ahmetdemir', 'acrylonitrile', 'eng.walaagomaaali', 'yojit105', 'ps5014', 'perihansherif', 'harsh05september', 'groever', 'hsncnyhn', 'akashminato1', 'sudhiriitb', 'michaelconnors', 'caner.baydan', 'jhorton19', 'ahmed_devices', 'highlander2475', 'louiscolson', 'hakanburakbalamir1', 'aavasquez2', 'drhodges', 'shashiadi', 'eggacher', 'ryanwood98', 'tugay95', 'bhu01', 'nemadepsn', 'ccheng852', 'simingma', 'phili180296', 'beraatyigit26', 'mattchuaruiyan', 'areeba123', 'dskartal16', 'neildalal', 'feruiz2', 'silicongo7', 'mjmartinez283', 'shubhangb97', 'kewang.ritsumei', 'shangdi1214', 'ezgii0088', 'amira123', 'abhikanse', 'mwong', 'yarenturker12', 'shaynesmq', 'kumar_ashutosh', 'jazzminesaif66', 'luisggranadost98', 'coolzach999', 'sanidhya27', 'cngzbdr', 'ayesharashid', 'ssdominguez', 'ingrammyles8', 'gunny.balakrishnan', 'mohamedabdelsalam', 'kubraciloglu', 'manar.ibraheem', 'makyz', 'terryyouknow988', 'acostadavid', 'daliahalmy', 'th3prince', 'esraaahmedabdelaal', 'menginaslan', 'tlordello', 'mustafaenesgner', 'liubenliang', 'khandelwalsanyam87', 'baranoncul', 'shashankti111', 'avinashkmry', 'deraz96', 'alejandro.juvera', 'yassinmahdy', 'saisireesha', 'nado.mahmoud1995', 'fvasquez6', 'wdang', 'hatem.rashwany', 'fang59', 'z.a.guzzardo', 'mcsalasnava', 'jesus_aguirre2000', 'timothyobrien', 'safelix', 'yusuf61', 'caranfatma', 'nourhangamal', 'allisontsay', 'omar.handy.96', 'ak83229', 'anonymousbuggy', 'abdurrahmanonuraydin', 'snjkhatri34', 'aesanchez6', 'vivekkandeyang97', 'noel19419', 'ydidwania', 'rz2405', 'mrryzen', 'nishagb04', 'calebringkob', 'anaselsabagh', 'mgthway', 'mustafaali12', 'mehmetdayioglu', 'lakshyakumarsingh', 'duenes957', 'mrinalrao1810', 'osmancanylmz1996', 'liuyuan', 'niamhmulholland', 'hobuobi', 'mauriciofalleiros', 'narendrarai1812', 'axsalomon', 'annasp', 'gonzalez.gaston', 'mayur777', 'resuliseri', 'bekirisgor', 'yerenayas', 'mertsen96', 'dirodriguez4', 'zeyneb', 'darivera3', 'dohaga95', 'elpaglia', 'saarthak', 'enesbas', 'halil26', 'ismailkemal', 'zzhanghuang', 'karimaboelmakarem', 'elijahbarrett22', 'ghanshyam.iitb', 'manny2750', 'abdelrahmanahmedabdelghany', 'demetguull', 'emirhan', 'afrahm104', 'virtuspro', 'yukseltugba14', 'jafar.vafaee', 'swadhasanghvi4', 'raaul.09', 'wassupyo412', 'mrtypc1539', 'mmoody.cma', 'aymanbakr1984.1', 'shiz', 'yigitcilce', 'emilyirisdahl', 'byminc', 'jmclean', 'janmol', 'jasmine1323', 'korhan', 'ahmed.r.elhanafy', 'rapacheco', 'nagidal146', 'bagrania385', 'joeeesalah', 'kirbye1101', 'rashmiravindranath', 'mdj', 'snnnnnnnnnnnn', 'ozgeozdamarr', 'vishwas1020', 'ajitzote', 'ahmedsayedeng1', 'ahmetsurucu', 'maged7423', 'eltonlossner', 'archiki', 'srycvk26', 'akashmunda12345', 'apoorvaudikeri', 'danielgetega', 'skucukarabaci', 'adam.kwiatkowski', 'mb141', 'mwood', 'nanomelis1996', 'marcusle', 'camakk', 'revez_tmr', '16d070026', 'ibrahimethemtemel', 'saboueleinen', 'betkahraman', 'mohamedabdelmaksoud1096', 'ayane123', 'cigo', 'pmmadhumita9', 'esraa7725334', 'saqibalisidd', 'feyzas26', 'ksselhi', 'steve.meraz', 'moises.navarro0423', 'glenpyeldho', 'guray.izmir95', 'dmertkeskin', 'anshulvermaiitb', 'aspruha.samal', 'sethabhinav89', 'abdelrahman_magdy', 'lovelyever17', 'love465944', 'sahilkumar1900', 'bhuyashi.deka', 'belmaci', 'violantium5', 'edlucero25', 'rsalgado19', 'zzhiye', 'dm94', 'gparra3', 'nicolekf', 'bahadirsonmezisik', 'tugcemekci', 'melikekorkmaz94', 'kaki.krish15', None, 'wdoeme93', 'cahidpolat', 'djcastillo', 'ehealey', 'ishitadas1998', 'bugrahansoylu', 'x.ganerdene', 'cacortespliego', 'abdullahaksoy26', 'asrivastava98', 'apoorv0', 'anirudh.singhal', 'ibraheemgalal7', 'menaalfread', 'abeischaos', 'ruohanjiang7', 'marissasaenger', 'mohammed123', 'hakanburakbalamir', 'monicaadelfahim', 'muratkoc503', 'rodriguez.joaquin.jesus', 'gabatres', 'mahe19851117', 'serhatgn', 'yaoweixie', 'havanbhavsar03', 'hasibeodak', 'shikhar1799', 'charanadipudi', 'ealvarez44', 'manarnegm', 'uygarelmali', 'hegdeananthar', 'jitendraiitb', 'mail.d', 'sukruardali', 'gao401', 'eslamamr', 'aydinturkkan44', 'saqibali', 'aengingokce', 'ahmed_moustafa_94', 'burcuakts', 'arbaz', 'jacobmeyerson', 'mernaosama40', 'kasapreyizz', 'gunesa96', 'eng.baristatar', 'siber', 'aimenevse', 'beratcandan', 'bilginper24', 'cshwethanayak', 'pandeykratvesh', 'rekharavindrar', 'mrmamos31', 'methemfaik', 'timobrien', 'nora171296', 'vineetkotariya', 'sezerguven', 'refiktuzakli', 'betildiz', 'jajurado3', 'kumaradarsh', 'nagranados', 'makala.bailey', 'bilgesukaymaz', 'neeraj.chimankar', 'tanmaypatil1598', 'haydartaskaya', 'mehmetock777', 'mbrk747', 'liamfitzgerald', 'dimplekochar3', 'keszler', 'havich', 'himanshuaswani123', 'seg915ept', 'sucheta317', 'jblopez2', 'shehab', 'ibrahimyararoglu', 'riosdaniel2014', 'devanshu', 'gokay.yilmaz', 'roy.mustang.eb', 'minatarek', 'ryckmonster', 'shauryasindhu', 'ccamarillo6732', 'hazalciftcioglu94', 'fdirisaglik', 'navnitkumar1224', 'rabin401', 'abdorady', 'djcruz', 'nadakoga', 'sandor.one', 'juliadavis19', 'pratyushragini', 'ewoudvissers', 'qwerty56', 'jsproviero', 'mguillen7', 'johnrahill1', 'rishikkumar18', 'mustafaozic42', 'rushib97', 'ethwong', 'brsyldrn', 'ahmed.star2025', 'iaaguilera', 'tskroezen', 'aniketsl', 'sven.siegmund', 'max2aneeb', 'navoj98', 'gizemuysal']"
1,323,391,8,6,"['abdelrahmanahmedabdelghany', 'dohaga95', 'mohamedabdelsalam', 'jazzminesaif66', 'th3prince', 'ahmedsayedeng1']",385,"['hasanaltintas', 'remsatkan', 'hakan_bicer_96', 'yagaat.smellypitts', 'kritikamna23', 'trinath', 'brekgungor', 'music20011', 'jajung89', 'ozlemsila1', 'shaimaamohamed61195', 'ezgibicak', 'nuri', 'neharikajali', 'salma_hesham', 'abduljalilahmed94', 'covarrubiasjaz05', 'ozlemkrms', 'mhyavuz', 'erenkeskin95', 'chingyinglu89', 'woooney', 'ahmetkaangecer', 'aldoalcantara1', 'arthurxavier.engineer', 'zoz', 'joelrc', 'kbkadir', 'mguillen6', 'aniketbhatia2107', 'mohamed3ssam', 'b10104023', 'singhalanirudh18', 'kzm_dmrlnk', 'senaydogn26', 'kemreakkas', 'ali.solak.1996', 'aliercn964', 'julio_c1712', 'alshareefabdulmajeed', 'austinsams', 'mark.hogg131', 'pirojiwalasubham', 'denizcango', 'ahmetdemir', 'acrylonitrile', 'eng.walaagomaaali', 'yojit105', 'ps5014', 'perihansherif', 'harsh05september', 'groever', 'hsncnyhn', 'akashminato1', 'sudhiriitb', 'michaelconnors', 'caner.baydan', 'jhorton19', 'ahmed_devices', 'highlander2475', 'louiscolson', 'hakanburakbalamir1', 'aavasquez2', 'drhodges', 'shashiadi', 'eggacher', 'ryanwood98', 'tugay95', 'bhu01', 'nemadepsn', 'ccheng852', 'simingma', 'phili180296', 'beraatyigit26', 'mattchuaruiyan', 'areeba123', 'dskartal16', 'neildalal', 'feruiz2', 'silicongo7', 'mjmartinez283', 'shubhangb97', 'kewang.ritsumei', 'shangdi1214', 'ezgii0088', 'amira123', 'abhikanse', 'mwong', 'yarenturker12', 'shaynesmq', 'kumar_ashutosh', 'luisggranadost98', 'coolzach999', 'sanidhya27', 'cngzbdr', 'ayesharashid', 'ssdominguez', 'ingrammyles8', 'gunny.balakrishnan', 'kubraciloglu', 'manar.ibraheem', 'makyz', 'terryyouknow988', 'acostadavid', 'daliahalmy', 'esraaahmedabdelaal', 'menginaslan', 'tlordello', 'mustafaenesgner', 'liubenliang', 'khandelwalsanyam87', 'baranoncul', 'shashankti111', 'avinashkmry', 'deraz96', 'alejandro.juvera', 'yassinmahdy', 'saisireesha', 'nado.mahmoud1995', 'fvasquez6', 'wdang', 'hatem.rashwany', 'fang59', 'z.a.guzzardo', 'mcsalasnava', 'jesus_aguirre2000', 'timothyobrien', 'safelix', 'yusuf61', 'caranfatma', 'nourhangamal', 'allisontsay', 'omar.handy.96', 'ak83229', 'anonymousbuggy', 'abdurrahmanonuraydin', 'snjkhatri34', 'aesanchez6', 'vivekkandeyang97', 'noel19419', 'ydidwania', 'rz2405', 'mrryzen', 'nishagb04', 'calebringkob', 'anaselsabagh', 'mgthway', 'mustafaali12', 'mehmetdayioglu', 'lakshyakumarsingh', 'duenes957', 'mrinalrao1810', 'osmancanylmz1996', 'liuyuan', 'niamhmulholland', 'hobuobi', 'mauriciofalleiros', 'narendrarai1812', 'axsalomon', 'annasp', 'gonzalez.gaston', 'mayur777', 'resuliseri', 'bekirisgor', 'yerenayas', 'mertsen96', 'dirodriguez4', 'zeyneb', 'darivera3', 'elpaglia', 'saarthak', 'enesbas', 'halil26', 'ismailkemal', 'zzhanghuang', 'karimaboelmakarem', 'elijahbarrett22', 'ghanshyam.iitb', 'manny2750', 'demetguull', 'emirhan', 'afrahm104', 'virtuspro', 'yukseltugba14', 'jafar.vafaee', 'swadhasanghvi4', 'raaul.09', 'wassupyo412', 'mrtypc1539', 'mmoody.cma', 'aymanbakr1984.1', 'shiz', 'yigitcilce', 'emilyirisdahl', 'byminc', 'jmclean', 'janmol', 'jasmine1323', 'korhan', 'ahmed.r.elhanafy', 'rapacheco', 'nagidal146', 'bagrania385', 'joeeesalah', 'kirbye1101', 'rashmiravindranath', 'mdj', 'snnnnnnnnnnnn', 'ozgeozdamarr', 'vishwas1020', 'ajitzote', 'ahmetsurucu', 'maged7423', 'eltonlossner', 'archiki', 'srycvk26', 'akashmunda12345', 'apoorvaudikeri', 'danielgetega', 'skucukarabaci', 'adam.kwiatkowski', 'mb141', 'mwood', 'nanomelis1996', 'marcusle', 'camakk', 'revez_tmr', '16d070026', 'ibrahimethemtemel', 'saboueleinen', 'betkahraman', 'mohamedabdelmaksoud1096', 'ayane123', 'cigo', 'pmmadhumita9', 'esraa7725334', 'saqibalisidd', 'feyzas26', 'ksselhi', 'steve.meraz', 'moises.navarro0423', 'glenpyeldho', 'guray.izmir95', 'dmertkeskin', 'anshulvermaiitb', 'aspruha.samal', 'sethabhinav89', 'abdelrahman_magdy', 'lovelyever17', 'love465944', 'sahilkumar1900', 'bhuyashi.deka', 'belmaci', 'violantium5', 'edlucero25', 'rsalgado19', 'zzhiye', 'dm94', 'gparra3', 'nicolekf', 'bahadirsonmezisik', 'tugcemekci', 'melikekorkmaz94', 'kaki.krish15', 'wdoeme93', 'cahidpolat', 'djcastillo', 'ehealey', 'ishitadas1998', 'bugrahansoylu', 'x.ganerdene', 'cacortespliego', 'abdullahaksoy26', 'asrivastava98', 'apoorv0', 'anirudh.singhal', 'ibraheemgalal7', 'menaalfread', 'abeischaos', 'ruohanjiang7', 'marissasaenger', 'mohammed123', 'hakanburakbalamir', 'monicaadelfahim', 'muratkoc503', 'rodriguez.joaquin.jesus', 'gabatres', 'mahe19851117', 'serhatgn', 'yaoweixie', 'havanbhavsar03', 'hasibeodak', 'shikhar1799', 'charanadipudi', 'ealvarez44', 'manarnegm', 'uygarelmali', 'hegdeananthar', 'jitendraiitb', 'mail.d', 'sukruardali', 'gao401', 'eslamamr', 'aydinturkkan44', 'saqibali', 'aengingokce', 'ahmed_moustafa_94', 'burcuakts', 'arbaz', 'jacobmeyerson', 'mernaosama40', 'kasapreyizz', 'gunesa96', 'eng.baristatar', 'siber', 'aimenevse', 'beratcandan', 'bilginper24', 'cshwethanayak', 'pandeykratvesh', 'rekharavindrar', 'mrmamos31', 'methemfaik', 'timobrien', 'nora171296', 'vineetkotariya', 'sezerguven', 'refiktuzakli', 'betildiz', 'jajurado3', 'kumaradarsh', 'nagranados', 'makala.bailey', 'bilgesukaymaz', 'neeraj.chimankar', 'tanmaypatil1598', 'haydartaskaya', 'mehmetock777', 'mbrk747', 'liamfitzgerald', 'dimplekochar3', 'keszler', 'havich', 'himanshuaswani123', 'seg915ept', 'sucheta317', 'jblopez2', 'shehab', 'ibrahimyararoglu', 'riosdaniel2014', 'devanshu', 'gokay.yilmaz', 'roy.mustang.eb', 'minatarek', 'ryckmonster', 'shauryasindhu', 'ccamarillo6732', 'hazalciftcioglu94', 'fdirisaglik', 'navnitkumar1224', 'rabin401', 'abdorady', 'djcruz', 'nadakoga', 'sandor.one', 'juliadavis19', 'pratyushragini', 'ewoudvissers', 'qwerty56', 'jsproviero', 'mguillen7', 'johnrahill1', 'rishikkumar18', 'mustafaozic42', 'rushib97', 'ethwong', 'brsyldrn', 'ahmed.star2025', 'iaaguilera', 'tskroezen', 'aniketsl', 'sven.siegmund', 'max2aneeb', 'navoj98', 'gizemuysal']",2,"['nody_elsaadany', None]",393,"['hasanaltintas', 'remsatkan', 'hakan_bicer_96', 'yagaat.smellypitts', 'kritikamna23', 'trinath', 'brekgungor', 'music20011', 'jajung89', 'ozlemsila1', 'shaimaamohamed61195', 'ezgibicak', 'nuri', 'neharikajali', 'salma_hesham', 'abduljalilahmed94', 'covarrubiasjaz05', 'ozlemkrms', 'mhyavuz', 'erenkeskin95', 'chingyinglu89', 'woooney', 'ahmetkaangecer', 'aldoalcantara1', 'arthurxavier.engineer', 'zoz', 'joelrc', 'kbkadir', 'mguillen6', 'aniketbhatia2107', 'mohamed3ssam', 'b10104023', 'singhalanirudh18', 'kzm_dmrlnk', 'senaydogn26', 'kemreakkas', 'ali.solak.1996', 'aliercn964', 'julio_c1712', 'alshareefabdulmajeed', 'austinsams', 'mark.hogg131', 'pirojiwalasubham', 'denizcango', 'ahmetdemir', 'acrylonitrile', 'eng.walaagomaaali', 'yojit105', 'ps5014', 'perihansherif', 'harsh05september', 'groever', 'hsncnyhn', 'akashminato1', 'sudhiriitb', 'michaelconnors', 'caner.baydan', 'jhorton19', 'ahmed_devices', 'highlander2475', 'louiscolson', 'hakanburakbalamir1', 'aavasquez2', 'drhodges', 'shashiadi', 'eggacher', 'ryanwood98', 'tugay95', 'bhu01', 'nemadepsn', 'ccheng852', 'simingma', 'phili180296', 'beraatyigit26', 'mattchuaruiyan', 'areeba123', 'dskartal16', 'neildalal', 'feruiz2', 'silicongo7', 'mjmartinez283', 'shubhangb97', 'kewang.ritsumei', 'shangdi1214', 'ezgii0088', 'amira123', 'abhikanse', 'mwong', 'yarenturker12', 'shaynesmq', 'kumar_ashutosh', 'jazzminesaif66', 'luisggranadost98', 'coolzach999', 'sanidhya27', 'cngzbdr', 'ayesharashid', 'ssdominguez', 'ingrammyles8', 'gunny.balakrishnan', 'mohamedabdelsalam', 'kubraciloglu', 'manar.ibraheem', 'makyz', 'terryyouknow988', 'acostadavid', 'daliahalmy', 'th3prince', 'esraaahmedabdelaal', 'menginaslan', 'tlordello', 'mustafaenesgner', 'liubenliang', 'khandelwalsanyam87', 'baranoncul', 'shashankti111', 'avinashkmry', 'deraz96', 'alejandro.juvera', 'yassinmahdy', 'saisireesha', 'nado.mahmoud1995', 'fvasquez6', 'wdang', 'hatem.rashwany', 'fang59', 'z.a.guzzardo', 'mcsalasnava', 'jesus_aguirre2000', 'timothyobrien', 'safelix', 'yusuf61', 'caranfatma', 'nourhangamal', 'allisontsay', 'omar.handy.96', 'ak83229', 'anonymousbuggy', 'abdurrahmanonuraydin', 'snjkhatri34', 'aesanchez6', 'vivekkandeyang97', 'noel19419', 'ydidwania', 'rz2405', 'mrryzen', 'nishagb04', 'calebringkob', 'anaselsabagh', 'mgthway', 'mustafaali12', 'mehmetdayioglu', 'lakshyakumarsingh', 'duenes957', 'mrinalrao1810', 'osmancanylmz1996', 'liuyuan', 'niamhmulholland', 'hobuobi', 'mauriciofalleiros', 'narendrarai1812', 'axsalomon', 'annasp', 'gonzalez.gaston', 'mayur777', 'resuliseri', 'bekirisgor', 'nody_elsaadany', 'yerenayas', 'mertsen96', 'dirodriguez4', 'zeyneb', 'darivera3', 'dohaga95', 'elpaglia', 'saarthak', 'enesbas', 'halil26', 'ismailkemal', 'zzhanghuang', 'karimaboelmakarem', 'elijahbarrett22', 'ghanshyam.iitb', 'manny2750', 'abdelrahmanahmedabdelghany', 'demetguull', 'emirhan', 'afrahm104', 'virtuspro', 'yukseltugba14', 'jafar.vafaee', 'swadhasanghvi4', 'raaul.09', 'wassupyo412', 'mrtypc1539', 'mmoody.cma', 'aymanbakr1984.1', 'shiz', 'yigitcilce', 'emilyirisdahl', 'byminc', 'jmclean', 'janmol', 'jasmine1323', 'korhan', 'ahmed.r.elhanafy', 'rapacheco', 'nagidal146', 'bagrania385', 'joeeesalah', 'kirbye1101', 'rashmiravindranath', 'mdj', 'snnnnnnnnnnnn', 'ozgeozdamarr', 'vishwas1020', 'ajitzote', 'ahmedsayedeng1', 'ahmetsurucu', 'maged7423', 'eltonlossner', 'archiki', 'srycvk26', 'akashmunda12345', 'apoorvaudikeri', 'danielgetega', 'skucukarabaci', 'adam.kwiatkowski', 'mb141', 'mwood', 'nanomelis1996', 'marcusle', 'camakk', 'revez_tmr', '16d070026', 'ibrahimethemtemel', 'saboueleinen', 'betkahraman', 'mohamedabdelmaksoud1096', 'ayane123', 'cigo', 'pmmadhumita9', 'esraa7725334', 'saqibalisidd', 'feyzas26', 'ksselhi', 'steve.meraz', 'moises.navarro0423', 'glenpyeldho', 'guray.izmir95', 'dmertkeskin', 'anshulvermaiitb', 'aspruha.samal', 'sethabhinav89', 'abdelrahman_magdy', 'lovelyever17', 'love465944', 'sahilkumar1900', 'bhuyashi.deka', 'belmaci', 'violantium5', 'edlucero25', 'rsalgado19', 'zzhiye', 'dm94', 'gparra3', 'nicolekf', 'bahadirsonmezisik', 'tugcemekci', 'melikekorkmaz94', 'kaki.krish15', None, 'wdoeme93', 'cahidpolat', 'djcastillo', 'ehealey', 'ishitadas1998', 'bugrahansoylu', 'x.ganerdene', 'cacortespliego', 'abdullahaksoy26', 'asrivastava98', 'apoorv0', 'anirudh.singhal', 'ibraheemgalal7', 'menaalfread', 'abeischaos', 'ruohanjiang7', 'marissasaenger', 'mohammed123', 'hakanburakbalamir', 'monicaadelfahim', 'muratkoc503', 'rodriguez.joaquin.jesus', 'gabatres', 'mahe19851117', 'serhatgn', 'yaoweixie', 'havanbhavsar03', 'hasibeodak', 'shikhar1799', 'charanadipudi', 'ealvarez44', 'manarnegm', 'uygarelmali', 'hegdeananthar', 'jitendraiitb', 'mail.d', 'sukruardali', 'gao401', 'eslamamr', 'aydinturkkan44', 'saqibali', 'aengingokce', 'ahmed_moustafa_94', 'burcuakts', 'arbaz', 'jacobmeyerson', 'mernaosama40', 'kasapreyizz', 'gunesa96', 'eng.baristatar', 'siber', 'aimenevse', 'beratcandan', 'bilginper24', 'cshwethanayak', 'pandeykratvesh', 'rekharavindrar', 'mrmamos31', 'methemfaik', 'timobrien', 'nora171296', 'vineetkotariya', 'sezerguven', 'refiktuzakli', 'betildiz', 'jajurado3', 'kumaradarsh', 'nagranados', 'makala.bailey', 'bilgesukaymaz', 'neeraj.chimankar', 'tanmaypatil1598', 'haydartaskaya', 'mehmetock777', 'mbrk747', 'liamfitzgerald', 'dimplekochar3', 'keszler', 'havich', 'himanshuaswani123', 'seg915ept', 'sucheta317', 'jblopez2', 'shehab', 'ibrahimyararoglu', 'riosdaniel2014', 'devanshu', 'gokay.yilmaz', 'roy.mustang.eb', 'minatarek', 'ryckmonster', 'shauryasindhu', 'ccamarillo6732', 'hazalciftcioglu94', 'fdirisaglik', 'navnitkumar1224', 'rabin401', 'abdorady', 'djcruz', 'nadakoga', 'sandor.one', 'juliadavis19', 'pratyushragini', 'ewoudvissers', 'qwerty56', 'jsproviero', 'mguillen7', 'johnrahill1', 'rishikkumar18', 'mustafaozic42', 'rushib97', 'ethwong', 'brsyldrn', 'ahmed.star2025', 'iaaguilera', 'tskroezen', 'aniketsl', 'sven.siegmund', 'max2aneeb', 'navoj98', 'gizemuysal']"
1,161,391,7,1,['jsproviero'],390,"['hasanaltintas', 'remsatkan', 'hakan_bicer_96', 'yagaat.smellypitts', 'kritikamna23', 'trinath', 'brekgungor', 'music20011', 'jajung89', 'ozlemsila1', 'shaimaamohamed61195', 'ezgibicak', 'nuri', 'neharikajali', 'salma_hesham', 'abduljalilahmed94', 'covarrubiasjaz05', 'ozlemkrms', 'mhyavuz', 'erenkeskin95', 'chingyinglu89', 'woooney', 'ahmetkaangecer', 'aldoalcantara1', 'arthurxavier.engineer', 'zoz', 'joelrc', 'kbkadir', 'mguillen6', 'aniketbhatia2107', 'mohamed3ssam', 'b10104023', 'singhalanirudh18', 'kzm_dmrlnk', 'senaydogn26', 'kemreakkas', 'ali.solak.1996', 'aliercn964', 'julio_c1712', 'alshareefabdulmajeed', 'austinsams', 'mark.hogg131', 'pirojiwalasubham', 'denizcango', 'ahmetdemir', 'acrylonitrile', 'eng.walaagomaaali', 'yojit105', 'ps5014', 'perihansherif', 'harsh05september', 'groever', 'hsncnyhn', 'akashminato1', 'sudhiriitb', 'michaelconnors', 'caner.baydan', 'jhorton19', 'ahmed_devices', 'highlander2475', 'louiscolson', 'hakanburakbalamir1', 'aavasquez2', 'drhodges', 'shashiadi', 'eggacher', 'ryanwood98', 'tugay95', 'bhu01', 'nemadepsn', 'ccheng852', 'simingma', 'phili180296', 'beraatyigit26', 'mattchuaruiyan', 'areeba123', 'dskartal16', 'neildalal', 'feruiz2', 'silicongo7', 'mjmartinez283', 'shubhangb97', 'kewang.ritsumei', 'shangdi1214', 'ezgii0088', 'amira123', 'abhikanse', 'mwong', 'yarenturker12', 'shaynesmq', 'kumar_ashutosh', 'jazzminesaif66', 'luisggranadost98', 'coolzach999', 'sanidhya27', 'cngzbdr', 'ayesharashid', 'ssdominguez', 'ingrammyles8', 'gunny.balakrishnan', 'mohamedabdelsalam', 'kubraciloglu', 'manar.ibraheem', 'makyz', 'terryyouknow988', 'acostadavid', 'daliahalmy', 'th3prince', 'esraaahmedabdelaal', 'menginaslan', 'tlordello', 'mustafaenesgner', 'liubenliang', 'khandelwalsanyam87', 'baranoncul', 'shashankti111', 'avinashkmry', 'deraz96', 'alejandro.juvera', 'yassinmahdy', 'saisireesha', 'nado.mahmoud1995', 'fvasquez6', 'wdang', 'hatem.rashwany', 'fang59', 'z.a.guzzardo', 'mcsalasnava', 'jesus_aguirre2000', 'timothyobrien', 'safelix', 'yusuf61', 'caranfatma', 'nourhangamal', 'allisontsay', 'omar.handy.96', 'ak83229', 'anonymousbuggy', 'abdurrahmanonuraydin', 'snjkhatri34', 'aesanchez6', 'vivekkandeyang97', 'noel19419', 'ydidwania', 'rz2405', 'mrryzen', 'nishagb04', 'calebringkob', 'anaselsabagh', 'mgthway', 'mustafaali12', 'mehmetdayioglu', 'lakshyakumarsingh', 'duenes957', 'mrinalrao1810', 'osmancanylmz1996', 'liuyuan', 'niamhmulholland', 'hobuobi', 'mauriciofalleiros', 'narendrarai1812', 'axsalomon', 'annasp', 'gonzalez.gaston', 'mayur777', 'resuliseri', 'bekirisgor', 'yerenayas', 'mertsen96', 'dirodriguez4', 'zeyneb', 'darivera3', 'dohaga95', 'elpaglia', 'saarthak', 'enesbas', 'halil26', 'ismailkemal', 'zzhanghuang', 'karimaboelmakarem', 'elijahbarrett22', 'ghanshyam.iitb', 'manny2750', 'abdelrahmanahmedabdelghany', 'demetguull', 'emirhan', 'afrahm104', 'virtuspro', 'yukseltugba14', 'jafar.vafaee', 'swadhasanghvi4', 'raaul.09', 'wassupyo412', 'mrtypc1539', 'mmoody.cma', 'aymanbakr1984.1', 'shiz', 'yigitcilce', 'emilyirisdahl', 'byminc', 'jmclean', 'janmol', 'jasmine1323', 'korhan', 'ahmed.r.elhanafy', 'rapacheco', 'nagidal146', 'bagrania385', 'joeeesalah', 'kirbye1101', 'rashmiravindranath', 'mdj', 'snnnnnnnnnnnn', 'ozgeozdamarr', 'vishwas1020', 'ajitzote', 'ahmedsayedeng1', 'ahmetsurucu', 'maged7423', 'eltonlossner', 'archiki', 'srycvk26', 'akashmunda12345', 'apoorvaudikeri', 'danielgetega', 'skucukarabaci', 'adam.kwiatkowski', 'mb141', 'mwood', 'nanomelis1996', 'marcusle', 'camakk', 'revez_tmr', '16d070026', 'ibrahimethemtemel', 'saboueleinen', 'betkahraman', 'mohamedabdelmaksoud1096', 'ayane123', 'cigo', 'pmmadhumita9', 'esraa7725334', 'saqibalisidd', 'feyzas26', 'ksselhi', 'steve.meraz', 'moises.navarro0423', 'glenpyeldho', 'guray.izmir95', 'dmertkeskin', 'anshulvermaiitb', 'aspruha.samal', 'sethabhinav89', 'abdelrahman_magdy', 'lovelyever17', 'love465944', 'sahilkumar1900', 'bhuyashi.deka', 'belmaci', 'violantium5', 'edlucero25', 'rsalgado19', 'zzhiye', 'dm94', 'gparra3', 'nicolekf', 'bahadirsonmezisik', 'tugcemekci', 'melikekorkmaz94', 'kaki.krish15', 'wdoeme93', 'cahidpolat', 'djcastillo', 'ehealey', 'ishitadas1998', 'bugrahansoylu', 'x.ganerdene', 'cacortespliego', 'abdullahaksoy26', 'asrivastava98', 'apoorv0', 'anirudh.singhal', 'ibraheemgalal7', 'menaalfread', 'abeischaos', 'ruohanjiang7', 'marissasaenger', 'mohammed123', 'hakanburakbalamir', 'monicaadelfahim', 'muratkoc503', 'rodriguez.joaquin.jesus', 'gabatres', 'mahe19851117', 'serhatgn', 'yaoweixie', 'havanbhavsar03', 'hasibeodak', 'shikhar1799', 'charanadipudi', 'ealvarez44', 'manarnegm', 'uygarelmali', 'hegdeananthar', 'jitendraiitb', 'mail.d', 'sukruardali', 'gao401', 'eslamamr', 'aydinturkkan44', 'saqibali', 'aengingokce', 'ahmed_moustafa_94', 'burcuakts', 'arbaz', 'jacobmeyerson', 'mernaosama40', 'kasapreyizz', 'gunesa96', 'eng.baristatar', 'siber', 'aimenevse', 'beratcandan', 'bilginper24', 'cshwethanayak', 'pandeykratvesh', 'rekharavindrar', 'mrmamos31', 'methemfaik', 'timobrien', 'nora171296', 'vineetkotariya', 'sezerguven', 'refiktuzakli', 'betildiz', 'jajurado3', 'kumaradarsh', 'nagranados', 'makala.bailey', 'bilgesukaymaz', 'neeraj.chimankar', 'tanmaypatil1598', 'haydartaskaya', 'mehmetock777', 'mbrk747', 'liamfitzgerald', 'dimplekochar3', 'keszler', 'havich', 'himanshuaswani123', 'seg915ept', 'sucheta317', 'jblopez2', 'shehab', 'ibrahimyararoglu', 'riosdaniel2014', 'devanshu', 'gokay.yilmaz', 'roy.mustang.eb', 'minatarek', 'ryckmonster', 'shauryasindhu', 'ccamarillo6732', 'hazalciftcioglu94', 'fdirisaglik', 'navnitkumar1224', 'rabin401', 'abdorady', 'djcruz', 'nadakoga', 'sandor.one', 'juliadavis19', 'pratyushragini', 'ewoudvissers', 'qwerty56', 'mguillen7', 'johnrahill1', 'rishikkumar18', 'mustafaozic42', 'rushib97', 'ethwong', 'brsyldrn', 'ahmed.star2025', 'iaaguilera', 'tskroezen', 'aniketsl', 'sven.siegmund', 'max2aneeb', 'navoj98', 'gizemuysal']",6,"['sguha', 'sgilani', 'nmsheridan', 'ewlee', 'mdelude', None]",397,"['hasanaltintas', 'remsatkan', 'hakan_bicer_96', 'yagaat.smellypitts', 'kritikamna23', 'trinath', 'brekgungor', 'music20011', 'jajung89', 'ozlemsila1', 'shaimaamohamed61195', 'ezgibicak', 'nuri', 'neharikajali', 'salma_hesham', 'abduljalilahmed94', 'covarrubiasjaz05', 'ozlemkrms', 'mhyavuz', 'erenkeskin95', 'chingyinglu89', 'woooney', 'ahmetkaangecer', 'aldoalcantara1', 'arthurxavier.engineer', 'zoz', 'joelrc', 'kbkadir', 'mguillen6', 'aniketbhatia2107', 'mohamed3ssam', 'b10104023', 'singhalanirudh18', 'kzm_dmrlnk', 'senaydogn26', 'kemreakkas', 'ali.solak.1996', 'aliercn964', 'julio_c1712', 'alshareefabdulmajeed', 'nmsheridan', 'austinsams', 'mark.hogg131', 'pirojiwalasubham', 'denizcango', 'ahmetdemir', 'acrylonitrile', 'eng.walaagomaaali', 'yojit105', 'ps5014', 'perihansherif', 'harsh05september', 'groever', 'hsncnyhn', 'akashminato1', 'sudhiriitb', 'michaelconnors', 'caner.baydan', 'jhorton19', 'ahmed_devices', 'highlander2475', 'louiscolson', 'hakanburakbalamir1', 'aavasquez2', 'drhodges', 'shashiadi', 'eggacher', 'ryanwood98', 'tugay95', 'bhu01', 'nemadepsn', 'ccheng852', 'simingma', 'phili180296', 'beraatyigit26', 'mattchuaruiyan', 'areeba123', 'dskartal16', 'neildalal', 'feruiz2', 'silicongo7', 'mjmartinez283', 'shubhangb97', 'kewang.ritsumei', 'shangdi1214', 'ezgii0088', 'amira123', 'abhikanse', 'mwong', 'yarenturker12', 'shaynesmq', 'kumar_ashutosh', 'jazzminesaif66', 'luisggranadost98', 'coolzach999', 'sanidhya27', 'cngzbdr', 'ayesharashid', 'ssdominguez', 'ingrammyles8', 'gunny.balakrishnan', 'mohamedabdelsalam', 'kubraciloglu', 'manar.ibraheem', 'makyz', 'terryyouknow988', 'acostadavid', 'daliahalmy', 'th3prince', 'esraaahmedabdelaal', 'menginaslan', 'tlordello', 'mustafaenesgner', 'liubenliang', 'khandelwalsanyam87', 'baranoncul', 'shashankti111', 'avinashkmry', 'deraz96', 'alejandro.juvera', 'yassinmahdy', 'saisireesha', 'nado.mahmoud1995', 'fvasquez6', 'wdang', 'hatem.rashwany', 'fang59', 'z.a.guzzardo', 'mcsalasnava', 'jesus_aguirre2000', 'timothyobrien', 'safelix', 'yusuf61', 'caranfatma', 'nourhangamal', 'allisontsay', 'omar.handy.96', 'ak83229', 'anonymousbuggy', 'abdurrahmanonuraydin', 'snjkhatri34', 'aesanchez6', 'vivekkandeyang97', 'noel19419', 'ydidwania', 'rz2405', 'mrryzen', 'nishagb04', 'calebringkob', 'anaselsabagh', 'mgthway', 'mustafaali12', 'mehmetdayioglu', 'lakshyakumarsingh', 'duenes957', 'mrinalrao1810', 'osmancanylmz1996', 'liuyuan', 'niamhmulholland', 'hobuobi', 'mauriciofalleiros', 'narendrarai1812', 'axsalomon', 'annasp', 'gonzalez.gaston', 'mayur777', 'resuliseri', 'bekirisgor', 'yerenayas', 'mertsen96', 'dirodriguez4', 'zeyneb', 'darivera3', 'dohaga95', 'elpaglia', 'saarthak', 'enesbas', 'halil26', 'ismailkemal', 'zzhanghuang', 'karimaboelmakarem', 'elijahbarrett22', 'sguha', 'ghanshyam.iitb', 'manny2750', 'abdelrahmanahmedabdelghany', 'demetguull', 'emirhan', 'afrahm104', 'virtuspro', 'yukseltugba14', 'jafar.vafaee', 'swadhasanghvi4', 'raaul.09', 'wassupyo412', 'mrtypc1539', 'mmoody.cma', 'aymanbakr1984.1', 'shiz', 'yigitcilce', 'emilyirisdahl', 'byminc', 'jmclean', 'janmol', 'jasmine1323', 'korhan', 'ahmed.r.elhanafy', 'rapacheco', 'nagidal146', 'bagrania385', 'joeeesalah', 'kirbye1101', 'rashmiravindranath', 'mdj', 'snnnnnnnnnnnn', 'ozgeozdamarr', 'vishwas1020', 'ajitzote', 'ahmedsayedeng1', 'ahmetsurucu', 'maged7423', 'eltonlossner', 'archiki', 'srycvk26', 'akashmunda12345', 'apoorvaudikeri', 'danielgetega', 'skucukarabaci', 'adam.kwiatkowski', 'mb141', 'mwood', 'nanomelis1996', 'marcusle', 'camakk', 'revez_tmr', '16d070026', 'ibrahimethemtemel', 'saboueleinen', 'betkahraman', 'mohamedabdelmaksoud1096', 'ayane123', 'cigo', 'pmmadhumita9', 'esraa7725334', 'saqibalisidd', 'feyzas26', 'ksselhi', 'steve.meraz', 'moises.navarro0423', 'glenpyeldho', 'guray.izmir95', 'dmertkeskin', 'anshulvermaiitb', 'aspruha.samal', 'sethabhinav89', 'abdelrahman_magdy', 'lovelyever17', 'love465944', 'sahilkumar1900', 'bhuyashi.deka', 'belmaci', 'violantium5', 'edlucero25', 'rsalgado19', 'zzhiye', 'dm94', 'gparra3', 'nicolekf', 'bahadirsonmezisik', 'tugcemekci', 'melikekorkmaz94', 'kaki.krish15', None, 'wdoeme93', 'cahidpolat', 'djcastillo', 'ehealey', 'ishitadas1998', 'bugrahansoylu', 'x.ganerdene', 'cacortespliego', 'abdullahaksoy26', 'asrivastava98', 'apoorv0', 'anirudh.singhal', 'ibraheemgalal7', 'menaalfread', 'abeischaos', 'ruohanjiang7', 'marissasaenger', 'mohammed123', 'hakanburakbalamir', 'monicaadelfahim', 'muratkoc503', 'rodriguez.joaquin.jesus', 'gabatres', 'mahe19851117', 'serhatgn', 'yaoweixie', 'havanbhavsar03', 'hasibeodak', 'shikhar1799', 'charanadipudi', 'ealvarez44', 'manarnegm', 'uygarelmali', 'hegdeananthar', 'ewlee', 'jitendraiitb', 'mail.d', 'sukruardali', 'gao401', 'eslamamr', 'aydinturkkan44', 'saqibali', 'aengingokce', 'ahmed_moustafa_94', 'burcuakts', 'arbaz', 'jacobmeyerson', 'mernaosama40', 'kasapreyizz', 'gunesa96', 'eng.baristatar', 'siber', 'aimenevse', 'beratcandan', 'bilginper24', 'cshwethanayak', 'pandeykratvesh', 'rekharavindrar', 'mrmamos31', 'methemfaik', 'timobrien', 'nora171296', 'vineetkotariya', 'sezerguven', 'refiktuzakli', 'betildiz', 'jajurado3', 'kumaradarsh', 'nagranados', 'makala.bailey', 'bilgesukaymaz', 'neeraj.chimankar', 'tanmaypatil1598', 'haydartaskaya', 'mehmetock777', 'mbrk747', 'liamfitzgerald', 'dimplekochar3', 'keszler', 'havich', 'himanshuaswani123', 'mdelude', 'seg915ept', 'sucheta317', 'jblopez2', 'shehab', 'ibrahimyararoglu', 'riosdaniel2014', 'devanshu', 'gokay.yilmaz', 'roy.mustang.eb', 'minatarek', 'ryckmonster', 'shauryasindhu', 'ccamarillo6732', 'hazalciftcioglu94', 'fdirisaglik', 'navnitkumar1224', 'rabin401', 'abdorady', 'djcruz', 'nadakoga', 'sandor.one', 'juliadavis19', 'pratyushragini', 'ewoudvissers', 'qwerty56', 'jsproviero', 'mguillen7', 'johnrahill1', 'rishikkumar18', 'mustafaozic42', 'rushib97', 'ethwong', 'brsyldrn', 'ahmed.star2025', 'iaaguilera', 'sgilani', 'tskroezen', 'aniketsl', 'sven.siegmund', 'max2aneeb', 'navoj98', 'gizemuysal']"
1,228,391,7,4,"['abhikanse', 'nemadepsn', 'ak83229', 'tanmaypatil1598']",387,"['hasanaltintas', 'remsatkan', 'hakan_bicer_96', 'yagaat.smellypitts', 'kritikamna23', 'trinath', 'brekgungor', 'music20011', 'jajung89', 'ozlemsila1', 'shaimaamohamed61195', 'ezgibicak', 'nuri', 'neharikajali', 'salma_hesham', 'abduljalilahmed94', 'covarrubiasjaz05', 'ozlemkrms', 'mhyavuz', 'erenkeskin95', 'chingyinglu89', 'woooney', 'ahmetkaangecer', 'aldoalcantara1', 'arthurxavier.engineer', 'zoz', 'joelrc', 'kbkadir', 'mguillen6', 'aniketbhatia2107', 'mohamed3ssam', 'b10104023', 'singhalanirudh18', 'kzm_dmrlnk', 'senaydogn26', 'kemreakkas', 'ali.solak.1996', 'aliercn964', 'julio_c1712', 'alshareefabdulmajeed', 'austinsams', 'mark.hogg131', 'pirojiwalasubham', 'denizcango', 'ahmetdemir', 'acrylonitrile', 'eng.walaagomaaali', 'yojit105', 'ps5014', 'perihansherif', 'harsh05september', 'groever', 'hsncnyhn', 'akashminato1', 'sudhiriitb', 'michaelconnors', 'caner.baydan', 'jhorton19', 'ahmed_devices', 'highlander2475', 'louiscolson', 'hakanburakbalamir1', 'aavasquez2', 'drhodges', 'shashiadi', 'eggacher', 'ryanwood98', 'tugay95', 'bhu01', 'ccheng852', 'simingma', 'phili180296', 'beraatyigit26', 'mattchuaruiyan', 'areeba123', 'dskartal16', 'neildalal', 'feruiz2', 'silicongo7', 'mjmartinez283', 'shubhangb97', 'kewang.ritsumei', 'shangdi1214', 'ezgii0088', 'amira123', 'mwong', 'yarenturker12', 'shaynesmq', 'kumar_ashutosh', 'jazzminesaif66', 'luisggranadost98', 'coolzach999', 'sanidhya27', 'cngzbdr', 'ayesharashid', 'ssdominguez', 'ingrammyles8', 'gunny.balakrishnan', 'mohamedabdelsalam', 'kubraciloglu', 'manar.ibraheem', 'makyz', 'terryyouknow988', 'acostadavid', 'daliahalmy', 'th3prince', 'esraaahmedabdelaal', 'menginaslan', 'tlordello', 'mustafaenesgner', 'liubenliang', 'khandelwalsanyam87', 'baranoncul', 'shashankti111', 'avinashkmry', 'deraz96', 'alejandro.juvera', 'yassinmahdy', 'saisireesha', 'nado.mahmoud1995', 'fvasquez6', 'wdang', 'hatem.rashwany', 'fang59', 'z.a.guzzardo', 'mcsalasnava', 'jesus_aguirre2000', 'timothyobrien', 'safelix', 'yusuf61', 'caranfatma', 'nourhangamal', 'allisontsay', 'omar.handy.96', 'anonymousbuggy', 'abdurrahmanonuraydin', 'snjkhatri34', 'aesanchez6', 'vivekkandeyang97', 'noel19419', 'ydidwania', 'rz2405', 'mrryzen', 'nishagb04', 'calebringkob', 'anaselsabagh', 'mgthway', 'mustafaali12', 'mehmetdayioglu', 'lakshyakumarsingh', 'duenes957', 'mrinalrao1810', 'osmancanylmz1996', 'liuyuan', 'niamhmulholland', 'hobuobi', 'mauriciofalleiros', 'narendrarai1812', 'axsalomon', 'annasp', 'gonzalez.gaston', 'mayur777', 'resuliseri', 'bekirisgor', 'yerenayas', 'mertsen96', 'dirodriguez4', 'zeyneb', 'darivera3', 'dohaga95', 'elpaglia', 'saarthak', 'enesbas', 'halil26', 'ismailkemal', 'zzhanghuang', 'karimaboelmakarem', 'elijahbarrett22', 'ghanshyam.iitb', 'manny2750', 'abdelrahmanahmedabdelghany', 'demetguull', 'emirhan', 'afrahm104', 'virtuspro', 'yukseltugba14', 'jafar.vafaee', 'swadhasanghvi4', 'raaul.09', 'wassupyo412', 'mrtypc1539', 'mmoody.cma', 'aymanbakr1984.1', 'shiz', 'yigitcilce', 'emilyirisdahl', 'byminc', 'jmclean', 'janmol', 'jasmine1323', 'korhan', 'ahmed.r.elhanafy', 'rapacheco', 'nagidal146', 'bagrania385', 'joeeesalah', 'kirbye1101', 'rashmiravindranath', 'mdj', 'snnnnnnnnnnnn', 'ozgeozdamarr', 'vishwas1020', 'ajitzote', 'ahmedsayedeng1', 'ahmetsurucu', 'maged7423', 'eltonlossner', 'archiki', 'srycvk26', 'akashmunda12345', 'apoorvaudikeri', 'danielgetega', 'skucukarabaci', 'adam.kwiatkowski', 'mb141', 'mwood', 'nanomelis1996', 'marcusle', 'camakk', 'revez_tmr', '16d070026', 'ibrahimethemtemel', 'saboueleinen', 'betkahraman', 'mohamedabdelmaksoud1096', 'ayane123', 'cigo', 'pmmadhumita9', 'esraa7725334', 'saqibalisidd', 'feyzas26', 'ksselhi', 'steve.meraz', 'moises.navarro0423', 'glenpyeldho', 'guray.izmir95', 'dmertkeskin', 'anshulvermaiitb', 'aspruha.samal', 'sethabhinav89', 'abdelrahman_magdy', 'lovelyever17', 'love465944', 'sahilkumar1900', 'bhuyashi.deka', 'belmaci', 'violantium5', 'edlucero25', 'rsalgado19', 'zzhiye', 'dm94', 'gparra3', 'nicolekf', 'bahadirsonmezisik', 'tugcemekci', 'melikekorkmaz94', 'kaki.krish15', 'wdoeme93', 'cahidpolat', 'djcastillo', 'ehealey', 'ishitadas1998', 'bugrahansoylu', 'x.ganerdene', 'cacortespliego', 'abdullahaksoy26', 'asrivastava98', 'apoorv0', 'anirudh.singhal', 'ibraheemgalal7', 'menaalfread', 'abeischaos', 'ruohanjiang7', 'marissasaenger', 'mohammed123', 'hakanburakbalamir', 'monicaadelfahim', 'muratkoc503', 'rodriguez.joaquin.jesus', 'gabatres', 'mahe19851117', 'serhatgn', 'yaoweixie', 'havanbhavsar03', 'hasibeodak', 'shikhar1799', 'charanadipudi', 'ealvarez44', 'manarnegm', 'uygarelmali', 'hegdeananthar', 'jitendraiitb', 'mail.d', 'sukruardali', 'gao401', 'eslamamr', 'aydinturkkan44', 'saqibali', 'aengingokce', 'ahmed_moustafa_94', 'burcuakts', 'arbaz', 'jacobmeyerson', 'mernaosama40', 'kasapreyizz', 'gunesa96', 'eng.baristatar', 'siber', 'aimenevse', 'beratcandan', 'bilginper24', 'cshwethanayak', 'pandeykratvesh', 'rekharavindrar', 'mrmamos31', 'methemfaik', 'timobrien', 'nora171296', 'vineetkotariya', 'sezerguven', 'refiktuzakli', 'betildiz', 'jajurado3', 'kumaradarsh', 'nagranados', 'makala.bailey', 'bilgesukaymaz', 'neeraj.chimankar', 'haydartaskaya', 'mehmetock777', 'mbrk747', 'liamfitzgerald', 'dimplekochar3', 'keszler', 'havich', 'himanshuaswani123', 'seg915ept', 'sucheta317', 'jblopez2', 'shehab', 'ibrahimyararoglu', 'riosdaniel2014', 'devanshu', 'gokay.yilmaz', 'roy.mustang.eb', 'minatarek', 'ryckmonster', 'shauryasindhu', 'ccamarillo6732', 'hazalciftcioglu94', 'fdirisaglik', 'navnitkumar1224', 'rabin401', 'abdorady', 'djcruz', 'nadakoga', 'sandor.one', 'juliadavis19', 'pratyushragini', 'ewoudvissers', 'qwerty56', 'jsproviero', 'mguillen7', 'johnrahill1', 'rishikkumar18', 'mustafaozic42', 'rushib97', 'ethwong', 'brsyldrn', 'ahmed.star2025', 'iaaguilera', 'tskroezen', 'aniketsl', 'sven.siegmund', 'max2aneeb', 'navoj98', 'gizemuysal']",3,"['ishank', None, 'prnair']",394,"['hasanaltintas', 'remsatkan', 'hakan_bicer_96', 'yagaat.smellypitts', 'kritikamna23', 'trinath', 'brekgungor', 'music20011', 'jajung89', 'ozlemsila1', 'shaimaamohamed61195', 'ezgibicak', 'nuri', 'neharikajali', 'salma_hesham', 'abduljalilahmed94', 'covarrubiasjaz05', 'ozlemkrms', 'mhyavuz', 'erenkeskin95', 'chingyinglu89', 'woooney', 'ahmetkaangecer', 'aldoalcantara1', 'arthurxavier.engineer', 'zoz', 'joelrc', 'kbkadir', 'mguillen6', 'aniketbhatia2107', 'mohamed3ssam', 'b10104023', 'singhalanirudh18', 'kzm_dmrlnk', 'senaydogn26', 'kemreakkas', 'ali.solak.1996', 'aliercn964', 'julio_c1712', 'alshareefabdulmajeed', 'austinsams', 'mark.hogg131', 'pirojiwalasubham', 'denizcango', 'ahmetdemir', 'acrylonitrile', 'eng.walaagomaaali', 'yojit105', 'ps5014', 'perihansherif', 'harsh05september', 'groever', 'hsncnyhn', 'akashminato1', 'sudhiriitb', 'michaelconnors', 'caner.baydan', 'jhorton19', 'ahmed_devices', 'highlander2475', 'louiscolson', 'hakanburakbalamir1', 'aavasquez2', 'drhodges', 'shashiadi', 'eggacher', 'ryanwood98', 'tugay95', 'bhu01', 'nemadepsn', 'ccheng852', 'simingma', 'phili180296', 'beraatyigit26', 'mattchuaruiyan', 'areeba123', 'dskartal16', 'neildalal', 'feruiz2', 'silicongo7', 'mjmartinez283', 'shubhangb97', 'kewang.ritsumei', 'shangdi1214', 'ezgii0088', 'amira123', 'abhikanse', 'mwong', 'yarenturker12', 'shaynesmq', 'kumar_ashutosh', 'jazzminesaif66', 'luisggranadost98', 'coolzach999', 'sanidhya27', 'cngzbdr', 'ayesharashid', 'ssdominguez', 'ingrammyles8', 'gunny.balakrishnan', 'mohamedabdelsalam', 'kubraciloglu', 'manar.ibraheem', 'ishank', 'makyz', 'terryyouknow988', 'acostadavid', 'daliahalmy', 'th3prince', 'esraaahmedabdelaal', 'menginaslan', 'tlordello', 'mustafaenesgner', 'liubenliang', 'khandelwalsanyam87', 'baranoncul', 'shashankti111', 'avinashkmry', 'deraz96', 'alejandro.juvera', 'yassinmahdy', 'saisireesha', 'nado.mahmoud1995', 'fvasquez6', 'wdang', 'hatem.rashwany', 'fang59', 'z.a.guzzardo', 'mcsalasnava', 'jesus_aguirre2000', 'timothyobrien', 'safelix', 'yusuf61', 'caranfatma', 'nourhangamal', 'allisontsay', 'omar.handy.96', 'ak83229', 'anonymousbuggy', 'abdurrahmanonuraydin', 'snjkhatri34', 'aesanchez6', 'vivekkandeyang97', 'noel19419', 'ydidwania', 'rz2405', 'mrryzen', 'nishagb04', 'calebringkob', 'anaselsabagh', 'mgthway', 'mustafaali12', 'mehmetdayioglu', 'lakshyakumarsingh', 'duenes957', 'mrinalrao1810', 'osmancanylmz1996', 'liuyuan', 'niamhmulholland', 'hobuobi', 'mauriciofalleiros', 'narendrarai1812', 'axsalomon', 'annasp', 'gonzalez.gaston', 'mayur777', 'resuliseri', 'bekirisgor', 'yerenayas', 'mertsen96', 'dirodriguez4', 'zeyneb', 'darivera3', 'dohaga95', 'elpaglia', 'saarthak', 'enesbas', 'halil26', 'ismailkemal', 'zzhanghuang', 'prnair', 'karimaboelmakarem', 'elijahbarrett22', 'ghanshyam.iitb', 'manny2750', 'abdelrahmanahmedabdelghany', 'demetguull', 'emirhan', 'afrahm104', 'virtuspro', 'yukseltugba14', 'jafar.vafaee', 'swadhasanghvi4', 'raaul.09', 'wassupyo412', 'mrtypc1539', 'mmoody.cma', 'aymanbakr1984.1', 'shiz', 'yigitcilce', 'emilyirisdahl', 'byminc', 'jmclean', 'janmol', 'jasmine1323', 'korhan', 'ahmed.r.elhanafy', 'rapacheco', 'nagidal146', 'bagrania385', 'joeeesalah', 'kirbye1101', 'rashmiravindranath', 'mdj', 'snnnnnnnnnnnn', 'ozgeozdamarr', 'vishwas1020', 'ajitzote', 'ahmedsayedeng1', 'ahmetsurucu', 'maged7423', 'eltonlossner', 'archiki', 'srycvk26', 'akashmunda12345', 'apoorvaudikeri', 'danielgetega', 'skucukarabaci', 'adam.kwiatkowski', 'mb141', 'mwood', 'nanomelis1996', 'marcusle', 'camakk', 'revez_tmr', '16d070026', 'ibrahimethemtemel', 'saboueleinen', 'betkahraman', 'mohamedabdelmaksoud1096', 'ayane123', 'cigo', 'pmmadhumita9', 'esraa7725334', 'saqibalisidd', 'feyzas26', 'ksselhi', 'steve.meraz', 'moises.navarro0423', 'glenpyeldho', 'guray.izmir95', 'dmertkeskin', 'anshulvermaiitb', 'aspruha.samal', 'sethabhinav89', 'abdelrahman_magdy', 'lovelyever17', 'love465944', 'sahilkumar1900', 'bhuyashi.deka', 'belmaci', 'violantium5', 'edlucero25', 'rsalgado19', 'zzhiye', 'dm94', 'gparra3', 'nicolekf', 'bahadirsonmezisik', 'tugcemekci', 'melikekorkmaz94', 'kaki.krish15', None, 'wdoeme93', 'cahidpolat', 'djcastillo', 'ehealey', 'ishitadas1998', 'bugrahansoylu', 'x.ganerdene', 'cacortespliego', 'abdullahaksoy26', 'asrivastava98', 'apoorv0', 'anirudh.singhal', 'ibraheemgalal7', 'menaalfread', 'abeischaos', 'ruohanjiang7', 'marissasaenger', 'mohammed123', 'hakanburakbalamir', 'monicaadelfahim', 'muratkoc503', 'rodriguez.joaquin.jesus', 'gabatres', 'mahe19851117', 'serhatgn', 'yaoweixie', 'havanbhavsar03', 'hasibeodak', 'shikhar1799', 'charanadipudi', 'ealvarez44', 'manarnegm', 'uygarelmali', 'hegdeananthar', 'jitendraiitb', 'mail.d', 'sukruardali', 'gao401', 'eslamamr', 'aydinturkkan44', 'saqibali', 'aengingokce', 'ahmed_moustafa_94', 'burcuakts', 'arbaz', 'jacobmeyerson', 'mernaosama40', 'kasapreyizz', 'gunesa96', 'eng.baristatar', 'siber', 'aimenevse', 'beratcandan', 'bilginper24', 'cshwethanayak', 'pandeykratvesh', 'rekharavindrar', 'mrmamos31', 'methemfaik', 'timobrien', 'nora171296', 'vineetkotariya', 'sezerguven', 'refiktuzakli', 'betildiz', 'jajurado3', 'kumaradarsh', 'nagranados', 'makala.bailey', 'bilgesukaymaz', 'neeraj.chimankar', 'tanmaypatil1598', 'haydartaskaya', 'mehmetock777', 'mbrk747', 'liamfitzgerald', 'dimplekochar3', 'keszler', 'havich', 'himanshuaswani123', 'seg915ept', 'sucheta317', 'jblopez2', 'shehab', 'ibrahimyararoglu', 'riosdaniel2014', 'devanshu', 'gokay.yilmaz', 'roy.mustang.eb', 'minatarek', 'ryckmonster', 'shauryasindhu', 'ccamarillo6732', 'hazalciftcioglu94', 'fdirisaglik', 'navnitkumar1224', 'rabin401', 'abdorady', 'djcruz', 'nadakoga', 'sandor.one', 'juliadavis19', 'pratyushragini', 'ewoudvissers', 'qwerty56', 'jsproviero', 'mguillen7', 'johnrahill1', 'rishikkumar18', 'mustafaozic42', 'rushib97', 'ethwong', 'brsyldrn', 'ahmed.star2025', 'iaaguilera', 'tskroezen', 'aniketsl', 'sven.siegmund', 'max2aneeb', 'navoj98', 'gizemuysal']"
1,315,391,7,6,"['mayur777', 'mrinalrao1810', 'saisireesha', 'apoorvaudikeri', 'cshwethanayak', 'rushib97']",385,"['hasanaltintas', 'remsatkan', 'hakan_bicer_96', 'yagaat.smellypitts', 'kritikamna23', 'trinath', 'brekgungor', 'music20011', 'jajung89', 'ozlemsila1', 'shaimaamohamed61195', 'ezgibicak', 'nuri', 'neharikajali', 'salma_hesham', 'abduljalilahmed94', 'covarrubiasjaz05', 'ozlemkrms', 'mhyavuz', 'erenkeskin95', 'chingyinglu89', 'woooney', 'ahmetkaangecer', 'aldoalcantara1', 'arthurxavier.engineer', 'zoz', 'joelrc', 'kbkadir', 'mguillen6', 'aniketbhatia2107', 'mohamed3ssam', 'b10104023', 'singhalanirudh18', 'kzm_dmrlnk', 'senaydogn26', 'kemreakkas', 'ali.solak.1996', 'aliercn964', 'julio_c1712', 'alshareefabdulmajeed', 'austinsams', 'mark.hogg131', 'pirojiwalasubham', 'denizcango', 'ahmetdemir', 'acrylonitrile', 'eng.walaagomaaali', 'yojit105', 'ps5014', 'perihansherif', 'harsh05september', 'groever', 'hsncnyhn', 'akashminato1', 'sudhiriitb', 'michaelconnors', 'caner.baydan', 'jhorton19', 'ahmed_devices', 'highlander2475', 'louiscolson', 'hakanburakbalamir1', 'aavasquez2', 'drhodges', 'shashiadi', 'eggacher', 'ryanwood98', 'tugay95', 'bhu01', 'nemadepsn', 'ccheng852', 'simingma', 'phili180296', 'beraatyigit26', 'mattchuaruiyan', 'areeba123', 'dskartal16', 'neildalal', 'feruiz2', 'silicongo7', 'mjmartinez283', 'shubhangb97', 'kewang.ritsumei', 'shangdi1214', 'ezgii0088', 'amira123', 'abhikanse', 'mwong', 'yarenturker12', 'shaynesmq', 'kumar_ashutosh', 'jazzminesaif66', 'luisggranadost98', 'coolzach999', 'sanidhya27', 'cngzbdr', 'ayesharashid', 'ssdominguez', 'ingrammyles8', 'gunny.balakrishnan', 'mohamedabdelsalam', 'kubraciloglu', 'manar.ibraheem', 'makyz', 'terryyouknow988', 'acostadavid', 'daliahalmy', 'th3prince', 'esraaahmedabdelaal', 'menginaslan', 'tlordello', 'mustafaenesgner', 'liubenliang', 'khandelwalsanyam87', 'baranoncul', 'shashankti111', 'avinashkmry', 'deraz96', 'alejandro.juvera', 'yassinmahdy', 'nado.mahmoud1995', 'fvasquez6', 'wdang', 'hatem.rashwany', 'fang59', 'z.a.guzzardo', 'mcsalasnava', 'jesus_aguirre2000', 'timothyobrien', 'safelix', 'yusuf61', 'caranfatma', 'nourhangamal', 'allisontsay', 'omar.handy.96', 'ak83229', 'anonymousbuggy', 'abdurrahmanonuraydin', 'snjkhatri34', 'aesanchez6', 'vivekkandeyang97', 'noel19419', 'ydidwania', 'rz2405', 'mrryzen', 'nishagb04', 'calebringkob', 'anaselsabagh', 'mgthway', 'mustafaali12', 'mehmetdayioglu', 'lakshyakumarsingh', 'duenes957', 'osmancanylmz1996', 'liuyuan', 'niamhmulholland', 'hobuobi', 'mauriciofalleiros', 'narendrarai1812', 'axsalomon', 'annasp', 'gonzalez.gaston', 'resuliseri', 'bekirisgor', 'yerenayas', 'mertsen96', 'dirodriguez4', 'zeyneb', 'darivera3', 'dohaga95', 'elpaglia', 'saarthak', 'enesbas', 'halil26', 'ismailkemal', 'zzhanghuang', 'karimaboelmakarem', 'elijahbarrett22', 'ghanshyam.iitb', 'manny2750', 'abdelrahmanahmedabdelghany', 'demetguull', 'emirhan', 'afrahm104', 'virtuspro', 'yukseltugba14', 'jafar.vafaee', 'swadhasanghvi4', 'raaul.09', 'wassupyo412', 'mrtypc1539', 'mmoody.cma', 'aymanbakr1984.1', 'shiz', 'yigitcilce', 'emilyirisdahl', 'byminc', 'jmclean', 'janmol', 'jasmine1323', 'korhan', 'ahmed.r.elhanafy', 'rapacheco', 'nagidal146', 'bagrania385', 'joeeesalah', 'kirbye1101', 'rashmiravindranath', 'mdj', 'snnnnnnnnnnnn', 'ozgeozdamarr', 'vishwas1020', 'ajitzote', 'ahmedsayedeng1', 'ahmetsurucu', 'maged7423', 'eltonlossner', 'archiki', 'srycvk26', 'akashmunda12345', 'danielgetega', 'skucukarabaci', 'adam.kwiatkowski', 'mb141', 'mwood', 'nanomelis1996', 'marcusle', 'camakk', 'revez_tmr', '16d070026', 'ibrahimethemtemel', 'saboueleinen', 'betkahraman', 'mohamedabdelmaksoud1096', 'ayane123', 'cigo', 'pmmadhumita9', 'esraa7725334', 'saqibalisidd', 'feyzas26', 'ksselhi', 'steve.meraz', 'moises.navarro0423', 'glenpyeldho', 'guray.izmir95', 'dmertkeskin', 'anshulvermaiitb', 'aspruha.samal', 'sethabhinav89', 'abdelrahman_magdy', 'lovelyever17', 'love465944', 'sahilkumar1900', 'bhuyashi.deka', 'belmaci', 'violantium5', 'edlucero25', 'rsalgado19', 'zzhiye', 'dm94', 'gparra3', 'nicolekf', 'bahadirsonmezisik', 'tugcemekci', 'melikekorkmaz94', 'kaki.krish15', 'wdoeme93', 'cahidpolat', 'djcastillo', 'ehealey', 'ishitadas1998', 'bugrahansoylu', 'x.ganerdene', 'cacortespliego', 'abdullahaksoy26', 'asrivastava98', 'apoorv0', 'anirudh.singhal', 'ibraheemgalal7', 'menaalfread', 'abeischaos', 'ruohanjiang7', 'marissasaenger', 'mohammed123', 'hakanburakbalamir', 'monicaadelfahim', 'muratkoc503', 'rodriguez.joaquin.jesus', 'gabatres', 'mahe19851117', 'serhatgn', 'yaoweixie', 'havanbhavsar03', 'hasibeodak', 'shikhar1799', 'charanadipudi', 'ealvarez44', 'manarnegm', 'uygarelmali', 'hegdeananthar', 'jitendraiitb', 'mail.d', 'sukruardali', 'gao401', 'eslamamr', 'aydinturkkan44', 'saqibali', 'aengingokce', 'ahmed_moustafa_94', 'burcuakts', 'arbaz', 'jacobmeyerson', 'mernaosama40', 'kasapreyizz', 'gunesa96', 'eng.baristatar', 'siber', 'aimenevse', 'beratcandan', 'bilginper24', 'pandeykratvesh', 'rekharavindrar', 'mrmamos31', 'methemfaik', 'timobrien', 'nora171296', 'vineetkotariya', 'sezerguven', 'refiktuzakli', 'betildiz', 'jajurado3', 'kumaradarsh', 'nagranados', 'makala.bailey', 'bilgesukaymaz', 'neeraj.chimankar', 'tanmaypatil1598', 'haydartaskaya', 'mehmetock777', 'mbrk747', 'liamfitzgerald', 'dimplekochar3', 'keszler', 'havich', 'himanshuaswani123', 'seg915ept', 'sucheta317', 'jblopez2', 'shehab', 'ibrahimyararoglu', 'riosdaniel2014', 'devanshu', 'gokay.yilmaz', 'roy.mustang.eb', 'minatarek', 'ryckmonster', 'shauryasindhu', 'ccamarillo6732', 'hazalciftcioglu94', 'fdirisaglik', 'navnitkumar1224', 'rabin401', 'abdorady', 'djcruz', 'nadakoga', 'sandor.one', 'juliadavis19', 'pratyushragini', 'ewoudvissers', 'qwerty56', 'jsproviero', 'mguillen7', 'johnrahill1', 'rishikkumar18', 'mustafaozic42', 'ethwong', 'brsyldrn', 'ahmed.star2025', 'iaaguilera', 'tskroezen', 'aniketsl', 'sven.siegmund', 'max2aneeb', 'navoj98', 'gizemuysal']",1,[None],392,"['hasanaltintas', 'remsatkan', 'hakan_bicer_96', 'yagaat.smellypitts', 'kritikamna23', 'trinath', 'brekgungor', 'music20011', 'jajung89', 'ozlemsila1', 'shaimaamohamed61195', 'ezgibicak', 'nuri', 'neharikajali', 'salma_hesham', 'abduljalilahmed94', 'covarrubiasjaz05', 'ozlemkrms', 'mhyavuz', 'erenkeskin95', 'chingyinglu89', 'woooney', 'ahmetkaangecer', 'aldoalcantara1', 'arthurxavier.engineer', 'zoz', 'joelrc', 'kbkadir', 'mguillen6', 'aniketbhatia2107', 'mohamed3ssam', 'b10104023', 'singhalanirudh18', 'kzm_dmrlnk', 'senaydogn26', 'kemreakkas', 'ali.solak.1996', 'aliercn964', 'julio_c1712', 'alshareefabdulmajeed', 'austinsams', 'mark.hogg131', 'pirojiwalasubham', 'denizcango', 'ahmetdemir', 'acrylonitrile', 'eng.walaagomaaali', 'yojit105', 'ps5014', 'perihansherif', 'harsh05september', 'groever', 'hsncnyhn', 'akashminato1', 'sudhiriitb', 'michaelconnors', 'caner.baydan', 'jhorton19', 'ahmed_devices', 'highlander2475', 'louiscolson', 'hakanburakbalamir1', 'aavasquez2', 'drhodges', 'shashiadi', 'eggacher', 'ryanwood98', 'tugay95', 'bhu01', 'nemadepsn', 'ccheng852', 'simingma', 'phili180296', 'beraatyigit26', 'mattchuaruiyan', 'areeba123', 'dskartal16', 'neildalal', 'feruiz2', 'silicongo7', 'mjmartinez283', 'shubhangb97', 'kewang.ritsumei', 'shangdi1214', 'ezgii0088', 'amira123', 'abhikanse', 'mwong', 'yarenturker12', 'shaynesmq', 'kumar_ashutosh', 'jazzminesaif66', 'luisggranadost98', 'coolzach999', 'sanidhya27', 'cngzbdr', 'ayesharashid', 'ssdominguez', 'ingrammyles8', 'gunny.balakrishnan', 'mohamedabdelsalam', 'kubraciloglu', 'manar.ibraheem', 'makyz', 'terryyouknow988', 'acostadavid', 'daliahalmy', 'th3prince', 'esraaahmedabdelaal', 'menginaslan', 'tlordello', 'mustafaenesgner', 'liubenliang', 'khandelwalsanyam87', 'baranoncul', 'shashankti111', 'avinashkmry', 'deraz96', 'alejandro.juvera', 'yassinmahdy', 'saisireesha', 'nado.mahmoud1995', 'fvasquez6', 'wdang', 'hatem.rashwany', 'fang59', 'z.a.guzzardo', 'mcsalasnava', 'jesus_aguirre2000', 'timothyobrien', 'safelix', 'yusuf61', 'caranfatma', 'nourhangamal', 'allisontsay', 'omar.handy.96', 'ak83229', 'anonymousbuggy', 'abdurrahmanonuraydin', 'snjkhatri34', 'aesanchez6', 'vivekkandeyang97', 'noel19419', 'ydidwania', 'rz2405', 'mrryzen', 'nishagb04', 'calebringkob', 'anaselsabagh', 'mgthway', 'mustafaali12', 'mehmetdayioglu', 'lakshyakumarsingh', 'duenes957', 'mrinalrao1810', 'osmancanylmz1996', 'liuyuan', 'niamhmulholland', 'hobuobi', 'mauriciofalleiros', 'narendrarai1812', 'axsalomon', 'annasp', 'gonzalez.gaston', 'mayur777', 'resuliseri', 'bekirisgor', 'yerenayas', 'mertsen96', 'dirodriguez4', 'zeyneb', 'darivera3', 'dohaga95', 'elpaglia', 'saarthak', 'enesbas', 'halil26', 'ismailkemal', 'zzhanghuang', 'karimaboelmakarem', 'elijahbarrett22', 'ghanshyam.iitb', 'manny2750', 'abdelrahmanahmedabdelghany', 'demetguull', 'emirhan', 'afrahm104', 'virtuspro', 'yukseltugba14', 'jafar.vafaee', 'swadhasanghvi4', 'raaul.09', 'wassupyo412', 'mrtypc1539', 'mmoody.cma', 'aymanbakr1984.1', 'shiz', 'yigitcilce', 'emilyirisdahl', 'byminc', 'jmclean', 'janmol', 'jasmine1323', 'korhan', 'ahmed.r.elhanafy', 'rapacheco', 'nagidal146', 'bagrania385', 'joeeesalah', 'kirbye1101', 'rashmiravindranath', 'mdj', 'snnnnnnnnnnnn', 'ozgeozdamarr', 'vishwas1020', 'ajitzote', 'ahmedsayedeng1', 'ahmetsurucu', 'maged7423', 'eltonlossner', 'archiki', 'srycvk26', 'akashmunda12345', 'apoorvaudikeri', 'danielgetega', 'skucukarabaci', 'adam.kwiatkowski', 'mb141', 'mwood', 'nanomelis1996', 'marcusle', 'camakk', 'revez_tmr', '16d070026', 'ibrahimethemtemel', 'saboueleinen', 'betkahraman', 'mohamedabdelmaksoud1096', 'ayane123', 'cigo', 'pmmadhumita9', 'esraa7725334', 'saqibalisidd', 'feyzas26', 'ksselhi', 'steve.meraz', 'moises.navarro0423', 'glenpyeldho', 'guray.izmir95', 'dmertkeskin', 'anshulvermaiitb', 'aspruha.samal', 'sethabhinav89', 'abdelrahman_magdy', 'lovelyever17', 'love465944', 'sahilkumar1900', 'bhuyashi.deka', 'belmaci', 'violantium5', 'edlucero25', 'rsalgado19', 'zzhiye', 'dm94', 'gparra3', 'nicolekf', 'bahadirsonmezisik', 'tugcemekci', 'melikekorkmaz94', 'kaki.krish15', None, 'wdoeme93', 'cahidpolat', 'djcastillo', 'ehealey', 'ishitadas1998', 'bugrahansoylu', 'x.ganerdene', 'cacortespliego', 'abdullahaksoy26', 'asrivastava98', 'apoorv0', 'anirudh.singhal', 'ibraheemgalal7', 'menaalfread', 'abeischaos', 'ruohanjiang7', 'marissasaenger', 'mohammed123', 'hakanburakbalamir', 'monicaadelfahim', 'muratkoc503', 'rodriguez.joaquin.jesus', 'gabatres', 'mahe19851117', 'serhatgn', 'yaoweixie', 'havanbhavsar03', 'hasibeodak', 'shikhar1799', 'charanadipudi', 'ealvarez44', 'manarnegm', 'uygarelmali', 'hegdeananthar', 'jitendraiitb', 'mail.d', 'sukruardali', 'gao401', 'eslamamr', 'aydinturkkan44', 'saqibali', 'aengingokce', 'ahmed_moustafa_94', 'burcuakts', 'arbaz', 'jacobmeyerson', 'mernaosama40', 'kasapreyizz', 'gunesa96', 'eng.baristatar', 'siber', 'aimenevse', 'beratcandan', 'bilginper24', 'cshwethanayak', 'pandeykratvesh', 'rekharavindrar', 'mrmamos31', 'methemfaik', 'timobrien', 'nora171296', 'vineetkotariya', 'sezerguven', 'refiktuzakli', 'betildiz', 'jajurado3', 'kumaradarsh', 'nagranados', 'makala.bailey', 'bilgesukaymaz', 'neeraj.chimankar', 'tanmaypatil1598', 'haydartaskaya', 'mehmetock777', 'mbrk747', 'liamfitzgerald', 'dimplekochar3', 'keszler', 'havich', 'himanshuaswani123', 'seg915ept', 'sucheta317', 'jblopez2', 'shehab', 'ibrahimyararoglu', 'riosdaniel2014', 'devanshu', 'gokay.yilmaz', 'roy.mustang.eb', 'minatarek', 'ryckmonster', 'shauryasindhu', 'ccamarillo6732', 'hazalciftcioglu94', 'fdirisaglik', 'navnitkumar1224', 'rabin401', 'abdorady', 'djcruz', 'nadakoga', 'sandor.one', 'juliadavis19', 'pratyushragini', 'ewoudvissers', 'qwerty56', 'jsproviero', 'mguillen7', 'johnrahill1', 'rishikkumar18', 'mustafaozic42', 'rushib97', 'ethwong', 'brsyldrn', 'ahmed.star2025', 'iaaguilera', 'tskroezen', 'aniketsl', 'sven.siegmund', 'max2aneeb', 'navoj98', 'gizemuysal']"
1,312,391,6,5,"['gabatres', 'violantium5', 'drhodges', 'noel19419', 'gparra3']",386,"['hasanaltintas', 'remsatkan', 'hakan_bicer_96', 'yagaat.smellypitts', 'kritikamna23', 'trinath', 'brekgungor', 'music20011', 'jajung89', 'ozlemsila1', 'shaimaamohamed61195', 'ezgibicak', 'nuri', 'neharikajali', 'salma_hesham', 'abduljalilahmed94', 'covarrubiasjaz05', 'ozlemkrms', 'mhyavuz', 'erenkeskin95', 'chingyinglu89', 'woooney', 'ahmetkaangecer', 'aldoalcantara1', 'arthurxavier.engineer', 'zoz', 'joelrc', 'kbkadir', 'mguillen6', 'aniketbhatia2107', 'mohamed3ssam', 'b10104023', 'singhalanirudh18', 'kzm_dmrlnk', 'senaydogn26', 'kemreakkas', 'ali.solak.1996', 'aliercn964', 'julio_c1712', 'alshareefabdulmajeed', 'austinsams', 'mark.hogg131', 'pirojiwalasubham', 'denizcango', 'ahmetdemir', 'acrylonitrile', 'eng.walaagomaaali', 'yojit105', 'ps5014', 'perihansherif', 'harsh05september', 'groever', 'hsncnyhn', 'akashminato1', 'sudhiriitb', 'michaelconnors', 'caner.baydan', 'jhorton19', 'ahmed_devices', 'highlander2475', 'louiscolson', 'hakanburakbalamir1', 'aavasquez2', 'shashiadi', 'eggacher', 'ryanwood98', 'tugay95', 'bhu01', 'nemadepsn', 'ccheng852', 'simingma', 'phili180296', 'beraatyigit26', 'mattchuaruiyan', 'areeba123', 'dskartal16', 'neildalal', 'feruiz2', 'silicongo7', 'mjmartinez283', 'shubhangb97', 'kewang.ritsumei', 'shangdi1214', 'ezgii0088', 'amira123', 'abhikanse', 'mwong', 'yarenturker12', 'shaynesmq', 'kumar_ashutosh', 'jazzminesaif66', 'luisggranadost98', 'coolzach999', 'sanidhya27', 'cngzbdr', 'ayesharashid', 'ssdominguez', 'ingrammyles8', 'gunny.balakrishnan', 'mohamedabdelsalam', 'kubraciloglu', 'manar.ibraheem', 'makyz', 'terryyouknow988', 'acostadavid', 'daliahalmy', 'th3prince', 'esraaahmedabdelaal', 'menginaslan', 'tlordello', 'mustafaenesgner', 'liubenliang', 'khandelwalsanyam87', 'baranoncul', 'shashankti111', 'avinashkmry', 'deraz96', 'alejandro.juvera', 'yassinmahdy', 'saisireesha', 'nado.mahmoud1995', 'fvasquez6', 'wdang', 'hatem.rashwany', 'fang59', 'z.a.guzzardo', 'mcsalasnava', 'jesus_aguirre2000', 'timothyobrien', 'safelix', 'yusuf61', 'caranfatma', 'nourhangamal', 'allisontsay', 'omar.handy.96', 'ak83229', 'anonymousbuggy', 'abdurrahmanonuraydin', 'snjkhatri34', 'aesanchez6', 'vivekkandeyang97', 'ydidwania', 'rz2405', 'mrryzen', 'nishagb04', 'calebringkob', 'anaselsabagh', 'mgthway', 'mustafaali12', 'mehmetdayioglu', 'lakshyakumarsingh', 'duenes957', 'mrinalrao1810', 'osmancanylmz1996', 'liuyuan', 'niamhmulholland', 'hobuobi', 'mauriciofalleiros', 'narendrarai1812', 'axsalomon', 'annasp', 'gonzalez.gaston', 'mayur777', 'resuliseri', 'bekirisgor', 'yerenayas', 'mertsen96', 'dirodriguez4', 'zeyneb', 'darivera3', 'dohaga95', 'elpaglia', 'saarthak', 'enesbas', 'halil26', 'ismailkemal', 'zzhanghuang', 'karimaboelmakarem', 'elijahbarrett22', 'ghanshyam.iitb', 'manny2750', 'abdelrahmanahmedabdelghany', 'demetguull', 'emirhan', 'afrahm104', 'virtuspro', 'yukseltugba14', 'jafar.vafaee', 'swadhasanghvi4', 'raaul.09', 'wassupyo412', 'mrtypc1539', 'mmoody.cma', 'aymanbakr1984.1', 'shiz', 'yigitcilce', 'emilyirisdahl', 'byminc', 'jmclean', 'janmol', 'jasmine1323', 'korhan', 'ahmed.r.elhanafy', 'rapacheco', 'nagidal146', 'bagrania385', 'joeeesalah', 'kirbye1101', 'rashmiravindranath', 'mdj', 'snnnnnnnnnnnn', 'ozgeozdamarr', 'vishwas1020', 'ajitzote', 'ahmedsayedeng1', 'ahmetsurucu', 'maged7423', 'eltonlossner', 'archiki', 'srycvk26', 'akashmunda12345', 'apoorvaudikeri', 'danielgetega', 'skucukarabaci', 'adam.kwiatkowski', 'mb141', 'mwood', 'nanomelis1996', 'marcusle', 'camakk', 'revez_tmr', '16d070026', 'ibrahimethemtemel', 'saboueleinen', 'betkahraman', 'mohamedabdelmaksoud1096', 'ayane123', 'cigo', 'pmmadhumita9', 'esraa7725334', 'saqibalisidd', 'feyzas26', 'ksselhi', 'steve.meraz', 'moises.navarro0423', 'glenpyeldho', 'guray.izmir95', 'dmertkeskin', 'anshulvermaiitb', 'aspruha.samal', 'sethabhinav89', 'abdelrahman_magdy', 'lovelyever17', 'love465944', 'sahilkumar1900', 'bhuyashi.deka', 'belmaci', 'edlucero25', 'rsalgado19', 'zzhiye', 'dm94', 'nicolekf', 'bahadirsonmezisik', 'tugcemekci', 'melikekorkmaz94', 'kaki.krish15', 'wdoeme93', 'cahidpolat', 'djcastillo', 'ehealey', 'ishitadas1998', 'bugrahansoylu', 'x.ganerdene', 'cacortespliego', 'abdullahaksoy26', 'asrivastava98', 'apoorv0', 'anirudh.singhal', 'ibraheemgalal7', 'menaalfread', 'abeischaos', 'ruohanjiang7', 'marissasaenger', 'mohammed123', 'hakanburakbalamir', 'monicaadelfahim', 'muratkoc503', 'rodriguez.joaquin.jesus', 'mahe19851117', 'serhatgn', 'yaoweixie', 'havanbhavsar03', 'hasibeodak', 'shikhar1799', 'charanadipudi', 'ealvarez44', 'manarnegm', 'uygarelmali', 'hegdeananthar', 'jitendraiitb', 'mail.d', 'sukruardali', 'gao401', 'eslamamr', 'aydinturkkan44', 'saqibali', 'aengingokce', 'ahmed_moustafa_94', 'burcuakts', 'arbaz', 'jacobmeyerson', 'mernaosama40', 'kasapreyizz', 'gunesa96', 'eng.baristatar', 'siber', 'aimenevse', 'beratcandan', 'bilginper24', 'cshwethanayak', 'pandeykratvesh', 'rekharavindrar', 'mrmamos31', 'methemfaik', 'timobrien', 'nora171296', 'vineetkotariya', 'sezerguven', 'refiktuzakli', 'betildiz', 'jajurado3', 'kumaradarsh', 'nagranados', 'makala.bailey', 'bilgesukaymaz', 'neeraj.chimankar', 'tanmaypatil1598', 'haydartaskaya', 'mehmetock777', 'mbrk747', 'liamfitzgerald', 'dimplekochar3', 'keszler', 'havich', 'himanshuaswani123', 'seg915ept', 'sucheta317', 'jblopez2', 'shehab', 'ibrahimyararoglu', 'riosdaniel2014', 'devanshu', 'gokay.yilmaz', 'roy.mustang.eb', 'minatarek', 'ryckmonster', 'shauryasindhu', 'ccamarillo6732', 'hazalciftcioglu94', 'fdirisaglik', 'navnitkumar1224', 'rabin401', 'abdorady', 'djcruz', 'nadakoga', 'sandor.one', 'juliadavis19', 'pratyushragini', 'ewoudvissers', 'qwerty56', 'jsproviero', 'mguillen7', 'johnrahill1', 'rishikkumar18', 'mustafaozic42', 'rushib97', 'ethwong', 'brsyldrn', 'ahmed.star2025', 'iaaguilera', 'tskroezen', 'aniketsl', 'sven.siegmund', 'max2aneeb', 'navoj98', 'gizemuysal']",1,[None],392,"['hasanaltintas', 'remsatkan', 'hakan_bicer_96', 'yagaat.smellypitts', 'kritikamna23', 'trinath', 'brekgungor', 'music20011', 'jajung89', 'ozlemsila1', 'shaimaamohamed61195', 'ezgibicak', 'nuri', 'neharikajali', 'salma_hesham', 'abduljalilahmed94', 'covarrubiasjaz05', 'ozlemkrms', 'mhyavuz', 'erenkeskin95', 'chingyinglu89', 'woooney', 'ahmetkaangecer', 'aldoalcantara1', 'arthurxavier.engineer', 'zoz', 'joelrc', 'kbkadir', 'mguillen6', 'aniketbhatia2107', 'mohamed3ssam', 'b10104023', 'singhalanirudh18', 'kzm_dmrlnk', 'senaydogn26', 'kemreakkas', 'ali.solak.1996', 'aliercn964', 'julio_c1712', 'alshareefabdulmajeed', 'austinsams', 'mark.hogg131', 'pirojiwalasubham', 'denizcango', 'ahmetdemir', 'acrylonitrile', 'eng.walaagomaaali', 'yojit105', 'ps5014', 'perihansherif', 'harsh05september', 'groever', 'hsncnyhn', 'akashminato1', 'sudhiriitb', 'michaelconnors', 'caner.baydan', 'jhorton19', 'ahmed_devices', 'highlander2475', 'louiscolson', 'hakanburakbalamir1', 'aavasquez2', 'drhodges', 'shashiadi', 'eggacher', 'ryanwood98', 'tugay95', 'bhu01', 'nemadepsn', 'ccheng852', 'simingma', 'phili180296', 'beraatyigit26', 'mattchuaruiyan', 'areeba123', 'dskartal16', 'neildalal', 'feruiz2', 'silicongo7', 'mjmartinez283', 'shubhangb97', 'kewang.ritsumei', 'shangdi1214', 'ezgii0088', 'amira123', 'abhikanse', 'mwong', 'yarenturker12', 'shaynesmq', 'kumar_ashutosh', 'jazzminesaif66', 'luisggranadost98', 'coolzach999', 'sanidhya27', 'cngzbdr', 'ayesharashid', 'ssdominguez', 'ingrammyles8', 'gunny.balakrishnan', 'mohamedabdelsalam', 'kubraciloglu', 'manar.ibraheem', 'makyz', 'terryyouknow988', 'acostadavid', 'daliahalmy', 'th3prince', 'esraaahmedabdelaal', 'menginaslan', 'tlordello', 'mustafaenesgner', 'liubenliang', 'khandelwalsanyam87', 'baranoncul', 'shashankti111', 'avinashkmry', 'deraz96', 'alejandro.juvera', 'yassinmahdy', 'saisireesha', 'nado.mahmoud1995', 'fvasquez6', 'wdang', 'hatem.rashwany', 'fang59', 'z.a.guzzardo', 'mcsalasnava', 'jesus_aguirre2000', 'timothyobrien', 'safelix', 'yusuf61', 'caranfatma', 'nourhangamal', 'allisontsay', 'omar.handy.96', 'ak83229', 'anonymousbuggy', 'abdurrahmanonuraydin', 'snjkhatri34', 'aesanchez6', 'vivekkandeyang97', 'noel19419', 'ydidwania', 'rz2405', 'mrryzen', 'nishagb04', 'calebringkob', 'anaselsabagh', 'mgthway', 'mustafaali12', 'mehmetdayioglu', 'lakshyakumarsingh', 'duenes957', 'mrinalrao1810', 'osmancanylmz1996', 'liuyuan', 'niamhmulholland', 'hobuobi', 'mauriciofalleiros', 'narendrarai1812', 'axsalomon', 'annasp', 'gonzalez.gaston', 'mayur777', 'resuliseri', 'bekirisgor', 'yerenayas', 'mertsen96', 'dirodriguez4', 'zeyneb', 'darivera3', 'dohaga95', 'elpaglia', 'saarthak', 'enesbas', 'halil26', 'ismailkemal', 'zzhanghuang', 'karimaboelmakarem', 'elijahbarrett22', 'ghanshyam.iitb', 'manny2750', 'abdelrahmanahmedabdelghany', 'demetguull', 'emirhan', 'afrahm104', 'virtuspro', 'yukseltugba14', 'jafar.vafaee', 'swadhasanghvi4', 'raaul.09', 'wassupyo412', 'mrtypc1539', 'mmoody.cma', 'aymanbakr1984.1', 'shiz', 'yigitcilce', 'emilyirisdahl', 'byminc', 'jmclean', 'janmol', 'jasmine1323', 'korhan', 'ahmed.r.elhanafy', 'rapacheco', 'nagidal146', 'bagrania385', 'joeeesalah', 'kirbye1101', 'rashmiravindranath', 'mdj', 'snnnnnnnnnnnn', 'ozgeozdamarr', 'vishwas1020', 'ajitzote', 'ahmedsayedeng1', 'ahmetsurucu', 'maged7423', 'eltonlossner', 'archiki', 'srycvk26', 'akashmunda12345', 'apoorvaudikeri', 'danielgetega', 'skucukarabaci', 'adam.kwiatkowski', 'mb141', 'mwood', 'nanomelis1996', 'marcusle', 'camakk', 'revez_tmr', '16d070026', 'ibrahimethemtemel', 'saboueleinen', 'betkahraman', 'mohamedabdelmaksoud1096', 'ayane123', 'cigo', 'pmmadhumita9', 'esraa7725334', 'saqibalisidd', 'feyzas26', 'ksselhi', 'steve.meraz', 'moises.navarro0423', 'glenpyeldho', 'guray.izmir95', 'dmertkeskin', 'anshulvermaiitb', 'aspruha.samal', 'sethabhinav89', 'abdelrahman_magdy', 'lovelyever17', 'love465944', 'sahilkumar1900', 'bhuyashi.deka', 'belmaci', 'violantium5', 'edlucero25', 'rsalgado19', 'zzhiye', 'dm94', 'gparra3', 'nicolekf', 'bahadirsonmezisik', 'tugcemekci', 'melikekorkmaz94', 'kaki.krish15', None, 'wdoeme93', 'cahidpolat', 'djcastillo', 'ehealey', 'ishitadas1998', 'bugrahansoylu', 'x.ganerdene', 'cacortespliego', 'abdullahaksoy26', 'asrivastava98', 'apoorv0', 'anirudh.singhal', 'ibraheemgalal7', 'menaalfread', 'abeischaos', 'ruohanjiang7', 'marissasaenger', 'mohammed123', 'hakanburakbalamir', 'monicaadelfahim', 'muratkoc503', 'rodriguez.joaquin.jesus', 'gabatres', 'mahe19851117', 'serhatgn', 'yaoweixie', 'havanbhavsar03', 'hasibeodak', 'shikhar1799', 'charanadipudi', 'ealvarez44', 'manarnegm', 'uygarelmali', 'hegdeananthar', 'jitendraiitb', 'mail.d', 'sukruardali', 'gao401', 'eslamamr', 'aydinturkkan44', 'saqibali', 'aengingokce', 'ahmed_moustafa_94', 'burcuakts', 'arbaz', 'jacobmeyerson', 'mernaosama40', 'kasapreyizz', 'gunesa96', 'eng.baristatar', 'siber', 'aimenevse', 'beratcandan', 'bilginper24', 'cshwethanayak', 'pandeykratvesh', 'rekharavindrar', 'mrmamos31', 'methemfaik', 'timobrien', 'nora171296', 'vineetkotariya', 'sezerguven', 'refiktuzakli', 'betildiz', 'jajurado3', 'kumaradarsh', 'nagranados', 'makala.bailey', 'bilgesukaymaz', 'neeraj.chimankar', 'tanmaypatil1598', 'haydartaskaya', 'mehmetock777', 'mbrk747', 'liamfitzgerald', 'dimplekochar3', 'keszler', 'havich', 'himanshuaswani123', 'seg915ept', 'sucheta317', 'jblopez2', 'shehab', 'ibrahimyararoglu', 'riosdaniel2014', 'devanshu', 'gokay.yilmaz', 'roy.mustang.eb', 'minatarek', 'ryckmonster', 'shauryasindhu', 'ccamarillo6732', 'hazalciftcioglu94', 'fdirisaglik', 'navnitkumar1224', 'rabin401', 'abdorady', 'djcruz', 'nadakoga', 'sandor.one', 'juliadavis19', 'pratyushragini', 'ewoudvissers', 'qwerty56', 'jsproviero', 'mguillen7', 'johnrahill1', 'rishikkumar18', 'mustafaozic42', 'rushib97', 'ethwong', 'brsyldrn', 'ahmed.star2025', 'iaaguilera', 'tskroezen', 'aniketsl', 'sven.siegmund', 'max2aneeb', 'navoj98', 'gizemuysal']"
1,314,391,6,5,"['mayur777', 'mrinalrao1810', 'saisireesha', 'cshwethanayak', 'rushib97']",386,"['hasanaltintas', 'remsatkan', 'hakan_bicer_96', 'yagaat.smellypitts', 'kritikamna23', 'trinath', 'brekgungor', 'music20011', 'jajung89', 'ozlemsila1', 'shaimaamohamed61195', 'ezgibicak', 'nuri', 'neharikajali', 'salma_hesham', 'abduljalilahmed94', 'covarrubiasjaz05', 'ozlemkrms', 'mhyavuz', 'erenkeskin95', 'chingyinglu89', 'woooney', 'ahmetkaangecer', 'aldoalcantara1', 'arthurxavier.engineer', 'zoz', 'joelrc', 'kbkadir', 'mguillen6', 'aniketbhatia2107', 'mohamed3ssam', 'b10104023', 'singhalanirudh18', 'kzm_dmrlnk', 'senaydogn26', 'kemreakkas', 'ali.solak.1996', 'aliercn964', 'julio_c1712', 'alshareefabdulmajeed', 'austinsams', 'mark.hogg131', 'pirojiwalasubham', 'denizcango', 'ahmetdemir', 'acrylonitrile', 'eng.walaagomaaali', 'yojit105', 'ps5014', 'perihansherif', 'harsh05september', 'groever', 'hsncnyhn', 'akashminato1', 'sudhiriitb', 'michaelconnors', 'caner.baydan', 'jhorton19', 'ahmed_devices', 'highlander2475', 'louiscolson', 'hakanburakbalamir1', 'aavasquez2', 'drhodges', 'shashiadi', 'eggacher', 'ryanwood98', 'tugay95', 'bhu01', 'nemadepsn', 'ccheng852', 'simingma', 'phili180296', 'beraatyigit26', 'mattchuaruiyan', 'areeba123', 'dskartal16', 'neildalal', 'feruiz2', 'silicongo7', 'mjmartinez283', 'shubhangb97', 'kewang.ritsumei', 'shangdi1214', 'ezgii0088', 'amira123', 'abhikanse', 'mwong', 'yarenturker12', 'shaynesmq', 'kumar_ashutosh', 'jazzminesaif66', 'luisggranadost98', 'coolzach999', 'sanidhya27', 'cngzbdr', 'ayesharashid', 'ssdominguez', 'ingrammyles8', 'gunny.balakrishnan', 'mohamedabdelsalam', 'kubraciloglu', 'manar.ibraheem', 'makyz', 'terryyouknow988', 'acostadavid', 'daliahalmy', 'th3prince', 'esraaahmedabdelaal', 'menginaslan', 'tlordello', 'mustafaenesgner', 'liubenliang', 'khandelwalsanyam87', 'baranoncul', 'shashankti111', 'avinashkmry', 'deraz96', 'alejandro.juvera', 'yassinmahdy', 'nado.mahmoud1995', 'fvasquez6', 'wdang', 'hatem.rashwany', 'fang59', 'z.a.guzzardo', 'mcsalasnava', 'jesus_aguirre2000', 'timothyobrien', 'safelix', 'yusuf61', 'caranfatma', 'nourhangamal', 'allisontsay', 'omar.handy.96', 'ak83229', 'anonymousbuggy', 'abdurrahmanonuraydin', 'snjkhatri34', 'aesanchez6', 'vivekkandeyang97', 'noel19419', 'ydidwania', 'rz2405', 'mrryzen', 'nishagb04', 'calebringkob', 'anaselsabagh', 'mgthway', 'mustafaali12', 'mehmetdayioglu', 'lakshyakumarsingh', 'duenes957', 'osmancanylmz1996', 'liuyuan', 'niamhmulholland', 'hobuobi', 'mauriciofalleiros', 'narendrarai1812', 'axsalomon', 'annasp', 'gonzalez.gaston', 'resuliseri', 'bekirisgor', 'yerenayas', 'mertsen96', 'dirodriguez4', 'zeyneb', 'darivera3', 'dohaga95', 'elpaglia', 'saarthak', 'enesbas', 'halil26', 'ismailkemal', 'zzhanghuang', 'karimaboelmakarem', 'elijahbarrett22', 'ghanshyam.iitb', 'manny2750', 'abdelrahmanahmedabdelghany', 'demetguull', 'emirhan', 'afrahm104', 'virtuspro', 'yukseltugba14', 'jafar.vafaee', 'swadhasanghvi4', 'raaul.09', 'wassupyo412', 'mrtypc1539', 'mmoody.cma', 'aymanbakr1984.1', 'shiz', 'yigitcilce', 'emilyirisdahl', 'byminc', 'jmclean', 'janmol', 'jasmine1323', 'korhan', 'ahmed.r.elhanafy', 'rapacheco', 'nagidal146', 'bagrania385', 'joeeesalah', 'kirbye1101', 'rashmiravindranath', 'mdj', 'snnnnnnnnnnnn', 'ozgeozdamarr', 'vishwas1020', 'ajitzote', 'ahmedsayedeng1', 'ahmetsurucu', 'maged7423', 'eltonlossner', 'archiki', 'srycvk26', 'akashmunda12345', 'apoorvaudikeri', 'danielgetega', 'skucukarabaci', 'adam.kwiatkowski', 'mb141', 'mwood', 'nanomelis1996', 'marcusle', 'camakk', 'revez_tmr', '16d070026', 'ibrahimethemtemel', 'saboueleinen', 'betkahraman', 'mohamedabdelmaksoud1096', 'ayane123', 'cigo', 'pmmadhumita9', 'esraa7725334', 'saqibalisidd', 'feyzas26', 'ksselhi', 'steve.meraz', 'moises.navarro0423', 'glenpyeldho', 'guray.izmir95', 'dmertkeskin', 'anshulvermaiitb', 'aspruha.samal', 'sethabhinav89', 'abdelrahman_magdy', 'lovelyever17', 'love465944', 'sahilkumar1900', 'bhuyashi.deka', 'belmaci', 'violantium5', 'edlucero25', 'rsalgado19', 'zzhiye', 'dm94', 'gparra3', 'nicolekf', 'bahadirsonmezisik', 'tugcemekci', 'melikekorkmaz94', 'kaki.krish15', 'wdoeme93', 'cahidpolat', 'djcastillo', 'ehealey', 'ishitadas1998', 'bugrahansoylu', 'x.ganerdene', 'cacortespliego', 'abdullahaksoy26', 'asrivastava98', 'apoorv0', 'anirudh.singhal', 'ibraheemgalal7', 'menaalfread', 'abeischaos', 'ruohanjiang7', 'marissasaenger', 'mohammed123', 'hakanburakbalamir', 'monicaadelfahim', 'muratkoc503', 'rodriguez.joaquin.jesus', 'gabatres', 'mahe19851117', 'serhatgn', 'yaoweixie', 'havanbhavsar03', 'hasibeodak', 'shikhar1799', 'charanadipudi', 'ealvarez44', 'manarnegm', 'uygarelmali', 'hegdeananthar', 'jitendraiitb', 'mail.d', 'sukruardali', 'gao401', 'eslamamr', 'aydinturkkan44', 'saqibali', 'aengingokce', 'ahmed_moustafa_94', 'burcuakts', 'arbaz', 'jacobmeyerson', 'mernaosama40', 'kasapreyizz', 'gunesa96', 'eng.baristatar', 'siber', 'aimenevse', 'beratcandan', 'bilginper24', 'pandeykratvesh', 'rekharavindrar', 'mrmamos31', 'methemfaik', 'timobrien', 'nora171296', 'vineetkotariya', 'sezerguven', 'refiktuzakli', 'betildiz', 'jajurado3', 'kumaradarsh', 'nagranados', 'makala.bailey', 'bilgesukaymaz', 'neeraj.chimankar', 'tanmaypatil1598', 'haydartaskaya', 'mehmetock777', 'mbrk747', 'liamfitzgerald', 'dimplekochar3', 'keszler', 'havich', 'himanshuaswani123', 'seg915ept', 'sucheta317', 'jblopez2', 'shehab', 'ibrahimyararoglu', 'riosdaniel2014', 'devanshu', 'gokay.yilmaz', 'roy.mustang.eb', 'minatarek', 'ryckmonster', 'shauryasindhu', 'ccamarillo6732', 'hazalciftcioglu94', 'fdirisaglik', 'navnitkumar1224', 'rabin401', 'abdorady', 'djcruz', 'nadakoga', 'sandor.one', 'juliadavis19', 'pratyushragini', 'ewoudvissers', 'qwerty56', 'jsproviero', 'mguillen7', 'johnrahill1', 'rishikkumar18', 'mustafaozic42', 'ethwong', 'brsyldrn', 'ahmed.star2025', 'iaaguilera', 'tskroezen', 'aniketsl', 'sven.siegmund', 'max2aneeb', 'navoj98', 'gizemuysal']",1,[None],392,"['hasanaltintas', 'remsatkan', 'hakan_bicer_96', 'yagaat.smellypitts', 'kritikamna23', 'trinath', 'brekgungor', 'music20011', 'jajung89', 'ozlemsila1', 'shaimaamohamed61195', 'ezgibicak', 'nuri', 'neharikajali', 'salma_hesham', 'abduljalilahmed94', 'covarrubiasjaz05', 'ozlemkrms', 'mhyavuz', 'erenkeskin95', 'chingyinglu89', 'woooney', 'ahmetkaangecer', 'aldoalcantara1', 'arthurxavier.engineer', 'zoz', 'joelrc', 'kbkadir', 'mguillen6', 'aniketbhatia2107', 'mohamed3ssam', 'b10104023', 'singhalanirudh18', 'kzm_dmrlnk', 'senaydogn26', 'kemreakkas', 'ali.solak.1996', 'aliercn964', 'julio_c1712', 'alshareefabdulmajeed', 'austinsams', 'mark.hogg131', 'pirojiwalasubham', 'denizcango', 'ahmetdemir', 'acrylonitrile', 'eng.walaagomaaali', 'yojit105', 'ps5014', 'perihansherif', 'harsh05september', 'groever', 'hsncnyhn', 'akashminato1', 'sudhiriitb', 'michaelconnors', 'caner.baydan', 'jhorton19', 'ahmed_devices', 'highlander2475', 'louiscolson', 'hakanburakbalamir1', 'aavasquez2', 'drhodges', 'shashiadi', 'eggacher', 'ryanwood98', 'tugay95', 'bhu01', 'nemadepsn', 'ccheng852', 'simingma', 'phili180296', 'beraatyigit26', 'mattchuaruiyan', 'areeba123', 'dskartal16', 'neildalal', 'feruiz2', 'silicongo7', 'mjmartinez283', 'shubhangb97', 'kewang.ritsumei', 'shangdi1214', 'ezgii0088', 'amira123', 'abhikanse', 'mwong', 'yarenturker12', 'shaynesmq', 'kumar_ashutosh', 'jazzminesaif66', 'luisggranadost98', 'coolzach999', 'sanidhya27', 'cngzbdr', 'ayesharashid', 'ssdominguez', 'ingrammyles8', 'gunny.balakrishnan', 'mohamedabdelsalam', 'kubraciloglu', 'manar.ibraheem', 'makyz', 'terryyouknow988', 'acostadavid', 'daliahalmy', 'th3prince', 'esraaahmedabdelaal', 'menginaslan', 'tlordello', 'mustafaenesgner', 'liubenliang', 'khandelwalsanyam87', 'baranoncul', 'shashankti111', 'avinashkmry', 'deraz96', 'alejandro.juvera', 'yassinmahdy', 'saisireesha', 'nado.mahmoud1995', 'fvasquez6', 'wdang', 'hatem.rashwany', 'fang59', 'z.a.guzzardo', 'mcsalasnava', 'jesus_aguirre2000', 'timothyobrien', 'safelix', 'yusuf61', 'caranfatma', 'nourhangamal', 'allisontsay', 'omar.handy.96', 'ak83229', 'anonymousbuggy', 'abdurrahmanonuraydin', 'snjkhatri34', 'aesanchez6', 'vivekkandeyang97', 'noel19419', 'ydidwania', 'rz2405', 'mrryzen', 'nishagb04', 'calebringkob', 'anaselsabagh', 'mgthway', 'mustafaali12', 'mehmetdayioglu', 'lakshyakumarsingh', 'duenes957', 'mrinalrao1810', 'osmancanylmz1996', 'liuyuan', 'niamhmulholland', 'hobuobi', 'mauriciofalleiros', 'narendrarai1812', 'axsalomon', 'annasp', 'gonzalez.gaston', 'mayur777', 'resuliseri', 'bekirisgor', 'yerenayas', 'mertsen96', 'dirodriguez4', 'zeyneb', 'darivera3', 'dohaga95', 'elpaglia', 'saarthak', 'enesbas', 'halil26', 'ismailkemal', 'zzhanghuang', 'karimaboelmakarem', 'elijahbarrett22', 'ghanshyam.iitb', 'manny2750', 'abdelrahmanahmedabdelghany', 'demetguull', 'emirhan', 'afrahm104', 'virtuspro', 'yukseltugba14', 'jafar.vafaee', 'swadhasanghvi4', 'raaul.09', 'wassupyo412', 'mrtypc1539', 'mmoody.cma', 'aymanbakr1984.1', 'shiz', 'yigitcilce', 'emilyirisdahl', 'byminc', 'jmclean', 'janmol', 'jasmine1323', 'korhan', 'ahmed.r.elhanafy', 'rapacheco', 'nagidal146', 'bagrania385', 'joeeesalah', 'kirbye1101', 'rashmiravindranath', 'mdj', 'snnnnnnnnnnnn', 'ozgeozdamarr', 'vishwas1020', 'ajitzote', 'ahmedsayedeng1', 'ahmetsurucu', 'maged7423', 'eltonlossner', 'archiki', 'srycvk26', 'akashmunda12345', 'apoorvaudikeri', 'danielgetega', 'skucukarabaci', 'adam.kwiatkowski', 'mb141', 'mwood', 'nanomelis1996', 'marcusle', 'camakk', 'revez_tmr', '16d070026', 'ibrahimethemtemel', 'saboueleinen', 'betkahraman', 'mohamedabdelmaksoud1096', 'ayane123', 'cigo', 'pmmadhumita9', 'esraa7725334', 'saqibalisidd', 'feyzas26', 'ksselhi', 'steve.meraz', 'moises.navarro0423', 'glenpyeldho', 'guray.izmir95', 'dmertkeskin', 'anshulvermaiitb', 'aspruha.samal', 'sethabhinav89', 'abdelrahman_magdy', 'lovelyever17', 'love465944', 'sahilkumar1900', 'bhuyashi.deka', 'belmaci', 'violantium5', 'edlucero25', 'rsalgado19', 'zzhiye', 'dm94', 'gparra3', 'nicolekf', 'bahadirsonmezisik', 'tugcemekci', 'melikekorkmaz94', 'kaki.krish15', None, 'wdoeme93', 'cahidpolat', 'djcastillo', 'ehealey', 'ishitadas1998', 'bugrahansoylu', 'x.ganerdene', 'cacortespliego', 'abdullahaksoy26', 'asrivastava98', 'apoorv0', 'anirudh.singhal', 'ibraheemgalal7', 'menaalfread', 'abeischaos', 'ruohanjiang7', 'marissasaenger', 'mohammed123', 'hakanburakbalamir', 'monicaadelfahim', 'muratkoc503', 'rodriguez.joaquin.jesus', 'gabatres', 'mahe19851117', 'serhatgn', 'yaoweixie', 'havanbhavsar03', 'hasibeodak', 'shikhar1799', 'charanadipudi', 'ealvarez44', 'manarnegm', 'uygarelmali', 'hegdeananthar', 'jitendraiitb', 'mail.d', 'sukruardali', 'gao401', 'eslamamr', 'aydinturkkan44', 'saqibali', 'aengingokce', 'ahmed_moustafa_94', 'burcuakts', 'arbaz', 'jacobmeyerson', 'mernaosama40', 'kasapreyizz', 'gunesa96', 'eng.baristatar', 'siber', 'aimenevse', 'beratcandan', 'bilginper24', 'cshwethanayak', 'pandeykratvesh', 'rekharavindrar', 'mrmamos31', 'methemfaik', 'timobrien', 'nora171296', 'vineetkotariya', 'sezerguven', 'refiktuzakli', 'betildiz', 'jajurado3', 'kumaradarsh', 'nagranados', 'makala.bailey', 'bilgesukaymaz', 'neeraj.chimankar', 'tanmaypatil1598', 'haydartaskaya', 'mehmetock777', 'mbrk747', 'liamfitzgerald', 'dimplekochar3', 'keszler', 'havich', 'himanshuaswani123', 'seg915ept', 'sucheta317', 'jblopez2', 'shehab', 'ibrahimyararoglu', 'riosdaniel2014', 'devanshu', 'gokay.yilmaz', 'roy.mustang.eb', 'minatarek', 'ryckmonster', 'shauryasindhu', 'ccamarillo6732', 'hazalciftcioglu94', 'fdirisaglik', 'navnitkumar1224', 'rabin401', 'abdorady', 'djcruz', 'nadakoga', 'sandor.one', 'juliadavis19', 'pratyushragini', 'ewoudvissers', 'qwerty56', 'jsproviero', 'mguillen7', 'johnrahill1', 'rishikkumar18', 'mustafaozic42', 'rushib97', 'ethwong', 'brsyldrn', 'ahmed.star2025', 'iaaguilera', 'tskroezen', 'aniketsl', 'sven.siegmund', 'max2aneeb', 'navoj98', 'gizemuysal']"
2,6,188,132,122,"['harshitkhardia', 'sjeet474', 'jawalikarpari', 'rajbhartiprince', 'anjannama0123', 'satyavruthg23', 'jishnu1705', 'lagadapativinay', 'sainarendra999', 'bindalrajat0406', 'ppg28072000', 'umangfogla', 'abiseik', 'kumarjitpal98', 'swagatam.haldar9', 'suryavishal26', 'h.farazul', 'vaibhav2010', 'ritu2512', 'rroshanraj32', 'souravofvibrant', 'arathore98', 'abhi.loveyou39', 'fcnew009', 'deepukumar27398', 'shubhamanurag98', 'pasupulavijay100', 'nikhil24', 'siddharthagarwal786', 'sri2899', 'sudippradhan641', 'goutham16ec', 'dvnshmnz', 'saivinay99', 'pratyush0824', 'praveen_kumar', 'kushal', 'satyam007', 'shayam0333', 'aaqibhoda', 'dipak101505', 'soumyashailja', 'jvlahari', '135goodguy', 'samanwaysadhu', 'harika', 'urstrulyuttam', 'rajeshdara', 'divyansh', 'apoorva123', 'puspendu672', 'kanishk.sonkusre', 'rsadhukhan900', 'lambaiitkgp', 'adityasai', 'sas36000', 'meghana977', 'kontham.abhay', 'rishavchakraborty1998', 'ankita132', 'kshivamraj32', 'mmkpa2012', 'gautam7', 'palakharwani', 'himaswetha', 'gouravfs1996', 'pavanrochester', 'bhaveshbaranda6', 'mahima333k', 'vineelchandra99', 'sayantanroy1801', 'ahirsharan', 'prakhar.bafna', 'himanshmittal237', 'umangagr56', 'pranit.dalal', 'rohitkhinchi1312', 'h_k', 'sharanmourya', 'pandityhre321', 'rahulnani412', 'snehavinjam123', 'bhargav', 'abhay12345678', 'satishiscool007', 'krishnapriyakantipudi', 'danish_imam', 'chandermohan', 'yash779193', 'adityavarma84', 'pritamsoni.hsr', 'sreejachowdary', 'harshmaheshwari135', 'ssingh29b', 'jahnvi123', 'addylocks11598', 'shashwatjai314', 'vibhorjain96', 'yennamharshavardhan', 'abhishekjain199820', 'utkarsh9992', 'meghana2507', 'anikdutta10', 'siddhanthaldar14', 'sowjanya', 'ayush3006kr', 'nageshpatle', 'yash_sharma', 'shubham.rajput98', 'singhpunarjeet', 'giriprasadmyworld1122', 'sajid.eqbal78', 'tibrewalpratik17', 'astikey', 'saptarshi.hobby2', 'vvsivakumar24', 'das.siddharth07', 'kumar.tarun2772', 'harshbarelia14', 'vyshnaviboddupalli', 'sanjeet029', 'tarun3827']",65,"['woodworthkyle', 'yhuang404', 'geetha0802', 'fods12', 'vinayvishwakarma', 'kumawat.devendra2', 'asheeshgir', 'patcat94', 'jcarlin', 'varthyasushanth', 'jackhon', 'aravind03', 'pratham', 'mlieber1995', 'bourbon', 'psaisantoshkr99', 'dounan0618', 'kunal.sanvaniya363', 'nugaira', 'carlos.acosta.berlin', 'mitchellknight', 'ladekar.vrushali', 'shahadeoshelke', 'imanmirzaie', 'myworld21.96', 'the_generic', 'kaunaj06', 'spazos7', 'tsuryawanshi34', 'punishment747', 'jbelcourt', 'bsamseth', 'ambekar.prathmesh', 'ahealey1', 'simrobson', 'sohi', 'adriang123', 'myomyint', 'khalidshaik', 'sgu20121476', 'ompatel13101995', 'anandkadu4108', 'ep14btech11003', 'zoloogg', 'pawarpratap555', 'saurabh.telavane', 'skotetho', 'trobertson1', 'sgu20131420', 'fermi0n', 'jbrizzy', 'ee16btech11031', 'zhang_f', 'akankshatoley44', 'suhboldb', 'quantumred3', 'harshitgargjpr', 'fdsbnmfds', 'rayliao', 'swapnilshingte504', 'leandrosaraco', 'jby2007', 'ankushbag', 'taufique.1929', 'bmunkhzorig']",10,"['varunpd', 'srijanbansal97', 'iamshounak', 'pi', 'sohammukherjee1398', 'mriganksh', 'punyak', 'thisissasank', 'jitendrabhandari100', 'rd']",197,"['harshitkhardia', 'sjeet474', 'jawalikarpari', 'dounan0618', 'anjannama0123', 'satyavruthg23', 'spazos7', 'lagadapativinay', 'ambekar.prathmesh', 'bindalrajat0406', 'ppg28072000', 'swagatam.haldar9', 'ompatel13101995', 'pawarpratap555', 'pi', 'h.farazul', 'arathore98', 'suhboldb', 'harshitgargjpr', 'fcnew009', 'rayliao', 'nikhil24', 'jby2007', 'ankushbag', 'siddharthagarwal786', 'yhuang404', 'geetha0802', 'sudippradhan641', 'dvnshmnz', 'pratyush0824', 'saivinay99', 'pratham', 'kushal', 'mitchellknight', 'ladekar.vrushali', 'myworld21.96', 'shayam0333', 'aaqibhoda', 'soumyashailja', 'jvlahari', 'ep14btech11003', 'harika', 'samanwaysadhu', 'urstrulyuttam', 'ee16btech11031', 'rajeshdara', 'puspendu672', 'kanishk.sonkusre', 'sohammukherjee1398', 'sas36000', 'meghana977', 'kontham.abhay', 'ankita132', 'kshivamraj32', 'taufique.1929', 'quantumred3', 'mmkpa2012', 'woodworthkyle', 'gautam7', 'himaswetha', 'pavanrochester', 'bhaveshbaranda6', 'mahima333k', 'bourbon', 'nugaira', 'sayantanroy1801', 'jbelcourt', 'bsamseth', 'iamshounak', 'himanshmittal237', 'pranit.dalal', 'adriang123', 'sgu20121476', 'anandkadu4108', 'trobertson1', 'h_k', 'snehavinjam123', 'abhay12345678', 'swapnilshingte504', 'satishiscool007', 'danish_imam', 'chandermohan', 'yash779193', 'pritamsoni.hsr', 'jahnvi123', 'jcarlin', 'varthyasushanth', 'aravind03', 'punyak', 'vibhorjain96', 'jitendrabhandari100', 'carlos.acosta.berlin', 'rd', 'abhishekjain199820', 'meghana2507', 'punishment747', 'anikdutta10', 'siddhanthaldar14', 'sowjanya', 'sohi', 'nageshpatle', 'yash_sharma', 'shubham.rajput98', 'singhpunarjeet', 'zoloogg', 'giriprasadmyworld1122', 'sgu20131420', 'tibrewalpratik17', 'saptarshi.hobby2', 'asheeshgir', 'jackhon', 'rajbhartiprince', 'jishnu1705', 'sainarendra999', 'umangfogla', 'abiseik', 'kumarjitpal98', 'myomyint', 'suryavishal26', 'vaibhav2010', 'ritu2512', 'rroshanraj32', 'akankshatoley44', 'souravofvibrant', 'abhi.loveyou39', 'fdsbnmfds', 'deepukumar27398', 'pasupulavijay100', 'shubhamanurag98', 'bmunkhzorig', 'patcat94', 'sri2899', 'goutham16ec', 'praveen_kumar', 'mlieber1995', 'kunal.sanvaniya363', 'satyam007', 'tsuryawanshi34', 'dipak101505', 'khalidshaik', 'srijanbansal97', '135goodguy', 'saurabh.telavane', 'zhang_f', 'divyansh', 'apoorva123', 'rsadhukhan900', 'lambaiitkgp', 'adityasai', 'rishavchakraborty1998', 'fods12', 'palakharwani', 'gouravfs1996', 'vinayvishwakarma', 'kumawat.devendra2', 'vineelchandra99', 'psaisantoshkr99', 'thisissasank', 'shahadeoshelke', 'ahirsharan', 'prakhar.bafna', 'the_generic', 'umangagr56', 'simrobson', 'skotetho', 'rohitkhinchi1312', 'fermi0n', 'sharanmourya', 'pandityhre321', 'rahulnani412', 'bhargav', 'leandrosaraco', 'krishnapriyakantipudi', 'adityavarma84', 'sreejachowdary', 'harshmaheshwari135', 'ssingh29b', 'addylocks11598', 'shashwatjai314', 'yennamharshavardhan', 'imanmirzaie', 'varunpd', 'kaunaj06', 'utkarsh9992', 'ahealey1', 'ayush3006kr', 'sajid.eqbal78', 'mriganksh', 'astikey', 'jbrizzy', 'vvsivakumar24', 'das.siddharth07', 'kumar.tarun2772', 'harshbarelia14', 'vyshnaviboddupalli', 'sanjeet029', 'tarun3827']"
2,80,188,78,4,"['anandkadu4108', 'ep14btech11003', 'khalidshaik', 'aravind03']",183,"['asheeshgir', 'harshitkhardia', 'jackhon', 'sjeet474', 'jawalikarpari', 'dounan0618', 'rajbhartiprince', 'anjannama0123', 'satyavruthg23', 'jishnu1705', 'spazos7', 'lagadapativinay', 'sainarendra999', 'ambekar.prathmesh', 'bindalrajat0406', 'ppg28072000', 'umangfogla', 'abiseik', 'kumarjitpal98', 'myomyint', 'swagatam.haldar9', 'suryavishal26', 'ompatel13101995', 'pawarpratap555', 'h.farazul', 'vaibhav2010', 'ritu2512', 'rroshanraj32', 'akankshatoley44', 'souravofvibrant', 'arathore98', 'suhboldb', 'abhi.loveyou39', 'harshitgargjpr', 'fdsbnmfds', 'fcnew009', 'deepukumar27398', 'pasupulavijay100', 'shubhamanurag98', 'rayliao', 'nikhil24', 'jby2007', 'ankushbag', 'bmunkhzorig', 'siddharthagarwal786', 'yhuang404', 'geetha0802', 'patcat94', 'sri2899', 'sudippradhan641', 'goutham16ec', 'dvnshmnz', 'pratyush0824', 'saivinay99', 'pratham', 'praveen_kumar', 'mlieber1995', 'kunal.sanvaniya363', 'kushal', 'satyam007', 'mitchellknight', 'ladekar.vrushali', 'myworld21.96', 'shayam0333', 'tsuryawanshi34', 'aaqibhoda', 'dipak101505', 'soumyashailja', 'jvlahari', '135goodguy', 'harika', 'saurabh.telavane', 'samanwaysadhu', 'urstrulyuttam', 'ee16btech11031', 'zhang_f', 'rajeshdara', 'divyansh', 'apoorva123', 'rsadhukhan900', 'kanishk.sonkusre', 'puspendu672', 'lambaiitkgp', 'adityasai', 'sas36000', 'meghana977', 'kontham.abhay', 'rishavchakraborty1998', 'ankita132', 'kshivamraj32', 'taufique.1929', 'quantumred3', 'mmkpa2012', 'woodworthkyle', 'fods12', 'gautam7', 'palakharwani', 'gouravfs1996', 'himaswetha', 'vinayvishwakarma', 'pavanrochester', 'bhaveshbaranda6', 'kumawat.devendra2', 'mahima333k', 'vineelchandra99', 'bourbon', 'psaisantoshkr99', 'nugaira', 'sayantanroy1801', 'shahadeoshelke', 'ahirsharan', 'prakhar.bafna', 'the_generic', 'jbelcourt', 'bsamseth', 'himanshmittal237', 'umangagr56', 'pranit.dalal', 'simrobson', 'adriang123', 'sgu20121476', 'skotetho', 'rohitkhinchi1312', 'trobertson1', 'h_k', 'fermi0n', 'sharanmourya', 'pandityhre321', 'rahulnani412', 'snehavinjam123', 'bhargav', 'abhay12345678', 'swapnilshingte504', 'leandrosaraco', 'satishiscool007', 'krishnapriyakantipudi', 'danish_imam', 'chandermohan', 'yash779193', 'adityavarma84', 'pritamsoni.hsr', 'sreejachowdary', 'harshmaheshwari135', 'ssingh29b', 'jahnvi123', 'jcarlin', 'addylocks11598', 'varthyasushanth', 'shashwatjai314', 'vibhorjain96', 'carlos.acosta.berlin', 'yennamharshavardhan', 'imanmirzaie', 'abhishekjain199820', 'kaunaj06', 'utkarsh9992', 'meghana2507', 'punishment747', 'anikdutta10', 'siddhanthaldar14', 'ahealey1', 'sowjanya', 'sohi', 'ayush3006kr', 'nageshpatle', 'yash_sharma', 'shubham.rajput98', 'singhpunarjeet', 'zoloogg', 'giriprasadmyworld1122', 'sajid.eqbal78', 'sgu20131420', 'tibrewalpratik17', 'astikey', 'jbrizzy', 'saptarshi.hobby2', 'vvsivakumar24', 'das.siddharth07', 'kumar.tarun2772', 'harshbarelia14', 'vyshnaviboddupalli', 'sanjeet029', 'tarun3827']",74,"['es16btech11018', 'siddharth_goel', 'bhavya12', 'es15btech11016', 'maniyarudit', 'ee16btech11024', 'nakshatra', 'tejas_p', 'emani', 'rajeshwarchennam', 'es16btech11007', 'es16btech11011', 'sayzeeel', 'bharadwaj1997', 'uditmaniyar', 'ep15btech11005', 'rangesh', 'vishnu_33', 'ramanudeepp', 'shardul', 'hydro123', 'srinidhibachu', 'havish', 'ee16btech11012', 'karlapatirajapradyumna', 'devnano', 'pulapapavan25', 'es16btech11008', 'chakri1804', 'chait', 'vivek2699', 'deepkarma82', 'snehith', 'sidmohla', 'aravindganesh', 'ncsham', 'anuragshekhar', 'es16btech11003', 'bhanutabeti', 'ee16btech11013', 'preetham1998', 'shanky98', 'jvinaykumar12', 'es15btech11007', 'aamir_ee', 'vishwajith', 'ee16btech11016', 'ganna09', None, 'saiashish', 'pramith', 'es14btech11022', 'saurav.varaprasad', 'ep15btech11001', 'akramya98', 'es15btech11010', 'ee16btech11042', 'im2learning', 'karthikr98', 'sumanth', 'pradeepmoturi', 'es16btech11001', 'samhitha', 're1nth', 'adithyahosapate', 'dj_16', 'ee16btech11028', 'es16btech11026', 'subhashchandra', 'priyanka7', 'es16btech11002', 'kmt6264', 'anushag', 'ee16btech11032']",261,"['asheeshgir', 'harshitkhardia', 'jackhon', 'sjeet474', 'jawalikarpari', 'dounan0618', 'rajeshwarchennam', 'rajbhartiprince', 'anjannama0123', 'sayzeeel', 'satyavruthg23', 'jishnu1705', 'spazos7', 'vishnu_33', 'hydro123', 'lagadapativinay', 'sainarendra999', 'ambekar.prathmesh', 'bindalrajat0406', 'ppg28072000', 'umangfogla', 'pulapapavan25', 'abiseik', 'kumarjitpal98', 'myomyint', 'swagatam.haldar9', 'suryavishal26', 'ompatel13101995', 'bhanutabeti', 'pawarpratap555', 'shanky98', 'h.farazul', 'vaibhav2010', 'ritu2512', 'rroshanraj32', 'ee16btech11016', 'akankshatoley44', 'souravofvibrant', 'arathore98', 'suhboldb', 'abhi.loveyou39', 'harshitgargjpr', 'fdsbnmfds', 'fcnew009', 'deepukumar27398', 'pasupulavijay100', 'shubhamanurag98', 'rayliao', 'nikhil24', 'es16btech11001', 'samhitha', 're1nth', 'dj_16', 'jby2007', 'ankushbag', 'es16btech11026', 'bmunkhzorig', 'priyanka7', 'anushag', 'siddharthagarwal786', 'yhuang404', 'geetha0802', 'siddharth_goel', 'patcat94', 'sri2899', 'sudippradhan641', 'goutham16ec', 'dvnshmnz', 'pratyush0824', 'saivinay99', 'ee16btech11024', 'nakshatra', 'pratham', 'praveen_kumar', 'mlieber1995', 'tejas_p', 'kunal.sanvaniya363', 'kushal', 'satyam007', 'mitchellknight', 'ladekar.vrushali', 'myworld21.96', 'shayam0333', 'uditmaniyar', 'rangesh', 'tsuryawanshi34', 'aaqibhoda', 'dipak101505', 'havish', 'ee16btech11012', 'soumyashailja', 'jvlahari', 'khalidshaik', '135goodguy', 'ep14btech11003', 'harika', 'saurabh.telavane', 'samanwaysadhu', 'urstrulyuttam', 'es15btech11007', 'ee16btech11031', 'zhang_f', None, 'rajeshdara', 'divyansh', 'apoorva123', 'ee16btech11042', 'rsadhukhan900', 'kanishk.sonkusre', 'puspendu672', 'lambaiitkgp', 'karthikr98', 'adityasai', 'sumanth', 'sas36000', 'meghana977', 'kontham.abhay', 'adithyahosapate', 'rishavchakraborty1998', 'ankita132', 'kshivamraj32', 'taufique.1929', 'quantumred3', 'subhashchandra', 'kmt6264', 'ee16btech11032', 'mmkpa2012', 'woodworthkyle', 'fods12', 'gautam7', 'palakharwani', 'gouravfs1996', 'himaswetha', 'vinayvishwakarma', 'pavanrochester', 'bhaveshbaranda6', 'kumawat.devendra2', 'mahima333k', 'bhavya12', 'es15btech11016', 'maniyarudit', 'vineelchandra99', 'bourbon', 'psaisantoshkr99', 'nugaira', 'sayantanroy1801', 'shahadeoshelke', 'ahirsharan', 'es16btech11011', 'bharadwaj1997', 'prakhar.bafna', 'the_generic', 'ep15btech11005', 'ramanudeepp', 'jbelcourt', 'bsamseth', 'himanshmittal237', 'umangagr56', 'pranit.dalal', 'simrobson', 'karlapatirajapradyumna', 'deepkarma82', 'adriang123', 'aravindganesh', 'sgu20121476', 'ncsham', 'anandkadu4108', 'skotetho', 'rohitkhinchi1312', 'trobertson1', 'h_k', 'fermi0n', 'saiashish', 'sharanmourya', 'pramith', 'pandityhre321', 'saurav.varaprasad', 'rahulnani412', 'im2learning', 'snehavinjam123', 'bhargav', 'abhay12345678', 'pradeepmoturi', 'swapnilshingte504', 'leandrosaraco', 'satishiscool007', 'krishnapriyakantipudi', 'danish_imam', 'chandermohan', 'yash779193', 'adityavarma84', 'pritamsoni.hsr', 'devnano', 'sreejachowdary', 'harshmaheshwari135', 'ssingh29b', 'akramya98', 'es16btech11018', 'jahnvi123', 'jcarlin', 'addylocks11598', 'varthyasushanth', 'shashwatjai314', 'aravind03', 'vibhorjain96', 'emani', 'carlos.acosta.berlin', 'es16btech11007', 'yennamharshavardhan', 'imanmirzaie', 'abhishekjain199820', 'kaunaj06', 'utkarsh9992', 'meghana2507', 'punishment747', 'shardul', 'anikdutta10', 'siddhanthaldar14', 'ahealey1', 'sowjanya', 'es16btech11008', 'chakri1804', 'chait', 'vivek2699', 'sohi', 'snehith', 'ayush3006kr', 'sidmohla', 'nageshpatle', 'yash_sharma', 'anuragshekhar', 'es16btech11003', 'shubham.rajput98', 'singhpunarjeet', 'ee16btech11013', 'preetham1998', 'zoloogg', 'giriprasadmyworld1122', 'sajid.eqbal78', 'jvinaykumar12', 'sgu20131420', 'tibrewalpratik17', 'astikey', 'aamir_ee', 'jbrizzy', 'vishwajith', 'ganna09', 'es14btech11022', 'ep15btech11001', 'es15btech11010', 'saptarshi.hobby2', 'vvsivakumar24', 'das.siddharth07', 'ee16btech11028', 'kumar.tarun2772', 'harshbarelia14', 'vyshnaviboddupalli', 'sanjeet029', 'srinidhibachu', 'es16btech11002', 'tarun3827']"
2,8,188,22,14,"['fods12', 'the_generic', 'jcarlin', 'bsamseth', 'jackhon', 'ahealey1', 'bourbon', 'mlieber1995', 'simrobson', 'fermi0n', 'dounan0618', 'zhang_f', 'mitchellknight', 'adriang123']",173,"['asheeshgir', 'harshitkhardia', 'sjeet474', 'jawalikarpari', 'rajbhartiprince', 'anjannama0123', 'satyavruthg23', 'jishnu1705', 'spazos7', 'lagadapativinay', 'sainarendra999', 'ambekar.prathmesh', 'bindalrajat0406', 'ppg28072000', 'umangfogla', 'abiseik', 'kumarjitpal98', 'myomyint', 'swagatam.haldar9', 'suryavishal26', 'ompatel13101995', 'pawarpratap555', 'h.farazul', 'vaibhav2010', 'ritu2512', 'rroshanraj32', 'akankshatoley44', 'souravofvibrant', 'arathore98', 'suhboldb', 'abhi.loveyou39', 'harshitgargjpr', 'fdsbnmfds', 'fcnew009', 'deepukumar27398', 'pasupulavijay100', 'shubhamanurag98', 'rayliao', 'nikhil24', 'jby2007', 'ankushbag', 'bmunkhzorig', 'siddharthagarwal786', 'yhuang404', 'geetha0802', 'patcat94', 'sri2899', 'sudippradhan641', 'goutham16ec', 'dvnshmnz', 'pratyush0824', 'saivinay99', 'pratham', 'praveen_kumar', 'kunal.sanvaniya363', 'kushal', 'satyam007', 'ladekar.vrushali', 'myworld21.96', 'shayam0333', 'tsuryawanshi34', 'aaqibhoda', 'dipak101505', 'soumyashailja', 'jvlahari', 'khalidshaik', '135goodguy', 'ep14btech11003', 'harika', 'saurabh.telavane', 'samanwaysadhu', 'urstrulyuttam', 'ee16btech11031', 'rajeshdara', 'divyansh', 'apoorva123', 'rsadhukhan900', 'kanishk.sonkusre', 'puspendu672', 'lambaiitkgp', 'adityasai', 'sas36000', 'meghana977', 'kontham.abhay', 'rishavchakraborty1998', 'ankita132', 'kshivamraj32', 'taufique.1929', 'quantumred3', 'mmkpa2012', 'woodworthkyle', 'gautam7', 'palakharwani', 'gouravfs1996', 'himaswetha', 'vinayvishwakarma', 'pavanrochester', 'bhaveshbaranda6', 'kumawat.devendra2', 'mahima333k', 'vineelchandra99', 'psaisantoshkr99', 'nugaira', 'sayantanroy1801', 'shahadeoshelke', 'ahirsharan', 'prakhar.bafna', 'jbelcourt', 'himanshmittal237', 'umangagr56', 'pranit.dalal', 'sgu20121476', 'anandkadu4108', 'skotetho', 'rohitkhinchi1312', 'trobertson1', 'h_k', 'sharanmourya', 'pandityhre321', 'rahulnani412', 'snehavinjam123', 'bhargav', 'abhay12345678', 'swapnilshingte504', 'leandrosaraco', 'satishiscool007', 'krishnapriyakantipudi', 'danish_imam', 'chandermohan', 'yash779193', 'adityavarma84', 'pritamsoni.hsr', 'sreejachowdary', 'harshmaheshwari135', 'ssingh29b', 'jahnvi123', 'addylocks11598', 'varthyasushanth', 'shashwatjai314', 'aravind03', 'vibhorjain96', 'carlos.acosta.berlin', 'yennamharshavardhan', 'imanmirzaie', 'abhishekjain199820', 'kaunaj06', 'utkarsh9992', 'meghana2507', 'punishment747', 'anikdutta10', 'siddhanthaldar14', 'sowjanya', 'sohi', 'ayush3006kr', 'nageshpatle', 'yash_sharma', 'shubham.rajput98', 'singhpunarjeet', 'zoloogg', 'giriprasadmyworld1122', 'sajid.eqbal78', 'sgu20131420', 'tibrewalpratik17', 'astikey', 'jbrizzy', 'saptarshi.hobby2', 'vvsivakumar24', 'das.siddharth07', 'kumar.tarun2772', 'harshbarelia14', 'vyshnaviboddupalli', 'sanjeet029', 'tarun3827']",8,"['jonnodean', 'chambersa', 'vphan3', 'cmccann', 'eringrant01', 'wyz135', None, 'frank_yl']",195,"['asheeshgir', 'harshitkhardia', 'jackhon', 'sjeet474', 'jawalikarpari', 'dounan0618', 'rajbhartiprince', 'wyz135', 'anjannama0123', 'satyavruthg23', 'jishnu1705', 'spazos7', 'lagadapativinay', 'sainarendra999', 'ambekar.prathmesh', 'bindalrajat0406', 'ppg28072000', 'umangfogla', 'abiseik', 'kumarjitpal98', 'myomyint', 'swagatam.haldar9', 'suryavishal26', 'ompatel13101995', 'pawarpratap555', 'h.farazul', 'vaibhav2010', 'ritu2512', 'rroshanraj32', 'akankshatoley44', 'souravofvibrant', 'arathore98', 'frank_yl', 'suhboldb', 'abhi.loveyou39', 'harshitgargjpr', 'fdsbnmfds', 'fcnew009', 'deepukumar27398', 'pasupulavijay100', 'shubhamanurag98', 'rayliao', 'nikhil24', 'jby2007', 'ankushbag', 'bmunkhzorig', 'siddharthagarwal786', 'yhuang404', 'geetha0802', 'patcat94', 'sri2899', 'vphan3', 'sudippradhan641', 'goutham16ec', 'dvnshmnz', 'pratyush0824', 'saivinay99', 'pratham', 'praveen_kumar', 'mlieber1995', 'kunal.sanvaniya363', 'kushal', 'satyam007', 'mitchellknight', 'ladekar.vrushali', 'myworld21.96', 'shayam0333', 'tsuryawanshi34', 'aaqibhoda', 'dipak101505', 'soumyashailja', 'jvlahari', 'khalidshaik', '135goodguy', 'ep14btech11003', 'harika', 'saurabh.telavane', 'samanwaysadhu', 'urstrulyuttam', 'cmccann', 'ee16btech11031', 'zhang_f', None, 'rajeshdara', 'divyansh', 'apoorva123', 'rsadhukhan900', 'kanishk.sonkusre', 'puspendu672', 'lambaiitkgp', 'adityasai', 'sas36000', 'meghana977', 'kontham.abhay', 'rishavchakraborty1998', 'ankita132', 'kshivamraj32', 'taufique.1929', 'quantumred3', 'mmkpa2012', 'woodworthkyle', 'fods12', 'gautam7', 'palakharwani', 'gouravfs1996', 'himaswetha', 'vinayvishwakarma', 'pavanrochester', 'bhaveshbaranda6', 'kumawat.devendra2', 'mahima333k', 'vineelchandra99', 'bourbon', 'psaisantoshkr99', 'nugaira', 'sayantanroy1801', 'shahadeoshelke', 'ahirsharan', 'prakhar.bafna', 'the_generic', 'chambersa', 'jbelcourt', 'bsamseth', 'himanshmittal237', 'umangagr56', 'pranit.dalal', 'simrobson', 'adriang123', 'sgu20121476', 'anandkadu4108', 'skotetho', 'rohitkhinchi1312', 'trobertson1', 'h_k', 'fermi0n', 'sharanmourya', 'pandityhre321', 'rahulnani412', 'snehavinjam123', 'bhargav', 'abhay12345678', 'swapnilshingte504', 'leandrosaraco', 'satishiscool007', 'krishnapriyakantipudi', 'danish_imam', 'chandermohan', 'yash779193', 'adityavarma84', 'pritamsoni.hsr', 'sreejachowdary', 'harshmaheshwari135', 'ssingh29b', 'jahnvi123', 'jcarlin', 'addylocks11598', 'varthyasushanth', 'shashwatjai314', 'aravind03', 'vibhorjain96', 'carlos.acosta.berlin', 'yennamharshavardhan', 'imanmirzaie', 'jonnodean', 'abhishekjain199820', 'kaunaj06', 'utkarsh9992', 'meghana2507', 'punishment747', 'anikdutta10', 'siddhanthaldar14', 'ahealey1', 'sowjanya', 'sohi', 'ayush3006kr', 'nageshpatle', 'yash_sharma', 'shubham.rajput98', 'singhpunarjeet', 'zoloogg', 'giriprasadmyworld1122', 'sajid.eqbal78', 'sgu20131420', 'tibrewalpratik17', 'astikey', 'jbrizzy', 'saptarshi.hobby2', 'vvsivakumar24', 'das.siddharth07', 'kumar.tarun2772', 'harshbarelia14', 'vyshnaviboddupalli', 'eringrant01', 'sanjeet029', 'tarun3827']"
2,7,188,20,18,"['utkarsh9992', 'suryavishal26', 'asheeshgir', 'swagatam.haldar9', 'harshitgargjpr', 'dipak101505', 'kanishk.sonkusre', 'shubhamanurag98', 'sainarendra999', 'himanshmittal237', 'giriprasadmyworld1122', 'rohitkhinchi1312', 'h.farazul', 'psaisantoshkr99', 'kumar.tarun2772', 'rishavchakraborty1998', 'jawalikarpari', 'kushal']",169,"['harshitkhardia', 'jackhon', 'sjeet474', 'dounan0618', 'rajbhartiprince', 'anjannama0123', 'satyavruthg23', 'jishnu1705', 'spazos7', 'lagadapativinay', 'ambekar.prathmesh', 'bindalrajat0406', 'ppg28072000', 'umangfogla', 'abiseik', 'kumarjitpal98', 'myomyint', 'ompatel13101995', 'pawarpratap555', 'vaibhav2010', 'ritu2512', 'rroshanraj32', 'akankshatoley44', 'souravofvibrant', 'arathore98', 'suhboldb', 'abhi.loveyou39', 'fdsbnmfds', 'fcnew009', 'deepukumar27398', 'pasupulavijay100', 'rayliao', 'nikhil24', 'jby2007', 'ankushbag', 'bmunkhzorig', 'siddharthagarwal786', 'yhuang404', 'geetha0802', 'patcat94', 'sri2899', 'sudippradhan641', 'goutham16ec', 'dvnshmnz', 'pratyush0824', 'saivinay99', 'pratham', 'praveen_kumar', 'mlieber1995', 'kunal.sanvaniya363', 'satyam007', 'mitchellknight', 'ladekar.vrushali', 'myworld21.96', 'shayam0333', 'tsuryawanshi34', 'aaqibhoda', 'soumyashailja', 'jvlahari', 'khalidshaik', '135goodguy', 'ep14btech11003', 'harika', 'saurabh.telavane', 'samanwaysadhu', 'urstrulyuttam', 'ee16btech11031', 'zhang_f', 'rajeshdara', 'divyansh', 'apoorva123', 'rsadhukhan900', 'puspendu672', 'lambaiitkgp', 'adityasai', 'sas36000', 'meghana977', 'kontham.abhay', 'ankita132', 'kshivamraj32', 'taufique.1929', 'quantumred3', 'mmkpa2012', 'woodworthkyle', 'fods12', 'gautam7', 'palakharwani', 'gouravfs1996', 'himaswetha', 'vinayvishwakarma', 'pavanrochester', 'bhaveshbaranda6', 'kumawat.devendra2', 'mahima333k', 'vineelchandra99', 'bourbon', 'nugaira', 'sayantanroy1801', 'shahadeoshelke', 'ahirsharan', 'prakhar.bafna', 'the_generic', 'jbelcourt', 'bsamseth', 'umangagr56', 'pranit.dalal', 'simrobson', 'adriang123', 'sgu20121476', 'anandkadu4108', 'skotetho', 'trobertson1', 'h_k', 'fermi0n', 'sharanmourya', 'pandityhre321', 'rahulnani412', 'snehavinjam123', 'bhargav', 'abhay12345678', 'swapnilshingte504', 'leandrosaraco', 'satishiscool007', 'krishnapriyakantipudi', 'danish_imam', 'chandermohan', 'yash779193', 'adityavarma84', 'pritamsoni.hsr', 'sreejachowdary', 'harshmaheshwari135', 'ssingh29b', 'jahnvi123', 'jcarlin', 'addylocks11598', 'varthyasushanth', 'shashwatjai314', 'aravind03', 'vibhorjain96', 'carlos.acosta.berlin', 'yennamharshavardhan', 'imanmirzaie', 'abhishekjain199820', 'kaunaj06', 'meghana2507', 'punishment747', 'anikdutta10', 'siddhanthaldar14', 'ahealey1', 'sowjanya', 'sohi', 'ayush3006kr', 'nageshpatle', 'yash_sharma', 'shubham.rajput98', 'singhpunarjeet', 'zoloogg', 'sajid.eqbal78', 'sgu20131420', 'tibrewalpratik17', 'astikey', 'jbrizzy', 'saptarshi.hobby2', 'vvsivakumar24', 'das.siddharth07', 'harshbarelia14', 'vyshnaviboddupalli', 'sanjeet029', 'tarun3827']",2,"['iamshounak', None]",189,"['asheeshgir', 'harshitkhardia', 'jackhon', 'sjeet474', 'jawalikarpari', 'dounan0618', 'rajbhartiprince', 'anjannama0123', 'satyavruthg23', 'jishnu1705', 'spazos7', 'lagadapativinay', 'sainarendra999', 'ambekar.prathmesh', 'bindalrajat0406', 'ppg28072000', 'umangfogla', 'abiseik', 'kumarjitpal98', 'myomyint', 'swagatam.haldar9', 'suryavishal26', 'ompatel13101995', 'pawarpratap555', 'h.farazul', 'vaibhav2010', 'ritu2512', 'rroshanraj32', 'akankshatoley44', 'souravofvibrant', 'arathore98', 'suhboldb', 'abhi.loveyou39', 'harshitgargjpr', 'fdsbnmfds', 'fcnew009', 'deepukumar27398', 'pasupulavijay100', 'shubhamanurag98', 'rayliao', 'nikhil24', 'jby2007', 'ankushbag', 'bmunkhzorig', 'siddharthagarwal786', 'yhuang404', 'geetha0802', 'patcat94', 'sri2899', 'sudippradhan641', 'goutham16ec', 'dvnshmnz', 'pratyush0824', 'saivinay99', 'pratham', 'praveen_kumar', 'mlieber1995', 'kunal.sanvaniya363', 'kushal', 'satyam007', 'mitchellknight', 'ladekar.vrushali', 'myworld21.96', 'shayam0333', 'tsuryawanshi34', 'aaqibhoda', 'dipak101505', 'soumyashailja', 'jvlahari', 'khalidshaik', '135goodguy', 'ep14btech11003', 'harika', 'saurabh.telavane', 'samanwaysadhu', 'urstrulyuttam', 'ee16btech11031', 'zhang_f', None, 'rajeshdara', 'divyansh', 'apoorva123', 'rsadhukhan900', 'kanishk.sonkusre', 'puspendu672', 'lambaiitkgp', 'adityasai', 'sas36000', 'meghana977', 'kontham.abhay', 'rishavchakraborty1998', 'ankita132', 'kshivamraj32', 'taufique.1929', 'quantumred3', 'mmkpa2012', 'woodworthkyle', 'fods12', 'gautam7', 'palakharwani', 'gouravfs1996', 'himaswetha', 'vinayvishwakarma', 'pavanrochester', 'bhaveshbaranda6', 'kumawat.devendra2', 'mahima333k', 'vineelchandra99', 'bourbon', 'psaisantoshkr99', 'nugaira', 'sayantanroy1801', 'shahadeoshelke', 'ahirsharan', 'prakhar.bafna', 'the_generic', 'jbelcourt', 'bsamseth', 'iamshounak', 'himanshmittal237', 'umangagr56', 'pranit.dalal', 'simrobson', 'adriang123', 'sgu20121476', 'anandkadu4108', 'skotetho', 'rohitkhinchi1312', 'trobertson1', 'h_k', 'fermi0n', 'sharanmourya', 'pandityhre321', 'rahulnani412', 'snehavinjam123', 'bhargav', 'abhay12345678', 'swapnilshingte504', 'leandrosaraco', 'satishiscool007', 'krishnapriyakantipudi', 'danish_imam', 'chandermohan', 'yash779193', 'adityavarma84', 'pritamsoni.hsr', 'sreejachowdary', 'harshmaheshwari135', 'ssingh29b', 'jahnvi123', 'jcarlin', 'addylocks11598', 'varthyasushanth', 'shashwatjai314', 'aravind03', 'vibhorjain96', 'carlos.acosta.berlin', 'yennamharshavardhan', 'imanmirzaie', 'abhishekjain199820', 'kaunaj06', 'utkarsh9992', 'meghana2507', 'punishment747', 'anikdutta10', 'siddhanthaldar14', 'ahealey1', 'sowjanya', 'sohi', 'ayush3006kr', 'nageshpatle', 'yash_sharma', 'shubham.rajput98', 'singhpunarjeet', 'zoloogg', 'giriprasadmyworld1122', 'sajid.eqbal78', 'sgu20131420', 'tibrewalpratik17', 'astikey', 'jbrizzy', 'saptarshi.hobby2', 'vvsivakumar24', 'das.siddharth07', 'kumar.tarun2772', 'harshbarelia14', 'vyshnaviboddupalli', 'sanjeet029', 'tarun3827']"
2,11,188,18,1,['sgu20131420'],186,"['asheeshgir', 'harshitkhardia', 'jackhon', 'sjeet474', 'jawalikarpari', 'dounan0618', 'rajbhartiprince', 'anjannama0123', 'satyavruthg23', 'jishnu1705', 'spazos7', 'lagadapativinay', 'sainarendra999', 'ambekar.prathmesh', 'bindalrajat0406', 'ppg28072000', 'umangfogla', 'abiseik', 'kumarjitpal98', 'myomyint', 'swagatam.haldar9', 'suryavishal26', 'ompatel13101995', 'pawarpratap555', 'h.farazul', 'vaibhav2010', 'ritu2512', 'rroshanraj32', 'akankshatoley44', 'souravofvibrant', 'arathore98', 'suhboldb', 'abhi.loveyou39', 'harshitgargjpr', 'fdsbnmfds', 'fcnew009', 'deepukumar27398', 'pasupulavijay100', 'shubhamanurag98', 'rayliao', 'nikhil24', 'jby2007', 'ankushbag', 'bmunkhzorig', 'siddharthagarwal786', 'yhuang404', 'geetha0802', 'patcat94', 'sri2899', 'sudippradhan641', 'goutham16ec', 'dvnshmnz', 'pratyush0824', 'saivinay99', 'pratham', 'praveen_kumar', 'mlieber1995', 'kunal.sanvaniya363', 'kushal', 'satyam007', 'mitchellknight', 'ladekar.vrushali', 'myworld21.96', 'shayam0333', 'tsuryawanshi34', 'aaqibhoda', 'dipak101505', 'soumyashailja', 'jvlahari', 'khalidshaik', '135goodguy', 'ep14btech11003', 'harika', 'saurabh.telavane', 'samanwaysadhu', 'urstrulyuttam', 'ee16btech11031', 'zhang_f', 'rajeshdara', 'divyansh', 'apoorva123', 'rsadhukhan900', 'kanishk.sonkusre', 'puspendu672', 'lambaiitkgp', 'adityasai', 'sas36000', 'meghana977', 'kontham.abhay', 'rishavchakraborty1998', 'ankita132', 'kshivamraj32', 'taufique.1929', 'quantumred3', 'mmkpa2012', 'woodworthkyle', 'fods12', 'gautam7', 'palakharwani', 'gouravfs1996', 'himaswetha', 'vinayvishwakarma', 'pavanrochester', 'bhaveshbaranda6', 'kumawat.devendra2', 'mahima333k', 'vineelchandra99', 'bourbon', 'psaisantoshkr99', 'nugaira', 'sayantanroy1801', 'shahadeoshelke', 'ahirsharan', 'prakhar.bafna', 'the_generic', 'jbelcourt', 'bsamseth', 'himanshmittal237', 'umangagr56', 'pranit.dalal', 'simrobson', 'adriang123', 'sgu20121476', 'anandkadu4108', 'skotetho', 'rohitkhinchi1312', 'trobertson1', 'h_k', 'fermi0n', 'sharanmourya', 'pandityhre321', 'rahulnani412', 'snehavinjam123', 'bhargav', 'abhay12345678', 'swapnilshingte504', 'leandrosaraco', 'satishiscool007', 'krishnapriyakantipudi', 'danish_imam', 'chandermohan', 'yash779193', 'adityavarma84', 'pritamsoni.hsr', 'sreejachowdary', 'harshmaheshwari135', 'ssingh29b', 'jahnvi123', 'jcarlin', 'addylocks11598', 'varthyasushanth', 'shashwatjai314', 'aravind03', 'vibhorjain96', 'carlos.acosta.berlin', 'yennamharshavardhan', 'imanmirzaie', 'abhishekjain199820', 'kaunaj06', 'utkarsh9992', 'meghana2507', 'punishment747', 'anikdutta10', 'siddhanthaldar14', 'ahealey1', 'sowjanya', 'sohi', 'ayush3006kr', 'nageshpatle', 'yash_sharma', 'shubham.rajput98', 'singhpunarjeet', 'zoloogg', 'giriprasadmyworld1122', 'sajid.eqbal78', 'tibrewalpratik17', 'astikey', 'jbrizzy', 'saptarshi.hobby2', 'vvsivakumar24', 'das.siddharth07', 'kumar.tarun2772', 'harshbarelia14', 'vyshnaviboddupalli', 'sanjeet029', 'tarun3827']",17,"['1022jinhee', 'honnyou', None, 'k910716kim', 'sgu20141488', 'sgu20121472', 'mvert157', 'sgu20121423', 'sgu20131499', 'angyi90', 'skzl34', 'sgu20141403', 'qpqp072472', 'miiinji', 'sgu20131509', 'bongwhan12', 'claritas']",204,"['asheeshgir', 'sgu20121472', 'harshitkhardia', 'jackhon', 'sjeet474', 'jawalikarpari', 'dounan0618', 'rajbhartiprince', 'anjannama0123', 'satyavruthg23', 'jishnu1705', 'spazos7', 'lagadapativinay', 'sainarendra999', 'ambekar.prathmesh', 'bindalrajat0406', 'ppg28072000', 'umangfogla', 'abiseik', 'kumarjitpal98', '1022jinhee', 'myomyint', 'swagatam.haldar9', 'suryavishal26', 'ompatel13101995', 'pawarpratap555', 'h.farazul', 'vaibhav2010', 'ritu2512', 'rroshanraj32', 'akankshatoley44', 'souravofvibrant', 'arathore98', 'suhboldb', 'abhi.loveyou39', 'harshitgargjpr', 'fdsbnmfds', 'fcnew009', 'deepukumar27398', 'pasupulavijay100', 'shubhamanurag98', 'rayliao', 'nikhil24', 'jby2007', 'ankushbag', 'bmunkhzorig', 'sgu20131509', 'siddharthagarwal786', 'honnyou', 'yhuang404', 'geetha0802', 'patcat94', 'sri2899', 'sudippradhan641', 'goutham16ec', 'dvnshmnz', 'pratyush0824', 'saivinay99', 'pratham', 'praveen_kumar', 'mlieber1995', 'kunal.sanvaniya363', 'kushal', 'satyam007', 'mitchellknight', 'ladekar.vrushali', 'myworld21.96', 'shayam0333', 'k910716kim', 'tsuryawanshi34', 'aaqibhoda', 'dipak101505', 'soumyashailja', 'jvlahari', 'qpqp072472', 'khalidshaik', '135goodguy', 'ep14btech11003', 'harika', 'saurabh.telavane', 'samanwaysadhu', 'urstrulyuttam', 'ee16btech11031', 'zhang_f', 'skzl34', None, 'rajeshdara', 'divyansh', 'apoorva123', 'rsadhukhan900', 'kanishk.sonkusre', 'puspendu672', 'lambaiitkgp', 'adityasai', 'sas36000', 'meghana977', 'kontham.abhay', 'rishavchakraborty1998', 'ankita132', 'kshivamraj32', 'taufique.1929', 'quantumred3', 'mmkpa2012', 'woodworthkyle', 'fods12', 'gautam7', 'palakharwani', 'gouravfs1996', 'himaswetha', 'vinayvishwakarma', 'pavanrochester', 'bhaveshbaranda6', 'kumawat.devendra2', 'mahima333k', 'vineelchandra99', 'bourbon', 'psaisantoshkr99', 'nugaira', 'miiinji', 'sayantanroy1801', 'shahadeoshelke', 'ahirsharan', 'prakhar.bafna', 'the_generic', 'sgu20141488', 'jbelcourt', 'bsamseth', 'himanshmittal237', 'umangagr56', 'pranit.dalal', 'simrobson', 'adriang123', 'sgu20121476', 'anandkadu4108', 'skotetho', 'rohitkhinchi1312', 'trobertson1', 'h_k', 'fermi0n', 'sharanmourya', 'pandityhre321', 'rahulnani412', 'snehavinjam123', 'bhargav', 'abhay12345678', 'swapnilshingte504', 'leandrosaraco', 'satishiscool007', 'krishnapriyakantipudi', 'danish_imam', 'chandermohan', 'yash779193', 'adityavarma84', 'pritamsoni.hsr', 'sgu20141403', 'sreejachowdary', 'harshmaheshwari135', 'ssingh29b', 'jahnvi123', 'jcarlin', 'addylocks11598', 'varthyasushanth', 'shashwatjai314', 'aravind03', 'vibhorjain96', 'carlos.acosta.berlin', 'yennamharshavardhan', 'imanmirzaie', 'abhishekjain199820', 'kaunaj06', 'utkarsh9992', 'meghana2507', 'punishment747', 'anikdutta10', 'siddhanthaldar14', 'ahealey1', 'sowjanya', 'sohi', 'ayush3006kr', 'nageshpatle', 'yash_sharma', 'shubham.rajput98', 'singhpunarjeet', 'zoloogg', 'giriprasadmyworld1122', 'sajid.eqbal78', 'sgu20131420', 'tibrewalpratik17', 'astikey', 'jbrizzy', 'bongwhan12', 'saptarshi.hobby2', 'vvsivakumar24', 'mvert157', 'sgu20121423', 'das.siddharth07', 'angyi90', 'kumar.tarun2772', 'harshbarelia14', 'vyshnaviboddupalli', 'sanjeet029', 'sgu20131499', 'tarun3827', 'claritas']"
2,5,188,17,6,"['khalidshaik', 'anandkadu4108', 'ep14btech11003', 'varthyasushanth', 'aravind03', 'ee16btech11031']",181,"['asheeshgir', 'harshitkhardia', 'jackhon', 'sjeet474', 'jawalikarpari', 'dounan0618', 'rajbhartiprince', 'anjannama0123', 'satyavruthg23', 'jishnu1705', 'spazos7', 'lagadapativinay', 'sainarendra999', 'ambekar.prathmesh', 'bindalrajat0406', 'ppg28072000', 'umangfogla', 'abiseik', 'kumarjitpal98', 'myomyint', 'swagatam.haldar9', 'suryavishal26', 'ompatel13101995', 'pawarpratap555', 'h.farazul', 'vaibhav2010', 'ritu2512', 'rroshanraj32', 'akankshatoley44', 'souravofvibrant', 'arathore98', 'suhboldb', 'abhi.loveyou39', 'harshitgargjpr', 'fdsbnmfds', 'fcnew009', 'deepukumar27398', 'pasupulavijay100', 'shubhamanurag98', 'rayliao', 'nikhil24', 'jby2007', 'ankushbag', 'bmunkhzorig', 'siddharthagarwal786', 'yhuang404', 'geetha0802', 'patcat94', 'sri2899', 'sudippradhan641', 'goutham16ec', 'dvnshmnz', 'pratyush0824', 'saivinay99', 'pratham', 'praveen_kumar', 'mlieber1995', 'kunal.sanvaniya363', 'kushal', 'satyam007', 'mitchellknight', 'ladekar.vrushali', 'myworld21.96', 'shayam0333', 'tsuryawanshi34', 'aaqibhoda', 'dipak101505', 'soumyashailja', 'jvlahari', '135goodguy', 'harika', 'saurabh.telavane', 'samanwaysadhu', 'urstrulyuttam', 'zhang_f', 'rajeshdara', 'divyansh', 'apoorva123', 'rsadhukhan900', 'kanishk.sonkusre', 'puspendu672', 'lambaiitkgp', 'adityasai', 'sas36000', 'meghana977', 'kontham.abhay', 'rishavchakraborty1998', 'ankita132', 'kshivamraj32', 'taufique.1929', 'quantumred3', 'mmkpa2012', 'woodworthkyle', 'fods12', 'gautam7', 'palakharwani', 'gouravfs1996', 'himaswetha', 'vinayvishwakarma', 'pavanrochester', 'bhaveshbaranda6', 'kumawat.devendra2', 'mahima333k', 'vineelchandra99', 'bourbon', 'psaisantoshkr99', 'nugaira', 'sayantanroy1801', 'shahadeoshelke', 'ahirsharan', 'prakhar.bafna', 'the_generic', 'jbelcourt', 'bsamseth', 'himanshmittal237', 'umangagr56', 'pranit.dalal', 'simrobson', 'adriang123', 'sgu20121476', 'skotetho', 'rohitkhinchi1312', 'trobertson1', 'h_k', 'fermi0n', 'sharanmourya', 'pandityhre321', 'rahulnani412', 'snehavinjam123', 'bhargav', 'abhay12345678', 'swapnilshingte504', 'leandrosaraco', 'satishiscool007', 'krishnapriyakantipudi', 'danish_imam', 'chandermohan', 'yash779193', 'adityavarma84', 'pritamsoni.hsr', 'sreejachowdary', 'harshmaheshwari135', 'ssingh29b', 'jahnvi123', 'jcarlin', 'addylocks11598', 'shashwatjai314', 'vibhorjain96', 'carlos.acosta.berlin', 'yennamharshavardhan', 'imanmirzaie', 'abhishekjain199820', 'kaunaj06', 'utkarsh9992', 'meghana2507', 'punishment747', 'anikdutta10', 'siddhanthaldar14', 'ahealey1', 'sowjanya', 'sohi', 'ayush3006kr', 'nageshpatle', 'yash_sharma', 'shubham.rajput98', 'singhpunarjeet', 'zoloogg', 'giriprasadmyworld1122', 'sajid.eqbal78', 'sgu20131420', 'tibrewalpratik17', 'astikey', 'jbrizzy', 'saptarshi.hobby2', 'vvsivakumar24', 'das.siddharth07', 'kumar.tarun2772', 'harshbarelia14', 'vyshnaviboddupalli', 'sanjeet029', 'tarun3827']",11,"['sidmohla', 'ee16btech11001', None, 'vishnu_33', 'karthikr98', 'adithyahosapate', 'dj_16', 'es16btech11008', 'chait', 'ganna09', 'deepkarma82']",198,"['asheeshgir', 'harshitkhardia', 'jackhon', 'sjeet474', 'jawalikarpari', 'dounan0618', 'rajbhartiprince', 'anjannama0123', 'satyavruthg23', 'jishnu1705', 'spazos7', 'vishnu_33', 'lagadapativinay', 'sainarendra999', 'ambekar.prathmesh', 'bindalrajat0406', 'ppg28072000', 'umangfogla', 'abiseik', 'kumarjitpal98', 'myomyint', 'swagatam.haldar9', 'suryavishal26', 'ompatel13101995', 'pawarpratap555', 'h.farazul', 'vaibhav2010', 'ritu2512', 'rroshanraj32', 'akankshatoley44', 'souravofvibrant', 'arathore98', 'suhboldb', 'abhi.loveyou39', 'harshitgargjpr', 'fdsbnmfds', 'fcnew009', 'deepukumar27398', 'pasupulavijay100', 'shubhamanurag98', 'rayliao', 'nikhil24', 'dj_16', 'jby2007', 'ankushbag', 'bmunkhzorig', 'siddharthagarwal786', 'yhuang404', 'geetha0802', 'patcat94', 'sri2899', 'sudippradhan641', 'goutham16ec', 'dvnshmnz', 'pratyush0824', 'saivinay99', 'pratham', 'praveen_kumar', 'mlieber1995', 'kunal.sanvaniya363', 'kushal', 'satyam007', 'mitchellknight', 'ladekar.vrushali', 'myworld21.96', 'shayam0333', 'tsuryawanshi34', 'aaqibhoda', 'dipak101505', 'soumyashailja', 'jvlahari', 'khalidshaik', '135goodguy', 'ep14btech11003', 'harika', 'saurabh.telavane', 'samanwaysadhu', 'urstrulyuttam', 'ee16btech11031', 'zhang_f', None, 'rajeshdara', 'divyansh', 'apoorva123', 'rsadhukhan900', 'kanishk.sonkusre', 'puspendu672', 'lambaiitkgp', 'karthikr98', 'adityasai', 'sas36000', 'meghana977', 'kontham.abhay', 'adithyahosapate', 'rishavchakraborty1998', 'ankita132', 'kshivamraj32', 'taufique.1929', 'quantumred3', 'mmkpa2012', 'woodworthkyle', 'fods12', 'gautam7', 'palakharwani', 'gouravfs1996', 'himaswetha', 'vinayvishwakarma', 'pavanrochester', 'bhaveshbaranda6', 'kumawat.devendra2', 'mahima333k', 'vineelchandra99', 'bourbon', 'psaisantoshkr99', 'nugaira', 'sayantanroy1801', 'shahadeoshelke', 'ahirsharan', 'prakhar.bafna', 'the_generic', 'jbelcourt', 'bsamseth', 'himanshmittal237', 'umangagr56', 'pranit.dalal', 'simrobson', 'deepkarma82', 'adriang123', 'sgu20121476', 'anandkadu4108', 'skotetho', 'rohitkhinchi1312', 'trobertson1', 'h_k', 'fermi0n', 'sharanmourya', 'pandityhre321', 'rahulnani412', 'snehavinjam123', 'bhargav', 'abhay12345678', 'swapnilshingte504', 'leandrosaraco', 'satishiscool007', 'krishnapriyakantipudi', 'danish_imam', 'chandermohan', 'yash779193', 'adityavarma84', 'pritamsoni.hsr', 'sreejachowdary', 'harshmaheshwari135', 'ssingh29b', 'jahnvi123', 'jcarlin', 'addylocks11598', 'varthyasushanth', 'shashwatjai314', 'aravind03', 'vibhorjain96', 'carlos.acosta.berlin', 'yennamharshavardhan', 'imanmirzaie', 'abhishekjain199820', 'kaunaj06', 'utkarsh9992', 'meghana2507', 'punishment747', 'anikdutta10', 'siddhanthaldar14', 'ahealey1', 'sowjanya', 'es16btech11008', 'chait', 'sohi', 'ayush3006kr', 'sidmohla', 'nageshpatle', 'yash_sharma', 'shubham.rajput98', 'singhpunarjeet', 'zoloogg', 'giriprasadmyworld1122', 'sajid.eqbal78', 'sgu20131420', 'tibrewalpratik17', 'astikey', 'jbrizzy', 'ganna09', 'ee16btech11001', 'saptarshi.hobby2', 'vvsivakumar24', 'das.siddharth07', 'kumar.tarun2772', 'harshbarelia14', 'vyshnaviboddupalli', 'sanjeet029', 'tarun3827']"
2,1,188,15,10,"['fods12', 'patcat94', 'jcarlin', 'jackhon', 'ahealey1', 'mlieber1995', 'fermi0n', 'quantumred3', 'zhang_f', 'adriang123']",177,"['asheeshgir', 'harshitkhardia', 'sjeet474', 'jawalikarpari', 'dounan0618', 'rajbhartiprince', 'anjannama0123', 'satyavruthg23', 'jishnu1705', 'spazos7', 'lagadapativinay', 'sainarendra999', 'ambekar.prathmesh', 'bindalrajat0406', 'ppg28072000', 'umangfogla', 'abiseik', 'kumarjitpal98', 'myomyint', 'swagatam.haldar9', 'suryavishal26', 'ompatel13101995', 'pawarpratap555', 'h.farazul', 'vaibhav2010', 'ritu2512', 'rroshanraj32', 'akankshatoley44', 'souravofvibrant', 'arathore98', 'suhboldb', 'abhi.loveyou39', 'harshitgargjpr', 'fdsbnmfds', 'fcnew009', 'deepukumar27398', 'pasupulavijay100', 'shubhamanurag98', 'rayliao', 'nikhil24', 'jby2007', 'ankushbag', 'bmunkhzorig', 'siddharthagarwal786', 'yhuang404', 'geetha0802', 'sri2899', 'sudippradhan641', 'goutham16ec', 'dvnshmnz', 'pratyush0824', 'saivinay99', 'pratham', 'praveen_kumar', 'kunal.sanvaniya363', 'kushal', 'satyam007', 'mitchellknight', 'ladekar.vrushali', 'myworld21.96', 'shayam0333', 'tsuryawanshi34', 'aaqibhoda', 'dipak101505', 'soumyashailja', 'jvlahari', 'khalidshaik', '135goodguy', 'ep14btech11003', 'harika', 'saurabh.telavane', 'samanwaysadhu', 'urstrulyuttam', 'ee16btech11031', 'rajeshdara', 'divyansh', 'apoorva123', 'rsadhukhan900', 'kanishk.sonkusre', 'puspendu672', 'lambaiitkgp', 'adityasai', 'sas36000', 'meghana977', 'kontham.abhay', 'rishavchakraborty1998', 'ankita132', 'kshivamraj32', 'taufique.1929', 'mmkpa2012', 'woodworthkyle', 'gautam7', 'palakharwani', 'gouravfs1996', 'himaswetha', 'vinayvishwakarma', 'pavanrochester', 'bhaveshbaranda6', 'kumawat.devendra2', 'mahima333k', 'vineelchandra99', 'bourbon', 'psaisantoshkr99', 'nugaira', 'sayantanroy1801', 'shahadeoshelke', 'ahirsharan', 'prakhar.bafna', 'the_generic', 'jbelcourt', 'bsamseth', 'himanshmittal237', 'umangagr56', 'pranit.dalal', 'simrobson', 'sgu20121476', 'anandkadu4108', 'skotetho', 'rohitkhinchi1312', 'trobertson1', 'h_k', 'sharanmourya', 'pandityhre321', 'rahulnani412', 'snehavinjam123', 'bhargav', 'abhay12345678', 'swapnilshingte504', 'leandrosaraco', 'satishiscool007', 'krishnapriyakantipudi', 'danish_imam', 'chandermohan', 'yash779193', 'adityavarma84', 'pritamsoni.hsr', 'sreejachowdary', 'harshmaheshwari135', 'ssingh29b', 'jahnvi123', 'addylocks11598', 'varthyasushanth', 'shashwatjai314', 'aravind03', 'vibhorjain96', 'carlos.acosta.berlin', 'yennamharshavardhan', 'imanmirzaie', 'abhishekjain199820', 'kaunaj06', 'utkarsh9992', 'meghana2507', 'punishment747', 'anikdutta10', 'siddhanthaldar14', 'sowjanya', 'sohi', 'ayush3006kr', 'nageshpatle', 'yash_sharma', 'shubham.rajput98', 'singhpunarjeet', 'zoloogg', 'giriprasadmyworld1122', 'sajid.eqbal78', 'sgu20131420', 'tibrewalpratik17', 'astikey', 'jbrizzy', 'saptarshi.hobby2', 'vvsivakumar24', 'das.siddharth07', 'kumar.tarun2772', 'harshbarelia14', 'vyshnaviboddupalli', 'sanjeet029', 'tarun3827']",5,"['brytz', 'chambersa', 'eringrant01', None, 'lbalkenhol']",192,"['asheeshgir', 'harshitkhardia', 'jackhon', 'sjeet474', 'jawalikarpari', 'dounan0618', 'rajbhartiprince', 'anjannama0123', 'satyavruthg23', 'jishnu1705', 'spazos7', 'lagadapativinay', 'sainarendra999', 'ambekar.prathmesh', 'bindalrajat0406', 'ppg28072000', 'umangfogla', 'abiseik', 'kumarjitpal98', 'myomyint', 'swagatam.haldar9', 'suryavishal26', 'ompatel13101995', 'pawarpratap555', 'h.farazul', 'vaibhav2010', 'ritu2512', 'rroshanraj32', 'akankshatoley44', 'souravofvibrant', 'arathore98', 'suhboldb', 'abhi.loveyou39', 'harshitgargjpr', 'fdsbnmfds', 'fcnew009', 'deepukumar27398', 'pasupulavijay100', 'shubhamanurag98', 'rayliao', 'nikhil24', 'jby2007', 'ankushbag', 'bmunkhzorig', 'siddharthagarwal786', 'yhuang404', 'geetha0802', 'patcat94', 'sri2899', 'sudippradhan641', 'goutham16ec', 'dvnshmnz', 'pratyush0824', 'saivinay99', 'pratham', 'praveen_kumar', 'mlieber1995', 'kunal.sanvaniya363', 'kushal', 'satyam007', 'mitchellknight', 'ladekar.vrushali', 'myworld21.96', 'shayam0333', 'tsuryawanshi34', 'aaqibhoda', 'dipak101505', 'soumyashailja', 'jvlahari', 'khalidshaik', '135goodguy', 'ep14btech11003', 'harika', 'saurabh.telavane', 'samanwaysadhu', 'urstrulyuttam', 'ee16btech11031', 'zhang_f', 'brytz', None, 'rajeshdara', 'divyansh', 'apoorva123', 'rsadhukhan900', 'kanishk.sonkusre', 'puspendu672', 'lambaiitkgp', 'adityasai', 'sas36000', 'meghana977', 'kontham.abhay', 'rishavchakraborty1998', 'ankita132', 'kshivamraj32', 'taufique.1929', 'quantumred3', 'mmkpa2012', 'woodworthkyle', 'fods12', 'gautam7', 'palakharwani', 'gouravfs1996', 'himaswetha', 'vinayvishwakarma', 'pavanrochester', 'bhaveshbaranda6', 'kumawat.devendra2', 'mahima333k', 'vineelchandra99', 'bourbon', 'psaisantoshkr99', 'nugaira', 'sayantanroy1801', 'shahadeoshelke', 'ahirsharan', 'prakhar.bafna', 'the_generic', 'chambersa', 'jbelcourt', 'bsamseth', 'himanshmittal237', 'umangagr56', 'pranit.dalal', 'simrobson', 'adriang123', 'sgu20121476', 'anandkadu4108', 'skotetho', 'rohitkhinchi1312', 'trobertson1', 'h_k', 'fermi0n', 'sharanmourya', 'pandityhre321', 'rahulnani412', 'snehavinjam123', 'bhargav', 'abhay12345678', 'swapnilshingte504', 'leandrosaraco', 'satishiscool007', 'krishnapriyakantipudi', 'danish_imam', 'chandermohan', 'yash779193', 'adityavarma84', 'pritamsoni.hsr', 'sreejachowdary', 'harshmaheshwari135', 'ssingh29b', 'jahnvi123', 'jcarlin', 'addylocks11598', 'varthyasushanth', 'shashwatjai314', 'aravind03', 'vibhorjain96', 'carlos.acosta.berlin', 'yennamharshavardhan', 'imanmirzaie', 'abhishekjain199820', 'kaunaj06', 'utkarsh9992', 'meghana2507', 'punishment747', 'anikdutta10', 'siddhanthaldar14', 'ahealey1', 'sowjanya', 'sohi', 'ayush3006kr', 'nageshpatle', 'yash_sharma', 'shubham.rajput98', 'singhpunarjeet', 'zoloogg', 'giriprasadmyworld1122', 'sajid.eqbal78', 'sgu20131420', 'tibrewalpratik17', 'astikey', 'jbrizzy', 'saptarshi.hobby2', 'vvsivakumar24', 'das.siddharth07', 'kumar.tarun2772', 'harshbarelia14', 'vyshnaviboddupalli', 'eringrant01', 'sanjeet029', 'lbalkenhol', 'tarun3827']"
2,12,188,13,2,"['suhboldb', 'bmunkhzorig']",185,"['asheeshgir', 'harshitkhardia', 'jackhon', 'sjeet474', 'jawalikarpari', 'dounan0618', 'rajbhartiprince', 'anjannama0123', 'satyavruthg23', 'jishnu1705', 'spazos7', 'lagadapativinay', 'sainarendra999', 'ambekar.prathmesh', 'bindalrajat0406', 'ppg28072000', 'umangfogla', 'abiseik', 'kumarjitpal98', 'myomyint', 'swagatam.haldar9', 'suryavishal26', 'ompatel13101995', 'pawarpratap555', 'h.farazul', 'vaibhav2010', 'ritu2512', 'rroshanraj32', 'akankshatoley44', 'souravofvibrant', 'arathore98', 'abhi.loveyou39', 'harshitgargjpr', 'fdsbnmfds', 'fcnew009', 'deepukumar27398', 'pasupulavijay100', 'shubhamanurag98', 'rayliao', 'nikhil24', 'jby2007', 'ankushbag', 'siddharthagarwal786', 'yhuang404', 'geetha0802', 'patcat94', 'sri2899', 'sudippradhan641', 'goutham16ec', 'dvnshmnz', 'pratyush0824', 'saivinay99', 'pratham', 'praveen_kumar', 'mlieber1995', 'kunal.sanvaniya363', 'kushal', 'satyam007', 'mitchellknight', 'ladekar.vrushali', 'myworld21.96', 'shayam0333', 'tsuryawanshi34', 'aaqibhoda', 'dipak101505', 'soumyashailja', 'jvlahari', 'khalidshaik', '135goodguy', 'ep14btech11003', 'harika', 'saurabh.telavane', 'samanwaysadhu', 'urstrulyuttam', 'ee16btech11031', 'zhang_f', 'rajeshdara', 'divyansh', 'apoorva123', 'rsadhukhan900', 'kanishk.sonkusre', 'puspendu672', 'lambaiitkgp', 'adityasai', 'sas36000', 'meghana977', 'kontham.abhay', 'rishavchakraborty1998', 'ankita132', 'kshivamraj32', 'taufique.1929', 'quantumred3', 'mmkpa2012', 'woodworthkyle', 'fods12', 'gautam7', 'palakharwani', 'gouravfs1996', 'himaswetha', 'vinayvishwakarma', 'pavanrochester', 'bhaveshbaranda6', 'kumawat.devendra2', 'mahima333k', 'vineelchandra99', 'bourbon', 'psaisantoshkr99', 'nugaira', 'sayantanroy1801', 'shahadeoshelke', 'ahirsharan', 'prakhar.bafna', 'the_generic', 'jbelcourt', 'bsamseth', 'himanshmittal237', 'umangagr56', 'pranit.dalal', 'simrobson', 'adriang123', 'sgu20121476', 'anandkadu4108', 'skotetho', 'rohitkhinchi1312', 'trobertson1', 'h_k', 'fermi0n', 'sharanmourya', 'pandityhre321', 'rahulnani412', 'snehavinjam123', 'bhargav', 'abhay12345678', 'swapnilshingte504', 'leandrosaraco', 'satishiscool007', 'krishnapriyakantipudi', 'danish_imam', 'chandermohan', 'yash779193', 'adityavarma84', 'pritamsoni.hsr', 'sreejachowdary', 'harshmaheshwari135', 'ssingh29b', 'jahnvi123', 'jcarlin', 'addylocks11598', 'varthyasushanth', 'shashwatjai314', 'aravind03', 'vibhorjain96', 'carlos.acosta.berlin', 'yennamharshavardhan', 'imanmirzaie', 'abhishekjain199820', 'kaunaj06', 'utkarsh9992', 'meghana2507', 'punishment747', 'anikdutta10', 'siddhanthaldar14', 'ahealey1', 'sowjanya', 'sohi', 'ayush3006kr', 'nageshpatle', 'yash_sharma', 'shubham.rajput98', 'singhpunarjeet', 'zoloogg', 'giriprasadmyworld1122', 'sajid.eqbal78', 'sgu20131420', 'tibrewalpratik17', 'astikey', 'jbrizzy', 'saptarshi.hobby2', 'vvsivakumar24', 'das.siddharth07', 'kumar.tarun2772', 'harshbarelia14', 'vyshnaviboddupalli', 'sanjeet029', 'tarun3827']",11,"['fuente', 'banzragch', 'oyuka46', 'seiko_anarjin', 'djtumenjargal', 'ganzo_0306', 'ulaankhuu72', 'bil_marbel', 'b.buynaa01', 'choijamts.choijoo', None]",198,"['asheeshgir', 'djtumenjargal', 'harshitkhardia', 'jackhon', 'sjeet474', 'jawalikarpari', 'dounan0618', 'rajbhartiprince', 'anjannama0123', 'satyavruthg23', 'jishnu1705', 'spazos7', 'lagadapativinay', 'sainarendra999', 'ambekar.prathmesh', 'bindalrajat0406', 'ppg28072000', 'umangfogla', 'abiseik', 'kumarjitpal98', 'fuente', 'myomyint', 'swagatam.haldar9', 'suryavishal26', 'ompatel13101995', 'oyuka46', 'pawarpratap555', 'h.farazul', 'vaibhav2010', 'ritu2512', 'rroshanraj32', 'akankshatoley44', 'souravofvibrant', 'arathore98', 'suhboldb', 'abhi.loveyou39', 'harshitgargjpr', 'fdsbnmfds', 'fcnew009', 'deepukumar27398', 'pasupulavijay100', 'shubhamanurag98', 'rayliao', 'nikhil24', 'ganzo_0306', 'jby2007', 'ankushbag', 'bmunkhzorig', 'siddharthagarwal786', 'yhuang404', 'geetha0802', 'patcat94', 'sri2899', 'sudippradhan641', 'goutham16ec', 'dvnshmnz', 'pratyush0824', 'saivinay99', 'pratham', 'praveen_kumar', 'mlieber1995', 'kunal.sanvaniya363', 'kushal', 'satyam007', 'mitchellknight', 'ladekar.vrushali', 'myworld21.96', 'shayam0333', 'seiko_anarjin', 'tsuryawanshi34', 'aaqibhoda', 'dipak101505', 'soumyashailja', 'jvlahari', 'bil_marbel', 'khalidshaik', '135goodguy', 'ep14btech11003', 'harika', 'saurabh.telavane', 'samanwaysadhu', 'urstrulyuttam', 'ulaankhuu72', 'ee16btech11031', 'zhang_f', None, 'rajeshdara', 'divyansh', 'apoorva123', 'rsadhukhan900', 'kanishk.sonkusre', 'puspendu672', 'lambaiitkgp', 'adityasai', 'sas36000', 'meghana977', 'kontham.abhay', 'rishavchakraborty1998', 'ankita132', 'kshivamraj32', 'taufique.1929', 'quantumred3', 'mmkpa2012', 'woodworthkyle', 'fods12', 'gautam7', 'palakharwani', 'gouravfs1996', 'himaswetha', 'vinayvishwakarma', 'pavanrochester', 'bhaveshbaranda6', 'kumawat.devendra2', 'mahima333k', 'vineelchandra99', 'bourbon', 'psaisantoshkr99', 'b.buynaa01', 'nugaira', 'sayantanroy1801', 'shahadeoshelke', 'ahirsharan', 'prakhar.bafna', 'the_generic', 'banzragch', 'jbelcourt', 'bsamseth', 'himanshmittal237', 'umangagr56', 'pranit.dalal', 'simrobson', 'adriang123', 'sgu20121476', 'anandkadu4108', 'skotetho', 'rohitkhinchi1312', 'trobertson1', 'h_k', 'fermi0n', 'choijamts.choijoo', 'sharanmourya', 'pandityhre321', 'rahulnani412', 'snehavinjam123', 'bhargav', 'abhay12345678', 'swapnilshingte504', 'leandrosaraco', 'satishiscool007', 'krishnapriyakantipudi', 'danish_imam', 'chandermohan', 'yash779193', 'adityavarma84', 'pritamsoni.hsr', 'sreejachowdary', 'harshmaheshwari135', 'ssingh29b', 'jahnvi123', 'jcarlin', 'addylocks11598', 'varthyasushanth', 'shashwatjai314', 'aravind03', 'vibhorjain96', 'carlos.acosta.berlin', 'yennamharshavardhan', 'imanmirzaie', 'abhishekjain199820', 'kaunaj06', 'utkarsh9992', 'meghana2507', 'punishment747', 'anikdutta10', 'siddhanthaldar14', 'ahealey1', 'sowjanya', 'sohi', 'ayush3006kr', 'nageshpatle', 'yash_sharma', 'shubham.rajput98', 'singhpunarjeet', 'zoloogg', 'giriprasadmyworld1122', 'sajid.eqbal78', 'sgu20131420', 'tibrewalpratik17', 'astikey', 'jbrizzy', 'saptarshi.hobby2', 'vvsivakumar24', 'das.siddharth07', 'kumar.tarun2772', 'harshbarelia14', 'vyshnaviboddupalli', 'sanjeet029', 'tarun3827']"
2,10,188,12,6,"['ompatel13101995', 'tsuryawanshi34', 'pawarpratap555', 'swapnilshingte504', 'ladekar.vrushali', 'shahadeoshelke']",181,"['asheeshgir', 'harshitkhardia', 'jackhon', 'sjeet474', 'jawalikarpari', 'dounan0618', 'rajbhartiprince', 'anjannama0123', 'satyavruthg23', 'jishnu1705', 'spazos7', 'lagadapativinay', 'sainarendra999', 'ambekar.prathmesh', 'bindalrajat0406', 'ppg28072000', 'umangfogla', 'abiseik', 'kumarjitpal98', 'myomyint', 'swagatam.haldar9', 'suryavishal26', 'h.farazul', 'vaibhav2010', 'ritu2512', 'rroshanraj32', 'akankshatoley44', 'souravofvibrant', 'arathore98', 'suhboldb', 'abhi.loveyou39', 'harshitgargjpr', 'fdsbnmfds', 'fcnew009', 'deepukumar27398', 'pasupulavijay100', 'shubhamanurag98', 'rayliao', 'nikhil24', 'jby2007', 'ankushbag', 'bmunkhzorig', 'siddharthagarwal786', 'yhuang404', 'geetha0802', 'patcat94', 'sri2899', 'sudippradhan641', 'goutham16ec', 'dvnshmnz', 'pratyush0824', 'saivinay99', 'pratham', 'praveen_kumar', 'mlieber1995', 'kunal.sanvaniya363', 'kushal', 'satyam007', 'mitchellknight', 'myworld21.96', 'shayam0333', 'aaqibhoda', 'dipak101505', 'soumyashailja', 'jvlahari', 'khalidshaik', '135goodguy', 'ep14btech11003', 'harika', 'saurabh.telavane', 'samanwaysadhu', 'urstrulyuttam', 'ee16btech11031', 'zhang_f', 'rajeshdara', 'divyansh', 'apoorva123', 'rsadhukhan900', 'kanishk.sonkusre', 'puspendu672', 'lambaiitkgp', 'adityasai', 'sas36000', 'meghana977', 'kontham.abhay', 'rishavchakraborty1998', 'ankita132', 'kshivamraj32', 'taufique.1929', 'quantumred3', 'mmkpa2012', 'woodworthkyle', 'fods12', 'gautam7', 'palakharwani', 'gouravfs1996', 'himaswetha', 'vinayvishwakarma', 'pavanrochester', 'bhaveshbaranda6', 'kumawat.devendra2', 'mahima333k', 'vineelchandra99', 'bourbon', 'psaisantoshkr99', 'nugaira', 'sayantanroy1801', 'ahirsharan', 'prakhar.bafna', 'the_generic', 'jbelcourt', 'bsamseth', 'himanshmittal237', 'umangagr56', 'pranit.dalal', 'simrobson', 'adriang123', 'sgu20121476', 'anandkadu4108', 'skotetho', 'rohitkhinchi1312', 'trobertson1', 'h_k', 'fermi0n', 'sharanmourya', 'pandityhre321', 'rahulnani412', 'snehavinjam123', 'bhargav', 'abhay12345678', 'leandrosaraco', 'satishiscool007', 'krishnapriyakantipudi', 'danish_imam', 'chandermohan', 'yash779193', 'adityavarma84', 'pritamsoni.hsr', 'sreejachowdary', 'harshmaheshwari135', 'ssingh29b', 'jahnvi123', 'jcarlin', 'addylocks11598', 'varthyasushanth', 'shashwatjai314', 'aravind03', 'vibhorjain96', 'carlos.acosta.berlin', 'yennamharshavardhan', 'imanmirzaie', 'abhishekjain199820', 'kaunaj06', 'utkarsh9992', 'meghana2507', 'punishment747', 'anikdutta10', 'siddhanthaldar14', 'ahealey1', 'sowjanya', 'sohi', 'ayush3006kr', 'nageshpatle', 'yash_sharma', 'shubham.rajput98', 'singhpunarjeet', 'zoloogg', 'giriprasadmyworld1122', 'sajid.eqbal78', 'sgu20131420', 'tibrewalpratik17', 'astikey', 'jbrizzy', 'saptarshi.hobby2', 'vvsivakumar24', 'das.siddharth07', 'kumar.tarun2772', 'harshbarelia14', 'vyshnaviboddupalli', 'sanjeet029', 'tarun3827']",6,"['shrikant4dulewad', 'btanmay01', 'praveshkup', 'sahil.sonar24', 'poojabatawale96', None]",193,"['asheeshgir', 'harshitkhardia', 'jackhon', 'sjeet474', 'jawalikarpari', 'dounan0618', 'rajbhartiprince', 'anjannama0123', 'satyavruthg23', 'jishnu1705', 'spazos7', 'lagadapativinay', 'sainarendra999', 'ambekar.prathmesh', 'bindalrajat0406', 'ppg28072000', 'umangfogla', 'abiseik', 'kumarjitpal98', 'myomyint', 'swagatam.haldar9', 'suryavishal26', 'ompatel13101995', 'pawarpratap555', 'h.farazul', 'vaibhav2010', 'ritu2512', 'rroshanraj32', 'akankshatoley44', 'souravofvibrant', 'arathore98', 'suhboldb', 'abhi.loveyou39', 'harshitgargjpr', 'fdsbnmfds', 'fcnew009', 'deepukumar27398', 'praveshkup', 'pasupulavijay100', 'shubhamanurag98', 'rayliao', 'nikhil24', 'jby2007', 'ankushbag', 'bmunkhzorig', 'siddharthagarwal786', 'yhuang404', 'geetha0802', 'patcat94', 'sri2899', 'sudippradhan641', 'goutham16ec', 'dvnshmnz', 'pratyush0824', 'saivinay99', 'pratham', 'praveen_kumar', 'mlieber1995', 'kunal.sanvaniya363', 'kushal', 'satyam007', 'mitchellknight', 'ladekar.vrushali', 'myworld21.96', 'shayam0333', 'tsuryawanshi34', 'aaqibhoda', 'dipak101505', 'soumyashailja', 'jvlahari', 'khalidshaik', '135goodguy', 'ep14btech11003', 'harika', 'saurabh.telavane', 'samanwaysadhu', 'urstrulyuttam', 'ee16btech11031', 'zhang_f', None, 'rajeshdara', 'divyansh', 'apoorva123', 'rsadhukhan900', 'kanishk.sonkusre', 'puspendu672', 'lambaiitkgp', 'adityasai', 'sas36000', 'meghana977', 'kontham.abhay', 'rishavchakraborty1998', 'ankita132', 'kshivamraj32', 'taufique.1929', 'quantumred3', 'mmkpa2012', 'woodworthkyle', 'fods12', 'gautam7', 'palakharwani', 'gouravfs1996', 'himaswetha', 'vinayvishwakarma', 'pavanrochester', 'bhaveshbaranda6', 'kumawat.devendra2', 'mahima333k', 'btanmay01', 'sahil.sonar24', 'vineelchandra99', 'bourbon', 'psaisantoshkr99', 'nugaira', 'sayantanroy1801', 'shahadeoshelke', 'ahirsharan', 'prakhar.bafna', 'the_generic', 'jbelcourt', 'bsamseth', 'himanshmittal237', 'umangagr56', 'pranit.dalal', 'simrobson', 'adriang123', 'sgu20121476', 'anandkadu4108', 'skotetho', 'rohitkhinchi1312', 'trobertson1', 'h_k', 'fermi0n', 'sharanmourya', 'pandityhre321', 'rahulnani412', 'snehavinjam123', 'bhargav', 'abhay12345678', 'swapnilshingte504', 'leandrosaraco', 'satishiscool007', 'krishnapriyakantipudi', 'danish_imam', 'chandermohan', 'yash779193', 'adityavarma84', 'pritamsoni.hsr', 'sreejachowdary', 'harshmaheshwari135', 'ssingh29b', 'shrikant4dulewad', 'jahnvi123', 'jcarlin', 'addylocks11598', 'varthyasushanth', 'shashwatjai314', 'aravind03', 'vibhorjain96', 'carlos.acosta.berlin', 'yennamharshavardhan', 'imanmirzaie', 'abhishekjain199820', 'kaunaj06', 'utkarsh9992', 'meghana2507', 'punishment747', 'anikdutta10', 'siddhanthaldar14', 'ahealey1', 'sowjanya', 'sohi', 'ayush3006kr', 'nageshpatle', 'yash_sharma', 'shubham.rajput98', 'singhpunarjeet', 'zoloogg', 'giriprasadmyworld1122', 'sajid.eqbal78', 'poojabatawale96', 'sgu20131420', 'tibrewalpratik17', 'astikey', 'jbrizzy', 'saptarshi.hobby2', 'vvsivakumar24', 'das.siddharth07', 'kumar.tarun2772', 'harshbarelia14', 'vyshnaviboddupalli', 'sanjeet029', 'tarun3827']"
2,2,188,11,4,"['mitchellknight', 'bourbon', 'the_generic', 'dounan0618']",183,"['asheeshgir', 'harshitkhardia', 'jackhon', 'sjeet474', 'jawalikarpari', 'rajbhartiprince', 'anjannama0123', 'satyavruthg23', 'jishnu1705', 'spazos7', 'lagadapativinay', 'sainarendra999', 'ambekar.prathmesh', 'bindalrajat0406', 'ppg28072000', 'umangfogla', 'abiseik', 'kumarjitpal98', 'myomyint', 'swagatam.haldar9', 'suryavishal26', 'ompatel13101995', 'pawarpratap555', 'h.farazul', 'vaibhav2010', 'ritu2512', 'rroshanraj32', 'akankshatoley44', 'souravofvibrant', 'arathore98', 'suhboldb', 'abhi.loveyou39', 'harshitgargjpr', 'fdsbnmfds', 'fcnew009', 'deepukumar27398', 'pasupulavijay100', 'shubhamanurag98', 'rayliao', 'nikhil24', 'jby2007', 'ankushbag', 'bmunkhzorig', 'siddharthagarwal786', 'yhuang404', 'geetha0802', 'patcat94', 'sri2899', 'sudippradhan641', 'goutham16ec', 'dvnshmnz', 'pratyush0824', 'saivinay99', 'pratham', 'praveen_kumar', 'mlieber1995', 'kunal.sanvaniya363', 'kushal', 'satyam007', 'ladekar.vrushali', 'myworld21.96', 'shayam0333', 'tsuryawanshi34', 'aaqibhoda', 'dipak101505', 'soumyashailja', 'jvlahari', 'khalidshaik', '135goodguy', 'ep14btech11003', 'harika', 'saurabh.telavane', 'samanwaysadhu', 'urstrulyuttam', 'ee16btech11031', 'zhang_f', 'rajeshdara', 'divyansh', 'apoorva123', 'rsadhukhan900', 'kanishk.sonkusre', 'puspendu672', 'lambaiitkgp', 'adityasai', 'sas36000', 'meghana977', 'kontham.abhay', 'rishavchakraborty1998', 'ankita132', 'kshivamraj32', 'taufique.1929', 'quantumred3', 'mmkpa2012', 'woodworthkyle', 'fods12', 'gautam7', 'palakharwani', 'gouravfs1996', 'himaswetha', 'vinayvishwakarma', 'pavanrochester', 'bhaveshbaranda6', 'kumawat.devendra2', 'mahima333k', 'vineelchandra99', 'psaisantoshkr99', 'nugaira', 'sayantanroy1801', 'shahadeoshelke', 'ahirsharan', 'prakhar.bafna', 'jbelcourt', 'bsamseth', 'himanshmittal237', 'umangagr56', 'pranit.dalal', 'simrobson', 'adriang123', 'sgu20121476', 'anandkadu4108', 'skotetho', 'rohitkhinchi1312', 'trobertson1', 'h_k', 'fermi0n', 'sharanmourya', 'pandityhre321', 'rahulnani412', 'snehavinjam123', 'bhargav', 'abhay12345678', 'swapnilshingte504', 'leandrosaraco', 'satishiscool007', 'krishnapriyakantipudi', 'danish_imam', 'chandermohan', 'yash779193', 'adityavarma84', 'pritamsoni.hsr', 'sreejachowdary', 'harshmaheshwari135', 'ssingh29b', 'jahnvi123', 'jcarlin', 'addylocks11598', 'varthyasushanth', 'shashwatjai314', 'aravind03', 'vibhorjain96', 'carlos.acosta.berlin', 'yennamharshavardhan', 'imanmirzaie', 'abhishekjain199820', 'kaunaj06', 'utkarsh9992', 'meghana2507', 'punishment747', 'anikdutta10', 'siddhanthaldar14', 'ahealey1', 'sowjanya', 'sohi', 'ayush3006kr', 'nageshpatle', 'yash_sharma', 'shubham.rajput98', 'singhpunarjeet', 'zoloogg', 'giriprasadmyworld1122', 'sajid.eqbal78', 'sgu20131420', 'tibrewalpratik17', 'astikey', 'jbrizzy', 'saptarshi.hobby2', 'vvsivakumar24', 'das.siddharth07', 'kumar.tarun2772', 'harshbarelia14', 'vyshnaviboddupalli', 'sanjeet029', 'tarun3827']",7,"['jamesabelcourt', 'vphan3', 'jrlon2', 'eringrant01', 'wyz135', None, 'frank_yl']",194,"['asheeshgir', 'harshitkhardia', 'jackhon', 'sjeet474', 'jawalikarpari', 'dounan0618', 'rajbhartiprince', 'wyz135', 'anjannama0123', 'satyavruthg23', 'jishnu1705', 'spazos7', 'lagadapativinay', 'sainarendra999', 'ambekar.prathmesh', 'bindalrajat0406', 'ppg28072000', 'umangfogla', 'abiseik', 'kumarjitpal98', 'jamesabelcourt', 'myomyint', 'swagatam.haldar9', 'suryavishal26', 'ompatel13101995', 'pawarpratap555', 'h.farazul', 'vaibhav2010', 'ritu2512', 'rroshanraj32', 'akankshatoley44', 'souravofvibrant', 'arathore98', 'frank_yl', 'suhboldb', 'abhi.loveyou39', 'harshitgargjpr', 'fdsbnmfds', 'fcnew009', 'deepukumar27398', 'pasupulavijay100', 'shubhamanurag98', 'rayliao', 'nikhil24', 'jby2007', 'ankushbag', 'bmunkhzorig', 'siddharthagarwal786', 'yhuang404', 'geetha0802', 'patcat94', 'sri2899', 'vphan3', 'sudippradhan641', 'goutham16ec', 'dvnshmnz', 'pratyush0824', 'saivinay99', 'pratham', 'praveen_kumar', 'mlieber1995', 'kunal.sanvaniya363', 'kushal', 'satyam007', 'mitchellknight', 'ladekar.vrushali', 'myworld21.96', 'shayam0333', 'tsuryawanshi34', 'aaqibhoda', 'dipak101505', 'soumyashailja', 'jvlahari', 'khalidshaik', '135goodguy', 'ep14btech11003', 'harika', 'saurabh.telavane', 'samanwaysadhu', 'urstrulyuttam', 'ee16btech11031', 'zhang_f', None, 'rajeshdara', 'divyansh', 'apoorva123', 'rsadhukhan900', 'kanishk.sonkusre', 'puspendu672', 'lambaiitkgp', 'adityasai', 'sas36000', 'meghana977', 'kontham.abhay', 'jrlon2', 'rishavchakraborty1998', 'ankita132', 'kshivamraj32', 'taufique.1929', 'quantumred3', 'mmkpa2012', 'woodworthkyle', 'fods12', 'gautam7', 'palakharwani', 'gouravfs1996', 'himaswetha', 'vinayvishwakarma', 'pavanrochester', 'bhaveshbaranda6', 'kumawat.devendra2', 'mahima333k', 'vineelchandra99', 'bourbon', 'psaisantoshkr99', 'nugaira', 'sayantanroy1801', 'shahadeoshelke', 'ahirsharan', 'prakhar.bafna', 'the_generic', 'jbelcourt', 'bsamseth', 'himanshmittal237', 'umangagr56', 'pranit.dalal', 'simrobson', 'adriang123', 'sgu20121476', 'anandkadu4108', 'skotetho', 'rohitkhinchi1312', 'trobertson1', 'h_k', 'fermi0n', 'sharanmourya', 'pandityhre321', 'rahulnani412', 'snehavinjam123', 'bhargav', 'abhay12345678', 'swapnilshingte504', 'leandrosaraco', 'satishiscool007', 'krishnapriyakantipudi', 'danish_imam', 'chandermohan', 'yash779193', 'adityavarma84', 'pritamsoni.hsr', 'sreejachowdary', 'harshmaheshwari135', 'ssingh29b', 'jahnvi123', 'jcarlin', 'addylocks11598', 'varthyasushanth', 'shashwatjai314', 'aravind03', 'vibhorjain96', 'carlos.acosta.berlin', 'yennamharshavardhan', 'imanmirzaie', 'abhishekjain199820', 'kaunaj06', 'utkarsh9992', 'meghana2507', 'punishment747', 'anikdutta10', 'siddhanthaldar14', 'ahealey1', 'sowjanya', 'sohi', 'ayush3006kr', 'nageshpatle', 'yash_sharma', 'shubham.rajput98', 'singhpunarjeet', 'zoloogg', 'giriprasadmyworld1122', 'sajid.eqbal78', 'sgu20131420', 'tibrewalpratik17', 'astikey', 'jbrizzy', 'saptarshi.hobby2', 'vvsivakumar24', 'das.siddharth07', 'kumar.tarun2772', 'harshbarelia14', 'vyshnaviboddupalli', 'eringrant01', 'sanjeet029', 'tarun3827']"
2,125,188,9,2,"['punishment747', 'bmunkhzorig']",185,"['asheeshgir', 'harshitkhardia', 'jackhon', 'sjeet474', 'jawalikarpari', 'dounan0618', 'rajbhartiprince', 'anjannama0123', 'satyavruthg23', 'jishnu1705', 'spazos7', 'lagadapativinay', 'sainarendra999', 'ambekar.prathmesh', 'bindalrajat0406', 'ppg28072000', 'umangfogla', 'abiseik', 'kumarjitpal98', 'myomyint', 'swagatam.haldar9', 'suryavishal26', 'ompatel13101995', 'pawarpratap555', 'h.farazul', 'vaibhav2010', 'ritu2512', 'rroshanraj32', 'akankshatoley44', 'souravofvibrant', 'arathore98', 'suhboldb', 'abhi.loveyou39', 'harshitgargjpr', 'fdsbnmfds', 'fcnew009', 'deepukumar27398', 'pasupulavijay100', 'shubhamanurag98', 'rayliao', 'nikhil24', 'jby2007', 'ankushbag', 'siddharthagarwal786', 'yhuang404', 'geetha0802', 'patcat94', 'sri2899', 'sudippradhan641', 'goutham16ec', 'dvnshmnz', 'pratyush0824', 'saivinay99', 'pratham', 'praveen_kumar', 'mlieber1995', 'kunal.sanvaniya363', 'kushal', 'satyam007', 'mitchellknight', 'ladekar.vrushali', 'myworld21.96', 'shayam0333', 'tsuryawanshi34', 'aaqibhoda', 'dipak101505', 'soumyashailja', 'jvlahari', 'khalidshaik', '135goodguy', 'ep14btech11003', 'harika', 'saurabh.telavane', 'samanwaysadhu', 'urstrulyuttam', 'ee16btech11031', 'zhang_f', 'rajeshdara', 'divyansh', 'apoorva123', 'rsadhukhan900', 'kanishk.sonkusre', 'puspendu672', 'lambaiitkgp', 'adityasai', 'sas36000', 'meghana977', 'kontham.abhay', 'rishavchakraborty1998', 'ankita132', 'kshivamraj32', 'taufique.1929', 'quantumred3', 'mmkpa2012', 'woodworthkyle', 'fods12', 'gautam7', 'palakharwani', 'gouravfs1996', 'himaswetha', 'vinayvishwakarma', 'pavanrochester', 'bhaveshbaranda6', 'kumawat.devendra2', 'mahima333k', 'vineelchandra99', 'bourbon', 'psaisantoshkr99', 'nugaira', 'sayantanroy1801', 'shahadeoshelke', 'ahirsharan', 'prakhar.bafna', 'the_generic', 'jbelcourt', 'bsamseth', 'himanshmittal237', 'umangagr56', 'pranit.dalal', 'simrobson', 'adriang123', 'sgu20121476', 'anandkadu4108', 'skotetho', 'rohitkhinchi1312', 'trobertson1', 'h_k', 'fermi0n', 'sharanmourya', 'pandityhre321', 'rahulnani412', 'snehavinjam123', 'bhargav', 'abhay12345678', 'swapnilshingte504', 'leandrosaraco', 'satishiscool007', 'krishnapriyakantipudi', 'danish_imam', 'chandermohan', 'yash779193', 'adityavarma84', 'pritamsoni.hsr', 'sreejachowdary', 'harshmaheshwari135', 'ssingh29b', 'jahnvi123', 'jcarlin', 'addylocks11598', 'varthyasushanth', 'shashwatjai314', 'aravind03', 'vibhorjain96', 'carlos.acosta.berlin', 'yennamharshavardhan', 'imanmirzaie', 'abhishekjain199820', 'kaunaj06', 'utkarsh9992', 'meghana2507', 'anikdutta10', 'siddhanthaldar14', 'ahealey1', 'sowjanya', 'sohi', 'ayush3006kr', 'nageshpatle', 'yash_sharma', 'shubham.rajput98', 'singhpunarjeet', 'zoloogg', 'giriprasadmyworld1122', 'sajid.eqbal78', 'sgu20131420', 'tibrewalpratik17', 'astikey', 'jbrizzy', 'saptarshi.hobby2', 'vvsivakumar24', 'das.siddharth07', 'kumar.tarun2772', 'harshbarelia14', 'vyshnaviboddupalli', 'sanjeet029', 'tarun3827']",7,"['fuente', 'oyuka46', 'banzragch', 'djtumenjargal', 'ganzo_0306', 'ulaankhuu72', None]",194,"['asheeshgir', 'djtumenjargal', 'harshitkhardia', 'jackhon', 'sjeet474', 'jawalikarpari', 'dounan0618', 'rajbhartiprince', 'anjannama0123', 'satyavruthg23', 'jishnu1705', 'spazos7', 'lagadapativinay', 'sainarendra999', 'ambekar.prathmesh', 'bindalrajat0406', 'ppg28072000', 'umangfogla', 'abiseik', 'kumarjitpal98', 'fuente', 'myomyint', 'swagatam.haldar9', 'suryavishal26', 'ompatel13101995', 'oyuka46', 'pawarpratap555', 'h.farazul', 'vaibhav2010', 'ritu2512', 'rroshanraj32', 'akankshatoley44', 'souravofvibrant', 'arathore98', 'suhboldb', 'abhi.loveyou39', 'harshitgargjpr', 'fdsbnmfds', 'fcnew009', 'deepukumar27398', 'pasupulavijay100', 'shubhamanurag98', 'rayliao', 'nikhil24', 'ganzo_0306', 'jby2007', 'ankushbag', 'bmunkhzorig', 'siddharthagarwal786', 'yhuang404', 'geetha0802', 'patcat94', 'sri2899', 'sudippradhan641', 'goutham16ec', 'dvnshmnz', 'pratyush0824', 'saivinay99', 'pratham', 'praveen_kumar', 'mlieber1995', 'kunal.sanvaniya363', 'kushal', 'satyam007', 'mitchellknight', 'ladekar.vrushali', 'myworld21.96', 'shayam0333', 'tsuryawanshi34', 'aaqibhoda', 'dipak101505', 'soumyashailja', 'jvlahari', 'khalidshaik', '135goodguy', 'ep14btech11003', 'harika', 'saurabh.telavane', 'samanwaysadhu', 'urstrulyuttam', 'ulaankhuu72', 'ee16btech11031', 'zhang_f', None, 'rajeshdara', 'divyansh', 'apoorva123', 'rsadhukhan900', 'kanishk.sonkusre', 'puspendu672', 'lambaiitkgp', 'adityasai', 'sas36000', 'meghana977', 'kontham.abhay', 'rishavchakraborty1998', 'ankita132', 'kshivamraj32', 'taufique.1929', 'quantumred3', 'mmkpa2012', 'woodworthkyle', 'fods12', 'gautam7', 'palakharwani', 'gouravfs1996', 'himaswetha', 'vinayvishwakarma', 'pavanrochester', 'bhaveshbaranda6', 'kumawat.devendra2', 'mahima333k', 'vineelchandra99', 'bourbon', 'psaisantoshkr99', 'nugaira', 'sayantanroy1801', 'shahadeoshelke', 'ahirsharan', 'prakhar.bafna', 'the_generic', 'banzragch', 'jbelcourt', 'bsamseth', 'himanshmittal237', 'umangagr56', 'pranit.dalal', 'simrobson', 'adriang123', 'sgu20121476', 'anandkadu4108', 'skotetho', 'rohitkhinchi1312', 'trobertson1', 'h_k', 'fermi0n', 'sharanmourya', 'pandityhre321', 'rahulnani412', 'snehavinjam123', 'bhargav', 'abhay12345678', 'swapnilshingte504', 'leandrosaraco', 'satishiscool007', 'krishnapriyakantipudi', 'danish_imam', 'chandermohan', 'yash779193', 'adityavarma84', 'pritamsoni.hsr', 'sreejachowdary', 'harshmaheshwari135', 'ssingh29b', 'jahnvi123', 'jcarlin', 'addylocks11598', 'varthyasushanth', 'shashwatjai314', 'aravind03', 'vibhorjain96', 'carlos.acosta.berlin', 'yennamharshavardhan', 'imanmirzaie', 'abhishekjain199820', 'kaunaj06', 'utkarsh9992', 'meghana2507', 'punishment747', 'anikdutta10', 'siddhanthaldar14', 'ahealey1', 'sowjanya', 'sohi', 'ayush3006kr', 'nageshpatle', 'yash_sharma', 'shubham.rajput98', 'singhpunarjeet', 'zoloogg', 'giriprasadmyworld1122', 'sajid.eqbal78', 'sgu20131420', 'tibrewalpratik17', 'astikey', 'jbrizzy', 'saptarshi.hobby2', 'vvsivakumar24', 'das.siddharth07', 'kumar.tarun2772', 'harshbarelia14', 'vyshnaviboddupalli', 'sanjeet029', 'tarun3827']"
2,14,188,8,1,['bmunkhzorig'],186,"['asheeshgir', 'harshitkhardia', 'jackhon', 'sjeet474', 'jawalikarpari', 'dounan0618', 'rajbhartiprince', 'anjannama0123', 'satyavruthg23', 'jishnu1705', 'spazos7', 'lagadapativinay', 'sainarendra999', 'ambekar.prathmesh', 'bindalrajat0406', 'ppg28072000', 'umangfogla', 'abiseik', 'kumarjitpal98', 'myomyint', 'swagatam.haldar9', 'suryavishal26', 'ompatel13101995', 'pawarpratap555', 'h.farazul', 'vaibhav2010', 'ritu2512', 'rroshanraj32', 'akankshatoley44', 'souravofvibrant', 'arathore98', 'suhboldb', 'abhi.loveyou39', 'harshitgargjpr', 'fdsbnmfds', 'fcnew009', 'deepukumar27398', 'pasupulavijay100', 'shubhamanurag98', 'rayliao', 'nikhil24', 'jby2007', 'ankushbag', 'siddharthagarwal786', 'yhuang404', 'geetha0802', 'patcat94', 'sri2899', 'sudippradhan641', 'goutham16ec', 'dvnshmnz', 'pratyush0824', 'saivinay99', 'pratham', 'praveen_kumar', 'mlieber1995', 'kunal.sanvaniya363', 'kushal', 'satyam007', 'mitchellknight', 'ladekar.vrushali', 'myworld21.96', 'shayam0333', 'tsuryawanshi34', 'aaqibhoda', 'dipak101505', 'soumyashailja', 'jvlahari', 'khalidshaik', '135goodguy', 'ep14btech11003', 'harika', 'saurabh.telavane', 'samanwaysadhu', 'urstrulyuttam', 'ee16btech11031', 'zhang_f', 'rajeshdara', 'divyansh', 'apoorva123', 'rsadhukhan900', 'kanishk.sonkusre', 'puspendu672', 'lambaiitkgp', 'adityasai', 'sas36000', 'meghana977', 'kontham.abhay', 'rishavchakraborty1998', 'ankita132', 'kshivamraj32', 'taufique.1929', 'quantumred3', 'mmkpa2012', 'woodworthkyle', 'fods12', 'gautam7', 'palakharwani', 'gouravfs1996', 'himaswetha', 'vinayvishwakarma', 'pavanrochester', 'bhaveshbaranda6', 'kumawat.devendra2', 'mahima333k', 'vineelchandra99', 'bourbon', 'psaisantoshkr99', 'nugaira', 'sayantanroy1801', 'shahadeoshelke', 'ahirsharan', 'prakhar.bafna', 'the_generic', 'jbelcourt', 'bsamseth', 'himanshmittal237', 'umangagr56', 'pranit.dalal', 'simrobson', 'adriang123', 'sgu20121476', 'anandkadu4108', 'skotetho', 'rohitkhinchi1312', 'trobertson1', 'h_k', 'fermi0n', 'sharanmourya', 'pandityhre321', 'rahulnani412', 'snehavinjam123', 'bhargav', 'abhay12345678', 'swapnilshingte504', 'leandrosaraco', 'satishiscool007', 'krishnapriyakantipudi', 'danish_imam', 'chandermohan', 'yash779193', 'adityavarma84', 'pritamsoni.hsr', 'sreejachowdary', 'harshmaheshwari135', 'ssingh29b', 'jahnvi123', 'jcarlin', 'addylocks11598', 'varthyasushanth', 'shashwatjai314', 'aravind03', 'vibhorjain96', 'carlos.acosta.berlin', 'yennamharshavardhan', 'imanmirzaie', 'abhishekjain199820', 'kaunaj06', 'utkarsh9992', 'meghana2507', 'punishment747', 'anikdutta10', 'siddhanthaldar14', 'ahealey1', 'sowjanya', 'sohi', 'ayush3006kr', 'nageshpatle', 'yash_sharma', 'shubham.rajput98', 'singhpunarjeet', 'zoloogg', 'giriprasadmyworld1122', 'sajid.eqbal78', 'sgu20131420', 'tibrewalpratik17', 'astikey', 'jbrizzy', 'saptarshi.hobby2', 'vvsivakumar24', 'das.siddharth07', 'kumar.tarun2772', 'harshbarelia14', 'vyshnaviboddupalli', 'sanjeet029', 'tarun3827']",7,"[None, 'seiko_anarjin', 'baagii_homie', 'djtumenjargal', 'anudari', 'choijamts.choijoo', 'gunsnroses.0219']",194,"['asheeshgir', 'djtumenjargal', 'harshitkhardia', 'jackhon', 'sjeet474', 'jawalikarpari', 'dounan0618', 'rajbhartiprince', 'anjannama0123', 'satyavruthg23', 'jishnu1705', 'spazos7', 'lagadapativinay', 'sainarendra999', 'ambekar.prathmesh', 'bindalrajat0406', 'ppg28072000', 'umangfogla', 'abiseik', 'kumarjitpal98', 'myomyint', 'swagatam.haldar9', 'suryavishal26', 'ompatel13101995', 'pawarpratap555', 'h.farazul', 'vaibhav2010', 'ritu2512', 'rroshanraj32', 'akankshatoley44', 'souravofvibrant', 'arathore98', 'suhboldb', 'abhi.loveyou39', 'harshitgargjpr', 'fdsbnmfds', 'fcnew009', 'deepukumar27398', 'pasupulavijay100', 'shubhamanurag98', 'rayliao', 'nikhil24', 'jby2007', 'ankushbag', 'bmunkhzorig', 'siddharthagarwal786', 'yhuang404', 'geetha0802', 'patcat94', 'sri2899', 'sudippradhan641', 'goutham16ec', 'dvnshmnz', 'pratyush0824', 'saivinay99', 'pratham', 'praveen_kumar', 'mlieber1995', 'kunal.sanvaniya363', 'kushal', 'satyam007', 'mitchellknight', 'ladekar.vrushali', 'myworld21.96', 'shayam0333', 'seiko_anarjin', 'tsuryawanshi34', 'aaqibhoda', 'dipak101505', 'soumyashailja', 'jvlahari', 'khalidshaik', '135goodguy', 'ep14btech11003', 'harika', 'saurabh.telavane', 'samanwaysadhu', 'urstrulyuttam', 'ee16btech11031', 'zhang_f', None, 'rajeshdara', 'divyansh', 'apoorva123', 'rsadhukhan900', 'kanishk.sonkusre', 'puspendu672', 'lambaiitkgp', 'adityasai', 'sas36000', 'meghana977', 'kontham.abhay', 'rishavchakraborty1998', 'ankita132', 'kshivamraj32', 'taufique.1929', 'quantumred3', 'mmkpa2012', 'woodworthkyle', 'fods12', 'gautam7', 'palakharwani', 'gouravfs1996', 'himaswetha', 'vinayvishwakarma', 'pavanrochester', 'bhaveshbaranda6', 'kumawat.devendra2', 'mahima333k', 'vineelchandra99', 'bourbon', 'psaisantoshkr99', 'nugaira', 'sayantanroy1801', 'shahadeoshelke', 'ahirsharan', 'prakhar.bafna', 'the_generic', 'jbelcourt', 'bsamseth', 'himanshmittal237', 'umangagr56', 'pranit.dalal', 'simrobson', 'adriang123', 'sgu20121476', 'anandkadu4108', 'anudari', 'skotetho', 'rohitkhinchi1312', 'trobertson1', 'h_k', 'fermi0n', 'choijamts.choijoo', 'sharanmourya', 'pandityhre321', 'rahulnani412', 'snehavinjam123', 'bhargav', 'abhay12345678', 'swapnilshingte504', 'leandrosaraco', 'satishiscool007', 'krishnapriyakantipudi', 'danish_imam', 'chandermohan', 'yash779193', 'adityavarma84', 'pritamsoni.hsr', 'sreejachowdary', 'harshmaheshwari135', 'ssingh29b', 'jahnvi123', 'jcarlin', 'addylocks11598', 'varthyasushanth', 'shashwatjai314', 'aravind03', 'vibhorjain96', 'carlos.acosta.berlin', 'yennamharshavardhan', 'imanmirzaie', 'abhishekjain199820', 'kaunaj06', 'utkarsh9992', 'meghana2507', 'punishment747', 'baagii_homie', 'anikdutta10', 'siddhanthaldar14', 'ahealey1', 'sowjanya', 'gunsnroses.0219', 'sohi', 'ayush3006kr', 'nageshpatle', 'yash_sharma', 'shubham.rajput98', 'singhpunarjeet', 'zoloogg', 'giriprasadmyworld1122', 'sajid.eqbal78', 'sgu20131420', 'tibrewalpratik17', 'astikey', 'jbrizzy', 'saptarshi.hobby2', 'vvsivakumar24', 'das.siddharth07', 'kumar.tarun2772', 'harshbarelia14', 'vyshnaviboddupalli', 'sanjeet029', 'tarun3827']"
2,21,188,8,4,"['saivinay99', 'harika', 'adityavarma84', 'urstrulyuttam']",183,"['asheeshgir', 'harshitkhardia', 'jackhon', 'sjeet474', 'jawalikarpari', 'dounan0618', 'rajbhartiprince', 'anjannama0123', 'satyavruthg23', 'jishnu1705', 'spazos7', 'lagadapativinay', 'sainarendra999', 'ambekar.prathmesh', 'bindalrajat0406', 'ppg28072000', 'umangfogla', 'abiseik', 'kumarjitpal98', 'myomyint', 'swagatam.haldar9', 'suryavishal26', 'ompatel13101995', 'pawarpratap555', 'h.farazul', 'vaibhav2010', 'ritu2512', 'rroshanraj32', 'akankshatoley44', 'souravofvibrant', 'arathore98', 'suhboldb', 'abhi.loveyou39', 'harshitgargjpr', 'fdsbnmfds', 'fcnew009', 'deepukumar27398', 'pasupulavijay100', 'shubhamanurag98', 'rayliao', 'nikhil24', 'jby2007', 'ankushbag', 'bmunkhzorig', 'siddharthagarwal786', 'yhuang404', 'geetha0802', 'patcat94', 'sri2899', 'sudippradhan641', 'goutham16ec', 'dvnshmnz', 'pratyush0824', 'pratham', 'praveen_kumar', 'mlieber1995', 'kunal.sanvaniya363', 'kushal', 'satyam007', 'mitchellknight', 'ladekar.vrushali', 'myworld21.96', 'shayam0333', 'tsuryawanshi34', 'aaqibhoda', 'dipak101505', 'soumyashailja', 'jvlahari', 'khalidshaik', '135goodguy', 'ep14btech11003', 'saurabh.telavane', 'samanwaysadhu', 'ee16btech11031', 'zhang_f', 'rajeshdara', 'divyansh', 'apoorva123', 'rsadhukhan900', 'kanishk.sonkusre', 'puspendu672', 'lambaiitkgp', 'adityasai', 'sas36000', 'meghana977', 'kontham.abhay', 'rishavchakraborty1998', 'ankita132', 'kshivamraj32', 'taufique.1929', 'quantumred3', 'mmkpa2012', 'woodworthkyle', 'fods12', 'gautam7', 'palakharwani', 'gouravfs1996', 'himaswetha', 'vinayvishwakarma', 'pavanrochester', 'bhaveshbaranda6', 'kumawat.devendra2', 'mahima333k', 'vineelchandra99', 'bourbon', 'psaisantoshkr99', 'nugaira', 'sayantanroy1801', 'shahadeoshelke', 'ahirsharan', 'prakhar.bafna', 'the_generic', 'jbelcourt', 'bsamseth', 'himanshmittal237', 'umangagr56', 'pranit.dalal', 'simrobson', 'adriang123', 'sgu20121476', 'anandkadu4108', 'skotetho', 'rohitkhinchi1312', 'trobertson1', 'h_k', 'fermi0n', 'sharanmourya', 'pandityhre321', 'rahulnani412', 'snehavinjam123', 'bhargav', 'abhay12345678', 'swapnilshingte504', 'leandrosaraco', 'satishiscool007', 'krishnapriyakantipudi', 'danish_imam', 'chandermohan', 'yash779193', 'pritamsoni.hsr', 'sreejachowdary', 'harshmaheshwari135', 'ssingh29b', 'jahnvi123', 'jcarlin', 'addylocks11598', 'varthyasushanth', 'shashwatjai314', 'aravind03', 'vibhorjain96', 'carlos.acosta.berlin', 'yennamharshavardhan', 'imanmirzaie', 'abhishekjain199820', 'kaunaj06', 'utkarsh9992', 'meghana2507', 'punishment747', 'anikdutta10', 'siddhanthaldar14', 'ahealey1', 'sowjanya', 'sohi', 'ayush3006kr', 'nageshpatle', 'yash_sharma', 'shubham.rajput98', 'singhpunarjeet', 'zoloogg', 'giriprasadmyworld1122', 'sajid.eqbal78', 'sgu20131420', 'tibrewalpratik17', 'astikey', 'jbrizzy', 'saptarshi.hobby2', 'vvsivakumar24', 'das.siddharth07', 'kumar.tarun2772', 'harshbarelia14', 'vyshnaviboddupalli', 'sanjeet029', 'tarun3827']",4,"['mriganksh', 'punyak', None, 'varunpd']",191,"['asheeshgir', 'harshitkhardia', 'jackhon', 'sjeet474', 'jawalikarpari', 'dounan0618', 'rajbhartiprince', 'anjannama0123', 'satyavruthg23', 'jishnu1705', 'spazos7', 'lagadapativinay', 'sainarendra999', 'ambekar.prathmesh', 'bindalrajat0406', 'ppg28072000', 'umangfogla', 'abiseik', 'kumarjitpal98', 'myomyint', 'swagatam.haldar9', 'suryavishal26', 'ompatel13101995', 'pawarpratap555', 'h.farazul', 'vaibhav2010', 'ritu2512', 'rroshanraj32', 'akankshatoley44', 'souravofvibrant', 'arathore98', 'suhboldb', 'abhi.loveyou39', 'harshitgargjpr', 'fdsbnmfds', 'fcnew009', 'deepukumar27398', 'pasupulavijay100', 'shubhamanurag98', 'rayliao', 'nikhil24', 'jby2007', 'ankushbag', 'bmunkhzorig', 'siddharthagarwal786', 'yhuang404', 'geetha0802', 'patcat94', 'sri2899', 'sudippradhan641', 'goutham16ec', 'dvnshmnz', 'pratyush0824', 'saivinay99', 'pratham', 'praveen_kumar', 'mlieber1995', 'kunal.sanvaniya363', 'kushal', 'satyam007', 'mitchellknight', 'ladekar.vrushali', 'myworld21.96', 'shayam0333', 'tsuryawanshi34', 'aaqibhoda', 'dipak101505', 'soumyashailja', 'jvlahari', 'khalidshaik', '135goodguy', 'ep14btech11003', 'harika', 'saurabh.telavane', 'samanwaysadhu', 'urstrulyuttam', 'ee16btech11031', 'zhang_f', None, 'rajeshdara', 'divyansh', 'apoorva123', 'rsadhukhan900', 'kanishk.sonkusre', 'puspendu672', 'lambaiitkgp', 'adityasai', 'sas36000', 'meghana977', 'kontham.abhay', 'rishavchakraborty1998', 'ankita132', 'kshivamraj32', 'taufique.1929', 'quantumred3', 'mmkpa2012', 'woodworthkyle', 'fods12', 'gautam7', 'palakharwani', 'gouravfs1996', 'himaswetha', 'vinayvishwakarma', 'pavanrochester', 'bhaveshbaranda6', 'kumawat.devendra2', 'mahima333k', 'vineelchandra99', 'bourbon', 'psaisantoshkr99', 'nugaira', 'sayantanroy1801', 'shahadeoshelke', 'ahirsharan', 'prakhar.bafna', 'the_generic', 'jbelcourt', 'bsamseth', 'himanshmittal237', 'umangagr56', 'pranit.dalal', 'simrobson', 'adriang123', 'sgu20121476', 'anandkadu4108', 'skotetho', 'rohitkhinchi1312', 'trobertson1', 'h_k', 'fermi0n', 'sharanmourya', 'pandityhre321', 'rahulnani412', 'snehavinjam123', 'bhargav', 'abhay12345678', 'swapnilshingte504', 'leandrosaraco', 'satishiscool007', 'krishnapriyakantipudi', 'danish_imam', 'chandermohan', 'yash779193', 'adityavarma84', 'pritamsoni.hsr', 'sreejachowdary', 'harshmaheshwari135', 'ssingh29b', 'jahnvi123', 'jcarlin', 'addylocks11598', 'varthyasushanth', 'shashwatjai314', 'aravind03', 'punyak', 'vibhorjain96', 'carlos.acosta.berlin', 'yennamharshavardhan', 'imanmirzaie', 'abhishekjain199820', 'kaunaj06', 'utkarsh9992', 'varunpd', 'meghana2507', 'punishment747', 'anikdutta10', 'siddhanthaldar14', 'ahealey1', 'sowjanya', 'sohi', 'ayush3006kr', 'nageshpatle', 'yash_sharma', 'shubham.rajput98', 'singhpunarjeet', 'zoloogg', 'giriprasadmyworld1122', 'sajid.eqbal78', 'mriganksh', 'sgu20131420', 'tibrewalpratik17', 'astikey', 'jbrizzy', 'saptarshi.hobby2', 'vvsivakumar24', 'das.siddharth07', 'kumar.tarun2772', 'harshbarelia14', 'vyshnaviboddupalli', 'sanjeet029', 'tarun3827']"
2,307,188,8,1,['sgu20131420'],186,"['asheeshgir', 'harshitkhardia', 'jackhon', 'sjeet474', 'jawalikarpari', 'dounan0618', 'rajbhartiprince', 'anjannama0123', 'satyavruthg23', 'jishnu1705', 'spazos7', 'lagadapativinay', 'sainarendra999', 'ambekar.prathmesh', 'bindalrajat0406', 'ppg28072000', 'umangfogla', 'abiseik', 'kumarjitpal98', 'myomyint', 'swagatam.haldar9', 'suryavishal26', 'ompatel13101995', 'pawarpratap555', 'h.farazul', 'vaibhav2010', 'ritu2512', 'rroshanraj32', 'akankshatoley44', 'souravofvibrant', 'arathore98', 'suhboldb', 'abhi.loveyou39', 'harshitgargjpr', 'fdsbnmfds', 'fcnew009', 'deepukumar27398', 'pasupulavijay100', 'shubhamanurag98', 'rayliao', 'nikhil24', 'jby2007', 'ankushbag', 'bmunkhzorig', 'siddharthagarwal786', 'yhuang404', 'geetha0802', 'patcat94', 'sri2899', 'sudippradhan641', 'goutham16ec', 'dvnshmnz', 'pratyush0824', 'saivinay99', 'pratham', 'praveen_kumar', 'mlieber1995', 'kunal.sanvaniya363', 'kushal', 'satyam007', 'mitchellknight', 'ladekar.vrushali', 'myworld21.96', 'shayam0333', 'tsuryawanshi34', 'aaqibhoda', 'dipak101505', 'soumyashailja', 'jvlahari', 'khalidshaik', '135goodguy', 'ep14btech11003', 'harika', 'saurabh.telavane', 'samanwaysadhu', 'urstrulyuttam', 'ee16btech11031', 'zhang_f', 'rajeshdara', 'divyansh', 'apoorva123', 'rsadhukhan900', 'kanishk.sonkusre', 'puspendu672', 'lambaiitkgp', 'adityasai', 'sas36000', 'meghana977', 'kontham.abhay', 'rishavchakraborty1998', 'ankita132', 'kshivamraj32', 'taufique.1929', 'quantumred3', 'mmkpa2012', 'woodworthkyle', 'fods12', 'gautam7', 'palakharwani', 'gouravfs1996', 'himaswetha', 'vinayvishwakarma', 'pavanrochester', 'bhaveshbaranda6', 'kumawat.devendra2', 'mahima333k', 'vineelchandra99', 'bourbon', 'psaisantoshkr99', 'nugaira', 'sayantanroy1801', 'shahadeoshelke', 'ahirsharan', 'prakhar.bafna', 'the_generic', 'jbelcourt', 'bsamseth', 'himanshmittal237', 'umangagr56', 'pranit.dalal', 'simrobson', 'adriang123', 'sgu20121476', 'anandkadu4108', 'skotetho', 'rohitkhinchi1312', 'trobertson1', 'h_k', 'fermi0n', 'sharanmourya', 'pandityhre321', 'rahulnani412', 'snehavinjam123', 'bhargav', 'abhay12345678', 'swapnilshingte504', 'leandrosaraco', 'satishiscool007', 'krishnapriyakantipudi', 'danish_imam', 'chandermohan', 'yash779193', 'adityavarma84', 'pritamsoni.hsr', 'sreejachowdary', 'harshmaheshwari135', 'ssingh29b', 'jahnvi123', 'jcarlin', 'addylocks11598', 'varthyasushanth', 'shashwatjai314', 'aravind03', 'vibhorjain96', 'carlos.acosta.berlin', 'yennamharshavardhan', 'imanmirzaie', 'abhishekjain199820', 'kaunaj06', 'utkarsh9992', 'meghana2507', 'punishment747', 'anikdutta10', 'siddhanthaldar14', 'ahealey1', 'sowjanya', 'sohi', 'ayush3006kr', 'nageshpatle', 'yash_sharma', 'shubham.rajput98', 'singhpunarjeet', 'zoloogg', 'giriprasadmyworld1122', 'sajid.eqbal78', 'tibrewalpratik17', 'astikey', 'jbrizzy', 'saptarshi.hobby2', 'vvsivakumar24', 'das.siddharth07', 'kumar.tarun2772', 'harshbarelia14', 'vyshnaviboddupalli', 'sanjeet029', 'tarun3827']",7,"['sgu20121500', 'sgu20121446', None, 'sgu20121466', 'sgu20121480', 'sgu20131419', 'sgu20131421']",194,"['sgu20121500', 'asheeshgir', 'harshitkhardia', 'jackhon', 'sjeet474', 'jawalikarpari', 'dounan0618', 'rajbhartiprince', 'anjannama0123', 'satyavruthg23', 'jishnu1705', 'spazos7', 'lagadapativinay', 'sainarendra999', 'ambekar.prathmesh', 'bindalrajat0406', 'ppg28072000', 'umangfogla', 'abiseik', 'kumarjitpal98', 'myomyint', 'swagatam.haldar9', 'suryavishal26', 'ompatel13101995', 'pawarpratap555', 'h.farazul', 'vaibhav2010', 'ritu2512', 'rroshanraj32', 'akankshatoley44', 'souravofvibrant', 'arathore98', 'sgu20131421', 'suhboldb', 'abhi.loveyou39', 'harshitgargjpr', 'fdsbnmfds', 'fcnew009', 'deepukumar27398', 'sgu20121466', 'pasupulavijay100', 'shubhamanurag98', 'rayliao', 'nikhil24', 'jby2007', 'ankushbag', 'bmunkhzorig', 'siddharthagarwal786', 'yhuang404', 'geetha0802', 'patcat94', 'sri2899', 'sudippradhan641', 'goutham16ec', 'dvnshmnz', 'pratyush0824', 'saivinay99', 'pratham', 'praveen_kumar', 'mlieber1995', 'kunal.sanvaniya363', 'kushal', 'satyam007', 'mitchellknight', 'ladekar.vrushali', 'myworld21.96', 'shayam0333', 'tsuryawanshi34', 'aaqibhoda', 'dipak101505', 'soumyashailja', 'jvlahari', 'khalidshaik', '135goodguy', 'ep14btech11003', 'harika', 'saurabh.telavane', 'samanwaysadhu', 'urstrulyuttam', 'ee16btech11031', 'zhang_f', None, 'rajeshdara', 'divyansh', 'apoorva123', 'rsadhukhan900', 'kanishk.sonkusre', 'puspendu672', 'lambaiitkgp', 'adityasai', 'sas36000', 'meghana977', 'kontham.abhay', 'sgu20131419', 'rishavchakraborty1998', 'ankita132', 'kshivamraj32', 'taufique.1929', 'quantumred3', 'mmkpa2012', 'woodworthkyle', 'fods12', 'gautam7', 'palakharwani', 'gouravfs1996', 'himaswetha', 'vinayvishwakarma', 'pavanrochester', 'bhaveshbaranda6', 'kumawat.devendra2', 'mahima333k', 'sgu20121480', 'vineelchandra99', 'bourbon', 'psaisantoshkr99', 'nugaira', 'sayantanroy1801', 'shahadeoshelke', 'ahirsharan', 'prakhar.bafna', 'the_generic', 'jbelcourt', 'bsamseth', 'himanshmittal237', 'umangagr56', 'pranit.dalal', 'simrobson', 'adriang123', 'sgu20121476', 'anandkadu4108', 'skotetho', 'rohitkhinchi1312', 'trobertson1', 'h_k', 'fermi0n', 'sharanmourya', 'pandityhre321', 'rahulnani412', 'snehavinjam123', 'bhargav', 'abhay12345678', 'swapnilshingte504', 'leandrosaraco', 'satishiscool007', 'krishnapriyakantipudi', 'danish_imam', 'chandermohan', 'yash779193', 'adityavarma84', 'pritamsoni.hsr', 'sreejachowdary', 'harshmaheshwari135', 'ssingh29b', 'jahnvi123', 'jcarlin', 'addylocks11598', 'varthyasushanth', 'shashwatjai314', 'aravind03', 'vibhorjain96', 'carlos.acosta.berlin', 'yennamharshavardhan', 'imanmirzaie', 'abhishekjain199820', 'kaunaj06', 'utkarsh9992', 'meghana2507', 'punishment747', 'anikdutta10', 'siddhanthaldar14', 'ahealey1', 'sowjanya', 'sohi', 'ayush3006kr', 'nageshpatle', 'yash_sharma', 'shubham.rajput98', 'singhpunarjeet', 'zoloogg', 'giriprasadmyworld1122', 'sajid.eqbal78', 'sgu20131420', 'tibrewalpratik17', 'astikey', 'jbrizzy', 'sgu20121446', 'saptarshi.hobby2', 'vvsivakumar24', 'das.siddharth07', 'kumar.tarun2772', 'harshbarelia14', 'vyshnaviboddupalli', 'sanjeet029', 'tarun3827']"
2,4,188,7,5,"['myworld21.96', 'kumawat.devendra2', 'saurabh.telavane', 'pratham', 'akankshatoley44']",182,"['asheeshgir', 'harshitkhardia', 'jackhon', 'sjeet474', 'jawalikarpari', 'dounan0618', 'rajbhartiprince', 'anjannama0123', 'satyavruthg23', 'jishnu1705', 'spazos7', 'lagadapativinay', 'sainarendra999', 'ambekar.prathmesh', 'bindalrajat0406', 'ppg28072000', 'umangfogla', 'abiseik', 'kumarjitpal98', 'myomyint', 'swagatam.haldar9', 'suryavishal26', 'ompatel13101995', 'pawarpratap555', 'h.farazul', 'vaibhav2010', 'ritu2512', 'rroshanraj32', 'souravofvibrant', 'arathore98', 'suhboldb', 'abhi.loveyou39', 'harshitgargjpr', 'fdsbnmfds', 'fcnew009', 'deepukumar27398', 'pasupulavijay100', 'shubhamanurag98', 'rayliao', 'nikhil24', 'jby2007', 'ankushbag', 'bmunkhzorig', 'siddharthagarwal786', 'yhuang404', 'geetha0802', 'patcat94', 'sri2899', 'sudippradhan641', 'goutham16ec', 'dvnshmnz', 'pratyush0824', 'saivinay99', 'praveen_kumar', 'mlieber1995', 'kunal.sanvaniya363', 'kushal', 'satyam007', 'mitchellknight', 'ladekar.vrushali', 'shayam0333', 'tsuryawanshi34', 'aaqibhoda', 'dipak101505', 'soumyashailja', 'jvlahari', 'khalidshaik', '135goodguy', 'ep14btech11003', 'harika', 'samanwaysadhu', 'urstrulyuttam', 'ee16btech11031', 'zhang_f', 'rajeshdara', 'divyansh', 'apoorva123', 'rsadhukhan900', 'kanishk.sonkusre', 'puspendu672', 'lambaiitkgp', 'adityasai', 'sas36000', 'meghana977', 'kontham.abhay', 'rishavchakraborty1998', 'ankita132', 'kshivamraj32', 'taufique.1929', 'quantumred3', 'mmkpa2012', 'woodworthkyle', 'fods12', 'gautam7', 'palakharwani', 'gouravfs1996', 'himaswetha', 'vinayvishwakarma', 'pavanrochester', 'bhaveshbaranda6', 'mahima333k', 'vineelchandra99', 'bourbon', 'psaisantoshkr99', 'nugaira', 'sayantanroy1801', 'shahadeoshelke', 'ahirsharan', 'prakhar.bafna', 'the_generic', 'jbelcourt', 'bsamseth', 'himanshmittal237', 'umangagr56', 'pranit.dalal', 'simrobson', 'adriang123', 'sgu20121476', 'anandkadu4108', 'skotetho', 'rohitkhinchi1312', 'trobertson1', 'h_k', 'fermi0n', 'sharanmourya', 'pandityhre321', 'rahulnani412', 'snehavinjam123', 'bhargav', 'abhay12345678', 'swapnilshingte504', 'leandrosaraco', 'satishiscool007', 'krishnapriyakantipudi', 'danish_imam', 'chandermohan', 'yash779193', 'adityavarma84', 'pritamsoni.hsr', 'sreejachowdary', 'harshmaheshwari135', 'ssingh29b', 'jahnvi123', 'jcarlin', 'addylocks11598', 'varthyasushanth', 'shashwatjai314', 'aravind03', 'vibhorjain96', 'carlos.acosta.berlin', 'yennamharshavardhan', 'imanmirzaie', 'abhishekjain199820', 'kaunaj06', 'utkarsh9992', 'meghana2507', 'punishment747', 'anikdutta10', 'siddhanthaldar14', 'ahealey1', 'sowjanya', 'sohi', 'ayush3006kr', 'nageshpatle', 'yash_sharma', 'shubham.rajput98', 'singhpunarjeet', 'zoloogg', 'giriprasadmyworld1122', 'sajid.eqbal78', 'sgu20131420', 'tibrewalpratik17', 'astikey', 'jbrizzy', 'saptarshi.hobby2', 'vvsivakumar24', 'das.siddharth07', 'kumar.tarun2772', 'harshbarelia14', 'vyshnaviboddupalli', 'sanjeet029', 'tarun3827']",2,"['dhanesh2197', None]",189,"['asheeshgir', 'harshitkhardia', 'jackhon', 'sjeet474', 'jawalikarpari', 'dounan0618', 'rajbhartiprince', 'anjannama0123', 'satyavruthg23', 'jishnu1705', 'spazos7', 'lagadapativinay', 'sainarendra999', 'ambekar.prathmesh', 'bindalrajat0406', 'ppg28072000', 'umangfogla', 'abiseik', 'kumarjitpal98', 'myomyint', 'swagatam.haldar9', 'suryavishal26', 'ompatel13101995', 'pawarpratap555', 'h.farazul', 'vaibhav2010', 'ritu2512', 'rroshanraj32', 'akankshatoley44', 'souravofvibrant', 'arathore98', 'suhboldb', 'abhi.loveyou39', 'harshitgargjpr', 'fdsbnmfds', 'fcnew009', 'deepukumar27398', 'pasupulavijay100', 'shubhamanurag98', 'rayliao', 'nikhil24', 'jby2007', 'ankushbag', 'bmunkhzorig', 'siddharthagarwal786', 'yhuang404', 'geetha0802', 'patcat94', 'sri2899', 'sudippradhan641', 'goutham16ec', 'dvnshmnz', 'pratyush0824', 'saivinay99', 'pratham', 'praveen_kumar', 'mlieber1995', 'kunal.sanvaniya363', 'kushal', 'satyam007', 'mitchellknight', 'ladekar.vrushali', 'myworld21.96', 'shayam0333', 'tsuryawanshi34', 'aaqibhoda', 'dipak101505', 'soumyashailja', 'jvlahari', 'khalidshaik', '135goodguy', 'ep14btech11003', 'harika', 'saurabh.telavane', 'samanwaysadhu', 'urstrulyuttam', 'ee16btech11031', 'zhang_f', None, 'rajeshdara', 'divyansh', 'apoorva123', 'rsadhukhan900', 'kanishk.sonkusre', 'puspendu672', 'lambaiitkgp', 'adityasai', 'sas36000', 'meghana977', 'kontham.abhay', 'rishavchakraborty1998', 'ankita132', 'kshivamraj32', 'taufique.1929', 'quantumred3', 'mmkpa2012', 'woodworthkyle', 'fods12', 'gautam7', 'palakharwani', 'gouravfs1996', 'himaswetha', 'vinayvishwakarma', 'pavanrochester', 'bhaveshbaranda6', 'kumawat.devendra2', 'mahima333k', 'vineelchandra99', 'bourbon', 'psaisantoshkr99', 'nugaira', 'sayantanroy1801', 'shahadeoshelke', 'ahirsharan', 'prakhar.bafna', 'the_generic', 'jbelcourt', 'bsamseth', 'himanshmittal237', 'umangagr56', 'pranit.dalal', 'simrobson', 'adriang123', 'sgu20121476', 'anandkadu4108', 'skotetho', 'rohitkhinchi1312', 'trobertson1', 'h_k', 'fermi0n', 'sharanmourya', 'pandityhre321', 'rahulnani412', 'snehavinjam123', 'bhargav', 'abhay12345678', 'swapnilshingte504', 'leandrosaraco', 'satishiscool007', 'krishnapriyakantipudi', 'danish_imam', 'chandermohan', 'yash779193', 'adityavarma84', 'pritamsoni.hsr', 'sreejachowdary', 'harshmaheshwari135', 'ssingh29b', 'jahnvi123', 'jcarlin', 'addylocks11598', 'varthyasushanth', 'shashwatjai314', 'aravind03', 'vibhorjain96', 'carlos.acosta.berlin', 'yennamharshavardhan', 'imanmirzaie', 'abhishekjain199820', 'kaunaj06', 'utkarsh9992', 'meghana2507', 'punishment747', 'anikdutta10', 'siddhanthaldar14', 'ahealey1', 'sowjanya', 'sohi', 'ayush3006kr', 'nageshpatle', 'yash_sharma', 'shubham.rajput98', 'singhpunarjeet', 'dhanesh2197', 'zoloogg', 'giriprasadmyworld1122', 'sajid.eqbal78', 'sgu20131420', 'tibrewalpratik17', 'astikey', 'jbrizzy', 'saptarshi.hobby2', 'vvsivakumar24', 'das.siddharth07', 'kumar.tarun2772', 'harshbarelia14', 'vyshnaviboddupalli', 'sanjeet029', 'tarun3827']"
2,17,188,7,1,['bmunkhzorig'],186,"['asheeshgir', 'harshitkhardia', 'jackhon', 'sjeet474', 'jawalikarpari', 'dounan0618', 'rajbhartiprince', 'anjannama0123', 'satyavruthg23', 'jishnu1705', 'spazos7', 'lagadapativinay', 'sainarendra999', 'ambekar.prathmesh', 'bindalrajat0406', 'ppg28072000', 'umangfogla', 'abiseik', 'kumarjitpal98', 'myomyint', 'swagatam.haldar9', 'suryavishal26', 'ompatel13101995', 'pawarpratap555', 'h.farazul', 'vaibhav2010', 'ritu2512', 'rroshanraj32', 'akankshatoley44', 'souravofvibrant', 'arathore98', 'suhboldb', 'abhi.loveyou39', 'harshitgargjpr', 'fdsbnmfds', 'fcnew009', 'deepukumar27398', 'pasupulavijay100', 'shubhamanurag98', 'rayliao', 'nikhil24', 'jby2007', 'ankushbag', 'siddharthagarwal786', 'yhuang404', 'geetha0802', 'patcat94', 'sri2899', 'sudippradhan641', 'goutham16ec', 'dvnshmnz', 'pratyush0824', 'saivinay99', 'pratham', 'praveen_kumar', 'mlieber1995', 'kunal.sanvaniya363', 'kushal', 'satyam007', 'mitchellknight', 'ladekar.vrushali', 'myworld21.96', 'shayam0333', 'tsuryawanshi34', 'aaqibhoda', 'dipak101505', 'soumyashailja', 'jvlahari', 'khalidshaik', '135goodguy', 'ep14btech11003', 'harika', 'saurabh.telavane', 'samanwaysadhu', 'urstrulyuttam', 'ee16btech11031', 'zhang_f', 'rajeshdara', 'divyansh', 'apoorva123', 'rsadhukhan900', 'kanishk.sonkusre', 'puspendu672', 'lambaiitkgp', 'adityasai', 'sas36000', 'meghana977', 'kontham.abhay', 'rishavchakraborty1998', 'ankita132', 'kshivamraj32', 'taufique.1929', 'quantumred3', 'mmkpa2012', 'woodworthkyle', 'fods12', 'gautam7', 'palakharwani', 'gouravfs1996', 'himaswetha', 'vinayvishwakarma', 'pavanrochester', 'bhaveshbaranda6', 'kumawat.devendra2', 'mahima333k', 'vineelchandra99', 'bourbon', 'psaisantoshkr99', 'nugaira', 'sayantanroy1801', 'shahadeoshelke', 'ahirsharan', 'prakhar.bafna', 'the_generic', 'jbelcourt', 'bsamseth', 'himanshmittal237', 'umangagr56', 'pranit.dalal', 'simrobson', 'adriang123', 'sgu20121476', 'anandkadu4108', 'skotetho', 'rohitkhinchi1312', 'trobertson1', 'h_k', 'fermi0n', 'sharanmourya', 'pandityhre321', 'rahulnani412', 'snehavinjam123', 'bhargav', 'abhay12345678', 'swapnilshingte504', 'leandrosaraco', 'satishiscool007', 'krishnapriyakantipudi', 'danish_imam', 'chandermohan', 'yash779193', 'adityavarma84', 'pritamsoni.hsr', 'sreejachowdary', 'harshmaheshwari135', 'ssingh29b', 'jahnvi123', 'jcarlin', 'addylocks11598', 'varthyasushanth', 'shashwatjai314', 'aravind03', 'vibhorjain96', 'carlos.acosta.berlin', 'yennamharshavardhan', 'imanmirzaie', 'abhishekjain199820', 'kaunaj06', 'utkarsh9992', 'meghana2507', 'punishment747', 'anikdutta10', 'siddhanthaldar14', 'ahealey1', 'sowjanya', 'sohi', 'ayush3006kr', 'nageshpatle', 'yash_sharma', 'shubham.rajput98', 'singhpunarjeet', 'zoloogg', 'giriprasadmyworld1122', 'sajid.eqbal78', 'sgu20131420', 'tibrewalpratik17', 'astikey', 'jbrizzy', 'saptarshi.hobby2', 'vvsivakumar24', 'das.siddharth07', 'kumar.tarun2772', 'harshbarelia14', 'vyshnaviboddupalli', 'sanjeet029', 'tarun3827']",6,"['banzragch', 'seiko_anarjin', 'gunsnroses.0219', 'djtumenjargal', 'choijamts.choijoo', None]",193,"['asheeshgir', 'djtumenjargal', 'harshitkhardia', 'jackhon', 'sjeet474', 'jawalikarpari', 'dounan0618', 'rajbhartiprince', 'anjannama0123', 'satyavruthg23', 'jishnu1705', 'spazos7', 'lagadapativinay', 'sainarendra999', 'ambekar.prathmesh', 'bindalrajat0406', 'ppg28072000', 'umangfogla', 'abiseik', 'kumarjitpal98', 'myomyint', 'swagatam.haldar9', 'suryavishal26', 'ompatel13101995', 'pawarpratap555', 'h.farazul', 'vaibhav2010', 'ritu2512', 'rroshanraj32', 'akankshatoley44', 'souravofvibrant', 'arathore98', 'suhboldb', 'abhi.loveyou39', 'harshitgargjpr', 'fdsbnmfds', 'fcnew009', 'deepukumar27398', 'pasupulavijay100', 'shubhamanurag98', 'rayliao', 'nikhil24', 'jby2007', 'ankushbag', 'bmunkhzorig', 'siddharthagarwal786', 'yhuang404', 'geetha0802', 'patcat94', 'sri2899', 'sudippradhan641', 'goutham16ec', 'dvnshmnz', 'pratyush0824', 'saivinay99', 'pratham', 'praveen_kumar', 'mlieber1995', 'kunal.sanvaniya363', 'kushal', 'satyam007', 'mitchellknight', 'ladekar.vrushali', 'myworld21.96', 'shayam0333', 'seiko_anarjin', 'tsuryawanshi34', 'aaqibhoda', 'dipak101505', 'soumyashailja', 'jvlahari', 'khalidshaik', '135goodguy', 'ep14btech11003', 'harika', 'saurabh.telavane', 'samanwaysadhu', 'urstrulyuttam', 'ee16btech11031', 'zhang_f', None, 'rajeshdara', 'divyansh', 'apoorva123', 'rsadhukhan900', 'kanishk.sonkusre', 'puspendu672', 'lambaiitkgp', 'adityasai', 'sas36000', 'meghana977', 'kontham.abhay', 'rishavchakraborty1998', 'ankita132', 'kshivamraj32', 'taufique.1929', 'quantumred3', 'mmkpa2012', 'woodworthkyle', 'fods12', 'gautam7', 'palakharwani', 'gouravfs1996', 'himaswetha', 'vinayvishwakarma', 'pavanrochester', 'bhaveshbaranda6', 'kumawat.devendra2', 'mahima333k', 'vineelchandra99', 'bourbon', 'psaisantoshkr99', 'nugaira', 'sayantanroy1801', 'shahadeoshelke', 'ahirsharan', 'prakhar.bafna', 'the_generic', 'banzragch', 'jbelcourt', 'bsamseth', 'himanshmittal237', 'umangagr56', 'pranit.dalal', 'simrobson', 'adriang123', 'sgu20121476', 'anandkadu4108', 'skotetho', 'rohitkhinchi1312', 'trobertson1', 'h_k', 'fermi0n', 'choijamts.choijoo', 'sharanmourya', 'pandityhre321', 'rahulnani412', 'snehavinjam123', 'bhargav', 'abhay12345678', 'swapnilshingte504', 'leandrosaraco', 'satishiscool007', 'krishnapriyakantipudi', 'danish_imam', 'chandermohan', 'yash779193', 'adityavarma84', 'pritamsoni.hsr', 'sreejachowdary', 'harshmaheshwari135', 'ssingh29b', 'jahnvi123', 'jcarlin', 'addylocks11598', 'varthyasushanth', 'shashwatjai314', 'aravind03', 'vibhorjain96', 'carlos.acosta.berlin', 'yennamharshavardhan', 'imanmirzaie', 'abhishekjain199820', 'kaunaj06', 'utkarsh9992', 'meghana2507', 'punishment747', 'anikdutta10', 'siddhanthaldar14', 'ahealey1', 'sowjanya', 'gunsnroses.0219', 'sohi', 'ayush3006kr', 'nageshpatle', 'yash_sharma', 'shubham.rajput98', 'singhpunarjeet', 'zoloogg', 'giriprasadmyworld1122', 'sajid.eqbal78', 'sgu20131420', 'tibrewalpratik17', 'astikey', 'jbrizzy', 'saptarshi.hobby2', 'vvsivakumar24', 'das.siddharth07', 'kumar.tarun2772', 'harshbarelia14', 'vyshnaviboddupalli', 'sanjeet029', 'tarun3827']"
2,398,188,7,1,['kaunaj06'],186,"['asheeshgir', 'harshitkhardia', 'jackhon', 'sjeet474', 'jawalikarpari', 'dounan0618', 'rajbhartiprince', 'anjannama0123', 'satyavruthg23', 'jishnu1705', 'spazos7', 'lagadapativinay', 'sainarendra999', 'ambekar.prathmesh', 'bindalrajat0406', 'ppg28072000', 'umangfogla', 'abiseik', 'kumarjitpal98', 'myomyint', 'swagatam.haldar9', 'suryavishal26', 'ompatel13101995', 'pawarpratap555', 'h.farazul', 'vaibhav2010', 'ritu2512', 'rroshanraj32', 'akankshatoley44', 'souravofvibrant', 'arathore98', 'suhboldb', 'abhi.loveyou39', 'harshitgargjpr', 'fdsbnmfds', 'fcnew009', 'deepukumar27398', 'pasupulavijay100', 'shubhamanurag98', 'rayliao', 'nikhil24', 'jby2007', 'ankushbag', 'bmunkhzorig', 'siddharthagarwal786', 'yhuang404', 'geetha0802', 'patcat94', 'sri2899', 'sudippradhan641', 'goutham16ec', 'dvnshmnz', 'pratyush0824', 'saivinay99', 'pratham', 'praveen_kumar', 'mlieber1995', 'kunal.sanvaniya363', 'kushal', 'satyam007', 'mitchellknight', 'ladekar.vrushali', 'myworld21.96', 'shayam0333', 'tsuryawanshi34', 'aaqibhoda', 'dipak101505', 'soumyashailja', 'jvlahari', 'khalidshaik', '135goodguy', 'ep14btech11003', 'harika', 'saurabh.telavane', 'samanwaysadhu', 'urstrulyuttam', 'ee16btech11031', 'zhang_f', 'rajeshdara', 'divyansh', 'apoorva123', 'rsadhukhan900', 'kanishk.sonkusre', 'puspendu672', 'lambaiitkgp', 'adityasai', 'sas36000', 'meghana977', 'kontham.abhay', 'rishavchakraborty1998', 'ankita132', 'kshivamraj32', 'taufique.1929', 'quantumred3', 'mmkpa2012', 'woodworthkyle', 'fods12', 'gautam7', 'palakharwani', 'gouravfs1996', 'himaswetha', 'vinayvishwakarma', 'pavanrochester', 'bhaveshbaranda6', 'kumawat.devendra2', 'mahima333k', 'vineelchandra99', 'bourbon', 'psaisantoshkr99', 'nugaira', 'sayantanroy1801', 'shahadeoshelke', 'ahirsharan', 'prakhar.bafna', 'the_generic', 'jbelcourt', 'bsamseth', 'himanshmittal237', 'umangagr56', 'pranit.dalal', 'simrobson', 'adriang123', 'sgu20121476', 'anandkadu4108', 'skotetho', 'rohitkhinchi1312', 'trobertson1', 'h_k', 'fermi0n', 'sharanmourya', 'pandityhre321', 'rahulnani412', 'snehavinjam123', 'bhargav', 'abhay12345678', 'swapnilshingte504', 'leandrosaraco', 'satishiscool007', 'krishnapriyakantipudi', 'danish_imam', 'chandermohan', 'yash779193', 'adityavarma84', 'pritamsoni.hsr', 'sreejachowdary', 'harshmaheshwari135', 'ssingh29b', 'jahnvi123', 'jcarlin', 'addylocks11598', 'varthyasushanth', 'shashwatjai314', 'aravind03', 'vibhorjain96', 'carlos.acosta.berlin', 'yennamharshavardhan', 'imanmirzaie', 'abhishekjain199820', 'utkarsh9992', 'meghana2507', 'punishment747', 'anikdutta10', 'siddhanthaldar14', 'ahealey1', 'sowjanya', 'sohi', 'ayush3006kr', 'nageshpatle', 'yash_sharma', 'shubham.rajput98', 'singhpunarjeet', 'zoloogg', 'giriprasadmyworld1122', 'sajid.eqbal78', 'sgu20131420', 'tibrewalpratik17', 'astikey', 'jbrizzy', 'saptarshi.hobby2', 'vvsivakumar24', 'das.siddharth07', 'kumar.tarun2772', 'harshbarelia14', 'vyshnaviboddupalli', 'sanjeet029', 'tarun3827']",6,"['sabarnochowdhury', 'soumajit', 'sovanmb94', 'arindam.ray', None, 'vlsi_12']",193,"['asheeshgir', 'harshitkhardia', 'jackhon', 'sjeet474', 'jawalikarpari', 'dounan0618', 'rajbhartiprince', 'anjannama0123', 'sabarnochowdhury', 'satyavruthg23', 'jishnu1705', 'spazos7', 'lagadapativinay', 'sainarendra999', 'ambekar.prathmesh', 'bindalrajat0406', 'ppg28072000', 'umangfogla', 'abiseik', 'kumarjitpal98', 'vlsi_12', 'myomyint', 'swagatam.haldar9', 'suryavishal26', 'ompatel13101995', 'pawarpratap555', 'h.farazul', 'vaibhav2010', 'ritu2512', 'rroshanraj32', 'akankshatoley44', 'souravofvibrant', 'arathore98', 'suhboldb', 'abhi.loveyou39', 'harshitgargjpr', 'fdsbnmfds', 'fcnew009', 'deepukumar27398', 'pasupulavijay100', 'shubhamanurag98', 'rayliao', 'nikhil24', 'jby2007', 'ankushbag', 'bmunkhzorig', 'siddharthagarwal786', 'yhuang404', 'geetha0802', 'patcat94', 'sri2899', 'sudippradhan641', 'goutham16ec', 'dvnshmnz', 'pratyush0824', 'saivinay99', 'pratham', 'praveen_kumar', 'mlieber1995', 'kunal.sanvaniya363', 'kushal', 'satyam007', 'mitchellknight', 'ladekar.vrushali', 'myworld21.96', 'shayam0333', 'tsuryawanshi34', 'aaqibhoda', 'dipak101505', 'soumyashailja', 'jvlahari', 'khalidshaik', '135goodguy', 'ep14btech11003', 'harika', 'saurabh.telavane', 'samanwaysadhu', 'urstrulyuttam', 'sovanmb94', 'ee16btech11031', 'zhang_f', None, 'rajeshdara', 'divyansh', 'apoorva123', 'rsadhukhan900', 'kanishk.sonkusre', 'puspendu672', 'lambaiitkgp', 'adityasai', 'sas36000', 'meghana977', 'kontham.abhay', 'rishavchakraborty1998', 'ankita132', 'kshivamraj32', 'taufique.1929', 'quantumred3', 'mmkpa2012', 'woodworthkyle', 'fods12', 'gautam7', 'palakharwani', 'gouravfs1996', 'himaswetha', 'vinayvishwakarma', 'pavanrochester', 'bhaveshbaranda6', 'kumawat.devendra2', 'mahima333k', 'vineelchandra99', 'bourbon', 'psaisantoshkr99', 'nugaira', 'sayantanroy1801', 'shahadeoshelke', 'ahirsharan', 'prakhar.bafna', 'the_generic', 'jbelcourt', 'bsamseth', 'himanshmittal237', 'umangagr56', 'pranit.dalal', 'simrobson', 'adriang123', 'sgu20121476', 'anandkadu4108', 'skotetho', 'rohitkhinchi1312', 'trobertson1', 'h_k', 'fermi0n', 'sharanmourya', 'pandityhre321', 'rahulnani412', 'snehavinjam123', 'bhargav', 'abhay12345678', 'swapnilshingte504', 'leandrosaraco', 'satishiscool007', 'krishnapriyakantipudi', 'danish_imam', 'chandermohan', 'yash779193', 'adityavarma84', 'pritamsoni.hsr', 'sreejachowdary', 'harshmaheshwari135', 'ssingh29b', 'jahnvi123', 'jcarlin', 'addylocks11598', 'varthyasushanth', 'shashwatjai314', 'aravind03', 'vibhorjain96', 'carlos.acosta.berlin', 'yennamharshavardhan', 'imanmirzaie', 'soumajit', 'abhishekjain199820', 'kaunaj06', 'utkarsh9992', 'meghana2507', 'punishment747', 'anikdutta10', 'siddhanthaldar14', 'ahealey1', 'sowjanya', 'arindam.ray', 'sohi', 'ayush3006kr', 'nageshpatle', 'yash_sharma', 'shubham.rajput98', 'singhpunarjeet', 'zoloogg', 'giriprasadmyworld1122', 'sajid.eqbal78', 'sgu20131420', 'tibrewalpratik17', 'astikey', 'jbrizzy', 'saptarshi.hobby2', 'vvsivakumar24', 'das.siddharth07', 'kumar.tarun2772', 'harshbarelia14', 'vyshnaviboddupalli', 'sanjeet029', 'tarun3827']"
2,23,188,6,4,"['urstrulyuttam', 'saptarshi.hobby2', 'adityavarma84', 'saivinay99']",183,"['asheeshgir', 'harshitkhardia', 'jackhon', 'sjeet474', 'jawalikarpari', 'dounan0618', 'rajbhartiprince', 'anjannama0123', 'satyavruthg23', 'jishnu1705', 'spazos7', 'lagadapativinay', 'sainarendra999', 'ambekar.prathmesh', 'bindalrajat0406', 'ppg28072000', 'umangfogla', 'abiseik', 'kumarjitpal98', 'myomyint', 'swagatam.haldar9', 'suryavishal26', 'ompatel13101995', 'pawarpratap555', 'h.farazul', 'vaibhav2010', 'ritu2512', 'rroshanraj32', 'akankshatoley44', 'souravofvibrant', 'arathore98', 'suhboldb', 'abhi.loveyou39', 'harshitgargjpr', 'fdsbnmfds', 'fcnew009', 'deepukumar27398', 'pasupulavijay100', 'shubhamanurag98', 'rayliao', 'nikhil24', 'jby2007', 'ankushbag', 'bmunkhzorig', 'siddharthagarwal786', 'yhuang404', 'geetha0802', 'patcat94', 'sri2899', 'sudippradhan641', 'goutham16ec', 'dvnshmnz', 'pratyush0824', 'pratham', 'praveen_kumar', 'mlieber1995', 'kunal.sanvaniya363', 'kushal', 'satyam007', 'mitchellknight', 'ladekar.vrushali', 'myworld21.96', 'shayam0333', 'tsuryawanshi34', 'aaqibhoda', 'dipak101505', 'soumyashailja', 'jvlahari', 'khalidshaik', '135goodguy', 'ep14btech11003', 'harika', 'saurabh.telavane', 'samanwaysadhu', 'ee16btech11031', 'zhang_f', 'rajeshdara', 'divyansh', 'apoorva123', 'rsadhukhan900', 'kanishk.sonkusre', 'puspendu672', 'lambaiitkgp', 'adityasai', 'sas36000', 'meghana977', 'kontham.abhay', 'rishavchakraborty1998', 'ankita132', 'kshivamraj32', 'taufique.1929', 'quantumred3', 'mmkpa2012', 'woodworthkyle', 'fods12', 'gautam7', 'palakharwani', 'gouravfs1996', 'himaswetha', 'vinayvishwakarma', 'pavanrochester', 'bhaveshbaranda6', 'kumawat.devendra2', 'mahima333k', 'vineelchandra99', 'bourbon', 'psaisantoshkr99', 'nugaira', 'sayantanroy1801', 'shahadeoshelke', 'ahirsharan', 'prakhar.bafna', 'the_generic', 'jbelcourt', 'bsamseth', 'himanshmittal237', 'umangagr56', 'pranit.dalal', 'simrobson', 'adriang123', 'sgu20121476', 'anandkadu4108', 'skotetho', 'rohitkhinchi1312', 'trobertson1', 'h_k', 'fermi0n', 'sharanmourya', 'pandityhre321', 'rahulnani412', 'snehavinjam123', 'bhargav', 'abhay12345678', 'swapnilshingte504', 'leandrosaraco', 'satishiscool007', 'krishnapriyakantipudi', 'danish_imam', 'chandermohan', 'yash779193', 'pritamsoni.hsr', 'sreejachowdary', 'harshmaheshwari135', 'ssingh29b', 'jahnvi123', 'jcarlin', 'addylocks11598', 'varthyasushanth', 'shashwatjai314', 'aravind03', 'vibhorjain96', 'carlos.acosta.berlin', 'yennamharshavardhan', 'imanmirzaie', 'abhishekjain199820', 'kaunaj06', 'utkarsh9992', 'meghana2507', 'punishment747', 'anikdutta10', 'siddhanthaldar14', 'ahealey1', 'sowjanya', 'sohi', 'ayush3006kr', 'nageshpatle', 'yash_sharma', 'shubham.rajput98', 'singhpunarjeet', 'zoloogg', 'giriprasadmyworld1122', 'sajid.eqbal78', 'sgu20131420', 'tibrewalpratik17', 'astikey', 'jbrizzy', 'vvsivakumar24', 'das.siddharth07', 'kumar.tarun2772', 'harshbarelia14', 'vyshnaviboddupalli', 'sanjeet029', 'tarun3827']",2,"['mriganksh', None]",189,"['asheeshgir', 'harshitkhardia', 'jackhon', 'sjeet474', 'jawalikarpari', 'dounan0618', 'rajbhartiprince', 'anjannama0123', 'satyavruthg23', 'jishnu1705', 'spazos7', 'lagadapativinay', 'sainarendra999', 'ambekar.prathmesh', 'bindalrajat0406', 'ppg28072000', 'umangfogla', 'abiseik', 'kumarjitpal98', 'myomyint', 'swagatam.haldar9', 'suryavishal26', 'ompatel13101995', 'pawarpratap555', 'h.farazul', 'vaibhav2010', 'ritu2512', 'rroshanraj32', 'akankshatoley44', 'souravofvibrant', 'arathore98', 'suhboldb', 'abhi.loveyou39', 'harshitgargjpr', 'fdsbnmfds', 'fcnew009', 'deepukumar27398', 'pasupulavijay100', 'shubhamanurag98', 'rayliao', 'nikhil24', 'jby2007', 'ankushbag', 'bmunkhzorig', 'siddharthagarwal786', 'yhuang404', 'geetha0802', 'patcat94', 'sri2899', 'sudippradhan641', 'goutham16ec', 'dvnshmnz', 'pratyush0824', 'saivinay99', 'pratham', 'praveen_kumar', 'mlieber1995', 'kunal.sanvaniya363', 'kushal', 'satyam007', 'mitchellknight', 'ladekar.vrushali', 'myworld21.96', 'shayam0333', 'tsuryawanshi34', 'aaqibhoda', 'dipak101505', 'soumyashailja', 'jvlahari', 'khalidshaik', '135goodguy', 'ep14btech11003', 'harika', 'saurabh.telavane', 'samanwaysadhu', 'urstrulyuttam', 'ee16btech11031', 'zhang_f', None, 'rajeshdara', 'divyansh', 'apoorva123', 'rsadhukhan900', 'kanishk.sonkusre', 'puspendu672', 'lambaiitkgp', 'adityasai', 'sas36000', 'meghana977', 'kontham.abhay', 'rishavchakraborty1998', 'ankita132', 'kshivamraj32', 'taufique.1929', 'quantumred3', 'mmkpa2012', 'woodworthkyle', 'fods12', 'gautam7', 'palakharwani', 'gouravfs1996', 'himaswetha', 'vinayvishwakarma', 'pavanrochester', 'bhaveshbaranda6', 'kumawat.devendra2', 'mahima333k', 'vineelchandra99', 'bourbon', 'psaisantoshkr99', 'nugaira', 'sayantanroy1801', 'shahadeoshelke', 'ahirsharan', 'prakhar.bafna', 'the_generic', 'jbelcourt', 'bsamseth', 'himanshmittal237', 'umangagr56', 'pranit.dalal', 'simrobson', 'adriang123', 'sgu20121476', 'anandkadu4108', 'skotetho', 'rohitkhinchi1312', 'trobertson1', 'h_k', 'fermi0n', 'sharanmourya', 'pandityhre321', 'rahulnani412', 'snehavinjam123', 'bhargav', 'abhay12345678', 'swapnilshingte504', 'leandrosaraco', 'satishiscool007', 'krishnapriyakantipudi', 'danish_imam', 'chandermohan', 'yash779193', 'adityavarma84', 'pritamsoni.hsr', 'sreejachowdary', 'harshmaheshwari135', 'ssingh29b', 'jahnvi123', 'jcarlin', 'addylocks11598', 'varthyasushanth', 'shashwatjai314', 'aravind03', 'vibhorjain96', 'carlos.acosta.berlin', 'yennamharshavardhan', 'imanmirzaie', 'abhishekjain199820', 'kaunaj06', 'utkarsh9992', 'meghana2507', 'punishment747', 'anikdutta10', 'siddhanthaldar14', 'ahealey1', 'sowjanya', 'sohi', 'ayush3006kr', 'nageshpatle', 'yash_sharma', 'shubham.rajput98', 'singhpunarjeet', 'zoloogg', 'giriprasadmyworld1122', 'sajid.eqbal78', 'mriganksh', 'sgu20131420', 'tibrewalpratik17', 'astikey', 'jbrizzy', 'saptarshi.hobby2', 'vvsivakumar24', 'das.siddharth07', 'kumar.tarun2772', 'harshbarelia14', 'vyshnaviboddupalli', 'sanjeet029', 'tarun3827']"
3,116,150,54,48,"['jhavey', 'waldropj', 'adhikarp', 'glabianc', 'zhan1263', 'gross53', 'graves34', 'alvare48', 'nckloff', 'mmanago', 'rmcandr', 'nloffred', 'nicktucker', 'aberding', 'behnkea', 'pan118', 'grewe', 'chan161', 'jgradows', 'madman5000', 'khan117', 'aronsonj', 'vtirukon9', 'aemerson', 'white378', 'jeveridg', 'asoordel', 'osborn33', 'yao127', 'neitsert', 'magi2elias', 'hyeon7300', 'fang137', 'kapur2', 'ece202', 'joderkir', 'msadi', 'piersonb', 'cstalcupxixi', 'ahornin', 'le67', 'lixu315612126', 'smit2538', 'pennk', 'wang2506', 'shah213', 'sawyer_sup', 'li1882']",101,"['hussni', 'arquita', 'aroggero', 'lbassett', 'jhemmerl11', 'ahmadubuntu', 'yshin0917', 'mordoches', 'duodinamico', 'liu1579', 'grant.ramage', 'kbg04193', 'vsbharadwaj91', 'khojandi', 'nnnjkl', 'liamarasta', 'turabhaiderkazmi1', 'esindela', 'amadwesh1', 'santine0915', 'simonfrfr', 'giorgiaf', 'gwangoo525', 'lovesaelin', 'asa10', 'trex6303', 'klm0637', 'kearns0', 'amartin2970', 'melhag', 'dmm13', 'trusso45', 'saurav7188', 'kaymi22', 'murphj2', 'khom', 'kfulford', 'xu964', 'bolt5136', 'dsguala', 'veerendra.vakkapatla', 'lasscap', 'lthomae', 'bgpotter', 'chepemontalvof', 'chae0823', 'nkhrush', 'cyeow', 'escalantemariaalejandra', 'naveedahmad0000000', 'gsurojit1', 'cfri', 'kliou', 'alexismagana47', 'vbe1', 'liam_sutton', 'sksqkrgur', 'abjh123', 'neo21top', 'kong36', 'leeseunghyun', 'uditrawat469', 'bseren', 'vchandwa', 'jtschwar', 'jmm24', 'reedra1', 'f.escallonp', 'anilgurjar85', 'leonchangzhy', 'syedshakeeb96', 'stella', 'verma30', 'lmulan', 'aruthe', 'choi381', 'rsaigal1', 'efernandez_97', 'zlesemanksu', 'thewhartonproject', 'shasadullah', 'billlight114', 'apk242', 'thelot44', 'greed', 'lkorean0120', 'yj1206love', 'rajnp', 'mw12heybuddy', 'anusha248', 'berger.143', 'asimo2.718', 'mkshamsi.ee', 'lauradnc15', 'govinda1', 'd.castley253', 'park_munsoo', 'ramnathbhatmech', 'fgalano', 'ml72', 'kmcpeak']",6,"['he300', 'leonar30', 'mneuendo', 'rbajaria', 'wang3617', None]",155,"['jhavey', 'hussni', 'arquita', 'waldropj', 'aroggero', 'lbassett', 'alvare48', 'jhemmerl11', 'ahmadubuntu', 'yshin0917', 'nicktucker', 'mordoches', 'duodinamico', 'liu1579', 'chan161', 'grant.ramage', 'kbg04193', 'vsbharadwaj91', 'asoordel', 'yao127', 'khojandi', 'fang137', 'nnnjkl', 'liamarasta', 'turabhaiderkazmi1', 'kapur2', 'he300', 'esindela', 'mneuendo', 'amadwesh1', 'ahornin', 'lixu315612126', 'santine0915', 'sawyer_sup', 'ece202', 'simonfrfr', 'giorgiaf', 'gwangoo525', 'lovesaelin', 'glabianc', 'asa10', 'trex6303', 'klm0637', 'kearns0', 'graves34', 'amartin2970', 'melhag', 'dmm13', 'trusso45', 'saurav7188', 'kaymi22', 'murphj2', 'khom', 'aberding', 'pan118', 'kfulford', 'xu964', 'khan117', 'jgradows', 'aemerson', 'bolt5136', 'dsguala', 'jeveridg', 'veerendra.vakkapatla', 'lasscap', 'osborn33', 'neitsert', 'lthomae', 'wang3617', None, 'bgpotter', 'chepemontalvof', 'pennk', 'chae0823', 'escalantemariaalejandra', 'nkhrush', 'cyeow', 'naveedahmad0000000', 'gsurojit1', 'cfri', 'kliou', 'alexismagana47', 'zhan1263', 'gross53', 'vbe1', 'liam_sutton', 'sksqkrgur', 'nckloff', 'nloffred', 'abjh123', 'neo21top', 'rbajaria', 'behnkea', 'grewe', 'kong36', 'madman5000', 'leeseunghyun', 'uditrawat469', 'vtirukon9', 'white378', 'bseren', 'vchandwa', 'magi2elias', 'joderkir', 'jmm24', 'msadi', 'piersonb', 'reedra1', 'f.escallonp', 'le67', 'anilgurjar85', 'leonchangzhy', 'wang2506', 'shah213', 'syedshakeeb96', 'li1882', 'stella', 'verma30', 'lmulan', 'adhikarp', 'aruthe', 'ml72', 'choi381', 'rsaigal1', 'efernandez_97', 'zlesemanksu', 'thewhartonproject', 'shasadullah', 'mmanago', 'billlight114', 'apk242', 'rmcandr', 'thelot44', 'greed', 'lkorean0120', 'yj1206love', 'rajnp', 'mw12heybuddy', 'anusha248', 'berger.143', 'asimo2.718', 'mkshamsi.ee', 'lauradnc15', 'aronsonj', 'govinda1', 'hyeon7300', 'd.castley253', 'park_munsoo', 'leonar30', 'ramnathbhatmech', 'cstalcupxixi', 'fgalano', 'smit2538', 'jtschwar', 'kmcpeak']"
3,123,150,39,1,['escalantemariaalejandra'],148,"['jhavey', 'hussni', 'arquita', 'waldropj', 'aroggero', 'lbassett', 'alvare48', 'jhemmerl11', 'ahmadubuntu', 'yshin0917', 'nicktucker', 'mordoches', 'duodinamico', 'liu1579', 'chan161', 'grant.ramage', 'kbg04193', 'vsbharadwaj91', 'asoordel', 'yao127', 'khojandi', 'fang137', 'nnnjkl', 'liamarasta', 'turabhaiderkazmi1', 'kapur2', 'esindela', 'amadwesh1', 'ahornin', 'lixu315612126', 'santine0915', 'sawyer_sup', 'ece202', 'simonfrfr', 'giorgiaf', 'gwangoo525', 'lovesaelin', 'glabianc', 'asa10', 'trex6303', 'klm0637', 'kearns0', 'graves34', 'amartin2970', 'melhag', 'dmm13', 'trusso45', 'saurav7188', 'kaymi22', 'murphj2', 'khom', 'aberding', 'pan118', 'kfulford', 'xu964', 'khan117', 'jgradows', 'aemerson', 'bolt5136', 'dsguala', 'jeveridg', 'veerendra.vakkapatla', 'lasscap', 'osborn33', 'neitsert', 'lthomae', 'bgpotter', 'chepemontalvof', 'pennk', 'chae0823', 'nkhrush', 'cyeow', 'naveedahmad0000000', 'gsurojit1', 'cfri', 'kliou', 'alexismagana47', 'zhan1263', 'gross53', 'vbe1', 'liam_sutton', 'sksqkrgur', 'nckloff', 'nloffred', 'abjh123', 'neo21top', 'behnkea', 'grewe', 'kong36', 'madman5000', 'leeseunghyun', 'uditrawat469', 'vtirukon9', 'white378', 'bseren', 'vchandwa', 'magi2elias', 'jtschwar', 'joderkir', 'jmm24', 'msadi', 'piersonb', 'reedra1', 'f.escallonp', 'le67', 'anilgurjar85', 'leonchangzhy', 'wang2506', 'shah213', 'syedshakeeb96', 'li1882', 'stella', 'verma30', 'lmulan', 'adhikarp', 'aruthe', 'choi381', 'rsaigal1', 'efernandez_97', 'zlesemanksu', 'thewhartonproject', 'shasadullah', 'mmanago', 'billlight114', 'apk242', 'rmcandr', 'thelot44', 'greed', 'lkorean0120', 'yj1206love', 'rajnp', 'mw12heybuddy', 'anusha248', 'berger.143', 'asimo2.718', 'mkshamsi.ee', 'lauradnc15', 'aronsonj', 'govinda1', 'hyeon7300', 'd.castley253', 'park_munsoo', 'ramnathbhatmech', 'cstalcupxixi', 'fgalano', 'smit2538', 'ml72', 'kmcpeak']",38,"['jufepas98', 'rdcajr', 'jenipinzon.ml', 'jesusvillamizar', 'raquelalejandra', 'erikananiela', 'sa.sanchez', 'we.simancas10', 'andresfdt.2k8', 'jairovlacha', 'brayant', 'jdmedinatobon', 'ja.jimenez317', 'dadelapa321', 'sd.diaz', 'af.vera10', 'j.wilckenlecompte', 'fabser7', 'sarabeja98', 'rf.ruiz10', 'andres9802', 'andrestrujillo098', 'juandavid97', 'lf.correa10', 'hectordavidpulido', 'jupalinar17', 'labiele2206', None, 'vserrano081821', 'te.vence10', 'isabella', 'jfgf11', 'diegobb', 'jframos', 'carlosdoblev', 'vanessamovilla', 'juan_camilo', 'eduardmolano']",187,"['jhavey', 'hussni', 'arquita', 'waldropj', 'jufepas98', 'aroggero', 'jenipinzon.ml', 'lbassett', 'raquelalejandra', 'alvare48', 'jhemmerl11', 'ahmadubuntu', 'yshin0917', 'sa.sanchez', 'nicktucker', 'mordoches', 'jairovlacha', 'duodinamico', 'liu1579', 'chan161', 'grant.ramage', 'kbg04193', 'fabser7', 'sarabeja98', 'vsbharadwaj91', 'asoordel', 'andres9802', 'lf.correa10', 'yao127', 'khojandi', 'fang137', 'nnnjkl', 'liamarasta', 'turabhaiderkazmi1', 'kapur2', 'esindela', 'amadwesh1', 'ahornin', 'lixu315612126', 'vanessamovilla', 'eduardmolano', 'santine0915', 'sawyer_sup', 'ece202', 'simonfrfr', 'giorgiaf', 'rdcajr', 'gwangoo525', 'lovesaelin', 'glabianc', 'asa10', 'trex6303', 'klm0637', 'jesusvillamizar', 'kearns0', 'graves34', 'amartin2970', 'melhag', 'dmm13', 'trusso45', 'saurav7188', 'kaymi22', 'murphj2', 'khom', 'aberding', 'pan118', 'brayant', 'kfulford', 'ja.jimenez317', 'dadelapa321', 'xu964', 'khan117', 'jgradows', 'af.vera10', 'j.wilckenlecompte', 'aemerson', 'bolt5136', 'dsguala', 'jeveridg', 'veerendra.vakkapatla', 'lasscap', 'osborn33', 'hectordavidpulido', 'neitsert', 'lthomae', None, 'vserrano081821', 'bgpotter', 'chepemontalvof', 'pennk', 'juan_camilo', 'chae0823', 'escalantemariaalejandra', 'nkhrush', 'cyeow', 'naveedahmad0000000', 'gsurojit1', 'cfri', 'kliou', 'alexismagana47', 'erikananiela', 'zhan1263', 'gross53', 'vbe1', 'liam_sutton', 'sksqkrgur', 'nckloff', 'nloffred', 'abjh123', 'neo21top', 'behnkea', 'grewe', 'kong36', 'madman5000', 'leeseunghyun', 'uditrawat469', 'vtirukon9', 'white378', 'bseren', 'vchandwa', 'rf.ruiz10', 'andrestrujillo098', 'juandavid97', 'magi2elias', 'labiele2206', 'joderkir', 'jmm24', 'msadi', 'piersonb', 'isabella', 'jfgf11', 'reedra1', 'diegobb', 'f.escallonp', 'le67', 'carlosdoblev', 'anilgurjar85', 'leonchangzhy', 'wang2506', 'shah213', 'syedshakeeb96', 'li1882', 'stella', 'verma30', 'lmulan', 'adhikarp', 'aruthe', 'ml72', 'choi381', 'rsaigal1', 'efernandez_97', 'zlesemanksu', 'thewhartonproject', 'shasadullah', 'mmanago', 'we.simancas10', 'billlight114', 'apk242', 'rmcandr', 'andresfdt.2k8', 'thelot44', 'greed', 'lkorean0120', 'yj1206love', 'rajnp', 'mw12heybuddy', 'anusha248', 'berger.143', 'asimo2.718', 'mkshamsi.ee', 'jdmedinatobon', 'sd.diaz', 'lauradnc15', 'aronsonj', 'govinda1', 'hyeon7300', 'd.castley253', 'jupalinar17', 'park_munsoo', 'te.vence10', 'ramnathbhatmech', 'cstalcupxixi', 'fgalano', 'smit2538', 'jframos', 'jtschwar', 'kmcpeak']"
3,118,150,31,3,"['f.escallonp', 'lauradnc15', 'duodinamico']",146,"['jhavey', 'hussni', 'arquita', 'waldropj', 'aroggero', 'lbassett', 'alvare48', 'jhemmerl11', 'ahmadubuntu', 'yshin0917', 'nicktucker', 'mordoches', 'liu1579', 'chan161', 'grant.ramage', 'kbg04193', 'vsbharadwaj91', 'asoordel', 'yao127', 'khojandi', 'fang137', 'nnnjkl', 'liamarasta', 'turabhaiderkazmi1', 'kapur2', 'esindela', 'amadwesh1', 'ahornin', 'lixu315612126', 'santine0915', 'sawyer_sup', 'ece202', 'simonfrfr', 'giorgiaf', 'gwangoo525', 'lovesaelin', 'glabianc', 'asa10', 'trex6303', 'klm0637', 'kearns0', 'graves34', 'amartin2970', 'melhag', 'dmm13', 'trusso45', 'saurav7188', 'kaymi22', 'murphj2', 'khom', 'aberding', 'pan118', 'kfulford', 'xu964', 'khan117', 'jgradows', 'aemerson', 'bolt5136', 'dsguala', 'jeveridg', 'veerendra.vakkapatla', 'lasscap', 'osborn33', 'neitsert', 'lthomae', 'bgpotter', 'chepemontalvof', 'pennk', 'chae0823', 'escalantemariaalejandra', 'nkhrush', 'cyeow', 'naveedahmad0000000', 'gsurojit1', 'cfri', 'kliou', 'alexismagana47', 'zhan1263', 'gross53', 'vbe1', 'liam_sutton', 'sksqkrgur', 'nckloff', 'nloffred', 'abjh123', 'neo21top', 'behnkea', 'grewe', 'kong36', 'madman5000', 'leeseunghyun', 'uditrawat469', 'vtirukon9', 'white378', 'bseren', 'vchandwa', 'magi2elias', 'joderkir', 'jmm24', 'msadi', 'piersonb', 'reedra1', 'le67', 'anilgurjar85', 'leonchangzhy', 'wang2506', 'shah213', 'syedshakeeb96', 'li1882', 'stella', 'verma30', 'lmulan', 'adhikarp', 'aruthe', 'ml72', 'choi381', 'rsaigal1', 'efernandez_97', 'zlesemanksu', 'thewhartonproject', 'shasadullah', 'mmanago', 'billlight114', 'apk242', 'rmcandr', 'thelot44', 'greed', 'lkorean0120', 'yj1206love', 'rajnp', 'mw12heybuddy', 'anusha248', 'berger.143', 'asimo2.718', 'mkshamsi.ee', 'aronsonj', 'govinda1', 'hyeon7300', 'd.castley253', 'park_munsoo', 'ramnathbhatmech', 'cstalcupxixi', 'fgalano', 'smit2538', 'jtschwar', 'kmcpeak']",28,"['jufepas98', 'rdcajr', 'jesusvillamizar', 'raquelalejandra', 'erikananiela', 'yeju16', 'we.simancas10', 'andresfdt.2k8', 'jdmedinatobon', 'dadelapa321', 'af.vera10', 'j.wilckenlecompte', 'fabser7', 'rf.ruiz10', 'andres9802', 'andrestrujillo098', 'juandavid97', 'lf.correa10', 'hectordavidpulido', 'jupalinar17', None, 'te.vence10', 'isabella', 'jfgf11', 'diegobb', 'vanessamovilla', 'juan_camilo', 'eduardmolano']",177,"['jhavey', 'hussni', 'arquita', 'waldropj', 'jufepas98', 'aroggero', 'lbassett', 'raquelalejandra', 'alvare48', 'jhemmerl11', 'ahmadubuntu', 'yshin0917', 'nicktucker', 'mordoches', 'duodinamico', 'liu1579', 'chan161', 'grant.ramage', 'kbg04193', 'fabser7', 'vsbharadwaj91', 'asoordel', 'andres9802', 'lf.correa10', 'yao127', 'khojandi', 'fang137', 'nnnjkl', 'liamarasta', 'turabhaiderkazmi1', 'kapur2', 'esindela', 'amadwesh1', 'ahornin', 'lixu315612126', 'vanessamovilla', 'eduardmolano', 'santine0915', 'sawyer_sup', 'ece202', 'simonfrfr', 'giorgiaf', 'rdcajr', 'gwangoo525', 'lovesaelin', 'glabianc', 'asa10', 'trex6303', 'klm0637', 'jesusvillamizar', 'kearns0', 'graves34', 'amartin2970', 'melhag', 'dmm13', 'trusso45', 'saurav7188', 'kaymi22', 'murphj2', 'khom', 'aberding', 'pan118', 'kfulford', 'dadelapa321', 'xu964', 'khan117', 'jgradows', 'af.vera10', 'j.wilckenlecompte', 'aemerson', 'bolt5136', 'dsguala', 'jeveridg', 'veerendra.vakkapatla', 'lasscap', 'osborn33', 'hectordavidpulido', 'neitsert', 'lthomae', None, 'bgpotter', 'chepemontalvof', 'pennk', 'juan_camilo', 'chae0823', 'escalantemariaalejandra', 'nkhrush', 'cyeow', 'naveedahmad0000000', 'gsurojit1', 'cfri', 'kliou', 'alexismagana47', 'erikananiela', 'zhan1263', 'gross53', 'vbe1', 'yeju16', 'liam_sutton', 'sksqkrgur', 'nckloff', 'nloffred', 'abjh123', 'neo21top', 'behnkea', 'grewe', 'kong36', 'madman5000', 'leeseunghyun', 'uditrawat469', 'vtirukon9', 'white378', 'bseren', 'vchandwa', 'rf.ruiz10', 'andrestrujillo098', 'juandavid97', 'magi2elias', 'joderkir', 'jmm24', 'msadi', 'piersonb', 'isabella', 'jfgf11', 'reedra1', 'diegobb', 'f.escallonp', 'le67', 'anilgurjar85', 'leonchangzhy', 'wang2506', 'shah213', 'syedshakeeb96', 'li1882', 'stella', 'verma30', 'lmulan', 'adhikarp', 'aruthe', 'ml72', 'choi381', 'rsaigal1', 'efernandez_97', 'zlesemanksu', 'thewhartonproject', 'shasadullah', 'mmanago', 'we.simancas10', 'billlight114', 'apk242', 'rmcandr', 'andresfdt.2k8', 'thelot44', 'greed', 'lkorean0120', 'yj1206love', 'rajnp', 'mw12heybuddy', 'anusha248', 'berger.143', 'asimo2.718', 'mkshamsi.ee', 'jdmedinatobon', 'lauradnc15', 'aronsonj', 'govinda1', 'hyeon7300', 'd.castley253', 'jupalinar17', 'park_munsoo', 'te.vence10', 'ramnathbhatmech', 'cstalcupxixi', 'fgalano', 'smit2538', 'jtschwar', 'kmcpeak']"
3,130,150,30,1,['liamarasta'],148,"['jhavey', 'hussni', 'arquita', 'waldropj', 'aroggero', 'lbassett', 'alvare48', 'jhemmerl11', 'ahmadubuntu', 'yshin0917', 'nicktucker', 'mordoches', 'duodinamico', 'liu1579', 'chan161', 'grant.ramage', 'kbg04193', 'vsbharadwaj91', 'asoordel', 'yao127', 'khojandi', 'fang137', 'nnnjkl', 'turabhaiderkazmi1', 'kapur2', 'esindela', 'amadwesh1', 'ahornin', 'lixu315612126', 'santine0915', 'sawyer_sup', 'ece202', 'simonfrfr', 'giorgiaf', 'gwangoo525', 'lovesaelin', 'glabianc', 'asa10', 'trex6303', 'klm0637', 'kearns0', 'graves34', 'amartin2970', 'melhag', 'dmm13', 'trusso45', 'saurav7188', 'kaymi22', 'murphj2', 'khom', 'aberding', 'pan118', 'kfulford', 'xu964', 'khan117', 'jgradows', 'aemerson', 'bolt5136', 'dsguala', 'jeveridg', 'veerendra.vakkapatla', 'lasscap', 'osborn33', 'neitsert', 'lthomae', 'bgpotter', 'chepemontalvof', 'pennk', 'chae0823', 'escalantemariaalejandra', 'nkhrush', 'cyeow', 'naveedahmad0000000', 'gsurojit1', 'cfri', 'kliou', 'alexismagana47', 'zhan1263', 'gross53', 'vbe1', 'liam_sutton', 'sksqkrgur', 'nckloff', 'nloffred', 'abjh123', 'neo21top', 'behnkea', 'grewe', 'kong36', 'madman5000', 'leeseunghyun', 'uditrawat469', 'vtirukon9', 'white378', 'bseren', 'vchandwa', 'magi2elias', 'joderkir', 'jmm24', 'msadi', 'piersonb', 'reedra1', 'f.escallonp', 'le67', 'anilgurjar85', 'leonchangzhy', 'wang2506', 'shah213', 'syedshakeeb96', 'li1882', 'stella', 'verma30', 'lmulan', 'adhikarp', 'aruthe', 'ml72', 'choi381', 'rsaigal1', 'efernandez_97', 'zlesemanksu', 'thewhartonproject', 'shasadullah', 'mmanago', 'billlight114', 'apk242', 'rmcandr', 'thelot44', 'greed', 'lkorean0120', 'yj1206love', 'rajnp', 'mw12heybuddy', 'anusha248', 'berger.143', 'asimo2.718', 'mkshamsi.ee', 'lauradnc15', 'aronsonj', 'govinda1', 'hyeon7300', 'd.castley253', 'park_munsoo', 'ramnathbhatmech', 'cstalcupxixi', 'fgalano', 'smit2538', 'jtschwar', 'kmcpeak']",29,"['dkurpaska', 'ztoscanini', 'yaoweixie', 'jhennessey', 'lemerson', 'mdelude', 'jrlacroix', 'rmcauliffe11', 'cpeter', 'rtam', 'ricardohenri', 'aksamija', 'lucasguertin', 'eliasphillip', 'oyacteen', 'akaluzny', 'pjaswal', 'rkornitsky', 'markgillespi', 'ctheriault', None, 'dgage', 'matthewsarge', 'sgilani', 'komminiadithya', 'nshattuck', 'nmsheridan', 'jpweber', 'ougorji']",178,"['dkurpaska', 'jhavey', 'hussni', 'ztoscanini', 'arquita', 'waldropj', 'aroggero', 'lbassett', 'alvare48', 'jhemmerl11', 'ahmadubuntu', 'yshin0917', 'ricardohenri', 'nicktucker', 'mordoches', 'duodinamico', 'liu1579', 'oyacteen', 'chan161', 'grant.ramage', 'kbg04193', 'vsbharadwaj91', 'asoordel', 'rkornitsky', 'markgillespi', 'yao127', 'khojandi', 'fang137', 'nnnjkl', 'liamarasta', 'turabhaiderkazmi1', 'kapur2', 'esindela', 'amadwesh1', 'ahornin', 'lixu315612126', 'nmsheridan', 'santine0915', 'sawyer_sup', 'ece202', 'simonfrfr', 'giorgiaf', 'gwangoo525', 'lovesaelin', 'glabianc', 'asa10', 'trex6303', 'klm0637', 'kearns0', 'graves34', 'amartin2970', 'melhag', 'dmm13', 'trusso45', 'saurav7188', 'rtam', 'kaymi22', 'murphj2', 'khom', 'aberding', 'pan118', 'kfulford', 'xu964', 'khan117', 'jgradows', 'aemerson', 'bolt5136', 'dsguala', 'jeveridg', 'veerendra.vakkapatla', 'lasscap', 'osborn33', 'ctheriault', 'neitsert', 'lthomae', None, 'dgage', 'bgpotter', 'nshattuck', 'chepemontalvof', 'pennk', 'jpweber', 'chae0823', 'escalantemariaalejandra', 'nkhrush', 'cyeow', 'naveedahmad0000000', 'gsurojit1', 'cfri', 'kliou', 'yaoweixie', 'alexismagana47', 'zhan1263', 'gross53', 'vbe1', 'liam_sutton', 'sksqkrgur', 'jrlacroix', 'nckloff', 'nloffred', 'aksamija', 'abjh123', 'neo21top', 'behnkea', 'grewe', 'kong36', 'eliasphillip', 'akaluzny', 'madman5000', 'leeseunghyun', 'uditrawat469', 'pjaswal', 'vtirukon9', 'white378', 'bseren', 'vchandwa', 'magi2elias', 'joderkir', 'jmm24', 'msadi', 'matthewsarge', 'piersonb', 'reedra1', 'f.escallonp', 'le67', 'anilgurjar85', 'leonchangzhy', 'ougorji', 'wang2506', 'shah213', 'syedshakeeb96', 'li1882', 'stella', 'verma30', 'lmulan', 'adhikarp', 'aruthe', 'ml72', 'choi381', 'jhennessey', 'rsaigal1', 'efernandez_97', 'lemerson', 'mdelude', 'zlesemanksu', 'thewhartonproject', 'shasadullah', 'mmanago', 'rmcauliffe11', 'billlight114', 'apk242', 'cpeter', 'rmcandr', 'thelot44', 'greed', 'lkorean0120', 'yj1206love', 'rajnp', 'mw12heybuddy', 'lucasguertin', 'anusha248', 'berger.143', 'asimo2.718', 'mkshamsi.ee', 'lauradnc15', 'aronsonj', 'govinda1', 'hyeon7300', 'd.castley253', 'park_munsoo', 'ramnathbhatmech', 'cstalcupxixi', 'fgalano', 'sgilani', 'komminiadithya', 'smit2538', 'jtschwar', 'kmcpeak']"
3,120,150,24,8,"['lmulan', 'leeseunghyun', 'kbg04193', 'gwangoo525', 'trex6303', 'abjh123', 'khojandi', 'chae0823']",141,"['jhavey', 'hussni', 'arquita', 'waldropj', 'aroggero', 'lbassett', 'alvare48', 'jhemmerl11', 'ahmadubuntu', 'yshin0917', 'nicktucker', 'mordoches', 'duodinamico', 'liu1579', 'chan161', 'grant.ramage', 'vsbharadwaj91', 'asoordel', 'yao127', 'fang137', 'nnnjkl', 'liamarasta', 'turabhaiderkazmi1', 'kapur2', 'esindela', 'amadwesh1', 'ahornin', 'lixu315612126', 'santine0915', 'sawyer_sup', 'ece202', 'simonfrfr', 'giorgiaf', 'lovesaelin', 'glabianc', 'asa10', 'klm0637', 'kearns0', 'graves34', 'amartin2970', 'melhag', 'dmm13', 'trusso45', 'saurav7188', 'kaymi22', 'murphj2', 'khom', 'aberding', 'pan118', 'kfulford', 'xu964', 'khan117', 'jgradows', 'aemerson', 'bolt5136', 'dsguala', 'jeveridg', 'veerendra.vakkapatla', 'lasscap', 'osborn33', 'neitsert', 'lthomae', 'bgpotter', 'chepemontalvof', 'pennk', 'escalantemariaalejandra', 'nkhrush', 'cyeow', 'naveedahmad0000000', 'gsurojit1', 'cfri', 'kliou', 'alexismagana47', 'zhan1263', 'gross53', 'vbe1', 'liam_sutton', 'sksqkrgur', 'nckloff', 'nloffred', 'neo21top', 'behnkea', 'grewe', 'kong36', 'madman5000', 'uditrawat469', 'vtirukon9', 'white378', 'bseren', 'vchandwa', 'magi2elias', 'joderkir', 'jmm24', 'msadi', 'piersonb', 'reedra1', 'f.escallonp', 'le67', 'anilgurjar85', 'leonchangzhy', 'wang2506', 'shah213', 'syedshakeeb96', 'li1882', 'stella', 'verma30', 'adhikarp', 'aruthe', 'ml72', 'choi381', 'rsaigal1', 'efernandez_97', 'zlesemanksu', 'thewhartonproject', 'shasadullah', 'mmanago', 'billlight114', 'apk242', 'rmcandr', 'thelot44', 'greed', 'lkorean0120', 'yj1206love', 'rajnp', 'mw12heybuddy', 'anusha248', 'berger.143', 'asimo2.718', 'mkshamsi.ee', 'lauradnc15', 'aronsonj', 'govinda1', 'hyeon7300', 'd.castley253', 'park_munsoo', 'ramnathbhatmech', 'cstalcupxixi', 'fgalano', 'smit2538', 'jtschwar', 'kmcpeak']",16,"['thscodus97', 'twpark8', None, 'xotn0104', 'kkhkcw', 'siun97', 'godemperorvars', 'iykoo010', 'jerrynohyunki', 'yicoreen', 'wnstn6361', 'han1801j', 'ariel1998', 'harry.na', 'rkim13', 'braian98']",165,"['jhavey', 'hussni', 'arquita', 'waldropj', 'aroggero', 'iykoo010', 'lbassett', 'alvare48', 'jhemmerl11', 'ahmadubuntu', 'yshin0917', 'braian98', 'nicktucker', 'mordoches', 'duodinamico', 'liu1579', 'harry.na', 'chan161', 'grant.ramage', 'kbg04193', 'vsbharadwaj91', 'asoordel', 'yao127', 'khojandi', 'fang137', 'nnnjkl', 'liamarasta', 'turabhaiderkazmi1', 'kapur2', 'esindela', 'amadwesh1', 'ahornin', 'han1801j', 'lixu315612126', 'santine0915', 'sawyer_sup', 'ece202', 'simonfrfr', 'giorgiaf', 'gwangoo525', 'lovesaelin', 'glabianc', 'asa10', 'trex6303', 'klm0637', 'kearns0', 'graves34', 'amartin2970', 'melhag', 'dmm13', 'trusso45', 'saurav7188', 'kaymi22', 'godemperorvars', 'murphj2', 'khom', 'aberding', 'pan118', 'rkim13', 'kfulford', 'xu964', 'khan117', 'jgradows', 'aemerson', 'bolt5136', 'dsguala', 'jeveridg', 'veerendra.vakkapatla', 'lasscap', 'osborn33', 'neitsert', 'lthomae', 'twpark8', None, 'bgpotter', 'xotn0104', 'siun97', 'chepemontalvof', 'pennk', 'chae0823', 'escalantemariaalejandra', 'nkhrush', 'cyeow', 'naveedahmad0000000', 'gsurojit1', 'cfri', 'kliou', 'yicoreen', 'wnstn6361', 'alexismagana47', 'zhan1263', 'gross53', 'vbe1', 'liam_sutton', 'sksqkrgur', 'nckloff', 'thscodus97', 'nloffred', 'jerrynohyunki', 'abjh123', 'neo21top', 'behnkea', 'ariel1998', 'grewe', 'kong36', 'madman5000', 'leeseunghyun', 'uditrawat469', 'vtirukon9', 'white378', 'bseren', 'vchandwa', 'magi2elias', 'joderkir', 'jmm24', 'msadi', 'piersonb', 'reedra1', 'f.escallonp', 'le67', 'anilgurjar85', 'leonchangzhy', 'wang2506', 'shah213', 'syedshakeeb96', 'li1882', 'stella', 'verma30', 'lmulan', 'kkhkcw', 'adhikarp', 'aruthe', 'ml72', 'choi381', 'rsaigal1', 'efernandez_97', 'zlesemanksu', 'thewhartonproject', 'shasadullah', 'mmanago', 'billlight114', 'apk242', 'rmcandr', 'thelot44', 'greed', 'lkorean0120', 'yj1206love', 'rajnp', 'mw12heybuddy', 'anusha248', 'berger.143', 'asimo2.718', 'mkshamsi.ee', 'lauradnc15', 'aronsonj', 'govinda1', 'hyeon7300', 'd.castley253', 'park_munsoo', 'ramnathbhatmech', 'cstalcupxixi', 'fgalano', 'smit2538', 'jtschwar', 'kmcpeak']"
3,131,150,15,3,"['greed', 'naveedahmad0000000', 'turabhaiderkazmi1']",146,"['jhavey', 'hussni', 'arquita', 'waldropj', 'aroggero', 'lbassett', 'alvare48', 'jhemmerl11', 'ahmadubuntu', 'yshin0917', 'nicktucker', 'mordoches', 'duodinamico', 'liu1579', 'chan161', 'grant.ramage', 'kbg04193', 'vsbharadwaj91', 'asoordel', 'yao127', 'khojandi', 'fang137', 'nnnjkl', 'liamarasta', 'kapur2', 'esindela', 'amadwesh1', 'ahornin', 'lixu315612126', 'santine0915', 'sawyer_sup', 'ece202', 'simonfrfr', 'giorgiaf', 'gwangoo525', 'lovesaelin', 'glabianc', 'asa10', 'trex6303', 'klm0637', 'kearns0', 'graves34', 'amartin2970', 'melhag', 'dmm13', 'trusso45', 'saurav7188', 'kaymi22', 'murphj2', 'khom', 'aberding', 'pan118', 'kfulford', 'xu964', 'khan117', 'jgradows', 'aemerson', 'bolt5136', 'dsguala', 'jeveridg', 'veerendra.vakkapatla', 'lasscap', 'osborn33', 'neitsert', 'lthomae', 'bgpotter', 'chepemontalvof', 'pennk', 'chae0823', 'escalantemariaalejandra', 'nkhrush', 'cyeow', 'gsurojit1', 'cfri', 'kliou', 'alexismagana47', 'zhan1263', 'gross53', 'vbe1', 'liam_sutton', 'sksqkrgur', 'nckloff', 'nloffred', 'abjh123', 'neo21top', 'behnkea', 'grewe', 'kong36', 'madman5000', 'leeseunghyun', 'uditrawat469', 'vtirukon9', 'white378', 'bseren', 'vchandwa', 'magi2elias', 'joderkir', 'jmm24', 'msadi', 'piersonb', 'reedra1', 'f.escallonp', 'le67', 'anilgurjar85', 'leonchangzhy', 'wang2506', 'shah213', 'syedshakeeb96', 'li1882', 'stella', 'verma30', 'lmulan', 'adhikarp', 'aruthe', 'ml72', 'choi381', 'rsaigal1', 'efernandez_97', 'zlesemanksu', 'thewhartonproject', 'shasadullah', 'mmanago', 'billlight114', 'apk242', 'rmcandr', 'thelot44', 'lkorean0120', 'yj1206love', 'rajnp', 'mw12heybuddy', 'anusha248', 'berger.143', 'asimo2.718', 'mkshamsi.ee', 'lauradnc15', 'aronsonj', 'govinda1', 'hyeon7300', 'd.castley253', 'park_munsoo', 'ramnathbhatmech', 'cstalcupxixi', 'fgalano', 'smit2538', 'jtschwar', 'kmcpeak']",12,"['hassanfatmi22', 'ahmed.uzair14', 'mannantirmizi', 'adeel9944', 'sheikh.asher', 'mhqqasmi', 'fakeha19', 'raousama3', 'uzairhasnain', 'adeel9955', 'hayder', None]",161,"['jhavey', 'hussni', 'arquita', 'adeel9944', 'waldropj', 'aroggero', 'lbassett', 'alvare48', 'jhemmerl11', 'ahmadubuntu', 'yshin0917', 'nicktucker', 'sheikh.asher', 'mordoches', 'duodinamico', 'liu1579', 'chan161', 'grant.ramage', 'kbg04193', 'vsbharadwaj91', 'asoordel', 'yao127', 'khojandi', 'fang137', 'nnnjkl', 'liamarasta', 'turabhaiderkazmi1', 'kapur2', 'esindela', 'amadwesh1', 'ahornin', 'lixu315612126', 'santine0915', 'sawyer_sup', 'ece202', 'simonfrfr', 'hassanfatmi22', 'giorgiaf', 'gwangoo525', 'lovesaelin', 'glabianc', 'asa10', 'trex6303', 'klm0637', 'mhqqasmi', 'kearns0', 'graves34', 'amartin2970', 'melhag', 'dmm13', 'trusso45', 'saurav7188', 'kaymi22', 'murphj2', 'khom', 'aberding', 'pan118', 'kfulford', 'xu964', 'khan117', 'jgradows', 'aemerson', 'bolt5136', 'dsguala', 'jeveridg', 'fakeha19', 'raousama3', 'veerendra.vakkapatla', 'uzairhasnain', 'lasscap', 'osborn33', 'neitsert', 'lthomae', 'adeel9955', None, 'bgpotter', 'chepemontalvof', 'pennk', 'chae0823', 'escalantemariaalejandra', 'nkhrush', 'cyeow', 'hayder', 'naveedahmad0000000', 'gsurojit1', 'cfri', 'kliou', 'alexismagana47', 'zhan1263', 'gross53', 'vbe1', 'liam_sutton', 'sksqkrgur', 'nckloff', 'nloffred', 'abjh123', 'neo21top', 'behnkea', 'grewe', 'kong36', 'madman5000', 'leeseunghyun', 'uditrawat469', 'mannantirmizi', 'vtirukon9', 'white378', 'bseren', 'vchandwa', 'magi2elias', 'joderkir', 'jmm24', 'msadi', 'piersonb', 'reedra1', 'f.escallonp', 'le67', 'anilgurjar85', 'leonchangzhy', 'wang2506', 'shah213', 'syedshakeeb96', 'li1882', 'stella', 'verma30', 'lmulan', 'ahmed.uzair14', 'adhikarp', 'aruthe', 'ml72', 'choi381', 'rsaigal1', 'efernandez_97', 'zlesemanksu', 'thewhartonproject', 'shasadullah', 'mmanago', 'billlight114', 'apk242', 'rmcandr', 'thelot44', 'greed', 'lkorean0120', 'yj1206love', 'rajnp', 'mw12heybuddy', 'anusha248', 'berger.143', 'asimo2.718', 'mkshamsi.ee', 'lauradnc15', 'aronsonj', 'govinda1', 'hyeon7300', 'd.castley253', 'park_munsoo', 'ramnathbhatmech', 'cstalcupxixi', 'fgalano', 'smit2538', 'jtschwar', 'kmcpeak']"
3,124,150,14,1,['rajnp'],148,"['jhavey', 'hussni', 'arquita', 'waldropj', 'aroggero', 'lbassett', 'alvare48', 'jhemmerl11', 'ahmadubuntu', 'yshin0917', 'nicktucker', 'mordoches', 'duodinamico', 'liu1579', 'chan161', 'grant.ramage', 'kbg04193', 'vsbharadwaj91', 'asoordel', 'yao127', 'khojandi', 'fang137', 'nnnjkl', 'liamarasta', 'turabhaiderkazmi1', 'kapur2', 'esindela', 'amadwesh1', 'ahornin', 'lixu315612126', 'santine0915', 'sawyer_sup', 'ece202', 'simonfrfr', 'giorgiaf', 'gwangoo525', 'lovesaelin', 'glabianc', 'asa10', 'trex6303', 'klm0637', 'kearns0', 'graves34', 'amartin2970', 'melhag', 'dmm13', 'trusso45', 'saurav7188', 'kaymi22', 'murphj2', 'khom', 'aberding', 'pan118', 'kfulford', 'xu964', 'khan117', 'jgradows', 'aemerson', 'bolt5136', 'dsguala', 'jeveridg', 'veerendra.vakkapatla', 'lasscap', 'osborn33', 'neitsert', 'lthomae', 'bgpotter', 'chepemontalvof', 'pennk', 'chae0823', 'escalantemariaalejandra', 'nkhrush', 'cyeow', 'naveedahmad0000000', 'gsurojit1', 'cfri', 'kliou', 'alexismagana47', 'zhan1263', 'gross53', 'vbe1', 'liam_sutton', 'sksqkrgur', 'nckloff', 'nloffred', 'abjh123', 'neo21top', 'behnkea', 'grewe', 'kong36', 'madman5000', 'leeseunghyun', 'uditrawat469', 'vtirukon9', 'white378', 'bseren', 'vchandwa', 'magi2elias', 'joderkir', 'jmm24', 'msadi', 'piersonb', 'reedra1', 'f.escallonp', 'le67', 'anilgurjar85', 'leonchangzhy', 'wang2506', 'shah213', 'syedshakeeb96', 'li1882', 'stella', 'verma30', 'lmulan', 'adhikarp', 'aruthe', 'ml72', 'choi381', 'rsaigal1', 'efernandez_97', 'zlesemanksu', 'thewhartonproject', 'shasadullah', 'mmanago', 'billlight114', 'apk242', 'rmcandr', 'thelot44', 'greed', 'lkorean0120', 'yj1206love', 'mw12heybuddy', 'anusha248', 'berger.143', 'asimo2.718', 'mkshamsi.ee', 'lauradnc15', 'aronsonj', 'govinda1', 'hyeon7300', 'd.castley253', 'park_munsoo', 'ramnathbhatmech', 'cstalcupxixi', 'fgalano', 'smit2538', 'jtschwar', 'kmcpeak']",13,"['chartig1', 'vpandya', 'bgrau', 'zejohn', None, 'patenright29', 'risia', 'ikyu', 'robbymancini1397', 'pragti.narang', 'srocca', 'jtimon', 'rwynne1']",162,"['jhavey', 'hussni', 'arquita', 'waldropj', 'aroggero', 'lbassett', 'alvare48', 'jhemmerl11', 'ahmadubuntu', 'yshin0917', 'nicktucker', 'mordoches', 'duodinamico', 'liu1579', 'chan161', 'chartig1', 'grant.ramage', 'kbg04193', 'vsbharadwaj91', 'asoordel', 'yao127', 'khojandi', 'fang137', 'jtimon', 'nnnjkl', 'liamarasta', 'turabhaiderkazmi1', 'kapur2', 'esindela', 'amadwesh1', 'ahornin', 'lixu315612126', 'santine0915', 'sawyer_sup', 'ece202', 'simonfrfr', 'giorgiaf', 'gwangoo525', 'lovesaelin', 'glabianc', 'asa10', 'trex6303', 'klm0637', 'kearns0', 'graves34', 'amartin2970', 'melhag', 'dmm13', 'trusso45', 'saurav7188', 'kaymi22', 'murphj2', 'khom', 'aberding', 'pan118', 'kfulford', 'xu964', 'khan117', 'jgradows', 'risia', 'aemerson', 'bolt5136', 'dsguala', 'jeveridg', 'veerendra.vakkapatla', 'lasscap', 'osborn33', 'neitsert', 'lthomae', None, 'bgpotter', 'chepemontalvof', 'pennk', 'chae0823', 'escalantemariaalejandra', 'nkhrush', 'cyeow', 'naveedahmad0000000', 'gsurojit1', 'cfri', 'kliou', 'alexismagana47', 'zhan1263', 'gross53', 'vbe1', 'liam_sutton', 'sksqkrgur', 'nckloff', 'nloffred', 'abjh123', 'neo21top', 'behnkea', 'robbymancini1397', 'grewe', 'rwynne1', 'kong36', 'zejohn', 'madman5000', 'leeseunghyun', 'uditrawat469', 'vtirukon9', 'white378', 'bseren', 'vchandwa', 'pragti.narang', 'magi2elias', 'joderkir', 'jmm24', 'msadi', 'piersonb', 'ikyu', 'reedra1', 'f.escallonp', 'le67', 'anilgurjar85', 'leonchangzhy', 'wang2506', 'shah213', 'syedshakeeb96', 'li1882', 'stella', 'verma30', 'lmulan', 'patenright29', 'adhikarp', 'aruthe', 'ml72', 'choi381', 'rsaigal1', 'efernandez_97', 'zlesemanksu', 'thewhartonproject', 'shasadullah', 'mmanago', 'billlight114', 'apk242', 'rmcandr', 'thelot44', 'greed', 'lkorean0120', 'yj1206love', 'rajnp', 'mw12heybuddy', 'anusha248', 'berger.143', 'srocca', 'asimo2.718', 'mkshamsi.ee', 'vpandya', 'bgrau', 'lauradnc15', 'aronsonj', 'govinda1', 'hyeon7300', 'd.castley253', 'park_munsoo', 'ramnathbhatmech', 'cstalcupxixi', 'fgalano', 'smit2538', 'jtschwar', 'kmcpeak']"
3,132,150,12,1,['apk242'],148,"['jhavey', 'hussni', 'arquita', 'waldropj', 'aroggero', 'lbassett', 'alvare48', 'jhemmerl11', 'ahmadubuntu', 'yshin0917', 'nicktucker', 'mordoches', 'duodinamico', 'liu1579', 'chan161', 'grant.ramage', 'kbg04193', 'vsbharadwaj91', 'asoordel', 'yao127', 'khojandi', 'fang137', 'nnnjkl', 'liamarasta', 'turabhaiderkazmi1', 'kapur2', 'esindela', 'amadwesh1', 'ahornin', 'lixu315612126', 'santine0915', 'sawyer_sup', 'ece202', 'simonfrfr', 'giorgiaf', 'gwangoo525', 'lovesaelin', 'glabianc', 'asa10', 'trex6303', 'klm0637', 'kearns0', 'graves34', 'amartin2970', 'melhag', 'dmm13', 'trusso45', 'saurav7188', 'kaymi22', 'murphj2', 'khom', 'aberding', 'pan118', 'kfulford', 'xu964', 'khan117', 'jgradows', 'aemerson', 'bolt5136', 'dsguala', 'jeveridg', 'veerendra.vakkapatla', 'lasscap', 'osborn33', 'neitsert', 'lthomae', 'bgpotter', 'chepemontalvof', 'pennk', 'chae0823', 'escalantemariaalejandra', 'nkhrush', 'cyeow', 'naveedahmad0000000', 'gsurojit1', 'cfri', 'kliou', 'alexismagana47', 'zhan1263', 'gross53', 'vbe1', 'liam_sutton', 'sksqkrgur', 'nckloff', 'nloffred', 'abjh123', 'neo21top', 'behnkea', 'grewe', 'kong36', 'madman5000', 'leeseunghyun', 'uditrawat469', 'vtirukon9', 'white378', 'bseren', 'vchandwa', 'magi2elias', 'joderkir', 'jmm24', 'msadi', 'piersonb', 'reedra1', 'f.escallonp', 'le67', 'anilgurjar85', 'leonchangzhy', 'wang2506', 'shah213', 'syedshakeeb96', 'li1882', 'stella', 'verma30', 'lmulan', 'adhikarp', 'aruthe', 'ml72', 'choi381', 'rsaigal1', 'efernandez_97', 'zlesemanksu', 'thewhartonproject', 'shasadullah', 'mmanago', 'billlight114', 'rmcandr', 'thelot44', 'greed', 'lkorean0120', 'yj1206love', 'rajnp', 'mw12heybuddy', 'anusha248', 'berger.143', 'asimo2.718', 'mkshamsi.ee', 'lauradnc15', 'aronsonj', 'govinda1', 'hyeon7300', 'd.castley253', 'park_munsoo', 'ramnathbhatmech', 'cstalcupxixi', 'fgalano', 'smit2538', 'jtschwar', 'kmcpeak']",11,"['kevintian2018', 'cjc560', None, 'mikebenim', 'adw8059', 'rb959', 'jwo739', 'johnnymski', 'tgh504_tgh504', 'jjb946', 'rmg895']",160,"['jhavey', 'hussni', 'arquita', 'waldropj', 'aroggero', 'lbassett', 'alvare48', 'tgh504_tgh504', 'jhemmerl11', 'ahmadubuntu', 'yshin0917', 'jjb946', 'rmg895', 'nicktucker', 'mordoches', 'duodinamico', 'liu1579', 'chan161', 'kevintian2018', 'grant.ramage', 'kbg04193', 'vsbharadwaj91', 'asoordel', 'yao127', 'khojandi', 'fang137', 'nnnjkl', 'liamarasta', 'turabhaiderkazmi1', 'kapur2', 'esindela', 'amadwesh1', 'ahornin', 'lixu315612126', 'santine0915', 'sawyer_sup', 'ece202', 'simonfrfr', 'mikebenim', 'giorgiaf', 'gwangoo525', 'lovesaelin', 'glabianc', 'asa10', 'trex6303', 'klm0637', 'kearns0', 'graves34', 'amartin2970', 'melhag', 'dmm13', 'trusso45', 'saurav7188', 'kaymi22', 'murphj2', 'khom', 'aberding', 'pan118', 'kfulford', 'xu964', 'khan117', 'jgradows', 'cjc560', 'aemerson', 'bolt5136', 'dsguala', 'rb959', 'jeveridg', 'johnnymski', 'veerendra.vakkapatla', 'lasscap', 'osborn33', 'neitsert', 'lthomae', None, 'bgpotter', 'chepemontalvof', 'pennk', 'chae0823', 'escalantemariaalejandra', 'nkhrush', 'cyeow', 'naveedahmad0000000', 'gsurojit1', 'cfri', 'kliou', 'alexismagana47', 'zhan1263', 'gross53', 'vbe1', 'liam_sutton', 'sksqkrgur', 'nckloff', 'nloffred', 'abjh123', 'neo21top', 'behnkea', 'grewe', 'kong36', 'madman5000', 'leeseunghyun', 'uditrawat469', 'vtirukon9', 'white378', 'bseren', 'vchandwa', 'magi2elias', 'joderkir', 'jmm24', 'msadi', 'piersonb', 'reedra1', 'f.escallonp', 'le67', 'anilgurjar85', 'leonchangzhy', 'wang2506', 'shah213', 'syedshakeeb96', 'li1882', 'stella', 'verma30', 'lmulan', 'adhikarp', 'aruthe', 'ml72', 'choi381', 'rsaigal1', 'efernandez_97', 'zlesemanksu', 'thewhartonproject', 'shasadullah', 'mmanago', 'billlight114', 'apk242', 'rmcandr', 'thelot44', 'greed', 'lkorean0120', 'yj1206love', 'rajnp', 'mw12heybuddy', 'jwo739', 'anusha248', 'berger.143', 'asimo2.718', 'mkshamsi.ee', 'lauradnc15', 'aronsonj', 'adw8059', 'govinda1', 'hyeon7300', 'd.castley253', 'park_munsoo', 'ramnathbhatmech', 'cstalcupxixi', 'fgalano', 'smit2538', 'jtschwar', 'kmcpeak']"
3,128,150,10,3,"['greed', 'naveedahmad0000000', 'shasadullah']",146,"['jhavey', 'hussni', 'arquita', 'waldropj', 'aroggero', 'lbassett', 'alvare48', 'jhemmerl11', 'ahmadubuntu', 'yshin0917', 'nicktucker', 'mordoches', 'duodinamico', 'liu1579', 'chan161', 'grant.ramage', 'kbg04193', 'vsbharadwaj91', 'asoordel', 'yao127', 'khojandi', 'fang137', 'nnnjkl', 'liamarasta', 'turabhaiderkazmi1', 'kapur2', 'esindela', 'amadwesh1', 'ahornin', 'lixu315612126', 'santine0915', 'sawyer_sup', 'ece202', 'simonfrfr', 'giorgiaf', 'gwangoo525', 'lovesaelin', 'glabianc', 'asa10', 'trex6303', 'klm0637', 'kearns0', 'graves34', 'amartin2970', 'melhag', 'dmm13', 'trusso45', 'saurav7188', 'kaymi22', 'murphj2', 'khom', 'aberding', 'pan118', 'kfulford', 'xu964', 'khan117', 'jgradows', 'aemerson', 'bolt5136', 'dsguala', 'jeveridg', 'veerendra.vakkapatla', 'lasscap', 'osborn33', 'neitsert', 'lthomae', 'bgpotter', 'chepemontalvof', 'pennk', 'chae0823', 'escalantemariaalejandra', 'nkhrush', 'cyeow', 'gsurojit1', 'cfri', 'kliou', 'alexismagana47', 'zhan1263', 'gross53', 'vbe1', 'liam_sutton', 'sksqkrgur', 'nckloff', 'nloffred', 'abjh123', 'neo21top', 'behnkea', 'grewe', 'kong36', 'madman5000', 'leeseunghyun', 'uditrawat469', 'vtirukon9', 'white378', 'bseren', 'vchandwa', 'magi2elias', 'joderkir', 'jmm24', 'msadi', 'piersonb', 'reedra1', 'f.escallonp', 'le67', 'anilgurjar85', 'leonchangzhy', 'wang2506', 'shah213', 'syedshakeeb96', 'li1882', 'stella', 'verma30', 'lmulan', 'adhikarp', 'aruthe', 'ml72', 'choi381', 'rsaigal1', 'efernandez_97', 'zlesemanksu', 'thewhartonproject', 'mmanago', 'billlight114', 'apk242', 'rmcandr', 'thelot44', 'lkorean0120', 'yj1206love', 'rajnp', 'mw12heybuddy', 'anusha248', 'berger.143', 'asimo2.718', 'mkshamsi.ee', 'lauradnc15', 'aronsonj', 'govinda1', 'hyeon7300', 'd.castley253', 'park_munsoo', 'ramnathbhatmech', 'cstalcupxixi', 'fgalano', 'smit2538', 'jtschwar', 'kmcpeak']",7,"['ahmed.uzair14', 'mhqqasmi', 'muhammadshernasir', 'fakeha19', 'hayder', None, 'malikarslan11']",156,"['jhavey', 'hussni', 'arquita', 'waldropj', 'aroggero', 'lbassett', 'alvare48', 'jhemmerl11', 'ahmadubuntu', 'yshin0917', 'nicktucker', 'mordoches', 'duodinamico', 'liu1579', 'chan161', 'grant.ramage', 'kbg04193', 'vsbharadwaj91', 'asoordel', 'yao127', 'khojandi', 'fang137', 'nnnjkl', 'liamarasta', 'turabhaiderkazmi1', 'kapur2', 'esindela', 'amadwesh1', 'ahornin', 'lixu315612126', 'santine0915', 'sawyer_sup', 'ece202', 'simonfrfr', 'giorgiaf', 'gwangoo525', 'lovesaelin', 'glabianc', 'asa10', 'trex6303', 'klm0637', 'mhqqasmi', 'kearns0', 'graves34', 'amartin2970', 'melhag', 'dmm13', 'trusso45', 'saurav7188', 'kaymi22', 'murphj2', 'khom', 'aberding', 'pan118', 'kfulford', 'xu964', 'khan117', 'jgradows', 'aemerson', 'bolt5136', 'dsguala', 'jeveridg', 'fakeha19', 'muhammadshernasir', 'veerendra.vakkapatla', 'lasscap', 'osborn33', 'neitsert', 'lthomae', None, 'bgpotter', 'chepemontalvof', 'pennk', 'chae0823', 'escalantemariaalejandra', 'nkhrush', 'cyeow', 'hayder', 'malikarslan11', 'naveedahmad0000000', 'gsurojit1', 'cfri', 'kliou', 'alexismagana47', 'zhan1263', 'gross53', 'vbe1', 'liam_sutton', 'sksqkrgur', 'nckloff', 'nloffred', 'abjh123', 'neo21top', 'behnkea', 'grewe', 'kong36', 'madman5000', 'leeseunghyun', 'uditrawat469', 'vtirukon9', 'white378', 'bseren', 'vchandwa', 'magi2elias', 'joderkir', 'jmm24', 'msadi', 'piersonb', 'reedra1', 'f.escallonp', 'le67', 'anilgurjar85', 'leonchangzhy', 'wang2506', 'shah213', 'syedshakeeb96', 'li1882', 'stella', 'verma30', 'lmulan', 'ahmed.uzair14', 'adhikarp', 'aruthe', 'ml72', 'choi381', 'rsaigal1', 'efernandez_97', 'zlesemanksu', 'thewhartonproject', 'shasadullah', 'mmanago', 'billlight114', 'apk242', 'rmcandr', 'thelot44', 'greed', 'lkorean0120', 'yj1206love', 'rajnp', 'mw12heybuddy', 'anusha248', 'berger.143', 'asimo2.718', 'mkshamsi.ee', 'lauradnc15', 'aronsonj', 'govinda1', 'hyeon7300', 'd.castley253', 'park_munsoo', 'ramnathbhatmech', 'cstalcupxixi', 'fgalano', 'smit2538', 'jtschwar', 'kmcpeak']"
3,122,150,9,1,['lasscap'],148,"['jhavey', 'hussni', 'arquita', 'waldropj', 'aroggero', 'lbassett', 'alvare48', 'jhemmerl11', 'ahmadubuntu', 'yshin0917', 'nicktucker', 'mordoches', 'duodinamico', 'liu1579', 'chan161', 'grant.ramage', 'kbg04193', 'vsbharadwaj91', 'asoordel', 'yao127', 'khojandi', 'fang137', 'nnnjkl', 'liamarasta', 'turabhaiderkazmi1', 'kapur2', 'esindela', 'amadwesh1', 'ahornin', 'lixu315612126', 'santine0915', 'sawyer_sup', 'ece202', 'simonfrfr', 'giorgiaf', 'gwangoo525', 'lovesaelin', 'glabianc', 'asa10', 'trex6303', 'klm0637', 'kearns0', 'graves34', 'amartin2970', 'melhag', 'dmm13', 'trusso45', 'saurav7188', 'kaymi22', 'murphj2', 'khom', 'aberding', 'pan118', 'kfulford', 'xu964', 'khan117', 'jgradows', 'aemerson', 'bolt5136', 'dsguala', 'jeveridg', 'veerendra.vakkapatla', 'osborn33', 'neitsert', 'lthomae', 'bgpotter', 'chepemontalvof', 'pennk', 'chae0823', 'escalantemariaalejandra', 'nkhrush', 'cyeow', 'naveedahmad0000000', 'gsurojit1', 'cfri', 'kliou', 'alexismagana47', 'zhan1263', 'gross53', 'vbe1', 'liam_sutton', 'sksqkrgur', 'nckloff', 'nloffred', 'abjh123', 'neo21top', 'behnkea', 'grewe', 'kong36', 'madman5000', 'leeseunghyun', 'uditrawat469', 'vtirukon9', 'white378', 'bseren', 'vchandwa', 'magi2elias', 'joderkir', 'jmm24', 'msadi', 'piersonb', 'reedra1', 'f.escallonp', 'le67', 'anilgurjar85', 'leonchangzhy', 'wang2506', 'shah213', 'syedshakeeb96', 'li1882', 'stella', 'verma30', 'lmulan', 'adhikarp', 'aruthe', 'ml72', 'choi381', 'rsaigal1', 'efernandez_97', 'zlesemanksu', 'thewhartonproject', 'shasadullah', 'mmanago', 'billlight114', 'apk242', 'rmcandr', 'thelot44', 'greed', 'lkorean0120', 'yj1206love', 'rajnp', 'mw12heybuddy', 'anusha248', 'berger.143', 'asimo2.718', 'mkshamsi.ee', 'lauradnc15', 'aronsonj', 'govinda1', 'hyeon7300', 'd.castley253', 'park_munsoo', 'ramnathbhatmech', 'cstalcupxixi', 'fgalano', 'smit2538', 'jtschwar', 'kmcpeak']",8,"['wnstn6361', 'fnf44', 'jhb0316', 'jhj970216d', 'gudwls0419', 'hys1031315', None, 'dxk0824']",157,"['jhavey', 'hussni', 'arquita', 'waldropj', 'aroggero', 'lbassett', 'alvare48', 'jhemmerl11', 'ahmadubuntu', 'yshin0917', 'nicktucker', 'mordoches', 'duodinamico', 'liu1579', 'chan161', 'grant.ramage', 'kbg04193', 'vsbharadwaj91', 'asoordel', 'yao127', 'khojandi', 'fang137', 'nnnjkl', 'liamarasta', 'turabhaiderkazmi1', 'kapur2', 'esindela', 'amadwesh1', 'ahornin', 'lixu315612126', 'santine0915', 'sawyer_sup', 'ece202', 'simonfrfr', 'giorgiaf', 'gwangoo525', 'lovesaelin', 'glabianc', 'asa10', 'trex6303', 'klm0637', 'kearns0', 'graves34', 'amartin2970', 'melhag', 'dmm13', 'trusso45', 'saurav7188', 'kaymi22', 'murphj2', 'khom', 'aberding', 'pan118', 'kfulford', 'xu964', 'khan117', 'jgradows', 'aemerson', 'bolt5136', 'dsguala', 'jeveridg', 'veerendra.vakkapatla', 'lasscap', 'osborn33', 'neitsert', 'lthomae', None, 'bgpotter', 'chepemontalvof', 'pennk', 'chae0823', 'escalantemariaalejandra', 'nkhrush', 'cyeow', 'naveedahmad0000000', 'gsurojit1', 'cfri', 'kliou', 'wnstn6361', 'alexismagana47', 'zhan1263', 'gross53', 'vbe1', 'liam_sutton', 'sksqkrgur', 'nckloff', 'nloffred', 'abjh123', 'neo21top', 'behnkea', 'grewe', 'kong36', 'dxk0824', 'madman5000', 'leeseunghyun', 'uditrawat469', 'vtirukon9', 'white378', 'bseren', 'vchandwa', 'fnf44', 'magi2elias', 'joderkir', 'jmm24', 'msadi', 'piersonb', 'reedra1', 'f.escallonp', 'le67', 'anilgurjar85', 'leonchangzhy', 'jhj970216d', 'gudwls0419', 'wang2506', 'shah213', 'syedshakeeb96', 'li1882', 'stella', 'verma30', 'lmulan', 'adhikarp', 'aruthe', 'ml72', 'choi381', 'rsaigal1', 'efernandez_97', 'jhb0316', 'zlesemanksu', 'thewhartonproject', 'shasadullah', 'mmanago', 'billlight114', 'apk242', 'rmcandr', 'thelot44', 'greed', 'lkorean0120', 'yj1206love', 'rajnp', 'mw12heybuddy', 'anusha248', 'berger.143', 'asimo2.718', 'mkshamsi.ee', 'lauradnc15', 'aronsonj', 'govinda1', 'hyeon7300', 'd.castley253', 'hys1031315', 'park_munsoo', 'ramnathbhatmech', 'cstalcupxixi', 'fgalano', 'smit2538', 'jtschwar', 'kmcpeak']"
3,117,150,6,5,"['trusso45', 'arquita', 'murphj2', 'reedra1', 'vchandwa']",144,"['jhavey', 'hussni', 'waldropj', 'aroggero', 'lbassett', 'alvare48', 'jhemmerl11', 'ahmadubuntu', 'yshin0917', 'nicktucker', 'mordoches', 'duodinamico', 'liu1579', 'chan161', 'grant.ramage', 'kbg04193', 'vsbharadwaj91', 'asoordel', 'yao127', 'khojandi', 'fang137', 'nnnjkl', 'liamarasta', 'turabhaiderkazmi1', 'kapur2', 'esindela', 'amadwesh1', 'ahornin', 'lixu315612126', 'santine0915', 'sawyer_sup', 'ece202', 'simonfrfr', 'giorgiaf', 'gwangoo525', 'lovesaelin', 'glabianc', 'asa10', 'trex6303', 'klm0637', 'kearns0', 'graves34', 'amartin2970', 'melhag', 'dmm13', 'saurav7188', 'kaymi22', 'khom', 'aberding', 'pan118', 'kfulford', 'xu964', 'khan117', 'jgradows', 'aemerson', 'bolt5136', 'dsguala', 'jeveridg', 'veerendra.vakkapatla', 'lasscap', 'osborn33', 'neitsert', 'lthomae', 'bgpotter', 'chepemontalvof', 'pennk', 'chae0823', 'escalantemariaalejandra', 'nkhrush', 'cyeow', 'naveedahmad0000000', 'gsurojit1', 'cfri', 'kliou', 'alexismagana47', 'zhan1263', 'gross53', 'vbe1', 'liam_sutton', 'sksqkrgur', 'nckloff', 'nloffred', 'abjh123', 'neo21top', 'behnkea', 'grewe', 'kong36', 'madman5000', 'leeseunghyun', 'uditrawat469', 'vtirukon9', 'white378', 'bseren', 'magi2elias', 'joderkir', 'jmm24', 'msadi', 'piersonb', 'f.escallonp', 'le67', 'anilgurjar85', 'leonchangzhy', 'wang2506', 'shah213', 'syedshakeeb96', 'li1882', 'stella', 'verma30', 'lmulan', 'adhikarp', 'aruthe', 'ml72', 'choi381', 'rsaigal1', 'efernandez_97', 'zlesemanksu', 'thewhartonproject', 'shasadullah', 'mmanago', 'billlight114', 'apk242', 'rmcandr', 'thelot44', 'greed', 'lkorean0120', 'yj1206love', 'rajnp', 'mw12heybuddy', 'anusha248', 'berger.143', 'asimo2.718', 'mkshamsi.ee', 'lauradnc15', 'aronsonj', 'govinda1', 'hyeon7300', 'd.castley253', 'park_munsoo', 'ramnathbhatmech', 'cstalcupxixi', 'fgalano', 'smit2538', 'jtschwar', 'kmcpeak']",1,[None],150,"['jhavey', 'hussni', 'arquita', 'waldropj', 'aroggero', 'lbassett', 'alvare48', 'jhemmerl11', 'ahmadubuntu', 'yshin0917', 'nicktucker', 'mordoches', 'duodinamico', 'liu1579', 'chan161', 'grant.ramage', 'kbg04193', 'vsbharadwaj91', 'asoordel', 'yao127', 'khojandi', 'fang137', 'nnnjkl', 'liamarasta', 'turabhaiderkazmi1', 'kapur2', 'esindela', 'amadwesh1', 'ahornin', 'lixu315612126', 'santine0915', 'sawyer_sup', 'ece202', 'simonfrfr', 'giorgiaf', 'gwangoo525', 'lovesaelin', 'glabianc', 'asa10', 'trex6303', 'klm0637', 'kearns0', 'graves34', 'amartin2970', 'melhag', 'dmm13', 'trusso45', 'saurav7188', 'kaymi22', 'murphj2', 'khom', 'aberding', 'pan118', 'kfulford', 'xu964', 'khan117', 'jgradows', 'aemerson', 'bolt5136', 'dsguala', 'jeveridg', 'veerendra.vakkapatla', 'lasscap', 'osborn33', 'neitsert', 'lthomae', None, 'bgpotter', 'chepemontalvof', 'pennk', 'chae0823', 'escalantemariaalejandra', 'nkhrush', 'cyeow', 'naveedahmad0000000', 'gsurojit1', 'cfri', 'kliou', 'alexismagana47', 'zhan1263', 'gross53', 'vbe1', 'liam_sutton', 'sksqkrgur', 'nckloff', 'nloffred', 'abjh123', 'neo21top', 'behnkea', 'grewe', 'kong36', 'madman5000', 'leeseunghyun', 'uditrawat469', 'vtirukon9', 'white378', 'bseren', 'vchandwa', 'magi2elias', 'joderkir', 'jmm24', 'msadi', 'piersonb', 'reedra1', 'f.escallonp', 'le67', 'anilgurjar85', 'leonchangzhy', 'wang2506', 'shah213', 'syedshakeeb96', 'li1882', 'stella', 'verma30', 'lmulan', 'adhikarp', 'aruthe', 'ml72', 'choi381', 'rsaigal1', 'efernandez_97', 'zlesemanksu', 'thewhartonproject', 'shasadullah', 'mmanago', 'billlight114', 'apk242', 'rmcandr', 'thelot44', 'greed', 'lkorean0120', 'yj1206love', 'rajnp', 'mw12heybuddy', 'anusha248', 'berger.143', 'asimo2.718', 'mkshamsi.ee', 'lauradnc15', 'aronsonj', 'govinda1', 'hyeon7300', 'd.castley253', 'park_munsoo', 'ramnathbhatmech', 'cstalcupxixi', 'fgalano', 'smit2538', 'jtschwar', 'kmcpeak']"
3,126,150,6,3,"['chan161', 'glabianc', 'msadi']",146,"['jhavey', 'hussni', 'arquita', 'waldropj', 'aroggero', 'lbassett', 'alvare48', 'jhemmerl11', 'ahmadubuntu', 'yshin0917', 'nicktucker', 'mordoches', 'duodinamico', 'liu1579', 'grant.ramage', 'kbg04193', 'vsbharadwaj91', 'asoordel', 'yao127', 'khojandi', 'fang137', 'nnnjkl', 'liamarasta', 'turabhaiderkazmi1', 'kapur2', 'esindela', 'amadwesh1', 'ahornin', 'lixu315612126', 'santine0915', 'sawyer_sup', 'ece202', 'simonfrfr', 'giorgiaf', 'gwangoo525', 'lovesaelin', 'asa10', 'trex6303', 'klm0637', 'kearns0', 'graves34', 'amartin2970', 'melhag', 'dmm13', 'trusso45', 'saurav7188', 'kaymi22', 'murphj2', 'khom', 'aberding', 'pan118', 'kfulford', 'xu964', 'khan117', 'jgradows', 'aemerson', 'bolt5136', 'dsguala', 'jeveridg', 'veerendra.vakkapatla', 'lasscap', 'osborn33', 'neitsert', 'lthomae', 'bgpotter', 'chepemontalvof', 'pennk', 'chae0823', 'escalantemariaalejandra', 'nkhrush', 'cyeow', 'naveedahmad0000000', 'gsurojit1', 'cfri', 'kliou', 'alexismagana47', 'zhan1263', 'gross53', 'vbe1', 'liam_sutton', 'sksqkrgur', 'nckloff', 'nloffred', 'abjh123', 'neo21top', 'behnkea', 'grewe', 'kong36', 'madman5000', 'leeseunghyun', 'uditrawat469', 'vtirukon9', 'white378', 'bseren', 'vchandwa', 'magi2elias', 'joderkir', 'jmm24', 'piersonb', 'reedra1', 'f.escallonp', 'le67', 'anilgurjar85', 'leonchangzhy', 'wang2506', 'shah213', 'syedshakeeb96', 'li1882', 'stella', 'verma30', 'lmulan', 'adhikarp', 'aruthe', 'ml72', 'choi381', 'rsaigal1', 'efernandez_97', 'zlesemanksu', 'thewhartonproject', 'shasadullah', 'mmanago', 'billlight114', 'apk242', 'rmcandr', 'thelot44', 'greed', 'lkorean0120', 'yj1206love', 'rajnp', 'mw12heybuddy', 'anusha248', 'berger.143', 'asimo2.718', 'mkshamsi.ee', 'lauradnc15', 'aronsonj', 'govinda1', 'hyeon7300', 'd.castley253', 'park_munsoo', 'ramnathbhatmech', 'cstalcupxixi', 'fgalano', 'smit2538', 'jtschwar', 'kmcpeak']",3,"['he300', None, 'rbajaria']",152,"['jhavey', 'hussni', 'arquita', 'waldropj', 'aroggero', 'lbassett', 'alvare48', 'jhemmerl11', 'ahmadubuntu', 'yshin0917', 'nicktucker', 'mordoches', 'duodinamico', 'liu1579', 'chan161', 'grant.ramage', 'kbg04193', 'vsbharadwaj91', 'asoordel', 'yao127', 'khojandi', 'fang137', 'nnnjkl', 'liamarasta', 'turabhaiderkazmi1', 'kapur2', 'he300', 'esindela', 'amadwesh1', 'ahornin', 'lixu315612126', 'santine0915', 'sawyer_sup', 'ece202', 'simonfrfr', 'giorgiaf', 'gwangoo525', 'lovesaelin', 'glabianc', 'asa10', 'trex6303', 'klm0637', 'kearns0', 'graves34', 'amartin2970', 'melhag', 'dmm13', 'trusso45', 'saurav7188', 'kaymi22', 'murphj2', 'khom', 'aberding', 'pan118', 'kfulford', 'xu964', 'khan117', 'jgradows', 'aemerson', 'bolt5136', 'dsguala', 'jeveridg', 'veerendra.vakkapatla', 'lasscap', 'osborn33', 'neitsert', 'lthomae', None, 'bgpotter', 'chepemontalvof', 'pennk', 'chae0823', 'escalantemariaalejandra', 'nkhrush', 'cyeow', 'naveedahmad0000000', 'gsurojit1', 'cfri', 'kliou', 'alexismagana47', 'zhan1263', 'gross53', 'vbe1', 'liam_sutton', 'sksqkrgur', 'nckloff', 'nloffred', 'abjh123', 'neo21top', 'rbajaria', 'behnkea', 'grewe', 'kong36', 'madman5000', 'leeseunghyun', 'uditrawat469', 'vtirukon9', 'white378', 'bseren', 'vchandwa', 'magi2elias', 'joderkir', 'jmm24', 'msadi', 'piersonb', 'reedra1', 'f.escallonp', 'le67', 'anilgurjar85', 'leonchangzhy', 'wang2506', 'shah213', 'syedshakeeb96', 'li1882', 'stella', 'verma30', 'lmulan', 'adhikarp', 'aruthe', 'ml72', 'choi381', 'rsaigal1', 'efernandez_97', 'zlesemanksu', 'thewhartonproject', 'shasadullah', 'mmanago', 'billlight114', 'apk242', 'rmcandr', 'thelot44', 'greed', 'lkorean0120', 'yj1206love', 'rajnp', 'mw12heybuddy', 'anusha248', 'berger.143', 'asimo2.718', 'mkshamsi.ee', 'lauradnc15', 'aronsonj', 'govinda1', 'hyeon7300', 'd.castley253', 'park_munsoo', 'ramnathbhatmech', 'cstalcupxixi', 'fgalano', 'smit2538', 'jtschwar', 'kmcpeak']"
4,278,80,101,75,"['hzhao44', 'adonofr2', 'syer2', 'mgambin2', 'ablee2', 'janavic2', 'jrgusta2', 'slee503', 'jjmaher2', 'ychen388', 'schen173', 'goodali2', 'dvaz2', 'murobar2', 'ghe6', 'cjbeck2', 'nim4', 'tson3', 'nahmoda2', 'lobryan2', 'kperozek2', 'xxia10', 'rrmiriy2', 'rekbot2', 'amogharavi1', 'wtso2', 'jmdimnd2', 'rll2', 'zx.9323', 'mjee3', 'yqin13', 'zzhan151', 'krupins2', 'dgao5', 'tsong', 'bdguo2', 'neves2', 'qchen39', 'juliaeb2', 'dszhu2', 'bcperki2', 'treppa2', 'twu53', 'emwisni2', 'rhyu2', 'clwhite5', 'enjucho2', 'bmcnich2', 'kkim142', 'xshan6', 'nlbenso2', 'shenxia', 'wwang114', 'mevtimo2', 'clin101', 'firpo2', 'yusenye2', 'conanlh2', 'jrlund3', 'masiewi2', 'elho2', 'ylee270', 'ycui18', 'aarmste2', 'sharpee2', 'cplant2', 'schoole2', 'rfbruck2', 'namiki2', 'hallorn2', 'jhardi9', 'yyun6', 'khazanv2', 'zchen208', 'atan14']",4,"['tomaj.ryb', 'eehoneg2', 'mschmitt27', 'jsharma3']",26,"['jmock3', 'djgnzlz2', 'hyang89', 'dyang48', 'bhliu2', 'shukankothari97', 'cfmuir2', 'ncadler2', 'imustaly52', 'cbott2', 'rjpavone', 'nikhilgk97', 'bpbaile2', 'khuang47', 'jkim526', 'hregner2', 'saegner2', 'jingyiw3', 'jlee742', 'nycbside95', None, 'ekisly2', 'jablowi2', 'ymoon11', 'jgallen3', 'ahrtmnn2']",105,"['mgambin2', 'ablee2', 'jrgusta2', 'janavic2', 'kperozek2', 'bhliu2', 'rekbot2', 'yqin13', 'zzhan151', 'krupins2', 'neves2', 'qchen39', 'emwisni2', 'kkim142', 'xshan6', 'firpo2', 'jrlund3', 'elho2', 'jhardi9', 'jgallen3', 'ahrtmnn2', 'adonofr2', 'syer2', 'slee503', 'jjmaher2', 'ychen388', 'dvaz2', 'cjbeck2', 'djgnzlz2', 'dyang48', 'mschmitt27', 'jmdimnd2', 'rll2', 'tsong', 'bdguo2', 'juliaeb2', 'bcperki2', 'cbott2', 'bpbaile2', 'bmcnich2', 'hregner2', 'shenxia', 'wwang114', 'saegner2', 'jingyiw3', 'clin101', 'yusenye2', 'nycbside95', None, 'ekisly2', 'ycui18', 'sharpee2', 'schoole2', 'rfbruck2', 'namiki2', 'eehoneg2', 'nlbenso2', 'yyun6', 'zchen208', 'schen173', 'goodali2', 'jmock3', 'jsharma3', 'lobryan2', 'rrmiriy2', 'mjee3', 'imustaly52', 'ncadler2', 'treppa2', 'rjpavone', 'clwhite5', 'enjucho2', 'tomaj.ryb', 'mevtimo2', 'jlee742', 'ylee270', 'cplant2', 'atan14', 'hzhao44', 'murobar2', 'ghe6', 'nim4', 'tson3', 'nahmoda2', 'hyang89', 'xxia10', 'amogharavi1', 'wtso2', 'zx.9323', 'shukankothari97', 'dgao5', 'cfmuir2', 'dszhu2', 'rhyu2', 'nikhilgk97', 'khuang47', 'jkim526', 'conanlh2', 'masiewi2', 'aarmste2', 'jablowi2', 'ymoon11', 'hallorn2', 'khazanv2', 'twu53']"
4,281,80,68,62,"['hzhao44', 'adonofr2', 'mgambin2', 'schen173', 'jrgusta2', 'janavic2', 'slee503', 'murobar2', 'goodali2', 'ghe6', 'jjmaher2', 'nim4', 'dvaz2', 'tson3', 'nahmoda2', 'cjbeck2', 'kperozek2', 'rrmiriy2', 'rekbot2', 'amogharavi1', 'wtso2', 'jmdimnd2', 'rll2', 'mjee3', 'yqin13', 'zzhan151', 'dgao5', 'tsong', 'bdguo2', 'neves2', 'qchen39', 'juliaeb2', 'dszhu2', 'twu53', 'emwisni2', 'clwhite5', 'enjucho2', 'bmcnich2', 'kkim142', 'xshan6', 'wwang114', 'mevtimo2', 'firpo2', 'yusenye2', 'conanlh2', 'jrlund3', 'masiewi2', 'elho2', 'ycui18', 'aarmste2', 'cplant2', 'sharpee2', 'schoole2', 'rfbruck2', 'namiki2', 'hallorn2', 'jhardi9', 'eehoneg2', 'yyun6', 'khazanv2', 'zchen208', 'atan14']",17,"['syer2', 'mschmitt27', 'ablee2', 'ylee270', 'zx.9323', 'ychen388', 'nlbenso2', 'krupins2', 'jsharma3', 'treppa2', 'shenxia', 'tomaj.ryb', 'lobryan2', 'clin101', 'bcperki2', 'xxia10', 'rhyu2']",6,"['nejhnsn2', 'amprath2', 'rpavone2', 'mockjustin', 'sashah10', None]",85,"['mgambin2', 'ablee2', 'jrgusta2', 'janavic2', 'schen173', 'goodali2', 'jsharma3', 'lobryan2', 'kperozek2', 'rrmiriy2', 'rekbot2', 'mjee3', 'yqin13', 'zzhan151', 'krupins2', 'nejhnsn2', 'neves2', 'qchen39', 'treppa2', 'emwisni2', 'clwhite5', 'enjucho2', 'kkim142', 'xshan6', 'nlbenso2', 'tomaj.ryb', 'mevtimo2', 'firpo2', 'jrlund3', 'elho2', 'ylee270', 'cplant2', 'jhardi9', 'sashah10', 'amprath2', 'atan14', 'hzhao44', 'adonofr2', 'syer2', 'slee503', 'murobar2', 'jjmaher2', 'ychen388', 'ghe6', 'nim4', 'dvaz2', 'cjbeck2', 'tson3', 'nahmoda2', 'rpavone2', 'xxia10', 'mschmitt27', 'amogharavi1', 'wtso2', 'jmdimnd2', 'rll2', 'zx.9323', 'dgao5', 'tsong', 'bdguo2', 'juliaeb2', 'mockjustin', 'dszhu2', 'bcperki2', 'twu53', 'rhyu2', 'bmcnich2', 'shenxia', 'wwang114', 'clin101', 'yusenye2', 'conanlh2', 'masiewi2', None, 'ycui18', 'aarmste2', 'sharpee2', 'schoole2', 'rfbruck2', 'namiki2', 'hallorn2', 'eehoneg2', 'yyun6', 'khazanv2', 'zchen208']"
4,279,80,25,1,['zx.9323'],78,"['mgambin2', 'ablee2', 'janavic2', 'jrgusta2', 'kperozek2', 'rekbot2', 'yqin13', 'zzhan151', 'krupins2', 'neves2', 'qchen39', 'emwisni2', 'kkim142', 'xshan6', 'firpo2', 'jrlund3', 'elho2', 'jhardi9', 'adonofr2', 'syer2', 'slee503', 'jjmaher2', 'ychen388', 'dvaz2', 'cjbeck2', 'mschmitt27', 'jmdimnd2', 'rll2', 'tsong', 'bdguo2', 'juliaeb2', 'bcperki2', 'bmcnich2', 'shenxia', 'wwang114', 'clin101', 'yusenye2', 'ycui18', 'sharpee2', 'schoole2', 'rfbruck2', 'namiki2', 'eehoneg2', 'nlbenso2', 'yyun6', 'zchen208', 'schen173', 'goodali2', 'jsharma3', 'lobryan2', 'rrmiriy2', 'mjee3', 'treppa2', 'clwhite5', 'enjucho2', 'tomaj.ryb', 'mevtimo2', 'ylee270', 'cplant2', 'atan14', 'hzhao44', 'murobar2', 'ghe6', 'nim4', 'tson3', 'nahmoda2', 'xxia10', 'amogharavi1', 'wtso2', 'dgao5', 'dszhu2', 'rhyu2', 'conanlh2', 'masiewi2', 'aarmste2', 'hallorn2', 'khazanv2', 'twu53']",24,"['goszkow2', 'drew.wise.10', 'jhmead2', 'jacob.dutler', 'liam.kenny96', 'dcschmi2', 'vs10', 'mtschmi2', 'qpr2', 'arovgno', 'jsshin3', 'jhbaker3', 'wtroth2', 'zlong4', 'jshi3120', 'mepaul2', 'jeoneil15', 'pross4', 'statar2', None, 'aladd2', 'prhogan2', 'slohman2', 'mtschro3']",103,"['mgambin2', 'ablee2', 'jrgusta2', 'janavic2', 'schen173', 'goodali2', 'jsharma3', 'lobryan2', 'kperozek2', 'drew.wise.10', 'jhmead2', 'rrmiriy2', 'rekbot2', 'jacob.dutler', 'liam.kenny96', 'mjee3', 'yqin13', 'zzhan151', 'krupins2', 'dcschmi2', 'qpr2', 'neves2', 'qchen39', 'treppa2', 'jsshin3', 'emwisni2', 'clwhite5', 'enjucho2', 'kkim142', 'xshan6', 'nlbenso2', 'tomaj.ryb', 'mevtimo2', 'firpo2', 'mepaul2', 'jrlund3', 'elho2', 'ylee270', 'cplant2', 'jhardi9', 'slohman2', 'zlong4', 'mtschro3', 'atan14', 'hzhao44', 'adonofr2', 'syer2', 'slee503', 'murobar2', 'jjmaher2', 'ychen388', 'ghe6', 'nim4', 'goszkow2', 'dvaz2', 'cjbeck2', 'tson3', 'nahmoda2', 'xxia10', 'mschmitt27', 'amogharavi1', 'wtso2', 'jmdimnd2', 'rll2', 'zx.9323', 'dgao5', 'tsong', 'bdguo2', 'vs10', 'mtschmi2', 'juliaeb2', 'arovgno', 'dszhu2', 'bcperki2', 'twu53', 'jhbaker3', 'rhyu2', 'wtroth2', 'bmcnich2', 'shenxia', 'wwang114', 'jshi3120', 'clin101', 'yusenye2', 'conanlh2', 'jeoneil15', 'pross4', 'masiewi2', 'statar2', None, 'ycui18', 'aarmste2', 'aladd2', 'sharpee2', 'schoole2', 'rfbruck2', 'namiki2', 'hallorn2', 'prhogan2', 'eehoneg2', 'yyun6', 'khazanv2', 'zchen208']"
4,280,80,24,22,"['syer2', 'ablee2', 'schen173', 'ychen388', 'goodali2', 'lobryan2', 'xxia10', 'zx.9323', 'krupins2', 'dszhu2', 'treppa2', 'bcperki2', 'rhyu2', 'shenxia', 'clin101', 'conanlh2', 'ylee270', 'sharpee2', 'cplant2', 'hallorn2', 'nlbenso2', 'zchen208']",57,"['hzhao44', 'adonofr2', 'mgambin2', 'jrgusta2', 'janavic2', 'slee503', 'jjmaher2', 'murobar2', 'ghe6', 'nim4', 'dvaz2', 'jsharma3', 'cjbeck2', 'tson3', 'nahmoda2', 'kperozek2', 'rrmiriy2', 'rekbot2', 'mschmitt27', 'amogharavi1', 'wtso2', 'jmdimnd2', 'rll2', 'mjee3', 'yqin13', 'zzhan151', 'dgao5', 'tsong', 'bdguo2', 'neves2', 'qchen39', 'juliaeb2', 'emwisni2', 'clwhite5', 'enjucho2', 'bmcnich2', 'kkim142', 'xshan6', 'wwang114', 'tomaj.ryb', 'mevtimo2', 'firpo2', 'yusenye2', 'jrlund3', 'masiewi2', 'elho2', 'ycui18', 'aarmste2', 'schoole2', 'rfbruck2', 'namiki2', 'jhardi9', 'eehoneg2', 'yyun6', 'khazanv2', 'twu53', 'atan14']",2,"['nejhnsn2', None]",81,"['mgambin2', 'ablee2', 'jrgusta2', 'janavic2', 'schen173', 'goodali2', 'jsharma3', 'lobryan2', 'kperozek2', 'rrmiriy2', 'rekbot2', 'mjee3', 'yqin13', 'zzhan151', 'krupins2', 'nejhnsn2', 'neves2', 'qchen39', 'treppa2', 'emwisni2', 'clwhite5', 'enjucho2', 'kkim142', 'xshan6', 'nlbenso2', 'tomaj.ryb', 'mevtimo2', 'firpo2', 'jrlund3', 'elho2', 'ylee270', 'cplant2', 'jhardi9', 'atan14', 'hzhao44', 'adonofr2', 'syer2', 'slee503', 'murobar2', 'jjmaher2', 'ychen388', 'ghe6', 'nim4', 'dvaz2', 'cjbeck2', 'tson3', 'nahmoda2', 'xxia10', 'mschmitt27', 'amogharavi1', 'wtso2', 'jmdimnd2', 'rll2', 'zx.9323', 'dgao5', 'tsong', 'bdguo2', 'juliaeb2', 'dszhu2', 'bcperki2', 'twu53', 'rhyu2', 'bmcnich2', 'shenxia', 'wwang114', 'clin101', 'yusenye2', 'conanlh2', 'masiewi2', None, 'ycui18', 'aarmste2', 'sharpee2', 'schoole2', 'rfbruck2', 'namiki2', 'hallorn2', 'eehoneg2', 'yyun6', 'khazanv2', 'zchen208']"
5,275,71,66,59,"['abood.sw', 'alex.wall', 'meghanjthomas', 'emilyg3110', 'dominik.cervenka', 'charlotteeg94', 'sophierosesmith98', 'mrb123', 'matthewhyder01', 'hkzneykus', 'maediannesonugan', 'benjamina', 'elliotthook', 'jjmartin49', 'sam.revell14', 'danjones235', 'aishanuhu', 'yassin12', 'amethyst44', 'rhys.bossler', 'corromon', 'alextucker56', 'dv018089', 'adflanaganlfc', 'dantrueman2015', 'toppdawg', 'rumanamiah1998', 'jemackay', 'alexsimmons27', 'zoerjames123', 'willvalentine02', 'karishma1', 'samweeks123', 'rh.taylor98', 'sammy_1555', 'simranc', 'nico97', 'ineshamiltonschool', 'ireland.gentile', 'jfeasey01', 'ayaanabdillahi1997', 'amasson', 'theofrost98', 'brandonb610', 'barat.abid', 'dmillard2491', 'gabslowe11', 'a_4cash', 'gelav', 'baggage1234', 'shw6195', 'maks.rakowski', 'peterhannanyoung', 'nadinecandelin', 'jessfraser13', 'hannahlaws59', 'ludmilacerne', 'shrnshafiee', 'emmwelham']",11,"['ravinder3265', 'agallag', 'cc011063', 'davidnutt', 'kathleen.burns', 'danskelson', 'stevesmith0', 'ryanbowers529', 'sam.bamforth', 'hubamarton1996', 'aliang']",7,"['yzelenkova98', 'tomleadon', 'angelaes', 'drishnasainju', None, 'lorna', 'georgelavender1995']",77,"['abood.sw', 'yzelenkova98', 'ravinder3265', 'emilyg3110', 'dominik.cervenka', 'kathleen.burns', 'matthewhyder01', 'maediannesonugan', 'sam.bamforth', 'danjones235', 'sam.revell14', 'dv018089', 'toppdawg', 'rumanamiah1998', 'alexsimmons27', 'zoerjames123', 'willvalentine02', 'samweeks123', 'nico97', 'ineshamiltonschool', 'jfeasey01', 'danskelson', 'theofrost98', 'ryanbowers529', 'gabslowe11', 'a_4cash', 'shw6195', 'tomleadon', 'maks.rakowski', 'peterhannanyoung', 'georgelavender1995', 'drishnasainju', 'ludmilacerne', 'shrnshafiee', 'amasson', 'alex.wall', 'meghanjthomas', 'charlotteeg94', 'sophierosesmith98', 'mrb123', 'hkzneykus', 'angelaes', 'benjamina', 'elliotthook', 'jjmartin49', 'aishanuhu', 'lorna', 'yassin12', 'amethyst44', 'corromon', 'rhys.bossler', 'alextucker56', 'dantrueman2015', 'adflanaganlfc', 'stevesmith0', 'jemackay', 'agallag', 'karishma1', 'rh.taylor98', 'sammy_1555', 'simranc', 'ireland.gentile', 'davidnutt', 'ayaanabdillahi1997', 'brandonb610', 'barat.abid', 'hubamarton1996', 'dmillard2491', None, 'aliang', 'gelav', 'baggage1234', 'cc011063', 'nadinecandelin', 'jessfraser13', 'hannahlaws59', 'emmwelham']"
6,80,56,78,53,"['es16btech11018', 'bhavya12', 'es15btech11016', 'maniyarudit', 'nakshatra', 'tejas_p', 'rajeshwarchennam', 'sayzeeel', 'ep15btech11005', 'rangesh', 'vishnu_33', 'shardul', 'hydro123', 'srinidhibachu', 'ee16btech11012', 'havish', 'karlapatirajapradyumna', 'pulapapavan25', 'chakri1804', 'chait', 'vivek2699', 'deepkarma82', 'snehith', 'sidmohla', 'aravindganesh', 'es16btech11003', 'ee16btech11013', 'ncsham', 'preetham1998', 'bhanutabeti', 'anuragshekhar', 'shanky98', 'vishwajith', 'anushag', 'ganna09', 'ep15btech11001', 'saiashish', 'pramith', 'es15btech11010', 'akramya98', 'ee16btech11042', 'im2learning', 'sumanth', 'karthikr98', 'pradeepmoturi', 'es16btech11001', 'samhitha', 'adithyahosapate', 're1nth', 'dj_16', 'es16btech11026', 'subhashchandra', 'devnano']",2,"['ee16btech11001', 'shengkai']",25,"['siddharth_goel', 'ee16btech11024', 'aravind03', 'emani', 'es16btech11007', 'es16btech11011', 'bharadwaj1997', 'uditmaniyar', 'ramanudeepp', 'es16btech11008', 'khalidshaik', 'anandkadu4108', 'ep14btech11003', 'jvinaykumar12', 'es15btech11007', 'aamir_ee', 'ee16btech11016', None, 'es14btech11022', 'saurav.varaprasad', 'ee16btech11028', 'priyanka7', 'es16btech11002', 'kmt6264', 'ee16btech11032']",80,"['rajeshwarchennam', 'sayzeeel', 'vishnu_33', 'hydro123', 'pulapapavan25', 'shengkai', 'bhanutabeti', 'shanky98', 'ee16btech11016', 'es16btech11001', 'samhitha', 're1nth', 'dj_16', 'es16btech11026', 'priyanka7', 'anushag', 'siddharth_goel', 'ee16btech11024', 'nakshatra', 'tejas_p', 'uditmaniyar', 'rangesh', 'ee16btech11012', 'havish', 'khalidshaik', 'ep14btech11003', 'es15btech11007', None, 'ee16btech11042', 'sumanth', 'karthikr98', 'adithyahosapate', 'subhashchandra', 'kmt6264', 'ee16btech11032', 'bhavya12', 'es15btech11016', 'maniyarudit', 'es16btech11011', 'bharadwaj1997', 'ep15btech11005', 'ramanudeepp', 'karlapatirajapradyumna', 'deepkarma82', 'aravindganesh', 'ncsham', 'anandkadu4108', 'saiashish', 'pramith', 'saurav.varaprasad', 'im2learning', 'pradeepmoturi', 'devnano', 'akramya98', 'es16btech11018', 'aravind03', 'emani', 'es16btech11007', 'shardul', 'es16btech11008', 'chakri1804', 'chait', 'vivek2699', 'snehith', 'sidmohla', 'anuragshekhar', 'es16btech11003', 'ee16btech11013', 'preetham1998', 'jvinaykumar12', 'aamir_ee', 'vishwajith', 'ganna09', 'ep15btech11001', 'es14btech11022', 'ee16btech11001', 'es15btech11010', 'ee16btech11028', 'srinidhibachu', 'es16btech11002']"
6,303,56,64,49,"['es16btech11018', 'bhavya12', 'es15btech11016', 'maniyarudit', 'nakshatra', 'rajeshwarchennam', 'ep15btech11005', 'rangesh', 'vishnu_33', 'srinidhibachu', 'ee16btech11012', 'havish', 'karlapatirajapradyumna', 'pulapapavan25', 'chakri1804', 'chait', 'vivek2699', 'deepkarma82', 'snehith', 'sidmohla', 'aravindganesh', 'es16btech11003', 'ee16btech11013', 'ncsham', 'preetham1998', 'bhanutabeti', 'anuragshekhar', 'vishwajith', 'anushag', 'ganna09', 'ep15btech11001', 'saiashish', 'pramith', 'ee16btech11001', 'akramya98', 'es15btech11010', 'ee16btech11042', 'im2learning', 'sumanth', 'karthikr98', 'pradeepmoturi', 'es16btech11001', 'samhitha', 'adithyahosapate', 're1nth', 'dj_16', 'es16btech11026', 'subhashchandra', 'devnano']",6,"['shengkai', 'shardul', 'hydro123', 'shanky98', 'tejas_p', 'sayzeeel']",15,"['ashish.kittu10', 'zzcfc257', 'mani6264', 'ee15btech11016', 'lleo', 'ee16btech11010', 'anandnwarrier1998', 'ee16btech11024', 'jvinaykumar12', 'choppaaravind', 'aamir_ee', 'emani', 'priya18', None, 'bharadwaj1997']",70,"['bhavya12', 'ee15btech11016', 'es15btech11016', 'maniyarudit', 'rajeshwarchennam', 'priya18', 'sayzeeel', 'bharadwaj1997', 'ep15btech11005', 'vishnu_33', 'hydro123', 'srinidhibachu', 'choppaaravind', 'karlapatirajapradyumna', 'pulapapavan25', 'deepkarma82', 'zzcfc257', 'aravindganesh', 'shengkai', 'ncsham', 'bhanutabeti', 'shanky98', 'saiashish', 'pramith', 'im2learning', 'pradeepmoturi', 'es16btech11001', 'samhitha', 're1nth', 'dj_16', 'es16btech11026', 'devnano', 'akramya98', 'es16btech11018', 'anushag', 'ee16btech11024', 'nakshatra', 'tejas_p', 'emani', 'ashish.kittu10', 'rangesh', 'shardul', 'ee16btech11012', 'havish', 'chakri1804', 'chait', 'vivek2699', 'snehith', 'sidmohla', 'anuragshekhar', 'es16btech11003', 'ee16btech11013', 'preetham1998', 'lleo', 'ee16btech11010', 'anandnwarrier1998', 'jvinaykumar12', 'aamir_ee', 'vishwajith', 'ganna09', 'ep15btech11001', None, 'ee16btech11001', 'es15btech11010', 'mani6264', 'ee16btech11042', 'sumanth', 'karthikr98', 'adithyahosapate', 'subhashchandra']"
6,223,56,40,31,"['es15btech11016', 'nakshatra', 'tejas_p', 'rajeshwarchennam', 'sayzeeel', 'ep15btech11005', 'rangesh', 'vishnu_33', 'shardul', 'hydro123', 'havish', 'chait', 'vivek2699', 'aravindganesh', 'es16btech11003', 'ee16btech11013', 'ncsham', 'shanky98', 'ep15btech11001', 'saiashish', 'ee16btech11001', 'es15btech11010', 'akramya98', 'ee16btech11042', 'im2learning', 'sumanth', 'es16btech11001', 'samhitha', 're1nth', 'srinidhibachu', 'anushag']",24,"['es16btech11018', 'bhavya12', 'maniyarudit', 'ee16btech11012', 'karlapatirajapradyumna', 'pulapapavan25', 'chakri1804', 'deepkarma82', 'snehith', 'sidmohla', 'shengkai', 'anuragshekhar', 'preetham1998', 'bhanutabeti', 'vishwajith', 'ganna09', 'pramith', 'karthikr98', 'pradeepmoturi', 'adithyahosapate', 'dj_16', 'es16btech11026', 'subhashchandra', 'devnano']",9,"['ashish.kittu10', 'mani6264', 'ee16btech11010', 'ee16btech11024', 'jvinaykumar12', 'aamir_ee', 'priya18', None, 'bharadwaj1997']",64,"['bhavya12', 'es15btech11016', 'maniyarudit', 'rajeshwarchennam', 'priya18', 'sayzeeel', 'bharadwaj1997', 'ep15btech11005', 'vishnu_33', 'hydro123', 'srinidhibachu', 'karlapatirajapradyumna', 'pulapapavan25', 'deepkarma82', 'aravindganesh', 'shengkai', 'ncsham', 'bhanutabeti', 'shanky98', 'saiashish', 'pramith', 'im2learning', 'pradeepmoturi', 'es16btech11001', 'samhitha', 're1nth', 'dj_16', 'es16btech11026', 'devnano', 'akramya98', 'es16btech11018', 'anushag', 'ee16btech11024', 'nakshatra', 'tejas_p', 'ashish.kittu10', 'rangesh', 'shardul', 'ee16btech11012', 'havish', 'chakri1804', 'chait', 'vivek2699', 'snehith', 'sidmohla', 'anuragshekhar', 'es16btech11003', 'ee16btech11013', 'preetham1998', 'ee16btech11010', 'jvinaykumar12', 'aamir_ee', 'vishwajith', 'ganna09', 'ep15btech11001', None, 'ee16btech11001', 'es15btech11010', 'mani6264', 'ee16btech11042', 'sumanth', 'karthikr98', 'adithyahosapate', 'subhashchandra']"
6,5,56,17,9,"['sidmohla', 'ee16btech11001', 'vishnu_33', 'karthikr98', 'adithyahosapate', 'dj_16', 'chait', 'ganna09', 'deepkarma82']",46,"['es16btech11018', 'bhavya12', 'es15btech11016', 'maniyarudit', 'nakshatra', 'tejas_p', 'rajeshwarchennam', 'sayzeeel', 'ep15btech11005', 'rangesh', 'shardul', 'hydro123', 'srinidhibachu', 'ee16btech11012', 'havish', 'karlapatirajapradyumna', 'pulapapavan25', 'chakri1804', 'vivek2699', 'snehith', 'aravindganesh', 'es16btech11003', 'shengkai', 'ee16btech11013', 'preetham1998', 'ncsham', 'bhanutabeti', 'anuragshekhar', 'shanky98', 'vishwajith', 'anushag', 'ep15btech11001', 'saiashish', 'pramith', 'es15btech11010', 'akramya98', 'ee16btech11042', 'im2learning', 'sumanth', 'pradeepmoturi', 'es16btech11001', 'samhitha', 're1nth', 'es16btech11026', 'subhashchandra', 'devnano']",8,"['khalidshaik', 'anandkadu4108', 'ep14btech11003', 'varthyasushanth', 'aravind03', 'es16btech11008', 'ee16btech11031', None]",63,"['es16btech11018', 'bhavya12', 'es15btech11016', 'maniyarudit', 'varthyasushanth', 'nakshatra', 'aravind03', 'tejas_p', 'subhashchandra', 'rajeshwarchennam', 'sayzeeel', 'ep15btech11005', 'rangesh', 'vishnu_33', 'shardul', 'hydro123', 'ee16btech11012', 'havish', 'karlapatirajapradyumna', 'devnano', 'pulapapavan25', 'chakri1804', 'chait', 'es16btech11008', 'vivek2699', 'deepkarma82', 'snehith', 'sidmohla', 'khalidshaik', 'aravindganesh', 'es16btech11003', 'shengkai', 'ee16btech11013', 'preetham1998', 'ncsham', 'bhanutabeti', 'anuragshekhar', 'anandkadu4108', 'ep14btech11003', 'shanky98', 'ee16btech11031', 'vishwajith', 'ganna09', 'ep15btech11001', 'saiashish', 'pramith', None, 'ee16btech11001', 'akramya98', 'es15btech11010', 'ee16btech11042', 'im2learning', 'sumanth', 'karthikr98', 'pradeepmoturi', 'es16btech11001', 'samhitha', 'adithyahosapate', 're1nth', 'dj_16', 'es16btech11026', 'srinidhibachu', 'anushag']"
7,278,55,101,23,"['jmock3', 'djgnzlz2', 'hyang89', 'dyang48', 'bhliu2', 'shukankothari97', 'cfmuir2', 'imustaly52', 'ncadler2', 'rjpavone', 'nikhilgk97', 'khuang47', 'jkim526', 'bpbaile2', 'hregner2', 'saegner2', 'jingyiw3', 'jlee742', 'ekisly2', 'jablowi2', 'ymoon11', 'jgallen3', 'ahrtmnn2']",31,"['goszkow2', 'drew.wise.10', 'jhmead2', 'jacob.dutler', 'kyleaarontaylor', 'liam.kenny96', 'alexmprather', 'qpr2', 'vs10', 'mtschmi2', 'dcschmi2', 'pgudlur', 'arovgno', 'jsshin3', 'jhbaker3', 'wtroth2', 'luiscm83', 'zlong4', 'janga1997', 'jshi3120', 'mepaul2', 'pross4', 'jeoneil15', 'jackylu2', 'statar2', 'aladd2', 'aaron.thompson.3517', 'prhogan2', 'stpoof2017', 'slohman2', 'mtschro3']",78,"['mgambin2', 'ablee2', 'janavic2', 'jrgusta2', 'kperozek2', 'rekbot2', 'yqin13', 'zzhan151', 'krupins2', 'neves2', 'qchen39', 'emwisni2', 'kkim142', 'xshan6', 'firpo2', 'jrlund3', 'elho2', 'jhardi9', 'syer2', 'adonofr2', 'slee503', 'jjmaher2', 'ychen388', 'dvaz2', 'cjbeck2', 'jmdimnd2', 'rll2', 'tsong', 'bdguo2', 'juliaeb2', 'bcperki2', 'cbott2', 'bmcnich2', 'shenxia', 'wwang114', 'clin101', 'yusenye2', 'nycbside95', None, 'ycui18', 'sharpee2', 'schoole2', 'rfbruck2', 'namiki2', 'nlbenso2', 'yyun6', 'zchen208', 'schen173', 'goodali2', 'lobryan2', 'rrmiriy2', 'mjee3', 'treppa2', 'clwhite5', 'enjucho2', 'mevtimo2', 'ylee270', 'cplant2', 'atan14', 'hzhao44', 'murobar2', 'ghe6', 'nim4', 'tson3', 'nahmoda2', 'xxia10', 'amogharavi1', 'wtso2', 'zx.9323', 'dgao5', 'dszhu2', 'rhyu2', 'conanlh2', 'masiewi2', 'aarmste2', 'hallorn2', 'khazanv2', 'twu53']",132,"['mgambin2', 'ablee2', 'jrgusta2', 'janavic2', 'kperozek2', 'bhliu2', 'jacob.dutler', 'rekbot2', 'kyleaarontaylor', 'yqin13', 'zzhan151', 'krupins2', 'dcschmi2', 'neves2', 'qchen39', 'jsshin3', 'emwisni2', 'kkim142', 'xshan6', 'mepaul2', 'firpo2', 'jrlund3', 'elho2', 'stpoof2017', 'jgallen3', 'jhardi9', 'mtschro3', 'ahrtmnn2', 'syer2', 'adonofr2', 'slee503', 'jjmaher2', 'ychen388', 'dvaz2', 'cjbeck2', 'djgnzlz2', 'dyang48', 'jmdimnd2', 'rll2', 'alexmprather', 'tsong', 'bdguo2', 'mtschmi2', 'juliaeb2', 'bcperki2', 'cbott2', 'wtroth2', 'bpbaile2', 'bmcnich2', 'hregner2', 'janga1997', 'shenxia', 'jshi3120', 'saegner2', 'jingyiw3', 'wwang114', 'clin101', 'yusenye2', 'jeoneil15', 'nycbside95', 'statar2', None, 'ekisly2', 'ycui18', 'sharpee2', 'schoole2', 'rfbruck2', 'namiki2', 'yyun6', 'nlbenso2', 'zchen208', 'schen173', 'jmock3', 'goodali2', 'lobryan2', 'drew.wise.10', 'jhmead2', 'rrmiriy2', 'liam.kenny96', 'mjee3', 'qpr2', 'imustaly52', 'ncadler2', 'treppa2', 'rjpavone', 'clwhite5', 'enjucho2', 'luiscm83', 'mevtimo2', 'jlee742', 'ylee270', 'cplant2', 'slohman2', 'zlong4', 'atan14', 'hzhao44', 'murobar2', 'ghe6', 'nim4', 'goszkow2', 'tson3', 'nahmoda2', 'hyang89', 'xxia10', 'amogharavi1', 'wtso2', 'zx.9323', 'shukankothari97', 'cfmuir2', 'dgao5', 'vs10', 'pgudlur', 'arovgno', 'dszhu2', 'jhbaker3', 'nikhilgk97', 'rhyu2', 'khuang47', 'jkim526', 'conanlh2', 'pross4', 'masiewi2', 'jackylu2', 'aarmste2', 'aladd2', 'jablowi2', 'ymoon11', 'aaron.thompson.3517', 'prhogan2', 'hallorn2', 'khazanv2', 'twu53']"
7,279,55,25,23,"['goszkow2', 'drew.wise.10', 'jhmead2', 'jacob.dutler', 'liam.kenny96', 'dcschmi2', 'vs10', 'mtschmi2', 'qpr2', 'arovgno', 'jsshin3', 'jhbaker3', 'wtroth2', 'zlong4', 'jshi3120', 'mepaul2', 'jeoneil15', 'pross4', 'statar2', 'aladd2', 'prhogan2', 'slohman2', 'mtschro3']",31,"['jmock3', 'djgnzlz2', 'hyang89', 'dyang48', 'bhliu2', 'kyleaarontaylor', 'shukankothari97', 'cfmuir2', 'alexmprather', 'pgudlur', 'imustaly52', 'ncadler2', 'rjpavone', 'nikhilgk97', 'khuang47', 'luiscm83', 'jkim526', 'bpbaile2', 'hregner2', 'janga1997', 'saegner2', 'jingyiw3', 'jlee742', 'jackylu2', 'ekisly2', 'jablowi2', 'ymoon11', 'aaron.thompson.3517', 'stpoof2017', 'jgallen3', 'ahrtmnn2']",2,"[None, 'zx.9323']",56,"['jmock3', 'drew.wise.10', 'jhmead2', 'bhliu2', 'jacob.dutler', 'kyleaarontaylor', 'liam.kenny96', 'qpr2', 'dcschmi2', 'imustaly52', 'ncadler2', 'jsshin3', 'rjpavone', 'luiscm83', 'mepaul2', 'jlee742', 'stpoof2017', 'jgallen3', 'slohman2', 'mtschro3', 'zlong4', 'ahrtmnn2', 'goszkow2', 'djgnzlz2', 'hyang89', 'dyang48', 'zx.9323', 'shukankothari97', 'cfmuir2', 'alexmprather', 'vs10', 'mtschmi2', 'pgudlur', 'arovgno', 'jhbaker3', 'nikhilgk97', 'wtroth2', 'khuang47', 'jkim526', 'bpbaile2', 'hregner2', 'janga1997', 'jshi3120', 'saegner2', 'jingyiw3', 'pross4', 'jeoneil15', 'jackylu2', 'statar2', None, 'ekisly2', 'aladd2', 'jablowi2', 'ymoon11', 'aaron.thompson.3517', 'prhogan2']"
8,55,55,65,17,"['rohanskambles', 'pranittambde', 'vrushalithakare82', 'kshete393', 'dipsbhalekar', 'harshadagaikwad145', 'dkgupata9768522176', 'vaibhavsnangare', 'swapnilbodekar', 'alyasingh51', 'nikitarane245', 'vishalyadav191096', 'payalbatwal', 'saailknarvekar', 'aakshatahadambar31', 'digr1992', 'chaitaliswnt11']",37,"['priyankamali2510', 'salaskarsu15', 'orenavikar', 'raj.misal', 'mkharkar', 'mugdhabhat1997', 'deepalisingh195', 'ssmande', 'shubham.patil585', 'vishurajigare10', 'samirbobade', 'gaurav.mishra', 'vishal914', 'uyewale', 'vishalnaik.0210', 'cm.balu05', 'nishtha.sharma406', 'vaitysushant', 'diksharth', 'svirendra31', 'niranjanbhavsar2491996', 'waynemdsouza', 'rasalvc15ex', 'skomald118', 'tc_cham', 'samuelalmeida17', 'nabhishek29', 'mdeshmukh', 'nikam468', 'n4mwolverine', 'jas.sahmbi123', 'aadi1212', 'naina', 'anil8796069443', 'akhil.shetty37', 'zil.c', 'shubhampatil2308']",48,"['ranegirish24', 'damini.rane', 'saurabhpathare304', 'rushikool12', 'prasadtrimukhe', 'pallavidshinde82', 'shubhamraut', 'shreya9609', 'manasitambat96', 'prathamesh24j', 'ashishghoderao', 'divekarpragati7', 'vinayak183', 'ronraviram789', 'satsamjr', 'priyaj1235', 'akshaygodse13', 'rutvikstar', 'nimishakurup857', 'kunaldua99999', 'mohitavhad1997', 'shirsekarakash', 'kavusatose123', 'pratikpawar4996', 'harshvardhan.gupta0696', 'dattaramkolekar', 'prasad.creativity123', 'k.vekhande69', 'divujagushte26', 'yashpimpale6', 'virajgaikwad421', 'sarveshbhoer158', 'adityawasekar11', 'siddhantpawar993', 'vedankasalunke96', 'siddhantwarankar', 'prasad24shingade', 'sayali_m9', 'apurvawaghmode14', 'megh19k', None, 'pankajpawar1515', 'chinmaysj96', 'sgharat297', 'komalparab', 'revati.naik1501', 'bhamghodke7', 'akshay1997bhagit']",102,"['priyankamali2510', 'ranegirish24', 'damini.rane', 'salaskarsu15', 'vrushalithakare82', 'saurabhpathare304', 'raj.misal', 'dkgupata9768522176', 'swapnilbodekar', 'rushikool12', 'prasadtrimukhe', 'vishalyadav191096', 'shubham.patil585', 'shreya9609', 'vishurajigare10', 'manasitambat96', 'gaurav.mishra', 'prathamesh24j', 'ashishghoderao', 'vishal914', 'vinayak183', 'uyewale', 'ronraviram789', 'cm.balu05', 'satsamjr', 'diksharth', 'nikitarane245', 'rutvikstar', 'nimishakurup857', 'shirsekarakash', 'pratikpawar4996', 'niranjanbhavsar2491996', 'aakshatahadambar31', 'waynemdsouza', 'yashpimpale6', 'skomald118', 'tc_cham', 'virajgaikwad421', 'samuelalmeida17', 'sarveshbhoer158', 'siddhantwarankar', 'nikam468', 'chaitaliswnt11', 'prasad24shingade', 'sayali_m9', 'megh19k', 'pankajpawar1515', 'dipsbhalekar', 'jas.sahmbi123', 'chinmaysj96', 'komalparab', 'naina', 'anil8796069443', 'revati.naik1501', 'zil.c', 'shubhampatil2308', 'pranittambde', 'orenavikar', 'mkharkar', 'mugdhabhat1997', 'deepalisingh195', 'ssmande', 'payalbatwal', 'pallavidshinde82', 'shubhamraut', 'samirbobade', 'divekarpragati7', 'harshadagaikwad145', 'akhil.shetty37', 'vishalnaik.0210', 'nishtha.sharma406', 'vaitysushant', 'priyaj1235', 'akshaygodse13', 'kunaldua99999', 'mohitavhad1997', 'kavusatose123', 'svirendra31', 'harshvardhan.gupta0696', 'rohanskambles', 'dattaramkolekar', 'prasad.creativity123', 'k.vekhande69', 'kshete393', 'divujagushte26', 'vaibhavsnangare', 'rasalvc15ex', 'alyasingh51', 'adityawasekar11', 'siddhantpawar993', 'vedankasalunke96', 'nabhishek29', 'mdeshmukh', 'apurvawaghmode14', None, 'digr1992', 'n4mwolverine', 'sgharat297', 'aadi1212', 'saailknarvekar', 'bhamghodke7', 'akshay1997bhagit']"
8,60,55,59,1,['samuelalmeida17'],53,"['priyankamali2510', 'pranittambde', 'salaskarsu15', 'vrushalithakare82', 'orenavikar', 'raj.misal', 'dkgupata9768522176', 'swapnilbodekar', 'mkharkar', 'mugdhabhat1997', 'deepalisingh195', 'vishalyadav191096', 'ssmande', 'payalbatwal', 'shubham.patil585', 'vishurajigare10', 'samirbobade', 'gaurav.mishra', 'vishal914', 'harshadagaikwad145', 'uyewale', 'akhil.shetty37', 'vishalnaik.0210', 'cm.balu05', 'nishtha.sharma406', 'vaitysushant', 'diksharth', 'nikitarane245', 'svirendra31', 'niranjanbhavsar2491996', 'aakshatahadambar31', 'waynemdsouza', 'rohanskambles', 'kshete393', 'vaibhavsnangare', 'rasalvc15ex', 'alyasingh51', 'skomald118', 'tc_cham', 'nabhishek29', 'mdeshmukh', 'nikam468', 'chaitaliswnt11', 'digr1992', 'n4mwolverine', 'dipsbhalekar', 'jas.sahmbi123', 'aadi1212', 'naina', 'anil8796069443', 'saailknarvekar', 'zil.c', 'shubhampatil2308']",58,"['vivekrana', 'rahul.baddi', 'pbhaveshv15et', 'deepalisas13', 'roshusakpal89', 'tanmay9', 'vinayakgadkari8', 'gnthakore', 'divya.shinde', 'brarath.nihal', 'pradhantn11e', 'varunmullins', 'suyash.sc', 'pallavivalunj', 'pratimadas1996', 'ankit.pandey', 'peterbraganza52', '1996jaypatel', 'mugdhas2030', 'spawar09', 'vaibhavkokare2011', 'adsoni468', 'stevenevendsouza23', 'sneha469', 'tushar.wadhaval', 'meet7', 'pateltejash96', 'sahilboble25', 'chahat.s', 'spodal24', 'sjayyant31', 'seemam', 'senmathew329', 'jmihavel', 'mayank.vp', 'kmamaniya', 'dhruv16', 'raj.vadariya', 'shubhamgharat274', 'singh5987', 'sonali.ramji', None, 'ketan.db', 'aditi.adilip', 'dshaikh4', 'prachiamrutkar16', 'krexianclass', 'vaishak', 'nirav.lm', 'murzellobenz', 'vvipul31', 'ninawe14', 'treesaachu', 'marcmathew', 'ssatendra31', 'vaibhavnagar08', 'yashuishwar', 'yadavsandeep793']",112,"['priyankamali2510', 'rahul.baddi', 'salaskarsu15', 'vrushalithakare82', 'deepalisas13', 'tanmay9', 'vinayakgadkari8', 'raj.misal', 'dkgupata9768522176', 'swapnilbodekar', 'vishalyadav191096', 'shubham.patil585', 'suyash.sc', 'pallavivalunj', 'vishurajigare10', 'gaurav.mishra', 'pratimadas1996', 'vishal914', 'peterbraganza52', 'uyewale', 'mugdhas2030', 'cm.balu05', 'spawar09', 'diksharth', 'nikitarane245', 'vaibhavkokare2011', 'niranjanbhavsar2491996', 'aakshatahadambar31', 'waynemdsouza', 'sahilboble25', 'seemam', 'senmathew329', 'jmihavel', 'skomald118', 'kmamaniya', 'tc_cham', 'dhruv16', 'samuelalmeida17', 'shubhamgharat274', 'singh5987', 'nikam468', 'chaitaliswnt11', 'ketan.db', 'dshaikh4', 'vaishak', 'dipsbhalekar', 'jas.sahmbi123', 'vvipul31', 'naina', 'anil8796069443', 'marcmathew', 'vaibhavnagar08', 'yashuishwar', 'zil.c', 'shubhampatil2308', 'yadavsandeep793', 'vivekrana', 'pranittambde', 'pbhaveshv15et', 'roshusakpal89', 'orenavikar', 'varunmullins', 'gnthakore', 'divya.shinde', 'brarath.nihal', 'mkharkar', 'mugdhabhat1997', 'deepalisingh195', 'pradhantn11e', 'ssmande', 'payalbatwal', 'samirbobade', 'ankit.pandey', 'harshadagaikwad145', 'akhil.shetty37', '1996jaypatel', 'vishalnaik.0210', 'nishtha.sharma406', 'vaitysushant', 'adsoni468', 'svirendra31', 'stevenevendsouza23', 'sneha469', 'tushar.wadhaval', 'meet7', 'pateltejash96', 'rohanskambles', 'chahat.s', 'kshete393', 'spodal24', 'vaibhavsnangare', 'sjayyant31', 'rasalvc15ex', 'alyasingh51', 'mayank.vp', 'raj.vadariya', 'nabhishek29', 'mdeshmukh', 'sonali.ramji', None, 'digr1992', 'n4mwolverine', 'aditi.adilip', 'prachiamrutkar16', 'krexianclass', 'nirav.lm', 'murzellobenz', 'ninawe14', 'aadi1212', 'treesaachu', 'ssatendra31', 'saailknarvekar']"
8,58,55,58,21,"['priyankamali2510', 'salaskarsu15', 'orenavikar', 'deepalisingh195', 'ssmande', 'shubham.patil585', 'vishurajigare10', 'samirbobade', 'vishal914', 'uyewale', 'vaitysushant', 'svirendra31', 'rasalvc15ex', 'skomald118', 'nabhishek29', 'mdeshmukh', 'nikam468', 'jas.sahmbi123', 'anil8796069443', 'akhil.shetty37', 'shubhampatil2308']",33,"['pranittambde', 'vrushalithakare82', 'dkgupata9768522176', 'raj.misal', 'swapnilbodekar', 'mkharkar', 'mugdhabhat1997', 'vishalyadav191096', 'payalbatwal', 'gaurav.mishra', 'harshadagaikwad145', 'vishalnaik.0210', 'cm.balu05', 'nishtha.sharma406', 'diksharth', 'nikitarane245', 'niranjanbhavsar2491996', 'aakshatahadambar31', 'waynemdsouza', 'rohanskambles', 'kshete393', 'vaibhavsnangare', 'alyasingh51', 'tc_cham', 'samuelalmeida17', 'chaitaliswnt11', 'digr1992', 'n4mwolverine', 'dipsbhalekar', 'aadi1212', 'naina', 'saailknarvekar', 'zil.c']",37,"['vivekrana', 'pbhaveshv15et', 'parineetap0', 'roshusakpal89', 'tanmay9', 'milind123', 'gnthakore', 'sushmafn', 'krunal.kasar', 'yuvraj.t', 'pratik007', 'k.gauswami', 'ralph.rodrigues69', 'spawar09', 'sagarika260710', 'patil.chinmay04', 'pranjal17', 'pateltejash96', 'sahilboble25', 'chahat.s', 'spodal24', 'sjayyant31', 'mayank.vp', 'raj.vadariya', 'sayali_m9', None, 'pratik.gc', 'dshaikh4', 'jonathanrjpereira', 'vaishak', 'nivedita', 'rubina15', 'vvipul31', 'ankitpandey1296', 'juili.save', 'shally', 'yadavsandeep793']",91,"['priyankamali2510', 'salaskarsu15', 'vrushalithakare82', 'tanmay9', 'raj.misal', 'dkgupata9768522176', 'swapnilbodekar', 'sushmafn', 'vishalyadav191096', 'shubham.patil585', 'vishurajigare10', 'yuvraj.t', 'gaurav.mishra', 'pratik007', 'vishal914', 'k.gauswami', 'uyewale', 'cm.balu05', 'spawar09', 'diksharth', 'nikitarane245', 'patil.chinmay04', 'niranjanbhavsar2491996', 'aakshatahadambar31', 'waynemdsouza', 'sahilboble25', 'skomald118', 'tc_cham', 'samuelalmeida17', 'nikam468', 'chaitaliswnt11', 'sayali_m9', 'pratik.gc', 'dshaikh4', 'vaishak', 'nivedita', 'dipsbhalekar', 'jas.sahmbi123', 'vvipul31', 'ankitpandey1296', 'naina', 'anil8796069443', 'zil.c', 'shubhampatil2308', 'yadavsandeep793', 'vivekrana', 'pranittambde', 'pbhaveshv15et', 'roshusakpal89', 'orenavikar', 'parineetap0', 'milind123', 'gnthakore', 'mkharkar', 'mugdhabhat1997', 'deepalisingh195', 'ssmande', 'payalbatwal', 'samirbobade', 'krunal.kasar', 'ralph.rodrigues69', 'harshadagaikwad145', 'akhil.shetty37', 'vishalnaik.0210', 'nishtha.sharma406', 'vaitysushant', 'svirendra31', 'sagarika260710', 'pranjal17', 'pateltejash96', 'rohanskambles', 'shally', 'chahat.s', 'kshete393', 'spodal24', 'vaibhavsnangare', 'sjayyant31', 'rasalvc15ex', 'alyasingh51', 'mayank.vp', 'raj.vadariya', 'nabhishek29', 'mdeshmukh', None, 'digr1992', 'n4mwolverine', 'jonathanrjpereira', 'rubina15', 'aadi1212', 'juili.save', 'saailknarvekar']"
8,56,55,50,19,"['priyankamali2510', 'raj.misal', 'mkharkar', 'mugdhabhat1997', 'ssmande', 'samirbobade', 'gaurav.mishra', 'uyewale', 'vishalnaik.0210', 'vaitysushant', 'diksharth', 'niranjanbhavsar2491996', 'waynemdsouza', 'samuelalmeida17', 'mdeshmukh', 'aadi1212', 'naina', 'anil8796069443', 'zil.c']",35,"['pranittambde', 'salaskarsu15', 'vrushalithakare82', 'orenavikar', 'dkgupata9768522176', 'swapnilbodekar', 'deepalisingh195', 'vishalyadav191096', 'payalbatwal', 'shubham.patil585', 'vishurajigare10', 'vishal914', 'harshadagaikwad145', 'akhil.shetty37', 'cm.balu05', 'nishtha.sharma406', 'nikitarane245', 'svirendra31', 'aakshatahadambar31', 'rohanskambles', 'kshete393', 'vaibhavsnangare', 'rasalvc15ex', 'alyasingh51', 'skomald118', 'tc_cham', 'nabhishek29', 'nikam468', 'chaitaliswnt11', 'digr1992', 'n4mwolverine', 'dipsbhalekar', 'jas.sahmbi123', 'saailknarvekar', 'shubhampatil2308']",31,"['prakshat095', 'tanmay9', 'milind123', 'gnthakore', 'sakshi.mandot', 'adnan.s', 'krunal.kasar', 'yuvraj.t', 'shrey.joshi', 'k.gauswami', 'shreyas.v', 'dkbathe29', 'pateltejash96', 'sahilboble25', 'mkhanvilkar', 'dghosalkar', 'suhayl4k', 'seemam', 'mahajanyashashree19', 'mayank.vp', 'pravingowda28', 'nairabhi1571996', 'sayali_m9', None, 'pratik.gc', 'pjay10708', 'nirav.lm', 'vaishak', 'nivedita', 'bharatesh.a', 'yadavsandeep793']",85,"['priyankamali2510', 'salaskarsu15', 'vrushalithakare82', 'tanmay9', 'raj.misal', 'dkgupata9768522176', 'swapnilbodekar', 'sakshi.mandot', 'adnan.s', 'vishalyadav191096', 'shubham.patil585', 'vishurajigare10', 'yuvraj.t', 'gaurav.mishra', 'vishal914', 'k.gauswami', 'uyewale', 'cm.balu05', 'diksharth', 'nikitarane245', 'shreyas.v', 'niranjanbhavsar2491996', 'aakshatahadambar31', 'waynemdsouza', 'sahilboble25', 'suhayl4k', 'seemam', 'skomald118', 'tc_cham', 'samuelalmeida17', 'nikam468', 'chaitaliswnt11', 'sayali_m9', 'pratik.gc', 'vaishak', 'nivedita', 'dipsbhalekar', 'jas.sahmbi123', 'naina', 'anil8796069443', 'zil.c', 'shubhampatil2308', 'yadavsandeep793', 'prakshat095', 'pranittambde', 'orenavikar', 'milind123', 'gnthakore', 'mkharkar', 'mugdhabhat1997', 'deepalisingh195', 'ssmande', 'payalbatwal', 'samirbobade', 'krunal.kasar', 'shrey.joshi', 'harshadagaikwad145', 'akhil.shetty37', 'vishalnaik.0210', 'nishtha.sharma406', 'vaitysushant', 'dkbathe29', 'svirendra31', 'pateltejash96', 'rohanskambles', 'mkhanvilkar', 'dghosalkar', 'kshete393', 'vaibhavsnangare', 'rasalvc15ex', 'alyasingh51', 'mahajanyashashree19', 'mayank.vp', 'pravingowda28', 'nabhishek29', 'mdeshmukh', 'nairabhi1571996', None, 'digr1992', 'n4mwolverine', 'pjay10708', 'nirav.lm', 'aadi1212', 'bharatesh.a', 'saailknarvekar']"
8,239,55,19,1,['samuelalmeida17'],53,"['priyankamali2510', 'pranittambde', 'salaskarsu15', 'vrushalithakare82', 'orenavikar', 'raj.misal', 'dkgupata9768522176', 'swapnilbodekar', 'mkharkar', 'mugdhabhat1997', 'deepalisingh195', 'vishalyadav191096', 'ssmande', 'payalbatwal', 'shubham.patil585', 'vishurajigare10', 'samirbobade', 'gaurav.mishra', 'vishal914', 'harshadagaikwad145', 'uyewale', 'akhil.shetty37', 'vishalnaik.0210', 'cm.balu05', 'nishtha.sharma406', 'vaitysushant', 'diksharth', 'nikitarane245', 'svirendra31', 'niranjanbhavsar2491996', 'aakshatahadambar31', 'waynemdsouza', 'rohanskambles', 'kshete393', 'vaibhavsnangare', 'rasalvc15ex', 'alyasingh51', 'skomald118', 'tc_cham', 'nabhishek29', 'mdeshmukh', 'nikam468', 'chaitaliswnt11', 'digr1992', 'n4mwolverine', 'dipsbhalekar', 'jas.sahmbi123', 'aadi1212', 'naina', 'anil8796069443', 'saailknarvekar', 'zil.c', 'shubhampatil2308']",18,"['samsonkajar', None, 'neetavarkute', 'prajoth.fernandes', 'tinu', 'ralph.rodrigues69', 'danieldsilva96', 'kruti.pradnil', 'livz944', 'sushmafn', 'swapnalimakdey25', 'treesaachu', 'mansikakrecha', 'aditya332', 'juili.save', 'hamad42623', 'bhadreshwarak308', 'pragatidhekale']",72,"['priyankamali2510', 'pranittambde', 'salaskarsu15', 'vrushalithakare82', 'orenavikar', 'neetavarkute', 'raj.misal', 'dkgupata9768522176', 'swapnilbodekar', 'mkharkar', 'mugdhabhat1997', 'deepalisingh195', 'livz944', 'sushmafn', 'vishalyadav191096', 'ssmande', 'payalbatwal', 'shubham.patil585', 'vishurajigare10', 'samirbobade', 'gaurav.mishra', 'samsonkajar', 'prajoth.fernandes', 'vishal914', 'tinu', 'ralph.rodrigues69', 'harshadagaikwad145', 'uyewale', 'vishalnaik.0210', 'cm.balu05', 'nishtha.sharma406', 'vaitysushant', 'diksharth', 'nikitarane245', 'svirendra31', 'niranjanbhavsar2491996', 'aakshatahadambar31', 'waynemdsouza', 'bhadreshwarak308', 'rohanskambles', 'kshete393', 'vaibhavsnangare', 'rasalvc15ex', 'alyasingh51', 'skomald118', 'tc_cham', 'samuelalmeida17', 'saailknarvekar', 'nabhishek29', 'mdeshmukh', 'nikam468', 'chaitaliswnt11', 'hamad42623', None, 'digr1992', 'n4mwolverine', 'pragatidhekale', 'mansikakrecha', 'dipsbhalekar', 'jas.sahmbi123', 'danieldsilva96', 'kruti.pradnil', 'aadi1212', 'swapnalimakdey25', 'treesaachu', 'naina', 'anil8796069443', 'aditya332', 'juili.save', 'akhil.shetty37', 'zil.c', 'shubhampatil2308']"
8,241,55,18,1,['samuelalmeida17'],53,"['priyankamali2510', 'pranittambde', 'salaskarsu15', 'vrushalithakare82', 'orenavikar', 'raj.misal', 'dkgupata9768522176', 'swapnilbodekar', 'mkharkar', 'mugdhabhat1997', 'deepalisingh195', 'vishalyadav191096', 'ssmande', 'payalbatwal', 'shubham.patil585', 'vishurajigare10', 'samirbobade', 'gaurav.mishra', 'vishal914', 'harshadagaikwad145', 'uyewale', 'akhil.shetty37', 'vishalnaik.0210', 'cm.balu05', 'nishtha.sharma406', 'vaitysushant', 'diksharth', 'nikitarane245', 'svirendra31', 'niranjanbhavsar2491996', 'aakshatahadambar31', 'waynemdsouza', 'rohanskambles', 'kshete393', 'vaibhavsnangare', 'rasalvc15ex', 'alyasingh51', 'skomald118', 'tc_cham', 'nabhishek29', 'mdeshmukh', 'nikam468', 'chaitaliswnt11', 'digr1992', 'n4mwolverine', 'dipsbhalekar', 'jas.sahmbi123', 'aadi1212', 'naina', 'anil8796069443', 'saailknarvekar', 'zil.c', 'shubhampatil2308']",17,"['moraeseric123', 'krexianclass', None, 'murzellobenz', 'dcruzdylan50', 'varunmullins', 'senmathew329', 'danieldsilva96', 'kmamaniya', 'marcmathew19', 'swapnalimakdey25', 'treesaachu', 'mmgmahendra', 'moraes.amos', 'vaibhavnagar08', 'bhadreshwarak308', 'mansikakrecha']",71,"['priyankamali2510', 'pranittambde', 'salaskarsu15', 'vrushalithakare82', 'orenavikar', 'varunmullins', 'raj.misal', 'dkgupata9768522176', 'swapnilbodekar', 'mkharkar', 'mugdhabhat1997', 'deepalisingh195', 'vishalyadav191096', 'ssmande', 'payalbatwal', 'shubham.patil585', 'mmgmahendra', 'vishurajigare10', 'samirbobade', 'gaurav.mishra', 'vishal914', 'harshadagaikwad145', 'uyewale', 'vishalnaik.0210', 'cm.balu05', 'nishtha.sharma406', 'vaitysushant', 'diksharth', 'nikitarane245', 'moraes.amos', 'svirendra31', 'niranjanbhavsar2491996', 'aakshatahadambar31', 'waynemdsouza', 'bhadreshwarak308', 'rohanskambles', 'kshete393', 'vaibhavsnangare', 'rasalvc15ex', 'alyasingh51', 'skomald118', 'senmathew329', 'kmamaniya', 'tc_cham', 'marcmathew19', 'samuelalmeida17', 'saailknarvekar', 'nabhishek29', 'mdeshmukh', 'nikam468', 'chaitaliswnt11', None, 'digr1992', 'n4mwolverine', 'mansikakrecha', 'moraeseric123', 'krexianclass', 'dcruzdylan50', 'dipsbhalekar', 'murzellobenz', 'jas.sahmbi123', 'danieldsilva96', 'aadi1212', 'swapnalimakdey25', 'treesaachu', 'naina', 'anil8796069443', 'vaibhavnagar08', 'akhil.shetty37', 'zil.c', 'shubhampatil2308']"
8,62,55,13,1,['samuelalmeida17'],53,"['priyankamali2510', 'pranittambde', 'salaskarsu15', 'vrushalithakare82', 'orenavikar', 'raj.misal', 'dkgupata9768522176', 'swapnilbodekar', 'mkharkar', 'mugdhabhat1997', 'deepalisingh195', 'vishalyadav191096', 'ssmande', 'payalbatwal', 'shubham.patil585', 'vishurajigare10', 'samirbobade', 'gaurav.mishra', 'vishal914', 'harshadagaikwad145', 'uyewale', 'akhil.shetty37', 'vishalnaik.0210', 'cm.balu05', 'nishtha.sharma406', 'vaitysushant', 'diksharth', 'nikitarane245', 'svirendra31', 'niranjanbhavsar2491996', 'aakshatahadambar31', 'waynemdsouza', 'rohanskambles', 'kshete393', 'vaibhavsnangare', 'rasalvc15ex', 'alyasingh51', 'skomald118', 'tc_cham', 'nabhishek29', 'mdeshmukh', 'nikam468', 'chaitaliswnt11', 'digr1992', 'n4mwolverine', 'dipsbhalekar', 'jas.sahmbi123', 'aadi1212', 'naina', 'anil8796069443', 'saailknarvekar', 'zil.c', 'shubhampatil2308']",12,"['pratimadas1996', 'vinayakgadkari8', 'varunmullins', 'mugdhas2030', 'brarath.nihal', 'jmihavel', 'stevenevendsouza23', 'treesaachu', 'vaibhavkokare2011', 'marcmathew', 'vaibhavnagar08', None]",66,"['priyankamali2510', 'pranittambde', 'salaskarsu15', 'vrushalithakare82', 'orenavikar', 'vinayakgadkari8', 'raj.misal', 'dkgupata9768522176', 'swapnilbodekar', 'mkharkar', 'mugdhabhat1997', 'deepalisingh195', 'varunmullins', 'brarath.nihal', 'vishalyadav191096', 'ssmande', 'payalbatwal', 'shubham.patil585', 'vishurajigare10', 'samirbobade', 'gaurav.mishra', 'pratimadas1996', 'vishal914', 'harshadagaikwad145', 'uyewale', 'mugdhas2030', 'vishalnaik.0210', 'cm.balu05', 'nishtha.sharma406', 'vaitysushant', 'diksharth', 'nikitarane245', 'vaibhavkokare2011', 'stevenevendsouza23', 'svirendra31', 'niranjanbhavsar2491996', 'aakshatahadambar31', 'waynemdsouza', 'rohanskambles', 'kshete393', 'vaibhavsnangare', 'rasalvc15ex', 'alyasingh51', 'skomald118', 'jmihavel', 'tc_cham', 'samuelalmeida17', 'saailknarvekar', 'nabhishek29', 'mdeshmukh', 'nikam468', 'chaitaliswnt11', None, 'digr1992', 'n4mwolverine', 'dipsbhalekar', 'jas.sahmbi123', 'aadi1212', 'treesaachu', 'naina', 'anil8796069443', 'marcmathew', 'vaibhavnagar08', 'akhil.shetty37', 'zil.c', 'shubhampatil2308']"
8,57,55,7,3,"['waynemdsouza', 'samuelalmeida17', 'mugdhabhat1997']",51,"['priyankamali2510', 'pranittambde', 'salaskarsu15', 'vrushalithakare82', 'orenavikar', 'raj.misal', 'dkgupata9768522176', 'swapnilbodekar', 'mkharkar', 'deepalisingh195', 'vishalyadav191096', 'ssmande', 'payalbatwal', 'shubham.patil585', 'vishurajigare10', 'samirbobade', 'gaurav.mishra', 'vishal914', 'harshadagaikwad145', 'uyewale', 'vishalnaik.0210', 'cm.balu05', 'nishtha.sharma406', 'vaitysushant', 'diksharth', 'nikitarane245', 'svirendra31', 'niranjanbhavsar2491996', 'aakshatahadambar31', 'rohanskambles', 'kshete393', 'vaibhavsnangare', 'rasalvc15ex', 'alyasingh51', 'skomald118', 'tc_cham', 'saailknarvekar', 'nabhishek29', 'mdeshmukh', 'nikam468', 'chaitaliswnt11', 'digr1992', 'n4mwolverine', 'dipsbhalekar', 'jas.sahmbi123', 'aadi1212', 'naina', 'anil8796069443', 'akhil.shetty37', 'zil.c', 'shubhampatil2308']",4,"['stevenevendsouza23', 'aayush2298', None, 'peterbraganza52']",58,"['priyankamali2510', 'pranittambde', 'salaskarsu15', 'vrushalithakare82', 'orenavikar', 'raj.misal', 'dkgupata9768522176', 'swapnilbodekar', 'mkharkar', 'mugdhabhat1997', 'deepalisingh195', 'vishalyadav191096', 'ssmande', 'payalbatwal', 'shubham.patil585', 'vishurajigare10', 'samirbobade', 'gaurav.mishra', 'vishal914', 'peterbraganza52', 'harshadagaikwad145', 'uyewale', 'vishalnaik.0210', 'cm.balu05', 'nishtha.sharma406', 'vaitysushant', 'diksharth', 'nikitarane245', 'stevenevendsouza23', 'svirendra31', 'niranjanbhavsar2491996', 'aakshatahadambar31', 'waynemdsouza', 'rohanskambles', 'kshete393', 'vaibhavsnangare', 'rasalvc15ex', 'alyasingh51', 'skomald118', 'tc_cham', 'samuelalmeida17', 'saailknarvekar', 'nabhishek29', 'mdeshmukh', 'nikam468', 'chaitaliswnt11', 'aayush2298', None, 'digr1992', 'n4mwolverine', 'dipsbhalekar', 'jas.sahmbi123', 'aadi1212', 'naina', 'anil8796069443', 'akhil.shetty37', 'zil.c', 'shubhampatil2308']"
9,13,52,68,45,"['sgu20131430', 'sgu20131440', 'sgu20131467', 'sgu20131507', 'sgu20141523', 'mightynebula', 'sgu20151515', 'sgu20131500', 'sgu20131486', 'sgu20151469', 'sgu20111471', 'sgu20131489', 'sgu20101584', 'sgu20131429', 'sgu20131413', 'sgu20131496', 'sgu20131482', 'sgu20141452', 'sgu20131504', 'sgu20111512', 'sgu20141488', 'sgu20131426', 'sgu20131471', 'sgu20131494', 'sgu20121439', 'sgu20121486', 'sgu20151423', 'sgu20131443', 'amirr89', 'sgu20141419', 'sgu20131437', 'sgu20111258', 'sgu20111794', 'sgu20121452', 'sgu20121423', 'sgu20131466', 'sgu20131509', 'sgu20121502', 'sgu20141401', 'sgu20131499', 'sgu20131469', 'sgu20141403', 'sgu20141310', 'ruth59', 'sgu20121510']",6,"['mohamedhelal', 'alidrashwan', 'youssefemad', 'paul94', 'norchan', 'b.buynaa01']",23,"['honnyou', 'sgu20131478', 'sgu20111537', 'sgu20121472', 'luysunyoung9', 'miiinji', 'kjt93', 'k910716kim', 'kangtae', 'qpqp072472', '1022jinhee', 'sgu20101494', 'sgu20121528', None, 'skzl34', 'bongwhan12', 'sgu20131422', 'sgu20131479', 'sgu201311413', 'angyi90', 'sgu20121494', 'sgu20151450', 'claritas']",74,"['sgu20131478', 'sgu20131430', 'sgu20121472', 'luysunyoung9', 'sgu20131507', 'sgu20141523', 'mightynebula', 'sgu20151515', 'b.buynaa01', 'miiinji', 'sgu20131413', 'kjt93', 'sgu20141452', 'sgu20141488', 'sgu20111512', 'sgu20131426', 'sgu20131471', '1022jinhee', 'sgu20131494', 'sgu20151423', 'sgu20101494', 'sgu20131443', 'amirr89', 'sgu20141419', 'alidrashwan', 'sgu20111258', 'sgu20121528', 'sgu20131422', 'youssefemad', 'sgu201311413', 'claritas', 'paul94', 'sgu20121494', 'sgu20151450', 'sgu20121502', 'sgu20131437', 'sgu20141401', 'sgu20141403', 'sgu20131509', 'ruth59', 'sgu20121510', 'honnyou', 'sgu20111537', 'sgu20131440', 'mohamedhelal', 'sgu20131467', 'sgu20131500', 'norchan', 'sgu20111471', 'sgu20131489', 'sgu20101584', 'sgu20131429', 'sgu20131496', 'sgu20131482', 'k910716kim', 'sgu20131504', 'kangtae', 'qpqp072472', 'sgu20121439', 'sgu20121486', 'sgu20111794', 'skzl34', None, 'bongwhan12', 'sgu20121452', 'sgu20131479', 'sgu20121423', 'angyi90', 'sgu20131466', 'sgu20131499', 'sgu20131469', 'sgu20131486', 'sgu20141310', 'sgu20151469']"
9,39,52,58,44,"['sgu20131430', 'sgu20131440', 'sgu20131467', 'sgu20131507', 'sgu20141523', 'mightynebula', 'sgu20151515', 'sgu20131500', 'sgu20131486', 'sgu20111471', 'sgu20131489', 'sgu20101584', 'sgu20131429', 'sgu20131413', 'sgu20131496', 'sgu20131482', 'sgu20141452', 'sgu20131504', 'sgu20111512', 'sgu20141488', 'sgu20131426', 'sgu20131471', 'sgu20131494', 'sgu20121439', 'sgu20121486', 'sgu20151423', 'sgu20131443', 'amirr89', 'sgu20141419', 'sgu20131437', 'sgu20111258', 'sgu20111794', 'sgu20121452', 'sgu20121423', 'sgu20131466', 'sgu20131509', 'sgu20121502', 'sgu20141401', 'sgu20131499', 'sgu20131469', 'sgu20141403', 'sgu20141310', 'ruth59', 'sgu20121510']",7,"['mohamedhelal', 'alidrashwan', 'youssefemad', 'paul94', 'norchan', 'b.buynaa01', 'sgu20151469']",14,"['brahms0827', 'sgu20131422', 'sgu20121472', 'pplongi', 'sgu20121466', 'sgu20121450', 'sg20121208', 'sgu20131419', 'kangtae', 'kcj1127', 'tulv37', 'sgu20121494', 'sgu20121528', None]",65,"['sgu20131430', 'sgu20121472', 'sgu20131507', 'sgu20141523', 'mightynebula', 'sgu20151515', 'b.buynaa01', 'sgu20131413', 'sgu20141452', 'sgu20141488', 'sgu20111512', 'sgu20131426', 'pplongi', 'sg20121208', 'kcj1127', 'sgu20131471', 'sgu20131494', 'sgu20151423', 'sgu20131443', 'amirr89', 'sgu20141419', 'alidrashwan', 'sgu20111258', 'sgu20121528', 'sgu20131422', 'youssefemad', 'sgu20121466', 'paul94', 'sgu20121494', 'sgu20121502', 'sgu20131437', 'sgu20141401', 'sgu20141403', 'sgu20131509', 'ruth59', 'sgu20121510', 'sgu20131440', 'mohamedhelal', 'sgu20131467', 'sgu20131500', 'norchan', 'sgu20111471', 'sgu20131489', 'sgu20101584', 'sgu20131429', 'sgu20131496', 'sgu20131482', 'sgu20131504', 'kangtae', 'tulv37', 'sgu20121439', 'sgu20121486', 'brahms0827', 'sgu20111794', None, 'sgu20121452', 'sgu20121423', 'sgu20121450', 'sgu20131466', 'sgu20131419', 'sgu20131499', 'sgu20131469', 'sgu20131486', 'sgu20141310', 'sgu20151469']"
9,28,52,54,42,"['sgu20131430', 'sgu20131440', 'sgu20141523', 'sgu20151515', 'mightynebula', 'sgu20131500', 'sgu20131486', 'sgu20151469', 'sgu20111471', 'sgu20131489', 'sgu20131429', 'sgu20131413', 'sgu20131496', 'sgu20131482', 'sgu20141452', 'sgu20131504', 'sgu20111512', 'sgu20141488', 'sgu20131426', 'sgu20131471', 'sgu20131494', 'sgu20121439', 'sgu20121486', 'sgu20151423', 'sgu20131443', 'amirr89', 'sgu20141419', 'sgu20131437', 'sgu20111258', 'sgu20111794', 'sgu20121452', 'sgu20121423', 'sgu20131466', 'sgu20131509', 'sgu20121502', 'sgu20141401', 'sgu20131499', 'sgu20131469', 'sgu20141403', 'sgu20141310', 'ruth59', 'sgu20121510']",9,"['mohamedhelal', 'alidrashwan', 'youssefemad', 'sgu20131467', 'sgu20131507', 'paul94', 'norchan', 'b.buynaa01', 'sgu20101584']",12,"[None, 'sgu20111537', 'sgu20131422', 'sgu20121472', 'sg20121208', 'sgu20131419', 'skzl34', 'sgu20151450', 'sgu20121494', '1022jinhee', 'miiinji', 'bongwhan12']",63,"['sgu20131430', 'sgu20121472', 'sgu20131507', 'sgu20141523', 'mightynebula', 'sgu20151515', 'b.buynaa01', 'miiinji', 'sgu20131413', 'sgu20141452', 'sgu20141488', 'sgu20111512', 'sgu20131426', 'sg20121208', 'sgu20131471', '1022jinhee', 'sgu20131494', 'sgu20151423', 'sgu20131443', 'amirr89', 'sgu20141419', 'alidrashwan', 'sgu20111258', 'sgu20131422', 'youssefemad', 'paul94', 'sgu20151450', 'sgu20121494', 'sgu20121502', 'sgu20131437', 'sgu20141401', 'sgu20141403', 'sgu20131509', 'ruth59', 'sgu20121510', 'sgu20111537', 'sgu20131440', 'mohamedhelal', 'sgu20131467', 'sgu20131500', 'norchan', 'sgu20111471', 'sgu20131489', 'sgu20101584', 'sgu20131429', 'sgu20131496', 'sgu20131482', 'sgu20131504', 'sgu20121439', 'sgu20121486', 'sgu20111794', 'skzl34', None, 'bongwhan12', 'sgu20121452', 'sgu20121423', 'sgu20131466', 'sgu20131419', 'sgu20131499', 'sgu20131469', 'sgu20131486', 'sgu20141310', 'sgu20151469']"
9,34,52,54,1,['youssefemad'],50,"['sgu20131430', 'sgu20131440', 'mohamedhelal', 'sgu20131467', 'sgu20131507', 'sgu20141523', 'mightynebula', 'sgu20151515', 'sgu20131500', 'norchan', 'sgu20131486', 'sgu20151469', 'sgu20111471', 'b.buynaa01', 'sgu20131489', 'sgu20101584', 'sgu20131429', 'sgu20131413', 'sgu20131496', 'sgu20131482', 'sgu20141452', 'sgu20131504', 'sgu20111512', 'sgu20141488', 'sgu20131426', 'sgu20131471', 'sgu20131494', 'sgu20121439', 'sgu20121486', 'sgu20151423', 'sgu20131443', 'amirr89', 'sgu20141419', 'alidrashwan', 'sgu20131437', 'sgu20111258', 'sgu20111794', 'sgu20121452', 'sgu20121423', 'paul94', 'sgu20131466', 'sgu20131509', 'sgu20121502', 'sgu20141401', 'sgu20131499', 'sgu20131469', 'sgu20141403', 'sgu20141310', 'ruth59', 'sgu20121510']",53,"['rehamkandel', 'karimelmeligy', 'youstinamamdouh', 'mohamedabdelmaksoud1096', 'perihansherif', 'shrouk_mahmoud', 'mahmoudtarek313', 'mostafanazim1', 'ahmedreda0', 'jljhgjvlm', 'shimaaezz149', 'yumnafmoussa', 'yehia', 'sararadwan', 'ranaahmed96', 'passantali', 'jailanosamaa', 'mosa_nosa', 'shimaaezz1495', 'fatma_aly2010', 'yaraahmeed7777', 'sara.saso9686', 'yehiafarouk.asurt', 'abdo1703', 'esraaezzzz', 'abdelrhman', 'mahmoudtarak51', 'abdorady', 'mernaosama40', 'hadilmazen10', 'menna_sarhan97', 'monmon', 'yehiaafaroukk', 'mustafa.maged95', 'hager.mostafa14.ah', 'mostafasami1996', 'mustafamagdy2020', 'nourhangamal', 'youstina1996mamdouh', 'ahmedashrafalaaser', 'tyo78790', None, 'sara_khaled1997', 'karim.tera1', 'sandy_sameh', 'abdelrahmanmagdy2022', 'manarahmeed', 'habib1996', 'mohamedtarek.mt450', 'nada_y', 'abdelrahmanelmy96', 'mnorhan1997', 'wa7sh19962013']",104,"['rehamkandel', 'sgu20131430', 'sgu20131507', 'sgu20141523', 'mightynebula', 'sgu20151515', 'mostafanazim1', 'ahmedreda0', 'b.buynaa01', 'shimaaezz149', 'sgu20131413', 'sararadwan', 'sgu20141452', 'sgu20141488', 'sgu20111512', 'sgu20131426', 'passantali', 'mosa_nosa', 'shimaaezz1495', 'yaraahmeed7777', 'sara.saso9686', 'yehiafarouk.asurt', 'abdo1703', 'sgu20131471', 'esraaezzzz', 'sgu20131494', 'abdelrhman', 'mahmoudtarak51', 'mernaosama40', 'sgu20151423', 'monmon', 'sgu20131443', 'amirr89', 'sgu20141419', 'alidrashwan', 'yehiaafaroukk', 'hager.mostafa14.ah', 'mustafamagdy2020', 'nourhangamal', 'sgu20111258', 'tyo78790', 'sandy_sameh', 'youssefemad', 'paul94', 'sgu20121502', 'sgu20131437', 'sgu20141401', 'abdelrahmanelmy96', 'mnorhan1997', 'sgu20141403', 'sgu20131509', 'ruth59', 'sgu20121510', 'wa7sh19962013', 'karimelmeligy', 'youstinamamdouh', 'mohamedabdelmaksoud1096', 'sgu20131440', 'perihansherif', 'mohamedhelal', 'shrouk_mahmoud', 'sgu20131467', 'mahmoudtarek313', 'sgu20131500', 'norchan', 'jljhgjvlm', 'sgu20111471', 'sgu20131489', 'sgu20101584', 'sgu20131429', 'yehia', 'sgu20131496', 'sgu20131482', 'yumnafmoussa', 'ranaahmed96', 'sgu20131504', 'jailanosamaa', 'fatma_aly2010', 'abdorady', 'sgu20121439', 'sgu20121486', 'hadilmazen10', 'menna_sarhan97', 'mustafa.maged95', 'mostafasami1996', 'youstina1996mamdouh', 'ahmedashrafalaaser', 'sgu20111794', None, 'sgu20121452', 'sara_khaled1997', 'karim.tera1', 'abdelrahmanmagdy2022', 'manarahmeed', 'sgu20121423', 'habib1996', 'mohamedtarek.mt450', 'nada_y', 'sgu20131466', 'sgu20131499', 'sgu20131469', 'sgu20131486', 'sgu20141310', 'sgu20151469']"
9,41,52,41,5,"['mohamedhelal', 'alidrashwan', 'youssefemad', 'paul94', 'norchan']",46,"['sgu20131430', 'sgu20131440', 'sgu20131467', 'sgu20131507', 'sgu20141523', 'mightynebula', 'sgu20151515', 'sgu20131500', 'sgu20131486', 'sgu20151469', 'sgu20111471', 'b.buynaa01', 'sgu20131489', 'sgu20101584', 'sgu20131429', 'sgu20131413', 'sgu20131496', 'sgu20131482', 'sgu20141452', 'sgu20131504', 'sgu20111512', 'sgu20141488', 'sgu20131426', 'sgu20131471', 'sgu20131494', 'sgu20121439', 'sgu20121486', 'sgu20151423', 'sgu20131443', 'amirr89', 'sgu20141419', 'sgu20131437', 'sgu20111258', 'sgu20111794', 'sgu20121452', 'sgu20121423', 'sgu20131466', 'sgu20131509', 'sgu20121502', 'sgu20141401', 'sgu20131499', 'sgu20131469', 'sgu20141403', 'sgu20141310', 'ruth59', 'sgu20121510']",36,"['marinaboules9', 'mfathy97', 'theinstructive_man', 'ahmad.abdelaziz.ibrahim', 'sandy_luxor', 'hebaismail', 'es.so1995', 'emara2756300', 'hanatouni97', 'zyad_2012', 'ahmedelkayal', 'masterrub', 'monicaaziz', 'abdelaziz', 'monicaaziz31', 'mohamedali915', 'ahmed.saeed', 'ahmedbakla94', 'ahmadessam1997', 'ok97', 'engynageeb97', 'omarkhaledgadallah', 'ahmed.k.shaker', 'h_ash96', 'gannatmagdy0', 'sohaanaselmashad', 'mido28elashmawy', None, 'amrkotb', 'olamansour21', 'minaadel2017', 'nadermoussa1', 'mohamed_tahoun', 'bel5525', 'ahmed_yahia', 'ayausama1997']",87,"['marinaboules9', 'mfathy97', 'sgu20131430', 'theinstructive_man', 'sgu20131507', 'sgu20141523', 'mightynebula', 'sgu20151515', 'b.buynaa01', 'emara2756300', 'hanatouni97', 'sgu20131413', 'zyad_2012', 'sgu20141452', 'sgu20141488', 'sgu20111512', 'sgu20131426', 'masterrub', 'monicaaziz', 'abdelaziz', 'ok97', 'mohamedali915', 'ahmedbakla94', 'sgu20131471', 'sgu20131494', 'omarkhaledgadallah', 'h_ash96', 'sgu20151423', 'sgu20131443', 'amirr89', 'sgu20141419', 'alidrashwan', 'sohaanaselmashad', 'mido28elashmawy', 'sgu20111258', 'youssefemad', 'amrkotb', 'olamansour21', 'paul94', 'mohamed_tahoun', 'bel5525', 'ahmed_yahia', 'sgu20121502', 'sgu20131437', 'sgu20141401', 'ayausama1997', 'sgu20141403', 'sgu20131509', 'ruth59', 'sgu20121510', 'sgu20131440', 'mohamedhelal', 'sgu20131467', 'ahmad.abdelaziz.ibrahim', 'sandy_luxor', 'sgu20131500', 'norchan', 'hebaismail', 'es.so1995', 'sgu20111471', 'sgu20131489', 'sgu20101584', 'sgu20131429', 'sgu20131496', 'sgu20131482', 'ahmedelkayal', 'sgu20131504', 'monicaaziz31', 'ahmed.saeed', 'ahmadessam1997', 'engynageeb97', 'ahmed.k.shaker', 'sgu20121439', 'sgu20121486', 'gannatmagdy0', 'sgu20111794', None, 'sgu20121452', 'sgu20121423', 'minaadel2017', 'nadermoussa1', 'sgu20131466', 'sgu20131499', 'sgu20131469', 'sgu20131486', 'sgu20141310', 'sgu20151469']"
9,37,52,32,26,"['sgu20131430', 'sgu20131467', 'sgu20131507', 'sgu20141523', 'mightynebula', 'sgu20131500', 'sgu20151515', 'sgu20131413', 'sgu20131496', 'sgu20141452', 'sgu20141488', 'sgu20131504', 'sgu20131426', 'sgu20151423', 'sgu20131443', 'amirr89', 'sgu20111794', 'sgu20121452', 'sgu20121423', 'sgu20131466', 'sgu20131437', 'sgu20141401', 'sgu20131499', 'sgu20131509', 'ruth59', 'sgu20121510']",25,"['sgu20131440', 'mohamedhelal', 'norchan', 'sgu20131486', 'sgu20111471', 'b.buynaa01', 'sgu20131489', 'sgu20101584', 'sgu20131429', 'sgu20131482', 'sgu20111512', 'sgu20131471', 'sgu20131494', 'sgu20121439', 'sgu20121486', 'sgu20141419', 'alidrashwan', 'sgu20111258', 'youssefemad', 'paul94', 'sgu20121502', 'sgu20131469', 'sgu20141403', 'sgu20141310', 'sgu20151469']",6,"['sgu20131422', 'sgu20121472', 'sg20121208', 'sgu20131419', 'sgu20121494', None]",57,"['sgu20131430', 'sgu20121472', 'sgu20131507', 'sgu20141523', 'mightynebula', 'sgu20151515', 'b.buynaa01', 'sgu20131413', 'sgu20141452', 'sgu20141488', 'sgu20111512', 'sgu20131426', 'sg20121208', 'sgu20131471', 'sgu20131494', 'sgu20151423', 'sgu20131443', 'amirr89', 'sgu20141419', 'alidrashwan', 'sgu20111258', 'sgu20131422', 'youssefemad', 'paul94', 'sgu20121494', 'sgu20121502', 'sgu20131437', 'sgu20141401', 'sgu20141403', 'sgu20131509', 'ruth59', 'sgu20121510', 'sgu20131440', 'mohamedhelal', 'sgu20131467', 'sgu20131500', 'norchan', 'sgu20111471', 'sgu20131489', 'sgu20101584', 'sgu20131429', 'sgu20131496', 'sgu20131482', 'sgu20131504', 'sgu20121439', 'sgu20121486', 'sgu20111794', None, 'sgu20121452', 'sgu20121423', 'sgu20131466', 'sgu20131419', 'sgu20131499', 'sgu20131469', 'sgu20131486', 'sgu20141310', 'sgu20151469']"
9,247,52,26,9,"['sgu20131496', 'sgu20121452', 'sgu20131504', 'sgu20111512', 'sgu20121502', 'sgu20141401', 'sgu20131469', 'sgu20131486', 'sgu20151469']",42,"['sgu20131430', 'sgu20131440', 'mohamedhelal', 'sgu20131467', 'sgu20131507', 'sgu20141523', 'mightynebula', 'sgu20151515', 'sgu20131500', 'norchan', 'sgu20111471', 'b.buynaa01', 'sgu20131489', 'sgu20101584', 'sgu20131429', 'sgu20131413', 'sgu20131482', 'sgu20141452', 'sgu20141488', 'sgu20131426', 'sgu20131471', 'sgu20131494', 'sgu20121439', 'sgu20121486', 'sgu20151423', 'sgu20131443', 'amirr89', 'sgu20141419', 'alidrashwan', 'sgu20111258', 'sgu20111794', 'youssefemad', 'sgu20121423', 'paul94', 'sgu20131466', 'sgu20131509', 'sgu20131437', 'sgu20131499', 'sgu20141403', 'sgu20141310', 'ruth59', 'sgu20121510']",17,"['sgu20121500', 'sgu20121446', 'sgu20131478', 'sgu20101494', 'sgu20131479', 'yunchoi', 'sgu20121472', 'sgu20121466', 'sgu20121480', 'miscre2d', 'taehojung', 'sgu20131421', 'sgu20121450', 'sgu20131419', 'kangtae', 'sgu20151450', None]",68,"['sgu20121500', 'sgu20131478', 'sgu20131430', 'sgu20121472', 'sgu20121480', 'sgu20131507', 'sgu20141523', 'mightynebula', 'sgu20151515', 'b.buynaa01', 'sgu20131413', 'sgu20141452', 'sgu20141488', 'sgu20111512', 'sgu20131426', 'sgu20131471', 'sgu20131494', 'sgu20151423', 'sgu20101494', 'sgu20131443', 'amirr89', 'sgu20141419', 'alidrashwan', 'sgu20111258', 'sgu20131421', 'yunchoi', 'youssefemad', 'sgu20121466', 'paul94', 'sgu20151450', 'sgu20121502', 'sgu20131437', 'sgu20141401', 'sgu20141403', 'sgu20131509', 'ruth59', 'sgu20121510', 'sgu20131440', 'mohamedhelal', 'sgu20131467', 'miscre2d', 'sgu20131500', 'norchan', 'sgu20111471', 'sgu20131489', 'sgu20101584', 'sgu20131429', 'sgu20131496', 'sgu20131482', 'sgu20131504', 'taehojung', 'kangtae', 'sgu20121439', 'sgu20121486', 'sgu20111794', None, 'sgu20121452', 'sgu20121446', 'sgu20131479', 'sgu20121423', 'sgu20121450', 'sgu20131466', 'sgu20131419', 'sgu20131499', 'sgu20131469', 'sgu20131486', 'sgu20141310', 'sgu20151469']"
9,9,52,18,8,"['sgu20131496', 'sgu20121486', 'sgu20131504', 'sgu20131440', 'mightynebula', 'sgu20131466', 'sgu20131486', 'sgu20121510']",43,"['sgu20131430', 'mohamedhelal', 'sgu20131467', 'sgu20131507', 'sgu20141523', 'sgu20151515', 'sgu20131500', 'norchan', 'sgu20111471', 'b.buynaa01', 'sgu20131489', 'sgu20101584', 'sgu20131429', 'sgu20131413', 'sgu20131482', 'sgu20141452', 'sgu20141488', 'sgu20111512', 'sgu20131426', 'sgu20131471', 'sgu20131494', 'sgu20121439', 'sgu20151423', 'sgu20131443', 'amirr89', 'sgu20141419', 'alidrashwan', 'sgu20131437', 'sgu20111258', 'sgu20111794', 'sgu20121452', 'youssefemad', 'sgu20121423', 'paul94', 'sgu20131509', 'sgu20121502', 'sgu20141401', 'sgu20131499', 'sgu20131469', 'sgu20141403', 'sgu20141310', 'ruth59', 'sgu20151469']",10,"['honnyou', None, 'k910716kim', 'mvert157', 'angyi90', 'skzl34', 'poby', '1022jinhee', 'miiinji', 'claritas']",61,"['honnyou', 'sgu20131430', 'sgu20131440', 'mohamedhelal', 'sgu20131467', 'sgu20131507', 'sgu20141523', 'mightynebula', 'sgu20151515', 'sgu20131500', 'norchan', 'sgu20121510', 'sgu20141310', 'sgu20121502', 'b.buynaa01', 'sgu20111471', 'sgu20131489', 'miiinji', 'sgu20101584', 'sgu20131413', 'sgu20131429', 'sgu20131496', 'sgu20131482', 'k910716kim', 'sgu20141452', 'sgu20131504', 'sgu20111512', 'sgu20141488', 'sgu20131426', 'sgu20131471', '1022jinhee', 'sgu20131494', 'sgu20121439', 'sgu20121486', 'sgu20151423', 'sgu20131443', 'amirr89', 'sgu20141419', 'alidrashwan', 'sgu20141403', 'sgu20111258', 'sgu20111794', 'skzl34', None, 'sgu20121452', 'youssefemad', 'sgu20121423', 'mvert157', 'claritas', 'angyi90', 'paul94', 'sgu20131466', 'poby', 'sgu20131437', 'sgu20141401', 'sgu20131499', 'sgu20131469', 'sgu20131486', 'sgu20131509', 'ruth59', 'sgu20151469']"
9,11,52,18,5,"['sgu20141488', 'sgu20121423', 'sgu20131499', 'sgu20141403', 'sgu20131509']",46,"['sgu20131430', 'sgu20131440', 'mohamedhelal', 'sgu20131467', 'sgu20131507', 'sgu20141523', 'mightynebula', 'sgu20151515', 'sgu20131500', 'norchan', 'sgu20151469', 'sgu20111471', 'b.buynaa01', 'sgu20131489', 'sgu20101584', 'sgu20131429', 'sgu20131413', 'sgu20131496', 'sgu20131482', 'sgu20141452', 'sgu20131504', 'sgu20111512', 'sgu20131426', 'sgu20131471', 'sgu20131494', 'sgu20121439', 'sgu20121486', 'sgu20151423', 'sgu20131443', 'amirr89', 'sgu20141419', 'alidrashwan', 'sgu20131437', 'sgu20111258', 'sgu20111794', 'sgu20121452', 'youssefemad', 'paul94', 'sgu20131466', 'sgu20121502', 'sgu20141401', 'sgu20131469', 'sgu20131486', 'sgu20141310', 'ruth59', 'sgu20121510']",13,"['1022jinhee', 'honnyou', None, 'k910716kim', 'sgu20121472', 'mvert157', 'angyi90', 'sgu20131420', 'skzl34', 'qpqp072472', 'miiinji', 'bongwhan12', 'claritas']",64,"['honnyou', 'sgu20131430', 'sgu20131440', 'mohamedhelal', 'sgu20121472', 'sgu20131467', 'sgu20131507', 'sgu20141523', 'mightynebula', 'sgu20151515', 'sgu20131500', 'norchan', 'sgu20121510', 'sgu20141310', 'sgu20121502', 'b.buynaa01', 'sgu20111471', 'sgu20131489', 'miiinji', 'sgu20101584', 'sgu20131413', 'sgu20131429', 'sgu20131496', 'sgu20131482', 'k910716kim', 'sgu20141452', 'sgu20131504', 'sgu20111512', 'sgu20141488', 'sgu20131426', 'sgu20131471', 'qpqp072472', 'sgu20131494', '1022jinhee', 'sgu20121439', 'sgu20121486', 'sgu20151423', 'sgu20131443', 'amirr89', 'sgu20141419', 'alidrashwan', 'sgu20131420', 'sgu20141403', 'sgu20111258', 'sgu20111794', 'skzl34', None, 'bongwhan12', 'sgu20121452', 'youssefemad', 'sgu20121423', 'mvert157', 'claritas', 'angyi90', 'paul94', 'sgu20131466', 'sgu20131437', 'sgu20141401', 'sgu20131499', 'sgu20131469', 'sgu20131486', 'sgu20131509', 'ruth59', 'sgu20151469']"
9,18,52,14,4,"['paul94', 'alidrashwan', 'youssefemad', 'mohamedhelal']",47,"['sgu20131430', 'sgu20131440', 'sgu20131467', 'sgu20131507', 'sgu20141523', 'mightynebula', 'sgu20151515', 'sgu20131500', 'norchan', 'sgu20131486', 'sgu20151469', 'sgu20111471', 'b.buynaa01', 'sgu20131489', 'sgu20101584', 'sgu20131429', 'sgu20131413', 'sgu20131496', 'sgu20131482', 'sgu20141452', 'sgu20131504', 'sgu20111512', 'sgu20141488', 'sgu20131426', 'sgu20131471', 'sgu20131494', 'sgu20121439', 'sgu20121486', 'sgu20151423', 'sgu20131443', 'amirr89', 'sgu20141419', 'sgu20131437', 'sgu20111258', 'sgu20111794', 'sgu20121452', 'sgu20121423', 'sgu20131466', 'sgu20131509', 'sgu20121502', 'sgu20141401', 'sgu20131499', 'sgu20131469', 'sgu20141403', 'sgu20141310', 'ruth59', 'sgu20121510']",10,"['aurora', 'i_metwally', None, 'peterasaad94', 'yehia', 'sahardiaaeldin1', 'shady_nashed', 'saramagdi', 'elsayed3', 'yumnafmoussa']",61,"['sgu20131430', 'sgu20131440', 'mohamedhelal', 'sgu20131467', 'sgu20131507', 'sgu20141523', 'mightynebula', 'sgu20151515', 'sgu20131500', 'norchan', 'sgu20121510', 'sgu20141310', 'sgu20121502', 'b.buynaa01', 'sgu20111471', 'sgu20131489', 'shady_nashed', 'sgu20101584', 'sgu20131413', 'sgu20131429', 'sgu20131496', 'sgu20131482', 'yumnafmoussa', 'yehia', 'sgu20141452', 'sgu20131504', 'sgu20111512', 'sgu20141488', 'sgu20131426', 'elsayed3', 'sgu20131471', 'sgu20131494', 'saramagdi', 'sgu20121439', 'sgu20121486', 'sgu20151423', 'sgu20131443', 'amirr89', 'sgu20141419', 'alidrashwan', 'sahardiaaeldin1', 'sgu20141403', 'aurora', 'sgu20111258', 'sgu20111794', None, 'sgu20121452', 'i_metwally', 'peterasaad94', 'youssefemad', 'sgu20121423', 'paul94', 'sgu20131466', 'sgu20131437', 'sgu20141401', 'sgu20131499', 'sgu20131469', 'sgu20131486', 'sgu20131509', 'ruth59', 'sgu20151469']"
9,12,52,13,1,['b.buynaa01'],50,"['sgu20131430', 'sgu20131440', 'mohamedhelal', 'sgu20131467', 'sgu20131507', 'sgu20141523', 'mightynebula', 'sgu20151515', 'sgu20131500', 'norchan', 'sgu20131486', 'sgu20151469', 'sgu20111471', 'sgu20131489', 'sgu20101584', 'sgu20131429', 'sgu20131413', 'sgu20131496', 'sgu20131482', 'sgu20141452', 'sgu20131504', 'sgu20111512', 'sgu20141488', 'sgu20131426', 'sgu20131471', 'sgu20131494', 'sgu20121439', 'sgu20121486', 'sgu20151423', 'sgu20131443', 'amirr89', 'sgu20141419', 'alidrashwan', 'sgu20131437', 'sgu20111258', 'sgu20111794', 'sgu20121452', 'youssefemad', 'sgu20121423', 'paul94', 'sgu20131466', 'sgu20131509', 'sgu20121502', 'sgu20141401', 'sgu20131499', 'sgu20131469', 'sgu20141403', 'sgu20141310', 'ruth59', 'sgu20121510']",12,"['suhboldb', 'fuente', 'banzragch', 'oyuka46', 'seiko_anarjin', 'djtumenjargal', 'ganzo_0306', 'ulaankhuu72', 'bil_marbel', 'bmunkhzorig', 'choijamts.choijoo', None]",63,"['sgu20131430', 'sgu20131440', 'mohamedhelal', 'djtumenjargal', 'sgu20131467', 'sgu20131507', 'sgu20141523', 'mightynebula', 'sgu20151515', 'sgu20131500', 'norchan', 'sgu20121510', 'sgu20141310', 'sgu20121502', 'b.buynaa01', 'sgu20111471', 'sgu20131489', 'sgu20101584', 'sgu20131413', 'sgu20131429', 'sgu20131496', 'sgu20131482', 'sgu20141452', 'sgu20131504', 'sgu20111512', 'sgu20141488', 'sgu20131426', 'banzragch', 'seiko_anarjin', 'bil_marbel', 'sgu20131471', 'sgu20131494', 'fuente', 'sgu20121439', 'sgu20121486', 'oyuka46', 'sgu20151423', 'sgu20131443', 'amirr89', 'sgu20141419', 'alidrashwan', 'bmunkhzorig', 'sgu20141403', 'ulaankhuu72', 'sgu20111258', 'sgu20111794', 'choijamts.choijoo', None, 'sgu20121452', 'suhboldb', 'youssefemad', 'sgu20121423', 'paul94', 'sgu20131466', 'ganzo_0306', 'sgu20131437', 'sgu20141401', 'sgu20131499', 'sgu20131469', 'sgu20131486', 'sgu20131509', 'ruth59', 'sgu20151469']"
9,16,52,10,3,"['mohamedhelal', 'norchan', 'alidrashwan']",48,"['sgu20131430', 'sgu20131440', 'sgu20131467', 'sgu20131507', 'sgu20141523', 'mightynebula', 'sgu20151515', 'sgu20131500', 'sgu20121510', 'sgu20141310', 'sgu20121502', 'b.buynaa01', 'sgu20111471', 'sgu20131489', 'sgu20101584', 'sgu20131413', 'sgu20131429', 'sgu20131496', 'sgu20131482', 'sgu20141452', 'sgu20131504', 'sgu20111512', 'sgu20141488', 'sgu20131426', 'sgu20131471', 'sgu20131494', 'sgu20121439', 'sgu20121486', 'sgu20151423', 'sgu20131443', 'amirr89', 'sgu20141419', 'sgu20141403', 'sgu20111258', 'sgu20111794', 'sgu20121452', 'youssefemad', 'sgu20121423', 'paul94', 'sgu20131466', 'sgu20131437', 'sgu20141401', 'sgu20131499', 'sgu20131469', 'sgu20131486', 'sgu20131509', 'ruth59', 'sgu20151469']",7,"['i_metwally', None, 'sahardiaaeldin1', 'aurora', 'saramagdi', 'elsayed3', 'yumnafmoussa']",58,"['sgu20131430', 'sgu20131440', 'mohamedhelal', 'sgu20131467', 'sgu20131507', 'sgu20141523', 'mightynebula', 'sgu20151515', 'sgu20131500', 'norchan', 'sgu20121510', 'sgu20141310', 'sgu20121502', 'b.buynaa01', 'sgu20111471', 'sgu20131489', 'sgu20101584', 'sgu20131413', 'sgu20131429', 'sgu20131496', 'sgu20131482', 'yumnafmoussa', 'sgu20141452', 'sgu20131504', 'sgu20111512', 'sgu20141488', 'sgu20131426', 'elsayed3', 'sgu20131471', 'sgu20131494', 'saramagdi', 'sgu20121439', 'sgu20121486', 'sgu20151423', 'sgu20131443', 'amirr89', 'sgu20141419', 'alidrashwan', 'sahardiaaeldin1', 'sgu20141403', 'aurora', 'sgu20111258', 'sgu20111794', None, 'sgu20121452', 'i_metwally', 'youssefemad', 'sgu20121423', 'paul94', 'sgu20131466', 'sgu20131437', 'sgu20141401', 'sgu20131499', 'sgu20131469', 'sgu20131486', 'sgu20131509', 'ruth59', 'sgu20151469']"
9,24,52,9,2,"['mohamedhelal', 'youssefemad']",49,"['sgu20131430', 'sgu20131440', 'sgu20131467', 'sgu20131507', 'sgu20141523', 'mightynebula', 'sgu20151515', 'sgu20131500', 'norchan', 'sgu20121510', 'sgu20141310', 'sgu20121502', 'b.buynaa01', 'sgu20111471', 'sgu20131489', 'sgu20101584', 'sgu20131413', 'sgu20131429', 'sgu20131496', 'sgu20131482', 'sgu20141452', 'sgu20131504', 'sgu20111512', 'sgu20141488', 'sgu20131426', 'sgu20131471', 'sgu20131494', 'sgu20121439', 'sgu20121486', 'sgu20151423', 'sgu20131443', 'amirr89', 'sgu20141419', 'alidrashwan', 'sgu20141403', 'sgu20111258', 'sgu20111794', 'sgu20121452', 'sgu20121423', 'paul94', 'sgu20131466', 'sgu20131437', 'sgu20141401', 'sgu20131499', 'sgu20131469', 'sgu20131486', 'sgu20131509', 'ruth59', 'sgu20151469']",7,"['shady_nashed', 'i_metwally', 'bel5525', 'aurora', 'saramagdi', None, 'yumnafmoussa']",58,"['sgu20131430', 'sgu20131440', 'mohamedhelal', 'sgu20131467', 'sgu20131507', 'sgu20141523', 'mightynebula', 'sgu20151515', 'sgu20131500', 'norchan', 'sgu20121510', 'sgu20141310', 'sgu20121502', 'b.buynaa01', 'sgu20111471', 'sgu20131489', 'shady_nashed', 'sgu20101584', 'sgu20131413', 'sgu20131429', 'sgu20131496', 'sgu20131482', 'yumnafmoussa', 'sgu20141452', 'sgu20131504', 'sgu20111512', 'sgu20141488', 'sgu20131426', 'sgu20131471', 'sgu20131494', 'saramagdi', 'sgu20121439', 'sgu20121486', 'sgu20151423', 'sgu20131443', 'amirr89', 'sgu20141419', 'alidrashwan', 'sgu20141403', 'aurora', 'sgu20111258', 'sgu20111794', None, 'sgu20121452', 'i_metwally', 'youssefemad', 'sgu20121423', 'paul94', 'sgu20131466', 'bel5525', 'sgu20131437', 'sgu20141401', 'sgu20131499', 'sgu20131469', 'sgu20131486', 'sgu20131509', 'ruth59', 'sgu20151469']"
9,38,52,8,1,['b.buynaa01'],50,"['sgu20131430', 'sgu20131440', 'mohamedhelal', 'sgu20131467', 'sgu20131507', 'sgu20141523', 'mightynebula', 'sgu20151515', 'sgu20131500', 'norchan', 'sgu20121510', 'sgu20141310', 'sgu20121502', 'sgu20111471', 'sgu20131489', 'sgu20101584', 'sgu20131413', 'sgu20131429', 'sgu20131496', 'sgu20131482', 'sgu20141452', 'sgu20131504', 'sgu20111512', 'sgu20141488', 'sgu20131426', 'sgu20131471', 'sgu20131494', 'sgu20121439', 'sgu20121486', 'sgu20151423', 'sgu20131443', 'amirr89', 'sgu20141419', 'alidrashwan', 'sgu20141403', 'sgu20111258', 'sgu20111794', 'sgu20121452', 'youssefemad', 'sgu20121423', 'paul94', 'sgu20131466', 'sgu20131437', 'sgu20141401', 'sgu20131499', 'sgu20131469', 'sgu20131486', 'sgu20131509', 'ruth59', 'sgu20151469']",7,"['banzragch', 'seiko_anarjin', 'djtumenjargal', 'ganzo_0306', 'bil_marbel', 'choijamts.choijoo', None]",58,"['sgu20131430', 'sgu20131440', 'mohamedhelal', 'djtumenjargal', 'sgu20131467', 'sgu20131507', 'sgu20141523', 'mightynebula', 'sgu20151515', 'sgu20131500', 'norchan', 'sgu20121510', 'sgu20141310', 'sgu20121502', 'b.buynaa01', 'sgu20111471', 'sgu20131489', 'sgu20101584', 'sgu20131413', 'sgu20131429', 'sgu20131496', 'sgu20131482', 'sgu20141452', 'sgu20131504', 'sgu20111512', 'sgu20141488', 'sgu20131426', 'banzragch', 'seiko_anarjin', 'bil_marbel', 'sgu20131471', 'sgu20131494', 'sgu20121439', 'sgu20121486', 'sgu20151423', 'sgu20131443', 'amirr89', 'sgu20141419', 'alidrashwan', 'sgu20141403', 'sgu20111258', 'sgu20111794', 'choijamts.choijoo', None, 'sgu20121452', 'youssefemad', 'sgu20121423', 'paul94', 'sgu20131466', 'ganzo_0306', 'sgu20131437', 'sgu20141401', 'sgu20131499', 'sgu20131469', 'sgu20131486', 'sgu20131509', 'ruth59', 'sgu20151469']"
9,229,52,8,1,['sgu20131467'],50,"['sgu20131430', 'sgu20131440', 'mohamedhelal', 'sgu20131507', 'sgu20141523', 'mightynebula', 'sgu20151515', 'sgu20131500', 'norchan', 'sgu20121510', 'sgu20141310', 'sgu20121502', 'b.buynaa01', 'sgu20111471', 'sgu20131489', 'sgu20101584', 'sgu20131413', 'sgu20131429', 'sgu20131496', 'sgu20131482', 'sgu20141452', 'sgu20131504', 'sgu20111512', 'sgu20141488', 'sgu20131426', 'sgu20131471', 'sgu20131494', 'sgu20121439', 'sgu20121486', 'sgu20151423', 'sgu20131443', 'amirr89', 'sgu20141419', 'alidrashwan', 'sgu20141403', 'sgu20111258', 'sgu20111794', 'sgu20121452', 'youssefemad', 'sgu20121423', 'paul94', 'sgu20131466', 'sgu20131437', 'sgu20141401', 'sgu20131499', 'sgu20131469', 'sgu20131486', 'sgu20131509', 'ruth59', 'sgu20151469']",7,"['sgu20121500', 'sgu20131478', None, 'sgu20101494', 'pplongi', 'kangtae', 'sgu20131421']",58,"['sgu20121500', 'sgu20131478', 'sgu20131430', 'sgu20131440', 'mohamedhelal', 'sgu20131467', 'sgu20131507', 'sgu20141523', 'mightynebula', 'sgu20151515', 'sgu20131500', 'norchan', 'sgu20121510', 'sgu20141310', 'sgu20121502', 'b.buynaa01', 'sgu20111471', 'sgu20131489', 'sgu20101584', 'sgu20131413', 'sgu20131429', 'sgu20131496', 'sgu20131482', 'sgu20141452', 'sgu20131504', 'sgu20111512', 'sgu20141488', 'sgu20131426', 'pplongi', 'kangtae', 'sgu20131471', 'sgu20131494', 'sgu20121439', 'sgu20121486', 'sgu20151423', 'sgu20101494', 'sgu20131443', 'amirr89', 'sgu20141419', 'alidrashwan', 'sgu20141403', 'sgu20111258', 'sgu20111794', 'sgu20131421', None, 'sgu20121452', 'youssefemad', 'sgu20121423', 'paul94', 'sgu20131466', 'sgu20131437', 'sgu20141401', 'sgu20131499', 'sgu20131469', 'sgu20131486', 'sgu20131509', 'ruth59', 'sgu20151469']"
9,255,52,6,1,['sgu20111512'],50,"['sgu20131430', 'sgu20131440', 'mohamedhelal', 'sgu20131467', 'sgu20131507', 'sgu20141523', 'mightynebula', 'sgu20151515', 'sgu20131500', 'norchan', 'sgu20121510', 'sgu20141310', 'sgu20121502', 'b.buynaa01', 'sgu20111471', 'sgu20131489', 'sgu20101584', 'sgu20131413', 'sgu20131429', 'sgu20131496', 'sgu20131482', 'sgu20141452', 'sgu20131504', 'sgu20141488', 'sgu20131426', 'sgu20131471', 'sgu20131494', 'sgu20121439', 'sgu20121486', 'sgu20151423', 'sgu20131443', 'amirr89', 'sgu20141419', 'alidrashwan', 'sgu20141403', 'sgu20111258', 'sgu20111794', 'sgu20121452', 'youssefemad', 'sgu20121423', 'paul94', 'sgu20131466', 'sgu20131437', 'sgu20141401', 'sgu20131499', 'sgu20131469', 'sgu20131486', 'sgu20131509', 'ruth59', 'sgu20151469']",5,"['sgu20131478', 'sgu20101494', 'sgu20121472', 'sgu20121466', None]",56,"['sgu20131478', 'sgu20131430', 'sgu20131440', 'mohamedhelal', 'sgu20121472', 'sgu20131467', 'sgu20131507', 'sgu20141523', 'mightynebula', 'sgu20151515', 'sgu20131500', 'norchan', 'sgu20121510', 'sgu20141310', 'sgu20121502', 'b.buynaa01', 'sgu20111471', 'sgu20131489', 'sgu20101584', 'sgu20131413', 'sgu20131429', 'sgu20131496', 'sgu20131482', 'sgu20141452', 'sgu20131504', 'sgu20111512', 'sgu20141488', 'sgu20131426', 'sgu20131471', 'sgu20131494', 'sgu20121439', 'sgu20121486', 'sgu20151423', 'sgu20101494', 'sgu20131443', 'amirr89', 'sgu20141419', 'alidrashwan', 'sgu20141403', 'sgu20111258', 'sgu20111794', None, 'sgu20121452', 'youssefemad', 'sgu20121423', 'sgu20121466', 'paul94', 'sgu20131466', 'sgu20131437', 'sgu20141401', 'sgu20131499', 'sgu20131469', 'sgu20131486', 'sgu20131509', 'ruth59', 'sgu20151469']"
10,154,51,34,31,"['dgarf314', 'yanru0519', 'vigneshshivaam', 'khiggi11', 'zongyanglyu', 'skumar17', 'taustin7', 'kurtafus', 'kbrowni7', 'kesmith421', 'pakelti2', 'jsutto16', 'candicek', 'lnuckols', 'jsmit492', 'whawley1', 'wgarcia', 'jtharpe2', 'dyixuan', 'kbreedi2', 'yli166', 'cxu27', 'zyn245', 'xuesong.fan1212', 'ddrey', 'jrizk', 'dkizzire', 'mabbaskh', 'ecomer2', 'gyarados11', 'xiedi90']",19,"['tsbonts01', 'igussev', 'dceresoli', 'mqmas', 'nmost69', 'vanecor.sol', 'davidhamblin', 'ars21031960', 'sking', 'molian7', 'maxhutch', 'lkasillas', 'rachelgaudet', 'demonolith', 'reddnk', 'rgj1234567890', 'skazemi', 'akm6w3', 'ericoquinn']",3,"['lsaturda', 'dtalley5', None]",53,"['dgarf314', 'tsbonts01', 'yanru0519', 'vigneshshivaam', 'dceresoli', 'vanecor.sol', 'skumar17', 'dtalley5', 'davidhamblin', 'taustin7', 'ars21031960', 'kbrowni7', 'pakelti2', 'lnuckols', 'sking', 'molian7', 'whawley1', 'maxhutch', 'jtharpe2', 'dyixuan', 'yli166', 'cxu27', 'ddrey', 'jrizk', 'lsaturda', 'akm6w3', 'ericoquinn', 'igussev', 'mqmas', 'khiggi11', 'nmost69', 'zongyanglyu', 'kurtafus', 'kesmith421', 'jsutto16', 'candicek', 'jsmit492', 'wgarcia', 'lkasillas', 'kbreedi2', 'rachelgaudet', 'zyn245', None, 'xuesong.fan1212', 'demonolith', 'dkizzire', 'mabbaskh', 'reddnk', 'ecomer2', 'rgj1234567890', 'skazemi', 'gyarados11', 'xiedi90']"
10,152,51,19,17,"['xuesong.fan1212', 'tsbonts01', 'kesmith421', 'pakelti2', 'gyarados11', 'igussev', 'yanru0519', 'vigneshshivaam', 'cxu27', 'ddrey', 'jrizk', 'dkizzire', 'ecomer2', 'jsmit492', 'lkasillas', 'jtharpe2', 'taustin7']",33,"['dgarf314', 'dceresoli', 'mqmas', 'khiggi11', 'nmost69', 'vanecor.sol', 'zongyanglyu', 'skumar17', 'davidhamblin', 'kurtafus', 'kbrowni7', 'ars21031960', 'jsutto16', 'candicek', 'lnuckols', 'sking', 'molian7', 'wgarcia', 'whawley1', 'maxhutch', 'dyixuan', 'kbreedi2', 'yli166', 'rachelgaudet', 'zyn245', 'demonolith', 'mabbaskh', 'reddnk', 'rgj1234567890', 'skazemi', 'xiedi90', 'akm6w3', 'ericoquinn']",2,"[None, 'whalezahid']",52,"['dgarf314', 'tsbonts01', 'igussev', 'yanru0519', 'vigneshshivaam', 'dceresoli', 'mqmas', 'khiggi11', 'ericoquinn', 'nmost69', 'vanecor.sol', 'zongyanglyu', 'skumar17', 'davidhamblin', 'taustin7', 'kurtafus', 'kbrowni7', 'kesmith421', 'pakelti2', 'jsutto16', 'ars21031960', 'candicek', 'lnuckols', 'sking', 'jsmit492', 'molian7', 'wgarcia', 'whawley1', 'lkasillas', 'maxhutch', 'jtharpe2', 'dyixuan', 'kbreedi2', 'whalezahid', 'yli166', 'rachelgaudet', 'zyn245', 'cxu27', None, 'xuesong.fan1212', 'demonolith', 'ddrey', 'jrizk', 'dkizzire', 'mabbaskh', 'reddnk', 'ecomer2', 'rgj1234567890', 'skazemi', 'gyarados11', 'akm6w3', 'xiedi90']"
11,81,49,53,48,"['malikrigg21', 'kevinkeller929', 'alexlleonart12', 'danieltola', 'nsessions', 'c.irene', 'ststrassle', 'alejandroarias', 'kurkutim', 'lancefox1191', 'frivasplata91', 'ryanfake', 'perryjetter', 'leoni95', 'concelmo', 'stevenb08', 'lemer1714', 'nhaydar', 'area', 'kaschmidt', 'latricereid', 'lchavous', 'danielfortiz94', 'salzmannra', 'gmoatts', 'fferrales', 'johntlee59', 'lwoodahl', 'davin', 'evanbishop', 'djordje.gluhovic', 'franky43', 'jldurso13', 'ssoto65', 'aw1195', 'wreuangrith13', 'thomas.e.mac1', 'kamalnasif', 'afranklin2016', 'juanz96', 'feng773', 'etanberg', 'anacovic', 'luisvf', 'pauljkania', 'eshortman5892', 'kgriffey95', 'jhaydenmashburn']",0,[],5,"['mltillman', 'jlim3538', 'zhipengdong2', 'jlahman', None]",53,"['danieltola', 'ststrassle', 'alejandroarias', 'kurkutim', 'lancefox1191', 'frivasplata91', 'ryanfake', 'perryjetter', 'jlim3538', 'stevenb08', 'lemer1714', 'kaschmidt', 'salzmannra', 'johntlee59', 'jldurso13', 'ssoto65', 'aw1195', 'kamalnasif', 'etanberg', 'jlahman', 'luisvf', 'pauljkania', 'eshortman5892', 'kgriffey95', 'jhaydenmashburn', 'malikrigg21', 'kevinkeller929', 'alexlleonart12', 'nsessions', 'c.irene', 'leoni95', 'mltillman', 'concelmo', 'nhaydar', 'area', 'latricereid', 'lchavous', 'danielfortiz94', 'gmoatts', 'fferrales', 'lwoodahl', 'davin', 'evanbishop', 'djordje.gluhovic', 'franky43', None, 'wreuangrith13', 'thomas.e.mac1', 'zhipengdong2', 'afranklin2016', 'juanz96', 'feng773', 'anacovic']"
11,230,49,50,48,"['malikrigg21', 'kevinkeller929', 'alexlleonart12', 'danieltola', 'nsessions', 'c.irene', 'ststrassle', 'alejandroarias', 'kurkutim', 'lancefox1191', 'frivasplata91', 'ryanfake', 'perryjetter', 'leoni95', 'concelmo', 'stevenb08', 'lemer1714', 'nhaydar', 'area', 'kaschmidt', 'latricereid', 'lchavous', 'danielfortiz94', 'salzmannra', 'gmoatts', 'fferrales', 'johntlee59', 'lwoodahl', 'davin', 'evanbishop', 'djordje.gluhovic', 'franky43', 'jldurso13', 'ssoto65', 'aw1195', 'wreuangrith13', 'thomas.e.mac1', 'kamalnasif', 'afranklin2016', 'juanz96', 'feng773', 'etanberg', 'anacovic', 'luisvf', 'pauljkania', 'eshortman5892', 'kgriffey95', 'jhaydenmashburn']",0,[],2,"[None, 'jlahman']",50,"['danieltola', 'ststrassle', 'alejandroarias', 'kurkutim', 'lancefox1191', 'frivasplata91', 'ryanfake', 'perryjetter', 'stevenb08', 'lemer1714', 'kaschmidt', 'salzmannra', 'johntlee59', 'jldurso13', 'ssoto65', 'aw1195', 'kamalnasif', 'etanberg', 'jlahman', 'luisvf', 'pauljkania', 'eshortman5892', 'kgriffey95', 'jhaydenmashburn', 'malikrigg21', 'kevinkeller929', 'alexlleonart12', 'nsessions', 'c.irene', 'leoni95', 'concelmo', 'nhaydar', 'area', 'latricereid', 'lchavous', 'danielfortiz94', 'gmoatts', 'fferrales', 'lwoodahl', 'davin', 'evanbishop', 'djordje.gluhovic', 'franky43', None, 'wreuangrith13', 'thomas.e.mac1', 'afranklin2016', 'juanz96', 'feng773', 'anacovic']"
11,328,49,50,47,"['malikrigg21', 'kevinkeller929', 'alexlleonart12', 'danieltola', 'nsessions', 'c.irene', 'ststrassle', 'alejandroarias', 'kurkutim', 'lancefox1191', 'frivasplata91', 'ryanfake', 'perryjetter', 'leoni95', 'concelmo', 'stevenb08', 'lemer1714', 'nhaydar', 'area', 'kaschmidt', 'latricereid', 'lchavous', 'danielfortiz94', 'salzmannra', 'gmoatts', 'fferrales', 'johntlee59', 'lwoodahl', 'davin', 'evanbishop', 'djordje.gluhovic', 'franky43', 'jldurso13', 'ssoto65', 'aw1195', 'wreuangrith13', 'kamalnasif', 'afranklin2016', 'juanz96', 'feng773', 'etanberg', 'anacovic', 'luisvf', 'pauljkania', 'eshortman5892', 'kgriffey95', 'jhaydenmashburn']",1,['thomas.e.mac1'],3,"['jlim3538', 'zhipengdong2', None]",51,"['danieltola', 'ststrassle', 'alejandroarias', 'kurkutim', 'lancefox1191', 'frivasplata91', 'ryanfake', 'perryjetter', 'jlim3538', 'stevenb08', 'lemer1714', 'kaschmidt', 'salzmannra', 'johntlee59', 'jldurso13', 'ssoto65', 'aw1195', 'kamalnasif', 'etanberg', 'luisvf', 'pauljkania', 'eshortman5892', 'kgriffey95', 'jhaydenmashburn', 'malikrigg21', 'kevinkeller929', 'alexlleonart12', 'nsessions', 'c.irene', 'leoni95', 'concelmo', 'nhaydar', 'area', 'latricereid', 'lchavous', 'danielfortiz94', 'gmoatts', 'fferrales', 'lwoodahl', 'davin', 'evanbishop', 'djordje.gluhovic', 'franky43', None, 'wreuangrith13', 'thomas.e.mac1', 'zhipengdong2', 'afranklin2016', 'juanz96', 'feng773', 'anacovic']"
12,13,49,68,1,['sgu20121528'],47,"['karimelmeligy', 'youstinamamdouh', 'bellmanz', 'baldassimassimo', 'mostafanazim1', 'jljhgjvlm', 'shimaaezz149', 'sararadwan', 'ranaahmed96', 'mittalswapnil81', 'lez94', 'scmendozar', 'shannu.sn96', 'mosa_nosa', 'jailanosamaa', 'shimaaezz1495', 'fatma_aly2010', 'ferrario.andrea', 'yaraahmeed7777', 'yehiafarouk.asurt', 'esraaezzzz', 'mohammed_yassin95', 'bhumitrojivadia', 'varvino', 'abdelrhman', 'ultzz', 'monmon', 'yehiaafaroukk', 'mustafa.maged95', 'hager.mostafa14.ah', 'mustafamagdy2020', 'xtllg', 'mostafasami1996', 'youstina1996mamdouh', 'ahmedashrafalaaser', 'lidaweicc123', 'seongshan', 'tyo78790', 'harishkct11', 'sara_khaled1997', 'karim.tera1', 'nada_y', 'evain', 'bel5525', 'ananth1026', 'mnorhan1997', 'wa7sh19962013']",67,"['honnyou', 'sgu20131478', 'sgu20111537', 'sgu20131440', 'sgu20131430', 'sgu20121472', 'luysunyoung9', 'sgu20131467', 'sgu20131507', 'sgu20141523', 'mightynebula', 'sgu20151515', 'sgu20131500', 'sgu20121510', 'sgu20121502', 'sgu20111471', 'sgu20131489', 'miiinji', 'sgu20131413', 'kjt93', 'sgu20131429', 'sgu20101584', 'sgu20131482', 'sgu20131496', 'k910716kim', 'sgu20141452', 'sgu20141488', 'sgu20111512', 'sgu20131426', 'sgu20131504', 'kangtae', 'sgu20131471', '1022jinhee', 'sgu20131494', 'qpqp072472', 'sgu20121439', 'sgu20121486', 'sgu20151423', 'sgu20101494', 'sgu20131443', 'sgu20141419', 'amirr89', 'sgu20141403', 'sgu20111258', 'sgu20111794', 'skzl34', None, 'bongwhan12', 'sgu20121452', 'sgu20131422', 'sgu20131479', 'sgu201311413', 'sgu20121423', 'claritas', 'angyi90', 'sgu20131466', 'sgu20121494', 'sgu20151450', 'sgu20131509', 'sgu20131437', 'sgu20141401', 'sgu20131499', 'sgu20131469', 'sgu20131486', 'sgu20141310', 'ruth59', 'sgu20151469']",115,"['sgu20131478', 'sgu20131430', 'sgu20121472', 'baldassimassimo', 'luysunyoung9', 'mostafanazim1', 'sgu20131507', 'sgu20141523', 'mightynebula', 'sgu20151515', 'shimaaezz149', 'miiinji', 'sgu20131413', 'kjt93', 'sararadwan', 'scmendozar', 'lez94', 'sgu20141452', 'sgu20141488', 'mosa_nosa', 'sgu20111512', 'sgu20131426', 'shimaaezz1495', 'yaraahmeed7777', 'yehiafarouk.asurt', 'sgu20131471', 'esraaezzzz', '1022jinhee', 'sgu20131494', 'abdelrhman', 'sgu20151423', 'ultzz', 'monmon', 'yehiaafaroukk', 'sgu20101494', 'sgu20131443', 'sgu20141419', 'hager.mostafa14.ah', 'amirr89', 'mustafamagdy2020', 'xtllg', 'sgu20121528', 'sgu20111258', 'tyo78790', 'harishkct11', 'sgu20131422', 'sgu201311413', 'claritas', 'evain', 'bel5525', 'ananth1026', 'sgu20121494', 'sgu20151450', 'sgu20131437', 'sgu20141401', 'sgu20121502', 'mnorhan1997', 'seongshan', 'wa7sh19962013', 'sgu20141403', 'sgu20121510', 'sgu20131509', 'karimelmeligy', 'honnyou', 'ruth59', 'youstinamamdouh', 'bellmanz', 'sgu20111537', 'sgu20131440', 'sgu20131467', 'sgu20131500', 'jljhgjvlm', 'sgu20111471', 'sgu20131489', 'sgu20131429', 'sgu20101584', 'sgu20131482', 'sgu20131496', 'ranaahmed96', 'mittalswapnil81', 'k910716kim', 'shannu.sn96', 'sgu20131504', 'jailanosamaa', 'fatma_aly2010', 'ferrario.andrea', 'kangtae', 'qpqp072472', 'mohammed_yassin95', 'bhumitrojivadia', 'varvino', 'sgu20121439', 'sgu20121486', 'mustafa.maged95', 'mostafasami1996', 'youstina1996mamdouh', 'ahmedashrafalaaser', 'lidaweicc123', 'sgu20111794', 'skzl34', None, 'bongwhan12', 'sgu20121452', 'sara_khaled1997', 'karim.tera1', 'sgu20131479', 'sgu20121423', 'nada_y', 'angyi90', 'sgu20131466', 'sgu20131499', 'sgu20131469', 'sgu20131486', 'sgu20141310', 'sgu20151469']"
12,39,49,58,1,['sgu20121528'],47,"['karimelmeligy', 'youstinamamdouh', 'bellmanz', 'baldassimassimo', 'mostafanazim1', 'jljhgjvlm', 'shimaaezz149', 'sararadwan', 'ranaahmed96', 'mittalswapnil81', 'lez94', 'scmendozar', 'shannu.sn96', 'mosa_nosa', 'jailanosamaa', 'shimaaezz1495', 'fatma_aly2010', 'ferrario.andrea', 'yaraahmeed7777', 'yehiafarouk.asurt', 'esraaezzzz', 'mohammed_yassin95', 'bhumitrojivadia', 'varvino', 'abdelrhman', 'ultzz', 'monmon', 'yehiaafaroukk', 'mustafa.maged95', 'hager.mostafa14.ah', 'mustafamagdy2020', 'xtllg', 'mostafasami1996', 'youstina1996mamdouh', 'ahmedashrafalaaser', 'lidaweicc123', 'seongshan', 'tyo78790', 'harishkct11', 'sara_khaled1997', 'karim.tera1', 'nada_y', 'evain', 'bel5525', 'ananth1026', 'mnorhan1997', 'wa7sh19962013']",57,"['sgu20131430', 'sgu20131440', 'sgu20121472', 'sgu20131467', 'sgu20131507', 'sgu20141523', 'mightynebula', 'sgu20131500', 'sgu20151515', 'sgu20121502', 'sgu20111471', 'sgu20131489', 'sgu20101584', 'sgu20131429', 'sgu20131413', 'sgu20131482', 'sgu20131496', 'sgu20141452', 'sgu20141488', 'sgu20111512', 'sgu20131426', 'sgu20131504', 'pplongi', 'sg20121208', 'kangtae', 'kcj1127', 'tulv37', 'sgu20131471', 'sgu20131494', 'sgu20121439', 'sgu20121486', 'brahms0827', 'sgu20151423', 'sgu20131443', 'sgu20141419', 'amirr89', 'sgu20141403', 'sgu20111258', 'sgu20111794', None, 'sgu20121452', 'sgu20131422', 'sgu20121466', 'sgu20121423', 'sgu20121450', 'sgu20131466', 'sgu20131419', 'sgu20121494', 'sgu20131509', 'sgu20131437', 'sgu20141401', 'sgu20131499', 'sgu20131469', 'sgu20131486', 'sgu20141310', 'ruth59', 'sgu20121510']",105,"['sgu20131430', 'sgu20121472', 'baldassimassimo', 'mostafanazim1', 'sgu20131507', 'sgu20141523', 'mightynebula', 'sgu20151515', 'shimaaezz149', 'sgu20131413', 'sararadwan', 'scmendozar', 'lez94', 'sgu20141452', 'sgu20141488', 'mosa_nosa', 'sgu20111512', 'sgu20131426', 'pplongi', 'shimaaezz1495', 'yaraahmeed7777', 'sg20121208', 'yehiafarouk.asurt', 'kcj1127', 'sgu20131471', 'esraaezzzz', 'sgu20131494', 'abdelrhman', 'sgu20151423', 'ultzz', 'monmon', 'yehiaafaroukk', 'sgu20131443', 'sgu20141419', 'amirr89', 'hager.mostafa14.ah', 'mustafamagdy2020', 'xtllg', 'sgu20121528', 'sgu20111258', 'tyo78790', 'harishkct11', 'sgu20131422', 'sgu20121466', 'evain', 'bel5525', 'ananth1026', 'sgu20121494', 'sgu20131437', 'sgu20141401', 'sgu20121502', 'mnorhan1997', 'seongshan', 'wa7sh19962013', 'sgu20141403', 'sgu20121510', 'sgu20131509', 'karimelmeligy', 'ruth59', 'youstinamamdouh', 'bellmanz', 'sgu20131440', 'sgu20131467', 'sgu20131500', 'jljhgjvlm', 'sgu20111471', 'sgu20131489', 'sgu20101584', 'sgu20131429', 'sgu20131482', 'sgu20131496', 'ranaahmed96', 'mittalswapnil81', 'shannu.sn96', 'sgu20131504', 'jailanosamaa', 'fatma_aly2010', 'ferrario.andrea', 'kangtae', 'tulv37', 'mohammed_yassin95', 'bhumitrojivadia', 'varvino', 'sgu20121439', 'sgu20121486', 'brahms0827', 'mustafa.maged95', 'mostafasami1996', 'youstina1996mamdouh', 'ahmedashrafalaaser', 'lidaweicc123', 'sgu20111794', None, 'sgu20121452', 'sara_khaled1997', 'karim.tera1', 'sgu20121423', 'nada_y', 'sgu20121450', 'sgu20131466', 'sgu20131419', 'sgu20131499', 'sgu20131469', 'sgu20131486', 'sgu20141310']"
12,34,49,54,29,"['karimelmeligy', 'youstinamamdouh', 'mostafanazim1', 'jljhgjvlm', 'shimaaezz149', 'sararadwan', 'ranaahmed96', 'mosa_nosa', 'jailanosamaa', 'shimaaezz1495', 'fatma_aly2010', 'yaraahmeed7777', 'yehiafarouk.asurt', 'esraaezzzz', 'abdelrhman', 'monmon', 'yehiaafaroukk', 'mustafa.maged95', 'hager.mostafa14.ah', 'mustafamagdy2020', 'mostafasami1996', 'youstina1996mamdouh', 'ahmedashrafalaaser', 'tyo78790', 'sara_khaled1997', 'karim.tera1', 'nada_y', 'mnorhan1997', 'wa7sh19962013']",19,"['bellmanz', 'baldassimassimo', 'mittalswapnil81', 'scmendozar', 'lez94', 'shannu.sn96', 'ferrario.andrea', 'mohammed_yassin95', 'bhumitrojivadia', 'varvino', 'ultzz', 'xtllg', 'sgu20121528', 'lidaweicc123', 'harishkct11', 'evain', 'bel5525', 'ananth1026', 'seongshan']",25,"['rehamkandel', 'mohamedabdelmaksoud1096', 'perihansherif', 'shrouk_mahmoud', 'mahmoudtarek313', 'ahmedreda0', 'yumnafmoussa', 'yehia', 'passantali', 'sara.saso9686', 'abdo1703', 'mahmoudtarak51', 'abdorady', 'mernaosama40', 'hadilmazen10', 'menna_sarhan97', 'nourhangamal', None, 'sandy_sameh', 'abdelrahmanmagdy2022', 'manarahmeed', 'habib1996', 'mohamedtarek.mt450', 'youssefemad', 'abdelrahmanelmy96']",73,"['rehamkandel', 'baldassimassimo', 'mostafanazim1', 'ahmedreda0', 'shimaaezz149', 'sararadwan', 'scmendozar', 'lez94', 'passantali', 'mosa_nosa', 'shimaaezz1495', 'yaraahmeed7777', 'sara.saso9686', 'yehiafarouk.asurt', 'abdo1703', 'esraaezzzz', 'abdelrhman', 'mahmoudtarak51', 'mernaosama40', 'ultzz', 'monmon', 'yehiaafaroukk', 'hager.mostafa14.ah', 'mustafamagdy2020', 'xtllg', 'nourhangamal', 'sgu20121528', 'tyo78790', 'harishkct11', 'sandy_sameh', 'youssefemad', 'evain', 'bel5525', 'ananth1026', 'abdelrahmanelmy96', 'mnorhan1997', 'seongshan', 'wa7sh19962013', 'karimelmeligy', 'youstinamamdouh', 'bellmanz', 'mohamedabdelmaksoud1096', 'perihansherif', 'shrouk_mahmoud', 'mahmoudtarek313', 'jljhgjvlm', 'yehia', 'yumnafmoussa', 'ranaahmed96', 'mittalswapnil81', 'shannu.sn96', 'jailanosamaa', 'fatma_aly2010', 'ferrario.andrea', 'mohammed_yassin95', 'bhumitrojivadia', 'varvino', 'abdorady', 'hadilmazen10', 'menna_sarhan97', 'mustafa.maged95', 'mostafasami1996', 'youstina1996mamdouh', 'ahmedashrafalaaser', 'lidaweicc123', None, 'sara_khaled1997', 'karim.tera1', 'abdelrahmanmagdy2022', 'manarahmeed', 'habib1996', 'nada_y', 'mohamedtarek.mt450']"
12,41,49,41,1,['bel5525'],47,"['karimelmeligy', 'youstinamamdouh', 'bellmanz', 'baldassimassimo', 'mostafanazim1', 'jljhgjvlm', 'shimaaezz149', 'sararadwan', 'ranaahmed96', 'mittalswapnil81', 'lez94', 'scmendozar', 'shannu.sn96', 'mosa_nosa', 'jailanosamaa', 'shimaaezz1495', 'fatma_aly2010', 'ferrario.andrea', 'yaraahmeed7777', 'yehiafarouk.asurt', 'esraaezzzz', 'mohammed_yassin95', 'bhumitrojivadia', 'varvino', 'abdelrhman', 'ultzz', 'monmon', 'yehiaafaroukk', 'mustafa.maged95', 'hager.mostafa14.ah', 'mustafamagdy2020', 'xtllg', 'mostafasami1996', 'youstina1996mamdouh', 'ahmedashrafalaaser', 'lidaweicc123', 'sgu20121528', 'tyo78790', 'seongshan', 'harishkct11', 'sara_khaled1997', 'karim.tera1', 'nada_y', 'evain', 'ananth1026', 'mnorhan1997', 'wa7sh19962013']",40,"['marinaboules9', 'mfathy97', 'theinstructive_man', 'mohamedhelal', 'ahmad.abdelaziz.ibrahim', 'sandy_luxor', 'hebaismail', 'norchan', 'es.so1995', 'emara2756300', 'hanatouni97', 'zyad_2012', 'ahmedelkayal', 'masterrub', 'monicaaziz', 'abdelaziz', 'monicaaziz31', 'mohamedali915', 'ahmed.saeed', 'ahmedbakla94', 'ahmadessam1997', 'ok97', 'engynageeb97', 'omarkhaledgadallah', 'ahmed.k.shaker', 'h_ash96', 'gannatmagdy0', 'alidrashwan', 'sohaanaselmashad', 'mido28elashmawy', None, 'amrkotb', 'olamansour21', 'youssefemad', 'minaadel2017', 'nadermoussa1', 'mohamed_tahoun', 'paul94', 'ahmed_yahia', 'ayausama1997']",88,"['marinaboules9', 'mfathy97', 'theinstructive_man', 'baldassimassimo', 'mostafanazim1', 'shimaaezz149', 'emara2756300', 'hanatouni97', 'sararadwan', 'scmendozar', 'zyad_2012', 'lez94', 'mosa_nosa', 'masterrub', 'monicaaziz', 'shimaaezz1495', 'abdelaziz', 'yaraahmeed7777', 'ok97', 'mohamedali915', 'ahmedbakla94', 'yehiafarouk.asurt', 'esraaezzzz', 'omarkhaledgadallah', 'abdelrhman', 'h_ash96', 'ultzz', 'monmon', 'yehiaafaroukk', 'alidrashwan', 'sohaanaselmashad', 'hager.mostafa14.ah', 'mustafamagdy2020', 'xtllg', 'mido28elashmawy', 'sgu20121528', 'tyo78790', 'harishkct11', 'amrkotb', 'olamansour21', 'youssefemad', 'evain', 'mohamed_tahoun', 'paul94', 'bel5525', 'ananth1026', 'ahmed_yahia', 'ayausama1997', 'mnorhan1997', 'seongshan', 'wa7sh19962013', 'karimelmeligy', 'youstinamamdouh', 'bellmanz', 'mohamedhelal', 'ahmad.abdelaziz.ibrahim', 'sandy_luxor', 'hebaismail', 'norchan', 'es.so1995', 'jljhgjvlm', 'ranaahmed96', 'mittalswapnil81', 'ahmedelkayal', 'shannu.sn96', 'jailanosamaa', 'fatma_aly2010', 'ferrario.andrea', 'monicaaziz31', 'ahmed.saeed', 'ahmadessam1997', 'engynageeb97', 'mohammed_yassin95', 'bhumitrojivadia', 'varvino', 'ahmed.k.shaker', 'gannatmagdy0', 'mustafa.maged95', 'mostafasami1996', 'youstina1996mamdouh', 'ahmedashrafalaaser', 'lidaweicc123', None, 'sara_khaled1997', 'karim.tera1', 'nada_y', 'minaadel2017', 'nadermoussa1']"
12,246,49,11,2,"['mittalswapnil81', 'varvino']",46,"['karimelmeligy', 'youstinamamdouh', 'bellmanz', 'baldassimassimo', 'mostafanazim1', 'mnorhan1997', 'jljhgjvlm', 'shimaaezz149', 'sararadwan', 'ranaahmed96', 'lez94', 'scmendozar', 'shannu.sn96', 'mosa_nosa', 'jailanosamaa', 'shimaaezz1495', 'fatma_aly2010', 'ferrario.andrea', 'yaraahmeed7777', 'yehiafarouk.asurt', 'esraaezzzz', 'mohammed_yassin95', 'bhumitrojivadia', 'abdelrhman', 'ultzz', 'monmon', 'yehiaafaroukk', 'mustafa.maged95', 'hager.mostafa14.ah', 'mustafamagdy2020', 'xtllg', 'mostafasami1996', 'youstina1996mamdouh', 'ahmedashrafalaaser', 'lidaweicc123', 'sgu20121528', 'tyo78790', 'harishkct11', 'sara_khaled1997', 'karim.tera1', 'nada_y', 'evain', 'bel5525', 'ananth1026', 'seongshan', 'wa7sh19962013']",9,"['sandeepkrishnan51', 'shara_mathew', 'shwetasuresh7', 'rathnamalarao', 'vishakh567', 'varsharobert', 'tsnitk2017', 'meerannaveeth', None]",57,"['karimelmeligy', 'youstinamamdouh', 'bellmanz', 'baldassimassimo', 'shara_mathew', 'mostafanazim1', 'shwetasuresh7', 'mnorhan1997', 'jljhgjvlm', 'shimaaezz149', 'sararadwan', 'ranaahmed96', 'mittalswapnil81', 'lez94', 'scmendozar', 'shannu.sn96', 'mosa_nosa', 'jailanosamaa', 'shimaaezz1495', 'fatma_aly2010', 'ferrario.andrea', 'yaraahmeed7777', 'vishakh567', 'yehiafarouk.asurt', 'esraaezzzz', 'mohammed_yassin95', 'bhumitrojivadia', 'varvino', 'abdelrhman', 'ultzz', 'monmon', 'yehiaafaroukk', 'sandeepkrishnan51', 'mustafa.maged95', 'hager.mostafa14.ah', 'mustafamagdy2020', 'xtllg', 'mostafasami1996', 'rathnamalarao', 'youstina1996mamdouh', 'varsharobert', 'ahmedashrafalaaser', 'lidaweicc123', 'sgu20121528', 'tyo78790', 'meerannaveeth', None, 'harishkct11', 'sara_khaled1997', 'karim.tera1', 'nada_y', 'evain', 'bel5525', 'ananth1026', 'tsnitk2017', 'seongshan', 'wa7sh19962013']"
12,24,49,9,1,['bel5525'],47,"['karimelmeligy', 'youstinamamdouh', 'bellmanz', 'baldassimassimo', 'mostafanazim1', 'mnorhan1997', 'jljhgjvlm', 'shimaaezz149', 'sararadwan', 'ranaahmed96', 'mittalswapnil81', 'lez94', 'scmendozar', 'shannu.sn96', 'mosa_nosa', 'jailanosamaa', 'shimaaezz1495', 'fatma_aly2010', 'ferrario.andrea', 'yaraahmeed7777', 'yehiafarouk.asurt', 'esraaezzzz', 'mohammed_yassin95', 'bhumitrojivadia', 'varvino', 'abdelrhman', 'ultzz', 'monmon', 'yehiaafaroukk', 'mustafa.maged95', 'hager.mostafa14.ah', 'mustafamagdy2020', 'xtllg', 'mostafasami1996', 'youstina1996mamdouh', 'ahmedashrafalaaser', 'lidaweicc123', 'sgu20121528', 'tyo78790', 'harishkct11', 'sara_khaled1997', 'karim.tera1', 'nada_y', 'evain', 'ananth1026', 'seongshan', 'wa7sh19962013']",8,"['shady_nashed', 'i_metwally', 'mohamedhelal', 'youssefemad', 'aurora', 'saramagdi', None, 'yumnafmoussa']",56,"['karimelmeligy', 'youstinamamdouh', 'bellmanz', 'mohamedhelal', 'baldassimassimo', 'mostafanazim1', 'mnorhan1997', 'jljhgjvlm', 'shimaaezz149', 'shady_nashed', 'yumnafmoussa', 'sararadwan', 'ranaahmed96', 'mittalswapnil81', 'lez94', 'scmendozar', 'shannu.sn96', 'mosa_nosa', 'jailanosamaa', 'shimaaezz1495', 'fatma_aly2010', 'ferrario.andrea', 'yaraahmeed7777', 'yehiafarouk.asurt', 'esraaezzzz', 'saramagdi', 'mohammed_yassin95', 'bhumitrojivadia', 'varvino', 'abdelrhman', 'ultzz', 'monmon', 'yehiaafaroukk', 'mustafa.maged95', 'hager.mostafa14.ah', 'mustafamagdy2020', 'xtllg', 'mostafasami1996', 'youstina1996mamdouh', 'ahmedashrafalaaser', 'aurora', 'lidaweicc123', 'sgu20121528', 'tyo78790', None, 'harishkct11', 'i_metwally', 'sara_khaled1997', 'karim.tera1', 'youssefemad', 'nada_y', 'evain', 'bel5525', 'ananth1026', 'seongshan', 'wa7sh19962013']"
12,33,49,8,1,['bellmanz'],47,"['karimelmeligy', 'youstinamamdouh', 'baldassimassimo', 'mostafanazim1', 'mnorhan1997', 'jljhgjvlm', 'shimaaezz149', 'sararadwan', 'ranaahmed96', 'mittalswapnil81', 'lez94', 'scmendozar', 'shannu.sn96', 'mosa_nosa', 'jailanosamaa', 'shimaaezz1495', 'fatma_aly2010', 'ferrario.andrea', 'yaraahmeed7777', 'yehiafarouk.asurt', 'esraaezzzz', 'mohammed_yassin95', 'bhumitrojivadia', 'varvino', 'abdelrhman', 'ultzz', 'monmon', 'yehiaafaroukk', 'mustafa.maged95', 'hager.mostafa14.ah', 'mustafamagdy2020', 'xtllg', 'mostafasami1996', 'youstina1996mamdouh', 'ahmedashrafalaaser', 'lidaweicc123', 'sgu20121528', 'tyo78790', 'harishkct11', 'sara_khaled1997', 'karim.tera1', 'nada_y', 'evain', 'bel5525', 'ananth1026', 'seongshan', 'wa7sh19962013']",7,"['marcofarina1994', 'luca.riccies', 'dongli_17', 'aledafers', 'corrado888', 'dirosagabriele', None]",55,"['marcofarina1994', 'karimelmeligy', 'youstinamamdouh', 'bellmanz', 'baldassimassimo', 'mostafanazim1', 'dirosagabriele', 'mnorhan1997', 'corrado888', 'jljhgjvlm', 'shimaaezz149', 'sararadwan', 'ranaahmed96', 'mittalswapnil81', 'lez94', 'scmendozar', 'shannu.sn96', 'luca.riccies', 'mosa_nosa', 'jailanosamaa', 'shimaaezz1495', 'fatma_aly2010', 'ferrario.andrea', 'yaraahmeed7777', 'yehiafarouk.asurt', 'esraaezzzz', 'mohammed_yassin95', 'bhumitrojivadia', 'varvino', 'abdelrhman', 'ultzz', 'monmon', 'yehiaafaroukk', 'dongli_17', 'mustafa.maged95', 'hager.mostafa14.ah', 'mustafamagdy2020', 'xtllg', 'mostafasami1996', 'youstina1996mamdouh', 'ahmedashrafalaaser', 'lidaweicc123', 'sgu20121528', 'tyo78790', None, 'harishkct11', 'sara_khaled1997', 'karim.tera1', 'nada_y', 'aledafers', 'evain', 'bel5525', 'ananth1026', 'seongshan', 'wa7sh19962013']"
12,29,49,7,2,"['ferrario.andrea', 'lez94']",46,"['karimelmeligy', 'youstinamamdouh', 'bellmanz', 'baldassimassimo', 'mostafanazim1', 'mnorhan1997', 'jljhgjvlm', 'shimaaezz149', 'sararadwan', 'ranaahmed96', 'mittalswapnil81', 'scmendozar', 'shannu.sn96', 'mosa_nosa', 'jailanosamaa', 'shimaaezz1495', 'fatma_aly2010', 'yaraahmeed7777', 'yehiafarouk.asurt', 'esraaezzzz', 'mohammed_yassin95', 'bhumitrojivadia', 'varvino', 'abdelrhman', 'ultzz', 'monmon', 'yehiaafaroukk', 'mustafa.maged95', 'hager.mostafa14.ah', 'mustafamagdy2020', 'xtllg', 'mostafasami1996', 'youstina1996mamdouh', 'ahmedashrafalaaser', 'lidaweicc123', 'sgu20121528', 'tyo78790', 'harishkct11', 'sara_khaled1997', 'karim.tera1', 'nada_y', 'evain', 'bel5525', 'ananth1026', 'seongshan', 'wa7sh19962013']",5,"['gianca', 'reatoeros', 'aldihoxha92', 'lucaselmi', None]",53,"['karimelmeligy', 'youstinamamdouh', 'bellmanz', 'baldassimassimo', 'mostafanazim1', 'mnorhan1997', 'aldihoxha92', 'jljhgjvlm', 'shimaaezz149', 'sararadwan', 'ranaahmed96', 'mittalswapnil81', 'lez94', 'scmendozar', 'shannu.sn96', 'mosa_nosa', 'jailanosamaa', 'shimaaezz1495', 'fatma_aly2010', 'ferrario.andrea', 'yaraahmeed7777', 'yehiafarouk.asurt', 'esraaezzzz', 'mohammed_yassin95', 'bhumitrojivadia', 'varvino', 'abdelrhman', 'ultzz', 'monmon', 'yehiaafaroukk', 'mustafa.maged95', 'hager.mostafa14.ah', 'mustafamagdy2020', 'xtllg', 'mostafasami1996', 'youstina1996mamdouh', 'ahmedashrafalaaser', 'lidaweicc123', 'sgu20121528', 'tyo78790', None, 'harishkct11', 'sara_khaled1997', 'karim.tera1', 'gianca', 'nada_y', 'evain', 'reatoeros', 'bel5525', 'ananth1026', 'lucaselmi', 'seongshan', 'wa7sh19962013']"
12,32,49,7,3,"['harishkct11', 'lez94', 'baldassimassimo']",45,"['karimelmeligy', 'youstinamamdouh', 'bellmanz', 'mostafanazim1', 'mnorhan1997', 'jljhgjvlm', 'shimaaezz149', 'sararadwan', 'ranaahmed96', 'mittalswapnil81', 'scmendozar', 'shannu.sn96', 'mosa_nosa', 'jailanosamaa', 'shimaaezz1495', 'fatma_aly2010', 'ferrario.andrea', 'yaraahmeed7777', 'yehiafarouk.asurt', 'esraaezzzz', 'mohammed_yassin95', 'bhumitrojivadia', 'varvino', 'abdelrhman', 'ultzz', 'monmon', 'yehiaafaroukk', 'mustafa.maged95', 'hager.mostafa14.ah', 'mustafamagdy2020', 'xtllg', 'mostafasami1996', 'youstina1996mamdouh', 'ahmedashrafalaaser', 'lidaweicc123', 'sgu20121528', 'tyo78790', 'sara_khaled1997', 'karim.tera1', 'nada_y', 'evain', 'bel5525', 'ananth1026', 'seongshan', 'wa7sh19962013']",4,"['lucaselmi', 'gianca', 'alessandro.pilotto', None]",52,"['karimelmeligy', 'youstinamamdouh', 'bellmanz', 'alessandro.pilotto', 'baldassimassimo', 'mostafanazim1', 'mnorhan1997', 'jljhgjvlm', 'shimaaezz149', 'sararadwan', 'ranaahmed96', 'mittalswapnil81', 'lez94', 'scmendozar', 'shannu.sn96', 'mosa_nosa', 'jailanosamaa', 'shimaaezz1495', 'fatma_aly2010', 'ferrario.andrea', 'yaraahmeed7777', 'yehiafarouk.asurt', 'esraaezzzz', 'mohammed_yassin95', 'bhumitrojivadia', 'varvino', 'abdelrhman', 'ultzz', 'monmon', 'yehiaafaroukk', 'mustafa.maged95', 'hager.mostafa14.ah', 'mustafamagdy2020', 'xtllg', 'mostafasami1996', 'youstina1996mamdouh', 'ahmedashrafalaaser', 'lidaweicc123', 'sgu20121528', 'tyo78790', None, 'harishkct11', 'sara_khaled1997', 'karim.tera1', 'gianca', 'nada_y', 'evain', 'bel5525', 'ananth1026', 'lucaselmi', 'seongshan', 'wa7sh19962013']"
13,91,46,38,29,"['amadatha', 'gseeniva', 'djjohn22', 'raalneya', 'pryan2', 'iwelland', 'abalaji6', 'oakalthaidi', 'sgovin10', 'aparame2', 'marulana', 'lelaprol', 'andrewwarrn', 'vrames13', 'rezavatan64', 'tpage3', 'molybdenum94', 'aveerana', 'pmuliyil', 'ctsai33', 'adas43', 'tyang66', 'navnano1034', 'sbassa', 'araguil3', 'tramesh', 'jager', 'vkumar21', 'abhinaba123']",16,"['hdarfade', 'daolive1', 'vrai3', 'mewcarpenter13', 'jmbeltr3', 'vrames14', 'rgudipat', 'sgolusul', 'egruel', 'jperki3', 'cchoppal', 'mkcotton', 'shruthiv1', 'nvokeke', 'gsjurado', 'wstumph']",9,"['athinarayanan9', 'smurali2951', 'adass123', 'wroscoe', 'snemaniw', 'vasileska', 'spolava1', 'nmohanku', None]",54,"['gseeniva', 'mewcarpenter13', 'pryan2', 'jperki3', 'nmohanku', 'oakalthaidi', 'sgovin10', 'aparame2', 'lelaprol', 'vrames14', 'andrewwarrn', 'snemaniw', 'vrames13', 'rezavatan64', 'tpage3', 'molybdenum94', 'adass123', 'pmuliyil', 'adas43', 'tyang66', 'jager', 'abhinaba123', 'amadatha', 'athinarayanan9', 'djjohn22', 'raalneya', 'iwelland', 'mkcotton', 'abalaji6', 'shruthiv1', 'wstumph', 'jmbeltr3', 'hdarfade', 'marulana', 'sgolusul', 'vasileska', 'nvokeke', 'vrai3', 'aveerana', 'wroscoe', 'cchoppal', 'ctsai33', 'gsjurado', None, 'navnano1034', 'sbassa', 'araguil3', 'daolive1', 'tramesh', 'egruel', 'spolava1', 'smurali2951', 'rgudipat', 'vkumar21']"
13,293,46,37,30,"['amadatha', 'gseeniva', 'djjohn22', 'raalneya', 'pryan2', 'jperki3', 'iwelland', 'abalaji6', 'sgovin10', 'aparame2', 'marulana', 'lelaprol', 'andrewwarrn', 'vrames13', 'rezavatan64', 'tpage3', 'molybdenum94', 'aveerana', 'cchoppal', 'pmuliyil', 'ctsai33', 'adas43', 'tyang66', 'navnano1034', 'sbassa', 'araguil3', 'tramesh', 'jager', 'vkumar21', 'abhinaba123']",15,"['hdarfade', 'daolive1', 'vrai3', 'wstumph', 'mewcarpenter13', 'jmbeltr3', 'vrames14', 'rgudipat', 'sgolusul', 'egruel', 'mkcotton', 'shruthiv1', 'nvokeke', 'gsjurado', 'oakalthaidi']",7,"['athinarayanan9', 'smurali2951', 'snemaniw', 'vasileska', 'spolava1', 'nmohanku', None]",52,"['gseeniva', 'mewcarpenter13', 'pryan2', 'jperki3', 'nmohanku', 'oakalthaidi', 'sgovin10', 'aparame2', 'lelaprol', 'vrames14', 'andrewwarrn', 'snemaniw', 'vrames13', 'rezavatan64', 'tpage3', 'molybdenum94', 'pmuliyil', 'adas43', 'tyang66', 'jager', 'abhinaba123', 'amadatha', 'athinarayanan9', 'djjohn22', 'raalneya', 'iwelland', 'mkcotton', 'abalaji6', 'shruthiv1', 'wstumph', 'jmbeltr3', 'hdarfade', 'marulana', 'sgolusul', 'vasileska', 'nvokeke', 'vrai3', 'aveerana', 'cchoppal', 'ctsai33', 'gsjurado', None, 'navnano1034', 'sbassa', 'araguil3', 'daolive1', 'tramesh', 'egruel', 'spolava1', 'smurali2951', 'rgudipat', 'vkumar21']"
13,291,46,9,4,"['djjohn22', 'rezavatan64', 'tyang66', 'marulana']",41,"['amadatha', 'gseeniva', 'mewcarpenter13', 'raalneya', 'pryan2', 'jperki3', 'iwelland', 'mkcotton', 'abalaji6', 'shruthiv1', 'wstumph', 'oakalthaidi', 'jmbeltr3', 'hdarfade', 'sgovin10', 'aparame2', 'lelaprol', 'vrames14', 'andrewwarrn', 'sgolusul', 'vrames13', 'nvokeke', 'tpage3', 'molybdenum94', 'vrai3', 'aveerana', 'pmuliyil', 'cchoppal', 'ctsai33', 'adas43', 'gsjurado', 'navnano1034', 'sbassa', 'araguil3', 'daolive1', 'jager', 'tramesh', 'egruel', 'rgudipat', 'vkumar21', 'abhinaba123']",5,"['vasileska', 'spolava1', 'smurali2951', 'nmohanku', None]",50,"['amadatha', 'gseeniva', 'mewcarpenter13', 'djjohn22', 'raalneya', 'pryan2', 'jperki3', 'iwelland', 'mkcotton', 'abalaji6', 'shruthiv1', 'nmohanku', 'wstumph', 'oakalthaidi', 'jmbeltr3', 'hdarfade', 'sgovin10', 'aparame2', 'marulana', 'lelaprol', 'vrames14', 'andrewwarrn', 'sgolusul', 'vasileska', 'vrames13', 'nvokeke', 'rezavatan64', 'tpage3', 'molybdenum94', 'vrai3', 'aveerana', 'pmuliyil', 'cchoppal', 'ctsai33', 'adas43', 'gsjurado', 'tyang66', 'navnano1034', 'sbassa', 'araguil3', 'daolive1', 'jager', 'tramesh', None, 'egruel', 'spolava1', 'smurali2951', 'rgudipat', 'vkumar21', 'abhinaba123']"
13,93,46,6,3,"['mkcotton', 'aveerana', 'jmbeltr3']",42,"['amadatha', 'gseeniva', 'mewcarpenter13', 'djjohn22', 'raalneya', 'pryan2', 'jperki3', 'iwelland', 'abalaji6', 'shruthiv1', 'wstumph', 'oakalthaidi', 'hdarfade', 'sgovin10', 'aparame2', 'marulana', 'lelaprol', 'vrames14', 'andrewwarrn', 'sgolusul', 'vrames13', 'nvokeke', 'rezavatan64', 'tpage3', 'molybdenum94', 'vrai3', 'pmuliyil', 'cchoppal', 'ctsai33', 'adas43', 'gsjurado', 'tyang66', 'navnano1034', 'sbassa', 'araguil3', 'daolive1', 'jager', 'tramesh', 'egruel', 'rgudipat', 'vkumar21', 'abhinaba123']",3,"[None, 'ksurapar', 'snemaniw']",48,"['amadatha', 'gseeniva', 'mewcarpenter13', 'djjohn22', 'raalneya', 'pryan2', 'jperki3', 'iwelland', 'mkcotton', 'abalaji6', 'shruthiv1', 'wstumph', 'oakalthaidi', 'jmbeltr3', 'hdarfade', 'sgovin10', 'aparame2', 'marulana', 'lelaprol', 'vrames14', 'andrewwarrn', 'sgolusul', 'snemaniw', 'vrames13', 'nvokeke', 'rezavatan64', 'tpage3', 'molybdenum94', 'vrai3', 'aveerana', 'ksurapar', 'pmuliyil', 'cchoppal', 'ctsai33', 'adas43', 'gsjurado', 'tyang66', 'navnano1034', 'sbassa', 'araguil3', 'daolive1', 'jager', 'tramesh', None, 'egruel', 'rgudipat', 'vkumar21', 'abhinaba123']"
14,392,46,40,1,['codylynde'],44,"['twinters', 'httmusial', 'zhilina.e.m', 'bknowlton', 'stinnesmil', 'zavdiel89', 'dorteplauborg', 'georgewarren', 'dtahaoglu', 'riccardotorsi', 'strcroft', 'kitesalman', 'cwalker', 'bjarkeakh', 'avazpourl', 'wjg82', 'armaghanehsani', 'williamcrow', 'kuntal123', 'majeed', 'nkatsou', 'guillermo.g.h', 'magnusgrafskou', 'andrescorrea', 'arminmirahcic', 'seanokelley', 'germarros', 'aaronbrown1', 'sakidja', 'yaizarodriguezortego', 'mbaatrup', 'lewaman', 'alejandromontoya', 'eoghanrattigan', 'ziyadbinsulaiman', 'janus_km', 'michaelhansen95', 'nickcarter', 'mjaal', 'jfreilich', 'bulow444', 'mopaak', 'belle6854', 'pauliwu']",39,"['mikehurley', 'jonhuff', 'kaiisaacs1', 'haaldowailah', 'sierraludwig', 'evansmith246', 'karilivingston', 'coreyefaw', 'soccor.ghuy', 'matthewgoelzer', 'fadelalatiqy', 'mitchellleibowitz', 'jennyfothergill', 'akvryan', 'theomoodley', 'lanlibsu', 'matthouston', 'saidarazaee', 'latifzamankhan', 'drewlysne', 'jamieadams2', 'shamidovic', 'zahraaalwazzan', 'thomasmonty', 'andreassavva', 'rick_326', 'raey69', 'danielcourtright', 'kelseymumford', None, 'bmw92', 'josephstellers924', 'conlanmarron', 'danniemakar', 'jihangaid', 'josephherker', 'jmd1', 'jimbuchanan', 'saeed00001']",84,"['bknowlton', 'httmusial', 'zavdiel89', 'sierraludwig', 'evansmith246', 'georgewarren', 'dtahaoglu', 'coreyefaw', 'riccardotorsi', 'soccor.ghuy', 'matthewgoelzer', 'fadelalatiqy', 'avazpourl', 'lanlibsu', 'wjg82', 'saidarazaee', 'williamcrow', 'latifzamankhan', 'drewlysne', 'majeed', 'jamieadams2', 'zahraaalwazzan', 'guillermo.g.h', 'magnusgrafskou', 'andreassavva', 'aaronbrown1', 'rick_326', 'danielcourtright', 'mbaatrup', 'lewaman', 'bmw92', 'eoghanrattigan', 'ziyadbinsulaiman', 'janus_km', 'michaelhansen95', 'conlanmarron', 'mjaal', 'jihangaid', 'jmd1', 'mopaak', 'jimbuchanan', 'raey69', 'saeed00001', 'pauliwu', 'mikehurley', 'twinters', 'jonhuff', 'zhilina.e.m', 'kaiisaacs1', 'stinnesmil', 'dorteplauborg', 'haaldowailah', 'karilivingston', 'strcroft', 'kitesalman', 'mitchellleibowitz', 'jennyfothergill', 'cwalker', 'bjarkeakh', 'akvryan', 'theomoodley', 'matthouston', 'armaghanehsani', 'kuntal123', 'nkatsou', 'shamidovic', 'andrescorrea', 'arminmirahcic', 'seanokelley', 'germarros', 'thomasmonty', 'sakidja', 'yaizarodriguezortego', 'kelseymumford', None, 'alejandromontoya', 'josephstellers924', 'nickcarter', 'danniemakar', 'jfreilich', 'codylynde', 'bulow444', 'josephherker', 'belle6854']"
14,383,46,25,21,"['bknowlton', 'twinters', 'zavdiel89', 'georgewarren', 'riccardotorsi', 'strcroft', 'cwalker', 'williamcrow', 'majeed', 'andrescorrea', 'arminmirahcic', 'seanokelley', 'aaronbrown1', 'yaizarodriguezortego', 'alejandromontoya', 'ziyadbinsulaiman', 'michaelhansen95', 'nickcarter', 'jfreilich', 'codylynde', 'belle6854']",24,"['httmusial', 'zhilina.e.m', 'stinnesmil', 'dorteplauborg', 'dtahaoglu', 'kitesalman', 'bjarkeakh', 'avazpourl', 'wjg82', 'armaghanehsani', 'kuntal123', 'nkatsou', 'guillermo.g.h', 'magnusgrafskou', 'germarros', 'sakidja', 'mbaatrup', 'lewaman', 'eoghanrattigan', 'janus_km', 'mjaal', 'bulow444', 'mopaak', 'pauliwu']",4,"['bmw92', 'lanlibsu', None, 'addielupercio']",49,"['twinters', 'httmusial', 'bknowlton', 'zhilina.e.m', 'stinnesmil', 'zavdiel89', 'dorteplauborg', 'georgewarren', 'dtahaoglu', 'riccardotorsi', 'strcroft', 'kitesalman', 'cwalker', 'bjarkeakh', 'avazpourl', 'lanlibsu', 'wjg82', 'armaghanehsani', 'addielupercio', 'williamcrow', 'kuntal123', 'majeed', 'nkatsou', 'guillermo.g.h', 'magnusgrafskou', 'andrescorrea', 'arminmirahcic', 'seanokelley', 'germarros', 'aaronbrown1', 'sakidja', 'yaizarodriguezortego', 'mbaatrup', None, 'lewaman', 'bmw92', 'alejandromontoya', 'eoghanrattigan', 'ziyadbinsulaiman', 'janus_km', 'michaelhansen95', 'nickcarter', 'mjaal', 'jfreilich', 'codylynde', 'bulow444', 'mopaak', 'belle6854', 'pauliwu']"
14,387,46,18,15,"['alejandromontoya', 'twinters', 'williamcrow', 'arminmirahcic', 'zavdiel89', 'ziyadbinsulaiman', 'michaelhansen95', 'cwalker', 'georgewarren', 'aaronbrown1', 'nickcarter', 'yaizarodriguezortego', 'codylynde', 'jfreilich', 'majeed']",30,"['bknowlton', 'httmusial', 'zhilina.e.m', 'stinnesmil', 'dorteplauborg', 'dtahaoglu', 'riccardotorsi', 'strcroft', 'kitesalman', 'bjarkeakh', 'avazpourl', 'wjg82', 'armaghanehsani', 'kuntal123', 'nkatsou', 'guillermo.g.h', 'magnusgrafskou', 'andrescorrea', 'seanokelley', 'germarros', 'sakidja', 'mbaatrup', 'lewaman', 'eoghanrattigan', 'janus_km', 'mjaal', 'bulow444', 'mopaak', 'belle6854', 'pauliwu']",3,"['bmw92', 'lanlibsu', None]",48,"['twinters', 'httmusial', 'bknowlton', 'zhilina.e.m', 'stinnesmil', 'zavdiel89', 'dorteplauborg', 'georgewarren', 'dtahaoglu', 'riccardotorsi', 'strcroft', 'kitesalman', 'cwalker', 'bjarkeakh', 'avazpourl', 'lanlibsu', 'wjg82', 'armaghanehsani', 'williamcrow', 'kuntal123', 'majeed', 'nkatsou', 'guillermo.g.h', 'magnusgrafskou', 'andrescorrea', 'arminmirahcic', 'seanokelley', 'germarros', 'aaronbrown1', 'sakidja', 'yaizarodriguezortego', 'mbaatrup', None, 'lewaman', 'bmw92', 'alejandromontoya', 'eoghanrattigan', 'ziyadbinsulaiman', 'janus_km', 'michaelhansen95', 'nickcarter', 'mjaal', 'jfreilich', 'codylynde', 'bulow444', 'mopaak', 'belle6854', 'pauliwu']"
14,382,46,15,13,"['httmusial', 'guillermo.g.h', 'magnusgrafskou', 'eoghanrattigan', 'stinnesmil', 'janus_km', 'dorteplauborg', 'bjarkeakh', 'mjaal', 'mbaatrup', 'bulow444', 'nkatsou', 'lewaman']",32,"['twinters', 'bknowlton', 'zhilina.e.m', 'zavdiel89', 'georgewarren', 'dtahaoglu', 'riccardotorsi', 'strcroft', 'kitesalman', 'cwalker', 'avazpourl', 'wjg82', 'armaghanehsani', 'williamcrow', 'kuntal123', 'majeed', 'andrescorrea', 'arminmirahcic', 'seanokelley', 'germarros', 'aaronbrown1', 'sakidja', 'yaizarodriguezortego', 'alejandromontoya', 'ziyadbinsulaiman', 'michaelhansen95', 'nickcarter', 'jfreilich', 'codylynde', 'mopaak', 'belle6854', 'pauliwu']",2,"['oriol.vendrell', None]",47,"['twinters', 'httmusial', 'bknowlton', 'zhilina.e.m', 'stinnesmil', 'zavdiel89', 'dorteplauborg', 'georgewarren', 'dtahaoglu', 'riccardotorsi', 'strcroft', 'kitesalman', 'cwalker', 'bjarkeakh', 'avazpourl', 'wjg82', 'armaghanehsani', 'williamcrow', 'kuntal123', 'majeed', 'nkatsou', 'guillermo.g.h', 'magnusgrafskou', 'andrescorrea', 'arminmirahcic', 'seanokelley', 'germarros', 'aaronbrown1', 'sakidja', 'yaizarodriguezortego', 'mbaatrup', 'oriol.vendrell', None, 'lewaman', 'alejandromontoya', 'eoghanrattigan', 'ziyadbinsulaiman', 'janus_km', 'michaelhansen95', 'nickcarter', 'mjaal', 'jfreilich', 'codylynde', 'bulow444', 'mopaak', 'belle6854', 'pauliwu']"
14,385,46,7,1,['kuntal123'],44,"['twinters', 'httmusial', 'bknowlton', 'zhilina.e.m', 'stinnesmil', 'zavdiel89', 'dorteplauborg', 'georgewarren', 'dtahaoglu', 'riccardotorsi', 'strcroft', 'kitesalman', 'cwalker', 'bjarkeakh', 'avazpourl', 'wjg82', 'armaghanehsani', 'williamcrow', 'majeed', 'nkatsou', 'guillermo.g.h', 'magnusgrafskou', 'andrescorrea', 'arminmirahcic', 'seanokelley', 'germarros', 'aaronbrown1', 'sakidja', 'yaizarodriguezortego', 'mbaatrup', 'lewaman', 'alejandromontoya', 'eoghanrattigan', 'ziyadbinsulaiman', 'janus_km', 'michaelhansen95', 'nickcarter', 'mjaal', 'jfreilich', 'codylynde', 'bulow444', 'mopaak', 'belle6854', 'pauliwu']",6,"['somsarang1990', 'damenpurt', 'eguerrero23', 'imtiaza20', 'dstrubbe', None]",51,"['twinters', 'httmusial', 'bknowlton', 'zhilina.e.m', 'eguerrero23', 'stinnesmil', 'zavdiel89', 'dorteplauborg', 'imtiaza20', 'georgewarren', 'dtahaoglu', 'riccardotorsi', 'strcroft', 'kitesalman', 'cwalker', 'bjarkeakh', 'avazpourl', 'wjg82', 'armaghanehsani', 'williamcrow', 'kuntal123', 'majeed', 'nkatsou', 'somsarang1990', 'guillermo.g.h', 'magnusgrafskou', 'andrescorrea', 'arminmirahcic', 'seanokelley', 'germarros', 'dstrubbe', 'aaronbrown1', 'sakidja', 'yaizarodriguezortego', 'mbaatrup', None, 'lewaman', 'alejandromontoya', 'eoghanrattigan', 'damenpurt', 'ziyadbinsulaiman', 'janus_km', 'michaelhansen95', 'nickcarter', 'mjaal', 'jfreilich', 'codylynde', 'bulow444', 'mopaak', 'belle6854', 'pauliwu']"
14,389,46,6,1,['kuntal123'],44,"['twinters', 'httmusial', 'bknowlton', 'zhilina.e.m', 'stinnesmil', 'zavdiel89', 'dorteplauborg', 'georgewarren', 'dtahaoglu', 'riccardotorsi', 'strcroft', 'kitesalman', 'cwalker', 'bjarkeakh', 'avazpourl', 'wjg82', 'armaghanehsani', 'williamcrow', 'majeed', 'nkatsou', 'guillermo.g.h', 'magnusgrafskou', 'andrescorrea', 'arminmirahcic', 'seanokelley', 'germarros', 'aaronbrown1', 'sakidja', 'yaizarodriguezortego', 'mbaatrup', 'lewaman', 'alejandromontoya', 'eoghanrattigan', 'ziyadbinsulaiman', 'janus_km', 'michaelhansen95', 'nickcarter', 'mjaal', 'jfreilich', 'codylynde', 'bulow444', 'mopaak', 'belle6854', 'pauliwu']",5,"['somsarang1990', 'damenpurt', 'eguerrero23', 'imtiaza20', None]",50,"['twinters', 'httmusial', 'bknowlton', 'zhilina.e.m', 'eguerrero23', 'stinnesmil', 'zavdiel89', 'dorteplauborg', 'imtiaza20', 'georgewarren', 'dtahaoglu', 'riccardotorsi', 'strcroft', 'kitesalman', 'cwalker', 'bjarkeakh', 'avazpourl', 'wjg82', 'armaghanehsani', 'williamcrow', 'kuntal123', 'majeed', 'nkatsou', 'somsarang1990', 'guillermo.g.h', 'magnusgrafskou', 'andrescorrea', 'arminmirahcic', 'seanokelley', 'germarros', 'aaronbrown1', 'sakidja', 'yaizarodriguezortego', 'mbaatrup', None, 'lewaman', 'alejandromontoya', 'eoghanrattigan', 'damenpurt', 'ziyadbinsulaiman', 'janus_km', 'michaelhansen95', 'nickcarter', 'mjaal', 'jfreilich', 'codylynde', 'bulow444', 'mopaak', 'belle6854', 'pauliwu']"
15,403,44,45,36,"['wmorton', 'kkingdon', 'kadair', 'khan106', 'mcapestr', 'leavittm', 'nmacke', 'figuero3', 'logan8', 'mbodziak', 'fbokhari', 'ghinkle', 'welch31', 'alichlyt', 'zhan1823', 'hobson7', 'johnwkeil', 'ncain3', 'clasky', 'abeckle', 'nbcain', 'mmuschar', 'jtrouba', 'erohrbac', 'ning2', 'ouyang6', 'richtern', 'jain139', 'cneudeck', 'davis635', 'pjgordon', 'colemaj', 'teeads', 'yang837', 'an49', 'adamjmiller']",7,"['smit2323', 'beggs', 'humphre4', 'burgosn', 'elliottt', 'sboes95', 'mviers']",9,"['mgolm', 'courtneyy', 'brendenh88', 'kohlerc', 'pan112', 'brettrasmus', 'eprussac', None, 'cooleys']",52,"['kadair', 'leavittm', 'sboes95', 'eprussac', 'mbodziak', 'logan8', 'ghinkle', 'courtneyy', 'johnwkeil', 'beggs', 'brendenh88', 'ncain3', 'burgosn', 'clasky', 'abeckle', 'cooleys', 'erohrbac', 'ning2', 'richtern', 'kohlerc', 'colemaj', 'an49', 'wmorton', 'kkingdon', 'khan106', 'humphre4', 'mcapestr', 'figuero3', 'nmacke', 'fbokhari', 'alichlyt', 'welch31', 'mgolm', 'zhan1823', 'hobson7', 'elliottt', 'brettrasmus', 'nbcain', 'mmuschar', 'jtrouba', 'ouyang6', 'jain139', 'pan112', 'cneudeck', 'davis635', None, 'mviers', 'pjgordon', 'smit2323', 'teeads', 'yang837', 'adamjmiller']"
16,64,39,92,3,"['mkhanvilkar', 'divya.shinde', 'inderjitsingh87']",35,"['rahulkamble9940', 'rahul.baddi', 'deepalisas13', 'pradhantn11e', 'brarath.nihal', 'shreyasgawali123', '4o4notfound', 'suyash.sc', 'gordonfu', 'peterbraganza52', 'k.gauswami', '1996jaypatel', 'mugdhas2030', 'adsoni468', 'sneha469', 'tushar.wadhaval', 'raghav20mishra', 'spodal24', 'seemam', 'sankethpjitta', 'jmihavel', 'dhruv16', 'singh5987', 'shubham4', 'sonali.ramji', 'yongjuneugene', 'aditi.adilip', 'prachiamrutkar16', 'vaishak', 'vik04', 'nivedita', 'ninawe14', 'ddangshiggy', 'ssatendra31', 'yadavsandeep793']",89,"['vinayakgadkari8', 'akashborhade123', 'naikpratiksha510', 'singhrajkarn1699', 'yuvraj.t', 'yashjivrajani7799', 'amolgolwankar', 'shibssalian', 'shreyas.v', 'smriti.sivadas96', 'alwin1996', 'suhayl4k', 'gvishs15', 'pguleria', 'shubhamgharat274', 'deeptimenon', 'danieldsilva96', 'cmahale95', 'sumasalian96', 'chinmaygawas', 'livz944', 'shrey.joshi', 'kumarkhandagle33', 'kharadesonam', 'anjali.kalmase', 'poojanale1996', 'pranjal17', 'prajwal.angolkar4', 'pravingowda28', 'mayank.vp', 'bnrnirmal94', 'npnishankpednekar', 'raj.vadariya', None, 'css_', 'rubina15', 'aniruddhaparte3', 'ashpillai.1996', 'shrutis31', 'tejalnaik12', 'abhaskar31', 'karar.bhadreshwara', 'keshvis26', 'abhijitharidas3107', 'kkiran31', 'pratik007', 'mayanair1104', 'prajoth.fernandes', 'kadampk15ex', 'aadi', 'sakshijoshi', 'kmamaniya', 'tejdhupkar', 'rashmithanair5', 'ketan.db', 'pratik.gc', 'chinmaysj96', 'akarnik.13', 'mayureshnagvekar57', 'aditya332', 'rnair10', 'varunmullins', 'temp999use', 'bpatel03', 'salianyatish111', 'jobin301', 'samsonkajar', 'apurva.nehru', 'ralph.rodrigues69', 'eshani2396', 'meet7', 'dghosalkar', 'varunndabhade', 'pjay10708', 'gsatpute64', 'krexianclass', 'jonathanrjpereira', 'yashgosar9', 'moraeseric123', 'adityagudla96', 'dheereshpoojary', 'sukhpreet11234kldfhd', 'nishumahapatro1995', 'pratik2225', 'bharatesh.a', 'cristyjne8', 'srevolution23', 'saniyasnair', 'shally']",127,"['deepalisas13', 'vinayakgadkari8', 'akashborhade123', 'naikpratiksha510', 'singhrajkarn1699', 'suyash.sc', 'yashjivrajani7799', 'yuvraj.t', 'amolgolwankar', 'gordonfu', 'peterbraganza52', 'shibssalian', 'mugdhas2030', 'shreyas.v', 'smriti.sivadas96', 'alwin1996', 'suhayl4k', 'jmihavel', 'gvishs15', 'pguleria', 'shubhamgharat274', 'singh5987', 'yongjuneugene', 'deeptimenon', 'vaishak', 'nivedita', 'danieldsilva96', 'cmahale95', 'sumasalian96', 'inderjitsingh87', 'chinmaygawas', 'pradhantn11e', 'shreyasgawali123', 'livz944', 'shrey.joshi', 'kumarkhandagle33', 'kharadesonam', 'anjali.kalmase', 'poojanale1996', 'adsoni468', 'pranjal17', 'mkhanvilkar', 'spodal24', 'sankethpjitta', 'prajwal.angolkar4', 'pravingowda28', 'mayank.vp', 'bnrnirmal94', 'npnishankpednekar', 'raj.vadariya', None, 'vik04', 'css_', 'rubina15', 'aniruddhaparte3', 'ssatendra31', 'ashpillai.1996', 'shrutis31', 'rahulkamble9940', 'rahul.baddi', 'tejalnaik12', 'abhaskar31', 'karar.bhadreshwara', 'keshvis26', '4o4notfound', 'abhijitharidas3107', 'kkiran31', 'pratik007', 'mayanair1104', 'prajoth.fernandes', 'k.gauswami', 'kadampk15ex', 'aadi', 'seemam', 'sakshijoshi', 'kmamaniya', 'dhruv16', 'tejdhupkar', 'rashmithanair5', 'ketan.db', 'pratik.gc', 'chinmaysj96', 'akarnik.13', 'mayureshnagvekar57', 'aditya332', 'rnair10', 'yadavsandeep793', 'varunmullins', 'divya.shinde', 'brarath.nihal', 'temp999use', 'bpatel03', 'salianyatish111', 'jobin301', 'samsonkajar', 'apurva.nehru', 'ralph.rodrigues69', '1996jaypatel', 'eshani2396', 'sneha469', 'tushar.wadhaval', 'meet7', 'raghav20mishra', 'dghosalkar', 'varunndabhade', 'sonali.ramji', 'shubham4', 'pjay10708', 'aditi.adilip', 'prachiamrutkar16', 'gsatpute64', 'krexianclass', 'jonathanrjpereira', 'yashgosar9', 'moraeseric123', 'adityagudla96', 'dheereshpoojary', 'ninawe14', 'sukhpreet11234kldfhd', 'nishumahapatro1995', 'pratik2225', 'ddangshiggy', 'bharatesh.a', 'cristyjne8', 'srevolution23', 'saniyasnair', 'shally']"
16,60,39,59,24,"['rahul.baddi', 'deepalisas13', 'divya.shinde', 'pradhantn11e', 'brarath.nihal', 'suyash.sc', 'peterbraganza52', '1996jaypatel', 'mugdhas2030', 'adsoni468', 'sneha469', 'tushar.wadhaval', 'spodal24', 'seemam', 'jmihavel', 'dhruv16', 'singh5987', 'sonali.ramji', 'aditi.adilip', 'prachiamrutkar16', 'vaishak', 'ninawe14', 'ssatendra31', 'yadavsandeep793']",14,"['rahulkamble9940', 'mkhanvilkar', 'vik04', 'gordonfu', 'nivedita', 'k.gauswami', 'shreyasgawali123', 'sankethpjitta', 'ddangshiggy', '4o4notfound', 'shubham4', 'inderjitsingh87', 'yongjuneugene', 'raghav20mishra']",35,"['vivekrana', 'pbhaveshv15et', 'roshusakpal89', 'tanmay9', 'vinayakgadkari8', 'gnthakore', 'varunmullins', 'pallavivalunj', 'pratimadas1996', 'ankit.pandey', 'spawar09', 'vaibhavkokare2011', 'stevenevendsouza23', 'meet7', 'sahilboble25', 'pateltejash96', 'chahat.s', 'sjayyant31', 'senmathew329', 'mayank.vp', 'kmamaniya', 'samuelalmeida17', 'raj.vadariya', 'shubhamgharat274', None, 'ketan.db', 'dshaikh4', 'nirav.lm', 'krexianclass', 'murzellobenz', 'vvipul31', 'treesaachu', 'marcmathew', 'vaibhavnagar08', 'yashuishwar']",73,"['rahulkamble9940', 'rahul.baddi', 'deepalisas13', 'tanmay9', 'vinayakgadkari8', '4o4notfound', 'suyash.sc', 'pallavivalunj', 'pratimadas1996', 'gordonfu', 'peterbraganza52', 'k.gauswami', 'mugdhas2030', 'spawar09', 'vaibhavkokare2011', 'sahilboble25', 'seemam', 'senmathew329', 'jmihavel', 'kmamaniya', 'dhruv16', 'samuelalmeida17', 'shubhamgharat274', 'singh5987', 'yongjuneugene', 'ketan.db', 'dshaikh4', 'vaishak', 'nivedita', 'vvipul31', 'marcmathew', 'vaibhavnagar08', 'yashuishwar', 'inderjitsingh87', 'yadavsandeep793', 'vivekrana', 'pbhaveshv15et', 'roshusakpal89', 'varunmullins', 'divya.shinde', 'gnthakore', 'pradhantn11e', 'brarath.nihal', 'shreyasgawali123', 'ankit.pandey', '1996jaypatel', 'adsoni468', 'stevenevendsouza23', 'sneha469', 'tushar.wadhaval', 'meet7', 'raghav20mishra', 'pateltejash96', 'mkhanvilkar', 'chahat.s', 'spodal24', 'sjayyant31', 'sankethpjitta', 'mayank.vp', 'raj.vadariya', 'sonali.ramji', 'shubham4', None, 'aditi.adilip', 'prachiamrutkar16', 'vik04', 'krexianclass', 'nirav.lm', 'murzellobenz', 'ninawe14', 'ddangshiggy', 'treesaachu', 'ssatendra31']"
16,58,39,58,5,"['vaishak', 'nivedita', 'spodal24', 'k.gauswami', 'yadavsandeep793']",33,"['rahulkamble9940', 'rahul.baddi', 'deepalisas13', 'divya.shinde', 'pradhantn11e', 'brarath.nihal', 'shreyasgawali123', '4o4notfound', 'suyash.sc', 'gordonfu', 'peterbraganza52', '1996jaypatel', 'mugdhas2030', 'adsoni468', 'sneha469', 'tushar.wadhaval', 'raghav20mishra', 'mkhanvilkar', 'seemam', 'sankethpjitta', 'jmihavel', 'dhruv16', 'singh5987', 'shubham4', 'sonali.ramji', 'yongjuneugene', 'aditi.adilip', 'prachiamrutkar16', 'vik04', 'ninawe14', 'ddangshiggy', 'ssatendra31', 'inderjitsingh87']",53,"['vivekrana', 'priyankamali2510', 'pbhaveshv15et', 'salaskarsu15', 'roshusakpal89', 'orenavikar', 'parineetap0', 'tanmay9', 'milind123', 'gnthakore', 'deepalisingh195', 'sushmafn', 'ssmande', 'shubham.patil585', 'vishurajigare10', 'krunal.kasar', 'yuvraj.t', 'samirbobade', 'pratik007', 'vishal914', 'ralph.rodrigues69', 'uyewale', 'akhil.shetty37', 'spawar09', 'vaitysushant', 'sagarika260710', 'patil.chinmay04', 'svirendra31', 'pranjal17', 'pateltejash96', 'sahilboble25', 'chahat.s', 'sjayyant31', 'rasalvc15ex', 'skomald118', 'mayank.vp', 'raj.vadariya', 'nabhishek29', 'mdeshmukh', 'nikam468', 'sayali_m9', None, 'pratik.gc', 'dshaikh4', 'jonathanrjpereira', 'rubina15', 'vvipul31', 'jas.sahmbi123', 'ankitpandey1296', 'anil8796069443', 'juili.save', 'shally', 'shubhampatil2308']",91,"['rahulkamble9940', 'priyankamali2510', 'rahul.baddi', 'deepalisas13', 'salaskarsu15', 'tanmay9', 'sushmafn', 'shubham.patil585', '4o4notfound', 'suyash.sc', 'vishurajigare10', 'yuvraj.t', 'pratik007', 'gordonfu', 'peterbraganza52', 'k.gauswami', 'vishal914', 'uyewale', 'mugdhas2030', 'spawar09', 'patil.chinmay04', 'sahilboble25', 'seemam', 'jmihavel', 'skomald118', 'dhruv16', 'singh5987', 'nikam468', 'sayali_m9', 'yongjuneugene', 'pratik.gc', 'dshaikh4', 'vaishak', 'nivedita', 'vvipul31', 'jas.sahmbi123', 'ankitpandey1296', 'anil8796069443', 'inderjitsingh87', 'yadavsandeep793', 'shubhampatil2308', 'vivekrana', 'pbhaveshv15et', 'parineetap0', 'roshusakpal89', 'orenavikar', 'milind123', 'divya.shinde', 'gnthakore', 'pradhantn11e', 'brarath.nihal', 'shreyasgawali123', 'deepalisingh195', 'ssmande', 'samirbobade', 'krunal.kasar', 'ralph.rodrigues69', '1996jaypatel', 'akhil.shetty37', 'vaitysushant', 'adsoni468', 'sagarika260710', 'svirendra31', 'pranjal17', 'sneha469', 'tushar.wadhaval', 'pateltejash96', 'raghav20mishra', 'mkhanvilkar', 'chahat.s', 'spodal24', 'sjayyant31', 'rasalvc15ex', 'sankethpjitta', 'mayank.vp', 'raj.vadariya', 'nabhishek29', 'sonali.ramji', 'shubham4', 'mdeshmukh', None, 'aditi.adilip', 'prachiamrutkar16', 'vik04', 'jonathanrjpereira', 'rubina15', 'ninawe14', 'ddangshiggy', 'ssatendra31', 'juili.save', 'shally']"
16,56,39,50,6,"['mkhanvilkar', 'vaishak', 'nivedita', 'k.gauswami', 'seemam', 'yadavsandeep793']",32,"['rahulkamble9940', 'rahul.baddi', 'deepalisas13', 'divya.shinde', 'pradhantn11e', 'brarath.nihal', 'shreyasgawali123', '4o4notfound', 'suyash.sc', 'gordonfu', 'peterbraganza52', '1996jaypatel', 'mugdhas2030', 'adsoni468', 'sneha469', 'tushar.wadhaval', 'raghav20mishra', 'spodal24', 'sankethpjitta', 'jmihavel', 'dhruv16', 'singh5987', 'shubham4', 'sonali.ramji', 'yongjuneugene', 'aditi.adilip', 'prachiamrutkar16', 'vik04', 'ninawe14', 'ddangshiggy', 'ssatendra31', 'inderjitsingh87']",44,"['priyankamali2510', 'prakshat095', 'tanmay9', 'milind123', 'gnthakore', 'raj.misal', 'sakshi.mandot', 'mugdhabhat1997', 'mkharkar', 'adnan.s', 'ssmande', 'samirbobade', 'krunal.kasar', 'yuvraj.t', 'shrey.joshi', 'gaurav.mishra', 'uyewale', 'vishalnaik.0210', 'vaitysushant', 'diksharth', 'shreyas.v', 'dkbathe29', 'niranjanbhavsar2491996', 'pateltejash96', 'waynemdsouza', 'sahilboble25', 'dghosalkar', 'suhayl4k', 'mahajanyashashree19', 'mayank.vp', 'pravingowda28', 'samuelalmeida17', 'mdeshmukh', 'nairabhi1571996', 'sayali_m9', None, 'pratik.gc', 'pjay10708', 'nirav.lm', 'aadi1212', 'bharatesh.a', 'naina', 'anil8796069443', 'zil.c']",82,"['rahulkamble9940', 'priyankamali2510', 'rahul.baddi', 'deepalisas13', 'tanmay9', 'raj.misal', 'sakshi.mandot', 'adnan.s', '4o4notfound', 'suyash.sc', 'yuvraj.t', 'gaurav.mishra', 'gordonfu', 'peterbraganza52', 'k.gauswami', 'uyewale', 'mugdhas2030', 'diksharth', 'shreyas.v', 'niranjanbhavsar2491996', 'waynemdsouza', 'sahilboble25', 'seemam', 'suhayl4k', 'jmihavel', 'dhruv16', 'samuelalmeida17', 'singh5987', 'sayali_m9', 'yongjuneugene', 'pratik.gc', 'vaishak', 'nivedita', 'naina', 'anil8796069443', 'zil.c', 'inderjitsingh87', 'yadavsandeep793', 'prakshat095', 'milind123', 'divya.shinde', 'gnthakore', 'pradhantn11e', 'brarath.nihal', 'shreyasgawali123', 'mugdhabhat1997', 'mkharkar', 'ssmande', 'samirbobade', 'krunal.kasar', 'shrey.joshi', '1996jaypatel', 'vishalnaik.0210', 'vaitysushant', 'dkbathe29', 'adsoni468', 'sneha469', 'tushar.wadhaval', 'pateltejash96', 'raghav20mishra', 'mkhanvilkar', 'dghosalkar', 'spodal24', 'sankethpjitta', 'mahajanyashashree19', 'mayank.vp', 'pravingowda28', 'sonali.ramji', 'shubham4', 'mdeshmukh', 'nairabhi1571996', None, 'pjay10708', 'aditi.adilip', 'prachiamrutkar16', 'vik04', 'nirav.lm', 'ninawe14', 'ddangshiggy', 'aadi1212', 'bharatesh.a', 'ssatendra31']"
16,65,39,19,1,['ddangshiggy'],37,"['rahulkamble9940', 'rahul.baddi', 'deepalisas13', 'divya.shinde', 'pradhantn11e', 'brarath.nihal', 'shreyasgawali123', '4o4notfound', 'suyash.sc', 'gordonfu', 'peterbraganza52', 'k.gauswami', '1996jaypatel', 'mugdhas2030', 'adsoni468', 'sneha469', 'tushar.wadhaval', 'raghav20mishra', 'mkhanvilkar', 'spodal24', 'seemam', 'sankethpjitta', 'jmihavel', 'dhruv16', 'singh5987', 'shubham4', 'sonali.ramji', 'yongjuneugene', 'aditi.adilip', 'prachiamrutkar16', 'vaishak', 'vik04', 'nivedita', 'ninawe14', 'ssatendra31', 'inderjitsingh87', 'yadavsandeep793']",18,"['minki051613', 'jyh', 'acrokw0502', None, 'k910716kim', 'jung0hun', 'shnie29', 'semmz105', 'doqnqo', 'mvert157', 'gunhoo777', 'hwi', 'gordius92', 'poby', 'jung0hunkr', 'scribble9440', 'empire312', 'guheak92']",56,"['rahulkamble9940', 'rahul.baddi', 'jyh', 'deepalisas13', 'divya.shinde', 'pradhantn11e', 'brarath.nihal', 'shreyasgawali123', 'hwi', '4o4notfound', 'suyash.sc', 'scribble9440', 'k910716kim', 'gordonfu', 'peterbraganza52', 'k.gauswami', '1996jaypatel', 'doqnqo', 'mugdhas2030', 'gunhoo777', 'adsoni468', 'empire312', 'sneha469', 'tushar.wadhaval', 'guheak92', 'raghav20mishra', 'mkhanvilkar', 'acrokw0502', 'spodal24', 'semmz105', 'seemam', 'sankethpjitta', 'jmihavel', 'dhruv16', 'gordius92', 'singh5987', 'shubham4', 'sonali.ramji', None, 'yongjuneugene', 'aditi.adilip', 'minki051613', 'prachiamrutkar16', 'vaishak', 'vik04', 'nivedita', 'jung0hun', 'shnie29', 'mvert157', 'ninawe14', 'ddangshiggy', 'ssatendra31', 'jung0hunkr', 'poby', 'inderjitsingh87', 'yadavsandeep793']"
16,62,39,13,3,"['mugdhas2030', 'brarath.nihal', 'jmihavel']",35,"['rahulkamble9940', 'rahul.baddi', 'deepalisas13', 'divya.shinde', 'pradhantn11e', 'shreyasgawali123', '4o4notfound', 'suyash.sc', 'gordonfu', 'peterbraganza52', 'k.gauswami', '1996jaypatel', 'adsoni468', 'sneha469', 'tushar.wadhaval', 'raghav20mishra', 'mkhanvilkar', 'spodal24', 'seemam', 'sankethpjitta', 'dhruv16', 'singh5987', 'shubham4', 'sonali.ramji', 'yongjuneugene', 'aditi.adilip', 'prachiamrutkar16', 'vaishak', 'vik04', 'nivedita', 'ninawe14', 'ddangshiggy', 'ssatendra31', 'inderjitsingh87', 'yadavsandeep793']",10,"['pratimadas1996', 'vinayakgadkari8', 'varunmullins', 'stevenevendsouza23', 'samuelalmeida17', 'treesaachu', 'vaibhavkokare2011', 'marcmathew', 'vaibhavnagar08', None]",48,"['rahulkamble9940', 'rahul.baddi', 'deepalisas13', 'vinayakgadkari8', 'divya.shinde', 'varunmullins', 'pradhantn11e', 'brarath.nihal', 'shreyasgawali123', '4o4notfound', 'suyash.sc', 'pratimadas1996', 'gordonfu', 'peterbraganza52', 'k.gauswami', '1996jaypatel', 'mugdhas2030', 'vaibhavkokare2011', 'adsoni468', 'stevenevendsouza23', 'sneha469', 'tushar.wadhaval', 'raghav20mishra', 'mkhanvilkar', 'spodal24', 'seemam', 'sankethpjitta', 'jmihavel', 'dhruv16', 'samuelalmeida17', 'singh5987', 'shubham4', 'sonali.ramji', None, 'yongjuneugene', 'aditi.adilip', 'prachiamrutkar16', 'vaishak', 'vik04', 'nivedita', 'ninawe14', 'ddangshiggy', 'treesaachu', 'marcmathew', 'ssatendra31', 'vaibhavnagar08', 'inderjitsingh87', 'yadavsandeep793']"
16,61,39,12,6,"['rahulkamble9940', 'vik04', 'sankethpjitta', 'shreyasgawali123', '4o4notfound', 'shubham4']",32,"['rahul.baddi', 'deepalisas13', 'divya.shinde', 'pradhantn11e', 'brarath.nihal', 'suyash.sc', 'gordonfu', 'peterbraganza52', 'k.gauswami', '1996jaypatel', 'mugdhas2030', 'adsoni468', 'sneha469', 'tushar.wadhaval', 'raghav20mishra', 'mkhanvilkar', 'spodal24', 'seemam', 'jmihavel', 'dhruv16', 'singh5987', 'sonali.ramji', 'yongjuneugene', 'aditi.adilip', 'prachiamrutkar16', 'vaishak', 'nivedita', 'ninawe14', 'ddangshiggy', 'ssatendra31', 'inderjitsingh87', 'yadavsandeep793']",6,"['srajannaik', 'adityagudla96', 'varunndabhade', 'sohamgharat27496', 'shubhamgharat274', None]",44,"['rahulkamble9940', 'rahul.baddi', 'deepalisas13', 'divya.shinde', 'pradhantn11e', 'brarath.nihal', 'shreyasgawali123', '4o4notfound', 'suyash.sc', 'gordonfu', 'peterbraganza52', 'k.gauswami', '1996jaypatel', 'mugdhas2030', 'sohamgharat27496', 'adsoni468', 'sneha469', 'tushar.wadhaval', 'raghav20mishra', 'mkhanvilkar', 'spodal24', 'seemam', 'varunndabhade', 'sankethpjitta', 'jmihavel', 'dhruv16', 'shubhamgharat274', 'singh5987', 'shubham4', 'sonali.ramji', None, 'yongjuneugene', 'aditi.adilip', 'prachiamrutkar16', 'vaishak', 'vik04', 'nivedita', 'srajannaik', 'adityagudla96', 'ninawe14', 'ddangshiggy', 'ssatendra31', 'inderjitsingh87', 'yadavsandeep793']"
16,57,39,7,1,['peterbraganza52'],37,"['rahulkamble9940', 'rahul.baddi', 'deepalisas13', 'divya.shinde', 'pradhantn11e', 'brarath.nihal', 'shreyasgawali123', '4o4notfound', 'suyash.sc', 'gordonfu', 'k.gauswami', '1996jaypatel', 'mugdhas2030', 'adsoni468', 'sneha469', 'tushar.wadhaval', 'raghav20mishra', 'mkhanvilkar', 'spodal24', 'seemam', 'sankethpjitta', 'jmihavel', 'dhruv16', 'singh5987', 'shubham4', 'sonali.ramji', 'yongjuneugene', 'aditi.adilip', 'prachiamrutkar16', 'vaishak', 'vik04', 'nivedita', 'ninawe14', 'ddangshiggy', 'ssatendra31', 'inderjitsingh87', 'yadavsandeep793']",6,"['mugdhabhat1997', 'samuelalmeida17', 'stevenevendsouza23', 'aayush2298', None, 'waynemdsouza']",44,"['rahulkamble9940', 'rahul.baddi', 'deepalisas13', 'divya.shinde', 'pradhantn11e', 'brarath.nihal', 'shreyasgawali123', 'mugdhabhat1997', '4o4notfound', 'suyash.sc', 'gordonfu', 'peterbraganza52', 'k.gauswami', '1996jaypatel', 'mugdhas2030', 'adsoni468', 'stevenevendsouza23', 'sneha469', 'tushar.wadhaval', 'waynemdsouza', 'raghav20mishra', 'mkhanvilkar', 'spodal24', 'seemam', 'sankethpjitta', 'jmihavel', 'dhruv16', 'samuelalmeida17', 'singh5987', 'shubham4', 'sonali.ramji', None, 'yongjuneugene', 'aditi.adilip', 'prachiamrutkar16', 'vaishak', 'vik04', 'nivedita', 'ninawe14', 'ddangshiggy', 'ssatendra31', 'aayush2298', 'inderjitsingh87', 'yadavsandeep793']"
17,243,39,34,28,"['ghuynh', 'sherryok', 'nmj10', 'manav.avlani', 'neildhar', 'judisanchez24', 'dukexy123', 'siddarth07', 'alexzap', 'wlkrwilletts', 'stephen.xu.42', 'culbertalex', 'jphilippe23', 'sunytranquility', 'brandondr96', 'bwelton', 'han.yu', 'websterbei', 'trishul.nagenalli', 'wang.michael213', 'afl13', 'sakuray10', 'savini3', 'yangjcandy', 'yx114', 'august', 'frankyin970709', 'ddmf']",10,"['sagar1gaik', 'ericwash', 'neelkhutale19', 'tanmaychandavarkar7', 'charmbond', 'rishi26', 'jos_fran79', 'thyagugowda', 'lekez2005', 'dennishan123']",6,"['vov1337', 'greggoldmanh', 'littlefingers', 'cfleeting1', None, 'briere.maddie']",44,"['ghuynh', 'neelkhutale19', 'sherryok', 'yx114', 'judisanchez24', 'nmj10', 'neildhar', 'manav.avlani', 'cfleeting1', 'thyagugowda', 'dukexy123', 'siddarth07', 'alexzap', 'wlkrwilletts', 'rishi26', 'tanmaychandavarkar7', 'stephen.xu.42', 'charmbond', 'culbertalex', 'lekez2005', 'briere.maddie', 'jphilippe23', 'sunytranquility', 'vov1337', 'ericwash', 'littlefingers', 'brandondr96', 'bwelton', None, 'han.yu', 'dennishan123', 'websterbei', 'sagar1gaik', 'trishul.nagenalli', 'wang.michael213', 'afl13', 'sakuray10', 'savini3', 'yangjcandy', 'jos_fran79', 'august', 'frankyin970709', 'ddmf', 'greggoldmanh']"
17,245,39,31,6,"['sagar1gaik', 'ericwash', 'tanmaychandavarkar7', 'rishi26', 'thyagugowda', 'dennishan123']",32,"['ghuynh', 'neelkhutale19', 'sherryok', 'judisanchez24', 'nmj10', 'neildhar', 'manav.avlani', 'dukexy123', 'siddarth07', 'alexzap', 'wlkrwilletts', 'stephen.xu.42', 'charmbond', 'culbertalex', 'lekez2005', 'jphilippe23', 'sunytranquility', 'brandondr96', 'bwelton', 'han.yu', 'websterbei', 'jos_fran79', 'trishul.nagenalli', 'wang.michael213', 'afl13', 'sakuray10', 'savini3', 'yangjcandy', 'yx114', 'august', 'frankyin970709', 'ddmf']",25,"['tanmaychandavarkar', 'saipranith257', 'hugos111', 'ashwingour', 'kkshehab95', 'jyothi2603', 'neelgajjar', 'razarath', 'nibble', 'ashaallen', 'kuruvila592', 'johnchou', '893400291ab', 'chaitra08', 'shreyasb_07', 'b200777', 'ashishgajalkar', None, 'btl', 'febatgeorge77', 'yandongluo', 'akshaylambat2393', '893524272cm', 'nekkanti', 'bhavigna1994']",63,"['tanmaychandavarkar', 'saipranith257', 'ghuynh', 'hugos111', 'ashwingour', 'kkshehab95', 'jyothi2603', 'neelkhutale19', 'sherryok', 'neelgajjar', 'yx114', 'judisanchez24', 'nmj10', 'neildhar', 'manav.avlani', 'razarath', 'nibble', 'ashaallen', 'kuruvila592', 'thyagugowda', 'dukexy123', 'siddarth07', 'alexzap', 'johnchou', 'wlkrwilletts', 'rishi26', 'tanmaychandavarkar7', 'stephen.xu.42', 'charmbond', '893400291ab', 'chaitra08', 'culbertalex', 'lekez2005', 'jphilippe23', 'sunytranquility', 'ericwash', 'shreyasb_07', 'brandondr96', 'b200777', 'ashishgajalkar', 'bwelton', None, 'han.yu', 'dennishan123', 'btl', 'websterbei', 'sagar1gaik', 'febatgeorge77', 'trishul.nagenalli', 'wang.michael213', 'afl13', 'yandongluo', 'akshaylambat2393', '893524272cm', 'nekkanti', 'sakuray10', 'savini3', 'yangjcandy', 'bhavigna1994', 'jos_fran79', 'august', 'frankyin970709', 'ddmf']"
18,64,39,92,10,"['amolgolwankar', 'kharadesonam', 'anjali.kalmase', 'css_', 'alwin1996', 'keshvis26', 'temp999use', 'srevolution23', 'sumasalian96', 'saniyasnair']",28,"['ruchira_ghule', 'pinakin', 'shrinishdonde', 'rajeshreesawale', 'mananmehta95', 'aagamshah999999999', 'sheetalchaudhari2210', 'divyavkhandkar.me', 'aamod1996', 'pallavi.valunj', 'dollarboyhardik', 'sagarika260710', 'pooja9702.pm', 'rwaghela51', 'tanvinj1', 'vipankoul1410', 'mehulkharvi7', 'chaitalivartak07', 'manassardar4444122', 'vandortshakti', 'jharupesh440', 'tzatakia', 'jamespatil1996', 'shah.shivani1702', 'niveshvaze', 'devashishmore478', 'meghana.loke02', 'ruchawaghulde']",82,"['vinayakgadkari8', 'akashborhade123', 'naikpratiksha510', 'singhrajkarn1699', 'yuvraj.t', 'yashjivrajani7799', 'shibssalian', 'shreyas.v', 'smriti.sivadas96', 'suhayl4k', 'gvishs15', 'pguleria', 'shubhamgharat274', 'deeptimenon', 'danieldsilva96', 'cmahale95', 'inderjitsingh87', 'chinmaygawas', 'livz944', 'shrey.joshi', 'kumarkhandagle33', 'poojanale1996', 'pranjal17', 'mkhanvilkar', 'prajwal.angolkar4', 'pravingowda28', 'mayank.vp', 'bnrnirmal94', 'npnishankpednekar', 'raj.vadariya', None, 'rubina15', 'aniruddhaparte3', 'ashpillai.1996', 'shrutis31', 'tejalnaik12', 'abhaskar31', 'karar.bhadreshwara', 'abhijitharidas3107', 'kkiran31', 'pratik007', 'mayanair1104', 'prajoth.fernandes', 'kadampk15ex', 'aadi', 'sakshijoshi', 'kmamaniya', 'tejdhupkar', 'rashmithanair5', 'ketan.db', 'pratik.gc', 'chinmaysj96', 'akarnik.13', 'mayureshnagvekar57', 'aditya332', 'rnair10', 'varunmullins', 'divya.shinde', 'bpatel03', 'salianyatish111', 'jobin301', 'samsonkajar', 'apurva.nehru', 'ralph.rodrigues69', 'eshani2396', 'meet7', 'dghosalkar', 'varunndabhade', 'pjay10708', 'gsatpute64', 'krexianclass', 'jonathanrjpereira', 'yashgosar9', 'moraeseric123', 'adityagudla96', 'dheereshpoojary', 'sukhpreet11234kldfhd', 'nishumahapatro1995', 'pratik2225', 'bharatesh.a', 'cristyjne8', 'shally']",120,"['ruchira_ghule', 'vinayakgadkari8', 'akashborhade123', 'naikpratiksha510', 'mananmehta95', 'singhrajkarn1699', 'yashjivrajani7799', 'yuvraj.t', 'amolgolwankar', 'shibssalian', 'sheetalchaudhari2210', 'shreyas.v', 'smriti.sivadas96', 'pooja9702.pm', 'tanvinj1', 'alwin1996', 'suhayl4k', 'gvishs15', 'pguleria', 'chaitalivartak07', 'manassardar4444122', 'shubhamgharat274', 'jharupesh440', 'tzatakia', 'deeptimenon', 'danieldsilva96', 'cmahale95', 'niveshvaze', 'sumasalian96', 'inderjitsingh87', 'chinmaygawas', 'livz944', 'rajeshreesawale', 'shrey.joshi', 'kumarkhandagle33', 'aagamshah999999999', 'kharadesonam', 'anjali.kalmase', 'poojanale1996', 'pallavi.valunj', 'pranjal17', 'mkhanvilkar', 'prajwal.angolkar4', 'pravingowda28', 'mayank.vp', 'bnrnirmal94', 'npnishankpednekar', 'raj.vadariya', 'vandortshakti', None, 'css_', 'rubina15', 'aniruddhaparte3', 'ashpillai.1996', 'meghana.loke02', 'shrutis31', 'ruchawaghulde', 'tejalnaik12', 'abhaskar31', 'karar.bhadreshwara', 'keshvis26', 'pinakin', 'shrinishdonde', 'abhijitharidas3107', 'kkiran31', 'pratik007', 'mayanair1104', 'prajoth.fernandes', 'kadampk15ex', 'dollarboyhardik', 'aadi', 'rwaghela51', 'sakshijoshi', 'kmamaniya', 'tejdhupkar', 'rashmithanair5', 'ketan.db', 'jamespatil1996', 'pratik.gc', 'chinmaysj96', 'akarnik.13', 'mayureshnagvekar57', 'aditya332', 'rnair10', 'varunmullins', 'divya.shinde', 'temp999use', 'bpatel03', 'salianyatish111', 'jobin301', 'samsonkajar', 'apurva.nehru', 'ralph.rodrigues69', 'divyavkhandkar.me', 'aamod1996', 'sagarika260710', 'eshani2396', 'meet7', 'dghosalkar', 'vipankoul1410', 'varunndabhade', 'mehulkharvi7', 'pjay10708', 'gsatpute64', 'krexianclass', 'jonathanrjpereira', 'yashgosar9', 'moraeseric123', 'adityagudla96', 'shah.shivani1702', 'dheereshpoojary', 'sukhpreet11234kldfhd', 'nishumahapatro1995', 'pratik2225', 'bharatesh.a', 'cristyjne8', 'srevolution23', 'devashishmore478', 'saniyasnair', 'shally']"
18,58,39,58,1,['sagarika260710'],37,"['ruchira_ghule', 'keshvis26', 'temp999use', 'pinakin', 'shrinishdonde', 'rajeshreesawale', 'mananmehta95', 'sumasalian96', 'aagamshah999999999', 'amolgolwankar', 'anjali.kalmase', 'kharadesonam', 'sheetalchaudhari2210', 'divyavkhandkar.me', 'aamod1996', 'pallavi.valunj', 'dollarboyhardik', 'pooja9702.pm', 'rwaghela51', 'tanvinj1', 'vipankoul1410', 'alwin1996', 'mehulkharvi7', 'chaitalivartak07', 'manassardar4444122', 'vandortshakti', 'jharupesh440', 'tzatakia', 'jamespatil1996', 'css_', 'shah.shivani1702', 'niveshvaze', 'srevolution23', 'devashishmore478', 'saniyasnair', 'meghana.loke02', 'ruchawaghulde']",57,"['vivekrana', 'priyankamali2510', 'shubhampatil2308', 'pbhaveshv15et', 'salaskarsu15', 'roshusakpal89', 'orenavikar', 'parineetap0', 'tanmay9', 'milind123', 'gnthakore', 'deepalisingh195', 'sushmafn', 'ssmande', 'shubham.patil585', 'vishurajigare10', 'krunal.kasar', 'yuvraj.t', 'samirbobade', 'pratik007', 'vishal914', 'k.gauswami', 'uyewale', 'ralph.rodrigues69', 'akhil.shetty37', 'spawar09', 'vaitysushant', 'svirendra31', 'patil.chinmay04', 'pranjal17', 'pateltejash96', 'sahilboble25', 'chahat.s', 'spodal24', 'sjayyant31', 'rasalvc15ex', 'skomald118', 'mayank.vp', 'raj.vadariya', 'nabhishek29', 'mdeshmukh', 'nikam468', 'sayali_m9', None, 'pratik.gc', 'dshaikh4', 'jonathanrjpereira', 'vaishak', 'nivedita', 'rubina15', 'vvipul31', 'jas.sahmbi123', 'ankitpandey1296', 'anil8796069443', 'juili.save', 'shally', 'yadavsandeep793']",95,"['priyankamali2510', 'ruchira_ghule', 'salaskarsu15', 'tanmay9', 'keshvis26', 'pinakin', 'sushmafn', 'shrinishdonde', 'shubham.patil585', 'mananmehta95', 'vishurajigare10', 'yuvraj.t', 'amolgolwankar', 'pratik007', 'vishal914', 'k.gauswami', 'uyewale', 'sheetalchaudhari2210', 'spawar09', 'dollarboyhardik', 'patil.chinmay04', 'rwaghela51', 'pooja9702.pm', 'sahilboble25', 'tanvinj1', 'alwin1996', 'skomald118', 'chaitalivartak07', 'manassardar4444122', 'jharupesh440', 'nikam468', 'sayali_m9', 'tzatakia', 'pratik.gc', 'jamespatil1996', 'dshaikh4', 'vaishak', 'nivedita', 'vvipul31', 'jas.sahmbi123', 'ankitpandey1296', 'niveshvaze', 'anil8796069443', 'sumasalian96', 'yadavsandeep793', 'shubhampatil2308', 'vivekrana', 'pbhaveshv15et', 'parineetap0', 'roshusakpal89', 'orenavikar', 'milind123', 'gnthakore', 'temp999use', 'deepalisingh195', 'rajeshreesawale', 'ssmande', 'samirbobade', 'krunal.kasar', 'aagamshah999999999', 'kharadesonam', 'anjali.kalmase', 'ralph.rodrigues69', 'akhil.shetty37', 'vaitysushant', 'divyavkhandkar.me', 'aamod1996', 'pallavi.valunj', 'sagarika260710', 'svirendra31', 'pranjal17', 'pateltejash96', 'vipankoul1410', 'chahat.s', 'spodal24', 'sjayyant31', 'rasalvc15ex', 'mayank.vp', 'mehulkharvi7', 'raj.vadariya', 'vandortshakti', 'nabhishek29', 'mdeshmukh', None, 'jonathanrjpereira', 'css_', 'rubina15', 'shah.shivani1702', 'srevolution23', 'juili.save', 'devashishmore478', 'saniyasnair', 'shally', 'meghana.loke02', 'ruchawaghulde']"
18,69,39,44,19,"['keshvis26', 'pinakin', 'shrinishdonde', 'rajeshreesawale', 'mananmehta95', 'aagamshah999999999', 'sheetalchaudhari2210', 'divyavkhandkar.me', 'pallavi.valunj', 'pooja9702.pm', 'tanvinj1', 'alwin1996', 'mehulkharvi7', 'chaitalivartak07', 'manassardar4444122', 'vandortshakti', 'niveshvaze', 'devashishmore478', 'meghana.loke02']",19,"['ruchira_ghule', 'temp999use', 'amolgolwankar', 'kharadesonam', 'anjali.kalmase', 'aamod1996', 'dollarboyhardik', 'sagarika260710', 'rwaghela51', 'vipankoul1410', 'jharupesh440', 'tzatakia', 'jamespatil1996', 'css_', 'shah.shivani1702', 'srevolution23', 'sumasalian96', 'saniyasnair', 'ruchawaghulde']",25,"['surbhib2897', 'techn720ab', 'rohitwaghmare1997', 'neha0206', 'yashjivrajani7799', 'kumarkhandagle33', 'sahil.sawant031996', 'vora.jai1', 'shreyasshah14', 'tripathishivam342', 'tanvishah2410', 'prerana', 'aditik2107', 'adityaprakash41', 'vidur888', 'raj.vadariya', None, 'ketan.db', 'rohitw0606', 'k25', 'rubina15', 'panchalparth417', 'aniruddhaparte3', 'ankitpandey1296', 'boy_with_nikon']",63,"['ruchira_ghule', 'techn720ab', 'rohitwaghmare1997', 'keshvis26', 'pinakin', 'shrinishdonde', 'mananmehta95', 'yashjivrajani7799', 'amolgolwankar', 'vora.jai1', 'shreyasshah14', 'sheetalchaudhari2210', 'tripathishivam342', 'dollarboyhardik', 'rwaghela51', 'pooja9702.pm', 'tanvishah2410', 'tanvinj1', 'prerana', 'aditik2107', 'alwin1996', 'vidur888', 'chaitalivartak07', 'manassardar4444122', 'jharupesh440', 'tzatakia', 'ketan.db', 'jamespatil1996', 'panchalparth417', 'ankitpandey1296', 'niveshvaze', 'sumasalian96', 'surbhib2897', 'temp999use', 'rajeshreesawale', 'neha0206', 'kumarkhandagle33', 'aagamshah999999999', 'kharadesonam', 'anjali.kalmase', 'sahil.sawant031996', 'divyavkhandkar.me', 'aamod1996', 'pallavi.valunj', 'sagarika260710', 'vipankoul1410', 'adityaprakash41', 'mehulkharvi7', 'raj.vadariya', 'vandortshakti', None, 'rohitw0606', 'k25', 'css_', 'rubina15', 'shah.shivani1702', 'aniruddhaparte3', 'srevolution23', 'boy_with_nikon', 'devashishmore478', 'saniyasnair', 'meghana.loke02', 'ruchawaghulde']"
18,173,39,44,18,"['amolgolwankar', 'ruchira_ghule', 'anjali.kalmase', 'kharadesonam', 'css_', 'alwin1996', 'keshvis26', 'sheetalchaudhari2210', 'chaitalivartak07', 'rajeshreesawale', 'niveshvaze', 'pallavi.valunj', 'srevolution23', 'sumasalian96', 'sagarika260710', 'meghana.loke02', 'saniyasnair', 'pooja9702.pm']",20,"['temp999use', 'pinakin', 'shrinishdonde', 'mananmehta95', 'aagamshah999999999', 'divyavkhandkar.me', 'aamod1996', 'dollarboyhardik', 'rwaghela51', 'tanvinj1', 'vipankoul1410', 'mehulkharvi7', 'manassardar4444122', 'vandortshakti', 'jharupesh440', 'tzatakia', 'jamespatil1996', 'shah.shivani1702', 'devashishmore478', 'ruchawaghulde']",26,"['jinal.sarvaiya.js', 'moreashank2', 'abhijitharidas3107', 'yuvraj.t', 'shrey.joshi', 'kumarkhandagle33', 'sahil.sawant031996', 'ankit.pandey', 'apurva.nehru', 'tinu', 'pranjal17', 'npnishankpednekar', 'kaushalmalaviya5', 'raj.vadariya', 'coolsprathamesh21', 'hamad42623', None, 'pragatidhekale', 'ketan.db', 'nirav.lm', 'jonathanrjpereira', 'rubina15', 'bharatesh.a', 'aditya332', 'juili.save', 'harshnsavla']",64,"['jinal.sarvaiya.js', 'ruchira_ghule', 'keshvis26', 'pinakin', 'shrinishdonde', 'mananmehta95', 'abhijitharidas3107', 'yuvraj.t', 'amolgolwankar', 'sheetalchaudhari2210', 'dollarboyhardik', 'rwaghela51', 'pooja9702.pm', 'tanvinj1', 'alwin1996', 'chaitalivartak07', 'kaushalmalaviya5', 'manassardar4444122', 'jharupesh440', 'coolsprathamesh21', 'tzatakia', 'pragatidhekale', 'jamespatil1996', 'ketan.db', 'niveshvaze', 'aditya332', 'sumasalian96', 'harshnsavla', 'temp999use', 'rajeshreesawale', 'moreashank2', 'shrey.joshi', 'kumarkhandagle33', 'aagamshah999999999', 'kharadesonam', 'anjali.kalmase', 'sahil.sawant031996', 'ankit.pandey', 'apurva.nehru', 'tinu', 'divyavkhandkar.me', 'aamod1996', 'pallavi.valunj', 'sagarika260710', 'pranjal17', 'vipankoul1410', 'mehulkharvi7', 'npnishankpednekar', 'raj.vadariya', 'vandortshakti', 'hamad42623', None, 'nirav.lm', 'jonathanrjpereira', 'css_', 'rubina15', 'shah.shivani1702', 'bharatesh.a', 'srevolution23', 'juili.save', 'devashishmore478', 'saniyasnair', 'meghana.loke02', 'ruchawaghulde']"
18,72,39,23,13,"['amolgolwankar', 'kharadesonam', 'dollarboyhardik', 'tanvinj1', 'css_', 'devashishmore478', 'alwin1996', 'shah.shivani1702', 'divyavkhandkar.me', 'sumasalian96', 'meghana.loke02', 'ruchawaghulde', 'tzatakia']",25,"['ruchira_ghule', 'keshvis26', 'temp999use', 'pinakin', 'shrinishdonde', 'rajeshreesawale', 'mananmehta95', 'aagamshah999999999', 'anjali.kalmase', 'sheetalchaudhari2210', 'aamod1996', 'pallavi.valunj', 'sagarika260710', 'pooja9702.pm', 'rwaghela51', 'vipankoul1410', 'mehulkharvi7', 'chaitalivartak07', 'manassardar4444122', 'vandortshakti', 'jharupesh440', 'jamespatil1996', 'niveshvaze', 'srevolution23', 'saniyasnair']",10,"['keshariaayesha', 'sahil.sawant031996', 'aditik2107', 'krexianclass', 'varshada15', 'vidur888', 'tripathishivam342', 'boy_with_nikon', 'neha0206', None]",48,"['ruchira_ghule', 'keshvis26', 'temp999use', 'pinakin', 'shrinishdonde', 'rajeshreesawale', 'mananmehta95', 'neha0206', 'aagamshah999999999', 'amolgolwankar', 'anjali.kalmase', 'kharadesonam', 'keshariaayesha', 'sahil.sawant031996', 'sheetalchaudhari2210', 'divyavkhandkar.me', 'aamod1996', 'tripathishivam342', 'pallavi.valunj', 'dollarboyhardik', 'sagarika260710', 'rwaghela51', 'pooja9702.pm', 'tanvinj1', 'vipankoul1410', 'aditik2107', 'alwin1996', 'varshada15', 'vidur888', 'mehulkharvi7', 'chaitalivartak07', 'manassardar4444122', 'vandortshakti', 'jharupesh440', 'devashishmore478', None, 'tzatakia', 'jamespatil1996', 'krexianclass', 'css_', 'shah.shivani1702', 'niveshvaze', 'srevolution23', 'boy_with_nikon', 'sumasalian96', 'saniyasnair', 'meghana.loke02', 'ruchawaghulde']"
18,180,39,21,6,"['jamespatil1996', 'tanvinj1', 'shah.shivani1702', 'divyavkhandkar.me', 'dollarboyhardik', 'ruchawaghulde']",32,"['ruchira_ghule', 'keshvis26', 'temp999use', 'pinakin', 'shrinishdonde', 'rajeshreesawale', 'mananmehta95', 'sumasalian96', 'aagamshah999999999', 'amolgolwankar', 'anjali.kalmase', 'kharadesonam', 'sheetalchaudhari2210', 'aamod1996', 'pallavi.valunj', 'sagarika260710', 'pooja9702.pm', 'rwaghela51', 'vipankoul1410', 'alwin1996', 'mehulkharvi7', 'chaitalivartak07', 'manassardar4444122', 'vandortshakti', 'jharupesh440', 'tzatakia', 'css_', 'niveshvaze', 'srevolution23', 'devashishmore478', 'saniyasnair', 'meghana.loke02']",15,"['keshariaayesha', 'aditik2107', 'krexianclass', 'justinvakkayil', 'upadhyechinmay', 'vidur888', 'danieldsilva96', 'vaibhavnagar08', 'shrivastavsomesh', 'tripathishivam342', 'boy_with_nikon', 'neha0206', 'aayush2298', None, 'kumarkhandagle33']",53,"['ruchira_ghule', 'keshvis26', 'temp999use', 'pinakin', 'shrinishdonde', 'rajeshreesawale', 'mananmehta95', 'neha0206', 'kumarkhandagle33', 'aagamshah999999999', 'amolgolwankar', 'anjali.kalmase', 'kharadesonam', 'keshariaayesha', 'justinvakkayil', 'vaibhavnagar08', 'sheetalchaudhari2210', 'divyavkhandkar.me', 'aamod1996', 'tripathishivam342', 'pallavi.valunj', 'dollarboyhardik', 'sagarika260710', 'rwaghela51', 'pooja9702.pm', 'tanvinj1', 'vipankoul1410', 'aditik2107', 'upadhyechinmay', 'alwin1996', 'vidur888', 'shrivastavsomesh', 'mehulkharvi7', 'chaitalivartak07', 'manassardar4444122', 'vandortshakti', 'jharupesh440', 'devashishmore478', 'aayush2298', None, 'tzatakia', 'jamespatil1996', 'krexianclass', 'css_', 'shah.shivani1702', 'danieldsilva96', 'niveshvaze', 'srevolution23', 'boy_with_nikon', 'sumasalian96', 'saniyasnair', 'meghana.loke02', 'ruchawaghulde']"
18,172,39,17,8,"['tanvinj1', 'kharadesonam', 'ruchira_ghule', 'keshvis26', 'mehulkharvi7', 'manassardar4444122', 'shrinishdonde', 'devashishmore478']",30,"['temp999use', 'pinakin', 'rajeshreesawale', 'mananmehta95', 'aagamshah999999999', 'amolgolwankar', 'anjali.kalmase', 'sheetalchaudhari2210', 'divyavkhandkar.me', 'aamod1996', 'pallavi.valunj', 'dollarboyhardik', 'sagarika260710', 'pooja9702.pm', 'rwaghela51', 'vipankoul1410', 'alwin1996', 'chaitalivartak07', 'vandortshakti', 'jharupesh440', 'tzatakia', 'jamespatil1996', 'css_', 'shah.shivani1702', 'niveshvaze', 'srevolution23', 'sumasalian96', 'saniyasnair', 'meghana.loke02', 'ruchawaghulde']",9,"['keshariaayesha', 'sahil.sawant031996', 'danieldsilva96', 'kaushalmalaviya5', 'ninadsc96', 'raj.vadariya', 'swapnalimakdey25', None, 'kumarkhandagle33']",47,"['ruchira_ghule', 'keshvis26', 'temp999use', 'pinakin', 'ninadsc96', 'shrinishdonde', 'rajeshreesawale', 'mananmehta95', 'kumarkhandagle33', 'aagamshah999999999', 'amolgolwankar', 'anjali.kalmase', 'kharadesonam', 'keshariaayesha', 'sahil.sawant031996', 'sheetalchaudhari2210', 'divyavkhandkar.me', 'aamod1996', 'pallavi.valunj', 'dollarboyhardik', 'sagarika260710', 'rwaghela51', 'pooja9702.pm', 'tanvinj1', 'vipankoul1410', 'alwin1996', 'mehulkharvi7', 'chaitalivartak07', 'kaushalmalaviya5', 'manassardar4444122', 'raj.vadariya', 'vandortshakti', 'jharupesh440', 'devashishmore478', None, 'tzatakia', 'jamespatil1996', 'css_', 'shah.shivani1702', 'danieldsilva96', 'swapnalimakdey25', 'niveshvaze', 'srevolution23', 'sumasalian96', 'saniyasnair', 'meghana.loke02', 'ruchawaghulde']"
18,177,39,16,2,"['alwin1996', 'aagamshah999999999']",36,"['ruchira_ghule', 'keshvis26', 'temp999use', 'pinakin', 'shrinishdonde', 'rajeshreesawale', 'mananmehta95', 'sumasalian96', 'amolgolwankar', 'kharadesonam', 'anjali.kalmase', 'sheetalchaudhari2210', 'divyavkhandkar.me', 'aamod1996', 'pallavi.valunj', 'dollarboyhardik', 'sagarika260710', 'pooja9702.pm', 'rwaghela51', 'tanvinj1', 'vipankoul1410', 'mehulkharvi7', 'chaitalivartak07', 'manassardar4444122', 'vandortshakti', 'jharupesh440', 'tzatakia', 'jamespatil1996', 'css_', 'shah.shivani1702', 'niveshvaze', 'srevolution23', 'devashishmore478', 'saniyasnair', 'meghana.loke02', 'ruchawaghulde']",14,"['aditik2107', 'riteshrajput381', 'justinvakkayil', 'siddhantssangal', 'senmathew329', 'vidur888', 'rohancontractor.rc', 'danieldsilva96', 'forumdesai96', 'shreyasshah14', 'tripathishivam342', 'neha0206', 'abhijitharidas3107', None]",52,"['ruchira_ghule', 'keshvis26', 'temp999use', 'pinakin', 'shrinishdonde', 'rajeshreesawale', 'mananmehta95', 'neha0206', 'abhijitharidas3107', 'aagamshah999999999', 'amolgolwankar', 'anjali.kalmase', 'kharadesonam', 'justinvakkayil', 'rohancontractor.rc', 'forumdesai96', 'sheetalchaudhari2210', 'shreyasshah14', 'divyavkhandkar.me', 'aamod1996', 'tripathishivam342', 'pallavi.valunj', 'dollarboyhardik', 'sagarika260710', 'rwaghela51', 'pooja9702.pm', 'tanvinj1', 'vipankoul1410', 'aditik2107', 'riteshrajput381', 'alwin1996', 'senmathew329', 'vidur888', 'mehulkharvi7', 'chaitalivartak07', 'manassardar4444122', 'vandortshakti', 'jharupesh440', 'devashishmore478', None, 'tzatakia', 'jamespatil1996', 'css_', 'siddhantssangal', 'shah.shivani1702', 'danieldsilva96', 'niveshvaze', 'srevolution23', 'sumasalian96', 'saniyasnair', 'meghana.loke02', 'ruchawaghulde']"
18,63,39,15,1,['temp999use'],37,"['ruchira_ghule', 'keshvis26', 'pinakin', 'shrinishdonde', 'rajeshreesawale', 'mananmehta95', 'sumasalian96', 'aagamshah999999999', 'amolgolwankar', 'anjali.kalmase', 'kharadesonam', 'sheetalchaudhari2210', 'divyavkhandkar.me', 'aamod1996', 'pallavi.valunj', 'dollarboyhardik', 'sagarika260710', 'pooja9702.pm', 'rwaghela51', 'tanvinj1', 'vipankoul1410', 'alwin1996', 'mehulkharvi7', 'chaitalivartak07', 'manassardar4444122', 'vandortshakti', 'jharupesh440', 'tzatakia', 'jamespatil1996', 'css_', 'shah.shivani1702', 'niveshvaze', 'srevolution23', 'devashishmore478', 'saniyasnair', 'meghana.loke02', 'ruchawaghulde']",14,"['pratik007', 'gsatpute64', 'jonathanrjpereira', None, 'apurva.nehru', 'rubina15', 'chinmaysj96', 'marcmathew', 'shubhamgharat274', 'eshani2396', 'shally', 'pranjal17', 'shrey.joshi', 'pratik.gc']",52,"['ruchira_ghule', 'keshvis26', 'temp999use', 'pinakin', 'shrinishdonde', 'rajeshreesawale', 'mananmehta95', 'shrey.joshi', 'aagamshah999999999', 'amolgolwankar', 'anjali.kalmase', 'kharadesonam', 'pratik007', 'apurva.nehru', 'sheetalchaudhari2210', 'divyavkhandkar.me', 'aamod1996', 'pallavi.valunj', 'dollarboyhardik', 'sagarika260710', 'pranjal17', 'eshani2396', 'rwaghela51', 'pooja9702.pm', 'tanvinj1', 'vipankoul1410', 'alwin1996', 'mehulkharvi7', 'chaitalivartak07', 'manassardar4444122', 'shubhamgharat274', 'vandortshakti', 'jharupesh440', 'devashishmore478', None, 'tzatakia', 'pratik.gc', 'jamespatil1996', 'gsatpute64', 'jonathanrjpereira', 'css_', 'rubina15', 'chinmaysj96', 'shah.shivani1702', 'niveshvaze', 'srevolution23', 'marcmathew', 'sumasalian96', 'saniyasnair', 'shally', 'meghana.loke02', 'ruchawaghulde']"
18,75,39,15,6,"['jamespatil1996', 'amolgolwankar', 'kharadesonam', 'alwin1996', 'srevolution23', 'pooja9702.pm']",32,"['ruchira_ghule', 'keshvis26', 'temp999use', 'pinakin', 'shrinishdonde', 'rajeshreesawale', 'mananmehta95', 'sumasalian96', 'aagamshah999999999', 'anjali.kalmase', 'sheetalchaudhari2210', 'divyavkhandkar.me', 'aamod1996', 'pallavi.valunj', 'dollarboyhardik', 'sagarika260710', 'rwaghela51', 'tanvinj1', 'vipankoul1410', 'mehulkharvi7', 'chaitalivartak07', 'manassardar4444122', 'vandortshakti', 'jharupesh440', 'tzatakia', 'css_', 'shah.shivani1702', 'niveshvaze', 'devashishmore478', 'saniyasnair', 'meghana.loke02', 'ruchawaghulde']",9,"['pranavp1311', 'tusharkumar', 'vidur888', 'panchalparth417', 'shrivastavsomesh', 'akarnik.13', 'tripathishivam342', 'abhijitharidas3107', None]",47,"['ruchira_ghule', 'keshvis26', 'temp999use', 'pinakin', 'shrinishdonde', 'rajeshreesawale', 'mananmehta95', 'abhijitharidas3107', 'aagamshah999999999', 'amolgolwankar', 'anjali.kalmase', 'kharadesonam', 'sheetalchaudhari2210', 'divyavkhandkar.me', 'aamod1996', 'tripathishivam342', 'pallavi.valunj', 'dollarboyhardik', 'sagarika260710', 'tusharkumar', 'rwaghela51', 'pooja9702.pm', 'tanvinj1', 'vipankoul1410', 'alwin1996', 'vidur888', 'shrivastavsomesh', 'mehulkharvi7', 'chaitalivartak07', 'manassardar4444122', 'vandortshakti', 'jharupesh440', 'devashishmore478', None, 'tzatakia', 'jamespatil1996', 'pranavp1311', 'css_', 'shah.shivani1702', 'panchalparth417', 'akarnik.13', 'niveshvaze', 'srevolution23', 'sumasalian96', 'saniyasnair', 'meghana.loke02', 'ruchawaghulde']"
18,174,39,13,2,"['anjali.kalmase', 'temp999use']",36,"['ruchira_ghule', 'keshvis26', 'pinakin', 'shrinishdonde', 'rajeshreesawale', 'mananmehta95', 'sumasalian96', 'aagamshah999999999', 'amolgolwankar', 'kharadesonam', 'sheetalchaudhari2210', 'divyavkhandkar.me', 'aamod1996', 'pallavi.valunj', 'dollarboyhardik', 'sagarika260710', 'pooja9702.pm', 'rwaghela51', 'tanvinj1', 'vipankoul1410', 'alwin1996', 'mehulkharvi7', 'chaitalivartak07', 'manassardar4444122', 'vandortshakti', 'jharupesh440', 'tzatakia', 'jamespatil1996', 'css_', 'shah.shivani1702', 'niveshvaze', 'srevolution23', 'devashishmore478', 'saniyasnair', 'meghana.loke02', 'ruchawaghulde']",11,"['ruchi61', 'neetavarkute', 'apurva.nehru', 'tinu', 'rubina15', 'coolsprathamesh21', 'juili.save', 'aditya332', 'shally', 'pranjal17', None]",49,"['ruchira_ghule', 'ruchi61', 'neetavarkute', 'keshvis26', 'temp999use', 'pinakin', 'shrinishdonde', 'rajeshreesawale', 'mananmehta95', 'aagamshah999999999', 'amolgolwankar', 'anjali.kalmase', 'kharadesonam', 'apurva.nehru', 'tinu', 'sheetalchaudhari2210', 'divyavkhandkar.me', 'aamod1996', 'pallavi.valunj', 'dollarboyhardik', 'sagarika260710', 'pranjal17', 'rwaghela51', 'pooja9702.pm', 'tanvinj1', 'vipankoul1410', 'alwin1996', 'mehulkharvi7', 'chaitalivartak07', 'manassardar4444122', 'vandortshakti', 'jharupesh440', 'devashishmore478', 'coolsprathamesh21', None, 'tzatakia', 'jamespatil1996', 'css_', 'rubina15', 'shah.shivani1702', 'niveshvaze', 'srevolution23', 'aditya332', 'juili.save', 'sumasalian96', 'saniyasnair', 'shally', 'meghana.loke02', 'ruchawaghulde']"
18,175,39,9,4,"['aagamshah999999999', 'pallavi.valunj', 'sheetalchaudhari2210', 'pinakin']",34,"['ruchira_ghule', 'keshvis26', 'temp999use', 'rajeshreesawale', 'shrinishdonde', 'mananmehta95', 'sumasalian96', 'amolgolwankar', 'kharadesonam', 'anjali.kalmase', 'divyavkhandkar.me', 'aamod1996', 'dollarboyhardik', 'sagarika260710', 'pooja9702.pm', 'rwaghela51', 'tanvinj1', 'vipankoul1410', 'alwin1996', 'mehulkharvi7', 'chaitalivartak07', 'manassardar4444122', 'vandortshakti', 'jharupesh440', 'tzatakia', 'jamespatil1996', 'css_', 'shah.shivani1702', 'niveshvaze', 'srevolution23', 'devashishmore478', 'saniyasnair', 'meghana.loke02', 'ruchawaghulde']",5,"['sahil.sawant031996', 'vidur888', 'ankitpandey1296', None, 'kumarkhandagle33']",43,"['ruchira_ghule', 'keshvis26', 'temp999use', 'pinakin', 'shrinishdonde', 'rajeshreesawale', 'mananmehta95', 'kumarkhandagle33', 'aagamshah999999999', 'amolgolwankar', 'anjali.kalmase', 'kharadesonam', 'sahil.sawant031996', 'sheetalchaudhari2210', 'divyavkhandkar.me', 'aamod1996', 'pallavi.valunj', 'dollarboyhardik', 'sagarika260710', 'rwaghela51', 'pooja9702.pm', 'tanvinj1', 'vipankoul1410', 'alwin1996', 'vidur888', 'mehulkharvi7', 'chaitalivartak07', 'manassardar4444122', 'vandortshakti', 'jharupesh440', 'devashishmore478', None, 'tzatakia', 'jamespatil1996', 'css_', 'shah.shivani1702', 'ankitpandey1296', 'niveshvaze', 'srevolution23', 'sumasalian96', 'saniyasnair', 'meghana.loke02', 'ruchawaghulde']"
18,73,39,8,3,"['tzatakia', 'aamod1996', 'ruchawaghulde']",35,"['ruchira_ghule', 'keshvis26', 'temp999use', 'pinakin', 'shrinishdonde', 'rajeshreesawale', 'mananmehta95', 'aagamshah999999999', 'amolgolwankar', 'anjali.kalmase', 'kharadesonam', 'sheetalchaudhari2210', 'divyavkhandkar.me', 'pallavi.valunj', 'dollarboyhardik', 'sagarika260710', 'rwaghela51', 'pooja9702.pm', 'tanvinj1', 'vipankoul1410', 'alwin1996', 'mehulkharvi7', 'chaitalivartak07', 'manassardar4444122', 'vandortshakti', 'jharupesh440', 'devashishmore478', 'jamespatil1996', 'css_', 'shah.shivani1702', 'niveshvaze', 'srevolution23', 'sumasalian96', 'saniyasnair', 'meghana.loke02']",5,"['vinayak183', 'harini.iyer', 'neha0206', 'gaurav.mahajan', None]",43,"['ruchira_ghule', 'keshvis26', 'temp999use', 'pinakin', 'shrinishdonde', 'rajeshreesawale', 'mananmehta95', 'neha0206', 'gaurav.mahajan', 'aagamshah999999999', 'amolgolwankar', 'anjali.kalmase', 'kharadesonam', 'vinayak183', 'sheetalchaudhari2210', 'divyavkhandkar.me', 'aamod1996', 'pallavi.valunj', 'dollarboyhardik', 'sagarika260710', 'rwaghela51', 'pooja9702.pm', 'tanvinj1', 'vipankoul1410', 'alwin1996', 'mehulkharvi7', 'chaitalivartak07', 'manassardar4444122', 'vandortshakti', 'jharupesh440', 'devashishmore478', 'harini.iyer', None, 'tzatakia', 'jamespatil1996', 'css_', 'shah.shivani1702', 'niveshvaze', 'srevolution23', 'sumasalian96', 'saniyasnair', 'meghana.loke02', 'ruchawaghulde']"
18,176,39,8,2,"['vandortshakti', 'jharupesh440']",36,"['ruchira_ghule', 'keshvis26', 'temp999use', 'pinakin', 'shrinishdonde', 'rajeshreesawale', 'mananmehta95', 'aagamshah999999999', 'amolgolwankar', 'anjali.kalmase', 'kharadesonam', 'sheetalchaudhari2210', 'divyavkhandkar.me', 'aamod1996', 'pallavi.valunj', 'dollarboyhardik', 'sagarika260710', 'rwaghela51', 'pooja9702.pm', 'tanvinj1', 'vipankoul1410', 'alwin1996', 'mehulkharvi7', 'chaitalivartak07', 'manassardar4444122', 'devashishmore478', 'tzatakia', 'jamespatil1996', 'css_', 'shah.shivani1702', 'niveshvaze', 'srevolution23', 'sumasalian96', 'saniyasnair', 'meghana.loke02', 'ruchawaghulde']",6,"['karan97km', 'goyal.suman312', 'nishant.joshi42', 'chinmayhejmadi', 'rohanrajeev21', None]",44,"['ruchira_ghule', 'keshvis26', 'temp999use', 'pinakin', 'shrinishdonde', 'rajeshreesawale', 'mananmehta95', 'aagamshah999999999', 'amolgolwankar', 'anjali.kalmase', 'kharadesonam', 'nishant.joshi42', 'sheetalchaudhari2210', 'divyavkhandkar.me', 'aamod1996', 'pallavi.valunj', 'dollarboyhardik', 'sagarika260710', 'rwaghela51', 'pooja9702.pm', 'tanvinj1', 'vipankoul1410', 'alwin1996', 'chinmayhejmadi', 'mehulkharvi7', 'chaitalivartak07', 'manassardar4444122', 'vandortshakti', 'jharupesh440', 'devashishmore478', None, 'tzatakia', 'jamespatil1996', 'karan97km', 'goyal.suman312', 'css_', 'shah.shivani1702', 'rohanrajeev21', 'niveshvaze', 'srevolution23', 'sumasalian96', 'saniyasnair', 'meghana.loke02', 'ruchawaghulde']"
18,179,39,7,2,"['rwaghela51', 'mananmehta95']",36,"['ruchira_ghule', 'keshvis26', 'temp999use', 'pinakin', 'shrinishdonde', 'rajeshreesawale', 'aagamshah999999999', 'amolgolwankar', 'anjali.kalmase', 'kharadesonam', 'sheetalchaudhari2210', 'divyavkhandkar.me', 'aamod1996', 'pallavi.valunj', 'dollarboyhardik', 'sagarika260710', 'pooja9702.pm', 'tanvinj1', 'vipankoul1410', 'alwin1996', 'mehulkharvi7', 'chaitalivartak07', 'manassardar4444122', 'vandortshakti', 'jharupesh440', 'devashishmore478', 'tzatakia', 'jamespatil1996', 'css_', 'shah.shivani1702', 'niveshvaze', 'srevolution23', 'sumasalian96', 'saniyasnair', 'meghana.loke02', 'ruchawaghulde']",5,"['vrushabhdesai.vd', 'siddhantssangal', 'chinmayhejmadi', 'ritugupta1102.rg97', None]",43,"['ruchira_ghule', 'keshvis26', 'temp999use', 'pinakin', 'shrinishdonde', 'rajeshreesawale', 'mananmehta95', 'aagamshah999999999', 'amolgolwankar', 'anjali.kalmase', 'kharadesonam', 'sheetalchaudhari2210', 'divyavkhandkar.me', 'aamod1996', 'pallavi.valunj', 'dollarboyhardik', 'sagarika260710', 'rwaghela51', 'pooja9702.pm', 'tanvinj1', 'vrushabhdesai.vd', 'vipankoul1410', 'alwin1996', 'ritugupta1102.rg97', 'chinmayhejmadi', 'mehulkharvi7', 'chaitalivartak07', 'manassardar4444122', 'vandortshakti', 'jharupesh440', 'devashishmore478', None, 'tzatakia', 'jamespatil1996', 'css_', 'siddhantssangal', 'shah.shivani1702', 'niveshvaze', 'srevolution23', 'sumasalian96', 'saniyasnair', 'meghana.loke02', 'ruchawaghulde']"
18,77,39,6,1,['amolgolwankar'],37,"['ruchira_ghule', 'keshvis26', 'temp999use', 'pinakin', 'shrinishdonde', 'rajeshreesawale', 'mananmehta95', 'aagamshah999999999', 'anjali.kalmase', 'kharadesonam', 'sheetalchaudhari2210', 'divyavkhandkar.me', 'aamod1996', 'pallavi.valunj', 'dollarboyhardik', 'sagarika260710', 'rwaghela51', 'pooja9702.pm', 'tanvinj1', 'vipankoul1410', 'alwin1996', 'mehulkharvi7', 'chaitalivartak07', 'manassardar4444122', 'vandortshakti', 'jharupesh440', 'devashishmore478', 'tzatakia', 'jamespatil1996', 'css_', 'shah.shivani1702', 'niveshvaze', 'srevolution23', 'sumasalian96', 'saniyasnair', 'meghana.loke02', 'ruchawaghulde']",5,"['shrivastavsomesh', 'pratiksha', 'akarnik.13', 'tripathishivam342', None]",43,"['ruchira_ghule', 'keshvis26', 'temp999use', 'pinakin', 'shrinishdonde', 'rajeshreesawale', 'mananmehta95', 'aagamshah999999999', 'amolgolwankar', 'anjali.kalmase', 'kharadesonam', 'sheetalchaudhari2210', 'divyavkhandkar.me', 'aamod1996', 'tripathishivam342', 'pallavi.valunj', 'dollarboyhardik', 'sagarika260710', 'rwaghela51', 'pooja9702.pm', 'tanvinj1', 'vipankoul1410', 'alwin1996', 'shrivastavsomesh', 'mehulkharvi7', 'chaitalivartak07', 'pratiksha', 'manassardar4444122', 'vandortshakti', 'jharupesh440', 'devashishmore478', None, 'tzatakia', 'jamespatil1996', 'css_', 'shah.shivani1702', 'akarnik.13', 'niveshvaze', 'srevolution23', 'sumasalian96', 'saniyasnair', 'meghana.loke02', 'ruchawaghulde']"
18,178,39,6,3,"['rwaghela51', 'vandortshakti', 'mananmehta95']",35,"['ruchira_ghule', 'keshvis26', 'temp999use', 'pinakin', 'shrinishdonde', 'rajeshreesawale', 'aagamshah999999999', 'amolgolwankar', 'anjali.kalmase', 'kharadesonam', 'sheetalchaudhari2210', 'divyavkhandkar.me', 'aamod1996', 'pallavi.valunj', 'dollarboyhardik', 'sagarika260710', 'pooja9702.pm', 'tanvinj1', 'vipankoul1410', 'alwin1996', 'mehulkharvi7', 'chaitalivartak07', 'manassardar4444122', 'jharupesh440', 'devashishmore478', 'tzatakia', 'jamespatil1996', 'css_', 'shah.shivani1702', 'niveshvaze', 'srevolution23', 'sumasalian96', 'saniyasnair', 'meghana.loke02', 'ruchawaghulde']",3,"['siddhantssangal', 'nishant.joshi42', None]",41,"['ruchira_ghule', 'keshvis26', 'temp999use', 'pinakin', 'shrinishdonde', 'rajeshreesawale', 'mananmehta95', 'aagamshah999999999', 'amolgolwankar', 'anjali.kalmase', 'kharadesonam', 'nishant.joshi42', 'sheetalchaudhari2210', 'divyavkhandkar.me', 'aamod1996', 'pallavi.valunj', 'dollarboyhardik', 'sagarika260710', 'rwaghela51', 'pooja9702.pm', 'tanvinj1', 'vipankoul1410', 'alwin1996', 'mehulkharvi7', 'chaitalivartak07', 'manassardar4444122', 'vandortshakti', 'jharupesh440', 'devashishmore478', None, 'tzatakia', 'jamespatil1996', 'css_', 'siddhantssangal', 'shah.shivani1702', 'niveshvaze', 'srevolution23', 'sumasalian96', 'saniyasnair', 'meghana.loke02', 'ruchawaghulde']"
19,270,35,40,34,"['nfinan', 'liu1888', 'mitch171', 'mooar', 'jeong76', 'zhan2536', 'reynol86', 'ren127', 'inmans', 'wheland', 'gerber24', 'allen264', 'fowlerh', 'mwardebe', 'zieglert', 'meberha', 'kkurpius', 'king357', 'evelezca', 'tgoldbe', 'hong224', 'john1879', 'hhermes', 'amartint', 'kline40', 'farrel18', 'llahrma16', 'dinino', 'mklingse', 'mill1914', 'rnederho', 'smit2625', 'nhightow', 'petrosky']",0,[],6,"['gentry9', 'fan184', 'robin198', None, 'wells89', 'wissela']",40,"['gentry9', 'nfinan', 'liu1888', 'mitch171', 'mooar', 'jeong76', 'zhan2536', 'fan184', 'robin198', 'reynol86', 'ren127', 'inmans', 'wheland', 'wells89', 'gerber24', 'allen264', 'fowlerh', 'mwardebe', 'zieglert', 'meberha', 'kkurpius', 'king357', 'evelezca', 'tgoldbe', 'hong224', 'john1879', 'hhermes', 'amartint', 'kline40', None, 'farrel18', 'llahrma16', 'dinino', 'mklingse', 'mill1914', 'rnederho', 'smit2625', 'nhightow', 'wissela', 'petrosky']"
20,187,35,32,30,"['pshyu2', 'varun278', 'yutingz3', 'yuehanxu', 'maamari2', 'smoshage', 'trzupek2', 'pppatel5', 'xbao4', 'amir.ostadi2007', 'kmmacdu2', 'wkim13', 'duffin2', 'aelarso2', 'jmwagner94', 'aszopa2', 'vguarin2', 'nivegdxb', 'lancezzz', 'mfcassi2', 'idaang2', 'mmart89', 'tcd3', 'mkim187', 'maye216', 'udoha2', 'haisler2', 'dsocha96', 'mlynnf92', 'sdemarc2']",4,"['glogana2', 'skaggar2', 'ptshyu2', 'hayesjackr']",2,"['zberent', None]",36,"['pshyu2', 'yutingz3', 'varun278', 'yuehanxu', 'glogana2', 'maamari2', 'smoshage', 'trzupek2', 'pppatel5', 'xbao4', 'hayesjackr', 'amir.ostadi2007', 'zberent', 'kmmacdu2', 'skaggar2', 'wkim13', 'duffin2', 'aelarso2', 'jmwagner94', 'aszopa2', 'vguarin2', 'nivegdxb', 'lancezzz', 'mfcassi2', 'idaang2', None, 'ptshyu2', 'mmart89', 'tcd3', 'mkim187', 'maye216', 'udoha2', 'haisler2', 'dsocha96', 'mlynnf92', 'sdemarc2']"
20,267,35,32,30,"['pshyu2', 'varun278', 'yutingz3', 'yuehanxu', 'maamari2', 'smoshage', 'trzupek2', 'pppatel5', 'xbao4', 'amir.ostadi2007', 'kmmacdu2', 'wkim13', 'duffin2', 'aelarso2', 'jmwagner94', 'aszopa2', 'vguarin2', 'nivegdxb', 'lancezzz', 'mfcassi2', 'idaang2', 'mmart89', 'tcd3', 'mkim187', 'maye216', 'udoha2', 'haisler2', 'dsocha96', 'mlynnf92', 'sdemarc2']",4,"['glogana2', 'skaggar2', 'ptshyu2', 'hayesjackr']",2,"['zberent', None]",36,"['pshyu2', 'yutingz3', 'varun278', 'yuehanxu', 'glogana2', 'maamari2', 'smoshage', 'trzupek2', 'pppatel5', 'xbao4', 'hayesjackr', 'amir.ostadi2007', 'zberent', 'kmmacdu2', 'skaggar2', 'wkim13', 'duffin2', 'aelarso2', 'jmwagner94', 'aszopa2', 'vguarin2', 'nivegdxb', 'lancezzz', 'mfcassi2', 'idaang2', None, 'ptshyu2', 'mmart89', 'tcd3', 'mkim187', 'maye216', 'udoha2', 'haisler2', 'dsocha96', 'mlynnf92', 'sdemarc2']"
20,268,35,30,28,"['yutingz3', 'yuehanxu', 'glogana2', 'maamari2', 'smoshage', 'pppatel5', 'xbao4', 'hayesjackr', 'amir.ostadi2007', 'kmmacdu2', 'skaggar2', 'duffin2', 'jmwagner94', 'aszopa2', 'vguarin2', 'nivegdxb', 'lancezzz', 'mfcassi2', 'idaang2', 'ptshyu2', 'mmart89', 'tcd3', 'mkim187', 'maye216', 'udoha2', 'dsocha96', 'mlynnf92', 'sdemarc2']",6,"['pshyu2', 'haisler2', 'varun278', 'wkim13', 'trzupek2', 'aelarso2']",2,"['widmarkjessica', None]",36,"['pshyu2', 'yutingz3', 'varun278', 'yuehanxu', 'glogana2', 'maamari2', 'smoshage', 'trzupek2', 'pppatel5', 'xbao4', 'hayesjackr', 'amir.ostadi2007', 'widmarkjessica', 'kmmacdu2', 'skaggar2', 'wkim13', 'duffin2', 'aelarso2', 'jmwagner94', 'aszopa2', 'vguarin2', 'nivegdxb', 'lancezzz', 'mfcassi2', 'idaang2', None, 'ptshyu2', 'mmart89', 'tcd3', 'mkim187', 'maye216', 'udoha2', 'haisler2', 'dsocha96', 'mlynnf92', 'sdemarc2']"
20,188,35,29,26,"['yutingz3', 'yuehanxu', 'glogana2', 'smoshage', 'pppatel5', 'xbao4', 'hayesjackr', 'amir.ostadi2007', 'kmmacdu2', 'skaggar2', 'duffin2', 'jmwagner94', 'aszopa2', 'vguarin2', 'nivegdxb', 'lancezzz', 'mfcassi2', 'idaang2', 'ptshyu2', 'mmart89', 'tcd3', 'mkim187', 'udoha2', 'dsocha96', 'mlynnf92', 'sdemarc2']",8,"['pshyu2', 'maye216', 'haisler2', 'varun278', 'wkim13', 'maamari2', 'trzupek2', 'aelarso2']",3,"['zberent', 'widmarkjessica', None]",37,"['pshyu2', 'yutingz3', 'varun278', 'yuehanxu', 'glogana2', 'maamari2', 'smoshage', 'trzupek2', 'pppatel5', 'xbao4', 'hayesjackr', 'amir.ostadi2007', 'zberent', 'widmarkjessica', 'kmmacdu2', 'skaggar2', 'wkim13', 'duffin2', 'aelarso2', 'jmwagner94', 'aszopa2', 'vguarin2', 'nivegdxb', 'lancezzz', 'mfcassi2', 'idaang2', None, 'ptshyu2', 'mmart89', 'tcd3', 'mkim187', 'maye216', 'udoha2', 'haisler2', 'dsocha96', 'mlynnf92', 'sdemarc2']"
21,39,35,58,2,"['brahms0827', 'kcj1127']",32,"['marinaboules9', 'mm16m010', 'mfathy97', 'theinstructive_man', 'ahmad.abdelaziz.ibrahim', 'luromark', 'sandy_luxor', 'hebaismail', 'es.so1995', 'emara2756300', 'hanatouni97', 'zyad_2012', 'ahmedelkayal', 'monicaaziz', 'abdelaziz', 'monicaaziz31', 'mohamedali915', 'ahmedbakla94', 'ok97', 'ahmadessam1997', 'engynageeb97', 'omarkhaledgadallah', 'mohammednasser', 'ahmed.k.shaker', 'h_ash96', 'gannatmagdy0', 'sohaanaselmashad', 'mdayman95', 'panos25', 'amrkotb', 'nadermoussa1', 'mohamed_tahoun']",56,"['sgu20131430', 'sgu20131440', 'sgu20121472', 'sgu20131467', 'sgu20131507', 'sgu20141523', 'mightynebula', 'sgu20131500', 'sgu20151515', 'sgu20121502', 'sgu20111471', 'sgu20131489', 'sgu20101584', 'sgu20131429', 'sgu20131413', 'sgu20131482', 'sgu20131496', 'sgu20141452', 'sgu20141488', 'sgu20111512', 'sgu20131426', 'sgu20131504', 'pplongi', 'sg20121208', 'kangtae', 'tulv37', 'sgu20131471', 'sgu20131494', 'sgu20121439', 'sgu20121486', 'sgu20151423', 'sgu20131443', 'sgu20141419', 'amirr89', 'sgu20141403', 'sgu20111258', 'sgu20111794', 'sgu20121528', None, 'sgu20121452', 'sgu20131422', 'sgu20121466', 'sgu20121423', 'sgu20121450', 'sgu20131466', 'sgu20131419', 'sgu20121494', 'sgu20131509', 'sgu20131437', 'sgu20141401', 'sgu20131499', 'sgu20131469', 'sgu20131486', 'sgu20141310', 'ruth59', 'sgu20121510']",90,"['marinaboules9', 'mfathy97', 'sgu20131430', 'theinstructive_man', 'sgu20121472', 'luromark', 'sgu20131507', 'sgu20141523', 'mightynebula', 'sgu20151515', 'emara2756300', 'hanatouni97', 'sgu20131413', 'zyad_2012', 'sgu20141452', 'sgu20141488', 'sgu20111512', 'sgu20131426', 'pplongi', 'monicaaziz', 'abdelaziz', 'sg20121208', 'ok97', 'mohamedali915', 'ahmedbakla94', 'kcj1127', 'sgu20131471', 'omarkhaledgadallah', 'sgu20131494', 'mohammednasser', 'h_ash96', 'sgu20151423', 'sgu20131443', 'sgu20141419', 'sohaanaselmashad', 'amirr89', 'mdayman95', 'sgu20111258', 'sgu20121528', 'sgu20131422', 'panos25', 'amrkotb', 'sgu20121466', 'mohamed_tahoun', 'sgu20121494', 'sgu20131437', 'sgu20141401', 'sgu20121502', 'sgu20141403', 'sgu20131509', 'ruth59', 'sgu20121510', 'mm16m010', 'sgu20131440', 'sgu20131467', 'ahmad.abdelaziz.ibrahim', 'sandy_luxor', 'sgu20131500', 'hebaismail', 'es.so1995', 'sgu20111471', 'sgu20131489', 'sgu20101584', 'sgu20131429', 'sgu20131482', 'sgu20131496', 'ahmedelkayal', 'sgu20131504', 'monicaaziz31', 'kangtae', 'tulv37', 'ahmadessam1997', 'engynageeb97', 'ahmed.k.shaker', 'sgu20121439', 'sgu20121486', 'brahms0827', 'gannatmagdy0', 'sgu20111794', None, 'sgu20121452', 'sgu20121423', 'nadermoussa1', 'sgu20121450', 'sgu20131466', 'sgu20131419', 'sgu20131499', 'sgu20131469', 'sgu20131486', 'sgu20141310']"
21,41,35,41,27,"['marinaboules9', 'mfathy97', 'theinstructive_man', 'ahmad.abdelaziz.ibrahim', 'sandy_luxor', 'hebaismail', 'es.so1995', 'emara2756300', 'hanatouni97', 'zyad_2012', 'ahmedelkayal', 'monicaaziz', 'abdelaziz', 'monicaaziz31', 'mohamedali915', 'ahmedbakla94', 'ok97', 'ahmadessam1997', 'engynageeb97', 'omarkhaledgadallah', 'ahmed.k.shaker', 'h_ash96', 'gannatmagdy0', 'sohaanaselmashad', 'amrkotb', 'nadermoussa1', 'mohamed_tahoun']",7,"['brahms0827', 'mm16m010', 'panos25', 'luromark', 'mdayman95', 'kcj1127', 'mohammednasser']",14,"['masterrub', 'mohamedhelal', 'alidrashwan', 'olamansour21', 'youssefemad', 'minaadel2017', 'paul94', 'mido28elashmawy', 'ahmed.saeed', 'norchan', 'bel5525', 'ahmed_yahia', 'ayausama1997', None]",48,"['marinaboules9', 'mm16m010', 'mfathy97', 'theinstructive_man', 'mohamedhelal', 'ahmad.abdelaziz.ibrahim', 'luromark', 'sandy_luxor', 'hebaismail', 'norchan', 'es.so1995', 'emara2756300', 'hanatouni97', 'zyad_2012', 'ahmedelkayal', 'masterrub', 'monicaaziz', 'abdelaziz', 'monicaaziz31', 'mohamedali915', 'ahmedbakla94', 'kcj1127', 'ok97', 'ahmadessam1997', 'ahmed.saeed', 'engynageeb97', 'omarkhaledgadallah', 'mohammednasser', 'ahmed.k.shaker', 'h_ash96', 'brahms0827', 'gannatmagdy0', 'alidrashwan', 'sohaanaselmashad', 'mdayman95', 'mido28elashmawy', None, 'panos25', 'amrkotb', 'olamansour21', 'youssefemad', 'minaadel2017', 'nadermoussa1', 'mohamed_tahoun', 'paul94', 'bel5525', 'ahmed_yahia', 'ayausama1997']"
22,147,34,33,19,"['clary0', 'ander677', 'bbattas', 'mcconneb', 'cmeisel', 'mkikend', 'lschroer24', 'shermang', 'sclevel', 'hvaught', 'abusker', 'hdebose', 'kebemis', 'apupillo', 'campb122', 'hrowlan', 'hweldy', 'smit2256', 'kcrew08']",14,"['harribas', 'ramos39', 'emeiner', 'wang2621', 'cpavlick', 'jokkema', 'zadeel', 'selazab', 'crguinn', 'gfukumot', 'kdecocke', 'higgin24', 'chaua', 'fodowd']",14,"['hasan10', 'gentry9', 'mgolm', 'parkermc', 'tay0', 'cooleys', 'acorda', 'ngaurav', 'jeinterz', 'carson22', 'bstegma', None, 'miramont', 'tstegall']",47,"['harribas', 'gentry9', 'clary0', 'tay0', 'acorda', 'ander677', 'carson22', 'bbattas', 'chaua', 'fodowd', 'ramos39', 'mgolm', 'mcconneb', 'selazab', 'cmeisel', 'mkikend', 'ngaurav', 'lschroer24', 'tstegall', 'cooleys', 'shermang', 'sclevel', 'hvaught', 'abusker', 'parkermc', 'crguinn', 'gfukumot', 'hdebose', 'kebemis', None, 'apupillo', 'miramont', 'hasan10', 'emeiner', 'campb122', 'wang2621', 'cpavlick', 'jokkema', 'zadeel', 'kdecocke', 'higgin24', 'hrowlan', 'hweldy', 'jeinterz', 'smit2256', 'bstegma', 'kcrew08']"
22,189,34,26,17,"['shermang', 'clary0', 'hvaught', 'sclevel', 'abusker', 'campb122', 'mcconneb', 'hrowlan', 'cpavlick', 'gfukumot', 'mkikend', 'hweldy', 'ander677', 'hdebose', 'kebemis', 'smit2256', 'apupillo']",16,"['harribas', 'ramos39', 'emeiner', 'wang2621', 'jokkema', 'zadeel', 'kdecocke', 'selazab', 'cmeisel', 'crguinn', 'higgin24', 'lschroer24', 'kcrew08', 'bbattas', 'chaua', 'fodowd']",9,"['gentry9', 'mgolm', 'tay0', 'cooleys', 'acorda', 'ngaurav', None, 'miramont', 'tstegall']",42,"['harribas', 'gentry9', 'clary0', 'tay0', 'acorda', 'ander677', 'bbattas', 'chaua', 'fodowd', 'ramos39', 'mgolm', 'mcconneb', 'selazab', 'cmeisel', 'mkikend', 'ngaurav', 'lschroer24', 'tstegall', 'cooleys', 'shermang', 'sclevel', 'hvaught', 'abusker', 'crguinn', 'gfukumot', 'hdebose', 'kebemis', None, 'apupillo', 'miramont', 'emeiner', 'campb122', 'wang2621', 'cpavlick', 'jokkema', 'zadeel', 'kdecocke', 'higgin24', 'hrowlan', 'hweldy', 'smit2256', 'kcrew08']"
23,260,33,73,31,"['damini.rane', 'saurabhpathare304', 'rushikool12', 'prasadtrimukhe', 'pallavidshinde82', 'shubhamraut', 'shreya9609', 'prathamesh24j', 'ashishghoderao', 'ronraviram789', 'akshaygodse13', 'rutvikstar', 'kunaldua99999', 'kavusatose123', 'mohitavhad1997', 'shirsekarakash', 'pratikpawar4996', 'dattaramkolekar', 'prasad.creativity123', 'k.vekhande69', 'divujagushte26', 'yashpimpale6', 'sarveshbhoer158', 'siddhantwarankar', 'prasad24shingade', 'megh19k', 'girish.gidaye', 'sgharat297', 'komalparab', 'revati.naik1501', 'bhamghodke7']",1,['mahajanyashashree19'],42,"['ranegirish24', 'tejaswini', 'tejas7', 'mestryumesh123', 'karishmahirve96', 'bodkesaurabh', 'rahul2011star', 'murkarnamita', 'gidayegirish', 'damle.rajas', 'shubhamrajpal038', 'manasitambat96', 'yash8976', 'siddhant319', 'patelriyalds', 'akshay1997bhagit', 'vinayak183', 'satsamjr', 'tejasawasarmol', 'plotankar96', 'mandar.261', 'bhairavi.chitalay', 'shubhamkamble9639', 'sandeep27996', 'aartibhalerao29', 'adityawasekar11', 'siddhantpawar993', 'vedankasalunke96', 'sawardekarsuyash97', 'rajatmohite48', None, 'jr.abishek00', 'kaminisuroshi26', 'priyankakudtarkar5', 'deshpande192', 'priyankachaurasia9167', 'priyankapal3011', 'suyogmankame93', 'narvekarsushant0', 'varadrajnanaware7', 'shubhangihnkre14', 'sonam.wairkar']",74,"['damini.rane', 'ranegirish24', 'tejas7', 'saurabhpathare304', 'rushikool12', 'prasadtrimukhe', 'mestryumesh123', 'murkarnamita', 'gidayegirish', 'shubhamrajpal038', 'shreya9609', 'manasitambat96', 'prathamesh24j', 'ashishghoderao', 'akshay1997bhagit', 'vinayak183', 'ronraviram789', 'satsamjr', 'rutvikstar', 'plotankar96', 'mandar.261', 'shirsekarakash', 'pratikpawar4996', 'yashpimpale6', 'sarveshbhoer158', 'siddhantwarankar', 'prasad24shingade', 'megh19k', 'jr.abishek00', 'girish.gidaye', 'kaminisuroshi26', 'deshpande192', 'komalparab', 'revati.naik1501', 'priyankapal3011', 'varadrajnanaware7', 'tejaswini', 'karishmahirve96', 'bodkesaurabh', 'pallavidshinde82', 'rahul2011star', 'shubhamraut', 'damle.rajas', 'yash8976', 'siddhant319', 'patelriyalds', 'akshaygodse13', 'tejasawasarmol', 'kunaldua99999', 'mohitavhad1997', 'kavusatose123', 'dattaramkolekar', 'prasad.creativity123', 'bhairavi.chitalay', 'k.vekhande69', 'divujagushte26', 'shubhamkamble9639', 'mahajanyashashree19', 'sandeep27996', 'aartibhalerao29', 'adityawasekar11', 'siddhantpawar993', 'vedankasalunke96', 'sawardekarsuyash97', 'rajatmohite48', None, 'priyankakudtarkar5', 'sgharat297', 'priyankachaurasia9167', 'narvekarsushant0', 'suyogmankame93', 'bhamghodke7', 'shubhangihnkre14', 'sonam.wairkar']"
23,55,33,65,30,"['damini.rane', 'saurabhpathare304', 'rushikool12', 'prasadtrimukhe', 'pallavidshinde82', 'shubhamraut', 'shreya9609', 'prathamesh24j', 'ashishghoderao', 'ronraviram789', 'akshaygodse13', 'rutvikstar', 'kunaldua99999', 'kavusatose123', 'mohitavhad1997', 'shirsekarakash', 'pratikpawar4996', 'dattaramkolekar', 'prasad.creativity123', 'k.vekhande69', 'divujagushte26', 'yashpimpale6', 'sarveshbhoer158', 'siddhantwarankar', 'prasad24shingade', 'megh19k', 'sgharat297', 'komalparab', 'revati.naik1501', 'bhamghodke7']",2,"['girish.gidaye', 'mahajanyashashree19']",35,"['ranegirish24', 'pranittambde', 'vrushalithakare82', 'dkgupata9768522176', 'swapnilbodekar', 'vishalyadav191096', 'payalbatwal', 'manasitambat96', 'divekarpragati7', 'vinayak183', 'harshadagaikwad145', 'satsamjr', 'priyaj1235', 'nikitarane245', 'nimishakurup857', 'aakshatahadambar31', 'harshvardhan.gupta0696', 'rohanskambles', 'kshete393', 'vaibhavsnangare', 'alyasingh51', 'virajgaikwad421', 'adityawasekar11', 'siddhantpawar993', 'vedankasalunke96', 'chaitaliswnt11', 'sayali_m9', 'apurvawaghmode14', None, 'digr1992', 'pankajpawar1515', 'dipsbhalekar', 'chinmaysj96', 'saailknarvekar', 'akshay1997bhagit']",67,"['damini.rane', 'ranegirish24', 'saurabhpathare304', 'vrushalithakare82', 'dkgupata9768522176', 'swapnilbodekar', 'rushikool12', 'prasadtrimukhe', 'vishalyadav191096', 'shreya9609', 'manasitambat96', 'prathamesh24j', 'ashishghoderao', 'vinayak183', 'ronraviram789', 'satsamjr', 'nikitarane245', 'rutvikstar', 'nimishakurup857', 'shirsekarakash', 'pratikpawar4996', 'aakshatahadambar31', 'yashpimpale6', 'virajgaikwad421', 'sarveshbhoer158', 'siddhantwarankar', 'prasad24shingade', 'chaitaliswnt11', 'sayali_m9', 'megh19k', 'pankajpawar1515', 'girish.gidaye', 'dipsbhalekar', 'chinmaysj96', 'komalparab', 'revati.naik1501', 'pranittambde', 'pallavidshinde82', 'payalbatwal', 'shubhamraut', 'divekarpragati7', 'harshadagaikwad145', 'akshaygodse13', 'priyaj1235', 'kunaldua99999', 'mohitavhad1997', 'kavusatose123', 'harshvardhan.gupta0696', 'dattaramkolekar', 'prasad.creativity123', 'rohanskambles', 'k.vekhande69', 'divujagushte26', 'kshete393', 'vaibhavsnangare', 'mahajanyashashree19', 'alyasingh51', 'adityawasekar11', 'siddhantpawar993', 'vedankasalunke96', 'apurvawaghmode14', None, 'digr1992', 'sgharat297', 'saailknarvekar', 'bhamghodke7', 'akshay1997bhagit']"
23,56,33,50,1,['mahajanyashashree19'],31,"['damini.rane', 'saurabhpathare304', 'rushikool12', 'prasadtrimukhe', 'pallavidshinde82', 'shubhamraut', 'shreya9609', 'prathamesh24j', 'ashishghoderao', 'ronraviram789', 'akshaygodse13', 'rutvikstar', 'kunaldua99999', 'kavusatose123', 'mohitavhad1997', 'shirsekarakash', 'pratikpawar4996', 'dattaramkolekar', 'prasad.creativity123', 'k.vekhande69', 'divujagushte26', 'yashpimpale6', 'sarveshbhoer158', 'siddhantwarankar', 'prasad24shingade', 'megh19k', 'girish.gidaye', 'sgharat297', 'komalparab', 'revati.naik1501', 'bhamghodke7']",49,"['priyankamali2510', 'prakshat095', 'tanmay9', 'milind123', 'gnthakore', 'raj.misal', 'sakshi.mandot', 'mugdhabhat1997', 'mkharkar', 'adnan.s', 'ssmande', 'samirbobade', 'krunal.kasar', 'yuvraj.t', 'shrey.joshi', 'gaurav.mishra', 'k.gauswami', 'uyewale', 'vishalnaik.0210', 'vaitysushant', 'diksharth', 'shreyas.v', 'dkbathe29', 'niranjanbhavsar2491996', 'pateltejash96', 'waynemdsouza', 'sahilboble25', 'mkhanvilkar', 'dghosalkar', 'suhayl4k', 'seemam', 'mayank.vp', 'pravingowda28', 'samuelalmeida17', 'mdeshmukh', 'nairabhi1571996', 'sayali_m9', None, 'pratik.gc', 'pjay10708', 'nirav.lm', 'vaishak', 'nivedita', 'aadi1212', 'bharatesh.a', 'naina', 'anil8796069443', 'zil.c', 'yadavsandeep793']",81,"['damini.rane', 'priyankamali2510', 'saurabhpathare304', 'tanmay9', 'raj.misal', 'rushikool12', 'sakshi.mandot', 'adnan.s', 'prasadtrimukhe', 'shreya9609', 'yuvraj.t', 'prathamesh24j', 'ashishghoderao', 'gaurav.mishra', 'k.gauswami', 'uyewale', 'ronraviram789', 'diksharth', 'shreyas.v', 'rutvikstar', 'shirsekarakash', 'pratikpawar4996', 'niranjanbhavsar2491996', 'waynemdsouza', 'sahilboble25', 'yashpimpale6', 'suhayl4k', 'seemam', 'sarveshbhoer158', 'samuelalmeida17', 'siddhantwarankar', 'prasad24shingade', 'sayali_m9', 'megh19k', 'pratik.gc', 'vaishak', 'nivedita', 'girish.gidaye', 'komalparab', 'naina', 'anil8796069443', 'revati.naik1501', 'zil.c', 'yadavsandeep793', 'prakshat095', 'milind123', 'gnthakore', 'mkharkar', 'mugdhabhat1997', 'pallavidshinde82', 'ssmande', 'shubhamraut', 'samirbobade', 'krunal.kasar', 'shrey.joshi', 'vishalnaik.0210', 'akshaygodse13', 'vaitysushant', 'kunaldua99999', 'mohitavhad1997', 'kavusatose123', 'dkbathe29', 'pateltejash96', 'dattaramkolekar', 'prasad.creativity123', 'mkhanvilkar', 'dghosalkar', 'k.vekhande69', 'divujagushte26', 'mahajanyashashree19', 'mayank.vp', 'pravingowda28', 'mdeshmukh', 'nairabhi1571996', None, 'pjay10708', 'nirav.lm', 'sgharat297', 'aadi1212', 'bharatesh.a', 'bhamghodke7']"
23,261,33,7,4,"['damini.rane', 'bhamghodke7', 'megh19k', 'shubhamraut']",28,"['saurabhpathare304', 'rushikool12', 'prasadtrimukhe', 'pallavidshinde82', 'shreya9609', 'prathamesh24j', 'ashishghoderao', 'ronraviram789', 'akshaygodse13', 'rutvikstar', 'kunaldua99999', 'mohitavhad1997', 'kavusatose123', 'shirsekarakash', 'pratikpawar4996', 'dattaramkolekar', 'prasad.creativity123', 'k.vekhande69', 'divujagushte26', 'yashpimpale6', 'mahajanyashashree19', 'sarveshbhoer158', 'siddhantwarankar', 'prasad24shingade', 'girish.gidaye', 'sgharat297', 'komalparab', 'revati.naik1501']",3,"['shubhamkamble9639', 'bodkesaurabh', None]",35,"['damini.rane', 'saurabhpathare304', 'rushikool12', 'prasadtrimukhe', 'bodkesaurabh', 'pallavidshinde82', 'shubhamraut', 'shreya9609', 'prathamesh24j', 'ashishghoderao', 'ronraviram789', 'akshaygodse13', 'rutvikstar', 'kunaldua99999', 'mohitavhad1997', 'kavusatose123', 'shirsekarakash', 'pratikpawar4996', 'dattaramkolekar', 'prasad.creativity123', 'k.vekhande69', 'divujagushte26', 'shubhamkamble9639', 'yashpimpale6', 'mahajanyashashree19', 'sarveshbhoer158', 'siddhantwarankar', 'prasad24shingade', None, 'megh19k', 'girish.gidaye', 'sgharat297', 'komalparab', 'revati.naik1501', 'bhamghodke7']"
24,85,32,19,18,"['anzalnahamrah', 'hemindesai91', 'tandra23', 'madangopalg', 'mounika', 'aparnasajeev', 'keerthi.miyu', 'jaykg37', 'r.jayakumar2017', 'aleena123', 'shriswaroop', 'sarmistha.brh', 'andrewsnano', 'akbarssz11', 'astjraj', 'chandana403ndl', 'jayadevkotipalli413', 'pradeep17mnt0013']",13,"['prinky.1234', 'resalat_f', 'pmiguel1994', 'pankajmech093', 'haidermoter2018', 'ahmed424800', 'makars.siskins', 'mszazynski', 'sanjuiitd', 'marius.buerkle', 'michelledsouza09', 'esathiyacnr', 'rohit.sharma2017']",1,[None],32,"['tandra23', 'madangopalg', 'ahmed424800', 'keerthi.miyu', 'sanjuiitd', 'michelledsouza09', 'jayadevkotipalli413', 'prinky.1234', 'esathiyacnr', 'makars.siskins', 'jaykg37', 'shriswaroop', 'mszazynski', 'resalat_f', 'pradeep17mnt0013', 'pmiguel1994', 'mounika', 'marius.buerkle', 'astjraj', None, 'anzalnahamrah', 'pankajmech093', 'haidermoter2018', 'aparnasajeev', 'r.jayakumar2017', 'aleena123', 'rohit.sharma2017', 'sarmistha.brh', 'andrewsnano', 'akbarssz11', 'chandana403ndl', 'hemindesai91']"
24,84,32,17,16,"['prinky.1234', 'esathiyacnr', 'anzalnahamrah', 'hemindesai91', 'pankajmech093', 'aparnasajeev', 'keerthi.miyu', 'r.jayakumar2017', 'aleena123', 'rohit.sharma2017', 'sarmistha.brh', 'michelledsouza09', 'akbarssz11', 'chandana403ndl', 'jayadevkotipalli413', 'pradeep17mnt0013']",15,"['pmiguel1994', 'tandra23', 'haidermoter2018', 'madangopalg', 'makars.siskins', 'ahmed424800', 'mounika', 'jaykg37', 'shriswaroop', 'sanjuiitd', 'mszazynski', 'resalat_f', 'marius.buerkle', 'andrewsnano', 'astjraj']",1,[None],32,"['tandra23', 'madangopalg', 'ahmed424800', 'keerthi.miyu', 'sanjuiitd', 'michelledsouza09', 'jayadevkotipalli413', 'prinky.1234', 'esathiyacnr', 'makars.siskins', 'jaykg37', 'shriswaroop', 'mszazynski', 'resalat_f', 'pradeep17mnt0013', 'pmiguel1994', 'mounika', 'marius.buerkle', 'astjraj', None, 'anzalnahamrah', 'pankajmech093', 'haidermoter2018', 'aparnasajeev', 'r.jayakumar2017', 'aleena123', 'rohit.sharma2017', 'sarmistha.brh', 'andrewsnano', 'akbarssz11', 'chandana403ndl', 'hemindesai91']"
24,82,32,7,1,['pmiguel1994'],30,"['tandra23', 'akbarssz11', 'madangopalg', 'ahmed424800', 'keerthi.miyu', 'sanjuiitd', 'michelledsouza09', 'jayadevkotipalli413', 'prinky.1234', 'makars.siskins', 'jaykg37', 'shriswaroop', 'mszazynski', 'resalat_f', 'pradeep17mnt0013', 'mounika', 'marius.buerkle', 'astjraj', 'anzalnahamrah', 'pankajmech093', 'haidermoter2018', 'aparnasajeev', 'r.jayakumar2017', 'aleena123', 'rohit.sharma2017', 'sarmistha.brh', 'andrewsnano', 'esathiyacnr', 'chandana403ndl', 'hemindesai91']",6,"['niaznasir18', 'timothy.wong.12', 'wtdlin', 'dbekah22', None, 'saleh.uw']",37,"['tandra23', 'madangopalg', 'ahmed424800', 'keerthi.miyu', 'sanjuiitd', 'michelledsouza09', 'jayadevkotipalli413', 'prinky.1234', 'esathiyacnr', 'makars.siskins', 'jaykg37', 'shriswaroop', 'mszazynski', 'resalat_f', 'pradeep17mnt0013', 'pmiguel1994', 'mounika', 'timothy.wong.12', 'marius.buerkle', 'astjraj', None, 'saleh.uw', 'anzalnahamrah', 'pankajmech093', 'haidermoter2018', 'niaznasir18', 'aparnasajeev', 'r.jayakumar2017', 'aleena123', 'rohit.sharma2017', 'sarmistha.brh', 'andrewsnano', 'wtdlin', 'akbarssz11', 'dbekah22', 'chandana403ndl', 'hemindesai91']"
25,116,30,54,1,['mneuendo'],28,"['jufepas98', 'jenipinzon.ml', 'jesusvillamizar', 'erikananiela', 'yeju16', 'we.simancas10', 'jairovlacha', 'jdmedinatobon', 'dadelapa321', 'af.vera10', 'j.wilckenlecompte', 'fabser7', 'rf.ruiz10', 'andres9802', 'andrestrujillo098', 'juandavid97', 'lf.correa10', 'hectordavidpulido', 'jupalinar17', 'vserrano081821', 'te.vence10', 'isabella', 'jfgf11', 'diegobb', 'carlosdoblev', 'vanessamovilla', 'juan_camilo', 'eduardmolano']",53,"['jhavey', 'waldropj', 'adhikarp', 'glabianc', 'zhan1263', 'gross53', 'graves34', 'alvare48', 'nckloff', 'mmanago', 'rmcandr', 'nloffred', 'nicktucker', 'aberding', 'rbajaria', 'behnkea', 'pan118', 'grewe', 'chan161', 'jgradows', 'madman5000', 'khan117', 'aronsonj', 'vtirukon9', 'aemerson', 'white378', 'jeveridg', 'asoordel', 'osborn33', 'yao127', 'neitsert', 'magi2elias', 'hyeon7300', 'fang137', 'wang3617', 'kapur2', None, 'ece202', 'he300', 'leonar30', 'joderkir', 'msadi', 'piersonb', 'cstalcupxixi', 'ahornin', 'le67', 'lixu315612126', 'smit2538', 'pennk', 'wang2506', 'shah213', 'sawyer_sup', 'li1882']",82,"['jhavey', 'jufepas98', 'waldropj', 'jenipinzon.ml', 'erikananiela', 'zhan1263', 'yeju16', 'gross53', 'alvare48', 'nckloff', 'nloffred', 'nicktucker', 'jairovlacha', 'rbajaria', 'behnkea', 'grewe', 'chan161', 'madman5000', 'vtirukon9', 'fabser7', 'white378', 'rf.ruiz10', 'asoordel', 'andres9802', 'andrestrujillo098', 'juandavid97', 'lf.correa10', 'yao127', 'magi2elias', 'fang137', 'kapur2', 'he300', 'joderkir', 'msadi', 'mneuendo', 'isabella', 'piersonb', 'jfgf11', 'ahornin', 'diegobb', 'le67', 'lixu315612126', 'carlosdoblev', 'vanessamovilla', 'eduardmolano', 'wang2506', 'shah213', 'sawyer_sup', 'li1882', 'ece202', 'adhikarp', 'glabianc', 'jesusvillamizar', 'graves34', 'we.simancas10', 'mmanago', 'rmcandr', 'aberding', 'pan118', 'jdmedinatobon', 'dadelapa321', 'jgradows', 'af.vera10', 'khan117', 'j.wilckenlecompte', 'aronsonj', 'aemerson', 'jeveridg', 'osborn33', 'hectordavidpulido', 'neitsert', 'jupalinar17', 'hyeon7300', 'wang3617', None, 'vserrano081821', 'leonar30', 'te.vence10', 'cstalcupxixi', 'smit2538', 'pennk', 'juan_camilo']"
25,300,30,48,28,"['jufepas98', 'jenipinzon.ml', 'jesusvillamizar', 'erikananiela', 'yeju16', 'we.simancas10', 'jairovlacha', 'jdmedinatobon', 'dadelapa321', 'af.vera10', 'j.wilckenlecompte', 'fabser7', 'rf.ruiz10', 'andres9802', 'andrestrujillo098', 'juandavid97', 'lf.correa10', 'hectordavidpulido', 'jupalinar17', 'vserrano081821', 'te.vence10', 'isabella', 'jfgf11', 'diegobb', 'carlosdoblev', 'vanessamovilla', 'juan_camilo', 'eduardmolano']",1,['mneuendo'],20,"['cdaniel089', 'rdcajr', 'raquelalejandra', 'sa.sanchez', 'a.mesias10', 'andresfdt.2k8', 'brayant', 'salazarnelson', 'jonathanpinzon05', 'ja.jimenez317', 'alejandro2655', 'sd.diaz', 'ogabriel.cv99', None, 'labiele2206', 'alejandract', 'jframos', 'aruiz6a', 'valentina.reyesmar4', 'mariaalejandraep']",49,"['cdaniel089', 'jufepas98', 'jenipinzon.ml', 'raquelalejandra', 'erikananiela', 'yeju16', 'sa.sanchez', 'jairovlacha', 'fabser7', 'rf.ruiz10', 'andres9802', 'andrestrujillo098', 'juandavid97', 'lf.correa10', 'labiele2206', 'mneuendo', 'isabella', 'jfgf11', 'diegobb', 'carlosdoblev', 'aruiz6a', 'vanessamovilla', 'eduardmolano', 'mariaalejandraep', 'rdcajr', 'jesusvillamizar', 'we.simancas10', 'a.mesias10', 'andresfdt.2k8', 'brayant', 'jdmedinatobon', 'salazarnelson', 'jonathanpinzon05', 'ja.jimenez317', 'dadelapa321', 'alejandro2655', 'sd.diaz', 'af.vera10', 'j.wilckenlecompte', 'ogabriel.cv99', 'hectordavidpulido', 'jupalinar17', None, 'vserrano081821', 'alejandract', 'te.vence10', 'jframos', 'juan_camilo', 'valentina.reyesmar4']"
25,123,30,39,27,"['jufepas98', 'jenipinzon.ml', 'jesusvillamizar', 'erikananiela', 'we.simancas10', 'jairovlacha', 'jdmedinatobon', 'dadelapa321', 'af.vera10', 'j.wilckenlecompte', 'fabser7', 'rf.ruiz10', 'andres9802', 'andrestrujillo098', 'juandavid97', 'lf.correa10', 'hectordavidpulido', 'jupalinar17', 'vserrano081821', 'te.vence10', 'isabella', 'jfgf11', 'diegobb', 'carlosdoblev', 'vanessamovilla', 'juan_camilo', 'eduardmolano']",2,"['yeju16', 'mneuendo']",12,"['andresfdt.2k8', 'sd.diaz', None, 'rdcajr', 'sarabeja98', 'raquelalejandra', 'jframos', 'brayant', 'sa.sanchez', 'escalantemariaalejandra', 'labiele2206', 'ja.jimenez317']",41,"['jufepas98', 'jenipinzon.ml', 'raquelalejandra', 'erikananiela', 'yeju16', 'sa.sanchez', 'jairovlacha', 'fabser7', 'sarabeja98', 'rf.ruiz10', 'andres9802', 'andrestrujillo098', 'juandavid97', 'lf.correa10', 'labiele2206', 'mneuendo', 'isabella', 'jfgf11', 'diegobb', 'carlosdoblev', 'vanessamovilla', 'eduardmolano', 'rdcajr', 'jesusvillamizar', 'we.simancas10', 'andresfdt.2k8', 'brayant', 'jdmedinatobon', 'ja.jimenez317', 'dadelapa321', 'sd.diaz', 'af.vera10', 'j.wilckenlecompte', 'hectordavidpulido', 'jupalinar17', None, 'vserrano081821', 'te.vence10', 'jframos', 'juan_camilo', 'escalantemariaalejandra']"
25,369,30,32,1,['eduardmolano'],28,"['jufepas98', 'jenipinzon.ml', 'jesusvillamizar', 'erikananiela', 'yeju16', 'we.simancas10', 'jairovlacha', 'jdmedinatobon', 'dadelapa321', 'af.vera10', 'j.wilckenlecompte', 'fabser7', 'rf.ruiz10', 'andres9802', 'andrestrujillo098', 'juandavid97', 'lf.correa10', 'hectordavidpulido', 'jupalinar17', 'vserrano081821', 'te.vence10', 'mneuendo', 'isabella', 'jfgf11', 'diegobb', 'carlosdoblev', 'vanessamovilla', 'juan_camilo']",31,"['juliantecnologic', 'na.diaz', 'rdcajr', 'cy.andrade', 'dssv99', 'raquelalejandra', 'ja.forero15', 'sa.sanchez', 'numumero', 'andresfdt.2k8', 'josedanielmecon', 'nata.quintero3098', 'anamis_forero', 'brayant', 'fd.nino10', 'sd.diaz', 'velajua', 'pabloccr', 'miguel1003', 'danielcusva', 'miguell98md', 'bryanc121297', 'ivanrulik', 'a.ricci10', 'labiele2206', None, 'carlos2992', 'crisdavbed08', 'ksgutierrez', 'electroniccasalins96', 'camilom']",60,"['juliantecnologic', 'na.diaz', 'jufepas98', 'rdcajr', 'jenipinzon.ml', 'jesusvillamizar', 'cy.andrade', 'erikananiela', 'dssv99', 'yeju16', 'raquelalejandra', 'ja.forero15', 'sa.sanchez', 'numumero', 'we.simancas10', 'andresfdt.2k8', 'josedanielmecon', 'jairovlacha', 'nata.quintero3098', 'anamis_forero', 'jdmedinatobon', 'brayant', 'fd.nino10', 'dadelapa321', 'sd.diaz', 'af.vera10', 'j.wilckenlecompte', 'velajua', 'fabser7', 'pabloccr', 'miguel1003', 'danielcusva', 'rf.ruiz10', 'miguell98md', 'andres9802', 'andrestrujillo098', 'bryanc121297', 'ivanrulik', 'juandavid97', 'lf.correa10', 'hectordavidpulido', 'a.ricci10', 'jupalinar17', 'labiele2206', None, 'vserrano081821', 'carlos2992', 'te.vence10', 'crisdavbed08', 'mneuendo', 'isabella', 'ksgutierrez', 'jfgf11', 'diegobb', 'carlosdoblev', 'vanessamovilla', 'juan_camilo', 'eduardmolano', 'electroniccasalins96', 'camilom']"
25,118,30,31,24,"['jufepas98', 'jesusvillamizar', 'erikananiela', 'yeju16', 'we.simancas10', 'jdmedinatobon', 'dadelapa321', 'af.vera10', 'j.wilckenlecompte', 'fabser7', 'rf.ruiz10', 'andres9802', 'andrestrujillo098', 'juandavid97', 'lf.correa10', 'hectordavidpulido', 'jupalinar17', 'te.vence10', 'isabella', 'jfgf11', 'diegobb', 'vanessamovilla', 'juan_camilo', 'eduardmolano']",5,"['mneuendo', 'jenipinzon.ml', 'jairovlacha', 'carlosdoblev', 'vserrano081821']",7,"['andresfdt.2k8', 'lauradnc15', 'rdcajr', 'f.escallonp', 'duodinamico', 'raquelalejandra', None]",36,"['jufepas98', 'rdcajr', 'jenipinzon.ml', 'jesusvillamizar', 'raquelalejandra', 'erikananiela', 'yeju16', 'we.simancas10', 'andresfdt.2k8', 'jairovlacha', 'duodinamico', 'jdmedinatobon', 'dadelapa321', 'af.vera10', 'lauradnc15', 'j.wilckenlecompte', 'fabser7', 'rf.ruiz10', 'andres9802', 'andrestrujillo098', 'juandavid97', 'lf.correa10', 'hectordavidpulido', 'jupalinar17', None, 'vserrano081821', 'te.vence10', 'mneuendo', 'isabella', 'jfgf11', 'diegobb', 'f.escallonp', 'carlosdoblev', 'vanessamovilla', 'juan_camilo', 'eduardmolano']"
26,69,29,44,3,"['adityaprakash41', 'k25', 'techn720ab']",25,"['sujaydandekar', 'ankit2896', 'wadekar.teja1995', 'lbpatil9', 'girishgholap', 'snehap2013', 'pinky1234', 'akashk07', 'lekhashewale92', 'pranjalipatil2896', 'akshaymeshram4', 'roshanmore0903', 'harshali263', 'kritureb1', 'sarveshgupta333', 'prashannt123', 'sumeet97', 'aishwaryanair29', 'mohakbheda1', 'priyamahajan', 'omkarpt1996', 'ajaykarande96', 'sonaliphadale94', 'saurabh123', 'kushaal']",41,"['surbhib2897', 'rohitwaghmare1997', 'keshvis26', 'pinakin', 'rajeshreesawale', 'shrinishdonde', 'mananmehta95', 'neha0206', 'yashjivrajani7799', 'kumarkhandagle33', 'aagamshah999999999', 'sahil.sawant031996', 'vora.jai1', 'shreyasshah14', 'sheetalchaudhari2210', 'divyavkhandkar.me', 'tripathishivam342', 'pallavi.valunj', 'tanvishah2410', 'pooja9702.pm', 'tanvinj1', 'prerana', 'aditik2107', 'alwin1996', 'vidur888', 'mehulkharvi7', 'chaitalivartak07', 'raj.vadariya', 'manassardar4444122', 'vandortshakti', None, 'ketan.db', 'rohitw0606', 'rubina15', 'panchalparth417', 'aniruddhaparte3', 'niveshvaze', 'boy_with_nikon', 'ankitpandey1296', 'devashishmore478', 'meghana.loke02']",69,"['techn720ab', 'wadekar.teja1995', 'rohitwaghmare1997', 'keshvis26', 'pinakin', 'shrinishdonde', 'mananmehta95', 'yashjivrajani7799', 'girishgholap', 'vora.jai1', 'shreyasshah14', 'akashk07', 'lekhashewale92', 'pranjalipatil2896', 'sheetalchaudhari2210', 'tripathishivam342', 'akshaymeshram4', 'tanvishah2410', 'pooja9702.pm', 'tanvinj1', 'prerana', 'aditik2107', 'harshali263', 'alwin1996', 'vidur888', 'chaitalivartak07', 'manassardar4444122', 'aishwaryanair29', 'sumeet97', 'ketan.db', 'panchalparth417', 'ankitpandey1296', 'niveshvaze', 'sonaliphadale94', 'surbhib2897', 'sujaydandekar', 'ankit2896', 'lbpatil9', 'rajeshreesawale', 'neha0206', 'snehap2013', 'kumarkhandagle33', 'aagamshah999999999', 'sahil.sawant031996', 'pinky1234', 'divyavkhandkar.me', 'pallavi.valunj', 'roshanmore0903', 'adityaprakash41', 'kritureb1', 'mehulkharvi7', 'sarveshgupta333', 'raj.vadariya', 'vandortshakti', 'prashannt123', None, 'mohakbheda1', 'k25', 'priyamahajan', 'rohitw0606', 'omkarpt1996', 'rubina15', 'ajaykarande96', 'aniruddhaparte3', 'boy_with_nikon', 'devashishmore478', 'meghana.loke02', 'saurabh123', 'kushaal']"
26,70,29,38,24,"['sujaydandekar', 'ankit2896', 'wadekar.teja1995', 'lbpatil9', 'girishgholap', 'snehap2013', 'pinky1234', 'akashk07', 'lekhashewale92', 'pranjalipatil2896', 'akshaymeshram4', 'roshanmore0903', 'harshali263', 'sarveshgupta333', 'prashannt123', 'sumeet97', 'aishwaryanair29', 'mohakbheda1', 'priyamahajan', 'omkarpt1996', 'ajaykarande96', 'sonaliphadale94', 'saurabh123', 'kushaal']",4,"['adityaprakash41', 'k25', 'kritureb1', 'techn720ab']",14,"['nikhilmore', 'laukiktikam333', 'hastimalpaliwal', 'akashnemade16', 'shraddha0306', 'siddharthnair', 'nisha08', 'pai.nivalkar', 'prasad622444', 'tusharshetty421', 'surajmahendrarai', 'nikhil421301', None, 'siddhivadhwana22']",42,"['techn720ab', 'wadekar.teja1995', 'pai.nivalkar', 'tusharshetty421', 'girishgholap', 'siddhivadhwana22', 'akashk07', 'lekhashewale92', 'pranjalipatil2896', 'akshaymeshram4', 'nikhil421301', 'nikhilmore', 'laukiktikam333', 'nisha08', 'harshali263', 'aishwaryanair29', 'sumeet97', 'hastimalpaliwal', 'sonaliphadale94', 'sujaydandekar', 'ankit2896', 'lbpatil9', 'prasad622444', 'snehap2013', 'pinky1234', 'roshanmore0903', 'adityaprakash41', 'kritureb1', 'sarveshgupta333', 'surajmahendrarai', 'prashannt123', None, 'mohakbheda1', 'k25', 'priyamahajan', 'akashnemade16', 'shraddha0306', 'siddharthnair', 'omkarpt1996', 'ajaykarande96', 'saurabh123', 'kushaal']"
27,349,27,28,23,"['aim_wb', 'gegiesilverlocket', 'kewalingale22', 'pattarawit_dukdik', 'stamper9987', 'pui_yaak1996', 'jirawat0441', 'pwangse', 'abinbueng', 'team5024', 'tewan', 'aschara_aum', 'nerysinnery', 'chanagantanakulrungsarit', 'panpilin443651', 'nurapa', 'fofai_41', 'surampha.s', 'khomphet66', 'paritmrj', 'cream160341', 'peeranut', 'jintanaree']",3,"['wsasima', 'saud', 'mimijsr09']",5,"['artsuradet17', 'saruto', 'tpuangmali', None, 'prang3_']",31,"['aim_wb', 'wsasima', 'gegiesilverlocket', 'kewalingale22', 'pattarawit_dukdik', 'stamper9987', 'pui_yaak1996', 'jirawat0441', 'pwangse', 'abinbueng', 'saud', 'team5024', 'tpuangmali', 'tewan', 'aschara_aum', 'nerysinnery', 'artsuradet17', 'saruto', 'mimijsr09', 'chanagantanakulrungsarit', 'panpilin443651', 'nurapa', 'fofai_41', 'surampha.s', 'khomphet66', 'paritmrj', None, 'cream160341', 'peeranut', 'jintanaree', 'prang3_']"
27,352,27,20,13,"['aim_wb', 'wsasima', 'tewan', 'aschara_aum', 'cream160341', 'pui_yaak1996', 'panpilin443651', 'jirawat0441', 'jintanaree', 'khomphet66', 'paritmrj', 'pwangse', 'team5024']",13,"['gegiesilverlocket', 'kewalingale22', 'pattarawit_dukdik', 'chanagantanakulrungsarit', 'nerysinnery', 'stamper9987', 'nurapa', 'fofai_41', 'peeranut', 'surampha.s', 'abinbueng', 'saud', 'mimijsr09']",7,"['navat1210', 'fuangsuda199817', 'yeennao2011', 'khomsak', 'me4335713', 'patcharapruek', None]",33,"['aim_wb', 'wsasima', 'gegiesilverlocket', 'kewalingale22', 'pattarawit_dukdik', 'stamper9987', 'pui_yaak1996', 'jirawat0441', 'pwangse', 'abinbueng', 'saud', 'team5024', 'tewan', 'aschara_aum', 'nerysinnery', 'yeennao2011', 'me4335713', 'patcharapruek', 'mimijsr09', 'navat1210', 'chanagantanakulrungsarit', 'panpilin443651', 'nurapa', 'fofai_41', 'surampha.s', 'khomphet66', 'paritmrj', None, 'fuangsuda199817', 'cream160341', 'peeranut', 'khomsak', 'jintanaree']"
27,354,27,10,9,"['gegiesilverlocket', 'pattarawit_dukdik', 'cream160341', 'peeranut', 'stamper9987', 'fofai_41', 'nurapa', 'khomphet66', 'pwangse']",17,"['aim_wb', 'wsasima', 'kewalingale22', 'team5024', 'tewan', 'aschara_aum', 'pui_yaak1996', 'nerysinnery', 'jirawat0441', 'chanagantanakulrungsarit', 'panpilin443651', 'jintanaree', 'surampha.s', 'paritmrj', 'abinbueng', 'saud', 'mimijsr09']",1,[None],27,"['aim_wb', 'wsasima', 'gegiesilverlocket', 'kewalingale22', 'pattarawit_dukdik', 'chanagantanakulrungsarit', 'stamper9987', 'pui_yaak1996', 'jirawat0441', 'panpilin443651', 'nurapa', 'fofai_41', 'surampha.s', 'khomphet66', 'paritmrj', 'pwangse', None, 'abinbueng', 'saud', 'team5024', 'tewan', 'aschara_aum', 'nerysinnery', 'cream160341', 'peeranut', 'jintanaree', 'mimijsr09']"
27,351,27,9,1,['saud'],25,"['aim_wb', 'wsasima', 'gegiesilverlocket', 'kewalingale22', 'pattarawit_dukdik', 'stamper9987', 'pui_yaak1996', 'jirawat0441', 'pwangse', 'abinbueng', 'team5024', 'tewan', 'aschara_aum', 'nerysinnery', 'mimijsr09', 'chanagantanakulrungsarit', 'panpilin443651', 'nurapa', 'fofai_41', 'surampha.s', 'khomphet66', 'paritmrj', 'cream160341', 'peeranut', 'jintanaree']",8,"['michalkononenko', 'rkilani', 'shaivibhatt', 'sidthk708', 'harsimrankaur13', 'hargasinski', 'bboy122', None]",34,"['aim_wb', 'wsasima', 'gegiesilverlocket', 'kewalingale22', 'pattarawit_dukdik', 'chanagantanakulrungsarit', 'michalkononenko', 'stamper9987', 'pui_yaak1996', 'jirawat0441', 'panpilin443651', 'nurapa', 'fofai_41', 'harsimrankaur13', 'shaivibhatt', 'hargasinski', 'surampha.s', 'khomphet66', 'paritmrj', 'pwangse', None, 'abinbueng', 'saud', 'team5024', 'rkilani', 'tewan', 'aschara_aum', 'nerysinnery', 'cream160341', 'peeranut', 'sidthk708', 'jintanaree', 'bboy122', 'mimijsr09']"
27,355,27,7,3,"['wsasima', 'kewalingale22', 'surampha.s']",23,"['aim_wb', 'gegiesilverlocket', 'pattarawit_dukdik', 'pui_yaak1996', 'stamper9987', 'jirawat0441', 'pwangse', 'team5024', 'abinbueng', 'saud', 'tewan', 'aschara_aum', 'nerysinnery', 'mimijsr09', 'chanagantanakulrungsarit', 'panpilin443651', 'nurapa', 'fofai_41', 'khomphet66', 'paritmrj', 'cream160341', 'peeranut', 'jintanaree']",4,"['fuangsuda199817', None, 'lpk29402', 'chaiyakrit']",30,"['aim_wb', 'wsasima', 'gegiesilverlocket', 'kewalingale22', 'pattarawit_dukdik', 'chanagantanakulrungsarit', 'stamper9987', 'pui_yaak1996', 'jirawat0441', 'panpilin443651', 'nurapa', 'fofai_41', 'surampha.s', 'khomphet66', 'paritmrj', 'pwangse', None, 'abinbueng', 'saud', 'team5024', 'fuangsuda199817', 'chaiyakrit', 'tewan', 'aschara_aum', 'nerysinnery', 'cream160341', 'peeranut', 'lpk29402', 'jintanaree', 'mimijsr09']"
27,350,27,6,1,['saud'],25,"['aim_wb', 'wsasima', 'gegiesilverlocket', 'kewalingale22', 'pattarawit_dukdik', 'stamper9987', 'pui_yaak1996', 'jirawat0441', 'pwangse', 'abinbueng', 'team5024', 'tewan', 'aschara_aum', 'nerysinnery', 'mimijsr09', 'chanagantanakulrungsarit', 'panpilin443651', 'nurapa', 'fofai_41', 'surampha.s', 'khomphet66', 'paritmrj', 'cream160341', 'peeranut', 'jintanaree']",5,"['shaivibhatt', 'dracoyunho', 'sidthk708', 'aalquras', None]",31,"['aim_wb', 'wsasima', 'gegiesilverlocket', 'kewalingale22', 'pattarawit_dukdik', 'chanagantanakulrungsarit', 'shaivibhatt', 'stamper9987', 'pui_yaak1996', 'jirawat0441', 'panpilin443651', 'nurapa', 'fofai_41', 'dracoyunho', 'surampha.s', 'khomphet66', 'paritmrj', 'pwangse', None, 'abinbueng', 'saud', 'team5024', 'tewan', 'aschara_aum', 'nerysinnery', 'cream160341', 'peeranut', 'sidthk708', 'jintanaree', 'aalquras', 'mimijsr09']"
28,19,26,18,12,"['gkatiyar', 'ujashshah2006', 'sandalib', 'guanzeyi', 'jausnance', 'atinkrish95', 'cmouzaoui', 'saravc', 'yunbo0527', 'abolfazlsadeghpour', 'luckypsh', 'addashti']",13,"['kopanog', 'ulaankhuu95', 'zezhizeng', 'geonelr', 'slize9995', 'leouniud', 'arnikam02', 'tajugole', 'denisbrandalise', 'soheilinho', 'm.techetrx', 'chetanthaware123', 'frar93']",6,"['jreed473', 'aalshehri', 'tsfisher', 'jinzhao.hu', 'mf071940', None]",31,"['kopanog', 'zezhizeng', 'arnikam02', 'jausnance', 'aalshehri', 'tsfisher', 'cmouzaoui', 'saravc', 'yunbo0527', 'luckypsh', 'ulaankhuu95', 'gkatiyar', 'sandalib', 'guanzeyi', 'atinkrish95', 'denisbrandalise', 'm.techetrx', 'abolfazlsadeghpour', 'geonelr', 'slize9995', 'jreed473', 'ujashshah2006', 'tajugole', 'soheilinho', 'jinzhao.hu', 'mf071940', 'chetanthaware123', None, 'addashti', 'leouniud', 'frar93']"
28,20,26,15,2,"['ulaankhuu95', 'slize9995']",23,"['kopanog', 'zezhizeng', 'arnikam02', 'jausnance', 'cmouzaoui', 'saravc', 'yunbo0527', 'luckypsh', 'gkatiyar', 'sandalib', 'guanzeyi', 'atinkrish95', 'denisbrandalise', 'm.techetrx', 'abolfazlsadeghpour', 'geonelr', 'ujashshah2006', 'tajugole', 'soheilinho', 'chetanthaware123', 'addashti', 'leouniud', 'frar93']",13,"['x.ganerdene', None, 'banzragch', 'seiko_anarjin', 'baagii_homie', 'djtumenjargal', 'anudari', 'ganzo_0306', 'ulaankhuu72', 'bil_marbel', 'luvsantseren_0329', 'choijamts.choijoo', 'gunsnroses.0219']",38,"['kopanog', 'zezhizeng', 'arnikam02', 'jausnance', 'djtumenjargal', 'cmouzaoui', 'saravc', 'yunbo0527', 'luckypsh', 'ulaankhuu95', 'gkatiyar', 'banzragch', 'seiko_anarjin', 'baagii_homie', 'sandalib', 'guanzeyi', 'atinkrish95', 'denisbrandalise', 'luvsantseren_0329', 'bil_marbel', 'm.techetrx', 'abolfazlsadeghpour', 'gunsnroses.0219', 'geonelr', 'slize9995', 'ujashshah2006', 'anudari', 'tajugole', 'soheilinho', 'ulaankhuu72', 'choijamts.choijoo', 'chetanthaware123', None, 'addashti', 'x.ganerdene', 'leouniud', 'ganzo_0306', 'frar93']"
28,22,26,9,4,"['m.techetrx', 'chetanthaware123', 'arnikam02', 'tajugole']",21,"['kopanog', 'zezhizeng', 'jausnance', 'saravc', 'cmouzaoui', 'yunbo0527', 'luckypsh', 'ulaankhuu95', 'gkatiyar', 'sandalib', 'guanzeyi', 'atinkrish95', 'denisbrandalise', 'abolfazlsadeghpour', 'geonelr', 'slize9995', 'ujashshah2006', 'soheilinho', 'addashti', 'leouniud', 'frar93']",5,"['shrikant4dulewad', 'praveshkup', 'sahil.sonar24', 'poojabatawale96', None]",30,"['kopanog', 'zezhizeng', 'geonelr', 'slize9995', 'shrikant4dulewad', 'ujashshah2006', 'sahil.sonar24', 'arnikam02', 'jausnance', 'poojabatawale96', 'tajugole', 'soheilinho', 'cmouzaoui', 'saravc', 'yunbo0527', 'luckypsh', 'chetanthaware123', None, 'addashti', 'ulaankhuu95', 'gkatiyar', 'praveshkup', 'sandalib', 'leouniud', 'guanzeyi', 'atinkrish95', 'denisbrandalise', 'm.techetrx', 'abolfazlsadeghpour', 'frar93']"
29,104,26,41,24,"['desaidhanashri32', 'cpatil7896', 'nandrerutuja', 'vivekpatil1964', 'abhijeetbiradar097', 'madhura7deshpande', 'amu72', 'magdumpriya18', 'shalmalirburse29', 'pranotikumbhar1411', 'shubhammagdum6002', 'somnath1995', 'pranavj1996', 'gajananpatil2513', 'gayatrimore2697', 'siddheshwagh007', 'swapnilpatil8072', 'vishalv8082', 'vvpowar1996', 'amarjakatware96', 'komalpatil1323', 'rutujabhiungade177', 'shraddhabodakepatil', 'dvd123jnv']",1,['anghakamble247'],17,"['pratikshachandane17197', 'akashvadrale', 'disha7', 'vaibhavg007.vg', 'vrushaligaikwad5496', 'swarupshende8055', 'chougulesourabh620', 'sharonsebastian333', 'khotatul94', 'pallavijagdale22', 'darshanahavaldar7', 'pruthvirajpatil191', 'pratikshasakhare', 'maheshchougale7072', 'paurnimadesaichinu', None, 'vrushali29sd']",42,"['chougulesourabh620', 'cpatil7896', 'abhijeetbiradar097', 'vrushali29sd', 'madhura7deshpande', 'amu72', 'vaibhavg007.vg', 'magdumpriya18', 'sharonsebastian333', 'shalmalirburse29', 'shubhammagdum6002', 'somnath1995', 'darshanahavaldar7', 'gajananpatil2513', 'gayatrimore2697', 'khotatul94', 'pruthvirajpatil191', 'shraddhabodakepatil', 'pallavijagdale22', 'maheshchougale7072', 'desaidhanashri32', 'akashvadrale', 'disha7', 'anghakamble247', 'nandrerutuja', 'vivekpatil1964', 'pratikshasakhare', 'vrushaligaikwad5496', 'pranotikumbhar1411', 'pranavj1996', 'pratikshachandane17197', 'swapnilpatil8072', 'siddheshwagh007', 'vishalv8082', 'vvpowar1996', 'amarjakatware96', 'komalpatil1323', 'rutujabhiungade177', None, 'dvd123jnv', 'swarupshende8055', 'paurnimadesaichinu']"
29,140,26,38,23,"['desaidhanashri32', 'anghakamble247', 'cpatil7896', 'nandrerutuja', 'vivekpatil1964', 'abhijeetbiradar097', 'amu72', 'magdumpriya18', 'shalmalirburse29', 'pranotikumbhar1411', 'shubhammagdum6002', 'pranavj1996', 'gajananpatil2513', 'gayatrimore2697', 'siddheshwagh007', 'swapnilpatil8072', 'vishalv8082', 'vvpowar1996', 'amarjakatware96', 'komalpatil1323', 'rutujabhiungade177', 'shraddhabodakepatil', 'dvd123jnv']",2,"['madhura7deshpande', 'somnath1995']",15,"['sayalipatil931997', 'sujitshinde341', 'akashvadrale', 'moreshilpa0910', 'disha7', 'vrushaligaikwad5496', 'vishuc1881', 'sakshi12', 'rk6998', 'ajitphadake108', 'darshanahavaldar7', 'pranalikumbhar5246', 'parimalpsonar1496', 'maheshchougale7072', None]",40,"['desaidhanashri32', 'sayalipatil931997', 'sujitshinde341', 'akashvadrale', 'moreshilpa0910', 'disha7', 'anghakamble247', 'cpatil7896', 'nandrerutuja', 'vivekpatil1964', 'abhijeetbiradar097', 'madhura7deshpande', 'amu72', 'vrushaligaikwad5496', 'magdumpriya18', 'sakshi12', 'shalmalirburse29', 'pranotikumbhar1411', 'shubhammagdum6002', 'ajitphadake108', 'somnath1995', 'pranalikumbhar5246', 'parimalpsonar1496', 'darshanahavaldar7', 'pranavj1996', 'gajananpatil2513', 'gayatrimore2697', 'siddheshwagh007', 'swapnilpatil8072', 'vishalv8082', 'vvpowar1996', 'rk6998', 'amarjakatware96', 'komalpatil1323', 'rutujabhiungade177', None, 'shraddhabodakepatil', 'dvd123jnv', 'vishuc1881', 'maheshchougale7072']"
29,141,26,9,7,"['madhura7deshpande', 'vishalv8082', 'magdumpriya18', 'vvpowar1996', 'abhijeetbiradar097', 'rutujabhiungade177', 'shraddhabodakepatil']",18,"['desaidhanashri32', 'gajananpatil2513', 'gayatrimore2697', 'siddheshwagh007', 'swapnilpatil8072', 'amu72', 'dvd123jnv', 'anghakamble247', 'shalmalirburse29', 'pranotikumbhar1411', 'shubhammagdum6002', 'cpatil7896', 'nandrerutuja', 'somnath1995', 'vivekpatil1964', 'amarjakatware96', 'komalpatil1323', 'pranavj1996']",2,"[None, 'akhilesh3587']",27,"['desaidhanashri32', 'gajananpatil2513', 'gayatrimore2697', 'siddheshwagh007', 'swapnilpatil8072', 'vishalv8082', 'vvpowar1996', 'anghakamble247', 'cpatil7896', 'nandrerutuja', 'amarjakatware96', 'vivekpatil1964', 'akhilesh3587', 'komalpatil1323', 'abhijeetbiradar097', 'rutujabhiungade177', None, 'shraddhabodakepatil', 'madhura7deshpande', 'amu72', 'dvd123jnv', 'magdumpriya18', 'shalmalirburse29', 'pranotikumbhar1411', 'shubhammagdum6002', 'somnath1995', 'pranavj1996']"
30,276,26,27,21,"['zacharymiler', 'hsafariyazd2', 'ayeshbond19', 'prathyush1', 'ktp210901234', 'yanxy', 'ysp16195', 'srinidhim', 'u3509300', 'xueningsong', 'alleksd', 'ktp21090', 'saiprathyushay', 'hsafariyazd', 'srinidhimula', 'ayeshbond', 'ccolina', 'lucky', 'sfb.chem', 'vjakhar', 'sradhaka']",4,"['dongyangli2016', 'budhathokisamir244', 'alchm', 'lee2002hu']",6,"['srisurya7', 'whenderson', 'john.garrison', 'mgbentley93', 'yadama95', None]",31,"['zacharymiler', 'budhathokisamir244', 'hsafariyazd2', 'ayeshbond19', 'alchm', 'lee2002hu', 'mgbentley93', 'prathyush1', 'ktp210901234', 'yanxy', 'ysp16195', 'srinidhim', 'u3509300', 'xueningsong', 'alleksd', 'dongyangli2016', 'ktp21090', 'srisurya7', 'saiprathyushay', 'hsafariyazd', 'john.garrison', 'srinidhimula', 'ayeshbond', 'yadama95', None, 'ccolina', 'whenderson', 'lucky', 'sfb.chem', 'vjakhar', 'sradhaka']"
30,277,26,16,12,"['ktp210901234', 'yanxy', 'saiprathyushay', 'lucky', 'u3509300', 'srinidhimula', 'ayeshbond', 'sradhaka', 'vjakhar', 'ayeshbond19', 'prathyush1', 'ccolina']",13,"['hsafariyazd', 'zacharymiler', 'ysp16195', 'budhathokisamir244', 'srinidhim', 'sfb.chem', 'hsafariyazd2', 'xueningsong', 'lee2002hu', 'alchm', 'alleksd', 'dongyangli2016', 'ktp21090']",4,"['mgbentley93', 'yadama95', None, 'john.garrison']",29,"['zacharymiler', 'budhathokisamir244', 'hsafariyazd2', 'ayeshbond19', 'alchm', 'lee2002hu', 'mgbentley93', 'prathyush1', 'ktp210901234', 'yanxy', 'ysp16195', 'srinidhim', 'u3509300', 'xueningsong', 'alleksd', 'dongyangli2016', 'ktp21090', 'saiprathyushay', 'hsafariyazd', 'john.garrison', 'srinidhimula', 'ayeshbond', 'yadama95', None, 'ccolina', 'lucky', 'sfb.chem', 'vjakhar', 'sradhaka']"
31,392,25,40,23,"['mikehurley', 'kaiisaacs1', 'jimbuchanan', 'haaldowailah', 'sierraludwig', 'karilivingston', 'fadelalatiqy', 'mitchellleibowitz', 'theomoodley', 'matthouston', 'latifzamankhan', 'jamieadams2', 'zahraaalwazzan', 'thomasmonty', 'rick_326', 'danielcourtright', 'kelseymumford', 'josephstellers924', 'conlanmarron', 'josephherker', 'jmd1', 'raey69', 'saeed00001']",1,['bakerbassel'],17,"['bmw92', 'jonhuff', 'jennyfothergill', 'codylynde', 'evansmith246', 'andreassavva', 'akvryan', 'coreyefaw', 'lanlibsu', 'soccor.ghuy', 'saidarazaee', 'matthewgoelzer', 'drewlysne', 'danniemakar', 'jihangaid', None, 'shamidovic']",41,"['sierraludwig', 'evansmith246', 'coreyefaw', 'soccor.ghuy', 'matthewgoelzer', 'fadelalatiqy', 'lanlibsu', 'saidarazaee', 'latifzamankhan', 'drewlysne', 'jamieadams2', 'zahraaalwazzan', 'bakerbassel', 'andreassavva', 'rick_326', 'danielcourtright', 'bmw92', 'conlanmarron', 'jihangaid', 'jmd1', 'jimbuchanan', 'raey69', 'saeed00001', 'mikehurley', 'jonhuff', 'kaiisaacs1', 'haaldowailah', 'karilivingston', 'mitchellleibowitz', 'jennyfothergill', 'akvryan', 'theomoodley', 'matthouston', 'shamidovic', 'thomasmonty', 'kelseymumford', None, 'josephstellers924', 'danniemakar', 'josephherker', 'codylynde']"
32,273,25,11,10,"['danielbrito', 'anarittacosta', 'pedro.carvalho.araujo.92', 'ramalho_goncalves', 'lucas_baptista', 'bernardofarol2', 'pachonbrito', 'jnieder', 'tiagoalvesq', 'barrinhos123']",14,"['zapdmitry', 'vancog', 'sajiddahar', 'cr_zy', 'leandrobenavides21', 'popkomisha', 'shell', 'kolyaalisevich1167', 'zheka', 'janstepnov', 'kamockia', 'kobernykyury', 'kukhto_97', 'blackmariah']",1,[None],25,"['zapdmitry', 'leandrobenavides21', 'ramalho_goncalves', 'popkomisha', 'lucas_baptista', 'janstepnov', 'kamockia', 'kobernykyury', 'kukhto_97', 'barrinhos123', 'blackmariah', None, 'danielbrito', 'sajiddahar', 'vancog', 'anarittacosta', 'pedro.carvalho.araujo.92', 'cr_zy', 'shell', 'kolyaalisevich1167', 'zheka', 'pachonbrito', 'bernardofarol2', 'jnieder', 'tiagoalvesq']"
32,274,25,11,3,"['kamockia', 'cr_zy', 'zapdmitry']",21,"['leandrobenavides21', 'ramalho_goncalves', 'blackmariah', 'danielbrito', 'sajiddahar', 'vancog', 'anarittacosta', 'pedro.carvalho.araujo.92', 'kolyaalisevich1167', 'zheka', 'pachonbrito', 'jnieder', 'tiagoalvesq', 'popkomisha', 'lucas_baptista', 'janstepnov', 'kobernykyury', 'kukhto_97', 'barrinhos123', 'shell', 'bernardofarol2']",8,"['vlad_iodo', 'io12345', 'misik.sashamiskoblr', 'mralexslbc', 'tripletwo567', 'jullietg', 'yura.menschikov', None]",32,"['vlad_iodo', 'zapdmitry', 'misik.sashamiskoblr', 'mralexslbc', 'leandrobenavides21', 'ramalho_goncalves', 'popkomisha', 'lucas_baptista', 'tripletwo567', 'janstepnov', 'yura.menschikov', 'kamockia', 'kobernykyury', 'kukhto_97', 'barrinhos123', 'blackmariah', None, 'io12345', 'danielbrito', 'sajiddahar', 'vancog', 'anarittacosta', 'pedro.carvalho.araujo.92', 'cr_zy', 'shell', 'kolyaalisevich1167', 'zheka', 'pachonbrito', 'bernardofarol2', 'jullietg', 'jnieder', 'tiagoalvesq']"
33,221,24,22,21,"['sion18', 'milesc18', 'ehrardt18', 'juntee', 'amurao18', 'areinemann', 'bdelplanche', 'almubari17', 'alkhudha16', 'osterberg', 'jacobbryant714', 'prpleluvr', 'langertrenton', 'guillera19', 'maggielongo', 'evandsmith14', 'jkarakawa12', 'guzmanv18', 'mukai18', 'paintballa628628', 'markusperry']",2,"['davisn18', 'thompsoj18']",1,[None],24,"['sion18', 'milesc18', 'ehrardt18', 'juntee', 'amurao18', 'areinemann', 'bdelplanche', 'almubari17', 'alkhudha16', 'osterberg', 'jacobbryant714', 'prpleluvr', 'langertrenton', 'guillera19', 'maggielongo', 'thompsoj18', 'davisn18', 'evandsmith14', None, 'jkarakawa12', 'guzmanv18', 'mukai18', 'paintballa628628', 'markusperry']"
34,400,23,27,21,"['elt17bw', 'mirjiang', 'gary0010', 'jxie13', 'niknanohub', 'orzmissman', 'azpixy', 'tanusharma', 'shanshuiyue', 'laplace_', 'pfeng3', 'wd2lh', 'clostuard', 'elq17cz', 'twang56', 'thursika', 'zhaohao', 'xtan15', 'jiangtao', 'myu9', 'gchen4']",1,['ayazbuet09'],6,"['nanahmadsufian1', 'dwen3', 'zhaomiaomiao', 'hzhou29', None, 'yvonnee213']",28,"['elt17bw', 'mirjiang', 'gary0010', 'jxie13', 'dwen3', 'zhaomiaomiao', 'niknanohub', 'yvonnee213', 'orzmissman', 'azpixy', 'tanusharma', 'shanshuiyue', 'hzhou29', 'laplace_', 'pfeng3', 'ayazbuet09', 'wd2lh', 'clostuard', 'elq17cz', 'twang56', 'thursika', None, 'zhaohao', 'xtan15', 'nanahmadsufian1', 'jiangtao', 'myu9', 'gchen4']"
34,399,23,25,21,"['elt17bw', 'mirjiang', 'gary0010', 'jxie13', 'niknanohub', 'orzmissman', 'azpixy', 'tanusharma', 'shanshuiyue', 'laplace_', 'pfeng3', 'wd2lh', 'clostuard', 'elq17cz', 'twang56', 'thursika', 'zhaohao', 'xtan15', 'jiangtao', 'myu9', 'gchen4']",1,['ayazbuet09'],4,"['zhouhenan', 'hkang8', None, 'wcz0129']",26,"['elt17bw', 'mirjiang', 'gary0010', 'jxie13', 'wcz0129', 'niknanohub', 'zhouhenan', 'orzmissman', 'azpixy', 'tanusharma', 'shanshuiyue', 'laplace_', 'pfeng3', 'ayazbuet09', 'wd2lh', 'clostuard', 'hkang8', 'elq17cz', 'twang56', 'thursika', None, 'zhaohao', 'xtan15', 'jiangtao', 'myu9', 'gchen4']"
34,401,23,25,19,"['elt17bw', 'mirjiang', 'gary0010', 'jxie13', 'niknanohub', 'orzmissman', 'azpixy', 'tanusharma', 'shanshuiyue', 'laplace_', 'pfeng3', 'wd2lh', 'elq17cz', 'twang56', 'thursika', 'zhaohao', 'xtan15', 'jiangtao', 'myu9']",3,"['clostuard', 'gchen4', 'ayazbuet09']",6,"['elp17ys', 'dwen3', 'zhaomiaomiao', 'hzhou29', None, 'yvonnee213']",28,"['elt17bw', 'mirjiang', 'gary0010', 'jxie13', 'dwen3', 'zhaomiaomiao', 'niknanohub', 'yvonnee213', 'orzmissman', 'azpixy', 'tanusharma', 'shanshuiyue', 'hzhou29', 'laplace_', 'pfeng3', 'ayazbuet09', 'wd2lh', 'clostuard', 'elq17cz', 'twang56', 'thursika', None, 'zhaohao', 'xtan15', 'elp17ys', 'jiangtao', 'myu9', 'gchen4']"
35,369,23,32,20,"['juliantecnologic', 'na.diaz', 'cy.andrade', 'dssv99', 'ja.forero15', 'numumero', 'josedanielmecon', 'nata.quintero3098', 'anamis_forero', 'pabloccr', 'danielcusva', 'miguel1003', 'miguell98md', 'ivanrulik', 'a.ricci10', 'carlos2992', 'crisdavbed08', 'ksgutierrez', 'electroniccasalins96', 'camilom']",2,"['jdal1996', 'miguelcg.97']",12,"['andresfdt.2k8', 'sd.diaz', None, 'velajua', 'eduardmolano', 'rdcajr', 'bryanc121297', 'raquelalejandra', 'brayant', 'sa.sanchez', 'fd.nino10', 'labiele2206']",34,"['juliantecnologic', 'na.diaz', 'rdcajr', 'cy.andrade', 'dssv99', 'raquelalejandra', 'ja.forero15', 'numumero', 'sa.sanchez', 'jdal1996', 'miguelcg.97', 'andresfdt.2k8', 'josedanielmecon', 'nata.quintero3098', 'anamis_forero', 'brayant', 'fd.nino10', 'sd.diaz', 'velajua', 'pabloccr', 'danielcusva', 'miguel1003', 'miguell98md', 'ivanrulik', 'bryanc121297', 'a.ricci10', 'labiele2206', None, 'carlos2992', 'crisdavbed08', 'ksgutierrez', 'eduardmolano', 'electroniccasalins96', 'camilom']"
35,219,23,30,19,"['juliantecnologic', 'na.diaz', 'cy.andrade', 'dssv99', 'ja.forero15', 'numumero', 'nata.quintero3098', 'anamis_forero', 'pabloccr', 'danielcusva', 'miguel1003', 'miguell98md', 'ivanrulik', 'a.ricci10', 'carlos2992', 'crisdavbed08', 'ksgutierrez', 'electroniccasalins96', 'camilom']",3,"['josedanielmecon', 'jdal1996', 'miguelcg.97']",11,"['andresfdt.2k8', 'sd.diaz', None, 'velajua', 'rdcajr', 'bryanc121297', 'raquelalejandra', 'kamilongis1', 'brayant', 'sa.sanchez', 'labiele2206']",33,"['juliantecnologic', 'na.diaz', 'rdcajr', 'cy.andrade', 'dssv99', 'raquelalejandra', 'ja.forero15', 'numumero', 'sa.sanchez', 'jdal1996', 'miguelcg.97', 'andresfdt.2k8', 'josedanielmecon', 'nata.quintero3098', 'anamis_forero', 'brayant', 'sd.diaz', 'velajua', 'pabloccr', 'danielcusva', 'miguel1003', 'miguell98md', 'ivanrulik', 'bryanc121297', 'kamilongis1', 'a.ricci10', 'labiele2206', None, 'carlos2992', 'crisdavbed08', 'ksgutierrez', 'electroniccasalins96', 'camilom']"
36,123,23,39,1,['sarabeja98'],21,"['hassanfatmi22', 'mikebenim', 'adeel9944', 'esmrln', 'jjb946', 'rmg895', 'sheikh.asher', 'jwo739', 'mhammadq71', 'willhelmd', 'kevintian2018', 'cjc560', 'mannantirmizi', 'lololilovechem', 'adw8059', 'rb959', 'johnnymski', 'hwoods6', 'adeel9955', 'marculius', 'sharmakm']",38,"['jufepas98', 'rdcajr', 'jenipinzon.ml', 'jesusvillamizar', 'raquelalejandra', 'erikananiela', 'sa.sanchez', 'we.simancas10', 'andresfdt.2k8', 'jairovlacha', 'brayant', 'jdmedinatobon', 'ja.jimenez317', 'dadelapa321', 'sd.diaz', 'af.vera10', 'j.wilckenlecompte', 'fabser7', 'rf.ruiz10', 'andres9802', 'andrestrujillo098', 'juandavid97', 'lf.correa10', 'hectordavidpulido', 'jupalinar17', 'labiele2206', None, 'vserrano081821', 'te.vence10', 'isabella', 'jfgf11', 'diegobb', 'jframos', 'carlosdoblev', 'vanessamovilla', 'juan_camilo', 'eduardmolano', 'escalantemariaalejandra']",60,"['hassanfatmi22', 'mikebenim', 'adeel9944', 'jufepas98', 'rdcajr', 'jenipinzon.ml', 'jesusvillamizar', 'raquelalejandra', 'erikananiela', 'esmrln', 'sa.sanchez', 'jjb946', 'rmg895', 'we.simancas10', 'andresfdt.2k8', 'sheikh.asher', 'jairovlacha', 'jwo739', 'mhammadq71', 'brayant', 'jdmedinatobon', 'ja.jimenez317', 'willhelmd', 'dadelapa321', 'kevintian2018', 'cjc560', 'sd.diaz', 'af.vera10', 'mannantirmizi', 'j.wilckenlecompte', 'lololilovechem', 'sarabeja98', 'adw8059', 'rb959', 'fabser7', 'rf.ruiz10', 'andres9802', 'johnnymski', 'hwoods6', 'andrestrujillo098', 'juandavid97', 'lf.correa10', 'hectordavidpulido', 'jupalinar17', 'adeel9955', 'labiele2206', None, 'vserrano081821', 'te.vence10', 'marculius', 'isabella', 'jfgf11', 'diegobb', 'jframos', 'carlosdoblev', 'vanessamovilla', 'sharmakm', 'juan_camilo', 'eduardmolano', 'escalantemariaalejandra']"
36,131,23,15,5,"['hassanfatmi22', 'mannantirmizi', 'adeel9944', 'sheikh.asher', 'adeel9955']",17,"['kevintian2018', 'cjc560', 'marculius', 'mikebenim', 'lololilovechem', 'sarabeja98', 'adw8059', 'rb959', 'jwo739', 'johnnymski', 'hwoods6', 'mhammadq71', 'sharmakm', 'esmrln', 'jjb946', 'rmg895', 'willhelmd']",10,"['naveedahmad0000000', 'ahmed.uzair14', 'greed', 'mhqqasmi', 'fakeha19', 'raousama3', 'uzairhasnain', 'hayder', None, 'turabhaiderkazmi1']",32,"['kevintian2018', 'cjc560', 'hassanfatmi22', 'mikebenim', 'adeel9944', 'mannantirmizi', 'naveedahmad0000000', 'lololilovechem', 'sarabeja98', 'adw8059', 'rb959', 'ahmed.uzair14', 'mhqqasmi', 'fakeha19', 'johnnymski', 'hwoods6', 'raousama3', 'uzairhasnain', 'esmrln', 'adeel9955', 'jjb946', None, 'rmg895', 'turabhaiderkazmi1', 'marculius', 'greed', 'sheikh.asher', 'jwo739', 'mhammadq71', 'sharmakm', 'hayder', 'willhelmd']"
36,132,23,12,9,"['kevintian2018', 'cjc560', 'mikebenim', 'adw8059', 'rb959', 'jwo739', 'johnnymski', 'jjb946', 'rmg895']",13,"['marculius', 'hassanfatmi22', 'adeel9944', 'mannantirmizi', 'lololilovechem', 'sarabeja98', 'sheikh.asher', 'hwoods6', 'mhammadq71', 'sharmakm', 'esmrln', 'adeel9955', 'willhelmd']",3,"['apk242', None, 'tgh504_tgh504']",25,"['kevintian2018', 'cjc560', 'hassanfatmi22', 'mikebenim', 'adeel9944', 'mannantirmizi', 'lololilovechem', 'sarabeja98', 'adw8059', 'rb959', 'johnnymski', 'hwoods6', 'tgh504_tgh504', 'esmrln', 'adeel9955', 'jjb946', None, 'rmg895', 'apk242', 'marculius', 'sheikh.asher', 'jwo739', 'mhammadq71', 'sharmakm', 'willhelmd']"
37,209,22,18,15,"['twilightermb', 'trentmeisenheimer1', 'phillipingraham', 'u0996851', 'spencerdonovan7', 'u6005951', 'shindw82', 'ericb2017', 'tale1201', 'jsmithslcc', 'rdejong', 'ethan.podritz', 'msanora', 'tawsif.bd', 'seansllewelyn']",6,"['maja.belacic', 'elancyu', 'u0494768', 'lsbp010', 'kniendorf24', 'janah']",3,"['muhammadzuhairi95', 'u1146591', None]",24,"['twilightermb', 'shindw82', 'lsbp010', 'ericb2017', 'tale1201', 'tawsif.bd', 'spencerdonovan7', 'u0494768', 'muhammadzuhairi95', 'jsmithslcc', 'ethan.podritz', 'seansllewelyn', 'phillipingraham', 'maja.belacic', 'elancyu', 'u6005951', 'u1146591', 'kniendorf24', 'rdejong', 'janah', 'msanora', None, 'u0996851', 'trentmeisenheimer1']"
38,193,22,113,15,"['rbritwik22', 'transegn1', 'piperp', 'pdressma', 'dkj142857', 'utsavac', 'zschleic', 'tmueller44', 'paulmather', 'vjoiner', 'engr13200', 'samrider', 'paul91', 'rituraj346', 'dcheu']",6,"['li2641', 'harrisonang713', 'tryba', 'biwrey', 'wbartell', 'cwiles']",98,"['yang1087', 'shi151', 'vdharman', 'sukirtthakur', 'ytursyn', 'gvkarthik', 'kbandar', 'lu500', 'kolispeter', 'taeksanglee', 'patkip', 'tsimon', 'willia98', 'samantas', 'taylorah', 'ndeneke', 'mrajase', 'tadhika', 'wang1471', 'phoutz', 'kristiaan2017', 'yjzhuang5', 'datta0', 'gmckiern', 'tanayadhikary', 'mulcay', 'jsqdcsq', 'huang714', 'myjokerss', 'psiripur', 'rahuldeshmukh', 'ych0580', 'mademoiselle0812', 'rtibrewa', 'kyano', 'xiaoli94', 'gchsong', 'alotaibi', 'kyrwilliams', 'bermel', 'wang3243', 'huntmartinm', 'ouyang16', 'harshit03sep', 'soto27', 'akshat042', 'shhsu001', 'shashanksk5495', 'marisol', 'marcum0', 'brown214', 'cmallen3', 'wang159', 'naik7', 'abhivictor2', 'nsalts', 'anjulvyas', 'liu1039', 'zhao830', 'rkanthar', 'denphi', 'azadoks', 'jiang556', 'zhan3024', 'nthung', 'titus9', 'mmh', 'hsu138', 'sabareesh169', 'ddmckay', 'wen', 'maathangi95', 'zhou646', 'kdaningb', 'bartar', 'patil52', 'ke_tang', 'ji52', 'ksriley', 'abiniwa', 'lpl', 'zhan3025', 'pengyu_long', 'psomers', 'wu1254', 'lalzatev', 'strachan', None, 'baerr', 'ybazarba', 'huan1177', 'jrudolp', 'ma130029', 'pratheekpatil24', 'isik', 'hvr', 'yang1489', 'yvemula']",119,"['yang1087', 'vdharman', 'sukirtthakur', 'gvkarthik', 'kbandar', 'tmueller44', 'lu500', 'kolispeter', 'ndeneke', 'mrajase', 'phoutz', 'yjzhuang5', 'gmckiern', 'rbritwik22', 'huang714', 'myjokerss', 'paulmather', 'rahuldeshmukh', 'kyrwilliams', 'bermel', 'ouyang16', 'dkj142857', 'harshit03sep', 'soto27', 'akshat042', 'shhsu001', 'shashanksk5495', 'marcum0', 'brown214', 'harrisonang713', 'wang159', 'naik7', 'anjulvyas', 'liu1039', 'zhao830', 'denphi', 'zhan3024', 'li2641', 'transegn1', 'mmh', 'hsu138', 'samrider', 'maathangi95', 'zhou646', 'vjoiner', 'ji52', 'abiniwa', 'lpl', 'psomers', 'wu1254', 'lalzatev', 'strachan', None, 'jrudolp', 'ma130029', 'piperp', 'isik', 'yang1489', 'cwiles', 'shi151', 'ytursyn', 'taeksanglee', 'patkip', 'tsimon', 'willia98', 'samantas', 'taylorah', 'tadhika', 'wang1471', 'kristiaan2017', 'dcheu', 'datta0', 'tanayadhikary', 'mulcay', 'jsqdcsq', 'psiripur', 'ych0580', 'mademoiselle0812', 'rtibrewa', 'kyano', 'xiaoli94', 'gchsong', 'alotaibi', 'wang3243', 'huntmartinm', 'paul91', 'biwrey', 'wbartell', 'marisol', 'cmallen3', 'zschleic', 'tryba', 'abhivictor2', 'nsalts', 'rkanthar', 'azadoks', 'jiang556', 'nthung', 'titus9', 'sabareesh169', 'ddmckay', 'wen', 'rituraj346', 'kdaningb', 'bartar', 'patil52', 'ke_tang', 'ksriley', 'zhan3025', 'pengyu_long', 'engr13200', 'baerr', 'ybazarba', 'huan1177', 'pratheekpatil24', 'pdressma', 'hvr', 'utsavac', 'yvemula']"
38,338,22,40,1,['rituraj346'],20,"['harrisonang713', 'zschleic', 'tmueller44', 'tryba', 'paul91', 'li2641', 'transegn1', 'samrider', 'vjoiner', 'dcheu', 'rbritwik22', 'paulmather', 'engr13200', 'piperp', 'pdressma', 'utsavac', 'dkj142857', 'biwrey', 'wbartell', 'cwiles']",39,"['marisol', 'dreamy', 'shi151', 'vdharman', 'brown214', 'ytursyn', 'yang1087', 'cmallen3', 'kbandar', 'abhivictor2', 'liu1039', 'lu500', 'zhao830', 'jiang556', 'patkip', 'zhan3024', 'nthung', 'phoutz', 'kristiaan2017', 'maathangi95', 'zhou646', 'yjzhuang5', 'bartar', 'ke_tang', 'ji52', 'ksriley', 'gmckiern', 'abiniwa', 'mulcay', 'huang714', 'myjokerss', 'wu1254', 'mademoiselle0812', None, 'baerr', 'ybazarba', 'xiaoli94', 'gchsong', 'isik']",60,"['marisol', 'dreamy', 'shi151', 'vdharman', 'brown214', 'harrisonang713', 'ytursyn', 'yang1087', 'cmallen3', 'zschleic', 'kbandar', 'tmueller44', 'tryba', 'abhivictor2', 'liu1039', 'lu500', 'zhao830', 'jiang556', 'patkip', 'zhan3024', 'li2641', 'transegn1', 'nthung', 'samrider', 'phoutz', 'kristiaan2017', 'maathangi95', 'vjoiner', 'rituraj346', 'biwrey', 'dcheu', 'zhou646', 'yjzhuang5', 'bartar', 'ke_tang', 'ji52', 'ksriley', 'gmckiern', 'rbritwik22', 'abiniwa', 'mulcay', 'huang714', 'myjokerss', 'paulmather', 'wu1254', 'engr13200', 'mademoiselle0812', None, 'baerr', 'ybazarba', 'xiaoli94', 'gchsong', 'piperp', 'pdressma', 'isik', 'utsavac', 'dkj142857', 'paul91', 'wbartell', 'cwiles']"
38,194,22,27,4,"['biwrey', 'tryba', 'vjoiner', 'li2641']",17,"['rbritwik22', 'harrisonang713', 'transegn1', 'piperp', 'pdressma', 'dkj142857', 'utsavac', 'zschleic', 'tmueller44', 'paulmather', 'engr13200', 'wbartell', 'samrider', 'paul91', 'rituraj346', 'dcheu', 'cwiles']",23,"['marisol', 'vdharman', 'chen2088', 'sukirtthakur', 'naik7', 'lu500', 'tsimon', 'patkip', 'sabareesh169', 'mrajase', 'wang1471', 'zhou646', 'abiniwa', 'huang714', 'chen380', 'rahuldeshmukh', 'lalzatev', 'mademoiselle0812', 'rtibrewa', None, 'yang1489', 'yvemula', 'wang3243']",44,"['marisol', 'vdharman', 'chen2088', 'harrisonang713', 'sukirtthakur', 'zschleic', 'tmueller44', 'tryba', 'naik7', 'lu500', 'tsimon', 'patkip', 'li2641', 'transegn1', 'sabareesh169', 'mrajase', 'wang1471', 'samrider', 'zhou646', 'vjoiner', 'rituraj346', 'biwrey', 'dcheu', 'abiniwa', 'rbritwik22', 'huang714', 'chen380', 'paulmather', 'engr13200', 'rahuldeshmukh', 'lalzatev', 'mademoiselle0812', 'rtibrewa', None, 'piperp', 'pdressma', 'utsavac', 'yang1489', 'yvemula', 'wang3243', 'dkj142857', 'paul91', 'wbartell', 'cwiles']"
38,196,22,17,2,"['samrider', 'rbritwik22']",19,"['harrisonang713', 'zschleic', 'tmueller44', 'tryba', 'paul91', 'li2641', 'transegn1', 'vjoiner', 'rituraj346', 'dcheu', 'paulmather', 'engr13200', 'piperp', 'pdressma', 'utsavac', 'dkj142857', 'biwrey', 'wbartell', 'cwiles']",15,"['ksriley', None, 'abiniwa', 'sukirtthakur', 'tanayadhikary', 'lalzatev', 'vyas13', 'psiripur', 'kbandar', 'alotaibi', 'soto27', 'kristiaan2017', 'anjulvyas', 'zhao830', 'patil52']",36,"['harrisonang713', 'sukirtthakur', 'zschleic', 'kbandar', 'tmueller44', 'tryba', 'anjulvyas', 'zhao830', 'li2641', 'transegn1', 'vyas13', 'samrider', 'kristiaan2017', 'vjoiner', 'rituraj346', 'biwrey', 'dcheu', 'patil52', 'ksriley', 'abiniwa', 'rbritwik22', 'tanayadhikary', 'psiripur', 'paulmather', 'engr13200', 'lalzatev', None, 'piperp', 'pdressma', 'utsavac', 'alotaibi', 'dkj142857', 'soto27', 'paul91', 'wbartell', 'cwiles']"
39,120,21,24,13,"['thscodus97', 'twpark8', 'xotn0104', 'kkhkcw', 'siun97', 'godemperorvars', 'iykoo010', 'jerrynohyunki', 'wnstn6361', 'han1801j', 'harry.na', 'rkim13', 'braian98']",7,"['fnf44', 'jhb0316', 'yeongbin', 'jhj970216d', 'gudwls0419', 'hys1031315', 'dxk0824']",11,"['lmulan', 'leeseunghyun', 'kbg04193', 'gwangoo525', 'trex6303', 'abjh123', 'yicoreen', 'ariel1998', 'khojandi', 'chae0823', None]",31,"['lmulan', 'kkhkcw', 'iykoo010', 'gwangoo525', 'trex6303', 'wnstn6361', 'yicoreen', 'jhb0316', 'braian98', 'thscodus97', 'godemperorvars', 'jerrynohyunki', 'abjh123', 'ariel1998', 'harry.na', 'rkim13', 'dxk0824', 'leeseunghyun', 'kbg04193', 'fnf44', 'yeongbin', 'khojandi', 'hys1031315', 'twpark8', None, 'xotn0104', 'siun97', 'han1801j', 'jhj970216d', 'gudwls0419', 'chae0823']"
39,368,21,14,9,"['kkhkcw', 'siun97', 'godemperorvars', 'iykoo010', 'jerrynohyunki', 'han1801j', 'fnf44', 'harry.na', 'twpark8']",11,"['thscodus97', 'gudwls0419', 'xotn0104', 'wnstn6361', 'jhb0316', 'yeongbin', 'jhj970216d', 'rkim13', 'hys1031315', 'braian98', 'dxk0824']",5,"['ariel1998', 'kbg04191', 'jhsk777', None, 'twpark8123']",25,"['gudwls0419', 'kkhkcw', 'iykoo010', 'wnstn6361', 'fnf44', 'jhj970216d', 'jhb0316', 'yeongbin', 'jhsk777', 'hys1031315', 'braian98', 'twpark8', None, 'twpark8123', 'thscodus97', 'xotn0104', 'siun97', 'godemperorvars', 'jerrynohyunki', 'han1801j', 'ariel1998', 'kbg04191', 'harry.na', 'rkim13', 'dxk0824']"
39,367,21,13,10,"['thscodus97', 'gudwls0419', 'xotn0104', 'wnstn6361', 'jhb0316', 'yeongbin', 'jhj970216d', 'rkim13', 'hys1031315', 'dxk0824']",10,"['twpark8', 'kkhkcw', 'siun97', 'godemperorvars', 'iykoo010', 'jerrynohyunki', 'han1801j', 'fnf44', 'harry.na', 'braian98']",3,"['grey10170', 'ryujin', None]",23,"['gudwls0419', 'kkhkcw', 'ryujin', 'iykoo010', 'wnstn6361', 'fnf44', 'jhj970216d', 'jhb0316', 'yeongbin', 'hys1031315', 'braian98', 'twpark8', None, 'thscodus97', 'xotn0104', 'siun97', 'godemperorvars', 'jerrynohyunki', 'han1801j', 'grey10170', 'harry.na', 'rkim13', 'dxk0824']"
39,122,21,9,7,"['wnstn6361', 'fnf44', 'jhb0316', 'jhj970216d', 'gudwls0419', 'hys1031315', 'dxk0824']",13,"['thscodus97', 'twpark8', 'xotn0104', 'kkhkcw', 'siun97', 'godemperorvars', 'iykoo010', 'jerrynohyunki', 'han1801j', 'yeongbin', 'harry.na', 'rkim13', 'braian98']",2,"[None, 'lasscap']",22,"['gudwls0419', 'kkhkcw', 'iykoo010', 'wnstn6361', 'fnf44', 'jhj970216d', 'jhb0316', 'lasscap', 'yeongbin', 'hys1031315', 'braian98', 'twpark8', None, 'thscodus97', 'xotn0104', 'siun97', 'godemperorvars', 'jerrynohyunki', 'han1801j', 'harry.na', 'rkim13', 'dxk0824']"
40,397,21,11,10,"['keldrid13', 'dodson0', 'audiallroadglg', 'gallowac', 'nsardjon', 'burton58', 'masterchief_117', 'hatfieb', 'lang32', 'cshanker']",10,"['pee8379', 'marija.jankunec', 'mcnallyh', 'mattpowell7', 'pkaur1', 'bmillik', 'viktorija.zaranko', 'dj_davo', 'wburnett', 'shams.hx']",1,[None],21,"['dodson0', 'audiallroadglg', 'gallowac', 'pee8379', 'nsardjon', 'marija.jankunec', 'mcnallyh', 'mattpowell7', 'pkaur1', 'hatfieb', 'viktorija.zaranko', 'lang32', None, 'cshanker', 'keldrid13', 'burton58', 'masterchief_117', 'bmillik', 'dj_davo', 'wburnett', 'shams.hx']"
40,395,21,8,7,"['keldrid13', 'audiallroadglg', 'gallowac', 'burton58', 'bmillik', 'lang32', 'cshanker']",13,"['dodson0', 'nsardjon', 'pee8379', 'marija.jankunec', 'mcnallyh', 'masterchief_117', 'mattpowell7', 'pkaur1', 'hatfieb', 'viktorija.zaranko', 'dj_davo', 'wburnett', 'shams.hx']",1,[None],21,"['dodson0', 'audiallroadglg', 'gallowac', 'pee8379', 'nsardjon', 'marija.jankunec', 'mcnallyh', 'mattpowell7', 'pkaur1', 'hatfieb', 'viktorija.zaranko', 'lang32', None, 'cshanker', 'keldrid13', 'burton58', 'masterchief_117', 'bmillik', 'dj_davo', 'wburnett', 'shams.hx']"
40,396,21,7,6,"['keldrid13', 'gallowac', 'burton58', 'masterchief_117', 'lang32', 'cshanker']",14,"['dodson0', 'audiallroadglg', 'nsardjon', 'pee8379', 'marija.jankunec', 'mcnallyh', 'mattpowell7', 'pkaur1', 'hatfieb', 'bmillik', 'viktorija.zaranko', 'dj_davo', 'wburnett', 'shams.hx']",1,[None],21,"['dodson0', 'audiallroadglg', 'gallowac', 'pee8379', 'nsardjon', 'marija.jankunec', 'mcnallyh', 'mattpowell7', 'pkaur1', 'hatfieb', 'viktorija.zaranko', 'lang32', None, 'cshanker', 'keldrid13', 'burton58', 'masterchief_117', 'bmillik', 'dj_davo', 'wburnett', 'shams.hx']"
41,260,21,73,20,"['karishmahirve96', 'mestryumesh123', 'rahul2011star', 'murkarnamita', 'shubhamrajpal038', 'yash8976', 'patelriyalds', 'tejasawasarmol', 'plotankar96', 'sandeep27996', 'rajatmohite48', 'jr.abishek00', 'kaminisuroshi26', 'deshpande192', 'priyankachaurasia9167', 'priyankapal3011', 'narvekarsushant0', 'varadrajnanaware7', 'shubhangihnkre14', 'sonam.wairkar']",0,[],53,"['ranegirish24', 'tejaswini', 'tejas7', 'damini.rane', 'saurabhpathare304', 'rushikool12', 'prasadtrimukhe', 'bodkesaurabh', 'pallavidshinde82', 'gidayegirish', 'shubhamraut', 'damle.rajas', 'shreya9609', 'manasitambat96', 'prathamesh24j', 'ashishghoderao', 'siddhant319', 'vinayak183', 'ronraviram789', 'satsamjr', 'akshaygodse13', 'rutvikstar', 'kunaldua99999', 'mandar.261', 'mohitavhad1997', 'shirsekarakash', 'kavusatose123', 'pratikpawar4996', 'dattaramkolekar', 'prasad.creativity123', 'bhairavi.chitalay', 'k.vekhande69', 'divujagushte26', 'shubhamkamble9639', 'yashpimpale6', 'aartibhalerao29', 'sarveshbhoer158', 'adityawasekar11', 'siddhantpawar993', 'vedankasalunke96', 'siddhantwarankar', 'sawardekarsuyash97', 'prasad24shingade', None, 'megh19k', 'girish.gidaye', 'priyankakudtarkar5', 'sgharat297', 'komalparab', 'revati.naik1501', 'suyogmankame93', 'bhamghodke7', 'akshay1997bhagit']",73,"['ranegirish24', 'damini.rane', 'tejas7', 'saurabhpathare304', 'rushikool12', 'mestryumesh123', 'prasadtrimukhe', 'murkarnamita', 'gidayegirish', 'shubhamrajpal038', 'shreya9609', 'manasitambat96', 'prathamesh24j', 'ashishghoderao', 'akshay1997bhagit', 'vinayak183', 'ronraviram789', 'satsamjr', 'rutvikstar', 'plotankar96', 'mandar.261', 'shirsekarakash', 'pratikpawar4996', 'yashpimpale6', 'sarveshbhoer158', 'siddhantwarankar', 'prasad24shingade', 'megh19k', 'jr.abishek00', 'kaminisuroshi26', 'girish.gidaye', 'deshpande192', 'komalparab', 'priyankapal3011', 'revati.naik1501', 'varadrajnanaware7', 'tejaswini', 'karishmahirve96', 'bodkesaurabh', 'rahul2011star', 'pallavidshinde82', 'shubhamraut', 'damle.rajas', 'yash8976', 'siddhant319', 'patelriyalds', 'akshaygodse13', 'tejasawasarmol', 'kunaldua99999', 'mohitavhad1997', 'kavusatose123', 'dattaramkolekar', 'prasad.creativity123', 'bhairavi.chitalay', 'k.vekhande69', 'divujagushte26', 'shubhamkamble9639', 'sandeep27996', 'aartibhalerao29', 'adityawasekar11', 'siddhantpawar993', 'vedankasalunke96', 'sawardekarsuyash97', 'rajatmohite48', None, 'priyankakudtarkar5', 'sgharat297', 'priyankachaurasia9167', 'narvekarsushant0', 'suyogmankame93', 'bhamghodke7', 'shubhangihnkre14', 'sonam.wairkar']"
42,303,20,64,5,"['zzcfc257', 'ee15btech11016', 'lleo', 'anandnwarrier1998', 'choppaaravind']",14,"['natalino.dimaio', 'mraval66', 'pooriaasa', 'aclement', 'batteryacidjuice', 'tatoedu', 'xdwzh123', 'patergio', 'datta119', 'vladimirgerasik', 'johnboy3312', 'matthewrdempsey', 'austin', 'nuitsman']",59,"['es16btech11018', 'bhavya12', 'es15btech11016', 'maniyarudit', 'ee16btech11024', 'nakshatra', 'subhashchandra', 'emani', 'rajeshwarchennam', 'priya18', 'bharadwaj1997', 'ashish.kittu10', 'ep15btech11005', 'rangesh', 'vishnu_33', 'havish', 'ee16btech11012', 'karlapatirajapradyumna', 'pulapapavan25', 'chakri1804', 'chait', 'vivek2699', 'deepkarma82', 'snehith', 'sidmohla', 'aravindganesh', 'ncsham', 'anuragshekhar', 'es16btech11003', 'bhanutabeti', 'ee16btech11013', 'preetham1998', 'ee16btech11010', 'jvinaykumar12', 'aamir_ee', 'vishwajith', 'anushag', 'ganna09', 'ep15btech11001', 'saiashish', 'pramith', None, 'es15btech11010', 'akramya98', 'ee16btech11001', 'mani6264', 'ee16btech11042', 'im2learning', 'karthikr98', 'sumanth', 'pradeepmoturi', 'es16btech11001', 'samhitha', 're1nth', 'adithyahosapate', 'dj_16', 'es16btech11026', 'srinidhibachu', 'devnano']",78,"['bhavya12', 'ee15btech11016', 'es15btech11016', 'maniyarudit', 'vladimirgerasik', 'subhashchandra', 'rajeshwarchennam', 'priya18', 'bharadwaj1997', 'mraval66', 'ep15btech11005', 'vishnu_33', 'choppaaravind', 'karlapatirajapradyumna', 'pulapapavan25', 'deepkarma82', 'zzcfc257', 'pooriaasa', 'aravindganesh', 'ncsham', 'bhanutabeti', 'saiashish', 'pramith', 'aclement', 'batteryacidjuice', 'im2learning', 'pradeepmoturi', 'es16btech11001', 'samhitha', 're1nth', 'dj_16', 'matthewrdempsey', 'es16btech11026', 'devnano', 'austin', 'es16btech11018', 'natalino.dimaio', 'akramya98', 'anushag', 'ee16btech11024', 'nakshatra', 'emani', 'ashish.kittu10', 'tatoedu', 'rangesh', 'datta119', 'havish', 'ee16btech11012', 'johnboy3312', 'chakri1804', 'chait', 'vivek2699', 'snehith', 'sidmohla', 'anuragshekhar', 'es16btech11003', 'ee16btech11013', 'preetham1998', 'patergio', 'lleo', 'anandnwarrier1998', 'ee16btech11010', 'jvinaykumar12', 'aamir_ee', 'vishwajith', 'ganna09', 'ep15btech11001', None, 'nuitsman', 'es15btech11010', 'ee16btech11001', 'mani6264', 'ee16btech11042', 'xdwzh123', 'karthikr98', 'sumanth', 'adithyahosapate', 'srinidhibachu']"
42,302,20,10,3,"['johnboy3312', 'batteryacidjuice', 'austin']",16,"['zzcfc257', 'natalino.dimaio', 'mraval66', 'pooriaasa', 'aclement', 'xdwzh123', 'tatoedu', 'ee15btech11016', 'patergio', 'lleo', 'anandnwarrier1998', 'datta119', 'vladimirgerasik', 'choppaaravind', 'matthewrdempsey', 'nuitsman']",7,"['breannbirch', 'lukemccormick09', 'x3bood', 'joshsykes', 'alisonleighoakes', None, 'siu853102587']",26,"['zzcfc257', 'natalino.dimaio', 'pooriaasa', 'ee15btech11016', 'patergio', 'lleo', 'anandnwarrier1998', 'vladimirgerasik', 'joshsykes', None, 'siu853102587', 'nuitsman', 'mraval66', 'aclement', 'batteryacidjuice', 'xdwzh123', 'tatoedu', 'breannbirch', 'lukemccormick09', 'x3bood', 'datta119', 'choppaaravind', 'johnboy3312', 'matthewrdempsey', 'alisonleighoakes', 'austin']"
42,304,20,9,3,"['batteryacidjuice', 'matthewrdempsey', 'nuitsman']",16,"['zzcfc257', 'natalino.dimaio', 'mraval66', 'pooriaasa', 'aclement', 'xdwzh123', 'tatoedu', 'ee15btech11016', 'patergio', 'lleo', 'anandnwarrier1998', 'datta119', 'vladimirgerasik', 'choppaaravind', 'johnboy3312', 'austin']",6,"['tanj83', 'diddykong63', 'x3bood', 'allymcminn98', 'malikasmith1', None]",25,"['zzcfc257', 'natalino.dimaio', 'pooriaasa', 'ee15btech11016', 'tanj83', 'patergio', 'lleo', 'anandnwarrier1998', 'diddykong63', 'allymcminn98', 'vladimirgerasik', None, 'nuitsman', 'mraval66', 'aclement', 'batteryacidjuice', 'xdwzh123', 'tatoedu', 'x3bood', 'datta119', 'choppaaravind', 'johnboy3312', 'matthewrdempsey', 'malikasmith1', 'austin']"
43,362,20,35,19,"['jer2201', 'cb3343', 'asg2189', 'wdm2114', 'hl3114', 'ibk2110', 'jon2104', 'jp3747', 'mag2293', 'jw3350', 'jg3910', 'ds3628', 'pcf2111', 'ldp2128', 'nrs2156', 'mab2397', 'mh14532', 'm.moeller', 'laf2175']",0,[],16,"['johnnyliinfo', 'smn2164', None, 'mosesp2', 'agutierrez', 'mak2254', 'st3113', 'bab2210', 'cs3647', 'ra2910', 'mm4764', 'margaretkaye01', 'smashnawaz', 'afq2101', 'cm3592', 'jm4304']",35,"['johnnyliinfo', 'jer2201', 'mosesp2', 'agutierrez', 'mak2254', 'asg2189', 'cb3343', 'wdm2114', 'mm4764', 'hl3114', 'ibk2110', 'jon2104', 'jp3747', 'mag2293', 'smashnawaz', 'jw3350', 'jg3910', 'cm3592', 'ds3628', 'pcf2111', 'st3113', 'ldp2128', 'bab2210', 'margaretkaye01', 'nrs2156', None, 'mab2397', 'smn2164', 'mh14532', 'm.moeller', 'cs3647', 'ra2910', 'afq2101', 'laf2175', 'jm4304']"
43,224,20,32,18,"['ibk2110', 'jer2201', 'jon2104', 'laf2175', 'ldp2128', 'mh14532', 'cb3343', 'asg2189', 'jp3747', 'wdm2114', 'mag2293', 'hl3114', 'm.moeller', 'nrs2156', 'jw3350', 'jg3910', 'ds3628', 'mab2397']",1,['pcf2111'],14,"['johnnyliinfo', 'smn2164', 'afq2101', 'mosesp2', 'mak2254', 'st3113', 'johnkym', 'bab2210', 'cs3647', 'ra2910', 'mm4764', 'bhupathirajumanasa', None, 'jm4304']",33,"['johnnyliinfo', 'jer2201', 'mosesp2', 'mak2254', 'asg2189', 'cb3343', 'wdm2114', 'mm4764', 'hl3114', 'ibk2110', 'jon2104', 'jp3747', 'mag2293', 'jw3350', 'jg3910', 'ds3628', 'pcf2111', 'st3113', 'johnkym', 'ldp2128', 'bab2210', 'nrs2156', 'bhupathirajumanasa', None, 'mab2397', 'smn2164', 'mh14532', 'm.moeller', 'cs3647', 'ra2910', 'afq2101', 'laf2175', 'jm4304']"
43,244,20,32,19,"['jer2201', 'cb3343', 'asg2189', 'wdm2114', 'hl3114', 'ibk2110', 'jon2104', 'jp3747', 'mag2293', 'jw3350', 'jg3910', 'ds3628', 'pcf2111', 'ldp2128', 'nrs2156', 'mab2397', 'mh14532', 'm.moeller', 'laf2175']",0,[],13,"['johnnyliinfo', 'smn2164', None, 'mak2254', 'st3113', 'johnkym', 'bab2210', 'cs3647', 'ra2910', 'mm4764', 'afq2101', 'cm3592', 'jm4304']",32,"['johnnyliinfo', 'jer2201', 'mak2254', 'asg2189', 'cb3343', 'wdm2114', 'mm4764', 'hl3114', 'ibk2110', 'jon2104', 'jp3747', 'mag2293', 'jw3350', 'jg3910', 'cm3592', 'ds3628', 'pcf2111', 'st3113', 'johnkym', 'ldp2128', 'bab2210', 'nrs2156', None, 'mab2397', 'smn2164', 'mh14532', 'm.moeller', 'cs3647', 'ra2910', 'afq2101', 'laf2175', 'jm4304']"
43,308,20,32,19,"['jer2201', 'cb3343', 'asg2189', 'wdm2114', 'hl3114', 'ibk2110', 'jon2104', 'jp3747', 'mag2293', 'jw3350', 'jg3910', 'ds3628', 'pcf2111', 'ldp2128', 'nrs2156', 'mab2397', 'mh14532', 'm.moeller', 'laf2175']",0,[],13,"['johnnyliinfo', 'smn2164', 'mosesp2', 'agutierrez', 'mak2254', 'st3113', 'bab2210', 'cs3647', 'ra2910', 'mm4764', 'afq2101', None, 'jm4304']",32,"['johnnyliinfo', 'jer2201', 'mosesp2', 'agutierrez', 'mak2254', 'asg2189', 'cb3343', 'wdm2114', 'mm4764', 'hl3114', 'ibk2110', 'jon2104', 'jp3747', 'mag2293', 'jw3350', 'jg3910', 'ds3628', 'pcf2111', 'st3113', 'ldp2128', 'bab2210', 'nrs2156', None, 'mab2397', 'smn2164', 'mh14532', 'm.moeller', 'cs3647', 'ra2910', 'afq2101', 'laf2175', 'jm4304']"
43,88,20,30,19,"['jer2201', 'cb3343', 'asg2189', 'wdm2114', 'hl3114', 'ibk2110', 'jon2104', 'jp3747', 'mag2293', 'jw3350', 'jg3910', 'ds3628', 'pcf2111', 'ldp2128', 'nrs2156', 'mab2397', 'mh14532', 'm.moeller', 'laf2175']",0,[],11,"['johnnyliinfo', 'smn2164', 'agutierrez', 'johnkym', 'bab2210', 'cs3647', 'ra2910', 'mm4764', 'afq2101', None, 'jm4304']",30,"['johnnyliinfo', 'jer2201', 'agutierrez', 'asg2189', 'cb3343', 'wdm2114', 'mm4764', 'hl3114', 'ibk2110', 'jon2104', 'jp3747', 'mag2293', 'jw3350', 'jg3910', 'ds3628', 'pcf2111', 'johnkym', 'ldp2128', 'bab2210', 'nrs2156', None, 'mab2397', 'smn2164', 'mh14532', 'm.moeller', 'cs3647', 'ra2910', 'afq2101', 'laf2175', 'jm4304']"
43,318,20,30,17,"['pcf2111', 'ibk2110', 'jer2201', 'jon2104', 'laf2175', 'ldp2128', 'mh14532', 'asg2189', 'jp3747', 'wdm2114', 'mag2293', 'hl3114', 'nrs2156', 'jw3350', 'jg3910', 'ds3628', 'mab2397']",2,"['m.moeller', 'cb3343']",13,"['johnnyliinfo', 'coolzach999', 'timobrien', 'agutierrez', 'mak2254', 'st3113', 'bab2210', 'cs3647', 'ra2910', 'mm4764', 'jm4304', 'rz2405', None]",32,"['johnnyliinfo', 'coolzach999', 'jer2201', 'agutierrez', 'mak2254', 'asg2189', 'cb3343', 'wdm2114', 'mm4764', 'hl3114', 'ibk2110', 'jon2104', 'jp3747', 'mag2293', 'jw3350', 'jg3910', 'ds3628', 'pcf2111', 'st3113', 'ldp2128', 'bab2210', 'nrs2156', None, 'mab2397', 'timobrien', 'mh14532', 'm.moeller', 'cs3647', 'ra2910', 'jm4304', 'rz2405', 'laf2175']"
43,242,20,29,19,"['jer2201', 'cb3343', 'asg2189', 'wdm2114', 'hl3114', 'ibk2110', 'jon2104', 'jp3747', 'mag2293', 'jw3350', 'jg3910', 'ds3628', 'pcf2111', 'ldp2128', 'nrs2156', 'mab2397', 'mh14532', 'm.moeller', 'laf2175']",0,[],10,"['johnnyliinfo', 'afq2101', 'mak2254', 'st3113', 'johnkym', 'cs3647', 'ra2910', 'bhupathirajumanasa', None, 'jm4304']",29,"['johnnyliinfo', 'jer2201', 'mak2254', 'asg2189', 'cb3343', 'wdm2114', 'hl3114', 'ibk2110', 'jon2104', 'jp3747', 'mag2293', 'jw3350', 'jg3910', 'ds3628', 'pcf2111', 'st3113', 'johnkym', 'ldp2128', 'nrs2156', 'bhupathirajumanasa', None, 'mab2397', 'mh14532', 'm.moeller', 'cs3647', 'ra2910', 'afq2101', 'laf2175', 'jm4304']"
43,227,20,28,18,"['pcf2111', 'ibk2110', 'jer2201', 'jon2104', 'laf2175', 'ldp2128', 'mh14532', 'cb3343', 'asg2189', 'jp3747', 'wdm2114', 'mag2293', 'hl3114', 'm.moeller', 'nrs2156', 'jw3350', 'jg3910', 'ds3628']",1,['mab2397'],10,"['johnnyliinfo', 'smn2164', 'mak2254', 'johnkym', 'st3113', 'ra2910', 'mm4764', 'afq2101', None, 'jm4304']",29,"['johnnyliinfo', 'jer2201', 'mak2254', 'asg2189', 'cb3343', 'wdm2114', 'mm4764', 'hl3114', 'ibk2110', 'jon2104', 'jp3747', 'mag2293', 'jw3350', 'jg3910', 'ds3628', 'pcf2111', 'johnkym', 'st3113', 'ldp2128', 'nrs2156', None, 'mab2397', 'smn2164', 'mh14532', 'm.moeller', 'ra2910', 'afq2101', 'laf2175', 'jm4304']"
43,83,20,26,17,"['pcf2111', 'jer2201', 'jon2104', 'laf2175', 'ldp2128', 'cb3343', 'asg2189', 'jp3747', 'wdm2114', 'mag2293', 'hl3114', 'm.moeller', 'nrs2156', 'jw3350', 'jg3910', 'ds3628', 'mab2397']",2,"['ibk2110', 'mh14532']",9,"['johnnyliinfo', 'mak2254', 'johnkym', 'st3113', 'bab2210', 'ra2910', 'mm4764', 'afq2101', None]",28,"['johnnyliinfo', 'jer2201', 'mak2254', 'asg2189', 'cb3343', 'wdm2114', 'mm4764', 'hl3114', 'ibk2110', 'jon2104', 'jp3747', 'mag2293', 'jw3350', 'jg3910', 'ds3628', 'pcf2111', 'johnkym', 'st3113', 'ldp2128', 'bab2210', 'nrs2156', None, 'mab2397', 'mh14532', 'm.moeller', 'ra2910', 'afq2101', 'laf2175']"
43,225,20,25,16,"['pcf2111', 'ibk2110', 'laf2175', 'ldp2128', 'mh14532', 'cb3343', 'asg2189', 'jp3747', 'wdm2114', 'mag2293', 'hl3114', 'm.moeller', 'nrs2156', 'jw3350', 'jg3910', 'ds3628']",3,"['jer2201', 'jon2104', 'mab2397']",9,"['johnnyliinfo', 'smn2164', 'mak2254', 'st3113', 'johnkym', 'ra2910', 'mm4764', 'bhupathirajumanasa', None]",28,"['johnnyliinfo', 'jer2201', 'mak2254', 'asg2189', 'cb3343', 'wdm2114', 'mm4764', 'hl3114', 'ibk2110', 'jon2104', 'jp3747', 'mag2293', 'jw3350', 'jg3910', 'ds3628', 'pcf2111', 'st3113', 'johnkym', 'ldp2128', 'nrs2156', 'bhupathirajumanasa', None, 'mab2397', 'smn2164', 'mh14532', 'm.moeller', 'ra2910', 'laf2175']"
43,324,20,24,17,"['pcf2111', 'ibk2110', 'laf2175', 'jon2104', 'ldp2128', 'cb3343', 'asg2189', 'jp3747', 'wdm2114', 'mag2293', 'hl3114', 'm.moeller', 'nrs2156', 'jw3350', 'jg3910', 'ds3628', 'mab2397']",2,"['jer2201', 'mh14532']",7,"['johnnyliinfo', 'mak2254', 'st3113', 'ra2910', 'mm4764', 'afq2101', None]",26,"['johnnyliinfo', 'jer2201', 'mak2254', 'asg2189', 'cb3343', 'wdm2114', 'mm4764', 'hl3114', 'ibk2110', 'jon2104', 'jp3747', 'mag2293', 'jw3350', 'jg3910', 'ds3628', 'pcf2111', 'st3113', 'ldp2128', 'nrs2156', None, 'mab2397', 'mh14532', 'm.moeller', 'ra2910', 'afq2101', 'laf2175']"
44,64,20,92,17,"['abhaskar31', 'shrutis31', 'kadampk15ex', 'pratik2225', 'gvishs15', 'prajwal.angolkar4', 'sakshijoshi', 'akashborhade123', 'sukhpreet11234kldfhd', 'cmahale95', 'tejdhupkar', 'jobin301', 'singhrajkarn1699', 'ashpillai.1996', 'yashjivrajani7799', 'aadi', 'kkiran31']",2,"['dipak131195', 'jung0hun']",75,"['tejalnaik12', 'vinayakgadkari8', 'karar.bhadreshwara', 'keshvis26', 'naikpratiksha510', 'abhijitharidas3107', 'yuvraj.t', 'amolgolwankar', 'pratik007', 'mayanair1104', 'prajoth.fernandes', 'shibssalian', 'shreyas.v', 'smriti.sivadas96', 'alwin1996', 'suhayl4k', 'pguleria', 'kmamaniya', 'shubhamgharat274', 'rashmithanair5', 'deeptimenon', 'ketan.db', 'pratik.gc', 'chinmaysj96', 'danieldsilva96', 'akarnik.13', 'mayureshnagvekar57', 'aditya332', 'sumasalian96', 'inderjitsingh87', 'rnair10', 'chinmaygawas', 'varunmullins', 'divya.shinde', 'temp999use', 'livz944', 'bpatel03', 'salianyatish111', 'shrey.joshi', 'kumarkhandagle33', 'samsonkajar', 'kharadesonam', 'anjali.kalmase', 'apurva.nehru', 'ralph.rodrigues69', 'poojanale1996', 'pranjal17', 'eshani2396', 'meet7', 'mkhanvilkar', 'dghosalkar', 'shally', 'varunndabhade', 'pravingowda28', 'mayank.vp', 'bnrnirmal94', 'npnishankpednekar', 'raj.vadariya', None, 'pjay10708', 'gsatpute64', 'krexianclass', 'css_', 'jonathanrjpereira', 'yashgosar9', 'moraeseric123', 'rubina15', 'adityagudla96', 'dheereshpoojary', 'nishumahapatro1995', 'bharatesh.a', 'cristyjne8', 'aniruddhaparte3', 'srevolution23', 'saniyasnair']",94,"['abhaskar31', 'tejalnaik12', 'vinayakgadkari8', 'karar.bhadreshwara', 'keshvis26', 'akashborhade123', 'naikpratiksha510', 'singhrajkarn1699', 'abhijitharidas3107', 'yashjivrajani7799', 'yuvraj.t', 'kkiran31', 'amolgolwankar', 'pratik007', 'mayanair1104', 'prajoth.fernandes', 'kadampk15ex', 'shibssalian', 'shreyas.v', 'smriti.sivadas96', 'aadi', 'alwin1996', 'suhayl4k', 'gvishs15', 'pguleria', 'sakshijoshi', 'kmamaniya', 'tejdhupkar', 'shubhamgharat274', 'rashmithanair5', 'deeptimenon', 'ketan.db', 'pratik.gc', 'chinmaysj96', 'danieldsilva96', 'dipak131195', 'cmahale95', 'akarnik.13', 'mayureshnagvekar57', 'aditya332', 'sumasalian96', 'inderjitsingh87', 'rnair10', 'chinmaygawas', 'varunmullins', 'divya.shinde', 'temp999use', 'livz944', 'bpatel03', 'salianyatish111', 'jobin301', 'shrey.joshi', 'kumarkhandagle33', 'samsonkajar', 'kharadesonam', 'anjali.kalmase', 'apurva.nehru', 'ralph.rodrigues69', 'poojanale1996', 'pranjal17', 'eshani2396', 'meet7', 'mkhanvilkar', 'dghosalkar', 'shally', 'varunndabhade', 'prajwal.angolkar4', 'pravingowda28', 'mayank.vp', 'bnrnirmal94', 'npnishankpednekar', 'raj.vadariya', None, 'pjay10708', 'gsatpute64', 'krexianclass', 'css_', 'jonathanrjpereira', 'jung0hun', 'yashgosar9', 'moraeseric123', 'rubina15', 'pratik2225', 'adityagudla96', 'sukhpreet11234kldfhd', 'dheereshpoojary', 'nishumahapatro1995', 'bharatesh.a', 'cristyjne8', 'aniruddhaparte3', 'srevolution23', 'saniyasnair', 'ashpillai.1996', 'shrutis31']"
44,69,20,44,1,['yashjivrajani7799'],18,"['abhaskar31', 'jung0hun', 'shrutis31', 'kadampk15ex', 'pratik2225', 'gvishs15', 'prajwal.angolkar4', 'sakshijoshi', 'akashborhade123', 'sukhpreet11234kldfhd', 'dipak131195', 'cmahale95', 'tejdhupkar', 'jobin301', 'singhrajkarn1699', 'ashpillai.1996', 'aadi', 'kkiran31']",43,"['surbhib2897', 'techn720ab', 'rohitwaghmare1997', 'keshvis26', 'pinakin', 'rajeshreesawale', 'shrinishdonde', 'mananmehta95', 'neha0206', 'kumarkhandagle33', 'aagamshah999999999', 'sahil.sawant031996', 'vora.jai1', 'shreyasshah14', 'sheetalchaudhari2210', 'divyavkhandkar.me', 'tripathishivam342', 'pallavi.valunj', 'tanvishah2410', 'pooja9702.pm', 'tanvinj1', 'prerana', 'aditik2107', 'adityaprakash41', 'alwin1996', 'vidur888', 'mehulkharvi7', 'chaitalivartak07', 'raj.vadariya', 'manassardar4444122', 'vandortshakti', None, 'ketan.db', 'rohitw0606', 'k25', 'rubina15', 'panchalparth417', 'aniruddhaparte3', 'niveshvaze', 'boy_with_nikon', 'ankitpandey1296', 'devashishmore478', 'meghana.loke02']",62,"['surbhib2897', 'abhaskar31', 'techn720ab', 'rohitwaghmare1997', 'keshvis26', 'akashborhade123', 'pinakin', 'rajeshreesawale', 'jobin301', 'shrinishdonde', 'singhrajkarn1699', 'mananmehta95', 'neha0206', 'yashjivrajani7799', 'kumarkhandagle33', 'kkiran31', 'aagamshah999999999', 'sahil.sawant031996', 'vora.jai1', 'kadampk15ex', 'shreyasshah14', 'sheetalchaudhari2210', 'divyavkhandkar.me', 'tripathishivam342', 'pallavi.valunj', 'aadi', 'tanvishah2410', 'pooja9702.pm', 'tanvinj1', 'prerana', 'aditik2107', 'adityaprakash41', 'alwin1996', 'gvishs15', 'prajwal.angolkar4', 'sakshijoshi', 'vidur888', 'mehulkharvi7', 'chaitalivartak07', 'tejdhupkar', 'raj.vadariya', 'manassardar4444122', 'vandortshakti', None, 'ketan.db', 'rohitw0606', 'k25', 'jung0hun', 'rubina15', 'pratik2225', 'sukhpreet11234kldfhd', 'panchalparth417', 'dipak131195', 'cmahale95', 'aniruddhaparte3', 'niveshvaze', 'boy_with_nikon', 'ankitpandey1296', 'devashishmore478', 'ashpillai.1996', 'meghana.loke02', 'shrutis31']"
44,65,20,19,1,['jung0hun'],18,"['abhaskar31', 'shrutis31', 'kadampk15ex', 'pratik2225', 'gvishs15', 'prajwal.angolkar4', 'sakshijoshi', 'akashborhade123', 'sukhpreet11234kldfhd', 'dipak131195', 'cmahale95', 'tejdhupkar', 'jobin301', 'singhrajkarn1699', 'ashpillai.1996', 'yashjivrajani7799', 'aadi', 'kkiran31']",18,"['minki051613', 'jyh', 'acrokw0502', None, 'k910716kim', 'shnie29', 'semmz105', 'doqnqo', 'mvert157', 'gunhoo777', 'hwi', 'ddangshiggy', 'gordius92', 'poby', 'jung0hunkr', 'scribble9440', 'empire312', 'guheak92']",37,"['jyh', 'abhaskar31', 'akashborhade123', 'hwi', 'jobin301', 'singhrajkarn1699', 'scribble9440', 'yashjivrajani7799', 'kkiran31', 'k910716kim', 'kadampk15ex', 'doqnqo', 'gunhoo777', 'empire312', 'guheak92', 'aadi', 'acrokw0502', 'semmz105', 'gvishs15', 'prajwal.angolkar4', 'sakshijoshi', 'tejdhupkar', 'gordius92', None, 'minki051613', 'jung0hun', 'shnie29', 'mvert157', 'pratik2225', 'sukhpreet11234kldfhd', 'dipak131195', 'cmahale95', 'ddangshiggy', 'jung0hunkr', 'ashpillai.1996', 'poby', 'shrutis31']"
44,67,20,6,1,['dipak131195'],18,"['abhaskar31', 'jung0hun', 'shrutis31', 'kadampk15ex', 'pratik2225', 'gvishs15', 'prajwal.angolkar4', 'sakshijoshi', 'akashborhade123', 'sukhpreet11234kldfhd', 'cmahale95', 'tejdhupkar', 'jobin301', 'singhrajkarn1699', 'ashpillai.1996', 'yashjivrajani7799', 'aadi', 'kkiran31']",5,"['ajaykumar2018', 'shraddha0306', 'yashgosar9', 'rashmithanair5', None]",24,"['abhaskar31', 'gvishs15', 'prajwal.angolkar4', 'sakshijoshi', 'akashborhade123', 'tejdhupkar', 'jobin301', 'rashmithanair5', 'singhrajkarn1699', 'yashjivrajani7799', None, 'kkiran31', 'ajaykumar2018', 'shraddha0306', 'yashgosar9', 'jung0hun', 'shrutis31', 'kadampk15ex', 'pratik2225', 'sukhpreet11234kldfhd', 'dipak131195', 'cmahale95', 'ashpillai.1996', 'aadi']"
44,68,20,6,1,['dipak131195'],18,"['abhaskar31', 'jung0hun', 'shrutis31', 'kadampk15ex', 'pratik2225', 'gvishs15', 'prajwal.angolkar4', 'sakshijoshi', 'akashborhade123', 'sukhpreet11234kldfhd', 'cmahale95', 'tejdhupkar', 'jobin301', 'singhrajkarn1699', 'ashpillai.1996', 'yashjivrajani7799', 'aadi', 'kkiran31']",5,"['ajaykumar2018', 'shraddha0306', 'alokpoddar526', 'tusharshetty421', None]",24,"['abhaskar31', 'alokpoddar526', 'gvishs15', 'prajwal.angolkar4', 'sakshijoshi', 'akashborhade123', 'tejdhupkar', 'jobin301', 'tusharshetty421', 'singhrajkarn1699', 'yashjivrajani7799', None, 'kkiran31', 'ajaykumar2018', 'shraddha0306', 'jung0hun', 'shrutis31', 'kadampk15ex', 'pratik2225', 'sukhpreet11234kldfhd', 'dipak131195', 'cmahale95', 'ashpillai.1996', 'aadi']"
45,89,19,15,13,"['julianolivares', 'baiyunkai', 'yasud11', 'rcobb7', 'chen.si', 'ruyam14', 'd4v13l', 'mgriessler', 'jongrez', 'dongyeh', 'caseyannmartin', 'dihu0830', 'morganahenderson']",5,"['jarrodconner', '9848421010.teja', 'djjohnnapier', 'ehakan', 'pedromauriciodesousa']",2,"[None, 'fzwake']",20,"['9848421010.teja', 'baiyunkai', 'rcobb7', 'd4v13l', 'ruyam14', 'dongyeh', 'morganahenderson', None, 'fzwake', 'julianolivares', 'jarrodconner', 'yasud11', 'djjohnnapier', 'chen.si', 'mgriessler', 'jongrez', 'caseyannmartin', 'dihu0830', 'ehakan', 'pedromauriciodesousa']"
46,127,19,27,17,"['villanovawildkitten', 'tsangiorgio', 'epalmese', 'zyu', 'patenright29', 'vutran1410', 'patrickhannagan', 'ameier', 'gwagner3', 'ncheong', 'jhan13', 'mfaller', 'qhao', 'qhuang1', 'robbymancini1397', 'dhauser2', 'tchung4']",1,['pegan4'],10,"['chartig1', None, 'mwhite46', 'josephedler', 'pragti.narang', 'ibukunsanni', 'kevinlifan', 'jtimon', 'barronstephanson', 'rwynne1']",28,"['tsangiorgio', 'patenright29', 'vutran1410', 'gwagner3', 'ncheong', 'mwhite46', 'qhao', 'dhauser2', 'ameier', 'robbymancini1397', 'ibukunsanni', 'rwynne1', 'villanovawildkitten', 'chartig1', 'epalmese', 'jhan13', 'mfaller', 'qhuang1', 'pegan4', 'pragti.narang', 'kevinlifan', 'jtimon', None, 'zyu', 'tchung4', 'josephedler', 'patrickhannagan', 'barronstephanson']"
46,92,19,24,18,"['villanovawildkitten', 'tsangiorgio', 'epalmese', 'zyu', 'patenright29', 'vutran1410', 'patrickhannagan', 'ameier', 'gwagner3', 'ncheong', 'jhan13', 'mfaller', 'qhao', 'qhuang1', 'robbymancini1397', 'pegan4', 'dhauser2', 'tchung4']",0,[],6,"['mwhite46', 'josephedler', 'ibukunsanni', 'jtimon', 'barronstephanson', None]",24,"['tsangiorgio', 'patenright29', 'vutran1410', 'gwagner3', 'ncheong', 'mwhite46', 'qhao', 'dhauser2', 'ameier', 'robbymancini1397', 'ibukunsanni', 'villanovawildkitten', 'epalmese', 'jhan13', 'mfaller', 'qhuang1', 'pegan4', 'jtimon', None, 'zyu', 'tchung4', 'josephedler', 'patrickhannagan', 'barronstephanson']"
46,133,19,23,17,"['villanovawildkitten', 'tsangiorgio', 'epalmese', 'zyu', 'patenright29', 'vutran1410', 'patrickhannagan', 'gwagner3', 'ncheong', 'jhan13', 'mfaller', 'qhao', 'qhuang1', 'robbymancini1397', 'pegan4', 'dhauser2', 'tchung4']",1,['ameier'],6,"['chartig1', 'ibukunsanni', 'jtimon', 'mgwhite97', None, 'gnanasaurya']",24,"['tsangiorgio', 'patenright29', 'vutran1410', 'gwagner3', 'ncheong', 'qhao', 'dhauser2', 'ameier', 'robbymancini1397', 'ibukunsanni', 'gnanasaurya', 'villanovawildkitten', 'chartig1', 'epalmese', 'jhan13', 'mfaller', 'qhuang1', 'pegan4', 'jtimon', None, 'zyu', 'tchung4', 'patrickhannagan', 'mgwhite97']"
46,359,19,22,16,"['villanovawildkitten', 'tsangiorgio', 'epalmese', 'zyu', 'vutran1410', 'patrickhannagan', 'ameier', 'gwagner3', 'ncheong', 'jhan13', 'mfaller', 'qhao', 'qhuang1', 'pegan4', 'dhauser2', 'tchung4']",2,"['robbymancini1397', 'patenright29']",6,"['mwhite46', 'josephedler', 'ibukunsanni', 'kevinlifan', 'barronstephanson', None]",24,"['tsangiorgio', 'patenright29', 'vutran1410', 'gwagner3', 'ncheong', 'mwhite46', 'qhao', 'dhauser2', 'ameier', 'robbymancini1397', 'ibukunsanni', 'villanovawildkitten', 'epalmese', 'jhan13', 'mfaller', 'qhuang1', 'pegan4', 'kevinlifan', None, 'zyu', 'tchung4', 'josephedler', 'patrickhannagan', 'barronstephanson']"
46,296,19,20,15,"['villanovawildkitten', 'tsangiorgio', 'epalmese', 'zyu', 'vutran1410', 'patrickhannagan', 'ameier', 'gwagner3', 'ncheong', 'mfaller', 'qhao', 'robbymancini1397', 'pegan4', 'dhauser2', 'tchung4']",3,"['qhuang1', 'jhan13', 'patenright29']",5,"['chartig1', 'mgwhite97', 'jtimon', 'barronstephanson', None]",23,"['tsangiorgio', 'patenright29', 'vutran1410', 'gwagner3', 'ncheong', 'qhao', 'dhauser2', 'ameier', 'robbymancini1397', 'villanovawildkitten', 'chartig1', 'epalmese', 'jhan13', 'mfaller', 'qhuang1', 'mgwhite97', 'pegan4', 'jtimon', None, 'zyu', 'tchung4', 'patrickhannagan', 'barronstephanson']"
46,294,19,16,12,"['villanovawildkitten', 'tsangiorgio', 'epalmese', 'vutran1410', 'patrickhannagan', 'ameier', 'gwagner3', 'ncheong', 'mfaller', 'qhao', 'dhauser2', 'tchung4']",6,"['zyu', 'patenright29', 'jhan13', 'qhuang1', 'robbymancini1397', 'pegan4']",4,"['josephedler', None, 'mwhite46', 'ibukunsanni']",22,"['villanovawildkitten', 'tsangiorgio', 'epalmese', 'patenright29', 'vutran1410', 'gwagner3', 'ncheong', 'jhan13', 'mwhite46', 'mfaller', 'qhao', 'qhuang1', 'pegan4', 'dhauser2', None, 'zyu', 'patrickhannagan', 'ameier', 'robbymancini1397', 'josephedler', 'ibukunsanni', 'tchung4']"
46,124,19,14,2,"['robbymancini1397', 'patenright29']",16,"['villanovawildkitten', 'tsangiorgio', 'epalmese', 'zyu', 'vutran1410', 'patrickhannagan', 'ameier', 'gwagner3', 'ncheong', 'jhan13', 'mfaller', 'qhao', 'qhuang1', 'pegan4', 'dhauser2', 'tchung4']",12,"['chartig1', 'vpandya', 'bgrau', 'zejohn', None, 'risia', 'ikyu', 'rajnp', 'pragti.narang', 'srocca', 'jtimon', 'rwynne1']",30,"['villanovawildkitten', 'chartig1', 'tsangiorgio', 'vpandya', 'epalmese', 'bgrau', 'patenright29', 'vutran1410', 'zejohn', 'risia', 'gwagner3', 'ncheong', 'jhan13', 'mfaller', 'qhao', 'qhuang1', 'pegan4', 'dhauser2', 'pragti.narang', 'jtimon', None, 'zyu', 'patrickhannagan', 'ameier', 'ikyu', 'rajnp', 'robbymancini1397', 'srocca', 'tchung4', 'rwynne1']"
46,292,19,14,10,"['villanovawildkitten', 'tsangiorgio', 'patenright29', 'vutran1410', 'ameier', 'jhan13', 'gwagner3', 'mfaller', 'robbymancini1397', 'dhauser2']",8,"['epalmese', 'zyu', 'patrickhannagan', 'ncheong', 'qhao', 'qhuang1', 'pegan4', 'tchung4']",4,"['jtimon', 'josephedler', None, 'mwhite46']",22,"['villanovawildkitten', 'tsangiorgio', 'epalmese', 'patenright29', 'vutran1410', 'gwagner3', 'ncheong', 'jhan13', 'mwhite46', 'mfaller', 'qhao', 'qhuang1', 'pegan4', 'dhauser2', 'jtimon', None, 'zyu', 'patrickhannagan', 'ameier', 'robbymancini1397', 'josephedler', 'tchung4']"
46,295,19,10,6,"['epalmese', 'zyu', 'vutran1410', 'ncheong', 'qhuang1', 'pegan4']",12,"['villanovawildkitten', 'tsangiorgio', 'patenright29', 'patrickhannagan', 'ameier', 'gwagner3', 'jhan13', 'mfaller', 'qhao', 'robbymancini1397', 'dhauser2', 'tchung4']",4,"['kevinlifan', 'josephedler', None, 'ibukunsanni']",22,"['villanovawildkitten', 'tsangiorgio', 'epalmese', 'patenright29', 'vutran1410', 'gwagner3', 'ncheong', 'jhan13', 'mfaller', 'qhao', 'qhuang1', 'pegan4', 'dhauser2', 'kevinlifan', None, 'zyu', 'patrickhannagan', 'ameier', 'robbymancini1397', 'josephedler', 'ibukunsanni', 'tchung4']"
46,95,19,8,5,"['villanovawildkitten', 'tsangiorgio', 'zyu', 'ncheong', 'qhuang1']",13,"['epalmese', 'patenright29', 'vutran1410', 'patrickhannagan', 'ameier', 'gwagner3', 'jhan13', 'mfaller', 'qhao', 'robbymancini1397', 'pegan4', 'dhauser2', 'tchung4']",3,"['kevinlifan', 'josephedler', None]",21,"['villanovawildkitten', 'tsangiorgio', 'epalmese', 'patenright29', 'vutran1410', 'gwagner3', 'ncheong', 'jhan13', 'mfaller', 'qhao', 'qhuang1', 'pegan4', 'dhauser2', 'kevinlifan', None, 'zyu', 'patrickhannagan', 'ameier', 'robbymancini1397', 'josephedler', 'tchung4']"
46,358,19,8,4,"['robbymancini1397', 'dhauser2', 'patenright29', 'vutran1410']",14,"['villanovawildkitten', 'tsangiorgio', 'epalmese', 'zyu', 'patrickhannagan', 'ameier', 'gwagner3', 'ncheong', 'jhan13', 'mfaller', 'qhao', 'qhuang1', 'pegan4', 'tchung4']",4,"['josephedler', None, 'pragti.narang', 'jtimon']",22,"['villanovawildkitten', 'tsangiorgio', 'epalmese', 'patenright29', 'vutran1410', 'gwagner3', 'ncheong', 'jhan13', 'mfaller', 'qhao', 'qhuang1', 'pegan4', 'dhauser2', 'pragti.narang', 'jtimon', None, 'zyu', 'patrickhannagan', 'ameier', 'robbymancini1397', 'josephedler', 'tchung4']"
46,94,19,7,5,"['epalmese', 'zyu', 'ncheong', 'qhao', 'patrickhannagan']",13,"['villanovawildkitten', 'tsangiorgio', 'patenright29', 'vutran1410', 'ameier', 'gwagner3', 'jhan13', 'mfaller', 'qhuang1', 'robbymancini1397', 'pegan4', 'dhauser2', 'tchung4']",2,"['josephedler', None]",20,"['villanovawildkitten', 'tsangiorgio', 'epalmese', 'patenright29', 'vutran1410', 'gwagner3', 'ncheong', 'jhan13', 'mfaller', 'qhao', 'qhuang1', 'pegan4', 'dhauser2', None, 'zyu', 'patrickhannagan', 'ameier', 'robbymancini1397', 'josephedler', 'tchung4']"
46,96,19,6,4,"['qhao', 'robbymancini1397', 'zyu', 'pegan4']",14,"['villanovawildkitten', 'tsangiorgio', 'epalmese', 'patenright29', 'vutran1410', 'patrickhannagan', 'ameier', 'gwagner3', 'ncheong', 'jhan13', 'mfaller', 'qhuang1', 'dhauser2', 'tchung4']",2,"[None, 'ibukunsanni']",20,"['villanovawildkitten', 'tsangiorgio', 'epalmese', 'patenright29', 'vutran1410', 'gwagner3', 'ncheong', 'jhan13', 'mfaller', 'qhao', 'qhuang1', 'pegan4', 'dhauser2', None, 'zyu', 'patrickhannagan', 'ameier', 'robbymancini1397', 'ibukunsanni', 'tchung4']"
47,243,19,34,5,"['briere.maddie', 'vov1337', 'littlefingers', 'cfleeting1', 'greggoldmanh']",13,"['tanmaychandavarkar', 'febatgeorge77', 'hemanthreddy088', 'shreyasb_07', 'naveen.250697', 'shwetasuresh7', 'neelgajjar', '893400291ab', 'razarath', 'nibble', 'nekkanti', 'chaitra08', 'varsharobert']",29,"['ghuynh', 'sherryok', 'nmj10', 'manav.avlani', 'neildhar', 'judisanchez24', 'dukexy123', 'siddarth07', 'alexzap', 'wlkrwilletts', 'stephen.xu.42', 'culbertalex', 'jphilippe23', 'sunytranquility', 'brandondr96', 'bwelton', None, 'han.yu', 'websterbei', 'trishul.nagenalli', 'wang.michael213', 'afl13', 'sakuray10', 'savini3', 'yangjcandy', 'yx114', 'august', 'frankyin970709', 'ddmf']",47,"['tanmaychandavarkar', 'ghuynh', 'naveen.250697', 'shwetasuresh7', 'neelgajjar', 'sherryok', 'razarath', 'nibble', 'manav.avlani', 'neildhar', 'cfleeting1', 'nmj10', 'judisanchez24', 'dukexy123', 'siddarth07', 'alexzap', '893400291ab', 'wlkrwilletts', 'stephen.xu.42', 'chaitra08', 'culbertalex', 'briere.maddie', 'jphilippe23', 'sunytranquility', 'vov1337', 'hemanthreddy088', 'shreyasb_07', 'littlefingers', 'brandondr96', 'varsharobert', 'bwelton', None, 'han.yu', 'websterbei', 'febatgeorge77', 'trishul.nagenalli', 'wang.michael213', 'afl13', 'nekkanti', 'sakuray10', 'savini3', 'yangjcandy', 'yx114', 'august', 'frankyin970709', 'ddmf', 'greggoldmanh']"
47,245,19,31,9,"['tanmaychandavarkar', 'febatgeorge77', 'shreyasb_07', '893400291ab', 'neelgajjar', 'nekkanti', 'razarath', 'nibble', 'chaitra08']",9,"['vov1337', 'greggoldmanh', 'hemanthreddy088', 'littlefingers', 'naveen.250697', 'shwetasuresh7', 'cfleeting1', 'varsharobert', 'briere.maddie']",22,"['saipranith257', 'hugos111', 'ashwingour', 'kkshehab95', 'jyothi2603', 'kuruvila592', 'ashaallen', 'thyagugowda', 'johnchou', 'rishi26', 'tanmaychandavarkar7', 'ericwash', 'b200777', 'ashishgajalkar', None, 'btl', 'dennishan123', 'sagar1gaik', 'yandongluo', 'akshaylambat2393', '893524272cm', 'bhavigna1994']",40,"['tanmaychandavarkar', 'saipranith257', 'hugos111', 'ashwingour', 'kkshehab95', 'naveen.250697', 'jyothi2603', 'shwetasuresh7', 'neelgajjar', 'razarath', 'nibble', 'ashaallen', 'kuruvila592', 'cfleeting1', 'thyagugowda', 'johnchou', '893400291ab', 'rishi26', 'tanmaychandavarkar7', 'chaitra08', 'briere.maddie', 'vov1337', 'hemanthreddy088', 'shreyasb_07', 'littlefingers', 'ericwash', 'varsharobert', 'b200777', 'ashishgajalkar', None, 'btl', 'dennishan123', 'sagar1gaik', 'febatgeorge77', 'yandongluo', 'akshaylambat2393', '893524272cm', 'nekkanti', 'bhavigna1994', 'greggoldmanh']"
47,254,19,26,9,"['tanmaychandavarkar', 'febatgeorge77', 'shreyasb_07', '893400291ab', 'neelgajjar', 'nekkanti', 'razarath', 'nibble', 'chaitra08']",9,"['vov1337', 'greggoldmanh', 'hemanthreddy088', 'littlefingers', 'naveen.250697', 'shwetasuresh7', 'cfleeting1', 'varsharobert', 'briere.maddie']",17,"['piyush.holay', 'saipranith257', 'ashwingour', 'samvid1992', 'kkshehab95', 'akshaylambat2393', 'keerthih22', 'kvepa', 'ekhesagar', 'ashaallen', 'b200777', 'bhavigna1994', 'ashishgajalkar', 'jamesp32895', None, 'btl', 'rahul060992']",35,"['tanmaychandavarkar', 'saipranith257', 'ashwingour', 'kkshehab95', 'naveen.250697', 'shwetasuresh7', 'neelgajjar', 'razarath', 'nibble', 'ashaallen', 'cfleeting1', 'samvid1992', 'keerthih22', '893400291ab', 'chaitra08', 'briere.maddie', 'rahul060992', 'piyush.holay', 'vov1337', 'hemanthreddy088', 'shreyasb_07', 'littlefingers', 'varsharobert', 'b200777', 'ashishgajalkar', None, 'btl', 'febatgeorge77', 'akshaylambat2393', 'nekkanti', 'ekhesagar', 'bhavigna1994', 'jamesp32895', 'kvepa', 'greggoldmanh']"
47,246,19,11,2,"['varsharobert', 'shwetasuresh7']",16,"['tanmaychandavarkar', 'febatgeorge77', 'vov1337', 'greggoldmanh', 'hemanthreddy088', 'shreyasb_07', 'naveen.250697', 'littlefingers', '893400291ab', 'neelgajjar', 'nekkanti', 'razarath', 'nibble', 'chaitra08', 'cfleeting1', 'briere.maddie']",9,"['mittalswapnil81', 'sandeepkrishnan51', 'shara_mathew', 'rathnamalarao', 'vishakh567', 'tsnitk2017', 'meerannaveeth', None, 'varvino']",27,"['tanmaychandavarkar', 'vov1337', 'hemanthreddy088', 'sandeepkrishnan51', 'shreyasb_07', 'naveen.250697', 'littlefingers', 'shara_mathew', 'shwetasuresh7', 'neelgajjar', 'razarath', 'nibble', 'rathnamalarao', 'cfleeting1', 'varsharobert', 'meerannaveeth', None, 'mittalswapnil81', 'febatgeorge77', 'greggoldmanh', '893400291ab', 'nekkanti', 'chaitra08', 'vishakh567', 'tsnitk2017', 'varvino', 'briere.maddie']"
48,146,18,19,15,"['maolson2', 'mbridge2', 'lakomy2', 'battini2', 'bstrfld2', 'chocoanna1128', 'dlee134', 'jhchen9328', 'erikjl2', 'berchto2', 'bsmith53', 'cgwllms2', 'onurcam2', 'yyabe2', 'plg2']",2,"['awang0718', 'pkapadi2']",4,"['kizhakk2', None, 'luisid2', 'jrodier2']",21,"['maolson2', 'lakomy2', 'bstrfld2', 'battini2', 'chocoanna1128', 'dlee134', 'cgwllms2', 'pkapadi2', 'onurcam2', None, 'plg2', 'mbridge2', 'jhchen9328', 'kizhakk2', 'erikjl2', 'berchto2', 'bsmith53', 'awang0718', 'luisid2', 'jrodier2', 'yyabe2']"
48,167,18,16,15,"['maolson2', 'mbridge2', 'lakomy2', 'battini2', 'bstrfld2', 'chocoanna1128', 'dlee134', 'jhchen9328', 'erikjl2', 'berchto2', 'bsmith53', 'cgwllms2', 'awang0718', 'yyabe2', 'plg2']",2,"['onurcam2', 'pkapadi2']",1,[None],18,"['maolson2', 'lakomy2', 'bstrfld2', 'battini2', 'chocoanna1128', 'dlee134', 'cgwllms2', 'pkapadi2', 'onurcam2', None, 'plg2', 'mbridge2', 'jhchen9328', 'erikjl2', 'berchto2', 'bsmith53', 'awang0718', 'yyabe2']"
48,168,18,13,12,"['maolson2', 'jhchen9328', 'bstrfld2', 'battini2', 'dlee134', 'erikjl2', 'berchto2', 'bsmith53', 'awang0718', 'onurcam2', 'yyabe2', 'plg2']",5,"['lakomy2', 'mbridge2', 'chocoanna1128', 'pkapadi2', 'cgwllms2']",1,[None],18,"['maolson2', 'lakomy2', 'bstrfld2', 'battini2', 'chocoanna1128', 'dlee134', 'cgwllms2', 'pkapadi2', 'onurcam2', None, 'plg2', 'mbridge2', 'jhchen9328', 'erikjl2', 'berchto2', 'bsmith53', 'awang0718', 'yyabe2']"
49,54,18,15,13,"['franklin1996', 'ruthcastaneda2000', 'cristhianxandino', 'fa7226199', 'kevinpatache', 'kleberllinin772', 'alexander0306', 'ru_viviana', 'jlrapter', 'santiago18remache', 'juancarlosaldazinca', 'dxnny', 'henryfazs1997']",4,"['ahmed.rezk.elalfy', 'vnkshree', 'santosh22', 'pradyoth98']",2,"['zulimar_tacuri', None]",19,"['franklin1996', 'ruthcastaneda2000', 'ahmed.rezk.elalfy', 'pradyoth98', 'juancarlosaldazinca', 'santosh22', None, 'cristhianxandino', 'zulimar_tacuri', 'fa7226199', 'kevinpatache', 'kleberllinin772', 'alexander0306', 'ru_viviana', 'jlrapter', 'santiago18remache', 'dxnny', 'vnkshree', 'henryfazs1997']"
50,202,18,36,17,"['zollermi', 'xianglijia', 'ardunn12', 'anas_abuodeh', 'ramotsai', 'hmkang', 'cherylc598', 'ruihan94', 'efelgus', 'qiuzanlin', 'viviannh', 'xperrylinn', 'sahays', 'xzwy2017', 'zinizhu', 'hhaoyan', 'humberto.batiz']",0,[],19,"['yihanxiao', 'cestellos', 'nongnuch.artrith', 'luoyunkai', 'jdagdelen', 'stko', 'penghaoxiao', 'rwoodsrobinson', 'bingxin_yu', 'tomaszy', 'jms94', 'lipengju', None, 'linusmettler', 'brian10salazar', 'rpigott', 'ylum', 'achuang2718', 'aurban']",36,"['yihanxiao', 'cestellos', 'nongnuch.artrith', 'luoyunkai', 'jdagdelen', 'ramotsai', 'hmkang', 'stko', 'qiuzanlin', 'viviannh', 'xperrylinn', 'sahays', 'xzwy2017', 'penghaoxiao', 'zinizhu', 'efelgus', 'humberto.batiz', 'rwoodsrobinson', 'bingxin_yu', 'xianglijia', 'anas_abuodeh', 'ruihan94', 'tomaszy', 'jms94', 'lipengju', None, 'linusmettler', 'brian10salazar', 'zollermi', 'ardunn12', 'rpigott', 'ylum', 'cherylc598', 'achuang2718', 'aurban', 'hhaoyan']"
50,155,18,28,17,"['zollermi', 'xianglijia', 'ardunn12', 'anas_abuodeh', 'ramotsai', 'hmkang', 'cherylc598', 'ruihan94', 'efelgus', 'qiuzanlin', 'viviannh', 'xperrylinn', 'sahays', 'xzwy2017', 'zinizhu', 'hhaoyan', 'humberto.batiz']",0,[],11,"['bingxin_yu', 'rpigott', 'ylum', 'stko', 'jms94', 'mmrejen', 'mpsherb', 'jdagdelen', 'zhang0419', None, 'rwoodsrobinson']",28,"['jdagdelen', 'ramotsai', 'hmkang', 'stko', 'qiuzanlin', 'viviannh', 'xperrylinn', 'sahays', 'xzwy2017', 'mmrejen', 'zinizhu', 'mpsherb', 'efelgus', 'humberto.batiz', 'zhang0419', 'rwoodsrobinson', 'bingxin_yu', 'xianglijia', 'anas_abuodeh', 'ruihan94', 'jms94', None, 'zollermi', 'ardunn12', 'rpigott', 'ylum', 'cherylc598', 'hhaoyan']"
50,206,18,20,15,"['zollermi', 'xianglijia', 'ardunn12', 'ramotsai', 'cherylc598', 'ruihan94', 'efelgus', 'qiuzanlin', 'viviannh', 'xperrylinn', 'sahays', 'xzwy2017', 'zinizhu', 'hhaoyan', 'humberto.batiz']",2,"['anas_abuodeh', 'hmkang']",5,"['bingxin_yu', 'stko', 'jms94', None, 'rwoodsrobinson']",22,"['bingxin_yu', 'xianglijia', 'anas_abuodeh', 'ruihan94', 'efelgus', 'jms94', None, 'zollermi', 'ardunn12', 'ramotsai', 'hmkang', 'cherylc598', 'stko', 'qiuzanlin', 'viviannh', 'xperrylinn', 'sahays', 'xzwy2017', 'zinizhu', 'hhaoyan', 'humberto.batiz', 'rwoodsrobinson']"
50,205,18,16,11,"['xianglijia', 'ardunn12', 'anas_abuodeh', 'ramotsai', 'cherylc598', 'ruihan94', 'sahays', 'viviannh', 'qiuzanlin', 'xzwy2017', 'zinizhu']",6,"['zollermi', 'hmkang', 'xperrylinn', 'hhaoyan', 'efelgus', 'humberto.batiz']",5,"['lu_jiang', 'ylum', 'stko', 'tomaszy', None]",22,"['xianglijia', 'anas_abuodeh', 'lu_jiang', 'ruihan94', 'efelgus', 'tomaszy', None, 'zollermi', 'ardunn12', 'ramotsai', 'hmkang', 'ylum', 'cherylc598', 'stko', 'qiuzanlin', 'viviannh', 'xperrylinn', 'sahays', 'xzwy2017', 'zinizhu', 'hhaoyan', 'humberto.batiz']"
50,153,18,6,4,"['ramotsai', 'efelgus', 'sahays', 'ardunn12']",13,"['zollermi', 'xianglijia', 'anas_abuodeh', 'hmkang', 'cherylc598', 'ruihan94', 'qiuzanlin', 'viviannh', 'xperrylinn', 'xzwy2017', 'zinizhu', 'hhaoyan', 'humberto.batiz']",2,"[None, 'rwoodsrobinson']",19,"['xianglijia', 'anas_abuodeh', 'ruihan94', 'efelgus', None, 'zollermi', 'ardunn12', 'ramotsai', 'hmkang', 'cherylc598', 'qiuzanlin', 'viviannh', 'xperrylinn', 'sahays', 'xzwy2017', 'zinizhu', 'hhaoyan', 'humberto.batiz', 'rwoodsrobinson']"
51,131,17,15,1,['fakeha19'],15,"['amir2552', 'appleton', 'zerogravity06', 'vchen3', 'therealdrcrater', 'rmnsaini92', 'mjdemari', 'reach2sayan', 'scme', 'backjoonho', 'sajib.barman', 'jgrout', 'tmccallu', 'inkatech', 'usslee']",14,"['naveedahmad0000000', 'hassanfatmi22', 'ahmed.uzair14', 'mannantirmizi', 'adeel9944', 'greed', 'sheikh.asher', 'mhqqasmi', 'raousama3', 'uzairhasnain', 'adeel9955', 'hayder', None, 'turabhaiderkazmi1']",30,"['amir2552', 'appleton', 'naveedahmad0000000', 'zerogravity06', 'ahmed.uzair14', 'hassanfatmi22', 'mannantirmizi', 'adeel9944', 'reach2sayan', 'mhqqasmi', 'fakeha19', 'raousama3', 'scme', 'uzairhasnain', 'sajib.barman', 'jgrout', 'adeel9955', 'usslee', None, 'turabhaiderkazmi1', 'therealdrcrater', 'vchen3', 'rmnsaini92', 'mjdemari', 'greed', 'sheikh.asher', 'backjoonho', 'tmccallu', 'inkatech', 'hayder']"
51,128,17,10,1,['fakeha19'],15,"['amir2552', 'appleton', 'zerogravity06', 'vchen3', 'therealdrcrater', 'rmnsaini92', 'mjdemari', 'reach2sayan', 'scme', 'backjoonho', 'sajib.barman', 'jgrout', 'tmccallu', 'inkatech', 'usslee']",9,"['naveedahmad0000000', 'ahmed.uzair14', 'greed', 'mhqqasmi', 'muhammadshernasir', 'hayder', 'shasadullah', None, 'malikarslan11']",25,"['amir2552', 'appleton', 'naveedahmad0000000', 'zerogravity06', 'ahmed.uzair14', 'reach2sayan', 'mhqqasmi', 'fakeha19', 'muhammadshernasir', 'scme', 'sajib.barman', 'jgrout', 'shasadullah', 'usslee', None, 'malikarslan11', 'therealdrcrater', 'vchen3', 'rmnsaini92', 'mjdemari', 'greed', 'backjoonho', 'tmccallu', 'inkatech', 'hayder']"
52,13,17,68,2,"['sgu201311413', 'sgu20131479']",14,"['rushnan', 'jreed473', 'nareshkumarhari', 'baagii_homie', 'gianca', 'anudari', 'aniruddharay93', 'reatoeros', 'eversor', 'aalshehri', 'tsfisher', 'ujash', 'gunsnroses.0219', 'yumnafmoussa']",66,"['sgu20131478', 'sgu20131430', 'sgu20121472', 'luysunyoung9', 'sgu20131507', 'sgu20141523', 'mightynebula', 'sgu20151515', 'miiinji', 'sgu20131413', 'kjt93', 'sgu20141452', 'sgu20141488', 'sgu20111512', 'sgu20131426', 'sgu20131471', '1022jinhee', 'sgu20131494', 'sgu20151423', 'sgu20101494', 'sgu20131443', 'sgu20141419', 'amirr89', 'sgu20111258', 'sgu20121528', 'sgu20131422', 'claritas', 'sgu20121494', 'sgu20151450', 'sgu20131437', 'sgu20141401', 'sgu20121502', 'sgu20141403', 'sgu20131509', 'ruth59', 'sgu20121510', 'honnyou', 'sgu20111537', 'sgu20131440', 'sgu20131467', 'sgu20131500', 'sgu20111471', 'sgu20131489', 'sgu20131429', 'sgu20101584', 'sgu20131482', 'sgu20131496', 'k910716kim', 'sgu20131504', 'kangtae', 'qpqp072472', 'sgu20121439', 'sgu20121486', 'sgu20111794', 'skzl34', None, 'bongwhan12', 'sgu20121452', 'sgu20121423', 'angyi90', 'sgu20131466', 'sgu20131499', 'sgu20131469', 'sgu20131486', 'sgu20141310', 'sgu20151469']",82,"['sgu20131478', 'sgu20131430', 'sgu20121472', 'luysunyoung9', 'sgu20131507', 'sgu20141523', 'aalshehri', 'mightynebula', 'sgu20151515', 'miiinji', 'sgu20131413', 'kjt93', 'sgu20141452', 'sgu20141488', 'sgu20111512', 'sgu20131426', 'sgu20131471', '1022jinhee', 'sgu20131494', 'sgu20151423', 'sgu20101494', 'sgu20131443', 'sgu20141419', 'amirr89', 'anudari', 'sgu20111258', 'sgu20121528', 'eversor', 'sgu20131422', 'sgu201311413', 'claritas', 'aniruddharay93', 'reatoeros', 'sgu20121494', 'sgu20151450', 'sgu20131437', 'sgu20141401', 'sgu20121502', 'sgu20141403', 'sgu20131509', 'ruth59', 'sgu20121510', 'honnyou', 'sgu20111537', 'nareshkumarhari', 'sgu20131440', 'sgu20131467', 'sgu20131500', 'tsfisher', 'sgu20111471', 'sgu20131489', 'sgu20131429', 'yumnafmoussa', 'sgu20101584', 'sgu20131482', 'sgu20131496', 'k910716kim', 'sgu20131504', 'baagii_homie', 'kangtae', 'qpqp072472', 'gunsnroses.0219', 'sgu20121439', 'jreed473', 'sgu20121486', 'sgu20111794', 'ujash', 'skzl34', None, 'bongwhan12', 'sgu20121452', 'rushnan', 'sgu20131479', 'gianca', 'sgu20121423', 'angyi90', 'sgu20131466', 'sgu20131499', 'sgu20131469', 'sgu20131486', 'sgu20141310', 'sgu20151469']"
52,34,17,54,1,['yumnafmoussa'],15,"['rushnan', 'jreed473', 'sgu20131479', 'nareshkumarhari', 'baagii_homie', 'sgu201311413', 'gianca', 'anudari', 'aniruddharay93', 'reatoeros', 'eversor', 'aalshehri', 'tsfisher', 'ujash', 'gunsnroses.0219']",53,"['rehamkandel', 'karimelmeligy', 'youstinamamdouh', 'mohamedabdelmaksoud1096', 'perihansherif', 'shrouk_mahmoud', 'mahmoudtarek313', 'mostafanazim1', 'ahmedreda0', 'jljhgjvlm', 'shimaaezz149', 'yehia', 'sararadwan', 'ranaahmed96', 'passantali', 'jailanosamaa', 'mosa_nosa', 'shimaaezz1495', 'fatma_aly2010', 'yaraahmeed7777', 'sara.saso9686', 'yehiafarouk.asurt', 'abdo1703', 'esraaezzzz', 'abdelrhman', 'mahmoudtarak51', 'abdorady', 'mernaosama40', 'hadilmazen10', 'menna_sarhan97', 'monmon', 'yehiaafaroukk', 'mustafa.maged95', 'hager.mostafa14.ah', 'mostafasami1996', 'mustafamagdy2020', 'nourhangamal', 'youstina1996mamdouh', 'ahmedashrafalaaser', 'tyo78790', None, 'sara_khaled1997', 'karim.tera1', 'sandy_sameh', 'abdelrahmanmagdy2022', 'manarahmeed', 'habib1996', 'mohamedtarek.mt450', 'nada_y', 'youssefemad', 'abdelrahmanelmy96', 'mnorhan1997', 'wa7sh19962013']",69,"['rehamkandel', 'mostafanazim1', 'ahmedreda0', 'aalshehri', 'shimaaezz149', 'sararadwan', 'passantali', 'mosa_nosa', 'shimaaezz1495', 'yaraahmeed7777', 'sara.saso9686', 'yehiafarouk.asurt', 'abdo1703', 'esraaezzzz', 'abdelrhman', 'mahmoudtarak51', 'mernaosama40', 'monmon', 'yehiaafaroukk', 'anudari', 'hager.mostafa14.ah', 'mustafamagdy2020', 'nourhangamal', 'eversor', 'tyo78790', 'sandy_sameh', 'sgu201311413', 'youssefemad', 'aniruddharay93', 'reatoeros', 'abdelrahmanelmy96', 'mnorhan1997', 'wa7sh19962013', 'karimelmeligy', 'youstinamamdouh', 'mohamedabdelmaksoud1096', 'nareshkumarhari', 'perihansherif', 'shrouk_mahmoud', 'mahmoudtarek313', 'tsfisher', 'jljhgjvlm', 'yumnafmoussa', 'yehia', 'ranaahmed96', 'jailanosamaa', 'baagii_homie', 'fatma_aly2010', 'gunsnroses.0219', 'abdorady', 'jreed473', 'hadilmazen10', 'menna_sarhan97', 'mustafa.maged95', 'mostafasami1996', 'youstina1996mamdouh', 'ahmedashrafalaaser', 'ujash', None, 'rushnan', 'sara_khaled1997', 'sgu20131479', 'karim.tera1', 'abdelrahmanmagdy2022', 'gianca', 'manarahmeed', 'habib1996', 'mohamedtarek.mt450', 'nada_y']"
52,247,17,26,1,['sgu20131479'],15,"['rushnan', 'jreed473', 'nareshkumarhari', 'baagii_homie', 'sgu201311413', 'gianca', 'anudari', 'aniruddharay93', 'reatoeros', 'eversor', 'aalshehri', 'tsfisher', 'ujash', 'gunsnroses.0219', 'yumnafmoussa']",25,"['sgu20121500', 'sgu20131478', 'sgu20121472', 'sgu20121480', 'miscre2d', 'sgu20131486', 'sgu20131496', 'sgu20131504', 'sgu20111512', 'taehojung', 'kangtae', 'sgu20101494', 'sgu20131421', None, 'sgu20121452', 'sgu20121446', 'yunchoi', 'sgu20121466', 'sgu20121450', 'sgu20131419', 'sgu20121502', 'sgu20141401', 'sgu20131469', 'sgu20151450', 'sgu20151469']",41,"['sgu20121500', 'sgu20131478', 'nareshkumarhari', 'sgu20121472', 'sgu20121480', 'miscre2d', 'aalshehri', 'tsfisher', 'sgu20131486', 'yumnafmoussa', 'sgu20131496', 'sgu20131504', 'sgu20111512', 'baagii_homie', 'taehojung', 'kangtae', 'gunsnroses.0219', 'jreed473', 'sgu20101494', 'anudari', 'ujash', 'eversor', None, 'sgu20131421', 'sgu20121452', 'rushnan', 'sgu20121446', 'sgu20131479', 'yunchoi', 'sgu201311413', 'gianca', 'sgu20121466', 'aniruddharay93', 'reatoeros', 'sgu20121450', 'sgu20131419', 'sgu20121502', 'sgu20141401', 'sgu20131469', 'sgu20151450', 'sgu20151469']"
52,19,17,18,3,"['aalshehri', 'jreed473', 'tsfisher']",13,"['rushnan', 'sgu20131479', 'nareshkumarhari', 'baagii_homie', 'sgu201311413', 'gianca', 'anudari', 'aniruddharay93', 'reatoeros', 'eversor', 'ujash', 'gunsnroses.0219', 'yumnafmoussa']",15,"['gkatiyar', None, 'ujashshah2006', 'sandalib', 'guanzeyi', 'jausnance', 'atinkrish95', 'cmouzaoui', 'saravc', 'jinzhao.hu', 'yunbo0527', 'mf071940', 'abolfazlsadeghpour', 'luckypsh', 'addashti']",31,"['jreed473', 'nareshkumarhari', 'ujashshah2006', 'anudari', 'jausnance', 'aalshehri', 'tsfisher', 'cmouzaoui', 'saravc', 'jinzhao.hu', 'yunbo0527', 'mf071940', 'ujash', 'eversor', 'luckypsh', 'yumnafmoussa', None, 'addashti', 'rushnan', 'gkatiyar', 'sgu20131479', 'baagii_homie', 'sgu201311413', 'gianca', 'sandalib', 'guanzeyi', 'aniruddharay93', 'reatoeros', 'atinkrish95', 'abolfazlsadeghpour', 'gunsnroses.0219']"
52,20,17,15,3,"['baagii_homie', 'gunsnroses.0219', 'anudari']",13,"['rushnan', 'jreed473', 'sgu20131479', 'nareshkumarhari', 'sgu201311413', 'gianca', 'aniruddharay93', 'reatoeros', 'aalshehri', 'tsfisher', 'ujash', 'eversor', 'yumnafmoussa']",12,"['ulaankhuu95', 'slize9995', 'x.ganerdene', 'banzragch', 'seiko_anarjin', 'djtumenjargal', 'ganzo_0306', 'ulaankhuu72', 'bil_marbel', 'luvsantseren_0329', 'choijamts.choijoo', None]",28,"['slize9995', 'jreed473', 'nareshkumarhari', 'djtumenjargal', 'anudari', 'aalshehri', 'tsfisher', 'ulaankhuu72', 'choijamts.choijoo', 'ujash', 'eversor', None, 'yumnafmoussa', 'rushnan', 'ulaankhuu95', 'x.ganerdene', 'banzragch', 'sgu20131479', 'seiko_anarjin', 'baagii_homie', 'sgu201311413', 'gianca', 'aniruddharay93', 'reatoeros', 'ganzo_0306', 'luvsantseren_0329', 'bil_marbel', 'gunsnroses.0219']"
52,18,17,14,1,['yumnafmoussa'],15,"['rushnan', 'jreed473', 'sgu20131479', 'nareshkumarhari', 'baagii_homie', 'sgu201311413', 'gianca', 'anudari', 'aniruddharay93', 'reatoeros', 'eversor', 'aalshehri', 'tsfisher', 'ujash', 'gunsnroses.0219']",13,"['aurora', 'i_metwally', None, 'peterasaad94', 'alidrashwan', 'mohamedhelal', 'youssefemad', 'sahardiaaeldin1', 'paul94', 'shady_nashed', 'saramagdi', 'elsayed3', 'yehia']",29,"['jreed473', 'nareshkumarhari', 'alidrashwan', 'mohamedhelal', 'anudari', 'sahardiaaeldin1', 'aalshehri', 'tsfisher', 'shady_nashed', 'aurora', 'ujash', 'eversor', None, 'yumnafmoussa', 'yehia', 'rushnan', 'i_metwally', 'peterasaad94', 'sgu20131479', 'baagii_homie', 'sgu201311413', 'gianca', 'youssefemad', 'elsayed3', 'aniruddharay93', 'reatoeros', 'paul94', 'saramagdi', 'gunsnroses.0219']"
52,27,17,12,3,"['baagii_homie', 'gunsnroses.0219', 'anudari']",13,"['rushnan', 'jreed473', 'sgu20131479', 'nareshkumarhari', 'sgu201311413', 'gianca', 'aniruddharay93', 'reatoeros', 'aalshehri', 'tsfisher', 'ujash', 'eversor', 'yumnafmoussa']",9,"['munkhtulga', 'banzragch', 'seiko_anarjin', 'undram', 'djtumenjargal', 'ulaankhuu72', 'khatna.ccb1218', 'bolor', None]",25,"['jreed473', 'nareshkumarhari', 'undram', 'djtumenjargal', 'anudari', 'aalshehri', 'tsfisher', 'ulaankhuu72', 'khatna.ccb1218', 'ujash', 'eversor', None, 'yumnafmoussa', 'rushnan', 'banzragch', 'sgu20131479', 'munkhtulga', 'baagii_homie', 'sgu201311413', 'gianca', 'seiko_anarjin', 'aniruddharay93', 'reatoeros', 'bolor', 'gunsnroses.0219']"
52,16,17,10,1,['yumnafmoussa'],15,"['rushnan', 'jreed473', 'sgu20131479', 'nareshkumarhari', 'baagii_homie', 'sgu201311413', 'gianca', 'anudari', 'aniruddharay93', 'reatoeros', 'eversor', 'aalshehri', 'tsfisher', 'ujash', 'gunsnroses.0219']",9,"['i_metwally', None, 'mohamedhelal', 'alidrashwan', 'sahardiaaeldin1', 'norchan', 'aurora', 'saramagdi', 'elsayed3']",25,"['jreed473', 'nareshkumarhari', 'mohamedhelal', 'alidrashwan', 'anudari', 'sahardiaaeldin1', 'aalshehri', 'tsfisher', 'norchan', 'aurora', 'ujash', 'eversor', None, 'yumnafmoussa', 'rushnan', 'i_metwally', 'sgu20131479', 'baagii_homie', 'sgu201311413', 'gianca', 'elsayed3', 'aniruddharay93', 'reatoeros', 'saramagdi', 'gunsnroses.0219']"
52,24,17,9,1,['yumnafmoussa'],15,"['rushnan', 'jreed473', 'sgu20131479', 'nareshkumarhari', 'baagii_homie', 'sgu201311413', 'gianca', 'anudari', 'aniruddharay93', 'reatoeros', 'eversor', 'aalshehri', 'tsfisher', 'ujash', 'gunsnroses.0219']",8,"['aurora', 'i_metwally', 'mohamedhelal', 'youssefemad', 'bel5525', 'shady_nashed', 'saramagdi', None]",24,"['jreed473', 'nareshkumarhari', 'mohamedhelal', 'anudari', 'aalshehri', 'tsfisher', 'shady_nashed', 'aurora', 'ujash', 'eversor', None, 'yumnafmoussa', 'rushnan', 'i_metwally', 'sgu20131479', 'baagii_homie', 'sgu201311413', 'gianca', 'youssefemad', 'aniruddharay93', 'reatoeros', 'bel5525', 'saramagdi', 'gunsnroses.0219']"
52,14,17,8,3,"['baagii_homie', 'gunsnroses.0219', 'anudari']",13,"['rushnan', 'jreed473', 'sgu20131479', 'nareshkumarhari', 'sgu201311413', 'gianca', 'aniruddharay93', 'reatoeros', 'aalshehri', 'tsfisher', 'ujash', 'eversor', 'yumnafmoussa']",5,"['seiko_anarjin', 'djtumenjargal', 'bmunkhzorig', 'choijamts.choijoo', None]",21,"['jreed473', 'nareshkumarhari', 'djtumenjargal', 'anudari', 'aalshehri', 'tsfisher', 'choijamts.choijoo', 'ujash', 'eversor', None, 'yumnafmoussa', 'rushnan', 'sgu20131479', 'seiko_anarjin', 'baagii_homie', 'sgu201311413', 'gianca', 'aniruddharay93', 'reatoeros', 'bmunkhzorig', 'gunsnroses.0219']"
52,17,17,7,1,['gunsnroses.0219'],15,"['rushnan', 'jreed473', 'sgu20131479', 'nareshkumarhari', 'baagii_homie', 'sgu201311413', 'gianca', 'anudari', 'aniruddharay93', 'reatoeros', 'aalshehri', 'tsfisher', 'ujash', 'eversor', 'yumnafmoussa']",6,"['banzragch', 'seiko_anarjin', 'djtumenjargal', 'bmunkhzorig', 'choijamts.choijoo', None]",22,"['jreed473', 'nareshkumarhari', 'djtumenjargal', 'anudari', 'aalshehri', 'tsfisher', 'choijamts.choijoo', 'ujash', 'eversor', None, 'yumnafmoussa', 'rushnan', 'banzragch', 'sgu20131479', 'seiko_anarjin', 'baagii_homie', 'sgu201311413', 'gianca', 'aniruddharay93', 'reatoeros', 'bmunkhzorig', 'gunsnroses.0219']"
52,29,17,7,2,"['gianca', 'reatoeros']",14,"['rushnan', 'jreed473', 'sgu20131479', 'nareshkumarhari', 'baagii_homie', 'sgu201311413', 'anudari', 'aniruddharay93', 'eversor', 'aalshehri', 'tsfisher', 'ujash', 'gunsnroses.0219', 'yumnafmoussa']",5,"['lez94', 'ferrario.andrea', 'aldihoxha92', 'lucaselmi', None]",21,"['jreed473', 'nareshkumarhari', 'anudari', 'aalshehri', 'tsfisher', 'aldihoxha92', 'ujash', 'eversor', None, 'yumnafmoussa', 'rushnan', 'lez94', 'sgu20131479', 'baagii_homie', 'sgu201311413', 'gianca', 'aniruddharay93', 'reatoeros', 'ferrario.andrea', 'lucaselmi', 'gunsnroses.0219']"
52,32,17,7,1,['gianca'],15,"['rushnan', 'jreed473', 'sgu20131479', 'nareshkumarhari', 'baagii_homie', 'sgu201311413', 'anudari', 'aniruddharay93', 'reatoeros', 'eversor', 'aalshehri', 'tsfisher', 'ujash', 'gunsnroses.0219', 'yumnafmoussa']",6,"['harishkct11', 'lez94', 'baldassimassimo', 'lucaselmi', 'alessandro.pilotto', None]",22,"['jreed473', 'nareshkumarhari', 'anudari', 'baldassimassimo', 'aalshehri', 'tsfisher', 'ujash', 'eversor', None, 'yumnafmoussa', 'rushnan', 'harishkct11', 'lez94', 'sgu20131479', 'baagii_homie', 'sgu201311413', 'gianca', 'aniruddharay93', 'reatoeros', 'lucaselmi', 'alessandro.pilotto', 'gunsnroses.0219']"
52,105,17,7,2,"['aalshehri', 'jreed473']",14,"['rushnan', 'sgu20131479', 'nareshkumarhari', 'baagii_homie', 'sgu201311413', 'gianca', 'anudari', 'aniruddharay93', 'reatoeros', 'eversor', 'tsfisher', 'ujash', 'gunsnroses.0219', 'yumnafmoussa']",5,"['kaiyuanj', 'navid3952', 'yaxin1995', None, 'jordantthan']",21,"['jreed473', 'nareshkumarhari', 'anudari', 'navid3952', 'aalshehri', 'tsfisher', 'yaxin1995', 'ujash', 'eversor', None, 'yumnafmoussa', 'rushnan', 'sgu20131479', 'baagii_homie', 'sgu201311413', 'gianca', 'kaiyuanj', 'aniruddharay93', 'reatoeros', 'gunsnroses.0219', 'jordantthan']"
52,226,17,7,1,['baagii_homie'],15,"['rushnan', 'jreed473', 'sgu20131479', 'nareshkumarhari', 'sgu201311413', 'gianca', 'anudari', 'aniruddharay93', 'reatoeros', 'eversor', 'aalshehri', 'tsfisher', 'ujash', 'gunsnroses.0219', 'yumnafmoussa']",6,"['banzragch', 'seiko_anarjin', 'ulaankhuu72', 'bil_marbel', 'choijamts.choijoo', None]",22,"['jreed473', 'nareshkumarhari', 'anudari', 'aalshehri', 'tsfisher', 'ulaankhuu72', 'choijamts.choijoo', 'ujash', 'eversor', None, 'yumnafmoussa', 'rushnan', 'banzragch', 'sgu20131479', 'seiko_anarjin', 'baagii_homie', 'sgu201311413', 'gianca', 'aniruddharay93', 'reatoeros', 'bil_marbel', 'gunsnroses.0219']"
53,64,16,92,15,"['mayanair1104', 'chinmaygawas', 'tejalnaik12', 'poojanale1996', 'dheereshpoojary', 'pguleria', 'bnrnirmal94', 'nishumahapatro1995', 'smriti.sivadas96', 'naikpratiksha510', 'bpatel03', 'cristyjne8', 'mayureshnagvekar57', 'rnair10', 'deeptimenon']",0,[],77,"['abhaskar31', 'vinayakgadkari8', 'karar.bhadreshwara', 'keshvis26', 'akashborhade123', 'singhrajkarn1699', 'abhijitharidas3107', 'yashjivrajani7799', 'yuvraj.t', 'kkiran31', 'amolgolwankar', 'pratik007', 'prajoth.fernandes', 'shibssalian', 'kadampk15ex', 'shreyas.v', 'aadi', 'alwin1996', 'suhayl4k', 'gvishs15', 'sakshijoshi', 'kmamaniya', 'tejdhupkar', 'shubhamgharat274', 'rashmithanair5', 'ketan.db', 'pratik.gc', 'chinmaysj96', 'danieldsilva96', 'cmahale95', 'akarnik.13', 'aditya332', 'sumasalian96', 'inderjitsingh87', 'varunmullins', 'divya.shinde', 'temp999use', 'livz944', 'salianyatish111', 'jobin301', 'shrey.joshi', 'kumarkhandagle33', 'samsonkajar', 'kharadesonam', 'anjali.kalmase', 'apurva.nehru', 'ralph.rodrigues69', 'pranjal17', 'eshani2396', 'meet7', 'mkhanvilkar', 'dghosalkar', 'shally', 'varunndabhade', 'prajwal.angolkar4', 'pravingowda28', 'mayank.vp', 'npnishankpednekar', 'raj.vadariya', None, 'pjay10708', 'gsatpute64', 'krexianclass', 'css_', 'jonathanrjpereira', 'yashgosar9', 'moraeseric123', 'rubina15', 'adityagudla96', 'sukhpreet11234kldfhd', 'pratik2225', 'bharatesh.a', 'aniruddhaparte3', 'srevolution23', 'saniyasnair', 'ashpillai.1996', 'shrutis31']",92,"['tejalnaik12', 'abhaskar31', 'vinayakgadkari8', 'karar.bhadreshwara', 'keshvis26', 'akashborhade123', 'naikpratiksha510', 'singhrajkarn1699', 'abhijitharidas3107', 'yashjivrajani7799', 'yuvraj.t', 'kkiran31', 'amolgolwankar', 'pratik007', 'mayanair1104', 'prajoth.fernandes', 'shibssalian', 'kadampk15ex', 'smriti.sivadas96', 'shreyas.v', 'aadi', 'alwin1996', 'suhayl4k', 'gvishs15', 'pguleria', 'sakshijoshi', 'kmamaniya', 'tejdhupkar', 'shubhamgharat274', 'rashmithanair5', 'deeptimenon', 'ketan.db', 'pratik.gc', 'chinmaysj96', 'danieldsilva96', 'cmahale95', 'mayureshnagvekar57', 'akarnik.13', 'aditya332', 'sumasalian96', 'rnair10', 'inderjitsingh87', 'chinmaygawas', 'varunmullins', 'divya.shinde', 'temp999use', 'livz944', 'bpatel03', 'salianyatish111', 'jobin301', 'shrey.joshi', 'kumarkhandagle33', 'samsonkajar', 'kharadesonam', 'anjali.kalmase', 'apurva.nehru', 'ralph.rodrigues69', 'poojanale1996', 'pranjal17', 'eshani2396', 'meet7', 'mkhanvilkar', 'dghosalkar', 'shally', 'varunndabhade', 'prajwal.angolkar4', 'bnrnirmal94', 'pravingowda28', 'mayank.vp', 'npnishankpednekar', 'raj.vadariya', None, 'pjay10708', 'gsatpute64', 'krexianclass', 'css_', 'jonathanrjpereira', 'yashgosar9', 'moraeseric123', 'rubina15', 'dheereshpoojary', 'adityagudla96', 'sukhpreet11234kldfhd', 'nishumahapatro1995', 'pratik2225', 'bharatesh.a', 'cristyjne8', 'aniruddhaparte3', 'srevolution23', 'saniyasnair', 'ashpillai.1996', 'shrutis31']"
54,170,16,16,15,"['g1415069', 'g1515037', 'fnhsdgsdg', 'g1515060', 'g1515027', 'azazer.anime0524', 'g1515028', 'g1515018', 'g1515026k1215', 'g1515030', 'g1515093', 'g1515064', 'hiromu', 'g1515088', 'msu0503']",0,[],1,[None],16,"['g1515060', 'azazer.anime0524', 'g1515018', 'g1515030', 'g1515093', 'g1515064', None, 'g1415069', 'g1515037', 'fnhsdgsdg', 'g1515027', 'g1515028', 'g1515026k1215', 'hiromu', 'g1515088', 'msu0503']"
56,129,16,19,1,['malikarslan11'],14,"['yuling', 'admiral', 'roy48', 'pdumas91', 'sarawut_dota', 'mkhorton', 'mattwil', 'chaitali.gajankush99', 'jch3782', 'sidharth1994', 'jkrynen', 'jlf323', 'joe.margetis', 'tadasmalina']",18,"['sajadali001', 'mishaim', 'actec', 'nidayousuf25', 'ssd2017', 'namrahkhan', 'tzihra14', 'wardaishrat', 'sheharyarsamad', 'naihapervez', 'mahinhasan', 'mafazahsan', 'jamalamasil2612', 'mavarakamal', 'ayeshakhan.2907', 'abdurrehman', None, 'aroomah']",33,"['mishaim', 'nidayousuf25', 'admiral', 'sarawut_dota', 'namrahkhan', 'tzihra14', 'ayeshakhan.2907', 'mattwil', 'chaitali.gajankush99', 'wardaishrat', 'jkrynen', 'abdurrehman', 'jch3782', 'aroomah', 'sajadali001', 'actec', 'yuling', 'roy48', 'ssd2017', 'pdumas91', 'naihapervez', 'joe.margetis', None, 'mkhorton', 'sheharyarsamad', 'mahinhasan', 'mafazahsan', 'jamalamasil2612', 'mavarakamal', 'sidharth1994', 'jlf323', 'tadasmalina', 'malikarslan11']"
56,128,16,10,1,['malikarslan11'],14,"['yuling', 'admiral', 'roy48', 'pdumas91', 'sarawut_dota', 'mkhorton', 'mattwil', 'chaitali.gajankush99', 'jch3782', 'sidharth1994', 'jkrynen', 'jlf323', 'joe.margetis', 'tadasmalina']",9,"['naveedahmad0000000', 'ahmed.uzair14', 'greed', 'mhqqasmi', 'fakeha19', 'muhammadshernasir', 'hayder', 'shasadullah', None]",24,"['naveedahmad0000000', 'yuling', 'admiral', 'roy48', 'pdumas91', 'sarawut_dota', 'ahmed.uzair14', 'mhqqasmi', 'fakeha19', 'muhammadshernasir', 'joe.margetis', 'shasadullah', None, 'mkhorton', 'mattwil', 'chaitali.gajankush99', 'jch3782', 'greed', 'hayder', 'sidharth1994', 'jkrynen', 'jlf323', 'tadasmalina', 'malikarslan11']"
56,135,16,8,1,['sidharth1994'],14,"['yuling', 'admiral', 'roy48', 'pdumas91', 'sarawut_dota', 'mkhorton', 'mattwil', 'chaitali.gajankush99', 'jch3782', 'jkrynen', 'jlf323', 'joe.margetis', 'malikarslan11', 'tadasmalina']",7,"['priyankamuley315', None, 'ashish.gopal', 'palukuru.g', 'varunkurup2', 'saurabh.dakhore', 'nirmol882']",22,"['yuling', 'admiral', 'roy48', 'pdumas91', 'sarawut_dota', 'ashish.gopal', 'joe.margetis', 'saurabh.dakhore', None, 'priyankamuley315', 'mkhorton', 'mattwil', 'chaitali.gajankush99', 'jch3782', 'sidharth1994', 'palukuru.g', 'jkrynen', 'varunkurup2', 'jlf323', 'tadasmalina', 'malikarslan11', 'nirmol882']"
56,136,16,8,1,['chaitali.gajankush99'],14,"['yuling', 'admiral', 'roy48', 'pdumas91', 'sarawut_dota', 'mkhorton', 'mattwil', 'jch3782', 'sidharth1994', 'jkrynen', 'jlf323', 'joe.margetis', 'malikarslan11', 'tadasmalina']",7,"['swatibhandarkar96', 'priyankamuley315', None, 'ashish.gopal', 'aditigosavi14', 'tushar.dhatinge', 'saurabh.dakhore']",22,"['swatibhandarkar96', 'yuling', 'admiral', 'roy48', 'pdumas91', 'sarawut_dota', 'ashish.gopal', 'tushar.dhatinge', 'joe.margetis', 'saurabh.dakhore', None, 'priyankamuley315', 'mkhorton', 'mattwil', 'chaitali.gajankush99', 'jch3782', 'aditigosavi14', 'sidharth1994', 'jkrynen', 'jlf323', 'tadasmalina', 'malikarslan11']"
57,336,15,11,10,"['abbottd', 'kcieplenski19', 'mcgough', 'hennesc29', 'josephz9', 'xplorer1975', 'chakalw', 'scaglum', 'maymc', 'freemarm']",4,"['jeffh99j', 'carrolkr', 'adamkaarstad', 'scuce']",1,[None],15,"['chakalw', None, 'adamkaarstad', 'freemarm', 'abbottd', 'kcieplenski19', 'mcgough', 'hennesc29', 'josephz9', 'xplorer1975', 'jeffh99j', 'carrolkr', 'maymc', 'scaglum', 'scuce']"
57,337,15,7,6,"['abbottd', 'kcieplenski19', 'josephz9', 'chakalw', 'adamkaarstad', 'scuce']",8,"['mcgough', 'hennesc29', 'xplorer1975', 'jeffh99j', 'carrolkr', 'maymc', 'scaglum', 'freemarm']",1,[None],15,"['chakalw', None, 'adamkaarstad', 'freemarm', 'abbottd', 'kcieplenski19', 'mcgough', 'hennesc29', 'josephz9', 'xplorer1975', 'jeffh99j', 'carrolkr', 'maymc', 'scaglum', 'scuce']"
58,80,15,78,13,"['saurav.varaprasad', 'siddharth_goel', 'uditmaniyar', 'priyanka7', 'ramanudeepp', 'es16btech11011', 'ee16btech11028', 'es15btech11007', 'ee16btech11016', 'es16btech11002', 'es14btech11022', 'kmt6264', 'ee16btech11032']",1,['paulcamann'],65,"['bhavya12', 'es15btech11016', 'maniyarudit', 'rajeshwarchennam', 'sayzeeel', 'bharadwaj1997', 'ep15btech11005', 'vishnu_33', 'hydro123', 'srinidhibachu', 'karlapatirajapradyumna', 'pulapapavan25', 'deepkarma82', 'aravindganesh', 'ncsham', 'bhanutabeti', 'anandkadu4108', 'shanky98', 'saiashish', 'pramith', 'im2learning', 'pradeepmoturi', 'es16btech11001', 'samhitha', 're1nth', 'dj_16', 'es16btech11026', 'anushag', 'devnano', 'akramya98', 'es16btech11018', 'ee16btech11024', 'nakshatra', 'aravind03', 'tejas_p', 'emani', 'es16btech11007', 'rangesh', 'shardul', 'havish', 'ee16btech11012', 'es16btech11008', 'chakri1804', 'chait', 'vivek2699', 'snehith', 'sidmohla', 'khalidshaik', 'anuragshekhar', 'es16btech11003', 'ee16btech11013', 'preetham1998', 'ep14btech11003', 'jvinaykumar12', 'aamir_ee', 'vishwajith', 'ganna09', None, 'ep15btech11001', 'es15btech11010', 'ee16btech11042', 'karthikr98', 'sumanth', 'adithyahosapate', 'subhashchandra']",79,"['bhavya12', 'es15btech11016', 'maniyarudit', 'rajeshwarchennam', 'es16btech11011', 'sayzeeel', 'bharadwaj1997', 'ep15btech11005', 'vishnu_33', 'ramanudeepp', 'hydro123', 'srinidhibachu', 'karlapatirajapradyumna', 'pulapapavan25', 'deepkarma82', 'aravindganesh', 'ncsham', 'bhanutabeti', 'anandkadu4108', 'shanky98', 'ee16btech11016', 'saiashish', 'pramith', 'saurav.varaprasad', 'im2learning', 'pradeepmoturi', 'es16btech11001', 'samhitha', 're1nth', 'dj_16', 'es16btech11026', 'priyanka7', 'anushag', 'devnano', 'akramya98', 'es16btech11018', 'siddharth_goel', 'ee16btech11024', 'nakshatra', 'aravind03', 'tejas_p', 'emani', 'es16btech11007', 'uditmaniyar', 'rangesh', 'shardul', 'paulcamann', 'havish', 'ee16btech11012', 'es16btech11008', 'chakri1804', 'chait', 'vivek2699', 'snehith', 'sidmohla', 'khalidshaik', 'anuragshekhar', 'es16btech11003', 'ee16btech11013', 'preetham1998', 'ep14btech11003', 'jvinaykumar12', 'es15btech11007', 'aamir_ee', 'vishwajith', 'ganna09', 'es14btech11022', None, 'ep15btech11001', 'es15btech11010', 'ee16btech11042', 'karthikr98', 'sumanth', 'ee16btech11028', 'adithyahosapate', 'subhashchandra', 'es16btech11002', 'kmt6264', 'ee16btech11032']"
59,284,15,7,5,"['eva_gasser', 'sered92', 'hendle_c', 'schoea17', 'abuali_t']",9,"['ladens12', 'heshamshaker', 'sandrowieser', 'mipe', 'syedaamir342', 'arnoldma', 'ijlalhassan', 'jennifer.prohinig', 'ctschernay']",2,"['schanbacher.janne', None]",16,"['schanbacher.janne', 'sandrowieser', 'syedaamir342', 'ijlalhassan', None, 'ctschernay', 'abuali_t', 'ladens12', 'sered92', 'eva_gasser', 'heshamshaker', 'hendle_c', 'schoea17', 'mipe', 'arnoldma', 'jennifer.prohinig']"
59,285,15,7,2,"['ijlalhassan', 'syedaamir342']",12,"['ladens12', 'sered92', 'eva_gasser', 'heshamshaker', 'hendle_c', 'sandrowieser', 'schoea17', 'mipe', 'arnoldma', 'abuali_t', 'jennifer.prohinig', 'ctschernay']",5,"['hassan278', 'abubakrjaved93', 'reh.younas', 'mhqqasmi', None]",19,"['reh.younas', 'abubakrjaved93', 'sandrowieser', 'mhqqasmi', 'syedaamir342', 'ijlalhassan', None, 'ctschernay', 'abuali_t', 'ladens12', 'sered92', 'eva_gasser', 'hassan278', 'heshamshaker', 'hendle_c', 'schoea17', 'mipe', 'arnoldma', 'jennifer.prohinig']"
59,286,15,7,2,"['ijlalhassan', 'syedaamir342']",12,"['ladens12', 'sered92', 'eva_gasser', 'heshamshaker', 'hendle_c', 'sandrowieser', 'schoea17', 'mipe', 'arnoldma', 'abuali_t', 'jennifer.prohinig', 'ctschernay']",5,"['hassan278', 'abubakrjaved93', 'reh.younas', 'mhqqasmi', None]",19,"['reh.younas', 'abubakrjaved93', 'sandrowieser', 'mhqqasmi', 'syedaamir342', 'ijlalhassan', None, 'ctschernay', 'abuali_t', 'ladens12', 'sered92', 'eva_gasser', 'hassan278', 'heshamshaker', 'hendle_c', 'schoea17', 'mipe', 'arnoldma', 'jennifer.prohinig']"
59,287,15,7,2,"['ijlalhassan', 'syedaamir342']",12,"['ladens12', 'sered92', 'eva_gasser', 'heshamshaker', 'hendle_c', 'sandrowieser', 'schoea17', 'mipe', 'arnoldma', 'abuali_t', 'jennifer.prohinig', 'ctschernay']",5,"['hassan278', 'abubakrjaved93', 'reh.younas', 'mhqqasmi', None]",19,"['reh.younas', 'abubakrjaved93', 'sandrowieser', 'mhqqasmi', 'syedaamir342', 'ijlalhassan', None, 'ctschernay', 'abuali_t', 'ladens12', 'sered92', 'eva_gasser', 'hassan278', 'heshamshaker', 'hendle_c', 'schoea17', 'mipe', 'arnoldma', 'jennifer.prohinig']"
60,232,15,7,5,"['komkar', 'adityajain090993', 'harithakp123', 'pradeepbanda03', 'murtazatw']",9,"['selma_ashraf', 'syedalizeeshan123', 'agnes.feb', 'bilal.rajab', 'rodrigo22cesar', 'syedman786', 'kdwyer2', 'j45yin', 'kasparych']",2,"[None, 'anjanasm25']",16,"['adityajain090993', 'selma_ashraf', 'bilal.rajab', 'rodrigo22cesar', 'pradeepbanda03', 'j45yin', 'murtazatw', None, 'komkar', 'syedalizeeshan123', 'agnes.feb', 'harithakp123', 'anjanasm25', 'syedman786', 'kdwyer2', 'kasparych']"
60,234,15,7,1,['j45yin'],13,"['adityajain090993', 'selma_ashraf', 'komkar', 'syedalizeeshan123', 'agnes.feb', 'bilal.rajab', 'harithakp123', 'rodrigo22cesar', 'pradeepbanda03', 'syedman786', 'kdwyer2', 'kasparych', 'murtazatw']",6,"['charlie.m.home', 'mlbsmith', 'bmusclow', 'hexiaoliang0123', 'davidwscott9', None]",20,"['adityajain090993', 'selma_ashraf', 'bilal.rajab', 'rodrigo22cesar', 'pradeepbanda03', 'hexiaoliang0123', 'j45yin', 'murtazatw', None, 'komkar', 'syedalizeeshan123', 'agnes.feb', 'charlie.m.home', 'harithakp123', 'mlbsmith', 'syedman786', 'kdwyer2', 'bmusclow', 'davidwscott9', 'kasparych']"
60,231,15,6,4,"['adityajain090993', 'harithakp123', 'murtazatw', 'pradeepbanda03']",10,"['selma_ashraf', 'komkar', 'syedalizeeshan123', 'agnes.feb', 'bilal.rajab', 'rodrigo22cesar', 'syedman786', 'kdwyer2', 'j45yin', 'kasparych']",2,"[None, 'anjanasm25']",16,"['adityajain090993', 'selma_ashraf', 'bilal.rajab', 'rodrigo22cesar', 'pradeepbanda03', 'j45yin', 'murtazatw', None, 'komkar', 'syedalizeeshan123', 'agnes.feb', 'harithakp123', 'anjanasm25', 'syedman786', 'kdwyer2', 'kasparych']"
61,97,14,10,2,"['smatherl', 'yzhao138']",11,"['alexgomez7285', 'nicki.lette', 'andrewhill1', 'kitzingk', 'devpatram', 'awful99', 'aexarhos', 'sfeemste', 'kobatros', 'pjb5015', 'trevorspina']",8,"['ilivings2016', 'ahariha5', 'vkoka', 'nlcarbal', 'djriver4', 'nyiin1', 'aherschf', None]",21,"['ilivings2016', 'alexgomez7285', 'nicki.lette', 'kitzingk', 'andrewhill1', 'devpatram', 'aexarhos', 'sfeemste', 'kobatros', 'djriver4', 'smatherl', None, 'trevorspina', 'ahariha5', 'vkoka', 'awful99', 'yzhao138', 'nlcarbal', 'pjb5015', 'nyiin1', 'aherschf']"
61,98,14,9,7,"['nicki.lette', 'kitzingk', 'andrewhill1', 'awful99', 'aexarhos', 'kobatros', 'trevorspina']",6,"['alexgomez7285', 'devpatram', 'yzhao138', 'sfeemste', 'pjb5015', 'smatherl']",2,"['hawley7777777', None]",15,"['alexgomez7285', 'nicki.lette', 'kitzingk', 'andrewhill1', 'devpatram', 'aexarhos', 'sfeemste', 'kobatros', 'smatherl', None, 'trevorspina', 'hawley7777777', 'awful99', 'yzhao138', 'pjb5015']"
64,184,14,15,4,"['kotemyr46', 'zanin2014', 'petrovavo1996', 'katehbka']",9,"['eccentric_shuvo', 'ak36874', 'etutuc', 'hobodump', 'izacevan', 'ssst0320', 'alamp', 'hadi_nanostyle85', 'sarah.muschinske']",11,"['irinaya21', 'kamennaja', 'tupitsina', 'dashasokurenko', 'ryabinin_and2014', 'nikitaemelianov1988', 'budartem', 'baron477', None, 'serova.n2013', 'crowkd']",24,"['irinaya21', 'tupitsina', 'dashasokurenko', 'hobodump', 'katehbka', 'ryabinin_and2014', 'nikitaemelianov1988', 'ssst0320', 'alamp', 'baron477', 'kotemyr46', None, 'serova.n2013', 'zanin2014', 'kamennaja', 'eccentric_shuvo', 'ak36874', 'etutuc', 'izacevan', 'budartem', 'sarah.muschinske', 'hadi_nanostyle85', 'petrovavo1996', 'crowkd']"
64,181,14,12,4,"['ssst0320', 'sarah.muschinske', 'ak36874', 'alamp']",9,"['zanin2014', 'eccentric_shuvo', 'etutuc', 'hobodump', 'katehbka', 'izacevan', 'hadi_nanostyle85', 'kotemyr46', 'petrovavo1996']",8,"['zhangjk87', 'lkgood', 'chloe.z', 'alecskipper', 'rhroberts', 'wangyn95', None, 'rmital.1995']",21,"['zhangjk87', 'hobodump', 'chloe.z', 'katehbka', 'ssst0320', 'alamp', 'kotemyr46', 'wangyn95', None, 'rmital.1995', 'zanin2014', 'eccentric_shuvo', 'ak36874', 'lkgood', 'etutuc', 'izacevan', 'alecskipper', 'sarah.muschinske', 'hadi_nanostyle85', 'rhroberts', 'petrovavo1996']"
64,182,14,7,2,"['kotemyr46', 'petrovavo1996']",11,"['zanin2014', 'eccentric_shuvo', 'ak36874', 'etutuc', 'hobodump', 'katehbka', 'izacevan', 'ssst0320', 'alamp', 'hadi_nanostyle85', 'sarah.muschinske']",5,"['victorn96', 'tupitsina', 'especiaiiy', 'baron477', None]",18,"['victorn96', 'tupitsina', 'hobodump', 'katehbka', 'especiaiiy', 'ssst0320', 'alamp', 'baron477', 'kotemyr46', None, 'zanin2014', 'eccentric_shuvo', 'ak36874', 'etutuc', 'izacevan', 'sarah.muschinske', 'hadi_nanostyle85', 'petrovavo1996']"
65,100,14,22,13,"['djgraziano', 'jaysuchanun', 'renj1', 'aragom1', 'fredsteven12', 'jsdye2010', 'stryder.loveday', 'arteaga52', 'escoba3', 'chezkov', 'doniashlayan', 'jonathanmalta', 'verdum1']",0,[],9,"['sachinpn', 'miyajis', 'nanoeric', 'barreto2', 'gentryd2', 'damitree', 'vikasvjois', 'eeprofessor', None]",22,"['barreto2', 'stryder.loveday', 'arteaga52', 'jonathanmalta', 'chezkov', 'doniashlayan', 'sachinpn', 'djgraziano', 'nanoeric', 'vikasvjois', 'jsdye2010', 'damitree', 'escoba3', 'verdum1', None, 'miyajis', 'jaysuchanun', 'renj1', 'aragom1', 'gentryd2', 'fredsteven12', 'eeprofessor']"
65,3,14,21,13,"['djgraziano', 'jaysuchanun', 'renj1', 'aragom1', 'fredsteven12', 'jsdye2010', 'stryder.loveday', 'arteaga52', 'escoba3', 'chezkov', 'doniashlayan', 'jonathanmalta', 'verdum1']",0,[],8,"['sachinpn', 'miyajis', 'nanoeric', 'barreto2', 'gentryd2', 'damitree', 'vikasvjois', None]",21,"['barreto2', 'stryder.loveday', 'arteaga52', 'jonathanmalta', 'chezkov', 'doniashlayan', 'sachinpn', 'djgraziano', 'nanoeric', 'vikasvjois', 'jsdye2010', 'damitree', 'escoba3', 'verdum1', None, 'miyajis', 'jaysuchanun', 'renj1', 'aragom1', 'gentryd2', 'fredsteven12']"
65,201,14,19,13,"['djgraziano', 'jaysuchanun', 'renj1', 'aragom1', 'fredsteven12', 'jsdye2010', 'stryder.loveday', 'arteaga52', 'escoba3', 'chezkov', 'doniashlayan', 'jonathanmalta', 'verdum1']",0,[],6,"['sachinpn', 'miyajis', 'nanoeric', 'barreto2', 'gentryd2', None]",19,"['barreto2', 'stryder.loveday', 'arteaga52', 'jonathanmalta', 'chezkov', 'doniashlayan', 'sachinpn', 'djgraziano', 'nanoeric', 'jsdye2010', 'escoba3', 'verdum1', None, 'miyajis', 'jaysuchanun', 'renj1', 'aragom1', 'gentryd2', 'fredsteven12']"
65,200,14,7,3,"['chezkov', 'renj1', 'verdum1']",10,"['djgraziano', 'jaysuchanun', 'aragom1', 'fredsteven12', 'jsdye2010', 'stryder.loveday', 'arteaga52', 'escoba3', 'doniashlayan', 'jonathanmalta']",4,"['sachinpn', 'gentryd2', None, 'nanoeric']",17,"['stryder.loveday', 'arteaga52', 'escoba3', 'jonathanmalta', 'chezkov', 'doniashlayan', 'verdum1', None, 'sachinpn', 'djgraziano', 'jaysuchanun', 'nanoeric', 'renj1', 'aragom1', 'gentryd2', 'fredsteven12', 'jsdye2010']"
66,251,13,13,12,"['mithil.c', 'darshakr123', 'raj.hs', 'ameya.c', 'harjotsingh.d', 'avinash.andhale', 'd.desai', 'jijov', 'sudhanva', 'aliqyaan.s', 'rutujaz', 'harsh.bechara']",0,[],1,[None],13,"['harjotsingh.d', 'ameya.c', None, 'harsh.bechara', 'darshakr123', 'mithil.c', 'raj.hs', 'avinash.andhale', 'd.desai', 'jijov', 'sudhanva', 'aliqyaan.s', 'rutujaz']"
66,332,13,13,12,"['mithil.c', 'darshakr123', 'raj.hs', 'ameya.c', 'harjotsingh.d', 'avinash.andhale', 'd.desai', 'jijov', 'sudhanva', 'aliqyaan.s', 'rutujaz', 'harsh.bechara']",0,[],1,[None],13,"['harjotsingh.d', 'ameya.c', None, 'harsh.bechara', 'darshakr123', 'mithil.c', 'raj.hs', 'avinash.andhale', 'd.desai', 'jijov', 'sudhanva', 'aliqyaan.s', 'rutujaz']"
67,300,13,48,11,"['a.mesias10', 'cdaniel089', 'alejandro2655', 'ogabriel.cv99', 'jframos', 'aruiz6a', 'valentina.reyesmar4', 'salazarnelson', 'jonathanpinzon05', 'alejandract', 'mariaalejandraep']",1,['felipeescallon'],37,"['jufepas98', 'rdcajr', 'jenipinzon.ml', 'jesusvillamizar', 'raquelalejandra', 'erikananiela', 'yeju16', 'sa.sanchez', 'we.simancas10', 'andresfdt.2k8', 'jairovlacha', 'brayant', 'jdmedinatobon', 'ja.jimenez317', 'dadelapa321', 'sd.diaz', 'af.vera10', 'j.wilckenlecompte', 'fabser7', 'rf.ruiz10', 'andres9802', 'andrestrujillo098', 'juandavid97', 'lf.correa10', 'hectordavidpulido', 'jupalinar17', 'labiele2206', None, 'vserrano081821', 'te.vence10', 'isabella', 'jfgf11', 'diegobb', 'carlosdoblev', 'vanessamovilla', 'juan_camilo', 'eduardmolano']",49,"['cdaniel089', 'jufepas98', 'rdcajr', 'jenipinzon.ml', 'jesusvillamizar', 'raquelalejandra', 'erikananiela', 'yeju16', 'sa.sanchez', 'we.simancas10', 'a.mesias10', 'andresfdt.2k8', 'jairovlacha', 'brayant', 'jdmedinatobon', 'salazarnelson', 'jonathanpinzon05', 'ja.jimenez317', 'alejandro2655', 'dadelapa321', 'sd.diaz', 'af.vera10', 'j.wilckenlecompte', 'fabser7', 'ogabriel.cv99', 'rf.ruiz10', 'andres9802', 'andrestrujillo098', 'juandavid97', 'lf.correa10', 'hectordavidpulido', 'jupalinar17', 'labiele2206', None, 'alejandract', 'vserrano081821', 'te.vence10', 'isabella', 'jfgf11', 'felipeescallon', 'diegobb', 'jframos', 'aruiz6a', 'carlosdoblev', 'vanessamovilla', 'juan_camilo', 'eduardmolano', 'valentina.reyesmar4', 'mariaalejandraep']"
67,123,13,39,1,['jframos'],11,"['a.mesias10', 'cdaniel089', 'alejandro2655', 'ogabriel.cv99', 'felipeescallon', 'aruiz6a', 'valentina.reyesmar4', 'salazarnelson', 'jonathanpinzon05', 'alejandract', 'mariaalejandraep']",38,"['jufepas98', 'rdcajr', 'jenipinzon.ml', 'jesusvillamizar', 'raquelalejandra', 'erikananiela', 'sa.sanchez', 'we.simancas10', 'andresfdt.2k8', 'jairovlacha', 'brayant', 'jdmedinatobon', 'ja.jimenez317', 'dadelapa321', 'sd.diaz', 'af.vera10', 'j.wilckenlecompte', 'fabser7', 'sarabeja98', 'rf.ruiz10', 'andres9802', 'andrestrujillo098', 'juandavid97', 'lf.correa10', 'hectordavidpulido', 'jupalinar17', 'labiele2206', None, 'vserrano081821', 'te.vence10', 'isabella', 'jfgf11', 'diegobb', 'carlosdoblev', 'vanessamovilla', 'juan_camilo', 'eduardmolano', 'escalantemariaalejandra']",50,"['cdaniel089', 'jufepas98', 'rdcajr', 'jenipinzon.ml', 'jesusvillamizar', 'raquelalejandra', 'erikananiela', 'sa.sanchez', 'we.simancas10', 'a.mesias10', 'andresfdt.2k8', 'jairovlacha', 'brayant', 'jdmedinatobon', 'salazarnelson', 'jonathanpinzon05', 'ja.jimenez317', 'alejandro2655', 'dadelapa321', 'sd.diaz', 'af.vera10', 'j.wilckenlecompte', 'fabser7', 'ogabriel.cv99', 'sarabeja98', 'rf.ruiz10', 'andres9802', 'andrestrujillo098', 'juandavid97', 'lf.correa10', 'hectordavidpulido', 'jupalinar17', 'labiele2206', None, 'alejandract', 'vserrano081821', 'te.vence10', 'isabella', 'jfgf11', 'felipeescallon', 'diegobb', 'jframos', 'aruiz6a', 'carlosdoblev', 'vanessamovilla', 'juan_camilo', 'eduardmolano', 'escalantemariaalejandra', 'valentina.reyesmar4', 'mariaalejandraep']"
69,386,13,24,8,"['otretten', 'kjmirrie94', 'samoah', 'aaadarwish2021', 'atfullme', 'yuey', 'sedaigle', 'tjoweida']",4,"['somsarang1990', 'damenpurt', 'imtiaza20', 'eguerrero23']",16,"['mdmannin', 'jzhao25', None, 'tsrane', 'ajhenri3', 'ksalem', 'jaconno2', 'hsaare', 'jaliu', 'llei2', 'hgz931030', 'syin4', 'ellee2', 'wamillik', 'swang59', 'tcheng7']",28,"['otretten', 'eguerrero23', 'aaadarwish2021', 'imtiaza20', 'atfullme', 'yuey', 'ellee2', 'swang59', 'tjoweida', 'mdmannin', 'ksalem', 'jaliu', 'hgz931030', 'somsarang1990', 'tsrane', 'ajhenri3', 'jaconno2', 'hsaare', 'llei2', 'syin4', 'jzhao25', 'tcheng7', None, 'damenpurt', 'samoah', 'kjmirrie94', 'sedaigle', 'wamillik']"
69,156,13,21,7,"['otretten', 'kjmirrie94', 'samoah', 'aaadarwish2021', 'yuey', 'sedaigle', 'tjoweida']",5,"['somsarang1990', 'damenpurt', 'eguerrero23', 'imtiaza20', 'atfullme']",14,"['jzhao25', None, 'tsrane', 'ajhenri3', 'hsaare', 'jaliu', 'llei2', 'alexanderfullmer', 'hgz931030', 'syin4', 'ellee2', 'wamillik', 'swang59', 'tcheng7']",26,"['otretten', 'eguerrero23', 'aaadarwish2021', 'imtiaza20', 'atfullme', 'yuey', 'ellee2', 'swang59', 'tjoweida', 'jaliu', 'hgz931030', 'somsarang1990', 'tsrane', 'ajhenri3', 'hsaare', 'llei2', 'alexanderfullmer', 'syin4', 'jzhao25', 'tcheng7', None, 'damenpurt', 'samoah', 'kjmirrie94', 'sedaigle', 'wamillik']"
69,102,13,18,8,"['otretten', 'kjmirrie94', 'samoah', 'aaadarwish2021', 'atfullme', 'yuey', 'sedaigle', 'tjoweida']",4,"['somsarang1990', 'damenpurt', 'imtiaza20', 'eguerrero23']",10,"['mdmannin', 'tsrane', 'ksalem', 'hsaare', 'jaliu', 'llei2', 'syin4', 'ellee2', 'wamillik', None]",22,"['somsarang1990', 'otretten', 'eguerrero23', 'aaadarwish2021', 'tsrane', 'imtiaza20', 'atfullme', 'hsaare', 'yuey', 'llei2', 'syin4', 'ellee2', None, 'tjoweida', 'mdmannin', 'damenpurt', 'samoah', 'kjmirrie94', 'ksalem', 'sedaigle', 'jaliu', 'wamillik']"
69,384,13,7,1,['otretten'],11,"['somsarang1990', 'damenpurt', 'samoah', 'kjmirrie94', 'eguerrero23', 'aaadarwish2021', 'imtiaza20', 'atfullme', 'yuey', 'sedaigle', 'tjoweida']",6,"['swang59', 'tsrane', 'hsaare', 'llei2', 'ellee2', None]",18,"['somsarang1990', 'otretten', 'eguerrero23', 'aaadarwish2021', 'tsrane', 'imtiaza20', 'atfullme', 'hsaare', 'yuey', 'llei2', 'ellee2', None, 'swang59', 'tjoweida', 'damenpurt', 'samoah', 'kjmirrie94', 'sedaigle']"
69,385,13,7,4,"['somsarang1990', 'damenpurt', 'imtiaza20', 'eguerrero23']",8,"['otretten', 'kjmirrie94', 'samoah', 'aaadarwish2021', 'atfullme', 'yuey', 'sedaigle', 'tjoweida']",3,"[None, 'dstrubbe', 'kuntal123']",15,"['somsarang1990', 'otretten', 'eguerrero23', 'aaadarwish2021', 'imtiaza20', 'atfullme', 'dstrubbe', 'yuey', None, 'tjoweida', 'damenpurt', 'samoah', 'kjmirrie94', 'sedaigle', 'kuntal123']"
69,389,13,6,4,"['somsarang1990', 'damenpurt', 'imtiaza20', 'eguerrero23']",8,"['otretten', 'kjmirrie94', 'samoah', 'aaadarwish2021', 'atfullme', 'yuey', 'sedaigle', 'tjoweida']",2,"[None, 'kuntal123']",14,"['somsarang1990', 'otretten', 'damenpurt', 'samoah', 'kjmirrie94', 'eguerrero23', 'aaadarwish2021', 'imtiaza20', 'atfullme', 'yuey', 'sedaigle', 'kuntal123', None, 'tjoweida']"
71,113,12,19,11,"['m.hussain', 'scogen', 'saraali11', 'aalmekaimi95', 'imadoo', 'jenan', 'far7oo95', 'loulwahalsanea', 'shahadalhamad', 'falmuhanna95', 'asayelalenazi']",0,[],8,"['omarqsm', 'mohd_qassem_94', 'adeltube', 'shahadalenzi109', 'jenanaljnaa', 'mohamedbsam95', 'alvin.mfteng', None]",19,"['omarqsm', 'mohd_qassem_94', 'm.hussain', 'shahadalenzi109', 'adeltube', 'scogen', 'jenanaljnaa', 'imadoo', 'loulwahalsanea', 'far7oo95', 'shahadalhamad', None, 'falmuhanna95', 'asayelalenazi', 'saraali11', 'aalmekaimi95', 'mohamedbsam95', 'jenan', 'alvin.mfteng']"
71,112,12,12,8,"['scogen', 'aalmekaimi95', 'imadoo', 'jenan', 'far7oo95', 'loulwahalsanea', 'falmuhanna95', 'asayelalenazi']",3,"['saraali11', 'shahadalhamad', 'm.hussain']",4,"[None, 'alyaa1995_', 'saraabdurhaman', 'mohamedbsam95']",15,"['m.hussain', 'scogen', 'imadoo', 'loulwahalsanea', 'far7oo95', 'shahadalhamad', None, 'falmuhanna95', 'asayelalenazi', 'saraabdurhaman', 'saraali11', 'aalmekaimi95', 'alyaa1995_', 'mohamedbsam95', 'jenan']"
72,81,12,53,3,"['mltillman', 'zhipengdong2', 'jlim3538']",8,"['eschlenk', 'kiranskanda', 'theharshit', 'm_vesterager', 'praveen_saxena15', 'vsaraswat009', 'wmcheung', 'anibalpacheco']",50,"['malikrigg21', 'kevinkeller929', 'alexlleonart12', 'danieltola', 'nsessions', 'c.irene', 'ststrassle', 'alejandroarias', 'kurkutim', 'lancefox1191', 'frivasplata91', 'leoni95', 'perryjetter', 'ryanfake', 'concelmo', 'stevenb08', 'lemer1714', 'nhaydar', 'area', 'kaschmidt', 'latricereid', 'lchavous', 'danielfortiz94', 'salzmannra', 'gmoatts', 'fferrales', 'johntlee59', 'lwoodahl', 'davin', 'evanbishop', 'djordje.gluhovic', 'franky43', 'jldurso13', 'ssoto65', 'aw1195', None, 'wreuangrith13', 'thomas.e.mac1', 'kamalnasif', 'afranklin2016', 'juanz96', 'feng773', 'etanberg', 'jlahman', 'anacovic', 'luisvf', 'pauljkania', 'eshortman5892', 'kgriffey95', 'jhaydenmashburn']",61,"['danieltola', 'ststrassle', 'alejandroarias', 'kurkutim', 'lancefox1191', 'frivasplata91', 'ryanfake', 'perryjetter', 'jlim3538', 'stevenb08', 'theharshit', 'lemer1714', 'kaschmidt', 'salzmannra', 'johntlee59', 'jldurso13', 'ssoto65', 'aw1195', 'eschlenk', 'kamalnasif', 'etanberg', 'jlahman', 'praveen_saxena15', 'luisvf', 'pauljkania', 'eshortman5892', 'kgriffey95', 'jhaydenmashburn', 'malikrigg21', 'kevinkeller929', 'alexlleonart12', 'nsessions', 'c.irene', 'leoni95', 'mltillman', 'concelmo', 'nhaydar', 'area', 'wmcheung', 'latricereid', 'lchavous', 'danielfortiz94', 'kiranskanda', 'gmoatts', 'fferrales', 'lwoodahl', 'davin', 'evanbishop', 'djordje.gluhovic', 'franky43', None, 'wreuangrith13', 'thomas.e.mac1', 'zhipengdong2', 'afranklin2016', 'juanz96', 'feng773', 'm_vesterager', 'anacovic', 'vsaraswat009', 'anibalpacheco']"
72,328,12,50,2,"['jlim3538', 'zhipengdong2']",9,"['eschlenk', 'mltillman', 'kiranskanda', 'theharshit', 'm_vesterager', 'praveen_saxena15', 'vsaraswat009', 'wmcheung', 'anibalpacheco']",48,"['malikrigg21', 'kevinkeller929', 'alexlleonart12', 'danieltola', 'nsessions', 'c.irene', 'ststrassle', 'alejandroarias', 'kurkutim', 'lancefox1191', 'frivasplata91', 'leoni95', 'perryjetter', 'ryanfake', 'concelmo', 'stevenb08', 'lemer1714', 'nhaydar', 'area', 'kaschmidt', 'latricereid', 'lchavous', 'danielfortiz94', 'salzmannra', 'gmoatts', 'fferrales', 'johntlee59', 'lwoodahl', 'davin', 'evanbishop', 'djordje.gluhovic', 'franky43', 'jldurso13', 'ssoto65', 'aw1195', None, 'wreuangrith13', 'kamalnasif', 'afranklin2016', 'juanz96', 'feng773', 'etanberg', 'anacovic', 'luisvf', 'pauljkania', 'eshortman5892', 'kgriffey95', 'jhaydenmashburn']",59,"['malikrigg21', 'kevinkeller929', 'alexlleonart12', 'danieltola', 'nsessions', 'c.irene', 'ststrassle', 'alejandroarias', 'kurkutim', 'lancefox1191', 'frivasplata91', 'leoni95', 'perryjetter', 'mltillman', 'jlim3538', 'ryanfake', 'concelmo', 'stevenb08', 'theharshit', 'lemer1714', 'nhaydar', 'area', 'kaschmidt', 'wmcheung', 'latricereid', 'lchavous', 'danielfortiz94', 'kiranskanda', 'salzmannra', 'gmoatts', 'fferrales', 'johntlee59', 'lwoodahl', 'davin', 'evanbishop', 'djordje.gluhovic', 'franky43', 'jldurso13', 'ssoto65', 'aw1195', None, 'wreuangrith13', 'eschlenk', 'zhipengdong2', 'kamalnasif', 'afranklin2016', 'juanz96', 'feng773', 'etanberg', 'm_vesterager', 'praveen_saxena15', 'anacovic', 'luisvf', 'vsaraswat009', 'pauljkania', 'eshortman5892', 'anibalpacheco', 'kgriffey95', 'jhaydenmashburn']"
75,352,12,20,5,"['navat1210', 'fuangsuda199817', 'yeennao2011', 'khomsak', 'patcharapruek']",6,"['mikecerdan', 'lpk29402', 'abhinavmaxim', 'hyungwon97', 'misterbransito96', 'blissm95']",15,"['aim_wb', 'wsasima', 'tewan', 'aschara_aum', 'cream160341', 'pui_yaak1996', 'panpilin443651', 'jirawat0441', 'me4335713', 'jintanaree', 'khomphet66', 'paritmrj', 'pwangse', None, 'team5024']",26,"['navat1210', 'aim_wb', 'wsasima', 'abhinavmaxim', 'pui_yaak1996', 'panpilin443651', 'jirawat0441', 'khomphet66', 'paritmrj', 'pwangse', None, 'team5024', 'fuangsuda199817', 'mikecerdan', 'lpk29402', 'tewan', 'aschara_aum', 'cream160341', 'yeennao2011', 'hyungwon97', 'khomsak', 'misterbransito96', 'me4335713', 'jintanaree', 'patcharapruek', 'blissm95']"
75,355,12,7,2,"['fuangsuda199817', 'lpk29402']",9,"['navat1210', 'mikecerdan', 'abhinavmaxim', 'yeennao2011', 'hyungwon97', 'khomsak', 'misterbransito96', 'patcharapruek', 'blissm95']",5,"['wsasima', 'kewalingale22', 'surampha.s', None, 'chaiyakrit']",16,"['navat1210', 'fuangsuda199817', 'wsasima', 'mikecerdan', 'lpk29402', 'abhinavmaxim', 'kewalingale22', 'yeennao2011', 'hyungwon97', 'khomsak', 'misterbransito96', 'surampha.s', 'patcharapruek', 'blissm95', None, 'chaiyakrit']"
78,64,12,92,1,['akarnik.13'],10,"['acrokw0502', 'semmz105', 'doqnqo', 'gunhoo777', 'panchalparth417', 'hwi', 'jung0hunkr', 'scribble9440', 'empire312', 'guheak92']",91,"['tejalnaik12', 'abhaskar31', 'vinayakgadkari8', 'karar.bhadreshwara', 'keshvis26', 'akashborhade123', 'naikpratiksha510', 'singhrajkarn1699', 'abhijitharidas3107', 'yashjivrajani7799', 'yuvraj.t', 'kkiran31', 'amolgolwankar', 'pratik007', 'mayanair1104', 'prajoth.fernandes', 'shibssalian', 'kadampk15ex', 'shreyas.v', 'smriti.sivadas96', 'aadi', 'alwin1996', 'suhayl4k', 'gvishs15', 'pguleria', 'sakshijoshi', 'kmamaniya', 'tejdhupkar', 'shubhamgharat274', 'rashmithanair5', 'deeptimenon', 'ketan.db', 'pratik.gc', 'chinmaysj96', 'danieldsilva96', 'cmahale95', 'mayureshnagvekar57', 'aditya332', 'sumasalian96', 'inderjitsingh87', 'rnair10', 'chinmaygawas', 'varunmullins', 'divya.shinde', 'temp999use', 'livz944', 'bpatel03', 'salianyatish111', 'jobin301', 'shrey.joshi', 'kumarkhandagle33', 'samsonkajar', 'kharadesonam', 'anjali.kalmase', 'apurva.nehru', 'ralph.rodrigues69', 'poojanale1996', 'pranjal17', 'eshani2396', 'meet7', 'mkhanvilkar', 'dghosalkar', 'shally', 'varunndabhade', 'prajwal.angolkar4', 'pravingowda28', 'mayank.vp', 'bnrnirmal94', 'npnishankpednekar', 'raj.vadariya', None, 'pjay10708', 'gsatpute64', 'krexianclass', 'css_', 'jonathanrjpereira', 'yashgosar9', 'moraeseric123', 'rubina15', 'adityagudla96', 'dheereshpoojary', 'sukhpreet11234kldfhd', 'nishumahapatro1995', 'pratik2225', 'bharatesh.a', 'cristyjne8', 'aniruddhaparte3', 'srevolution23', 'saniyasnair', 'ashpillai.1996', 'shrutis31']",102,"['tejalnaik12', 'abhaskar31', 'vinayakgadkari8', 'karar.bhadreshwara', 'keshvis26', 'akashborhade123', 'hwi', 'naikpratiksha510', 'singhrajkarn1699', 'abhijitharidas3107', 'yashjivrajani7799', 'yuvraj.t', 'kkiran31', 'amolgolwankar', 'pratik007', 'mayanair1104', 'prajoth.fernandes', 'doqnqo', 'shibssalian', 'gunhoo777', 'kadampk15ex', 'shreyas.v', 'smriti.sivadas96', 'aadi', 'acrokw0502', 'semmz105', 'alwin1996', 'suhayl4k', 'gvishs15', 'pguleria', 'sakshijoshi', 'kmamaniya', 'tejdhupkar', 'shubhamgharat274', 'rashmithanair5', 'deeptimenon', 'ketan.db', 'pratik.gc', 'chinmaysj96', 'danieldsilva96', 'panchalparth417', 'cmahale95', 'akarnik.13', 'mayureshnagvekar57', 'jung0hunkr', 'aditya332', 'sumasalian96', 'inderjitsingh87', 'rnair10', 'chinmaygawas', 'varunmullins', 'divya.shinde', 'temp999use', 'livz944', 'bpatel03', 'salianyatish111', 'jobin301', 'scribble9440', 'shrey.joshi', 'kumarkhandagle33', 'samsonkajar', 'kharadesonam', 'anjali.kalmase', 'apurva.nehru', 'ralph.rodrigues69', 'poojanale1996', 'empire312', 'pranjal17', 'guheak92', 'eshani2396', 'meet7', 'mkhanvilkar', 'dghosalkar', 'shally', 'varunndabhade', 'prajwal.angolkar4', 'pravingowda28', 'mayank.vp', 'bnrnirmal94', 'npnishankpednekar', 'raj.vadariya', None, 'pjay10708', 'gsatpute64', 'krexianclass', 'css_', 'jonathanrjpereira', 'yashgosar9', 'moraeseric123', 'rubina15', 'adityagudla96', 'dheereshpoojary', 'sukhpreet11234kldfhd', 'nishumahapatro1995', 'pratik2225', 'bharatesh.a', 'cristyjne8', 'aniruddhaparte3', 'srevolution23', 'saniyasnair', 'ashpillai.1996', 'shrutis31']"
78,69,12,44,1,['panchalparth417'],10,"['acrokw0502', 'semmz105', 'doqnqo', 'gunhoo777', 'hwi', 'akarnik.13', 'jung0hunkr', 'scribble9440', 'empire312', 'guheak92']",43,"['surbhib2897', 'techn720ab', 'rohitwaghmare1997', 'keshvis26', 'pinakin', 'rajeshreesawale', 'shrinishdonde', 'mananmehta95', 'neha0206', 'yashjivrajani7799', 'kumarkhandagle33', 'aagamshah999999999', 'sahil.sawant031996', 'vora.jai1', 'shreyasshah14', 'sheetalchaudhari2210', 'divyavkhandkar.me', 'tripathishivam342', 'pallavi.valunj', 'tanvishah2410', 'pooja9702.pm', 'tanvinj1', 'prerana', 'aditik2107', 'adityaprakash41', 'alwin1996', 'vidur888', 'mehulkharvi7', 'chaitalivartak07', 'raj.vadariya', 'manassardar4444122', 'vandortshakti', None, 'ketan.db', 'rohitw0606', 'k25', 'rubina15', 'aniruddhaparte3', 'niveshvaze', 'boy_with_nikon', 'ankitpandey1296', 'devashishmore478', 'meghana.loke02']",54,"['surbhib2897', 'techn720ab', 'rohitwaghmare1997', 'keshvis26', 'hwi', 'pinakin', 'rajeshreesawale', 'shrinishdonde', 'mananmehta95', 'scribble9440', 'neha0206', 'yashjivrajani7799', 'kumarkhandagle33', 'aagamshah999999999', 'sahil.sawant031996', 'vora.jai1', 'doqnqo', 'gunhoo777', 'shreyasshah14', 'sheetalchaudhari2210', 'divyavkhandkar.me', 'tripathishivam342', 'pallavi.valunj', 'empire312', 'guheak92', 'tanvishah2410', 'pooja9702.pm', 'tanvinj1', 'prerana', 'acrokw0502', 'aditik2107', 'adityaprakash41', 'semmz105', 'alwin1996', 'vidur888', 'mehulkharvi7', 'chaitalivartak07', 'raj.vadariya', 'manassardar4444122', 'vandortshakti', 'devashishmore478', None, 'ketan.db', 'rohitw0606', 'k25', 'rubina15', 'panchalparth417', 'akarnik.13', 'aniruddhaparte3', 'niveshvaze', 'jung0hunkr', 'boy_with_nikon', 'ankitpandey1296', 'meghana.loke02']"
78,65,12,19,9,"['acrokw0502', 'semmz105', 'doqnqo', 'gunhoo777', 'hwi', 'jung0hunkr', 'scribble9440', 'empire312', 'guheak92']",2,"['akarnik.13', 'panchalparth417']",10,"['minki051613', 'jyh', 'k910716kim', 'jung0hun', 'shnie29', 'mvert157', 'ddangshiggy', 'gordius92', 'poby', None]",21,"['jyh', 'acrokw0502', 'semmz105', 'hwi', 'gordius92', 'scribble9440', None, 'minki051613', 'k910716kim', 'jung0hun', 'shnie29', 'doqnqo', 'mvert157', 'gunhoo777', 'panchalparth417', 'ddangshiggy', 'akarnik.13', 'poby', 'jung0hunkr', 'empire312', 'guheak92']"
78,75,12,15,2,"['akarnik.13', 'panchalparth417']",9,"['acrokw0502', 'semmz105', 'doqnqo', 'gunhoo777', 'hwi', 'jung0hunkr', 'scribble9440', 'empire312', 'guheak92']",13,"['jamespatil1996', 'amolgolwankar', 'pranavp1311', 'kharadesonam', 'alwin1996', 'tusharkumar', 'vidur888', 'shrivastavsomesh', 'tripathishivam342', 'srevolution23', 'abhijitharidas3107', None, 'pooja9702.pm']",24,"['acrokw0502', 'semmz105', 'alwin1996', 'tusharkumar', 'vidur888', 'shrivastavsomesh', 'hwi', 'scribble9440', 'abhijitharidas3107', None, 'jamespatil1996', 'amolgolwankar', 'pranavp1311', 'kharadesonam', 'doqnqo', 'gunhoo777', 'panchalparth417', 'akarnik.13', 'tripathishivam342', 'srevolution23', 'jung0hunkr', 'empire312', 'guheak92', 'pooja9702.pm']"
78,74,12,14,8,"['acrokw0502', 'semmz105', 'doqnqo', 'gunhoo777', 'hwi', 'scribble9440', 'empire312', 'guheak92']",3,"['akarnik.13', 'panchalparth417', 'jung0hunkr']",6,"['minki051613', 'jyh', 'shnie29', 'mvert157', 'gordius92', None]",17,"['jyh', 'acrokw0502', 'semmz105', 'hwi', 'gordius92', 'scribble9440', None, 'minki051613', 'shnie29', 'doqnqo', 'mvert157', 'gunhoo777', 'panchalparth417', 'akarnik.13', 'jung0hunkr', 'empire312', 'guheak92']"
78,78,12,11,7,"['acrokw0502', 'semmz105', 'gunhoo777', 'hwi', 'scribble9440', 'empire312', 'guheak92']",4,"['doqnqo', 'akarnik.13', 'panchalparth417', 'jung0hunkr']",4,"['honnyou', 'jyh', None, 'mvert157']",15,"['honnyou', 'jyh', 'acrokw0502', 'semmz105', 'hwi', 'scribble9440', None, 'doqnqo', 'mvert157', 'gunhoo777', 'panchalparth417', 'akarnik.13', 'jung0hunkr', 'empire312', 'guheak92']"
78,79,12,10,7,"['acrokw0502', 'semmz105', 'gunhoo777', 'hwi', 'jung0hunkr', 'scribble9440', 'empire312']",4,"['doqnqo', 'akarnik.13', 'guheak92', 'panchalparth417']",3,"['honnyou', 'mvert157', None]",14,"['honnyou', 'acrokw0502', 'semmz105', 'hwi', 'scribble9440', None, 'doqnqo', 'mvert157', 'gunhoo777', 'panchalparth417', 'akarnik.13', 'jung0hunkr', 'empire312', 'guheak92']"
78,76,12,9,7,"['semmz105', 'doqnqo', 'gunhoo777', 'jung0hunkr', 'scribble9440', 'empire312', 'guheak92']",4,"['hwi', 'acrokw0502', 'panchalparth417', 'akarnik.13']",2,"['mvert157', None]",13,"['acrokw0502', 'semmz105', 'hwi', 'scribble9440', None, 'doqnqo', 'mvert157', 'gunhoo777', 'panchalparth417', 'akarnik.13', 'jung0hunkr', 'empire312', 'guheak92']"
78,77,12,6,1,['akarnik.13'],10,"['acrokw0502', 'semmz105', 'doqnqo', 'gunhoo777', 'panchalparth417', 'hwi', 'jung0hunkr', 'scribble9440', 'empire312', 'guheak92']",5,"['amolgolwankar', 'shrivastavsomesh', 'pratiksha', 'tripathishivam342', None]",16,"['amolgolwankar', 'acrokw0502', None, 'semmz105', 'doqnqo', 'gunhoo777', 'panchalparth417', 'shrivastavsomesh', 'hwi', 'pratiksha', 'akarnik.13', 'tripathishivam342', 'jung0hunkr', 'scribble9440', 'empire312', 'guheak92']"
79,347,11,16,10,"['hunterisaac8', 'brennan', 'dvavrinak47', 'navigatornick', 'rawunder', 'anonymousllama', 'edbanks19', 'arpuente19', 'jrwhitaker15', 'paulschmitt8']",0,[],6,"['lysanny1', 'idsaleh18', 'connorbrooks500', 'lukedant', 'woodardju316', None]",16,"['hunterisaac8', 'dvavrinak47', 'lysanny1', 'idsaleh18', 'connorbrooks500', 'edbanks19', 'lukedant', 'woodardju316', None, 'paulschmitt8', 'brennan', 'navigatornick', 'rawunder', 'anonymousllama', 'arpuente19', 'jrwhitaker15']"
79,346,11,15,10,"['hunterisaac8', 'brennan', 'dvavrinak47', 'navigatornick', 'rawunder', 'anonymousllama', 'edbanks19', 'arpuente19', 'jrwhitaker15', 'paulschmitt8']",0,[],5,"['sergiosteven1', 'irfandarwish.saleh', 'a.puente102', 'connorbrooks5000', None]",15,"['hunterisaac8', 'dvavrinak47', 'sergiosteven1', 'edbanks19', 'a.puente102', None, 'paulschmitt8', 'brennan', 'navigatornick', 'rawunder', 'anonymousllama', 'irfandarwish.saleh', 'connorbrooks5000', 'arpuente19', 'jrwhitaker15']"
80,392,11,40,10,"['jonhuff', 'jennyfothergill', 'evansmith246', 'andreassavva', 'coreyefaw', 'danniemakar', 'saidarazaee', 'matthewgoelzer', 'drewlysne', 'shamidovic']",0,[],30,"['mikehurley', 'kaiisaacs1', 'haaldowailah', 'sierraludwig', 'karilivingston', 'soccor.ghuy', 'fadelalatiqy', 'mitchellleibowitz', 'akvryan', 'theomoodley', 'lanlibsu', 'matthouston', 'latifzamankhan', 'jamieadams2', 'zahraaalwazzan', 'thomasmonty', 'rick_326', 'raey69', 'danielcourtright', 'kelseymumford', None, 'bmw92', 'josephstellers924', 'conlanmarron', 'jihangaid', 'codylynde', 'jmd1', 'jimbuchanan', 'josephherker', 'saeed00001']",40,"['mikehurley', 'jonhuff', 'kaiisaacs1', 'haaldowailah', 'evansmith246', 'sierraludwig', 'karilivingston', 'coreyefaw', 'soccor.ghuy', 'matthewgoelzer', 'fadelalatiqy', 'mitchellleibowitz', 'jennyfothergill', 'akvryan', 'theomoodley', 'lanlibsu', 'saidarazaee', 'matthouston', 'latifzamankhan', 'drewlysne', 'jamieadams2', 'shamidovic', 'zahraaalwazzan', 'thomasmonty', 'andreassavva', 'rick_326', 'raey69', 'danielcourtright', 'kelseymumford', None, 'bmw92', 'josephstellers924', 'conlanmarron', 'danniemakar', 'jihangaid', 'codylynde', 'jmd1', 'jimbuchanan', 'josephherker', 'saeed00001']"
80,402,11,11,10,"['jonhuff', 'jennyfothergill', 'evansmith246', 'andreassavva', 'coreyefaw', 'danniemakar', 'saidarazaee', 'matthewgoelzer', 'drewlysne', 'shamidovic']",0,[],1,[None],11,"['jonhuff', 'evansmith246', 'andreassavva', 'coreyefaw', 'matthewgoelzer', None, 'jennyfothergill', 'danniemakar', 'saidarazaee', 'drewlysne', 'shamidovic']"
81,104,11,41,9,"['vaibhavg007.vg', 'swarupshende8055', 'chougulesourabh620', 'sharonsebastian333', 'khotatul94', 'pallavijagdale22', 'pruthvirajpatil191', 'pratikshasakhare', 'paurnimadesaichinu']",1,['myrroncaguila'],32,"['desaidhanashri32', 'akashvadrale', 'disha7', 'cpatil7896', 'nandrerutuja', 'vivekpatil1964', 'abhijeetbiradar097', 'vrushali29sd', 'madhura7deshpande', 'amu72', 'vrushaligaikwad5496', 'magdumpriya18', 'shalmalirburse29', 'pranotikumbhar1411', 'shubhammagdum6002', 'somnath1995', 'darshanahavaldar7', 'pranavj1996', 'gajananpatil2513', 'pratikshachandane17197', 'gayatrimore2697', 'swapnilpatil8072', 'siddheshwagh007', 'vishalv8082', 'vvpowar1996', 'amarjakatware96', 'komalpatil1323', 'rutujabhiungade177', None, 'shraddhabodakepatil', 'dvd123jnv', 'maheshchougale7072']",42,"['desaidhanashri32', 'akashvadrale', 'disha7', 'chougulesourabh620', 'cpatil7896', 'nandrerutuja', 'pratikshasakhare', 'vivekpatil1964', 'abhijeetbiradar097', 'vrushali29sd', 'madhura7deshpande', 'myrroncaguila', 'amu72', 'vaibhavg007.vg', 'vrushaligaikwad5496', 'magdumpriya18', 'sharonsebastian333', 'shalmalirburse29', 'pranotikumbhar1411', 'shubhammagdum6002', 'somnath1995', 'darshanahavaldar7', 'pranavj1996', 'gajananpatil2513', 'pratikshachandane17197', 'gayatrimore2697', 'swapnilpatil8072', 'siddheshwagh007', 'vishalv8082', 'khotatul94', 'vvpowar1996', 'pruthvirajpatil191', 'amarjakatware96', 'komalpatil1323', 'rutujabhiungade177', None, 'shraddhabodakepatil', 'dvd123jnv', 'swarupshende8055', 'pallavijagdale22', 'maheshchougale7072', 'paurnimadesaichinu']"
82,107,11,26,3,"['ngel1914', 'tdunlop', 'noahdebrincat']",7,"['dwkeene80', 'mamadouece', 'mjshea2', 'ljkersha', 'shuvobuet13', 'hemanthkumarsouram', 'm.faruk']",23,"['aly.hassan9', 'matthewmartz', 's2dhamij', 'jajung89', 'jachiang', 'make_it_true42', 'jdchan', 'dh2lam', 'nelsawah', 'qihao', 'adamw1995', 'almutairi', 'joshuaawicks', 'g2joe', 'k2muruga', None, 'millsrlm', 'adam.r.tetreault', 'kvslaughter', 'mlbsmith', 't_coathup', 'dbekah22', 'akshayaag']",33,"['aly.hassan9', 'mamadouece', 'matthewmartz', 's2dhamij', 'jajung89', 'hemanthkumarsouram', 'dwkeene80', 'jachiang', 'make_it_true42', 'jdchan', 'dh2lam', 'nelsawah', 'qihao', 'adamw1995', 'almutairi', 'tdunlop', 'noahdebrincat', 'ljkersha', 'joshuaawicks', 'shuvobuet13', 'g2joe', 'k2muruga', None, 'millsrlm', 'm.faruk', 'adam.r.tetreault', 'ngel1914', 'kvslaughter', 'mjshea2', 'mlbsmith', 't_coathup', 'dbekah22', 'akshayaag']"
82,106,11,6,3,"['dwkeene80', 'm.faruk', 'mamadouece']",7,"['ngel1914', 'mjshea2', 'tdunlop', 'noahdebrincat', 'ljkersha', 'shuvobuet13', 'hemanthkumarsouram']",3,"[None, 'normanjwayne', 'jasane2000']",13,"['ngel1914', 'normanjwayne', 'dwkeene80', None, 'mamadouece', 'mjshea2', 'tdunlop', 'noahdebrincat', 'ljkersha', 'shuvobuet13', 'hemanthkumarsouram', 'm.faruk', 'jasane2000']"
83,211,11,12,8,"['nklobucar', 'luka18.mikoc', 'prusinakatarina', 'fizisizisist', 'mpejinov', 'yashamon', 'denny.shaikh', 'dominik111']",2,"['krozman93', 'jajtict']",4,"['matijapiskacimp', 'ivanjkv', None, 'dora.vnucec']",14,"['nklobucar', 'matijapiskacimp', 'luka18.mikoc', 'prusinakatarina', 'jajtict', 'mpejinov', 'yashamon', 'krozman93', None, 'dominik111', 'dora.vnucec', 'fizisizisist', 'ivanjkv', 'denny.shaikh']"
83,44,11,11,8,"['nklobucar', 'luka18.mikoc', 'fizisizisist', 'jajtict', 'mpejinov', 'yashamon', 'denny.shaikh', 'dominik111']",2,"['prusinakatarina', 'krozman93']",3,"['matijapiskacimp', 'ivanjkv', None]",13,"['nklobucar', 'matijapiskacimp', 'luka18.mikoc', 'prusinakatarina', 'jajtict', 'mpejinov', 'yashamon', 'krozman93', None, 'dominik111', 'fizisizisist', 'ivanjkv', 'denny.shaikh']"
83,210,11,11,9,"['nklobucar', 'luka18.mikoc', 'prusinakatarina', 'jajtict', 'mpejinov', 'yashamon', 'krozman93', 'denny.shaikh', 'dominik111']",1,['fizisizisist'],2,"['matijapiskacimp', None]",12,"['nklobucar', 'matijapiskacimp', 'luka18.mikoc', 'prusinakatarina', 'jajtict', 'mpejinov', 'yashamon', 'krozman93', None, 'dominik111', 'fizisizisist', 'denny.shaikh']"
83,393,11,11,8,"['nklobucar', 'luka18.mikoc', 'fizisizisist', 'jajtict', 'mpejinov', 'yashamon', 'denny.shaikh', 'dominik111']",2,"['prusinakatarina', 'krozman93']",3,"['matijapiskacimp', 'ivanjkv', None]",13,"['nklobucar', 'matijapiskacimp', 'luka18.mikoc', 'prusinakatarina', 'jajtict', 'mpejinov', 'yashamon', 'krozman93', None, 'dominik111', 'fizisizisist', 'ivanjkv', 'denny.shaikh']"
83,43,11,10,8,"['nklobucar', 'luka18.mikoc', 'prusinakatarina', 'fizisizisist', 'jajtict', 'yashamon', 'krozman93', 'dominik111']",2,"['denny.shaikh', 'mpejinov']",2,"['chemprescigla', None]",12,"['nklobucar', 'luka18.mikoc', 'prusinakatarina', 'jajtict', 'mpejinov', 'yashamon', 'krozman93', None, 'dominik111', 'fizisizisist', 'chemprescigla', 'denny.shaikh']"
83,134,11,10,7,"['luka18.mikoc', 'prusinakatarina', 'fizisizisist', 'jajtict', 'yashamon', 'krozman93', 'denny.shaikh']",3,"['nklobucar', 'dominik111', 'mpejinov']",3,"['btomrlin', 'ivanjkv', None]",13,"['nklobucar', 'luka18.mikoc', 'prusinakatarina', 'jajtict', 'mpejinov', 'yashamon', 'krozman93', 'btomrlin', None, 'dominik111', 'fizisizisist', 'ivanjkv', 'denny.shaikh']"
83,212,11,10,7,"['nklobucar', 'luka18.mikoc', 'jajtict', 'mpejinov', 'yashamon', 'krozman93', 'denny.shaikh']",3,"['dominik111', 'prusinakatarina', 'fizisizisist']",3,"['matijapiskacimp', None, 'dora.vnucec']",13,"['nklobucar', 'matijapiskacimp', 'luka18.mikoc', 'prusinakatarina', 'jajtict', 'mpejinov', 'yashamon', 'krozman93', None, 'dominik111', 'dora.vnucec', 'fizisizisist', 'denny.shaikh']"
83,374,11,9,6,"['luka18.mikoc', 'prusinakatarina', 'fizisizisist', 'jajtict', 'yashamon', 'denny.shaikh']",4,"['nklobucar', 'krozman93', 'dominik111', 'mpejinov']",3,"['btomrlin', 'ivanjkv', None]",13,"['nklobucar', 'luka18.mikoc', 'prusinakatarina', 'jajtict', 'mpejinov', 'yashamon', 'krozman93', 'btomrlin', None, 'dominik111', 'fizisizisist', 'ivanjkv', 'denny.shaikh']"
83,390,11,7,6,"['nklobucar', 'luka18.mikoc', 'jajtict', 'yashamon', 'krozman93', 'denny.shaikh']",4,"['dominik111', 'prusinakatarina', 'fizisizisist', 'mpejinov']",1,[None],11,"['nklobucar', 'luka18.mikoc', 'prusinakatarina', 'jajtict', 'mpejinov', 'fizisizisist', 'yashamon', 'krozman93', 'denny.shaikh', None, 'dominik111']"
84,360,10,14,9,"['tebby0929', 'keniya.amish', 'arjunsoni56', 'shubhamsingh7875', 'msd_07', 'prachichoudhari78', 'kolhatkarchinmay96', 'nikkz', 'dhruvin007']",0,[],5,"['dhanesh2197', 'imafoodie9', 'apurvapatil777', 'pharsh800', None]",14,"['dhanesh2197', 'imafoodie9', 'pharsh800', 'prachichoudhari78', None, 'nikkz', 'keniya.amish', 'tebby0929', 'arjunsoni56', 'shubhamsingh7875', 'msd_07', 'apurvapatil777', 'kolhatkarchinmay96', 'dhruvin007']"
85,302,10,10,5,"['breannbirch', 'lukemccormick09', 'x3bood', 'joshsykes', 'alisonleighoakes']",4,"['allymcminn98', 'yewu', 'malikasmith1', 'tanj83']",5,"['batteryacidjuice', 'johnboy3312', None, 'siu853102587', 'austin']",14,"['tanj83', 'allymcminn98', 'yewu', 'joshsykes', None, 'siu853102587', 'batteryacidjuice', 'breannbirch', 'lukemccormick09', 'x3bood', 'johnboy3312', 'malikasmith1', 'alisonleighoakes', 'austin']"
85,252,10,9,5,"['tanj83', 'allymcminn98', 'yewu', 'malikasmith1', 'alisonleighoakes']",4,"['breannbirch', 'lukemccormick09', 'joshsykes', 'x3bood']",4,"['czabdullah', None, 'siu851483691', 'nickwgnr1']",13,"['tanj83', 'nickwgnr1', 'breannbirch', 'lukemccormick09', 'siu851483691', 'x3bood', 'allymcminn98', 'czabdullah', 'yewu', 'malikasmith1', 'joshsykes', 'alisonleighoakes', None]"
85,304,10,9,4,"['allymcminn98', 'malikasmith1', 'tanj83', 'x3bood']",5,"['breannbirch', 'lukemccormick09', 'yewu', 'joshsykes', 'alisonleighoakes']",5,"['batteryacidjuice', 'diddykong63', 'matthewrdempsey', None, 'nuitsman']",14,"['batteryacidjuice', 'tanj83', 'breannbirch', 'diddykong63', 'lukemccormick09', 'x3bood', 'allymcminn98', 'yewu', 'matthewrdempsey', 'malikasmith1', 'joshsykes', 'alisonleighoakes', None, 'nuitsman']"
85,253,10,8,4,"['breannbirch', 'lukemccormick09', 'joshsykes', 'x3bood']",5,"['tanj83', 'allymcminn98', 'yewu', 'malikasmith1', 'alisonleighoakes']",4,"[None, 'siu853151260', 'david.e.thompson', 'kentots07']",13,"['david.e.thompson', 'tanj83', 'breannbirch', 'lukemccormick09', 'x3bood', 'allymcminn98', 'kentots07', 'yewu', 'malikasmith1', 'joshsykes', 'alisonleighoakes', 'siu853151260', None]"
86,193,10,113,1,['hsu138'],8,"['bi10', 'mbollige', 'trimstid', 'hectork', 'transegn', 'aghodgao', 'dkhawas', 'riley.barta76']",112,"['yang1087', 'shi151', 'vdharman', 'sukirtthakur', 'ytursyn', 'gvkarthik', 'kbandar', 'tmueller44', 'lu500', 'kolispeter', 'taeksanglee', 'patkip', 'tsimon', 'willia98', 'samantas', 'taylorah', 'ndeneke', 'mrajase', 'tadhika', 'wang1471', 'phoutz', 'kristiaan2017', 'yjzhuang5', 'dcheu', 'datta0', 'gmckiern', 'rbritwik22', 'tanayadhikary', 'mulcay', 'jsqdcsq', 'huang714', 'myjokerss', 'psiripur', 'paulmather', 'rahuldeshmukh', 'ych0580', 'mademoiselle0812', 'rtibrewa', 'kyano', 'xiaoli94', 'gchsong', 'alotaibi', 'kyrwilliams', 'bermel', 'wang3243', 'huntmartinm', 'ouyang16', 'harshit03sep', 'dkj142857', 'soto27', 'akshat042', 'paul91', 'shhsu001', 'shashanksk5495', 'marisol', 'marcum0', 'brown214', 'cmallen3', 'zschleic', 'wang159', 'naik7', 'abhivictor2', 'nsalts', 'anjulvyas', 'liu1039', 'zhao830', 'rkanthar', 'denphi', 'azadoks', 'jiang556', 'zhan3024', 'transegn1', 'nthung', 'titus9', 'mmh', 'sabareesh169', 'ddmckay', 'samrider', 'wen', 'maathangi95', 'zhou646', 'vjoiner', 'rituraj346', 'kdaningb', 'bartar', 'patil52', 'ke_tang', 'ji52', 'ksriley', 'abiniwa', 'lpl', 'zhan3025', 'pengyu_long', 'psomers', 'wu1254', 'engr13200', 'lalzatev', 'strachan', None, 'baerr', 'ybazarba', 'huan1177', 'jrudolp', 'ma130029', 'pratheekpatil24', 'isik', 'piperp', 'pdressma', 'hvr', 'yang1489', 'utsavac', 'yvemula']",121,"['yang1087', 'shi151', 'vdharman', 'sukirtthakur', 'ytursyn', 'gvkarthik', 'kbandar', 'tmueller44', 'lu500', 'kolispeter', 'taeksanglee', 'patkip', 'tsimon', 'willia98', 'samantas', 'trimstid', 'ndeneke', 'mrajase', 'taylorah', 'aghodgao', 'tadhika', 'wang1471', 'phoutz', 'kristiaan2017', 'yjzhuang5', 'dcheu', 'datta0', 'gmckiern', 'rbritwik22', 'tanayadhikary', 'mulcay', 'jsqdcsq', 'huang714', 'myjokerss', 'psiripur', 'paulmather', 'rahuldeshmukh', 'ych0580', 'mademoiselle0812', 'rtibrewa', 'riley.barta76', 'kyano', 'xiaoli94', 'gchsong', 'mbollige', 'alotaibi', 'kyrwilliams', 'bermel', 'wang3243', 'huntmartinm', 'ouyang16', 'harshit03sep', 'dkj142857', 'soto27', 'akshat042', 'paul91', 'shhsu001', 'shashanksk5495', 'marisol', 'marcum0', 'brown214', 'cmallen3', 'zschleic', 'wang159', 'naik7', 'transegn', 'abhivictor2', 'nsalts', 'anjulvyas', 'liu1039', 'zhao830', 'rkanthar', 'denphi', 'azadoks', 'jiang556', 'zhan3024', 'transegn1', 'nthung', 'titus9', 'mmh', 'hsu138', 'sabareesh169', 'ddmckay', 'samrider', 'wen', 'maathangi95', 'zhou646', 'vjoiner', 'rituraj346', 'kdaningb', 'bartar', 'patil52', 'ke_tang', 'ji52', 'ksriley', 'abiniwa', 'lpl', 'zhan3025', 'pengyu_long', 'psomers', 'wu1254', 'engr13200', 'lalzatev', 'strachan', None, 'baerr', 'ybazarba', 'huan1177', 'jrudolp', 'ma130029', 'pratheekpatil24', 'bi10', 'isik', 'piperp', 'pdressma', 'hvr', 'yang1489', 'utsavac', 'yvemula', 'hectork', 'dkhawas']"
86,195,10,7,1,['hectork'],8,"['bi10', 'mbollige', 'hsu138', 'trimstid', 'transegn', 'aghodgao', 'dkhawas', 'riley.barta76']",6,"['malrefae', 'vyas13', 'psiripur', 'kbandar', 'zhao830', None]",15,"['malrefae', 'bi10', 'vyas13', 'mbollige', 'hsu138', 'psiripur', 'trimstid', 'kbandar', 'hectork', 'transegn', 'aghodgao', 'dkhawas', 'zhao830', None, 'riley.barta76']"
92,137,9,23,8,"['ratmnietzsche', 'elisabetsinh', 'aalfgvm', 'josecarlos', 'claferlop', 'javi94x', 'mercedesruiz994', 'ajsalas']",0,[],15,"['pedromaldonadoinfante', 'gabrielmelguizo', 'jrosa', None, 'rafrubgar95', 'armandomanuellopez93', 'alicorrgonz', 'pablosanchezcid', 'elena_aldeanueva', 'b.ortin.vinader', 'f.j.sanchez19', 'raul_mulguer', 'raquelcano.96', 'emigoca14', 'joseluiscastroarroyo95']",23,"['gabrielmelguizo', 'jrosa', 'rafrubgar95', 'armandomanuellopez93', 'b.ortin.vinader', 'raul_mulguer', 'emigoca14', 'mercedesruiz994', None, 'pedromaldonadoinfante', 'ratmnietzsche', 'elisabetsinh', 'alicorrgonz', 'pablosanchezcid', 'josecarlos', 'aalfgvm', 'elena_aldeanueva', 'f.j.sanchez19', 'claferlop', 'raquelcano.96', 'javi94x', 'ajsalas', 'joseluiscastroarroyo95']"
92,169,9,23,8,"['ratmnietzsche', 'elisabetsinh', 'aalfgvm', 'josecarlos', 'claferlop', 'javi94x', 'mercedesruiz994', 'ajsalas']",0,[],15,"['pedromaldonadoinfante', 'gabrielmelguizo', 'jrosa', None, 'rafrubgar95', 'armandomanuellopez93', 'alicorrgonz', 'pablosanchezcid', 'elena_aldeanueva', 'b.ortin.vinader', 'f.j.sanchez19', 'raul_mulguer', 'raquelcano.96', 'emigoca14', 'joseluiscastroarroyo95']",23,"['gabrielmelguizo', 'jrosa', 'rafrubgar95', 'armandomanuellopez93', 'b.ortin.vinader', 'raul_mulguer', 'emigoca14', 'mercedesruiz994', None, 'pedromaldonadoinfante', 'ratmnietzsche', 'elisabetsinh', 'alicorrgonz', 'pablosanchezcid', 'josecarlos', 'aalfgvm', 'elena_aldeanueva', 'f.j.sanchez19', 'claferlop', 'raquelcano.96', 'javi94x', 'ajsalas', 'joseluiscastroarroyo95']"
92,325,9,23,8,"['ratmnietzsche', 'elisabetsinh', 'aalfgvm', 'josecarlos', 'claferlop', 'javi94x', 'mercedesruiz994', 'ajsalas']",0,[],15,"['pedromaldonadoinfante', 'gabrielmelguizo', 'jrosa', None, 'rafrubgar95', 'armandomanuellopez93', 'alicorrgonz', 'pablosanchezcid', 'elena_aldeanueva', 'b.ortin.vinader', 'f.j.sanchez19', 'raul_mulguer', 'raquelcano.96', 'emigoca14', 'joseluiscastroarroyo95']",23,"['gabrielmelguizo', 'jrosa', 'rafrubgar95', 'armandomanuellopez93', 'b.ortin.vinader', 'raul_mulguer', 'emigoca14', 'mercedesruiz994', None, 'pedromaldonadoinfante', 'ratmnietzsche', 'elisabetsinh', 'alicorrgonz', 'pablosanchezcid', 'josecarlos', 'aalfgvm', 'elena_aldeanueva', 'f.j.sanchez19', 'claferlop', 'raquelcano.96', 'javi94x', 'ajsalas', 'joseluiscastroarroyo95']"
92,90,9,22,8,"['ratmnietzsche', 'elisabetsinh', 'aalfgvm', 'josecarlos', 'claferlop', 'javi94x', 'mercedesruiz994', 'ajsalas']",0,[],14,"[None, 'gabrielmelguizo', 'jrosa', 'rafrubgar95', 'armandomanuellopez93', 'alicorrgonz', 'pablosanchezcid', 'elena_aldeanueva', 'b.ortin.vinader', 'f.j.sanchez19', 'raul_mulguer', 'raquelcano.96', 'emigoca14', 'joseluiscastroarroyo95']",22,"['gabrielmelguizo', 'jrosa', 'rafrubgar95', 'armandomanuellopez93', 'b.ortin.vinader', 'raul_mulguer', 'emigoca14', 'mercedesruiz994', None, 'ratmnietzsche', 'elisabetsinh', 'alicorrgonz', 'pablosanchezcid', 'josecarlos', 'aalfgvm', 'elena_aldeanueva', 'f.j.sanchez19', 'claferlop', 'raquelcano.96', 'javi94x', 'ajsalas', 'joseluiscastroarroyo95']"
92,42,9,20,8,"['ratmnietzsche', 'elisabetsinh', 'aalfgvm', 'josecarlos', 'claferlop', 'javi94x', 'mercedesruiz994', 'ajsalas']",0,[],12,"[None, 'gabrielmelguizo', 'jrosa', 'rafrubgar95', 'armandomanuellopez93', 'alicorrgonz', 'elena_aldeanueva', 'b.ortin.vinader', 'f.j.sanchez19', 'raul_mulguer', 'emigoca14', 'joseluiscastroarroyo95']",20,"['gabrielmelguizo', 'jrosa', 'rafrubgar95', 'armandomanuellopez93', 'b.ortin.vinader', 'raul_mulguer', 'emigoca14', 'mercedesruiz994', None, 'ratmnietzsche', 'elisabetsinh', 'alicorrgonz', 'josecarlos', 'aalfgvm', 'elena_aldeanueva', 'f.j.sanchez19', 'claferlop', 'javi94x', 'ajsalas', 'joseluiscastroarroyo95']"
92,185,9,17,8,"['ratmnietzsche', 'elisabetsinh', 'aalfgvm', 'josecarlos', 'claferlop', 'javi94x', 'mercedesruiz994', 'ajsalas']",0,[],9,"[None, 'gabrielmelguizo', 'jrosa', 'rafrubgar95', 'alicorrgonz', 'b.ortin.vinader', 'raul_mulguer', 'emigoca14', 'joseluiscastroarroyo95']",17,"['gabrielmelguizo', 'jrosa', 'rafrubgar95', 'b.ortin.vinader', 'raul_mulguer', 'emigoca14', 'mercedesruiz994', None, 'ratmnietzsche', 'elisabetsinh', 'alicorrgonz', 'josecarlos', 'aalfgvm', 'claferlop', 'javi94x', 'ajsalas', 'joseluiscastroarroyo95']"
92,186,9,13,8,"['ratmnietzsche', 'elisabetsinh', 'aalfgvm', 'josecarlos', 'claferlop', 'javi94x', 'mercedesruiz994', 'ajsalas']",0,[],5,"['jrosa', 'pablosanchezcid', 'b.ortin.vinader', 'f.j.sanchez19', None]",13,"['jrosa', 'b.ortin.vinader', 'mercedesruiz994', None, 'ratmnietzsche', 'elisabetsinh', 'pablosanchezcid', 'josecarlos', 'aalfgvm', 'f.j.sanchez19', 'claferlop', 'javi94x', 'ajsalas']"
93,365,9,14,8,"['alaa.derhem', 'kaisoni', 'ayesha.alqaz', 'akhmetzhan.kussainov', 'ahmadmhr7', 'doaa.khalil', 'ali.yaqoob', 'fares']",0,[],6,"['nadeenr', 'mostafa010', 'hadielbaba', 'anthony2', 'nadamohammed', None]",14,"['ayesha.alqaz', 'mostafa010', 'doaa.khalil', None, 'alaa.derhem', 'kaisoni', 'nadeenr', 'akhmetzhan.kussainov', 'ahmadmhr7', 'hadielbaba', 'anthony2', 'nadamohammed', 'ali.yaqoob', 'fares']"
93,309,9,10,8,"['alaa.derhem', 'kaisoni', 'ayesha.alqaz', 'akhmetzhan.kussainov', 'ahmadmhr7', 'doaa.khalil', 'ali.yaqoob', 'fares']",0,[],2,"['nadamohammed', None]",10,"['alaa.derhem', 'kaisoni', 'ayesha.alqaz', 'akhmetzhan.kussainov', 'ahmadmhr7', 'doaa.khalil', 'nadamohammed', None, 'ali.yaqoob', 'fares']"
94,15,9,11,8,"['velmurugan.v', 'gowtham5174', 'dhavanth', 'suryavinayak007', 'rkpriyaviji', 'sandeep404', 'vinopoornimaece', 'vikesh.s.b']",0,[],3,"['kirtika.am', None, 'sahananive20']",11,"['velmurugan.v', 'sandeep404', 'vinopoornimaece', 'sahananive20', None, 'kirtika.am', 'gowtham5174', 'dhavanth', 'suryavinayak007', 'rkpriyaviji', 'vikesh.s.b']"
94,114,9,11,8,"['velmurugan.v', 'gowtham5174', 'dhavanth', 'suryavinayak007', 'rkpriyaviji', 'sandeep404', 'vinopoornimaece', 'vikesh.s.b']",0,[],3,"['kirtika.am', None, 'sahananive20']",11,"['velmurugan.v', 'sandeep404', 'vinopoornimaece', 'sahananive20', None, 'kirtika.am', 'gowtham5174', 'dhavanth', 'suryavinayak007', 'rkpriyaviji', 'vikesh.s.b']"
94,262,9,11,8,"['velmurugan.v', 'gowtham5174', 'dhavanth', 'suryavinayak007', 'rkpriyaviji', 'sandeep404', 'vinopoornimaece', 'vikesh.s.b']",0,[],3,"['kirtika.am', None, 'sahananive20']",11,"['velmurugan.v', 'sandeep404', 'vinopoornimaece', 'sahananive20', None, 'kirtika.am', 'gowtham5174', 'dhavanth', 'suryavinayak007', 'rkpriyaviji', 'vikesh.s.b']"
94,218,9,9,8,"['velmurugan.v', 'gowtham5174', 'dhavanth', 'suryavinayak007', 'rkpriyaviji', 'sandeep404', 'vinopoornimaece', 'vikesh.s.b']",0,[],1,[None],9,"['velmurugan.v', 'gowtham5174', 'dhavanth', 'suryavinayak007', 'rkpriyaviji', 'sandeep404', 'vinopoornimaece', None, 'vikesh.s.b']"
97,33,9,8,6,"['marcofarina1994', 'luca.riccies', 'dongli_17', 'aledafers', 'corrado888', 'dirosagabriele']",2,"['waqar.177', 'miltonpersson']",2,"[None, 'bellmanz']",10,"['marcofarina1994', 'bellmanz', 'luca.riccies', 'waqar.177', 'dongli_17', 'aledafers', 'corrado888', 'miltonpersson', 'dirosagabriele', None]"
97,36,9,7,6,"['marcofarina1994', 'luca.riccies', 'aledafers', 'corrado888', 'miltonpersson', 'dirosagabriele']",2,"['waqar.177', 'dongli_17']",1,[None],9,"['marcofarina1994', 'luca.riccies', 'waqar.177', 'dongli_17', 'aledafers', 'corrado888', 'miltonpersson', 'dirosagabriele', None]"
97,40,9,7,6,"['marcofarina1994', 'dongli_17', 'aledafers', 'corrado888', 'miltonpersson', 'dirosagabriele']",2,"['waqar.177', 'luca.riccies']",1,[None],9,"['marcofarina1994', 'luca.riccies', 'waqar.177', 'dongli_17', 'aledafers', 'corrado888', 'miltonpersson', 'dirosagabriele', None]"
97,183,9,6,5,"['marcofarina1994', 'aledafers', 'corrado888', 'miltonpersson', 'dirosagabriele']",3,"['waqar.177', 'dongli_17', 'luca.riccies']",1,[None],9,"['marcofarina1994', 'luca.riccies', 'waqar.177', 'dongli_17', 'aledafers', 'corrado888', 'miltonpersson', 'dirosagabriele', None]"
98,400,9,27,4,"['yvonnee213', 'dwen3', 'zhaomiaomiao', 'hzhou29']",4,"['tsooj_0117', 'elp17ys', 'silpa_p_a', 'kexinli']",23,"['elt17bw', 'mirjiang', 'gary0010', 'jxie13', 'niknanohub', 'orzmissman', 'azpixy', 'tanusharma', 'shanshuiyue', 'laplace_', 'pfeng3', 'wd2lh', 'clostuard', 'elq17cz', 'twang56', 'thursika', None, 'zhaohao', 'xtan15', 'nanahmadsufian1', 'jiangtao', 'myu9', 'gchen4']",31,"['elt17bw', 'mirjiang', 'gary0010', 'dwen3', 'zhaomiaomiao', 'jxie13', 'niknanohub', 'yvonnee213', 'orzmissman', 'kexinli', 'azpixy', 'tanusharma', 'shanshuiyue', 'silpa_p_a', 'hzhou29', 'laplace_', 'pfeng3', 'wd2lh', 'clostuard', 'elq17cz', 'twang56', 'thursika', None, 'zhaohao', 'xtan15', 'tsooj_0117', 'elp17ys', 'nanahmadsufian1', 'jiangtao', 'myu9', 'gchen4']"
98,401,9,25,5,"['elp17ys', 'dwen3', 'zhaomiaomiao', 'hzhou29', 'yvonnee213']",3,"['tsooj_0117', 'silpa_p_a', 'kexinli']",20,"['elt17bw', 'mirjiang', 'gary0010', 'jxie13', 'niknanohub', 'orzmissman', 'azpixy', 'tanusharma', 'shanshuiyue', 'laplace_', 'pfeng3', 'wd2lh', 'elq17cz', 'twang56', 'thursika', None, 'zhaohao', 'xtan15', 'jiangtao', 'myu9']",28,"['elt17bw', 'mirjiang', 'gary0010', 'dwen3', 'zhaomiaomiao', 'jxie13', 'niknanohub', 'yvonnee213', 'orzmissman', 'kexinli', 'azpixy', 'tanusharma', 'shanshuiyue', 'silpa_p_a', 'hzhou29', 'laplace_', 'pfeng3', 'wd2lh', 'elq17cz', 'twang56', 'thursika', None, 'zhaohao', 'xtan15', 'tsooj_0117', 'elp17ys', 'jiangtao', 'myu9']"
99,64,9,92,2,"['moraeseric123', 'kmamaniya']",6,"['murzellobenz', 'treesaachu', 'moraes.amos', 'patil.chinmay04', 'bhadreshwarak308', 'pragatidhekale']",90,"['tejalnaik12', 'abhaskar31', 'vinayakgadkari8', 'karar.bhadreshwara', 'keshvis26', 'akashborhade123', 'naikpratiksha510', 'singhrajkarn1699', 'abhijitharidas3107', 'yashjivrajani7799', 'yuvraj.t', 'kkiran31', 'amolgolwankar', 'pratik007', 'mayanair1104', 'prajoth.fernandes', 'shibssalian', 'kadampk15ex', 'shreyas.v', 'smriti.sivadas96', 'aadi', 'alwin1996', 'suhayl4k', 'gvishs15', 'pguleria', 'sakshijoshi', 'tejdhupkar', 'shubhamgharat274', 'rashmithanair5', 'deeptimenon', 'ketan.db', 'pratik.gc', 'chinmaysj96', 'danieldsilva96', 'cmahale95', 'akarnik.13', 'mayureshnagvekar57', 'aditya332', 'sumasalian96', 'inderjitsingh87', 'rnair10', 'chinmaygawas', 'varunmullins', 'divya.shinde', 'temp999use', 'livz944', 'bpatel03', 'salianyatish111', 'jobin301', 'shrey.joshi', 'kumarkhandagle33', 'samsonkajar', 'kharadesonam', 'anjali.kalmase', 'apurva.nehru', 'ralph.rodrigues69', 'poojanale1996', 'pranjal17', 'eshani2396', 'meet7', 'mkhanvilkar', 'dghosalkar', 'shally', 'varunndabhade', 'prajwal.angolkar4', 'pravingowda28', 'mayank.vp', 'bnrnirmal94', 'npnishankpednekar', 'raj.vadariya', None, 'pjay10708', 'gsatpute64', 'krexianclass', 'css_', 'jonathanrjpereira', 'yashgosar9', 'rubina15', 'adityagudla96', 'dheereshpoojary', 'sukhpreet11234kldfhd', 'nishumahapatro1995', 'pratik2225', 'bharatesh.a', 'cristyjne8', 'aniruddhaparte3', 'srevolution23', 'saniyasnair', 'ashpillai.1996', 'shrutis31']",98,"['tejalnaik12', 'abhaskar31', 'vinayakgadkari8', 'karar.bhadreshwara', 'keshvis26', 'akashborhade123', 'naikpratiksha510', 'singhrajkarn1699', 'abhijitharidas3107', 'yashjivrajani7799', 'yuvraj.t', 'kkiran31', 'amolgolwankar', 'pratik007', 'mayanair1104', 'prajoth.fernandes', 'shibssalian', 'kadampk15ex', 'shreyas.v', 'smriti.sivadas96', 'patil.chinmay04', 'aadi', 'alwin1996', 'suhayl4k', 'gvishs15', 'pguleria', 'kmamaniya', 'sakshijoshi', 'tejdhupkar', 'shubhamgharat274', 'rashmithanair5', 'pragatidhekale', 'deeptimenon', 'ketan.db', 'pratik.gc', 'chinmaysj96', 'danieldsilva96', 'cmahale95', 'akarnik.13', 'mayureshnagvekar57', 'aditya332', 'sumasalian96', 'inderjitsingh87', 'rnair10', 'chinmaygawas', 'varunmullins', 'divya.shinde', 'temp999use', 'livz944', 'bpatel03', 'salianyatish111', 'jobin301', 'shrey.joshi', 'kumarkhandagle33', 'samsonkajar', 'kharadesonam', 'anjali.kalmase', 'apurva.nehru', 'ralph.rodrigues69', 'poojanale1996', 'moraes.amos', 'pranjal17', 'bhadreshwarak308', 'eshani2396', 'meet7', 'mkhanvilkar', 'dghosalkar', 'shally', 'varunndabhade', 'prajwal.angolkar4', 'pravingowda28', 'mayank.vp', 'bnrnirmal94', 'npnishankpednekar', 'raj.vadariya', None, 'pjay10708', 'moraeseric123', 'gsatpute64', 'css_', 'krexianclass', 'murzellobenz', 'jonathanrjpereira', 'yashgosar9', 'rubina15', 'adityagudla96', 'dheereshpoojary', 'sukhpreet11234kldfhd', 'nishumahapatro1995', 'pratik2225', 'bharatesh.a', 'cristyjne8', 'treesaachu', 'aniruddhaparte3', 'srevolution23', 'saniyasnair', 'ashpillai.1996', 'shrutis31']"
99,60,9,59,3,"['treesaachu', 'kmamaniya', 'murzellobenz']",5,"['moraeseric123', 'moraes.amos', 'patil.chinmay04', 'bhadreshwarak308', 'pragatidhekale']",56,"['vivekrana', 'rahul.baddi', 'pbhaveshv15et', 'deepalisas13', 'roshusakpal89', 'tanmay9', 'vinayakgadkari8', 'gnthakore', 'divya.shinde', 'brarath.nihal', 'pradhantn11e', 'varunmullins', 'suyash.sc', 'pallavivalunj', 'pratimadas1996', 'ankit.pandey', 'peterbraganza52', '1996jaypatel', 'mugdhas2030', 'spawar09', 'vaibhavkokare2011', 'adsoni468', 'stevenevendsouza23', 'sneha469', 'tushar.wadhaval', 'meet7', 'pateltejash96', 'sahilboble25', 'chahat.s', 'spodal24', 'sjayyant31', 'seemam', 'senmathew329', 'jmihavel', 'mayank.vp', 'dhruv16', 'samuelalmeida17', 'raj.vadariya', 'shubhamgharat274', 'singh5987', 'sonali.ramji', None, 'ketan.db', 'aditi.adilip', 'dshaikh4', 'prachiamrutkar16', 'krexianclass', 'vaishak', 'nirav.lm', 'vvipul31', 'ninawe14', 'marcmathew', 'ssatendra31', 'vaibhavnagar08', 'yashuishwar', 'yadavsandeep793']",64,"['rahul.baddi', 'deepalisas13', 'tanmay9', 'vinayakgadkari8', 'suyash.sc', 'pallavivalunj', 'pratimadas1996', 'peterbraganza52', 'mugdhas2030', 'spawar09', 'vaibhavkokare2011', 'patil.chinmay04', 'sahilboble25', 'seemam', 'senmathew329', 'jmihavel', 'kmamaniya', 'dhruv16', 'samuelalmeida17', 'shubhamgharat274', 'singh5987', 'pragatidhekale', 'ketan.db', 'dshaikh4', 'vaishak', 'vvipul31', 'marcmathew', 'vaibhavnagar08', 'yashuishwar', 'yadavsandeep793', 'vivekrana', 'pbhaveshv15et', 'roshusakpal89', 'varunmullins', 'gnthakore', 'divya.shinde', 'brarath.nihal', 'pradhantn11e', 'ankit.pandey', '1996jaypatel', 'moraes.amos', 'adsoni468', 'stevenevendsouza23', 'bhadreshwarak308', 'sneha469', 'tushar.wadhaval', 'meet7', 'pateltejash96', 'chahat.s', 'spodal24', 'sjayyant31', 'mayank.vp', 'raj.vadariya', 'sonali.ramji', None, 'aditi.adilip', 'moraeseric123', 'prachiamrutkar16', 'krexianclass', 'nirav.lm', 'murzellobenz', 'ninawe14', 'treesaachu', 'ssatendra31']"
99,58,9,58,1,['patil.chinmay04'],7,"['moraeseric123', 'murzellobenz', 'kmamaniya', 'treesaachu', 'moraes.amos', 'bhadreshwarak308', 'pragatidhekale']",57,"['vivekrana', 'priyankamali2510', 'pbhaveshv15et', 'salaskarsu15', 'roshusakpal89', 'orenavikar', 'parineetap0', 'tanmay9', 'milind123', 'gnthakore', 'deepalisingh195', 'sushmafn', 'ssmande', 'shubham.patil585', 'vishurajigare10', 'yuvraj.t', 'krunal.kasar', 'samirbobade', 'pratik007', 'yadavsandeep793', 'vishal914', 'k.gauswami', 'uyewale', 'ralph.rodrigues69', 'spawar09', 'vaitysushant', 'sagarika260710', 'svirendra31', 'pranjal17', 'pateltejash96', 'sahilboble25', 'shally', 'chahat.s', 'spodal24', 'sjayyant31', 'rasalvc15ex', 'skomald118', 'mayank.vp', 'raj.vadariya', 'nabhishek29', 'mdeshmukh', 'nikam468', 'sayali_m9', None, 'pratik.gc', 'dshaikh4', 'jonathanrjpereira', 'vaishak', 'nivedita', 'rubina15', 'vvipul31', 'jas.sahmbi123', 'ankitpandey1296', 'anil8796069443', 'juili.save', 'akhil.shetty37', 'shubhampatil2308']",65,"['priyankamali2510', 'salaskarsu15', 'tanmay9', 'sushmafn', 'shubham.patil585', 'vishurajigare10', 'yuvraj.t', 'pratik007', 'vishal914', 'k.gauswami', 'uyewale', 'spawar09', 'patil.chinmay04', 'sahilboble25', 'skomald118', 'kmamaniya', 'nikam468', 'sayali_m9', 'pragatidhekale', 'pratik.gc', 'dshaikh4', 'vaishak', 'nivedita', 'vvipul31', 'jas.sahmbi123', 'ankitpandey1296', 'anil8796069443', 'yadavsandeep793', 'shubhampatil2308', 'vivekrana', 'pbhaveshv15et', 'parineetap0', 'roshusakpal89', 'orenavikar', 'milind123', 'gnthakore', 'deepalisingh195', 'ssmande', 'samirbobade', 'krunal.kasar', 'ralph.rodrigues69', 'akhil.shetty37', 'vaitysushant', 'moraes.amos', 'sagarika260710', 'svirendra31', 'pranjal17', 'bhadreshwarak308', 'pateltejash96', 'chahat.s', 'spodal24', 'sjayyant31', 'rasalvc15ex', 'mayank.vp', 'raj.vadariya', 'nabhishek29', 'mdeshmukh', None, 'moraeseric123', 'jonathanrjpereira', 'murzellobenz', 'rubina15', 'treesaachu', 'juili.save', 'shally']"
99,173,9,44,1,['pragatidhekale'],7,"['moraeseric123', 'murzellobenz', 'kmamaniya', 'treesaachu', 'moraes.amos', 'patil.chinmay04', 'bhadreshwarak308']",43,"['jinal.sarvaiya.js', 'ruchira_ghule', 'keshvis26', 'rajeshreesawale', 'moreashank2', 'abhijitharidas3107', 'yuvraj.t', 'shrey.joshi', 'kumarkhandagle33', 'meghana.loke02', 'amolgolwankar', 'kharadesonam', 'anjali.kalmase', 'sahil.sawant031996', 'ankit.pandey', 'apurva.nehru', 'tinu', 'sheetalchaudhari2210', 'pallavi.valunj', 'sagarika260710', 'pranjal17', 'pooja9702.pm', 'alwin1996', 'npnishankpednekar', 'kaushalmalaviya5', 'chaitalivartak07', 'raj.vadariya', 'coolsprathamesh21', 'hamad42623', None, 'ketan.db', 'nirav.lm', 'jonathanrjpereira', 'css_', 'rubina15', 'bharatesh.a', 'niveshvaze', 'srevolution23', 'aditya332', 'juili.save', 'sumasalian96', 'saniyasnair', 'harshnsavla']",51,"['jinal.sarvaiya.js', 'ruchira_ghule', 'keshvis26', 'rajeshreesawale', 'moreashank2', 'abhijitharidas3107', 'yuvraj.t', 'shrey.joshi', 'kumarkhandagle33', 'amolgolwankar', 'kharadesonam', 'anjali.kalmase', 'sahil.sawant031996', 'ankit.pandey', 'apurva.nehru', 'tinu', 'sheetalchaudhari2210', 'moraes.amos', 'pallavi.valunj', 'sagarika260710', 'patil.chinmay04', 'pranjal17', 'bhadreshwarak308', 'pooja9702.pm', 'alwin1996', 'kmamaniya', 'npnishankpednekar', 'kaushalmalaviya5', 'chaitalivartak07', 'raj.vadariya', 'coolsprathamesh21', 'hamad42623', None, 'pragatidhekale', 'ketan.db', 'moraeseric123', 'nirav.lm', 'jonathanrjpereira', 'css_', 'murzellobenz', 'harshnsavla', 'rubina15', 'bharatesh.a', 'treesaachu', 'niveshvaze', 'srevolution23', 'aditya332', 'juili.save', 'sumasalian96', 'saniyasnair', 'meghana.loke02']"
99,239,9,19,3,"['treesaachu', 'bhadreshwarak308', 'pragatidhekale']",5,"['moraeseric123', 'murzellobenz', 'kmamaniya', 'moraes.amos', 'patil.chinmay04']",16,"['samsonkajar', 'neetavarkute', 'prajoth.fernandes', 'tinu', 'ralph.rodrigues69', 'danieldsilva96', 'kruti.pradnil', 'livz944', 'sushmafn', 'samuelalmeida17', 'swapnalimakdey25', 'aditya332', 'juili.save', 'hamad42623', None, 'mansikakrecha']",24,"['neetavarkute', 'kmamaniya', 'livz944', 'sushmafn', 'samuelalmeida17', 'hamad42623', None, 'pragatidhekale', 'mansikakrecha', 'samsonkajar', 'moraeseric123', 'prajoth.fernandes', 'murzellobenz', 'tinu', 'ralph.rodrigues69', 'danieldsilva96', 'kruti.pradnil', 'swapnalimakdey25', 'treesaachu', 'moraes.amos', 'aditya332', 'patil.chinmay04', 'juili.save', 'bhadreshwarak308']"
99,241,9,18,6,"['moraeseric123', 'murzellobenz', 'kmamaniya', 'treesaachu', 'moraes.amos', 'bhadreshwarak308']",2,"['patil.chinmay04', 'pragatidhekale']",12,"['krexianclass', 'dcruzdylan50', 'varunmullins', 'senmathew329', 'danieldsilva96', 'marcmathew19', 'samuelalmeida17', 'swapnalimakdey25', 'mmgmahendra', 'vaibhavnagar08', None, 'mansikakrecha']",20,"['varunmullins', 'senmathew329', 'kmamaniya', 'marcmathew19', 'samuelalmeida17', 'mmgmahendra', None, 'pragatidhekale', 'mansikakrecha', 'moraeseric123', 'krexianclass', 'murzellobenz', 'dcruzdylan50', 'danieldsilva96', 'swapnalimakdey25', 'treesaachu', 'moraes.amos', 'vaibhavnagar08', 'patil.chinmay04', 'bhadreshwarak308']"
99,265,9,14,8,"['moraeseric123', 'murzellobenz', 'kmamaniya', 'treesaachu', 'moraes.amos', 'patil.chinmay04', 'bhadreshwarak308', 'pragatidhekale']",0,[],6,"['neetavarkute', 'senmathew329', 'danieldsilva96', 'swapnalimakdey25', 'vaibhavnagar08', None]",14,"['neetavarkute', 'senmathew329', 'kmamaniya', None, 'pragatidhekale', 'moraeseric123', 'murzellobenz', 'danieldsilva96', 'swapnalimakdey25', 'treesaachu', 'moraes.amos', 'vaibhavnagar08', 'patil.chinmay04', 'bhadreshwarak308']"
99,62,9,13,1,['treesaachu'],7,"['moraeseric123', 'murzellobenz', 'kmamaniya', 'moraes.amos', 'patil.chinmay04', 'bhadreshwarak308', 'pragatidhekale']",12,"['pratimadas1996', 'vinayakgadkari8', 'varunmullins', 'mugdhas2030', 'brarath.nihal', 'jmihavel', 'stevenevendsouza23', 'samuelalmeida17', 'vaibhavkokare2011', 'marcmathew', 'vaibhavnagar08', None]",20,"['vinayakgadkari8', 'varunmullins', 'brarath.nihal', 'jmihavel', 'kmamaniya', 'samuelalmeida17', None, 'pragatidhekale', 'moraeseric123', 'pratimadas1996', 'murzellobenz', 'mugdhas2030', 'stevenevendsouza23', 'treesaachu', 'vaibhavkokare2011', 'marcmathew', 'moraes.amos', 'vaibhavnagar08', 'patil.chinmay04', 'bhadreshwarak308']"
99,240,9,13,2,"['patil.chinmay04', 'pragatidhekale']",6,"['moraeseric123', 'murzellobenz', 'kmamaniya', 'treesaachu', 'moraes.amos', 'bhadreshwarak308']",11,"[None, 'prajoth.fernandes', 'neetavarkute', 'tinu', 'ralph.rodrigues69', 'danieldsilva96', 'livz944', 'sushmafn', 'juili.save', 'hamad42623', 'dakshatavaze96']",19,"['neetavarkute', 'kmamaniya', 'livz944', 'sushmafn', 'hamad42623', 'dakshatavaze96', None, 'pragatidhekale', 'moraeseric123', 'prajoth.fernandes', 'murzellobenz', 'tinu', 'ralph.rodrigues69', 'danieldsilva96', 'treesaachu', 'moraes.amos', 'juili.save', 'patil.chinmay04', 'bhadreshwarak308']"
99,66,9,10,1,['kmamaniya'],7,"['moraeseric123', 'murzellobenz', 'treesaachu', 'moraes.amos', 'patil.chinmay04', 'bhadreshwarak308', 'pragatidhekale']",9,"['samsonkajar', 'krexianclass', 'prajoth.fernandes', 'dcruzdylan50', 'varunmullins', 'marcmathew19', 'aditya332', 'vaibhavnagar08', None]",17,"['samsonkajar', 'moraeseric123', 'krexianclass', 'prajoth.fernandes', None, 'murzellobenz', 'dcruzdylan50', 'varunmullins', 'kmamaniya', 'marcmathew19', 'treesaachu', 'moraes.amos', 'aditya332', 'vaibhavnagar08', 'patil.chinmay04', 'bhadreshwarak308', 'pragatidhekale']"
100,326,8,10,6,"['poorva.gupta', 'ishasawant', 'mihir.patange', 'baishakhi.choudhury', 'saurabh.jadhav', 'rohan.pawar']",1,['antonsaikia11'],4,"['dhruva.aklekar', 'sahil.tasgavkar', None, 'gayatri.devadiga']",11,"['poorva.gupta', 'ishasawant', 'dhruva.aklekar', None, 'mihir.patange', 'gayatri.devadiga', 'sahil.tasgavkar', 'antonsaikia11', 'baishakhi.choudhury', 'saurabh.jadhav', 'rohan.pawar']"
101,111,8,10,6,"['bayrlhagva_gaara', 'zayagerel0617', 'tsedenbalzolbayr050719', 'bolortugs_svnjidmaa', 'badi_0120', 'a.badamgaraw0514']",1,['classicok'],4,"['undram', None, 'selengesuren', 'baasanlhamaa']",11,"['undram', 'selengesuren', 'zayagerel0617', 'classicok', 'tsedenbalzolbayr050719', 'badi_0120', 'a.badamgaraw0514', None, 'bayrlhagva_gaara', 'bolortugs_svnjidmaa', 'baasanlhamaa']"
102,181,8,12,7,"['zhangjk87', 'lkgood', 'chloe.z', 'alecskipper', 'rhroberts', 'wangyn95', 'rmital.1995']",0,[],5,"['ak36874', 'ssst0320', 'sarah.muschinske', 'alamp', None]",12,"['zhangjk87', 'chloe.z', 'alamp', 'ssst0320', 'wangyn95', None, 'rmital.1995', 'lkgood', 'ak36874', 'alecskipper', 'rhroberts', 'sarah.muschinske']"
103,306,8,80,1,['arishinam123'],6,"['husseinaljawazri', 'utkumerttopcuoglu', 'itaybm2', 'abilio_azevedo', 'siriphun.amaritchoti', 'fokossi']",79,"['swadhasanghvi4', 'sanidhya27', 'ishank', 'kritikamna23', 'hegdeananthar', 'jitendraiitb', 'guptasheetal436', 'bagrania385', 'khandelwalsanyam87', 'neharikajali', 'nilesh8', 'rashmiravindranath', 'gb42', 'ajitzote', 'arbaz', 'archiki', 'anilk', 'akashmunda12345', 'pandeykratvesh', '28dhruv.varshney', 'aniketbhatia2107', 'ak83229', 'singhalanirudh18', 'vineetkotariya', 'snjkhatri34', 'anonymousbuggy', 'kumaradarsh', 'vivekkandeyang97', '16d070026', 'ydidwania', 'tanmaypatil1598', 'neeraj.chimankar', 'pirojiwalasubham', 'acrylonitrile', 'devesh1102', 'nishagb04', 'yojit105', 'dimplekochar3', 'pmmadhumita9', 'harsh05september', 'mustafaali12', 'lakshyakumarsingh', 'akashminato1', 'himanshuaswani123', 'sudhiriitb', 'ksselhi', 'sucheta317', 'keshariaayesha', 'narendrarai1812', 'devanshu', 'shashiadi', 'anshulvermaiitb', 'shauryasindhu', 'aspruha.samal', 'sethabhinav89', 'navnitkumar1224', 'nemadepsn', 'sahilkumar1900', 'bhuyashi.deka', 'neildalal', 'pratyushragini', 'shubhangb97', 'saarthak', 'prnair', 'qwerty56', 'ghanshyam.techfest', None, 'rishikkumar18', 'apoorv0', 'ishitadas1998', 'anirudh.singhal', 'ghanshyam.iitb', 'abhikanse', 'sudhanshum2014', 'aniketsl', 'kumar_ashutosh', 'navoj98', 'max2aneeb', 'kaki.krish15']",86,"['swadhasanghvi4', 'husseinaljawazri', 'sanidhya27', 'ishank', 'kritikamna23', 'siriphun.amaritchoti', 'hegdeananthar', 'jitendraiitb', 'guptasheetal436', 'bagrania385', 'utkumerttopcuoglu', 'khandelwalsanyam87', 'neharikajali', 'nilesh8', 'rashmiravindranath', 'abilio_azevedo', 'gb42', 'ajitzote', 'arbaz', 'arishinam123', 'archiki', 'anilk', 'akashmunda12345', 'pandeykratvesh', '28dhruv.varshney', 'aniketbhatia2107', 'ak83229', 'singhalanirudh18', 'vineetkotariya', 'snjkhatri34', 'anonymousbuggy', 'kumaradarsh', 'vivekkandeyang97', '16d070026', 'ydidwania', 'tanmaypatil1598', 'neeraj.chimankar', 'pirojiwalasubham', 'acrylonitrile', 'devesh1102', 'nishagb04', 'yojit105', 'dimplekochar3', 'itaybm2', 'pmmadhumita9', 'harsh05september', 'mustafaali12', 'lakshyakumarsingh', 'akashminato1', 'himanshuaswani123', 'sudhiriitb', 'ksselhi', 'sucheta317', 'keshariaayesha', 'narendrarai1812', 'devanshu', 'shashiadi', 'anshulvermaiitb', 'shauryasindhu', 'aspruha.samal', 'sethabhinav89', 'navnitkumar1224', 'nemadepsn', 'sahilkumar1900', 'bhuyashi.deka', 'neildalal', 'pratyushragini', 'shubhangb97', 'saarthak', 'prnair', 'qwerty56', 'fokossi', 'ghanshyam.techfest', None, 'rishikkumar18', 'apoorv0', 'ishitadas1998', 'anirudh.singhal', 'ghanshyam.iitb', 'abhikanse', 'sudhanshum2014', 'aniketsl', 'kumar_ashutosh', 'navoj98', 'max2aneeb', 'kaki.krish15']"
104,300,8,48,7,"['sd.diaz', 'andresfdt.2k8', 'rdcajr', 'raquelalejandra', 'brayant', 'sa.sanchez', 'labiele2206']",0,[],41,"['cdaniel089', 'jufepas98', 'jenipinzon.ml', 'jesusvillamizar', 'erikananiela', 'yeju16', 'we.simancas10', 'a.mesias10', 'jairovlacha', 'jdmedinatobon', 'salazarnelson', 'jonathanpinzon05', 'ja.jimenez317', 'alejandro2655', 'dadelapa321', 'af.vera10', 'j.wilckenlecompte', 'fabser7', 'ogabriel.cv99', 'rf.ruiz10', 'andres9802', 'andrestrujillo098', 'juandavid97', 'lf.correa10', 'hectordavidpulido', 'jupalinar17', None, 'alejandract', 'vserrano081821', 'te.vence10', 'isabella', 'jfgf11', 'diegobb', 'jframos', 'carlosdoblev', 'aruiz6a', 'vanessamovilla', 'juan_camilo', 'eduardmolano', 'valentina.reyesmar4', 'mariaalejandraep']",48,"['cdaniel089', 'jufepas98', 'rdcajr', 'jenipinzon.ml', 'jesusvillamizar', 'raquelalejandra', 'erikananiela', 'yeju16', 'sa.sanchez', 'we.simancas10', 'a.mesias10', 'andresfdt.2k8', 'jairovlacha', 'brayant', 'jdmedinatobon', 'salazarnelson', 'jonathanpinzon05', 'ja.jimenez317', 'alejandro2655', 'dadelapa321', 'sd.diaz', 'af.vera10', 'j.wilckenlecompte', 'fabser7', 'ogabriel.cv99', 'rf.ruiz10', 'andres9802', 'andrestrujillo098', 'juandavid97', 'lf.correa10', 'hectordavidpulido', 'jupalinar17', 'labiele2206', None, 'alejandract', 'vserrano081821', 'te.vence10', 'isabella', 'jfgf11', 'diegobb', 'jframos', 'carlosdoblev', 'aruiz6a', 'vanessamovilla', 'juan_camilo', 'eduardmolano', 'valentina.reyesmar4', 'mariaalejandraep']"
104,123,8,39,7,"['sd.diaz', 'andresfdt.2k8', 'rdcajr', 'raquelalejandra', 'brayant', 'sa.sanchez', 'labiele2206']",0,[],32,"['jufepas98', 'jenipinzon.ml', 'jesusvillamizar', 'erikananiela', 'we.simancas10', 'jairovlacha', 'jdmedinatobon', 'ja.jimenez317', 'dadelapa321', 'af.vera10', 'j.wilckenlecompte', 'fabser7', 'sarabeja98', 'rf.ruiz10', 'andres9802', 'andrestrujillo098', 'juandavid97', 'lf.correa10', 'hectordavidpulido', 'jupalinar17', None, 'vserrano081821', 'te.vence10', 'isabella', 'jfgf11', 'diegobb', 'jframos', 'carlosdoblev', 'vanessamovilla', 'juan_camilo', 'eduardmolano', 'escalantemariaalejandra']",39,"['jufepas98', 'rdcajr', 'jenipinzon.ml', 'jesusvillamizar', 'raquelalejandra', 'erikananiela', 'sa.sanchez', 'we.simancas10', 'andresfdt.2k8', 'jairovlacha', 'brayant', 'jdmedinatobon', 'ja.jimenez317', 'dadelapa321', 'sd.diaz', 'af.vera10', 'j.wilckenlecompte', 'fabser7', 'sarabeja98', 'rf.ruiz10', 'andres9802', 'andrestrujillo098', 'juandavid97', 'lf.correa10', 'hectordavidpulido', 'jupalinar17', 'labiele2206', None, 'vserrano081821', 'te.vence10', 'isabella', 'jfgf11', 'diegobb', 'jframos', 'carlosdoblev', 'vanessamovilla', 'juan_camilo', 'eduardmolano', 'escalantemariaalejandra']"
104,369,8,32,7,"['sd.diaz', 'andresfdt.2k8', 'rdcajr', 'raquelalejandra', 'brayant', 'sa.sanchez', 'labiele2206']",0,[],25,"['juliantecnologic', 'na.diaz', 'cy.andrade', 'dssv99', 'ja.forero15', 'numumero', 'josedanielmecon', 'nata.quintero3098', 'anamis_forero', 'fd.nino10', 'velajua', 'pabloccr', 'miguel1003', 'danielcusva', 'miguell98md', 'bryanc121297', 'ivanrulik', 'a.ricci10', None, 'carlos2992', 'crisdavbed08', 'ksgutierrez', 'eduardmolano', 'electroniccasalins96', 'camilom']",32,"['juliantecnologic', 'na.diaz', 'rdcajr', 'raquelalejandra', 'cy.andrade', 'dssv99', 'ja.forero15', 'sa.sanchez', 'numumero', 'andresfdt.2k8', 'josedanielmecon', 'nata.quintero3098', 'brayant', 'anamis_forero', 'fd.nino10', 'sd.diaz', 'velajua', 'pabloccr', 'miguel1003', 'danielcusva', 'miguell98md', 'bryanc121297', 'ivanrulik', 'a.ricci10', 'labiele2206', None, 'carlos2992', 'crisdavbed08', 'ksgutierrez', 'eduardmolano', 'electroniccasalins96', 'camilom']"
104,118,8,31,3,"['raquelalejandra', 'rdcajr', 'andresfdt.2k8']",4,"['sa.sanchez', 'sd.diaz', 'labiele2206', 'brayant']",28,"['jufepas98', 'jesusvillamizar', 'erikananiela', 'yeju16', 'we.simancas10', 'duodinamico', 'jdmedinatobon', 'dadelapa321', 'af.vera10', 'lauradnc15', 'j.wilckenlecompte', 'fabser7', 'rf.ruiz10', 'andres9802', 'andrestrujillo098', 'juandavid97', 'lf.correa10', 'hectordavidpulido', 'jupalinar17', None, 'te.vence10', 'isabella', 'jfgf11', 'diegobb', 'f.escallonp', 'vanessamovilla', 'juan_camilo', 'eduardmolano']",35,"['jufepas98', 'rdcajr', 'jesusvillamizar', 'raquelalejandra', 'erikananiela', 'yeju16', 'sa.sanchez', 'we.simancas10', 'andresfdt.2k8', 'duodinamico', 'brayant', 'jdmedinatobon', 'dadelapa321', 'sd.diaz', 'af.vera10', 'lauradnc15', 'j.wilckenlecompte', 'fabser7', 'rf.ruiz10', 'andres9802', 'andrestrujillo098', 'juandavid97', 'lf.correa10', 'hectordavidpulido', 'jupalinar17', 'labiele2206', None, 'te.vence10', 'isabella', 'jfgf11', 'diegobb', 'f.escallonp', 'vanessamovilla', 'juan_camilo', 'eduardmolano']"
104,219,8,30,7,"['sd.diaz', 'andresfdt.2k8', 'rdcajr', 'raquelalejandra', 'brayant', 'sa.sanchez', 'labiele2206']",0,[],23,"['juliantecnologic', 'na.diaz', 'cy.andrade', 'dssv99', 'ja.forero15', 'numumero', 'nata.quintero3098', 'anamis_forero', 'velajua', 'pabloccr', 'miguel1003', 'danielcusva', 'miguell98md', 'ivanrulik', 'bryanc121297', 'kamilongis1', 'a.ricci10', None, 'carlos2992', 'crisdavbed08', 'ksgutierrez', 'electroniccasalins96', 'camilom']",30,"['juliantecnologic', 'na.diaz', 'rdcajr', 'raquelalejandra', 'cy.andrade', 'dssv99', 'ja.forero15', 'sa.sanchez', 'numumero', 'andresfdt.2k8', 'nata.quintero3098', 'brayant', 'anamis_forero', 'sd.diaz', 'velajua', 'pabloccr', 'miguel1003', 'danielcusva', 'miguell98md', 'ivanrulik', 'bryanc121297', 'kamilongis1', 'a.ricci10', 'labiele2206', None, 'carlos2992', 'crisdavbed08', 'ksgutierrez', 'electroniccasalins96', 'camilom']"
104,119,8,8,7,"['sd.diaz', 'andresfdt.2k8', 'rdcajr', 'raquelalejandra', 'brayant', 'sa.sanchez', 'labiele2206']",0,[],1,[None],8,"['sd.diaz', 'andresfdt.2k8', None, 'rdcajr', 'raquelalejandra', 'brayant', 'sa.sanchez', 'labiele2206']"
105,216,8,8,7,"['anitadey12', 's.arutwar', 'surabhi23', 'ameyc007', 'vipul123', 'siddheshgothankar', 'shirishparkhe']",0,[],1,[None],8,"['anitadey12', 'ameyc007', 'surabhi23', 'shirishparkhe', 'vipul123', 'siddheshgothankar', None, 's.arutwar']"
105,335,8,8,7,"['anitadey12', 's.arutwar', 'surabhi23', 'ameyc007', 'vipul123', 'siddheshgothankar', 'shirishparkhe']",0,[],1,[None],8,"['anitadey12', 'ameyc007', 'surabhi23', 'shirishparkhe', 'vipul123', 'siddheshgothankar', None, 's.arutwar']"
106,329,8,16,7,"['ashish.waghule', 'trishala.dixit', 'prathamesh.chaudhari', 'saurabh.kurhe', 'bhiva.gawade', 'jyoti30', 'darshana.jain']",0,[],9,"[None, 'gayatri.devadiga', 'ej2012.abhishek.bane', 'hitenmalkani', 'virendra.wagh', 'falguni.pawar', 'gaurav.mahajan', 'aishwarya.kadam', 'rahul.yadav']",16,"['trishala.dixit', 'virendra.wagh', 'gaurav.mahajan', None, 'falguni.pawar', 'darshana.jain', 'ashish.waghule', 'gayatri.devadiga', 'ej2012.abhishek.bane', 'prathamesh.chaudhari', 'saurabh.kurhe', 'hitenmalkani', 'bhiva.gawade', 'jyoti30', 'aishwarya.kadam', 'rahul.yadav']"
108,274,8,11,7,"['vlad_iodo', 'io12345', 'misik.sashamiskoblr', 'mralexslbc', 'tripletwo567', 'jullietg', 'yura.menschikov']",0,[],4,"['kamockia', None, 'cr_zy', 'zapdmitry']",11,"['vlad_iodo', 'misik.sashamiskoblr', 'zapdmitry', 'mralexslbc', 'tripletwo567', 'yura.menschikov', 'kamockia', None, 'io12345', 'cr_zy', 'jullietg']"
109,361,8,45,7,"['aarifahhaque02', 'faizan_ned', 'arubarashid123', 'm.usman', 'hassam', 'rimal.ozair16', 'farooque73']",0,[],38,"['mishaim', 'hamzaaleem1', 'nidayousuf25', 'aqsakhan', 'alizeshan', 'namrahkhan', 'usama.ned079', 'shshrukhsyed', 'munamfarooqui2244', 'shahram95', 'hmasqureshi', 'ahmed_raza96', 'ayeshaarshad', 'jahangir1994', 'wajeehaiqbal5', 'shujjat', 'naseerhakeem8', 'sajadali001', 'umerkhan95', 'ssd2017', 'don_carlos1995', 'azkahaq', 'naihapervez', 'aqsanaz444657', None, 'aymenbatool98', 'arooba', 'iffatiqbal', 'salikhassan', 'shriya17', 'misbah', 'jamalamasil2612', 'mavarakamal', 'maheenmazharkhan', 'faisalraza', 'engineer94', 'imaad', 'jado_96']",45,"['mishaim', 'hamzaaleem1', 'nidayousuf25', 'aqsakhan', 'alizeshan', 'namrahkhan', 'usama.ned079', 'shshrukhsyed', 'munamfarooqui2244', 'shahram95', 'hmasqureshi', 'ahmed_raza96', 'ayeshaarshad', 'jahangir1994', 'wajeehaiqbal5', 'shujjat', 'naseerhakeem8', 'arubarashid123', 'hassam', 'farooque73', 'aarifahhaque02', 'sajadali001', 'umerkhan95', 'ssd2017', 'faizan_ned', 'don_carlos1995', 'azkahaq', 'naihapervez', 'm.usman', 'aqsanaz444657', None, 'rimal.ozair16', 'aymenbatool98', 'arooba', 'iffatiqbal', 'salikhassan', 'shriya17', 'misbah', 'jamalamasil2612', 'mavarakamal', 'maheenmazharkhan', 'faisalraza', 'engineer94', 'imaad', 'jado_96']"
109,301,8,36,5,"['faizan_ned', 'arubarashid123', 'hassam', 'rimal.ozair16', 'farooque73']",2,"['aarifahhaque02', 'm.usman']",31,"['mishaim', 'hamzaaleem1', 'nidayousuf25', 'ayesharashid', 'aqsakhan', 'namrahkhan', 'munamfarooqui2244', 'ayeshakhan.2907', 'saqibalisidd', 'wajeehaiqbal5', 'wardaishrat', 'naseerhakeem8', 'abdurrehman', 'ramshaiqbal3', 'aroomah', 'sajadali001', 'actec', 'ssd2017', 'azkahaq', 'naihapervez', 'aqsanaz444657', None, 'rabat', 'aymenbatool98', 'iffatiqbal', 'arooba', 'shriya17', 'misbah', 'jamalamasil2612', 'mavarakamal', 'arifali013']",38,"['mishaim', 'hamzaaleem1', 'nidayousuf25', 'ayesharashid', 'aqsakhan', 'namrahkhan', 'munamfarooqui2244', 'ayeshakhan.2907', 'saqibalisidd', 'wajeehaiqbal5', 'wardaishrat', 'naseerhakeem8', 'arubarashid123', 'hassam', 'abdurrehman', 'ramshaiqbal3', 'aroomah', 'farooque73', 'aarifahhaque02', 'sajadali001', 'actec', 'ssd2017', 'faizan_ned', 'azkahaq', 'naihapervez', 'm.usman', 'aqsanaz444657', None, 'rimal.ozair16', 'rabat', 'aymenbatool98', 'iffatiqbal', 'arooba', 'shriya17', 'misbah', 'jamalamasil2612', 'mavarakamal', 'arifali013']"
110,103,8,9,7,"['eksaath2', 'calbers2', 'bowang12', 'chemaly2', 'xlz.287', 'zhetang2', 'billliyanye']",0,[],2,"[None, 'sophiampersand']",9,"['eksaath2', 'sophiampersand', None, 'billliyanye', 'calbers2', 'bowang12', 'chemaly2', 'xlz.287', 'zhetang2']"
112,69,8,44,1,['rohitwaghmare1997'],6,"['siddharthnair', 'sangeetamjoshi', 'pai.nivalkar', 'vishalgpt579', 'omkarkhot73', 'nikhilmore']",43,"['surbhib2897', 'techn720ab', 'keshvis26', 'pinakin', 'rajeshreesawale', 'shrinishdonde', 'mananmehta95', 'neha0206', 'yashjivrajani7799', 'kumarkhandagle33', 'aagamshah999999999', 'sahil.sawant031996', 'vora.jai1', 'shreyasshah14', 'sheetalchaudhari2210', 'divyavkhandkar.me', 'tripathishivam342', 'pallavi.valunj', 'tanvishah2410', 'pooja9702.pm', 'tanvinj1', 'prerana', 'aditik2107', 'adityaprakash41', 'alwin1996', 'vidur888', 'mehulkharvi7', 'chaitalivartak07', 'raj.vadariya', 'manassardar4444122', 'vandortshakti', None, 'ketan.db', 'rohitw0606', 'k25', 'rubina15', 'panchalparth417', 'aniruddhaparte3', 'niveshvaze', 'boy_with_nikon', 'ankitpandey1296', 'devashishmore478', 'meghana.loke02']",50,"['surbhib2897', 'techn720ab', 'rohitwaghmare1997', 'keshvis26', 'pai.nivalkar', 'pinakin', 'vishalgpt579', 'rajeshreesawale', 'shrinishdonde', 'mananmehta95', 'neha0206', 'yashjivrajani7799', 'kumarkhandagle33', 'aagamshah999999999', 'sahil.sawant031996', 'vora.jai1', 'sangeetamjoshi', 'shreyasshah14', 'sheetalchaudhari2210', 'divyavkhandkar.me', 'tripathishivam342', 'pallavi.valunj', 'nikhilmore', 'tanvishah2410', 'pooja9702.pm', 'tanvinj1', 'prerana', 'aditik2107', 'adityaprakash41', 'alwin1996', 'vidur888', 'mehulkharvi7', 'chaitalivartak07', 'raj.vadariya', 'manassardar4444122', 'vandortshakti', 'omkarkhot73', None, 'ketan.db', 'rohitw0606', 'siddharthnair', 'k25', 'rubina15', 'panchalparth417', 'aniruddhaparte3', 'niveshvaze', 'boy_with_nikon', 'ankitpandey1296', 'devashishmore478', 'meghana.loke02']"
112,70,8,38,3,"['siddharthnair', 'nikhilmore', 'pai.nivalkar']",4,"['vishalgpt579', 'rohitwaghmare1997', 'sangeetamjoshi', 'omkarkhot73']",35,"['sujaydandekar', 'lbpatil9', 'wadekar.teja1995', 'ankit2896', 'prasad622444', 'tusharshetty421', 'girishgholap', 'snehap2013', 'siddhivadhwana22', 'pinky1234', 'akashk07', 'lekhashewale92', 'pranjalipatil2896', 'akshaymeshram4', 'nikhil421301', 'roshanmore0903', 'laukiktikam333', 'nisha08', 'harshali263', 'sarveshgupta333', 'surajmahendrarai', 'prashannt123', 'sumeet97', 'aishwaryanair29', None, 'hastimalpaliwal', 'mohakbheda1', 'akashnemade16', 'priyamahajan', 'shraddha0306', 'omkarpt1996', 'ajaykarande96', 'sonaliphadale94', 'saurabh123', 'kushaal']",42,"['sujaydandekar', 'lbpatil9', 'wadekar.teja1995', 'rohitwaghmare1997', 'ankit2896', 'pai.nivalkar', 'vishalgpt579', 'prasad622444', 'tusharshetty421', 'girishgholap', 'snehap2013', 'siddhivadhwana22', 'pinky1234', 'sangeetamjoshi', 'akashk07', 'lekhashewale92', 'pranjalipatil2896', 'akshaymeshram4', 'nikhil421301', 'roshanmore0903', 'nikhilmore', 'laukiktikam333', 'nisha08', 'harshali263', 'sarveshgupta333', 'surajmahendrarai', 'omkarkhot73', 'prashannt123', 'sumeet97', 'aishwaryanair29', None, 'hastimalpaliwal', 'mohakbheda1', 'siddharthnair', 'akashnemade16', 'priyamahajan', 'shraddha0306', 'omkarpt1996', 'ajaykarande96', 'sonaliphadale94', 'saurabh123', 'kushaal']"
112,266,8,15,3,"['vishalgpt579', 'sangeetamjoshi', 'omkarkhot73']",4,"['rohitwaghmare1997', 'siddharthnair', 'nikhilmore', 'pai.nivalkar']",12,"['snnakaskar97', 'surbhib2897', 'kshemkalyanimanjiri11', 'satsamjr', 'sachinwaykar1596', 'sinalkarshweta5', 'adityawasekar11', 'aniruddhaparte3', 'santoshiparab11', 'mounikajalla99', None, 'akshay1997bhagit']",19,"['surbhib2897', 'rohitwaghmare1997', 'kshemkalyanimanjiri11', 'pai.nivalkar', 'adityawasekar11', 'vishalgpt579', 'mounikajalla99', 'omkarkhot73', None, 'snnakaskar97', 'siddharthnair', 'sangeetamjoshi', 'satsamjr', 'sachinwaykar1596', 'sinalkarshweta5', 'aniruddhaparte3', 'santoshiparab11', 'akshay1997bhagit', 'nikhilmore']"
112,71,8,11,2,"['omkarkhot73', 'vishalgpt579']",5,"['siddharthnair', 'rohitwaghmare1997', 'sangeetamjoshi', 'pai.nivalkar', 'nikhilmore']",9,"['ranegirish24', 'snnakaskar97', 'satsamjr', 'adityawasekar11', 'vedankasalunke96', 'aniruddhaparte3', 'santoshiparab11', None, 'akshay1997bhagit']",16,"['ranegirish24', 'rohitwaghmare1997', 'pai.nivalkar', 'adityawasekar11', 'vishalgpt579', 'vedankasalunke96', 'omkarkhot73', None, 'snnakaskar97', 'siddharthnair', 'sangeetamjoshi', 'satsamjr', 'aniruddhaparte3', 'santoshiparab11', 'akshay1997bhagit', 'nikhilmore']"
112,263,8,9,3,"['siddharthnair', 'nikhilmore', 'pai.nivalkar']",4,"['vishalgpt579', 'rohitwaghmare1997', 'sangeetamjoshi', 'omkarkhot73']",6,"['shraddha0306', 'akashnemade16', 'nisha08', 'prasad622444', 'surajmahendrarai', None]",13,"['nisha08', 'rohitwaghmare1997', 'pai.nivalkar', 'vishalgpt579', 'prasad622444', 'surajmahendrarai', 'omkarkhot73', None, 'shraddha0306', 'siddharthnair', 'akashnemade16', 'sangeetamjoshi', 'nikhilmore']"
113,64,8,92,5,"['bharatesh.a', 'shally', 'yuvraj.t', 'shrey.joshi', 'ketan.db']",2,"['nirav.lm', 'ankit.pandey']",87,"['tejalnaik12', 'abhaskar31', 'vinayakgadkari8', 'karar.bhadreshwara', 'keshvis26', 'akashborhade123', 'naikpratiksha510', 'singhrajkarn1699', 'abhijitharidas3107', 'yashjivrajani7799', 'kkiran31', 'amolgolwankar', 'pratik007', 'mayanair1104', 'prajoth.fernandes', 'shibssalian', 'kadampk15ex', 'shreyas.v', 'smriti.sivadas96', 'aadi', 'alwin1996', 'suhayl4k', 'gvishs15', 'pguleria', 'sakshijoshi', 'kmamaniya', 'tejdhupkar', 'shubhamgharat274', 'rashmithanair5', 'deeptimenon', 'pratik.gc', 'chinmaysj96', 'danieldsilva96', 'cmahale95', 'akarnik.13', 'mayureshnagvekar57', 'aditya332', 'sumasalian96', 'inderjitsingh87', 'rnair10', 'chinmaygawas', 'varunmullins', 'divya.shinde', 'temp999use', 'livz944', 'bpatel03', 'salianyatish111', 'jobin301', 'kumarkhandagle33', 'samsonkajar', 'kharadesonam', 'anjali.kalmase', 'apurva.nehru', 'ralph.rodrigues69', 'poojanale1996', 'pranjal17', 'eshani2396', 'meet7', 'mkhanvilkar', 'dghosalkar', 'varunndabhade', 'prajwal.angolkar4', 'pravingowda28', 'mayank.vp', 'bnrnirmal94', 'npnishankpednekar', 'raj.vadariya', None, 'pjay10708', 'gsatpute64', 'krexianclass', 'css_', 'jonathanrjpereira', 'yashgosar9', 'moraeseric123', 'rubina15', 'adityagudla96', 'dheereshpoojary', 'sukhpreet11234kldfhd', 'nishumahapatro1995', 'pratik2225', 'cristyjne8', 'aniruddhaparte3', 'srevolution23', 'saniyasnair', 'ashpillai.1996', 'shrutis31']",94,"['tejalnaik12', 'abhaskar31', 'vinayakgadkari8', 'karar.bhadreshwara', 'keshvis26', 'akashborhade123', 'naikpratiksha510', 'singhrajkarn1699', 'abhijitharidas3107', 'ashpillai.1996', 'yuvraj.t', 'yashjivrajani7799', 'kkiran31', 'amolgolwankar', 'pratik007', 'mayanair1104', 'prajoth.fernandes', 'shibssalian', 'kadampk15ex', 'shreyas.v', 'smriti.sivadas96', 'aadi', 'alwin1996', 'suhayl4k', 'gvishs15', 'pguleria', 'sakshijoshi', 'kmamaniya', 'tejdhupkar', 'shubhamgharat274', 'rashmithanair5', 'deeptimenon', 'ketan.db', 'pratik.gc', 'chinmaysj96', 'danieldsilva96', 'cmahale95', 'akarnik.13', 'mayureshnagvekar57', 'aditya332', 'sumasalian96', 'inderjitsingh87', 'rnair10', 'chinmaygawas', 'varunmullins', 'divya.shinde', 'temp999use', 'livz944', 'bpatel03', 'salianyatish111', 'jobin301', 'shrey.joshi', 'kumarkhandagle33', 'samsonkajar', 'kharadesonam', 'anjali.kalmase', 'ankit.pandey', 'apurva.nehru', 'ralph.rodrigues69', 'poojanale1996', 'pranjal17', 'eshani2396', 'meet7', 'mkhanvilkar', 'dghosalkar', 'varunndabhade', 'prajwal.angolkar4', 'pravingowda28', 'mayank.vp', 'bnrnirmal94', 'npnishankpednekar', 'raj.vadariya', None, 'pjay10708', 'nirav.lm', 'gsatpute64', 'css_', 'krexianclass', 'jonathanrjpereira', 'yashgosar9', 'moraeseric123', 'rubina15', 'adityagudla96', 'dheereshpoojary', 'sukhpreet11234kldfhd', 'nishumahapatro1995', 'pratik2225', 'bharatesh.a', 'cristyjne8', 'aniruddhaparte3', 'srevolution23', 'saniyasnair', 'shally', 'shrutis31']"
113,60,8,59,3,"['nirav.lm', 'ankit.pandey', 'ketan.db']",4,"['bharatesh.a', 'shally', 'yuvraj.t', 'shrey.joshi']",56,"['vivekrana', 'rahul.baddi', 'pbhaveshv15et', 'deepalisas13', 'roshusakpal89', 'tanmay9', 'vinayakgadkari8', 'gnthakore', 'divya.shinde', 'brarath.nihal', 'pradhantn11e', 'varunmullins', 'suyash.sc', 'pallavivalunj', 'pratimadas1996', 'peterbraganza52', '1996jaypatel', 'mugdhas2030', 'spawar09', 'vaibhavkokare2011', 'adsoni468', 'stevenevendsouza23', 'sneha469', 'tushar.wadhaval', 'meet7', 'pateltejash96', 'sahilboble25', 'chahat.s', 'spodal24', 'sjayyant31', 'seemam', 'senmathew329', 'jmihavel', 'mayank.vp', 'kmamaniya', 'dhruv16', 'samuelalmeida17', 'raj.vadariya', 'shubhamgharat274', 'singh5987', 'sonali.ramji', None, 'aditi.adilip', 'dshaikh4', 'prachiamrutkar16', 'krexianclass', 'vaishak', 'murzellobenz', 'vvipul31', 'ninawe14', 'treesaachu', 'marcmathew', 'ssatendra31', 'vaibhavnagar08', 'yashuishwar', 'yadavsandeep793']",63,"['rahul.baddi', 'deepalisas13', 'tanmay9', 'vinayakgadkari8', 'suyash.sc', 'pallavivalunj', 'yuvraj.t', 'pratimadas1996', 'peterbraganza52', 'mugdhas2030', 'spawar09', 'vaibhavkokare2011', 'sahilboble25', 'seemam', 'senmathew329', 'jmihavel', 'kmamaniya', 'dhruv16', 'samuelalmeida17', 'shubhamgharat274', 'singh5987', 'ketan.db', 'dshaikh4', 'vaishak', 'vvipul31', 'marcmathew', 'vaibhavnagar08', 'yashuishwar', 'yadavsandeep793', 'vivekrana', 'pbhaveshv15et', 'roshusakpal89', 'varunmullins', 'gnthakore', 'divya.shinde', 'brarath.nihal', 'pradhantn11e', 'shrey.joshi', 'ankit.pandey', '1996jaypatel', 'adsoni468', 'stevenevendsouza23', 'sneha469', 'tushar.wadhaval', 'meet7', 'pateltejash96', 'chahat.s', 'spodal24', 'sjayyant31', 'mayank.vp', 'raj.vadariya', 'sonali.ramji', None, 'aditi.adilip', 'nirav.lm', 'prachiamrutkar16', 'krexianclass', 'murzellobenz', 'ninawe14', 'bharatesh.a', 'treesaachu', 'ssatendra31', 'shally']"
113,58,8,58,2,"['shally', 'yuvraj.t']",5,"['nirav.lm', 'ankit.pandey', 'bharatesh.a', 'shrey.joshi', 'ketan.db']",56,"['vivekrana', 'priyankamali2510', 'pbhaveshv15et', 'salaskarsu15', 'roshusakpal89', 'orenavikar', 'parineetap0', 'tanmay9', 'milind123', 'gnthakore', 'deepalisingh195', 'sushmafn', 'ssmande', 'shubham.patil585', 'vishurajigare10', 'krunal.kasar', 'samirbobade', 'pratik007', 'yadavsandeep793', 'vishal914', 'k.gauswami', 'uyewale', 'ralph.rodrigues69', 'spawar09', 'vaitysushant', 'sagarika260710', 'patil.chinmay04', 'svirendra31', 'pranjal17', 'pateltejash96', 'sahilboble25', 'chahat.s', 'spodal24', 'sjayyant31', 'rasalvc15ex', 'skomald118', 'mayank.vp', 'raj.vadariya', 'nabhishek29', 'mdeshmukh', 'nikam468', 'sayali_m9', None, 'pratik.gc', 'dshaikh4', 'jonathanrjpereira', 'vaishak', 'nivedita', 'rubina15', 'vvipul31', 'jas.sahmbi123', 'ankitpandey1296', 'anil8796069443', 'juili.save', 'akhil.shetty37', 'shubhampatil2308']",63,"['priyankamali2510', 'salaskarsu15', 'tanmay9', 'sushmafn', 'shubham.patil585', 'vishurajigare10', 'yuvraj.t', 'pratik007', 'vishal914', 'k.gauswami', 'uyewale', 'spawar09', 'patil.chinmay04', 'sahilboble25', 'skomald118', 'nikam468', 'sayali_m9', 'ketan.db', 'pratik.gc', 'dshaikh4', 'vaishak', 'nivedita', 'vvipul31', 'jas.sahmbi123', 'ankitpandey1296', 'anil8796069443', 'yadavsandeep793', 'shubhampatil2308', 'vivekrana', 'pbhaveshv15et', 'parineetap0', 'roshusakpal89', 'orenavikar', 'milind123', 'gnthakore', 'deepalisingh195', 'ssmande', 'samirbobade', 'krunal.kasar', 'shrey.joshi', 'ankit.pandey', 'ralph.rodrigues69', 'akhil.shetty37', 'vaitysushant', 'sagarika260710', 'svirendra31', 'pranjal17', 'pateltejash96', 'chahat.s', 'spodal24', 'sjayyant31', 'rasalvc15ex', 'mayank.vp', 'raj.vadariya', 'nabhishek29', 'mdeshmukh', None, 'nirav.lm', 'jonathanrjpereira', 'rubina15', 'bharatesh.a', 'juili.save', 'shally']"
113,56,8,50,4,"['yuvraj.t', 'bharatesh.a', 'nirav.lm', 'shrey.joshi']",3,"['shally', 'ankit.pandey', 'ketan.db']",46,"['priyankamali2510', 'prakshat095', 'tanmay9', 'milind123', 'gnthakore', 'raj.misal', 'sakshi.mandot', 'mugdhabhat1997', 'mkharkar', 'adnan.s', 'ssmande', 'samirbobade', 'krunal.kasar', 'gaurav.mishra', 'k.gauswami', 'uyewale', 'vishalnaik.0210', 'vaitysushant', 'diksharth', 'shreyas.v', 'dkbathe29', 'niranjanbhavsar2491996', 'pateltejash96', 'waynemdsouza', 'sahilboble25', 'mkhanvilkar', 'dghosalkar', 'suhayl4k', 'seemam', 'mahajanyashashree19', 'mayank.vp', 'pravingowda28', 'samuelalmeida17', 'mdeshmukh', 'nairabhi1571996', 'sayali_m9', None, 'pratik.gc', 'pjay10708', 'vaishak', 'nivedita', 'aadi1212', 'naina', 'anil8796069443', 'zil.c', 'yadavsandeep793']",53,"['priyankamali2510', 'prakshat095', 'tanmay9', 'milind123', 'gnthakore', 'raj.misal', 'sakshi.mandot', 'mugdhabhat1997', 'mkharkar', 'adnan.s', 'ssmande', 'samirbobade', 'yuvraj.t', 'shrey.joshi', 'krunal.kasar', 'gaurav.mishra', 'ankit.pandey', 'k.gauswami', 'uyewale', 'vishalnaik.0210', 'vaitysushant', 'diksharth', 'shreyas.v', 'dkbathe29', 'niranjanbhavsar2491996', 'pateltejash96', 'waynemdsouza', 'sahilboble25', 'mkhanvilkar', 'dghosalkar', 'suhayl4k', 'seemam', 'mahajanyashashree19', 'mayank.vp', 'pravingowda28', 'samuelalmeida17', 'mdeshmukh', 'nairabhi1571996', 'sayali_m9', None, 'ketan.db', 'pratik.gc', 'pjay10708', 'nirav.lm', 'vaishak', 'nivedita', 'bharatesh.a', 'aadi1212', 'naina', 'anil8796069443', 'shally', 'zil.c', 'yadavsandeep793']"
113,69,8,44,1,['ketan.db'],6,"['nirav.lm', 'ankit.pandey', 'bharatesh.a', 'shally', 'yuvraj.t', 'shrey.joshi']",43,"['surbhib2897', 'techn720ab', 'rohitwaghmare1997', 'keshvis26', 'pinakin', 'rajeshreesawale', 'shrinishdonde', 'mananmehta95', 'neha0206', 'yashjivrajani7799', 'kumarkhandagle33', 'aagamshah999999999', 'sahil.sawant031996', 'vora.jai1', 'shreyasshah14', 'sheetalchaudhari2210', 'divyavkhandkar.me', 'tripathishivam342', 'pallavi.valunj', 'tanvishah2410', 'pooja9702.pm', 'tanvinj1', 'prerana', 'aditik2107', 'adityaprakash41', 'alwin1996', 'vidur888', 'mehulkharvi7', 'chaitalivartak07', 'raj.vadariya', 'manassardar4444122', 'vandortshakti', None, 'rohitw0606', 'k25', 'rubina15', 'panchalparth417', 'aniruddhaparte3', 'niveshvaze', 'boy_with_nikon', 'ankitpandey1296', 'devashishmore478', 'meghana.loke02']",50,"['surbhib2897', 'techn720ab', 'rohitwaghmare1997', 'keshvis26', 'pinakin', 'rajeshreesawale', 'shrinishdonde', 'mananmehta95', 'neha0206', 'yuvraj.t', 'shrey.joshi', 'yashjivrajani7799', 'kumarkhandagle33', 'aagamshah999999999', 'sahil.sawant031996', 'ankit.pandey', 'vora.jai1', 'shreyasshah14', 'sheetalchaudhari2210', 'divyavkhandkar.me', 'tripathishivam342', 'pallavi.valunj', 'tanvishah2410', 'pooja9702.pm', 'tanvinj1', 'prerana', 'aditik2107', 'adityaprakash41', 'alwin1996', 'vidur888', 'mehulkharvi7', 'chaitalivartak07', 'raj.vadariya', 'manassardar4444122', 'vandortshakti', None, 'ketan.db', 'nirav.lm', 'rohitw0606', 'k25', 'rubina15', 'panchalparth417', 'bharatesh.a', 'aniruddhaparte3', 'niveshvaze', 'boy_with_nikon', 'ankitpandey1296', 'devashishmore478', 'shally', 'meghana.loke02']"
113,173,8,44,6,"['nirav.lm', 'ankit.pandey', 'bharatesh.a', 'yuvraj.t', 'shrey.joshi', 'ketan.db']",1,['shally'],38,"['jinal.sarvaiya.js', 'ruchira_ghule', 'keshvis26', 'rajeshreesawale', 'moreashank2', 'abhijitharidas3107', 'kumarkhandagle33', 'meghana.loke02', 'amolgolwankar', 'kharadesonam', 'anjali.kalmase', 'sahil.sawant031996', 'apurva.nehru', 'tinu', 'sheetalchaudhari2210', 'pallavi.valunj', 'sagarika260710', 'pranjal17', 'pooja9702.pm', 'alwin1996', 'npnishankpednekar', 'kaushalmalaviya5', 'chaitalivartak07', 'raj.vadariya', 'coolsprathamesh21', 'hamad42623', None, 'pragatidhekale', 'jonathanrjpereira', 'css_', 'rubina15', 'niveshvaze', 'srevolution23', 'aditya332', 'juili.save', 'sumasalian96', 'saniyasnair', 'harshnsavla']",45,"['jinal.sarvaiya.js', 'ruchira_ghule', 'keshvis26', 'rajeshreesawale', 'moreashank2', 'abhijitharidas3107', 'yuvraj.t', 'shrey.joshi', 'kumarkhandagle33', 'amolgolwankar', 'kharadesonam', 'anjali.kalmase', 'sahil.sawant031996', 'ankit.pandey', 'apurva.nehru', 'tinu', 'sheetalchaudhari2210', 'pallavi.valunj', 'sagarika260710', 'pranjal17', 'pooja9702.pm', 'alwin1996', 'npnishankpednekar', 'kaushalmalaviya5', 'chaitalivartak07', 'raj.vadariya', 'coolsprathamesh21', 'hamad42623', None, 'pragatidhekale', 'ketan.db', 'nirav.lm', 'jonathanrjpereira', 'css_', 'harshnsavla', 'rubina15', 'bharatesh.a', 'niveshvaze', 'srevolution23', 'aditya332', 'juili.save', 'sumasalian96', 'saniyasnair', 'shally', 'meghana.loke02']"
113,63,8,15,2,"['shally', 'shrey.joshi']",5,"['nirav.lm', 'ankit.pandey', 'bharatesh.a', 'yuvraj.t', 'ketan.db']",13,"['pratik007', 'gsatpute64', 'jonathanrjpereira', 'apurva.nehru', 'rubina15', 'chinmaysj96', 'temp999use', 'marcmathew', 'shubhamgharat274', 'eshani2396', 'pranjal17', None, 'pratik.gc']",20,"['temp999use', 'shubhamgharat274', 'eshani2396', 'yuvraj.t', 'shrey.joshi', None, 'ketan.db', 'pratik.gc', 'pratik007', 'nirav.lm', 'gsatpute64', 'jonathanrjpereira', 'ankit.pandey', 'apurva.nehru', 'rubina15', 'chinmaysj96', 'bharatesh.a', 'marcmathew', 'shally', 'pranjal17']"
113,174,8,13,1,['shally'],6,"['nirav.lm', 'ankit.pandey', 'bharatesh.a', 'yuvraj.t', 'shrey.joshi', 'ketan.db']",12,"['ruchi61', 'anjali.kalmase', 'neetavarkute', 'apurva.nehru', 'tinu', 'rubina15', 'temp999use', 'coolsprathamesh21', 'juili.save', 'aditya332', 'pranjal17', None]",19,"['ruchi61', 'neetavarkute', 'temp999use', 'coolsprathamesh21', 'yuvraj.t', 'shrey.joshi', None, 'ketan.db', 'nirav.lm', 'anjali.kalmase', 'ankit.pandey', 'apurva.nehru', 'tinu', 'rubina15', 'bharatesh.a', 'aditya332', 'juili.save', 'shally', 'pranjal17']"
113,171,8,8,1,['shally'],6,"['nirav.lm', 'ankit.pandey', 'bharatesh.a', 'yuvraj.t', 'shrey.joshi', 'ketan.db']",7,"['samsonkajar', 'ralph.rodrigues69', 'vinayakgadkari8', 'karar.bhadreshwara', 'livz944', 'aditya332', None]",14,"['samsonkajar', 'nirav.lm', None, 'ankit.pandey', 'ralph.rodrigues69', 'vinayakgadkari8', 'karar.bhadreshwara', 'bharatesh.a', 'livz944', 'aditya332', 'shally', 'yuvraj.t', 'shrey.joshi', 'ketan.db']"
114,398,8,7,5,"['sabarnochowdhury', 'soumajit', 'sovanmb94', 'arindam.ray', 'vlsi_12']",2,"['drkarthik747', 'saisuhas147']",2,"[None, 'kaunaj06']",9,"['sabarnochowdhury', 'soumajit', 'kaunaj06', 'drkarthik747', 'sovanmb94', 'arindam.ray', None, 'vlsi_12', 'saisuhas147']"
116,236,7,9,6,"['yg94026', 'adityashahn60', 'shahbazshaikh599', 'theomkar', 'bhumikagor', 'bhattitejas77']",0,[],3,"['rohan1903', None, 'tateakshay']",9,"['rohan1903', 'yg94026', 'tateakshay', 'adityashahn60', 'shahbazshaikh599', 'theomkar', 'bhumikagor', None, 'bhattitejas77']"
116,250,7,9,6,"['yg94026', 'adityashahn60', 'shahbazshaikh599', 'theomkar', 'bhumikagor', 'bhattitejas77']",0,[],3,"['rohan1903', None, 'tateakshay']",9,"['rohan1903', 'yg94026', 'tateakshay', 'adityashahn60', 'shahbazshaikh599', 'theomkar', 'bhumikagor', None, 'bhattitejas77']"
117,135,7,8,3,"['priyankamuley315', 'saurabh.dakhore', 'nirmol882']",3,"['swatibhandarkar96', 'aditigosavi14', 'tushar.dhatinge']",5,"['ashish.gopal', 'palukuru.g', 'sidharth1994', 'varunkurup2', None]",11,"['swatibhandarkar96', 'priyankamuley315', None, 'ashish.gopal', 'aditigosavi14', 'tushar.dhatinge', 'palukuru.g', 'sidharth1994', 'varunkurup2', 'saurabh.dakhore', 'nirmol882']"
117,136,7,8,5,"['swatibhandarkar96', 'priyankamuley315', 'aditigosavi14', 'tushar.dhatinge', 'saurabh.dakhore']",1,['nirmol882'],3,"['chaitali.gajankush99', None, 'ashish.gopal']",9,"['swatibhandarkar96', 'priyankamuley315', None, 'ashish.gopal', 'chaitali.gajankush99', 'aditigosavi14', 'tushar.dhatinge', 'saurabh.dakhore', 'nirmol882']"
118,137,7,23,6,"['gabrielmelguizo', 'rafrubgar95', 'alicorrgonz', 'raul_mulguer', 'emigoca14', 'joseluiscastroarroyo95']",0,[],17,"['pedromaldonadoinfante', 'jrosa', 'ratmnietzsche', 'elisabetsinh', 'armandomanuellopez93', 'pablosanchezcid', 'aalfgvm', 'josecarlos', 'b.ortin.vinader', 'f.j.sanchez19', 'claferlop', 'raquelcano.96', 'elena_aldeanueva', 'javi94x', 'mercedesruiz994', 'ajsalas', None]",23,"['gabrielmelguizo', 'jrosa', 'rafrubgar95', 'armandomanuellopez93', 'b.ortin.vinader', 'raul_mulguer', 'emigoca14', 'mercedesruiz994', None, 'pedromaldonadoinfante', 'ratmnietzsche', 'elisabetsinh', 'alicorrgonz', 'pablosanchezcid', 'aalfgvm', 'josecarlos', 'elena_aldeanueva', 'f.j.sanchez19', 'claferlop', 'raquelcano.96', 'javi94x', 'ajsalas', 'joseluiscastroarroyo95']"
118,169,7,23,6,"['gabrielmelguizo', 'rafrubgar95', 'alicorrgonz', 'raul_mulguer', 'emigoca14', 'joseluiscastroarroyo95']",0,[],17,"['pedromaldonadoinfante', 'jrosa', 'ratmnietzsche', 'elisabetsinh', 'armandomanuellopez93', 'pablosanchezcid', 'aalfgvm', 'josecarlos', 'b.ortin.vinader', 'f.j.sanchez19', 'claferlop', 'raquelcano.96', 'elena_aldeanueva', 'javi94x', 'mercedesruiz994', 'ajsalas', None]",23,"['gabrielmelguizo', 'jrosa', 'rafrubgar95', 'armandomanuellopez93', 'b.ortin.vinader', 'raul_mulguer', 'emigoca14', 'mercedesruiz994', None, 'pedromaldonadoinfante', 'ratmnietzsche', 'elisabetsinh', 'alicorrgonz', 'pablosanchezcid', 'aalfgvm', 'josecarlos', 'elena_aldeanueva', 'f.j.sanchez19', 'claferlop', 'raquelcano.96', 'javi94x', 'ajsalas', 'joseluiscastroarroyo95']"
118,325,7,23,6,"['gabrielmelguizo', 'rafrubgar95', 'alicorrgonz', 'raul_mulguer', 'emigoca14', 'joseluiscastroarroyo95']",0,[],17,"['pedromaldonadoinfante', 'jrosa', 'ratmnietzsche', 'elisabetsinh', 'armandomanuellopez93', 'pablosanchezcid', 'aalfgvm', 'josecarlos', 'b.ortin.vinader', 'f.j.sanchez19', 'claferlop', 'raquelcano.96', 'elena_aldeanueva', 'javi94x', 'mercedesruiz994', 'ajsalas', None]",23,"['gabrielmelguizo', 'jrosa', 'rafrubgar95', 'armandomanuellopez93', 'b.ortin.vinader', 'raul_mulguer', 'emigoca14', 'mercedesruiz994', None, 'pedromaldonadoinfante', 'ratmnietzsche', 'elisabetsinh', 'alicorrgonz', 'pablosanchezcid', 'aalfgvm', 'josecarlos', 'elena_aldeanueva', 'f.j.sanchez19', 'claferlop', 'raquelcano.96', 'javi94x', 'ajsalas', 'joseluiscastroarroyo95']"
118,90,7,22,6,"['gabrielmelguizo', 'rafrubgar95', 'alicorrgonz', 'raul_mulguer', 'emigoca14', 'joseluiscastroarroyo95']",0,[],16,"['jrosa', 'ratmnietzsche', 'elisabetsinh', 'armandomanuellopez93', 'pablosanchezcid', 'aalfgvm', 'josecarlos', 'b.ortin.vinader', 'f.j.sanchez19', 'claferlop', 'raquelcano.96', 'elena_aldeanueva', 'javi94x', 'mercedesruiz994', 'ajsalas', None]",22,"['gabrielmelguizo', 'jrosa', 'rafrubgar95', 'armandomanuellopez93', 'b.ortin.vinader', 'raul_mulguer', 'emigoca14', 'mercedesruiz994', None, 'ratmnietzsche', 'elisabetsinh', 'alicorrgonz', 'pablosanchezcid', 'aalfgvm', 'josecarlos', 'elena_aldeanueva', 'f.j.sanchez19', 'claferlop', 'raquelcano.96', 'javi94x', 'ajsalas', 'joseluiscastroarroyo95']"
118,42,7,20,6,"['gabrielmelguizo', 'rafrubgar95', 'alicorrgonz', 'raul_mulguer', 'emigoca14', 'joseluiscastroarroyo95']",0,[],14,"['jrosa', 'ratmnietzsche', 'elisabetsinh', 'armandomanuellopez93', 'aalfgvm', 'josecarlos', 'b.ortin.vinader', 'f.j.sanchez19', 'claferlop', 'elena_aldeanueva', 'javi94x', 'mercedesruiz994', 'ajsalas', None]",20,"['gabrielmelguizo', 'jrosa', 'rafrubgar95', 'armandomanuellopez93', 'b.ortin.vinader', 'raul_mulguer', 'emigoca14', 'mercedesruiz994', None, 'ratmnietzsche', 'elisabetsinh', 'alicorrgonz', 'aalfgvm', 'josecarlos', 'elena_aldeanueva', 'f.j.sanchez19', 'claferlop', 'javi94x', 'ajsalas', 'joseluiscastroarroyo95']"
118,185,7,17,6,"['gabrielmelguizo', 'rafrubgar95', 'alicorrgonz', 'raul_mulguer', 'emigoca14', 'joseluiscastroarroyo95']",0,[],11,"['jrosa', 'elisabetsinh', 'ratmnietzsche', 'josecarlos', 'aalfgvm', 'b.ortin.vinader', 'claferlop', 'javi94x', 'mercedesruiz994', 'ajsalas', None]",17,"['gabrielmelguizo', 'jrosa', 'rafrubgar95', 'b.ortin.vinader', 'raul_mulguer', 'emigoca14', 'mercedesruiz994', None, 'elisabetsinh', 'ratmnietzsche', 'alicorrgonz', 'josecarlos', 'aalfgvm', 'claferlop', 'javi94x', 'ajsalas', 'joseluiscastroarroyo95']"
119,334,7,7,6,"['kadam.rupesh28297', 'akshay.khetale', 'lekhakande', 'sendpost2mahesh', 'nikhil_ns', 'subodhsawant74']",0,[],1,[None],7,"['kadam.rupesh28297', None, 'akshay.khetale', 'lekhakande', 'sendpost2mahesh', 'nikhil_ns', 'subodhsawant74']"
120,349,7,28,3,"['artsuradet17', 'tpuangmali', 'saruto']",3,"['jyothishm', 'hashour', 'pay_gxh']",25,"['aim_wb', 'gegiesilverlocket', 'kewalingale22', 'pattarawit_dukdik', 'chanagantanakulrungsarit', 'pui_yaak1996', 'stamper9987', 'jirawat0441', 'fofai_41', 'panpilin443651', 'nurapa', 'khomphet66', 'surampha.s', 'paritmrj', 'pwangse', None, 'team5024', 'abinbueng', 'tewan', 'aschara_aum', 'nerysinnery', 'cream160341', 'peeranut', 'jintanaree', 'prang3_']",31,"['aim_wb', 'gegiesilverlocket', 'kewalingale22', 'pattarawit_dukdik', 'pui_yaak1996', 'stamper9987', 'jirawat0441', 'pay_gxh', 'pwangse', 'team5024', 'tpuangmali', 'abinbueng', 'tewan', 'aschara_aum', 'nerysinnery', 'hashour', 'artsuradet17', 'saruto', 'chanagantanakulrungsarit', 'fofai_41', 'panpilin443651', 'nurapa', 'khomphet66', 'surampha.s', 'paritmrj', 'jyothishm', None, 'cream160341', 'peeranut', 'jintanaree', 'prang3_']"
121,99,7,11,4,"['ilivings2016', 'vkoka', 'msdisilv', 'aherschf']",2,"['byetter', 'hcbutler']",7,"['mgoryll', 'charlsshannon', None, 'moman2', 'xiaozhi418', 'nyiin1', 'klhall5']",13,"['ilivings2016', 'charlsshannon', 'moman2', 'byetter', 'klhall5', None, 'hcbutler', 'mgoryll', 'vkoka', 'msdisilv', 'xiaozhi418', 'nyiin1', 'aherschf']"
121,97,7,10,3,"['ilivings2016', 'vkoka', 'aherschf']",3,"['byetter', 'hcbutler', 'msdisilv']",7,"['ahariha5', 'yzhao138', 'nlcarbal', 'djriver4', 'smatherl', 'nyiin1', None]",13,"['ilivings2016', 'byetter', 'djriver4', 'smatherl', None, 'hcbutler', 'ahariha5', 'vkoka', 'msdisilv', 'yzhao138', 'nlcarbal', 'nyiin1', 'aherschf']"
122,177,7,16,2,"['rohancontractor.rc', 'forumdesai96']",4,"['karan97km', 'nishant.joshi42', 'ajoshi1996', 'rohanrajeev21']",14,"['aagamshah999999999', 'aditik2107', 'riteshrajput381', 'justinvakkayil', 'siddhantssangal', 'alwin1996', 'senmathew329', 'vidur888', 'danieldsilva96', 'shreyasshah14', 'tripathishivam342', 'neha0206', 'abhijitharidas3107', None]",20,"['aditik2107', 'riteshrajput381', 'alwin1996', 'senmathew329', 'vidur888', 'neha0206', 'abhijitharidas3107', None, 'karan97km', 'aagamshah999999999', 'justinvakkayil', 'siddhantssangal', 'nishant.joshi42', 'rohancontractor.rc', 'forumdesai96', 'rohanrajeev21', 'danieldsilva96', 'shreyasshah14', 'tripathishivam342', 'ajoshi1996']"
122,176,7,8,3,"['karan97km', 'nishant.joshi42', 'rohanrajeev21']",3,"['rohancontractor.rc', 'forumdesai96', 'ajoshi1996']",5,"['goyal.suman312', 'chinmayhejmadi', 'jharupesh440', 'vandortshakti', None]",11,"['karan97km', 'goyal.suman312', 'nishant.joshi42', 'rohancontractor.rc', 'forumdesai96', 'rohanrajeev21', 'chinmayhejmadi', 'jharupesh440', 'vandortshakti', None, 'ajoshi1996']"
122,178,7,6,1,['nishant.joshi42'],5,"['karan97km', 'forumdesai96', 'rohancontractor.rc', 'rohanrajeev21', 'ajoshi1996']",5,"['siddhantssangal', 'vandortshakti', 'mananmehta95', None, 'rwaghela51']",11,"['karan97km', 'siddhantssangal', 'nishant.joshi42', 'rohancontractor.rc', 'forumdesai96', 'rohanrajeev21', 'vandortshakti', 'mananmehta95', None, 'ajoshi1996', 'rwaghela51']"
125,80,7,78,1,['es16btech11007'],5,"['ece4080', 'xzang', 'yesiyuanjim', 'lukaszgluba', 'sahayshubham']",77,"['bhavya12', 'es15btech11016', 'maniyarudit', 'rajeshwarchennam', 'es16btech11011', 'sayzeeel', 'bharadwaj1997', 'ep15btech11005', 'vishnu_33', 'ramanudeepp', 'hydro123', 'srinidhibachu', 'karlapatirajapradyumna', 'pulapapavan25', 'deepkarma82', 'aravindganesh', 'ncsham', 'bhanutabeti', 'anandkadu4108', 'shanky98', 'ee16btech11016', 'saiashish', 'pramith', 'saurav.varaprasad', 'im2learning', 'pradeepmoturi', 'es16btech11001', 'samhitha', 're1nth', 'dj_16', 'es16btech11026', 'priyanka7', 'anushag', 'devnano', 'akramya98', 'es16btech11018', 'siddharth_goel', 'ee16btech11024', 'nakshatra', 'aravind03', 'tejas_p', 'emani', 'uditmaniyar', 'rangesh', 'shardul', 'havish', 'ee16btech11012', 'es16btech11008', 'chakri1804', 'chait', 'vivek2699', 'snehith', 'sidmohla', 'khalidshaik', 'anuragshekhar', 'es16btech11003', 'ee16btech11013', 'preetham1998', 'ep14btech11003', 'jvinaykumar12', 'es15btech11007', 'aamir_ee', 'vishwajith', 'ganna09', None, 'es14btech11022', 'ep15btech11001', 'es15btech11010', 'ee16btech11042', 'karthikr98', 'sumanth', 'adithyahosapate', 'ee16btech11028', 'subhashchandra', 'es16btech11002', 'kmt6264', 'ee16btech11032']",83,"['bhavya12', 'es15btech11016', 'maniyarudit', 'yesiyuanjim', 'rajeshwarchennam', 'es16btech11011', 'sayzeeel', 'bharadwaj1997', 'ep15btech11005', 'vishnu_33', 'ramanudeepp', 'hydro123', 'srinidhibachu', 'karlapatirajapradyumna', 'pulapapavan25', 'deepkarma82', 'aravindganesh', 'ncsham', 'bhanutabeti', 'anandkadu4108', 'xzang', 'shanky98', 'ee16btech11016', 'saiashish', 'pramith', 'saurav.varaprasad', 'im2learning', 'pradeepmoturi', 'es16btech11001', 'samhitha', 're1nth', 'dj_16', 'es16btech11026', 'priyanka7', 'anushag', 'devnano', 'akramya98', 'es16btech11018', 'siddharth_goel', 'ee16btech11024', 'nakshatra', 'aravind03', 'tejas_p', 'emani', 'es16btech11007', 'uditmaniyar', 'rangesh', 'ece4080', 'shardul', 'havish', 'ee16btech11012', 'lukaszgluba', 'es16btech11008', 'chakri1804', 'chait', 'vivek2699', 'snehith', 'sidmohla', 'khalidshaik', 'anuragshekhar', 'es16btech11003', 'ee16btech11013', 'preetham1998', 'ep14btech11003', 'jvinaykumar12', 'es15btech11007', 'aamir_ee', 'vishwajith', 'ganna09', None, 'es14btech11022', 'ep15btech11001', 'es15btech11010', 'ee16btech11042', 'karthikr98', 'sumanth', 'adithyahosapate', 'ee16btech11028', 'sahayshubham', 'subhashchandra', 'es16btech11002', 'kmt6264', 'ee16btech11032']"
126,100,7,22,1,['eeprofessor'],5,"['zasmith2', 'charlsshannon', 'moman2', 'xiaozhi418', 'scfeem']",21,"['barreto2', 'stryder.loveday', 'arteaga52', 'jonathanmalta', 'chezkov', 'doniashlayan', 'sachinpn', 'djgraziano', 'nanoeric', 'vikasvjois', 'jsdye2010', 'damitree', 'escoba3', None, 'verdum1', 'miyajis', 'jaysuchanun', 'gentryd2', 'renj1', 'aragom1', 'fredsteven12']",27,"['charlsshannon', 'barreto2', 'moman2', 'damitree', 'stryder.loveday', 'arteaga52', 'jonathanmalta', 'escoba3', 'chezkov', 'scfeem', 'doniashlayan', None, 'verdum1', 'zasmith2', 'sachinpn', 'djgraziano', 'miyajis', 'nanoeric', 'jaysuchanun', 'gentryd2', 'renj1', 'aragom1', 'fredsteven12', 'vikasvjois', 'xiaozhi418', 'jsdye2010', 'eeprofessor']"
126,99,7,11,3,"['charlsshannon', 'xiaozhi418', 'moman2']",3,"['zasmith2', 'scfeem', 'eeprofessor']",8,"['ilivings2016', 'mgoryll', None, 'vkoka', 'msdisilv', 'nyiin1', 'aherschf', 'klhall5']",14,"['ilivings2016', 'charlsshannon', 'moman2', 'scfeem', 'klhall5', None, 'zasmith2', 'mgoryll', 'vkoka', 'msdisilv', 'xiaozhi418', 'nyiin1', 'aherschf', 'eeprofessor']"
127,403,7,45,1,['eprussac'],5,"['shen380', 'qiu129', 'andresvilla', 'vhoshing', 'wasynczu']",44,"['wmorton', 'kkingdon', 'kadair', 'khan106', 'mcapestr', 'leavittm', 'nmacke', 'figuero3', 'logan8', 'mbodziak', 'fbokhari', 'alichlyt', 'ghinkle', 'mgolm', 'welch31', 'zhan1823', 'courtneyy', 'hobson7', 'johnwkeil', 'brendenh88', 'ncain3', 'brettrasmus', 'clasky', 'abeckle', 'cooleys', 'nbcain', 'mmuschar', 'jtrouba', 'erohrbac', 'ning2', 'ouyang6', 'richtern', 'kohlerc', 'jain139', 'pan112', 'cneudeck', 'davis635', None, 'pjgordon', 'colemaj', 'teeads', 'yang837', 'an49', 'adamjmiller']",50,"['wmorton', 'kkingdon', 'kadair', 'qiu129', 'khan106', 'mcapestr', 'leavittm', 'eprussac', 'vhoshing', 'nmacke', 'figuero3', 'logan8', 'mbodziak', 'fbokhari', 'alichlyt', 'ghinkle', 'mgolm', 'welch31', 'zhan1823', 'courtneyy', 'hobson7', 'johnwkeil', 'brendenh88', 'ncain3', 'brettrasmus', 'clasky', 'abeckle', 'adamjmiller', 'cooleys', 'nbcain', 'shen380', 'mmuschar', 'jtrouba', 'erohrbac', 'ning2', 'ouyang6', 'richtern', 'kohlerc', 'jain139', 'pan112', 'cneudeck', 'davis635', 'andresvilla', None, 'pjgordon', 'colemaj', 'teeads', 'yang837', 'an49', 'wasynczu']"
127,162,7,11,4,"['eprussac', 'qiu129', 'andresvilla', 'vhoshing']",2,"['shen380', 'wasynczu']",7,"['chung192', 'redwing', 'ding92', 'dgosala', 'qzmdtc1993', 'sharm316', None]",13,"['chung192', 'shen380', 'qiu129', 'ding92', 'eprussac', 'andresvilla', 'vhoshing', 'sharm316', None, 'redwing', 'dgosala', 'qzmdtc1993', 'wasynczu']"
128,194,7,27,1,['chen380'],5,"['sharm318', 'nstites', 'skashya0504', 'butlerq', 'fmegally']",26,"['marisol', 'vdharman', 'chen2088', 'sukirtthakur', 'naik7', 'tryba', 'lu500', 'tsimon', 'patkip', 'li2641', 'sabareesh169', 'mrajase', 'wang1471', 'zhou646', 'vjoiner', 'abiniwa', 'huang714', 'rahuldeshmukh', 'lalzatev', 'mademoiselle0812', 'rtibrewa', None, 'yang1489', 'yvemula', 'wang3243', 'biwrey']",32,"['marisol', 'vdharman', 'chen2088', 'sukirtthakur', 'naik7', 'tryba', 'lu500', 'tsimon', 'patkip', 'nstites', 'li2641', 'sabareesh169', 'mrajase', 'wang1471', 'zhou646', 'vjoiner', 'sharm318', 'abiniwa', 'skashya0504', 'huang714', 'chen380', 'rahuldeshmukh', 'fmegally', 'lalzatev', 'mademoiselle0812', 'rtibrewa', None, 'butlerq', 'yang1489', 'yvemula', 'wang3243', 'biwrey']"
131,77,7,6,1,['pratiksha'],5,"['belz.7', 'lekh.nith', 'matphys17', 'tourangharis', 'nickjrz']",5,"['amolgolwankar', 'shrivastavsomesh', 'akarnik.13', 'tripathishivam342', None]",11,"['belz.7', 'lekh.nith', 'amolgolwankar', 'shrivastavsomesh', 'pratiksha', 'akarnik.13', 'tripathishivam342', 'matphys17', 'tourangharis', None, 'nickjrz']"
134,283,6,9,5,"['djukic', 'petra', 'tomaivo91', 'martinamartinovicmtk', 'gloria.odak']",0,[],4,"['marijanaugrina', 'jscurla', 'zeljka.san', None]",9,"['djukic', 'petra', 'tomaivo91', 'marijanaugrina', 'zeljka.san', 'martinamartinovicmtk', 'jscurla', 'gloria.odak', None]"
136,356,6,10,5,"['subhadeepchowdhury0212', 'siu854268186', 'siu854111003', 'siu854217482', 'stevensmith']",0,[],5,"['lalithkanala', 'ssahmed', 'rizbi03', 'purnomohonghosh', None]",10,"['subhadeepchowdhury0212', 'siu854268186', 'ssahmed', 'siu854111003', 'lalithkanala', 'siu854217482', 'rizbi03', 'stevensmith', 'purnomohonghosh', None]"
138,275,6,66,5,"['yzelenkova98', 'tomleadon', 'angelaes', 'drishnasainju', 'georgelavender1995']",0,[],61,"['abood.sw', 'emilyg3110', 'dominik.cervenka', 'matthewhyder01', 'maediannesonugan', 'danjones235', 'sam.revell14', 'dv018089', 'toppdawg', 'rumanamiah1998', 'alexsimmons27', 'zoerjames123', 'willvalentine02', 'samweeks123', 'nico97', 'ineshamiltonschool', 'jfeasey01', 'theofrost98', 'gabslowe11', 'a_4cash', 'shw6195', 'maks.rakowski', 'peterhannanyoung', 'ludmilacerne', 'shrnshafiee', 'amasson', 'alex.wall', 'meghanjthomas', 'charlotteeg94', 'sophierosesmith98', 'mrb123', 'hkzneykus', 'benjamina', 'elliotthook', 'jjmartin49', 'aishanuhu', 'lorna', 'yassin12', 'amethyst44', 'rhys.bossler', 'corromon', 'alextucker56', 'adflanaganlfc', 'dantrueman2015', 'jemackay', 'emmwelham', 'karishma1', 'rh.taylor98', 'sammy_1555', 'simranc', 'ireland.gentile', 'ayaanabdillahi1997', 'brandonb610', 'barat.abid', None, 'dmillard2491', 'gelav', 'baggage1234', 'nadinecandelin', 'jessfraser13', 'hannahlaws59']",66,"['abood.sw', 'yzelenkova98', 'emilyg3110', 'dominik.cervenka', 'matthewhyder01', 'maediannesonugan', 'danjones235', 'sam.revell14', 'dv018089', 'toppdawg', 'rumanamiah1998', 'alexsimmons27', 'zoerjames123', 'willvalentine02', 'samweeks123', 'nico97', 'ineshamiltonschool', 'jfeasey01', 'theofrost98', 'gabslowe11', 'a_4cash', 'tomleadon', 'shw6195', 'maks.rakowski', 'peterhannanyoung', 'drishnasainju', 'ludmilacerne', 'shrnshafiee', 'amasson', 'alex.wall', 'meghanjthomas', 'charlotteeg94', 'sophierosesmith98', 'mrb123', 'hkzneykus', 'angelaes', 'benjamina', 'elliotthook', 'jjmartin49', 'aishanuhu', 'lorna', 'yassin12', 'amethyst44', 'rhys.bossler', 'corromon', 'alextucker56', 'adflanaganlfc', 'dantrueman2015', 'jemackay', 'emmwelham', 'karishma1', 'rh.taylor98', 'sammy_1555', 'simranc', 'ireland.gentile', 'ayaanabdillahi1997', 'brandonb610', 'barat.abid', None, 'dmillard2491', 'gelav', 'baggage1234', 'nadinecandelin', 'jessfraser13', 'hannahlaws59', 'georgelavender1995']"
139,331,6,6,5,"['supriya.palve', 'chhaya.patil', 'chetan.mhaske', 'rushabh.patil', 'gokul.kizhakkeppattu']",0,[],1,[None],6,"['supriya.palve', 'chhaya.patil', 'chetan.mhaske', 'rushabh.patil', 'gokul.kizhakkeppattu', None]"
141,130,6,30,5,"['cpeter', 'rtam', 'komminiadithya', 'ctheriault', 'eliasphillip']",0,[],25,"['dkurpaska', 'akaluzny', 'ztoscanini', 'pjaswal', 'yaoweixie', 'jhennessey', 'rkornitsky', 'markgillespi', 'lemerson', 'mdelude', 'jrlacroix', None, 'dgage', 'rmcauliffe11', 'liamarasta', 'ricardohenri', 'aksamija', 'matthewsarge', 'sgilani', 'lucasguertin', 'nshattuck', 'nmsheridan', 'jpweber', 'ougorji', 'oyacteen']",30,"['dkurpaska', 'ztoscanini', 'yaoweixie', 'jhennessey', 'lemerson', 'mdelude', 'jrlacroix', 'rmcauliffe11', 'cpeter', 'rtam', 'ricardohenri', 'aksamija', 'lucasguertin', 'eliasphillip', 'oyacteen', 'akaluzny', 'pjaswal', 'rkornitsky', 'markgillespi', 'ctheriault', None, 'dgage', 'liamarasta', 'matthewsarge', 'sgilani', 'komminiadithya', 'nshattuck', 'nmsheridan', 'jpweber', 'ougorji']"
141,199,6,27,5,"['cpeter', 'rtam', 'komminiadithya', 'ctheriault', 'eliasphillip']",0,[],22,"['dkurpaska', 'akaluzny', 'ztoscanini', 'pjaswal', 'jhennessey', 'rkornitsky', 'markgillespi', 'lemerson', 'mdelude', 'jrlacroix', None, 'dgage', 'ricardohenri', 'aksamija', 'matthewsarge', 'sgilani', 'lucasguertin', 'nshattuck', 'nmsheridan', 'jpweber', 'ougorji', 'oyacteen']",27,"['dkurpaska', 'ztoscanini', 'jhennessey', 'lemerson', 'mdelude', 'jrlacroix', 'cpeter', 'rtam', 'ricardohenri', 'aksamija', 'lucasguertin', 'eliasphillip', 'oyacteen', 'akaluzny', 'pjaswal', 'rkornitsky', 'markgillespi', 'ctheriault', None, 'dgage', 'matthewsarge', 'sgilani', 'komminiadithya', 'nshattuck', 'nmsheridan', 'jpweber', 'ougorji']"
141,319,6,25,5,"['cpeter', 'rtam', 'komminiadithya', 'ctheriault', 'eliasphillip']",0,[],20,"['akaluzny', 'ztoscanini', 'pjaswal', 'yaoweixie', 'jhennessey', 'rkornitsky', 'markgillespi', 'lemerson', 'mdelude', 'jsproviero', 'jrlacroix', None, 'dgage', 'nmccarthy', 'sguha', 'aksamija', 'marcusle', 'nmsheridan', 'wdang', 'samuelburges']",25,"['akaluzny', 'ztoscanini', 'pjaswal', 'yaoweixie', 'jhennessey', 'rkornitsky', 'markgillespi', 'lemerson', 'ctheriault', 'mdelude', 'jsproviero', 'jrlacroix', None, 'dgage', 'cpeter', 'nmccarthy', 'rtam', 'sguha', 'aksamija', 'marcusle', 'komminiadithya', 'nmsheridan', 'wdang', 'eliasphillip', 'samuelburges']"
141,160,6,7,5,"['cpeter', 'rtam', 'komminiadithya', 'ctheriault', 'eliasphillip']",0,[],2,"[None, 'nshattuck']",7,"['cpeter', 'rtam', 'komminiadithya', 'nshattuck', 'ctheriault', None, 'eliasphillip']"
141,166,6,7,5,"['cpeter', 'rtam', 'komminiadithya', 'ctheriault', 'eliasphillip']",0,[],2,"[None, 'nshattuck']",7,"['cpeter', 'rtam', 'komminiadithya', 'nshattuck', 'ctheriault', None, 'eliasphillip']"
142,347,6,16,5,"['lysanny1', 'idsaleh18', 'connorbrooks500', 'lukedant', 'woodardju316']",0,[],11,"['hunterisaac8', 'brennan', 'dvavrinak47', 'navigatornick', 'rawunder', 'anonymousllama', 'edbanks19', 'arpuente19', 'jrwhitaker15', None, 'paulschmitt8']",16,"['hunterisaac8', 'dvavrinak47', 'lysanny1', 'idsaleh18', 'connorbrooks500', 'edbanks19', 'lukedant', 'woodardju316', None, 'paulschmitt8', 'brennan', 'navigatornick', 'rawunder', 'anonymousllama', 'arpuente19', 'jrwhitaker15']"
143,217,6,7,4,"['dilip.wakdikar', 'asinghal.anuj47', 'podililaxmi30', 'sharvari.narvekar']",1,['sarveshgh9999'],3,"['shraddhasam78', None, 'pratibhagawari28']",8,"['dilip.wakdikar', 'asinghal.anuj47', 'podililaxmi30', 'sarveshgh9999', 'shraddhasam78', 'sharvari.narvekar', None, 'pratibhagawari28']"
145,202,6,36,5,"['brian10salazar', 'cestellos', 'luoyunkai', 'achuang2718', 'linusmettler']",0,[],31,"['yihanxiao', 'nongnuch.artrith', 'jdagdelen', 'ramotsai', 'hmkang', 'stko', 'qiuzanlin', 'penghaoxiao', 'sahays', 'viviannh', 'xzwy2017', 'xperrylinn', 'zinizhu', 'efelgus', 'humberto.batiz', 'rwoodsrobinson', 'bingxin_yu', 'xianglijia', 'anas_abuodeh', 'ruihan94', 'tomaszy', 'jms94', 'lipengju', None, 'zollermi', 'rpigott', 'ardunn12', 'ylum', 'cherylc598', 'aurban', 'hhaoyan']",36,"['yihanxiao', 'cestellos', 'luoyunkai', 'nongnuch.artrith', 'jdagdelen', 'ramotsai', 'hmkang', 'stko', 'qiuzanlin', 'penghaoxiao', 'sahays', 'viviannh', 'xzwy2017', 'xperrylinn', 'zinizhu', 'efelgus', 'humberto.batiz', 'rwoodsrobinson', 'bingxin_yu', 'xianglijia', 'anas_abuodeh', 'ruihan94', 'tomaszy', 'jms94', 'lipengju', None, 'linusmettler', 'brian10salazar', 'zollermi', 'rpigott', 'ardunn12', 'ylum', 'cherylc598', 'achuang2718', 'aurban', 'hhaoyan']"
146,329,6,16,3,"['virendra.wagh', 'falguni.pawar', 'gayatri.devadiga']",2,"['et2012.tejas.patil', 'pooja.thorat']",13,"['ashish.waghule', None, 'trishala.dixit', 'ej2012.abhishek.bane', 'prathamesh.chaudhari', 'hitenmalkani', 'saurabh.kurhe', 'bhiva.gawade', 'gaurav.mahajan', 'jyoti30', 'aishwarya.kadam', 'rahul.yadav', 'darshana.jain']",18,"['trishala.dixit', 'et2012.tejas.patil', 'virendra.wagh', 'gaurav.mahajan', None, 'falguni.pawar', 'darshana.jain', 'ashish.waghule', 'gayatri.devadiga', 'pooja.thorat', 'ej2012.abhishek.bane', 'prathamesh.chaudhari', 'hitenmalkani', 'saurabh.kurhe', 'bhiva.gawade', 'jyoti30', 'aishwarya.kadam', 'rahul.yadav']"
146,326,6,10,1,['gayatri.devadiga'],4,"['virendra.wagh', 'et2012.tejas.patil', 'falguni.pawar', 'pooja.thorat']",9,"['poorva.gupta', 'mihir.patange', 'ishasawant', 'sahil.tasgavkar', 'baishakhi.choudhury', 'saurabh.jadhav', 'dhruva.aklekar', 'rohan.pawar', None]",14,"['poorva.gupta', 'ishasawant', 'gayatri.devadiga', 'pooja.thorat', 'mihir.patange', 'sahil.tasgavkar', 'et2012.tejas.patil', 'virendra.wagh', 'baishakhi.choudhury', 'saurabh.jadhav', 'dhruva.aklekar', 'rohan.pawar', None, 'falguni.pawar']"
146,327,6,7,2,"['et2012.tejas.patil', 'pooja.thorat']",3,"['virendra.wagh', 'falguni.pawar', 'gayatri.devadiga']",5,"['prachi.shinde', 'vikram.singh', 'shruti.g.shetty', None, 'rahul.yadav']",10,"['gayatri.devadiga', 'pooja.thorat', 'rahul.yadav', 'vikram.singh', 'et2012.tejas.patil', 'virendra.wagh', 'shruti.g.shetty', 'prachi.shinde', None, 'falguni.pawar']"
146,330,6,6,2,"['et2012.tejas.patil', 'pooja.thorat']",3,"['virendra.wagh', 'falguni.pawar', 'gayatri.devadiga']",4,"['dhruva.aklekar', 'prachi.shinde', None, 'rahul.yadav']",9,"['gayatri.devadiga', 'pooja.thorat', 'rahul.yadav', 'et2012.tejas.patil', 'virendra.wagh', 'dhruva.aklekar', 'prachi.shinde', None, 'falguni.pawar']"
147,370,6,7,5,"['janek', 'robertmiszcz', 'zj88', 'bartoszgren', 'b.rozwalka']",0,[],2,"['j_piechota', None]",7,"['janek', 'robertmiszcz', None, 'zj88', 'bartoszgren', 'j_piechota', 'b.rozwalka']"
149,380,6,11,4,"['jeraldedwin21', 'archana123', 'bhavyak160', 'nixon.daniel20']",1,['shamsaabdulshukkur'],7,"['rajaitha', 'minusimonrajr', 'rajalakshmi1996', 'raghul', 'varnitha', 'swraijak06', None]",12,"['bhavyak160', 'minusimonrajr', 'rajalakshmi1996', 'shamsaabdulshukkur', None, 'archana123', 'rajaitha', 'raghul', 'varnitha', 'jeraldedwin21', 'swraijak06', 'nixon.daniel20']"
149,391,6,9,5,"['archana123', 'bhavyak160', 'shamsaabdulshukkur', 'jeraldedwin21', 'nixon.daniel20']",0,[],4,"['minusimonrajr', 'biswadeep987', None, 'swraijak06']",9,"['archana123', 'biswadeep987', 'bhavyak160', 'minusimonrajr', 'shamsaabdulshukkur', 'jeraldedwin21', 'swraijak06', 'nixon.daniel20', None]"
149,388,6,8,5,"['archana123', 'bhavyak160', 'shamsaabdulshukkur', 'jeraldedwin21', 'nixon.daniel20']",0,[],3,"['biswadeep987', None, 'rajaithamary']",8,"['archana123', 'biswadeep987', 'bhavyak160', 'shamsaabdulshukkur', 'jeraldedwin21', 'rajaithamary', 'nixon.daniel20', None]"
151,271,6,6,5,"['ortiz.andrea', 'duverney.corrales', 'mathias0100', 'andresc.vargasr', 'jaime.velasco']",0,[],1,[None],6,"['ortiz.andrea', 'duverney.corrales', 'mathias0100', 'andresc.vargasr', 'jaime.velasco', None]"
151,381,6,6,5,"['ortiz.andrea', 'duverney.corrales', 'mathias0100', 'andresc.vargasr', 'jaime.velasco']",0,[],1,[None],6,"['ortiz.andrea', 'duverney.corrales', 'mathias0100', 'andresc.vargasr', 'jaime.velasco', None]"
153,202,6,36,5,"['yihanxiao', 'nongnuch.artrith', 'lipengju', 'aurban', 'jdagdelen']",0,[],31,"['cestellos', 'luoyunkai', 'ramotsai', 'hmkang', 'stko', 'qiuzanlin', 'penghaoxiao', 'sahays', 'viviannh', 'xzwy2017', 'xperrylinn', 'zinizhu', 'efelgus', 'humberto.batiz', 'rwoodsrobinson', 'bingxin_yu', 'xianglijia', 'anas_abuodeh', 'ruihan94', 'tomaszy', 'jms94', None, 'linusmettler', 'brian10salazar', 'zollermi', 'rpigott', 'ardunn12', 'ylum', 'cherylc598', 'achuang2718', 'hhaoyan']",36,"['yihanxiao', 'cestellos', 'nongnuch.artrith', 'luoyunkai', 'jdagdelen', 'ramotsai', 'hmkang', 'stko', 'qiuzanlin', 'penghaoxiao', 'sahays', 'viviannh', 'xzwy2017', 'xperrylinn', 'zinizhu', 'efelgus', 'humberto.batiz', 'rwoodsrobinson', 'bingxin_yu', 'xianglijia', 'anas_abuodeh', 'ruihan94', 'tomaszy', 'lipengju', 'jms94', None, 'linusmettler', 'brian10salazar', 'zollermi', 'rpigott', 'ardunn12', 'ylum', 'cherylc598', 'achuang2718', 'aurban', 'hhaoyan']"
153,155,6,28,1,['jdagdelen'],4,"['aurban', 'yihanxiao', 'nongnuch.artrith', 'lipengju']",27,"['bingxin_yu', 'mpsherb', 'xianglijia', 'anas_abuodeh', 'ruihan94', 'jms94', 'hhaoyan', None, 'zollermi', 'rpigott', 'ramotsai', 'ardunn12', 'hmkang', 'ylum', 'cherylc598', 'stko', 'qiuzanlin', 'xperrylinn', 'sahays', 'mmrejen', 'xzwy2017', 'viviannh', 'zinizhu', 'zhang0419', 'efelgus', 'humberto.batiz', 'rwoodsrobinson']",32,"['yihanxiao', 'nongnuch.artrith', 'jdagdelen', 'ramotsai', 'hmkang', 'stko', 'qiuzanlin', 'xperrylinn', 'sahays', 'mmrejen', 'xzwy2017', 'mpsherb', 'viviannh', 'zinizhu', 'efelgus', 'zhang0419', 'humberto.batiz', 'rwoodsrobinson', 'bingxin_yu', 'xianglijia', 'anas_abuodeh', 'ruihan94', 'lipengju', 'jms94', None, 'zollermi', 'rpigott', 'ardunn12', 'ylum', 'cherylc598', 'aurban', 'hhaoyan']"
154,306,6,80,1,['ghanshyam.techfest'],4,"['tonigaam', 'alvarodifer', 'tm.mail', 'choquette']",79,"['swadhasanghvi4', 'sanidhya27', 'ishank', 'kritikamna23', 'hegdeananthar', 'jitendraiitb', 'guptasheetal436', 'bagrania385', 'khandelwalsanyam87', 'neharikajali', 'nilesh8', 'rashmiravindranath', 'gb42', 'ajitzote', 'arbaz', 'arishinam123', 'archiki', 'anilk', 'akashmunda12345', 'pandeykratvesh', '28dhruv.varshney', 'aniketbhatia2107', 'ak83229', 'singhalanirudh18', 'vineetkotariya', 'snjkhatri34', 'anonymousbuggy', 'kumaradarsh', 'vivekkandeyang97', '16d070026', 'ydidwania', 'tanmaypatil1598', 'neeraj.chimankar', 'pirojiwalasubham', 'acrylonitrile', 'devesh1102', 'nishagb04', 'yojit105', 'dimplekochar3', 'pmmadhumita9', 'harsh05september', 'mustafaali12', 'lakshyakumarsingh', 'akashminato1', 'himanshuaswani123', 'sudhiriitb', 'ksselhi', 'sucheta317', 'keshariaayesha', 'narendrarai1812', 'devanshu', 'shashiadi', 'anshulvermaiitb', 'shauryasindhu', 'aspruha.samal', 'sethabhinav89', 'navnitkumar1224', 'nemadepsn', 'sahilkumar1900', 'bhuyashi.deka', 'neildalal', 'pratyushragini', 'shubhangb97', 'saarthak', 'prnair', 'qwerty56', None, 'rishikkumar18', 'apoorv0', 'ishitadas1998', 'anirudh.singhal', 'ghanshyam.iitb', 'abhikanse', 'sudhanshum2014', 'aniketsl', 'kumar_ashutosh', 'navoj98', 'max2aneeb', 'kaki.krish15']",84,"['swadhasanghvi4', 'sanidhya27', 'ishank', 'kritikamna23', 'hegdeananthar', 'alvarodifer', 'jitendraiitb', 'guptasheetal436', 'bagrania385', 'khandelwalsanyam87', 'neharikajali', 'nilesh8', 'tm.mail', 'rashmiravindranath', 'gb42', 'ajitzote', 'arbaz', 'arishinam123', 'archiki', 'anilk', 'akashmunda12345', 'pandeykratvesh', '28dhruv.varshney', 'aniketbhatia2107', 'ak83229', 'singhalanirudh18', 'vineetkotariya', 'snjkhatri34', 'anonymousbuggy', 'kumaradarsh', 'vivekkandeyang97', '16d070026', 'ydidwania', 'tanmaypatil1598', 'neeraj.chimankar', 'pirojiwalasubham', 'acrylonitrile', 'devesh1102', 'nishagb04', 'yojit105', 'tonigaam', 'dimplekochar3', 'pmmadhumita9', 'harsh05september', 'mustafaali12', 'lakshyakumarsingh', 'akashminato1', 'himanshuaswani123', 'choquette', 'sudhiriitb', 'ksselhi', 'sucheta317', 'keshariaayesha', 'narendrarai1812', 'devanshu', 'shashiadi', 'anshulvermaiitb', 'shauryasindhu', 'aspruha.samal', 'sethabhinav89', 'navnitkumar1224', 'nemadepsn', 'sahilkumar1900', 'bhuyashi.deka', 'neildalal', 'pratyushragini', 'shubhangb97', 'saarthak', 'prnair', 'qwerty56', 'ghanshyam.techfest', None, 'rishikkumar18', 'apoorv0', 'ishitadas1998', 'anirudh.singhal', 'ghanshyam.iitb', 'abhikanse', 'sudhanshum2014', 'aniketsl', 'kumar_ashutosh', 'navoj98', 'max2aneeb', 'kaki.krish15']"
155,333,6,7,5,"['amita.t', 'hgkj03', 'rohit.thapliyal', 'kramik.g', 'nayanika.diwadkar']",0,[],2,"['srikrishna.h', None]",7,"['amita.t', 'hgkj03', 'rohit.thapliyal', 'kramik.g', 'srikrishna.h', 'nayanika.diwadkar', None]"
158,260,6,73,4,"['sawardekarsuyash97', 'tejas7', 'damle.rajas', 'mandar.261']",1,['nikhilmatkar47'],69,"['ranegirish24', 'damini.rane', 'saurabhpathare304', 'rushikool12', 'mestryumesh123', 'prasadtrimukhe', 'murkarnamita', 'gidayegirish', 'shubhamrajpal038', 'shreya9609', 'manasitambat96', 'prathamesh24j', 'ashishghoderao', 'akshay1997bhagit', 'vinayak183', 'ronraviram789', 'satsamjr', 'rutvikstar', 'plotankar96', 'shirsekarakash', 'pratikpawar4996', 'yashpimpale6', 'sarveshbhoer158', 'siddhantwarankar', 'prasad24shingade', 'megh19k', 'jr.abishek00', 'girish.gidaye', 'kaminisuroshi26', 'deshpande192', 'komalparab', 'revati.naik1501', 'priyankapal3011', 'varadrajnanaware7', 'tejaswini', 'karishmahirve96', 'bodkesaurabh', 'pallavidshinde82', 'rahul2011star', 'shubhamraut', 'yash8976', 'siddhant319', 'patelriyalds', 'akshaygodse13', 'tejasawasarmol', 'kunaldua99999', 'mohitavhad1997', 'kavusatose123', 'dattaramkolekar', 'prasad.creativity123', 'bhairavi.chitalay', 'k.vekhande69', 'divujagushte26', 'shubhamkamble9639', 'sandeep27996', 'aartibhalerao29', 'adityawasekar11', 'siddhantpawar993', 'vedankasalunke96', 'rajatmohite48', None, 'priyankakudtarkar5', 'sgharat297', 'priyankachaurasia9167', 'narvekarsushant0', 'suyogmankame93', 'bhamghodke7', 'shubhangihnkre14', 'sonam.wairkar']",74,"['ranegirish24', 'damini.rane', 'tejas7', 'saurabhpathare304', 'rushikool12', 'mestryumesh123', 'prasadtrimukhe', 'murkarnamita', 'gidayegirish', 'shubhamrajpal038', 'shreya9609', 'manasitambat96', 'prathamesh24j', 'ashishghoderao', 'akshay1997bhagit', 'vinayak183', 'ronraviram789', 'satsamjr', 'rutvikstar', 'plotankar96', 'mandar.261', 'shirsekarakash', 'pratikpawar4996', 'yashpimpale6', 'sarveshbhoer158', 'siddhantwarankar', 'prasad24shingade', 'megh19k', 'jr.abishek00', 'girish.gidaye', 'kaminisuroshi26', 'deshpande192', 'komalparab', 'revati.naik1501', 'priyankapal3011', 'varadrajnanaware7', 'tejaswini', 'karishmahirve96', 'bodkesaurabh', 'pallavidshinde82', 'rahul2011star', 'shubhamraut', 'damle.rajas', 'yash8976', 'siddhant319', 'patelriyalds', 'akshaygodse13', 'tejasawasarmol', 'kunaldua99999', 'mohitavhad1997', 'kavusatose123', 'dattaramkolekar', 'prasad.creativity123', 'bhairavi.chitalay', 'k.vekhande69', 'divujagushte26', 'shubhamkamble9639', 'sandeep27996', 'aartibhalerao29', 'adityawasekar11', 'siddhantpawar993', 'vedankasalunke96', 'sawardekarsuyash97', 'rajatmohite48', None, 'priyankakudtarkar5', 'sgharat297', 'priyankachaurasia9167', 'nikhilmatkar47', 'narvekarsushant0', 'suyogmankame93', 'bhamghodke7', 'shubhangihnkre14', 'sonam.wairkar']"
