MClusterID,XClusterID,MClusterSize,XClusterSize,OverlapSize,OverlapMembers,MOnlySize,MOnlyMembers,XOnlySize,XOnlyMembers,CombinedSize,CombinedMembers
1,85,241,85,67,"['tson3', 'allenxg2', 'mepaul2', 'zlevell2', 'jgallen3', 'eehoneg2', 'liam.kenny96', 'ychen388', 'tylerjj2', 'talee3', 'emwisni2', 'bpbaile2', 'skomar4', 'shim35', 'zchen208', 'nycbside95', 'eugenep2', 'bdguo2', 'harryf2', 'cisrael2', 'khuang47', 'tidate2', 'rwlandi2', 'jsharma3', 'atan14', 'clin101', 'vivo2', 'jablowi2', 'saphknight', 'kperozek2', 'cplant2', 'kkim142', 'syer2', 'ahrtmnn2', 'pbehera2', 'ab20', 'mtschro3', 'mckillo2', 'reishac2', 'mguagli2', 'xzhng125', 'sang5', 'dszhu2', 'ajfrank3', 'xxia10', 'mevtimo2', 'jhpham2', 'mjee3', 'janavic2', 'zohair2', 'enjucho2', 'masiewi2', 'nkrshnn2', 'wtso2', 'jlee742', 'willwheelera', 'ekisly2', 'wendidc2', 'neves2', 'yjeong12', 'elho2', 'sharpee2', 'dylanb2', 'conanlh2', 'rfbruck2', 'jrgusta2', 'aneeshj2']",174,"['asyrafwalkman', 'keerthih22', 'joelgearhart', 'karldavid', 'lukmanafif36', 'amprath2', 'ionsko', 'mohamadzulfikar88', 'syahidaam', 'thaqifharith22', 'haziqhelmy98', 'shiwangi.p', 'mehtavarshil', 'rohitlad93', 'marcanco', 'iwana20', 'ppawar', 'mahitha', 'hazemzainal7', 'surendhar', 'yubai', 'abubakarmughal92', 'vikram0420', 'asyrafjr', 'mihrjeev', 'luv8patel', 'tommy.boilard', 'kaisin_lee', 'rajauwais98', 'yingjunl', 'nishad1994', 'snsayed06', 'philou231', 'hereisericlai', 'jiahui0323', 'ammarhilmi9815', 'rolesen', 'baharoner90', 'rtorzilli', 'bellmanz', 'ixam25', 'danialasyrafrahman', 'andy23', 'julianaredzuan02', 'hbh841995', 'dr.karthik2016', 'louis.balsan.1', 'tokchinkuan', 'bstewie', 'bve5056', 'wilsonl98', 'vangurjeet', 'frbourassa', 'taiki', 'sagar5670', 'ooitzepng', 'kmrabe', 'atiqahazni', 'sylbbb33', 'vikrant23', 'csnaim75', 'luca.riccies', 'gitanshu_805702222', 'c1274995299', 'felicia', 'gacruz007', 'umar19200', 'arcmalrz', 'cathou09', 'asadullah2393', 'roclammergeier', 'ftnndh13', 'rutbeer.991', 'rucha_30', 'omarsm14', 'juanloisfuentes', 'alexmetreveli', 'ved.pragyan', 'pu3_888', 'hariz_muz', 'keven.voyer.1', 'd.ramos.santesmases', 'crunk1005', 'zhenting98', 'perrochibo', 'gacou54', 'ioncy1998', 'mipoire', 'setan', 'treppa2', 'dave.76', 'paqito9999', 'zayedh001', 'weeei0514', 'saipranith257', 'naveensundar', 'alra', 'mrkedekut', 'fbw27', 'kushaljain', 'arifikmal29031997', 'nurfthah', 'luisyugen', 'hilmy114', 'haziqhelmy3', 'edduc4', 'kkkoo115', 'kaihsinwen', 'dreew.yang', '893580746sumana', 'poggi', 'qistinaa48', 'larose.alex', 'gninacuri', 'niharika12', 'seminara.sergio7', 'mique12', 'auni0702', 'cbott2', 'thyagugowdaa', 'adonofr2', 'chfor216', 'dulguun', 'sophiagschwalbe', 'sdnayak94', 'chinaharveyum', 'zhehan666', 'zy83619', 'naziranat', 'arifikmal97', 'gboudreau03', 'xchartrand', 'zzhan151', 'sweet.robotbd', 'tangjiemu', 'sandy39', 'fredgauv', 'choongshengliang1997', 'ashishgajalkar', 'musyafa', 'kaiyuan', 'alex.tplante', 'athirahz', 'amirulasyhraffazmi98', 'aakanksha17', 'arexya', 'kenny457802550', 'ooi_benjamin', 'thierrylapointeleclerc2', 'omnia128', 'pizyo2011', 'karwaikhit1997', 'dabotop2', 'mohammed_naveed', 'pym', 'chraps', 'jmdimnd2', 'marcelskra', 'shahidah722', 'dannrez', 'xshan6', 'kaijun6541', 'syahidahnasir', 'titanking231', 'kelvinchanwh99', 'durgasundaram', 'taimoor5012', 'akmalkamaruzzaman', 'khaier', 'fadhilhaziq', 'chuhang.jin', 'riduwan', 'khohck97', 'donghu']",18,"['wolan2', 'schoole2', 'aokisang', 'rhyu2', 'jboo72390', 'wendi0522', 'michael.p.gambino', 'clwhite5', 'hyang89', 'jsshin3', 'mgambin2', 'eratta2', 'sarahrp2', 'yhuan127', 'rpavone2', 'nim4', None, 'jzhan142']",259,"['asyrafwalkman', 'keerthih22', 'karldavid', 'lukmanafif36', 'ionsko', 'talee3', 'thaqifharith22', 'haziqhelmy98', 'khuang47', 'marcanco', 'ppawar', 'mahitha', 'surendhar', 'mckillo2', 'dszhu2', 'asyrafjr', 'mihrjeev', 'luv8patel', 'kaisin_lee', 'rajauwais98', 'nishad1994', 'yjeong12', 'sharpee2', 'hereisericlai', 'jiahui0323', 'ammarhilmi9815', 'baharoner90', 'bellmanz', 'eehoneg2', 'ixam25', 'danialasyrafrahman', 'andy23', 'rpavone2', 'hbh841995', 'dr.karthik2016', 'nim4', 'shim35', 'louis.balsan.1', 'bve5056', 'vangurjeet', 'frbourassa', 'hyang89', 'taiki', 'vivo2', 'jzhan142', 'ooitzepng', 'reishac2', 'atiqahazni', 'sylbbb33', 'vikrant23', 'csnaim75', 'luca.riccies', 'felicia', 'umar19200', 'arcmalrz', 'asadullah2393', 'ftnndh13', 'mjee3', 'rutbeer.991', 'zohair2', 'jlee742', 'nkrshnn2', 'wtso2', 'omarsm14', 'alexmetreveli', 'rfbruck2', 'crunk1005', 'eugenep2', 'perrochibo', 'setan', 'ychen388', 'weeei0514', 'naveensundar', 'alra', 'mrkedekut', 'fbw27', 'cisrael2', 'haziqhelmy3', 'luisyugen', 'hilmy114', 'jablowi2', 'kperozek2', 'dreew.yang', '893580746sumana', 'poggi', 'mguagli2', 'qistinaa48', 'sang5', 'gninacuri', 'wendi0522', 'niharika12', 'xxia10', 'mique12', 'seminara.sergio7', 'thyagugowdaa', 'adonofr2', 'chfor216', 'ekisly2', 'neves2', 'sophiagschwalbe', 'chinaharveyum', 'allenxg2', 'xchartrand', 'sweet.robotbd', 'tangjiemu', 'skomar4', 'ashishgajalkar', 'musyafa', 'zchen208', 'nycbside95', 'harryf2', 'kaiyuan', 'rwlandi2', 'aakanksha17', 'clwhite5', 'arexya', 'ooi_benjamin', 'thierrylapointeleclerc2', 'omnia128', 'pizyo2011', 'mohammed_naveed', 'pym', 'jmdimnd2', 'marcelskra', 'shahidah722', 'dannrez', 'kaijun6541', 'willwheelera', 'kelvinchanwh99', 'taimoor5012', 'khaier', 'chuhang.jin', 'riduwan', 'donghu', 'tson3', 'wolan2', 'aokisang', 'mepaul2', 'joelgearhart', 'liam.kenny96', 'sarahrp2', 'amprath2', 'mohamadzulfikar88', 'syahidaam', 'rhyu2', 'bdguo2', 'shiwangi.p', 'mehtavarshil', 'rohitlad93', 'iwana20', 'clin101', 'saphknight', 'hazemzainal7', 'kkim142', 'yubai', 'ab20', 'mtschro3', 'schoole2', 'jboo72390', 'abubakarmughal92', 'vikram0420', 'yhuan127', 'tommy.boilard', 'janavic2', 'yingjunl', 'snsayed06', 'philou231', 'elho2', 'conanlh2', 'rolesen', 'rtorzilli', 'julianaredzuan02', 'tokchinkuan', 'bstewie', 'wilsonl98', 'tidate2', 'syer2', 'sagar5670', 'kmrabe', 'gitanshu_805702222', 'ajfrank3', 'c1274995299', 'gacruz007', 'eratta2', 'cathou09', 'michael.p.gambino', 'roclammergeier', None, 'rucha_30', 'juanloisfuentes', 'ved.pragyan', 'pu3_888', 'dylanb2', 'hariz_muz', 'keven.voyer.1', 'd.ramos.santesmases', 'jrgusta2', 'zhenting98', 'gacou54', 'zlevell2', 'ioncy1998', 'mipoire', 'jsshin3', 'treppa2', 'dave.76', 'paqito9999', 'zayedh001', 'saipranith257', 'emwisni2', 'bpbaile2', 'kushaljain', 'arifikmal29031997', 'nurfthah', 'jsharma3', 'edduc4', 'kkkoo115', 'kaihsinwen', 'cplant2', 'xzhng125', 'larose.alex', 'auni0702', 'cbott2', 'mevtimo2', 'jhpham2', 'enjucho2', 'dulguun', 'sdnayak94', 'zhehan666', 'aneeshj2', 'zy83619', 'naziranat', 'jgallen3', 'gboudreau03', 'zzhan151', 'mgambin2', 'tylerjj2', 'sandy39', 'fredgauv', 'choongshengliang1997', 'alex.tplante', 'athirahz', 'amirulasyhraffazmi98', 'atan14', 'kenny457802550', 'ahrtmnn2', 'karwaikhit1997', 'pbehera2', 'dabotop2', 'chraps', 'xshan6', 'masiewi2', 'syahidahnasir', 'titanking231', 'durgasundaram', 'wendidc2', 'akmalkamaruzzaman', 'fadhilhaziq', 'khohck97', 'arifikmal97']"
1,17,241,82,68,"['naziranat', 'asyrafwalkman', 'ioncy1998', 'arifikmal97', 'andy23', 'danialasyrafrahman', 'lukmanafif36', 'julianaredzuan02', 'zayedh001', 'choongshengliang1997', 'mohamadzulfikar88', 'syahidaam', 'thaqifharith22', 'tokchinkuan', 'musyafa', 'haziqhelmy98', 'wilsonl98', 'mrkedekut', 'kaiyuan', 'vangurjeet', 'fbw27', 'athirahz', 'arifikmal29031997', 'amirulasyhraffazmi98', 'haziqhelmy3', 'luisyugen', 'hilmy114', 'nurfthah', 'iwana20', 'kkkoo115', 'arexya', 'ooi_benjamin', 'hazemzainal7', 'omnia128', 'pizyo2011', 'karwaikhit1997', 'ooitzepng', 'atiqahazni', 'qistinaa48', 'pym', 'abubakarmughal92', 'csnaim75', 'c1274995299', 'auni0702', 'asyrafjr', 'umar19200', 'arcmalrz', 'shahidah722', 'mihrjeev', 'dannrez', 'ftnndh13', 'rutbeer.991', 'syahidahnasir', 'kaisin_lee', 'rajauwais98', 'kelvinchanwh99', 'taimoor5012', 'akmalkamaruzzaman', 'pu3_888', 'khaier', 'hereisericlai', 'hariz_muz', 'jiahui0323', 'riduwan', 'khohck97', 'chinaharveyum', 'zhenting98', 'ammarhilmi9815']",173,"['tson3', 'mepaul2', 'keerthih22', 'joelgearhart', 'liam.kenny96', 'karldavid', 'amprath2', 'ionsko', 'talee3', 'bdguo2', 'shiwangi.p', 'khuang47', 'mehtavarshil', 'rohitlad93', 'marcanco', 'ppawar', 'clin101', 'mahitha', 'surendhar', 'saphknight', 'kkim142', 'yubai', 'ab20', 'mtschro3', 'mckillo2', 'dszhu2', 'vikram0420', 'luv8patel', 'tommy.boilard', 'janavic2', 'nishad1994', 'yingjunl', 'snsayed06', 'philou231', 'yjeong12', 'elho2', 'sharpee2', 'conanlh2', 'rolesen', 'baharoner90', 'rtorzilli', 'bellmanz', 'eehoneg2', 'ixam25', 'hbh841995', 'dr.karthik2016', 'shim35', 'louis.balsan.1', 'bstewie', 'bve5056', 'tidate2', 'frbourassa', 'taiki', 'vivo2', 'syer2', 'sagar5670', 'reishac2', 'kmrabe', 'sylbbb33', 'vikrant23', 'gitanshu_805702222', 'luca.riccies', 'ajfrank3', 'felicia', 'gacruz007', 'cathou09', 'asadullah2393', 'roclammergeier', 'mjee3', 'rucha_30', 'zohair2', 'jlee742', 'nkrshnn2', 'wtso2', 'omarsm14', 'juanloisfuentes', 'alexmetreveli', 'ved.pragyan', 'dylanb2', 'keven.voyer.1', 'd.ramos.santesmases', 'jrgusta2', 'crunk1005', 'eugenep2', 'perrochibo', 'rfbruck2', 'gacou54', 'zlevell2', 'mipoire', 'setan', 'treppa2', 'ychen388', 'dave.76', 'paqito9999', 'weeei0514', 'saipranith257', 'emwisni2', 'bpbaile2', 'naveensundar', 'alra', 'cisrael2', 'kushaljain', 'edduc4', 'jsharma3', 'jablowi2', 'kaihsinwen', 'kperozek2', 'dreew.yang', 'cplant2', '893580746sumana', 'poggi', 'mguagli2', 'xzhng125', 'sang5', 'larose.alex', 'gninacuri', 'niharika12', 'xxia10', 'mique12', 'seminara.sergio7', 'cbott2', 'mevtimo2', 'thyagugowdaa', 'adonofr2', 'jhpham2', 'enjucho2', 'chfor216', 'dulguun', 'ekisly2', 'neves2', 'sophiagschwalbe', 'sdnayak94', 'zhehan666', 'aneeshj2', 'zy83619', 'allenxg2', 'jgallen3', 'gboudreau03', 'xchartrand', 'zzhan151', 'sweet.robotbd', 'tangjiemu', 'tylerjj2', 'sandy39', 'fredgauv', 'skomar4', 'ashishgajalkar', 'zchen208', 'nycbside95', 'harryf2', 'alex.tplante', 'rwlandi2', 'aakanksha17', 'atan14', 'kenny457802550', 'thierrylapointeleclerc2', 'ahrtmnn2', 'pbehera2', 'dabotop2', 'mohammed_naveed', 'chraps', 'jmdimnd2', 'marcelskra', 'xshan6', 'kaijun6541', 'masiewi2', 'willwheelera', 'titanking231', 'durgasundaram', 'wendidc2', 'fadhilhaziq', 'chuhang.jin', 'donghu']",14,"['zayedh', 'sharifah_fatmadiana', None, 'slapass321', 'hamizanhamdani5079', 'akasyah123456', 'zayan1998', 'baldwenraj', 'wan_ezzat98', 'zaki.hakimi10', 'aymahmed13', 'jasonloo97', 'aaronstonegovin', 'irdnarush']",255,"['asyrafwalkman', 'keerthih22', 'karldavid', 'lukmanafif36', 'ionsko', 'talee3', 'thaqifharith22', 'haziqhelmy98', 'khuang47', 'marcanco', 'ppawar', 'mahitha', 'surendhar', 'mckillo2', 'dszhu2', 'asyrafjr', 'mihrjeev', 'luv8patel', 'kaisin_lee', 'rajauwais98', 'nishad1994', 'yjeong12', 'sharpee2', 'hereisericlai', 'jiahui0323', 'ammarhilmi9815', 'baharoner90', 'sharifah_fatmadiana', 'bellmanz', 'eehoneg2', 'ixam25', 'danialasyrafrahman', 'andy23', 'hbh841995', 'dr.karthik2016', 'shim35', 'louis.balsan.1', 'bve5056', 'slapass321', 'vangurjeet', 'frbourassa', 'taiki', 'vivo2', 'aaronstonegovin', 'ooitzepng', 'reishac2', 'atiqahazni', 'sylbbb33', 'vikrant23', 'csnaim75', 'luca.riccies', 'felicia', 'umar19200', 'arcmalrz', 'asadullah2393', 'ftnndh13', 'mjee3', 'rutbeer.991', 'zohair2', 'jlee742', 'nkrshnn2', 'wtso2', 'omarsm14', 'alexmetreveli', 'rfbruck2', 'crunk1005', 'eugenep2', 'perrochibo', 'setan', 'ychen388', 'weeei0514', 'naveensundar', 'alra', 'mrkedekut', 'fbw27', 'cisrael2', 'haziqhelmy3', 'luisyugen', 'hilmy114', 'jablowi2', 'kperozek2', 'dreew.yang', '893580746sumana', 'poggi', 'mguagli2', 'qistinaa48', 'sang5', 'gninacuri', 'niharika12', 'xxia10', 'mique12', 'seminara.sergio7', 'thyagugowdaa', 'adonofr2', 'chfor216', 'ekisly2', 'neves2', 'sophiagschwalbe', 'chinaharveyum', 'zayedh', 'allenxg2', 'xchartrand', 'sweet.robotbd', 'tangjiemu', 'aymahmed13', 'skomar4', 'ashishgajalkar', 'musyafa', 'zchen208', 'nycbside95', 'harryf2', 'kaiyuan', 'rwlandi2', 'aakanksha17', 'arexya', 'ooi_benjamin', 'thierrylapointeleclerc2', 'omnia128', 'pizyo2011', 'mohammed_naveed', 'pym', 'jmdimnd2', 'marcelskra', 'shahidah722', 'dannrez', 'kaijun6541', 'willwheelera', 'kelvinchanwh99', 'taimoor5012', 'khaier', 'chuhang.jin', 'riduwan', 'donghu', 'tson3', 'mepaul2', 'joelgearhart', 'liam.kenny96', 'amprath2', 'mohamadzulfikar88', 'syahidaam', 'irdnarush', 'bdguo2', 'shiwangi.p', 'mehtavarshil', 'rohitlad93', 'iwana20', 'clin101', 'saphknight', 'hazemzainal7', 'kkim142', 'yubai', 'ab20', 'mtschro3', 'hamizanhamdani5079', 'abubakarmughal92', 'vikram0420', 'tommy.boilard', 'janavic2', 'yingjunl', 'snsayed06', 'philou231', 'elho2', 'baldwenraj', 'conanlh2', 'rolesen', 'rtorzilli', 'julianaredzuan02', 'zaki.hakimi10', 'tokchinkuan', 'bstewie', 'wilsonl98', 'tidate2', 'syer2', 'sagar5670', 'kmrabe', 'gitanshu_805702222', 'ajfrank3', 'c1274995299', 'gacruz007', 'cathou09', 'roclammergeier', None, 'rucha_30', 'juanloisfuentes', 'ved.pragyan', 'pu3_888', 'dylanb2', 'hariz_muz', 'keven.voyer.1', 'd.ramos.santesmases', 'jrgusta2', 'zhenting98', 'gacou54', 'zlevell2', 'ioncy1998', 'mipoire', 'treppa2', 'dave.76', 'paqito9999', 'zayedh001', 'saipranith257', 'emwisni2', 'bpbaile2', 'kushaljain', 'arifikmal29031997', 'nurfthah', 'jsharma3', 'edduc4', 'kkkoo115', 'kaihsinwen', 'cplant2', 'xzhng125', 'larose.alex', 'auni0702', 'cbott2', 'mevtimo2', 'jhpham2', 'enjucho2', 'dulguun', 'sdnayak94', 'zhehan666', 'aneeshj2', 'jasonloo97', 'zayan1998', 'zy83619', 'naziranat', 'jgallen3', 'gboudreau03', 'zzhan151', 'tylerjj2', 'sandy39', 'fredgauv', 'choongshengliang1997', 'akasyah123456', 'alex.tplante', 'athirahz', 'amirulasyhraffazmi98', 'atan14', 'wan_ezzat98', 'kenny457802550', 'ahrtmnn2', 'karwaikhit1997', 'pbehera2', 'dabotop2', 'chraps', 'xshan6', 'masiewi2', 'syahidahnasir', 'titanking231', 'durgasundaram', 'wendidc2', 'akmalkamaruzzaman', 'fadhilhaziq', 'khohck97', 'arifikmal97']"
1,179,241,75,11,"['reishac2', 'allenxg2', 'xzhng125', 'zlevell2', 'tidate2', 'dylanb2', 'tylerjj2', 'vivo2', 'eugenep2', 'aneeshj2', 'shim35']",230,"['tson3', 'mepaul2', 'keerthih22', 'asyrafwalkman', 'joelgearhart', 'liam.kenny96', 'karldavid', 'lukmanafif36', 'amprath2', 'ionsko', 'mohamadzulfikar88', 'talee3', 'syahidaam', 'thaqifharith22', 'haziqhelmy98', 'bdguo2', 'shiwangi.p', 'khuang47', 'mehtavarshil', 'rohitlad93', 'marcanco', 'iwana20', 'ppawar', 'clin101', 'mahitha', 'hazemzainal7', 'surendhar', 'kkim142', 'saphknight', 'yubai', 'ab20', 'mtschro3', 'mckillo2', 'abubakarmughal92', 'dszhu2', 'vikram0420', 'asyrafjr', 'mihrjeev', 'luv8patel', 'tommy.boilard', 'janavic2', 'kaisin_lee', 'rajauwais98', 'yingjunl', 'nishad1994', 'snsayed06', 'philou231', 'yjeong12', 'elho2', 'sharpee2', 'hereisericlai', 'jiahui0323', 'conanlh2', 'ammarhilmi9815', 'rolesen', 'baharoner90', 'rtorzilli', 'bellmanz', 'eehoneg2', 'ixam25', 'danialasyrafrahman', 'andy23', 'julianaredzuan02', 'hbh841995', 'dr.karthik2016', 'louis.balsan.1', 'tokchinkuan', 'bstewie', 'bve5056', 'wilsonl98', 'vangurjeet', 'frbourassa', 'taiki', 'syer2', 'sagar5670', 'ooitzepng', 'kmrabe', 'atiqahazni', 'sylbbb33', 'vikrant23', 'csnaim75', 'luca.riccies', 'ajfrank3', 'c1274995299', 'gitanshu_805702222', 'felicia', 'gacruz007', 'umar19200', 'arcmalrz', 'cathou09', 'asadullah2393', 'roclammergeier', 'ftnndh13', 'mjee3', 'rutbeer.991', 'rucha_30', 'zohair2', 'jlee742', 'nkrshnn2', 'wtso2', 'omarsm14', 'juanloisfuentes', 'alexmetreveli', 'ved.pragyan', 'pu3_888', 'hariz_muz', 'keven.voyer.1', 'd.ramos.santesmases', 'jrgusta2', 'crunk1005', 'zhenting98', 'perrochibo', 'rfbruck2', 'gacou54', 'ioncy1998', 'mipoire', 'setan', 'treppa2', 'ychen388', 'dave.76', 'paqito9999', 'zayedh001', 'weeei0514', 'saipranith257', 'emwisni2', 'bpbaile2', 'naveensundar', 'alra', 'mrkedekut', 'fbw27', 'cisrael2', 'kushaljain', 'arifikmal29031997', 'nurfthah', 'luisyugen', 'hilmy114', 'jsharma3', 'haziqhelmy3', 'kkkoo115', 'jablowi2', 'edduc4', 'kaihsinwen', 'kperozek2', 'dreew.yang', 'cplant2', '893580746sumana', 'poggi', 'mguagli2', 'qistinaa48', 'sang5', 'larose.alex', 'gninacuri', 'niharika12', 'xxia10', 'mique12', 'seminara.sergio7', 'auni0702', 'cbott2', 'mevtimo2', 'thyagugowdaa', 'adonofr2', 'jhpham2', 'enjucho2', 'chfor216', 'dulguun', 'ekisly2', 'neves2', 'sophiagschwalbe', 'sdnayak94', 'chinaharveyum', 'zhehan666', 'zy83619', 'naziranat', 'jgallen3', 'arifikmal97', 'gboudreau03', 'xchartrand', 'zzhan151', 'sweet.robotbd', 'tangjiemu', 'sandy39', 'fredgauv', 'choongshengliang1997', 'skomar4', 'ashishgajalkar', 'musyafa', 'zchen208', 'nycbside95', 'harryf2', 'kaiyuan', 'alex.tplante', 'rwlandi2', 'athirahz', 'amirulasyhraffazmi98', 'aakanksha17', 'arexya', 'atan14', 'kenny457802550', 'ooi_benjamin', 'thierrylapointeleclerc2', 'omnia128', 'pizyo2011', 'karwaikhit1997', 'pbehera2', 'ahrtmnn2', 'dabotop2', 'mohammed_naveed', 'pym', 'chraps', 'jmdimnd2', 'marcelskra', 'shahidah722', 'dannrez', 'xshan6', 'kaijun6541', 'masiewi2', 'syahidahnasir', 'willwheelera', 'kelvinchanwh99', 'titanking231', 'durgasundaram', 'taimoor5012', 'wendidc2', 'akmalkamaruzzaman', 'khaier', 'fadhilhaziq', 'chuhang.jin', 'riduwan', 'khohck97', 'donghu']",64,"['dlee145', 'jarodm2', 'goshan2', 'jiwu2', 'emt2', 'sili5', 'asyang3', 'kph2', 'yusenye2', 'kychui2', 'vfont2', 'sarahrp2', 'myl3', 'yoonjae3', 'amyrm2', 'hahmad7', 'restep2', 'zehuahe2', 'jl49', 'anperry2', 'tjf2', 'juliajh2', 'schoi98', 'baohl2', 'aeh2', 'mollyh2', 'junbaek2', 'yhu55', 'kv2', 'scc3', 'coderko3', 'ckw2', 'kkl3', 'nsk2', 'mmm4', 'mtobah2', 'rsyuan2', 'sk4', 'aztan2', 'isaxton2', 'jinwoo2', 'mengkem2', 'yiqiaol3', 'icegmtle', 'travisc2', 'garnm2', 'caschwa2', 'bharath3', 'pranjal3', 'jillmcar', 'jmjin2', 'donnadc2', 'ckim123', None, 'vkm2', 'qz3', 'shwetab2', 'kevins2', 'djohns85', 'gxiao2', 'ykoyake2', 'dplata2', 'jes3', 'spangnt2']",305,"['asyrafwalkman', 'keerthih22', 'karldavid', 'lukmanafif36', 'ionsko', 'talee3', 'thaqifharith22', 'anperry2', 'tjf2', 'haziqhelmy98', 'khuang47', 'marcanco', 'ppawar', 'aeh2', 'mollyh2', 'scc3', 'mahitha', 'surendhar', 'mckillo2', 'yiqiaol3', 'dszhu2', 'asyrafjr', 'mihrjeev', 'luv8patel', 'kaisin_lee', 'rajauwais98', 'nishad1994', 'yjeong12', 'sharpee2', 'hereisericlai', 'jiahui0323', 'ykoyake2', 'ammarhilmi9815', 'baharoner90', 'jarodm2', 'bellmanz', 'eehoneg2', 'ixam25', 'danialasyrafrahman', 'andy23', 'hbh841995', 'dr.karthik2016', 'shim35', 'louis.balsan.1', 'jl49', 'bve5056', 'vangurjeet', 'schoi98', 'frbourassa', 'taiki', 'vivo2', 'kkl3', 'mtobah2', 'rsyuan2', 'ooitzepng', 'reishac2', 'atiqahazni', 'sylbbb33', 'icegmtle', 'vikrant23', 'csnaim75', 'luca.riccies', 'felicia', 'travisc2', 'umar19200', 'arcmalrz', 'asadullah2393', 'ftnndh13', 'mjee3', 'ckim123', 'rutbeer.991', 'zohair2', 'jlee742', 'nkrshnn2', 'wtso2', 'omarsm14', 'alexmetreveli', 'qz3', 'rfbruck2', 'crunk1005', 'eugenep2', 'perrochibo', 'dplata2', 'spangnt2', 'goshan2', 'jiwu2', 'emt2', 'setan', 'yusenye2', 'ychen388', 'weeei0514', 'yoonjae3', 'zehuahe2', 'naveensundar', 'alra', 'mrkedekut', 'fbw27', 'cisrael2', 'haziqhelmy3', 'luisyugen', 'hilmy114', 'baohl2', 'kv2', 'jablowi2', 'junbaek2', 'yhu55', 'kperozek2', 'dreew.yang', '893580746sumana', 'poggi', 'mguagli2', 'qistinaa48', 'sang5', 'gninacuri', 'niharika12', 'xxia10', 'mique12', 'seminara.sergio7', 'pranjal3', 'thyagugowdaa', 'adonofr2', 'jillmcar', 'jmjin2', 'donnadc2', 'chfor216', 'ekisly2', 'neves2', 'sophiagschwalbe', 'chinaharveyum', 'allenxg2', 'sili5', 'xchartrand', 'sweet.robotbd', 'tangjiemu', 'kychui2', 'vfont2', 'amyrm2', 'restep2', 'skomar4', 'ashishgajalkar', 'musyafa', 'zchen208', 'nycbside95', 'harryf2', 'kaiyuan', 'rwlandi2', 'aakanksha17', 'arexya', 'nsk2', 'kevins2', 'ooi_benjamin', 'mmm4', 'thierrylapointeleclerc2', 'omnia128', 'pizyo2011', 'sk4', 'mohammed_naveed', 'pym', 'mengkem2', 'garnm2', 'jmdimnd2', 'marcelskra', 'shahidah722', 'dannrez', 'kaijun6541', 'willwheelera', 'kelvinchanwh99', 'taimoor5012', 'khaier', 'chuhang.jin', 'riduwan', 'donghu', 'tson3', 'mepaul2', 'joelgearhart', 'liam.kenny96', 'sarahrp2', 'amprath2', 'mohamadzulfikar88', 'syahidaam', 'bdguo2', 'shiwangi.p', 'mehtavarshil', 'rohitlad93', 'iwana20', 'clin101', 'saphknight', 'hazemzainal7', 'kkim142', 'yubai', 'ab20', 'mtschro3', 'isaxton2', 'abubakarmughal92', 'vikram0420', 'tommy.boilard', 'janavic2', 'yingjunl', 'snsayed06', 'philou231', 'elho2', 'djohns85', 'gxiao2', 'conanlh2', 'rolesen', 'rtorzilli', 'asyang3', 'julianaredzuan02', 'hahmad7', 'tokchinkuan', 'bstewie', 'wilsonl98', 'tidate2', 'syer2', 'sagar5670', 'kmrabe', 'jinwoo2', 'gitanshu_805702222', 'ajfrank3', 'c1274995299', 'caschwa2', 'bharath3', 'gacruz007', 'cathou09', 'roclammergeier', None, 'rucha_30', 'juanloisfuentes', 'vkm2', 'ved.pragyan', 'pu3_888', 'dylanb2', 'shwetab2', 'hariz_muz', 'keven.voyer.1', 'd.ramos.santesmases', 'jrgusta2', 'zhenting98', 'gacou54', 'zlevell2', 'ioncy1998', 'mipoire', 'treppa2', 'dave.76', 'paqito9999', 'zayedh001', 'saipranith257', 'emwisni2', 'bpbaile2', 'juliajh2', 'kushaljain', 'arifikmal29031997', 'nurfthah', 'jsharma3', 'edduc4', 'kkkoo115', 'kaihsinwen', 'cplant2', 'aztan2', 'xzhng125', 'larose.alex', 'auni0702', 'cbott2', 'mevtimo2', 'jhpham2', 'enjucho2', 'dulguun', 'sdnayak94', 'zhehan666', 'aneeshj2', 'jes3', 'zy83619', 'naziranat', 'jgallen3', 'dlee145', 'gboudreau03', 'zzhan151', 'kph2', 'tylerjj2', 'sandy39', 'fredgauv', 'choongshengliang1997', 'myl3', 'alex.tplante', 'athirahz', 'amirulasyhraffazmi98', 'atan14', 'coderko3', 'ckw2', 'kenny457802550', 'ahrtmnn2', 'karwaikhit1997', 'pbehera2', 'dabotop2', 'chraps', 'xshan6', 'masiewi2', 'syahidahnasir', 'titanking231', 'durgasundaram', 'wendidc2', 'akmalkamaruzzaman', 'fadhilhaziq', 'khohck97', 'arifikmal97']"
1,19,241,68,66,"['tson3', 'allenxg2', 'jgallen3', 'mepaul2', 'zlevell2', 'eehoneg2', 'zzhan151', 'liam.kenny96', 'treppa2', 'ychen388', 'tylerjj2', 'emwisni2', 'bpbaile2', 'skomar4', 'shim35', 'zchen208', 'nycbside95', 'harryf2', 'bdguo2', 'cisrael2', 'khuang47', 'rwlandi2', 'tidate2', 'jsharma3', 'atan14', 'clin101', 'vivo2', 'kperozek2', 'saphknight', 'cplant2', 'kkim142', 'syer2', 'ahrtmnn2', 'pbehera2', 'ab20', 'mtschro3', 'mguagli2', 'xzhng125', 'reishac2', 'sang5', 'ajfrank3', 'xxia10', 'jmdimnd2', 'mevtimo2', 'cbott2', 'adonofr2', 'xshan6', 'mjee3', 'janavic2', 'zohair2', 'enjucho2', 'masiewi2', 'willwheelera', 'nkrshnn2', 'wtso2', 'jlee742', 'ekisly2', 'neves2', 'yjeong12', 'elho2', 'dylanb2', 'jrgusta2', 'conanlh2', 'rfbruck2', 'eugenep2', 'aneeshj2']",175,"['asyrafwalkman', 'keerthih22', 'joelgearhart', 'karldavid', 'lukmanafif36', 'amprath2', 'ionsko', 'mohamadzulfikar88', 'talee3', 'syahidaam', 'thaqifharith22', 'haziqhelmy98', 'shiwangi.p', 'mehtavarshil', 'rohitlad93', 'marcanco', 'iwana20', 'ppawar', 'mahitha', 'hazemzainal7', 'surendhar', 'yubai', 'mckillo2', 'abubakarmughal92', 'dszhu2', 'vikram0420', 'asyrafjr', 'mihrjeev', 'luv8patel', 'tommy.boilard', 'kaisin_lee', 'rajauwais98', 'yingjunl', 'nishad1994', 'snsayed06', 'philou231', 'sharpee2', 'hereisericlai', 'jiahui0323', 'ammarhilmi9815', 'rolesen', 'baharoner90', 'rtorzilli', 'bellmanz', 'ixam25', 'danialasyrafrahman', 'andy23', 'julianaredzuan02', 'hbh841995', 'dr.karthik2016', 'louis.balsan.1', 'tokchinkuan', 'bstewie', 'bve5056', 'wilsonl98', 'vangurjeet', 'frbourassa', 'taiki', 'sagar5670', 'ooitzepng', 'kmrabe', 'atiqahazni', 'sylbbb33', 'vikrant23', 'csnaim75', 'luca.riccies', 'gitanshu_805702222', 'c1274995299', 'felicia', 'gacruz007', 'umar19200', 'arcmalrz', 'cathou09', 'asadullah2393', 'roclammergeier', 'ftnndh13', 'rutbeer.991', 'rucha_30', 'omarsm14', 'juanloisfuentes', 'alexmetreveli', 'ved.pragyan', 'pu3_888', 'hariz_muz', 'keven.voyer.1', 'd.ramos.santesmases', 'crunk1005', 'zhenting98', 'perrochibo', 'gacou54', 'ioncy1998', 'mipoire', 'setan', 'dave.76', 'paqito9999', 'zayedh001', 'weeei0514', 'saipranith257', 'naveensundar', 'alra', 'mrkedekut', 'fbw27', 'kushaljain', 'arifikmal29031997', 'nurfthah', 'luisyugen', 'hilmy114', 'haziqhelmy3', 'edduc4', 'kkkoo115', 'jablowi2', 'kaihsinwen', 'dreew.yang', '893580746sumana', 'poggi', 'qistinaa48', 'larose.alex', 'gninacuri', 'niharika12', 'seminara.sergio7', 'mique12', 'auni0702', 'thyagugowdaa', 'jhpham2', 'chfor216', 'dulguun', 'sophiagschwalbe', 'sdnayak94', 'chinaharveyum', 'zhehan666', 'zy83619', 'naziranat', 'arifikmal97', 'gboudreau03', 'xchartrand', 'sweet.robotbd', 'tangjiemu', 'sandy39', 'fredgauv', 'choongshengliang1997', 'ashishgajalkar', 'musyafa', 'kaiyuan', 'alex.tplante', 'athirahz', 'amirulasyhraffazmi98', 'aakanksha17', 'arexya', 'kenny457802550', 'ooi_benjamin', 'thierrylapointeleclerc2', 'omnia128', 'pizyo2011', 'karwaikhit1997', 'dabotop2', 'mohammed_naveed', 'pym', 'chraps', 'marcelskra', 'shahidah722', 'dannrez', 'kaijun6541', 'syahidahnasir', 'titanking231', 'kelvinchanwh99', 'durgasundaram', 'taimoor5012', 'wendidc2', 'akmalkamaruzzaman', 'khaier', 'fadhilhaziq', 'chuhang.jin', 'riduwan', 'khohck97', 'donghu']",2,"[None, 'sarahrp2']",243,"['asyrafwalkman', 'keerthih22', 'karldavid', 'lukmanafif36', 'ionsko', 'talee3', 'thaqifharith22', 'haziqhelmy98', 'khuang47', 'marcanco', 'ppawar', 'mahitha', 'surendhar', 'mckillo2', 'dszhu2', 'asyrafjr', 'mihrjeev', 'luv8patel', 'kaisin_lee', 'rajauwais98', 'nishad1994', 'yjeong12', 'sharpee2', 'hereisericlai', 'jiahui0323', 'ammarhilmi9815', 'baharoner90', 'bellmanz', 'eehoneg2', 'ixam25', 'danialasyrafrahman', 'andy23', 'hbh841995', 'dr.karthik2016', 'shim35', 'louis.balsan.1', 'bve5056', 'vangurjeet', 'frbourassa', 'taiki', 'vivo2', 'ooitzepng', 'reishac2', 'atiqahazni', 'sylbbb33', 'vikrant23', 'csnaim75', 'luca.riccies', 'felicia', 'umar19200', 'arcmalrz', 'asadullah2393', 'ftnndh13', 'mjee3', 'rutbeer.991', 'zohair2', 'jlee742', 'nkrshnn2', 'wtso2', 'omarsm14', 'alexmetreveli', 'rfbruck2', 'crunk1005', 'eugenep2', 'perrochibo', 'setan', 'ychen388', 'weeei0514', 'naveensundar', 'alra', 'mrkedekut', 'fbw27', 'cisrael2', 'haziqhelmy3', 'luisyugen', 'hilmy114', 'jablowi2', 'kperozek2', 'dreew.yang', '893580746sumana', 'poggi', 'mguagli2', 'qistinaa48', 'sang5', 'gninacuri', 'niharika12', 'xxia10', 'mique12', 'seminara.sergio7', 'thyagugowdaa', 'adonofr2', 'chfor216', 'ekisly2', 'neves2', 'sophiagschwalbe', 'chinaharveyum', 'allenxg2', 'xchartrand', 'sweet.robotbd', 'tangjiemu', 'skomar4', 'ashishgajalkar', 'musyafa', 'zchen208', 'nycbside95', 'harryf2', 'kaiyuan', 'rwlandi2', 'aakanksha17', 'arexya', 'ooi_benjamin', 'thierrylapointeleclerc2', 'omnia128', 'pizyo2011', 'mohammed_naveed', 'pym', 'jmdimnd2', 'marcelskra', 'shahidah722', 'dannrez', 'kaijun6541', 'willwheelera', 'kelvinchanwh99', 'taimoor5012', 'khaier', 'chuhang.jin', 'riduwan', 'donghu', 'tson3', 'mepaul2', 'joelgearhart', 'liam.kenny96', 'sarahrp2', 'amprath2', 'mohamadzulfikar88', 'syahidaam', 'bdguo2', 'shiwangi.p', 'mehtavarshil', 'rohitlad93', 'iwana20', 'clin101', 'saphknight', 'hazemzainal7', 'kkim142', 'yubai', 'ab20', 'mtschro3', 'abubakarmughal92', 'vikram0420', 'tommy.boilard', 'janavic2', 'yingjunl', 'snsayed06', 'philou231', 'elho2', 'conanlh2', 'rolesen', 'rtorzilli', 'julianaredzuan02', 'tokchinkuan', 'bstewie', 'wilsonl98', 'tidate2', 'syer2', 'sagar5670', 'kmrabe', 'gitanshu_805702222', 'ajfrank3', 'c1274995299', 'gacruz007', 'cathou09', 'roclammergeier', None, 'rucha_30', 'juanloisfuentes', 'ved.pragyan', 'pu3_888', 'dylanb2', 'hariz_muz', 'keven.voyer.1', 'd.ramos.santesmases', 'jrgusta2', 'zhenting98', 'gacou54', 'zlevell2', 'ioncy1998', 'mipoire', 'treppa2', 'dave.76', 'paqito9999', 'zayedh001', 'saipranith257', 'emwisni2', 'bpbaile2', 'kushaljain', 'arifikmal29031997', 'nurfthah', 'jsharma3', 'edduc4', 'kkkoo115', 'kaihsinwen', 'cplant2', 'xzhng125', 'larose.alex', 'auni0702', 'cbott2', 'mevtimo2', 'jhpham2', 'enjucho2', 'dulguun', 'sdnayak94', 'zhehan666', 'aneeshj2', 'zy83619', 'naziranat', 'jgallen3', 'gboudreau03', 'zzhan151', 'tylerjj2', 'sandy39', 'fredgauv', 'choongshengliang1997', 'alex.tplante', 'athirahz', 'amirulasyhraffazmi98', 'atan14', 'kenny457802550', 'ahrtmnn2', 'karwaikhit1997', 'pbehera2', 'dabotop2', 'chraps', 'xshan6', 'masiewi2', 'syahidahnasir', 'titanking231', 'durgasundaram', 'wendidc2', 'akmalkamaruzzaman', 'fadhilhaziq', 'khohck97', 'arifikmal97']"
1,219,241,42,9,"['rajauwais98', 'hilmy114', 'hereisericlai', 'hariz_muz', 'hazemzainal7', 'mihrjeev', 'pizyo2011', 'tokchinkuan', 'rutbeer.991']",232,"['tson3', 'mepaul2', 'keerthih22', 'asyrafwalkman', 'joelgearhart', 'liam.kenny96', 'karldavid', 'lukmanafif36', 'amprath2', 'ionsko', 'mohamadzulfikar88', 'talee3', 'syahidaam', 'thaqifharith22', 'haziqhelmy98', 'bdguo2', 'shiwangi.p', 'khuang47', 'mehtavarshil', 'rohitlad93', 'marcanco', 'iwana20', 'ppawar', 'clin101', 'mahitha', 'surendhar', 'kkim142', 'saphknight', 'yubai', 'ab20', 'mtschro3', 'mckillo2', 'abubakarmughal92', 'dszhu2', 'vikram0420', 'asyrafjr', 'luv8patel', 'tommy.boilard', 'janavic2', 'kaisin_lee', 'yingjunl', 'nishad1994', 'snsayed06', 'philou231', 'yjeong12', 'elho2', 'sharpee2', 'jiahui0323', 'conanlh2', 'ammarhilmi9815', 'rolesen', 'baharoner90', 'rtorzilli', 'bellmanz', 'eehoneg2', 'ixam25', 'danialasyrafrahman', 'andy23', 'julianaredzuan02', 'hbh841995', 'dr.karthik2016', 'shim35', 'louis.balsan.1', 'bstewie', 'bve5056', 'wilsonl98', 'vangurjeet', 'tidate2', 'frbourassa', 'taiki', 'vivo2', 'syer2', 'sagar5670', 'ooitzepng', 'reishac2', 'atiqahazni', 'kmrabe', 'sylbbb33', 'vikrant23', 'csnaim75', 'luca.riccies', 'ajfrank3', 'c1274995299', 'gitanshu_805702222', 'felicia', 'gacruz007', 'umar19200', 'arcmalrz', 'cathou09', 'asadullah2393', 'roclammergeier', 'ftnndh13', 'mjee3', 'rucha_30', 'zohair2', 'jlee742', 'nkrshnn2', 'wtso2', 'omarsm14', 'juanloisfuentes', 'alexmetreveli', 'ved.pragyan', 'pu3_888', 'dylanb2', 'keven.voyer.1', 'd.ramos.santesmases', 'jrgusta2', 'crunk1005', 'zhenting98', 'eugenep2', 'perrochibo', 'rfbruck2', 'gacou54', 'zlevell2', 'ioncy1998', 'mipoire', 'setan', 'treppa2', 'ychen388', 'dave.76', 'paqito9999', 'zayedh001', 'weeei0514', 'donghu', 'saipranith257', 'emwisni2', 'bpbaile2', 'naveensundar', 'alra', 'mrkedekut', 'fbw27', 'cisrael2', 'kushaljain', 'arifikmal29031997', 'nurfthah', 'luisyugen', 'jsharma3', 'haziqhelmy3', 'kkkoo115', 'jablowi2', 'edduc4', 'kaihsinwen', 'kperozek2', 'dreew.yang', 'cplant2', '893580746sumana', 'poggi', 'mguagli2', 'xzhng125', 'qistinaa48', 'sang5', 'larose.alex', 'gninacuri', 'niharika12', 'xxia10', 'mique12', 'seminara.sergio7', 'auni0702', 'cbott2', 'mevtimo2', 'thyagugowdaa', 'adonofr2', 'jhpham2', 'enjucho2', 'chfor216', 'dulguun', 'ekisly2', 'neves2', 'sophiagschwalbe', 'sdnayak94', 'chinaharveyum', 'aneeshj2', 'zhehan666', 'zy83619', 'allenxg2', 'jgallen3', 'naziranat', 'gboudreau03', 'xchartrand', 'zzhan151', 'sweet.robotbd', 'tangjiemu', 'tylerjj2', 'sandy39', 'fredgauv', 'choongshengliang1997', 'skomar4', 'ashishgajalkar', 'musyafa', 'zchen208', 'nycbside95', 'harryf2', 'kaiyuan', 'alex.tplante', 'rwlandi2', 'athirahz', 'amirulasyhraffazmi98', 'aakanksha17', 'arexya', 'atan14', 'kenny457802550', 'ooi_benjamin', 'thierrylapointeleclerc2', 'omnia128', 'karwaikhit1997', 'pbehera2', 'ahrtmnn2', 'dabotop2', 'mohammed_naveed', 'pym', 'chraps', 'jmdimnd2', 'marcelskra', 'shahidah722', 'dannrez', 'xshan6', 'kaijun6541', 'masiewi2', 'syahidahnasir', 'willwheelera', 'kelvinchanwh99', 'titanking231', 'durgasundaram', 'taimoor5012', 'wendidc2', 'akmalkamaruzzaman', 'khaier', 'fadhilhaziq', 'chuhang.jin', 'riduwan', 'khohck97', 'arifikmal97']",33,"['rifqi1398', 'zayedh', 'mohd199912', 'syahminaqiuddins', 'khairel_aqil', 'syarafifaz98', 'qatrisyia', 'arifhallofamer', 'aljaodi', 'isacaudy', 'akasyah123456', 'basirznal98', 'hakim_izani', 'hijrahsalleh28', 'chimingzhi', 'amirulal73', 'kayroll', 'nazmi3', 'rubiksmaniac98', 'mdisyraf19', 'phantom4', 'doominous1', 'hamizanhamdani5079', 'k.m.zihad888', 'edrusmohamad', 'pyc960101', 'gbinula', 'imsinchee', None, 'imranarif', 'rubiksmaniac', 'haqimshahrudin', 'muhamadafiqfarhan98']",274,"['tson3', 'mepaul2', 'keerthih22', 'asyrafwalkman', 'joelgearhart', 'khairel_aqil', 'liam.kenny96', 'aljaodi', 'karldavid', 'lukmanafif36', 'amprath2', 'ionsko', 'mohamadzulfikar88', 'talee3', 'syahidaam', 'thaqifharith22', 'haziqhelmy98', 'bdguo2', 'shiwangi.p', 'khuang47', 'kayroll', 'mehtavarshil', 'rohitlad93', 'marcanco', 'nazmi3', 'iwana20', 'ppawar', 'clin101', 'mahitha', 'hazemzainal7', 'surendhar', 'kkim142', 'saphknight', 'yubai', 'ab20', 'mtschro3', 'mckillo2', 'hamizanhamdani5079', 'k.m.zihad888', 'abubakarmughal92', 'dszhu2', 'vikram0420', 'asyrafjr', 'mihrjeev', 'luv8patel', 'tommy.boilard', 'janavic2', 'kaisin_lee', 'rajauwais98', 'yingjunl', 'nishad1994', 'snsayed06', 'philou231', 'rubiksmaniac', 'yjeong12', 'elho2', 'sharpee2', 'haqimshahrudin', 'hereisericlai', 'jiahui0323', 'conanlh2', 'ammarhilmi9815', 'rolesen', 'baharoner90', 'rtorzilli', 'bellmanz', 'eehoneg2', 'syarafifaz98', 'ixam25', 'danialasyrafrahman', 'andy23', 'julianaredzuan02', 'hbh841995', 'dr.karthik2016', 'basirznal98', 'shim35', 'louis.balsan.1', 'tokchinkuan', 'bstewie', 'bve5056', 'wilsonl98', 'vangurjeet', 'tidate2', 'frbourassa', 'taiki', 'vivo2', 'syer2', 'sagar5670', 'ooitzepng', 'phantom4', 'reishac2', 'atiqahazni', 'kmrabe', 'sylbbb33', 'vikrant23', 'csnaim75', 'luca.riccies', 'ajfrank3', 'c1274995299', 'gitanshu_805702222', 'felicia', 'gacruz007', 'umar19200', 'arcmalrz', 'cathou09', 'asadullah2393', 'roclammergeier', 'ftnndh13', 'mjee3', None, 'rutbeer.991', 'rucha_30', 'zohair2', 'imranarif', 'jlee742', 'nkrshnn2', 'wtso2', 'omarsm14', 'juanloisfuentes', 'alexmetreveli', 'ved.pragyan', 'pu3_888', 'dylanb2', 'hariz_muz', 'keven.voyer.1', 'd.ramos.santesmases', 'jrgusta2', 'crunk1005', 'zhenting98', 'eugenep2', 'perrochibo', 'rfbruck2', 'rifqi1398', 'gacou54', 'zlevell2', 'ioncy1998', 'mohd199912', 'qatrisyia', 'mipoire', 'setan', 'treppa2', 'ychen388', 'dave.76', 'paqito9999', 'isacaudy', 'zayedh001', 'weeei0514', 'donghu', 'saipranith257', 'emwisni2', 'bpbaile2', 'chimingzhi', 'hijrahsalleh28', 'naveensundar', 'alra', 'mrkedekut', 'fbw27', 'cisrael2', 'kushaljain', 'arifikmal29031997', 'nurfthah', 'luisyugen', 'hilmy114', 'jsharma3', 'haziqhelmy3', 'kkkoo115', 'jablowi2', 'edduc4', 'kaihsinwen', 'kperozek2', 'dreew.yang', 'cplant2', '893580746sumana', 'mdisyraf19', 'poggi', 'mguagli2', 'xzhng125', 'qistinaa48', 'sang5', 'larose.alex', 'gninacuri', 'edrusmohamad', 'niharika12', 'xxia10', 'mique12', 'seminara.sergio7', 'auni0702', 'cbott2', 'mevtimo2', 'imsinchee', 'thyagugowdaa', 'adonofr2', 'jhpham2', 'enjucho2', 'chfor216', 'dulguun', 'ekisly2', 'neves2', 'sophiagschwalbe', 'sdnayak94', 'muhamadafiqfarhan98', 'chinaharveyum', 'aneeshj2', 'zhehan666', 'zy83619', 'zayedh', 'allenxg2', 'jgallen3', 'naziranat', 'syahminaqiuddins', 'gboudreau03', 'xchartrand', 'zzhan151', 'arifhallofamer', 'sweet.robotbd', 'tangjiemu', 'tylerjj2', 'sandy39', 'fredgauv', 'choongshengliang1997', 'akasyah123456', 'skomar4', 'hakim_izani', 'ashishgajalkar', 'musyafa', 'amirulal73', 'zchen208', 'nycbside95', 'harryf2', 'kaiyuan', 'alex.tplante', 'rwlandi2', 'athirahz', 'amirulasyhraffazmi98', 'aakanksha17', 'arexya', 'atan14', 'kenny457802550', 'rubiksmaniac98', 'ooi_benjamin', 'thierrylapointeleclerc2', 'omnia128', 'pizyo2011', 'karwaikhit1997', 'pbehera2', 'ahrtmnn2', 'dabotop2', 'mohammed_naveed', 'pym', 'doominous1', 'chraps', 'pyc960101', 'jmdimnd2', 'gbinula', 'marcelskra', 'shahidah722', 'dannrez', 'xshan6', 'kaijun6541', 'masiewi2', 'syahidahnasir', 'willwheelera', 'kelvinchanwh99', 'titanking231', 'durgasundaram', 'taimoor5012', 'wendidc2', 'akmalkamaruzzaman', 'khaier', 'fadhilhaziq', 'chuhang.jin', 'riduwan', 'khohck97', 'arifikmal97']"
1,18,241,32,27,"['keerthih22', 'saipranith257', 'ashishgajalkar', 'shiwangi.p', 'kushaljain', 'rohitlad93', 'aakanksha17', 'mehtavarshil', 'ppawar', 'mahitha', 'surendhar', 'yubai', 'sagar5670', '893580746sumana', 'mohammed_naveed', 'vikrant23', 'gitanshu_805702222', 'niharika12', 'vikram0420', 'luv8patel', 'thyagugowdaa', 'asadullah2393', 'rucha_30', 'nishad1994', 'snsayed06', 'durgasundaram', 'sdnayak94']",214,"['tson3', 'mepaul2', 'asyrafwalkman', 'joelgearhart', 'liam.kenny96', 'karldavid', 'lukmanafif36', 'amprath2', 'ionsko', 'mohamadzulfikar88', 'talee3', 'syahidaam', 'thaqifharith22', 'haziqhelmy98', 'bdguo2', 'khuang47', 'marcanco', 'iwana20', 'clin101', 'hazemzainal7', 'kkim142', 'saphknight', 'ab20', 'mtschro3', 'mckillo2', 'abubakarmughal92', 'dszhu2', 'asyrafjr', 'mihrjeev', 'tommy.boilard', 'janavic2', 'kaisin_lee', 'rajauwais98', 'yingjunl', 'philou231', 'yjeong12', 'elho2', 'sharpee2', 'hereisericlai', 'jiahui0323', 'conanlh2', 'ammarhilmi9815', 'rolesen', 'baharoner90', 'rtorzilli', 'bellmanz', 'eehoneg2', 'ixam25', 'danialasyrafrahman', 'andy23', 'julianaredzuan02', 'hbh841995', 'dr.karthik2016', 'shim35', 'louis.balsan.1', 'tokchinkuan', 'bstewie', 'bve5056', 'wilsonl98', 'vangurjeet', 'tidate2', 'frbourassa', 'taiki', 'vivo2', 'syer2', 'ooitzepng', 'reishac2', 'atiqahazni', 'kmrabe', 'sylbbb33', 'csnaim75', 'luca.riccies', 'ajfrank3', 'c1274995299', 'felicia', 'gacruz007', 'umar19200', 'arcmalrz', 'cathou09', 'roclammergeier', 'ftnndh13', 'mjee3', 'rutbeer.991', 'zohair2', 'jlee742', 'nkrshnn2', 'wtso2', 'omarsm14', 'juanloisfuentes', 'alexmetreveli', 'ved.pragyan', 'pu3_888', 'dylanb2', 'hariz_muz', 'keven.voyer.1', 'd.ramos.santesmases', 'jrgusta2', 'crunk1005', 'zhenting98', 'eugenep2', 'perrochibo', 'rfbruck2', 'gacou54', 'zlevell2', 'ioncy1998', 'mipoire', 'setan', 'treppa2', 'ychen388', 'dave.76', 'paqito9999', 'zayedh001', 'weeei0514', 'donghu', 'emwisni2', 'bpbaile2', 'naveensundar', 'alra', 'mrkedekut', 'fbw27', 'cisrael2', 'arifikmal29031997', 'nurfthah', 'luisyugen', 'hilmy114', 'jsharma3', 'haziqhelmy3', 'kkkoo115', 'jablowi2', 'edduc4', 'kaihsinwen', 'kperozek2', 'dreew.yang', 'cplant2', 'poggi', 'mguagli2', 'xzhng125', 'qistinaa48', 'sang5', 'larose.alex', 'gninacuri', 'xxia10', 'mique12', 'seminara.sergio7', 'auni0702', 'cbott2', 'mevtimo2', 'adonofr2', 'jhpham2', 'enjucho2', 'chfor216', 'dulguun', 'ekisly2', 'neves2', 'sophiagschwalbe', 'chinaharveyum', 'aneeshj2', 'zhehan666', 'zy83619', 'allenxg2', 'jgallen3', 'naziranat', 'gboudreau03', 'xchartrand', 'zzhan151', 'sweet.robotbd', 'tangjiemu', 'tylerjj2', 'sandy39', 'fredgauv', 'choongshengliang1997', 'skomar4', 'musyafa', 'zchen208', 'nycbside95', 'harryf2', 'kaiyuan', 'alex.tplante', 'rwlandi2', 'athirahz', 'amirulasyhraffazmi98', 'arexya', 'atan14', 'kenny457802550', 'ooi_benjamin', 'thierrylapointeleclerc2', 'omnia128', 'pizyo2011', 'karwaikhit1997', 'pbehera2', 'ahrtmnn2', 'dabotop2', 'pym', 'chraps', 'jmdimnd2', 'marcelskra', 'shahidah722', 'dannrez', 'xshan6', 'kaijun6541', 'masiewi2', 'syahidahnasir', 'willwheelera', 'kelvinchanwh99', 'titanking231', 'taimoor5012', 'wendidc2', 'akmalkamaruzzaman', 'khaier', 'fadhilhaziq', 'chuhang.jin', 'riduwan', 'khohck97', 'arifikmal97']",5,"['bhavigna1994', 'suyashvardhansingh', 'luvpatel8', 'krupen3443', None]",246,"['tson3', 'mepaul2', 'keerthih22', 'asyrafwalkman', 'joelgearhart', 'liam.kenny96', 'karldavid', 'lukmanafif36', 'amprath2', 'ionsko', 'mohamadzulfikar88', 'talee3', 'syahidaam', 'thaqifharith22', 'haziqhelmy98', 'bdguo2', 'shiwangi.p', 'khuang47', 'mehtavarshil', 'rohitlad93', 'marcanco', 'iwana20', 'ppawar', 'clin101', 'mahitha', 'hazemzainal7', 'surendhar', 'kkim142', 'saphknight', 'yubai', 'ab20', 'mtschro3', 'mckillo2', 'abubakarmughal92', 'dszhu2', 'vikram0420', 'asyrafjr', 'mihrjeev', 'luv8patel', 'tommy.boilard', 'janavic2', 'kaisin_lee', 'rajauwais98', 'yingjunl', 'nishad1994', 'snsayed06', 'philou231', 'yjeong12', 'elho2', 'sharpee2', 'hereisericlai', 'jiahui0323', 'conanlh2', 'ammarhilmi9815', 'rolesen', 'baharoner90', 'rtorzilli', 'bellmanz', 'eehoneg2', 'ixam25', 'danialasyrafrahman', 'andy23', 'julianaredzuan02', 'hbh841995', 'dr.karthik2016', 'shim35', 'louis.balsan.1', 'tokchinkuan', 'bstewie', 'bve5056', 'wilsonl98', 'vangurjeet', 'tidate2', 'frbourassa', 'taiki', 'vivo2', 'syer2', 'sagar5670', 'ooitzepng', 'reishac2', 'atiqahazni', 'kmrabe', 'sylbbb33', 'vikrant23', 'csnaim75', 'luca.riccies', 'ajfrank3', 'c1274995299', 'gitanshu_805702222', 'felicia', 'gacruz007', 'umar19200', 'arcmalrz', 'cathou09', 'asadullah2393', 'luvpatel8', 'roclammergeier', 'ftnndh13', 'mjee3', None, 'rutbeer.991', 'rucha_30', 'zohair2', 'jlee742', 'nkrshnn2', 'wtso2', 'omarsm14', 'juanloisfuentes', 'alexmetreveli', 'ved.pragyan', 'pu3_888', 'dylanb2', 'hariz_muz', 'keven.voyer.1', 'd.ramos.santesmases', 'jrgusta2', 'crunk1005', 'zhenting98', 'eugenep2', 'perrochibo', 'rfbruck2', 'gacou54', 'zlevell2', 'ioncy1998', 'mipoire', 'setan', 'treppa2', 'ychen388', 'dave.76', 'paqito9999', 'zayedh001', 'weeei0514', 'donghu', 'saipranith257', 'emwisni2', 'bpbaile2', 'naveensundar', 'alra', 'mrkedekut', 'fbw27', 'cisrael2', 'kushaljain', 'arifikmal29031997', 'nurfthah', 'luisyugen', 'hilmy114', 'jsharma3', 'haziqhelmy3', 'kkkoo115', 'jablowi2', 'edduc4', 'kaihsinwen', 'kperozek2', 'dreew.yang', 'cplant2', 'bhavigna1994', 'krupen3443', '893580746sumana', 'poggi', 'mguagli2', 'xzhng125', 'qistinaa48', 'sang5', 'larose.alex', 'gninacuri', 'niharika12', 'xxia10', 'mique12', 'seminara.sergio7', 'auni0702', 'cbott2', 'mevtimo2', 'thyagugowdaa', 'adonofr2', 'jhpham2', 'enjucho2', 'chfor216', 'dulguun', 'ekisly2', 'neves2', 'sophiagschwalbe', 'sdnayak94', 'chinaharveyum', 'aneeshj2', 'zhehan666', 'zy83619', 'allenxg2', 'jgallen3', 'naziranat', 'gboudreau03', 'xchartrand', 'zzhan151', 'sweet.robotbd', 'tangjiemu', 'tylerjj2', 'sandy39', 'fredgauv', 'choongshengliang1997', 'skomar4', 'ashishgajalkar', 'musyafa', 'zchen208', 'nycbside95', 'harryf2', 'kaiyuan', 'alex.tplante', 'rwlandi2', 'athirahz', 'amirulasyhraffazmi98', 'aakanksha17', 'arexya', 'atan14', 'kenny457802550', 'ooi_benjamin', 'thierrylapointeleclerc2', 'omnia128', 'pizyo2011', 'karwaikhit1997', 'pbehera2', 'ahrtmnn2', 'dabotop2', 'mohammed_naveed', 'pym', 'chraps', 'jmdimnd2', 'marcelskra', 'shahidah722', 'dannrez', 'xshan6', 'kaijun6541', 'masiewi2', 'syahidahnasir', 'willwheelera', 'kelvinchanwh99', 'titanking231', 'durgasundaram', 'taimoor5012', 'wendidc2', 'akmalkamaruzzaman', 'suyashvardhansingh', 'khaier', 'fadhilhaziq', 'chuhang.jin', 'riduwan', 'khohck97', 'arifikmal97']"
1,13,241,21,19,"['bellmanz', 'tangjiemu', 'weeei0514', 'ionsko', 'hbh841995', 'naveensundar', 'alra', 'taiki', 'kaihsinwen', 'poggi', 'chraps', 'luca.riccies', 'felicia', 'yingjunl', 'alexmetreveli', 'chuhang.jin', 'd.ramos.santesmases', 'zhehan666', 'donghu']",222,"['tson3', 'mepaul2', 'keerthih22', 'asyrafwalkman', 'joelgearhart', 'liam.kenny96', 'karldavid', 'lukmanafif36', 'amprath2', 'mohamadzulfikar88', 'talee3', 'syahidaam', 'thaqifharith22', 'haziqhelmy98', 'bdguo2', 'shiwangi.p', 'khuang47', 'mehtavarshil', 'rohitlad93', 'marcanco', 'iwana20', 'ppawar', 'clin101', 'mahitha', 'hazemzainal7', 'surendhar', 'kkim142', 'saphknight', 'yubai', 'ab20', 'mtschro3', 'mckillo2', 'abubakarmughal92', 'dszhu2', 'vikram0420', 'asyrafjr', 'mihrjeev', 'luv8patel', 'tommy.boilard', 'janavic2', 'kaisin_lee', 'rajauwais98', 'nishad1994', 'snsayed06', 'philou231', 'yjeong12', 'elho2', 'sharpee2', 'hereisericlai', 'jiahui0323', 'conanlh2', 'ammarhilmi9815', 'rolesen', 'baharoner90', 'rtorzilli', 'eehoneg2', 'ixam25', 'danialasyrafrahman', 'andy23', 'julianaredzuan02', 'dr.karthik2016', 'shim35', 'louis.balsan.1', 'tokchinkuan', 'bstewie', 'bve5056', 'wilsonl98', 'vangurjeet', 'tidate2', 'frbourassa', 'vivo2', 'syer2', 'sagar5670', 'ooitzepng', 'reishac2', 'atiqahazni', 'kmrabe', 'sylbbb33', 'vikrant23', 'csnaim75', 'ajfrank3', 'c1274995299', 'gitanshu_805702222', 'gacruz007', 'umar19200', 'arcmalrz', 'cathou09', 'asadullah2393', 'roclammergeier', 'ftnndh13', 'mjee3', 'rutbeer.991', 'rucha_30', 'zohair2', 'jlee742', 'nkrshnn2', 'wtso2', 'omarsm14', 'juanloisfuentes', 'ved.pragyan', 'pu3_888', 'dylanb2', 'hariz_muz', 'keven.voyer.1', 'jrgusta2', 'crunk1005', 'zhenting98', 'eugenep2', 'perrochibo', 'rfbruck2', 'gacou54', 'zlevell2', 'ioncy1998', 'mipoire', 'setan', 'treppa2', 'ychen388', 'dave.76', 'paqito9999', 'zayedh001', 'saipranith257', 'emwisni2', 'bpbaile2', 'mrkedekut', 'fbw27', 'cisrael2', 'kushaljain', 'arifikmal29031997', 'nurfthah', 'luisyugen', 'hilmy114', 'jsharma3', 'haziqhelmy3', 'kkkoo115', 'jablowi2', 'edduc4', 'kperozek2', 'dreew.yang', 'cplant2', '893580746sumana', 'mguagli2', 'xzhng125', 'qistinaa48', 'sang5', 'larose.alex', 'gninacuri', 'niharika12', 'xxia10', 'mique12', 'seminara.sergio7', 'auni0702', 'cbott2', 'mevtimo2', 'thyagugowdaa', 'adonofr2', 'jhpham2', 'enjucho2', 'chfor216', 'dulguun', 'ekisly2', 'neves2', 'sophiagschwalbe', 'sdnayak94', 'chinaharveyum', 'aneeshj2', 'zy83619', 'allenxg2', 'jgallen3', 'naziranat', 'gboudreau03', 'xchartrand', 'zzhan151', 'sweet.robotbd', 'tylerjj2', 'sandy39', 'fredgauv', 'choongshengliang1997', 'skomar4', 'ashishgajalkar', 'musyafa', 'zchen208', 'nycbside95', 'harryf2', 'kaiyuan', 'alex.tplante', 'rwlandi2', 'athirahz', 'amirulasyhraffazmi98', 'aakanksha17', 'arexya', 'atan14', 'kenny457802550', 'ooi_benjamin', 'thierrylapointeleclerc2', 'omnia128', 'pizyo2011', 'karwaikhit1997', 'pbehera2', 'ahrtmnn2', 'dabotop2', 'mohammed_naveed', 'pym', 'jmdimnd2', 'marcelskra', 'shahidah722', 'dannrez', 'xshan6', 'kaijun6541', 'masiewi2', 'syahidahnasir', 'willwheelera', 'kelvinchanwh99', 'titanking231', 'durgasundaram', 'taimoor5012', 'wendidc2', 'akmalkamaruzzaman', 'khaier', 'fadhilhaziq', 'riduwan', 'khohck97', 'arifikmal97']",2,"['aledafers', None]",243,"['tson3', 'mepaul2', 'keerthih22', 'asyrafwalkman', 'joelgearhart', 'liam.kenny96', 'karldavid', 'lukmanafif36', 'amprath2', 'ionsko', 'mohamadzulfikar88', 'talee3', 'syahidaam', 'thaqifharith22', 'haziqhelmy98', 'bdguo2', 'shiwangi.p', 'khuang47', 'mehtavarshil', 'rohitlad93', 'marcanco', 'iwana20', 'ppawar', 'clin101', 'mahitha', 'hazemzainal7', 'surendhar', 'kkim142', 'saphknight', 'yubai', 'ab20', 'mtschro3', 'mckillo2', 'abubakarmughal92', 'dszhu2', 'vikram0420', 'asyrafjr', 'mihrjeev', 'luv8patel', 'tommy.boilard', 'janavic2', 'kaisin_lee', 'rajauwais98', 'yingjunl', 'nishad1994', 'snsayed06', 'philou231', 'yjeong12', 'elho2', 'sharpee2', 'hereisericlai', 'jiahui0323', 'conanlh2', 'ammarhilmi9815', 'rolesen', 'baharoner90', 'rtorzilli', 'bellmanz', 'eehoneg2', 'ixam25', 'danialasyrafrahman', 'andy23', 'julianaredzuan02', 'hbh841995', 'dr.karthik2016', 'shim35', 'louis.balsan.1', 'tokchinkuan', 'bstewie', 'bve5056', 'wilsonl98', 'vangurjeet', 'tidate2', 'frbourassa', 'taiki', 'vivo2', 'syer2', 'sagar5670', 'ooitzepng', 'reishac2', 'atiqahazni', 'kmrabe', 'sylbbb33', 'vikrant23', 'csnaim75', 'luca.riccies', 'ajfrank3', 'c1274995299', 'gitanshu_805702222', 'felicia', 'gacruz007', 'umar19200', 'arcmalrz', 'cathou09', 'asadullah2393', 'roclammergeier', 'ftnndh13', 'mjee3', None, 'rutbeer.991', 'rucha_30', 'zohair2', 'jlee742', 'nkrshnn2', 'wtso2', 'omarsm14', 'juanloisfuentes', 'alexmetreveli', 'ved.pragyan', 'pu3_888', 'dylanb2', 'hariz_muz', 'keven.voyer.1', 'd.ramos.santesmases', 'jrgusta2', 'crunk1005', 'zhenting98', 'eugenep2', 'perrochibo', 'rfbruck2', 'aledafers', 'gacou54', 'zlevell2', 'ioncy1998', 'mipoire', 'setan', 'treppa2', 'ychen388', 'dave.76', 'paqito9999', 'zayedh001', 'weeei0514', 'donghu', 'saipranith257', 'emwisni2', 'bpbaile2', 'naveensundar', 'alra', 'mrkedekut', 'fbw27', 'cisrael2', 'kushaljain', 'arifikmal29031997', 'nurfthah', 'luisyugen', 'hilmy114', 'jsharma3', 'haziqhelmy3', 'kkkoo115', 'jablowi2', 'edduc4', 'kaihsinwen', 'kperozek2', 'dreew.yang', 'cplant2', '893580746sumana', 'poggi', 'mguagli2', 'xzhng125', 'qistinaa48', 'sang5', 'larose.alex', 'gninacuri', 'niharika12', 'xxia10', 'mique12', 'seminara.sergio7', 'auni0702', 'cbott2', 'mevtimo2', 'thyagugowdaa', 'adonofr2', 'jhpham2', 'enjucho2', 'chfor216', 'dulguun', 'ekisly2', 'neves2', 'sophiagschwalbe', 'sdnayak94', 'chinaharveyum', 'aneeshj2', 'zhehan666', 'zy83619', 'allenxg2', 'jgallen3', 'naziranat', 'gboudreau03', 'xchartrand', 'zzhan151', 'sweet.robotbd', 'tangjiemu', 'tylerjj2', 'sandy39', 'fredgauv', 'choongshengliang1997', 'skomar4', 'ashishgajalkar', 'musyafa', 'zchen208', 'nycbside95', 'harryf2', 'kaiyuan', 'alex.tplante', 'rwlandi2', 'athirahz', 'amirulasyhraffazmi98', 'aakanksha17', 'arexya', 'atan14', 'kenny457802550', 'ooi_benjamin', 'thierrylapointeleclerc2', 'omnia128', 'pizyo2011', 'karwaikhit1997', 'pbehera2', 'ahrtmnn2', 'dabotop2', 'mohammed_naveed', 'pym', 'chraps', 'jmdimnd2', 'marcelskra', 'shahidah722', 'dannrez', 'xshan6', 'kaijun6541', 'masiewi2', 'syahidahnasir', 'willwheelera', 'kelvinchanwh99', 'titanking231', 'durgasundaram', 'taimoor5012', 'wendidc2', 'akmalkamaruzzaman', 'khaier', 'fadhilhaziq', 'chuhang.jin', 'riduwan', 'khohck97', 'arifikmal97']"
1,16,241,20,19,"['gacou54', 'xchartrand', 'gboudreau03', 'mipoire', 'karldavid', 'fredgauv', 'louis.balsan.1', 'alex.tplante', 'edduc4', 'frbourassa', 'thierrylapointeleclerc2', 'larose.alex', 'mique12', 'gacruz007', 'marcelskra', 'tommy.boilard', 'titanking231', 'omarsm14', 'philou231']",222,"['tson3', 'mepaul2', 'keerthih22', 'asyrafwalkman', 'joelgearhart', 'liam.kenny96', 'lukmanafif36', 'amprath2', 'ionsko', 'mohamadzulfikar88', 'talee3', 'syahidaam', 'thaqifharith22', 'haziqhelmy98', 'bdguo2', 'shiwangi.p', 'khuang47', 'mehtavarshil', 'rohitlad93', 'marcanco', 'iwana20', 'ppawar', 'clin101', 'mahitha', 'hazemzainal7', 'surendhar', 'kkim142', 'saphknight', 'yubai', 'ab20', 'mtschro3', 'mckillo2', 'abubakarmughal92', 'dszhu2', 'vikram0420', 'asyrafjr', 'mihrjeev', 'luv8patel', 'janavic2', 'kaisin_lee', 'rajauwais98', 'yingjunl', 'nishad1994', 'snsayed06', 'yjeong12', 'elho2', 'sharpee2', 'hereisericlai', 'jiahui0323', 'conanlh2', 'ammarhilmi9815', 'rolesen', 'baharoner90', 'rtorzilli', 'bellmanz', 'eehoneg2', 'ixam25', 'danialasyrafrahman', 'andy23', 'julianaredzuan02', 'hbh841995', 'dr.karthik2016', 'shim35', 'tokchinkuan', 'bstewie', 'bve5056', 'wilsonl98', 'vangurjeet', 'tidate2', 'taiki', 'vivo2', 'syer2', 'sagar5670', 'ooitzepng', 'reishac2', 'atiqahazni', 'kmrabe', 'sylbbb33', 'vikrant23', 'csnaim75', 'luca.riccies', 'ajfrank3', 'c1274995299', 'gitanshu_805702222', 'felicia', 'umar19200', 'arcmalrz', 'cathou09', 'asadullah2393', 'roclammergeier', 'ftnndh13', 'mjee3', 'rutbeer.991', 'rucha_30', 'zohair2', 'jlee742', 'nkrshnn2', 'wtso2', 'juanloisfuentes', 'alexmetreveli', 'ved.pragyan', 'pu3_888', 'dylanb2', 'hariz_muz', 'keven.voyer.1', 'd.ramos.santesmases', 'jrgusta2', 'crunk1005', 'zhenting98', 'eugenep2', 'perrochibo', 'rfbruck2', 'zlevell2', 'ioncy1998', 'setan', 'treppa2', 'ychen388', 'dave.76', 'paqito9999', 'zayedh001', 'weeei0514', 'donghu', 'saipranith257', 'emwisni2', 'bpbaile2', 'naveensundar', 'alra', 'mrkedekut', 'fbw27', 'cisrael2', 'kushaljain', 'arifikmal29031997', 'nurfthah', 'luisyugen', 'hilmy114', 'jsharma3', 'haziqhelmy3', 'kkkoo115', 'jablowi2', 'kaihsinwen', 'kperozek2', 'dreew.yang', 'cplant2', '893580746sumana', 'poggi', 'mguagli2', 'xzhng125', 'qistinaa48', 'sang5', 'gninacuri', 'niharika12', 'xxia10', 'seminara.sergio7', 'auni0702', 'cbott2', 'mevtimo2', 'thyagugowdaa', 'adonofr2', 'jhpham2', 'enjucho2', 'chfor216', 'dulguun', 'ekisly2', 'neves2', 'sophiagschwalbe', 'sdnayak94', 'chinaharveyum', 'aneeshj2', 'zhehan666', 'zy83619', 'allenxg2', 'jgallen3', 'naziranat', 'zzhan151', 'sweet.robotbd', 'tangjiemu', 'tylerjj2', 'sandy39', 'choongshengliang1997', 'skomar4', 'ashishgajalkar', 'musyafa', 'zchen208', 'nycbside95', 'harryf2', 'kaiyuan', 'rwlandi2', 'athirahz', 'amirulasyhraffazmi98', 'aakanksha17', 'arexya', 'atan14', 'kenny457802550', 'ooi_benjamin', 'omnia128', 'pizyo2011', 'karwaikhit1997', 'pbehera2', 'ahrtmnn2', 'dabotop2', 'mohammed_naveed', 'pym', 'chraps', 'jmdimnd2', 'shahidah722', 'dannrez', 'xshan6', 'kaijun6541', 'masiewi2', 'syahidahnasir', 'willwheelera', 'kelvinchanwh99', 'durgasundaram', 'taimoor5012', 'wendidc2', 'akmalkamaruzzaman', 'khaier', 'fadhilhaziq', 'chuhang.jin', 'riduwan', 'khohck97', 'arifikmal97']",1,[None],242,"['tson3', 'mepaul2', 'keerthih22', 'asyrafwalkman', 'joelgearhart', 'liam.kenny96', 'karldavid', 'lukmanafif36', 'amprath2', 'ionsko', 'mohamadzulfikar88', 'talee3', 'syahidaam', 'thaqifharith22', 'haziqhelmy98', 'bdguo2', 'shiwangi.p', 'khuang47', 'mehtavarshil', 'rohitlad93', 'marcanco', 'iwana20', 'ppawar', 'clin101', 'mahitha', 'hazemzainal7', 'surendhar', 'kkim142', 'saphknight', 'yubai', 'ab20', 'mtschro3', 'mckillo2', 'abubakarmughal92', 'dszhu2', 'vikram0420', 'asyrafjr', 'mihrjeev', 'luv8patel', 'tommy.boilard', 'janavic2', 'kaisin_lee', 'rajauwais98', 'yingjunl', 'nishad1994', 'snsayed06', 'philou231', 'yjeong12', 'elho2', 'sharpee2', 'hereisericlai', 'jiahui0323', 'conanlh2', 'ammarhilmi9815', 'rolesen', 'baharoner90', 'rtorzilli', 'bellmanz', 'eehoneg2', 'ixam25', 'danialasyrafrahman', 'andy23', 'julianaredzuan02', 'hbh841995', 'dr.karthik2016', 'shim35', 'louis.balsan.1', 'tokchinkuan', 'bstewie', 'bve5056', 'wilsonl98', 'vangurjeet', 'tidate2', 'frbourassa', 'taiki', 'vivo2', 'syer2', 'sagar5670', 'ooitzepng', 'reishac2', 'atiqahazni', 'kmrabe', 'sylbbb33', 'vikrant23', 'csnaim75', 'luca.riccies', 'ajfrank3', 'c1274995299', 'gitanshu_805702222', 'felicia', 'gacruz007', 'umar19200', 'arcmalrz', 'cathou09', 'asadullah2393', 'roclammergeier', 'ftnndh13', 'mjee3', None, 'rutbeer.991', 'rucha_30', 'zohair2', 'jlee742', 'nkrshnn2', 'wtso2', 'omarsm14', 'juanloisfuentes', 'alexmetreveli', 'ved.pragyan', 'pu3_888', 'dylanb2', 'hariz_muz', 'keven.voyer.1', 'd.ramos.santesmases', 'jrgusta2', 'crunk1005', 'zhenting98', 'eugenep2', 'perrochibo', 'rfbruck2', 'gacou54', 'zlevell2', 'ioncy1998', 'mipoire', 'setan', 'treppa2', 'ychen388', 'dave.76', 'paqito9999', 'zayedh001', 'weeei0514', 'donghu', 'saipranith257', 'emwisni2', 'bpbaile2', 'naveensundar', 'alra', 'mrkedekut', 'fbw27', 'cisrael2', 'kushaljain', 'arifikmal29031997', 'nurfthah', 'luisyugen', 'hilmy114', 'jsharma3', 'haziqhelmy3', 'kkkoo115', 'jablowi2', 'edduc4', 'kaihsinwen', 'kperozek2', 'dreew.yang', 'cplant2', '893580746sumana', 'poggi', 'mguagli2', 'xzhng125', 'qistinaa48', 'sang5', 'larose.alex', 'gninacuri', 'niharika12', 'xxia10', 'mique12', 'seminara.sergio7', 'auni0702', 'cbott2', 'mevtimo2', 'thyagugowdaa', 'adonofr2', 'jhpham2', 'enjucho2', 'chfor216', 'dulguun', 'ekisly2', 'neves2', 'sophiagschwalbe', 'sdnayak94', 'chinaharveyum', 'aneeshj2', 'zhehan666', 'zy83619', 'allenxg2', 'jgallen3', 'naziranat', 'gboudreau03', 'xchartrand', 'zzhan151', 'sweet.robotbd', 'tangjiemu', 'tylerjj2', 'sandy39', 'fredgauv', 'choongshengliang1997', 'skomar4', 'ashishgajalkar', 'musyafa', 'zchen208', 'nycbside95', 'harryf2', 'kaiyuan', 'alex.tplante', 'rwlandi2', 'athirahz', 'amirulasyhraffazmi98', 'aakanksha17', 'arexya', 'atan14', 'kenny457802550', 'ooi_benjamin', 'thierrylapointeleclerc2', 'omnia128', 'pizyo2011', 'karwaikhit1997', 'pbehera2', 'ahrtmnn2', 'dabotop2', 'mohammed_naveed', 'pym', 'chraps', 'jmdimnd2', 'marcelskra', 'shahidah722', 'dannrez', 'xshan6', 'kaijun6541', 'masiewi2', 'syahidahnasir', 'willwheelera', 'kelvinchanwh99', 'titanking231', 'durgasundaram', 'taimoor5012', 'wendidc2', 'akmalkamaruzzaman', 'khaier', 'fadhilhaziq', 'chuhang.jin', 'riduwan', 'khohck97', 'arifikmal97']"
1,22,241,14,10,"['musyafa', 'kaiyuan', 'amirulasyhraffazmi98', 'auni0702', 'luisyugen', 'umar19200', 'shahidah722', 'choongshengliang1997', 'pizyo2011', 'kaijun6541']",231,"['tson3', 'mepaul2', 'keerthih22', 'asyrafwalkman', 'joelgearhart', 'liam.kenny96', 'karldavid', 'lukmanafif36', 'amprath2', 'ionsko', 'mohamadzulfikar88', 'talee3', 'syahidaam', 'thaqifharith22', 'haziqhelmy98', 'bdguo2', 'shiwangi.p', 'khuang47', 'mehtavarshil', 'rohitlad93', 'marcanco', 'iwana20', 'ppawar', 'clin101', 'mahitha', 'hazemzainal7', 'surendhar', 'kkim142', 'saphknight', 'yubai', 'ab20', 'mtschro3', 'mckillo2', 'abubakarmughal92', 'dszhu2', 'vikram0420', 'asyrafjr', 'mihrjeev', 'luv8patel', 'tommy.boilard', 'janavic2', 'kaisin_lee', 'rajauwais98', 'yingjunl', 'nishad1994', 'snsayed06', 'philou231', 'yjeong12', 'elho2', 'sharpee2', 'hereisericlai', 'jiahui0323', 'conanlh2', 'ammarhilmi9815', 'rolesen', 'baharoner90', 'rtorzilli', 'bellmanz', 'eehoneg2', 'ixam25', 'danialasyrafrahman', 'andy23', 'julianaredzuan02', 'hbh841995', 'dr.karthik2016', 'shim35', 'louis.balsan.1', 'tokchinkuan', 'bstewie', 'bve5056', 'wilsonl98', 'vangurjeet', 'tidate2', 'frbourassa', 'taiki', 'vivo2', 'syer2', 'sagar5670', 'ooitzepng', 'reishac2', 'atiqahazni', 'kmrabe', 'sylbbb33', 'vikrant23', 'csnaim75', 'luca.riccies', 'ajfrank3', 'c1274995299', 'gitanshu_805702222', 'felicia', 'gacruz007', 'arcmalrz', 'cathou09', 'asadullah2393', 'roclammergeier', 'ftnndh13', 'mjee3', 'rutbeer.991', 'rucha_30', 'zohair2', 'jlee742', 'nkrshnn2', 'wtso2', 'omarsm14', 'juanloisfuentes', 'alexmetreveli', 'ved.pragyan', 'pu3_888', 'dylanb2', 'hariz_muz', 'keven.voyer.1', 'd.ramos.santesmases', 'jrgusta2', 'crunk1005', 'zhenting98', 'eugenep2', 'perrochibo', 'rfbruck2', 'gacou54', 'zlevell2', 'ioncy1998', 'mipoire', 'setan', 'treppa2', 'ychen388', 'dave.76', 'paqito9999', 'zayedh001', 'weeei0514', 'donghu', 'saipranith257', 'emwisni2', 'bpbaile2', 'naveensundar', 'alra', 'mrkedekut', 'fbw27', 'cisrael2', 'kushaljain', 'arifikmal29031997', 'nurfthah', 'hilmy114', 'jsharma3', 'haziqhelmy3', 'kkkoo115', 'jablowi2', 'edduc4', 'kaihsinwen', 'kperozek2', 'dreew.yang', 'cplant2', '893580746sumana', 'poggi', 'mguagli2', 'xzhng125', 'qistinaa48', 'sang5', 'larose.alex', 'gninacuri', 'niharika12', 'xxia10', 'mique12', 'seminara.sergio7', 'cbott2', 'mevtimo2', 'thyagugowdaa', 'adonofr2', 'jhpham2', 'enjucho2', 'chfor216', 'dulguun', 'ekisly2', 'neves2', 'sophiagschwalbe', 'sdnayak94', 'chinaharveyum', 'aneeshj2', 'zhehan666', 'zy83619', 'allenxg2', 'jgallen3', 'naziranat', 'gboudreau03', 'xchartrand', 'zzhan151', 'sweet.robotbd', 'tangjiemu', 'tylerjj2', 'sandy39', 'fredgauv', 'skomar4', 'ashishgajalkar', 'zchen208', 'nycbside95', 'harryf2', 'alex.tplante', 'rwlandi2', 'athirahz', 'aakanksha17', 'arexya', 'atan14', 'kenny457802550', 'ooi_benjamin', 'thierrylapointeleclerc2', 'omnia128', 'karwaikhit1997', 'pbehera2', 'ahrtmnn2', 'dabotop2', 'mohammed_naveed', 'pym', 'chraps', 'jmdimnd2', 'marcelskra', 'dannrez', 'xshan6', 'masiewi2', 'syahidahnasir', 'willwheelera', 'kelvinchanwh99', 'titanking231', 'durgasundaram', 'taimoor5012', 'wendidc2', 'akmalkamaruzzaman', 'khaier', 'fadhilhaziq', 'chuhang.jin', 'riduwan', 'khohck97', 'arifikmal97']",4,"['akasyah123456', None, 'slapass321', 'aqila118']",245,"['tson3', 'mepaul2', 'keerthih22', 'asyrafwalkman', 'joelgearhart', 'liam.kenny96', 'karldavid', 'lukmanafif36', 'amprath2', 'ionsko', 'mohamadzulfikar88', 'talee3', 'syahidaam', 'thaqifharith22', 'haziqhelmy98', 'bdguo2', 'shiwangi.p', 'khuang47', 'mehtavarshil', 'rohitlad93', 'marcanco', 'iwana20', 'ppawar', 'clin101', 'mahitha', 'hazemzainal7', 'surendhar', 'kkim142', 'saphknight', 'yubai', 'ab20', 'mtschro3', 'mckillo2', 'abubakarmughal92', 'dszhu2', 'vikram0420', 'asyrafjr', 'mihrjeev', 'luv8patel', 'tommy.boilard', 'janavic2', 'kaisin_lee', 'rajauwais98', 'yingjunl', 'nishad1994', 'snsayed06', 'philou231', 'yjeong12', 'elho2', 'sharpee2', 'hereisericlai', 'jiahui0323', 'conanlh2', 'ammarhilmi9815', 'rolesen', 'baharoner90', 'rtorzilli', 'bellmanz', 'eehoneg2', 'ixam25', 'danialasyrafrahman', 'andy23', 'julianaredzuan02', 'hbh841995', 'dr.karthik2016', 'shim35', 'louis.balsan.1', 'tokchinkuan', 'bstewie', 'bve5056', 'wilsonl98', 'slapass321', 'vangurjeet', 'tidate2', 'frbourassa', 'taiki', 'vivo2', 'syer2', 'sagar5670', 'ooitzepng', 'reishac2', 'atiqahazni', 'kmrabe', 'sylbbb33', 'vikrant23', 'csnaim75', 'luca.riccies', 'ajfrank3', 'c1274995299', 'gitanshu_805702222', 'felicia', 'gacruz007', 'umar19200', 'arcmalrz', 'cathou09', 'asadullah2393', 'roclammergeier', 'ftnndh13', 'mjee3', None, 'rutbeer.991', 'rucha_30', 'zohair2', 'jlee742', 'nkrshnn2', 'wtso2', 'omarsm14', 'juanloisfuentes', 'alexmetreveli', 'ved.pragyan', 'pu3_888', 'dylanb2', 'hariz_muz', 'keven.voyer.1', 'd.ramos.santesmases', 'jrgusta2', 'crunk1005', 'zhenting98', 'eugenep2', 'perrochibo', 'rfbruck2', 'gacou54', 'zlevell2', 'ioncy1998', 'mipoire', 'setan', 'treppa2', 'ychen388', 'dave.76', 'paqito9999', 'zayedh001', 'weeei0514', 'donghu', 'saipranith257', 'emwisni2', 'bpbaile2', 'naveensundar', 'alra', 'mrkedekut', 'fbw27', 'cisrael2', 'kushaljain', 'arifikmal29031997', 'nurfthah', 'luisyugen', 'hilmy114', 'jsharma3', 'haziqhelmy3', 'kkkoo115', 'jablowi2', 'edduc4', 'kaihsinwen', 'kperozek2', 'dreew.yang', 'cplant2', '893580746sumana', 'aqila118', 'poggi', 'mguagli2', 'xzhng125', 'qistinaa48', 'sang5', 'larose.alex', 'gninacuri', 'niharika12', 'xxia10', 'mique12', 'seminara.sergio7', 'auni0702', 'cbott2', 'mevtimo2', 'thyagugowdaa', 'adonofr2', 'jhpham2', 'enjucho2', 'chfor216', 'dulguun', 'ekisly2', 'neves2', 'sophiagschwalbe', 'sdnayak94', 'chinaharveyum', 'aneeshj2', 'zhehan666', 'zy83619', 'allenxg2', 'jgallen3', 'naziranat', 'gboudreau03', 'xchartrand', 'zzhan151', 'sweet.robotbd', 'tangjiemu', 'tylerjj2', 'sandy39', 'fredgauv', 'choongshengliang1997', 'akasyah123456', 'skomar4', 'ashishgajalkar', 'musyafa', 'zchen208', 'nycbside95', 'harryf2', 'kaiyuan', 'alex.tplante', 'rwlandi2', 'athirahz', 'amirulasyhraffazmi98', 'aakanksha17', 'arexya', 'atan14', 'kenny457802550', 'ooi_benjamin', 'thierrylapointeleclerc2', 'omnia128', 'pizyo2011', 'karwaikhit1997', 'pbehera2', 'ahrtmnn2', 'dabotop2', 'mohammed_naveed', 'pym', 'chraps', 'jmdimnd2', 'marcelskra', 'shahidah722', 'dannrez', 'xshan6', 'kaijun6541', 'masiewi2', 'syahidahnasir', 'willwheelera', 'kelvinchanwh99', 'titanking231', 'durgasundaram', 'taimoor5012', 'wendidc2', 'akmalkamaruzzaman', 'khaier', 'fadhilhaziq', 'chuhang.jin', 'riduwan', 'khohck97', 'arifikmal97']"
1,222,241,14,1,['omnia128'],240,"['tson3', 'mepaul2', 'keerthih22', 'asyrafwalkman', 'joelgearhart', 'liam.kenny96', 'karldavid', 'lukmanafif36', 'amprath2', 'ionsko', 'mohamadzulfikar88', 'talee3', 'syahidaam', 'thaqifharith22', 'haziqhelmy98', 'bdguo2', 'shiwangi.p', 'khuang47', 'mehtavarshil', 'rohitlad93', 'marcanco', 'iwana20', 'ppawar', 'clin101', 'mahitha', 'hazemzainal7', 'surendhar', 'kkim142', 'saphknight', 'yubai', 'ab20', 'mtschro3', 'mckillo2', 'abubakarmughal92', 'dszhu2', 'vikram0420', 'asyrafjr', 'mihrjeev', 'luv8patel', 'tommy.boilard', 'janavic2', 'kaisin_lee', 'rajauwais98', 'yingjunl', 'nishad1994', 'snsayed06', 'philou231', 'yjeong12', 'elho2', 'sharpee2', 'hereisericlai', 'jiahui0323', 'conanlh2', 'ammarhilmi9815', 'rolesen', 'baharoner90', 'rtorzilli', 'bellmanz', 'eehoneg2', 'ixam25', 'danialasyrafrahman', 'andy23', 'julianaredzuan02', 'hbh841995', 'dr.karthik2016', 'shim35', 'louis.balsan.1', 'tokchinkuan', 'bstewie', 'bve5056', 'wilsonl98', 'vangurjeet', 'tidate2', 'frbourassa', 'taiki', 'vivo2', 'syer2', 'sagar5670', 'ooitzepng', 'reishac2', 'atiqahazni', 'kmrabe', 'sylbbb33', 'vikrant23', 'csnaim75', 'luca.riccies', 'ajfrank3', 'c1274995299', 'gitanshu_805702222', 'felicia', 'gacruz007', 'umar19200', 'arcmalrz', 'cathou09', 'asadullah2393', 'roclammergeier', 'ftnndh13', 'mjee3', 'rutbeer.991', 'rucha_30', 'zohair2', 'jlee742', 'nkrshnn2', 'wtso2', 'omarsm14', 'juanloisfuentes', 'alexmetreveli', 'ved.pragyan', 'pu3_888', 'dylanb2', 'hariz_muz', 'keven.voyer.1', 'd.ramos.santesmases', 'jrgusta2', 'crunk1005', 'zhenting98', 'eugenep2', 'perrochibo', 'rfbruck2', 'gacou54', 'zlevell2', 'ioncy1998', 'mipoire', 'setan', 'treppa2', 'ychen388', 'dave.76', 'paqito9999', 'zayedh001', 'weeei0514', 'donghu', 'saipranith257', 'emwisni2', 'bpbaile2', 'naveensundar', 'alra', 'mrkedekut', 'fbw27', 'cisrael2', 'kushaljain', 'arifikmal29031997', 'nurfthah', 'luisyugen', 'hilmy114', 'jsharma3', 'haziqhelmy3', 'kkkoo115', 'jablowi2', 'edduc4', 'kaihsinwen', 'kperozek2', 'dreew.yang', 'cplant2', '893580746sumana', 'poggi', 'mguagli2', 'xzhng125', 'qistinaa48', 'sang5', 'larose.alex', 'gninacuri', 'niharika12', 'xxia10', 'mique12', 'seminara.sergio7', 'auni0702', 'cbott2', 'mevtimo2', 'thyagugowdaa', 'adonofr2', 'jhpham2', 'enjucho2', 'chfor216', 'dulguun', 'ekisly2', 'neves2', 'sophiagschwalbe', 'sdnayak94', 'chinaharveyum', 'aneeshj2', 'zhehan666', 'zy83619', 'allenxg2', 'jgallen3', 'naziranat', 'gboudreau03', 'xchartrand', 'zzhan151', 'sweet.robotbd', 'tangjiemu', 'tylerjj2', 'sandy39', 'fredgauv', 'choongshengliang1997', 'skomar4', 'ashishgajalkar', 'musyafa', 'zchen208', 'nycbside95', 'harryf2', 'kaiyuan', 'alex.tplante', 'rwlandi2', 'athirahz', 'amirulasyhraffazmi98', 'aakanksha17', 'arexya', 'atan14', 'kenny457802550', 'ooi_benjamin', 'thierrylapointeleclerc2', 'pizyo2011', 'karwaikhit1997', 'pbehera2', 'ahrtmnn2', 'dabotop2', 'mohammed_naveed', 'pym', 'chraps', 'jmdimnd2', 'marcelskra', 'shahidah722', 'dannrez', 'xshan6', 'kaijun6541', 'masiewi2', 'syahidahnasir', 'willwheelera', 'kelvinchanwh99', 'titanking231', 'durgasundaram', 'taimoor5012', 'wendidc2', 'akmalkamaruzzaman', 'khaier', 'fadhilhaziq', 'chuhang.jin', 'riduwan', 'khohck97', 'arifikmal97']",13,"['hamizanhamdani5079', 'syahminaqiuddins', 'ihsan92', 'pyc960101', 'qatrisyia', 'atiqahkhaishah', 'meftahulturag', 'aliff98', 'muaz.zulkarnain98', 'imsinchee', 'hijrahsalleh28', None, 'mdisyraf19']",254,"['tson3', 'mepaul2', 'keerthih22', 'asyrafwalkman', 'joelgearhart', 'liam.kenny96', 'karldavid', 'lukmanafif36', 'amprath2', 'ionsko', 'mohamadzulfikar88', 'talee3', 'syahidaam', 'thaqifharith22', 'haziqhelmy98', 'bdguo2', 'shiwangi.p', 'khuang47', 'mehtavarshil', 'rohitlad93', 'marcanco', 'iwana20', 'ppawar', 'clin101', 'mahitha', 'hazemzainal7', 'surendhar', 'kkim142', 'saphknight', 'muaz.zulkarnain98', 'yubai', 'ab20', 'mtschro3', 'mckillo2', 'hamizanhamdani5079', 'abubakarmughal92', 'dszhu2', 'vikram0420', 'asyrafjr', 'mihrjeev', 'luv8patel', 'tommy.boilard', 'janavic2', 'kaisin_lee', 'rajauwais98', 'yingjunl', 'nishad1994', 'snsayed06', 'philou231', 'yjeong12', 'elho2', 'sharpee2', 'hereisericlai', 'jiahui0323', 'conanlh2', 'ammarhilmi9815', 'rolesen', 'baharoner90', 'rtorzilli', 'bellmanz', 'eehoneg2', 'ixam25', 'danialasyrafrahman', 'andy23', 'julianaredzuan02', 'hbh841995', 'dr.karthik2016', 'shim35', 'louis.balsan.1', 'tokchinkuan', 'bstewie', 'bve5056', 'wilsonl98', 'vangurjeet', 'tidate2', 'frbourassa', 'taiki', 'vivo2', 'syer2', 'sagar5670', 'ooitzepng', 'reishac2', 'atiqahazni', 'kmrabe', 'sylbbb33', 'vikrant23', 'csnaim75', 'luca.riccies', 'ajfrank3', 'c1274995299', 'gitanshu_805702222', 'felicia', 'gacruz007', 'umar19200', 'arcmalrz', 'cathou09', 'asadullah2393', 'roclammergeier', 'ftnndh13', 'mjee3', None, 'rutbeer.991', 'rucha_30', 'zohair2', 'jlee742', 'nkrshnn2', 'wtso2', 'omarsm14', 'juanloisfuentes', 'alexmetreveli', 'ved.pragyan', 'pu3_888', 'dylanb2', 'atiqahkhaishah', 'hariz_muz', 'keven.voyer.1', 'd.ramos.santesmases', 'jrgusta2', 'crunk1005', 'zhenting98', 'eugenep2', 'perrochibo', 'rfbruck2', 'gacou54', 'zlevell2', 'ioncy1998', 'qatrisyia', 'mipoire', 'setan', 'treppa2', 'ychen388', 'dave.76', 'paqito9999', 'zayedh001', 'weeei0514', 'donghu', 'saipranith257', 'emwisni2', 'bpbaile2', 'hijrahsalleh28', 'naveensundar', 'alra', 'mrkedekut', 'fbw27', 'cisrael2', 'kushaljain', 'arifikmal29031997', 'nurfthah', 'luisyugen', 'hilmy114', 'jsharma3', 'haziqhelmy3', 'kkkoo115', 'jablowi2', 'edduc4', 'kaihsinwen', 'kperozek2', 'dreew.yang', 'cplant2', '893580746sumana', 'mdisyraf19', 'poggi', 'mguagli2', 'xzhng125', 'qistinaa48', 'sang5', 'larose.alex', 'gninacuri', 'niharika12', 'xxia10', 'mique12', 'seminara.sergio7', 'auni0702', 'cbott2', 'mevtimo2', 'meftahulturag', 'imsinchee', 'thyagugowdaa', 'adonofr2', 'jhpham2', 'enjucho2', 'chfor216', 'dulguun', 'ekisly2', 'neves2', 'sophiagschwalbe', 'sdnayak94', 'chinaharveyum', 'aneeshj2', 'zhehan666', 'zy83619', 'allenxg2', 'jgallen3', 'naziranat', 'syahminaqiuddins', 'gboudreau03', 'xchartrand', 'zzhan151', 'sweet.robotbd', 'tangjiemu', 'tylerjj2', 'sandy39', 'fredgauv', 'choongshengliang1997', 'skomar4', 'ashishgajalkar', 'musyafa', 'zchen208', 'nycbside95', 'harryf2', 'kaiyuan', 'alex.tplante', 'ihsan92', 'rwlandi2', 'athirahz', 'amirulasyhraffazmi98', 'aakanksha17', 'arexya', 'atan14', 'kenny457802550', 'ooi_benjamin', 'thierrylapointeleclerc2', 'omnia128', 'pizyo2011', 'karwaikhit1997', 'pbehera2', 'ahrtmnn2', 'dabotop2', 'mohammed_naveed', 'pym', 'chraps', 'pyc960101', 'jmdimnd2', 'marcelskra', 'shahidah722', 'dannrez', 'xshan6', 'kaijun6541', 'masiewi2', 'syahidahnasir', 'willwheelera', 'kelvinchanwh99', 'titanking231', 'durgasundaram', 'taimoor5012', 'wendidc2', 'akmalkamaruzzaman', 'khaier', 'fadhilhaziq', 'chuhang.jin', 'riduwan', 'aliff98', 'khohck97', 'arifikmal97']"
1,14,241,10,1,['dulguun'],240,"['tson3', 'mepaul2', 'keerthih22', 'asyrafwalkman', 'joelgearhart', 'liam.kenny96', 'karldavid', 'lukmanafif36', 'amprath2', 'ionsko', 'mohamadzulfikar88', 'talee3', 'syahidaam', 'thaqifharith22', 'haziqhelmy98', 'bdguo2', 'shiwangi.p', 'khuang47', 'mehtavarshil', 'rohitlad93', 'marcanco', 'iwana20', 'ppawar', 'clin101', 'mahitha', 'hazemzainal7', 'surendhar', 'kkim142', 'saphknight', 'yubai', 'ab20', 'mtschro3', 'mckillo2', 'abubakarmughal92', 'dszhu2', 'vikram0420', 'asyrafjr', 'mihrjeev', 'luv8patel', 'tommy.boilard', 'janavic2', 'kaisin_lee', 'rajauwais98', 'yingjunl', 'nishad1994', 'snsayed06', 'philou231', 'yjeong12', 'elho2', 'sharpee2', 'hereisericlai', 'jiahui0323', 'conanlh2', 'ammarhilmi9815', 'rolesen', 'baharoner90', 'rtorzilli', 'bellmanz', 'eehoneg2', 'ixam25', 'danialasyrafrahman', 'andy23', 'julianaredzuan02', 'hbh841995', 'dr.karthik2016', 'shim35', 'louis.balsan.1', 'tokchinkuan', 'bstewie', 'bve5056', 'wilsonl98', 'vangurjeet', 'tidate2', 'frbourassa', 'taiki', 'vivo2', 'syer2', 'sagar5670', 'ooitzepng', 'reishac2', 'atiqahazni', 'kmrabe', 'sylbbb33', 'vikrant23', 'csnaim75', 'luca.riccies', 'ajfrank3', 'c1274995299', 'gitanshu_805702222', 'felicia', 'gacruz007', 'umar19200', 'arcmalrz', 'cathou09', 'asadullah2393', 'roclammergeier', 'ftnndh13', 'mjee3', 'rutbeer.991', 'rucha_30', 'zohair2', 'jlee742', 'nkrshnn2', 'wtso2', 'omarsm14', 'juanloisfuentes', 'alexmetreveli', 'ved.pragyan', 'pu3_888', 'dylanb2', 'hariz_muz', 'keven.voyer.1', 'd.ramos.santesmases', 'jrgusta2', 'crunk1005', 'zhenting98', 'eugenep2', 'perrochibo', 'rfbruck2', 'gacou54', 'zlevell2', 'ioncy1998', 'mipoire', 'setan', 'treppa2', 'ychen388', 'dave.76', 'paqito9999', 'zayedh001', 'weeei0514', 'donghu', 'saipranith257', 'emwisni2', 'bpbaile2', 'naveensundar', 'alra', 'mrkedekut', 'fbw27', 'cisrael2', 'kushaljain', 'arifikmal29031997', 'nurfthah', 'luisyugen', 'hilmy114', 'jsharma3', 'haziqhelmy3', 'kkkoo115', 'jablowi2', 'edduc4', 'kaihsinwen', 'kperozek2', 'dreew.yang', 'cplant2', '893580746sumana', 'poggi', 'mguagli2', 'xzhng125', 'qistinaa48', 'sang5', 'larose.alex', 'gninacuri', 'niharika12', 'xxia10', 'mique12', 'seminara.sergio7', 'auni0702', 'cbott2', 'mevtimo2', 'thyagugowdaa', 'adonofr2', 'jhpham2', 'enjucho2', 'chfor216', 'ekisly2', 'neves2', 'sophiagschwalbe', 'sdnayak94', 'chinaharveyum', 'aneeshj2', 'zhehan666', 'zy83619', 'allenxg2', 'jgallen3', 'naziranat', 'gboudreau03', 'xchartrand', 'zzhan151', 'sweet.robotbd', 'tangjiemu', 'tylerjj2', 'sandy39', 'fredgauv', 'choongshengliang1997', 'skomar4', 'ashishgajalkar', 'musyafa', 'zchen208', 'nycbside95', 'harryf2', 'kaiyuan', 'alex.tplante', 'rwlandi2', 'athirahz', 'amirulasyhraffazmi98', 'aakanksha17', 'arexya', 'atan14', 'kenny457802550', 'ooi_benjamin', 'thierrylapointeleclerc2', 'omnia128', 'pizyo2011', 'karwaikhit1997', 'pbehera2', 'ahrtmnn2', 'dabotop2', 'mohammed_naveed', 'pym', 'chraps', 'jmdimnd2', 'marcelskra', 'shahidah722', 'dannrez', 'xshan6', 'kaijun6541', 'masiewi2', 'syahidahnasir', 'willwheelera', 'kelvinchanwh99', 'titanking231', 'durgasundaram', 'taimoor5012', 'wendidc2', 'akmalkamaruzzaman', 'khaier', 'fadhilhaziq', 'chuhang.jin', 'riduwan', 'khohck97', 'arifikmal97']",9,"['ext2a96', None, 'tornado_u', 'amraa061', 'n.batkaa', 'ganguye', 'davaanaa010101', 'battulga9192', 'bulganbatjargal']",250,"['tson3', 'mepaul2', 'keerthih22', 'asyrafwalkman', 'joelgearhart', 'liam.kenny96', 'karldavid', 'lukmanafif36', 'amprath2', 'ionsko', 'mohamadzulfikar88', 'talee3', 'syahidaam', 'thaqifharith22', 'haziqhelmy98', 'bdguo2', 'shiwangi.p', 'khuang47', 'mehtavarshil', 'rohitlad93', 'marcanco', 'iwana20', 'ppawar', 'clin101', 'mahitha', 'hazemzainal7', 'surendhar', 'kkim142', 'saphknight', 'yubai', 'ab20', 'mtschro3', 'mckillo2', 'amraa061', 'abubakarmughal92', 'dszhu2', 'vikram0420', 'asyrafjr', 'mihrjeev', 'luv8patel', 'tommy.boilard', 'janavic2', 'ext2a96', 'kaisin_lee', 'rajauwais98', 'yingjunl', 'nishad1994', 'snsayed06', 'philou231', 'yjeong12', 'elho2', 'sharpee2', 'hereisericlai', 'jiahui0323', 'conanlh2', 'ammarhilmi9815', 'rolesen', 'baharoner90', 'rtorzilli', 'bellmanz', 'eehoneg2', 'ixam25', 'danialasyrafrahman', 'andy23', 'julianaredzuan02', 'hbh841995', 'dr.karthik2016', 'shim35', 'louis.balsan.1', 'tokchinkuan', 'bstewie', 'bve5056', 'wilsonl98', 'vangurjeet', 'tidate2', 'frbourassa', 'taiki', 'vivo2', 'syer2', 'sagar5670', 'ooitzepng', 'reishac2', 'atiqahazni', 'kmrabe', 'sylbbb33', 'vikrant23', 'csnaim75', 'luca.riccies', 'ajfrank3', 'c1274995299', 'gitanshu_805702222', 'felicia', 'gacruz007', 'umar19200', 'arcmalrz', 'cathou09', 'asadullah2393', 'ganguye', 'roclammergeier', 'ftnndh13', 'mjee3', None, 'rutbeer.991', 'rucha_30', 'zohair2', 'jlee742', 'nkrshnn2', 'wtso2', 'omarsm14', 'juanloisfuentes', 'alexmetreveli', 'ved.pragyan', 'pu3_888', 'dylanb2', 'hariz_muz', 'keven.voyer.1', 'd.ramos.santesmases', 'jrgusta2', 'crunk1005', 'zhenting98', 'eugenep2', 'perrochibo', 'rfbruck2', 'davaanaa010101', 'gacou54', 'zlevell2', 'ioncy1998', 'mipoire', 'setan', 'treppa2', 'ychen388', 'dave.76', 'paqito9999', 'zayedh001', 'weeei0514', 'donghu', 'saipranith257', 'emwisni2', 'bpbaile2', 'naveensundar', 'alra', 'mrkedekut', 'fbw27', 'cisrael2', 'kushaljain', 'arifikmal29031997', 'nurfthah', 'luisyugen', 'hilmy114', 'jsharma3', 'haziqhelmy3', 'kkkoo115', 'jablowi2', 'edduc4', 'kaihsinwen', 'kperozek2', 'dreew.yang', 'cplant2', '893580746sumana', 'poggi', 'mguagli2', 'xzhng125', 'qistinaa48', 'sang5', 'larose.alex', 'gninacuri', 'niharika12', 'xxia10', 'mique12', 'seminara.sergio7', 'auni0702', 'cbott2', 'mevtimo2', 'thyagugowdaa', 'adonofr2', 'jhpham2', 'bulganbatjargal', 'enjucho2', 'chfor216', 'dulguun', 'ekisly2', 'neves2', 'sophiagschwalbe', 'sdnayak94', 'chinaharveyum', 'aneeshj2', 'zhehan666', 'zy83619', 'allenxg2', 'jgallen3', 'naziranat', 'gboudreau03', 'xchartrand', 'zzhan151', 'sweet.robotbd', 'tangjiemu', 'tylerjj2', 'sandy39', 'fredgauv', 'choongshengliang1997', 'skomar4', 'ashishgajalkar', 'musyafa', 'zchen208', 'nycbside95', 'harryf2', 'kaiyuan', 'alex.tplante', 'rwlandi2', 'athirahz', 'amirulasyhraffazmi98', 'aakanksha17', 'arexya', 'atan14', 'kenny457802550', 'ooi_benjamin', 'thierrylapointeleclerc2', 'omnia128', 'pizyo2011', 'karwaikhit1997', 'pbehera2', 'ahrtmnn2', 'dabotop2', 'mohammed_naveed', 'pym', 'chraps', 'jmdimnd2', 'marcelskra', 'shahidah722', 'dannrez', 'xshan6', 'kaijun6541', 'battulga9192', 'masiewi2', 'syahidahnasir', 'willwheelera', 'kelvinchanwh99', 'titanking231', 'durgasundaram', 'taimoor5012', 'tornado_u', 'wendidc2', 'akmalkamaruzzaman', 'khaier', 'fadhilhaziq', 'chuhang.jin', 'riduwan', 'n.batkaa', 'khohck97', 'arifikmal97']"
1,220,241,10,5,"['rajauwais98', 'kkkoo115', 'mihrjeev', 'tokchinkuan', 'rutbeer.991']",236,"['tson3', 'mepaul2', 'keerthih22', 'asyrafwalkman', 'joelgearhart', 'liam.kenny96', 'karldavid', 'lukmanafif36', 'amprath2', 'ionsko', 'mohamadzulfikar88', 'talee3', 'syahidaam', 'thaqifharith22', 'haziqhelmy98', 'bdguo2', 'shiwangi.p', 'khuang47', 'mehtavarshil', 'rohitlad93', 'marcanco', 'iwana20', 'ppawar', 'clin101', 'mahitha', 'hazemzainal7', 'surendhar', 'kkim142', 'saphknight', 'yubai', 'ab20', 'mtschro3', 'mckillo2', 'abubakarmughal92', 'dszhu2', 'vikram0420', 'asyrafjr', 'luv8patel', 'tommy.boilard', 'janavic2', 'kaisin_lee', 'yingjunl', 'nishad1994', 'snsayed06', 'philou231', 'yjeong12', 'elho2', 'sharpee2', 'hereisericlai', 'jiahui0323', 'conanlh2', 'ammarhilmi9815', 'rolesen', 'baharoner90', 'rtorzilli', 'bellmanz', 'eehoneg2', 'ixam25', 'danialasyrafrahman', 'andy23', 'julianaredzuan02', 'hbh841995', 'dr.karthik2016', 'shim35', 'louis.balsan.1', 'bstewie', 'bve5056', 'wilsonl98', 'vangurjeet', 'tidate2', 'frbourassa', 'taiki', 'vivo2', 'syer2', 'sagar5670', 'ooitzepng', 'reishac2', 'atiqahazni', 'kmrabe', 'sylbbb33', 'vikrant23', 'csnaim75', 'luca.riccies', 'ajfrank3', 'c1274995299', 'gitanshu_805702222', 'felicia', 'gacruz007', 'umar19200', 'arcmalrz', 'cathou09', 'asadullah2393', 'roclammergeier', 'ftnndh13', 'mjee3', 'rucha_30', 'zohair2', 'jlee742', 'nkrshnn2', 'wtso2', 'omarsm14', 'juanloisfuentes', 'alexmetreveli', 'ved.pragyan', 'pu3_888', 'dylanb2', 'hariz_muz', 'keven.voyer.1', 'd.ramos.santesmases', 'jrgusta2', 'crunk1005', 'zhenting98', 'eugenep2', 'perrochibo', 'rfbruck2', 'gacou54', 'zlevell2', 'ioncy1998', 'mipoire', 'setan', 'treppa2', 'ychen388', 'dave.76', 'paqito9999', 'zayedh001', 'weeei0514', 'donghu', 'saipranith257', 'emwisni2', 'bpbaile2', 'naveensundar', 'alra', 'mrkedekut', 'fbw27', 'cisrael2', 'kushaljain', 'arifikmal29031997', 'nurfthah', 'luisyugen', 'hilmy114', 'jsharma3', 'haziqhelmy3', 'jablowi2', 'edduc4', 'kaihsinwen', 'kperozek2', 'dreew.yang', 'cplant2', '893580746sumana', 'poggi', 'mguagli2', 'xzhng125', 'qistinaa48', 'sang5', 'larose.alex', 'gninacuri', 'niharika12', 'xxia10', 'mique12', 'seminara.sergio7', 'auni0702', 'cbott2', 'mevtimo2', 'thyagugowdaa', 'adonofr2', 'jhpham2', 'enjucho2', 'chfor216', 'dulguun', 'ekisly2', 'neves2', 'sophiagschwalbe', 'sdnayak94', 'chinaharveyum', 'aneeshj2', 'zhehan666', 'zy83619', 'allenxg2', 'jgallen3', 'naziranat', 'gboudreau03', 'xchartrand', 'zzhan151', 'sweet.robotbd', 'tangjiemu', 'tylerjj2', 'sandy39', 'fredgauv', 'choongshengliang1997', 'skomar4', 'ashishgajalkar', 'musyafa', 'zchen208', 'nycbside95', 'harryf2', 'kaiyuan', 'alex.tplante', 'rwlandi2', 'athirahz', 'amirulasyhraffazmi98', 'aakanksha17', 'arexya', 'atan14', 'kenny457802550', 'ooi_benjamin', 'thierrylapointeleclerc2', 'omnia128', 'pizyo2011', 'karwaikhit1997', 'pbehera2', 'ahrtmnn2', 'dabotop2', 'mohammed_naveed', 'pym', 'chraps', 'jmdimnd2', 'marcelskra', 'shahidah722', 'dannrez', 'xshan6', 'kaijun6541', 'masiewi2', 'syahidahnasir', 'willwheelera', 'kelvinchanwh99', 'titanking231', 'durgasundaram', 'taimoor5012', 'wendidc2', 'akmalkamaruzzaman', 'khaier', 'fadhilhaziq', 'chuhang.jin', 'riduwan', 'khohck97', 'arifikmal97']",5,"['zayedh', 'hamizanhamdani5079', 'zayan1998', 'jasonloo97', None]",246,"['tson3', 'mepaul2', 'keerthih22', 'asyrafwalkman', 'joelgearhart', 'liam.kenny96', 'karldavid', 'lukmanafif36', 'amprath2', 'ionsko', 'mohamadzulfikar88', 'talee3', 'syahidaam', 'thaqifharith22', 'haziqhelmy98', 'bdguo2', 'shiwangi.p', 'khuang47', 'mehtavarshil', 'rohitlad93', 'marcanco', 'iwana20', 'ppawar', 'clin101', 'mahitha', 'hazemzainal7', 'surendhar', 'kkim142', 'saphknight', 'yubai', 'ab20', 'mtschro3', 'mckillo2', 'hamizanhamdani5079', 'abubakarmughal92', 'dszhu2', 'vikram0420', 'asyrafjr', 'mihrjeev', 'luv8patel', 'tommy.boilard', 'janavic2', 'kaisin_lee', 'rajauwais98', 'yingjunl', 'nishad1994', 'snsayed06', 'philou231', 'yjeong12', 'elho2', 'sharpee2', 'hereisericlai', 'jiahui0323', 'conanlh2', 'ammarhilmi9815', 'rolesen', 'baharoner90', 'rtorzilli', 'bellmanz', 'eehoneg2', 'ixam25', 'danialasyrafrahman', 'andy23', 'julianaredzuan02', 'hbh841995', 'dr.karthik2016', 'shim35', 'louis.balsan.1', 'tokchinkuan', 'bstewie', 'bve5056', 'wilsonl98', 'vangurjeet', 'tidate2', 'frbourassa', 'taiki', 'vivo2', 'syer2', 'sagar5670', 'ooitzepng', 'reishac2', 'atiqahazni', 'kmrabe', 'sylbbb33', 'vikrant23', 'csnaim75', 'luca.riccies', 'ajfrank3', 'c1274995299', 'gitanshu_805702222', 'felicia', 'gacruz007', 'umar19200', 'arcmalrz', 'cathou09', 'asadullah2393', 'roclammergeier', 'ftnndh13', 'mjee3', None, 'rutbeer.991', 'rucha_30', 'zohair2', 'jlee742', 'nkrshnn2', 'wtso2', 'omarsm14', 'juanloisfuentes', 'alexmetreveli', 'ved.pragyan', 'pu3_888', 'dylanb2', 'hariz_muz', 'keven.voyer.1', 'd.ramos.santesmases', 'jrgusta2', 'crunk1005', 'zhenting98', 'eugenep2', 'perrochibo', 'rfbruck2', 'gacou54', 'zlevell2', 'ioncy1998', 'mipoire', 'setan', 'treppa2', 'ychen388', 'dave.76', 'paqito9999', 'zayedh001', 'weeei0514', 'donghu', 'saipranith257', 'emwisni2', 'bpbaile2', 'naveensundar', 'alra', 'mrkedekut', 'fbw27', 'cisrael2', 'kushaljain', 'arifikmal29031997', 'nurfthah', 'luisyugen', 'hilmy114', 'jsharma3', 'haziqhelmy3', 'kkkoo115', 'jablowi2', 'edduc4', 'kaihsinwen', 'kperozek2', 'dreew.yang', 'cplant2', '893580746sumana', 'poggi', 'mguagli2', 'xzhng125', 'qistinaa48', 'sang5', 'larose.alex', 'gninacuri', 'niharika12', 'xxia10', 'mique12', 'seminara.sergio7', 'auni0702', 'cbott2', 'mevtimo2', 'thyagugowdaa', 'adonofr2', 'jhpham2', 'enjucho2', 'chfor216', 'dulguun', 'ekisly2', 'neves2', 'sophiagschwalbe', 'sdnayak94', 'chinaharveyum', 'aneeshj2', 'zhehan666', 'zayan1998', 'jasonloo97', 'zy83619', 'zayedh', 'allenxg2', 'jgallen3', 'naziranat', 'gboudreau03', 'xchartrand', 'zzhan151', 'sweet.robotbd', 'tangjiemu', 'tylerjj2', 'sandy39', 'fredgauv', 'choongshengliang1997', 'skomar4', 'ashishgajalkar', 'musyafa', 'zchen208', 'nycbside95', 'harryf2', 'kaiyuan', 'alex.tplante', 'rwlandi2', 'athirahz', 'amirulasyhraffazmi98', 'aakanksha17', 'arexya', 'atan14', 'kenny457802550', 'ooi_benjamin', 'thierrylapointeleclerc2', 'omnia128', 'pizyo2011', 'karwaikhit1997', 'pbehera2', 'ahrtmnn2', 'dabotop2', 'mohammed_naveed', 'pym', 'chraps', 'jmdimnd2', 'marcelskra', 'shahidah722', 'dannrez', 'xshan6', 'kaijun6541', 'masiewi2', 'syahidahnasir', 'willwheelera', 'kelvinchanwh99', 'titanking231', 'durgasundaram', 'taimoor5012', 'wendidc2', 'akmalkamaruzzaman', 'khaier', 'fadhilhaziq', 'chuhang.jin', 'riduwan', 'khohck97', 'arifikmal97']"
1,15,241,8,7,"['rolesen', 'rtorzilli', 'bve5056', 'joelgearhart', 'sophiagschwalbe', 'crunk1005', 'dabotop2']",234,"['tson3', 'mepaul2', 'keerthih22', 'asyrafwalkman', 'liam.kenny96', 'karldavid', 'lukmanafif36', 'amprath2', 'ionsko', 'mohamadzulfikar88', 'talee3', 'syahidaam', 'thaqifharith22', 'haziqhelmy98', 'bdguo2', 'shiwangi.p', 'khuang47', 'mehtavarshil', 'rohitlad93', 'marcanco', 'iwana20', 'ppawar', 'clin101', 'mahitha', 'hazemzainal7', 'surendhar', 'kkim142', 'saphknight', 'yubai', 'ab20', 'mtschro3', 'mckillo2', 'abubakarmughal92', 'dszhu2', 'vikram0420', 'asyrafjr', 'mihrjeev', 'luv8patel', 'tommy.boilard', 'janavic2', 'kaisin_lee', 'rajauwais98', 'yingjunl', 'nishad1994', 'snsayed06', 'philou231', 'yjeong12', 'elho2', 'sharpee2', 'hereisericlai', 'jiahui0323', 'conanlh2', 'ammarhilmi9815', 'baharoner90', 'bellmanz', 'eehoneg2', 'ixam25', 'danialasyrafrahman', 'andy23', 'julianaredzuan02', 'hbh841995', 'dr.karthik2016', 'shim35', 'louis.balsan.1', 'tokchinkuan', 'bstewie', 'wilsonl98', 'vangurjeet', 'tidate2', 'frbourassa', 'taiki', 'vivo2', 'syer2', 'sagar5670', 'ooitzepng', 'reishac2', 'atiqahazni', 'kmrabe', 'sylbbb33', 'vikrant23', 'csnaim75', 'luca.riccies', 'ajfrank3', 'c1274995299', 'gitanshu_805702222', 'felicia', 'gacruz007', 'umar19200', 'arcmalrz', 'cathou09', 'asadullah2393', 'roclammergeier', 'ftnndh13', 'mjee3', 'rutbeer.991', 'rucha_30', 'zohair2', 'jlee742', 'nkrshnn2', 'wtso2', 'omarsm14', 'juanloisfuentes', 'alexmetreveli', 'ved.pragyan', 'pu3_888', 'dylanb2', 'hariz_muz', 'keven.voyer.1', 'd.ramos.santesmases', 'jrgusta2', 'zhenting98', 'eugenep2', 'perrochibo', 'rfbruck2', 'gacou54', 'zlevell2', 'ioncy1998', 'mipoire', 'setan', 'treppa2', 'ychen388', 'dave.76', 'paqito9999', 'zayedh001', 'weeei0514', 'donghu', 'saipranith257', 'emwisni2', 'bpbaile2', 'naveensundar', 'alra', 'mrkedekut', 'fbw27', 'cisrael2', 'kushaljain', 'arifikmal29031997', 'nurfthah', 'luisyugen', 'hilmy114', 'jsharma3', 'haziqhelmy3', 'kkkoo115', 'jablowi2', 'edduc4', 'kaihsinwen', 'kperozek2', 'dreew.yang', 'cplant2', '893580746sumana', 'poggi', 'mguagli2', 'xzhng125', 'qistinaa48', 'sang5', 'larose.alex', 'gninacuri', 'niharika12', 'xxia10', 'mique12', 'seminara.sergio7', 'auni0702', 'cbott2', 'mevtimo2', 'thyagugowdaa', 'adonofr2', 'jhpham2', 'enjucho2', 'chfor216', 'dulguun', 'ekisly2', 'neves2', 'sdnayak94', 'chinaharveyum', 'aneeshj2', 'zhehan666', 'zy83619', 'allenxg2', 'jgallen3', 'naziranat', 'gboudreau03', 'xchartrand', 'zzhan151', 'sweet.robotbd', 'tangjiemu', 'tylerjj2', 'sandy39', 'fredgauv', 'choongshengliang1997', 'skomar4', 'ashishgajalkar', 'musyafa', 'zchen208', 'nycbside95', 'harryf2', 'kaiyuan', 'alex.tplante', 'rwlandi2', 'athirahz', 'amirulasyhraffazmi98', 'aakanksha17', 'arexya', 'atan14', 'kenny457802550', 'ooi_benjamin', 'thierrylapointeleclerc2', 'omnia128', 'pizyo2011', 'karwaikhit1997', 'pbehera2', 'ahrtmnn2', 'mohammed_naveed', 'pym', 'chraps', 'jmdimnd2', 'marcelskra', 'shahidah722', 'dannrez', 'xshan6', 'kaijun6541', 'masiewi2', 'syahidahnasir', 'willwheelera', 'kelvinchanwh99', 'titanking231', 'durgasundaram', 'taimoor5012', 'wendidc2', 'akmalkamaruzzaman', 'khaier', 'fadhilhaziq', 'chuhang.jin', 'riduwan', 'khohck97', 'arifikmal97']",1,[None],242,"['tson3', 'mepaul2', 'keerthih22', 'asyrafwalkman', 'joelgearhart', 'liam.kenny96', 'karldavid', 'lukmanafif36', 'amprath2', 'ionsko', 'mohamadzulfikar88', 'talee3', 'syahidaam', 'thaqifharith22', 'haziqhelmy98', 'bdguo2', 'shiwangi.p', 'khuang47', 'mehtavarshil', 'rohitlad93', 'marcanco', 'iwana20', 'ppawar', 'clin101', 'mahitha', 'hazemzainal7', 'surendhar', 'kkim142', 'saphknight', 'yubai', 'ab20', 'mtschro3', 'mckillo2', 'abubakarmughal92', 'dszhu2', 'vikram0420', 'asyrafjr', 'mihrjeev', 'luv8patel', 'tommy.boilard', 'janavic2', 'kaisin_lee', 'rajauwais98', 'yingjunl', 'nishad1994', 'snsayed06', 'philou231', 'yjeong12', 'elho2', 'sharpee2', 'hereisericlai', 'jiahui0323', 'conanlh2', 'ammarhilmi9815', 'rolesen', 'baharoner90', 'rtorzilli', 'bellmanz', 'eehoneg2', 'ixam25', 'danialasyrafrahman', 'andy23', 'julianaredzuan02', 'hbh841995', 'dr.karthik2016', 'shim35', 'louis.balsan.1', 'tokchinkuan', 'bstewie', 'bve5056', 'wilsonl98', 'vangurjeet', 'tidate2', 'frbourassa', 'taiki', 'vivo2', 'syer2', 'sagar5670', 'ooitzepng', 'reishac2', 'atiqahazni', 'kmrabe', 'sylbbb33', 'vikrant23', 'csnaim75', 'luca.riccies', 'ajfrank3', 'c1274995299', 'gitanshu_805702222', 'felicia', 'gacruz007', 'umar19200', 'arcmalrz', 'cathou09', 'asadullah2393', 'roclammergeier', 'ftnndh13', 'mjee3', None, 'rutbeer.991', 'rucha_30', 'zohair2', 'jlee742', 'nkrshnn2', 'wtso2', 'omarsm14', 'juanloisfuentes', 'alexmetreveli', 'ved.pragyan', 'pu3_888', 'dylanb2', 'hariz_muz', 'keven.voyer.1', 'd.ramos.santesmases', 'jrgusta2', 'crunk1005', 'zhenting98', 'eugenep2', 'perrochibo', 'rfbruck2', 'gacou54', 'zlevell2', 'ioncy1998', 'mipoire', 'setan', 'treppa2', 'ychen388', 'dave.76', 'paqito9999', 'zayedh001', 'weeei0514', 'donghu', 'saipranith257', 'emwisni2', 'bpbaile2', 'naveensundar', 'alra', 'mrkedekut', 'fbw27', 'cisrael2', 'kushaljain', 'arifikmal29031997', 'nurfthah', 'luisyugen', 'hilmy114', 'jsharma3', 'haziqhelmy3', 'kkkoo115', 'jablowi2', 'edduc4', 'kaihsinwen', 'kperozek2', 'dreew.yang', 'cplant2', '893580746sumana', 'poggi', 'mguagli2', 'xzhng125', 'qistinaa48', 'sang5', 'larose.alex', 'gninacuri', 'niharika12', 'xxia10', 'mique12', 'seminara.sergio7', 'auni0702', 'cbott2', 'mevtimo2', 'thyagugowdaa', 'adonofr2', 'jhpham2', 'enjucho2', 'chfor216', 'dulguun', 'ekisly2', 'neves2', 'sophiagschwalbe', 'sdnayak94', 'chinaharveyum', 'aneeshj2', 'zhehan666', 'zy83619', 'allenxg2', 'jgallen3', 'naziranat', 'gboudreau03', 'xchartrand', 'zzhan151', 'sweet.robotbd', 'tangjiemu', 'tylerjj2', 'sandy39', 'fredgauv', 'choongshengliang1997', 'skomar4', 'ashishgajalkar', 'musyafa', 'zchen208', 'nycbside95', 'harryf2', 'kaiyuan', 'alex.tplante', 'rwlandi2', 'athirahz', 'amirulasyhraffazmi98', 'aakanksha17', 'arexya', 'atan14', 'kenny457802550', 'ooi_benjamin', 'thierrylapointeleclerc2', 'omnia128', 'pizyo2011', 'karwaikhit1997', 'pbehera2', 'ahrtmnn2', 'dabotop2', 'mohammed_naveed', 'pym', 'chraps', 'jmdimnd2', 'marcelskra', 'shahidah722', 'dannrez', 'xshan6', 'kaijun6541', 'masiewi2', 'syahidahnasir', 'willwheelera', 'kelvinchanwh99', 'titanking231', 'durgasundaram', 'taimoor5012', 'wendidc2', 'akmalkamaruzzaman', 'khaier', 'fadhilhaziq', 'chuhang.jin', 'riduwan', 'khohck97', 'arifikmal97']"
1,12,241,7,6,"['chfor216', 'alex.tplante', 'karldavid', 'keven.voyer.1', 'cathou09', 'tommy.boilard']",235,"['tson3', 'mepaul2', 'keerthih22', 'asyrafwalkman', 'joelgearhart', 'liam.kenny96', 'lukmanafif36', 'amprath2', 'ionsko', 'mohamadzulfikar88', 'talee3', 'syahidaam', 'thaqifharith22', 'haziqhelmy98', 'bdguo2', 'shiwangi.p', 'khuang47', 'mehtavarshil', 'rohitlad93', 'marcanco', 'iwana20', 'ppawar', 'clin101', 'mahitha', 'hazemzainal7', 'surendhar', 'kkim142', 'saphknight', 'yubai', 'ab20', 'mtschro3', 'mckillo2', 'abubakarmughal92', 'dszhu2', 'vikram0420', 'asyrafjr', 'mihrjeev', 'luv8patel', 'janavic2', 'kaisin_lee', 'rajauwais98', 'yingjunl', 'nishad1994', 'snsayed06', 'philou231', 'yjeong12', 'elho2', 'sharpee2', 'hereisericlai', 'jiahui0323', 'conanlh2', 'ammarhilmi9815', 'rolesen', 'baharoner90', 'rtorzilli', 'bellmanz', 'eehoneg2', 'ixam25', 'danialasyrafrahman', 'andy23', 'julianaredzuan02', 'hbh841995', 'dr.karthik2016', 'shim35', 'louis.balsan.1', 'tokchinkuan', 'bstewie', 'bve5056', 'wilsonl98', 'vangurjeet', 'tidate2', 'frbourassa', 'taiki', 'vivo2', 'syer2', 'sagar5670', 'ooitzepng', 'reishac2', 'atiqahazni', 'kmrabe', 'sylbbb33', 'vikrant23', 'csnaim75', 'luca.riccies', 'ajfrank3', 'c1274995299', 'gitanshu_805702222', 'felicia', 'gacruz007', 'umar19200', 'arcmalrz', 'asadullah2393', 'roclammergeier', 'ftnndh13', 'mjee3', 'rutbeer.991', 'rucha_30', 'zohair2', 'jlee742', 'nkrshnn2', 'wtso2', 'omarsm14', 'juanloisfuentes', 'alexmetreveli', 'ved.pragyan', 'pu3_888', 'dylanb2', 'hariz_muz', 'd.ramos.santesmases', 'jrgusta2', 'crunk1005', 'zhenting98', 'eugenep2', 'perrochibo', 'rfbruck2', 'gacou54', 'zlevell2', 'ioncy1998', 'mipoire', 'setan', 'treppa2', 'ychen388', 'dave.76', 'paqito9999', 'zayedh001', 'weeei0514', 'donghu', 'saipranith257', 'emwisni2', 'bpbaile2', 'naveensundar', 'alra', 'mrkedekut', 'fbw27', 'cisrael2', 'kushaljain', 'arifikmal29031997', 'nurfthah', 'luisyugen', 'hilmy114', 'jsharma3', 'haziqhelmy3', 'kkkoo115', 'jablowi2', 'edduc4', 'kaihsinwen', 'kperozek2', 'dreew.yang', 'cplant2', '893580746sumana', 'poggi', 'mguagli2', 'xzhng125', 'qistinaa48', 'sang5', 'larose.alex', 'gninacuri', 'niharika12', 'xxia10', 'mique12', 'seminara.sergio7', 'auni0702', 'cbott2', 'mevtimo2', 'thyagugowdaa', 'adonofr2', 'jhpham2', 'enjucho2', 'dulguun', 'ekisly2', 'neves2', 'sophiagschwalbe', 'sdnayak94', 'chinaharveyum', 'aneeshj2', 'zhehan666', 'zy83619', 'allenxg2', 'jgallen3', 'naziranat', 'gboudreau03', 'xchartrand', 'zzhan151', 'sweet.robotbd', 'tangjiemu', 'tylerjj2', 'sandy39', 'fredgauv', 'choongshengliang1997', 'skomar4', 'ashishgajalkar', 'musyafa', 'zchen208', 'nycbside95', 'harryf2', 'kaiyuan', 'rwlandi2', 'athirahz', 'amirulasyhraffazmi98', 'aakanksha17', 'arexya', 'atan14', 'kenny457802550', 'ooi_benjamin', 'thierrylapointeleclerc2', 'omnia128', 'pizyo2011', 'karwaikhit1997', 'pbehera2', 'ahrtmnn2', 'dabotop2', 'mohammed_naveed', 'pym', 'chraps', 'jmdimnd2', 'marcelskra', 'shahidah722', 'dannrez', 'xshan6', 'kaijun6541', 'masiewi2', 'syahidahnasir', 'willwheelera', 'kelvinchanwh99', 'titanking231', 'durgasundaram', 'taimoor5012', 'wendidc2', 'akmalkamaruzzaman', 'khaier', 'fadhilhaziq', 'chuhang.jin', 'riduwan', 'khohck97', 'arifikmal97']",1,[None],242,"['tson3', 'mepaul2', 'keerthih22', 'asyrafwalkman', 'joelgearhart', 'liam.kenny96', 'karldavid', 'lukmanafif36', 'amprath2', 'ionsko', 'mohamadzulfikar88', 'talee3', 'syahidaam', 'thaqifharith22', 'haziqhelmy98', 'bdguo2', 'shiwangi.p', 'khuang47', 'mehtavarshil', 'rohitlad93', 'marcanco', 'iwana20', 'ppawar', 'clin101', 'mahitha', 'hazemzainal7', 'surendhar', 'kkim142', 'saphknight', 'yubai', 'ab20', 'mtschro3', 'mckillo2', 'abubakarmughal92', 'dszhu2', 'vikram0420', 'asyrafjr', 'mihrjeev', 'luv8patel', 'tommy.boilard', 'janavic2', 'kaisin_lee', 'rajauwais98', 'yingjunl', 'nishad1994', 'snsayed06', 'philou231', 'yjeong12', 'elho2', 'sharpee2', 'hereisericlai', 'jiahui0323', 'conanlh2', 'ammarhilmi9815', 'rolesen', 'baharoner90', 'rtorzilli', 'bellmanz', 'eehoneg2', 'ixam25', 'danialasyrafrahman', 'andy23', 'julianaredzuan02', 'hbh841995', 'dr.karthik2016', 'shim35', 'louis.balsan.1', 'tokchinkuan', 'bstewie', 'bve5056', 'wilsonl98', 'vangurjeet', 'tidate2', 'frbourassa', 'taiki', 'vivo2', 'syer2', 'sagar5670', 'ooitzepng', 'reishac2', 'atiqahazni', 'kmrabe', 'sylbbb33', 'vikrant23', 'csnaim75', 'luca.riccies', 'ajfrank3', 'c1274995299', 'gitanshu_805702222', 'felicia', 'gacruz007', 'umar19200', 'arcmalrz', 'cathou09', 'asadullah2393', 'roclammergeier', 'ftnndh13', 'mjee3', None, 'rutbeer.991', 'rucha_30', 'zohair2', 'jlee742', 'nkrshnn2', 'wtso2', 'omarsm14', 'juanloisfuentes', 'alexmetreveli', 'ved.pragyan', 'pu3_888', 'dylanb2', 'hariz_muz', 'keven.voyer.1', 'd.ramos.santesmases', 'jrgusta2', 'crunk1005', 'zhenting98', 'eugenep2', 'perrochibo', 'rfbruck2', 'gacou54', 'zlevell2', 'ioncy1998', 'mipoire', 'setan', 'treppa2', 'ychen388', 'dave.76', 'paqito9999', 'zayedh001', 'weeei0514', 'donghu', 'saipranith257', 'emwisni2', 'bpbaile2', 'naveensundar', 'alra', 'mrkedekut', 'fbw27', 'cisrael2', 'kushaljain', 'arifikmal29031997', 'nurfthah', 'luisyugen', 'hilmy114', 'jsharma3', 'haziqhelmy3', 'kkkoo115', 'jablowi2', 'edduc4', 'kaihsinwen', 'kperozek2', 'dreew.yang', 'cplant2', '893580746sumana', 'poggi', 'mguagli2', 'xzhng125', 'qistinaa48', 'sang5', 'larose.alex', 'gninacuri', 'niharika12', 'xxia10', 'mique12', 'seminara.sergio7', 'auni0702', 'cbott2', 'mevtimo2', 'thyagugowdaa', 'adonofr2', 'jhpham2', 'enjucho2', 'chfor216', 'dulguun', 'ekisly2', 'neves2', 'sophiagschwalbe', 'sdnayak94', 'chinaharveyum', 'aneeshj2', 'zhehan666', 'zy83619', 'allenxg2', 'jgallen3', 'naziranat', 'gboudreau03', 'xchartrand', 'zzhan151', 'sweet.robotbd', 'tangjiemu', 'tylerjj2', 'sandy39', 'fredgauv', 'choongshengliang1997', 'skomar4', 'ashishgajalkar', 'musyafa', 'zchen208', 'nycbside95', 'harryf2', 'kaiyuan', 'alex.tplante', 'rwlandi2', 'athirahz', 'amirulasyhraffazmi98', 'aakanksha17', 'arexya', 'atan14', 'kenny457802550', 'ooi_benjamin', 'thierrylapointeleclerc2', 'omnia128', 'pizyo2011', 'karwaikhit1997', 'pbehera2', 'ahrtmnn2', 'dabotop2', 'mohammed_naveed', 'pym', 'chraps', 'jmdimnd2', 'marcelskra', 'shahidah722', 'dannrez', 'xshan6', 'kaijun6541', 'masiewi2', 'syahidahnasir', 'willwheelera', 'kelvinchanwh99', 'titanking231', 'durgasundaram', 'taimoor5012', 'wendidc2', 'akmalkamaruzzaman', 'khaier', 'fadhilhaziq', 'chuhang.jin', 'riduwan', 'khohck97', 'arifikmal97']"
1,20,241,7,6,"['rolesen', 'bve5056', 'joelgearhart', 'sophiagschwalbe', 'crunk1005', 'dabotop2']",235,"['tson3', 'mepaul2', 'keerthih22', 'asyrafwalkman', 'liam.kenny96', 'karldavid', 'lukmanafif36', 'amprath2', 'ionsko', 'mohamadzulfikar88', 'talee3', 'syahidaam', 'thaqifharith22', 'haziqhelmy98', 'bdguo2', 'shiwangi.p', 'khuang47', 'mehtavarshil', 'rohitlad93', 'marcanco', 'iwana20', 'ppawar', 'clin101', 'mahitha', 'hazemzainal7', 'surendhar', 'kkim142', 'saphknight', 'yubai', 'ab20', 'mtschro3', 'mckillo2', 'abubakarmughal92', 'dszhu2', 'vikram0420', 'asyrafjr', 'mihrjeev', 'luv8patel', 'tommy.boilard', 'janavic2', 'kaisin_lee', 'rajauwais98', 'yingjunl', 'nishad1994', 'snsayed06', 'philou231', 'yjeong12', 'elho2', 'sharpee2', 'hereisericlai', 'jiahui0323', 'conanlh2', 'ammarhilmi9815', 'baharoner90', 'rtorzilli', 'bellmanz', 'eehoneg2', 'ixam25', 'danialasyrafrahman', 'andy23', 'julianaredzuan02', 'hbh841995', 'dr.karthik2016', 'shim35', 'louis.balsan.1', 'tokchinkuan', 'bstewie', 'wilsonl98', 'vangurjeet', 'tidate2', 'frbourassa', 'taiki', 'vivo2', 'syer2', 'sagar5670', 'ooitzepng', 'reishac2', 'atiqahazni', 'kmrabe', 'sylbbb33', 'vikrant23', 'csnaim75', 'luca.riccies', 'ajfrank3', 'c1274995299', 'gitanshu_805702222', 'felicia', 'gacruz007', 'umar19200', 'arcmalrz', 'cathou09', 'asadullah2393', 'roclammergeier', 'ftnndh13', 'mjee3', 'rutbeer.991', 'rucha_30', 'zohair2', 'jlee742', 'nkrshnn2', 'wtso2', 'omarsm14', 'juanloisfuentes', 'alexmetreveli', 'ved.pragyan', 'pu3_888', 'dylanb2', 'hariz_muz', 'keven.voyer.1', 'd.ramos.santesmases', 'jrgusta2', 'zhenting98', 'eugenep2', 'perrochibo', 'rfbruck2', 'gacou54', 'zlevell2', 'ioncy1998', 'mipoire', 'setan', 'treppa2', 'ychen388', 'dave.76', 'paqito9999', 'zayedh001', 'weeei0514', 'donghu', 'saipranith257', 'emwisni2', 'bpbaile2', 'naveensundar', 'alra', 'mrkedekut', 'fbw27', 'cisrael2', 'kushaljain', 'arifikmal29031997', 'nurfthah', 'luisyugen', 'hilmy114', 'jsharma3', 'haziqhelmy3', 'kkkoo115', 'jablowi2', 'edduc4', 'kaihsinwen', 'kperozek2', 'dreew.yang', 'cplant2', '893580746sumana', 'poggi', 'mguagli2', 'xzhng125', 'qistinaa48', 'sang5', 'larose.alex', 'gninacuri', 'niharika12', 'xxia10', 'mique12', 'seminara.sergio7', 'auni0702', 'cbott2', 'mevtimo2', 'thyagugowdaa', 'adonofr2', 'jhpham2', 'enjucho2', 'chfor216', 'dulguun', 'ekisly2', 'neves2', 'sdnayak94', 'chinaharveyum', 'aneeshj2', 'zhehan666', 'zy83619', 'allenxg2', 'jgallen3', 'naziranat', 'gboudreau03', 'xchartrand', 'zzhan151', 'sweet.robotbd', 'tangjiemu', 'tylerjj2', 'sandy39', 'fredgauv', 'choongshengliang1997', 'skomar4', 'ashishgajalkar', 'musyafa', 'zchen208', 'nycbside95', 'harryf2', 'kaiyuan', 'alex.tplante', 'rwlandi2', 'athirahz', 'amirulasyhraffazmi98', 'aakanksha17', 'arexya', 'atan14', 'kenny457802550', 'ooi_benjamin', 'thierrylapointeleclerc2', 'omnia128', 'pizyo2011', 'karwaikhit1997', 'pbehera2', 'ahrtmnn2', 'mohammed_naveed', 'pym', 'chraps', 'jmdimnd2', 'marcelskra', 'shahidah722', 'dannrez', 'xshan6', 'kaijun6541', 'masiewi2', 'syahidahnasir', 'willwheelera', 'kelvinchanwh99', 'titanking231', 'durgasundaram', 'taimoor5012', 'wendidc2', 'akmalkamaruzzaman', 'khaier', 'fadhilhaziq', 'chuhang.jin', 'riduwan', 'khohck97', 'arifikmal97']",1,[None],242,"['tson3', 'mepaul2', 'keerthih22', 'asyrafwalkman', 'joelgearhart', 'liam.kenny96', 'karldavid', 'lukmanafif36', 'amprath2', 'ionsko', 'mohamadzulfikar88', 'talee3', 'syahidaam', 'thaqifharith22', 'haziqhelmy98', 'bdguo2', 'shiwangi.p', 'khuang47', 'mehtavarshil', 'rohitlad93', 'marcanco', 'iwana20', 'ppawar', 'clin101', 'mahitha', 'hazemzainal7', 'surendhar', 'kkim142', 'saphknight', 'yubai', 'ab20', 'mtschro3', 'mckillo2', 'abubakarmughal92', 'dszhu2', 'vikram0420', 'asyrafjr', 'mihrjeev', 'luv8patel', 'tommy.boilard', 'janavic2', 'kaisin_lee', 'rajauwais98', 'yingjunl', 'nishad1994', 'snsayed06', 'philou231', 'yjeong12', 'elho2', 'sharpee2', 'hereisericlai', 'jiahui0323', 'conanlh2', 'ammarhilmi9815', 'rolesen', 'baharoner90', 'rtorzilli', 'bellmanz', 'eehoneg2', 'ixam25', 'danialasyrafrahman', 'andy23', 'julianaredzuan02', 'hbh841995', 'dr.karthik2016', 'shim35', 'louis.balsan.1', 'tokchinkuan', 'bstewie', 'bve5056', 'wilsonl98', 'vangurjeet', 'tidate2', 'frbourassa', 'taiki', 'vivo2', 'syer2', 'sagar5670', 'ooitzepng', 'reishac2', 'atiqahazni', 'kmrabe', 'sylbbb33', 'vikrant23', 'csnaim75', 'luca.riccies', 'ajfrank3', 'c1274995299', 'gitanshu_805702222', 'felicia', 'gacruz007', 'umar19200', 'arcmalrz', 'cathou09', 'asadullah2393', 'roclammergeier', 'ftnndh13', 'mjee3', None, 'rutbeer.991', 'rucha_30', 'zohair2', 'jlee742', 'nkrshnn2', 'wtso2', 'omarsm14', 'juanloisfuentes', 'alexmetreveli', 'ved.pragyan', 'pu3_888', 'dylanb2', 'hariz_muz', 'keven.voyer.1', 'd.ramos.santesmases', 'jrgusta2', 'crunk1005', 'zhenting98', 'eugenep2', 'perrochibo', 'rfbruck2', 'gacou54', 'zlevell2', 'ioncy1998', 'mipoire', 'setan', 'treppa2', 'ychen388', 'dave.76', 'paqito9999', 'zayedh001', 'weeei0514', 'donghu', 'saipranith257', 'emwisni2', 'bpbaile2', 'naveensundar', 'alra', 'mrkedekut', 'fbw27', 'cisrael2', 'kushaljain', 'arifikmal29031997', 'nurfthah', 'luisyugen', 'hilmy114', 'jsharma3', 'haziqhelmy3', 'kkkoo115', 'jablowi2', 'edduc4', 'kaihsinwen', 'kperozek2', 'dreew.yang', 'cplant2', '893580746sumana', 'poggi', 'mguagli2', 'xzhng125', 'qistinaa48', 'sang5', 'larose.alex', 'gninacuri', 'niharika12', 'xxia10', 'mique12', 'seminara.sergio7', 'auni0702', 'cbott2', 'mevtimo2', 'thyagugowdaa', 'adonofr2', 'jhpham2', 'enjucho2', 'chfor216', 'dulguun', 'ekisly2', 'neves2', 'sophiagschwalbe', 'sdnayak94', 'chinaharveyum', 'aneeshj2', 'zhehan666', 'zy83619', 'allenxg2', 'jgallen3', 'naziranat', 'gboudreau03', 'xchartrand', 'zzhan151', 'sweet.robotbd', 'tangjiemu', 'tylerjj2', 'sandy39', 'fredgauv', 'choongshengliang1997', 'skomar4', 'ashishgajalkar', 'musyafa', 'zchen208', 'nycbside95', 'harryf2', 'kaiyuan', 'alex.tplante', 'rwlandi2', 'athirahz', 'amirulasyhraffazmi98', 'aakanksha17', 'arexya', 'atan14', 'kenny457802550', 'ooi_benjamin', 'thierrylapointeleclerc2', 'omnia128', 'pizyo2011', 'karwaikhit1997', 'pbehera2', 'ahrtmnn2', 'dabotop2', 'mohammed_naveed', 'pym', 'chraps', 'jmdimnd2', 'marcelskra', 'shahidah722', 'dannrez', 'xshan6', 'kaijun6541', 'masiewi2', 'syahidahnasir', 'willwheelera', 'kelvinchanwh99', 'titanking231', 'durgasundaram', 'taimoor5012', 'wendidc2', 'akmalkamaruzzaman', 'khaier', 'fadhilhaziq', 'chuhang.jin', 'riduwan', 'khohck97', 'arifikmal97']"
1,21,241,6,5,"['rolesen', 'joelgearhart', 'crunk1005', 'roclammergeier', 'dabotop2']",236,"['tson3', 'mepaul2', 'keerthih22', 'asyrafwalkman', 'liam.kenny96', 'karldavid', 'lukmanafif36', 'amprath2', 'ionsko', 'mohamadzulfikar88', 'talee3', 'syahidaam', 'thaqifharith22', 'haziqhelmy98', 'bdguo2', 'shiwangi.p', 'khuang47', 'mehtavarshil', 'rohitlad93', 'marcanco', 'iwana20', 'ppawar', 'clin101', 'mahitha', 'hazemzainal7', 'surendhar', 'kkim142', 'saphknight', 'yubai', 'ab20', 'mtschro3', 'mckillo2', 'abubakarmughal92', 'dszhu2', 'vikram0420', 'asyrafjr', 'mihrjeev', 'luv8patel', 'tommy.boilard', 'janavic2', 'kaisin_lee', 'rajauwais98', 'yingjunl', 'nishad1994', 'snsayed06', 'philou231', 'yjeong12', 'elho2', 'sharpee2', 'hereisericlai', 'jiahui0323', 'conanlh2', 'ammarhilmi9815', 'baharoner90', 'rtorzilli', 'bellmanz', 'eehoneg2', 'ixam25', 'danialasyrafrahman', 'andy23', 'julianaredzuan02', 'hbh841995', 'dr.karthik2016', 'shim35', 'louis.balsan.1', 'tokchinkuan', 'bstewie', 'bve5056', 'wilsonl98', 'vangurjeet', 'tidate2', 'frbourassa', 'taiki', 'vivo2', 'syer2', 'sagar5670', 'ooitzepng', 'reishac2', 'atiqahazni', 'kmrabe', 'sylbbb33', 'vikrant23', 'csnaim75', 'luca.riccies', 'ajfrank3', 'c1274995299', 'gitanshu_805702222', 'felicia', 'gacruz007', 'umar19200', 'arcmalrz', 'cathou09', 'asadullah2393', 'ftnndh13', 'mjee3', 'rutbeer.991', 'rucha_30', 'zohair2', 'jlee742', 'nkrshnn2', 'wtso2', 'omarsm14', 'juanloisfuentes', 'alexmetreveli', 'ved.pragyan', 'pu3_888', 'dylanb2', 'hariz_muz', 'keven.voyer.1', 'd.ramos.santesmases', 'jrgusta2', 'zhenting98', 'eugenep2', 'perrochibo', 'rfbruck2', 'gacou54', 'zlevell2', 'ioncy1998', 'mipoire', 'setan', 'treppa2', 'ychen388', 'dave.76', 'paqito9999', 'zayedh001', 'weeei0514', 'donghu', 'saipranith257', 'emwisni2', 'bpbaile2', 'naveensundar', 'alra', 'mrkedekut', 'fbw27', 'cisrael2', 'kushaljain', 'arifikmal29031997', 'nurfthah', 'luisyugen', 'hilmy114', 'jsharma3', 'haziqhelmy3', 'kkkoo115', 'jablowi2', 'edduc4', 'kaihsinwen', 'kperozek2', 'dreew.yang', 'cplant2', '893580746sumana', 'poggi', 'mguagli2', 'xzhng125', 'qistinaa48', 'sang5', 'larose.alex', 'gninacuri', 'niharika12', 'xxia10', 'mique12', 'seminara.sergio7', 'auni0702', 'cbott2', 'mevtimo2', 'thyagugowdaa', 'adonofr2', 'jhpham2', 'enjucho2', 'chfor216', 'dulguun', 'ekisly2', 'neves2', 'sophiagschwalbe', 'sdnayak94', 'chinaharveyum', 'aneeshj2', 'zhehan666', 'zy83619', 'allenxg2', 'jgallen3', 'naziranat', 'gboudreau03', 'xchartrand', 'zzhan151', 'sweet.robotbd', 'tangjiemu', 'tylerjj2', 'sandy39', 'fredgauv', 'choongshengliang1997', 'skomar4', 'ashishgajalkar', 'musyafa', 'zchen208', 'nycbside95', 'harryf2', 'kaiyuan', 'alex.tplante', 'rwlandi2', 'athirahz', 'amirulasyhraffazmi98', 'aakanksha17', 'arexya', 'atan14', 'kenny457802550', 'ooi_benjamin', 'thierrylapointeleclerc2', 'omnia128', 'pizyo2011', 'karwaikhit1997', 'pbehera2', 'ahrtmnn2', 'mohammed_naveed', 'pym', 'chraps', 'jmdimnd2', 'marcelskra', 'shahidah722', 'dannrez', 'xshan6', 'kaijun6541', 'masiewi2', 'syahidahnasir', 'willwheelera', 'kelvinchanwh99', 'titanking231', 'durgasundaram', 'taimoor5012', 'wendidc2', 'akmalkamaruzzaman', 'khaier', 'fadhilhaziq', 'chuhang.jin', 'riduwan', 'khohck97', 'arifikmal97']",1,[None],242,"['tson3', 'mepaul2', 'keerthih22', 'asyrafwalkman', 'joelgearhart', 'liam.kenny96', 'karldavid', 'lukmanafif36', 'amprath2', 'ionsko', 'mohamadzulfikar88', 'talee3', 'syahidaam', 'thaqifharith22', 'haziqhelmy98', 'bdguo2', 'shiwangi.p', 'khuang47', 'mehtavarshil', 'rohitlad93', 'marcanco', 'iwana20', 'ppawar', 'clin101', 'mahitha', 'hazemzainal7', 'surendhar', 'kkim142', 'saphknight', 'yubai', 'ab20', 'mtschro3', 'mckillo2', 'abubakarmughal92', 'dszhu2', 'vikram0420', 'asyrafjr', 'mihrjeev', 'luv8patel', 'tommy.boilard', 'janavic2', 'kaisin_lee', 'rajauwais98', 'yingjunl', 'nishad1994', 'snsayed06', 'philou231', 'yjeong12', 'elho2', 'sharpee2', 'hereisericlai', 'jiahui0323', 'conanlh2', 'ammarhilmi9815', 'rolesen', 'baharoner90', 'rtorzilli', 'bellmanz', 'eehoneg2', 'ixam25', 'danialasyrafrahman', 'andy23', 'julianaredzuan02', 'hbh841995', 'dr.karthik2016', 'shim35', 'louis.balsan.1', 'tokchinkuan', 'bstewie', 'bve5056', 'wilsonl98', 'vangurjeet', 'tidate2', 'frbourassa', 'taiki', 'vivo2', 'syer2', 'sagar5670', 'ooitzepng', 'reishac2', 'atiqahazni', 'kmrabe', 'sylbbb33', 'vikrant23', 'csnaim75', 'luca.riccies', 'ajfrank3', 'c1274995299', 'gitanshu_805702222', 'felicia', 'gacruz007', 'umar19200', 'arcmalrz', 'cathou09', 'asadullah2393', 'roclammergeier', 'ftnndh13', 'mjee3', None, 'rutbeer.991', 'rucha_30', 'zohair2', 'jlee742', 'nkrshnn2', 'wtso2', 'omarsm14', 'juanloisfuentes', 'alexmetreveli', 'ved.pragyan', 'pu3_888', 'dylanb2', 'hariz_muz', 'keven.voyer.1', 'd.ramos.santesmases', 'jrgusta2', 'crunk1005', 'zhenting98', 'eugenep2', 'perrochibo', 'rfbruck2', 'gacou54', 'zlevell2', 'ioncy1998', 'mipoire', 'setan', 'treppa2', 'ychen388', 'dave.76', 'paqito9999', 'zayedh001', 'weeei0514', 'donghu', 'saipranith257', 'emwisni2', 'bpbaile2', 'naveensundar', 'alra', 'mrkedekut', 'fbw27', 'cisrael2', 'kushaljain', 'arifikmal29031997', 'nurfthah', 'luisyugen', 'hilmy114', 'jsharma3', 'haziqhelmy3', 'kkkoo115', 'jablowi2', 'edduc4', 'kaihsinwen', 'kperozek2', 'dreew.yang', 'cplant2', '893580746sumana', 'poggi', 'mguagli2', 'xzhng125', 'qistinaa48', 'sang5', 'larose.alex', 'gninacuri', 'niharika12', 'xxia10', 'mique12', 'seminara.sergio7', 'auni0702', 'cbott2', 'mevtimo2', 'thyagugowdaa', 'adonofr2', 'jhpham2', 'enjucho2', 'chfor216', 'dulguun', 'ekisly2', 'neves2', 'sophiagschwalbe', 'sdnayak94', 'chinaharveyum', 'aneeshj2', 'zhehan666', 'zy83619', 'allenxg2', 'jgallen3', 'naziranat', 'gboudreau03', 'xchartrand', 'zzhan151', 'sweet.robotbd', 'tangjiemu', 'tylerjj2', 'sandy39', 'fredgauv', 'choongshengliang1997', 'skomar4', 'ashishgajalkar', 'musyafa', 'zchen208', 'nycbside95', 'harryf2', 'kaiyuan', 'alex.tplante', 'rwlandi2', 'athirahz', 'amirulasyhraffazmi98', 'aakanksha17', 'arexya', 'atan14', 'kenny457802550', 'ooi_benjamin', 'thierrylapointeleclerc2', 'omnia128', 'pizyo2011', 'karwaikhit1997', 'pbehera2', 'ahrtmnn2', 'dabotop2', 'mohammed_naveed', 'pym', 'chraps', 'jmdimnd2', 'marcelskra', 'shahidah722', 'dannrez', 'xshan6', 'kaijun6541', 'masiewi2', 'syahidahnasir', 'willwheelera', 'kelvinchanwh99', 'titanking231', 'durgasundaram', 'taimoor5012', 'wendidc2', 'akmalkamaruzzaman', 'khaier', 'fadhilhaziq', 'chuhang.jin', 'riduwan', 'khohck97', 'arifikmal97']"
2,85,155,85,1,['jsshin3'],153,"['brschick', 'khairel_aqil', 'edgar10', 'aljaodi', 'andreszabalacobo', 'mariocs96az', 'marialo', 'paloma95', 'f42rodim', 'rcl5', 'shuangli', 'eljota96', 'paco9', 'kimx2373', 'antoniojema', 'ivanna', 'nazmi3', 'javierugr', 'imarquez2', 'alvarolb5', 'shouharda12', 'hamizanhamdani5079', 'k.m.zihad888', 'lekez2005', 'juan_flores', 'msmartinez7', 'marcocrio', 'cepebe13', 'katya.mpapadakis', 'ruben.estrada14', 'rubiksmaniac', 'lolocatt', 'javier7', 'zhi', 'jcoronado', 'shahrul1306', 'haqimshahrudin', 'adrianrubio', 'cdarmody', 'leonardo9606', 'isracv19', 'ghanshyamjoshi', 'ivj1997', 'syarafifaz98', 'snajera7', 'lidp', 'yaoch', 'basirznal98', 'jocelynsw46', 'urllopez', 'ftinaut', 'javiervillar96', 'jeffreytebeau', 'anase1994', 'emil96', 'miguel1396', 'subiresad', 'phantom4', 'glaucoepiro', 'beskisehir', 'jajurado3', 'laarvizu', 'lidialacal', 'daniel.yikyang', 'amarincaba', 'atiqahkhaishah', 'isaacspidey', 'teck60', 'damianbro', 'rifqi1398', 'camachacador', 'mohd199912', 'malena23', 'mjmartinez283', 'qatrisyia', 'isacaudy', 'javm6', 'cuadros95', 'josebruq', 'pralcalde', 'chimingzhi', 'hijrahsalleh28', 'luis93', 'derekortiz21', 'chandana.garikipati123', 'mendez.r', 'baloncesto1996', 'fpdn', 'jmfernandez4', 'msridhar961', 'carlos849702', 'jrispardo', 'jgmrfisica', 'levicueto', 'mdisyraf19', 'karlaa2296', 'victorsalas', 'edrusmohamad', 'mbriones25', 'jeal8a', 'teck60osc', 'meftahulturag', 'imsinchee', 'ccramirez3', 'anvilo', 'itzel.hernandez88', 'pabloaguadero', 'zzhiye', 'rulies07', 'gottagoxxx72', 'mariaenders', 'trucosuso', 'syahminaqiuddins', 'kcharlene94', 'arifhallofamer', 'aorea1997', 'jamarquez8', 'durzua07', 'achavez107', 'theinhtike', 'jooe1121', 'juan_flores12', 'brschick1', 'albertortepin', 'hakim_izani', 'amirulal73', 'andrew0605', 'ihsan92', 'amorales546', 'rubiksmaniac98', 'jose_fett', 'lidia', 'doominous1', 'oc', 'djcastillo', 'mariammb', 'achavez17', 'juanenri14', 'avivpaskaro', 'aframirez', 'quinonez.amado15', 'javiarrabal', 'isalopezcasas', 'lauragalindo', 'julioeroma', 'jotaeneeme', 'pachu555', 'clarakaramazov', 'pollosasica', 'jaimemtz21', 'aliff98', 'javierfloresmartin1992', 'jusmar21897']",84,"['wolan2', 'tson3', 'aokisang', 'mepaul2', 'liam.kenny96', 'sarahrp2', 'talee3', 'rhyu2', 'bdguo2', 'khuang47', 'clin101', 'saphknight', 'kkim142', 'ab20', 'mtschro3', 'schoole2', 'mckillo2', 'jboo72390', 'dszhu2', 'yhuan127', 'janavic2', 'yjeong12', 'elho2', 'sharpee2', 'conanlh2', 'eehoneg2', 'rpavone2', 'nim4', 'shim35', 'tidate2', 'hyang89', 'vivo2', 'syer2', 'jzhan142', 'reishac2', 'ajfrank3', 'eratta2', 'michael.p.gambino', 'mjee3', None, 'zohair2', 'nkrshnn2', 'wtso2', 'jlee742', 'dylanb2', 'rfbruck2', 'eugenep2', 'jrgusta2', 'zlevell2', 'ychen388', 'emwisni2', 'bpbaile2', 'cisrael2', 'jsharma3', 'jablowi2', 'kperozek2', 'cplant2', 'mguagli2', 'xzhng125', 'sang5', 'wendi0522', 'xxia10', 'mevtimo2', 'jhpham2', 'enjucho2', 'ekisly2', 'neves2', 'aneeshj2', 'allenxg2', 'jgallen3', 'mgambin2', 'tylerjj2', 'skomar4', 'zchen208', 'nycbside95', 'harryf2', 'rwlandi2', 'clwhite5', 'atan14', 'ahrtmnn2', 'pbehera2', 'masiewi2', 'willwheelera', 'wendidc2']",238,"['wolan2', 'tson3', 'brschick', 'aokisang', 'mepaul2', 'khairel_aqil', 'liam.kenny96', 'edgar10', 'andreszabalacobo', 'aljaodi', 'mariocs96az', 'marialo', 'sarahrp2', 'paloma95', 'f42rodim', 'talee3', 'rcl5', 'shuangli', 'eljota96', 'paco9', 'rhyu2', 'bdguo2', 'kimx2373', 'antoniojema', 'khuang47', 'ivanna', 'nazmi3', 'clin101', 'javierugr', 'imarquez2', 'alvarolb5', 'saphknight', 'kkim142', 'shouharda12', 'ab20', 'mtschro3', 'schoole2', 'mckillo2', 'hamizanhamdani5079', 'jboo72390', 'k.m.zihad888', 'dszhu2', 'lekez2005', 'yhuan127', 'juan_flores', 'msmartinez7', 'marcocrio', 'cepebe13', 'janavic2', 'katya.mpapadakis', 'ruben.estrada14', 'rubiksmaniac', 'lolocatt', 'yjeong12', 'elho2', 'javier7', 'sharpee2', 'zhi', 'jcoronado', 'shahrul1306', 'haqimshahrudin', 'adrianrubio', 'cdarmody', 'leonardo9606', 'conanlh2', 'isracv19', 'ghanshyamjoshi', 'ivj1997', 'eehoneg2', 'syarafifaz98', 'snajera7', 'lidp', 'yaoch', 'rpavone2', 'basirznal98', 'nim4', 'jocelynsw46', 'shim35', 'urllopez', 'ftinaut', 'tidate2', 'javiervillar96', 'hyang89', 'jeffreytebeau', 'vivo2', 'anase1994', 'syer2', 'emil96', 'miguel1396', 'subiresad', 'phantom4', 'jzhan142', 'reishac2', 'glaucoepiro', 'ajfrank3', 'eratta2', 'beskisehir', 'jajurado3', 'michael.p.gambino', 'laarvizu', 'mjee3', None, 'zohair2', 'lidialacal', 'nkrshnn2', 'wtso2', 'daniel.yikyang', 'jlee742', 'amarincaba', 'dylanb2', 'atiqahkhaishah', 'isaacspidey', 'teck60', 'damianbro', 'rfbruck2', 'jrgusta2', 'eugenep2', 'rifqi1398', 'camachacador', 'mohd199912', 'zlevell2', 'malena23', 'mjmartinez283', 'qatrisyia', 'jsshin3', 'ychen388', 'isacaudy', 'javm6', 'cuadros95', 'josebruq', 'emwisni2', 'pralcalde', 'bpbaile2', 'chimingzhi', 'hijrahsalleh28', 'luis93', 'derekortiz21', 'chandana.garikipati123', 'mendez.r', 'baloncesto1996', 'fpdn', 'jmfernandez4', 'cisrael2', 'msridhar961', 'jsharma3', 'jablowi2', 'carlos849702', 'kperozek2', 'cplant2', 'jrispardo', 'jgmrfisica', 'levicueto', 'mdisyraf19', 'karlaa2296', 'mguagli2', 'xzhng125', 'sang5', 'victorsalas', 'wendi0522', 'edrusmohamad', 'mbriones25', 'jeal8a', 'xxia10', 'teck60osc', 'mevtimo2', 'meftahulturag', 'imsinchee', 'ccramirez3', 'jhpham2', 'enjucho2', 'ekisly2', 'anvilo', 'itzel.hernandez88', 'neves2', 'pabloaguadero', 'zzhiye', 'aneeshj2', 'rulies07', 'gottagoxxx72', 'allenxg2', 'mariaenders', 'jgallen3', 'trucosuso', 'syahminaqiuddins', 'kcharlene94', 'arifhallofamer', 'aorea1997', 'jamarquez8', 'durzua07', 'achavez107', 'mgambin2', 'tylerjj2', 'theinhtike', 'jooe1121', 'juan_flores12', 'brschick1', 'albertortepin', 'skomar4', 'hakim_izani', 'amirulal73', 'andrew0605', 'zchen208', 'nycbside95', 'harryf2', 'ihsan92', 'rwlandi2', 'clwhite5', 'atan14', 'amorales546', 'rubiksmaniac98', 'ahrtmnn2', 'jose_fett', 'pbehera2', 'lidia', 'doominous1', 'oc', 'djcastillo', 'mariammb', 'achavez17', 'juanenri14', 'avivpaskaro', 'aframirez', 'masiewi2', 'willwheelera', 'quinonez.amado15', 'javiarrabal', 'isalopezcasas', 'lauragalindo', 'wendidc2', 'julioeroma', 'jotaeneeme', 'pachu555', 'clarakaramazov', 'pollosasica', 'jaimemtz21', 'aliff98', 'javierfloresmartin1992', 'jusmar21897']"
2,17,155,82,1,['hamizanhamdani5079'],153,"['brschick', 'khairel_aqil', 'edgar10', 'aljaodi', 'andreszabalacobo', 'mariocs96az', 'marialo', 'paloma95', 'f42rodim', 'rcl5', 'shuangli', 'eljota96', 'paco9', 'kimx2373', 'antoniojema', 'ivanna', 'nazmi3', 'javierugr', 'imarquez2', 'alvarolb5', 'shouharda12', 'k.m.zihad888', 'lekez2005', 'juan_flores', 'msmartinez7', 'marcocrio', 'cepebe13', 'katya.mpapadakis', 'ruben.estrada14', 'rubiksmaniac', 'lolocatt', 'javier7', 'zhi', 'jcoronado', 'shahrul1306', 'haqimshahrudin', 'adrianrubio', 'cdarmody', 'leonardo9606', 'isracv19', 'ghanshyamjoshi', 'ivj1997', 'syarafifaz98', 'snajera7', 'lidp', 'yaoch', 'basirznal98', 'jocelynsw46', 'urllopez', 'ftinaut', 'javiervillar96', 'jeffreytebeau', 'anase1994', 'emil96', 'miguel1396', 'subiresad', 'phantom4', 'glaucoepiro', 'beskisehir', 'jajurado3', 'laarvizu', 'lidialacal', 'daniel.yikyang', 'amarincaba', 'atiqahkhaishah', 'isaacspidey', 'teck60', 'damianbro', 'rifqi1398', 'camachacador', 'mohd199912', 'malena23', 'mjmartinez283', 'qatrisyia', 'jsshin3', 'isacaudy', 'javm6', 'cuadros95', 'josebruq', 'pralcalde', 'chimingzhi', 'hijrahsalleh28', 'luis93', 'derekortiz21', 'chandana.garikipati123', 'mendez.r', 'baloncesto1996', 'fpdn', 'jmfernandez4', 'msridhar961', 'carlos849702', 'jrispardo', 'jgmrfisica', 'levicueto', 'mdisyraf19', 'karlaa2296', 'victorsalas', 'edrusmohamad', 'mbriones25', 'jeal8a', 'teck60osc', 'meftahulturag', 'imsinchee', 'ccramirez3', 'anvilo', 'itzel.hernandez88', 'pabloaguadero', 'zzhiye', 'rulies07', 'gottagoxxx72', 'mariaenders', 'trucosuso', 'syahminaqiuddins', 'kcharlene94', 'arifhallofamer', 'aorea1997', 'jamarquez8', 'durzua07', 'achavez107', 'theinhtike', 'jooe1121', 'juan_flores12', 'brschick1', 'albertortepin', 'hakim_izani', 'amirulal73', 'andrew0605', 'ihsan92', 'amorales546', 'rubiksmaniac98', 'jose_fett', 'lidia', 'doominous1', 'oc', 'djcastillo', 'mariammb', 'achavez17', 'juanenri14', 'avivpaskaro', 'aframirez', 'quinonez.amado15', 'javiarrabal', 'isalopezcasas', 'lauragalindo', 'julioeroma', 'jotaeneeme', 'pachu555', 'clarakaramazov', 'pollosasica', 'jaimemtz21', 'aliff98', 'javierfloresmartin1992', 'jusmar21897']",81,"['asyrafwalkman', 'lukmanafif36', 'mohamadzulfikar88', 'syahidaam', 'thaqifharith22', 'irdnarush', 'haziqhelmy98', 'iwana20', 'hazemzainal7', 'abubakarmughal92', 'asyrafjr', 'mihrjeev', 'kaisin_lee', 'rajauwais98', 'baldwenraj', 'hereisericlai', 'jiahui0323', 'ammarhilmi9815', 'sharifah_fatmadiana', 'andy23', 'danialasyrafrahman', 'julianaredzuan02', 'zaki.hakimi10', 'tokchinkuan', 'wilsonl98', 'slapass321', 'vangurjeet', 'aaronstonegovin', 'ooitzepng', 'atiqahazni', 'csnaim75', 'c1274995299', 'umar19200', 'arcmalrz', 'ftnndh13', None, 'rutbeer.991', 'pu3_888', 'hariz_muz', 'zhenting98', 'ioncy1998', 'zayedh001', 'mrkedekut', 'fbw27', 'arifikmal29031997', 'haziqhelmy3', 'luisyugen', 'hilmy114', 'nurfthah', 'kkkoo115', 'qistinaa48', 'auni0702', 'chinaharveyum', 'jasonloo97', 'zayan1998', 'zayedh', 'naziranat', 'choongshengliang1997', 'aymahmed13', 'akasyah123456', 'musyafa', 'kaiyuan', 'athirahz', 'amirulasyhraffazmi98', 'arexya', 'wan_ezzat98', 'ooi_benjamin', 'omnia128', 'pizyo2011', 'karwaikhit1997', 'pym', 'shahidah722', 'dannrez', 'syahidahnasir', 'kelvinchanwh99', 'taimoor5012', 'akmalkamaruzzaman', 'khaier', 'riduwan', 'khohck97', 'arifikmal97']",235,"['brschick', 'asyrafwalkman', 'khairel_aqil', 'edgar10', 'andreszabalacobo', 'aljaodi', 'mariocs96az', 'lukmanafif36', 'marialo', 'paloma95', 'f42rodim', 'mohamadzulfikar88', 'syahidaam', 'rcl5', 'shuangli', 'thaqifharith22', 'irdnarush', 'eljota96', 'paco9', 'haziqhelmy98', 'kimx2373', 'antoniojema', 'ivanna', 'nazmi3', 'iwana20', 'javierugr', 'imarquez2', 'alvarolb5', 'hazemzainal7', 'shouharda12', 'hamizanhamdani5079', 'k.m.zihad888', 'abubakarmughal92', 'lekez2005', 'asyrafjr', 'mihrjeev', 'juan_flores', 'msmartinez7', 'marcocrio', 'cepebe13', 'kaisin_lee', 'katya.mpapadakis', 'ruben.estrada14', 'rajauwais98', 'rubiksmaniac', 'lolocatt', 'javier7', 'baldwenraj', 'zhi', 'jcoronado', 'shahrul1306', 'haqimshahrudin', 'adrianrubio', 'cdarmody', 'leonardo9606', 'hereisericlai', 'isracv19', 'jiahui0323', 'ammarhilmi9815', 'ghanshyamjoshi', 'sharifah_fatmadiana', 'ivj1997', 'syarafifaz98', 'snajera7', 'andy23', 'danialasyrafrahman', 'lidp', 'yaoch', 'julianaredzuan02', 'zaki.hakimi10', 'basirznal98', 'jocelynsw46', 'tokchinkuan', 'urllopez', 'wilsonl98', 'slapass321', 'ftinaut', 'vangurjeet', 'javiervillar96', 'jeffreytebeau', 'anase1994', 'aaronstonegovin', 'emil96', 'miguel1396', 'subiresad', 'phantom4', 'ooitzepng', 'atiqahazni', 'glaucoepiro', 'csnaim75', 'c1274995299', 'beskisehir', 'jajurado3', 'umar19200', 'arcmalrz', 'ftnndh13', 'laarvizu', None, 'rutbeer.991', 'lidialacal', 'daniel.yikyang', 'amarincaba', 'atiqahkhaishah', 'pu3_888', 'isaacspidey', 'teck60', 'hariz_muz', 'damianbro', 'zhenting98', 'rifqi1398', 'camachacador', 'mohd199912', 'ioncy1998', 'malena23', 'mjmartinez283', 'qatrisyia', 'jsshin3', 'isacaudy', 'zayedh001', 'javm6', 'cuadros95', 'josebruq', 'pralcalde', 'chimingzhi', 'hijrahsalleh28', 'luis93', 'derekortiz21', 'chandana.garikipati123', 'mendez.r', 'baloncesto1996', 'fpdn', 'jmfernandez4', 'mrkedekut', 'fbw27', 'arifikmal29031997', 'msridhar961', 'haziqhelmy3', 'luisyugen', 'hilmy114', 'nurfthah', 'kkkoo115', 'carlos849702', 'jrispardo', 'jgmrfisica', 'levicueto', 'mdisyraf19', 'karlaa2296', 'qistinaa48', 'victorsalas', 'edrusmohamad', 'mbriones25', 'jeal8a', 'auni0702', 'teck60osc', 'meftahulturag', 'imsinchee', 'ccramirez3', 'anvilo', 'itzel.hernandez88', 'pabloaguadero', 'zzhiye', 'chinaharveyum', 'rulies07', 'jasonloo97', 'zayan1998', 'gottagoxxx72', 'zayedh', 'naziranat', 'mariaenders', 'trucosuso', 'syahminaqiuddins', 'kcharlene94', 'arifhallofamer', 'aorea1997', 'jamarquez8', 'durzua07', 'achavez107', 'theinhtike', 'jooe1121', 'choongshengliang1997', 'juan_flores12', 'aymahmed13', 'brschick1', 'albertortepin', 'akasyah123456', 'hakim_izani', 'amirulal73', 'andrew0605', 'musyafa', 'kaiyuan', 'ihsan92', 'athirahz', 'amirulasyhraffazmi98', 'arexya', 'wan_ezzat98', 'amorales546', 'rubiksmaniac98', 'ooi_benjamin', 'omnia128', 'pizyo2011', 'jose_fett', 'karwaikhit1997', 'lidia', 'pym', 'doominous1', 'oc', 'djcastillo', 'mariammb', 'shahidah722', 'dannrez', 'achavez17', 'juanenri14', 'avivpaskaro', 'aframirez', 'syahidahnasir', 'kelvinchanwh99', 'quinonez.amado15', 'taimoor5012', 'javiarrabal', 'isalopezcasas', 'lauragalindo', 'akmalkamaruzzaman', 'julioeroma', 'jotaeneeme', 'pachu555', 'clarakaramazov', 'pollosasica', 'jaimemtz21', 'khaier', 'riduwan', 'aliff98', 'khohck97', 'javierfloresmartin1992', 'arifikmal97', 'jusmar21897']"
2,217,155,66,58,"['camachacador', 'mariaenders', 'trucosuso', 'lidp', 'andreszabalacobo', 'mariocs96az', 'marialo', 'paloma95', 'javm6', 'f42rodim', 'cuadros95', 'josebruq', 'albertortepin', 'pralcalde', 'rcl5', 'luis93', 'eljota96', 'paco9', 'baloncesto1996', 'andrew0605', 'fpdn', 'ftinaut', 'antoniojema', 'ivanna', 'javiervillar96', 'javierugr', 'alvarolb5', 'anase1994', 'jrispardo', 'jgmrfisica', 'jose_fett', 'emil96', 'miguel1396', 'subiresad', 'lidia', 'victorsalas', 'glaucoepiro', 'oc', 'mariammb', 'cepebe13', 'aframirez', 'lolocatt', 'javiarrabal', 'isalopezcasas', 'amarincaba', 'anvilo', 'lauragalindo', 'julioeroma', 'javier7', 'jotaeneeme', 'pachu555', 'pabloaguadero', 'adrianrubio', 'clarakaramazov', 'isaacspidey', 'pollosasica', 'damianbro', 'javierfloresmartin1992']",96,"['brschick', 'khairel_aqil', 'edgar10', 'aljaodi', 'shuangli', 'kimx2373', 'nazmi3', 'imarquez2', 'shouharda12', 'hamizanhamdani5079', 'k.m.zihad888', 'lekez2005', 'juan_flores', 'marcocrio', 'msmartinez7', 'katya.mpapadakis', 'ruben.estrada14', 'rubiksmaniac', 'zhi', 'jcoronado', 'shahrul1306', 'haqimshahrudin', 'cdarmody', 'leonardo9606', 'isracv19', 'ghanshyamjoshi', 'ivj1997', 'syarafifaz98', 'snajera7', 'yaoch', 'basirznal98', 'jocelynsw46', 'urllopez', 'jeffreytebeau', 'phantom4', 'beskisehir', 'jajurado3', 'laarvizu', 'lidialacal', 'daniel.yikyang', 'atiqahkhaishah', 'teck60', 'rifqi1398', 'mohd199912', 'malena23', 'mjmartinez283', 'qatrisyia', 'jsshin3', 'isacaudy', 'chimingzhi', 'hijrahsalleh28', 'derekortiz21', 'chandana.garikipati123', 'mendez.r', 'jmfernandez4', 'msridhar961', 'carlos849702', 'levicueto', 'mdisyraf19', 'karlaa2296', 'edrusmohamad', 'mbriones25', 'jeal8a', 'teck60osc', 'meftahulturag', 'imsinchee', 'ccramirez3', 'itzel.hernandez88', 'zzhiye', 'rulies07', 'gottagoxxx72', 'syahminaqiuddins', 'kcharlene94', 'arifhallofamer', 'aorea1997', 'jamarquez8', 'durzua07', 'achavez107', 'theinhtike', 'jooe1121', 'juan_flores12', 'brschick1', 'hakim_izani', 'amirulal73', 'ihsan92', 'amorales546', 'rubiksmaniac98', 'doominous1', 'djcastillo', 'achavez17', 'juanenri14', 'avivpaskaro', 'quinonez.amado15', 'jaimemtz21', 'aliff98', 'jusmar21897']",8,"['sofisofi', 'luciag', 'luismarchante', 'pablo_5__', 'fmgomez', 'tatianacc', 'sergioob', None]",162,"['brschick', 'khairel_aqil', 'edgar10', 'andreszabalacobo', 'aljaodi', 'mariocs96az', 'marialo', 'paloma95', 'f42rodim', 'rcl5', 'shuangli', 'sofisofi', 'eljota96', 'paco9', 'kimx2373', 'antoniojema', 'ivanna', 'fmgomez', 'nazmi3', 'javierugr', 'imarquez2', 'alvarolb5', 'shouharda12', 'hamizanhamdani5079', 'k.m.zihad888', 'lekez2005', 'juan_flores', 'msmartinez7', 'marcocrio', 'cepebe13', 'katya.mpapadakis', 'ruben.estrada14', 'rubiksmaniac', 'lolocatt', 'javier7', 'zhi', 'jcoronado', 'shahrul1306', 'haqimshahrudin', 'adrianrubio', 'cdarmody', 'leonardo9606', 'isracv19', 'ghanshyamjoshi', 'ivj1997', 'syarafifaz98', 'snajera7', 'lidp', 'yaoch', 'basirznal98', 'jocelynsw46', 'urllopez', 'ftinaut', 'javiervillar96', 'jeffreytebeau', 'anase1994', 'tatianacc', 'emil96', 'miguel1396', 'subiresad', 'phantom4', 'luismarchante', 'glaucoepiro', 'beskisehir', 'jajurado3', 'laarvizu', None, 'lidialacal', 'daniel.yikyang', 'amarincaba', 'atiqahkhaishah', 'isaacspidey', 'teck60', 'damianbro', 'rifqi1398', 'camachacador', 'luciag', 'mohd199912', 'malena23', 'mjmartinez283', 'qatrisyia', 'jsshin3', 'isacaudy', 'javm6', 'cuadros95', 'josebruq', 'pralcalde', 'chimingzhi', 'hijrahsalleh28', 'luis93', 'derekortiz21', 'chandana.garikipati123', 'mendez.r', 'baloncesto1996', 'fpdn', 'jmfernandez4', 'msridhar961', 'carlos849702', 'jrispardo', 'jgmrfisica', 'levicueto', 'mdisyraf19', 'karlaa2296', 'victorsalas', 'edrusmohamad', 'mbriones25', 'jeal8a', 'teck60osc', 'meftahulturag', 'imsinchee', 'ccramirez3', 'anvilo', 'itzel.hernandez88', 'pablo_5__', 'pabloaguadero', 'zzhiye', 'rulies07', 'gottagoxxx72', 'mariaenders', 'trucosuso', 'syahminaqiuddins', 'kcharlene94', 'arifhallofamer', 'aorea1997', 'jamarquez8', 'durzua07', 'achavez107', 'theinhtike', 'jooe1121', 'juan_flores12', 'brschick1', 'albertortepin', 'hakim_izani', 'amirulal73', 'andrew0605', 'ihsan92', 'amorales546', 'rubiksmaniac98', 'jose_fett', 'lidia', 'doominous1', 'oc', 'djcastillo', 'mariammb', 'achavez17', 'juanenri14', 'avivpaskaro', 'aframirez', 'quinonez.amado15', 'javiarrabal', 'isalopezcasas', 'lauragalindo', 'julioeroma', 'jotaeneeme', 'pachu555', 'clarakaramazov', 'pollosasica', 'jaimemtz21', 'aliff98', 'javierfloresmartin1992', 'sergioob', 'jusmar21897']"
2,216,155,62,53,"['camachacador', 'mariaenders', 'trucosuso', 'lidp', 'andreszabalacobo', 'marialo', 'paloma95', 'f42rodim', 'cuadros95', 'josebruq', 'pralcalde', 'albertortepin', 'rcl5', 'luis93', 'eljota96', 'andrew0605', 'baloncesto1996', 'paco9', 'fpdn', 'ftinaut', 'antoniojema', 'javiervillar96', 'ivanna', 'javierugr', 'alvarolb5', 'anase1994', 'jose_fett', 'jrispardo', 'emil96', 'miguel1396', 'subiresad', 'lidia', 'victorsalas', 'glaucoepiro', 'oc', 'mariammb', 'aframirez', 'cepebe13', 'lolocatt', 'isalopezcasas', 'lauragalindo', 'anvilo', 'julioeroma', 'jotaeneeme', 'pachu555', 'javier7', 'isaacspidey', 'pabloaguadero', 'amarincaba', 'adrianrubio', 'pollosasica', 'damianbro', 'javierfloresmartin1992']",101,"['brschick', 'khairel_aqil', 'edgar10', 'aljaodi', 'mariocs96az', 'shuangli', 'kimx2373', 'nazmi3', 'imarquez2', 'shouharda12', 'hamizanhamdani5079', 'k.m.zihad888', 'lekez2005', 'juan_flores', 'marcocrio', 'msmartinez7', 'katya.mpapadakis', 'ruben.estrada14', 'rubiksmaniac', 'zhi', 'jcoronado', 'shahrul1306', 'haqimshahrudin', 'cdarmody', 'leonardo9606', 'isracv19', 'ghanshyamjoshi', 'ivj1997', 'syarafifaz98', 'snajera7', 'yaoch', 'basirznal98', 'jocelynsw46', 'urllopez', 'jeffreytebeau', 'phantom4', 'beskisehir', 'jajurado3', 'laarvizu', 'lidialacal', 'daniel.yikyang', 'atiqahkhaishah', 'teck60', 'rifqi1398', 'mohd199912', 'malena23', 'mjmartinez283', 'qatrisyia', 'jsshin3', 'isacaudy', 'javm6', 'chimingzhi', 'hijrahsalleh28', 'derekortiz21', 'chandana.garikipati123', 'mendez.r', 'jmfernandez4', 'msridhar961', 'carlos849702', 'jgmrfisica', 'levicueto', 'mdisyraf19', 'karlaa2296', 'edrusmohamad', 'mbriones25', 'jeal8a', 'teck60osc', 'meftahulturag', 'imsinchee', 'ccramirez3', 'itzel.hernandez88', 'zzhiye', 'rulies07', 'gottagoxxx72', 'syahminaqiuddins', 'kcharlene94', 'arifhallofamer', 'aorea1997', 'jamarquez8', 'durzua07', 'achavez107', 'theinhtike', 'jooe1121', 'juan_flores12', 'brschick1', 'hakim_izani', 'amirulal73', 'ihsan92', 'amorales546', 'rubiksmaniac98', 'doominous1', 'djcastillo', 'achavez17', 'juanenri14', 'avivpaskaro', 'quinonez.amado15', 'javiarrabal', 'clarakaramazov', 'jaimemtz21', 'aliff98', 'jusmar21897']",9,"['sofisofi', 'luciag', 'luismarchante', 'mariapb', 'pablo_5__', 'fmgomez', 'tatianacc', 'sergioob', None]",163,"['brschick', 'khairel_aqil', 'edgar10', 'andreszabalacobo', 'aljaodi', 'mariocs96az', 'marialo', 'paloma95', 'f42rodim', 'rcl5', 'shuangli', 'sofisofi', 'eljota96', 'paco9', 'kimx2373', 'antoniojema', 'ivanna', 'fmgomez', 'nazmi3', 'javierugr', 'imarquez2', 'alvarolb5', 'shouharda12', 'hamizanhamdani5079', 'k.m.zihad888', 'lekez2005', 'juan_flores', 'msmartinez7', 'marcocrio', 'cepebe13', 'katya.mpapadakis', 'ruben.estrada14', 'rubiksmaniac', 'lolocatt', 'javier7', 'zhi', 'jcoronado', 'shahrul1306', 'haqimshahrudin', 'adrianrubio', 'cdarmody', 'leonardo9606', 'isracv19', 'ghanshyamjoshi', 'ivj1997', 'syarafifaz98', 'snajera7', 'lidp', 'yaoch', 'basirznal98', 'jocelynsw46', 'urllopez', 'ftinaut', 'javiervillar96', 'jeffreytebeau', 'anase1994', 'tatianacc', 'emil96', 'miguel1396', 'subiresad', 'phantom4', 'luismarchante', 'glaucoepiro', 'beskisehir', 'jajurado3', 'laarvizu', None, 'lidialacal', 'daniel.yikyang', 'amarincaba', 'atiqahkhaishah', 'isaacspidey', 'teck60', 'damianbro', 'rifqi1398', 'camachacador', 'luciag', 'mohd199912', 'malena23', 'mjmartinez283', 'qatrisyia', 'jsshin3', 'isacaudy', 'javm6', 'cuadros95', 'josebruq', 'pralcalde', 'chimingzhi', 'hijrahsalleh28', 'luis93', 'derekortiz21', 'chandana.garikipati123', 'mendez.r', 'baloncesto1996', 'fpdn', 'jmfernandez4', 'msridhar961', 'carlos849702', 'jrispardo', 'jgmrfisica', 'levicueto', 'mdisyraf19', 'karlaa2296', 'victorsalas', 'edrusmohamad', 'mbriones25', 'jeal8a', 'teck60osc', 'meftahulturag', 'imsinchee', 'ccramirez3', 'anvilo', 'itzel.hernandez88', 'pablo_5__', 'pabloaguadero', 'zzhiye', 'rulies07', 'gottagoxxx72', 'mariaenders', 'trucosuso', 'syahminaqiuddins', 'kcharlene94', 'arifhallofamer', 'aorea1997', 'jamarquez8', 'durzua07', 'achavez107', 'theinhtike', 'jooe1121', 'juan_flores12', 'brschick1', 'albertortepin', 'hakim_izani', 'amirulal73', 'andrew0605', 'ihsan92', 'amorales546', 'rubiksmaniac98', 'jose_fett', 'lidia', 'doominous1', 'mariapb', 'oc', 'djcastillo', 'mariammb', 'achavez17', 'juanenri14', 'avivpaskaro', 'aframirez', 'quinonez.amado15', 'javiarrabal', 'isalopezcasas', 'lauragalindo', 'julioeroma', 'jotaeneeme', 'pachu555', 'clarakaramazov', 'pollosasica', 'jaimemtz21', 'aliff98', 'javierfloresmartin1992', 'sergioob', 'jusmar21897']"
2,218,155,50,41,"['brschick', 'ivj1997', 'kcharlene94', 'mjmartinez283', 'aorea1997', 'jamarquez8', 'snajera7', 'durzua07', 'achavez107', 'edgar10', 'jooe1121', 'brschick1', 'jocelynsw46', 'derekortiz21', 'urllopez', 'jmfernandez4', 'jeffreytebeau', 'amorales546', 'imarquez2', 'carlos849702', 'levicueto', 'karlaa2296', 'mbriones25', 'jeal8a', 'teck60osc', 'jajurado3', 'achavez17', 'ccramirez3', 'marcocrio', 'juanenri14', 'msmartinez7', 'katya.mpapadakis', 'quinonez.amado15', 'itzel.hernandez88', 'zhi', 'jcoronado', 'jaimemtz21', 'teck60', 'zzhiye', 'rulies07', 'jusmar21897']",113,"['khairel_aqil', 'aljaodi', 'andreszabalacobo', 'mariocs96az', 'marialo', 'paloma95', 'f42rodim', 'rcl5', 'shuangli', 'eljota96', 'paco9', 'kimx2373', 'antoniojema', 'ivanna', 'nazmi3', 'javierugr', 'alvarolb5', 'shouharda12', 'hamizanhamdani5079', 'k.m.zihad888', 'lekez2005', 'juan_flores', 'cepebe13', 'ruben.estrada14', 'rubiksmaniac', 'lolocatt', 'javier7', 'shahrul1306', 'haqimshahrudin', 'adrianrubio', 'cdarmody', 'leonardo9606', 'isracv19', 'ghanshyamjoshi', 'syarafifaz98', 'lidp', 'yaoch', 'basirznal98', 'ftinaut', 'javiervillar96', 'anase1994', 'emil96', 'miguel1396', 'subiresad', 'phantom4', 'glaucoepiro', 'beskisehir', 'laarvizu', 'lidialacal', 'daniel.yikyang', 'amarincaba', 'atiqahkhaishah', 'isaacspidey', 'damianbro', 'rifqi1398', 'camachacador', 'mohd199912', 'malena23', 'qatrisyia', 'jsshin3', 'isacaudy', 'javm6', 'cuadros95', 'josebruq', 'pralcalde', 'chimingzhi', 'hijrahsalleh28', 'luis93', 'chandana.garikipati123', 'mendez.r', 'baloncesto1996', 'fpdn', 'msridhar961', 'jrispardo', 'jgmrfisica', 'mdisyraf19', 'victorsalas', 'edrusmohamad', 'meftahulturag', 'imsinchee', 'anvilo', 'pabloaguadero', 'gottagoxxx72', 'mariaenders', 'trucosuso', 'syahminaqiuddins', 'arifhallofamer', 'theinhtike', 'juan_flores12', 'albertortepin', 'hakim_izani', 'amirulal73', 'andrew0605', 'ihsan92', 'rubiksmaniac98', 'jose_fett', 'lidia', 'doominous1', 'oc', 'djcastillo', 'mariammb', 'avivpaskaro', 'aframirez', 'javiarrabal', 'isalopezcasas', 'lauragalindo', 'julioeroma', 'jotaeneeme', 'pachu555', 'clarakaramazov', 'pollosasica', 'aliff98', 'javierfloresmartin1992']",9,"['astridforever20', 'albertomzc', 'sefuentes', 'niahyoder', 'josellujan.14', 'caalvar13', 'oquezada911', None, 'jaimeeeemtz16']",163,"['brschick', 'khairel_aqil', 'edgar10', 'andreszabalacobo', 'aljaodi', 'mariocs96az', 'marialo', 'paloma95', 'f42rodim', 'rcl5', 'shuangli', 'eljota96', 'paco9', 'kimx2373', 'albertomzc', 'antoniojema', 'ivanna', 'nazmi3', 'javierugr', 'imarquez2', 'alvarolb5', 'shouharda12', 'hamizanhamdani5079', 'k.m.zihad888', 'lekez2005', 'juan_flores', 'msmartinez7', 'marcocrio', 'cepebe13', 'katya.mpapadakis', 'ruben.estrada14', 'rubiksmaniac', 'lolocatt', 'javier7', 'zhi', 'jcoronado', 'shahrul1306', 'haqimshahrudin', 'adrianrubio', 'cdarmody', 'leonardo9606', 'isracv19', 'ghanshyamjoshi', 'ivj1997', 'syarafifaz98', 'snajera7', 'lidp', 'yaoch', 'basirznal98', 'jocelynsw46', 'urllopez', 'ftinaut', 'javiervillar96', 'jeffreytebeau', 'anase1994', 'emil96', 'miguel1396', 'subiresad', 'phantom4', 'glaucoepiro', 'josellujan.14', 'beskisehir', 'jajurado3', 'laarvizu', 'jaimeeeemtz16', None, 'lidialacal', 'daniel.yikyang', 'amarincaba', 'atiqahkhaishah', 'isaacspidey', 'teck60', 'damianbro', 'rifqi1398', 'camachacador', 'mohd199912', 'malena23', 'mjmartinez283', 'qatrisyia', 'jsshin3', 'isacaudy', 'javm6', 'cuadros95', 'josebruq', 'pralcalde', 'chimingzhi', 'hijrahsalleh28', 'luis93', 'derekortiz21', 'chandana.garikipati123', 'mendez.r', 'baloncesto1996', 'fpdn', 'jmfernandez4', 'msridhar961', 'carlos849702', 'jrispardo', 'jgmrfisica', 'levicueto', 'mdisyraf19', 'karlaa2296', 'victorsalas', 'edrusmohamad', 'mbriones25', 'jeal8a', 'sefuentes', 'teck60osc', 'meftahulturag', 'imsinchee', 'caalvar13', 'ccramirez3', 'anvilo', 'itzel.hernandez88', 'pabloaguadero', 'zzhiye', 'rulies07', 'gottagoxxx72', 'mariaenders', 'trucosuso', 'syahminaqiuddins', 'kcharlene94', 'arifhallofamer', 'aorea1997', 'jamarquez8', 'durzua07', 'achavez107', 'theinhtike', 'jooe1121', 'juan_flores12', 'brschick1', 'albertortepin', 'hakim_izani', 'amirulal73', 'andrew0605', 'ihsan92', 'amorales546', 'rubiksmaniac98', 'jose_fett', 'lidia', 'astridforever20', 'doominous1', 'oc', 'djcastillo', 'mariammb', 'niahyoder', 'achavez17', 'juanenri14', 'avivpaskaro', 'aframirez', 'quinonez.amado15', 'javiarrabal', 'isalopezcasas', 'lauragalindo', 'julioeroma', 'jotaeneeme', 'pachu555', 'clarakaramazov', 'pollosasica', 'jaimemtz21', 'aliff98', 'oquezada911', 'javierfloresmartin1992', 'jusmar21897']"
2,223,155,47,42,"['camachacador', 'trucosuso', 'malena23', 'lidp', 'andreszabalacobo', 'javm6', 'cuadros95', 'josebruq', 'albertortepin', 'rcl5', 'eljota96', 'paco9', 'baloncesto1996', 'andrew0605', 'ftinaut', 'antoniojema', 'javiervillar96', 'ivanna', 'javierugr', 'alvarolb5', 'anase1994', 'jose_fett', 'jgmrfisica', 'emil96', 'subiresad', 'miguel1396', 'victorsalas', 'glaucoepiro', 'oc', 'cepebe13', 'lidialacal', 'amarincaba', 'julioeroma', 'jotaeneeme', 'javier7', 'pachu555', 'isaacspidey', 'adrianrubio', 'pabloaguadero', 'pollosasica', 'leonardo9606', 'javierfloresmartin1992']",112,"['brschick', 'khairel_aqil', 'edgar10', 'aljaodi', 'mariocs96az', 'marialo', 'paloma95', 'f42rodim', 'shuangli', 'kimx2373', 'nazmi3', 'imarquez2', 'shouharda12', 'hamizanhamdani5079', 'k.m.zihad888', 'lekez2005', 'juan_flores', 'marcocrio', 'msmartinez7', 'katya.mpapadakis', 'ruben.estrada14', 'rubiksmaniac', 'lolocatt', 'zhi', 'jcoronado', 'shahrul1306', 'haqimshahrudin', 'cdarmody', 'isracv19', 'ghanshyamjoshi', 'ivj1997', 'syarafifaz98', 'snajera7', 'yaoch', 'basirznal98', 'jocelynsw46', 'urllopez', 'jeffreytebeau', 'phantom4', 'beskisehir', 'jajurado3', 'laarvizu', 'daniel.yikyang', 'atiqahkhaishah', 'teck60', 'damianbro', 'rifqi1398', 'mohd199912', 'mjmartinez283', 'qatrisyia', 'jsshin3', 'isacaudy', 'pralcalde', 'chimingzhi', 'hijrahsalleh28', 'luis93', 'derekortiz21', 'chandana.garikipati123', 'mendez.r', 'fpdn', 'jmfernandez4', 'msridhar961', 'carlos849702', 'jrispardo', 'levicueto', 'mdisyraf19', 'karlaa2296', 'edrusmohamad', 'mbriones25', 'jeal8a', 'teck60osc', 'meftahulturag', 'imsinchee', 'ccramirez3', 'anvilo', 'itzel.hernandez88', 'zzhiye', 'rulies07', 'gottagoxxx72', 'mariaenders', 'syahminaqiuddins', 'kcharlene94', 'arifhallofamer', 'aorea1997', 'jamarquez8', 'durzua07', 'achavez107', 'theinhtike', 'jooe1121', 'juan_flores12', 'brschick1', 'hakim_izani', 'amirulal73', 'ihsan92', 'amorales546', 'rubiksmaniac98', 'lidia', 'doominous1', 'djcastillo', 'mariammb', 'achavez17', 'juanenri14', 'avivpaskaro', 'aframirez', 'quinonez.amado15', 'javiarrabal', 'isalopezcasas', 'lauragalindo', 'clarakaramazov', 'jaimemtz21', 'aliff98', 'jusmar21897']",5,"['luciag', 'luishue', 'mariapb', 'sergioob', None]",159,"['brschick', 'khairel_aqil', 'edgar10', 'andreszabalacobo', 'aljaodi', 'mariocs96az', 'marialo', 'paloma95', 'f42rodim', 'rcl5', 'shuangli', 'eljota96', 'paco9', 'kimx2373', 'antoniojema', 'ivanna', 'nazmi3', 'javierugr', 'imarquez2', 'alvarolb5', 'shouharda12', 'hamizanhamdani5079', 'k.m.zihad888', 'lekez2005', 'juan_flores', 'msmartinez7', 'marcocrio', 'cepebe13', 'katya.mpapadakis', 'ruben.estrada14', 'rubiksmaniac', 'lolocatt', 'javier7', 'zhi', 'jcoronado', 'shahrul1306', 'haqimshahrudin', 'adrianrubio', 'cdarmody', 'leonardo9606', 'isracv19', 'ghanshyamjoshi', 'luishue', 'ivj1997', 'syarafifaz98', 'snajera7', 'lidp', 'yaoch', 'basirznal98', 'jocelynsw46', 'urllopez', 'ftinaut', 'javiervillar96', 'jeffreytebeau', 'anase1994', 'emil96', 'miguel1396', 'subiresad', 'phantom4', 'glaucoepiro', 'beskisehir', 'jajurado3', 'laarvizu', None, 'lidialacal', 'daniel.yikyang', 'amarincaba', 'atiqahkhaishah', 'isaacspidey', 'teck60', 'damianbro', 'rifqi1398', 'camachacador', 'luciag', 'mohd199912', 'malena23', 'mjmartinez283', 'qatrisyia', 'jsshin3', 'isacaudy', 'javm6', 'cuadros95', 'josebruq', 'pralcalde', 'chimingzhi', 'hijrahsalleh28', 'luis93', 'derekortiz21', 'chandana.garikipati123', 'mendez.r', 'baloncesto1996', 'fpdn', 'jmfernandez4', 'msridhar961', 'carlos849702', 'jrispardo', 'jgmrfisica', 'levicueto', 'mdisyraf19', 'karlaa2296', 'victorsalas', 'edrusmohamad', 'mbriones25', 'jeal8a', 'teck60osc', 'meftahulturag', 'imsinchee', 'ccramirez3', 'anvilo', 'itzel.hernandez88', 'pabloaguadero', 'zzhiye', 'rulies07', 'gottagoxxx72', 'mariaenders', 'trucosuso', 'syahminaqiuddins', 'kcharlene94', 'arifhallofamer', 'aorea1997', 'jamarquez8', 'durzua07', 'achavez107', 'theinhtike', 'jooe1121', 'juan_flores12', 'brschick1', 'albertortepin', 'hakim_izani', 'amirulal73', 'andrew0605', 'ihsan92', 'amorales546', 'rubiksmaniac98', 'jose_fett', 'lidia', 'doominous1', 'mariapb', 'oc', 'djcastillo', 'mariammb', 'achavez17', 'juanenri14', 'avivpaskaro', 'aframirez', 'quinonez.amado15', 'javiarrabal', 'isalopezcasas', 'lauragalindo', 'julioeroma', 'jotaeneeme', 'pachu555', 'clarakaramazov', 'pollosasica', 'jaimemtz21', 'aliff98', 'javierfloresmartin1992', 'sergioob', 'jusmar21897']"
2,219,155,42,25,"['rifqi1398', 'mohd199912', 'syahminaqiuddins', 'khairel_aqil', 'syarafifaz98', 'qatrisyia', 'arifhallofamer', 'aljaodi', 'isacaudy', 'basirznal98', 'hakim_izani', 'hijrahsalleh28', 'chimingzhi', 'amirulal73', 'nazmi3', 'rubiksmaniac98', 'mdisyraf19', 'phantom4', 'doominous1', 'hamizanhamdani5079', 'k.m.zihad888', 'edrusmohamad', 'imsinchee', 'rubiksmaniac', 'haqimshahrudin']",129,"['brschick', 'edgar10', 'andreszabalacobo', 'mariocs96az', 'marialo', 'paloma95', 'f42rodim', 'rcl5', 'shuangli', 'eljota96', 'paco9', 'kimx2373', 'antoniojema', 'ivanna', 'javierugr', 'imarquez2', 'alvarolb5', 'shouharda12', 'lekez2005', 'juan_flores', 'msmartinez7', 'marcocrio', 'cepebe13', 'katya.mpapadakis', 'ruben.estrada14', 'lolocatt', 'javier7', 'zhi', 'jcoronado', 'shahrul1306', 'adrianrubio', 'cdarmody', 'leonardo9606', 'isracv19', 'ghanshyamjoshi', 'ivj1997', 'snajera7', 'lidp', 'yaoch', 'jocelynsw46', 'urllopez', 'ftinaut', 'javiervillar96', 'jeffreytebeau', 'anase1994', 'emil96', 'miguel1396', 'subiresad', 'glaucoepiro', 'beskisehir', 'jajurado3', 'laarvizu', 'lidialacal', 'daniel.yikyang', 'amarincaba', 'atiqahkhaishah', 'isaacspidey', 'teck60', 'damianbro', 'camachacador', 'malena23', 'mjmartinez283', 'jsshin3', 'javm6', 'cuadros95', 'josebruq', 'pralcalde', 'luis93', 'derekortiz21', 'chandana.garikipati123', 'mendez.r', 'baloncesto1996', 'fpdn', 'jmfernandez4', 'msridhar961', 'carlos849702', 'jrispardo', 'jgmrfisica', 'levicueto', 'karlaa2296', 'victorsalas', 'mbriones25', 'jeal8a', 'teck60osc', 'meftahulturag', 'ccramirez3', 'anvilo', 'itzel.hernandez88', 'pabloaguadero', 'zzhiye', 'rulies07', 'gottagoxxx72', 'mariaenders', 'trucosuso', 'kcharlene94', 'aorea1997', 'jamarquez8', 'durzua07', 'achavez107', 'theinhtike', 'jooe1121', 'juan_flores12', 'brschick1', 'albertortepin', 'andrew0605', 'ihsan92', 'amorales546', 'jose_fett', 'lidia', 'oc', 'djcastillo', 'mariammb', 'achavez17', 'juanenri14', 'avivpaskaro', 'aframirez', 'quinonez.amado15', 'javiarrabal', 'isalopezcasas', 'lauragalindo', 'julioeroma', 'jotaeneeme', 'pachu555', 'clarakaramazov', 'pollosasica', 'jaimemtz21', 'aliff98', 'javierfloresmartin1992', 'jusmar21897']",17,"['zayedh', 'imranarif', 'rajauwais98', 'pyc960101', 'kayroll', 'hilmy114', 'gbinula', 'muhamadafiqfarhan98', 'hereisericlai', 'hariz_muz', 'hazemzainal7', 'mihrjeev', 'pizyo2011', 'akasyah123456', None, 'tokchinkuan', 'rutbeer.991']",171,"['brschick', 'khairel_aqil', 'edgar10', 'andreszabalacobo', 'aljaodi', 'mariocs96az', 'marialo', 'paloma95', 'f42rodim', 'rcl5', 'shuangli', 'eljota96', 'paco9', 'kimx2373', 'antoniojema', 'kayroll', 'ivanna', 'nazmi3', 'javierugr', 'imarquez2', 'alvarolb5', 'hazemzainal7', 'shouharda12', 'hamizanhamdani5079', 'k.m.zihad888', 'lekez2005', 'mihrjeev', 'juan_flores', 'msmartinez7', 'marcocrio', 'cepebe13', 'katya.mpapadakis', 'ruben.estrada14', 'rajauwais98', 'rubiksmaniac', 'lolocatt', 'javier7', 'zhi', 'jcoronado', 'shahrul1306', 'haqimshahrudin', 'adrianrubio', 'cdarmody', 'leonardo9606', 'hereisericlai', 'isracv19', 'ghanshyamjoshi', 'ivj1997', 'syarafifaz98', 'snajera7', 'lidp', 'yaoch', 'basirznal98', 'jocelynsw46', 'tokchinkuan', 'urllopez', 'ftinaut', 'javiervillar96', 'jeffreytebeau', 'anase1994', 'emil96', 'miguel1396', 'subiresad', 'phantom4', 'glaucoepiro', 'beskisehir', 'jajurado3', 'laarvizu', None, 'rutbeer.991', 'imranarif', 'lidialacal', 'daniel.yikyang', 'amarincaba', 'atiqahkhaishah', 'isaacspidey', 'teck60', 'hariz_muz', 'damianbro', 'rifqi1398', 'camachacador', 'mohd199912', 'malena23', 'mjmartinez283', 'qatrisyia', 'jsshin3', 'isacaudy', 'javm6', 'cuadros95', 'josebruq', 'pralcalde', 'chimingzhi', 'hijrahsalleh28', 'luis93', 'derekortiz21', 'chandana.garikipati123', 'mendez.r', 'baloncesto1996', 'fpdn', 'jmfernandez4', 'msridhar961', 'hilmy114', 'carlos849702', 'jrispardo', 'jgmrfisica', 'levicueto', 'mdisyraf19', 'karlaa2296', 'victorsalas', 'edrusmohamad', 'mbriones25', 'jeal8a', 'teck60osc', 'meftahulturag', 'imsinchee', 'ccramirez3', 'anvilo', 'itzel.hernandez88', 'pabloaguadero', 'muhamadafiqfarhan98', 'zzhiye', 'rulies07', 'gottagoxxx72', 'zayedh', 'mariaenders', 'trucosuso', 'syahminaqiuddins', 'kcharlene94', 'arifhallofamer', 'aorea1997', 'jamarquez8', 'durzua07', 'achavez107', 'theinhtike', 'jooe1121', 'juan_flores12', 'akasyah123456', 'brschick1', 'albertortepin', 'hakim_izani', 'amirulal73', 'andrew0605', 'ihsan92', 'amorales546', 'rubiksmaniac98', 'pizyo2011', 'jose_fett', 'lidia', 'doominous1', 'pyc960101', 'oc', 'djcastillo', 'mariammb', 'gbinula', 'achavez17', 'juanenri14', 'avivpaskaro', 'aframirez', 'quinonez.amado15', 'javiarrabal', 'isalopezcasas', 'lauragalindo', 'julioeroma', 'jotaeneeme', 'pachu555', 'clarakaramazov', 'pollosasica', 'jaimemtz21', 'aliff98', 'javierfloresmartin1992', 'jusmar21897']"
2,222,155,14,10,"['hamizanhamdani5079', 'syahminaqiuddins', 'ihsan92', 'qatrisyia', 'atiqahkhaishah', 'meftahulturag', 'aliff98', 'imsinchee', 'hijrahsalleh28', 'mdisyraf19']",144,"['brschick', 'khairel_aqil', 'edgar10', 'andreszabalacobo', 'aljaodi', 'mariocs96az', 'marialo', 'paloma95', 'f42rodim', 'rcl5', 'shuangli', 'eljota96', 'paco9', 'kimx2373', 'antoniojema', 'ivanna', 'nazmi3', 'javierugr', 'imarquez2', 'alvarolb5', 'shouharda12', 'k.m.zihad888', 'lekez2005', 'juan_flores', 'msmartinez7', 'marcocrio', 'cepebe13', 'katya.mpapadakis', 'ruben.estrada14', 'rubiksmaniac', 'lolocatt', 'javier7', 'zhi', 'jcoronado', 'shahrul1306', 'haqimshahrudin', 'adrianrubio', 'cdarmody', 'leonardo9606', 'isracv19', 'ghanshyamjoshi', 'ivj1997', 'syarafifaz98', 'snajera7', 'lidp', 'yaoch', 'basirznal98', 'jocelynsw46', 'urllopez', 'ftinaut', 'javiervillar96', 'jeffreytebeau', 'anase1994', 'emil96', 'miguel1396', 'subiresad', 'phantom4', 'glaucoepiro', 'beskisehir', 'jajurado3', 'laarvizu', 'lidialacal', 'daniel.yikyang', 'amarincaba', 'isaacspidey', 'teck60', 'damianbro', 'rifqi1398', 'camachacador', 'mohd199912', 'malena23', 'mjmartinez283', 'jsshin3', 'isacaudy', 'javm6', 'cuadros95', 'josebruq', 'pralcalde', 'chimingzhi', 'luis93', 'derekortiz21', 'chandana.garikipati123', 'mendez.r', 'baloncesto1996', 'fpdn', 'jmfernandez4', 'msridhar961', 'carlos849702', 'jrispardo', 'jgmrfisica', 'levicueto', 'karlaa2296', 'victorsalas', 'edrusmohamad', 'mbriones25', 'jeal8a', 'teck60osc', 'ccramirez3', 'anvilo', 'itzel.hernandez88', 'pabloaguadero', 'zzhiye', 'rulies07', 'gottagoxxx72', 'mariaenders', 'trucosuso', 'kcharlene94', 'arifhallofamer', 'aorea1997', 'jamarquez8', 'durzua07', 'achavez107', 'theinhtike', 'jooe1121', 'juan_flores12', 'brschick1', 'albertortepin', 'hakim_izani', 'amirulal73', 'andrew0605', 'amorales546', 'rubiksmaniac98', 'jose_fett', 'lidia', 'doominous1', 'oc', 'djcastillo', 'mariammb', 'achavez17', 'juanenri14', 'avivpaskaro', 'aframirez', 'quinonez.amado15', 'javiarrabal', 'isalopezcasas', 'lauragalindo', 'julioeroma', 'jotaeneeme', 'pachu555', 'clarakaramazov', 'pollosasica', 'jaimemtz21', 'javierfloresmartin1992', 'jusmar21897']",4,"['pyc960101', None, 'muaz.zulkarnain98', 'omnia128']",158,"['brschick', 'khairel_aqil', 'edgar10', 'andreszabalacobo', 'aljaodi', 'mariocs96az', 'marialo', 'paloma95', 'f42rodim', 'rcl5', 'shuangli', 'eljota96', 'paco9', 'kimx2373', 'antoniojema', 'ivanna', 'nazmi3', 'javierugr', 'imarquez2', 'alvarolb5', 'muaz.zulkarnain98', 'shouharda12', 'hamizanhamdani5079', 'k.m.zihad888', 'lekez2005', 'juan_flores', 'msmartinez7', 'marcocrio', 'cepebe13', 'katya.mpapadakis', 'ruben.estrada14', 'rubiksmaniac', 'lolocatt', 'javier7', 'zhi', 'jcoronado', 'shahrul1306', 'haqimshahrudin', 'adrianrubio', 'cdarmody', 'leonardo9606', 'isracv19', 'ghanshyamjoshi', 'ivj1997', 'syarafifaz98', 'snajera7', 'lidp', 'yaoch', 'basirznal98', 'jocelynsw46', 'urllopez', 'ftinaut', 'javiervillar96', 'jeffreytebeau', 'anase1994', 'emil96', 'miguel1396', 'subiresad', 'phantom4', 'glaucoepiro', 'beskisehir', 'jajurado3', 'laarvizu', None, 'lidialacal', 'daniel.yikyang', 'amarincaba', 'atiqahkhaishah', 'isaacspidey', 'teck60', 'damianbro', 'rifqi1398', 'camachacador', 'mohd199912', 'malena23', 'mjmartinez283', 'qatrisyia', 'jsshin3', 'isacaudy', 'javm6', 'cuadros95', 'josebruq', 'pralcalde', 'chimingzhi', 'hijrahsalleh28', 'luis93', 'derekortiz21', 'chandana.garikipati123', 'mendez.r', 'baloncesto1996', 'fpdn', 'jmfernandez4', 'msridhar961', 'carlos849702', 'jrispardo', 'jgmrfisica', 'levicueto', 'mdisyraf19', 'karlaa2296', 'victorsalas', 'edrusmohamad', 'mbriones25', 'jeal8a', 'teck60osc', 'meftahulturag', 'imsinchee', 'ccramirez3', 'anvilo', 'itzel.hernandez88', 'pabloaguadero', 'zzhiye', 'rulies07', 'gottagoxxx72', 'mariaenders', 'trucosuso', 'syahminaqiuddins', 'kcharlene94', 'arifhallofamer', 'aorea1997', 'jamarquez8', 'durzua07', 'achavez107', 'theinhtike', 'jooe1121', 'juan_flores12', 'brschick1', 'albertortepin', 'hakim_izani', 'amirulal73', 'andrew0605', 'ihsan92', 'amorales546', 'rubiksmaniac98', 'omnia128', 'jose_fett', 'lidia', 'doominous1', 'pyc960101', 'oc', 'djcastillo', 'mariammb', 'achavez17', 'juanenri14', 'avivpaskaro', 'aframirez', 'quinonez.amado15', 'javiarrabal', 'isalopezcasas', 'lauragalindo', 'julioeroma', 'jotaeneeme', 'pachu555', 'clarakaramazov', 'pollosasica', 'jaimemtz21', 'aliff98', 'javierfloresmartin1992', 'jusmar21897']"
2,220,155,10,1,['hamizanhamdani5079'],153,"['brschick', 'khairel_aqil', 'edgar10', 'andreszabalacobo', 'aljaodi', 'mariocs96az', 'marialo', 'paloma95', 'f42rodim', 'rcl5', 'shuangli', 'eljota96', 'paco9', 'kimx2373', 'antoniojema', 'ivanna', 'nazmi3', 'javierugr', 'imarquez2', 'alvarolb5', 'shouharda12', 'k.m.zihad888', 'lekez2005', 'juan_flores', 'msmartinez7', 'marcocrio', 'cepebe13', 'katya.mpapadakis', 'ruben.estrada14', 'rubiksmaniac', 'lolocatt', 'javier7', 'zhi', 'jcoronado', 'shahrul1306', 'haqimshahrudin', 'adrianrubio', 'cdarmody', 'leonardo9606', 'isracv19', 'ghanshyamjoshi', 'ivj1997', 'syarafifaz98', 'snajera7', 'lidp', 'yaoch', 'basirznal98', 'jocelynsw46', 'urllopez', 'ftinaut', 'javiervillar96', 'jeffreytebeau', 'anase1994', 'emil96', 'miguel1396', 'subiresad', 'phantom4', 'glaucoepiro', 'beskisehir', 'jajurado3', 'laarvizu', 'lidialacal', 'daniel.yikyang', 'amarincaba', 'atiqahkhaishah', 'isaacspidey', 'teck60', 'damianbro', 'rifqi1398', 'camachacador', 'mohd199912', 'malena23', 'mjmartinez283', 'qatrisyia', 'jsshin3', 'isacaudy', 'javm6', 'cuadros95', 'josebruq', 'pralcalde', 'chimingzhi', 'hijrahsalleh28', 'luis93', 'derekortiz21', 'chandana.garikipati123', 'mendez.r', 'baloncesto1996', 'fpdn', 'jmfernandez4', 'msridhar961', 'carlos849702', 'jrispardo', 'jgmrfisica', 'levicueto', 'mdisyraf19', 'karlaa2296', 'victorsalas', 'edrusmohamad', 'mbriones25', 'jeal8a', 'teck60osc', 'meftahulturag', 'imsinchee', 'ccramirez3', 'anvilo', 'itzel.hernandez88', 'pabloaguadero', 'zzhiye', 'rulies07', 'gottagoxxx72', 'mariaenders', 'trucosuso', 'syahminaqiuddins', 'kcharlene94', 'arifhallofamer', 'aorea1997', 'jamarquez8', 'durzua07', 'achavez107', 'theinhtike', 'jooe1121', 'juan_flores12', 'brschick1', 'albertortepin', 'hakim_izani', 'amirulal73', 'andrew0605', 'ihsan92', 'amorales546', 'rubiksmaniac98', 'jose_fett', 'lidia', 'doominous1', 'oc', 'djcastillo', 'mariammb', 'achavez17', 'juanenri14', 'avivpaskaro', 'aframirez', 'quinonez.amado15', 'javiarrabal', 'isalopezcasas', 'lauragalindo', 'julioeroma', 'jotaeneeme', 'pachu555', 'clarakaramazov', 'pollosasica', 'jaimemtz21', 'aliff98', 'javierfloresmartin1992', 'jusmar21897']",9,"['zayedh', 'rajauwais98', None, 'kkkoo115', 'mihrjeev', 'jasonloo97', 'zayan1998', 'tokchinkuan', 'rutbeer.991']",163,"['brschick', 'khairel_aqil', 'edgar10', 'andreszabalacobo', 'aljaodi', 'mariocs96az', 'marialo', 'paloma95', 'f42rodim', 'rcl5', 'shuangli', 'eljota96', 'paco9', 'kimx2373', 'antoniojema', 'ivanna', 'nazmi3', 'javierugr', 'imarquez2', 'alvarolb5', 'shouharda12', 'hamizanhamdani5079', 'k.m.zihad888', 'lekez2005', 'mihrjeev', 'juan_flores', 'msmartinez7', 'marcocrio', 'cepebe13', 'katya.mpapadakis', 'ruben.estrada14', 'rajauwais98', 'rubiksmaniac', 'lolocatt', 'javier7', 'zhi', 'jcoronado', 'shahrul1306', 'haqimshahrudin', 'adrianrubio', 'cdarmody', 'leonardo9606', 'isracv19', 'ghanshyamjoshi', 'ivj1997', 'syarafifaz98', 'snajera7', 'lidp', 'yaoch', 'basirznal98', 'jocelynsw46', 'tokchinkuan', 'urllopez', 'ftinaut', 'javiervillar96', 'jeffreytebeau', 'anase1994', 'emil96', 'miguel1396', 'subiresad', 'phantom4', 'glaucoepiro', 'beskisehir', 'jajurado3', 'laarvizu', None, 'rutbeer.991', 'lidialacal', 'daniel.yikyang', 'amarincaba', 'atiqahkhaishah', 'isaacspidey', 'teck60', 'damianbro', 'rifqi1398', 'camachacador', 'mohd199912', 'malena23', 'mjmartinez283', 'qatrisyia', 'jsshin3', 'isacaudy', 'javm6', 'cuadros95', 'josebruq', 'pralcalde', 'chimingzhi', 'hijrahsalleh28', 'luis93', 'derekortiz21', 'chandana.garikipati123', 'mendez.r', 'baloncesto1996', 'fpdn', 'jmfernandez4', 'msridhar961', 'kkkoo115', 'carlos849702', 'jrispardo', 'jgmrfisica', 'levicueto', 'mdisyraf19', 'karlaa2296', 'victorsalas', 'edrusmohamad', 'mbriones25', 'jeal8a', 'teck60osc', 'meftahulturag', 'imsinchee', 'ccramirez3', 'anvilo', 'itzel.hernandez88', 'pabloaguadero', 'zzhiye', 'jasonloo97', 'rulies07', 'zayan1998', 'gottagoxxx72', 'zayedh', 'mariaenders', 'trucosuso', 'syahminaqiuddins', 'kcharlene94', 'arifhallofamer', 'aorea1997', 'jamarquez8', 'durzua07', 'achavez107', 'theinhtike', 'jooe1121', 'juan_flores12', 'brschick1', 'albertortepin', 'hakim_izani', 'amirulal73', 'andrew0605', 'ihsan92', 'amorales546', 'rubiksmaniac98', 'jose_fett', 'lidia', 'doominous1', 'oc', 'djcastillo', 'mariammb', 'achavez17', 'juanenri14', 'avivpaskaro', 'aframirez', 'quinonez.amado15', 'javiarrabal', 'isalopezcasas', 'lauragalindo', 'julioeroma', 'jotaeneeme', 'pachu555', 'clarakaramazov', 'pollosasica', 'jaimemtz21', 'aliff98', 'javierfloresmartin1992', 'jusmar21897']"
2,221,155,10,7,"['javiervillar96', 'lidp', 'javierugr', 'alvarolb5', 'anase1994', 'javierfloresmartin1992', 'albertortepin']",147,"['brschick', 'khairel_aqil', 'edgar10', 'andreszabalacobo', 'aljaodi', 'mariocs96az', 'marialo', 'paloma95', 'f42rodim', 'rcl5', 'shuangli', 'eljota96', 'paco9', 'kimx2373', 'antoniojema', 'ivanna', 'nazmi3', 'imarquez2', 'shouharda12', 'hamizanhamdani5079', 'k.m.zihad888', 'lekez2005', 'juan_flores', 'msmartinez7', 'marcocrio', 'cepebe13', 'katya.mpapadakis', 'ruben.estrada14', 'rubiksmaniac', 'lolocatt', 'javier7', 'zhi', 'jcoronado', 'shahrul1306', 'haqimshahrudin', 'adrianrubio', 'cdarmody', 'leonardo9606', 'isracv19', 'ghanshyamjoshi', 'ivj1997', 'syarafifaz98', 'snajera7', 'yaoch', 'basirznal98', 'jocelynsw46', 'urllopez', 'ftinaut', 'jeffreytebeau', 'emil96', 'miguel1396', 'subiresad', 'phantom4', 'glaucoepiro', 'beskisehir', 'jajurado3', 'laarvizu', 'lidialacal', 'daniel.yikyang', 'amarincaba', 'atiqahkhaishah', 'isaacspidey', 'teck60', 'damianbro', 'rifqi1398', 'camachacador', 'mohd199912', 'malena23', 'mjmartinez283', 'qatrisyia', 'jsshin3', 'isacaudy', 'javm6', 'cuadros95', 'josebruq', 'pralcalde', 'chimingzhi', 'hijrahsalleh28', 'luis93', 'derekortiz21', 'chandana.garikipati123', 'mendez.r', 'baloncesto1996', 'fpdn', 'jmfernandez4', 'msridhar961', 'carlos849702', 'jrispardo', 'jgmrfisica', 'levicueto', 'mdisyraf19', 'karlaa2296', 'victorsalas', 'edrusmohamad', 'mbriones25', 'jeal8a', 'teck60osc', 'meftahulturag', 'imsinchee', 'ccramirez3', 'anvilo', 'itzel.hernandez88', 'pabloaguadero', 'zzhiye', 'rulies07', 'gottagoxxx72', 'mariaenders', 'trucosuso', 'syahminaqiuddins', 'kcharlene94', 'arifhallofamer', 'aorea1997', 'jamarquez8', 'durzua07', 'achavez107', 'theinhtike', 'jooe1121', 'juan_flores12', 'brschick1', 'hakim_izani', 'amirulal73', 'andrew0605', 'ihsan92', 'amorales546', 'rubiksmaniac98', 'jose_fett', 'lidia', 'doominous1', 'oc', 'djcastillo', 'mariammb', 'achavez17', 'juanenri14', 'avivpaskaro', 'aframirez', 'quinonez.amado15', 'javiarrabal', 'isalopezcasas', 'lauragalindo', 'julioeroma', 'jotaeneeme', 'pachu555', 'clarakaramazov', 'pollosasica', 'jaimemtz21', 'aliff98', 'jusmar21897']",3,"['luciag', 'sergioob', None]",157,"['brschick', 'khairel_aqil', 'edgar10', 'andreszabalacobo', 'aljaodi', 'mariocs96az', 'marialo', 'paloma95', 'f42rodim', 'rcl5', 'shuangli', 'eljota96', 'paco9', 'kimx2373', 'antoniojema', 'ivanna', 'nazmi3', 'javierugr', 'imarquez2', 'alvarolb5', 'shouharda12', 'hamizanhamdani5079', 'k.m.zihad888', 'lekez2005', 'juan_flores', 'msmartinez7', 'marcocrio', 'cepebe13', 'katya.mpapadakis', 'ruben.estrada14', 'rubiksmaniac', 'lolocatt', 'javier7', 'zhi', 'jcoronado', 'shahrul1306', 'haqimshahrudin', 'adrianrubio', 'cdarmody', 'leonardo9606', 'isracv19', 'ghanshyamjoshi', 'ivj1997', 'syarafifaz98', 'snajera7', 'lidp', 'yaoch', 'basirznal98', 'jocelynsw46', 'urllopez', 'ftinaut', 'javiervillar96', 'jeffreytebeau', 'anase1994', 'emil96', 'miguel1396', 'subiresad', 'phantom4', 'glaucoepiro', 'beskisehir', 'jajurado3', 'laarvizu', None, 'lidialacal', 'daniel.yikyang', 'amarincaba', 'atiqahkhaishah', 'isaacspidey', 'teck60', 'damianbro', 'rifqi1398', 'camachacador', 'luciag', 'mohd199912', 'malena23', 'mjmartinez283', 'qatrisyia', 'jsshin3', 'isacaudy', 'javm6', 'cuadros95', 'josebruq', 'pralcalde', 'chimingzhi', 'hijrahsalleh28', 'luis93', 'derekortiz21', 'chandana.garikipati123', 'mendez.r', 'baloncesto1996', 'fpdn', 'jmfernandez4', 'msridhar961', 'carlos849702', 'jrispardo', 'jgmrfisica', 'levicueto', 'mdisyraf19', 'karlaa2296', 'victorsalas', 'edrusmohamad', 'mbriones25', 'jeal8a', 'teck60osc', 'meftahulturag', 'imsinchee', 'ccramirez3', 'anvilo', 'itzel.hernandez88', 'pabloaguadero', 'zzhiye', 'rulies07', 'gottagoxxx72', 'mariaenders', 'trucosuso', 'syahminaqiuddins', 'kcharlene94', 'arifhallofamer', 'aorea1997', 'jamarquez8', 'durzua07', 'achavez107', 'theinhtike', 'jooe1121', 'juan_flores12', 'brschick1', 'albertortepin', 'hakim_izani', 'amirulal73', 'andrew0605', 'ihsan92', 'amorales546', 'rubiksmaniac98', 'jose_fett', 'lidia', 'doominous1', 'oc', 'djcastillo', 'mariammb', 'achavez17', 'juanenri14', 'avivpaskaro', 'aframirez', 'quinonez.amado15', 'javiarrabal', 'isalopezcasas', 'lauragalindo', 'julioeroma', 'jotaeneeme', 'pachu555', 'clarakaramazov', 'pollosasica', 'jaimemtz21', 'aliff98', 'javierfloresmartin1992', 'sergioob', 'jusmar21897']"
2,224,155,9,7,"['camachacador', 'yaoch', 'adrianrubio', 'marialo', 'pralcalde', 'emil96', 'aframirez']",147,"['brschick', 'khairel_aqil', 'edgar10', 'andreszabalacobo', 'aljaodi', 'mariocs96az', 'paloma95', 'f42rodim', 'rcl5', 'shuangli', 'eljota96', 'paco9', 'kimx2373', 'antoniojema', 'ivanna', 'nazmi3', 'javierugr', 'imarquez2', 'alvarolb5', 'shouharda12', 'hamizanhamdani5079', 'k.m.zihad888', 'lekez2005', 'juan_flores', 'msmartinez7', 'marcocrio', 'cepebe13', 'katya.mpapadakis', 'ruben.estrada14', 'rubiksmaniac', 'lolocatt', 'javier7', 'zhi', 'jcoronado', 'shahrul1306', 'haqimshahrudin', 'cdarmody', 'leonardo9606', 'isracv19', 'ghanshyamjoshi', 'ivj1997', 'syarafifaz98', 'snajera7', 'lidp', 'basirznal98', 'jocelynsw46', 'urllopez', 'ftinaut', 'javiervillar96', 'jeffreytebeau', 'anase1994', 'miguel1396', 'subiresad', 'phantom4', 'glaucoepiro', 'beskisehir', 'jajurado3', 'laarvizu', 'lidialacal', 'daniel.yikyang', 'amarincaba', 'atiqahkhaishah', 'isaacspidey', 'teck60', 'damianbro', 'rifqi1398', 'mohd199912', 'malena23', 'mjmartinez283', 'qatrisyia', 'jsshin3', 'isacaudy', 'javm6', 'cuadros95', 'josebruq', 'chimingzhi', 'hijrahsalleh28', 'luis93', 'derekortiz21', 'chandana.garikipati123', 'mendez.r', 'baloncesto1996', 'fpdn', 'jmfernandez4', 'msridhar961', 'carlos849702', 'jrispardo', 'jgmrfisica', 'levicueto', 'mdisyraf19', 'karlaa2296', 'victorsalas', 'edrusmohamad', 'mbriones25', 'jeal8a', 'teck60osc', 'meftahulturag', 'imsinchee', 'ccramirez3', 'anvilo', 'itzel.hernandez88', 'pabloaguadero', 'zzhiye', 'rulies07', 'gottagoxxx72', 'mariaenders', 'trucosuso', 'syahminaqiuddins', 'kcharlene94', 'arifhallofamer', 'aorea1997', 'jamarquez8', 'durzua07', 'achavez107', 'theinhtike', 'jooe1121', 'juan_flores12', 'brschick1', 'albertortepin', 'hakim_izani', 'amirulal73', 'andrew0605', 'ihsan92', 'amorales546', 'rubiksmaniac98', 'jose_fett', 'lidia', 'doominous1', 'oc', 'djcastillo', 'mariammb', 'achavez17', 'juanenri14', 'avivpaskaro', 'quinonez.amado15', 'javiarrabal', 'isalopezcasas', 'lauragalindo', 'julioeroma', 'jotaeneeme', 'pachu555', 'clarakaramazov', 'pollosasica', 'jaimemtz21', 'aliff98', 'javierfloresmartin1992', 'jusmar21897']",2,"['miguelpalominocobo', None]",156,"['brschick', 'khairel_aqil', 'edgar10', 'andreszabalacobo', 'aljaodi', 'mariocs96az', 'marialo', 'paloma95', 'f42rodim', 'rcl5', 'shuangli', 'eljota96', 'paco9', 'kimx2373', 'antoniojema', 'ivanna', 'nazmi3', 'javierugr', 'imarquez2', 'alvarolb5', 'shouharda12', 'hamizanhamdani5079', 'k.m.zihad888', 'lekez2005', 'juan_flores', 'msmartinez7', 'marcocrio', 'cepebe13', 'katya.mpapadakis', 'ruben.estrada14', 'rubiksmaniac', 'lolocatt', 'javier7', 'zhi', 'jcoronado', 'shahrul1306', 'haqimshahrudin', 'adrianrubio', 'cdarmody', 'leonardo9606', 'isracv19', 'ghanshyamjoshi', 'ivj1997', 'syarafifaz98', 'snajera7', 'lidp', 'yaoch', 'basirznal98', 'jocelynsw46', 'urllopez', 'ftinaut', 'javiervillar96', 'jeffreytebeau', 'anase1994', 'emil96', 'miguel1396', 'subiresad', 'phantom4', 'glaucoepiro', 'beskisehir', 'jajurado3', 'laarvizu', None, 'lidialacal', 'daniel.yikyang', 'amarincaba', 'atiqahkhaishah', 'isaacspidey', 'teck60', 'damianbro', 'rifqi1398', 'camachacador', 'mohd199912', 'malena23', 'mjmartinez283', 'qatrisyia', 'jsshin3', 'isacaudy', 'javm6', 'cuadros95', 'josebruq', 'pralcalde', 'chimingzhi', 'hijrahsalleh28', 'luis93', 'derekortiz21', 'chandana.garikipati123', 'mendez.r', 'baloncesto1996', 'fpdn', 'jmfernandez4', 'msridhar961', 'carlos849702', 'jrispardo', 'jgmrfisica', 'levicueto', 'mdisyraf19', 'karlaa2296', 'victorsalas', 'edrusmohamad', 'mbriones25', 'jeal8a', 'teck60osc', 'meftahulturag', 'imsinchee', 'ccramirez3', 'anvilo', 'itzel.hernandez88', 'pabloaguadero', 'zzhiye', 'rulies07', 'gottagoxxx72', 'mariaenders', 'trucosuso', 'syahminaqiuddins', 'kcharlene94', 'arifhallofamer', 'aorea1997', 'jamarquez8', 'durzua07', 'achavez107', 'theinhtike', 'jooe1121', 'juan_flores12', 'brschick1', 'albertortepin', 'hakim_izani', 'amirulal73', 'andrew0605', 'ihsan92', 'amorales546', 'rubiksmaniac98', 'jose_fett', 'lidia', 'doominous1', 'oc', 'djcastillo', 'mariammb', 'achavez17', 'juanenri14', 'avivpaskaro', 'aframirez', 'quinonez.amado15', 'javiarrabal', 'isalopezcasas', 'lauragalindo', 'julioeroma', 'jotaeneeme', 'pachu555', 'clarakaramazov', 'pollosasica', 'jaimemtz21', 'miguelpalominocobo', 'aliff98', 'javierfloresmartin1992', 'jusmar21897']"
2,112,155,7,4,"['camachacador', 'jgmrfisica', 'leonardo9606', 'javm6']",150,"['brschick', 'khairel_aqil', 'edgar10', 'andreszabalacobo', 'aljaodi', 'mariocs96az', 'marialo', 'paloma95', 'f42rodim', 'rcl5', 'shuangli', 'eljota96', 'paco9', 'kimx2373', 'antoniojema', 'ivanna', 'nazmi3', 'javierugr', 'imarquez2', 'alvarolb5', 'shouharda12', 'hamizanhamdani5079', 'k.m.zihad888', 'lekez2005', 'juan_flores', 'msmartinez7', 'marcocrio', 'cepebe13', 'katya.mpapadakis', 'ruben.estrada14', 'rubiksmaniac', 'lolocatt', 'javier7', 'zhi', 'jcoronado', 'shahrul1306', 'haqimshahrudin', 'adrianrubio', 'cdarmody', 'isracv19', 'ghanshyamjoshi', 'ivj1997', 'syarafifaz98', 'snajera7', 'lidp', 'yaoch', 'basirznal98', 'jocelynsw46', 'urllopez', 'ftinaut', 'javiervillar96', 'jeffreytebeau', 'anase1994', 'emil96', 'miguel1396', 'subiresad', 'phantom4', 'glaucoepiro', 'beskisehir', 'jajurado3', 'laarvizu', 'lidialacal', 'daniel.yikyang', 'amarincaba', 'atiqahkhaishah', 'isaacspidey', 'teck60', 'damianbro', 'rifqi1398', 'mohd199912', 'malena23', 'mjmartinez283', 'qatrisyia', 'jsshin3', 'isacaudy', 'cuadros95', 'josebruq', 'pralcalde', 'chimingzhi', 'hijrahsalleh28', 'luis93', 'derekortiz21', 'chandana.garikipati123', 'mendez.r', 'baloncesto1996', 'fpdn', 'jmfernandez4', 'msridhar961', 'carlos849702', 'jrispardo', 'levicueto', 'mdisyraf19', 'karlaa2296', 'victorsalas', 'edrusmohamad', 'mbriones25', 'jeal8a', 'teck60osc', 'meftahulturag', 'imsinchee', 'ccramirez3', 'anvilo', 'itzel.hernandez88', 'pabloaguadero', 'zzhiye', 'rulies07', 'gottagoxxx72', 'mariaenders', 'trucosuso', 'syahminaqiuddins', 'kcharlene94', 'arifhallofamer', 'aorea1997', 'jamarquez8', 'durzua07', 'achavez107', 'theinhtike', 'jooe1121', 'juan_flores12', 'brschick1', 'albertortepin', 'hakim_izani', 'amirulal73', 'andrew0605', 'ihsan92', 'amorales546', 'rubiksmaniac98', 'jose_fett', 'lidia', 'doominous1', 'oc', 'djcastillo', 'mariammb', 'achavez17', 'juanenri14', 'avivpaskaro', 'aframirez', 'quinonez.amado15', 'javiarrabal', 'isalopezcasas', 'lauragalindo', 'julioeroma', 'jotaeneeme', 'pachu555', 'clarakaramazov', 'pollosasica', 'jaimemtz21', 'aliff98', 'javierfloresmartin1992', 'jusmar21897']",3,"['fmgomez', None, 'luishue']",157,"['brschick', 'khairel_aqil', 'edgar10', 'andreszabalacobo', 'aljaodi', 'mariocs96az', 'marialo', 'paloma95', 'f42rodim', 'rcl5', 'shuangli', 'eljota96', 'paco9', 'kimx2373', 'antoniojema', 'ivanna', 'fmgomez', 'nazmi3', 'javierugr', 'imarquez2', 'alvarolb5', 'shouharda12', 'hamizanhamdani5079', 'k.m.zihad888', 'lekez2005', 'juan_flores', 'msmartinez7', 'marcocrio', 'cepebe13', 'katya.mpapadakis', 'ruben.estrada14', 'rubiksmaniac', 'lolocatt', 'javier7', 'zhi', 'jcoronado', 'shahrul1306', 'haqimshahrudin', 'adrianrubio', 'cdarmody', 'leonardo9606', 'isracv19', 'ghanshyamjoshi', 'luishue', 'ivj1997', 'syarafifaz98', 'snajera7', 'lidp', 'yaoch', 'basirznal98', 'jocelynsw46', 'urllopez', 'ftinaut', 'javiervillar96', 'jeffreytebeau', 'anase1994', 'emil96', 'miguel1396', 'subiresad', 'phantom4', 'glaucoepiro', 'beskisehir', 'jajurado3', 'laarvizu', None, 'lidialacal', 'daniel.yikyang', 'amarincaba', 'atiqahkhaishah', 'isaacspidey', 'teck60', 'damianbro', 'rifqi1398', 'camachacador', 'mohd199912', 'malena23', 'mjmartinez283', 'qatrisyia', 'jsshin3', 'isacaudy', 'javm6', 'cuadros95', 'josebruq', 'pralcalde', 'chimingzhi', 'hijrahsalleh28', 'luis93', 'derekortiz21', 'chandana.garikipati123', 'mendez.r', 'baloncesto1996', 'fpdn', 'jmfernandez4', 'msridhar961', 'carlos849702', 'jrispardo', 'jgmrfisica', 'levicueto', 'mdisyraf19', 'karlaa2296', 'victorsalas', 'edrusmohamad', 'mbriones25', 'jeal8a', 'teck60osc', 'meftahulturag', 'imsinchee', 'ccramirez3', 'anvilo', 'itzel.hernandez88', 'pabloaguadero', 'zzhiye', 'rulies07', 'gottagoxxx72', 'mariaenders', 'trucosuso', 'syahminaqiuddins', 'kcharlene94', 'arifhallofamer', 'aorea1997', 'jamarquez8', 'durzua07', 'achavez107', 'theinhtike', 'jooe1121', 'juan_flores12', 'brschick1', 'albertortepin', 'hakim_izani', 'amirulal73', 'andrew0605', 'ihsan92', 'amorales546', 'rubiksmaniac98', 'jose_fett', 'lidia', 'doominous1', 'oc', 'djcastillo', 'mariammb', 'achavez17', 'juanenri14', 'avivpaskaro', 'aframirez', 'quinonez.amado15', 'javiarrabal', 'isalopezcasas', 'lauragalindo', 'julioeroma', 'jotaeneeme', 'pachu555', 'clarakaramazov', 'pollosasica', 'jaimemtz21', 'aliff98', 'javierfloresmartin1992', 'jusmar21897']"
2,113,155,6,3,"['camachacador', 'jgmrfisica', 'leonardo9606']",151,"['brschick', 'khairel_aqil', 'edgar10', 'andreszabalacobo', 'aljaodi', 'mariocs96az', 'marialo', 'paloma95', 'f42rodim', 'rcl5', 'shuangli', 'eljota96', 'paco9', 'kimx2373', 'antoniojema', 'ivanna', 'nazmi3', 'javierugr', 'imarquez2', 'alvarolb5', 'shouharda12', 'hamizanhamdani5079', 'k.m.zihad888', 'lekez2005', 'juan_flores', 'msmartinez7', 'marcocrio', 'cepebe13', 'katya.mpapadakis', 'ruben.estrada14', 'rubiksmaniac', 'lolocatt', 'javier7', 'zhi', 'jcoronado', 'shahrul1306', 'haqimshahrudin', 'adrianrubio', 'cdarmody', 'isracv19', 'ghanshyamjoshi', 'ivj1997', 'syarafifaz98', 'snajera7', 'lidp', 'yaoch', 'basirznal98', 'jocelynsw46', 'urllopez', 'ftinaut', 'javiervillar96', 'jeffreytebeau', 'anase1994', 'emil96', 'miguel1396', 'subiresad', 'phantom4', 'glaucoepiro', 'beskisehir', 'jajurado3', 'laarvizu', 'lidialacal', 'daniel.yikyang', 'amarincaba', 'atiqahkhaishah', 'isaacspidey', 'teck60', 'damianbro', 'rifqi1398', 'mohd199912', 'malena23', 'mjmartinez283', 'qatrisyia', 'jsshin3', 'isacaudy', 'javm6', 'cuadros95', 'josebruq', 'pralcalde', 'chimingzhi', 'hijrahsalleh28', 'luis93', 'derekortiz21', 'chandana.garikipati123', 'mendez.r', 'baloncesto1996', 'fpdn', 'jmfernandez4', 'msridhar961', 'carlos849702', 'jrispardo', 'levicueto', 'mdisyraf19', 'karlaa2296', 'victorsalas', 'edrusmohamad', 'mbriones25', 'jeal8a', 'teck60osc', 'meftahulturag', 'imsinchee', 'ccramirez3', 'anvilo', 'itzel.hernandez88', 'pabloaguadero', 'zzhiye', 'rulies07', 'gottagoxxx72', 'mariaenders', 'trucosuso', 'syahminaqiuddins', 'kcharlene94', 'arifhallofamer', 'aorea1997', 'jamarquez8', 'durzua07', 'achavez107', 'theinhtike', 'jooe1121', 'juan_flores12', 'brschick1', 'albertortepin', 'hakim_izani', 'amirulal73', 'andrew0605', 'ihsan92', 'amorales546', 'rubiksmaniac98', 'jose_fett', 'lidia', 'doominous1', 'oc', 'djcastillo', 'mariammb', 'achavez17', 'juanenri14', 'avivpaskaro', 'aframirez', 'quinonez.amado15', 'javiarrabal', 'isalopezcasas', 'lauragalindo', 'julioeroma', 'jotaeneeme', 'pachu555', 'clarakaramazov', 'pollosasica', 'jaimemtz21', 'aliff98', 'javierfloresmartin1992', 'jusmar21897']",3,"['fmgomez', None, 'luishue']",157,"['brschick', 'khairel_aqil', 'edgar10', 'andreszabalacobo', 'aljaodi', 'mariocs96az', 'marialo', 'paloma95', 'f42rodim', 'rcl5', 'shuangli', 'eljota96', 'paco9', 'kimx2373', 'antoniojema', 'ivanna', 'fmgomez', 'nazmi3', 'javierugr', 'imarquez2', 'alvarolb5', 'shouharda12', 'hamizanhamdani5079', 'k.m.zihad888', 'lekez2005', 'juan_flores', 'msmartinez7', 'marcocrio', 'cepebe13', 'katya.mpapadakis', 'ruben.estrada14', 'rubiksmaniac', 'lolocatt', 'javier7', 'zhi', 'jcoronado', 'shahrul1306', 'haqimshahrudin', 'adrianrubio', 'cdarmody', 'leonardo9606', 'isracv19', 'ghanshyamjoshi', 'luishue', 'ivj1997', 'syarafifaz98', 'snajera7', 'lidp', 'yaoch', 'basirznal98', 'jocelynsw46', 'urllopez', 'ftinaut', 'javiervillar96', 'jeffreytebeau', 'anase1994', 'emil96', 'miguel1396', 'subiresad', 'phantom4', 'glaucoepiro', 'beskisehir', 'jajurado3', 'laarvizu', None, 'lidialacal', 'daniel.yikyang', 'amarincaba', 'atiqahkhaishah', 'isaacspidey', 'teck60', 'damianbro', 'rifqi1398', 'camachacador', 'mohd199912', 'malena23', 'mjmartinez283', 'qatrisyia', 'jsshin3', 'isacaudy', 'javm6', 'cuadros95', 'josebruq', 'pralcalde', 'chimingzhi', 'hijrahsalleh28', 'luis93', 'derekortiz21', 'chandana.garikipati123', 'mendez.r', 'baloncesto1996', 'fpdn', 'jmfernandez4', 'msridhar961', 'carlos849702', 'jrispardo', 'jgmrfisica', 'levicueto', 'mdisyraf19', 'karlaa2296', 'victorsalas', 'edrusmohamad', 'mbriones25', 'jeal8a', 'teck60osc', 'meftahulturag', 'imsinchee', 'ccramirez3', 'anvilo', 'itzel.hernandez88', 'pabloaguadero', 'zzhiye', 'rulies07', 'gottagoxxx72', 'mariaenders', 'trucosuso', 'syahminaqiuddins', 'kcharlene94', 'arifhallofamer', 'aorea1997', 'jamarquez8', 'durzua07', 'achavez107', 'theinhtike', 'jooe1121', 'juan_flores12', 'brschick1', 'albertortepin', 'hakim_izani', 'amirulal73', 'andrew0605', 'ihsan92', 'amorales546', 'rubiksmaniac98', 'jose_fett', 'lidia', 'doominous1', 'oc', 'djcastillo', 'mariammb', 'achavez17', 'juanenri14', 'avivpaskaro', 'aframirez', 'quinonez.amado15', 'javiarrabal', 'isalopezcasas', 'lauragalindo', 'julioeroma', 'jotaeneeme', 'pachu555', 'clarakaramazov', 'pollosasica', 'jaimemtz21', 'aliff98', 'javierfloresmartin1992', 'jusmar21897']"
3,211,125,74,73,"['zitan10', 'lennyt7', 'simon853597793', 'cnjloo2', 'hamza96', 'memcnicol', 'azmy.a.andrew', 'blawson2', 'linivanl', 'jasontoo', 'jerryzijiansong', 'sabasafaei7', 'sajanrajdev', 'amikkelsen', 'zekmaster', 'shamwow987', 'ctsutton', 'cblackaby900', 'haoyuwang', 'arashk31', 'kerimsertturk', 'asamhan', 'thomas.siu96', 'gregormorrison123', 'hannahvsawiuk', 'cierraskov', 'kalebgraham97', 'lnatkamol', 'ryaneaston8', 'brenden.fung', 'rayhan.bosch1996', 'siddb3', 'colsen8', 'adil27', 'lucylufei', 'ms.lailaplus', 'savio1', 'samcope', 'rotemm', 'dhruval97', 'jimmyhuang0904', 'victorwu95', 'nancyhong321', 'fsxac', 'michaelmarchesi', 'jacobfaber', 'divyabudihal', 'naomiven', 'imnotastalker69', 'gaoyu0515', 'matt.94.gill', 'aneetnano', 'harmandayal10', '23carloscastro', 'raadkhan', 'yy603511714', 'lwrichardca', 'danmerlo96', 'muhabtomoum', 'terminator.2008', 'm.shehata.1995', 'j329333767', 'gwhyte', 'lyze96', 'shadi3847', 'c.loo.1997', 'bccabrao', 'weitao1994', 'june.ha14', 'jsn0716', 'leoliu', 'byakuyamon', 'tarrynm535']",51,"['doniashlayan', 'cullend', 'ae86micah', 'neoprince', 'nickolas.bybee94', 'lfelleson', 'chadlokker', 'miao', 'holwerje', 'daniel.robin22', 'lokkerch', 'mengshenkoh', 'adianliusie', 'mvalero2214', 'jtrolfe', 'asif_iqbal', 'hlonhlon', 'jiaolh', 'djcarlo_vitelli', 'oddmanout3', 'dag.mtz.97', 'shivakumar', 'nmlippy', 'jwhit', 'cowboys_rugby', 'homanl', 'amlas', 'u0652894', 'berke.durak', 'arweers', 'mejiar', 'sswisher', 'matteo.guareschi', 'msuspartan9622', 'intjohn', 'khambo', 'u0806348', 'hqasem', 'escoba3', 'petelehoux', 'jsdye2010', 'u1163115', 'sandersonq35', 'ktberdar', 'sgtsparky', 'raj57', 'gibsonan', 'dunlar1', 'cuicas', 'stuart20', 'mjbe223']",1,[None],125,"['cnjloo2', 'neoprince', 'memcnicol', 'lokkerch', 'shamwow987', 'arashk31', 'jtrolfe', 'asamhan', 'oddmanout3', 'djcarlo_vitelli', 'shivakumar', 'lucylufei', 'cowboys_rugby', 'ms.lailaplus', 'homanl', 'rotemm', 'nancyhong321', 'fsxac', 'jacobfaber', 'divyabudihal', 'mejiar', 'naomiven', 'u0806348', 'imnotastalker69', 'petelehoux', 'u1163115', 'raadkhan', 'yy603511714', 'dunlar1', 'gwhyte', 'shadi3847', 'cullend', 'ae86micah', 'hamza96', 'nickolas.bybee94', 'azmy.a.andrew', 'chadlokker', 'holwerje', 'sajanrajdev', 'ctsutton', 'mvalero2214', 'kerimsertturk', 'thomas.siu96', 'hannahvsawiuk', 'hlonhlon', 'kalebgraham97', 'jiaolh', 'rayhan.bosch1996', 'siddb3', 'dag.mtz.97', 'samcope', 'dhruval97', 'victorwu95', 'michaelmarchesi', 'sswisher', 'msuspartan9622', 'khambo', 'hqasem', None, 'aneetnano', 'm.shehata.1995', 'sgtsparky', 'raj57', 'gibsonan', 'cuicas', 'weitao1994', 'byakuyamon', 'leoliu', 'jsn0716', 'tarrynm535', 'zitan10', 'doniashlayan', 'lfelleson', 'miao', 'linivanl', 'sabasafaei7', 'jerryzijiansong', 'amikkelsen', 'haoyuwang', 'asif_iqbal', 'cierraskov', 'lnatkamol', 'colsen8', 'nmlippy', 'savio1', 'u0652894', 'berke.durak', 'arweers', 'gaoyu0515', 'sandersonq35', '23carloscastro', 'danmerlo96', 'muhabtomoum', 'terminator.2008', 'lyze96', 'june.ha14', 'lennyt7', 'simon853597793', 'blawson2', 'daniel.robin22', 'jasontoo', 'mengshenkoh', 'zekmaster', 'adianliusie', 'cblackaby900', 'gregormorrison123', 'ryaneaston8', 'brenden.fung', 'adil27', 'jwhit', 'amlas', 'jimmyhuang0904', 'matteo.guareschi', 'intjohn', 'escoba3', 'jsdye2010', 'matt.94.gill', 'harmandayal10', 'ktberdar', 'lwrichardca', 'j329333767', 'stuart20', 'c.loo.1997', 'mjbe223', 'bccabrao']"
3,125,125,24,5,"['doniashlayan', 'cuicas', 'mejiar', 'escoba3', 'jsdye2010']",119,"['zitan10', 'cnjloo2', 'neoprince', 'lfelleson', 'memcnicol', 'miao', 'linivanl', 'sabasafaei7', 'lokkerch', 'jerryzijiansong', 'amikkelsen', 'shamwow987', 'haoyuwang', 'arashk31', 'jtrolfe', 'asamhan', 'asif_iqbal', 'cierraskov', 'lnatkamol', 'oddmanout3', 'djcarlo_vitelli', 'shivakumar', 'colsen8', 'nmlippy', 'lucylufei', 'cowboys_rugby', 'ms.lailaplus', 'homanl', 'savio1', 'rotemm', 'nancyhong321', 'fsxac', 'u0652894', 'jacobfaber', 'divyabudihal', 'berke.durak', 'arweers', 'naomiven', 'u0806348', 'imnotastalker69', 'petelehoux', 'gaoyu0515', 'u1163115', 'sandersonq35', '23carloscastro', 'raadkhan', 'yy603511714', 'danmerlo96', 'muhabtomoum', 'terminator.2008', 'dunlar1', 'gwhyte', 'shadi3847', 'lyze96', 'june.ha14', 'lennyt7', 'cullend', 'ae86micah', 'simon853597793', 'hamza96', 'nickolas.bybee94', 'azmy.a.andrew', 'chadlokker', 'blawson2', 'holwerje', 'daniel.robin22', 'jasontoo', 'sajanrajdev', 'mengshenkoh', 'zekmaster', 'adianliusie', 'ctsutton', 'cblackaby900', 'mvalero2214', 'kerimsertturk', 'thomas.siu96', 'gregormorrison123', 'hannahvsawiuk', 'hlonhlon', 'kalebgraham97', 'ryaneaston8', 'brenden.fung', 'jiaolh', 'rayhan.bosch1996', 'siddb3', 'dag.mtz.97', 'adil27', 'jwhit', 'samcope', 'dhruval97', 'amlas', 'victorwu95', 'jimmyhuang0904', 'michaelmarchesi', 'sswisher', 'matteo.guareschi', 'msuspartan9622', 'intjohn', 'khambo', 'hqasem', 'matt.94.gill', 'aneetnano', 'harmandayal10', 'ktberdar', 'lwrichardca', 'm.shehata.1995', 'sgtsparky', 'j329333767', 'raj57', 'gibsonan', 'stuart20', 'weitao1994', 'byakuyamon', 'c.loo.1997', 'leoliu', 'mjbe223', 'bccabrao', 'jsn0716', 'tarrynm535']",19,"['morgaj7', 'tuqueroe', 'djgraziano', 'mccart2', 'smithb25', 'marqua2', 'munguia4', 'ramirc5', 'fredsteven12', 'arteaga52', 'reekj', 'dingal', None, 'aragom1', 'lasseb1', 'fristerc', 'sama1', 'joseemunguia', 'butlerk2']",143,"['zitan10', 'doniashlayan', 'tuqueroe', 'cnjloo2', 'neoprince', 'lfelleson', 'memcnicol', 'miao', 'linivanl', 'sabasafaei7', 'lokkerch', 'jerryzijiansong', 'amikkelsen', 'shamwow987', 'haoyuwang', 'arashk31', 'jtrolfe', 'asamhan', 'asif_iqbal', 'mccart2', 'marqua2', 'cierraskov', 'lnatkamol', 'oddmanout3', 'djcarlo_vitelli', 'shivakumar', 'colsen8', 'nmlippy', 'lucylufei', 'cowboys_rugby', 'ms.lailaplus', 'homanl', 'savio1', 'rotemm', 'reekj', 'nancyhong321', 'fsxac', 'u0652894', 'jacobfaber', 'divyabudihal', 'berke.durak', 'arweers', 'mejiar', 'dingal', 'naomiven', 'u0806348', 'imnotastalker69', 'petelehoux', 'gaoyu0515', 'u1163115', 'sandersonq35', '23carloscastro', 'raadkhan', 'yy603511714', 'lasseb1', 'danmerlo96', 'muhabtomoum', 'terminator.2008', 'sama1', 'dunlar1', 'gwhyte', 'shadi3847', 'lyze96', 'june.ha14', 'lennyt7', 'morgaj7', 'cullend', 'ae86micah', 'simon853597793', 'hamza96', 'nickolas.bybee94', 'azmy.a.andrew', 'chadlokker', 'blawson2', 'holwerje', 'daniel.robin22', 'jasontoo', 'sajanrajdev', 'mengshenkoh', 'zekmaster', 'adianliusie', 'djgraziano', 'ctsutton', 'cblackaby900', 'mvalero2214', 'kerimsertturk', 'thomas.siu96', 'gregormorrison123', 'hannahvsawiuk', 'smithb25', 'hlonhlon', 'kalebgraham97', 'ryaneaston8', 'brenden.fung', 'munguia4', 'jiaolh', 'rayhan.bosch1996', 'ramirc5', 'fredsteven12', 'siddb3', 'dag.mtz.97', 'arteaga52', 'adil27', 'jwhit', 'samcope', 'dhruval97', 'amlas', 'victorwu95', 'jimmyhuang0904', 'michaelmarchesi', 'sswisher', 'matteo.guareschi', 'msuspartan9622', 'intjohn', 'khambo', 'hqasem', 'escoba3', None, 'jsdye2010', 'matt.94.gill', 'aneetnano', 'aragom1', 'harmandayal10', 'fristerc', 'ktberdar', 'lwrichardca', 'm.shehata.1995', 'sgtsparky', 'j329333767', 'raj57', 'gibsonan', 'cuicas', 'stuart20', 'weitao1994', 'byakuyamon', 'c.loo.1997', 'leoliu', 'mjbe223', 'bccabrao', 'jsn0716', 'joseemunguia', 'butlerk2', 'tarrynm535']"
3,213,125,22,9,"['cullend', 'jiaolh', 'gibsonan', 'chadlokker', 'nmlippy', 'msuspartan9622', 'holwerje', 'lokkerch', 'homanl']",115,"['zitan10', 'doniashlayan', 'cnjloo2', 'neoprince', 'lfelleson', 'memcnicol', 'miao', 'linivanl', 'sabasafaei7', 'jerryzijiansong', 'amikkelsen', 'shamwow987', 'haoyuwang', 'arashk31', 'jtrolfe', 'asamhan', 'asif_iqbal', 'cierraskov', 'lnatkamol', 'oddmanout3', 'djcarlo_vitelli', 'shivakumar', 'colsen8', 'lucylufei', 'cowboys_rugby', 'ms.lailaplus', 'savio1', 'rotemm', 'nancyhong321', 'fsxac', 'u0652894', 'jacobfaber', 'divyabudihal', 'berke.durak', 'arweers', 'mejiar', 'naomiven', 'u0806348', 'imnotastalker69', 'petelehoux', 'gaoyu0515', 'u1163115', 'sandersonq35', '23carloscastro', 'raadkhan', 'yy603511714', 'danmerlo96', 'muhabtomoum', 'terminator.2008', 'dunlar1', 'gwhyte', 'shadi3847', 'lyze96', 'june.ha14', 'lennyt7', 'ae86micah', 'simon853597793', 'hamza96', 'nickolas.bybee94', 'azmy.a.andrew', 'blawson2', 'daniel.robin22', 'jasontoo', 'sajanrajdev', 'mengshenkoh', 'zekmaster', 'adianliusie', 'ctsutton', 'cblackaby900', 'mvalero2214', 'kerimsertturk', 'thomas.siu96', 'gregormorrison123', 'hannahvsawiuk', 'hlonhlon', 'kalebgraham97', 'ryaneaston8', 'brenden.fung', 'rayhan.bosch1996', 'siddb3', 'dag.mtz.97', 'adil27', 'jwhit', 'samcope', 'dhruval97', 'amlas', 'victorwu95', 'jimmyhuang0904', 'michaelmarchesi', 'sswisher', 'matteo.guareschi', 'intjohn', 'khambo', 'hqasem', 'escoba3', 'jsdye2010', 'matt.94.gill', 'aneetnano', 'harmandayal10', 'ktberdar', 'lwrichardca', 'm.shehata.1995', 'sgtsparky', 'j329333767', 'raj57', 'cuicas', 'stuart20', 'weitao1994', 'byakuyamon', 'c.loo.1997', 'leoliu', 'mjbe223', 'bccabrao', 'jsn0716', 'tarrynm535']",13,"['cordesm', 'ejmehall130', None, 'manduzza', 'addison1231', 'emerald41', 'barnessa', 'barnardj', 'andreaschwallier', 'b.j.b.11', 'broeka', 'websteco', 'cameronbeemer6']",137,"['zitan10', 'doniashlayan', 'cnjloo2', 'neoprince', 'lfelleson', 'memcnicol', 'emerald41', 'miao', 'linivanl', 'sabasafaei7', 'lokkerch', 'jerryzijiansong', 'amikkelsen', 'shamwow987', 'haoyuwang', 'arashk31', 'jtrolfe', 'asamhan', 'asif_iqbal', 'cierraskov', 'lnatkamol', 'oddmanout3', 'djcarlo_vitelli', 'shivakumar', 'colsen8', 'nmlippy', 'lucylufei', 'cowboys_rugby', 'broeka', 'ms.lailaplus', 'websteco', 'homanl', 'savio1', 'rotemm', 'nancyhong321', 'fsxac', 'u0652894', 'jacobfaber', 'divyabudihal', 'berke.durak', 'arweers', 'mejiar', 'naomiven', 'u0806348', 'imnotastalker69', 'petelehoux', 'gaoyu0515', 'u1163115', 'sandersonq35', '23carloscastro', 'raadkhan', 'yy603511714', 'manduzza', 'danmerlo96', 'muhabtomoum', 'terminator.2008', 'dunlar1', 'gwhyte', 'shadi3847', 'lyze96', 'june.ha14', 'lennyt7', 'cullend', 'ae86micah', 'simon853597793', 'hamza96', 'nickolas.bybee94', 'azmy.a.andrew', 'chadlokker', 'blawson2', 'barnessa', 'holwerje', 'daniel.robin22', 'jasontoo', 'sajanrajdev', 'mengshenkoh', 'zekmaster', 'adianliusie', 'ctsutton', 'cblackaby900', 'mvalero2214', 'kerimsertturk', 'thomas.siu96', 'gregormorrison123', 'hannahvsawiuk', 'hlonhlon', 'kalebgraham97', 'ryaneaston8', 'brenden.fung', 'jiaolh', 'rayhan.bosch1996', 'siddb3', 'dag.mtz.97', 'adil27', 'jwhit', 'cameronbeemer6', 'samcope', 'dhruval97', 'amlas', 'victorwu95', 'jimmyhuang0904', 'cordesm', 'ejmehall130', 'michaelmarchesi', 'barnardj', 'sswisher', 'matteo.guareschi', 'msuspartan9622', 'intjohn', 'khambo', 'hqasem', 'escoba3', None, 'jsdye2010', 'matt.94.gill', 'aneetnano', 'b.j.b.11', 'harmandayal10', 'ktberdar', 'lwrichardca', 'addison1231', 'm.shehata.1995', 'sgtsparky', 'j329333767', 'raj57', 'gibsonan', 'cuicas', 'stuart20', 'andreaschwallier', 'weitao1994', 'byakuyamon', 'c.loo.1997', 'leoliu', 'mjbe223', 'bccabrao', 'jsn0716', 'tarrynm535']"
3,214,125,17,13,"['u1163115', 'mvalero2214', 'jtrolfe', 'sandersonq35', 'ae86micah', 'u0652894', 'neoprince', 'nickolas.bybee94', 'lfelleson', 'stuart20', 'jwhit', 'cowboys_rugby', 'u0806348']",111,"['zitan10', 'doniashlayan', 'cnjloo2', 'memcnicol', 'miao', 'linivanl', 'sabasafaei7', 'lokkerch', 'jerryzijiansong', 'amikkelsen', 'shamwow987', 'haoyuwang', 'arashk31', 'asamhan', 'asif_iqbal', 'cierraskov', 'lnatkamol', 'oddmanout3', 'djcarlo_vitelli', 'shivakumar', 'colsen8', 'nmlippy', 'lucylufei', 'ms.lailaplus', 'homanl', 'savio1', 'rotemm', 'nancyhong321', 'fsxac', 'jacobfaber', 'divyabudihal', 'berke.durak', 'arweers', 'mejiar', 'naomiven', 'imnotastalker69', 'petelehoux', 'gaoyu0515', '23carloscastro', 'raadkhan', 'yy603511714', 'danmerlo96', 'muhabtomoum', 'terminator.2008', 'dunlar1', 'gwhyte', 'shadi3847', 'lyze96', 'june.ha14', 'lennyt7', 'cullend', 'simon853597793', 'hamza96', 'azmy.a.andrew', 'chadlokker', 'blawson2', 'holwerje', 'daniel.robin22', 'jasontoo', 'sajanrajdev', 'mengshenkoh', 'zekmaster', 'adianliusie', 'ctsutton', 'cblackaby900', 'kerimsertturk', 'thomas.siu96', 'gregormorrison123', 'hannahvsawiuk', 'hlonhlon', 'kalebgraham97', 'ryaneaston8', 'brenden.fung', 'jiaolh', 'rayhan.bosch1996', 'siddb3', 'dag.mtz.97', 'adil27', 'samcope', 'dhruval97', 'amlas', 'victorwu95', 'jimmyhuang0904', 'michaelmarchesi', 'sswisher', 'matteo.guareschi', 'msuspartan9622', 'intjohn', 'khambo', 'hqasem', 'escoba3', 'jsdye2010', 'matt.94.gill', 'aneetnano', 'harmandayal10', 'ktberdar', 'lwrichardca', 'm.shehata.1995', 'sgtsparky', 'j329333767', 'raj57', 'gibsonan', 'cuicas', 'weitao1994', 'byakuyamon', 'c.loo.1997', 'leoliu', 'mjbe223', 'bccabrao', 'jsn0716', 'tarrynm535']",4,"['eldonpea', 'u1015768', 'nuttall_justin', None]",128,"['zitan10', 'doniashlayan', 'cnjloo2', 'neoprince', 'lfelleson', 'memcnicol', 'miao', 'linivanl', 'sabasafaei7', 'lokkerch', 'jerryzijiansong', 'amikkelsen', 'shamwow987', 'haoyuwang', 'arashk31', 'jtrolfe', 'asamhan', 'asif_iqbal', 'cierraskov', 'eldonpea', 'lnatkamol', 'oddmanout3', 'djcarlo_vitelli', 'shivakumar', 'colsen8', 'nmlippy', 'lucylufei', 'cowboys_rugby', 'ms.lailaplus', 'homanl', 'savio1', 'rotemm', 'nancyhong321', 'fsxac', 'u0652894', 'jacobfaber', 'divyabudihal', 'berke.durak', 'arweers', 'mejiar', 'naomiven', 'u0806348', 'imnotastalker69', 'petelehoux', 'gaoyu0515', 'u1163115', 'sandersonq35', '23carloscastro', 'raadkhan', 'yy603511714', 'danmerlo96', 'muhabtomoum', 'terminator.2008', 'dunlar1', 'gwhyte', 'shadi3847', 'lyze96', 'june.ha14', 'lennyt7', 'cullend', 'ae86micah', 'simon853597793', 'hamza96', 'nickolas.bybee94', 'azmy.a.andrew', 'chadlokker', 'blawson2', 'holwerje', 'daniel.robin22', 'jasontoo', 'sajanrajdev', 'mengshenkoh', 'zekmaster', 'adianliusie', 'ctsutton', 'cblackaby900', 'mvalero2214', 'kerimsertturk', 'thomas.siu96', 'gregormorrison123', 'hannahvsawiuk', 'hlonhlon', 'kalebgraham97', 'ryaneaston8', 'brenden.fung', 'jiaolh', 'rayhan.bosch1996', 'siddb3', 'dag.mtz.97', 'adil27', 'jwhit', 'samcope', 'dhruval97', 'amlas', 'victorwu95', 'jimmyhuang0904', 'nuttall_justin', 'u1015768', 'michaelmarchesi', 'sswisher', 'matteo.guareschi', 'msuspartan9622', 'intjohn', 'khambo', 'hqasem', 'escoba3', None, 'jsdye2010', 'matt.94.gill', 'aneetnano', 'harmandayal10', 'ktberdar', 'lwrichardca', 'm.shehata.1995', 'sgtsparky', 'j329333767', 'raj57', 'gibsonan', 'cuicas', 'stuart20', 'weitao1994', 'byakuyamon', 'c.loo.1997', 'leoliu', 'mjbe223', 'bccabrao', 'jsn0716', 'tarrynm535']"
3,212,125,11,7,"['doniashlayan', 'cuicas', 'oddmanout3', 'dunlar1', 'mejiar', 'escoba3', 'jsdye2010']",117,"['zitan10', 'cnjloo2', 'neoprince', 'lfelleson', 'memcnicol', 'miao', 'linivanl', 'sabasafaei7', 'lokkerch', 'jerryzijiansong', 'amikkelsen', 'shamwow987', 'haoyuwang', 'arashk31', 'jtrolfe', 'asamhan', 'asif_iqbal', 'cierraskov', 'lnatkamol', 'djcarlo_vitelli', 'shivakumar', 'colsen8', 'nmlippy', 'lucylufei', 'cowboys_rugby', 'ms.lailaplus', 'homanl', 'savio1', 'rotemm', 'nancyhong321', 'fsxac', 'u0652894', 'jacobfaber', 'divyabudihal', 'berke.durak', 'arweers', 'naomiven', 'u0806348', 'imnotastalker69', 'petelehoux', 'gaoyu0515', 'u1163115', 'sandersonq35', '23carloscastro', 'raadkhan', 'yy603511714', 'danmerlo96', 'muhabtomoum', 'terminator.2008', 'gwhyte', 'shadi3847', 'lyze96', 'june.ha14', 'lennyt7', 'cullend', 'ae86micah', 'simon853597793', 'hamza96', 'nickolas.bybee94', 'azmy.a.andrew', 'chadlokker', 'blawson2', 'holwerje', 'daniel.robin22', 'jasontoo', 'sajanrajdev', 'mengshenkoh', 'zekmaster', 'adianliusie', 'ctsutton', 'cblackaby900', 'mvalero2214', 'kerimsertturk', 'thomas.siu96', 'gregormorrison123', 'hannahvsawiuk', 'hlonhlon', 'kalebgraham97', 'ryaneaston8', 'brenden.fung', 'jiaolh', 'rayhan.bosch1996', 'siddb3', 'dag.mtz.97', 'adil27', 'jwhit', 'samcope', 'dhruval97', 'amlas', 'victorwu95', 'jimmyhuang0904', 'michaelmarchesi', 'sswisher', 'matteo.guareschi', 'msuspartan9622', 'intjohn', 'khambo', 'hqasem', 'matt.94.gill', 'aneetnano', 'harmandayal10', 'ktberdar', 'lwrichardca', 'm.shehata.1995', 'sgtsparky', 'j329333767', 'raj57', 'gibsonan', 'stuart20', 'weitao1994', 'byakuyamon', 'c.loo.1997', 'leoliu', 'mjbe223', 'bccabrao', 'jsn0716', 'tarrynm535']",4,"['jonathanmalta', None, 'arteaga52', 'nanomaster']",128,"['zitan10', 'doniashlayan', 'cnjloo2', 'neoprince', 'lfelleson', 'memcnicol', 'miao', 'linivanl', 'sabasafaei7', 'lokkerch', 'jerryzijiansong', 'amikkelsen', 'shamwow987', 'haoyuwang', 'arashk31', 'jtrolfe', 'asamhan', 'asif_iqbal', 'cierraskov', 'lnatkamol', 'oddmanout3', 'djcarlo_vitelli', 'shivakumar', 'colsen8', 'nmlippy', 'lucylufei', 'cowboys_rugby', 'ms.lailaplus', 'homanl', 'savio1', 'rotemm', 'nancyhong321', 'fsxac', 'u0652894', 'jacobfaber', 'divyabudihal', 'berke.durak', 'arweers', 'mejiar', 'naomiven', 'u0806348', 'imnotastalker69', 'petelehoux', 'gaoyu0515', 'u1163115', 'sandersonq35', '23carloscastro', 'raadkhan', 'yy603511714', 'danmerlo96', 'muhabtomoum', 'terminator.2008', 'dunlar1', 'gwhyte', 'shadi3847', 'lyze96', 'june.ha14', 'nanomaster', 'lennyt7', 'cullend', 'ae86micah', 'simon853597793', 'hamza96', 'nickolas.bybee94', 'azmy.a.andrew', 'chadlokker', 'blawson2', 'holwerje', 'daniel.robin22', 'jasontoo', 'sajanrajdev', 'mengshenkoh', 'zekmaster', 'adianliusie', 'ctsutton', 'cblackaby900', 'mvalero2214', 'kerimsertturk', 'thomas.siu96', 'gregormorrison123', 'hannahvsawiuk', 'hlonhlon', 'kalebgraham97', 'ryaneaston8', 'brenden.fung', 'jiaolh', 'rayhan.bosch1996', 'siddb3', 'dag.mtz.97', 'arteaga52', 'adil27', 'jwhit', 'jonathanmalta', 'samcope', 'dhruval97', 'amlas', 'victorwu95', 'jimmyhuang0904', 'michaelmarchesi', 'sswisher', 'matteo.guareschi', 'msuspartan9622', 'intjohn', 'khambo', 'hqasem', 'escoba3', None, 'jsdye2010', 'matt.94.gill', 'aneetnano', 'harmandayal10', 'ktberdar', 'lwrichardca', 'm.shehata.1995', 'sgtsparky', 'j329333767', 'raj57', 'gibsonan', 'cuicas', 'stuart20', 'weitao1994', 'byakuyamon', 'c.loo.1997', 'leoliu', 'mjbe223', 'bccabrao', 'jsn0716', 'tarrynm535']"
4,44,92,34,31,"['p3rozaria', 'jkhaira', 'smit2590', 'inagrani', 'glamah96', 'thorneb', 'zubin.p.mistry', 'blaguire', 'becochra', 'chopra5', 'chengruili117', 'cpitaniello', 'rebecca9623', 'patel743', 'treyistheway', 'qstar29', 'dkj1022', 'wacciorchen', 's.aditya.v', 'jribeir', 'jsouth3434', 'hsahasra', 'tupelor', 'nguye207', 'mbalasu', 'msadi', 'dramdoss', 'simonzhang8525', 'zhan2130', 'ymalhotr', 'shshin1994']",60,"['pcristini', 'bpieper', 'shobh.nanoscitech', 'vishalnishad97', 'desartbird', 'guofu', 'gigijr', 'sadmanfuad15', 'nnesun', 'menglv1', 'akhosravani3', 'jamesmr', 'stevenw', 'alberto.rivera', 'zypatel7', 'kcicek', 'benbmw1028', 'abinhamd', 'na725333', 'angelo.gaitas', 'ruchimjadhav', 'smithjor', 'jessicastoner', 'lhb', 'pradeepkumarlodhi580', 'andresfrancisco98', 'jamidueee', 'jtejpal', 'tjarcher', 'tithy', 'emonemraul', 'james.byers', 'adsutton', 'mbayle', 'hansg23', 'zachary.bumstead', 'azadkalamd', 'gio.piz', 'zahlernick', 'rimu03', 'szreynolds', 'mislivec', 'eleazar1', 'jpm115', 'oguzhanokudur', 'cenyu', 'hclyanshan96', 'kutliev.u.o', 'catia.m.guarda93', 'momar', 'wjpigg', 'sarvesh', 'tomkelly', 'chen1634', 'jjnash', 'ridha', 'teopze', 'emsimons96', 'shoque', 'ctr']",3,"['bermel', 'jlawry', None]",94,"['pcristini', 'bpieper', 'shobh.nanoscitech', 'p3rozaria', 'jkhaira', 'desartbird', 'glamah96', 'gigijr', 'jlawry', 'menglv1', 'akhosravani3', 'zypatel7', 'blaguire', 'benbmw1028', 'becochra', 'na725333', 'chengruili117', 'smithjor', 'patel743', 'rebecca9623', 'treyistheway', 'qstar29', 'jamidueee', 'jtejpal', 'tithy', 'hansg23', 'wacciorchen', 'zachary.bumstead', 'azadkalamd', 'szreynolds', 'mislivec', 'oguzhanokudur', 'cenyu', 'hclyanshan96', 'kutliev.u.o', 'hsahasra', 'tupelor', 'nguye207', 'catia.m.guarda93', 'momar', 'dramdoss', 'tomkelly', 'msadi', 'bermel', 'simonzhang8525', 'zhan2130', 'teopze', 'shshin1994', 'shoque', 'vishalnishad97', 'smit2590', 'guofu', 'inagrani', 'sadmanfuad15', 'thorneb', 'nnesun', 'zubin.p.mistry', 'stevenw', 'alberto.rivera', 'kcicek', 'chopra5', 'angelo.gaitas', 'ruchimjadhav', 'jessicastoner', 'cpitaniello', 'lhb', 'pradeepkumarlodhi580', 'dkj1022', 'andresfrancisco98', 'tjarcher', 'emonemraul', 'james.byers', 'adsutton', 'mbayle', 'gio.piz', 'zahlernick', 'rimu03', 's.aditya.v', 'eleazar1', 'jsouth3434', 'jpm115', 'jribeir', None, 'wjpigg', 'sarvesh', 'mbalasu', 'chen1634', 'jjnash', 'ridha', 'ymalhotr', 'abinhamd', 'emsimons96', 'jamesmr', 'ctr']"
4,43,92,11,10,"['stevenw', 'wjpigg', 'bpieper', 'tomkelly', 'jjnash', 'gigijr', 'mislivec', 'tjarcher', 'menglv1', 'ctr']",81,"['pcristini', 'shobh.nanoscitech', 'p3rozaria', 'jkhaira', 'desartbird', 'glamah96', 'akhosravani3', 'zypatel7', 'blaguire', 'benbmw1028', 'becochra', 'na725333', 'chengruili117', 'smithjor', 'patel743', 'rebecca9623', 'treyistheway', 'qstar29', 'jamidueee', 'jtejpal', 'tithy', 'hansg23', 'wacciorchen', 'zachary.bumstead', 'azadkalamd', 'szreynolds', 'oguzhanokudur', 'cenyu', 'hclyanshan96', 'kutliev.u.o', 'hsahasra', 'tupelor', 'nguye207', 'catia.m.guarda93', 'momar', 'dramdoss', 'msadi', 'simonzhang8525', 'zhan2130', 'teopze', 'shshin1994', 'shoque', 'vishalnishad97', 'smit2590', 'guofu', 'inagrani', 'sadmanfuad15', 'thorneb', 'nnesun', 'zubin.p.mistry', 'alberto.rivera', 'kcicek', 'chopra5', 'angelo.gaitas', 'ruchimjadhav', 'jessicastoner', 'cpitaniello', 'lhb', 'pradeepkumarlodhi580', 'dkj1022', 'andresfrancisco98', 'emonemraul', 'james.byers', 'adsutton', 'mbayle', 'gio.piz', 'zahlernick', 'rimu03', 's.aditya.v', 'eleazar1', 'jsouth3434', 'jpm115', 'jribeir', 'sarvesh', 'mbalasu', 'chen1634', 'ridha', 'ymalhotr', 'abinhamd', 'emsimons96', 'jamesmr']",1,[None],92,"['pcristini', 'bpieper', 'shobh.nanoscitech', 'p3rozaria', 'jkhaira', 'desartbird', 'glamah96', 'gigijr', 'menglv1', 'akhosravani3', 'zypatel7', 'blaguire', 'benbmw1028', 'becochra', 'na725333', 'chengruili117', 'smithjor', 'patel743', 'rebecca9623', 'treyistheway', 'qstar29', 'jamidueee', 'jtejpal', 'tithy', 'hansg23', 'wacciorchen', 'zachary.bumstead', 'azadkalamd', 'szreynolds', 'mislivec', 'oguzhanokudur', 'cenyu', 'hclyanshan96', 'kutliev.u.o', 'hsahasra', 'tupelor', 'nguye207', 'catia.m.guarda93', 'momar', 'dramdoss', 'tomkelly', 'msadi', 'simonzhang8525', 'zhan2130', 'teopze', 'shshin1994', 'shoque', 'vishalnishad97', 'smit2590', 'guofu', 'inagrani', 'sadmanfuad15', 'thorneb', 'nnesun', 'zubin.p.mistry', 'stevenw', 'alberto.rivera', 'kcicek', 'chopra5', 'angelo.gaitas', 'ruchimjadhav', 'jessicastoner', 'cpitaniello', 'lhb', 'pradeepkumarlodhi580', 'dkj1022', 'andresfrancisco98', 'tjarcher', 'emonemraul', 'james.byers', 'adsutton', 'mbayle', 'gio.piz', 'zahlernick', 'rimu03', 's.aditya.v', 'eleazar1', 'jsouth3434', 'jpm115', 'jribeir', None, 'wjpigg', 'sarvesh', 'mbalasu', 'chen1634', 'jjnash', 'ridha', 'ymalhotr', 'abinhamd', 'emsimons96', 'jamesmr', 'ctr']"
4,45,92,10,7,"['tupelor', 'mbalasu', 'simonzhang8525', 'glamah96', 'rebecca9623', 'treyistheway', 'jamesmr']",84,"['pcristini', 'bpieper', 'shobh.nanoscitech', 'p3rozaria', 'jkhaira', 'desartbird', 'gigijr', 'menglv1', 'akhosravani3', 'zypatel7', 'blaguire', 'benbmw1028', 'becochra', 'na725333', 'chengruili117', 'smithjor', 'patel743', 'qstar29', 'jamidueee', 'jtejpal', 'tithy', 'hansg23', 'wacciorchen', 'zachary.bumstead', 'azadkalamd', 'szreynolds', 'mislivec', 'oguzhanokudur', 'cenyu', 'hclyanshan96', 'kutliev.u.o', 'hsahasra', 'nguye207', 'catia.m.guarda93', 'momar', 'dramdoss', 'tomkelly', 'msadi', 'zhan2130', 'teopze', 'shshin1994', 'shoque', 'vishalnishad97', 'smit2590', 'guofu', 'inagrani', 'sadmanfuad15', 'thorneb', 'nnesun', 'zubin.p.mistry', 'stevenw', 'alberto.rivera', 'kcicek', 'chopra5', 'angelo.gaitas', 'ruchimjadhav', 'jessicastoner', 'cpitaniello', 'lhb', 'pradeepkumarlodhi580', 'dkj1022', 'andresfrancisco98', 'tjarcher', 'emonemraul', 'james.byers', 'adsutton', 'mbayle', 'gio.piz', 'zahlernick', 'rimu03', 's.aditya.v', 'eleazar1', 'jsouth3434', 'jpm115', 'jribeir', 'wjpigg', 'sarvesh', 'chen1634', 'jjnash', 'ridha', 'ymalhotr', 'abinhamd', 'emsimons96', 'ctr']",3,"['rao30', 'jlawry', None]",94,"['pcristini', 'bpieper', 'shobh.nanoscitech', 'p3rozaria', 'jkhaira', 'desartbird', 'glamah96', 'gigijr', 'jlawry', 'menglv1', 'akhosravani3', 'zypatel7', 'blaguire', 'benbmw1028', 'becochra', 'na725333', 'chengruili117', 'smithjor', 'patel743', 'rebecca9623', 'treyistheway', 'qstar29', 'jamidueee', 'jtejpal', 'tithy', 'hansg23', 'wacciorchen', 'zachary.bumstead', 'azadkalamd', 'szreynolds', 'mislivec', 'oguzhanokudur', 'cenyu', 'hclyanshan96', 'kutliev.u.o', 'hsahasra', 'tupelor', 'nguye207', 'catia.m.guarda93', 'momar', 'dramdoss', 'tomkelly', 'msadi', 'simonzhang8525', 'zhan2130', 'teopze', 'shshin1994', 'shoque', 'vishalnishad97', 'smit2590', 'guofu', 'inagrani', 'sadmanfuad15', 'thorneb', 'nnesun', 'zubin.p.mistry', 'stevenw', 'alberto.rivera', 'kcicek', 'chopra5', 'angelo.gaitas', 'ruchimjadhav', 'jessicastoner', 'cpitaniello', 'lhb', 'pradeepkumarlodhi580', 'dkj1022', 'andresfrancisco98', 'tjarcher', 'emonemraul', 'james.byers', 'adsutton', 'mbayle', 'gio.piz', 'zahlernick', 'rimu03', 's.aditya.v', 'eleazar1', 'jsouth3434', 'jpm115', 'jribeir', None, 'rao30', 'wjpigg', 'sarvesh', 'mbalasu', 'chen1634', 'jjnash', 'ridha', 'ymalhotr', 'abinhamd', 'emsimons96', 'jamesmr', 'ctr']"
5,205,91,30,29,"['ravinda', 'wshackel', 'zghorrat', 'xie285', 'sveerall', 'dgrismor', 'aolokun', 'cunnin85', 'hsun.chao', 'ramir145', 'pikus', 'marti730', 'nolans', 'john15', 'potter22', 'ironsj', 'pwitsber', 'jnyhus', 'du187', 'chen2692', 'skarmar', 'vsudarsa', 'aaron.pikus', 'sun374', 'amastrea17', 'stamrazi', 'ldietsch', 'herna283', 'mberns']",61,"['pheney', 'frenchw', 'cgergel8', 'alexan27', 'lbuwick', 'hchim', 'cbrolin', 'ogirod', 'abendoyr', 'nguye316', 'evanderi', 'tillman.rya', 'grootk', 'augustyp', 'locnguyen', 'hughes24', 'aesmaeili', 'seonaleehan', 'hesilva', 'cguarini', 'rrolley', 'jcarah1980', 'brakowsk', 'klecapta', 'shah338', 'eckhart', 'rtillman', 'klawton', 'kangyu159', 'allie.hayford', 'tikram', 'ahayford', 'wang3337', 'modi5', 'nyet', 'scetnar', 'davendra', 'dpilkey', 'templed', 'hookr', 'ibakhle', 'mehta124', 'bdilevsk', 'robin338', 'myers203', 'tpenner', 'rbarba', 'malkan78', 'stroupe', 'orrb', 'sbratto', 'davi1064', 'dgolfin', 'mdai278', 'jlandon', 'gressler', 'wilso868', 'majorhall', 'gkho', 'benjamin.hilker', 'sulliv47']",1,[None],91,"['cgergel8', 'ravinda', 'lbuwick', 'zghorrat', 'abendoyr', 'xie285', 'evanderi', 'aolokun', 'hesilva', 'jcarah1980', 'klecapta', 'eckhart', 'shah338', 'kangyu159', 'allie.hayford', 'tikram', 'ahayford', 'wang3337', 'ramir145', 'modi5', 'pikus', 'marti730', 'nolans', 'templed', 'ironsj', 'pwitsber', 'myers203', 'du187', 'stamrazi', 'wilso868', 'mberns', 'pheney', 'frenchw', 'alexan27', 'wshackel', 'hchim', 'cbrolin', 'ogirod', 'nguye316', 'sveerall', 'tillman.rya', 'grootk', 'augustyp', 'locnguyen', 'dgrismor', 'hughes24', 'majorhall', 'seonaleehan', 'cguarini', 'rrolley', 'brakowsk', 'cunnin85', 'klawton', 'nyet', 'rtillman', 'tpenner', 'aesmaeili', 'hsun.chao', 'scetnar', 'davendra', 'dpilkey', 'john15', 'potter22', 'hookr', 'ibakhle', 'mehta124', 'bdilevsk', 'robin338', 'jnyhus', 'rbarba', 'malkan78', 'chen2692', 'stroupe', 'skarmar', None, 'orrb', 'sbratto', 'vsudarsa', 'davi1064', 'dgolfin', 'aaron.pikus', 'sun374', 'herna283', 'mdai278', 'jlandon', 'gressler', 'amastrea17', 'ldietsch', 'gkho', 'benjamin.hilker', 'sulliv47']"
5,206,91,23,22,"['wshackel', 'zghorrat', 'xie285', 'dgrismor', 'aolokun', 'klecapta', 'cunnin85', 'aesmaeili', 'pikus', 'marti730', 'john15', 'potter22', 'ironsj', 'mehta124', 'jnyhus', 'skarmar', 'vsudarsa', 'sun374', 'stamrazi', 'herna283', 'benjamin.hilker', 'mberns']",68,"['pheney', 'frenchw', 'cgergel8', 'ravinda', 'alexan27', 'lbuwick', 'hchim', 'cbrolin', 'ogirod', 'abendoyr', 'nguye316', 'sveerall', 'evanderi', 'tillman.rya', 'grootk', 'augustyp', 'locnguyen', 'hughes24', 'majorhall', 'seonaleehan', 'hesilva', 'cguarini', 'rrolley', 'jcarah1980', 'brakowsk', 'eckhart', 'shah338', 'klawton', 'rtillman', 'nyet', 'kangyu159', 'allie.hayford', 'tikram', 'ahayford', 'wang3337', 'ramir145', 'modi5', 'scetnar', 'davendra', 'hsun.chao', 'nolans', 'dpilkey', 'templed', 'hookr', 'ibakhle', 'bdilevsk', 'robin338', 'pwitsber', 'myers203', 'tpenner', 'du187', 'rbarba', 'chen2692', 'malkan78', 'stroupe', 'orrb', 'sbratto', 'davi1064', 'dgolfin', 'aaron.pikus', 'mdai278', 'jlandon', 'gressler', 'amastrea17', 'wilso868', 'ldietsch', 'gkho', 'sulliv47']",1,[None],91,"['cgergel8', 'ravinda', 'lbuwick', 'zghorrat', 'abendoyr', 'xie285', 'evanderi', 'aolokun', 'hesilva', 'jcarah1980', 'klecapta', 'eckhart', 'shah338', 'kangyu159', 'allie.hayford', 'tikram', 'ahayford', 'wang3337', 'ramir145', 'modi5', 'pikus', 'marti730', 'nolans', 'templed', 'ironsj', 'pwitsber', 'myers203', 'du187', 'stamrazi', 'wilso868', 'mberns', 'pheney', 'frenchw', 'alexan27', 'wshackel', 'hchim', 'cbrolin', 'ogirod', 'nguye316', 'sveerall', 'tillman.rya', 'grootk', 'augustyp', 'locnguyen', 'dgrismor', 'hughes24', 'majorhall', 'seonaleehan', 'cguarini', 'rrolley', 'brakowsk', 'cunnin85', 'klawton', 'nyet', 'rtillman', 'tpenner', 'aesmaeili', 'hsun.chao', 'scetnar', 'davendra', 'dpilkey', 'john15', 'potter22', 'hookr', 'ibakhle', 'mehta124', 'bdilevsk', 'robin338', 'jnyhus', 'rbarba', 'malkan78', 'chen2692', 'stroupe', 'skarmar', None, 'orrb', 'sbratto', 'vsudarsa', 'davi1064', 'dgolfin', 'aaron.pikus', 'sun374', 'herna283', 'mdai278', 'jlandon', 'gressler', 'amastrea17', 'ldietsch', 'gkho', 'benjamin.hilker', 'sulliv47']"
5,204,91,13,12,"['seonaleehan', 'jcarah1980', 'gressler', 'hchim', 'bdilevsk', 'shah338', 'tikram', 'modi5', 'malkan78', 'scetnar', 'dpilkey', 'wang3337']",78,"['cgergel8', 'ravinda', 'lbuwick', 'zghorrat', 'abendoyr', 'xie285', 'evanderi', 'aolokun', 'hesilva', 'klecapta', 'eckhart', 'kangyu159', 'allie.hayford', 'ahayford', 'ramir145', 'pikus', 'marti730', 'nolans', 'templed', 'ironsj', 'pwitsber', 'myers203', 'du187', 'stamrazi', 'wilso868', 'mberns', 'pheney', 'frenchw', 'alexan27', 'wshackel', 'cbrolin', 'ogirod', 'nguye316', 'sveerall', 'tillman.rya', 'grootk', 'augustyp', 'locnguyen', 'dgrismor', 'hughes24', 'majorhall', 'cguarini', 'rrolley', 'brakowsk', 'cunnin85', 'klawton', 'nyet', 'rtillman', 'tpenner', 'aesmaeili', 'hsun.chao', 'davendra', 'john15', 'potter22', 'hookr', 'ibakhle', 'mehta124', 'robin338', 'jnyhus', 'rbarba', 'chen2692', 'stroupe', 'skarmar', 'orrb', 'sbratto', 'vsudarsa', 'davi1064', 'dgolfin', 'aaron.pikus', 'sun374', 'herna283', 'mdai278', 'jlandon', 'amastrea17', 'ldietsch', 'gkho', 'benjamin.hilker', 'sulliv47']",1,[None],91,"['cgergel8', 'ravinda', 'lbuwick', 'zghorrat', 'abendoyr', 'xie285', 'evanderi', 'aolokun', 'hesilva', 'jcarah1980', 'klecapta', 'eckhart', 'shah338', 'kangyu159', 'allie.hayford', 'tikram', 'ahayford', 'wang3337', 'ramir145', 'modi5', 'pikus', 'marti730', 'nolans', 'templed', 'ironsj', 'pwitsber', 'myers203', 'du187', 'stamrazi', 'wilso868', 'mberns', 'pheney', 'frenchw', 'alexan27', 'wshackel', 'hchim', 'cbrolin', 'ogirod', 'nguye316', 'sveerall', 'tillman.rya', 'grootk', 'augustyp', 'locnguyen', 'dgrismor', 'hughes24', 'majorhall', 'seonaleehan', 'cguarini', 'rrolley', 'brakowsk', 'cunnin85', 'klawton', 'nyet', 'rtillman', 'tpenner', 'aesmaeili', 'hsun.chao', 'scetnar', 'davendra', 'dpilkey', 'john15', 'potter22', 'hookr', 'ibakhle', 'mehta124', 'bdilevsk', 'robin338', 'jnyhus', 'rbarba', 'malkan78', 'chen2692', 'stroupe', 'skarmar', None, 'orrb', 'sbratto', 'vsudarsa', 'davi1064', 'dgolfin', 'aaron.pikus', 'sun374', 'herna283', 'mdai278', 'jlandon', 'gressler', 'amastrea17', 'ldietsch', 'gkho', 'benjamin.hilker', 'sulliv47']"
5,207,91,8,7,"['seonaleehan', 'cgergel8', 'jcarah1980', 'gressler', 'tikram', 'scetnar', 'dpilkey']",83,"['ravinda', 'lbuwick', 'zghorrat', 'abendoyr', 'xie285', 'evanderi', 'aolokun', 'hesilva', 'klecapta', 'eckhart', 'shah338', 'kangyu159', 'allie.hayford', 'ahayford', 'wang3337', 'ramir145', 'modi5', 'pikus', 'marti730', 'nolans', 'templed', 'ironsj', 'pwitsber', 'myers203', 'du187', 'stamrazi', 'wilso868', 'mberns', 'pheney', 'frenchw', 'alexan27', 'wshackel', 'hchim', 'cbrolin', 'ogirod', 'nguye316', 'sveerall', 'tillman.rya', 'grootk', 'augustyp', 'locnguyen', 'dgrismor', 'hughes24', 'majorhall', 'cguarini', 'rrolley', 'brakowsk', 'cunnin85', 'klawton', 'nyet', 'rtillman', 'tpenner', 'aesmaeili', 'hsun.chao', 'davendra', 'john15', 'potter22', 'hookr', 'ibakhle', 'mehta124', 'bdilevsk', 'robin338', 'jnyhus', 'rbarba', 'malkan78', 'chen2692', 'stroupe', 'skarmar', 'orrb', 'sbratto', 'vsudarsa', 'davi1064', 'dgolfin', 'aaron.pikus', 'sun374', 'herna283', 'mdai278', 'jlandon', 'amastrea17', 'ldietsch', 'gkho', 'benjamin.hilker', 'sulliv47']",1,[None],91,"['cgergel8', 'ravinda', 'lbuwick', 'zghorrat', 'abendoyr', 'xie285', 'evanderi', 'aolokun', 'hesilva', 'jcarah1980', 'klecapta', 'eckhart', 'shah338', 'kangyu159', 'allie.hayford', 'tikram', 'ahayford', 'wang3337', 'ramir145', 'modi5', 'pikus', 'marti730', 'nolans', 'templed', 'ironsj', 'pwitsber', 'myers203', 'du187', 'stamrazi', 'wilso868', 'mberns', 'pheney', 'frenchw', 'alexan27', 'wshackel', 'hchim', 'cbrolin', 'ogirod', 'nguye316', 'sveerall', 'tillman.rya', 'grootk', 'augustyp', 'locnguyen', 'dgrismor', 'hughes24', 'majorhall', 'seonaleehan', 'cguarini', 'rrolley', 'brakowsk', 'cunnin85', 'klawton', 'nyet', 'rtillman', 'tpenner', 'aesmaeili', 'hsun.chao', 'scetnar', 'davendra', 'dpilkey', 'john15', 'potter22', 'hookr', 'ibakhle', 'mehta124', 'bdilevsk', 'robin338', 'jnyhus', 'rbarba', 'malkan78', 'chen2692', 'stroupe', 'skarmar', None, 'orrb', 'sbratto', 'vsudarsa', 'davi1064', 'dgolfin', 'aaron.pikus', 'sun374', 'herna283', 'mdai278', 'jlandon', 'gressler', 'amastrea17', 'ldietsch', 'gkho', 'benjamin.hilker', 'sulliv47']"
6,48,88,41,34,"['lm.cruzh', 'luisaferplata', 'miguelangie', 'je.ovalles', 'materiales2018', 'pa.mata', 'alvarocardona', 'medagorodavid', 'tumamitaloka', 'voteportimo', 'hernandezjuandavid918', 'serranito', 'drhurtado', 'julissa.vigoya', 'leonard.ruiz00', 'valeparra1999', 'se.alfonso', 'holapincheputita', 'carlosan98', 'seturizo98', 'n.abril', 'juanseb4444', 'acostacpaulina', 'sramirezc2', 'dacosta', 'paulinaacostac', 'jchaparrog10', 'alejandroariaszuluaga', 'haroldsteven013', 'vitery', 'juanesdiaz98', 'polania.andres.a', 'jeisontimana', 'tovar96']",53,"['mukeshtyadav21', 'abhamid', 'eleacecar94', 'rcarvajal208', 'pfang', 'manolobetancur', 'connorv', 'omair.mohamad', 'paulavg1995', 'ccescott', 'sajjadahmed.uet', 'shelvon', 'sayeembinkutub.ewu', 'atilla.atli', 'kolhatkarchinmay96', 'stericeling_108', 'vragiydron', 'lyates6', 'bigfatpaul', 'ngilbert', 'yaminibalannagari1998', 'nourkhaled.1994', 'ganeshmashette', 'gdm121', 'zevgan98', 'lassesodergren', 'cva41', 'pharsh800', 'deniz.yildirim.ee', 'flowdaddy', 'donaldwilliams', 'dhanesh2197', 'borun', 'macharyaua', 'kulbirpal84', 'theblacktigerultimate', 'ivanleongg88', 'neiderbarret02', 'nh747', 'broinel', 'sushy', 'amp6567', 'rahulserves2', 'lsmarcoa', 'karimfouda2', 'doubrm', 'linhy', 'srpuranmath', 'brb307', 'synsilvers', 'humberto3', 'kavu094', '96harryireland']",7,"['edgarfpena', 'w.pantoja005', 's.devia10', 'rc.moreno1084', None, 'am.bolivar', 'yeju16']",94,"['miguelangie', 'eleacecar94', 'pfang', 'paulavg1995', 'materiales2018', 'pa.mata', 'alvarocardona', 'sajjadahmed.uet', 'yeju16', 'shelvon', 'tumamitaloka', 'voteportimo', 'kolhatkarchinmay96', 'bigfatpaul', 'serranito', 'yaminibalannagari1998', 'valeparra1999', 'nourkhaled.1994', 's.devia10', 'gdm121', 'zevgan98', 'n.abril', 'juanseb4444', 'dhanesh2197', 'borun', 'macharyaua', 'kulbirpal84', 'ivanleongg88', 'broinel', 'sushy', 'amp6567', 'alejandroariaszuluaga', 'rahulserves2', 'lsmarcoa', 'karimfouda2', 'juanesdiaz98', 'srpuranmath', 'synsilvers', 'rc.moreno1084', 'kavu094', '96harryireland', 'jeisontimana', 'lm.cruzh', 'mukeshtyadav21', 'luisaferplata', 'abhamid', 'je.ovalles', 'rcarvajal208', 'edgarfpena', 'manolobetancur', 'connorv', 'w.pantoja005', 'omair.mohamad', 'ccescott', 'medagorodavid', 'sayeembinkutub.ewu', 'atilla.atli', 'stericeling_108', 'hernandezjuandavid918', 'vragiydron', 'lyates6', 'julissa.vigoya', 'drhurtado', 'ngilbert', 'leonard.ruiz00', 'se.alfonso', 'ganeshmashette', 'holapincheputita', 'carlosan98', 'seturizo98', 'lassesodergren', 'cva41', 'deniz.yildirim.ee', 'pharsh800', 'flowdaddy', 'donaldwilliams', 'acostacpaulina', 'sramirezc2', 'theblacktigerultimate', 'dacosta', 'paulinaacostac', 'neiderbarret02', 'jchaparrog10', 'nh747', None, 'haroldsteven013', 'doubrm', 'vitery', 'linhy', 'brb307', 'polania.andres.a', 'humberto3', 'am.bolivar', 'tovar96']"
6,46,88,24,1,['pfang'],86,"['miguelangie', 'paulavg1995', 'pa.mata', 'sajjadahmed.uet', 'shelvon', 'tumamitaloka', 'kolhatkarchinmay96', 'bigfatpaul', 'yaminibalannagari1998', 'n.abril', 'juanseb4444', 'dhanesh2197', 'ivanleongg88', 'juanesdiaz98', 'srpuranmath', 'lm.cruzh', 'abhamid', 'rcarvajal208', 'omair.mohamad', 'ccescott', 'sayeembinkutub.ewu', 'atilla.atli', 'hernandezjuandavid918', 'leonard.ruiz00', 'se.alfonso', 'ganeshmashette', 'holapincheputita', 'seturizo98', 'deniz.yildirim.ee', 'donaldwilliams', 'sramirezc2', 'theblacktigerultimate', 'dacosta', 'paulinaacostac', 'neiderbarret02', 'nh747', 'linhy', 'brb307', 'polania.andres.a', 'humberto3', 'eleacecar94', 'materiales2018', 'alvarocardona', 'voteportimo', 'serranito', 'valeparra1999', 'nourkhaled.1994', 'gdm121', 'zevgan98', 'borun', 'macharyaua', 'kulbirpal84', 'broinel', 'sushy', 'amp6567', 'alejandroariaszuluaga', 'rahulserves2', 'lsmarcoa', 'karimfouda2', 'synsilvers', 'kavu094', '96harryireland', 'jeisontimana', 'mukeshtyadav21', 'luisaferplata', 'je.ovalles', 'manolobetancur', 'connorv', 'medagorodavid', 'stericeling_108', 'vragiydron', 'lyates6', 'julissa.vigoya', 'drhurtado', 'ngilbert', 'carlosan98', 'lassesodergren', 'cva41', 'pharsh800', 'flowdaddy', 'acostacpaulina', 'jchaparrog10', 'haroldsteven013', 'doubrm', 'vitery', 'tovar96']",23,"['hongyangao', 'mtorfeh', 'dchitkara', 'ravichan', 'sheringeorge', 'fatemehkiani', 'zzou', 'sayandas', 'aliyaqureshi', 'srini999', 'spalani', 'awaingade', 'aksamija', 'nazanintakbiri', 'edward8324', 'fairytail', 'bmirzapouebe', 'edward83241994', 'xiaomengliu', None, 'babak.mirzapour', 'acalambur', 'abanagozar']",110,"['hongyangao', 'miguelangie', 'eleacecar94', 'pfang', 'ravichan', 'paulavg1995', 'materiales2018', 'pa.mata', 'alvarocardona', 'sajjadahmed.uet', 'sayandas', 'shelvon', 'tumamitaloka', 'voteportimo', 'kolhatkarchinmay96', 'aliyaqureshi', 'bigfatpaul', 'serranito', 'yaminibalannagari1998', 'valeparra1999', 'nourkhaled.1994', 'gdm121', 'zevgan98', 'spalani', 'n.abril', 'awaingade', 'juanseb4444', 'dhanesh2197', 'borun', 'macharyaua', 'kulbirpal84', 'aksamija', 'ivanleongg88', 'bmirzapouebe', 'broinel', 'sushy', 'amp6567', 'alejandroariaszuluaga', 'rahulserves2', 'lsmarcoa', 'karimfouda2', 'juanesdiaz98', 'srpuranmath', 'synsilvers', 'abanagozar', 'kavu094', '96harryireland', 'jeisontimana', 'lm.cruzh', 'mukeshtyadav21', 'luisaferplata', 'mtorfeh', 'abhamid', 'je.ovalles', 'dchitkara', 'rcarvajal208', 'manolobetancur', 'connorv', 'omair.mohamad', 'sheringeorge', 'ccescott', 'fatemehkiani', 'zzou', 'medagorodavid', 'sayeembinkutub.ewu', 'atilla.atli', 'stericeling_108', 'hernandezjuandavid918', 'vragiydron', 'lyates6', 'julissa.vigoya', 'drhurtado', 'ngilbert', 'leonard.ruiz00', 'se.alfonso', 'ganeshmashette', 'holapincheputita', 'carlosan98', 'seturizo98', 'lassesodergren', 'cva41', 'deniz.yildirim.ee', 'pharsh800', 'flowdaddy', 'donaldwilliams', 'srini999', 'acostacpaulina', 'sramirezc2', 'nazanintakbiri', 'theblacktigerultimate', 'dacosta', 'paulinaacostac', 'edward8324', 'fairytail', 'neiderbarret02', 'edward83241994', 'jchaparrog10', 'nh747', 'xiaomengliu', None, 'haroldsteven013', 'doubrm', 'vitery', 'babak.mirzapour', 'linhy', 'acalambur', 'brb307', 'polania.andres.a', 'humberto3', 'tovar96']"
6,50,88,22,2,"['paulavg1995', 'eleacecar94']",85,"['miguelangie', 'pfang', 'pa.mata', 'sajjadahmed.uet', 'shelvon', 'tumamitaloka', 'kolhatkarchinmay96', 'bigfatpaul', 'yaminibalannagari1998', 'n.abril', 'juanseb4444', 'dhanesh2197', 'ivanleongg88', 'juanesdiaz98', 'srpuranmath', 'lm.cruzh', 'abhamid', 'rcarvajal208', 'omair.mohamad', 'ccescott', 'sayeembinkutub.ewu', 'atilla.atli', 'hernandezjuandavid918', 'leonard.ruiz00', 'se.alfonso', 'ganeshmashette', 'holapincheputita', 'seturizo98', 'deniz.yildirim.ee', 'donaldwilliams', 'sramirezc2', 'theblacktigerultimate', 'dacosta', 'paulinaacostac', 'neiderbarret02', 'nh747', 'linhy', 'brb307', 'polania.andres.a', 'humberto3', 'materiales2018', 'alvarocardona', 'voteportimo', 'serranito', 'valeparra1999', 'nourkhaled.1994', 'gdm121', 'zevgan98', 'borun', 'macharyaua', 'kulbirpal84', 'broinel', 'sushy', 'amp6567', 'alejandroariaszuluaga', 'rahulserves2', 'lsmarcoa', 'karimfouda2', 'synsilvers', 'kavu094', '96harryireland', 'jeisontimana', 'mukeshtyadav21', 'luisaferplata', 'je.ovalles', 'manolobetancur', 'connorv', 'medagorodavid', 'stericeling_108', 'vragiydron', 'lyates6', 'julissa.vigoya', 'drhurtado', 'ngilbert', 'carlosan98', 'lassesodergren', 'cva41', 'pharsh800', 'flowdaddy', 'acostacpaulina', 'jchaparrog10', 'haroldsteven013', 'doubrm', 'vitery', 'tovar96']",20,"['galfa', 'miguelhernandezcamacho', 'hansinivaswani', 'fernandoserranoperez94', 'andermoren', 'martaalvarezdominguez', 'gines', 'samgalv', 'alexparedesgranado', 'angyrom8', 'claudiagalindo', 'anxela', None, 'maclopveg', 'mariaal23', 'acasgar17', 'jesuschaconmontero', 'solitaso', 'mariano', 'paunavgon2296']",107,"['miguelangie', 'eleacecar94', 'pfang', 'paulavg1995', 'materiales2018', 'pa.mata', 'alvarocardona', 'sajjadahmed.uet', 'shelvon', 'tumamitaloka', 'voteportimo', 'kolhatkarchinmay96', 'miguelhernandezcamacho', 'bigfatpaul', 'serranito', 'yaminibalannagari1998', 'valeparra1999', 'nourkhaled.1994', 'gdm121', 'zevgan98', 'andermoren', 'n.abril', 'juanseb4444', 'dhanesh2197', 'borun', 'macharyaua', 'kulbirpal84', 'alexparedesgranado', 'angyrom8', 'ivanleongg88', 'broinel', 'sushy', 'anxela', 'amp6567', 'alejandroariaszuluaga', 'rahulserves2', 'mariaal23', 'lsmarcoa', 'karimfouda2', 'jesuschaconmontero', 'juanesdiaz98', 'srpuranmath', 'synsilvers', 'kavu094', '96harryireland', 'jeisontimana', 'mariano', 'lm.cruzh', 'mukeshtyadav21', 'luisaferplata', 'paunavgon2296', 'abhamid', 'je.ovalles', 'rcarvajal208', 'manolobetancur', 'connorv', 'omair.mohamad', 'ccescott', 'medagorodavid', 'sayeembinkutub.ewu', 'atilla.atli', 'galfa', 'stericeling_108', 'hernandezjuandavid918', 'vragiydron', 'lyates6', 'hansinivaswani', 'julissa.vigoya', 'drhurtado', 'fernandoserranoperez94', 'ngilbert', 'leonard.ruiz00', 'se.alfonso', 'ganeshmashette', 'holapincheputita', 'carlosan98', 'seturizo98', 'lassesodergren', 'cva41', 'deniz.yildirim.ee', 'pharsh800', 'flowdaddy', 'donaldwilliams', 'martaalvarezdominguez', 'gines', 'acostacpaulina', 'samgalv', 'sramirezc2', 'theblacktigerultimate', 'dacosta', 'paulinaacostac', 'neiderbarret02', 'jchaparrog10', 'nh747', 'claudiagalindo', None, 'maclopveg', 'haroldsteven013', 'doubrm', 'vitery', 'acasgar17', 'linhy', 'brb307', 'polania.andres.a', 'humberto3', 'solitaso', 'tovar96']"
6,49,88,6,4,"['mukeshtyadav21', 'pharsh800', 'dhanesh2197', 'kolhatkarchinmay96']",83,"['miguelangie', 'eleacecar94', 'pfang', 'paulavg1995', 'materiales2018', 'pa.mata', 'alvarocardona', 'sajjadahmed.uet', 'shelvon', 'tumamitaloka', 'voteportimo', 'bigfatpaul', 'serranito', 'yaminibalannagari1998', 'valeparra1999', 'nourkhaled.1994', 'gdm121', 'zevgan98', 'n.abril', 'juanseb4444', 'borun', 'macharyaua', 'kulbirpal84', 'ivanleongg88', 'broinel', 'sushy', 'amp6567', 'alejandroariaszuluaga', 'rahulserves2', 'lsmarcoa', 'karimfouda2', 'juanesdiaz98', 'srpuranmath', 'synsilvers', 'kavu094', '96harryireland', 'jeisontimana', 'lm.cruzh', 'luisaferplata', 'abhamid', 'je.ovalles', 'rcarvajal208', 'manolobetancur', 'connorv', 'omair.mohamad', 'ccescott', 'medagorodavid', 'sayeembinkutub.ewu', 'atilla.atli', 'stericeling_108', 'hernandezjuandavid918', 'vragiydron', 'lyates6', 'julissa.vigoya', 'drhurtado', 'ngilbert', 'leonard.ruiz00', 'se.alfonso', 'ganeshmashette', 'holapincheputita', 'carlosan98', 'seturizo98', 'lassesodergren', 'cva41', 'deniz.yildirim.ee', 'flowdaddy', 'donaldwilliams', 'acostacpaulina', 'sramirezc2', 'theblacktigerultimate', 'dacosta', 'paulinaacostac', 'neiderbarret02', 'jchaparrog10', 'nh747', 'haroldsteven013', 'doubrm', 'vitery', 'linhy', 'brb307', 'polania.andres.a', 'humberto3', 'tovar96']",2,"['vinayvishwakarma', None]",89,"['miguelangie', 'eleacecar94', 'pfang', 'paulavg1995', 'materiales2018', 'pa.mata', 'alvarocardona', 'sajjadahmed.uet', 'shelvon', 'tumamitaloka', 'voteportimo', 'kolhatkarchinmay96', 'bigfatpaul', 'serranito', 'yaminibalannagari1998', 'valeparra1999', 'nourkhaled.1994', 'gdm121', 'zevgan98', 'n.abril', 'juanseb4444', 'dhanesh2197', 'borun', 'macharyaua', 'kulbirpal84', 'vinayvishwakarma', 'ivanleongg88', 'broinel', 'sushy', 'amp6567', 'alejandroariaszuluaga', 'rahulserves2', 'lsmarcoa', 'karimfouda2', 'juanesdiaz98', 'srpuranmath', 'synsilvers', 'kavu094', '96harryireland', 'jeisontimana', 'lm.cruzh', 'mukeshtyadav21', 'luisaferplata', 'abhamid', 'je.ovalles', 'rcarvajal208', 'manolobetancur', 'connorv', 'omair.mohamad', 'ccescott', 'medagorodavid', 'sayeembinkutub.ewu', 'atilla.atli', 'stericeling_108', 'hernandezjuandavid918', 'vragiydron', 'lyates6', 'julissa.vigoya', 'drhurtado', 'ngilbert', 'leonard.ruiz00', 'se.alfonso', 'ganeshmashette', 'holapincheputita', 'carlosan98', 'seturizo98', 'lassesodergren', 'cva41', 'deniz.yildirim.ee', 'pharsh800', 'flowdaddy', 'donaldwilliams', 'acostacpaulina', 'sramirezc2', 'theblacktigerultimate', 'dacosta', 'paulinaacostac', 'neiderbarret02', 'jchaparrog10', 'nh747', None, 'haroldsteven013', 'doubrm', 'vitery', 'linhy', 'brb307', 'polania.andres.a', 'humberto3', 'tovar96']"
7,138,80,44,42,"['shaneclarke979', 'ayush17085', 'samyakshukla30', 'varshita15187', 'saurabh17119', 'naina17102', 'sambhav14158', 'vishal17127', 'shivam15177', 'tushar13114', 'nihal17103', 'adityadiundi', 'subhadip17124', 'nishant15151', 'shivendra070993', 'shivangi17121', 'sanket17118', 'sumeet15182', 'pendharkar17108', 'apoorva15130', 'vindhya', 'sameer13140', 'ishit17093', 'shubhangi17123', 'nimish17104', 'saurabh.41093', 'ashwin17083', 'palakurthy13145', 'aankeet14125', 'amogh14134', 'abhilashag', 'ishanbhatia1993', 'snehs', 'vasisht15137', 'vidisha15189', 'aakanksha.singh97', 'bhavna', 'shagun15175', 'piyushgupta955', 'yogesh13171', 'sanketrastogi29', 'rajesh15164']",37,"['yurafif', 'iavalenzuela', 'jahernandez35', 'ffrancees', 'joshdumo', 'aholguin13', 'lasanchez14', 'kerly96sanchez', 'amdelarosa23', 'caglaray92', 'violantium5', 'cjramirez7', 'ok.com.org', 'rarivera7', 'cflores25', 'sarakbazuhair', 'sami36', 'tdhawal1998', 'carloslopezcueto1', 'mmartinez631', 'ed_mq_14', 'aahmed2', 'arpan15132', 'iesalais', 'aldom92', 'yaramirez3', 'odsalazar', 'tupai', 'mmartinez63', 'fdjasf', 'mherrera21', 'sharmine_cute98', 'lesandoval', 'herrera29', 'solrac27', 'robertsifuentes', 'aeron17']",2,"[None, 'sushilsemwalsspl']",81,"['yurafif', 'iavalenzuela', 'ffrancees', 'samyakshukla30', 'joshdumo', 'varshita15187', 'aholguin13', 'lasanchez14', 'kerly96sanchez', 'caglaray92', 'shivam15177', 'nihal17103', 'adityadiundi', 'ok.com.org', 'rarivera7', 'cflores25', 'sumeet15182', 'pendharkar17108', 'apoorva15130', 'vindhya', 'carloslopezcueto1', 'mmartinez631', 'ed_mq_14', 'ishit17093', 'shubhangi17123', 'ashwin17083', 'aldom92', 'odsalazar', 'snehs', 'ishanbhatia1993', 'fdjasf', 'abhilashag', 'vidisha15189', 'bhavna', 'shagun15175', 'piyushgupta955', 'solrac27', 'robertsifuentes', 'sanketrastogi29', 'shaneclarke979', 'ayush17085', 'jahernandez35', 'saurabh17119', 'naina17102', 'amdelarosa23', 'sambhav14158', 'cjramirez7', 'violantium5', 'vishal17127', 'tushar13114', 'subhadip17124', 'nishant15151', 'shivendra070993', 'shivangi17121', 'sanket17118', 'sarakbazuhair', 'sami36', 'tdhawal1998', 'sameer13140', 'aahmed2', 'arpan15132', 'nimish17104', 'saurabh.41093', 'iesalais', 'yaramirez3', 'tupai', 'palakurthy13145', 'mmartinez63', None, 'aankeet14125', 'amogh14134', 'vasisht15137', 'mherrera21', 'sharmine_cute98', 'lesandoval', 'aakanksha.singh97', 'herrera29', 'yogesh13171', 'aeron17', 'sushilsemwalsspl', 'rajesh15164']"
7,142,80,35,25,"['iavalenzuela', 'jahernandez35', 'ffrancees', 'aholguin13', 'lasanchez14', 'amdelarosa23', 'violantium5', 'cjramirez7', 'rarivera7', 'cflores25', 'sami36', 'carloslopezcueto1', 'mmartinez631', 'aahmed2', 'iesalais', 'aldom92', 'yaramirez3', 'odsalazar', 'mmartinez63', 'fdjasf', 'mherrera21', 'lesandoval', 'herrera29', 'robertsifuentes', 'aeron17']",54,"['shaneclarke979', 'yurafif', 'ayush17085', 'samyakshukla30', 'joshdumo', 'varshita15187', 'kerly96sanchez', 'saurabh17119', 'caglaray92', 'naina17102', 'sambhav14158', 'vishal17127', 'shivam15177', 'tushar13114', 'nihal17103', 'adityadiundi', 'subhadip17124', 'ok.com.org', 'nishant15151', 'shivendra070993', 'shivangi17121', 'sanket17118', 'sumeet15182', 'pendharkar17108', 'sarakbazuhair', 'apoorva15130', 'vindhya', 'tdhawal1998', 'sameer13140', 'ed_mq_14', 'ishit17093', 'arpan15132', 'shubhangi17123', 'ashwin17083', 'nimish17104', 'saurabh.41093', 'tupai', 'palakurthy13145', 'aankeet14125', 'snehs', 'amogh14134', 'ishanbhatia1993', 'abhilashag', 'vasisht15137', 'vidisha15189', 'sharmine_cute98', 'aakanksha.singh97', 'bhavna', 'shagun15175', 'piyushgupta955', 'solrac27', 'yogesh13171', 'sanketrastogi29', 'rajesh15164']",10,"['eegomez4', 'eanguianochavez', 'levaleriofrias', 'rmartinez69', 'vidal', 'adelgado36', 'jalapeno512lk', 'gortega90', 'underdahl8', None]",89,"['yurafif', 'eegomez4', 'iavalenzuela', 'ffrancees', 'samyakshukla30', 'joshdumo', 'varshita15187', 'aholguin13', 'lasanchez14', 'kerly96sanchez', 'caglaray92', 'shivam15177', 'nihal17103', 'adityadiundi', 'ok.com.org', 'rarivera7', 'cflores25', 'sumeet15182', 'pendharkar17108', 'apoorva15130', 'jalapeno512lk', 'vindhya', 'carloslopezcueto1', 'mmartinez631', 'ed_mq_14', 'ishit17093', 'shubhangi17123', 'ashwin17083', 'aldom92', 'gortega90', 'odsalazar', 'snehs', 'ishanbhatia1993', 'fdjasf', 'abhilashag', 'vidisha15189', 'bhavna', 'shagun15175', 'piyushgupta955', 'solrac27', 'robertsifuentes', 'sanketrastogi29', 'shaneclarke979', 'ayush17085', 'jahernandez35', 'levaleriofrias', 'saurabh17119', 'naina17102', 'amdelarosa23', 'vidal', 'adelgado36', 'sambhav14158', 'cjramirez7', 'violantium5', 'vishal17127', 'tushar13114', 'underdahl8', 'subhadip17124', 'eanguianochavez', 'nishant15151', 'shivendra070993', 'shivangi17121', 'sanket17118', 'rmartinez69', 'sarakbazuhair', 'sami36', 'tdhawal1998', 'sameer13140', 'aahmed2', 'arpan15132', 'nimish17104', 'saurabh.41093', 'iesalais', 'yaramirez3', 'tupai', 'palakurthy13145', 'mmartinez63', None, 'aankeet14125', 'amogh14134', 'vasisht15137', 'mherrera21', 'sharmine_cute98', 'lesandoval', 'aakanksha.singh97', 'herrera29', 'yogesh13171', 'aeron17', 'rajesh15164']"
8,55,80,73,54,"['syeddanial7', 'abrana', 'fahadali', 'muhammaddawood', 'sabaahmed11', 'kumail49', 'bushranajeeb86', 'mahefatima', 'sohiadeen23', 'mariumr786', 'me89', 'mashaheerzafar400', 'maarijqamar', 'kanwal_ashfaq', 'sheebahashmi0', 'sidrakanwal', 'farkhundahanif', 'saadshakir', 'zohra101', 'abiharizvi', 'mhwajeeh', 'heebazaheer', 'rabia', 'im.zohaib96', 'rabbiaahmed2016', 'qassiashoaib74', 'mahwishkhalil20', 'scorpion3132774171', 'munazzah', 'talha_hilal', 'muneeb1516', 'syedamahrukh', 'asadhk96', 'sabafakhar', 'aflaha10', 'rabbiyanasir', 'asrakhan', 'arishaazam', 'masi123.mr1', 'arooba_jamal', 'abbasgroup', 'maira', 'uroojalam', 'dawar_ijaz', 'moiz95pk', 'sakina.waseem', 'uzma', 'rubabzehra26', 'hassaank98', 'mahnoor', 'fabihasheikh18', 'mahwish653', 'zainulislam47', 'maha_ahmed']",25,"['ncnweb_outreach2', 'alvaronanohub', 'prasanna666pk', 'mohit3013', 'fdelpech', 'dystopic', 'zaq3830', 'pathakprakash1411', 'fdlima', 'xlu1', 'lamabuti', 'bishu', 'myunusozyasar', 'lbassett', 'sehmusozden', 'furkan_aykut93', 'oliveira.sidney96', 'jdverbakel', 'ggaggoosub', 'saniya.jilani6', 'twolfe5', 'schalljd', 'shuovt', 'jpnanomaster', 'sergi.cantos']",19,"['anas.ahm5', 'mairaliaqat', 'haurainsia4', 'musabahmed2', 'ms286611', 'hawkchikna', 'arifmujtaba321', 'bismashaikh26', 'tahashaikh333', 'nmkpt20', 'sabaahmed', 'a.haseeb', None, 'imtiazhira', 'asgharnoor', 'rahima', 'saniamahrukh1998', 'abbymd52', 'bluejeans_umi']",98,"['anas.ahm5', 'ncnweb_outreach2', 'syeddanial7', 'sabaahmed11', 'alvaronanohub', 'ms286611', 'me89', 'sheebahashmi0', 'maarijqamar', 'saadshakir', 'abiharizvi', 'bismashaikh26', 'heebazaheer', 'mhwajeeh', 'rabia', 'dystopic', 'zaq3830', 'pathakprakash1411', 'xlu1', 'lamabuti', 'qassiashoaib74', 'mahwishkhalil20', 'lbassett', 'muneeb1516', 'nmkpt20', 'sehmusozden', 'furkan_aykut93', 'jdverbakel', 'asrakhan', 'arishaazam', 'masi123.mr1', 'arooba_jamal', 'saniya.jilani6', 'imtiazhira', 'maira', 'dawar_ijaz', 'twolfe5', 'uzma', 'saniamahrukh1998', 'abbymd52', 'zohra101', 'fabihasheikh18', 'sabafakhar', 'mahwish653', 'abrana', 'sakina.waseem', 'sergi.cantos', 'bluejeans_umi', 'mairaliaqat', 'fahadali', 'muhammaddawood', 'haurainsia4', 'kumail49', 'bushranajeeb86', 'mahefatima', 'sohiadeen23', 'prasanna666pk', 'mariumr786', 'musabahmed2', 'mashaheerzafar400', 'hawkchikna', 'kanwal_ashfaq', 'farkhundahanif', 'sidrakanwal', 'arifmujtaba321', 'mohit3013', 'fdelpech', 'tahashaikh333', 'im.zohaib96', 'rabbiaahmed2016', 'fdlima', 'bishu', 'myunusozyasar', 'scorpion3132774171', 'munazzah', 'talha_hilal', 'syedamahrukh', 'oliveira.sidney96', 'asadhk96', 'sabaahmed', 'aflaha10', 'rabbiyanasir', 'a.haseeb', 'ggaggoosub', 'abbasgroup', None, 'uroojalam', 'moiz95pk', 'asgharnoor', 'rahima', 'rubabzehra26', 'hassaank98', 'schalljd', 'shuovt', 'mahnoor', 'jpnanomaster', 'zainulislam47', 'maha_ahmed']"
9,179,69,75,62,"['dlee145', 'jarodm2', 'goshan2', 'jiwu2', 'emt2', 'sili5', 'asyang3', 'kph2', 'yusenye2', 'kychui2', 'vfont2', 'myl3', 'amyrm2', 'yoonjae3', 'hahmad7', 'restep2', 'zehuahe2', 'jl49', 'anperry2', 'tjf2', 'juliajh2', 'schoi98', 'kv2', 'aeh2', 'mollyh2', 'scc3', 'yhu55', 'junbaek2', 'baohl2', 'coderko3', 'ckw2', 'kkl3', 'kevins2', 'nsk2', 'mmm4', 'mtobah2', 'rsyuan2', 'sk4', 'aztan2', 'isaxton2', 'jinwoo2', 'mengkem2', 'yiqiaol3', 'icegmtle', 'travisc2', 'garnm2', 'caschwa2', 'bharath3', 'pranjal3', 'donnadc2', 'jillmcar', 'jmjin2', 'ckim123', 'vkm2', 'qz3', 'shwetab2', 'djohns85', 'gxiao2', 'ykoyake2', 'dplata2', 'jes3', 'spangnt2']",6,"['machine', 'yutingliu', 'nosatov2', 'goyage', 'xshen25', 'gse216']",13,"['reishac2', 'allenxg2', 'xzhng125', 'zlevell2', 'tidate2', 'dylanb2', 'tylerjj2', 'vivo2', 'sarahrp2', 'eugenep2', 'aneeshj2', None, 'shim35']",81,"['zlevell2', 'goshan2', 'jiwu2', 'emt2', 'yusenye2', 'sarahrp2', 'yoonjae3', 'zehuahe2', 'anperry2', 'tjf2', 'juliajh2', 'kv2', 'aeh2', 'mollyh2', 'scc3', 'yhu55', 'junbaek2', 'baohl2', 'aztan2', 'xzhng125', 'isaxton2', 'yiqiaol3', 'pranjal3', 'donnadc2', 'jillmcar', 'jmjin2', 'nosatov2', 'goyage', 'gse216', 'djohns85', 'gxiao2', 'ykoyake2', 'aneeshj2', 'jes3', 'allenxg2', 'jarodm2', 'dlee145', 'sili5', 'asyang3', 'kph2', 'kychui2', 'xshen25', 'vfont2', 'tylerjj2', 'myl3', 'amyrm2', 'hahmad7', 'restep2', 'jl49', 'shim35', 'machine', 'yutingliu', 'schoi98', 'tidate2', 'coderko3', 'ckw2', 'kkl3', 'kevins2', 'nsk2', 'mmm4', 'mtobah2', 'vivo2', 'rsyuan2', 'sk4', 'reishac2', 'jinwoo2', 'mengkem2', 'icegmtle', 'travisc2', 'garnm2', 'caschwa2', 'bharath3', 'ckim123', None, 'vkm2', 'qz3', 'dylanb2', 'shwetab2', 'eugenep2', 'dplata2', 'spangnt2']"
10,82,62,37,34,"['zpan12', 'asingh117', 'syang64', 'ssaukhla', 'chenyangli0303', 'liuzhuo2015', 'pli32', 'etchibozo', 'hummerwjl', 'wyang28', 'kv8094', 'ytsai10', 'lzwrhxt', 'xqi11', 'dtiparti', 'y355903682', 'jeremyeliasfriedman', 'kmullin', 'yzhou91', 'fyang', 'mingzhang', 'moralist', 'mluo12', 'wyao8', 'dmurugadass', 'wpan7', 'xiaoguai4u', 'xxiao17', 'nmylavaramsubbaraju7020', 'jli206', 'sma25', 'zwang219', 'bsun24', 'ltinysheep']",27,"['shigueru', 'amitbhowmick_du', 'asholajic', 'mani173', 'mukilvenn', 'antranig16', 'indu.muthancheri', 'mschoelmerich', 'chinyi', 'bwilson5', 'abossen', 'peklan', 'zleng2', 'hhmsama', 'sslana', 'rvigneshkumar0395', 'mahmoudrefaat84', 'zhou297', '59forbes', 'nanoguyciit', 'amitbhowmick.du', 'thinkens', 'im225', 'ngel1914', 'marculius', 'vmeschke', 'chummell']",3,"[None, 'ssengupta3', 'hjia5']",64,"['asingh117', 'shigueru', 'amitbhowmick_du', 'asholajic', 'mani173', 'mukilvenn', 'ssaukhla', 'antranig16', 'liuzhuo2015', 'mschoelmerich', 'pli32', 'hummerwjl', 'wyang28', 'kv8094', 'ytsai10', 'peklan', 'lzwrhxt', 'xqi11', 'zleng2', 'y355903682', 'jeremyeliasfriedman', 'mahmoudrefaat84', 'kmullin', '59forbes', 'ssengupta3', 'nanoguyciit', 'yzhou91', 'fyang', 'mluo12', 'im225', 'ngel1914', 'xiaoguai4u', 'xxiao17', 'jli206', 'vmeschke', 'bsun24', 'chummell', 'ltinysheep', 'zpan12', 'syang64', 'indu.muthancheri', 'chenyangli0303', 'etchibozo', 'chinyi', 'bwilson5', 'abossen', 'dtiparti', 'hhmsama', 'sslana', 'rvigneshkumar0395', 'zhou297', 'amitbhowmick.du', 'mingzhang', 'moralist', 'wyao8', None, 'thinkens', 'dmurugadass', 'wpan7', 'marculius', 'nmylavaramsubbaraju7020', 'hjia5', 'sma25', 'zwang219']"
10,80,62,16,7,"['abossen', 'zhou297', 'vmeschke', 'zleng2', 'sslana', 'chummell', 'thinkens']",54,"['zpan12', 'asingh117', 'shigueru', 'amitbhowmick_du', 'syang64', 'mani173', 'mukilvenn', 'asholajic', 'ssaukhla', 'antranig16', 'indu.muthancheri', 'chenyangli0303', 'liuzhuo2015', 'mschoelmerich', 'pli32', 'chinyi', 'etchibozo', 'hummerwjl', 'wyang28', 'bwilson5', 'kv8094', 'ytsai10', 'peklan', 'lzwrhxt', 'xqi11', 'dtiparti', 'hhmsama', 'y355903682', 'rvigneshkumar0395', 'jeremyeliasfriedman', 'mahmoudrefaat84', 'kmullin', '59forbes', 'nanoguyciit', 'yzhou91', 'amitbhowmick.du', 'fyang', 'mingzhang', 'moralist', 'mluo12', 'wyao8', 'im225', 'dmurugadass', 'wpan7', 'ngel1914', 'xiaoguai4u', 'marculius', 'xxiao17', 'nmylavaramsubbaraju7020', 'jli206', 'sma25', 'zwang219', 'bsun24', 'ltinysheep']",9,"['jgperez2', 'dwu93', 'jrgreaves', 'ncurley', 'alee48', 'alfieri', 'btock', 'huang274', None]",70,"['asingh117', 'shigueru', 'amitbhowmick_du', 'asholajic', 'mani173', 'mukilvenn', 'ssaukhla', 'antranig16', 'liuzhuo2015', 'mschoelmerich', 'pli32', 'hummerwjl', 'wyang28', 'kv8094', 'ytsai10', 'peklan', 'alfieri', 'lzwrhxt', 'xqi11', 'zleng2', 'y355903682', 'jeremyeliasfriedman', 'mahmoudrefaat84', 'ncurley', 'kmullin', '59forbes', 'btock', 'nanoguyciit', 'yzhou91', 'huang274', 'fyang', 'mluo12', 'im225', 'ngel1914', 'jrgreaves', 'xiaoguai4u', 'xxiao17', 'jli206', 'vmeschke', 'bsun24', 'chummell', 'ltinysheep', 'jgperez2', 'zpan12', 'syang64', 'indu.muthancheri', 'chenyangli0303', 'etchibozo', 'chinyi', 'dwu93', 'bwilson5', 'abossen', 'alee48', 'dtiparti', 'hhmsama', 'sslana', 'rvigneshkumar0395', 'zhou297', 'amitbhowmick.du', 'mingzhang', 'moralist', 'wyao8', None, 'thinkens', 'dmurugadass', 'wpan7', 'marculius', 'nmylavaramsubbaraju7020', 'sma25', 'zwang219']"
10,81,62,15,6,"['abossen', 'zhou297', 'vmeschke', 'zleng2', 'chummell', 'thinkens']",55,"['zpan12', 'asingh117', 'shigueru', 'amitbhowmick_du', 'syang64', 'mani173', 'mukilvenn', 'asholajic', 'ssaukhla', 'antranig16', 'indu.muthancheri', 'chenyangli0303', 'liuzhuo2015', 'mschoelmerich', 'pli32', 'chinyi', 'etchibozo', 'hummerwjl', 'wyang28', 'bwilson5', 'kv8094', 'ytsai10', 'peklan', 'lzwrhxt', 'xqi11', 'dtiparti', 'hhmsama', 'sslana', 'y355903682', 'rvigneshkumar0395', 'jeremyeliasfriedman', 'mahmoudrefaat84', 'kmullin', '59forbes', 'nanoguyciit', 'yzhou91', 'amitbhowmick.du', 'fyang', 'mingzhang', 'moralist', 'mluo12', 'wyao8', 'im225', 'dmurugadass', 'wpan7', 'ngel1914', 'xiaoguai4u', 'marculius', 'xxiao17', 'nmylavaramsubbaraju7020', 'jli206', 'sma25', 'zwang219', 'bsun24', 'ltinysheep']",9,"['jgperez2', 'dwu93', 'jrgreaves', 'ncurley', 'alee48', 'alfieri', 'btock', 'huang274', None]",70,"['jgperez2', 'zpan12', 'asingh117', 'shigueru', 'amitbhowmick_du', 'syang64', 'mani173', 'mukilvenn', 'asholajic', 'ssaukhla', 'antranig16', 'indu.muthancheri', 'chenyangli0303', 'liuzhuo2015', 'mschoelmerich', 'pli32', 'etchibozo', 'chinyi', 'hummerwjl', 'wyang28', 'dwu93', 'bwilson5', 'abossen', 'kv8094', 'ytsai10', 'peklan', 'alee48', 'alfieri', 'lzwrhxt', 'xqi11', 'dtiparti', 'hhmsama', 'zleng2', 'sslana', 'y355903682', 'rvigneshkumar0395', 'jeremyeliasfriedman', 'mahmoudrefaat84', 'ncurley', 'kmullin', 'zhou297', 'chummell', '59forbes', 'btock', 'nanoguyciit', 'yzhou91', 'amitbhowmick.du', 'huang274', 'fyang', 'mingzhang', 'moralist', 'mluo12', 'wyao8', 'thinkens', 'im225', 'dmurugadass', None, 'wpan7', 'ngel1914', 'jrgreaves', 'xiaoguai4u', 'marculius', 'xxiao17', 'nmylavaramsubbaraju7020', 'jli206', 'sma25', 'vmeschke', 'zwang219', 'bsun24', 'ltinysheep']"
10,38,62,8,1,['ngel1914'],60,"['zpan12', 'asingh117', 'shigueru', 'amitbhowmick_du', 'syang64', 'mani173', 'mukilvenn', 'asholajic', 'ssaukhla', 'antranig16', 'indu.muthancheri', 'chenyangli0303', 'liuzhuo2015', 'mschoelmerich', 'pli32', 'etchibozo', 'chinyi', 'hummerwjl', 'wyang28', 'bwilson5', 'abossen', 'kv8094', 'ytsai10', 'peklan', 'lzwrhxt', 'xqi11', 'dtiparti', 'hhmsama', 'zleng2', 'sslana', 'y355903682', 'rvigneshkumar0395', 'jeremyeliasfriedman', 'mahmoudrefaat84', 'kmullin', 'zhou297', 'chummell', '59forbes', 'nanoguyciit', 'yzhou91', 'amitbhowmick.du', 'fyang', 'mingzhang', 'moralist', 'mluo12', 'wyao8', 'thinkens', 'im225', 'dmurugadass', 'wpan7', 'xiaoguai4u', 'marculius', 'xxiao17', 'nmylavaramsubbaraju7020', 'jli206', 'sma25', 'vmeschke', 'zwang219', 'bsun24', 'ltinysheep']",7,"['henhaocang', 'kimnananina', 'ghan221', 'niaznasir18', 'j45yin', None, 'hyunjae']",68,"['zpan12', 'asingh117', 'shigueru', 'amitbhowmick_du', 'syang64', 'mani173', 'mukilvenn', 'asholajic', 'ghan221', 'ssaukhla', 'antranig16', 'indu.muthancheri', 'chenyangli0303', 'liuzhuo2015', 'mschoelmerich', 'pli32', 'etchibozo', 'chinyi', 'hummerwjl', 'wyang28', 'hyunjae', 'bwilson5', 'abossen', 'kv8094', 'ytsai10', 'peklan', 'lzwrhxt', 'xqi11', 'j45yin', 'dtiparti', 'hhmsama', 'zleng2', 'sslana', 'y355903682', 'rvigneshkumar0395', 'jeremyeliasfriedman', 'mahmoudrefaat84', 'kmullin', 'zhou297', 'chummell', '59forbes', 'nanoguyciit', 'yzhou91', 'amitbhowmick.du', 'fyang', 'mingzhang', 'moralist', 'mluo12', 'wyao8', 'thinkens', 'im225', 'dmurugadass', None, 'henhaocang', 'wpan7', 'ngel1914', 'kimnananina', 'xiaoguai4u', 'marculius', 'xxiao17', 'nmylavaramsubbaraju7020', 'niaznasir18', 'jli206', 'sma25', 'vmeschke', 'zwang219', 'bsun24', 'ltinysheep']"
11,71,47,36,35,"['congnyu2', 'ewynne2', 'pressna2', 'qiaoyix2', 'ravimalpani', 'dkline2', 'hh7', 'yanz4', 'awaller2', 'kathk15', 'yongdeokkim', 'nnawar2', 'johnb2', 'jeberge2', 'mlyu6', 'jft200', 'nantaoli', 'yiranli6', 'erinkim1019', 'adpatel8', 'munim2', 'srnak2', 'eqi2', 'mm10032', 'tcalder2', 'ayeshaellahi10', 'kirklin2', 'lcgrant3', 'kyang15', 'rpfitzg2', 'rekbot2', 'psoni6', 'szhan114', 'gnadt2', 'alhirsc2']",11,"['rlopez48', 'samuelpgroth', 'shiviokass', 'scottap2', 'arman.tulegenov', 'alitz2', 'blew2', 'aashay.patel1', 'jmbrow11', 'sbhrdwaj', 'michelcascor']",1,[None],47,"['rlopez48', 'congnyu2', 'ewynne2', 'pressna2', 'qiaoyix2', 'dkline2', 'hh7', 'yanz4', 'awaller2', 'kathk15', 'yongdeokkim', 'sbhrdwaj', 'michelcascor', 'arman.tulegenov', 'nantaoli', 'erinkim1019', 'adpatel8', 'shiviokass', 'mm10032', 'scottap2', 'kyang15', 'psoni6', 'szhan114', 'blew2', 'gnadt2', 'alhirsc2', 'ravimalpani', 'jmbrow11', 'nnawar2', 'samuelpgroth', 'johnb2', 'jeberge2', 'mlyu6', 'jft200', 'munim2', 'srnak2', 'eqi2', 'tcalder2', 'ayeshaellahi10', 'aashay.patel1', 'kirklin2', None, 'lcgrant3', 'alitz2', 'rpfitzg2', 'rekbot2', 'yiranli6']"
12,26,46,52,44,"['less76', 'nigel.a', 'larstatum', 'carolinagomez', 'jenngibson', 'kstone1993', 'nguyenbt', 'justindiazuf', 'blueearth2000', 'tylertucker1', 'mglarson', 'canishat', 'dgirard124', 'tburns97', 'acharlot', 'ozzie4297', 'dylannong', 'jlim3538', 'huapva', 'kristjanamanco', 'antural', 'vlusat7', 'kennychiphu', 'tluu3', 'cjdanner', 'harris.ja', 'floresda95', 'd.hamilton', 'mattbuster', 't_mic1', 'argho7x7', 'kennyramos8', 'ehdavis1337', 'rachelpcollins', 'jcrain', 'dluck', 'rjacobse7', 'juliettefr', 'pengzhaozhu', 'zmesscher', 'eugenesg1ddin', 'dmanyaz', 'alexdiaz', 'klai1995']",1,['vera95'],8,"['zhonga4', 'kevinkeller929', 'jsourivongs', 'linglin', 'scorchio36', 'jr8000', 'veraest95', None]",53,"['less76', 'nigel.a', 'carolinagomez', 'jenngibson', 'nguyenbt', 'dgirard124', 'acharlot', 'ozzie4297', 'dylannong', 'vera95', 'kristjanamanco', 'huapva', 'vlusat7', 'kennychiphu', 'tluu3', 'veraest95', 'd.hamilton', 'mattbuster', 'kennyramos8', 'ehdavis1337', 'linglin', 'rjacobse7', 'pengzhaozhu', 'eugenesg1ddin', 'dmanyaz', 'larstatum', 'kevinkeller929', 'scorchio36', 'kstone1993', 'jr8000', 'justindiazuf', 'blueearth2000', 'tylertucker1', 'mglarson', 'zhonga4', 'canishat', 'tburns97', 'jlim3538', 'antural', 'cjdanner', 'harris.ja', None, 'floresda95', 't_mic1', 'argho7x7', 'rachelpcollins', 'jcrain', 'jsourivongs', 'dluck', 'juliettefr', 'zmesscher', 'alexdiaz', 'klai1995']"
12,123,46,43,41,"['less76', 'nigel.a', 'larstatum', 'carolinagomez', 'kstone1993', 'nguyenbt', 'justindiazuf', 'blueearth2000', 'tylertucker1', 'mglarson', 'canishat', 'dgirard124', 'tburns97', 'acharlot', 'ozzie4297', 'dylannong', 'jlim3538', 'huapva', 'kristjanamanco', 'vera95', 'vlusat7', 'kennychiphu', 'cjdanner', 'tluu3', 'harris.ja', 'd.hamilton', 'floresda95', 'mattbuster', 't_mic1', 'argho7x7', 'rachelpcollins', 'ehdavis1337', 'kennyramos8', 'jcrain', 'rjacobse7', 'zmesscher', 'pengzhaozhu', 'eugenesg1ddin', 'dmanyaz', 'alexdiaz', 'klai1995']",4,"['antural', 'jenngibson', 'dluck', 'juliettefr']",2,"[None, 'linglin']",47,"['less76', 'nigel.a', 'carolinagomez', 'jenngibson', 'nguyenbt', 'dgirard124', 'acharlot', 'ozzie4297', 'dylannong', 'vera95', 'kristjanamanco', 'huapva', 'vlusat7', 'kennychiphu', 'tluu3', 'd.hamilton', 'mattbuster', 'kennyramos8', 'ehdavis1337', 'linglin', 'rjacobse7', 'pengzhaozhu', 'eugenesg1ddin', 'dmanyaz', 'larstatum', 'kstone1993', 'justindiazuf', 'blueearth2000', 'tylertucker1', 'mglarson', 'canishat', 'tburns97', 'jlim3538', 'antural', 'cjdanner', 'harris.ja', None, 'floresda95', 't_mic1', 'argho7x7', 'rachelpcollins', 'jcrain', 'dluck', 'juliettefr', 'zmesscher', 'alexdiaz', 'klai1995']"
12,228,46,43,39,"['less76', 'nigel.a', 'larstatum', 'carolinagomez', 'jenngibson', 'nguyenbt', 'justindiazuf', 'blueearth2000', 'tylertucker1', 'mglarson', 'canishat', 'dgirard124', 'tburns97', 'acharlot', 'ozzie4297', 'jlim3538', 'huapva', 'kristjanamanco', 'antural', 'vlusat7', 'kennychiphu', 'cjdanner', 'tluu3', 'harris.ja', 'd.hamilton', 'mattbuster', 'argho7x7', 'rachelpcollins', 'ehdavis1337', 'kennyramos8', 'jcrain', 'dluck', 'zmesscher', 'pengzhaozhu', 'juliettefr', 'eugenesg1ddin', 'dmanyaz', 'alexdiaz', 'klai1995']",6,"['vera95', 't_mic1', 'rjacobse7', 'kstone1993', 'dylannong', 'floresda95']",4,"['jsourivongs', None, 'rjacobse', 'zhonga4']",49,"['less76', 'nigel.a', 'carolinagomez', 'jenngibson', 'nguyenbt', 'dgirard124', 'acharlot', 'ozzie4297', 'dylannong', 'vera95', 'kristjanamanco', 'huapva', 'vlusat7', 'kennychiphu', 'tluu3', 'd.hamilton', 'mattbuster', 'kennyramos8', 'ehdavis1337', 'rjacobse7', 'pengzhaozhu', 'eugenesg1ddin', 'dmanyaz', 'larstatum', 'kstone1993', 'justindiazuf', 'blueearth2000', 'tylertucker1', 'mglarson', 'zhonga4', 'canishat', 'tburns97', 'jlim3538', 'antural', 'cjdanner', 'harris.ja', None, 'floresda95', 't_mic1', 'rjacobse', 'argho7x7', 'rachelpcollins', 'jcrain', 'jsourivongs', 'dluck', 'juliettefr', 'zmesscher', 'alexdiaz', 'klai1995']"
12,229,46,24,21,"['less76', 'carolinagomez', 'blueearth2000', 'tylertucker1', 'mglarson', 'tburns97', 'dylannong', 'kristjanamanco', 'kennychiphu', 'cjdanner', 'floresda95', 'd.hamilton', 'mattbuster', 't_mic1', 'rachelpcollins', 'jcrain', 'dluck', 'rjacobse7', 'juliettefr', 'pengzhaozhu', 'eugenesg1ddin']",24,"['nigel.a', 'larstatum', 'jenngibson', 'kstone1993', 'nguyenbt', 'justindiazuf', 'canishat', 'dgirard124', 'acharlot', 'ozzie4297', 'jlim3538', 'vera95', 'huapva', 'antural', 'vlusat7', 'tluu3', 'harris.ja', 'argho7x7', 'kennyramos8', 'ehdavis1337', 'zmesscher', 'dmanyaz', 'alexdiaz', 'klai1995']",3,"['scorchio36', None, 'zhonga4']",48,"['less76', 'nigel.a', 'larstatum', 'carolinagomez', 'scorchio36', 'jenngibson', 'kstone1993', 'nguyenbt', 'justindiazuf', 'blueearth2000', 'tylertucker1', 'mglarson', 'zhonga4', 'canishat', 'dgirard124', 'tburns97', 'acharlot', 'ozzie4297', 'dylannong', 'jlim3538', 'vera95', 'kristjanamanco', 'huapva', 'antural', 'vlusat7', 'kennychiphu', 'tluu3', 'cjdanner', 'harris.ja', None, 'floresda95', 'd.hamilton', 'mattbuster', 't_mic1', 'argho7x7', 'kennyramos8', 'ehdavis1337', 'rachelpcollins', 'jcrain', 'dluck', 'rjacobse7', 'juliettefr', 'pengzhaozhu', 'zmesscher', 'eugenesg1ddin', 'dmanyaz', 'alexdiaz', 'klai1995']"
13,111,40,37,34,"['pobila', 'abasiri1', 'danielehmann24', 'radelacr', 'malhadad', 'kfalmuta', 'africks', 'dasuncio', 'jdclar17', 'thieb', 'avilla09', 'ccarpen7', 'kbwiens', 'jmroger8', 'wangkaiyi0801', 'guitargod85296', 'jcoin', 'kelchen111', 'dnguye31', 'lddavis6', 'rcw82335448', 'wmcheung', 'yansijie5jimmy', 'lbrist', 'tsforman', 'banigl', 'liviangels97', 'laytondd', 'bwatson8', 'wildline', 'sdornbie', 'nvorach1', 'cdluesang', 'dwildens']",5,"['naddamig', 'srisweth557', 'onlineassig', 'mwambamwenda', 'jmpatte8']",3,"['halmukht', None, 'ljohns69']",42,"['srisweth557', 'pobila', 'abasiri1', 'danielehmann24', 'dwildens', 'radelacr', 'malhadad', 'kfalmuta', 'africks', 'jdclar17', 'dasuncio', 'thieb', 'avilla09', 'ccarpen7', 'onlineassig', 'kbwiens', 'jmroger8', 'wangkaiyi0801', 'guitargod85296', 'jcoin', 'kelchen111', 'dnguye31', None, 'lddavis6', 'rcw82335448', 'wmcheung', 'naddamig', 'yansijie5jimmy', 'lbrist', 'mwambamwenda', 'laytondd', 'tsforman', 'liviangels97', 'banigl', 'halmukht', 'wildline', 'ljohns69', 'sdornbie', 'nvorach1', 'jmpatte8', 'cdluesang', 'bwatson8']"
13,35,40,31,26,"['srisweth557', 'pobila', 'dwildens', 'radelacr', 'malhadad', 'kfalmuta', 'africks', 'jdclar17', 'avilla09', 'ccarpen7', 'kbwiens', 'wangkaiyi0801', 'guitargod85296', 'kelchen111', 'dnguye31', 'lddavis6', 'rcw82335448', 'yansijie5jimmy', 'lbrist', 'laytondd', 'banigl', 'liviangels97', 'sdornbie', 'nvorach1', 'cdluesang', 'bwatson8']",13,"['wmcheung', 'naddamig', 'onlineassig', 'dasuncio', 'jmroger8', 'thieb', 'mwambamwenda', 'abasiri1', 'danielehmann24', 'tsforman', 'wildline', 'jcoin', 'jmpatte8']",5,"['halmukht', 'cheetha94607', 'gsingh26', 'magonz39', None]",44,"['srisweth557', 'pobila', 'abasiri1', 'danielehmann24', 'dwildens', 'cheetha94607', 'radelacr', 'magonz39', 'malhadad', 'kfalmuta', 'africks', 'jdclar17', 'dasuncio', 'thieb', 'avilla09', 'ccarpen7', 'onlineassig', 'kbwiens', 'jmroger8', 'wangkaiyi0801', 'guitargod85296', 'gsingh26', 'jcoin', 'kelchen111', 'dnguye31', None, 'lddavis6', 'rcw82335448', 'wmcheung', 'naddamig', 'yansijie5jimmy', 'lbrist', 'mwambamwenda', 'laytondd', 'tsforman', 'liviangels97', 'banigl', 'wildline', 'halmukht', 'sdornbie', 'nvorach1', 'jmpatte8', 'cdluesang', 'bwatson8']"
13,34,40,25,19,"['pobila', 'abasiri1', 'danielehmann24', 'radelacr', 'dasuncio', 'thieb', 'avilla09', 'ccarpen7', 'jmroger8', 'jcoin', 'dnguye31', 'naddamig', 'lbrist', 'tsforman', 'wildline', 'sdornbie', 'nvorach1', 'cdluesang', 'bwatson8']",20,"['srisweth557', 'malhadad', 'kfalmuta', 'africks', 'jdclar17', 'onlineassig', 'kbwiens', 'wangkaiyi0801', 'guitargod85296', 'kelchen111', 'lddavis6', 'rcw82335448', 'wmcheung', 'yansijie5jimmy', 'mwambamwenda', 'laytondd', 'banigl', 'liviangels97', 'jmpatte8', 'dwildens']",6,"['rrking', None, 'halmukht', 'gsingh26', 'magonz39', 'cdluesan']",45,"['srisweth557', 'pobila', 'abasiri1', 'danielehmann24', 'dwildens', 'radelacr', 'magonz39', 'cdluesan', 'malhadad', 'kfalmuta', 'africks', 'jdclar17', 'dasuncio', 'thieb', 'avilla09', 'rrking', 'ccarpen7', 'onlineassig', 'kbwiens', 'jmroger8', 'wangkaiyi0801', 'guitargod85296', 'gsingh26', 'jcoin', 'kelchen111', 'dnguye31', None, 'lddavis6', 'rcw82335448', 'wmcheung', 'naddamig', 'yansijie5jimmy', 'lbrist', 'mwambamwenda', 'laytondd', 'tsforman', 'liviangels97', 'banigl', 'wildline', 'halmukht', 'sdornbie', 'nvorach1', 'jmpatte8', 'cdluesang', 'bwatson8']"
14,1,39,43,38,"['rushaimb', 'robert.t.mastey', 'valentjg', 'brownmg2', 'coopea3', 'ryan.c.holman', 'mohdfan', 'scherpkl', 'sherkst', 'samdrn45', 'bremnej', 'yostjg', 'stilsota', 'linng1', 'jon_mcgahee', 'coirodl', 'edwarddb', 'leeea2', 'pinneya', 'apreston1', 'aliyazdani1997', 'harrisonyct', 'silverlr', 'sentilmj', 'johnsmc2', 'crawforc', 'chasonar', 'roslin', 'majumdkr', 'stsai19', 'oseibw', 'smita22', 'brianrider156', 'millep2', 'alexroed', 'gustaver', 'liucl', 'romanc1']",0,[],5,"['tarij', 'gw014425', 'corners1', 'crispeds', None]",43,"['rushaimb', 'brownmg2', 'mohdfan', 'scherpkl', 'sherkst', 'samdrn45', 'crispeds', 'stilsota', 'linng1', 'jon_mcgahee', 'leeea2', 'pinneya', 'apreston1', 'aliyazdani1997', 'harrisonyct', 'gw014425', 'johnsmc2', 'crawforc', 'tarij', 'alexroed', 'robert.t.mastey', 'corners1', 'valentjg', 'coopea3', 'ryan.c.holman', 'bremnej', 'yostjg', 'coirodl', 'edwarddb', 'silverlr', 'sentilmj', None, 'chasonar', 'roslin', 'majumdkr', 'stsai19', 'oseibw', 'smita22', 'brianrider156', 'millep2', 'gustaver', 'liucl', 'romanc1']"
15,276,39,90,18,"['sahil709', 'atul', 'veronicathapa56', 'ashishghoderao', 'mhatrenrupal42', 'niharmasurkar', 'pritijha1996', 'sumitpatil512', 'sonali.ramji', 'preethinaik', 'ninadmandavkar29', 'yogeshmaurya50', 'nishigandhaprsd14', 'sendpost2mahesh', 'pandeydeepak825', 'surbhib2897', 'hborse28', 'rushikeshsalgar123']",20,"['pranittambde', 'siddhu.murkar', 'goreravindra95', 'prasad.creativity123', 'pratikpawar4996', 'tusharvan', 'salianyatish111', 'amritamukeshb', 'jayshreepakhare63', 'santoshiparab11', 'snehaspm1397', 'siddhantwarankar', 'bhamghodke7', 'jr.abishek00', 'ameykokate2015', 'shivanilohar55', 'shirsekarakash', 'rahul2011star', 'karishmahirve96', 'adityagudla96']",72,"['rajeshree.kumbhar5018', 'gaurav.mishra', 'vivekrana', 'manjarekarchinmayeen', 'sumitmhatre5670', 'riddhi737', 'ronak.tiwari', 'apurvawaghmode14', 'sanchitkad', 'bhandarinirali57', 'rasikapotdar2108', 'bhagyashrimali280497', 'aishuauti20496', 'adnan.s', 'ritik.singh', 'mihirgogri613', 'prerana.goythale', 'sarika_bukkawar', 'lekhakande', 'pratibhagawari28', 'shweta.joglekar', 'nirav.lm', 'mounikajalla99', 'anitadey12', 'puranikatharva', 'mayurgonbare22', 'bonhomie11', 'bhushan9321', 'vishalnaik.0210', 'prathamesh.nikam', 'harishkumar.n', 'rohan.mestry', 'sanketmane1997.sm', 'dhavit.v', 'shirishparkhe', 'dleena19961209', 'krunal.kasar', 'yuvraj.t', 'akshay1997bhagit', 'sid.jagtap1992', 'maneaniket', 'siddheshgothankar', 'shraddhasam78', 'richitapatil', 'yashuishwar', 'atulkokane1234', 'electronics209', 'raj.vadariya', 'paromita24', 'niveditachaudhari', 'trambakesh97', 'neonargon5', 'sarika', 'ayesha.pathan', 'digvijayjadeja725', 'shrey.joshi', 'bgharat713', 'mayank.vp', 'nehamallan', 'snehalpatil', 'rajesh05', None, 'ameyc007', 'shreyas.v', 'neelamt', 'amarravade31', 'podililaxmi30', 'patiltejas000003', 'divyassingh56', 'akshatamahajan47', 'shraddha.dhage', 'mithilagajarmal']",110,"['rajeshree.kumbhar5018', 'sanchitkad', 'aishuauti20496', 'shweta.joglekar', 'goreravindra95', 'puranikatharva', 'bhushan9321', 'vishalnaik.0210', 'tusharvan', 'shirishparkhe', 'salianyatish111', 'sendpost2mahesh', 'surbhib2897', 'shraddhasam78', 'jayshreepakhare63', 'atul', 'paromita24', 'niveditachaudhari', 'mhatrenrupal42', 'neonargon5', 'digvijayjadeja725', 'nehamallan', 'bhamghodke7', 'shivanilohar55', 'sahil709', 'neelamt', 'amarravade31', 'akshatamahajan47', 'yogeshmaurya50', 'riddhi737', 'niharmasurkar', 'apurvawaghmode14', 'bhandarinirali57', 'pratibhagawari28', 'nirav.lm', 'mayurgonbare22', 'prasad.creativity123', 'sonali.ramji', 'dleena19961209', 'yuvraj.t', 'akshay1997bhagit', 'amritamukeshb', 'trambakesh97', 'sarika', 'pritijha1996', 'preethinaik', 'rajesh05', None, 'podililaxmi30', 'divyassingh56', 'hborse28', 'adityagudla96', 'mithilagajarmal', 'pranittambde', 'ashishghoderao', 'sumitmhatre5670', 'ronak.tiwari', 'rasikapotdar2108', 'adnan.s', 'ritik.singh', 'prerana.goythale', 'pandeydeepak825', 'mounikajalla99', 'bonhomie11', 'prathamesh.nikam', 'harishkumar.n', 'sanketmane1997.sm', 'krunal.kasar', 'sid.jagtap1992', 'richitapatil', 'yashuishwar', 'siddhantwarankar', 'ayesha.pathan', 'shrey.joshi', 'ninadmandavkar29', 'nishigandhaprsd14', 'rushikeshsalgar123', 'ameykokate2015', 'ameyc007', 'patiltejas000003', 'rahul2011star', 'karishmahirve96', 'gaurav.mishra', 'vivekrana', 'manjarekarchinmayeen', 'bhagyashrimali280497', 'mihirgogri613', 'siddhu.murkar', 'sarika_bukkawar', 'lekhakande', 'anitadey12', 'rohan.mestry', 'dhavit.v', 'pratikpawar4996', 'sumitpatil512', 'maneaniket', 'siddheshgothankar', 'santoshiparab11', 'atulkokane1234', 'snehaspm1397', 'electronics209', 'raj.vadariya', 'bgharat713', 'mayank.vp', 'jr.abishek00', 'snehalpatil', 'shreyas.v', 'veronicathapa56', 'shirsekarakash', 'shraddha.dhage']"
15,269,39,75,20,"['ashishghoderao', 'niharmasurkar', 'pandeydeepak825', 'sumitpatil512', 'sonali.ramji', 'adityagudla96', 'sendpost2mahesh', 'surbhib2897', 'jayshreepakhare63', 'atul', 'mhatrenrupal42', 'pritijha1996', 'preethinaik', 'ninadmandavkar29', 'nishigandhaprsd14', 'rushikeshsalgar123', 'sahil709', 'veronicathapa56', 'yogeshmaurya50', 'hborse28']",18,"['pranittambde', 'santoshiparab11', 'snehaspm1397', 'goreravindra95', 'salianyatish111', 'siddhantwarankar', 'prasad.creativity123', 'shirsekarakash', 'rahul2011star', 'pratikpawar4996', 'tusharvan', 'karishmahirve96', 'bhamghodke7', 'jr.abishek00', 'siddhu.murkar', 'ameykokate2015', 'amritamukeshb', 'shivanilohar55']",55,"['rajeshree.kumbhar5018', 'palakchheda2407', 'mbhosale863', 'manjarekarchinmayeen', 'sumitmhatre5670', 'ashwinipardeshi702', 'ronak.tiwari', 'riddhi737', 'sanchitkad', 'bhandarinirali57', 'rasikapotdar2108', 'mihirgogri613', 'aishuauti20496', 'lekhakande', 'pratibhagawari28', 'anitadey12', 'ab17', 'puranikatharva', 'prathamesh.nikam', 'bhushan9321', 'mayurgonbare22', 'maneaniket', 'siddheshgothankar', 'dleena19961209', 'sid.jagtap1992', 'shraddhasam78', 'abhijaypandey', 'dilip.wakdikar', 'bolekunal42', 'trambakesh97', 'neonargon5', 'riyakulkarni16021997', 'ayesha.pathan', 'brarath.nihal', 'bgharat713', 'abhishek2397', 'ganeshjadhav', 'bhaveshsawant1996', 'sanket.mane', 'snehalpatil', 'rajesh05', 'ksanket025', None, 'dusty', 'rahul.sawant', 'neelamt', 's.arutwar', 'sudar', 'prashant.khedkar', 'shreekantrasam69', 'vishal8244', 'shraddha.dhage', 'ganesh.mali', 'kavusatose123', 'mithilagajarmal']",93,"['pranittambde', 'rajeshree.kumbhar5018', 'palakchheda2407', 'mbhosale863', 'ashishghoderao', 'sumitmhatre5670', 'ashwinipardeshi702', 'ronak.tiwari', 'sanchitkad', 'rasikapotdar2108', 'aishuauti20496', 'pandeydeepak825', 'goreravindra95', 'puranikatharva', 'prathamesh.nikam', 'bhushan9321', 'tusharvan', 'adityagudla96', 'salianyatish111', 'sendpost2mahesh', 'sid.jagtap1992', 'surbhib2897', 'shraddhasam78', 'jayshreepakhare63', 'atul', 'bolekunal42', 'mhatrenrupal42', 'siddhantwarankar', 'neonargon5', 'ayesha.pathan', 'ninadmandavkar29', 'abhishek2397', 'bhamghodke7', 'nishigandhaprsd14', 'bhaveshsawant1996', 'rushikeshsalgar123', 'shivanilohar55', 'sahil709', 'ameykokate2015', 'dusty', 'neelamt', 'sudar', 'shreekantrasam69', 'rahul2011star', 'karishmahirve96', 'yogeshmaurya50', 'kavusatose123', 'manjarekarchinmayeen', 'riddhi737', 'niharmasurkar', 'bhandarinirali57', 'mihirgogri613', 'siddhu.murkar', 'lekhakande', 'pratibhagawari28', 'ab17', 'anitadey12', 'mayurgonbare22', 'prasad.creativity123', 'pratikpawar4996', 'sonali.ramji', 'sumitpatil512', 'maneaniket', 'siddheshgothankar', 'dleena19961209', 'amritamukeshb', 'santoshiparab11', 'snehaspm1397', 'abhijaypandey', 'dilip.wakdikar', 'trambakesh97', 'riyakulkarni16021997', 'pritijha1996', 'brarath.nihal', 'bgharat713', 'preethinaik', 'ganeshjadhav', 'sanket.mane', 'jr.abishek00', 'snehalpatil', 'rajesh05', 'ksanket025', None, 'veronicathapa56', 'rahul.sawant', 's.arutwar', 'prashant.khedkar', 'shirsekarakash', 'vishal8244', 'shraddha.dhage', 'hborse28', 'ganesh.mali', 'mithilagajarmal']"
15,275,39,59,23,"['pranittambde', 'ashishghoderao', 'siddhu.murkar', 'goreravindra95', 'prasad.creativity123', 'pratikpawar4996', 'tusharvan', 'sonali.ramji', 'salianyatish111', 'surbhib2897', 'amritamukeshb', 'jayshreepakhare63', 'santoshiparab11', 'snehaspm1397', 'siddhantwarankar', 'bhamghodke7', 'jr.abishek00', 'ameykokate2015', 'shivanilohar55', 'shirsekarakash', 'rahul2011star', 'karishmahirve96', 'adityagudla96']",15,"['sahil709', 'atul', 'veronicathapa56', 'mhatrenrupal42', 'niharmasurkar', 'pritijha1996', 'sumitpatil512', 'preethinaik', 'ninadmandavkar29', 'yogeshmaurya50', 'nishigandhaprsd14', 'sendpost2mahesh', 'pandeydeepak825', 'hborse28', 'rushikeshsalgar123']",36,"['tejas7', 'siddhant319', 'divekarpragati7', 'abhishekv.1100', 'divujagushte26', 'ngmahajan1', 'nimishakurup857', 'sawardekarsuyash97', 'priyankaingle18', 'bonhomie11', 'chinmaysj96', 'narvekarsushant0', 'prasad24shingade', 'akshay1997bhagit', 'sinalkarshweta5', 'sanketdamame', 'dkgupata9768522176', 'sayali_m9', 'rutvikstar', 'priyaj1235', 'rohitwaghmare1997', 'navneet.nrj', 'theindianpacifist', None, 'ranegirish24', 'pankajpawar1515', 'sgharat297', 'satsamjr', 'dipsbhalekar', 'vedankasalunke96', 'aartibhalerao29', 'k.vekhande69', 'kshemkalyanimanjiri11', 'aniruddhaparte3', 'madhuranasare', 'kavusatose123']",74,"['pranittambde', 'ashishghoderao', 'divujagushte26', 'ngmahajan1', 'nimishakurup857', 'pandeydeepak825', 'priyankaingle18', 'goreravindra95', 'bonhomie11', 'tusharvan', 'adityagudla96', 'salianyatish111', 'sendpost2mahesh', 'surbhib2897', 'jayshreepakhare63', 'atul', 'mhatrenrupal42', 'siddhantwarankar', 'navneet.nrj', 'ninadmandavkar29', 'bhamghodke7', 'nishigandhaprsd14', 'rushikeshsalgar123', 'shivanilohar55', 'sahil709', 'ameykokate2015', 'ranegirish24', 'pankajpawar1515', 'satsamjr', 'dipsbhalekar', 'aartibhalerao29', 'kshemkalyanimanjiri11', 'rahul2011star', 'aniruddhaparte3', 'karishmahirve96', 'yogeshmaurya50', 'kavusatose123', 'tejas7', 'siddhant319', 'divekarpragati7', 'abhishekv.1100', 'niharmasurkar', 'siddhu.murkar', 'sawardekarsuyash97', 'prasad.creativity123', 'chinmaysj96', 'narvekarsushant0', 'prasad24shingade', 'pratikpawar4996', 'sonali.ramji', 'sumitpatil512', 'akshay1997bhagit', 'amritamukeshb', 'sinalkarshweta5', 'santoshiparab11', 'snehaspm1397', 'sanketdamame', 'dkgupata9768522176', 'sayali_m9', 'rutvikstar', 'priyaj1235', 'rohitwaghmare1997', 'pritijha1996', 'preethinaik', 'jr.abishek00', 'theindianpacifist', None, 'veronicathapa56', 'sgharat297', 'vedankasalunke96', 'shirsekarakash', 'k.vekhande69', 'hborse28', 'madhuranasare']"
15,268,39,42,18,"['pranittambde', 'santoshiparab11', 'snehaspm1397', 'goreravindra95', 'surbhib2897', 'salianyatish111', 'siddhantwarankar', 'shirsekarakash', 'rahul2011star', 'pratikpawar4996', 'tusharvan', 'sonali.ramji', 'bhamghodke7', 'jr.abishek00', 'siddhu.murkar', 'amritamukeshb', 'adityagudla96', 'shivanilohar55']",20,"['ashishghoderao', 'niharmasurkar', 'pandeydeepak825', 'prasad.creativity123', 'sumitpatil512', 'sendpost2mahesh', 'jayshreepakhare63', 'atul', 'mhatrenrupal42', 'pritijha1996', 'preethinaik', 'ninadmandavkar29', 'nishigandhaprsd14', 'rushikeshsalgar123', 'ameykokate2015', 'sahil709', 'veronicathapa56', 'karishmahirve96', 'yogeshmaurya50', 'hborse28']",24,"['tejas7', 'siddhant319', 'sarvesh107', 'sawardekarsuyash97', 'priyankaingle18', 'mounikajalla99', 'shreya9609', 'bonhomie11', 'chinmaysj96', 'narvekarsushant0', 'prasad24shingade', 'sinalkarshweta5', 'dkgupata9768522176', 'vrushalithakare82', 'navneet.nrj', None, 'ranegirish24', 'pankajpawar1515', 'satsamjr', 'vedankasalunke96', 'aartibhalerao29', 'vinayak183', 'aniruddhaparte3', 'kavusatose123']",62,"['pranittambde', 'ashishghoderao', 'sarvesh107', 'pandeydeepak825', 'priyankaingle18', 'mounikajalla99', 'shreya9609', 'goreravindra95', 'bonhomie11', 'tusharvan', 'adityagudla96', 'salianyatish111', 'sendpost2mahesh', 'surbhib2897', 'jayshreepakhare63', 'atul', 'mhatrenrupal42', 'siddhantwarankar', 'vrushalithakare82', 'navneet.nrj', 'ninadmandavkar29', 'bhamghodke7', 'nishigandhaprsd14', 'rushikeshsalgar123', 'shivanilohar55', 'sahil709', 'ameykokate2015', 'ranegirish24', 'pankajpawar1515', 'satsamjr', 'aartibhalerao29', 'vinayak183', 'rahul2011star', 'aniruddhaparte3', 'karishmahirve96', 'yogeshmaurya50', 'kavusatose123', 'tejas7', 'siddhant319', 'niharmasurkar', 'siddhu.murkar', 'sawardekarsuyash97', 'prasad.creativity123', 'chinmaysj96', 'narvekarsushant0', 'prasad24shingade', 'pratikpawar4996', 'sonali.ramji', 'sumitpatil512', 'amritamukeshb', 'sinalkarshweta5', 'santoshiparab11', 'snehaspm1397', 'dkgupata9768522176', 'pritijha1996', 'preethinaik', 'jr.abishek00', None, 'veronicathapa56', 'vedankasalunke96', 'shirsekarakash', 'hborse28']"
15,267,39,31,7,"['sahil709', 'niharmasurkar', 'pritijha1996', 'ninadmandavkar29', 'yogeshmaurya50', 'pandeydeepak825', 'rushikeshsalgar123']",31,"['pranittambde', 'ashishghoderao', 'siddhu.murkar', 'goreravindra95', 'prasad.creativity123', 'pratikpawar4996', 'tusharvan', 'sonali.ramji', 'sumitpatil512', 'adityagudla96', 'salianyatish111', 'sendpost2mahesh', 'surbhib2897', 'amritamukeshb', 'jayshreepakhare63', 'santoshiparab11', 'snehaspm1397', 'atul', 'mhatrenrupal42', 'siddhantwarankar', 'preethinaik', 'bhamghodke7', 'nishigandhaprsd14', 'jr.abishek00', 'shivanilohar55', 'ameykokate2015', 'veronicathapa56', 'shirsekarakash', 'rahul2011star', 'karishmahirve96', 'hborse28']",24,"['rajeshree.kumbhar5018', 'sampadaphatak28', 'ani.date23', 'mbhosale863', 'bhandarinirali57', 'puranikatharva', 'mayurgonbare22', 'imdevendra258', 'maneaniket', 'shirishparkhe', 'pawargeeta177', 'dilip.wakdikar', 'bolekunal42', 'trambakesh97', 'madhuri.thosare13', 'abhishek2397', 'ganeshjadhav', None, 'dusty', 'prashant.khedkar', 'subodhsawant07', 'sudar', 'panditkunal98', 'vishal8244']",62,"['pranittambde', 'rajeshree.kumbhar5018', 'sampadaphatak28', 'ani.date23', 'mbhosale863', 'ashishghoderao', 'niharmasurkar', 'bhandarinirali57', 'hborse28', 'siddhu.murkar', 'pandeydeepak825', 'goreravindra95', 'puranikatharva', 'mayurgonbare22', 'prasad.creativity123', 'imdevendra258', 'pratikpawar4996', 'tusharvan', 'sonali.ramji', 'sumitpatil512', 'maneaniket', 'shirishparkhe', 'salianyatish111', 'sendpost2mahesh', 'pawargeeta177', 'amritamukeshb', 'surbhib2897', 'jayshreepakhare63', 'santoshiparab11', 'snehaspm1397', 'atul', 'dilip.wakdikar', 'bolekunal42', 'mhatrenrupal42', 'siddhantwarankar', 'trambakesh97', 'madhuri.thosare13', 'pritijha1996', 'preethinaik', 'ninadmandavkar29', 'bhamghodke7', 'nishigandhaprsd14', 'jr.abishek00', 'abhishek2397', 'ganeshjadhav', None, 'rushikeshsalgar123', 'shivanilohar55', 'sahil709', 'ameykokate2015', 'dusty', 'veronicathapa56', 'prashant.khedkar', 'subodhsawant07', 'sudar', 'panditkunal98', 'shirsekarakash', 'vishal8244', 'rahul2011star', 'karishmahirve96', 'yogeshmaurya50', 'adityagudla96']"
15,266,39,30,6,"['ashishghoderao', 'prasad.creativity123', 'karishmahirve96', 'salianyatish111', 'jayshreepakhare63', 'ameykokate2015']",32,"['pranittambde', 'niharmasurkar', 'siddhu.murkar', 'pandeydeepak825', 'goreravindra95', 'pratikpawar4996', 'tusharvan', 'sonali.ramji', 'sumitpatil512', 'adityagudla96', 'sendpost2mahesh', 'surbhib2897', 'amritamukeshb', 'santoshiparab11', 'snehaspm1397', 'atul', 'mhatrenrupal42', 'siddhantwarankar', 'pritijha1996', 'preethinaik', 'ninadmandavkar29', 'bhamghodke7', 'nishigandhaprsd14', 'jr.abishek00', 'rushikeshsalgar123', 'shivanilohar55', 'sahil709', 'veronicathapa56', 'shirsekarakash', 'rahul2011star', 'yogeshmaurya50', 'hborse28']",24,"['vallabhbudhkar', 'sarvesh107', 'sarveshbhoer158', 'pranaybhatkar', 'shreya9609', 'ronraviram789', 'pritesh.roy27', 'bonhomie11', 'deshpande192', 'yashpimpale6', 'dipikapatil097', 'nikamsupriya44', 'apurvaganu1996', 'sanketdamame', 'rincyj327', 'rohitwaghmare1997', 'navneet.nrj', 'dwivedidaya1996', None, 'rawatchefchetan', 'vinayak183', 'rashmithanair5', 'mitalihaldankar8', 'shreyasgawali123']",62,"['pranittambde', 'vallabhbudhkar', 'ashishghoderao', 'sarveshbhoer158', 'sarvesh107', 'niharmasurkar', 'pranaybhatkar', 'hborse28', 'siddhu.murkar', 'pandeydeepak825', 'shreya9609', 'ronraviram789', 'goreravindra95', 'pritesh.roy27', 'bonhomie11', 'prasad.creativity123', 'deshpande192', 'pratikpawar4996', 'tusharvan', 'sonali.ramji', 'sumitpatil512', 'yashpimpale6', 'dipikapatil097', 'salianyatish111', 'sendpost2mahesh', 'nikamsupriya44', 'amritamukeshb', 'surbhib2897', 'jayshreepakhare63', 'santoshiparab11', 'apurvaganu1996', 'snehaspm1397', 'atul', 'sanketdamame', 'rincyj327', 'rohitwaghmare1997', 'mhatrenrupal42', 'siddhantwarankar', 'pritijha1996', 'navneet.nrj', 'preethinaik', 'ninadmandavkar29', 'bhamghodke7', 'nishigandhaprsd14', 'jr.abishek00', 'dwivedidaya1996', None, 'rushikeshsalgar123', 'shivanilohar55', 'sahil709', 'ameykokate2015', 'rawatchefchetan', 'mitalihaldankar8', 'veronicathapa56', 'shirsekarakash', 'vinayak183', 'rahul2011star', 'karishmahirve96', 'rashmithanair5', 'yogeshmaurya50', 'adityagudla96', 'shreyasgawali123']"
15,58,39,19,1,['preethinaik'],37,"['pranittambde', 'ashishghoderao', 'niharmasurkar', 'siddhu.murkar', 'pandeydeepak825', 'goreravindra95', 'prasad.creativity123', 'pratikpawar4996', 'tusharvan', 'sonali.ramji', 'sumitpatil512', 'adityagudla96', 'salianyatish111', 'sendpost2mahesh', 'surbhib2897', 'amritamukeshb', 'jayshreepakhare63', 'santoshiparab11', 'snehaspm1397', 'atul', 'mhatrenrupal42', 'siddhantwarankar', 'pritijha1996', 'ninadmandavkar29', 'bhamghodke7', 'nishigandhaprsd14', 'jr.abishek00', 'rushikeshsalgar123', 'shivanilohar55', 'sahil709', 'ameykokate2015', 'veronicathapa56', 'shirsekarakash', 'rahul2011star', 'karishmahirve96', 'yogeshmaurya50', 'hborse28']",18,"['sanket.gawade', 'dusty', 'sid.jagtap1992', 'manjarekarchinmayeen', 'prathamesh.nikam', 'bhushan9321', 'riddhi737', 'ronak.tiwari', 'ayesha.pathan', 'sanchitkad', 'sanketmane1997.sm', 'digvijayjadeja725', 'patiltejas000003', 'aishuauti20496', 'rajesh05', 'abhishek.diggewadi', 'kgirkar6104', None]",56,"['pranittambde', 'sanket.gawade', 'ashishghoderao', 'manjarekarchinmayeen', 'riddhi737', 'niharmasurkar', 'ronak.tiwari', 'sanchitkad', 'aishuauti20496', 'hborse28', 'siddhu.murkar', 'pandeydeepak825', 'goreravindra95', 'prathamesh.nikam', 'bhushan9321', 'prasad.creativity123', 'sanketmane1997.sm', 'pratikpawar4996', 'tusharvan', 'sonali.ramji', 'sumitpatil512', 'salianyatish111', 'sendpost2mahesh', 'abhishek.diggewadi', 'amritamukeshb', 'surbhib2897', 'sid.jagtap1992', 'jayshreepakhare63', 'santoshiparab11', 'snehaspm1397', 'atul', 'mhatrenrupal42', 'siddhantwarankar', 'ayesha.pathan', 'digvijayjadeja725', 'pritijha1996', 'preethinaik', 'ninadmandavkar29', 'bhamghodke7', 'nishigandhaprsd14', 'jr.abishek00', 'rajesh05', None, 'rushikeshsalgar123', 'shivanilohar55', 'sahil709', 'ameykokate2015', 'dusty', 'veronicathapa56', 'shirsekarakash', 'patiltejas000003', 'rahul2011star', 'karishmahirve96', 'yogeshmaurya50', 'kgirkar6104', 'adityagudla96']"
15,277,39,7,3,"['pritijha1996', 'pandeydeepak825', 'yogeshmaurya50']",35,"['pranittambde', 'ashishghoderao', 'niharmasurkar', 'hborse28', 'siddhu.murkar', 'goreravindra95', 'prasad.creativity123', 'pratikpawar4996', 'tusharvan', 'sonali.ramji', 'sumitpatil512', 'salianyatish111', 'sendpost2mahesh', 'amritamukeshb', 'surbhib2897', 'jayshreepakhare63', 'santoshiparab11', 'snehaspm1397', 'atul', 'mhatrenrupal42', 'siddhantwarankar', 'preethinaik', 'ninadmandavkar29', 'bhamghodke7', 'nishigandhaprsd14', 'jr.abishek00', 'rushikeshsalgar123', 'shivanilohar55', 'sahil709', 'ameykokate2015', 'veronicathapa56', 'shirsekarakash', 'rahul2011star', 'karishmahirve96', 'adityagudla96']",4,"['bonhomie11', None, 'maneaniket', 'bhandarinirali57']",42,"['pranittambde', 'ashishghoderao', 'niharmasurkar', 'bhandarinirali57', 'hborse28', 'siddhu.murkar', 'pandeydeepak825', 'goreravindra95', 'bonhomie11', 'prasad.creativity123', 'pratikpawar4996', 'tusharvan', 'sonali.ramji', 'sumitpatil512', 'maneaniket', 'salianyatish111', 'sendpost2mahesh', 'amritamukeshb', 'surbhib2897', 'jayshreepakhare63', 'santoshiparab11', 'snehaspm1397', 'atul', 'mhatrenrupal42', 'siddhantwarankar', 'pritijha1996', 'preethinaik', 'ninadmandavkar29', 'bhamghodke7', 'nishigandhaprsd14', 'jr.abishek00', None, 'rushikeshsalgar123', 'shivanilohar55', 'sahil709', 'ameykokate2015', 'veronicathapa56', 'shirsekarakash', 'rahul2011star', 'karishmahirve96', 'yogeshmaurya50', 'adityagudla96']"
16,300,37,32,29,"['erdebnam', 'ircrawfo', 'jeboehle', 'jwhall5', 'evjucov', 'abhishekkher', 'gcortez', 'daliu', 'lasowers', 'jmdonal2', 'jmwendro', 'oawander', 'yzhan110', 'bshawki2', 'emgram', 'pwwagner', 'tbmeyer', 'abcallan', 'bhnestvo', 'gematth2', 'amsteige', 'gfrost2', 'nmurphy2', 'mjavakia', 'meskelto', 'eclloyd3', 'jagibson', 'cmkey', 'efroe']",7,"['lebedevgeorge12', 'john.li', 'kesavan3000', 'michael15247', 'hemantcharaya', 'webster.thomas.1', 'danilbash']",3,"['kjcody', 'cprocid', None]",39,"['erdebnam', 'ircrawfo', 'jeboehle', 'jwhall5', 'evjucov', 'cprocid', 'abhishekkher', 'gcortez', 'daliu', 'lasowers', 'kjcody', 'jmdonal2', 'oawander', 'jmwendro', 'yzhan110', 'bshawki2', 'emgram', 'pwwagner', 'tbmeyer', 'abcallan', 'bhnestvo', 'danilbash', 'kesavan3000', 'gematth2', 'john.li', 'amsteige', 'lebedevgeorge12', 'gfrost2', 'nmurphy2', 'mjavakia', None, 'meskelto', 'eclloyd3', 'jagibson', 'cmkey', 'michael15247', 'hemantcharaya', 'webster.thomas.1', 'efroe']"
16,299,37,15,10,"['bshawki2', 'nmurphy2', 'jeboehle', 'evjucov', 'cmkey', 'pwwagner', 'mjavakia', 'abcallan', 'meskelto', 'bhnestvo']",26,"['erdebnam', 'ircrawfo', 'jwhall5', 'abhishekkher', 'gcortez', 'daliu', 'lasowers', 'jmdonal2', 'oawander', 'jmwendro', 'yzhan110', 'emgram', 'tbmeyer', 'kesavan3000', 'danilbash', 'gematth2', 'john.li', 'amsteige', 'lebedevgeorge12', 'gfrost2', 'eclloyd3', 'jagibson', 'michael15247', 'hemantcharaya', 'webster.thomas.1', 'efroe']",5,"['edelder', 'emmanuel06', 'jjgullet', 'jmarion', None]",41,"['erdebnam', 'ircrawfo', 'jeboehle', 'jwhall5', 'evjucov', 'abhishekkher', 'gcortez', 'daliu', 'lasowers', 'edelder', 'jmdonal2', 'oawander', 'jmwendro', 'yzhan110', 'bshawki2', 'emgram', 'pwwagner', 'tbmeyer', 'abcallan', 'bhnestvo', 'danilbash', 'kesavan3000', 'gematth2', 'john.li', 'amsteige', 'lebedevgeorge12', 'gfrost2', 'emmanuel06', 'nmurphy2', 'jjgullet', 'jmarion', 'mjavakia', None, 'meskelto', 'eclloyd3', 'jagibson', 'cmkey', 'michael15247', 'hemantcharaya', 'webster.thomas.1', 'efroe']"
17,153,33,38,32,"['jayldoherty', 'martinli.841', 'juanpablogf95', 'hattan.abuzaid', 'alexanderzapata.duke', 'mitchelljbognar', 'chungb96', 'wang.michael213', 'jpablogf95', 'gwessler', 'aboyce140', 'neildhar', 'kvv4', 'ryanpond21', 'meb100', 'august', 'jacarde4', 'cathyfizzpop11', 'ddmf', 'jcorey018', 'epharis', 'd_maye_arg', 'advaitreddy', 'kfinke44', 'culbert_alex', 'tonghuayu001', 'xdeputy', 'spencerdf', 'kmv10', 'codybrinkmansoccer', 'eddie.yao1', 'kenkoch4']",0,[],6,"['bognar_m', 'kekoch4', 'eas90', 'eaxstump', 'nwilli43', None]",38,"['jayldoherty', 'bognar_m', 'martinli.841', 'hattan.abuzaid', 'juanpablogf95', 'kekoch4', 'eaxstump', 'alexanderzapata.duke', 'mitchelljbognar', 'chungb96', 'wang.michael213', 'jpablogf95', 'gwessler', 'eas90', 'aboyce140', 'neildhar', 'kvv4', 'ryanpond21', 'meb100', 'august', 'jacarde4', 'cathyfizzpop11', 'nwilli43', None, 'ddmf', 'jcorey018', 'epharis', 'd_maye_arg', 'advaitreddy', 'kfinke44', 'culbert_alex', 'tonghuayu001', 'xdeputy', 'spencerdf', 'kmv10', 'codybrinkmansoccer', 'eddie.yao1', 'kenkoch4']"
17,150,33,34,32,"['jayldoherty', 'martinli.841', 'juanpablogf95', 'hattan.abuzaid', 'alexanderzapata.duke', 'mitchelljbognar', 'chungb96', 'wang.michael213', 'jpablogf95', 'gwessler', 'aboyce140', 'neildhar', 'kvv4', 'ryanpond21', 'meb100', 'august', 'jacarde4', 'cathyfizzpop11', 'ddmf', 'jcorey018', 'epharis', 'd_maye_arg', 'advaitreddy', 'kfinke44', 'culbert_alex', 'tonghuayu001', 'xdeputy', 'spencerdf', 'kmv10', 'codybrinkmansoccer', 'eddie.yao1', 'kenkoch4']",0,[],2,"[None, 'nwilli43']",34,"['jayldoherty', 'martinli.841', 'hattan.abuzaid', 'juanpablogf95', 'alexanderzapata.duke', 'mitchelljbognar', 'chungb96', 'wang.michael213', 'jpablogf95', 'gwessler', 'aboyce140', 'neildhar', 'kvv4', 'ryanpond21', 'meb100', 'august', 'jacarde4', 'cathyfizzpop11', 'nwilli43', None, 'ddmf', 'jcorey018', 'epharis', 'd_maye_arg', 'advaitreddy', 'kfinke44', 'culbert_alex', 'tonghuayu001', 'xdeputy', 'spencerdf', 'kmv10', 'codybrinkmansoccer', 'eddie.yao1', 'kenkoch4']"
17,72,33,16,4,"['advaitreddy', 'wang.michael213', 'jpablogf95', 'ddmf']",28,"['jayldoherty', 'martinli.841', 'juanpablogf95', 'hattan.abuzaid', 'alexanderzapata.duke', 'mitchelljbognar', 'chungb96', 'gwessler', 'aboyce140', 'neildhar', 'kvv4', 'ryanpond21', 'meb100', 'august', 'jacarde4', 'cathyfizzpop11', 'jcorey018', 'epharis', 'd_maye_arg', 'kfinke44', 'tonghuayu001', 'culbert_alex', 'spencerdf', 'xdeputy', 'kmv10', 'codybrinkmansoccer', 'eddie.yao1', 'kenkoch4']",12,"['elin6243', None, 'emcox', 'aqiu95', 'vmf7', 'arr45', 'ben_jackson341', 'covielc', 'khyland1031', '09petunia', 'sdorukdoganay', 'andubandu']",44,"['jayldoherty', 'emcox', 'martinli.841', 'hattan.abuzaid', 'juanpablogf95', 'ben_jackson341', 'alexanderzapata.duke', 'covielc', '09petunia', 'mitchelljbognar', 'chungb96', 'wang.michael213', 'jpablogf95', 'aqiu95', 'gwessler', 'aboyce140', 'neildhar', 'kvv4', 'sdorukdoganay', 'ryanpond21', 'meb100', 'august', 'khyland1031', 'jacarde4', 'cathyfizzpop11', None, 'ddmf', 'elin6243', 'jcorey018', 'epharis', 'd_maye_arg', 'advaitreddy', 'kfinke44', 'culbert_alex', 'tonghuayu001', 'xdeputy', 'spencerdf', 'kmv10', 'vmf7', 'arr45', 'codybrinkmansoccer', 'eddie.yao1', 'andubandu', 'kenkoch4']"
17,154,33,8,6,"['jcorey018', 'd_maye_arg', 'tonghuayu001', 'culbert_alex', 'meb100', 'cathyfizzpop11']",26,"['jayldoherty', 'martinli.841', 'juanpablogf95', 'hattan.abuzaid', 'alexanderzapata.duke', 'mitchelljbognar', 'chungb96', 'wang.michael213', 'jpablogf95', 'gwessler', 'aboyce140', 'neildhar', 'kvv4', 'ryanpond21', 'august', 'jacarde4', 'ddmf', 'epharis', 'kfinke44', 'advaitreddy', 'spencerdf', 'xdeputy', 'kmv10', 'codybrinkmansoccer', 'eddie.yao1', 'kenkoch4']",2,"[None, 'nwilli43']",34,"['jayldoherty', 'martinli.841', 'hattan.abuzaid', 'juanpablogf95', 'alexanderzapata.duke', 'mitchelljbognar', 'chungb96', 'wang.michael213', 'jpablogf95', 'gwessler', 'aboyce140', 'neildhar', 'kvv4', 'ryanpond21', 'meb100', 'august', 'jacarde4', 'cathyfizzpop11', 'nwilli43', None, 'ddmf', 'jcorey018', 'epharis', 'd_maye_arg', 'advaitreddy', 'kfinke44', 'culbert_alex', 'tonghuayu001', 'xdeputy', 'spencerdf', 'kmv10', 'codybrinkmansoccer', 'eddie.yao1', 'kenkoch4']"
18,256,32,33,30,"['yarshun9', 'abdas2', 'yhh2', 'jingwei2', 'shudong2', 'tguan2', 'timzuiuc', 'becarro2', 'dvaz2', 'dmgalla2', 'andrewhu1995', 'mdl3', 'dulin2', 'cawel', 'nw3', 'sahilm', 'hchun5', 'dwh4', 'strekha2', 'nathanrampage', 'ywang530', 'stogner2', 'dhruvbohra97', 'fhismail', 'dslee8', 'girdhrn2', 'moemoespitfire', 'irodeh2', 'caryzhu2', 'jguo32']",1,['jzhao56'],3,"['zhopkin2', None, 'pruiett2']",34,"['abdas2', 'yhh2', 'shudong2', 'tguan2', 'becarro2', 'dvaz2', 'dmgalla2', 'mdl3', 'dulin2', 'sahilm', 'dwh4', 'strekha2', 'ywang530', 'stogner2', 'pruiett2', 'fhismail', 'dslee8', 'girdhrn2', 'moemoespitfire', 'irodeh2', 'caryzhu2', 'jguo32', 'yarshun9', 'jingwei2', 'timzuiuc', 'andrewhu1995', 'cawel', 'nw3', 'hchun5', 'jzhao56', 'nathanrampage', None, 'zhopkin2', 'dhruvbohra97']"
19,175,32,37,31,"['rabing', 'weemsh', 'creask', 'fields4242', 'zhaiyue1002', 'enxhimarika', 'parins', 'helaina', 'lphuang', 'sdavis3.1415', 'marcoy', 'danwilliams96', 'patrick.aselin', 'monica.mazur7', 'lordswoledemort', 'blaugc', 'brandon.marino09', 'amcewen53', 'kebiggs', 'schror2', 'harmoa', 'destinyadelalopez', 'jacksonfwong', 'emma.zec7', 'schnea2', 'abhishandy', 'cheny34', 'stamaki', 'mikemiller', 'dingxuanyi', 'wenjia']",0,[],6,"['nipayi27', 'jbcarr1421', 'phillip.falcone42', 'chend67791935', 'the.notorious.djg', None]",37,"['jbcarr1421', 'creask', 'enxhimarika', 'helaina', 'lphuang', 'the.notorious.djg', 'marcoy', 'nipayi27', 'phillip.falcone42', 'monica.mazur7', 'abhishandy', 'cheny34', 'stamaki', 'mikemiller', 'dingxuanyi', 'chend67791935', 'rabing', 'weemsh', 'fields4242', 'zhaiyue1002', 'parins', 'sdavis3.1415', 'danwilliams96', 'patrick.aselin', 'lordswoledemort', 'blaugc', 'brandon.marino09', 'amcewen53', 'kebiggs', 'schror2', None, 'harmoa', 'destinyadelalopez', 'jacksonfwong', 'emma.zec7', 'schnea2', 'wenjia']"
19,311,32,37,31,"['rabing', 'weemsh', 'creask', 'fields4242', 'zhaiyue1002', 'enxhimarika', 'parins', 'helaina', 'lphuang', 'sdavis3.1415', 'marcoy', 'danwilliams96', 'patrick.aselin', 'monica.mazur7', 'lordswoledemort', 'blaugc', 'brandon.marino09', 'amcewen53', 'kebiggs', 'schror2', 'harmoa', 'destinyadelalopez', 'jacksonfwong', 'emma.zec7', 'schnea2', 'abhishandy', 'cheny34', 'stamaki', 'mikemiller', 'dingxuanyi', 'wenjia']",0,[],6,"['nipayi27', 'jbcarr1421', 'phillip.falcone42', 'chend67791935', 'the.notorious.djg', None]",37,"['jbcarr1421', 'creask', 'enxhimarika', 'helaina', 'lphuang', 'the.notorious.djg', 'marcoy', 'nipayi27', 'phillip.falcone42', 'monica.mazur7', 'abhishandy', 'cheny34', 'stamaki', 'mikemiller', 'dingxuanyi', 'chend67791935', 'rabing', 'weemsh', 'fields4242', 'zhaiyue1002', 'parins', 'sdavis3.1415', 'danwilliams96', 'patrick.aselin', 'lordswoledemort', 'blaugc', 'brandon.marino09', 'amcewen53', 'kebiggs', 'schror2', None, 'harmoa', 'destinyadelalopez', 'jacksonfwong', 'emma.zec7', 'schnea2', 'wenjia']"
19,322,32,37,31,"['rabing', 'weemsh', 'creask', 'fields4242', 'zhaiyue1002', 'enxhimarika', 'parins', 'helaina', 'lphuang', 'sdavis3.1415', 'marcoy', 'danwilliams96', 'patrick.aselin', 'monica.mazur7', 'lordswoledemort', 'blaugc', 'brandon.marino09', 'amcewen53', 'kebiggs', 'schror2', 'harmoa', 'destinyadelalopez', 'jacksonfwong', 'emma.zec7', 'schnea2', 'abhishandy', 'cheny34', 'stamaki', 'mikemiller', 'dingxuanyi', 'wenjia']",0,[],6,"['nipayi27', 'jbcarr1421', 'phillip.falcone42', 'chend67791935', 'the.notorious.djg', None]",37,"['jbcarr1421', 'creask', 'enxhimarika', 'helaina', 'lphuang', 'the.notorious.djg', 'marcoy', 'nipayi27', 'phillip.falcone42', 'monica.mazur7', 'abhishandy', 'cheny34', 'stamaki', 'mikemiller', 'dingxuanyi', 'chend67791935', 'rabing', 'weemsh', 'fields4242', 'zhaiyue1002', 'parins', 'sdavis3.1415', 'danwilliams96', 'patrick.aselin', 'lordswoledemort', 'blaugc', 'brandon.marino09', 'amcewen53', 'kebiggs', 'schror2', None, 'harmoa', 'destinyadelalopez', 'jacksonfwong', 'emma.zec7', 'schnea2', 'wenjia']"
19,312,32,33,27,"['rabing', 'weemsh', 'creask', 'fields4242', 'zhaiyue1002', 'enxhimarika', 'parins', 'sdavis3.1415', 'marcoy', 'danwilliams96', 'patrick.aselin', 'monica.mazur7', 'blaugc', 'brandon.marino09', 'amcewen53', 'kebiggs', 'schror2', 'harmoa', 'destinyadelalopez', 'jacksonfwong', 'emma.zec7', 'schnea2', 'abhishandy', 'cheny34', 'stamaki', 'dingxuanyi', 'wenjia']",4,"['lphuang', 'mikemiller', 'helaina', 'lordswoledemort']",6,"['nipayi27', 'jbcarr1421', 'phillip.falcone42', 'chend67791935', 'the.notorious.djg', None]",37,"['jbcarr1421', 'creask', 'enxhimarika', 'helaina', 'lphuang', 'the.notorious.djg', 'marcoy', 'nipayi27', 'phillip.falcone42', 'monica.mazur7', 'abhishandy', 'cheny34', 'stamaki', 'mikemiller', 'dingxuanyi', 'chend67791935', 'rabing', 'weemsh', 'fields4242', 'zhaiyue1002', 'parins', 'sdavis3.1415', 'danwilliams96', 'patrick.aselin', 'lordswoledemort', 'blaugc', 'brandon.marino09', 'amcewen53', 'kebiggs', 'schror2', None, 'harmoa', 'destinyadelalopez', 'jacksonfwong', 'emma.zec7', 'schnea2', 'wenjia']"
19,176,32,28,22,"['weemsh', 'creask', 'zhaiyue1002', 'enxhimarika', 'parins', 'sdavis3.1415', 'marcoy', 'patrick.aselin', 'blaugc', 'brandon.marino09', 'amcewen53', 'kebiggs', 'schror2', 'harmoa', 'destinyadelalopez', 'jacksonfwong', 'emma.zec7', 'abhishandy', 'stamaki', 'cheny34', 'mikemiller', 'dingxuanyi']",9,"['danwilliams96', 'helaina', 'monica.mazur7', 'rabing', 'schnea2', 'lphuang', 'lordswoledemort', 'fields4242', 'wenjia']",6,"['nipayi27', 'jbcarr1421', 'phillip.falcone42', 'chend67791935', 'the.notorious.djg', None]",37,"['jbcarr1421', 'chend67791935', 'rabing', 'weemsh', 'creask', 'fields4242', 'zhaiyue1002', 'enxhimarika', 'parins', 'helaina', 'lphuang', 'sdavis3.1415', 'the.notorious.djg', 'marcoy', 'danwilliams96', 'nipayi27', 'phillip.falcone42', 'patrick.aselin', 'monica.mazur7', 'lordswoledemort', 'blaugc', 'brandon.marino09', 'amcewen53', 'kebiggs', 'schror2', None, 'harmoa', 'destinyadelalopez', 'jacksonfwong', 'emma.zec7', 'schnea2', 'abhishandy', 'cheny34', 'stamaki', 'mikemiller', 'dingxuanyi', 'wenjia']"
19,321,32,7,5,"['rabing', 'lphuang', 'fields4242', 'wenjia', 'zhaiyue1002']",26,"['weemsh', 'creask', 'enxhimarika', 'parins', 'helaina', 'sdavis3.1415', 'marcoy', 'danwilliams96', 'patrick.aselin', 'monica.mazur7', 'lordswoledemort', 'blaugc', 'brandon.marino09', 'amcewen53', 'kebiggs', 'schror2', 'harmoa', 'destinyadelalopez', 'jacksonfwong', 'emma.zec7', 'schnea2', 'abhishandy', 'cheny34', 'stamaki', 'mikemiller', 'dingxuanyi']",2,"['nipayi27', None]",33,"['rabing', 'weemsh', 'creask', 'fields4242', 'zhaiyue1002', 'enxhimarika', 'parins', 'helaina', 'lphuang', 'sdavis3.1415', 'marcoy', 'danwilliams96', 'nipayi27', 'patrick.aselin', 'monica.mazur7', 'lordswoledemort', 'blaugc', 'brandon.marino09', 'amcewen53', 'kebiggs', 'schror2', None, 'harmoa', 'destinyadelalopez', 'jacksonfwong', 'emma.zec7', 'schnea2', 'abhishandy', 'cheny34', 'stamaki', 'mikemiller', 'dingxuanyi', 'wenjia']"
20,166,32,14,12,"['ahmadh9', 'sheikh.asher', 'mhussnainriaz', 'asimakiran1', 'turabhaiderkazmi12', 'shani_libra', 'raousama3', 'arbaab.eeng', 'zarmeen.94', 'muhammadmohsin_saeed', 'fakeha19', 'ehsanzubair6']",19,"['p.swierdz', 'tvddries', 'thomasvandendries', 'yuanliu', 'saqibtariq', 'usamarao', 'zrsheikh19', 'anouar.lakbir89', 'learn.niwane', 'sheikhasher94', 'zahid', 'pooghosh6', 'physics2018', 'benshawn', 'xingfei', 'muhakhan', 'turabhaiderkazmi1', 'huiyi', 'tangoclan2007']",2,"[None, 'nbutt']",33,"['turabhaiderkazmi12', 'p.swierdz', 'raousama3', 'tvddries', 'thomasvandendries', 'yuanliu', 'saqibtariq', 'usamarao', 'zrsheikh19', 'nbutt', 'anouar.lakbir89', 'learn.niwane', 'shani_libra', 'sheikhasher94', 'zahid', 'pooghosh6', 'fakeha19', 'physics2018', 'benshawn', 'ahmadh9', 'mhussnainriaz', 'asimakiran1', 'xingfei', 'arbaab.eeng', None, 'muhakhan', 'turabhaiderkazmi1', 'sheikh.asher', 'zarmeen.94', 'huiyi', 'muhammadmohsin_saeed', 'tangoclan2007', 'ehsanzubair6']"
20,167,32,14,13,"['benshawn', 'usamarao', 'ahmadh9', 'zrsheikh19', 'turabhaiderkazmi1', 'sheikh.asher', 'mhussnainriaz', 'sheikhasher94', 'raousama3', 'arbaab.eeng', 'zahid', 'zarmeen.94', 'fakeha19']",18,"['ehsanzubair6', 'asimakiran1', 'turabhaiderkazmi12', 'p.swierdz', 'tvddries', 'anouar.lakbir89', 'learn.niwane', 'shani_libra', 'xingfei', 'pooghosh6', 'huiyi', 'muhammadmohsin_saeed', 'physics2018', 'tangoclan2007', 'saqibtariq', 'thomasvandendries', 'muhakhan', 'yuanliu']",1,[None],32,"['turabhaiderkazmi12', 'p.swierdz', 'raousama3', 'tvddries', 'thomasvandendries', 'yuanliu', 'saqibtariq', 'usamarao', 'zrsheikh19', 'anouar.lakbir89', 'learn.niwane', 'shani_libra', 'sheikhasher94', 'zahid', 'pooghosh6', 'fakeha19', 'physics2018', 'benshawn', 'ahmadh9', 'mhussnainriaz', 'asimakiran1', 'xingfei', 'arbaab.eeng', None, 'muhakhan', 'turabhaiderkazmi1', 'sheikh.asher', 'zarmeen.94', 'huiyi', 'muhammadmohsin_saeed', 'tangoclan2007', 'ehsanzubair6']"
20,168,32,10,8,"['anouar.lakbir89', 'p.swierdz', 'thomasvandendries', 'huiyi', 'tangoclan2007', 'tvddries', 'muhakhan', 'yuanliu']",23,"['turabhaiderkazmi12', 'raousama3', 'saqibtariq', 'usamarao', 'zrsheikh19', 'learn.niwane', 'shani_libra', 'sheikhasher94', 'zahid', 'pooghosh6', 'fakeha19', 'physics2018', 'benshawn', 'ahmadh9', 'mhussnainriaz', 'asimakiran1', 'xingfei', 'arbaab.eeng', 'turabhaiderkazmi1', 'sheikh.asher', 'zarmeen.94', 'muhammadmohsin_saeed', 'ehsanzubair6']",2,"[None, 'parvais']",33,"['turabhaiderkazmi12', 'p.swierdz', 'raousama3', 'tvddries', 'thomasvandendries', 'yuanliu', 'saqibtariq', 'usamarao', 'zrsheikh19', 'anouar.lakbir89', 'learn.niwane', 'shani_libra', 'sheikhasher94', 'zahid', 'pooghosh6', 'fakeha19', 'physics2018', 'benshawn', 'ahmadh9', 'mhussnainriaz', 'asimakiran1', 'xingfei', 'arbaab.eeng', None, 'muhakhan', 'turabhaiderkazmi1', 'sheikh.asher', 'parvais', 'zarmeen.94', 'huiyi', 'muhammadmohsin_saeed', 'tangoclan2007', 'ehsanzubair6']"
20,165,32,7,5,"['ahmadh9', 'shani_libra', 'raousama3', 'muhammadmohsin_saeed', 'fakeha19']",26,"['turabhaiderkazmi12', 'p.swierdz', 'tvddries', 'thomasvandendries', 'saqibtariq', 'yuanliu', 'usamarao', 'zrsheikh19', 'anouar.lakbir89', 'learn.niwane', 'sheikhasher94', 'zahid', 'pooghosh6', 'physics2018', 'benshawn', 'mhussnainriaz', 'asimakiran1', 'xingfei', 'arbaab.eeng', 'muhakhan', 'turabhaiderkazmi1', 'sheikh.asher', 'zarmeen.94', 'huiyi', 'tangoclan2007', 'ehsanzubair6']",2,"[None, 'nbutt']",33,"['turabhaiderkazmi12', 'p.swierdz', 'raousama3', 'tvddries', 'thomasvandendries', 'yuanliu', 'saqibtariq', 'usamarao', 'zrsheikh19', 'nbutt', 'anouar.lakbir89', 'learn.niwane', 'shani_libra', 'sheikhasher94', 'zahid', 'pooghosh6', 'fakeha19', 'physics2018', 'benshawn', 'ahmadh9', 'mhussnainriaz', 'asimakiran1', 'xingfei', 'arbaab.eeng', None, 'muhakhan', 'turabhaiderkazmi1', 'sheikh.asher', 'zarmeen.94', 'huiyi', 'muhammadmohsin_saeed', 'tangoclan2007', 'ehsanzubair6']"
21,306,31,42,28,"['gary0010', 'jxie13', 'hzhou29', 'azpixy', 'gchen4', 'elt17bw', 'clostuard', 'ashz8888', 'xtan15', 'twang56', 'jiangtao', 'shanshuiyue', 'laplace_', 'thursika', 'yvonnee213', 'tanusharma', 'mirjiang', 'sxy4869', 'elp17ys', 'wd2lh', 'zhaomiaomiao', 'niknanohub', 'orzmissman', 'zhaohao', 'pfeng3', 'zimtiaz1', 'myu9', 'elq17cz']",2,"['louhaijun', 'tipu031']",14,"['zhaohao9303', 'charlotte.phillips', 'ben951103', 'elp17fw', 'cphillips3', 'dwen3', 'richardfeng0052', 'cby32195', 'gary00101', 'yumingji123', 'nanahmadsufian1', 'dlwang', None, 'wang7705271']",44,"['gary0010', 'jxie13', 'dwen3', 'twang56', 'jiangtao', 'wang7705271', 'shanshuiyue', 'elp17fw', 'thursika', 'gary00101', 'tipu031', 'mirjiang', 'sxy4869', 'elp17ys', 'nanahmadsufian1', 'zhaomiaomiao', 'ben951103', 'orzmissman', 'yumingji123', 'zimtiaz1', 'hzhou29', 'azpixy', 'gchen4', 'elt17bw', 'clostuard', 'richardfeng0052', 'cby32195', 'ashz8888', 'xtan15', 'dlwang', 'louhaijun', 'zhaohao9303', 'charlotte.phillips', 'laplace_', 'yvonnee213', 'tanusharma', 'wd2lh', 'niknanohub', None, 'cphillips3', 'zhaohao', 'pfeng3', 'myu9', 'elq17cz']"
21,303,31,28,25,"['gary0010', 'jxie13', 'hzhou29', 'azpixy', 'gchen4', 'elt17bw', 'clostuard', 'ashz8888', 'xtan15', 'jiangtao', 'twang56', 'shanshuiyue', 'laplace_', 'thursika', 'yvonnee213', 'tanusharma', 'mirjiang', 'elp17ys', 'zhaomiaomiao', 'orzmissman', 'zhaohao', 'pfeng3', 'zimtiaz1', 'myu9', 'elq17cz']",5,"['tipu031', 'sxy4869', 'wd2lh', 'louhaijun', 'niknanohub']",3,"[None, 'bjiang5', 'nozdormu0129']",33,"['gary0010', 'jxie13', 'hzhou29', 'azpixy', 'gchen4', 'elt17bw', 'clostuard', 'ashz8888', 'xtan15', 'twang56', 'jiangtao', 'louhaijun', 'shanshuiyue', 'laplace_', 'thursika', 'tipu031', 'bjiang5', 'yvonnee213', 'tanusharma', 'mirjiang', 'sxy4869', 'elp17ys', 'wd2lh', 'zhaomiaomiao', 'niknanohub', None, 'nozdormu0129', 'orzmissman', 'zhaohao', 'pfeng3', 'zimtiaz1', 'myu9', 'elq17cz']"
21,305,31,15,13,"['laplace_', 'gary0010', 'orzmissman', 'pfeng3', 'tanusharma', 'mirjiang', 'xtan15', 'jiangtao', 'hzhou29', 'zhaomiaomiao', 'niknanohub', 'elq17cz', 'shanshuiyue']",17,"['elt17bw', 'thursika', 'clostuard', 'zhaohao', 'tipu031', 'zimtiaz1', 'yvonnee213', 'jxie13', 'ashz8888', 'sxy4869', 'elp17ys', 'twang56', 'wd2lh', 'myu9', 'louhaijun', 'azpixy', 'gchen4']",2,"[None, 'yzhao85']",32,"['gary0010', 'jxie13', 'hzhou29', 'azpixy', 'gchen4', 'yzhao85', 'elt17bw', 'clostuard', 'ashz8888', 'xtan15', 'twang56', 'jiangtao', 'louhaijun', 'shanshuiyue', 'laplace_', 'thursika', 'tipu031', 'yvonnee213', 'tanusharma', 'mirjiang', 'sxy4869', 'elp17ys', 'wd2lh', 'zhaomiaomiao', 'niknanohub', None, 'orzmissman', 'zhaohao', 'pfeng3', 'zimtiaz1', 'myu9', 'elq17cz']"
21,304,31,8,7,"['laplace_', 'gary0010', 'pfeng3', 'mirjiang', 'xtan15', 'zhaomiaomiao', 'elq17cz']",23,"['jxie13', 'hzhou29', 'azpixy', 'gchen4', 'elt17bw', 'clostuard', 'ashz8888', 'twang56', 'jiangtao', 'louhaijun', 'shanshuiyue', 'thursika', 'tipu031', 'yvonnee213', 'tanusharma', 'sxy4869', 'elp17ys', 'wd2lh', 'niknanohub', 'orzmissman', 'zhaohao', 'zimtiaz1', 'myu9']",1,[None],31,"['gary0010', 'jxie13', 'hzhou29', 'azpixy', 'gchen4', 'elt17bw', 'clostuard', 'ashz8888', 'xtan15', 'twang56', 'jiangtao', 'louhaijun', 'shanshuiyue', 'laplace_', 'thursika', 'tipu031', 'yvonnee213', 'tanusharma', 'mirjiang', 'sxy4869', 'elp17ys', 'wd2lh', 'zhaomiaomiao', 'niknanohub', None, 'orzmissman', 'zhaohao', 'pfeng3', 'zimtiaz1', 'myu9', 'elq17cz']"
22,37,28,28,27,"['leondiazabel', 'luislaya14', 'lizbethore10rj', 'analucerocp', 'alvaro99.art', 'thonyavs', 'zoreshl150', 'carlos.moquillaza', 'tupac.olivares', 'jes.noa', 'almq', 'marllynevega27', 'edgarzc123', 'yoselingc.1401', 'narda.jovan', 'olenqafb', 'henry_ht', 'bladimir.stalen', 'karen.salcedo', 'mvto', 'floreschavezjack', 'jhonnymeison3', 'deborajimena14', 'rocioqo', 'llacchasandradedaniel', 'dianalisbettrojascardenas', 'lopezbravo482']",0,[],1,[None],28,"['leondiazabel', 'luislaya14', 'lizbethore10rj', 'analucerocp', 'alvaro99.art', 'thonyavs', 'zoreshl150', 'carlos.moquillaza', 'tupac.olivares', 'jes.noa', 'almq', 'marllynevega27', 'edgarzc123', 'yoselingc.1401', 'narda.jovan', 'olenqafb', 'henry_ht', 'bladimir.stalen', 'karen.salcedo', 'mvto', None, 'floreschavezjack', 'jhonnymeison3', 'deborajimena14', 'rocioqo', 'llacchasandradedaniel', 'dianalisbettrojascardenas', 'lopezbravo482']"
23,252,28,28,26,"['shweta1694', 'gajjarneel', 'kagithamanoj', 'dhydh', 'yashraj_kshirsagar', 'shaila', 'dharsh027', 'shubhamgajbhiye', 'yashaswini153', 'amogh9293', 'arpitha11', 'yogeshvmhase', 'dinosha', 'megha30', 'cccpsoda', 'b200777', 'dishap1794', 'sanjana1704', 'vhanumante', 'vishnunair1557', 'priyanka31', 'prakashneha06', 'neha893556589', 'merdogan72', 'tparamasivam', 'prithvi95']",1,['thakurianiharika'],2,"['kuruvila592', None]",29,"['shweta1694', 'gajjarneel', 'kagithamanoj', 'dhydh', 'yashraj_kshirsagar', 'kuruvila592', 'shaila', 'shubhamgajbhiye', 'dharsh027', 'yashaswini153', 'thakurianiharika', 'amogh9293', 'arpitha11', 'yogeshvmhase', 'dinosha', 'megha30', 'cccpsoda', 'dishap1794', 'b200777', 'sanjana1704', 'vhanumante', None, 'vishnunair1557', 'priyanka31', 'prakashneha06', 'neha893556589', 'merdogan72', 'tparamasivam', 'prithvi95']"
24,269,27,75,7,"['bolekunal42', 'prashant.khedkar', 'mbhosale863', 'sudar', 'vishal8244', 'abhishek2397', 'ganeshjadhav']",19,"['sampadaphatak28', 'vallabhbudhkar', 'sarveshbhoer158', 'pranaybhatkar', 'shreya9609', 'ronraviram789', 'imdevendra258', 'deshpande192', 'dipikapatil097', 'yashpimpale6', 'pawargeeta177', 'nikamsupriya44', 'apurvaganu1996', 'rincyj327', 'rawatchefchetan', 'subodhsawant07', 'vinayak183', 'rashmithanair5', 'mitalihaldankar8']",68,"['rajeshree.kumbhar5018', 'palakchheda2407', 'ashishghoderao', 'sumitmhatre5670', 'manjarekarchinmayeen', 'ashwinipardeshi702', 'ronak.tiwari', 'riddhi737', 'sanchitkad', 'niharmasurkar', 'rasikapotdar2108', 'bhandarinirali57', 'aishuauti20496', 'mihirgogri613', 'pandeydeepak825', 'lekhakande', 'pratibhagawari28', 'ab17', 'puranikatharva', 'anitadey12', 'prathamesh.nikam', 'bhushan9321', 'mayurgonbare22', 'sumitpatil512', 'sonali.ramji', 'maneaniket', 'siddheshgothankar', 'dleena19961209', 'adityagudla96', 'sid.jagtap1992', 'sendpost2mahesh', 'surbhib2897', 'shraddhasam78', 'jayshreepakhare63', 'atul', 'abhijaypandey', 'dilip.wakdikar', 'mhatrenrupal42', 'neonargon5', 'trambakesh97', 'riyakulkarni16021997', 'ayesha.pathan', 'brarath.nihal', 'bgharat713', 'pritijha1996', 'ninadmandavkar29', 'preethinaik', 'sanket.mane', 'nishigandhaprsd14', 'bhaveshsawant1996', 'snehalpatil', 'rajesh05', 'ksanket025', None, 'rushikeshsalgar123', 'sahil709', 'dusty', 'rahul.sawant', 'neelamt', 's.arutwar', 'veronicathapa56', 'shreekantrasam69', 'yogeshmaurya50', 'shraddha.dhage', 'hborse28', 'ganesh.mali', 'kavusatose123', 'mithilagajarmal']",94,"['rajeshree.kumbhar5018', 'palakchheda2407', 'sampadaphatak28', 'mbhosale863', 'ashishghoderao', 'sumitmhatre5670', 'pranaybhatkar', 'ashwinipardeshi702', 'ronak.tiwari', 'sanchitkad', 'rasikapotdar2108', 'aishuauti20496', 'pandeydeepak825', 'shreya9609', 'ronraviram789', 'puranikatharva', 'prathamesh.nikam', 'bhushan9321', 'adityagudla96', 'pawargeeta177', 'sid.jagtap1992', 'sendpost2mahesh', 'surbhib2897', 'shraddhasam78', 'jayshreepakhare63', 'apurvaganu1996', 'atul', 'bolekunal42', 'mhatrenrupal42', 'neonargon5', 'ayesha.pathan', 'ninadmandavkar29', 'abhishek2397', 'nishigandhaprsd14', 'bhaveshsawant1996', 'rushikeshsalgar123', 'sahil709', 'dusty', 'neelamt', 'sudar', 'shreekantrasam69', 'vinayak183', 'rashmithanair5', 'yogeshmaurya50', 'kavusatose123', 'shraddha.dhage', 'vallabhbudhkar', 'manjarekarchinmayeen', 'sarveshbhoer158', 'riddhi737', 'niharmasurkar', 'bhandarinirali57', 'mihirgogri613', 'lekhakande', 'pratibhagawari28', 'ab17', 'anitadey12', 'mayurgonbare22', 'imdevendra258', 'deshpande192', 'dipikapatil097', 'yashpimpale6', 'sumitpatil512', 'sonali.ramji', 'maneaniket', 'siddheshgothankar', 'dleena19961209', 'nikamsupriya44', 'abhijaypandey', 'rincyj327', 'dilip.wakdikar', 'trambakesh97', 'riyakulkarni16021997', 'brarath.nihal', 'bgharat713', 'pritijha1996', 'preethinaik', 'ganeshjadhav', 'sanket.mane', 'snehalpatil', 'rajesh05', 'ksanket025', None, 'rawatchefchetan', 'rahul.sawant', 's.arutwar', 'veronicathapa56', 'prashant.khedkar', 'subodhsawant07', 'vishal8244', 'mitalihaldankar8', 'hborse28', 'ganesh.mali', 'mithilagajarmal']"
24,268,27,42,2,"['shreya9609', 'vinayak183']",24,"['sampadaphatak28', 'vallabhbudhkar', 'mbhosale863', 'sarveshbhoer158', 'pranaybhatkar', 'ronraviram789', 'imdevendra258', 'deshpande192', 'dipikapatil097', 'yashpimpale6', 'pawargeeta177', 'nikamsupriya44', 'apurvaganu1996', 'rincyj327', 'bolekunal42', 'ganeshjadhav', 'abhishek2397', 'rawatchefchetan', 'prashant.khedkar', 'subodhsawant07', 'sudar', 'vishal8244', 'rashmithanair5', 'mitalihaldankar8']",40,"['pranittambde', 'tejas7', 'siddhant319', 'sarvesh107', 'siddhu.murkar', 'sawardekarsuyash97', 'priyankaingle18', 'mounikajalla99', 'goreravindra95', 'bonhomie11', 'chinmaysj96', 'narvekarsushant0', 'prasad24shingade', 'pratikpawar4996', 'tusharvan', 'sonali.ramji', 'salianyatish111', 'amritamukeshb', 'surbhib2897', 'sinalkarshweta5', 'santoshiparab11', 'snehaspm1397', 'dkgupata9768522176', 'siddhantwarankar', 'vrushalithakare82', 'navneet.nrj', 'bhamghodke7', 'jr.abishek00', None, 'shivanilohar55', 'ranegirish24', 'pankajpawar1515', 'satsamjr', 'vedankasalunke96', 'shirsekarakash', 'aartibhalerao29', 'rahul2011star', 'aniruddhaparte3', 'adityagudla96', 'kavusatose123']",66,"['pranittambde', 'sampadaphatak28', 'mbhosale863', 'sarvesh107', 'pranaybhatkar', 'priyankaingle18', 'shreya9609', 'mounikajalla99', 'ronraviram789', 'goreravindra95', 'bonhomie11', 'tusharvan', 'pawargeeta177', 'salianyatish111', 'surbhib2897', 'apurvaganu1996', 'bolekunal42', 'siddhantwarankar', 'vrushalithakare82', 'navneet.nrj', 'abhishek2397', 'bhamghodke7', 'shivanilohar55', 'ranegirish24', 'pankajpawar1515', 'satsamjr', 'sudar', 'aartibhalerao29', 'vinayak183', 'rahul2011star', 'aniruddhaparte3', 'rashmithanair5', 'kavusatose123', 'tejas7', 'vallabhbudhkar', 'siddhant319', 'sarveshbhoer158', 'siddhu.murkar', 'sawardekarsuyash97', 'chinmaysj96', 'narvekarsushant0', 'imdevendra258', 'deshpande192', 'dipikapatil097', 'yashpimpale6', 'prasad24shingade', 'pratikpawar4996', 'sonali.ramji', 'nikamsupriya44', 'amritamukeshb', 'sinalkarshweta5', 'santoshiparab11', 'snehaspm1397', 'rincyj327', 'dkgupata9768522176', 'ganeshjadhav', 'jr.abishek00', None, 'rawatchefchetan', 'prashant.khedkar', 'subodhsawant07', 'vedankasalunke96', 'shirsekarakash', 'vishal8244', 'mitalihaldankar8', 'adityagudla96']"
24,267,27,31,11,"['sampadaphatak28', 'bolekunal42', 'prashant.khedkar', 'mbhosale863', 'subodhsawant07', 'sudar', 'vishal8244', 'imdevendra258', 'ganeshjadhav', 'pawargeeta177', 'abhishek2397']",15,"['rawatchefchetan', 'apurvaganu1996', 'mitalihaldankar8', 'shreya9609', 'vallabhbudhkar', 'ronraviram789', 'rincyj327', 'sarveshbhoer158', 'pranaybhatkar', 'vinayak183', 'deshpande192', 'dipikapatil097', 'yashpimpale6', 'rashmithanair5', 'nikamsupriya44']",20,"['rajeshree.kumbhar5018', 'ani.date23', 'niharmasurkar', 'bhandarinirali57', 'pandeydeepak825', 'puranikatharva', 'mayurgonbare22', 'maneaniket', 'shirishparkhe', 'dilip.wakdikar', 'trambakesh97', 'madhuri.thosare13', 'pritijha1996', 'ninadmandavkar29', None, 'rushikeshsalgar123', 'sahil709', 'dusty', 'panditkunal98', 'yogeshmaurya50']",46,"['rajeshree.kumbhar5018', 'sampadaphatak28', 'vallabhbudhkar', 'ani.date23', 'mbhosale863', 'sarveshbhoer158', 'pranaybhatkar', 'niharmasurkar', 'bhandarinirali57', 'pandeydeepak825', 'shreya9609', 'ronraviram789', 'puranikatharva', 'mayurgonbare22', 'imdevendra258', 'deshpande192', 'dipikapatil097', 'yashpimpale6', 'maneaniket', 'shirishparkhe', 'pawargeeta177', 'nikamsupriya44', 'apurvaganu1996', 'rincyj327', 'bolekunal42', 'dilip.wakdikar', 'trambakesh97', 'madhuri.thosare13', 'pritijha1996', 'ninadmandavkar29', 'ganeshjadhav', 'abhishek2397', None, 'rushikeshsalgar123', 'rawatchefchetan', 'sahil709', 'dusty', 'prashant.khedkar', 'subodhsawant07', 'sudar', 'panditkunal98', 'vishal8244', 'vinayak183', 'yogeshmaurya50', 'rashmithanair5', 'mitalihaldankar8']"
24,266,27,30,15,"['rawatchefchetan', 'apurvaganu1996', 'mitalihaldankar8', 'shreya9609', 'vallabhbudhkar', 'ronraviram789', 'rincyj327', 'sarveshbhoer158', 'pranaybhatkar', 'vinayak183', 'deshpande192', 'dipikapatil097', 'yashpimpale6', 'rashmithanair5', 'nikamsupriya44']",11,"['sampadaphatak28', 'bolekunal42', 'prashant.khedkar', 'mbhosale863', 'subodhsawant07', 'sudar', 'vishal8244', 'imdevendra258', 'ganeshjadhav', 'pawargeeta177', 'abhishek2397']",15,"['sanketdamame', 'ashishghoderao', 'bonhomie11', 'sarvesh107', 'prasad.creativity123', 'pritesh.roy27', 'rohitwaghmare1997', 'navneet.nrj', 'karishmahirve96', 'dwivedidaya1996', 'ameykokate2015', 'salianyatish111', None, 'shreyasgawali123', 'jayshreepakhare63']",41,"['sampadaphatak28', 'vallabhbudhkar', 'mbhosale863', 'ashishghoderao', 'sarveshbhoer158', 'pranaybhatkar', 'sarvesh107', 'shreya9609', 'ronraviram789', 'pritesh.roy27', 'bonhomie11', 'prasad.creativity123', 'imdevendra258', 'deshpande192', 'dipikapatil097', 'yashpimpale6', 'pawargeeta177', 'salianyatish111', 'nikamsupriya44', 'jayshreepakhare63', 'apurvaganu1996', 'sanketdamame', 'rincyj327', 'bolekunal42', 'rohitwaghmare1997', 'navneet.nrj', 'ganeshjadhav', 'abhishek2397', 'dwivedidaya1996', None, 'ameykokate2015', 'rawatchefchetan', 'prashant.khedkar', 'subodhsawant07', 'sudar', 'vishal8244', 'vinayak183', 'karishmahirve96', 'rashmithanair5', 'mitalihaldankar8', 'shreyasgawali123']"
25,57,25,65,22,"['gnthakore', 'samirbobade', 'mayanair1104', 'sjayyant31', 'thapa156', 'ashpillai.1996', 'aadi1212', 'vmundhe1234', 'mayureshnagvekar57', 'guptasandeep220', 'uyewale', 'komalsb37', 'gaikarprashant6', 'chavanv953', 'vaishak', 'vishwas', 'bkumar', 'komalsurve982', 'spolai', 'mdeshmukh', 'bhagyashree.narewade', 'jiteshutekar']",2,"['abhi96.diggewadi', 'crkarande28']",43,"['aniket_15', 'amal31', 'vishal914', 'thapabhavana13', 'pratik2225', 'ie2012.krishna.paryani', 'adsoni468', 'singh5987', 'pbhaveshv15et', 'yashvadkar6969', 'dheereshpoojary', 'ashetty07', 'deepalisingh195', 'sushantpawar2508', 'vinodnair46', 'pguleria', 'wtushart15e', 'mhaskaraditya21', 'zainawk0', 'prathemeshjd3200', 'tanmay9', 'pradipkumar200', 'sukhpreet11234kldfhd', 'shubham.patil585', 'gvishs15', 'jobin301', 'vjrasal1', 'bilalp188', 'autikiran77', 'nless363', 'mkhanvilkar', None, 'kurawless15ex', 'vishurajigare10', 'jas.sahmbi123', 'harish8528', 'rohitchaudhari10021996', 'anil8796069443', 'singhrajkarn1699', 'mankumre96', 'ladnishis15', 'shrutis31', 'tejdhupkar']",67,"['gnthakore', 'amal31', 'vishal914', 'thapabhavana13', 'samirbobade', 'pratik2225', 'sjayyant31', 'ashpillai.1996', 'singh5987', 'ashetty07', 'mayureshnagvekar57', 'vinodnair46', 'pguleria', 'mhaskaraditya21', 'zainawk0', 'prathemeshjd3200', 'gaikarprashant6', 'pradipkumar200', 'chavanv953', 'gvishs15', 'jobin301', 'vaishak', 'vishwas', 'komalsurve982', 'kurawless15ex', 'mdeshmukh', 'jas.sahmbi123', 'harish8528', 'rohitchaudhari10021996', 'anil8796069443', 'singhrajkarn1699', 'mankumre96', 'ladnishis15', 'shrutis31', 'bhagyashree.narewade', 'jiteshutekar', 'aniket_15', 'abhi96.diggewadi', 'mayanair1104', 'ie2012.krishna.paryani', 'thapa156', 'crkarande28', 'adsoni468', 'yashvadkar6969', 'aadi1212', 'vmundhe1234', 'guptasandeep220', 'deepalisingh195', 'dheereshpoojary', 'pbhaveshv15et', 'sushantpawar2508', 'wtushart15e', 'uyewale', 'komalsb37', 'tanmay9', 'sukhpreet11234kldfhd', 'shubham.patil585', 'vjrasal1', 'bilalp188', 'autikiran77', 'bkumar', 'nless363', 'mkhanvilkar', None, 'vishurajigare10', 'spolai', 'tejdhupkar']"
25,280,25,23,10,"['spolai', 'samirbobade', 'uyewale', 'mdeshmukh', 'thapa156', 'vaishak', 'jiteshutekar', 'bhagyashree.narewade', 'vmundhe1234', 'guptasandeep220']",14,"['gnthakore', 'abhi96.diggewadi', 'chavanv953', 'mayanair1104', 'ashpillai.1996', 'sjayyant31', 'crkarande28', 'komalsb37', 'vishwas', 'bkumar', 'komalsurve982', 'gaikarprashant6', 'aadi1212', 'mayureshnagvekar57']",13,"['zkhan', 'pravingowda28', 'deeptimenon', 'vaitysushant', 'suhayl4k', 'yadavsandeep793', 'mihirkharkar', 'urshruti69', 'jagiipanda1611', 'mayankjha0221', 'spandharkame', None, 'bnrnirmal94']",37,"['gnthakore', 'abhi96.diggewadi', 'vaitysushant', 'samirbobade', 'mayanair1104', 'sjayyant31', 'thapa156', 'ashpillai.1996', 'crkarande28', 'urshruti69', 'mayankjha0221', 'spandharkame', 'aadi1212', 'vmundhe1234', 'guptasandeep220', 'mayureshnagvekar57', 'bnrnirmal94', 'zkhan', 'pravingowda28', 'uyewale', 'mihirkharkar', 'komalsb37', 'gaikarprashant6', 'chavanv953', 'vaishak', 'vishwas', 'jagiipanda1611', 'bkumar', 'komalsurve982', None, 'spolai', 'mdeshmukh', 'suhayl4k', 'yadavsandeep793', 'bhagyashree.narewade', 'jiteshutekar', 'deeptimenon']"
25,278,25,20,10,"['chavanv953', 'mayanair1104', 'sjayyant31', 'ashpillai.1996', 'komalsb37', 'vishwas', 'bkumar', 'komalsurve982', 'aadi1212', 'mayureshnagvekar57']",14,"['gnthakore', 'abhi96.diggewadi', 'spolai', 'samirbobade', 'uyewale', 'mdeshmukh', 'thapa156', 'crkarande28', 'vaishak', 'jiteshutekar', 'bhagyashree.narewade', 'gaikarprashant6', 'vmundhe1234', 'guptasandeep220']",10,"['rakesh.shinde65', 'omkarcrenavikar', 'beelectronics0', 'ananth33', 'sayaligite11', 'ganesh160194', 'rnair10', 'ninawe14', 'sandhya.rathore14', None]",34,"['gnthakore', 'abhi96.diggewadi', 'omkarcrenavikar', 'samirbobade', 'mayanair1104', 'sjayyant31', 'thapa156', 'ashpillai.1996', 'crkarande28', 'aadi1212', 'vmundhe1234', 'guptasandeep220', 'mayureshnagvekar57', 'ananth33', 'uyewale', 'ninawe14', 'komalsb37', 'gaikarprashant6', 'chavanv953', 'beelectronics0', 'rnair10', 'vaishak', 'sandhya.rathore14', 'vishwas', 'bkumar', 'komalsurve982', None, 'rakesh.shinde65', 'sayaligite11', 'spolai', 'mdeshmukh', 'ganesh160194', 'bhagyashree.narewade', 'jiteshutekar']"
25,63,25,9,4,"['mdeshmukh', 'uyewale', 'vmundhe1234', 'gaikarprashant6']",20,"['gnthakore', 'abhi96.diggewadi', 'samirbobade', 'mayanair1104', 'sjayyant31', 'thapa156', 'ashpillai.1996', 'crkarande28', 'aadi1212', 'mayureshnagvekar57', 'guptasandeep220', 'komalsb37', 'chavanv953', 'vaishak', 'vishwas', 'bkumar', 'komalsurve982', 'spolai', 'bhagyashree.narewade', 'jiteshutekar']",5,"['yadavsandeep793', 'dhruv16', 'snehavijan60', 'tushar.wadhaval', None]",29,"['gnthakore', 'abhi96.diggewadi', 'chavanv953', 'samirbobade', 'mayanair1104', 'sjayyant31', 'thapa156', 'ashpillai.1996', 'crkarande28', 'vaishak', 'dhruv16', 'vishwas', 'bkumar', 'tushar.wadhaval', 'komalsurve982', 'aadi1212', 'vmundhe1234', 'guptasandeep220', 'mayureshnagvekar57', None, 'spolai', 'uyewale', 'mdeshmukh', 'yadavsandeep793', 'komalsb37', 'snehavijan60', 'bhagyashree.narewade', 'gaikarprashant6', 'jiteshutekar']"
25,279,25,9,4,"['mdeshmukh', 'uyewale', 'vmundhe1234', 'gaikarprashant6']",20,"['gnthakore', 'abhi96.diggewadi', 'samirbobade', 'mayanair1104', 'sjayyant31', 'thapa156', 'ashpillai.1996', 'crkarande28', 'aadi1212', 'mayureshnagvekar57', 'guptasandeep220', 'komalsb37', 'chavanv953', 'vaishak', 'vishwas', 'bkumar', 'komalsurve982', 'spolai', 'bhagyashree.narewade', 'jiteshutekar']",5,"['yadavsandeep793', 'dhruv16', 'snehavijan60', 'tushar.wadhaval', None]",29,"['gnthakore', 'abhi96.diggewadi', 'chavanv953', 'samirbobade', 'mayanair1104', 'sjayyant31', 'thapa156', 'ashpillai.1996', 'crkarande28', 'vaishak', 'dhruv16', 'vishwas', 'bkumar', 'tushar.wadhaval', 'komalsurve982', 'aadi1212', 'vmundhe1234', 'guptasandeep220', 'mayureshnagvekar57', None, 'spolai', 'uyewale', 'mdeshmukh', 'yadavsandeep793', 'komalsb37', 'snehavijan60', 'bhagyashree.narewade', 'gaikarprashant6', 'jiteshutekar']"
26,57,25,65,24,"['vishal914', 'thapabhavana13', 'pratik2225', 'pbhaveshv15et', 'yashvadkar6969', 'ashetty07', 'deepalisingh195', 'sushantpawar2508', 'wtushart15e', 'mhaskaraditya21', 'prathemeshjd3200', 'shubham.patil585', 'gvishs15', 'vjrasal1', 'nless363', 'mkhanvilkar', 'kurawless15ex', 'vishurajigare10', 'jas.sahmbi123', 'rohitchaudhari10021996', 'anil8796069443', 'mankumre96', 'ladnishis15', 'shrutis31']",0,[],41,"['aniket_15', 'gnthakore', 'amal31', 'samirbobade', 'mayanair1104', 'ashpillai.1996', 'sjayyant31', 'ie2012.krishna.paryani', 'thapa156', 'adsoni468', 'singh5987', 'aadi1212', 'vmundhe1234', 'guptasandeep220', 'dheereshpoojary', 'mayureshnagvekar57', 'vinodnair46', 'pguleria', 'uyewale', 'komalsb37', 'zainawk0', 'gaikarprashant6', 'tanmay9', 'pradipkumar200', 'sukhpreet11234kldfhd', 'chavanv953', 'jobin301', 'vaishak', 'bilalp188', 'vishwas', 'autikiran77', 'bkumar', 'komalsurve982', None, 'spolai', 'mdeshmukh', 'harish8528', 'singhrajkarn1699', 'bhagyashree.narewade', 'jiteshutekar', 'tejdhupkar']",65,"['gnthakore', 'amal31', 'vishal914', 'thapabhavana13', 'samirbobade', 'pratik2225', 'ashpillai.1996', 'sjayyant31', 'singh5987', 'ashetty07', 'mayureshnagvekar57', 'vinodnair46', 'pguleria', 'mhaskaraditya21', 'zainawk0', 'prathemeshjd3200', 'gaikarprashant6', 'pradipkumar200', 'chavanv953', 'gvishs15', 'jobin301', 'vaishak', 'vishwas', 'komalsurve982', 'kurawless15ex', 'mdeshmukh', 'jas.sahmbi123', 'harish8528', 'rohitchaudhari10021996', 'anil8796069443', 'mankumre96', 'ladnishis15', 'singhrajkarn1699', 'shrutis31', 'bhagyashree.narewade', 'jiteshutekar', 'aniket_15', 'mayanair1104', 'ie2012.krishna.paryani', 'thapa156', 'adsoni468', 'yashvadkar6969', 'pbhaveshv15et', 'deepalisingh195', 'aadi1212', 'dheereshpoojary', 'vmundhe1234', 'sushantpawar2508', 'guptasandeep220', 'wtushart15e', 'uyewale', 'komalsb37', 'tanmay9', 'sukhpreet11234kldfhd', 'shubham.patil585', 'vjrasal1', 'bilalp188', 'autikiran77', 'bkumar', 'nless363', 'mkhanvilkar', None, 'vishurajigare10', 'spolai', 'tejdhupkar']"
27,240,25,8,7,"['krebs1', 'atellit', 'trevinon', 'cross23', 'hess35', 'cortez10', 'robin295']",17,"['wang2700', 'gross51', 'juanseramirez1', 'mturenn', 'mcintyr2', 'lshp2210', 'chage', 'eheikens', 'samuelc', 'hutchi15', 'jganley', 'rnaon', 'praja', 'dbecktell', 'krousgri', 'kamranahmed', 'short44']",1,[None],25,"['gross51', 'juanseramirez1', 'lshp2210', 'cross23', 'trevinon', 'eheikens', 'samuelc', 'hutchi15', 'hess35', 'jganley', 'rnaon', 'robin295', 'dbecktell', 'krousgri', None, 'short44', 'chage', 'krebs1', 'wang2700', 'mcintyr2', 'mturenn', 'atellit', 'cortez10', 'praja', 'kamranahmed']"
28,134,24,18,7,"['exericex', 'exeric', 'aeja0520', 'yoonjee26', 'wjddlwp', 'rlawlgks147', 'god23213']",16,"['baccar_noura', 'saumipadeer', 'dkenl62', 'thestellarguy', 'saketdpandey1', 'leeyb39', 'satyanarayanpande', 'virajsanghvicool09', 'wnslekd89', 'forever1601', 'lalitambikap', 'dalaiashmita97', 'mind12230', 'pathakshubham17', 'sanjeevanichaudhari999', 'sahilanande96']",11,"['jungchun94', 'wsmwsm10', 'pasu5625', 'gtkim4617', 'skyship0415', 'tlsdhrwn777', 'hshan1115', '93seongyun', 'true1326', None, 'austin7']",34,"['baccar_noura', 'exericex', 'dkenl62', 'saketdpandey1', 'virajsanghvicool09', 'wnslekd89', 'skyship0415', 'tlsdhrwn777', 'hshan1115', 'yoonjee26', 'pathakshubham17', 'sanjeevanichaudhari999', 'thestellarguy', 'wsmwsm10', 'gtkim4617', 'satyanarayanpande', 'forever1601', 'lalitambikap', 'mind12230', 'rlawlgks147', 'sahilanande96', 'pasu5625', 'aeja0520', 'true1326', 'leeyb39', None, 'god23213', 'austin7', 'jungchun94', 'saumipadeer', 'exeric', 'dalaiashmita97', '93seongyun', 'wjddlwp']"
28,133,24,12,5,"['dkenl62', 'mind12230', 'forever1601', 'wnslekd89', 'leeyb39']",18,"['baccar_noura', 'exericex', 'saumipadeer', 'thestellarguy', 'saketdpandey1', 'exeric', 'satyanarayanpande', 'virajsanghvicool09', 'dalaiashmita97', 'lalitambikap', 'yoonjee26', 'aeja0520', 'wjddlwp', 'rlawlgks147', 'pathakshubham17', 'sanjeevanichaudhari999', 'god23213', 'sahilanande96']",7,"['jungchun94', 'rhddlrrhdrns098', 'gtkim4617', 'cgrandsoul', '93seongyun', None, 'rh8963']",30,"['baccar_noura', 'exericex', 'dkenl62', 'rhddlrrhdrns098', 'saketdpandey1', 'virajsanghvicool09', 'wnslekd89', 'cgrandsoul', 'yoonjee26', 'aeja0520', 'leeyb39', 'pathakshubham17', 'sanjeevanichaudhari999', 'god23213', None, 'rh8963', 'jungchun94', 'saumipadeer', 'thestellarguy', 'exeric', 'satyanarayanpande', 'forever1601', 'dalaiashmita97', 'gtkim4617', 'lalitambikap', '93seongyun', 'wjddlwp', 'mind12230', 'rlawlgks147', 'sahilanande96']"
28,131,24,11,6,"['saumipadeer', 'thestellarguy', 'saketdpandey1', 'virajsanghvicool09', 'sanjeevanichaudhari999', 'sahilanande96']",17,"['baccar_noura', 'exericex', 'dkenl62', 'leeyb39', 'exeric', 'satyanarayanpande', 'forever1601', 'wnslekd89', 'dalaiashmita97', 'lalitambikap', 'yoonjee26', 'aeja0520', 'wjddlwp', 'mind12230', 'rlawlgks147', 'pathakshubham17', 'god23213']",5,"['komal2015patil', 'sagarnm308', 'komalmahajan1197', None, 'yash.shirke9623']",28,"['baccar_noura', 'exericex', 'dkenl62', 'saketdpandey1', 'virajsanghvicool09', 'wnslekd89', 'komal2015patil', 'sagarnm308', 'yoonjee26', 'aeja0520', 'leeyb39', 'komalmahajan1197', 'pathakshubham17', 'sanjeevanichaudhari999', 'god23213', 'yash.shirke9623', None, 'saumipadeer', 'thestellarguy', 'exeric', 'satyanarayanpande', 'forever1601', 'dalaiashmita97', 'lalitambikap', 'wjddlwp', 'mind12230', 'rlawlgks147', 'sahilanande96']"
28,135,24,10,4,"['pathakshubham17', 'saumipadeer', 'dalaiashmita97', 'satyanarayanpande']",19,"['baccar_noura', 'exericex', 'dkenl62', 'saketdpandey1', 'virajsanghvicool09', 'wnslekd89', 'yoonjee26', 'sanjeevanichaudhari999', 'thestellarguy', 'forever1601', 'lalitambikap', 'mind12230', 'rlawlgks147', 'sahilanande96', 'aeja0520', 'leeyb39', 'god23213', 'exeric', 'wjddlwp']",6,"['adityamhatre68', 'sagarnm308', 'virajsanghvi09', 'jheelnagaria', None, 'dharan_shah']",29,"['baccar_noura', 'exericex', 'dkenl62', 'saketdpandey1', 'virajsanghvi09', 'virajsanghvicool09', 'wnslekd89', 'sagarnm308', 'yoonjee26', 'aeja0520', 'leeyb39', 'pathakshubham17', 'sanjeevanichaudhari999', 'god23213', None, 'dharan_shah', 'adityamhatre68', 'saumipadeer', 'thestellarguy', 'exeric', 'satyanarayanpande', 'forever1601', 'dalaiashmita97', 'lalitambikap', 'jheelnagaria', 'wjddlwp', 'mind12230', 'rlawlgks147', 'sahilanande96']"
29,161,23,35,18,"['djlinz', 'aml18', 'edgar916m', 'johnyu', 'glahti', 'evalyu', 'gfabian', 'mwz99', 'erdeme95616', 'jmizutan', 'rychu12', 'bpbrocke', 'jonthomas', 'yuhao96', 'samadsen', 'phamgk', 'zajin97', 'quynhha']",4,"['jmchristiansensalameh', 'nbalbayati', 'chengxu2', 'ludnguyen']",17,"['qycjerry', 'chhliu', 'zsl510705', 'flare791', 'calcarb', 'hannahhhr', 'jtmulvey', 'sg630', 'song9194', 'yhcheng', 'jhazeghazam', 'sfoster15', 'jgdoran', 'ohyli1997', None, 'poonam97', 'mbyazidi']",39,"['edgar916m', 'flare791', 'glahti', 'evalyu', 'erdeme95616', 'jmizutan', 'chengxu2', 'rychu12', 'sfoster15', 'ohyli1997', 'djlinz', 'chhliu', 'zsl510705', 'calcarb', 'gfabian', 'ludnguyen', 'yhcheng', 'yuhao96', 'poonam97', 'qycjerry', 'aml18', 'hannahhhr', 'sg630', 'bpbrocke', 'jonthomas', 'song9194', 'samadsen', 'nbalbayati', None, 'jgdoran', 'quynhha', 'mbyazidi', 'johnyu', 'jtmulvey', 'mwz99', 'phamgk', 'jhazeghazam', 'jmchristiansensalameh', 'zajin97']"
29,163,23,21,20,"['edgar916m', 'glahti', 'erdeme95616', 'jmizutan', 'rychu12', 'djlinz', 'gfabian', 'ludnguyen', 'yuhao96', 'aml18', 'jonthomas', 'bpbrocke', 'samadsen', 'nbalbayati', 'quynhha', 'johnyu', 'mwz99', 'phamgk', 'jmchristiansensalameh', 'zajin97']",2,"['evalyu', 'chengxu2']",1,[None],23,"['edgar916m', 'glahti', 'evalyu', 'erdeme95616', 'jmizutan', 'chengxu2', 'rychu12', 'djlinz', 'gfabian', 'ludnguyen', 'yuhao96', 'aml18', 'bpbrocke', 'jonthomas', 'samadsen', 'nbalbayati', None, 'quynhha', 'johnyu', 'mwz99', 'phamgk', 'jmchristiansensalameh', 'zajin97']"
29,162,23,8,6,"['evalyu', 'gfabian', 'jonthomas', 'erdeme95616', 'rychu12', 'yuhao96']",16,"['djlinz', 'aml18', 'edgar916m', 'johnyu', 'glahti', 'mwz99', 'bpbrocke', 'jmizutan', 'chengxu2', 'ludnguyen', 'samadsen', 'phamgk', 'jmchristiansensalameh', 'nbalbayati', 'zajin97', 'quynhha']",2,"['erdemnano', None]",24,"['aml18', 'edgar916m', 'glahti', 'evalyu', 'erdeme95616', 'jmizutan', 'chengxu2', 'rychu12', 'bpbrocke', 'jonthomas', 'samadsen', 'nbalbayati', None, 'quynhha', 'djlinz', 'johnyu', 'erdemnano', 'gfabian', 'mwz99', 'phamgk', 'ludnguyen', 'yuhao96', 'jmchristiansensalameh', 'zajin97']"
31,302,23,9,7,"['rongtao327', 'vermouthday', 'wilbergerrard', 'juh79', 'cong123', 'zhw3953', 'tdb32']",15,"['thangameeran', 'lee2839', 'psacco', 'reiter0', 'ruijisun', 'wang3076', 'biechaoxi', 'sellierh', 'tonytaft78', 'tewfik79', 'vinay.teagasc', 'ma512', 'will2', 'mousey_like_music', 'yus72']",2,"['krb104', None]",24,"['ruijisun', 'wang3076', 'biechaoxi', 'sellierh', 'juh79', 'tewfik79', 'cong123', 'will2', 'mousey_like_music', None, 'zhw3953', 'yus72', 'rongtao327', 'tdb32', 'lee2839', 'psacco', 'reiter0', 'vermouthday', 'krb104', 'wilbergerrard', 'tonytaft78', 'vinay.teagasc', 'ma512', 'thangameeran']"
31,301,23,7,6,"['rongtao327', 'vermouthday', 'wilbergerrard', 'juh79', 'cong123', 'yus72']",16,"['lee2839', 'psacco', 'reiter0', 'ruijisun', 'wang3076', 'biechaoxi', 'sellierh', 'tonytaft78', 'tewfik79', 'vinay.teagasc', 'ma512', 'will2', 'tdb32', 'mousey_like_music', 'zhw3953', 'thangameeran']",1,[None],23,"['ruijisun', 'wang3076', 'biechaoxi', 'sellierh', 'juh79', 'tewfik79', 'cong123', 'will2', 'mousey_like_music', None, 'zhw3953', 'yus72', 'rongtao327', 'tdb32', 'lee2839', 'psacco', 'reiter0', 'vermouthday', 'wilbergerrard', 'tonytaft78', 'vinay.teagasc', 'ma512', 'thangameeran']"
32,159,22,40,21,"['payne68', 'mbalog', 'mtan05280528', 'bprestin', 'cervantd', 'rmaccion', 'wu795', 'rskoog', 'ma529', 'giesler', 'cknechte', 'morgoncosby', 'kboateng', 'peck11', 'clark485', 'ray76', 'sheng18', 'kjacobi', 'psteckle', 'morri382', 'akunzman']",0,[],19,"['sachdev0', 'rleather', 'pkurczek', 'titus9', 'dshoue', 'owellbor', 'pangn', 'melvin3', 'mserewic', None, 'lucast', 'gray164', 'davidjohnson', 'rsabatel', 'white494', 'pike10', 'su107', 'keener0', 'mason92']",40,"['payne68', 'sachdev0', 'mbalog', 'mtan05280528', 'bprestin', 'rleather', 'mason92', 'cervantd', 'pkurczek', 'wu795', 'rmaccion', 'titus9', 'rskoog', 'ma529', 'giesler', 'dshoue', 'cknechte', 'morgoncosby', 'kboateng', 'owellbor', 'pangn', 'peck11', 'melvin3', 'mserewic', 'ray76', 'clark485', 'sheng18', None, 'lucast', 'gray164', 'davidjohnson', 'kjacobi', 'rsabatel', 'white494', 'pike10', 'su107', 'keener0', 'psteckle', 'morri382', 'akunzman']"
32,226,22,38,21,"['payne68', 'mbalog', 'mtan05280528', 'bprestin', 'cervantd', 'rmaccion', 'wu795', 'rskoog', 'ma529', 'giesler', 'cknechte', 'morgoncosby', 'kboateng', 'peck11', 'clark485', 'ray76', 'sheng18', 'kjacobi', 'psteckle', 'morri382', 'akunzman']",0,[],17,"['gray164', 'owellbor', None, 'pangn', 'rsabatel', 'white494', 'pike10', 'sachdev0', 'melvin3', 'su107', 'mserewic', 'dshoue', 'rleather', 'keener0', 'pkurczek', 'mason92', 'lucast']",38,"['payne68', 'sachdev0', 'mbalog', 'mtan05280528', 'bprestin', 'rleather', 'mason92', 'cervantd', 'pkurczek', 'wu795', 'rmaccion', 'rskoog', 'ma529', 'giesler', 'dshoue', 'cknechte', 'morgoncosby', 'kboateng', 'owellbor', 'pangn', 'peck11', 'melvin3', 'mserewic', 'ray76', 'clark485', 'sheng18', None, 'lucast', 'gray164', 'kjacobi', 'rsabatel', 'white494', 'pike10', 'su107', 'keener0', 'psteckle', 'morri382', 'akunzman']"
32,99,22,17,2,"['rmaccion', 'akunzman']",19,"['payne68', 'mbalog', 'mtan05280528', 'bprestin', 'cervantd', 'wu795', 'rskoog', 'ma529', 'giesler', 'cknechte', 'morgoncosby', 'kboateng', 'peck11', 'clark485', 'ray76', 'sheng18', 'kjacobi', 'psteckle', 'morri382']",15,"['tgoldbe', None, 'pangn', 'kkurpius', 'wu801', 'saldwin', 'zhan2536', 'dinino', 'dtisdale', 'mill1914', 'dbradbu', 'iaranadi', 'rleather', 'petrosky', 'mbanerje']",36,"['payne68', 'mbalog', 'mtan05280528', 'bprestin', 'dbradbu', 'rleather', 'petrosky', 'cervantd', 'wu795', 'rmaccion', 'rskoog', 'ma529', 'kkurpius', 'saldwin', 'giesler', 'zhan2536', 'dtisdale', 'iaranadi', 'cknechte', 'morgoncosby', 'kboateng', 'pangn', 'peck11', 'mill1914', 'ray76', 'clark485', 'sheng18', 'mbanerje', None, 'tgoldbe', 'kjacobi', 'wu801', 'dinino', 'psteckle', 'morri382', 'akunzman']"
32,100,22,11,7,"['clark485', 'rmaccion', 'mtan05280528', 'ray76', 'sheng18', 'morri382', 'akunzman']",14,"['psteckle', 'rskoog', 'ma529', 'morgoncosby', 'peck11', 'kjacobi', 'payne68', 'giesler', 'mbalog', 'bprestin', 'kboateng', 'cknechte', 'cervantd', 'wu795']",4,"['su107', 'nmacke', 'keener0', None]",25,"['peck11', 'payne68', 'morri382', 'mbalog', 'mtan05280528', 'bprestin', 'ray76', 'clark485', 'cervantd', 'sheng18', 'wu795', 'rmaccion', 'nmacke', None, 'psteckle', 'rskoog', 'ma529', 'kjacobi', 'giesler', 'su107', 'keener0', 'cknechte', 'morgoncosby', 'kboateng', 'akunzman']"
32,160,22,9,6,"['rskoog', 'giesler', 'ray76', 'psteckle', 'sheng18', 'morri382']",15,"['ma529', 'morgoncosby', 'peck11', 'kjacobi', 'payne68', 'rmaccion', 'mbalog', 'mtan05280528', 'bprestin', 'kboateng', 'clark485', 'cknechte', 'cervantd', 'wu795', 'akunzman']",3,"[None, 'pangn', 'rleather']",24,"['pangn', 'peck11', 'payne68', 'morri382', 'mbalog', 'mtan05280528', 'bprestin', 'rleather', 'ray76', 'clark485', 'cervantd', 'sheng18', 'wu795', 'rmaccion', None, 'psteckle', 'rskoog', 'ma529', 'kjacobi', 'giesler', 'cknechte', 'morgoncosby', 'kboateng', 'akunzman']"
33,48,21,41,1,['rc.moreno1084'],19,"['arnab13', 'tahmeed997', 'conormck08', 'asif_tanmay', 'psychojisan', 'alistairjkho', 's.louerdi', 'topen33', 'muneeeb1002', 'ozgetopal9', 'lschumac', 'farhanfuad.abir', 'nasima', 'changniu.phys', 'varun.hemanth2016', 'rrcs.al', 'alvenleong67', 'miatrirhmn', 'zhelevnz']",40,"['lm.cruzh', 'luisaferplata', 'miguelangie', 'je.ovalles', 'edgarfpena', 'w.pantoja005', 'materiales2018', 'pa.mata', 'alvarocardona', 'medagorodavid', 'yeju16', 'tumamitaloka', 'voteportimo', 'hernandezjuandavid918', 'serranito', 'drhurtado', 'julissa.vigoya', 'am.bolivar', 'leonard.ruiz00', 'valeparra1999', 'se.alfonso', 's.devia10', 'holapincheputita', 'carlosan98', 'seturizo98', 'n.abril', 'juanseb4444', 'acostacpaulina', 'sramirezc2', 'dacosta', 'paulinaacostac', 'jchaparrog10', 'alejandroariaszuluaga', None, 'haroldsteven013', 'vitery', 'juanesdiaz98', 'polania.andres.a', 'jeisontimana', 'tovar96']",60,"['lm.cruzh', 'luisaferplata', 'miguelangie', 'je.ovalles', 'edgarfpena', 'arnab13', 'w.pantoja005', 'tahmeed997', 'materiales2018', 'pa.mata', 'alvarocardona', 'medagorodavid', 'yeju16', 'conormck08', 'tumamitaloka', 'voteportimo', 'asif_tanmay', 'hernandezjuandavid918', 'psychojisan', 'serranito', 'drhurtado', 'julissa.vigoya', 'alistairjkho', 'am.bolivar', 'leonard.ruiz00', 's.louerdi', 'valeparra1999', 'se.alfonso', 's.devia10', 'holapincheputita', 'topen33', 'carlosan98', 'seturizo98', 'n.abril', 'muneeeb1002', 'juanseb4444', 'acostacpaulina', 'sramirezc2', 'ozgetopal9', 'dacosta', 'paulinaacostac', 'jchaparrog10', 'lschumac', 'alejandroariaszuluaga', 'nasima', 'farhanfuad.abir', None, 'haroldsteven013', 'changniu.phys', 'varun.hemanth2016', 'rrcs.al', 'vitery', 'alvenleong67', 'juanesdiaz98', 'miatrirhmn', 'polania.andres.a', 'rc.moreno1084', 'zhelevnz', 'jeisontimana', 'tovar96']"
33,53,21,7,6,"['asif_tanmay', 'psychojisan', 'arnab13', 'miatrirhmn', 'tahmeed997', 'farhanfuad.abir']",14,"['conormck08', 'changniu.phys', 'varun.hemanth2016', 'rrcs.al', 'rc.moreno1084', 'ozgetopal9', 'alvenleong67', 'alistairjkho', 's.louerdi', 'lschumac', 'topen33', 'zhelevnz', 'nasima', 'muneeeb1002']",1,[None],21,"['ozgetopal9', 'arnab13', 'tahmeed997', 'lschumac', 'nasima', 'farhanfuad.abir', 'rc.moreno1084', None, 'conormck08', 'changniu.phys', 'varun.hemanth2016', 'asif_tanmay', 'rrcs.al', 'psychojisan', 'alvenleong67', 'miatrirhmn', 'alistairjkho', 's.louerdi', 'topen33', 'zhelevnz', 'muneeeb1002']"
34,245,21,11,9,"['erlin.nurlianti', 'haoze.yang', 'muhammad.naufal', 'muhammad.qureshi.1', 'emilie.dauzon', 'norah.alsadun', 'mossabalsaedi94', 'aya.saidi', 'diegorv']",11,"['reifenberger', 'julielyish', 'antonshimkevitch', 'abdulkhaleq.almansaf', 'nourhan.mo7amd', 'tkubis', 'chebotarev.sergei', 'haithamgaafer', 'bootcd', 'drsockr2000', 'taliya1022']",2,"[None, 'jawaher.almutlaq']",22,"['reifenberger', 'erlin.nurlianti', 'nourhan.mo7amd', 'emilie.dauzon', 'muhammad.qureshi.1', 'jawaher.almutlaq', 'norah.alsadun', 'mossabalsaedi94', 'diegorv', 'haithamgaafer', None, 'bootcd', 'taliya1022', 'julielyish', 'haoze.yang', 'antonshimkevitch', 'muhammad.naufal', 'abdulkhaleq.almansaf', 'tkubis', 'chebotarev.sergei', 'aya.saidi', 'drsockr2000']"
34,246,21,9,8,"['erlin.nurlianti', 'haoze.yang', 'abdulkhaleq.almansaf', 'muhammad.qureshi.1', 'emilie.dauzon', 'aya.saidi', 'mossabalsaedi94', 'diegorv']",12,"['reifenberger', 'julielyish', 'antonshimkevitch', 'muhammad.naufal', 'nourhan.mo7amd', 'norah.alsadun', 'tkubis', 'chebotarev.sergei', 'haithamgaafer', 'bootcd', 'drsockr2000', 'taliya1022']",1,[None],21,"['reifenberger', 'erlin.nurlianti', 'nourhan.mo7amd', 'emilie.dauzon', 'muhammad.qureshi.1', 'norah.alsadun', 'mossabalsaedi94', 'diegorv', 'haithamgaafer', None, 'bootcd', 'taliya1022', 'julielyish', 'haoze.yang', 'antonshimkevitch', 'muhammad.naufal', 'abdulkhaleq.almansaf', 'tkubis', 'chebotarev.sergei', 'aya.saidi', 'drsockr2000']"
35,247,21,13,11,"['baroo2tayyem2', 'hebaalrashed1651996', 'asdk1995', 'manarmaq96', 'khaledyj', 'sondosabohantash', 'loayaqa', 'waedyusef', 'totofrehat65', 'ranataqwa', 'hasanbat94']",9,"['fullmoon', 'jaygu', 'meghakhanna2011', 'prothweiler', 'rodrisanjm', 'angel145', 'gauravsinha2211', 'soufyane_7', '3ksnn64']",2,"['nalaqtash76', None]",22,"['baroo2tayyem2', 'asdk1995', 'manarmaq96', 'sondosabohantash', 'loayaqa', 'rodrisanjm', 'prothweiler', 'totofrehat65', 'gauravsinha2211', 'hasanbat94', None, 'fullmoon', 'hebaalrashed1651996', 'nalaqtash76', 'jaygu', 'khaledyj', 'meghakhanna2011', 'angel145', 'ranataqwa', 'soufyane_7', 'waedyusef', '3ksnn64']"
36,306,20,42,13,"['zhaohao9303', 'charlotte.phillips', 'ben951103', 'elp17fw', 'cphillips3', 'dwen3', 'richardfeng0052', 'cby32195', 'gary00101', 'yumingji123', 'nanahmadsufian1', 'dlwang', 'wang7705271']",6,"['arnabm.electinstru', 'sayantanpramanik97', 'dtquang', 'saran.usk', 'gholipour', 'vbhattac']",29,"['gary0010', 'jxie13', 'hzhou29', 'azpixy', 'gchen4', 'elt17bw', 'clostuard', 'ashz8888', 'xtan15', 'jiangtao', 'twang56', 'shanshuiyue', 'laplace_', 'thursika', 'yvonnee213', 'tanusharma', 'mirjiang', 'sxy4869', 'elp17ys', 'wd2lh', 'zhaomiaomiao', 'niknanohub', None, 'orzmissman', 'zhaohao', 'pfeng3', 'zimtiaz1', 'myu9', 'elq17cz']",48,"['gary0010', 'sayantanpramanik97', 'jxie13', 'gholipour', 'hzhou29', 'azpixy', 'gchen4', 'elt17bw', 'clostuard', 'dwen3', 'richardfeng0052', 'cby32195', 'ashz8888', 'xtan15', 'dlwang', 'jiangtao', 'twang56', 'wang7705271', 'shanshuiyue', 'zhaohao9303', 'charlotte.phillips', 'elp17fw', 'laplace_', 'thursika', 'gary00101', 'yvonnee213', 'tanusharma', 'saran.usk', 'nanahmadsufian1', 'mirjiang', 'sxy4869', 'elp17ys', 'wd2lh', 'zhaomiaomiao', 'niknanohub', None, 'vbhattac', 'ben951103', 'arnabm.electinstru', 'cphillips3', 'orzmissman', 'yumingji123', 'zhaohao', 'pfeng3', 'zimtiaz1', 'dtquang', 'myu9', 'elq17cz']"
37,125,19,24,16,"['aragom1', 'mccart2', 'lasseb1', 'morgaj7', 'reekj', 'fristerc', 'marqua2', 'tuqueroe', 'smithb25', 'munguia4', 'sama1', 'fredsteven12', 'dingal', 'arteaga52', 'djgraziano', 'butlerk2']",2,"['cordom1', 'bolormaa']",8,"['doniashlayan', 'ramirc5', 'cuicas', 'mejiar', 'joseemunguia', 'escoba3', None, 'jsdye2010']",26,"['morgaj7', 'doniashlayan', 'tuqueroe', 'bolormaa', 'djgraziano', 'mccart2', 'marqua2', 'smithb25', 'munguia4', 'ramirc5', 'fredsteven12', 'arteaga52', 'reekj', 'dingal', 'mejiar', 'cordom1', 'escoba3', None, 'jsdye2010', 'aragom1', 'lasseb1', 'fristerc', 'sama1', 'cuicas', 'joseemunguia', 'butlerk2']"
37,10,19,19,16,"['aragom1', 'mccart2', 'lasseb1', 'morgaj7', 'reekj', 'fristerc', 'marqua2', 'tuqueroe', 'smithb25', 'munguia4', 'sama1', 'fredsteven12', 'dingal', 'cordom1', 'djgraziano', 'butlerk2']",2,"['arteaga52', 'bolormaa']",3,"['morga', None, 'patelp3']",21,"['morgaj7', 'reekj', 'patelp3', 'tuqueroe', 'bolormaa', 'dingal', 'cordom1', 'djgraziano', None, 'aragom1', 'mccart2', 'lasseb1', 'fristerc', 'marqua2', 'smithb25', 'munguia4', 'sama1', 'fredsteven12', 'arteaga52', 'morga', 'butlerk2']"
37,212,19,11,1,['arteaga52'],17,"['aragom1', 'mccart2', 'lasseb1', 'morgaj7', 'reekj', 'fristerc', 'marqua2', 'tuqueroe', 'smithb25', 'munguia4', 'sama1', 'bolormaa', 'fredsteven12', 'dingal', 'cordom1', 'djgraziano', 'butlerk2']",10,"['doniashlayan', 'cuicas', 'oddmanout3', 'dunlar1', 'nanomaster', 'mejiar', 'jonathanmalta', 'escoba3', None, 'jsdye2010']",28,"['morgaj7', 'reekj', 'doniashlayan', 'tuqueroe', 'bolormaa', 'dingal', 'mejiar', 'cordom1', 'djgraziano', 'escoba3', None, 'jsdye2010', 'aragom1', 'mccart2', 'lasseb1', 'fristerc', 'marqua2', 'smithb25', 'munguia4', 'sama1', 'cuicas', 'oddmanout3', 'fredsteven12', 'dunlar1', 'arteaga52', 'jonathanmalta', 'butlerk2', 'nanomaster']"
38,319,18,20,15,"['mrajivmoorthy', 'zhangsf1988', 'ejmunoz3', 'emiolagunes', 'jpluce', 'sanjeevst', 'wilsonnater', 'aramac13', 'mk2018', 'msessim', 'skazemi', 'wuxin', 'fhilty', 'timjzl.albert', 'ximeng']",2,"['clee152', 'trinimartina18']",5,"['emarq', 'campos26', 'darkoscar', 'min.mohammadzadeh', None]",22,"['emarq', 'clee152', 'mrajivmoorthy', 'zhangsf1988', 'campos26', 'darkoscar', 'sanjeevst', 'min.mohammadzadeh', 'aramac13', 'mk2018', 'wuxin', 'jpluce', 'trinimartina18', None, 'ejmunoz3', 'emiolagunes', 'wilsonnater', 'msessim', 'skazemi', 'fhilty', 'timjzl.albert', 'ximeng']"
38,86,18,18,15,"['clee152', 'mrajivmoorthy', 'zhangsf1988', 'ejmunoz3', 'emiolagunes', 'jpluce', 'sanjeevst', 'wilsonnater', 'aramac13', 'mk2018', 'msessim', 'skazemi', 'fhilty', 'timjzl.albert', 'ximeng']",2,"['wuxin', 'trinimartina18']",3,"['min.mohammadzadeh', None, 'campos26']",20,"['clee152', 'mrajivmoorthy', 'zhangsf1988', 'campos26', 'sanjeevst', 'min.mohammadzadeh', 'aramac13', 'mk2018', 'wuxin', 'jpluce', 'trinimartina18', None, 'ejmunoz3', 'emiolagunes', 'wilsonnater', 'msessim', 'skazemi', 'fhilty', 'timjzl.albert', 'ximeng']"
38,183,18,18,16,"['clee152', 'mrajivmoorthy', 'zhangsf1988', 'ejmunoz3', 'emiolagunes', 'jpluce', 'sanjeevst', 'wilsonnater', 'aramac13', 'mk2018', 'msessim', 'skazemi', 'wuxin', 'fhilty', 'timjzl.albert', 'ximeng']",1,['trinimartina18'],2,"[None, 'campos26']",19,"['clee152', 'mrajivmoorthy', 'zhangsf1988', 'campos26', 'sanjeevst', 'aramac13', 'mk2018', 'wuxin', 'jpluce', 'trinimartina18', None, 'ejmunoz3', 'emiolagunes', 'wilsonnater', 'msessim', 'skazemi', 'fhilty', 'timjzl.albert', 'ximeng']"
38,320,18,15,13,"['clee152', 'mrajivmoorthy', 'ejmunoz3', 'emiolagunes', 'jpluce', 'sanjeevst', 'wilsonnater', 'msessim', 'aramac13', 'skazemi', 'fhilty', 'timjzl.albert', 'ximeng']",4,"['wuxin', 'trinimartina18', 'mk2018', 'zhangsf1988']",2,"[None, 'campos26']",19,"['clee152', 'mrajivmoorthy', 'zhangsf1988', 'campos26', 'sanjeevst', 'aramac13', 'mk2018', 'wuxin', 'jpluce', 'trinimartina18', None, 'ejmunoz3', 'emiolagunes', 'wilsonnater', 'msessim', 'skazemi', 'fhilty', 'timjzl.albert', 'ximeng']"
39,238,18,18,16,"['mayuripatil', 'janani96', 'apapale1', 'cadwellryanj', 'dyogind', 'akanksha893', 'prasanth4477', 'grule1', 'maitrey27', 'nkdaniel95', 'awalwai1', 'mgill4', 'mmdoza18', 'mjani1', 'singlet', 'jasoneph']",1,['jmckenn3'],2,"[None, 'rgalisa']",19,"['mayuripatil', 'janani96', 'apapale1', 'rgalisa', 'grule1', 'awalwai1', 'mmdoza18', 'cadwellryanj', 'mjani1', 'dyogind', 'jasoneph', 'mgill4', None, 'jmckenn3', 'akanksha893', 'prasanth4477', 'maitrey27', 'nkdaniel95', 'singlet']"
39,141,18,17,16,"['mayuripatil', 'janani96', 'jmckenn3', 'dyogind', 'akanksha893', 'prasanth4477', 'grule1', 'maitrey27', 'nkdaniel95', 'mmdoza18', 'awalwai1', 'mgill4', 'cadwellryanj', 'mjani1', 'singlet', 'jasoneph']",1,['apapale1'],1,[None],18,"['mayuripatil', 'janani96', 'apapale1', 'grule1', 'awalwai1', 'mmdoza18', 'cadwellryanj', 'mjani1', 'dyogind', 'jasoneph', 'mgill4', None, 'jmckenn3', 'akanksha893', 'prasanth4477', 'maitrey27', 'nkdaniel95', 'singlet']"
39,232,18,17,16,"['mayuripatil', 'janani96', 'jmckenn3', 'dyogind', 'akanksha893', 'prasanth4477', 'grule1', 'maitrey27', 'nkdaniel95', 'mmdoza18', 'awalwai1', 'mgill4', 'cadwellryanj', 'mjani1', 'singlet', 'jasoneph']",1,['apapale1'],1,[None],18,"['mayuripatil', 'janani96', 'apapale1', 'grule1', 'awalwai1', 'mmdoza18', 'cadwellryanj', 'mjani1', 'dyogind', 'jasoneph', 'mgill4', None, 'jmckenn3', 'akanksha893', 'prasanth4477', 'maitrey27', 'nkdaniel95', 'singlet']"
40,24,18,18,13,"['verenafritz', 'fratschko', 'spital_t', 'seebac_m', 'sambucus33', 'dg053', 'indium3arsenid', 'reinli13', 'robert.koeberl', 'pirker_c', 'howland12', 'kzojer', 'chrispi']",4,"['julianpower', 'butej_b', 'b00050512', 'chrisi588']",5,"['matthias_w', 'feyer', 'martin92', 'fl0_pi', None]",22,"['verenafritz', 'fratschko', 'feyer', 'julianpower', 'sambucus33', 'martin92', 'dg053', 'butej_b', 'howland12', None, 'spital_t', 'matthias_w', 'seebac_m', 'b00050512', 'chrispi', 'indium3arsenid', 'reinli13', 'robert.koeberl', 'fl0_pi', 'pirker_c', 'kzojer', 'chrisi588']"
40,25,18,14,7,"['verenafritz', 'seebac_m', 'reinli13', 'indium3arsenid', 'howland12', 'spital_t', 'chrisi588']",10,"['fratschko', 'julianpower', 'b00050512', 'sambucus33', 'dg053', 'butej_b', 'robert.koeberl', 'pirker_c', 'kzojer', 'chrispi']",7,"['dg0530814', 'nikolaus.czepl', 'feyer', 'wbodlo21', 'vicarius', 'fl0_pi', None]",24,"['verenafritz', 'fratschko', 'dg0530814', 'nikolaus.czepl', 'feyer', 'vicarius', 'julianpower', 'sambucus33', 'dg053', 'butej_b', 'wbodlo21', 'howland12', None, 'spital_t', 'seebac_m', 'b00050512', 'chrispi', 'indium3arsenid', 'reinli13', 'robert.koeberl', 'fl0_pi', 'pirker_c', 'kzojer', 'chrisi588']"
40,191,18,11,8,"['verenafritz', 'seebac_m', 'b00050512', 'reinli13', 'indium3arsenid', 'howland12', 'spital_t', 'chrisi588']",9,"['fratschko', 'julianpower', 'sambucus33', 'dg053', 'butej_b', 'robert.koeberl', 'pirker_c', 'kzojer', 'chrispi']",3,"[None, 'feyer', 'vicarius']",20,"['verenafritz', 'fratschko', 'feyer', 'vicarius', 'julianpower', 'sambucus33', 'dg053', 'butej_b', 'howland12', None, 'spital_t', 'seebac_m', 'b00050512', 'chrispi', 'indium3arsenid', 'reinli13', 'robert.koeberl', 'pirker_c', 'kzojer', 'chrisi588']"
40,192,18,9,7,"['fratschko', 'sambucus33', 'dg053', 'butej_b', 'robert.koeberl', 'pirker_c', 'chrispi']",10,"['verenafritz', 'julianpower', 'spital_t', 'seebac_m', 'b00050512', 'indium3arsenid', 'reinli13', 'howland12', 'kzojer', 'chrisi588']",2,"['stef101', None]",19,"['verenafritz', 'fratschko', 'julianpower', 'sambucus33', 'dg053', 'butej_b', 'stef101', 'howland12', None, 'spital_t', 'seebac_m', 'b00050512', 'chrispi', 'indium3arsenid', 'reinli13', 'robert.koeberl', 'pirker_c', 'kzojer', 'chrisi588']"
41,337,18,12,9,"['mzt5', 'zs347', 'njt47', 'jcs694', 'uniqu123', 'ecd74', 'cliddell1', 'js3366', 'bk534']",8,"['lipai91', 'rohit.batra', 'carmen91', 'zgreenberg6', 'charles.cornet', 'mahokanji', 'chatain', 'jan.weinreich']",3,"['zw475', None, 'jz854']",20,"['zs347', 'carmen91', 'charles.cornet', 'ecd74', 'zgreenberg6', 'cliddell1', 'uniqu123', None, 'rohit.batra', 'lipai91', 'mzt5', 'jz854', 'njt47', 'zw475', 'jcs694', 'mahokanji', 'chatain', 'js3366', 'bk534', 'jan.weinreich']"
42,98,17,17,14,"['ehsan.moshkelgosha', 'stevejohns', 'naqsh.mansoor', 'jordanvandegrift', 'victoriavolk', 'jennyfothergill', 'muramutsa365', 'ajchristy47', 'jonhuff', 'scottbirks', 'drewlysne', 'indigocloud123', 'matthewgoelzer', 'satture5678']",2,"['bjkarki', 'i.sameutbouhaik']",3,"['saidarazaee', None, 'lanlibsu']",19,"['saidarazaee', 'stevejohns', 'jordanvandegrift', 'jonhuff', 'drewlysne', 'indigocloud123', 'ajchristy47', 'lanlibsu', None, 'satture5678', 'bjkarki', 'victoriavolk', 'ehsan.moshkelgosha', 'naqsh.mansoor', 'jennyfothergill', 'muramutsa365', 'i.sameutbouhaik', 'scottbirks', 'matthewgoelzer']"
42,296,17,15,12,"['bjkarki', 'ehsan.moshkelgosha', 'stevejohns', 'naqsh.mansoor', 'jordanvandegrift', 'victoriavolk', 'ajchristy47', 'jonhuff', 'scottbirks', 'drewlysne', 'matthewgoelzer', 'satture5678']",4,"['i.sameutbouhaik', 'indigocloud123', 'jennyfothergill', 'muramutsa365']",3,"['katiesautter1', None, 'jakesoares']",19,"['stevejohns', 'jordanvandegrift', 'jonhuff', 'drewlysne', 'indigocloud123', 'katiesautter1', 'ajchristy47', None, 'satture5678', 'bjkarki', 'victoriavolk', 'ehsan.moshkelgosha', 'naqsh.mansoor', 'jennyfothergill', 'muramutsa365', 'i.sameutbouhaik', 'scottbirks', 'jakesoares', 'matthewgoelzer']"
42,294,17,13,9,"['stevejohns', 'naqsh.mansoor', 'jordanvandegrift', 'jennyfothergill', 'jonhuff', 'scottbirks', 'indigocloud123', 'matthewgoelzer', 'satture5678']",7,"['bjkarki', 'ehsan.moshkelgosha', 'muramutsa365', 'i.sameutbouhaik', 'drewlysne', 'ajchristy47', 'victoriavolk']",4,"[None, 'vallejokevin3', 'jakesoares', 'lanlibsu']",20,"['stevejohns', 'vallejokevin3', 'jordanvandegrift', 'jonhuff', 'drewlysne', 'indigocloud123', 'ajchristy47', 'lanlibsu', None, 'satture5678', 'bjkarki', 'victoriavolk', 'ehsan.moshkelgosha', 'naqsh.mansoor', 'jennyfothergill', 'muramutsa365', 'i.sameutbouhaik', 'scottbirks', 'jakesoares', 'matthewgoelzer']"
42,293,17,8,6,"['ehsan.moshkelgosha', 'jordanvandegrift', 'scottbirks', 'drewlysne', 'ajchristy47', 'satture5678']",10,"['bjkarki', 'stevejohns', 'naqsh.mansoor', 'jennyfothergill', 'muramutsa365', 'jonhuff', 'i.sameutbouhaik', 'indigocloud123', 'matthewgoelzer', 'victoriavolk']",2,"[None, 'lanlibsu']",18,"['stevejohns', 'jordanvandegrift', 'jonhuff', 'drewlysne', 'indigocloud123', 'ajchristy47', 'lanlibsu', None, 'satture5678', 'bjkarki', 'victoriavolk', 'ehsan.moshkelgosha', 'naqsh.mansoor', 'jennyfothergill', 'muramutsa365', 'i.sameutbouhaik', 'scottbirks', 'matthewgoelzer']"
43,96,17,11,8,"['mbmeshuk', 'mahir.kabir', 'apecerakib', 'abdullahappliedphysics', 'sajiaafringlory26', 'iffat', 'sujan.ghosh31', 'sakin.sarwar1993']",8,"['amon_396', 'ucetian43', 'hira.apece.54', 'ferdousunivdhakaeee', 'tas1115096', 'gvurimi', 'ferdous.univdhaka.eee', 'hhouili41']",3,"['ashfaqohi5', None, 'shajjad3']",19,"['shajjad3', 'ferdousunivdhakaeee', 'tas1115096', 'apecerakib', 'abdullahappliedphysics', 'sujan.ghosh31', 'ferdous.univdhaka.eee', None, 'amon_396', 'mbmeshuk', 'ucetian43', 'hira.apece.54', 'mahir.kabir', 'ashfaqohi5', 'sajiaafringlory26', 'gvurimi', 'iffat', 'sakin.sarwar1993', 'hhouili41']"
43,97,17,9,8,"['amon_396', 'mbmeshuk', 'hira.apece.54', 'ferdousunivdhakaeee', 'tas1115096', 'abdullahappliedphysics', 'sajiaafringlory26', 'ferdous.univdhaka.eee']",8,"['ucetian43', 'mahir.kabir', 'apecerakib', 'gvurimi', 'iffat', 'sujan.ghosh31', 'sakin.sarwar1993', 'hhouili41']",1,[None],17,"['ferdousunivdhakaeee', 'tas1115096', 'apecerakib', 'abdullahappliedphysics', 'sujan.ghosh31', 'ferdous.univdhaka.eee', None, 'amon_396', 'mbmeshuk', 'ucetian43', 'hira.apece.54', 'mahir.kabir', 'sajiaafringlory26', 'gvurimi', 'iffat', 'sakin.sarwar1993', 'hhouili41']"
44,258,17,16,15,"['erika_chisag', 'andyvallejo', 'lema_fer999', 'jessyp19', 'navi', 'luismarin123', 'cristian17945', 'valeriucha', 'jenifferz', 'luisfernand', 'vito', 'josericardomorancabezas', 'kevinfvg1209', 'ricardomoran40', 'ivonnetoala']",1,['cdiaz'],1,[None],17,"['andyvallejo', 'jessyp19', 'cristian17945', 'valeriucha', 'jenifferz', 'luisfernand', 'josericardomorancabezas', 'kevinfvg1209', 'ricardomoran40', 'ivonnetoala', None, 'erika_chisag', 'cdiaz', 'lema_fer999', 'navi', 'luismarin123', 'vito']"
44,23,17,10,9,"['andyvallejo', 'luismarin123', 'lema_fer999', 'navi', 'cristian17945', 'jenifferz', 'kevinfvg1209', 'ricardomoran40', 'ivonnetoala']",7,"['erika_chisag', 'cdiaz', 'jessyp19', 'valeriucha', 'luisfernand', 'vito', 'josericardomorancabezas']",1,[None],17,"['andyvallejo', 'jessyp19', 'cristian17945', 'valeriucha', 'jenifferz', 'luisfernand', 'josericardomorancabezas', 'kevinfvg1209', 'ricardomoran40', 'ivonnetoala', None, 'erika_chisag', 'cdiaz', 'lema_fer999', 'navi', 'luismarin123', 'vito']"
44,259,17,10,8,"['erika_chisag', 'andyvallejo', 'luismarin123', 'jessyp19', 'lema_fer999', 'luisfernand', 'vito', 'ricardomoran40']",8,"['cdiaz', 'navi', 'cristian17945', 'valeriucha', 'jenifferz', 'josericardomorancabezas', 'kevinfvg1209', 'ivonnetoala']",2,"[None, 'valeriucha578']",18,"['andyvallejo', 'jessyp19', 'cristian17945', 'valeriucha', 'jenifferz', 'luisfernand', 'josericardomorancabezas', 'kevinfvg1209', 'ricardomoran40', 'ivonnetoala', None, 'erika_chisag', 'cdiaz', 'lema_fer999', 'navi', 'luismarin123', 'valeriucha578', 'vito']"
45,288,17,28,15,"['alwin1996', 'panchalparth417', 'css_', 'divyavkhandkar.me', 'saniyasnair', 'abhishekg', 'amolgolwankar', 'devashishmore478', 'chaitalivartak07', 'boy_with_nikon', 'abhijitharidas3107', 'devanshibhatt19', 'keshvis26', 'tanvinj1', 'varshada15']",1,['adityaprakash41'],13,"['purvikapatil', 'ruchira_ghule', 'akarnik.13', 'techn720ab', 'ninadsc96', 'pranu175', 'sumasalian96', 'niveshvaze', 'ravikapooooor', 'sukhmote1997', 'manassardar4444122', 'ajinkyasssyadav', None]",29,"['alwin1996', 'adityaprakash41', 'abhishekg', 'ravikapooooor', 'chaitalivartak07', 'keshvis26', 'purvikapatil', 'css_', 'divyavkhandkar.me', 'saniyasnair', 'varshada15', 'panchalparth417', 'devashishmore478', 'boy_with_nikon', 'abhijitharidas3107', 'ajinkyasssyadav', 'tanvinj1', None, 'ruchira_ghule', 'akarnik.13', 'techn720ab', 'ninadsc96', 'pranu175', 'amolgolwankar', 'niveshvaze', 'sukhmote1997', 'manassardar4444122', 'devanshibhatt19', 'sumasalian96']"
45,198,17,27,15,"['alwin1996', 'panchalparth417', 'css_', 'divyavkhandkar.me', 'saniyasnair', 'abhishekg', 'amolgolwankar', 'devashishmore478', 'chaitalivartak07', 'boy_with_nikon', 'abhijitharidas3107', 'devanshibhatt19', 'keshvis26', 'tanvinj1', 'varshada15']",1,['adityaprakash41'],12,"['purvikapatil', 'ruchira_ghule', 'akarnik.13', 'techn720ab', 'ninadsc96', 'pranu175', 'sumasalian96', 'niveshvaze', 'sukhmote1997', 'manassardar4444122', 'ajinkyasssyadav', None]",28,"['alwin1996', 'adityaprakash41', 'abhishekg', 'chaitalivartak07', 'keshvis26', 'purvikapatil', 'css_', 'divyavkhandkar.me', 'saniyasnair', 'varshada15', 'panchalparth417', 'devashishmore478', 'boy_with_nikon', 'abhijitharidas3107', 'ajinkyasssyadav', 'tanvinj1', None, 'ruchira_ghule', 'akarnik.13', 'techn720ab', 'ninadsc96', 'pranu175', 'amolgolwankar', 'niveshvaze', 'sukhmote1997', 'manassardar4444122', 'devanshibhatt19', 'sumasalian96']"
45,201,17,8,4,"['alwin1996', 'abhijitharidas3107', 'amolgolwankar', 'devashishmore478']",12,"['panchalparth417', 'css_', 'divyavkhandkar.me', 'saniyasnair', 'adityaprakash41', 'abhishekg', 'chaitalivartak07', 'boy_with_nikon', 'devanshibhatt19', 'keshvis26', 'tanvinj1', 'varshada15']",4,"['vidur888', 'pooja9702.pm', None, 'aditik2107']",20,"['alwin1996', 'panchalparth417', 'pooja9702.pm', 'aditik2107', 'adityaprakash41', 'abhishekg', 'devashishmore478', 'chaitalivartak07', 'boy_with_nikon', 'abhijitharidas3107', 'keshvis26', 'tanvinj1', None, 'css_', 'divyavkhandkar.me', 'saniyasnair', 'vidur888', 'amolgolwankar', 'devanshibhatt19', 'varshada15']"
45,290,17,6,2,"['alwin1996', 'amolgolwankar']",14,"['panchalparth417', 'css_', 'divyavkhandkar.me', 'saniyasnair', 'adityaprakash41', 'abhishekg', 'devashishmore478', 'chaitalivartak07', 'boy_with_nikon', 'abhijitharidas3107', 'devanshibhatt19', 'keshvis26', 'tanvinj1', 'varshada15']",4,"['vidur888', 'pooja9702.pm', None, 'aditik2107']",20,"['alwin1996', 'panchalparth417', 'pooja9702.pm', 'aditik2107', 'adityaprakash41', 'abhishekg', 'devashishmore478', 'chaitalivartak07', 'boy_with_nikon', 'abhijitharidas3107', 'keshvis26', 'tanvinj1', None, 'css_', 'divyavkhandkar.me', 'saniyasnair', 'vidur888', 'amolgolwankar', 'devanshibhatt19', 'varshada15']"
46,99,16,17,5,"['tgoldbe', 'kkurpius', 'iaranadi', 'petrosky', 'mbanerje']",10,"['smit2625', 'wheland', 'zieglert', 'john1879', 'mwardebe', 'mooar', 'king357', 'llahrma16', 'gerber24', 'amartint']",12,"[None, 'pangn', 'wu801', 'saldwin', 'zhan2536', 'dinino', 'dtisdale', 'mill1914', 'dbradbu', 'rleather', 'rmaccion', 'akunzman']",27,"['smit2625', 'wheland', 'zieglert', 'mooar', 'dbradbu', 'petrosky', 'rleather', 'rmaccion', 'kkurpius', 'saldwin', 'zhan2536', 'john1879', 'dtisdale', 'iaranadi', 'llahrma16', 'gerber24', 'amartint', 'pangn', 'mill1914', 'mbanerje', None, 'tgoldbe', 'wu801', 'dinino', 'mwardebe', 'king357', 'akunzman']"
47,251,16,37,15,"['ananna', 'shafinsaqib', 'aronnobiswas', 'zahid26islam', 'ridwan.ayon29', 'bulbul_islam', 'sunjida.nova', 'amahfuj898', 'tasnimmortuza', 'tuhin7109', 'atikur14eee', 'kazit7', 'rakibulrakib72', 'rinkuewu', 'saiful.tushar15935789']",0,[],22,"['hk6700', 'ryyan', 'nazmulhoda652', 'hamzabinahsan94', 'bulbulislam89', 'malihamarjanratree', 'namesaq', 'anikmahfuz', 'badrunnesataposi', 'riadazad.ewu', 'saikatsaha95', 'tanvir.ravin007', 'mdhossainali', 'luthful71', 'iftakhar42', 'moriom.akter', 'asr010395', None, 'samiaalam94', 'ahsan.jim25', 'faisal.ewu', 'samratewu']",37,"['hk6700', 'ryyan', 'nazmulhoda652', 'tasnimmortuza', 'tuhin7109', 'aronnobiswas', 'hamzabinahsan94', 'ridwan.ayon29', 'bulbulislam89', 'malihamarjanratree', 'namesaq', 'anikmahfuz', 'badrunnesataposi', 'shafinsaqib', 'riadazad.ewu', 'zahid26islam', 'saikatsaha95', 'bulbul_islam', 'tanvir.ravin007', 'amahfuj898', 'mdhossainali', 'luthful71', 'iftakhar42', 'moriom.akter', 'asr010395', None, 'ananna', 'samiaalam94', 'ahsan.jim25', 'sunjida.nova', 'faisal.ewu', 'atikur14eee', 'kazit7', 'samratewu', 'rakibulrakib72', 'rinkuewu', 'saiful.tushar15935789']"
47,70,16,36,15,"['ananna', 'shafinsaqib', 'aronnobiswas', 'zahid26islam', 'ridwan.ayon29', 'bulbul_islam', 'sunjida.nova', 'amahfuj898', 'tasnimmortuza', 'tuhin7109', 'atikur14eee', 'kazit7', 'rakibulrakib72', 'rinkuewu', 'saiful.tushar15935789']",0,[],21,"['hk6700', 'ryyan', 'nazmulhoda652', 'hamzabinahsan94', 'malihamarjanratree', 'namesaq', 'anikmahfuz', 'badrunnesataposi', 'riadazad.ewu', 'saikatsaha95', 'tanvir.ravin007', 'mdhossainali', 'luthful71', 'iftakhar42', 'moriom.akter', 'asr010395', None, 'samiaalam94', 'ahsan.jim25', 'faisal.ewu', 'samratewu']",36,"['hk6700', 'ryyan', 'nazmulhoda652', 'tasnimmortuza', 'tuhin7109', 'aronnobiswas', 'hamzabinahsan94', 'ridwan.ayon29', 'malihamarjanratree', 'namesaq', 'anikmahfuz', 'badrunnesataposi', 'shafinsaqib', 'riadazad.ewu', 'zahid26islam', 'saikatsaha95', 'bulbul_islam', 'tanvir.ravin007', 'amahfuj898', 'mdhossainali', 'luthful71', 'iftakhar42', 'moriom.akter', 'asr010395', None, 'ananna', 'samiaalam94', 'ahsan.jim25', 'sunjida.nova', 'faisal.ewu', 'atikur14eee', 'kazit7', 'samratewu', 'rakibulrakib72', 'rinkuewu', 'saiful.tushar15935789']"
47,137,16,30,15,"['ananna', 'shafinsaqib', 'aronnobiswas', 'zahid26islam', 'ridwan.ayon29', 'bulbul_islam', 'sunjida.nova', 'amahfuj898', 'tasnimmortuza', 'tuhin7109', 'atikur14eee', 'kazit7', 'rakibulrakib72', 'rinkuewu', 'saiful.tushar15935789']",0,[],15,"['samiaalam94', 'hamzabinahsan94', 'ahsan.jim25', 'ryyan', 'saikatsaha95', 'tanvir.ravin007', 'faisal.ewu', 'malihamarjanratree', 'namesaq', 'mdhossainali', 'luthful71', 'iftakhar42', 'samratewu', 'moriom.akter', None]",30,"['ryyan', 'tasnimmortuza', 'tuhin7109', 'aronnobiswas', 'hamzabinahsan94', 'ridwan.ayon29', 'malihamarjanratree', 'namesaq', 'shafinsaqib', 'zahid26islam', 'saikatsaha95', 'bulbul_islam', 'tanvir.ravin007', 'amahfuj898', 'mdhossainali', 'luthful71', 'iftakhar42', 'moriom.akter', None, 'ananna', 'samiaalam94', 'ahsan.jim25', 'sunjida.nova', 'faisal.ewu', 'atikur14eee', 'kazit7', 'samratewu', 'rakibulrakib72', 'rinkuewu', 'saiful.tushar15935789']"
48,292,16,20,6,"['mikechem', 'jeremyloden', 'ju94', 'alecgnn', 'bigtree', 'tc0471992']",9,"['frankhuang', 'indranil.mal', 'ezcostta', 'obuiu', 'chemprescigla', 'xpansa666', 'xfjin', 'mrlk22', 'soul_echo_sky']",14,"['rkhadka', None, 'rijankarkee', 'shattiquemsu2018', 'rajankhadka882', 'robert.mayanovic', 'nazmulph39', 'das.sanchali26', 'bjz0310', 'sakidja', 'sabilakader', 'nirmal098', 'muztobarabbani', 'mdashifanwar']",29,"['frankhuang', 'rkhadka', 'shattiquemsu2018', 'rajankhadka882', 'jeremyloden', 'chemprescigla', 'xpansa666', 'sabilakader', 'muztobarabbani', 'sakidja', 'nirmal098', 'rijankarkee', 'ezcostta', 'obuiu', 'xfjin', 'alecgnn', 'bigtree', 'soul_echo_sky', 'tc0471992', 'robert.mayanovic', None, 'mdashifanwar', 'mikechem', 'indranil.mal', 'nazmulph39', 'ju94', 'das.sanchali26', 'mrlk22', 'bjz0310']"
48,84,16,13,1,['ju94'],14,"['frankhuang', 'mikechem', 'indranil.mal', 'jeremyloden', 'ezcostta', 'obuiu', 'chemprescigla', 'alecgnn', 'xpansa666', 'xfjin', 'mrlk22', 'bigtree', 'soul_echo_sky', 'tc0471992']",12,"['rkhadka', 'muztobarabbani', None, 'rijankarkee', 'dhakal86', 'das.sanchali26', 'kartikghosh2008', 'sakidja', 'sabilakader', 'nirmal098', 'bjz0310', 'mdashifanwar']",27,"['frankhuang', 'rkhadka', 'rijankarkee', 'dhakal86', 'jeremyloden', 'ezcostta', 'obuiu', 'chemprescigla', 'alecgnn', 'xpansa666', 'xfjin', 'kartikghosh2008', 'bigtree', 'soul_echo_sky', 'tc0471992', 'sabilakader', None, 'muztobarabbani', 'mdashifanwar', 'mikechem', 'indranil.mal', 'ju94', 'das.sanchali26', 'mrlk22', 'sakidja', 'nirmal098', 'bjz0310']"
49,209,16,10,4,"['mtroll', 'nslagle', 'mandiediane', 'rpw32']",11,"['mbhattarai453', 'borjasepulveda', 'ahmed_ammar', 'stephanemonfray', 'reuven91', 'alex.mark.mars', 'talukder18', 'doclouis', 'ddkrut', 'nathan.butterfield', 's.hosseinkasaei']",6,"['joshualevan', 'cneum', 'siu852794109', 'sidell66', None, 'andipyle14']",21,"['mbhattarai453', 'cneum', 'ahmed_ammar', 'stephanemonfray', 'reuven91', 'alex.mark.mars', 'rpw32', 'mandiediane', 'nslagle', 'sidell66', 's.hosseinkasaei', 'joshualevan', None, 'andipyle14', 'borjasepulveda', 'mtroll', 'talukder18', 'doclouis', 'ddkrut', 'nathan.butterfield', 'siu852794109']"
50,57,16,65,1,['ie2012.krishna.paryani'],14,"['milunmoghe98', 'moka0707shi', 'apoorva.kelkar', 'sanjana.masurkar', 'pawan.sukhwani', 'darshana.mahajan', 'ssonali_21', 'shaanigwwass2', 'kushal.bhosale', 'kmamaniya', 'kapil.paliwal', 'ie2012.jibran.nakhwa', 'yogita.panmand', 'hashmeet.chaudhery']",64,"['gnthakore', 'amal31', 'vishal914', 'thapabhavana13', 'samirbobade', 'pratik2225', 'ashpillai.1996', 'sjayyant31', 'singh5987', 'ashetty07', 'mayureshnagvekar57', 'vinodnair46', 'pguleria', 'mhaskaraditya21', 'zainawk0', 'prathemeshjd3200', 'gaikarprashant6', 'pradipkumar200', 'chavanv953', 'gvishs15', 'jobin301', 'vaishak', 'vishwas', 'komalsurve982', 'kurawless15ex', 'mdeshmukh', 'jas.sahmbi123', 'harish8528', 'rohitchaudhari10021996', 'anil8796069443', 'singhrajkarn1699', 'mankumre96', 'ladnishis15', 'shrutis31', 'bhagyashree.narewade', 'jiteshutekar', 'aniket_15', 'mayanair1104', 'thapa156', 'adsoni468', 'yashvadkar6969', 'aadi1212', 'deepalisingh195', 'dheereshpoojary', 'pbhaveshv15et', 'vmundhe1234', 'sushantpawar2508', 'guptasandeep220', 'wtushart15e', 'uyewale', 'komalsb37', 'tanmay9', 'sukhpreet11234kldfhd', 'shubham.patil585', 'vjrasal1', 'bilalp188', 'autikiran77', 'bkumar', 'nless363', 'mkhanvilkar', None, 'vishurajigare10', 'spolai', 'tejdhupkar']",79,"['milunmoghe98', 'gnthakore', 'amal31', 'vishal914', 'thapabhavana13', 'samirbobade', 'pratik2225', 'darshana.mahajan', 'ssonali_21', 'ashpillai.1996', 'sjayyant31', 'kushal.bhosale', 'singh5987', 'ashetty07', 'mayureshnagvekar57', 'hashmeet.chaudhery', 'vinodnair46', 'pguleria', 'mhaskaraditya21', 'zainawk0', 'prathemeshjd3200', 'yogita.panmand', 'kapil.paliwal', 'gaikarprashant6', 'pradipkumar200', 'chavanv953', 'gvishs15', 'jobin301', 'sanjana.masurkar', 'vaishak', 'vishwas', 'ie2012.jibran.nakhwa', 'komalsurve982', 'kurawless15ex', 'mdeshmukh', 'pawan.sukhwani', 'jas.sahmbi123', 'harish8528', 'rohitchaudhari10021996', 'anil8796069443', 'singhrajkarn1699', 'mankumre96', 'ladnishis15', 'shrutis31', 'bhagyashree.narewade', 'jiteshutekar', 'aniket_15', 'mayanair1104', 'ie2012.krishna.paryani', 'thapa156', 'adsoni468', 'kmamaniya', 'yashvadkar6969', 'aadi1212', 'deepalisingh195', 'dheereshpoojary', 'pbhaveshv15et', 'vmundhe1234', 'sushantpawar2508', 'moka0707shi', 'apoorva.kelkar', 'guptasandeep220', 'wtushart15e', 'uyewale', 'komalsb37', 'tanmay9', 'sukhpreet11234kldfhd', 'shubham.patil585', 'vjrasal1', 'shaanigwwass2', 'bilalp188', 'autikiran77', 'bkumar', 'nless363', 'mkhanvilkar', None, 'vishurajigare10', 'spolai', 'tejdhupkar']"
50,68,16,19,1,['kmamaniya'],14,"['milunmoghe98', 'moka0707shi', 'apoorva.kelkar', 'sanjana.masurkar', 'pawan.sukhwani', 'ie2012.krishna.paryani', 'ssonali_21', 'darshana.mahajan', 'shaanigwwass2', 'kushal.bhosale', 'ie2012.jibran.nakhwa', 'kapil.paliwal', 'yogita.panmand', 'hashmeet.chaudhery']",18,"['shreyash112', 'swapnalimakdey25', 'shah.shivani1702', 'peterbraganza52', 'meet7', 'krexianclass', 'dcruzdylan50', 'riyakulkarni16021997', 'jonathanrjpereira', 'rubina15', 'senmathew329', 'treesaachu', 'marcmathew19', 'jmihavel', 'ahmedshabbir99', 'tinu', None, 'mugdhas2030']",33,"['milunmoghe98', 'shreyash112', 'meet7', 'ie2012.krishna.paryani', 'ssonali_21', 'darshana.mahajan', 'kushal.bhosale', 'kmamaniya', 'tinu', 'hashmeet.chaudhery', 'moka0707shi', 'apoorva.kelkar', 'senmathew329', 'marcmathew19', 'yogita.panmand', 'kapil.paliwal', 'ahmedshabbir99', 'mugdhas2030', 'swapnalimakdey25', 'krexianclass', 'dcruzdylan50', 'sanjana.masurkar', 'riyakulkarni16021997', 'shaanigwwass2', 'ie2012.jibran.nakhwa', 'jmihavel', None, 'shah.shivani1702', 'peterbraganza52', 'pawan.sukhwani', 'jonathanrjpereira', 'rubina15', 'treesaachu']"
50,67,16,16,4,"['shaanigwwass2', 'darshana.mahajan', 'ie2012.krishna.paryani', 'ssonali_21']",11,"['milunmoghe98', 'moka0707shi', 'apoorva.kelkar', 'sanjana.masurkar', 'pawan.sukhwani', 'kushal.bhosale', 'kmamaniya', 'kapil.paliwal', 'ie2012.jibran.nakhwa', 'yogita.panmand', 'hashmeet.chaudhery']",12,"['ssw10j', 'mihir.joshi', 'poojathorat157', 'siddharth.mundada', 'et2012.tejas.patil', 'ie2012.advait.mohile', 'nehal.jahagirdar', 'rushabh.patil', 'rhlklwr', 'akshaymane1296', None, 'supriya.palve']",27,"['milunmoghe98', 'ssw10j', 'poojathorat157', 'sanjana.masurkar', 'et2012.tejas.patil', 'ie2012.krishna.paryani', 'ssonali_21', 'darshana.mahajan', 'rushabh.patil', 'shaanigwwass2', 'kushal.bhosale', 'kmamaniya', 'ie2012.jibran.nakhwa', None, 'hashmeet.chaudhery', 'moka0707shi', 'apoorva.kelkar', 'mihir.joshi', 'siddharth.mundada', 'pawan.sukhwani', 'ie2012.advait.mohile', 'nehal.jahagirdar', 'rhlklwr', 'yogita.panmand', 'kapil.paliwal', 'akshaymane1296', 'supriya.palve']"
50,65,16,14,4,"['shaanigwwass2', 'pawan.sukhwani', 'kushal.bhosale', 'ssonali_21']",11,"['milunmoghe98', 'moka0707shi', 'apoorva.kelkar', 'sanjana.masurkar', 'ie2012.krishna.paryani', 'darshana.mahajan', 'kmamaniya', 'kapil.paliwal', 'ie2012.jibran.nakhwa', 'yogita.panmand', 'hashmeet.chaudhery']",10,"['shruti.g.shetty', 'sunny23', 'rutuja.pate', 'shamlishelar', 'rhlklwr', 'gaurav.mahajan', 'chetan.mhaske', None, 'prathamesh.prakash', 'supriya.palve']",25,"['milunmoghe98', 'sanjana.masurkar', 'ie2012.krishna.paryani', 'ssonali_21', 'darshana.mahajan', 'shaanigwwass2', 'kushal.bhosale', 'chetan.mhaske', 'kmamaniya', 'ie2012.jibran.nakhwa', None, 'hashmeet.chaudhery', 'shruti.g.shetty', 'moka0707shi', 'apoorva.kelkar', 'sunny23', 'rutuja.pate', 'pawan.sukhwani', 'shamlishelar', 'rhlklwr', 'gaurav.mahajan', 'yogita.panmand', 'kapil.paliwal', 'prathamesh.prakash', 'supriya.palve']"
50,59,16,10,4,"['kushal.bhosale', 'darshana.mahajan', 'ie2012.jibran.nakhwa', 'hashmeet.chaudhery']",11,"['milunmoghe98', 'moka0707shi', 'apoorva.kelkar', 'sanjana.masurkar', 'pawan.sukhwani', 'ie2012.krishna.paryani', 'ssonali_21', 'shaanigwwass2', 'kmamaniya', 'kapil.paliwal', 'yogita.panmand']",6,"['sanhita.bhagwat', 'rohan.pawar', 'shardulmalvankar2104', 'harini.iyer', 'sonali.kalbande', None]",21,"['milunmoghe98', 'sanjana.masurkar', 'sanhita.bhagwat', 'ie2012.krishna.paryani', 'ssonali_21', 'darshana.mahajan', 'shaanigwwass2', 'kushal.bhosale', 'kmamaniya', 'ie2012.jibran.nakhwa', 'harini.iyer', None, 'hashmeet.chaudhery', 'moka0707shi', 'apoorva.kelkar', 'pawan.sukhwani', 'rohan.pawar', 'yogita.panmand', 'kapil.paliwal', 'sonali.kalbande', 'shardulmalvankar2104']"
50,60,16,10,4,"['kushal.bhosale', 'darshana.mahajan', 'ie2012.jibran.nakhwa', 'hashmeet.chaudhery']",11,"['milunmoghe98', 'moka0707shi', 'apoorva.kelkar', 'sanjana.masurkar', 'pawan.sukhwani', 'ie2012.krishna.paryani', 'ssonali_21', 'shaanigwwass2', 'kmamaniya', 'kapil.paliwal', 'yogita.panmand']",6,"['abhishek.manurkar', None, 'chinmay.shetye', 'shardulmalvankar2104', 'sonali.kalbande', 'abhay.kshirsagar']",21,"['milunmoghe98', 'abhishek.manurkar', 'sanjana.masurkar', 'ie2012.krishna.paryani', 'ssonali_21', 'darshana.mahajan', 'shaanigwwass2', 'kushal.bhosale', 'kmamaniya', 'ie2012.jibran.nakhwa', None, 'hashmeet.chaudhery', 'moka0707shi', 'apoorva.kelkar', 'pawan.sukhwani', 'chinmay.shetye', 'yogita.panmand', 'kapil.paliwal', 'sonali.kalbande', 'shardulmalvankar2104', 'abhay.kshirsagar']"
50,66,16,10,2,"['pawan.sukhwani', 'ssonali_21']",13,"['milunmoghe98', 'moka0707shi', 'apoorva.kelkar', 'sanjana.masurkar', 'ie2012.krishna.paryani', 'darshana.mahajan', 'shaanigwwass2', 'kushal.bhosale', 'kmamaniya', 'kapil.paliwal', 'ie2012.jibran.nakhwa', 'yogita.panmand', 'hashmeet.chaudhery']",8,"['sahil.tasgavkar', 'gayatri.devadiga', 'rahul.yadav', 'poojathorat157', 'prachi.shinde', 'mayur_sn', None, 'sunny23']",23,"['milunmoghe98', 'sahil.tasgavkar', 'gayatri.devadiga', 'poojathorat157', 'sanjana.masurkar', 'ie2012.krishna.paryani', 'ssonali_21', 'darshana.mahajan', 'mayur_sn', 'shaanigwwass2', 'kushal.bhosale', 'kmamaniya', 'ie2012.jibran.nakhwa', None, 'hashmeet.chaudhery', 'moka0707shi', 'apoorva.kelkar', 'rahul.yadav', 'pawan.sukhwani', 'prachi.shinde', 'yogita.panmand', 'kapil.paliwal', 'sunny23']"
50,61,16,7,3,"['kushal.bhosale', 'ssonali_21', 'hashmeet.chaudhery']",12,"['milunmoghe98', 'moka0707shi', 'apoorva.kelkar', 'sanjana.masurkar', 'pawan.sukhwani', 'ie2012.krishna.paryani', 'darshana.mahajan', 'shaanigwwass2', 'kmamaniya', 'kapil.paliwal', 'ie2012.jibran.nakhwa', 'yogita.panmand']",4,"['abhishek.manurkar', 'abhay.kshirsagar', 'chinmay.shetye', None]",19,"['milunmoghe98', 'abhishek.manurkar', 'sanjana.masurkar', 'ie2012.krishna.paryani', 'ssonali_21', 'darshana.mahajan', 'shaanigwwass2', 'kushal.bhosale', 'kmamaniya', 'ie2012.jibran.nakhwa', None, 'hashmeet.chaudhery', 'moka0707shi', 'apoorva.kelkar', 'pawan.sukhwani', 'chinmay.shetye', 'yogita.panmand', 'kapil.paliwal', 'abhay.kshirsagar']"
50,62,16,7,2,"['yogita.panmand', 'kapil.paliwal']",13,"['milunmoghe98', 'moka0707shi', 'apoorva.kelkar', 'sanjana.masurkar', 'pawan.sukhwani', 'ie2012.krishna.paryani', 'ssonali_21', 'darshana.mahajan', 'shaanigwwass2', 'kushal.bhosale', 'kmamaniya', 'ie2012.jibran.nakhwa', 'hashmeet.chaudhery']",5,"['padmaj.manore', 'ie2012.advait.mohile', 'vishnu.lohia', 'jmihavel', None]",20,"['milunmoghe98', 'sanjana.masurkar', 'ie2012.krishna.paryani', 'ssonali_21', 'darshana.mahajan', 'vishnu.lohia', 'shaanigwwass2', 'kushal.bhosale', 'kmamaniya', 'ie2012.jibran.nakhwa', 'jmihavel', None, 'hashmeet.chaudhery', 'moka0707shi', 'apoorva.kelkar', 'padmaj.manore', 'pawan.sukhwani', 'ie2012.advait.mohile', 'yogita.panmand', 'kapil.paliwal']"
50,64,16,6,1,['kmamaniya'],14,"['milunmoghe98', 'moka0707shi', 'apoorva.kelkar', 'sanjana.masurkar', 'pawan.sukhwani', 'ie2012.krishna.paryani', 'ssonali_21', 'darshana.mahajan', 'shaanigwwass2', 'kushal.bhosale', 'ie2012.jibran.nakhwa', 'kapil.paliwal', 'yogita.panmand', 'hashmeet.chaudhery']",5,"['yashjivrajani7799', 'senmathew329', 'vaibhavnagar08', 'mugdhabhat1997', None]",20,"['milunmoghe98', 'sanjana.masurkar', 'ie2012.krishna.paryani', 'ssonali_21', 'darshana.mahajan', 'shaanigwwass2', 'kushal.bhosale', 'kmamaniya', 'ie2012.jibran.nakhwa', 'vaibhavnagar08', 'mugdhabhat1997', None, 'hashmeet.chaudhery', 'moka0707shi', 'apoorva.kelkar', 'pawan.sukhwani', 'yashjivrajani7799', 'senmathew329', 'yogita.panmand', 'kapil.paliwal']"
50,69,16,6,3,"['apoorva.kelkar', 'sanjana.masurkar', 'yogita.panmand']",12,"['milunmoghe98', 'moka0707shi', 'pawan.sukhwani', 'ie2012.krishna.paryani', 'ssonali_21', 'darshana.mahajan', 'shaanigwwass2', 'kushal.bhosale', 'kmamaniya', 'kapil.paliwal', 'ie2012.jibran.nakhwa', 'hashmeet.chaudhery']",3,"['ie2012.advait.mohile', None, 'yash_madhavani']",18,"['milunmoghe98', 'sanjana.masurkar', 'ie2012.krishna.paryani', 'ssonali_21', 'darshana.mahajan', 'shaanigwwass2', 'kushal.bhosale', 'kmamaniya', 'ie2012.jibran.nakhwa', None, 'hashmeet.chaudhery', 'moka0707shi', 'apoorva.kelkar', 'yash_madhavani', 'pawan.sukhwani', 'ie2012.advait.mohile', 'yogita.panmand', 'kapil.paliwal']"
51,2,16,17,11,"['zzh', 'rthowe', 'galexop', 'qfhuang', 'liluoqi07', 'avan994', 'zhouz4', 'yangjennie', 'savs413', 'fangguanhua2013', 'dm628']",4,"['b.buynaa01', 'x.ganerdene123', 'shapera2', 'shehan']",6,"['aditidatta', 'cdflem94', 'hgao3', 'xiushan', 'cccharleschan', None]",21,"['zhouz4', 'xiushan', 'aditidatta', 'zzh', 'rthowe', 'galexop', 'shapera2', 'liluoqi07', 'avan994', 'yangjennie', 'b.buynaa01', 'fangguanhua2013', 'shehan', 'x.ganerdene123', 'hgao3', 'qfhuang', None, 'savs413', 'dm628', 'cdflem94', 'cccharleschan']"
51,3,16,12,8,"['zzh', 'galexop', 'liluoqi07', 'avan994', 'zhouz4', 'yangjennie', 'savs413', 'dm628']",7,"['rthowe', 'shehan', 'shapera2', 'qfhuang', 'x.ganerdene123', 'b.buynaa01', 'fangguanhua2013']",4,"['ehernndz', 'ozhao2012', None, 'chrisrocks40']",19,"['chrisrocks40', 'shehan', 'x.ganerdene123', 'qfhuang', 'zhouz4', None, 'savs413', 'dm628', 'zzh', 'rthowe', 'ehernndz', 'galexop', 'shapera2', 'liluoqi07', 'ozhao2012', 'avan994', 'yangjennie', 'b.buynaa01', 'fangguanhua2013']"
51,5,16,9,1,['x.ganerdene123'],14,"['zzh', 'rthowe', 'galexop', 'shapera2', 'qfhuang', 'liluoqi07', 'shehan', 'avan994', 'zhouz4', 'yangjennie', 'b.buynaa01', 'savs413', 'fangguanhua2013', 'dm628']",8,"['davaanaa0101', None, 'bganaabganaa1998', 'baagii_homie', 'nyamjantsan', 'billy888', 'n.batkaa', 'bulganbatjargal']",23,"['davaanaa0101', 'baagii_homie', 'bganaabganaa1998', 'shehan', 'x.ganerdene123', 'qfhuang', 'nyamjantsan', 'billy888', 'zhouz4', 'bulganbatjargal', 'savs413', None, 'dm628', 'zzh', 'rthowe', 'galexop', 'shapera2', 'liluoqi07', 'avan994', 'yangjennie', 'n.batkaa', 'b.buynaa01', 'fangguanhua2013']"
51,6,16,9,1,['x.ganerdene123'],14,"['zzh', 'rthowe', 'galexop', 'shapera2', 'qfhuang', 'liluoqi07', 'shehan', 'avan994', 'zhouz4', 'yangjennie', 'b.buynaa01', 'savs413', 'fangguanhua2013', 'dm628']",8,"['davaanaa0101', 'zulaa95', 'davaa23', 'bz_5657', 'n.batkaa', 'davaanaa010101', None, 'b.byambadorj']",23,"['davaanaa0101', 'shehan', 'x.ganerdene123', 'qfhuang', 'zhouz4', None, 'savs413', 'dm628', 'zulaa95', 'zzh', 'rthowe', 'davaa23', 'galexop', 'shapera2', 'liluoqi07', 'avan994', 'yangjennie', 'bz_5657', 'n.batkaa', 'davaanaa010101', 'b.buynaa01', 'fangguanhua2013', 'b.byambadorj']"
51,208,16,9,2,"['fangguanhua2013', 'qfhuang']",13,"['zzh', 'rthowe', 'galexop', 'shapera2', 'x.ganerdene123', 'liluoqi07', 'avan994', 'zhouz4', 'yangjennie', 'b.buynaa01', 'savs413', 'shehan', 'dm628']",7,"['ellathomson', 'cdflem94', 'ishaabishnoi', 'dmfeng', 'shrcor', 'xiushan', None]",22,"['ellathomson', 'shehan', 'x.ganerdene123', 'qfhuang', 'ishaabishnoi', 'shrcor', 'zhouz4', 'xiushan', None, 'savs413', 'dm628', 'cdflem94', 'zzh', 'rthowe', 'galexop', 'shapera2', 'liluoqi07', 'dmfeng', 'avan994', 'yangjennie', 'b.buynaa01', 'fangguanhua2013']"
51,7,16,7,1,['b.buynaa01'],14,"['zzh', 'rthowe', 'galexop', 'shapera2', 'qfhuang', 'liluoqi07', 'shehan', 'x.ganerdene123', 'avan994', 'zhouz4', 'yangjennie', 'savs413', 'fangguanhua2013', 'dm628']",6,"['bganaabganaa1998', 'amraa061', 'ganguye', 'davaanaa010101', 'battulga9192', None]",21,"['bganaabganaa1998', 'amraa061', 'shehan', 'x.ganerdene123', 'qfhuang', 'zhouz4', 'ganguye', 'battulga9192', None, 'savs413', 'dm628', 'zzh', 'rthowe', 'galexop', 'shapera2', 'liluoqi07', 'avan994', 'yangjennie', 'davaanaa010101', 'b.buynaa01', 'fangguanhua2013']"
51,4,16,6,2,"['b.buynaa01', 'x.ganerdene123']",13,"['zzh', 'rthowe', 'galexop', 'shapera2', 'qfhuang', 'liluoqi07', 'shehan', 'avan994', 'zhouz4', 'yangjennie', 'savs413', 'fangguanhua2013', 'dm628']",4,"['tornado_u', 'davaab.num', None, 'n.batkaa']",19,"['shehan', 'x.ganerdene123', 'qfhuang', 'davaab.num', 'zhouz4', None, 'savs413', 'dm628', 'zzh', 'rthowe', 'tornado_u', 'galexop', 'shapera2', 'liluoqi07', 'avan994', 'yangjennie', 'n.batkaa', 'b.buynaa01', 'fangguanhua2013']"
52,55,16,73,8,"['bismashaikh26', 'asgharnoor', 'mairaliaqat', 'tahashaikh333', 'saniamahrukh1998', 'abbymd52', 'bluejeans_umi', 'arifmujtaba321']",7,"['navaneethjune27', 'wakemeup36', 'tsebasti', 'adolfoeguerrero', 'd.t.yimam', 'heardc', 'mattjorgensen']",65,"['anas.ahm5', 'syeddanial7', 'sabaahmed11', 'ms286611', 'me89', 'sheebahashmi0', 'maarijqamar', 'saadshakir', 'abiharizvi', 'mhwajeeh', 'heebazaheer', 'rabia', 'qassiashoaib74', 'mahwishkhalil20', 'muneeb1516', 'nmkpt20', 'asrakhan', 'arishaazam', 'masi123.mr1', 'arooba_jamal', 'imtiazhira', 'maira', 'dawar_ijaz', 'uzma', 'zohra101', 'fabihasheikh18', 'mahwish653', 'sabafakhar', 'sakina.waseem', 'abrana', 'fahadali', 'muhammaddawood', 'haurainsia4', 'kumail49', 'bushranajeeb86', 'mahefatima', 'sohiadeen23', 'mariumr786', 'musabahmed2', 'mashaheerzafar400', 'hawkchikna', 'kanwal_ashfaq', 'sidrakanwal', 'farkhundahanif', 'im.zohaib96', 'rabbiaahmed2016', 'scorpion3132774171', 'munazzah', 'talha_hilal', 'syedamahrukh', 'asadhk96', 'sabaahmed', 'aflaha10', 'rabbiyanasir', 'a.haseeb', 'abbasgroup', None, 'uroojalam', 'moiz95pk', 'rahima', 'rubabzehra26', 'hassaank98', 'mahnoor', 'zainulislam47', 'maha_ahmed']",80,"['navaneethjune27', 'anas.ahm5', 'syeddanial7', 'sabaahmed11', 'ms286611', 'me89', 'sheebahashmi0', 'd.t.yimam', 'maarijqamar', 'saadshakir', 'abiharizvi', 'bismashaikh26', 'mhwajeeh', 'heebazaheer', 'wakemeup36', 'rabia', 'qassiashoaib74', 'mahwishkhalil20', 'muneeb1516', 'heardc', 'nmkpt20', 'adolfoeguerrero', 'asrakhan', 'arishaazam', 'masi123.mr1', 'arooba_jamal', 'imtiazhira', 'maira', 'dawar_ijaz', 'uzma', 'saniamahrukh1998', 'abbymd52', 'zohra101', 'fabihasheikh18', 'mahwish653', 'bluejeans_umi', 'sakina.waseem', 'sabafakhar', 'abrana', 'mairaliaqat', 'fahadali', 'muhammaddawood', 'haurainsia4', 'kumail49', 'bushranajeeb86', 'mahefatima', 'sohiadeen23', 'mariumr786', 'musabahmed2', 'mashaheerzafar400', 'hawkchikna', 'kanwal_ashfaq', 'sidrakanwal', 'farkhundahanif', 'arifmujtaba321', 'mattjorgensen', 'tahashaikh333', 'tsebasti', 'im.zohaib96', 'rabbiaahmed2016', 'scorpion3132774171', 'munazzah', 'talha_hilal', 'syedamahrukh', 'asadhk96', 'sabaahmed', 'aflaha10', 'rabbiyanasir', 'a.haseeb', 'abbasgroup', None, 'uroojalam', 'moiz95pk', 'asgharnoor', 'rahima', 'rubabzehra26', 'hassaank98', 'mahnoor', 'zainulislam47', 'maha_ahmed']"
53,26,16,52,6,"['zhonga4', 'jsourivongs', 'kevinkeller929', 'scorchio36', 'jr8000', 'veraest95']",9,"['pragyakushwaha', 'ehsan.vadiee7', 'pariha.narendra', 'yejindgihamari', 'sahayshubham', 'robin95', 'harshit_agarwal', 'dan10400', 'davide.revignas']",46,"['less76', 'nigel.a', 'larstatum', 'carolinagomez', 'jenngibson', 'kstone1993', 'nguyenbt', 'justindiazuf', 'blueearth2000', 'tylertucker1', 'mglarson', 'canishat', 'dgirard124', 'tburns97', 'acharlot', 'ozzie4297', 'dylannong', 'jlim3538', 'huapva', 'kristjanamanco', 'antural', 'vlusat7', 'kennychiphu', 'cjdanner', 'tluu3', 'harris.ja', None, 'd.hamilton', 'floresda95', 'mattbuster', 't_mic1', 'argho7x7', 'rachelpcollins', 'ehdavis1337', 'kennyramos8', 'jcrain', 'dluck', 'linglin', 'rjacobse7', 'zmesscher', 'pengzhaozhu', 'juliettefr', 'eugenesg1ddin', 'dmanyaz', 'alexdiaz', 'klai1995']",61,"['less76', 'nigel.a', 'yejindgihamari', 'carolinagomez', 'jenngibson', 'nguyenbt', 'dgirard124', 'acharlot', 'ozzie4297', 'dylannong', 'huapva', 'kristjanamanco', 'vlusat7', 'kennychiphu', 'tluu3', 'dan10400', 'veraest95', 'd.hamilton', 'mattbuster', 'kennyramos8', 'ehdavis1337', 'linglin', 'rjacobse7', 'harshit_agarwal', 'pengzhaozhu', 'eugenesg1ddin', 'dmanyaz', 'pariha.narendra', 'larstatum', 'sahayshubham', 'kevinkeller929', 'scorchio36', 'kstone1993', 'jr8000', 'justindiazuf', 'blueearth2000', 'tylertucker1', 'mglarson', 'zhonga4', 'canishat', 'tburns97', 'jlim3538', 'antural', 'pragyakushwaha', 'ehsan.vadiee7', 'cjdanner', 'davide.revignas', 'harris.ja', None, 'floresda95', 't_mic1', 'argho7x7', 'rachelpcollins', 'jcrain', 'robin95', 'jsourivongs', 'dluck', 'zmesscher', 'juliettefr', 'alexdiaz', 'klai1995']"
53,228,16,43,2,"['jsourivongs', 'zhonga4']",13,"['pragyakushwaha', 'ehsan.vadiee7', 'pariha.narendra', 'yejindgihamari', 'sahayshubham', 'kevinkeller929', 'robin95', 'scorchio36', 'harshit_agarwal', 'jr8000', 'dan10400', 'davide.revignas', 'veraest95']",41,"['less76', 'nigel.a', 'larstatum', 'carolinagomez', 'jenngibson', 'nguyenbt', 'justindiazuf', 'blueearth2000', 'tylertucker1', 'mglarson', 'canishat', 'dgirard124', 'tburns97', 'acharlot', 'ozzie4297', 'jlim3538', 'huapva', 'kristjanamanco', 'antural', 'vlusat7', 'kennychiphu', 'cjdanner', 'tluu3', 'harris.ja', None, 'd.hamilton', 'mattbuster', 'rjacobse', 'argho7x7', 'rachelpcollins', 'ehdavis1337', 'kennyramos8', 'jcrain', 'dluck', 'zmesscher', 'pengzhaozhu', 'juliettefr', 'eugenesg1ddin', 'dmanyaz', 'alexdiaz', 'klai1995']",56,"['less76', 'pariha.narendra', 'nigel.a', 'larstatum', 'yejindgihamari', 'sahayshubham', 'kevinkeller929', 'scorchio36', 'carolinagomez', 'jenngibson', 'jr8000', 'nguyenbt', 'justindiazuf', 'blueearth2000', 'tylertucker1', 'mglarson', 'zhonga4', 'canishat', 'dgirard124', 'tburns97', 'acharlot', 'ozzie4297', 'jlim3538', 'huapva', 'kristjanamanco', 'antural', 'vlusat7', 'pragyakushwaha', 'ehsan.vadiee7', 'kennychiphu', 'cjdanner', 'tluu3', 'dan10400', 'davide.revignas', 'veraest95', 'harris.ja', None, 'd.hamilton', 'mattbuster', 'rjacobse', 'argho7x7', 'rachelpcollins', 'ehdavis1337', 'kennyramos8', 'jcrain', 'robin95', 'jsourivongs', 'dluck', 'harshit_agarwal', 'zmesscher', 'pengzhaozhu', 'juliettefr', 'eugenesg1ddin', 'dmanyaz', 'alexdiaz', 'klai1995']"
53,229,16,24,2,"['scorchio36', 'zhonga4']",13,"['pragyakushwaha', 'ehsan.vadiee7', 'pariha.narendra', 'yejindgihamari', 'sahayshubham', 'kevinkeller929', 'robin95', 'jsourivongs', 'harshit_agarwal', 'jr8000', 'dan10400', 'davide.revignas', 'veraest95']",22,"['less76', 'carolinagomez', 'blueearth2000', 'tylertucker1', 'mglarson', 'tburns97', 'dylannong', 'kristjanamanco', 'kennychiphu', 'cjdanner', None, 'floresda95', 'd.hamilton', 'mattbuster', 't_mic1', 'rachelpcollins', 'jcrain', 'dluck', 'rjacobse7', 'juliettefr', 'pengzhaozhu', 'eugenesg1ddin']",37,"['less76', 'pariha.narendra', 'yejindgihamari', 'sahayshubham', 'kevinkeller929', 'scorchio36', 'carolinagomez', 'jr8000', 'blueearth2000', 'tylertucker1', 'mglarson', 'zhonga4', 'tburns97', 'dylannong', 'kristjanamanco', 'pragyakushwaha', 'ehsan.vadiee7', 'kennychiphu', 'cjdanner', 'dan10400', 'davide.revignas', 'veraest95', None, 'floresda95', 'd.hamilton', 'mattbuster', 't_mic1', 'rachelpcollins', 'jcrain', 'robin95', 'jsourivongs', 'dluck', 'rjacobse7', 'harshit_agarwal', 'juliettefr', 'pengzhaozhu', 'eugenesg1ddin']"
54,181,16,22,4,"['zluy10', 'benmurton', 'chinchin', 'danny101']",11,"['dianeribeiro', 'rvmadkey', 'matsumotokoki', 'wehbemajd79', 'nijohnso314', 'enriquer', 'prashantsteele', 'vignesh.bgals', 'yatharth', 'rishi1618madhu', 'sibashisghosh1998']",18,"['rxu22', 'dhe48', 'btmurton', 'wilburcoote', 'maswahs', 'kevinokane777', 'jchin11', 'nathanyates01', 'hugohills.nz', 'njr85', 'mcdiggidy', 'bpsorenson', 'qianhui', 'hwa99', 'ckn21', None, 'dannz', 'bonald9056']",33,"['rvmadkey', 'rxu22', 'danny101', 'enriquer', 'prashantsteele', 'vignesh.bgals', 'yatharth', 'hwa99', 'rishi1618madhu', 'bonald9056', 'wehbemajd79', 'dhe48', 'btmurton', 'kevinokane777', 'dannz', 'matsumotokoki', 'wilburcoote', 'maswahs', 'jchin11', 'benmurton', 'bpsorenson', 'zluy10', None, 'dianeribeiro', 'sibashisghosh1998', 'nathanyates01', 'nijohnso314', 'hugohills.nz', 'njr85', 'chinchin', 'mcdiggidy', 'qianhui', 'ckn21']"
54,184,16,13,1,['nijohnso314'],14,"['dianeribeiro', 'rvmadkey', 'matsumotokoki', 'wehbemajd79', 'danny101', 'chinchin', 'enriquer', 'benmurton', 'prashantsteele', 'vignesh.bgals', 'yatharth', 'zluy10', 'rishi1618madhu', 'sibashisghosh1998']",12,"['alexisamaro91', 'julia0704', 'sonali2001', 'iremhatipoglu2', 'bflouretdsq8', 'beyzaince', 'kennedirc', 'min506011', 'lindseyserlovsky', 'imani', None, 'kayla15']",27,"['rvmadkey', 'matsumotokoki', 'alexisamaro91', 'julia0704', 'danny101', 'iremhatipoglu2', 'beyzaince', 'enriquer', 'benmurton', 'prashantsteele', 'kennedirc', 'vignesh.bgals', 'yatharth', 'min506011', 'zluy10', 'imani', None, 'rishi1618madhu', 'dianeribeiro', 'sibashisghosh1998', 'wehbemajd79', 'nijohnso314', 'sonali2001', 'chinchin', 'bflouretdsq8', 'lindseyserlovsky', 'kayla15']"
55,291,16,16,13,"['francesco244075', 'luca.agnoletti', 'agostinopiazzese', 'noemi1694', 'edoardopansoya', 'vittoriomartini94', 'andrea.tallone94', 'fremicalma', 'andreabussi3', 'simo17', 'paolozupa15', 'saragiacchig', 'alessandradelboca1']",2,"['s239892', 'giu']",3,"['matteo.fasano', None, 'lucabergamasco']",18,"['francesco244075', 'luca.agnoletti', 'noemi1694', 'edoardopansoya', 'simo17', 's239892', None, 'lucabergamasco', 'agostinopiazzese', 'matteo.fasano', 'vittoriomartini94', 'andrea.tallone94', 'fremicalma', 'andreabussi3', 'paolozupa15', 'saragiacchig', 'giu', 'alessandradelboca1']"
56,164,15,17,14,"['mustapha.makki', 'jmansfie', 'yalda.sfr', 'samandh', 'klinz', 'erica15', 'bmam1979', 'kierstenlenz', 'ladypopscoffeebooks1', 'greatben', 'rzareena', 'mhkim84', 'lrmanfre', 'jwsanders']",0,[],3,"[None, 'vyettell', 'sg630']",17,"['jmansfie', 'samandh', 'klinz', 'bmam1979', 'vyettell', 'sg630', 'greatben', 'lrmanfre', None, 'jwsanders', 'mustapha.makki', 'yalda.sfr', 'erica15', 'kierstenlenz', 'rzareena', 'mhkim84', 'ladypopscoffeebooks1']"
56,185,15,17,14,"['mustapha.makki', 'jmansfie', 'yalda.sfr', 'samandh', 'klinz', 'erica15', 'bmam1979', 'kierstenlenz', 'ladypopscoffeebooks1', 'greatben', 'rzareena', 'mhkim84', 'lrmanfre', 'jwsanders']",0,[],3,"[None, 'vyettell', 'sg630']",17,"['jmansfie', 'samandh', 'klinz', 'bmam1979', 'vyettell', 'sg630', 'greatben', 'lrmanfre', None, 'jwsanders', 'mustapha.makki', 'yalda.sfr', 'erica15', 'kierstenlenz', 'rzareena', 'mhkim84', 'ladypopscoffeebooks1']"
57,76,15,14,12,"['edwinchoi', 'lmendoz6', 'ctran34', 'jkerins', 'j_samson', 'c_reyes7', 'jhu6', 'cvillalobos2', 'lsanne', 'g_moore5', 'josejjimenez209', 'p_vuong2']",2,"['mtgross2', 'j_cearley']",2,"['g_bartolo', None]",16,"['edwinchoi', 'jkerins', 'c_reyes7', 'j_cearley', 'mtgross2', 'cvillalobos2', 'p_vuong2', 'g_bartolo', None, 'lmendoz6', 'ctran34', 'j_samson', 'jhu6', 'lsanne', 'g_moore5', 'josejjimenez209']"
58,193,14,12,9,"['araguil3', 'jbai14', 'trietho', 'dongying93', 'jager', 'shujianxue', 'wuyanze_athlon', 'smurali2951', 'pwang83']",4,"['jjacoby3', 'ajniles', 'ysun169', 'vasileska']",3,"['papsangi', None, 'andrewwarrn']",16,"['trietho', 'ysun169', 'shujianxue', 'wuyanze_athlon', 'smurali2951', 'pwang83', None, 'araguil3', 'jbai14', 'jjacoby3', 'dongying93', 'jager', 'andrewwarrn', 'ajniles', 'papsangi', 'vasileska']"
58,253,14,12,9,"['araguil3', 'jbai14', 'trietho', 'dongying93', 'jager', 'shujianxue', 'wuyanze_athlon', 'smurali2951', 'pwang83']",4,"['jjacoby3', 'ajniles', 'ysun169', 'vasileska']",3,"['papsangi', None, 'andrewwarrn']",16,"['trietho', 'ysun169', 'shujianxue', 'wuyanze_athlon', 'smurali2951', 'pwang83', None, 'araguil3', 'jbai14', 'jjacoby3', 'dongying93', 'jager', 'andrewwarrn', 'ajniles', 'papsangi', 'vasileska']"
59,276,14,90,13,"['lekhakande', 'anitadey12', 'puranikatharva', 'mayurgonbare22', 'neonargon5', 'rasikapotdar2108', 'maneaniket', 'siddheshgothankar', 'shirishparkhe', 'snehalpatil', 'shraddha.dhage', 'shraddhasam78', 'mithilagajarmal']",0,[],77,"['rajeshree.kumbhar5018', 'ashishghoderao', 'sumitmhatre5670', 'ronak.tiwari', 'sanchitkad', 'aishuauti20496', 'adnan.s', 'ritik.singh', 'prerana.goythale', 'pandeydeepak825', 'shweta.joglekar', 'mounikajalla99', 'bonhomie11', 'prathamesh.nikam', 'bhushan9321', 'vishalnaik.0210', 'harishkumar.n', 'sanketmane1997.sm', 'krunal.kasar', 'sendpost2mahesh', 'sid.jagtap1992', 'surbhib2897', 'richitapatil', 'yashuishwar', 'atul', 'paromita24', 'niveditachaudhari', 'mhatrenrupal42', 'ayesha.pathan', 'digvijayjadeja725', 'shrey.joshi', 'ninadmandavkar29', 'nehamallan', 'nishigandhaprsd14', 'rushikeshsalgar123', 'sahil709', 'ameyc007', 'neelamt', 'amarravade31', 'patiltejas000003', 'akshatamahajan47', 'yogeshmaurya50', 'gaurav.mishra', 'vivekrana', 'manjarekarchinmayeen', 'riddhi737', 'niharmasurkar', 'apurvawaghmode14', 'bhandarinirali57', 'bhagyashrimali280497', 'mihirgogri613', 'sarika_bukkawar', 'pratibhagawari28', 'nirav.lm', 'rohan.mestry', 'dhavit.v', 'sumitpatil512', 'sonali.ramji', 'dleena19961209', 'yuvraj.t', 'akshay1997bhagit', 'atulkokane1234', 'electronics209', 'raj.vadariya', 'trambakesh97', 'sarika', 'pritijha1996', 'bgharat713', 'mayank.vp', 'preethinaik', 'rajesh05', None, 'shreyas.v', 'veronicathapa56', 'podililaxmi30', 'divyassingh56', 'hborse28']",90,"['rajeshree.kumbhar5018', 'ashishghoderao', 'sumitmhatre5670', 'ronak.tiwari', 'sanchitkad', 'rasikapotdar2108', 'aishuauti20496', 'adnan.s', 'ritik.singh', 'prerana.goythale', 'pandeydeepak825', 'shweta.joglekar', 'mounikajalla99', 'puranikatharva', 'bonhomie11', 'prathamesh.nikam', 'bhushan9321', 'vishalnaik.0210', 'harishkumar.n', 'sanketmane1997.sm', 'shirishparkhe', 'krunal.kasar', 'sendpost2mahesh', 'sid.jagtap1992', 'surbhib2897', 'shraddhasam78', 'richitapatil', 'yashuishwar', 'atul', 'paromita24', 'niveditachaudhari', 'mhatrenrupal42', 'neonargon5', 'ayesha.pathan', 'digvijayjadeja725', 'shrey.joshi', 'ninadmandavkar29', 'nehamallan', 'nishigandhaprsd14', 'rushikeshsalgar123', 'sahil709', 'ameyc007', 'neelamt', 'amarravade31', 'patiltejas000003', 'akshatamahajan47', 'yogeshmaurya50', 'gaurav.mishra', 'vivekrana', 'manjarekarchinmayeen', 'riddhi737', 'niharmasurkar', 'apurvawaghmode14', 'bhandarinirali57', 'bhagyashrimali280497', 'mihirgogri613', 'sarika_bukkawar', 'lekhakande', 'pratibhagawari28', 'nirav.lm', 'anitadey12', 'rohan.mestry', 'mayurgonbare22', 'dhavit.v', 'sumitpatil512', 'sonali.ramji', 'maneaniket', 'siddheshgothankar', 'dleena19961209', 'yuvraj.t', 'akshay1997bhagit', 'atulkokane1234', 'electronics209', 'raj.vadariya', 'trambakesh97', 'sarika', 'pritijha1996', 'bgharat713', 'mayank.vp', 'preethinaik', 'snehalpatil', 'rajesh05', None, 'shreyas.v', 'veronicathapa56', 'podililaxmi30', 'divyassingh56', 'shraddha.dhage', 'hborse28', 'mithilagajarmal']"
59,269,14,75,12,"['lekhakande', 'anitadey12', 'puranikatharva', 'mayurgonbare22', 'neonargon5', 'rasikapotdar2108', 'maneaniket', 'siddheshgothankar', 'snehalpatil', 'shraddha.dhage', 'shraddhasam78', 'mithilagajarmal']",1,['shirishparkhe'],63,"['rajeshree.kumbhar5018', 'palakchheda2407', 'mbhosale863', 'ashishghoderao', 'sumitmhatre5670', 'ashwinipardeshi702', 'ronak.tiwari', 'sanchitkad', 'aishuauti20496', 'pandeydeepak825', 'prathamesh.nikam', 'bhushan9321', 'adityagudla96', 'sid.jagtap1992', 'sendpost2mahesh', 'surbhib2897', 'jayshreepakhare63', 'atul', 'bolekunal42', 'mhatrenrupal42', 'ayesha.pathan', 'ninadmandavkar29', 'abhishek2397', 'nishigandhaprsd14', 'bhaveshsawant1996', 'rushikeshsalgar123', 'sahil709', 'dusty', 'neelamt', 'sudar', 'shreekantrasam69', 'yogeshmaurya50', 'kavusatose123', 'manjarekarchinmayeen', 'riddhi737', 'niharmasurkar', 'bhandarinirali57', 'mihirgogri613', 'pratibhagawari28', 'ab17', 'sumitpatil512', 'sonali.ramji', 'dleena19961209', 'abhijaypandey', 'dilip.wakdikar', 'trambakesh97', 'riyakulkarni16021997', 'brarath.nihal', 'bgharat713', 'pritijha1996', 'preethinaik', 'ganeshjadhav', 'sanket.mane', 'rajesh05', 'ksanket025', None, 'rahul.sawant', 's.arutwar', 'veronicathapa56', 'prashant.khedkar', 'vishal8244', 'hborse28', 'ganesh.mali']",76,"['rajeshree.kumbhar5018', 'palakchheda2407', 'mbhosale863', 'ashishghoderao', 'sumitmhatre5670', 'ashwinipardeshi702', 'ronak.tiwari', 'sanchitkad', 'rasikapotdar2108', 'aishuauti20496', 'pandeydeepak825', 'puranikatharva', 'prathamesh.nikam', 'bhushan9321', 'shirishparkhe', 'adityagudla96', 'sid.jagtap1992', 'sendpost2mahesh', 'surbhib2897', 'shraddhasam78', 'jayshreepakhare63', 'atul', 'bolekunal42', 'mhatrenrupal42', 'neonargon5', 'ayesha.pathan', 'ninadmandavkar29', 'abhishek2397', 'nishigandhaprsd14', 'bhaveshsawant1996', 'rushikeshsalgar123', 'sahil709', 'dusty', 'neelamt', 'sudar', 'shreekantrasam69', 'yogeshmaurya50', 'kavusatose123', 'manjarekarchinmayeen', 'riddhi737', 'niharmasurkar', 'bhandarinirali57', 'mihirgogri613', 'lekhakande', 'pratibhagawari28', 'anitadey12', 'ab17', 'mayurgonbare22', 'sumitpatil512', 'sonali.ramji', 'maneaniket', 'siddheshgothankar', 'dleena19961209', 'abhijaypandey', 'dilip.wakdikar', 'trambakesh97', 'riyakulkarni16021997', 'brarath.nihal', 'bgharat713', 'pritijha1996', 'preethinaik', 'ganeshjadhav', 'sanket.mane', 'snehalpatil', 'rajesh05', 'ksanket025', None, 'rahul.sawant', 's.arutwar', 'veronicathapa56', 'prashant.khedkar', 'vishal8244', 'shraddha.dhage', 'hborse28', 'ganesh.mali', 'mithilagajarmal']"
59,282,14,50,9,"['lekhakande', 'anitadey12', 'puranikatharva', 'mayurgonbare22', 'rasikapotdar2108', 'siddheshgothankar', 'shirishparkhe', 'snehalpatil', 'shraddhasam78']",4,"['shraddha.dhage', 'neonargon5', 'maneaniket', 'mithilagajarmal']",41,"['rajeshree.kumbhar5018', 'sanket.gawade', 'sunilmolawade', 'ani.date23', 'manjarekarchinmayeen', 'nikhil.a', 'riddhi737', 'aishuauti20496', 'satish.yadav', 'nasareen.k', 'pratibhagawari28', 'nirav.lm', 'bhushan9321', 'sanketmane1997.sm', 'janawalekarp', 'krunal.kasar', 'yuvraj.t', 'kadam.rupesh28297', 'abhishek.diggewadi', 'shreyapatel606', 'renukabhosale14', 'vijayshankarchaurasiya', 'paromita24', 'ayesha.pathan', 'rajesh05', 'pratik.gc', 'sumitmhatre', None, 'dusty', 'ameyc007', 'rahul.sawant', 'neelamt', 'podililaxmi30', 'pratikshedge23', 'amarravade31', 'divyashriteppala', 'patiltejas000003', 'krupalpatel1996', 'akshatamahajan47', 'shweta.gosavi', 'kgirkar6104']",54,"['rajeshree.kumbhar5018', 'sanket.gawade', 'sunilmolawade', 'ani.date23', 'manjarekarchinmayeen', 'nikhil.a', 'riddhi737', 'rasikapotdar2108', 'aishuauti20496', 'satish.yadav', 'nasareen.k', 'lekhakande', 'pratibhagawari28', 'nirav.lm', 'anitadey12', 'puranikatharva', 'mayurgonbare22', 'bhushan9321', 'sanketmane1997.sm', 'janawalekarp', 'maneaniket', 'siddheshgothankar', 'shirishparkhe', 'krunal.kasar', 'yuvraj.t', 'abhishek.diggewadi', 'kadam.rupesh28297', 'shreyapatel606', 'shraddhasam78', 'renukabhosale14', 'vijayshankarchaurasiya', 'paromita24', 'neonargon5', 'ayesha.pathan', 'snehalpatil', 'rajesh05', 'pratik.gc', 'sumitmhatre', None, 'dusty', 'ameyc007', 'rahul.sawant', 'neelamt', 'podililaxmi30', 'pratikshedge23', 'amarravade31', 'divyashriteppala', 'patiltejas000003', 'krupalpatel1996', 'akshatamahajan47', 'shweta.gosavi', 'shraddha.dhage', 'kgirkar6104', 'mithilagajarmal']"
59,281,14,32,8,"['lekhakande', 'anitadey12', 'puranikatharva', 'neonargon5', 'rasikapotdar2108', 'maneaniket', 'shraddha.dhage', 'mithilagajarmal']",5,"['mayurgonbare22', 'siddheshgothankar', 'shirishparkhe', 'snehalpatil', 'shraddhasam78']",24,"['palakchheda2407', 'manjarekarchinmayeen', 'sumitmhatre5670', 'ronak.tiwari', 'bhagyashrimali280497', 'sanchitkad', 'mihirgogri613', 'ab17', 'bhushan9321', 'siddhi123', 'sanketmane1997.sm', 'sonysagar1996', 'richitapatil', 'renukabhosale14', 'dilip.wakdikar', 'vijayshankarchaurasiya', 'ayesha.pathan', 'digvijayjadeja725', 'rajesh05', None, 'podililaxmi30', 'patiltejas000003', 'divyassingh56', 'akshatamahajan47']",37,"['palakchheda2407', 'manjarekarchinmayeen', 'sumitmhatre5670', 'ronak.tiwari', 'bhagyashrimali280497', 'sanchitkad', 'rasikapotdar2108', 'mihirgogri613', 'lekhakande', 'anitadey12', 'puranikatharva', 'mayurgonbare22', 'ab17', 'bhushan9321', 'siddhi123', 'sanketmane1997.sm', 'sonysagar1996', 'maneaniket', 'siddheshgothankar', 'shirishparkhe', 'shraddhasam78', 'richitapatil', 'renukabhosale14', 'dilip.wakdikar', 'vijayshankarchaurasiya', 'neonargon5', 'ayesha.pathan', 'digvijayjadeja725', 'snehalpatil', 'rajesh05', None, 'podililaxmi30', 'patiltejas000003', 'divyassingh56', 'akshatamahajan47', 'shraddha.dhage', 'mithilagajarmal']"
59,267,14,31,4,"['puranikatharva', 'mayurgonbare22', 'maneaniket', 'shirishparkhe']",9,"['lekhakande', 'anitadey12', 'neonargon5', 'rasikapotdar2108', 'siddheshgothankar', 'snehalpatil', 'shraddha.dhage', 'shraddhasam78', 'mithilagajarmal']",27,"['rajeshree.kumbhar5018', 'sampadaphatak28', 'ani.date23', 'mbhosale863', 'niharmasurkar', 'bhandarinirali57', 'pandeydeepak825', 'imdevendra258', 'pawargeeta177', 'dilip.wakdikar', 'bolekunal42', 'trambakesh97', 'madhuri.thosare13', 'pritijha1996', 'ninadmandavkar29', 'abhishek2397', 'ganeshjadhav', None, 'rushikeshsalgar123', 'sahil709', 'dusty', 'prashant.khedkar', 'subodhsawant07', 'sudar', 'panditkunal98', 'vishal8244', 'yogeshmaurya50']",40,"['rajeshree.kumbhar5018', 'sampadaphatak28', 'ani.date23', 'mbhosale863', 'niharmasurkar', 'bhandarinirali57', 'rasikapotdar2108', 'pandeydeepak825', 'lekhakande', 'anitadey12', 'puranikatharva', 'mayurgonbare22', 'imdevendra258', 'maneaniket', 'siddheshgothankar', 'shirishparkhe', 'pawargeeta177', 'shraddhasam78', 'dilip.wakdikar', 'bolekunal42', 'trambakesh97', 'neonargon5', 'madhuri.thosare13', 'pritijha1996', 'ninadmandavkar29', 'abhishek2397', 'ganeshjadhav', 'snehalpatil', None, 'rushikeshsalgar123', 'sahil709', 'dusty', 'prashant.khedkar', 'subodhsawant07', 'sudar', 'panditkunal98', 'vishal8244', 'yogeshmaurya50', 'shraddha.dhage', 'mithilagajarmal']"
59,277,14,7,1,['maneaniket'],12,"['lekhakande', 'anitadey12', 'puranikatharva', 'mayurgonbare22', 'neonargon5', 'rasikapotdar2108', 'siddheshgothankar', 'shirishparkhe', 'snehalpatil', 'shraddha.dhage', 'shraddhasam78', 'mithilagajarmal']",6,"['bonhomie11', 'bhandarinirali57', 'pritijha1996', 'yogeshmaurya50', 'pandeydeepak825', None]",19,"['neonargon5', 'bhandarinirali57', 'pritijha1996', 'rasikapotdar2108', 'snehalpatil', 'pandeydeepak825', None, 'lekhakande', 'anitadey12', 'puranikatharva', 'mayurgonbare22', 'bonhomie11', 'maneaniket', 'siddheshgothankar', 'shirishparkhe', 'yogeshmaurya50', 'shraddha.dhage', 'shraddhasam78', 'mithilagajarmal']"
60,46,14,24,12,"['hongyangao', 'nazanintakbiri', 'aliyaqureshi', 'edward8324', 'fairytail', 'ravichan', 'sayandas', 'abanagozar', 'fatemehkiani', 'spalani', 'zzou', 'awaingade']",1,['jgarchali'],12,"['mtorfeh', 'dchitkara', 'aksamija', 'pfang', 'babak.mirzapour', 'acalambur', 'bmirzapouebe', 'sheringeorge', 'edward83241994', 'srini999', 'xiaomengliu', None]",25,"['hongyangao', 'mtorfeh', 'dchitkara', 'pfang', 'ravichan', 'sheringeorge', 'fatemehkiani', 'zzou', 'sayandas', 'aliyaqureshi', 'srini999', 'spalani', 'awaingade', 'aksamija', 'nazanintakbiri', 'edward8324', 'fairytail', 'bmirzapouebe', 'edward83241994', 'xiaomengliu', None, 'jgarchali', 'babak.mirzapour', 'acalambur', 'abanagozar']"
60,110,14,21,13,"['hongyangao', 'jgarchali', 'nazanintakbiri', 'aliyaqureshi', 'edward8324', 'fairytail', 'ravichan', 'sayandas', 'abanagozar', 'fatemehkiani', 'spalani', 'zzou', 'awaingade']",0,[],8,"['mtorfeh', 'dchitkara', 'shamzehei', 'bmirzapouebe', 'sheringeorge', 'narendranx1', 'mmansouree', None]",21,"['hongyangao', 'mtorfeh', 'dchitkara', 'ravichan', 'sheringeorge', 'fatemehkiani', 'mmansouree', 'zzou', 'sayandas', 'aliyaqureshi', 'narendranx1', 'spalani', 'awaingade', 'nazanintakbiri', 'edward8324', 'fairytail', 'bmirzapouebe', None, 'jgarchali', 'shamzehei', 'abanagozar']"
60,121,14,20,13,"['hongyangao', 'jgarchali', 'nazanintakbiri', 'aliyaqureshi', 'edward8324', 'fairytail', 'ravichan', 'sayandas', 'abanagozar', 'fatemehkiani', 'spalani', 'zzou', 'awaingade']",0,[],7,"['mtorfeh', 'dchitkara', 'bmirzapouebe', 'sheringeorge', 'narendranx1', 'xiaomengliu', None]",20,"['hongyangao', 'mtorfeh', 'dchitkara', 'ravichan', 'sheringeorge', 'fatemehkiani', 'zzou', 'sayandas', 'aliyaqureshi', 'narendranx1', 'spalani', 'awaingade', 'nazanintakbiri', 'edward8324', 'fairytail', 'bmirzapouebe', 'xiaomengliu', None, 'jgarchali', 'abanagozar']"
60,126,14,19,11,"['hongyangao', 'nazanintakbiri', 'aliyaqureshi', 'edward8324', 'fairytail', 'ravichan', 'sayandas', 'abanagozar', 'fatemehkiani', 'zzou', 'awaingade']",2,"['spalani', 'jgarchali']",8,"['dchitkara', 'acalambur', 'sheringeorge', 'srini999', 'mmansouree', 'xiaomengliu', None, 'isaac_fu']",21,"['hongyangao', 'dchitkara', 'ravichan', 'sheringeorge', 'fatemehkiani', 'mmansouree', 'zzou', 'sayandas', 'aliyaqureshi', 'srini999', 'spalani', 'awaingade', 'nazanintakbiri', 'edward8324', 'fairytail', 'xiaomengliu', None, 'isaac_fu', 'jgarchali', 'acalambur', 'abanagozar']"
60,215,14,18,11,"['hongyangao', 'nazanintakbiri', 'aliyaqureshi', 'ravichan', 'fairytail', 'sayandas', 'abanagozar', 'fatemehkiani', 'spalani', 'zzou', 'awaingade']",2,"['edward8324', 'jgarchali']",7,"['dchitkara', 'acalambur', 'sheringeorge', 'srini999', 'mmansouree', 'xiaomengliu', None]",20,"['hongyangao', 'dchitkara', 'nazanintakbiri', 'edward8324', 'fairytail', 'ravichan', 'sheringeorge', 'fatemehkiani', 'mmansouree', 'xiaomengliu', None, 'zzou', 'sayandas', 'jgarchali', 'aliyaqureshi', 'acalambur', 'abanagozar', 'srini999', 'spalani', 'awaingade']"
60,51,14,11,8,"['hongyangao', 'aliyaqureshi', 'ravichan', 'edward8324', 'fatemehkiani', 'spalani', 'sayandas', 'awaingade']",5,"['jgarchali', 'nazanintakbiri', 'fairytail', 'abanagozar', 'zzou']",3,"['mtorfeh', None, 'narendranx1']",16,"['hongyangao', 'mtorfeh', 'nazanintakbiri', 'edward8324', 'fairytail', 'ravichan', 'fatemehkiani', None, 'zzou', 'sayandas', 'jgarchali', 'aliyaqureshi', 'narendranx1', 'abanagozar', 'spalani', 'awaingade']"
62,196,14,12,9,"['malikaqeelanwar', 'athippeswamy3', 'spentapati3', 'abn31', 'kkamdar7', 'sbiri3', 'arajguru7', 'bbhar3', 'gauravpundlik']",4,"['kotharitej', 'prakhe22', 'swadekar3', 'sahanamurthy1317']",3,"['pthomas31', None, 'anthony.gaskell']",16,"['pthomas31', 'swadekar3', 'athippeswamy3', 'kotharitej', 'abn31', 'sbiri3', 'arajguru7', None, 'bbhar3', 'prakhe22', 'malikaqeelanwar', 'anthony.gaskell', 'kkamdar7', 'sahanamurthy1317', 'spentapati3', 'gauravpundlik']"
62,195,14,11,9,"['prakhe22', 'swadekar3', 'athippeswamy3', 'kotharitej', 'abn31', 'kkamdar7', 'spentapati3', 'bbhar3', 'gauravpundlik']",4,"['sahanamurthy1317', 'arajguru7', 'sbiri3', 'malikaqeelanwar']",2,"[None, 'pranavghaisas64']",15,"['swadekar3', 'athippeswamy3', 'kotharitej', 'abn31', 'sbiri3', 'arajguru7', None, 'bbhar3', 'prakhe22', 'malikaqeelanwar', 'pranavghaisas64', 'kkamdar7', 'sahanamurthy1317', 'spentapati3', 'gauravpundlik']"
63,72,13,16,11,"['elin6243', 'emcox', 'aqiu95', 'arr45', 'vmf7', 'ben_jackson341', 'khyland1031', 'covielc', '09petunia', 'sdorukdoganay', 'andubandu']",1,['stefani1703'],5,"['wang.michael213', 'advaitreddy', 'jpablogf95', None, 'ddmf']",17,"['emcox', 'ben_jackson341', 'khyland1031', 'stefani1703', 'covielc', '09petunia', None, 'ddmf', 'elin6243', 'wang.michael213', 'jpablogf95', 'advaitreddy', 'aqiu95', 'arr45', 'vmf7', 'sdorukdoganay', 'andubandu']"
64,120,13,14,11,"['prashanth.kittu25', 'btly9b', 'ht2r2', 'sharukhguntur', 'srivardhinich95', 'v.gsanjana598', 'keygan.foster', 'maanb2', 'athiya.nizam', 'vc4fg', 'jurxcn']",1,['marajan0'],3,"['pradeepvallam111', None, 'sehtab']",15,"['btly9b', 'ht2r2', 'keygan.foster', 'pradeepvallam111', 'maanb2', None, 'vc4fg', 'jurxcn', 'prashanth.kittu25', 'sharukhguntur', 'sehtab', 'v.gsanjana598', 'athiya.nizam', 'marajan0', 'srivardhinich95']"
65,46,13,24,2,"['babak.mirzapour', 'edward83241994']",10,"['arshadans811', 'uzaifashaikh99', 'reshma', 'shaikhasif0114', 'sameera.syed', 'prachiraorane1', 'nishant3j', 'leo.official.mail', 'shaanshaikh092', 'fhsk19']",22,"['hongyangao', 'mtorfeh', 'dchitkara', 'pfang', 'ravichan', 'sheringeorge', 'fatemehkiani', 'zzou', 'sayandas', 'aliyaqureshi', 'srini999', 'spalani', 'awaingade', 'aksamija', 'nazanintakbiri', 'edward8324', 'fairytail', 'bmirzapouebe', 'xiaomengliu', None, 'acalambur', 'abanagozar']",34,"['hongyangao', 'mtorfeh', 'dchitkara', 'arshadans811', 'uzaifashaikh99', 'pfang', 'ravichan', 'sheringeorge', 'fatemehkiani', 'sayandas', 'zzou', 'aliyaqureshi', 'sameera.syed', 'nishant3j', 'srini999', 'spalani', 'shaanshaikh092', 'fhsk19', 'awaingade', 'aksamija', 'nazanintakbiri', 'edward8324', 'fairytail', 'bmirzapouebe', 'edward83241994', 'leo.official.mail', 'xiaomengliu', None, 'babak.mirzapour', 'shaikhasif0114', 'reshma', 'prachiraorane1', 'acalambur', 'abanagozar']"
65,47,13,15,7,"['arshadans811', 'uzaifashaikh99', 'shaikhasif0114', 'sameera.syed', 'prachiraorane1', 'shaanshaikh092', 'fhsk19']",5,"['babak.mirzapour', 'reshma', 'nishant3j', 'edward83241994', 'leo.official.mail']",8,"['aruship03.ap', 'kprathamesh45', 'nishadewangan4991', 'poojashitole', 'sayleechandavarkar', 'afaque.qazi', None, 'komaldave007']",20,"['arshadans811', 'uzaifashaikh99', 'aruship03.ap', 'kprathamesh45', 'nishadewangan4991', 'poojashitole', 'edward83241994', 'leo.official.mail', None, 'komaldave007', 'babak.mirzapour', 'shaikhasif0114', 'reshma', 'sameera.syed', 'prachiraorane1', 'nishant3j', 'sayleechandavarkar', 'afaque.qazi', 'shaanshaikh092', 'fhsk19']"
66,159,13,40,12,"['owellbor', 'pangn', 'rsabatel', 'white494', 'pike10', 'melvin3', 'mserewic', 'dshoue', 'rleather', 'pkurczek', 'mason92', 'lucast']",0,[],28,"['payne68', 'sachdev0', 'mbalog', 'bprestin', 'mtan05280528', 'cervantd', 'wu795', 'titus9', 'rmaccion', 'rskoog', 'ma529', 'giesler', 'cknechte', 'morgoncosby', 'kboateng', 'peck11', 'ray76', 'clark485', 'sheng18', None, 'gray164', 'davidjohnson', 'kjacobi', 'su107', 'keener0', 'psteckle', 'morri382', 'akunzman']",40,"['payne68', 'sachdev0', 'mbalog', 'bprestin', 'mtan05280528', 'rleather', 'pkurczek', 'cervantd', 'rmaccion', 'titus9', 'wu795', 'rskoog', 'ma529', 'giesler', 'dshoue', 'cknechte', 'morgoncosby', 'kboateng', 'owellbor', 'pangn', 'peck11', 'melvin3', 'morri382', 'mserewic', 'clark485', 'ray76', 'sheng18', None, 'lucast', 'gray164', 'davidjohnson', 'kjacobi', 'rsabatel', 'white494', 'pike10', 'su107', 'keener0', 'psteckle', 'mason92', 'akunzman']"
66,226,13,38,12,"['owellbor', 'pangn', 'rsabatel', 'white494', 'pike10', 'melvin3', 'mserewic', 'dshoue', 'rleather', 'pkurczek', 'mason92', 'lucast']",0,[],26,"['payne68', 'sachdev0', 'mbalog', 'bprestin', 'mtan05280528', 'cervantd', 'wu795', 'rmaccion', 'rskoog', 'ma529', 'giesler', 'cknechte', 'morgoncosby', 'kboateng', 'peck11', 'ray76', 'clark485', 'sheng18', None, 'gray164', 'kjacobi', 'su107', 'keener0', 'psteckle', 'morri382', 'akunzman']",38,"['payne68', 'sachdev0', 'mbalog', 'bprestin', 'mtan05280528', 'rleather', 'pkurczek', 'cervantd', 'rmaccion', 'wu795', 'rskoog', 'ma529', 'giesler', 'dshoue', 'cknechte', 'morgoncosby', 'kboateng', 'owellbor', 'pangn', 'peck11', 'melvin3', 'morri382', 'mserewic', 'clark485', 'ray76', 'sheng18', None, 'lucast', 'gray164', 'kjacobi', 'rsabatel', 'white494', 'pike10', 'su107', 'keener0', 'psteckle', 'mason92', 'akunzman']"
66,99,13,17,2,"['pangn', 'rleather']",10,"['owellbor', 'rsabatel', 'white494', 'pike10', 'melvin3', 'mserewic', 'dshoue', 'pkurczek', 'mason92', 'lucast']",15,"['tgoldbe', None, 'kkurpius', 'wu801', 'saldwin', 'zhan2536', 'dinino', 'mbanerje', 'dtisdale', 'mill1914', 'dbradbu', 'iaranadi', 'petrosky', 'rmaccion', 'akunzman']",27,"['owellbor', 'pangn', 'melvin3', 'mill1914', 'mserewic', 'dbradbu', 'rleather', 'petrosky', 'pkurczek', 'rmaccion', 'lucast', 'mbanerje', None, 'tgoldbe', 'kkurpius', 'wu801', 'rsabatel', 'saldwin', 'white494', 'zhan2536', 'pike10', 'dinino', 'dtisdale', 'dshoue', 'iaranadi', 'mason92', 'akunzman']"
66,160,13,9,2,"['pangn', 'rleather']",10,"['owellbor', 'rsabatel', 'white494', 'pike10', 'melvin3', 'mserewic', 'dshoue', 'pkurczek', 'mason92', 'lucast']",7,"[None, 'rskoog', 'giesler', 'ray76', 'psteckle', 'sheng18', 'morri382']",19,"['owellbor', 'pangn', 'melvin3', 'morri382', 'mserewic', 'rleather', 'ray76', 'pkurczek', 'sheng18', None, 'lucast', 'rskoog', 'rsabatel', 'giesler', 'white494', 'pike10', 'dshoue', 'psteckle', 'mason92']"
66,101,13,7,1,['owellbor'],11,"['pangn', 'rsabatel', 'white494', 'pike10', 'melvin3', 'mserewic', 'dshoue', 'rleather', 'pkurczek', 'mason92', 'lucast']",6,"['tarabear1313', 'saldwin', 'dinino', 'dtisdale', 'dbradbu', None]",18,"['owellbor', 'pangn', 'melvin3', 'mserewic', 'dbradbu', 'rleather', 'pkurczek', None, 'lucast', 'tarabear1313', 'rsabatel', 'saldwin', 'white494', 'dinino', 'pike10', 'dtisdale', 'dshoue', 'mason92']"
66,103,13,6,5,"['owellbor', 'white494', 'mserewic', 'rleather', 'mason92']",7,"['pangn', 'rsabatel', 'pike10', 'melvin3', 'dshoue', 'pkurczek', 'lucast']",1,[None],13,"['owellbor', None, 'pangn', 'rsabatel', 'white494', 'pike10', 'melvin3', 'mserewic', 'dshoue', 'rleather', 'pkurczek', 'mason92', 'lucast']"
67,276,13,90,3,"['akshay1997bhagit', 'atulkokane1234', 'sarika']",9,"['sayali_m9', 'dipsbhalekar', 'priyaj1235', 'divekarpragati7', 'ngmahajan1', 'nimishakurup857', 'ankita123', 'theindianpacifist', 'madhuranasare']",87,"['rajeshree.kumbhar5018', 'ashishghoderao', 'sumitmhatre5670', 'ronak.tiwari', 'sanchitkad', 'rasikapotdar2108', 'aishuauti20496', 'adnan.s', 'ritik.singh', 'prerana.goythale', 'pandeydeepak825', 'shweta.joglekar', 'mounikajalla99', 'puranikatharva', 'bonhomie11', 'prathamesh.nikam', 'bhushan9321', 'vishalnaik.0210', 'harishkumar.n', 'sanketmane1997.sm', 'shirishparkhe', 'krunal.kasar', 'sendpost2mahesh', 'sid.jagtap1992', 'surbhib2897', 'shraddhasam78', 'richitapatil', 'yashuishwar', 'atul', 'paromita24', 'niveditachaudhari', 'mhatrenrupal42', 'neonargon5', 'ayesha.pathan', 'digvijayjadeja725', 'shrey.joshi', 'ninadmandavkar29', 'nehamallan', 'nishigandhaprsd14', 'rushikeshsalgar123', 'sahil709', 'ameyc007', 'neelamt', 'amarravade31', 'patiltejas000003', 'akshatamahajan47', 'yogeshmaurya50', 'gaurav.mishra', 'vivekrana', 'manjarekarchinmayeen', 'riddhi737', 'niharmasurkar', 'apurvawaghmode14', 'bhandarinirali57', 'bhagyashrimali280497', 'mihirgogri613', 'sarika_bukkawar', 'lekhakande', 'pratibhagawari28', 'nirav.lm', 'anitadey12', 'rohan.mestry', 'mayurgonbare22', 'dhavit.v', 'sumitpatil512', 'sonali.ramji', 'dleena19961209', 'maneaniket', 'siddheshgothankar', 'yuvraj.t', 'electronics209', 'raj.vadariya', 'trambakesh97', 'pritijha1996', 'bgharat713', 'mayank.vp', 'preethinaik', 'snehalpatil', 'rajesh05', None, 'shreyas.v', 'veronicathapa56', 'podililaxmi30', 'divyassingh56', 'shraddha.dhage', 'hborse28', 'mithilagajarmal']",99,"['rajeshree.kumbhar5018', 'ashishghoderao', 'sumitmhatre5670', 'ronak.tiwari', 'sanchitkad', 'rasikapotdar2108', 'aishuauti20496', 'adnan.s', 'ngmahajan1', 'ritik.singh', 'nimishakurup857', 'prerana.goythale', 'pandeydeepak825', 'shweta.joglekar', 'mounikajalla99', 'puranikatharva', 'bonhomie11', 'prathamesh.nikam', 'bhushan9321', 'vishalnaik.0210', 'harishkumar.n', 'sanketmane1997.sm', 'shirishparkhe', 'krunal.kasar', 'sendpost2mahesh', 'sid.jagtap1992', 'surbhib2897', 'shraddhasam78', 'richitapatil', 'yashuishwar', 'atul', 'paromita24', 'niveditachaudhari', 'mhatrenrupal42', 'neonargon5', 'ayesha.pathan', 'digvijayjadeja725', 'shrey.joshi', 'ninadmandavkar29', 'nehamallan', 'nishigandhaprsd14', 'rushikeshsalgar123', 'sahil709', 'ameyc007', 'neelamt', 'dipsbhalekar', 'amarravade31', 'patiltejas000003', 'akshatamahajan47', 'yogeshmaurya50', 'gaurav.mishra', 'vivekrana', 'manjarekarchinmayeen', 'divekarpragati7', 'riddhi737', 'niharmasurkar', 'apurvawaghmode14', 'bhandarinirali57', 'bhagyashrimali280497', 'mihirgogri613', 'ankita123', 'sarika_bukkawar', 'lekhakande', 'pratibhagawari28', 'nirav.lm', 'anitadey12', 'rohan.mestry', 'mayurgonbare22', 'dhavit.v', 'sumitpatil512', 'sonali.ramji', 'dleena19961209', 'maneaniket', 'siddheshgothankar', 'yuvraj.t', 'akshay1997bhagit', 'atulkokane1234', 'electronics209', 'raj.vadariya', 'sayali_m9', 'priyaj1235', 'trambakesh97', 'sarika', 'pritijha1996', 'bgharat713', 'mayank.vp', 'preethinaik', 'snehalpatil', 'rajesh05', 'theindianpacifist', None, 'shreyas.v', 'veronicathapa56', 'podililaxmi30', 'divyassingh56', 'shraddha.dhage', 'hborse28', 'madhuranasare', 'mithilagajarmal']"
67,275,13,59,9,"['sayali_m9', 'dipsbhalekar', 'priyaj1235', 'divekarpragati7', 'ngmahajan1', 'nimishakurup857', 'akshay1997bhagit', 'theindianpacifist', 'madhuranasare']",3,"['atulkokane1234', 'ankita123', 'sarika']",50,"['pranittambde', 'tejas7', 'siddhant319', 'ashishghoderao', 'abhishekv.1100', 'divujagushte26', 'siddhu.murkar', 'sawardekarsuyash97', 'priyankaingle18', 'goreravindra95', 'bonhomie11', 'prasad.creativity123', 'chinmaysj96', 'narvekarsushant0', 'prasad24shingade', 'pratikpawar4996', 'tusharvan', 'sonali.ramji', 'salianyatish111', 'surbhib2897', 'amritamukeshb', 'sinalkarshweta5', 'jayshreepakhare63', 'santoshiparab11', 'snehaspm1397', 'sanketdamame', 'dkgupata9768522176', 'rutvikstar', 'rohitwaghmare1997', 'siddhantwarankar', 'navneet.nrj', 'bhamghodke7', 'jr.abishek00', None, 'ameykokate2015', 'ranegirish24', 'shivanilohar55', 'pankajpawar1515', 'sgharat297', 'satsamjr', 'vedankasalunke96', 'shirsekarakash', 'aartibhalerao29', 'k.vekhande69', 'kshemkalyanimanjiri11', 'rahul2011star', 'aniruddhaparte3', 'karishmahirve96', 'adityagudla96', 'kavusatose123']",62,"['pranittambde', 'ashishghoderao', 'divujagushte26', 'ngmahajan1', 'nimishakurup857', 'priyankaingle18', 'goreravindra95', 'bonhomie11', 'tusharvan', 'salianyatish111', 'surbhib2897', 'jayshreepakhare63', 'siddhantwarankar', 'navneet.nrj', 'bhamghodke7', 'ameykokate2015', 'ranegirish24', 'shivanilohar55', 'pankajpawar1515', 'satsamjr', 'dipsbhalekar', 'aartibhalerao29', 'kshemkalyanimanjiri11', 'rahul2011star', 'aniruddhaparte3', 'karishmahirve96', 'kavusatose123', 'tejas7', 'siddhant319', 'divekarpragati7', 'abhishekv.1100', 'siddhu.murkar', 'ankita123', 'sawardekarsuyash97', 'prasad.creativity123', 'chinmaysj96', 'narvekarsushant0', 'prasad24shingade', 'pratikpawar4996', 'sonali.ramji', 'akshay1997bhagit', 'amritamukeshb', 'sinalkarshweta5', 'atulkokane1234', 'santoshiparab11', 'snehaspm1397', 'sanketdamame', 'dkgupata9768522176', 'sayali_m9', 'rutvikstar', 'priyaj1235', 'rohitwaghmare1997', 'sarika', 'jr.abishek00', 'theindianpacifist', None, 'sgharat297', 'vedankasalunke96', 'shirsekarakash', 'k.vekhande69', 'adityagudla96', 'madhuranasare']"
68,67,13,16,2,"['rhlklwr', 'poojathorat157']",10,"['shruti.g.shetty', 'rutuja.pate', 'prachi.shinde', 'pratik.brid', 'sayali.avhad', 'gaurav.mahajan', 'shamlishelar', 'chetan.mhaske', 'prathamesh.prakash', 'sunny23']",14,"['ssw10j', 'mihir.joshi', 'siddharth.mundada', 'ie2012.advait.mohile', 'et2012.tejas.patil', 'darshana.mahajan', 'ie2012.krishna.paryani', 'rushabh.patil', 'ssonali_21', 'shaanigwwass2', 'nehal.jahagirdar', 'akshaymane1296', None, 'supriya.palve']",26,"['ssw10j', 'poojathorat157', 'supriya.palve', 'et2012.tejas.patil', 'darshana.mahajan', 'ie2012.krishna.paryani', 'rushabh.patil', 'ssonali_21', 'shaanigwwass2', 'chetan.mhaske', None, 'shruti.g.shetty', 'mihir.joshi', 'rutuja.pate', 'siddharth.mundada', 'prachi.shinde', 'ie2012.advait.mohile', 'pratik.brid', 'nehal.jahagirdar', 'sayali.avhad', 'gaurav.mahajan', 'rhlklwr', 'shamlishelar', 'akshaymane1296', 'prathamesh.prakash', 'sunny23']"
68,65,13,14,8,"['shruti.g.shetty', 'rutuja.pate', 'gaurav.mahajan', 'shamlishelar', 'rhlklwr', 'chetan.mhaske', 'prathamesh.prakash', 'sunny23']",4,"['sayali.avhad', 'prachi.shinde', 'pratik.brid', 'poojathorat157']",6,"['pawan.sukhwani', 'ssonali_21', 'shaanigwwass2', 'kushal.bhosale', None, 'supriya.palve']",18,"['poojathorat157', 'supriya.palve', 'ssonali_21', 'shaanigwwass2', 'kushal.bhosale', 'chetan.mhaske', None, 'shruti.g.shetty', 'rutuja.pate', 'pawan.sukhwani', 'prachi.shinde', 'pratik.brid', 'sayali.avhad', 'gaurav.mahajan', 'rhlklwr', 'shamlishelar', 'prathamesh.prakash', 'sunny23']"
68,66,13,10,3,"['sunny23', 'prachi.shinde', 'poojathorat157']",9,"['shruti.g.shetty', 'rutuja.pate', 'pratik.brid', 'sayali.avhad', 'gaurav.mahajan', 'rhlklwr', 'shamlishelar', 'chetan.mhaske', 'prathamesh.prakash']",7,"['sahil.tasgavkar', 'gayatri.devadiga', 'rahul.yadav', 'pawan.sukhwani', 'ssonali_21', 'mayur_sn', None]",19,"['sahil.tasgavkar', 'gayatri.devadiga', 'poojathorat157', 'ssonali_21', 'mayur_sn', 'chetan.mhaske', None, 'shruti.g.shetty', 'rahul.yadav', 'rutuja.pate', 'pawan.sukhwani', 'prachi.shinde', 'pratik.brid', 'sayali.avhad', 'gaurav.mahajan', 'rhlklwr', 'shamlishelar', 'prathamesh.prakash', 'sunny23']"
69,57,13,65,8,"['vinodnair46', 'pguleria', 'harish8528', 'adsoni468', 'singh5987', 'tanmay9', 'pradipkumar200', 'dheereshpoojary']",4,"['shardulmalvankar2104', 'rohan.pawar', 'harini.iyer', 'atoros']",57,"['gnthakore', 'amal31', 'vishal914', 'thapabhavana13', 'samirbobade', 'pratik2225', 'ashpillai.1996', 'sjayyant31', 'ashetty07', 'mayureshnagvekar57', 'mhaskaraditya21', 'zainawk0', 'prathemeshjd3200', 'gaikarprashant6', 'chavanv953', 'gvishs15', 'jobin301', 'vaishak', 'vishwas', 'komalsurve982', 'kurawless15ex', 'mdeshmukh', 'jas.sahmbi123', 'rohitchaudhari10021996', 'anil8796069443', 'singhrajkarn1699', 'mankumre96', 'ladnishis15', 'shrutis31', 'bhagyashree.narewade', 'jiteshutekar', 'aniket_15', 'mayanair1104', 'ie2012.krishna.paryani', 'thapa156', 'yashvadkar6969', 'aadi1212', 'deepalisingh195', 'pbhaveshv15et', 'vmundhe1234', 'sushantpawar2508', 'guptasandeep220', 'wtushart15e', 'uyewale', 'komalsb37', 'sukhpreet11234kldfhd', 'shubham.patil585', 'vjrasal1', 'bilalp188', 'autikiran77', 'bkumar', 'nless363', 'mkhanvilkar', None, 'vishurajigare10', 'spolai', 'tejdhupkar']",69,"['gnthakore', 'amal31', 'vishal914', 'thapabhavana13', 'samirbobade', 'pratik2225', 'ashpillai.1996', 'sjayyant31', 'singh5987', 'ashetty07', 'mayureshnagvekar57', 'vinodnair46', 'pguleria', 'atoros', 'mhaskaraditya21', 'zainawk0', 'prathemeshjd3200', 'gaikarprashant6', 'pradipkumar200', 'chavanv953', 'gvishs15', 'jobin301', 'vaishak', 'vishwas', 'komalsurve982', 'kurawless15ex', 'mdeshmukh', 'jas.sahmbi123', 'harish8528', 'rohitchaudhari10021996', 'anil8796069443', 'rohan.pawar', 'singhrajkarn1699', 'mankumre96', 'shardulmalvankar2104', 'ladnishis15', 'shrutis31', 'bhagyashree.narewade', 'jiteshutekar', 'aniket_15', 'mayanair1104', 'ie2012.krishna.paryani', 'thapa156', 'adsoni468', 'yashvadkar6969', 'aadi1212', 'dheereshpoojary', 'deepalisingh195', 'pbhaveshv15et', 'vmundhe1234', 'sushantpawar2508', 'guptasandeep220', 'wtushart15e', 'uyewale', 'komalsb37', 'tanmay9', 'sukhpreet11234kldfhd', 'shubham.patil585', 'vjrasal1', 'bilalp188', 'autikiran77', 'bkumar', 'harini.iyer', 'nless363', 'mkhanvilkar', None, 'vishurajigare10', 'spolai', 'tejdhupkar']"
69,59,13,10,3,"['shardulmalvankar2104', 'rohan.pawar', 'harini.iyer']",9,"['vinodnair46', 'pguleria', 'atoros', 'harish8528', 'adsoni468', 'singh5987', 'tanmay9', 'pradipkumar200', 'dheereshpoojary']",7,"['sanhita.bhagwat', 'darshana.mahajan', 'kushal.bhosale', 'ie2012.jibran.nakhwa', 'sonali.kalbande', None, 'hashmeet.chaudhery']",19,"['sanhita.bhagwat', 'darshana.mahajan', 'adsoni468', 'singh5987', 'harini.iyer', 'kushal.bhosale', 'ie2012.jibran.nakhwa', 'dheereshpoojary', None, 'hashmeet.chaudhery', 'vinodnair46', 'pguleria', 'atoros', 'harish8528', 'rohan.pawar', 'shardulmalvankar2104', 'sonali.kalbande', 'tanmay9', 'pradipkumar200']"
69,60,13,10,1,['shardulmalvankar2104'],11,"['vinodnair46', 'pguleria', 'atoros', 'harish8528', 'rohan.pawar', 'adsoni468', 'singh5987', 'harini.iyer', 'tanmay9', 'pradipkumar200', 'dheereshpoojary']",9,"['abhishek.manurkar', None, 'darshana.mahajan', 'kushal.bhosale', 'chinmay.shetye', 'sonali.kalbande', 'ie2012.jibran.nakhwa', 'abhay.kshirsagar', 'hashmeet.chaudhery']",21,"['abhishek.manurkar', 'darshana.mahajan', 'adsoni468', 'singh5987', 'harini.iyer', 'kushal.bhosale', 'ie2012.jibran.nakhwa', 'dheereshpoojary', None, 'hashmeet.chaudhery', 'vinodnair46', 'pguleria', 'atoros', 'harish8528', 'rohan.pawar', 'chinmay.shetye', 'shardulmalvankar2104', 'sonali.kalbande', 'tanmay9', 'pradipkumar200', 'abhay.kshirsagar']"
70,255,13,15,10,"['yl4807', 'hsp291', 'ms9670', 'kexinli', 'liuroujia', 'jj2285', 'yw3100', 'kcs431', 'bs2849', 'yz3814']",2,"['jimmy4048', 'imfree0322116']",5,"['sc6023', 'adityakulai7', 'harshithreddy016', 'jvk249', None]",17,"['hsp291', 'ms9670', 'kexinli', 'liuroujia', 'yw3100', 'kcs431', None, 'yl4807', 'sc6023', 'jimmy4048', 'adityakulai7', 'jj2285', 'jvk249', 'harshithreddy016', 'imfree0322116', 'bs2849', 'yz3814']"
70,254,13,6,1,['jimmy4048'],11,"['yl4807', 'hsp291', 'ms9670', 'kexinli', 'liuroujia', 'jj2285', 'yw3100', 'kcs431', 'imfree0322116', 'bs2849', 'yz3814']",5,"['wu09803026', 'huangyaoting', 'eshem3347', 'h56789106', None]",17,"['yl4807', 'wu09803026', 'jimmy4048', 'hsp291', 'ms9670', 'kexinli', 'liuroujia', 'jj2285', 'yw3100', 'huangyaoting', 'kcs431', 'eshem3347', 'imfree0322116', 'h56789106', None, 'bs2849', 'yz3814']"
71,283,12,13,11,"['patshard17', 'jadhavdarshan533', 'cvkolhe1994', 'abhishekmhaskar55', 'apjadhav67', 'ssk110596', 'rohitmehetre701', 'mandarmhatre96', 'chetan.hirlekar', 'abhishekpisal07', 'mbhagyashri111296']",0,[],2,"['jayeshmore583', None]",13,"['patshard17', 'jadhavdarshan533', 'jayeshmore583', 'abhishekmhaskar55', 'cvkolhe1994', 'ssk110596', 'chetan.hirlekar', None, 'apjadhav67', 'rohitmehetre701', 'mandarmhatre96', 'abhishekpisal07', 'mbhagyashri111296']"
71,236,12,12,11,"['patshard17', 'jadhavdarshan533', 'cvkolhe1994', 'abhishekmhaskar55', 'apjadhav67', 'ssk110596', 'rohitmehetre701', 'mandarmhatre96', 'chetan.hirlekar', 'abhishekpisal07', 'mbhagyashri111296']",0,[],1,[None],12,"['patshard17', 'jadhavdarshan533', 'abhishekmhaskar55', 'cvkolhe1994', 'ssk110596', 'chetan.hirlekar', None, 'apjadhav67', 'rohitmehetre701', 'mandarmhatre96', 'abhishekpisal07', 'mbhagyashri111296']"
72,264,12,7,6,"['viban', 'jnoszek', 'emilycf', 'mmockett', 'ericwong', 'raynachiguchi']",5,"['ehsoice', 'darlaearl22', 'znlallas', 'qinzhao', 'gracemel']",1,[None],12,"['viban', 'ehsoice', 'darlaearl22', 'jnoszek', 'emilycf', 'znlallas', 'mmockett', 'qinzhao', 'gracemel', None, 'ericwong', 'raynachiguchi']"
73,276,12,90,1,['mounikajalla99'],10,"['tejas7', 'sanketdamame', 'vedankasalunke96', 'rohitwaghmare1997', 'aartibhalerao29', 'chinmaysj96', 'prasad24shingade', 'aniruddhaparte3', 'sinalkarshweta5', 'sawardekarsuyash97']",89,"['rajeshree.kumbhar5018', 'ashishghoderao', 'sumitmhatre5670', 'ronak.tiwari', 'sanchitkad', 'rasikapotdar2108', 'aishuauti20496', 'adnan.s', 'ritik.singh', 'prerana.goythale', 'pandeydeepak825', 'shweta.joglekar', 'puranikatharva', 'bonhomie11', 'prathamesh.nikam', 'bhushan9321', 'vishalnaik.0210', 'harishkumar.n', 'sanketmane1997.sm', 'shirishparkhe', 'krunal.kasar', 'sendpost2mahesh', 'sid.jagtap1992', 'surbhib2897', 'shraddhasam78', 'richitapatil', 'yashuishwar', 'atul', 'paromita24', 'niveditachaudhari', 'mhatrenrupal42', 'neonargon5', 'ayesha.pathan', 'digvijayjadeja725', 'shrey.joshi', 'ninadmandavkar29', 'nehamallan', 'nishigandhaprsd14', 'rushikeshsalgar123', 'sahil709', 'ameyc007', 'neelamt', 'amarravade31', 'patiltejas000003', 'akshatamahajan47', 'yogeshmaurya50', 'gaurav.mishra', 'vivekrana', 'manjarekarchinmayeen', 'riddhi737', 'niharmasurkar', 'apurvawaghmode14', 'bhandarinirali57', 'bhagyashrimali280497', 'mihirgogri613', 'sarika_bukkawar', 'lekhakande', 'pratibhagawari28', 'nirav.lm', 'anitadey12', 'rohan.mestry', 'mayurgonbare22', 'dhavit.v', 'sumitpatil512', 'sonali.ramji', 'dleena19961209', 'maneaniket', 'siddheshgothankar', 'yuvraj.t', 'akshay1997bhagit', 'atulkokane1234', 'electronics209', 'raj.vadariya', 'trambakesh97', 'sarika', 'pritijha1996', 'bgharat713', 'mayank.vp', 'preethinaik', 'snehalpatil', 'rajesh05', None, 'shreyas.v', 'veronicathapa56', 'podililaxmi30', 'divyassingh56', 'shraddha.dhage', 'hborse28', 'mithilagajarmal']",100,"['rajeshree.kumbhar5018', 'ashishghoderao', 'sumitmhatre5670', 'ronak.tiwari', 'sanchitkad', 'rasikapotdar2108', 'aishuauti20496', 'adnan.s', 'ritik.singh', 'prerana.goythale', 'pandeydeepak825', 'mounikajalla99', 'shweta.joglekar', 'puranikatharva', 'bonhomie11', 'prathamesh.nikam', 'bhushan9321', 'vishalnaik.0210', 'harishkumar.n', 'sanketmane1997.sm', 'shirishparkhe', 'krunal.kasar', 'sendpost2mahesh', 'sid.jagtap1992', 'surbhib2897', 'shraddhasam78', 'richitapatil', 'yashuishwar', 'atul', 'paromita24', 'niveditachaudhari', 'mhatrenrupal42', 'neonargon5', 'ayesha.pathan', 'digvijayjadeja725', 'shrey.joshi', 'ninadmandavkar29', 'nehamallan', 'nishigandhaprsd14', 'rushikeshsalgar123', 'sahil709', 'ameyc007', 'neelamt', 'amarravade31', 'aartibhalerao29', 'patiltejas000003', 'aniruddhaparte3', 'akshatamahajan47', 'yogeshmaurya50', 'tejas7', 'gaurav.mishra', 'vivekrana', 'manjarekarchinmayeen', 'riddhi737', 'niharmasurkar', 'apurvawaghmode14', 'bhandarinirali57', 'bhagyashrimali280497', 'mihirgogri613', 'sarika_bukkawar', 'sawardekarsuyash97', 'lekhakande', 'pratibhagawari28', 'nirav.lm', 'anitadey12', 'rohan.mestry', 'mayurgonbare22', 'chinmaysj96', 'prasad24shingade', 'dhavit.v', 'sumitpatil512', 'sonali.ramji', 'dleena19961209', 'maneaniket', 'siddheshgothankar', 'yuvraj.t', 'akshay1997bhagit', 'sinalkarshweta5', 'atulkokane1234', 'electronics209', 'sanketdamame', 'raj.vadariya', 'rohitwaghmare1997', 'trambakesh97', 'sarika', 'pritijha1996', 'bgharat713', 'mayank.vp', 'preethinaik', 'snehalpatil', 'rajesh05', None, 'shreyas.v', 'veronicathapa56', 'podililaxmi30', 'vedankasalunke96', 'divyassingh56', 'shraddha.dhage', 'hborse28', 'mithilagajarmal']"
73,275,12,59,10,"['tejas7', 'sanketdamame', 'vedankasalunke96', 'rohitwaghmare1997', 'aartibhalerao29', 'chinmaysj96', 'prasad24shingade', 'aniruddhaparte3', 'sinalkarshweta5', 'sawardekarsuyash97']",1,['mounikajalla99'],49,"['pranittambde', 'siddhant319', 'ashishghoderao', 'divekarpragati7', 'abhishekv.1100', 'divujagushte26', 'ngmahajan1', 'nimishakurup857', 'siddhu.murkar', 'priyankaingle18', 'goreravindra95', 'bonhomie11', 'prasad.creativity123', 'narvekarsushant0', 'pratikpawar4996', 'tusharvan', 'sonali.ramji', 'salianyatish111', 'akshay1997bhagit', 'surbhib2897', 'amritamukeshb', 'jayshreepakhare63', 'santoshiparab11', 'snehaspm1397', 'dkgupata9768522176', 'sayali_m9', 'rutvikstar', 'priyaj1235', 'siddhantwarankar', 'navneet.nrj', 'bhamghodke7', 'jr.abishek00', 'theindianpacifist', None, 'ameykokate2015', 'ranegirish24', 'shivanilohar55', 'pankajpawar1515', 'sgharat297', 'satsamjr', 'dipsbhalekar', 'shirsekarakash', 'k.vekhande69', 'kshemkalyanimanjiri11', 'rahul2011star', 'karishmahirve96', 'adityagudla96', 'madhuranasare', 'kavusatose123']",60,"['pranittambde', 'ashishghoderao', 'divujagushte26', 'ngmahajan1', 'nimishakurup857', 'priyankaingle18', 'mounikajalla99', 'goreravindra95', 'bonhomie11', 'tusharvan', 'salianyatish111', 'surbhib2897', 'jayshreepakhare63', 'siddhantwarankar', 'navneet.nrj', 'bhamghodke7', 'ameykokate2015', 'ranegirish24', 'shivanilohar55', 'pankajpawar1515', 'satsamjr', 'dipsbhalekar', 'aartibhalerao29', 'kshemkalyanimanjiri11', 'aniruddhaparte3', 'rahul2011star', 'karishmahirve96', 'kavusatose123', 'tejas7', 'siddhant319', 'divekarpragati7', 'abhishekv.1100', 'siddhu.murkar', 'sawardekarsuyash97', 'prasad.creativity123', 'chinmaysj96', 'prasad24shingade', 'narvekarsushant0', 'pratikpawar4996', 'sonali.ramji', 'akshay1997bhagit', 'sinalkarshweta5', 'amritamukeshb', 'santoshiparab11', 'sanketdamame', 'snehaspm1397', 'dkgupata9768522176', 'sayali_m9', 'rutvikstar', 'priyaj1235', 'rohitwaghmare1997', 'jr.abishek00', 'theindianpacifist', None, 'sgharat297', 'vedankasalunke96', 'shirsekarakash', 'k.vekhande69', 'adityagudla96', 'madhuranasare']"
73,268,12,42,9,"['tejas7', 'mounikajalla99', 'vedankasalunke96', 'aartibhalerao29', 'chinmaysj96', 'prasad24shingade', 'aniruddhaparte3', 'sinalkarshweta5', 'sawardekarsuyash97']",2,"['rohitwaghmare1997', 'sanketdamame']",33,"['pranittambde', 'siddhant319', 'sarvesh107', 'siddhu.murkar', 'priyankaingle18', 'shreya9609', 'goreravindra95', 'bonhomie11', 'narvekarsushant0', 'pratikpawar4996', 'tusharvan', 'sonali.ramji', 'salianyatish111', 'amritamukeshb', 'surbhib2897', 'santoshiparab11', 'snehaspm1397', 'dkgupata9768522176', 'siddhantwarankar', 'vrushalithakare82', 'navneet.nrj', 'bhamghodke7', 'jr.abishek00', None, 'shivanilohar55', 'ranegirish24', 'pankajpawar1515', 'satsamjr', 'shirsekarakash', 'vinayak183', 'rahul2011star', 'adityagudla96', 'kavusatose123']",44,"['pranittambde', 'tejas7', 'siddhant319', 'sarvesh107', 'siddhu.murkar', 'sawardekarsuyash97', 'priyankaingle18', 'mounikajalla99', 'shreya9609', 'goreravindra95', 'bonhomie11', 'chinmaysj96', 'prasad24shingade', 'narvekarsushant0', 'pratikpawar4996', 'tusharvan', 'sonali.ramji', 'salianyatish111', 'sinalkarshweta5', 'surbhib2897', 'amritamukeshb', 'santoshiparab11', 'sanketdamame', 'snehaspm1397', 'dkgupata9768522176', 'rohitwaghmare1997', 'siddhantwarankar', 'vrushalithakare82', 'navneet.nrj', 'bhamghodke7', 'jr.abishek00', None, 'shivanilohar55', 'ranegirish24', 'pankajpawar1515', 'satsamjr', 'vedankasalunke96', 'shirsekarakash', 'aartibhalerao29', 'vinayak183', 'aniruddhaparte3', 'rahul2011star', 'adityagudla96', 'kavusatose123']"
73,266,12,30,2,"['rohitwaghmare1997', 'sanketdamame']",9,"['tejas7', 'mounikajalla99', 'vedankasalunke96', 'aartibhalerao29', 'chinmaysj96', 'prasad24shingade', 'aniruddhaparte3', 'sinalkarshweta5', 'sawardekarsuyash97']",28,"['vallabhbudhkar', 'ashishghoderao', 'sarvesh107', 'sarveshbhoer158', 'pranaybhatkar', 'shreya9609', 'ronraviram789', 'pritesh.roy27', 'bonhomie11', 'prasad.creativity123', 'deshpande192', 'yashpimpale6', 'dipikapatil097', 'salianyatish111', 'nikamsupriya44', 'jayshreepakhare63', 'apurvaganu1996', 'rincyj327', 'navneet.nrj', 'dwivedidaya1996', None, 'ameykokate2015', 'rawatchefchetan', 'vinayak183', 'karishmahirve96', 'rashmithanair5', 'mitalihaldankar8', 'shreyasgawali123']",39,"['tejas7', 'vallabhbudhkar', 'ashishghoderao', 'sarveshbhoer158', 'sarvesh107', 'pranaybhatkar', 'sawardekarsuyash97', 'mounikajalla99', 'shreya9609', 'ronraviram789', 'pritesh.roy27', 'bonhomie11', 'prasad.creativity123', 'chinmaysj96', 'prasad24shingade', 'deshpande192', 'yashpimpale6', 'dipikapatil097', 'salianyatish111', 'nikamsupriya44', 'sinalkarshweta5', 'jayshreepakhare63', 'apurvaganu1996', 'sanketdamame', 'rincyj327', 'rohitwaghmare1997', 'navneet.nrj', 'dwivedidaya1996', None, 'ameykokate2015', 'rawatchefchetan', 'vedankasalunke96', 'aartibhalerao29', 'vinayak183', 'aniruddhaparte3', 'karishmahirve96', 'rashmithanair5', 'mitalihaldankar8', 'shreyasgawali123']"
73,202,12,29,8,"['tejas7', 'mounikajalla99', 'vedankasalunke96', 'aartibhalerao29', 'prasad24shingade', 'aniruddhaparte3', 'sinalkarshweta5', 'sawardekarsuyash97']",3,"['rohitwaghmare1997', 'sanketdamame', 'chinmaysj96']",21,"['sonam.wairkar', 'digr1992', 'varunndabhade', 'shubhangihnkre14', 'mestryumesh123', 'virajgaikwad421', 'rohanskambles', 'kaminisuroshi26', 'siddhantpawar993', 'madhuri.thosare13', 'navneet.nrj', 'shaileshdsuryawanshi96', None, 'satsamjr', 'sandeep27996', 'kshemkalyanimanjiri11', 'k.vekhande69', 'akshaygodse13', 'divyanshub2311', 'dattaramkolekar', 'kavusatose123']",32,"['tejas7', 'sonam.wairkar', 'digr1992', 'varunndabhade', 'shubhangihnkre14', 'mestryumesh123', 'sawardekarsuyash97', 'virajgaikwad421', 'mounikajalla99', 'chinmaysj96', 'prasad24shingade', 'rohanskambles', 'sinalkarshweta5', 'kaminisuroshi26', 'sanketdamame', 'siddhantpawar993', 'rohitwaghmare1997', 'madhuri.thosare13', 'navneet.nrj', 'shaileshdsuryawanshi96', None, 'satsamjr', 'vedankasalunke96', 'sandeep27996', 'aartibhalerao29', 'k.vekhande69', 'kshemkalyanimanjiri11', 'akshaygodse13', 'aniruddhaparte3', 'divyanshub2311', 'dattaramkolekar', 'kavusatose123']"
73,199,12,6,2,"['rohitwaghmare1997', 'sanketdamame']",9,"['tejas7', 'mounikajalla99', 'vedankasalunke96', 'aartibhalerao29', 'chinmaysj96', 'prasad24shingade', 'aniruddhaparte3', 'sinalkarshweta5', 'sawardekarsuyash97']",4,"['shibssalian', 'tejaswini', None, 'shreyasgawali123']",15,"['tejas7', 'mounikajalla99', 'sanketdamame', None, 'vedankasalunke96', 'rohitwaghmare1997', 'aartibhalerao29', 'chinmaysj96', 'prasad24shingade', 'aniruddhaparte3', 'tejaswini', 'shibssalian', 'sinalkarshweta5', 'sawardekarsuyash97', 'shreyasgawali123']"
74,178,12,25,11,"['rxu22', 'dhe48', 'wilburcoote', 'bonald9056', 'jchin11', 'kevinokane777', 'njr85', 'hemi.jones44', 'mcdiggidy', 'dannz', 'ckn21']",0,[],14,"['btmurton', 'otorres40', 'maswahs', 'nca46', 'hugohills.nz', 'dougj.watkins', 'zly10', 'bpsorenson', 'qianhui', 'amy19', 'hwa99', None, 'redwing', 'nathanyates01']",25,"['rxu22', 'hwa99', 'bonald9056', 'dhe48', 'btmurton', 'kevinokane777', 'amy19', 'dannz', 'wilburcoote', 'maswahs', 'jchin11', 'hemi.jones44', 'zly10', 'bpsorenson', None, 'nathanyates01', 'otorres40', 'nca46', 'hugohills.nz', 'njr85', 'dougj.watkins', 'mcdiggidy', 'qianhui', 'redwing', 'ckn21']"
74,181,12,22,10,"['rxu22', 'dhe48', 'wilburcoote', 'bonald9056', 'jchin11', 'kevinokane777', 'njr85', 'mcdiggidy', 'dannz', 'ckn21']",1,['hemi.jones44'],12,"['btmurton', 'danny101', 'maswahs', 'hugohills.nz', 'chinchin', 'benmurton', 'bpsorenson', 'qianhui', 'zluy10', 'hwa99', None, 'nathanyates01']",23,"['rxu22', 'danny101', 'hwa99', 'bonald9056', 'dhe48', 'btmurton', 'kevinokane777', 'dannz', 'wilburcoote', 'maswahs', 'jchin11', 'hemi.jones44', 'benmurton', 'bpsorenson', 'zluy10', None, 'nathanyates01', 'hugohills.nz', 'njr85', 'chinchin', 'mcdiggidy', 'qianhui', 'ckn21']"
74,177,12,21,11,"['rxu22', 'dhe48', 'wilburcoote', 'bonald9056', 'jchin11', 'kevinokane777', 'njr85', 'hemi.jones44', 'mcdiggidy', 'dannz', 'ckn21']",0,[],10,"['otorres40', 'nca46', 'zly10', 'bpsorenson', 'qianhui', 'hugohills', 'amy19', 'hwa99', None, 'nathanyates01']",21,"['rxu22', 'hwa99', 'bonald9056', 'dhe48', 'kevinokane777', 'hugohills', 'amy19', 'dannz', 'wilburcoote', 'jchin11', 'hemi.jones44', 'zly10', 'bpsorenson', None, 'nathanyates01', 'otorres40', 'nca46', 'njr85', 'mcdiggidy', 'qianhui', 'ckn21']"
74,313,12,20,11,"['rxu22', 'dhe48', 'wilburcoote', 'bonald9056', 'jchin11', 'kevinokane777', 'njr85', 'hemi.jones44', 'mcdiggidy', 'dannz', 'ckn21']",0,[],9,"['maswahs', 'hugohills.nz', 'zly10', 'bpsorenson', 'qianhui', 'amy19', 'hwa99', None, 'nathanyates01']",20,"['rxu22', 'wilburcoote', 'maswahs', 'jchin11', 'hemi.jones44', 'zly10', 'bpsorenson', 'hwa99', None, 'bonald9056', 'nathanyates01', 'dhe48', 'hugohills.nz', 'kevinokane777', 'njr85', 'mcdiggidy', 'qianhui', 'amy19', 'dannz', 'ckn21']"
74,317,12,18,11,"['rxu22', 'dhe48', 'wilburcoote', 'bonald9056', 'jchin11', 'kevinokane777', 'njr85', 'hemi.jones44', 'mcdiggidy', 'dannz', 'ckn21']",0,[],7,"['btmurton', 'zly10', 'qianhui', 'hwa99', None, 'redwing', 'nathanyates01']",18,"['rxu22', 'wilburcoote', 'jchin11', 'hemi.jones44', 'zly10', 'hwa99', None, 'bonald9056', 'nathanyates01', 'dhe48', 'btmurton', 'kevinokane777', 'njr85', 'mcdiggidy', 'qianhui', 'redwing', 'dannz', 'ckn21']"
74,314,12,17,8,"['rxu22', 'dhe48', 'wilburcoote', 'kevinokane777', 'njr85', 'hemi.jones44', 'dannz', 'bonald9056']",3,"['jchin11', 'ckn21', 'mcdiggidy']",9,"['btmurton', 'maswahs', 'hugohills.nz', 'zly10', 'bpsorenson', 'qianhui', 'hwa99', None, 'nathanyates01']",20,"['rxu22', 'wilburcoote', 'maswahs', 'jchin11', 'hemi.jones44', 'zly10', 'bpsorenson', 'hwa99', None, 'bonald9056', 'nathanyates01', 'dhe48', 'btmurton', 'hugohills.nz', 'kevinokane777', 'njr85', 'mcdiggidy', 'qianhui', 'dannz', 'ckn21']"
74,316,12,17,10,"['rxu22', 'dhe48', 'wilburcoote', 'bonald9056', 'kevinokane777', 'njr85', 'hemi.jones44', 'mcdiggidy', 'dannz', 'ckn21']",1,['jchin11'],7,"['hugohills.nz', 'zly10', 'bpsorenson', 'qianhui', 'hwa99', None, 'nathanyates01']",18,"['rxu22', 'wilburcoote', 'jchin11', 'hemi.jones44', 'zly10', 'bpsorenson', 'hwa99', None, 'bonald9056', 'nathanyates01', 'dhe48', 'hugohills.nz', 'kevinokane777', 'njr85', 'mcdiggidy', 'qianhui', 'dannz', 'ckn21']"
74,87,12,16,9,"['rxu22', 'dhe48', 'bonald9056', 'kevinokane777', 'njr85', 'hemi.jones44', 'mcdiggidy', 'dannz', 'ckn21']",2,"['jchin11', 'wilburcoote']",7,"['btmurton', 'zly10', 'bpsorenson', 'qianhui', 'hwa99', None, 'nathanyates01']",18,"['rxu22', 'wilburcoote', 'jchin11', 'hemi.jones44', 'zly10', 'bpsorenson', 'hwa99', None, 'bonald9056', 'nathanyates01', 'dhe48', 'btmurton', 'kevinokane777', 'njr85', 'mcdiggidy', 'qianhui', 'dannz', 'ckn21']"
74,318,12,14,9,"['rxu22', 'dhe48', 'wilburcoote', 'bonald9056', 'kevinokane777', 'njr85', 'hemi.jones44', 'dannz', 'ckn21']",2,"['jchin11', 'mcdiggidy']",5,"['hugohills.nz', 'zly10', 'qianhui', 'hwa99', None]",16,"['rxu22', 'wilburcoote', 'jchin11', 'hemi.jones44', 'zly10', 'hwa99', None, 'bonald9056', 'dhe48', 'hugohills.nz', 'kevinokane777', 'njr85', 'mcdiggidy', 'qianhui', 'dannz', 'ckn21']"
74,182,12,11,5,"['dhe48', 'bonald9056', 'jchin11', 'mcdiggidy', 'ckn21']",6,"['rxu22', 'wilburcoote', 'kevinokane777', 'njr85', 'hemi.jones44', 'dannz']",6,"['maswahs', 'zly10', 'bpsorenson', 'qianhui', None, 'nathanyates01']",17,"['rxu22', 'wilburcoote', 'maswahs', 'jchin11', 'hemi.jones44', 'zly10', 'bpsorenson', None, 'bonald9056', 'nathanyates01', 'dhe48', 'kevinokane777', 'njr85', 'mcdiggidy', 'qianhui', 'dannz', 'ckn21']"
74,180,12,9,3,"['mcdiggidy', 'dhe48', 'bonald9056']",8,"['rxu22', 'wilburcoote', 'jchin11', 'njr85', 'kevinokane777', 'hemi.jones44', 'dannz', 'ckn21']",6,"['maswahs', 'zly10', 'bpsorenson', 'qianhui', None, 'nathanyates01']",17,"['rxu22', 'wilburcoote', 'maswahs', 'jchin11', 'hemi.jones44', 'zly10', 'bpsorenson', None, 'bonald9056', 'nathanyates01', 'dhe48', 'kevinokane777', 'njr85', 'mcdiggidy', 'qianhui', 'dannz', 'ckn21']"
75,92,12,9,8,"['yuchenxu', 'longyun125', 'alexg35', 'dstrande47', 'elim', 'gtsutsumi', 'nickpant', 'aliali95']",3,"['kanhagargvlsi', 'anushreeprakash9', 'malik.ashter.mehdy']",1,[None],12,"['yuchenxu', 'longyun125', 'alexg35', 'malik.ashter.mehdy', 'kanhagargvlsi', None, 'dstrande47', 'elim', 'gtsutsumi', 'anushreeprakash9', 'nickpant', 'aliali95']"
76,184,12,13,11,"['alexisamaro91', 'julia0704', 'kayla15', 'sonali2001', 'iremhatipoglu2', 'bflouretdsq8', 'beyzaince', 'kennedirc', 'min506011', 'imani', 'lindseyserlovsky']",0,[],2,"[None, 'nijohnso314']",13,"['alexisamaro91', 'julia0704', 'iremhatipoglu2', 'beyzaince', 'kennedirc', 'min506011', 'imani', None, 'nijohnso314', 'sonali2001', 'bflouretdsq8', 'kayla15', 'lindseyserlovsky']"
77,202,11,29,10,"['kaminisuroshi26', 'digr1992', 'siddhantpawar993', 'varunndabhade', 'sandeep27996', 'akshaygodse13', 'rohanskambles', 'divyanshub2311', 'shaileshdsuryawanshi96', 'mestryumesh123']",0,[],19,"['tejas7', 'sonam.wairkar', 'shubhangihnkre14', 'sawardekarsuyash97', 'virajgaikwad421', 'mounikajalla99', 'prasad24shingade', 'sinalkarshweta5', 'madhuri.thosare13', 'navneet.nrj', None, 'satsamjr', 'vedankasalunke96', 'aartibhalerao29', 'k.vekhande69', 'kshemkalyanimanjiri11', 'aniruddhaparte3', 'dattaramkolekar', 'kavusatose123']",29,"['tejas7', 'digr1992', 'sonam.wairkar', 'varunndabhade', 'shubhangihnkre14', 'mestryumesh123', 'sawardekarsuyash97', 'virajgaikwad421', 'mounikajalla99', 'prasad24shingade', 'rohanskambles', 'sinalkarshweta5', 'kaminisuroshi26', 'siddhantpawar993', 'madhuri.thosare13', 'navneet.nrj', 'shaileshdsuryawanshi96', None, 'satsamjr', 'vedankasalunke96', 'sandeep27996', 'aartibhalerao29', 'k.vekhande69', 'kshemkalyanimanjiri11', 'akshaygodse13', 'aniruddhaparte3', 'divyanshub2311', 'dattaramkolekar', 'kavusatose123']"
78,280,11,23,10,"['zkhan', 'bnrnirmal94', 'pravingowda28', 'vaitysushant', 'suhayl4k', 'mihirkharkar', 'urshruti69', 'jagiipanda1611', 'mayankjha0221', 'deeptimenon']",0,[],13,"[None, 'spolai', 'samirbobade', 'uyewale', 'mdeshmukh', 'yadavsandeep793', 'thapa156', 'vaishak', 'jiteshutekar', 'bhagyashree.narewade', 'spandharkame', 'vmundhe1234', 'guptasandeep220']",23,"['vaitysushant', 'samirbobade', 'urshruti69', 'thapa156', 'mayankjha0221', 'spandharkame', 'vmundhe1234', 'guptasandeep220', 'bnrnirmal94', 'zkhan', 'pravingowda28', 'uyewale', 'mihirkharkar', 'vaishak', 'jagiipanda1611', None, 'spolai', 'suhayl4k', 'mdeshmukh', 'yadavsandeep793', 'bhagyashree.narewade', 'jiteshutekar', 'deeptimenon']"
79,75,11,22,7,"['ybalog2000', 'zhiliangntnu', 'muxuan2008', 'brandon.i.macdonald', 'hdgh1369', 'crainshower', 'multiscalele']",3,"['mostafahg', 'thesustainableinvestor', 'robinmt1']",15,"['tangyunlong2011', 'jq1', 'jiaoquan_0610', 'rdai5', 'maryamtab', 'buehler', 'csgong', 'prabhashundi008', 'heneveld', 'gmclachl', 'qihanliu', 'mrodri05', 'kevin88', None, 'sp435']",25,"['tangyunlong2011', 'jq1', 'thesustainableinvestor', 'brandon.i.macdonald', 'zhiliangntnu', 'ybalog2000', 'jiaoquan_0610', 'rdai5', 'buehler', 'heneveld', 'qihanliu', 'mrodri05', 'muxuan2008', 'multiscalele', 'csgong', 'mostafahg', 'kevin88', 'crainshower', None, 'maryamtab', 'sp435', 'prabhashundi008', 'gmclachl', 'robinmt1', 'hdgh1369']"
79,298,11,20,8,"['ybalog2000', 'zhiliangntnu', 'thesustainableinvestor', 'muxuan2008', 'brandon.i.macdonald', 'hdgh1369', 'crainshower', 'multiscalele']",2,"['mostafahg', 'robinmt1']",12,"['tangyunlong2011', 'jq1', 'jiaoquan_0610', 'rdai5', 'maryamtab', 'csgong', 'prabhashundi008', 'heneveld', 'mrodri05', 'kevin88', None, 'sp435']",22,"['tangyunlong2011', 'jq1', 'thesustainableinvestor', 'csgong', 'mostafahg', 'brandon.i.macdonald', 'kevin88', 'crainshower', 'zhiliangntnu', None, 'maryamtab', 'sp435', 'ybalog2000', 'jiaoquan_0610', 'rdai5', 'prabhashundi008', 'heneveld', 'robinmt1', 'mrodri05', 'hdgh1369', 'muxuan2008', 'multiscalele']"
79,263,11,16,8,"['ybalog2000', 'zhiliangntnu', 'thesustainableinvestor', 'muxuan2008', 'brandon.i.macdonald', 'hdgh1369', 'crainshower', 'multiscalele']",2,"['mostafahg', 'robinmt1']",8,"['tangyunlong2011', 'jq1', None, 'rdai5', 'prabhashundi008', 'mrodri05', 'maryamtab', 'sp435']",18,"['tangyunlong2011', 'jq1', 'thesustainableinvestor', 'mostafahg', 'brandon.i.macdonald', 'crainshower', 'zhiliangntnu', 'maryamtab', None, 'sp435', 'ybalog2000', 'rdai5', 'prabhashundi008', 'robinmt1', 'mrodri05', 'hdgh1369', 'muxuan2008', 'multiscalele']"
80,310,11,17,10,"['patri220', 'santi164', 'mccla126', 'marks127', 'mcgra360', 'clar1471', 'obers032', 'elemi001', 'schib037', 'howar690']",0,[],7,"['mi.chan.820', 'thakr007', 'yuexx129', 'condo098', 'mill6749', 'chanx361', None]",17,"['patri220', 'mill6749', 'marks127', 'mi.chan.820', 'obers032', 'condo098', 'chanx361', None, 'santi164', 'mccla126', 'mcgra360', 'thakr007', 'clar1471', 'yuexx129', 'elemi001', 'schib037', 'howar690']"
82,142,11,35,1,['eanguianochavez'],9,"['dd46748', 'ft48125', 'tomic.bih08', 'martin.apro', 'vedran', 'deakstarkiller', 'tinapetrina96', 'bewhitejr', 'ac48154']",34,"['eegomez4', 'iavalenzuela', 'jahernandez35', 'ffrancees', 'levaleriofrias', 'aholguin13', 'lasanchez14', 'amdelarosa23', 'vidal', 'adelgado36', 'violantium5', 'cjramirez7', 'underdahl8', 'rarivera7', 'cflores25', 'rmartinez69', 'sami36', 'jalapeno512lk', 'carloslopezcueto1', 'mmartinez631', 'aahmed2', 'iesalais', 'aldom92', 'yaramirez3', 'gortega90', 'odsalazar', 'mmartinez63', None, 'fdjasf', 'mherrera21', 'lesandoval', 'herrera29', 'robertsifuentes', 'aeron17']",44,"['eegomez4', 'iavalenzuela', 'jahernandez35', 'ffrancees', 'levaleriofrias', 'aholguin13', 'lasanchez14', 'deakstarkiller', 'tinapetrina96', 'amdelarosa23', 'vidal', 'adelgado36', 'violantium5', 'cjramirez7', 'underdahl8', 'rarivera7', 'cflores25', 'eanguianochavez', 'dd46748', 'ft48125', 'rmartinez69', 'sami36', 'jalapeno512lk', 'carloslopezcueto1', 'mmartinez631', 'ac48154', 'aahmed2', 'martin.apro', 'iesalais', 'aldom92', 'vedran', 'yaramirez3', 'gortega90', 'odsalazar', 'mmartinez63', None, 'bewhitejr', 'fdjasf', 'mherrera21', 'lesandoval', 'tomic.bih08', 'herrera29', 'robertsifuentes', 'aeron17']"
83,142,11,35,7,"['eegomez4', 'levaleriofrias', 'rmartinez69', 'adelgado36', 'jalapeno512lk', 'gortega90', 'underdahl8']",3,"['cristian__erazo', 'iriamonterroso', 'carlosdoblev']",28,"['iavalenzuela', 'jahernandez35', 'ffrancees', 'aholguin13', 'lasanchez14', 'amdelarosa23', 'vidal', 'violantium5', 'cjramirez7', 'rarivera7', 'cflores25', 'eanguianochavez', 'sami36', 'carloslopezcueto1', 'mmartinez631', 'aahmed2', 'iesalais', 'aldom92', 'yaramirez3', 'odsalazar', 'mmartinez63', None, 'fdjasf', 'mherrera21', 'lesandoval', 'herrera29', 'robertsifuentes', 'aeron17']",38,"['eegomez4', 'iavalenzuela', 'levaleriofrias', 'jahernandez35', 'ffrancees', 'aholguin13', 'lasanchez14', 'amdelarosa23', 'vidal', 'adelgado36', 'iriamonterroso', 'violantium5', 'cjramirez7', 'underdahl8', 'rarivera7', 'cflores25', 'eanguianochavez', 'rmartinez69', 'sami36', 'jalapeno512lk', 'carloslopezcueto1', 'mmartinez631', 'cristian__erazo', 'aahmed2', 'iesalais', 'aldom92', 'yaramirez3', 'gortega90', 'odsalazar', 'mmartinez63', None, 'fdjasf', 'mherrera21', 'lesandoval', 'herrera29', 'robertsifuentes', 'aeron17', 'carlosdoblev']"
83,146,11,7,6,"['eegomez4', 'levaleriofrias', 'rmartinez69', 'adelgado36', 'jalapeno512lk', 'underdahl8']",4,"['cristian__erazo', 'iriamonterroso', 'gortega90', 'carlosdoblev']",1,[None],11,"['eegomez4', 'cristian__erazo', 'levaleriofrias', 'rmartinez69', 'adelgado36', 'iriamonterroso', 'gortega90', 'jalapeno512lk', 'underdahl8', None, 'carlosdoblev']"
85,161,10,35,6,"['qycjerry', 'chhliu', 'flare791', 'song9194', 'jhazeghazam', 'ohyli1997']",3,"['vigneshwar.ramakrishnan', 'smejia97', 'kxzhao']",29,"['edgar916m', 'glahti', 'evalyu', 'erdeme95616', 'jmizutan', 'rychu12', 'sfoster15', 'djlinz', 'zsl510705', 'calcarb', 'gfabian', 'yhcheng', 'yuhao96', 'poonam97', 'aml18', 'hannahhhr', 'sg630', 'jonthomas', 'bpbrocke', 'samadsen', None, 'jgdoran', 'mbyazidi', 'quynhha', 'johnyu', 'jtmulvey', 'mwz99', 'phamgk', 'zajin97']",38,"['edgar916m', 'flare791', 'glahti', 'evalyu', 'erdeme95616', 'jmizutan', 'rychu12', 'sfoster15', 'ohyli1997', 'djlinz', 'chhliu', 'zsl510705', 'calcarb', 'vigneshwar.ramakrishnan', 'gfabian', 'yhcheng', 'yuhao96', 'poonam97', 'qycjerry', 'aml18', 'hannahhhr', 'sg630', 'jonthomas', 'song9194', 'bpbrocke', 'samadsen', None, 'jgdoran', 'mbyazidi', 'quynhha', 'johnyu', 'jtmulvey', 'smejia97', 'kxzhao', 'mwz99', 'phamgk', 'jhazeghazam', 'zajin97']"
86,260,10,10,9,"['iga', 'zuzbed', 'mimiau', 'andrzej0szczepanczyk0muzyk', 'bogusapi', 'mateusz94', 'j_piechota', 'pyra21', 'no404564']",0,[],1,[None],10,"['iga', 'zuzbed', 'mateusz94', 'j_piechota', None, 'no404564', 'mimiau', 'andrzej0szczepanczyk0muzyk', 'bogusapi', 'pyra21']"
87,161,10,35,8,"['zsl510705', 'hannahhhr', 'jtmulvey', 'yhcheng', 'sfoster15', 'jgdoran', 'poonam97', 'mbyazidi']",1,['ahurtado'],27,"['edgar916m', 'flare791', 'glahti', 'evalyu', 'erdeme95616', 'jmizutan', 'rychu12', 'ohyli1997', 'djlinz', 'chhliu', 'calcarb', 'gfabian', 'yuhao96', 'qycjerry', 'aml18', 'sg630', 'jonthomas', 'song9194', 'bpbrocke', 'samadsen', None, 'quynhha', 'johnyu', 'mwz99', 'phamgk', 'jhazeghazam', 'zajin97']",36,"['edgar916m', 'flare791', 'glahti', 'evalyu', 'erdeme95616', 'jmizutan', 'rychu12', 'ahurtado', 'sfoster15', 'ohyli1997', 'djlinz', 'chhliu', 'zsl510705', 'calcarb', 'gfabian', 'yhcheng', 'yuhao96', 'poonam97', 'qycjerry', 'aml18', 'hannahhhr', 'sg630', 'jonthomas', 'song9194', 'bpbrocke', 'samadsen', None, 'jgdoran', 'mbyazidi', 'quynhha', 'johnyu', 'jtmulvey', 'mwz99', 'phamgk', 'jhazeghazam', 'zajin97']"
88,148,10,23,7,"['shally', 'niranjanbhavsar2491996', 'ralph.rodrigues69', 'kruti.pradnil', 'pranjal17', 'livz944', 'jinal.sarvaiya.js']",2,"['samsonkajar', 'moraes.amos']",16,"['bhadreshwarak308', 'mmgsaga', 'dakshatavaze96', 'dcruzdylan50', 'jonathanrjpereira', 'danieldsilva96', 'neetavarkute', 'rubina15', 'pragatidhekale', 'treesaachu', 'marcmathew19', 'jmihavel', 'aditya332', 'tinu', None, 'hamad.momin45']",25,"['niranjanbhavsar2491996', 'bhadreshwarak308', 'kruti.pradnil', 'tinu', 'shally', 'ralph.rodrigues69', 'dakshatavaze96', 'pranjal17', 'marcmathew19', 'hamad.momin45', 'samsonkajar', 'dcruzdylan50', 'pragatidhekale', 'livz944', 'jinal.sarvaiya.js', 'jmihavel', None, 'mmgsaga', 'jonathanrjpereira', 'danieldsilva96', 'moraes.amos', 'neetavarkute', 'rubina15', 'treesaachu', 'aditya332']"
88,147,10,19,6,"['shally', 'ralph.rodrigues69', 'samsonkajar', 'moraes.amos', 'pranjal17', 'jinal.sarvaiya.js']",3,"['kruti.pradnil', 'niranjanbhavsar2491996', 'livz944']",13,"['varunmullins', 'ruchi61', 'mmgsaga', 'dakshatavaze96', 'danieldsilva96', 'rubina15', 'treesaachu', 'marcmathew19', 'jmihavel', 'ahmedshabbir99', 'prajoth.fernandes', 'tinu', None]",22,"['niranjanbhavsar2491996', 'samsonkajar', 'kruti.pradnil', 'livz944', 'jinal.sarvaiya.js', 'jmihavel', 'tinu', None, 'varunmullins', 'shally', 'ruchi61', 'ralph.rodrigues69', 'mmgsaga', 'dakshatavaze96', 'danieldsilva96', 'moraes.amos', 'rubina15', 'treesaachu', 'pranjal17', 'marcmathew19', 'ahmedshabbir99', 'prajoth.fernandes']"
88,128,10,14,8,"['niranjanbhavsar2491996', 'ralph.rodrigues69', 'samsonkajar', 'moraes.amos', 'kruti.pradnil', 'pranjal17', 'livz944', 'jinal.sarvaiya.js']",1,['shally'],6,"['varunmullins', 'mmgsaga', 'jonathanrjpereira', 'danieldsilva96', 'marcmathew19', None]",15,"['niranjanbhavsar2491996', 'samsonkajar', 'kruti.pradnil', 'livz944', 'jinal.sarvaiya.js', None, 'varunmullins', 'shally', 'ralph.rodrigues69', 'mmgsaga', 'jonathanrjpereira', 'danieldsilva96', 'moraes.amos', 'pranjal17', 'marcmathew19']"
89,288,10,28,8,"['purvikapatil', 'ruchira_ghule', 'akarnik.13', 'techn720ab', 'ninadsc96', 'pranu175', 'sukhmote1997', 'manassardar4444122']",1,['mayursanap1997'],20,"['alwin1996', 'abhishekg', 'ravikapooooor', 'chaitalivartak07', 'keshvis26', 'css_', 'divyavkhandkar.me', 'saniyasnair', 'varshada15', 'panchalparth417', 'devashishmore478', 'boy_with_nikon', 'abhijitharidas3107', 'ajinkyasssyadav', 'tanvinj1', None, 'amolgolwankar', 'niveshvaze', 'devanshibhatt19', 'sumasalian96']",29,"['alwin1996', 'abhishekg', 'ravikapooooor', 'chaitalivartak07', 'keshvis26', 'purvikapatil', 'css_', 'divyavkhandkar.me', 'saniyasnair', 'varshada15', 'panchalparth417', 'devashishmore478', 'boy_with_nikon', 'abhijitharidas3107', 'ajinkyasssyadav', 'mayursanap1997', None, 'tanvinj1', 'ruchira_ghule', 'akarnik.13', 'ninadsc96', 'techn720ab', 'pranu175', 'amolgolwankar', 'niveshvaze', 'sukhmote1997', 'manassardar4444122', 'devanshibhatt19', 'sumasalian96']"
89,198,10,27,8,"['purvikapatil', 'ruchira_ghule', 'akarnik.13', 'techn720ab', 'ninadsc96', 'pranu175', 'sukhmote1997', 'manassardar4444122']",1,['mayursanap1997'],19,"['alwin1996', 'abhishekg', 'chaitalivartak07', 'keshvis26', 'css_', 'divyavkhandkar.me', 'saniyasnair', 'varshada15', 'panchalparth417', 'devashishmore478', 'boy_with_nikon', 'abhijitharidas3107', 'ajinkyasssyadav', 'tanvinj1', None, 'amolgolwankar', 'niveshvaze', 'devanshibhatt19', 'sumasalian96']",28,"['alwin1996', 'abhishekg', 'chaitalivartak07', 'keshvis26', 'purvikapatil', 'css_', 'divyavkhandkar.me', 'saniyasnair', 'varshada15', 'panchalparth417', 'devashishmore478', 'boy_with_nikon', 'abhijitharidas3107', 'ajinkyasssyadav', 'mayursanap1997', None, 'tanvinj1', 'ruchira_ghule', 'akarnik.13', 'ninadsc96', 'techn720ab', 'pranu175', 'amolgolwankar', 'niveshvaze', 'sukhmote1997', 'manassardar4444122', 'devanshibhatt19', 'sumasalian96']"
89,271,10,12,8,"['purvikapatil', 'ruchira_ghule', 'akarnik.13', 'techn720ab', 'ninadsc96', 'pranu175', 'sukhmote1997', 'manassardar4444122']",1,['mayursanap1997'],4,"['ravikapooooor', None, 'niveshvaze', 'ajinkyasssyadav']",13,"['ravikapooooor', 'ajinkyasssyadav', 'mayursanap1997', None, 'purvikapatil', 'ruchira_ghule', 'akarnik.13', 'ninadsc96', 'techn720ab', 'pranu175', 'niveshvaze', 'sukhmote1997', 'manassardar4444122']"
89,270,10,7,3,"['mayursanap1997', 'sukhmote1997', 'manassardar4444122']",6,"['purvikapatil', 'ruchira_ghule', 'akarnik.13', 'techn720ab', 'ninadsc96', 'pranu175']",4,"['vidur888', 'tripathishivam342', None, 'niveshvaze']",13,"['purvikapatil', 'ruchira_ghule', 'akarnik.13', 'ninadsc96', 'techn720ab', 'pranu175', 'vidur888', 'tripathishivam342', 'niveshvaze', 'sukhmote1997', 'manassardar4444122', 'mayursanap1997', None]"
89,287,10,7,3,"['mayursanap1997', 'sukhmote1997', 'manassardar4444122']",6,"['purvikapatil', 'ruchira_ghule', 'akarnik.13', 'techn720ab', 'ninadsc96', 'pranu175']",4,"['vidur888', 'tripathishivam342', None, 'niveshvaze']",13,"['purvikapatil', 'ruchira_ghule', 'akarnik.13', 'ninadsc96', 'techn720ab', 'pranu175', 'vidur888', 'tripathishivam342', 'niveshvaze', 'sukhmote1997', 'manassardar4444122', 'mayursanap1997', None]"
89,289,10,7,4,"['akarnik.13', 'manassardar4444122', 'techn720ab', 'sukhmote1997']",5,"['purvikapatil', 'ruchira_ghule', 'ninadsc96', 'pranu175', 'mayursanap1997']",3,"['ravikapooooor', None, 'niveshvaze']",12,"['purvikapatil', 'ruchira_ghule', 'akarnik.13', 'ninadsc96', 'techn720ab', 'pranu175', 'niveshvaze', 'ravikapooooor', 'sukhmote1997', 'manassardar4444122', 'mayursanap1997', None]"
89,197,10,6,2,"['mayursanap1997', 'manassardar4444122']",7,"['purvikapatil', 'ruchira_ghule', 'akarnik.13', 'techn720ab', 'ninadsc96', 'pranu175', 'sukhmote1997']",4,"['vidur888', 'tripathishivam342', None, 'niveshvaze']",13,"['purvikapatil', 'ruchira_ghule', 'akarnik.13', 'ninadsc96', 'techn720ab', 'pranu175', 'vidur888', 'tripathishivam342', 'niveshvaze', 'sukhmote1997', 'manassardar4444122', 'mayursanap1997', None]"
90,104,10,93,3,"['nthung', 'franciscolozano', 'yang924']",6,"['jkantor', 'lejano', 'stephen.f.clark1', 'wu1254', 'abhishek30', 'sschreur']",90,"['jeanpierre1030', 'harshit03sep', 'rheiland', 'desai61', 'yjzhuang5', 'liu1947', 'ddmckay', 'trezitorul', 'siddharthpantoji22', 'vkattaku', 'huntmartinm', 'titus9', 'denphi', 'taeksanglee', 'sabareesh169', 'ych0580', 'xiaoli94', 'soto27', 'naik.pratik', 'kristiaan2017', 'rahuldeshmukh', 'proycho', 'vdharman', 'paul91', 'sahu2', 'yang1489', 'zhan2283', 'maathangi95', 'pgurunat', 'tsimon', 'sreeve', 'pdressma', 'azadoks', 'rex07040058', 'huang706', 'abhivictor2', 'tadhika', 'cfrist', 'jiang556', 'sukirtthakur', 'paul54', 'jasakadu', 'tanayadhikary', 'sachadervi', 'transegn1', 'ziyang', 'mmh', 'pmeunier', 'psiripur', 'kogunsin', 'han289', 'zhou646', 'abiniwa', 'lalzatev', 'krane', 'jhartl', 'ouyang16', 'kcruse2', 'mjokar', 'nmsnodgr', 'huang714', 'yang1087', 'bphnano', 'anjulvyas', 'prachi19', 'jthekine', 'zhao830', 'kbandar', 'paulmather', 'mrajase', 'vradkar', 'mathcancer', 'rbritwik22', 'tian50', 'jsqdcsq', 'lu500', 'rohitkt10', 'wen', 'unitas', 'gjhanwar', 'davidjohnson', 'mademoiselle0812', 'msakariy', 'xliu123', 'dadams', 'bhaley', 'zhangshengsunny', 'jrudolp', 'xiaolongyang1990', 'adervise']",99,"['jeanpierre1030', 'harshit03sep', 'rheiland', 'desai61', 'yjzhuang5', 'liu1947', 'ddmckay', 'stephen.f.clark1', 'trezitorul', 'siddharthpantoji22', 'vkattaku', 'huntmartinm', 'titus9', 'denphi', 'taeksanglee', 'sabareesh169', 'ych0580', 'xiaoli94', 'soto27', 'naik.pratik', 'kristiaan2017', 'rahuldeshmukh', 'proycho', 'vdharman', 'paul91', 'sahu2', 'yang1489', 'zhan2283', 'maathangi95', 'pgurunat', 'tsimon', 'sreeve', 'pdressma', 'azadoks', 'rex07040058', 'huang706', 'abhivictor2', 'tadhika', 'cfrist', 'jiang556', 'sukirtthakur', 'paul54', 'jasakadu', 'tanayadhikary', 'sachadervi', 'yang924', 'transegn1', 'nthung', 'ziyang', 'mmh', 'pmeunier', 'psiripur', 'kogunsin', 'han289', 'abhishek30', 'zhou646', 'abiniwa', 'lalzatev', 'krane', 'jhartl', 'ouyang16', 'kcruse2', 'mjokar', 'nmsnodgr', 'huang714', 'yang1087', 'bphnano', 'anjulvyas', 'prachi19', 'jthekine', 'zhao830', 'kbandar', 'paulmather', 'mrajase', 'vradkar', 'jkantor', 'mathcancer', 'rbritwik22', 'franciscolozano', 'tian50', 'wu1254', 'jsqdcsq', 'sschreur', 'lu500', 'rohitkt10', 'wen', 'unitas', 'gjhanwar', 'davidjohnson', 'mademoiselle0812', 'msakariy', 'xliu123', 'dadams', 'lejano', 'bhaley', 'zhangshengsunny', 'jrudolp', 'xiaolongyang1990', 'adervise']"
92,269,9,75,7,"['abhijaypandey', 's.arutwar', 'shreekantrasam69', 'sanket.mane', 'bhaveshsawant1996', 'ksanket025', 'ganesh.mali']",1,['vrushalithakare82'],68,"['rajeshree.kumbhar5018', 'palakchheda2407', 'mbhosale863', 'ashishghoderao', 'sumitmhatre5670', 'ashwinipardeshi702', 'ronak.tiwari', 'sanchitkad', 'rasikapotdar2108', 'aishuauti20496', 'pandeydeepak825', 'puranikatharva', 'prathamesh.nikam', 'bhushan9321', 'adityagudla96', 'sid.jagtap1992', 'sendpost2mahesh', 'surbhib2897', 'shraddhasam78', 'jayshreepakhare63', 'atul', 'bolekunal42', 'mhatrenrupal42', 'neonargon5', 'ayesha.pathan', 'ninadmandavkar29', 'abhishek2397', 'nishigandhaprsd14', 'rushikeshsalgar123', 'sahil709', 'dusty', 'neelamt', 'sudar', 'yogeshmaurya50', 'kavusatose123', 'manjarekarchinmayeen', 'riddhi737', 'niharmasurkar', 'bhandarinirali57', 'mihirgogri613', 'lekhakande', 'pratibhagawari28', 'ab17', 'anitadey12', 'mayurgonbare22', 'sumitpatil512', 'sonali.ramji', 'maneaniket', 'siddheshgothankar', 'dleena19961209', 'dilip.wakdikar', 'trambakesh97', 'riyakulkarni16021997', 'brarath.nihal', 'bgharat713', 'pritijha1996', 'preethinaik', 'ganeshjadhav', 'snehalpatil', 'rajesh05', None, 'rahul.sawant', 'veronicathapa56', 'prashant.khedkar', 'vishal8244', 'shraddha.dhage', 'hborse28', 'mithilagajarmal']",76,"['rajeshree.kumbhar5018', 'palakchheda2407', 'mbhosale863', 'ashishghoderao', 'sumitmhatre5670', 'ashwinipardeshi702', 'ronak.tiwari', 'sanchitkad', 'rasikapotdar2108', 'aishuauti20496', 'pandeydeepak825', 'puranikatharva', 'prathamesh.nikam', 'bhushan9321', 'adityagudla96', 'sid.jagtap1992', 'sendpost2mahesh', 'surbhib2897', 'shraddhasam78', 'jayshreepakhare63', 'atul', 'bolekunal42', 'mhatrenrupal42', 'neonargon5', 'ayesha.pathan', 'vrushalithakare82', 'ninadmandavkar29', 'abhishek2397', 'bhaveshsawant1996', 'nishigandhaprsd14', 'rushikeshsalgar123', 'sahil709', 'dusty', 'neelamt', 'sudar', 'shreekantrasam69', 'yogeshmaurya50', 'kavusatose123', 'manjarekarchinmayeen', 'riddhi737', 'niharmasurkar', 'bhandarinirali57', 'mihirgogri613', 'lekhakande', 'pratibhagawari28', 'ab17', 'anitadey12', 'mayurgonbare22', 'sumitpatil512', 'sonali.ramji', 'maneaniket', 'siddheshgothankar', 'dleena19961209', 'abhijaypandey', 'dilip.wakdikar', 'trambakesh97', 'riyakulkarni16021997', 'brarath.nihal', 'bgharat713', 'pritijha1996', 'preethinaik', 'ganeshjadhav', 'sanket.mane', 'snehalpatil', 'rajesh05', 'ksanket025', None, 'rahul.sawant', 's.arutwar', 'veronicathapa56', 'prashant.khedkar', 'vishal8244', 'shraddha.dhage', 'hborse28', 'ganesh.mali', 'mithilagajarmal']"
92,268,9,42,1,['vrushalithakare82'],7,"['abhijaypandey', 's.arutwar', 'shreekantrasam69', 'sanket.mane', 'bhaveshsawant1996', 'ksanket025', 'ganesh.mali']",41,"['pranittambde', 'tejas7', 'siddhant319', 'sarvesh107', 'siddhu.murkar', 'sawardekarsuyash97', 'priyankaingle18', 'mounikajalla99', 'shreya9609', 'goreravindra95', 'bonhomie11', 'chinmaysj96', 'narvekarsushant0', 'prasad24shingade', 'pratikpawar4996', 'tusharvan', 'sonali.ramji', 'salianyatish111', 'surbhib2897', 'amritamukeshb', 'sinalkarshweta5', 'santoshiparab11', 'snehaspm1397', 'dkgupata9768522176', 'siddhantwarankar', 'navneet.nrj', 'bhamghodke7', 'jr.abishek00', None, 'shivanilohar55', 'ranegirish24', 'pankajpawar1515', 'satsamjr', 'vedankasalunke96', 'shirsekarakash', 'aartibhalerao29', 'vinayak183', 'rahul2011star', 'aniruddhaparte3', 'adityagudla96', 'kavusatose123']",49,"['pranittambde', 'tejas7', 'siddhant319', 'sarvesh107', 'siddhu.murkar', 'sawardekarsuyash97', 'priyankaingle18', 'mounikajalla99', 'shreya9609', 'goreravindra95', 'bonhomie11', 'chinmaysj96', 'narvekarsushant0', 'prasad24shingade', 'pratikpawar4996', 'tusharvan', 'sonali.ramji', 'salianyatish111', 'surbhib2897', 'amritamukeshb', 'sinalkarshweta5', 'santoshiparab11', 'snehaspm1397', 'abhijaypandey', 'dkgupata9768522176', 'siddhantwarankar', 'vrushalithakare82', 'navneet.nrj', 'sanket.mane', 'bhaveshsawant1996', 'bhamghodke7', 'jr.abishek00', 'ksanket025', None, 'shivanilohar55', 'ranegirish24', 'pankajpawar1515', 's.arutwar', 'satsamjr', 'vedankasalunke96', 'shirsekarakash', 'shreekantrasam69', 'aartibhalerao29', 'vinayak183', 'rahul2011star', 'aniruddhaparte3', 'adityagudla96', 'ganesh.mali', 'kavusatose123']"
93,276,9,90,8,"['ameyc007', 'amarravade31', 'bhagyashrimali280497', 'divyassingh56', 'akshatamahajan47', 'nehamallan', 'sarika_bukkawar', 'richitapatil']",0,[],82,"['rajeshree.kumbhar5018', 'ashishghoderao', 'sumitmhatre5670', 'ronak.tiwari', 'sanchitkad', 'rasikapotdar2108', 'aishuauti20496', 'adnan.s', 'ritik.singh', 'prerana.goythale', 'pandeydeepak825', 'shweta.joglekar', 'mounikajalla99', 'puranikatharva', 'bonhomie11', 'prathamesh.nikam', 'bhushan9321', 'vishalnaik.0210', 'harishkumar.n', 'sanketmane1997.sm', 'shirishparkhe', 'krunal.kasar', 'sendpost2mahesh', 'sid.jagtap1992', 'surbhib2897', 'shraddhasam78', 'yashuishwar', 'atul', 'paromita24', 'niveditachaudhari', 'mhatrenrupal42', 'neonargon5', 'ayesha.pathan', 'digvijayjadeja725', 'shrey.joshi', 'ninadmandavkar29', 'nishigandhaprsd14', 'rushikeshsalgar123', 'sahil709', 'neelamt', 'patiltejas000003', 'yogeshmaurya50', 'gaurav.mishra', 'vivekrana', 'manjarekarchinmayeen', 'riddhi737', 'niharmasurkar', 'apurvawaghmode14', 'bhandarinirali57', 'mihirgogri613', 'lekhakande', 'pratibhagawari28', 'nirav.lm', 'anitadey12', 'rohan.mestry', 'mayurgonbare22', 'dhavit.v', 'sumitpatil512', 'sonali.ramji', 'dleena19961209', 'maneaniket', 'siddheshgothankar', 'yuvraj.t', 'akshay1997bhagit', 'atulkokane1234', 'electronics209', 'raj.vadariya', 'trambakesh97', 'sarika', 'pritijha1996', 'bgharat713', 'mayank.vp', 'preethinaik', 'snehalpatil', 'rajesh05', None, 'shreyas.v', 'veronicathapa56', 'podililaxmi30', 'shraddha.dhage', 'hborse28', 'mithilagajarmal']",90,"['rajeshree.kumbhar5018', 'ashishghoderao', 'sumitmhatre5670', 'ronak.tiwari', 'sanchitkad', 'rasikapotdar2108', 'aishuauti20496', 'adnan.s', 'ritik.singh', 'prerana.goythale', 'pandeydeepak825', 'shweta.joglekar', 'mounikajalla99', 'puranikatharva', 'bonhomie11', 'prathamesh.nikam', 'bhushan9321', 'vishalnaik.0210', 'harishkumar.n', 'sanketmane1997.sm', 'shirishparkhe', 'krunal.kasar', 'sendpost2mahesh', 'sid.jagtap1992', 'surbhib2897', 'richitapatil', 'shraddhasam78', 'yashuishwar', 'atul', 'paromita24', 'niveditachaudhari', 'mhatrenrupal42', 'neonargon5', 'ayesha.pathan', 'digvijayjadeja725', 'shrey.joshi', 'ninadmandavkar29', 'nehamallan', 'nishigandhaprsd14', 'rushikeshsalgar123', 'sahil709', 'ameyc007', 'amarravade31', 'neelamt', 'patiltejas000003', 'akshatamahajan47', 'yogeshmaurya50', 'gaurav.mishra', 'vivekrana', 'manjarekarchinmayeen', 'riddhi737', 'niharmasurkar', 'apurvawaghmode14', 'bhagyashrimali280497', 'bhandarinirali57', 'mihirgogri613', 'sarika_bukkawar', 'lekhakande', 'pratibhagawari28', 'nirav.lm', 'anitadey12', 'rohan.mestry', 'mayurgonbare22', 'dhavit.v', 'sumitpatil512', 'sonali.ramji', 'dleena19961209', 'maneaniket', 'siddheshgothankar', 'yuvraj.t', 'akshay1997bhagit', 'atulkokane1234', 'electronics209', 'raj.vadariya', 'trambakesh97', 'sarika', 'pritijha1996', 'bgharat713', 'mayank.vp', 'preethinaik', 'snehalpatil', 'rajesh05', None, 'shreyas.v', 'veronicathapa56', 'podililaxmi30', 'divyassingh56', 'shraddha.dhage', 'hborse28', 'mithilagajarmal']"
93,282,9,50,3,"['ameyc007', 'amarravade31', 'akshatamahajan47']",5,"['bhagyashrimali280497', 'divyassingh56', 'nehamallan', 'sarika_bukkawar', 'richitapatil']",47,"['rajeshree.kumbhar5018', 'sanket.gawade', 'sunilmolawade', 'ani.date23', 'manjarekarchinmayeen', 'nikhil.a', 'riddhi737', 'rasikapotdar2108', 'aishuauti20496', 'satish.yadav', 'nasareen.k', 'lekhakande', 'pratibhagawari28', 'nirav.lm', 'anitadey12', 'puranikatharva', 'mayurgonbare22', 'bhushan9321', 'sanketmane1997.sm', 'janawalekarp', 'siddheshgothankar', 'shirishparkhe', 'krunal.kasar', 'yuvraj.t', 'abhishek.diggewadi', 'kadam.rupesh28297', 'shreyapatel606', 'shraddhasam78', 'renukabhosale14', 'vijayshankarchaurasiya', 'paromita24', 'ayesha.pathan', 'snehalpatil', 'rajesh05', 'pratik.gc', 'sumitmhatre', None, 'dusty', 'rahul.sawant', 'neelamt', 'podililaxmi30', 'pratikshedge23', 'divyashriteppala', 'patiltejas000003', 'krupalpatel1996', 'shweta.gosavi', 'kgirkar6104']",55,"['rajeshree.kumbhar5018', 'sanket.gawade', 'sunilmolawade', 'ani.date23', 'manjarekarchinmayeen', 'nikhil.a', 'riddhi737', 'bhagyashrimali280497', 'rasikapotdar2108', 'aishuauti20496', 'satish.yadav', 'nasareen.k', 'sarika_bukkawar', 'lekhakande', 'pratibhagawari28', 'nirav.lm', 'anitadey12', 'puranikatharva', 'mayurgonbare22', 'bhushan9321', 'sanketmane1997.sm', 'janawalekarp', 'siddheshgothankar', 'shirishparkhe', 'krunal.kasar', 'yuvraj.t', 'abhishek.diggewadi', 'kadam.rupesh28297', 'shreyapatel606', 'richitapatil', 'shraddhasam78', 'renukabhosale14', 'vijayshankarchaurasiya', 'paromita24', 'ayesha.pathan', 'nehamallan', 'snehalpatil', 'rajesh05', 'pratik.gc', 'sumitmhatre', None, 'ameyc007', 'dusty', 'rahul.sawant', 'amarravade31', 'neelamt', 'podililaxmi30', 'pratikshedge23', 'divyashriteppala', 'patiltejas000003', 'divyassingh56', 'akshatamahajan47', 'krupalpatel1996', 'shweta.gosavi', 'kgirkar6104']"
93,281,9,32,4,"['divyassingh56', 'akshatamahajan47', 'richitapatil', 'bhagyashrimali280497']",4,"['ameyc007', 'sarika_bukkawar', 'nehamallan', 'amarravade31']",28,"['palakchheda2407', 'manjarekarchinmayeen', 'sumitmhatre5670', 'ronak.tiwari', 'sanchitkad', 'rasikapotdar2108', 'mihirgogri613', 'lekhakande', 'ab17', 'anitadey12', 'puranikatharva', 'bhushan9321', 'siddhi123', 'sanketmane1997.sm', 'sonysagar1996', 'maneaniket', 'renukabhosale14', 'dilip.wakdikar', 'vijayshankarchaurasiya', 'neonargon5', 'ayesha.pathan', 'digvijayjadeja725', 'rajesh05', None, 'podililaxmi30', 'patiltejas000003', 'shraddha.dhage', 'mithilagajarmal']",36,"['palakchheda2407', 'manjarekarchinmayeen', 'sumitmhatre5670', 'ronak.tiwari', 'bhagyashrimali280497', 'sanchitkad', 'rasikapotdar2108', 'mihirgogri613', 'sarika_bukkawar', 'lekhakande', 'ab17', 'anitadey12', 'puranikatharva', 'bhushan9321', 'siddhi123', 'sanketmane1997.sm', 'sonysagar1996', 'maneaniket', 'richitapatil', 'renukabhosale14', 'dilip.wakdikar', 'vijayshankarchaurasiya', 'neonargon5', 'ayesha.pathan', 'digvijayjadeja725', 'nehamallan', 'rajesh05', None, 'ameyc007', 'amarravade31', 'podililaxmi30', 'patiltejas000003', 'divyassingh56', 'akshatamahajan47', 'shraddha.dhage', 'mithilagajarmal']"
94,148,9,23,6,"['bhadreshwarak308', 'dakshatavaze96', 'neetavarkute', 'pragatidhekale', 'aditya332', 'hamad.momin45']",2,"['prajoth.fernandes', 'ruchi61']",17,"['shally', 'niranjanbhavsar2491996', 'ralph.rodrigues69', 'mmgsaga', 'dcruzdylan50', 'jonathanrjpereira', 'danieldsilva96', 'kruti.pradnil', 'rubina15', 'treesaachu', 'marcmathew19', 'pranjal17', 'livz944', 'jmihavel', 'jinal.sarvaiya.js', 'tinu', None]",25,"['niranjanbhavsar2491996', 'bhadreshwarak308', 'dcruzdylan50', 'kruti.pradnil', 'pragatidhekale', 'livz944', 'jmihavel', 'jinal.sarvaiya.js', 'tinu', None, 'shally', 'ruchi61', 'ralph.rodrigues69', 'mmgsaga', 'dakshatavaze96', 'jonathanrjpereira', 'danieldsilva96', 'neetavarkute', 'rubina15', 'treesaachu', 'marcmathew19', 'pranjal17', 'aditya332', 'prajoth.fernandes', 'hamad.momin45']"
94,147,9,19,3,"['prajoth.fernandes', 'dakshatavaze96', 'ruchi61']",5,"['bhadreshwarak308', 'neetavarkute', 'pragatidhekale', 'aditya332', 'hamad.momin45']",16,"['varunmullins', 'shally', 'ralph.rodrigues69', 'mmgsaga', 'samsonkajar', 'danieldsilva96', 'moraes.amos', 'rubina15', 'treesaachu', 'marcmathew19', 'pranjal17', 'jinal.sarvaiya.js', 'ahmedshabbir99', 'jmihavel', 'tinu', None]",24,"['bhadreshwarak308', 'samsonkajar', 'pragatidhekale', 'jinal.sarvaiya.js', 'jmihavel', 'tinu', None, 'ahmedshabbir99', 'varunmullins', 'shally', 'ruchi61', 'ralph.rodrigues69', 'mmgsaga', 'dakshatavaze96', 'danieldsilva96', 'neetavarkute', 'moraes.amos', 'rubina15', 'treesaachu', 'marcmathew19', 'pranjal17', 'aditya332', 'prajoth.fernandes', 'hamad.momin45']"
95,276,9,90,8,"['manjarekarchinmayeen', 'bhushan9321', 'riddhi737', 'ayesha.pathan', 'sanchitkad', 'mihirgogri613', 'aishuauti20496', 'rajesh05']",0,[],82,"['rajeshree.kumbhar5018', 'ashishghoderao', 'sumitmhatre5670', 'ronak.tiwari', 'rasikapotdar2108', 'adnan.s', 'ritik.singh', 'prerana.goythale', 'pandeydeepak825', 'shweta.joglekar', 'mounikajalla99', 'puranikatharva', 'bonhomie11', 'prathamesh.nikam', 'vishalnaik.0210', 'harishkumar.n', 'sanketmane1997.sm', 'shirishparkhe', 'krunal.kasar', 'sendpost2mahesh', 'sid.jagtap1992', 'surbhib2897', 'shraddhasam78', 'richitapatil', 'yashuishwar', 'atul', 'paromita24', 'niveditachaudhari', 'mhatrenrupal42', 'neonargon5', 'digvijayjadeja725', 'shrey.joshi', 'ninadmandavkar29', 'nehamallan', 'nishigandhaprsd14', 'rushikeshsalgar123', 'sahil709', 'ameyc007', 'neelamt', 'amarravade31', 'patiltejas000003', 'akshatamahajan47', 'yogeshmaurya50', 'gaurav.mishra', 'vivekrana', 'niharmasurkar', 'apurvawaghmode14', 'bhandarinirali57', 'bhagyashrimali280497', 'sarika_bukkawar', 'lekhakande', 'pratibhagawari28', 'nirav.lm', 'anitadey12', 'rohan.mestry', 'mayurgonbare22', 'dhavit.v', 'sumitpatil512', 'sonali.ramji', 'dleena19961209', 'maneaniket', 'siddheshgothankar', 'yuvraj.t', 'akshay1997bhagit', 'atulkokane1234', 'electronics209', 'raj.vadariya', 'trambakesh97', 'sarika', 'pritijha1996', 'bgharat713', 'mayank.vp', 'preethinaik', 'snehalpatil', None, 'shreyas.v', 'veronicathapa56', 'podililaxmi30', 'divyassingh56', 'shraddha.dhage', 'hborse28', 'mithilagajarmal']",90,"['rajeshree.kumbhar5018', 'ashishghoderao', 'sumitmhatre5670', 'ronak.tiwari', 'sanchitkad', 'rasikapotdar2108', 'aishuauti20496', 'adnan.s', 'ritik.singh', 'prerana.goythale', 'pandeydeepak825', 'shweta.joglekar', 'mounikajalla99', 'puranikatharva', 'bonhomie11', 'prathamesh.nikam', 'bhushan9321', 'vishalnaik.0210', 'harishkumar.n', 'sanketmane1997.sm', 'shirishparkhe', 'krunal.kasar', 'sendpost2mahesh', 'sid.jagtap1992', 'surbhib2897', 'shraddhasam78', 'richitapatil', 'yashuishwar', 'atul', 'paromita24', 'niveditachaudhari', 'mhatrenrupal42', 'neonargon5', 'ayesha.pathan', 'digvijayjadeja725', 'shrey.joshi', 'ninadmandavkar29', 'nehamallan', 'nishigandhaprsd14', 'rushikeshsalgar123', 'sahil709', 'ameyc007', 'neelamt', 'amarravade31', 'patiltejas000003', 'akshatamahajan47', 'yogeshmaurya50', 'gaurav.mishra', 'vivekrana', 'manjarekarchinmayeen', 'riddhi737', 'niharmasurkar', 'apurvawaghmode14', 'bhandarinirali57', 'bhagyashrimali280497', 'mihirgogri613', 'sarika_bukkawar', 'lekhakande', 'pratibhagawari28', 'nirav.lm', 'anitadey12', 'rohan.mestry', 'mayurgonbare22', 'dhavit.v', 'sumitpatil512', 'sonali.ramji', 'dleena19961209', 'maneaniket', 'siddheshgothankar', 'yuvraj.t', 'akshay1997bhagit', 'atulkokane1234', 'electronics209', 'raj.vadariya', 'trambakesh97', 'sarika', 'pritijha1996', 'bgharat713', 'mayank.vp', 'preethinaik', 'snehalpatil', 'rajesh05', None, 'shreyas.v', 'veronicathapa56', 'podililaxmi30', 'divyassingh56', 'shraddha.dhage', 'hborse28', 'mithilagajarmal']"
95,269,9,75,8,"['manjarekarchinmayeen', 'bhushan9321', 'riddhi737', 'ayesha.pathan', 'sanchitkad', 'mihirgogri613', 'aishuauti20496', 'rajesh05']",0,[],67,"['rajeshree.kumbhar5018', 'palakchheda2407', 'mbhosale863', 'ashishghoderao', 'sumitmhatre5670', 'ashwinipardeshi702', 'ronak.tiwari', 'rasikapotdar2108', 'pandeydeepak825', 'puranikatharva', 'prathamesh.nikam', 'adityagudla96', 'sid.jagtap1992', 'sendpost2mahesh', 'surbhib2897', 'shraddhasam78', 'jayshreepakhare63', 'atul', 'bolekunal42', 'mhatrenrupal42', 'neonargon5', 'ninadmandavkar29', 'abhishek2397', 'nishigandhaprsd14', 'bhaveshsawant1996', 'rushikeshsalgar123', 'sahil709', 'dusty', 'neelamt', 'sudar', 'shreekantrasam69', 'yogeshmaurya50', 'kavusatose123', 'niharmasurkar', 'bhandarinirali57', 'lekhakande', 'pratibhagawari28', 'ab17', 'anitadey12', 'mayurgonbare22', 'sumitpatil512', 'sonali.ramji', 'maneaniket', 'siddheshgothankar', 'dleena19961209', 'abhijaypandey', 'dilip.wakdikar', 'trambakesh97', 'riyakulkarni16021997', 'brarath.nihal', 'bgharat713', 'pritijha1996', 'preethinaik', 'ganeshjadhav', 'sanket.mane', 'snehalpatil', 'ksanket025', None, 'rahul.sawant', 's.arutwar', 'veronicathapa56', 'prashant.khedkar', 'vishal8244', 'shraddha.dhage', 'hborse28', 'ganesh.mali', 'mithilagajarmal']",75,"['rajeshree.kumbhar5018', 'palakchheda2407', 'mbhosale863', 'ashishghoderao', 'sumitmhatre5670', 'ashwinipardeshi702', 'ronak.tiwari', 'sanchitkad', 'rasikapotdar2108', 'aishuauti20496', 'pandeydeepak825', 'puranikatharva', 'prathamesh.nikam', 'bhushan9321', 'adityagudla96', 'sid.jagtap1992', 'sendpost2mahesh', 'surbhib2897', 'shraddhasam78', 'jayshreepakhare63', 'atul', 'bolekunal42', 'mhatrenrupal42', 'neonargon5', 'ayesha.pathan', 'ninadmandavkar29', 'abhishek2397', 'nishigandhaprsd14', 'bhaveshsawant1996', 'rushikeshsalgar123', 'sahil709', 'dusty', 'neelamt', 'sudar', 'shreekantrasam69', 'yogeshmaurya50', 'kavusatose123', 'manjarekarchinmayeen', 'riddhi737', 'niharmasurkar', 'bhandarinirali57', 'mihirgogri613', 'lekhakande', 'pratibhagawari28', 'ab17', 'anitadey12', 'mayurgonbare22', 'sumitpatil512', 'sonali.ramji', 'maneaniket', 'siddheshgothankar', 'dleena19961209', 'abhijaypandey', 'dilip.wakdikar', 'trambakesh97', 'riyakulkarni16021997', 'brarath.nihal', 'bgharat713', 'pritijha1996', 'preethinaik', 'ganeshjadhav', 'sanket.mane', 'snehalpatil', 'rajesh05', 'ksanket025', None, 'rahul.sawant', 's.arutwar', 'veronicathapa56', 'prashant.khedkar', 'vishal8244', 'shraddha.dhage', 'hborse28', 'ganesh.mali', 'mithilagajarmal']"
95,282,9,50,6,"['manjarekarchinmayeen', 'bhushan9321', 'riddhi737', 'ayesha.pathan', 'aishuauti20496', 'rajesh05']",2,"['mihirgogri613', 'sanchitkad']",44,"['rajeshree.kumbhar5018', 'sanket.gawade', 'sunilmolawade', 'ani.date23', 'nikhil.a', 'rasikapotdar2108', 'satish.yadav', 'nasareen.k', 'lekhakande', 'pratibhagawari28', 'nirav.lm', 'anitadey12', 'puranikatharva', 'mayurgonbare22', 'sanketmane1997.sm', 'janawalekarp', 'siddheshgothankar', 'shirishparkhe', 'krunal.kasar', 'yuvraj.t', 'abhishek.diggewadi', 'kadam.rupesh28297', 'shreyapatel606', 'shraddhasam78', 'renukabhosale14', 'vijayshankarchaurasiya', 'paromita24', 'snehalpatil', 'pratik.gc', 'sumitmhatre', None, 'dusty', 'ameyc007', 'rahul.sawant', 'neelamt', 'podililaxmi30', 'pratikshedge23', 'amarravade31', 'divyashriteppala', 'patiltejas000003', 'krupalpatel1996', 'akshatamahajan47', 'shweta.gosavi', 'kgirkar6104']",52,"['rajeshree.kumbhar5018', 'sanket.gawade', 'sunilmolawade', 'ani.date23', 'manjarekarchinmayeen', 'nikhil.a', 'riddhi737', 'sanchitkad', 'rasikapotdar2108', 'mihirgogri613', 'aishuauti20496', 'satish.yadav', 'nasareen.k', 'lekhakande', 'pratibhagawari28', 'nirav.lm', 'anitadey12', 'puranikatharva', 'mayurgonbare22', 'bhushan9321', 'sanketmane1997.sm', 'janawalekarp', 'siddheshgothankar', 'shirishparkhe', 'krunal.kasar', 'yuvraj.t', 'abhishek.diggewadi', 'kadam.rupesh28297', 'shreyapatel606', 'shraddhasam78', 'renukabhosale14', 'vijayshankarchaurasiya', 'paromita24', 'ayesha.pathan', 'snehalpatil', 'rajesh05', 'pratik.gc', 'sumitmhatre', None, 'dusty', 'ameyc007', 'rahul.sawant', 'neelamt', 'podililaxmi30', 'pratikshedge23', 'amarravade31', 'divyashriteppala', 'patiltejas000003', 'krupalpatel1996', 'akshatamahajan47', 'shweta.gosavi', 'kgirkar6104']"
95,281,9,32,6,"['manjarekarchinmayeen', 'bhushan9321', 'ayesha.pathan', 'sanchitkad', 'mihirgogri613', 'rajesh05']",2,"['aishuauti20496', 'riddhi737']",26,"['palakchheda2407', 'sumitmhatre5670', 'ronak.tiwari', 'bhagyashrimali280497', 'rasikapotdar2108', 'lekhakande', 'ab17', 'anitadey12', 'puranikatharva', 'siddhi123', 'sanketmane1997.sm', 'sonysagar1996', 'maneaniket', 'richitapatil', 'renukabhosale14', 'dilip.wakdikar', 'vijayshankarchaurasiya', 'neonargon5', 'digvijayjadeja725', None, 'podililaxmi30', 'patiltejas000003', 'divyassingh56', 'akshatamahajan47', 'shraddha.dhage', 'mithilagajarmal']",34,"['palakchheda2407', 'manjarekarchinmayeen', 'sumitmhatre5670', 'riddhi737', 'ronak.tiwari', 'sanchitkad', 'bhagyashrimali280497', 'rasikapotdar2108', 'mihirgogri613', 'aishuauti20496', 'lekhakande', 'ab17', 'anitadey12', 'puranikatharva', 'bhushan9321', 'siddhi123', 'sanketmane1997.sm', 'sonysagar1996', 'maneaniket', 'richitapatil', 'renukabhosale14', 'dilip.wakdikar', 'vijayshankarchaurasiya', 'neonargon5', 'ayesha.pathan', 'digvijayjadeja725', 'rajesh05', None, 'podililaxmi30', 'patiltejas000003', 'divyassingh56', 'akshatamahajan47', 'shraddha.dhage', 'mithilagajarmal']"
95,58,9,19,7,"['manjarekarchinmayeen', 'bhushan9321', 'riddhi737', 'ayesha.pathan', 'sanchitkad', 'aishuauti20496', 'rajesh05']",1,['mihirgogri613'],12,"['sanket.gawade', 'dusty', 'sid.jagtap1992', 'prathamesh.nikam', 'ronak.tiwari', 'patiltejas000003', 'digvijayjadeja725', 'sanketmane1997.sm', 'preethinaik', 'abhishek.diggewadi', 'kgirkar6104', None]",20,"['sanket.gawade', 'sid.jagtap1992', 'manjarekarchinmayeen', 'riddhi737', 'ronak.tiwari', 'ayesha.pathan', 'sanchitkad', 'digvijayjadeja725', 'mihirgogri613', 'aishuauti20496', 'preethinaik', 'rajesh05', None, 'dusty', 'prathamesh.nikam', 'bhushan9321', 'patiltejas000003', 'sanketmane1997.sm', 'abhishek.diggewadi', 'kgirkar6104']"
96,272,9,12,5,"['riteshrajput381', 'vora.jai1', 'vaibhavvadia', 'patelmeeti1995', 'hardikganatra1806']",3,"['sankheneel', 'rakshandakhan38', 'helloworld1']",7,"['nishant.joshi42', 'aagamshah999999999', 'kush100', 'bhavana.djs19', None, 'dollarboyhardik', 'karan.dhareshwar']",15,"['riteshrajput381', 'aagamshah999999999', 'patelmeeti1995', 'sankheneel', 'kush100', None, 'karan.dhareshwar', 'dollarboyhardik', 'vora.jai1', 'rakshandakhan38', 'helloworld1', 'vaibhavvadia', 'bhavana.djs19', 'nishant.joshi42', 'hardikganatra1806']"
96,273,9,9,3,"['sankheneel', 'rakshandakhan38', 'helloworld1']",5,"['riteshrajput381', 'vora.jai1', 'vaibhavvadia', 'patelmeeti1995', 'hardikganatra1806']",6,"['rohanshah611', 'tanvishah2410', 'parikhnisarg19', 'mohitrv30', None, 'doshipayal1996']",14,"['riteshrajput381', 'vora.jai1', 'rakshandakhan38', 'helloworld1', 'rohanshah611', 'tanvishah2410', 'vaibhavvadia', 'doshipayal1996', 'patelmeeti1995', 'sankheneel', 'parikhnisarg19', 'mohitrv30', None, 'hardikganatra1806']"
97,129,9,11,6,"['ahmed_moustafa_94', 'karimaboelmakarem', 'ahhamed93', 'ahmedhossam', 'alaa_khairalla', 'ahmed_devices']",2,"['abubakrjaved93', 'abdulrahman.elmashed']",5,"['manarnegm', 'sdadasda', 'manar.ibraheem', None, 'eng.mona.fouad']",13,"['sdadasda', 'manar.ibraheem', 'abubakrjaved93', None, 'ahmed_devices', 'eng.mona.fouad', 'karimaboelmakarem', 'manarnegm', 'abdulrahman.elmashed', 'ahhamed93', 'ahmedhossam', 'alaa_khairalla', 'ahmed_moustafa_94']"
97,190,9,8,4,"['karimaboelmakarem', 'ahhamed93', 'alaa_khairalla', 'ahmed_devices']",4,"['abubakrjaved93', 'ahmedhossam', 'abdulrahman.elmashed', 'ahmed_moustafa_94']",4,"['manarnegm', 'manar.ibraheem', 'aymanbakr1984.1', None]",12,"[None, 'ahmed_devices', 'karimaboelmakarem', 'manarnegm', 'abdulrahman.elmashed', 'ahhamed93', 'manar.ibraheem', 'abubakrjaved93', 'ahmedhossam', 'aymanbakr1984.1', 'alaa_khairalla', 'ahmed_moustafa_94']"
98,118,9,24,8,"['swapnilpatil8072', 'shalmalirburse29', 'anghakamble247', 'rk6998', 'khotatul94', 'vrushali29sd', 'prashantsarvalkar22', 'chougulesourabh620']",0,[],16,"['sharonsebastian333', 'tukaram', 'darshanahavaldar7', 'maheshchougale7072', 'shraddhabodakepatil', 'pratikshachandane17197', 'shubhammagdum6002', 'jnv123dvd', 'pallavijagdale22', 'patilpruthviraj191', 'vaibhavg007.vg', 'madhura7deshpande', 'pranotikumbhar1411', 'somnath1995', None, 'kadamkalyani1997']",24,"['swapnilpatil8072', 'darshanahavaldar7', 'rk6998', 'khotatul94', 'pallavijagdale22', 'prashantsarvalkar22', 'kadamkalyani1997', 'tukaram', 'shraddhabodakepatil', 'pranotikumbhar1411', 'chougulesourabh620', 'shalmalirburse29', 'anghakamble247', 'pratikshachandane17197', 'patilpruthviraj191', 'vaibhavg007.vg', None, 'madhura7deshpande', 'sharonsebastian333', 'maheshchougale7072', 'shubhammagdum6002', 'jnv123dvd', 'vrushali29sd', 'somnath1995']"
98,156,9,24,8,"['swapnilpatil8072', 'shalmalirburse29', 'anghakamble247', 'rk6998', 'khotatul94', 'vrushali29sd', 'prashantsarvalkar22', 'chougulesourabh620']",0,[],16,"['sharonsebastian333', 'tukaram', 'darshanahavaldar7', 'maheshchougale7072', 'shraddhabodakepatil', 'pratikshachandane17197', 'shubhammagdum6002', 'jnv123dvd', 'pallavijagdale22', 'patilpruthviraj191', 'vaibhavg007.vg', 'madhura7deshpande', 'pranotikumbhar1411', 'somnath1995', None, 'kadamkalyani1997']",24,"['swapnilpatil8072', 'darshanahavaldar7', 'rk6998', 'khotatul94', 'pallavijagdale22', 'prashantsarvalkar22', 'kadamkalyani1997', 'tukaram', 'shraddhabodakepatil', 'pranotikumbhar1411', 'chougulesourabh620', 'shalmalirburse29', 'anghakamble247', 'pratikshachandane17197', 'patilpruthviraj191', 'vaibhavg007.vg', None, 'madhura7deshpande', 'sharonsebastian333', 'maheshchougale7072', 'shubhammagdum6002', 'jnv123dvd', 'vrushali29sd', 'somnath1995']"
98,248,9,24,8,"['swapnilpatil8072', 'shalmalirburse29', 'anghakamble247', 'rk6998', 'khotatul94', 'vrushali29sd', 'prashantsarvalkar22', 'chougulesourabh620']",0,[],16,"['sharonsebastian333', 'tukaram', 'darshanahavaldar7', 'maheshchougale7072', 'shraddhabodakepatil', 'pratikshachandane17197', 'shubhammagdum6002', 'jnv123dvd', 'pallavijagdale22', 'patilpruthviraj191', 'vaibhavg007.vg', 'madhura7deshpande', 'pranotikumbhar1411', 'somnath1995', None, 'kadamkalyani1997']",24,"['swapnilpatil8072', 'darshanahavaldar7', 'rk6998', 'khotatul94', 'pallavijagdale22', 'prashantsarvalkar22', 'kadamkalyani1997', 'tukaram', 'shraddhabodakepatil', 'pranotikumbhar1411', 'chougulesourabh620', 'shalmalirburse29', 'anghakamble247', 'pratikshachandane17197', 'patilpruthviraj191', 'vaibhavg007.vg', None, 'madhura7deshpande', 'sharonsebastian333', 'maheshchougale7072', 'shubhammagdum6002', 'jnv123dvd', 'vrushali29sd', 'somnath1995']"
99,278,9,20,8,"['rakesh.shinde65', 'ananth33', 'beelectronics0', 'omkarcrenavikar', 'ganesh160194', 'rnair10', 'ninawe14', 'sandhya.rathore14']",0,[],12,"['chavanv953', 'sayaligite11', 'mayanair1104', 'sjayyant31', 'ashpillai.1996', 'komalsb37', 'vishwas', 'bkumar', 'komalsurve982', 'aadi1212', None, 'mayureshnagvekar57']",20,"['omkarcrenavikar', 'beelectronics0', 'chavanv953', 'mayanair1104', 'rnair10', 'ashpillai.1996', 'sjayyant31', 'sandhya.rathore14', 'vishwas', 'bkumar', 'komalsurve982', 'aadi1212', None, 'mayureshnagvekar57', 'rakesh.shinde65', 'ananth33', 'sayaligite11', 'ganesh160194', 'ninawe14', 'komalsb37']"
100,77,9,9,7,"['zzeng1', 'kkidder', 'materialschem', 'mbollmey', 'cgood', 'aunruh', 'rgaston']",1,['rschimpf78'],2,"['kplass', None]",10,"[None, 'zzeng1', 'kkidder', 'materialschem', 'mbollmey', 'cgood', 'rschimpf78', 'kplass', 'aunruh', 'rgaston']"
101,172,9,10,6,"['luoxia', 'drivera', 'jombogo', 'pchakraborty', 'mihasan', 'toby_black']",2,"['em15140', 'mibaglay']",4,"['azahiri', None, 'tengfeim', 'czampella']",12,"['toby_black', 'em15140', 'luoxia', 'jombogo', 'pchakraborty', 'mihasan', 'mibaglay', 'tengfeim', 'azahiri', 'drivera', None, 'czampella']"
103,194,9,10,8,"['tj748', 'dh1860', 'emb581', 'jh4339', 'yochutes', 'kp1578', 'jkf292', 'jk4697']",0,[],2,"[None, 'rc2975']",10,"['tj748', 'dh1860', 'emb581', 'jh4339', 'yochutes', 'kp1578', 'jkf292', None, 'jk4697', 'rc2975']"
104,24,9,18,4,"['matthias_w', 'feyer', 'martin92', 'fl0_pi']",4,"['dg0530814', 'nikolaus.czepl', 'wbodlo21', 'framesfree']",14,"['verenafritz', 'fratschko', 'spital_t', 'seebac_m', 'sambucus33', 'dg053', 'reinli13', 'indium3arsenid', 'robert.koeberl', 'pirker_c', 'howland12', None, 'kzojer', 'chrispi']",22,"['verenafritz', 'fratschko', 'dg0530814', 'nikolaus.czepl', 'feyer', 'martin92', 'sambucus33', 'dg053', 'wbodlo21', 'howland12', None, 'spital_t', 'matthias_w', 'framesfree', 'seebac_m', 'reinli13', 'indium3arsenid', 'robert.koeberl', 'fl0_pi', 'pirker_c', 'kzojer', 'chrispi']"
104,25,9,14,5,"['dg0530814', 'nikolaus.czepl', 'feyer', 'fl0_pi', 'wbodlo21']",3,"['matthias_w', 'martin92', 'framesfree']",9,"['verenafritz', 'seebac_m', 'reinli13', 'indium3arsenid', 'vicarius', 'howland12', None, 'spital_t', 'chrisi588']",17,"['verenafritz', 'dg0530814', 'nikolaus.czepl', 'feyer', 'martin92', 'wbodlo21', 'howland12', None, 'spital_t', 'matthias_w', 'framesfree', 'seebac_m', 'reinli13', 'indium3arsenid', 'fl0_pi', 'vicarius', 'chrisi588']"
104,191,9,11,1,['feyer'],7,"['matthias_w', 'dg0530814', 'nikolaus.czepl', 'framesfree', 'martin92', 'wbodlo21', 'fl0_pi']",10,"['verenafritz', 'seebac_m', 'b00050512', 'reinli13', 'indium3arsenid', 'vicarius', 'howland12', None, 'spital_t', 'chrisi588']",18,"['verenafritz', 'dg0530814', 'nikolaus.czepl', 'feyer', 'martin92', 'wbodlo21', 'howland12', None, 'spital_t', 'matthias_w', 'framesfree', 'seebac_m', 'b00050512', 'reinli13', 'indium3arsenid', 'fl0_pi', 'vicarius', 'chrisi588']"
105,2,9,17,2,"['cdflem94', 'xiushan']",6,"['ellathomson', 'jzhao4', 'bryu', 'ishaabishnoi', 'dmfeng', 'anjali.majumdar1']",15,"['aditidatta', 'zzh', 'rthowe', 'hgao3', 'galexop', 'qfhuang', 'liluoqi07', 'avan994', 'zhouz4', 'yangjennie', 'cccharleschan', None, 'savs413', 'fangguanhua2013', 'dm628']",23,"['ellathomson', 'hgao3', 'bryu', 'ishaabishnoi', 'qfhuang', 'anjali.majumdar1', 'zhouz4', 'xiushan', None, 'savs413', 'dm628', 'aditidatta', 'cdflem94', 'zzh', 'rthowe', 'jzhao4', 'galexop', 'liluoqi07', 'dmfeng', 'avan994', 'yangjennie', 'cccharleschan', 'fangguanhua2013']"
105,88,9,14,7,"['ellathomson', 'cdflem94', 'jzhao4', 'bryu', 'ishaabishnoi', 'dmfeng', 'xiushan']",1,['anjali.majumdar1'],7,"['aditidatta', 'chrisrocks40', 'ehernndz', 'mark01', 'ozhao2012', 'bunj', None]",15,"['ellathomson', 'chrisrocks40', 'bryu', 'ishaabishnoi', 'mark01', 'anjali.majumdar1', 'bunj', 'xiushan', None, 'aditidatta', 'cdflem94', 'ehernndz', 'jzhao4', 'dmfeng', 'ozhao2012']"
105,208,9,9,5,"['ellathomson', 'cdflem94', 'ishaabishnoi', 'dmfeng', 'xiushan']",3,"['jzhao4', 'anjali.majumdar1', 'bryu']",4,"['shrcor', 'fangguanhua2013', None, 'qfhuang']",12,"['ellathomson', 'cdflem94', 'jzhao4', 'bryu', 'ishaabishnoi', 'qfhuang', 'dmfeng', 'anjali.majumdar1', 'shrcor', 'xiushan', None, 'fangguanhua2013']"
106,10,9,19,1,['morga'],7,"['abouelatta2311998', 'seeyoong', 'samdig', 'mtlg0509', 'yzhong22', 'bz_5657', 'jinbo.wan']",18,"['aragom1', 'mccart2', 'morgaj7', 'reekj', 'patelp3', 'smithb25', 'marqua2', 'tuqueroe', 'munguia4', 'lasseb1', 'fristerc', 'sama1', 'fredsteven12', 'dingal', 'cordom1', 'djgraziano', None, 'butlerk2']",26,"['abouelatta2311998', 'morgaj7', 'reekj', 'patelp3', 'tuqueroe', 'seeyoong', 'samdig', 'dingal', 'cordom1', 'djgraziano', None, 'aragom1', 'mccart2', 'lasseb1', 'fristerc', 'smithb25', 'marqua2', 'munguia4', 'sama1', 'mtlg0509', 'fredsteven12', 'yzhong22', 'bz_5657', 'morga', 'jinbo.wan', 'butlerk2']"
106,8,9,12,1,['seeyoong'],7,"['abouelatta2311998', 'samdig', 'mtlg0509', 'yzhong22', 'bz_5657', 'morga', 'jinbo.wan']",11,"['wedad_almutairi', 'alaleh', None, 'amandeep', 'sarahbamford_97', 'svkal001', 'lre', 'adkro001', 'raf802', 'sohard', 'emmyg']",19,"['abouelatta2311998', 'amandeep', 'seeyoong', 'samdig', 'sarahbamford_97', 'adkro001', 'sohard', None, 'emmyg', 'wedad_almutairi', 'alaleh', 'mtlg0509', 'lre', 'yzhong22', 'raf802', 'bz_5657', 'morga', 'jinbo.wan', 'svkal001']"
106,6,9,9,1,['bz_5657'],7,"['abouelatta2311998', 'seeyoong', 'samdig', 'mtlg0509', 'yzhong22', 'morga', 'jinbo.wan']",8,"['davaanaa0101', 'zulaa95', 'davaa23', 'n.batkaa', 'davaanaa010101', None, 'x.ganerdene123', 'b.byambadorj']",16,"['abouelatta2311998', 'davaanaa0101', 'zulaa95', 'davaa23', 'seeyoong', 'samdig', 'mtlg0509', 'yzhong22', 'bz_5657', 'morga', 'n.batkaa', 'davaanaa010101', 'jinbo.wan', None, 'x.ganerdene123', 'b.byambadorj']"
106,11,9,9,1,['bz_5657'],7,"['abouelatta2311998', 'seeyoong', 'samdig', 'mtlg0509', 'yzhong22', 'morga', 'jinbo.wan']",8,"['davaanaa0101', 'bganaabganaa1998', 'boogii', 'amraa061', 'nyamjantsan', 'davaanaa010101', 'battulga9192', None]",16,"['abouelatta2311998', 'davaanaa0101', 'bganaabganaa1998', 'boogii', 'amraa061', 'seeyoong', 'samdig', 'mtlg0509', 'nyamjantsan', 'battulga9192', 'yzhong22', 'bz_5657', 'morga', 'davaanaa010101', 'jinbo.wan', None]"
107,249,9,13,1,['abhijeetbiradar097'],7,"['eliecobo45', 'blassselva', 'ecardozo', 'molotov.mhb', 'unnaturaltm', 'emmanuel.calvet42', 'heomond']",12,"['sujitshinde341', 'darshanahavaldar7', 'amu72', 'khotsagar77', 'pallavijagdale22', 'patilpruthviraj191', 'magdumpriya18', 'gajananpatil2513', 'disha7', 'vvpowar1996', None, 'madhura7deshpande']",20,"['blassselva', 'ecardozo', 'sujitshinde341', 'darshanahavaldar7', 'pallavijagdale22', 'abhijeetbiradar097', 'emmanuel.calvet42', 'patilpruthviraj191', None, 'madhura7deshpande', 'gajananpatil2513', 'eliecobo45', 'molotov.mhb', 'amu72', 'unnaturaltm', 'khotsagar77', 'magdumpriya18', 'heomond', 'disha7', 'vvpowar1996']"
109,42,8,8,7,"['hb2018', 'renny', 'susanne.reischauer', 'mdrusgala', 'freskida.goni', 'petrus.chalmers', 'hafnerm']",0,[],1,[None],8,"['hb2018', 'renny', 'susanne.reischauer', 'mdrusgala', 'freskida.goni', 'petrus.chalmers', None, 'hafnerm']"
109,227,8,8,7,"['hb2018', 'renny', 'susanne.reischauer', 'mdrusgala', 'freskida.goni', 'petrus.chalmers', 'hafnerm']",0,[],1,[None],8,"['hb2018', 'renny', 'susanne.reischauer', 'mdrusgala', 'freskida.goni', 'petrus.chalmers', None, 'hafnerm']"
110,9,8,22,7,"['alberto_ct_96', 'samgalv', 'galfa', 'acasgar17', 'angyrom8', 'andermoren', 'martaalvarezdominguez']",0,[],15,"['maclopveg', 'eleni_ac', 'juanrh96', 'miguelhernandezcamacho', 'abldvd', 'jesuschaconmontero', 'hansinivaswani', 'fernandoserranoperez94', 'andreazaccaria', 'claudiagalindo', 'solitaso', 'anxela', None, 'mariano', 'gines']",22,"['alberto_ct_96', 'samgalv', 'eleni_ac', 'angyrom8', 'claudiagalindo', 'anxela', None, 'maclopveg', 'galfa', 'solitaso', 'juanrh96', 'miguelhernandezcamacho', 'abldvd', 'acasgar17', 'jesuschaconmontero', 'hansinivaswani', 'fernandoserranoperez94', 'andreazaccaria', 'andermoren', 'mariano', 'martaalvarezdominguez', 'gines']"
110,50,8,22,6,"['samgalv', 'galfa', 'acasgar17', 'angyrom8', 'andermoren', 'martaalvarezdominguez']",1,['alberto_ct_96'],16,"['maclopveg', 'eleacecar94', 'miguelhernandezcamacho', 'alexparedesgranado', 'jesuschaconmontero', 'hansinivaswani', 'fernandoserranoperez94', 'paulavg1995', 'claudiagalindo', 'mariaal23', 'paunavgon2296', 'solitaso', 'anxela', None, 'mariano', 'gines']",23,"['alberto_ct_96', 'samgalv', 'eleacecar94', 'alexparedesgranado', 'angyrom8', 'paulavg1995', 'claudiagalindo', 'paunavgon2296', 'anxela', None, 'maclopveg', 'mariaal23', 'galfa', 'solitaso', 'miguelhernandezcamacho', 'acasgar17', 'jesuschaconmontero', 'hansinivaswani', 'fernandoserranoperez94', 'andermoren', 'mariano', 'martaalvarezdominguez', 'gines']"
110,173,8,22,7,"['alberto_ct_96', 'samgalv', 'galfa', 'acasgar17', 'angyrom8', 'andermoren', 'martaalvarezdominguez']",0,[],15,"['maclopveg', 'eleni_ac', 'juanrh96', 'miguelhernandezcamacho', 'abldvd', 'jesuschaconmontero', 'hansinivaswani', 'fernandoserranoperez94', 'andreazaccaria', 'claudiagalindo', 'solitaso', 'anxela', None, 'mariano', 'gines']",22,"['alberto_ct_96', 'samgalv', 'eleni_ac', 'angyrom8', 'claudiagalindo', 'anxela', None, 'maclopveg', 'galfa', 'solitaso', 'juanrh96', 'miguelhernandezcamacho', 'abldvd', 'acasgar17', 'jesuschaconmontero', 'hansinivaswani', 'fernandoserranoperez94', 'andreazaccaria', 'andermoren', 'mariano', 'martaalvarezdominguez', 'gines']"
110,40,8,20,7,"['alberto_ct_96', 'samgalv', 'galfa', 'acasgar17', 'angyrom8', 'andermoren', 'martaalvarezdominguez']",0,[],13,"['maclopveg', 'eleni_ac', 'juanrh96', 'miguelhernandezcamacho', 'abldvd', 'jesuschaconmontero', 'hansinivaswani', 'fernandoserranoperez94', 'andreazaccaria', 'claudiagalindo', 'anxela', None, 'gines']",20,"['alberto_ct_96', 'samgalv', 'eleni_ac', 'angyrom8', 'claudiagalindo', 'anxela', None, 'maclopveg', 'galfa', 'juanrh96', 'miguelhernandezcamacho', 'abldvd', 'acasgar17', 'jesuschaconmontero', 'hansinivaswani', 'fernandoserranoperez94', 'andreazaccaria', 'andermoren', 'martaalvarezdominguez', 'gines']"
110,52,8,20,6,"['alberto_ct_96', 'samgalv', 'galfa', 'acasgar17', 'angyrom8', 'andermoren']",1,['martaalvarezdominguez'],14,"['eleni_ac', 'juanrh96', 'miguelhernandezcamacho', 'abldvd', 'jesuschaconmontero', 'hansinivaswani', 'fernandoserranoperez94', 'andreazaccaria', 'claudiagalindo', 'solitaso', 'anxela', None, 'mariano', 'gines']",21,"['alberto_ct_96', 'samgalv', 'eleni_ac', 'angyrom8', 'claudiagalindo', 'anxela', None, 'galfa', 'solitaso', 'juanrh96', 'miguelhernandezcamacho', 'abldvd', 'acasgar17', 'jesuschaconmontero', 'hansinivaswani', 'fernandoserranoperez94', 'andreazaccaria', 'andermoren', 'mariano', 'martaalvarezdominguez', 'gines']"
110,257,8,20,7,"['alberto_ct_96', 'samgalv', 'galfa', 'acasgar17', 'angyrom8', 'andermoren', 'martaalvarezdominguez']",0,[],13,"['maclopveg', 'eleni_ac', 'abldvd', 'alexparedesgranado', 'jesuschaconmontero', 'claudiagalindo', 'mariaal23', 'paunavgon2296', 'solitaso', 'anxela', None, 'mariano', 'gines']",20,"['alberto_ct_96', 'samgalv', 'eleni_ac', 'alexparedesgranado', 'angyrom8', 'claudiagalindo', 'paunavgon2296', 'anxela', None, 'maclopveg', 'mariaal23', 'galfa', 'solitaso', 'abldvd', 'acasgar17', 'jesuschaconmontero', 'andermoren', 'mariano', 'martaalvarezdominguez', 'gines']"
110,203,8,13,5,"['alberto_ct_96', 'samgalv', 'galfa', 'acasgar17', 'martaalvarezdominguez']",2,"['andermoren', 'angyrom8']",8,"['maclopveg', 'eleni_ac', 'abldvd', 'alexparedesgranado', 'andreazaccaria', 'solitaso', None, 'gines']",15,"['alberto_ct_96', 'samgalv', 'eleni_ac', 'alexparedesgranado', 'angyrom8', None, 'maclopveg', 'galfa', 'solitaso', 'abldvd', 'acasgar17', 'andreazaccaria', 'andermoren', 'martaalvarezdominguez', 'gines']"
110,274,8,13,5,"['alberto_ct_96', 'samgalv', 'galfa', 'acasgar17', 'martaalvarezdominguez']",2,"['andermoren', 'angyrom8']",8,"['maclopveg', 'eleni_ac', 'abldvd', 'alexparedesgranado', 'andreazaccaria', 'solitaso', None, 'gines']",15,"['alberto_ct_96', 'samgalv', 'eleni_ac', 'alexparedesgranado', 'angyrom8', None, 'maclopveg', 'galfa', 'solitaso', 'abldvd', 'acasgar17', 'andreazaccaria', 'andermoren', 'martaalvarezdominguez', 'gines']"
113,75,8,22,4,"['heneveld', 'jiaoquan_0610', 'kevin88', 'csgong']",3,"['askhdy9431', 'bohuawen', 'xungong']",18,"['tangyunlong2011', 'jq1', 'ybalog2000', 'multiscalele', None, 'crainshower', 'rdai5', 'mrodri05', 'maryamtab', 'buehler', 'prabhashundi008', 'gmclachl', 'qihanliu', 'brandon.i.macdonald', 'hdgh1369', 'muxuan2008', 'zhiliangntnu', 'sp435']",25,"['tangyunlong2011', 'jq1', 'xungong', 'bohuawen', 'csgong', 'brandon.i.macdonald', 'kevin88', 'crainshower', 'zhiliangntnu', None, 'maryamtab', 'sp435', 'jiaoquan_0610', 'ybalog2000', 'rdai5', 'buehler', 'askhdy9431', 'prabhashundi008', 'heneveld', 'gmclachl', 'qihanliu', 'mrodri05', 'hdgh1369', 'muxuan2008', 'multiscalele']"
113,298,8,20,4,"['heneveld', 'jiaoquan_0610', 'kevin88', 'csgong']",3,"['askhdy9431', 'bohuawen', 'xungong']",16,"['tangyunlong2011', 'jq1', 'ybalog2000', 'multiscalele', None, 'crainshower', 'thesustainableinvestor', 'rdai5', 'mrodri05', 'maryamtab', 'prabhashundi008', 'brandon.i.macdonald', 'hdgh1369', 'muxuan2008', 'zhiliangntnu', 'sp435']",23,"['tangyunlong2011', 'jq1', 'xungong', 'thesustainableinvestor', 'bohuawen', 'csgong', 'brandon.i.macdonald', 'kevin88', 'crainshower', 'zhiliangntnu', None, 'maryamtab', 'sp435', 'jiaoquan_0610', 'ybalog2000', 'rdai5', 'askhdy9431', 'prabhashundi008', 'heneveld', 'mrodri05', 'hdgh1369', 'muxuan2008', 'multiscalele']"
114,265,8,8,7,"['wnewto01', 'dsalmo01', 'tehtas01', 'afitzs01', 'awisha01', 'sophielee', 'msalam05']",0,[],1,[None],8,"[None, 'wnewto01', 'dsalmo01', 'tehtas01', 'afitzs01', 'awisha01', 'sophielee', 'msalam05']"
115,250,8,10,7,"['fmpk_john', 'ikhardin000', 'alexandrshvetsov174', 'papylya', 'kasha', 'igorecek97', 'parukin']",0,[],3,"['eadiyak', 'evelyngualotuna21', None]",10,"['eadiyak', 'ikhardin000', 'kasha', None, 'fmpk_john', 'alexandrshvetsov174', 'evelyngualotuna21', 'papylya', 'igorecek97', 'parukin']"
116,209,8,10,4,"['siu852794109', 'cneum', 'joshualevan', 'andipyle14']",3,"['shandrock', 'tiarecassidy', 'siu853656298']",6,"['mtroll', 'rpw32', 'mandiediane', 'nslagle', 'sidell66', None]",13,"['cneum', 'tiarecassidy', 'rpw32', 'mandiediane', 'shandrock', 'nslagle', 'sidell66', 'joshualevan', 'andipyle14', None, 'mtroll', 'siu853656298', 'siu852794109']"
118,85,8,85,7,"['aokisang', 'rhyu2', 'jboo72390', 'wendi0522', 'hyang89', 'michael.p.gambino', 'jzhan142']",0,[],78,"['wolan2', 'tson3', 'mepaul2', 'zlevell2', 'liam.kenny96', 'jsshin3', 'ychen388', 'sarahrp2', 'talee3', 'emwisni2', 'bpbaile2', 'bdguo2', 'cisrael2', 'khuang47', 'jsharma3', 'clin101', 'jablowi2', 'saphknight', 'kperozek2', 'cplant2', 'kkim142', 'ab20', 'mtschro3', 'schoole2', 'mckillo2', 'mguagli2', 'xzhng125', 'sang5', 'dszhu2', 'xxia10', 'mevtimo2', 'yhuan127', 'jhpham2', 'janavic2', 'enjucho2', 'ekisly2', 'neves2', 'yjeong12', 'elho2', 'sharpee2', 'conanlh2', 'aneeshj2', 'allenxg2', 'jgallen3', 'eehoneg2', 'mgambin2', 'tylerjj2', 'rpavone2', 'nim4', 'skomar4', 'shim35', 'zchen208', 'nycbside95', 'eugenep2', 'harryf2', 'rwlandi2', 'tidate2', 'clwhite5', 'atan14', 'vivo2', 'syer2', 'ahrtmnn2', 'pbehera2', 'reishac2', 'ajfrank3', 'eratta2', 'mjee3', None, 'zohair2', 'masiewi2', 'willwheelera', 'nkrshnn2', 'wtso2', 'jlee742', 'wendidc2', 'dylanb2', 'rfbruck2', 'jrgusta2']",85,"['wolan2', 'tson3', 'aokisang', 'mepaul2', 'zlevell2', 'liam.kenny96', 'jsshin3', 'ychen388', 'sarahrp2', 'talee3', 'emwisni2', 'bpbaile2', 'rhyu2', 'bdguo2', 'cisrael2', 'khuang47', 'jsharma3', 'clin101', 'jablowi2', 'saphknight', 'kperozek2', 'cplant2', 'kkim142', 'ab20', 'mtschro3', 'schoole2', 'mckillo2', 'mguagli2', 'xzhng125', 'jboo72390', 'sang5', 'wendi0522', 'dszhu2', 'xxia10', 'mevtimo2', 'yhuan127', 'jhpham2', 'janavic2', 'enjucho2', 'ekisly2', 'neves2', 'yjeong12', 'elho2', 'sharpee2', 'conanlh2', 'aneeshj2', 'allenxg2', 'jgallen3', 'eehoneg2', 'mgambin2', 'tylerjj2', 'rpavone2', 'nim4', 'skomar4', 'shim35', 'zchen208', 'nycbside95', 'eugenep2', 'harryf2', 'rwlandi2', 'tidate2', 'clwhite5', 'hyang89', 'atan14', 'vivo2', 'syer2', 'ahrtmnn2', 'pbehera2', 'jzhan142', 'reishac2', 'ajfrank3', 'eratta2', 'michael.p.gambino', 'mjee3', None, 'zohair2', 'masiewi2', 'willwheelera', 'nkrshnn2', 'wtso2', 'jlee742', 'wendidc2', 'dylanb2', 'rfbruck2', 'jrgusta2']"
122,292,8,20,7,"['bjz0310', 'das.sanchali26', 'sakidja', 'sabilakader', 'nirmal098', 'muztobarabbani', 'mdashifanwar']",0,[],13,"['rkhadka', 'rijankarkee', 'mikechem', 'shattiquemsu2018', 'rajankhadka882', 'jeremyloden', 'nazmulph39', 'ju94', 'alecgnn', 'bigtree', 'robert.mayanovic', 'tc0471992', None]",20,"['rkhadka', 'rijankarkee', 'shattiquemsu2018', 'rajankhadka882', 'jeremyloden', 'alecgnn', 'bigtree', 'robert.mayanovic', 'tc0471992', 'sabilakader', None, 'muztobarabbani', 'mdashifanwar', 'mikechem', 'nazmulph39', 'das.sanchali26', 'ju94', 'sakidja', 'nirmal098', 'bjz0310']"
122,84,8,13,7,"['bjz0310', 'das.sanchali26', 'sakidja', 'sabilakader', 'nirmal098', 'muztobarabbani', 'mdashifanwar']",0,[],6,"['rkhadka', 'rijankarkee', 'dhakal86', 'ju94', 'kartikghosh2008', None]",13,"['rkhadka', 'rijankarkee', 'dhakal86', 'kartikghosh2008', 'sabilakader', None, 'muztobarabbani', 'mdashifanwar', 'das.sanchali26', 'ju94', 'sakidja', 'nirmal098', 'bjz0310']"
122,295,8,12,7,"['bjz0310', 'das.sanchali26', 'sakidja', 'sabilakader', 'nirmal098', 'muztobarabbani', 'mdashifanwar']",0,[],5,"['rkhadka', 'rijankarkee', 'dhakal86', 'kartikghosh2008', None]",12,"['rkhadka', 'rijankarkee', 'dhakal86', 'kartikghosh2008', 'sabilakader', None, 'muztobarabbani', 'mdashifanwar', 'das.sanchali26', 'sakidja', 'nirmal098', 'bjz0310']"
127,310,7,17,6,"['mi.chan.820', 'thakr007', 'yuexx129', 'condo098', 'mill6749', 'chanx361']",0,[],11,"['patri220', 'santi164', 'mccla126', 'marks127', 'mcgra360', 'clar1471', 'obers032', 'elemi001', 'schib037', 'howar690', None]",17,"['patri220', 'marks127', 'mi.chan.820', 'obers032', 'condo098', 'chanx361', None, 'santi164', 'mccla126', 'mcgra360', 'schib037', 'thakr007', 'clar1471', 'yuexx129', 'elemi001', 'mill6749', 'howar690']"
128,272,7,12,1,['aagamshah999999999'],5,"['rohanshah611', 'tanvishah2410', 'parikhnisarg19', 'mohitrv30', 'doshipayal1996']",11,"['riteshrajput381', None, 'dollarboyhardik', 'vora.jai1', 'vaibhavvadia', 'patelmeeti1995', 'kush100', 'bhavana.djs19', 'nishant.joshi42', 'hardikganatra1806', 'karan.dhareshwar']",17,"['riteshrajput381', 'aagamshah999999999', 'patelmeeti1995', 'kush100', 'mohitrv30', None, 'doshipayal1996', 'karan.dhareshwar', 'dollarboyhardik', 'vora.jai1', 'rohanshah611', 'tanvishah2410', 'vaibhavvadia', 'parikhnisarg19', 'bhavana.djs19', 'nishant.joshi42', 'hardikganatra1806']"
128,273,7,9,5,"['rohanshah611', 'tanvishah2410', 'parikhnisarg19', 'mohitrv30', 'doshipayal1996']",1,['aagamshah999999999'],4,"[None, 'sankheneel', 'rakshandakhan38', 'helloworld1']",10,"['rohanshah611', 'helloworld1', 'tanvishah2410', 'rakshandakhan38', 'aagamshah999999999', 'parikhnisarg19', 'sankheneel', 'mohitrv30', None, 'doshipayal1996']"
129,187,7,8,6,"['goncalves.dias', 'bruno_h_b', 'nicolasvizarim', 'lucas.affonco', 'roberto.ramos', 'guilhermeslfabris']",0,[],2,"['olafvanterve', None]",8,"['goncalves.dias', 'olafvanterve', 'bruno_h_b', 'nicolasvizarim', 'lucas.affonco', 'roberto.ramos', 'guilhermeslfabris', None]"
131,276,7,90,3,"['vishalnaik.0210', 'apurvawaghmode14', 'shrey.joshi']",3,"['abhishekv.1100', 'sgharat297', 'rutvikstar']",87,"['rajeshree.kumbhar5018', 'ashishghoderao', 'sumitmhatre5670', 'ronak.tiwari', 'sanchitkad', 'rasikapotdar2108', 'aishuauti20496', 'adnan.s', 'ritik.singh', 'prerana.goythale', 'pandeydeepak825', 'shweta.joglekar', 'mounikajalla99', 'puranikatharva', 'bonhomie11', 'prathamesh.nikam', 'bhushan9321', 'harishkumar.n', 'sanketmane1997.sm', 'shirishparkhe', 'krunal.kasar', 'sendpost2mahesh', 'sid.jagtap1992', 'surbhib2897', 'shraddhasam78', 'richitapatil', 'yashuishwar', 'atul', 'paromita24', 'niveditachaudhari', 'mhatrenrupal42', 'neonargon5', 'ayesha.pathan', 'digvijayjadeja725', 'ninadmandavkar29', 'nehamallan', 'nishigandhaprsd14', 'rushikeshsalgar123', 'sahil709', 'ameyc007', 'neelamt', 'amarravade31', 'patiltejas000003', 'akshatamahajan47', 'yogeshmaurya50', 'gaurav.mishra', 'vivekrana', 'manjarekarchinmayeen', 'riddhi737', 'niharmasurkar', 'bhandarinirali57', 'bhagyashrimali280497', 'mihirgogri613', 'sarika_bukkawar', 'lekhakande', 'pratibhagawari28', 'nirav.lm', 'anitadey12', 'rohan.mestry', 'mayurgonbare22', 'dhavit.v', 'sumitpatil512', 'sonali.ramji', 'dleena19961209', 'maneaniket', 'siddheshgothankar', 'yuvraj.t', 'akshay1997bhagit', 'atulkokane1234', 'electronics209', 'raj.vadariya', 'trambakesh97', 'sarika', 'pritijha1996', 'bgharat713', 'mayank.vp', 'preethinaik', 'snehalpatil', 'rajesh05', None, 'shreyas.v', 'veronicathapa56', 'podililaxmi30', 'divyassingh56', 'shraddha.dhage', 'hborse28', 'mithilagajarmal']",93,"['rajeshree.kumbhar5018', 'ashishghoderao', 'sumitmhatre5670', 'ronak.tiwari', 'sanchitkad', 'rasikapotdar2108', 'aishuauti20496', 'adnan.s', 'ritik.singh', 'prerana.goythale', 'pandeydeepak825', 'shweta.joglekar', 'mounikajalla99', 'puranikatharva', 'bonhomie11', 'prathamesh.nikam', 'vishalnaik.0210', 'bhushan9321', 'harishkumar.n', 'sanketmane1997.sm', 'shirishparkhe', 'krunal.kasar', 'sendpost2mahesh', 'sid.jagtap1992', 'surbhib2897', 'shraddhasam78', 'richitapatil', 'yashuishwar', 'atul', 'paromita24', 'niveditachaudhari', 'mhatrenrupal42', 'neonargon5', 'ayesha.pathan', 'shrey.joshi', 'digvijayjadeja725', 'ninadmandavkar29', 'nehamallan', 'nishigandhaprsd14', 'rushikeshsalgar123', 'sahil709', 'ameyc007', 'neelamt', 'amarravade31', 'patiltejas000003', 'akshatamahajan47', 'yogeshmaurya50', 'gaurav.mishra', 'vivekrana', 'manjarekarchinmayeen', 'abhishekv.1100', 'riddhi737', 'apurvawaghmode14', 'niharmasurkar', 'bhandarinirali57', 'bhagyashrimali280497', 'mihirgogri613', 'sarika_bukkawar', 'lekhakande', 'pratibhagawari28', 'nirav.lm', 'anitadey12', 'rohan.mestry', 'mayurgonbare22', 'dhavit.v', 'sumitpatil512', 'sonali.ramji', 'dleena19961209', 'maneaniket', 'siddheshgothankar', 'yuvraj.t', 'akshay1997bhagit', 'atulkokane1234', 'electronics209', 'raj.vadariya', 'rutvikstar', 'trambakesh97', 'sarika', 'pritijha1996', 'bgharat713', 'mayank.vp', 'preethinaik', 'snehalpatil', 'rajesh05', None, 'shreyas.v', 'sgharat297', 'podililaxmi30', 'veronicathapa56', 'divyassingh56', 'shraddha.dhage', 'hborse28', 'mithilagajarmal']"
131,275,7,59,3,"['abhishekv.1100', 'sgharat297', 'rutvikstar']",3,"['vishalnaik.0210', 'apurvawaghmode14', 'shrey.joshi']",56,"['pranittambde', 'tejas7', 'siddhant319', 'ashishghoderao', 'divekarpragati7', 'divujagushte26', 'ngmahajan1', 'nimishakurup857', 'siddhu.murkar', 'sawardekarsuyash97', 'priyankaingle18', 'goreravindra95', 'bonhomie11', 'prasad.creativity123', 'chinmaysj96', 'narvekarsushant0', 'prasad24shingade', 'pratikpawar4996', 'tusharvan', 'sonali.ramji', 'salianyatish111', 'akshay1997bhagit', 'surbhib2897', 'amritamukeshb', 'sinalkarshweta5', 'jayshreepakhare63', 'santoshiparab11', 'snehaspm1397', 'sanketdamame', 'dkgupata9768522176', 'sayali_m9', 'priyaj1235', 'rohitwaghmare1997', 'siddhantwarankar', 'navneet.nrj', 'bhamghodke7', 'jr.abishek00', 'theindianpacifist', None, 'ameykokate2015', 'ranegirish24', 'shivanilohar55', 'pankajpawar1515', 'satsamjr', 'dipsbhalekar', 'vedankasalunke96', 'shirsekarakash', 'aartibhalerao29', 'k.vekhande69', 'kshemkalyanimanjiri11', 'rahul2011star', 'aniruddhaparte3', 'karishmahirve96', 'adityagudla96', 'madhuranasare', 'kavusatose123']",62,"['pranittambde', 'ashishghoderao', 'divujagushte26', 'ngmahajan1', 'nimishakurup857', 'priyankaingle18', 'goreravindra95', 'bonhomie11', 'vishalnaik.0210', 'tusharvan', 'salianyatish111', 'surbhib2897', 'jayshreepakhare63', 'siddhantwarankar', 'shrey.joshi', 'navneet.nrj', 'bhamghodke7', 'ameykokate2015', 'ranegirish24', 'shivanilohar55', 'pankajpawar1515', 'satsamjr', 'dipsbhalekar', 'aartibhalerao29', 'kshemkalyanimanjiri11', 'rahul2011star', 'aniruddhaparte3', 'karishmahirve96', 'kavusatose123', 'tejas7', 'siddhant319', 'divekarpragati7', 'abhishekv.1100', 'apurvawaghmode14', 'siddhu.murkar', 'sawardekarsuyash97', 'prasad.creativity123', 'chinmaysj96', 'narvekarsushant0', 'prasad24shingade', 'pratikpawar4996', 'sonali.ramji', 'akshay1997bhagit', 'amritamukeshb', 'sinalkarshweta5', 'santoshiparab11', 'snehaspm1397', 'sanketdamame', 'dkgupata9768522176', 'sayali_m9', 'rutvikstar', 'priyaj1235', 'rohitwaghmare1997', 'jr.abishek00', 'theindianpacifist', None, 'sgharat297', 'vedankasalunke96', 'shirsekarakash', 'k.vekhande69', 'adityagudla96', 'madhuranasare']"
132,5,7,9,2,"['billy888', 'baagii_homie']",4,"['manuel.pelayog', 'michal.swiniarski90', 'mttrch', 'mpurevdavaa']",7,"['davaanaa0101', None, 'bganaabganaa1998', 'nyamjantsan', 'n.batkaa', 'bulganbatjargal', 'x.ganerdene123']",13,"['davaanaa0101', None, 'baagii_homie', 'mpurevdavaa', 'bganaabganaa1998', 'manuel.pelayog', 'nyamjantsan', 'billy888', 'n.batkaa', 'bulganbatjargal', 'michal.swiniarski90', 'mttrch', 'x.ganerdene123']"
134,29,7,9,2,"['hemin.desai2017', 'priyada']",4,"['aparnasajeev', 'haidermoter2018', 'jay.kishorkumar2017', 'michelledsouza09']",7,"[None, 'rohit.sharma2017', 'smartkool002', 'shriswaroop', 'madangopalg', 'anzalnahamrah', 'aarthym']",13,"['hemin.desai2017', None, 'haidermoter2018', 'rohit.sharma2017', 'anzalnahamrah', 'jay.kishorkumar2017', 'aparnasajeev', 'smartkool002', 'shriswaroop', 'madangopalg', 'priyada', 'aarthym', 'michelledsouza09']"
134,30,7,8,3,"['priyada', 'jay.kishorkumar2017', 'michelledsouza09']",3,"['hemin.desai2017', 'aparnasajeev', 'haidermoter2018']",5,"['rohit.sharma2017', 'tandra23', 'madangopalg', None, 'r.jayakumar2017']",11,"['hemin.desai2017', None, 'haidermoter2018', 'tandra23', 'rohit.sharma2017', 'jay.kishorkumar2017', 'r.jayakumar2017', 'aparnasajeev', 'madangopalg', 'priyada', 'michelledsouza09']"
134,28,7,6,3,"['hemin.desai2017', 'priyada', 'jay.kishorkumar2017']",3,"['aparnasajeev', 'haidermoter2018', 'michelledsouza09']",3,"['jayadevkotipalli413', None, 'pradeep17mnt0013']",9,"['hemin.desai2017', None, 'haidermoter2018', 'pradeep17mnt0013', 'jay.kishorkumar2017', 'aparnasajeev', 'jayadevkotipalli413', 'priyada', 'michelledsouza09']"
135,85,7,85,2,"['eratta2', 'schoole2']",4,"['mksatti11122122', 'robertandrawis', 'pb621931', 'jack.limate']",83,"['wolan2', 'tson3', 'aokisang', 'mepaul2', 'zlevell2', 'liam.kenny96', 'jsshin3', 'ychen388', 'sarahrp2', 'talee3', 'emwisni2', 'bpbaile2', 'rhyu2', 'bdguo2', 'cisrael2', 'khuang47', 'jsharma3', 'clin101', 'jablowi2', 'saphknight', 'kperozek2', 'cplant2', 'kkim142', 'ab20', 'mtschro3', 'mckillo2', 'mguagli2', 'xzhng125', 'jboo72390', 'sang5', 'wendi0522', 'dszhu2', 'xxia10', 'mevtimo2', 'yhuan127', 'jhpham2', 'janavic2', 'enjucho2', 'ekisly2', 'neves2', 'yjeong12', 'elho2', 'sharpee2', 'conanlh2', 'aneeshj2', 'allenxg2', 'jgallen3', 'eehoneg2', 'mgambin2', 'tylerjj2', 'rpavone2', 'nim4', 'skomar4', 'shim35', 'zchen208', 'nycbside95', 'eugenep2', 'harryf2', 'rwlandi2', 'tidate2', 'clwhite5', 'hyang89', 'atan14', 'vivo2', 'syer2', 'ahrtmnn2', 'pbehera2', 'jzhan142', 'reishac2', 'ajfrank3', 'michael.p.gambino', 'mjee3', None, 'zohair2', 'masiewi2', 'willwheelera', 'nkrshnn2', 'wtso2', 'jlee742', 'wendidc2', 'dylanb2', 'rfbruck2', 'jrgusta2']",89,"['wolan2', 'tson3', 'aokisang', 'mepaul2', 'zlevell2', 'liam.kenny96', 'jsshin3', 'ychen388', 'sarahrp2', 'talee3', 'emwisni2', 'bpbaile2', 'mksatti11122122', 'rhyu2', 'bdguo2', 'cisrael2', 'khuang47', 'jsharma3', 'clin101', 'jablowi2', 'saphknight', 'kperozek2', 'cplant2', 'kkim142', 'ab20', 'mtschro3', 'schoole2', 'mckillo2', 'mguagli2', 'xzhng125', 'jboo72390', 'sang5', 'wendi0522', 'dszhu2', 'xxia10', 'mevtimo2', 'yhuan127', 'jhpham2', 'janavic2', 'robertandrawis', 'enjucho2', 'ekisly2', 'neves2', 'yjeong12', 'elho2', 'sharpee2', 'jack.limate', 'conanlh2', 'aneeshj2', 'allenxg2', 'jgallen3', 'eehoneg2', 'mgambin2', 'tylerjj2', 'rpavone2', 'nim4', 'skomar4', 'shim35', 'zchen208', 'nycbside95', 'eugenep2', 'harryf2', 'rwlandi2', 'tidate2', 'clwhite5', 'hyang89', 'atan14', 'vivo2', 'syer2', 'ahrtmnn2', 'pbehera2', 'jzhan142', 'reishac2', 'pb621931', 'ajfrank3', 'eratta2', 'michael.p.gambino', 'mjee3', None, 'zohair2', 'masiewi2', 'willwheelera', 'nkrshnn2', 'wtso2', 'jlee742', 'wendidc2', 'dylanb2', 'rfbruck2', 'jrgusta2']"
136,99,7,17,5,"['wu801', 'saldwin', 'dinino', 'zhan2536', 'dtisdale']",1,['mitch171'],12,"['tgoldbe', None, 'pangn', 'kkurpius', 'mbanerje', 'mill1914', 'dbradbu', 'iaranadi', 'rleather', 'petrosky', 'rmaccion', 'akunzman']",18,"['pangn', 'mill1914', 'dbradbu', 'rleather', 'petrosky', 'rmaccion', 'mbanerje', None, 'tgoldbe', 'kkurpius', 'wu801', 'saldwin', 'dinino', 'zhan2536', 'dtisdale', 'iaranadi', 'mitch171', 'akunzman']"
136,101,7,7,3,"['dtisdale', 'saldwin', 'dinino']",3,"['wu801', 'mitch171', 'zhan2536']",4,"['owellbor', 'dbradbu', 'tarabear1313', None]",10,"['owellbor', 'tarabear1313', 'wu801', 'saldwin', 'dinino', 'zhan2536', 'dtisdale', 'dbradbu', 'mitch171', None]"
136,102,7,6,1,['zhan2536'],5,"['wu801', 'saldwin', 'dinino', 'dtisdale', 'mitch171']",5,"['evelezca', 'mklingse', 'kline40', 'hong224', None]",11,"['evelezca', 'mklingse', 'wu801', 'saldwin', 'kline40', 'dinino', 'zhan2536', 'dtisdale', 'hong224', 'mitch171', None]"
137,242,7,7,6,"['deepikapal', 'gokuljaiswal', 'alba369', 'sudhamaurya', 'sofikgn786', 'rukhmanirai']",0,[],1,[None],7,"['deepikapal', 'gokuljaiswal', 'alba369', 'sudhamaurya', 'sofikgn786', None, 'rukhmanirai']"
141,151,7,7,6,"['jk083', 'soccerpain', 'cjh9412', 'jsbang56', 'chelung66', 'hj0110']",0,[],1,[None],7,"['jsbang56', 'soccerpain', 'cjh9412', 'jk083', 'chelung66', 'hj0110', None]"
142,104,7,93,6,"['vradkar', 'vkattaku', 'vdharman', 'tanayadhikary', 'tadhika', 'kbandar']",0,[],87,"['jeanpierre1030', 'harshit03sep', 'rheiland', 'desai61', 'yjzhuang5', 'liu1947', 'ddmckay', 'trezitorul', 'siddharthpantoji22', 'huntmartinm', 'titus9', 'denphi', 'taeksanglee', 'sabareesh169', 'ych0580', 'xiaoli94', 'soto27', 'naik.pratik', 'kristiaan2017', 'rahuldeshmukh', 'proycho', 'paul91', 'sahu2', 'yang1489', 'zhan2283', 'maathangi95', 'pgurunat', 'tsimon', 'sreeve', 'pdressma', 'azadoks', 'rex07040058', 'huang706', 'abhivictor2', 'cfrist', 'jiang556', 'sukirtthakur', 'paul54', 'jasakadu', 'sachadervi', 'yang924', 'transegn1', 'nthung', 'ziyang', 'mmh', 'pmeunier', 'psiripur', 'kogunsin', 'han289', 'zhou646', 'abiniwa', 'lalzatev', 'krane', 'jhartl', 'ouyang16', 'kcruse2', 'mjokar', 'nmsnodgr', 'huang714', 'yang1087', 'bphnano', 'anjulvyas', 'prachi19', 'jthekine', 'zhao830', 'paulmather', 'mrajase', 'mathcancer', 'rbritwik22', 'franciscolozano', 'tian50', 'jsqdcsq', 'lu500', 'rohitkt10', 'wen', 'unitas', 'gjhanwar', 'davidjohnson', 'mademoiselle0812', 'msakariy', 'xliu123', 'dadams', 'bhaley', 'zhangshengsunny', 'jrudolp', 'xiaolongyang1990', 'adervise']",93,"['jeanpierre1030', 'harshit03sep', 'rheiland', 'desai61', 'yjzhuang5', 'liu1947', 'ddmckay', 'trezitorul', 'siddharthpantoji22', 'vkattaku', 'huntmartinm', 'titus9', 'denphi', 'taeksanglee', 'sabareesh169', 'ych0580', 'xiaoli94', 'soto27', 'naik.pratik', 'kristiaan2017', 'rahuldeshmukh', 'vdharman', 'proycho', 'paul91', 'sahu2', 'yang1489', 'zhan2283', 'maathangi95', 'pgurunat', 'tsimon', 'sreeve', 'pdressma', 'azadoks', 'rex07040058', 'huang706', 'abhivictor2', 'tadhika', 'cfrist', 'jiang556', 'sukirtthakur', 'paul54', 'jasakadu', 'tanayadhikary', 'sachadervi', 'yang924', 'transegn1', 'nthung', 'ziyang', 'mmh', 'pmeunier', 'psiripur', 'kogunsin', 'han289', 'zhou646', 'abiniwa', 'lalzatev', 'krane', 'jhartl', 'ouyang16', 'kcruse2', 'mjokar', 'nmsnodgr', 'huang714', 'yang1087', 'bphnano', 'anjulvyas', 'prachi19', 'jthekine', 'kbandar', 'zhao830', 'paulmather', 'vradkar', 'mrajase', 'mathcancer', 'rbritwik22', 'franciscolozano', 'tian50', 'jsqdcsq', 'lu500', 'rohitkt10', 'wen', 'unitas', 'gjhanwar', 'davidjohnson', 'mademoiselle0812', 'msakariy', 'xliu123', 'dadams', 'bhaley', 'zhangshengsunny', 'jrudolp', 'xiaolongyang1990', 'adervise']"
145,104,6,93,5,"['mrajase', 'tian50', 'jiang556', 'pdressma', 'huang706']",0,[],88,"['jeanpierre1030', 'harshit03sep', 'rheiland', 'desai61', 'yjzhuang5', 'liu1947', 'ddmckay', 'trezitorul', 'siddharthpantoji22', 'vkattaku', 'huntmartinm', 'titus9', 'denphi', 'taeksanglee', 'sabareesh169', 'ych0580', 'xiaoli94', 'soto27', 'naik.pratik', 'kristiaan2017', 'rahuldeshmukh', 'proycho', 'vdharman', 'paul91', 'sahu2', 'yang1489', 'zhan2283', 'maathangi95', 'pgurunat', 'tsimon', 'sreeve', 'azadoks', 'rex07040058', 'abhivictor2', 'tadhika', 'cfrist', 'sukirtthakur', 'paul54', 'jasakadu', 'tanayadhikary', 'sachadervi', 'yang924', 'transegn1', 'nthung', 'ziyang', 'mmh', 'pmeunier', 'psiripur', 'kogunsin', 'han289', 'zhou646', 'abiniwa', 'lalzatev', 'krane', 'jhartl', 'ouyang16', 'kcruse2', 'mjokar', 'nmsnodgr', 'huang714', 'yang1087', 'bphnano', 'anjulvyas', 'prachi19', 'jthekine', 'zhao830', 'kbandar', 'paulmather', 'vradkar', 'mathcancer', 'rbritwik22', 'franciscolozano', 'jsqdcsq', 'lu500', 'rohitkt10', 'wen', 'unitas', 'gjhanwar', 'davidjohnson', 'mademoiselle0812', 'msakariy', 'xliu123', 'dadams', 'bhaley', 'zhangshengsunny', 'jrudolp', 'xiaolongyang1990', 'adervise']",93,"['jeanpierre1030', 'harshit03sep', 'rheiland', 'desai61', 'yjzhuang5', 'liu1947', 'ddmckay', 'trezitorul', 'siddharthpantoji22', 'vkattaku', 'huntmartinm', 'titus9', 'denphi', 'taeksanglee', 'sabareesh169', 'ych0580', 'xiaoli94', 'soto27', 'naik.pratik', 'kristiaan2017', 'rahuldeshmukh', 'proycho', 'vdharman', 'paul91', 'sahu2', 'yang1489', 'zhan2283', 'maathangi95', 'pgurunat', 'tsimon', 'sreeve', 'pdressma', 'azadoks', 'rex07040058', 'huang706', 'abhivictor2', 'tadhika', 'cfrist', 'jiang556', 'sukirtthakur', 'paul54', 'jasakadu', 'tanayadhikary', 'sachadervi', 'yang924', 'transegn1', 'nthung', 'ziyang', 'mmh', 'pmeunier', 'psiripur', 'kogunsin', 'han289', 'zhou646', 'abiniwa', 'lalzatev', 'krane', 'jhartl', 'ouyang16', 'kcruse2', 'mjokar', 'nmsnodgr', 'huang714', 'yang1087', 'bphnano', 'anjulvyas', 'prachi19', 'jthekine', 'zhao830', 'kbandar', 'paulmather', 'mrajase', 'vradkar', 'mathcancer', 'rbritwik22', 'franciscolozano', 'tian50', 'jsqdcsq', 'lu500', 'rohitkt10', 'wen', 'unitas', 'gjhanwar', 'davidjohnson', 'mademoiselle0812', 'msakariy', 'xliu123', 'dadams', 'bhaley', 'zhangshengsunny', 'jrudolp', 'xiaolongyang1990', 'adervise']"
149,67,6,16,4,"['akshaymane1296', 'nehal.jahagirdar', 'mihir.joshi', 'rushabh.patil']",1,['rahul.yadav'],12,"['ssw10j', 'poojathorat157', 'siddharth.mundada', 'et2012.tejas.patil', 'ie2012.advait.mohile', 'darshana.mahajan', 'ie2012.krishna.paryani', 'ssonali_21', 'shaanigwwass2', 'rhlklwr', None, 'supriya.palve']",17,"['ssw10j', 'poojathorat157', 'et2012.tejas.patil', 'darshana.mahajan', 'ie2012.krishna.paryani', 'rushabh.patil', 'ssonali_21', 'shaanigwwass2', None, 'mihir.joshi', 'rahul.yadav', 'siddharth.mundada', 'ie2012.advait.mohile', 'nehal.jahagirdar', 'rhlklwr', 'akshaymane1296', 'supriya.palve']"
149,66,6,10,1,['rahul.yadav'],4,"['akshaymane1296', 'nehal.jahagirdar', 'mihir.joshi', 'rushabh.patil']",9,"['sahil.tasgavkar', 'gayatri.devadiga', 'poojathorat157', 'pawan.sukhwani', 'prachi.shinde', 'ssonali_21', 'mayur_sn', None, 'sunny23']",14,"['sahil.tasgavkar', 'gayatri.devadiga', 'mihir.joshi', 'rahul.yadav', 'poojathorat157', 'pawan.sukhwani', 'prachi.shinde', 'nehal.jahagirdar', 'ssonali_21', 'rushabh.patil', 'mayur_sn', 'akshaymane1296', None, 'sunny23']"
150,131,6,11,4,"['sagarnm308', 'komalmahajan1197', 'komal2015patil', 'yash.shirke9623']",1,['ambika19patted'],7,"['saumipadeer', 'thestellarguy', 'saketdpandey1', 'virajsanghvicool09', None, 'sanjeevanichaudhari999', 'sahilanande96']",12,"['saketdpandey1', 'komal2015patil', 'virajsanghvicool09', 'sagarnm308', 'komalmahajan1197', None, 'sanjeevanichaudhari999', 'yash.shirke9623', 'saumipadeer', 'thestellarguy', 'ambika19patted', 'sahilanande96']"
150,135,6,10,1,['sagarnm308'],4,"['ambika19patted', 'komalmahajan1197', 'komal2015patil', 'yash.shirke9623']",9,"['adityamhatre68', None, 'saumipadeer', 'dalaiashmita97', 'satyanarayanpande', 'virajsanghvi09', 'jheelnagaria', 'pathakshubham17', 'dharan_shah']",14,"['adityamhatre68', None, 'saumipadeer', 'dalaiashmita97', 'komal2015patil', 'satyanarayanpande', 'ambika19patted', 'sagarnm308', 'virajsanghvi09', 'jheelnagaria', 'komalmahajan1197', 'pathakshubham17', 'dharan_shah', 'yash.shirke9623']"
151,241,6,6,4,"['14.nt.mital.nanda', 'sam942870', 'jivanisweta2014', 'jaypala']",1,['14.nt.zalak.bhut'],2,"['monika.bhuva97', None]",7,"['14.nt.mital.nanda', 'jaypala', 'monika.bhuva97', '14.nt.zalak.bhut', 'jivanisweta2014', None, 'sam942870']"
152,6,6,9,3,"['zulaa95', 'davaa23', 'b.byambadorj']",2,"['lez94', 'parishok']",6,"['davaanaa0101', 'bz_5657', 'n.batkaa', 'davaanaa010101', None, 'x.ganerdene123']",11,"['lez94', 'zulaa95', 'davaanaa0101', 'davaa23', 'bz_5657', 'parishok', 'n.batkaa', 'davaanaa010101', None, 'x.ganerdene123', 'b.byambadorj']"
155,276,6,90,1,['bgharat713'],4,"['narvekarsushant0', 'priyankaingle18', 'dkgupata9768522176', 'siddhant319']",89,"['rajeshree.kumbhar5018', 'ashishghoderao', 'sumitmhatre5670', 'ronak.tiwari', 'sanchitkad', 'rasikapotdar2108', 'aishuauti20496', 'adnan.s', 'ritik.singh', 'prerana.goythale', 'pandeydeepak825', 'shweta.joglekar', 'mounikajalla99', 'puranikatharva', 'bonhomie11', 'prathamesh.nikam', 'bhushan9321', 'vishalnaik.0210', 'harishkumar.n', 'sanketmane1997.sm', 'shirishparkhe', 'krunal.kasar', 'sendpost2mahesh', 'sid.jagtap1992', 'surbhib2897', 'shraddhasam78', 'richitapatil', 'yashuishwar', 'atul', 'paromita24', 'niveditachaudhari', 'mhatrenrupal42', 'neonargon5', 'ayesha.pathan', 'digvijayjadeja725', 'shrey.joshi', 'ninadmandavkar29', 'nehamallan', 'nishigandhaprsd14', 'rushikeshsalgar123', 'sahil709', 'ameyc007', 'neelamt', 'amarravade31', 'patiltejas000003', 'akshatamahajan47', 'yogeshmaurya50', 'gaurav.mishra', 'vivekrana', 'manjarekarchinmayeen', 'riddhi737', 'niharmasurkar', 'apurvawaghmode14', 'bhandarinirali57', 'bhagyashrimali280497', 'mihirgogri613', 'sarika_bukkawar', 'lekhakande', 'pratibhagawari28', 'nirav.lm', 'anitadey12', 'rohan.mestry', 'mayurgonbare22', 'dhavit.v', 'sumitpatil512', 'sonali.ramji', 'dleena19961209', 'maneaniket', 'siddheshgothankar', 'yuvraj.t', 'akshay1997bhagit', 'atulkokane1234', 'electronics209', 'raj.vadariya', 'trambakesh97', 'sarika', 'pritijha1996', 'mayank.vp', 'preethinaik', 'snehalpatil', 'rajesh05', None, 'shreyas.v', 'veronicathapa56', 'podililaxmi30', 'divyassingh56', 'shraddha.dhage', 'hborse28', 'mithilagajarmal']",94,"['rajeshree.kumbhar5018', 'ashishghoderao', 'sumitmhatre5670', 'ronak.tiwari', 'sanchitkad', 'rasikapotdar2108', 'aishuauti20496', 'adnan.s', 'ritik.singh', 'prerana.goythale', 'pandeydeepak825', 'priyankaingle18', 'shweta.joglekar', 'mounikajalla99', 'puranikatharva', 'bonhomie11', 'prathamesh.nikam', 'bhushan9321', 'vishalnaik.0210', 'harishkumar.n', 'sanketmane1997.sm', 'shirishparkhe', 'krunal.kasar', 'sendpost2mahesh', 'sid.jagtap1992', 'surbhib2897', 'shraddhasam78', 'richitapatil', 'yashuishwar', 'atul', 'paromita24', 'niveditachaudhari', 'mhatrenrupal42', 'neonargon5', 'ayesha.pathan', 'digvijayjadeja725', 'shrey.joshi', 'ninadmandavkar29', 'nehamallan', 'nishigandhaprsd14', 'rushikeshsalgar123', 'sahil709', 'ameyc007', 'neelamt', 'amarravade31', 'patiltejas000003', 'akshatamahajan47', 'yogeshmaurya50', 'gaurav.mishra', 'siddhant319', 'vivekrana', 'manjarekarchinmayeen', 'riddhi737', 'niharmasurkar', 'apurvawaghmode14', 'bhandarinirali57', 'bhagyashrimali280497', 'mihirgogri613', 'sarika_bukkawar', 'lekhakande', 'pratibhagawari28', 'nirav.lm', 'anitadey12', 'rohan.mestry', 'mayurgonbare22', 'narvekarsushant0', 'dhavit.v', 'sumitpatil512', 'sonali.ramji', 'dleena19961209', 'maneaniket', 'siddheshgothankar', 'yuvraj.t', 'akshay1997bhagit', 'atulkokane1234', 'electronics209', 'dkgupata9768522176', 'raj.vadariya', 'trambakesh97', 'sarika', 'bgharat713', 'pritijha1996', 'mayank.vp', 'preethinaik', 'snehalpatil', 'rajesh05', None, 'shreyas.v', 'veronicathapa56', 'podililaxmi30', 'divyassingh56', 'shraddha.dhage', 'hborse28', 'mithilagajarmal']"
155,269,6,75,1,['bgharat713'],4,"['narvekarsushant0', 'priyankaingle18', 'dkgupata9768522176', 'siddhant319']",74,"['rajeshree.kumbhar5018', 'palakchheda2407', 'mbhosale863', 'ashishghoderao', 'sumitmhatre5670', 'ashwinipardeshi702', 'ronak.tiwari', 'sanchitkad', 'rasikapotdar2108', 'aishuauti20496', 'pandeydeepak825', 'puranikatharva', 'prathamesh.nikam', 'bhushan9321', 'adityagudla96', 'sid.jagtap1992', 'sendpost2mahesh', 'surbhib2897', 'shraddhasam78', 'jayshreepakhare63', 'atul', 'bolekunal42', 'mhatrenrupal42', 'neonargon5', 'ayesha.pathan', 'ninadmandavkar29', 'abhishek2397', 'nishigandhaprsd14', 'bhaveshsawant1996', 'rushikeshsalgar123', 'sahil709', 'dusty', 'neelamt', 'sudar', 'shreekantrasam69', 'yogeshmaurya50', 'kavusatose123', 'manjarekarchinmayeen', 'riddhi737', 'niharmasurkar', 'bhandarinirali57', 'mihirgogri613', 'lekhakande', 'pratibhagawari28', 'ab17', 'anitadey12', 'mayurgonbare22', 'sumitpatil512', 'sonali.ramji', 'maneaniket', 'siddheshgothankar', 'dleena19961209', 'abhijaypandey', 'dilip.wakdikar', 'trambakesh97', 'riyakulkarni16021997', 'brarath.nihal', 'pritijha1996', 'preethinaik', 'ganeshjadhav', 'sanket.mane', 'snehalpatil', 'rajesh05', 'ksanket025', None, 'rahul.sawant', 's.arutwar', 'veronicathapa56', 'prashant.khedkar', 'vishal8244', 'shraddha.dhage', 'hborse28', 'ganesh.mali', 'mithilagajarmal']",79,"['rajeshree.kumbhar5018', 'palakchheda2407', 'mbhosale863', 'ashishghoderao', 'sumitmhatre5670', 'ashwinipardeshi702', 'ronak.tiwari', 'sanchitkad', 'rasikapotdar2108', 'aishuauti20496', 'pandeydeepak825', 'priyankaingle18', 'puranikatharva', 'prathamesh.nikam', 'bhushan9321', 'adityagudla96', 'sid.jagtap1992', 'sendpost2mahesh', 'surbhib2897', 'shraddhasam78', 'jayshreepakhare63', 'atul', 'bolekunal42', 'mhatrenrupal42', 'neonargon5', 'ayesha.pathan', 'ninadmandavkar29', 'abhishek2397', 'nishigandhaprsd14', 'bhaveshsawant1996', 'rushikeshsalgar123', 'sahil709', 'dusty', 'neelamt', 'sudar', 'shreekantrasam69', 'yogeshmaurya50', 'kavusatose123', 'siddhant319', 'manjarekarchinmayeen', 'riddhi737', 'niharmasurkar', 'bhandarinirali57', 'mihirgogri613', 'lekhakande', 'pratibhagawari28', 'ab17', 'anitadey12', 'mayurgonbare22', 'narvekarsushant0', 'sumitpatil512', 'sonali.ramji', 'maneaniket', 'siddheshgothankar', 'dleena19961209', 'abhijaypandey', 'dkgupata9768522176', 'dilip.wakdikar', 'trambakesh97', 'riyakulkarni16021997', 'bgharat713', 'brarath.nihal', 'pritijha1996', 'preethinaik', 'ganeshjadhav', 'sanket.mane', 'snehalpatil', 'rajesh05', 'ksanket025', None, 'rahul.sawant', 's.arutwar', 'veronicathapa56', 'prashant.khedkar', 'vishal8244', 'shraddha.dhage', 'hborse28', 'ganesh.mali', 'mithilagajarmal']"
155,275,6,59,4,"['narvekarsushant0', 'priyankaingle18', 'dkgupata9768522176', 'siddhant319']",1,['bgharat713'],55,"['pranittambde', 'tejas7', 'ashishghoderao', 'divekarpragati7', 'abhishekv.1100', 'divujagushte26', 'ngmahajan1', 'nimishakurup857', 'siddhu.murkar', 'sawardekarsuyash97', 'goreravindra95', 'bonhomie11', 'prasad.creativity123', 'chinmaysj96', 'prasad24shingade', 'pratikpawar4996', 'tusharvan', 'sonali.ramji', 'salianyatish111', 'akshay1997bhagit', 'surbhib2897', 'amritamukeshb', 'sinalkarshweta5', 'jayshreepakhare63', 'santoshiparab11', 'snehaspm1397', 'sanketdamame', 'sayali_m9', 'rutvikstar', 'priyaj1235', 'rohitwaghmare1997', 'siddhantwarankar', 'navneet.nrj', 'bhamghodke7', 'jr.abishek00', 'theindianpacifist', None, 'ameykokate2015', 'ranegirish24', 'shivanilohar55', 'pankajpawar1515', 'sgharat297', 'satsamjr', 'dipsbhalekar', 'vedankasalunke96', 'shirsekarakash', 'aartibhalerao29', 'k.vekhande69', 'kshemkalyanimanjiri11', 'rahul2011star', 'aniruddhaparte3', 'karishmahirve96', 'adityagudla96', 'madhuranasare', 'kavusatose123']",60,"['pranittambde', 'ashishghoderao', 'divujagushte26', 'ngmahajan1', 'nimishakurup857', 'priyankaingle18', 'goreravindra95', 'bonhomie11', 'tusharvan', 'salianyatish111', 'surbhib2897', 'jayshreepakhare63', 'siddhantwarankar', 'navneet.nrj', 'bhamghodke7', 'ameykokate2015', 'ranegirish24', 'shivanilohar55', 'pankajpawar1515', 'satsamjr', 'dipsbhalekar', 'aartibhalerao29', 'kshemkalyanimanjiri11', 'rahul2011star', 'aniruddhaparte3', 'karishmahirve96', 'kavusatose123', 'tejas7', 'siddhant319', 'divekarpragati7', 'abhishekv.1100', 'siddhu.murkar', 'sawardekarsuyash97', 'prasad.creativity123', 'chinmaysj96', 'narvekarsushant0', 'prasad24shingade', 'pratikpawar4996', 'sonali.ramji', 'akshay1997bhagit', 'amritamukeshb', 'sinalkarshweta5', 'santoshiparab11', 'snehaspm1397', 'sanketdamame', 'dkgupata9768522176', 'sayali_m9', 'rutvikstar', 'priyaj1235', 'rohitwaghmare1997', 'bgharat713', 'jr.abishek00', 'theindianpacifist', None, 'sgharat297', 'vedankasalunke96', 'shirsekarakash', 'k.vekhande69', 'adityagudla96', 'madhuranasare']"
155,268,6,42,4,"['narvekarsushant0', 'priyankaingle18', 'dkgupata9768522176', 'siddhant319']",1,['bgharat713'],38,"['pranittambde', 'tejas7', 'sarvesh107', 'siddhu.murkar', 'sawardekarsuyash97', 'mounikajalla99', 'shreya9609', 'goreravindra95', 'bonhomie11', 'chinmaysj96', 'prasad24shingade', 'pratikpawar4996', 'tusharvan', 'sonali.ramji', 'salianyatish111', 'surbhib2897', 'amritamukeshb', 'sinalkarshweta5', 'santoshiparab11', 'snehaspm1397', 'siddhantwarankar', 'vrushalithakare82', 'navneet.nrj', 'bhamghodke7', 'jr.abishek00', None, 'shivanilohar55', 'ranegirish24', 'pankajpawar1515', 'satsamjr', 'vedankasalunke96', 'shirsekarakash', 'aartibhalerao29', 'vinayak183', 'rahul2011star', 'aniruddhaparte3', 'adityagudla96', 'kavusatose123']",43,"['pranittambde', 'tejas7', 'siddhant319', 'sarvesh107', 'siddhu.murkar', 'sawardekarsuyash97', 'priyankaingle18', 'mounikajalla99', 'shreya9609', 'goreravindra95', 'bonhomie11', 'chinmaysj96', 'narvekarsushant0', 'prasad24shingade', 'pratikpawar4996', 'tusharvan', 'sonali.ramji', 'salianyatish111', 'surbhib2897', 'amritamukeshb', 'sinalkarshweta5', 'santoshiparab11', 'snehaspm1397', 'dkgupata9768522176', 'siddhantwarankar', 'bgharat713', 'vrushalithakare82', 'navneet.nrj', 'bhamghodke7', 'jr.abishek00', None, 'shivanilohar55', 'ranegirish24', 'pankajpawar1515', 'satsamjr', 'vedankasalunke96', 'shirsekarakash', 'aartibhalerao29', 'vinayak183', 'rahul2011star', 'aniruddhaparte3', 'adityagudla96', 'kavusatose123']"
155,284,6,7,4,"['narvekarsushant0', 'priyankaingle18', 'dkgupata9768522176', 'siddhant319']",1,['bgharat713'],3,"['ranegirish24', None, 'satsamjr']",8,"['ranegirish24', 'dkgupata9768522176', 'satsamjr', 'siddhant319', 'narvekarsushant0', 'bgharat713', None, 'priyankaingle18']"
156,237,6,6,5,"['rutujakadam610', 'nikhiljambhale28', 'umshirole', 'sandeep.phadke16', 'dhirajhire69']",0,[],1,[None],6,"['rutujakadam610', 'nikhiljambhale28', 'umshirole', 'sandeep.phadke16', None, 'dhirajhire69']"
159,299,6,15,4,"['jmarion', 'jjgullet', 'edelder', 'emmanuel06']",1,['ralfniemand'],11,"[None, 'bshawki2', 'nmurphy2', 'jeboehle', 'evjucov', 'cmkey', 'pwwagner', 'mjavakia', 'abcallan', 'meskelto', 'bhnestvo']",16,"['emmanuel06', 'jeboehle', 'nmurphy2', 'evjucov', 'jjgullet', 'edelder', 'jmarion', 'mjavakia', None, 'meskelto', 'bshawki2', 'cmkey', 'pwwagner', 'ralfniemand', 'abcallan', 'bhnestvo']"
162,272,6,12,1,['kush100'],4,"['malay123', 'mehtadevanshi21', 'hinal.shah999', 'jinitarathod97']",11,"['riteshrajput381', None, 'dollarboyhardik', 'vora.jai1', 'aagamshah999999999', 'vaibhavvadia', 'patelmeeti1995', 'bhavana.djs19', 'nishant.joshi42', 'hardikganatra1806', 'karan.dhareshwar']",16,"['riteshrajput381', 'hinal.shah999', 'aagamshah999999999', 'patelmeeti1995', 'kush100', 'jinitarathod97', None, 'karan.dhareshwar', 'malay123', 'dollarboyhardik', 'vora.jai1', 'hardikganatra1806', 'vaibhavvadia', 'bhavana.djs19', 'nishant.joshi42', 'mehtadevanshi21']"
163,158,6,12,5,"['mpejinov', 'matijapiskacimp', 'nklobucar', 'jajtict', 'prusinakatarina']",0,[],7,"['krozman93', 'dora.vnucec', 'denny.shaikh', 'yashamon', 'luka18.mikoc', None, 'ivanjkv']",12,"['mpejinov', 'denny.shaikh', 'luka18.mikoc', 'jajtict', None, 'krozman93', 'dora.vnucec', 'matijapiskacimp', 'yashamon', 'nklobucar', 'prusinakatarina', 'ivanjkv']"
163,309,6,12,5,"['mpejinov', 'matijapiskacimp', 'nklobucar', 'jajtict', 'prusinakatarina']",0,[],7,"['krozman93', 'dora.vnucec', 'denny.shaikh', 'yashamon', 'luka18.mikoc', None, 'ivanjkv']",12,"['mpejinov', 'denny.shaikh', 'luka18.mikoc', 'jajtict', None, 'krozman93', 'dora.vnucec', 'matijapiskacimp', 'yashamon', 'nklobucar', 'prusinakatarina', 'ivanjkv']"
166,109,6,24,1,['gmkershaw'],4,"['keafechen', 'elireber', 'chan161', 'marianars013']",23,"['desai61', 'mmh', 'pgurunat', 'dbenham', 'kpgreenm', 'mill1914', 'huntmartinm', 'jhartl', None, 'denphi', 'sabareesh169', 'zooley', 'unitas', 'gavinbcarter4', 'valeriagrilloa', 'patkip', 'kristiaan2017', 'bradchoi343', 'valencid', 'adervise', 'marquarj', 'lpl', 'tpownell']",28,"['desai61', 'mmh', 'pgurunat', 'dbenham', 'kpgreenm', 'mill1914', 'chan161', 'elireber', 'huntmartinm', 'jhartl', None, 'denphi', 'sabareesh169', 'zooley', 'unitas', 'gavinbcarter4', 'valeriagrilloa', 'patkip', 'kristiaan2017', 'bradchoi343', 'marianars013', 'keafechen', 'valencid', 'adervise', 'marquarj', 'gmkershaw', 'lpl', 'tpownell']"
166,335,6,7,1,['marianars013'],4,"['keafechen', 'chan161', 'gmkershaw', 'elireber']",6,"['rafatulfaria', None, 'kpgreenm', 'apps', 'zhu603', 'kngo1207']",11,"['rafatulfaria', None, 'kpgreenm', 'marianars013', 'keafechen', 'apps', 'zhu603', 'chan161', 'elireber', 'gmkershaw', 'kngo1207']"
168,46,6,24,4,"['xiaomengliu', 'dchitkara', 'sheringeorge', 'acalambur']",1,['mmansouree'],20,"['hongyangao', 'mtorfeh', 'aksamija', 'nazanintakbiri', 'pfang', 'ravichan', 'edward8324', 'fairytail', 'bmirzapouebe', 'edward83241994', 'fatemehkiani', None, 'sayandas', 'zzou', 'aliyaqureshi', 'babak.mirzapour', 'abanagozar', 'srini999', 'spalani', 'awaingade']",25,"['hongyangao', 'dchitkara', 'mtorfeh', 'aksamija', 'nazanintakbiri', 'pfang', 'ravichan', 'edward8324', 'fairytail', 'bmirzapouebe', 'sheringeorge', 'edward83241994', 'fatemehkiani', 'mmansouree', 'xiaomengliu', None, 'sayandas', 'zzou', 'aliyaqureshi', 'babak.mirzapour', 'acalambur', 'abanagozar', 'srini999', 'spalani', 'awaingade']"
168,110,6,21,3,"['mmansouree', 'dchitkara', 'sheringeorge']",2,"['xiaomengliu', 'acalambur']",18,"['hongyangao', 'mtorfeh', 'nazanintakbiri', 'jgarchali', 'aliyaqureshi', 'ravichan', 'zzou', 'edward8324', 'fairytail', 'shamzehei', 'bmirzapouebe', 'narendranx1', 'abanagozar', 'fatemehkiani', 'spalani', None, 'sayandas', 'awaingade']",23,"['hongyangao', 'dchitkara', 'mtorfeh', 'nazanintakbiri', 'ravichan', 'edward8324', 'fairytail', 'bmirzapouebe', 'sheringeorge', 'fatemehkiani', 'mmansouree', 'xiaomengliu', None, 'sayandas', 'zzou', 'jgarchali', 'aliyaqureshi', 'acalambur', 'shamzehei', 'narendranx1', 'abanagozar', 'spalani', 'awaingade']"
168,121,6,20,3,"['xiaomengliu', 'dchitkara', 'sheringeorge']",2,"['mmansouree', 'acalambur']",17,"['hongyangao', 'mtorfeh', 'nazanintakbiri', 'jgarchali', 'aliyaqureshi', 'ravichan', 'edward8324', 'fairytail', 'sayandas', 'bmirzapouebe', 'narendranx1', 'abanagozar', 'fatemehkiani', 'spalani', None, 'zzou', 'awaingade']",22,"['hongyangao', 'dchitkara', 'mtorfeh', 'nazanintakbiri', 'ravichan', 'edward8324', 'fairytail', 'bmirzapouebe', 'sheringeorge', 'fatemehkiani', 'mmansouree', 'xiaomengliu', None, 'zzou', 'sayandas', 'jgarchali', 'aliyaqureshi', 'acalambur', 'narendranx1', 'abanagozar', 'spalani', 'awaingade']"
168,126,6,19,5,"['dchitkara', 'acalambur', 'sheringeorge', 'mmansouree', 'xiaomengliu']",0,[],14,"['hongyangao', 'nazanintakbiri', 'aliyaqureshi', 'ravichan', 'zzou', 'edward8324', 'fairytail', 'srini999', 'abanagozar', 'fatemehkiani', None, 'sayandas', 'isaac_fu', 'awaingade']",19,"['hongyangao', 'dchitkara', 'nazanintakbiri', 'ravichan', 'edward8324', 'fairytail', 'sheringeorge', 'fatemehkiani', 'mmansouree', 'xiaomengliu', None, 'zzou', 'sayandas', 'isaac_fu', 'aliyaqureshi', 'acalambur', 'abanagozar', 'srini999', 'awaingade']"
168,215,6,18,5,"['dchitkara', 'acalambur', 'sheringeorge', 'mmansouree', 'xiaomengliu']",0,[],13,"['hongyangao', 'nazanintakbiri', 'aliyaqureshi', 'ravichan', 'fairytail', 'fatemehkiani', 'sayandas', 'abanagozar', 'srini999', 'spalani', None, 'zzou', 'awaingade']",18,"['hongyangao', 'dchitkara', 'nazanintakbiri', 'ravichan', 'fairytail', 'sheringeorge', 'fatemehkiani', 'mmansouree', 'xiaomengliu', None, 'zzou', 'sayandas', 'aliyaqureshi', 'acalambur', 'abanagozar', 'srini999', 'spalani', 'awaingade']"
169,210,6,10,5,"['mdfaisalkabir', 'rahulsrikonda04', 'kkumaarpradeep18', 'sohelrana', 'mdkamrulhassanma']",0,[],5,"['mecrifat123', 'shafaqkausar', 'sarasedighi', 'abayneh', None]",10,"['mdfaisalkabir', 'kkumaarpradeep18', 'rahulsrikonda04', 'mecrifat123', 'sohelrana', 'shafaqkausar', 'sarasedighi', 'abayneh', 'mdkamrulhassanma', None]"
169,33,6,9,4,"['kkumaarpradeep18', 'mdfaisalkabir', 'sohelrana', 'mdkamrulhassanma']",1,['rahulsrikonda04'],5,"['mecrifat123', 'shafaqkausar', 'sarasedighi', 'abayneh', None]",10,"['mdfaisalkabir', 'kkumaarpradeep18', 'rahulsrikonda04', 'mecrifat123', 'sohelrana', 'shafaqkausar', 'sarasedighi', 'abayneh', 'mdkamrulhassanma', None]"
169,139,6,9,5,"['mdfaisalkabir', 'rahulsrikonda04', 'kkumaarpradeep18', 'sohelrana', 'mdkamrulhassanma']",0,[],4,"['mecrifat123', 'abayneh', None, 'kcantley']",9,"['mdfaisalkabir', 'kkumaarpradeep18', 'rahulsrikonda04', 'mecrifat123', 'sohelrana', 'abayneh', 'mdkamrulhassanma', 'kcantley', None]"
169,140,6,9,4,"['kkumaarpradeep18', 'mdfaisalkabir', 'sohelrana', 'mdkamrulhassanma']",1,['rahulsrikonda04'],5,"['mecrifat123', 'sarasedighi', 'abayneh', 'kcantley', None]",10,"['mdfaisalkabir', 'kkumaarpradeep18', 'rahulsrikonda04', 'mecrifat123', 'sohelrana', 'sarasedighi', 'abayneh', 'mdkamrulhassanma', 'kcantley', None]"
169,32,6,7,4,"['kkumaarpradeep18', 'mdfaisalkabir', 'sohelrana', 'mdkamrulhassanma']",1,['rahulsrikonda04'],3,"['mecrifat123', 'abayneh', None]",8,"['mdfaisalkabir', 'kkumaarpradeep18', 'rahulsrikonda04', 'mecrifat123', 'sohelrana', 'abayneh', 'mdkamrulhassanma', None]"
169,124,6,7,4,"['kkumaarpradeep18', 'mdfaisalkabir', 'sohelrana', 'mdkamrulhassanma']",1,['rahulsrikonda04'],3,"['mecrifat123', 'abayneh', None]",8,"['mdfaisalkabir', 'kkumaarpradeep18', 'rahulsrikonda04', 'mecrifat123', 'sohelrana', 'abayneh', 'mdkamrulhassanma', None]"
170,189,6,16,5,"['liyong', 'wuzehan', 'xuzhourui', 'liumengjie', 'sara1994']",0,[],11,"['renben', 'quanyuhui', 'akumar123', 'liyuanzhe123', 'nonofrio', 'kotszwai', 'yxlyu', 'fakemkczaq', 'tkcadam1992', None, 'christopher1993']",16,"['renben', 'liumengjie', None, 'yxlyu', 'christopher1993', 'liyong', 'wuzehan', 'quanyuhui', 'akumar123', 'liyuanzhe123', 'nonofrio', 'xuzhourui', 'kotszwai', 'fakemkczaq', 'tkcadam1992', 'sara1994']"
170,323,6,15,5,"['liyong', 'wuzehan', 'xuzhourui', 'liumengjie', 'sara1994']",0,[],10,"['kenko911', 'renben', None, 'quanyuhui', 'akumar123', 'liyuanzhe123', 'nonofrio', 'kotszwai', 'tkcadam1992', 'yxlyu']",15,"['kenko911', 'renben', 'liumengjie', 'yxlyu', None, 'liyong', 'wuzehan', 'quanyuhui', 'akumar123', 'liyuanzhe123', 'nonofrio', 'xuzhourui', 'kotszwai', 'tkcadam1992', 'sara1994']"
170,171,6,12,5,"['liyong', 'wuzehan', 'xuzhourui', 'liumengjie', 'sara1994']",0,[],7,"['renben', None, 'quanyuhui', 'nonofrio', 'kotszwai', 'tkcadam1992', 'yxlyu']",12,"['renben', 'liumengjie', 'yxlyu', None, 'liyong', 'wuzehan', 'quanyuhui', 'nonofrio', 'xuzhourui', 'kotszwai', 'tkcadam1992', 'sara1994']"
170,324,6,12,1,['liumengjie'],4,"['liyong', 'sara1994', 'wuzehan', 'xuzhourui']",11,"['renben', None, 'quanyuhui', 'akumar123', 'liyuanzhe123', 'nonofrio', 'kotszwai', 'tkcadam1992', 'yxlyu', 'christopher1993', 'yingyr']",16,"['renben', 'liumengjie', 'yxlyu', None, 'christopher1993', 'liyong', 'wuzehan', 'quanyuhui', 'akumar123', 'liyuanzhe123', 'nonofrio', 'xuzhourui', 'kotszwai', 'tkcadam1992', 'sara1994', 'yingyr']"
