MClusterID,XClusterID,MClusterSize,XClusterSize,OverlapSize,OverlapMembers,MOnlySize,MOnlyMembers,XOnlySize,XOnlyMembers,CombinedSize,CombinedMembers
1,17,336,165,3,"['gopijettiboyina841', 'shaikyahul77', 'salman1999']",333,"['yasmine317', 'asmaahussein99', 'engmo3taz99', 'simon1205', 'luca.riccies', 'sgu20171586', 'lisifan', 'heba_star1999', 'jkson3', 'nadaessam', 'addashti', 'yara.magdy222', 'bellayang', 'sg20121208', 'muhammed.number', 'pradeep_c17', 'sgu20131481', 'almoatasem_bellah', 'sgu20131507', 'dsreynolds93', 'sgu2014726019', 'lamyaalfa', 'aubai.hassan98', 'a.omar125242', 'c15444808', 'tktm44', 'wenfeng', 'sgu20151486', 'wangmingzhu', 'mariam0', 'wpsun319', 'eric.kosdi', 'nalvarez92', 'gjfdjzo', 'ionsko', 'sgu20151464', 'leeann901', 'weka_201219', 'abdulrahmangalal', 'goddoggo', 'duweigg', 'sgu20141478', 'tianzk2', 'juhu93', 'hanamantmn999', 'dydgus201', 'jxc248006', 'aya.mohamed97', 'bassem_mazen', 'sgu20171572', 'nelwagdy', 'ataulmamun', 'harry0913', 'caowd92', 'yangqu', 'ppjunb12', 'nayerakhaled', 'ahmadabdelsalam', 'henryhe9806', 'mazen_ashraf', 'asmaagamalelsayed96', 'nouran_mohamed', 'sgu20141474', 'basmahassan697', 'mdabrarshaikh90', 'sgu20161542e', 'simon6599', 'sgu20151463', 'lincolnwang321', 'arvindh', 'sgu20141460', 'sgu20131410', 'aymansaadhack', 'georgesamy', 'monakamel97', 'cxu004', 'sgu20171502', 'omarz977', 'ruodaz', 'yayman55', 'radu.uta93', 'smrsaravanan', 'amjadtaleb', 'sgu20141389', 'ankita.patil.0001', 'mayura0621', 'mohammedmajdyict', 'labmiugac2993', 'sgu20141458', 'gyl0428', 'sgu20151490', 'sgu20141476', 'jiamin2068', 'ahmedmoustafa771', 'ahmad.yasserr', 'wildprince', 'yuelian1234', 'sgu20091548', 'alaa98', 'sgu20171524', 'ge24', 'zeinabtaha', 'shinsunhak', 'ranaahmed96', 'thapu.putta', 'sgu20151476', 'sgu20171556', 'ulas_965', 'bentelghaly', 'lemon12345', 'gsabbir87', 'uozgur', 'e0186014', 'omar_eid73', 'sgu20171526', 'sgu20141395', 'han20151510', 'muhlasheen2', 'sgu20141468', 'sgu20151485', 'mostafa200100', 'sgu20151424', 'julianna', 'zhangziyan', 'hgowaily', 'lindatalts', 'mariamzanaty', 'sgu20141483', 'scientist.affawn', 'indronil.ghosh27', 'mimo007007', 'sgu20151513', 'mariomedhat9', 'salmasaher', 'tutulalala', 'jlong1028', 'sgu20141393', 'amgadsami1998', 'khaledhigazy94', 'saramahmoud19', 'ayaabdelrahim', 'faharalalawi', 'sgu20141471', 'lennynator92', 'dko1217', 'sgu20141394', 'amirnabilhanna', 'toqa1999', 'sgu20121498', 'kingmokey', 'amrsaeed012', 'ekhlas3535', 'f.elgebaly', 'sgu20141461', 'mohameddomy97', 'mitchelld2', 'john17.su', 'hamedamr95', 'unal', 'tingyu.qu', 'memonona017', 'muhamriaz', 'sayeedrm', 'sgu20151422', 'sgu20141448', 'plloydwright', 'ayakhaled4897', 'aradwa477', 'husalaa98', 'shy19951119', 'sgu20151438', 'roddaro', 'omniapinkflower', 'hayaat', 'horstmannbm', 'changlin2328', 'heshamebrahim123', 'sgu20131455', 'timmy_mer', 'vb9237865', 'sgu20151456', 'hamda', 'monikaa', 'sgu20131462', 'hbg2112', 'sogang20141460', 'sgu20171566', 'sgu20141414', 'sgu20161542', 'mohammed_naveed', 'nayeramansour', 'youmna.moussa2016', 'sgu20161474', 'abdelazimmohamed98', 'sgu20131432', 'sgu20171490', 'sgu20151436', 'bassem8989', 'nourhanmagdymahmoud', 'sgu20151478', 'akarkotis94', 'sgu20151418', 'ayamohamed', 'demonleon1995', 'mennatallamostafa87', 'nahlatarek', 'bguillet', 'xanxo18', 'naremanallam40', 'zjhnus', 'sikaislam66', 'abdelrhmanadelhassan', 'yaozu', 'jhoeniges', 'akshayb', 'sgu20141398', 'qky0921', 'yasmin.gad412', 'sgu20141415', 'a0928404798', 'sgu20171558', 'nouran.tarek97', 'seohyeoniii', 'rinap', 'olashazly27', 'sgu20151410', 'gehadosama', 'bbaekssun', 'jishen', 'tahaa.rore', 'marwan.m96', 'joanliu951001', 'sgu20171562', 'anas_massoud', 'sgu20141480', 'sgu20171520', 'sgu20141484', 'sgu20131412', 'nada.omran', 'tokahossam71', 'basmagharieb', 'yusuf313', 'youssefrefaat', 'mennaessam98', 'estradavictor96', 'hananalamri', 'mahmouddeghadi', 'e0320957', 'sgu20151487', 'guitarist9816', 'bluer', 'mohamedkutb', 'mtmaccc', 'chen2712', 'omnia.khaled12', 'a960710', 'jaydm26', 'sgu20171508', 'as', 'sgu20141424', 'sgu20141430', 'sgu20171503', 'sgu20141417', 'johnmccarthy', 'mustafaakhlak', 'chxxtu2009', 'sgu20151452', 'mohmedaliessa', 'sgu20141411', 'nada5essam', 'salmaaatareeek', 'mohamedallam0000', 'qwu2', 'nkpuga', 'michaelashraf777', 'donghu', 'dvid0315', 'yhlee27', 'sgu20131508', 'ankitraj9', 'sgu20121532', 'esoomoh64', 'velurihasita', 'latifaalfardan', 'leo666', 'ibrahimkamal1997', 'assemabdelmoniem', 'engtuan123', 'sgu20161494', 'loaydiaa', 'kabinaya08', 'sgu20171570', 'zeyadahmedbadr97', 'nimashi001', 'nkvv88', 'mohamedabdelmeged', 'jackhoeniges', 'zackkk123', 'michaelguevara', 'cbzkcbzk1', 'hagarkhaled', 'bperera', 'jorgealexandre', 'jojosazziz', 'shamyofficial2', 'zhichongcarl', 'cuoghimarco', 'hanamant17', 'sgu20161503', 'zenaj', 'khaledshehab44', 'rahmanr3', 'sgu20151194', 'ooooo18', 'ayoyayoyo2008', 'radwa123', 'mjkingdem', 'sgu20141408', 'ramyadel1313', 'mohanad.waheed9', 'hala97', 'icey123', 'sgu20171550', 'youssef_essam', 'johan.iswara', 'hongyan', 'visionsofshiva', 'sgu20131492', 'weeei0514', 'hour', 'zhangnianchen', 'abdo1703', 'neuton']",162,"['karthikbajjuri05', 'kotapati.venkatanaveen', 'karthiknvv1999', 'konkasiva1234', 'saikumar1919sms', 'indub', 'bellala9182', 'mdevendrareddy21', 'pradeepsanapala22', 'sharvanireddy29', 'nandisrividya123', 'settysucharitha', 'preethippin.r', 'amrutha3366', 'naveen6052531', 'prasadsai481', 'jyotsnaasari15', 'akashravichandran872', 'mohan.p1965.mp', 'elango.vit', 'pujithapuny', 'sanepallibalaji143', 'hareesh.audireddy', 'beemisettypavankumar', 'bhargavijolly2000', 'gurakalasravanisravs', 'shivakumar1999', 'gorasekhar62', 'rajasekhar.j33', 'gpindrani', 'dharma879reddy', 'sakethchinna424', 'chinna143', 'pavankumar.koyyalamudi185', 'gundlapallecharanya', 'bindubhogireddy', 'preethi2', 'rahuljayanthi83', 'bathalasailu555it', 'rajeshkumaripg1', 'gsaimanikanta1234', 'thummala.naveen47', 'alaikvenumadhav', 'annametirohith123', 'mercyevangelin03', 'kirthikaug1', 'mounika.punati07', 'lingamallika00', 'pandubabu819', 'raju1408gopi', 'lalithyareddy9', 'saikumarkanisetty525', 'jaswanth521999', 'swetha.yerabapu', 'ruthalasaisujay2000', 'renusreekarnam', 'sukeshbsr', 'manugondamanoj.11', 'vjvijay1999', 'dhanalakshmidnvs', 'naveennani19991', 'devireddyaravind786', 'sridharamjayashree5274', 'bhargavibharu9876', 'saleema', 'vaisnavikv', 'abhishekm61102', 'saitejaswi2210', 'kusumareddy049', 'teddy4u2015', 'swethainturi7', 'sasikumart73', 'manojmaverick19', 'poolakshmiramesh', 'ponnasasikumar379', 'ysvrnv', 'praveenkella2299', 'subhasrithathineni', 'salmansamjashi', 'segumahesh', 'haranadh11', 'kannarevanth123', 'divyalathamidhun12', 'kotakondaarunteja', 'chekuripradeep888', 'sumanth.bingi139', 'sravanthijai1999', 'upendravalleti', 'suryaboddupalli.3216', 'vyshnavi.jonnala', 'abburisrihari8', 'kamlesh_', 'manivinay777', 'deepakarunannamalai', 'bandiramya2000', 'jonahjoni7', 'chaithualadi', 'mrachapalli443', 'saiviswa9595', 'adhurugundlavikrambliss', 'harshavardhini.mohan125', 'chillavishnuvardhan1234', 'gowthamnt.vik333', 'pravallika', 'abbasmanthri904', 'gunasekharreddy.thummala', 'kalyanamsubhash65', 'thanigai', 'vrprasanna38118114', 'sukanyacheruvu30', 'harshavardhan.ph', 'varunsai.gajawada1999', 'shaikbajithun', 'chennakesavareddy200', 'saicharangayathri66', 'reshmaraju', 'gayalanagaanudeep183', 'gokulsai142', 'harshavardhan211099', 'alexandra', 'saivamsiusha', 'paulina.gollapudi', 'anu27111999', 'sreekanthreddynussam75596', 'surendar2042', 'chekkatchyutkumar', 'babuanand76865', 'bhavyapreethi24', 'sugansugumar55', 'onadikrishnareddy72', 'vinuthakasthala', 'akhilchandaka111', 'studychennaiv4u', 'thanushayaddala1999', 'mohanakrishna1', 'jeevanmorkelnttf', 'bhaskarrao', 'gayu_kutty', 'princerafi588', 'kundasrinivasulu55', 'vijaydurgareddy9', 'swaroop6055', 'amarapraveenkumar', 'sainikhilgodl', 'jyotheesh', 'bathulasrikanth135', 'vishnupriya', 'azharab839', 'sreenivassree0143', 'manjuladrp', 'gnanasekharmani2000', 'ariyareddygaripavithra', 'saikumarbodapati97', 'tejateja1574', 'krushithakrishna1212', 'susmithainturi02', 'bashasameerbasha', 'vsswathiraj2017', 'lavanyavarapana111', 'chandug2310', 'lakshmipunati02', 'avr6668']",498,"['yasmine317', 'mitchelld2', 'john17.su', 'asmaahussein99', 'kotapati.venkatanaveen', 'engmo3taz99', 'simon1205', 'konkasiva1234', 'hamedamr95', 'unal', 'pradeepsanapala22', 'luca.riccies', 'sgu20171586', 'lisifan', 'tingyu.qu', 'memonona017', 'heba_star1999', 'settysucharitha', 'jkson3', 'nadaessam', 'addashti', 'yara.magdy222', 'bellayang', 'sg20121208', 'muhammed.number', 'pradeep_c17', 'sgu20131481', 'jyotsnaasari15', 'muhamriaz', 'akashravichandran872', 'mohan.p1965.mp', 'almoatasem_bellah', 'sayeedrm', 'sgu20151422', 'sgu20141448', 'plloydwright', 'pujithapuny', 'sgu20131507', 'dsreynolds93', 'beemisettypavankumar', 'sgu2014726019', 'lamyaalfa', 'aubai.hassan98', 'a.omar125242', 'gurakalasravanisravs', 'ayakhaled4897', 'c15444808', 'rajasekhar.j33', 'tktm44', 'aradwa477', 'husalaa98', 'shy19951119', 'dharma879reddy', 'sgu20151438', 'sakethchinna424', 'wenfeng', 'chinna143', 'roddaro', 'omniapinkflower', 'hayaat', 'bathalasailu555it', 'horstmannbm', 'sgu20151486', 'gsaimanikanta1234', 'wangmingzhu', 'mariam0', 'changlin2328', 'heshamebrahim123', 'wpsun319', 'sgu20131455', 'timmy_mer', 'eric.kosdi', 'vb9237865', 'sgu20151456', 'hamda', 'nalvarez92', 'gjfdjzo', 'ionsko', 'sgu20151464', 'monikaa', 'leeann901', 'weka_201219', 'abdulrahmangalal', 'sgu20131462', 'hbg2112', 'swetha.yerabapu', 'ruthalasaisujay2000', 'goddoggo', 'duweigg', 'sogang20141460', 'sgu20141478', 'sgu20171566', 'sgu20141414', 'renusreekarnam', 'manugondamanoj.11', 'sgu20161542', 'devireddyaravind786', 'tianzk2', 'mohammed_naveed', 'nayeramansour', 'sridharamjayashree5274', 'juhu93', 'youmna.moussa2016', 'sgu20161474', 'abdelazimmohamed98', 'sgu20131432', 'sgu20171490', 'sgu20151436', 'bhargavibharu9876', 'hanamantmn999', 'dydgus201', 'bassem8989', 'vaisnavikv', 'nourhanmagdymahmoud', 'jxc248006', 'aya.mohamed97', 'sgu20151478', 'akarkotis94', 'swethainturi7', 'poolakshmiramesh', 'sgu20151418', 'bassem_mazen', 'sgu20171572', 'nelwagdy', 'ysvrnv', 'ataulmamun', 'praveenkella2299', 'salmansamjashi', 'ayamohamed', 'harry0913', 'demonleon1995', 'caowd92', 'divyalathamidhun12', 'yangqu', 'kotakondaarunteja', 'upendravalleti', 'ppjunb12', 'nayerakhaled', 'mennatallamostafa87', 'vyshnavi.jonnala', 'nahlatarek', 'manivinay777', 'jonahjoni7', 'ahmadabdelsalam', 'bguillet', 'xanxo18', 'naremanallam40', 'henryhe9806', 'zjhnus', 'mazen_ashraf', 'sikaislam66', 'asmaagamalelsayed96', 'nouran_mohamed', 'sgu20141474', 'abdelrhmanadelhassan', 'basmahassan697', 'yaozu', 'jhoeniges', 'akshayb', 'abbasmanthri904', 'kalyanamsubhash65', 'mdabrarshaikh90', 'sgu20141398', 'qky0921', 'thanigai', 'sgu20161542e', 'yasmin.gad412', 'vrprasanna38118114', 'sukanyacheruvu30', 'simon6599', 'sgu20151463', 'lincolnwang321', 'harshavardhan.ph', 'arvindh', 'sgu20141460', 'sgu20141415', 'a0928404798', 'sgu20131410', 'sgu20171558', 'shaikbajithun', 'nouran.tarek97', 'chennakesavareddy200', 'reshmaraju', 'gokulsai142', 'gayalanagaanudeep183', 'seohyeoniii', 'harshavardhan211099', 'alexandra', 'rinap', 'aymansaadhack', 'anu27111999', 'olashazly27', 'sreekanthreddynussam75596', 'sgu20151410', 'georgesamy', 'gehadosama', 'chekkatchyutkumar', 'monakamel97', 'bbaekssun', 'onadikrishnareddy72', 'vinuthakasthala', 'jishen', 'cxu004', 'tahaa.rore', 'marwan.m96', 'mohanakrishna1', 'joanliu951001', 'sgu20171502', 'jeevanmorkelnttf', 'omarz977', 'sgu20171562', 'ruodaz', 'yayman55', 'radu.uta93', 'kundasrinivasulu55', 'vijaydurgareddy9', 'amarapraveenkumar', 'smrsaravanan', 'amjadtaleb', 'anas_massoud', 'sgu20141389', 'ankita.patil.0001', 'mayura0621', 'sreenivassree0143', 'mohammedmajdyict', 'labmiugac2993', 'sgu20141480', 'ariyareddygaripavithra', 'sgu20171520', 'sgu20141458', 'sgu20141484', 'gyl0428', 'sgu20151490', 'sgu20131412', 'sgu20141476', 'nada.omran', 'jiamin2068', 'tokahossam71', 'krushithakrishna1212', 'ahmedmoustafa771', 'vsswathiraj2017', 'chandug2310', 'basmagharieb', 'lakshmipunati02', 'karthikbajjuri05', 'yusuf313', 'ahmad.yasserr', 'wildprince', 'yuelian1234', 'karthiknvv1999', 'saikumar1919sms', 'indub', 'youssefrefaat', 'bellala9182', 'mdevendrareddy21', 'sgu20091548', 'alaa98', 'mennaessam98', 'sharvanireddy29', 'estradavictor96', 'sgu20171524', 'ge24', 'nandisrividya123', 'preethippin.r', 'amrutha3366', 'zeinabtaha', 'hananalamri', 'shinsunhak', 'mahmouddeghadi', 'naveen6052531', 'ranaahmed96', 'thapu.putta', 'e0320957', 'sgu20151487', 'guitarist9816', 'prasadsai481', 'sgu20151476', 'bluer', 'sgu20171556', 'mohamedkutb', 'elango.vit', 'sanepallibalaji143', 'hareesh.audireddy', 'bhargavijolly2000', 'ulas_965', 'mtmaccc', 'shivakumar1999', 'gorasekhar62', 'chen2712', 'omnia.khaled12', 'a960710', 'gpindrani', 'bentelghaly', 'jaydm26', 'pavankumar.koyyalamudi185', 'gundlapallecharanya', 'bindubhogireddy', 'preethi2', 'lemon12345', 'gsabbir87', 'sgu20171508', 'as', 'rahuljayanthi83', 'uozgur', 'sgu20141424', 'e0186014', 'rajeshkumaripg1', 'omar_eid73', 'sgu20141430', 'sgu20171503', 'thummala.naveen47', 'sgu20141417', 'johnmccarthy', 'alaikvenumadhav', 'mustafaakhlak', 'chxxtu2009', 'sgu20151452', 'annametirohith123', 'mohmedaliessa', 'mercyevangelin03', 'sgu20141411', 'kirthikaug1', 'sgu20171526', 'nada5essam', 'salmaaatareeek', 'mohamedallam0000', 'mounika.punati07', 'qwu2', 'lingamallika00', 'sgu20141395', 'pandubabu819', 'raju1408gopi', 'han20151510', 'nkpuga', 'michaelashraf777', 'lalithyareddy9', 'saikumarkanisetty525', 'jaswanth521999', 'donghu', 'muhlasheen2', 'sukeshbsr', 'dvid0315', 'yhlee27', 'sgu20131508', 'vjvijay1999', 'sgu20141468', 'dhanalakshmidnvs', 'naveennani19991', 'sgu20151485', 'ankitraj9', 'mostafa200100', 'sgu20121532', 'esoomoh64', 'sgu20151424', 'saleema', 'velurihasita', 'abhishekm61102', 'saitejaswi2210', 'latifaalfardan', 'leo666', 'ibrahimkamal1997', 'assemabdelmoniem', 'julianna', 'kusumareddy049', 'teddy4u2015', 'zhangziyan', 'hgowaily', 'lindatalts', 'sasikumart73', 'manojmaverick19', 'engtuan123', 'ponnasasikumar379', 'subhasrithathineni', 'sgu20161494', 'loaydiaa', 'segumahesh', 'haranadh11', 'kabinaya08', 'kannarevanth123', 'mariamzanaty', 'sgu20171570', 'sgu20141483', 'sumanth.bingi139', 'chekuripradeep888', 'zeyadahmedbadr97', 'sravanthijai1999', 'gopijettiboyina841', 'nimashi001', 'suryaboddupalli.3216', 'nkvv88', 'abburisrihari8', 'mohamedabdelmeged', 'kamlesh_', 'scientist.affawn', 'indronil.ghosh27', 'deepakarunannamalai', 'bandiramya2000', 'jackhoeniges', 'chaithualadi', 'mrachapalli443', 'saiviswa9595', 'adhurugundlavikrambliss', 'zackkk123', 'mimo007007', 'sgu20151513', 'mariomedhat9', 'michaelguevara', 'cbzkcbzk1', 'hagarkhaled', 'bperera', 'jorgealexandre', 'jojosazziz', 'harshavardhini.mohan125', 'salmasaher', 'tutulalala', 'chillavishnuvardhan1234', 'gowthamnt.vik333', 'shamyofficial2', 'zhichongcarl', 'jlong1028', 'pravallika', 'cuoghimarco', 'sgu20141393', 'hanamant17', 'amgadsami1998', 'gunasekharreddy.thummala', 'shaikyahul77', 'sgu20161503', 'varunsai.gajawada1999', 'zenaj', 'khaledshehab44', 'khaledhigazy94', 'saramahmoud19', 'rahmanr3', 'ayaabdelrahim', 'faharalalawi', 'sgu20141471', 'sgu20151194', 'saicharangayathri66', 'lennynator92', 'saivamsiusha', 'dko1217', 'ooooo18', 'paulina.gollapudi', 'surendar2042', 'sgu20141394', 'amirnabilhanna', 'babuanand76865', 'ayoyayoyo2008', 'radwa123', 'bhavyapreethi24', 'sugansugumar55', 'akhilchandaka111', 'toqa1999', 'studychennaiv4u', 'thanushayaddala1999', 'mjkingdem', 'sgu20141408', 'ramyadel1313', 'mohanad.waheed9', 'bhaskarrao', 'sgu20121498', 'kingmokey', 'salman1999', 'hala97', 'gayu_kutty', 'princerafi588', 'amrsaeed012', 'icey123', 'swaroop6055', 'sainikhilgodl', 'bathulasrikanth135', 'sgu20171550', 'youssef_essam', 'johan.iswara', 'vishnupriya', 'ekhlas3535', 'azharab839', 'f.elgebaly', 'hongyan', 'manjuladrp', 'gnanasekharmani2000', 'sgu20141461', 'visionsofshiva', 'saikumarbodapati97', 'sgu20131492', 'weeei0514', 'hour', 'tejateja1574', 'mohameddomy97', 'zhangnianchen', 'susmithainturi02', 'bashasameerbasha', 'abdo1703', 'lavanyavarapana111', 'jyotheesh', 'neuton', 'avr6668']"
1,138,336,140,1,['gopijettiboyina841'],335,"['yasmine317', 'asmaahussein99', 'engmo3taz99', 'simon1205', 'luca.riccies', 'sgu20171586', 'lisifan', 'heba_star1999', 'jkson3', 'nadaessam', 'addashti', 'yara.magdy222', 'bellayang', 'sg20121208', 'muhammed.number', 'pradeep_c17', 'sgu20131481', 'almoatasem_bellah', 'sgu20131507', 'dsreynolds93', 'sgu2014726019', 'lamyaalfa', 'aubai.hassan98', 'a.omar125242', 'c15444808', 'tktm44', 'wenfeng', 'sgu20151486', 'wangmingzhu', 'mariam0', 'wpsun319', 'eric.kosdi', 'nalvarez92', 'gjfdjzo', 'ionsko', 'sgu20151464', 'leeann901', 'weka_201219', 'abdulrahmangalal', 'goddoggo', 'duweigg', 'sgu20141478', 'tianzk2', 'juhu93', 'hanamantmn999', 'dydgus201', 'jxc248006', 'aya.mohamed97', 'bassem_mazen', 'sgu20171572', 'nelwagdy', 'ataulmamun', 'harry0913', 'caowd92', 'yangqu', 'ppjunb12', 'nayerakhaled', 'ahmadabdelsalam', 'henryhe9806', 'mazen_ashraf', 'asmaagamalelsayed96', 'nouran_mohamed', 'sgu20141474', 'basmahassan697', 'mdabrarshaikh90', 'sgu20161542e', 'simon6599', 'sgu20151463', 'lincolnwang321', 'arvindh', 'sgu20141460', 'sgu20131410', 'aymansaadhack', 'georgesamy', 'monakamel97', 'cxu004', 'sgu20171502', 'omarz977', 'ruodaz', 'yayman55', 'radu.uta93', 'smrsaravanan', 'amjadtaleb', 'sgu20141389', 'ankita.patil.0001', 'mayura0621', 'mohammedmajdyict', 'labmiugac2993', 'sgu20141458', 'gyl0428', 'sgu20151490', 'sgu20141476', 'jiamin2068', 'ahmedmoustafa771', 'ahmad.yasserr', 'wildprince', 'yuelian1234', 'sgu20091548', 'alaa98', 'sgu20171524', 'ge24', 'zeinabtaha', 'shinsunhak', 'ranaahmed96', 'thapu.putta', 'sgu20151476', 'sgu20171556', 'ulas_965', 'bentelghaly', 'lemon12345', 'gsabbir87', 'uozgur', 'e0186014', 'omar_eid73', 'sgu20171526', 'sgu20141395', 'han20151510', 'muhlasheen2', 'sgu20141468', 'sgu20151485', 'mostafa200100', 'sgu20151424', 'julianna', 'zhangziyan', 'hgowaily', 'lindatalts', 'mariamzanaty', 'sgu20141483', 'scientist.affawn', 'indronil.ghosh27', 'mimo007007', 'sgu20151513', 'mariomedhat9', 'salmasaher', 'tutulalala', 'jlong1028', 'sgu20141393', 'amgadsami1998', 'shaikyahul77', 'khaledhigazy94', 'saramahmoud19', 'ayaabdelrahim', 'faharalalawi', 'sgu20141471', 'lennynator92', 'dko1217', 'sgu20141394', 'amirnabilhanna', 'toqa1999', 'sgu20121498', 'kingmokey', 'salman1999', 'amrsaeed012', 'ekhlas3535', 'f.elgebaly', 'sgu20141461', 'mohameddomy97', 'mitchelld2', 'john17.su', 'hamedamr95', 'unal', 'tingyu.qu', 'memonona017', 'muhamriaz', 'sayeedrm', 'sgu20151422', 'sgu20141448', 'plloydwright', 'ayakhaled4897', 'aradwa477', 'husalaa98', 'shy19951119', 'sgu20151438', 'roddaro', 'omniapinkflower', 'hayaat', 'horstmannbm', 'changlin2328', 'heshamebrahim123', 'sgu20131455', 'timmy_mer', 'vb9237865', 'sgu20151456', 'hamda', 'monikaa', 'sgu20131462', 'hbg2112', 'sogang20141460', 'sgu20171566', 'sgu20141414', 'sgu20161542', 'mohammed_naveed', 'nayeramansour', 'youmna.moussa2016', 'sgu20161474', 'abdelazimmohamed98', 'sgu20131432', 'sgu20171490', 'sgu20151436', 'bassem8989', 'nourhanmagdymahmoud', 'sgu20151478', 'akarkotis94', 'sgu20151418', 'ayamohamed', 'demonleon1995', 'mennatallamostafa87', 'nahlatarek', 'bguillet', 'xanxo18', 'naremanallam40', 'zjhnus', 'sikaislam66', 'abdelrhmanadelhassan', 'yaozu', 'jhoeniges', 'akshayb', 'sgu20141398', 'qky0921', 'yasmin.gad412', 'sgu20141415', 'a0928404798', 'sgu20171558', 'nouran.tarek97', 'seohyeoniii', 'rinap', 'olashazly27', 'sgu20151410', 'gehadosama', 'bbaekssun', 'jishen', 'tahaa.rore', 'marwan.m96', 'joanliu951001', 'sgu20171562', 'anas_massoud', 'sgu20141480', 'sgu20171520', 'sgu20141484', 'sgu20131412', 'nada.omran', 'tokahossam71', 'basmagharieb', 'yusuf313', 'youssefrefaat', 'mennaessam98', 'estradavictor96', 'hananalamri', 'mahmouddeghadi', 'e0320957', 'sgu20151487', 'guitarist9816', 'bluer', 'mohamedkutb', 'mtmaccc', 'chen2712', 'omnia.khaled12', 'a960710', 'jaydm26', 'sgu20171508', 'as', 'sgu20141424', 'sgu20141430', 'sgu20171503', 'sgu20141417', 'johnmccarthy', 'mustafaakhlak', 'chxxtu2009', 'sgu20151452', 'mohmedaliessa', 'sgu20141411', 'nada5essam', 'salmaaatareeek', 'mohamedallam0000', 'qwu2', 'nkpuga', 'michaelashraf777', 'donghu', 'dvid0315', 'yhlee27', 'sgu20131508', 'ankitraj9', 'sgu20121532', 'esoomoh64', 'velurihasita', 'latifaalfardan', 'leo666', 'ibrahimkamal1997', 'assemabdelmoniem', 'engtuan123', 'sgu20161494', 'loaydiaa', 'kabinaya08', 'sgu20171570', 'zeyadahmedbadr97', 'nimashi001', 'nkvv88', 'mohamedabdelmeged', 'jackhoeniges', 'zackkk123', 'michaelguevara', 'cbzkcbzk1', 'hagarkhaled', 'bperera', 'jorgealexandre', 'jojosazziz', 'shamyofficial2', 'zhichongcarl', 'cuoghimarco', 'hanamant17', 'sgu20161503', 'zenaj', 'khaledshehab44', 'rahmanr3', 'sgu20151194', 'ooooo18', 'ayoyayoyo2008', 'radwa123', 'mjkingdem', 'sgu20141408', 'ramyadel1313', 'mohanad.waheed9', 'hala97', 'icey123', 'sgu20171550', 'youssef_essam', 'johan.iswara', 'hongyan', 'visionsofshiva', 'sgu20131492', 'weeei0514', 'hour', 'zhangnianchen', 'abdo1703', 'neuton']",139,"['karthikbajjuri05', 'kotapati.venkatanaveen', 'karthiknvv1999', 'indub', 'bellala9182', 'mdevendrareddy21', 'pradeepsanapala22', 'nandisrividya123', 'settysucharitha', 'preethippin.r', 'amrutha3366', 'pallamalavamsi123', 'saileshcruzzer', 'athish_m', 'naveen6052531', 'adityakondragunta7', 'prasadsai481', 'jyotsnaasari15', 'elango.vit', 'pujithapuny', 'bhargavijolly2000', 'pavankumarreddyalamuri', 'gurakalasravanisravs', 'shivakumar1999', 'rajasekhar.j33', 'gpindrani', 'dharma879reddy', 'sakethchinna424', 'chinna143', 'gundlapallecharanya', 'preethi2', 'rahuljayanthi83', 'bathalasailu555it', 'rajeshkumaripg1', 'gsaimanikanta1234', 'thummala.naveen47', 'jahnavi703', 'alaikvenumadhav', 'krmohithchinnu248', 'mercyevangelin03', 'kirthikaug1', 'mounika.punati07', 'lingamallika00', 'raju1408gopi', 'lalithyareddy9', 'saikumarkanisetty525', 'jaswanth521999', 'swetha.yerabapu', 'ruthalasaisujay2000', 'renusreekarnam', 'vjvijay1999', 'dhanalakshmidnvs', 'shaikfayazaashiq', 'poojipenubolu8', 'sridharamjayashree5274', 'kovvurisesha', 'bhargavibharu9876', 'saleema', 'vaisnavikv', 'balajiluminasree', 'saitejaswi2210', 'sathesh.m', 'teddy4u2015', 'ysvrnv', 'praveenkella2299', 'sreenusree1789', 'haranadh11', 'palletiharsha777', 'segumahesh', 'rajeev7032', 'narayanareddy1666', 'divyalathamidhun12', 'kotakondaarunteja', 'chekuripradeep888', 'sumanth.bingi139', 'sravanthijai1999', 'upendravalleti', 'suryaboddupalli.3216', 'kbharggav721', 'saikiran89131', 'kamlesh_', 'bandiramya2000', 'deepakarunannamalai', 'jonahjoni7', 'chaithualadi', 'saiviswa9595', 'mrprnv', 'chillavishnuvardhan1234', 'pravallika', 'abbasmanthri904', 'gunasekharreddy.thummala', 'kalyanamsubhash65', 'vrprasanna38118114', 'sukanyacheruvu30', 'k.rajagopalreddy33', 'rajareddy9052', 'shaikbajithun', 'penchalaprasanna2000', 'venkateshreddy69', 'harinid176', 'saicharangayathri66', 'reshmaraju', 'suresh339', 'dharanicheeda', 'alexandra', 'paulina.gollapudi', 'anu27111999', 'surendar2042', 'chekkatchyutkumar', 'bhavyapreethi24', 'sugansugumar55', 'pharipriyapriya9445', 'akhilchandaka111', 'studychennaiv4u', 'nivetha', 'rakesh.969550', 'jeevanmorkelnttf', 'sandhyareddy', 'gayu_kutty', 'princerafi588', 'kundasrinivasulu55', 'swaroop6055', 'sainikhilgodl', 'rajenjoy25', 'vishnupriya', 'sreenivassree0143', 'manjuladrp', 'gnanasekharmani2000', None, 'katlatipavani666', 'sivabapatu123', 'tejateja1574', 'nanoelectronicsece', 'krushithakrishna1212', 'susmithainturi02', 'bashasameerbasha', 'vsswathiraj2017', 'lavanyavarapana111', 'lakshmipunati02']",475,"['yasmine317', 'mitchelld2', 'john17.su', 'asmaahussein99', 'kotapati.venkatanaveen', 'engmo3taz99', 'simon1205', 'hamedamr95', 'unal', 'pradeepsanapala22', 'luca.riccies', 'sgu20171586', 'lisifan', 'tingyu.qu', 'memonona017', 'heba_star1999', 'settysucharitha', 'jkson3', 'nadaessam', 'addashti', 'yara.magdy222', 'bellayang', 'sg20121208', 'muhammed.number', 'saileshcruzzer', 'pradeep_c17', 'sgu20131481', 'jyotsnaasari15', 'muhamriaz', 'almoatasem_bellah', 'sayeedrm', 'sgu20151422', 'sgu20141448', 'plloydwright', 'pujithapuny', 'sgu20131507', 'dsreynolds93', 'sgu2014726019', 'lamyaalfa', 'aubai.hassan98', 'a.omar125242', 'gurakalasravanisravs', 'ayakhaled4897', 'c15444808', 'rajasekhar.j33', 'tktm44', 'aradwa477', 'husalaa98', 'shy19951119', 'dharma879reddy', 'sgu20151438', 'sakethchinna424', 'wenfeng', 'chinna143', 'roddaro', 'omniapinkflower', 'hayaat', 'bathalasailu555it', 'horstmannbm', 'sgu20151486', 'gsaimanikanta1234', 'wangmingzhu', 'mariam0', 'changlin2328', 'heshamebrahim123', 'wpsun319', 'jahnavi703', 'sgu20131455', 'krmohithchinnu248', 'timmy_mer', 'eric.kosdi', 'vb9237865', 'sgu20151456', 'hamda', 'nalvarez92', 'gjfdjzo', 'ionsko', 'sgu20151464', 'monikaa', 'leeann901', 'weka_201219', 'abdulrahmangalal', 'sgu20131462', 'hbg2112', 'swetha.yerabapu', 'ruthalasaisujay2000', 'goddoggo', 'duweigg', 'sogang20141460', 'sgu20141478', 'sgu20171566', 'sgu20141414', 'renusreekarnam', 'sgu20161542', 'tianzk2', 'mohammed_naveed', 'nayeramansour', 'poojipenubolu8', 'sridharamjayashree5274', 'juhu93', 'youmna.moussa2016', 'sgu20161474', 'abdelazimmohamed98', 'sgu20131432', 'sgu20171490', 'sgu20151436', 'kovvurisesha', 'bhargavibharu9876', 'hanamantmn999', 'dydgus201', 'bassem8989', 'vaisnavikv', 'nourhanmagdymahmoud', 'jxc248006', 'sathesh.m', 'aya.mohamed97', 'sgu20151478', 'akarkotis94', 'sgu20151418', 'bassem_mazen', 'sgu20171572', 'nelwagdy', 'ysvrnv', 'ataulmamun', 'praveenkella2299', 'rajeev7032', 'ayamohamed', 'harry0913', 'demonleon1995', 'caowd92', 'narayanareddy1666', 'yangqu', 'divyalathamidhun12', 'kotakondaarunteja', 'upendravalleti', 'ppjunb12', 'nayerakhaled', 'mennatallamostafa87', 'saikiran89131', 'nahlatarek', 'jonahjoni7', 'ahmadabdelsalam', 'bguillet', 'xanxo18', 'naremanallam40', 'henryhe9806', 'zjhnus', 'mazen_ashraf', 'sikaislam66', 'asmaagamalelsayed96', 'nouran_mohamed', 'sgu20141474', 'abdelrhmanadelhassan', 'basmahassan697', 'yaozu', 'jhoeniges', 'akshayb', 'abbasmanthri904', 'kalyanamsubhash65', 'mdabrarshaikh90', 'sgu20141398', 'qky0921', 'vrprasanna38118114', 'sgu20161542e', 'yasmin.gad412', 'sukanyacheruvu30', 'k.rajagopalreddy33', 'simon6599', 'sgu20151463', 'lincolnwang321', 'arvindh', 'sgu20141460', 'rajareddy9052', 'sgu20141415', 'a0928404798', 'sgu20131410', 'sgu20171558', 'shaikbajithun', 'nouran.tarek97', 'harinid176', 'reshmaraju', 'suresh339', 'seohyeoniii', 'dharanicheeda', 'alexandra', 'rinap', 'aymansaadhack', 'anu27111999', 'olashazly27', 'sgu20151410', 'georgesamy', 'gehadosama', 'chekkatchyutkumar', 'monakamel97', 'bbaekssun', 'rakesh.969550', 'jishen', 'cxu004', 'tahaa.rore', 'marwan.m96', 'nivetha', 'joanliu951001', 'sgu20171502', 'jeevanmorkelnttf', 'omarz977', 'sandhyareddy', 'sgu20171562', 'ruodaz', 'yayman55', 'radu.uta93', 'kundasrinivasulu55', 'smrsaravanan', 'amjadtaleb', 'anas_massoud', 'sgu20141389', 'rajenjoy25', 'ankita.patil.0001', 'mayura0621', 'sreenivassree0143', 'mohammedmajdyict', 'labmiugac2993', 'sgu20141480', None, 'sgu20171520', 'sgu20141458', 'sgu20141484', 'gyl0428', 'sgu20151490', 'sgu20131412', 'sgu20141476', 'nada.omran', 'jiamin2068', 'tokahossam71', 'krushithakrishna1212', 'ahmedmoustafa771', 'vsswathiraj2017', 'basmagharieb', 'lakshmipunati02', 'karthikbajjuri05', 'yusuf313', 'ahmad.yasserr', 'wildprince', 'yuelian1234', 'karthiknvv1999', 'indub', 'youssefrefaat', 'bellala9182', 'mdevendrareddy21', 'sgu20091548', 'alaa98', 'mennaessam98', 'estradavictor96', 'sgu20171524', 'ge24', 'nandisrividya123', 'preethippin.r', 'amrutha3366', 'zeinabtaha', 'pallamalavamsi123', 'hananalamri', 'shinsunhak', 'athish_m', 'mahmouddeghadi', 'naveen6052531', 'ranaahmed96', 'thapu.putta', 'e0320957', 'sgu20151487', 'guitarist9816', 'adityakondragunta7', 'prasadsai481', 'sgu20151476', 'bluer', 'sgu20171556', 'mohamedkutb', 'elango.vit', 'bhargavijolly2000', 'pavankumarreddyalamuri', 'ulas_965', 'mtmaccc', 'shivakumar1999', 'chen2712', 'omnia.khaled12', 'a960710', 'gpindrani', 'bentelghaly', 'jaydm26', 'gundlapallecharanya', 'preethi2', 'lemon12345', 'gsabbir87', 'sgu20171508', 'as', 'rahuljayanthi83', 'uozgur', 'sgu20141424', 'e0186014', 'rajeshkumaripg1', 'omar_eid73', 'sgu20141430', 'sgu20171503', 'thummala.naveen47', 'sgu20141417', 'johnmccarthy', 'alaikvenumadhav', 'mustafaakhlak', 'chxxtu2009', 'sgu20151452', 'mohmedaliessa', 'mercyevangelin03', 'sgu20141411', 'kirthikaug1', 'sgu20171526', 'nada5essam', 'salmaaatareeek', 'mohamedallam0000', 'mounika.punati07', 'qwu2', 'lingamallika00', 'sgu20141395', 'raju1408gopi', 'han20151510', 'nkpuga', 'michaelashraf777', 'lalithyareddy9', 'saikumarkanisetty525', 'jaswanth521999', 'donghu', 'muhlasheen2', 'dvid0315', 'yhlee27', 'sgu20131508', 'vjvijay1999', 'sgu20141468', 'dhanalakshmidnvs', 'shaikfayazaashiq', 'sgu20151485', 'ankitraj9', 'mostafa200100', 'sgu20121532', 'esoomoh64', 'sgu20151424', 'saleema', 'velurihasita', 'balajiluminasree', 'saitejaswi2210', 'latifaalfardan', 'leo666', 'ibrahimkamal1997', 'assemabdelmoniem', 'julianna', 'teddy4u2015', 'zhangziyan', 'hgowaily', 'lindatalts', 'engtuan123', 'sgu20161494', 'loaydiaa', 'sreenusree1789', 'segumahesh', 'palletiharsha777', 'kabinaya08', 'haranadh11', 'mariamzanaty', 'sgu20171570', 'sgu20141483', 'sumanth.bingi139', 'chekuripradeep888', 'zeyadahmedbadr97', 'sravanthijai1999', 'gopijettiboyina841', 'nimashi001', 'suryaboddupalli.3216', 'kbharggav721', 'nkvv88', 'mohamedabdelmeged', 'kamlesh_', 'scientist.affawn', 'indronil.ghosh27', 'bandiramya2000', 'deepakarunannamalai', 'jackhoeniges', 'chaithualadi', 'saiviswa9595', 'zackkk123', 'mimo007007', 'sgu20151513', 'mariomedhat9', 'michaelguevara', 'cbzkcbzk1', 'hagarkhaled', 'bperera', 'jorgealexandre', 'jojosazziz', 'mrprnv', 'salmasaher', 'tutulalala', 'chillavishnuvardhan1234', 'shamyofficial2', 'zhichongcarl', 'jlong1028', 'pravallika', 'cuoghimarco', 'sgu20141393', 'hanamant17', 'amgadsami1998', 'gunasekharreddy.thummala', 'shaikyahul77', 'sgu20161503', 'zenaj', 'khaledshehab44', 'khaledhigazy94', 'penchalaprasanna2000', 'venkateshreddy69', 'saramahmoud19', 'rahmanr3', 'ayaabdelrahim', 'faharalalawi', 'sgu20141471', 'sgu20151194', 'saicharangayathri66', 'lennynator92', 'dko1217', 'ooooo18', 'paulina.gollapudi', 'surendar2042', 'sgu20141394', 'amirnabilhanna', 'ayoyayoyo2008', 'radwa123', 'bhavyapreethi24', 'sugansugumar55', 'pharipriyapriya9445', 'akhilchandaka111', 'toqa1999', 'studychennaiv4u', 'mjkingdem', 'sgu20141408', 'ramyadel1313', 'mohanad.waheed9', 'sgu20121498', 'kingmokey', 'salman1999', 'hala97', 'gayu_kutty', 'princerafi588', 'amrsaeed012', 'icey123', 'swaroop6055', 'sainikhilgodl', 'sgu20171550', 'youssef_essam', 'johan.iswara', 'vishnupriya', 'ekhlas3535', 'f.elgebaly', 'hongyan', 'manjuladrp', 'gnanasekharmani2000', 'sgu20141461', 'visionsofshiva', 'katlatipavani666', 'sgu20131492', 'weeei0514', 'sivabapatu123', 'hour', 'tejateja1574', 'nanoelectronicsece', 'mohameddomy97', 'zhangnianchen', 'susmithainturi02', 'bashasameerbasha', 'abdo1703', 'lavanyavarapana111', 'neuton']"
1,31,336,110,97,"['yasmine317', 'yusuf313', 'ahmad.yasserr', 'asmaahussein99', 'wildprince', 'engmo3taz99', 'hamedamr95', 'youssefrefaat', 'alaa98', 'mennaessam98', 'memonona017', 'heba_star1999', 'yara.magdy222', 'zeinabtaha', 'muhammed.number', 'mahmouddeghadi', 'ranaahmed96', 'guitarist9816', 'almoatasem_bellah', 'aubai.hassan98', 'a.omar125242', 'ayakhaled4897', 'aradwa477', 'husalaa98', 'omnia.khaled12', 'bentelghaly', 'omniapinkflower', 'as', 'omar_eid73', 'mariam0', 'heshamebrahim123', 'mustafaakhlak', 'mohmedaliessa', 'nada5essam', 'mohamedallam0000', 'salmaaatareeek', 'michaelashraf777', 'abdulrahmangalal', 'muhlasheen2', 'nayeramansour', 'youmna.moussa2016', 'mostafa200100', 'abdelazimmohamed98', 'esoomoh64', 'nourhanmagdymahmoud', 'ibrahimkamal1997', 'assemabdelmoniem', 'aya.mohamed97', 'hgowaily', 'loaydiaa', 'mariamzanaty', 'ayamohamed', 'zeyadahmedbadr97', 'mennatallamostafa87', 'nahlatarek', 'mohamedabdelmeged', 'ahmadabdelsalam', 'naremanallam40', 'mimo007007', 'mariomedhat9', 'mazen_ashraf', 'hagarkhaled', 'jojosazziz', 'asmaagamalelsayed96', 'nouran_mohamed', 'salmasaher', 'shamyofficial2', 'abdelrhmanadelhassan', 'basmahassan697', 'amgadsami1998', 'yasmin.gad412', 'khaledshehab44', 'khaledhigazy94', 'nouran.tarek97', 'aymansaadhack', 'georgesamy', 'amirnabilhanna', 'gehadosama', 'ayoyayoyo2008', 'tahaa.rore', 'toqa1999', 'marwan.m96', 'mjkingdem', 'ramyadel1313', 'mohanad.waheed9', 'omarz977', 'hala97', 'yayman55', 'amrsaeed012', 'anas_massoud', 'f.elgebaly', 'mohammedmajdyict', 'hour', 'nada.omran', 'mohameddomy97', 'tokahossam71', 'basmagharieb']",239,"['mitchelld2', 'john17.su', 'yuelian1234', 'simon1205', 'unal', 'sgu20091548', 'luca.riccies', 'sgu20171586', 'lisifan', 'tingyu.qu', 'sgu20171524', 'estradavictor96', 'ge24', 'jkson3', 'nadaessam', 'addashti', 'bellayang', 'sg20121208', 'pradeep_c17', 'sgu20131481', 'shinsunhak', 'hananalamri', 'e0320957', 'thapu.putta', 'sgu20151487', 'muhamriaz', 'sgu20151476', 'bluer', 'sgu20171556', 'sayeedrm', 'sgu20151422', 'sgu20141448', 'plloydwright', 'mohamedkutb', 'sgu20131507', 'dsreynolds93', 'sgu2014726019', 'lamyaalfa', 'ulas_965', 'mtmaccc', 'chen2712', 'c15444808', 'tktm44', 'a960710', 'shy19951119', 'jaydm26', 'sgu20151438', 'wenfeng', 'roddaro', 'hayaat', 'lemon12345', 'gsabbir87', 'sgu20171508', 'uozgur', 'sgu20141424', 'e0186014', 'horstmannbm', 'sgu20151486', 'sgu20141430', 'sgu20171503', 'wangmingzhu', 'sgu20141417', 'johnmccarthy', 'changlin2328', 'wpsun319', 'sgu20131455', 'chxxtu2009', 'sgu20151452', 'timmy_mer', 'eric.kosdi', 'vb9237865', 'sgu20141411', 'sgu20151456', 'hamda', 'nalvarez92', 'sgu20171526', 'gjfdjzo', 'ionsko', 'sgu20151464', 'monikaa', 'qwu2', 'leeann901', 'sgu20141395', 'han20151510', 'nkpuga', 'weka_201219', 'sgu20131462', 'donghu', 'hbg2112', 'goddoggo', 'duweigg', 'sogang20141460', 'sgu20141478', 'sgu20171566', 'sgu20141414', 'dvid0315', 'yhlee27', 'sgu20141468', 'sgu20161542', 'sgu20131508', 'tianzk2', 'mohammed_naveed', 'sgu20151485', 'juhu93', 'sgu20161474', 'ankitraj9', 'sgu20121532', 'sgu20151424', 'sgu20131432', 'sgu20171490', 'sgu20151436', 'hanamantmn999', 'dydgus201', 'bassem8989', 'velurihasita', 'latifaalfardan', 'jxc248006', 'leo666', 'julianna', 'sgu20151478', 'zhangziyan', 'akarkotis94', 'lindatalts', 'sgu20151418', 'bassem_mazen', 'sgu20171572', 'nelwagdy', 'engtuan123', 'ataulmamun', 'sgu20161494', 'kabinaya08', 'harry0913', 'demonleon1995', 'caowd92', 'sgu20171570', 'yangqu', 'sgu20141483', 'gopijettiboyina841', 'nimashi001', 'ppjunb12', 'nkvv88', 'nayerakhaled', 'scientist.affawn', 'indronil.ghosh27', 'jackhoeniges', 'bguillet', 'xanxo18', 'zackkk123', 'henryhe9806', 'zjhnus', 'sgu20151513', 'michaelguevara', 'cbzkcbzk1', 'sikaislam66', 'bperera', 'jorgealexandre', 'tutulalala', 'sgu20141474', 'zhichongcarl', 'jlong1028', 'yaozu', 'jhoeniges', 'akshayb', 'sgu20141393', 'cuoghimarco', 'hanamant17', 'mdabrarshaikh90', 'sgu20141398', 'qky0921', 'shaikyahul77', 'sgu20161542e', 'sgu20161503', 'simon6599', 'sgu20151463', 'lincolnwang321', 'arvindh', 'sgu20141460', 'sgu20141415', 'a0928404798', 'sgu20131410', 'sgu20171558', 'zenaj', 'saramahmoud19', 'rahmanr3', 'ayaabdelrahim', 'faharalalawi', 'sgu20141471', 'sgu20151194', 'seohyeoniii', 'lennynator92', 'dko1217', 'rinap', 'ooooo18', 'olashazly27', 'sgu20151410', 'sgu20141394', 'monakamel97', 'bbaekssun', 'radwa123', 'jishen', 'cxu004', 'sgu20141408', 'joanliu951001', 'sgu20171502', 'sgu20121498', 'kingmokey', 'salman1999', 'sgu20171562', 'ruodaz', 'radu.uta93', 'icey123', 'smrsaravanan', 'amjadtaleb', 'sgu20141389', 'sgu20171550', 'youssef_essam', 'johan.iswara', 'ankita.patil.0001', 'mayura0621', 'ekhlas3535', 'hongyan', 'labmiugac2993', 'sgu20141461', 'sgu20141480', 'visionsofshiva', 'sgu20171520', 'sgu20141458', 'sgu20141484', 'sgu20131492', 'weeei0514', 'gyl0428', 'sgu20151490', 'sgu20131412', 'sgu20141476', 'jiamin2068', 'ahmedmoustafa771', 'zhangnianchen', 'abdo1703', 'neuton']",13,"['waseem98', 'minaayman2', 'karimfoda1', 'karinramy', 'naderyosab67', 'youssef.yassermounir98', 'geek10', 'm16p3', 'nado.mahmoud1995', 'sajaaadel', 'moaz', None, 'mohanedayman']",349,"['yasmine317', 'mitchelld2', 'john17.su', 'asmaahussein99', 'engmo3taz99', 'simon1205', 'hamedamr95', 'unal', 'luca.riccies', 'sgu20171586', 'lisifan', 'tingyu.qu', 'memonona017', 'heba_star1999', 'jkson3', 'nadaessam', 'addashti', 'yara.magdy222', 'bellayang', 'sg20121208', 'muhammed.number', 'pradeep_c17', 'sgu20131481', 'muhamriaz', 'almoatasem_bellah', 'sayeedrm', 'sgu20151422', 'sgu20141448', 'plloydwright', 'sgu20131507', 'dsreynolds93', 'sgu2014726019', 'lamyaalfa', 'aubai.hassan98', 'a.omar125242', 'ayakhaled4897', 'c15444808', 'tktm44', 'aradwa477', 'husalaa98', 'shy19951119', 'sgu20151438', 'wenfeng', 'roddaro', 'omniapinkflower', 'hayaat', 'horstmannbm', 'sgu20151486', 'wangmingzhu', 'mariam0', 'changlin2328', 'heshamebrahim123', 'wpsun319', 'sgu20131455', 'timmy_mer', 'eric.kosdi', 'vb9237865', 'sgu20151456', 'hamda', 'nalvarez92', 'gjfdjzo', 'ionsko', 'sgu20151464', 'monikaa', 'leeann901', 'minaayman2', 'weka_201219', 'abdulrahmangalal', 'sgu20131462', 'hbg2112', 'goddoggo', 'duweigg', 'sogang20141460', 'sgu20141478', 'sgu20171566', 'sgu20141414', 'sgu20161542', 'tianzk2', 'mohammed_naveed', 'nayeramansour', 'juhu93', 'youmna.moussa2016', 'sgu20161474', 'abdelazimmohamed98', 'sgu20131432', 'sgu20171490', 'sgu20151436', 'm16p3', 'hanamantmn999', 'dydgus201', 'bassem8989', 'nourhanmagdymahmoud', 'jxc248006', 'aya.mohamed97', 'sgu20151478', 'karinramy', 'akarkotis94', 'sgu20151418', 'bassem_mazen', 'sgu20171572', 'nelwagdy', 'nado.mahmoud1995', 'ataulmamun', 'ayamohamed', 'harry0913', 'demonleon1995', 'caowd92', 'yangqu', 'ppjunb12', 'nayerakhaled', 'mennatallamostafa87', 'nahlatarek', 'ahmadabdelsalam', 'bguillet', 'xanxo18', 'naremanallam40', 'henryhe9806', 'zjhnus', 'mazen_ashraf', 'sikaislam66', 'asmaagamalelsayed96', 'nouran_mohamed', 'sgu20141474', 'abdelrhmanadelhassan', 'basmahassan697', 'yaozu', 'jhoeniges', 'akshayb', 'mdabrarshaikh90', 'sgu20141398', 'qky0921', 'sgu20161542e', 'yasmin.gad412', 'simon6599', 'sgu20151463', 'lincolnwang321', 'arvindh', 'sgu20141460', 'sgu20141415', 'a0928404798', 'sgu20131410', 'sgu20171558', 'nouran.tarek97', 'seohyeoniii', 'rinap', 'aymansaadhack', 'olashazly27', 'sgu20151410', 'georgesamy', 'gehadosama', 'monakamel97', 'bbaekssun', 'jishen', 'cxu004', 'tahaa.rore', 'marwan.m96', 'joanliu951001', 'sgu20171502', 'omarz977', 'waseem98', 'sgu20171562', 'ruodaz', 'yayman55', 'radu.uta93', 'smrsaravanan', 'amjadtaleb', 'anas_massoud', 'sgu20141389', 'ankita.patil.0001', 'mayura0621', 'mohammedmajdyict', 'labmiugac2993', 'sgu20141480', None, 'sgu20171520', 'sgu20141458', 'sgu20141484', 'gyl0428', 'sgu20151490', 'sgu20131412', 'sgu20141476', 'nada.omran', 'jiamin2068', 'tokahossam71', 'ahmedmoustafa771', 'basmagharieb', 'yusuf313', 'ahmad.yasserr', 'wildprince', 'yuelian1234', 'youssefrefaat', 'sgu20091548', 'alaa98', 'mennaessam98', 'estradavictor96', 'sgu20171524', 'ge24', 'zeinabtaha', 'hananalamri', 'shinsunhak', 'mahmouddeghadi', 'ranaahmed96', 'thapu.putta', 'e0320957', 'sgu20151487', 'guitarist9816', 'sgu20151476', 'bluer', 'sgu20171556', 'mohamedkutb', 'ulas_965', 'mtmaccc', 'chen2712', 'omnia.khaled12', 'a960710', 'bentelghaly', 'jaydm26', 'lemon12345', 'gsabbir87', 'sgu20171508', 'as', 'uozgur', 'sgu20141424', 'e0186014', 'omar_eid73', 'sgu20141430', 'sgu20171503', 'sgu20141417', 'johnmccarthy', 'mustafaakhlak', 'chxxtu2009', 'sgu20151452', 'mohmedaliessa', 'sgu20141411', 'sgu20171526', 'nada5essam', 'salmaaatareeek', 'mohamedallam0000', 'qwu2', 'sgu20141395', 'han20151510', 'nkpuga', 'michaelashraf777', 'donghu', 'muhlasheen2', 'dvid0315', 'yhlee27', 'sgu20131508', 'sgu20141468', 'sgu20151485', 'ankitraj9', 'mostafa200100', 'sgu20121532', 'esoomoh64', 'sgu20151424', 'velurihasita', 'latifaalfardan', 'leo666', 'ibrahimkamal1997', 'assemabdelmoniem', 'julianna', 'zhangziyan', 'hgowaily', 'lindatalts', 'engtuan123', 'sgu20161494', 'loaydiaa', 'kabinaya08', 'mariamzanaty', 'sgu20171570', 'sgu20141483', 'zeyadahmedbadr97', 'gopijettiboyina841', 'nimashi001', 'nkvv88', 'mohamedabdelmeged', 'scientist.affawn', 'indronil.ghosh27', 'jackhoeniges', 'zackkk123', 'mimo007007', 'sgu20151513', 'mariomedhat9', 'michaelguevara', 'cbzkcbzk1', 'hagarkhaled', 'bperera', 'jorgealexandre', 'jojosazziz', 'salmasaher', 'tutulalala', 'shamyofficial2', 'karimfoda1', 'zhichongcarl', 'jlong1028', 'geek10', 'cuoghimarco', 'sgu20141393', 'hanamant17', 'amgadsami1998', 'mohanedayman', 'shaikyahul77', 'sgu20161503', 'zenaj', 'khaledshehab44', 'khaledhigazy94', 'saramahmoud19', 'rahmanr3', 'ayaabdelrahim', 'faharalalawi', 'sgu20141471', 'sgu20151194', 'lennynator92', 'dko1217', 'ooooo18', 'naderyosab67', 'sgu20141394', 'amirnabilhanna', 'moaz', 'ayoyayoyo2008', 'radwa123', 'toqa1999', 'mjkingdem', 'sgu20141408', 'ramyadel1313', 'mohanad.waheed9', 'sgu20121498', 'kingmokey', 'salman1999', 'hala97', 'sajaaadel', 'amrsaeed012', 'icey123', 'sgu20171550', 'youssef_essam', 'johan.iswara', 'ekhlas3535', 'f.elgebaly', 'hongyan', 'sgu20141461', 'visionsofshiva', 'sgu20131492', 'weeei0514', 'hour', 'mohameddomy97', 'zhangnianchen', 'youssef.yassermounir98', 'abdo1703', 'neuton']"
1,28,336,97,83,"['sgu20091548', 'sgu20171586', 'sgu20171524', 'jkson3', 'sg20121208', 'sgu20131481', 'sgu20151487', 'sgu20151476', 'sgu20171556', 'sgu20151422', 'sgu20141448', 'sgu20131507', 'tktm44', 'a960710', 'sgu20151438', 'sgu20171508', 'sgu20141424', 'sgu20141430', 'sgu20151486', 'sgu20171503', 'sgu20141417', 'sgu20131455', 'sgu20151452', 'sgu20141411', 'sgu20151456', 'sgu20171526', 'gjfdjzo', 'sgu20151464', 'sgu20141395', 'han20151510', 'sgu20131462', 'sgu20171566', 'sgu20131508', 'sgu20141414', 'sgu20141478', 'sgu20161542', 'sgu20141468', 'sgu20151485', 'sgu20161474', 'sgu20121532', 'sgu20131432', 'sgu20151436', 'sgu20171490', 'sgu20151424', 'dydgus201', 'sgu20151478', 'sgu20151418', 'sgu20171572', 'harry0913', 'sgu20171570', 'sgu20141483', 'ppjunb12', 'sgu20151513', 'sgu20141474', 'sgu20141393', 'sgu20141398', 'sgu20161503', 'sgu20161542e', 'sgu20151463', 'sgu20141460', 'sgu20141415', 'sgu20131410', 'sgu20171558', 'sgu20151194', 'sgu20141471', 'seohyeoniii', 'sgu20151410', 'sgu20141394', 'sgu20141408', 'sgu20171502', 'sgu20121498', 'sgu20171562', 'sgu20141389', 'sgu20171550', 'sgu20141461', 'sgu20141480', 'sgu20171520', 'sgu20141458', 'sgu20141484', 'sgu20131492', 'sgu20151490', 'sgu20131412', 'sgu20141476']",253,"['yasmine317', 'mitchelld2', 'ahmad.yasserr', 'asmaahussein99', 'wildprince', 'yuelian1234', 'engmo3taz99', 'john17.su', 'yusuf313', 'simon1205', 'hamedamr95', 'unal', 'youssefrefaat', 'alaa98', 'mennaessam98', 'luca.riccies', 'lisifan', 'tingyu.qu', 'memonona017', 'estradavictor96', 'ge24', 'heba_star1999', 'nadaessam', 'addashti', 'yara.magdy222', 'bellayang', 'zeinabtaha', 'muhammed.number', 'pradeep_c17', 'shinsunhak', 'hananalamri', 'mahmouddeghadi', 'ranaahmed96', 'thapu.putta', 'e0320957', 'guitarist9816', 'muhamriaz', 'bluer', 'mohamedkutb', 'almoatasem_bellah', 'sayeedrm', 'plloydwright', 'dsreynolds93', 'sgu2014726019', 'lamyaalfa', 'aubai.hassan98', 'a.omar125242', 'ulas_965', 'ayakhaled4897', 'mtmaccc', 'chen2712', 'c15444808', 'aradwa477', 'husalaa98', 'omnia.khaled12', 'shy19951119', 'bentelghaly', 'jaydm26', 'wenfeng', 'roddaro', 'omniapinkflower', 'hayaat', 'neuton', 'lemon12345', 'gsabbir87', 'as', 'uozgur', 'e0186014', 'omar_eid73', 'horstmannbm', 'wangmingzhu', 'mariam0', 'johnmccarthy', 'changlin2328', 'heshamebrahim123', 'wpsun319', 'mustafaakhlak', 'chxxtu2009', 'timmy_mer', 'mohmedaliessa', 'eric.kosdi', 'vb9237865', 'hamda', 'nalvarez92', 'nada5essam', 'monikaa', 'ionsko', 'salmaaatareeek', 'mohamedallam0000', 'qwu2', 'leeann901', 'nkpuga', 'weka_201219', 'michaelashraf777', 'abdulrahmangalal', 'donghu', 'hbg2112', 'goddoggo', 'duweigg', 'muhlasheen2', 'sogang20141460', 'dvid0315', 'yhlee27', 'tianzk2', 'mohammed_naveed', 'nayeramansour', 'juhu93', 'youmna.moussa2016', 'ankitraj9', 'mostafa200100', 'abdelazimmohamed98', 'esoomoh64', 'hanamantmn999', 'bassem8989', 'velurihasita', 'nourhanmagdymahmoud', 'latifaalfardan', 'jxc248006', 'leo666', 'ibrahimkamal1997', 'julianna', 'assemabdelmoniem', 'aya.mohamed97', 'zhangziyan', 'hgowaily', 'akarkotis94', 'lindatalts', 'engtuan123', 'bassem_mazen', 'nelwagdy', 'ataulmamun', 'sgu20161494', 'loaydiaa', 'kabinaya08', 'mariamzanaty', 'ayamohamed', 'demonleon1995', 'caowd92', 'yangqu', 'zeyadahmedbadr97', 'gopijettiboyina841', 'nimashi001', 'nkvv88', 'nayerakhaled', 'mennatallamostafa87', 'nahlatarek', 'mohamedabdelmeged', 'scientist.affawn', 'indronil.ghosh27', 'jackhoeniges', 'ahmadabdelsalam', 'bguillet', 'xanxo18', 'naremanallam40', 'henryhe9806', 'mimo007007', 'zackkk123', 'zjhnus', 'mazen_ashraf', 'mariomedhat9', 'michaelguevara', 'sikaislam66', 'asmaagamalelsayed96', 'cbzkcbzk1', 'hagarkhaled', 'nouran_mohamed', 'bperera', 'salmasaher', 'jorgealexandre', 'tutulalala', 'jojosazziz', 'shamyofficial2', 'abdelrhmanadelhassan', 'jlong1028', 'basmahassan697', 'yaozu', 'jhoeniges', 'zhichongcarl', 'akshayb', 'cuoghimarco', 'hanamant17', 'amgadsami1998', 'mdabrarshaikh90', 'qky0921', 'shaikyahul77', 'yasmin.gad412', 'simon6599', 'lincolnwang321', 'arvindh', 'a0928404798', 'zenaj', 'khaledshehab44', 'khaledhigazy94', 'nouran.tarek97', 'saramahmoud19', 'rahmanr3', 'ayaabdelrahim', 'faharalalawi', 'lennynator92', 'dko1217', 'rinap', 'aymansaadhack', 'ooooo18', 'olashazly27', 'georgesamy', 'amirnabilhanna', 'gehadosama', 'monakamel97', 'bbaekssun', 'ayoyayoyo2008', 'radwa123', 'toqa1999', 'cxu004', 'jishen', 'tahaa.rore', 'marwan.m96', 'mjkingdem', 'joanliu951001', 'ramyadel1313', 'mohanad.waheed9', 'omarz977', 'kingmokey', 'salman1999', 'hala97', 'ruodaz', 'yayman55', 'radu.uta93', 'amrsaeed012', 'icey123', 'smrsaravanan', 'amjadtaleb', 'anas_massoud', 'youssef_essam', 'johan.iswara', 'ankita.patil.0001', 'mayura0621', 'ekhlas3535', 'f.elgebaly', 'hongyan', 'mohammedmajdyict', 'labmiugac2993', 'visionsofshiva', 'weeei0514', 'gyl0428', 'hour', 'nada.omran', 'jiamin2068', 'mohameddomy97', 'tokahossam71', 'ahmedmoustafa771', 'zhangnianchen', 'abdo1703', 'basmagharieb']",14,"['sgu20141385', 'sgu20141433', 'sgu20121462', 'sgu20141404', 'sgu20101498', 'sgu20141465', 'dusxo124', 'sgu20151448', 'claritas', 'sgu20161535', 'sgu20171538', 'sgu20141459', None, 'sgu20141450']",350,"['yasmine317', 'mitchelld2', 'john17.su', 'asmaahussein99', 'engmo3taz99', 'simon1205', 'hamedamr95', 'unal', 'luca.riccies', 'sgu20171586', 'lisifan', 'tingyu.qu', 'memonona017', 'heba_star1999', 'jkson3', 'nadaessam', 'sgu20121462', 'addashti', 'yara.magdy222', 'bellayang', 'sg20121208', 'muhammed.number', 'pradeep_c17', 'sgu20131481', 'muhamriaz', 'almoatasem_bellah', 'sayeedrm', 'sgu20151422', 'sgu20141448', 'plloydwright', 'sgu20131507', 'dsreynolds93', 'sgu2014726019', 'lamyaalfa', 'aubai.hassan98', 'a.omar125242', 'ayakhaled4897', 'c15444808', 'tktm44', 'aradwa477', 'husalaa98', 'shy19951119', 'sgu20141433', 'sgu20151438', 'wenfeng', 'roddaro', 'omniapinkflower', 'hayaat', 'sgu20171538', 'horstmannbm', 'sgu20151486', 'wangmingzhu', 'mariam0', 'changlin2328', 'heshamebrahim123', 'wpsun319', 'sgu20131455', 'timmy_mer', 'eric.kosdi', 'vb9237865', 'sgu20151456', 'hamda', 'nalvarez92', 'gjfdjzo', 'ionsko', 'sgu20151464', 'monikaa', 'leeann901', 'weka_201219', 'abdulrahmangalal', 'sgu20131462', 'hbg2112', 'goddoggo', 'duweigg', 'sogang20141460', 'sgu20141478', 'sgu20171566', 'sgu20141414', 'sgu20161542', 'tianzk2', 'mohammed_naveed', 'nayeramansour', 'juhu93', 'youmna.moussa2016', 'sgu20161474', 'dusxo124', 'abdelazimmohamed98', 'sgu20131432', 'sgu20171490', 'sgu20151436', 'hanamantmn999', 'dydgus201', 'bassem8989', 'nourhanmagdymahmoud', 'jxc248006', 'aya.mohamed97', 'sgu20151478', 'akarkotis94', 'sgu20151418', 'bassem_mazen', 'sgu20171572', 'nelwagdy', 'ataulmamun', 'ayamohamed', 'harry0913', 'demonleon1995', 'caowd92', 'yangqu', 'sgu20101498', 'ppjunb12', 'nayerakhaled', 'mennatallamostafa87', 'nahlatarek', 'ahmadabdelsalam', 'bguillet', 'xanxo18', 'naremanallam40', 'henryhe9806', 'zjhnus', 'mazen_ashraf', 'sikaislam66', 'asmaagamalelsayed96', 'nouran_mohamed', 'sgu20141474', 'abdelrhmanadelhassan', 'basmahassan697', 'yaozu', 'jhoeniges', 'akshayb', 'mdabrarshaikh90', 'sgu20141398', 'qky0921', 'sgu20161542e', 'yasmin.gad412', 'simon6599', 'sgu20151463', 'lincolnwang321', 'arvindh', 'sgu20141460', 'sgu20141415', 'a0928404798', 'sgu20131410', 'sgu20171558', 'nouran.tarek97', 'seohyeoniii', 'rinap', 'aymansaadhack', 'olashazly27', 'sgu20151410', 'georgesamy', 'gehadosama', 'monakamel97', 'bbaekssun', 'jishen', 'cxu004', 'tahaa.rore', 'marwan.m96', 'sgu20141465', 'joanliu951001', 'sgu20171502', 'omarz977', 'sgu20171562', 'ruodaz', 'yayman55', 'radu.uta93', 'smrsaravanan', 'amjadtaleb', 'anas_massoud', 'sgu20141389', 'ankita.patil.0001', 'mayura0621', 'mohammedmajdyict', 'labmiugac2993', 'sgu20141480', None, 'sgu20171520', 'sgu20141458', 'sgu20141484', 'gyl0428', 'sgu20151490', 'sgu20131412', 'sgu20141476', 'nada.omran', 'jiamin2068', 'tokahossam71', 'ahmedmoustafa771', 'basmagharieb', 'yusuf313', 'ahmad.yasserr', 'wildprince', 'yuelian1234', 'youssefrefaat', 'sgu20091548', 'alaa98', 'mennaessam98', 'sgu20161535', 'estradavictor96', 'sgu20171524', 'ge24', 'zeinabtaha', 'hananalamri', 'shinsunhak', 'mahmouddeghadi', 'ranaahmed96', 'thapu.putta', 'e0320957', 'sgu20151487', 'guitarist9816', 'sgu20151476', 'bluer', 'sgu20171556', 'mohamedkutb', 'ulas_965', 'mtmaccc', 'chen2712', 'omnia.khaled12', 'a960710', 'bentelghaly', 'jaydm26', 'lemon12345', 'gsabbir87', 'sgu20171508', 'as', 'uozgur', 'sgu20141424', 'e0186014', 'omar_eid73', 'sgu20141430', 'sgu20171503', 'sgu20141417', 'johnmccarthy', 'mustafaakhlak', 'chxxtu2009', 'sgu20151452', 'mohmedaliessa', 'sgu20141411', 'sgu20171526', 'nada5essam', 'salmaaatareeek', 'mohamedallam0000', 'qwu2', 'sgu20141395', 'han20151510', 'nkpuga', 'michaelashraf777', 'donghu', 'muhlasheen2', 'dvid0315', 'yhlee27', 'sgu20131508', 'sgu20141468', 'sgu20151485', 'ankitraj9', 'mostafa200100', 'sgu20121532', 'esoomoh64', 'sgu20151424', 'velurihasita', 'latifaalfardan', 'leo666', 'ibrahimkamal1997', 'assemabdelmoniem', 'julianna', 'sgu20141404', 'zhangziyan', 'hgowaily', 'lindatalts', 'engtuan123', 'sgu20161494', 'loaydiaa', 'kabinaya08', 'mariamzanaty', 'sgu20171570', 'sgu20141483', 'zeyadahmedbadr97', 'gopijettiboyina841', 'nimashi001', 'nkvv88', 'mohamedabdelmeged', 'scientist.affawn', 'indronil.ghosh27', 'jackhoeniges', 'zackkk123', 'mimo007007', 'sgu20151513', 'mariomedhat9', 'michaelguevara', 'cbzkcbzk1', 'hagarkhaled', 'bperera', 'jorgealexandre', 'jojosazziz', 'salmasaher', 'tutulalala', 'shamyofficial2', 'zhichongcarl', 'jlong1028', 'cuoghimarco', 'sgu20141393', 'hanamant17', 'amgadsami1998', 'shaikyahul77', 'sgu20161503', 'zenaj', 'khaledshehab44', 'khaledhigazy94', 'saramahmoud19', 'rahmanr3', 'ayaabdelrahim', 'faharalalawi', 'sgu20141471', 'sgu20151194', 'lennynator92', 'dko1217', 'ooooo18', 'sgu20151448', 'sgu20141394', 'amirnabilhanna', 'ayoyayoyo2008', 'radwa123', 'toqa1999', 'mjkingdem', 'sgu20141408', 'ramyadel1313', 'mohanad.waheed9', 'claritas', 'sgu20121498', 'sgu20141459', 'kingmokey', 'salman1999', 'hala97', 'amrsaeed012', 'icey123', 'sgu20171550', 'youssef_essam', 'johan.iswara', 'ekhlas3535', 'f.elgebaly', 'hongyan', 'sgu20141461', 'visionsofshiva', 'sgu20141385', 'sgu20141450', 'sgu20131492', 'weeei0514', 'hour', 'mohameddomy97', 'zhangnianchen', 'abdo1703', 'neuton']"
1,29,336,84,76,"['yusuf313', 'ahmad.yasserr', 'asmaahussein99', 'wildprince', 'mariamzanaty', 'engmo3taz99', 'ayamohamed', 'aymansaadhack', 'olashazly27', 'mustafaakhlak', 'youssefrefaat', 'mohmedaliessa', 'mennaessam98', 'gehadosama', 'zeyadahmedbadr97', 'memonona017', 'ayoyayoyo2008', 'heba_star1999', 'nayerakhaled', 'radwa123', 'nadaessam', 'nada5essam', 'salmaaatareeek', 'monikaa', 'zeinabtaha', 'nahlatarek', 'tahaa.rore', 'marwan.m96', 'mjkingdem', 'muhammed.number', 'michaelashraf777', 'mahmouddeghadi', 'weka_201219', 'ahmadabdelsalam', 'abdulrahmangalal', 'mohanad.waheed9', 'naremanallam40', 'mimo007007', 'hala97', 'mohamedkutb', 'almoatasem_bellah', 'nouran.tarek97', 'mariomedhat9', 'hagarkhaled', 'sikaislam66', 'jojosazziz', 'nouran_mohamed', 'salmasaher', 'shamyofficial2', 'youssef_essam', 'a.omar125242', 'abdelrhmanadelhassan', 'ayakhaled4897', 'basmahassan697', 'mostafa200100', 'f.elgebaly', 'abdelazimmohamed98', 'esoomoh64', 'mohammedmajdyict', 'aradwa477', 'omnia.khaled12', 'bassem8989', 'bentelghaly', 'ibrahimkamal1997', 'yasmin.gad412', 'nada.omran', 'omniapinkflower', 'tokahossam71', 'ahmedmoustafa771', 'as', 'khaledshehab44', 'bassem_mazen', 'abdo1703', 'ayaabdelrahim', 'basmagharieb', 'omar_eid73']",260,"['yasmine317', 'mitchelld2', 'john17.su', 'yuelian1234', 'simon1205', 'hamedamr95', 'unal', 'sgu20091548', 'alaa98', 'luca.riccies', 'sgu20171586', 'lisifan', 'tingyu.qu', 'sgu20171524', 'estradavictor96', 'ge24', 'jkson3', 'addashti', 'yara.magdy222', 'bellayang', 'sg20121208', 'pradeep_c17', 'sgu20131481', 'shinsunhak', 'hananalamri', 'ranaahmed96', 'thapu.putta', 'e0320957', 'sgu20151487', 'guitarist9816', 'muhamriaz', 'sgu20151476', 'bluer', 'sgu20171556', 'sayeedrm', 'sgu20151422', 'sgu20141448', 'plloydwright', 'sgu20131507', 'dsreynolds93', 'sgu2014726019', 'lamyaalfa', 'aubai.hassan98', 'ulas_965', 'mtmaccc', 'chen2712', 'c15444808', 'tktm44', 'husalaa98', 'a960710', 'shy19951119', 'jaydm26', 'sgu20151438', 'wenfeng', 'roddaro', 'hayaat', 'lemon12345', 'gsabbir87', 'sgu20171508', 'uozgur', 'sgu20141424', 'e0186014', 'horstmannbm', 'sgu20151486', 'sgu20141430', 'sgu20171503', 'wangmingzhu', 'mariam0', 'sgu20141417', 'changlin2328', 'heshamebrahim123', 'wpsun319', 'johnmccarthy', 'sgu20131455', 'chxxtu2009', 'sgu20151452', 'timmy_mer', 'eric.kosdi', 'vb9237865', 'sgu20141411', 'sgu20151456', 'hamda', 'nalvarez92', 'sgu20171526', 'mohamedallam0000', 'gjfdjzo', 'ionsko', 'sgu20151464', 'qwu2', 'leeann901', 'sgu20141395', 'han20151510', 'nkpuga', 'sgu20131462', 'donghu', 'hbg2112', 'goddoggo', 'duweigg', 'muhlasheen2', 'sgu20141478', 'sogang20141460', 'sgu20171566', 'sgu20141414', 'dvid0315', 'sgu20141468', 'sgu20161542', 'yhlee27', 'sgu20131508', 'tianzk2', 'mohammed_naveed', 'nayeramansour', 'sgu20151485', 'juhu93', 'youmna.moussa2016', 'sgu20161474', 'ankitraj9', 'sgu20121532', 'sgu20151424', 'sgu20131432', 'sgu20171490', 'sgu20151436', 'hanamantmn999', 'dydgus201', 'velurihasita', 'nourhanmagdymahmoud', 'latifaalfardan', 'jxc248006', 'leo666', 'assemabdelmoniem', 'julianna', 'aya.mohamed97', 'sgu20151478', 'zhangziyan', 'hgowaily', 'akarkotis94', 'lindatalts', 'sgu20151418', 'engtuan123', 'sgu20171572', 'nelwagdy', 'ataulmamun', 'sgu20161494', 'loaydiaa', 'kabinaya08', 'harry0913', 'demonleon1995', 'caowd92', 'sgu20171570', 'yangqu', 'sgu20141483', 'gopijettiboyina841', 'nimashi001', 'ppjunb12', 'nkvv88', 'mennatallamostafa87', 'mohamedabdelmeged', 'scientist.affawn', 'indronil.ghosh27', 'jackhoeniges', 'bguillet', 'xanxo18', 'zackkk123', 'henryhe9806', 'zjhnus', 'sgu20151513', 'mazen_ashraf', 'michaelguevara', 'cbzkcbzk1', 'bperera', 'asmaagamalelsayed96', 'jorgealexandre', 'tutulalala', 'sgu20141474', 'zhichongcarl', 'jlong1028', 'yaozu', 'jhoeniges', 'akshayb', 'sgu20141393', 'cuoghimarco', 'amgadsami1998', 'hanamant17', 'mdabrarshaikh90', 'sgu20141398', 'qky0921', 'shaikyahul77', 'sgu20161542e', 'sgu20161503', 'simon6599', 'sgu20151463', 'lincolnwang321', 'arvindh', 'sgu20141460', 'sgu20141415', 'a0928404798', 'sgu20131410', 'khaledhigazy94', 'sgu20171558', 'zenaj', 'saramahmoud19', 'rahmanr3', 'sgu20151194', 'faharalalawi', 'sgu20141471', 'seohyeoniii', 'lennynator92', 'dko1217', 'rinap', 'ooooo18', 'sgu20151410', 'georgesamy', 'sgu20141394', 'amirnabilhanna', 'monakamel97', 'bbaekssun', 'toqa1999', 'cxu004', 'jishen', 'sgu20141408', 'joanliu951001', 'sgu20171502', 'ramyadel1313', 'omarz977', 'sgu20121498', 'kingmokey', 'salman1999', 'sgu20171562', 'ruodaz', 'yayman55', 'radu.uta93', 'amrsaeed012', 'icey123', 'smrsaravanan', 'amjadtaleb', 'anas_massoud', 'sgu20141389', 'sgu20171550', 'johan.iswara', 'ankita.patil.0001', 'mayura0621', 'ekhlas3535', 'hongyan', 'labmiugac2993', 'sgu20141461', 'sgu20141480', 'visionsofshiva', 'sgu20171520', 'sgu20141458', 'sgu20141484', 'sgu20131492', 'weeei0514', 'gyl0428', 'sgu20151490', 'sgu20131412', 'hour', 'sgu20141476', 'jiamin2068', 'mohameddomy97', 'zhangnianchen', 'neuton']",8,"['veroveronica08', 'ayakhaled', 'youssef.yassermounir98', 'nado.mahmoud1995', 'sajaaadel', 'moaz', None, 'youstinamagdy']",344,"['yasmine317', 'mitchelld2', 'john17.su', 'asmaahussein99', 'engmo3taz99', 'simon1205', 'hamedamr95', 'unal', 'luca.riccies', 'sgu20171586', 'lisifan', 'tingyu.qu', 'memonona017', 'heba_star1999', 'jkson3', 'nadaessam', 'addashti', 'yara.magdy222', 'bellayang', 'sg20121208', 'muhammed.number', 'pradeep_c17', 'sgu20131481', 'muhamriaz', 'almoatasem_bellah', 'sayeedrm', 'sgu20151422', 'sgu20141448', 'plloydwright', 'sgu20131507', 'dsreynolds93', 'sgu2014726019', 'lamyaalfa', 'aubai.hassan98', 'a.omar125242', 'ayakhaled4897', 'c15444808', 'tktm44', 'aradwa477', 'husalaa98', 'shy19951119', 'sgu20151438', 'wenfeng', 'roddaro', 'omniapinkflower', 'hayaat', 'horstmannbm', 'sgu20151486', 'wangmingzhu', 'mariam0', 'changlin2328', 'heshamebrahim123', 'wpsun319', 'sgu20131455', 'timmy_mer', 'eric.kosdi', 'vb9237865', 'sgu20151456', 'hamda', 'nalvarez92', 'gjfdjzo', 'ionsko', 'sgu20151464', 'monikaa', 'leeann901', 'weka_201219', 'abdulrahmangalal', 'sgu20131462', 'hbg2112', 'goddoggo', 'duweigg', 'sogang20141460', 'sgu20141478', 'sgu20171566', 'sgu20141414', 'youstinamagdy', 'sgu20161542', 'tianzk2', 'mohammed_naveed', 'nayeramansour', 'juhu93', 'youmna.moussa2016', 'sgu20161474', 'abdelazimmohamed98', 'sgu20131432', 'sgu20171490', 'sgu20151436', 'hanamantmn999', 'dydgus201', 'bassem8989', 'nourhanmagdymahmoud', 'jxc248006', 'aya.mohamed97', 'sgu20151478', 'akarkotis94', 'sgu20151418', 'bassem_mazen', 'sgu20171572', 'nelwagdy', 'nado.mahmoud1995', 'ataulmamun', 'ayamohamed', 'harry0913', 'demonleon1995', 'caowd92', 'yangqu', 'ppjunb12', 'nayerakhaled', 'mennatallamostafa87', 'nahlatarek', 'ahmadabdelsalam', 'bguillet', 'xanxo18', 'naremanallam40', 'henryhe9806', 'zjhnus', 'mazen_ashraf', 'sikaislam66', 'asmaagamalelsayed96', 'nouran_mohamed', 'sgu20141474', 'abdelrhmanadelhassan', 'basmahassan697', 'yaozu', 'jhoeniges', 'akshayb', 'mdabrarshaikh90', 'sgu20141398', 'qky0921', 'sgu20161542e', 'yasmin.gad412', 'simon6599', 'sgu20151463', 'lincolnwang321', 'arvindh', 'sgu20141460', 'sgu20141415', 'a0928404798', 'sgu20131410', 'sgu20171558', 'nouran.tarek97', 'seohyeoniii', 'rinap', 'aymansaadhack', 'olashazly27', 'sgu20151410', 'georgesamy', 'gehadosama', 'monakamel97', 'bbaekssun', 'jishen', 'cxu004', 'tahaa.rore', 'marwan.m96', 'joanliu951001', 'sgu20171502', 'omarz977', 'sgu20171562', 'ruodaz', 'yayman55', 'radu.uta93', 'smrsaravanan', 'amjadtaleb', 'anas_massoud', 'sgu20141389', 'ankita.patil.0001', 'mayura0621', 'mohammedmajdyict', 'labmiugac2993', 'sgu20141480', None, 'sgu20171520', 'sgu20141458', 'sgu20141484', 'gyl0428', 'sgu20151490', 'sgu20131412', 'sgu20141476', 'nada.omran', 'jiamin2068', 'tokahossam71', 'ahmedmoustafa771', 'basmagharieb', 'yusuf313', 'ahmad.yasserr', 'wildprince', 'yuelian1234', 'youssefrefaat', 'sgu20091548', 'alaa98', 'mennaessam98', 'estradavictor96', 'sgu20171524', 'ge24', 'zeinabtaha', 'hananalamri', 'shinsunhak', 'mahmouddeghadi', 'ranaahmed96', 'thapu.putta', 'e0320957', 'sgu20151487', 'guitarist9816', 'sgu20151476', 'bluer', 'sgu20171556', 'mohamedkutb', 'ulas_965', 'mtmaccc', 'chen2712', 'omnia.khaled12', 'a960710', 'bentelghaly', 'jaydm26', 'lemon12345', 'gsabbir87', 'sgu20171508', 'as', 'uozgur', 'sgu20141424', 'e0186014', 'omar_eid73', 'sgu20141430', 'sgu20171503', 'veroveronica08', 'sgu20141417', 'johnmccarthy', 'mustafaakhlak', 'chxxtu2009', 'sgu20151452', 'mohmedaliessa', 'sgu20141411', 'sgu20171526', 'nada5essam', 'salmaaatareeek', 'mohamedallam0000', 'qwu2', 'sgu20141395', 'han20151510', 'nkpuga', 'michaelashraf777', 'donghu', 'muhlasheen2', 'dvid0315', 'yhlee27', 'sgu20131508', 'sgu20141468', 'sgu20151485', 'ankitraj9', 'mostafa200100', 'sgu20121532', 'esoomoh64', 'sgu20151424', 'velurihasita', 'latifaalfardan', 'leo666', 'ibrahimkamal1997', 'assemabdelmoniem', 'julianna', 'zhangziyan', 'hgowaily', 'lindatalts', 'engtuan123', 'sgu20161494', 'loaydiaa', 'kabinaya08', 'mariamzanaty', 'sgu20171570', 'sgu20141483', 'zeyadahmedbadr97', 'gopijettiboyina841', 'nimashi001', 'nkvv88', 'mohamedabdelmeged', 'scientist.affawn', 'indronil.ghosh27', 'jackhoeniges', 'zackkk123', 'mimo007007', 'sgu20151513', 'mariomedhat9', 'michaelguevara', 'cbzkcbzk1', 'hagarkhaled', 'bperera', 'jorgealexandre', 'jojosazziz', 'salmasaher', 'tutulalala', 'shamyofficial2', 'zhichongcarl', 'jlong1028', 'cuoghimarco', 'sgu20141393', 'hanamant17', 'amgadsami1998', 'shaikyahul77', 'sgu20161503', 'ayakhaled', 'zenaj', 'khaledshehab44', 'khaledhigazy94', 'saramahmoud19', 'rahmanr3', 'ayaabdelrahim', 'faharalalawi', 'sgu20141471', 'sgu20151194', 'lennynator92', 'dko1217', 'ooooo18', 'sgu20141394', 'amirnabilhanna', 'moaz', 'ayoyayoyo2008', 'radwa123', 'toqa1999', 'mjkingdem', 'sgu20141408', 'ramyadel1313', 'mohanad.waheed9', 'sgu20121498', 'kingmokey', 'salman1999', 'hala97', 'sajaaadel', 'amrsaeed012', 'icey123', 'sgu20171550', 'youssef_essam', 'johan.iswara', 'ekhlas3535', 'f.elgebaly', 'hongyan', 'sgu20141461', 'visionsofshiva', 'sgu20131492', 'weeei0514', 'hour', 'mohameddomy97', 'zhangnianchen', 'youssef.yassermounir98', 'abdo1703', 'neuton']"
1,19,336,62,60,"['kabinaya08', 'john17.su', 'lennynator92', 'yuelian1234', 'wangmingzhu', 'changlin2328', 'ooooo18', 'simon1205', 'demonleon1995', 'caowd92', 'yangqu', 'eric.kosdi', 'lisifan', 'tingyu.qu', 'nimashi001', 'bellayang', 'jishen', 'cxu004', 'leeann901', 'qwu2', 'pradeep_c17', 'joanliu951001', 'e0320957', 'thapu.putta', 'xanxo18', 'zackkk123', 'kingmokey', 'duweigg', 'zjhnus', 'bluer', 'bperera', 'jorgealexandre', 'smrsaravanan', 'tianzk2', 'icey123', 'johan.iswara', 'mayura0621', 'jlong1028', 'zhichongcarl', 'yaozu', 'hongyan', 'visionsofshiva', 'hanamant17', 'hanamantmn999', 'velurihasita', 'shy19951119', 'qky0921', 'gyl0428', 'wenfeng', 'lincolnwang321', 'julianna', 'simon6599', 'jiamin2068', 'arvindh', 'zhangziyan', 'lemon12345', 'zhangnianchen', 'zenaj', 'engtuan123', 'e0186014']",276,"['yasmine317', 'mitchelld2', 'asmaahussein99', 'engmo3taz99', 'hamedamr95', 'unal', 'luca.riccies', 'sgu20171586', 'memonona017', 'heba_star1999', 'jkson3', 'nadaessam', 'addashti', 'yara.magdy222', 'sg20121208', 'muhammed.number', 'sgu20131481', 'muhamriaz', 'almoatasem_bellah', 'sayeedrm', 'sgu20151422', 'sgu20141448', 'plloydwright', 'sgu20131507', 'dsreynolds93', 'sgu2014726019', 'lamyaalfa', 'aubai.hassan98', 'a.omar125242', 'ayakhaled4897', 'c15444808', 'tktm44', 'aradwa477', 'husalaa98', 'sgu20151438', 'roddaro', 'omniapinkflower', 'hayaat', 'horstmannbm', 'sgu20151486', 'mariam0', 'heshamebrahim123', 'wpsun319', 'sgu20131455', 'timmy_mer', 'vb9237865', 'sgu20151456', 'hamda', 'nalvarez92', 'gjfdjzo', 'ionsko', 'sgu20151464', 'monikaa', 'weka_201219', 'abdulrahmangalal', 'sgu20131462', 'hbg2112', 'goddoggo', 'sogang20141460', 'sgu20141478', 'sgu20171566', 'sgu20141414', 'sgu20161542', 'mohammed_naveed', 'nayeramansour', 'juhu93', 'youmna.moussa2016', 'sgu20161474', 'abdelazimmohamed98', 'sgu20131432', 'sgu20171490', 'sgu20151436', 'dydgus201', 'bassem8989', 'nourhanmagdymahmoud', 'jxc248006', 'aya.mohamed97', 'sgu20151478', 'akarkotis94', 'sgu20151418', 'bassem_mazen', 'sgu20171572', 'nelwagdy', 'ataulmamun', 'ayamohamed', 'harry0913', 'ppjunb12', 'nayerakhaled', 'mennatallamostafa87', 'nahlatarek', 'ahmadabdelsalam', 'bguillet', 'naremanallam40', 'henryhe9806', 'mazen_ashraf', 'sikaislam66', 'asmaagamalelsayed96', 'nouran_mohamed', 'sgu20141474', 'abdelrhmanadelhassan', 'basmahassan697', 'jhoeniges', 'akshayb', 'mdabrarshaikh90', 'sgu20141398', 'sgu20161542e', 'yasmin.gad412', 'sgu20151463', 'sgu20141460', 'sgu20141415', 'a0928404798', 'sgu20131410', 'sgu20171558', 'nouran.tarek97', 'seohyeoniii', 'rinap', 'aymansaadhack', 'olashazly27', 'sgu20151410', 'georgesamy', 'gehadosama', 'monakamel97', 'bbaekssun', 'tahaa.rore', 'marwan.m96', 'sgu20171502', 'omarz977', 'sgu20171562', 'ruodaz', 'yayman55', 'radu.uta93', 'amjadtaleb', 'anas_massoud', 'sgu20141389', 'ankita.patil.0001', 'mohammedmajdyict', 'labmiugac2993', 'sgu20141480', 'sgu20171520', 'sgu20141458', 'sgu20141484', 'sgu20151490', 'sgu20131412', 'sgu20141476', 'nada.omran', 'tokahossam71', 'ahmedmoustafa771', 'basmagharieb', 'yusuf313', 'ahmad.yasserr', 'wildprince', 'youssefrefaat', 'sgu20091548', 'alaa98', 'mennaessam98', 'estradavictor96', 'sgu20171524', 'ge24', 'zeinabtaha', 'hananalamri', 'shinsunhak', 'mahmouddeghadi', 'ranaahmed96', 'sgu20151487', 'guitarist9816', 'sgu20151476', 'sgu20171556', 'mohamedkutb', 'ulas_965', 'mtmaccc', 'chen2712', 'omnia.khaled12', 'a960710', 'bentelghaly', 'jaydm26', 'gsabbir87', 'sgu20171508', 'as', 'uozgur', 'sgu20141424', 'omar_eid73', 'sgu20141430', 'sgu20171503', 'sgu20141417', 'johnmccarthy', 'mustafaakhlak', 'chxxtu2009', 'sgu20151452', 'mohmedaliessa', 'sgu20141411', 'sgu20171526', 'nada5essam', 'salmaaatareeek', 'mohamedallam0000', 'sgu20141395', 'han20151510', 'nkpuga', 'michaelashraf777', 'donghu', 'muhlasheen2', 'dvid0315', 'yhlee27', 'sgu20131508', 'sgu20141468', 'sgu20151485', 'ankitraj9', 'mostafa200100', 'sgu20121532', 'esoomoh64', 'sgu20151424', 'latifaalfardan', 'leo666', 'ibrahimkamal1997', 'assemabdelmoniem', 'hgowaily', 'lindatalts', 'sgu20161494', 'loaydiaa', 'mariamzanaty', 'sgu20171570', 'sgu20141483', 'zeyadahmedbadr97', 'gopijettiboyina841', 'nkvv88', 'mohamedabdelmeged', 'scientist.affawn', 'indronil.ghosh27', 'jackhoeniges', 'mimo007007', 'sgu20151513', 'mariomedhat9', 'michaelguevara', 'cbzkcbzk1', 'hagarkhaled', 'jojosazziz', 'salmasaher', 'tutulalala', 'shamyofficial2', 'cuoghimarco', 'sgu20141393', 'amgadsami1998', 'shaikyahul77', 'sgu20161503', 'khaledshehab44', 'khaledhigazy94', 'saramahmoud19', 'rahmanr3', 'ayaabdelrahim', 'faharalalawi', 'sgu20141471', 'sgu20151194', 'dko1217', 'sgu20141394', 'amirnabilhanna', 'ayoyayoyo2008', 'radwa123', 'toqa1999', 'mjkingdem', 'sgu20141408', 'ramyadel1313', 'mohanad.waheed9', 'sgu20121498', 'salman1999', 'hala97', 'amrsaeed012', 'sgu20171550', 'youssef_essam', 'ekhlas3535', 'f.elgebaly', 'sgu20141461', 'sgu20131492', 'weeei0514', 'hour', 'mohameddomy97', 'abdo1703', 'neuton']",2,"[None, 'xfong']",338,"['yasmine317', 'mitchelld2', 'john17.su', 'asmaahussein99', 'engmo3taz99', 'simon1205', 'hamedamr95', 'unal', 'luca.riccies', 'sgu20171586', 'lisifan', 'tingyu.qu', 'memonona017', 'heba_star1999', 'jkson3', 'nadaessam', 'addashti', 'yara.magdy222', 'bellayang', 'sg20121208', 'muhammed.number', 'pradeep_c17', 'sgu20131481', 'muhamriaz', 'almoatasem_bellah', 'sayeedrm', 'sgu20151422', 'sgu20141448', 'plloydwright', 'sgu20131507', 'dsreynolds93', 'sgu2014726019', 'lamyaalfa', 'aubai.hassan98', 'a.omar125242', 'ayakhaled4897', 'c15444808', 'tktm44', 'aradwa477', 'husalaa98', 'shy19951119', 'sgu20151438', 'wenfeng', 'roddaro', 'omniapinkflower', 'hayaat', 'horstmannbm', 'sgu20151486', 'wangmingzhu', 'mariam0', 'changlin2328', 'heshamebrahim123', 'wpsun319', 'sgu20131455', 'timmy_mer', 'eric.kosdi', 'vb9237865', 'sgu20151456', 'hamda', 'nalvarez92', 'gjfdjzo', 'ionsko', 'sgu20151464', 'monikaa', 'leeann901', 'weka_201219', 'abdulrahmangalal', 'sgu20131462', 'hbg2112', 'goddoggo', 'duweigg', 'sogang20141460', 'sgu20141478', 'sgu20171566', 'sgu20141414', 'sgu20161542', 'tianzk2', 'mohammed_naveed', 'nayeramansour', 'juhu93', 'youmna.moussa2016', 'sgu20161474', 'abdelazimmohamed98', 'sgu20131432', 'sgu20171490', 'sgu20151436', 'hanamantmn999', 'dydgus201', 'bassem8989', 'nourhanmagdymahmoud', 'jxc248006', 'aya.mohamed97', 'sgu20151478', 'akarkotis94', 'sgu20151418', 'bassem_mazen', 'sgu20171572', 'nelwagdy', 'ataulmamun', 'ayamohamed', 'harry0913', 'demonleon1995', 'caowd92', 'yangqu', 'ppjunb12', 'nayerakhaled', 'mennatallamostafa87', 'nahlatarek', 'ahmadabdelsalam', 'bguillet', 'xanxo18', 'naremanallam40', 'henryhe9806', 'zjhnus', 'mazen_ashraf', 'sikaislam66', 'asmaagamalelsayed96', 'nouran_mohamed', 'sgu20141474', 'abdelrhmanadelhassan', 'basmahassan697', 'yaozu', 'jhoeniges', 'akshayb', 'mdabrarshaikh90', 'sgu20141398', 'qky0921', 'sgu20161542e', 'yasmin.gad412', 'simon6599', 'sgu20151463', 'lincolnwang321', 'arvindh', 'sgu20141460', 'sgu20141415', 'a0928404798', 'sgu20131410', 'sgu20171558', 'nouran.tarek97', 'seohyeoniii', 'rinap', 'aymansaadhack', 'olashazly27', 'sgu20151410', 'georgesamy', 'gehadosama', 'monakamel97', 'bbaekssun', 'jishen', 'cxu004', 'tahaa.rore', 'marwan.m96', 'joanliu951001', 'sgu20171502', 'omarz977', 'sgu20171562', 'ruodaz', 'yayman55', 'radu.uta93', 'smrsaravanan', 'amjadtaleb', 'anas_massoud', 'sgu20141389', 'ankita.patil.0001', 'mayura0621', 'mohammedmajdyict', 'labmiugac2993', 'sgu20141480', None, 'sgu20171520', 'sgu20141458', 'sgu20141484', 'gyl0428', 'sgu20151490', 'sgu20131412', 'sgu20141476', 'nada.omran', 'jiamin2068', 'tokahossam71', 'ahmedmoustafa771', 'basmagharieb', 'yusuf313', 'ahmad.yasserr', 'wildprince', 'yuelian1234', 'youssefrefaat', 'sgu20091548', 'alaa98', 'mennaessam98', 'estradavictor96', 'sgu20171524', 'ge24', 'zeinabtaha', 'hananalamri', 'shinsunhak', 'mahmouddeghadi', 'ranaahmed96', 'thapu.putta', 'e0320957', 'sgu20151487', 'guitarist9816', 'sgu20151476', 'bluer', 'sgu20171556', 'mohamedkutb', 'ulas_965', 'mtmaccc', 'chen2712', 'omnia.khaled12', 'a960710', 'bentelghaly', 'jaydm26', 'lemon12345', 'gsabbir87', 'sgu20171508', 'as', 'uozgur', 'sgu20141424', 'e0186014', 'omar_eid73', 'sgu20141430', 'sgu20171503', 'sgu20141417', 'johnmccarthy', 'mustafaakhlak', 'chxxtu2009', 'sgu20151452', 'mohmedaliessa', 'sgu20141411', 'sgu20171526', 'nada5essam', 'salmaaatareeek', 'mohamedallam0000', 'qwu2', 'sgu20141395', 'han20151510', 'nkpuga', 'michaelashraf777', 'donghu', 'muhlasheen2', 'dvid0315', 'yhlee27', 'sgu20131508', 'sgu20141468', 'sgu20151485', 'ankitraj9', 'mostafa200100', 'sgu20121532', 'esoomoh64', 'sgu20151424', 'velurihasita', 'latifaalfardan', 'leo666', 'ibrahimkamal1997', 'assemabdelmoniem', 'julianna', 'zhangziyan', 'hgowaily', 'lindatalts', 'engtuan123', 'sgu20161494', 'loaydiaa', 'kabinaya08', 'mariamzanaty', 'sgu20171570', 'sgu20141483', 'zeyadahmedbadr97', 'gopijettiboyina841', 'nimashi001', 'nkvv88', 'mohamedabdelmeged', 'scientist.affawn', 'indronil.ghosh27', 'jackhoeniges', 'zackkk123', 'mimo007007', 'sgu20151513', 'mariomedhat9', 'michaelguevara', 'cbzkcbzk1', 'hagarkhaled', 'bperera', 'jorgealexandre', 'jojosazziz', 'salmasaher', 'tutulalala', 'shamyofficial2', 'zhichongcarl', 'jlong1028', 'cuoghimarco', 'sgu20141393', 'hanamant17', 'amgadsami1998', 'shaikyahul77', 'sgu20161503', 'zenaj', 'khaledshehab44', 'khaledhigazy94', 'saramahmoud19', 'rahmanr3', 'ayaabdelrahim', 'faharalalawi', 'sgu20141471', 'sgu20151194', 'lennynator92', 'dko1217', 'ooooo18', 'sgu20141394', 'amirnabilhanna', 'ayoyayoyo2008', 'radwa123', 'xfong', 'toqa1999', 'mjkingdem', 'sgu20141408', 'ramyadel1313', 'mohanad.waheed9', 'sgu20121498', 'kingmokey', 'salman1999', 'hala97', 'amrsaeed012', 'icey123', 'sgu20171550', 'youssef_essam', 'johan.iswara', 'ekhlas3535', 'f.elgebaly', 'hongyan', 'sgu20141461', 'visionsofshiva', 'sgu20131492', 'weeei0514', 'hour', 'mohameddomy97', 'zhangnianchen', 'abdo1703', 'neuton']"
1,243,336,59,1,['shaikyahul77'],335,"['yasmine317', 'mitchelld2', 'john17.su', 'asmaahussein99', 'engmo3taz99', 'simon1205', 'hamedamr95', 'unal', 'luca.riccies', 'sgu20171586', 'lisifan', 'tingyu.qu', 'memonona017', 'heba_star1999', 'jkson3', 'nadaessam', 'addashti', 'yara.magdy222', 'bellayang', 'sg20121208', 'muhammed.number', 'pradeep_c17', 'sgu20131481', 'muhamriaz', 'almoatasem_bellah', 'sayeedrm', 'sgu20151422', 'sgu20141448', 'plloydwright', 'sgu20131507', 'dsreynolds93', 'sgu2014726019', 'lamyaalfa', 'aubai.hassan98', 'a.omar125242', 'ayakhaled4897', 'c15444808', 'tktm44', 'aradwa477', 'husalaa98', 'shy19951119', 'sgu20151438', 'wenfeng', 'roddaro', 'omniapinkflower', 'hayaat', 'horstmannbm', 'sgu20151486', 'wangmingzhu', 'mariam0', 'changlin2328', 'heshamebrahim123', 'wpsun319', 'sgu20131455', 'timmy_mer', 'eric.kosdi', 'vb9237865', 'sgu20151456', 'hamda', 'nalvarez92', 'gjfdjzo', 'ionsko', 'sgu20151464', 'monikaa', 'leeann901', 'weka_201219', 'abdulrahmangalal', 'sgu20131462', 'hbg2112', 'goddoggo', 'duweigg', 'sogang20141460', 'sgu20141478', 'sgu20171566', 'sgu20141414', 'sgu20161542', 'tianzk2', 'mohammed_naveed', 'nayeramansour', 'juhu93', 'youmna.moussa2016', 'sgu20161474', 'abdelazimmohamed98', 'sgu20131432', 'sgu20171490', 'sgu20151436', 'hanamantmn999', 'dydgus201', 'bassem8989', 'nourhanmagdymahmoud', 'jxc248006', 'aya.mohamed97', 'sgu20151478', 'akarkotis94', 'sgu20151418', 'bassem_mazen', 'sgu20171572', 'nelwagdy', 'ataulmamun', 'ayamohamed', 'harry0913', 'demonleon1995', 'caowd92', 'yangqu', 'ppjunb12', 'nayerakhaled', 'mennatallamostafa87', 'nahlatarek', 'ahmadabdelsalam', 'bguillet', 'xanxo18', 'naremanallam40', 'henryhe9806', 'zjhnus', 'mazen_ashraf', 'sikaislam66', 'asmaagamalelsayed96', 'nouran_mohamed', 'sgu20141474', 'abdelrhmanadelhassan', 'basmahassan697', 'yaozu', 'jhoeniges', 'akshayb', 'mdabrarshaikh90', 'sgu20141398', 'qky0921', 'sgu20161542e', 'yasmin.gad412', 'simon6599', 'sgu20151463', 'lincolnwang321', 'arvindh', 'sgu20141460', 'sgu20141415', 'a0928404798', 'sgu20131410', 'sgu20171558', 'nouran.tarek97', 'seohyeoniii', 'rinap', 'aymansaadhack', 'olashazly27', 'sgu20151410', 'georgesamy', 'gehadosama', 'monakamel97', 'bbaekssun', 'jishen', 'cxu004', 'tahaa.rore', 'marwan.m96', 'joanliu951001', 'sgu20171502', 'omarz977', 'sgu20171562', 'ruodaz', 'yayman55', 'radu.uta93', 'smrsaravanan', 'amjadtaleb', 'anas_massoud', 'sgu20141389', 'ankita.patil.0001', 'mayura0621', 'mohammedmajdyict', 'labmiugac2993', 'sgu20141480', 'sgu20171520', 'sgu20141458', 'sgu20141484', 'gyl0428', 'sgu20151490', 'sgu20131412', 'sgu20141476', 'nada.omran', 'jiamin2068', 'tokahossam71', 'ahmedmoustafa771', 'basmagharieb', 'yusuf313', 'ahmad.yasserr', 'wildprince', 'yuelian1234', 'youssefrefaat', 'sgu20091548', 'alaa98', 'mennaessam98', 'estradavictor96', 'sgu20171524', 'ge24', 'zeinabtaha', 'hananalamri', 'shinsunhak', 'mahmouddeghadi', 'ranaahmed96', 'thapu.putta', 'e0320957', 'sgu20151487', 'guitarist9816', 'sgu20151476', 'bluer', 'sgu20171556', 'mohamedkutb', 'ulas_965', 'mtmaccc', 'chen2712', 'omnia.khaled12', 'a960710', 'bentelghaly', 'jaydm26', 'lemon12345', 'gsabbir87', 'sgu20171508', 'as', 'uozgur', 'sgu20141424', 'e0186014', 'omar_eid73', 'sgu20141430', 'sgu20171503', 'sgu20141417', 'johnmccarthy', 'mustafaakhlak', 'chxxtu2009', 'sgu20151452', 'mohmedaliessa', 'sgu20141411', 'sgu20171526', 'nada5essam', 'salmaaatareeek', 'mohamedallam0000', 'qwu2', 'sgu20141395', 'han20151510', 'nkpuga', 'michaelashraf777', 'donghu', 'muhlasheen2', 'dvid0315', 'yhlee27', 'sgu20131508', 'sgu20141468', 'sgu20151485', 'ankitraj9', 'mostafa200100', 'sgu20121532', 'esoomoh64', 'sgu20151424', 'velurihasita', 'latifaalfardan', 'leo666', 'ibrahimkamal1997', 'assemabdelmoniem', 'julianna', 'zhangziyan', 'hgowaily', 'lindatalts', 'engtuan123', 'sgu20161494', 'loaydiaa', 'kabinaya08', 'mariamzanaty', 'sgu20171570', 'sgu20141483', 'zeyadahmedbadr97', 'gopijettiboyina841', 'nimashi001', 'nkvv88', 'mohamedabdelmeged', 'scientist.affawn', 'indronil.ghosh27', 'jackhoeniges', 'zackkk123', 'mimo007007', 'sgu20151513', 'mariomedhat9', 'michaelguevara', 'cbzkcbzk1', 'hagarkhaled', 'bperera', 'jorgealexandre', 'jojosazziz', 'salmasaher', 'tutulalala', 'shamyofficial2', 'zhichongcarl', 'jlong1028', 'cuoghimarco', 'sgu20141393', 'hanamant17', 'amgadsami1998', 'sgu20161503', 'zenaj', 'khaledshehab44', 'khaledhigazy94', 'saramahmoud19', 'rahmanr3', 'ayaabdelrahim', 'faharalalawi', 'sgu20141471', 'sgu20151194', 'lennynator92', 'dko1217', 'ooooo18', 'sgu20141394', 'amirnabilhanna', 'ayoyayoyo2008', 'radwa123', 'toqa1999', 'mjkingdem', 'sgu20141408', 'ramyadel1313', 'mohanad.waheed9', 'sgu20121498', 'kingmokey', 'salman1999', 'hala97', 'amrsaeed012', 'icey123', 'sgu20171550', 'youssef_essam', 'johan.iswara', 'ekhlas3535', 'f.elgebaly', 'hongyan', 'sgu20141461', 'visionsofshiva', 'sgu20131492', 'weeei0514', 'hour', 'mohameddomy97', 'zhangnianchen', 'abdo1703', 'neuton']",58,"['gayalanagaanudeep183', 'kannarevanth123', 'alexandra', 'harshavardhan211099', 'anu27111999', 'alaikvenumadhav', 'surendar2042', 'saikumar1919sms', 'indub', 'bellala9182', 'mdevendrareddy21', 'divyalathamidhun12', 'kotakondaarunteja', 'chekuripradeep888', 'pradeepsanapala22', 'mercyevangelin03', 'chekkatchyutkumar', 'suryaboddupalli.3216', 'nandisrividya123', 'sugansugumar55', 'mounika.punati07', 'akhilchandaka111', 'manivinay777', 'mohanakrishna1', 'jonahjoni7', 'pandubabu819', 'lalithyareddy9', 'saikumarkanisetty525', 'chaithualadi', 'prasadsai481', 'swetha.yerabapu', 'sukeshbsr', 'kundasrinivasulu55', 'vijaydurgareddy9', 'swaroop6055', 'naveennani19991', 'bathulasrikanth135', 'gowthamnt.vik333', 'gurakalasravanisravs', 'shivakumar1999', 'azharab839', 'sreenivassree0143', 'manjuladrp', 'bhargavibharu9876', 'rajasekhar.j33', 'gunasekharreddy.thummala', None, 'vrprasanna38118114', 'dharma879reddy', 'sakethchinna424', 'gundlapallecharanya', 'manojmaverick19', 'susmithainturi02', 'rahuljayanthi83', 'lavanyavarapana111', 'subhasrithathineni', 'chennakesavareddy200', 'sreenusree1789']",394,"['yasmine317', 'mitchelld2', 'john17.su', 'asmaahussein99', 'engmo3taz99', 'simon1205', 'hamedamr95', 'unal', 'pradeepsanapala22', 'luca.riccies', 'sgu20171586', 'lisifan', 'tingyu.qu', 'memonona017', 'heba_star1999', 'jkson3', 'nadaessam', 'addashti', 'yara.magdy222', 'bellayang', 'sg20121208', 'muhammed.number', 'pradeep_c17', 'sgu20131481', 'muhamriaz', 'almoatasem_bellah', 'sayeedrm', 'sgu20151422', 'sgu20141448', 'plloydwright', 'sgu20131507', 'dsreynolds93', 'sgu2014726019', 'lamyaalfa', 'aubai.hassan98', 'a.omar125242', 'gurakalasravanisravs', 'ayakhaled4897', 'c15444808', 'rajasekhar.j33', 'tktm44', 'aradwa477', 'husalaa98', 'shy19951119', 'dharma879reddy', 'sgu20151438', 'sakethchinna424', 'wenfeng', 'roddaro', 'omniapinkflower', 'hayaat', 'horstmannbm', 'sgu20151486', 'wangmingzhu', 'mariam0', 'changlin2328', 'heshamebrahim123', 'wpsun319', 'sgu20131455', 'timmy_mer', 'eric.kosdi', 'vb9237865', 'sgu20151456', 'hamda', 'nalvarez92', 'gjfdjzo', 'ionsko', 'sgu20151464', 'monikaa', 'leeann901', 'weka_201219', 'abdulrahmangalal', 'sgu20131462', 'hbg2112', 'swetha.yerabapu', 'goddoggo', 'duweigg', 'sogang20141460', 'sgu20141478', 'sgu20171566', 'sgu20141414', 'sgu20161542', 'tianzk2', 'mohammed_naveed', 'nayeramansour', 'juhu93', 'youmna.moussa2016', 'sgu20161474', 'abdelazimmohamed98', 'sgu20131432', 'sgu20171490', 'sgu20151436', 'bhargavibharu9876', 'hanamantmn999', 'dydgus201', 'bassem8989', 'nourhanmagdymahmoud', 'jxc248006', 'aya.mohamed97', 'sgu20151478', 'akarkotis94', 'sgu20151418', 'bassem_mazen', 'sgu20171572', 'nelwagdy', 'ataulmamun', 'ayamohamed', 'harry0913', 'demonleon1995', 'caowd92', 'divyalathamidhun12', 'yangqu', 'kotakondaarunteja', 'ppjunb12', 'nayerakhaled', 'mennatallamostafa87', 'nahlatarek', 'manivinay777', 'jonahjoni7', 'ahmadabdelsalam', 'bguillet', 'xanxo18', 'naremanallam40', 'henryhe9806', 'zjhnus', 'mazen_ashraf', 'sikaislam66', 'asmaagamalelsayed96', 'nouran_mohamed', 'sgu20141474', 'abdelrhmanadelhassan', 'basmahassan697', 'yaozu', 'jhoeniges', 'akshayb', 'mdabrarshaikh90', 'sgu20141398', 'qky0921', 'vrprasanna38118114', 'sgu20161542e', 'yasmin.gad412', 'simon6599', 'sgu20151463', 'lincolnwang321', 'arvindh', 'sgu20141460', 'sgu20141415', 'a0928404798', 'sgu20131410', 'sgu20171558', 'nouran.tarek97', 'chennakesavareddy200', 'gayalanagaanudeep183', 'seohyeoniii', 'harshavardhan211099', 'alexandra', 'rinap', 'aymansaadhack', 'anu27111999', 'olashazly27', 'sgu20151410', 'georgesamy', 'gehadosama', 'chekkatchyutkumar', 'monakamel97', 'bbaekssun', 'jishen', 'cxu004', 'tahaa.rore', 'marwan.m96', 'mohanakrishna1', 'joanliu951001', 'sgu20171502', 'omarz977', 'sgu20171562', 'ruodaz', 'yayman55', 'radu.uta93', 'kundasrinivasulu55', 'vijaydurgareddy9', 'smrsaravanan', 'amjadtaleb', 'anas_massoud', 'sgu20141389', 'ankita.patil.0001', 'mayura0621', 'sreenivassree0143', 'mohammedmajdyict', 'labmiugac2993', 'sgu20141480', None, 'sgu20171520', 'sgu20141458', 'sgu20141484', 'gyl0428', 'sgu20151490', 'sgu20131412', 'sgu20141476', 'nada.omran', 'jiamin2068', 'tokahossam71', 'ahmedmoustafa771', 'basmagharieb', 'yusuf313', 'ahmad.yasserr', 'wildprince', 'yuelian1234', 'saikumar1919sms', 'indub', 'youssefrefaat', 'bellala9182', 'mdevendrareddy21', 'sgu20091548', 'alaa98', 'mennaessam98', 'estradavictor96', 'sgu20171524', 'ge24', 'nandisrividya123', 'zeinabtaha', 'hananalamri', 'shinsunhak', 'mahmouddeghadi', 'ranaahmed96', 'thapu.putta', 'e0320957', 'sgu20151487', 'guitarist9816', 'prasadsai481', 'sgu20151476', 'bluer', 'sgu20171556', 'mohamedkutb', 'ulas_965', 'mtmaccc', 'shivakumar1999', 'chen2712', 'omnia.khaled12', 'a960710', 'bentelghaly', 'jaydm26', 'gundlapallecharanya', 'lemon12345', 'gsabbir87', 'sgu20171508', 'as', 'rahuljayanthi83', 'uozgur', 'sgu20141424', 'e0186014', 'omar_eid73', 'sgu20141430', 'sgu20171503', 'sgu20141417', 'johnmccarthy', 'alaikvenumadhav', 'mustafaakhlak', 'chxxtu2009', 'sgu20151452', 'mohmedaliessa', 'mercyevangelin03', 'sgu20141411', 'sgu20171526', 'nada5essam', 'salmaaatareeek', 'mohamedallam0000', 'mounika.punati07', 'qwu2', 'sgu20141395', 'pandubabu819', 'han20151510', 'nkpuga', 'michaelashraf777', 'lalithyareddy9', 'saikumarkanisetty525', 'donghu', 'muhlasheen2', 'sukeshbsr', 'dvid0315', 'yhlee27', 'sgu20131508', 'sgu20141468', 'naveennani19991', 'sgu20151485', 'ankitraj9', 'mostafa200100', 'sgu20121532', 'esoomoh64', 'sgu20151424', 'velurihasita', 'latifaalfardan', 'leo666', 'ibrahimkamal1997', 'assemabdelmoniem', 'julianna', 'zhangziyan', 'hgowaily', 'lindatalts', 'manojmaverick19', 'engtuan123', 'subhasrithathineni', 'sgu20161494', 'loaydiaa', 'sreenusree1789', 'kabinaya08', 'kannarevanth123', 'mariamzanaty', 'sgu20171570', 'sgu20141483', 'chekuripradeep888', 'zeyadahmedbadr97', 'gopijettiboyina841', 'nimashi001', 'suryaboddupalli.3216', 'nkvv88', 'mohamedabdelmeged', 'scientist.affawn', 'indronil.ghosh27', 'jackhoeniges', 'chaithualadi', 'zackkk123', 'mimo007007', 'sgu20151513', 'mariomedhat9', 'michaelguevara', 'cbzkcbzk1', 'hagarkhaled', 'bperera', 'jorgealexandre', 'jojosazziz', 'salmasaher', 'tutulalala', 'gowthamnt.vik333', 'shamyofficial2', 'zhichongcarl', 'jlong1028', 'cuoghimarco', 'sgu20141393', 'hanamant17', 'amgadsami1998', 'gunasekharreddy.thummala', 'shaikyahul77', 'sgu20161503', 'zenaj', 'khaledshehab44', 'khaledhigazy94', 'saramahmoud19', 'rahmanr3', 'ayaabdelrahim', 'faharalalawi', 'sgu20141471', 'sgu20151194', 'lennynator92', 'dko1217', 'ooooo18', 'surendar2042', 'sgu20141394', 'amirnabilhanna', 'ayoyayoyo2008', 'radwa123', 'sugansugumar55', 'akhilchandaka111', 'toqa1999', 'mjkingdem', 'sgu20141408', 'ramyadel1313', 'mohanad.waheed9', 'sgu20121498', 'kingmokey', 'salman1999', 'hala97', 'amrsaeed012', 'icey123', 'swaroop6055', 'bathulasrikanth135', 'sgu20171550', 'youssef_essam', 'johan.iswara', 'azharab839', 'ekhlas3535', 'f.elgebaly', 'hongyan', 'manjuladrp', 'sgu20141461', 'visionsofshiva', 'sgu20131492', 'weeei0514', 'hour', 'mohameddomy97', 'zhangnianchen', 'susmithainturi02', 'abdo1703', 'lavanyavarapana111', 'neuton']"
1,22,336,43,34,"['sgu20141417', 'harry0913', 'sgu20131455', 'sgu20141483', 'sgu20141394', 'sgu20141411', 'ppjunb12', 'gjfdjzo', 'sgu20141395', 'sg20121208', 'sgu20141408', 'sgu20131481', 'sgu20131462', 'sgu20151487', 'sogang20141460', 'sgu20131508', 'sgu20141448', 'sgu20141468', 'sgu20131507', 'sgu20141389', 'sgu20151485', 'sgu2014726019', 'sgu20161474', 'sgu20131432', 'sgu20141393', 'sgu20161503', 'sgu20131412', 'sgu20141476', 'sgu20141460', 'sgu20141415', 'sgu20131410', 'sgu20151194', 'sgu20161494', 'sgu20141471']",302,"['yasmine317', 'mitchelld2', 'john17.su', 'asmaahussein99', 'engmo3taz99', 'simon1205', 'hamedamr95', 'unal', 'luca.riccies', 'sgu20171586', 'lisifan', 'tingyu.qu', 'memonona017', 'heba_star1999', 'jkson3', 'nadaessam', 'addashti', 'yara.magdy222', 'bellayang', 'muhammed.number', 'pradeep_c17', 'muhamriaz', 'almoatasem_bellah', 'sayeedrm', 'sgu20151422', 'plloydwright', 'dsreynolds93', 'lamyaalfa', 'aubai.hassan98', 'a.omar125242', 'ayakhaled4897', 'c15444808', 'tktm44', 'aradwa477', 'husalaa98', 'shy19951119', 'sgu20151438', 'wenfeng', 'roddaro', 'omniapinkflower', 'hayaat', 'horstmannbm', 'sgu20151486', 'wangmingzhu', 'mariam0', 'changlin2328', 'heshamebrahim123', 'wpsun319', 'timmy_mer', 'eric.kosdi', 'vb9237865', 'sgu20151456', 'hamda', 'nalvarez92', 'ionsko', 'sgu20151464', 'monikaa', 'leeann901', 'weka_201219', 'abdulrahmangalal', 'hbg2112', 'goddoggo', 'duweigg', 'sgu20141478', 'sgu20171566', 'sgu20141414', 'sgu20161542', 'tianzk2', 'mohammed_naveed', 'nayeramansour', 'juhu93', 'youmna.moussa2016', 'abdelazimmohamed98', 'sgu20171490', 'sgu20151436', 'hanamantmn999', 'dydgus201', 'bassem8989', 'nourhanmagdymahmoud', 'jxc248006', 'aya.mohamed97', 'sgu20151478', 'akarkotis94', 'sgu20151418', 'bassem_mazen', 'sgu20171572', 'nelwagdy', 'ataulmamun', 'ayamohamed', 'demonleon1995', 'caowd92', 'yangqu', 'nayerakhaled', 'mennatallamostafa87', 'nahlatarek', 'ahmadabdelsalam', 'bguillet', 'xanxo18', 'naremanallam40', 'henryhe9806', 'zjhnus', 'mazen_ashraf', 'sikaislam66', 'asmaagamalelsayed96', 'nouran_mohamed', 'sgu20141474', 'abdelrhmanadelhassan', 'basmahassan697', 'yaozu', 'jhoeniges', 'akshayb', 'mdabrarshaikh90', 'sgu20141398', 'qky0921', 'sgu20161542e', 'yasmin.gad412', 'simon6599', 'sgu20151463', 'lincolnwang321', 'arvindh', 'a0928404798', 'sgu20171558', 'nouran.tarek97', 'seohyeoniii', 'rinap', 'aymansaadhack', 'olashazly27', 'sgu20151410', 'georgesamy', 'gehadosama', 'monakamel97', 'bbaekssun', 'jishen', 'cxu004', 'tahaa.rore', 'marwan.m96', 'joanliu951001', 'sgu20171502', 'omarz977', 'sgu20171562', 'ruodaz', 'yayman55', 'radu.uta93', 'smrsaravanan', 'amjadtaleb', 'anas_massoud', 'ankita.patil.0001', 'mayura0621', 'mohammedmajdyict', 'labmiugac2993', 'sgu20141480', 'sgu20171520', 'sgu20141458', 'sgu20141484', 'gyl0428', 'sgu20151490', 'nada.omran', 'jiamin2068', 'tokahossam71', 'ahmedmoustafa771', 'basmagharieb', 'yusuf313', 'ahmad.yasserr', 'wildprince', 'yuelian1234', 'youssefrefaat', 'sgu20091548', 'alaa98', 'mennaessam98', 'estradavictor96', 'sgu20171524', 'ge24', 'zeinabtaha', 'hananalamri', 'shinsunhak', 'mahmouddeghadi', 'ranaahmed96', 'thapu.putta', 'e0320957', 'guitarist9816', 'sgu20151476', 'bluer', 'sgu20171556', 'mohamedkutb', 'ulas_965', 'mtmaccc', 'chen2712', 'omnia.khaled12', 'a960710', 'bentelghaly', 'jaydm26', 'lemon12345', 'gsabbir87', 'sgu20171508', 'as', 'uozgur', 'sgu20141424', 'e0186014', 'omar_eid73', 'sgu20141430', 'sgu20171503', 'johnmccarthy', 'mustafaakhlak', 'chxxtu2009', 'sgu20151452', 'mohmedaliessa', 'sgu20171526', 'nada5essam', 'salmaaatareeek', 'mohamedallam0000', 'qwu2', 'han20151510', 'nkpuga', 'michaelashraf777', 'donghu', 'muhlasheen2', 'dvid0315', 'yhlee27', 'ankitraj9', 'mostafa200100', 'sgu20121532', 'esoomoh64', 'sgu20151424', 'velurihasita', 'latifaalfardan', 'leo666', 'ibrahimkamal1997', 'assemabdelmoniem', 'julianna', 'zhangziyan', 'hgowaily', 'lindatalts', 'engtuan123', 'loaydiaa', 'kabinaya08', 'mariamzanaty', 'sgu20171570', 'zeyadahmedbadr97', 'gopijettiboyina841', 'nimashi001', 'nkvv88', 'mohamedabdelmeged', 'scientist.affawn', 'indronil.ghosh27', 'jackhoeniges', 'zackkk123', 'mimo007007', 'sgu20151513', 'mariomedhat9', 'michaelguevara', 'cbzkcbzk1', 'hagarkhaled', 'bperera', 'jorgealexandre', 'jojosazziz', 'salmasaher', 'tutulalala', 'shamyofficial2', 'zhichongcarl', 'jlong1028', 'cuoghimarco', 'hanamant17', 'amgadsami1998', 'shaikyahul77', 'zenaj', 'khaledshehab44', 'khaledhigazy94', 'saramahmoud19', 'rahmanr3', 'ayaabdelrahim', 'faharalalawi', 'lennynator92', 'dko1217', 'ooooo18', 'amirnabilhanna', 'ayoyayoyo2008', 'radwa123', 'toqa1999', 'mjkingdem', 'ramyadel1313', 'mohanad.waheed9', 'sgu20121498', 'kingmokey', 'salman1999', 'hala97', 'amrsaeed012', 'icey123', 'sgu20171550', 'youssef_essam', 'johan.iswara', 'ekhlas3535', 'f.elgebaly', 'hongyan', 'sgu20141461', 'visionsofshiva', 'sgu20131492', 'weeei0514', 'hour', 'mohameddomy97', 'zhangnianchen', 'abdo1703', 'neuton']",9,"['sgu20121462', 'sgu20141465', 'sgu20141441', 'sgu20131458', 'sgu960911', 'sgu20141459', 'sgu20141385', None, 'sgu20141450']",345,"['yasmine317', 'mitchelld2', 'john17.su', 'asmaahussein99', 'engmo3taz99', 'simon1205', 'hamedamr95', 'unal', 'luca.riccies', 'sgu20171586', 'lisifan', 'tingyu.qu', 'memonona017', 'heba_star1999', 'jkson3', 'nadaessam', 'sgu20121462', 'addashti', 'yara.magdy222', 'bellayang', 'sg20121208', 'muhammed.number', 'pradeep_c17', 'sgu20131481', 'muhamriaz', 'almoatasem_bellah', 'sayeedrm', 'sgu20151422', 'sgu20141448', 'plloydwright', 'sgu20131507', 'dsreynolds93', 'sgu2014726019', 'lamyaalfa', 'aubai.hassan98', 'a.omar125242', 'ayakhaled4897', 'c15444808', 'tktm44', 'aradwa477', 'husalaa98', 'shy19951119', 'sgu20151438', 'wenfeng', 'roddaro', 'omniapinkflower', 'hayaat', 'horstmannbm', 'sgu20151486', 'wangmingzhu', 'mariam0', 'changlin2328', 'heshamebrahim123', 'wpsun319', 'sgu20131455', 'sgu960911', 'timmy_mer', 'eric.kosdi', 'vb9237865', 'sgu20151456', 'hamda', 'nalvarez92', 'gjfdjzo', 'ionsko', 'sgu20151464', 'monikaa', 'leeann901', 'weka_201219', 'abdulrahmangalal', 'sgu20131462', 'hbg2112', 'goddoggo', 'duweigg', 'sogang20141460', 'sgu20141478', 'sgu20171566', 'sgu20141414', 'sgu20161542', 'tianzk2', 'mohammed_naveed', 'nayeramansour', 'juhu93', 'youmna.moussa2016', 'sgu20161474', 'abdelazimmohamed98', 'sgu20131432', 'sgu20171490', 'sgu20151436', 'hanamantmn999', 'dydgus201', 'bassem8989', 'nourhanmagdymahmoud', 'jxc248006', 'aya.mohamed97', 'sgu20151478', 'akarkotis94', 'sgu20151418', 'bassem_mazen', 'sgu20171572', 'nelwagdy', 'ataulmamun', 'ayamohamed', 'harry0913', 'demonleon1995', 'caowd92', 'sgu20141441', 'yangqu', 'ppjunb12', 'nayerakhaled', 'mennatallamostafa87', 'nahlatarek', 'ahmadabdelsalam', 'bguillet', 'xanxo18', 'naremanallam40', 'henryhe9806', 'zjhnus', 'mazen_ashraf', 'sikaislam66', 'asmaagamalelsayed96', 'nouran_mohamed', 'sgu20141474', 'abdelrhmanadelhassan', 'basmahassan697', 'yaozu', 'jhoeniges', 'akshayb', 'mdabrarshaikh90', 'sgu20141398', 'qky0921', 'sgu20161542e', 'yasmin.gad412', 'simon6599', 'sgu20151463', 'lincolnwang321', 'arvindh', 'sgu20141460', 'sgu20141415', 'a0928404798', 'sgu20131410', 'sgu20171558', 'nouran.tarek97', 'seohyeoniii', 'rinap', 'aymansaadhack', 'olashazly27', 'sgu20151410', 'georgesamy', 'gehadosama', 'monakamel97', 'bbaekssun', 'jishen', 'cxu004', 'tahaa.rore', 'marwan.m96', 'sgu20141465', 'joanliu951001', 'sgu20171502', 'omarz977', 'sgu20171562', 'ruodaz', 'yayman55', 'radu.uta93', 'smrsaravanan', 'amjadtaleb', 'anas_massoud', 'sgu20141389', 'ankita.patil.0001', 'mayura0621', 'mohammedmajdyict', 'labmiugac2993', 'sgu20141480', None, 'sgu20171520', 'sgu20141458', 'sgu20141484', 'gyl0428', 'sgu20151490', 'sgu20131412', 'sgu20141476', 'nada.omran', 'jiamin2068', 'tokahossam71', 'ahmedmoustafa771', 'basmagharieb', 'yusuf313', 'ahmad.yasserr', 'wildprince', 'yuelian1234', 'youssefrefaat', 'sgu20091548', 'alaa98', 'mennaessam98', 'estradavictor96', 'sgu20171524', 'ge24', 'zeinabtaha', 'hananalamri', 'shinsunhak', 'mahmouddeghadi', 'ranaahmed96', 'thapu.putta', 'e0320957', 'sgu20151487', 'guitarist9816', 'sgu20151476', 'bluer', 'sgu20171556', 'mohamedkutb', 'ulas_965', 'mtmaccc', 'chen2712', 'omnia.khaled12', 'a960710', 'bentelghaly', 'jaydm26', 'lemon12345', 'gsabbir87', 'sgu20171508', 'as', 'uozgur', 'sgu20141424', 'e0186014', 'omar_eid73', 'sgu20141430', 'sgu20171503', 'sgu20141417', 'johnmccarthy', 'mustafaakhlak', 'chxxtu2009', 'sgu20151452', 'sgu20131458', 'mohmedaliessa', 'sgu20141411', 'sgu20171526', 'nada5essam', 'salmaaatareeek', 'mohamedallam0000', 'qwu2', 'sgu20141395', 'han20151510', 'nkpuga', 'michaelashraf777', 'donghu', 'muhlasheen2', 'dvid0315', 'yhlee27', 'sgu20131508', 'sgu20141468', 'sgu20151485', 'ankitraj9', 'mostafa200100', 'sgu20121532', 'esoomoh64', 'sgu20151424', 'velurihasita', 'latifaalfardan', 'leo666', 'ibrahimkamal1997', 'assemabdelmoniem', 'julianna', 'zhangziyan', 'hgowaily', 'lindatalts', 'engtuan123', 'sgu20161494', 'loaydiaa', 'kabinaya08', 'mariamzanaty', 'sgu20171570', 'sgu20141483', 'zeyadahmedbadr97', 'gopijettiboyina841', 'nimashi001', 'nkvv88', 'mohamedabdelmeged', 'scientist.affawn', 'indronil.ghosh27', 'jackhoeniges', 'zackkk123', 'mimo007007', 'sgu20151513', 'mariomedhat9', 'michaelguevara', 'cbzkcbzk1', 'hagarkhaled', 'bperera', 'jorgealexandre', 'jojosazziz', 'salmasaher', 'tutulalala', 'shamyofficial2', 'zhichongcarl', 'jlong1028', 'cuoghimarco', 'sgu20141393', 'hanamant17', 'amgadsami1998', 'shaikyahul77', 'sgu20161503', 'zenaj', 'khaledshehab44', 'khaledhigazy94', 'saramahmoud19', 'rahmanr3', 'ayaabdelrahim', 'faharalalawi', 'sgu20141471', 'sgu20151194', 'lennynator92', 'dko1217', 'ooooo18', 'sgu20141394', 'amirnabilhanna', 'ayoyayoyo2008', 'radwa123', 'toqa1999', 'mjkingdem', 'sgu20141408', 'ramyadel1313', 'mohanad.waheed9', 'sgu20121498', 'sgu20141459', 'kingmokey', 'salman1999', 'hala97', 'amrsaeed012', 'icey123', 'sgu20171550', 'youssef_essam', 'johan.iswara', 'ekhlas3535', 'f.elgebaly', 'hongyan', 'sgu20141461', 'visionsofshiva', 'sgu20141385', 'sgu20141450', 'sgu20131492', 'weeei0514', 'hour', 'mohameddomy97', 'zhangnianchen', 'abdo1703', 'neuton']"
1,235,336,27,3,"['sgu20141483', 'sgu20151485', 'sgu20131432']",333,"['yasmine317', 'mitchelld2', 'john17.su', 'asmaahussein99', 'engmo3taz99', 'simon1205', 'hamedamr95', 'unal', 'luca.riccies', 'sgu20171586', 'lisifan', 'tingyu.qu', 'memonona017', 'heba_star1999', 'jkson3', 'nadaessam', 'addashti', 'yara.magdy222', 'bellayang', 'sg20121208', 'muhammed.number', 'pradeep_c17', 'sgu20131481', 'muhamriaz', 'almoatasem_bellah', 'sayeedrm', 'sgu20151422', 'sgu20141448', 'plloydwright', 'sgu20131507', 'dsreynolds93', 'sgu2014726019', 'lamyaalfa', 'aubai.hassan98', 'a.omar125242', 'ayakhaled4897', 'c15444808', 'tktm44', 'aradwa477', 'husalaa98', 'shy19951119', 'sgu20151438', 'wenfeng', 'roddaro', 'omniapinkflower', 'hayaat', 'horstmannbm', 'sgu20151486', 'wangmingzhu', 'mariam0', 'changlin2328', 'heshamebrahim123', 'wpsun319', 'sgu20131455', 'timmy_mer', 'eric.kosdi', 'vb9237865', 'sgu20151456', 'hamda', 'nalvarez92', 'gjfdjzo', 'ionsko', 'sgu20151464', 'monikaa', 'leeann901', 'weka_201219', 'abdulrahmangalal', 'sgu20131462', 'hbg2112', 'goddoggo', 'duweigg', 'sogang20141460', 'sgu20141478', 'sgu20171566', 'sgu20141414', 'sgu20161542', 'tianzk2', 'mohammed_naveed', 'nayeramansour', 'juhu93', 'youmna.moussa2016', 'sgu20161474', 'abdelazimmohamed98', 'sgu20171490', 'sgu20151436', 'hanamantmn999', 'dydgus201', 'bassem8989', 'nourhanmagdymahmoud', 'jxc248006', 'aya.mohamed97', 'sgu20151478', 'akarkotis94', 'sgu20151418', 'bassem_mazen', 'sgu20171572', 'nelwagdy', 'ataulmamun', 'ayamohamed', 'harry0913', 'demonleon1995', 'caowd92', 'yangqu', 'ppjunb12', 'nayerakhaled', 'mennatallamostafa87', 'nahlatarek', 'ahmadabdelsalam', 'bguillet', 'xanxo18', 'naremanallam40', 'henryhe9806', 'zjhnus', 'mazen_ashraf', 'sikaislam66', 'asmaagamalelsayed96', 'nouran_mohamed', 'sgu20141474', 'abdelrhmanadelhassan', 'basmahassan697', 'yaozu', 'jhoeniges', 'akshayb', 'mdabrarshaikh90', 'sgu20141398', 'qky0921', 'sgu20161542e', 'yasmin.gad412', 'simon6599', 'sgu20151463', 'lincolnwang321', 'arvindh', 'sgu20141460', 'sgu20141415', 'a0928404798', 'sgu20131410', 'sgu20171558', 'nouran.tarek97', 'seohyeoniii', 'rinap', 'aymansaadhack', 'olashazly27', 'sgu20151410', 'georgesamy', 'gehadosama', 'monakamel97', 'bbaekssun', 'jishen', 'cxu004', 'tahaa.rore', 'marwan.m96', 'joanliu951001', 'sgu20171502', 'omarz977', 'sgu20171562', 'ruodaz', 'yayman55', 'radu.uta93', 'smrsaravanan', 'amjadtaleb', 'anas_massoud', 'sgu20141389', 'ankita.patil.0001', 'mayura0621', 'mohammedmajdyict', 'labmiugac2993', 'sgu20141480', 'sgu20171520', 'sgu20141458', 'sgu20141484', 'gyl0428', 'sgu20151490', 'sgu20131412', 'sgu20141476', 'nada.omran', 'jiamin2068', 'tokahossam71', 'ahmedmoustafa771', 'basmagharieb', 'yusuf313', 'ahmad.yasserr', 'wildprince', 'yuelian1234', 'youssefrefaat', 'sgu20091548', 'alaa98', 'mennaessam98', 'estradavictor96', 'sgu20171524', 'ge24', 'zeinabtaha', 'hananalamri', 'shinsunhak', 'mahmouddeghadi', 'ranaahmed96', 'thapu.putta', 'e0320957', 'sgu20151487', 'guitarist9816', 'sgu20151476', 'bluer', 'sgu20171556', 'mohamedkutb', 'ulas_965', 'mtmaccc', 'chen2712', 'omnia.khaled12', 'a960710', 'bentelghaly', 'jaydm26', 'lemon12345', 'gsabbir87', 'sgu20171508', 'as', 'uozgur', 'sgu20141424', 'e0186014', 'omar_eid73', 'sgu20141430', 'sgu20171503', 'sgu20141417', 'johnmccarthy', 'mustafaakhlak', 'chxxtu2009', 'sgu20151452', 'mohmedaliessa', 'sgu20141411', 'sgu20171526', 'nada5essam', 'salmaaatareeek', 'mohamedallam0000', 'qwu2', 'sgu20141395', 'han20151510', 'nkpuga', 'michaelashraf777', 'donghu', 'muhlasheen2', 'dvid0315', 'yhlee27', 'sgu20131508', 'sgu20141468', 'ankitraj9', 'mostafa200100', 'sgu20121532', 'esoomoh64', 'sgu20151424', 'velurihasita', 'latifaalfardan', 'leo666', 'ibrahimkamal1997', 'assemabdelmoniem', 'julianna', 'zhangziyan', 'hgowaily', 'lindatalts', 'engtuan123', 'sgu20161494', 'loaydiaa', 'kabinaya08', 'mariamzanaty', 'sgu20171570', 'zeyadahmedbadr97', 'gopijettiboyina841', 'nimashi001', 'nkvv88', 'mohamedabdelmeged', 'scientist.affawn', 'indronil.ghosh27', 'jackhoeniges', 'zackkk123', 'mimo007007', 'sgu20151513', 'mariomedhat9', 'michaelguevara', 'cbzkcbzk1', 'hagarkhaled', 'bperera', 'jorgealexandre', 'jojosazziz', 'salmasaher', 'tutulalala', 'shamyofficial2', 'zhichongcarl', 'jlong1028', 'cuoghimarco', 'sgu20141393', 'hanamant17', 'amgadsami1998', 'shaikyahul77', 'sgu20161503', 'zenaj', 'khaledshehab44', 'khaledhigazy94', 'saramahmoud19', 'rahmanr3', 'ayaabdelrahim', 'faharalalawi', 'sgu20141471', 'sgu20151194', 'lennynator92', 'dko1217', 'ooooo18', 'sgu20141394', 'amirnabilhanna', 'ayoyayoyo2008', 'radwa123', 'toqa1999', 'mjkingdem', 'sgu20141408', 'ramyadel1313', 'mohanad.waheed9', 'sgu20121498', 'kingmokey', 'salman1999', 'hala97', 'amrsaeed012', 'icey123', 'sgu20171550', 'youssef_essam', 'johan.iswara', 'ekhlas3535', 'f.elgebaly', 'hongyan', 'sgu20141461', 'visionsofshiva', 'sgu20131492', 'weeei0514', 'hour', 'mohameddomy97', 'zhangnianchen', 'abdo1703', 'neuton']",24,"['dke625', 'sgu20141493', 'sgu20141445', 'sgu20141441', 'sgu20131458', 'sgu20141453', 'sgu20131414', 'saemin1024', 'sgu20151957', 'sohnt', 'sgu20141388', 'sgu20141434', 'sgu201414733', 'hoobeen', 'sgu20131420', 'dusxo124', 'sgu20131431', 'bangong12', 'sgu20131496', 'taehojung', None, 'davidjung01', 'sgu20131484', 'sgu20131374']",360,"['yasmine317', 'mitchelld2', 'john17.su', 'asmaahussein99', 'engmo3taz99', 'simon1205', 'hamedamr95', 'unal', 'luca.riccies', 'sgu20171586', 'lisifan', 'tingyu.qu', 'memonona017', 'heba_star1999', 'jkson3', 'nadaessam', 'addashti', 'yara.magdy222', 'bellayang', 'sg20121208', 'muhammed.number', 'pradeep_c17', 'sgu20131481', 'saemin1024', 'muhamriaz', 'almoatasem_bellah', 'sayeedrm', 'sgu20151422', 'sgu20141448', 'plloydwright', 'sgu20131507', 'dsreynolds93', 'sgu2014726019', 'lamyaalfa', 'aubai.hassan98', 'a.omar125242', 'ayakhaled4897', 'c15444808', 'tktm44', 'aradwa477', 'husalaa98', 'shy19951119', 'sgu20151438', 'wenfeng', 'roddaro', 'omniapinkflower', 'hayaat', 'horstmannbm', 'sgu20151486', 'wangmingzhu', 'mariam0', 'changlin2328', 'heshamebrahim123', 'wpsun319', 'sgu20131455', 'timmy_mer', 'eric.kosdi', 'vb9237865', 'sgu20151456', 'hamda', 'nalvarez92', 'gjfdjzo', 'ionsko', 'sgu20151464', 'monikaa', 'leeann901', 'weka_201219', 'abdulrahmangalal', 'sgu20131462', 'hbg2112', 'goddoggo', 'duweigg', 'sogang20141460', 'sgu20141478', 'sgu20171566', 'sgu20141414', 'sgu20161542', 'tianzk2', 'mohammed_naveed', 'sgu201414733', 'nayeramansour', 'juhu93', 'youmna.moussa2016', 'sgu20161474', 'dusxo124', 'sgu20131431', 'bangong12', 'abdelazimmohamed98', 'sgu20131432', 'sgu20171490', 'sgu20151436', 'hanamantmn999', 'dydgus201', 'bassem8989', 'nourhanmagdymahmoud', 'jxc248006', 'aya.mohamed97', 'sgu20151478', 'akarkotis94', 'sgu20151418', 'bassem_mazen', 'sgu20171572', 'nelwagdy', 'ataulmamun', 'ayamohamed', 'harry0913', 'demonleon1995', 'caowd92', 'sgu20141441', 'yangqu', 'ppjunb12', 'sgu20141453', 'nayerakhaled', 'mennatallamostafa87', 'nahlatarek', 'ahmadabdelsalam', 'sgu20151957', 'bguillet', 'xanxo18', 'naremanallam40', 'henryhe9806', 'zjhnus', 'mazen_ashraf', 'sikaislam66', 'asmaagamalelsayed96', 'nouran_mohamed', 'hoobeen', 'sgu20141474', 'abdelrhmanadelhassan', 'basmahassan697', 'yaozu', 'jhoeniges', 'akshayb', 'mdabrarshaikh90', 'sgu20141398', 'qky0921', 'sgu20161542e', 'yasmin.gad412', 'simon6599', 'sgu20151463', 'lincolnwang321', 'arvindh', 'sgu20141460', 'sgu20141415', 'a0928404798', 'sgu20131410', 'sgu20171558', 'nouran.tarek97', 'seohyeoniii', 'rinap', 'aymansaadhack', 'olashazly27', 'sgu20151410', 'georgesamy', 'gehadosama', 'monakamel97', 'bbaekssun', 'jishen', 'cxu004', 'tahaa.rore', 'marwan.m96', 'joanliu951001', 'sgu20171502', 'omarz977', 'sgu20171562', 'ruodaz', 'yayman55', 'radu.uta93', 'smrsaravanan', 'amjadtaleb', 'anas_massoud', 'sgu20141389', 'ankita.patil.0001', 'mayura0621', 'sgu20131496', 'mohammedmajdyict', 'labmiugac2993', 'sgu20141480', None, 'sgu20171520', 'sgu20141458', 'sgu20141484', 'davidjung01', 'gyl0428', 'sgu20151490', 'sgu20131412', 'sgu20141476', 'nada.omran', 'jiamin2068', 'tokahossam71', 'ahmedmoustafa771', 'basmagharieb', 'yusuf313', 'ahmad.yasserr', 'wildprince', 'yuelian1234', 'dke625', 'youssefrefaat', 'sgu20091548', 'alaa98', 'mennaessam98', 'estradavictor96', 'sgu20171524', 'ge24', 'zeinabtaha', 'sgu20131414', 'hananalamri', 'shinsunhak', 'mahmouddeghadi', 'ranaahmed96', 'thapu.putta', 'e0320957', 'sgu20151487', 'guitarist9816', 'sgu20151476', 'bluer', 'sgu20171556', 'mohamedkutb', 'sgu20131420', 'ulas_965', 'mtmaccc', 'chen2712', 'omnia.khaled12', 'a960710', 'bentelghaly', 'jaydm26', 'sgu20131484', 'lemon12345', 'gsabbir87', 'sgu20171508', 'as', 'uozgur', 'sgu20141424', 'e0186014', 'omar_eid73', 'sgu20141430', 'sgu20171503', 'sgu20141417', 'johnmccarthy', 'sgu20141493', 'mustafaakhlak', 'chxxtu2009', 'sgu20151452', 'sgu20131458', 'mohmedaliessa', 'sgu20141411', 'sgu20171526', 'nada5essam', 'salmaaatareeek', 'mohamedallam0000', 'qwu2', 'sgu20141395', 'han20151510', 'nkpuga', 'michaelashraf777', 'donghu', 'sgu20141434', 'muhlasheen2', 'dvid0315', 'yhlee27', 'sgu20131508', 'sgu20141468', 'sgu20151485', 'ankitraj9', 'mostafa200100', 'sgu20121532', 'esoomoh64', 'sgu20151424', 'velurihasita', 'latifaalfardan', 'leo666', 'ibrahimkamal1997', 'assemabdelmoniem', 'julianna', 'zhangziyan', 'hgowaily', 'lindatalts', 'sgu20131374', 'engtuan123', 'sgu20161494', 'loaydiaa', 'kabinaya08', 'mariamzanaty', 'sgu20171570', 'sgu20141483', 'zeyadahmedbadr97', 'gopijettiboyina841', 'nimashi001', 'nkvv88', 'mohamedabdelmeged', 'scientist.affawn', 'indronil.ghosh27', 'jackhoeniges', 'sohnt', 'zackkk123', 'mimo007007', 'sgu20151513', 'mariomedhat9', 'michaelguevara', 'cbzkcbzk1', 'hagarkhaled', 'bperera', 'jorgealexandre', 'jojosazziz', 'salmasaher', 'tutulalala', 'shamyofficial2', 'zhichongcarl', 'jlong1028', 'taehojung', 'cuoghimarco', 'sgu20141393', 'hanamant17', 'amgadsami1998', 'shaikyahul77', 'sgu20161503', 'zenaj', 'khaledshehab44', 'khaledhigazy94', 'saramahmoud19', 'rahmanr3', 'ayaabdelrahim', 'faharalalawi', 'sgu20141471', 'sgu20151194', 'lennynator92', 'sgu20141445', 'dko1217', 'ooooo18', 'sgu20141394', 'amirnabilhanna', 'ayoyayoyo2008', 'radwa123', 'toqa1999', 'mjkingdem', 'sgu20141408', 'ramyadel1313', 'mohanad.waheed9', 'sgu20121498', 'sgu20141388', 'kingmokey', 'salman1999', 'hala97', 'amrsaeed012', 'icey123', 'sgu20171550', 'youssef_essam', 'johan.iswara', 'ekhlas3535', 'f.elgebaly', 'hongyan', 'sgu20141461', 'visionsofshiva', 'sgu20131492', 'weeei0514', 'hour', 'mohameddomy97', 'zhangnianchen', 'abdo1703', 'neuton']"
1,15,336,26,19,"['dko1217', 'estradavictor96', 'nalvarez92', 'bbaekssun', 'ge24', 'addashti', 'indronil.ghosh27', 'jackhoeniges', 'muhamriaz', 'yhlee27', 'ruodaz', 'plloydwright', 'dsreynolds93', 'juhu93', 'jhoeniges', 'labmiugac2993', 'akshayb', 'jaydm26', 'gsabbir87']",317,"['yasmine317', 'mitchelld2', 'john17.su', 'asmaahussein99', 'engmo3taz99', 'simon1205', 'hamedamr95', 'unal', 'luca.riccies', 'sgu20171586', 'lisifan', 'tingyu.qu', 'memonona017', 'heba_star1999', 'jkson3', 'nadaessam', 'yara.magdy222', 'bellayang', 'sg20121208', 'muhammed.number', 'pradeep_c17', 'sgu20131481', 'almoatasem_bellah', 'sayeedrm', 'sgu20151422', 'sgu20141448', 'sgu20131507', 'sgu2014726019', 'lamyaalfa', 'aubai.hassan98', 'a.omar125242', 'ayakhaled4897', 'c15444808', 'tktm44', 'aradwa477', 'husalaa98', 'shy19951119', 'sgu20151438', 'wenfeng', 'roddaro', 'omniapinkflower', 'hayaat', 'horstmannbm', 'sgu20151486', 'wangmingzhu', 'mariam0', 'changlin2328', 'heshamebrahim123', 'wpsun319', 'sgu20131455', 'timmy_mer', 'eric.kosdi', 'vb9237865', 'sgu20151456', 'hamda', 'gjfdjzo', 'ionsko', 'sgu20151464', 'monikaa', 'leeann901', 'weka_201219', 'abdulrahmangalal', 'sgu20131462', 'hbg2112', 'goddoggo', 'duweigg', 'sogang20141460', 'sgu20141478', 'sgu20171566', 'sgu20141414', 'sgu20161542', 'tianzk2', 'mohammed_naveed', 'nayeramansour', 'youmna.moussa2016', 'sgu20161474', 'abdelazimmohamed98', 'sgu20131432', 'sgu20171490', 'sgu20151436', 'hanamantmn999', 'dydgus201', 'bassem8989', 'nourhanmagdymahmoud', 'jxc248006', 'aya.mohamed97', 'sgu20151478', 'akarkotis94', 'sgu20151418', 'bassem_mazen', 'sgu20171572', 'nelwagdy', 'ataulmamun', 'ayamohamed', 'harry0913', 'demonleon1995', 'caowd92', 'yangqu', 'ppjunb12', 'nayerakhaled', 'mennatallamostafa87', 'nahlatarek', 'ahmadabdelsalam', 'bguillet', 'xanxo18', 'naremanallam40', 'henryhe9806', 'zjhnus', 'mazen_ashraf', 'sikaislam66', 'asmaagamalelsayed96', 'nouran_mohamed', 'sgu20141474', 'abdelrhmanadelhassan', 'basmahassan697', 'yaozu', 'mdabrarshaikh90', 'sgu20141398', 'qky0921', 'sgu20161542e', 'yasmin.gad412', 'simon6599', 'sgu20151463', 'lincolnwang321', 'arvindh', 'sgu20141460', 'sgu20141415', 'a0928404798', 'sgu20131410', 'sgu20171558', 'nouran.tarek97', 'seohyeoniii', 'rinap', 'aymansaadhack', 'olashazly27', 'sgu20151410', 'georgesamy', 'gehadosama', 'monakamel97', 'jishen', 'cxu004', 'tahaa.rore', 'marwan.m96', 'joanliu951001', 'sgu20171502', 'omarz977', 'sgu20171562', 'yayman55', 'radu.uta93', 'smrsaravanan', 'amjadtaleb', 'anas_massoud', 'sgu20141389', 'ankita.patil.0001', 'mayura0621', 'mohammedmajdyict', 'sgu20141480', 'sgu20171520', 'sgu20141458', 'sgu20141484', 'gyl0428', 'sgu20151490', 'sgu20131412', 'sgu20141476', 'nada.omran', 'jiamin2068', 'tokahossam71', 'ahmedmoustafa771', 'basmagharieb', 'yusuf313', 'ahmad.yasserr', 'wildprince', 'yuelian1234', 'youssefrefaat', 'sgu20091548', 'alaa98', 'mennaessam98', 'sgu20171524', 'zeinabtaha', 'hananalamri', 'shinsunhak', 'mahmouddeghadi', 'ranaahmed96', 'thapu.putta', 'e0320957', 'sgu20151487', 'guitarist9816', 'sgu20151476', 'bluer', 'sgu20171556', 'mohamedkutb', 'ulas_965', 'mtmaccc', 'chen2712', 'omnia.khaled12', 'a960710', 'bentelghaly', 'lemon12345', 'sgu20171508', 'as', 'uozgur', 'sgu20141424', 'e0186014', 'omar_eid73', 'sgu20141430', 'sgu20171503', 'sgu20141417', 'johnmccarthy', 'mustafaakhlak', 'chxxtu2009', 'sgu20151452', 'mohmedaliessa', 'sgu20141411', 'sgu20171526', 'nada5essam', 'salmaaatareeek', 'mohamedallam0000', 'qwu2', 'sgu20141395', 'han20151510', 'nkpuga', 'michaelashraf777', 'donghu', 'muhlasheen2', 'dvid0315', 'sgu20131508', 'sgu20141468', 'sgu20151485', 'ankitraj9', 'mostafa200100', 'sgu20121532', 'esoomoh64', 'sgu20151424', 'velurihasita', 'latifaalfardan', 'leo666', 'ibrahimkamal1997', 'assemabdelmoniem', 'julianna', 'zhangziyan', 'hgowaily', 'lindatalts', 'engtuan123', 'sgu20161494', 'loaydiaa', 'kabinaya08', 'mariamzanaty', 'sgu20171570', 'sgu20141483', 'zeyadahmedbadr97', 'gopijettiboyina841', 'nimashi001', 'nkvv88', 'mohamedabdelmeged', 'scientist.affawn', 'zackkk123', 'mimo007007', 'sgu20151513', 'mariomedhat9', 'michaelguevara', 'cbzkcbzk1', 'hagarkhaled', 'bperera', 'jorgealexandre', 'jojosazziz', 'salmasaher', 'tutulalala', 'shamyofficial2', 'zhichongcarl', 'jlong1028', 'cuoghimarco', 'sgu20141393', 'hanamant17', 'amgadsami1998', 'shaikyahul77', 'sgu20161503', 'zenaj', 'khaledshehab44', 'khaledhigazy94', 'saramahmoud19', 'rahmanr3', 'ayaabdelrahim', 'faharalalawi', 'sgu20141471', 'sgu20151194', 'lennynator92', 'ooooo18', 'sgu20141394', 'amirnabilhanna', 'ayoyayoyo2008', 'radwa123', 'toqa1999', 'mjkingdem', 'sgu20141408', 'ramyadel1313', 'mohanad.waheed9', 'sgu20121498', 'kingmokey', 'salman1999', 'hala97', 'amrsaeed012', 'icey123', 'sgu20171550', 'youssef_essam', 'johan.iswara', 'ekhlas3535', 'f.elgebaly', 'hongyan', 'sgu20141461', 'visionsofshiva', 'sgu20131492', 'weeei0514', 'hour', 'mohameddomy97', 'zhangnianchen', 'abdo1703', 'neuton']",7,"['ujash', 'davidlnguyen96', 'nuchizono', 'yuning', 'alghfeli', 'cjelloian', None]",343,"['yasmine317', 'mitchelld2', 'john17.su', 'asmaahussein99', 'engmo3taz99', 'simon1205', 'hamedamr95', 'unal', 'luca.riccies', 'sgu20171586', 'lisifan', 'tingyu.qu', 'memonona017', 'heba_star1999', 'jkson3', 'nadaessam', 'addashti', 'yara.magdy222', 'bellayang', 'sg20121208', 'muhammed.number', 'pradeep_c17', 'sgu20131481', 'muhamriaz', 'almoatasem_bellah', 'sayeedrm', 'sgu20151422', 'sgu20141448', 'plloydwright', 'sgu20131507', 'dsreynolds93', 'sgu2014726019', 'lamyaalfa', 'aubai.hassan98', 'a.omar125242', 'ayakhaled4897', 'c15444808', 'tktm44', 'aradwa477', 'husalaa98', 'shy19951119', 'sgu20151438', 'wenfeng', 'roddaro', 'omniapinkflower', 'hayaat', 'nuchizono', 'horstmannbm', 'sgu20151486', 'wangmingzhu', 'mariam0', 'changlin2328', 'heshamebrahim123', 'wpsun319', 'sgu20131455', 'timmy_mer', 'davidlnguyen96', 'eric.kosdi', 'vb9237865', 'sgu20151456', 'hamda', 'nalvarez92', 'gjfdjzo', 'ionsko', 'sgu20151464', 'monikaa', 'leeann901', 'weka_201219', 'abdulrahmangalal', 'sgu20131462', 'hbg2112', 'goddoggo', 'duweigg', 'sogang20141460', 'sgu20141478', 'sgu20171566', 'sgu20141414', 'sgu20161542', 'tianzk2', 'mohammed_naveed', 'nayeramansour', 'juhu93', 'youmna.moussa2016', 'sgu20161474', 'abdelazimmohamed98', 'sgu20131432', 'sgu20171490', 'sgu20151436', 'hanamantmn999', 'dydgus201', 'bassem8989', 'nourhanmagdymahmoud', 'jxc248006', 'ujash', 'aya.mohamed97', 'sgu20151478', 'akarkotis94', 'sgu20151418', 'bassem_mazen', 'sgu20171572', 'nelwagdy', 'yuning', 'ataulmamun', 'ayamohamed', 'harry0913', 'demonleon1995', 'caowd92', 'yangqu', 'ppjunb12', 'nayerakhaled', 'mennatallamostafa87', 'nahlatarek', 'ahmadabdelsalam', 'bguillet', 'xanxo18', 'naremanallam40', 'henryhe9806', 'zjhnus', 'mazen_ashraf', 'sikaislam66', 'asmaagamalelsayed96', 'nouran_mohamed', 'sgu20141474', 'abdelrhmanadelhassan', 'basmahassan697', 'yaozu', 'jhoeniges', 'akshayb', 'mdabrarshaikh90', 'sgu20141398', 'qky0921', 'sgu20161542e', 'yasmin.gad412', 'simon6599', 'sgu20151463', 'lincolnwang321', 'arvindh', 'sgu20141460', 'sgu20141415', 'a0928404798', 'sgu20131410', 'sgu20171558', 'nouran.tarek97', 'seohyeoniii', 'rinap', 'aymansaadhack', 'olashazly27', 'sgu20151410', 'georgesamy', 'gehadosama', 'monakamel97', 'bbaekssun', 'jishen', 'cxu004', 'tahaa.rore', 'marwan.m96', 'joanliu951001', 'sgu20171502', 'omarz977', 'sgu20171562', 'ruodaz', 'yayman55', 'radu.uta93', 'smrsaravanan', 'amjadtaleb', 'anas_massoud', 'sgu20141389', 'ankita.patil.0001', 'mayura0621', 'mohammedmajdyict', 'labmiugac2993', 'sgu20141480', None, 'sgu20171520', 'sgu20141458', 'sgu20141484', 'gyl0428', 'sgu20151490', 'sgu20131412', 'sgu20141476', 'nada.omran', 'jiamin2068', 'tokahossam71', 'ahmedmoustafa771', 'basmagharieb', 'yusuf313', 'ahmad.yasserr', 'wildprince', 'yuelian1234', 'youssefrefaat', 'sgu20091548', 'alaa98', 'mennaessam98', 'estradavictor96', 'sgu20171524', 'ge24', 'zeinabtaha', 'hananalamri', 'shinsunhak', 'mahmouddeghadi', 'ranaahmed96', 'thapu.putta', 'e0320957', 'sgu20151487', 'guitarist9816', 'sgu20151476', 'bluer', 'sgu20171556', 'mohamedkutb', 'ulas_965', 'mtmaccc', 'chen2712', 'omnia.khaled12', 'a960710', 'bentelghaly', 'jaydm26', 'lemon12345', 'gsabbir87', 'sgu20171508', 'as', 'uozgur', 'sgu20141424', 'e0186014', 'omar_eid73', 'sgu20141430', 'sgu20171503', 'sgu20141417', 'johnmccarthy', 'mustafaakhlak', 'chxxtu2009', 'sgu20151452', 'mohmedaliessa', 'sgu20141411', 'sgu20171526', 'nada5essam', 'salmaaatareeek', 'mohamedallam0000', 'qwu2', 'sgu20141395', 'han20151510', 'nkpuga', 'michaelashraf777', 'donghu', 'alghfeli', 'muhlasheen2', 'dvid0315', 'yhlee27', 'sgu20131508', 'sgu20141468', 'sgu20151485', 'ankitraj9', 'mostafa200100', 'sgu20121532', 'esoomoh64', 'sgu20151424', 'velurihasita', 'latifaalfardan', 'leo666', 'ibrahimkamal1997', 'assemabdelmoniem', 'julianna', 'zhangziyan', 'hgowaily', 'lindatalts', 'engtuan123', 'sgu20161494', 'loaydiaa', 'kabinaya08', 'mariamzanaty', 'sgu20171570', 'sgu20141483', 'zeyadahmedbadr97', 'gopijettiboyina841', 'nimashi001', 'nkvv88', 'mohamedabdelmeged', 'scientist.affawn', 'indronil.ghosh27', 'jackhoeniges', 'zackkk123', 'mimo007007', 'sgu20151513', 'mariomedhat9', 'michaelguevara', 'cbzkcbzk1', 'hagarkhaled', 'bperera', 'jorgealexandre', 'jojosazziz', 'salmasaher', 'tutulalala', 'shamyofficial2', 'zhichongcarl', 'jlong1028', 'cuoghimarco', 'sgu20141393', 'hanamant17', 'amgadsami1998', 'shaikyahul77', 'sgu20161503', 'zenaj', 'khaledshehab44', 'khaledhigazy94', 'saramahmoud19', 'rahmanr3', 'ayaabdelrahim', 'faharalalawi', 'sgu20141471', 'sgu20151194', 'lennynator92', 'dko1217', 'ooooo18', 'sgu20141394', 'amirnabilhanna', 'ayoyayoyo2008', 'radwa123', 'toqa1999', 'mjkingdem', 'sgu20141408', 'ramyadel1313', 'mohanad.waheed9', 'sgu20121498', 'kingmokey', 'salman1999', 'hala97', 'amrsaeed012', 'icey123', 'sgu20171550', 'youssef_essam', 'johan.iswara', 'ekhlas3535', 'f.elgebaly', 'hongyan', 'sgu20141461', 'visionsofshiva', 'sgu20131492', 'weeei0514', 'hour', 'mohameddomy97', 'zhangnianchen', 'abdo1703', 'cjelloian', 'neuton']"
1,227,336,26,1,['sgu20141476'],335,"['yasmine317', 'mitchelld2', 'john17.su', 'asmaahussein99', 'engmo3taz99', 'simon1205', 'hamedamr95', 'unal', 'luca.riccies', 'sgu20171586', 'lisifan', 'tingyu.qu', 'memonona017', 'heba_star1999', 'jkson3', 'nadaessam', 'addashti', 'yara.magdy222', 'bellayang', 'sg20121208', 'muhammed.number', 'pradeep_c17', 'sgu20131481', 'muhamriaz', 'almoatasem_bellah', 'sayeedrm', 'sgu20151422', 'sgu20141448', 'plloydwright', 'sgu20131507', 'dsreynolds93', 'sgu2014726019', 'lamyaalfa', 'aubai.hassan98', 'a.omar125242', 'ayakhaled4897', 'c15444808', 'tktm44', 'aradwa477', 'husalaa98', 'shy19951119', 'sgu20151438', 'wenfeng', 'roddaro', 'omniapinkflower', 'hayaat', 'horstmannbm', 'sgu20151486', 'wangmingzhu', 'mariam0', 'changlin2328', 'heshamebrahim123', 'wpsun319', 'sgu20131455', 'timmy_mer', 'eric.kosdi', 'vb9237865', 'sgu20151456', 'hamda', 'nalvarez92', 'gjfdjzo', 'ionsko', 'sgu20151464', 'monikaa', 'leeann901', 'weka_201219', 'abdulrahmangalal', 'sgu20131462', 'hbg2112', 'goddoggo', 'duweigg', 'sogang20141460', 'sgu20141478', 'sgu20171566', 'sgu20141414', 'sgu20161542', 'tianzk2', 'mohammed_naveed', 'nayeramansour', 'juhu93', 'youmna.moussa2016', 'sgu20161474', 'abdelazimmohamed98', 'sgu20131432', 'sgu20171490', 'sgu20151436', 'hanamantmn999', 'dydgus201', 'bassem8989', 'nourhanmagdymahmoud', 'jxc248006', 'aya.mohamed97', 'sgu20151478', 'akarkotis94', 'sgu20151418', 'bassem_mazen', 'sgu20171572', 'nelwagdy', 'ataulmamun', 'ayamohamed', 'harry0913', 'demonleon1995', 'caowd92', 'yangqu', 'ppjunb12', 'nayerakhaled', 'mennatallamostafa87', 'nahlatarek', 'ahmadabdelsalam', 'bguillet', 'xanxo18', 'naremanallam40', 'henryhe9806', 'zjhnus', 'mazen_ashraf', 'sikaislam66', 'asmaagamalelsayed96', 'nouran_mohamed', 'sgu20141474', 'abdelrhmanadelhassan', 'basmahassan697', 'yaozu', 'jhoeniges', 'akshayb', 'mdabrarshaikh90', 'sgu20141398', 'qky0921', 'sgu20161542e', 'yasmin.gad412', 'simon6599', 'sgu20151463', 'lincolnwang321', 'arvindh', 'sgu20141460', 'sgu20141415', 'a0928404798', 'sgu20131410', 'sgu20171558', 'nouran.tarek97', 'seohyeoniii', 'rinap', 'aymansaadhack', 'olashazly27', 'sgu20151410', 'georgesamy', 'gehadosama', 'monakamel97', 'bbaekssun', 'jishen', 'cxu004', 'tahaa.rore', 'marwan.m96', 'joanliu951001', 'sgu20171502', 'omarz977', 'sgu20171562', 'ruodaz', 'yayman55', 'radu.uta93', 'smrsaravanan', 'amjadtaleb', 'anas_massoud', 'sgu20141389', 'ankita.patil.0001', 'mayura0621', 'mohammedmajdyict', 'labmiugac2993', 'sgu20141480', 'sgu20171520', 'sgu20141458', 'sgu20141484', 'gyl0428', 'sgu20151490', 'sgu20131412', 'nada.omran', 'jiamin2068', 'tokahossam71', 'ahmedmoustafa771', 'basmagharieb', 'yusuf313', 'ahmad.yasserr', 'wildprince', 'yuelian1234', 'youssefrefaat', 'sgu20091548', 'alaa98', 'mennaessam98', 'estradavictor96', 'sgu20171524', 'ge24', 'zeinabtaha', 'hananalamri', 'shinsunhak', 'mahmouddeghadi', 'ranaahmed96', 'thapu.putta', 'e0320957', 'sgu20151487', 'guitarist9816', 'sgu20151476', 'bluer', 'sgu20171556', 'mohamedkutb', 'ulas_965', 'mtmaccc', 'chen2712', 'omnia.khaled12', 'a960710', 'bentelghaly', 'jaydm26', 'lemon12345', 'gsabbir87', 'sgu20171508', 'as', 'uozgur', 'sgu20141424', 'e0186014', 'omar_eid73', 'sgu20141430', 'sgu20171503', 'sgu20141417', 'johnmccarthy', 'mustafaakhlak', 'chxxtu2009', 'sgu20151452', 'mohmedaliessa', 'sgu20141411', 'sgu20171526', 'nada5essam', 'salmaaatareeek', 'mohamedallam0000', 'qwu2', 'sgu20141395', 'han20151510', 'nkpuga', 'michaelashraf777', 'donghu', 'muhlasheen2', 'dvid0315', 'yhlee27', 'sgu20131508', 'sgu20141468', 'sgu20151485', 'ankitraj9', 'mostafa200100', 'sgu20121532', 'esoomoh64', 'sgu20151424', 'velurihasita', 'latifaalfardan', 'leo666', 'ibrahimkamal1997', 'assemabdelmoniem', 'julianna', 'zhangziyan', 'hgowaily', 'lindatalts', 'engtuan123', 'sgu20161494', 'loaydiaa', 'kabinaya08', 'mariamzanaty', 'sgu20171570', 'sgu20141483', 'zeyadahmedbadr97', 'gopijettiboyina841', 'nimashi001', 'nkvv88', 'mohamedabdelmeged', 'scientist.affawn', 'indronil.ghosh27', 'jackhoeniges', 'zackkk123', 'mimo007007', 'sgu20151513', 'mariomedhat9', 'michaelguevara', 'cbzkcbzk1', 'hagarkhaled', 'bperera', 'jorgealexandre', 'jojosazziz', 'salmasaher', 'tutulalala', 'shamyofficial2', 'zhichongcarl', 'jlong1028', 'cuoghimarco', 'sgu20141393', 'hanamant17', 'amgadsami1998', 'shaikyahul77', 'sgu20161503', 'zenaj', 'khaledshehab44', 'khaledhigazy94', 'saramahmoud19', 'rahmanr3', 'ayaabdelrahim', 'faharalalawi', 'sgu20141471', 'sgu20151194', 'lennynator92', 'dko1217', 'ooooo18', 'sgu20141394', 'amirnabilhanna', 'ayoyayoyo2008', 'radwa123', 'toqa1999', 'mjkingdem', 'sgu20141408', 'ramyadel1313', 'mohanad.waheed9', 'sgu20121498', 'kingmokey', 'salman1999', 'hala97', 'amrsaeed012', 'icey123', 'sgu20171550', 'youssef_essam', 'johan.iswara', 'ekhlas3535', 'f.elgebaly', 'hongyan', 'sgu20141461', 'visionsofshiva', 'sgu20131492', 'weeei0514', 'hour', 'mohameddomy97', 'zhangnianchen', 'abdo1703', 'neuton']",25,"['dke625', 'sgu20141493', 'sgu20141445', 'sgu20141441', 'sgu20131458', 'sgu20141429', 'sgu20141453', 'sgu20131414', 'saemin1024', 'sohnt', 'sgu20141388', 'sgu20141434', 'ghkskxlr', 'sgu201414733', 'hoobeen', 'ghks031800', 'sgu20131420', 'happyman1104', 'sgu20131431', None, 'sohnterry', 'davidjung01', 'sgu20131484', 'sgu20131374', 'do1608']",361,"['yasmine317', 'mitchelld2', 'john17.su', 'asmaahussein99', 'engmo3taz99', 'simon1205', 'hamedamr95', 'unal', 'sgu20141429', 'luca.riccies', 'sgu20171586', 'lisifan', 'tingyu.qu', 'memonona017', 'heba_star1999', 'jkson3', 'nadaessam', 'addashti', 'yara.magdy222', 'bellayang', 'sg20121208', 'muhammed.number', 'pradeep_c17', 'sgu20131481', 'saemin1024', 'muhamriaz', 'almoatasem_bellah', 'sayeedrm', 'sgu20151422', 'sgu20141448', 'plloydwright', 'sgu20131507', 'dsreynolds93', 'sgu2014726019', 'lamyaalfa', 'aubai.hassan98', 'a.omar125242', 'ayakhaled4897', 'c15444808', 'tktm44', 'aradwa477', 'husalaa98', 'shy19951119', 'sgu20151438', 'wenfeng', 'roddaro', 'omniapinkflower', 'hayaat', 'horstmannbm', 'sgu20151486', 'do1608', 'wangmingzhu', 'mariam0', 'changlin2328', 'heshamebrahim123', 'wpsun319', 'sgu20131455', 'timmy_mer', 'eric.kosdi', 'vb9237865', 'sgu20151456', 'hamda', 'nalvarez92', 'gjfdjzo', 'ionsko', 'sgu20151464', 'monikaa', 'leeann901', 'weka_201219', 'abdulrahmangalal', 'sgu20131462', 'hbg2112', 'goddoggo', 'duweigg', 'sogang20141460', 'sgu20141478', 'sgu20171566', 'sgu20141414', 'sgu20161542', 'tianzk2', 'mohammed_naveed', 'sgu201414733', 'nayeramansour', 'ghks031800', 'juhu93', 'youmna.moussa2016', 'sgu20161474', 'sgu20131431', 'abdelazimmohamed98', 'sgu20131432', 'sgu20171490', 'sgu20151436', 'hanamantmn999', 'dydgus201', 'bassem8989', 'nourhanmagdymahmoud', 'jxc248006', 'aya.mohamed97', 'sgu20151478', 'akarkotis94', 'sgu20151418', 'bassem_mazen', 'sgu20171572', 'nelwagdy', 'ataulmamun', 'ayamohamed', 'harry0913', 'demonleon1995', 'caowd92', 'sgu20141441', 'yangqu', 'ppjunb12', 'sgu20141453', 'nayerakhaled', 'mennatallamostafa87', 'nahlatarek', 'ahmadabdelsalam', 'bguillet', 'xanxo18', 'naremanallam40', 'henryhe9806', 'zjhnus', 'mazen_ashraf', 'sikaislam66', 'asmaagamalelsayed96', 'nouran_mohamed', 'hoobeen', 'sgu20141474', 'abdelrhmanadelhassan', 'basmahassan697', 'yaozu', 'jhoeniges', 'akshayb', 'mdabrarshaikh90', 'sgu20141398', 'qky0921', 'sgu20161542e', 'yasmin.gad412', 'simon6599', 'sgu20151463', 'lincolnwang321', 'arvindh', 'sgu20141460', 'sgu20141415', 'a0928404798', 'sgu20131410', 'sgu20171558', 'nouran.tarek97', 'seohyeoniii', 'rinap', 'aymansaadhack', 'olashazly27', 'sgu20151410', 'georgesamy', 'gehadosama', 'monakamel97', 'bbaekssun', 'jishen', 'cxu004', 'tahaa.rore', 'marwan.m96', 'joanliu951001', 'sgu20171502', 'omarz977', 'sgu20171562', 'ruodaz', 'yayman55', 'radu.uta93', 'smrsaravanan', 'amjadtaleb', 'anas_massoud', 'sgu20141389', 'ankita.patil.0001', 'mayura0621', 'mohammedmajdyict', 'labmiugac2993', 'sgu20141480', None, 'sgu20171520', 'sgu20141458', 'sgu20141484', 'davidjung01', 'gyl0428', 'sgu20151490', 'sgu20131412', 'sgu20141476', 'nada.omran', 'jiamin2068', 'tokahossam71', 'ahmedmoustafa771', 'basmagharieb', 'yusuf313', 'ahmad.yasserr', 'wildprince', 'yuelian1234', 'dke625', 'youssefrefaat', 'sgu20091548', 'alaa98', 'mennaessam98', 'estradavictor96', 'sgu20171524', 'ge24', 'zeinabtaha', 'sgu20131414', 'hananalamri', 'shinsunhak', 'mahmouddeghadi', 'ranaahmed96', 'thapu.putta', 'e0320957', 'sgu20151487', 'guitarist9816', 'sgu20151476', 'bluer', 'sgu20171556', 'mohamedkutb', 'sgu20131420', 'ulas_965', 'happyman1104', 'mtmaccc', 'chen2712', 'omnia.khaled12', 'a960710', 'bentelghaly', 'jaydm26', 'sgu20131484', 'lemon12345', 'gsabbir87', 'sgu20171508', 'as', 'uozgur', 'sgu20141424', 'e0186014', 'omar_eid73', 'sgu20141430', 'sgu20171503', 'sgu20141417', 'johnmccarthy', 'sgu20141493', 'mustafaakhlak', 'chxxtu2009', 'sgu20151452', 'sgu20131458', 'mohmedaliessa', 'sgu20141411', 'sgu20171526', 'nada5essam', 'salmaaatareeek', 'mohamedallam0000', 'qwu2', 'sgu20141395', 'han20151510', 'nkpuga', 'michaelashraf777', 'donghu', 'sgu20141434', 'muhlasheen2', 'dvid0315', 'yhlee27', 'sgu20131508', 'sgu20141468', 'sgu20151485', 'ankitraj9', 'mostafa200100', 'sgu20121532', 'esoomoh64', 'sgu20151424', 'velurihasita', 'latifaalfardan', 'leo666', 'ibrahimkamal1997', 'assemabdelmoniem', 'julianna', 'zhangziyan', 'hgowaily', 'lindatalts', 'sgu20131374', 'engtuan123', 'sgu20161494', 'loaydiaa', 'kabinaya08', 'mariamzanaty', 'sgu20171570', 'sgu20141483', 'zeyadahmedbadr97', 'gopijettiboyina841', 'nimashi001', 'nkvv88', 'mohamedabdelmeged', 'scientist.affawn', 'indronil.ghosh27', 'jackhoeniges', 'sohnt', 'zackkk123', 'mimo007007', 'sgu20151513', 'mariomedhat9', 'michaelguevara', 'cbzkcbzk1', 'hagarkhaled', 'bperera', 'jorgealexandre', 'jojosazziz', 'ghkskxlr', 'salmasaher', 'tutulalala', 'shamyofficial2', 'zhichongcarl', 'jlong1028', 'cuoghimarco', 'sgu20141393', 'hanamant17', 'amgadsami1998', 'sohnterry', 'shaikyahul77', 'sgu20161503', 'zenaj', 'khaledshehab44', 'khaledhigazy94', 'saramahmoud19', 'rahmanr3', 'ayaabdelrahim', 'faharalalawi', 'sgu20141471', 'sgu20151194', 'lennynator92', 'sgu20141445', 'dko1217', 'ooooo18', 'sgu20141394', 'amirnabilhanna', 'ayoyayoyo2008', 'radwa123', 'toqa1999', 'mjkingdem', 'sgu20141408', 'ramyadel1313', 'mohanad.waheed9', 'sgu20121498', 'sgu20141388', 'kingmokey', 'salman1999', 'hala97', 'amrsaeed012', 'icey123', 'sgu20171550', 'youssef_essam', 'johan.iswara', 'ekhlas3535', 'f.elgebaly', 'hongyan', 'sgu20141461', 'visionsofshiva', 'sgu20131492', 'weeei0514', 'hour', 'mohameddomy97', 'zhangnianchen', 'abdo1703', 'neuton']"
1,27,336,14,1,['vb9237865'],335,"['yasmine317', 'mitchelld2', 'john17.su', 'asmaahussein99', 'engmo3taz99', 'simon1205', 'hamedamr95', 'unal', 'luca.riccies', 'sgu20171586', 'lisifan', 'tingyu.qu', 'memonona017', 'heba_star1999', 'jkson3', 'nadaessam', 'addashti', 'yara.magdy222', 'bellayang', 'sg20121208', 'muhammed.number', 'pradeep_c17', 'sgu20131481', 'muhamriaz', 'almoatasem_bellah', 'sayeedrm', 'sgu20151422', 'sgu20141448', 'plloydwright', 'sgu20131507', 'dsreynolds93', 'sgu2014726019', 'lamyaalfa', 'aubai.hassan98', 'a.omar125242', 'ayakhaled4897', 'c15444808', 'tktm44', 'aradwa477', 'husalaa98', 'shy19951119', 'sgu20151438', 'wenfeng', 'roddaro', 'omniapinkflower', 'hayaat', 'horstmannbm', 'sgu20151486', 'wangmingzhu', 'mariam0', 'changlin2328', 'heshamebrahim123', 'wpsun319', 'sgu20131455', 'timmy_mer', 'eric.kosdi', 'sgu20151456', 'hamda', 'nalvarez92', 'gjfdjzo', 'ionsko', 'sgu20151464', 'monikaa', 'leeann901', 'weka_201219', 'abdulrahmangalal', 'sgu20131462', 'hbg2112', 'goddoggo', 'duweigg', 'sogang20141460', 'sgu20141478', 'sgu20171566', 'sgu20141414', 'sgu20161542', 'tianzk2', 'mohammed_naveed', 'nayeramansour', 'juhu93', 'youmna.moussa2016', 'sgu20161474', 'abdelazimmohamed98', 'sgu20131432', 'sgu20171490', 'sgu20151436', 'hanamantmn999', 'dydgus201', 'bassem8989', 'nourhanmagdymahmoud', 'jxc248006', 'aya.mohamed97', 'sgu20151478', 'akarkotis94', 'sgu20151418', 'bassem_mazen', 'sgu20171572', 'nelwagdy', 'ataulmamun', 'ayamohamed', 'harry0913', 'demonleon1995', 'caowd92', 'yangqu', 'ppjunb12', 'nayerakhaled', 'mennatallamostafa87', 'nahlatarek', 'ahmadabdelsalam', 'bguillet', 'xanxo18', 'naremanallam40', 'henryhe9806', 'zjhnus', 'mazen_ashraf', 'sikaislam66', 'asmaagamalelsayed96', 'nouran_mohamed', 'sgu20141474', 'abdelrhmanadelhassan', 'basmahassan697', 'yaozu', 'jhoeniges', 'akshayb', 'mdabrarshaikh90', 'sgu20141398', 'qky0921', 'sgu20161542e', 'yasmin.gad412', 'simon6599', 'sgu20151463', 'lincolnwang321', 'arvindh', 'sgu20141460', 'sgu20141415', 'a0928404798', 'sgu20131410', 'sgu20171558', 'nouran.tarek97', 'seohyeoniii', 'rinap', 'aymansaadhack', 'olashazly27', 'sgu20151410', 'georgesamy', 'gehadosama', 'monakamel97', 'bbaekssun', 'jishen', 'cxu004', 'tahaa.rore', 'marwan.m96', 'joanliu951001', 'sgu20171502', 'omarz977', 'sgu20171562', 'ruodaz', 'yayman55', 'radu.uta93', 'smrsaravanan', 'amjadtaleb', 'anas_massoud', 'sgu20141389', 'ankita.patil.0001', 'mayura0621', 'mohammedmajdyict', 'labmiugac2993', 'sgu20141480', 'sgu20171520', 'sgu20141458', 'sgu20141484', 'gyl0428', 'sgu20151490', 'sgu20131412', 'sgu20141476', 'nada.omran', 'jiamin2068', 'tokahossam71', 'ahmedmoustafa771', 'basmagharieb', 'yusuf313', 'ahmad.yasserr', 'wildprince', 'yuelian1234', 'youssefrefaat', 'sgu20091548', 'alaa98', 'mennaessam98', 'estradavictor96', 'sgu20171524', 'ge24', 'zeinabtaha', 'hananalamri', 'shinsunhak', 'mahmouddeghadi', 'ranaahmed96', 'thapu.putta', 'e0320957', 'sgu20151487', 'guitarist9816', 'sgu20151476', 'bluer', 'sgu20171556', 'mohamedkutb', 'ulas_965', 'mtmaccc', 'chen2712', 'omnia.khaled12', 'a960710', 'bentelghaly', 'jaydm26', 'lemon12345', 'gsabbir87', 'sgu20171508', 'as', 'uozgur', 'sgu20141424', 'e0186014', 'omar_eid73', 'sgu20141430', 'sgu20171503', 'sgu20141417', 'johnmccarthy', 'mustafaakhlak', 'chxxtu2009', 'sgu20151452', 'mohmedaliessa', 'sgu20141411', 'sgu20171526', 'nada5essam', 'salmaaatareeek', 'mohamedallam0000', 'qwu2', 'sgu20141395', 'han20151510', 'nkpuga', 'michaelashraf777', 'donghu', 'muhlasheen2', 'dvid0315', 'yhlee27', 'sgu20131508', 'sgu20141468', 'sgu20151485', 'ankitraj9', 'mostafa200100', 'sgu20121532', 'esoomoh64', 'sgu20151424', 'velurihasita', 'latifaalfardan', 'leo666', 'ibrahimkamal1997', 'assemabdelmoniem', 'julianna', 'zhangziyan', 'hgowaily', 'lindatalts', 'engtuan123', 'sgu20161494', 'loaydiaa', 'kabinaya08', 'mariamzanaty', 'sgu20171570', 'sgu20141483', 'zeyadahmedbadr97', 'gopijettiboyina841', 'nimashi001', 'nkvv88', 'mohamedabdelmeged', 'scientist.affawn', 'indronil.ghosh27', 'jackhoeniges', 'zackkk123', 'mimo007007', 'sgu20151513', 'mariomedhat9', 'michaelguevara', 'cbzkcbzk1', 'hagarkhaled', 'bperera', 'jorgealexandre', 'jojosazziz', 'salmasaher', 'tutulalala', 'shamyofficial2', 'zhichongcarl', 'jlong1028', 'cuoghimarco', 'sgu20141393', 'hanamant17', 'amgadsami1998', 'shaikyahul77', 'sgu20161503', 'zenaj', 'khaledshehab44', 'khaledhigazy94', 'saramahmoud19', 'rahmanr3', 'ayaabdelrahim', 'faharalalawi', 'sgu20141471', 'sgu20151194', 'lennynator92', 'dko1217', 'ooooo18', 'sgu20141394', 'amirnabilhanna', 'ayoyayoyo2008', 'radwa123', 'toqa1999', 'mjkingdem', 'sgu20141408', 'ramyadel1313', 'mohanad.waheed9', 'sgu20121498', 'kingmokey', 'salman1999', 'hala97', 'amrsaeed012', 'icey123', 'sgu20171550', 'youssef_essam', 'johan.iswara', 'ekhlas3535', 'f.elgebaly', 'hongyan', 'sgu20141461', 'visionsofshiva', 'sgu20131492', 'weeei0514', 'hour', 'mohameddomy97', 'zhangnianchen', 'abdo1703', 'neuton']",13,"['kunalipillalamarri', 'sreepuramsravani', 'polireddychaitanya', 'pulisaipavan500', 'rajareddy9052', 'kirankumarreddy1256', 'aragondadinesh', 'vineelachowdary27', 'renusreekarnam', 'saleema', None, 'sreenusree1789', 'sasikumar.c.16']",349,"['yasmine317', 'mitchelld2', 'john17.su', 'asmaahussein99', 'engmo3taz99', 'simon1205', 'hamedamr95', 'unal', 'luca.riccies', 'sgu20171586', 'lisifan', 'tingyu.qu', 'memonona017', 'heba_star1999', 'jkson3', 'nadaessam', 'addashti', 'yara.magdy222', 'bellayang', 'sg20121208', 'muhammed.number', 'pradeep_c17', 'sgu20131481', 'muhamriaz', 'almoatasem_bellah', 'sayeedrm', 'sgu20151422', 'sgu20141448', 'plloydwright', 'sgu20131507', 'dsreynolds93', 'sgu2014726019', 'lamyaalfa', 'aubai.hassan98', 'a.omar125242', 'ayakhaled4897', 'c15444808', 'tktm44', 'aradwa477', 'husalaa98', 'shy19951119', 'sgu20151438', 'wenfeng', 'roddaro', 'omniapinkflower', 'hayaat', 'horstmannbm', 'sgu20151486', 'wangmingzhu', 'mariam0', 'changlin2328', 'heshamebrahim123', 'wpsun319', 'sgu20131455', 'timmy_mer', 'eric.kosdi', 'vb9237865', 'sgu20151456', 'hamda', 'nalvarez92', 'gjfdjzo', 'ionsko', 'sgu20151464', 'monikaa', 'leeann901', 'weka_201219', 'abdulrahmangalal', 'sgu20131462', 'hbg2112', 'renusreekarnam', 'goddoggo', 'duweigg', 'sogang20141460', 'sgu20141478', 'sgu20171566', 'sgu20141414', 'sgu20161542', 'tianzk2', 'mohammed_naveed', 'nayeramansour', 'juhu93', 'youmna.moussa2016', 'sgu20161474', 'abdelazimmohamed98', 'sgu20131432', 'sgu20171490', 'sgu20151436', 'hanamantmn999', 'dydgus201', 'bassem8989', 'nourhanmagdymahmoud', 'jxc248006', 'aya.mohamed97', 'sgu20151478', 'akarkotis94', 'sgu20151418', 'bassem_mazen', 'sgu20171572', 'nelwagdy', 'ataulmamun', 'ayamohamed', 'harry0913', 'demonleon1995', 'caowd92', 'yangqu', 'ppjunb12', 'nayerakhaled', 'mennatallamostafa87', 'nahlatarek', 'ahmadabdelsalam', 'bguillet', 'xanxo18', 'naremanallam40', 'henryhe9806', 'zjhnus', 'mazen_ashraf', 'sikaislam66', 'asmaagamalelsayed96', 'nouran_mohamed', 'sgu20141474', 'abdelrhmanadelhassan', 'basmahassan697', 'yaozu', 'jhoeniges', 'akshayb', 'sasikumar.c.16', 'mdabrarshaikh90', 'sgu20141398', 'qky0921', 'sgu20161542e', 'yasmin.gad412', 'simon6599', 'sgu20151463', 'lincolnwang321', 'arvindh', 'sgu20141460', 'rajareddy9052', 'sgu20141415', 'a0928404798', 'sgu20131410', 'sgu20171558', 'nouran.tarek97', 'seohyeoniii', 'rinap', 'aymansaadhack', 'olashazly27', 'sgu20151410', 'georgesamy', 'gehadosama', 'monakamel97', 'bbaekssun', 'jishen', 'cxu004', 'tahaa.rore', 'marwan.m96', 'joanliu951001', 'sgu20171502', 'omarz977', 'sgu20171562', 'ruodaz', 'yayman55', 'radu.uta93', 'smrsaravanan', 'amjadtaleb', 'anas_massoud', 'sgu20141389', 'ankita.patil.0001', 'mayura0621', 'kunalipillalamarri', 'mohammedmajdyict', 'labmiugac2993', 'sgu20141480', None, 'sgu20171520', 'sgu20141458', 'sgu20141484', 'gyl0428', 'sgu20151490', 'sgu20131412', 'sgu20141476', 'nada.omran', 'jiamin2068', 'tokahossam71', 'ahmedmoustafa771', 'basmagharieb', 'yusuf313', 'ahmad.yasserr', 'wildprince', 'yuelian1234', 'youssefrefaat', 'sgu20091548', 'alaa98', 'mennaessam98', 'estradavictor96', 'sgu20171524', 'ge24', 'zeinabtaha', 'sreepuramsravani', 'hananalamri', 'shinsunhak', 'mahmouddeghadi', 'ranaahmed96', 'thapu.putta', 'e0320957', 'sgu20151487', 'guitarist9816', 'sgu20151476', 'bluer', 'sgu20171556', 'mohamedkutb', 'ulas_965', 'mtmaccc', 'chen2712', 'omnia.khaled12', 'a960710', 'bentelghaly', 'jaydm26', 'lemon12345', 'gsabbir87', 'sgu20171508', 'as', 'uozgur', 'sgu20141424', 'e0186014', 'omar_eid73', 'sgu20141430', 'sgu20171503', 'sgu20141417', 'johnmccarthy', 'mustafaakhlak', 'chxxtu2009', 'sgu20151452', 'mohmedaliessa', 'sgu20141411', 'sgu20171526', 'nada5essam', 'salmaaatareeek', 'mohamedallam0000', 'qwu2', 'sgu20141395', 'han20151510', 'nkpuga', 'michaelashraf777', 'donghu', 'muhlasheen2', 'dvid0315', 'yhlee27', 'sgu20131508', 'sgu20141468', 'sgu20151485', 'ankitraj9', 'mostafa200100', 'sgu20121532', 'esoomoh64', 'sgu20151424', 'saleema', 'velurihasita', 'latifaalfardan', 'leo666', 'ibrahimkamal1997', 'assemabdelmoniem', 'julianna', 'zhangziyan', 'hgowaily', 'lindatalts', 'engtuan123', 'sgu20161494', 'loaydiaa', 'sreenusree1789', 'kabinaya08', 'mariamzanaty', 'sgu20171570', 'sgu20141483', 'zeyadahmedbadr97', 'gopijettiboyina841', 'nimashi001', 'nkvv88', 'mohamedabdelmeged', 'scientist.affawn', 'indronil.ghosh27', 'jackhoeniges', 'zackkk123', 'mimo007007', 'sgu20151513', 'mariomedhat9', 'michaelguevara', 'cbzkcbzk1', 'hagarkhaled', 'bperera', 'jorgealexandre', 'jojosazziz', 'salmasaher', 'tutulalala', 'polireddychaitanya', 'shamyofficial2', 'zhichongcarl', 'jlong1028', 'vineelachowdary27', 'cuoghimarco', 'sgu20141393', 'hanamant17', 'amgadsami1998', 'shaikyahul77', 'sgu20161503', 'pulisaipavan500', 'zenaj', 'khaledshehab44', 'khaledhigazy94', 'saramahmoud19', 'rahmanr3', 'ayaabdelrahim', 'faharalalawi', 'sgu20141471', 'sgu20151194', 'lennynator92', 'dko1217', 'ooooo18', 'kirankumarreddy1256', 'sgu20141394', 'amirnabilhanna', 'ayoyayoyo2008', 'radwa123', 'toqa1999', 'mjkingdem', 'sgu20141408', 'ramyadel1313', 'mohanad.waheed9', 'sgu20121498', 'aragondadinesh', 'kingmokey', 'salman1999', 'hala97', 'amrsaeed012', 'icey123', 'sgu20171550', 'youssef_essam', 'johan.iswara', 'ekhlas3535', 'f.elgebaly', 'hongyan', 'sgu20141461', 'visionsofshiva', 'sgu20131492', 'weeei0514', 'hour', 'mohameddomy97', 'zhangnianchen', 'abdo1703', 'neuton']"
1,23,336,12,1,['cuoghimarco'],335,"['yasmine317', 'mitchelld2', 'john17.su', 'asmaahussein99', 'engmo3taz99', 'simon1205', 'hamedamr95', 'unal', 'luca.riccies', 'sgu20171586', 'lisifan', 'tingyu.qu', 'memonona017', 'heba_star1999', 'jkson3', 'nadaessam', 'addashti', 'yara.magdy222', 'bellayang', 'sg20121208', 'muhammed.number', 'pradeep_c17', 'sgu20131481', 'muhamriaz', 'almoatasem_bellah', 'sayeedrm', 'sgu20151422', 'sgu20141448', 'plloydwright', 'sgu20131507', 'dsreynolds93', 'sgu2014726019', 'lamyaalfa', 'aubai.hassan98', 'a.omar125242', 'ayakhaled4897', 'c15444808', 'tktm44', 'aradwa477', 'husalaa98', 'shy19951119', 'sgu20151438', 'wenfeng', 'roddaro', 'omniapinkflower', 'hayaat', 'horstmannbm', 'sgu20151486', 'wangmingzhu', 'mariam0', 'changlin2328', 'heshamebrahim123', 'wpsun319', 'sgu20131455', 'timmy_mer', 'eric.kosdi', 'vb9237865', 'sgu20151456', 'hamda', 'nalvarez92', 'gjfdjzo', 'ionsko', 'sgu20151464', 'monikaa', 'leeann901', 'weka_201219', 'abdulrahmangalal', 'sgu20131462', 'hbg2112', 'goddoggo', 'duweigg', 'sogang20141460', 'sgu20141478', 'sgu20171566', 'sgu20141414', 'sgu20161542', 'tianzk2', 'mohammed_naveed', 'nayeramansour', 'juhu93', 'youmna.moussa2016', 'sgu20161474', 'abdelazimmohamed98', 'sgu20131432', 'sgu20171490', 'sgu20151436', 'hanamantmn999', 'dydgus201', 'bassem8989', 'nourhanmagdymahmoud', 'jxc248006', 'aya.mohamed97', 'sgu20151478', 'akarkotis94', 'sgu20151418', 'bassem_mazen', 'sgu20171572', 'nelwagdy', 'ataulmamun', 'ayamohamed', 'harry0913', 'demonleon1995', 'caowd92', 'yangqu', 'ppjunb12', 'nayerakhaled', 'mennatallamostafa87', 'nahlatarek', 'ahmadabdelsalam', 'bguillet', 'xanxo18', 'naremanallam40', 'henryhe9806', 'zjhnus', 'mazen_ashraf', 'sikaislam66', 'asmaagamalelsayed96', 'nouran_mohamed', 'sgu20141474', 'abdelrhmanadelhassan', 'basmahassan697', 'yaozu', 'jhoeniges', 'akshayb', 'mdabrarshaikh90', 'sgu20141398', 'qky0921', 'sgu20161542e', 'yasmin.gad412', 'simon6599', 'sgu20151463', 'lincolnwang321', 'arvindh', 'sgu20141460', 'sgu20141415', 'a0928404798', 'sgu20131410', 'sgu20171558', 'nouran.tarek97', 'seohyeoniii', 'rinap', 'aymansaadhack', 'olashazly27', 'sgu20151410', 'georgesamy', 'gehadosama', 'monakamel97', 'bbaekssun', 'jishen', 'cxu004', 'tahaa.rore', 'marwan.m96', 'joanliu951001', 'sgu20171502', 'omarz977', 'sgu20171562', 'ruodaz', 'yayman55', 'radu.uta93', 'smrsaravanan', 'amjadtaleb', 'anas_massoud', 'sgu20141389', 'ankita.patil.0001', 'mayura0621', 'mohammedmajdyict', 'labmiugac2993', 'sgu20141480', 'sgu20171520', 'sgu20141458', 'sgu20141484', 'gyl0428', 'sgu20151490', 'sgu20131412', 'sgu20141476', 'nada.omran', 'jiamin2068', 'tokahossam71', 'ahmedmoustafa771', 'basmagharieb', 'yusuf313', 'ahmad.yasserr', 'wildprince', 'yuelian1234', 'youssefrefaat', 'sgu20091548', 'alaa98', 'mennaessam98', 'estradavictor96', 'sgu20171524', 'ge24', 'zeinabtaha', 'hananalamri', 'shinsunhak', 'mahmouddeghadi', 'ranaahmed96', 'thapu.putta', 'e0320957', 'sgu20151487', 'guitarist9816', 'sgu20151476', 'bluer', 'sgu20171556', 'mohamedkutb', 'ulas_965', 'mtmaccc', 'chen2712', 'omnia.khaled12', 'a960710', 'bentelghaly', 'jaydm26', 'lemon12345', 'gsabbir87', 'sgu20171508', 'as', 'uozgur', 'sgu20141424', 'e0186014', 'omar_eid73', 'sgu20141430', 'sgu20171503', 'sgu20141417', 'johnmccarthy', 'mustafaakhlak', 'chxxtu2009', 'sgu20151452', 'mohmedaliessa', 'sgu20141411', 'sgu20171526', 'nada5essam', 'salmaaatareeek', 'mohamedallam0000', 'qwu2', 'sgu20141395', 'han20151510', 'nkpuga', 'michaelashraf777', 'donghu', 'muhlasheen2', 'dvid0315', 'yhlee27', 'sgu20131508', 'sgu20141468', 'sgu20151485', 'ankitraj9', 'mostafa200100', 'sgu20121532', 'esoomoh64', 'sgu20151424', 'velurihasita', 'latifaalfardan', 'leo666', 'ibrahimkamal1997', 'assemabdelmoniem', 'julianna', 'zhangziyan', 'hgowaily', 'lindatalts', 'engtuan123', 'sgu20161494', 'loaydiaa', 'kabinaya08', 'mariamzanaty', 'sgu20171570', 'sgu20141483', 'zeyadahmedbadr97', 'gopijettiboyina841', 'nimashi001', 'nkvv88', 'mohamedabdelmeged', 'scientist.affawn', 'indronil.ghosh27', 'jackhoeniges', 'zackkk123', 'mimo007007', 'sgu20151513', 'mariomedhat9', 'michaelguevara', 'cbzkcbzk1', 'hagarkhaled', 'bperera', 'jorgealexandre', 'jojosazziz', 'salmasaher', 'tutulalala', 'shamyofficial2', 'zhichongcarl', 'jlong1028', 'sgu20141393', 'hanamant17', 'amgadsami1998', 'shaikyahul77', 'sgu20161503', 'zenaj', 'khaledshehab44', 'khaledhigazy94', 'saramahmoud19', 'rahmanr3', 'ayaabdelrahim', 'faharalalawi', 'sgu20141471', 'sgu20151194', 'lennynator92', 'dko1217', 'ooooo18', 'sgu20141394', 'amirnabilhanna', 'ayoyayoyo2008', 'radwa123', 'toqa1999', 'mjkingdem', 'sgu20141408', 'ramyadel1313', 'mohanad.waheed9', 'sgu20121498', 'kingmokey', 'salman1999', 'hala97', 'amrsaeed012', 'icey123', 'sgu20171550', 'youssef_essam', 'johan.iswara', 'ekhlas3535', 'f.elgebaly', 'hongyan', 'sgu20141461', 'visionsofshiva', 'sgu20131492', 'weeei0514', 'hour', 'mohameddomy97', 'zhangnianchen', 'abdo1703', 'neuton']",11,"['enrico876', 'simoneiaia', 'lucaselmi', 'hassanmughal92', 'stefano.righi1994', 'rubenasa', 'ettoremasetti', 'riccardotassi', 'alessiobevilacqua', None, 'taynaraapoena123']",347,"['yasmine317', 'mitchelld2', 'john17.su', 'asmaahussein99', 'engmo3taz99', 'simon1205', 'hamedamr95', 'unal', 'luca.riccies', 'sgu20171586', 'lisifan', 'tingyu.qu', 'memonona017', 'heba_star1999', 'jkson3', 'nadaessam', 'addashti', 'yara.magdy222', 'bellayang', 'sg20121208', 'muhammed.number', 'pradeep_c17', 'sgu20131481', 'hassanmughal92', 'muhamriaz', 'almoatasem_bellah', 'sayeedrm', 'sgu20151422', 'sgu20141448', 'plloydwright', 'taynaraapoena123', 'sgu20131507', 'dsreynolds93', 'sgu2014726019', 'lamyaalfa', 'aubai.hassan98', 'a.omar125242', 'ayakhaled4897', 'c15444808', 'tktm44', 'aradwa477', 'husalaa98', 'shy19951119', 'sgu20151438', 'wenfeng', 'roddaro', 'omniapinkflower', 'hayaat', 'horstmannbm', 'sgu20151486', 'wangmingzhu', 'mariam0', 'changlin2328', 'heshamebrahim123', 'wpsun319', 'sgu20131455', 'timmy_mer', 'eric.kosdi', 'vb9237865', 'sgu20151456', 'hamda', 'nalvarez92', 'gjfdjzo', 'ionsko', 'sgu20151464', 'monikaa', 'leeann901', 'weka_201219', 'abdulrahmangalal', 'sgu20131462', 'hbg2112', 'goddoggo', 'duweigg', 'sogang20141460', 'sgu20141478', 'sgu20171566', 'sgu20141414', 'sgu20161542', 'tianzk2', 'mohammed_naveed', 'nayeramansour', 'juhu93', 'youmna.moussa2016', 'sgu20161474', 'abdelazimmohamed98', 'sgu20131432', 'sgu20171490', 'sgu20151436', 'hanamantmn999', 'dydgus201', 'bassem8989', 'nourhanmagdymahmoud', 'jxc248006', 'aya.mohamed97', 'sgu20151478', 'akarkotis94', 'sgu20151418', 'bassem_mazen', 'sgu20171572', 'nelwagdy', 'riccardotassi', 'ataulmamun', 'ayamohamed', 'harry0913', 'demonleon1995', 'caowd92', 'yangqu', 'ppjunb12', 'nayerakhaled', 'mennatallamostafa87', 'nahlatarek', 'ahmadabdelsalam', 'bguillet', 'rubenasa', 'xanxo18', 'naremanallam40', 'henryhe9806', 'zjhnus', 'mazen_ashraf', 'sikaislam66', 'asmaagamalelsayed96', 'nouran_mohamed', 'sgu20141474', 'abdelrhmanadelhassan', 'basmahassan697', 'yaozu', 'jhoeniges', 'akshayb', 'mdabrarshaikh90', 'sgu20141398', 'qky0921', 'sgu20161542e', 'yasmin.gad412', 'simon6599', 'sgu20151463', 'lincolnwang321', 'arvindh', 'sgu20141460', 'sgu20141415', 'a0928404798', 'sgu20131410', 'sgu20171558', 'nouran.tarek97', 'seohyeoniii', 'rinap', 'aymansaadhack', 'olashazly27', 'sgu20151410', 'georgesamy', 'gehadosama', 'monakamel97', 'bbaekssun', 'jishen', 'cxu004', 'tahaa.rore', 'marwan.m96', 'joanliu951001', 'sgu20171502', 'omarz977', 'ettoremasetti', 'sgu20171562', 'ruodaz', 'yayman55', 'radu.uta93', 'smrsaravanan', 'amjadtaleb', 'anas_massoud', 'sgu20141389', 'ankita.patil.0001', 'mayura0621', 'mohammedmajdyict', 'labmiugac2993', 'sgu20141480', None, 'sgu20171520', 'sgu20141458', 'sgu20141484', 'gyl0428', 'sgu20151490', 'sgu20131412', 'sgu20141476', 'nada.omran', 'jiamin2068', 'tokahossam71', 'ahmedmoustafa771', 'basmagharieb', 'yusuf313', 'ahmad.yasserr', 'wildprince', 'yuelian1234', 'youssefrefaat', 'sgu20091548', 'alaa98', 'mennaessam98', 'estradavictor96', 'sgu20171524', 'ge24', 'zeinabtaha', 'hananalamri', 'shinsunhak', 'mahmouddeghadi', 'ranaahmed96', 'thapu.putta', 'e0320957', 'sgu20151487', 'guitarist9816', 'sgu20151476', 'bluer', 'sgu20171556', 'mohamedkutb', 'ulas_965', 'mtmaccc', 'chen2712', 'omnia.khaled12', 'a960710', 'bentelghaly', 'jaydm26', 'lemon12345', 'gsabbir87', 'sgu20171508', 'as', 'uozgur', 'sgu20141424', 'e0186014', 'omar_eid73', 'sgu20141430', 'sgu20171503', 'sgu20141417', 'johnmccarthy', 'simoneiaia', 'mustafaakhlak', 'chxxtu2009', 'sgu20151452', 'mohmedaliessa', 'sgu20141411', 'sgu20171526', 'nada5essam', 'salmaaatareeek', 'mohamedallam0000', 'qwu2', 'sgu20141395', 'han20151510', 'nkpuga', 'michaelashraf777', 'donghu', 'muhlasheen2', 'dvid0315', 'yhlee27', 'sgu20131508', 'enrico876', 'sgu20141468', 'sgu20151485', 'ankitraj9', 'mostafa200100', 'sgu20121532', 'esoomoh64', 'sgu20151424', 'stefano.righi1994', 'velurihasita', 'latifaalfardan', 'leo666', 'ibrahimkamal1997', 'assemabdelmoniem', 'julianna', 'zhangziyan', 'hgowaily', 'lucaselmi', 'lindatalts', 'engtuan123', 'sgu20161494', 'loaydiaa', 'kabinaya08', 'mariamzanaty', 'sgu20171570', 'sgu20141483', 'zeyadahmedbadr97', 'gopijettiboyina841', 'nimashi001', 'nkvv88', 'mohamedabdelmeged', 'scientist.affawn', 'indronil.ghosh27', 'jackhoeniges', 'zackkk123', 'mimo007007', 'sgu20151513', 'mariomedhat9', 'michaelguevara', 'cbzkcbzk1', 'hagarkhaled', 'bperera', 'jorgealexandre', 'jojosazziz', 'salmasaher', 'tutulalala', 'shamyofficial2', 'zhichongcarl', 'jlong1028', 'cuoghimarco', 'sgu20141393', 'hanamant17', 'amgadsami1998', 'shaikyahul77', 'sgu20161503', 'zenaj', 'khaledshehab44', 'khaledhigazy94', 'saramahmoud19', 'rahmanr3', 'ayaabdelrahim', 'faharalalawi', 'sgu20141471', 'sgu20151194', 'lennynator92', 'dko1217', 'ooooo18', 'sgu20141394', 'amirnabilhanna', 'ayoyayoyo2008', 'radwa123', 'toqa1999', 'mjkingdem', 'sgu20141408', 'ramyadel1313', 'mohanad.waheed9', 'sgu20121498', 'kingmokey', 'salman1999', 'hala97', 'amrsaeed012', 'icey123', 'sgu20171550', 'youssef_essam', 'johan.iswara', 'ekhlas3535', 'f.elgebaly', 'hongyan', 'sgu20141461', 'visionsofshiva', 'sgu20131492', 'weeei0514', 'hour', 'mohameddomy97', 'zhangnianchen', 'abdo1703', 'alessiobevilacqua', 'neuton']"
1,232,336,9,1,['weeei0514'],335,"['yasmine317', 'mitchelld2', 'john17.su', 'asmaahussein99', 'engmo3taz99', 'simon1205', 'hamedamr95', 'unal', 'luca.riccies', 'sgu20171586', 'lisifan', 'tingyu.qu', 'memonona017', 'heba_star1999', 'jkson3', 'nadaessam', 'addashti', 'yara.magdy222', 'bellayang', 'sg20121208', 'muhammed.number', 'pradeep_c17', 'sgu20131481', 'muhamriaz', 'almoatasem_bellah', 'sayeedrm', 'sgu20151422', 'sgu20141448', 'plloydwright', 'sgu20131507', 'dsreynolds93', 'sgu2014726019', 'lamyaalfa', 'aubai.hassan98', 'a.omar125242', 'ayakhaled4897', 'c15444808', 'tktm44', 'aradwa477', 'husalaa98', 'shy19951119', 'sgu20151438', 'wenfeng', 'roddaro', 'omniapinkflower', 'hayaat', 'horstmannbm', 'sgu20151486', 'wangmingzhu', 'mariam0', 'changlin2328', 'heshamebrahim123', 'wpsun319', 'sgu20131455', 'timmy_mer', 'eric.kosdi', 'vb9237865', 'sgu20151456', 'hamda', 'nalvarez92', 'gjfdjzo', 'ionsko', 'sgu20151464', 'monikaa', 'leeann901', 'weka_201219', 'abdulrahmangalal', 'sgu20131462', 'hbg2112', 'goddoggo', 'duweigg', 'sogang20141460', 'sgu20141478', 'sgu20171566', 'sgu20141414', 'sgu20161542', 'tianzk2', 'mohammed_naveed', 'nayeramansour', 'juhu93', 'youmna.moussa2016', 'sgu20161474', 'abdelazimmohamed98', 'sgu20131432', 'sgu20171490', 'sgu20151436', 'hanamantmn999', 'dydgus201', 'bassem8989', 'nourhanmagdymahmoud', 'jxc248006', 'aya.mohamed97', 'sgu20151478', 'akarkotis94', 'sgu20151418', 'bassem_mazen', 'sgu20171572', 'nelwagdy', 'ataulmamun', 'ayamohamed', 'harry0913', 'demonleon1995', 'caowd92', 'yangqu', 'ppjunb12', 'nayerakhaled', 'mennatallamostafa87', 'nahlatarek', 'ahmadabdelsalam', 'bguillet', 'xanxo18', 'naremanallam40', 'henryhe9806', 'zjhnus', 'mazen_ashraf', 'sikaislam66', 'asmaagamalelsayed96', 'nouran_mohamed', 'sgu20141474', 'abdelrhmanadelhassan', 'basmahassan697', 'yaozu', 'jhoeniges', 'akshayb', 'mdabrarshaikh90', 'sgu20141398', 'qky0921', 'sgu20161542e', 'yasmin.gad412', 'simon6599', 'sgu20151463', 'lincolnwang321', 'arvindh', 'sgu20141460', 'sgu20141415', 'a0928404798', 'sgu20131410', 'sgu20171558', 'nouran.tarek97', 'seohyeoniii', 'rinap', 'aymansaadhack', 'olashazly27', 'sgu20151410', 'georgesamy', 'gehadosama', 'monakamel97', 'bbaekssun', 'jishen', 'cxu004', 'tahaa.rore', 'marwan.m96', 'joanliu951001', 'sgu20171502', 'omarz977', 'sgu20171562', 'ruodaz', 'yayman55', 'radu.uta93', 'smrsaravanan', 'amjadtaleb', 'anas_massoud', 'sgu20141389', 'ankita.patil.0001', 'mayura0621', 'mohammedmajdyict', 'labmiugac2993', 'sgu20141480', 'sgu20171520', 'sgu20141458', 'sgu20141484', 'gyl0428', 'sgu20151490', 'sgu20131412', 'sgu20141476', 'nada.omran', 'jiamin2068', 'tokahossam71', 'ahmedmoustafa771', 'basmagharieb', 'yusuf313', 'ahmad.yasserr', 'wildprince', 'yuelian1234', 'youssefrefaat', 'sgu20091548', 'alaa98', 'mennaessam98', 'estradavictor96', 'sgu20171524', 'ge24', 'zeinabtaha', 'hananalamri', 'shinsunhak', 'mahmouddeghadi', 'ranaahmed96', 'thapu.putta', 'e0320957', 'sgu20151487', 'guitarist9816', 'sgu20151476', 'bluer', 'sgu20171556', 'mohamedkutb', 'ulas_965', 'mtmaccc', 'chen2712', 'omnia.khaled12', 'a960710', 'bentelghaly', 'jaydm26', 'lemon12345', 'gsabbir87', 'sgu20171508', 'as', 'uozgur', 'sgu20141424', 'e0186014', 'omar_eid73', 'sgu20141430', 'sgu20171503', 'sgu20141417', 'johnmccarthy', 'mustafaakhlak', 'chxxtu2009', 'sgu20151452', 'mohmedaliessa', 'sgu20141411', 'sgu20171526', 'nada5essam', 'salmaaatareeek', 'mohamedallam0000', 'qwu2', 'sgu20141395', 'han20151510', 'nkpuga', 'michaelashraf777', 'donghu', 'muhlasheen2', 'dvid0315', 'yhlee27', 'sgu20131508', 'sgu20141468', 'sgu20151485', 'ankitraj9', 'mostafa200100', 'sgu20121532', 'esoomoh64', 'sgu20151424', 'velurihasita', 'latifaalfardan', 'leo666', 'ibrahimkamal1997', 'assemabdelmoniem', 'julianna', 'zhangziyan', 'hgowaily', 'lindatalts', 'engtuan123', 'sgu20161494', 'loaydiaa', 'kabinaya08', 'mariamzanaty', 'sgu20171570', 'sgu20141483', 'zeyadahmedbadr97', 'gopijettiboyina841', 'nimashi001', 'nkvv88', 'mohamedabdelmeged', 'scientist.affawn', 'indronil.ghosh27', 'jackhoeniges', 'zackkk123', 'mimo007007', 'sgu20151513', 'mariomedhat9', 'michaelguevara', 'cbzkcbzk1', 'hagarkhaled', 'bperera', 'jorgealexandre', 'jojosazziz', 'salmasaher', 'tutulalala', 'shamyofficial2', 'zhichongcarl', 'jlong1028', 'cuoghimarco', 'sgu20141393', 'hanamant17', 'amgadsami1998', 'shaikyahul77', 'sgu20161503', 'zenaj', 'khaledshehab44', 'khaledhigazy94', 'saramahmoud19', 'rahmanr3', 'ayaabdelrahim', 'faharalalawi', 'sgu20141471', 'sgu20151194', 'lennynator92', 'dko1217', 'ooooo18', 'sgu20141394', 'amirnabilhanna', 'ayoyayoyo2008', 'radwa123', 'toqa1999', 'mjkingdem', 'sgu20141408', 'ramyadel1313', 'mohanad.waheed9', 'sgu20121498', 'kingmokey', 'salman1999', 'hala97', 'amrsaeed012', 'icey123', 'sgu20171550', 'youssef_essam', 'johan.iswara', 'ekhlas3535', 'f.elgebaly', 'hongyan', 'sgu20141461', 'visionsofshiva', 'sgu20131492', 'hour', 'mohameddomy97', 'zhangnianchen', 'abdo1703', 'neuton']",8,"['mickeym', 'siddharthsahu912', 'd.ramos.santesmases', 'chuhang.jin', 'zhehan666', 'tangjiemu', None, 'minchaoan']",344,"['yasmine317', 'mitchelld2', 'john17.su', 'asmaahussein99', 'engmo3taz99', 'simon1205', 'hamedamr95', 'unal', 'luca.riccies', 'sgu20171586', 'lisifan', 'tingyu.qu', 'memonona017', 'heba_star1999', 'jkson3', 'nadaessam', 'addashti', 'yara.magdy222', 'bellayang', 'sg20121208', 'muhammed.number', 'pradeep_c17', 'sgu20131481', 'tangjiemu', 'muhamriaz', 'almoatasem_bellah', 'sayeedrm', 'sgu20151422', 'sgu20141448', 'plloydwright', 'sgu20131507', 'dsreynolds93', 'sgu2014726019', 'lamyaalfa', 'aubai.hassan98', 'a.omar125242', 'ayakhaled4897', 'c15444808', 'tktm44', 'aradwa477', 'husalaa98', 'shy19951119', 'sgu20151438', 'wenfeng', 'roddaro', 'omniapinkflower', 'hayaat', 'horstmannbm', 'sgu20151486', 'wangmingzhu', 'mariam0', 'changlin2328', 'heshamebrahim123', 'wpsun319', 'sgu20131455', 'timmy_mer', 'eric.kosdi', 'vb9237865', 'sgu20151456', 'hamda', 'nalvarez92', 'gjfdjzo', 'ionsko', 'sgu20151464', 'monikaa', 'leeann901', 'weka_201219', 'abdulrahmangalal', 'sgu20131462', 'hbg2112', 'goddoggo', 'duweigg', 'sogang20141460', 'sgu20141478', 'sgu20171566', 'sgu20141414', 'sgu20161542', 'tianzk2', 'mohammed_naveed', 'nayeramansour', 'juhu93', 'youmna.moussa2016', 'sgu20161474', 'abdelazimmohamed98', 'sgu20131432', 'sgu20171490', 'sgu20151436', 'hanamantmn999', 'dydgus201', 'bassem8989', 'nourhanmagdymahmoud', 'jxc248006', 'aya.mohamed97', 'sgu20151478', 'akarkotis94', 'sgu20151418', 'bassem_mazen', 'sgu20171572', 'nelwagdy', 'ataulmamun', 'ayamohamed', 'harry0913', 'demonleon1995', 'caowd92', 'yangqu', 'ppjunb12', 'nayerakhaled', 'mennatallamostafa87', 'nahlatarek', 'ahmadabdelsalam', 'bguillet', 'xanxo18', 'naremanallam40', 'henryhe9806', 'zjhnus', 'mazen_ashraf', 'sikaislam66', 'asmaagamalelsayed96', 'nouran_mohamed', 'sgu20141474', 'abdelrhmanadelhassan', 'basmahassan697', 'yaozu', 'jhoeniges', 'akshayb', 'mdabrarshaikh90', 'sgu20141398', 'qky0921', 'sgu20161542e', 'yasmin.gad412', 'simon6599', 'sgu20151463', 'lincolnwang321', 'arvindh', 'sgu20141460', 'sgu20141415', 'a0928404798', 'sgu20131410', 'sgu20171558', 'nouran.tarek97', 'seohyeoniii', 'rinap', 'aymansaadhack', 'olashazly27', 'sgu20151410', 'georgesamy', 'gehadosama', 'monakamel97', 'bbaekssun', 'jishen', 'cxu004', 'tahaa.rore', 'marwan.m96', 'joanliu951001', 'sgu20171502', 'omarz977', 'sgu20171562', 'ruodaz', 'yayman55', 'radu.uta93', 'smrsaravanan', 'amjadtaleb', 'anas_massoud', 'sgu20141389', 'zhehan666', 'ankita.patil.0001', 'mayura0621', 'mohammedmajdyict', 'labmiugac2993', 'sgu20141480', None, 'sgu20171520', 'sgu20141458', 'sgu20141484', 'gyl0428', 'sgu20151490', 'sgu20131412', 'sgu20141476', 'nada.omran', 'jiamin2068', 'tokahossam71', 'ahmedmoustafa771', 'basmagharieb', 'yusuf313', 'ahmad.yasserr', 'wildprince', 'yuelian1234', 'youssefrefaat', 'sgu20091548', 'alaa98', 'mennaessam98', 'estradavictor96', 'sgu20171524', 'ge24', 'mickeym', 'zeinabtaha', 'hananalamri', 'shinsunhak', 'mahmouddeghadi', 'ranaahmed96', 'thapu.putta', 'e0320957', 'sgu20151487', 'guitarist9816', 'sgu20151476', 'bluer', 'sgu20171556', 'mohamedkutb', 'ulas_965', 'mtmaccc', 'chen2712', 'omnia.khaled12', 'a960710', 'bentelghaly', 'jaydm26', 'lemon12345', 'gsabbir87', 'sgu20171508', 'as', 'uozgur', 'sgu20141424', 'e0186014', 'omar_eid73', 'sgu20141430', 'sgu20171503', 'sgu20141417', 'johnmccarthy', 'mustafaakhlak', 'chxxtu2009', 'sgu20151452', 'mohmedaliessa', 'sgu20141411', 'sgu20171526', 'nada5essam', 'salmaaatareeek', 'mohamedallam0000', 'qwu2', 'sgu20141395', 'han20151510', 'nkpuga', 'michaelashraf777', 'donghu', 'muhlasheen2', 'dvid0315', 'yhlee27', 'sgu20131508', 'sgu20141468', 'sgu20151485', 'ankitraj9', 'mostafa200100', 'sgu20121532', 'esoomoh64', 'sgu20151424', 'velurihasita', 'minchaoan', 'latifaalfardan', 'leo666', 'ibrahimkamal1997', 'assemabdelmoniem', 'julianna', 'zhangziyan', 'hgowaily', 'lindatalts', 'engtuan123', 'sgu20161494', 'loaydiaa', 'kabinaya08', 'mariamzanaty', 'siddharthsahu912', 'sgu20171570', 'sgu20141483', 'zeyadahmedbadr97', 'gopijettiboyina841', 'nimashi001', 'nkvv88', 'mohamedabdelmeged', 'scientist.affawn', 'indronil.ghosh27', 'jackhoeniges', 'zackkk123', 'mimo007007', 'sgu20151513', 'mariomedhat9', 'michaelguevara', 'cbzkcbzk1', 'hagarkhaled', 'bperera', 'jorgealexandre', 'jojosazziz', 'd.ramos.santesmases', 'salmasaher', 'tutulalala', 'shamyofficial2', 'zhichongcarl', 'jlong1028', 'cuoghimarco', 'sgu20141393', 'hanamant17', 'amgadsami1998', 'shaikyahul77', 'sgu20161503', 'chuhang.jin', 'zenaj', 'khaledshehab44', 'khaledhigazy94', 'saramahmoud19', 'rahmanr3', 'ayaabdelrahim', 'faharalalawi', 'sgu20141471', 'sgu20151194', 'lennynator92', 'dko1217', 'ooooo18', 'sgu20141394', 'amirnabilhanna', 'ayoyayoyo2008', 'radwa123', 'toqa1999', 'mjkingdem', 'sgu20141408', 'ramyadel1313', 'mohanad.waheed9', 'sgu20121498', 'kingmokey', 'salman1999', 'hala97', 'amrsaeed012', 'icey123', 'sgu20171550', 'youssef_essam', 'johan.iswara', 'ekhlas3535', 'f.elgebaly', 'hongyan', 'sgu20141461', 'visionsofshiva', 'sgu20131492', 'weeei0514', 'hour', 'mohameddomy97', 'zhangnianchen', 'abdo1703', 'neuton']"
1,16,336,8,5,"['nkpuga', 'sayeedrm', 'rahmanr3', 'ataulmamun', 'horstmannbm']",331,"['yasmine317', 'mitchelld2', 'john17.su', 'asmaahussein99', 'engmo3taz99', 'simon1205', 'hamedamr95', 'unal', 'luca.riccies', 'sgu20171586', 'lisifan', 'tingyu.qu', 'memonona017', 'heba_star1999', 'jkson3', 'nadaessam', 'addashti', 'yara.magdy222', 'bellayang', 'sg20121208', 'muhammed.number', 'pradeep_c17', 'sgu20131481', 'muhamriaz', 'almoatasem_bellah', 'sgu20151422', 'sgu20141448', 'plloydwright', 'sgu20131507', 'dsreynolds93', 'sgu2014726019', 'lamyaalfa', 'aubai.hassan98', 'a.omar125242', 'ayakhaled4897', 'c15444808', 'tktm44', 'aradwa477', 'husalaa98', 'shy19951119', 'sgu20151438', 'wenfeng', 'roddaro', 'omniapinkflower', 'hayaat', 'sgu20151486', 'wangmingzhu', 'mariam0', 'changlin2328', 'heshamebrahim123', 'wpsun319', 'sgu20131455', 'timmy_mer', 'eric.kosdi', 'vb9237865', 'sgu20151456', 'hamda', 'nalvarez92', 'gjfdjzo', 'ionsko', 'sgu20151464', 'monikaa', 'leeann901', 'weka_201219', 'abdulrahmangalal', 'sgu20131462', 'hbg2112', 'goddoggo', 'duweigg', 'sogang20141460', 'sgu20141478', 'sgu20171566', 'sgu20141414', 'sgu20161542', 'tianzk2', 'mohammed_naveed', 'nayeramansour', 'juhu93', 'youmna.moussa2016', 'sgu20161474', 'abdelazimmohamed98', 'sgu20131432', 'sgu20171490', 'sgu20151436', 'hanamantmn999', 'dydgus201', 'bassem8989', 'nourhanmagdymahmoud', 'jxc248006', 'aya.mohamed97', 'sgu20151478', 'akarkotis94', 'sgu20151418', 'bassem_mazen', 'sgu20171572', 'nelwagdy', 'ayamohamed', 'harry0913', 'demonleon1995', 'caowd92', 'yangqu', 'ppjunb12', 'nayerakhaled', 'mennatallamostafa87', 'nahlatarek', 'ahmadabdelsalam', 'bguillet', 'xanxo18', 'naremanallam40', 'henryhe9806', 'zjhnus', 'mazen_ashraf', 'sikaislam66', 'asmaagamalelsayed96', 'nouran_mohamed', 'sgu20141474', 'abdelrhmanadelhassan', 'basmahassan697', 'yaozu', 'jhoeniges', 'akshayb', 'mdabrarshaikh90', 'sgu20141398', 'qky0921', 'sgu20161542e', 'yasmin.gad412', 'simon6599', 'sgu20151463', 'lincolnwang321', 'arvindh', 'sgu20141460', 'sgu20141415', 'a0928404798', 'sgu20131410', 'sgu20171558', 'nouran.tarek97', 'seohyeoniii', 'rinap', 'aymansaadhack', 'olashazly27', 'sgu20151410', 'georgesamy', 'gehadosama', 'monakamel97', 'bbaekssun', 'jishen', 'cxu004', 'tahaa.rore', 'marwan.m96', 'joanliu951001', 'sgu20171502', 'omarz977', 'sgu20171562', 'ruodaz', 'yayman55', 'radu.uta93', 'smrsaravanan', 'amjadtaleb', 'anas_massoud', 'sgu20141389', 'ankita.patil.0001', 'mayura0621', 'mohammedmajdyict', 'labmiugac2993', 'sgu20141480', 'sgu20171520', 'sgu20141458', 'sgu20141484', 'gyl0428', 'sgu20151490', 'sgu20131412', 'sgu20141476', 'nada.omran', 'jiamin2068', 'tokahossam71', 'ahmedmoustafa771', 'basmagharieb', 'yusuf313', 'ahmad.yasserr', 'wildprince', 'yuelian1234', 'youssefrefaat', 'sgu20091548', 'alaa98', 'mennaessam98', 'estradavictor96', 'sgu20171524', 'ge24', 'zeinabtaha', 'hananalamri', 'shinsunhak', 'mahmouddeghadi', 'ranaahmed96', 'thapu.putta', 'e0320957', 'sgu20151487', 'guitarist9816', 'sgu20151476', 'bluer', 'sgu20171556', 'mohamedkutb', 'ulas_965', 'mtmaccc', 'chen2712', 'omnia.khaled12', 'a960710', 'bentelghaly', 'jaydm26', 'lemon12345', 'gsabbir87', 'sgu20171508', 'as', 'uozgur', 'sgu20141424', 'e0186014', 'omar_eid73', 'sgu20141430', 'sgu20171503', 'sgu20141417', 'johnmccarthy', 'mustafaakhlak', 'chxxtu2009', 'sgu20151452', 'mohmedaliessa', 'sgu20141411', 'sgu20171526', 'nada5essam', 'salmaaatareeek', 'mohamedallam0000', 'qwu2', 'sgu20141395', 'han20151510', 'michaelashraf777', 'donghu', 'muhlasheen2', 'dvid0315', 'yhlee27', 'sgu20131508', 'sgu20141468', 'sgu20151485', 'ankitraj9', 'mostafa200100', 'sgu20121532', 'esoomoh64', 'sgu20151424', 'velurihasita', 'latifaalfardan', 'leo666', 'ibrahimkamal1997', 'assemabdelmoniem', 'julianna', 'zhangziyan', 'hgowaily', 'lindatalts', 'engtuan123', 'sgu20161494', 'loaydiaa', 'kabinaya08', 'mariamzanaty', 'sgu20171570', 'sgu20141483', 'zeyadahmedbadr97', 'gopijettiboyina841', 'nimashi001', 'nkvv88', 'mohamedabdelmeged', 'scientist.affawn', 'indronil.ghosh27', 'jackhoeniges', 'zackkk123', 'mimo007007', 'sgu20151513', 'mariomedhat9', 'michaelguevara', 'cbzkcbzk1', 'hagarkhaled', 'bperera', 'jorgealexandre', 'jojosazziz', 'salmasaher', 'tutulalala', 'shamyofficial2', 'zhichongcarl', 'jlong1028', 'cuoghimarco', 'sgu20141393', 'hanamant17', 'amgadsami1998', 'shaikyahul77', 'sgu20161503', 'zenaj', 'khaledshehab44', 'khaledhigazy94', 'saramahmoud19', 'ayaabdelrahim', 'faharalalawi', 'sgu20141471', 'sgu20151194', 'lennynator92', 'dko1217', 'ooooo18', 'sgu20141394', 'amirnabilhanna', 'ayoyayoyo2008', 'radwa123', 'toqa1999', 'mjkingdem', 'sgu20141408', 'ramyadel1313', 'mohanad.waheed9', 'sgu20121498', 'kingmokey', 'salman1999', 'hala97', 'amrsaeed012', 'icey123', 'sgu20171550', 'youssef_essam', 'johan.iswara', 'ekhlas3535', 'f.elgebaly', 'hongyan', 'sgu20141461', 'visionsofshiva', 'sgu20131492', 'weeei0514', 'hour', 'mohameddomy97', 'zhangnianchen', 'abdo1703', 'neuton']",3,"[None, 'dhruv.fomra', 'gigantems']",339,"['yasmine317', 'mitchelld2', 'john17.su', 'asmaahussein99', 'engmo3taz99', 'simon1205', 'hamedamr95', 'unal', 'luca.riccies', 'sgu20171586', 'lisifan', 'tingyu.qu', 'memonona017', 'heba_star1999', 'jkson3', 'nadaessam', 'addashti', 'yara.magdy222', 'bellayang', 'sg20121208', 'muhammed.number', 'pradeep_c17', 'sgu20131481', 'muhamriaz', 'almoatasem_bellah', 'sayeedrm', 'sgu20151422', 'sgu20141448', 'plloydwright', 'sgu20131507', 'dsreynolds93', 'sgu2014726019', 'lamyaalfa', 'aubai.hassan98', 'a.omar125242', 'ayakhaled4897', 'c15444808', 'tktm44', 'aradwa477', 'husalaa98', 'shy19951119', 'sgu20151438', 'wenfeng', 'roddaro', 'omniapinkflower', 'hayaat', 'horstmannbm', 'sgu20151486', 'wangmingzhu', 'mariam0', 'changlin2328', 'heshamebrahim123', 'wpsun319', 'sgu20131455', 'timmy_mer', 'eric.kosdi', 'vb9237865', 'sgu20151456', 'hamda', 'nalvarez92', 'gjfdjzo', 'ionsko', 'sgu20151464', 'monikaa', 'leeann901', 'weka_201219', 'abdulrahmangalal', 'sgu20131462', 'hbg2112', 'goddoggo', 'duweigg', 'sogang20141460', 'sgu20141478', 'sgu20171566', 'sgu20141414', 'sgu20161542', 'tianzk2', 'mohammed_naveed', 'nayeramansour', 'juhu93', 'youmna.moussa2016', 'sgu20161474', 'abdelazimmohamed98', 'sgu20131432', 'sgu20171490', 'sgu20151436', 'hanamantmn999', 'dydgus201', 'bassem8989', 'nourhanmagdymahmoud', 'jxc248006', 'aya.mohamed97', 'sgu20151478', 'akarkotis94', 'sgu20151418', 'bassem_mazen', 'sgu20171572', 'nelwagdy', 'ataulmamun', 'ayamohamed', 'harry0913', 'demonleon1995', 'caowd92', 'yangqu', 'ppjunb12', 'nayerakhaled', 'mennatallamostafa87', 'nahlatarek', 'ahmadabdelsalam', 'bguillet', 'xanxo18', 'naremanallam40', 'henryhe9806', 'zjhnus', 'mazen_ashraf', 'sikaislam66', 'asmaagamalelsayed96', 'nouran_mohamed', 'sgu20141474', 'abdelrhmanadelhassan', 'basmahassan697', 'yaozu', 'jhoeniges', 'akshayb', 'mdabrarshaikh90', 'sgu20141398', 'qky0921', 'sgu20161542e', 'yasmin.gad412', 'simon6599', 'sgu20151463', 'lincolnwang321', 'arvindh', 'sgu20141460', 'sgu20141415', 'a0928404798', 'sgu20131410', 'sgu20171558', 'nouran.tarek97', 'seohyeoniii', 'rinap', 'aymansaadhack', 'olashazly27', 'sgu20151410', 'georgesamy', 'gehadosama', 'monakamel97', 'bbaekssun', 'jishen', 'cxu004', 'tahaa.rore', 'marwan.m96', 'joanliu951001', 'sgu20171502', 'omarz977', 'sgu20171562', 'ruodaz', 'yayman55', 'radu.uta93', 'smrsaravanan', 'amjadtaleb', 'anas_massoud', 'sgu20141389', 'ankita.patil.0001', 'mayura0621', 'mohammedmajdyict', 'labmiugac2993', 'sgu20141480', None, 'sgu20171520', 'sgu20141458', 'sgu20141484', 'gyl0428', 'sgu20151490', 'sgu20131412', 'sgu20141476', 'nada.omran', 'jiamin2068', 'tokahossam71', 'ahmedmoustafa771', 'basmagharieb', 'yusuf313', 'ahmad.yasserr', 'wildprince', 'yuelian1234', 'youssefrefaat', 'sgu20091548', 'alaa98', 'mennaessam98', 'estradavictor96', 'sgu20171524', 'ge24', 'zeinabtaha', 'hananalamri', 'shinsunhak', 'mahmouddeghadi', 'ranaahmed96', 'thapu.putta', 'e0320957', 'sgu20151487', 'guitarist9816', 'sgu20151476', 'bluer', 'sgu20171556', 'mohamedkutb', 'ulas_965', 'mtmaccc', 'chen2712', 'omnia.khaled12', 'a960710', 'bentelghaly', 'jaydm26', 'lemon12345', 'gsabbir87', 'sgu20171508', 'as', 'uozgur', 'sgu20141424', 'e0186014', 'omar_eid73', 'sgu20141430', 'sgu20171503', 'sgu20141417', 'johnmccarthy', 'mustafaakhlak', 'chxxtu2009', 'sgu20151452', 'mohmedaliessa', 'sgu20141411', 'sgu20171526', 'nada5essam', 'salmaaatareeek', 'mohamedallam0000', 'qwu2', 'sgu20141395', 'han20151510', 'nkpuga', 'michaelashraf777', 'donghu', 'muhlasheen2', 'dvid0315', 'yhlee27', 'sgu20131508', 'sgu20141468', 'sgu20151485', 'ankitraj9', 'mostafa200100', 'sgu20121532', 'esoomoh64', 'sgu20151424', 'velurihasita', 'latifaalfardan', 'leo666', 'ibrahimkamal1997', 'assemabdelmoniem', 'julianna', 'zhangziyan', 'hgowaily', 'lindatalts', 'engtuan123', 'sgu20161494', 'loaydiaa', 'kabinaya08', 'mariamzanaty', 'sgu20171570', 'sgu20141483', 'zeyadahmedbadr97', 'gopijettiboyina841', 'nimashi001', 'nkvv88', 'mohamedabdelmeged', 'scientist.affawn', 'indronil.ghosh27', 'jackhoeniges', 'zackkk123', 'mimo007007', 'sgu20151513', 'mariomedhat9', 'michaelguevara', 'cbzkcbzk1', 'hagarkhaled', 'bperera', 'jorgealexandre', 'jojosazziz', 'salmasaher', 'tutulalala', 'shamyofficial2', 'zhichongcarl', 'jlong1028', 'cuoghimarco', 'sgu20141393', 'hanamant17', 'amgadsami1998', 'shaikyahul77', 'sgu20161503', 'dhruv.fomra', 'zenaj', 'khaledshehab44', 'khaledhigazy94', 'saramahmoud19', 'rahmanr3', 'ayaabdelrahim', 'faharalalawi', 'sgu20141471', 'sgu20151194', 'lennynator92', 'dko1217', 'ooooo18', 'sgu20141394', 'amirnabilhanna', 'ayoyayoyo2008', 'radwa123', 'toqa1999', 'mjkingdem', 'sgu20141408', 'ramyadel1313', 'mohanad.waheed9', 'sgu20121498', 'kingmokey', 'salman1999', 'hala97', 'amrsaeed012', 'icey123', 'sgu20171550', 'youssef_essam', 'johan.iswara', 'ekhlas3535', 'f.elgebaly', 'hongyan', 'gigantems', 'sgu20141461', 'visionsofshiva', 'sgu20131492', 'weeei0514', 'hour', 'mohameddomy97', 'zhangnianchen', 'abdo1703', 'neuton']"
1,21,336,7,3,"['ekhlas3535', 'faharalalawi', 'lamyaalfa']",333,"['yasmine317', 'mitchelld2', 'john17.su', 'asmaahussein99', 'engmo3taz99', 'simon1205', 'hamedamr95', 'unal', 'luca.riccies', 'sgu20171586', 'lisifan', 'tingyu.qu', 'memonona017', 'heba_star1999', 'jkson3', 'nadaessam', 'addashti', 'yara.magdy222', 'bellayang', 'sg20121208', 'muhammed.number', 'pradeep_c17', 'sgu20131481', 'muhamriaz', 'almoatasem_bellah', 'sayeedrm', 'sgu20151422', 'sgu20141448', 'plloydwright', 'sgu20131507', 'dsreynolds93', 'sgu2014726019', 'aubai.hassan98', 'a.omar125242', 'ayakhaled4897', 'c15444808', 'tktm44', 'aradwa477', 'husalaa98', 'shy19951119', 'sgu20151438', 'wenfeng', 'roddaro', 'omniapinkflower', 'hayaat', 'horstmannbm', 'sgu20151486', 'wangmingzhu', 'mariam0', 'changlin2328', 'heshamebrahim123', 'wpsun319', 'sgu20131455', 'timmy_mer', 'eric.kosdi', 'vb9237865', 'sgu20151456', 'hamda', 'nalvarez92', 'gjfdjzo', 'ionsko', 'sgu20151464', 'monikaa', 'leeann901', 'weka_201219', 'abdulrahmangalal', 'sgu20131462', 'hbg2112', 'goddoggo', 'duweigg', 'sogang20141460', 'sgu20141478', 'sgu20171566', 'sgu20141414', 'sgu20161542', 'tianzk2', 'mohammed_naveed', 'nayeramansour', 'juhu93', 'youmna.moussa2016', 'sgu20161474', 'abdelazimmohamed98', 'sgu20131432', 'sgu20171490', 'sgu20151436', 'hanamantmn999', 'dydgus201', 'bassem8989', 'nourhanmagdymahmoud', 'jxc248006', 'aya.mohamed97', 'sgu20151478', 'akarkotis94', 'sgu20151418', 'bassem_mazen', 'sgu20171572', 'nelwagdy', 'ataulmamun', 'ayamohamed', 'harry0913', 'demonleon1995', 'caowd92', 'yangqu', 'ppjunb12', 'nayerakhaled', 'mennatallamostafa87', 'nahlatarek', 'ahmadabdelsalam', 'bguillet', 'xanxo18', 'naremanallam40', 'henryhe9806', 'zjhnus', 'mazen_ashraf', 'sikaislam66', 'asmaagamalelsayed96', 'nouran_mohamed', 'sgu20141474', 'abdelrhmanadelhassan', 'basmahassan697', 'yaozu', 'jhoeniges', 'akshayb', 'mdabrarshaikh90', 'sgu20141398', 'qky0921', 'sgu20161542e', 'yasmin.gad412', 'simon6599', 'sgu20151463', 'lincolnwang321', 'arvindh', 'sgu20141460', 'sgu20141415', 'a0928404798', 'sgu20131410', 'sgu20171558', 'nouran.tarek97', 'seohyeoniii', 'rinap', 'aymansaadhack', 'olashazly27', 'sgu20151410', 'georgesamy', 'gehadosama', 'monakamel97', 'bbaekssun', 'jishen', 'cxu004', 'tahaa.rore', 'marwan.m96', 'joanliu951001', 'sgu20171502', 'omarz977', 'sgu20171562', 'ruodaz', 'yayman55', 'radu.uta93', 'smrsaravanan', 'amjadtaleb', 'anas_massoud', 'sgu20141389', 'ankita.patil.0001', 'mayura0621', 'mohammedmajdyict', 'labmiugac2993', 'sgu20141480', 'sgu20171520', 'sgu20141458', 'sgu20141484', 'gyl0428', 'sgu20151490', 'sgu20131412', 'sgu20141476', 'nada.omran', 'jiamin2068', 'tokahossam71', 'ahmedmoustafa771', 'basmagharieb', 'yusuf313', 'ahmad.yasserr', 'wildprince', 'yuelian1234', 'youssefrefaat', 'sgu20091548', 'alaa98', 'mennaessam98', 'estradavictor96', 'sgu20171524', 'ge24', 'zeinabtaha', 'hananalamri', 'shinsunhak', 'mahmouddeghadi', 'ranaahmed96', 'thapu.putta', 'e0320957', 'sgu20151487', 'guitarist9816', 'sgu20151476', 'bluer', 'sgu20171556', 'mohamedkutb', 'ulas_965', 'mtmaccc', 'chen2712', 'omnia.khaled12', 'a960710', 'bentelghaly', 'jaydm26', 'lemon12345', 'gsabbir87', 'sgu20171508', 'as', 'uozgur', 'sgu20141424', 'e0186014', 'omar_eid73', 'sgu20141430', 'sgu20171503', 'sgu20141417', 'johnmccarthy', 'mustafaakhlak', 'chxxtu2009', 'sgu20151452', 'mohmedaliessa', 'sgu20141411', 'sgu20171526', 'nada5essam', 'salmaaatareeek', 'mohamedallam0000', 'qwu2', 'sgu20141395', 'han20151510', 'nkpuga', 'michaelashraf777', 'donghu', 'muhlasheen2', 'dvid0315', 'yhlee27', 'sgu20131508', 'sgu20141468', 'sgu20151485', 'ankitraj9', 'mostafa200100', 'sgu20121532', 'esoomoh64', 'sgu20151424', 'velurihasita', 'latifaalfardan', 'leo666', 'ibrahimkamal1997', 'assemabdelmoniem', 'julianna', 'zhangziyan', 'hgowaily', 'lindatalts', 'engtuan123', 'sgu20161494', 'loaydiaa', 'kabinaya08', 'mariamzanaty', 'sgu20171570', 'sgu20141483', 'zeyadahmedbadr97', 'gopijettiboyina841', 'nimashi001', 'nkvv88', 'mohamedabdelmeged', 'scientist.affawn', 'indronil.ghosh27', 'jackhoeniges', 'zackkk123', 'mimo007007', 'sgu20151513', 'mariomedhat9', 'michaelguevara', 'cbzkcbzk1', 'hagarkhaled', 'bperera', 'jorgealexandre', 'jojosazziz', 'salmasaher', 'tutulalala', 'shamyofficial2', 'zhichongcarl', 'jlong1028', 'cuoghimarco', 'sgu20141393', 'hanamant17', 'amgadsami1998', 'shaikyahul77', 'sgu20161503', 'zenaj', 'khaledshehab44', 'khaledhigazy94', 'saramahmoud19', 'rahmanr3', 'ayaabdelrahim', 'sgu20141471', 'sgu20151194', 'lennynator92', 'dko1217', 'ooooo18', 'sgu20141394', 'amirnabilhanna', 'ayoyayoyo2008', 'radwa123', 'toqa1999', 'mjkingdem', 'sgu20141408', 'ramyadel1313', 'mohanad.waheed9', 'sgu20121498', 'kingmokey', 'salman1999', 'hala97', 'amrsaeed012', 'icey123', 'sgu20171550', 'youssef_essam', 'johan.iswara', 'f.elgebaly', 'hongyan', 'sgu20141461', 'visionsofshiva', 'sgu20131492', 'weeei0514', 'hour', 'mohameddomy97', 'zhangnianchen', 'abdo1703', 'neuton']",4,"['tewfik79', 'malik89oman', None, 'osama005']",340,"['yasmine317', 'mitchelld2', 'john17.su', 'asmaahussein99', 'engmo3taz99', 'simon1205', 'hamedamr95', 'unal', 'luca.riccies', 'sgu20171586', 'lisifan', 'tingyu.qu', 'memonona017', 'heba_star1999', 'jkson3', 'nadaessam', 'addashti', 'yara.magdy222', 'bellayang', 'sg20121208', 'muhammed.number', 'pradeep_c17', 'sgu20131481', 'osama005', 'muhamriaz', 'almoatasem_bellah', 'sayeedrm', 'sgu20151422', 'sgu20141448', 'plloydwright', 'sgu20131507', 'dsreynolds93', 'sgu2014726019', 'lamyaalfa', 'aubai.hassan98', 'a.omar125242', 'ayakhaled4897', 'c15444808', 'tktm44', 'aradwa477', 'husalaa98', 'shy19951119', 'sgu20151438', 'wenfeng', 'roddaro', 'tewfik79', 'omniapinkflower', 'hayaat', 'horstmannbm', 'sgu20151486', 'wangmingzhu', 'mariam0', 'changlin2328', 'heshamebrahim123', 'wpsun319', 'sgu20131455', 'timmy_mer', 'eric.kosdi', 'vb9237865', 'sgu20151456', 'hamda', 'nalvarez92', 'gjfdjzo', 'ionsko', 'sgu20151464', 'monikaa', 'leeann901', 'weka_201219', 'abdulrahmangalal', 'sgu20131462', 'hbg2112', 'goddoggo', 'duweigg', 'sogang20141460', 'sgu20141478', 'sgu20171566', 'sgu20141414', 'sgu20161542', 'tianzk2', 'mohammed_naveed', 'nayeramansour', 'juhu93', 'youmna.moussa2016', 'sgu20161474', 'abdelazimmohamed98', 'sgu20131432', 'sgu20171490', 'sgu20151436', 'hanamantmn999', 'dydgus201', 'bassem8989', 'nourhanmagdymahmoud', 'jxc248006', 'aya.mohamed97', 'sgu20151478', 'akarkotis94', 'sgu20151418', 'bassem_mazen', 'sgu20171572', 'nelwagdy', 'ataulmamun', 'ayamohamed', 'harry0913', 'demonleon1995', 'caowd92', 'yangqu', 'ppjunb12', 'nayerakhaled', 'mennatallamostafa87', 'nahlatarek', 'ahmadabdelsalam', 'bguillet', 'xanxo18', 'naremanallam40', 'henryhe9806', 'zjhnus', 'mazen_ashraf', 'sikaislam66', 'asmaagamalelsayed96', 'nouran_mohamed', 'sgu20141474', 'abdelrhmanadelhassan', 'basmahassan697', 'yaozu', 'jhoeniges', 'akshayb', 'mdabrarshaikh90', 'sgu20141398', 'qky0921', 'sgu20161542e', 'yasmin.gad412', 'simon6599', 'sgu20151463', 'lincolnwang321', 'arvindh', 'sgu20141460', 'sgu20141415', 'a0928404798', 'sgu20131410', 'sgu20171558', 'nouran.tarek97', 'seohyeoniii', 'rinap', 'aymansaadhack', 'olashazly27', 'sgu20151410', 'georgesamy', 'gehadosama', 'monakamel97', 'bbaekssun', 'jishen', 'cxu004', 'tahaa.rore', 'marwan.m96', 'joanliu951001', 'sgu20171502', 'omarz977', 'sgu20171562', 'ruodaz', 'yayman55', 'radu.uta93', 'smrsaravanan', 'amjadtaleb', 'anas_massoud', 'sgu20141389', 'ankita.patil.0001', 'mayura0621', 'mohammedmajdyict', 'labmiugac2993', 'sgu20141480', None, 'sgu20171520', 'sgu20141458', 'sgu20141484', 'gyl0428', 'sgu20151490', 'sgu20131412', 'sgu20141476', 'nada.omran', 'jiamin2068', 'tokahossam71', 'ahmedmoustafa771', 'basmagharieb', 'yusuf313', 'ahmad.yasserr', 'wildprince', 'yuelian1234', 'youssefrefaat', 'sgu20091548', 'alaa98', 'mennaessam98', 'estradavictor96', 'sgu20171524', 'ge24', 'zeinabtaha', 'hananalamri', 'shinsunhak', 'mahmouddeghadi', 'ranaahmed96', 'thapu.putta', 'e0320957', 'sgu20151487', 'guitarist9816', 'sgu20151476', 'bluer', 'sgu20171556', 'mohamedkutb', 'ulas_965', 'mtmaccc', 'chen2712', 'omnia.khaled12', 'a960710', 'bentelghaly', 'jaydm26', 'lemon12345', 'gsabbir87', 'sgu20171508', 'as', 'uozgur', 'sgu20141424', 'e0186014', 'omar_eid73', 'sgu20141430', 'sgu20171503', 'sgu20141417', 'johnmccarthy', 'mustafaakhlak', 'chxxtu2009', 'sgu20151452', 'mohmedaliessa', 'sgu20141411', 'sgu20171526', 'nada5essam', 'salmaaatareeek', 'mohamedallam0000', 'qwu2', 'sgu20141395', 'han20151510', 'nkpuga', 'michaelashraf777', 'donghu', 'muhlasheen2', 'dvid0315', 'yhlee27', 'sgu20131508', 'sgu20141468', 'sgu20151485', 'ankitraj9', 'mostafa200100', 'sgu20121532', 'esoomoh64', 'sgu20151424', 'velurihasita', 'latifaalfardan', 'leo666', 'ibrahimkamal1997', 'assemabdelmoniem', 'julianna', 'zhangziyan', 'hgowaily', 'lindatalts', 'engtuan123', 'sgu20161494', 'loaydiaa', 'kabinaya08', 'mariamzanaty', 'sgu20171570', 'sgu20141483', 'zeyadahmedbadr97', 'gopijettiboyina841', 'nimashi001', 'nkvv88', 'mohamedabdelmeged', 'scientist.affawn', 'indronil.ghosh27', 'jackhoeniges', 'zackkk123', 'mimo007007', 'sgu20151513', 'mariomedhat9', 'michaelguevara', 'cbzkcbzk1', 'hagarkhaled', 'bperera', 'jorgealexandre', 'jojosazziz', 'salmasaher', 'tutulalala', 'shamyofficial2', 'zhichongcarl', 'jlong1028', 'cuoghimarco', 'sgu20141393', 'hanamant17', 'amgadsami1998', 'shaikyahul77', 'sgu20161503', 'malik89oman', 'zenaj', 'khaledshehab44', 'khaledhigazy94', 'saramahmoud19', 'rahmanr3', 'ayaabdelrahim', 'faharalalawi', 'sgu20141471', 'sgu20151194', 'lennynator92', 'dko1217', 'ooooo18', 'sgu20141394', 'amirnabilhanna', 'ayoyayoyo2008', 'radwa123', 'toqa1999', 'mjkingdem', 'sgu20141408', 'ramyadel1313', 'mohanad.waheed9', 'sgu20121498', 'kingmokey', 'salman1999', 'hala97', 'amrsaeed012', 'icey123', 'sgu20171550', 'youssef_essam', 'johan.iswara', 'ekhlas3535', 'f.elgebaly', 'hongyan', 'sgu20141461', 'visionsofshiva', 'sgu20131492', 'weeei0514', 'hour', 'mohameddomy97', 'zhangnianchen', 'abdo1703', 'neuton']"
1,24,336,7,3,"['ekhlas3535', 'faharalalawi', 'lamyaalfa']",333,"['yasmine317', 'mitchelld2', 'john17.su', 'asmaahussein99', 'engmo3taz99', 'simon1205', 'hamedamr95', 'unal', 'luca.riccies', 'sgu20171586', 'lisifan', 'tingyu.qu', 'memonona017', 'heba_star1999', 'jkson3', 'nadaessam', 'addashti', 'yara.magdy222', 'bellayang', 'sg20121208', 'muhammed.number', 'pradeep_c17', 'sgu20131481', 'muhamriaz', 'almoatasem_bellah', 'sayeedrm', 'sgu20151422', 'sgu20141448', 'plloydwright', 'sgu20131507', 'dsreynolds93', 'sgu2014726019', 'aubai.hassan98', 'a.omar125242', 'ayakhaled4897', 'c15444808', 'tktm44', 'aradwa477', 'husalaa98', 'shy19951119', 'sgu20151438', 'wenfeng', 'roddaro', 'omniapinkflower', 'hayaat', 'horstmannbm', 'sgu20151486', 'wangmingzhu', 'mariam0', 'changlin2328', 'heshamebrahim123', 'wpsun319', 'sgu20131455', 'timmy_mer', 'eric.kosdi', 'vb9237865', 'sgu20151456', 'hamda', 'nalvarez92', 'gjfdjzo', 'ionsko', 'sgu20151464', 'monikaa', 'leeann901', 'weka_201219', 'abdulrahmangalal', 'sgu20131462', 'hbg2112', 'goddoggo', 'duweigg', 'sogang20141460', 'sgu20141478', 'sgu20171566', 'sgu20141414', 'sgu20161542', 'tianzk2', 'mohammed_naveed', 'nayeramansour', 'juhu93', 'youmna.moussa2016', 'sgu20161474', 'abdelazimmohamed98', 'sgu20131432', 'sgu20171490', 'sgu20151436', 'hanamantmn999', 'dydgus201', 'bassem8989', 'nourhanmagdymahmoud', 'jxc248006', 'aya.mohamed97', 'sgu20151478', 'akarkotis94', 'sgu20151418', 'bassem_mazen', 'sgu20171572', 'nelwagdy', 'ataulmamun', 'ayamohamed', 'harry0913', 'demonleon1995', 'caowd92', 'yangqu', 'ppjunb12', 'nayerakhaled', 'mennatallamostafa87', 'nahlatarek', 'ahmadabdelsalam', 'bguillet', 'xanxo18', 'naremanallam40', 'henryhe9806', 'zjhnus', 'mazen_ashraf', 'sikaislam66', 'asmaagamalelsayed96', 'nouran_mohamed', 'sgu20141474', 'abdelrhmanadelhassan', 'basmahassan697', 'yaozu', 'jhoeniges', 'akshayb', 'mdabrarshaikh90', 'sgu20141398', 'qky0921', 'sgu20161542e', 'yasmin.gad412', 'simon6599', 'sgu20151463', 'lincolnwang321', 'arvindh', 'sgu20141460', 'sgu20141415', 'a0928404798', 'sgu20131410', 'sgu20171558', 'nouran.tarek97', 'seohyeoniii', 'rinap', 'aymansaadhack', 'olashazly27', 'sgu20151410', 'georgesamy', 'gehadosama', 'monakamel97', 'bbaekssun', 'jishen', 'cxu004', 'tahaa.rore', 'marwan.m96', 'joanliu951001', 'sgu20171502', 'omarz977', 'sgu20171562', 'ruodaz', 'yayman55', 'radu.uta93', 'smrsaravanan', 'amjadtaleb', 'anas_massoud', 'sgu20141389', 'ankita.patil.0001', 'mayura0621', 'mohammedmajdyict', 'labmiugac2993', 'sgu20141480', 'sgu20171520', 'sgu20141458', 'sgu20141484', 'gyl0428', 'sgu20151490', 'sgu20131412', 'sgu20141476', 'nada.omran', 'jiamin2068', 'tokahossam71', 'ahmedmoustafa771', 'basmagharieb', 'yusuf313', 'ahmad.yasserr', 'wildprince', 'yuelian1234', 'youssefrefaat', 'sgu20091548', 'alaa98', 'mennaessam98', 'estradavictor96', 'sgu20171524', 'ge24', 'zeinabtaha', 'hananalamri', 'shinsunhak', 'mahmouddeghadi', 'ranaahmed96', 'thapu.putta', 'e0320957', 'sgu20151487', 'guitarist9816', 'sgu20151476', 'bluer', 'sgu20171556', 'mohamedkutb', 'ulas_965', 'mtmaccc', 'chen2712', 'omnia.khaled12', 'a960710', 'bentelghaly', 'jaydm26', 'lemon12345', 'gsabbir87', 'sgu20171508', 'as', 'uozgur', 'sgu20141424', 'e0186014', 'omar_eid73', 'sgu20141430', 'sgu20171503', 'sgu20141417', 'johnmccarthy', 'mustafaakhlak', 'chxxtu2009', 'sgu20151452', 'mohmedaliessa', 'sgu20141411', 'sgu20171526', 'nada5essam', 'salmaaatareeek', 'mohamedallam0000', 'qwu2', 'sgu20141395', 'han20151510', 'nkpuga', 'michaelashraf777', 'donghu', 'muhlasheen2', 'dvid0315', 'yhlee27', 'sgu20131508', 'sgu20141468', 'sgu20151485', 'ankitraj9', 'mostafa200100', 'sgu20121532', 'esoomoh64', 'sgu20151424', 'velurihasita', 'latifaalfardan', 'leo666', 'ibrahimkamal1997', 'assemabdelmoniem', 'julianna', 'zhangziyan', 'hgowaily', 'lindatalts', 'engtuan123', 'sgu20161494', 'loaydiaa', 'kabinaya08', 'mariamzanaty', 'sgu20171570', 'sgu20141483', 'zeyadahmedbadr97', 'gopijettiboyina841', 'nimashi001', 'nkvv88', 'mohamedabdelmeged', 'scientist.affawn', 'indronil.ghosh27', 'jackhoeniges', 'zackkk123', 'mimo007007', 'sgu20151513', 'mariomedhat9', 'michaelguevara', 'cbzkcbzk1', 'hagarkhaled', 'bperera', 'jorgealexandre', 'jojosazziz', 'salmasaher', 'tutulalala', 'shamyofficial2', 'zhichongcarl', 'jlong1028', 'cuoghimarco', 'sgu20141393', 'hanamant17', 'amgadsami1998', 'shaikyahul77', 'sgu20161503', 'zenaj', 'khaledshehab44', 'khaledhigazy94', 'saramahmoud19', 'rahmanr3', 'ayaabdelrahim', 'sgu20141471', 'sgu20151194', 'lennynator92', 'dko1217', 'ooooo18', 'sgu20141394', 'amirnabilhanna', 'ayoyayoyo2008', 'radwa123', 'toqa1999', 'mjkingdem', 'sgu20141408', 'ramyadel1313', 'mohanad.waheed9', 'sgu20121498', 'kingmokey', 'salman1999', 'hala97', 'amrsaeed012', 'icey123', 'sgu20171550', 'youssef_essam', 'johan.iswara', 'f.elgebaly', 'hongyan', 'sgu20141461', 'visionsofshiva', 'sgu20131492', 'weeei0514', 'hour', 'mohameddomy97', 'zhangnianchen', 'abdo1703', 'neuton']",4,"['tewfik79', 'malik89oman', None, 'osama005']",340,"['yasmine317', 'mitchelld2', 'john17.su', 'asmaahussein99', 'engmo3taz99', 'simon1205', 'hamedamr95', 'unal', 'luca.riccies', 'sgu20171586', 'lisifan', 'tingyu.qu', 'memonona017', 'heba_star1999', 'jkson3', 'nadaessam', 'addashti', 'yara.magdy222', 'bellayang', 'sg20121208', 'muhammed.number', 'pradeep_c17', 'sgu20131481', 'osama005', 'muhamriaz', 'almoatasem_bellah', 'sayeedrm', 'sgu20151422', 'sgu20141448', 'plloydwright', 'sgu20131507', 'dsreynolds93', 'sgu2014726019', 'lamyaalfa', 'aubai.hassan98', 'a.omar125242', 'ayakhaled4897', 'c15444808', 'tktm44', 'aradwa477', 'husalaa98', 'shy19951119', 'sgu20151438', 'wenfeng', 'roddaro', 'tewfik79', 'omniapinkflower', 'hayaat', 'horstmannbm', 'sgu20151486', 'wangmingzhu', 'mariam0', 'changlin2328', 'heshamebrahim123', 'wpsun319', 'sgu20131455', 'timmy_mer', 'eric.kosdi', 'vb9237865', 'sgu20151456', 'hamda', 'nalvarez92', 'gjfdjzo', 'ionsko', 'sgu20151464', 'monikaa', 'leeann901', 'weka_201219', 'abdulrahmangalal', 'sgu20131462', 'hbg2112', 'goddoggo', 'duweigg', 'sogang20141460', 'sgu20141478', 'sgu20171566', 'sgu20141414', 'sgu20161542', 'tianzk2', 'mohammed_naveed', 'nayeramansour', 'juhu93', 'youmna.moussa2016', 'sgu20161474', 'abdelazimmohamed98', 'sgu20131432', 'sgu20171490', 'sgu20151436', 'hanamantmn999', 'dydgus201', 'bassem8989', 'nourhanmagdymahmoud', 'jxc248006', 'aya.mohamed97', 'sgu20151478', 'akarkotis94', 'sgu20151418', 'bassem_mazen', 'sgu20171572', 'nelwagdy', 'ataulmamun', 'ayamohamed', 'harry0913', 'demonleon1995', 'caowd92', 'yangqu', 'ppjunb12', 'nayerakhaled', 'mennatallamostafa87', 'nahlatarek', 'ahmadabdelsalam', 'bguillet', 'xanxo18', 'naremanallam40', 'henryhe9806', 'zjhnus', 'mazen_ashraf', 'sikaislam66', 'asmaagamalelsayed96', 'nouran_mohamed', 'sgu20141474', 'abdelrhmanadelhassan', 'basmahassan697', 'yaozu', 'jhoeniges', 'akshayb', 'mdabrarshaikh90', 'sgu20141398', 'qky0921', 'sgu20161542e', 'yasmin.gad412', 'simon6599', 'sgu20151463', 'lincolnwang321', 'arvindh', 'sgu20141460', 'sgu20141415', 'a0928404798', 'sgu20131410', 'sgu20171558', 'nouran.tarek97', 'seohyeoniii', 'rinap', 'aymansaadhack', 'olashazly27', 'sgu20151410', 'georgesamy', 'gehadosama', 'monakamel97', 'bbaekssun', 'jishen', 'cxu004', 'tahaa.rore', 'marwan.m96', 'joanliu951001', 'sgu20171502', 'omarz977', 'sgu20171562', 'ruodaz', 'yayman55', 'radu.uta93', 'smrsaravanan', 'amjadtaleb', 'anas_massoud', 'sgu20141389', 'ankita.patil.0001', 'mayura0621', 'mohammedmajdyict', 'labmiugac2993', 'sgu20141480', None, 'sgu20171520', 'sgu20141458', 'sgu20141484', 'gyl0428', 'sgu20151490', 'sgu20131412', 'sgu20141476', 'nada.omran', 'jiamin2068', 'tokahossam71', 'ahmedmoustafa771', 'basmagharieb', 'yusuf313', 'ahmad.yasserr', 'wildprince', 'yuelian1234', 'youssefrefaat', 'sgu20091548', 'alaa98', 'mennaessam98', 'estradavictor96', 'sgu20171524', 'ge24', 'zeinabtaha', 'hananalamri', 'shinsunhak', 'mahmouddeghadi', 'ranaahmed96', 'thapu.putta', 'e0320957', 'sgu20151487', 'guitarist9816', 'sgu20151476', 'bluer', 'sgu20171556', 'mohamedkutb', 'ulas_965', 'mtmaccc', 'chen2712', 'omnia.khaled12', 'a960710', 'bentelghaly', 'jaydm26', 'lemon12345', 'gsabbir87', 'sgu20171508', 'as', 'uozgur', 'sgu20141424', 'e0186014', 'omar_eid73', 'sgu20141430', 'sgu20171503', 'sgu20141417', 'johnmccarthy', 'mustafaakhlak', 'chxxtu2009', 'sgu20151452', 'mohmedaliessa', 'sgu20141411', 'sgu20171526', 'nada5essam', 'salmaaatareeek', 'mohamedallam0000', 'qwu2', 'sgu20141395', 'han20151510', 'nkpuga', 'michaelashraf777', 'donghu', 'muhlasheen2', 'dvid0315', 'yhlee27', 'sgu20131508', 'sgu20141468', 'sgu20151485', 'ankitraj9', 'mostafa200100', 'sgu20121532', 'esoomoh64', 'sgu20151424', 'velurihasita', 'latifaalfardan', 'leo666', 'ibrahimkamal1997', 'assemabdelmoniem', 'julianna', 'zhangziyan', 'hgowaily', 'lindatalts', 'engtuan123', 'sgu20161494', 'loaydiaa', 'kabinaya08', 'mariamzanaty', 'sgu20171570', 'sgu20141483', 'zeyadahmedbadr97', 'gopijettiboyina841', 'nimashi001', 'nkvv88', 'mohamedabdelmeged', 'scientist.affawn', 'indronil.ghosh27', 'jackhoeniges', 'zackkk123', 'mimo007007', 'sgu20151513', 'mariomedhat9', 'michaelguevara', 'cbzkcbzk1', 'hagarkhaled', 'bperera', 'jorgealexandre', 'jojosazziz', 'salmasaher', 'tutulalala', 'shamyofficial2', 'zhichongcarl', 'jlong1028', 'cuoghimarco', 'sgu20141393', 'hanamant17', 'amgadsami1998', 'shaikyahul77', 'sgu20161503', 'malik89oman', 'zenaj', 'khaledshehab44', 'khaledhigazy94', 'saramahmoud19', 'rahmanr3', 'ayaabdelrahim', 'faharalalawi', 'sgu20141471', 'sgu20151194', 'lennynator92', 'dko1217', 'ooooo18', 'sgu20141394', 'amirnabilhanna', 'ayoyayoyo2008', 'radwa123', 'toqa1999', 'mjkingdem', 'sgu20141408', 'ramyadel1313', 'mohanad.waheed9', 'sgu20121498', 'kingmokey', 'salman1999', 'hala97', 'amrsaeed012', 'icey123', 'sgu20171550', 'youssef_essam', 'johan.iswara', 'ekhlas3535', 'f.elgebaly', 'hongyan', 'sgu20141461', 'visionsofshiva', 'sgu20131492', 'weeei0514', 'hour', 'mohameddomy97', 'zhangnianchen', 'abdo1703', 'neuton']"
1,30,336,7,5,"['latifaalfardan', 'hayaat', 'hananalamri', 'saramahmoud19', 'hamda']",331,"['yasmine317', 'mitchelld2', 'john17.su', 'asmaahussein99', 'engmo3taz99', 'simon1205', 'hamedamr95', 'unal', 'luca.riccies', 'sgu20171586', 'lisifan', 'tingyu.qu', 'memonona017', 'heba_star1999', 'jkson3', 'nadaessam', 'addashti', 'yara.magdy222', 'bellayang', 'sg20121208', 'muhammed.number', 'pradeep_c17', 'sgu20131481', 'muhamriaz', 'almoatasem_bellah', 'sayeedrm', 'sgu20151422', 'sgu20141448', 'plloydwright', 'sgu20131507', 'dsreynolds93', 'sgu2014726019', 'lamyaalfa', 'aubai.hassan98', 'a.omar125242', 'ayakhaled4897', 'c15444808', 'tktm44', 'aradwa477', 'husalaa98', 'shy19951119', 'sgu20151438', 'wenfeng', 'roddaro', 'omniapinkflower', 'horstmannbm', 'sgu20151486', 'wangmingzhu', 'mariam0', 'changlin2328', 'heshamebrahim123', 'wpsun319', 'sgu20131455', 'timmy_mer', 'eric.kosdi', 'vb9237865', 'sgu20151456', 'nalvarez92', 'gjfdjzo', 'ionsko', 'sgu20151464', 'monikaa', 'leeann901', 'weka_201219', 'abdulrahmangalal', 'sgu20131462', 'hbg2112', 'goddoggo', 'duweigg', 'sogang20141460', 'sgu20141478', 'sgu20171566', 'sgu20141414', 'sgu20161542', 'tianzk2', 'mohammed_naveed', 'nayeramansour', 'juhu93', 'youmna.moussa2016', 'sgu20161474', 'abdelazimmohamed98', 'sgu20131432', 'sgu20171490', 'sgu20151436', 'hanamantmn999', 'dydgus201', 'bassem8989', 'nourhanmagdymahmoud', 'jxc248006', 'aya.mohamed97', 'sgu20151478', 'akarkotis94', 'sgu20151418', 'bassem_mazen', 'sgu20171572', 'nelwagdy', 'ataulmamun', 'ayamohamed', 'harry0913', 'demonleon1995', 'caowd92', 'yangqu', 'ppjunb12', 'nayerakhaled', 'mennatallamostafa87', 'nahlatarek', 'ahmadabdelsalam', 'bguillet', 'xanxo18', 'naremanallam40', 'henryhe9806', 'zjhnus', 'mazen_ashraf', 'sikaislam66', 'asmaagamalelsayed96', 'nouran_mohamed', 'sgu20141474', 'abdelrhmanadelhassan', 'basmahassan697', 'yaozu', 'jhoeniges', 'akshayb', 'mdabrarshaikh90', 'sgu20141398', 'qky0921', 'sgu20161542e', 'yasmin.gad412', 'simon6599', 'sgu20151463', 'lincolnwang321', 'arvindh', 'sgu20141460', 'sgu20141415', 'a0928404798', 'sgu20131410', 'sgu20171558', 'nouran.tarek97', 'seohyeoniii', 'rinap', 'aymansaadhack', 'olashazly27', 'sgu20151410', 'georgesamy', 'gehadosama', 'monakamel97', 'bbaekssun', 'jishen', 'cxu004', 'tahaa.rore', 'marwan.m96', 'joanliu951001', 'sgu20171502', 'omarz977', 'sgu20171562', 'ruodaz', 'yayman55', 'radu.uta93', 'smrsaravanan', 'amjadtaleb', 'anas_massoud', 'sgu20141389', 'ankita.patil.0001', 'mayura0621', 'mohammedmajdyict', 'labmiugac2993', 'sgu20141480', 'sgu20171520', 'sgu20141458', 'sgu20141484', 'gyl0428', 'sgu20151490', 'sgu20131412', 'sgu20141476', 'nada.omran', 'jiamin2068', 'tokahossam71', 'ahmedmoustafa771', 'basmagharieb', 'yusuf313', 'ahmad.yasserr', 'wildprince', 'yuelian1234', 'youssefrefaat', 'sgu20091548', 'alaa98', 'mennaessam98', 'estradavictor96', 'sgu20171524', 'ge24', 'zeinabtaha', 'shinsunhak', 'mahmouddeghadi', 'ranaahmed96', 'thapu.putta', 'e0320957', 'sgu20151487', 'guitarist9816', 'sgu20151476', 'bluer', 'sgu20171556', 'mohamedkutb', 'ulas_965', 'mtmaccc', 'chen2712', 'omnia.khaled12', 'a960710', 'bentelghaly', 'jaydm26', 'lemon12345', 'gsabbir87', 'sgu20171508', 'as', 'uozgur', 'sgu20141424', 'e0186014', 'omar_eid73', 'sgu20141430', 'sgu20171503', 'sgu20141417', 'johnmccarthy', 'mustafaakhlak', 'chxxtu2009', 'sgu20151452', 'mohmedaliessa', 'sgu20141411', 'sgu20171526', 'nada5essam', 'salmaaatareeek', 'mohamedallam0000', 'qwu2', 'sgu20141395', 'han20151510', 'nkpuga', 'michaelashraf777', 'donghu', 'muhlasheen2', 'dvid0315', 'yhlee27', 'sgu20131508', 'sgu20141468', 'sgu20151485', 'ankitraj9', 'mostafa200100', 'sgu20121532', 'esoomoh64', 'sgu20151424', 'velurihasita', 'leo666', 'ibrahimkamal1997', 'assemabdelmoniem', 'julianna', 'zhangziyan', 'hgowaily', 'lindatalts', 'engtuan123', 'sgu20161494', 'loaydiaa', 'kabinaya08', 'mariamzanaty', 'sgu20171570', 'sgu20141483', 'zeyadahmedbadr97', 'gopijettiboyina841', 'nimashi001', 'nkvv88', 'mohamedabdelmeged', 'scientist.affawn', 'indronil.ghosh27', 'jackhoeniges', 'zackkk123', 'mimo007007', 'sgu20151513', 'mariomedhat9', 'michaelguevara', 'cbzkcbzk1', 'hagarkhaled', 'bperera', 'jorgealexandre', 'jojosazziz', 'salmasaher', 'tutulalala', 'shamyofficial2', 'zhichongcarl', 'jlong1028', 'cuoghimarco', 'sgu20141393', 'hanamant17', 'amgadsami1998', 'shaikyahul77', 'sgu20161503', 'zenaj', 'khaledshehab44', 'khaledhigazy94', 'rahmanr3', 'ayaabdelrahim', 'faharalalawi', 'sgu20141471', 'sgu20151194', 'lennynator92', 'dko1217', 'ooooo18', 'sgu20141394', 'amirnabilhanna', 'ayoyayoyo2008', 'radwa123', 'toqa1999', 'mjkingdem', 'sgu20141408', 'ramyadel1313', 'mohanad.waheed9', 'sgu20121498', 'kingmokey', 'salman1999', 'hala97', 'amrsaeed012', 'icey123', 'sgu20171550', 'youssef_essam', 'johan.iswara', 'ekhlas3535', 'f.elgebaly', 'hongyan', 'sgu20141461', 'visionsofshiva', 'sgu20131492', 'weeei0514', 'hour', 'mohameddomy97', 'zhangnianchen', 'abdo1703', 'neuton']",2,"['pangraci', None]",338,"['yasmine317', 'mitchelld2', 'john17.su', 'asmaahussein99', 'engmo3taz99', 'simon1205', 'hamedamr95', 'unal', 'luca.riccies', 'sgu20171586', 'lisifan', 'tingyu.qu', 'memonona017', 'heba_star1999', 'jkson3', 'nadaessam', 'addashti', 'yara.magdy222', 'bellayang', 'sg20121208', 'muhammed.number', 'pradeep_c17', 'sgu20131481', 'muhamriaz', 'almoatasem_bellah', 'sayeedrm', 'sgu20151422', 'sgu20141448', 'plloydwright', 'sgu20131507', 'dsreynolds93', 'sgu2014726019', 'lamyaalfa', 'aubai.hassan98', 'a.omar125242', 'ayakhaled4897', 'c15444808', 'tktm44', 'aradwa477', 'husalaa98', 'shy19951119', 'sgu20151438', 'wenfeng', 'roddaro', 'omniapinkflower', 'hayaat', 'horstmannbm', 'sgu20151486', 'wangmingzhu', 'mariam0', 'changlin2328', 'heshamebrahim123', 'wpsun319', 'sgu20131455', 'timmy_mer', 'eric.kosdi', 'vb9237865', 'sgu20151456', 'hamda', 'nalvarez92', 'gjfdjzo', 'ionsko', 'sgu20151464', 'monikaa', 'leeann901', 'pangraci', 'weka_201219', 'abdulrahmangalal', 'sgu20131462', 'hbg2112', 'goddoggo', 'duweigg', 'sogang20141460', 'sgu20141478', 'sgu20171566', 'sgu20141414', 'sgu20161542', 'tianzk2', 'mohammed_naveed', 'nayeramansour', 'juhu93', 'youmna.moussa2016', 'sgu20161474', 'abdelazimmohamed98', 'sgu20131432', 'sgu20171490', 'sgu20151436', 'hanamantmn999', 'dydgus201', 'bassem8989', 'nourhanmagdymahmoud', 'jxc248006', 'aya.mohamed97', 'sgu20151478', 'akarkotis94', 'sgu20151418', 'bassem_mazen', 'sgu20171572', 'nelwagdy', 'ataulmamun', 'ayamohamed', 'harry0913', 'demonleon1995', 'caowd92', 'yangqu', 'ppjunb12', 'nayerakhaled', 'mennatallamostafa87', 'nahlatarek', 'ahmadabdelsalam', 'bguillet', 'xanxo18', 'naremanallam40', 'henryhe9806', 'zjhnus', 'mazen_ashraf', 'sikaislam66', 'asmaagamalelsayed96', 'nouran_mohamed', 'sgu20141474', 'abdelrhmanadelhassan', 'basmahassan697', 'yaozu', 'jhoeniges', 'akshayb', 'mdabrarshaikh90', 'sgu20141398', 'qky0921', 'sgu20161542e', 'yasmin.gad412', 'simon6599', 'sgu20151463', 'lincolnwang321', 'arvindh', 'sgu20141460', 'sgu20141415', 'a0928404798', 'sgu20131410', 'sgu20171558', 'nouran.tarek97', 'seohyeoniii', 'rinap', 'aymansaadhack', 'olashazly27', 'sgu20151410', 'georgesamy', 'gehadosama', 'monakamel97', 'bbaekssun', 'jishen', 'cxu004', 'tahaa.rore', 'marwan.m96', 'joanliu951001', 'sgu20171502', 'omarz977', 'sgu20171562', 'ruodaz', 'yayman55', 'radu.uta93', 'smrsaravanan', 'amjadtaleb', 'anas_massoud', 'sgu20141389', 'ankita.patil.0001', 'mayura0621', 'mohammedmajdyict', 'labmiugac2993', 'sgu20141480', None, 'sgu20171520', 'sgu20141458', 'sgu20141484', 'gyl0428', 'sgu20151490', 'sgu20131412', 'sgu20141476', 'nada.omran', 'jiamin2068', 'tokahossam71', 'ahmedmoustafa771', 'basmagharieb', 'yusuf313', 'ahmad.yasserr', 'wildprince', 'yuelian1234', 'youssefrefaat', 'sgu20091548', 'alaa98', 'mennaessam98', 'estradavictor96', 'sgu20171524', 'ge24', 'zeinabtaha', 'hananalamri', 'shinsunhak', 'mahmouddeghadi', 'ranaahmed96', 'thapu.putta', 'e0320957', 'sgu20151487', 'guitarist9816', 'sgu20151476', 'bluer', 'sgu20171556', 'mohamedkutb', 'ulas_965', 'mtmaccc', 'chen2712', 'omnia.khaled12', 'a960710', 'bentelghaly', 'jaydm26', 'lemon12345', 'gsabbir87', 'sgu20171508', 'as', 'uozgur', 'sgu20141424', 'e0186014', 'omar_eid73', 'sgu20141430', 'sgu20171503', 'sgu20141417', 'johnmccarthy', 'mustafaakhlak', 'chxxtu2009', 'sgu20151452', 'mohmedaliessa', 'sgu20141411', 'sgu20171526', 'nada5essam', 'salmaaatareeek', 'mohamedallam0000', 'qwu2', 'sgu20141395', 'han20151510', 'nkpuga', 'michaelashraf777', 'donghu', 'muhlasheen2', 'dvid0315', 'yhlee27', 'sgu20131508', 'sgu20141468', 'sgu20151485', 'ankitraj9', 'mostafa200100', 'sgu20121532', 'esoomoh64', 'sgu20151424', 'velurihasita', 'latifaalfardan', 'leo666', 'ibrahimkamal1997', 'assemabdelmoniem', 'julianna', 'zhangziyan', 'hgowaily', 'lindatalts', 'engtuan123', 'sgu20161494', 'loaydiaa', 'kabinaya08', 'mariamzanaty', 'sgu20171570', 'sgu20141483', 'zeyadahmedbadr97', 'gopijettiboyina841', 'nimashi001', 'nkvv88', 'mohamedabdelmeged', 'scientist.affawn', 'indronil.ghosh27', 'jackhoeniges', 'zackkk123', 'mimo007007', 'sgu20151513', 'mariomedhat9', 'michaelguevara', 'cbzkcbzk1', 'hagarkhaled', 'bperera', 'jorgealexandre', 'jojosazziz', 'salmasaher', 'tutulalala', 'shamyofficial2', 'zhichongcarl', 'jlong1028', 'cuoghimarco', 'sgu20141393', 'hanamant17', 'amgadsami1998', 'shaikyahul77', 'sgu20161503', 'zenaj', 'khaledshehab44', 'khaledhigazy94', 'saramahmoud19', 'rahmanr3', 'ayaabdelrahim', 'faharalalawi', 'sgu20141471', 'sgu20151194', 'lennynator92', 'dko1217', 'ooooo18', 'sgu20141394', 'amirnabilhanna', 'ayoyayoyo2008', 'radwa123', 'toqa1999', 'mjkingdem', 'sgu20141408', 'ramyadel1313', 'mohanad.waheed9', 'sgu20121498', 'kingmokey', 'salman1999', 'hala97', 'amrsaeed012', 'icey123', 'sgu20171550', 'youssef_essam', 'johan.iswara', 'ekhlas3535', 'f.elgebaly', 'hongyan', 'sgu20141461', 'visionsofshiva', 'sgu20131492', 'weeei0514', 'hour', 'mohameddomy97', 'zhangnianchen', 'abdo1703', 'neuton']"
1,26,336,6,1,['jxc248006'],335,"['yasmine317', 'mitchelld2', 'john17.su', 'asmaahussein99', 'engmo3taz99', 'simon1205', 'hamedamr95', 'unal', 'luca.riccies', 'sgu20171586', 'lisifan', 'tingyu.qu', 'memonona017', 'heba_star1999', 'jkson3', 'nadaessam', 'addashti', 'yara.magdy222', 'bellayang', 'sg20121208', 'muhammed.number', 'pradeep_c17', 'sgu20131481', 'muhamriaz', 'almoatasem_bellah', 'sayeedrm', 'sgu20151422', 'sgu20141448', 'plloydwright', 'sgu20131507', 'dsreynolds93', 'sgu2014726019', 'lamyaalfa', 'aubai.hassan98', 'a.omar125242', 'ayakhaled4897', 'c15444808', 'tktm44', 'aradwa477', 'husalaa98', 'shy19951119', 'sgu20151438', 'wenfeng', 'roddaro', 'omniapinkflower', 'hayaat', 'horstmannbm', 'sgu20151486', 'wangmingzhu', 'mariam0', 'changlin2328', 'heshamebrahim123', 'wpsun319', 'sgu20131455', 'timmy_mer', 'eric.kosdi', 'vb9237865', 'sgu20151456', 'hamda', 'nalvarez92', 'gjfdjzo', 'ionsko', 'sgu20151464', 'monikaa', 'leeann901', 'weka_201219', 'abdulrahmangalal', 'sgu20131462', 'hbg2112', 'goddoggo', 'duweigg', 'sogang20141460', 'sgu20141478', 'sgu20171566', 'sgu20141414', 'sgu20161542', 'tianzk2', 'mohammed_naveed', 'nayeramansour', 'juhu93', 'youmna.moussa2016', 'sgu20161474', 'abdelazimmohamed98', 'sgu20131432', 'sgu20171490', 'sgu20151436', 'hanamantmn999', 'dydgus201', 'bassem8989', 'nourhanmagdymahmoud', 'aya.mohamed97', 'sgu20151478', 'akarkotis94', 'sgu20151418', 'bassem_mazen', 'sgu20171572', 'nelwagdy', 'ataulmamun', 'ayamohamed', 'harry0913', 'demonleon1995', 'caowd92', 'yangqu', 'ppjunb12', 'nayerakhaled', 'mennatallamostafa87', 'nahlatarek', 'ahmadabdelsalam', 'bguillet', 'xanxo18', 'naremanallam40', 'henryhe9806', 'zjhnus', 'mazen_ashraf', 'sikaislam66', 'asmaagamalelsayed96', 'nouran_mohamed', 'sgu20141474', 'abdelrhmanadelhassan', 'basmahassan697', 'yaozu', 'jhoeniges', 'akshayb', 'mdabrarshaikh90', 'sgu20141398', 'qky0921', 'sgu20161542e', 'yasmin.gad412', 'simon6599', 'sgu20151463', 'lincolnwang321', 'arvindh', 'sgu20141460', 'sgu20141415', 'a0928404798', 'sgu20131410', 'sgu20171558', 'nouran.tarek97', 'seohyeoniii', 'rinap', 'aymansaadhack', 'olashazly27', 'sgu20151410', 'georgesamy', 'gehadosama', 'monakamel97', 'bbaekssun', 'jishen', 'cxu004', 'tahaa.rore', 'marwan.m96', 'joanliu951001', 'sgu20171502', 'omarz977', 'sgu20171562', 'ruodaz', 'yayman55', 'radu.uta93', 'smrsaravanan', 'amjadtaleb', 'anas_massoud', 'sgu20141389', 'ankita.patil.0001', 'mayura0621', 'mohammedmajdyict', 'labmiugac2993', 'sgu20141480', 'sgu20171520', 'sgu20141458', 'sgu20141484', 'gyl0428', 'sgu20151490', 'sgu20131412', 'sgu20141476', 'nada.omran', 'jiamin2068', 'tokahossam71', 'ahmedmoustafa771', 'basmagharieb', 'yusuf313', 'ahmad.yasserr', 'wildprince', 'yuelian1234', 'youssefrefaat', 'sgu20091548', 'alaa98', 'mennaessam98', 'estradavictor96', 'sgu20171524', 'ge24', 'zeinabtaha', 'hananalamri', 'shinsunhak', 'mahmouddeghadi', 'ranaahmed96', 'thapu.putta', 'e0320957', 'sgu20151487', 'guitarist9816', 'sgu20151476', 'bluer', 'sgu20171556', 'mohamedkutb', 'ulas_965', 'mtmaccc', 'chen2712', 'omnia.khaled12', 'a960710', 'bentelghaly', 'jaydm26', 'lemon12345', 'gsabbir87', 'sgu20171508', 'as', 'uozgur', 'sgu20141424', 'e0186014', 'omar_eid73', 'sgu20141430', 'sgu20171503', 'sgu20141417', 'johnmccarthy', 'mustafaakhlak', 'chxxtu2009', 'sgu20151452', 'mohmedaliessa', 'sgu20141411', 'sgu20171526', 'nada5essam', 'salmaaatareeek', 'mohamedallam0000', 'qwu2', 'sgu20141395', 'han20151510', 'nkpuga', 'michaelashraf777', 'donghu', 'muhlasheen2', 'dvid0315', 'yhlee27', 'sgu20131508', 'sgu20141468', 'sgu20151485', 'ankitraj9', 'mostafa200100', 'sgu20121532', 'esoomoh64', 'sgu20151424', 'velurihasita', 'latifaalfardan', 'leo666', 'ibrahimkamal1997', 'assemabdelmoniem', 'julianna', 'zhangziyan', 'hgowaily', 'lindatalts', 'engtuan123', 'sgu20161494', 'loaydiaa', 'kabinaya08', 'mariamzanaty', 'sgu20171570', 'sgu20141483', 'zeyadahmedbadr97', 'gopijettiboyina841', 'nimashi001', 'nkvv88', 'mohamedabdelmeged', 'scientist.affawn', 'indronil.ghosh27', 'jackhoeniges', 'zackkk123', 'mimo007007', 'sgu20151513', 'mariomedhat9', 'michaelguevara', 'cbzkcbzk1', 'hagarkhaled', 'bperera', 'jorgealexandre', 'jojosazziz', 'salmasaher', 'tutulalala', 'shamyofficial2', 'zhichongcarl', 'jlong1028', 'cuoghimarco', 'sgu20141393', 'hanamant17', 'amgadsami1998', 'shaikyahul77', 'sgu20161503', 'zenaj', 'khaledshehab44', 'khaledhigazy94', 'saramahmoud19', 'rahmanr3', 'ayaabdelrahim', 'faharalalawi', 'sgu20141471', 'sgu20151194', 'lennynator92', 'dko1217', 'ooooo18', 'sgu20141394', 'amirnabilhanna', 'ayoyayoyo2008', 'radwa123', 'toqa1999', 'mjkingdem', 'sgu20141408', 'ramyadel1313', 'mohanad.waheed9', 'sgu20121498', 'kingmokey', 'salman1999', 'hala97', 'amrsaeed012', 'icey123', 'sgu20171550', 'youssef_essam', 'johan.iswara', 'ekhlas3535', 'f.elgebaly', 'hongyan', 'sgu20141461', 'visionsofshiva', 'sgu20131492', 'weeei0514', 'hour', 'mohameddomy97', 'zhangnianchen', 'abdo1703', 'neuton']",5,"['gi.ga212', 'davidegallo20', 'stefano.righi1994', 'alessiobevilacqua', None]",341,"['yasmine317', 'mitchelld2', 'john17.su', 'asmaahussein99', 'engmo3taz99', 'simon1205', 'hamedamr95', 'unal', 'luca.riccies', 'sgu20171586', 'lisifan', 'tingyu.qu', 'memonona017', 'heba_star1999', 'jkson3', 'nadaessam', 'addashti', 'yara.magdy222', 'bellayang', 'sg20121208', 'muhammed.number', 'pradeep_c17', 'sgu20131481', 'muhamriaz', 'almoatasem_bellah', 'sayeedrm', 'sgu20151422', 'sgu20141448', 'plloydwright', 'sgu20131507', 'dsreynolds93', 'sgu2014726019', 'lamyaalfa', 'aubai.hassan98', 'a.omar125242', 'ayakhaled4897', 'c15444808', 'tktm44', 'aradwa477', 'husalaa98', 'shy19951119', 'sgu20151438', 'wenfeng', 'roddaro', 'omniapinkflower', 'hayaat', 'horstmannbm', 'sgu20151486', 'wangmingzhu', 'mariam0', 'changlin2328', 'heshamebrahim123', 'wpsun319', 'sgu20131455', 'timmy_mer', 'eric.kosdi', 'vb9237865', 'sgu20151456', 'hamda', 'nalvarez92', 'gjfdjzo', 'ionsko', 'sgu20151464', 'monikaa', 'leeann901', 'weka_201219', 'abdulrahmangalal', 'sgu20131462', 'hbg2112', 'goddoggo', 'duweigg', 'sogang20141460', 'sgu20141478', 'sgu20171566', 'sgu20141414', 'sgu20161542', 'tianzk2', 'mohammed_naveed', 'nayeramansour', 'juhu93', 'youmna.moussa2016', 'sgu20161474', 'abdelazimmohamed98', 'sgu20131432', 'sgu20171490', 'sgu20151436', 'hanamantmn999', 'dydgus201', 'bassem8989', 'nourhanmagdymahmoud', 'jxc248006', 'aya.mohamed97', 'sgu20151478', 'akarkotis94', 'sgu20151418', 'bassem_mazen', 'sgu20171572', 'nelwagdy', 'ataulmamun', 'ayamohamed', 'harry0913', 'demonleon1995', 'caowd92', 'yangqu', 'ppjunb12', 'nayerakhaled', 'mennatallamostafa87', 'nahlatarek', 'ahmadabdelsalam', 'bguillet', 'xanxo18', 'naremanallam40', 'henryhe9806', 'zjhnus', 'mazen_ashraf', 'sikaislam66', 'asmaagamalelsayed96', 'nouran_mohamed', 'sgu20141474', 'abdelrhmanadelhassan', 'basmahassan697', 'yaozu', 'jhoeniges', 'akshayb', 'mdabrarshaikh90', 'sgu20141398', 'qky0921', 'sgu20161542e', 'yasmin.gad412', 'simon6599', 'sgu20151463', 'lincolnwang321', 'arvindh', 'sgu20141460', 'sgu20141415', 'a0928404798', 'sgu20131410', 'sgu20171558', 'nouran.tarek97', 'seohyeoniii', 'davidegallo20', 'rinap', 'aymansaadhack', 'olashazly27', 'sgu20151410', 'georgesamy', 'gehadosama', 'monakamel97', 'bbaekssun', 'jishen', 'cxu004', 'tahaa.rore', 'marwan.m96', 'joanliu951001', 'sgu20171502', 'omarz977', 'sgu20171562', 'ruodaz', 'yayman55', 'radu.uta93', 'smrsaravanan', 'amjadtaleb', 'anas_massoud', 'sgu20141389', 'ankita.patil.0001', 'mayura0621', 'mohammedmajdyict', 'labmiugac2993', 'sgu20141480', None, 'sgu20171520', 'sgu20141458', 'sgu20141484', 'gyl0428', 'sgu20151490', 'sgu20131412', 'sgu20141476', 'nada.omran', 'jiamin2068', 'tokahossam71', 'ahmedmoustafa771', 'basmagharieb', 'yusuf313', 'ahmad.yasserr', 'wildprince', 'yuelian1234', 'youssefrefaat', 'sgu20091548', 'alaa98', 'mennaessam98', 'estradavictor96', 'sgu20171524', 'ge24', 'zeinabtaha', 'hananalamri', 'shinsunhak', 'mahmouddeghadi', 'ranaahmed96', 'thapu.putta', 'e0320957', 'sgu20151487', 'guitarist9816', 'sgu20151476', 'bluer', 'sgu20171556', 'mohamedkutb', 'ulas_965', 'mtmaccc', 'chen2712', 'omnia.khaled12', 'a960710', 'bentelghaly', 'jaydm26', 'lemon12345', 'gsabbir87', 'sgu20171508', 'as', 'uozgur', 'sgu20141424', 'e0186014', 'omar_eid73', 'sgu20141430', 'sgu20171503', 'gi.ga212', 'sgu20141417', 'johnmccarthy', 'mustafaakhlak', 'chxxtu2009', 'sgu20151452', 'mohmedaliessa', 'sgu20141411', 'sgu20171526', 'nada5essam', 'salmaaatareeek', 'mohamedallam0000', 'qwu2', 'sgu20141395', 'han20151510', 'nkpuga', 'michaelashraf777', 'donghu', 'muhlasheen2', 'dvid0315', 'yhlee27', 'sgu20131508', 'sgu20141468', 'sgu20151485', 'ankitraj9', 'mostafa200100', 'sgu20121532', 'esoomoh64', 'sgu20151424', 'stefano.righi1994', 'velurihasita', 'latifaalfardan', 'leo666', 'ibrahimkamal1997', 'assemabdelmoniem', 'julianna', 'zhangziyan', 'hgowaily', 'lindatalts', 'engtuan123', 'sgu20161494', 'loaydiaa', 'kabinaya08', 'mariamzanaty', 'sgu20171570', 'sgu20141483', 'zeyadahmedbadr97', 'gopijettiboyina841', 'nimashi001', 'nkvv88', 'mohamedabdelmeged', 'scientist.affawn', 'indronil.ghosh27', 'jackhoeniges', 'zackkk123', 'mimo007007', 'sgu20151513', 'mariomedhat9', 'michaelguevara', 'cbzkcbzk1', 'hagarkhaled', 'bperera', 'jorgealexandre', 'jojosazziz', 'salmasaher', 'tutulalala', 'shamyofficial2', 'zhichongcarl', 'jlong1028', 'cuoghimarco', 'sgu20141393', 'hanamant17', 'amgadsami1998', 'shaikyahul77', 'sgu20161503', 'zenaj', 'khaledshehab44', 'khaledhigazy94', 'saramahmoud19', 'rahmanr3', 'ayaabdelrahim', 'faharalalawi', 'sgu20141471', 'sgu20151194', 'lennynator92', 'dko1217', 'ooooo18', 'sgu20141394', 'amirnabilhanna', 'ayoyayoyo2008', 'radwa123', 'toqa1999', 'mjkingdem', 'sgu20141408', 'ramyadel1313', 'mohanad.waheed9', 'sgu20121498', 'kingmokey', 'salman1999', 'hala97', 'amrsaeed012', 'icey123', 'sgu20171550', 'youssef_essam', 'johan.iswara', 'ekhlas3535', 'f.elgebaly', 'hongyan', 'sgu20141461', 'visionsofshiva', 'sgu20131492', 'weeei0514', 'hour', 'mohameddomy97', 'zhangnianchen', 'abdo1703', 'alessiobevilacqua', 'neuton']"
1,326,336,6,4,"['nkpuga', 'rahmanr3', 'ataulmamun', 'horstmannbm']",332,"['yasmine317', 'mitchelld2', 'john17.su', 'asmaahussein99', 'engmo3taz99', 'simon1205', 'hamedamr95', 'unal', 'luca.riccies', 'sgu20171586', 'lisifan', 'tingyu.qu', 'memonona017', 'heba_star1999', 'jkson3', 'nadaessam', 'addashti', 'yara.magdy222', 'bellayang', 'sg20121208', 'muhammed.number', 'pradeep_c17', 'sgu20131481', 'muhamriaz', 'almoatasem_bellah', 'sayeedrm', 'sgu20151422', 'sgu20141448', 'plloydwright', 'sgu20131507', 'dsreynolds93', 'sgu2014726019', 'lamyaalfa', 'aubai.hassan98', 'a.omar125242', 'ayakhaled4897', 'c15444808', 'tktm44', 'aradwa477', 'husalaa98', 'shy19951119', 'sgu20151438', 'wenfeng', 'roddaro', 'omniapinkflower', 'hayaat', 'sgu20151486', 'wangmingzhu', 'mariam0', 'changlin2328', 'heshamebrahim123', 'wpsun319', 'sgu20131455', 'timmy_mer', 'eric.kosdi', 'vb9237865', 'sgu20151456', 'hamda', 'nalvarez92', 'gjfdjzo', 'ionsko', 'sgu20151464', 'monikaa', 'leeann901', 'weka_201219', 'abdulrahmangalal', 'sgu20131462', 'hbg2112', 'goddoggo', 'duweigg', 'sogang20141460', 'sgu20141478', 'sgu20171566', 'sgu20141414', 'sgu20161542', 'tianzk2', 'mohammed_naveed', 'nayeramansour', 'juhu93', 'youmna.moussa2016', 'sgu20161474', 'abdelazimmohamed98', 'sgu20131432', 'sgu20171490', 'sgu20151436', 'hanamantmn999', 'dydgus201', 'bassem8989', 'nourhanmagdymahmoud', 'jxc248006', 'aya.mohamed97', 'sgu20151478', 'akarkotis94', 'sgu20151418', 'bassem_mazen', 'sgu20171572', 'nelwagdy', 'ayamohamed', 'harry0913', 'demonleon1995', 'caowd92', 'yangqu', 'ppjunb12', 'nayerakhaled', 'mennatallamostafa87', 'nahlatarek', 'ahmadabdelsalam', 'bguillet', 'xanxo18', 'naremanallam40', 'henryhe9806', 'zjhnus', 'mazen_ashraf', 'sikaislam66', 'asmaagamalelsayed96', 'nouran_mohamed', 'sgu20141474', 'abdelrhmanadelhassan', 'basmahassan697', 'yaozu', 'jhoeniges', 'akshayb', 'mdabrarshaikh90', 'sgu20141398', 'qky0921', 'sgu20161542e', 'yasmin.gad412', 'simon6599', 'sgu20151463', 'lincolnwang321', 'arvindh', 'sgu20141460', 'sgu20141415', 'a0928404798', 'sgu20131410', 'sgu20171558', 'nouran.tarek97', 'seohyeoniii', 'rinap', 'aymansaadhack', 'olashazly27', 'sgu20151410', 'georgesamy', 'gehadosama', 'monakamel97', 'bbaekssun', 'jishen', 'cxu004', 'tahaa.rore', 'marwan.m96', 'joanliu951001', 'sgu20171502', 'omarz977', 'sgu20171562', 'ruodaz', 'yayman55', 'radu.uta93', 'smrsaravanan', 'amjadtaleb', 'anas_massoud', 'sgu20141389', 'ankita.patil.0001', 'mayura0621', 'mohammedmajdyict', 'labmiugac2993', 'sgu20141480', 'sgu20171520', 'sgu20141458', 'sgu20141484', 'gyl0428', 'sgu20151490', 'sgu20131412', 'sgu20141476', 'nada.omran', 'jiamin2068', 'tokahossam71', 'ahmedmoustafa771', 'basmagharieb', 'yusuf313', 'ahmad.yasserr', 'wildprince', 'yuelian1234', 'youssefrefaat', 'sgu20091548', 'alaa98', 'mennaessam98', 'estradavictor96', 'sgu20171524', 'ge24', 'zeinabtaha', 'hananalamri', 'shinsunhak', 'mahmouddeghadi', 'ranaahmed96', 'thapu.putta', 'e0320957', 'sgu20151487', 'guitarist9816', 'sgu20151476', 'bluer', 'sgu20171556', 'mohamedkutb', 'ulas_965', 'mtmaccc', 'chen2712', 'omnia.khaled12', 'a960710', 'bentelghaly', 'jaydm26', 'lemon12345', 'gsabbir87', 'sgu20171508', 'as', 'uozgur', 'sgu20141424', 'e0186014', 'omar_eid73', 'sgu20141430', 'sgu20171503', 'sgu20141417', 'johnmccarthy', 'mustafaakhlak', 'chxxtu2009', 'sgu20151452', 'mohmedaliessa', 'sgu20141411', 'sgu20171526', 'nada5essam', 'salmaaatareeek', 'mohamedallam0000', 'qwu2', 'sgu20141395', 'han20151510', 'michaelashraf777', 'donghu', 'muhlasheen2', 'dvid0315', 'yhlee27', 'sgu20131508', 'sgu20141468', 'sgu20151485', 'ankitraj9', 'mostafa200100', 'sgu20121532', 'esoomoh64', 'sgu20151424', 'velurihasita', 'latifaalfardan', 'leo666', 'ibrahimkamal1997', 'assemabdelmoniem', 'julianna', 'zhangziyan', 'hgowaily', 'lindatalts', 'engtuan123', 'sgu20161494', 'loaydiaa', 'kabinaya08', 'mariamzanaty', 'sgu20171570', 'sgu20141483', 'zeyadahmedbadr97', 'gopijettiboyina841', 'nimashi001', 'nkvv88', 'mohamedabdelmeged', 'scientist.affawn', 'indronil.ghosh27', 'jackhoeniges', 'zackkk123', 'mimo007007', 'sgu20151513', 'mariomedhat9', 'michaelguevara', 'cbzkcbzk1', 'hagarkhaled', 'bperera', 'jorgealexandre', 'jojosazziz', 'salmasaher', 'tutulalala', 'shamyofficial2', 'zhichongcarl', 'jlong1028', 'cuoghimarco', 'sgu20141393', 'hanamant17', 'amgadsami1998', 'shaikyahul77', 'sgu20161503', 'zenaj', 'khaledshehab44', 'khaledhigazy94', 'saramahmoud19', 'ayaabdelrahim', 'faharalalawi', 'sgu20141471', 'sgu20151194', 'lennynator92', 'dko1217', 'ooooo18', 'sgu20141394', 'amirnabilhanna', 'ayoyayoyo2008', 'radwa123', 'toqa1999', 'mjkingdem', 'sgu20141408', 'ramyadel1313', 'mohanad.waheed9', 'sgu20121498', 'kingmokey', 'salman1999', 'hala97', 'amrsaeed012', 'icey123', 'sgu20171550', 'youssef_essam', 'johan.iswara', 'ekhlas3535', 'f.elgebaly', 'hongyan', 'sgu20141461', 'visionsofshiva', 'sgu20131492', 'weeei0514', 'hour', 'mohameddomy97', 'zhangnianchen', 'abdo1703', 'neuton']",2,"[None, 'dhruv.fomra']",338,"['yasmine317', 'mitchelld2', 'john17.su', 'asmaahussein99', 'engmo3taz99', 'simon1205', 'hamedamr95', 'unal', 'luca.riccies', 'sgu20171586', 'lisifan', 'tingyu.qu', 'memonona017', 'heba_star1999', 'jkson3', 'nadaessam', 'addashti', 'yara.magdy222', 'bellayang', 'sg20121208', 'muhammed.number', 'pradeep_c17', 'sgu20131481', 'muhamriaz', 'almoatasem_bellah', 'sayeedrm', 'sgu20151422', 'sgu20141448', 'plloydwright', 'sgu20131507', 'dsreynolds93', 'sgu2014726019', 'lamyaalfa', 'aubai.hassan98', 'a.omar125242', 'ayakhaled4897', 'c15444808', 'tktm44', 'aradwa477', 'husalaa98', 'shy19951119', 'sgu20151438', 'wenfeng', 'roddaro', 'omniapinkflower', 'hayaat', 'horstmannbm', 'sgu20151486', 'wangmingzhu', 'mariam0', 'changlin2328', 'heshamebrahim123', 'wpsun319', 'sgu20131455', 'timmy_mer', 'eric.kosdi', 'vb9237865', 'sgu20151456', 'hamda', 'nalvarez92', 'gjfdjzo', 'ionsko', 'sgu20151464', 'monikaa', 'leeann901', 'weka_201219', 'abdulrahmangalal', 'sgu20131462', 'hbg2112', 'goddoggo', 'duweigg', 'sogang20141460', 'sgu20141478', 'sgu20171566', 'sgu20141414', 'sgu20161542', 'tianzk2', 'mohammed_naveed', 'nayeramansour', 'juhu93', 'youmna.moussa2016', 'sgu20161474', 'abdelazimmohamed98', 'sgu20131432', 'sgu20171490', 'sgu20151436', 'hanamantmn999', 'dydgus201', 'bassem8989', 'nourhanmagdymahmoud', 'jxc248006', 'aya.mohamed97', 'sgu20151478', 'akarkotis94', 'sgu20151418', 'bassem_mazen', 'sgu20171572', 'nelwagdy', 'ataulmamun', 'ayamohamed', 'harry0913', 'demonleon1995', 'caowd92', 'yangqu', 'ppjunb12', 'nayerakhaled', 'mennatallamostafa87', 'nahlatarek', 'ahmadabdelsalam', 'bguillet', 'xanxo18', 'naremanallam40', 'henryhe9806', 'zjhnus', 'mazen_ashraf', 'sikaislam66', 'asmaagamalelsayed96', 'nouran_mohamed', 'sgu20141474', 'abdelrhmanadelhassan', 'basmahassan697', 'yaozu', 'jhoeniges', 'akshayb', 'mdabrarshaikh90', 'sgu20141398', 'qky0921', 'sgu20161542e', 'yasmin.gad412', 'simon6599', 'sgu20151463', 'lincolnwang321', 'arvindh', 'sgu20141460', 'sgu20141415', 'a0928404798', 'sgu20131410', 'sgu20171558', 'nouran.tarek97', 'seohyeoniii', 'rinap', 'aymansaadhack', 'olashazly27', 'sgu20151410', 'georgesamy', 'gehadosama', 'monakamel97', 'bbaekssun', 'jishen', 'cxu004', 'tahaa.rore', 'marwan.m96', 'joanliu951001', 'sgu20171502', 'omarz977', 'sgu20171562', 'ruodaz', 'yayman55', 'radu.uta93', 'smrsaravanan', 'amjadtaleb', 'anas_massoud', 'sgu20141389', 'ankita.patil.0001', 'mayura0621', 'mohammedmajdyict', 'labmiugac2993', 'sgu20141480', None, 'sgu20171520', 'sgu20141458', 'sgu20141484', 'gyl0428', 'sgu20151490', 'sgu20131412', 'sgu20141476', 'nada.omran', 'jiamin2068', 'tokahossam71', 'ahmedmoustafa771', 'basmagharieb', 'yusuf313', 'ahmad.yasserr', 'wildprince', 'yuelian1234', 'youssefrefaat', 'sgu20091548', 'alaa98', 'mennaessam98', 'estradavictor96', 'sgu20171524', 'ge24', 'zeinabtaha', 'hananalamri', 'shinsunhak', 'mahmouddeghadi', 'ranaahmed96', 'thapu.putta', 'e0320957', 'sgu20151487', 'guitarist9816', 'sgu20151476', 'bluer', 'sgu20171556', 'mohamedkutb', 'ulas_965', 'mtmaccc', 'chen2712', 'omnia.khaled12', 'a960710', 'bentelghaly', 'jaydm26', 'lemon12345', 'gsabbir87', 'sgu20171508', 'as', 'uozgur', 'sgu20141424', 'e0186014', 'omar_eid73', 'sgu20141430', 'sgu20171503', 'sgu20141417', 'johnmccarthy', 'mustafaakhlak', 'chxxtu2009', 'sgu20151452', 'mohmedaliessa', 'sgu20141411', 'sgu20171526', 'nada5essam', 'salmaaatareeek', 'mohamedallam0000', 'qwu2', 'sgu20141395', 'han20151510', 'nkpuga', 'michaelashraf777', 'donghu', 'muhlasheen2', 'dvid0315', 'yhlee27', 'sgu20131508', 'sgu20141468', 'sgu20151485', 'ankitraj9', 'mostafa200100', 'sgu20121532', 'esoomoh64', 'sgu20151424', 'velurihasita', 'latifaalfardan', 'leo666', 'ibrahimkamal1997', 'assemabdelmoniem', 'julianna', 'zhangziyan', 'hgowaily', 'lindatalts', 'engtuan123', 'sgu20161494', 'loaydiaa', 'kabinaya08', 'mariamzanaty', 'sgu20171570', 'sgu20141483', 'zeyadahmedbadr97', 'gopijettiboyina841', 'nimashi001', 'nkvv88', 'mohamedabdelmeged', 'scientist.affawn', 'indronil.ghosh27', 'jackhoeniges', 'zackkk123', 'mimo007007', 'sgu20151513', 'mariomedhat9', 'michaelguevara', 'cbzkcbzk1', 'hagarkhaled', 'bperera', 'jorgealexandre', 'jojosazziz', 'salmasaher', 'tutulalala', 'shamyofficial2', 'zhichongcarl', 'jlong1028', 'cuoghimarco', 'sgu20141393', 'hanamant17', 'amgadsami1998', 'shaikyahul77', 'sgu20161503', 'dhruv.fomra', 'zenaj', 'khaledshehab44', 'khaledhigazy94', 'saramahmoud19', 'rahmanr3', 'ayaabdelrahim', 'faharalalawi', 'sgu20141471', 'sgu20151194', 'lennynator92', 'dko1217', 'ooooo18', 'sgu20141394', 'amirnabilhanna', 'ayoyayoyo2008', 'radwa123', 'toqa1999', 'mjkingdem', 'sgu20141408', 'ramyadel1313', 'mohanad.waheed9', 'sgu20121498', 'kingmokey', 'salman1999', 'hala97', 'amrsaeed012', 'icey123', 'sgu20171550', 'youssef_essam', 'johan.iswara', 'ekhlas3535', 'f.elgebaly', 'hongyan', 'sgu20141461', 'visionsofshiva', 'sgu20131492', 'weeei0514', 'hour', 'mohameddomy97', 'zhangnianchen', 'abdo1703', 'neuton']"
2,115,237,66,60,"['sharm338', 'ng000046', 'mendo123', 'thiosady', 'damic014', 'yang6086', 'levac004', 'werki004', 'salmo091', 'utzma006', 'kambo001', 'zamri003', 'and04848', 'almai005', 'sirraf1', 'wegex009', 'prusi009', 'hagst077', 'schm4149', 'olso5589', 'kapla302', 'vuong056', 'jarga001', 'gagno094', 'gerva039', 'hentg030', 'olso7126', 'leex8370', 'bajda004', 'tran0559', 'raabx028', 'nebix006', 'royxx318', 'kianx006', 'zhou0868', 'richard_thompson', 'klonc003', 'fuxxx391', 'mukon004', 'dang0134', 'keech015', 'wille474', 'tuft0029', 'parke867', 'leama008', 'conwe007', 'mendo172', 'klung009', 'spred003', 'udstr005', 'nicho919', 'gesex006', 'yang5123', 'dixon347', 'sahyo002', 'alhin010', 'providedrailroad', 'lyde0037', 'kruss008', 'joh02339']",176,"['rtoopal', 'francesco0131', 'xinyue.fang', 'eeich09281997', 'vton', 'carinaocarina', 'sgowtham09', 'mhoang', 'bhostetl', 'kristinachan', 'satyamku', 'matt.mcalpin26', 'mozomiguel73', 'ana_gomez', 'alice_vergani', 'kisleee3', 'jurbani1', 'sthomps5', 'chan_cheryl', 'alicemo', 'mbaghdad', 'johnbestman22', 'blum001', 'a.hu.16', 'david960617', 'juan98', 'christine.shim', 'nataliaramos3', 'msteve20', 'sobota_hailey', 'felipe_hdz', 'pinasimone10', 'mdfariduddin15', 'jaardila', 'opeojoy2k', 'chem558', 'jwen20', 'pcampbe3', 'efang001', 'jhg617', 'jfitzhen', 'dmccann20', 'mashiyatshawkat', 'huntorrocks', 'rgaurav0393', 'shwetakotkar229', 'daniel2809', 'lingyexie', 'donaldp97', 'wshin765', 'mk7800797', 'mingxi', 'jahough', 'zihaoz', 'oskar_radermecker', 'jpj', 'timtoh168', 'armentasantiago', 'mgerba', 'apaulo', 'zib.summer', 'amcalear', 'subuls', 'anewton4', '11jazzyc', 'thegaga', 'jagadishkarthikeya', 'myflash995', 'mariano06', '20lnelson', 'gsakoda', 'drddragan', 'adonadio', 'katherinecrawford', 'liya_abraha', 'blui001', 'juliortegon', 'tosaleal', 'md.quintero', 'pvd', 'jrpuerto', 'scharles', 'chanshaomun', 'mariaddld', 'allisondong1995', 'dinhtmh', 'ryellitz', 'jamer98', 'lbarber', 'camilo0869', 'jeisson1299', 'polinp0p0', 'whloganw', 'popkir', 'lautmusicmois', 'ad.gregory', 'qwertyacc1', 'liu.nathaniel', 'justsadler', 'poojarao75', 'erichu57023', 'saurabh96jun', 'wpiszker42', 'anderpensilva', 'ahender4', 'cmkennedy', 'kevinbernalru', 'mallika', 'solerjavier7', 'maximum136', 'shreyasnaik', 'mugnier', 'lkabraha1', 'gvaishnavi761', 'christina.ngo', 'maria.a.solano.otero', 'santiago.aine', 'bader11', 'anwar.iiserk', 'nicholast900', 'rachellyumi', 'joedude15', 'sfhivo', 'lildoug1997', 'p.j.grenz', 'hahasan09', 'andyz4', 'matthew.byrnes4852', 'shahnewaz01', 'naltemose89', 'bthorgood3', 'emunguia', 'tvv', 'ykes2bige', 'georgeking159', 'yyan818', 'sitarsky', 'lomeligabriela88', 'tofer13', 'francis.marquez21', 'prigs2323', 's.villamilp', 'pab272', 'pvargas', 'iarasantelices', 'davide_asnaghi', 'aphauser', 'libardo11chapal', 'cmckenz2', 'juanpbotero9897', 'sebas.villaba2002', 'mlfronk', 'seabassparker', 'matildem', 'xinyiz', 'deboka', 'go_arvind', 'rmghannam', 'prithiv_natarajan', 'dperry', 'wdurnan', 'tguy', 'v.cardonac1', 'arthur.alo', 'mtrudd97', 's.y.wang.sdu', 'nicolash025', 'matthiashartl', 'nsimonian', 'chrisowen873', 'wang150', 'alva_liang', 'tegan.anderes', 'ssantia1', 'ashton.bateman', 'inorman']",6,"['buchnich', 'chandol314', 'eric3331', 'hanza023', 'sswisher', None]",242,"['rtoopal', 'francesco0131', 'xinyue.fang', 'eeich09281997', 'werki004', 'vton', 'carinaocarina', 'sgowtham09', 'mhoang', 'bhostetl', 'almai005', 'kristinachan', 'and04848', 'satyamku', 'ana_gomez', 'matt.mcalpin26', 'mozomiguel73', 'alice_vergani', 'kisleee3', 'schm4149', 'jurbani1', 'sthomps5', 'olso5589', 'chan_cheryl', 'alicemo', 'mbaghdad', 'vuong056', 'johnbestman22', 'blum001', 'a.hu.16', 'david960617', 'juan98', 'hentg030', 'christine.shim', 'nataliaramos3', 'msteve20', 'sobota_hailey', 'bajda004', 'felipe_hdz', 'pinasimone10', 'raabx028', 'mdfariduddin15', 'richard_thompson', 'opeojoy2k', 'fuxxx391', 'chem558', 'jwen20', 'pcampbe3', 'efang001', 'jhg617', 'jfitzhen', 'dmccann20', 'mashiyatshawkat', 'huntorrocks', 'rgaurav0393', 'sahyo002', 'shwetakotkar229', 'alhin010', 'daniel2809', 'lingyexie', 'donaldp97', 'thiosady', 'wshin765', 'mk7800797', 'mingxi', 'jahough', 'zihaoz', 'yang6086', 'oskar_radermecker', 'utzma006', 'jpj', 'timtoh168', 'sirraf1', 'armentasantiago', 'mgerba', 'jarga001', 'gagno094', 'apaulo', 'zib.summer', 'amcalear', 'leex8370', 'subuls', 'anewton4', 'royxx318', '11jazzyc', 'kianx006', 'thegaga', 'jagadishkarthikeya', 'myflash995', 'klonc003', 'zhou0868', 'mariano06', '20lnelson', 'gsakoda', 'drddragan', 'ashton.bateman', 'adonadio', 'wille474', 'keech015', 'tuft0029', 'katherinecrawford', 'mendo172', 'liya_abraha', 'blui001', 'juliortegon', 'tosaleal', 'md.quintero', 'udstr005', 'nicho919', 'klung009', 'yang5123', 'pvd', 'jrpuerto', 'providedrailroad', 'scharles', 'chanshaomun', 'mariaddld', 'allisondong1995', 'sharm338', 'dinhtmh', 'ng000046', 'mendo123', 'ryellitz', 'jamer98', 'damic014', 'lbarber', 'levac004', 'camilo0869', 'jeisson1299', 'polinp0p0', 'whloganw', 'popkir', 'prusi009', 'wegex009', 'lautmusicmois', 'ad.gregory', 'qwertyacc1', 'liu.nathaniel', 'justsadler', 'poojarao75', 'erichu57023', 'saurabh96jun', 'wpiszker42', 'anderpensilva', 'ahender4', 'olso7126', 'cmkennedy', 'buchnich', 'nebix006', 'kevinbernalru', 'mallika', 'solerjavier7', 'maximum136', 'mukon004', 'shreyasnaik', 'mugnier', 'lkabraha1', 'gvaishnavi761', 'christina.ngo', 'maria.a.solano.otero', 'santiago.aine', 'bader11', 'anwar.iiserk', 'nicholast900', 'rachellyumi', 'gesex006', 'joedude15', 'sfhivo', 'lyde0037', 'lildoug1997', 'joh02339', 'p.j.grenz', 'hahasan09', None, 'andyz4', 'matthew.byrnes4852', 'shahnewaz01', 'naltemose89', 'eric3331', 'salmo091', 'bthorgood3', 'emunguia', 'tvv', 'ykes2bige', 'georgeking159', 'zamri003', 'yyan818', 'kambo001', 'sitarsky', 'lomeligabriela88', 'tofer13', 'francis.marquez21', 'prigs2323', 'hagst077', 'sswisher', 's.villamilp', 'pab272', 'kapla302', 'pvargas', 'iarasantelices', 'davide_asnaghi', 'aphauser', 'hanza023', 'libardo11chapal', 'cmckenz2', 'gerva039', 'juanpbotero9897', 'sebas.villaba2002', 'mlfronk', 'tran0559', 'chandol314', 'seabassparker', 'matildem', 'xinyiz', 'deboka', 'go_arvind', 'rmghannam', 'dang0134', 'prithiv_natarajan', 'dperry', 'wdurnan', 'parke867', 'v.cardonac1', 'arthur.alo', 'mtrudd97', 's.y.wang.sdu', 'conwe007', 'tguy', 'matthiashartl', 'nsimonian', 'nicolash025', 'leama008', 'chrisowen873', 'spred003', 'wang150', 'alva_liang', 'dixon347', 'tegan.anderes', 'kruss008', 'ssantia1', 'jaardila', 'inorman']"
2,117,237,65,64,"['rtoopal', 'dinhtmh', 'andyz4', 'xinyue.fang', 'francesco0131', 'naltemose89', 'mariaddld', 'mingxi', 'wshin765', 'oskar_radermecker', 'vton', 'carinaocarina', 'sgowtham09', 'yyan818', 'mhoang', 'timtoh168', 'kristinachan', 'lomeligabriela88', 'tofer13', 'popkir', 'ana_gomez', 'alice_vergani', 'chan_cheryl', 'alicemo', 'liu.nathaniel', 'qwertyacc1', 'davide_asnaghi', 'poojarao75', 'blum001', 'a.hu.16', 'erichu57023', 'saurabh96jun', 'david960617', 'zib.summer', 'wpiszker42', 'christine.shim', 'subuls', 'pinasimone10', '11jazzyc', 'thegaga', 'matildem', 'mallika', 'xinyiz', 'go_arvind', '20lnelson', 'gsakoda', 'prithiv_natarajan', 'katherinecrawford', 'hahasan09', 'lkabraha1', 'christina.ngo', 'jwen20', 'liya_abraha', 'bader11', 'nsimonian', 'nicholast900', 'efang001', 'alva_liang', 'jrpuerto', 'tegan.anderes', 'shwetakotkar229', 'chanshaomun', 'lingyexie', 'allisondong1995']",172,"['eeich09281997', 'werki004', 'bhostetl', 'almai005', 'and04848', 'satyamku', 'mozomiguel73', 'matt.mcalpin26', 'kisleee3', 'schm4149', 'jurbani1', 'sthomps5', 'olso5589', 'mbaghdad', 'vuong056', 'johnbestman22', 'juan98', 'hentg030', 'nataliaramos3', 'msteve20', 'sobota_hailey', 'bajda004', 'felipe_hdz', 'mdfariduddin15', 'raabx028', 'jaardila', 'richard_thompson', 'opeojoy2k', 'fuxxx391', 'chem558', 'pcampbe3', 'jhg617', 'jfitzhen', 'dmccann20', 'mashiyatshawkat', 'huntorrocks', 'rgaurav0393', 'sahyo002', 'alhin010', 'daniel2809', 'donaldp97', 'thiosady', 'mk7800797', 'jahough', 'zihaoz', 'yang6086', 'utzma006', 'jpj', 'sirraf1', 'armentasantiago', 'mgerba', 'jarga001', 'gagno094', 'apaulo', 'amcalear', 'leex8370', 'anewton4', 'royxx318', 'kianx006', 'zhou0868', 'jagadishkarthikeya', 'myflash995', 'klonc003', 'mariano06', 'drddragan', 'adonadio', 'wille474', 'keech015', 'tuft0029', 'mendo172', 'blui001', 'juliortegon', 'tosaleal', 'md.quintero', 'udstr005', 'nicho919', 'klung009', 'yang5123', 'pvd', 'providedrailroad', 'scharles', 'sharm338', 'ng000046', 'mendo123', 'ryellitz', 'jamer98', 'damic014', 'lbarber', 'levac004', 'camilo0869', 'jeisson1299', 'polinp0p0', 'whloganw', 'prusi009', 'wegex009', 'lautmusicmois', 'ad.gregory', 'justsadler', 'anderpensilva', 'ahender4', 'olso7126', 'cmkennedy', 'nebix006', 'kevinbernalru', 'solerjavier7', 'maximum136', 'mukon004', 'shreyasnaik', 'mugnier', 'gvaishnavi761', 'maria.a.solano.otero', 'santiago.aine', 'anwar.iiserk', 'rachellyumi', 'gesex006', 'joedude15', 'sfhivo', 'lyde0037', 'lildoug1997', 'joh02339', 'p.j.grenz', 'matthew.byrnes4852', 'shahnewaz01', 'salmo091', 'bthorgood3', 'emunguia', 'tvv', 'ykes2bige', 'georgeking159', 'zamri003', 'kambo001', 'sitarsky', 'francis.marquez21', 'prigs2323', 'hagst077', 's.villamilp', 'pab272', 'kapla302', 'pvargas', 'iarasantelices', 'aphauser', 'libardo11chapal', 'cmckenz2', 'gerva039', 'juanpbotero9897', 'sebas.villaba2002', 'mlfronk', 'tran0559', 'seabassparker', 'deboka', 'rmghannam', 'dang0134', 'dperry', 'wdurnan', 'parke867', 'v.cardonac1', 'arthur.alo', 'mtrudd97', 's.y.wang.sdu', 'conwe007', 'tguy', 'matthiashartl', 'nicolash025', 'leama008', 'chrisowen873', 'spred003', 'wang150', 'dixon347', 'kruss008', 'ssantia1', 'ashton.bateman', 'inorman']",1,[None],237,"['rtoopal', 'francesco0131', 'xinyue.fang', 'eeich09281997', 'werki004', 'vton', 'carinaocarina', 'sgowtham09', 'mhoang', 'bhostetl', 'almai005', 'kristinachan', 'and04848', 'satyamku', 'ana_gomez', 'matt.mcalpin26', 'mozomiguel73', 'alice_vergani', 'kisleee3', 'schm4149', 'jurbani1', 'sthomps5', 'olso5589', 'chan_cheryl', 'alicemo', 'mbaghdad', 'vuong056', 'johnbestman22', 'blum001', 'a.hu.16', 'david960617', 'juan98', 'hentg030', 'christine.shim', 'nataliaramos3', 'msteve20', 'sobota_hailey', 'bajda004', 'felipe_hdz', 'pinasimone10', 'raabx028', 'mdfariduddin15', 'richard_thompson', 'opeojoy2k', 'fuxxx391', 'chem558', 'jwen20', 'pcampbe3', 'efang001', 'jhg617', 'jfitzhen', 'dmccann20', 'mashiyatshawkat', 'huntorrocks', 'rgaurav0393', 'sahyo002', 'shwetakotkar229', 'alhin010', 'daniel2809', 'lingyexie', 'donaldp97', 'thiosady', 'wshin765', 'mk7800797', 'mingxi', 'jahough', 'zihaoz', 'yang6086', 'oskar_radermecker', 'utzma006', 'jpj', 'timtoh168', 'sirraf1', 'armentasantiago', 'mgerba', 'jarga001', 'gagno094', 'apaulo', 'zib.summer', 'amcalear', 'leex8370', 'subuls', 'anewton4', 'royxx318', '11jazzyc', 'kianx006', 'thegaga', 'jagadishkarthikeya', 'myflash995', 'klonc003', 'zhou0868', 'mariano06', '20lnelson', 'gsakoda', 'drddragan', 'ashton.bateman', 'adonadio', 'wille474', 'keech015', 'tuft0029', 'katherinecrawford', 'mendo172', 'liya_abraha', 'blui001', 'juliortegon', 'tosaleal', 'md.quintero', 'udstr005', 'nicho919', 'klung009', 'yang5123', 'pvd', 'jrpuerto', 'providedrailroad', 'scharles', 'chanshaomun', 'mariaddld', 'allisondong1995', 'sharm338', 'dinhtmh', 'ng000046', 'mendo123', 'ryellitz', 'jamer98', 'damic014', 'lbarber', 'levac004', 'camilo0869', 'jeisson1299', 'polinp0p0', 'whloganw', 'popkir', 'prusi009', 'wegex009', 'lautmusicmois', 'ad.gregory', 'qwertyacc1', 'liu.nathaniel', 'justsadler', 'poojarao75', 'erichu57023', 'saurabh96jun', 'wpiszker42', 'anderpensilva', 'ahender4', 'olso7126', 'cmkennedy', 'nebix006', 'kevinbernalru', 'mallika', 'solerjavier7', 'maximum136', 'mukon004', 'shreyasnaik', 'mugnier', 'lkabraha1', 'gvaishnavi761', 'christina.ngo', 'maria.a.solano.otero', 'santiago.aine', 'bader11', 'anwar.iiserk', 'nicholast900', 'rachellyumi', 'gesex006', 'joedude15', 'sfhivo', 'lyde0037', 'lildoug1997', 'joh02339', 'p.j.grenz', 'hahasan09', None, 'andyz4', 'matthew.byrnes4852', 'shahnewaz01', 'naltemose89', 'salmo091', 'bthorgood3', 'emunguia', 'tvv', 'ykes2bige', 'georgeking159', 'zamri003', 'yyan818', 'kambo001', 'sitarsky', 'lomeligabriela88', 'tofer13', 'francis.marquez21', 'prigs2323', 'hagst077', 's.villamilp', 'pab272', 'kapla302', 'pvargas', 'iarasantelices', 'davide_asnaghi', 'aphauser', 'libardo11chapal', 'cmckenz2', 'gerva039', 'juanpbotero9897', 'sebas.villaba2002', 'mlfronk', 'tran0559', 'seabassparker', 'matildem', 'xinyiz', 'deboka', 'go_arvind', 'rmghannam', 'dang0134', 'prithiv_natarajan', 'dperry', 'wdurnan', 'parke867', 'v.cardonac1', 'arthur.alo', 'mtrudd97', 's.y.wang.sdu', 'conwe007', 'tguy', 'matthiashartl', 'nsimonian', 'nicolash025', 'leama008', 'chrisowen873', 'spred003', 'wang150', 'alva_liang', 'dixon347', 'tegan.anderes', 'kruss008', 'ssantia1', 'jaardila', 'inorman']"
2,116,237,36,6,"['aphauser', 'emunguia', 'dperry', 'adonadio', 'inorman', 'cmkennedy']",230,"['rtoopal', 'francesco0131', 'xinyue.fang', 'eeich09281997', 'werki004', 'vton', 'carinaocarina', 'sgowtham09', 'mhoang', 'bhostetl', 'almai005', 'kristinachan', 'and04848', 'satyamku', 'ana_gomez', 'matt.mcalpin26', 'mozomiguel73', 'alice_vergani', 'kisleee3', 'schm4149', 'jurbani1', 'sthomps5', 'olso5589', 'chan_cheryl', 'alicemo', 'mbaghdad', 'vuong056', 'johnbestman22', 'blum001', 'a.hu.16', 'david960617', 'juan98', 'hentg030', 'christine.shim', 'nataliaramos3', 'msteve20', 'sobota_hailey', 'bajda004', 'felipe_hdz', 'pinasimone10', 'raabx028', 'mdfariduddin15', 'richard_thompson', 'opeojoy2k', 'fuxxx391', 'chem558', 'jwen20', 'pcampbe3', 'efang001', 'jhg617', 'jfitzhen', 'dmccann20', 'mashiyatshawkat', 'huntorrocks', 'rgaurav0393', 'sahyo002', 'shwetakotkar229', 'alhin010', 'daniel2809', 'lingyexie', 'donaldp97', 'thiosady', 'wshin765', 'mk7800797', 'mingxi', 'jahough', 'zihaoz', 'yang6086', 'oskar_radermecker', 'utzma006', 'jpj', 'timtoh168', 'sirraf1', 'armentasantiago', 'mgerba', 'jarga001', 'gagno094', 'apaulo', 'zib.summer', 'amcalear', 'leex8370', 'subuls', 'anewton4', 'royxx318', '11jazzyc', 'kianx006', 'thegaga', 'jagadishkarthikeya', 'myflash995', 'klonc003', 'zhou0868', 'mariano06', '20lnelson', 'gsakoda', 'drddragan', 'ashton.bateman', 'wille474', 'keech015', 'tuft0029', 'katherinecrawford', 'mendo172', 'liya_abraha', 'blui001', 'juliortegon', 'tosaleal', 'md.quintero', 'udstr005', 'nicho919', 'klung009', 'yang5123', 'pvd', 'jrpuerto', 'providedrailroad', 'scharles', 'chanshaomun', 'mariaddld', 'allisondong1995', 'sharm338', 'dinhtmh', 'ng000046', 'mendo123', 'ryellitz', 'jamer98', 'damic014', 'lbarber', 'levac004', 'camilo0869', 'jeisson1299', 'polinp0p0', 'whloganw', 'popkir', 'prusi009', 'wegex009', 'lautmusicmois', 'ad.gregory', 'qwertyacc1', 'liu.nathaniel', 'justsadler', 'poojarao75', 'erichu57023', 'saurabh96jun', 'wpiszker42', 'anderpensilva', 'ahender4', 'olso7126', 'nebix006', 'kevinbernalru', 'mallika', 'solerjavier7', 'maximum136', 'mukon004', 'shreyasnaik', 'mugnier', 'lkabraha1', 'gvaishnavi761', 'christina.ngo', 'maria.a.solano.otero', 'santiago.aine', 'bader11', 'anwar.iiserk', 'nicholast900', 'rachellyumi', 'gesex006', 'joedude15', 'sfhivo', 'lyde0037', 'lildoug1997', 'joh02339', 'p.j.grenz', 'hahasan09', 'andyz4', 'matthew.byrnes4852', 'shahnewaz01', 'naltemose89', 'salmo091', 'bthorgood3', 'tvv', 'ykes2bige', 'georgeking159', 'zamri003', 'yyan818', 'kambo001', 'sitarsky', 'lomeligabriela88', 'tofer13', 'francis.marquez21', 'prigs2323', 'hagst077', 's.villamilp', 'pab272', 'kapla302', 'pvargas', 'iarasantelices', 'davide_asnaghi', 'libardo11chapal', 'cmckenz2', 'gerva039', 'juanpbotero9897', 'sebas.villaba2002', 'mlfronk', 'tran0559', 'seabassparker', 'matildem', 'xinyiz', 'deboka', 'go_arvind', 'rmghannam', 'dang0134', 'prithiv_natarajan', 'wdurnan', 'parke867', 'v.cardonac1', 'arthur.alo', 'mtrudd97', 's.y.wang.sdu', 'conwe007', 'tguy', 'matthiashartl', 'nsimonian', 'nicolash025', 'leama008', 'chrisowen873', 'spred003', 'wang150', 'alva_liang', 'dixon347', 'tegan.anderes', 'kruss008', 'ssantia1', 'jaardila']",30,"['vmouradian', 'komminiadithya', 'jcrouss', 'dgabriel', 'opin', 'aksamija', 'ayen', 'jgnall', 'mskaza', 'ltweston', 'aeshak', 'bdester', 'rwbrown', 'mjaffe', 'angusmo', 'sfick', 'jkvaternik', 'menglingshi', 'fpanikov', None, 'ajewers', 'oterry', 'whobby', 'tfloyd', 'jaandrade', 'jrosborne', 'bdeguire', 'tinamaurer', 'rcperkins', 'msokolov']",266,"['rtoopal', 'francesco0131', 'xinyue.fang', 'eeich09281997', 'jcrouss', 'werki004', 'vton', 'carinaocarina', 'sgowtham09', 'opin', 'mhoang', 'bhostetl', 'almai005', 'kristinachan', 'and04848', 'satyamku', 'ana_gomez', 'matt.mcalpin26', 'mozomiguel73', 'alice_vergani', 'kisleee3', 'schm4149', 'jurbani1', 'sthomps5', 'olso5589', 'chan_cheryl', 'alicemo', 'mbaghdad', 'vuong056', 'johnbestman22', 'blum001', 'a.hu.16', 'mjaffe', 'david960617', 'juan98', 'hentg030', 'christine.shim', 'nataliaramos3', 'msteve20', 'sobota_hailey', 'bajda004', 'felipe_hdz', 'pinasimone10', 'raabx028', 'mdfariduddin15', 'richard_thompson', 'opeojoy2k', 'fuxxx391', 'chem558', 'fpanikov', 'jwen20', 'pcampbe3', 'efang001', 'jhg617', 'jfitzhen', 'tfloyd', 'dmccann20', 'mashiyatshawkat', 'huntorrocks', 'rgaurav0393', 'sahyo002', 'shwetakotkar229', 'alhin010', 'daniel2809', 'lingyexie', 'donaldp97', 'thiosady', 'wshin765', 'mk7800797', 'mingxi', 'jahough', 'zihaoz', 'yang6086', 'oskar_radermecker', 'utzma006', 'jpj', 'timtoh168', 'sirraf1', 'mskaza', 'armentasantiago', 'mgerba', 'jarga001', 'gagno094', 'apaulo', 'rwbrown', 'zib.summer', 'amcalear', 'leex8370', 'subuls', 'anewton4', 'royxx318', '11jazzyc', 'kianx006', 'thegaga', 'jagadishkarthikeya', 'myflash995', 'klonc003', 'zhou0868', 'mariano06', '20lnelson', 'gsakoda', 'menglingshi', 'drddragan', 'ashton.bateman', 'adonadio', 'wille474', 'keech015', 'tuft0029', 'katherinecrawford', 'mendo172', 'liya_abraha', 'blui001', 'juliortegon', 'tosaleal', 'md.quintero', 'udstr005', 'nicho919', 'klung009', 'oterry', 'yang5123', 'jrosborne', 'bdeguire', 'pvd', 'jrpuerto', 'providedrailroad', 'scharles', 'chanshaomun', 'mariaddld', 'allisondong1995', 'aeshak', 'sharm338', 'dinhtmh', 'ng000046', 'mendo123', 'komminiadithya', 'ryellitz', 'jamer98', 'damic014', 'lbarber', 'levac004', 'camilo0869', 'jeisson1299', 'dgabriel', 'aksamija', 'jgnall', 'polinp0p0', 'whloganw', 'popkir', 'prusi009', 'wegex009', 'lautmusicmois', 'ltweston', 'ad.gregory', 'qwertyacc1', 'liu.nathaniel', 'justsadler', 'poojarao75', 'erichu57023', 'saurabh96jun', 'wpiszker42', 'anderpensilva', 'ahender4', 'olso7126', 'cmkennedy', 'nebix006', 'kevinbernalru', 'mallika', 'solerjavier7', 'sfick', 'maximum136', 'mukon004', 'shreyasnaik', 'jkvaternik', 'mugnier', 'lkabraha1', 'gvaishnavi761', 'christina.ngo', 'maria.a.solano.otero', 'santiago.aine', 'bader11', 'anwar.iiserk', 'nicholast900', 'rachellyumi', 'jaandrade', 'whobby', 'gesex006', 'joedude15', 'sfhivo', 'rcperkins', 'lyde0037', 'lildoug1997', 'joh02339', 'p.j.grenz', 'hahasan09', 'msokolov', None, 'andyz4', 'matthew.byrnes4852', 'shahnewaz01', 'naltemose89', 'vmouradian', 'salmo091', 'bthorgood3', 'emunguia', 'tvv', 'ykes2bige', 'georgeking159', 'zamri003', 'yyan818', 'kambo001', 'sitarsky', 'lomeligabriela88', 'tofer13', 'francis.marquez21', 'ayen', 'prigs2323', 'hagst077', 's.villamilp', 'pab272', 'kapla302', 'pvargas', 'bdester', 'iarasantelices', 'davide_asnaghi', 'aphauser', 'libardo11chapal', 'cmckenz2', 'gerva039', 'juanpbotero9897', 'sebas.villaba2002', 'mlfronk', 'angusmo', 'tran0559', 'seabassparker', 'matildem', 'xinyiz', 'deboka', 'go_arvind', 'rmghannam', 'dang0134', 'prithiv_natarajan', 'dperry', 'wdurnan', 'parke867', 'v.cardonac1', 'arthur.alo', 'mtrudd97', 's.y.wang.sdu', 'conwe007', 'tguy', 'matthiashartl', 'nsimonian', 'nicolash025', 'leama008', 'chrisowen873', 'spred003', 'ajewers', 'wang150', 'tinamaurer', 'alva_liang', 'dixon347', 'tegan.anderes', 'kruss008', 'ssantia1', 'jaardila', 'inorman']"
2,111,237,35,25,"['camilo0869', 'jeisson1299', 'mozomiguel73', 'lautmusicmois', 'armentasantiago', 'ad.gregory', 's.villamilp', 'libardo11chapal', 'anderpensilva', 'juan98', 'juanpbotero9897', 'sebas.villaba2002', 'nataliaramos3', 'felipe_hdz', 'kevinbernalru', 'solerjavier7', 'mugnier', 'nicolash025', 'v.cardonac1', 'maria.a.solano.otero', 'juliortegon', 'tosaleal', 'md.quintero', 'daniel2809', 'jaardila']",211,"['rtoopal', 'francesco0131', 'xinyue.fang', 'eeich09281997', 'werki004', 'vton', 'carinaocarina', 'sgowtham09', 'mhoang', 'bhostetl', 'almai005', 'kristinachan', 'and04848', 'satyamku', 'ana_gomez', 'matt.mcalpin26', 'alice_vergani', 'kisleee3', 'schm4149', 'jurbani1', 'sthomps5', 'olso5589', 'chan_cheryl', 'alicemo', 'mbaghdad', 'vuong056', 'johnbestman22', 'blum001', 'a.hu.16', 'david960617', 'hentg030', 'christine.shim', 'msteve20', 'sobota_hailey', 'bajda004', 'pinasimone10', 'raabx028', 'mdfariduddin15', 'richard_thompson', 'opeojoy2k', 'fuxxx391', 'chem558', 'jwen20', 'pcampbe3', 'efang001', 'jhg617', 'jfitzhen', 'dmccann20', 'mashiyatshawkat', 'huntorrocks', 'rgaurav0393', 'sahyo002', 'shwetakotkar229', 'alhin010', 'lingyexie', 'donaldp97', 'thiosady', 'wshin765', 'mk7800797', 'mingxi', 'jahough', 'zihaoz', 'yang6086', 'oskar_radermecker', 'utzma006', 'jpj', 'timtoh168', 'sirraf1', 'mgerba', 'jarga001', 'gagno094', 'apaulo', 'zib.summer', 'amcalear', 'leex8370', 'subuls', 'anewton4', 'royxx318', '11jazzyc', 'kianx006', 'thegaga', 'jagadishkarthikeya', 'myflash995', 'klonc003', 'zhou0868', 'mariano06', '20lnelson', 'gsakoda', 'drddragan', 'ashton.bateman', 'adonadio', 'wille474', 'keech015', 'tuft0029', 'katherinecrawford', 'mendo172', 'liya_abraha', 'blui001', 'udstr005', 'nicho919', 'klung009', 'yang5123', 'pvd', 'jrpuerto', 'providedrailroad', 'scharles', 'chanshaomun', 'mariaddld', 'allisondong1995', 'sharm338', 'dinhtmh', 'ng000046', 'mendo123', 'ryellitz', 'jamer98', 'damic014', 'lbarber', 'levac004', 'polinp0p0', 'whloganw', 'popkir', 'prusi009', 'wegex009', 'qwertyacc1', 'liu.nathaniel', 'justsadler', 'poojarao75', 'erichu57023', 'saurabh96jun', 'wpiszker42', 'ahender4', 'olso7126', 'cmkennedy', 'nebix006', 'mallika', 'maximum136', 'mukon004', 'shreyasnaik', 'lkabraha1', 'gvaishnavi761', 'christina.ngo', 'santiago.aine', 'bader11', 'anwar.iiserk', 'nicholast900', 'rachellyumi', 'gesex006', 'joedude15', 'sfhivo', 'lyde0037', 'lildoug1997', 'joh02339', 'p.j.grenz', 'hahasan09', 'andyz4', 'matthew.byrnes4852', 'shahnewaz01', 'naltemose89', 'salmo091', 'bthorgood3', 'emunguia', 'tvv', 'ykes2bige', 'georgeking159', 'zamri003', 'yyan818', 'kambo001', 'sitarsky', 'lomeligabriela88', 'tofer13', 'francis.marquez21', 'prigs2323', 'hagst077', 'pab272', 'kapla302', 'pvargas', 'iarasantelices', 'davide_asnaghi', 'aphauser', 'cmckenz2', 'gerva039', 'mlfronk', 'tran0559', 'seabassparker', 'matildem', 'xinyiz', 'deboka', 'go_arvind', 'rmghannam', 'dang0134', 'prithiv_natarajan', 'dperry', 'wdurnan', 'parke867', 'arthur.alo', 'mtrudd97', 's.y.wang.sdu', 'conwe007', 'tguy', 'matthiashartl', 'nsimonian', 'leama008', 'chrisowen873', 'spred003', 'wang150', 'alva_liang', 'dixon347', 'tegan.anderes', 'kruss008', 'ssantia1', 'inorman']",10,"['andysanty', 'linkiano', 'juanguerron', 'davidru.dr3', 'julianberonn', 'ayalagamezn', 'vb.herrera', 'camilo0868', None, 'alesk1208']",246,"['rtoopal', 'francesco0131', 'xinyue.fang', 'eeich09281997', 'werki004', 'vton', 'carinaocarina', 'sgowtham09', 'mhoang', 'bhostetl', 'almai005', 'kristinachan', 'and04848', 'satyamku', 'ana_gomez', 'matt.mcalpin26', 'mozomiguel73', 'alice_vergani', 'kisleee3', 'schm4149', 'jurbani1', 'sthomps5', 'olso5589', 'chan_cheryl', 'alicemo', 'mbaghdad', 'vuong056', 'johnbestman22', 'blum001', 'davidru.dr3', 'a.hu.16', 'camilo0868', 'david960617', 'juan98', 'hentg030', 'christine.shim', 'nataliaramos3', 'msteve20', 'sobota_hailey', 'bajda004', 'felipe_hdz', 'pinasimone10', 'raabx028', 'mdfariduddin15', 'richard_thompson', 'opeojoy2k', 'fuxxx391', 'chem558', 'jwen20', 'pcampbe3', 'efang001', 'jhg617', 'jfitzhen', 'dmccann20', 'mashiyatshawkat', 'huntorrocks', 'rgaurav0393', 'sahyo002', 'shwetakotkar229', 'alhin010', 'daniel2809', 'lingyexie', 'donaldp97', 'thiosady', 'wshin765', 'mk7800797', 'mingxi', 'jahough', 'zihaoz', 'yang6086', 'oskar_radermecker', 'vb.herrera', 'utzma006', 'jpj', 'timtoh168', 'sirraf1', 'armentasantiago', 'mgerba', 'jarga001', 'gagno094', 'apaulo', 'zib.summer', 'amcalear', 'leex8370', 'subuls', 'anewton4', 'royxx318', '11jazzyc', 'kianx006', 'thegaga', 'jagadishkarthikeya', 'myflash995', 'klonc003', 'zhou0868', 'mariano06', '20lnelson', 'ayalagamezn', 'gsakoda', 'drddragan', 'ashton.bateman', 'adonadio', 'wille474', 'keech015', 'tuft0029', 'katherinecrawford', 'mendo172', 'liya_abraha', 'blui001', 'juliortegon', 'tosaleal', 'md.quintero', 'udstr005', 'nicho919', 'klung009', 'yang5123', 'pvd', 'jrpuerto', 'providedrailroad', 'scharles', 'chanshaomun', 'mariaddld', 'allisondong1995', 'sharm338', 'dinhtmh', 'ng000046', 'andysanty', 'mendo123', 'ryellitz', 'jamer98', 'damic014', 'lbarber', 'levac004', 'camilo0869', 'julianberonn', 'jeisson1299', 'polinp0p0', 'whloganw', 'popkir', 'prusi009', 'wegex009', 'lautmusicmois', 'ad.gregory', 'qwertyacc1', 'liu.nathaniel', 'justsadler', 'poojarao75', 'erichu57023', 'saurabh96jun', 'wpiszker42', 'anderpensilva', 'ahender4', 'olso7126', 'cmkennedy', 'alesk1208', 'nebix006', 'kevinbernalru', 'mallika', 'solerjavier7', 'maximum136', 'mukon004', 'shreyasnaik', 'mugnier', 'lkabraha1', 'gvaishnavi761', 'christina.ngo', 'maria.a.solano.otero', 'santiago.aine', 'bader11', 'anwar.iiserk', 'nicholast900', 'rachellyumi', 'gesex006', 'juanguerron', 'joedude15', 'sfhivo', 'lyde0037', 'lildoug1997', 'joh02339', 'p.j.grenz', 'hahasan09', None, 'andyz4', 'matthew.byrnes4852', 'shahnewaz01', 'naltemose89', 'salmo091', 'bthorgood3', 'emunguia', 'tvv', 'ykes2bige', 'georgeking159', 'zamri003', 'yyan818', 'kambo001', 'sitarsky', 'lomeligabriela88', 'tofer13', 'francis.marquez21', 'prigs2323', 'hagst077', 's.villamilp', 'pab272', 'kapla302', 'pvargas', 'iarasantelices', 'davide_asnaghi', 'aphauser', 'libardo11chapal', 'cmckenz2', 'gerva039', 'juanpbotero9897', 'sebas.villaba2002', 'mlfronk', 'tran0559', 'seabassparker', 'linkiano', 'matildem', 'xinyiz', 'deboka', 'go_arvind', 'rmghannam', 'dang0134', 'prithiv_natarajan', 'dperry', 'wdurnan', 'parke867', 'v.cardonac1', 'arthur.alo', 'mtrudd97', 's.y.wang.sdu', 'conwe007', 'tguy', 'matthiashartl', 'nsimonian', 'nicolash025', 'leama008', 'chrisowen873', 'spred003', 'wang150', 'alva_liang', 'dixon347', 'tegan.anderes', 'kruss008', 'ssantia1', 'jaardila', 'inorman']"
2,113,237,34,33,"['donaldp97', 'matthew.byrnes4852', 'eeich09281997', 'ryellitz', 'jamer98', 'jahough', 'lbarber', 'georgeking159', 'ykes2bige', 'whloganw', 'matt.mcalpin26', 'jurbani1', 'sthomps5', 'mgerba', 'pvargas', 'mbaghdad', 'amcalear', 'cmckenz2', 'ahender4', 'sobota_hailey', 'anewton4', 'seabassparker', 'drddragan', 'wdurnan', 'tguy', 'mtrudd97', 'pcampbe3', 'jfitzhen', 'joedude15', 'huntorrocks', 'lildoug1997', 'ssantia1', 'ashton.bateman']",203,"['rtoopal', 'francesco0131', 'xinyue.fang', 'werki004', 'vton', 'carinaocarina', 'sgowtham09', 'mhoang', 'bhostetl', 'almai005', 'kristinachan', 'and04848', 'satyamku', 'ana_gomez', 'mozomiguel73', 'alice_vergani', 'kisleee3', 'schm4149', 'olso5589', 'chan_cheryl', 'alicemo', 'vuong056', 'johnbestman22', 'blum001', 'a.hu.16', 'david960617', 'juan98', 'hentg030', 'christine.shim', 'nataliaramos3', 'msteve20', 'bajda004', 'felipe_hdz', 'pinasimone10', 'raabx028', 'mdfariduddin15', 'richard_thompson', 'opeojoy2k', 'fuxxx391', 'chem558', 'jwen20', 'efang001', 'jhg617', 'dmccann20', 'mashiyatshawkat', 'rgaurav0393', 'sahyo002', 'shwetakotkar229', 'alhin010', 'daniel2809', 'lingyexie', 'thiosady', 'wshin765', 'mk7800797', 'mingxi', 'zihaoz', 'yang6086', 'oskar_radermecker', 'utzma006', 'jpj', 'timtoh168', 'sirraf1', 'armentasantiago', 'jarga001', 'gagno094', 'apaulo', 'zib.summer', 'leex8370', 'subuls', 'royxx318', '11jazzyc', 'kianx006', 'thegaga', 'jagadishkarthikeya', 'myflash995', 'klonc003', 'zhou0868', 'mariano06', '20lnelson', 'gsakoda', 'adonadio', 'wille474', 'keech015', 'tuft0029', 'katherinecrawford', 'mendo172', 'liya_abraha', 'blui001', 'juliortegon', 'tosaleal', 'md.quintero', 'udstr005', 'nicho919', 'klung009', 'yang5123', 'pvd', 'jrpuerto', 'providedrailroad', 'scharles', 'chanshaomun', 'mariaddld', 'allisondong1995', 'sharm338', 'dinhtmh', 'ng000046', 'mendo123', 'damic014', 'levac004', 'camilo0869', 'jeisson1299', 'polinp0p0', 'popkir', 'prusi009', 'wegex009', 'lautmusicmois', 'ad.gregory', 'qwertyacc1', 'liu.nathaniel', 'justsadler', 'poojarao75', 'erichu57023', 'saurabh96jun', 'wpiszker42', 'anderpensilva', 'olso7126', 'cmkennedy', 'nebix006', 'kevinbernalru', 'mallika', 'solerjavier7', 'maximum136', 'mukon004', 'shreyasnaik', 'mugnier', 'lkabraha1', 'gvaishnavi761', 'christina.ngo', 'maria.a.solano.otero', 'santiago.aine', 'bader11', 'anwar.iiserk', 'nicholast900', 'rachellyumi', 'gesex006', 'sfhivo', 'lyde0037', 'joh02339', 'p.j.grenz', 'hahasan09', 'andyz4', 'shahnewaz01', 'naltemose89', 'salmo091', 'bthorgood3', 'emunguia', 'tvv', 'zamri003', 'yyan818', 'kambo001', 'sitarsky', 'lomeligabriela88', 'tofer13', 'francis.marquez21', 'prigs2323', 'hagst077', 's.villamilp', 'pab272', 'kapla302', 'iarasantelices', 'davide_asnaghi', 'aphauser', 'libardo11chapal', 'gerva039', 'juanpbotero9897', 'sebas.villaba2002', 'mlfronk', 'tran0559', 'matildem', 'xinyiz', 'deboka', 'go_arvind', 'rmghannam', 'dang0134', 'prithiv_natarajan', 'dperry', 'parke867', 'v.cardonac1', 'arthur.alo', 's.y.wang.sdu', 'conwe007', 'matthiashartl', 'nsimonian', 'nicolash025', 'leama008', 'chrisowen873', 'spred003', 'wang150', 'alva_liang', 'dixon347', 'tegan.anderes', 'kruss008', 'jaardila', 'inorman']",1,[None],237,"['rtoopal', 'francesco0131', 'xinyue.fang', 'eeich09281997', 'werki004', 'vton', 'carinaocarina', 'sgowtham09', 'mhoang', 'bhostetl', 'almai005', 'kristinachan', 'and04848', 'satyamku', 'ana_gomez', 'matt.mcalpin26', 'mozomiguel73', 'alice_vergani', 'kisleee3', 'schm4149', 'jurbani1', 'sthomps5', 'olso5589', 'chan_cheryl', 'alicemo', 'mbaghdad', 'vuong056', 'johnbestman22', 'blum001', 'a.hu.16', 'david960617', 'juan98', 'hentg030', 'christine.shim', 'nataliaramos3', 'msteve20', 'sobota_hailey', 'bajda004', 'felipe_hdz', 'pinasimone10', 'raabx028', 'mdfariduddin15', 'richard_thompson', 'opeojoy2k', 'fuxxx391', 'chem558', 'jwen20', 'pcampbe3', 'efang001', 'jhg617', 'jfitzhen', 'dmccann20', 'mashiyatshawkat', 'huntorrocks', 'rgaurav0393', 'sahyo002', 'shwetakotkar229', 'alhin010', 'daniel2809', 'lingyexie', 'donaldp97', 'thiosady', 'wshin765', 'mk7800797', 'mingxi', 'jahough', 'zihaoz', 'yang6086', 'oskar_radermecker', 'utzma006', 'jpj', 'timtoh168', 'sirraf1', 'armentasantiago', 'mgerba', 'jarga001', 'gagno094', 'apaulo', 'zib.summer', 'amcalear', 'leex8370', 'subuls', 'anewton4', 'royxx318', '11jazzyc', 'kianx006', 'thegaga', 'jagadishkarthikeya', 'myflash995', 'klonc003', 'zhou0868', 'mariano06', '20lnelson', 'gsakoda', 'drddragan', 'ashton.bateman', 'adonadio', 'wille474', 'keech015', 'tuft0029', 'katherinecrawford', 'mendo172', 'liya_abraha', 'blui001', 'juliortegon', 'tosaleal', 'md.quintero', 'udstr005', 'nicho919', 'klung009', 'yang5123', 'pvd', 'jrpuerto', 'providedrailroad', 'scharles', 'chanshaomun', 'mariaddld', 'allisondong1995', 'sharm338', 'dinhtmh', 'ng000046', 'mendo123', 'ryellitz', 'jamer98', 'damic014', 'lbarber', 'levac004', 'camilo0869', 'jeisson1299', 'polinp0p0', 'whloganw', 'popkir', 'prusi009', 'wegex009', 'lautmusicmois', 'ad.gregory', 'qwertyacc1', 'liu.nathaniel', 'justsadler', 'poojarao75', 'erichu57023', 'saurabh96jun', 'wpiszker42', 'anderpensilva', 'ahender4', 'olso7126', 'cmkennedy', 'nebix006', 'kevinbernalru', 'mallika', 'solerjavier7', 'maximum136', 'mukon004', 'shreyasnaik', 'mugnier', 'lkabraha1', 'gvaishnavi761', 'christina.ngo', 'maria.a.solano.otero', 'santiago.aine', 'bader11', 'anwar.iiserk', 'nicholast900', 'rachellyumi', 'gesex006', 'joedude15', 'sfhivo', 'lyde0037', 'lildoug1997', 'joh02339', 'p.j.grenz', 'hahasan09', None, 'andyz4', 'matthew.byrnes4852', 'shahnewaz01', 'naltemose89', 'salmo091', 'bthorgood3', 'emunguia', 'tvv', 'ykes2bige', 'georgeking159', 'zamri003', 'yyan818', 'kambo001', 'sitarsky', 'lomeligabriela88', 'tofer13', 'francis.marquez21', 'prigs2323', 'hagst077', 's.villamilp', 'pab272', 'kapla302', 'pvargas', 'iarasantelices', 'davide_asnaghi', 'aphauser', 'libardo11chapal', 'cmckenz2', 'gerva039', 'juanpbotero9897', 'sebas.villaba2002', 'mlfronk', 'tran0559', 'seabassparker', 'matildem', 'xinyiz', 'deboka', 'go_arvind', 'rmghannam', 'dang0134', 'prithiv_natarajan', 'dperry', 'wdurnan', 'parke867', 'v.cardonac1', 'arthur.alo', 'mtrudd97', 's.y.wang.sdu', 'conwe007', 'tguy', 'matthiashartl', 'nsimonian', 'nicolash025', 'leama008', 'chrisowen873', 'spred003', 'wang150', 'alva_liang', 'dixon347', 'tegan.anderes', 'kruss008', 'ssantia1', 'jaardila', 'inorman']"
2,213,237,25,1,['maria.a.solano.otero'],235,"['rtoopal', 'francesco0131', 'xinyue.fang', 'eeich09281997', 'werki004', 'vton', 'carinaocarina', 'sgowtham09', 'mhoang', 'bhostetl', 'almai005', 'kristinachan', 'and04848', 'satyamku', 'ana_gomez', 'matt.mcalpin26', 'mozomiguel73', 'alice_vergani', 'kisleee3', 'schm4149', 'jurbani1', 'sthomps5', 'olso5589', 'chan_cheryl', 'alicemo', 'mbaghdad', 'vuong056', 'johnbestman22', 'blum001', 'a.hu.16', 'david960617', 'juan98', 'hentg030', 'christine.shim', 'nataliaramos3', 'msteve20', 'sobota_hailey', 'bajda004', 'felipe_hdz', 'pinasimone10', 'raabx028', 'mdfariduddin15', 'richard_thompson', 'opeojoy2k', 'fuxxx391', 'chem558', 'jwen20', 'pcampbe3', 'efang001', 'jhg617', 'jfitzhen', 'dmccann20', 'mashiyatshawkat', 'huntorrocks', 'rgaurav0393', 'sahyo002', 'shwetakotkar229', 'alhin010', 'daniel2809', 'lingyexie', 'donaldp97', 'thiosady', 'wshin765', 'mk7800797', 'mingxi', 'jahough', 'zihaoz', 'yang6086', 'oskar_radermecker', 'utzma006', 'jpj', 'timtoh168', 'sirraf1', 'armentasantiago', 'mgerba', 'jarga001', 'gagno094', 'apaulo', 'zib.summer', 'amcalear', 'leex8370', 'subuls', 'anewton4', 'royxx318', '11jazzyc', 'kianx006', 'thegaga', 'jagadishkarthikeya', 'myflash995', 'klonc003', 'zhou0868', 'mariano06', '20lnelson', 'gsakoda', 'drddragan', 'ashton.bateman', 'adonadio', 'wille474', 'keech015', 'tuft0029', 'katherinecrawford', 'mendo172', 'liya_abraha', 'blui001', 'juliortegon', 'tosaleal', 'md.quintero', 'udstr005', 'nicho919', 'klung009', 'yang5123', 'pvd', 'jrpuerto', 'providedrailroad', 'scharles', 'chanshaomun', 'mariaddld', 'allisondong1995', 'sharm338', 'dinhtmh', 'ng000046', 'mendo123', 'ryellitz', 'jamer98', 'damic014', 'lbarber', 'levac004', 'camilo0869', 'jeisson1299', 'polinp0p0', 'whloganw', 'popkir', 'prusi009', 'wegex009', 'lautmusicmois', 'ad.gregory', 'qwertyacc1', 'liu.nathaniel', 'justsadler', 'poojarao75', 'erichu57023', 'saurabh96jun', 'wpiszker42', 'anderpensilva', 'ahender4', 'olso7126', 'cmkennedy', 'nebix006', 'kevinbernalru', 'mallika', 'solerjavier7', 'maximum136', 'mukon004', 'shreyasnaik', 'mugnier', 'lkabraha1', 'gvaishnavi761', 'christina.ngo', 'santiago.aine', 'bader11', 'anwar.iiserk', 'nicholast900', 'rachellyumi', 'gesex006', 'joedude15', 'sfhivo', 'lyde0037', 'lildoug1997', 'joh02339', 'p.j.grenz', 'hahasan09', 'andyz4', 'matthew.byrnes4852', 'shahnewaz01', 'naltemose89', 'salmo091', 'bthorgood3', 'emunguia', 'tvv', 'ykes2bige', 'georgeking159', 'zamri003', 'yyan818', 'kambo001', 'sitarsky', 'lomeligabriela88', 'tofer13', 'francis.marquez21', 'prigs2323', 'hagst077', 's.villamilp', 'pab272', 'kapla302', 'pvargas', 'iarasantelices', 'davide_asnaghi', 'aphauser', 'libardo11chapal', 'cmckenz2', 'gerva039', 'juanpbotero9897', 'sebas.villaba2002', 'mlfronk', 'tran0559', 'seabassparker', 'matildem', 'xinyiz', 'deboka', 'go_arvind', 'rmghannam', 'dang0134', 'prithiv_natarajan', 'dperry', 'wdurnan', 'parke867', 'v.cardonac1', 'arthur.alo', 'mtrudd97', 's.y.wang.sdu', 'conwe007', 'tguy', 'matthiashartl', 'nsimonian', 'nicolash025', 'leama008', 'chrisowen873', 'spred003', 'wang150', 'alva_liang', 'dixon347', 'tegan.anderes', 'kruss008', 'ssantia1', 'jaardila', 'inorman']",24,"['rcarvajal208', 'julianberonn', 'drhurtado', 'julissa.vigoya', 'am.bolivar', 'danielpena96', 'danielbaron104', 'juanseb98', 'edgarfpena', 'lauraguerreroa88', 'jgal', 'te.vence10', 'lf.correa10', 'carlosan98', 'labfund', 'alejandroariaszuluaga', 'alvarocardona', 'ma.sandoval', 'andresfdt.2k8', None, 'santiagoalfonso015', 'medagorodavid', 'carlosaenz2626', 'juanguerron']",260,"['rtoopal', 'francesco0131', 'xinyue.fang', 'eeich09281997', 'werki004', 'vton', 'carinaocarina', 'sgowtham09', 'mhoang', 'bhostetl', 'almai005', 'kristinachan', 'and04848', 'am.bolivar', 'satyamku', 'ana_gomez', 'matt.mcalpin26', 'mozomiguel73', 'alice_vergani', 'kisleee3', 'schm4149', 'jurbani1', 'sthomps5', 'olso5589', 'chan_cheryl', 'alicemo', 'mbaghdad', 'danielbaron104', 'vuong056', 'johnbestman22', 'blum001', 'a.hu.16', 'david960617', 'juan98', 'hentg030', 'christine.shim', 'nataliaramos3', 'msteve20', 'sobota_hailey', 'bajda004', 'felipe_hdz', 'pinasimone10', 'raabx028', 'mdfariduddin15', 'te.vence10', 'richard_thompson', 'alvarocardona', 'opeojoy2k', 'fuxxx391', 'ma.sandoval', 'chem558', 'santiagoalfonso015', 'jwen20', 'pcampbe3', 'efang001', 'jhg617', 'jfitzhen', 'dmccann20', 'mashiyatshawkat', 'huntorrocks', 'rgaurav0393', 'sahyo002', 'shwetakotkar229', 'alhin010', 'daniel2809', 'lingyexie', 'donaldp97', 'thiosady', 'wshin765', 'mk7800797', 'mingxi', 'jahough', 'zihaoz', 'yang6086', 'oskar_radermecker', 'utzma006', 'drhurtado', 'jpj', 'timtoh168', 'sirraf1', 'armentasantiago', 'mgerba', 'jarga001', 'gagno094', 'apaulo', 'lauraguerreroa88', 'zib.summer', 'amcalear', 'leex8370', 'subuls', 'anewton4', 'lf.correa10', 'royxx318', '11jazzyc', 'kianx006', 'alejandroariaszuluaga', 'thegaga', 'jagadishkarthikeya', 'myflash995', 'klonc003', 'zhou0868', 'mariano06', '20lnelson', 'gsakoda', 'andresfdt.2k8', 'drddragan', 'ashton.bateman', 'adonadio', 'wille474', 'keech015', 'tuft0029', 'katherinecrawford', 'mendo172', 'liya_abraha', 'blui001', 'juliortegon', 'tosaleal', 'md.quintero', 'udstr005', 'nicho919', 'klung009', 'carlosaenz2626', 'yang5123', 'pvd', 'jrpuerto', 'providedrailroad', 'scharles', 'chanshaomun', 'mariaddld', 'allisondong1995', 'sharm338', 'dinhtmh', 'ng000046', 'mendo123', 'ryellitz', 'jamer98', 'damic014', 'rcarvajal208', 'lbarber', 'levac004', 'camilo0869', 'julianberonn', 'jeisson1299', 'polinp0p0', 'whloganw', 'popkir', 'prusi009', 'wegex009', 'lautmusicmois', 'ad.gregory', 'qwertyacc1', 'liu.nathaniel', 'justsadler', 'juanseb98', 'poojarao75', 'edgarfpena', 'erichu57023', 'saurabh96jun', 'wpiszker42', 'anderpensilva', 'ahender4', 'olso7126', 'cmkennedy', 'jgal', 'carlosan98', 'nebix006', 'kevinbernalru', 'mallika', 'solerjavier7', 'maximum136', 'mukon004', 'shreyasnaik', 'mugnier', 'lkabraha1', 'gvaishnavi761', 'christina.ngo', 'maria.a.solano.otero', 'santiago.aine', 'bader11', 'anwar.iiserk', 'nicholast900', 'medagorodavid', 'rachellyumi', 'gesex006', 'juanguerron', 'joedude15', 'sfhivo', 'lyde0037', 'lildoug1997', 'joh02339', 'p.j.grenz', 'hahasan09', None, 'andyz4', 'matthew.byrnes4852', 'shahnewaz01', 'naltemose89', 'salmo091', 'bthorgood3', 'emunguia', 'tvv', 'ykes2bige', 'georgeking159', 'zamri003', 'yyan818', 'kambo001', 'sitarsky', 'lomeligabriela88', 'tofer13', 'francis.marquez21', 'julissa.vigoya', 'prigs2323', 'hagst077', 'danielpena96', 's.villamilp', 'pab272', 'kapla302', 'pvargas', 'iarasantelices', 'davide_asnaghi', 'aphauser', 'libardo11chapal', 'cmckenz2', 'gerva039', 'juanpbotero9897', 'sebas.villaba2002', 'labfund', 'mlfronk', 'tran0559', 'seabassparker', 'matildem', 'xinyiz', 'deboka', 'go_arvind', 'rmghannam', 'dang0134', 'prithiv_natarajan', 'dperry', 'wdurnan', 'parke867', 'v.cardonac1', 'arthur.alo', 'mtrudd97', 's.y.wang.sdu', 'conwe007', 'tguy', 'matthiashartl', 'nsimonian', 'nicolash025', 'leama008', 'chrisowen873', 'spred003', 'wang150', 'alva_liang', 'dixon347', 'tegan.anderes', 'kruss008', 'ssantia1', 'jaardila', 'inorman']"
2,118,237,8,7,"['blui001', 'efang001', 'qwertyacc1', 'xinyiz', 'blum001', 'chanshaomun', 'christina.ngo']",229,"['rtoopal', 'francesco0131', 'xinyue.fang', 'eeich09281997', 'werki004', 'vton', 'carinaocarina', 'sgowtham09', 'mhoang', 'bhostetl', 'almai005', 'kristinachan', 'and04848', 'satyamku', 'ana_gomez', 'matt.mcalpin26', 'mozomiguel73', 'alice_vergani', 'kisleee3', 'schm4149', 'jurbani1', 'sthomps5', 'olso5589', 'chan_cheryl', 'alicemo', 'mbaghdad', 'vuong056', 'johnbestman22', 'a.hu.16', 'david960617', 'juan98', 'hentg030', 'christine.shim', 'nataliaramos3', 'msteve20', 'sobota_hailey', 'bajda004', 'felipe_hdz', 'pinasimone10', 'raabx028', 'mdfariduddin15', 'richard_thompson', 'opeojoy2k', 'fuxxx391', 'chem558', 'jwen20', 'pcampbe3', 'jhg617', 'jfitzhen', 'dmccann20', 'mashiyatshawkat', 'huntorrocks', 'rgaurav0393', 'sahyo002', 'shwetakotkar229', 'alhin010', 'daniel2809', 'lingyexie', 'donaldp97', 'thiosady', 'wshin765', 'mk7800797', 'mingxi', 'jahough', 'zihaoz', 'yang6086', 'oskar_radermecker', 'utzma006', 'jpj', 'timtoh168', 'sirraf1', 'armentasantiago', 'mgerba', 'jarga001', 'gagno094', 'apaulo', 'zib.summer', 'amcalear', 'leex8370', 'subuls', 'anewton4', 'royxx318', '11jazzyc', 'kianx006', 'thegaga', 'jagadishkarthikeya', 'myflash995', 'klonc003', 'zhou0868', 'mariano06', '20lnelson', 'gsakoda', 'drddragan', 'ashton.bateman', 'adonadio', 'wille474', 'keech015', 'tuft0029', 'katherinecrawford', 'mendo172', 'liya_abraha', 'juliortegon', 'tosaleal', 'md.quintero', 'udstr005', 'nicho919', 'klung009', 'yang5123', 'pvd', 'jrpuerto', 'providedrailroad', 'scharles', 'mariaddld', 'allisondong1995', 'sharm338', 'dinhtmh', 'ng000046', 'mendo123', 'ryellitz', 'jamer98', 'damic014', 'lbarber', 'levac004', 'camilo0869', 'jeisson1299', 'polinp0p0', 'whloganw', 'popkir', 'prusi009', 'wegex009', 'lautmusicmois', 'ad.gregory', 'liu.nathaniel', 'justsadler', 'poojarao75', 'erichu57023', 'saurabh96jun', 'wpiszker42', 'anderpensilva', 'ahender4', 'olso7126', 'cmkennedy', 'nebix006', 'kevinbernalru', 'mallika', 'solerjavier7', 'maximum136', 'mukon004', 'shreyasnaik', 'mugnier', 'lkabraha1', 'gvaishnavi761', 'maria.a.solano.otero', 'santiago.aine', 'bader11', 'anwar.iiserk', 'nicholast900', 'rachellyumi', 'gesex006', 'joedude15', 'sfhivo', 'lyde0037', 'lildoug1997', 'joh02339', 'p.j.grenz', 'hahasan09', 'andyz4', 'matthew.byrnes4852', 'shahnewaz01', 'naltemose89', 'salmo091', 'bthorgood3', 'emunguia', 'tvv', 'ykes2bige', 'georgeking159', 'zamri003', 'yyan818', 'kambo001', 'sitarsky', 'lomeligabriela88', 'tofer13', 'francis.marquez21', 'prigs2323', 'hagst077', 's.villamilp', 'pab272', 'kapla302', 'pvargas', 'iarasantelices', 'davide_asnaghi', 'aphauser', 'libardo11chapal', 'cmckenz2', 'gerva039', 'juanpbotero9897', 'sebas.villaba2002', 'mlfronk', 'tran0559', 'seabassparker', 'matildem', 'deboka', 'go_arvind', 'rmghannam', 'dang0134', 'prithiv_natarajan', 'dperry', 'wdurnan', 'parke867', 'v.cardonac1', 'arthur.alo', 'mtrudd97', 's.y.wang.sdu', 'conwe007', 'tguy', 'matthiashartl', 'nsimonian', 'nicolash025', 'leama008', 'chrisowen873', 'spred003', 'wang150', 'alva_liang', 'dixon347', 'tegan.anderes', 'kruss008', 'ssantia1', 'jaardila', 'inorman']",1,[None],237,"['rtoopal', 'francesco0131', 'xinyue.fang', 'eeich09281997', 'werki004', 'vton', 'carinaocarina', 'sgowtham09', 'mhoang', 'bhostetl', 'almai005', 'kristinachan', 'and04848', 'satyamku', 'ana_gomez', 'matt.mcalpin26', 'mozomiguel73', 'alice_vergani', 'kisleee3', 'schm4149', 'jurbani1', 'sthomps5', 'olso5589', 'chan_cheryl', 'alicemo', 'mbaghdad', 'vuong056', 'johnbestman22', 'blum001', 'a.hu.16', 'david960617', 'juan98', 'hentg030', 'christine.shim', 'nataliaramos3', 'msteve20', 'sobota_hailey', 'bajda004', 'felipe_hdz', 'pinasimone10', 'raabx028', 'mdfariduddin15', 'richard_thompson', 'opeojoy2k', 'fuxxx391', 'chem558', 'jwen20', 'pcampbe3', 'efang001', 'jhg617', 'jfitzhen', 'dmccann20', 'mashiyatshawkat', 'huntorrocks', 'rgaurav0393', 'sahyo002', 'shwetakotkar229', 'alhin010', 'daniel2809', 'lingyexie', 'donaldp97', 'thiosady', 'wshin765', 'mk7800797', 'mingxi', 'jahough', 'zihaoz', 'yang6086', 'oskar_radermecker', 'utzma006', 'jpj', 'timtoh168', 'sirraf1', 'armentasantiago', 'mgerba', 'jarga001', 'gagno094', 'apaulo', 'zib.summer', 'amcalear', 'leex8370', 'subuls', 'anewton4', 'royxx318', '11jazzyc', 'kianx006', 'thegaga', 'jagadishkarthikeya', 'myflash995', 'klonc003', 'zhou0868', 'mariano06', '20lnelson', 'gsakoda', 'drddragan', 'ashton.bateman', 'adonadio', 'wille474', 'keech015', 'tuft0029', 'katherinecrawford', 'mendo172', 'liya_abraha', 'blui001', 'juliortegon', 'tosaleal', 'md.quintero', 'udstr005', 'nicho919', 'klung009', 'yang5123', 'pvd', 'jrpuerto', 'providedrailroad', 'scharles', 'chanshaomun', 'mariaddld', 'allisondong1995', 'sharm338', 'dinhtmh', 'ng000046', 'mendo123', 'ryellitz', 'jamer98', 'damic014', 'lbarber', 'levac004', 'camilo0869', 'jeisson1299', 'polinp0p0', 'whloganw', 'popkir', 'prusi009', 'wegex009', 'lautmusicmois', 'ad.gregory', 'qwertyacc1', 'liu.nathaniel', 'justsadler', 'poojarao75', 'erichu57023', 'saurabh96jun', 'wpiszker42', 'anderpensilva', 'ahender4', 'olso7126', 'cmkennedy', 'nebix006', 'kevinbernalru', 'mallika', 'solerjavier7', 'maximum136', 'mukon004', 'shreyasnaik', 'mugnier', 'lkabraha1', 'gvaishnavi761', 'christina.ngo', 'maria.a.solano.otero', 'santiago.aine', 'bader11', 'anwar.iiserk', 'nicholast900', 'rachellyumi', 'gesex006', 'joedude15', 'sfhivo', 'lyde0037', 'lildoug1997', 'joh02339', 'p.j.grenz', 'hahasan09', None, 'andyz4', 'matthew.byrnes4852', 'shahnewaz01', 'naltemose89', 'salmo091', 'bthorgood3', 'emunguia', 'tvv', 'ykes2bige', 'georgeking159', 'zamri003', 'yyan818', 'kambo001', 'sitarsky', 'lomeligabriela88', 'tofer13', 'francis.marquez21', 'prigs2323', 'hagst077', 's.villamilp', 'pab272', 'kapla302', 'pvargas', 'iarasantelices', 'davide_asnaghi', 'aphauser', 'libardo11chapal', 'cmckenz2', 'gerva039', 'juanpbotero9897', 'sebas.villaba2002', 'mlfronk', 'tran0559', 'seabassparker', 'matildem', 'xinyiz', 'deboka', 'go_arvind', 'rmghannam', 'dang0134', 'prithiv_natarajan', 'dperry', 'wdurnan', 'parke867', 'v.cardonac1', 'arthur.alo', 'mtrudd97', 's.y.wang.sdu', 'conwe007', 'tguy', 'matthiashartl', 'nsimonian', 'nicolash025', 'leama008', 'chrisowen873', 'spred003', 'wang150', 'alva_liang', 'dixon347', 'tegan.anderes', 'kruss008', 'ssantia1', 'jaardila', 'inorman']"
2,119,237,8,1,['apaulo'],235,"['rtoopal', 'francesco0131', 'xinyue.fang', 'eeich09281997', 'werki004', 'vton', 'carinaocarina', 'sgowtham09', 'mhoang', 'bhostetl', 'almai005', 'kristinachan', 'and04848', 'satyamku', 'ana_gomez', 'matt.mcalpin26', 'mozomiguel73', 'alice_vergani', 'kisleee3', 'schm4149', 'jurbani1', 'sthomps5', 'olso5589', 'chan_cheryl', 'alicemo', 'mbaghdad', 'vuong056', 'johnbestman22', 'blum001', 'a.hu.16', 'david960617', 'juan98', 'hentg030', 'christine.shim', 'nataliaramos3', 'msteve20', 'sobota_hailey', 'bajda004', 'felipe_hdz', 'pinasimone10', 'raabx028', 'mdfariduddin15', 'richard_thompson', 'opeojoy2k', 'fuxxx391', 'chem558', 'jwen20', 'pcampbe3', 'efang001', 'jhg617', 'jfitzhen', 'dmccann20', 'mashiyatshawkat', 'huntorrocks', 'rgaurav0393', 'sahyo002', 'shwetakotkar229', 'alhin010', 'daniel2809', 'lingyexie', 'donaldp97', 'thiosady', 'wshin765', 'mk7800797', 'mingxi', 'jahough', 'zihaoz', 'yang6086', 'oskar_radermecker', 'utzma006', 'jpj', 'timtoh168', 'sirraf1', 'armentasantiago', 'mgerba', 'jarga001', 'gagno094', 'zib.summer', 'amcalear', 'leex8370', 'subuls', 'anewton4', 'royxx318', '11jazzyc', 'kianx006', 'thegaga', 'jagadishkarthikeya', 'myflash995', 'klonc003', 'zhou0868', 'mariano06', '20lnelson', 'gsakoda', 'drddragan', 'ashton.bateman', 'adonadio', 'wille474', 'keech015', 'tuft0029', 'katherinecrawford', 'mendo172', 'liya_abraha', 'blui001', 'juliortegon', 'tosaleal', 'md.quintero', 'udstr005', 'nicho919', 'klung009', 'yang5123', 'pvd', 'jrpuerto', 'providedrailroad', 'scharles', 'chanshaomun', 'mariaddld', 'allisondong1995', 'sharm338', 'dinhtmh', 'ng000046', 'mendo123', 'ryellitz', 'jamer98', 'damic014', 'lbarber', 'levac004', 'camilo0869', 'jeisson1299', 'polinp0p0', 'whloganw', 'popkir', 'prusi009', 'wegex009', 'lautmusicmois', 'ad.gregory', 'qwertyacc1', 'liu.nathaniel', 'justsadler', 'poojarao75', 'erichu57023', 'saurabh96jun', 'wpiszker42', 'anderpensilva', 'ahender4', 'olso7126', 'cmkennedy', 'nebix006', 'kevinbernalru', 'mallika', 'solerjavier7', 'maximum136', 'mukon004', 'shreyasnaik', 'mugnier', 'lkabraha1', 'gvaishnavi761', 'christina.ngo', 'maria.a.solano.otero', 'santiago.aine', 'bader11', 'anwar.iiserk', 'nicholast900', 'rachellyumi', 'gesex006', 'joedude15', 'sfhivo', 'lyde0037', 'lildoug1997', 'joh02339', 'p.j.grenz', 'hahasan09', 'andyz4', 'matthew.byrnes4852', 'shahnewaz01', 'naltemose89', 'salmo091', 'bthorgood3', 'emunguia', 'tvv', 'ykes2bige', 'georgeking159', 'zamri003', 'yyan818', 'kambo001', 'sitarsky', 'lomeligabriela88', 'tofer13', 'francis.marquez21', 'prigs2323', 'hagst077', 's.villamilp', 'pab272', 'kapla302', 'pvargas', 'iarasantelices', 'davide_asnaghi', 'aphauser', 'libardo11chapal', 'cmckenz2', 'gerva039', 'juanpbotero9897', 'sebas.villaba2002', 'mlfronk', 'tran0559', 'seabassparker', 'matildem', 'xinyiz', 'deboka', 'go_arvind', 'rmghannam', 'dang0134', 'prithiv_natarajan', 'dperry', 'wdurnan', 'parke867', 'v.cardonac1', 'arthur.alo', 'mtrudd97', 's.y.wang.sdu', 'conwe007', 'tguy', 'matthiashartl', 'nsimonian', 'nicolash025', 'leama008', 'chrisowen873', 'spred003', 'wang150', 'alva_liang', 'dixon347', 'tegan.anderes', 'kruss008', 'ssantia1', 'jaardila', 'inorman']",7,"['whobby', 'jrosborne', 'bdester', 'jkvaternik', 'mlaszcz', 'fpanikov', None]",243,"['rtoopal', 'francesco0131', 'xinyue.fang', 'eeich09281997', 'werki004', 'vton', 'carinaocarina', 'sgowtham09', 'mhoang', 'bhostetl', 'almai005', 'kristinachan', 'and04848', 'satyamku', 'ana_gomez', 'matt.mcalpin26', 'mozomiguel73', 'alice_vergani', 'kisleee3', 'schm4149', 'jurbani1', 'sthomps5', 'olso5589', 'chan_cheryl', 'alicemo', 'mbaghdad', 'vuong056', 'johnbestman22', 'blum001', 'a.hu.16', 'david960617', 'juan98', 'hentg030', 'christine.shim', 'nataliaramos3', 'msteve20', 'sobota_hailey', 'bajda004', 'felipe_hdz', 'pinasimone10', 'raabx028', 'mdfariduddin15', 'richard_thompson', 'opeojoy2k', 'fuxxx391', 'chem558', 'fpanikov', 'jwen20', 'pcampbe3', 'efang001', 'jhg617', 'jfitzhen', 'dmccann20', 'mashiyatshawkat', 'huntorrocks', 'rgaurav0393', 'sahyo002', 'shwetakotkar229', 'alhin010', 'daniel2809', 'lingyexie', 'donaldp97', 'thiosady', 'wshin765', 'mk7800797', 'mingxi', 'jahough', 'zihaoz', 'yang6086', 'oskar_radermecker', 'utzma006', 'jpj', 'timtoh168', 'sirraf1', 'armentasantiago', 'mgerba', 'jarga001', 'gagno094', 'apaulo', 'zib.summer', 'amcalear', 'leex8370', 'subuls', 'anewton4', 'royxx318', '11jazzyc', 'kianx006', 'thegaga', 'jagadishkarthikeya', 'myflash995', 'klonc003', 'zhou0868', 'mariano06', '20lnelson', 'gsakoda', 'drddragan', 'mlaszcz', 'ashton.bateman', 'adonadio', 'wille474', 'keech015', 'tuft0029', 'katherinecrawford', 'mendo172', 'liya_abraha', 'blui001', 'juliortegon', 'tosaleal', 'md.quintero', 'udstr005', 'nicho919', 'klung009', 'yang5123', 'jrosborne', 'pvd', 'jrpuerto', 'providedrailroad', 'scharles', 'chanshaomun', 'mariaddld', 'allisondong1995', 'sharm338', 'dinhtmh', 'ng000046', 'mendo123', 'ryellitz', 'jamer98', 'damic014', 'lbarber', 'levac004', 'camilo0869', 'jeisson1299', 'polinp0p0', 'whloganw', 'popkir', 'prusi009', 'wegex009', 'lautmusicmois', 'ad.gregory', 'qwertyacc1', 'liu.nathaniel', 'justsadler', 'poojarao75', 'erichu57023', 'saurabh96jun', 'wpiszker42', 'anderpensilva', 'ahender4', 'olso7126', 'cmkennedy', 'nebix006', 'kevinbernalru', 'mallika', 'solerjavier7', 'maximum136', 'mukon004', 'shreyasnaik', 'jkvaternik', 'mugnier', 'lkabraha1', 'gvaishnavi761', 'christina.ngo', 'maria.a.solano.otero', 'santiago.aine', 'bader11', 'anwar.iiserk', 'nicholast900', 'rachellyumi', 'whobby', 'gesex006', 'joedude15', 'sfhivo', 'lyde0037', 'lildoug1997', 'joh02339', 'p.j.grenz', 'hahasan09', None, 'andyz4', 'matthew.byrnes4852', 'shahnewaz01', 'naltemose89', 'salmo091', 'bthorgood3', 'emunguia', 'tvv', 'ykes2bige', 'georgeking159', 'zamri003', 'yyan818', 'kambo001', 'sitarsky', 'lomeligabriela88', 'tofer13', 'francis.marquez21', 'prigs2323', 'hagst077', 's.villamilp', 'pab272', 'kapla302', 'pvargas', 'bdester', 'iarasantelices', 'davide_asnaghi', 'aphauser', 'libardo11chapal', 'cmckenz2', 'gerva039', 'juanpbotero9897', 'sebas.villaba2002', 'mlfronk', 'tran0559', 'seabassparker', 'matildem', 'xinyiz', 'deboka', 'go_arvind', 'rmghannam', 'dang0134', 'prithiv_natarajan', 'dperry', 'wdurnan', 'parke867', 'v.cardonac1', 'arthur.alo', 'mtrudd97', 's.y.wang.sdu', 'conwe007', 'tguy', 'matthiashartl', 'nsimonian', 'nicolash025', 'leama008', 'chrisowen873', 'spred003', 'wang150', 'alva_liang', 'dixon347', 'tegan.anderes', 'kruss008', 'ssantia1', 'jaardila', 'inorman']"
3,149,166,78,72,"['robertramji', 'jdvilleg', 'makita', 'jmmmyy', 'a1wan', 'delrialmichael', 'kinuthgelmo', 'jfelderm', 'adamardigo', 'zhh063', 'ivarobb', 'wuzibei20', 'mfahrni', 'aardigo', 'bballerman26', 'jjhuang97', 'mmurguia', 'snfkrantk', 'mbautistalayton', 'gasuresh', 'yix002', 'dlakshmipathy', 'klw009', 'ktwon97', 'dscheah', 'gus4ofdiamonds', 'maxmin', 'jileet', 'y2zong', 'kcante', 'debrunner.edward', 'sjamnuch', 'wjablonski95', 'yic111', 'jmm036', 'ziw142', 'otrieu', 'erasmo127', 'hss008', 'sik023', 'mtbautistalayton', 'bsl012', 'yal216', 'yjgong', 'gusilun', 'j9wan', 'lewis_nick49', 'shemreb', 'carlsjr3', 'nplam', 'jleekay', 'ajg037', 'pwarren42', 'sydneykerr', 'bmarkey', 'kmhilby', 'rjarroyo', 'otrieu97', 'mcmuelle', 'btjhia', 'hwliu', 'liyanbiao2015', 'nigoel', 'snehdhruv', 'yohanns', 'ajs021', 'qizhangyan', 'q3yan', 'pfcarrol', 'jjhuangucsd', 'xil303', 'millerjennifer125']",93,"['traviskwon1', 'stuarts4', 'ikrobin', 'rana.phy.buet', 'lmk115', 'willy030054', 'shuvra.bhu', 'rjm325221', 'bjaswanth08', 'brlasdan', 'amahmoo3', 'appusingh94242', 'jwc137', 'asadncepc', 'delumeau', 'qizehui', 'kurtafus', 'bwing1', 'hemarajesh89', 'chayanh53', 'nibana', 'davesanchezp', 'kourosh.e.rahimi', 'rachel_wong', 'namjee.k', 'rmschoel', 'dmille84', 'mayurisri.63', 'tbrahmb1', 'xt.chen', 'haoge.sun', 'karanvish', 'leilakhalili87', 'jkumar.kld', 'abdulmoeez', 'mjregan2', 'postnicov', 'hitarthc64', 'mrlk22', 'wponder', 'pianassola', 'tangnan19911028', 'parkhj9065', 'rsherro3', 'yinxiang419', 'sloanart', 'kevinmoseni', 'kongjon3', 'patrickying', 'golam.bappi', 'ndgaffin', 'pmondal0402', 'aangelbe', 'salcorn', 'jcicotte', 'yangmeih1234', 'jehadabed', 'franklengers', 'voves', 'tatianebadaro', 'tiwarip3', 'mcneilr2', 'bendigha', 'tapascal', 'marcomontoya', 'mksatti11122122', 'anita93', 'lintegrity', 'qchen23', 'sreya27', 'kevinx0412', 'abdullahsaud', 'lyu19', 'mcothrine', 'mostafa.radwan', 'ahorton8', 'silverknight922', 'mikailsln', 'pabbasi', 'dryzhak2', 'joshuajones', 'aalfadhi', 'wshuxter', 'rishabh.guha', 'jbrookin', 'astoni_1', 'acain11', 'benjamin.kidston', 'daleg', 'xxia10', 'nachiketshah', 'jiaxing.huang', 'nishantbirdi95']",6,"['jtt039', 'katwongkatherine', 'todacp', 'brandonmarkey55', 'mdelrial212', None]",171,"['traviskwon1', 'stuarts4', 'ikrobin', 'rana.phy.buet', 'katwongkatherine', 'lmk115', 'adamardigo', 'brandonmarkey55', 'ivarobb', 'mdelrial212', 'rjm325221', 'shuvra.bhu', 'willy030054', 'bjaswanth08', 'gasuresh', 'yix002', 'brlasdan', 'amahmoo3', 'dscheah', 'y2zong', 'debrunner.edward', 'kcante', 'appusingh94242', 'jwc137', 'asadncepc', 'otrieu', 'hss008', 'mtbautistalayton', 'delumeau', 'qizehui', 'shemreb', 'carlsjr3', 'kurtafus', 'ajg037', 'kmhilby', 'bwing1', 'hemarajesh89', 'chayanh53', 'liyanbiao2015', 'qizhangyan', 'nibana', 'pfcarrol', 'jjhuangucsd', 'xil303', 'davesanchezp', 'millerjennifer125', 'kourosh.e.rahimi', 'rachel_wong', 'namjee.k', 'rmschoel', 'dmille84', 'mayurisri.63', 'tbrahmb1', 'delrialmichael', 'kinuthgelmo', 'xt.chen', 'wuzibei20', 'mmurguia', 'haoge.sun', 'mbautistalayton', 'karanvish', 'leilakhalili87', 'jkumar.kld', 'abdulmoeez', 'klw009', 'mjregan2', 'postnicov', 'gus4ofdiamonds', 'maxmin', 'hitarthc64', 'yic111', 'jmm036', 'ziw142', 'mrlk22', 'wponder', 'pianassola', 'bsl012', 'tangnan19911028', 'parkhj9065', 'gusilun', 'j9wan', 'rsherro3', 'yinxiang419', 'sloanart', 'sydneykerr', 'pwarren42', 'hwliu', 'yohanns', 'kevinmoseni', 'jdvilleg', 'kongjon3', 'jmmmyy', 'a1wan', 'jfelderm', 'zhh063', 'patrickying', 'golam.bappi', 'ndgaffin', 'bballerman26', 'aardigo', 'snfkrantk', 'sjamnuch', 'pmondal0402', 'wjablonski95', 'aangelbe', 'salcorn', 'jcicotte', 'yangmeih1234', 'jehadabed', 'sik023', 'yal216', 'nplam', 'franklengers', 'voves', 'tatianebadaro', 'tiwarip3', 'mcneilr2', 'bendigha', 'tapascal', 'marcomontoya', 'snehdhruv', 'mksatti11122122', 'rjarroyo', 'robertramji', 'makita', 'anita93', 'jtt039', 'lintegrity', 'qchen23', 'mfahrni', 'sreya27', 'jjhuang97', 'kevinx0412', 'abdullahsaud', 'lyu19', 'mcothrine', 'mostafa.radwan', 'dlakshmipathy', 'ahorton8', 'ktwon97', 'silverknight922', 'mikailsln', 'pabbasi', 'jileet', 'dryzhak2', 'joshuajones', 'aalfadhi', 'wshuxter', 'yjgong', 'lewis_nick49', 'rishabh.guha', None, 'jbrookin', 'jleekay', 'bmarkey', 'otrieu97', 'astoni_1', 'acain11', 'benjamin.kidston', 'mcmuelle', 'daleg', 'btjhia', 'todacp', 'xxia10', 'nachiketshah', 'nigoel', 'ajs021', 'q3yan', 'jiaxing.huang', 'erasmo127', 'nishantbirdi95']"
3,146,166,41,34,"['stuarts4', 'kongjon3', 'namjee.k', 'rachel_wong', 'anita93', 'lintegrity', 'xt.chen', 'patrickying', 'golam.bappi', 'rjm325221', 'abdullahsaud', 'kevinx0412', 'haoge.sun', 'karanvish', 'brlasdan', 'silverknight922', 'joshuajones', 'hitarthc64', 'mrlk22', 'jehadabed', 'yangmeih1234', 'wshuxter', 'delumeau', 'sloanart', 'tatianebadaro', 'tiwarip3', 'mcneilr2', 'hemarajesh89', 'benjamin.kidston', 'bendigha', 'daleg', 'marcomontoya', 'jiaxing.huang', 'davesanchezp']",131,"['traviskwon1', 'ikrobin', 'rana.phy.buet', 'lmk115', 'adamardigo', 'ivarobb', 'willy030054', 'shuvra.bhu', 'bjaswanth08', 'gasuresh', 'yix002', 'amahmoo3', 'dscheah', 'y2zong', 'kcante', 'debrunner.edward', 'appusingh94242', 'jwc137', 'asadncepc', 'otrieu', 'hss008', 'mtbautistalayton', 'qizehui', 'shemreb', 'carlsjr3', 'kurtafus', 'ajg037', 'kmhilby', 'bwing1', 'chayanh53', 'liyanbiao2015', 'qizhangyan', 'nibana', 'pfcarrol', 'jjhuangucsd', 'xil303', 'millerjennifer125', 'kourosh.e.rahimi', 'rmschoel', 'dmille84', 'mayurisri.63', 'tbrahmb1', 'delrialmichael', 'kinuthgelmo', 'wuzibei20', 'mmurguia', 'mbautistalayton', 'leilakhalili87', 'jkumar.kld', 'abdulmoeez', 'klw009', 'mjregan2', 'postnicov', 'gus4ofdiamonds', 'maxmin', 'yic111', 'jmm036', 'ziw142', 'wponder', 'pianassola', 'bsl012', 'tangnan19911028', 'parkhj9065', 'gusilun', 'j9wan', 'rsherro3', 'yinxiang419', 'sydneykerr', 'pwarren42', 'hwliu', 'yohanns', 'kevinmoseni', 'jdvilleg', 'jmmmyy', 'a1wan', 'jfelderm', 'zhh063', 'ndgaffin', 'bballerman26', 'aardigo', 'snfkrantk', 'sjamnuch', 'pmondal0402', 'wjablonski95', 'aangelbe', 'salcorn', 'jcicotte', 'sik023', 'yal216', 'nplam', 'franklengers', 'voves', 'tapascal', 'snehdhruv', 'mksatti11122122', 'rjarroyo', 'robertramji', 'makita', 'qchen23', 'mfahrni', 'sreya27', 'jjhuang97', 'lyu19', 'mcothrine', 'mostafa.radwan', 'dlakshmipathy', 'ahorton8', 'ktwon97', 'mikailsln', 'pabbasi', 'jileet', 'dryzhak2', 'aalfadhi', 'yjgong', 'lewis_nick49', 'rishabh.guha', 'jbrookin', 'jleekay', 'bmarkey', 'otrieu97', 'astoni_1', 'acain11', 'mcmuelle', 'btjhia', 'xxia10', 'nachiketshah', 'nigoel', 'ajs021', 'q3yan', 'erasmo127', 'nishantbirdi95']",7,"['abuanand', 'rjw2018', 'edy', 'emmastorimans', 'pranays', None, 'anhnguyen']",172,"['traviskwon1', 'stuarts4', 'ikrobin', 'rana.phy.buet', 'emmastorimans', 'lmk115', 'adamardigo', 'ivarobb', 'rjm325221', 'shuvra.bhu', 'willy030054', 'bjaswanth08', 'gasuresh', 'yix002', 'brlasdan', 'amahmoo3', 'dscheah', 'y2zong', 'debrunner.edward', 'kcante', 'anhnguyen', 'appusingh94242', 'jwc137', 'asadncepc', 'otrieu', 'hss008', 'mtbautistalayton', 'delumeau', 'qizehui', 'shemreb', 'carlsjr3', 'kurtafus', 'ajg037', 'rjw2018', 'kmhilby', 'bwing1', 'hemarajesh89', 'chayanh53', 'liyanbiao2015', 'qizhangyan', 'nibana', 'pfcarrol', 'jjhuangucsd', 'xil303', 'davesanchezp', 'millerjennifer125', 'kourosh.e.rahimi', 'rachel_wong', 'namjee.k', 'rmschoel', 'dmille84', 'edy', 'mayurisri.63', 'tbrahmb1', 'delrialmichael', 'kinuthgelmo', 'xt.chen', 'wuzibei20', 'mmurguia', 'haoge.sun', 'mbautistalayton', 'karanvish', 'leilakhalili87', 'jkumar.kld', 'abdulmoeez', 'klw009', 'mjregan2', 'postnicov', 'gus4ofdiamonds', 'maxmin', 'hitarthc64', 'yic111', 'jmm036', 'ziw142', 'mrlk22', 'wponder', 'pranays', 'pianassola', 'bsl012', 'tangnan19911028', 'parkhj9065', 'gusilun', 'j9wan', 'rsherro3', 'yinxiang419', 'sloanart', 'sydneykerr', 'pwarren42', 'hwliu', 'yohanns', 'kevinmoseni', 'jdvilleg', 'kongjon3', 'jmmmyy', 'a1wan', 'jfelderm', 'zhh063', 'patrickying', 'golam.bappi', 'ndgaffin', 'bballerman26', 'aardigo', 'snfkrantk', 'sjamnuch', 'pmondal0402', 'wjablonski95', 'abuanand', 'aangelbe', 'salcorn', 'jcicotte', 'yangmeih1234', 'jehadabed', 'sik023', 'yal216', 'nplam', 'franklengers', 'voves', 'tatianebadaro', 'tiwarip3', 'mcneilr2', 'bendigha', 'tapascal', 'marcomontoya', 'snehdhruv', 'mksatti11122122', 'rjarroyo', 'robertramji', 'makita', 'anita93', 'lintegrity', 'qchen23', 'mfahrni', 'sreya27', 'jjhuang97', 'kevinx0412', 'abdullahsaud', 'lyu19', 'mcothrine', 'mostafa.radwan', 'dlakshmipathy', 'ahorton8', 'ktwon97', 'silverknight922', 'mikailsln', 'pabbasi', 'jileet', 'dryzhak2', 'joshuajones', 'aalfadhi', 'wshuxter', 'yjgong', 'lewis_nick49', 'rishabh.guha', None, 'jbrookin', 'jleekay', 'bmarkey', 'otrieu97', 'astoni_1', 'acain11', 'benjamin.kidston', 'mcmuelle', 'daleg', 'btjhia', 'xxia10', 'nachiketshah', 'nigoel', 'ajs021', 'q3yan', 'jiaxing.huang', 'erasmo127', 'nishantbirdi95']"
3,144,166,25,24,"['ikrobin', 'dmille84', 'tbrahmb1', 'qchen23', 'sreya27', 'ndgaffin', 'lyu19', 'mcothrine', 'bjaswanth08', 'ahorton8', 'dryzhak2', 'aalfadhi', 'salcorn', 'jcicotte', 'wponder', 'pianassola', 'tangnan19911028', 'parkhj9065', 'qizehui', 'jbrookin', 'kurtafus', 'astoni_1', 'acain11', 'bwing1']",141,"['traviskwon1', 'stuarts4', 'rana.phy.buet', 'lmk115', 'adamardigo', 'ivarobb', 'rjm325221', 'shuvra.bhu', 'willy030054', 'gasuresh', 'yix002', 'brlasdan', 'amahmoo3', 'dscheah', 'y2zong', 'debrunner.edward', 'kcante', 'appusingh94242', 'jwc137', 'asadncepc', 'otrieu', 'hss008', 'mtbautistalayton', 'delumeau', 'shemreb', 'carlsjr3', 'ajg037', 'kmhilby', 'hemarajesh89', 'chayanh53', 'liyanbiao2015', 'qizhangyan', 'nibana', 'pfcarrol', 'jjhuangucsd', 'xil303', 'davesanchezp', 'millerjennifer125', 'kourosh.e.rahimi', 'rachel_wong', 'namjee.k', 'rmschoel', 'mayurisri.63', 'delrialmichael', 'kinuthgelmo', 'xt.chen', 'wuzibei20', 'mmurguia', 'haoge.sun', 'mbautistalayton', 'karanvish', 'leilakhalili87', 'jkumar.kld', 'abdulmoeez', 'klw009', 'mjregan2', 'postnicov', 'gus4ofdiamonds', 'maxmin', 'hitarthc64', 'yic111', 'jmm036', 'ziw142', 'mrlk22', 'bsl012', 'gusilun', 'j9wan', 'rsherro3', 'yinxiang419', 'sloanart', 'sydneykerr', 'pwarren42', 'hwliu', 'yohanns', 'kevinmoseni', 'jdvilleg', 'kongjon3', 'jmmmyy', 'a1wan', 'jfelderm', 'zhh063', 'patrickying', 'golam.bappi', 'bballerman26', 'aardigo', 'snfkrantk', 'sjamnuch', 'pmondal0402', 'wjablonski95', 'aangelbe', 'yangmeih1234', 'jehadabed', 'sik023', 'yal216', 'nplam', 'franklengers', 'voves', 'tatianebadaro', 'tiwarip3', 'mcneilr2', 'bendigha', 'tapascal', 'marcomontoya', 'snehdhruv', 'mksatti11122122', 'rjarroyo', 'robertramji', 'makita', 'anita93', 'lintegrity', 'mfahrni', 'jjhuang97', 'kevinx0412', 'abdullahsaud', 'mostafa.radwan', 'dlakshmipathy', 'ktwon97', 'silverknight922', 'mikailsln', 'pabbasi', 'jileet', 'joshuajones', 'wshuxter', 'yjgong', 'lewis_nick49', 'rishabh.guha', 'jleekay', 'bmarkey', 'otrieu97', 'benjamin.kidston', 'mcmuelle', 'daleg', 'btjhia', 'xxia10', 'nachiketshah', 'nigoel', 'ajs021', 'q3yan', 'jiaxing.huang', 'erasmo127', 'nishantbirdi95']",1,[None],166,"['traviskwon1', 'stuarts4', 'ikrobin', 'rana.phy.buet', 'lmk115', 'adamardigo', 'ivarobb', 'rjm325221', 'shuvra.bhu', 'willy030054', 'bjaswanth08', 'gasuresh', 'yix002', 'brlasdan', 'amahmoo3', 'dscheah', 'y2zong', 'debrunner.edward', 'kcante', 'appusingh94242', 'jwc137', 'asadncepc', 'otrieu', 'hss008', 'mtbautistalayton', 'delumeau', 'qizehui', 'shemreb', 'carlsjr3', 'kurtafus', 'ajg037', 'kmhilby', 'bwing1', 'hemarajesh89', 'chayanh53', 'liyanbiao2015', 'qizhangyan', 'nibana', 'pfcarrol', 'jjhuangucsd', 'xil303', 'davesanchezp', 'millerjennifer125', 'kourosh.e.rahimi', 'rachel_wong', 'namjee.k', 'rmschoel', 'dmille84', 'mayurisri.63', 'tbrahmb1', 'delrialmichael', 'kinuthgelmo', 'xt.chen', 'wuzibei20', 'mmurguia', 'haoge.sun', 'mbautistalayton', 'karanvish', 'leilakhalili87', 'jkumar.kld', 'abdulmoeez', 'klw009', 'mjregan2', 'postnicov', 'gus4ofdiamonds', 'maxmin', 'hitarthc64', 'yic111', 'jmm036', 'ziw142', 'mrlk22', 'wponder', 'pianassola', 'bsl012', 'tangnan19911028', 'parkhj9065', 'gusilun', 'j9wan', 'rsherro3', 'yinxiang419', 'sloanart', 'sydneykerr', 'pwarren42', 'hwliu', 'yohanns', 'kevinmoseni', 'jdvilleg', 'kongjon3', 'jmmmyy', 'a1wan', 'jfelderm', 'zhh063', 'patrickying', 'golam.bappi', 'ndgaffin', 'bballerman26', 'aardigo', 'snfkrantk', 'sjamnuch', 'pmondal0402', 'wjablonski95', 'aangelbe', 'salcorn', 'jcicotte', 'yangmeih1234', 'jehadabed', 'sik023', 'yal216', 'nplam', 'franklengers', 'voves', 'tatianebadaro', 'tiwarip3', 'mcneilr2', 'bendigha', 'tapascal', 'marcomontoya', 'snehdhruv', 'mksatti11122122', 'rjarroyo', 'robertramji', 'makita', 'anita93', 'lintegrity', 'qchen23', 'mfahrni', 'sreya27', 'jjhuang97', 'kevinx0412', 'abdullahsaud', 'lyu19', 'mcothrine', 'mostafa.radwan', 'dlakshmipathy', 'ahorton8', 'ktwon97', 'silverknight922', 'mikailsln', 'pabbasi', 'jileet', 'dryzhak2', 'joshuajones', 'aalfadhi', 'wshuxter', 'yjgong', 'lewis_nick49', 'rishabh.guha', None, 'jbrookin', 'jleekay', 'bmarkey', 'otrieu97', 'astoni_1', 'acain11', 'benjamin.kidston', 'mcmuelle', 'daleg', 'btjhia', 'xxia10', 'nachiketshah', 'nigoel', 'ajs021', 'q3yan', 'jiaxing.huang', 'erasmo127', 'nishantbirdi95']"
3,148,166,21,6,"['rmschoel', 'leilakhalili87', 'mostafa.radwan', 'amahmoo3', 'mjregan2', 'rishabh.guha']",159,"['traviskwon1', 'stuarts4', 'ikrobin', 'rana.phy.buet', 'lmk115', 'adamardigo', 'ivarobb', 'rjm325221', 'shuvra.bhu', 'willy030054', 'bjaswanth08', 'gasuresh', 'yix002', 'brlasdan', 'dscheah', 'y2zong', 'debrunner.edward', 'kcante', 'appusingh94242', 'jwc137', 'asadncepc', 'otrieu', 'hss008', 'mtbautistalayton', 'delumeau', 'qizehui', 'shemreb', 'carlsjr3', 'kurtafus', 'ajg037', 'kmhilby', 'bwing1', 'hemarajesh89', 'chayanh53', 'liyanbiao2015', 'qizhangyan', 'nibana', 'pfcarrol', 'jjhuangucsd', 'xil303', 'davesanchezp', 'millerjennifer125', 'kourosh.e.rahimi', 'rachel_wong', 'namjee.k', 'dmille84', 'mayurisri.63', 'tbrahmb1', 'delrialmichael', 'kinuthgelmo', 'xt.chen', 'wuzibei20', 'mmurguia', 'haoge.sun', 'mbautistalayton', 'karanvish', 'jkumar.kld', 'abdulmoeez', 'klw009', 'postnicov', 'gus4ofdiamonds', 'maxmin', 'hitarthc64', 'yic111', 'jmm036', 'ziw142', 'mrlk22', 'wponder', 'pianassola', 'bsl012', 'tangnan19911028', 'parkhj9065', 'gusilun', 'j9wan', 'rsherro3', 'yinxiang419', 'sloanart', 'sydneykerr', 'pwarren42', 'hwliu', 'yohanns', 'kevinmoseni', 'jdvilleg', 'kongjon3', 'jmmmyy', 'a1wan', 'jfelderm', 'zhh063', 'patrickying', 'golam.bappi', 'ndgaffin', 'bballerman26', 'aardigo', 'snfkrantk', 'sjamnuch', 'pmondal0402', 'wjablonski95', 'aangelbe', 'salcorn', 'jcicotte', 'yangmeih1234', 'jehadabed', 'sik023', 'yal216', 'nplam', 'franklengers', 'voves', 'tatianebadaro', 'tiwarip3', 'mcneilr2', 'bendigha', 'tapascal', 'marcomontoya', 'snehdhruv', 'mksatti11122122', 'rjarroyo', 'robertramji', 'makita', 'anita93', 'lintegrity', 'qchen23', 'mfahrni', 'sreya27', 'jjhuang97', 'kevinx0412', 'abdullahsaud', 'lyu19', 'mcothrine', 'dlakshmipathy', 'ahorton8', 'ktwon97', 'silverknight922', 'mikailsln', 'pabbasi', 'jileet', 'dryzhak2', 'joshuajones', 'aalfadhi', 'wshuxter', 'yjgong', 'lewis_nick49', 'jbrookin', 'jleekay', 'bmarkey', 'otrieu97', 'astoni_1', 'acain11', 'benjamin.kidston', 'mcmuelle', 'daleg', 'btjhia', 'xxia10', 'nachiketshah', 'nigoel', 'ajs021', 'q3yan', 'jiaxing.huang', 'erasmo127', 'nishantbirdi95']",15,"['sierrami', 'ygyingli', 'zeinabsmadi93', 'mgao4', 'cwmeeks', 'kjkronk', 'hyuqing', 'babegley', 'tshasan', 'mhelbadr', 'ltnuke', 'schoell.2', 'sgupta32', None, 'zdrussell55']",180,"['traviskwon1', 'stuarts4', 'ikrobin', 'rana.phy.buet', 'lmk115', 'adamardigo', 'ivarobb', 'rjm325221', 'shuvra.bhu', 'willy030054', 'bjaswanth08', 'gasuresh', 'cwmeeks', 'yix002', 'brlasdan', 'amahmoo3', 'dscheah', 'sgupta32', 'y2zong', 'debrunner.edward', 'kcante', 'appusingh94242', 'jwc137', 'asadncepc', 'otrieu', 'hss008', 'mtbautistalayton', 'schoell.2', 'delumeau', 'qizehui', 'shemreb', 'carlsjr3', 'zdrussell55', 'kurtafus', 'ajg037', 'kmhilby', 'bwing1', 'hemarajesh89', 'chayanh53', 'tshasan', 'liyanbiao2015', 'qizhangyan', 'nibana', 'pfcarrol', 'jjhuangucsd', 'xil303', 'davesanchezp', 'millerjennifer125', 'kourosh.e.rahimi', 'sierrami', 'rachel_wong', 'namjee.k', 'rmschoel', 'dmille84', 'mayurisri.63', 'tbrahmb1', 'delrialmichael', 'kinuthgelmo', 'xt.chen', 'wuzibei20', 'mmurguia', 'haoge.sun', 'mbautistalayton', 'karanvish', 'leilakhalili87', 'jkumar.kld', 'abdulmoeez', 'klw009', 'mjregan2', 'postnicov', 'gus4ofdiamonds', 'maxmin', 'hitarthc64', 'yic111', 'jmm036', 'zeinabsmadi93', 'ziw142', 'mrlk22', 'wponder', 'pianassola', 'bsl012', 'tangnan19911028', 'parkhj9065', 'gusilun', 'j9wan', 'rsherro3', 'yinxiang419', 'sloanart', 'sydneykerr', 'pwarren42', 'kjkronk', 'babegley', 'hwliu', 'yohanns', 'kevinmoseni', 'jdvilleg', 'kongjon3', 'hyuqing', 'jmmmyy', 'a1wan', 'jfelderm', 'zhh063', 'patrickying', 'golam.bappi', 'ndgaffin', 'bballerman26', 'aardigo', 'snfkrantk', 'sjamnuch', 'pmondal0402', 'wjablonski95', 'aangelbe', 'salcorn', 'jcicotte', 'yangmeih1234', 'jehadabed', 'sik023', 'yal216', 'nplam', 'franklengers', 'voves', 'tatianebadaro', 'tiwarip3', 'mcneilr2', 'bendigha', 'tapascal', 'marcomontoya', 'snehdhruv', 'mksatti11122122', 'rjarroyo', 'robertramji', 'makita', 'anita93', 'lintegrity', 'qchen23', 'mfahrni', 'sreya27', 'jjhuang97', 'kevinx0412', 'abdullahsaud', 'lyu19', 'mcothrine', 'mostafa.radwan', 'dlakshmipathy', 'ahorton8', 'ktwon97', 'silverknight922', 'mikailsln', 'ltnuke', 'pabbasi', 'jileet', 'dryzhak2', 'joshuajones', 'ygyingli', 'aalfadhi', 'mgao4', 'wshuxter', 'mhelbadr', 'yjgong', 'lewis_nick49', 'rishabh.guha', None, 'jbrookin', 'jleekay', 'bmarkey', 'otrieu97', 'astoni_1', 'acain11', 'benjamin.kidston', 'mcmuelle', 'daleg', 'btjhia', 'xxia10', 'nachiketshah', 'nigoel', 'ajs021', 'q3yan', 'jiaxing.huang', 'erasmo127', 'nishantbirdi95']"
3,147,166,9,8,"['lyu19', 'aalfadhi', 'bjaswanth08', 'salcorn', 'astoni_1', 'tangnan19911028', 'sreya27', 'rsherro3']",157,"['traviskwon1', 'stuarts4', 'ikrobin', 'rana.phy.buet', 'lmk115', 'adamardigo', 'ivarobb', 'rjm325221', 'shuvra.bhu', 'willy030054', 'gasuresh', 'yix002', 'brlasdan', 'amahmoo3', 'dscheah', 'y2zong', 'debrunner.edward', 'kcante', 'appusingh94242', 'jwc137', 'asadncepc', 'otrieu', 'hss008', 'mtbautistalayton', 'delumeau', 'qizehui', 'shemreb', 'carlsjr3', 'kurtafus', 'ajg037', 'kmhilby', 'bwing1', 'hemarajesh89', 'chayanh53', 'liyanbiao2015', 'qizhangyan', 'nibana', 'pfcarrol', 'jjhuangucsd', 'xil303', 'davesanchezp', 'millerjennifer125', 'kourosh.e.rahimi', 'rachel_wong', 'namjee.k', 'rmschoel', 'dmille84', 'mayurisri.63', 'tbrahmb1', 'delrialmichael', 'kinuthgelmo', 'xt.chen', 'wuzibei20', 'mmurguia', 'haoge.sun', 'mbautistalayton', 'karanvish', 'leilakhalili87', 'jkumar.kld', 'abdulmoeez', 'klw009', 'mjregan2', 'postnicov', 'gus4ofdiamonds', 'maxmin', 'hitarthc64', 'yic111', 'jmm036', 'ziw142', 'mrlk22', 'wponder', 'pianassola', 'bsl012', 'parkhj9065', 'gusilun', 'j9wan', 'yinxiang419', 'sloanart', 'sydneykerr', 'pwarren42', 'hwliu', 'yohanns', 'kevinmoseni', 'jdvilleg', 'kongjon3', 'jmmmyy', 'a1wan', 'jfelderm', 'zhh063', 'patrickying', 'golam.bappi', 'ndgaffin', 'bballerman26', 'aardigo', 'snfkrantk', 'sjamnuch', 'pmondal0402', 'wjablonski95', 'aangelbe', 'jcicotte', 'yangmeih1234', 'jehadabed', 'sik023', 'yal216', 'nplam', 'franklengers', 'voves', 'tatianebadaro', 'tiwarip3', 'mcneilr2', 'bendigha', 'tapascal', 'marcomontoya', 'snehdhruv', 'mksatti11122122', 'rjarroyo', 'robertramji', 'makita', 'anita93', 'lintegrity', 'qchen23', 'mfahrni', 'jjhuang97', 'kevinx0412', 'abdullahsaud', 'mcothrine', 'mostafa.radwan', 'dlakshmipathy', 'ahorton8', 'ktwon97', 'silverknight922', 'mikailsln', 'pabbasi', 'jileet', 'dryzhak2', 'joshuajones', 'wshuxter', 'yjgong', 'lewis_nick49', 'rishabh.guha', 'jbrookin', 'jleekay', 'bmarkey', 'otrieu97', 'acain11', 'benjamin.kidston', 'mcmuelle', 'daleg', 'btjhia', 'xxia10', 'nachiketshah', 'nigoel', 'ajs021', 'q3yan', 'jiaxing.huang', 'erasmo127', 'nishantbirdi95']",1,[None],166,"['traviskwon1', 'stuarts4', 'ikrobin', 'rana.phy.buet', 'lmk115', 'adamardigo', 'ivarobb', 'rjm325221', 'shuvra.bhu', 'willy030054', 'bjaswanth08', 'gasuresh', 'yix002', 'brlasdan', 'amahmoo3', 'dscheah', 'y2zong', 'debrunner.edward', 'kcante', 'appusingh94242', 'jwc137', 'asadncepc', 'otrieu', 'hss008', 'mtbautistalayton', 'delumeau', 'qizehui', 'shemreb', 'carlsjr3', 'kurtafus', 'ajg037', 'kmhilby', 'bwing1', 'hemarajesh89', 'chayanh53', 'liyanbiao2015', 'qizhangyan', 'nibana', 'pfcarrol', 'jjhuangucsd', 'xil303', 'davesanchezp', 'millerjennifer125', 'kourosh.e.rahimi', 'rachel_wong', 'namjee.k', 'rmschoel', 'dmille84', 'mayurisri.63', 'tbrahmb1', 'delrialmichael', 'kinuthgelmo', 'xt.chen', 'wuzibei20', 'mmurguia', 'haoge.sun', 'mbautistalayton', 'karanvish', 'leilakhalili87', 'jkumar.kld', 'abdulmoeez', 'klw009', 'mjregan2', 'postnicov', 'gus4ofdiamonds', 'maxmin', 'hitarthc64', 'yic111', 'jmm036', 'ziw142', 'mrlk22', 'wponder', 'pianassola', 'bsl012', 'tangnan19911028', 'parkhj9065', 'gusilun', 'j9wan', 'rsherro3', 'yinxiang419', 'sloanart', 'sydneykerr', 'pwarren42', 'hwliu', 'yohanns', 'kevinmoseni', 'jdvilleg', 'kongjon3', 'jmmmyy', 'a1wan', 'jfelderm', 'zhh063', 'patrickying', 'golam.bappi', 'ndgaffin', 'bballerman26', 'aardigo', 'snfkrantk', 'sjamnuch', 'pmondal0402', 'wjablonski95', 'aangelbe', 'salcorn', 'jcicotte', 'yangmeih1234', 'jehadabed', 'sik023', 'yal216', 'nplam', 'franklengers', 'voves', 'tatianebadaro', 'tiwarip3', 'mcneilr2', 'bendigha', 'tapascal', 'marcomontoya', 'snehdhruv', 'mksatti11122122', 'rjarroyo', 'robertramji', 'makita', 'anita93', 'lintegrity', 'qchen23', 'mfahrni', 'sreya27', 'jjhuang97', 'kevinx0412', 'abdullahsaud', 'lyu19', 'mcothrine', 'mostafa.radwan', 'dlakshmipathy', 'ahorton8', 'ktwon97', 'silverknight922', 'mikailsln', 'pabbasi', 'jileet', 'dryzhak2', 'joshuajones', 'aalfadhi', 'wshuxter', 'yjgong', 'lewis_nick49', 'rishabh.guha', None, 'jbrookin', 'jleekay', 'bmarkey', 'otrieu97', 'astoni_1', 'acain11', 'benjamin.kidston', 'mcmuelle', 'daleg', 'btjhia', 'xxia10', 'nachiketshah', 'nigoel', 'ajs021', 'q3yan', 'jiaxing.huang', 'erasmo127', 'nishantbirdi95']"
3,105,166,7,3,"['jiaxing.huang', 'anita93', 'rjm325221']",162,"['traviskwon1', 'stuarts4', 'ikrobin', 'rana.phy.buet', 'lmk115', 'adamardigo', 'ivarobb', 'shuvra.bhu', 'willy030054', 'bjaswanth08', 'gasuresh', 'yix002', 'brlasdan', 'amahmoo3', 'dscheah', 'y2zong', 'debrunner.edward', 'kcante', 'appusingh94242', 'jwc137', 'asadncepc', 'otrieu', 'hss008', 'mtbautistalayton', 'delumeau', 'qizehui', 'shemreb', 'carlsjr3', 'kurtafus', 'ajg037', 'kmhilby', 'bwing1', 'hemarajesh89', 'chayanh53', 'liyanbiao2015', 'qizhangyan', 'nibana', 'pfcarrol', 'jjhuangucsd', 'xil303', 'davesanchezp', 'millerjennifer125', 'kourosh.e.rahimi', 'rachel_wong', 'namjee.k', 'rmschoel', 'dmille84', 'mayurisri.63', 'tbrahmb1', 'delrialmichael', 'kinuthgelmo', 'xt.chen', 'wuzibei20', 'mmurguia', 'haoge.sun', 'mbautistalayton', 'karanvish', 'leilakhalili87', 'jkumar.kld', 'abdulmoeez', 'klw009', 'mjregan2', 'postnicov', 'gus4ofdiamonds', 'maxmin', 'hitarthc64', 'yic111', 'jmm036', 'ziw142', 'mrlk22', 'wponder', 'pianassola', 'bsl012', 'tangnan19911028', 'parkhj9065', 'gusilun', 'j9wan', 'rsherro3', 'yinxiang419', 'sloanart', 'sydneykerr', 'pwarren42', 'hwliu', 'yohanns', 'kevinmoseni', 'jdvilleg', 'kongjon3', 'jmmmyy', 'a1wan', 'jfelderm', 'zhh063', 'patrickying', 'golam.bappi', 'ndgaffin', 'bballerman26', 'aardigo', 'snfkrantk', 'sjamnuch', 'pmondal0402', 'wjablonski95', 'aangelbe', 'salcorn', 'jcicotte', 'yangmeih1234', 'jehadabed', 'sik023', 'yal216', 'nplam', 'franklengers', 'voves', 'tatianebadaro', 'tiwarip3', 'mcneilr2', 'bendigha', 'tapascal', 'marcomontoya', 'snehdhruv', 'mksatti11122122', 'rjarroyo', 'robertramji', 'makita', 'lintegrity', 'qchen23', 'mfahrni', 'sreya27', 'jjhuang97', 'kevinx0412', 'abdullahsaud', 'lyu19', 'mcothrine', 'mostafa.radwan', 'dlakshmipathy', 'ahorton8', 'ktwon97', 'silverknight922', 'mikailsln', 'pabbasi', 'jileet', 'dryzhak2', 'joshuajones', 'aalfadhi', 'wshuxter', 'yjgong', 'lewis_nick49', 'rishabh.guha', 'jbrookin', 'jleekay', 'bmarkey', 'otrieu97', 'astoni_1', 'acain11', 'benjamin.kidston', 'mcmuelle', 'daleg', 'btjhia', 'xxia10', 'nachiketshah', 'nigoel', 'ajs021', 'q3yan', 'erasmo127', 'nishantbirdi95']",4,"['edy', None, 'rjw2018', 'anhnguyen']",169,"['traviskwon1', 'stuarts4', 'ikrobin', 'rana.phy.buet', 'lmk115', 'adamardigo', 'ivarobb', 'rjm325221', 'shuvra.bhu', 'willy030054', 'bjaswanth08', 'gasuresh', 'yix002', 'brlasdan', 'amahmoo3', 'dscheah', 'y2zong', 'debrunner.edward', 'kcante', 'anhnguyen', 'appusingh94242', 'jwc137', 'asadncepc', 'otrieu', 'hss008', 'mtbautistalayton', 'delumeau', 'qizehui', 'shemreb', 'carlsjr3', 'kurtafus', 'ajg037', 'rjw2018', 'kmhilby', 'bwing1', 'hemarajesh89', 'chayanh53', 'liyanbiao2015', 'qizhangyan', 'nibana', 'pfcarrol', 'jjhuangucsd', 'xil303', 'davesanchezp', 'millerjennifer125', 'kourosh.e.rahimi', 'rachel_wong', 'namjee.k', 'rmschoel', 'dmille84', 'edy', 'mayurisri.63', 'tbrahmb1', 'delrialmichael', 'kinuthgelmo', 'xt.chen', 'wuzibei20', 'mmurguia', 'haoge.sun', 'mbautistalayton', 'karanvish', 'leilakhalili87', 'jkumar.kld', 'abdulmoeez', 'klw009', 'mjregan2', 'postnicov', 'gus4ofdiamonds', 'maxmin', 'hitarthc64', 'yic111', 'jmm036', 'ziw142', 'mrlk22', 'wponder', 'pianassola', 'bsl012', 'tangnan19911028', 'parkhj9065', 'gusilun', 'j9wan', 'rsherro3', 'yinxiang419', 'sloanart', 'sydneykerr', 'pwarren42', 'hwliu', 'yohanns', 'kevinmoseni', 'jdvilleg', 'kongjon3', 'jmmmyy', 'a1wan', 'jfelderm', 'zhh063', 'patrickying', 'golam.bappi', 'ndgaffin', 'bballerman26', 'aardigo', 'snfkrantk', 'sjamnuch', 'pmondal0402', 'wjablonski95', 'aangelbe', 'salcorn', 'jcicotte', 'yangmeih1234', 'jehadabed', 'sik023', 'yal216', 'nplam', 'franklengers', 'voves', 'tatianebadaro', 'tiwarip3', 'mcneilr2', 'bendigha', 'tapascal', 'marcomontoya', 'snehdhruv', 'mksatti11122122', 'rjarroyo', 'robertramji', 'makita', 'anita93', 'lintegrity', 'qchen23', 'mfahrni', 'sreya27', 'jjhuang97', 'kevinx0412', 'abdullahsaud', 'lyu19', 'mcothrine', 'mostafa.radwan', 'dlakshmipathy', 'ahorton8', 'ktwon97', 'silverknight922', 'mikailsln', 'pabbasi', 'jileet', 'dryzhak2', 'joshuajones', 'aalfadhi', 'wshuxter', 'yjgong', 'lewis_nick49', 'rishabh.guha', None, 'jbrookin', 'jleekay', 'bmarkey', 'otrieu97', 'astoni_1', 'acain11', 'benjamin.kidston', 'mcmuelle', 'daleg', 'btjhia', 'xxia10', 'nachiketshah', 'nigoel', 'ajs021', 'q3yan', 'jiaxing.huang', 'erasmo127', 'nishantbirdi95']"
4,343,111,60,36,"['deepanshu.koshta', 'ds1621pc', 'tanmayg890', 'siddharthmaniar99', 'aniruddh', 'pragatimeshram30', 'vaidehipatil', 'ritizsaini', 'aryanlall53', 'siddharthsh2', 'prajwalbarapatre13', 'mundrayagya1', 'rishabhdahale', 'adityakhanna1999', 'kdbeatbox', 'hellblazer', 'riteshsadwik', 'prashantkurrey61520', 'yashmandharerl', 'harshdolhare99', 'jaideep', 'etcherla.harshavardhan3', 'sayedzuzair', 'parasbodke', 'phsysaicms', 'bhalodeutu', 'mihir.kavishwar710', 'goelripul999', 'anubhavgoel026', 'sshailee270', 'namannarang', 'patel.prajval1', 'agarwal.aishwarya2013', 'kushalpatil07', 'sakethchandra', 'madhurs']",74,"['esranurcengiz43', 'dogukaninci93', 'onuur', 'erhan_1996', 'dadaskral', 'muhammedaliuzun1998', 'anilkiziltas', 'exploit4', 'yewu', 'ulkubarut', 'ozgurdenizkozan', 'jorik.waeterschoot', 'aycaduman', 'haticesari333333', 'oakbulut1997', 'moze', 'muratlevent', 'evrenyigit', 'samet1231234', 'hasanaltintas', 'ilkaydost', 'enizcelik', '1903setoo', 'nadim.chow', 'emreycanc', 'jsmahesh.iitb', 'burcuukoksal', 'daijiejian', 'ronal_denho_931', 'nanohubpnesogu', 'aylinyildiz968', 'azalomar', 'senanurcetin96', 'methemfaik', 'emre_krtn97', 'glps.ozdmr', 'cihanbuyuknacar', 'kocamuha', 'timpe005', 'davuteee', 'herzkim', 'yilmazemine855', 'ig', 'nc_ionutz', 'mayazli97', 'cri95', 'mustafaerdurann', 'irfancakmaz', 'aarondfranklin', 'safiyemermer', 'timmons.luke', 'lever', 'rafshezani', 'orcun_bakkal', 'metehanmustafayalcin', 'batuhanuslu', 'sonalkumar199842', 'aviss', 'malhotra.divyesha', 'ahmetdundar', 'salihyanikgonul', 'pinarg.225', 'octonionstar', 'pradeep264', 'ercannmutlu', 'zubeydekal37', 'c.schumann', 'aleksandra02', 'fatih.yorgun', 'mmert.bacak', 'osmankaplanci_01', 'ckadircaner', 'wubbbiz', 'murat_lani']",24,"['methi1999', 'adil456', 'agarwalanubhav.2011', 'tarunatsamadder', 'prachigoel2511', 'manasv09', 'surya99', 'bjsmahesh', 'sudhanshu.an', 'deviljokerkaran', 'divyansh001', 'sakshee.pimpale', 'jeetika2000singla', 'anirudh31', 'shivamagarwal0240', None, 'shivani_vn', 'ayushrajmehrotra.11', 'karan_chate', 'meshramrishikesh1206', 'sumritg267', 'rathodhare', 'prajwaldkamble', 'nitish_21']",134,"['deepanshu.koshta', 'dogukaninci93', 'agarwalanubhav.2011', 'ozgurdenizkozan', 'aniruddh', 'pragatimeshram30', 'ritizsaini', 'mundrayagya1', 'manasv09', 'surya99', 'hellblazer', 'riteshsadwik', 'kocamuha', 'cihanbuyuknacar', 'yilmazemine855', 'bhalodeutu', 'cri95', 'mustafaerdurann', 'mihir.kavishwar710', 'shivamagarwal0240', 'shivani_vn', 'aviss', 'ayushrajmehrotra.11', 'namannarang', 'kushalpatil07', 'aleksandra02', 'nitish_21', 'fatih.yorgun', 'mmert.bacak', 'murat_lani', 'esranurcengiz43', 'tanmayg890', 'onuur', 'erhan_1996', 'dadaskral', 'methi1999', 'ulkubarut', 'jorik.waeterschoot', 'haticesari333333', 'oakbulut1997', 'evrenyigit', 'samet1231234', 'aryanlall53', 'hasanaltintas', 'ilkaydost', 'enizcelik', 'nadim.chow', 'emreycanc', 'daijiejian', 'rishabhdahale', 'azalomar', 'senanurcetin96', 'glps.ozdmr', 'yashmandharerl', 'jaideep', 'ig', 'sayedzuzair', 'irfancakmaz', 'lever', 'rafshezani', 'orcun_bakkal', 'metehanmustafayalcin', 'malhotra.divyesha', 'karan_chate', 'sshailee270', 'agarwal.aishwarya2013', 'salihyanikgonul', 'ckadircaner', 'aycaduman', 'ds1621pc', 'muhammedaliuzun1998', 'anilkiziltas', 'exploit4', 'yewu', 'moze', 'vaidehipatil', '1903setoo', 'tarunatsamadder', 'jsmahesh.iitb', 'prajwalbarapatre13', 'burcuukoksal', 'kdbeatbox', 'methemfaik', 'prashantkurrey61520', 'harshdolhare99', 'deviljokerkaran', 'sakshee.pimpale', 'parasbodke', 'etcherla.harshavardhan3', 'jeetika2000singla', 'aarondfranklin', 'safiyemermer', 'anubhavgoel026', 'octonionstar', 'pradeep264', 'ercannmutlu', 'meshramrishikesh1206', 'sumritg267', 'rathodhare', 'prajwaldkamble', 'sakethchandra', 'ronal_denho_931', 'madhurs', 'siddharthmaniar99', 'adil456', 'muratlevent', 'siddharthsh2', 'wubbbiz', 'prachigoel2511', 'nanohubpnesogu', 'aylinyildiz968', 'adityakhanna1999', 'davuteee', 'bjsmahesh', 'herzkim', 'sudhanshu.an', 'nc_ionutz', 'mayazli97', 'divyansh001', 'phsysaicms', 'anirudh31', 'goelripul999', 'timmons.luke', 'batuhanuslu', None, 'sonalkumar199842', 'ahmetdundar', 'patel.prajval1', 'pinarg.225', 'zubeydekal37', 'c.schumann', 'timpe005', 'emre_krtn97', 'osmankaplanci_01']"
4,216,111,57,2,"['malhotra.divyesha', 'aarondfranklin']",108,"['deepanshu.koshta', 'dogukaninci93', 'ozgurdenizkozan', 'pragatimeshram30', 'aniruddh', 'ritizsaini', 'mundrayagya1', 'hellblazer', 'riteshsadwik', 'cihanbuyuknacar', 'kocamuha', 'yilmazemine855', 'bhalodeutu', 'cri95', 'mustafaerdurann', 'mihir.kavishwar710', 'aviss', 'namannarang', 'kushalpatil07', 'aleksandra02', 'fatih.yorgun', 'mmert.bacak', 'murat_lani', 'esranurcengiz43', 'tanmayg890', 'onuur', 'erhan_1996', 'dadaskral', 'ulkubarut', 'jorik.waeterschoot', 'haticesari333333', 'oakbulut1997', 'evrenyigit', 'samet1231234', 'aryanlall53', 'hasanaltintas', 'ilkaydost', 'enizcelik', 'nadim.chow', 'emreycanc', 'daijiejian', 'rishabhdahale', 'azalomar', 'senanurcetin96', 'glps.ozdmr', 'yashmandharerl', 'jaideep', 'ig', 'sayedzuzair', 'irfancakmaz', 'lever', 'rafshezani', 'orcun_bakkal', 'metehanmustafayalcin', 'sshailee270', 'agarwal.aishwarya2013', 'salihyanikgonul', 'ckadircaner', 'aycaduman', 'ds1621pc', 'muhammedaliuzun1998', 'anilkiziltas', 'exploit4', 'yewu', 'moze', 'vaidehipatil', '1903setoo', 'jsmahesh.iitb', 'prajwalbarapatre13', 'burcuukoksal', 'kdbeatbox', 'methemfaik', 'prashantkurrey61520', 'harshdolhare99', 'parasbodke', 'etcherla.harshavardhan3', 'safiyemermer', 'anubhavgoel026', 'octonionstar', 'pradeep264', 'ercannmutlu', 'sakethchandra', 'ronal_denho_931', 'madhurs', 'siddharthmaniar99', 'muratlevent', 'siddharthsh2', 'wubbbiz', 'nanohubpnesogu', 'aylinyildiz968', 'adityakhanna1999', 'davuteee', 'herzkim', 'nc_ionutz', 'mayazli97', 'phsysaicms', 'goelripul999', 'timmons.luke', 'batuhanuslu', 'sonalkumar199842', 'ahmetdundar', 'patel.prajval1', 'pinarg.225', 'zubeydekal37', 'c.schumann', 'timpe005', 'emre_krtn97', 'osmankaplanci_01']",55,"['karanv667', 'nnovitsky', 'joanne.zheng', 'marystuartelder', 'ammiexia', 'deniz.simsek', 'siyuan_chen', 'idkwain', 'xiangjin', 'suman.bajgain', 'justinhavas', 'ian_hanus', 'jierong1220', 'yousuf.rehman7', 'allencao', 'srabinowitz', 'joeyliang99', 'zoey1998', 'kerrycastor', 'fooiey', 'jmb186', 'gmak6464', 'lindamanyenga', 'cjingram2020', 'ben_jackson341', 'casiomichael', 'matthew.harris.1998', 'aricarri', 'rishdafish97', 'luciamees2016', 'ramilmsh', 'elamorhan', 'jacarde4', 'gkw12345', 'knice', 'joanna.li', 'jar121', 'bluedevil729', None, 'ltruitt5', 'nev', 'hannahwilen', 'davidmiron80', 'trevor.stevenson', 'alicettdai', 'cooper.lair', 'jswubbenhorst', 'nguyen.andy.le', 'chaofan.tao', 'bgolbin', 'iwillforgetthisname', 'annadiemel', 'anshudwibhashi', 'qinwen.deng168367', 'eceodev']",165,"['deepanshu.koshta', 'dogukaninci93', 'joanne.zheng', 'xiangjin', 'ozgurdenizkozan', 'aniruddh', 'pragatimeshram30', 'ritizsaini', 'ian_hanus', 'mundrayagya1', 'fooiey', 'hellblazer', 'lindamanyenga', 'riteshsadwik', 'kocamuha', 'cihanbuyuknacar', 'rishdafish97', 'yilmazemine855', 'jacarde4', 'gkw12345', 'bhalodeutu', 'cri95', 'mustafaerdurann', 'mihir.kavishwar710', 'joanna.li', 'ltruitt5', 'aviss', 'nev', 'namannarang', 'kushalpatil07', 'bgolbin', 'aleksandra02', 'iwillforgetthisname', 'fatih.yorgun', 'mmert.bacak', 'murat_lani', 'esranurcengiz43', 'tanmayg890', 'onuur', 'erhan_1996', 'dadaskral', 'ammiexia', 'ulkubarut', 'jorik.waeterschoot', 'haticesari333333', 'oakbulut1997', 'evrenyigit', 'samet1231234', 'aryanlall53', 'hasanaltintas', 'ilkaydost', 'enizcelik', 'jierong1220', 'nadim.chow', 'emreycanc', 'allencao', 'daijiejian', 'srabinowitz', 'rishabhdahale', 'jmb186', 'azalomar', 'senanurcetin96', 'cjingram2020', 'ben_jackson341', 'glps.ozdmr', 'yashmandharerl', 'ramilmsh', 'jaideep', 'ig', 'elamorhan', 'sayedzuzair', 'irfancakmaz', 'lever', 'rafshezani', 'orcun_bakkal', 'metehanmustafayalcin', 'bluedevil729', 'malhotra.divyesha', 'hannahwilen', 'davidmiron80', 'trevor.stevenson', 'sshailee270', 'agarwal.aishwarya2013', 'salihyanikgonul', 'nguyen.andy.le', 'chaofan.tao', 'anshudwibhashi', 'eceodev', 'ckadircaner', 'aycaduman', 'ds1621pc', 'marystuartelder', 'muhammedaliuzun1998', 'anilkiziltas', 'exploit4', 'siyuan_chen', 'yewu', 'idkwain', 'moze', 'vaidehipatil', '1903setoo', 'jsmahesh.iitb', 'prajwalbarapatre13', 'burcuukoksal', 'kerrycastor', 'kdbeatbox', 'gmak6464', 'methemfaik', 'casiomichael', 'matthew.harris.1998', 'prashantkurrey61520', 'luciamees2016', 'harshdolhare99', 'parasbodke', 'etcherla.harshavardhan3', 'aarondfranklin', 'safiyemermer', 'anubhavgoel026', 'jar121', 'alicettdai', 'cooper.lair', 'jswubbenhorst', 'octonionstar', 'pradeep264', 'ercannmutlu', 'annadiemel', 'sakethchandra', 'qinwen.deng168367', 'ronal_denho_931', 'madhurs', 'karanv667', 'nnovitsky', 'siddharthmaniar99', 'deniz.simsek', 'suman.bajgain', 'justinhavas', 'muratlevent', 'siddharthsh2', 'wubbbiz', 'yousuf.rehman7', 'nanohubpnesogu', 'joeyliang99', 'zoey1998', 'aylinyildiz968', 'adityakhanna1999', 'aricarri', 'davuteee', 'herzkim', 'nc_ionutz', 'mayazli97', 'phsysaicms', 'goelripul999', 'timmons.luke', 'knice', 'batuhanuslu', None, 'sonalkumar199842', 'ahmetdundar', 'patel.prajval1', 'pinarg.225', 'zubeydekal37', 'c.schumann', 'timpe005', 'emre_krtn97', 'osmankaplanci_01']"
4,340,111,48,32,"['deepanshu.koshta', 'ds1621pc', 'tanmayg890', 'siddharthmaniar99', 'aniruddh', 'pragatimeshram30', 'vaidehipatil', 'ritizsaini', 'aryanlall53', 'jsmahesh.iitb', 'prajwalbarapatre13', 'mundrayagya1', 'rishabhdahale', 'hellblazer', 'yashmandharerl', 'harshdolhare99', 'jaideep', 'etcherla.harshavardhan3', 'sayedzuzair', 'phsysaicms', 'bhalodeutu', 'mihir.kavishwar710', 'goelripul999', 'anubhavgoel026', 'sonalkumar199842', 'sshailee270', 'namannarang', 'patel.prajval1', 'agarwal.aishwarya2013', 'pradeep264', 'sakethchandra', 'madhurs']",78,"['dogukaninci93', 'ozgurdenizkozan', 'riteshsadwik', 'cihanbuyuknacar', 'kocamuha', 'yilmazemine855', 'cri95', 'mustafaerdurann', 'aviss', 'kushalpatil07', 'aleksandra02', 'fatih.yorgun', 'mmert.bacak', 'murat_lani', 'esranurcengiz43', 'onuur', 'erhan_1996', 'dadaskral', 'ulkubarut', 'jorik.waeterschoot', 'haticesari333333', 'oakbulut1997', 'evrenyigit', 'samet1231234', 'hasanaltintas', 'ilkaydost', 'enizcelik', 'nadim.chow', 'emreycanc', 'daijiejian', 'azalomar', 'senanurcetin96', 'glps.ozdmr', 'ig', 'irfancakmaz', 'lever', 'rafshezani', 'orcun_bakkal', 'metehanmustafayalcin', 'malhotra.divyesha', 'salihyanikgonul', 'ckadircaner', 'aycaduman', 'muhammedaliuzun1998', 'anilkiziltas', 'exploit4', 'yewu', 'moze', '1903setoo', 'burcuukoksal', 'kdbeatbox', 'methemfaik', 'prashantkurrey61520', 'parasbodke', 'aarondfranklin', 'safiyemermer', 'octonionstar', 'ercannmutlu', 'ronal_denho_931', 'muratlevent', 'siddharthsh2', 'wubbbiz', 'nanohubpnesogu', 'aylinyildiz968', 'adityakhanna1999', 'davuteee', 'herzkim', 'nc_ionutz', 'mayazli97', 'timmons.luke', 'batuhanuslu', 'ahmetdundar', 'pinarg.225', 'zubeydekal37', 'c.schumann', 'timpe005', 'emre_krtn97', 'osmankaplanci_01']",16,"['bjsmahesh', 'tavishmeena', 'ayushrajmehrotra.11', 'karan_chate', 'methi1999', 'adil456', 'sonalkumar632', 'surya99', 'agarwalanubhav.2011', 'meshramrishikesh1206', 'sumritg267', 'nitish_21', 'bhavesh.garg', None, 'shivani_vn', 'vatsal']",126,"['deepanshu.koshta', 'dogukaninci93', 'agarwalanubhav.2011', 'ozgurdenizkozan', 'aniruddh', 'pragatimeshram30', 'ritizsaini', 'mundrayagya1', 'surya99', 'hellblazer', 'riteshsadwik', 'kocamuha', 'cihanbuyuknacar', 'yilmazemine855', 'bhalodeutu', 'cri95', 'mustafaerdurann', 'mihir.kavishwar710', 'shivani_vn', 'aviss', 'ayushrajmehrotra.11', 'namannarang', 'kushalpatil07', 'aleksandra02', 'nitish_21', 'fatih.yorgun', 'mmert.bacak', 'murat_lani', 'esranurcengiz43', 'tanmayg890', 'onuur', 'erhan_1996', 'dadaskral', 'methi1999', 'ulkubarut', 'jorik.waeterschoot', 'haticesari333333', 'oakbulut1997', 'evrenyigit', 'samet1231234', 'aryanlall53', 'hasanaltintas', 'ilkaydost', 'enizcelik', 'nadim.chow', 'emreycanc', 'daijiejian', 'rishabhdahale', 'azalomar', 'senanurcetin96', 'glps.ozdmr', 'yashmandharerl', 'jaideep', 'ig', 'sayedzuzair', 'irfancakmaz', 'lever', 'rafshezani', 'orcun_bakkal', 'metehanmustafayalcin', 'bhavesh.garg', 'malhotra.divyesha', 'karan_chate', 'sshailee270', 'agarwal.aishwarya2013', 'salihyanikgonul', 'ckadircaner', 'aycaduman', 'ds1621pc', 'muhammedaliuzun1998', 'anilkiziltas', 'exploit4', 'yewu', 'moze', 'vaidehipatil', '1903setoo', 'jsmahesh.iitb', 'prajwalbarapatre13', 'burcuukoksal', 'kdbeatbox', 'methemfaik', 'prashantkurrey61520', 'tavishmeena', 'harshdolhare99', 'parasbodke', 'etcherla.harshavardhan3', 'aarondfranklin', 'safiyemermer', 'anubhavgoel026', 'octonionstar', 'pradeep264', 'ercannmutlu', 'meshramrishikesh1206', 'sumritg267', 'sakethchandra', 'ronal_denho_931', 'madhurs', 'siddharthmaniar99', 'adil456', 'sonalkumar632', 'muratlevent', 'siddharthsh2', 'wubbbiz', 'vatsal', 'nanohubpnesogu', 'aylinyildiz968', 'adityakhanna1999', 'davuteee', 'bjsmahesh', 'herzkim', 'nc_ionutz', 'mayazli97', 'phsysaicms', 'goelripul999', 'timmons.luke', 'batuhanuslu', None, 'sonalkumar199842', 'ahmetdundar', 'patel.prajval1', 'pinarg.225', 'zubeydekal37', 'c.schumann', 'timpe005', 'emre_krtn97', 'osmankaplanci_01']"
4,345,111,47,29,"['moze', 'muratlevent', 'haticesari333333', 'oakbulut1997', 'samet1231234', 'hasanaltintas', '1903setoo', 'ilkaydost', 'enizcelik', 'aylinyildiz968', 'glps.ozdmr', 'cihanbuyuknacar', 'davuteee', 'mayazli97', 'yilmazemine855', 'mustafaerdurann', 'safiyemermer', 'rafshezani', 'orcun_bakkal', 'batuhanuslu', 'metehanmustafayalcin', 'ahmetdundar', 'pinarg.225', 'zubeydekal37', 'ercannmutlu', 'fatih.yorgun', 'emre_krtn97', 'osmankaplanci_01', 'aycaduman']",81,"['deepanshu.koshta', 'dogukaninci93', 'ozgurdenizkozan', 'pragatimeshram30', 'aniruddh', 'ritizsaini', 'mundrayagya1', 'hellblazer', 'riteshsadwik', 'kocamuha', 'bhalodeutu', 'cri95', 'mihir.kavishwar710', 'aviss', 'namannarang', 'kushalpatil07', 'aleksandra02', 'mmert.bacak', 'murat_lani', 'esranurcengiz43', 'tanmayg890', 'onuur', 'erhan_1996', 'dadaskral', 'ulkubarut', 'jorik.waeterschoot', 'evrenyigit', 'aryanlall53', 'nadim.chow', 'emreycanc', 'daijiejian', 'rishabhdahale', 'azalomar', 'senanurcetin96', 'yashmandharerl', 'jaideep', 'ig', 'sayedzuzair', 'irfancakmaz', 'lever', 'malhotra.divyesha', 'sshailee270', 'agarwal.aishwarya2013', 'salihyanikgonul', 'ckadircaner', 'ds1621pc', 'muhammedaliuzun1998', 'anilkiziltas', 'exploit4', 'yewu', 'vaidehipatil', 'jsmahesh.iitb', 'prajwalbarapatre13', 'burcuukoksal', 'kdbeatbox', 'methemfaik', 'prashantkurrey61520', 'harshdolhare99', 'parasbodke', 'etcherla.harshavardhan3', 'aarondfranklin', 'anubhavgoel026', 'octonionstar', 'pradeep264', 'sakethchandra', 'ronal_denho_931', 'madhurs', 'siddharthmaniar99', 'siddharthsh2', 'wubbbiz', 'nanohubpnesogu', 'adityakhanna1999', 'herzkim', 'nc_ionutz', 'phsysaicms', 'goelripul999', 'timmons.luke', 'sonalkumar199842', 'patel.prajval1', 'c.schumann', 'timpe005']",18,"['eaydinaydin40364036', 'melikemusal1', 'oguzhaneker', 'kganozcan', 'aycapektas', 'fdirisaglik', 'melisozkarr', 'muratygurpinar', 'agderemahmut', 'mervertok', 'muvafikmelikkaya', 'yilmazberat1997', 'karapasa026', 'mthn', 'elifisparta38', None, 'alihakanyalcintepe', 'dd.kok']",128,"['deepanshu.koshta', 'dogukaninci93', 'ozgurdenizkozan', 'aniruddh', 'pragatimeshram30', 'ritizsaini', 'mundrayagya1', 'hellblazer', 'riteshsadwik', 'kocamuha', 'cihanbuyuknacar', 'yilmazemine855', 'bhalodeutu', 'cri95', 'mustafaerdurann', 'mihir.kavishwar710', 'elifisparta38', 'aviss', 'namannarang', 'kushalpatil07', 'aleksandra02', 'fatih.yorgun', 'mmert.bacak', 'alihakanyalcintepe', 'murat_lani', 'esranurcengiz43', 'eaydinaydin40364036', 'tanmayg890', 'onuur', 'erhan_1996', 'dadaskral', 'ulkubarut', 'jorik.waeterschoot', 'muvafikmelikkaya', 'haticesari333333', 'oakbulut1997', 'evrenyigit', 'samet1231234', 'aryanlall53', 'hasanaltintas', 'ilkaydost', 'enizcelik', 'nadim.chow', 'emreycanc', 'daijiejian', 'rishabhdahale', 'azalomar', 'senanurcetin96', 'glps.ozdmr', 'yashmandharerl', 'jaideep', 'ig', 'sayedzuzair', 'irfancakmaz', 'lever', 'rafshezani', 'orcun_bakkal', 'metehanmustafayalcin', 'dd.kok', 'malhotra.divyesha', 'fdirisaglik', 'sshailee270', 'agarwal.aishwarya2013', 'salihyanikgonul', 'ckadircaner', 'karapasa026', 'aycaduman', 'ds1621pc', 'muhammedaliuzun1998', 'anilkiziltas', 'exploit4', 'yewu', 'moze', 'vaidehipatil', '1903setoo', 'jsmahesh.iitb', 'prajwalbarapatre13', 'burcuukoksal', 'kdbeatbox', 'methemfaik', 'mthn', 'prashantkurrey61520', 'harshdolhare99', 'parasbodke', 'etcherla.harshavardhan3', 'aarondfranklin', 'safiyemermer', 'anubhavgoel026', 'yilmazberat1997', 'octonionstar', 'pradeep264', 'ercannmutlu', 'sakethchandra', 'ronal_denho_931', 'madhurs', 'siddharthmaniar99', 'agderemahmut', 'mervertok', 'muratlevent', 'siddharthsh2', 'wubbbiz', 'oguzhaneker', 'nanohubpnesogu', 'aylinyildiz968', 'adityakhanna1999', 'davuteee', 'herzkim', 'nc_ionutz', 'mayazli97', 'aycapektas', 'phsysaicms', 'melisozkarr', 'goelripul999', 'timmons.luke', 'batuhanuslu', None, 'sonalkumar199842', 'melikemusal1', 'ahmetdundar', 'kganozcan', 'patel.prajval1', 'pinarg.225', 'zubeydekal37', 'muratygurpinar', 'c.schumann', 'timpe005', 'emre_krtn97', 'osmankaplanci_01']"
4,342,111,32,19,"['esranurcengiz43', 'dogukaninci93', 'onuur', 'erhan_1996', 'muhammedaliuzun1998', 'ckadircaner', 'exploit4', 'ulkubarut', 'evrenyigit', 'enizcelik', 'burcuukoksal', 'emreycanc', 'senanurcetin96', 'kocamuha', 'ig', 'irfancakmaz', 'batuhanuslu', 'aviss', 'ronal_denho_931']",91,"['deepanshu.koshta', 'ozgurdenizkozan', 'aniruddh', 'pragatimeshram30', 'ritizsaini', 'mundrayagya1', 'hellblazer', 'riteshsadwik', 'cihanbuyuknacar', 'yilmazemine855', 'bhalodeutu', 'cri95', 'mustafaerdurann', 'mihir.kavishwar710', 'namannarang', 'kushalpatil07', 'aleksandra02', 'fatih.yorgun', 'mmert.bacak', 'murat_lani', 'tanmayg890', 'dadaskral', 'jorik.waeterschoot', 'haticesari333333', 'oakbulut1997', 'aryanlall53', 'samet1231234', 'hasanaltintas', 'ilkaydost', 'nadim.chow', 'daijiejian', 'rishabhdahale', 'azalomar', 'glps.ozdmr', 'yashmandharerl', 'jaideep', 'sayedzuzair', 'lever', 'rafshezani', 'orcun_bakkal', 'metehanmustafayalcin', 'malhotra.divyesha', 'sshailee270', 'agarwal.aishwarya2013', 'salihyanikgonul', 'aycaduman', 'ds1621pc', 'anilkiziltas', 'yewu', 'moze', 'vaidehipatil', '1903setoo', 'jsmahesh.iitb', 'prajwalbarapatre13', 'kdbeatbox', 'methemfaik', 'prashantkurrey61520', 'harshdolhare99', 'parasbodke', 'etcherla.harshavardhan3', 'aarondfranklin', 'safiyemermer', 'anubhavgoel026', 'octonionstar', 'pradeep264', 'ercannmutlu', 'sakethchandra', 'madhurs', 'siddharthmaniar99', 'muratlevent', 'siddharthsh2', 'wubbbiz', 'nanohubpnesogu', 'aylinyildiz968', 'adityakhanna1999', 'davuteee', 'herzkim', 'nc_ionutz', 'mayazli97', 'phsysaicms', 'goelripul999', 'timmons.luke', 'sonalkumar199842', 'ahmetdundar', 'patel.prajval1', 'pinarg.225', 'zubeydekal37', 'c.schumann', 'timpe005', 'emre_krtn97', 'osmankaplanci_01']",13,"['emrebuyukkose', 'oguzhaneker', 'serpillyuksell', 'denizkaraali', 'melisozkarr', 'albulenagjoshi', 'joker632455', 'onurhansann', 'muvafikmelikkaya', 'cgr_burgucu', None, 'omrbayrak19', 'dd.kok']",123,"['deepanshu.koshta', 'ds1621pc', 'dogukaninci93', 'muhammedaliuzun1998', 'anilkiziltas', 'exploit4', 'yewu', 'ozgurdenizkozan', 'aniruddh', 'pragatimeshram30', 'moze', 'ritizsaini', 'vaidehipatil', 'cgr_burgucu', '1903setoo', 'jsmahesh.iitb', 'prajwalbarapatre13', 'burcuukoksal', 'mundrayagya1', 'kdbeatbox', 'hellblazer', 'joker632455', 'methemfaik', 'riteshsadwik', 'kocamuha', 'cihanbuyuknacar', 'prashantkurrey61520', 'emrebuyukkose', 'yilmazemine855', 'harshdolhare99', 'parasbodke', 'etcherla.harshavardhan3', 'bhalodeutu', 'cri95', 'mustafaerdurann', 'mihir.kavishwar710', 'aarondfranklin', 'safiyemermer', 'anubhavgoel026', 'aviss', 'namannarang', 'kushalpatil07', 'octonionstar', 'pradeep264', 'ercannmutlu', 'aleksandra02', 'sakethchandra', 'fatih.yorgun', 'mmert.bacak', 'ronal_denho_931', 'madhurs', 'murat_lani', 'esranurcengiz43', 'tanmayg890', 'onuur', 'erhan_1996', 'dadaskral', 'siddharthmaniar99', 'ulkubarut', 'jorik.waeterschoot', 'albulenagjoshi', 'muratlevent', 'haticesari333333', 'oakbulut1997', 'muvafikmelikkaya', 'evrenyigit', 'samet1231234', 'aryanlall53', 'siddharthsh2', 'hasanaltintas', 'ilkaydost', 'enizcelik', 'wubbbiz', 'nadim.chow', 'emreycanc', 'daijiejian', 'oguzhaneker', 'rishabhdahale', 'nanohubpnesogu', 'denizkaraali', 'aylinyildiz968', 'adityakhanna1999', 'azalomar', 'senanurcetin96', 'glps.ozdmr', 'onurhansann', 'davuteee', 'yashmandharerl', 'herzkim', 'nc_ionutz', 'jaideep', 'ig', 'mayazli97', 'serpillyuksell', 'sayedzuzair', 'phsysaicms', 'irfancakmaz', 'melisozkarr', 'goelripul999', 'timmons.luke', 'lever', 'rafshezani', 'orcun_bakkal', 'metehanmustafayalcin', 'batuhanuslu', 'omrbayrak19', None, 'sonalkumar199842', 'dd.kok', 'malhotra.divyesha', 'ahmetdundar', 'sshailee270', 'patel.prajval1', 'agarwal.aishwarya2013', 'salihyanikgonul', 'pinarg.225', 'zubeydekal37', 'c.schumann', 'timpe005', 'emre_krtn97', 'osmankaplanci_01', 'ckadircaner', 'aycaduman']"
4,341,111,31,2,"['malhotra.divyesha', 'wubbbiz']",108,"['deepanshu.koshta', 'dogukaninci93', 'ozgurdenizkozan', 'pragatimeshram30', 'aniruddh', 'ritizsaini', 'mundrayagya1', 'hellblazer', 'riteshsadwik', 'cihanbuyuknacar', 'kocamuha', 'yilmazemine855', 'bhalodeutu', 'cri95', 'mustafaerdurann', 'mihir.kavishwar710', 'aviss', 'namannarang', 'kushalpatil07', 'aleksandra02', 'fatih.yorgun', 'mmert.bacak', 'murat_lani', 'esranurcengiz43', 'tanmayg890', 'onuur', 'erhan_1996', 'dadaskral', 'ulkubarut', 'jorik.waeterschoot', 'haticesari333333', 'oakbulut1997', 'evrenyigit', 'samet1231234', 'aryanlall53', 'hasanaltintas', 'ilkaydost', 'enizcelik', 'nadim.chow', 'emreycanc', 'daijiejian', 'rishabhdahale', 'azalomar', 'senanurcetin96', 'glps.ozdmr', 'yashmandharerl', 'jaideep', 'ig', 'sayedzuzair', 'irfancakmaz', 'lever', 'rafshezani', 'orcun_bakkal', 'metehanmustafayalcin', 'sshailee270', 'agarwal.aishwarya2013', 'salihyanikgonul', 'ckadircaner', 'aycaduman', 'ds1621pc', 'muhammedaliuzun1998', 'anilkiziltas', 'exploit4', 'yewu', 'moze', 'vaidehipatil', '1903setoo', 'jsmahesh.iitb', 'prajwalbarapatre13', 'burcuukoksal', 'kdbeatbox', 'methemfaik', 'prashantkurrey61520', 'harshdolhare99', 'parasbodke', 'etcherla.harshavardhan3', 'aarondfranklin', 'safiyemermer', 'anubhavgoel026', 'octonionstar', 'pradeep264', 'ercannmutlu', 'sakethchandra', 'ronal_denho_931', 'madhurs', 'siddharthmaniar99', 'muratlevent', 'siddharthsh2', 'nanohubpnesogu', 'aylinyildiz968', 'adityakhanna1999', 'davuteee', 'herzkim', 'nc_ionutz', 'mayazli97', 'phsysaicms', 'goelripul999', 'timmons.luke', 'batuhanuslu', 'sonalkumar199842', 'ahmetdundar', 'patel.prajval1', 'pinarg.225', 'zubeydekal37', 'c.schumann', 'timpe005', 'emre_krtn97', 'osmankaplanci_01']",29,"['ammiexia', 'siyuan_chen', 'idkwain', 'xiangjin', 'justinhavas', 'ian_hanus', 'jierong1220', 'allencao', 'joeyliang99', 'zoey1998', 'kerrycastor', 'jmb186', 'gmak6464', 'lindamanyenga', 'casiomichael', 'matthew.harris.1998', 'aricarri', 'ramilmsh', 'jacarde4', 'knice', 'jar121', None, 'trevor.stevenson', 'cooper.lair', 'nguyen.andy.le', 'chaofan.tao', 'bgolbin', 'annadiemel', 'anshudwibhashi']",139,"['deepanshu.koshta', 'ds1621pc', 'dogukaninci93', 'muhammedaliuzun1998', 'anilkiziltas', 'exploit4', 'siyuan_chen', 'yewu', 'idkwain', 'xiangjin', 'ozgurdenizkozan', 'aniruddh', 'pragatimeshram30', 'moze', 'ritizsaini', 'vaidehipatil', 'ian_hanus', '1903setoo', 'jsmahesh.iitb', 'prajwalbarapatre13', 'burcuukoksal', 'mundrayagya1', 'kerrycastor', 'kdbeatbox', 'hellblazer', 'gmak6464', 'lindamanyenga', 'methemfaik', 'casiomichael', 'riteshsadwik', 'matthew.harris.1998', 'kocamuha', 'cihanbuyuknacar', 'prashantkurrey61520', 'yilmazemine855', 'harshdolhare99', 'parasbodke', 'etcherla.harshavardhan3', 'jacarde4', 'bhalodeutu', 'cri95', 'mustafaerdurann', 'mihir.kavishwar710', 'aarondfranklin', 'safiyemermer', 'anubhavgoel026', 'jar121', 'aviss', 'cooper.lair', 'namannarang', 'kushalpatil07', 'octonionstar', 'pradeep264', 'ercannmutlu', 'bgolbin', 'aleksandra02', 'annadiemel', 'sakethchandra', 'fatih.yorgun', 'mmert.bacak', 'ronal_denho_931', 'madhurs', 'murat_lani', 'esranurcengiz43', 'tanmayg890', 'onuur', 'erhan_1996', 'dadaskral', 'siddharthmaniar99', 'ammiexia', 'ulkubarut', 'jorik.waeterschoot', 'justinhavas', 'muratlevent', 'haticesari333333', 'oakbulut1997', 'evrenyigit', 'samet1231234', 'aryanlall53', 'siddharthsh2', 'hasanaltintas', 'ilkaydost', 'enizcelik', 'wubbbiz', 'nadim.chow', 'emreycanc', 'jierong1220', 'allencao', 'daijiejian', 'rishabhdahale', 'nanohubpnesogu', 'joeyliang99', 'zoey1998', 'aylinyildiz968', 'adityakhanna1999', 'jmb186', 'azalomar', 'senanurcetin96', 'glps.ozdmr', 'aricarri', 'davuteee', 'yashmandharerl', 'herzkim', 'ramilmsh', 'nc_ionutz', 'jaideep', 'ig', 'mayazli97', 'sayedzuzair', 'phsysaicms', 'irfancakmaz', 'goelripul999', 'timmons.luke', 'lever', 'rafshezani', 'knice', 'orcun_bakkal', 'metehanmustafayalcin', 'batuhanuslu', None, 'sonalkumar199842', 'malhotra.divyesha', 'trevor.stevenson', 'ahmetdundar', 'sshailee270', 'patel.prajval1', 'agarwal.aishwarya2013', 'salihyanikgonul', 'pinarg.225', 'zubeydekal37', 'nguyen.andy.le', 'chaofan.tao', 'c.schumann', 'anshudwibhashi', 'timpe005', 'emre_krtn97', 'osmankaplanci_01', 'ckadircaner', 'aycaduman']"
4,344,111,10,5,"['anilkiziltas', 'ozgurdenizkozan', 'glps.ozdmr', 'batuhanuslu', 'mmert.bacak']",105,"['deepanshu.koshta', 'ds1621pc', 'dogukaninci93', 'muhammedaliuzun1998', 'exploit4', 'yewu', 'aniruddh', 'pragatimeshram30', 'moze', 'ritizsaini', 'vaidehipatil', '1903setoo', 'jsmahesh.iitb', 'prajwalbarapatre13', 'burcuukoksal', 'mundrayagya1', 'kdbeatbox', 'hellblazer', 'methemfaik', 'riteshsadwik', 'kocamuha', 'cihanbuyuknacar', 'prashantkurrey61520', 'yilmazemine855', 'harshdolhare99', 'parasbodke', 'etcherla.harshavardhan3', 'bhalodeutu', 'cri95', 'mustafaerdurann', 'mihir.kavishwar710', 'aarondfranklin', 'safiyemermer', 'anubhavgoel026', 'aviss', 'namannarang', 'kushalpatil07', 'octonionstar', 'pradeep264', 'ercannmutlu', 'aleksandra02', 'sakethchandra', 'fatih.yorgun', 'ronal_denho_931', 'madhurs', 'murat_lani', 'esranurcengiz43', 'tanmayg890', 'onuur', 'erhan_1996', 'dadaskral', 'siddharthmaniar99', 'ulkubarut', 'jorik.waeterschoot', 'muratlevent', 'haticesari333333', 'oakbulut1997', 'evrenyigit', 'samet1231234', 'aryanlall53', 'siddharthsh2', 'hasanaltintas', 'ilkaydost', 'enizcelik', 'wubbbiz', 'nadim.chow', 'emreycanc', 'daijiejian', 'rishabhdahale', 'nanohubpnesogu', 'aylinyildiz968', 'adityakhanna1999', 'azalomar', 'senanurcetin96', 'davuteee', 'yashmandharerl', 'herzkim', 'nc_ionutz', 'jaideep', 'ig', 'mayazli97', 'sayedzuzair', 'phsysaicms', 'irfancakmaz', 'goelripul999', 'timmons.luke', 'lever', 'rafshezani', 'orcun_bakkal', 'metehanmustafayalcin', 'sonalkumar199842', 'malhotra.divyesha', 'ahmetdundar', 'sshailee270', 'patel.prajval1', 'agarwal.aishwarya2013', 'salihyanikgonul', 'pinarg.225', 'zubeydekal37', 'c.schumann', 'timpe005', 'emre_krtn97', 'osmankaplanci_01', 'ckadircaner', 'aycaduman']",5,"['eaydinaydin40364036', 'yeterates06', 'omrbayrak19', None, 'eymen']",115,"['deepanshu.koshta', 'ds1621pc', 'dogukaninci93', 'muhammedaliuzun1998', 'anilkiziltas', 'eymen', 'exploit4', 'yewu', 'ozgurdenizkozan', 'aniruddh', 'pragatimeshram30', 'moze', 'ritizsaini', 'vaidehipatil', '1903setoo', 'jsmahesh.iitb', 'prajwalbarapatre13', 'burcuukoksal', 'mundrayagya1', 'kdbeatbox', 'hellblazer', 'methemfaik', 'riteshsadwik', 'kocamuha', 'cihanbuyuknacar', 'prashantkurrey61520', 'yilmazemine855', 'harshdolhare99', 'parasbodke', 'etcherla.harshavardhan3', 'bhalodeutu', 'cri95', 'mustafaerdurann', 'mihir.kavishwar710', 'aarondfranklin', 'safiyemermer', 'anubhavgoel026', 'aviss', 'namannarang', 'kushalpatil07', 'octonionstar', 'pradeep264', 'ercannmutlu', 'aleksandra02', 'sakethchandra', 'fatih.yorgun', 'mmert.bacak', 'ronal_denho_931', 'madhurs', 'murat_lani', 'esranurcengiz43', 'eaydinaydin40364036', 'tanmayg890', 'onuur', 'erhan_1996', 'dadaskral', 'siddharthmaniar99', 'ulkubarut', 'jorik.waeterschoot', 'muratlevent', 'haticesari333333', 'oakbulut1997', 'evrenyigit', 'samet1231234', 'aryanlall53', 'siddharthsh2', 'hasanaltintas', 'ilkaydost', 'enizcelik', 'wubbbiz', 'nadim.chow', 'emreycanc', 'daijiejian', 'rishabhdahale', 'nanohubpnesogu', 'aylinyildiz968', 'adityakhanna1999', 'azalomar', 'senanurcetin96', 'glps.ozdmr', 'davuteee', 'yashmandharerl', 'herzkim', 'nc_ionutz', 'jaideep', 'ig', 'mayazli97', 'sayedzuzair', 'phsysaicms', 'irfancakmaz', 'goelripul999', 'timmons.luke', 'lever', 'rafshezani', 'orcun_bakkal', 'metehanmustafayalcin', 'batuhanuslu', 'omrbayrak19', None, 'sonalkumar199842', 'malhotra.divyesha', 'ahmetdundar', 'yeterates06', 'sshailee270', 'patel.prajval1', 'agarwal.aishwarya2013', 'salihyanikgonul', 'pinarg.225', 'zubeydekal37', 'c.schumann', 'timpe005', 'emre_krtn97', 'osmankaplanci_01', 'ckadircaner', 'aycaduman']"
5,348,80,59,48,"['quebrado33', 'senor_el_joynes', 'jcmunoz7', 'davidglezm14', 'iavila215', 'mdurbina2', 'genesisalvarado22', 'laaviles', 'perezmelissa7.10', 'alialali95', 'sal080294', 'rsalgado19', 'mohammedbasim750', 'yvdeleon', 'piercecoby', 'jjameson', 'josehoa7', 'bjasmin2014', 'coby_mj', 'aalopez18', 'yousef.alfarisi', 'victorjr1984', 'taylor.wells2015', 'dolvera', 'rmunoz', 'arios', 'ghostbdr', 'andresjuego1', 'joddady360', 'avazquezmo792', 'aazambrano2', 'ajavila704', 'eabaca', 'jdelcastillo', 'fmrodriguez', 'in3zl0p3z', 'admacias4', 'egarcia91', 'nabutep1', 'afalshareef', 'jasias', 'fdo.glz', 'aliciagrajeda97', 'qiharris', 'mamapula', 'ksantacruz', 'miguelon312', 'crysdbz.22']",31,"['anneraheem', 'geysenbach', 'davidxu', 'hat431', 'chialung.lin', 'bernhard.fabel', 'ccoltsimonds', 'nicolasweninger', 'denizkaraali', 'priyangshu', 'darabagis88', 'alihakanyalcintepe', 'doktoro', 'igbokwe', 'huh12141', 'ddrum2000', 'zxs5627', 'mikfulvio', 'heiknen', 'awnitsingh', 'aurkinet', 'siddharthasr', 'amany02', 'grushko', 'udaykiranreddysadula', 'djhidalgo', 'fhiebel', 'tagyun', 'bjasmin2007', 'mkroberts2015', 'janmanalac08']",11,"['aceniceros7', 'rgomez21', 'iantorres', 'asagredo', 'kchaconflo', 'ponchitofam', 'giosantiago1997', 'hope7197', 'ragdedivad15', 'fjcandelario', None]",90,"['geysenbach', 'hat431', 'bernhard.fabel', 'davidglezm14', 'ponchitofam', 'janmanalac08', 'perezmelissa7.10', 'sal080294', 'aceniceros7', 'yvdeleon', 'rgomez21', 'piercecoby', 'josehoa7', 'aalopez18', 'igbokwe', 'fjcandelario', 'ddrum2000', 'taylor.wells2015', 'dolvera', 'rmunoz', 'giosantiago1997', 'andresjuego1', 'avazquezmo792', 'heiknen', 'eabaca', 'jdelcastillo', 'fmrodriguez', 'awnitsingh', 'aurkinet', 'siddharthasr', 'admacias4', 'amany02', 'afalshareef', 'aliciagrajeda97', 'qiharris', 'fhiebel', 'bjasmin2007', 'miguelon312', 'ragdedivad15', 'alihakanyalcintepe', 'priyangshu', 'quebrado33', 'anneraheem', 'davidxu', 'senor_el_joynes', 'jcmunoz7', 'chialung.lin', 'iavila215', 'mdurbina2', 'hope7197', 'genesisalvarado22', 'laaviles', 'nicolasweninger', 'alialali95', 'rsalgado19', 'mohammedbasim750', 'denizkaraali', 'jjameson', 'bjasmin2014', 'kchaconflo', 'darabagis88', 'doktoro', 'coby_mj', 'huh12141', 'yousef.alfarisi', 'victorjr1984', 'iantorres', 'zxs5627', 'arios', 'ghostbdr', 'joddady360', 'mikfulvio', 'ajavila704', 'aazambrano2', None, 'in3zl0p3z', 'egarcia91', 'nabutep1', 'asagredo', 'jasias', 'grushko', 'fdo.glz', 'udaykiranreddysadula', 'djhidalgo', 'mamapula', 'ksantacruz', 'tagyun', 'crysdbz.22', 'mkroberts2015', 'ccoltsimonds']"
5,345,80,47,1,['alihakanyalcintepe'],78,"['hat431', 'bernhard.fabel', 'sal080294', 'igbokwe', 'dolvera', 'rmunoz', 'jdelcastillo', 'eabaca', 'aurkinet', 'afalshareef', 'davidxu', 'senor_el_joynes', 'jcmunoz7', 'iavila215', 'genesisalvarado22', 'laaviles', 'rsalgado19', 'mohammedbasim750', 'denizkaraali', 'jjameson', 'huh12141', 'victorjr1984', 'arios', 'ghostbdr', 'joddady360', 'mikfulvio', 'ajavila704', 'in3zl0p3z', 'egarcia91', 'nabutep1', 'jasias', 'grushko', 'fdo.glz', 'ksantacruz', 'janmanalac08', 'ccoltsimonds', 'geysenbach', 'davidglezm14', 'perezmelissa7.10', 'yvdeleon', 'piercecoby', 'josehoa7', 'aalopez18', 'ddrum2000', 'taylor.wells2015', 'andresjuego1', 'avazquezmo792', 'heiknen', 'fmrodriguez', 'awnitsingh', 'siddharthasr', 'admacias4', 'amany02', 'aliciagrajeda97', 'qiharris', 'fhiebel', 'bjasmin2007', 'miguelon312', 'priyangshu', 'quebrado33', 'anneraheem', 'chialung.lin', 'mdurbina2', 'nicolasweninger', 'alialali95', 'bjasmin2014', 'darabagis88', 'doktoro', 'coby_mj', 'yousef.alfarisi', 'zxs5627', 'aazambrano2', 'udaykiranreddysadula', 'djhidalgo', 'mamapula', 'tagyun', 'crysdbz.22', 'mkroberts2015']",46,"['eaydinaydin40364036', 'agderemahmut', 'mervertok', 'moze', 'muratlevent', 'haticesari333333', 'muvafikmelikkaya', 'oakbulut1997', 'samet1231234', 'hasanaltintas', '1903setoo', 'ilkaydost', 'enizcelik', 'oguzhaneker', 'aylinyildiz968', 'glps.ozdmr', 'mthn', 'cihanbuyuknacar', 'davuteee', 'mayazli97', 'yilmazemine855', 'aycapektas', 'melisozkarr', 'mustafaerdurann', 'safiyemermer', 'yilmazberat1997', 'rafshezani', 'orcun_bakkal', 'batuhanuslu', 'elifisparta38', 'metehanmustafayalcin', None, 'dd.kok', 'melikemusal1', 'ahmetdundar', 'kganozcan', 'fdirisaglik', 'pinarg.225', 'zubeydekal37', 'ercannmutlu', 'muratygurpinar', 'fatih.yorgun', 'emre_krtn97', 'osmankaplanci_01', 'karapasa026', 'aycaduman']",125,"['geysenbach', 'hat431', 'bernhard.fabel', 'davidglezm14', 'moze', 'janmanalac08', 'perezmelissa7.10', 'sal080294', '1903setoo', 'yvdeleon', 'piercecoby', 'josehoa7', 'emre_krtn97', 'mthn', 'aalopez18', 'igbokwe', 'cihanbuyuknacar', 'ddrum2000', 'taylor.wells2015', 'dolvera', 'yilmazemine855', 'rmunoz', 'mustafaerdurann', 'andresjuego1', 'safiyemermer', 'avazquezmo792', 'muratygurpinar', 'yilmazberat1997', 'heiknen', 'eabaca', 'jdelcastillo', 'fmrodriguez', 'awnitsingh', 'elifisparta38', 'aurkinet', 'siddharthasr', 'admacias4', 'amany02', 'afalshareef', 'ercannmutlu', 'aliciagrajeda97', 'qiharris', 'fhiebel', 'bjasmin2007', 'miguelon312', 'fatih.yorgun', 'alihakanyalcintepe', 'priyangshu', 'quebrado33', 'anneraheem', 'eaydinaydin40364036', 'davidxu', 'senor_el_joynes', 'jcmunoz7', 'chialung.lin', 'agderemahmut', 'iavila215', 'mervertok', 'mdurbina2', 'muratlevent', 'haticesari333333', 'muvafikmelikkaya', 'genesisalvarado22', 'laaviles', 'oakbulut1997', 'nicolasweninger', 'alialali95', 'samet1231234', 'hasanaltintas', 'rsalgado19', 'ilkaydost', 'mohammedbasim750', 'enizcelik', 'oguzhaneker', 'denizkaraali', 'jjameson', 'aylinyildiz968', 'bjasmin2014', 'darabagis88', 'doktoro', 'coby_mj', 'glps.ozdmr', 'huh12141', 'davuteee', 'yousef.alfarisi', 'victorjr1984', 'mayazli97', 'aycapektas', 'zxs5627', 'arios', 'melisozkarr', 'ghostbdr', 'joddady360', 'mikfulvio', 'ajavila704', 'aazambrano2', 'rafshezani', 'orcun_bakkal', 'batuhanuslu', 'metehanmustafayalcin', None, 'in3zl0p3z', 'dd.kok', 'melikemusal1', 'egarcia91', 'ahmetdundar', 'nabutep1', 'kganozcan', 'fdirisaglik', 'jasias', 'grushko', 'fdo.glz', 'udaykiranreddysadula', 'djhidalgo', 'pinarg.225', 'mamapula', 'ksantacruz', 'tagyun', 'zubeydekal37', 'crysdbz.22', 'mkroberts2015', 'osmankaplanci_01', 'ccoltsimonds', 'karapasa026', 'aycaduman']"
5,342,80,32,1,['denizkaraali'],78,"['hat431', 'bernhard.fabel', 'sal080294', 'igbokwe', 'dolvera', 'rmunoz', 'jdelcastillo', 'eabaca', 'aurkinet', 'afalshareef', 'alihakanyalcintepe', 'davidxu', 'senor_el_joynes', 'jcmunoz7', 'iavila215', 'genesisalvarado22', 'laaviles', 'rsalgado19', 'mohammedbasim750', 'jjameson', 'huh12141', 'victorjr1984', 'arios', 'ghostbdr', 'joddady360', 'mikfulvio', 'ajavila704', 'in3zl0p3z', 'egarcia91', 'nabutep1', 'jasias', 'grushko', 'fdo.glz', 'ksantacruz', 'ccoltsimonds', 'janmanalac08', 'geysenbach', 'davidglezm14', 'perezmelissa7.10', 'yvdeleon', 'piercecoby', 'josehoa7', 'aalopez18', 'ddrum2000', 'taylor.wells2015', 'andresjuego1', 'avazquezmo792', 'heiknen', 'fmrodriguez', 'awnitsingh', 'siddharthasr', 'admacias4', 'amany02', 'aliciagrajeda97', 'qiharris', 'fhiebel', 'bjasmin2007', 'miguelon312', 'priyangshu', 'quebrado33', 'anneraheem', 'chialung.lin', 'mdurbina2', 'nicolasweninger', 'alialali95', 'bjasmin2014', 'darabagis88', 'doktoro', 'coby_mj', 'yousef.alfarisi', 'zxs5627', 'aazambrano2', 'udaykiranreddysadula', 'djhidalgo', 'mamapula', 'tagyun', 'crysdbz.22', 'mkroberts2015']",31,"['esranurcengiz43', 'dogukaninci93', 'onuur', 'erhan_1996', 'muhammedaliuzun1998', 'exploit4', 'albulenagjoshi', 'ulkubarut', 'muvafikmelikkaya', 'evrenyigit', 'cgr_burgucu', 'enizcelik', 'burcuukoksal', 'emreycanc', 'ronal_denho_931', 'oguzhaneker', 'senanurcetin96', 'joker632455', 'kocamuha', 'emrebuyukkose', 'ig', 'serpillyuksell', 'melisozkarr', 'irfancakmaz', 'omrbayrak19', 'batuhanuslu', None, 'dd.kok', 'aviss', 'onurhansann', 'ckadircaner']",110,"['geysenbach', 'dogukaninci93', 'muhammedaliuzun1998', 'hat431', 'exploit4', 'bernhard.fabel', 'davidglezm14', 'janmanalac08', 'perezmelissa7.10', 'sal080294', 'cgr_burgucu', 'burcuukoksal', 'yvdeleon', 'piercecoby', 'josehoa7', 'joker632455', 'aalopez18', 'igbokwe', 'kocamuha', 'ddrum2000', 'emrebuyukkose', 'taylor.wells2015', 'dolvera', 'rmunoz', 'andresjuego1', 'avazquezmo792', 'heiknen', 'eabaca', 'jdelcastillo', 'fmrodriguez', 'awnitsingh', 'aurkinet', 'siddharthasr', 'admacias4', 'aviss', 'amany02', 'afalshareef', 'aliciagrajeda97', 'qiharris', 'fhiebel', 'bjasmin2007', 'miguelon312', 'alihakanyalcintepe', 'priyangshu', 'ronal_denho_931', 'esranurcengiz43', 'quebrado33', 'anneraheem', 'davidxu', 'onuur', 'erhan_1996', 'ckadircaner', 'senor_el_joynes', 'jcmunoz7', 'chialung.lin', 'iavila215', 'albulenagjoshi', 'mdurbina2', 'ulkubarut', 'muvafikmelikkaya', 'genesisalvarado22', 'laaviles', 'evrenyigit', 'nicolasweninger', 'alialali95', 'rsalgado19', 'enizcelik', 'mohammedbasim750', 'emreycanc', 'oguzhaneker', 'denizkaraali', 'jjameson', 'bjasmin2014', 'darabagis88', 'senanurcetin96', 'doktoro', 'coby_mj', 'huh12141', 'yousef.alfarisi', 'victorjr1984', 'ig', 'zxs5627', 'serpillyuksell', 'arios', 'melisozkarr', 'ghostbdr', 'irfancakmaz', 'joddady360', 'mikfulvio', 'ajavila704', 'aazambrano2', 'omrbayrak19', 'batuhanuslu', None, 'in3zl0p3z', 'dd.kok', 'egarcia91', 'nabutep1', 'jasias', 'grushko', 'fdo.glz', 'udaykiranreddysadula', 'djhidalgo', 'mamapula', 'ksantacruz', 'tagyun', 'crysdbz.22', 'mkroberts2015', 'onurhansann', 'ccoltsimonds']"
5,347,80,27,1,['siddharthasr'],78,"['hat431', 'bernhard.fabel', 'sal080294', 'igbokwe', 'dolvera', 'rmunoz', 'jdelcastillo', 'eabaca', 'aurkinet', 'afalshareef', 'alihakanyalcintepe', 'davidxu', 'senor_el_joynes', 'jcmunoz7', 'iavila215', 'genesisalvarado22', 'laaviles', 'rsalgado19', 'mohammedbasim750', 'denizkaraali', 'jjameson', 'huh12141', 'victorjr1984', 'arios', 'ghostbdr', 'joddady360', 'mikfulvio', 'ajavila704', 'in3zl0p3z', 'egarcia91', 'nabutep1', 'jasias', 'grushko', 'fdo.glz', 'ksantacruz', 'ccoltsimonds', 'janmanalac08', 'geysenbach', 'davidglezm14', 'perezmelissa7.10', 'yvdeleon', 'piercecoby', 'josehoa7', 'aalopez18', 'ddrum2000', 'taylor.wells2015', 'andresjuego1', 'avazquezmo792', 'heiknen', 'fmrodriguez', 'awnitsingh', 'admacias4', 'amany02', 'aliciagrajeda97', 'qiharris', 'fhiebel', 'bjasmin2007', 'miguelon312', 'priyangshu', 'quebrado33', 'anneraheem', 'chialung.lin', 'mdurbina2', 'nicolasweninger', 'alialali95', 'bjasmin2014', 'darabagis88', 'doktoro', 'coby_mj', 'yousef.alfarisi', 'zxs5627', 'aazambrano2', 'udaykiranreddysadula', 'djhidalgo', 'mamapula', 'tagyun', 'crysdbz.22', 'mkroberts2015']",26,"['komminiadithya', 'cdunnington', 'jcrouss', 'aksamija', 'opin', 'jgnall', 'asanmiguel', 'mskaza', 'aeshak', 'matthewsarge', 'bdester', 'rwbrown', 'mjaffe', 'ranonyai', 'angusmo', 'sfick', 'fpanikov', None, 'ajewers', 'oterry', 'tfloyd', 'tinamaurer', 'bdeguire', 'jrosborne', 'rcperkins', 'msokolov']",105,"['geysenbach', 'komminiadithya', 'hat431', 'jcrouss', 'bernhard.fabel', 'davidglezm14', 'aksamija', 'opin', 'jgnall', 'janmanalac08', 'perezmelissa7.10', 'sal080294', 'yvdeleon', 'piercecoby', 'josehoa7', 'mjaffe', 'aalopez18', 'igbokwe', 'ddrum2000', 'taylor.wells2015', 'dolvera', 'rmunoz', 'sfick', 'andresjuego1', 'avazquezmo792', 'heiknen', 'fpanikov', 'eabaca', 'jdelcastillo', 'fmrodriguez', 'awnitsingh', 'aurkinet', 'siddharthasr', 'admacias4', 'amany02', 'afalshareef', 'tfloyd', 'aliciagrajeda97', 'qiharris', 'fhiebel', 'bjasmin2007', 'miguelon312', 'rcperkins', 'msokolov', 'alihakanyalcintepe', 'priyangshu', 'quebrado33', 'anneraheem', 'davidxu', 'senor_el_joynes', 'jcmunoz7', 'chialung.lin', 'cdunnington', 'iavila215', 'mdurbina2', 'genesisalvarado22', 'laaviles', 'nicolasweninger', 'alialali95', 'rsalgado19', 'asanmiguel', 'mohammedbasim750', 'mskaza', 'denizkaraali', 'jjameson', 'matthewsarge', 'bjasmin2014', 'bdester', 'darabagis88', 'rwbrown', 'doktoro', 'coby_mj', 'ranonyai', 'huh12141', 'yousef.alfarisi', 'angusmo', 'victorjr1984', 'zxs5627', 'arios', 'ghostbdr', 'joddady360', 'mikfulvio', 'ajavila704', 'aazambrano2', None, 'in3zl0p3z', 'egarcia91', 'nabutep1', 'ajewers', 'oterry', 'tinamaurer', 'jasias', 'grushko', 'fdo.glz', 'udaykiranreddysadula', 'djhidalgo', 'bdeguire', 'mamapula', 'ksantacruz', 'tagyun', 'jrosborne', 'crysdbz.22', 'mkroberts2015', 'aeshak', 'ccoltsimonds']"
5,349,80,20,14,"['anneraheem', 'awnitsingh', 'geysenbach', 'davidxu', 'amany02', 'mkroberts2015', 'hat431', 'grushko', 'fhiebel', 'nicolasweninger', 'igbokwe', 'huh12141', 'ccoltsimonds', 'ddrum2000']",65,"['quebrado33', 'senor_el_joynes', 'jcmunoz7', 'chialung.lin', 'bernhard.fabel', 'davidglezm14', 'iavila215', 'mdurbina2', 'genesisalvarado22', 'laaviles', 'janmanalac08', 'perezmelissa7.10', 'sal080294', 'alialali95', 'rsalgado19', 'mohammedbasim750', 'yvdeleon', 'denizkaraali', 'piercecoby', 'jjameson', 'josehoa7', 'priyangshu', 'bjasmin2014', 'darabagis88', 'doktoro', 'coby_mj', 'aalopez18', 'yousef.alfarisi', 'victorjr1984', 'dolvera', 'taylor.wells2015', 'rmunoz', 'zxs5627', 'arios', 'ghostbdr', 'andresjuego1', 'joddady360', 'avazquezmo792', 'mikfulvio', 'ajavila704', 'heiknen', 'aazambrano2', 'jdelcastillo', 'eabaca', 'fmrodriguez', 'in3zl0p3z', 'aurkinet', 'siddharthasr', 'admacias4', 'egarcia91', 'nabutep1', 'afalshareef', 'jasias', 'udaykiranreddysadula', 'fdo.glz', 'djhidalgo', 'aliciagrajeda97', 'qiharris', 'mamapula', 'ksantacruz', 'bjasmin2007', 'miguelon312', 'tagyun', 'crysdbz.22', 'alihakanyalcintepe']",6,"['bkkoech', 'avareberg', 'moebied', 'mattzli', 'santiagovargas', None]",85,"['geysenbach', 'hat431', 'bernhard.fabel', 'davidglezm14', 'janmanalac08', 'perezmelissa7.10', 'sal080294', 'yvdeleon', 'piercecoby', 'josehoa7', 'santiagovargas', 'aalopez18', 'igbokwe', 'ddrum2000', 'bkkoech', 'avareberg', 'taylor.wells2015', 'dolvera', 'rmunoz', 'andresjuego1', 'avazquezmo792', 'heiknen', 'eabaca', 'jdelcastillo', 'fmrodriguez', 'awnitsingh', 'aurkinet', 'siddharthasr', 'admacias4', 'amany02', 'afalshareef', 'aliciagrajeda97', 'qiharris', 'fhiebel', 'mattzli', 'bjasmin2007', 'miguelon312', 'alihakanyalcintepe', 'priyangshu', 'quebrado33', 'anneraheem', 'davidxu', 'senor_el_joynes', 'jcmunoz7', 'chialung.lin', 'iavila215', 'mdurbina2', 'genesisalvarado22', 'laaviles', 'nicolasweninger', 'alialali95', 'rsalgado19', 'mohammedbasim750', 'denizkaraali', 'jjameson', 'bjasmin2014', 'darabagis88', 'doktoro', 'coby_mj', 'huh12141', 'yousef.alfarisi', 'victorjr1984', 'zxs5627', 'moebied', 'arios', 'ghostbdr', 'joddady360', 'mikfulvio', 'ajavila704', 'aazambrano2', None, 'in3zl0p3z', 'egarcia91', 'nabutep1', 'jasias', 'grushko', 'fdo.glz', 'udaykiranreddysadula', 'djhidalgo', 'mamapula', 'ksantacruz', 'tagyun', 'crysdbz.22', 'mkroberts2015', 'ccoltsimonds']"
6,435,76,52,49,"['xingrunli', 'ashitaka', 'high1393594963', 'lvxinduan', 'zhaojianyuan', 'thh1009445665', 'jianchunliao', 'yzj1344690056', 'muxi', 'xuzengxu', 'zhouling', 'henryshepard', 'catinchest', 'hitsz', 'xzpcsss', 'temkcyakaruro', 'ysj1205145831', 'omashuu', 'jarryzikaros', 'simon777', 'nuomeili', 'mengyubinmengyubin', 'fantasymiao', 'buyi', 'yufeng', 'wilbolu1999', 'zhoupeiru', 'yangzhehao', 'yingnengtao', 'anny', 'blueheart', 'yhy', 'qihang', 'lzy', 'gyhanis', 'eastsp', 'demo9312', 'liangyiliu', 'licheemango', 'wangxin', 'chrysanthemum0', 'zhangchi', 'hubohan', 'hhn19340', 'wangzhongbin', 'sutcliffe', 'starrysky', 'abandantstar', 'xsy1142431113']",26,"['zoumanacisse692', 'recendiz2504', 'jedemuth', 'khuut001', 'aesanchezcastro', 'neltom', 'dhakal86', 'sjd039', 'deltadude12', 'jenntran0', 'aliciaa1', 'gthelema', 'pmedini', 'martiney', 'vmasokan', 'alinag99', 'wxc4292', 'lwvong', 'lpreyes', 'ishunko', 'zhuangyaojelock', 'jadenb', 'mayagv', 'trujilloju18', 'daisy.diaz2', 'aburrell3']",3,"['lanlibsu', None, 'tuomasiweide']",78,"['zoumanacisse692', 'xingrunli', 'recendiz2504', 'ashitaka', 'high1393594963', 'zhaojianyuan', 'khuut001', 'zhouling', 'henryshepard', 'catinchest', 'neltom', 'dhakal86', 'xzpcsss', 'omashuu', 'jarryzikaros', 'nuomeili', 'fantasymiao', 'deltadude12', 'wilbolu1999', 'gthelema', 'yangzhehao', 'yingnengtao', 'lanlibsu', 'yhy', 'qihang', 'vmasokan', 'lzy', 'alinag99', 'ishunko', 'gyhanis', 'liangyiliu', 'wangxin', 'mayagv', 'zhangchi', 'sutcliffe', 'starrysky', 'daisy.diaz2', 'aburrell3', 'jedemuth', 'lvxinduan', 'jianchunliao', 'thh1009445665', 'yzj1344690056', 'muxi', 'xuzengxu', 'aesanchezcastro', 'hitsz', 'temkcyakaruro', 'ysj1205145831', 'simon777', 'mengyubinmengyubin', 'tuomasiweide', 'sjd039', 'buyi', 'jenntran0', 'yufeng', 'aliciaa1', 'zhoupeiru', 'pmedini', 'anny', 'blueheart', 'martiney', None, 'lwvong', 'wxc4292', 'lpreyes', 'zhuangyaojelock', 'eastsp', 'demo9312', 'licheemango', 'jadenb', 'chrysanthemum0', 'trujilloju18', 'hubohan', 'hhn19340', 'wangzhongbin', 'abandantstar', 'xsy1142431113']"
6,434,76,19,18,"['zoumanacisse692', 'recendiz2504', 'aliciaa1', 'lpreyes', 'gthelema', 'jadenb', 'mayagv', 'trujilloju18', 'sjd039', 'deltadude12', 'daisy.diaz2', 'aburrell3', 'khuut001', 'jenntran0', 'martiney', 'alinag99', 'lwvong', 'neltom']",57,"['xingrunli', 'jedemuth', 'ashitaka', 'high1393594963', 'lvxinduan', 'zhaojianyuan', 'jianchunliao', 'thh1009445665', 'yzj1344690056', 'muxi', 'xuzengxu', 'zhouling', 'henryshepard', 'catinchest', 'aesanchezcastro', 'dhakal86', 'xzpcsss', 'omashuu', 'hitsz', 'temkcyakaruro', 'jarryzikaros', 'ysj1205145831', 'simon777', 'nuomeili', 'mengyubinmengyubin', 'fantasymiao', 'buyi', 'yufeng', 'wilbolu1999', 'zhoupeiru', 'yangzhehao', 'yingnengtao', 'pmedini', 'anny', 'blueheart', 'yhy', 'qihang', 'vmasokan', 'lzy', 'wxc4292', 'ishunko', 'gyhanis', 'zhuangyaojelock', 'liangyiliu', 'eastsp', 'demo9312', 'wangxin', 'licheemango', 'chrysanthemum0', 'zhangchi', 'hubohan', 'hhn19340', 'wangzhongbin', 'sutcliffe', 'starrysky', 'abandantstar', 'xsy1142431113']",1,[None],76,"['zoumanacisse692', 'xingrunli', 'recendiz2504', 'ashitaka', 'high1393594963', 'zhaojianyuan', 'khuut001', 'zhouling', 'henryshepard', 'catinchest', 'neltom', 'dhakal86', 'xzpcsss', 'omashuu', 'jarryzikaros', 'nuomeili', 'fantasymiao', 'deltadude12', 'wilbolu1999', 'gthelema', 'yangzhehao', 'yingnengtao', 'yhy', 'qihang', 'vmasokan', 'lzy', 'alinag99', 'ishunko', 'gyhanis', 'liangyiliu', 'wangxin', 'mayagv', 'zhangchi', 'sutcliffe', 'starrysky', 'daisy.diaz2', 'aburrell3', 'jedemuth', 'lvxinduan', 'jianchunliao', 'thh1009445665', 'yzj1344690056', 'muxi', 'xuzengxu', 'aesanchezcastro', 'hitsz', 'temkcyakaruro', 'ysj1205145831', 'simon777', 'mengyubinmengyubin', 'sjd039', 'buyi', 'jenntran0', 'yufeng', 'aliciaa1', 'zhoupeiru', 'pmedini', 'anny', 'blueheart', 'martiney', None, 'lwvong', 'wxc4292', 'lpreyes', 'zhuangyaojelock', 'eastsp', 'demo9312', 'licheemango', 'jadenb', 'chrysanthemum0', 'trujilloju18', 'hubohan', 'hhn19340', 'wangzhongbin', 'abandantstar', 'xsy1142431113']"
7,309,69,90,65,"['jiwu2', 'jes3', 'baohl2', 'kkl3', 'mtobah2', 'mmm4', 'goshan2', 'jhpham2', 'reishac2', 'juliajh2', 'amyrm20', 'tjf2', 'isaxton2', 'anperry2', 'caschwa2', 'junbaek2', 'djohns85', 'aeh2', 'emt2', 'gofer2', 'coderko3', 'sarahrp2', 'allenxg2', 'nosatov2', 'dahlen2', 'vivo2', 'qz3', 'schoi98', 'rsyuan2', 'spangnt2', 'sili5', 'wjsthdgkrl', 'tidate2', 'kph2', 'zehuahe2', 'shim35', 'pranjal3', 'ellenrf2', 'jaketh2', 'rwtham2', 'yuxuanw7', 'kaiyuan7', 'skomar4', 'travisc2', 'nsk2', 'kychui2', 'harryf2', 'eratta2', 'garnm2', 'ckw2', 'myl3', 'jarodm2', 'earamir2', 'ckim123', 'gmle2', 'pcp2', 'dplata2', 'donnadc2', 'yiqiaol3', 'jinwoo2', 'restep2', 'jmjin2', 'kv2', 'bharath3', 'hahmad7']",3,"['dylanb2', 'schen173', 'vs10']",25,"['eugenep2', 'scc3', 'aneeshj2', 'mjoza2', 'tylerjj2', 'kgolk2', 'masonpb2', 'cisrael2', 'gxiao2', 'vfont2', 'clee152', 'kevin_sager', 'jillmcar', 'mengkem2', 'djgnzlz2', 'rge3', 'dlee145', 'ab20', None, 'kjfrank2', 'ykoyake2', 'mollyh2', 'ncryan2', 'rmahakul13', 'yahn22']",93,"['eugenep2', 'scc3', 'goshan2', 'reishac2', 'juliajh2', 'isaxton2', 'sarahrp2', 'allenxg2', 'dylanb2', 'sili5', 'tidate2', 'kph2', 'zehuahe2', 'pranjal3', 'jaketh2', 'rwtham2', 'kychui2', 'harryf2', 'kjfrank2', 'eratta2', 'mollyh2', 'ckw2', 'yiqiaol3', 'jiwu2', 'mjoza2', 'tjf2', 'kgolk2', 'caschwa2', 'junbaek2', 'qz3', 'spangnt2', 'mengkem2', 'djgnzlz2', 'rge3', 'dlee145', 'ellenrf2', 'nsk2', 'myl3', 'dplata2', 'restep2', 'jmjin2', 'bharath3', 'jes3', 'baohl2', 'kkl3', 'aneeshj2', 'mtobah2', 'mmm4', 'vs10', 'jhpham2', 'tylerjj2', 'anperry2', 'djohns85', 'nosatov2', 'dahlen2', 'vfont2', 'wjsthdgkrl', 'kevin_sager', 'shim35', 'ab20', 'yuxuanw7', 'travisc2', 'earamir2', 'ckim123', 'donnadc2', 'jinwoo2', 'kv2', 'amyrm20', 'aeh2', 'emt2', 'gofer2', 'masonpb2', 'coderko3', 'vivo2', 'cisrael2', 'schoi98', 'rsyuan2', 'gxiao2', 'clee152', 'jillmcar', 'schen173', 'kaiyuan7', 'skomar4', None, 'ykoyake2', 'garnm2', 'ncryan2', 'rmahakul13', 'jarodm2', 'gmle2', 'pcp2', 'yahn22', 'hahmad7']"
7,312,69,61,56,"['jiwu2', 'jes3', 'baohl2', 'kkl3', 'mtobah2', 'jhpham2', 'reishac2', 'juliajh2', 'amyrm20', 'tjf2', 'isaxton2', 'anperry2', 'caschwa2', 'junbaek2', 'djohns85', 'aeh2', 'gofer2', 'emt2', 'coderko3', 'sarahrp2', 'allenxg2', 'nosatov2', 'vivo2', 'dahlen2', 'schoi98', 'spangnt2', 'dylanb2', 'wjsthdgkrl', 'tidate2', 'kph2', 'zehuahe2', 'shim35', 'pranjal3', 'ellenrf2', 'rwtham2', 'yuxuanw7', 'kaiyuan7', 'skomar4', 'travisc2', 'kychui2', 'eratta2', 'garnm2', 'ckw2', 'myl3', 'jarodm2', 'earamir2', 'gmle2', 'ckim123', 'dplata2', 'restep2', 'donnadc2', 'jmjin2', 'jinwoo2', 'yiqiaol3', 'bharath3', 'hahmad7']",12,"['mmm4', 'goshan2', 'qz3', 'vs10', 'pcp2', 'jaketh2', 'schen173', 'rsyuan2', 'kv2', 'nsk2', 'sili5', 'harryf2']",5,"['kevins2', 'cisrael22', 'atan14', None, 'rakam2']",73,"['jes3', 'baohl2', 'kkl3', 'mtobah2', 'mmm4', 'goshan2', 'vs10', 'jhpham2', 'reishac2', 'juliajh2', 'isaxton2', 'anperry2', 'djohns85', 'sarahrp2', 'allenxg2', 'nosatov2', 'dahlen2', 'dylanb2', 'wjsthdgkrl', 'tidate2', 'sili5', 'rakam2', 'kph2', 'zehuahe2', 'cisrael22', 'shim35', 'pranjal3', 'jaketh2', 'rwtham2', 'yuxuanw7', 'travisc2', 'kychui2', 'harryf2', 'eratta2', 'ckw2', 'earamir2', 'ckim123', 'donnadc2', 'yiqiaol3', 'jinwoo2', 'kv2', 'jiwu2', 'kevins2', 'amyrm20', 'tjf2', 'atan14', 'caschwa2', 'aeh2', 'junbaek2', 'emt2', 'gofer2', 'coderko3', 'vivo2', 'qz3', 'schoi98', 'rsyuan2', 'spangnt2', 'ellenrf2', 'schen173', 'kaiyuan7', 'skomar4', 'nsk2', None, 'garnm2', 'myl3', 'jarodm2', 'gmle2', 'pcp2', 'dplata2', 'restep2', 'jmjin2', 'bharath3', 'hahmad7']"
7,310,69,24,1,['schen173'],67,"['jiwu2', 'jes3', 'baohl2', 'kkl3', 'mtobah2', 'mmm4', 'goshan2', 'vs10', 'jhpham2', 'reishac2', 'juliajh2', 'amyrm20', 'tjf2', 'isaxton2', 'anperry2', 'caschwa2', 'junbaek2', 'djohns85', 'aeh2', 'emt2', 'gofer2', 'coderko3', 'sarahrp2', 'allenxg2', 'nosatov2', 'dahlen2', 'vivo2', 'qz3', 'schoi98', 'rsyuan2', 'spangnt2', 'dylanb2', 'wjsthdgkrl', 'tidate2', 'sili5', 'kph2', 'zehuahe2', 'shim35', 'pranjal3', 'ellenrf2', 'jaketh2', 'rwtham2', 'yuxuanw7', 'kaiyuan7', 'skomar4', 'travisc2', 'nsk2', 'kychui2', 'harryf2', 'eratta2', 'garnm2', 'ckw2', 'myl3', 'jarodm2', 'earamir2', 'ckim123', 'gmle2', 'pcp2', 'dplata2', 'donnadc2', 'yiqiaol3', 'jinwoo2', 'restep2', 'jmjin2', 'kv2', 'bharath3', 'hahmad7']",23,"['bmcnich2', 'rolijne2', 'treppa2', 'eehoneg2', 'ablee2', 'amprath2', 'rwlandi2', 'nim4', 'schoole2', 'sjshan2', 'bpfield2', 'clee152', 'neves2', 'jhardi9', 'ekisly2', None, 'zchen208', 'rpavone2', 'dp7', 'fa4', 'juliaeb2', 'emwisni2', 'ocelebi2']",91,"['bmcnich2', 'rolijne2', 'jes3', 'baohl2', 'kkl3', 'mtobah2', 'mmm4', 'goshan2', 'vs10', 'jhpham2', 'reishac2', 'juliajh2', 'eehoneg2', 'isaxton2', 'anperry2', 'djohns85', 'sarahrp2', 'allenxg2', 'nosatov2', 'dahlen2', 'amprath2', 'nim4', 'sjshan2', 'dylanb2', 'wjsthdgkrl', 'tidate2', 'sili5', 'bpfield2', 'kph2', 'neves2', 'jhardi9', 'zehuahe2', 'shim35', 'pranjal3', 'jaketh2', 'rwtham2', 'yuxuanw7', 'travisc2', 'kychui2', 'harryf2', 'zchen208', 'eratta2', 'ckw2', 'juliaeb2', 'earamir2', 'ckim123', 'donnadc2', 'yiqiaol3', 'jinwoo2', 'kv2', 'ocelebi2', 'jiwu2', 'treppa2', 'amyrm20', 'tjf2', 'caschwa2', 'ablee2', 'aeh2', 'junbaek2', 'emt2', 'gofer2', 'coderko3', 'vivo2', 'rwlandi2', 'qz3', 'schoi98', 'rsyuan2', 'schoole2', 'spangnt2', 'clee152', 'ellenrf2', 'schen173', 'kaiyuan7', 'skomar4', 'nsk2', 'ekisly2', None, 'rpavone2', 'dp7', 'garnm2', 'myl3', 'fa4', 'jarodm2', 'gmle2', 'pcp2', 'dplata2', 'restep2', 'jmjin2', 'emwisni2', 'bharath3', 'hahmad7']"
7,311,69,13,11,"['jiwu2', 'mmm4', 'goshan2', 'vs10', 'qz3', 'jaketh2', 'rsyuan2', 'kv2', 'nsk2', 'sili5', 'harryf2']",57,"['jes3', 'baohl2', 'kkl3', 'mtobah2', 'jhpham2', 'reishac2', 'juliajh2', 'isaxton2', 'anperry2', 'djohns85', 'sarahrp2', 'allenxg2', 'nosatov2', 'dahlen2', 'dylanb2', 'wjsthdgkrl', 'tidate2', 'kph2', 'zehuahe2', 'shim35', 'pranjal3', 'rwtham2', 'yuxuanw7', 'travisc2', 'kychui2', 'eratta2', 'ckw2', 'earamir2', 'ckim123', 'donnadc2', 'yiqiaol3', 'jinwoo2', 'amyrm20', 'tjf2', 'caschwa2', 'aeh2', 'junbaek2', 'emt2', 'gofer2', 'coderko3', 'vivo2', 'schoi98', 'spangnt2', 'ellenrf2', 'schen173', 'kaiyuan7', 'skomar4', 'garnm2', 'myl3', 'jarodm2', 'gmle2', 'pcp2', 'dplata2', 'restep2', 'jmjin2', 'bharath3', 'hahmad7']",2,"['clee152', None]",70,"['jes3', 'baohl2', 'kkl3', 'mtobah2', 'mmm4', 'goshan2', 'vs10', 'jhpham2', 'reishac2', 'juliajh2', 'isaxton2', 'anperry2', 'djohns85', 'sarahrp2', 'allenxg2', 'nosatov2', 'dahlen2', 'dylanb2', 'wjsthdgkrl', 'tidate2', 'sili5', 'kph2', 'zehuahe2', 'shim35', 'pranjal3', 'jaketh2', 'rwtham2', 'yuxuanw7', 'travisc2', 'kychui2', 'harryf2', 'eratta2', 'ckw2', 'earamir2', 'ckim123', 'donnadc2', 'yiqiaol3', 'jinwoo2', 'kv2', 'jiwu2', 'amyrm20', 'tjf2', 'caschwa2', 'aeh2', 'junbaek2', 'emt2', 'gofer2', 'coderko3', 'vivo2', 'qz3', 'schoi98', 'rsyuan2', 'spangnt2', 'clee152', 'ellenrf2', 'schen173', 'kaiyuan7', 'skomar4', 'nsk2', None, 'garnm2', 'myl3', 'jarodm2', 'gmle2', 'pcp2', 'dplata2', 'restep2', 'jmjin2', 'bharath3', 'hahmad7']"
8,56,62,142,53,"['omkar.chalke96', 'kunalk4796', 'dmce123456789', 'darshana.mehta', 'prithvianvekar21', 'shubham.yelange', 'sagargujar123', 'aadi', 'nihal.raut', 'smahamulkar1013', 'shreyasmoolya', 'adwaitnaik2', 'shreyahonagekar04', 'kssheetal2497', 'goyalvishal147', 'aditya.bhabhe', 'singhamod111', 'apurvamirke29', 'zeevd19', 'kacharerohan', 'arthaya.koyande28', 'sujittupe3490', 'bhangaleprit', 'rehan.mistry', 'mehulkharvi7', 'ranajay1997', 'bhushan0397', 'shrutik1997.mallick', 'arpanmodi2014', 'ritesh0111', 'kaustubhvaishampayan', 'yasir.mulla47', 'adityajoy29', 'kalekajal2', 'apeksha.shinde', 'ninad.mulay', 'vikramtirathkar96', 'kevin.z', 'spawar.ap', 'divya.sawant17497', 'pranalim11', 'aditya.prnair', 'yashshetye7', 'bhushanrsonawane1998', 'saadrahman.a', 'roy.shinde77', 'shettynitin667', 'pranaykaranjekar28', 'umeshlohote', 'jainamshah409', 'rohithebbar10', 'amey.mahadik98', 'shettysagar35']",8,"['ankitaangarkhe20', 'dhwani.vichhi', 'rulisp', 'karan97km', 'aditya.kalavagunta', 'ayansaikia1994', 'kunaldua99999', 'irfan.pindoo']",89,"['nikperu007', 'nikhilchaudhari5516', 'harshalisawant92', 'h.vyas', 'rajasiar1234', 'sagarthool', 'rahul.jethwa', 'akashupadhyay', 'rishi.mistry', 'aditya27', 'manalighorpade07', 'jugal.vaja', 'shivam.rs', 'sakshi.bhosle', 'chauhanajay4u', 'sachin.sc', 'pinak.p', 'vidushirazdan1308', 'madhuriwawale13', 'shraddha0306', 'p_vasant', 'nehagurale10', 'yash.gulve', 'jagnoor.p', 'rajaskhasgiwale8497', 'aladvait', 'arat.gouda', 'pranay.sadavarte', 'doobvoob', 'tejaskinage', 'k.siddhapura', 'vivek4238', 'jayshree90', 'rutuja.mehta', 'huzefa9702', 'jay.km', 'shipra2', 'shubhada.shetti', 'sakshi.trivedi', 'hitvena.shah', 'nikita.rp', 'zotingsagar', 'shashankyadavade68', 'mehanshi.p', 'yashsavle', 'akankshapatil', 'rajat.p', 'gaurav24', 'shah.ns', 'slimshady', 'dilipramgir', 'maitrishah', 'saurabh.palde', 'karanshah16', 'prachi04', 'thakreshivam805', 'ankita.nd', 'nitin.lalwani', 'soham.sk', 'pranesha08', 'perekarnk', 's.suvarna', 'harshal.bhole', 'shwetakanoja', 'ssoneria7', 'd.haria', 'aashutoshkhapare22', 'darshana2504', 'swapnalidethe', 's.vohra', 'kapil1410', 'shahruchi', 'chakulipatil999', 'dhanshreeshawale', 'anushkaw055', 'rushabhkothari12', 'nayan_nanohub', 'abbas.barwaniwala', 'harish.c', None, 'parin.ss', 'abhay.nadkarni', 'dishasaraiya', 'saurabhgawade.777.4.sg', 'pranali', 'nitish_mishra', 'ameysawant25597', 'kumawatmukesh71', 'rahulbirwadkar123']",150,"['nikperu007', 'nikhilchaudhari5516', 'harshalisawant92', 'omkar.chalke96', 'dmce123456789', 'rajasiar1234', 'h.vyas', 'darshana.mehta', 'sagarthool', 'sagargujar123', 'rahul.jethwa', 'akashupadhyay', 'rishi.mistry', 'aditya27', 'manalighorpade07', 'shreyahonagekar04', 'jugal.vaja', 'kssheetal2497', 'aditya.bhabhe', 'shivam.rs', 'sakshi.bhosle', 'singhamod111', 'chauhanajay4u', 'sachin.sc', 'sujittupe3490', 'rehan.mistry', 'mehulkharvi7', 'ranajay1997', 'bhushan0397', 'pinak.p', 'shrutik1997.mallick', 'dhwani.vichhi', 'ritesh0111', 'vidushirazdan1308', 'madhuriwawale13', 'shraddha0306', 'p_vasant', 'nehagurale10', 'vikramtirathkar96', 'kevin.z', 'yash.gulve', 'aditya.prnair', 'umeshlohote', 'jainamshah409', 'jagnoor.p', 'amey.mahadik98', 'kunalk4796', 'rajaskhasgiwale8497', 'prithvianvekar21', 'shubham.yelange', 'aladvait', 'aditya.kalavagunta', 'arat.gouda', 'pranay.sadavarte', 'doobvoob', 'tejaskinage', 'ankitaangarkhe20', 'k.siddhapura', 'vivek4238', 'jayshree90', 'karan97km', 'apurvamirke29', 'kacharerohan', 'rutuja.mehta', 'kunaldua99999', 'arpanmodi2014', 'huzefa9702', 'adityajoy29', 'jay.km', 'shipra2', 'shubhada.shetti', 'irfan.pindoo', 'divya.sawant17497', 'sakshi.trivedi', 'hitvena.shah', 'rulisp', 'nikita.rp', 'zotingsagar', 'shashankyadavade68', 'mehanshi.p', 'yashsavle', 'akankshapatil', 'rajat.p', 'gaurav24', 'nihal.raut', 'smahamulkar1013', 'rahulbirwadkar123', 'shah.ns', 'slimshady', 'dilipramgir', 'goyalvishal147', 'maitrishah', 'saurabh.palde', 'karanshah16', 'zeevd19', 'arthaya.koyande28', 'prachi04', 'thakreshivam805', 'ankita.nd', 'kaustubhvaishampayan', 'nitin.lalwani', 'soham.sk', 'pranesha08', 'kalekajal2', 'perekarnk', 's.suvarna', 'spawar.ap', 'harshal.bhole', 'shwetakanoja', 'saadrahman.a', 'roy.shinde77', 'shettynitin667', 'pranaykaranjekar28', 'ssoneria7', 'd.haria', 'aashutoshkhapare22', 'darshana2504', 'ayansaikia1994', 'swapnalidethe', 'aadi', 'shreyasmoolya', 's.vohra', 'kapil1410', 'adwaitnaik2', 'shahruchi', 'chakulipatil999', 'bhangaleprit', 'dhanshreeshawale', 'anushkaw055', 'rushabhkothari12', 'nayan_nanohub', 'yasir.mulla47', 'abbas.barwaniwala', 'harish.c', None, 'apeksha.shinde', 'ninad.mulay', 'parin.ss', 'abhay.nadkarni', 'dishasaraiya', 'pranalim11', 'saurabhgawade.777.4.sg', 'yashshetye7', 'pranali', 'bhushanrsonawane1998', 'nitish_mishra', 'ameysawant25597', 'kumawatmukesh71', 'rohithebbar10', 'shettysagar35']"
8,53,62,75,16,"['kunalk4796', 'shreyahonagekar04', 'shrutik1997.mallick', 'dhwani.vichhi', 'spawar.ap', 'prithvianvekar21', 'shubham.yelange', 'yasir.mulla47', 'aadi', 'smahamulkar1013', 'zeevd19', 'shreyasmoolya', 'umeshlohote', 'arthaya.koyande28', 'sujittupe3490', 'ninad.mulay']",45,"['omkar.chalke96', 'dmce123456789', 'darshana.mehta', 'sagargujar123', 'nihal.raut', 'aditya.kalavagunta', 'adwaitnaik2', 'ayansaikia1994', 'ankitaangarkhe20', 'kssheetal2497', 'goyalvishal147', 'aditya.bhabhe', 'singhamod111', 'karan97km', 'apurvamirke29', 'kacharerohan', 'kunaldua99999', 'bhangaleprit', 'rehan.mistry', 'mehulkharvi7', 'ranajay1997', 'bhushan0397', 'arpanmodi2014', 'ritesh0111', 'kaustubhvaishampayan', 'adityajoy29', 'kalekajal2', 'irfan.pindoo', 'apeksha.shinde', 'vikramtirathkar96', 'kevin.z', 'divya.sawant17497', 'pranalim11', 'aditya.prnair', 'yashshetye7', 'bhushanrsonawane1998', 'saadrahman.a', 'roy.shinde77', 'shettynitin667', 'pranaykaranjekar28', 'rulisp', 'jainamshah409', 'rohithebbar10', 'amey.mahadik98', 'shettysagar35']",59,"['nikhilchaudhari5516', 'shindedeepak129', 'rajat.p', 'evanjalinbenita', 'austin.dsouza1997', 'mayuridesai', 'selimajack26', 'akau100', 'rohitnair77880', 'shah.ns', 'vixsnair', 'aditya27', 'shaibilsabu', 'jugal.vaja', 'shivam.rs', 'chavankeasmita29', 'sakshi.bhosle', 'paras.mehta', 'jayesh.kakkad8770', 'saurabh.palde', 'sushobh', 'rohansaldanha6370', 'davidrisaac', 'sachin.sc', 'shubhamnagpure745', 'vatsal23', 'swapnalimakdey25', 'orencollaco97', 'anujchhabra25', 'jay.km', 'waynemdsouza', 'shraddha0306', 'ghevadeyogesh', 'adityadesu1', 'harish.c', None, 's.suvarna', 'pranitkumbhar19', 'adityadh943', 'parin.ss', 'sebin.bc', 'abhay.nadkarni', 'sakshi.trivedi', 'naiksandesh1998', 'priyu0964', 'patilprasad0123', '15anuchaudhari', 'vidhi.satra', 'sukanyajadhav1997', 'dishasaraiya', 'aur_mnzs', 'saurabhgawade.777.4.sg', 'maneshweta23', 'jeniferishwarya', 'shail.maroo', 'd.haria', 'wanichinmay577', 'jagnoor.p', 'omkar.karande']",120,"['nikhilchaudhari5516', 'omkar.chalke96', 'dmce123456789', 'shindedeepak129', 'darshana.mehta', 'sagargujar123', 'selimajack26', 'akau100', 'rohitnair77880', 'aditya27', 'shreyahonagekar04', 'jugal.vaja', 'kssheetal2497', 'aditya.bhabhe', 'shivam.rs', 'chavankeasmita29', 'sakshi.bhosle', 'paras.mehta', 'singhamod111', 'sushobh', 'sachin.sc', 'sujittupe3490', 'rehan.mistry', 'mehulkharvi7', 'ranajay1997', 'bhushan0397', 'orencollaco97', 'shrutik1997.mallick', 'dhwani.vichhi', 'ritesh0111', 'waynemdsouza', 'shraddha0306', 'vikramtirathkar96', 'kevin.z', 'naiksandesh1998', 'priyu0964', 'aditya.prnair', 'patilprasad0123', 'vidhi.satra', 'maneshweta23', 'jeniferishwarya', 'umeshlohote', 'jainamshah409', 'jagnoor.p', 'amey.mahadik98', 'kunalk4796', 'prithvianvekar21', 'evanjalinbenita', 'shubham.yelange', 'austin.dsouza1997', 'mayuridesai', 'aditya.kalavagunta', 'ankitaangarkhe20', 'karan97km', 'apurvamirke29', 'rohansaldanha6370', 'davidrisaac', 'shubhamnagpure745', 'kacharerohan', 'kunaldua99999', 'swapnalimakdey25', 'arpanmodi2014', 'adityajoy29', 'jay.km', 'adityadesu1', 'irfan.pindoo', 'divya.sawant17497', 'sakshi.trivedi', 'aur_mnzs', 'rulisp', 'shail.maroo', 'omkar.karande', 'rajat.p', 'nihal.raut', 'smahamulkar1013', 'shah.ns', 'goyalvishal147', 'saurabh.palde', 'zeevd19', 'arthaya.koyande28', 'vatsal23', 'anujchhabra25', 'kaustubhvaishampayan', 'kalekajal2', 's.suvarna', 'pranitkumbhar19', 'sebin.bc', 'spawar.ap', '15anuchaudhari', 'sukanyajadhav1997', 'saadrahman.a', 'roy.shinde77', 'shettynitin667', 'pranaykaranjekar28', 'd.haria', 'ayansaikia1994', 'aadi', 'shreyasmoolya', 'adwaitnaik2', 'vixsnair', 'shaibilsabu', 'jayesh.kakkad8770', 'bhangaleprit', 'yasir.mulla47', 'ghevadeyogesh', 'harish.c', None, 'apeksha.shinde', 'ninad.mulay', 'adityadh943', 'parin.ss', 'abhay.nadkarni', 'dishasaraiya', 'pranalim11', 'saurabhgawade.777.4.sg', 'yashshetye7', 'bhushanrsonawane1998', 'wanichinmay577', 'rohithebbar10', 'shettysagar35']"
8,48,62,35,1,['dhwani.vichhi'],60,"['omkar.chalke96', 'kunalk4796', 'dmce123456789', 'darshana.mehta', 'prithvianvekar21', 'shubham.yelange', 'sagargujar123', 'aadi', 'nihal.raut', 'smahamulkar1013', 'shreyasmoolya', 'aditya.kalavagunta', 'adwaitnaik2', 'ayansaikia1994', 'ankitaangarkhe20', 'shreyahonagekar04', 'kssheetal2497', 'goyalvishal147', 'aditya.bhabhe', 'singhamod111', 'karan97km', 'apurvamirke29', 'zeevd19', 'kacharerohan', 'arthaya.koyande28', 'kunaldua99999', 'sujittupe3490', 'bhangaleprit', 'rehan.mistry', 'mehulkharvi7', 'ranajay1997', 'bhushan0397', 'shrutik1997.mallick', 'arpanmodi2014', 'ritesh0111', 'kaustubhvaishampayan', 'yasir.mulla47', 'adityajoy29', 'kalekajal2', 'irfan.pindoo', 'ninad.mulay', 'apeksha.shinde', 'vikramtirathkar96', 'kevin.z', 'spawar.ap', 'divya.sawant17497', 'pranalim11', 'aditya.prnair', 'yashshetye7', 'bhushanrsonawane1998', 'saadrahman.a', 'roy.shinde77', 'shettynitin667', 'pranaykaranjekar28', 'umeshlohote', 'rulisp', 'jainamshah409', 'rohithebbar10', 'amey.mahadik98', 'shettysagar35']",34,"['harshada.benke', 'rajat.p', 'rahul.jethwa', 'mayuresh.auti', 'rishi.mistry', 'shah.ns', 'aditya27', 'ragini.g', 'jugal.vaja', 'shivam.rs', 'paras.mehta', 'saurabh.palde', 'arati.mule2900', 'sachin.sc', 'rutuja.mehta', 'pinak.p', 'jay.km', 'anuj.cm', 'umed.jadhav', 'harish.c', None, 's.suvarna', 'parin.ss', 'abhay.nadkarni', 'hitvena.shah', 'sakshi.trivedi', 'dishasaraiya', 'pritish.mishra1', 'vidhi.satra', 'shail.maroo', 'nikita.rp', 'd.haria', 'jagnoor.p', 'omkar.karande']",95,"['omkar.chalke96', 'dmce123456789', 'darshana.mehta', 'rajat.p', 'sagargujar123', 'rahul.jethwa', 'nihal.raut', 'smahamulkar1013', 'rishi.mistry', 'shah.ns', 'aditya27', 'shreyahonagekar04', 'ragini.g', 'jugal.vaja', 'kssheetal2497', 'goyalvishal147', 'aditya.bhabhe', 'shivam.rs', 'paras.mehta', 'singhamod111', 'saurabh.palde', 'zeevd19', 'sachin.sc', 'arthaya.koyande28', 'sujittupe3490', 'rehan.mistry', 'mehulkharvi7', 'ranajay1997', 'bhushan0397', 'pinak.p', 'shrutik1997.mallick', 'dhwani.vichhi', 'ritesh0111', 'kaustubhvaishampayan', 'anuj.cm', 'kalekajal2', 's.suvarna', 'vikramtirathkar96', 'kevin.z', 'spawar.ap', 'aditya.prnair', 'pritish.mishra1', 'vidhi.satra', 'saadrahman.a', 'roy.shinde77', 'shettynitin667', 'pranaykaranjekar28', 'umeshlohote', 'd.haria', 'jainamshah409', 'jagnoor.p', 'ayansaikia1994', 'amey.mahadik98', 'kunalk4796', 'harshada.benke', 'prithvianvekar21', 'shubham.yelange', 'aadi', 'shreyasmoolya', 'aditya.kalavagunta', 'mayuresh.auti', 'adwaitnaik2', 'ankitaangarkhe20', 'karan97km', 'apurvamirke29', 'arati.mule2900', 'kacharerohan', 'rutuja.mehta', 'kunaldua99999', 'bhangaleprit', 'arpanmodi2014', 'yasir.mulla47', 'adityajoy29', 'jay.km', 'umed.jadhav', 'harish.c', None, 'irfan.pindoo', 'ninad.mulay', 'apeksha.shinde', 'parin.ss', 'abhay.nadkarni', 'divya.sawant17497', 'hitvena.shah', 'sakshi.trivedi', 'dishasaraiya', 'pranalim11', 'yashshetye7', 'bhushanrsonawane1998', 'rulisp', 'shail.maroo', 'nikita.rp', 'rohithebbar10', 'omkar.karande', 'shettysagar35']"
8,59,62,8,1,['amey.mahadik98'],60,"['omkar.chalke96', 'kunalk4796', 'dmce123456789', 'darshana.mehta', 'rohithebbar10', 'prithvianvekar21', 'shubham.yelange', 'sagargujar123', 'aadi', 'nihal.raut', 'smahamulkar1013', 'shreyasmoolya', 'aditya.kalavagunta', 'adwaitnaik2', 'ankitaangarkhe20', 'shreyahonagekar04', 'kssheetal2497', 'goyalvishal147', 'aditya.bhabhe', 'singhamod111', 'karan97km', 'apurvamirke29', 'zeevd19', 'kacharerohan', 'arthaya.koyande28', 'kunaldua99999', 'sujittupe3490', 'bhangaleprit', 'rehan.mistry', 'mehulkharvi7', 'ranajay1997', 'bhushan0397', 'shrutik1997.mallick', 'dhwani.vichhi', 'arpanmodi2014', 'ritesh0111', 'kaustubhvaishampayan', 'yasir.mulla47', 'adityajoy29', 'kalekajal2', 'irfan.pindoo', 'ninad.mulay', 'apeksha.shinde', 'vikramtirathkar96', 'kevin.z', 'spawar.ap', 'divya.sawant17497', 'pranalim11', 'aditya.prnair', 'yashshetye7', 'bhushanrsonawane1998', 'saadrahman.a', 'roy.shinde77', 'shettynitin667', 'pranaykaranjekar28', 'umeshlohote', 'rulisp', 'jainamshah409', 'ayansaikia1994', 'shettysagar35']",7,"['zotingsagar1', 'shwetakanoja', 'gaurav24', 'vyardly94', 'vidushirazdan1308', None, 'kapil1410']",68,"['zotingsagar1', 'omkar.chalke96', 'kunalk4796', 'dmce123456789', 'darshana.mehta', 'rohithebbar10', 'prithvianvekar21', 'gaurav24', 'shubham.yelange', 'sagargujar123', 'aadi', 'nihal.raut', 'smahamulkar1013', 'shreyasmoolya', 'aditya.kalavagunta', 'kapil1410', 'adwaitnaik2', 'ankitaangarkhe20', 'shreyahonagekar04', 'kssheetal2497', 'goyalvishal147', 'aditya.bhabhe', 'singhamod111', 'karan97km', 'apurvamirke29', 'vyardly94', 'zeevd19', 'kacharerohan', 'arthaya.koyande28', 'kunaldua99999', 'sujittupe3490', 'bhangaleprit', 'rehan.mistry', 'mehulkharvi7', 'ranajay1997', 'bhushan0397', 'shrutik1997.mallick', 'dhwani.vichhi', 'arpanmodi2014', 'ritesh0111', 'kaustubhvaishampayan', 'yasir.mulla47', 'adityajoy29', 'vidushirazdan1308', 'kalekajal2', None, 'irfan.pindoo', 'ninad.mulay', 'apeksha.shinde', 'vikramtirathkar96', 'kevin.z', 'spawar.ap', 'divya.sawant17497', 'shwetakanoja', 'pranalim11', 'aditya.prnair', 'yashshetye7', 'bhushanrsonawane1998', 'saadrahman.a', 'roy.shinde77', 'shettynitin667', 'pranaykaranjekar28', 'umeshlohote', 'rulisp', 'jainamshah409', 'ayansaikia1994', 'amey.mahadik98', 'shettysagar35']"
8,58,62,7,3,"['aditya.prnair', 'amey.mahadik98', 'darshana.mehta']",58,"['omkar.chalke96', 'kunalk4796', 'dmce123456789', 'rohithebbar10', 'prithvianvekar21', 'shubham.yelange', 'sagargujar123', 'aadi', 'nihal.raut', 'smahamulkar1013', 'shreyasmoolya', 'aditya.kalavagunta', 'adwaitnaik2', 'ankitaangarkhe20', 'shreyahonagekar04', 'kssheetal2497', 'goyalvishal147', 'aditya.bhabhe', 'singhamod111', 'karan97km', 'apurvamirke29', 'zeevd19', 'kacharerohan', 'arthaya.koyande28', 'kunaldua99999', 'sujittupe3490', 'bhangaleprit', 'rehan.mistry', 'mehulkharvi7', 'ranajay1997', 'bhushan0397', 'shrutik1997.mallick', 'dhwani.vichhi', 'arpanmodi2014', 'ritesh0111', 'kaustubhvaishampayan', 'yasir.mulla47', 'adityajoy29', 'kalekajal2', 'irfan.pindoo', 'ninad.mulay', 'apeksha.shinde', 'vikramtirathkar96', 'kevin.z', 'spawar.ap', 'divya.sawant17497', 'pranalim11', 'yashshetye7', 'bhushanrsonawane1998', 'saadrahman.a', 'roy.shinde77', 'shettynitin667', 'pranaykaranjekar28', 'umeshlohote', 'rulisp', 'jainamshah409', 'ayansaikia1994', 'shettysagar35']",4,"[None, 'zotingsagar01', 'darshana2504', 'kapil1410']",65,"['omkar.chalke96', 'kunalk4796', 'dmce123456789', 'darshana.mehta', 'rohithebbar10', 'prithvianvekar21', 'shubham.yelange', 'sagargujar123', 'aadi', 'nihal.raut', 'smahamulkar1013', 'shreyasmoolya', 'aditya.kalavagunta', 'kapil1410', 'adwaitnaik2', 'zotingsagar01', 'ankitaangarkhe20', 'shreyahonagekar04', 'kssheetal2497', 'goyalvishal147', 'aditya.bhabhe', 'singhamod111', 'karan97km', 'apurvamirke29', 'zeevd19', 'kacharerohan', 'arthaya.koyande28', 'kunaldua99999', 'sujittupe3490', 'bhangaleprit', 'rehan.mistry', 'mehulkharvi7', 'ranajay1997', 'bhushan0397', 'shrutik1997.mallick', 'dhwani.vichhi', 'arpanmodi2014', 'ritesh0111', 'kaustubhvaishampayan', 'yasir.mulla47', 'adityajoy29', 'kalekajal2', None, 'irfan.pindoo', 'ninad.mulay', 'apeksha.shinde', 'vikramtirathkar96', 'kevin.z', 'spawar.ap', 'divya.sawant17497', 'pranalim11', 'aditya.prnair', 'yashshetye7', 'bhushanrsonawane1998', 'saadrahman.a', 'roy.shinde77', 'shettynitin667', 'pranaykaranjekar28', 'umeshlohote', 'rulisp', 'darshana2504', 'jainamshah409', 'ayansaikia1994', 'amey.mahadik98', 'shettysagar35']"
9,89,61,50,5,"['jonathanrasmussen1996', 'adrianycchan', 'k31berte', 'kylenova', 'h_waterloo']",55,"['supichayajune14', 'nikoschatzarakis', 'i.mirasifali', 'phacharapon1999', 'tortrkool.s', 'milkjarin', 'faraz.najam13', 'piyatida.sukee', 'tanapon_hirunkham', 'seanwoneill', 'kulthida150', 'raemyaowaret', 'emm_emmypan', 'nknitchakan', 'por.101041.prasat', 'annikak19081988', 'salingy', 'simsan', 'tpuangmali', 'battlelogongame', 'koonnink1', 'benlawson8507', 'sk.zeeshan1992', 'suphawan_', 'sedtee_fay', 'piper.color.nn', 'jatinkchaudhary', 'patharabhornkhamket', 'kanokwan', 'pattaweeboonmak', 'kornchada', 'punyanut.nong', 'fluk.flic', 'prang110641', 'thinktong_231141', 'wuyifernnn', 'osipov1140', 'wuttirat_boonkaew', 'nuttaponka', 'nammon.m', 'pansawunya', 'ankit.gujarat', 'i.o0850091121', 'davidnaja', 'pang.pang30', 'poo_p101', 'fan080170', '40926wannapa', 'irenef04', 'abhinew', 'nitisartnupangtha', '150_cm', 'nanasung', 'lalita.namsri', 'pinkkpiair']",45,"['smithamdan', 'my2low', 'cas', 'zifanek', 'agill16', 'coursework', 'qianshu', 'deminyin', 'reed.maximilian', 'vyshakh.sanjeev', 'jthomasyang', 'ne471nanoschool', 'zack.strike', 'jasminek', 'mikejewski', 'amargharial', 'graemek4', 'cui.wentao', 'yuxiao.zhou', 'wkap', 'arunrangahotmail.ca', 'sumi_sumi_7', 'k.malejczuk', 'mwin', 'j442chen', None, 'takdeniz', 'rainwind2010', 'manasakaniselvan', 'mototsune1', 'zameer13b', 'drousso', 'ryanj', 'robertbennett', 'l2mcgrat', 'adrianeitzen', 'sw4chan', 'saravind', 'cullentielemans', 'anthony.le3124', 'khadijaasad', 'calena3', 'theeran', 'rendall_jenner', 'fade237']",105,"['supichayajune14', 'nikoschatzarakis', 'coursework', 'zifanek', 'milkjarin', 'piyatida.sukee', 'tanapon_hirunkham', 'reed.maximilian', 'kulthida150', 'vyshakh.sanjeev', 'nknitchakan', 'jthomasyang', 'tpuangmali', 'simsan', 'jasminek', 'mikejewski', 'graemek4', 'koonnink1', 'cui.wentao', 'yuxiao.zhou', 'sedtee_fay', 'arunrangahotmail.ca', 'piper.color.nn', 'jatinkchaudhary', 'sumi_sumi_7', 'patharabhornkhamket', 'kanokwan', 'pattaweeboonmak', 'kornchada', 'punyanut.nong', 'thinktong_231141', 'k.malejczuk', 'wuyifernnn', 'osipov1140', 'mwin', 'nammon.m', 'takdeniz', 'pansawunya', 'rainwind2010', 'manasakaniselvan', 'zameer13b', 'adrianeitzen', 'robertbennett', 'khadijaasad', 'fan080170', '40926wannapa', '150_cm', 'rendall_jenner', 'fade237', 'smithamdan', 'i.mirasifali', 'my2low', 'cas', 'agill16', 'phacharapon1999', 'tortrkool.s', 'qianshu', 'deminyin', 'faraz.najam13', 'theeran', 'seanwoneill', 'raemyaowaret', 'adrianycchan', 'emm_emmypan', 'ne471nanoschool', 'por.101041.prasat', 'annikak19081988', 'salingy', 'battlelogongame', 'zack.strike', 'amargharial', 'benlawson8507', 'sk.zeeshan1992', 'suphawan_', 'jonathanrasmussen1996', 'wkap', 'fluk.flic', 'prang110641', 'wuttirat_boonkaew', 'h_waterloo', 'nuttaponka', 'j442chen', None, 'ankit.gujarat', 'mototsune1', 'ryanj', 'i.o0850091121', 'davidnaja', 'drousso', 'l2mcgrat', 'sw4chan', 'anthony.le3124', 'saravind', 'k31berte', 'pang.pang30', 'poo_p101', 'kylenova', 'nitisartnupangtha', 'irenef04', 'abhinew', 'nanasung', 'cullentielemans', 'calena3', 'lalita.namsri', 'pinkkpiair']"
9,389,61,34,31,"['supichayajune14', 'phacharapon1999', 'milkjarin', 'tanapon_hirunkham', 'raemyaowaret', 'nknitchakan', 'por.101041.prasat', 'battlelogongame', 'sedtee_fay', 'piper.color.nn', 'patharabhornkhamket', 'pattaweeboonmak', 'kanokwan', 'kornchada', 'punyanut.nong', 'thinktong_231141', 'wuyifernnn', 'wuttirat_boonkaew', 'nuttaponka', 'nammon.m', 'pansawunya', 'i.o0850091121', 'davidnaja', 'poo_p101', 'pang.pang30', 'fan080170', 'nitisartnupangtha', '40926wannapa', 'nanasung', '150_cm', 'lalita.namsri']",29,"['nikoschatzarakis', 'i.mirasifali', 'tortrkool.s', 'faraz.najam13', 'piyatida.sukee', 'seanwoneill', 'kulthida150', 'adrianycchan', 'emm_emmypan', 'annikak19081988', 'salingy', 'simsan', 'tpuangmali', 'koonnink1', 'benlawson8507', 'sk.zeeshan1992', 'suphawan_', 'jonathanrasmussen1996', 'jatinkchaudhary', 'fluk.flic', 'prang110641', 'osipov1140', 'h_waterloo', 'ankit.gujarat', 'k31berte', 'kylenova', 'irenef04', 'abhinew', 'pinkkpiair']",3,"['sungputpong', 'saruttaya_love', None]",63,"['supichayajune14', 'nikoschatzarakis', 'milkjarin', 'piyatida.sukee', 'tanapon_hirunkham', 'kulthida150', 'nknitchakan', 'tpuangmali', 'simsan', 'sungputpong', 'koonnink1', 'sedtee_fay', 'piper.color.nn', 'jatinkchaudhary', 'patharabhornkhamket', 'kanokwan', 'pattaweeboonmak', 'kornchada', 'punyanut.nong', 'thinktong_231141', 'wuyifernnn', 'osipov1140', 'nammon.m', 'pansawunya', 'fan080170', '40926wannapa', '150_cm', 'i.mirasifali', 'phacharapon1999', 'tortrkool.s', 'faraz.najam13', 'seanwoneill', 'raemyaowaret', 'adrianycchan', 'emm_emmypan', 'saruttaya_love', 'por.101041.prasat', 'annikak19081988', 'salingy', 'battlelogongame', 'benlawson8507', 'sk.zeeshan1992', 'suphawan_', 'jonathanrasmussen1996', 'fluk.flic', 'prang110641', 'wuttirat_boonkaew', 'h_waterloo', 'nuttaponka', None, 'ankit.gujarat', 'i.o0850091121', 'davidnaja', 'k31berte', 'pang.pang30', 'poo_p101', 'kylenova', 'nitisartnupangtha', 'irenef04', 'abhinew', 'nanasung', 'lalita.namsri', 'pinkkpiair']"
9,388,61,30,28,"['supichayajune14', 'phacharapon1999', 'tortrkool.s', 'tanapon_hirunkham', 'emm_emmypan', 'por.101041.prasat', 'salingy', 'tpuangmali', 'battlelogongame', 'koonnink1', 'sedtee_fay', 'patharabhornkhamket', 'pattaweeboonmak', 'kanokwan', 'thinktong_231141', 'fluk.flic', 'wuyifernnn', 'wuttirat_boonkaew', 'nuttaponka', 'nammon.m', 'i.o0850091121', 'poo_p101', 'pang.pang30', 'fan080170', 'nitisartnupangtha', '40926wannapa', 'nanasung', 'lalita.namsri']",32,"['nikoschatzarakis', 'i.mirasifali', 'milkjarin', 'faraz.najam13', 'piyatida.sukee', 'seanwoneill', 'kulthida150', 'adrianycchan', 'raemyaowaret', 'nknitchakan', 'annikak19081988', 'simsan', 'benlawson8507', 'sk.zeeshan1992', 'suphawan_', 'jonathanrasmussen1996', 'piper.color.nn', 'jatinkchaudhary', 'kornchada', 'punyanut.nong', 'prang110641', 'osipov1140', 'h_waterloo', 'pansawunya', 'ankit.gujarat', 'davidnaja', 'k31berte', 'kylenova', 'irenef04', 'abhinew', '150_cm', 'pinkkpiair']",2,"['saruttaya_love', None]",62,"['supichayajune14', 'nikoschatzarakis', 'milkjarin', 'piyatida.sukee', 'tanapon_hirunkham', 'kulthida150', 'nknitchakan', 'tpuangmali', 'simsan', 'koonnink1', 'sedtee_fay', 'piper.color.nn', 'jatinkchaudhary', 'patharabhornkhamket', 'kanokwan', 'pattaweeboonmak', 'kornchada', 'punyanut.nong', 'thinktong_231141', 'wuyifernnn', 'osipov1140', 'nammon.m', 'pansawunya', 'fan080170', '40926wannapa', '150_cm', 'i.mirasifali', 'phacharapon1999', 'tortrkool.s', 'faraz.najam13', 'seanwoneill', 'raemyaowaret', 'adrianycchan', 'emm_emmypan', 'saruttaya_love', 'por.101041.prasat', 'annikak19081988', 'salingy', 'battlelogongame', 'benlawson8507', 'sk.zeeshan1992', 'suphawan_', 'jonathanrasmussen1996', 'fluk.flic', 'prang110641', 'wuttirat_boonkaew', 'h_waterloo', 'nuttaponka', None, 'ankit.gujarat', 'i.o0850091121', 'davidnaja', 'k31berte', 'pang.pang30', 'poo_p101', 'kylenova', 'nitisartnupangtha', 'irenef04', 'abhinew', 'nanasung', 'lalita.namsri', 'pinkkpiair']"
9,390,61,14,12,"['raemyaowaret', 'i.o0850091121', 'davidnaja', 'nammon.m', 'por.101041.prasat', 'punyanut.nong', 'poo_p101', 'nitisartnupangtha', 'kornchada', 'battlelogongame', 'lalita.namsri', 'suphawan_']",48,"['supichayajune14', 'nikoschatzarakis', 'i.mirasifali', 'phacharapon1999', 'tortrkool.s', 'milkjarin', 'faraz.najam13', 'piyatida.sukee', 'tanapon_hirunkham', 'seanwoneill', 'kulthida150', 'adrianycchan', 'emm_emmypan', 'nknitchakan', 'annikak19081988', 'salingy', 'simsan', 'tpuangmali', 'koonnink1', 'benlawson8507', 'sk.zeeshan1992', 'sedtee_fay', 'jonathanrasmussen1996', 'piper.color.nn', 'jatinkchaudhary', 'patharabhornkhamket', 'kanokwan', 'pattaweeboonmak', 'fluk.flic', 'prang110641', 'thinktong_231141', 'wuyifernnn', 'osipov1140', 'wuttirat_boonkaew', 'h_waterloo', 'nuttaponka', 'pansawunya', 'ankit.gujarat', 'k31berte', 'pang.pang30', 'fan080170', '40926wannapa', 'irenef04', 'abhinew', 'kylenova', '150_cm', 'nanasung', 'pinkkpiair']",2,"['saruttaya_love', None]",62,"['supichayajune14', 'nikoschatzarakis', 'i.mirasifali', 'phacharapon1999', 'tortrkool.s', 'milkjarin', 'faraz.najam13', 'piyatida.sukee', 'tanapon_hirunkham', 'seanwoneill', 'kulthida150', 'adrianycchan', 'raemyaowaret', 'emm_emmypan', 'saruttaya_love', 'nknitchakan', 'por.101041.prasat', 'annikak19081988', 'salingy', 'simsan', 'tpuangmali', 'battlelogongame', 'koonnink1', 'benlawson8507', 'sk.zeeshan1992', 'suphawan_', 'sedtee_fay', 'jonathanrasmussen1996', 'piper.color.nn', 'jatinkchaudhary', 'patharabhornkhamket', 'kanokwan', 'pattaweeboonmak', 'kornchada', 'punyanut.nong', 'fluk.flic', 'prang110641', 'thinktong_231141', 'wuyifernnn', 'osipov1140', 'wuttirat_boonkaew', 'h_waterloo', 'nuttaponka', 'nammon.m', None, 'pansawunya', 'ankit.gujarat', 'i.o0850091121', 'davidnaja', 'k31berte', 'pang.pang30', 'poo_p101', 'fan080170', '40926wannapa', 'irenef04', 'abhinew', 'kylenova', '150_cm', 'nitisartnupangtha', 'lalita.namsri', 'nanasung', 'pinkkpiair']"
9,387,61,11,2,"['benlawson8507', 'simsan']",58,"['supichayajune14', 'nikoschatzarakis', 'i.mirasifali', 'phacharapon1999', 'tortrkool.s', 'milkjarin', 'faraz.najam13', 'piyatida.sukee', 'tanapon_hirunkham', 'seanwoneill', 'kulthida150', 'adrianycchan', 'raemyaowaret', 'emm_emmypan', 'nknitchakan', 'por.101041.prasat', 'annikak19081988', 'salingy', 'tpuangmali', 'battlelogongame', 'koonnink1', 'sk.zeeshan1992', 'suphawan_', 'sedtee_fay', 'jonathanrasmussen1996', 'piper.color.nn', 'jatinkchaudhary', 'patharabhornkhamket', 'kanokwan', 'pattaweeboonmak', 'kornchada', 'punyanut.nong', 'fluk.flic', 'prang110641', 'thinktong_231141', 'wuyifernnn', 'osipov1140', 'wuttirat_boonkaew', 'h_waterloo', 'nuttaponka', 'nammon.m', 'pansawunya', 'ankit.gujarat', 'i.o0850091121', 'davidnaja', 'k31berte', 'pang.pang30', 'poo_p101', 'fan080170', '40926wannapa', 'irenef04', 'abhinew', 'kylenova', '150_cm', 'nitisartnupangtha', 'lalita.namsri', 'nanasung', 'pinkkpiair']",9,"['mike10rivera', 'briscoej3', None, 'eddie93jw', 'vinskoj', 'ruemenaj', 'barnessa', 'lawsonbe', 'berezeol']",69,"['supichayajune14', 'nikoschatzarakis', 'briscoej3', 'i.mirasifali', 'phacharapon1999', 'tortrkool.s', 'vinskoj', 'milkjarin', 'lawsonbe', 'faraz.najam13', 'piyatida.sukee', 'tanapon_hirunkham', 'seanwoneill', 'kulthida150', 'adrianycchan', 'raemyaowaret', 'emm_emmypan', 'nknitchakan', 'por.101041.prasat', 'annikak19081988', 'salingy', 'simsan', 'tpuangmali', 'battlelogongame', 'koonnink1', 'benlawson8507', 'sk.zeeshan1992', 'barnessa', 'suphawan_', 'sedtee_fay', 'jonathanrasmussen1996', 'piper.color.nn', 'jatinkchaudhary', 'patharabhornkhamket', 'kanokwan', 'pattaweeboonmak', 'kornchada', 'punyanut.nong', 'fluk.flic', 'prang110641', 'thinktong_231141', 'eddie93jw', 'wuyifernnn', 'osipov1140', 'wuttirat_boonkaew', 'h_waterloo', 'ruemenaj', 'nuttaponka', 'nammon.m', None, 'pansawunya', 'ankit.gujarat', 'mike10rivera', 'i.o0850091121', 'davidnaja', 'k31berte', 'pang.pang30', 'poo_p101', 'fan080170', '40926wannapa', 'irenef04', 'abhinew', 'kylenova', '150_cm', 'nitisartnupangtha', 'lalita.namsri', 'nanasung', 'pinkkpiair', 'berezeol']"
9,391,61,8,7,"['kulthida150', 'emm_emmypan', 'nknitchakan', 'prang110641', 'tortrkool.s', '150_cm', 'piyatida.sukee']",53,"['supichayajune14', 'nikoschatzarakis', 'i.mirasifali', 'phacharapon1999', 'milkjarin', 'faraz.najam13', 'tanapon_hirunkham', 'seanwoneill', 'adrianycchan', 'raemyaowaret', 'por.101041.prasat', 'annikak19081988', 'salingy', 'simsan', 'tpuangmali', 'battlelogongame', 'koonnink1', 'benlawson8507', 'sk.zeeshan1992', 'suphawan_', 'sedtee_fay', 'jonathanrasmussen1996', 'piper.color.nn', 'jatinkchaudhary', 'patharabhornkhamket', 'kanokwan', 'pattaweeboonmak', 'kornchada', 'punyanut.nong', 'fluk.flic', 'thinktong_231141', 'wuyifernnn', 'osipov1140', 'wuttirat_boonkaew', 'h_waterloo', 'nuttaponka', 'nammon.m', 'pansawunya', 'ankit.gujarat', 'i.o0850091121', 'davidnaja', 'k31berte', 'pang.pang30', 'poo_p101', 'fan080170', '40926wannapa', 'irenef04', 'abhinew', 'kylenova', 'nitisartnupangtha', 'lalita.namsri', 'nanasung', 'pinkkpiair']",1,[None],61,"['supichayajune14', 'nikoschatzarakis', 'i.mirasifali', 'phacharapon1999', 'tortrkool.s', 'milkjarin', 'faraz.najam13', 'piyatida.sukee', 'tanapon_hirunkham', 'seanwoneill', 'kulthida150', 'adrianycchan', 'raemyaowaret', 'emm_emmypan', 'nknitchakan', 'por.101041.prasat', 'annikak19081988', 'salingy', 'simsan', 'tpuangmali', 'battlelogongame', 'koonnink1', 'benlawson8507', 'sk.zeeshan1992', 'suphawan_', 'sedtee_fay', 'jonathanrasmussen1996', 'piper.color.nn', 'jatinkchaudhary', 'patharabhornkhamket', 'kanokwan', 'pattaweeboonmak', 'kornchada', 'punyanut.nong', 'fluk.flic', 'prang110641', 'thinktong_231141', 'wuyifernnn', 'osipov1140', 'wuttirat_boonkaew', 'h_waterloo', 'nuttaponka', 'nammon.m', None, 'pansawunya', 'ankit.gujarat', 'i.o0850091121', 'davidnaja', 'k31berte', 'pang.pang30', 'poo_p101', 'fan080170', '40926wannapa', 'irenef04', 'abhinew', 'kylenova', '150_cm', 'nitisartnupangtha', 'lalita.namsri', 'nanasung', 'pinkkpiair']"
10,197,59,26,25,"['dj1995', 'z5128332', 'quintusloveme123', 'h.indrianitapratiwi', 'xuanzhi', 'guandl9528', 'sqqq', 'bellabai', 'chenzeli', 'oliverwang', 'mingdongxie', 'lostxici', 'cecilia', 'zwlulu222', 'ywhkqthg0010', 'z5119373', 'z5170091', 'jianan', 'sevensevenbaby', 'chuangliu1103', 'ethan990', 'xiaohan1226', 'duolahaotian', 'wh123456', 'lzhpagpag']",33,"['joepete8', 'khusaini227', 'qikunliao1212', 'u0897949', 'lym1994723', 'wendycheche214', 'u0927220', 'wyx343332275', 'innakurg', 'u0407716', 'u0921074', 'kristenzhang0721', 'u1214602', 'u0908354', 'ainuddin', 'sabinnepal', 'u1025731', 'z5177843', 'sakichokie', 'evansmail22', 'z5176339', 'u0992040', 'u0460831', 'u0658961', 'michae28', 'nazeerulhelmi', 'rajanneupane', 'a.vant', 'aliknielsen', 'dm1lovich', 'u0885428', 'u1012528', 'u0762357']",1,[None],59,"['joepete8', 'z5128332', 'quintusloveme123', 'khusaini227', 'h.indrianitapratiwi', 'qikunliao1212', 'u0897949', 'lym1994723', 'wyx343332275', 'innakurg', 'u0407716', 'chenzeli', 'u0921074', 'kristenzhang0721', 'u0908354', 'oliverwang', 'ainuddin', 'sabinnepal', 'sakichokie', 'zwlulu222', 'ywhkqthg0010', 'u0992040', 'z5170091', 'jianan', 'michae28', 'nazeerulhelmi', 'rajanneupane', 'aliknielsen', 'u1012528', 'wh123456', 'lzhpagpag', 'u0762357', 'dj1995', 'xuanzhi', 'guandl9528', 'sqqq', 'wendycheche214', 'bellabai', 'u0927220', 'u1214602', 'u1025731', 'mingdongxie', 'lostxici', 'cecilia', 'z5177843', 'evansmail22', 'z5176339', 'z5119373', 'u0460831', 'u0658961', None, 'sevensevenbaby', 'chuangliu1103', 'a.vant', 'dm1lovich', 'ethan990', 'u0885428', 'xiaohan1226', 'duolahaotian']"
10,196,59,24,23,"['joepete8', 'khusaini227', 'u0897949', 'u0927220', 'u0407716', 'u0921074', 'u1214602', 'u0908354', 'ainuddin', 'sabinnepal', 'u1025731', 'sakichokie', 'evansmail22', 'u0460831', 'u0992040', 'u0658961', 'michae28', 'nazeerulhelmi', 'rajanneupane', 'dm1lovich', 'u0885428', 'u1012528', 'u0762357']",35,"['dj1995', 'z5128332', 'quintusloveme123', 'h.indrianitapratiwi', 'xuanzhi', 'qikunliao1212', 'guandl9528', 'lym1994723', 'sqqq', 'wendycheche214', 'bellabai', 'wyx343332275', 'innakurg', 'chenzeli', 'kristenzhang0721', 'oliverwang', 'mingdongxie', 'lostxici', 'cecilia', 'z5177843', 'zwlulu222', 'z5119373', 'ywhkqthg0010', 'z5176339', 'z5170091', 'jianan', 'sevensevenbaby', 'chuangliu1103', 'a.vant', 'aliknielsen', 'ethan990', 'xiaohan1226', 'duolahaotian', 'wh123456', 'lzhpagpag']",1,[None],59,"['joepete8', 'z5128332', 'quintusloveme123', 'khusaini227', 'h.indrianitapratiwi', 'qikunliao1212', 'u0897949', 'lym1994723', 'wyx343332275', 'innakurg', 'u0407716', 'chenzeli', 'u0921074', 'kristenzhang0721', 'u0908354', 'oliverwang', 'ainuddin', 'sabinnepal', 'sakichokie', 'zwlulu222', 'ywhkqthg0010', 'u0992040', 'z5170091', 'jianan', 'michae28', 'nazeerulhelmi', 'rajanneupane', 'aliknielsen', 'u1012528', 'wh123456', 'lzhpagpag', 'u0762357', 'dj1995', 'xuanzhi', 'guandl9528', 'sqqq', 'wendycheche214', 'bellabai', 'u0927220', 'u1214602', 'u1025731', 'mingdongxie', 'lostxici', 'cecilia', 'z5177843', 'evansmail22', 'z5176339', 'z5119373', 'u0460831', 'u0658961', None, 'sevensevenbaby', 'chuangliu1103', 'a.vant', 'dm1lovich', 'ethan990', 'u0885428', 'xiaohan1226', 'duolahaotian']"
11,441,59,26,23,"['kevinvallejo', 'stevejohns', 'timphero', 'victoriavolk', 'a3dman00', 'sjriley', 'indigocloud123', 'jordanvandegrift', 'kjtemple', 'codysatterthwait', 'naqsh.mansoor', 'addielupercio', 'katiesautter', 'sublimn', 'ajchristy47', 'ehsan.moshkelgosha', 'yaizarodriguezortego', 'simonroy', 'flores.juan', 'abiaggne', 'bjkarki', 'scottbirks', 'muramutsa365']",35,"['gokulggoku', 'manojjayan1995', 'hannigrace2797', 'besa9826', 'jasmineriya1996', 'jinithacg5', 'pavithras17', 'joyson229', 'matthewgoelzer', 'sarchanaa97', 'nach', 'divyaphilip2016', 'amarnath.mgm98', 'rabosudkr', 'heeng2210', 'rafiqakhan12', 'ranjithkumar0822', 'sunnyanju7', 'christo.eldho', 'vdeepthi63', 'tnarayanasamymsc', 'privacymatters', 'jesujohn66', 'tommy91779', 'stevensonalva1', 'jenisha12', 'call2kevin', 'stanislav_markov', 'nakkeeran', 'abhinavgpaleri', 'bentennyson13579', 'satture5678', 'maheshkrishnan1997', 'ttdwyer', 'joelinjoma']",3,"['lanlibsu', None, 'donaldkellis']",61,"['hannigrace2797', 'kevinvallejo', 'stevejohns', 'jinithacg5', 'timphero', 'victoriavolk', 'pavithras17', 'sarchanaa97', 'nach', 'a3dman00', 'divyaphilip2016', 'jordanvandegrift', 'amarnath.mgm98', 'rafiqakhan12', 'ranjithkumar0822', 'codysatterthwait', 'naqsh.mansoor', 'sunnyanju7', 'jesujohn66', 'addielupercio', 'tommy91779', 'katiesautter', 'jenisha12', 'lanlibsu', 'ehsan.moshkelgosha', 'nakkeeran', 'simonroy', 'abhinavgpaleri', 'flores.juan', 'maheshkrishnan1997', 'abiaggne', 'gokulggoku', 'manojjayan1995', 'besa9826', 'jasmineriya1996', 'donaldkellis', 'joyson229', 'matthewgoelzer', 'sjriley', 'indigocloud123', 'rabosudkr', 'heeng2210', 'kjtemple', 'christo.eldho', 'vdeepthi63', 'tnarayanasamymsc', 'privacymatters', 'stevensonalva1', 'call2kevin', 'sublimn', 'stanislav_markov', 'ajchristy47', None, 'yaizarodriguezortego', 'bentennyson13579', 'satture5678', 'ttdwyer', 'bjkarki', 'scottbirks', 'joelinjoma', 'muramutsa365']"
11,437,59,18,11,"['sarchanaa97', 'sunnyanju7', 'hannigrace2797', 'christo.eldho', 'bentennyson13579', 'divyaphilip2016', 'vdeepthi63', 'amarnath.mgm98', 'rabosudkr', 'jenisha12', 'joyson229']",47,"['gokulggoku', 'manojjayan1995', 'kevinvallejo', 'stevejohns', 'besa9826', 'jasmineriya1996', 'jinithacg5', 'timphero', 'victoriavolk', 'pavithras17', 'matthewgoelzer', 'nach', 'a3dman00', 'sjriley', 'indigocloud123', 'jordanvandegrift', 'heeng2210', 'rafiqakhan12', 'kjtemple', 'ranjithkumar0822', 'codysatterthwait', 'naqsh.mansoor', 'tnarayanasamymsc', 'privacymatters', 'jesujohn66', 'tommy91779', 'katiesautter', 'call2kevin', 'addielupercio', 'stevensonalva1', 'stanislav_markov', 'ajchristy47', 'sublimn', 'ehsan.moshkelgosha', 'nakkeeran', 'yaizarodriguezortego', 'simonroy', 'abhinavgpaleri', 'flores.juan', 'satture5678', 'maheshkrishnan1997', 'ttdwyer', 'bjkarki', 'abiaggne', 'scottbirks', 'joelinjoma', 'muramutsa365']",7,"['nsubash30', 'joyxavier15', 'muralijoshap', 'himab', 'harithasree', None, 'annchristma25']",65,"['gokulggoku', 'manojjayan1995', 'hannigrace2797', 'kevinvallejo', 'stevejohns', 'besa9826', 'jasmineriya1996', 'jinithacg5', 'timphero', 'victoriavolk', 'pavithras17', 'joyson229', 'matthewgoelzer', 'sarchanaa97', 'nach', 'a3dman00', 'sjriley', 'indigocloud123', 'divyaphilip2016', 'jordanvandegrift', 'amarnath.mgm98', 'rabosudkr', 'harithasree', 'heeng2210', 'rafiqakhan12', 'kjtemple', 'ranjithkumar0822', 'codysatterthwait', 'naqsh.mansoor', 'nsubash30', 'sunnyanju7', 'muralijoshap', 'joyxavier15', 'christo.eldho', 'vdeepthi63', 'tnarayanasamymsc', 'privacymatters', 'jesujohn66', 'tommy91779', 'katiesautter', 'jenisha12', 'call2kevin', 'addielupercio', 'stanislav_markov', 'ajchristy47', 'stevensonalva1', 'ehsan.moshkelgosha', 'sublimn', None, 'annchristma25', 'nakkeeran', 'yaizarodriguezortego', 'simonroy', 'abhinavgpaleri', 'flores.juan', 'bentennyson13579', 'satture5678', 'himab', 'maheshkrishnan1997', 'ttdwyer', 'bjkarki', 'abiaggne', 'scottbirks', 'joelinjoma', 'muramutsa365']"
11,438,59,12,9,"['manojjayan1995', 'sunnyanju7', 'abhinavgpaleri', 'divyaphilip2016', 'vdeepthi63', 'tnarayanasamymsc', 'jinithacg5', 'joelinjoma', 'pavithras17']",49,"['gokulggoku', 'hannigrace2797', 'kevinvallejo', 'stevejohns', 'besa9826', 'jasmineriya1996', 'timphero', 'victoriavolk', 'joyson229', 'matthewgoelzer', 'sarchanaa97', 'nach', 'a3dman00', 'sjriley', 'indigocloud123', 'jordanvandegrift', 'amarnath.mgm98', 'rabosudkr', 'heeng2210', 'rafiqakhan12', 'kjtemple', 'ranjithkumar0822', 'codysatterthwait', 'naqsh.mansoor', 'christo.eldho', 'privacymatters', 'jesujohn66', 'tommy91779', 'katiesautter', 'jenisha12', 'call2kevin', 'addielupercio', 'stanislav_markov', 'ajchristy47', 'stevensonalva1', 'ehsan.moshkelgosha', 'sublimn', 'nakkeeran', 'yaizarodriguezortego', 'simonroy', 'flores.juan', 'bentennyson13579', 'satture5678', 'maheshkrishnan1997', 'ttdwyer', 'bjkarki', 'abiaggne', 'scottbirks', 'muramutsa365']",3,"['giftlingeorge', None, 'joyxavier15']",61,"['gokulggoku', 'manojjayan1995', 'hannigrace2797', 'kevinvallejo', 'stevejohns', 'besa9826', 'jasmineriya1996', 'jinithacg5', 'timphero', 'victoriavolk', 'pavithras17', 'joyson229', 'matthewgoelzer', 'sarchanaa97', 'nach', 'a3dman00', 'sjriley', 'indigocloud123', 'divyaphilip2016', 'jordanvandegrift', 'amarnath.mgm98', 'rabosudkr', 'heeng2210', 'rafiqakhan12', 'kjtemple', 'ranjithkumar0822', 'codysatterthwait', 'naqsh.mansoor', 'sunnyanju7', 'joyxavier15', 'christo.eldho', 'giftlingeorge', 'vdeepthi63', 'tnarayanasamymsc', 'privacymatters', 'jesujohn66', 'tommy91779', 'katiesautter', 'jenisha12', 'call2kevin', 'addielupercio', 'stanislav_markov', 'ajchristy47', 'stevensonalva1', 'ehsan.moshkelgosha', 'sublimn', None, 'nakkeeran', 'yaizarodriguezortego', 'simonroy', 'abhinavgpaleri', 'flores.juan', 'bentennyson13579', 'satture5678', 'maheshkrishnan1997', 'ttdwyer', 'bjkarki', 'abiaggne', 'scottbirks', 'joelinjoma', 'muramutsa365']"
11,439,59,9,8,"['nakkeeran', 'gokulggoku', 'maheshkrishnan1997', 'jasmineriya1996', 'jesujohn66', 'stevensonalva1', 'call2kevin', 'ranjithkumar0822']",50,"['manojjayan1995', 'hannigrace2797', 'kevinvallejo', 'stevejohns', 'besa9826', 'jinithacg5', 'timphero', 'victoriavolk', 'pavithras17', 'joyson229', 'matthewgoelzer', 'sarchanaa97', 'nach', 'a3dman00', 'sjriley', 'indigocloud123', 'divyaphilip2016', 'jordanvandegrift', 'amarnath.mgm98', 'rabosudkr', 'heeng2210', 'rafiqakhan12', 'kjtemple', 'codysatterthwait', 'naqsh.mansoor', 'sunnyanju7', 'christo.eldho', 'vdeepthi63', 'tnarayanasamymsc', 'privacymatters', 'tommy91779', 'katiesautter', 'jenisha12', 'addielupercio', 'stanislav_markov', 'ajchristy47', 'ehsan.moshkelgosha', 'sublimn', 'yaizarodriguezortego', 'simonroy', 'abhinavgpaleri', 'flores.juan', 'bentennyson13579', 'satture5678', 'ttdwyer', 'bjkarki', 'abiaggne', 'scottbirks', 'joelinjoma', 'muramutsa365']",1,[None],59,"['gokulggoku', 'manojjayan1995', 'hannigrace2797', 'kevinvallejo', 'stevejohns', 'besa9826', 'jasmineriya1996', 'jinithacg5', 'timphero', 'victoriavolk', 'pavithras17', 'joyson229', 'matthewgoelzer', 'sarchanaa97', 'nach', 'a3dman00', 'sjriley', 'indigocloud123', 'divyaphilip2016', 'jordanvandegrift', 'amarnath.mgm98', 'rabosudkr', 'heeng2210', 'rafiqakhan12', 'kjtemple', 'ranjithkumar0822', 'codysatterthwait', 'naqsh.mansoor', 'sunnyanju7', 'christo.eldho', 'vdeepthi63', 'tnarayanasamymsc', 'privacymatters', 'jesujohn66', 'tommy91779', 'katiesautter', 'jenisha12', 'call2kevin', 'addielupercio', 'stanislav_markov', 'ajchristy47', 'stevensonalva1', 'ehsan.moshkelgosha', 'sublimn', None, 'nakkeeran', 'yaizarodriguezortego', 'simonroy', 'abhinavgpaleri', 'flores.juan', 'bentennyson13579', 'satture5678', 'maheshkrishnan1997', 'ttdwyer', 'bjkarki', 'abiaggne', 'scottbirks', 'joelinjoma', 'muramutsa365']"
11,436,59,7,2,"['sarchanaa97', 'amarnath.mgm98']",56,"['gokulggoku', 'manojjayan1995', 'hannigrace2797', 'kevinvallejo', 'stevejohns', 'besa9826', 'jasmineriya1996', 'jinithacg5', 'timphero', 'victoriavolk', 'pavithras17', 'joyson229', 'matthewgoelzer', 'nach', 'a3dman00', 'sjriley', 'indigocloud123', 'divyaphilip2016', 'jordanvandegrift', 'rabosudkr', 'heeng2210', 'rafiqakhan12', 'kjtemple', 'ranjithkumar0822', 'codysatterthwait', 'naqsh.mansoor', 'sunnyanju7', 'christo.eldho', 'vdeepthi63', 'tnarayanasamymsc', 'privacymatters', 'jesujohn66', 'tommy91779', 'katiesautter', 'jenisha12', 'call2kevin', 'addielupercio', 'stanislav_markov', 'ajchristy47', 'stevensonalva1', 'ehsan.moshkelgosha', 'sublimn', 'nakkeeran', 'yaizarodriguezortego', 'simonroy', 'abhinavgpaleri', 'flores.juan', 'bentennyson13579', 'satture5678', 'maheshkrishnan1997', 'ttdwyer', 'bjkarki', 'abiaggne', 'scottbirks', 'joelinjoma', 'muramutsa365']",5,"['muralijoshap', 'himab', 'kirubaroshlin98', None, 'jenisha']",63,"['gokulggoku', 'manojjayan1995', 'hannigrace2797', 'kevinvallejo', 'stevejohns', 'besa9826', 'jasmineriya1996', 'jinithacg5', 'timphero', 'victoriavolk', 'pavithras17', 'joyson229', 'matthewgoelzer', 'sarchanaa97', 'nach', 'a3dman00', 'sjriley', 'indigocloud123', 'divyaphilip2016', 'jordanvandegrift', 'amarnath.mgm98', 'rabosudkr', 'heeng2210', 'rafiqakhan12', 'kjtemple', 'ranjithkumar0822', 'codysatterthwait', 'naqsh.mansoor', 'sunnyanju7', 'muralijoshap', 'christo.eldho', 'vdeepthi63', 'tnarayanasamymsc', 'privacymatters', 'jesujohn66', 'tommy91779', 'katiesautter', 'jenisha12', 'call2kevin', 'addielupercio', 'stanislav_markov', 'ajchristy47', 'stevensonalva1', 'ehsan.moshkelgosha', 'sublimn', None, 'nakkeeran', 'yaizarodriguezortego', 'simonroy', 'abhinavgpaleri', 'flores.juan', 'bentennyson13579', 'satture5678', 'himab', 'maheshkrishnan1997', 'ttdwyer', 'bjkarki', 'abiaggne', 'kirubaroshlin98', 'scottbirks', 'joelinjoma', 'muramutsa365', 'jenisha']"
12,327,58,22,17,"['burakbekar', 'parabellum252', 'ecehannn', 'berfin1995', 'alperarsslan', 'uguryildiz', 'gunesfaruk', 'tknmzmhmt', 'erhanfishermen', 'yusalpa', 'eray1234', 'hasanhasan', 'ugurcandemir96', 'ugurbayraktr', 'cutku40', 'hasantemelort', 'tlg.phlvn1296']",40,"['mustafacinar', 'nadilerojda94', 'senabozdemir', 'said', 'aylnn.k', 'sabriefe', 'nurres41', 'bekiraginagca', 'sezer1616', 'tunasahinnn', 'maheshmeghwal070296', 'lippertn', 'spurrs', 'ozcntpl', 'wegfbdddys', 'tuncerhasantugrul', 'thisisdumb', 'keremucman', 'esouludag', 'omer_faruk418', 'omer_faruk539', 'willryan86', 'ms.egilmez', 'rktsyntst', 'animusvox', 'm.burakgunduz23', 'emregonder', 'aureus', 'venv21', 'zavarnik', 'fmgomez', 'camg', 'didemcyd', 'harun_97_97', 'fettullahbag', 'sami_brs', 'talha458', 'senhasan1995', 'miguelpalominocobo', 'joseph.pena']",5,"['eaydinaydin40364036', 'gokturkkeskin08', 'hakanpinarkara', 'fatiheren', None]",62,"['mustafacinar', 'senabozdemir', 'erhanfishermen', 'sabriefe', 'ugurbayraktr', 'tunasahinnn', 'burakbekar', 'tuncerhasantugrul', 'thisisdumb', 'uguryildiz', 'keremucman', 'omer_faruk539', 'tlg.phlvn1296', 'willryan86', 'ms.egilmez', 'rktsyntst', 'm.burakgunduz23', 'aureus', 'venv21', 'fmgomez', 'camg', 'berfin1995', 'alperarsslan', 'tknmzmhmt', 'ugurcandemir96', 'hasantemelort', 'hakanpinarkara', 'nadilerojda94', 'eaydinaydin40364036', 'said', 'aylnn.k', 'nurres41', 'bekiraginagca', 'sezer1616', 'maheshmeghwal070296', 'lippertn', 'spurrs', 'ozcntpl', 'wegfbdddys', 'esouludag', 'omer_faruk418', 'hasanhasan', 'fatiheren', 'parabellum252', 'animusvox', 'emregonder', 'cutku40', 'zavarnik', 'didemcyd', None, 'harun_97_97', 'ecehannn', 'gunesfaruk', 'fettullahbag', 'yusalpa', 'eray1234', 'gokturkkeskin08', 'sami_brs', 'talha458', 'senhasan1995', 'miguelpalominocobo', 'joseph.pena']"
12,328,58,15,12,"['senabozdemir', 'erhanfishermen', 'm.burakgunduz23', 'keremucman', 'sabriefe', 'ugurcandemir96', 'bekiraginagca', 'hasantemelort', 'senhasan1995', 'talha458', 'tunasahinnn', 'didemcyd']",45,"['mustafacinar', 'nadilerojda94', 'said', 'aylnn.k', 'nurres41', 'ugurbayraktr', 'sezer1616', 'maheshmeghwal070296', 'lippertn', 'burakbekar', 'spurrs', 'ozcntpl', 'wegfbdddys', 'tuncerhasantugrul', 'thisisdumb', 'uguryildiz', 'esouludag', 'omer_faruk418', 'omer_faruk539', 'hasanhasan', 'tlg.phlvn1296', 'parabellum252', 'willryan86', 'ms.egilmez', 'rktsyntst', 'animusvox', 'emregonder', 'aureus', 'venv21', 'cutku40', 'zavarnik', 'fmgomez', 'camg', 'harun_97_97', 'ecehannn', 'berfin1995', 'alperarsslan', 'gunesfaruk', 'tknmzmhmt', 'fettullahbag', 'yusalpa', 'eray1234', 'sami_brs', 'miguelpalominocobo', 'joseph.pena']",3,"['eaydinaydin40364036', None, 'karapasa026']",60,"['mustafacinar', 'nadilerojda94', 'senabozdemir', 'eaydinaydin40364036', 'erhanfishermen', 'said', 'aylnn.k', 'sabriefe', 'nurres41', 'ugurbayraktr', 'bekiraginagca', 'sezer1616', 'maheshmeghwal070296', 'tunasahinnn', 'lippertn', 'burakbekar', 'spurrs', 'ozcntpl', 'wegfbdddys', 'tuncerhasantugrul', 'thisisdumb', 'uguryildiz', 'keremucman', 'esouludag', 'omer_faruk418', 'omer_faruk539', 'hasanhasan', 'tlg.phlvn1296', 'parabellum252', 'willryan86', 'ms.egilmez', 'rktsyntst', 'animusvox', 'm.burakgunduz23', 'emregonder', 'aureus', 'venv21', 'cutku40', 'zavarnik', 'fmgomez', 'camg', 'didemcyd', None, 'harun_97_97', 'ecehannn', 'berfin1995', 'alperarsslan', 'gunesfaruk', 'tknmzmhmt', 'fettullahbag', 'yusalpa', 'eray1234', 'ugurcandemir96', 'hasantemelort', 'talha458', 'senhasan1995', 'sami_brs', 'miguelpalominocobo', 'karapasa026', 'joseph.pena']"
12,330,58,11,8,"['ozcntpl', 'tknmzmhmt', 'animusvox', 'omer_faruk418', 'nurres41', 'sezer1616', 'zavarnik', 'harun_97_97']",49,"['mustafacinar', 'nadilerojda94', 'senabozdemir', 'erhanfishermen', 'said', 'aylnn.k', 'sabriefe', 'ugurbayraktr', 'bekiraginagca', 'maheshmeghwal070296', 'tunasahinnn', 'lippertn', 'burakbekar', 'spurrs', 'wegfbdddys', 'tuncerhasantugrul', 'thisisdumb', 'uguryildiz', 'keremucman', 'esouludag', 'omer_faruk539', 'hasanhasan', 'tlg.phlvn1296', 'parabellum252', 'willryan86', 'ms.egilmez', 'rktsyntst', 'm.burakgunduz23', 'emregonder', 'aureus', 'venv21', 'cutku40', 'fmgomez', 'camg', 'didemcyd', 'ecehannn', 'berfin1995', 'alperarsslan', 'gunesfaruk', 'fettullahbag', 'yusalpa', 'eray1234', 'ugurcandemir96', 'hasantemelort', 'talha458', 'senhasan1995', 'sami_brs', 'miguelpalominocobo', 'joseph.pena']",3,"['jhonyfth', 'fatiheren', None]",60,"['mustafacinar', 'nadilerojda94', 'senabozdemir', 'erhanfishermen', 'said', 'aylnn.k', 'sabriefe', 'nurres41', 'ugurbayraktr', 'bekiraginagca', 'sezer1616', 'maheshmeghwal070296', 'tunasahinnn', 'lippertn', 'burakbekar', 'spurrs', 'ozcntpl', 'wegfbdddys', 'tuncerhasantugrul', 'thisisdumb', 'uguryildiz', 'jhonyfth', 'keremucman', 'esouludag', 'omer_faruk418', 'omer_faruk539', 'hasanhasan', 'fatiheren', 'tlg.phlvn1296', 'parabellum252', 'willryan86', 'ms.egilmez', 'rktsyntst', 'animusvox', 'm.burakgunduz23', 'emregonder', 'aureus', 'venv21', 'cutku40', 'zavarnik', 'fmgomez', 'camg', 'didemcyd', None, 'harun_97_97', 'ecehannn', 'berfin1995', 'alperarsslan', 'gunesfaruk', 'tknmzmhmt', 'fettullahbag', 'yusalpa', 'eray1234', 'ugurcandemir96', 'hasantemelort', 'talha458', 'senhasan1995', 'sami_brs', 'miguelpalominocobo', 'joseph.pena']"
12,329,58,8,7,"['mustafacinar', 'tuncerhasantugrul', 'ms.egilmez', 'said', 'esouludag', 'emregonder', 'omer_faruk539']",50,"['nadilerojda94', 'senabozdemir', 'erhanfishermen', 'aylnn.k', 'sabriefe', 'nurres41', 'ugurbayraktr', 'bekiraginagca', 'sezer1616', 'maheshmeghwal070296', 'tunasahinnn', 'lippertn', 'burakbekar', 'spurrs', 'ozcntpl', 'wegfbdddys', 'thisisdumb', 'uguryildiz', 'keremucman', 'omer_faruk418', 'hasanhasan', 'tlg.phlvn1296', 'parabellum252', 'willryan86', 'rktsyntst', 'animusvox', 'm.burakgunduz23', 'aureus', 'venv21', 'cutku40', 'zavarnik', 'fmgomez', 'camg', 'didemcyd', 'harun_97_97', 'ecehannn', 'berfin1995', 'alperarsslan', 'gunesfaruk', 'tknmzmhmt', 'fettullahbag', 'yusalpa', 'eray1234', 'ugurcandemir96', 'hasantemelort', 'talha458', 'senhasan1995', 'sami_brs', 'miguelpalominocobo', 'joseph.pena']",1,[None],58,"['mustafacinar', 'nadilerojda94', 'senabozdemir', 'erhanfishermen', 'said', 'aylnn.k', 'sabriefe', 'nurres41', 'ugurbayraktr', 'bekiraginagca', 'sezer1616', 'maheshmeghwal070296', 'tunasahinnn', 'lippertn', 'burakbekar', 'spurrs', 'ozcntpl', 'wegfbdddys', 'tuncerhasantugrul', 'thisisdumb', 'uguryildiz', 'keremucman', 'esouludag', 'omer_faruk418', 'omer_faruk539', 'hasanhasan', 'tlg.phlvn1296', 'parabellum252', 'willryan86', 'ms.egilmez', 'rktsyntst', 'animusvox', 'm.burakgunduz23', 'emregonder', 'aureus', 'venv21', 'cutku40', 'zavarnik', 'fmgomez', 'camg', 'didemcyd', None, 'harun_97_97', 'ecehannn', 'berfin1995', 'alperarsslan', 'gunesfaruk', 'tknmzmhmt', 'fettullahbag', 'yusalpa', 'eray1234', 'ugurcandemir96', 'hasantemelort', 'talha458', 'senhasan1995', 'sami_brs', 'miguelpalominocobo', 'joseph.pena']"
13,56,56,142,1,['shah.ns'],54,"['muhammadanto27', 'steven123', 'ayushibhtngr96', 'moregayatri4', 'ariflinggasaputra28', 'danielsinaga220', 'evanjalinbenita', 'fadhilihsand', 'austin.dsouza1997', 'fevikrisda', 'shreyawazir', 'raflysna', 'frenkysiregar', 'irwansyahekaputra1', 'ismaelfozio', 'linaelfita29', 's.naek', 'shaibilsabu', 'rahul1178', 'threehans21', 'wahyuramadhan', 'oliversitorus', 'dedypurwadisinaga', 'srldaindars', 'manasvi.vartak10', 'rohansaldanha6370', 'siddeshwar', 'dvnrvnd', 'ashirhassan11', 'sreejit97', 'siluvaiwinston', 'kpganesh121.gk', 'alifindralukman', 'swedel', 'afryanainggolan07', 'mekiripaldo00', 'donyricardo', 'josephpatole23', 'gaurav.kolapate54', 'dhaffiz_aries25', 'umed.jadhav', 'aditwiranu', 'ellyramadhanti957', 'dwifurwana02', 'megauripawar', 'rendipardosi', 'khairuhafiz', 'urusajack124', 'shivanianekar13', 'thomasshanekoshy', 'cintyarubiah', 'mhafiz15', 'tanvi2881998', 'jennipusva']",141,"['nikperu007', 'nikhilchaudhari5516', 'harshalisawant92', 'omkar.chalke96', 'rajasiar1234', 'dmce123456789', 'h.vyas', 'darshana.mehta', 'sagarthool', 'sagargujar123', 'rahul.jethwa', 'akashupadhyay', 'rishi.mistry', 'aditya27', 'manalighorpade07', 'shreyahonagekar04', 'jugal.vaja', 'kssheetal2497', 'aditya.bhabhe', 'shivam.rs', 'sakshi.bhosle', 'singhamod111', 'chauhanajay4u', 'sachin.sc', 'sujittupe3490', 'rehan.mistry', 'mehulkharvi7', 'ranajay1997', 'pinak.p', 'bhushan0397', 'shrutik1997.mallick', 'ritesh0111', 'vidushirazdan1308', 'madhuriwawale13', 'shraddha0306', 'p_vasant', 'nehagurale10', 'vikramtirathkar96', 'kevin.z', 'yash.gulve', 'aditya.prnair', 'umeshlohote', 'jainamshah409', 'jagnoor.p', 'amey.mahadik98', 'kunalk4796', 'rajaskhasgiwale8497', 'prithvianvekar21', 'shubham.yelange', 'aladvait', 'arat.gouda', 'pranay.sadavarte', 'doobvoob', 'tejaskinage', 'k.siddhapura', 'vivek4238', 'jayshree90', 'apurvamirke29', 'kacharerohan', 'rutuja.mehta', 'arpanmodi2014', 'huzefa9702', 'adityajoy29', 'jay.km', 'shipra2', 'shubhada.shetti', 'divya.sawant17497', 'sakshi.trivedi', 'hitvena.shah', 'nikita.rp', 'zotingsagar', 'shashankyadavade68', 'mehanshi.p', 'yashsavle', 'akankshapatil', 'rajat.p', 'gaurav24', 'nihal.raut', 'smahamulkar1013', 'rahulbirwadkar123', 'slimshady', 'dilipramgir', 'maitrishah', 'goyalvishal147', 'saurabh.palde', 'karanshah16', 'zeevd19', 'arthaya.koyande28', 'prachi04', 'thakreshivam805', 'ankita.nd', 'kaustubhvaishampayan', 'nitin.lalwani', 'soham.sk', 'pranesha08', 'kalekajal2', 'perekarnk', 's.suvarna', 'harshal.bhole', 'spawar.ap', 'shwetakanoja', 'roy.shinde77', 'pranaykaranjekar28', 'shettynitin667', 'saadrahman.a', 'ssoneria7', 'd.haria', 'aashutoshkhapare22', 'darshana2504', 'swapnalidethe', 'aadi', 's.vohra', 'shreyasmoolya', 'kapil1410', 'adwaitnaik2', 'shahruchi', 'chakulipatil999', 'bhangaleprit', 'dhanshreeshawale', 'anushkaw055', 'rushabhkothari12', 'nayan_nanohub', 'yasir.mulla47', 'abbas.barwaniwala', 'harish.c', None, 'apeksha.shinde', 'ninad.mulay', 'parin.ss', 'abhay.nadkarni', 'dishasaraiya', 'pranalim11', 'saurabhgawade.777.4.sg', 'yashshetye7', 'pranali', 'nitish_mishra', 'bhushanrsonawane1998', 'ameysawant25597', 'kumawatmukesh71', 'rohithebbar10', 'shettysagar35']",196,"['nikperu007', 'nikhilchaudhari5516', 'harshalisawant92', 'omkar.chalke96', 'rajasiar1234', 'dmce123456789', 'h.vyas', 'darshana.mehta', 'fadhilihsand', 'sagarthool', 'sagargujar123', 'rahul.jethwa', 'irwansyahekaputra1', 'akashupadhyay', 'rishi.mistry', 'aditya27', 'manalighorpade07', 'shreyahonagekar04', 'jugal.vaja', 'kssheetal2497', 'aditya.bhabhe', 'shivam.rs', 'sakshi.bhosle', 'singhamod111', 'dedypurwadisinaga', 'srldaindars', 'chauhanajay4u', 'sachin.sc', 'sujittupe3490', 'rehan.mistry', 'mehulkharvi7', 'ranajay1997', 'pinak.p', 'bhushan0397', 'shrutik1997.mallick', 'ritesh0111', 'vidushirazdan1308', 'madhuriwawale13', 'dhaffiz_aries25', 'shraddha0306', 'p_vasant', 'aditwiranu', 'ellyramadhanti957', 'nehagurale10', 'megauripawar', 'vikramtirathkar96', 'kevin.z', 'yash.gulve', 'aditya.prnair', 'thomasshanekoshy', 'mhafiz15', 'tanvi2881998', 'umeshlohote', 'jainamshah409', 'jagnoor.p', 'amey.mahadik98', 'muhammadanto27', 'kunalk4796', 'rajaskhasgiwale8497', 'prithvianvekar21', 'ariflinggasaputra28', 'evanjalinbenita', 'austin.dsouza1997', 'shubham.yelange', 'aladvait', 'raflysna', 'arat.gouda', 'linaelfita29', 'pranay.sadavarte', 's.naek', 'doobvoob', 'tejaskinage', 'k.siddhapura', 'vivek4238', 'jayshree90', 'wahyuramadhan', 'apurvamirke29', 'rohansaldanha6370', 'dvnrvnd', 'kpganesh121.gk', 'sreejit97', 'kacharerohan', 'rutuja.mehta', 'arpanmodi2014', 'afryanainggolan07', 'huzefa9702', 'mekiripaldo00', 'adityajoy29', 'jay.km', 'shipra2', 'umed.jadhav', 'shubhada.shetti', 'divya.sawant17497', 'rendipardosi', 'sakshi.trivedi', 'hitvena.shah', 'shivanianekar13', 'nikita.rp', 'zotingsagar', 'shashankyadavade68', 'mehanshi.p', 'steven123', 'ayushibhtngr96', 'yashsavle', 'akankshapatil', 'moregayatri4', 'rajat.p', 'danielsinaga220', 'gaurav24', 'shreyawazir', 'nihal.raut', 'smahamulkar1013', 'rahulbirwadkar123', 'shah.ns', 'slimshady', 'dilipramgir', 'maitrishah', 'goyalvishal147', 'threehans21', 'saurabh.palde', 'karanshah16', 'manasvi.vartak10', 'zeevd19', 'siddeshwar', 'arthaya.koyande28', 'prachi04', 'thakreshivam805', 'ankita.nd', 'swedel', 'kaustubhvaishampayan', 'nitin.lalwani', 'soham.sk', 'pranesha08', 'donyricardo', 'josephpatole23', 'gaurav.kolapate54', 'dwifurwana02', 'kalekajal2', 'perekarnk', 's.suvarna', 'harshal.bhole', 'spawar.ap', 'shwetakanoja', 'roy.shinde77', 'pranaykaranjekar28', 'shettynitin667', 'saadrahman.a', 'jennipusva', 'ssoneria7', 'd.haria', 'aashutoshkhapare22', 'darshana2504', 'swapnalidethe', 'fevikrisda', 'aadi', 's.vohra', 'shreyasmoolya', 'frenkysiregar', 'ismaelfozio', 'kapil1410', 'adwaitnaik2', 'shaibilsabu', 'rahul1178', 'shahruchi', 'oliversitorus', 'chakulipatil999', 'ashirhassan11', 'siluvaiwinston', 'bhangaleprit', 'dhanshreeshawale', 'alifindralukman', 'anushkaw055', 'rushabhkothari12', 'nayan_nanohub', 'yasir.mulla47', 'abbas.barwaniwala', 'harish.c', None, 'apeksha.shinde', 'ninad.mulay', 'parin.ss', 'abhay.nadkarni', 'khairuhafiz', 'urusajack124', 'dishasaraiya', 'pranalim11', 'saurabhgawade.777.4.sg', 'yashshetye7', 'cintyarubiah', 'pranali', 'nitish_mishra', 'bhushanrsonawane1998', 'ameysawant25597', 'kumawatmukesh71', 'rohithebbar10', 'shettysagar35']"
13,53,56,75,5,"['shaibilsabu', 'evanjalinbenita', 'austin.dsouza1997', 'rohansaldanha6370', 'shah.ns']",50,"['muhammadanto27', 'steven123', 'ayushibhtngr96', 'moregayatri4', 'ariflinggasaputra28', 'danielsinaga220', 'fadhilihsand', 'fevikrisda', 'shreyawazir', 'raflysna', 'frenkysiregar', 'irwansyahekaputra1', 'ismaelfozio', 'linaelfita29', 's.naek', 'rahul1178', 'threehans21', 'wahyuramadhan', 'oliversitorus', 'dedypurwadisinaga', 'srldaindars', 'manasvi.vartak10', 'kpganesh121.gk', 'siddeshwar', 'dvnrvnd', 'ashirhassan11', 'sreejit97', 'siluvaiwinston', 'alifindralukman', 'swedel', 'afryanainggolan07', 'mekiripaldo00', 'donyricardo', 'josephpatole23', 'gaurav.kolapate54', 'dhaffiz_aries25', 'umed.jadhav', 'aditwiranu', 'ellyramadhanti957', 'dwifurwana02', 'megauripawar', 'rendipardosi', 'khairuhafiz', 'urusajack124', 'shivanianekar13', 'thomasshanekoshy', 'cintyarubiah', 'mhafiz15', 'tanvi2881998', 'jennipusva']",70,"['nikhilchaudhari5516', 'kunalk4796', 'shindedeepak129', 'prithvianvekar21', 'rajat.p', 'shubham.yelange', 'aadi', 'mayuridesai', 'smahamulkar1013', 'selimajack26', 'akau100', 'shreyasmoolya', 'rohitnair77880', 'vixsnair', 'aditya27', 'shreyahonagekar04', 'jugal.vaja', 'shivam.rs', 'chavankeasmita29', 'sakshi.bhosle', 'paras.mehta', 'jayesh.kakkad8770', 'saurabh.palde', 'sushobh', 'zeevd19', 'davidrisaac', 'sachin.sc', 'shubhamnagpure745', 'arthaya.koyande28', 'vatsal23', 'sujittupe3490', 'swapnalimakdey25', 'orencollaco97', 'shrutik1997.mallick', 'dhwani.vichhi', 'anujchhabra25', 'yasir.mulla47', 'jay.km', 'waynemdsouza', 'shraddha0306', 'ghevadeyogesh', 'adityadesu1', 'harish.c', None, 's.suvarna', 'ninad.mulay', 'pranitkumbhar19', 'adityadh943', 'parin.ss', 'sebin.bc', 'abhay.nadkarni', 'spawar.ap', 'sakshi.trivedi', 'naiksandesh1998', 'priyu0964', 'patilprasad0123', '15anuchaudhari', 'vidhi.satra', 'sukanyajadhav1997', 'dishasaraiya', 'aur_mnzs', 'saurabhgawade.777.4.sg', 'maneshweta23', 'jeniferishwarya', 'shail.maroo', 'd.haria', 'umeshlohote', 'wanichinmay577', 'jagnoor.p', 'omkar.karande']",125,"['nikhilchaudhari5516', 'shindedeepak129', 'fadhilihsand', 'selimajack26', 'akau100', 'irwansyahekaputra1', 'rohitnair77880', 'aditya27', 'shreyahonagekar04', 'jugal.vaja', 'shivam.rs', 'chavankeasmita29', 'sakshi.bhosle', 'paras.mehta', 'dedypurwadisinaga', 'srldaindars', 'sushobh', 'sachin.sc', 'sujittupe3490', 'orencollaco97', 'shrutik1997.mallick', 'dhwani.vichhi', 'waynemdsouza', 'dhaffiz_aries25', 'shraddha0306', 'aditwiranu', 'ellyramadhanti957', 'megauripawar', 'naiksandesh1998', 'priyu0964', 'patilprasad0123', 'thomasshanekoshy', 'vidhi.satra', 'mhafiz15', 'tanvi2881998', 'maneshweta23', 'jeniferishwarya', 'umeshlohote', 'jagnoor.p', 'muhammadanto27', 'kunalk4796', 'prithvianvekar21', 'ariflinggasaputra28', 'evanjalinbenita', 'austin.dsouza1997', 'shubham.yelange', 'mayuridesai', 'raflysna', 'linaelfita29', 's.naek', 'wahyuramadhan', 'rohansaldanha6370', 'dvnrvnd', 'kpganesh121.gk', 'davidrisaac', 'sreejit97', 'shubhamnagpure745', 'swapnalimakdey25', 'afryanainggolan07', 'mekiripaldo00', 'jay.km', 'umed.jadhav', 'adityadesu1', 'rendipardosi', 'sakshi.trivedi', 'shivanianekar13', 'aur_mnzs', 'shail.maroo', 'omkar.karande', 'steven123', 'ayushibhtngr96', 'moregayatri4', 'rajat.p', 'danielsinaga220', 'shreyawazir', 'smahamulkar1013', 'shah.ns', 'threehans21', 'saurabh.palde', 'manasvi.vartak10', 'zeevd19', 'siddeshwar', 'arthaya.koyande28', 'vatsal23', 'swedel', 'anujchhabra25', 'donyricardo', 'josephpatole23', 'gaurav.kolapate54', 'dwifurwana02', 's.suvarna', 'pranitkumbhar19', 'sebin.bc', 'spawar.ap', '15anuchaudhari', 'sukanyajadhav1997', 'jennipusva', 'd.haria', 'fevikrisda', 'aadi', 'shreyasmoolya', 'frenkysiregar', 'ismaelfozio', 'vixsnair', 'shaibilsabu', 'rahul1178', 'jayesh.kakkad8770', 'oliversitorus', 'ashirhassan11', 'siluvaiwinston', 'alifindralukman', 'yasir.mulla47', 'ghevadeyogesh', 'harish.c', None, 'ninad.mulay', 'adityadh943', 'parin.ss', 'abhay.nadkarni', 'khairuhafiz', 'urusajack124', 'dishasaraiya', 'saurabhgawade.777.4.sg', 'cintyarubiah', 'wanichinmay577']"
13,49,56,39,31,"['muhammadanto27', 'steven123', 'fadhilihsand', 'danielsinaga220', 'ariflinggasaputra28', 'fevikrisda', 'raflysna', 'frenkysiregar', 'irwansyahekaputra1', 'ismaelfozio', 'linaelfita29', 's.naek', 'threehans21', 'wahyuramadhan', 'oliversitorus', 'dedypurwadisinaga', 'srldaindars', 'dvnrvnd', 'alifindralukman', 'afryanainggolan07', 'mekiripaldo00', 'donyricardo', 'dhaffiz_aries25', 'dwifurwana02', 'aditwiranu', 'ellyramadhanti957', 'rendipardosi', 'khairuhafiz', 'cintyarubiah', 'mhafiz15', 'jennipusva']",24,"['ayushibhtngr96', 'moregayatri4', 'evanjalinbenita', 'austin.dsouza1997', 'shreyawazir', 'shah.ns', 'shaibilsabu', 'rahul1178', 'manasvi.vartak10', 'rohansaldanha6370', 'siddeshwar', 'kpganesh121.gk', 'ashirhassan11', 'sreejit97', 'siluvaiwinston', 'swedel', 'josephpatole23', 'gaurav.kolapate54', 'umed.jadhav', 'megauripawar', 'urusajack124', 'shivanianekar13', 'thomasshanekoshy', 'tanvi2881998']",8,"['biawak_terbengkalai', 'zeroabdi1212', 'nantafakih', 'raflysna3', 'muhammadrifqi', 'wahyu', 'benkhalifah94', None]",63,"['steven123', 'ayushibhtngr96', 'biawak_terbengkalai', 'moregayatri4', 'fadhilihsand', 'danielsinaga220', 'shreyawazir', 'irwansyahekaputra1', 'shah.ns', 'threehans21', 'dedypurwadisinaga', 'srldaindars', 'manasvi.vartak10', 'siddeshwar', 'swedel', 'zeroabdi1212', 'donyricardo', 'josephpatole23', 'gaurav.kolapate54', 'dhaffiz_aries25', 'dwifurwana02', 'aditwiranu', 'ellyramadhanti957', 'megauripawar', 'thomasshanekoshy', 'mhafiz15', 'tanvi2881998', 'jennipusva', 'benkhalifah94', 'muhammadanto27', 'ariflinggasaputra28', 'evanjalinbenita', 'austin.dsouza1997', 'fevikrisda', 'raflysna', 'frenkysiregar', 'ismaelfozio', 'linaelfita29', 's.naek', 'shaibilsabu', 'rahul1178', 'wahyuramadhan', 'oliversitorus', 'rohansaldanha6370', 'dvnrvnd', 'kpganesh121.gk', 'ashirhassan11', 'sreejit97', 'siluvaiwinston', 'alifindralukman', 'afryanainggolan07', 'nantafakih', 'raflysna3', 'mekiripaldo00', 'muhammadrifqi', 'wahyu', 'umed.jadhav', None, 'rendipardosi', 'khairuhafiz', 'urusajack124', 'shivanianekar13', 'cintyarubiah']"
13,48,56,35,2,"['umed.jadhav', 'shah.ns']",53,"['muhammadanto27', 'steven123', 'ayushibhtngr96', 'moregayatri4', 'ariflinggasaputra28', 'danielsinaga220', 'evanjalinbenita', 'fadhilihsand', 'austin.dsouza1997', 'fevikrisda', 'shreyawazir', 'raflysna', 'frenkysiregar', 'irwansyahekaputra1', 'ismaelfozio', 'linaelfita29', 's.naek', 'shaibilsabu', 'rahul1178', 'threehans21', 'wahyuramadhan', 'oliversitorus', 'dedypurwadisinaga', 'srldaindars', 'manasvi.vartak10', 'rohansaldanha6370', 'siddeshwar', 'dvnrvnd', 'ashirhassan11', 'sreejit97', 'siluvaiwinston', 'kpganesh121.gk', 'alifindralukman', 'swedel', 'afryanainggolan07', 'mekiripaldo00', 'donyricardo', 'josephpatole23', 'gaurav.kolapate54', 'dhaffiz_aries25', 'dwifurwana02', 'aditwiranu', 'ellyramadhanti957', 'megauripawar', 'rendipardosi', 'khairuhafiz', 'urusajack124', 'shivanianekar13', 'thomasshanekoshy', 'cintyarubiah', 'mhafiz15', 'tanvi2881998', 'jennipusva']",33,"['harshada.benke', 'rajat.p', 'rahul.jethwa', 'mayuresh.auti', 'rishi.mistry', 'aditya27', 'ragini.g', 'jugal.vaja', 'shivam.rs', 'paras.mehta', 'saurabh.palde', 'arati.mule2900', 'sachin.sc', 'rutuja.mehta', 'pinak.p', 'dhwani.vichhi', 'jay.km', 'anuj.cm', 'harish.c', None, 's.suvarna', 'parin.ss', 'abhay.nadkarni', 'hitvena.shah', 'sakshi.trivedi', 'dishasaraiya', 'pritish.mishra1', 'vidhi.satra', 'shail.maroo', 'nikita.rp', 'd.haria', 'jagnoor.p', 'omkar.karande']",88,"['steven123', 'ayushibhtngr96', 'moregayatri4', 'fadhilihsand', 'danielsinaga220', 'rajat.p', 'shreyawazir', 'rahul.jethwa', 'irwansyahekaputra1', 'rishi.mistry', 'shah.ns', 'aditya27', 'ragini.g', 'jugal.vaja', 'threehans21', 'shivam.rs', 'paras.mehta', 'saurabh.palde', 'dedypurwadisinaga', 'srldaindars', 'manasvi.vartak10', 'siddeshwar', 'sachin.sc', 'pinak.p', 'dhwani.vichhi', 'swedel', 'anuj.cm', 'donyricardo', 'josephpatole23', 'gaurav.kolapate54', 'dhaffiz_aries25', 'dwifurwana02', 'aditwiranu', 'ellyramadhanti957', 's.suvarna', 'megauripawar', 'thomasshanekoshy', 'pritish.mishra1', 'vidhi.satra', 'mhafiz15', 'tanvi2881998', 'jennipusva', 'd.haria', 'jagnoor.p', 'muhammadanto27', 'harshada.benke', 'ariflinggasaputra28', 'evanjalinbenita', 'austin.dsouza1997', 'fevikrisda', 'raflysna', 'frenkysiregar', 'mayuresh.auti', 'ismaelfozio', 'linaelfita29', 's.naek', 'shaibilsabu', 'rahul1178', 'wahyuramadhan', 'oliversitorus', 'rohansaldanha6370', 'dvnrvnd', 'kpganesh121.gk', 'ashirhassan11', 'sreejit97', 'siluvaiwinston', 'arati.mule2900', 'rutuja.mehta', 'alifindralukman', 'afryanainggolan07', 'mekiripaldo00', 'jay.km', 'umed.jadhav', 'harish.c', None, 'parin.ss', 'abhay.nadkarni', 'rendipardosi', 'khairuhafiz', 'urusajack124', 'shivanianekar13', 'hitvena.shah', 'sakshi.trivedi', 'dishasaraiya', 'cintyarubiah', 'shail.maroo', 'nikita.rp', 'omkar.karande']"
13,50,56,27,15,"['ayushibhtngr96', 'megauripawar', 'swedel', 'moregayatri4', 'urusajack124', 'shivanianekar13', 'thomasshanekoshy', 'shreyawazir', 'tanvi2881998', 'manasvi.vartak10', 'kpganesh121.gk', 'siddeshwar', 'josephpatole23', 'siluvaiwinston', 'gaurav.kolapate54']",40,"['muhammadanto27', 'steven123', 'ariflinggasaputra28', 'danielsinaga220', 'evanjalinbenita', 'fadhilihsand', 'austin.dsouza1997', 'fevikrisda', 'raflysna', 'frenkysiregar', 'irwansyahekaputra1', 'ismaelfozio', 'shah.ns', 'linaelfita29', 's.naek', 'shaibilsabu', 'rahul1178', 'threehans21', 'wahyuramadhan', 'oliversitorus', 'dedypurwadisinaga', 'srldaindars', 'rohansaldanha6370', 'dvnrvnd', 'ashirhassan11', 'sreejit97', 'alifindralukman', 'afryanainggolan07', 'mekiripaldo00', 'donyricardo', 'dhaffiz_aries25', 'dwifurwana02', 'umed.jadhav', 'aditwiranu', 'ellyramadhanti957', 'rendipardosi', 'khairuhafiz', 'cintyarubiah', 'mhafiz15', 'jennipusva']",12,"['smita.n', 'morechinmay123', 'gaurav.dangat', 'sebin.bc', 'aur_mnzs', 'jeniferishwarya', 'aru2000in', 'adityachachad', 'adityadesu1', None, 'vatsal23', 'swapnalimakdey25']",67,"['steven123', 'ayushibhtngr96', 'gaurav.dangat', 'moregayatri4', 'fadhilihsand', 'danielsinaga220', 'shreyawazir', 'irwansyahekaputra1', 'shah.ns', 'smita.n', 'threehans21', 'dedypurwadisinaga', 'srldaindars', 'manasvi.vartak10', 'aru2000in', 'siddeshwar', 'adityachachad', 'vatsal23', 'swedel', 'donyricardo', 'josephpatole23', 'gaurav.kolapate54', 'dhaffiz_aries25', 'dwifurwana02', 'aditwiranu', 'ellyramadhanti957', 'megauripawar', 'sebin.bc', 'thomasshanekoshy', 'mhafiz15', 'tanvi2881998', 'jeniferishwarya', 'jennipusva', 'muhammadanto27', 'ariflinggasaputra28', 'evanjalinbenita', 'austin.dsouza1997', 'fevikrisda', 'raflysna', 'frenkysiregar', 'ismaelfozio', 'linaelfita29', 'morechinmay123', 's.naek', 'shaibilsabu', 'rahul1178', 'wahyuramadhan', 'oliversitorus', 'rohansaldanha6370', 'dvnrvnd', 'kpganesh121.gk', 'ashirhassan11', 'sreejit97', 'siluvaiwinston', 'swapnalimakdey25', 'alifindralukman', 'afryanainggolan07', 'mekiripaldo00', 'umed.jadhav', 'adityadesu1', None, 'rendipardosi', 'khairuhafiz', 'urusajack124', 'shivanianekar13', 'aur_mnzs', 'cintyarubiah']"
13,51,56,16,8,"['megauripawar', 'thomasshanekoshy', 'tanvi2881998', 'kpganesh121.gk', 'siddeshwar', 'gaurav.kolapate54', 'sreejit97', 'siluvaiwinston']",47,"['muhammadanto27', 'steven123', 'ayushibhtngr96', 'moregayatri4', 'ariflinggasaputra28', 'danielsinaga220', 'evanjalinbenita', 'fadhilihsand', 'austin.dsouza1997', 'fevikrisda', 'shreyawazir', 'raflysna', 'frenkysiregar', 'irwansyahekaputra1', 'ismaelfozio', 'shah.ns', 'linaelfita29', 's.naek', 'shaibilsabu', 'rahul1178', 'threehans21', 'wahyuramadhan', 'oliversitorus', 'dedypurwadisinaga', 'srldaindars', 'manasvi.vartak10', 'rohansaldanha6370', 'dvnrvnd', 'ashirhassan11', 'alifindralukman', 'swedel', 'afryanainggolan07', 'mekiripaldo00', 'donyricardo', 'josephpatole23', 'dhaffiz_aries25', 'dwifurwana02', 'umed.jadhav', 'aditwiranu', 'ellyramadhanti957', 'rendipardosi', 'khairuhafiz', 'urusajack124', 'shivanianekar13', 'cintyarubiah', 'mhafiz15', 'jennipusva']",8,"['morechinmay123', 'sebin.bc', 'parthdave197', 'jeniferishwarya', 'aru2000in', 'adityadesu1', None, 'swapnalimakdey25']",63,"['muhammadanto27', 'steven123', 'ayushibhtngr96', 'moregayatri4', 'ariflinggasaputra28', 'danielsinaga220', 'evanjalinbenita', 'fadhilihsand', 'austin.dsouza1997', 'fevikrisda', 'shreyawazir', 'raflysna', 'frenkysiregar', 'irwansyahekaputra1', 'ismaelfozio', 'shah.ns', 'linaelfita29', 'morechinmay123', 's.naek', 'shaibilsabu', 'rahul1178', 'threehans21', 'wahyuramadhan', 'oliversitorus', 'dedypurwadisinaga', 'srldaindars', 'manasvi.vartak10', 'rohansaldanha6370', 'siddeshwar', 'dvnrvnd', 'ashirhassan11', 'sreejit97', 'siluvaiwinston', 'kpganesh121.gk', 'aru2000in', 'swapnalimakdey25', 'alifindralukman', 'swedel', 'afryanainggolan07', 'parthdave197', 'mekiripaldo00', 'donyricardo', 'josephpatole23', 'gaurav.kolapate54', 'dhaffiz_aries25', 'umed.jadhav', 'aditwiranu', 'ellyramadhanti957', 'dwifurwana02', 'adityadesu1', None, 'megauripawar', 'sebin.bc', 'rendipardosi', 'khairuhafiz', 'urusajack124', 'shivanianekar13', 'thomasshanekoshy', 'cintyarubiah', 'mhafiz15', 'tanvi2881998', 'jeniferishwarya', 'jennipusva']"
13,52,56,15,4,"['austin.dsouza1997', 'evanjalinbenita', 'rohansaldanha6370', 'shaibilsabu']",51,"['muhammadanto27', 'steven123', 'ayushibhtngr96', 'moregayatri4', 'ariflinggasaputra28', 'danielsinaga220', 'fadhilihsand', 'fevikrisda', 'shreyawazir', 'raflysna', 'frenkysiregar', 'irwansyahekaputra1', 'ismaelfozio', 'shah.ns', 'linaelfita29', 's.naek', 'rahul1178', 'threehans21', 'wahyuramadhan', 'oliversitorus', 'dedypurwadisinaga', 'srldaindars', 'manasvi.vartak10', 'kpganesh121.gk', 'siddeshwar', 'dvnrvnd', 'ashirhassan11', 'sreejit97', 'siluvaiwinston', 'alifindralukman', 'swedel', 'afryanainggolan07', 'mekiripaldo00', 'donyricardo', 'josephpatole23', 'gaurav.kolapate54', 'dhaffiz_aries25', 'umed.jadhav', 'aditwiranu', 'ellyramadhanti957', 'dwifurwana02', 'megauripawar', 'rendipardosi', 'khairuhafiz', 'urusajack124', 'shivanianekar13', 'thomasshanekoshy', 'cintyarubiah', 'mhafiz15', 'tanvi2881998', 'jennipusva']",11,"['smita.n', 'shriya.h.joshi', 'omkarkhedkaro', 'urvi.panchal', 'hit.kamble', 'selimajack26', 'jayesh.a', 'vatsal23', None, 'ajitjadhav', 'swapnalimakdey25']",66,"['muhammadanto27', 'steven123', 'ayushibhtngr96', 'hit.kamble', 'moregayatri4', 'ariflinggasaputra28', 'danielsinaga220', 'evanjalinbenita', 'fadhilihsand', 'austin.dsouza1997', 'fevikrisda', 'shreyawazir', 'raflysna', 'selimajack26', 'frenkysiregar', 'irwansyahekaputra1', 'ismaelfozio', 'shah.ns', 'linaelfita29', 'smita.n', 's.naek', 'shaibilsabu', 'rahul1178', 'threehans21', 'shriya.h.joshi', 'omkarkhedkaro', 'wahyuramadhan', 'oliversitorus', 'dedypurwadisinaga', 'srldaindars', 'manasvi.vartak10', 'rohansaldanha6370', 'siddeshwar', 'dvnrvnd', 'ashirhassan11', 'sreejit97', 'siluvaiwinston', 'kpganesh121.gk', 'ajitjadhav', 'jayesh.a', 'vatsal23', 'swapnalimakdey25', 'alifindralukman', 'swedel', 'afryanainggolan07', 'mekiripaldo00', 'urvi.panchal', 'donyricardo', 'josephpatole23', 'gaurav.kolapate54', 'dhaffiz_aries25', 'umed.jadhav', 'aditwiranu', 'ellyramadhanti957', 'dwifurwana02', None, 'megauripawar', 'rendipardosi', 'khairuhafiz', 'urusajack124', 'shivanianekar13', 'thomasshanekoshy', 'cintyarubiah', 'mhafiz15', 'tanvi2881998', 'jennipusva']"
13,54,56,7,2,"['evanjalinbenita', 'shaibilsabu']",53,"['muhammadanto27', 'steven123', 'ayushibhtngr96', 'moregayatri4', 'ariflinggasaputra28', 'danielsinaga220', 'fadhilihsand', 'austin.dsouza1997', 'fevikrisda', 'shreyawazir', 'raflysna', 'frenkysiregar', 'irwansyahekaputra1', 'ismaelfozio', 'shah.ns', 'linaelfita29', 's.naek', 'rahul1178', 'threehans21', 'wahyuramadhan', 'oliversitorus', 'dedypurwadisinaga', 'srldaindars', 'manasvi.vartak10', 'rohansaldanha6370', 'siddeshwar', 'dvnrvnd', 'ashirhassan11', 'sreejit97', 'siluvaiwinston', 'kpganesh121.gk', 'alifindralukman', 'swedel', 'afryanainggolan07', 'mekiripaldo00', 'donyricardo', 'josephpatole23', 'gaurav.kolapate54', 'dhaffiz_aries25', 'umed.jadhav', 'aditwiranu', 'ellyramadhanti957', 'dwifurwana02', 'megauripawar', 'rendipardosi', 'khairuhafiz', 'urusajack124', 'shivanianekar13', 'thomasshanekoshy', 'cintyarubiah', 'mhafiz15', 'tanvi2881998', 'jennipusva']",5,"['jackymathew', 'omkarkhedkaro', 'selimajack26', None, 'swapnalimakdey25']",60,"['muhammadanto27', 'steven123', 'ayushibhtngr96', 'moregayatri4', 'ariflinggasaputra28', 'danielsinaga220', 'evanjalinbenita', 'fadhilihsand', 'austin.dsouza1997', 'fevikrisda', 'shreyawazir', 'raflysna', 'selimajack26', 'frenkysiregar', 'irwansyahekaputra1', 'ismaelfozio', 'shah.ns', 'linaelfita29', 's.naek', 'shaibilsabu', 'rahul1178', 'threehans21', 'omkarkhedkaro', 'wahyuramadhan', 'oliversitorus', 'dedypurwadisinaga', 'srldaindars', 'manasvi.vartak10', 'rohansaldanha6370', 'siddeshwar', 'dvnrvnd', 'ashirhassan11', 'sreejit97', 'siluvaiwinston', 'kpganesh121.gk', 'swapnalimakdey25', 'alifindralukman', 'swedel', 'afryanainggolan07', 'mekiripaldo00', 'donyricardo', 'josephpatole23', 'gaurav.kolapate54', 'dhaffiz_aries25', 'umed.jadhav', 'aditwiranu', 'ellyramadhanti957', 'dwifurwana02', None, 'megauripawar', 'jackymathew', 'rendipardosi', 'khairuhafiz', 'urusajack124', 'shivanianekar13', 'thomasshanekoshy', 'cintyarubiah', 'mhafiz15', 'tanvi2881998', 'jennipusva']"
14,89,55,50,1,['ne471nanoschool'],53,"['amruthaa176', 'dke625', 'willecormier', 'sgu20141445', 'sgu20141493', 'sgu20141441', 'sgu20131458', 'sagor01840', 'jakariaalamin1994', 'bvalls', 'sgu20141429', 'alexandru.smaranda19', 'gabrielmaranhao10', 'sgu20141453', 'sgu20131414', 'andreik_94', 'saemin1024', 'sohnt', 'ana.costea47', 'tangjiemu', 'sgu20141388', 'sgu20141434', 'lfv2108', 'danilozaro10', 'dogaruvalentin94', 'ghkskxlr', 'binisor.alin', 'sgu201414733', 'd.ramos.santesmases', 'hoobeen', 'ghks031800', 'far9an', 'sanduramona75', 'sgu20131420', 'sgu20131431', 'zhehan666', 'mostakmorshedshuvo95shuvo2015018', 'riccardo.pietrella', 'bangong12', 'sgu20131496', 'dkorakakis', 'minchaoan', 'bratosin.vm', 'sohnterry', 'ldesanti', 'davidjung01', 'monikapathare97', 'chuhang.jin', 'sgu20131484', 'datleb', 'namrataravi26', 'sgu20131374', 'do1608']",49,"['smithamdan', 'my2low', 'cas', 'zifanek', 'agill16', 'coursework', 'qianshu', 'deminyin', 'reed.maximilian', 'adrianycchan', 'vyshakh.sanjeev', 'jthomasyang', 'zack.strike', 'jasminek', 'mikejewski', 'amargharial', 'graemek4', 'cui.wentao', 'yuxiao.zhou', 'jonathanrasmussen1996', 'wkap', 'arunrangahotmail.ca', 'sumi_sumi_7', 'k.malejczuk', 'h_waterloo', 'mwin', 'j442chen', None, 'takdeniz', 'rainwind2010', 'manasakaniselvan', 'mototsune1', 'zameer13b', 'drousso', 'ryanj', 'robertbennett', 'l2mcgrat', 'adrianeitzen', 'sw4chan', 'saravind', 'cullentielemans', 'kylenova', 'anthony.le3124', 'k31berte', 'khadijaasad', 'calena3', 'theeran', 'rendall_jenner', 'fade237']",103,"['amruthaa176', 'dke625', 'coursework', 'zifanek', 'sgu20141441', 'sagor01840', 'jakariaalamin1994', 'sgu20141429', 'sgu20141453', 'reed.maximilian', 'sgu20131414', 'vyshakh.sanjeev', 'jthomasyang', 'saemin1024', 'sohnt', 'ana.costea47', 'jasminek', 'tangjiemu', 'mikejewski', 'graemek4', 'cui.wentao', 'yuxiao.zhou', 'danilozaro10', 'dogaruvalentin94', 'ghkskxlr', 'arunrangahotmail.ca', 'd.ramos.santesmases', 'hoobeen', 'sumi_sumi_7', 'sgu20131420', 'k.malejczuk', 'mostakmorshedshuvo95shuvo2015018', 'mwin', 'takdeniz', 'rainwind2010', 'sohnterry', 'manasakaniselvan', 'zameer13b', 'adrianeitzen', 'chuhang.jin', 'robertbennett', 'khadijaasad', 'sgu20131484', 'rendall_jenner', 'fade237', 'do1608', 'smithamdan', 'willecormier', 'sgu20141493', 'sgu20141445', 'my2low', 'cas', 'sgu20131458', 'agill16', 'bvalls', 'qianshu', 'deminyin', 'alexandru.smaranda19', 'gabrielmaranhao10', 'adrianycchan', 'ne471nanoschool', 'andreik_94', 'zack.strike', 'amargharial', 'sgu20141388', 'sgu20141434', 'lfv2108', 'binisor.alin', 'jonathanrasmussen1996', 'wkap', 'sgu201414733', 'ghks031800', 'far9an', 'sanduramona75', 'sgu20131431', 'zhehan666', 'riccardo.pietrella', 'bangong12', 'sgu20131496', 'h_waterloo', 'j442chen', 'dkorakakis', None, 'minchaoan', 'bratosin.vm', 'ldesanti', 'davidjung01', 'mototsune1', 'ryanj', 'drousso', 'sw4chan', 'monikapathare97', 'l2mcgrat', 'anthony.le3124', 'datleb', 'saravind', 'cullentielemans', 'kylenova', 'namrataravi26', 'k31berte', 'sgu20131374', 'calena3', 'theeran']"
14,22,55,43,2,"['sgu20141441', 'sgu20131458']",52,"['amruthaa176', 'dke625', 'willecormier', 'sgu20141445', 'sgu20141493', 'sagor01840', 'jakariaalamin1994', 'bvalls', 'sgu20141429', 'alexandru.smaranda19', 'gabrielmaranhao10', 'sgu20141453', 'sgu20131414', 'ne471nanoschool', 'andreik_94', 'saemin1024', 'sohnt', 'ana.costea47', 'tangjiemu', 'sgu20141388', 'sgu20141434', 'lfv2108', 'danilozaro10', 'dogaruvalentin94', 'ghkskxlr', 'binisor.alin', 'sgu201414733', 'd.ramos.santesmases', 'hoobeen', 'ghks031800', 'far9an', 'sanduramona75', 'sgu20131420', 'sgu20131431', 'zhehan666', 'mostakmorshedshuvo95shuvo2015018', 'riccardo.pietrella', 'bangong12', 'sgu20131496', 'dkorakakis', 'minchaoan', 'bratosin.vm', 'sohnterry', 'ldesanti', 'davidjung01', 'monikapathare97', 'chuhang.jin', 'sgu20131484', 'datleb', 'namrataravi26', 'sgu20131374', 'do1608']",41,"['sgu20141417', 'harry0913', 'sgu20131455', 'sgu960911', 'sgu20141394', 'sgu20141483', 'sgu20141411', 'ppjunb12', 'sgu20121462', 'gjfdjzo', 'sgu20141395', 'sg20121208', 'sgu20141408', 'sgu20141465', 'sgu20131481', 'sgu20131462', 'sgu20151487', 'sgu20141459', 'sogang20141460', 'sgu20131508', 'sgu20141448', 'sgu20141468', 'sgu20131507', 'sgu20141389', 'sgu20151485', 'sgu2014726019', 'sgu20161474', 'sgu20131432', 'sgu20141385', 'sgu20141393', None, 'sgu20141450', 'sgu20161503', 'sgu20131412', 'sgu20141476', 'sgu20141460', 'sgu20141415', 'sgu20131410', 'sgu20151194', 'sgu20161494', 'sgu20141471']",95,"['amruthaa176', 'dke625', 'harry0913', 'sgu20141441', 'sagor01840', 'jakariaalamin1994', 'sgu20141429', 'sgu20141483', 'ppjunb12', 'sgu20141453', 'sgu20121462', 'sgu20131414', 'sg20121208', 'sgu20131481', 'saemin1024', 'sohnt', 'ana.costea47', 'tangjiemu', 'sgu20151487', 'danilozaro10', 'dogaruvalentin94', 'ghkskxlr', 'sgu20141448', 'sgu20131507', 'd.ramos.santesmases', 'hoobeen', 'sgu20131420', 'sgu2014726019', 'mostakmorshedshuvo95shuvo2015018', 'sgu20141393', 'sohnterry', 'sgu20161503', 'chuhang.jin', 'sgu20131484', 'sgu20141460', 'sgu20141415', 'sgu20131410', 'sgu20151194', 'sgu20141471', 'do1608', 'willecormier', 'sgu20141493', 'sgu20141445', 'sgu20141417', 'sgu20131455', 'sgu20131458', 'bvalls', 'sgu960911', 'sgu20141394', 'sgu20141411', 'alexandru.smaranda19', 'gabrielmaranhao10', 'gjfdjzo', 'sgu20141395', 'ne471nanoschool', 'sgu20141408', 'sgu20141465', 'andreik_94', 'sgu20131462', 'sgu20141388', 'sgu20141434', 'sgu20141459', 'lfv2108', 'sogang20141460', 'sgu20131508', 'binisor.alin', 'sgu20141468', 'sgu201414733', 'ghks031800', 'sgu20141389', 'far9an', 'sanduramona75', 'sgu20151485', 'sgu20131431', 'zhehan666', 'sgu20161474', 'riccardo.pietrella', 'bangong12', 'sgu20131496', 'sgu20131432', 'sgu20141385', 'dkorakakis', None, 'minchaoan', 'bratosin.vm', 'sgu20141450', 'ldesanti', 'davidjung01', 'sgu20131412', 'monikapathare97', 'sgu20141476', 'datleb', 'namrataravi26', 'sgu20131374', 'sgu20161494']"
14,235,55,27,20,"['dke625', 'sgu20141493', 'sgu20141445', 'sgu20141441', 'sgu20131458', 'sgu20141453', 'sgu20131414', 'saemin1024', 'sohnt', 'sgu20141388', 'sgu20141434', 'sgu201414733', 'hoobeen', 'sgu20131420', 'sgu20131431', 'bangong12', 'sgu20131496', 'davidjung01', 'sgu20131484', 'sgu20131374']",34,"['amruthaa176', 'willecormier', 'sagor01840', 'jakariaalamin1994', 'bvalls', 'sgu20141429', 'alexandru.smaranda19', 'gabrielmaranhao10', 'ne471nanoschool', 'andreik_94', 'ana.costea47', 'tangjiemu', 'lfv2108', 'dogaruvalentin94', 'danilozaro10', 'ghkskxlr', 'binisor.alin', 'd.ramos.santesmases', 'ghks031800', 'far9an', 'sanduramona75', 'zhehan666', 'mostakmorshedshuvo95shuvo2015018', 'riccardo.pietrella', 'dkorakakis', 'minchaoan', 'bratosin.vm', 'sohnterry', 'ldesanti', 'monikapathare97', 'chuhang.jin', 'datleb', 'namrataravi26', 'do1608']",7,"['sgu20151485', 'dusxo124', 'sgu20151957', 'sgu20141483', 'taehojung', 'sgu20131432', None]",61,"['amruthaa176', 'dke625', 'sgu20141441', 'sagor01840', 'jakariaalamin1994', 'sgu20141429', 'sgu20141483', 'sgu20141453', 'sgu20131414', 'saemin1024', 'sohnt', 'ana.costea47', 'sgu20151957', 'tangjiemu', 'danilozaro10', 'dogaruvalentin94', 'ghkskxlr', 'd.ramos.santesmases', 'hoobeen', 'sgu20131420', 'mostakmorshedshuvo95shuvo2015018', 'taehojung', 'sohnterry', 'chuhang.jin', 'sgu20131484', 'do1608', 'willecormier', 'sgu20141493', 'sgu20141445', 'sgu20131458', 'bvalls', 'alexandru.smaranda19', 'gabrielmaranhao10', 'ne471nanoschool', 'andreik_94', 'sgu20141388', 'sgu20141434', 'lfv2108', 'binisor.alin', 'sgu201414733', 'ghks031800', 'far9an', 'sanduramona75', 'sgu20151485', 'sgu20131431', 'zhehan666', 'dusxo124', 'riccardo.pietrella', 'bangong12', 'sgu20131496', 'sgu20131432', 'dkorakakis', None, 'minchaoan', 'bratosin.vm', 'ldesanti', 'davidjung01', 'monikapathare97', 'datleb', 'namrataravi26', 'sgu20131374']"
14,227,55,26,23,"['dke625', 'sgu20141493', 'sgu20141445', 'sgu20141441', 'sgu20131458', 'sgu20141429', 'sgu20141453', 'sgu20131414', 'saemin1024', 'sohnt', 'sgu20141388', 'sgu20141434', 'ghkskxlr', 'sgu201414733', 'hoobeen', 'ghks031800', 'sgu20131420', 'sgu20131431', 'sohnterry', 'davidjung01', 'sgu20131484', 'sgu20131374', 'do1608']",31,"['amruthaa176', 'willecormier', 'sagor01840', 'jakariaalamin1994', 'bvalls', 'alexandru.smaranda19', 'gabrielmaranhao10', 'ne471nanoschool', 'andreik_94', 'ana.costea47', 'tangjiemu', 'lfv2108', 'dogaruvalentin94', 'danilozaro10', 'binisor.alin', 'd.ramos.santesmases', 'far9an', 'sanduramona75', 'zhehan666', 'mostakmorshedshuvo95shuvo2015018', 'riccardo.pietrella', 'bangong12', 'sgu20131496', 'dkorakakis', 'minchaoan', 'bratosin.vm', 'ldesanti', 'monikapathare97', 'chuhang.jin', 'datleb', 'namrataravi26']",3,"['sgu20141476', None, 'happyman1104']",57,"['amruthaa176', 'dke625', 'sgu20141441', 'sagor01840', 'jakariaalamin1994', 'sgu20141429', 'sgu20141453', 'sgu20131414', 'saemin1024', 'sohnt', 'ana.costea47', 'tangjiemu', 'danilozaro10', 'dogaruvalentin94', 'ghkskxlr', 'd.ramos.santesmases', 'hoobeen', 'sgu20131420', 'happyman1104', 'mostakmorshedshuvo95shuvo2015018', 'sohnterry', 'chuhang.jin', 'sgu20131484', 'do1608', 'willecormier', 'sgu20141493', 'sgu20141445', 'sgu20131458', 'bvalls', 'alexandru.smaranda19', 'gabrielmaranhao10', 'ne471nanoschool', 'andreik_94', 'sgu20141388', 'sgu20141434', 'lfv2108', 'binisor.alin', 'sgu201414733', 'ghks031800', 'far9an', 'sanduramona75', 'sgu20131431', 'zhehan666', 'riccardo.pietrella', 'bangong12', 'sgu20131496', 'dkorakakis', None, 'minchaoan', 'bratosin.vm', 'ldesanti', 'davidjung01', 'monikapathare97', 'sgu20141476', 'datleb', 'namrataravi26', 'sgu20131374']"
14,233,55,12,4,"['jakariaalamin1994', 'far9an', 'sagor01840', 'mostakmorshedshuvo95shuvo2015018']",50,"['amruthaa176', 'dke625', 'willecormier', 'sgu20141493', 'sgu20141445', 'sgu20141441', 'sgu20131458', 'bvalls', 'sgu20141429', 'alexandru.smaranda19', 'gabrielmaranhao10', 'sgu20141453', 'sgu20131414', 'ne471nanoschool', 'andreik_94', 'saemin1024', 'sohnt', 'ana.costea47', 'tangjiemu', 'sgu20141388', 'sgu20141434', 'lfv2108', 'danilozaro10', 'dogaruvalentin94', 'ghkskxlr', 'binisor.alin', 'sgu201414733', 'd.ramos.santesmases', 'hoobeen', 'ghks031800', 'sanduramona75', 'sgu20131420', 'sgu20131431', 'zhehan666', 'riccardo.pietrella', 'bangong12', 'sgu20131496', 'dkorakakis', 'minchaoan', 'bratosin.vm', 'sohnterry', 'ldesanti', 'davidjung01', 'monikapathare97', 'chuhang.jin', 'sgu20131484', 'datleb', 'namrataravi26', 'sgu20131374', 'do1608']",8,"['bakarsiddique', 'abubakarsiddqueand', 'sumayeara.tammee', 'altamim', 'sabbirraihan88', 'sakib_01', 'joynul', None]",62,"['amruthaa176', 'dke625', 'willecormier', 'sgu20141493', 'sgu20141445', 'sgu20141441', 'sgu20131458', 'sagor01840', 'jakariaalamin1994', 'bvalls', 'sgu20141429', 'sakib_01', 'alexandru.smaranda19', 'gabrielmaranhao10', 'sgu20141453', 'bakarsiddique', 'altamim', 'sgu20131414', 'ne471nanoschool', 'andreik_94', 'saemin1024', 'sohnt', 'ana.costea47', 'tangjiemu', 'sgu20141388', 'sgu20141434', 'joynul', 'lfv2108', 'danilozaro10', 'dogaruvalentin94', 'ghkskxlr', 'binisor.alin', 'sgu201414733', 'd.ramos.santesmases', 'hoobeen', 'ghks031800', 'abubakarsiddqueand', 'far9an', 'sanduramona75', 'sgu20131420', 'sgu20131431', 'zhehan666', 'mostakmorshedshuvo95shuvo2015018', 'riccardo.pietrella', 'bangong12', 'sumayeara.tammee', 'sgu20131496', 'sabbirraihan88', 'dkorakakis', None, 'minchaoan', 'bratosin.vm', 'sohnterry', 'ldesanti', 'davidjung01', 'monikapathare97', 'chuhang.jin', 'sgu20131484', 'datleb', 'namrataravi26', 'sgu20131374', 'do1608']"
14,229,55,11,1,['bvalls'],53,"['amruthaa176', 'dke625', 'willecormier', 'sgu20141493', 'sgu20141445', 'sgu20141441', 'sgu20131458', 'sagor01840', 'jakariaalamin1994', 'sgu20141429', 'alexandru.smaranda19', 'gabrielmaranhao10', 'sgu20141453', 'sgu20131414', 'ne471nanoschool', 'andreik_94', 'saemin1024', 'sohnt', 'ana.costea47', 'tangjiemu', 'sgu20141388', 'sgu20141434', 'lfv2108', 'danilozaro10', 'dogaruvalentin94', 'ghkskxlr', 'binisor.alin', 'sgu201414733', 'd.ramos.santesmases', 'hoobeen', 'ghks031800', 'far9an', 'sanduramona75', 'sgu20131420', 'sgu20131431', 'zhehan666', 'mostakmorshedshuvo95shuvo2015018', 'riccardo.pietrella', 'bangong12', 'sgu20131496', 'dkorakakis', 'minchaoan', 'bratosin.vm', 'sohnterry', 'ldesanti', 'davidjung01', 'monikapathare97', 'chuhang.jin', 'sgu20131484', 'datleb', 'namrataravi26', 'sgu20131374', 'do1608']",10,"['vandit', 'trujillo492', 'hemacsuf1027', 'shweta1694', 'asadullah2393', 'neha893556589', 'calinisan20', 'luvpatel8', None, 'stymie']",64,"['amruthaa176', 'vandit', 'dke625', 'willecormier', 'sgu20141493', 'sgu20141445', 'sgu20141441', 'sgu20131458', 'sagor01840', 'jakariaalamin1994', 'bvalls', 'sgu20141429', 'shweta1694', 'neha893556589', 'alexandru.smaranda19', 'gabrielmaranhao10', 'sgu20141453', 'sgu20131414', 'ne471nanoschool', 'andreik_94', 'saemin1024', 'sohnt', 'ana.costea47', 'calinisan20', 'tangjiemu', 'sgu20141388', 'sgu20141434', 'luvpatel8', 'lfv2108', 'danilozaro10', 'dogaruvalentin94', 'stymie', 'ghkskxlr', 'binisor.alin', 'trujillo492', 'sgu201414733', 'd.ramos.santesmases', 'hoobeen', 'ghks031800', 'far9an', 'sanduramona75', 'sgu20131420', 'sgu20131431', 'zhehan666', 'mostakmorshedshuvo95shuvo2015018', 'riccardo.pietrella', 'bangong12', 'sgu20131496', 'dkorakakis', None, 'minchaoan', 'bratosin.vm', 'sohnterry', 'ldesanti', 'davidjung01', 'hemacsuf1027', 'monikapathare97', 'chuhang.jin', 'sgu20131484', 'datleb', 'namrataravi26', 'asadullah2393', 'sgu20131374', 'do1608']"
14,232,55,9,5,"['d.ramos.santesmases', 'chuhang.jin', 'zhehan666', 'tangjiemu', 'minchaoan']",49,"['amruthaa176', 'dke625', 'willecormier', 'sgu20141493', 'sgu20141445', 'sgu20141441', 'sgu20131458', 'sagor01840', 'jakariaalamin1994', 'bvalls', 'sgu20141429', 'alexandru.smaranda19', 'gabrielmaranhao10', 'sgu20141453', 'sgu20131414', 'ne471nanoschool', 'andreik_94', 'saemin1024', 'sohnt', 'ana.costea47', 'sgu20141388', 'sgu20141434', 'lfv2108', 'danilozaro10', 'dogaruvalentin94', 'ghkskxlr', 'binisor.alin', 'sgu201414733', 'hoobeen', 'ghks031800', 'far9an', 'sanduramona75', 'sgu20131420', 'sgu20131431', 'mostakmorshedshuvo95shuvo2015018', 'riccardo.pietrella', 'bangong12', 'sgu20131496', 'dkorakakis', 'bratosin.vm', 'sohnterry', 'ldesanti', 'davidjung01', 'monikapathare97', 'sgu20131484', 'datleb', 'namrataravi26', 'sgu20131374', 'do1608']",4,"['mickeym', 'weeei0514', None, 'siddharthsahu912']",58,"['amruthaa176', 'dke625', 'willecormier', 'sgu20141493', 'sgu20141445', 'siddharthsahu912', 'sgu20141441', 'sgu20131458', 'sagor01840', 'jakariaalamin1994', 'bvalls', 'sgu20141429', 'alexandru.smaranda19', 'gabrielmaranhao10', 'sgu20141453', 'mickeym', 'sgu20131414', 'ne471nanoschool', 'andreik_94', 'saemin1024', 'sohnt', 'ana.costea47', 'tangjiemu', 'sgu20141388', 'sgu20141434', 'lfv2108', 'danilozaro10', 'dogaruvalentin94', 'ghkskxlr', 'binisor.alin', 'sgu201414733', 'd.ramos.santesmases', 'hoobeen', 'ghks031800', 'far9an', 'sanduramona75', 'sgu20131420', 'sgu20131431', 'zhehan666', 'mostakmorshedshuvo95shuvo2015018', 'riccardo.pietrella', 'bangong12', 'sgu20131496', 'dkorakakis', None, 'minchaoan', 'bratosin.vm', 'sohnterry', 'ldesanti', 'davidjung01', 'weeei0514', 'monikapathare97', 'chuhang.jin', 'sgu20131484', 'datleb', 'namrataravi26', 'sgu20131374', 'do1608']"
14,228,55,8,4,"['ana.costea47', 'sanduramona75', 'dogaruvalentin94', 'alexandru.smaranda19']",50,"['amruthaa176', 'dke625', 'willecormier', 'sgu20141493', 'sgu20141445', 'sgu20141441', 'sgu20131458', 'sagor01840', 'jakariaalamin1994', 'bvalls', 'sgu20141429', 'gabrielmaranhao10', 'sgu20141453', 'sgu20131414', 'ne471nanoschool', 'andreik_94', 'saemin1024', 'sohnt', 'tangjiemu', 'sgu20141388', 'sgu20141434', 'lfv2108', 'danilozaro10', 'ghkskxlr', 'binisor.alin', 'sgu201414733', 'd.ramos.santesmases', 'hoobeen', 'ghks031800', 'far9an', 'sgu20131420', 'sgu20131431', 'zhehan666', 'mostakmorshedshuvo95shuvo2015018', 'riccardo.pietrella', 'bangong12', 'sgu20131496', 'dkorakakis', 'minchaoan', 'bratosin.vm', 'sohnterry', 'ldesanti', 'davidjung01', 'monikapathare97', 'chuhang.jin', 'sgu20131484', 'datleb', 'namrataravi26', 'sgu20131374', 'do1608']",4,"['a.lauragheorghe', 'velea_95', None, 'elenacorina.melcescu']",58,"['amruthaa176', 'dke625', 'willecormier', 'sgu20141493', 'sgu20141445', 'sgu20141441', 'sgu20131458', 'sagor01840', 'jakariaalamin1994', 'bvalls', 'sgu20141429', 'alexandru.smaranda19', 'gabrielmaranhao10', 'sgu20141453', 'sgu20131414', 'ne471nanoschool', 'andreik_94', 'saemin1024', 'sohnt', 'ana.costea47', 'velea_95', 'tangjiemu', 'sgu20141388', 'sgu20141434', 'lfv2108', 'danilozaro10', 'dogaruvalentin94', 'ghkskxlr', 'binisor.alin', 'a.lauragheorghe', 'sgu201414733', 'd.ramos.santesmases', 'hoobeen', 'ghks031800', 'far9an', 'sanduramona75', 'sgu20131420', 'sgu20131431', 'zhehan666', 'mostakmorshedshuvo95shuvo2015018', 'riccardo.pietrella', 'bangong12', 'sgu20131496', 'dkorakakis', None, 'minchaoan', 'bratosin.vm', 'sohnterry', 'ldesanti', 'davidjung01', 'monikapathare97', 'chuhang.jin', 'sgu20131484', 'datleb', 'elenacorina.melcescu', 'namrataravi26', 'sgu20131374', 'do1608']"
14,230,55,8,5,"['binisor.alin', 'sanduramona75', 'andreik_94', 'dogaruvalentin94', 'bratosin.vm']",49,"['amruthaa176', 'dke625', 'willecormier', 'sgu20141493', 'sgu20141445', 'sgu20141441', 'sgu20131458', 'sagor01840', 'jakariaalamin1994', 'bvalls', 'sgu20141429', 'alexandru.smaranda19', 'gabrielmaranhao10', 'sgu20141453', 'sgu20131414', 'ne471nanoschool', 'saemin1024', 'sohnt', 'ana.costea47', 'tangjiemu', 'sgu20141388', 'sgu20141434', 'lfv2108', 'danilozaro10', 'ghkskxlr', 'sgu201414733', 'd.ramos.santesmases', 'hoobeen', 'ghks031800', 'far9an', 'sgu20131420', 'sgu20131431', 'zhehan666', 'mostakmorshedshuvo95shuvo2015018', 'riccardo.pietrella', 'bangong12', 'sgu20131496', 'dkorakakis', 'minchaoan', 'sohnterry', 'ldesanti', 'davidjung01', 'monikapathare97', 'chuhang.jin', 'sgu20131484', 'datleb', 'namrataravi26', 'sgu20131374', 'do1608']",3,"['a.lauragheorghe', None, 'elenacorina.melcescu']",57,"['amruthaa176', 'dke625', 'willecormier', 'sgu20141493', 'sgu20141445', 'sgu20141441', 'sgu20131458', 'sagor01840', 'jakariaalamin1994', 'bvalls', 'sgu20141429', 'alexandru.smaranda19', 'gabrielmaranhao10', 'sgu20141453', 'sgu20131414', 'ne471nanoschool', 'andreik_94', 'saemin1024', 'sohnt', 'ana.costea47', 'tangjiemu', 'sgu20141388', 'sgu20141434', 'lfv2108', 'danilozaro10', 'dogaruvalentin94', 'ghkskxlr', 'binisor.alin', 'a.lauragheorghe', 'sgu201414733', 'd.ramos.santesmases', 'hoobeen', 'ghks031800', 'far9an', 'sanduramona75', 'sgu20131420', 'sgu20131431', 'zhehan666', 'mostakmorshedshuvo95shuvo2015018', 'riccardo.pietrella', 'bangong12', 'sgu20131496', 'dkorakakis', None, 'minchaoan', 'bratosin.vm', 'sohnterry', 'ldesanti', 'davidjung01', 'monikapathare97', 'chuhang.jin', 'sgu20131484', 'datleb', 'elenacorina.melcescu', 'namrataravi26', 'sgu20131374', 'do1608']"
14,231,55,6,1,['ne471nanoschool'],53,"['amruthaa176', 'dke625', 'willecormier', 'sgu20141493', 'sgu20141445', 'sgu20141441', 'sgu20131458', 'sagor01840', 'jakariaalamin1994', 'bvalls', 'sgu20141429', 'alexandru.smaranda19', 'gabrielmaranhao10', 'sgu20141453', 'sgu20131414', 'andreik_94', 'saemin1024', 'sohnt', 'ana.costea47', 'tangjiemu', 'sgu20141388', 'sgu20141434', 'lfv2108', 'danilozaro10', 'dogaruvalentin94', 'ghkskxlr', 'binisor.alin', 'sgu201414733', 'd.ramos.santesmases', 'hoobeen', 'ghks031800', 'far9an', 'sanduramona75', 'sgu20131420', 'sgu20131431', 'zhehan666', 'mostakmorshedshuvo95shuvo2015018', 'riccardo.pietrella', 'bangong12', 'sgu20131496', 'dkorakakis', 'minchaoan', 'bratosin.vm', 'sohnterry', 'ldesanti', 'davidjung01', 'monikapathare97', 'chuhang.jin', 'sgu20131484', 'datleb', 'namrataravi26', 'sgu20131374', 'do1608']",5,"['dkhosla', 'r25islam', 'hmitwaly', None, 'okokok9']",59,"['amruthaa176', 'dke625', 'willecormier', 'sgu20141493', 'sgu20141445', 'sgu20141441', 'sgu20131458', 'sagor01840', 'jakariaalamin1994', 'bvalls', 'sgu20141429', 'alexandru.smaranda19', 'gabrielmaranhao10', 'sgu20141453', 'sgu20131414', 'ne471nanoschool', 'andreik_94', 'saemin1024', 'sohnt', 'ana.costea47', 'hmitwaly', 'tangjiemu', 'sgu20141388', 'sgu20141434', 'lfv2108', 'danilozaro10', 'dogaruvalentin94', 'okokok9', 'ghkskxlr', 'binisor.alin', 'sgu201414733', 'd.ramos.santesmases', 'hoobeen', 'ghks031800', 'far9an', 'sanduramona75', 'sgu20131420', 'sgu20131431', 'zhehan666', 'mostakmorshedshuvo95shuvo2015018', 'riccardo.pietrella', 'bangong12', 'sgu20131496', 'dkorakakis', None, 'minchaoan', 'bratosin.vm', 'dkhosla', 'sohnterry', 'ldesanti', 'davidjung01', 'monikapathare97', 'chuhang.jin', 'sgu20131484', 'datleb', 'namrataravi26', 'sgu20131374', 'r25islam', 'do1608']"
14,234,55,6,1,['ne471nanoschool'],53,"['amruthaa176', 'dke625', 'willecormier', 'sgu20141493', 'sgu20141445', 'sgu20141441', 'sgu20131458', 'sagor01840', 'jakariaalamin1994', 'bvalls', 'sgu20141429', 'alexandru.smaranda19', 'gabrielmaranhao10', 'sgu20141453', 'sgu20131414', 'andreik_94', 'saemin1024', 'sohnt', 'ana.costea47', 'tangjiemu', 'sgu20141388', 'sgu20141434', 'lfv2108', 'danilozaro10', 'dogaruvalentin94', 'ghkskxlr', 'binisor.alin', 'sgu201414733', 'd.ramos.santesmases', 'hoobeen', 'ghks031800', 'far9an', 'sanduramona75', 'sgu20131420', 'sgu20131431', 'zhehan666', 'mostakmorshedshuvo95shuvo2015018', 'riccardo.pietrella', 'bangong12', 'sgu20131496', 'dkorakakis', 'minchaoan', 'bratosin.vm', 'sohnterry', 'ldesanti', 'davidjung01', 'monikapathare97', 'chuhang.jin', 'sgu20131484', 'datleb', 'namrataravi26', 'sgu20131374', 'do1608']",5,"['dkhosla', 'r25islam', 'hmitwaly', None, 'okokok9']",59,"['amruthaa176', 'dke625', 'willecormier', 'sgu20141493', 'sgu20141445', 'sgu20141441', 'sgu20131458', 'sagor01840', 'jakariaalamin1994', 'bvalls', 'sgu20141429', 'alexandru.smaranda19', 'gabrielmaranhao10', 'sgu20141453', 'sgu20131414', 'ne471nanoschool', 'andreik_94', 'saemin1024', 'sohnt', 'ana.costea47', 'hmitwaly', 'tangjiemu', 'sgu20141388', 'sgu20141434', 'lfv2108', 'danilozaro10', 'dogaruvalentin94', 'okokok9', 'ghkskxlr', 'binisor.alin', 'sgu201414733', 'd.ramos.santesmases', 'hoobeen', 'ghks031800', 'far9an', 'sanduramona75', 'sgu20131420', 'sgu20131431', 'zhehan666', 'mostakmorshedshuvo95shuvo2015018', 'riccardo.pietrella', 'bangong12', 'sgu20131496', 'dkorakakis', None, 'minchaoan', 'bratosin.vm', 'dkhosla', 'sohnterry', 'ldesanti', 'davidjung01', 'monikapathare97', 'chuhang.jin', 'sgu20131484', 'datleb', 'namrataravi26', 'sgu20131374', 'r25islam', 'do1608']"
15,61,54,54,50,"['e.e.ladron', 'mvalois27', 'soliddevicesfall2018', 'jl48853', 'milpatel0606', 'npoindexter', 'kylessimpson', 'eawad24', 'avuong99', 'harrison.ab', 'nickpatel24', 'kwawrzyniak', 'tanyyang', 'm.lo', 'erictmenger', 'malonei', 'brandhon.sweeney', 'andy.yang', 'scratem', 'remarkt', 'agoya', 'argho7x7', 'bsapolsky', 'katrina12m', 'ttharpe', 'mariaw', 'ramiroj4', 'daniel.bermudez', 'llibukun', 'j.ospina', 'astegall', 'josh3081', 'caelum', 'ngp0619', 'ferreira.k', 'ncbaker', 'drivera2960', 'mickle94', 'ceceliabistrong', 'jpirino', 'henrydoublejay', 'xavieraponte', 'mater508', 'pierre.l', 'katlynnejones', 'craigbash', 'perezbenjamin48', 'chadingram2800', 'jamesegruber', 'mpercival']",3,"['juliettefr', 'bezell05', 'rvsidekick6']",4,"['nmiller95', None, 'rvarn', 'joseph1997']",57,"['e.e.ladron', 'nmiller95', 'kylessimpson', 'npoindexter', 'harrison.ab', 'kwawrzyniak', 'm.lo', 'malonei', 'juliettefr', 'andy.yang', 'remarkt', 'agoya', 'argho7x7', 'rvarn', 'joseph1997', 'llibukun', 'astegall', 'josh3081', 'caelum', 'ncbaker', 'drivera2960', 'ceceliabistrong', 'henrydoublejay', 'xavieraponte', 'pierre.l', 'bezell05', 'craigbash', 'perezbenjamin48', 'jamesegruber', 'scratem', 'mpercival', 'mvalois27', 'soliddevicesfall2018', 'jl48853', 'milpatel0606', 'eawad24', 'rvsidekick6', 'avuong99', 'nickpatel24', 'tanyyang', 'erictmenger', 'brandhon.sweeney', 'bsapolsky', 'katrina12m', 'ttharpe', 'mariaw', 'ramiroj4', 'daniel.bermudez', 'j.ospina', 'ngp0619', 'ferreira.k', None, 'mickle94', 'jpirino', 'mater508', 'katlynnejones', 'chadingram2800']"
15,217,54,53,51,"['e.e.ladron', 'mvalois27', 'soliddevicesfall2018', 'jl48853', 'milpatel0606', 'npoindexter', 'kylessimpson', 'eawad24', 'rvsidekick6', 'avuong99', 'harrison.ab', 'nickpatel24', 'kwawrzyniak', 'm.lo', 'malonei', 'erictmenger', 'tanyyang', 'brandhon.sweeney', 'juliettefr', 'andy.yang', 'remarkt', 'agoya', 'argho7x7', 'bsapolsky', 'katrina12m', 'ttharpe', 'mariaw', 'ramiroj4', 'daniel.bermudez', 'llibukun', 'j.ospina', 'astegall', 'josh3081', 'ngp0619', 'ferreira.k', 'ncbaker', 'drivera2960', 'mickle94', 'ceceliabistrong', 'jpirino', 'henrydoublejay', 'xavieraponte', 'mater508', 'katlynnejones', 'pierre.l', 'jamesegruber', 'craigbash', 'perezbenjamin48', 'chadingram2800', 'scratem', 'mpercival']",2,"['bezell05', 'caelum']",2,"[None, 'joseph1997']",55,"['e.e.ladron', 'kylessimpson', 'npoindexter', 'harrison.ab', 'kwawrzyniak', 'm.lo', 'malonei', 'juliettefr', 'andy.yang', 'remarkt', 'agoya', 'argho7x7', 'joseph1997', 'llibukun', 'astegall', 'josh3081', 'caelum', 'ncbaker', 'drivera2960', 'ceceliabistrong', 'henrydoublejay', 'xavieraponte', 'pierre.l', 'bezell05', 'craigbash', 'perezbenjamin48', 'jamesegruber', 'scratem', 'mpercival', 'mvalois27', 'soliddevicesfall2018', 'jl48853', 'milpatel0606', 'eawad24', 'rvsidekick6', 'avuong99', 'nickpatel24', 'tanyyang', 'erictmenger', 'brandhon.sweeney', 'bsapolsky', 'katrina12m', 'ttharpe', 'mariaw', 'ramiroj4', 'daniel.bermudez', 'j.ospina', 'ngp0619', 'ferreira.k', None, 'mickle94', 'jpirino', 'mater508', 'katlynnejones', 'chadingram2800']"
15,358,54,53,51,"['e.e.ladron', 'mvalois27', 'soliddevicesfall2018', 'jl48853', 'kylessimpson', 'milpatel0606', 'npoindexter', 'rvsidekick6', 'avuong99', 'harrison.ab', 'nickpatel24', 'kwawrzyniak', 'm.lo', 'malonei', 'erictmenger', 'tanyyang', 'brandhon.sweeney', 'juliettefr', 'andy.yang', 'remarkt', 'agoya', 'argho7x7', 'bsapolsky', 'katrina12m', 'ttharpe', 'mariaw', 'ramiroj4', 'daniel.bermudez', 'llibukun', 'j.ospina', 'astegall', 'josh3081', 'caelum', 'ngp0619', 'ferreira.k', 'ncbaker', 'drivera2960', 'mickle94', 'jpirino', 'ceceliabistrong', 'henrydoublejay', 'xavieraponte', 'mater508', 'katlynnejones', 'pierre.l', 'jamesegruber', 'craigbash', 'perezbenjamin48', 'chadingram2800', 'scratem', 'mpercival']",2,"['eawad24', 'bezell05']",2,"[None, 'joseph1997']",55,"['e.e.ladron', 'kylessimpson', 'npoindexter', 'harrison.ab', 'kwawrzyniak', 'm.lo', 'malonei', 'juliettefr', 'andy.yang', 'remarkt', 'agoya', 'argho7x7', 'joseph1997', 'llibukun', 'astegall', 'josh3081', 'caelum', 'ncbaker', 'drivera2960', 'ceceliabistrong', 'henrydoublejay', 'xavieraponte', 'pierre.l', 'bezell05', 'craigbash', 'perezbenjamin48', 'jamesegruber', 'scratem', 'mpercival', 'mvalois27', 'soliddevicesfall2018', 'jl48853', 'milpatel0606', 'eawad24', 'rvsidekick6', 'avuong99', 'nickpatel24', 'tanyyang', 'erictmenger', 'brandhon.sweeney', 'bsapolsky', 'katrina12m', 'ttharpe', 'mariaw', 'ramiroj4', 'daniel.bermudez', 'j.ospina', 'ngp0619', 'ferreira.k', None, 'mickle94', 'jpirino', 'mater508', 'katlynnejones', 'chadingram2800']"
16,307,54,53,51,"['nayeemababul98', 'tegaorogun', 'elcarter1065', 'umair27', 'jamescounter', 'parkl137', 'adriansamler', 'hughmungus1234', 'dilrajmankoo', 'euan.j.davis', 'barat.abid', 'callumveer1', 'jacktookey', 'lilymaymeechan', 'shehinedias', 'ellisfrank28', 'aspataru', 'lify_khossen', 'hanifa1706', 'hamizahmalek', 'j.harding', 'saskia.mobin', 'crebyrne', 'amasson', 'farahli', 'lfurneaux13', 'ruthfosbo', 'mhyder', 'ddouglas98', 'zainpearlhall', 'anshuli', 'alexandroslfc', 'racheljames464', 'hatton.d99', 'beckywhayman', 'zainh17', 'callum.abercromby', 'joedore19', 'thomaslyhe23', 'hughr894', 'zacharycauchi', 'meganrdaw', 'jenna.moors', 'izzlefizzle99', 'ludmilacerne', 'keithkyc', 'francesktowers', 'elliemutter13', 'alexwall', 'michaelaustin381', 'anisa_2465']",2,"['libanx99', 'ali_baletti']",2,"['wzy9162017', None]",55,"['nayeemababul98', 'tegaorogun', 'elcarter1065', 'jamescounter', 'adriansamler', 'hughmungus1234', 'barat.abid', 'callumveer1', 'jacktookey', 'lilymaymeechan', 'shehinedias', 'hanifa1706', 'crebyrne', 'hamizahmalek', 'saskia.mobin', 'amasson', 'mhyder', 'hatton.d99', 'callum.abercromby', 'joedore19', 'hughr894', 'zacharycauchi', 'meganrdaw', 'jenna.moors', 'francesktowers', 'elliemutter13', 'michaelaustin381', 'alexwall', 'umair27', 'dilrajmankoo', 'parkl137', 'euan.j.davis', 'anisa_2465', 'ellisfrank28', 'aspataru', 'lify_khossen', 'j.harding', 'farahli', 'lfurneaux13', 'ruthfosbo', 'libanx99', 'ddouglas98', 'anshuli', 'alexandroslfc', 'racheljames464', 'beckywhayman', 'zainh17', 'thomaslyhe23', None, 'izzlefizzle99', 'ludmilacerne', 'keithkyc', 'wzy9162017', 'ali_baletti', 'zainpearlhall']"
17,142,51,40,30,"['morgoncosby', 'krishn73', 'smit2625', 'guo307', 'kline40', 'morri382', 'pgegg', 'meberha', 'hhermes', 'petrosky', 'ainaa_aisyaa', 'ggushurst11', 'payne68', 'mitch171', 'mklingse', 'bprestin', 'inmans', 'gerber24', 'ding145', 'mserewic', 'zhan2536', 'rleather', 'ahmad24', 'melvin3', 'baird11', 'zieglert', 'owellbor', 'pangn', 'psteckle', 'king357']",20,"['tgoldbe', 'kkurpius', 'amartint', 'pkurczek', 'wells89', 'dhurley', 'llahrma16', 'cervantd', 'ma529', 'keener0', 'dinino', 'dshoue', 'wu801', 'mwardebe', 'mbanerje', 'hong224', 'ren127', 'reynol86', 'white494', 'fowlerh']",10,"['deshpan5', 'wissela', 'astubber', 'farrel18', 'mill1914', 'saldwin', 'rmaccion', 'lpl', None, 'edabagia']",60,"['morgoncosby', 'guo307', 'kline40', 'farrel18', 'pgegg', 'mill1914', 'saldwin', 'amartint', 'pkurczek', 'dhurley', 'cervantd', 'ggushurst11', 'ma529', 'keener0', 'dinino', 'psteckle', 'wu801', 'bprestin', 'inmans', 'gerber24', 'zhan2536', 'deshpan5', 'zieglert', 'owellbor', 'king357', 'wissela', 'krishn73', 'smit2625', 'tgoldbe', 'morri382', 'meberha', 'kkurpius', 'rmaccion', 'hhermes', 'petrosky', 'edabagia', 'wells89', 'llahrma16', 'ainaa_aisyaa', 'astubber', 'payne68', 'dshoue', 'mitch171', 'mwardebe', 'mklingse', 'mbanerje', 'hong224', 'ren127', None, 'ding145', 'mserewic', 'ahmad24', 'melvin3', 'rleather', 'baird11', 'reynol86', 'white494', 'pangn', 'fowlerh', 'lpl']"
17,184,51,29,23,"['morgoncosby', 'krishn73', 'smit2625', 'guo307', 'kline40', 'pgegg', 'meberha', 'hhermes', 'petrosky', 'ggushurst11', 'payne68', 'mitch171', 'bprestin', 'gerber24', 'zhan2536', 'rleather', 'ahmad24', 'melvin3', 'baird11', 'zieglert', 'owellbor', 'psteckle', 'king357']",27,"['tgoldbe', 'morri382', 'kkurpius', 'amartint', 'pkurczek', 'wells89', 'dhurley', 'llahrma16', 'cervantd', 'ainaa_aisyaa', 'ma529', 'keener0', 'dinino', 'dshoue', 'wu801', 'mwardebe', 'mklingse', 'mbanerje', 'inmans', 'hong224', 'ren127', 'ding145', 'mserewic', 'reynol86', 'white494', 'pangn', 'fowlerh']",6,"['astubber', 'farrel18', 'saldwin', 'rmaccion', None, 'edabagia']",56,"['morgoncosby', 'guo307', 'kline40', 'farrel18', 'pgegg', 'saldwin', 'amartint', 'pkurczek', 'dhurley', 'cervantd', 'ggushurst11', 'ma529', 'keener0', 'dinino', 'psteckle', 'wu801', 'bprestin', 'inmans', 'gerber24', 'zhan2536', 'zieglert', 'owellbor', 'king357', 'krishn73', 'smit2625', 'tgoldbe', 'morri382', 'meberha', 'kkurpius', 'rmaccion', 'hhermes', 'petrosky', 'edabagia', 'wells89', 'llahrma16', 'ainaa_aisyaa', 'astubber', 'payne68', 'dshoue', 'mitch171', 'mwardebe', 'mklingse', 'mbanerje', 'hong224', 'ren127', None, 'ding145', 'mserewic', 'ahmad24', 'melvin3', 'rleather', 'baird11', 'reynol86', 'white494', 'pangn', 'fowlerh']"
18,433,51,64,48,"['klee146', 'ivanf2', 'vjain13', 'sun87', 'trprice2', 'jdlambe2', 'dbala2', 'xliu147', 'pjha6', 'parafin2', 'fortelk2', 'baning2', 'kaconra2', 'hsankar2', 'dspoole2', 'dwharmo2', 'jpanell2', 'ttran82', 'cdnorth2', 'jfy2', 'gzak2', 'rbwhite2', 'dpetrou2', 'goedelm2', 'shao22', 'claramu2', 'mwallen3', 'gpopovi2', 'awad4', 'uhrich2', 'ejwahl2', 'anthonymorales15', 'cmackh2', 'malmsbu2', 'gonzalo11', 'mprogal2', 'sathvik2', 'tkimmle2', 'djpeter3', 'cwjanse2', 'pakelts2', 'tanmaykanth', 'asengup3', 'mhnolton', 'bpepper2', 'viwilso2', 'kulkwsk2', 'ayanoh2']",2,"['hchen126', 'nejdl2']",16,"['donlin2', 'kpcourt2', 'wmuckia2', 'vthana2', 'dongyun2', 'dmntpls2', 'ali41', 'hawken2', 'mgosma2', 'junqima2', 'jlozier2', 'kevinu2', 'signalsca', 'jrshapi2', 'mzalews2', None]",66,"['trprice2', 'jdlambe2', 'ali41', 'junqima2', 'pjha6', 'fortelk2', 'kaconra2', 'ttran82', 'cdnorth2', 'signalsca', 'mzalews2', 'goedelm2', 'claramu2', 'hawken2', 'mwallen3', 'awad4', 'uhrich2', 'ejwahl2', 'cmackh2', 'mprogal2', 'vthana2', 'cwjanse2', 'jrshapi2', 'klee146', 'ivanf2', 'vjain13', 'sun87', 'dbala2', 'xliu147', 'parafin2', 'nejdl2', 'baning2', 'hsankar2', 'dspoole2', 'dwharmo2', 'jpanell2', 'kpcourt2', 'jlozier2', 'jfy2', 'gzak2', 'rbwhite2', 'wmuckia2', 'hchen126', 'dpetrou2', 'shao22', 'gpopovi2', 'anthonymorales15', None, 'malmsbu2', 'gonzalo11', 'sathvik2', 'donlin2', 'tkimmle2', 'djpeter3', 'dmntpls2', 'mgosma2', 'pakelts2', 'kevinu2', 'tanmaykanth', 'asengup3', 'mhnolton', 'bpepper2', 'viwilso2', 'dongyun2', 'kulkwsk2', 'ayanoh2']"
18,171,51,62,48,"['klee146', 'ivanf2', 'vjain13', 'sun87', 'trprice2', 'jdlambe2', 'dbala2', 'xliu147', 'pjha6', 'parafin2', 'fortelk2', 'baning2', 'kaconra2', 'hsankar2', 'dspoole2', 'dwharmo2', 'jpanell2', 'ttran82', 'cdnorth2', 'jfy2', 'gzak2', 'rbwhite2', 'dpetrou2', 'goedelm2', 'shao22', 'claramu2', 'mwallen3', 'gpopovi2', 'awad4', 'uhrich2', 'ejwahl2', 'anthonymorales15', 'cmackh2', 'malmsbu2', 'gonzalo11', 'mprogal2', 'sathvik2', 'tkimmle2', 'djpeter3', 'cwjanse2', 'pakelts2', 'tanmaykanth', 'asengup3', 'mhnolton', 'bpepper2', 'viwilso2', 'kulkwsk2', 'ayanoh2']",2,"['hchen126', 'nejdl2']",14,"['donlin2', 'wmuckia2', 'dongyun2', 'vthana2', 'dmntpls2', 'ali41', 'hawken2', 'mgosma2', 'junqima2', 'jlozier2', 'kevinu2', 'signalsca', 'mzalews2', None]",64,"['trprice2', 'jdlambe2', 'ali41', 'junqima2', 'pjha6', 'fortelk2', 'kaconra2', 'ttran82', 'cdnorth2', 'signalsca', 'mzalews2', 'goedelm2', 'claramu2', 'hawken2', 'mwallen3', 'awad4', 'uhrich2', 'ejwahl2', 'cmackh2', 'mprogal2', 'vthana2', 'cwjanse2', 'klee146', 'ivanf2', 'vjain13', 'sun87', 'dbala2', 'xliu147', 'parafin2', 'nejdl2', 'baning2', 'hsankar2', 'dspoole2', 'dwharmo2', 'jpanell2', 'jlozier2', 'jfy2', 'gzak2', 'rbwhite2', 'wmuckia2', 'hchen126', 'dpetrou2', 'shao22', 'gpopovi2', 'anthonymorales15', None, 'malmsbu2', 'gonzalo11', 'sathvik2', 'donlin2', 'tkimmle2', 'djpeter3', 'dmntpls2', 'mgosma2', 'pakelts2', 'kevinu2', 'tanmaykanth', 'asengup3', 'mhnolton', 'bpepper2', 'viwilso2', 'dongyun2', 'kulkwsk2', 'ayanoh2']"
18,432,51,6,4,"['cwjanse2', 'hchen126', 'ayanoh2', 'gpopovi2']",46,"['klee146', 'ivanf2', 'vjain13', 'sun87', 'trprice2', 'jdlambe2', 'dbala2', 'xliu147', 'pjha6', 'parafin2', 'fortelk2', 'nejdl2', 'baning2', 'kaconra2', 'hsankar2', 'dspoole2', 'dwharmo2', 'jpanell2', 'ttran82', 'cdnorth2', 'jfy2', 'gzak2', 'rbwhite2', 'dpetrou2', 'goedelm2', 'shao22', 'claramu2', 'mwallen3', 'awad4', 'uhrich2', 'ejwahl2', 'anthonymorales15', 'cmackh2', 'malmsbu2', 'gonzalo11', 'mprogal2', 'sathvik2', 'tkimmle2', 'djpeter3', 'pakelts2', 'tanmaykanth', 'asengup3', 'mhnolton', 'bpepper2', 'viwilso2', 'kulkwsk2']",2,"[None, 'vthana2']",52,"['klee146', 'ivanf2', 'vjain13', 'sun87', 'trprice2', 'jdlambe2', 'dbala2', 'xliu147', 'pjha6', 'parafin2', 'fortelk2', 'nejdl2', 'baning2', 'kaconra2', 'hsankar2', 'dspoole2', 'dwharmo2', 'jpanell2', 'ttran82', 'cdnorth2', 'jfy2', 'gzak2', 'rbwhite2', 'hchen126', 'dpetrou2', 'goedelm2', 'shao22', 'claramu2', 'mwallen3', 'gpopovi2', 'awad4', 'uhrich2', 'ejwahl2', 'anthonymorales15', 'cmackh2', None, 'malmsbu2', 'gonzalo11', 'mprogal2', 'sathvik2', 'tkimmle2', 'djpeter3', 'vthana2', 'cwjanse2', 'pakelts2', 'tanmaykanth', 'asengup3', 'mhnolton', 'bpepper2', 'viwilso2', 'kulkwsk2', 'ayanoh2']"
19,216,49,57,48,"['nnovitsky', 'joanne.zheng', 'marystuartelder', 'ammiexia', 'siyuan_chen', 'idkwain', 'xiangjin', 'justinhavas', 'ian_hanus', 'jierong1220', 'yousuf.rehman7', 'allencao', 'srabinowitz', 'joeyliang99', 'zoey1998', 'kerrycastor', 'fooiey', 'jmb186', 'gmak6464', 'lindamanyenga', 'cjingram2020', 'casiomichael', 'matthew.harris.1998', 'aricarri', 'luciamees2016', 'rishdafish97', 'ramilmsh', 'elamorhan', 'jacarde4', 'gkw12345', 'knice', 'joanna.li', 'jar121', 'bluedevil729', 'ltruitt5', 'nev', 'hannahwilen', 'davidmiron80', 'trevor.stevenson', 'alicettdai', 'cooper.lair', 'jswubbenhorst', 'nguyen.andy.le', 'chaofan.tao', 'bgolbin', 'iwillforgetthisname', 'anshudwibhashi', 'qinwen.deng168367']",0,[],9,"['malhotra.divyesha', 'karanv667', 'deniz.simsek', 'aarondfranklin', 'suman.bajgain', 'ben_jackson341', 'annadiemel', 'eceodev', None]",57,"['joanne.zheng', 'marystuartelder', 'siyuan_chen', 'idkwain', 'xiangjin', 'ian_hanus', 'kerrycastor', 'fooiey', 'gmak6464', 'lindamanyenga', 'casiomichael', 'matthew.harris.1998', 'luciamees2016', 'rishdafish97', 'jacarde4', 'gkw12345', 'aarondfranklin', 'joanna.li', 'jar121', 'ltruitt5', 'nev', 'alicettdai', 'cooper.lair', 'jswubbenhorst', 'bgolbin', 'iwillforgetthisname', 'annadiemel', 'qinwen.deng168367', 'karanv667', 'nnovitsky', 'ammiexia', 'deniz.simsek', 'suman.bajgain', 'justinhavas', 'jierong1220', 'yousuf.rehman7', 'allencao', 'srabinowitz', 'joeyliang99', 'zoey1998', 'jmb186', 'cjingram2020', 'ben_jackson341', 'aricarri', 'ramilmsh', 'elamorhan', 'knice', 'bluedevil729', None, 'hannahwilen', 'malhotra.divyesha', 'davidmiron80', 'trevor.stevenson', 'nguyen.andy.le', 'chaofan.tao', 'anshudwibhashi', 'eceodev']"
19,279,49,51,48,"['nnovitsky', 'joanne.zheng', 'marystuartelder', 'ammiexia', 'siyuan_chen', 'idkwain', 'xiangjin', 'justinhavas', 'ian_hanus', 'jierong1220', 'yousuf.rehman7', 'allencao', 'srabinowitz', 'joeyliang99', 'zoey1998', 'kerrycastor', 'fooiey', 'jmb186', 'gmak6464', 'lindamanyenga', 'cjingram2020', 'casiomichael', 'matthew.harris.1998', 'aricarri', 'luciamees2016', 'rishdafish97', 'ramilmsh', 'elamorhan', 'jacarde4', 'gkw12345', 'knice', 'joanna.li', 'jar121', 'bluedevil729', 'ltruitt5', 'nev', 'hannahwilen', 'davidmiron80', 'trevor.stevenson', 'alicettdai', 'cooper.lair', 'jswubbenhorst', 'nguyen.andy.le', 'chaofan.tao', 'bgolbin', 'iwillforgetthisname', 'anshudwibhashi', 'qinwen.deng168367']",0,[],3,"['karanv667', None, 'annadiemel']",51,"['joanne.zheng', 'marystuartelder', 'siyuan_chen', 'idkwain', 'xiangjin', 'ian_hanus', 'kerrycastor', 'fooiey', 'gmak6464', 'lindamanyenga', 'casiomichael', 'matthew.harris.1998', 'luciamees2016', 'rishdafish97', 'jacarde4', 'gkw12345', 'joanna.li', 'jar121', 'ltruitt5', 'nev', 'alicettdai', 'cooper.lair', 'jswubbenhorst', 'bgolbin', 'iwillforgetthisname', 'annadiemel', 'qinwen.deng168367', 'karanv667', 'nnovitsky', 'ammiexia', 'justinhavas', 'jierong1220', 'yousuf.rehman7', 'allencao', 'srabinowitz', 'joeyliang99', 'zoey1998', 'jmb186', 'cjingram2020', 'aricarri', 'ramilmsh', 'elamorhan', 'knice', 'bluedevil729', None, 'hannahwilen', 'davidmiron80', 'trevor.stevenson', 'nguyen.andy.le', 'chaofan.tao', 'anshudwibhashi']"
19,262,49,46,43,"['nnovitsky', 'joanne.zheng', 'marystuartelder', 'ammiexia', 'siyuan_chen', 'idkwain', 'xiangjin', 'justinhavas', 'ian_hanus', 'jierong1220', 'yousuf.rehman7', 'allencao', 'srabinowitz', 'joeyliang99', 'zoey1998', 'kerrycastor', 'fooiey', 'jmb186', 'cjingram2020', 'casiomichael', 'aricarri', 'rishdafish97', 'luciamees2016', 'ramilmsh', 'gkw12345', 'knice', 'joanna.li', 'jar121', 'bluedevil729', 'ltruitt5', 'nev', 'hannahwilen', 'davidmiron80', 'trevor.stevenson', 'alicettdai', 'cooper.lair', 'jswubbenhorst', 'nguyen.andy.le', 'chaofan.tao', 'bgolbin', 'iwillforgetthisname', 'anshudwibhashi', 'qinwen.deng168367']",5,"['elamorhan', 'jacarde4', 'gmak6464', 'lindamanyenga', 'matthew.harris.1998']",3,"['oelam', None, 'annadiemel']",51,"['joanne.zheng', 'marystuartelder', 'siyuan_chen', 'idkwain', 'xiangjin', 'ian_hanus', 'kerrycastor', 'fooiey', 'gmak6464', 'lindamanyenga', 'casiomichael', 'matthew.harris.1998', 'luciamees2016', 'rishdafish97', 'jacarde4', 'gkw12345', 'oelam', 'joanna.li', 'jar121', 'ltruitt5', 'nev', 'alicettdai', 'cooper.lair', 'jswubbenhorst', 'bgolbin', 'iwillforgetthisname', 'annadiemel', 'qinwen.deng168367', 'nnovitsky', 'ammiexia', 'justinhavas', 'jierong1220', 'yousuf.rehman7', 'allencao', 'srabinowitz', 'joeyliang99', 'zoey1998', 'jmb186', 'cjingram2020', 'aricarri', 'ramilmsh', 'elamorhan', 'knice', 'bluedevil729', None, 'hannahwilen', 'davidmiron80', 'trevor.stevenson', 'nguyen.andy.le', 'chaofan.tao', 'anshudwibhashi']"
19,341,49,31,27,"['ammiexia', 'siyuan_chen', 'idkwain', 'xiangjin', 'justinhavas', 'ian_hanus', 'jierong1220', 'allencao', 'joeyliang99', 'zoey1998', 'kerrycastor', 'jmb186', 'gmak6464', 'lindamanyenga', 'casiomichael', 'matthew.harris.1998', 'aricarri', 'ramilmsh', 'jacarde4', 'knice', 'jar121', 'trevor.stevenson', 'cooper.lair', 'nguyen.andy.le', 'chaofan.tao', 'bgolbin', 'anshudwibhashi']",21,"['nnovitsky', 'joanne.zheng', 'marystuartelder', 'yousuf.rehman7', 'srabinowitz', 'fooiey', 'cjingram2020', 'rishdafish97', 'luciamees2016', 'elamorhan', 'gkw12345', 'joanna.li', 'bluedevil729', 'ltruitt5', 'nev', 'hannahwilen', 'davidmiron80', 'alicettdai', 'jswubbenhorst', 'iwillforgetthisname', 'qinwen.deng168367']",4,"['malhotra.divyesha', 'annadiemel', None, 'wubbbiz']",52,"['joanne.zheng', 'marystuartelder', 'siyuan_chen', 'idkwain', 'xiangjin', 'ian_hanus', 'kerrycastor', 'fooiey', 'gmak6464', 'lindamanyenga', 'casiomichael', 'matthew.harris.1998', 'luciamees2016', 'rishdafish97', 'jacarde4', 'gkw12345', 'joanna.li', 'jar121', 'ltruitt5', 'nev', 'alicettdai', 'cooper.lair', 'jswubbenhorst', 'bgolbin', 'iwillforgetthisname', 'annadiemel', 'qinwen.deng168367', 'nnovitsky', 'ammiexia', 'justinhavas', 'wubbbiz', 'jierong1220', 'yousuf.rehman7', 'allencao', 'srabinowitz', 'joeyliang99', 'zoey1998', 'jmb186', 'cjingram2020', 'aricarri', 'ramilmsh', 'elamorhan', 'knice', 'bluedevil729', None, 'hannahwilen', 'malhotra.divyesha', 'davidmiron80', 'trevor.stevenson', 'nguyen.andy.le', 'chaofan.tao', 'anshudwibhashi']"
20,115,49,66,1,['buchnich'],47,"['durgapavankumar', 'gunandrose', 'ritz99887', 'guofu', 'kuroykkr1129', 'gianca', 'pardhi34', 'vchand33', 'auxedyn', 'amirhossein11', 'purnimaasalve', 'omustecaplioglu', 'liji66666', 'yutaka3991', 'cdhan', 'plabininayak', 'r.sriramkarthik', 'wangxxzj', 'gattuabhijith1125', 'jndukaif', 'mzc258369', 'kalpeshdhole', 'asen.nano', 'hven1234', 'pranavphansekar99', 'amanmaskay', 'avantivartak256', 'aniketlambture50', 'abhijith1125', 'bkkim60', 'allo0186', 'yadav.vaishnavi042', 'indranujgangan97', 'geetha0802', 'rahulrokade220', 'sanathtalekar98', 'trvarun94', 'urja.29', 'sumit.korade99', 'u02632322', 'ashkura19', 'd.panda.2016', 'chenyang821', 'jwal7309', 'komalmore48', 'jnuernbe', 'yuning']",65,"['sharm338', 'ng000046', 'mendo123', 'thiosady', 'eric3331', 'damic014', 'yang6086', 'levac004', 'werki004', 'salmo091', 'utzma006', 'kambo001', 'zamri003', 'and04848', 'almai005', 'sirraf1', 'wegex009', 'prusi009', 'hagst077', 'schm4149', 'olso5589', 'kapla302', 'vuong056', 'jarga001', 'hanza023', 'gagno094', 'gerva039', 'hentg030', 'olso7126', 'leex8370', 'bajda004', 'chandol314', 'raabx028', 'nebix006', 'tran0559', 'royxx318', 'kianx006', 'zhou0868', 'richard_thompson', 'klonc003', 'fuxxx391', 'mukon004', 'dang0134', 'keech015', 'wille474', 'tuft0029', 'parke867', 'leama008', 'conwe007', 'mendo172', None, 'joh02339', 'klung009', 'spred003', 'udstr005', 'nicho919', 'gesex006', 'yang5123', 'dixon347', 'sahyo002', 'alhin010', 'providedrailroad', 'lyde0037', 'kruss008', 'sswisher']",113,"['sharm338', 'durgapavankumar', 'ng000046', 'mendo123', 'damic014', 'levac004', 'werki004', 'guofu', 'and04848', 'almai005', 'wegex009', 'prusi009', 'pardhi34', 'auxedyn', 'schm4149', 'amirhossein11', 'olso5589', 'vuong056', 'cdhan', 'plabininayak', 'r.sriramkarthik', 'hentg030', 'gattuabhijith1125', 'olso7126', 'buchnich', 'bajda004', 'raabx028', 'nebix006', 'kalpeshdhole', 'hven1234', 'richard_thompson', 'pranavphansekar99', 'fuxxx391', 'amanmaskay', 'mukon004', 'avantivartak256', 'aniketlambture50', 'bkkim60', 'allo0186', 'yadav.vaishnavi042', 'indranujgangan97', 'rahulrokade220', 'ashkura19', 'd.panda.2016', 'chenyang821', 'jwal7309', 'gesex006', 'sahyo002', 'jnuernbe', 'alhin010', 'lyde0037', 'joh02339', 'gunandrose', 'thiosady', 'ritz99887', 'eric3331', 'yang6086', 'salmo091', 'utzma006', 'kambo001', 'zamri003', 'kuroykkr1129', 'gianca', 'sirraf1', 'hagst077', 'vchand33', 'kapla302', 'jarga001', 'hanza023', 'purnimaasalve', 'gagno094', 'omustecaplioglu', 'liji66666', 'yutaka3991', 'gerva039', 'wangxxzj', 'leex8370', 'chandol314', 'jndukaif', 'tran0559', 'mzc258369', 'asen.nano', 'royxx318', 'kianx006', 'zhou0868', 'klonc003', 'dang0134', 'abhijith1125', 'keech015', 'wille474', 'tuft0029', 'parke867', 'leama008', 'conwe007', 'mendo172', None, 'geetha0802', 'sanathtalekar98', 'trvarun94', 'urja.29', 'sumit.korade99', 'u02632322', 'klung009', 'spred003', 'udstr005', 'nicho919', 'yang5123', 'dixon347', 'komalmore48', 'yuning', 'providedrailroad', 'kruss008', 'sswisher']"
20,15,49,26,1,['yuning'],47,"['durgapavankumar', 'gunandrose', 'ritz99887', 'guofu', 'kuroykkr1129', 'gianca', 'pardhi34', 'vchand33', 'auxedyn', 'amirhossein11', 'purnimaasalve', 'omustecaplioglu', 'liji66666', 'yutaka3991', 'cdhan', 'plabininayak', 'r.sriramkarthik', 'wangxxzj', 'gattuabhijith1125', 'buchnich', 'jndukaif', 'mzc258369', 'kalpeshdhole', 'asen.nano', 'hven1234', 'pranavphansekar99', 'amanmaskay', 'avantivartak256', 'aniketlambture50', 'abhijith1125', 'bkkim60', 'allo0186', 'yadav.vaishnavi042', 'indranujgangan97', 'geetha0802', 'rahulrokade220', 'sanathtalekar98', 'trvarun94', 'urja.29', 'sumit.korade99', 'u02632322', 'ashkura19', 'd.panda.2016', 'chenyang821', 'jwal7309', 'komalmore48', 'jnuernbe']",25,"['dko1217', 'davidlnguyen96', 'estradavictor96', 'nalvarez92', 'ge24', 'bbaekssun', 'addashti', 'indronil.ghosh27', 'jackhoeniges', 'alghfeli', 'muhamriaz', 'yhlee27', 'ruodaz', 'plloydwright', 'dsreynolds93', 'juhu93', 'jhoeniges', 'labmiugac2993', 'akshayb', None, 'jaydm26', 'ujash', 'gsabbir87', 'nuchizono', 'cjelloian']",73,"['durgapavankumar', 'gunandrose', 'dko1217', 'ritz99887', 'davidlnguyen96', 'guofu', 'kuroykkr1129', 'gianca', 'estradavictor96', 'nalvarez92', 'bbaekssun', 'ge24', 'pardhi34', 'vchand33', 'auxedyn', 'amirhossein11', 'addashti', 'indronil.ghosh27', 'jackhoeniges', 'purnimaasalve', 'omustecaplioglu', 'liji66666', 'yutaka3991', 'cdhan', 'alghfeli', 'plabininayak', 'r.sriramkarthik', 'muhamriaz', 'wangxxzj', 'gattuabhijith1125', 'yhlee27', 'ruodaz', 'buchnich', 'plloydwright', 'jndukaif', 'mzc258369', 'kalpeshdhole', 'asen.nano', 'dsreynolds93', 'hven1234', 'pranavphansekar99', 'juhu93', 'amanmaskay', 'avantivartak256', 'aniketlambture50', 'abhijith1125', 'jhoeniges', 'labmiugac2993', 'bkkim60', 'allo0186', 'akshayb', None, 'yadav.vaishnavi042', 'indranujgangan97', 'geetha0802', 'rahulrokade220', 'sanathtalekar98', 'jaydm26', 'trvarun94', 'urja.29', 'sumit.korade99', 'u02632322', 'ujash', 'ashkura19', 'd.panda.2016', 'chenyang821', 'jwal7309', 'komalmore48', 'gsabbir87', 'jnuernbe', 'yuning', 'nuchizono', 'cjelloian']"
20,10,49,18,3,"['auxedyn', 'cdhan', 'chenyang821']",45,"['durgapavankumar', 'gunandrose', 'ritz99887', 'guofu', 'kuroykkr1129', 'gianca', 'pardhi34', 'vchand33', 'amirhossein11', 'purnimaasalve', 'omustecaplioglu', 'liji66666', 'yutaka3991', 'plabininayak', 'r.sriramkarthik', 'wangxxzj', 'gattuabhijith1125', 'buchnich', 'jndukaif', 'mzc258369', 'kalpeshdhole', 'asen.nano', 'hven1234', 'pranavphansekar99', 'amanmaskay', 'avantivartak256', 'aniketlambture50', 'abhijith1125', 'bkkim60', 'allo0186', 'yadav.vaishnavi042', 'indranujgangan97', 'geetha0802', 'rahulrokade220', 'sanathtalekar98', 'trvarun94', 'urja.29', 'sumit.korade99', 'u02632322', 'ashkura19', 'd.panda.2016', 'jwal7309', 'komalmore48', 'jnuernbe', 'yuning']",15,"['ibassi1', 'hmeena', 'jzhou129', 'sgnanave', 'jnuernbe7728', 'aawarrie', 'skallam666', 'zirshovon', 'pbaikadi96', 'kgaddipa', 'arajan10', 'bclenzen', 'trietho', None, 'vasileska']",63,"['durgapavankumar', 'gunandrose', 'ritz99887', 'jzhou129', 'guofu', 'kuroykkr1129', 'gianca', 'bclenzen', 'pardhi34', 'vchand33', 'auxedyn', 'amirhossein11', 'hmeena', 'purnimaasalve', 'jnuernbe7728', 'omustecaplioglu', 'liji66666', 'yutaka3991', 'cdhan', 'plabininayak', 'r.sriramkarthik', 'wangxxzj', 'gattuabhijith1125', 'vasileska', 'buchnich', 'jndukaif', 'mzc258369', 'kalpeshdhole', 'asen.nano', 'hven1234', 'pranavphansekar99', 'amanmaskay', 'sgnanave', 'avantivartak256', 'aniketlambture50', 'abhijith1125', 'pbaikadi96', 'kgaddipa', 'bkkim60', 'allo0186', None, 'yadav.vaishnavi042', 'indranujgangan97', 'geetha0802', 'rahulrokade220', 'sanathtalekar98', 'ibassi1', 'trvarun94', 'urja.29', 'sumit.korade99', 'u02632322', 'ashkura19', 'd.panda.2016', 'chenyang821', 'jwal7309', 'aawarrie', 'komalmore48', 'skallam666', 'jnuernbe', 'zirshovon', 'yuning', 'arajan10', 'trietho']"
20,322,49,18,2,"['jnuernbe', 'cdhan']",46,"['durgapavankumar', 'gunandrose', 'ritz99887', 'guofu', 'kuroykkr1129', 'gianca', 'pardhi34', 'vchand33', 'auxedyn', 'amirhossein11', 'purnimaasalve', 'omustecaplioglu', 'liji66666', 'yutaka3991', 'plabininayak', 'r.sriramkarthik', 'wangxxzj', 'gattuabhijith1125', 'buchnich', 'jndukaif', 'mzc258369', 'kalpeshdhole', 'asen.nano', 'hven1234', 'pranavphansekar99', 'amanmaskay', 'avantivartak256', 'aniketlambture50', 'abhijith1125', 'bkkim60', 'allo0186', 'yadav.vaishnavi042', 'indranujgangan97', 'geetha0802', 'rahulrokade220', 'sanathtalekar98', 'trvarun94', 'urja.29', 'sumit.korade99', 'u02632322', 'ashkura19', 'd.panda.2016', 'chenyang821', 'jwal7309', 'komalmore48', 'yuning']",16,"['ibassi1', 'hmeena', 'mavadha1', 'akkrish3', 'jzhou129', 'sgnanave', 'skallam666', 'sthirum6', 'ttmccart', 'pbaikadi96', 'zirshovon', 'jjacoby3', 'bclenzen', 'trietho', None, 'cyang130']",64,"['durgapavankumar', 'gunandrose', 'mavadha1', 'ritz99887', 'jzhou129', 'guofu', 'kuroykkr1129', 'gianca', 'bclenzen', 'pardhi34', 'vchand33', 'auxedyn', 'amirhossein11', 'hmeena', 'purnimaasalve', 'omustecaplioglu', 'liji66666', 'yutaka3991', 'cdhan', 'plabininayak', 'r.sriramkarthik', 'jjacoby3', 'wangxxzj', 'gattuabhijith1125', 'buchnich', 'jndukaif', 'mzc258369', 'kalpeshdhole', 'asen.nano', 'hven1234', 'pranavphansekar99', 'amanmaskay', 'sgnanave', 'sthirum6', 'avantivartak256', 'aniketlambture50', 'abhijith1125', 'ttmccart', 'pbaikadi96', 'bkkim60', 'allo0186', 'cyang130', None, 'yadav.vaishnavi042', 'indranujgangan97', 'geetha0802', 'rahulrokade220', 'sanathtalekar98', 'ibassi1', 'trvarun94', 'urja.29', 'sumit.korade99', 'u02632322', 'akkrish3', 'ashkura19', 'd.panda.2016', 'chenyang821', 'jwal7309', 'skallam666', 'komalmore48', 'jnuernbe', 'zirshovon', 'yuning', 'trietho']"
20,11,49,16,14,"['rahulrokade220', 'sanathtalekar98', 'pardhi34', 'kalpeshdhole', 'urja.29', 'ritz99887', 'pranavphansekar99', 'ashkura19', 'purnimaasalve', 'komalmore48', 'avantivartak256', 'aniketlambture50', 'yadav.vaishnavi042', 'indranujgangan97']",34,"['durgapavankumar', 'gunandrose', 'guofu', 'kuroykkr1129', 'gianca', 'vchand33', 'auxedyn', 'amirhossein11', 'omustecaplioglu', 'liji66666', 'yutaka3991', 'cdhan', 'plabininayak', 'r.sriramkarthik', 'wangxxzj', 'gattuabhijith1125', 'buchnich', 'jndukaif', 'mzc258369', 'asen.nano', 'hven1234', 'amanmaskay', 'abhijith1125', 'bkkim60', 'allo0186', 'geetha0802', 'trvarun94', 'sumit.korade99', 'u02632322', 'd.panda.2016', 'chenyang821', 'jwal7309', 'jnuernbe', 'yuning']",2,"['aparna.rne', None]",50,"['durgapavankumar', 'gunandrose', 'ritz99887', 'guofu', 'kuroykkr1129', 'gianca', 'pardhi34', 'vchand33', 'auxedyn', 'amirhossein11', 'purnimaasalve', 'omustecaplioglu', 'liji66666', 'yutaka3991', 'cdhan', 'plabininayak', 'r.sriramkarthik', 'wangxxzj', 'gattuabhijith1125', 'buchnich', 'jndukaif', 'mzc258369', 'kalpeshdhole', 'asen.nano', 'hven1234', 'pranavphansekar99', 'amanmaskay', 'avantivartak256', 'aniketlambture50', 'abhijith1125', 'bkkim60', 'allo0186', None, 'yadav.vaishnavi042', 'indranujgangan97', 'geetha0802', 'rahulrokade220', 'sanathtalekar98', 'trvarun94', 'urja.29', 'sumit.korade99', 'u02632322', 'ashkura19', 'd.panda.2016', 'chenyang821', 'jwal7309', 'komalmore48', 'jnuernbe', 'yuning', 'aparna.rne']"
20,13,49,15,2,"['durgapavankumar', 'abhijith1125']",46,"['gunandrose', 'ritz99887', 'guofu', 'kuroykkr1129', 'gianca', 'pardhi34', 'vchand33', 'auxedyn', 'amirhossein11', 'purnimaasalve', 'omustecaplioglu', 'liji66666', 'yutaka3991', 'cdhan', 'plabininayak', 'r.sriramkarthik', 'wangxxzj', 'gattuabhijith1125', 'buchnich', 'jndukaif', 'mzc258369', 'kalpeshdhole', 'asen.nano', 'hven1234', 'pranavphansekar99', 'amanmaskay', 'avantivartak256', 'aniketlambture50', 'bkkim60', 'allo0186', 'yadav.vaishnavi042', 'indranujgangan97', 'geetha0802', 'rahulrokade220', 'sanathtalekar98', 'trvarun94', 'urja.29', 'sumit.korade99', 'u02632322', 'ashkura19', 'd.panda.2016', 'chenyang821', 'jwal7309', 'komalmore48', 'jnuernbe', 'yuning']",13,"['manojkumar.pydimarri', 'swati.kumari', 'ashi1999', 'shyamrishi.kashyap', 'saiprasad_cv', 'vinitsaini', 'g.saikiran', 'mahathi.ganimisetti', 'vs.phanindra', 'hanu.saisudhir', None, 'rohit_peesa', 'garuda.pranathi']",61,"['durgapavankumar', 'gunandrose', 'ashi1999', 'ritz99887', 'saiprasad_cv', 'vinitsaini', 'guofu', 'kuroykkr1129', 'gianca', 'g.saikiran', 'pardhi34', 'vchand33', 'auxedyn', 'amirhossein11', 'manojkumar.pydimarri', 'purnimaasalve', 'omustecaplioglu', 'liji66666', 'yutaka3991', 'cdhan', 'plabininayak', 'r.sriramkarthik', 'wangxxzj', 'gattuabhijith1125', 'garuda.pranathi', 'buchnich', 'jndukaif', 'mzc258369', 'kalpeshdhole', 'asen.nano', 'hven1234', 'pranavphansekar99', 'amanmaskay', 'avantivartak256', 'aniketlambture50', 'abhijith1125', 'bkkim60', 'allo0186', 'vs.phanindra', None, 'yadav.vaishnavi042', 'indranujgangan97', 'geetha0802', 'rahulrokade220', 'sanathtalekar98', 'trvarun94', 'urja.29', 'sumit.korade99', 'u02632322', 'swati.kumari', 'shyamrishi.kashyap', 'ashkura19', 'd.panda.2016', 'chenyang821', 'jwal7309', 'komalmore48', 'jnuernbe', 'yuning', 'mahathi.ganimisetti', 'hanu.saisudhir', 'rohit_peesa']"
20,9,49,9,5,"['durgapavankumar', 'plabininayak', 'd.panda.2016', 'abhijith1125', 'r.sriramkarthik']",43,"['gunandrose', 'ritz99887', 'guofu', 'kuroykkr1129', 'gianca', 'pardhi34', 'vchand33', 'auxedyn', 'amirhossein11', 'purnimaasalve', 'omustecaplioglu', 'liji66666', 'yutaka3991', 'cdhan', 'wangxxzj', 'gattuabhijith1125', 'buchnich', 'jndukaif', 'mzc258369', 'kalpeshdhole', 'asen.nano', 'hven1234', 'pranavphansekar99', 'amanmaskay', 'avantivartak256', 'aniketlambture50', 'bkkim60', 'allo0186', 'yadav.vaishnavi042', 'indranujgangan97', 'geetha0802', 'rahulrokade220', 'sanathtalekar98', 'trvarun94', 'urja.29', 'sumit.korade99', 'u02632322', 'ashkura19', 'chenyang821', 'jwal7309', 'komalmore48', 'jnuernbe', 'yuning']",4,"['saiprasad_cv', None, 'vivekg', 'rohit_peesa']",52,"['durgapavankumar', 'gunandrose', 'ritz99887', 'saiprasad_cv', 'vivekg', 'guofu', 'kuroykkr1129', 'gianca', 'pardhi34', 'vchand33', 'auxedyn', 'amirhossein11', 'purnimaasalve', 'omustecaplioglu', 'liji66666', 'yutaka3991', 'cdhan', 'plabininayak', 'r.sriramkarthik', 'wangxxzj', 'gattuabhijith1125', 'buchnich', 'jndukaif', 'mzc258369', 'kalpeshdhole', 'asen.nano', 'hven1234', 'pranavphansekar99', 'amanmaskay', 'avantivartak256', 'aniketlambture50', 'abhijith1125', 'bkkim60', 'allo0186', None, 'yadav.vaishnavi042', 'indranujgangan97', 'geetha0802', 'rahulrokade220', 'sanathtalekar98', 'trvarun94', 'urja.29', 'sumit.korade99', 'u02632322', 'ashkura19', 'd.panda.2016', 'chenyang821', 'jwal7309', 'komalmore48', 'jnuernbe', 'yuning', 'rohit_peesa']"
20,14,49,9,3,"['jnuernbe', 'vchand33', 'cdhan']",45,"['durgapavankumar', 'gunandrose', 'ritz99887', 'guofu', 'kuroykkr1129', 'gianca', 'pardhi34', 'auxedyn', 'amirhossein11', 'purnimaasalve', 'omustecaplioglu', 'liji66666', 'yutaka3991', 'plabininayak', 'r.sriramkarthik', 'wangxxzj', 'gattuabhijith1125', 'buchnich', 'jndukaif', 'mzc258369', 'kalpeshdhole', 'asen.nano', 'hven1234', 'pranavphansekar99', 'amanmaskay', 'avantivartak256', 'aniketlambture50', 'abhijith1125', 'bkkim60', 'allo0186', 'yadav.vaishnavi042', 'indranujgangan97', 'geetha0802', 'rahulrokade220', 'sanathtalekar98', 'trvarun94', 'urja.29', 'sumit.korade99', 'u02632322', 'ashkura19', 'd.panda.2016', 'chenyang821', 'jwal7309', 'komalmore48', 'yuning']",6,"['ibassi1', 'sean.babcock', 'aawarrie', 'kgaddipa', 'arajan10', None]",54,"['durgapavankumar', 'gunandrose', 'ritz99887', 'guofu', 'kuroykkr1129', 'gianca', 'pardhi34', 'vchand33', 'auxedyn', 'amirhossein11', 'purnimaasalve', 'omustecaplioglu', 'liji66666', 'yutaka3991', 'cdhan', 'plabininayak', 'r.sriramkarthik', 'wangxxzj', 'gattuabhijith1125', 'buchnich', 'jndukaif', 'mzc258369', 'kalpeshdhole', 'asen.nano', 'sean.babcock', 'hven1234', 'pranavphansekar99', 'amanmaskay', 'avantivartak256', 'aniketlambture50', 'abhijith1125', 'kgaddipa', 'bkkim60', 'allo0186', None, 'yadav.vaishnavi042', 'indranujgangan97', 'geetha0802', 'rahulrokade220', 'sanathtalekar98', 'ibassi1', 'trvarun94', 'urja.29', 'sumit.korade99', 'u02632322', 'ashkura19', 'd.panda.2016', 'chenyang821', 'jwal7309', 'aawarrie', 'komalmore48', 'jnuernbe', 'yuning', 'arajan10']"
20,12,49,8,1,['bkkim60'],47,"['durgapavankumar', 'gunandrose', 'ritz99887', 'guofu', 'kuroykkr1129', 'gianca', 'pardhi34', 'vchand33', 'auxedyn', 'amirhossein11', 'purnimaasalve', 'omustecaplioglu', 'liji66666', 'yutaka3991', 'cdhan', 'plabininayak', 'r.sriramkarthik', 'wangxxzj', 'gattuabhijith1125', 'buchnich', 'jndukaif', 'mzc258369', 'kalpeshdhole', 'asen.nano', 'hven1234', 'pranavphansekar99', 'amanmaskay', 'avantivartak256', 'aniketlambture50', 'abhijith1125', 'allo0186', 'yadav.vaishnavi042', 'indranujgangan97', 'geetha0802', 'rahulrokade220', 'sanathtalekar98', 'trvarun94', 'urja.29', 'sumit.korade99', 'u02632322', 'ashkura19', 'd.panda.2016', 'chenyang821', 'jwal7309', 'komalmore48', 'jnuernbe', 'yuning']",7,"['sgu20121462', 'claritas', 'sgu20161535', 'sgu20141385', 'sgu20141459', None, 'sgu20141450']",55,"['durgapavankumar', 'gunandrose', 'ritz99887', 'guofu', 'kuroykkr1129', 'gianca', 'sgu20161535', 'pardhi34', 'vchand33', 'auxedyn', 'sgu20121462', 'amirhossein11', 'purnimaasalve', 'omustecaplioglu', 'liji66666', 'yutaka3991', 'cdhan', 'claritas', 'plabininayak', 'r.sriramkarthik', 'sgu20141459', 'wangxxzj', 'gattuabhijith1125', 'buchnich', 'jndukaif', 'mzc258369', 'kalpeshdhole', 'asen.nano', 'hven1234', 'pranavphansekar99', 'amanmaskay', 'avantivartak256', 'aniketlambture50', 'abhijith1125', 'bkkim60', 'allo0186', 'sgu20141385', None, 'yadav.vaishnavi042', 'indranujgangan97', 'geetha0802', 'rahulrokade220', 'sanathtalekar98', 'sgu20141450', 'trvarun94', 'urja.29', 'sumit.korade99', 'u02632322', 'ashkura19', 'd.panda.2016', 'chenyang821', 'jwal7309', 'komalmore48', 'jnuernbe', 'yuning']"
21,309,47,90,19,"['eugenep2', 'scc3', 'aneeshj2', 'mjoza2', 'tylerjj2', 'masonpb2', 'cisrael2', 'vfont2', 'kevin_sager', 'jillmcar', 'djgnzlz2', 'rge3', 'ab20', 'kjfrank2', 'ykoyake2', 'ncryan2', 'mollyh2', 'rmahakul13', 'yahn22']",27,"['rolijne2', 'bmcnich2', 'treppa2', 'eehoneg2', 'om288225', 'ablee2', 'akantheza', 'amprath2', 'rwlandi2', 'nim4', 'john.saputo', 'schoole2', 'sjshan2', 'bpfield2', 'neves2', 'jhardi9', 'ekisly2', 'zchen208', 'chenxiaohu', 'dp7', 'rpavone2', 'fa4', 'juliaeb2', 'emwisni2', 'ywang364', 'ocelebi2', 'matsumotokoki']",71,"['jiwu2', 'jes3', 'baohl2', 'kkl3', 'mtobah2', 'mmm4', 'goshan2', 'jhpham2', 'reishac2', 'juliajh2', 'amyrm20', 'tjf2', 'isaxton2', 'anperry2', 'kgolk2', 'caschwa2', 'junbaek2', 'djohns85', 'aeh2', 'emt2', 'gofer2', 'coderko3', 'sarahrp2', 'allenxg2', 'nosatov2', 'dahlen2', 'qz3', 'vivo2', 'schoi98', 'rsyuan2', 'gxiao2', 'spangnt2', 'sili5', 'wjsthdgkrl', 'tidate2', 'clee152', 'kph2', 'mengkem2', 'dlee145', 'zehuahe2', 'shim35', 'pranjal3', 'ellenrf2', 'jaketh2', 'rwtham2', 'yuxuanw7', 'kaiyuan7', 'skomar4', 'nsk2', 'travisc2', 'kychui2', None, 'harryf2', 'eratta2', 'garnm2', 'ckw2', 'myl3', 'jarodm2', 'earamir2', 'ckim123', 'gmle2', 'pcp2', 'dplata2', 'yiqiaol3', 'restep2', 'jmjin2', 'donnadc2', 'jinwoo2', 'kv2', 'bharath3', 'hahmad7']",117,"['eugenep2', 'scc3', 'eehoneg2', 'goshan2', 'reishac2', 'juliajh2', 'isaxton2', 'sarahrp2', 'akantheza', 'allenxg2', 'bpfield2', 'sili5', 'tidate2', 'kph2', 'neves2', 'jhardi9', 'zehuahe2', 'pranjal3', 'jaketh2', 'rwtham2', 'kychui2', 'kjfrank2', 'zchen208', 'harryf2', 'eratta2', 'mollyh2', 'ckw2', 'yiqiaol3', 'jiwu2', 'treppa2', 'mjoza2', 'tjf2', 'kgolk2', 'caschwa2', 'ablee2', 'junbaek2', 'qz3', 'schoole2', 'spangnt2', 'mengkem2', 'djgnzlz2', 'rge3', 'dlee145', 'ellenrf2', 'ekisly2', 'nsk2', 'chenxiaohu', 'dp7', 'fa4', 'myl3', 'dplata2', 'restep2', 'jmjin2', 'emwisni2', 'ywang364', 'bharath3', 'rolijne2', 'bmcnich2', 'jes3', 'baohl2', 'kkl3', 'aneeshj2', 'mtobah2', 'mmm4', 'om288225', 'jhpham2', 'tylerjj2', 'anperry2', 'djohns85', 'amprath2', 'nosatov2', 'dahlen2', 'nim4', 'vfont2', 'sjshan2', 'wjsthdgkrl', 'kevin_sager', 'shim35', 'ab20', 'yuxuanw7', 'travisc2', 'juliaeb2', 'earamir2', 'ckim123', 'donnadc2', 'jinwoo2', 'kv2', 'ocelebi2', 'amyrm20', 'aeh2', 'emt2', 'masonpb2', 'gofer2', 'coderko3', 'rwlandi2', 'vivo2', 'cisrael2', 'schoi98', 'john.saputo', 'rsyuan2', 'gxiao2', 'clee152', 'jillmcar', 'kaiyuan7', 'skomar4', None, 'ykoyake2', 'rpavone2', 'garnm2', 'ncryan2', 'rmahakul13', 'jarodm2', 'gmle2', 'pcp2', 'yahn22', 'matsumotokoki', 'hahmad7']"
21,310,47,24,21,"['bmcnich2', 'rolijne2', 'treppa2', 'eehoneg2', 'ablee2', 'amprath2', 'rwlandi2', 'nim4', 'schoole2', 'sjshan2', 'bpfield2', 'neves2', 'jhardi9', 'ekisly2', 'zchen208', 'rpavone2', 'dp7', 'fa4', 'juliaeb2', 'emwisni2', 'ocelebi2']",25,"['eugenep2', 'scc3', 'aneeshj2', 'om288225', 'mjoza2', 'tylerjj2', 'masonpb2', 'akantheza', 'cisrael2', 'john.saputo', 'vfont2', 'kevin_sager', 'jillmcar', 'djgnzlz2', 'rge3', 'ab20', 'kjfrank2', 'ykoyake2', 'chenxiaohu', 'ncryan2', 'mollyh2', 'rmahakul13', 'yahn22', 'ywang364', 'matsumotokoki']",3,"['clee152', None, 'schen173']",49,"['rolijne2', 'bmcnich2', 'eugenep2', 'scc3', 'aneeshj2', 'treppa2', 'eehoneg2', 'om288225', 'mjoza2', 'tylerjj2', 'ablee2', 'masonpb2', 'akantheza', 'amprath2', 'rwlandi2', 'cisrael2', 'nim4', 'john.saputo', 'schoole2', 'vfont2', 'sjshan2', 'bpfield2', 'clee152', 'kevin_sager', 'jillmcar', 'neves2', 'jhardi9', 'djgnzlz2', 'rge3', 'schen173', 'ab20', 'ekisly2', None, 'kjfrank2', 'ykoyake2', 'chenxiaohu', 'zchen208', 'dp7', 'rpavone2', 'ncryan2', 'mollyh2', 'rmahakul13', 'fa4', 'juliaeb2', 'yahn22', 'emwisni2', 'ywang364', 'ocelebi2', 'matsumotokoki']"
22,413,39,24,21,"['mohansai282', 'keerthi.v.17mec', 'shivam.vyas.17mec', 'tarun2', 'naman.wishraw.17mec', 'aditya1543', 'vinayreddymanda', 'tarunjnv2000', 'vbharath99', 'sucharitha', 'madhusudan.ashiya.17ece', 'iaakashaakash9', 'naveen.malik.17mec', 'adithyavarma02', 'guptaamol1999', 'phanetkar', 'shikshaa2017', 'suryasatyeswar', 'pavanreddy1999', 'kj8', 'vsaku00']",17,"['michal.balberg', 'vineetsinghal', 'baljeet10', 'faiyazkhira27', 'karthikgomada', 'daniel13579', 'manogna99', 'madhan0621', 'kontham.reddy.17mec', 'sunboykjl', 'ayush.goyal.17mec', 'dheeresh123', 'sanju927', 'nhaustein', 'saiteja.bajoji', 'shashank.aggarwal.17mec', 'prakashpanja45']",3,"['pnarasimha', 'bipin.singh', None]",41,"['baljeet10', 'mohansai282', 'bipin.singh', 'manogna99', 'keerthi.v.17mec', 'kontham.reddy.17mec', 'shivam.vyas.17mec', 'naman.wishraw.17mec', 'tarun2', 'aditya1543', 'karthikgomada', 'vinayreddymanda', 'sunboykjl', 'tarunjnv2000', 'vbharath99', 'sucharitha', 'madhusudan.ashiya.17ece', 'pnarasimha', 'iaakashaakash9', 'naveen.malik.17mec', 'michal.balberg', 'adithyavarma02', 'guptaamol1999', 'madhan0621', 'phanetkar', 'shikshaa2017', 'dheeresh123', 'sanju927', 'shashank.aggarwal.17mec', None, 'prakashpanja45', 'suryasatyeswar', 'vineetsinghal', 'faiyazkhira27', 'pavanreddy1999', 'daniel13579', 'ayush.goyal.17mec', 'nhaustein', 'kj8', 'saiteja.bajoji', 'vsaku00']"
22,414,39,13,6,"['karthikgomada', 'pavanreddy1999', 'manogna99', 'shivam.vyas.17mec', 'sanju927', 'dheeresh123']",32,"['baljeet10', 'mohansai282', 'keerthi.v.17mec', 'kontham.reddy.17mec', 'naman.wishraw.17mec', 'tarun2', 'aditya1543', 'vinayreddymanda', 'sunboykjl', 'tarunjnv2000', 'vbharath99', 'sucharitha', 'madhusudan.ashiya.17ece', 'iaakashaakash9', 'naveen.malik.17mec', 'michal.balberg', 'adithyavarma02', 'guptaamol1999', 'madhan0621', 'phanetkar', 'shikshaa2017', 'shashank.aggarwal.17mec', 'prakashpanja45', 'suryasatyeswar', 'vineetsinghal', 'faiyazkhira27', 'daniel13579', 'ayush.goyal.17mec', 'nhaustein', 'kj8', 'saiteja.bajoji', 'vsaku00']",7,"['poorna', 'bipin.singh', 'teja.kopuri.17ece', 'vasanthawada.saketh.17cvl', 'harshavardhan.sai.m', 'pnarasimha', None]",45,"['baljeet10', 'mohansai282', 'poorna', 'bipin.singh', 'manogna99', 'keerthi.v.17mec', 'kontham.reddy.17mec', 'shivam.vyas.17mec', 'naman.wishraw.17mec', 'tarun2', 'teja.kopuri.17ece', 'vasanthawada.saketh.17cvl', 'harshavardhan.sai.m', 'aditya1543', 'karthikgomada', 'vinayreddymanda', 'sunboykjl', 'tarunjnv2000', 'vbharath99', 'sucharitha', 'madhusudan.ashiya.17ece', 'pnarasimha', 'iaakashaakash9', 'naveen.malik.17mec', 'michal.balberg', 'adithyavarma02', 'guptaamol1999', 'madhan0621', 'phanetkar', 'shikshaa2017', 'dheeresh123', 'sanju927', 'shashank.aggarwal.17mec', None, 'prakashpanja45', 'suryasatyeswar', 'vineetsinghal', 'faiyazkhira27', 'pavanreddy1999', 'daniel13579', 'ayush.goyal.17mec', 'nhaustein', 'kj8', 'saiteja.bajoji', 'vsaku00']"
23,76,38,26,22,"['geralda.lara', 'ctjett', 'azahedi1', 'kbwiens', 'hujuju', 'xying2', 'dehmann', 'banigl', 'ktappend', 'africks', 'srojsati', 'jclark44', 'dnguye31', 'aspeck', 'lbrist', 'bshehab', 't09101236', 'kmaham', 'iamthematrix', 'tsforman', 'celio', 'mtian14']",15,"['catatw', 'shastin3', 'jpgerber', 'aomorgan', 'pdelcast', 'jfsilves', 'iawilkin', 'sabrah13', 'rlyocum', 'jrcolumb', 'flacowade12', 'bentley32599', 'jessica.r.columbus', 'rcraft1', 'thisismybsacct']",4,"['smaeel_2012', None, 'ecervan4', 'smural23']",41,"['geralda.lara', 'ctjett', 'azahedi1', 'shastin3', 'smaeel_2012', 'jfsilves', 'iawilkin', 'bentley32599', 'kbwiens', 'rcraft1', 'thisismybsacct', 'hujuju', 'jpgerber', 'aomorgan', 'pdelcast', 'xying2', 'dehmann', 'ecervan4', 'banigl', 'jessica.r.columbus', 'ktappend', 'africks', 'srojsati', 'catatw', 'jclark44', 'aspeck', 'dnguye31', 'sabrah13', 'lbrist', 'bshehab', 't09101236', None, 'kmaham', 'iamthematrix', 'tsforman', 'rlyocum', 'flacowade12', 'celio', 'smural23', 'mtian14', 'jrcolumb']"
23,75,38,6,1,['flacowade12'],36,"['geralda.lara', 'ctjett', 'azahedi1', 'shastin3', 'jfsilves', 'iawilkin', 'bentley32599', 'kbwiens', 'rcraft1', 'thisismybsacct', 'hujuju', 'jpgerber', 'aomorgan', 'pdelcast', 'xying2', 'dehmann', 'banigl', 'jessica.r.columbus', 'ktappend', 'africks', 'srojsati', 'catatw', 'jclark44', 'aspeck', 'dnguye31', 'sabrah13', 'lbrist', 'bshehab', 't09101236', 'kmaham', 'iamthematrix', 'tsforman', 'rlyocum', 'celio', 'mtian14', 'jrcolumb']",5,"['klhorvath25', 'blc29', 'newright8', 'neildhar', None]",42,"['geralda.lara', 'ctjett', 'azahedi1', 'shastin3', 'jfsilves', 'iawilkin', 'bentley32599', 'kbwiens', 'rcraft1', 'thisismybsacct', 'hujuju', 'jpgerber', 'aomorgan', 'pdelcast', 'xying2', 'dehmann', 'banigl', 'jessica.r.columbus', 'ktappend', 'africks', 'srojsati', 'catatw', 'klhorvath25', 'jclark44', 'aspeck', 'dnguye31', 'blc29', 'newright8', 'sabrah13', 'lbrist', 'bshehab', 't09101236', None, 'kmaham', 'iamthematrix', 'tsforman', 'rlyocum', 'neildhar', 'flacowade12', 'celio', 'mtian14', 'jrcolumb']"
23,77,38,6,1,['flacowade12'],36,"['geralda.lara', 'ctjett', 'azahedi1', 'shastin3', 'jfsilves', 'iawilkin', 'bentley32599', 'kbwiens', 'rcraft1', 'thisismybsacct', 'hujuju', 'jpgerber', 'aomorgan', 'pdelcast', 'xying2', 'dehmann', 'banigl', 'jessica.r.columbus', 'ktappend', 'africks', 'srojsati', 'catatw', 'jclark44', 'aspeck', 'dnguye31', 'sabrah13', 'lbrist', 'bshehab', 't09101236', 'kmaham', 'iamthematrix', 'tsforman', 'rlyocum', 'celio', 'mtian14', 'jrcolumb']",5,"['klhorvath25', 'abigail.mrvos', 'blc29', 'neildhar', None]",42,"['geralda.lara', 'ctjett', 'azahedi1', 'shastin3', 'jfsilves', 'iawilkin', 'bentley32599', 'kbwiens', 'rcraft1', 'thisismybsacct', 'hujuju', 'jpgerber', 'aomorgan', 'pdelcast', 'xying2', 'dehmann', 'banigl', 'jessica.r.columbus', 'ktappend', 'africks', 'srojsati', 'catatw', 'klhorvath25', 'jclark44', 'aspeck', 'dnguye31', 'blc29', 'sabrah13', 'lbrist', 'bshehab', 't09101236', None, 'kmaham', 'iamthematrix', 'abigail.mrvos', 'tsforman', 'rlyocum', 'neildhar', 'flacowade12', 'celio', 'mtian14', 'jrcolumb']"
24,281,33,42,29,"['harmon55', 'cnotting', 'shaw108', 'nmcphero', 'brow1503', 'mstreit', 'rplotner', 'apapay', 'mfarnell', 'hopem', 'kelly238', 'lam71', 'snobbe', 'niemannj', 'weiss58', 'ly8', 'conrad43', 'hschroad', 'bmckenz', 'jprukop', 'ababiukm', 'adams386', 'jkueche', 'bkeunek', 'teo0', 'chen2515', 'burnau', 'carr71', 'cmestre']",3,"['kohn2', 'dpucket', 'iwoodhou']",13,"['seey', 'carte247', 'deshpan5', 'mbrezina16', 'yao201', 'ja37989', 'titus9', 'ocegueda', 'tswolfe', 'wen', 'dbranco', 'pghaneka', None]",45,"['seey', 'carte247', 'harmon55', 'shaw108', 'cnotting', 'nmcphero', 'ja37989', 'mbrezina16', 'tswolfe', 'brow1503', 'mstreit', 'pghaneka', 'rplotner', 'apapay', 'mfarnell', 'titus9', 'hopem', 'kelly238', 'dpucket', 'lam71', 'niemannj', 'snobbe', 'weiss58', 'ly8', 'conrad43', 'hschroad', 'bmckenz', 'dbranco', 'jprukop', 'ababiukm', 'adams386', 'jkueche', 'bkeunek', 'teo0', None, 'chen2515', 'burnau', 'deshpan5', 'yao201', 'carr71', 'ocegueda', 'kohn2', 'wen', 'cmestre', 'iwoodhou']"
24,282,33,26,21,"['harmon55', 'cnotting', 'nmcphero', 'rplotner', 'apapay', 'mfarnell', 'hopem', 'kelly238', 'lam71', 'weiss58', 'ly8', 'conrad43', 'bmckenz', 'jprukop', 'adams386', 'ababiukm', 'teo0', 'chen2515', 'carr71', 'cmestre', 'iwoodhou']",11,"['burnau', 'snobbe', 'shaw108', 'kohn2', 'hschroad', 'brow1503', 'dpucket', 'jkueche', 'mstreit', 'bkeunek', 'niemannj']",5,"['seey', 'carte247', 'titus9', 'jsiwajek', None]",37,"['seey', 'carte247', 'harmon55', 'shaw108', 'cnotting', 'nmcphero', 'brow1503', 'mstreit', 'rplotner', 'apapay', 'mfarnell', 'titus9', 'hopem', 'kelly238', 'jsiwajek', 'dpucket', 'lam71', 'niemannj', 'snobbe', 'weiss58', 'ly8', 'conrad43', 'hschroad', 'bmckenz', 'jprukop', 'ababiukm', 'adams386', 'jkueche', 'bkeunek', 'teo0', None, 'chen2515', 'burnau', 'carr71', 'kohn2', 'cmestre', 'iwoodhou']"
24,351,33,25,23,"['harmon55', 'shaw108', 'cnotting', 'nmcphero', 'brow1503', 'mstreit', 'mfarnell', 'kelly238', 'lam71', 'snobbe', 'niemannj', 'ly8', 'conrad43', 'bmckenz', 'jprukop', 'adams386', 'ababiukm', 'jkueche', 'bkeunek', 'teo0', 'chen2515', 'cmestre', 'iwoodhou']",9,"['burnau', 'weiss58', 'apapay', 'carr71', 'kohn2', 'hschroad', 'hopem', 'dpucket', 'rplotner']",2,"['dwething', None]",34,"['dwething', 'harmon55', 'shaw108', 'cnotting', 'nmcphero', 'brow1503', 'mstreit', 'rplotner', 'apapay', 'mfarnell', 'hopem', 'kelly238', 'dpucket', 'lam71', 'niemannj', 'snobbe', 'weiss58', 'ly8', 'conrad43', 'hschroad', 'bmckenz', 'jprukop', 'ababiukm', 'adams386', 'jkueche', 'bkeunek', 'teo0', None, 'chen2515', 'burnau', 'carr71', 'kohn2', 'cmestre', 'iwoodhou']"
24,352,33,8,6,"['ly8', 'adams386', 'iwoodhou', 'ababiukm', 'mstreit', 'teo0']",26,"['harmon55', 'cnotting', 'shaw108', 'nmcphero', 'brow1503', 'rplotner', 'apapay', 'mfarnell', 'hopem', 'kelly238', 'dpucket', 'lam71', 'snobbe', 'niemannj', 'weiss58', 'conrad43', 'hschroad', 'bmckenz', 'jprukop', 'jkueche', 'bkeunek', 'chen2515', 'burnau', 'carr71', 'kohn2', 'cmestre']",2,"[None, 'kang214']",34,"['harmon55', 'shaw108', 'cnotting', 'nmcphero', 'brow1503', 'mstreit', 'rplotner', 'apapay', 'mfarnell', 'hopem', 'kelly238', 'dpucket', 'lam71', 'niemannj', 'snobbe', 'weiss58', 'ly8', 'conrad43', 'hschroad', 'bmckenz', 'jprukop', 'ababiukm', 'adams386', 'jkueche', 'bkeunek', 'teo0', None, 'chen2515', 'burnau', 'carr71', 'kohn2', 'cmestre', 'kang214', 'iwoodhou']"
25,306,30,31,28,"['notting133e', 'zjgxyj123', 'carlzyy', 'zyysb15105188933', 'yufeidong', 'victor9800', 'sorata', 'jyh1564591297', 'a664792523', '18isalways18hhh', 'zywrdz521', 'huaji', 'shadowdancer', 'glmdy', 'oscar877', 'satoshiohno', 'diw2122', 'tommy_tang', 'elagen', 'yiboconqueror', 'mailcaozheng', 'aliang', 'xuan0719', '1770341964zzw', 'shiwenyao', 'jinyu4416', 'wangshuyi98', 'hnxqfk']",1,['konzarnaveli'],3,"['wzy9162017', None, 'angelaes']",32,"['notting133e', 'zjgxyj123', 'carlzyy', 'zyysb15105188933', 'yufeidong', 'victor9800', 'sorata', 'jyh1564591297', 'a664792523', '18isalways18hhh', 'zywrdz521', 'huaji', 'shadowdancer', 'glmdy', 'oscar877', 'satoshiohno', 'diw2122', 'angelaes', 'tommy_tang', 'elagen', 'yiboconqueror', 'mailcaozheng', 'aliang', 'xuan0719', '1770341964zzw', None, 'shiwenyao', 'jinyu4416', 'wzy9162017', 'wangshuyi98', 'hnxqfk', 'konzarnaveli']"
26,350,30,25,15,"['ezzelgaby', 'mariam.3m', 'konswa98', 'abdogaber65', 'marawan97zizo', 'omartarekmostafaa14', 'menna21', 'maggie_tarek', 'nadine_gamal', 'eng.hassan.cu', 'nada_tarek', 'maghraby74', 'mennaessam', 'magdypeter30', 'superman_sammour']",14,"['iron_boy809', 'mosasgenius', 'amind', 'txomin', 'honarfar.alireza', 'mesposito', 'vpmagical', 'smile25258', 'dona_dodo2222', 'y0shilab', 'haithamgaafer', 'hesham.beshary', 'ivan.devwork90', 'rbdltjd']",10,"['eng.sherry.heshmat.h', 'karimfoda1', 'karinramy', 'm16p3', 'youssef.yassermounir98', 'waseem98', 'sajaaadel', 'moaz', None, 'mohanedayman']",39,"['konswa98', 'mosasgenius', 'marawan97zizo', 'eng.sherry.heshmat.h', 'menna21', 'mesposito', 'nadine_gamal', 'nada_tarek', 'magdypeter30', 'moaz', 'rbdltjd', 'superman_sammour', 'ezzelgaby', 'mariam.3m', 'amind', 'smile25258', 'dona_dodo2222', 'y0shilab', 'hesham.beshary', 'waseem98', 'ivan.devwork90', 'sajaaadel', 'abdogaber65', 'txomin', 'karimfoda1', 'maggie_tarek', 'vpmagical', 'eng.hassan.cu', 'maghraby74', 'm16p3', None, 'mohanedayman', 'iron_boy809', 'omartarekmostafaa14', 'honarfar.alireza', 'karinramy', 'haithamgaafer', 'mennaessam', 'youssef.yassermounir98']"
29,131,29,29,28,"['stogner2', 'dmgalla2', 'jkaram2', 'hchun5', 'jingwei2', 'girdhrn2', 'timzuiuc', 'nathanrampage', 'dvaz2', 'shudong2', 'yhh2', 'dbohra2', 'caryzhu2', 'ywang530', 'nw3', 'strekha2', 'sahilmorrow', 'dwh4', 'zhopkin2', 'irodeh2', 'moemoespitfire', 'yuqiaohuang0928', 'tguan2', 'abdas2', 'mdl3', 'dulin2', 'pruiett2', 'pabloc2']",0,[],1,[None],29,"['stogner2', 'dmgalla2', 'hchun5', 'jkaram2', 'jingwei2', 'nathanrampage', 'timzuiuc', 'girdhrn2', 'dvaz2', 'shudong2', 'yhh2', 'dbohra2', 'caryzhu2', 'ywang530', 'nw3', 'strekha2', 'sahilmorrow', 'dwh4', 'zhopkin2', 'irodeh2', None, 'moemoespitfire', 'yuqiaohuang0928', 'tguan2', 'abdas2', 'mdl3', 'dulin2', 'pruiett2', 'pabloc2']"
30,181,26,30,25,"['achasna2', 'deepthisuresh8', 'slzrcrt2', 'mlee141', 'fmohajir086', 'klimas2', 'figura2', 'danielleb', 'amstilger', 'gnadt2', 'alexchasnain', 'jw18', 'loughln2', 'thuynh31', 'godtag97', 'megaridis.melina', 'tyyang2', 'imfeign1997', 'savard2', 'scorchnoxap', 'archaicevil', 'mmmarko2', 'msjoy3', 'kcmalinis', 'merhode2']",0,[],5,"['hdsmith4', 'amir.ostadi2007', 'kgolk2', None, 'nickflowers7896']",30,"['achasna2', 'hdsmith4', 'deepthisuresh8', 'slzrcrt2', 'fmohajir086', 'mlee141', 'klimas2', 'kgolk2', 'figura2', 'amstilger', 'danielleb', 'nickflowers7896', 'gnadt2', 'alexchasnain', 'jw18', 'loughln2', 'thuynh31', 'godtag97', 'megaridis.melina', None, 'tyyang2', 'imfeign1997', 'savard2', 'scorchnoxap', 'archaicevil', 'mmmarko2', 'amir.ostadi2007', 'msjoy3', 'kcmalinis', 'merhode2']"
30,280,26,30,25,"['achasna2', 'deepthisuresh8', 'slzrcrt2', 'mlee141', 'fmohajir086', 'klimas2', 'figura2', 'danielleb', 'amstilger', 'gnadt2', 'alexchasnain', 'jw18', 'loughln2', 'thuynh31', 'godtag97', 'megaridis.melina', 'tyyang2', 'imfeign1997', 'savard2', 'scorchnoxap', 'archaicevil', 'mmmarko2', 'msjoy3', 'kcmalinis', 'merhode2']",0,[],5,"['hdsmith4', 'amir.ostadi2007', 'kgolk2', None, 'nickflowers7896']",30,"['achasna2', 'hdsmith4', 'deepthisuresh8', 'slzrcrt2', 'fmohajir086', 'mlee141', 'klimas2', 'kgolk2', 'figura2', 'amstilger', 'danielleb', 'nickflowers7896', 'gnadt2', 'alexchasnain', 'jw18', 'loughln2', 'thuynh31', 'godtag97', 'megaridis.melina', None, 'tyyang2', 'imfeign1997', 'savard2', 'scorchnoxap', 'archaicevil', 'mmmarko2', 'amir.ostadi2007', 'msjoy3', 'kcmalinis', 'merhode2']"
31,53,25,75,1,['sukanyajadhav1997'],23,"['sohammhas', 'pnrasika', 'sanjit', 'rohit.elawadekar333', 'tejeshwarvaidya', 'bendalneha', 'siddhant8291', 'tanmaykkudalkar', 'vanaja2812', 'kajaldevake30', 'thosarebhavesh', 'shubhambhosale', 'sanket.r.makwana', 'saayuj.s', 'aloksardesai97', 'kiranpanchal', 'pandeymikhil', 'rugvedikesare427', 'alpha_32123', 'snehald827', 'arpitakudesia3011', 'komalbangar54', 'arpitgodbole7']",74,"['nikhilchaudhari5516', 'kunalk4796', 'shindedeepak129', 'prithvianvekar21', 'rajat.p', 'evanjalinbenita', 'shubham.yelange', 'austin.dsouza1997', 'aadi', 'mayuridesai', 'smahamulkar1013', 'selimajack26', 'akau100', 'shreyasmoolya', 'rohitnair77880', 'shah.ns', 'vixsnair', 'aditya27', 'shreyahonagekar04', 'shaibilsabu', 'jugal.vaja', 'shivam.rs', 'chavankeasmita29', 'sakshi.bhosle', 'paras.mehta', 'jayesh.kakkad8770', 'saurabh.palde', 'sushobh', 'zeevd19', 'rohansaldanha6370', 'sachin.sc', 'davidrisaac', 'arthaya.koyande28', 'shubhamnagpure745', 'vatsal23', 'sujittupe3490', 'swapnalimakdey25', 'orencollaco97', 'shrutik1997.mallick', 'dhwani.vichhi', 'anujchhabra25', 'yasir.mulla47', 'jay.km', 'waynemdsouza', 'shraddha0306', 'ghevadeyogesh', 'adityadesu1', 'harish.c', None, 's.suvarna', 'ninad.mulay', 'pranitkumbhar19', 'adityadh943', 'parin.ss', 'sebin.bc', 'abhay.nadkarni', 'spawar.ap', 'sakshi.trivedi', 'naiksandesh1998', 'priyu0964', 'patilprasad0123', '15anuchaudhari', 'vidhi.satra', 'dishasaraiya', 'aur_mnzs', 'saurabhgawade.777.4.sg', 'shail.maroo', 'maneshweta23', 'jeniferishwarya', 'd.haria', 'umeshlohote', 'wanichinmay577', 'jagnoor.p', 'omkar.karande']",98,"['nikhilchaudhari5516', 'shindedeepak129', 'rajat.p', 'sohammhas', 'smahamulkar1013', 'selimajack26', 'akau100', 'pnrasika', 'rohit.elawadekar333', 'tejeshwarvaidya', 'rohitnair77880', 'shah.ns', 'siddhant8291', 'aditya27', 'tanmaykkudalkar', 'shreyahonagekar04', 'jugal.vaja', 'shivam.rs', 'chavankeasmita29', 'sakshi.bhosle', 'paras.mehta', 'saurabh.palde', 'sushobh', 'zeevd19', 'sachin.sc', 'arthaya.koyande28', 'vatsal23', 'sujittupe3490', 'orencollaco97', 'shrutik1997.mallick', 'dhwani.vichhi', 'anujchhabra25', 'sanket.r.makwana', 'saayuj.s', 'waynemdsouza', 'pandeymikhil', 'shraddha0306', 's.suvarna', 'pranitkumbhar19', 'rugvedikesare427', 'sebin.bc', 'alpha_32123', 'spawar.ap', 'snehald827', 'naiksandesh1998', 'priyu0964', 'arpitakudesia3011', 'patilprasad0123', '15anuchaudhari', 'sukanyajadhav1997', 'vidhi.satra', 'komalbangar54', 'maneshweta23', 'jeniferishwarya', 'd.haria', 'umeshlohote', 'arpitgodbole7', 'jagnoor.p', 'kunalk4796', 'prithvianvekar21', 'evanjalinbenita', 'shubham.yelange', 'austin.dsouza1997', 'aadi', 'mayuridesai', 'shreyasmoolya', 'sanjit', 'bendalneha', 'vixsnair', 'shaibilsabu', 'vanaja2812', 'jayesh.kakkad8770', 'kajaldevake30', 'rohansaldanha6370', 'davidrisaac', 'thosarebhavesh', 'shubhamnagpure745', 'shubhambhosale', 'swapnalimakdey25', 'aloksardesai97', 'yasir.mulla47', 'jay.km', 'kiranpanchal', 'ghevadeyogesh', 'adityadesu1', 'harish.c', None, 'ninad.mulay', 'adityadh943', 'parin.ss', 'abhay.nadkarni', 'sakshi.trivedi', 'dishasaraiya', 'aur_mnzs', 'saurabhgawade.777.4.sg', 'shail.maroo', 'wanichinmay577', 'omkar.karande']"
31,47,25,53,18,"['siddhant8291', 'rugvedikesare427', 'tanmaykkudalkar', 'alpha_32123', 'sanket.r.makwana', 'snehald827', 'kiranpanchal', 'arpitakudesia3011', 'sohammhas', 'vanaja2812', 'sukanyajadhav1997', 'komalbangar54', 'pnrasika', 'pandeymikhil', 'arpitgodbole7', 'rohit.elawadekar333', 'tejeshwarvaidya', 'shubhambhosale']",6,"['bendalneha', 'saayuj.s', 'aloksardesai97', 'kajaldevake30', 'thosarebhavesh', 'sanjit']",35,"['sonalikharade5', 'prathameshpatle13', 'pratikkul26', 'shwetatambe12', 'shubhamchury1', 'prasadbodekar1996', 'sameersanjaysalveashalata', 'sarvesh.mohite97', 'prashantmanjre9', 'hsnnalwala7', 'suffiyanshaikh92', 'shahraj165', 'rishimud', 'sunilkavatkar', 'h10waghela', 'nichiteprh1995', 'rushikeshrane27', 'prasadmasurkar97', 'susmeetsukte', 'gabru1803', 'kaushiksawant93', 'nehakhushi1418', 'preeti.kharas', 'neil.dani9', 'shelarpranali1309', 'risha15', 'prathamesh.shivmare1', 'aditi.ramadwar', 'prajaktathorat24', 'ankitagamare2218', 'prashant20297', None, 'akshayjambhale07', 'divyassonawane', 'pawarrajshree12']",59,"['prathameshpatle13', 'shwetatambe12', 'sohammhas', 'sarvesh.mohite97', 'prashantmanjre9', 'pnrasika', 'hsnnalwala7', 'rohit.elawadekar333', 'tejeshwarvaidya', 'suffiyanshaikh92', 'siddhant8291', 'tanmaykkudalkar', 'rishimud', 'prasadmasurkar97', 'preeti.kharas', 'sanket.r.makwana', 'saayuj.s', 'shelarpranali1309', 'risha15', 'pandeymikhil', 'prajaktathorat24', 'ankitagamare2218', 'rugvedikesare427', 'alpha_32123', 'snehald827', 'arpitakudesia3011', 'sukanyajadhav1997', 'komalbangar54', 'divyassonawane', 'arpitgodbole7', 'pawarrajshree12', 'sonalikharade5', 'pratikkul26', 'shubhamchury1', 'prasadbodekar1996', 'sameersanjaysalveashalata', 'sanjit', 'bendalneha', 'shahraj165', 'vanaja2812', 'kajaldevake30', 'sunilkavatkar', 'h10waghela', 'nichiteprh1995', 'thosarebhavesh', 'rushikeshrane27', 'susmeetsukte', 'shubhambhosale', 'gabru1803', 'kaushiksawant93', 'nehakhushi1418', 'neil.dani9', 'aloksardesai97', 'prathamesh.shivmare1', 'kiranpanchal', 'aditi.ramadwar', 'prashant20297', None, 'akshayjambhale07']"
31,264,25,52,19,"['sohammhas', 'sanjit', 'rohit.elawadekar333', 'tejeshwarvaidya', 'bendalneha', 'tanmaykkudalkar', 'vanaja2812', 'kajaldevake30', 'thosarebhavesh', 'shubhambhosale', 'aloksardesai97', 'kiranpanchal', 'pandeymikhil', 'rugvedikesare427', 'alpha_32123', 'snehald827', 'sukanyajadhav1997', 'komalbangar54', 'arpitgodbole7']",5,"['siddhant8291', 'sanket.r.makwana', 'arpitakudesia3011', 'saayuj.s', 'pnrasika']",33,"['sonalikharade5', 'chinmay_kudtarkar', 'pratikkul26', 'ashu0497', 'sarvesh.mohite97', 'dushy98', 'pavanborde910', 'hsnnalwala7', 'suffiyanshaikh92', 'nikneswankar16', 'sahilsankhe2023', 'as691177', 'sunilkavatkar', 'rushikeshrane27', 'durgeshthorat4', 'pranjalijadhav0911', 'kavi1388', 'amey123', 'akibmujawar13', 'neil.dani9', 'preeti.kharas', 'saurabh.bahad13', 'prathamesh.shivmare1', 'ashwinkadam1996', 'prajaktathorat24', 'anujmdeorukhkar', 'prashant20297', 'akankshagunjal99722', 'zainabshah181997', 'ankitagamare2218', 'mayurmore', None, 'manedeven09']",57,"['chinmay_kudtarkar', 'ashu0497', 'sohammhas', 'sarvesh.mohite97', 'dushy98', 'pnrasika', 'hsnnalwala7', 'rohit.elawadekar333', 'tejeshwarvaidya', 'suffiyanshaikh92', 'siddhant8291', 'tanmaykkudalkar', 'nikneswankar16', 'sahilsankhe2023', 'as691177', 'durgeshthorat4', 'kavi1388', 'pranjalijadhav0911', 'amey123', 'preeti.kharas', 'sanket.r.makwana', 'saurabh.bahad13', 'saayuj.s', 'ashwinkadam1996', 'pandeymikhil', 'prajaktathorat24', 'akankshagunjal99722', 'ankitagamare2218', 'rugvedikesare427', 'alpha_32123', 'snehald827', 'arpitakudesia3011', 'sukanyajadhav1997', 'komalbangar54', 'arpitgodbole7', 'sonalikharade5', 'pratikkul26', 'pavanborde910', 'sanjit', 'bendalneha', 'vanaja2812', 'kajaldevake30', 'sunilkavatkar', 'thosarebhavesh', 'rushikeshrane27', 'shubhambhosale', 'akibmujawar13', 'neil.dani9', 'aloksardesai97', 'prathamesh.shivmare1', 'kiranpanchal', 'zainabshah181997', 'anujmdeorukhkar', 'prashant20297', None, 'mayurmore', 'manedeven09']"
31,46,25,34,5,"['siddhant8291', 'snehald827', 'arpitakudesia3011', 'saayuj.s', 'pnrasika']",19,"['sohammhas', 'sanjit', 'rohit.elawadekar333', 'tejeshwarvaidya', 'bendalneha', 'tanmaykkudalkar', 'vanaja2812', 'kajaldevake30', 'thosarebhavesh', 'shubhambhosale', 'sanket.r.makwana', 'aloksardesai97', 'kiranpanchal', 'pandeymikhil', 'rugvedikesare427', 'alpha_32123', 'sukanyajadhav1997', 'komalbangar54', 'arpitgodbole7']",29,"['soureen.g', 'gaurav.dangat', 'akshatask', 'yash.mhatre', 'raj.velani', 'pratham123', 'smita.n', 'niraj.parte', 'jagruti.patil', 'hrishikesh12', 'jayesh.a', 'nikitamittal97', 'vatsal23', 'sonali.gavkar', 'preeti.kharas', 'neil.dani9', 'shelarpranali1309', 'pjkarmokar', 'pawan.mojar', 'rajas.b', 'anjana.bhave', 'mayur.gosavi', None, 'akansha_sampat', 'tapan.garge', 'kharatomkar24', 'vaishnavi.soni', 'mayuri.sapkal', 'priyanka.rp']",53,"['soureen.g', 'gaurav.dangat', 'akshatask', 'sohammhas', 'yash.mhatre', 'pnrasika', 'sanjit', 'rohit.elawadekar333', 'tejeshwarvaidya', 'raj.velani', 'bendalneha', 'siddhant8291', 'pratham123', 'tanmaykkudalkar', 'smita.n', 'niraj.parte', 'jagruti.patil', 'vanaja2812', 'hrishikesh12', 'kajaldevake30', 'jayesh.a', 'thosarebhavesh', 'nikitamittal97', 'vatsal23', 'shubhambhosale', 'sonali.gavkar', 'preeti.kharas', 'neil.dani9', 'sanket.r.makwana', 'saayuj.s', 'aloksardesai97', 'shelarpranali1309', 'pjkarmokar', 'pawan.mojar', 'rajas.b', 'anjana.bhave', 'kiranpanchal', 'pandeymikhil', 'mayur.gosavi', None, 'akansha_sampat', 'rugvedikesare427', 'alpha_32123', 'tapan.garge', 'kharatomkar24', 'snehald827', 'arpitakudesia3011', 'sukanyajadhav1997', 'komalbangar54', 'vaishnavi.soni', 'mayuri.sapkal', 'priyanka.rp', 'arpitgodbole7']"
31,55,25,15,1,['vanaja2812'],23,"['sohammhas', 'pnrasika', 'sanjit', 'rohit.elawadekar333', 'tejeshwarvaidya', 'bendalneha', 'siddhant8291', 'tanmaykkudalkar', 'kajaldevake30', 'thosarebhavesh', 'shubhambhosale', 'sanket.r.makwana', 'saayuj.s', 'aloksardesai97', 'kiranpanchal', 'pandeymikhil', 'rugvedikesare427', 'alpha_32123', 'snehald827', 'arpitakudesia3011', 'sukanyajadhav1997', 'komalbangar54', 'arpitgodbole7']",14,"['arshan.ansari002', 'sonalkadam10', 'abhishektoraskar412', 'atithipawar', 'sagar.pawar35418', 'runakshi97', 'aishwaryahiwale97', 'tejalborhade', 'bshelke77', 'rsbangar1998', 'mohini.bhangale5', None, 'vedantpalshetkar259', 'sid.soyane1997']",38,"['arshan.ansari002', 'sohammhas', 'aishwaryahiwale97', 'tejalborhade', 'pnrasika', 'sanjit', 'rohit.elawadekar333', 'sid.soyane1997', 'tejeshwarvaidya', 'bendalneha', 'siddhant8291', 'tanmaykkudalkar', 'atithipawar', 'vanaja2812', 'kajaldevake30', 'bshelke77', 'thosarebhavesh', 'shubhambhosale', 'vedantpalshetkar259', 'abhishektoraskar412', 'sanket.r.makwana', 'saayuj.s', 'aloksardesai97', 'runakshi97', 'kiranpanchal', 'pandeymikhil', 'rsbangar1998', None, 'rugvedikesare427', 'sonalkadam10', 'alpha_32123', 'snehald827', 'arpitakudesia3011', 'sagar.pawar35418', 'sukanyajadhav1997', 'komalbangar54', 'arpitgodbole7', 'mohini.bhangale5']"
31,44,25,7,6,"['bendalneha', 'aloksardesai97', 'vanaja2812', 'kajaldevake30', 'thosarebhavesh', 'sanjit']",18,"['siddhant8291', 'rugvedikesare427', 'tanmaykkudalkar', 'alpha_32123', 'sanket.r.makwana', 'snehald827', 'kiranpanchal', 'saayuj.s', 'arpitakudesia3011', 'sohammhas', 'sukanyajadhav1997', 'komalbangar54', 'pnrasika', 'pandeymikhil', 'arpitgodbole7', 'rohit.elawadekar333', 'tejeshwarvaidya', 'shubhambhosale']",1,[None],25,"['sanket.r.makwana', 'saayuj.s', 'aloksardesai97', 'sohammhas', 'pnrasika', 'kiranpanchal', 'sanjit', 'rohit.elawadekar333', 'pandeymikhil', 'tejeshwarvaidya', None, 'bendalneha', 'siddhant8291', 'rugvedikesare427', 'tanmaykkudalkar', 'alpha_32123', 'snehald827', 'arpitakudesia3011', 'vanaja2812', 'sukanyajadhav1997', 'kajaldevake30', 'komalbangar54', 'thosarebhavesh', 'arpitgodbole7', 'shubhambhosale']"
32,210,25,71,24,"['vijen.g', 'akash.mehta', 'viral.mamaniya', 'nishad.joshi', 'saumya.kamde', 'ankita.thikekar09', 'hitendra.k', 'parth.nj', 'sanjana.dhulla', 'parthkataria999', 'navneet.d', 'pratyaksh.i', 'jinali.d', 'j.kariya', 's.ambardekar', 'srinidhi.g', 'jainam.bj', 'chirayu.m', 'arya.ambardekar', 'd.kotecha', 'urva.d', 'karan.chhadawa', 'vignesh.j', 'taral.mehta']",0,[],47,"['dhaval.vs', 'het.manek', 'harshada.benke', 's.balsaraf73', 'rajat.p', 'gaurav24', 'mansi.gori', 'gayatri.gandhi', 'kunj.haria', 's.vohra', 'inderjitsingh', 'mayuresh.auti', 'siddhesh0607', 'raghunath.gangi', 'meetparadia', 'yjb', 'doobvoob', 'jitun', 'chauhanajay4u', 'arati.mule2900', 'sachin.sc', 'fatima.h', 'dvb', 'nishit.pabari', 'ankita.nd', 'nayan_nanohub', 'nitin.lalwani', 'soham.sk', 'adithya.n', 'anuj.cm', 'nainil.m', 'yash.shah9', 'shubhada.shetti', None, 'shraddha.jj', 'harshal.bhole', 'yash.gulve', 'vikram.sagar', 'dishasaraiya', 'vidhi.satra', 'shah.jm', 'acadithya.m', 'ssoneria7', 'anilguruprasad', 'bhumika.kava', 'omkar.karande', 'mehanshi.p']",71,"['vijen.g', 'dhaval.vs', 's.balsaraf73', 'rajat.p', 'gaurav24', 'kunj.haria', 'ankita.thikekar09', 'siddhesh0607', 'yjb', 'sanjana.dhulla', 'parthkataria999', 'chauhanajay4u', 'sachin.sc', 'dvb', 'nishit.pabari', 'navneet.d', 'ankita.nd', 'pratyaksh.i', 'jinali.d', 'nitin.lalwani', 'soham.sk', 'anuj.cm', 'yash.shah9', 'chirayu.m', 'arya.ambardekar', 'shraddha.jj', 'd.kotecha', 'harshal.bhole', 'yash.gulve', 'vidhi.satra', 'ssoneria7', 'akash.mehta', 'harshada.benke', 'het.manek', 'viral.mamaniya', 'nishad.joshi', 'mansi.gori', 'gayatri.gandhi', 'saumya.kamde', 's.vohra', 'inderjitsingh', 'mayuresh.auti', 'raghunath.gangi', 'hitendra.k', 'meetparadia', 'doobvoob', 'parth.nj', 'jitun', 'arati.mule2900', 'fatima.h', 'bhumika.kava', 'nayan_nanohub', 'j.kariya', 's.ambardekar', 'srinidhi.g', 'adithya.n', 'jainam.bj', 'nainil.m', 'shubhada.shetti', None, 'urva.d', 'vikram.sagar', 'karan.chhadawa', 'dishasaraiya', 'shah.jm', 'acadithya.m', 'anilguruprasad', 'vignesh.j', 'omkar.karande', 'mehanshi.p', 'taral.mehta']"
32,208,25,55,20,"['vijen.g', 'akash.mehta', 'viral.mamaniya', 'nishad.joshi', 'saumya.kamde', 'hitendra.k', 'parth.nj', 'sanjana.dhulla', 'parthkataria999', 'navneet.d', 'pratyaksh.i', 'jinali.d', 'j.kariya', 's.ambardekar', 'srinidhi.g', 'arya.ambardekar', 'd.kotecha', 'urva.d', 'karan.chhadawa', 'vignesh.j']",4,"['ankita.thikekar09', 'chirayu.m', 'taral.mehta', 'jainam.bj']",35,"['dhaval.vs', 'het.manek', 'harshada.benke', 's.balsaraf73', 'gayatri.gandhi', 'kunj.haria', 's.vohra', 'siddhesh0607', 'meetparadia', 'yjb', 'doobvoob', 'jitun', 'chauhanajay4u', 'arati.mule2900', 'sachin.sc', 'fatima.h', 'dvb', 'ankita.nd', 'nayan_nanohub', 'soham.sk', 'adithya.n', 'anuj.cm', 'nainil.m', 'shubhada.shetti', None, 'shraddha.jj', 'harshal.bhole', 'yash.gulve', 'shah.jm', 'acadithya.m', 'anilguruprasad', 'bhumika.kava', 'omkar.karande', 'mehanshi.p', 'anilthosar']",59,"['vijen.g', 'dhaval.vs', 's.balsaraf73', 'kunj.haria', 'ankita.thikekar09', 'siddhesh0607', 'yjb', 'sanjana.dhulla', 'parthkataria999', 'chauhanajay4u', 'sachin.sc', 'dvb', 'navneet.d', 'ankita.nd', 'pratyaksh.i', 'jinali.d', 'soham.sk', 'anuj.cm', 'chirayu.m', 'arya.ambardekar', 'shraddha.jj', 'd.kotecha', 'harshal.bhole', 'yash.gulve', 'akash.mehta', 'harshada.benke', 'het.manek', 'viral.mamaniya', 'nishad.joshi', 'gayatri.gandhi', 'saumya.kamde', 's.vohra', 'hitendra.k', 'meetparadia', 'doobvoob', 'parth.nj', 'jitun', 'arati.mule2900', 'fatima.h', 'bhumika.kava', 'nayan_nanohub', 'j.kariya', 's.ambardekar', 'srinidhi.g', 'adithya.n', 'anilthosar', 'jainam.bj', 'nainil.m', 'shubhada.shetti', None, 'urva.d', 'karan.chhadawa', 'shah.jm', 'acadithya.m', 'anilguruprasad', 'vignesh.j', 'omkar.karande', 'mehanshi.p', 'taral.mehta']"
32,364,25,46,11,"['akash.mehta', 'pratyaksh.i', 'd.kotecha', 'karan.chhadawa', 'viral.mamaniya', 'parth.nj', 's.ambardekar', 'srinidhi.g', 'vignesh.j', 'hitendra.k', 'navneet.d']",13,"['arya.ambardekar', 'vijen.g', 'urva.d', 'jinali.d', 'nishad.joshi', 'j.kariya', 'sanjana.dhulla', 'jainam.bj', 'saumya.kamde', 'parthkataria999', 'ankita.thikekar09', 'chirayu.m', 'taral.mehta']",35,"['h.vyas', 'dhaval.vs', 'het.manek', 'gayatri.gandhi', 'adwait', 'rushabhoswal1997', 'anuradhaverma', 'sunitha.r', 'meetparadia', 'parva.shah', 'doobvoob', 'maitrishah', 'jitun', 'shreela.nair14', 'leena.kesarkar', 'anshul.mehta', 'patel.ss', 'manan.raval', 'khanjankundalia', 'nayan_nanohub', 'devashish123', 'rachanad', 'smit08', 'adithya.n', 'nainil.m', None, 'sagarika.b', 'shraddha.jj', 'karan.harjai', 'ayesha.sayyad', 'acadithya.m', 'nikhita.r', 'ojas.pethe', 'pritesh.surana', 'bhumika.kava']",59,"['h.vyas', 'vijen.g', 'dhaval.vs', 'adwait', 'ankita.thikekar09', 'rushabhoswal1997', 'anuradhaverma', 'maitrishah', 'sanjana.dhulla', 'parthkataria999', 'shreela.nair14', 'leena.kesarkar', 'anshul.mehta', 'navneet.d', 'patel.ss', 'khanjankundalia', 'pratyaksh.i', 'jinali.d', 'rachanad', 'smit08', 'chirayu.m', 'arya.ambardekar', 'shraddha.jj', 'd.kotecha', 'karan.harjai', 'ayesha.sayyad', 'nikhita.r', 'pritesh.surana', 'akash.mehta', 'het.manek', 'viral.mamaniya', 'nishad.joshi', 'gayatri.gandhi', 'saumya.kamde', 'sunitha.r', 'hitendra.k', 'meetparadia', 'parva.shah', 'doobvoob', 'parth.nj', 'jitun', 'manan.raval', 'bhumika.kava', 'nayan_nanohub', 'j.kariya', 'devashish123', 's.ambardekar', 'srinidhi.g', 'adithya.n', 'jainam.bj', 'nainil.m', None, 'sagarika.b', 'urva.d', 'karan.chhadawa', 'acadithya.m', 'ojas.pethe', 'vignesh.j', 'taral.mehta']"
32,365,25,22,12,"['pratyaksh.i', 'akash.mehta', 'd.kotecha', 'taral.mehta', 'karan.chhadawa', 'viral.mamaniya', 'jainam.bj', 'srinidhi.g', 'ankita.thikekar09', 'vignesh.j', 'chirayu.m', 'hitendra.k']",12,"['arya.ambardekar', 'vijen.g', 'urva.d', 'jinali.d', 'parth.nj', 'nishad.joshi', 'j.kariya', 'sanjana.dhulla', 's.ambardekar', 'saumya.kamde', 'parthkataria999', 'navneet.d']",10,"['vikram.sagar', 'rhea.gupta', 'harsh.patel3', 'jeet.khunt', 'mansi.gori', 'nikita.virkud', 'gayatri.gandhi', 'nishit.pabari', None, 'sunitha.r']",34,"['vijen.g', 'akash.mehta', 'viral.mamaniya', 'nishad.joshi', 'mansi.gori', 'gayatri.gandhi', 'saumya.kamde', 'ankita.thikekar09', 'jeet.khunt', 'hitendra.k', 'sunitha.r', 'harsh.patel3', 'parth.nj', 'sanjana.dhulla', 'nikita.virkud', 'parthkataria999', 'nishit.pabari', 'navneet.d', 'pratyaksh.i', 'jinali.d', 'rhea.gupta', 'j.kariya', 's.ambardekar', 'srinidhi.g', 'jainam.bj', None, 'chirayu.m', 'arya.ambardekar', 'd.kotecha', 'urva.d', 'vikram.sagar', 'karan.chhadawa', 'vignesh.j', 'taral.mehta']"
32,353,25,14,8,"['akash.mehta', 'd.kotecha', 'viral.mamaniya', 'ankita.thikekar09', 'vignesh.j', 'chirayu.m', 'hitendra.k', 'navneet.d']",16,"['arya.ambardekar', 'vijen.g', 'pratyaksh.i', 'jinali.d', 'urva.d', 'karan.chhadawa', 'parth.nj', 'nishad.joshi', 'j.kariya', 'sanjana.dhulla', 's.ambardekar', 'srinidhi.g', 'saumya.kamde', 'parthkataria999', 'jainam.bj', 'taral.mehta']",6,"['rhea.gupta', 'harsh.patel3', 'nikita.virkud', 'raghunath.gangi', None, 'jeet.khunt']",30,"['vijen.g', 'akash.mehta', 'viral.mamaniya', 'nishad.joshi', 'saumya.kamde', 'ankita.thikekar09', 'raghunath.gangi', 'jeet.khunt', 'hitendra.k', 'harsh.patel3', 'parth.nj', 'sanjana.dhulla', 'nikita.virkud', 'parthkataria999', 'navneet.d', 'pratyaksh.i', 'jinali.d', 'rhea.gupta', 'j.kariya', 's.ambardekar', 'srinidhi.g', 'jainam.bj', None, 'chirayu.m', 'arya.ambardekar', 'd.kotecha', 'urva.d', 'karan.chhadawa', 'vignesh.j', 'taral.mehta']"
32,362,25,14,8,"['akash.mehta', 'd.kotecha', 'viral.mamaniya', 'ankita.thikekar09', 'vignesh.j', 'chirayu.m', 'hitendra.k', 'navneet.d']",16,"['arya.ambardekar', 'vijen.g', 'pratyaksh.i', 'jinali.d', 'urva.d', 'karan.chhadawa', 'parth.nj', 'nishad.joshi', 'j.kariya', 'sanjana.dhulla', 's.ambardekar', 'srinidhi.g', 'saumya.kamde', 'parthkataria999', 'jainam.bj', 'taral.mehta']",6,"['rhea.gupta', 'harsh.patel3', 'nikita.virkud', 'raghunath.gangi', None, 'jeet.khunt']",30,"['vijen.g', 'akash.mehta', 'viral.mamaniya', 'nishad.joshi', 'saumya.kamde', 'ankita.thikekar09', 'raghunath.gangi', 'jeet.khunt', 'hitendra.k', 'harsh.patel3', 'parth.nj', 'sanjana.dhulla', 'nikita.virkud', 'parthkataria999', 'navneet.d', 'pratyaksh.i', 'jinali.d', 'rhea.gupta', 'j.kariya', 's.ambardekar', 'srinidhi.g', 'jainam.bj', None, 'chirayu.m', 'arya.ambardekar', 'd.kotecha', 'urva.d', 'karan.chhadawa', 'vignesh.j', 'taral.mehta']"
32,355,25,12,9,"['arya.ambardekar', 'vijen.g', 'urva.d', 'jinali.d', 'nishad.joshi', 'j.kariya', 'sanjana.dhulla', 'saumya.kamde', 'parthkataria999']",15,"['akash.mehta', 'pratyaksh.i', 'd.kotecha', 'taral.mehta', 'karan.chhadawa', 'viral.mamaniya', 'parth.nj', 's.ambardekar', 'jainam.bj', 'srinidhi.g', 'ankita.thikekar09', 'vignesh.j', 'chirayu.m', 'hitendra.k', 'navneet.d']",3,"[None, 'yashbhanushali006', 'asdfghjkl1234']",27,"['vijen.g', 'akash.mehta', 'pratyaksh.i', 'jinali.d', 'viral.mamaniya', 'nishad.joshi', 'j.kariya', 's.ambardekar', 'srinidhi.g', 'saumya.kamde', 'yashbhanushali006', 'ankita.thikekar09', 'jainam.bj', None, 'chirayu.m', 'hitendra.k', 'arya.ambardekar', 'd.kotecha', 'urva.d', 'asdfghjkl1234', 'karan.chhadawa', 'parth.nj', 'sanjana.dhulla', 'parthkataria999', 'vignesh.j', 'taral.mehta', 'navneet.d']"
32,367,25,12,9,"['arya.ambardekar', 'vijen.g', 'urva.d', 'jinali.d', 'nishad.joshi', 'j.kariya', 'sanjana.dhulla', 'saumya.kamde', 'parthkataria999']",15,"['akash.mehta', 'pratyaksh.i', 'd.kotecha', 'taral.mehta', 'karan.chhadawa', 'viral.mamaniya', 'parth.nj', 's.ambardekar', 'jainam.bj', 'srinidhi.g', 'ankita.thikekar09', 'vignesh.j', 'chirayu.m', 'hitendra.k', 'navneet.d']",3,"[None, 'yashbhanushali006', 'asdfghjkl1234']",27,"['vijen.g', 'akash.mehta', 'pratyaksh.i', 'jinali.d', 'viral.mamaniya', 'nishad.joshi', 'j.kariya', 's.ambardekar', 'srinidhi.g', 'saumya.kamde', 'yashbhanushali006', 'ankita.thikekar09', 'jainam.bj', None, 'chirayu.m', 'hitendra.k', 'arya.ambardekar', 'd.kotecha', 'urva.d', 'asdfghjkl1234', 'karan.chhadawa', 'parth.nj', 'sanjana.dhulla', 'parthkataria999', 'vignesh.j', 'taral.mehta', 'navneet.d']"
32,354,25,10,7,"['pratyaksh.i', 'karan.chhadawa', 'parth.nj', 's.ambardekar', 'srinidhi.g', 'jainam.bj', 'taral.mehta']",17,"['arya.ambardekar', 'vijen.g', 'akash.mehta', 'jinali.d', 'd.kotecha', 'urva.d', 'viral.mamaniya', 'nishad.joshi', 'j.kariya', 'sanjana.dhulla', 'saumya.kamde', 'parthkataria999', 'ankita.thikekar09', 'vignesh.j', 'chirayu.m', 'hitendra.k', 'navneet.d']",3,"['karan.harjai', None, 'pritesh.surana']",27,"['vijen.g', 'akash.mehta', 'pratyaksh.i', 'jinali.d', 'viral.mamaniya', 'nishad.joshi', 'j.kariya', 's.ambardekar', 'srinidhi.g', 'saumya.kamde', 'ankita.thikekar09', 'jainam.bj', None, 'chirayu.m', 'hitendra.k', 'arya.ambardekar', 'd.kotecha', 'urva.d', 'karan.chhadawa', 'karan.harjai', 'parth.nj', 'sanjana.dhulla', 'parthkataria999', 'pritesh.surana', 'vignesh.j', 'taral.mehta', 'navneet.d']"
33,134,23,22,21,"['edchoi0513', 'teddkim', 'lpanozz2', 'hiraald2', 'mkraman2', 'mailteahwa', 'mgarc67', 'pz3', 'nlbenso2', 'sanat.pandey', 'amartnz7', 'ryancube15', 'nth2', 'vanjari2', 'bcchen3', 'rishabh3', 'wkim53', 'abhishek.nemkumar', 'cbott2', 'mnwilso2', 'ktomli2']",1,['vvgopal2'],1,[None],23,"['edchoi0513', 'teddkim', 'lpanozz2', 'hiraald2', 'mkraman2', 'mailteahwa', 'mgarc67', 'pz3', 'vvgopal2', 'nlbenso2', 'sanat.pandey', 'amartnz7', 'ryancube15', 'nth2', 'vanjari2', 'bcchen3', None, 'rishabh3', 'wkim53', 'abhishek.nemkumar', 'cbott2', 'mnwilso2', 'ktomli2']"
33,160,23,20,18,"['edchoi0513', 'nlbenso2', 'rishabh3', 'wkim53', 'lpanozz2', 'hiraald2', 'abhishek.nemkumar', 'sanat.pandey', 'mailteahwa', 'cbott2', 'mkraman2', 'mnwilso2', 'ryancube15', 'nth2', 'bcchen3', 'mgarc67', 'pz3', 'ktomli2']",4,"['teddkim', 'vvgopal2', 'vanjari2', 'amartnz7']",2,"['anb412', None]",24,"['edchoi0513', 'teddkim', 'lpanozz2', 'hiraald2', 'mkraman2', 'mailteahwa', 'anb412', 'mgarc67', 'pz3', 'vvgopal2', 'nlbenso2', 'sanat.pandey', 'amartnz7', 'ryancube15', 'nth2', 'vanjari2', 'bcchen3', None, 'rishabh3', 'wkim53', 'abhishek.nemkumar', 'cbott2', 'mnwilso2', 'ktomli2']"
33,159,23,19,17,"['edchoi0513', 'teddkim', 'vvgopal2', 'nlbenso2', 'rishabh3', 'wkim53', 'lpanozz2', 'hiraald2', 'sanat.pandey', 'cbott2', 'mnwilso2', 'ryancube15', 'vanjari2', 'bcchen3', 'mgarc67', 'pz3', 'ktomli2']",5,"['abhishek.nemkumar', 'mailteahwa', 'amartnz7', 'mkraman2', 'nth2']",2,"[None, 'choquette']",24,"['edchoi0513', 'teddkim', 'lpanozz2', 'hiraald2', 'mkraman2', 'mailteahwa', 'choquette', 'mgarc67', 'pz3', 'vvgopal2', 'nlbenso2', 'sanat.pandey', 'amartnz7', 'ryancube15', 'nth2', 'vanjari2', 'bcchen3', None, 'rishabh3', 'wkim53', 'abhishek.nemkumar', 'cbott2', 'mnwilso2', 'ktomli2']"
34,339,23,22,20,"['ananth7121999', 'dheerajracha', 'ep16btech11006', 'djatomic.10', 'raktim', 'vicky2000', 'siddharthmanu500', '124guna', 'karthikp', 'es17btech11026', 'ee17btech11048', 'tippireddi.t1966', 'aayusharora48', '1754ayush', 'lakshitsingla', 'ee17btech11018', 'maaz777', 'yashasa', 'ee17btech11036', 'praharsh_412']",2,"['yarahamza2021997', 'riv']",2,"['taruntejreddych', None]",24,"['ananth7121999', 'dheerajracha', 'ep16btech11006', 'djatomic.10', 'raktim', 'vicky2000', 'siddharthmanu500', '124guna', 'karthikp', 'es17btech11026', 'taruntejreddych', 'ee17btech11048', 'yarahamza2021997', 'tippireddi.t1966', 'aayusharora48', None, '1754ayush', 'riv', 'lakshitsingla', 'ee17btech11018', 'maaz777', 'yashasa', 'ee17btech11036', 'praharsh_412']"
35,318,22,8,6,"['feyer', 'robert.koeberl', 'indium3arsenid', 'sambucus33', 'fl0_pi', 'howland12']",15,"['josejc27', 'fratschko', 'rieflo125', 'chrisi588', 'nikolaus.czepl', 'stef101', 'butej_b', 'vicarius', 'b00050512', 'spital_t', 'pirker_c', 'reinli13', 'dg0530814', 'wbodlo21', 'matthias_w']",2,"[None, 'seebac_m']",23,"['fratschko', 'rieflo125', 'feyer', 'robert.koeberl', 'nikolaus.czepl', 'butej_b', 'b00050512', 'pirker_c', 'reinli13', 'dg0530814', 'seebac_m', 'wbodlo21', 'chrisi588', 'howland12', None, 'matthias_w', 'josejc27', 'stef101', 'indium3arsenid', 'vicarius', 'spital_t', 'sambucus33', 'fl0_pi']"
36,443,22,8,7,"['jeonkeun', 'mark.croxall', 'yukevin3', 'azayadi', 'walla214', 'mattjamestimm', 'alexa.zayadi']",14,"['millerwjw', 'colingrant', 'brow1693', 'mohi_iqbal', 'alok.bharadwaj.94', 'enricrull', 'saeidhomayounslm', 'hushuiqing', 'lionelbureau2', 'nanozool', 'skonala', 'adbl3551', 'ksrikanth.anand22', 'msalerno']",1,[None],22,"['jeonkeun', 'millerwjw', 'colingrant', 'brow1693', 'mohi_iqbal', 'alok.bharadwaj.94', 'lionelbureau2', 'nanozool', 'skonala', 'adbl3551', 'azayadi', 'walla214', 'mattjamestimm', None, 'enricrull', 'mark.croxall', 'yukevin3', 'saeidhomayounslm', 'hushuiqing', 'ksrikanth.anand22', 'msalerno', 'alexa.zayadi']"
37,170,21,19,17,"['qm3ngv', 'yuanzhujunpku', 'jmdepoy', 'hfzgafur', 'soubir96', 'xinwei.liu', 'andyshwu', 'claireganski', 'rse439', 'shmallen36', 'cluth402', 'zhouyuanyuan28', 'mnd1', 'otitoaleke', 'suyogya.karki', 'david.leocadio94', 'rpschalip']",3,"['gurpreetbhikhi1947', 'hodece.bfcet', 'astump.stump']",2,"['zhouyj33', None]",22,"['xinwei.liu', 'hodece.bfcet', 'gurpreetbhikhi1947', 'zhouyj33', 'jmdepoy', 'zhouyuanyuan28', 'mnd1', 'suyogya.karki', 'rpschalip', 'qm3ngv', 'hfzgafur', 'andyshwu', 'soubir96', 'rse439', 'cluth402', 'astump.stump', 'otitoaleke', 'david.leocadio94', None, 'yuanzhujunpku', 'claireganski', 'shmallen36']"
38,412,19,36,15,"['te.vence10', 'lf.correa10', 'carlosan98', 'alejandroariaszuluaga', 'fa.gomez12', 'rcarvajal208', 'alvarocardona', 'danielbaron104', 'ma.sandoval', 'edgarfpena', 'drhurtado', 'julissa.vigoya', 'am.bolivar', 'santiagoalfonso015', 'labfund']",3,"['carlos_gonzaleza', 'carlosaenz2626', 'jgal']",21,"['rc.moreno1084', 'julianberonn', 'holapincheputita', 'nico1029', 'nanoxzapata', 'andydroid07', 'je.diaz', 'juanseb98', 'lauraguerreroa88', 'leonard.ruiz00', 'dianroro97', 'labbasica', 'ayalagamezn', 'nicortescen', 'andresfdt.2k8', 'alexrc9778', 'jairovlacha97', None, 'lauradnc1505', 'eduardmolano', 'jc.sanchez16']",39,"['rc.moreno1084', 'rcarvajal208', 'julianberonn', 'drhurtado', 'julissa.vigoya', 'holapincheputita', 'nico1029', 'am.bolivar', 'nanoxzapata', 'andydroid07', 'je.diaz', 'fa.gomez12', 'danielbaron104', 'juanseb98', 'edgarfpena', 'lauraguerreroa88', 'leonard.ruiz00', 'labfund', 'te.vence10', 'lf.correa10', 'carlosan98', 'jgal', 'dianroro97', 'labbasica', 'alejandroariaszuluaga', 'carlos_gonzaleza', 'alvarocardona', 'ma.sandoval', 'nicortescen', 'ayalagamezn', 'andresfdt.2k8', 'alexrc9778', 'jairovlacha97', None, 'santiagoalfonso015', 'lauradnc1505', 'carlosaenz2626', 'eduardmolano', 'jc.sanchez16']"
38,213,19,25,16,"['te.vence10', 'lf.correa10', 'carlosan98', 'alejandroariaszuluaga', 'labfund', 'rcarvajal208', 'alvarocardona', 'carlosaenz2626', 'danielbaron104', 'ma.sandoval', 'edgarfpena', 'drhurtado', 'julissa.vigoya', 'am.bolivar', 'santiagoalfonso015', 'jgal']",2,"['carlos_gonzaleza', 'fa.gomez12']",9,"['danielpena96', 'medagorodavid', 'juanseb98', 'juanguerron', 'julianberonn', 'lauraguerreroa88', 'andresfdt.2k8', None, 'maria.a.solano.otero']",27,"['rcarvajal208', 'julianberonn', 'drhurtado', 'julissa.vigoya', 'am.bolivar', 'danielpena96', 'fa.gomez12', 'danielbaron104', 'juanseb98', 'edgarfpena', 'lauraguerreroa88', 'labfund', 'te.vence10', 'lf.correa10', 'carlosan98', 'jgal', 'alejandroariaszuluaga', 'carlos_gonzaleza', 'alvarocardona', 'ma.sandoval', 'andresfdt.2k8', None, 'maria.a.solano.otero', 'santiagoalfonso015', 'medagorodavid', 'carlosaenz2626', 'juanguerron']"
38,411,19,18,5,"['te.vence10', 'alejandroariaszuluaga', 'carlosaenz2626', 'ma.sandoval', 'am.bolivar']",13,"['carlosan98', 'lf.correa10', 'carlos_gonzaleza', 'fa.gomez12', 'labfund', 'rcarvajal208', 'alvarocardona', 'danielbaron104', 'edgarfpena', 'drhurtado', 'julissa.vigoya', 'santiagoalfonso015', 'jgal']",13,"['polania.andres.a', 'andydroid07', 'julianberonn', 'ayalagamezn', 'vb.herrera', 'miguelangie', 'eduardmolano', 'andresfdt.2k8', 'nico1029', 'gaboandrez99', 'jeisontimana', None, 'daljim76']",31,"['te.vence10', 'lf.correa10', 'carlosan98', 'alejandroariaszuluaga', 'carlos_gonzaleza', 'rcarvajal208', 'alvarocardona', 'julianberonn', 'ma.sandoval', 'ayalagamezn', 'miguelangie', 'drhurtado', 'julissa.vigoya', 'vb.herrera', 'andresfdt.2k8', 'nico1029', 'am.bolivar', None, 'santiagoalfonso015', 'polania.andres.a', 'andydroid07', 'fa.gomez12', 'labfund', 'carlosaenz2626', 'danielbaron104', 'edgarfpena', 'eduardmolano', 'gaboandrez99', 'jeisontimana', 'daljim76', 'jgal']"
38,212,19,7,4,"['fa.gomez12', 'carlosaenz2626', 'jgal', 'alejandroariaszuluaga']",14,"['te.vence10', 'lf.correa10', 'carlosan98', 'carlos_gonzaleza', 'rcarvajal208', 'alvarocardona', 'danielbaron104', 'ma.sandoval', 'edgarfpena', 'drhurtado', 'julissa.vigoya', 'am.bolivar', 'santiagoalfonso015', 'labfund']",3,"[None, 'cdaniel089', 'julianberonn']",21,"['te.vence10', 'lf.correa10', 'carlosan98', 'alejandroariaszuluaga', 'carlos_gonzaleza', 'rcarvajal208', 'alvarocardona', 'julianberonn', 'ma.sandoval', 'drhurtado', 'julissa.vigoya', 'cdaniel089', 'am.bolivar', None, 'santiagoalfonso015', 'fa.gomez12', 'labfund', 'carlosaenz2626', 'danielbaron104', 'edgarfpena', 'jgal']"
39,216,19,57,1,['ben_jackson341'],17,"['williamzhang0821', 'klhorvath25', 'zhaolin.guo', 'elin6243', 'ccannell', 'abigail.mrvos', 'nathuffman97', 'blc29', 'fanzhang0815', 'neildhar', 'qxx', 'jayldoherty', 'joeyandrews9211', 'vvvany', 'avah', 'amrvos', 'raulvyas']",56,"['karanv667', 'nnovitsky', 'joanne.zheng', 'marystuartelder', 'ammiexia', 'deniz.simsek', 'siyuan_chen', 'idkwain', 'xiangjin', 'suman.bajgain', 'justinhavas', 'ian_hanus', 'jierong1220', 'yousuf.rehman7', 'allencao', 'srabinowitz', 'joeyliang99', 'zoey1998', 'kerrycastor', 'fooiey', 'jmb186', 'gmak6464', 'lindamanyenga', 'cjingram2020', 'casiomichael', 'matthew.harris.1998', 'aricarri', 'rishdafish97', 'luciamees2016', 'ramilmsh', 'elamorhan', 'jacarde4', 'gkw12345', 'aarondfranklin', 'knice', 'joanna.li', 'jar121', 'bluedevil729', None, 'ltruitt5', 'nev', 'malhotra.divyesha', 'hannahwilen', 'davidmiron80', 'trevor.stevenson', 'alicettdai', 'cooper.lair', 'jswubbenhorst', 'nguyen.andy.le', 'chaofan.tao', 'bgolbin', 'iwillforgetthisname', 'annadiemel', 'anshudwibhashi', 'qinwen.deng168367', 'eceodev']",74,"['joanne.zheng', 'marystuartelder', 'siyuan_chen', 'idkwain', 'xiangjin', 'amrvos', 'ian_hanus', 'kerrycastor', 'fooiey', 'gmak6464', 'lindamanyenga', 'casiomichael', 'matthew.harris.1998', 'rishdafish97', 'luciamees2016', 'ccannell', 'jacarde4', 'gkw12345', 'qxx', 'aarondfranklin', 'vvvany', 'joanna.li', 'jar121', 'ltruitt5', 'nev', 'alicettdai', 'cooper.lair', 'jswubbenhorst', 'bgolbin', 'avah', 'iwillforgetthisname', 'annadiemel', 'qinwen.deng168367', 'raulvyas', 'karanv667', 'nnovitsky', 'ammiexia', 'deniz.simsek', 'jayldoherty', 'suman.bajgain', 'justinhavas', 'jierong1220', 'williamzhang0821', 'yousuf.rehman7', 'allencao', 'srabinowitz', 'nathuffman97', 'joeyliang99', 'zoey1998', 'jmb186', 'joeyandrews9211', 'ben_jackson341', 'cjingram2020', 'aricarri', 'klhorvath25', 'ramilmsh', 'elin6243', 'elamorhan', 'blc29', 'knice', 'bluedevil729', None, 'malhotra.divyesha', 'hannahwilen', 'zhaolin.guo', 'davidmiron80', 'trevor.stevenson', 'abigail.mrvos', 'fanzhang0815', 'neildhar', 'nguyen.andy.le', 'chaofan.tao', 'anshudwibhashi', 'eceodev']"
39,42,19,16,15,"['williamzhang0821', 'zhaolin.guo', 'elin6243', 'ccannell', 'abigail.mrvos', 'nathuffman97', 'fanzhang0815', 'qxx', 'jayldoherty', 'joeyandrews9211', 'vvvany', 'ben_jackson341', 'avah', 'amrvos', 'raulvyas']",3,"['blc29', 'klhorvath25', 'neildhar']",1,[None],19,"['klhorvath25', 'elin6243', 'ccannell', 'blc29', 'qxx', 'jayldoherty', 'vvvany', 'amrvos', None, 'williamzhang0821', 'zhaolin.guo', 'abigail.mrvos', 'nathuffman97', 'fanzhang0815', 'neildhar', 'joeyandrews9211', 'ben_jackson341', 'avah', 'raulvyas']"
39,43,19,13,12,"['williamzhang0821', 'zhaolin.guo', 'elin6243', 'ccannell', 'abigail.mrvos', 'qxx', 'jayldoherty', 'ben_jackson341', 'vvvany', 'avah', 'joeyandrews9211', 'raulvyas']",6,"['klhorvath25', 'nathuffman97', 'blc29', 'fanzhang0815', 'neildhar', 'amrvos']",1,[None],19,"['klhorvath25', 'elin6243', 'ccannell', 'blc29', 'qxx', 'jayldoherty', 'vvvany', 'amrvos', None, 'williamzhang0821', 'zhaolin.guo', 'abigail.mrvos', 'nathuffman97', 'fanzhang0815', 'neildhar', 'joeyandrews9211', 'ben_jackson341', 'avah', 'raulvyas']"
39,75,19,6,3,"['blc29', 'klhorvath25', 'neildhar']",15,"['williamzhang0821', 'zhaolin.guo', 'elin6243', 'ccannell', 'abigail.mrvos', 'nathuffman97', 'fanzhang0815', 'qxx', 'jayldoherty', 'joeyandrews9211', 'vvvany', 'ben_jackson341', 'avah', 'amrvos', 'raulvyas']",3,"['newright8', 'flacowade12', None]",21,"['klhorvath25', 'elin6243', 'ccannell', 'blc29', 'newright8', 'qxx', 'jayldoherty', 'vvvany', 'amrvos', None, 'williamzhang0821', 'zhaolin.guo', 'abigail.mrvos', 'nathuffman97', 'fanzhang0815', 'neildhar', 'joeyandrews9211', 'ben_jackson341', 'avah', 'flacowade12', 'raulvyas']"
39,77,19,6,4,"['blc29', 'klhorvath25', 'neildhar', 'abigail.mrvos']",14,"['williamzhang0821', 'zhaolin.guo', 'elin6243', 'ccannell', 'nathuffman97', 'fanzhang0815', 'qxx', 'jayldoherty', 'joeyandrews9211', 'vvvany', 'ben_jackson341', 'avah', 'amrvos', 'raulvyas']",2,"['flacowade12', None]",20,"['klhorvath25', 'elin6243', 'ccannell', 'blc29', 'qxx', 'jayldoherty', 'vvvany', 'amrvos', None, 'williamzhang0821', 'zhaolin.guo', 'abigail.mrvos', 'nathuffman97', 'fanzhang0815', 'neildhar', 'joeyandrews9211', 'ben_jackson341', 'avah', 'flacowade12', 'raulvyas']"
40,53,18,75,10,"['pranitkumbhar19', 'adityadh943', 'shindedeepak129', 'anujchhabra25', 'naiksandesh1998', 'jayesh.kakkad8770', 'maneshweta23', 'akau100', 'davidrisaac', 'shubhamnagpure745']",7,"['arshan.ansari002', 'sonalkadam10', 'jackymathew', 'runakshi97', 'atithipawar', 'bshelke77', 'sid.soyane1997']",65,"['nikhilchaudhari5516', 'rajat.p', 'smahamulkar1013', 'selimajack26', 'rohitnair77880', 'shah.ns', 'aditya27', 'shreyahonagekar04', 'jugal.vaja', 'shivam.rs', 'chavankeasmita29', 'sakshi.bhosle', 'paras.mehta', 'saurabh.palde', 'sushobh', 'zeevd19', 'sachin.sc', 'arthaya.koyande28', 'vatsal23', 'sujittupe3490', 'orencollaco97', 'shrutik1997.mallick', 'dhwani.vichhi', 'waynemdsouza', 'shraddha0306', 's.suvarna', 'sebin.bc', 'spawar.ap', 'priyu0964', 'patilprasad0123', '15anuchaudhari', 'vidhi.satra', 'sukanyajadhav1997', 'jeniferishwarya', 'd.haria', 'umeshlohote', 'jagnoor.p', 'kunalk4796', 'prithvianvekar21', 'evanjalinbenita', 'shubham.yelange', 'austin.dsouza1997', 'aadi', 'mayuridesai', 'shreyasmoolya', 'vixsnair', 'shaibilsabu', 'rohansaldanha6370', 'swapnalimakdey25', 'yasir.mulla47', 'jay.km', 'ghevadeyogesh', 'adityadesu1', 'harish.c', None, 'ninad.mulay', 'parin.ss', 'abhay.nadkarni', 'sakshi.trivedi', 'dishasaraiya', 'aur_mnzs', 'saurabhgawade.777.4.sg', 'shail.maroo', 'wanichinmay577', 'omkar.karande']",82,"['arshan.ansari002', 'nikhilchaudhari5516', 'shindedeepak129', 'rajat.p', 'smahamulkar1013', 'selimajack26', 'akau100', 'sid.soyane1997', 'rohitnair77880', 'shah.ns', 'aditya27', 'shreyahonagekar04', 'jugal.vaja', 'shivam.rs', 'chavankeasmita29', 'sakshi.bhosle', 'paras.mehta', 'saurabh.palde', 'sushobh', 'zeevd19', 'sachin.sc', 'arthaya.koyande28', 'vatsal23', 'sujittupe3490', 'orencollaco97', 'shrutik1997.mallick', 'dhwani.vichhi', 'anujchhabra25', 'runakshi97', 'waynemdsouza', 'shraddha0306', 's.suvarna', 'pranitkumbhar19', 'jackymathew', 'sebin.bc', 'spawar.ap', 'naiksandesh1998', 'priyu0964', 'patilprasad0123', '15anuchaudhari', 'vidhi.satra', 'sukanyajadhav1997', 'maneshweta23', 'jeniferishwarya', 'd.haria', 'umeshlohote', 'jagnoor.p', 'kunalk4796', 'prithvianvekar21', 'evanjalinbenita', 'shubham.yelange', 'austin.dsouza1997', 'aadi', 'mayuridesai', 'shreyasmoolya', 'vixsnair', 'shaibilsabu', 'atithipawar', 'jayesh.kakkad8770', 'bshelke77', 'rohansaldanha6370', 'davidrisaac', 'shubhamnagpure745', 'swapnalimakdey25', 'yasir.mulla47', 'jay.km', 'ghevadeyogesh', 'adityadesu1', 'harish.c', None, 'ninad.mulay', 'adityadh943', 'parin.ss', 'sonalkadam10', 'abhay.nadkarni', 'sakshi.trivedi', 'dishasaraiya', 'aur_mnzs', 'saurabhgawade.777.4.sg', 'shail.maroo', 'wanichinmay577', 'omkar.karande']"
40,55,18,15,6,"['arshan.ansari002', 'sonalkadam10', 'runakshi97', 'atithipawar', 'bshelke77', 'sid.soyane1997']",11,"['pranitkumbhar19', 'adityadh943', 'jackymathew', 'shindedeepak129', 'anujchhabra25', 'naiksandesh1998', 'jayesh.kakkad8770', 'maneshweta23', 'akau100', 'davidrisaac', 'shubhamnagpure745']",9,"['abhishektoraskar412', 'sagar.pawar35418', 'vanaja2812', 'aishwaryahiwale97', 'tejalborhade', 'rsbangar1998', 'mohini.bhangale5', None, 'vedantpalshetkar259']",26,"['arshan.ansari002', 'shindedeepak129', 'abhishektoraskar412', 'anujchhabra25', 'runakshi97', 'aishwaryahiwale97', 'tejalborhade', 'akau100', 'sid.soyane1997', 'rsbangar1998', None, 'pranitkumbhar19', 'adityadh943', 'jackymathew', 'sonalkadam10', 'naiksandesh1998', 'atithipawar', 'sagar.pawar35418', 'jayesh.kakkad8770', 'vanaja2812', 'maneshweta23', 'bshelke77', 'davidrisaac', 'shubhamnagpure745', 'mohini.bhangale5', 'vedantpalshetkar259']"
40,54,18,7,1,['jackymathew'],16,"['pranitkumbhar19', 'arshan.ansari002', 'adityadh943', 'sonalkadam10', 'shindedeepak129', 'anujchhabra25', 'naiksandesh1998', 'runakshi97', 'atithipawar', 'jayesh.kakkad8770', 'maneshweta23', 'bshelke77', 'akau100', 'davidrisaac', 'shubhamnagpure745', 'sid.soyane1997']",6,"['shaibilsabu', 'evanjalinbenita', 'omkarkhedkaro', 'selimajack26', None, 'swapnalimakdey25']",23,"['arshan.ansari002', 'shindedeepak129', 'anujchhabra25', 'runakshi97', 'evanjalinbenita', 'selimajack26', 'akau100', 'sid.soyane1997', None, 'pranitkumbhar19', 'adityadh943', 'jackymathew', 'sonalkadam10', 'shaibilsabu', 'naiksandesh1998', 'atithipawar', 'jayesh.kakkad8770', 'omkarkhedkaro', 'maneshweta23', 'bshelke77', 'davidrisaac', 'shubhamnagpure745', 'swapnalimakdey25']"
41,412,18,36,15,"['dianroro97', 'labbasica', 'andydroid07', 'rc.moreno1084', 'je.diaz', 'lauradnc1505', 'nicortescen', 'eduardmolano', 'holapincheputita', 'nico1029', 'andresfdt.2k8', 'leonard.ruiz00', 'alexrc9778', 'jairovlacha97', 'nanoxzapata']",2,"['jairovlacha', 'kriscampbell']",21,"['rcarvajal208', 'julianberonn', 'drhurtado', 'julissa.vigoya', 'am.bolivar', 'fa.gomez12', 'danielbaron104', 'juanseb98', 'edgarfpena', 'lauraguerreroa88', 'labfund', 'te.vence10', 'lf.correa10', 'carlosan98', 'alejandroariaszuluaga', 'alvarocardona', 'ma.sandoval', 'ayalagamezn', None, 'santiagoalfonso015', 'jc.sanchez16']",38,"['jairovlacha', 'rc.moreno1084', 'rcarvajal208', 'julianberonn', 'drhurtado', 'holapincheputita', 'nico1029', 'julissa.vigoya', 'am.bolivar', 'nanoxzapata', 'andydroid07', 'je.diaz', 'fa.gomez12', 'danielbaron104', 'juanseb98', 'edgarfpena', 'lauraguerreroa88', 'leonard.ruiz00', 'kriscampbell', 'labfund', 'te.vence10', 'lf.correa10', 'dianroro97', 'labbasica', 'carlosan98', 'alejandroariaszuluaga', 'alvarocardona', 'ma.sandoval', 'nicortescen', 'ayalagamezn', 'andresfdt.2k8', 'alexrc9778', 'jairovlacha97', None, 'santiagoalfonso015', 'lauradnc1505', 'eduardmolano', 'jc.sanchez16']"
41,213,18,25,1,['andresfdt.2k8'],16,"['jairovlacha', 'dianroro97', 'labbasica', 'andydroid07', 'rc.moreno1084', 'je.diaz', 'lauradnc1505', 'nicortescen', 'eduardmolano', 'holapincheputita', 'nico1029', 'leonard.ruiz00', 'alexrc9778', 'jairovlacha97', 'kriscampbell', 'nanoxzapata']",24,"['rcarvajal208', 'julianberonn', 'drhurtado', 'julissa.vigoya', 'am.bolivar', 'danielpena96', 'danielbaron104', 'juanseb98', 'edgarfpena', 'lauraguerreroa88', 'jgal', 'te.vence10', 'lf.correa10', 'carlosan98', 'labfund', 'alejandroariaszuluaga', 'alvarocardona', 'ma.sandoval', None, 'maria.a.solano.otero', 'santiagoalfonso015', 'medagorodavid', 'carlosaenz2626', 'juanguerron']",41,"['jairovlacha', 'rc.moreno1084', 'rcarvajal208', 'julianberonn', 'drhurtado', 'holapincheputita', 'nico1029', 'julissa.vigoya', 'am.bolivar', 'nanoxzapata', 'danielpena96', 'andydroid07', 'je.diaz', 'danielbaron104', 'juanseb98', 'edgarfpena', 'lauraguerreroa88', 'leonard.ruiz00', 'kriscampbell', 'labfund', 'te.vence10', 'lf.correa10', 'dianroro97', 'labbasica', 'carlosan98', 'jgal', 'alejandroariaszuluaga', 'alvarocardona', 'ma.sandoval', 'nicortescen', 'andresfdt.2k8', 'alexrc9778', 'jairovlacha97', None, 'maria.a.solano.otero', 'santiagoalfonso015', 'medagorodavid', 'lauradnc1505', 'carlosaenz2626', 'juanguerron', 'eduardmolano']"
41,411,18,18,4,"['eduardmolano', 'andresfdt.2k8', 'andydroid07', 'nico1029']",13,"['jairovlacha', 'dianroro97', 'labbasica', 'rc.moreno1084', 'je.diaz', 'lauradnc1505', 'nicortescen', 'holapincheputita', 'leonard.ruiz00', 'alexrc9778', 'jairovlacha97', 'kriscampbell', 'nanoxzapata']",14,"['te.vence10', 'polania.andres.a', 'alejandroariaszuluaga', 'carlosaenz2626', 'julianberonn', 'ayalagamezn', 'ma.sandoval', 'miguelangie', 'vb.herrera', 'gaboandrez99', 'jeisontimana', 'am.bolivar', None, 'daljim76']",31,"['te.vence10', 'jairovlacha', 'dianroro97', 'labbasica', 'rc.moreno1084', 'alejandroariaszuluaga', 'julianberonn', 'ayalagamezn', 'nicortescen', 'ma.sandoval', 'miguelangie', 'holapincheputita', 'nico1029', 'andresfdt.2k8', 'vb.herrera', 'alexrc9778', 'am.bolivar', 'jairovlacha97', 'daljim76', None, 'nanoxzapata', 'polania.andres.a', 'andydroid07', 'je.diaz', 'lauradnc1505', 'carlosaenz2626', 'eduardmolano', 'gaboandrez99', 'jeisontimana', 'leonard.ruiz00', 'kriscampbell']"
42,35,17,16,14,"['ebowall', 'hanmkim', 'mcsherry', 'tobiasbu', 'zjber', 'agarprat', 'kturaczy', 'ajbgayle', 'csempere', 'epacheck', 'luisab.12', 'mveksler', 'alenert1', 'brownmbr']",2,"['muhammad.smsm94', 'alexandros.cruz']",2,"['jhemmerl11', None]",18,"['muhammad.smsm94', 'hanmkim', 'mcsherry', 'ajbgayle', 'luisab.12', 'csempere', 'ebowall', None, 'jhemmerl11', 'tobiasbu', 'zjber', 'agarprat', 'kturaczy', 'epacheck', 'mveksler', 'alenert1', 'brownmbr', 'alexandros.cruz']"
43,301,17,22,16,"['jpt5290', 'sur405', 'zcr5008', 'alt21', 'jcm5832', 'hna5042', 'daf5394', 'alexphinn197', 'icp5016', 'xjw5028', 'qvf5023', 'mma5586', 'acl5384', 'cas6792', 'hpb5076', 'veb5055']",0,[],6,"['rha5063', 'jdc5551', 'n.baughman04', 'lassejensen', 'sxp1153', None]",22,"['alt21', 'jcm5832', 'lassejensen', 'acl5384', 'cas6792', 'jpt5290', 'hna5042', 'daf5394', 'qvf5023', 'jdc5551', 'n.baughman04', 'sur405', 'hpb5076', None, 'zcr5008', 'alexphinn197', 'icp5016', 'xjw5028', 'mma5586', 'sxp1153', 'rha5063', 'veb5055']"
43,374,17,22,16,"['jpt5290', 'sur405', 'zcr5008', 'alt21', 'jcm5832', 'hna5042', 'daf5394', 'alexphinn197', 'icp5016', 'xjw5028', 'qvf5023', 'mma5586', 'acl5384', 'cas6792', 'hpb5076', 'veb5055']",0,[],6,"['rha5063', 'jdc5551', 'bpw5146', 'lassejensen', 'jeff.becca', None]",22,"['alt21', 'bpw5146', 'jcm5832', 'lassejensen', 'acl5384', 'cas6792', 'jeff.becca', 'jpt5290', 'hna5042', 'daf5394', 'qvf5023', 'jdc5551', 'sur405', 'hpb5076', None, 'zcr5008', 'alexphinn197', 'icp5016', 'xjw5028', 'mma5586', 'rha5063', 'veb5055']"
43,378,17,19,15,"['jpt5290', 'sur405', 'alt21', 'jcm5832', 'hna5042', 'daf5394', 'alexphinn197', 'icp5016', 'xjw5028', 'qvf5023', 'mma5586', 'acl5384', 'cas6792', 'hpb5076', 'veb5055']",1,['zcr5008'],4,"['bpw5146', 'jdc5551', None, 'lassejensen']",20,"['jdc5551', 'sur405', 'alt21', 'jcm5832', 'bpw5146', 'lassejensen', 'acl5384', 'hpb5076', 'cas6792', None, 'jpt5290', 'zcr5008', 'hna5042', 'daf5394', 'alexphinn197', 'icp5016', 'xjw5028', 'qvf5023', 'mma5586', 'veb5055']"
43,302,17,18,14,"['jpt5290', 'sur405', 'alt21', 'jcm5832', 'hna5042', 'daf5394', 'alexphinn197', 'icp5016', 'xjw5028', 'qvf5023', 'mma5586', 'cas6792', 'hpb5076', 'veb5055']",2,"['zcr5008', 'acl5384']",4,"['bpw5146', None, 'rha5063', 'ppp31']",20,"['sur405', 'alt21', 'jcm5832', 'bpw5146', 'ppp31', 'acl5384', 'hpb5076', 'cas6792', None, 'jpt5290', 'zcr5008', 'hna5042', 'daf5394', 'alexphinn197', 'icp5016', 'xjw5028', 'qvf5023', 'mma5586', 'rha5063', 'veb5055']"
43,375,17,11,9,"['jpt5290', 'alt21', 'hna5042', 'alexphinn197', 'xjw5028', 'mma5586', 'acl5384', 'hpb5076', 'veb5055']",7,"['sur405', 'zcr5008', 'jcm5832', 'daf5394', 'icp5016', 'qvf5023', 'cas6792']",2,"['bpw5146', None]",18,"['sur405', 'alt21', 'jcm5832', 'bpw5146', 'acl5384', 'hpb5076', 'cas6792', None, 'jpt5290', 'zcr5008', 'hna5042', 'daf5394', 'alexphinn197', 'icp5016', 'xjw5028', 'qvf5023', 'mma5586', 'veb5055']"
43,303,17,7,6,"['jpt5290', 'daf5394', 'alexphinn197', 'acl5384', 'hpb5076', 'veb5055']",10,"['sur405', 'zcr5008', 'jcm5832', 'hna5042', 'alt21', 'icp5016', 'xjw5028', 'qvf5023', 'mma5586', 'cas6792']",1,[None],17,"['sur405', 'alt21', 'jcm5832', 'acl5384', 'hpb5076', 'cas6792', None, 'jpt5290', 'zcr5008', 'hna5042', 'daf5394', 'alexphinn197', 'icp5016', 'xjw5028', 'qvf5023', 'mma5586', 'veb5055']"
44,56,17,142,16,"['nikhilchaudhari5516', 'tejaskinage', 'rushabhkothari12', 'akankshapatil', 'sagarthool', 'huzefa9702', 'saurabhgawade.777.4.sg', 'vivek4238', 'pranali', 'pranesha08', 'nitish_mishra', 'chakulipatil999', 'aashutoshkhapare22', 'shraddha0306', 'shipra2', 'prachi04']",0,[],126,"['nikperu007', 'harshalisawant92', 'omkar.chalke96', 'rajasiar1234', 'dmce123456789', 'h.vyas', 'darshana.mehta', 'sagargujar123', 'rahul.jethwa', 'akashupadhyay', 'rishi.mistry', 'aditya27', 'manalighorpade07', 'shreyahonagekar04', 'jugal.vaja', 'kssheetal2497', 'aditya.bhabhe', 'shivam.rs', 'sakshi.bhosle', 'singhamod111', 'chauhanajay4u', 'sachin.sc', 'sujittupe3490', 'rehan.mistry', 'mehulkharvi7', 'ranajay1997', 'pinak.p', 'bhushan0397', 'shrutik1997.mallick', 'ritesh0111', 'vidushirazdan1308', 'madhuriwawale13', 'p_vasant', 'nehagurale10', 'vikramtirathkar96', 'kevin.z', 'yash.gulve', 'aditya.prnair', 'umeshlohote', 'jainamshah409', 'jagnoor.p', 'amey.mahadik98', 'kunalk4796', 'rajaskhasgiwale8497', 'prithvianvekar21', 'shubham.yelange', 'aladvait', 'arat.gouda', 'pranay.sadavarte', 'doobvoob', 'k.siddhapura', 'jayshree90', 'apurvamirke29', 'kacharerohan', 'rutuja.mehta', 'arpanmodi2014', 'adityajoy29', 'jay.km', 'shubhada.shetti', 'divya.sawant17497', 'sakshi.trivedi', 'hitvena.shah', 'nikita.rp', 'zotingsagar', 'shashankyadavade68', 'mehanshi.p', 'yashsavle', 'rajat.p', 'gaurav24', 'nihal.raut', 'smahamulkar1013', 'shah.ns', 'slimshady', 'dilipramgir', 'maitrishah', 'goyalvishal147', 'saurabh.palde', 'karanshah16', 'zeevd19', 'arthaya.koyande28', 'thakreshivam805', 'ankita.nd', 'kaustubhvaishampayan', 'nitin.lalwani', 'soham.sk', 'kalekajal2', 'perekarnk', 's.suvarna', 'harshal.bhole', 'spawar.ap', 'shwetakanoja', 'roy.shinde77', 'pranaykaranjekar28', 'shettynitin667', 'saadrahman.a', 'ssoneria7', 'd.haria', 'darshana2504', 'swapnalidethe', 'rohithebbar10', 'aadi', 's.vohra', 'shreyasmoolya', 'kapil1410', 'adwaitnaik2', 'shahruchi', 'bhangaleprit', 'dhanshreeshawale', 'anushkaw055', 'nayan_nanohub', 'yasir.mulla47', 'abbas.barwaniwala', 'harish.c', None, 'apeksha.shinde', 'ninad.mulay', 'parin.ss', 'abhay.nadkarni', 'dishasaraiya', 'pranalim11', 'yashshetye7', 'bhushanrsonawane1998', 'ameysawant25597', 'kumawatmukesh71', 'rahulbirwadkar123', 'shettysagar35']",142,"['nikperu007', 'nikhilchaudhari5516', 'harshalisawant92', 'omkar.chalke96', 'rajasiar1234', 'dmce123456789', 'h.vyas', 'darshana.mehta', 'sagarthool', 'sagargujar123', 'rahul.jethwa', 'akashupadhyay', 'rishi.mistry', 'aditya27', 'manalighorpade07', 'shreyahonagekar04', 'jugal.vaja', 'kssheetal2497', 'aditya.bhabhe', 'shivam.rs', 'sakshi.bhosle', 'singhamod111', 'chauhanajay4u', 'sachin.sc', 'sujittupe3490', 'rehan.mistry', 'mehulkharvi7', 'ranajay1997', 'pinak.p', 'bhushan0397', 'shrutik1997.mallick', 'ritesh0111', 'vidushirazdan1308', 'madhuriwawale13', 'shraddha0306', 'p_vasant', 'nehagurale10', 'vikramtirathkar96', 'kevin.z', 'yash.gulve', 'aditya.prnair', 'umeshlohote', 'jainamshah409', 'jagnoor.p', 'amey.mahadik98', 'kunalk4796', 'rajaskhasgiwale8497', 'prithvianvekar21', 'shubham.yelange', 'aladvait', 'arat.gouda', 'pranay.sadavarte', 'tejaskinage', 'doobvoob', 'k.siddhapura', 'vivek4238', 'jayshree90', 'apurvamirke29', 'kacharerohan', 'rutuja.mehta', 'arpanmodi2014', 'huzefa9702', 'adityajoy29', 'jay.km', 'shipra2', 'shubhada.shetti', 'divya.sawant17497', 'sakshi.trivedi', 'hitvena.shah', 'nikita.rp', 'zotingsagar', 'shashankyadavade68', 'mehanshi.p', 'yashsavle', 'akankshapatil', 'rajat.p', 'gaurav24', 'nihal.raut', 'smahamulkar1013', 'rahulbirwadkar123', 'shah.ns', 'slimshady', 'dilipramgir', 'maitrishah', 'goyalvishal147', 'saurabh.palde', 'karanshah16', 'zeevd19', 'arthaya.koyande28', 'prachi04', 'thakreshivam805', 'ankita.nd', 'kaustubhvaishampayan', 'nitin.lalwani', 'soham.sk', 'pranesha08', 'kalekajal2', 'perekarnk', 's.suvarna', 'harshal.bhole', 'spawar.ap', 'shwetakanoja', 'roy.shinde77', 'pranaykaranjekar28', 'shettynitin667', 'saadrahman.a', 'ssoneria7', 'd.haria', 'aashutoshkhapare22', 'darshana2504', 'swapnalidethe', 'aadi', 's.vohra', 'shreyasmoolya', 'kapil1410', 'adwaitnaik2', 'shahruchi', 'chakulipatil999', 'bhangaleprit', 'dhanshreeshawale', 'anushkaw055', 'rushabhkothari12', 'nayan_nanohub', 'yasir.mulla47', 'abbas.barwaniwala', 'harish.c', None, 'apeksha.shinde', 'ninad.mulay', 'parin.ss', 'abhay.nadkarni', 'dishasaraiya', 'saurabhgawade.777.4.sg', 'pranalim11', 'yashshetye7', 'pranali', 'nitish_mishra', 'bhushanrsonawane1998', 'ameysawant25597', 'kumawatmukesh71', 'rohithebbar10', 'shettysagar35']"
44,53,17,75,3,"['shraddha0306', 'nikhilchaudhari5516', 'saurabhgawade.777.4.sg']",13,"['tejaskinage', 'rushabhkothari12', 'akankshapatil', 'sagarthool', 'huzefa9702', 'vivek4238', 'pranali', 'pranesha08', 'nitish_mishra', 'chakulipatil999', 'aashutoshkhapare22', 'shipra2', 'prachi04']",72,"['shindedeepak129', 'rajat.p', 'smahamulkar1013', 'selimajack26', 'akau100', 'rohitnair77880', 'shah.ns', 'aditya27', 'shreyahonagekar04', 'jugal.vaja', 'shivam.rs', 'chavankeasmita29', 'sakshi.bhosle', 'paras.mehta', 'saurabh.palde', 'sushobh', 'zeevd19', 'sachin.sc', 'arthaya.koyande28', 'vatsal23', 'sujittupe3490', 'orencollaco97', 'shrutik1997.mallick', 'dhwani.vichhi', 'anujchhabra25', 'waynemdsouza', 's.suvarna', 'pranitkumbhar19', 'sebin.bc', 'spawar.ap', 'naiksandesh1998', 'priyu0964', 'patilprasad0123', '15anuchaudhari', 'vidhi.satra', 'sukanyajadhav1997', 'maneshweta23', 'jeniferishwarya', 'd.haria', 'umeshlohote', 'jagnoor.p', 'kunalk4796', 'prithvianvekar21', 'evanjalinbenita', 'shubham.yelange', 'austin.dsouza1997', 'aadi', 'mayuridesai', 'shreyasmoolya', 'vixsnair', 'shaibilsabu', 'jayesh.kakkad8770', 'rohansaldanha6370', 'davidrisaac', 'shubhamnagpure745', 'swapnalimakdey25', 'yasir.mulla47', 'jay.km', 'ghevadeyogesh', 'adityadesu1', 'harish.c', None, 'ninad.mulay', 'adityadh943', 'parin.ss', 'abhay.nadkarni', 'sakshi.trivedi', 'dishasaraiya', 'aur_mnzs', 'shail.maroo', 'wanichinmay577', 'omkar.karande']",88,"['nikhilchaudhari5516', 'shindedeepak129', 'akankshapatil', 'sagarthool', 'rajat.p', 'smahamulkar1013', 'selimajack26', 'akau100', 'rohitnair77880', 'shah.ns', 'aditya27', 'shreyahonagekar04', 'jugal.vaja', 'shivam.rs', 'chavankeasmita29', 'sakshi.bhosle', 'paras.mehta', 'saurabh.palde', 'sushobh', 'zeevd19', 'sachin.sc', 'arthaya.koyande28', 'prachi04', 'vatsal23', 'sujittupe3490', 'orencollaco97', 'shrutik1997.mallick', 'dhwani.vichhi', 'anujchhabra25', 'pranesha08', 'waynemdsouza', 'shraddha0306', 's.suvarna', 'pranitkumbhar19', 'sebin.bc', 'spawar.ap', 'naiksandesh1998', 'priyu0964', 'patilprasad0123', '15anuchaudhari', 'vidhi.satra', 'sukanyajadhav1997', 'maneshweta23', 'jeniferishwarya', 'd.haria', 'aashutoshkhapare22', 'umeshlohote', 'jagnoor.p', 'kunalk4796', 'prithvianvekar21', 'evanjalinbenita', 'shubham.yelange', 'austin.dsouza1997', 'aadi', 'mayuridesai', 'shreyasmoolya', 'vixsnair', 'tejaskinage', 'shaibilsabu', 'vivek4238', 'jayesh.kakkad8770', 'chakulipatil999', 'rohansaldanha6370', 'davidrisaac', 'shubhamnagpure745', 'swapnalimakdey25', 'rushabhkothari12', 'huzefa9702', 'yasir.mulla47', 'jay.km', 'ghevadeyogesh', 'shipra2', 'adityadesu1', 'harish.c', None, 'ninad.mulay', 'adityadh943', 'parin.ss', 'abhay.nadkarni', 'sakshi.trivedi', 'dishasaraiya', 'saurabhgawade.777.4.sg', 'aur_mnzs', 'pranali', 'nitish_mishra', 'shail.maroo', 'wanichinmay577', 'omkar.karande']"
44,271,17,22,14,"['tejaskinage', 'rushabhkothari12', 'akankshapatil', 'sagarthool', 'huzefa9702', 'vivek4238', 'pranali', 'pranesha08', 'nitish_mishra', 'chakulipatil999', 'aashutoshkhapare22', 'shraddha0306', 'shipra2', 'prachi04']",2,"['nikhilchaudhari5516', 'saurabhgawade.777.4.sg']",8,"['swapnalidethe', 'nikperu007', 'slimshady', 'nehagurale10', 'kumawatmukesh71', 'shashankyadavade68', None, 'perekarnk']",24,"['swapnalidethe', 'nikhilchaudhari5516', 'nikperu007', 'akankshapatil', 'sagarthool', 'slimshady', 'tejaskinage', 'vivek4238', 'chakulipatil999', 'prachi04', 'rushabhkothari12', 'huzefa9702', 'pranesha08', 'shraddha0306', 'shipra2', None, 'perekarnk', 'nehagurale10', 'saurabhgawade.777.4.sg', 'pranali', 'nitish_mishra', 'aashutoshkhapare22', 'kumawatmukesh71', 'shashankyadavade68']"
44,285,17,17,12,"['tejaskinage', 'rushabhkothari12', 'akankshapatil', 'sagarthool', 'huzefa9702', 'pranali', 'pranesha08', 'chakulipatil999', 'aashutoshkhapare22', 'shraddha0306', 'shipra2', 'prachi04']",4,"['nitish_mishra', 'nikhilchaudhari5516', 'saurabhgawade.777.4.sg', 'vivek4238']",5,"['thakreshivam805', 'rajasiar1234', 'aladvait', None, 'dhanshreeshawale']",21,"['thakreshivam805', 'nikhilchaudhari5516', 'rajasiar1234', 'rushabhkothari12', 'akankshapatil', 'sagarthool', 'huzefa9702', 'pranesha08', 'aladvait', 'shraddha0306', 'shipra2', None, 'tejaskinage', 'saurabhgawade.777.4.sg', 'vivek4238', 'pranali', 'nitish_mishra', 'chakulipatil999', 'aashutoshkhapare22', 'prachi04', 'dhanshreeshawale']"
44,286,17,14,9,"['nikhilchaudhari5516', 'sagarthool', 'saurabhgawade.777.4.sg', 'vivek4238', 'nitish_mishra', 'chakulipatil999', 'shraddha0306', 'shipra2', 'prachi04']",7,"['tejaskinage', 'rushabhkothari12', 'akankshapatil', 'huzefa9702', 'pranali', 'pranesha08', 'aashutoshkhapare22']",5,"['thakreshivam805', 'yad.chin159', 'rohanpatil483', '15anuchaudhari', None]",21,"['thakreshivam805', 'nikhilchaudhari5516', 'rushabhkothari12', 'akankshapatil', 'sagarthool', 'huzefa9702', 'pranesha08', 'shraddha0306', 'shipra2', None, 'tejaskinage', 'yad.chin159', 'rohanpatil483', 'saurabhgawade.777.4.sg', 'vivek4238', '15anuchaudhari', 'pranali', 'nitish_mishra', 'chakulipatil999', 'aashutoshkhapare22', 'prachi04']"
44,275,17,6,4,"['shraddha0306', 'nikhilchaudhari5516', 'saurabhgawade.777.4.sg', 'vivek4238']",12,"['tejaskinage', 'rushabhkothari12', 'akankshapatil', 'sagarthool', 'huzefa9702', 'pranali', 'pranesha08', 'nitish_mishra', 'chakulipatil999', 'aashutoshkhapare22', 'shipra2', 'prachi04']",2,"[None, '15anuchaudhari']",18,"['nikhilchaudhari5516', 'rushabhkothari12', 'akankshapatil', 'sagarthool', 'huzefa9702', 'pranesha08', 'shraddha0306', 'shipra2', None, 'tejaskinage', 'saurabhgawade.777.4.sg', 'vivek4238', '15anuchaudhari', 'pranali', 'nitish_mishra', 'chakulipatil999', 'aashutoshkhapare22', 'prachi04']"
45,187,17,122,9,"['zhou646', 'mademoiselle0812', 'zhou483', 'shreeya26', 'tracykh276', 'pan279', 'buchanaw', 'rahuldeshmukh', 'li1668']",7,"['pgurunat', 'jkantor', '67373dw', 'chan65', 'lu500', 'ouyang16', 'hanest']",113,"['marisol', 'praveenapprasad', 'kolispeter', 'msakano', 'ja37989', 'jrudolp', 'shashanksk5495', 'jpancha', 'park855', 'zhan1337', 'brendenh88', 'zhan3366', 'mill1914', 'sahu2', 'abhivictor2', 'sachadervi', 'sandracore21', 'ganti', 'montoyah', 'pkolis', 'desai61', 'paul91', 'jverduzc', 'svaze', 'mao85', 'azadoks', 'poiuy1134', 'ncummock', 'swarnava881995', 'mishra94', 'mukher25', 'song517', 'naik.pratik', 'jhartl', 'kkoradiy', 'westonbuchanan', 'peoplesj', 'peter496', 'sanghik', 'mmh', 'li2467', 'beck50', 'clarksm', 'harshit03sep', 'zhao300', 'kaiming', 'skolacek', 'kogunsin', 'alafzi', 'strachan', 'tsimon', 'hao55', 'atrikana', 'zhan3294', 'tracyelkhoury', 'dbenham', 'pandinghao1', 'joshi59', 'shhsu001', 'sabareesh169', 'chand101', 'lslcyc970214', 'chang548', 'singh152', 'abaird7', 'qianyuz482', 'wxy30003000', 'parmar0', 'fu237', 'ke_tang', 'denphi', 'gjhanwar', 'amankar', 'lyons20', 'anavarka', 'izarmako93', 'szamani', 'ownbey', 'wu952', 'kim2957', 'xu530', 'jthekine', 'jiaosiyu', 'vradkar', 'han547', 'jiang556', 'radhakv', 'nkamdar', 'dbranco', 'lee1131', None, 'sukirtthakur', 'cgrantz', 'conley39', 'balasub9', 'gentry9', 'ksethura', 'pkaundin', 'yao201', 'yao99', 'dcappell', 'clarksnano', 'slorenz', 'kbandar', 'samantas', 'shah484', 'tfleck', 'unitas', 'mcclurez', 'patkip', 'ksalish', 'jlavorat', 'vkattaku']",129,"['praveenapprasad', 'jrudolp', 'shreeya26', 'park855', 'zhan1337', 'mill1914', 'chan65', 'sahu2', 'abhivictor2', 'ganti', 'jverduzc', 'svaze', 'mao85', 'poiuy1134', 'swarnava881995', 'song517', 'kkoradiy', 'peoplesj', 'peter496', 'sanghik', 'mmh', 'beck50', 'kaiming', 'kogunsin', '67373dw', 'tsimon', 'hao55', 'zhan3294', 'li1668', 'dbenham', 'mademoiselle0812', 'sabareesh169', 'chand101', 'lslcyc970214', 'singh152', 'hanest', 'qianyuz482', 'fu237', 'zhou646', 'ke_tang', 'amankar', 'anavarka', 'izarmako93', 'pan279', 'ownbey', 'kim2957', 'xu530', 'jthekine', 'jiaosiyu', 'vradkar', 'han547', 'ouyang16', 'sukirtthakur', 'cgrantz', 'conley39', 'balasub9', 'gentry9', 'ksethura', 'pkaundin', 'yao201', 'clarksnano', 'samantas', 'shah484', 'unitas', 'patkip', 'ksalish', 'buchanaw', 'vkattaku', 'marisol', 'kolispeter', 'msakano', 'ja37989', 'shashanksk5495', 'jpancha', 'brendenh88', 'zhan3366', 'sachadervi', 'sandracore21', 'montoyah', 'pkolis', 'desai61', 'paul91', 'rahuldeshmukh', 'azadoks', 'ncummock', 'mishra94', 'mukher25', 'naik.pratik', 'jhartl', 'westonbuchanan', 'li2467', 'clarksm', 'harshit03sep', 'zhao300', 'skolacek', 'alafzi', 'strachan', 'atrikana', 'tracyelkhoury', 'pandinghao1', 'joshi59', 'shhsu001', 'jkantor', 'chang548', 'lu500', 'abaird7', 'wxy30003000', 'parmar0', 'denphi', 'gjhanwar', 'lyons20', 'szamani', 'wu952', 'pgurunat', 'jiang556', 'radhakv', 'tracykh276', 'nkamdar', 'dbranco', 'lee1131', None, 'yao99', 'dcappell', 'slorenz', 'zhou483', 'kbandar', 'tfleck', 'mcclurez', 'jlavorat']"
45,370,17,57,1,['67373dw'],15,"['pgurunat', 'zhou646', 'zhou483', 'mademoiselle0812', 'shreeya26', 'jkantor', 'lu500', 'tracykh276', 'chan65', 'buchanaw', 'pan279', 'rahuldeshmukh', 'ouyang16', 'hanest', 'li1668']",56,"['marisol', 'praveenapprasad', 'joshi59', 'chand101', 'zhan3366', 'lslcyc970214', 'chang548', 'abhivictor2', 'sandracore21', 'abaird7', 'parmar0', 'ganti', 'qianyuz482', 'fu237', 'zypurdue300', 'montoyah', 'pkolis', 'amankar', 'svaze', 'lyons20', 'anavarka', 'mao85', 'izarmako93', 'atrikana', 'ncummock', 'wu952', 'kim2957', 'xu530', 'jiaosiyu', 'mukher25', 'han547', 'radhakv', 'kkoradiy', 'peoplesj', 'peter496', 'lee1131', 'nkamdar', 'li2467', None, 'cgrantz', 'conley39', 'yao99', 'balasub9', 'beck50', 'slorenz', 'kbandar', 'tfleck', 'kaiming', 'shah484', 'mukher32', 'alafzi', 'ksalish', 'hao55', 'zhan3294', 'tracyelkhoury', 'vkattaku']",72,"['marisol', 'praveenapprasad', 'shreeya26', 'zhan3366', 'chan65', 'abhivictor2', 'sandracore21', 'ganti', 'montoyah', 'pkolis', 'svaze', 'mao85', 'rahuldeshmukh', 'ncummock', 'mukher25', 'kkoradiy', 'peoplesj', 'peter496', 'li2467', 'beck50', 'kaiming', 'mukher32', 'alafzi', '67373dw', 'hao55', 'atrikana', 'zhan3294', 'li1668', 'tracyelkhoury', 'joshi59', 'mademoiselle0812', 'jkantor', 'chand101', 'lslcyc970214', 'chang548', 'lu500', 'hanest', 'qianyuz482', 'abaird7', 'parmar0', 'fu237', 'zhou646', 'zypurdue300', 'amankar', 'lyons20', 'anavarka', 'izarmako93', 'pan279', 'wu952', 'pgurunat', 'kim2957', 'xu530', 'jiaosiyu', 'han547', 'radhakv', 'tracykh276', 'lee1131', 'nkamdar', 'ouyang16', None, 'cgrantz', 'conley39', 'yao99', 'balasub9', 'slorenz', 'zhou483', 'kbandar', 'tfleck', 'shah484', 'ksalish', 'buchanaw', 'vkattaku']"
45,188,17,9,1,['hanest'],15,"['pgurunat', 'zhou646', 'zhou483', 'mademoiselle0812', 'shreeya26', 'jkantor', 'lu500', '67373dw', 'tracykh276', 'chan65', 'buchanaw', 'pan279', 'rahuldeshmukh', 'ouyang16', 'li1668']",8,"['pvenupra', 'kline45', 'pkolis', 'naik.pratik', 'dadams', 'peter496', 'ckennett', None]",24,"['pgurunat', 'pvenupra', 'kline45', 'mademoiselle0812', 'naik.pratik', 'shreeya26', 'jkantor', 'peter496', 'tracykh276', 'chan65', 'lu500', 'ouyang16', None, 'hanest', 'zhou646', 'pkolis', 'zhou483', 'dadams', '67373dw', 'ckennett', 'pan279', 'buchanaw', 'rahuldeshmukh', 'li1668']"
46,47,16,53,8,"['nehakhushi1418', 'prathameshpatle13', 'prasadbodekar1996', 'h10waghela', 'nichiteprh1995', 'prasadmasurkar97', 'pawarrajshree12', 'gabru1803']",7,"['kharatomkar24', 'akshatask', 'pawan.mojar', 'rajas.b', 'mayuri.sapkal', 'priyanka.rp', 'mayur.gosavi']",45,"['sonalikharade5', 'pratikkul26', 'shwetatambe12', 'shubhamchury1', 'sohammhas', 'sameersanjaysalveashalata', 'sarvesh.mohite97', 'prashantmanjre9', 'pnrasika', 'hsnnalwala7', 'rohit.elawadekar333', 'tejeshwarvaidya', 'suffiyanshaikh92', 'siddhant8291', 'tanmaykkudalkar', 'shahraj165', 'vanaja2812', 'rishimud', 'sunilkavatkar', 'rushikeshrane27', 'susmeetsukte', 'shubhambhosale', 'kaushiksawant93', 'preeti.kharas', 'neil.dani9', 'sanket.r.makwana', 'shelarpranali1309', 'risha15', 'prathamesh.shivmare1', 'kiranpanchal', 'pandeymikhil', 'aditi.ramadwar', 'prajaktathorat24', 'ankitagamare2218', 'prashant20297', None, 'rugvedikesare427', 'alpha_32123', 'snehald827', 'arpitakudesia3011', 'akshayjambhale07', 'sukanyajadhav1997', 'komalbangar54', 'divyassonawane', 'arpitgodbole7']",60,"['prathameshpatle13', 'shwetatambe12', 'sohammhas', 'sarvesh.mohite97', 'prashantmanjre9', 'hsnnalwala7', 'pnrasika', 'rohit.elawadekar333', 'tejeshwarvaidya', 'suffiyanshaikh92', 'siddhant8291', 'tanmaykkudalkar', 'rishimud', 'prasadmasurkar97', 'preeti.kharas', 'sanket.r.makwana', 'shelarpranali1309', 'risha15', 'pawan.mojar', 'rajas.b', 'pandeymikhil', 'prajaktathorat24', 'ankitagamare2218', 'mayur.gosavi', 'rugvedikesare427', 'alpha_32123', 'kharatomkar24', 'snehald827', 'arpitakudesia3011', 'sukanyajadhav1997', 'komalbangar54', 'divyassonawane', 'priyanka.rp', 'arpitgodbole7', 'pawarrajshree12', 'sonalikharade5', 'pratikkul26', 'akshatask', 'prasadbodekar1996', 'shubhamchury1', 'sameersanjaysalveashalata', 'shahraj165', 'vanaja2812', 'h10waghela', 'nichiteprh1995', 'sunilkavatkar', 'rushikeshrane27', 'susmeetsukte', 'shubhambhosale', 'gabru1803', 'kaushiksawant93', 'nehakhushi1418', 'neil.dani9', 'prathamesh.shivmare1', 'kiranpanchal', 'aditi.ramadwar', 'prashant20297', None, 'akshayjambhale07', 'mayuri.sapkal']"
46,46,16,34,7,"['kharatomkar24', 'akshatask', 'pawan.mojar', 'rajas.b', 'mayuri.sapkal', 'priyanka.rp', 'mayur.gosavi']",8,"['nehakhushi1418', 'prathameshpatle13', 'prasadbodekar1996', 'h10waghela', 'nichiteprh1995', 'prasadmasurkar97', 'pawarrajshree12', 'gabru1803']",27,"['soureen.g', 'gaurav.dangat', 'yash.mhatre', 'pnrasika', 'raj.velani', 'pratham123', 'siddhant8291', 'smita.n', 'niraj.parte', 'jagruti.patil', 'hrishikesh12', 'jayesh.a', 'nikitamittal97', 'vatsal23', 'sonali.gavkar', 'preeti.kharas', 'neil.dani9', 'shelarpranali1309', 'saayuj.s', 'pjkarmokar', 'anjana.bhave', None, 'akansha_sampat', 'tapan.garge', 'snehald827', 'arpitakudesia3011', 'vaishnavi.soni']",42,"['soureen.g', 'prathameshpatle13', 'gaurav.dangat', 'akshatask', 'prasadbodekar1996', 'yash.mhatre', 'pnrasika', 'raj.velani', 'pratham123', 'siddhant8291', 'smita.n', 'niraj.parte', 'jagruti.patil', 'hrishikesh12', 'h10waghela', 'nichiteprh1995', 'jayesh.a', 'prasadmasurkar97', 'nikitamittal97', 'vatsal23', 'gabru1803', 'nehakhushi1418', 'sonali.gavkar', 'preeti.kharas', 'neil.dani9', 'shelarpranali1309', 'saayuj.s', 'pjkarmokar', 'pawan.mojar', 'rajas.b', 'anjana.bhave', 'mayur.gosavi', None, 'akansha_sampat', 'kharatomkar24', 'tapan.garge', 'snehald827', 'arpitakudesia3011', 'vaishnavi.soni', 'mayuri.sapkal', 'priyanka.rp', 'pawarrajshree12']"
47,93,15,17,8,"['priyupawar0797', 'sonalimiraje', 'arshkop97', 'killedarshirish', 'rachupotadar30', 'aafreenpatel2196', 'shubhamyadav', 'ameysabanis16']",6,"['rabadeswapnali13', 'pritammorankar', 'harshada11', 'sp194306', 'afiya2626', 'cpatil7896']",9,"['aadityapatil77', 'snehalavate3', 'mrunalb1497', 'rutujaamate68', 'shreeyarane19', 'kirannirmal57', 'harkesayali19', None, 'trishadesai1111']",23,"['rabadeswapnali13', 'snehalavate3', 'rachupotadar30', 'aafreenpatel2196', 'sp194306', 'mrunalb1497', 'afiya2626', 'shubhamyadav', 'rutujaamate68', 'kirannirmal57', None, 'trishadesai1111', 'ameysabanis16', 'priyupawar0797', 'pritammorankar', 'aadityapatil77', 'sonalimiraje', 'arshkop97', 'killedarshirish', 'harshada11', 'cpatil7896', 'shreeyarane19', 'harkesayali19']"
47,124,15,17,4,"['priyupawar0797', 'cpatil7896', 'sonalimiraje', 'ameysabanis16']",10,"['rabadeswapnali13', 'pritammorankar', 'arshkop97', 'rachupotadar30', 'killedarshirish', 'aafreenpatel2196', 'harshada11', 'sp194306', 'afiya2626', 'shubhamyadav']",13,"['2509patilkomal', 'sanketchavan', 'aadityapatil77', 'utkarshajadhav2018', 'nikitapatil13', 'm.patekari78', 'sharvaript', 'shrikantppmurkute', 'revadekarchetan', 'preranadhumal12575', None, 'trishadesai1111', 'shwetalizambre']",27,"['2509patilkomal', 'rabadeswapnali13', 'utkarshajadhav2018', 'nikitapatil13', 'rachupotadar30', 'aafreenpatel2196', 'sp194306', 'afiya2626', 'shubhamyadav', 'preranadhumal12575', 'm.patekari78', None, 'trishadesai1111', 'ameysabanis16', 'priyupawar0797', 'pritammorankar', 'sanketchavan', 'aadityapatil77', 'sonalimiraje', 'arshkop97', 'sharvaript', 'killedarshirish', 'shrikantppmurkute', 'harshada11', 'revadekarchetan', 'cpatil7896', 'shwetalizambre']"
47,92,15,16,4,"['priyupawar0797', 'cpatil7896', 'sonalimiraje', 'ameysabanis16']",10,"['rabadeswapnali13', 'pritammorankar', 'arshkop97', 'rachupotadar30', 'killedarshirish', 'aafreenpatel2196', 'harshada11', 'sp194306', 'afiya2626', 'shubhamyadav']",12,"['2509patilkomal', 'utkarsha531998', 'utkarshajadhav2018', 'patilkomal100997', 'nikitapatil13', 'shubhangi6', 'snehalavate3', 'swaroopaphadke1', 'snehalawand7', 'shreeyarane19', 'preranadhumal12575', None]",26,"['2509patilkomal', 'rabadeswapnali13', 'utkarsha531998', 'utkarshajadhav2018', 'nikitapatil13', 'shubhangi6', 'snehalavate3', 'rachupotadar30', 'aafreenpatel2196', 'sp194306', 'afiya2626', 'shubhamyadav', 'preranadhumal12575', None, 'ameysabanis16', 'priyupawar0797', 'pritammorankar', 'patilkomal100997', 'sonalimiraje', 'arshkop97', 'killedarshirish', 'swaroopaphadke1', 'harshada11', 'snehalawand7', 'cpatil7896', 'shreeyarane19']"
47,125,15,16,7,"['priyupawar0797', 'rabadeswapnali13', 'pritammorankar', 'sonalimiraje', 'harshada11', 'afiya2626', 'ameysabanis16']",7,"['arshkop97', 'rachupotadar30', 'killedarshirish', 'aafreenpatel2196', 'sp194306', 'shubhamyadav', 'cpatil7896']",9,"['nikitapatil13', 'sahilmagdum', 'shrikantppmurkute', 'snehalawand7', 'sumitvajrashetti', 'm.patekari78', 'kajal181097', None, 'trishadesai1111']",23,"['rabadeswapnali13', 'nikitapatil13', 'rachupotadar30', 'aafreenpatel2196', 'sp194306', 'afiya2626', 'shubhamyadav', 'm.patekari78', 'kajal181097', None, 'trishadesai1111', 'ameysabanis16', 'priyupawar0797', 'pritammorankar', 'sonalimiraje', 'arshkop97', 'sahilmagdum', 'killedarshirish', 'shrikantppmurkute', 'harshada11', 'snehalawand7', 'cpatil7896', 'sumitvajrashetti']"
47,126,15,14,8,"['priyupawar0797', 'pritammorankar', 'sonalimiraje', 'arshkop97', 'killedarshirish', 'rachupotadar30', 'aafreenpatel2196', 'ameysabanis16']",6,"['rabadeswapnali13', 'harshada11', 'sp194306', 'afiya2626', 'shubhamyadav', 'cpatil7896']",6,"['dnyaneshwarghatge55', 'aadityapatil77', 'harkesayali19', 'shreeyarane19', 'kirannirmal57', None]",20,"['rabadeswapnali13', 'dnyaneshwarghatge55', 'rachupotadar30', 'aafreenpatel2196', 'sp194306', 'afiya2626', 'shubhamyadav', 'kirannirmal57', None, 'ameysabanis16', 'priyupawar0797', 'pritammorankar', 'aadityapatil77', 'sonalimiraje', 'arshkop97', 'killedarshirish', 'harshada11', 'cpatil7896', 'shreeyarane19', 'harkesayali19']"
47,94,15,12,6,"['priyupawar0797', 'pritammorankar', 'sonalimiraje', 'harshada11', 'afiya2626', 'ameysabanis16']",8,"['rabadeswapnali13', 'arshkop97', 'rachupotadar30', 'killedarshirish', 'aafreenpatel2196', 'sp194306', 'shubhamyadav', 'cpatil7896']",6,"['utkarsha531998', 'nikitapatil13', 'shubhangi6', 'mrachapalli443', 'djpavan1997', None]",20,"['utkarsha531998', 'rabadeswapnali13', 'nikitapatil13', 'shubhangi6', 'rachupotadar30', 'aafreenpatel2196', 'sp194306', 'afiya2626', 'shubhamyadav', None, 'ameysabanis16', 'priyupawar0797', 'pritammorankar', 'sonalimiraje', 'arshkop97', 'killedarshirish', 'harshada11', 'mrachapalli443', 'cpatil7896', 'djpavan1997']"
48,325,15,9,7,"['agee2', 'tyleradams96', 'iabukhteeva', 'lhamm2', 'njohns84', 'abhishekshibu', 'ranzanofficial']",7,"['constantinegishko', 'vllebedev', 'mauerdmitrii1', 'uliannat', 'vladimirpolyakov93', 'o.s.a.nielsen', 'stas_zaytsev']",2,"[None, 'jcpoler']",16,"['mauerdmitrii1', 'o.s.a.nielsen', 'lhamm2', 'njohns84', 'abhishekshibu', None, 'stas_zaytsev', 'constantinegishko', 'tyleradams96', 'vllebedev', 'uliannat', 'iabukhteeva', 'vladimirpolyakov93', 'agee2', 'jcpoler', 'ranzanofficial']"
48,392,15,8,7,"['tyleradams96', 'lhamm2', 'iabukhteeva', 'agee2', 'njohns84', 'abhishekshibu', 'ranzanofficial']",7,"['constantinegishko', 'vllebedev', 'mauerdmitrii1', 'uliannat', 'vladimirpolyakov93', 'o.s.a.nielsen', 'stas_zaytsev']",1,[None],15,"['mauerdmitrii1', 'o.s.a.nielsen', 'lhamm2', 'njohns84', 'abhishekshibu', None, 'stas_zaytsev', 'constantinegishko', 'tyleradams96', 'vllebedev', 'uliannat', 'iabukhteeva', 'vladimirpolyakov93', 'agee2', 'ranzanofficial']"
48,91,15,6,4,"['lhamm2', 'njohns84', 'ranzanofficial', 'agee2']",10,"['constantinegishko', 'tyleradams96', 'vllebedev', 'mauerdmitrii1', 'uliannat', 'iabukhteeva', 'vladimirpolyakov93', 'o.s.a.nielsen', 'abhishekshibu', 'stas_zaytsev']",2,"['vranjan1', None]",16,"['mauerdmitrii1', 'o.s.a.nielsen', 'vranjan1', 'lhamm2', 'njohns84', 'abhishekshibu', None, 'stas_zaytsev', 'constantinegishko', 'tyleradams96', 'vllebedev', 'uliannat', 'iabukhteeva', 'vladimirpolyakov93', 'agee2', 'ranzanofficial']"
48,104,15,6,4,"['lhamm2', 'njohns84', 'ranzanofficial', 'agee2']",10,"['constantinegishko', 'tyleradams96', 'vllebedev', 'mauerdmitrii1', 'uliannat', 'iabukhteeva', 'vladimirpolyakov93', 'o.s.a.nielsen', 'abhishekshibu', 'stas_zaytsev']",2,"['vranjan1', None]",16,"['mauerdmitrii1', 'o.s.a.nielsen', 'vranjan1', 'lhamm2', 'njohns84', 'abhishekshibu', None, 'stas_zaytsev', 'constantinegishko', 'tyleradams96', 'vllebedev', 'uliannat', 'iabukhteeva', 'vladimirpolyakov93', 'agee2', 'ranzanofficial']"
49,56,15,142,5,"['swapnalidethe', 'slimshady', 'nehagurale10', 'kumawatmukesh71', 'shashankyadavade68']",9,"['vaibhavtoys', 'sourabhkothari16', 'aumkar.nk1', 'kedar.kulkarni12', 'tejalborhade', 'gambhirepraful57', 'ashnavirdikar.av', 'tathagat34', 'mohini.bhangale5']",137,"['nikperu007', 'nikhilchaudhari5516', 'harshalisawant92', 'omkar.chalke96', 'rajasiar1234', 'dmce123456789', 'h.vyas', 'darshana.mehta', 'sagarthool', 'sagargujar123', 'rahul.jethwa', 'akashupadhyay', 'rishi.mistry', 'aditya27', 'manalighorpade07', 'shreyahonagekar04', 'jugal.vaja', 'kssheetal2497', 'aditya.bhabhe', 'shivam.rs', 'sakshi.bhosle', 'singhamod111', 'chauhanajay4u', 'sachin.sc', 'sujittupe3490', 'rehan.mistry', 'mehulkharvi7', 'ranajay1997', 'pinak.p', 'bhushan0397', 'shrutik1997.mallick', 'ritesh0111', 'vidushirazdan1308', 'madhuriwawale13', 'shraddha0306', 'p_vasant', 'vikramtirathkar96', 'kevin.z', 'yash.gulve', 'aditya.prnair', 'umeshlohote', 'jainamshah409', 'jagnoor.p', 'amey.mahadik98', 'kunalk4796', 'rajaskhasgiwale8497', 'prithvianvekar21', 'shubham.yelange', 'aladvait', 'arat.gouda', 'pranay.sadavarte', 'doobvoob', 'tejaskinage', 'k.siddhapura', 'vivek4238', 'jayshree90', 'apurvamirke29', 'kacharerohan', 'rutuja.mehta', 'arpanmodi2014', 'huzefa9702', 'adityajoy29', 'jay.km', 'shipra2', 'shubhada.shetti', 'divya.sawant17497', 'sakshi.trivedi', 'hitvena.shah', 'nikita.rp', 'zotingsagar', 'mehanshi.p', 'yashsavle', 'akankshapatil', 'rajat.p', 'gaurav24', 'nihal.raut', 'smahamulkar1013', 'shah.ns', 'dilipramgir', 'maitrishah', 'goyalvishal147', 'saurabh.palde', 'karanshah16', 'zeevd19', 'arthaya.koyande28', 'prachi04', 'thakreshivam805', 'ankita.nd', 'kaustubhvaishampayan', 'nitin.lalwani', 'soham.sk', 'pranesha08', 'kalekajal2', 'perekarnk', 's.suvarna', 'harshal.bhole', 'spawar.ap', 'shwetakanoja', 'roy.shinde77', 'pranaykaranjekar28', 'shettynitin667', 'saadrahman.a', 'ssoneria7', 'd.haria', 'aashutoshkhapare22', 'darshana2504', 'rohithebbar10', 'aadi', 's.vohra', 'shreyasmoolya', 'kapil1410', 'adwaitnaik2', 'shahruchi', 'chakulipatil999', 'bhangaleprit', 'dhanshreeshawale', 'anushkaw055', 'rushabhkothari12', 'nayan_nanohub', 'yasir.mulla47', 'abbas.barwaniwala', 'harish.c', None, 'apeksha.shinde', 'ninad.mulay', 'parin.ss', 'abhay.nadkarni', 'dishasaraiya', 'pranalim11', 'saurabhgawade.777.4.sg', 'yashshetye7', 'pranali', 'nitish_mishra', 'bhushanrsonawane1998', 'ameysawant25597', 'rahulbirwadkar123', 'shettysagar35']",151,"['vaibhavtoys', 'aumkar.nk1', 'nikperu007', 'nikhilchaudhari5516', 'harshalisawant92', 'omkar.chalke96', 'rajasiar1234', 'dmce123456789', 'h.vyas', 'darshana.mehta', 'sagarthool', 'sagargujar123', 'rahul.jethwa', 'akashupadhyay', 'rishi.mistry', 'aditya27', 'manalighorpade07', 'shreyahonagekar04', 'jugal.vaja', 'kssheetal2497', 'aditya.bhabhe', 'shivam.rs', 'sakshi.bhosle', 'singhamod111', 'chauhanajay4u', 'sachin.sc', 'sujittupe3490', 'rehan.mistry', 'mehulkharvi7', 'ranajay1997', 'pinak.p', 'bhushan0397', 'shrutik1997.mallick', 'ritesh0111', 'vidushirazdan1308', 'madhuriwawale13', 'shraddha0306', 'p_vasant', 'nehagurale10', 'vikramtirathkar96', 'kevin.z', 'yash.gulve', 'aditya.prnair', 'gambhirepraful57', 'umeshlohote', 'jainamshah409', 'jagnoor.p', 'amey.mahadik98', 'kunalk4796', 'rajaskhasgiwale8497', 'prithvianvekar21', 'shubham.yelange', 'aladvait', 'arat.gouda', 'pranay.sadavarte', 'doobvoob', 'tejaskinage', 'k.siddhapura', 'vivek4238', 'jayshree90', 'apurvamirke29', 'kacharerohan', 'rutuja.mehta', 'arpanmodi2014', 'huzefa9702', 'adityajoy29', 'jay.km', 'shipra2', 'shubhada.shetti', 'divya.sawant17497', 'sakshi.trivedi', 'hitvena.shah', 'ashnavirdikar.av', 'nikita.rp', 'zotingsagar', 'shashankyadavade68', 'mehanshi.p', 'yashsavle', 'akankshapatil', 'rajat.p', 'gaurav24', 'tejalborhade', 'nihal.raut', 'smahamulkar1013', 'rahulbirwadkar123', 'shah.ns', 'slimshady', 'dilipramgir', 'maitrishah', 'goyalvishal147', 'saurabh.palde', 'karanshah16', 'zeevd19', 'arthaya.koyande28', 'prachi04', 'thakreshivam805', 'ankita.nd', 'kaustubhvaishampayan', 'nitin.lalwani', 'soham.sk', 'pranesha08', 'kalekajal2', 'perekarnk', 's.suvarna', 'harshal.bhole', 'spawar.ap', 'shwetakanoja', 'roy.shinde77', 'pranaykaranjekar28', 'shettynitin667', 'saadrahman.a', 'ssoneria7', 'd.haria', 'aashutoshkhapare22', 'darshana2504', 'mohini.bhangale5', 'swapnalidethe', 'aadi', 's.vohra', 'shreyasmoolya', 'kapil1410', 'adwaitnaik2', 'kedar.kulkarni12', 'shahruchi', 'chakulipatil999', 'bhangaleprit', 'dhanshreeshawale', 'sourabhkothari16', 'anushkaw055', 'rushabhkothari12', 'nayan_nanohub', 'yasir.mulla47', 'tathagat34', 'abbas.barwaniwala', 'harish.c', None, 'apeksha.shinde', 'ninad.mulay', 'parin.ss', 'abhay.nadkarni', 'dishasaraiya', 'pranalim11', 'saurabhgawade.777.4.sg', 'yashshetye7', 'pranali', 'nitish_mishra', 'bhushanrsonawane1998', 'ameysawant25597', 'kumawatmukesh71', 'rohithebbar10', 'shettysagar35']"
49,271,15,22,5,"['swapnalidethe', 'slimshady', 'nehagurale10', 'kumawatmukesh71', 'shashankyadavade68']",9,"['vaibhavtoys', 'sourabhkothari16', 'aumkar.nk1', 'kedar.kulkarni12', 'tejalborhade', 'gambhirepraful57', 'ashnavirdikar.av', 'tathagat34', 'mohini.bhangale5']",17,"['nikperu007', 'tejaskinage', 'rushabhkothari12', 'akankshapatil', 'sagarthool', 'vivek4238', 'huzefa9702', 'pranali', 'pranesha08', 'nitish_mishra', 'chakulipatil999', 'aashutoshkhapare22', 'shraddha0306', 'shipra2', 'prachi04', None, 'perekarnk']",31,"['vaibhavtoys', 'swapnalidethe', 'aumkar.nk1', 'nikperu007', 'akankshapatil', 'sagarthool', 'tejalborhade', 'slimshady', 'kedar.kulkarni12', 'tejaskinage', 'vivek4238', 'chakulipatil999', 'prachi04', 'sourabhkothari16', 'rushabhkothari12', 'huzefa9702', 'pranesha08', 'tathagat34', 'shraddha0306', 'shipra2', None, 'perekarnk', 'nehagurale10', 'pranali', 'nitish_mishra', 'gambhirepraful57', 'ashnavirdikar.av', 'kumawatmukesh71', 'aashutoshkhapare22', 'shashankyadavade68', 'mohini.bhangale5']"
49,57,15,19,7,"['vaibhavtoys', 'sourabhkothari16', 'aumkar.nk1', 'kedar.kulkarni12', 'gambhirepraful57', 'ashnavirdikar.av', 'tathagat34']",7,"['swapnalidethe', 'slimshady', 'nehagurale10', 'tejalborhade', 'kumawatmukesh71', 'shashankyadavade68', 'mohini.bhangale5']",12,"['gayatri.hadap47', 'nvicharenv464', 'abhishektoraskar412', 'prasadwagh95', 'rakeshpatil9271', 'mayur98bhor', 'iammayuri3', 'pratik.devle98', 'siddhesh.soyane', 'rsbangar1998', None, 'gambhirepraful87']",26,"['vaibhavtoys', 'swapnalidethe', 'aumkar.nk1', 'gayatri.hadap47', 'rakeshpatil9271', 'tejalborhade', 'slimshady', 'kedar.kulkarni12', 'nvicharenv464', 'siddhesh.soyane', 'sourabhkothari16', 'abhishektoraskar412', 'mayur98bhor', 'iammayuri3', 'pratik.devle98', 'tathagat34', 'rsbangar1998', None, 'gambhirepraful87', 'nehagurale10', 'prasadwagh95', 'gambhirepraful57', 'ashnavirdikar.av', 'kumawatmukesh71', 'shashankyadavade68', 'mohini.bhangale5']"
49,268,15,16,6,"['vaibhavtoys', 'aumkar.nk1', 'kedar.kulkarni12', 'gambhirepraful57', 'ashnavirdikar.av', 'tathagat34']",8,"['swapnalidethe', 'slimshady', 'nehagurale10', 'sourabhkothari16', 'tejalborhade', 'kumawatmukesh71', 'shashankyadavade68', 'mohini.bhangale5']",10,"['gayatri.hadap47', 'shankharimeenu', 'priyankakunde22', 'abhishektoraskar412', 'pillaiabhinash11', 'rsbangar1998', 'iammayuri3', 'pooja1996', None, 'gambhirepraful87']",24,"['vaibhavtoys', 'sourabhkothari16', 'swapnalidethe', 'aumkar.nk1', 'priyankakunde22', 'shankharimeenu', 'gayatri.hadap47', 'abhishektoraskar412', 'iammayuri3', 'tejalborhade', 'tathagat34', 'pooja1996', 'rsbangar1998', None, 'gambhirepraful87', 'slimshady', 'nehagurale10', 'kedar.kulkarni12', 'pillaiabhinash11', 'gambhirepraful57', 'ashnavirdikar.av', 'kumawatmukesh71', 'shashankyadavade68', 'mohini.bhangale5']"
49,55,15,15,2,"['tejalborhade', 'mohini.bhangale5']",12,"['vaibhavtoys', 'slimshady', 'nehagurale10', 'kedar.kulkarni12', 'sourabhkothari16', 'swapnalidethe', 'aumkar.nk1', 'gambhirepraful57', 'ashnavirdikar.av', 'kumawatmukesh71', 'tathagat34', 'shashankyadavade68']",13,"['arshan.ansari002', 'sonalkadam10', 'abhishektoraskar412', 'atithipawar', 'sagar.pawar35418', 'runakshi97', 'vanaja2812', 'aishwaryahiwale97', 'bshelke77', 'rsbangar1998', None, 'vedantpalshetkar259', 'sid.soyane1997']",27,"['vaibhavtoys', 'sourabhkothari16', 'swapnalidethe', 'aumkar.nk1', 'arshan.ansari002', 'abhishektoraskar412', 'runakshi97', 'aishwaryahiwale97', 'tejalborhade', 'tathagat34', 'rsbangar1998', 'sid.soyane1997', None, 'slimshady', 'nehagurale10', 'kedar.kulkarni12', 'sonalkadam10', 'atithipawar', 'sagar.pawar35418', 'vanaja2812', 'gambhirepraful57', 'ashnavirdikar.av', 'bshelke77', 'kumawatmukesh71', 'shashankyadavade68', 'mohini.bhangale5', 'vedantpalshetkar259']"
49,270,15,13,1,['tejalborhade'],13,"['vaibhavtoys', 'slimshady', 'nehagurale10', 'kedar.kulkarni12', 'sourabhkothari16', 'swapnalidethe', 'aumkar.nk1', 'gambhirepraful57', 'ashnavirdikar.av', 'kumawatmukesh71', 'tathagat34', 'shashankyadavade68', 'mohini.bhangale5']",12,"['rakshitpoojary1606', 'deepaputran', 'tushar.t.rao', 'camit149', 'srt150597', 'snehashinde093', 'akshata11', 'patelkhushbu098', 'prajaktawarke7797', 'samikshakamble6', None, 'ssavtirkar1']",26,"['vaibhavtoys', 'sourabhkothari16', 'swapnalidethe', 'aumkar.nk1', 'rakshitpoojary1606', 'srt150597', 'tejalborhade', 'snehashinde093', 'prajaktawarke7797', 'tathagat34', None, 'ssavtirkar1', 'slimshady', 'nehagurale10', 'kedar.kulkarni12', 'deepaputran', 'tushar.t.rao', 'camit149', 'gambhirepraful57', 'patelkhushbu098', 'ashnavirdikar.av', 'akshata11', 'kumawatmukesh71', 'samikshakamble6', 'shashankyadavade68', 'mohini.bhangale5']"
49,272,15,13,1,['sourabhkothari16'],13,"['vaibhavtoys', 'slimshady', 'nehagurale10', 'kedar.kulkarni12', 'swapnalidethe', 'aumkar.nk1', 'tejalborhade', 'gambhirepraful57', 'ashnavirdikar.av', 'kumawatmukesh71', 'tathagat34', 'shashankyadavade68', 'mohini.bhangale5']",12,"['priyankakunde22', 'nvicharenv464', 'prasadwagh95', 'pillaiabhinash11', 'rakeshpatil9271', 'sandesh', 'mayur98bhor', 'akankshachandoskar1198', 'aaronkoli98', 'pratik.devle98', None, 'gambhirepraful87']",26,"['vaibhavtoys', 'sourabhkothari16', 'swapnalidethe', 'aumkar.nk1', 'priyankakunde22', 'rakeshpatil9271', 'sandesh', 'mayur98bhor', 'akankshachandoskar1198', 'pratik.devle98', 'tejalborhade', 'tathagat34', None, 'gambhirepraful87', 'slimshady', 'nehagurale10', 'kedar.kulkarni12', 'nvicharenv464', 'prasadwagh95', 'pillaiabhinash11', 'aaronkoli98', 'gambhirepraful57', 'ashnavirdikar.av', 'kumawatmukesh71', 'shashankyadavade68', 'mohini.bhangale5']"
49,273,15,6,1,['mohini.bhangale5'],13,"['vaibhavtoys', 'slimshady', 'nehagurale10', 'kedar.kulkarni12', 'sourabhkothari16', 'swapnalidethe', 'aumkar.nk1', 'tejalborhade', 'gambhirepraful57', 'ashnavirdikar.av', 'kumawatmukesh71', 'tathagat34', 'shashankyadavade68']",5,"['priyankakunde22', 'pillaiabhinash11', 'iammayuri3', 'pratik.devle98', None]",19,"['vaibhavtoys', 'sourabhkothari16', 'swapnalidethe', 'aumkar.nk1', 'priyankakunde22', 'iammayuri3', 'pratik.devle98', 'tejalborhade', 'tathagat34', None, 'slimshady', 'nehagurale10', 'kedar.kulkarni12', 'pillaiabhinash11', 'gambhirepraful57', 'ashnavirdikar.av', 'kumawatmukesh71', 'shashankyadavade68', 'mohini.bhangale5']"
50,210,14,71,13,"['shraddha.jj', 'dhaval.vs', 'het.manek', 'vikram.sagar', 'mansi.gori', 'acadithya.m', 'gayatri.gandhi', 'jitun', 'adithya.n', 'kunj.haria', 'nainil.m', 'nishit.pabari', 'meetparadia']",0,[],58,"['vijen.g', 's.balsaraf73', 'rajat.p', 'gaurav24', 'ankita.thikekar09', 'siddhesh0607', 'yjb', 'sanjana.dhulla', 'chauhanajay4u', 'parthkataria999', 'sachin.sc', 'dvb', 'navneet.d', 'ankita.nd', 'pratyaksh.i', 'jinali.d', 'nitin.lalwani', 'soham.sk', 'anuj.cm', 'yash.shah9', 'chirayu.m', 'arya.ambardekar', 'd.kotecha', 'harshal.bhole', 'yash.gulve', 'vidhi.satra', 'ssoneria7', 'vignesh.j', 'akash.mehta', 'harshada.benke', 'viral.mamaniya', 'nishad.joshi', 'saumya.kamde', 's.vohra', 'inderjitsingh', 'mayuresh.auti', 'raghunath.gangi', 'hitendra.k', 'doobvoob', 'parth.nj', 'arati.mule2900', 'fatima.h', 'nayan_nanohub', 'j.kariya', 's.ambardekar', 'srinidhi.g', 'jainam.bj', 'shubhada.shetti', None, 'urva.d', 'karan.chhadawa', 'dishasaraiya', 'shah.jm', 'anilguruprasad', 'bhumika.kava', 'omkar.karande', 'mehanshi.p', 'taral.mehta']",71,"['dhaval.vs', 'vijen.g', 's.balsaraf73', 'rajat.p', 'gaurav24', 'kunj.haria', 'ankita.thikekar09', 'siddhesh0607', 'yjb', 'sanjana.dhulla', 'chauhanajay4u', 'parthkataria999', 'sachin.sc', 'nishit.pabari', 'dvb', 'navneet.d', 'ankita.nd', 'pratyaksh.i', 'jinali.d', 'nitin.lalwani', 'soham.sk', 'anuj.cm', 'yash.shah9', 'chirayu.m', 'shraddha.jj', 'arya.ambardekar', 'd.kotecha', 'harshal.bhole', 'yash.gulve', 'vidhi.satra', 'ssoneria7', 'vignesh.j', 'het.manek', 'akash.mehta', 'harshada.benke', 'viral.mamaniya', 'nishad.joshi', 'mansi.gori', 'gayatri.gandhi', 'saumya.kamde', 's.vohra', 'inderjitsingh', 'mayuresh.auti', 'raghunath.gangi', 'meetparadia', 'hitendra.k', 'doobvoob', 'parth.nj', 'jitun', 'arati.mule2900', 'fatima.h', 'nayan_nanohub', 'j.kariya', 's.ambardekar', 'srinidhi.g', 'adithya.n', 'jainam.bj', 'nainil.m', 'shubhada.shetti', None, 'urva.d', 'vikram.sagar', 'karan.chhadawa', 'dishasaraiya', 'shah.jm', 'acadithya.m', 'anilguruprasad', 'bhumika.kava', 'omkar.karande', 'mehanshi.p', 'taral.mehta']"
50,208,14,55,10,"['shraddha.jj', 'dhaval.vs', 'het.manek', 'acadithya.m', 'gayatri.gandhi', 'jitun', 'adithya.n', 'kunj.haria', 'nainil.m', 'meetparadia']",3,"['nishit.pabari', 'mansi.gori', 'vikram.sagar']",45,"['vijen.g', 'akash.mehta', 'harshada.benke', 's.balsaraf73', 'viral.mamaniya', 'nishad.joshi', 'saumya.kamde', 's.vohra', 'siddhesh0607', 'hitendra.k', 'yjb', 'doobvoob', 'parth.nj', 'sanjana.dhulla', 'chauhanajay4u', 'parthkataria999', 'sachin.sc', 'arati.mule2900', 'fatima.h', 'dvb', 'navneet.d', 'ankita.nd', 'pratyaksh.i', 'jinali.d', 'nayan_nanohub', 'soham.sk', 'j.kariya', 's.ambardekar', 'srinidhi.g', 'anuj.cm', 'shubhada.shetti', None, 'arya.ambardekar', 'd.kotecha', 'harshal.bhole', 'yash.gulve', 'urva.d', 'karan.chhadawa', 'shah.jm', 'anilguruprasad', 'bhumika.kava', 'omkar.karande', 'mehanshi.p', 'anilthosar', 'vignesh.j']",58,"['dhaval.vs', 'vijen.g', 's.balsaraf73', 'kunj.haria', 'siddhesh0607', 'yjb', 'sanjana.dhulla', 'chauhanajay4u', 'parthkataria999', 'sachin.sc', 'nishit.pabari', 'dvb', 'navneet.d', 'ankita.nd', 'pratyaksh.i', 'jinali.d', 'soham.sk', 'anuj.cm', 'shraddha.jj', 'arya.ambardekar', 'd.kotecha', 'harshal.bhole', 'yash.gulve', 'vignesh.j', 'het.manek', 'akash.mehta', 'harshada.benke', 'viral.mamaniya', 'nishad.joshi', 'mansi.gori', 'gayatri.gandhi', 'saumya.kamde', 's.vohra', 'meetparadia', 'hitendra.k', 'doobvoob', 'parth.nj', 'jitun', 'arati.mule2900', 'fatima.h', 'nayan_nanohub', 'j.kariya', 's.ambardekar', 'srinidhi.g', 'adithya.n', 'nainil.m', 'shubhada.shetti', None, 'urva.d', 'vikram.sagar', 'karan.chhadawa', 'shah.jm', 'acadithya.m', 'anilguruprasad', 'bhumika.kava', 'omkar.karande', 'mehanshi.p', 'anilthosar']"
50,364,14,46,9,"['shraddha.jj', 'dhaval.vs', 'het.manek', 'acadithya.m', 'gayatri.gandhi', 'jitun', 'adithya.n', 'nainil.m', 'meetparadia']",4,"['kunj.haria', 'nishit.pabari', 'mansi.gori', 'vikram.sagar']",37,"['h.vyas', 'akash.mehta', 'viral.mamaniya', 'adwait', 'rushabhoswal1997', 'anuradhaverma', 'sunitha.r', 'hitendra.k', 'parva.shah', 'doobvoob', 'maitrishah', 'parth.nj', 'shreela.nair14', 'leena.kesarkar', 'anshul.mehta', 'navneet.d', 'manan.raval', 'patel.ss', 'khanjankundalia', 'pratyaksh.i', 'nayan_nanohub', 'devashish123', 'rachanad', 'smit08', 's.ambardekar', 'srinidhi.g', None, 'sagarika.b', 'd.kotecha', 'karan.chhadawa', 'karan.harjai', 'ayesha.sayyad', 'nikhita.r', 'ojas.pethe', 'pritesh.surana', 'bhumika.kava', 'vignesh.j']",50,"['h.vyas', 'dhaval.vs', 'het.manek', 'akash.mehta', 'viral.mamaniya', 'mansi.gori', 'gayatri.gandhi', 'kunj.haria', 'adwait', 'rushabhoswal1997', 'anuradhaverma', 'sunitha.r', 'meetparadia', 'hitendra.k', 'parva.shah', 'doobvoob', 'maitrishah', 'parth.nj', 'jitun', 'shreela.nair14', 'leena.kesarkar', 'anshul.mehta', 'nishit.pabari', 'patel.ss', 'manan.raval', 'navneet.d', 'khanjankundalia', 'pratyaksh.i', 'nayan_nanohub', 'devashish123', 'rachanad', 'smit08', 's.ambardekar', 'srinidhi.g', 'adithya.n', 'nainil.m', None, 'shraddha.jj', 'sagarika.b', 'd.kotecha', 'vikram.sagar', 'karan.chhadawa', 'karan.harjai', 'ayesha.sayyad', 'acadithya.m', 'nikhita.r', 'ojas.pethe', 'pritesh.surana', 'bhumika.kava', 'vignesh.j']"
50,365,14,22,4,"['gayatri.gandhi', 'nishit.pabari', 'mansi.gori', 'vikram.sagar']",9,"['shraddha.jj', 'dhaval.vs', 'het.manek', 'acadithya.m', 'jitun', 'adithya.n', 'kunj.haria', 'nainil.m', 'meetparadia']",18,"['chirayu.m', 'akash.mehta', 'pratyaksh.i', 'd.kotecha', 'rhea.gupta', 'karan.chhadawa', 'harsh.patel3', 'viral.mamaniya', 'taral.mehta', 'sunitha.r', 'nikita.virkud', 'jainam.bj', 'srinidhi.g', 'ankita.thikekar09', 'vignesh.j', None, 'jeet.khunt', 'hitendra.k']",31,"['dhaval.vs', 'het.manek', 'akash.mehta', 'viral.mamaniya', 'mansi.gori', 'gayatri.gandhi', 'kunj.haria', 'ankita.thikekar09', 'jeet.khunt', 'meetparadia', 'sunitha.r', 'hitendra.k', 'harsh.patel3', 'nikita.virkud', 'jitun', 'nishit.pabari', 'pratyaksh.i', 'rhea.gupta', 'srinidhi.g', 'adithya.n', 'jainam.bj', 'nainil.m', None, 'chirayu.m', 'shraddha.jj', 'd.kotecha', 'vikram.sagar', 'karan.chhadawa', 'acadithya.m', 'vignesh.j', 'taral.mehta']"
50,366,14,6,1,['kunj.haria'],12,"['shraddha.jj', 'dhaval.vs', 'het.manek', 'vikram.sagar', 'mansi.gori', 'acadithya.m', 'gayatri.gandhi', 'jitun', 'adithya.n', 'nainil.m', 'nishit.pabari', 'meetparadia']",5,"['anilguruprasad04', 'suyash.joshi', 'vishrut.d', 'sid0607', None]",18,"['dhaval.vs', 'het.manek', 'mansi.gori', 'anilguruprasad04', 'gayatri.gandhi', 'adithya.n', 'kunj.haria', 'vishrut.d', 'nainil.m', 'sid0607', None, 'meetparadia', 'shraddha.jj', 'vikram.sagar', 'acadithya.m', 'jitun', 'suyash.joshi', 'nishit.pabari']"
51,164,14,33,7,"['kaushik11', 'imtiazshaik18', 'sasi.kiran.16ece', 'ramdhungana1999', 'meghna.goel.16ece', 'gupta.bhavishya1998', 'poojitha.bathini.16ece']",6,"['charan_92799', 'bshara.meme123456789', 'pranav.ss', 'nikita.us', 'rahul.ys', 'siddhesh.y']",26,"['raghavendra.sinha.16ece', 'pooja.madireddy.16ece', 'konkimallasumanth', 'karthikpinnelli5', 'ashish.sharma.16ece', 'sakethsolasa1999', 'snehyajnik77777', 'vvardhan660', 'abhinavsingh10', 'srikarkodavati99', 'warlock', 'bharath_varma', 'kshitizomar', 'kakkiralapavankumar', 'msaibhavani99', 'kaushikyerukonda', 'praneethmutta', 'sinha.raghav199801', None, 'sashank.1999', 'manyam.soumith.16cse', 'ande.varun.16ece', 'twinklegoel138', 'ram.dhungana.16ece', 'himanshi', 'sai.99madhav']",39,"['raghavendra.sinha.16ece', 'pooja.madireddy.16ece', 'bshara.meme123456789', 'konkimallasumanth', 'karthikpinnelli5', 'pranav.ss', 'ashish.sharma.16ece', 'nikita.us', 'sakethsolasa1999', 'snehyajnik77777', 'siddhesh.y', 'vvardhan660', 'charan_92799', 'abhinavsingh10', 'imtiazshaik18', 'srikarkodavati99', 'warlock', 'rahul.ys', 'bharath_varma', 'kshitizomar', 'kakkiralapavankumar', 'sasi.kiran.16ece', 'msaibhavani99', 'kaushikyerukonda', 'praneethmutta', 'ramdhungana1999', 'meghna.goel.16ece', 'sinha.raghav199801', None, 'sashank.1999', 'kaushik11', 'manyam.soumith.16cse', 'ande.varun.16ece', 'twinklegoel138', 'ram.dhungana.16ece', 'himanshi', 'gupta.bhavishya1998', 'sai.99madhav', 'poojitha.bathini.16ece']"
51,165,14,13,3,"['rahul.ys', 'nikita.us', 'siddhesh.y']",10,"['kaushik11', 'charan_92799', 'imtiazshaik18', 'bshara.meme123456789', 'sasi.kiran.16ece', 'pranav.ss', 'ramdhungana1999', 'meghna.goel.16ece', 'gupta.bhavishya1998', 'poojitha.bathini.16ece']",10,"['pratham123', 'smita.n', 'gaurav.dangat', 'jagruti.patil', 'urvi.panchal', 'anjana.bhave', 'jayesh.a', 'nikitamittal97', None, 'vatsal23']",23,"['gaurav.dangat', 'urvi.panchal', 'sasi.kiran.16ece', 'bshara.meme123456789', 'pranav.ss', 'anjana.bhave', 'nikita.us', 'ramdhungana1999', 'meghna.goel.16ece', 'siddhesh.y', None, 'kaushik11', 'pratham123', 'gupta.bhavishya1998', 'smita.n', 'charan_92799', 'jagruti.patil', 'imtiazshaik18', 'jayesh.a', 'nikitamittal97', 'rahul.ys', 'vatsal23', 'poojitha.bathini.16ece']"
51,163,14,9,2,"['pranav.ss', 'nikita.us']",11,"['kaushik11', 'gupta.bhavishya1998', 'charan_92799', 'imtiazshaik18', 'sasi.kiran.16ece', 'bshara.meme123456789', 'ramdhungana1999', 'meghna.goel.16ece', 'rahul.ys', 'siddhesh.y', 'poojitha.bathini.16ece']",7,"['pratham123', 'gaurav.dangat', 'niraj.parte', 'anjana.bhave', 'nikitamittal97', None, 'raj.velani']",20,"['gaurav.dangat', 'sasi.kiran.16ece', 'bshara.meme123456789', 'pranav.ss', 'anjana.bhave', 'nikita.us', 'ramdhungana1999', 'meghna.goel.16ece', 'siddhesh.y', None, 'raj.velani', 'kaushik11', 'pratham123', 'gupta.bhavishya1998', 'charan_92799', 'niraj.parte', 'imtiazshaik18', 'nikitamittal97', 'rahul.ys', 'poojitha.bathini.16ece']"
52,433,14,64,12,"['donlin2', 'wmuckia2', 'vthana2', 'dmntpls2', 'mgosma2', 'hawken2', 'ali41', 'junqima2', 'jlozier2', 'kevinu2', 'signalsca', 'mzalews2']",1,['wypark2'],52,"['trprice2', 'jdlambe2', 'pjha6', 'fortelk2', 'kaconra2', 'ttran82', 'cdnorth2', 'goedelm2', 'claramu2', 'mwallen3', 'awad4', 'uhrich2', 'ejwahl2', 'cmackh2', 'mprogal2', 'cwjanse2', 'jrshapi2', 'klee146', 'ivanf2', 'vjain13', 'sun87', 'dbala2', 'xliu147', 'parafin2', 'baning2', 'hsankar2', 'dwharmo2', 'dspoole2', 'kpcourt2', 'jpanell2', 'jfy2', 'gzak2', 'rbwhite2', 'dpetrou2', 'shao22', 'gpopovi2', 'anthonymorales15', None, 'malmsbu2', 'gonzalo11', 'sathvik2', 'tkimmle2', 'djpeter3', 'pakelts2', 'tanmaykanth', 'mhnolton', 'asengup3', 'bpepper2', 'viwilso2', 'dongyun2', 'kulkwsk2', 'ayanoh2']",65,"['trprice2', 'ali41', 'jdlambe2', 'junqima2', 'pjha6', 'fortelk2', 'kaconra2', 'ttran82', 'cdnorth2', 'signalsca', 'mzalews2', 'goedelm2', 'claramu2', 'hawken2', 'mwallen3', 'awad4', 'uhrich2', 'ejwahl2', 'cmackh2', 'mprogal2', 'vthana2', 'cwjanse2', 'jrshapi2', 'klee146', 'ivanf2', 'vjain13', 'sun87', 'dbala2', 'xliu147', 'parafin2', 'wypark2', 'baning2', 'hsankar2', 'dwharmo2', 'dspoole2', 'kpcourt2', 'jpanell2', 'jlozier2', 'jfy2', 'gzak2', 'rbwhite2', 'wmuckia2', 'dpetrou2', 'shao22', 'gpopovi2', 'anthonymorales15', None, 'malmsbu2', 'gonzalo11', 'donlin2', 'sathvik2', 'tkimmle2', 'djpeter3', 'dmntpls2', 'mgosma2', 'kevinu2', 'pakelts2', 'tanmaykanth', 'mhnolton', 'asengup3', 'bpepper2', 'viwilso2', 'dongyun2', 'kulkwsk2', 'ayanoh2']"
52,171,14,62,12,"['donlin2', 'wmuckia2', 'vthana2', 'dmntpls2', 'mgosma2', 'hawken2', 'ali41', 'junqima2', 'jlozier2', 'kevinu2', 'signalsca', 'mzalews2']",1,['wypark2'],50,"['klee146', 'ivanf2', 'vjain13', 'sun87', 'trprice2', 'jdlambe2', 'dbala2', 'xliu147', 'pjha6', 'parafin2', 'fortelk2', 'baning2', 'kaconra2', 'hsankar2', 'dwharmo2', 'dspoole2', 'jpanell2', 'ttran82', 'cdnorth2', 'jfy2', 'gzak2', 'rbwhite2', 'dpetrou2', 'shao22', 'goedelm2', 'claramu2', 'gpopovi2', 'mwallen3', 'awad4', 'uhrich2', 'anthonymorales15', 'ejwahl2', 'cmackh2', None, 'malmsbu2', 'gonzalo11', 'mprogal2', 'sathvik2', 'tkimmle2', 'djpeter3', 'cwjanse2', 'pakelts2', 'tanmaykanth', 'mhnolton', 'asengup3', 'bpepper2', 'viwilso2', 'dongyun2', 'kulkwsk2', 'ayanoh2']",63,"['trprice2', 'ali41', 'jdlambe2', 'junqima2', 'pjha6', 'fortelk2', 'kaconra2', 'ttran82', 'cdnorth2', 'signalsca', 'mzalews2', 'goedelm2', 'claramu2', 'hawken2', 'mwallen3', 'awad4', 'uhrich2', 'ejwahl2', 'cmackh2', 'mprogal2', 'vthana2', 'cwjanse2', 'klee146', 'ivanf2', 'vjain13', 'sun87', 'dbala2', 'xliu147', 'parafin2', 'wypark2', 'baning2', 'hsankar2', 'dwharmo2', 'dspoole2', 'jpanell2', 'jlozier2', 'jfy2', 'gzak2', 'rbwhite2', 'wmuckia2', 'dpetrou2', 'shao22', 'gpopovi2', 'anthonymorales15', None, 'malmsbu2', 'gonzalo11', 'donlin2', 'sathvik2', 'tkimmle2', 'djpeter3', 'dmntpls2', 'mgosma2', 'kevinu2', 'pakelts2', 'tanmaykanth', 'mhnolton', 'asengup3', 'bpepper2', 'viwilso2', 'dongyun2', 'kulkwsk2', 'ayanoh2']"
52,172,14,13,10,"['donlin2', 'vthana2', 'dmntpls2', 'ali41', 'mgosma2', 'hawken2', 'junqima2', 'jlozier2', 'kevinu2', 'signalsca']",3,"['wmuckia2', 'wypark2', 'mzalews2']",3,"[None, 'kpcourt2', 'jrshapi2']",16,"['wmuckia2', 'ali41', 'hawken2', 'junqima2', None, 'wypark2', 'donlin2', 'kpcourt2', 'vthana2', 'dmntpls2', 'mgosma2', 'jlozier2', 'kevinu2', 'signalsca', 'jrshapi2', 'mzalews2']"
52,432,14,6,1,['vthana2'],12,"['donlin2', 'wmuckia2', 'dmntpls2', 'mgosma2', 'hawken2', 'ali41', 'junqima2', 'jlozier2', 'kevinu2', 'signalsca', 'mzalews2', 'wypark2']",5,"['hchen126', 'cwjanse2', 'gpopovi2', None, 'ayanoh2']",18,"['wmuckia2', 'hchen126', 'ali41', 'hawken2', 'junqima2', 'gpopovi2', None, 'wypark2', 'donlin2', 'vthana2', 'cwjanse2', 'dmntpls2', 'mgosma2', 'jlozier2', 'kevinu2', 'signalsca', 'mzalews2', 'ayanoh2']"
53,313,14,12,11,"['tsmi3692', 'stillgoon123', 'a.hertel9011', 'sole', 'denise.puglinha', 'frederiknathan', 'mariacamilagelvez', 'bk_zh', 'sadhuna.khan', 'ccakarolotw', 'annabirkhellenes']",2,"['abhaybhu', 'marand2108']",1,[None],14,"['tsmi3692', 'stillgoon123', 'sole', 'bk_zh', 'sadhuna.khan', None, 'annabirkhellenes', 'marand2108', 'a.hertel9011', 'frederiknathan', 'denise.puglinha', 'abhaybhu', 'mariacamilagelvez', 'ccakarolotw']"
54,327,14,22,1,['fatiheren'],12,"['darylyjw', 'koosha', 'mahnoor', 'cccharleschan', 'bdeems94', 'joeyyurg', 'akim4', 'sirrolfe', 'wuyujia6', 'datnguyen', 'ryankwon88', 'uniment']",21,"['eaydinaydin40364036', 'erhanfishermen', 'ugurbayraktr', 'burakbekar', 'uguryildiz', 'hasanhasan', 'tlg.phlvn1296', 'parabellum252', 'cutku40', None, 'ecehannn', 'berfin1995', 'alperarsslan', 'gunesfaruk', 'tknmzmhmt', 'yusalpa', 'eray1234', 'gokturkkeskin08', 'ugurcandemir96', 'hasantemelort', 'hakanpinarkara']",34,"['koosha', 'eaydinaydin40364036', 'erhanfishermen', 'ugurbayraktr', 'wuyujia6', 'darylyjw', 'burakbekar', 'cccharleschan', 'uguryildiz', 'joeyyurg', 'akim4', 'hasanhasan', 'fatiheren', 'tlg.phlvn1296', 'parabellum252', 'bdeems94', 'cutku40', None, 'ryankwon88', 'uniment', 'ecehannn', 'mahnoor', 'berfin1995', 'alperarsslan', 'gunesfaruk', 'tknmzmhmt', 'yusalpa', 'eray1234', 'sirrolfe', 'gokturkkeskin08', 'ugurcandemir96', 'hasantemelort', 'hakanpinarkara', 'datnguyen']"
54,155,14,12,10,"['darylyjw', 'koosha', 'cccharleschan', 'bdeems94', 'joeyyurg', 'akim4', 'sirrolfe', 'wuyujia6', 'ryankwon88', 'uniment']",3,"['fatiheren', 'mahnoor', 'datnguyen']",2,"[None, 'siavashkan']",15,"['koosha', 'bdeems94', 'siavashkan', 'wuyujia6', None, 'ryankwon88', 'uniment', 'darylyjw', 'mahnoor', 'cccharleschan', 'joeyyurg', 'akim4', 'sirrolfe', 'fatiheren', 'datnguyen']"
54,330,14,11,1,['fatiheren'],12,"['darylyjw', 'koosha', 'mahnoor', 'cccharleschan', 'bdeems94', 'joeyyurg', 'akim4', 'sirrolfe', 'wuyujia6', 'datnguyen', 'ryankwon88', 'uniment']",10,"['ozcntpl', 'jhonyfth', 'tknmzmhmt', 'animusvox', 'omer_faruk418', 'nurres41', 'sezer1616', 'zavarnik', None, 'harun_97_97']",23,"['koosha', 'bdeems94', 'animusvox', 'nurres41', 'sezer1616', 'zavarnik', 'wuyujia6', None, 'harun_97_97', 'ryankwon88', 'uniment', 'darylyjw', 'ozcntpl', 'mahnoor', 'cccharleschan', 'jhonyfth', 'joeyyurg', 'akim4', 'tknmzmhmt', 'omer_faruk418', 'sirrolfe', 'fatiheren', 'datnguyen']"
54,332,14,11,10,"['darylyjw', 'koosha', 'cccharleschan', 'bdeems94', 'joeyyurg', 'akim4', 'sirrolfe', 'wuyujia6', 'ryankwon88', 'uniment']",3,"['fatiheren', 'mahnoor', 'datnguyen']",1,[None],14,"['koosha', 'bdeems94', 'wuyujia6', None, 'ryankwon88', 'uniment', 'darylyjw', 'mahnoor', 'cccharleschan', 'joeyyurg', 'akim4', 'sirrolfe', 'fatiheren', 'datnguyen']"
54,335,14,9,8,"['darylyjw', 'cccharleschan', 'joeyyurg', 'akim4', 'sirrolfe', 'wuyujia6', 'ryankwon88', 'uniment']",5,"['koosha', 'mahnoor', 'bdeems94', 'fatiheren', 'datnguyen']",1,[None],14,"['koosha', 'bdeems94', 'wuyujia6', None, 'ryankwon88', 'uniment', 'darylyjw', 'mahnoor', 'cccharleschan', 'joeyyurg', 'akim4', 'sirrolfe', 'fatiheren', 'datnguyen']"
55,399,14,12,9,"['dmitriiracheev', 'waldmonk', 'jacktheruler', 'felixklein', 'p1ux271', 'prada', 'kaiweitaipeh', 'silvio_ac', 'marie1993']",4,"['sorenhecht', 'dpropst', 'evain', 'mclawso2']",3,"[None, 'sfedders', 'yu.zhang']",16,"['jacktheruler', 'evain', 'felixklein', 'mclawso2', 'kaiweitaipeh', None, 'dmitriiracheev', 'dpropst', 'sfedders', 'waldmonk', 'sorenhecht', 'p1ux271', 'prada', 'yu.zhang', 'silvio_ac', 'marie1993']"
56,216,14,57,3,"['deniz.simsek', 'eceodev', 'suman.bajgain']",10,"['nalineeshchahal', 'u0', 'philipp.waelchli', 'liqiang', 'shuvo.sakib', 'mjdoyel', 'ma7nq', 'myoldonewasaskinme', 'satendra.gautam48', 'pramd.k145']",54,"['karanv667', 'nnovitsky', 'joanne.zheng', 'marystuartelder', 'ammiexia', 'siyuan_chen', 'idkwain', 'xiangjin', 'justinhavas', 'ian_hanus', 'jierong1220', 'yousuf.rehman7', 'allencao', 'srabinowitz', 'joeyliang99', 'zoey1998', 'kerrycastor', 'fooiey', 'jmb186', 'gmak6464', 'lindamanyenga', 'cjingram2020', 'ben_jackson341', 'casiomichael', 'matthew.harris.1998', 'aricarri', 'rishdafish97', 'luciamees2016', 'ramilmsh', 'elamorhan', 'jacarde4', 'gkw12345', 'aarondfranklin', 'knice', 'joanna.li', 'jar121', 'bluedevil729', None, 'ltruitt5', 'nev', 'malhotra.divyesha', 'hannahwilen', 'davidmiron80', 'trevor.stevenson', 'alicettdai', 'cooper.lair', 'jswubbenhorst', 'nguyen.andy.le', 'chaofan.tao', 'bgolbin', 'iwillforgetthisname', 'annadiemel', 'anshudwibhashi', 'qinwen.deng168367']",67,"['joanne.zheng', 'marystuartelder', 'siyuan_chen', 'idkwain', 'xiangjin', 'ian_hanus', 'pramd.k145', 'shuvo.sakib', 'kerrycastor', 'fooiey', 'gmak6464', 'lindamanyenga', 'casiomichael', 'matthew.harris.1998', 'rishdafish97', 'luciamees2016', 'liqiang', 'jacarde4', 'gkw12345', 'aarondfranklin', 'joanna.li', 'jar121', 'ltruitt5', 'nev', 'alicettdai', 'cooper.lair', 'jswubbenhorst', 'bgolbin', 'iwillforgetthisname', 'annadiemel', 'qinwen.deng168367', 'nalineeshchahal', 'u0', 'karanv667', 'nnovitsky', 'ammiexia', 'deniz.simsek', 'ma7nq', 'suman.bajgain', 'justinhavas', 'jierong1220', 'yousuf.rehman7', 'allencao', 'srabinowitz', 'joeyliang99', 'zoey1998', 'jmb186', 'cjingram2020', 'ben_jackson341', 'aricarri', 'ramilmsh', 'elamorhan', 'philipp.waelchli', 'mjdoyel', 'knice', 'bluedevil729', None, 'malhotra.divyesha', 'hannahwilen', 'davidmiron80', 'trevor.stevenson', 'nguyen.andy.le', 'chaofan.tao', 'myoldonewasaskinme', 'anshudwibhashi', 'satendra.gautam48', 'eceodev']"
57,10,14,18,1,['kgaddipa'],12,"['sureshbs', 'swati.kumari', 'oren.menachem1', 'manojkumar.pydimarri', 'shyamrishi.kashyap', 'the.owais30', 'g.saikiran', 'ee16s063', 'aparna.rne', 'mahathi.ganimisetti', 'vs.phanindra', 'garuda.pranathi']",17,"['auxedyn', 'ibassi1', 'hmeena', 'chenyang821', 'jzhou129', 'sgnanave', 'jnuernbe7728', 'aawarrie', 'skallam666', 'cdhan', 'pbaikadi96', 'zirshovon', 'arajan10', 'bclenzen', 'trietho', None, 'vasileska']",30,"['sureshbs', 'oren.menachem1', 'the.owais30', 'jzhou129', 'sgnanave', 'pbaikadi96', 'kgaddipa', 'g.saikiran', 'bclenzen', 'vs.phanindra', None, 'auxedyn', 'ibassi1', 'manojkumar.pydimarri', 'swati.kumari', 'hmeena', 'shyamrishi.kashyap', 'chenyang821', 'arajan10', 'jnuernbe7728', 'aawarrie', 'skallam666', 'cdhan', 'zirshovon', 'ee16s063', 'aparna.rne', 'mahathi.ganimisetti', 'trietho', 'vasileska', 'garuda.pranathi']"
57,11,14,16,1,['aparna.rne'],12,"['sureshbs', 'swati.kumari', 'oren.menachem1', 'manojkumar.pydimarri', 'shyamrishi.kashyap', 'the.owais30', 'kgaddipa', 'ee16s063', 'g.saikiran', 'mahathi.ganimisetti', 'vs.phanindra', 'garuda.pranathi']",15,"['rahulrokade220', 'sanathtalekar98', 'pardhi34', 'kalpeshdhole', 'urja.29', 'ritz99887', 'pranavphansekar99', 'ashkura19', 'purnimaasalve', 'komalmore48', 'avantivartak256', 'aniketlambture50', None, 'yadav.vaishnavi042', 'indranujgangan97']",28,"['sureshbs', 'oren.menachem1', 'the.owais30', 'kalpeshdhole', 'ritz99887', 'pranavphansekar99', 'avantivartak256', 'aniketlambture50', 'kgaddipa', 'g.saikiran', 'vs.phanindra', None, 'yadav.vaishnavi042', 'indranujgangan97', 'rahulrokade220', 'sanathtalekar98', 'pardhi34', 'manojkumar.pydimarri', 'swati.kumari', 'urja.29', 'shyamrishi.kashyap', 'ashkura19', 'purnimaasalve', 'komalmore48', 'ee16s063', 'aparna.rne', 'mahathi.ganimisetti', 'garuda.pranathi']"
57,13,14,15,7,"['swati.kumari', 'manojkumar.pydimarri', 'shyamrishi.kashyap', 'g.saikiran', 'mahathi.ganimisetti', 'vs.phanindra', 'garuda.pranathi']",6,"['sureshbs', 'the.owais30', 'oren.menachem1', 'kgaddipa', 'ee16s063', 'aparna.rne']",8,"['durgapavankumar', 'ashi1999', 'saiprasad_cv', 'vinitsaini', 'abhijith1125', 'hanu.saisudhir', None, 'rohit_peesa']",21,"['sureshbs', 'durgapavankumar', 'oren.menachem1', 'the.owais30', 'ashi1999', 'saiprasad_cv', 'vinitsaini', 'kgaddipa', 'abhijith1125', 'g.saikiran', 'vs.phanindra', None, 'manojkumar.pydimarri', 'swati.kumari', 'shyamrishi.kashyap', 'ee16s063', 'aparna.rne', 'mahathi.ganimisetti', 'hanu.saisudhir', 'rohit_peesa', 'garuda.pranathi']"
57,14,14,9,1,['kgaddipa'],12,"['sureshbs', 'swati.kumari', 'oren.menachem1', 'manojkumar.pydimarri', 'shyamrishi.kashyap', 'the.owais30', 'g.saikiran', 'ee16s063', 'aparna.rne', 'mahathi.ganimisetti', 'vs.phanindra', 'garuda.pranathi']",8,"['vchand33', 'ibassi1', 'sean.babcock', 'aawarrie', 'cdhan', 'jnuernbe', 'arajan10', None]",21,"['sureshbs', 'oren.menachem1', 'the.owais30', 'sean.babcock', 'kgaddipa', 'g.saikiran', 'vs.phanindra', None, 'vchand33', 'ibassi1', 'manojkumar.pydimarri', 'swati.kumari', 'shyamrishi.kashyap', 'arajan10', 'aawarrie', 'cdhan', 'jnuernbe', 'ee16s063', 'aparna.rne', 'mahathi.ganimisetti', 'garuda.pranathi']"
58,357,13,11,1,['rachana.dandekar'],11,"['raihanabila1807', 'tomyreynaldi', 'egysimbolon', 'yosianariadonna81', 'deazindra25', 'rodzan.iskandar16', 'adityadamarjati.adj', 'smadhuso', 'mohamadfaizulfikri', 'bayudimas', 'nanaxaxa99shafly']",10,"['ej2013.ankit.panvalkar', 'ragini.g', 'swathi_nair', 'paras.mehta', 'aynaiksatam', '2015nitish.nayak', '2015vishal.kasat', 'anuradhaverma', None, 'mulearati290']",22,"['ej2013.ankit.panvalkar', 'raihanabila1807', '2015vishal.kasat', 'tomyreynaldi', 'deazindra25', 'smadhuso', 'swathi_nair', 'aynaiksatam', 'mohamadfaizulfikri', 'anuradhaverma', None, 'ragini.g', 'rachana.dandekar', 'egysimbolon', 'yosianariadonna81', 'rodzan.iskandar16', 'adityadamarjati.adj', 'paras.mehta', '2015nitish.nayak', 'bayudimas', 'nanaxaxa99shafly', 'mulearati290']"
58,359,13,9,8,"['raihanabila1807', 'tomyreynaldi', 'egysimbolon', 'yosianariadonna81', 'adityadamarjati.adj', 'mohamadfaizulfikri', 'bayudimas', 'nanaxaxa99shafly']",4,"['rodzan.iskandar16', 'deazindra25', 'smadhuso', 'rachana.dandekar']",1,[None],13,"['raihanabila1807', 'tomyreynaldi', 'deazindra25', 'smadhuso', 'mohamadfaizulfikri', None, 'rachana.dandekar', 'egysimbolon', 'yosianariadonna81', 'rodzan.iskandar16', 'adityadamarjati.adj', 'bayudimas', 'nanaxaxa99shafly']"
59,264,13,52,11,"['mayurmore', 'chinmay_kudtarkar', 'akibmujawar13', 'nikneswankar16', 'saurabh.bahad13', 'as691177', 'manedeven09', 'pavanborde910', 'ashwinkadam1996', 'akankshagunjal99722', 'anujmdeorukhkar']",1,['ankit_dxt'],41,"['sonalikharade5', 'pratikkul26', 'ashu0497', 'sohammhas', 'sarvesh.mohite97', 'dushy98', 'hsnnalwala7', 'sanjit', 'rohit.elawadekar333', 'tejeshwarvaidya', 'suffiyanshaikh92', 'bendalneha', 'tanmaykkudalkar', 'sahilsankhe2023', 'kajaldevake30', 'sunilkavatkar', 'vanaja2812', 'durgeshthorat4', 'thosarebhavesh', 'rushikeshrane27', 'kavi1388', 'pranjalijadhav0911', 'shubhambhosale', 'amey123', 'neil.dani9', 'preeti.kharas', 'aloksardesai97', 'prathamesh.shivmare1', 'kiranpanchal', 'pandeymikhil', 'prajaktathorat24', 'prashant20297', 'zainabshah181997', 'ankitagamare2218', None, 'rugvedikesare427', 'alpha_32123', 'snehald827', 'sukanyajadhav1997', 'komalbangar54', 'arpitgodbole7']",53,"['chinmay_kudtarkar', 'ashu0497', 'ankit_dxt', 'sohammhas', 'sarvesh.mohite97', 'dushy98', 'hsnnalwala7', 'rohit.elawadekar333', 'tejeshwarvaidya', 'suffiyanshaikh92', 'tanmaykkudalkar', 'nikneswankar16', 'sahilsankhe2023', 'as691177', 'durgeshthorat4', 'kavi1388', 'pranjalijadhav0911', 'amey123', 'preeti.kharas', 'saurabh.bahad13', 'ashwinkadam1996', 'pandeymikhil', 'akankshagunjal99722', 'prajaktathorat24', 'ankitagamare2218', 'rugvedikesare427', 'alpha_32123', 'snehald827', 'sukanyajadhav1997', 'komalbangar54', 'arpitgodbole7', 'sonalikharade5', 'pratikkul26', 'pavanborde910', 'sanjit', 'bendalneha', 'vanaja2812', 'kajaldevake30', 'sunilkavatkar', 'thosarebhavesh', 'rushikeshrane27', 'shubhambhosale', 'akibmujawar13', 'neil.dani9', 'aloksardesai97', 'prathamesh.shivmare1', 'kiranpanchal', 'zainabshah181997', 'anujmdeorukhkar', 'prashant20297', None, 'mayurmore', 'manedeven09']"
60,56,13,142,12,"['ankita.nd', 'doobvoob', 'yash.gulve', 'nayan_nanohub', 'nitin.lalwani', 'soham.sk', 'gaurav24', 'ssoneria7', 's.vohra', 'chauhanajay4u', 'shubhada.shetti', 'mehanshi.p']",0,[],130,"['nikperu007', 'nikhilchaudhari5516', 'harshalisawant92', 'omkar.chalke96', 'rajasiar1234', 'dmce123456789', 'h.vyas', 'darshana.mehta', 'sagarthool', 'sagargujar123', 'rahul.jethwa', 'akashupadhyay', 'rishi.mistry', 'aditya27', 'manalighorpade07', 'shreyahonagekar04', 'jugal.vaja', 'kssheetal2497', 'aditya.bhabhe', 'shivam.rs', 'sakshi.bhosle', 'singhamod111', 'sachin.sc', 'sujittupe3490', 'rehan.mistry', 'mehulkharvi7', 'ranajay1997', 'pinak.p', 'bhushan0397', 'shrutik1997.mallick', 'ritesh0111', 'vidushirazdan1308', 'madhuriwawale13', 'shraddha0306', 'p_vasant', 'nehagurale10', 'vikramtirathkar96', 'kevin.z', 'aditya.prnair', 'umeshlohote', 'jainamshah409', 'jagnoor.p', 'amey.mahadik98', 'kunalk4796', 'rajaskhasgiwale8497', 'prithvianvekar21', 'shubham.yelange', 'aladvait', 'arat.gouda', 'pranay.sadavarte', 'tejaskinage', 'k.siddhapura', 'vivek4238', 'jayshree90', 'apurvamirke29', 'kacharerohan', 'rutuja.mehta', 'arpanmodi2014', 'huzefa9702', 'adityajoy29', 'jay.km', 'shipra2', 'divya.sawant17497', 'sakshi.trivedi', 'hitvena.shah', 'nikita.rp', 'zotingsagar', 'shashankyadavade68', 'yashsavle', 'akankshapatil', 'rajat.p', 'nihal.raut', 'smahamulkar1013', 'shah.ns', 'slimshady', 'dilipramgir', 'maitrishah', 'goyalvishal147', 'saurabh.palde', 'karanshah16', 'zeevd19', 'arthaya.koyande28', 'prachi04', 'thakreshivam805', 'kaustubhvaishampayan', 'pranesha08', 'kalekajal2', 'perekarnk', 's.suvarna', 'harshal.bhole', 'spawar.ap', 'shwetakanoja', 'roy.shinde77', 'pranaykaranjekar28', 'shettynitin667', 'saadrahman.a', 'd.haria', 'aashutoshkhapare22', 'darshana2504', 'swapnalidethe', 'rohithebbar10', 'aadi', 'shreyasmoolya', 'kapil1410', 'adwaitnaik2', 'shahruchi', 'chakulipatil999', 'bhangaleprit', 'dhanshreeshawale', 'anushkaw055', 'rushabhkothari12', 'yasir.mulla47', 'abbas.barwaniwala', 'harish.c', None, 'apeksha.shinde', 'ninad.mulay', 'parin.ss', 'abhay.nadkarni', 'dishasaraiya', 'pranalim11', 'saurabhgawade.777.4.sg', 'yashshetye7', 'pranali', 'nitish_mishra', 'bhushanrsonawane1998', 'ameysawant25597', 'kumawatmukesh71', 'rahulbirwadkar123', 'shettysagar35']",142,"['nikperu007', 'nikhilchaudhari5516', 'harshalisawant92', 'omkar.chalke96', 'rajasiar1234', 'dmce123456789', 'h.vyas', 'darshana.mehta', 'sagarthool', 'sagargujar123', 'rahul.jethwa', 'akashupadhyay', 'rishi.mistry', 'aditya27', 'manalighorpade07', 'shreyahonagekar04', 'jugal.vaja', 'kssheetal2497', 'aditya.bhabhe', 'shivam.rs', 'sakshi.bhosle', 'singhamod111', 'chauhanajay4u', 'sachin.sc', 'sujittupe3490', 'rehan.mistry', 'mehulkharvi7', 'ranajay1997', 'pinak.p', 'bhushan0397', 'shrutik1997.mallick', 'ritesh0111', 'vidushirazdan1308', 'madhuriwawale13', 'shraddha0306', 'p_vasant', 'nehagurale10', 'vikramtirathkar96', 'kevin.z', 'yash.gulve', 'aditya.prnair', 'umeshlohote', 'jainamshah409', 'jagnoor.p', 'amey.mahadik98', 'kunalk4796', 'rajaskhasgiwale8497', 'prithvianvekar21', 'shubham.yelange', 'aladvait', 'arat.gouda', 'pranay.sadavarte', 'doobvoob', 'tejaskinage', 'k.siddhapura', 'vivek4238', 'jayshree90', 'apurvamirke29', 'kacharerohan', 'rutuja.mehta', 'arpanmodi2014', 'huzefa9702', 'adityajoy29', 'jay.km', 'shipra2', 'shubhada.shetti', 'divya.sawant17497', 'sakshi.trivedi', 'hitvena.shah', 'nikita.rp', 'zotingsagar', 'shashankyadavade68', 'mehanshi.p', 'yashsavle', 'akankshapatil', 'rajat.p', 'gaurav24', 'nihal.raut', 'smahamulkar1013', 'rahulbirwadkar123', 'shah.ns', 'slimshady', 'dilipramgir', 'maitrishah', 'goyalvishal147', 'saurabh.palde', 'karanshah16', 'zeevd19', 'arthaya.koyande28', 'prachi04', 'thakreshivam805', 'ankita.nd', 'nitin.lalwani', 'soham.sk', 'kaustubhvaishampayan', 'pranesha08', 'kalekajal2', 'perekarnk', 's.suvarna', 'harshal.bhole', 'spawar.ap', 'shwetakanoja', 'roy.shinde77', 'pranaykaranjekar28', 'shettynitin667', 'saadrahman.a', 'ssoneria7', 'd.haria', 'aashutoshkhapare22', 'darshana2504', 'swapnalidethe', 'aadi', 's.vohra', 'shreyasmoolya', 'kapil1410', 'adwaitnaik2', 'shahruchi', 'chakulipatil999', 'bhangaleprit', 'dhanshreeshawale', 'anushkaw055', 'rushabhkothari12', 'nayan_nanohub', 'yasir.mulla47', 'abbas.barwaniwala', 'harish.c', None, 'apeksha.shinde', 'ninad.mulay', 'parin.ss', 'abhay.nadkarni', 'dishasaraiya', 'pranalim11', 'saurabhgawade.777.4.sg', 'yashshetye7', 'pranali', 'nitish_mishra', 'bhushanrsonawane1998', 'ameysawant25597', 'kumawatmukesh71', 'rohithebbar10', 'shettysagar35']"
60,210,13,71,12,"['ankita.nd', 'doobvoob', 'yash.gulve', 'nayan_nanohub', 'nitin.lalwani', 'soham.sk', 'gaurav24', 'ssoneria7', 's.vohra', 'chauhanajay4u', 'shubhada.shetti', 'mehanshi.p']",0,[],59,"['dhaval.vs', 'vijen.g', 's.balsaraf73', 'rajat.p', 'kunj.haria', 'ankita.thikekar09', 'siddhesh0607', 'yjb', 'sanjana.dhulla', 'parthkataria999', 'sachin.sc', 'dvb', 'nishit.pabari', 'navneet.d', 'pratyaksh.i', 'jinali.d', 'anuj.cm', 'yash.shah9', 'chirayu.m', 'shraddha.jj', 'arya.ambardekar', 'd.kotecha', 'harshal.bhole', 'vidhi.satra', 'vignesh.j', 'akash.mehta', 'harshada.benke', 'het.manek', 'viral.mamaniya', 'nishad.joshi', 'mansi.gori', 'gayatri.gandhi', 'saumya.kamde', 'inderjitsingh', 'mayuresh.auti', 'raghunath.gangi', 'meetparadia', 'hitendra.k', 'parth.nj', 'jitun', 'arati.mule2900', 'fatima.h', 'j.kariya', 's.ambardekar', 'srinidhi.g', 'adithya.n', 'jainam.bj', 'nainil.m', None, 'urva.d', 'vikram.sagar', 'karan.chhadawa', 'dishasaraiya', 'shah.jm', 'acadithya.m', 'anilguruprasad', 'bhumika.kava', 'omkar.karande', 'taral.mehta']",71,"['dhaval.vs', 'vijen.g', 's.balsaraf73', 'rajat.p', 'gaurav24', 'kunj.haria', 'ankita.thikekar09', 'siddhesh0607', 'yjb', 'sanjana.dhulla', 'chauhanajay4u', 'parthkataria999', 'sachin.sc', 'dvb', 'nishit.pabari', 'navneet.d', 'ankita.nd', 'pratyaksh.i', 'jinali.d', 'nitin.lalwani', 'soham.sk', 'anuj.cm', 'yash.shah9', 'chirayu.m', 'shraddha.jj', 'arya.ambardekar', 'd.kotecha', 'harshal.bhole', 'yash.gulve', 'vidhi.satra', 'ssoneria7', 'vignesh.j', 'akash.mehta', 'harshada.benke', 'het.manek', 'viral.mamaniya', 'nishad.joshi', 'mansi.gori', 'gayatri.gandhi', 'saumya.kamde', 's.vohra', 'inderjitsingh', 'mayuresh.auti', 'raghunath.gangi', 'meetparadia', 'hitendra.k', 'doobvoob', 'parth.nj', 'jitun', 'arati.mule2900', 'fatima.h', 'nayan_nanohub', 'j.kariya', 's.ambardekar', 'srinidhi.g', 'adithya.n', 'jainam.bj', 'nainil.m', 'shubhada.shetti', None, 'urva.d', 'vikram.sagar', 'karan.chhadawa', 'dishasaraiya', 'shah.jm', 'acadithya.m', 'anilguruprasad', 'bhumika.kava', 'omkar.karande', 'mehanshi.p', 'taral.mehta']"
60,208,13,55,9,"['ankita.nd', 'doobvoob', 'yash.gulve', 'nayan_nanohub', 'soham.sk', 's.vohra', 'chauhanajay4u', 'shubhada.shetti', 'mehanshi.p']",3,"['nitin.lalwani', 'ssoneria7', 'gaurav24']",46,"['dhaval.vs', 'akash.mehta', 'vijen.g', 'harshada.benke', 'het.manek', 's.balsaraf73', 'viral.mamaniya', 'nishad.joshi', 'gayatri.gandhi', 'kunj.haria', 'saumya.kamde', 'siddhesh0607', 'hitendra.k', 'meetparadia', 'yjb', 'parth.nj', 'sanjana.dhulla', 'jitun', 'parthkataria999', 'sachin.sc', 'arati.mule2900', 'fatima.h', 'dvb', 'navneet.d', 'pratyaksh.i', 'jinali.d', 'j.kariya', 's.ambardekar', 'srinidhi.g', 'adithya.n', 'anuj.cm', 'nainil.m', None, 'shraddha.jj', 'arya.ambardekar', 'd.kotecha', 'harshal.bhole', 'urva.d', 'karan.chhadawa', 'shah.jm', 'acadithya.m', 'anilguruprasad', 'bhumika.kava', 'omkar.karande', 'anilthosar', 'vignesh.j']",58,"['dhaval.vs', 'vijen.g', 's.balsaraf73', 'gaurav24', 'kunj.haria', 'siddhesh0607', 'yjb', 'sanjana.dhulla', 'chauhanajay4u', 'parthkataria999', 'sachin.sc', 'dvb', 'navneet.d', 'ankita.nd', 'pratyaksh.i', 'jinali.d', 'nitin.lalwani', 'soham.sk', 'anuj.cm', 'shraddha.jj', 'arya.ambardekar', 'd.kotecha', 'harshal.bhole', 'yash.gulve', 'ssoneria7', 'vignesh.j', 'akash.mehta', 'harshada.benke', 'het.manek', 'viral.mamaniya', 'nishad.joshi', 'gayatri.gandhi', 'saumya.kamde', 's.vohra', 'hitendra.k', 'meetparadia', 'doobvoob', 'parth.nj', 'jitun', 'arati.mule2900', 'fatima.h', 'nayan_nanohub', 'j.kariya', 's.ambardekar', 'srinidhi.g', 'adithya.n', 'nainil.m', 'shubhada.shetti', None, 'urva.d', 'karan.chhadawa', 'shah.jm', 'acadithya.m', 'anilguruprasad', 'bhumika.kava', 'omkar.karande', 'mehanshi.p', 'anilthosar']"
60,364,13,46,2,"['nayan_nanohub', 'doobvoob']",10,"['ankita.nd', 'yash.gulve', 'nitin.lalwani', 'soham.sk', 'gaurav24', 'ssoneria7', 's.vohra', 'chauhanajay4u', 'shubhada.shetti', 'mehanshi.p']",44,"['h.vyas', 'dhaval.vs', 'akash.mehta', 'het.manek', 'viral.mamaniya', 'gayatri.gandhi', 'adwait', 'rushabhoswal1997', 'anuradhaverma', 'sunitha.r', 'meetparadia', 'hitendra.k', 'parva.shah', 'maitrishah', 'parth.nj', 'jitun', 'shreela.nair14', 'leena.kesarkar', 'anshul.mehta', 'patel.ss', 'manan.raval', 'navneet.d', 'khanjankundalia', 'pratyaksh.i', 'devashish123', 'rachanad', 'smit08', 's.ambardekar', 'srinidhi.g', 'adithya.n', 'nainil.m', None, 'sagarika.b', 'shraddha.jj', 'd.kotecha', 'karan.chhadawa', 'karan.harjai', 'ayesha.sayyad', 'acadithya.m', 'nikhita.r', 'ojas.pethe', 'pritesh.surana', 'bhumika.kava', 'vignesh.j']",56,"['h.vyas', 'dhaval.vs', 'akash.mehta', 'het.manek', 'viral.mamaniya', 'gaurav24', 'gayatri.gandhi', 'adwait', 's.vohra', 'rushabhoswal1997', 'anuradhaverma', 'sunitha.r', 'hitendra.k', 'meetparadia', 'parva.shah', 'doobvoob', 'maitrishah', 'parth.nj', 'jitun', 'chauhanajay4u', 'shreela.nair14', 'leena.kesarkar', 'anshul.mehta', 'patel.ss', 'manan.raval', 'ankita.nd', 'navneet.d', 'khanjankundalia', 'pratyaksh.i', 'nayan_nanohub', 'nitin.lalwani', 'soham.sk', 'devashish123', 'rachanad', 'smit08', 's.ambardekar', 'srinidhi.g', 'adithya.n', 'nainil.m', 'shubhada.shetti', None, 'sagarika.b', 'shraddha.jj', 'd.kotecha', 'yash.gulve', 'karan.chhadawa', 'karan.harjai', 'ayesha.sayyad', 'acadithya.m', 'ssoneria7', 'nikhita.r', 'ojas.pethe', 'pritesh.surana', 'bhumika.kava', 'mehanshi.p', 'vignesh.j']"
60,363,13,27,12,"['ankita.nd', 'doobvoob', 'yash.gulve', 'nayan_nanohub', 'nitin.lalwani', 'soham.sk', 'gaurav24', 'ssoneria7', 's.vohra', 'chauhanajay4u', 'shubhada.shetti', 'mehanshi.p']",0,[],15,"['manan.raval', 'h.vyas', 'khanjankundalia', 'zubin333', 'maitrishah', 'shreela.nair14', 'rachanad', 'vatsal.bavishi', 'pritesh.surana', 'adwait', 'arat.gouda', 'shubhambalsaraf73', 'rushabhoswal1997', 'anuradhaverma', None]",27,"['h.vyas', 'gaurav24', 'adwait', 's.vohra', 'shubhambalsaraf73', 'arat.gouda', 'rushabhoswal1997', 'anuradhaverma', 'doobvoob', 'zubin333', 'maitrishah', 'chauhanajay4u', 'shreela.nair14', 'manan.raval', 'ankita.nd', 'khanjankundalia', 'nayan_nanohub', 'nitin.lalwani', 'soham.sk', 'rachanad', 'shubhada.shetti', None, 'yash.gulve', 'vatsal.bavishi', 'ssoneria7', 'pritesh.surana', 'mehanshi.p']"
60,59,13,8,1,['gaurav24'],11,"['ankita.nd', 'doobvoob', 'yash.gulve', 'nayan_nanohub', 'nitin.lalwani', 'soham.sk', 'ssoneria7', 's.vohra', 'chauhanajay4u', 'shubhada.shetti', 'mehanshi.p']",7,"['zotingsagar1', 'shwetakanoja', 'vyardly94', 'vidushirazdan1308', None, 'amey.mahadik98', 'kapil1410']",19,"['ankita.nd', 'zotingsagar1', 'nayan_nanohub', 'nitin.lalwani', 'soham.sk', 'gaurav24', 'vidushirazdan1308', 's.vohra', 'shubhada.shetti', None, 'kapil1410', 'doobvoob', 'amey.mahadik98', 'yash.gulve', 'shwetakanoja', 'vyardly94', 'ssoneria7', 'chauhanajay4u', 'mehanshi.p']"
60,60,13,7,3,"['nitin.lalwani', 'ssoneria7', 'gaurav24']",9,"['ankita.nd', 'doobvoob', 'yash.gulve', 'nayan_nanohub', 'soham.sk', 's.vohra', 'chauhanajay4u', 'shubhada.shetti', 'mehanshi.p']",4,"['rajat.p', None, 'shettyrahul97', 'mayuresh.auti']",16,"['ankita.nd', 'nayan_nanohub', 'nitin.lalwani', 'soham.sk', 'rajat.p', 'gaurav24', 's.vohra', 'mayuresh.auti', 'shubhada.shetti', None, 'doobvoob', 'shettyrahul97', 'yash.gulve', 'ssoneria7', 'chauhanajay4u', 'mehanshi.p']"
61,161,13,18,12,"['shun0502.', 'kopo5517', 'tcuaj', 'jun.o', 'fineday050gosh', 'nao', 'www.yutaro.taka', 'hiro', 'denndenn5648', 'g1615068', 'yuya_otake', 'nanohub0709']",0,[],6,"['g1615016', 'gpen9650', 'hiroki', None, 'ushio2600', 'ri21']",18,"['kopo5517', 'tcuaj', 'g1615016', 'hiro', 'gpen9650', 'denndenn5648', 'g1615068', None, 'nanohub0709', 'shun0502.', 'jun.o', 'fineday050gosh', 'nao', 'www.yutaro.taka', 'hiroki', 'yuya_otake', 'ushio2600', 'ri21']"
61,1,13,17,12,"['shun0502.', 'kopo5517', 'tcuaj', 'jun.o', 'fineday050gosh', 'nao', 'www.yutaro.taka', 'hiro', 'denndenn5648', 'g1615068', 'yuya_otake', 'nanohub0709']",0,[],5,"['yoshino', 'namiki.817.1997', 'smtk.y.giants', None, 'ushio2600']",17,"['kopo5517', 'tcuaj', 'yoshino', 'hiro', 'namiki.817.1997', 'denndenn5648', 'smtk.y.giants', 'g1615068', None, 'nanohub0709', 'shun0502.', 'jun.o', 'fineday050gosh', 'nao', 'www.yutaro.taka', 'yuya_otake', 'ushio2600']"
62,193,13,13,11,"['amorris2', 'junyany', 'xmao1', 'abcdef123456', 'uom', 'chenxip', 'gang', 'shiqin', 'runchangs', 'mtie1', 'sjawahar']",1,['zhanlinz0413'],2,"[None, 'trobertson1']",14,"['zhanlinz0413', 'xmao1', 'abcdef123456', 'uom', 'trobertson1', 'gang', 'runchangs', 'mtie1', None, 'amorris2', 'junyany', 'chenxip', 'shiqin', 'sjawahar']"
62,192,13,12,9,"['zhanlinz0413', 'xmao1', 'junyany', 'amorris2', 'abcdef123456', 'chenxip', 'runchangs', 'mtie1', 'sjawahar']",3,"['uom', 'shiqin', 'gang']",3,"['jeffliu', None, 'glyu']",15,"['zhanlinz0413', 'xmao1', 'abcdef123456', 'uom', 'gang', 'runchangs', 'mtie1', None, 'amorris2', 'junyany', 'glyu', 'chenxip', 'shiqin', 'sjawahar', 'jeffliu']"
62,194,13,11,9,"['zhanlinz0413', 'xmao1', 'junyany', 'abcdef123456', 'shiqin', 'gang', 'chenxip', 'runchangs', 'mtie1']",3,"['amorris2', 'uom', 'sjawahar']",2,"[None, 'trobertson1']",14,"['zhanlinz0413', 'xmao1', 'abcdef123456', 'uom', 'trobertson1', 'gang', 'runchangs', 'mtie1', None, 'amorris2', 'junyany', 'chenxip', 'shiqin', 'sjawahar']"
63,72,13,11,9,"['sdm9385', 'ale10016', 'th474600', 'sww4393', 'hj95y', 'dntka0767', 'ghwjd5179', 'seongjin', 'jisu9071']",3,"['saikumarsomineni1999', 'ehehrhsks', 'evanlune']",2,"['temlab', None]",14,"['sdm9385', 'hj95y', 'ghwjd5179', 'seongjin', None, 'ehehrhsks', 'jisu9071', 'temlab', 'ale10016', 'th474600', 'saikumarsomineni1999', 'sww4393', 'dntka0767', 'evanlune']"
63,70,13,10,9,"['sdm9385', 'evanlune', 'th474600', 'sww4393', 'hj95y', 'dntka0767', 'ghwjd5179', 'seongjin', 'ehehrhsks']",3,"['saikumarsomineni1999', 'ale10016', 'jisu9071']",1,[None],13,"['sdm9385', 'hj95y', 'ghwjd5179', 'seongjin', None, 'ehehrhsks', 'jisu9071', 'ale10016', 'th474600', 'saikumarsomineni1999', 'sww4393', 'dntka0767', 'evanlune']"
63,71,13,9,7,"['sdm9385', 'ale10016', 'sww4393', 'hj95y', 'dntka0767', 'seongjin', 'jisu9071']",5,"['evanlune', 'th474600', 'saikumarsomineni1999', 'ghwjd5179', 'ehehrhsks']",2,"['kiyommi', None]",14,"['sdm9385', 'hj95y', 'kiyommi', 'ghwjd5179', 'seongjin', None, 'ehehrhsks', 'jisu9071', 'ale10016', 'th474600', 'saikumarsomineni1999', 'sww4393', 'dntka0767', 'evanlune']"
63,426,13,8,1,['saikumarsomineni1999'],11,"['sdm9385', 'ale10016', 'evanlune', 'th474600', 'seongjin', 'sww4393', 'hj95y', 'dntka0767', 'ghwjd5179', 'jisu9071', 'ehehrhsks']",7,"['dinesharmi143', 'azarshaik79', 'saikumar1919sms', 'basireddymadhu455', 'sreenivassree0143', 'manjuladrp', None]",19,"['sdm9385', 'dinesharmi143', 'saikumar1919sms', 'hj95y', 'sreenivassree0143', 'manjuladrp', 'azarshaik79', 'ghwjd5179', 'seongjin', None, 'ehehrhsks', 'jisu9071', 'ale10016', 'th474600', 'saikumarsomineni1999', 'basireddymadhu455', 'sww4393', 'dntka0767', 'evanlune']"
66,364,12,46,11,"['manan.raval', 'anshul.mehta', 'khanjankundalia', 'ayesha.sayyad', 'devashish123', 'smit08', 'rachanad', 'adwait', 'shreela.nair14', 'leena.kesarkar', 'rushabhoswal1997']",0,[],35,"['h.vyas', 'dhaval.vs', 'akash.mehta', 'het.manek', 'viral.mamaniya', 'gayatri.gandhi', 'anuradhaverma', 'sunitha.r', 'meetparadia', 'hitendra.k', 'parva.shah', 'doobvoob', 'maitrishah', 'parth.nj', 'jitun', 'navneet.d', 'patel.ss', 'pratyaksh.i', 'nayan_nanohub', 's.ambardekar', 'srinidhi.g', 'adithya.n', 'nainil.m', None, 'sagarika.b', 'shraddha.jj', 'd.kotecha', 'karan.chhadawa', 'karan.harjai', 'acadithya.m', 'nikhita.r', 'ojas.pethe', 'pritesh.surana', 'bhumika.kava', 'vignesh.j']",46,"['h.vyas', 'dhaval.vs', 'akash.mehta', 'het.manek', 'viral.mamaniya', 'gayatri.gandhi', 'adwait', 'rushabhoswal1997', 'anuradhaverma', 'sunitha.r', 'hitendra.k', 'meetparadia', 'parva.shah', 'doobvoob', 'maitrishah', 'parth.nj', 'jitun', 'shreela.nair14', 'leena.kesarkar', 'anshul.mehta', 'patel.ss', 'manan.raval', 'navneet.d', 'khanjankundalia', 'pratyaksh.i', 'nayan_nanohub', 'devashish123', 'smit08', 'rachanad', 's.ambardekar', 'srinidhi.g', 'adithya.n', 'nainil.m', None, 'sagarika.b', 'shraddha.jj', 'd.kotecha', 'karan.chhadawa', 'karan.harjai', 'ayesha.sayyad', 'acadithya.m', 'nikhita.r', 'ojas.pethe', 'pritesh.surana', 'bhumika.kava', 'vignesh.j']"
66,363,12,27,6,"['manan.raval', 'khanjankundalia', 'rachanad', 'adwait', 'shreela.nair14', 'rushabhoswal1997']",5,"['ayesha.sayyad', 'devashish123', 'smit08', 'leena.kesarkar', 'anshul.mehta']",21,"['h.vyas', 'gaurav24', 's.vohra', 'shubhambalsaraf73', 'arat.gouda', 'anuradhaverma', 'doobvoob', 'zubin333', 'maitrishah', 'chauhanajay4u', 'ankita.nd', 'nayan_nanohub', 'nitin.lalwani', 'soham.sk', 'shubhada.shetti', None, 'yash.gulve', 'vatsal.bavishi', 'ssoneria7', 'pritesh.surana', 'mehanshi.p']",32,"['h.vyas', 'gaurav24', 'adwait', 's.vohra', 'shubhambalsaraf73', 'rushabhoswal1997', 'arat.gouda', 'anuradhaverma', 'doobvoob', 'zubin333', 'maitrishah', 'chauhanajay4u', 'shreela.nair14', 'leena.kesarkar', 'anshul.mehta', 'manan.raval', 'ankita.nd', 'khanjankundalia', 'nayan_nanohub', 'nitin.lalwani', 'soham.sk', 'devashish123', 'smit08', 'rachanad', None, 'shubhada.shetti', 'yash.gulve', 'ayesha.sayyad', 'vatsal.bavishi', 'ssoneria7', 'pritesh.surana', 'mehanshi.p']"
67,47,12,53,7,"['shwetatambe12', 'shubhamchury1', 'risha15', 'sameersanjaysalveashalata', 'prashantmanjre9', 'divyassonawane', 'aditi.ramadwar']",4,"['yash.mhatre', 'akansha_sampat', 'tapan.garge', 'pjkarmokar']",46,"['sonalikharade5', 'prathameshpatle13', 'pratikkul26', 'prasadbodekar1996', 'sohammhas', 'sarvesh.mohite97', 'hsnnalwala7', 'pnrasika', 'rohit.elawadekar333', 'tejeshwarvaidya', 'suffiyanshaikh92', 'siddhant8291', 'tanmaykkudalkar', 'shahraj165', 'vanaja2812', 'rishimud', 'sunilkavatkar', 'h10waghela', 'nichiteprh1995', 'rushikeshrane27', 'prasadmasurkar97', 'susmeetsukte', 'shubhambhosale', 'gabru1803', 'kaushiksawant93', 'nehakhushi1418', 'preeti.kharas', 'neil.dani9', 'sanket.r.makwana', 'shelarpranali1309', 'prathamesh.shivmare1', 'kiranpanchal', 'pandeymikhil', 'prajaktathorat24', 'ankitagamare2218', 'prashant20297', None, 'rugvedikesare427', 'alpha_32123', 'snehald827', 'arpitakudesia3011', 'akshayjambhale07', 'sukanyajadhav1997', 'komalbangar54', 'arpitgodbole7', 'pawarrajshree12']",57,"['prathameshpatle13', 'shwetatambe12', 'sohammhas', 'yash.mhatre', 'sarvesh.mohite97', 'prashantmanjre9', 'hsnnalwala7', 'pnrasika', 'rohit.elawadekar333', 'tejeshwarvaidya', 'suffiyanshaikh92', 'siddhant8291', 'tanmaykkudalkar', 'rishimud', 'prasadmasurkar97', 'preeti.kharas', 'sanket.r.makwana', 'shelarpranali1309', 'risha15', 'pjkarmokar', 'pandeymikhil', 'prajaktathorat24', 'ankitagamare2218', 'rugvedikesare427', 'alpha_32123', 'snehald827', 'arpitakudesia3011', 'sukanyajadhav1997', 'komalbangar54', 'divyassonawane', 'arpitgodbole7', 'pawarrajshree12', 'sonalikharade5', 'pratikkul26', 'shubhamchury1', 'prasadbodekar1996', 'sameersanjaysalveashalata', 'shahraj165', 'vanaja2812', 'sunilkavatkar', 'h10waghela', 'nichiteprh1995', 'rushikeshrane27', 'susmeetsukte', 'shubhambhosale', 'gabru1803', 'kaushiksawant93', 'nehakhushi1418', 'neil.dani9', 'prathamesh.shivmare1', 'kiranpanchal', 'aditi.ramadwar', 'prashant20297', None, 'akansha_sampat', 'tapan.garge', 'akshayjambhale07']"
67,46,12,34,4,"['yash.mhatre', 'akansha_sampat', 'tapan.garge', 'pjkarmokar']",7,"['shwetatambe12', 'shubhamchury1', 'risha15', 'sameersanjaysalveashalata', 'prashantmanjre9', 'divyassonawane', 'aditi.ramadwar']",30,"['soureen.g', 'gaurav.dangat', 'akshatask', 'pnrasika', 'raj.velani', 'pratham123', 'siddhant8291', 'smita.n', 'niraj.parte', 'jagruti.patil', 'hrishikesh12', 'jayesh.a', 'nikitamittal97', 'vatsal23', 'sonali.gavkar', 'preeti.kharas', 'neil.dani9', 'shelarpranali1309', 'saayuj.s', 'pawan.mojar', 'rajas.b', 'anjana.bhave', 'mayur.gosavi', None, 'kharatomkar24', 'snehald827', 'arpitakudesia3011', 'vaishnavi.soni', 'mayuri.sapkal', 'priyanka.rp']",41,"['soureen.g', 'gaurav.dangat', 'akshatask', 'shwetatambe12', 'shubhamchury1', 'sameersanjaysalveashalata', 'yash.mhatre', 'prashantmanjre9', 'pnrasika', 'raj.velani', 'pratham123', 'siddhant8291', 'smita.n', 'niraj.parte', 'jagruti.patil', 'hrishikesh12', 'jayesh.a', 'nikitamittal97', 'vatsal23', 'sonali.gavkar', 'preeti.kharas', 'neil.dani9', 'shelarpranali1309', 'risha15', 'saayuj.s', 'pjkarmokar', 'pawan.mojar', 'rajas.b', 'anjana.bhave', 'aditi.ramadwar', 'mayur.gosavi', None, 'akansha_sampat', 'tapan.garge', 'kharatomkar24', 'snehald827', 'arpitakudesia3011', 'vaishnavi.soni', 'divyassonawane', 'mayuri.sapkal', 'priyanka.rp']"
68,3,12,100,4,"['pallavie12345', 'sivasai2467', 'yaminireddy72304', 'aishwaryatheerthala2000']",7,"['madhavspai', 'thushithathushi52', 'paraglokhande108', 'spazos7', 'nirmalr251', 'jochoab', 'wyattm']",96,"['niteeshsandu143', 'harshitha.lokireddy', 'agnesangel012', 'smart.roopesh305', 'obulenaveenkumarreddy', 'umamaheshwarreddy074', 'kalyanyadavjadda', 'bharath.pbn99', 'msmadhu1442000', 'likhithachinni2000', 'nethanchowdary', 'johnthesayan', 'alurupraveen6', 'reddyvenkateswara02', 'sivananda993', 'ranjithrock044', '8187096036p', 'abburisrihari8', 'sreepuramsravani', 'jhansibaddela', 'deepakarunannamalai', 'preethidakkili321', 'sudheerr1999', 'narayanaroyal888', 'maheshmahi68709', 'amulyaammu24689', 'viggyviggy50', 'chowdaryteja620', 'pasamvenkatlokesh', 'phaniramaraju7', 'sadwikareddy999', 'ramakrishnareddydaggula007', 'gowthamreddybathala', 'venkatesh.u', 'polireddychaitanya', 'jaideepkishor', 'jaideepkishor1999', 'uppusrikanth333', 'udaykiranaliveli8', 'khiransai123', 'adithyaprince.ams', 'bindubhogireddy', 'kirthirajan.1999', 'yvaravindkumar', 'pandatijahnavi01', 'iambhagat1299', 'smileyroja.k', 'shaikziyauddin786', 'chakradhar', 'sushmithakankanala17', 'amulyareddy358', 'mmudhaya0505', 'cvenkateshvenki99', 'nano2018slot1', 'kirankumarreddy1256', 'sandhyamoorpa357', 'kavianandraj2000', 'sanjaymsdhoni2', 'harshavardhan5152', 'sanaeswar143', 'harishsreenivas09', 'layasree062', 'vinayadusumilli28', 'eswarkumar.kandepi', 'raju1408gopi', 'gokulspy', 'meghanareddy55555', 'msatishkumarreddy244', 'agnes', 'bhaskarrao', 'aragondadinesh', 'krishnakrish815865', 'gnanasai369', 'kethinenivenkatpavan2000', 'durganath', 'reddysivareddy2000', 'maniroyal725', 'shrinath', 'saikiran9546', 'dineshgunji154', 'dinesh.polisetty24', 'uvishnupriya1999', 'ariyareddygaripavithra', 'gowthammuppala123', 'shaiktabrash333', None, 'g.dharanija', 'sathesh.m', 'chandu74162', 'karthikreddy1807', 'aryajayanthcool143', 'rangepallirajasekhar', 'keerthanagprasad123', 'sairamkoneti444', 'kudupudiprudhviraj8', 'dushyanth7jakkam']",107,"['niteeshsandu143', 'harshitha.lokireddy', 'madhavspai', 'agnesangel012', 'smart.roopesh305', 'obulenaveenkumarreddy', 'umamaheshwarreddy074', 'kalyanyadavjadda', 'pallavie12345', 'bharath.pbn99', 'msmadhu1442000', 'likhithachinni2000', 'nethanchowdary', 'johnthesayan', 'alurupraveen6', 'reddyvenkateswara02', 'sivananda993', 'ranjithrock044', '8187096036p', 'yaminireddy72304', 'abburisrihari8', 'sreepuramsravani', 'jhansibaddela', 'deepakarunannamalai', 'paraglokhande108', 'preethidakkili321', 'sudheerr1999', 'narayanaroyal888', 'aishwaryatheerthala2000', 'maheshmahi68709', 'amulyaammu24689', 'viggyviggy50', 'chowdaryteja620', 'pasamvenkatlokesh', 'phaniramaraju7', 'sadwikareddy999', 'wyattm', 'ramakrishnareddydaggula007', 'gowthamreddybathala', 'venkatesh.u', 'sivasai2467', 'nirmalr251', 'spazos7', 'polireddychaitanya', 'jaideepkishor', 'jaideepkishor1999', 'uppusrikanth333', 'udaykiranaliveli8', 'khiransai123', 'adithyaprince.ams', 'bindubhogireddy', 'kirthirajan.1999', 'yvaravindkumar', 'pandatijahnavi01', 'iambhagat1299', 'smileyroja.k', 'shaikziyauddin786', 'chakradhar', 'sushmithakankanala17', 'amulyareddy358', 'mmudhaya0505', 'cvenkateshvenki99', 'nano2018slot1', 'kirankumarreddy1256', 'sandhyamoorpa357', 'kavianandraj2000', 'sanjaymsdhoni2', 'harshavardhan5152', 'sanaeswar143', 'harishsreenivas09', 'layasree062', 'vinayadusumilli28', 'eswarkumar.kandepi', 'raju1408gopi', 'gokulspy', 'meghanareddy55555', 'msatishkumarreddy244', 'agnes', 'bhaskarrao', 'aragondadinesh', 'krishnakrish815865', 'gnanasai369', 'kethinenivenkatpavan2000', 'durganath', 'reddysivareddy2000', 'maniroyal725', 'thushithathushi52', 'shrinath', 'saikiran9546', 'dineshgunji154', 'dinesh.polisetty24', 'uvishnupriya1999', 'ariyareddygaripavithra', 'gowthammuppala123', 'shaiktabrash333', None, 'g.dharanija', 'sathesh.m', 'chandu74162', 'karthikreddy1807', 'aryajayanthcool143', 'rangepallirajasekhar', 'keerthanagprasad123', 'sairamkoneti444', 'jochoab', 'kudupudiprudhviraj8', 'dushyanth7jakkam']"
69,289,11,42,4,"['nainamohamed', 'gunaselvaraj13579', 'keatz', 'srividya.ong']",6,"['induriraja', 'pasamvenkatlokesh143', 'varmadeekshitha695', 'umeshreddy562', 'puttarushendranaidu', 'shaikabdulhafeez']",38,"['praveenvenkat', 'smart.roopesh305', 'cvenkateshvenki99', 'kavianandraj2000', 'purnapallapati4090755', 'johnthesayan', 'kaivaramteja', 'razack0709', 'alurupraveen6', 'kapileshwar', 'sivananda993', 'vinayreddy200018', 'sreepuramsravani', 'deepakarunannamalai', 'nandini9885194902', 'dinesh1919', 'sadwikareddy999', 'krishnakrish815865', 'maaridinesh007', 'sumanthkumarchadalavada456', 'dprakashbhanu2000', 'dinesh.polisetty24', 'riyazsherifaforever0729', None, 'udaykiranaliveli8', 'alexsunduru9', 'sathesh.m', 'ravie', 'khiransai123', 'aryajayanthcool143', 'bindubhogireddy', 'kirthirajan.1999', 'rangepallirajasekhar', 'keerthanagprasad123', 'nagarjunabayinedi', 'yuvarajyuvaraj2114', 'deveshwaarece30', 'sushmithakankanala17']",48,"['gunaselvaraj13579', 'induriraja', 'praveenvenkat', 'smart.roopesh305', 'srividya.ong', 'cvenkateshvenki99', 'purnapallapati4090755', 'kavianandraj2000', 'johnthesayan', 'shaikabdulhafeez', 'kaivaramteja', 'razack0709', 'alurupraveen6', 'kapileshwar', 'sivananda993', 'vinayreddy200018', 'sreepuramsravani', 'deepakarunannamalai', 'puttarushendranaidu', 'nandini9885194902', 'dinesh1919', 'sadwikareddy999', 'krishnakrish815865', 'maaridinesh007', 'nainamohamed', 'sumanthkumarchadalavada456', 'dprakashbhanu2000', 'dinesh.polisetty24', 'riyazsherifaforever0729', None, 'udaykiranaliveli8', 'alexsunduru9', 'pasamvenkatlokesh143', 'varmadeekshitha695', 'sathesh.m', 'ravie', 'khiransai123', 'aryajayanthcool143', 'bindubhogireddy', 'umeshreddy562', 'kirthirajan.1999', 'rangepallirajasekhar', 'keerthanagprasad123', 'nagarjunabayinedi', 'keatz', 'yuvarajyuvaraj2114', 'deveshwaarece30', 'sushmithakankanala17']"
69,287,11,36,6,"['induriraja', 'pasamvenkatlokesh143', 'varmadeekshitha695', 'umeshreddy562', 'puttarushendranaidu', 'shaikabdulhafeez']",4,"['nainamohamed', 'gunaselvaraj13579', 'keatz', 'srividya.ong']",30,"['etukurikrishnavamsi242638', 'charantejagunji', 'praveenvenkat', 'cvenkateshvenki99', 'sanjaymsdhoni2', 'razack0709', 'manideep', 'harishsreenivas09', '8187096036p', 'vinayreddy200018', 'kalyandv200', 'kandukurinsr', 'pandubabu819', 'preethidakkili321', 'saikumar15025', 'amulyaammu24689', 'saiviswa9595', 'sauravsins', 'durganath', 'vickkyy', 'pnagamohan2000', 'dileepkumarkc43', None, 'abhimahe123', 'nanoelectronicsece', 'kirthirajan.1999', 'sairamkoneti444', 'sayeshreddy', 'a.sankar', 'premamenon27']",40,"['gunaselvaraj13579', 'etukurikrishnavamsi242638', 'induriraja', 'charantejagunji', 'praveenvenkat', 'srividya.ong', 'cvenkateshvenki99', 'sanjaymsdhoni2', 'shaikabdulhafeez', 'razack0709', 'manideep', 'harishsreenivas09', '8187096036p', 'vinayreddy200018', 'kalyandv200', 'kandukurinsr', 'pandubabu819', 'preethidakkili321', 'saikumar15025', 'puttarushendranaidu', 'amulyaammu24689', 'saiviswa9595', 'sauravsins', 'durganath', 'nainamohamed', 'vickkyy', 'pnagamohan2000', 'dileepkumarkc43', None, 'abhimahe123', 'pasamvenkatlokesh143', 'varmadeekshitha695', 'nanoelectronicsece', 'umeshreddy562', 'kirthirajan.1999', 'sairamkoneti444', 'sayeshreddy', 'keatz', 'a.sankar', 'premamenon27']"
69,295,11,30,6,"['gunaselvaraj13579', 'induriraja', 'pasamvenkatlokesh143', 'varmadeekshitha695', 'umeshreddy562', 'puttarushendranaidu']",4,"['nainamohamed', 'shaikabdulhafeez', 'keatz', 'srividya.ong']",24,"['etukurikrishnavamsi242638', 'charantejagunji', 'praveenvenkat', 'umamaheshwarreddy074', 'kavianandraj2000', 'sanjaymsdhoni2', 'harinadh', 'manideep', 'harishsreenivas09', 'shaikziyauddin786', '8187096036p', 'kandukurinsr', 'preethidakkili321', 'raju1408gopi', 'saikumar15025', 'amulyaammu24689', 'bhagath18499', 'durganath', None, 'sreenadh', 'abhimahe123', 'keerthanagprasad123', 'sushmithakankanala17', 'premamenon27']",34,"['gunaselvaraj13579', 'etukurikrishnavamsi242638', 'induriraja', 'charantejagunji', 'praveenvenkat', 'umamaheshwarreddy074', 'srividya.ong', 'kavianandraj2000', 'sanjaymsdhoni2', 'shaikabdulhafeez', 'harinadh', 'manideep', 'harishsreenivas09', 'shaikziyauddin786', '8187096036p', 'kandukurinsr', 'preethidakkili321', 'raju1408gopi', 'saikumar15025', 'puttarushendranaidu', 'amulyaammu24689', 'bhagath18499', 'durganath', 'nainamohamed', None, 'sreenadh', 'abhimahe123', 'pasamvenkatlokesh143', 'varmadeekshitha695', 'umeshreddy562', 'keerthanagprasad123', 'keatz', 'sushmithakankanala17', 'premamenon27']"
69,288,11,15,4,"['puttarushendranaidu', 'shaikabdulhafeez', 'pasamvenkatlokesh143', 'umeshreddy562']",6,"['gunaselvaraj13579', 'induriraja', 'varmadeekshitha695', 'nainamohamed', 'srividya.ong', 'keatz']",11,"['vickkyy', 'kandukurinsr', 'pandubabu819', 'praveenvenkat', 'sayeshreddy', 'pnagamohan2000', 'dileepkumarkc43', 'a.sankar', None, 'sauravsins', 'kalyandv200']",21,"['gunaselvaraj13579', 'induriraja', 'nainamohamed', 'vickkyy', 'praveenvenkat', 'srividya.ong', 'pnagamohan2000', 'dileepkumarkc43', 'shaikabdulhafeez', None, 'pasamvenkatlokesh143', 'varmadeekshitha695', 'kandukurinsr', 'pandubabu819', 'umeshreddy562', 'sayeshreddy', 'puttarushendranaidu', 'keatz', 'a.sankar', 'sauravsins', 'kalyandv200']"
69,290,11,14,2,"['gunaselvaraj13579', 'srividya.ong']",8,"['induriraja', 'pasamvenkatlokesh143', 'varmadeekshitha695', 'nainamohamed', 'umeshreddy562', 'puttarushendranaidu', 'keatz', 'shaikabdulhafeez']",12,"['kapileshwar', 'maaridinesh007', 'praveenvenkat', 'keerthanagprasad123', 'dprakashbhanu2000', 'nagarjunabayinedi', 'riyazsherifaforever0729', 'dinesh1919', 'johnthesayan', 'kaivaramteja', None, 'deveshwaarece30']",22,"['maaridinesh007', 'gunaselvaraj13579', 'induriraja', 'nainamohamed', 'praveenvenkat', 'srividya.ong', 'dprakashbhanu2000', 'riyazsherifaforever0729', 'johnthesayan', 'shaikabdulhafeez', 'kaivaramteja', None, 'kapileshwar', 'pasamvenkatlokesh143', 'varmadeekshitha695', 'umeshreddy562', 'keerthanagprasad123', 'puttarushendranaidu', 'keatz', 'nagarjunabayinedi', 'dinesh1919', 'deveshwaarece30']"
69,294,11,8,3,"['nainamohamed', 'keatz', 'srividya.ong']",7,"['gunaselvaraj13579', 'induriraja', 'pasamvenkatlokesh143', 'varmadeekshitha695', 'umeshreddy562', 'puttarushendranaidu', 'shaikabdulhafeez']",5,"['pnagamohan2000', 'dinesh.polisetty24', 'dinesh1919', None, 'gmanohar317']",15,"['gunaselvaraj13579', 'pasamvenkatlokesh143', 'varmadeekshitha695', 'induriraja', 'nainamohamed', 'umeshreddy562', 'srividya.ong', 'pnagamohan2000', 'puttarushendranaidu', 'keatz', 'dinesh.polisetty24', 'dinesh1919', 'shaikabdulhafeez', None, 'gmanohar317']"
71,53,11,75,10,"['vixsnair', 'waynemdsouza', 'priyu0964', 'patilprasad0123', 'chavankeasmita29', 'mayuridesai', 'sushobh', 'wanichinmay577', 'ghevadeyogesh', 'rohitnair77880']",0,[],65,"['nikhilchaudhari5516', 'shindedeepak129', 'rajat.p', 'smahamulkar1013', 'selimajack26', 'akau100', 'shah.ns', 'aditya27', 'shreyahonagekar04', 'jugal.vaja', 'shivam.rs', 'sakshi.bhosle', 'paras.mehta', 'saurabh.palde', 'zeevd19', 'sachin.sc', 'arthaya.koyande28', 'vatsal23', 'sujittupe3490', 'orencollaco97', 'shrutik1997.mallick', 'dhwani.vichhi', 'anujchhabra25', 'shraddha0306', 's.suvarna', 'pranitkumbhar19', 'sebin.bc', 'spawar.ap', 'naiksandesh1998', '15anuchaudhari', 'vidhi.satra', 'sukanyajadhav1997', 'maneshweta23', 'jeniferishwarya', 'd.haria', 'umeshlohote', 'jagnoor.p', 'kunalk4796', 'prithvianvekar21', 'evanjalinbenita', 'shubham.yelange', 'austin.dsouza1997', 'aadi', 'shreyasmoolya', 'shaibilsabu', 'jayesh.kakkad8770', 'rohansaldanha6370', 'davidrisaac', 'shubhamnagpure745', 'swapnalimakdey25', 'yasir.mulla47', 'jay.km', 'adityadesu1', 'harish.c', None, 'ninad.mulay', 'adityadh943', 'parin.ss', 'abhay.nadkarni', 'sakshi.trivedi', 'dishasaraiya', 'aur_mnzs', 'saurabhgawade.777.4.sg', 'shail.maroo', 'omkar.karande']",75,"['nikhilchaudhari5516', 'shindedeepak129', 'rajat.p', 'smahamulkar1013', 'selimajack26', 'akau100', 'rohitnair77880', 'shah.ns', 'aditya27', 'shreyahonagekar04', 'jugal.vaja', 'chavankeasmita29', 'shivam.rs', 'sakshi.bhosle', 'paras.mehta', 'saurabh.palde', 'sushobh', 'zeevd19', 'sachin.sc', 'arthaya.koyande28', 'vatsal23', 'sujittupe3490', 'orencollaco97', 'shrutik1997.mallick', 'dhwani.vichhi', 'anujchhabra25', 'waynemdsouza', 'shraddha0306', 's.suvarna', 'pranitkumbhar19', 'sebin.bc', 'spawar.ap', 'priyu0964', 'patilprasad0123', 'naiksandesh1998', '15anuchaudhari', 'vidhi.satra', 'sukanyajadhav1997', 'maneshweta23', 'jeniferishwarya', 'd.haria', 'umeshlohote', 'jagnoor.p', 'kunalk4796', 'prithvianvekar21', 'evanjalinbenita', 'shubham.yelange', 'austin.dsouza1997', 'aadi', 'mayuridesai', 'shreyasmoolya', 'vixsnair', 'shaibilsabu', 'jayesh.kakkad8770', 'rohansaldanha6370', 'davidrisaac', 'shubhamnagpure745', 'swapnalimakdey25', 'yasir.mulla47', 'jay.km', 'ghevadeyogesh', 'adityadesu1', 'harish.c', None, 'ninad.mulay', 'adityadh943', 'parin.ss', 'abhay.nadkarni', 'sakshi.trivedi', 'dishasaraiya', 'aur_mnzs', 'saurabhgawade.777.4.sg', 'shail.maroo', 'wanichinmay577', 'omkar.karande']"
72,99,11,20,10,"['gawade.tanmay.tg', 'pgonbare55', 'rushabhgudekar', 'lllaxmanh', 'sidrah.khan', 'manishshingade31', 'sahilnaidu.2016', 'rutujakurdhundkar', 'ajaymohite15', 'neha.nibre']",0,[],10,"['amogh.angre', 'riddhijet7', 'sadaf.surve', 'asktej143', 'sagargujral61', 'pillaishantanu', 'shreeyashthorat24', 'murtaza.indorewala95', None, 'ankitadrave97']",20,"['lllaxmanh', 'pillaishantanu', 'shreeyashthorat24', 'manishshingade31', 'sahilnaidu.2016', None, 'ajaymohite15', 'amogh.angre', 'gawade.tanmay.tg', 'pgonbare55', 'sadaf.surve', 'asktej143', 'rushabhgudekar', 'sagargujral61', 'ankitadrave97', 'sidrah.khan', 'riddhijet7', 'rutujakurdhundkar', 'murtaza.indorewala95', 'neha.nibre']"
72,207,11,18,10,"['gawade.tanmay.tg', 'pgonbare55', 'rushabhgudekar', 'lllaxmanh', 'sidrah.khan', 'manishshingade31', 'sahilnaidu.2016', 'rutujakurdhundkar', 'ajaymohite15', 'neha.nibre']",0,[],8,"['amogh.angre', 'riddhijet7', 'sagargujral61', 'pillaishantanu', 'shreeyashthorat24', 'murtaza.indorewala95', None, 'ankitadrave97']",18,"['lllaxmanh', 'pillaishantanu', 'shreeyashthorat24', 'manishshingade31', 'sahilnaidu.2016', None, 'ajaymohite15', 'amogh.angre', 'gawade.tanmay.tg', 'pgonbare55', 'rushabhgudekar', 'sagargujral61', 'ankitadrave97', 'sidrah.khan', 'riddhijet7', 'rutujakurdhundkar', 'murtaza.indorewala95', 'neha.nibre']"
72,274,11,16,10,"['gawade.tanmay.tg', 'pgonbare55', 'rushabhgudekar', 'lllaxmanh', 'sidrah.khan', 'manishshingade31', 'sahilnaidu.2016', 'rutujakurdhundkar', 'ajaymohite15', 'neha.nibre']",0,[],6,"['sadaf.surve', 'asktej143', 'pillaishantanu', 'riddhijet7', None, 'ankitadrave97']",16,"['lllaxmanh', 'pillaishantanu', 'manishshingade31', 'sahilnaidu.2016', None, 'ajaymohite15', 'gawade.tanmay.tg', 'pgonbare55', 'sadaf.surve', 'asktej143', 'rushabhgudekar', 'ankitadrave97', 'sidrah.khan', 'riddhijet7', 'rutujakurdhundkar', 'neha.nibre']"
72,276,11,8,2,"['manishshingade31', 'sahilnaidu.2016']",8,"['gawade.tanmay.tg', 'pgonbare55', 'rushabhgudekar', 'lllaxmanh', 'sidrah.khan', 'rutujakurdhundkar', 'ajaymohite15', 'neha.nibre']",6,"['sagargujral61', 'pillaishantanu', 'shreeyashthorat24', 'murtaza.indorewala95', None, 'ankitadrave97']",16,"['gawade.tanmay.tg', 'pgonbare55', 'rushabhgudekar', 'sagargujral61', 'lllaxmanh', 'pillaishantanu', 'shreeyashthorat24', 'ankitadrave97', 'sidrah.khan', 'manishshingade31', 'sahilnaidu.2016', 'rutujakurdhundkar', 'murtaza.indorewala95', None, 'ajaymohite15', 'neha.nibre']"
73,445,11,9,7,"['mas856', 'jw2448', 'zw569', 'mrk263', 'xxxxxxxwx', 'sh2488', 'ab2552']",3,"['atif47', 'cliddell1', 'tieqiao']",2,"['dvc25', None]",12,"['jw2448', 'cliddell1', 'mrk263', 'xxxxxxxwx', 'dvc25', 'atif47', None, 'mas856', 'zw569', 'tieqiao', 'sh2488', 'ab2552']"
74,268,11,16,2,"['pillaiabhinash11', 'pooja1996']",8,"['deepaputran', 'tushar.t.rao', 'akankshachandoskar1198', 'sandesh', 'aaronkoli98', 'snehashinde093', 'prajaktawarke7797', 'samikshakamble6']",14,"['vaibhavtoys', 'aumkar.nk1', 'priyankakunde22', 'shankharimeenu', 'gayatri.hadap47', 'kedar.kulkarni12', 'abhishektoraskar412', 'iammayuri3', 'gambhirepraful57', 'ashnavirdikar.av', 'tathagat34', 'rsbangar1998', None, 'gambhirepraful87']",24,"['vaibhavtoys', 'aumkar.nk1', 'priyankakunde22', 'shankharimeenu', 'gayatri.hadap47', 'abhishektoraskar412', 'sandesh', 'akankshachandoskar1198', 'iammayuri3', 'snehashinde093', 'prajaktawarke7797', 'tathagat34', 'pooja1996', 'rsbangar1998', None, 'gambhirepraful87', 'kedar.kulkarni12', 'deepaputran', 'tushar.t.rao', 'pillaiabhinash11', 'aaronkoli98', 'gambhirepraful57', 'ashnavirdikar.av', 'samikshakamble6']"
74,270,11,13,5,"['deepaputran', 'tushar.t.rao', 'snehashinde093', 'prajaktawarke7797', 'samikshakamble6']",5,"['pillaiabhinash11', 'sandesh', 'akankshachandoskar1198', 'aaronkoli98', 'pooja1996']",8,"['rakshitpoojary1606', 'camit149', 'srt150597', 'tejalborhade', 'patelkhushbu098', 'akshata11', None, 'ssavtirkar1']",18,"['rakshitpoojary1606', 'srt150597', 'sandesh', 'akankshachandoskar1198', 'tejalborhade', 'snehashinde093', 'prajaktawarke7797', 'pooja1996', None, 'ssavtirkar1', 'deepaputran', 'tushar.t.rao', 'pillaiabhinash11', 'camit149', 'aaronkoli98', 'patelkhushbu098', 'akshata11', 'samikshakamble6']"
74,272,11,13,4,"['pillaiabhinash11', 'sandesh', 'akankshachandoskar1198', 'aaronkoli98']",6,"['deepaputran', 'tushar.t.rao', 'snehashinde093', 'prajaktawarke7797', 'samikshakamble6', 'pooja1996']",9,"['sourabhkothari16', 'priyankakunde22', 'nvicharenv464', 'prasadwagh95', 'rakeshpatil9271', 'mayur98bhor', 'pratik.devle98', None, 'gambhirepraful87']",19,"['sourabhkothari16', 'priyankakunde22', 'rakeshpatil9271', 'sandesh', 'akankshachandoskar1198', 'mayur98bhor', 'pratik.devle98', 'snehashinde093', 'prajaktawarke7797', 'pooja1996', None, 'gambhirepraful87', 'nvicharenv464', 'deepaputran', 'prasadwagh95', 'tushar.t.rao', 'pillaiabhinash11', 'aaronkoli98', 'samikshakamble6']"
74,273,11,6,1,['pillaiabhinash11'],9,"['deepaputran', 'tushar.t.rao', 'akankshachandoskar1198', 'sandesh', 'aaronkoli98', 'snehashinde093', 'prajaktawarke7797', 'samikshakamble6', 'pooja1996']",5,"['priyankakunde22', 'iammayuri3', 'pratik.devle98', 'mohini.bhangale5', None]",15,"['priyankakunde22', 'deepaputran', 'tushar.t.rao', 'pillaiabhinash11', 'sandesh', 'akankshachandoskar1198', 'aaronkoli98', 'iammayuri3', 'pratik.devle98', 'snehashinde093', 'prajaktawarke7797', 'samikshakamble6', 'pooja1996', 'mohini.bhangale5', None]"
78,116,11,36,9,"['angusmo', 'ayen', 'ajewers', 'tinamaurer', 'bdeguire', 'jrosborne', 'jkvaternik', 'menglingshi', 'jgnall']",1,['matthewsarge'],27,"['vmouradian', 'komminiadithya', 'jcrouss', 'emunguia', 'dgabriel', 'opin', 'aksamija', 'mskaza', 'ltweston', 'aeshak', 'bdester', 'aphauser', 'rwbrown', 'mjaffe', 'cmkennedy', 'sfick', 'dperry', 'adonadio', 'fpanikov', None, 'oterry', 'tfloyd', 'whobby', 'jaandrade', 'rcperkins', 'msokolov', 'inorman']",37,"['vmouradian', 'komminiadithya', 'jcrouss', 'emunguia', 'dgabriel', 'opin', 'aksamija', 'jgnall', 'ayen', 'mskaza', 'ltweston', 'aeshak', 'matthewsarge', 'bdester', 'aphauser', 'rwbrown', 'mjaffe', 'cmkennedy', 'angusmo', 'sfick', 'jkvaternik', 'menglingshi', 'dperry', 'adonadio', 'fpanikov', None, 'ajewers', 'tinamaurer', 'oterry', 'whobby', 'bdeguire', 'jrosborne', 'tfloyd', 'jaandrade', 'rcperkins', 'msokolov', 'inorman']"
78,157,11,27,8,"['angusmo', 'ajewers', 'tinamaurer', 'bdeguire', 'matthewsarge', 'jkvaternik', 'menglingshi', 'ayen']",2,"['jgnall', 'jrosborne']",19,"['komminiadithya', 'cdunnington', 'aleckchen', 'jcrouss', 'asanmiguel', 'ltweston', 'mjaffe', 'ranonyai', 'kmcwherter', 'sfick', 'mlaszcz', 'fpanikov', None, 'zoudngdng', 'oterry', 'tfloyd', 'jaandrade', 'tgerstel', 'yongjieyang']",29,"['komminiadithya', 'aleckchen', 'cdunnington', 'jcrouss', 'jgnall', 'ayen', 'asanmiguel', 'ltweston', 'matthewsarge', 'mjaffe', 'ranonyai', 'kmcwherter', 'angusmo', 'sfick', 'jkvaternik', 'menglingshi', 'mlaszcz', 'fpanikov', 'yongjieyang', None, 'ajewers', 'tinamaurer', 'oterry', 'tfloyd', 'bdeguire', 'jrosborne', 'jaandrade', 'tgerstel', 'zoudngdng']"
78,347,11,27,7,"['angusmo', 'ajewers', 'tinamaurer', 'bdeguire', 'matthewsarge', 'jrosborne', 'jgnall']",3,"['ayen', 'jkvaternik', 'menglingshi']",20,"['komminiadithya', 'cdunnington', 'jcrouss', 'aksamija', 'opin', 'asanmiguel', 'mskaza', 'aeshak', 'bdester', 'rwbrown', 'mjaffe', 'ranonyai', 'sfick', 'fpanikov', None, 'siddharthasr', 'oterry', 'tfloyd', 'rcperkins', 'msokolov']",30,"['komminiadithya', 'cdunnington', 'jcrouss', 'aksamija', 'opin', 'jgnall', 'ayen', 'asanmiguel', 'mskaza', 'aeshak', 'matthewsarge', 'bdester', 'rwbrown', 'mjaffe', 'ranonyai', 'angusmo', 'sfick', 'jkvaternik', 'menglingshi', 'fpanikov', None, 'siddharthasr', 'ajewers', 'tinamaurer', 'oterry', 'tfloyd', 'bdeguire', 'jrosborne', 'rcperkins', 'msokolov']"
78,218,11,18,10,"['angusmo', 'ayen', 'ajewers', 'tinamaurer', 'bdeguire', 'matthewsarge', 'jrosborne', 'jkvaternik', 'menglingshi', 'jgnall']",0,[],8,"['vmouradian', 'alessy.leblanc', 'bdester', 'mconsigli', 'rwbrown', 'ranonyai', None, 'aeshak']",18,"['angusmo', 'vmouradian', 'alessy.leblanc', 'jkvaternik', 'menglingshi', 'jgnall', 'ayen', None, 'ajewers', 'tinamaurer', 'bdeguire', 'matthewsarge', 'jrosborne', 'bdester', 'mconsigli', 'rwbrown', 'ranonyai', 'aeshak']"
78,151,11,11,2,"['ajewers', 'menglingshi']",8,"['angusmo', 'ayen', 'tinamaurer', 'bdeguire', 'matthewsarge', 'jrosborne', 'jkvaternik', 'jgnall']",9,"['zoudngdng', 'tfloyd', 'asanmiguel', 'cdunnington', 'jcrouss', 'ranonyai', None, 'yongjieyang', 'kmcwherter']",19,"['angusmo', 'cdunnington', 'jcrouss', 'jkvaternik', 'menglingshi', 'jgnall', 'ayen', None, 'asanmiguel', 'zoudngdng', 'ajewers', 'tinamaurer', 'tfloyd', 'bdeguire', 'matthewsarge', 'jrosborne', 'ranonyai', 'yongjieyang', 'kmcwherter']"
78,119,11,8,2,"['jkvaternik', 'jrosborne']",8,"['angusmo', 'ayen', 'ajewers', 'tinamaurer', 'bdeguire', 'matthewsarge', 'menglingshi', 'jgnall']",6,"['whobby', 'bdester', 'apaulo', 'mlaszcz', 'fpanikov', None]",16,"['angusmo', 'jgnall', 'ajewers', 'tinamaurer', 'whobby', 'bdeguire', 'matthewsarge', 'jrosborne', 'bdester', 'apaulo', 'jkvaternik', 'menglingshi', 'mlaszcz', 'ayen', 'fpanikov', None]"
78,158,11,7,3,"['jgnall', 'jkvaternik', 'jrosborne']",7,"['angusmo', 'ajewers', 'tinamaurer', 'bdeguire', 'matthewsarge', 'menglingshi', 'ayen']",4,"['fpanikov', 'whobby', None, 'mlaszcz']",14,"['angusmo', 'jgnall', 'ajewers', 'tinamaurer', 'whobby', 'bdeguire', 'matthewsarge', 'jrosborne', 'jkvaternik', 'menglingshi', 'mlaszcz', 'ayen', 'fpanikov', None]"
79,31,11,110,7,"['waseem98', 'karimfoda1', 'karinramy', 'youssef.yassermounir98', 'm16p3', 'moaz', 'mohanedayman']",3,"['sgu20171538', 'rawan.adel.1998', 'sgu20151448']",103,"['yasmine317', 'yusuf313', 'ahmad.yasserr', 'asmaahussein99', 'wildprince', 'mariamzanaty', 'engmo3taz99', 'ayamohamed', 'hamedamr95', 'youssefrefaat', 'alaa98', 'mennaessam98', 'zeyadahmedbadr97', 'memonona017', 'heba_star1999', 'mennatallamostafa87', 'nahlatarek', 'yara.magdy222', 'zeinabtaha', 'mohamedabdelmeged', 'muhammed.number', 'ahmadabdelsalam', 'mahmouddeghadi', 'ranaahmed96', 'guitarist9816', 'naremanallam40', 'mimo007007', 'almoatasem_bellah', 'mariomedhat9', 'mazen_ashraf', 'hagarkhaled', 'jojosazziz', 'asmaagamalelsayed96', 'nouran_mohamed', 'salmasaher', 'aubai.hassan98', 'a.omar125242', 'shamyofficial2', 'ayakhaled4897', 'abdelrhmanadelhassan', 'basmahassan697', 'geek10', 'aradwa477', 'husalaa98', 'omnia.khaled12', 'amgadsami1998', 'bentelghaly', 'yasmin.gad412', 'omniapinkflower', 'as', 'khaledshehab44', 'khaledhigazy94', 'nouran.tarek97', 'omar_eid73', 'mariam0', 'heshamebrahim123', 'aymansaadhack', 'mustafaakhlak', 'naderyosab67', 'georgesamy', 'mohmedaliessa', 'amirnabilhanna', 'gehadosama', 'ayoyayoyo2008', 'nada5essam', 'mohamedallam0000', 'salmaaatareeek', 'tahaa.rore', 'toqa1999', 'marwan.m96', 'mjkingdem', 'minaayman2', 'ramyadel1313', 'michaelashraf777', 'mohanad.waheed9', 'abdulrahmangalal', 'omarz977', 'muhlasheen2', 'sajaaadel', 'hala97', 'yayman55', 'amrsaeed012', 'anas_massoud', 'nayeramansour', 'youmna.moussa2016', 'mostafa200100', 'f.elgebaly', 'abdelazimmohamed98', 'esoomoh64', 'mohammedmajdyict', None, 'nourhanmagdymahmoud', 'ibrahimkamal1997', 'assemabdelmoniem', 'hour', 'nada.omran', 'aya.mohamed97', 'mohameddomy97', 'tokahossam71', 'hgowaily', 'nado.mahmoud1995', 'basmagharieb', 'loaydiaa']",113,"['yasmine317', 'yusuf313', 'ahmad.yasserr', 'asmaahussein99', 'wildprince', 'mariamzanaty', 'engmo3taz99', 'ayamohamed', 'hamedamr95', 'youssefrefaat', 'alaa98', 'mennaessam98', 'zeyadahmedbadr97', 'memonona017', 'heba_star1999', 'mennatallamostafa87', 'nahlatarek', 'yara.magdy222', 'zeinabtaha', 'mohamedabdelmeged', 'muhammed.number', 'ahmadabdelsalam', 'mahmouddeghadi', 'ranaahmed96', 'rawan.adel.1998', 'guitarist9816', 'naremanallam40', 'mimo007007', 'almoatasem_bellah', 'mariomedhat9', 'mazen_ashraf', 'hagarkhaled', 'jojosazziz', 'asmaagamalelsayed96', 'nouran_mohamed', 'salmasaher', 'karimfoda1', 'aubai.hassan98', 'a.omar125242', 'shamyofficial2', 'ayakhaled4897', 'abdelrhmanadelhassan', 'basmahassan697', 'geek10', 'aradwa477', 'mohanedayman', 'husalaa98', 'omnia.khaled12', 'amgadsami1998', 'bentelghaly', 'yasmin.gad412', 'omniapinkflower', 'as', 'khaledshehab44', 'khaledhigazy94', 'nouran.tarek97', 'sgu20171538', 'omar_eid73', 'mariam0', 'heshamebrahim123', 'aymansaadhack', 'mustafaakhlak', 'sgu20151448', 'naderyosab67', 'georgesamy', 'mohmedaliessa', 'amirnabilhanna', 'gehadosama', 'moaz', 'ayoyayoyo2008', 'nada5essam', 'mohamedallam0000', 'salmaaatareeek', 'tahaa.rore', 'toqa1999', 'marwan.m96', 'mjkingdem', 'minaayman2', 'ramyadel1313', 'michaelashraf777', 'mohanad.waheed9', 'abdulrahmangalal', 'omarz977', 'waseem98', 'muhlasheen2', 'sajaaadel', 'hala97', 'yayman55', 'amrsaeed012', 'anas_massoud', 'nayeramansour', 'youmna.moussa2016', 'mostafa200100', 'f.elgebaly', 'abdelazimmohamed98', 'm16p3', 'esoomoh64', 'mohammedmajdyict', None, 'nourhanmagdymahmoud', 'ibrahimkamal1997', 'assemabdelmoniem', 'hour', 'nada.omran', 'aya.mohamed97', 'mohameddomy97', 'karinramy', 'tokahossam71', 'hgowaily', 'youssef.yassermounir98', 'nado.mahmoud1995', 'basmagharieb', 'loaydiaa']"
79,28,11,97,2,"['sgu20171538', 'sgu20151448']",8,"['karimfoda1', 'karinramy', 'youssef.yassermounir98', 'rawan.adel.1998', 'waseem98', 'm16p3', 'moaz', 'mohanedayman']",95,"['harry0913', 'sgu20171570', 'sgu20141483', 'sgu20091548', 'sgu20171586', 'sgu20161535', 'sgu20101498', 'sgu20171524', 'ppjunb12', 'jkson3', 'sgu20121462', 'sg20121208', 'sgu20131481', 'sgu20151487', 'sgu20151476', 'sgu20171556', 'sgu20151513', 'sgu20151422', 'sgu20141448', 'sgu20131507', 'sgu20141474', 'sgu20141393', 'tktm44', 'a960710', 'sgu20141398', 'sgu20141433', 'sgu20161503', 'sgu20161542e', 'sgu20151438', 'sgu20151463', 'sgu20141460', 'sgu20171508', 'sgu20141415', 'sgu20131410', 'sgu20171558', 'sgu20141424', 'sgu20151194', 'sgu20141471', 'sgu20141430', 'sgu20151486', 'sgu20171503', 'seohyeoniii', 'sgu20141417', 'sgu20131455', 'sgu20151452', 'sgu20151410', 'sgu20141394', 'sgu20141411', 'sgu20151456', 'sgu20171526', 'gjfdjzo', 'sgu20151464', 'sgu20141395', 'sgu20141408', 'sgu20141465', 'han20151510', 'sgu20171502', 'claritas', 'sgu20131462', 'sgu20121498', 'sgu20141459', 'sgu20171562', 'sgu20171566', 'sgu20131508', 'sgu20141414', 'sgu20141478', 'sgu20161542', 'sgu20141468', 'sgu20141389', 'sgu20171550', 'sgu20151485', 'sgu20161474', 'dusxo124', 'sgu20121532', 'sgu20131432', 'sgu20151436', 'sgu20171490', 'sgu20151424', 'sgu20141461', 'dydgus201', 'sgu20141385', 'sgu20141480', None, 'sgu20171520', 'sgu20141450', 'sgu20141458', 'sgu20141484', 'sgu20131492', 'sgu20151490', 'sgu20141404', 'sgu20131412', 'sgu20141476', 'sgu20151478', 'sgu20151418', 'sgu20171572']",105,"['harry0913', 'sgu20171570', 'sgu20141483', 'sgu20091548', 'sgu20171586', 'sgu20161535', 'sgu20101498', 'sgu20171524', 'ppjunb12', 'jkson3', 'sgu20121462', 'sg20121208', 'sgu20131481', 'rawan.adel.1998', 'sgu20151487', 'sgu20151476', 'sgu20171556', 'sgu20151513', 'sgu20151422', 'sgu20141448', 'sgu20131507', 'karimfoda1', 'sgu20141474', 'sgu20141393', 'tktm44', 'mohanedayman', 'a960710', 'sgu20141398', 'sgu20141433', 'sgu20161503', 'sgu20161542e', 'sgu20151438', 'sgu20151463', 'sgu20141460', 'sgu20171508', 'sgu20141415', 'sgu20131410', 'sgu20171558', 'sgu20141424', 'sgu20171538', 'sgu20151194', 'sgu20141471', 'sgu20141430', 'sgu20151486', 'sgu20171503', 'seohyeoniii', 'sgu20141417', 'sgu20131455', 'sgu20151448', 'sgu20151452', 'sgu20151410', 'sgu20141394', 'sgu20141411', 'moaz', 'sgu20151456', 'sgu20171526', 'gjfdjzo', 'sgu20151464', 'sgu20141395', 'sgu20141408', 'sgu20141465', 'han20151510', 'sgu20171502', 'claritas', 'sgu20131462', 'waseem98', 'sgu20121498', 'sgu20141459', 'sgu20171562', 'sgu20171566', 'sgu20131508', 'sgu20141414', 'sgu20141478', 'sgu20161542', 'sgu20141468', 'sgu20141389', 'sgu20171550', 'sgu20151485', 'sgu20161474', 'dusxo124', 'sgu20121532', 'm16p3', 'sgu20131432', 'sgu20151436', 'sgu20171490', 'sgu20151424', 'dydgus201', 'sgu20141461', 'sgu20141385', 'sgu20141480', None, 'sgu20171520', 'sgu20141450', 'sgu20141458', 'sgu20141484', 'sgu20131492', 'sgu20151490', 'sgu20141404', 'sgu20131412', 'sgu20141476', 'sgu20151478', 'karinramy', 'youssef.yassermounir98', 'sgu20151418', 'sgu20171572']"
79,29,11,84,2,"['youssef.yassermounir98', 'moaz']",8,"['sgu20171538', 'karimfoda1', 'sgu20151448', 'karinramy', 'rawan.adel.1998', 'waseem98', 'm16p3', 'mohanedayman']",82,"['yusuf313', 'ahmad.yasserr', 'asmaahussein99', 'wildprince', 'mariamzanaty', 'engmo3taz99', 'ayamohamed', 'youssefrefaat', 'mennaessam98', 'zeyadahmedbadr97', 'memonona017', 'heba_star1999', 'nayerakhaled', 'nadaessam', 'nahlatarek', 'zeinabtaha', 'muhammed.number', 'ahmadabdelsalam', 'mahmouddeghadi', 'naremanallam40', 'mimo007007', 'mohamedkutb', 'almoatasem_bellah', 'mariomedhat9', 'hagarkhaled', 'sikaislam66', 'jojosazziz', 'nouran_mohamed', 'salmasaher', 'shamyofficial2', 'a.omar125242', 'abdelrhmanadelhassan', 'ayakhaled4897', 'basmahassan697', 'aradwa477', 'omnia.khaled12', 'bentelghaly', 'yasmin.gad412', 'omniapinkflower', 'ayakhaled', 'as', 'khaledshehab44', 'nouran.tarek97', 'ayaabdelrahim', 'omar_eid73', 'veroveronica08', 'aymansaadhack', 'olashazly27', 'mustafaakhlak', 'mohmedaliessa', 'gehadosama', 'ayoyayoyo2008', 'radwa123', 'nada5essam', 'salmaaatareeek', 'monikaa', 'tahaa.rore', 'marwan.m96', 'mjkingdem', 'michaelashraf777', 'weka_201219', 'mohanad.waheed9', 'abdulrahmangalal', 'sajaaadel', 'hala97', 'youstinamagdy', 'youssef_essam', 'mostafa200100', 'f.elgebaly', 'abdelazimmohamed98', 'esoomoh64', 'mohammedmajdyict', 'bassem8989', None, 'ibrahimkamal1997', 'nada.omran', 'tokahossam71', 'ahmedmoustafa771', 'bassem_mazen', 'abdo1703', 'nado.mahmoud1995', 'basmagharieb']",92,"['yusuf313', 'ahmad.yasserr', 'asmaahussein99', 'wildprince', 'mariamzanaty', 'engmo3taz99', 'ayamohamed', 'youssefrefaat', 'mennaessam98', 'zeyadahmedbadr97', 'memonona017', 'heba_star1999', 'nayerakhaled', 'nadaessam', 'nahlatarek', 'zeinabtaha', 'muhammed.number', 'ahmadabdelsalam', 'mahmouddeghadi', 'rawan.adel.1998', 'naremanallam40', 'mimo007007', 'mohamedkutb', 'almoatasem_bellah', 'mariomedhat9', 'hagarkhaled', 'sikaislam66', 'jojosazziz', 'nouran_mohamed', 'salmasaher', 'karimfoda1', 'shamyofficial2', 'a.omar125242', 'abdelrhmanadelhassan', 'ayakhaled4897', 'basmahassan697', 'aradwa477', 'mohanedayman', 'omnia.khaled12', 'bentelghaly', 'yasmin.gad412', 'omniapinkflower', 'ayakhaled', 'as', 'khaledshehab44', 'nouran.tarek97', 'sgu20171538', 'ayaabdelrahim', 'omar_eid73', 'veroveronica08', 'aymansaadhack', 'olashazly27', 'mustafaakhlak', 'sgu20151448', 'mohmedaliessa', 'gehadosama', 'moaz', 'ayoyayoyo2008', 'radwa123', 'nada5essam', 'salmaaatareeek', 'monikaa', 'tahaa.rore', 'marwan.m96', 'mjkingdem', 'michaelashraf777', 'weka_201219', 'mohanad.waheed9', 'abdulrahmangalal', 'waseem98', 'sajaaadel', 'hala97', 'youstinamagdy', 'youssef_essam', 'mostafa200100', 'f.elgebaly', 'abdelazimmohamed98', 'm16p3', 'esoomoh64', 'mohammedmajdyict', 'bassem8989', None, 'ibrahimkamal1997', 'nada.omran', 'karinramy', 'tokahossam71', 'youssef.yassermounir98', 'ahmedmoustafa771', 'bassem_mazen', 'abdo1703', 'nado.mahmoud1995', 'basmagharieb']"
79,350,11,25,7,"['waseem98', 'karimfoda1', 'karinramy', 'youssef.yassermounir98', 'm16p3', 'moaz', 'mohanedayman']",3,"['sgu20171538', 'rawan.adel.1998', 'sgu20151448']",18,"['ezzelgaby', 'mariam.3m', 'konswa98', 'abdogaber65', 'marawan97zizo', 'omartarekmostafaa14', 'eng.sherry.heshmat.h', 'menna21', 'maggie_tarek', 'nadine_gamal', 'eng.hassan.cu', 'nada_tarek', 'maghraby74', 'mennaessam', 'magdypeter30', 'sajaaadel', None, 'superman_sammour']",28,"['konswa98', 'marawan97zizo', 'eng.sherry.heshmat.h', 'menna21', 'sgu20151448', 'nadine_gamal', 'nada_tarek', 'magdypeter30', 'moaz', 'superman_sammour', 'ezzelgaby', 'mariam.3m', 'rawan.adel.1998', 'waseem98', 'sajaaadel', 'abdogaber65', 'karimfoda1', 'maggie_tarek', 'eng.hassan.cu', 'maghraby74', 'm16p3', None, 'mohanedayman', 'omartarekmostafaa14', 'karinramy', 'youssef.yassermounir98', 'mennaessam', 'sgu20171538']"
80,343,11,60,1,['sumritg267'],9,"['dutta.alankar', 'lovelyhari.haricharan', 'davidliupatriots', 'gtzintzarov', 'abourassa', 'aildefonso3', 'intoblackout', 'umts_5298', 'pansj.ust']",59,"['deepanshu.koshta', 'ds1621pc', 'tanmayg890', 'siddharthmaniar99', 'methi1999', 'adil456', 'agarwalanubhav.2011', 'aniruddh', 'pragatimeshram30', 'vaidehipatil', 'ritizsaini', 'aryanlall53', 'siddharthsh2', 'tarunatsamadder', 'prajwalbarapatre13', 'prachigoel2511', 'mundrayagya1', 'rishabhdahale', 'manasv09', 'adityakhanna1999', 'surya99', 'kdbeatbox', 'hellblazer', 'riteshsadwik', 'prashantkurrey61520', 'bjsmahesh', 'yashmandharerl', 'sudhanshu.an', 'harshdolhare99', 'jaideep', 'deviljokerkaran', 'sakshee.pimpale', 'etcherla.harshavardhan3', 'sayedzuzair', 'divyansh001', 'phsysaicms', 'bhalodeutu', 'parasbodke', 'jeetika2000singla', 'mihir.kavishwar710', 'anirudh31', 'goelripul999', 'shivamagarwal0240', 'anubhavgoel026', None, 'shivani_vn', 'ayushrajmehrotra.11', 'karan_chate', 'sshailee270', 'namannarang', 'patel.prajval1', 'agarwal.aishwarya2013', 'meshramrishikesh1206', 'kushalpatil07', 'rathodhare', 'prajwaldkamble', 'nitish_21', 'sakethchandra', 'madhurs']",69,"['deepanshu.koshta', 'ds1621pc', 'agarwalanubhav.2011', 'aniruddh', 'pragatimeshram30', 'abourassa', 'vaidehipatil', 'ritizsaini', 'tarunatsamadder', 'prajwalbarapatre13', 'mundrayagya1', 'manasv09', 'surya99', 'kdbeatbox', 'hellblazer', 'riteshsadwik', 'prashantkurrey61520', 'harshdolhare99', 'deviljokerkaran', 'sakshee.pimpale', 'etcherla.harshavardhan3', 'parasbodke', 'bhalodeutu', 'jeetika2000singla', 'mihir.kavishwar710', 'shivamagarwal0240', 'anubhavgoel026', 'umts_5298', 'shivani_vn', 'ayushrajmehrotra.11', 'dutta.alankar', 'lovelyhari.haricharan', 'namannarang', 'meshramrishikesh1206', 'kushalpatil07', 'sumritg267', 'rathodhare', 'prajwaldkamble', 'nitish_21', 'aildefonso3', 'sakethchandra', 'davidliupatriots', 'madhurs', 'tanmayg890', 'siddharthmaniar99', 'methi1999', 'adil456', 'aryanlall53', 'siddharthsh2', 'prachigoel2511', 'rishabhdahale', 'adityakhanna1999', 'bjsmahesh', 'yashmandharerl', 'sudhanshu.an', 'jaideep', 'divyansh001', 'sayedzuzair', 'phsysaicms', 'anirudh31', 'goelripul999', 'intoblackout', None, 'pansj.ust', 'karan_chate', 'sshailee270', 'patel.prajval1', 'agarwal.aishwarya2013', 'gtzintzarov']"
80,340,11,48,1,['sumritg267'],9,"['dutta.alankar', 'lovelyhari.haricharan', 'davidliupatriots', 'gtzintzarov', 'abourassa', 'aildefonso3', 'intoblackout', 'umts_5298', 'pansj.ust']",47,"['deepanshu.koshta', 'ds1621pc', 'tanmayg890', 'siddharthmaniar99', 'methi1999', 'adil456', 'sonalkumar632', 'agarwalanubhav.2011', 'aniruddh', 'pragatimeshram30', 'vaidehipatil', 'ritizsaini', 'aryanlall53', 'jsmahesh.iitb', 'prajwalbarapatre13', 'vatsal', 'mundrayagya1', 'rishabhdahale', 'surya99', 'hellblazer', 'bjsmahesh', 'yashmandharerl', 'tavishmeena', 'harshdolhare99', 'jaideep', 'etcherla.harshavardhan3', 'sayedzuzair', 'phsysaicms', 'bhalodeutu', 'mihir.kavishwar710', 'goelripul999', 'anubhavgoel026', 'bhavesh.garg', None, 'sonalkumar199842', 'shivani_vn', 'ayushrajmehrotra.11', 'karan_chate', 'sshailee270', 'namannarang', 'patel.prajval1', 'agarwal.aishwarya2013', 'meshramrishikesh1206', 'pradeep264', 'nitish_21', 'sakethchandra', 'madhurs']",57,"['deepanshu.koshta', 'ds1621pc', 'tanmayg890', 'siddharthmaniar99', 'methi1999', 'adil456', 'sonalkumar632', 'agarwalanubhav.2011', 'aniruddh', 'pragatimeshram30', 'abourassa', 'vaidehipatil', 'ritizsaini', 'aryanlall53', 'jsmahesh.iitb', 'prajwalbarapatre13', 'vatsal', 'mundrayagya1', 'rishabhdahale', 'surya99', 'hellblazer', 'bjsmahesh', 'yashmandharerl', 'tavishmeena', 'harshdolhare99', 'jaideep', 'etcherla.harshavardhan3', 'sayedzuzair', 'phsysaicms', 'bhalodeutu', 'mihir.kavishwar710', 'goelripul999', 'anubhavgoel026', 'bhavesh.garg', 'intoblackout', 'umts_5298', None, 'sonalkumar199842', 'pansj.ust', 'shivani_vn', 'ayushrajmehrotra.11', 'dutta.alankar', 'karan_chate', 'lovelyhari.haricharan', 'sshailee270', 'namannarang', 'patel.prajval1', 'agarwal.aishwarya2013', 'gtzintzarov', 'meshramrishikesh1206', 'sumritg267', 'pradeep264', 'nitish_21', 'aildefonso3', 'sakethchandra', 'davidliupatriots', 'madhurs']"
82,89,11,50,2,"['graemek4', 'zameer13b']",8,"['mukims', 'li1569910942', 'sengermi', 'bfocassio', 'tghosle', 'kiminhahaha', 'highmorewu', 'ethereal']",48,"['smithamdan', 'my2low', 'cas', 'zifanek', 'agill16', 'coursework', 'qianshu', 'deminyin', 'reed.maximilian', 'adrianycchan', 'vyshakh.sanjeev', 'jthomasyang', 'ne471nanoschool', 'zack.strike', 'jasminek', 'mikejewski', 'amargharial', 'cui.wentao', 'yuxiao.zhou', 'jonathanrasmussen1996', 'wkap', 'arunrangahotmail.ca', 'sumi_sumi_7', 'k.malejczuk', 'h_waterloo', 'mwin', 'j442chen', None, 'takdeniz', 'rainwind2010', 'manasakaniselvan', 'mototsune1', 'drousso', 'ryanj', 'robertbennett', 'l2mcgrat', 'adrianeitzen', 'sw4chan', 'saravind', 'cullentielemans', 'kylenova', 'anthony.le3124', 'k31berte', 'khadijaasad', 'calena3', 'theeran', 'rendall_jenner', 'fade237']",58,"['smithamdan', 'my2low', 'cas', 'zifanek', 'agill16', 'coursework', 'qianshu', 'deminyin', 'kiminhahaha', 'reed.maximilian', 'adrianycchan', 'vyshakh.sanjeev', 'jthomasyang', 'ne471nanoschool', 'zack.strike', 'jasminek', 'mikejewski', 'amargharial', 'graemek4', 'bfocassio', 'tghosle', 'cui.wentao', 'highmorewu', 'yuxiao.zhou', 'mukims', 'jonathanrasmussen1996', 'wkap', 'arunrangahotmail.ca', 'sumi_sumi_7', 'k.malejczuk', 'sengermi', 'ethereal', 'h_waterloo', 'mwin', 'j442chen', None, 'takdeniz', 'rainwind2010', 'manasakaniselvan', 'mototsune1', 'zameer13b', 'drousso', 'ryanj', 'robertbennett', 'l2mcgrat', 'adrianeitzen', 'sw4chan', 'saravind', 'cullentielemans', 'kylenova', 'anthony.le3124', 'k31berte', 'khadijaasad', 'li1569910942', 'calena3', 'theeran', 'rendall_jenner', 'fade237']"
83,28,11,97,1,['sgu20101498'],9,"['pmontgomery89', 'jaxnolan797', 'chadparrish', 'deepak.kumar', 'zka227', 'wya232', 'adnan.qabbani', 'elendi', 'dlla228']",96,"['harry0913', 'sgu20171570', 'sgu20141483', 'sgu20091548', 'sgu20171586', 'sgu20161535', 'sgu20171524', 'ppjunb12', 'jkson3', 'sgu20121462', 'sg20121208', 'sgu20131481', 'sgu20151487', 'sgu20151476', 'sgu20171556', 'sgu20151513', 'sgu20151422', 'sgu20141448', 'sgu20131507', 'sgu20141474', 'sgu20141393', 'tktm44', 'a960710', 'sgu20141398', 'sgu20141433', 'sgu20161503', 'sgu20161542e', 'sgu20151438', 'sgu20151463', 'sgu20141460', 'sgu20171508', 'sgu20141415', 'sgu20131410', 'sgu20171558', 'sgu20141424', 'sgu20171538', 'sgu20151194', 'sgu20141471', 'sgu20141430', 'sgu20151486', 'sgu20171503', 'seohyeoniii', 'sgu20141417', 'sgu20131455', 'sgu20151448', 'sgu20151452', 'sgu20151410', 'sgu20141394', 'sgu20141411', 'sgu20151456', 'sgu20171526', 'gjfdjzo', 'sgu20151464', 'sgu20141395', 'sgu20141408', 'sgu20141465', 'han20151510', 'sgu20171502', 'claritas', 'sgu20131462', 'sgu20121498', 'sgu20141459', 'sgu20171562', 'sgu20171566', 'sgu20131508', 'sgu20141414', 'sgu20141478', 'sgu20161542', 'sgu20141468', 'sgu20141389', 'sgu20171550', 'sgu20151485', 'sgu20161474', 'dusxo124', 'sgu20121532', 'sgu20131432', 'sgu20151436', 'sgu20171490', 'sgu20151424', 'sgu20141461', 'dydgus201', 'sgu20141385', 'sgu20141480', None, 'sgu20171520', 'sgu20141450', 'sgu20141458', 'sgu20141484', 'sgu20131492', 'sgu20151490', 'sgu20141404', 'sgu20131412', 'sgu20141476', 'sgu20151478', 'sgu20151418', 'sgu20171572']",106,"['harry0913', 'sgu20171570', 'sgu20141483', 'sgu20091548', 'sgu20171586', 'sgu20161535', 'sgu20101498', 'sgu20171524', 'ppjunb12', 'jkson3', 'sgu20121462', 'sg20121208', 'sgu20131481', 'sgu20151487', 'elendi', 'sgu20151476', 'sgu20171556', 'sgu20151513', 'dlla228', 'sgu20151422', 'sgu20141448', 'sgu20131507', 'zka227', 'sgu20141474', 'sgu20141393', 'tktm44', 'a960710', 'sgu20141398', 'sgu20141433', 'sgu20161503', 'sgu20161542e', 'sgu20151438', 'deepak.kumar', 'sgu20151463', 'sgu20141460', 'sgu20171508', 'sgu20141415', 'sgu20131410', 'sgu20171558', 'adnan.qabbani', 'sgu20141424', 'sgu20171538', 'sgu20151194', 'sgu20141471', 'sgu20141430', 'sgu20151486', 'sgu20171503', 'seohyeoniii', 'sgu20141417', 'sgu20131455', 'sgu20151448', 'sgu20151452', 'sgu20151410', 'sgu20141394', 'sgu20141411', 'sgu20151456', 'sgu20171526', 'gjfdjzo', 'sgu20151464', 'sgu20141395', 'sgu20141408', 'sgu20141465', 'han20151510', 'sgu20171502', 'claritas', 'sgu20131462', 'wya232', 'sgu20121498', 'sgu20141459', 'sgu20171562', 'sgu20171566', 'sgu20131508', 'sgu20141414', 'sgu20141478', 'pmontgomery89', 'sgu20161542', 'sgu20141468', 'chadparrish', 'sgu20141389', 'sgu20171550', 'sgu20151485', 'sgu20161474', 'dusxo124', 'sgu20121532', 'sgu20131432', 'sgu20151436', 'sgu20171490', 'sgu20151424', 'sgu20141461', 'dydgus201', 'sgu20141385', 'sgu20141480', None, 'sgu20171520', 'sgu20141450', 'sgu20141458', 'sgu20141484', 'sgu20131492', 'sgu20151490', 'sgu20141404', 'sgu20131412', 'sgu20141476', 'sgu20151478', 'sgu20151418', 'sgu20171572', 'jaxnolan797']"
83,320,11,9,6,"['pmontgomery89', 'jaxnolan797', 'chadparrish', 'deepak.kumar', 'wya232', 'dlla228']",4,"['elendi', 'sgu20101498', 'zka227', 'adnan.qabbani']",3,"['jthastings', None, 'mansooriq']",13,"['pmontgomery89', 'jaxnolan797', 'chadparrish', 'zka227', 'sgu20101498', None, 'deepak.kumar', 'mansooriq', 'wya232', 'adnan.qabbani', 'jthastings', 'elendi', 'dlla228']"
85,289,10,42,6,"['kapileshwar', 'maaridinesh007', 'dprakashbhanu2000', 'riyazsherifaforever0729', 'kaivaramteja', 'deveshwaarece30']",3,"['sayeshreddy', 'vickkyy', 'sauravsins']",36,"['gunaselvaraj13579', 'praveenvenkat', 'smart.roopesh305', 'srividya.ong', 'cvenkateshvenki99', 'purnapallapati4090755', 'kavianandraj2000', 'johnthesayan', 'razack0709', 'alurupraveen6', 'sivananda993', 'vinayreddy200018', 'sreepuramsravani', 'deepakarunannamalai', 'nandini9885194902', 'dinesh1919', 'sadwikareddy999', 'krishnakrish815865', 'nainamohamed', 'sumanthkumarchadalavada456', 'dinesh.polisetty24', None, 'udaykiranaliveli8', 'alexsunduru9', 'sathesh.m', 'ravie', 'khiransai123', 'aryajayanthcool143', 'bindubhogireddy', 'kirthirajan.1999', 'rangepallirajasekhar', 'keerthanagprasad123', 'nagarjunabayinedi', 'keatz', 'yuvarajyuvaraj2114', 'sushmithakankanala17']",45,"['gunaselvaraj13579', 'praveenvenkat', 'smart.roopesh305', 'srividya.ong', 'cvenkateshvenki99', 'purnapallapati4090755', 'kavianandraj2000', 'johnthesayan', 'kaivaramteja', 'razack0709', 'alurupraveen6', 'kapileshwar', 'sivananda993', 'vinayreddy200018', 'sreepuramsravani', 'deepakarunannamalai', 'nandini9885194902', 'dinesh1919', 'sadwikareddy999', 'krishnakrish815865', 'sauravsins', 'maaridinesh007', 'nainamohamed', 'vickkyy', 'sumanthkumarchadalavada456', 'dprakashbhanu2000', 'dinesh.polisetty24', 'riyazsherifaforever0729', None, 'udaykiranaliveli8', 'alexsunduru9', 'sathesh.m', 'ravie', 'khiransai123', 'aryajayanthcool143', 'bindubhogireddy', 'sayeshreddy', 'kirthirajan.1999', 'rangepallirajasekhar', 'keerthanagprasad123', 'nagarjunabayinedi', 'keatz', 'yuvarajyuvaraj2114', 'deveshwaarece30', 'sushmithakankanala17']"
85,287,10,36,3,"['sayeshreddy', 'vickkyy', 'sauravsins']",6,"['kapileshwar', 'maaridinesh007', 'dprakashbhanu2000', 'riyazsherifaforever0729', 'kaivaramteja', 'deveshwaarece30']",33,"['etukurikrishnavamsi242638', 'induriraja', 'charantejagunji', 'praveenvenkat', 'cvenkateshvenki99', 'sanjaymsdhoni2', 'shaikabdulhafeez', 'razack0709', 'manideep', 'harishsreenivas09', '8187096036p', 'vinayreddy200018', 'kalyandv200', 'kandukurinsr', 'pandubabu819', 'preethidakkili321', 'saikumar15025', 'puttarushendranaidu', 'amulyaammu24689', 'saiviswa9595', 'durganath', 'pnagamohan2000', 'dileepkumarkc43', None, 'abhimahe123', 'pasamvenkatlokesh143', 'varmadeekshitha695', 'nanoelectronicsece', 'umeshreddy562', 'kirthirajan.1999', 'sairamkoneti444', 'a.sankar', 'premamenon27']",42,"['etukurikrishnavamsi242638', 'induriraja', 'charantejagunji', 'praveenvenkat', 'cvenkateshvenki99', 'sanjaymsdhoni2', 'kaivaramteja', 'shaikabdulhafeez', 'razack0709', 'manideep', 'harishsreenivas09', 'kapileshwar', '8187096036p', 'vinayreddy200018', 'kalyandv200', 'kandukurinsr', 'pandubabu819', 'preethidakkili321', 'saikumar15025', 'puttarushendranaidu', 'amulyaammu24689', 'saiviswa9595', 'sauravsins', 'maaridinesh007', 'durganath', 'vickkyy', 'pnagamohan2000', 'dprakashbhanu2000', 'dileepkumarkc43', 'riyazsherifaforever0729', None, 'abhimahe123', 'pasamvenkatlokesh143', 'varmadeekshitha695', 'nanoelectronicsece', 'umeshreddy562', 'sayeshreddy', 'kirthirajan.1999', 'sairamkoneti444', 'a.sankar', 'deveshwaarece30', 'premamenon27']"
85,288,10,15,3,"['sayeshreddy', 'vickkyy', 'sauravsins']",6,"['kapileshwar', 'maaridinesh007', 'dprakashbhanu2000', 'riyazsherifaforever0729', 'kaivaramteja', 'deveshwaarece30']",12,"['pasamvenkatlokesh143', 'kandukurinsr', 'pandubabu819', 'praveenvenkat', 'umeshreddy562', 'pnagamohan2000', 'dileepkumarkc43', 'puttarushendranaidu', 'a.sankar', 'shaikabdulhafeez', None, 'kalyandv200']",21,"['maaridinesh007', 'vickkyy', 'praveenvenkat', 'pnagamohan2000', 'dprakashbhanu2000', 'dileepkumarkc43', 'riyazsherifaforever0729', 'kaivaramteja', 'shaikabdulhafeez', None, 'kapileshwar', 'pasamvenkatlokesh143', 'kandukurinsr', 'pandubabu819', 'umeshreddy562', 'sayeshreddy', 'puttarushendranaidu', 'a.sankar', 'deveshwaarece30', 'sauravsins', 'kalyandv200']"
85,290,10,14,6,"['kapileshwar', 'maaridinesh007', 'dprakashbhanu2000', 'riyazsherifaforever0729', 'kaivaramteja', 'deveshwaarece30']",3,"['sayeshreddy', 'vickkyy', 'sauravsins']",8,"['gunaselvaraj13579', 'praveenvenkat', 'srividya.ong', 'keerthanagprasad123', 'nagarjunabayinedi', 'dinesh1919', 'johnthesayan', None]",17,"['maaridinesh007', 'gunaselvaraj13579', 'vickkyy', 'praveenvenkat', 'srividya.ong', 'dprakashbhanu2000', 'riyazsherifaforever0729', 'johnthesayan', 'kaivaramteja', None, 'kapileshwar', 'sayeshreddy', 'keerthanagprasad123', 'nagarjunabayinedi', 'dinesh1919', 'deveshwaarece30', 'sauravsins']"
87,56,10,142,5,"['yashsavle', 'shwetakanoja', 'vidushirazdan1308', 'zotingsagar', 'abbas.barwaniwala']",4,"['vrindasinghal', 'jigar', '1jyotsna1', 'tanuj.udani']",137,"['nikperu007', 'nikhilchaudhari5516', 'harshalisawant92', 'omkar.chalke96', 'rajasiar1234', 'dmce123456789', 'h.vyas', 'darshana.mehta', 'sagarthool', 'sagargujar123', 'rahul.jethwa', 'akashupadhyay', 'rishi.mistry', 'aditya27', 'manalighorpade07', 'shreyahonagekar04', 'jugal.vaja', 'kssheetal2497', 'aditya.bhabhe', 'shivam.rs', 'sakshi.bhosle', 'singhamod111', 'chauhanajay4u', 'sachin.sc', 'sujittupe3490', 'rehan.mistry', 'mehulkharvi7', 'ranajay1997', 'pinak.p', 'bhushan0397', 'shrutik1997.mallick', 'ritesh0111', 'madhuriwawale13', 'shraddha0306', 'p_vasant', 'nehagurale10', 'vikramtirathkar96', 'kevin.z', 'yash.gulve', 'aditya.prnair', 'umeshlohote', 'jainamshah409', 'jagnoor.p', 'amey.mahadik98', 'kunalk4796', 'rajaskhasgiwale8497', 'prithvianvekar21', 'shubham.yelange', 'aladvait', 'arat.gouda', 'pranay.sadavarte', 'doobvoob', 'tejaskinage', 'k.siddhapura', 'vivek4238', 'jayshree90', 'apurvamirke29', 'kacharerohan', 'rutuja.mehta', 'arpanmodi2014', 'huzefa9702', 'adityajoy29', 'jay.km', 'shipra2', 'shubhada.shetti', 'divya.sawant17497', 'sakshi.trivedi', 'hitvena.shah', 'nikita.rp', 'shashankyadavade68', 'mehanshi.p', 'akankshapatil', 'rajat.p', 'gaurav24', 'nihal.raut', 'smahamulkar1013', 'shah.ns', 'slimshady', 'dilipramgir', 'maitrishah', 'goyalvishal147', 'saurabh.palde', 'karanshah16', 'zeevd19', 'arthaya.koyande28', 'prachi04', 'thakreshivam805', 'ankita.nd', 'kaustubhvaishampayan', 'nitin.lalwani', 'soham.sk', 'pranesha08', 'kalekajal2', 'perekarnk', 's.suvarna', 'harshal.bhole', 'spawar.ap', 'roy.shinde77', 'pranaykaranjekar28', 'shettynitin667', 'saadrahman.a', 'ssoneria7', 'd.haria', 'aashutoshkhapare22', 'darshana2504', 'swapnalidethe', 'rohithebbar10', 'aadi', 's.vohra', 'shreyasmoolya', 'kapil1410', 'adwaitnaik2', 'shahruchi', 'chakulipatil999', 'bhangaleprit', 'dhanshreeshawale', 'anushkaw055', 'rushabhkothari12', 'nayan_nanohub', 'yasir.mulla47', 'harish.c', None, 'apeksha.shinde', 'ninad.mulay', 'parin.ss', 'abhay.nadkarni', 'dishasaraiya', 'pranalim11', 'saurabhgawade.777.4.sg', 'yashshetye7', 'pranali', 'nitish_mishra', 'bhushanrsonawane1998', 'ameysawant25597', 'kumawatmukesh71', 'rahulbirwadkar123', 'shettysagar35']",146,"['nikperu007', 'nikhilchaudhari5516', 'harshalisawant92', 'omkar.chalke96', 'rajasiar1234', 'dmce123456789', 'h.vyas', 'darshana.mehta', 'sagarthool', 'sagargujar123', 'rahul.jethwa', 'akashupadhyay', 'rishi.mistry', 'aditya27', 'manalighorpade07', 'shreyahonagekar04', 'jugal.vaja', 'kssheetal2497', 'aditya.bhabhe', 'shivam.rs', 'sakshi.bhosle', 'singhamod111', 'chauhanajay4u', 'sachin.sc', 'sujittupe3490', 'tanuj.udani', 'rehan.mistry', 'mehulkharvi7', 'ranajay1997', 'pinak.p', 'bhushan0397', 'shrutik1997.mallick', 'ritesh0111', 'vidushirazdan1308', 'madhuriwawale13', 'shraddha0306', 'p_vasant', 'nehagurale10', 'vikramtirathkar96', 'kevin.z', 'yash.gulve', 'aditya.prnair', 'umeshlohote', 'jainamshah409', 'jagnoor.p', 'amey.mahadik98', 'kunalk4796', 'rajaskhasgiwale8497', 'prithvianvekar21', 'shubham.yelange', 'aladvait', 'arat.gouda', 'pranay.sadavarte', 'doobvoob', 'tejaskinage', 'k.siddhapura', 'vivek4238', 'jayshree90', 'apurvamirke29', 'kacharerohan', 'rutuja.mehta', 'arpanmodi2014', 'huzefa9702', 'adityajoy29', 'jay.km', 'shipra2', 'shubhada.shetti', 'divya.sawant17497', 'sakshi.trivedi', 'hitvena.shah', 'nikita.rp', 'zotingsagar', 'shashankyadavade68', 'mehanshi.p', 'yashsavle', 'akankshapatil', 'rajat.p', 'gaurav24', 'nihal.raut', 'smahamulkar1013', 'rahulbirwadkar123', 'shah.ns', 'slimshady', 'dilipramgir', 'maitrishah', 'goyalvishal147', 'saurabh.palde', 'karanshah16', 'zeevd19', 'arthaya.koyande28', 'prachi04', 'thakreshivam805', 'ankita.nd', 'kaustubhvaishampayan', 'nitin.lalwani', 'soham.sk', 'pranesha08', 'kalekajal2', 'jigar', 'perekarnk', 's.suvarna', 'harshal.bhole', 'spawar.ap', 'shwetakanoja', 'roy.shinde77', 'pranaykaranjekar28', 'shettynitin667', 'saadrahman.a', 'ssoneria7', '1jyotsna1', 'd.haria', 'aashutoshkhapare22', 'darshana2504', 'swapnalidethe', 'vrindasinghal', 'aadi', 's.vohra', 'shreyasmoolya', 'kapil1410', 'adwaitnaik2', 'shahruchi', 'chakulipatil999', 'bhangaleprit', 'dhanshreeshawale', 'anushkaw055', 'rushabhkothari12', 'nayan_nanohub', 'yasir.mulla47', 'abbas.barwaniwala', 'harish.c', None, 'apeksha.shinde', 'ninad.mulay', 'parin.ss', 'abhay.nadkarni', 'dishasaraiya', 'pranalim11', 'saurabhgawade.777.4.sg', 'yashshetye7', 'pranali', 'nitish_mishra', 'bhushanrsonawane1998', 'ameysawant25597', 'kumawatmukesh71', 'rohithebbar10', 'shettysagar35']"
87,167,10,12,4,"['abbas.barwaniwala', 'vrindasinghal', 'yashsavle', 'tanuj.udani']",5,"['shwetakanoja', 'vidushirazdan1308', '1jyotsna1', 'zotingsagar', 'jigar']",8,"['manalighorpade07', 'aditya.khopkar', 'ameysawant25597', 'rajas.khasgiwale', 'p_vasant', '2015suraj.daryapurkar', None, 'sagar.khuteta']",17,"['yashsavle', 'vrindasinghal', 'aditya.khopkar', 'vidushirazdan1308', 'p_vasant', 'abbas.barwaniwala', 'jigar', None, 'sagar.khuteta', 'manalighorpade07', 'shwetakanoja', 'ameysawant25597', 'rajas.khasgiwale', '1jyotsna1', 'zotingsagar', '2015suraj.daryapurkar', 'tanuj.udani']"
87,169,10,12,5,"['shwetakanoja', 'vrindasinghal', 'vidushirazdan1308', 'zotingsagar', 'abbas.barwaniwala']",4,"['1jyotsna1', 'jigar', 'yashsavle', 'tanuj.udani']",7,"['jayshree90', 'adithyar697', 'sawantdivya', 'p_vasant', None, 'nitin.shetty', 'kapil1410']",16,"['yashsavle', 'vrindasinghal', 'vidushirazdan1308', 'p_vasant', 'abbas.barwaniwala', 'jigar', 'nitin.shetty', None, 'kapil1410', 'shwetakanoja', 'jayshree90', 'adithyar697', 'sawantdivya', '1jyotsna1', 'zotingsagar', 'tanuj.udani']"
87,59,10,8,2,"['shwetakanoja', 'vidushirazdan1308']",7,"['yashsavle', 'vrindasinghal', '1jyotsna1', 'zotingsagar', 'abbas.barwaniwala', 'jigar', 'tanuj.udani']",6,"['zotingsagar1', 'gaurav24', 'vyardly94', None, 'amey.mahadik98', 'kapil1410']",15,"['zotingsagar1', 'kapil1410', 'yashsavle', 'shwetakanoja', 'vrindasinghal', 'gaurav24', 'vyardly94', 'vidushirazdan1308', '1jyotsna1', 'zotingsagar', 'abbas.barwaniwala', None, 'jigar', 'amey.mahadik98', 'tanuj.udani']"
87,166,10,6,2,"['yashsavle', 'tanuj.udani']",7,"['shwetakanoja', 'vrindasinghal', 'vidushirazdan1308', '1jyotsna1', 'zotingsagar', 'abbas.barwaniwala', 'jigar']",4,"['naval29', None, 'varunj331', 'prp23dec']",13,"['yashsavle', 'shwetakanoja', 'vrindasinghal', 'vidushirazdan1308', 'prp23dec', 'varunj331', '1jyotsna1', 'zotingsagar', 'naval29', 'abbas.barwaniwala', None, 'jigar', 'tanuj.udani']"
87,168,10,6,2,"['abbas.barwaniwala', 'vrindasinghal']",7,"['yashsavle', 'shwetakanoja', 'vidushirazdan1308', '1jyotsna1', 'zotingsagar', 'jigar', 'tanuj.udani']",4,"['2015suraj.daryapurkar', None, 'jayshree90', 'p_vasant']",13,"['2015suraj.daryapurkar', 'yashsavle', 'shwetakanoja', 'vrindasinghal', 'jayshree90', 'vidushirazdan1308', '1jyotsna1', 'p_vasant', 'zotingsagar', 'abbas.barwaniwala', None, 'jigar', 'tanuj.udani']"
88,111,10,35,4,"['linkiano', 'camilo0868', 'andysanty', 'davidru.dr3']",5,"['xormus', 'rbor93', 'kyle0johnston', 'ayyubj', 'alinder']",31,"['julianberonn', 'camilo0869', 'vb.herrera', 'jeisson1299', 'mozomiguel73', 'lautmusicmois', 'armentasantiago', 'ad.gregory', 's.villamilp', 'libardo11chapal', 'anderpensilva', 'juan98', 'juanpbotero9897', 'sebas.villaba2002', 'nataliaramos3', 'alesk1208', 'felipe_hdz', 'kevinbernalru', 'solerjavier7', 'ayalagamezn', 'mugnier', 'v.cardonac1', 'nicolash025', 'maria.a.solano.otero', None, 'juliortegon', 'tosaleal', 'md.quintero', 'juanguerron', 'daniel2809', 'jaardila']",40,"['andysanty', 'julianberonn', 'camilo0869', 'vb.herrera', 'jeisson1299', 'mozomiguel73', 'lautmusicmois', 'armentasantiago', 'ad.gregory', 's.villamilp', 'davidru.dr3', 'kyle0johnston', 'camilo0868', 'libardo11chapal', 'anderpensilva', 'juan98', 'alinder', 'juanpbotero9897', 'sebas.villaba2002', 'nataliaramos3', 'alesk1208', 'xormus', 'felipe_hdz', 'linkiano', 'kevinbernalru', 'solerjavier7', 'ayalagamezn', 'ayyubj', 'mugnier', 'v.cardonac1', 'nicolash025', 'maria.a.solano.otero', None, 'juliortegon', 'tosaleal', 'md.quintero', 'rbor93', 'juanguerron', 'daniel2809', 'jaardila']"
90,214,10,8,7,"['gavinlow', 'delaneydeanna', 'roses20', 'jvoeller6', 'shenanigans503', 'gmunster', 'osterberg']",2,"['griffinc', 'victorbnguyen']",1,[None],10,"['delaneydeanna', 'gavinlow', 'griffinc', 'roses20', 'victorbnguyen', 'jvoeller6', 'shenanigans503', 'gmunster', None, 'osterberg']"
91,116,10,36,9,"['oterry', 'tfloyd', 'whobby', 'sfick', 'bdester', 'jcrouss', 'mjaffe', 'fpanikov', 'aeshak']",0,[],27,"['vmouradian', 'komminiadithya', 'emunguia', 'dgabriel', 'opin', 'aksamija', 'ayen', 'jgnall', 'mskaza', 'ltweston', 'aphauser', 'rwbrown', 'cmkennedy', 'angusmo', 'jkvaternik', 'menglingshi', 'dperry', 'adonadio', None, 'ajewers', 'jaandrade', 'tinamaurer', 'bdeguire', 'jrosborne', 'rcperkins', 'msokolov', 'inorman']",36,"['vmouradian', 'komminiadithya', 'jcrouss', 'emunguia', 'dgabriel', 'opin', 'aksamija', 'jgnall', 'ayen', 'mskaza', 'ltweston', 'msokolov', 'bdester', 'aphauser', 'rwbrown', 'mjaffe', 'cmkennedy', 'angusmo', 'sfick', 'jkvaternik', 'menglingshi', 'dperry', 'fpanikov', 'adonadio', None, 'oterry', 'tfloyd', 'whobby', 'ajewers', 'jaandrade', 'jrosborne', 'bdeguire', 'tinamaurer', 'rcperkins', 'aeshak', 'inorman']"
91,157,10,27,6,"['oterry', 'tfloyd', 'sfick', 'jcrouss', 'mjaffe', 'fpanikov']",3,"['whobby', 'aeshak', 'bdester']",21,"['komminiadithya', 'cdunnington', 'aleckchen', 'ayen', 'asanmiguel', 'ltweston', 'matthewsarge', 'ranonyai', 'kmcwherter', 'angusmo', 'jkvaternik', 'menglingshi', 'mlaszcz', 'yongjieyang', None, 'ajewers', 'jaandrade', 'tinamaurer', 'bdeguire', 'tgerstel', 'zoudngdng']",30,"['komminiadithya', 'aleckchen', 'jcrouss', 'cdunnington', 'ayen', 'asanmiguel', 'ltweston', 'bdester', 'matthewsarge', 'mjaffe', 'ranonyai', 'kmcwherter', 'angusmo', 'sfick', 'jkvaternik', 'menglingshi', 'mlaszcz', 'fpanikov', 'yongjieyang', None, 'oterry', 'tfloyd', 'whobby', 'ajewers', 'jaandrade', 'bdeguire', 'tinamaurer', 'tgerstel', 'aeshak', 'zoudngdng']"
91,347,10,27,8,"['oterry', 'tfloyd', 'sfick', 'jcrouss', 'bdester', 'mjaffe', 'fpanikov', 'aeshak']",1,['whobby'],19,"['komminiadithya', 'cdunnington', 'aksamija', 'opin', 'jgnall', 'asanmiguel', 'mskaza', 'matthewsarge', 'rwbrown', 'ranonyai', 'angusmo', None, 'siddharthasr', 'ajewers', 'tinamaurer', 'bdeguire', 'jrosborne', 'rcperkins', 'msokolov']",28,"['komminiadithya', 'cdunnington', 'jcrouss', 'aksamija', 'opin', 'jgnall', 'asanmiguel', 'mskaza', 'msokolov', 'bdester', 'matthewsarge', 'rwbrown', 'mjaffe', 'ranonyai', 'angusmo', 'sfick', 'fpanikov', None, 'siddharthasr', 'oterry', 'tfloyd', 'whobby', 'ajewers', 'tinamaurer', 'bdeguire', 'jrosborne', 'rcperkins', 'aeshak']"
91,218,10,18,2,"['aeshak', 'bdester']",7,"['oterry', 'tfloyd', 'whobby', 'sfick', 'jcrouss', 'mjaffe', 'fpanikov']",16,"['angusmo', 'jgnall', 'vmouradian', 'ajewers', 'tinamaurer', 'alessy.leblanc', 'bdeguire', 'matthewsarge', 'jrosborne', 'mconsigli', 'jkvaternik', 'menglingshi', 'rwbrown', 'ayen', 'ranonyai', None]",25,"['angusmo', 'vmouradian', 'alessy.leblanc', 'sfick', 'jcrouss', 'jkvaternik', 'menglingshi', 'fpanikov', 'ayen', 'jgnall', None, 'oterry', 'tfloyd', 'whobby', 'ajewers', 'tinamaurer', 'bdester', 'bdeguire', 'matthewsarge', 'jrosborne', 'mconsigli', 'rwbrown', 'mjaffe', 'ranonyai', 'aeshak']"
91,151,10,11,2,"['tfloyd', 'jcrouss']",7,"['oterry', 'whobby', 'sfick', 'bdester', 'mjaffe', 'fpanikov', 'aeshak']",9,"['zoudngdng', 'ajewers', 'asanmiguel', 'cdunnington', 'menglingshi', 'ranonyai', None, 'yongjieyang', 'kmcwherter']",18,"['sfick', 'cdunnington', 'jcrouss', 'menglingshi', 'fpanikov', None, 'asanmiguel', 'zoudngdng', 'oterry', 'tfloyd', 'whobby', 'ajewers', 'bdester', 'mjaffe', 'ranonyai', 'aeshak', 'yongjieyang', 'kmcwherter']"
91,119,10,8,3,"['fpanikov', 'whobby', 'bdester']",6,"['oterry', 'tfloyd', 'sfick', 'jcrouss', 'mjaffe', 'aeshak']",5,"['jrosborne', 'apaulo', 'jkvaternik', 'mlaszcz', None]",14,"['oterry', 'tfloyd', 'whobby', 'sfick', 'bdester', 'jcrouss', 'jrosborne', 'apaulo', 'jkvaternik', 'mjaffe', 'mlaszcz', 'fpanikov', None, 'aeshak']"
91,158,10,7,2,"['fpanikov', 'whobby']",7,"['oterry', 'tfloyd', 'sfick', 'jcrouss', 'bdester', 'mjaffe', 'aeshak']",5,"['jrosborne', 'jkvaternik', 'mlaszcz', 'jgnall', None]",14,"['jgnall', 'oterry', 'tfloyd', 'whobby', 'sfick', 'bdester', 'jcrouss', 'jrosborne', 'jkvaternik', 'mjaffe', 'mlaszcz', 'fpanikov', None, 'aeshak']"
92,99,9,20,1,['sadaf.surve'],7,"['chinmayutekar8', 'sneha.dornala', 'arnikakp30', 'dhaneshmistry6', 'surbhitondwalkar', 'auramusiccompany', 'shubham7']",19,"['pillaishantanu', 'manishshingade31', 'ajaymohite15', 'rushabhgudekar', 'sidrah.khan', 'shreeyashthorat24', 'riddhijet7', 'murtaza.indorewala95', 'lllaxmanh', 'sahilnaidu.2016', None, 'amogh.angre', 'gawade.tanmay.tg', 'pgonbare55', 'asktej143', 'sagargujral61', 'ankitadrave97', 'rutujakurdhundkar', 'neha.nibre']",27,"['chinmayutekar8', 'arnikakp30', 'pillaishantanu', 'lllaxmanh', 'shreeyashthorat24', 'auramusiccompany', 'manishshingade31', 'sahilnaidu.2016', 'neha.nibre', None, 'ajaymohite15', 'amogh.angre', 'gawade.tanmay.tg', 'sneha.dornala', 'pgonbare55', 'sadaf.surve', 'asktej143', 'rushabhgudekar', 'sagargujral61', 'dhaneshmistry6', 'surbhitondwalkar', 'sidrah.khan', 'shubham7', 'riddhijet7', 'rutujakurdhundkar', 'murtaza.indorewala95', 'ankitadrave97']"
92,274,9,16,1,['sadaf.surve'],7,"['chinmayutekar8', 'sneha.dornala', 'arnikakp30', 'dhaneshmistry6', 'surbhitondwalkar', 'auramusiccompany', 'shubham7']",15,"['gawade.tanmay.tg', 'pgonbare55', 'asktej143', 'rushabhgudekar', 'lllaxmanh', 'pillaishantanu', 'ajaymohite15', 'sidrah.khan', 'manishshingade31', 'riddhijet7', 'rutujakurdhundkar', 'neha.nibre', None, 'sahilnaidu.2016', 'ankitadrave97']",23,"['chinmayutekar8', 'arnikakp30', 'lllaxmanh', 'pillaishantanu', 'auramusiccompany', 'manishshingade31', 'sahilnaidu.2016', 'neha.nibre', None, 'ajaymohite15', 'gawade.tanmay.tg', 'sneha.dornala', 'pgonbare55', 'sadaf.surve', 'asktej143', 'rushabhgudekar', 'dhaneshmistry6', 'surbhitondwalkar', 'sidrah.khan', 'shubham7', 'riddhijet7', 'rutujakurdhundkar', 'ankitadrave97']"
92,205,9,15,8,"['chinmayutekar8', 'sneha.dornala', 'sadaf.surve', 'arnikakp30', 'dhaneshmistry6', 'surbhitondwalkar', 'auramusiccompany', 'shubham7']",0,[],7,"['kadamp382', 'asktej143', 'jainkunal2019', 'pillaishantanu', 'mayanksamar786', 'diydiy6363', None]",15,"['kadamp382', 'chinmayutekar8', 'arnikakp30', 'pillaishantanu', 'mayanksamar786', 'auramusiccompany', None, 'sneha.dornala', 'sadaf.surve', 'asktej143', 'jainkunal2019', 'dhaneshmistry6', 'surbhitondwalkar', 'shubham7', 'diydiy6363']"
92,97,9,13,7,"['chinmayutekar8', 'sneha.dornala', 'arnikakp30', 'dhaneshmistry6', 'surbhitondwalkar', 'auramusiccompany', 'shubham7']",1,['sadaf.surve'],6,"['kadamp382', 'jainkunal2019', 'pillaishantanu', 'mayanksamar786', 'diydiy6363', None]",14,"['kadamp382', 'chinmayutekar8', 'arnikakp30', 'pillaishantanu', 'mayanksamar786', 'auramusiccompany', None, 'sneha.dornala', 'sadaf.surve', 'jainkunal2019', 'dhaneshmistry6', 'surbhitondwalkar', 'shubham7', 'diydiy6363']"
92,269,9,13,8,"['chinmayutekar8', 'sneha.dornala', 'sadaf.surve', 'arnikakp30', 'dhaneshmistry6', 'surbhitondwalkar', 'auramusiccompany', 'shubham7']",0,[],5,"['asktej143', 'pillaishantanu', 'mayanksamar786', 'diydiy6363', None]",13,"['chinmayutekar8', 'arnikakp30', 'pillaishantanu', 'mayanksamar786', 'auramusiccompany', None, 'sneha.dornala', 'sadaf.surve', 'asktej143', 'dhaneshmistry6', 'surbhitondwalkar', 'shubham7', 'diydiy6363']"
92,98,9,7,5,"['sadaf.surve', 'arnikakp30', 'dhaneshmistry6', 'surbhitondwalkar', 'auramusiccompany']",3,"['chinmayutekar8', 'sneha.dornala', 'shubham7']",2,"['asktej143', None]",10,"['chinmayutekar8', 'sneha.dornala', 'sadaf.surve', 'asktej143', 'arnikakp30', 'dhaneshmistry6', 'surbhitondwalkar', 'auramusiccompany', 'shubham7', None]"
93,56,9,142,8,"['pranay.sadavarte', 'harshalisawant92', 'anushkaw055', 'rajaskhasgiwale8497', 'shahruchi', 'karanshah16', 'madhuriwawale13', 'akashupadhyay']",0,[],134,"['nikperu007', 'nikhilchaudhari5516', 'omkar.chalke96', 'rajasiar1234', 'dmce123456789', 'h.vyas', 'darshana.mehta', 'sagarthool', 'sagargujar123', 'rahul.jethwa', 'rishi.mistry', 'aditya27', 'manalighorpade07', 'shreyahonagekar04', 'jugal.vaja', 'kssheetal2497', 'aditya.bhabhe', 'shivam.rs', 'sakshi.bhosle', 'singhamod111', 'chauhanajay4u', 'sachin.sc', 'sujittupe3490', 'rehan.mistry', 'mehulkharvi7', 'ranajay1997', 'pinak.p', 'bhushan0397', 'shrutik1997.mallick', 'ritesh0111', 'vidushirazdan1308', 'shraddha0306', 'p_vasant', 'nehagurale10', 'vikramtirathkar96', 'kevin.z', 'yash.gulve', 'aditya.prnair', 'umeshlohote', 'jainamshah409', 'jagnoor.p', 'amey.mahadik98', 'kunalk4796', 'prithvianvekar21', 'shubham.yelange', 'aladvait', 'arat.gouda', 'doobvoob', 'tejaskinage', 'k.siddhapura', 'vivek4238', 'jayshree90', 'apurvamirke29', 'kacharerohan', 'rutuja.mehta', 'arpanmodi2014', 'huzefa9702', 'adityajoy29', 'jay.km', 'shipra2', 'shubhada.shetti', 'divya.sawant17497', 'sakshi.trivedi', 'hitvena.shah', 'nikita.rp', 'zotingsagar', 'shashankyadavade68', 'mehanshi.p', 'yashsavle', 'akankshapatil', 'rajat.p', 'gaurav24', 'nihal.raut', 'smahamulkar1013', 'shah.ns', 'slimshady', 'dilipramgir', 'maitrishah', 'goyalvishal147', 'saurabh.palde', 'zeevd19', 'arthaya.koyande28', 'prachi04', 'thakreshivam805', 'ankita.nd', 'kaustubhvaishampayan', 'nitin.lalwani', 'soham.sk', 'pranesha08', 'kalekajal2', 'perekarnk', 's.suvarna', 'harshal.bhole', 'spawar.ap', 'shwetakanoja', 'roy.shinde77', 'pranaykaranjekar28', 'shettynitin667', 'saadrahman.a', 'ssoneria7', 'd.haria', 'aashutoshkhapare22', 'darshana2504', 'swapnalidethe', 'rohithebbar10', 'aadi', 's.vohra', 'shreyasmoolya', 'kapil1410', 'adwaitnaik2', 'chakulipatil999', 'bhangaleprit', 'dhanshreeshawale', 'rushabhkothari12', 'nayan_nanohub', 'yasir.mulla47', 'abbas.barwaniwala', 'harish.c', None, 'apeksha.shinde', 'ninad.mulay', 'parin.ss', 'abhay.nadkarni', 'dishasaraiya', 'pranalim11', 'saurabhgawade.777.4.sg', 'yashshetye7', 'pranali', 'nitish_mishra', 'bhushanrsonawane1998', 'ameysawant25597', 'kumawatmukesh71', 'rahulbirwadkar123', 'shettysagar35']",142,"['nikperu007', 'nikhilchaudhari5516', 'harshalisawant92', 'omkar.chalke96', 'rajasiar1234', 'dmce123456789', 'h.vyas', 'darshana.mehta', 'sagarthool', 'sagargujar123', 'rahul.jethwa', 'akashupadhyay', 'rishi.mistry', 'aditya27', 'manalighorpade07', 'shreyahonagekar04', 'jugal.vaja', 'kssheetal2497', 'aditya.bhabhe', 'shivam.rs', 'sakshi.bhosle', 'singhamod111', 'chauhanajay4u', 'sachin.sc', 'sujittupe3490', 'rehan.mistry', 'mehulkharvi7', 'ranajay1997', 'pinak.p', 'bhushan0397', 'shrutik1997.mallick', 'ritesh0111', 'vidushirazdan1308', 'madhuriwawale13', 'shraddha0306', 'p_vasant', 'nehagurale10', 'vikramtirathkar96', 'kevin.z', 'yash.gulve', 'aditya.prnair', 'umeshlohote', 'jainamshah409', 'jagnoor.p', 'amey.mahadik98', 'kunalk4796', 'rajaskhasgiwale8497', 'prithvianvekar21', 'shubham.yelange', 'aladvait', 'arat.gouda', 'pranay.sadavarte', 'doobvoob', 'tejaskinage', 'k.siddhapura', 'vivek4238', 'jayshree90', 'apurvamirke29', 'kacharerohan', 'rutuja.mehta', 'arpanmodi2014', 'huzefa9702', 'adityajoy29', 'jay.km', 'shipra2', 'shubhada.shetti', 'divya.sawant17497', 'sakshi.trivedi', 'hitvena.shah', 'nikita.rp', 'zotingsagar', 'shashankyadavade68', 'mehanshi.p', 'yashsavle', 'akankshapatil', 'rajat.p', 'gaurav24', 'nihal.raut', 'smahamulkar1013', 'rahulbirwadkar123', 'shah.ns', 'slimshady', 'dilipramgir', 'maitrishah', 'goyalvishal147', 'karanshah16', 'saurabh.palde', 'zeevd19', 'arthaya.koyande28', 'prachi04', 'thakreshivam805', 'ankita.nd', 'kaustubhvaishampayan', 'nitin.lalwani', 'soham.sk', 'pranesha08', 'kalekajal2', 'perekarnk', 's.suvarna', 'harshal.bhole', 'spawar.ap', 'shwetakanoja', 'roy.shinde77', 'pranaykaranjekar28', 'shettynitin667', 'saadrahman.a', 'ssoneria7', 'd.haria', 'aashutoshkhapare22', 'darshana2504', 'swapnalidethe', 'aadi', 's.vohra', 'shreyasmoolya', 'kapil1410', 'adwaitnaik2', 'shahruchi', 'chakulipatil999', 'bhangaleprit', 'dhanshreeshawale', 'anushkaw055', 'rushabhkothari12', 'nayan_nanohub', 'yasir.mulla47', 'abbas.barwaniwala', 'harish.c', None, 'apeksha.shinde', 'ninad.mulay', 'parin.ss', 'abhay.nadkarni', 'dishasaraiya', 'pranalim11', 'saurabhgawade.777.4.sg', 'yashshetye7', 'pranali', 'nitish_mishra', 'bhushanrsonawane1998', 'ameysawant25597', 'kumawatmukesh71', 'rohithebbar10', 'shettysagar35']"
94,389,9,34,1,['saruttaya_love'],7,"['briscoej3', 'eddie93jw', 'vinskoj', 'ruemenaj', 'barnessa', 'lawsonbe', 'berezeol']",33,"['supichayajune14', 'phacharapon1999', 'milkjarin', 'tanapon_hirunkham', 'raemyaowaret', 'nknitchakan', 'por.101041.prasat', 'battlelogongame', 'sungputpong', 'sedtee_fay', 'piper.color.nn', 'patharabhornkhamket', 'pattaweeboonmak', 'kanokwan', 'kornchada', 'punyanut.nong', 'thinktong_231141', 'wuyifernnn', 'wuttirat_boonkaew', 'nuttaponka', 'nammon.m', None, 'pansawunya', 'i.o0850091121', 'davidnaja', 'poo_p101', 'pang.pang30', 'fan080170', 'nitisartnupangtha', '40926wannapa', 'nanasung', '150_cm', 'lalita.namsri']",41,"['supichayajune14', 'briscoej3', 'phacharapon1999', 'vinskoj', 'milkjarin', 'lawsonbe', 'tanapon_hirunkham', 'raemyaowaret', 'saruttaya_love', 'nknitchakan', 'por.101041.prasat', 'battlelogongame', 'sungputpong', 'barnessa', 'sedtee_fay', 'piper.color.nn', 'patharabhornkhamket', 'pattaweeboonmak', 'kanokwan', 'eddie93jw', 'kornchada', 'punyanut.nong', 'thinktong_231141', 'wuyifernnn', 'ruemenaj', 'wuttirat_boonkaew', 'nuttaponka', 'nammon.m', None, 'pansawunya', 'i.o0850091121', 'davidnaja', 'poo_p101', 'pang.pang30', 'fan080170', 'nitisartnupangtha', '40926wannapa', 'nanasung', '150_cm', 'lalita.namsri', 'berezeol']"
94,388,9,30,1,['saruttaya_love'],7,"['briscoej3', 'eddie93jw', 'vinskoj', 'ruemenaj', 'barnessa', 'lawsonbe', 'berezeol']",29,"['supichayajune14', 'phacharapon1999', 'tortrkool.s', 'tanapon_hirunkham', 'emm_emmypan', 'por.101041.prasat', 'salingy', 'tpuangmali', 'battlelogongame', 'koonnink1', 'sedtee_fay', 'patharabhornkhamket', 'pattaweeboonmak', 'kanokwan', 'thinktong_231141', 'fluk.flic', 'wuyifernnn', 'wuttirat_boonkaew', 'nuttaponka', None, 'nammon.m', 'i.o0850091121', 'poo_p101', 'pang.pang30', 'fan080170', 'nitisartnupangtha', '40926wannapa', 'nanasung', 'lalita.namsri']",37,"['supichayajune14', 'briscoej3', 'phacharapon1999', 'tortrkool.s', 'vinskoj', 'lawsonbe', 'tanapon_hirunkham', 'emm_emmypan', 'saruttaya_love', 'por.101041.prasat', 'salingy', 'tpuangmali', 'battlelogongame', 'koonnink1', 'barnessa', 'sedtee_fay', 'patharabhornkhamket', 'pattaweeboonmak', 'kanokwan', 'eddie93jw', 'thinktong_231141', 'fluk.flic', 'wuyifernnn', 'ruemenaj', 'wuttirat_boonkaew', 'nuttaponka', None, 'nammon.m', 'i.o0850091121', 'poo_p101', 'pang.pang30', 'fan080170', 'nitisartnupangtha', '40926wannapa', 'nanasung', 'lalita.namsri', 'berezeol']"
94,390,9,14,1,['saruttaya_love'],7,"['briscoej3', 'eddie93jw', 'vinskoj', 'ruemenaj', 'barnessa', 'lawsonbe', 'berezeol']",13,"['raemyaowaret', 'i.o0850091121', 'davidnaja', 'nammon.m', 'por.101041.prasat', 'punyanut.nong', 'poo_p101', 'nitisartnupangtha', 'kornchada', 'battlelogongame', 'lalita.namsri', None, 'suphawan_']",21,"['lalita.namsri', 'briscoej3', 'suphawan_', 'eddie93jw', 'punyanut.nong', 'kornchada', 'ruemenaj', 'vinskoj', 'lawsonbe', None, 'nammon.m', 'raemyaowaret', 'i.o0850091121', 'davidnaja', 'saruttaya_love', 'por.101041.prasat', 'poo_p101', 'nitisartnupangtha', 'battlelogongame', 'barnessa', 'berezeol']"
94,387,9,11,7,"['briscoej3', 'eddie93jw', 'vinskoj', 'ruemenaj', 'barnessa', 'lawsonbe', 'berezeol']",1,['saruttaya_love'],4,"['benlawson8507', 'simsan', None, 'mike10rivera']",12,"['briscoej3', 'eddie93jw', 'ruemenaj', 'vinskoj', 'lawsonbe', None, 'mike10rivera', 'saruttaya_love', 'simsan', 'barnessa', 'berezeol', 'benlawson8507']"
94,415,9,9,7,"['briscoej3', 'eddie93jw', 'vinskoj', 'ruemenaj', 'barnessa', 'lawsonbe', 'berezeol']",1,['saruttaya_love'],2,"['jiaolh', None]",10,"['jiaolh', 'briscoej3', None, 'saruttaya_love', 'eddie93jw', 'barnessa', 'ruemenaj', 'vinskoj', 'lawsonbe', 'berezeol']"
96,164,9,33,8,"['manyam.soumith.16cse', 'ande.varun.16ece', 'raghavendra.sinha.16ece', 'pooja.madireddy.16ece', 'msaibhavani99', 'himanshi', 'sinha.raghav199801', 'sai.99madhav']",0,[],25,"['konkimallasumanth', 'karthikpinnelli5', 'ashish.sharma.16ece', 'sakethsolasa1999', 'snehyajnik77777', 'vvardhan660', 'abhinavsingh10', 'imtiazshaik18', 'srikarkodavati99', 'warlock', 'bharath_varma', 'kshitizomar', 'kakkiralapavankumar', 'sasi.kiran.16ece', 'kaushikyerukonda', 'praneethmutta', 'ramdhungana1999', 'meghna.goel.16ece', None, 'sashank.1999', 'kaushik11', 'twinklegoel138', 'ram.dhungana.16ece', 'gupta.bhavishya1998', 'poojitha.bathini.16ece']",33,"['raghavendra.sinha.16ece', 'pooja.madireddy.16ece', 'konkimallasumanth', 'karthikpinnelli5', 'ashish.sharma.16ece', 'sakethsolasa1999', 'snehyajnik77777', 'vvardhan660', 'abhinavsingh10', 'imtiazshaik18', 'srikarkodavati99', 'warlock', 'bharath_varma', 'kshitizomar', 'kakkiralapavankumar', 'msaibhavani99', 'kaushikyerukonda', 'sasi.kiran.16ece', 'praneethmutta', 'ramdhungana1999', 'sinha.raghav199801', 'meghna.goel.16ece', None, 'sashank.1999', 'kaushik11', 'manyam.soumith.16cse', 'ande.varun.16ece', 'twinklegoel138', 'ram.dhungana.16ece', 'himanshi', 'gupta.bhavishya1998', 'sai.99madhav', 'poojitha.bathini.16ece']"
96,225,9,24,8,"['manyam.soumith.16cse', 'ande.varun.16ece', 'raghavendra.sinha.16ece', 'pooja.madireddy.16ece', 'msaibhavani99', 'himanshi', 'sinha.raghav199801', 'sai.99madhav']",0,[],16,"['vvardhan660', 'sai.vijay.16ece', 'bharath_varma', 'kshitizomar', 'avinike18', 'thakkallaplli.shashider.16ece', 'vojjala.pranav.16ece', 'kakkiralapavankumar', 'ram.dhungana.16ece', 'konkimallasumanth', 'kaushikyerukonda', 'maturi.bahavana.16ece', 'praneethmutta', 'sakethsolasa1999', None, 'sashank.1999']",24,"['sai.vijay.16ece', 'raghavendra.sinha.16ece', 'pooja.madireddy.16ece', 'vojjala.pranav.16ece', 'konkimallasumanth', 'sakethsolasa1999', 'vvardhan660', 'bharath_varma', 'kshitizomar', 'avinike18', 'kakkiralapavankumar', 'msaibhavani99', 'kaushikyerukonda', 'maturi.bahavana.16ece', 'praneethmutta', 'sinha.raghav199801', None, 'thakkallaplli.shashider.16ece', 'sashank.1999', 'manyam.soumith.16cse', 'ande.varun.16ece', 'ram.dhungana.16ece', 'himanshi', 'sai.99madhav']"
96,241,9,18,8,"['manyam.soumith.16cse', 'ande.varun.16ece', 'raghavendra.sinha.16ece', 'pooja.madireddy.16ece', 'msaibhavani99', 'himanshi', 'sinha.raghav199801', 'sai.99madhav']",0,[],10,"['avinike18', 'abhinavsingh10', 'twinklegoel138', 'konkimallasumanth', 'karthikpinnelli5', 'ashish.sharma.16ece', 'srikarkodavati99', 'maturi.bahavana.16ece', 'sakethsolasa1999', None]",18,"['raghavendra.sinha.16ece', 'pooja.madireddy.16ece', 'avinike18', 'msaibhavani99', 'konkimallasumanth', 'karthikpinnelli5', 'ashish.sharma.16ece', 'maturi.bahavana.16ece', 'sinha.raghav199801', 'sakethsolasa1999', None, 'manyam.soumith.16cse', 'ande.varun.16ece', 'twinklegoel138', 'abhinavsingh10', 'himanshi', 'srikarkodavati99', 'sai.99madhav']"
98,138,9,140,5,"['k.rajagopalreddy33', 'mrprnv', 'pavankumarreddyalamuri', 'pallamalavamsi123', 'harinid176']",3,"['uttejthumati99', '9940210291a', 'harshareddy']",135,"['karthikbajjuri05', 'kotapati.venkatanaveen', 'karthiknvv1999', 'indub', 'bellala9182', 'mdevendrareddy21', 'pradeepsanapala22', 'nandisrividya123', 'settysucharitha', 'preethippin.r', 'amrutha3366', 'saileshcruzzer', 'athish_m', 'naveen6052531', 'adityakondragunta7', 'prasadsai481', 'jyotsnaasari15', 'elango.vit', 'pujithapuny', 'bhargavijolly2000', 'gurakalasravanisravs', 'shivakumar1999', 'rajasekhar.j33', 'gpindrani', 'dharma879reddy', 'sakethchinna424', 'chinna143', 'gundlapallecharanya', 'preethi2', 'rahuljayanthi83', 'bathalasailu555it', 'rajeshkumaripg1', 'gsaimanikanta1234', 'thummala.naveen47', 'jahnavi703', 'alaikvenumadhav', 'krmohithchinnu248', 'mercyevangelin03', 'kirthikaug1', 'mounika.punati07', 'lingamallika00', 'raju1408gopi', 'lalithyareddy9', 'saikumarkanisetty525', 'jaswanth521999', 'swetha.yerabapu', 'ruthalasaisujay2000', 'renusreekarnam', 'vjvijay1999', 'dhanalakshmidnvs', 'shaikfayazaashiq', 'poojipenubolu8', 'sridharamjayashree5274', 'kovvurisesha', 'bhargavibharu9876', 'saleema', 'vaisnavikv', 'balajiluminasree', 'saitejaswi2210', 'sathesh.m', 'teddy4u2015', 'ysvrnv', 'praveenkella2299', 'sreenusree1789', 'rajeev7032', 'palletiharsha777', 'segumahesh', 'haranadh11', 'narayanareddy1666', 'divyalathamidhun12', 'kotakondaarunteja', 'chekuripradeep888', 'sumanth.bingi139', 'sravanthijai1999', 'gopijettiboyina841', 'suryaboddupalli.3216', 'upendravalleti', 'kbharggav721', 'saikiran89131', 'kamlesh_', 'bandiramya2000', 'deepakarunannamalai', 'jonahjoni7', 'chaithualadi', 'saiviswa9595', 'chillavishnuvardhan1234', 'pravallika', 'abbasmanthri904', 'gunasekharreddy.thummala', 'kalyanamsubhash65', 'vrprasanna38118114', 'sukanyacheruvu30', 'rajareddy9052', 'shaikbajithun', 'penchalaprasanna2000', 'venkateshreddy69', 'saicharangayathri66', 'reshmaraju', 'suresh339', 'dharanicheeda', 'alexandra', 'paulina.gollapudi', 'anu27111999', 'surendar2042', 'chekkatchyutkumar', 'bhavyapreethi24', 'sugansugumar55', 'pharipriyapriya9445', 'akhilchandaka111', 'studychennaiv4u', 'nivetha', 'rakesh.969550', 'jeevanmorkelnttf', 'sandhyareddy', 'gayu_kutty', 'princerafi588', 'kundasrinivasulu55', 'swaroop6055', 'sainikhilgodl', 'rajenjoy25', 'vishnupriya', 'sreenivassree0143', 'manjuladrp', 'gnanasekharmani2000', None, 'katlatipavani666', 'sivabapatu123', 'tejateja1574', 'nanoelectronicsece', 'krushithakrishna1212', 'susmithainturi02', 'bashasameerbasha', 'vsswathiraj2017', 'lavanyavarapana111', 'lakshmipunati02']",143,"['karthikbajjuri05', 'kotapati.venkatanaveen', 'karthiknvv1999', 'indub', 'bellala9182', 'mdevendrareddy21', 'pradeepsanapala22', 'nandisrividya123', 'settysucharitha', 'preethippin.r', 'amrutha3366', 'pallamalavamsi123', 'saileshcruzzer', 'athish_m', 'naveen6052531', 'adityakondragunta7', 'prasadsai481', 'jyotsnaasari15', 'elango.vit', 'pujithapuny', 'bhargavijolly2000', 'pavankumarreddyalamuri', 'gurakalasravanisravs', 'shivakumar1999', 'harshareddy', 'rajasekhar.j33', 'gpindrani', 'dharma879reddy', 'sakethchinna424', 'chinna143', 'gundlapallecharanya', 'preethi2', 'rahuljayanthi83', 'bathalasailu555it', 'rajeshkumaripg1', 'gsaimanikanta1234', 'thummala.naveen47', 'jahnavi703', 'alaikvenumadhav', 'krmohithchinnu248', 'mercyevangelin03', 'kirthikaug1', 'mounika.punati07', 'lingamallika00', 'raju1408gopi', 'lalithyareddy9', 'saikumarkanisetty525', 'jaswanth521999', 'swetha.yerabapu', 'ruthalasaisujay2000', 'renusreekarnam', 'vjvijay1999', 'dhanalakshmidnvs', 'shaikfayazaashiq', 'poojipenubolu8', 'sridharamjayashree5274', 'kovvurisesha', 'bhargavibharu9876', 'saleema', 'vaisnavikv', 'balajiluminasree', 'saitejaswi2210', 'sathesh.m', 'teddy4u2015', 'ysvrnv', 'praveenkella2299', 'sreenusree1789', 'rajeev7032', 'palletiharsha777', 'segumahesh', 'haranadh11', 'narayanareddy1666', 'divyalathamidhun12', 'kotakondaarunteja', 'chekuripradeep888', 'sumanth.bingi139', 'sravanthijai1999', 'gopijettiboyina841', 'suryaboddupalli.3216', 'upendravalleti', 'kbharggav721', 'saikiran89131', '9940210291a', 'kamlesh_', 'bandiramya2000', 'deepakarunannamalai', 'jonahjoni7', 'chaithualadi', 'saiviswa9595', 'mrprnv', 'uttejthumati99', 'chillavishnuvardhan1234', 'pravallika', 'abbasmanthri904', 'gunasekharreddy.thummala', 'kalyanamsubhash65', 'vrprasanna38118114', 'sukanyacheruvu30', 'k.rajagopalreddy33', 'rajareddy9052', 'shaikbajithun', 'penchalaprasanna2000', 'venkateshreddy69', 'harinid176', 'saicharangayathri66', 'reshmaraju', 'suresh339', 'dharanicheeda', 'alexandra', 'paulina.gollapudi', 'anu27111999', 'surendar2042', 'chekkatchyutkumar', 'bhavyapreethi24', 'sugansugumar55', 'pharipriyapriya9445', 'akhilchandaka111', 'studychennaiv4u', 'nivetha', 'rakesh.969550', 'jeevanmorkelnttf', 'sandhyareddy', 'gayu_kutty', 'princerafi588', 'kundasrinivasulu55', 'swaroop6055', 'sainikhilgodl', 'rajenjoy25', 'vishnupriya', 'sreenivassree0143', 'manjuladrp', 'gnanasekharmani2000', None, 'katlatipavani666', 'sivabapatu123', 'tejateja1574', 'nanoelectronicsece', 'krushithakrishna1212', 'susmithainturi02', 'bashasameerbasha', 'vsswathiraj2017', 'lavanyavarapana111', 'lakshmipunati02']"
98,139,9,41,2,"['9940210291a', 'harshareddy']",6,"['k.rajagopalreddy33', 'mrprnv', 'uttejthumati99', 'pavankumarreddyalamuri', 'pallamalavamsi123', 'harinid176']",39,"['alexandra', 'yamunalakshmi18', 'ssreddynallamilli87270', 'surendar2042', 'mdevendrareddy21', 'zameershan88', 'sharvanireddy29', 'bhavyapreethi24', 'sugansugumar55', 'settysucharitha', 'pavithraml123', 'nivetha', 'thanushayaddala1999', 'sibhi.raja', 'swetha.yerabapu', 'jyotsnaasari15', 'harini.d', 'rayapanani.azad', 'harshavardhini.mohan125', 'sridharamjayashree5274', 'spmohammedali72', 'pravallika', 'kalyanamsubhash65', None, 'sivabapatu123', 'vemasanidivya', 'phemalatha.stvd', 'teddy4u2015', 'bafridi', 'sasikumart73', 'bhavya.sravani123', 'penchalaprasanna2000', 'vsswathiraj2017', 'sandhyakannan2022', 'praveenkella2299', 'chandug2310', 'kondurureshma', 'reshmaraju', 'segumahesh']",47,"['alexandra', 'ssreddynallamilli87270', 'surendar2042', 'kondurureshma', 'mdevendrareddy21', 'zameershan88', 'sharvanireddy29', 'bhavyapreethi24', 'sugansugumar55', 'settysucharitha', '9940210291a', 'pavithraml123', 'nivetha', 'thanushayaddala1999', 'pallamalavamsi123', 'sibhi.raja', 'swetha.yerabapu', 'jyotsnaasari15', 'harini.d', 'rayapanani.azad', 'harshavardhini.mohan125', 'mrprnv', 'uttejthumati99', 'pavankumarreddyalamuri', 'sridharamjayashree5274', 'harshareddy', 'spmohammedali72', 'pravallika', 'kalyanamsubhash65', None, 'sivabapatu123', 'k.rajagopalreddy33', 'vemasanidivya', 'praveenkella2299', 'phemalatha.stvd', 'teddy4u2015', 'bafridi', 'sasikumart73', 'bhavya.sravani123', 'penchalaprasanna2000', 'vsswathiraj2017', 'sandhyakannan2022', 'yamunalakshmi18', 'chandug2310', 'harinid176', 'reshmaraju', 'segumahesh']"
99,34,9,14,7,"['mfilipasic', 'andrejkontrec', 'cindric19', 'sabinadzafic1', 'juraj.ovcar', 'aso', 'metalian8']",1,['josipadiklic'],7,"['avidov', 'goranka', 'pingvincina', 'leonardokrleza', 'havaicp', 'pgazdek', None]",15,"['mfilipasic', 'andrejkontrec', 'leonardokrleza', 'sabinadzafic1', 'juraj.ovcar', 'pgazdek', 'avidov', None, 'goranka', 'pingvincina', 'josipadiklic', 'cindric19', 'havaicp', 'aso', 'metalian8']"
99,198,9,14,8,"['josipadiklic', 'mfilipasic', 'andrejkontrec', 'cindric19', 'sabinadzafic1', 'juraj.ovcar', 'aso', 'metalian8']",0,[],6,"['igsertic', 'goranka', 'leonardokrleza', 'havaicp', 'pgazdek', None]",14,"['mfilipasic', 'andrejkontrec', 'leonardokrleza', 'sabinadzafic1', 'juraj.ovcar', 'pgazdek', None, 'igsertic', 'goranka', 'josipadiklic', 'cindric19', 'havaicp', 'aso', 'metalian8']"
99,122,9,13,6,"['josipadiklic', 'cindric19', 'andrejkontrec', 'sabinadzafic1', 'juraj.ovcar', 'aso']",2,"['metalian8', 'mfilipasic']",7,"['igsertic', 'pingvincina', 'leonardokrleza', 'ante.sodan', 'ana.milinovic', 'havaicp', None]",15,"['mfilipasic', 'andrejkontrec', 'leonardokrleza', 'ante.sodan', 'ana.milinovic', 'sabinadzafic1', 'juraj.ovcar', None, 'igsertic', 'pingvincina', 'josipadiklic', 'cindric19', 'havaicp', 'aso', 'metalian8']"
99,199,9,13,7,"['josipadiklic', 'mfilipasic', 'andrejkontrec', 'cindric19', 'sabinadzafic1', 'juraj.ovcar', 'metalian8']",1,['aso'],6,"['igsertic', 'avidov', 'amilinovic', 'havaicp', 'pgazdek', None]",14,"['mfilipasic', 'andrejkontrec', 'sabinadzafic1', 'juraj.ovcar', 'pgazdek', 'avidov', None, 'igsertic', 'josipadiklic', 'amilinovic', 'cindric19', 'havaicp', 'aso', 'metalian8']"
99,427,9,13,6,"['josipadiklic', 'cindric19', 'andrejkontrec', 'sabinadzafic1', 'juraj.ovcar', 'aso']",2,"['metalian8', 'mfilipasic']",7,"['igsertic', 'pingvincina', 'leonardokrleza', 'ante.sodan', 'ana.milinovic', 'havaicp', None]",15,"['mfilipasic', 'andrejkontrec', 'leonardokrleza', 'ante.sodan', 'ana.milinovic', 'sabinadzafic1', 'juraj.ovcar', None, 'igsertic', 'pingvincina', 'josipadiklic', 'cindric19', 'havaicp', 'aso', 'metalian8']"
99,442,9,12,7,"['mfilipasic', 'andrejkontrec', 'cindric19', 'sabinadzafic1', 'juraj.ovcar', 'aso', 'metalian8']",1,['josipadiklic'],5,"['avidov', 'pingvincina', 'havaicp', 'pgazdek', None]",13,"['mfilipasic', 'andrejkontrec', 'sabinadzafic1', 'juraj.ovcar', 'pgazdek', 'avidov', None, 'pingvincina', 'josipadiklic', 'cindric19', 'havaicp', 'aso', 'metalian8']"
99,33,9,9,6,"['josipadiklic', 'mfilipasic', 'cindric19', 'sabinadzafic1', 'juraj.ovcar', 'metalian8']",2,"['aso', 'andrejkontrec']",3,"['ante.sodan', None, 'goranka']",11,"['goranka', None, 'josipadiklic', 'mfilipasic', 'andrejkontrec', 'cindric19', 'ante.sodan', 'sabinadzafic1', 'juraj.ovcar', 'aso', 'metalian8']"
99,440,9,7,5,"['josipadiklic', 'mfilipasic', 'cindric19', 'sabinadzafic1', 'metalian8']",3,"['juraj.ovcar', 'aso', 'andrejkontrec']",2,"['ante.sodan', None]",10,"[None, 'josipadiklic', 'mfilipasic', 'andrejkontrec', 'cindric19', 'ante.sodan', 'sabinadzafic1', 'juraj.ovcar', 'aso', 'metalian8']"
100,22,9,43,1,['sgu960911'],7,"['kamalq97', 'fraannn101', 'y.yayaoye', 's.boguc', 'sotonye.w', 'pip', 'jresina']",42,"['sgu20141417', 'harry0913', 'sgu20141441', 'sgu20131455', 'sgu20131458', 'sgu20141394', 'sgu20141483', 'sgu20141411', 'ppjunb12', 'sgu20121462', 'gjfdjzo', 'sgu20141395', 'sg20121208', 'sgu20141408', 'sgu20141465', 'sgu20131481', 'sgu20131462', 'sgu20151487', 'sgu20141459', 'sogang20141460', 'sgu20131508', 'sgu20141448', 'sgu20141468', 'sgu20131507', 'sgu20141389', 'sgu20151485', 'sgu2014726019', 'sgu20161474', 'sgu20131432', 'sgu20141385', 'sgu20141393', None, 'sgu20141450', 'sgu20161503', 'sgu20131412', 'sgu20141476', 'sgu20141460', 'sgu20141415', 'sgu20131410', 'sgu20151194', 'sgu20161494', 'sgu20141471']",50,"['sgu20141417', 'harry0913', 'sgu20141441', 'sgu20131455', 'sgu20131458', 'sgu960911', 'sgu20141394', 'sgu20141483', 'sgu20141411', 'pip', 'ppjunb12', 'sgu20121462', 'kamalq97', 'gjfdjzo', 'fraannn101', 'sgu20141395', 'sg20121208', 'sgu20141408', 'sgu20141465', 'sgu20131481', 'sgu20131462', 'sgu20151487', 'sgu20141459', 'sogang20141460', 'jresina', 'sgu20131508', 'sgu20141448', 'sgu20141468', 'sgu20131507', 'sgu20141389', 'y.yayaoye', 'sgu20151485', 'sgu2014726019', 'sgu20161474', 'sgu20131432', 'sotonye.w', 'sgu20141385', 'sgu20141393', None, 'sgu20141450', 'sgu20161503', 'sgu20131412', 'sgu20141476', 's.boguc', 'sgu20141460', 'sgu20141415', 'sgu20131410', 'sgu20151194', 'sgu20161494', 'sgu20141471']"
100,319,9,10,7,"['kamalq97', 'fraannn101', 'y.yayaoye', 's.boguc', 'sotonye.w', 'pip', 'jresina']",1,['sgu960911'],3,"['jav4796', None, 'timechtermeyer']",11,"['kamalq97', 'timechtermeyer', 'fraannn101', 'y.yayaoye', 's.boguc', 'sgu960911', 'jav4796', 'sotonye.w', 'pip', None, 'jresina']"
101,8,9,7,4,"['lige3243', 'mgudkov', 'mstoj', 'junyis4']",4,"['sayeembinkutub.ewu', 'fhl1103042721', 'wsun11', 'sashade']",3,"['metgolb', None, 'drazovicfilip']",11,"['metgolb', 'fhl1103042721', 'sashade', 'wsun11', 'drazovicfilip', 'junyis4', 'lige3243', 'mgudkov', 'mstoj', 'sayeembinkutub.ewu', None]"
102,187,9,122,4,"['shashanksk5495', 'shhsu001', 'jlavorat', 'vradkar']",4,"['nsalts', 'abiniwa', 'taeksanglee', 'hasadi']",118,"['marisol', 'praveenapprasad', 'kolispeter', 'msakano', 'ja37989', 'jrudolp', 'shreeya26', 'jpancha', 'park855', 'zhan1337', 'brendenh88', 'zhan3366', 'mill1914', 'sahu2', 'abhivictor2', 'sachadervi', 'sandracore21', 'ganti', 'montoyah', 'pkolis', 'desai61', 'paul91', 'jverduzc', 'svaze', 'mao85', 'azadoks', 'rahuldeshmukh', 'poiuy1134', 'ncummock', 'swarnava881995', 'mishra94', 'mukher25', 'song517', 'naik.pratik', 'jhartl', 'kkoradiy', 'westonbuchanan', 'peoplesj', 'peter496', 'sanghik', 'mmh', 'li2467', 'beck50', 'clarksm', 'harshit03sep', 'zhao300', 'kaiming', 'skolacek', 'kogunsin', 'alafzi', 'strachan', 'tsimon', 'hao55', 'atrikana', 'zhan3294', 'li1668', 'tracyelkhoury', 'dbenham', 'pandinghao1', 'joshi59', 'mademoiselle0812', 'sabareesh169', 'chand101', 'lslcyc970214', 'chang548', 'singh152', 'abaird7', 'qianyuz482', 'wxy30003000', 'parmar0', 'fu237', 'zhou646', 'ke_tang', 'denphi', 'gjhanwar', 'amankar', 'lyons20', 'anavarka', 'izarmako93', 'pan279', 'szamani', 'ownbey', 'wu952', 'kim2957', 'xu530', 'jthekine', 'jiaosiyu', 'han547', 'jiang556', 'radhakv', 'tracykh276', 'nkamdar', 'dbranco', 'lee1131', None, 'sukirtthakur', 'cgrantz', 'conley39', 'balasub9', 'gentry9', 'ksethura', 'pkaundin', 'yao201', 'yao99', 'dcappell', 'clarksnano', 'slorenz', 'kbandar', 'samantas', 'shah484', 'tfleck', 'zhou483', 'unitas', 'mcclurez', 'patkip', 'ksalish', 'buchanaw', 'vkattaku']",126,"['praveenapprasad', 'jrudolp', 'shreeya26', 'park855', 'zhan1337', 'mill1914', 'sahu2', 'abhivictor2', 'ganti', 'jverduzc', 'svaze', 'mao85', 'poiuy1134', 'swarnava881995', 'song517', 'kkoradiy', 'peoplesj', 'peter496', 'sanghik', 'mmh', 'beck50', 'kaiming', 'kogunsin', 'tsimon', 'hao55', 'zhan3294', 'li1668', 'dbenham', 'mademoiselle0812', 'sabareesh169', 'chand101', 'lslcyc970214', 'singh152', 'qianyuz482', 'fu237', 'zhou646', 'ke_tang', 'amankar', 'anavarka', 'izarmako93', 'pan279', 'ownbey', 'kim2957', 'xu530', 'jthekine', 'jiaosiyu', 'vradkar', 'han547', 'sukirtthakur', 'cgrantz', 'conley39', 'balasub9', 'gentry9', 'ksethura', 'pkaundin', 'yao201', 'clarksnano', 'samantas', 'shah484', 'unitas', 'patkip', 'ksalish', 'buchanaw', 'vkattaku', 'marisol', 'kolispeter', 'msakano', 'ja37989', 'shashanksk5495', 'jpancha', 'brendenh88', 'zhan3366', 'sachadervi', 'sandracore21', 'montoyah', 'pkolis', 'desai61', 'paul91', 'azadoks', 'rahuldeshmukh', 'ncummock', 'mishra94', 'mukher25', 'naik.pratik', 'jhartl', 'westonbuchanan', 'li2467', 'clarksm', 'harshit03sep', 'zhao300', 'skolacek', 'alafzi', 'strachan', 'hasadi', 'atrikana', 'tracyelkhoury', 'pandinghao1', 'joshi59', 'shhsu001', 'chang548', 'abaird7', 'wxy30003000', 'parmar0', 'denphi', 'gjhanwar', 'lyons20', 'szamani', 'abiniwa', 'wu952', 'jiang556', 'radhakv', 'tracykh276', 'nkamdar', 'dbranco', 'lee1131', None, 'yao99', 'dcappell', 'slorenz', 'nsalts', 'kbandar', 'tfleck', 'taeksanglee', 'zhou483', 'mcclurez', 'jlavorat']"
104,417,8,9,7,"['piotr_z', 'aleksabond', 'buurg', 'matmiecz', 'dami95', 'eatrunner', 'j_piechota']",0,[],2,"[None, 'igarygielska']",9,"['dami95', None, 'j_piechota', 'piotr_z', 'aleksabond', 'buurg', 'matmiecz', 'igarygielska', 'eatrunner']"
104,418,8,9,7,"['piotr_z', 'aleksabond', 'buurg', 'matmiecz', 'dami95', 'eatrunner', 'j_piechota']",0,[],2,"[None, 'rygielskaiga']",9,"['dami95', None, 'rygielskaiga', 'j_piechota', 'piotr_z', 'aleksabond', 'buurg', 'matmiecz', 'eatrunner']"
105,164,8,33,7,"['vvardhan660', 'bharath_varma', 'kshitizomar', 'kakkiralapavankumar', 'ram.dhungana.16ece', 'kaushikyerukonda', 'sashank.1999']",0,[],26,"['raghavendra.sinha.16ece', 'pooja.madireddy.16ece', 'konkimallasumanth', 'karthikpinnelli5', 'ashish.sharma.16ece', 'sakethsolasa1999', 'snehyajnik77777', 'abhinavsingh10', 'imtiazshaik18', 'srikarkodavati99', 'warlock', 'msaibhavani99', 'sasi.kiran.16ece', 'praneethmutta', 'ramdhungana1999', 'meghna.goel.16ece', 'sinha.raghav199801', None, 'kaushik11', 'manyam.soumith.16cse', 'ande.varun.16ece', 'twinklegoel138', 'himanshi', 'gupta.bhavishya1998', 'sai.99madhav', 'poojitha.bathini.16ece']",33,"['raghavendra.sinha.16ece', 'pooja.madireddy.16ece', 'konkimallasumanth', 'karthikpinnelli5', 'ashish.sharma.16ece', 'sakethsolasa1999', 'snehyajnik77777', 'vvardhan660', 'abhinavsingh10', 'imtiazshaik18', 'srikarkodavati99', 'warlock', 'bharath_varma', 'kshitizomar', 'kakkiralapavankumar', 'msaibhavani99', 'kaushikyerukonda', 'sasi.kiran.16ece', 'praneethmutta', 'ramdhungana1999', 'meghna.goel.16ece', 'sinha.raghav199801', None, 'sashank.1999', 'kaushik11', 'manyam.soumith.16cse', 'ande.varun.16ece', 'twinklegoel138', 'ram.dhungana.16ece', 'himanshi', 'gupta.bhavishya1998', 'sai.99madhav', 'poojitha.bathini.16ece']"
105,225,8,24,7,"['vvardhan660', 'bharath_varma', 'kshitizomar', 'kakkiralapavankumar', 'ram.dhungana.16ece', 'kaushikyerukonda', 'sashank.1999']",0,[],17,"['sai.vijay.16ece', 'manyam.soumith.16cse', 'ande.varun.16ece', 'raghavendra.sinha.16ece', 'pooja.madireddy.16ece', 'avinike18', 'vojjala.pranav.16ece', 'thakkallaplli.shashider.16ece', 'msaibhavani99', 'konkimallasumanth', 'himanshi', 'sai.99madhav', 'maturi.bahavana.16ece', 'praneethmutta', 'sinha.raghav199801', 'sakethsolasa1999', None]",24,"['sai.vijay.16ece', 'bharath_varma', 'kshitizomar', 'raghavendra.sinha.16ece', 'pooja.madireddy.16ece', 'kakkiralapavankumar', 'vojjala.pranav.16ece', 'avinike18', 'msaibhavani99', 'kaushikyerukonda', 'konkimallasumanth', 'maturi.bahavana.16ece', 'praneethmutta', 'sinha.raghav199801', 'sakethsolasa1999', None, 'sashank.1999', 'thakkallaplli.shashider.16ece', 'vvardhan660', 'manyam.soumith.16cse', 'ande.varun.16ece', 'ram.dhungana.16ece', 'himanshi', 'sai.99madhav']"
106,124,8,17,3,"['sanketchavan', 'shrikantppmurkute', 'm.patekari78']",4,"['kajal181097', 'dnyaneshwarghatge55', 'sumitvajrashetti', 'sahilmagdum']",14,"['2509patilkomal', 'priyupawar0797', 'aadityapatil77', 'utkarshajadhav2018', 'nikitapatil13', 'sonalimiraje', 'sharvaript', 'revadekarchetan', 'cpatil7896', 'ameysabanis16', 'preranadhumal12575', None, 'trishadesai1111', 'shwetalizambre']",21,"['2509patilkomal', 'dnyaneshwarghatge55', 'utkarshajadhav2018', 'nikitapatil13', 'm.patekari78', 'kajal181097', 'preranadhumal12575', None, 'trishadesai1111', 'ameysabanis16', 'priyupawar0797', 'sanketchavan', 'aadityapatil77', 'sonalimiraje', 'sahilmagdum', 'sharvaript', 'shrikantppmurkute', 'revadekarchetan', 'sumitvajrashetti', 'cpatil7896', 'shwetalizambre']"
106,125,8,16,5,"['sahilmagdum', 'shrikantppmurkute', 'sumitvajrashetti', 'm.patekari78', 'kajal181097']",2,"['dnyaneshwarghatge55', 'sanketchavan']",11,"['priyupawar0797', 'rabadeswapnali13', 'pritammorankar', 'sonalimiraje', 'nikitapatil13', 'harshada11', 'afiya2626', 'snehalawand7', None, 'trishadesai1111', 'ameysabanis16']",18,"['dnyaneshwarghatge55', 'rabadeswapnali13', 'nikitapatil13', 'afiya2626', 'm.patekari78', 'kajal181097', None, 'trishadesai1111', 'ameysabanis16', 'priyupawar0797', 'sanketchavan', 'pritammorankar', 'sonalimiraje', 'sahilmagdum', 'shrikantppmurkute', 'harshada11', 'snehalawand7', 'sumitvajrashetti']"
106,126,8,14,1,['dnyaneshwarghatge55'],6,"['sanketchavan', 'sahilmagdum', 'shrikantppmurkute', 'sumitvajrashetti', 'm.patekari78', 'kajal181097']",13,"['priyupawar0797', 'pritammorankar', 'aadityapatil77', 'sonalimiraje', 'arshkop97', 'harkesayali19', 'killedarshirish', 'rachupotadar30', 'aafreenpatel2196', 'shreeyarane19', 'kirannirmal57', None, 'ameysabanis16']",20,"['dnyaneshwarghatge55', 'rachupotadar30', 'aafreenpatel2196', 'm.patekari78', 'kajal181097', 'kirannirmal57', None, 'ameysabanis16', 'priyupawar0797', 'sanketchavan', 'pritammorankar', 'aadityapatil77', 'sonalimiraje', 'sahilmagdum', 'arshkop97', 'killedarshirish', 'shrikantppmurkute', 'sumitvajrashetti', 'shreeyarane19', 'harkesayali19']"
107,373,8,10,6,"['pdvanhou20', 'roarke.m.tollar', 'connor.guzior138', 'jdandry20', 'bagrubbs20', 'ajembree19']",1,['titusdanieledwards98'],4,"['jamac1724', 'paulschmitt8', None, 'titusdanieledwards']",11,"['jamac1724', 'pdvanhou20', 'titusdanieledwards98', 'titusdanieledwards', 'connor.guzior138', 'bagrubbs20', None, 'paulschmitt8', 'roarke.m.tollar', 'jdandry20', 'ajembree19']"
107,376,8,10,7,"['pdvanhou20', 'roarke.m.tollar', 'titusdanieledwards98', 'connor.guzior138', 'jdandry20', 'bagrubbs20', 'ajembree19']",0,[],3,"['jamac1724', 'paulschmitt8', None]",10,"['jamac1724', 'pdvanhou20', 'titusdanieledwards98', 'connor.guzior138', 'bagrubbs20', None, 'paulschmitt8', 'roarke.m.tollar', 'jdandry20', 'ajembree19']"
107,377,8,9,7,"['pdvanhou20', 'roarke.m.tollar', 'titusdanieledwards98', 'connor.guzior138', 'jdandry20', 'bagrubbs20', 'ajembree19']",0,[],2,"['jamac1724', None]",9,"['jamac1724', 'pdvanhou20', 'titusdanieledwards98', 'connor.guzior138', 'bagrubbs20', None, 'roarke.m.tollar', 'jdandry20', 'ajembree19']"
108,333,8,12,6,"['nihaljoshi', 'rohityyy025', 'a.sakur81', 'shraddhahegde31', 'akshayclanwars', 'sejal.01']",1,['brentsj'],6,"['charmigandhi99', 'nairsayuj', 'snehaljagdale27', 'mrunalnasare', None, 'vrinda']",13,"['shraddhahegde31', 'rohityyy025', 'nairsayuj', 'mrunalnasare', None, 'vrinda', 'nihaljoshi', 'charmigandhi99', 'a.sakur81', 'snehaljagdale27', 'brentsj', 'akshayclanwars', 'sejal.01']"
111,152,8,7,6,"['guicho.gonzales.amaya', 'martacsoult', 'robinfrancotte', 'dvlaethe87', 'adrivarech', 'carol.reyes39']",1,['debikachanu'],1,[None],8,"['martacsoult', 'guicho.gonzales.amaya', 'dvlaethe87', 'adrivarech', 'carol.reyes39', None, 'robinfrancotte', 'debikachanu']"
112,304,8,8,5,"['rochalucas', 'alexvsc5', 'mrtuned', 'bior', 'nano_doc']",2,"['azarisyu', 'fernandes.pedrobraga']",3,"[None, 'jnieder', 'silvavitor4']",10,"['rochalucas', 'alexvsc5', 'mrtuned', 'bior', 'azarisyu', 'jnieder', 'nano_doc', None, 'silvavitor4', 'fernandes.pedrobraga']"
113,445,8,9,1,['dvc25'],6,"['kinnear.ci', 'crazyheyou', 'clausera', 'tirskyzhang', 'andresog', 'zhoujh']",8,"['mas856', 'jw2448', 'zw569', 'mrk263', 'xxxxxxxwx', 'sh2488', 'ab2552', None]",15,"['jw2448', 'mrk263', 'xxxxxxxwx', 'dvc25', 'andresog', 'zhoujh', None, 'mas856', 'kinnear.ci', 'zw569', 'crazyheyou', 'clausera', 'sh2488', 'tirskyzhang', 'ab2552']"
117,259,7,12,6,"['rahulfatnani1008', 'mrudulageddam', 'priyankajondhale12', 'ashu25', 'soham.shirwadkar', 'joyrinferns97']",0,[],6,"['nikhil9e', 'piyasawant10', 'tanmaygujar999', 'vaibhaviapatil1997', None, 'chatterjeesoumik97']",12,"['priyankajondhale12', 'tanmaygujar999', 'vaibhaviapatil1997', 'soham.shirwadkar', None, 'joyrinferns97', 'ashu25', 'chatterjeesoumik97', 'rahulfatnani1008', 'nikhil9e', 'piyasawant10', 'mrudulageddam']"
117,425,7,12,6,"['rahulfatnani1008', 'mrudulageddam', 'priyankajondhale12', 'ashu25', 'soham.shirwadkar', 'joyrinferns97']",0,[],6,"['nikhil9e', 'piyasawant10', 'tanmaygujar999', 'vaibhaviapatil1997', None, 'chatterjeesoumik97']",12,"['priyankajondhale12', 'tanmaygujar999', 'vaibhaviapatil1997', 'soham.shirwadkar', None, 'joyrinferns97', 'ashu25', 'chatterjeesoumik97', 'rahulfatnani1008', 'nikhil9e', 'piyasawant10', 'mrudulageddam']"
118,46,7,34,2,"['soureen.g', 'hrishikesh12']",4,"['pratham786', 'aniruddh.s', 'vaibhav.mete', 'bhoite.p']",32,"['gaurav.dangat', 'akshatask', 'yash.mhatre', 'pnrasika', 'raj.velani', 'pratham123', 'siddhant8291', 'smita.n', 'niraj.parte', 'jagruti.patil', 'jayesh.a', 'nikitamittal97', 'vatsal23', 'sonali.gavkar', 'preeti.kharas', 'neil.dani9', 'shelarpranali1309', 'saayuj.s', 'pjkarmokar', 'pawan.mojar', 'rajas.b', 'anjana.bhave', 'mayur.gosavi', None, 'akansha_sampat', 'tapan.garge', 'kharatomkar24', 'snehald827', 'arpitakudesia3011', 'vaishnavi.soni', 'mayuri.sapkal', 'priyanka.rp']",38,"['soureen.g', 'gaurav.dangat', 'akshatask', 'yash.mhatre', 'pnrasika', 'raj.velani', 'pratham123', 'siddhant8291', 'smita.n', 'niraj.parte', 'jagruti.patil', 'aniruddh.s', 'hrishikesh12', 'jayesh.a', 'nikitamittal97', 'vaibhav.mete', 'vatsal23', 'pratham786', 'sonali.gavkar', 'preeti.kharas', 'neil.dani9', 'shelarpranali1309', 'saayuj.s', 'pjkarmokar', 'pawan.mojar', 'rajas.b', 'anjana.bhave', 'mayur.gosavi', None, 'akansha_sampat', 'tapan.garge', 'kharatomkar24', 'snehald827', 'arpitakudesia3011', 'vaishnavi.soni', 'mayuri.sapkal', 'bhoite.p', 'priyanka.rp']"
118,45,7,10,6,"['soureen.g', 'pratham786', 'aniruddh.s', 'hrishikesh12', 'bhoite.p', 'vaibhav.mete']",0,[],4,"['nikitamittal97', None, 'smita.n', 'jayshree90']",10,"['soureen.g', 'pratham786', None, 'smita.n', 'aniruddh.s', 'jayshree90', 'hrishikesh12', 'bhoite.p', 'nikitamittal97', 'vaibhav.mete']"
119,49,7,39,2,"['biawak_terbengkalai', 'raflysna3']",4,"['hit.kamble', 'ajitjadhav', 'danielsinaga360', 'srkate97']",37,"['muhammadanto27', 'steven123', 'fadhilihsand', 'danielsinaga220', 'ariflinggasaputra28', 'fevikrisda', 'raflysna', 'frenkysiregar', 'irwansyahekaputra1', 'ismaelfozio', 'linaelfita29', 's.naek', 'threehans21', 'wahyuramadhan', 'oliversitorus', 'dedypurwadisinaga', 'srldaindars', 'dvnrvnd', 'alifindralukman', 'zeroabdi1212', 'nantafakih', 'afryanainggolan07', 'mekiripaldo00', 'muhammadrifqi', 'wahyu', 'donyricardo', 'dhaffiz_aries25', 'dwifurwana02', 'aditwiranu', 'ellyramadhanti957', None, 'rendipardosi', 'khairuhafiz', 'cintyarubiah', 'mhafiz15', 'jennipusva', 'benkhalifah94']",43,"['muhammadanto27', 'biawak_terbengkalai', 'steven123', 'fadhilihsand', 'danielsinaga220', 'ariflinggasaputra28', 'fevikrisda', 'raflysna', 'frenkysiregar', 'irwansyahekaputra1', 'ismaelfozio', 'linaelfita29', 's.naek', 'threehans21', 'srkate97', 'wahyuramadhan', 'hit.kamble', 'oliversitorus', 'dedypurwadisinaga', 'srldaindars', 'dvnrvnd', 'ajitjadhav', 'alifindralukman', 'zeroabdi1212', 'nantafakih', 'raflysna3', 'afryanainggolan07', 'mekiripaldo00', 'muhammadrifqi', 'wahyu', 'donyricardo', 'dhaffiz_aries25', 'dwifurwana02', 'aditwiranu', 'ellyramadhanti957', None, 'rendipardosi', 'khairuhafiz', 'cintyarubiah', 'mhafiz15', 'jennipusva', 'benkhalifah94', 'danielsinaga360']"
119,52,7,15,2,"['hit.kamble', 'ajitjadhav']",4,"['biawak_terbengkalai', 'raflysna3', 'danielsinaga360', 'srkate97']",13,"['smita.n', 'shaibilsabu', 'evanjalinbenita', 'shriya.h.joshi', 'omkarkhedkaro', 'austin.dsouza1997', 'urvi.panchal', 'rohansaldanha6370', 'selimajack26', 'jayesh.a', None, 'vatsal23', 'swapnalimakdey25']",19,"['biawak_terbengkalai', 'raflysna3', 'evanjalinbenita', 'urvi.panchal', 'austin.dsouza1997', 'selimajack26', None, 'smita.n', 'shaibilsabu', 'shriya.h.joshi', 'omkarkhedkaro', 'srkate97', 'hit.kamble', 'rohansaldanha6370', 'jayesh.a', 'vatsal23', 'ajitjadhav', 'danielsinaga360', 'swapnalimakdey25']"
120,56,7,142,4,"['dishasaraiya', 'shivam.rs', 'harish.c', 'sachin.sc']",2,"['omkar.karande', 'vidhi.satra']",138,"['nikperu007', 'nikhilchaudhari5516', 'harshalisawant92', 'omkar.chalke96', 'rajasiar1234', 'dmce123456789', 'h.vyas', 'darshana.mehta', 'sagarthool', 'sagargujar123', 'rahul.jethwa', 'akashupadhyay', 'rishi.mistry', 'aditya27', 'manalighorpade07', 'shreyahonagekar04', 'jugal.vaja', 'kssheetal2497', 'aditya.bhabhe', 'sakshi.bhosle', 'singhamod111', 'chauhanajay4u', 'sujittupe3490', 'rehan.mistry', 'mehulkharvi7', 'ranajay1997', 'pinak.p', 'bhushan0397', 'shrutik1997.mallick', 'ritesh0111', 'vidushirazdan1308', 'madhuriwawale13', 'shraddha0306', 'p_vasant', 'nehagurale10', 'vikramtirathkar96', 'kevin.z', 'yash.gulve', 'aditya.prnair', 'umeshlohote', 'jainamshah409', 'jagnoor.p', 'amey.mahadik98', 'kunalk4796', 'rajaskhasgiwale8497', 'prithvianvekar21', 'shubham.yelange', 'aladvait', 'arat.gouda', 'pranay.sadavarte', 'doobvoob', 'tejaskinage', 'k.siddhapura', 'vivek4238', 'jayshree90', 'apurvamirke29', 'kacharerohan', 'rutuja.mehta', 'arpanmodi2014', 'huzefa9702', 'adityajoy29', 'jay.km', 'shipra2', 'shubhada.shetti', 'divya.sawant17497', 'sakshi.trivedi', 'hitvena.shah', 'nikita.rp', 'zotingsagar', 'shashankyadavade68', 'mehanshi.p', 'yashsavle', 'akankshapatil', 'rajat.p', 'gaurav24', 'nihal.raut', 'smahamulkar1013', 'shah.ns', 'slimshady', 'dilipramgir', 'maitrishah', 'goyalvishal147', 'saurabh.palde', 'karanshah16', 'zeevd19', 'arthaya.koyande28', 'prachi04', 'thakreshivam805', 'ankita.nd', 'kaustubhvaishampayan', 'nitin.lalwani', 'soham.sk', 'pranesha08', 'kalekajal2', 'perekarnk', 's.suvarna', 'harshal.bhole', 'spawar.ap', 'shwetakanoja', 'roy.shinde77', 'pranaykaranjekar28', 'shettynitin667', 'saadrahman.a', 'ssoneria7', 'd.haria', 'aashutoshkhapare22', 'darshana2504', 'swapnalidethe', 'rohithebbar10', 'aadi', 's.vohra', 'shreyasmoolya', 'kapil1410', 'adwaitnaik2', 'shahruchi', 'chakulipatil999', 'bhangaleprit', 'dhanshreeshawale', 'anushkaw055', 'rushabhkothari12', 'nayan_nanohub', 'yasir.mulla47', 'abbas.barwaniwala', None, 'apeksha.shinde', 'ninad.mulay', 'parin.ss', 'abhay.nadkarni', 'pranalim11', 'saurabhgawade.777.4.sg', 'yashshetye7', 'pranali', 'nitish_mishra', 'bhushanrsonawane1998', 'ameysawant25597', 'kumawatmukesh71', 'rahulbirwadkar123', 'shettysagar35']",144,"['nikperu007', 'nikhilchaudhari5516', 'harshalisawant92', 'omkar.chalke96', 'rajasiar1234', 'dmce123456789', 'h.vyas', 'darshana.mehta', 'sagarthool', 'sagargujar123', 'rahul.jethwa', 'akashupadhyay', 'rishi.mistry', 'aditya27', 'manalighorpade07', 'shreyahonagekar04', 'jugal.vaja', 'kssheetal2497', 'aditya.bhabhe', 'shivam.rs', 'sakshi.bhosle', 'singhamod111', 'chauhanajay4u', 'sachin.sc', 'sujittupe3490', 'rehan.mistry', 'mehulkharvi7', 'ranajay1997', 'pinak.p', 'bhushan0397', 'shrutik1997.mallick', 'ritesh0111', 'vidushirazdan1308', 'madhuriwawale13', 'shraddha0306', 'p_vasant', 'nehagurale10', 'vikramtirathkar96', 'kevin.z', 'yash.gulve', 'aditya.prnair', 'vidhi.satra', 'umeshlohote', 'jainamshah409', 'jagnoor.p', 'amey.mahadik98', 'kunalk4796', 'rajaskhasgiwale8497', 'prithvianvekar21', 'shubham.yelange', 'aladvait', 'arat.gouda', 'pranay.sadavarte', 'doobvoob', 'tejaskinage', 'k.siddhapura', 'vivek4238', 'jayshree90', 'apurvamirke29', 'kacharerohan', 'rutuja.mehta', 'arpanmodi2014', 'huzefa9702', 'adityajoy29', 'jay.km', 'shipra2', 'shubhada.shetti', 'divya.sawant17497', 'sakshi.trivedi', 'hitvena.shah', 'nikita.rp', 'zotingsagar', 'shashankyadavade68', 'omkar.karande', 'mehanshi.p', 'yashsavle', 'akankshapatil', 'rajat.p', 'gaurav24', 'nihal.raut', 'smahamulkar1013', 'rahulbirwadkar123', 'shah.ns', 'slimshady', 'dilipramgir', 'maitrishah', 'goyalvishal147', 'saurabh.palde', 'karanshah16', 'zeevd19', 'arthaya.koyande28', 'prachi04', 'thakreshivam805', 'ankita.nd', 'kaustubhvaishampayan', 'nitin.lalwani', 'soham.sk', 'pranesha08', 'kalekajal2', 'perekarnk', 's.suvarna', 'harshal.bhole', 'spawar.ap', 'shwetakanoja', 'roy.shinde77', 'pranaykaranjekar28', 'shettynitin667', 'saadrahman.a', 'ssoneria7', 'd.haria', 'aashutoshkhapare22', 'darshana2504', 'swapnalidethe', 'aadi', 's.vohra', 'shreyasmoolya', 'kapil1410', 'adwaitnaik2', 'shahruchi', 'chakulipatil999', 'bhangaleprit', 'dhanshreeshawale', 'anushkaw055', 'rushabhkothari12', 'nayan_nanohub', 'yasir.mulla47', 'abbas.barwaniwala', 'harish.c', None, 'apeksha.shinde', 'ninad.mulay', 'parin.ss', 'abhay.nadkarni', 'dishasaraiya', 'pranalim11', 'saurabhgawade.777.4.sg', 'yashshetye7', 'pranali', 'nitish_mishra', 'bhushanrsonawane1998', 'ameysawant25597', 'kumawatmukesh71', 'rohithebbar10', 'shettysagar35']"
120,53,7,75,6,"['dishasaraiya', 'shivam.rs', 'vidhi.satra', 'sachin.sc', 'harish.c', 'omkar.karande']",0,[],69,"['nikhilchaudhari5516', 'shindedeepak129', 'rajat.p', 'smahamulkar1013', 'selimajack26', 'akau100', 'rohitnair77880', 'shah.ns', 'aditya27', 'shreyahonagekar04', 'jugal.vaja', 'chavankeasmita29', 'sakshi.bhosle', 'paras.mehta', 'saurabh.palde', 'sushobh', 'zeevd19', 'arthaya.koyande28', 'vatsal23', 'sujittupe3490', 'orencollaco97', 'shrutik1997.mallick', 'dhwani.vichhi', 'anujchhabra25', 'waynemdsouza', 'shraddha0306', 's.suvarna', 'pranitkumbhar19', 'sebin.bc', 'spawar.ap', 'naiksandesh1998', 'priyu0964', 'patilprasad0123', '15anuchaudhari', 'sukanyajadhav1997', 'maneshweta23', 'jeniferishwarya', 'd.haria', 'umeshlohote', 'jagnoor.p', 'kunalk4796', 'prithvianvekar21', 'evanjalinbenita', 'shubham.yelange', 'austin.dsouza1997', 'aadi', 'mayuridesai', 'shreyasmoolya', 'vixsnair', 'shaibilsabu', 'jayesh.kakkad8770', 'rohansaldanha6370', 'davidrisaac', 'shubhamnagpure745', 'swapnalimakdey25', 'yasir.mulla47', 'jay.km', 'ghevadeyogesh', 'adityadesu1', None, 'ninad.mulay', 'adityadh943', 'parin.ss', 'abhay.nadkarni', 'sakshi.trivedi', 'aur_mnzs', 'saurabhgawade.777.4.sg', 'shail.maroo', 'wanichinmay577']",75,"['nikhilchaudhari5516', 'shindedeepak129', 'rajat.p', 'smahamulkar1013', 'selimajack26', 'akau100', 'rohitnair77880', 'shah.ns', 'aditya27', 'shreyahonagekar04', 'jugal.vaja', 'shivam.rs', 'chavankeasmita29', 'sakshi.bhosle', 'paras.mehta', 'saurabh.palde', 'sushobh', 'zeevd19', 'sachin.sc', 'arthaya.koyande28', 'vatsal23', 'sujittupe3490', 'orencollaco97', 'shrutik1997.mallick', 'dhwani.vichhi', 'anujchhabra25', 'waynemdsouza', 'shraddha0306', 's.suvarna', 'pranitkumbhar19', 'sebin.bc', 'spawar.ap', 'naiksandesh1998', 'priyu0964', 'patilprasad0123', '15anuchaudhari', 'vidhi.satra', 'sukanyajadhav1997', 'maneshweta23', 'jeniferishwarya', 'd.haria', 'umeshlohote', 'jagnoor.p', 'kunalk4796', 'prithvianvekar21', 'evanjalinbenita', 'shubham.yelange', 'austin.dsouza1997', 'aadi', 'mayuridesai', 'shreyasmoolya', 'vixsnair', 'shaibilsabu', 'jayesh.kakkad8770', 'rohansaldanha6370', 'davidrisaac', 'shubhamnagpure745', 'swapnalimakdey25', 'yasir.mulla47', 'jay.km', 'ghevadeyogesh', 'adityadesu1', 'harish.c', None, 'ninad.mulay', 'adityadh943', 'parin.ss', 'abhay.nadkarni', 'sakshi.trivedi', 'dishasaraiya', 'aur_mnzs', 'saurabhgawade.777.4.sg', 'shail.maroo', 'wanichinmay577', 'omkar.karande']"
120,210,7,71,4,"['dishasaraiya', 'omkar.karande', 'vidhi.satra', 'sachin.sc']",2,"['shivam.rs', 'harish.c']",67,"['dhaval.vs', 'vijen.g', 's.balsaraf73', 'rajat.p', 'gaurav24', 'kunj.haria', 'ankita.thikekar09', 'siddhesh0607', 'yjb', 'sanjana.dhulla', 'chauhanajay4u', 'parthkataria999', 'dvb', 'nishit.pabari', 'navneet.d', 'ankita.nd', 'pratyaksh.i', 'jinali.d', 'nitin.lalwani', 'soham.sk', 'anuj.cm', 'yash.shah9', 'chirayu.m', 'shraddha.jj', 'arya.ambardekar', 'd.kotecha', 'harshal.bhole', 'yash.gulve', 'ssoneria7', 'vignesh.j', 'akash.mehta', 'harshada.benke', 'het.manek', 'viral.mamaniya', 'nishad.joshi', 'mansi.gori', 'gayatri.gandhi', 'saumya.kamde', 's.vohra', 'inderjitsingh', 'mayuresh.auti', 'raghunath.gangi', 'meetparadia', 'hitendra.k', 'doobvoob', 'parth.nj', 'jitun', 'arati.mule2900', 'fatima.h', 'nayan_nanohub', 'j.kariya', 's.ambardekar', 'srinidhi.g', 'adithya.n', 'jainam.bj', 'nainil.m', 'shubhada.shetti', None, 'urva.d', 'vikram.sagar', 'karan.chhadawa', 'shah.jm', 'acadithya.m', 'anilguruprasad', 'bhumika.kava', 'mehanshi.p', 'taral.mehta']",73,"['dhaval.vs', 'vijen.g', 's.balsaraf73', 'rajat.p', 'gaurav24', 'kunj.haria', 'ankita.thikekar09', 'siddhesh0607', 'yjb', 'shivam.rs', 'sanjana.dhulla', 'chauhanajay4u', 'parthkataria999', 'sachin.sc', 'dvb', 'nishit.pabari', 'navneet.d', 'ankita.nd', 'pratyaksh.i', 'jinali.d', 'nitin.lalwani', 'soham.sk', 'anuj.cm', 'yash.shah9', 'chirayu.m', 'shraddha.jj', 'arya.ambardekar', 'd.kotecha', 'harshal.bhole', 'yash.gulve', 'vidhi.satra', 'ssoneria7', 'vignesh.j', 'akash.mehta', 'harshada.benke', 'het.manek', 'viral.mamaniya', 'nishad.joshi', 'mansi.gori', 'gayatri.gandhi', 'saumya.kamde', 's.vohra', 'inderjitsingh', 'mayuresh.auti', 'raghunath.gangi', 'meetparadia', 'hitendra.k', 'doobvoob', 'parth.nj', 'jitun', 'arati.mule2900', 'fatima.h', 'nayan_nanohub', 'j.kariya', 's.ambardekar', 'srinidhi.g', 'adithya.n', 'jainam.bj', 'harish.c', 'nainil.m', 'shubhada.shetti', None, 'urva.d', 'vikram.sagar', 'karan.chhadawa', 'dishasaraiya', 'shah.jm', 'acadithya.m', 'anilguruprasad', 'bhumika.kava', 'omkar.karande', 'mehanshi.p', 'taral.mehta']"
120,208,7,55,2,"['omkar.karande', 'sachin.sc']",4,"['dishasaraiya', 'shivam.rs', 'vidhi.satra', 'harish.c']",53,"['dhaval.vs', 'akash.mehta', 'vijen.g', 'harshada.benke', 'het.manek', 's.balsaraf73', 'viral.mamaniya', 'nishad.joshi', 'gayatri.gandhi', 'kunj.haria', 's.vohra', 'saumya.kamde', 'siddhesh0607', 'hitendra.k', 'meetparadia', 'yjb', 'doobvoob', 'parth.nj', 'sanjana.dhulla', 'jitun', 'chauhanajay4u', 'parthkataria999', 'arati.mule2900', 'fatima.h', 'dvb', 'navneet.d', 'ankita.nd', 'pratyaksh.i', 'jinali.d', 'nayan_nanohub', 'soham.sk', 'j.kariya', 's.ambardekar', 'srinidhi.g', 'adithya.n', 'anuj.cm', 'nainil.m', 'shubhada.shetti', None, 'shraddha.jj', 'arya.ambardekar', 'd.kotecha', 'harshal.bhole', 'yash.gulve', 'urva.d', 'karan.chhadawa', 'shah.jm', 'acadithya.m', 'anilguruprasad', 'bhumika.kava', 'mehanshi.p', 'anilthosar', 'vignesh.j']",59,"['dhaval.vs', 'akash.mehta', 'vijen.g', 'harshada.benke', 'het.manek', 's.balsaraf73', 'viral.mamaniya', 'nishad.joshi', 'gayatri.gandhi', 'kunj.haria', 's.vohra', 'saumya.kamde', 'siddhesh0607', 'hitendra.k', 'meetparadia', 'yjb', 'doobvoob', 'shivam.rs', 'parth.nj', 'sanjana.dhulla', 'jitun', 'chauhanajay4u', 'parthkataria999', 'sachin.sc', 'arati.mule2900', 'fatima.h', 'dvb', 'navneet.d', 'ankita.nd', 'pratyaksh.i', 'jinali.d', 'nayan_nanohub', 'soham.sk', 'j.kariya', 's.ambardekar', 'srinidhi.g', 'adithya.n', 'anuj.cm', 'harish.c', 'nainil.m', 'shubhada.shetti', None, 'shraddha.jj', 'arya.ambardekar', 'd.kotecha', 'harshal.bhole', 'yash.gulve', 'urva.d', 'karan.chhadawa', 'dishasaraiya', 'vidhi.satra', 'shah.jm', 'acadithya.m', 'anilguruprasad', 'bhumika.kava', 'omkar.karande', 'mehanshi.p', 'anilthosar', 'vignesh.j']"
120,48,7,35,6,"['dishasaraiya', 'shivam.rs', 'vidhi.satra', 'sachin.sc', 'harish.c', 'omkar.karande']",0,[],29,"['harshada.benke', 'rajat.p', 'rahul.jethwa', 'mayuresh.auti', 'rishi.mistry', 'shah.ns', 'aditya27', 'ragini.g', 'jugal.vaja', 'paras.mehta', 'saurabh.palde', 'arati.mule2900', 'rutuja.mehta', 'pinak.p', 'dhwani.vichhi', 'jay.km', 'anuj.cm', 'umed.jadhav', None, 's.suvarna', 'parin.ss', 'abhay.nadkarni', 'hitvena.shah', 'sakshi.trivedi', 'pritish.mishra1', 'shail.maroo', 'nikita.rp', 'd.haria', 'jagnoor.p']",35,"['harshada.benke', 'rajat.p', 'rahul.jethwa', 'mayuresh.auti', 'rishi.mistry', 'shah.ns', 'aditya27', 'ragini.g', 'jugal.vaja', 'shivam.rs', 'paras.mehta', 'saurabh.palde', 'arati.mule2900', 'sachin.sc', 'rutuja.mehta', 'pinak.p', 'dhwani.vichhi', 'jay.km', 'anuj.cm', 'umed.jadhav', 'harish.c', None, 's.suvarna', 'parin.ss', 'abhay.nadkarni', 'hitvena.shah', 'sakshi.trivedi', 'dishasaraiya', 'pritish.mishra1', 'vidhi.satra', 'shail.maroo', 'nikita.rp', 'd.haria', 'jagnoor.p', 'omkar.karande']"
120,211,7,9,3,"['shivam.rs', 'omkar.karande', 'harish.c']",3,"['dishasaraiya', 'vidhi.satra', 'sachin.sc']",6,"['ragini.g', 'rajat.p', 'komkar8.ok', 'd.haria', 'inderjitsingh', None]",12,"['ragini.g', None, 'dishasaraiya', 'shivam.rs', 'rajat.p', 'vidhi.satra', 'komkar8.ok', 'd.haria', 'sachin.sc', 'inderjitsingh', 'harish.c', 'omkar.karande']"
121,92,7,16,2,"['utkarsha531998', 'swaroopaphadke1']",4,"['jdubblej', 'james.lloydhughes', 'djpavan1997', 'tongq08']",14,"['2509patilkomal', 'priyupawar0797', 'utkarshajadhav2018', 'patilkomal100997', 'nikitapatil13', 'shubhangi6', 'snehalavate3', 'sonalimiraje', 'snehalawand7', 'shreeyarane19', 'cpatil7896', 'preranadhumal12575', None, 'ameysabanis16']",20,"['utkarsha531998', '2509patilkomal', 'utkarshajadhav2018', 'nikitapatil13', 'shubhangi6', 'snehalavate3', 'james.lloydhughes', 'jdubblej', 'preranadhumal12575', None, 'ameysabanis16', 'priyupawar0797', 'patilkomal100997', 'tongq08', 'sonalimiraje', 'swaroopaphadke1', 'snehalawand7', 'shreeyarane19', 'cpatil7896', 'djpavan1997']"
121,94,7,12,2,"['utkarsha531998', 'djpavan1997']",4,"['jdubblej', 'james.lloydhughes', 'swaroopaphadke1', 'tongq08']",10,"['priyupawar0797', 'pritammorankar', 'sonalimiraje', 'nikitapatil13', 'shubhangi6', 'harshada11', 'afiya2626', 'mrachapalli443', None, 'ameysabanis16']",16,"['utkarsha531998', 'nikitapatil13', 'shubhangi6', 'james.lloydhughes', 'jdubblej', 'afiya2626', None, 'ameysabanis16', 'priyupawar0797', 'pritammorankar', 'tongq08', 'sonalimiraje', 'swaroopaphadke1', 'harshada11', 'mrachapalli443', 'djpavan1997']"
122,218,7,18,2,"['mconsigli', 'alessy.leblanc']",4,"['roychaudhurirajarshi', 'wriddhichakroborty', 'ocojocaru', 'u1212698']",16,"['angusmo', 'jgnall', 'vmouradian', 'ajewers', 'tinamaurer', 'bdeguire', 'matthewsarge', 'bdester', 'jrosborne', 'jkvaternik', 'menglingshi', 'rwbrown', 'ayen', 'ranonyai', None, 'aeshak']",22,"['angusmo', 'vmouradian', 'alessy.leblanc', 'wriddhichakroborty', 'roychaudhurirajarshi', 'jkvaternik', 'menglingshi', 'ayen', 'jgnall', None, 'ajewers', 'tinamaurer', 'bdeguire', 'matthewsarge', 'ocojocaru', 'bdester', 'jrosborne', 'mconsigli', 'rwbrown', 'ranonyai', 'aeshak', 'u1212698']"
124,115,7,66,2,"['chandol314', 'eric3331']",4,"['mskaza', 'msokolov', 'opin', 'rcperkins']",64,"['sharm338', 'ng000046', 'mendo123', 'damic014', 'levac004', 'werki004', 'and04848', 'almai005', 'wegex009', 'prusi009', 'schm4149', 'olso5589', 'vuong056', 'hentg030', 'olso7126', 'bajda004', 'buchnich', 'raabx028', 'nebix006', 'richard_thompson', 'fuxxx391', 'mukon004', 'gesex006', 'sahyo002', 'alhin010', 'lyde0037', 'joh02339', 'thiosady', 'yang6086', 'salmo091', 'utzma006', 'kambo001', 'zamri003', 'sirraf1', 'hagst077', 'kapla302', 'jarga001', 'hanza023', 'gagno094', 'gerva039', 'leex8370', 'tran0559', 'royxx318', 'kianx006', 'zhou0868', 'klonc003', 'dang0134', 'keech015', 'wille474', 'tuft0029', 'parke867', 'leama008', 'conwe007', 'mendo172', None, 'klung009', 'spred003', 'udstr005', 'nicho919', 'yang5123', 'dixon347', 'providedrailroad', 'kruss008', 'sswisher']",70,"['sharm338', 'ng000046', 'mendo123', 'damic014', 'levac004', 'werki004', 'opin', 'and04848', 'almai005', 'wegex009', 'prusi009', 'schm4149', 'olso5589', 'vuong056', 'hentg030', 'olso7126', 'bajda004', 'buchnich', 'raabx028', 'nebix006', 'richard_thompson', 'fuxxx391', 'mukon004', 'gesex006', 'sahyo002', 'rcperkins', 'alhin010', 'lyde0037', 'joh02339', 'msokolov', 'thiosady', 'eric3331', 'yang6086', 'salmo091', 'utzma006', 'kambo001', 'zamri003', 'sirraf1', 'mskaza', 'hagst077', 'kapla302', 'jarga001', 'hanza023', 'gagno094', 'gerva039', 'leex8370', 'chandol314', 'tran0559', 'royxx318', 'kianx006', 'zhou0868', 'klonc003', 'dang0134', 'keech015', 'wille474', 'tuft0029', 'parke867', 'leama008', 'conwe007', 'mendo172', None, 'klung009', 'spred003', 'udstr005', 'nicho919', 'yang5123', 'dixon347', 'providedrailroad', 'kruss008', 'sswisher']"
124,116,7,36,4,"['mskaza', 'msokolov', 'opin', 'rcperkins']",2,"['chandol314', 'eric3331']",32,"['vmouradian', 'komminiadithya', 'jcrouss', 'emunguia', 'dgabriel', 'aksamija', 'jgnall', 'ayen', 'ltweston', 'bdester', 'aphauser', 'rwbrown', 'mjaffe', 'cmkennedy', 'angusmo', 'sfick', 'jkvaternik', 'menglingshi', 'dperry', 'adonadio', 'fpanikov', None, 'ajewers', 'oterry', 'whobby', 'tfloyd', 'jaandrade', 'jrosborne', 'bdeguire', 'tinamaurer', 'aeshak', 'inorman']",38,"['vmouradian', 'komminiadithya', 'eric3331', 'jcrouss', 'emunguia', 'dgabriel', 'opin', 'aksamija', 'jgnall', 'ayen', 'mskaza', 'ltweston', 'aeshak', 'bdester', 'aphauser', 'rwbrown', 'mjaffe', 'cmkennedy', 'angusmo', 'chandol314', 'sfick', 'jkvaternik', 'menglingshi', 'dperry', 'adonadio', 'fpanikov', None, 'ajewers', 'oterry', 'whobby', 'tfloyd', 'jaandrade', 'jrosborne', 'bdeguire', 'tinamaurer', 'rcperkins', 'msokolov', 'inorman']"
124,347,7,27,4,"['mskaza', 'msokolov', 'opin', 'rcperkins']",2,"['chandol314', 'eric3331']",23,"['komminiadithya', 'cdunnington', 'jcrouss', 'aksamija', 'jgnall', 'asanmiguel', 'matthewsarge', 'bdester', 'rwbrown', 'mjaffe', 'ranonyai', 'angusmo', 'sfick', 'fpanikov', None, 'siddharthasr', 'ajewers', 'oterry', 'tfloyd', 'tinamaurer', 'bdeguire', 'jrosborne', 'aeshak']",29,"['komminiadithya', 'eric3331', 'cdunnington', 'jcrouss', 'aksamija', 'opin', 'jgnall', 'asanmiguel', 'mskaza', 'aeshak', 'matthewsarge', 'bdester', 'rwbrown', 'mjaffe', 'ranonyai', 'angusmo', 'chandol314', 'sfick', 'fpanikov', None, 'siddharthasr', 'ajewers', 'oterry', 'tfloyd', 'tinamaurer', 'bdeguire', 'jrosborne', 'rcperkins', 'msokolov']"
125,47,7,53,6,"['preeti.kharas', 'neil.dani9', 'sunilkavatkar', 'sarvesh.mohite97', 'prajaktathorat24', 'prashant20297']",0,[],47,"['sonalikharade5', 'prathameshpatle13', 'pratikkul26', 'shwetatambe12', 'shubhamchury1', 'prasadbodekar1996', 'sohammhas', 'sameersanjaysalveashalata', 'prashantmanjre9', 'hsnnalwala7', 'pnrasika', 'rohit.elawadekar333', 'tejeshwarvaidya', 'suffiyanshaikh92', 'siddhant8291', 'tanmaykkudalkar', 'shahraj165', 'vanaja2812', 'rishimud', 'h10waghela', 'nichiteprh1995', 'rushikeshrane27', 'prasadmasurkar97', 'susmeetsukte', 'shubhambhosale', 'gabru1803', 'kaushiksawant93', 'nehakhushi1418', 'sanket.r.makwana', 'shelarpranali1309', 'risha15', 'prathamesh.shivmare1', 'kiranpanchal', 'pandeymikhil', 'aditi.ramadwar', 'ankitagamare2218', None, 'rugvedikesare427', 'alpha_32123', 'snehald827', 'arpitakudesia3011', 'akshayjambhale07', 'sukanyajadhav1997', 'komalbangar54', 'divyassonawane', 'arpitgodbole7', 'pawarrajshree12']",53,"['sonalikharade5', 'prathameshpatle13', 'pratikkul26', 'shwetatambe12', 'shubhamchury1', 'prasadbodekar1996', 'sohammhas', 'sameersanjaysalveashalata', 'sarvesh.mohite97', 'prashantmanjre9', 'hsnnalwala7', 'pnrasika', 'rohit.elawadekar333', 'tejeshwarvaidya', 'suffiyanshaikh92', 'siddhant8291', 'tanmaykkudalkar', 'shahraj165', 'vanaja2812', 'rishimud', 'sunilkavatkar', 'h10waghela', 'nichiteprh1995', 'rushikeshrane27', 'prasadmasurkar97', 'susmeetsukte', 'shubhambhosale', 'gabru1803', 'kaushiksawant93', 'nehakhushi1418', 'preeti.kharas', 'neil.dani9', 'sanket.r.makwana', 'shelarpranali1309', 'risha15', 'prathamesh.shivmare1', 'kiranpanchal', 'pandeymikhil', 'aditi.ramadwar', 'prajaktathorat24', 'ankitagamare2218', 'prashant20297', None, 'rugvedikesare427', 'alpha_32123', 'snehald827', 'arpitakudesia3011', 'akshayjambhale07', 'sukanyajadhav1997', 'komalbangar54', 'divyassonawane', 'arpitgodbole7', 'pawarrajshree12']"
125,264,7,52,6,"['preeti.kharas', 'neil.dani9', 'sunilkavatkar', 'sarvesh.mohite97', 'prajaktathorat24', 'prashant20297']",0,[],46,"['sonalikharade5', 'chinmay_kudtarkar', 'pratikkul26', 'ashu0497', 'sohammhas', 'dushy98', 'pavanborde910', 'hsnnalwala7', 'sanjit', 'rohit.elawadekar333', 'tejeshwarvaidya', 'suffiyanshaikh92', 'bendalneha', 'tanmaykkudalkar', 'nikneswankar16', 'sahilsankhe2023', 'as691177', 'kajaldevake30', 'vanaja2812', 'durgeshthorat4', 'thosarebhavesh', 'rushikeshrane27', 'kavi1388', 'pranjalijadhav0911', 'shubhambhosale', 'amey123', 'akibmujawar13', 'saurabh.bahad13', 'aloksardesai97', 'prathamesh.shivmare1', 'ashwinkadam1996', 'kiranpanchal', 'pandeymikhil', 'anujmdeorukhkar', 'akankshagunjal99722', 'zainabshah181997', 'ankitagamare2218', 'mayurmore', None, 'rugvedikesare427', 'alpha_32123', 'snehald827', 'sukanyajadhav1997', 'manedeven09', 'komalbangar54', 'arpitgodbole7']",52,"['sonalikharade5', 'chinmay_kudtarkar', 'pratikkul26', 'ashu0497', 'sohammhas', 'sarvesh.mohite97', 'dushy98', 'pavanborde910', 'hsnnalwala7', 'sanjit', 'rohit.elawadekar333', 'tejeshwarvaidya', 'suffiyanshaikh92', 'bendalneha', 'tanmaykkudalkar', 'nikneswankar16', 'sahilsankhe2023', 'as691177', 'kajaldevake30', 'sunilkavatkar', 'vanaja2812', 'durgeshthorat4', 'thosarebhavesh', 'rushikeshrane27', 'kavi1388', 'pranjalijadhav0911', 'shubhambhosale', 'amey123', 'preeti.kharas', 'neil.dani9', 'akibmujawar13', 'saurabh.bahad13', 'aloksardesai97', 'prathamesh.shivmare1', 'ashwinkadam1996', 'kiranpanchal', 'pandeymikhil', 'prajaktathorat24', 'anujmdeorukhkar', 'prashant20297', 'akankshagunjal99722', 'zainabshah181997', 'ankitagamare2218', 'mayurmore', None, 'rugvedikesare427', 'alpha_32123', 'snehald827', 'sukanyajadhav1997', 'manedeven09', 'komalbangar54', 'arpitgodbole7']"
125,46,7,34,2,"['preeti.kharas', 'neil.dani9']",4,"['sunilkavatkar', 'prajaktathorat24', 'prashant20297', 'sarvesh.mohite97']",32,"['soureen.g', 'gaurav.dangat', 'akshatask', 'yash.mhatre', 'pnrasika', 'raj.velani', 'pratham123', 'siddhant8291', 'smita.n', 'niraj.parte', 'jagruti.patil', 'hrishikesh12', 'jayesh.a', 'nikitamittal97', 'vatsal23', 'sonali.gavkar', 'shelarpranali1309', 'saayuj.s', 'pjkarmokar', 'pawan.mojar', 'rajas.b', 'anjana.bhave', 'mayur.gosavi', None, 'akansha_sampat', 'tapan.garge', 'kharatomkar24', 'snehald827', 'arpitakudesia3011', 'vaishnavi.soni', 'mayuri.sapkal', 'priyanka.rp']",38,"['soureen.g', 'gaurav.dangat', 'akshatask', 'yash.mhatre', 'sarvesh.mohite97', 'pnrasika', 'raj.velani', 'pratham123', 'siddhant8291', 'smita.n', 'niraj.parte', 'jagruti.patil', 'hrishikesh12', 'sunilkavatkar', 'jayesh.a', 'nikitamittal97', 'vatsal23', 'sonali.gavkar', 'preeti.kharas', 'neil.dani9', 'shelarpranali1309', 'saayuj.s', 'pjkarmokar', 'pawan.mojar', 'rajas.b', 'anjana.bhave', 'prajaktathorat24', 'prashant20297', 'mayur.gosavi', None, 'akansha_sampat', 'tapan.garge', 'kharatomkar24', 'snehald827', 'arpitakudesia3011', 'vaishnavi.soni', 'mayuri.sapkal', 'priyanka.rp']"
125,308,7,11,4,"['sarvesh.mohite97', 'prajaktathorat24', 'prashant20297', 'neil.dani9']",2,"['sunilkavatkar', 'preeti.kharas']",7,"['pratikkul26', 'sahilsankhe2023', 'rushikeshrane27', 'dushy98', 'durgeshthorat4', 'zainabshah181997', None]",13,"['preeti.kharas', 'neil.dani9', 'pratikkul26', 'sarvesh.mohite97', 'dushy98', 'prajaktathorat24', 'zainabshah181997', 'prashant20297', 'durgeshthorat4', None, 'sahilsankhe2023', 'sunilkavatkar', 'rushikeshrane27']"
126,127,7,12,5,"['jpvdrm', 'bjc16', 'nichoke', 'acamarda1103', 'ebonyshantellluster']",1,['cyronferguson'],7,"['shchlin', 'gmb12c', 'mc13c', 'stephaniemarxsen', 'shaonbarua', 'estanisauskis', None]",13,"['shchlin', 'jpvdrm', 'mc13c', 'nichoke', 'stephaniemarxsen', 'acamarda1103', None, 'gmb12c', 'bjc16', 'cyronferguson', 'shaonbarua', 'estanisauskis', 'ebonyshantellluster']"
126,129,7,12,6,"['jpvdrm', 'bjc16', 'nichoke', 'cyronferguson', 'acamarda1103', 'ebonyshantellluster']",0,[],6,"['mc13c', 'amm15s', 'gmb12c', 'shaonbarua', None, 'jenired']",12,"['jpvdrm', 'mc13c', 'nichoke', 'acamarda1103', 'jenired', None, 'amm15s', 'gmb12c', 'bjc16', 'cyronferguson', 'shaonbarua', 'ebonyshantellluster']"
126,128,7,7,3,"['nichoke', 'cyronferguson', 'ebonyshantellluster']",3,"['bjc16', 'jpvdrm', 'acamarda1103']",4,"['stephaniemarxsen', 'shaonbarua', None, 'amm15s']",10,"['jpvdrm', 'amm15s', 'bjc16', 'nichoke', 'cyronferguson', 'shaonbarua', 'acamarda1103', 'stephaniemarxsen', None, 'ebonyshantellluster']"
126,130,7,7,6,"['jpvdrm', 'bjc16', 'nichoke', 'cyronferguson', 'acamarda1103', 'ebonyshantellluster']",0,[],1,[None],7,"['jpvdrm', 'bjc16', 'nichoke', 'cyronferguson', 'acamarda1103', None, 'ebonyshantellluster']"
129,73,6,24,5,"['johnnyh97', 'vgedal', 'sgallen2', 'danmcteague53', 'kksnova']",0,[],19,"['thorstensenr', 'mkmastaler', 'rwynne1', 'cisrael', 'sabrina0850', 'minnoce1', 'jpeders1', None, 'kcoope13', 'jcarlton', 'spanasci', 'nflorio', 'jbonanot', 'auhunt32', 'ballasmatthew', 'hcenteno', 'mross18', 'joeyorr4', 'pgenett']",24,"['thorstensenr', 'mkmastaler', 'sgallen2', 'rwynne1', 'cisrael', 'sabrina0850', 'minnoce1', 'jpeders1', None, 'kcoope13', 'kksnova', 'jcarlton', 'johnnyh97', 'spanasci', 'vgedal', 'nflorio', 'jbonanot', 'auhunt32', 'ballasmatthew', 'hcenteno', 'mross18', 'danmcteague53', 'joeyorr4', 'pgenett']"
129,121,6,17,4,"['johnnyh97', 'vgedal', 'danmcteague53', 'kksnova']",1,['sgallen2'],13,"['mwebste3', 'spanasci', 'mkmastaler', 'hcenteno', 'cmarrs7', 'cisrael', 'joeyorr4', 'pdantoin', 'sabrina0850', 'japun', 'mballas', None, 'jcarlton']",18,"['mkmastaler', 'sgallen2', 'cmarrs7', 'cisrael', 'sabrina0850', 'mballas', None, 'kksnova', 'jcarlton', 'johnnyh97', 'spanasci', 'vgedal', 'mwebste3', 'hcenteno', 'danmcteague53', 'pdantoin', 'joeyorr4', 'japun']"
129,321,6,17,5,"['johnnyh97', 'vgedal', 'sgallen2', 'danmcteague53', 'kksnova']",0,[],12,"['jbonanot', 'thorstensenr', 'auhunt32', 'ballasmatthew', 'mross18', 'rwynne1', 'joeyorr4', 'sabrina0850', 'minnoce1', None, 'kcoope13', 'jcarlton']",17,"['thorstensenr', 'sgallen2', 'rwynne1', 'sabrina0850', 'minnoce1', None, 'kcoope13', 'kksnova', 'jcarlton', 'johnnyh97', 'vgedal', 'jbonanot', 'auhunt32', 'ballasmatthew', 'mross18', 'danmcteague53', 'joeyorr4']"
129,120,6,16,5,"['johnnyh97', 'vgedal', 'sgallen2', 'danmcteague53', 'kksnova']",0,[],11,"['jbonanot', 'mkmastaler', 'hcenteno', 'rwynne1', 'cisrael', 'joeyorr4', 'jdelaure', 'pgenett', 'jpeders1', None, 'kcoope13']",16,"['mkmastaler', 'sgallen2', 'rwynne1', 'cisrael', 'jdelaure', 'jpeders1', None, 'kcoope13', 'kksnova', 'johnnyh97', 'vgedal', 'jbonanot', 'hcenteno', 'danmcteague53', 'joeyorr4', 'pgenett']"
129,397,6,15,3,"['johnnyh97', 'kksnova', 'sgallen2']",2,"['vgedal', 'danmcteague53']",12,"['nflorio', 'jbonanot', 'spanasci', 'mross18', 'cisrael', 'pgenett', 'joeyorr4', 'minnoce1', 'jpeders1', None, 'kcoope13', 'jcarlton']",17,"['sgallen2', 'cisrael', 'minnoce1', 'jpeders1', None, 'kcoope13', 'kksnova', 'jcarlton', 'johnnyh97', 'spanasci', 'vgedal', 'nflorio', 'jbonanot', 'mross18', 'danmcteague53', 'joeyorr4', 'pgenett']"
129,323,6,11,3,"['johnnyh97', 'vgedal', 'danmcteague53']",2,"['kksnova', 'sgallen2']",8,"['thorstensenr', 'mkmastaler', 'hcenteno', 'kmin2', 'jdelaure', 'minnoce1', None, 'jcarlton']",13,"['thorstensenr', 'mkmastaler', 'sgallen2', 'kmin2', 'jdelaure', 'minnoce1', None, 'kksnova', 'jcarlton', 'johnnyh97', 'vgedal', 'hcenteno', 'danmcteague53']"
129,396,6,10,2,"['kksnova', 'sgallen2']",3,"['johnnyh97', 'vgedal', 'danmcteague53']",8,"['jbonanot', 'rwynne1', 'cisrael', 'joeyorr4', 'pgenett', None, 'kcoope13', 'jcarlton']",13,"['johnnyh97', 'vgedal', 'jbonanot', 'sgallen2', 'rwynne1', 'cisrael', 'danmcteague53', 'joeyorr4', 'pgenett', None, 'kcoope13', 'kksnova', 'jcarlton']"
129,398,6,9,3,"['johnnyh97', 'vgedal', 'sgallen2']",2,"['danmcteague53', 'kksnova']",6,"['cmarrs7', 'cisrael', 'joeyorr4', 'jpeders1', None, 'jcarlton']",11,"['johnnyh97', 'vgedal', 'sgallen2', 'cmarrs7', 'cisrael', 'danmcteague53', 'joeyorr4', 'jpeders1', None, 'kksnova', 'jcarlton']"
129,78,6,7,1,['johnnyh97'],4,"['vgedal', 'danmcteague53', 'kksnova', 'sgallen2']",6,"['mkmastaler', 'cmarrs7', 'japun', 'mballas', None, 'jcarlton']",11,"['johnnyh97', 'vgedal', 'mkmastaler', 'sgallen2', 'cmarrs7', 'danmcteague53', 'japun', 'mballas', None, 'kksnova', 'jcarlton']"
129,324,6,7,2,"['johnnyh97', 'vgedal']",3,"['danmcteague53', 'kksnova', 'sgallen2']",5,"['mkmastaler', 'cmarrs7', 'joeyorr4', 'mballas', None]",10,"['johnnyh97', 'vgedal', 'mkmastaler', 'sgallen2', 'cmarrs7', 'danmcteague53', 'joeyorr4', 'mballas', None, 'kksnova']"
129,74,6,6,2,"['johnnyh97', 'vgedal']",3,"['danmcteague53', 'kksnova', 'sgallen2']",4,"['mballas', None, 'kcoope13', 'thorstensenr']",9,"['johnnyh97', 'vgedal', 'thorstensenr', 'sgallen2', 'danmcteague53', 'mballas', None, 'kcoope13', 'kksnova']"
129,79,6,6,1,['kksnova'],4,"['johnnyh97', 'vgedal', 'danmcteague53', 'sgallen2']",5,"['jbonanot', 'hcenteno', 'minnoce1', None, 'jcarlton']",10,"['johnnyh97', 'vgedal', 'jbonanot', 'hcenteno', 'sgallen2', 'danmcteague53', 'minnoce1', None, 'kksnova', 'jcarlton']"
132,28,6,97,5,"['sgu20121462', 'sgu20161535', 'sgu20141385', 'sgu20141459', 'sgu20141450']",0,[],92,"['harry0913', 'sgu20171570', 'sgu20141483', 'sgu20091548', 'sgu20171586', 'sgu20101498', 'sgu20171524', 'ppjunb12', 'jkson3', 'sg20121208', 'sgu20131481', 'sgu20151487', 'sgu20151476', 'sgu20171556', 'sgu20151513', 'sgu20151422', 'sgu20141448', 'sgu20131507', 'sgu20141474', 'sgu20141393', 'tktm44', 'a960710', 'sgu20141398', 'sgu20141433', 'sgu20161503', 'sgu20161542e', 'sgu20151438', 'sgu20151463', 'sgu20141460', 'sgu20171508', 'sgu20141415', 'sgu20131410', 'sgu20171558', 'sgu20141424', 'sgu20171538', 'sgu20151194', 'sgu20141471', 'sgu20141430', 'sgu20151486', 'sgu20171503', 'seohyeoniii', 'sgu20141417', 'sgu20131455', 'sgu20151448', 'sgu20151452', 'sgu20151410', 'sgu20141394', 'sgu20141411', 'sgu20151456', 'sgu20171526', 'gjfdjzo', 'sgu20151464', 'sgu20141395', 'sgu20141408', 'sgu20141465', 'han20151510', 'sgu20171502', 'claritas', 'sgu20131462', 'sgu20121498', 'sgu20171562', 'sgu20171566', 'sgu20131508', 'sgu20141414', 'sgu20141478', 'sgu20161542', 'sgu20141468', 'sgu20141389', 'sgu20171550', 'sgu20151485', 'sgu20161474', 'dusxo124', 'sgu20121532', 'sgu20131432', 'sgu20151436', 'sgu20171490', 'sgu20151424', 'sgu20141461', 'dydgus201', 'sgu20141480', None, 'sgu20171520', 'sgu20141458', 'sgu20141484', 'sgu20131492', 'sgu20151490', 'sgu20141404', 'sgu20131412', 'sgu20141476', 'sgu20151478', 'sgu20151418', 'sgu20171572']",97,"['harry0913', 'sgu20171570', 'sgu20141483', 'sgu20091548', 'sgu20171586', 'sgu20161535', 'sgu20101498', 'sgu20171524', 'ppjunb12', 'jkson3', 'sgu20121462', 'sg20121208', 'sgu20131481', 'sgu20151487', 'sgu20151476', 'sgu20171556', 'sgu20151513', 'sgu20151422', 'sgu20141448', 'sgu20131507', 'sgu20141474', 'sgu20141393', 'tktm44', 'a960710', 'sgu20141398', 'sgu20141433', 'sgu20161503', 'sgu20161542e', 'sgu20151438', 'sgu20151463', 'sgu20141460', 'sgu20171508', 'sgu20141415', 'sgu20131410', 'sgu20171558', 'sgu20141424', 'sgu20171538', 'sgu20151194', 'sgu20141471', 'sgu20141430', 'sgu20151486', 'sgu20171503', 'seohyeoniii', 'sgu20141417', 'sgu20131455', 'sgu20151448', 'sgu20151452', 'sgu20151410', 'sgu20141394', 'sgu20141411', 'sgu20151456', 'sgu20171526', 'gjfdjzo', 'sgu20151464', 'sgu20141395', 'sgu20141408', 'sgu20141465', 'han20151510', 'sgu20171502', 'claritas', 'sgu20131462', 'sgu20121498', 'sgu20141459', 'sgu20171562', 'sgu20171566', 'sgu20131508', 'sgu20141414', 'sgu20141478', 'sgu20161542', 'sgu20141468', 'sgu20141389', 'sgu20171550', 'sgu20151485', 'sgu20161474', 'dusxo124', 'sgu20121532', 'sgu20131432', 'sgu20151436', 'sgu20171490', 'sgu20141385', 'sgu20151424', 'dydgus201', 'sgu20141450', 'sgu20141461', 'sgu20141480', None, 'sgu20171520', 'sgu20141458', 'sgu20141484', 'sgu20131492', 'sgu20151490', 'sgu20141404', 'sgu20131412', 'sgu20141476', 'sgu20151478', 'sgu20151418', 'sgu20171572']"
132,22,6,43,4,"['sgu20141459', 'sgu20141385', 'sgu20121462', 'sgu20141450']",1,['sgu20161535'],39,"['sgu20141417', 'harry0913', 'sgu20141441', 'sgu20131455', 'sgu20131458', 'sgu960911', 'sgu20141394', 'sgu20141483', 'sgu20141411', 'ppjunb12', 'gjfdjzo', 'sgu20141395', 'sg20121208', 'sgu20141408', 'sgu20141465', 'sgu20131481', 'sgu20131462', 'sgu20151487', 'sogang20141460', 'sgu20131508', 'sgu20141448', 'sgu20141468', 'sgu20131507', 'sgu20141389', 'sgu20151485', 'sgu2014726019', 'sgu20161474', 'sgu20131432', 'sgu20141393', None, 'sgu20161503', 'sgu20131412', 'sgu20141476', 'sgu20141460', 'sgu20141415', 'sgu20131410', 'sgu20151194', 'sgu20161494', 'sgu20141471']",44,"['sgu20141417', 'harry0913', 'sgu20141441', 'sgu20131455', 'sgu20131458', 'sgu960911', 'sgu20141394', 'sgu20141483', 'sgu20161535', 'sgu20141411', 'ppjunb12', 'sgu20121462', 'gjfdjzo', 'sgu20141395', 'sg20121208', 'sgu20141408', 'sgu20141465', 'sgu20131481', 'sgu20131462', 'sgu20151487', 'sgu20141459', 'sogang20141460', 'sgu20131508', 'sgu20141448', 'sgu20141468', 'sgu20131507', 'sgu20141389', 'sgu20151485', 'sgu2014726019', 'sgu20161474', 'sgu20131432', 'sgu20141385', 'sgu20141393', None, 'sgu20141450', 'sgu20161503', 'sgu20131412', 'sgu20141476', 'sgu20141460', 'sgu20141415', 'sgu20131410', 'sgu20151194', 'sgu20161494', 'sgu20141471']"
132,12,6,8,5,"['sgu20121462', 'sgu20161535', 'sgu20141385', 'sgu20141459', 'sgu20141450']",0,[],3,"['bkkim60', None, 'claritas']",8,"['sgu20121462', 'bkkim60', 'claritas', 'sgu20161535', 'sgu20141385', 'sgu20141459', None, 'sgu20141450']"
134,53,6,75,1,['vatsal23'],4,"['pratham123', 'nantafakih', 'anjana.bhave', 'jayesh.a']",74,"['nikhilchaudhari5516', 'shindedeepak129', 'rajat.p', 'smahamulkar1013', 'selimajack26', 'akau100', 'rohitnair77880', 'shah.ns', 'aditya27', 'shreyahonagekar04', 'jugal.vaja', 'shivam.rs', 'chavankeasmita29', 'sakshi.bhosle', 'paras.mehta', 'saurabh.palde', 'sushobh', 'zeevd19', 'sachin.sc', 'arthaya.koyande28', 'sujittupe3490', 'orencollaco97', 'shrutik1997.mallick', 'dhwani.vichhi', 'anujchhabra25', 'waynemdsouza', 'shraddha0306', 's.suvarna', 'pranitkumbhar19', 'sebin.bc', 'spawar.ap', 'naiksandesh1998', 'priyu0964', 'patilprasad0123', '15anuchaudhari', 'vidhi.satra', 'sukanyajadhav1997', 'maneshweta23', 'jeniferishwarya', 'd.haria', 'umeshlohote', 'jagnoor.p', 'kunalk4796', 'prithvianvekar21', 'evanjalinbenita', 'shubham.yelange', 'austin.dsouza1997', 'aadi', 'mayuridesai', 'shreyasmoolya', 'vixsnair', 'shaibilsabu', 'jayesh.kakkad8770', 'rohansaldanha6370', 'davidrisaac', 'shubhamnagpure745', 'swapnalimakdey25', 'yasir.mulla47', 'jay.km', 'ghevadeyogesh', 'adityadesu1', 'harish.c', None, 'ninad.mulay', 'adityadh943', 'parin.ss', 'abhay.nadkarni', 'sakshi.trivedi', 'dishasaraiya', 'aur_mnzs', 'saurabhgawade.777.4.sg', 'shail.maroo', 'wanichinmay577', 'omkar.karande']",79,"['nikhilchaudhari5516', 'shindedeepak129', 'rajat.p', 'smahamulkar1013', 'selimajack26', 'akau100', 'rohitnair77880', 'shah.ns', 'aditya27', 'shreyahonagekar04', 'jugal.vaja', 'shivam.rs', 'chavankeasmita29', 'sakshi.bhosle', 'paras.mehta', 'saurabh.palde', 'sushobh', 'zeevd19', 'jayesh.a', 'sachin.sc', 'arthaya.koyande28', 'vatsal23', 'sujittupe3490', 'orencollaco97', 'shrutik1997.mallick', 'dhwani.vichhi', 'anujchhabra25', 'waynemdsouza', 'shraddha0306', 's.suvarna', 'pranitkumbhar19', 'sebin.bc', 'spawar.ap', 'naiksandesh1998', 'priyu0964', 'patilprasad0123', '15anuchaudhari', 'vidhi.satra', 'sukanyajadhav1997', 'maneshweta23', 'jeniferishwarya', 'd.haria', 'umeshlohote', 'jagnoor.p', 'kunalk4796', 'prithvianvekar21', 'evanjalinbenita', 'shubham.yelange', 'austin.dsouza1997', 'aadi', 'mayuridesai', 'shreyasmoolya', 'pratham123', 'vixsnair', 'shaibilsabu', 'jayesh.kakkad8770', 'rohansaldanha6370', 'davidrisaac', 'shubhamnagpure745', 'swapnalimakdey25', 'nantafakih', 'yasir.mulla47', 'anjana.bhave', 'jay.km', 'ghevadeyogesh', 'adityadesu1', 'harish.c', None, 'ninad.mulay', 'adityadh943', 'parin.ss', 'abhay.nadkarni', 'sakshi.trivedi', 'dishasaraiya', 'aur_mnzs', 'saurabhgawade.777.4.sg', 'shail.maroo', 'wanichinmay577', 'omkar.karande']"
134,49,6,39,1,['nantafakih'],4,"['pratham123', 'anjana.bhave', 'vatsal23', 'jayesh.a']",38,"['muhammadanto27', 'steven123', 'biawak_terbengkalai', 'fadhilihsand', 'danielsinaga220', 'ariflinggasaputra28', 'fevikrisda', 'raflysna', 'frenkysiregar', 'irwansyahekaputra1', 'ismaelfozio', 'linaelfita29', 's.naek', 'threehans21', 'wahyuramadhan', 'oliversitorus', 'dedypurwadisinaga', 'srldaindars', 'dvnrvnd', 'alifindralukman', 'zeroabdi1212', 'raflysna3', 'afryanainggolan07', 'mekiripaldo00', 'muhammadrifqi', 'wahyu', 'donyricardo', 'dhaffiz_aries25', 'dwifurwana02', 'aditwiranu', 'ellyramadhanti957', None, 'rendipardosi', 'khairuhafiz', 'cintyarubiah', 'mhafiz15', 'jennipusva', 'benkhalifah94']",43,"['muhammadanto27', 'steven123', 'biawak_terbengkalai', 'fadhilihsand', 'danielsinaga220', 'ariflinggasaputra28', 'fevikrisda', 'raflysna', 'frenkysiregar', 'irwansyahekaputra1', 'ismaelfozio', 'pratham123', 'linaelfita29', 's.naek', 'threehans21', 'wahyuramadhan', 'oliversitorus', 'dedypurwadisinaga', 'srldaindars', 'jayesh.a', 'dvnrvnd', 'vatsal23', 'alifindralukman', 'zeroabdi1212', 'nantafakih', 'raflysna3', 'afryanainggolan07', 'mekiripaldo00', 'muhammadrifqi', 'anjana.bhave', 'wahyu', 'donyricardo', 'dhaffiz_aries25', 'dwifurwana02', 'aditwiranu', 'ellyramadhanti957', None, 'rendipardosi', 'khairuhafiz', 'cintyarubiah', 'mhafiz15', 'jennipusva', 'benkhalifah94']"
134,46,6,34,4,"['pratham123', 'anjana.bhave', 'vatsal23', 'jayesh.a']",1,['nantafakih'],30,"['soureen.g', 'gaurav.dangat', 'akshatask', 'yash.mhatre', 'pnrasika', 'raj.velani', 'siddhant8291', 'smita.n', 'niraj.parte', 'jagruti.patil', 'hrishikesh12', 'nikitamittal97', 'sonali.gavkar', 'preeti.kharas', 'neil.dani9', 'shelarpranali1309', 'saayuj.s', 'pjkarmokar', 'pawan.mojar', 'rajas.b', 'mayur.gosavi', None, 'akansha_sampat', 'tapan.garge', 'kharatomkar24', 'snehald827', 'arpitakudesia3011', 'vaishnavi.soni', 'mayuri.sapkal', 'priyanka.rp']",35,"['soureen.g', 'gaurav.dangat', 'akshatask', 'yash.mhatre', 'pnrasika', 'raj.velani', 'pratham123', 'siddhant8291', 'smita.n', 'niraj.parte', 'jagruti.patil', 'hrishikesh12', 'jayesh.a', 'nikitamittal97', 'vatsal23', 'sonali.gavkar', 'preeti.kharas', 'neil.dani9', 'nantafakih', 'shelarpranali1309', 'saayuj.s', 'pjkarmokar', 'pawan.mojar', 'anjana.bhave', 'rajas.b', 'mayur.gosavi', None, 'akansha_sampat', 'tapan.garge', 'kharatomkar24', 'snehald827', 'arpitakudesia3011', 'vaishnavi.soni', 'mayuri.sapkal', 'priyanka.rp']"
134,50,6,27,1,['vatsal23'],4,"['pratham123', 'nantafakih', 'anjana.bhave', 'jayesh.a']",26,"['ayushibhtngr96', 'gaurav.dangat', 'swedel', 'moregayatri4', 'shreyawazir', 'josephpatole23', 'gaurav.kolapate54', 'adityadesu1', None, 'morechinmay123', 'smita.n', 'megauripawar', 'sebin.bc', 'urusajack124', 'shivanianekar13', 'aur_mnzs', 'thomasshanekoshy', 'tanvi2881998', 'jeniferishwarya', 'aru2000in', 'manasvi.vartak10', 'siddeshwar', 'kpganesh121.gk', 'adityachachad', 'siluvaiwinston', 'swapnalimakdey25']",31,"['ayushibhtngr96', 'gaurav.dangat', 'moregayatri4', 'shreyawazir', 'pratham123', 'morechinmay123', 'smita.n', 'aru2000in', 'manasvi.vartak10', 'jayesh.a', 'siddeshwar', 'kpganesh121.gk', 'adityachachad', 'siluvaiwinston', 'vatsal23', 'swapnalimakdey25', 'swedel', 'nantafakih', 'anjana.bhave', 'josephpatole23', 'gaurav.kolapate54', 'adityadesu1', None, 'megauripawar', 'sebin.bc', 'urusajack124', 'shivanianekar13', 'aur_mnzs', 'thomasshanekoshy', 'tanvi2881998', 'jeniferishwarya']"
134,52,6,15,2,"['vatsal23', 'jayesh.a']",3,"['pratham123', 'nantafakih', 'anjana.bhave']",13,"['smita.n', 'shaibilsabu', 'evanjalinbenita', 'shriya.h.joshi', 'omkarkhedkaro', 'austin.dsouza1997', 'urvi.panchal', 'hit.kamble', 'rohansaldanha6370', 'selimajack26', None, 'ajitjadhav', 'swapnalimakdey25']",18,"['nantafakih', 'evanjalinbenita', 'urvi.panchal', 'austin.dsouza1997', 'anjana.bhave', 'selimajack26', None, 'pratham123', 'smita.n', 'shaibilsabu', 'swapnalimakdey25', 'shriya.h.joshi', 'omkarkhedkaro', 'hit.kamble', 'rohansaldanha6370', 'jayesh.a', 'vatsal23', 'ajitjadhav']"
134,165,6,13,4,"['pratham123', 'anjana.bhave', 'vatsal23', 'jayesh.a']",1,['nantafakih'],9,"['smita.n', 'gaurav.dangat', 'jagruti.patil', 'urvi.panchal', 'nikita.us', 'siddhesh.y', 'nikitamittal97', 'rahul.ys', None]",14,"['gaurav.dangat', 'nantafakih', 'urvi.panchal', 'anjana.bhave', 'nikita.us', None, 'siddhesh.y', 'pratham123', 'smita.n', 'jagruti.patil', 'jayesh.a', 'nikitamittal97', 'rahul.ys', 'vatsal23']"
134,163,6,9,2,"['pratham123', 'anjana.bhave']",3,"['nantafakih', 'vatsal23', 'jayesh.a']",7,"['gaurav.dangat', 'niraj.parte', 'pranav.ss', 'nikita.us', 'nikitamittal97', None, 'raj.velani']",12,"['pratham123', 'gaurav.dangat', 'niraj.parte', 'nantafakih', 'anjana.bhave', 'pranav.ss', 'nikita.us', 'jayesh.a', 'nikitamittal97', None, 'vatsal23', 'raj.velani']"
145,337,6,18,4,"['malikamalimran', 'usvah.tareen', 'princesramsha', 'rubab.nasir']",1,['bismashaikh26'],14,"['ms.padela', 'moizhuda7', 'haurainsia4', 'aflaha10', 'ms286611', 'me89', 'sheebahashmi0', 'mahefatima', 'sana17azim', 'areebaaa', 'alizeh', 'im.zohaib96', None, 'ummefarwah']",19,"['ms.padela', 'haurainsia4', 'usvah.tareen', 'princesramsha', 'me89', 'mahefatima', 'bismashaikh26', 'alizeh', None, 'ummefarwah', 'moizhuda7', 'aflaha10', 'ms286611', 'sheebahashmi0', 'sana17azim', 'areebaaa', 'im.zohaib96', 'malikamalimran', 'rubab.nasir']"
145,410,6,17,5,"['usvah.tareen', 'princesramsha', 'bismashaikh26', 'malikamalimran', 'rubab.nasir']",0,[],12,"['moizhuda7', 'haurainsia4', 'aflaha10', 'ms286611', 'me89', 'sheebahashmi0', 'mahefatima', 'areebaaa', 'sana17azim', 'alizeh', 'im.zohaib96', None]",17,"['haurainsia4', 'usvah.tareen', 'princesramsha', 'me89', 'mahefatima', 'bismashaikh26', 'alizeh', None, 'moizhuda7', 'aflaha10', 'ms286611', 'sheebahashmi0', 'areebaaa', 'sana17azim', 'im.zohaib96', 'malikamalimran', 'rubab.nasir']"
145,133,6,12,3,"['malikamalimran', 'princesramsha', 'rubab.nasir']",2,"['usvah.tareen', 'bismashaikh26']",9,"['moizhuda7', 'haurainsia4', 'sheebahashmi0', 'areebaaa', 'sana17azim', 'alizeh', 'im.zohaib96', None, 'ummefarwah']",14,"['haurainsia4', 'usvah.tareen', 'princesramsha', 'bismashaikh26', 'alizeh', None, 'ummefarwah', 'moizhuda7', 'sheebahashmi0', 'areebaaa', 'sana17azim', 'im.zohaib96', 'malikamalimran', 'rubab.nasir']"
145,338,6,8,1,['bismashaikh26'],4,"['malikamalimran', 'usvah.tareen', 'princesramsha', 'rubab.nasir']",7,"['masi123.mr1', 'ms.padela', 'rubabzehra26', 'sana17azim', 'moiz95pk', None, 'ummefarwah']",12,"['masi123.mr1', 'ms.padela', 'usvah.tareen', 'princesramsha', 'rubabzehra26', 'sana17azim', 'bismashaikh26', 'moiz95pk', 'malikamalimran', None, 'ummefarwah', 'rubab.nasir']"
145,409,6,7,1,['usvah.tareen'],4,"['malikamalimran', 'princesramsha', 'bismashaikh26', 'rubab.nasir']",6,"['aflaha10', 'ms286611', 'mahefatima', 'rubabzehra26', 'areebaaa', None]",11,"['aflaha10', 'usvah.tareen', 'princesramsha', 'ms286611', 'mahefatima', 'rubabzehra26', 'areebaaa', 'bismashaikh26', 'malikamalimran', None, 'rubab.nasir']"
146,180,6,7,5,"['nfmou_104', 'annevel2', 'ferdous2', 'weiye_zhang', 'mhaque']",0,[],2,"['jaschil2', None]",7,"['nfmou_104', 'annevel2', 'ferdous2', 'weiye_zhang', 'mhaque', 'jaschil2', None]"
148,437,6,18,4,"['nsubash30', 'annchristma25', 'muralijoshap', 'harithasree']",1,['mdashifanwar'],14,"['sarchanaa97', 'sunnyanju7', 'joyxavier15', 'hannigrace2797', 'christo.eldho', 'bentennyson13579', 'divyaphilip2016', 'himab', 'vdeepthi63', 'amarnath.mgm98', 'rabosudkr', 'jenisha12', None, 'joyson229']",19,"['nsubash30', 'sunnyanju7', 'muralijoshap', 'joyxavier15', 'hannigrace2797', 'christo.eldho', 'mdashifanwar', 'vdeepthi63', 'jenisha12', None, 'joyson229', 'annchristma25', 'sarchanaa97', 'bentennyson13579', 'divyaphilip2016', 'himab', 'amarnath.mgm98', 'rabosudkr', 'harithasree']"
148,436,6,7,1,['muralijoshap'],4,"['nsubash30', 'mdashifanwar', 'harithasree', 'annchristma25']",6,"['sarchanaa97', 'himab', 'amarnath.mgm98', 'kirubaroshlin98', None, 'jenisha']",11,"['nsubash30', 'sarchanaa97', 'muralijoshap', 'mdashifanwar', 'himab', 'amarnath.mgm98', 'kirubaroshlin98', 'harithasree', None, 'annchristma25', 'jenisha']"
149,10,6,18,4,"['sgnanave', 'trietho', 'zirshovon', 'bclenzen']",1,['kanilba1'],14,"['auxedyn', 'ibassi1', 'hmeena', 'chenyang821', 'jzhou129', 'jnuernbe7728', 'aawarrie', 'skallam666', 'cdhan', 'pbaikadi96', 'kgaddipa', 'arajan10', None, 'vasileska']",19,"['kanilba1', 'jzhou129', 'sgnanave', 'pbaikadi96', 'kgaddipa', 'bclenzen', None, 'auxedyn', 'ibassi1', 'hmeena', 'chenyang821', 'jnuernbe7728', 'aawarrie', 'skallam666', 'zirshovon', 'cdhan', 'arajan10', 'trietho', 'vasileska']"
149,322,6,18,4,"['sgnanave', 'trietho', 'zirshovon', 'bclenzen']",1,['kanilba1'],14,"['ibassi1', 'hmeena', 'mavadha1', 'akkrish3', 'jzhou129', 'skallam666', 'sthirum6', 'ttmccart', 'pbaikadi96', 'jnuernbe', 'cdhan', 'jjacoby3', None, 'cyang130']",19,"['mavadha1', 'kanilba1', 'jzhou129', 'sgnanave', 'sthirum6', 'ttmccart', 'pbaikadi96', 'bclenzen', 'cyang130', None, 'ibassi1', 'hmeena', 'akkrish3', 'skallam666', 'zirshovon', 'jnuernbe', 'cdhan', 'jjacoby3', 'trietho']"
149,112,6,10,2,"['bclenzen', 'zirshovon']",3,"['kanilba1', 'trietho', 'sgnanave']",8,"['ibassi1', 'hmeena', 'aawarrie', 'sthirum6', 'pbaikadi96', 'arajan10', None, 'vasileska']",13,"['ibassi1', 'hmeena', 'kanilba1', 'sgnanave', 'arajan10', 'aawarrie', 'sthirum6', 'zirshovon', 'pbaikadi96', 'bclenzen', 'trietho', None, 'vasileska']"
149,114,6,10,2,"['sgnanave', 'zirshovon']",3,"['kanilba1', 'trietho', 'bclenzen']",8,"['ibassi1', 'mavadha1', 'aawarrie', 'sthirum6', 'ttmccart', 'pbaikadi96', 'jjacoby3', None]",13,"['ibassi1', 'mavadha1', 'kanilba1', 'sgnanave', 'aawarrie', 'sthirum6', 'zirshovon', 'ttmccart', 'pbaikadi96', 'jjacoby3', 'bclenzen', 'trietho', None]"
150,227,6,26,1,['happyman1104'],4,"['trujillo492', 'neha893556589', 'luka.evdo', 'stymie']",25,"['ghkskxlr', 'dke625', 'sgu20141493', 'sgu20141445', 'sgu201414733', 'hoobeen', 'ghks031800', 'sgu20131420', 'sgu20141441', 'sgu20131458', 'sgu20131431', 'sgu20141429', None, 'sgu20141453', 'sohnterry', 'davidjung01', 'sgu20131414', 'sgu20141476', 'sgu20131484', 'saemin1024', 'sohnt', 'sgu20131374', 'sgu20141388', 'sgu20141434', 'do1608']",30,"['ghkskxlr', 'trujillo492', 'dke625', 'sgu20141493', 'sgu20141445', 'sgu201414733', 'hoobeen', 'ghks031800', 'sgu20131420', 'luka.evdo', 'happyman1104', 'sgu20141441', 'sgu20131458', 'sgu20131431', 'neha893556589', 'sgu20141429', None, 'sgu20141453', 'do1608', 'sohnterry', 'davidjung01', 'sgu20131414', 'sgu20141476', 'sgu20131484', 'saemin1024', 'sohnt', 'sgu20131374', 'sgu20141388', 'sgu20141434', 'stymie']"
150,229,6,11,3,"['trujillo492', 'neha893556589', 'stymie']",2,"['luka.evdo', 'happyman1104']",8,"['vandit', 'hemacsuf1027', 'shweta1694', 'asadullah2393', 'bvalls', 'calinisan20', 'luvpatel8', None]",13,"['trujillo492', 'vandit', 'luka.evdo', 'happyman1104', 'shweta1694', 'bvalls', 'neha893556589', None, 'hemacsuf1027', 'asadullah2393', 'calinisan20', 'luvpatel8', 'stymie']"
150,247,6,9,3,"['trujillo492', 'neha893556589', 'stymie']",2,"['luka.evdo', 'happyman1104']",6,"['trujillo4', 'hemacsuf1027', 'shweta1694', 'nposey97', 'calinisan20', None]",11,"['trujillo492', 'trujillo4', 'hemacsuf1027', 'luka.evdo', 'happyman1104', 'shweta1694', 'nposey97', 'neha893556589', 'calinisan20', None, 'stymie']"
151,111,6,35,1,['alesk1208'],4,"['jjacoby3', 'sthirum6', 'kmin2', 'mavadha1']",34,"['andysanty', 'julianberonn', 'camilo0869', 'vb.herrera', 'jeisson1299', 'mozomiguel73', 'lautmusicmois', 'armentasantiago', 'ad.gregory', 's.villamilp', 'davidru.dr3', 'camilo0868', 'libardo11chapal', 'anderpensilva', 'juan98', 'juanpbotero9897', 'sebas.villaba2002', 'nataliaramos3', 'felipe_hdz', 'linkiano', 'kevinbernalru', 'solerjavier7', 'ayalagamezn', 'mugnier', 'v.cardonac1', 'nicolash025', 'maria.a.solano.otero', None, 'juliortegon', 'tosaleal', 'md.quintero', 'juanguerron', 'daniel2809', 'jaardila']",39,"['andysanty', 'mavadha1', 'julianberonn', 'camilo0869', 'vb.herrera', 'jeisson1299', 'mozomiguel73', 'lautmusicmois', 'armentasantiago', 'ad.gregory', 's.villamilp', 'davidru.dr3', 'camilo0868', 'libardo11chapal', 'jjacoby3', 'anderpensilva', 'juan98', 'juanpbotero9897', 'sebas.villaba2002', 'nataliaramos3', 'alesk1208', 'felipe_hdz', 'linkiano', 'kevinbernalru', 'solerjavier7', 'ayalagamezn', 'sthirum6', 'kmin2', 'mugnier', 'v.cardonac1', 'nicolash025', 'maria.a.solano.otero', None, 'juliortegon', 'tosaleal', 'md.quintero', 'juanguerron', 'daniel2809', 'jaardila']"
151,322,6,18,3,"['jjacoby3', 'sthirum6', 'mavadha1']",2,"['kmin2', 'alesk1208']",15,"['ibassi1', 'hmeena', 'akkrish3', 'jzhou129', 'sgnanave', 'skallam666', 'ttmccart', 'pbaikadi96', 'jnuernbe', 'cdhan', 'bclenzen', 'zirshovon', 'trietho', None, 'cyang130']",20,"['mavadha1', 'jzhou129', 'sgnanave', 'sthirum6', 'kmin2', 'ttmccart', 'pbaikadi96', 'bclenzen', 'cyang130', None, 'ibassi1', 'hmeena', 'akkrish3', 'skallam666', 'jnuernbe', 'cdhan', 'zirshovon', 'jjacoby3', 'trietho', 'alesk1208']"
151,323,6,11,1,['kmin2'],4,"['jjacoby3', 'sthirum6', 'mavadha1', 'alesk1208']",10,"['johnnyh97', 'vgedal', 'thorstensenr', 'mkmastaler', 'hcenteno', 'danmcteague53', 'jdelaure', 'minnoce1', None, 'jcarlton']",15,"['mavadha1', 'thorstensenr', 'mkmastaler', 'sthirum6', 'kmin2', 'jdelaure', 'minnoce1', None, 'jcarlton', 'johnnyh97', 'vgedal', 'hcenteno', 'danmcteague53', 'jjacoby3', 'alesk1208']"
151,112,6,10,1,['sthirum6'],4,"['jjacoby3', 'kmin2', 'mavadha1', 'alesk1208']",9,"['ibassi1', 'hmeena', 'bclenzen', 'aawarrie', 'zirshovon', 'pbaikadi96', 'arajan10', None, 'vasileska']",14,"['ibassi1', 'mavadha1', 'hmeena', 'bclenzen', 'arajan10', 'aawarrie', 'sthirum6', 'kmin2', 'zirshovon', 'pbaikadi96', 'jjacoby3', None, 'vasileska', 'alesk1208']"
151,114,6,10,3,"['jjacoby3', 'sthirum6', 'mavadha1']",2,"['kmin2', 'alesk1208']",7,"['ibassi1', 'sgnanave', 'aawarrie', 'ttmccart', 'pbaikadi96', 'zirshovon', None]",12,"['ibassi1', 'mavadha1', 'sgnanave', 'aawarrie', 'sthirum6', 'kmin2', 'ttmccart', 'pbaikadi96', 'zirshovon', 'jjacoby3', None, 'alesk1208']"
