MClusterID,XClusterID,MClusterSize,XClusterSize,OverlapSize,OverlapMembers,MOnlySize,MOnlyMembers,XOnlySize,XOnlyMembers,CombinedSize,CombinedMembers
1,42,391,71,65,"['pingan99', 'afeefz', 'shaf31', 'hong_gao', 'kie180031', 'sealseal', 'musabmalek0717', 'abdulrahim2905', 'desmondsoon', 'pip29', 'baleko12345', 'm939454', 'nabilah1403', 'rahimnoorj', 'janeneil88', 'zikrizaki88995', 'abieday1704', 'hafizmokh99', 'yjenyiee155', 'tamchouweng', 'anwar909', 'ablahsaoud', 'kimzihuang', 'leejq', 'harshini9962', 'alifzulkifli99', 'kakmeera1999', 'ffazul64', 'guoyao', 'ari6nd', 'melroy_caeiro', 'kie180028', 'cheokonn', 'gabrielyii99', 'amni99', 'kie180702', 'wahidiah52', 'zakhwan7', 'chengweiheng', 'redzuan11', 'kie180073', 'nikalyaamani', 'tingliang', 'arifjalani99', 'happyleexin', 'nadhnasorudin', 'azizijazam11', 'rooban11', 'yeejou990318', 'adriancheah', 'aimansyaz99', 'khor', 'kowjiajin', 'nihaosawaddee', 'exjamil', 'syedzakwan', 'ahchehyan', 'kie180039', 'aimanadnan', 'yansi', 'magic_ocean99', 'gabrielyii', 'kie180079', 'xunyong', 'asyrafaqil']",326,"['oliviercharbonneau', 'miri23', 'ozgurkablan26', 'loisonchambers', 'tuberkargan_97', 'pranjal3', 'nadanasser1199', 'siemprewowthechami', 'staceyn2', 'vblanco.nico', 'abbesalaeddine', 'efrenhub', 'isabelmaria.vazquez', 'ahmedamr', 'shorouk_ossama', 'rikardberger', 'alancantu57', 'luciano.brignone', 'guttsfulltyagi', 'mjgebara14', 'kartal', 'aboone06', 'saegner2', 'manuelsomoza94', 'amani12345', 'youssefsherif22', 'j.haliburton', 'amr_ua07', 'evrenyigit', 'kirankumar94', 'ahagras13', 'njgale01', 'al4995', 'smrdafdl', 'travisc2', 'dlee145', 'stambo', 'anthonyroux', 'ryanorem', 'moh.bahaa', 'veronica.mieites', 's_coriolis', 'trkmengkay', 'cbecker413', 'mcruces.fz', 'latecnologiameodia', 'gxiao2', 'emilechouinard', 'je_guilbert', 'yubai', 'sinasigurpinar', 'lauragdevesa', 'muvafikmelikkaya', 'kason.carroll', 'jbaggie2019', 'annahaozheng0606', 'jtorres17', 'ahmedayman2370', '46harunakgul', 'kaitlinh', 'tyy233', 'sdehoyos47', 'malgaca', 'lsleed', 'khazanv2', 'alexisdixon6', 'gc_1', 'jinsup2', 'rishu', 'amparo.castro.96', 'tbryan', 'martin32', 'michael.mechelay', 'akash140410107098', 'nowapoca', 'onaam8', 'pablosaavedra', 'camilolcastro97', 'ankit6257', 'samashraf1', 'benoiturcotte', 'aishu98', 'rileyroca', 'david.peral.moran', 'kiruthikaabalu181996', 'taymacnichols', 'dhodapp', 'nagihankececi', 'carlosvigo1997', 'moh.ashraf105', 'ikhbal', 'kaustubh.shirpurkar', 'bflores18', 'tdubnansky6', 'jorgecastelo5', 'andreadiazgar', 'david2397', 'bcperki2', 'melaniejkramer', 'rkchapman', 'jn1404', 'mateocampos', 'jzhan142', 'josepazmartin', 'brannon44', 'adfoz', 'avw2', 'youxing0309', 'scremin', 'lderemo', 'perezsarmar', 'ashutoshsinghhenry6', 'viratbhatt007', 'fkl217', 'coderko3', 'alimatama', 'ammaralaa516', 'adarsh123', 'jacquelinethardin', 'mjoza2', 'nihatyavuz', 'estebanrial', 'jinwoo2', 'adnanyuceer', 'danielfernandezcalo', 'berkaydean', 'cloudyoverhead', 'fred_dion', 'e1150590', 'fcfrancapra94', 'amiruldanial99', 'ozbunar01', 'alecorti.pardo', 'electronica18', 'nourananwar123', 'olivier.gilbert.paquet', 'anibarseghyan', 'amlibrahim', 'neuroque', 'kychui2', 'paul.aniruddha', 'carlosbesadaromero', 'mohaballam', 'apb5472', 'tuberkargan', 'javierisma98', 'fathy1104', 'corredoira', 'helenalecoq97', 'muteki', 'masitadonmez', 'nadja1', 'dancastaneda', 'ahmedsameh1698', 'rocio', 'mallen22', 'kerryreto', 'pedrosiaba', 'michaelsaldana1', 'omarmagdy', 'vickytubio', 'ericrobles', 'soccadelic44', 'selena', 'aasifhameed99', 'damlakubattt', 'anxovidal8', 'jahnavikachhia', 'joker632455', 'vincentpainchaud.vp', 'svo4321', 'zhixin2', 'xyz11', 'virajput299', 'ryanboucher', 'jpmcgee98', 'mariz', 'bhliu97', 'amrebrahim', 'c.a.stupka', 'tonybocadillosgrandes', 'talwren', 'rxtodd', 'farah26', 'tss3', 'mavanzato0418', 'facundovia', 'cristinacigarran', 'nazimmath3', 'baohl2', 'ales.gajdacz', 'elad.d', 'kyang37', 'lino13', 'jaimefookinlannister', 'physquig', 'jarodm2', 'noureldin1999', 'michael2010814', 'ckim123', 'eddin21', 'jipiccardi', 'prabuddha_888253127', 'david_atef', 'kalebhilde', 'saipraneett', 'sanchjai', 'omardeyaa', 'aaq', 'alidsjt', 'mengkem2', 'haclarke', 'oishikfaruque', 'ilou', 'aengm', 'janalorenzolumbreras', 'hilisa', 'carlosvillar54', 'vikazvereva', 'va844', 'pablobou4', 'ludovick.begin', 'maniphysics09', 'eduard25252598', 'apascao', 'xosegq16', 'adam562', 'lauramolinosmayo', 'saharoaf', 'ypp200', 'kph2', 'martinzapata', 'kirolosehab99', 'restep2', 'seifhabib', 'maramtarek53', 'zehuahe2', 'marcosanllo', 'elizametias12', 'juanmacano97', 'sparshagarwal1009', 'prakharbhargava0', 'njs035', 'alberfn', 'ramy_maged4', 'hmoulvi1', 'vanesagarcia', 'hf4', 'wowmuchchuck', 'mohammedemadeldin2000', 'keerthisv', 'pythagoras2', 'irenehb92', 'shradhap', 'mohameeddsamy', 'marianne.gratton.1', 'marcmagdy98', 'brknshn', 'gemma', 'lukunze1', 'caglanlee', 'sebasket14', 'masonpb2', 'youssef2042000', 'retty8', 'bharath3', 'syin4', 'ethanmorse', 'ematson5897', 'jacobzeshleman', 'reemali99_', 'xxlilmontysignxx', 'ramonruiz.infor', 'atharva98', 'ahern0722', 'hishamzakaria20', 'adriangarea', 'jeanmichael.deschenes', 'samet1231234', 'mr4425', 'bluelobster', 'justin.lariviere.25', 'dcpang2', 'felivitullo87', 'puertarcd', 'farahsamir978', 'akozych2', 'nbs691', 'bleuminuit', 'atx203', 'kanet1234', 'emrebuyukkose2', 'arrow823', 'dhvanil', 'nuanno97', 'dkshelat', 'mohabayman', 'ranasherif65', 'diamond92', 'ugur.cankaya.3718', 'ammareltalli', 'acn562', 'yaseminablacandir', 'sriharshap', 'mrefaat', 'bassamtarek', 'hamidausat', 'teoster50', 'nolmos96', 'abdurrahmn13', 'mmartinezsanchez', 'sandrabashara', 'acregodean', 'sarapl', 'williammitchell5818', 'maxernest', 'david.garrido', 'guibill10', 'mohamedsameh', 'spazos7', 'tmi211', 'worldlineusaf', 'mgk816', 'ledicia97', 'movi205', 'shuming2']",6,"['fitrimohdyunus99', 'miloaismanis', 'mahafizuddin', 'jazlilong', 'firdaushusnoruddin99', None]",397,"['oliviercharbonneau', 'miri23', 'ozgurkablan26', 'loisonchambers', 'tuberkargan_97', 'pranjal3', 'musabmalek0717', 'nadanasser1199', 'siemprewowthechami', 'staceyn2', 'vblanco.nico', 'abbesalaeddine', 'efrenhub', 'isabelmaria.vazquez', 'ahmedamr', 'shorouk_ossama', 'rikardberger', 'alancantu57', 'luciano.brignone', 'rahimnoorj', 'janeneil88', 'guttsfulltyagi', 'mjgebara14', 'kartal', 'gabrielyii99', 'aboone06', 'saegner2', 'manuelsomoza94', 'amani12345', 'youssefsherif22', 'j.haliburton', 'amr_ua07', 'evrenyigit', 'tingliang', 'kirankumar94', 'ahagras13', 'njgale01', 'al4995', 'smrdafdl', 'travisc2', 'dlee145', 'stambo', 'anthonyroux', 'ryanorem', 'moh.bahaa', 'ahchehyan', 'aimanadnan', 'veronica.mieites', 's_coriolis', 'trkmengkay', 'cbecker413', 'mcruces.fz', 'latecnologiameodia', 'gxiao2', 'emilechouinard', 'je_guilbert', 'yubai', 'sinasigurpinar', 'lauragdevesa', 'muvafikmelikkaya', 'kason.carroll', 'jbaggie2019', 'annahaozheng0606', 'jtorres17', 'ahmedayman2370', 'zikrizaki88995', 'yjenyiee155', '46harunakgul', 'firdaushusnoruddin99', 'alifzulkifli99', 'kaitlinh', 'tyy233', 'sdehoyos47', 'malgaca', 'lsleed', 'khazanv2', 'alexisdixon6', 'gc_1', 'jinsup2', 'rishu', 'amparo.castro.96', 'tbryan', 'martin32', 'michael.mechelay', 'akash140410107098', 'nowapoca', 'onaam8', 'pablosaavedra', 'camilolcastro97', 'khor', 'ankit6257', 'samashraf1', 'benoiturcotte', 'aishu98', 'rileyroca', 'david.peral.moran', 'kiruthikaabalu181996', 'taymacnichols', 'dhodapp', 'nagihankececi', 'carlosvigo1997', 'moh.ashraf105', 'baleko12345', 'ikhbal', 'afeefz', 'kaustubh.shirpurkar', 'kie180031', 'bflores18', 'tdubnansky6', 'jorgecastelo5', 'andreadiazgar', 'david2397', 'bcperki2', 'melaniejkramer', 'rkchapman', 'jn1404', 'mateocampos', 'jzhan142', 'josepazmartin', 'brannon44', 'adfoz', 'avw2', 'youxing0309', 'scremin', 'lderemo', 'perezsarmar', 'ashutoshsinghhenry6', 'melroy_caeiro', 'viratbhatt007', 'fkl217', 'coderko3', 'alimatama', 'ammaralaa516', 'nadhnasorudin', 'adarsh123', 'jacquelinethardin', 'mjoza2', 'nihatyavuz', 'estebanrial', 'jinwoo2', 'adnanyuceer', 'danielfernandezcalo', 'berkaydean', 'cloudyoverhead', 'fred_dion', 'syedzakwan', 'e1150590', 'fcfrancapra94', 'amiruldanial99', 'ozbunar01', 'alecorti.pardo', 'electronica18', 'nourananwar123', 'olivier.gilbert.paquet', 'anibarseghyan', 'amlibrahim', 'neuroque', 'kychui2', 'shaf31', 'hong_gao', 'paul.aniruddha', 'carlosbesadaromero', 'mohaballam', 'pip29', 'fitrimohdyunus99', 'apb5472', 'tuberkargan', 'hafizmokh99', 'javierisma98', 'fathy1104', 'corredoira', 'helenalecoq97', 'kimzihuang', 'muteki', 'masitadonmez', 'nadja1', 'dancastaneda', 'ahmedsameh1698', 'rocio', 'mallen22', 'ffazul64', 'guoyao', 'ari6nd', 'kerryreto', 'pedrosiaba', 'michaelsaldana1', 'omarmagdy', 'vickytubio', 'ericrobles', 'soccadelic44', 'selena', 'aasifhameed99', 'damlakubattt', 'anxovidal8', 'exjamil', 'jahnavikachhia', 'joker632455', 'vincentpainchaud.vp', 'svo4321', 'zhixin2', 'yansi', 'asyrafaqil', 'xyz11', 'virajput299', 'ryanboucher', 'jpmcgee98', 'mariz', 'bhliu97', 'amrebrahim', 'abdulrahim2905', 'c.a.stupka', 'tonybocadillosgrandes', 'talwren', 'rxtodd', 'farah26', 'tss3', 'abieday1704', 'mavanzato0418', 'facundovia', 'cristinacigarran', 'nazimmath3', 'baohl2', 'ales.gajdacz', 'elad.d', 'kie180028', 'wahidiah52', 'kyang37', 'arifjalani99', 'lino13', 'jaimefookinlannister', 'physquig', 'adriancheah', 'jarodm2', 'noureldin1999', 'michael2010814', 'ckim123', 'eddin21', 'jipiccardi', 'prabuddha_888253127', 'david_atef', 'kalebhilde', 'magic_ocean99', 'saipraneett', 'sanchjai', 'omardeyaa', 'pingan99', 'aaq', 'alidsjt', 'mengkem2', 'haclarke', 'oishikfaruque', 'ilou', 'aengm', 'janalorenzolumbreras', 'hilisa', 'carlosvillar54', 'vikazvereva', 'm939454', 'va844', 'pablobou4', 'ludovick.begin', 'maniphysics09', 'eduard25252598', 'apascao', 'xosegq16', 'adam562', 'lauramolinosmayo', 'amni99', 'kie180702', 'saharoaf', 'redzuan11', 'ypp200', 'kph2', 'martinzapata', 'kirolosehab99', 'restep2', 'seifhabib', 'maramtarek53', 'zehuahe2', 'azizijazam11', 'marcosanllo', 'aimansyaz99', 'elizametias12', 'juanmacano97', 'sparshagarwal1009', 'prakharbhargava0', 'njs035', 'alberfn', 'ramy_maged4', 'hmoulvi1', 'vanesagarcia', 'hf4', 'wowmuchchuck', 'mohammedemadeldin2000', 'gabrielyii', 'keerthisv', 'pythagoras2', 'xunyong', 'irenehb92', 'shradhap', 'mohameeddsamy', 'marianne.gratton.1', 'marcmagdy98', 'brknshn', 'gemma', 'lukunze1', 'caglanlee', 'desmondsoon', 'sebasket14', 'masonpb2', 'youssef2042000', 'retty8', 'bharath3', 'syin4', 'ethanmorse', 'ematson5897', 'jacobzeshleman', 'leejq', 'harshini9962', 'reemali99_', 'xxlilmontysignxx', 'ramonruiz.infor', 'atharva98', 'ahern0722', 'hishamzakaria20', 'cheokonn', 'adriangarea', 'jeanmichael.deschenes', 'samet1231234', 'mr4425', 'bluelobster', 'justin.lariviere.25', 'dcpang2', 'felivitullo87', 'puertarcd', 'miloaismanis', 'farahsamir978', 'akozych2', 'nbs691', 'kie180073', 'anwar909', 'bleuminuit', 'atx203', 'kanet1234', 'sealseal', 'emrebuyukkose2', 'arrow823', 'mahafizuddin', 'dhvanil', 'nuanno97', 'dkshelat', 'mohabayman', 'ranasherif65', 'diamond92', 'ugur.cankaya.3718', 'ammareltalli', 'acn562', 'nabilah1403', 'yaseminablacandir', 'tamchouweng', 'ablahsaoud', 'sriharshap', 'mrefaat', 'bassamtarek', 'hamidausat', 'kakmeera1999', 'teoster50', 'nolmos96', 'abdurrahmn13', 'mmartinezsanchez', 'sandrabashara', 'zakhwan7', 'chengweiheng', 'nikalyaamani', 'acregodean', 'happyleexin', 'sarapl', 'williammitchell5818', None, 'rooban11', 'yeejou990318', 'kowjiajin', 'nihaosawaddee', 'maxernest', 'david.garrido', 'guibill10', 'mohamedsameh', 'spazos7', 'jazlilong', 'tmi211', 'kie180039', 'worldlineusaf', 'mgk816', 'kie180079', 'ledicia97', 'movi205', 'shuming2']"
1,120,391,63,31,"['mengkem2', 'kychui2', 'pranjal3', 'bhliu97', 'staceyn2', 'bcperki2', 'jzhan142', 'masonpb2', 'tss3', 'bharath3', 'avw2', 'baohl2', 'khazanv2', 'saegner2', 'kph2', 'kyang37', 'jinsup2', 'coderko3', 'restep2', 'zehuahe2', 'mjoza2', 'travisc2', 'dlee145', 'jinwoo2', 'dcpang2', 'jarodm2', 'ckim123', 'zhixin2', 'hf4', 'akozych2', 'shuming2']",360,"['oliviercharbonneau', 'miri23', 'ozgurkablan26', 'loisonchambers', 'tuberkargan_97', 'musabmalek0717', 'nadanasser1199', 'siemprewowthechami', 'vblanco.nico', 'abbesalaeddine', 'efrenhub', 'isabelmaria.vazquez', 'ahmedamr', 'shorouk_ossama', 'rikardberger', 'alancantu57', 'luciano.brignone', 'rahimnoorj', 'janeneil88', 'guttsfulltyagi', 'mjgebara14', 'kartal', 'gabrielyii99', 'aboone06', 'manuelsomoza94', 'amani12345', 'youssefsherif22', 'j.haliburton', 'amr_ua07', 'evrenyigit', 'tingliang', 'kirankumar94', 'ahagras13', 'njgale01', 'al4995', 'smrdafdl', 'stambo', 'anthonyroux', 'ryanorem', 'moh.bahaa', 'ahchehyan', 'aimanadnan', 'veronica.mieites', 's_coriolis', 'trkmengkay', 'cbecker413', 'mcruces.fz', 'latecnologiameodia', 'gxiao2', 'emilechouinard', 'je_guilbert', 'yubai', 'sinasigurpinar', 'lauragdevesa', 'muvafikmelikkaya', 'kason.carroll', 'jbaggie2019', 'annahaozheng0606', 'jtorres17', 'ahmedayman2370', 'zikrizaki88995', 'yjenyiee155', '46harunakgul', 'alifzulkifli99', 'kaitlinh', 'tyy233', 'sdehoyos47', 'malgaca', 'lsleed', 'alexisdixon6', 'gc_1', 'rishu', 'amparo.castro.96', 'tbryan', 'martin32', 'michael.mechelay', 'akash140410107098', 'nowapoca', 'onaam8', 'pablosaavedra', 'camilolcastro97', 'khor', 'ankit6257', 'samashraf1', 'benoiturcotte', 'aishu98', 'rileyroca', 'david.peral.moran', 'kiruthikaabalu181996', 'taymacnichols', 'dhodapp', 'nagihankececi', 'carlosvigo1997', 'moh.ashraf105', 'baleko12345', 'ikhbal', 'afeefz', 'kaustubh.shirpurkar', 'kie180031', 'bflores18', 'tdubnansky6', 'jorgecastelo5', 'andreadiazgar', 'david2397', 'melaniejkramer', 'rkchapman', 'jn1404', 'mateocampos', 'josepazmartin', 'brannon44', 'adfoz', 'youxing0309', 'scremin', 'lderemo', 'perezsarmar', 'ashutoshsinghhenry6', 'melroy_caeiro', 'viratbhatt007', 'fkl217', 'alimatama', 'ammaralaa516', 'nadhnasorudin', 'adarsh123', 'jacquelinethardin', 'nihatyavuz', 'estebanrial', 'adnanyuceer', 'danielfernandezcalo', 'berkaydean', 'cloudyoverhead', 'fred_dion', 'syedzakwan', 'e1150590', 'fcfrancapra94', 'amiruldanial99', 'ozbunar01', 'alecorti.pardo', 'electronica18', 'nourananwar123', 'olivier.gilbert.paquet', 'anibarseghyan', 'amlibrahim', 'neuroque', 'shaf31', 'hong_gao', 'paul.aniruddha', 'carlosbesadaromero', 'mohaballam', 'pip29', 'apb5472', 'tuberkargan', 'hafizmokh99', 'javierisma98', 'fathy1104', 'corredoira', 'helenalecoq97', 'kimzihuang', 'muteki', 'masitadonmez', 'nadja1', 'dancastaneda', 'ahmedsameh1698', 'rocio', 'mallen22', 'ffazul64', 'guoyao', 'ari6nd', 'kerryreto', 'pedrosiaba', 'michaelsaldana1', 'omarmagdy', 'vickytubio', 'ericrobles', 'soccadelic44', 'selena', 'aasifhameed99', 'damlakubattt', 'anxovidal8', 'exjamil', 'jahnavikachhia', 'joker632455', 'vincentpainchaud.vp', 'svo4321', 'yansi', 'asyrafaqil', 'xyz11', 'virajput299', 'ryanboucher', 'jpmcgee98', 'mariz', 'amrebrahim', 'abdulrahim2905', 'c.a.stupka', 'tonybocadillosgrandes', 'talwren', 'rxtodd', 'farah26', 'abieday1704', 'mavanzato0418', 'facundovia', 'cristinacigarran', 'nazimmath3', 'ales.gajdacz', 'elad.d', 'kie180028', 'wahidiah52', 'arifjalani99', 'lino13', 'jaimefookinlannister', 'physquig', 'adriancheah', 'noureldin1999', 'michael2010814', 'eddin21', 'jipiccardi', 'prabuddha_888253127', 'david_atef', 'kalebhilde', 'magic_ocean99', 'saipraneett', 'sanchjai', 'omardeyaa', 'pingan99', 'aaq', 'alidsjt', 'haclarke', 'oishikfaruque', 'ilou', 'aengm', 'janalorenzolumbreras', 'hilisa', 'carlosvillar54', 'vikazvereva', 'm939454', 'va844', 'pablobou4', 'ludovick.begin', 'maniphysics09', 'eduard25252598', 'apascao', 'xosegq16', 'adam562', 'lauramolinosmayo', 'amni99', 'kie180702', 'saharoaf', 'redzuan11', 'ypp200', 'martinzapata', 'kirolosehab99', 'seifhabib', 'maramtarek53', 'azizijazam11', 'marcosanllo', 'aimansyaz99', 'elizametias12', 'juanmacano97', 'sparshagarwal1009', 'prakharbhargava0', 'njs035', 'alberfn', 'ramy_maged4', 'hmoulvi1', 'vanesagarcia', 'wowmuchchuck', 'mohammedemadeldin2000', 'gabrielyii', 'keerthisv', 'pythagoras2', 'xunyong', 'irenehb92', 'shradhap', 'mohameeddsamy', 'marianne.gratton.1', 'marcmagdy98', 'brknshn', 'gemma', 'lukunze1', 'caglanlee', 'desmondsoon', 'sebasket14', 'youssef2042000', 'retty8', 'syin4', 'ethanmorse', 'ematson5897', 'jacobzeshleman', 'leejq', 'harshini9962', 'reemali99_', 'xxlilmontysignxx', 'ramonruiz.infor', 'atharva98', 'ahern0722', 'hishamzakaria20', 'cheokonn', 'adriangarea', 'jeanmichael.deschenes', 'samet1231234', 'mr4425', 'bluelobster', 'justin.lariviere.25', 'felivitullo87', 'puertarcd', 'farahsamir978', 'nbs691', 'kie180073', 'anwar909', 'bleuminuit', 'atx203', 'kanet1234', 'sealseal', 'emrebuyukkose2', 'arrow823', 'dhvanil', 'nuanno97', 'dkshelat', 'mohabayman', 'ranasherif65', 'diamond92', 'ugur.cankaya.3718', 'ammareltalli', 'acn562', 'nabilah1403', 'yaseminablacandir', 'tamchouweng', 'ablahsaoud', 'sriharshap', 'mrefaat', 'bassamtarek', 'hamidausat', 'kakmeera1999', 'teoster50', 'nolmos96', 'abdurrahmn13', 'mmartinezsanchez', 'sandrabashara', 'zakhwan7', 'chengweiheng', 'nikalyaamani', 'acregodean', 'happyleexin', 'sarapl', 'williammitchell5818', 'rooban11', 'yeejou990318', 'kowjiajin', 'nihaosawaddee', 'maxernest', 'david.garrido', 'guibill10', 'mohamedsameh', 'spazos7', 'tmi211', 'kie180039', 'worldlineusaf', 'mgk816', 'kie180079', 'ledicia97', 'movi205']",32,"['hregner2', 'nsk2', 'jmjin2', 'mtobah2', 'myl3', 'kv2', 'kfurbee2', 'joseam2', 'jhardi9', 'juliaeb2', 'sili5', 'dplata2', 'rrmiriy2', 'nahmoda2', 'jingyiw3', 'rakam2', 'kjfrank2', 'jiwu2', 'rsyuan2', 'juliajh2', 'isaxton2', 'leveill2', 'joshua.leveillee', 'jaketh2', 'ellenrf2', None, 'scc3', 'rll2', 'xzhan147', 'werforgerf4life', 'yhu55', 'dkfkadbs304']",423,"['oliviercharbonneau', 'miri23', 'ozgurkablan26', 'loisonchambers', 'tuberkargan_97', 'pranjal3', 'musabmalek0717', 'nadanasser1199', 'siemprewowthechami', 'staceyn2', 'vblanco.nico', 'abbesalaeddine', 'efrenhub', 'isabelmaria.vazquez', 'ahmedamr', 'shorouk_ossama', 'rikardberger', 'alancantu57', 'luciano.brignone', 'jhardi9', 'rahimnoorj', 'janeneil88', 'guttsfulltyagi', 'dplata2', 'mjgebara14', 'kartal', 'gabrielyii99', 'aboone06', 'saegner2', 'manuelsomoza94', 'amani12345', 'rsyuan2', 'youssefsherif22', 'j.haliburton', 'amr_ua07', 'evrenyigit', 'tingliang', 'kirankumar94', 'ahagras13', 'joshua.leveillee', 'njgale01', 'al4995', 'smrdafdl', 'travisc2', 'dlee145', 'stambo', 'anthonyroux', 'ryanorem', 'moh.bahaa', 'ahchehyan', 'aimanadnan', 'veronica.mieites', 's_coriolis', 'trkmengkay', 'cbecker413', 'mcruces.fz', 'latecnologiameodia', 'gxiao2', 'emilechouinard', 'je_guilbert', 'yubai', 'sinasigurpinar', 'lauragdevesa', 'muvafikmelikkaya', 'kason.carroll', 'jbaggie2019', 'annahaozheng0606', 'jtorres17', 'ahmedayman2370', 'zikrizaki88995', 'yjenyiee155', '46harunakgul', 'alifzulkifli99', 'kaitlinh', 'tyy233', 'sdehoyos47', 'malgaca', 'lsleed', 'khazanv2', 'alexisdixon6', 'gc_1', 'jinsup2', 'rishu', 'amparo.castro.96', 'tbryan', 'martin32', 'michael.mechelay', 'akash140410107098', 'nowapoca', 'onaam8', 'pablosaavedra', 'camilolcastro97', 'khor', 'ankit6257', 'samashraf1', 'scc3', 'benoiturcotte', 'aishu98', 'rileyroca', 'david.peral.moran', 'kiruthikaabalu181996', 'taymacnichols', 'dhodapp', 'nagihankececi', 'carlosvigo1997', 'moh.ashraf105', 'baleko12345', 'ikhbal', 'afeefz', 'kaustubh.shirpurkar', 'kie180031', 'bflores18', 'tdubnansky6', 'jorgecastelo5', 'andreadiazgar', 'david2397', 'bcperki2', 'melaniejkramer', 'rkchapman', 'jn1404', 'mateocampos', 'jzhan142', 'joseam2', 'josepazmartin', 'brannon44', 'adfoz', 'sili5', 'nahmoda2', 'jingyiw3', 'avw2', 'youxing0309', 'scremin', 'lderemo', 'perezsarmar', 'ashutoshsinghhenry6', 'melroy_caeiro', 'viratbhatt007', 'fkl217', 'coderko3', 'alimatama', 'ammaralaa516', 'nadhnasorudin', 'adarsh123', 'jacquelinethardin', 'ellenrf2', 'mjoza2', 'nihatyavuz', 'estebanrial', 'jinwoo2', 'adnanyuceer', 'danielfernandezcalo', 'berkaydean', 'cloudyoverhead', 'fred_dion', 'syedzakwan', 'xzhan147', 'e1150590', 'fcfrancapra94', 'amiruldanial99', 'ozbunar01', 'alecorti.pardo', 'electronica18', 'nourananwar123', 'olivier.gilbert.paquet', 'anibarseghyan', 'dkfkadbs304', 'amlibrahim', 'neuroque', 'kychui2', 'shaf31', 'hong_gao', 'paul.aniruddha', 'carlosbesadaromero', 'mohaballam', 'pip29', 'apb5472', 'tuberkargan', 'hafizmokh99', 'javierisma98', 'fathy1104', 'corredoira', 'helenalecoq97', 'kimzihuang', 'muteki', 'masitadonmez', 'nadja1', 'dancastaneda', 'ahmedsameh1698', 'rocio', 'mallen22', 'ffazul64', 'guoyao', 'ari6nd', 'kerryreto', 'pedrosiaba', 'michaelsaldana1', 'kjfrank2', 'juliajh2', 'omarmagdy', 'vickytubio', 'ericrobles', 'soccadelic44', 'selena', 'aasifhameed99', 'damlakubattt', 'anxovidal8', 'exjamil', 'jahnavikachhia', 'joker632455', 'vincentpainchaud.vp', 'svo4321', 'zhixin2', 'yansi', 'asyrafaqil', 'xyz11', 'virajput299', 'ryanboucher', 'jpmcgee98', 'mariz', 'bhliu97', 'amrebrahim', 'jmjin2', 'abdulrahim2905', 'c.a.stupka', 'tonybocadillosgrandes', 'talwren', 'rxtodd', 'farah26', 'tss3', 'abieday1704', 'mavanzato0418', 'facundovia', 'cristinacigarran', 'rrmiriy2', 'nazimmath3', 'baohl2', 'ales.gajdacz', 'elad.d', 'kie180028', 'wahidiah52', 'kyang37', 'arifjalani99', 'lino13', 'jaimefookinlannister', 'physquig', 'jaketh2', 'adriancheah', 'jarodm2', 'noureldin1999', 'michael2010814', 'ckim123', 'eddin21', 'jipiccardi', 'prabuddha_888253127', 'werforgerf4life', 'david_atef', 'kalebhilde', 'magic_ocean99', 'saipraneett', 'sanchjai', 'omardeyaa', 'pingan99', 'aaq', 'alidsjt', 'hregner2', 'mengkem2', 'nsk2', 'haclarke', 'oishikfaruque', 'ilou', 'aengm', 'janalorenzolumbreras', 'hilisa', 'carlosvillar54', 'vikazvereva', 'm939454', 'va844', 'pablobou4', 'ludovick.begin', 'maniphysics09', 'eduard25252598', 'apascao', 'xosegq16', 'adam562', 'lauramolinosmayo', 'amni99', 'kie180702', 'saharoaf', 'redzuan11', 'ypp200', 'kph2', 'martinzapata', 'jiwu2', 'kirolosehab99', 'restep2', 'seifhabib', 'leveill2', 'maramtarek53', 'zehuahe2', 'azizijazam11', 'marcosanllo', 'aimansyaz99', 'elizametias12', 'juanmacano97', 'sparshagarwal1009', 'prakharbhargava0', 'njs035', 'alberfn', 'ramy_maged4', 'hmoulvi1', 'vanesagarcia', 'hf4', 'wowmuchchuck', 'mohammedemadeldin2000', 'gabrielyii', 'keerthisv', 'pythagoras2', 'xunyong', 'irenehb92', 'shradhap', 'mohameeddsamy', 'marianne.gratton.1', 'marcmagdy98', 'brknshn', 'gemma', 'lukunze1', 'mtobah2', 'kv2', 'caglanlee', 'desmondsoon', 'kfurbee2', 'sebasket14', 'masonpb2', 'youssef2042000', 'retty8', 'bharath3', 'syin4', 'ethanmorse', 'ematson5897', 'rakam2', 'jacobzeshleman', 'leejq', 'harshini9962', 'reemali99_', 'xxlilmontysignxx', 'ramonruiz.infor', 'atharva98', 'ahern0722', 'hishamzakaria20', 'cheokonn', 'adriangarea', 'jeanmichael.deschenes', 'isaxton2', 'samet1231234', 'mr4425', 'bluelobster', 'justin.lariviere.25', 'dcpang2', 'rll2', 'felivitullo87', 'puertarcd', 'farahsamir978', 'akozych2', 'nbs691', 'kie180073', 'anwar909', 'bleuminuit', 'atx203', 'kanet1234', 'sealseal', 'emrebuyukkose2', 'arrow823', 'dhvanil', 'nuanno97', 'dkshelat', 'mohabayman', 'ranasherif65', 'diamond92', 'ugur.cankaya.3718', 'ammareltalli', 'myl3', 'acn562', 'nabilah1403', 'yaseminablacandir', 'juliaeb2', 'tamchouweng', 'ablahsaoud', 'sriharshap', 'mrefaat', 'bassamtarek', 'hamidausat', 'kakmeera1999', 'teoster50', 'nolmos96', 'abdurrahmn13', 'mmartinezsanchez', 'sandrabashara', 'zakhwan7', 'chengweiheng', 'nikalyaamani', 'acregodean', 'happyleexin', 'sarapl', 'williammitchell5818', None, 'rooban11', 'yeejou990318', 'kowjiajin', 'nihaosawaddee', 'maxernest', 'david.garrido', 'guibill10', 'mohamedsameh', 'spazos7', 'tmi211', 'kie180039', 'worldlineusaf', 'yhu55', 'mgk816', 'kie180079', 'ledicia97', 'movi205', 'shuming2']"
1,33,391,57,53,"['aaq', 'kanet1234', 'kaustubh.shirpurkar', 'ryanboucher', 'jpmcgee98', 'bflores18', 'tdubnansky6', 'haclarke', 'oishikfaruque', 'melaniejkramer', 'c.a.stupka', 'acn562', 'kason.carroll', 'rxtodd', 'jbaggie2019', 'jtorres17', 'brannon44', 'alancantu57', 'luciano.brignone', 'mavanzato0418', 'javierisma98', 'mjgebara14', 'ethanmorse', 'ematson5897', 'xxlilmontysignxx', 'dancastaneda', 'hamidausat', 'sdehoyos47', 'atharva98', 'ahern0722', 'teoster50', 'elad.d', 'nolmos96', 'lderemo', 'aboone06', 'michaelsaldana1', 'ypp200', 'amani12345', 'alexisdixon6', 'j.haliburton', 'tbryan', 'michael.mechelay', 'jaimefookinlannister', 'onaam8', 'ericrobles', 'samashraf1', 'aishu98', 'e1150590', 'sanchjai', 'dhodapp', 'wowmuchchuck', 'anibarseghyan', 'saipraneett']",338,"['oliviercharbonneau', 'miri23', 'ozgurkablan26', 'loisonchambers', 'tuberkargan_97', 'pranjal3', 'musabmalek0717', 'nadanasser1199', 'siemprewowthechami', 'staceyn2', 'vblanco.nico', 'abbesalaeddine', 'efrenhub', 'isabelmaria.vazquez', 'ahmedamr', 'shorouk_ossama', 'rikardberger', 'rahimnoorj', 'janeneil88', 'guttsfulltyagi', 'kartal', 'gabrielyii99', 'saegner2', 'manuelsomoza94', 'youssefsherif22', 'amr_ua07', 'evrenyigit', 'tingliang', 'kirankumar94', 'ahagras13', 'njgale01', 'al4995', 'smrdafdl', 'travisc2', 'dlee145', 'stambo', 'anthonyroux', 'ryanorem', 'moh.bahaa', 'ahchehyan', 'aimanadnan', 'veronica.mieites', 's_coriolis', 'trkmengkay', 'cbecker413', 'mcruces.fz', 'latecnologiameodia', 'gxiao2', 'emilechouinard', 'je_guilbert', 'yubai', 'sinasigurpinar', 'lauragdevesa', 'muvafikmelikkaya', 'annahaozheng0606', 'ahmedayman2370', 'zikrizaki88995', 'yjenyiee155', '46harunakgul', 'alifzulkifli99', 'kaitlinh', 'tyy233', 'malgaca', 'lsleed', 'khazanv2', 'gc_1', 'jinsup2', 'rishu', 'amparo.castro.96', 'martin32', 'akash140410107098', 'nowapoca', 'pablosaavedra', 'camilolcastro97', 'khor', 'ankit6257', 'benoiturcotte', 'rileyroca', 'david.peral.moran', 'kiruthikaabalu181996', 'taymacnichols', 'nagihankececi', 'carlosvigo1997', 'moh.ashraf105', 'baleko12345', 'ikhbal', 'afeefz', 'kie180031', 'jorgecastelo5', 'andreadiazgar', 'david2397', 'bcperki2', 'rkchapman', 'jn1404', 'mateocampos', 'jzhan142', 'josepazmartin', 'adfoz', 'avw2', 'youxing0309', 'scremin', 'perezsarmar', 'ashutoshsinghhenry6', 'melroy_caeiro', 'viratbhatt007', 'fkl217', 'coderko3', 'alimatama', 'ammaralaa516', 'nadhnasorudin', 'adarsh123', 'jacquelinethardin', 'mjoza2', 'nihatyavuz', 'estebanrial', 'jinwoo2', 'adnanyuceer', 'danielfernandezcalo', 'berkaydean', 'cloudyoverhead', 'fred_dion', 'syedzakwan', 'fcfrancapra94', 'amiruldanial99', 'ozbunar01', 'alecorti.pardo', 'electronica18', 'nourananwar123', 'olivier.gilbert.paquet', 'amlibrahim', 'neuroque', 'kychui2', 'shaf31', 'hong_gao', 'paul.aniruddha', 'carlosbesadaromero', 'mohaballam', 'pip29', 'apb5472', 'tuberkargan', 'hafizmokh99', 'fathy1104', 'corredoira', 'helenalecoq97', 'kimzihuang', 'muteki', 'masitadonmez', 'nadja1', 'ahmedsameh1698', 'rocio', 'mallen22', 'ffazul64', 'guoyao', 'ari6nd', 'kerryreto', 'pedrosiaba', 'omarmagdy', 'vickytubio', 'soccadelic44', 'selena', 'aasifhameed99', 'damlakubattt', 'anxovidal8', 'exjamil', 'jahnavikachhia', 'joker632455', 'vincentpainchaud.vp', 'svo4321', 'zhixin2', 'yansi', 'asyrafaqil', 'xyz11', 'virajput299', 'mariz', 'bhliu97', 'amrebrahim', 'abdulrahim2905', 'tonybocadillosgrandes', 'talwren', 'farah26', 'tss3', 'abieday1704', 'facundovia', 'cristinacigarran', 'nazimmath3', 'baohl2', 'ales.gajdacz', 'kie180028', 'wahidiah52', 'kyang37', 'arifjalani99', 'lino13', 'physquig', 'adriancheah', 'jarodm2', 'noureldin1999', 'michael2010814', 'ckim123', 'eddin21', 'jipiccardi', 'prabuddha_888253127', 'david_atef', 'kalebhilde', 'magic_ocean99', 'omardeyaa', 'pingan99', 'alidsjt', 'mengkem2', 'ilou', 'aengm', 'janalorenzolumbreras', 'hilisa', 'carlosvillar54', 'vikazvereva', 'm939454', 'va844', 'pablobou4', 'ludovick.begin', 'maniphysics09', 'eduard25252598', 'apascao', 'xosegq16', 'adam562', 'lauramolinosmayo', 'amni99', 'kie180702', 'saharoaf', 'redzuan11', 'kph2', 'martinzapata', 'kirolosehab99', 'restep2', 'seifhabib', 'maramtarek53', 'zehuahe2', 'azizijazam11', 'marcosanllo', 'aimansyaz99', 'elizametias12', 'juanmacano97', 'sparshagarwal1009', 'prakharbhargava0', 'njs035', 'alberfn', 'ramy_maged4', 'hmoulvi1', 'vanesagarcia', 'hf4', 'mohammedemadeldin2000', 'gabrielyii', 'keerthisv', 'pythagoras2', 'xunyong', 'irenehb92', 'shradhap', 'mohameeddsamy', 'marianne.gratton.1', 'marcmagdy98', 'brknshn', 'gemma', 'lukunze1', 'caglanlee', 'desmondsoon', 'sebasket14', 'masonpb2', 'youssef2042000', 'retty8', 'bharath3', 'syin4', 'jacobzeshleman', 'leejq', 'harshini9962', 'reemali99_', 'ramonruiz.infor', 'hishamzakaria20', 'cheokonn', 'adriangarea', 'jeanmichael.deschenes', 'samet1231234', 'mr4425', 'bluelobster', 'justin.lariviere.25', 'dcpang2', 'felivitullo87', 'puertarcd', 'farahsamir978', 'akozych2', 'nbs691', 'kie180073', 'anwar909', 'bleuminuit', 'atx203', 'sealseal', 'emrebuyukkose2', 'arrow823', 'dhvanil', 'nuanno97', 'dkshelat', 'mohabayman', 'ranasherif65', 'diamond92', 'ugur.cankaya.3718', 'ammareltalli', 'nabilah1403', 'yaseminablacandir', 'tamchouweng', 'ablahsaoud', 'sriharshap', 'mrefaat', 'bassamtarek', 'kakmeera1999', 'abdurrahmn13', 'mmartinezsanchez', 'sandrabashara', 'zakhwan7', 'chengweiheng', 'nikalyaamani', 'acregodean', 'happyleexin', 'sarapl', 'williammitchell5818', 'rooban11', 'yeejou990318', 'kowjiajin', 'nihaosawaddee', 'maxernest', 'david.garrido', 'guibill10', 'mohamedsameh', 'spazos7', 'tmi211', 'kie180039', 'worldlineusaf', 'mgk816', 'kie180079', 'ledicia97', 'movi205', 'shuming2']",4,"['billsnow', 'lobwedge', None, 'darielysp']",395,"['oliviercharbonneau', 'miri23', 'ozgurkablan26', 'loisonchambers', 'tuberkargan_97', 'pranjal3', 'musabmalek0717', 'nadanasser1199', 'siemprewowthechami', 'staceyn2', 'vblanco.nico', 'abbesalaeddine', 'efrenhub', 'isabelmaria.vazquez', 'ahmedamr', 'shorouk_ossama', 'rikardberger', 'alancantu57', 'luciano.brignone', 'rahimnoorj', 'janeneil88', 'guttsfulltyagi', 'mjgebara14', 'kartal', 'gabrielyii99', 'aboone06', 'saegner2', 'manuelsomoza94', 'amani12345', 'youssefsherif22', 'j.haliburton', 'amr_ua07', 'evrenyigit', 'tingliang', 'kirankumar94', 'ahagras13', 'njgale01', 'al4995', 'smrdafdl', 'travisc2', 'dlee145', 'stambo', 'anthonyroux', 'ryanorem', 'moh.bahaa', 'ahchehyan', 'aimanadnan', 'veronica.mieites', 's_coriolis', 'trkmengkay', 'lobwedge', 'cbecker413', 'mcruces.fz', 'latecnologiameodia', 'gxiao2', 'emilechouinard', 'je_guilbert', 'yubai', 'sinasigurpinar', 'lauragdevesa', 'muvafikmelikkaya', 'kason.carroll', 'jbaggie2019', 'annahaozheng0606', 'jtorres17', 'ahmedayman2370', 'zikrizaki88995', 'yjenyiee155', '46harunakgul', 'alifzulkifli99', 'kaitlinh', 'tyy233', 'sdehoyos47', 'malgaca', 'lsleed', 'khazanv2', 'alexisdixon6', 'gc_1', 'jinsup2', 'rishu', 'amparo.castro.96', 'tbryan', 'martin32', 'michael.mechelay', 'akash140410107098', 'nowapoca', 'onaam8', 'pablosaavedra', 'camilolcastro97', 'khor', 'ankit6257', 'samashraf1', 'benoiturcotte', 'aishu98', 'rileyroca', 'darielysp', 'david.peral.moran', 'kiruthikaabalu181996', 'taymacnichols', 'dhodapp', 'nagihankececi', 'carlosvigo1997', 'moh.ashraf105', 'baleko12345', 'ikhbal', 'afeefz', 'kaustubh.shirpurkar', 'kie180031', 'bflores18', 'tdubnansky6', 'jorgecastelo5', 'andreadiazgar', 'david2397', 'bcperki2', 'melaniejkramer', 'rkchapman', 'jn1404', 'mateocampos', 'jzhan142', 'josepazmartin', 'brannon44', 'adfoz', 'avw2', 'youxing0309', 'scremin', 'lderemo', 'perezsarmar', 'ashutoshsinghhenry6', 'melroy_caeiro', 'viratbhatt007', 'fkl217', 'coderko3', 'alimatama', 'ammaralaa516', 'nadhnasorudin', 'adarsh123', 'jacquelinethardin', 'mjoza2', 'nihatyavuz', 'estebanrial', 'jinwoo2', 'adnanyuceer', 'danielfernandezcalo', 'berkaydean', 'cloudyoverhead', 'fred_dion', 'syedzakwan', 'e1150590', 'fcfrancapra94', 'amiruldanial99', 'ozbunar01', 'alecorti.pardo', 'electronica18', 'nourananwar123', 'olivier.gilbert.paquet', 'anibarseghyan', 'amlibrahim', 'neuroque', 'kychui2', 'shaf31', 'hong_gao', 'paul.aniruddha', 'carlosbesadaromero', 'mohaballam', 'pip29', 'apb5472', 'tuberkargan', 'hafizmokh99', 'javierisma98', 'fathy1104', 'corredoira', 'helenalecoq97', 'kimzihuang', 'muteki', 'masitadonmez', 'nadja1', 'dancastaneda', 'ahmedsameh1698', 'rocio', 'mallen22', 'ffazul64', 'guoyao', 'ari6nd', 'kerryreto', 'pedrosiaba', 'michaelsaldana1', 'billsnow', 'omarmagdy', 'vickytubio', 'ericrobles', 'soccadelic44', 'selena', 'aasifhameed99', 'damlakubattt', 'anxovidal8', 'exjamil', 'jahnavikachhia', 'joker632455', 'vincentpainchaud.vp', 'svo4321', 'zhixin2', 'yansi', 'asyrafaqil', 'xyz11', 'virajput299', 'ryanboucher', 'jpmcgee98', 'mariz', 'bhliu97', 'amrebrahim', 'abdulrahim2905', 'c.a.stupka', 'tonybocadillosgrandes', 'talwren', 'rxtodd', 'farah26', 'tss3', 'abieday1704', 'mavanzato0418', 'facundovia', 'cristinacigarran', 'nazimmath3', 'baohl2', 'ales.gajdacz', 'elad.d', 'kie180028', 'wahidiah52', 'kyang37', 'arifjalani99', 'lino13', 'jaimefookinlannister', 'physquig', 'adriancheah', 'jarodm2', 'noureldin1999', 'michael2010814', 'ckim123', 'eddin21', 'jipiccardi', 'prabuddha_888253127', 'david_atef', 'kalebhilde', 'magic_ocean99', 'saipraneett', 'sanchjai', 'omardeyaa', 'pingan99', 'aaq', 'alidsjt', 'mengkem2', 'haclarke', 'oishikfaruque', 'ilou', 'aengm', 'janalorenzolumbreras', 'hilisa', 'carlosvillar54', 'vikazvereva', 'm939454', 'va844', 'pablobou4', 'ludovick.begin', 'maniphysics09', 'eduard25252598', 'apascao', 'xosegq16', 'adam562', 'lauramolinosmayo', 'amni99', 'kie180702', 'saharoaf', 'redzuan11', 'ypp200', 'kph2', 'martinzapata', 'kirolosehab99', 'restep2', 'seifhabib', 'maramtarek53', 'zehuahe2', 'azizijazam11', 'marcosanllo', 'aimansyaz99', 'elizametias12', 'juanmacano97', 'sparshagarwal1009', 'prakharbhargava0', 'njs035', 'alberfn', 'ramy_maged4', 'hmoulvi1', 'vanesagarcia', 'hf4', 'wowmuchchuck', 'mohammedemadeldin2000', 'gabrielyii', 'keerthisv', 'pythagoras2', 'xunyong', 'irenehb92', 'shradhap', 'mohameeddsamy', 'marianne.gratton.1', 'marcmagdy98', 'brknshn', 'gemma', 'lukunze1', 'caglanlee', 'desmondsoon', 'sebasket14', 'masonpb2', 'youssef2042000', 'retty8', 'bharath3', 'syin4', 'ethanmorse', 'ematson5897', 'jacobzeshleman', 'leejq', 'harshini9962', 'reemali99_', 'xxlilmontysignxx', 'ramonruiz.infor', 'atharva98', 'ahern0722', 'hishamzakaria20', 'cheokonn', 'adriangarea', 'jeanmichael.deschenes', 'samet1231234', 'mr4425', 'bluelobster', 'justin.lariviere.25', 'dcpang2', 'felivitullo87', 'puertarcd', 'farahsamir978', 'akozych2', 'nbs691', 'kie180073', 'anwar909', 'bleuminuit', 'atx203', 'kanet1234', 'sealseal', 'emrebuyukkose2', 'arrow823', 'dhvanil', 'nuanno97', 'dkshelat', 'mohabayman', 'ranasherif65', 'diamond92', 'ugur.cankaya.3718', 'ammareltalli', 'acn562', 'nabilah1403', 'yaseminablacandir', 'tamchouweng', 'ablahsaoud', 'sriharshap', 'mrefaat', 'bassamtarek', 'hamidausat', 'kakmeera1999', 'teoster50', 'nolmos96', 'abdurrahmn13', 'mmartinezsanchez', 'sandrabashara', 'zakhwan7', 'chengweiheng', 'nikalyaamani', 'acregodean', 'happyleexin', 'sarapl', 'williammitchell5818', None, 'rooban11', 'yeejou990318', 'kowjiajin', 'nihaosawaddee', 'maxernest', 'david.garrido', 'guibill10', 'mohamedsameh', 'spazos7', 'tmi211', 'kie180039', 'worldlineusaf', 'mgk816', 'kie180079', 'ledicia97', 'movi205', 'shuming2']"
1,36,391,54,47,"['alidsjt', 'loisonchambers', 'mcruces.fz', 'latecnologiameodia', 'carlosbesadaromero', 'gemma', 'nuanno97', 'vblanco.nico', 'janalorenzolumbreras', 'carlosvillar54', 'efrenhub', 'mateocampos', 'tonybocadillosgrandes', 'lauragdevesa', 'pablobou4', 'retty8', 'cristinacigarran', 'corredoira', 'helenalecoq97', 'xosegq16', 'ramonruiz.infor', 'perezsarmar', 'malgaca', 'pedrosiaba', 'martinzapata', 'alimatama', 'acregodean', 'amparo.castro.96', 'lino13', 'martin32', 'sarapl', 'vickytubio', 'camilolcastro97', 'marcosanllo', 'juanmacano97', 'maxernest', 'anxovidal8', 'david.peral.moran', 'puertarcd', 'svo4321', 'alecorti.pardo', 'electronica18', 'veronica.mieites', 'vanesagarcia', 'carlosvigo1997', 'ledicia97', 'movi205']",344,"['oliviercharbonneau', 'miri23', 'ozgurkablan26', 'tuberkargan_97', 'pranjal3', 'musabmalek0717', 'nadanasser1199', 'siemprewowthechami', 'staceyn2', 'abbesalaeddine', 'isabelmaria.vazquez', 'ahmedamr', 'shorouk_ossama', 'rikardberger', 'alancantu57', 'luciano.brignone', 'rahimnoorj', 'janeneil88', 'guttsfulltyagi', 'mjgebara14', 'kartal', 'gabrielyii99', 'aboone06', 'saegner2', 'manuelsomoza94', 'amani12345', 'youssefsherif22', 'j.haliburton', 'amr_ua07', 'evrenyigit', 'tingliang', 'kirankumar94', 'ahagras13', 'njgale01', 'al4995', 'smrdafdl', 'travisc2', 'dlee145', 'stambo', 'anthonyroux', 'ryanorem', 'moh.bahaa', 'ahchehyan', 'aimanadnan', 's_coriolis', 'trkmengkay', 'cbecker413', 'gxiao2', 'emilechouinard', 'je_guilbert', 'yubai', 'sinasigurpinar', 'muvafikmelikkaya', 'kason.carroll', 'jbaggie2019', 'annahaozheng0606', 'jtorres17', 'ahmedayman2370', 'zikrizaki88995', 'yjenyiee155', '46harunakgul', 'alifzulkifli99', 'kaitlinh', 'tyy233', 'sdehoyos47', 'lsleed', 'khazanv2', 'alexisdixon6', 'gc_1', 'jinsup2', 'rishu', 'tbryan', 'michael.mechelay', 'akash140410107098', 'nowapoca', 'onaam8', 'pablosaavedra', 'khor', 'ankit6257', 'samashraf1', 'benoiturcotte', 'aishu98', 'rileyroca', 'kiruthikaabalu181996', 'taymacnichols', 'dhodapp', 'nagihankececi', 'moh.ashraf105', 'baleko12345', 'ikhbal', 'afeefz', 'kaustubh.shirpurkar', 'kie180031', 'bflores18', 'tdubnansky6', 'jorgecastelo5', 'andreadiazgar', 'david2397', 'bcperki2', 'melaniejkramer', 'rkchapman', 'jn1404', 'jzhan142', 'josepazmartin', 'brannon44', 'adfoz', 'avw2', 'youxing0309', 'scremin', 'lderemo', 'ashutoshsinghhenry6', 'melroy_caeiro', 'viratbhatt007', 'fkl217', 'coderko3', 'ammaralaa516', 'nadhnasorudin', 'adarsh123', 'jacquelinethardin', 'mjoza2', 'nihatyavuz', 'estebanrial', 'jinwoo2', 'adnanyuceer', 'danielfernandezcalo', 'berkaydean', 'cloudyoverhead', 'fred_dion', 'syedzakwan', 'e1150590', 'fcfrancapra94', 'amiruldanial99', 'ozbunar01', 'nourananwar123', 'olivier.gilbert.paquet', 'anibarseghyan', 'amlibrahim', 'neuroque', 'kychui2', 'shaf31', 'hong_gao', 'paul.aniruddha', 'mohaballam', 'pip29', 'apb5472', 'tuberkargan', 'hafizmokh99', 'javierisma98', 'fathy1104', 'kimzihuang', 'muteki', 'masitadonmez', 'nadja1', 'dancastaneda', 'ahmedsameh1698', 'rocio', 'mallen22', 'ffazul64', 'guoyao', 'ari6nd', 'kerryreto', 'michaelsaldana1', 'omarmagdy', 'ericrobles', 'soccadelic44', 'selena', 'aasifhameed99', 'damlakubattt', 'exjamil', 'jahnavikachhia', 'joker632455', 'vincentpainchaud.vp', 'zhixin2', 'yansi', 'asyrafaqil', 'xyz11', 'virajput299', 'ryanboucher', 'jpmcgee98', 'mariz', 'bhliu97', 'amrebrahim', 'abdulrahim2905', 'c.a.stupka', 'talwren', 'rxtodd', 'farah26', 'tss3', 'abieday1704', 'mavanzato0418', 'facundovia', 'nazimmath3', 'baohl2', 'ales.gajdacz', 'elad.d', 'kie180028', 'wahidiah52', 'kyang37', 'arifjalani99', 'jaimefookinlannister', 'physquig', 'adriancheah', 'jarodm2', 'noureldin1999', 'michael2010814', 'ckim123', 'eddin21', 'jipiccardi', 'prabuddha_888253127', 'david_atef', 'kalebhilde', 'magic_ocean99', 'saipraneett', 'sanchjai', 'omardeyaa', 'pingan99', 'aaq', 'mengkem2', 'haclarke', 'oishikfaruque', 'ilou', 'aengm', 'hilisa', 'vikazvereva', 'm939454', 'va844', 'ludovick.begin', 'maniphysics09', 'eduard25252598', 'apascao', 'adam562', 'lauramolinosmayo', 'amni99', 'kie180702', 'saharoaf', 'redzuan11', 'ypp200', 'kph2', 'kirolosehab99', 'restep2', 'seifhabib', 'maramtarek53', 'zehuahe2', 'azizijazam11', 'aimansyaz99', 'elizametias12', 'sparshagarwal1009', 'prakharbhargava0', 'njs035', 'alberfn', 'ramy_maged4', 'hmoulvi1', 'hf4', 'wowmuchchuck', 'mohammedemadeldin2000', 'gabrielyii', 'keerthisv', 'pythagoras2', 'xunyong', 'irenehb92', 'shradhap', 'mohameeddsamy', 'marianne.gratton.1', 'marcmagdy98', 'brknshn', 'lukunze1', 'caglanlee', 'desmondsoon', 'sebasket14', 'masonpb2', 'youssef2042000', 'bharath3', 'syin4', 'ethanmorse', 'ematson5897', 'jacobzeshleman', 'leejq', 'harshini9962', 'reemali99_', 'xxlilmontysignxx', 'atharva98', 'ahern0722', 'hishamzakaria20', 'cheokonn', 'adriangarea', 'jeanmichael.deschenes', 'samet1231234', 'mr4425', 'bluelobster', 'justin.lariviere.25', 'dcpang2', 'felivitullo87', 'farahsamir978', 'akozych2', 'nbs691', 'kie180073', 'anwar909', 'bleuminuit', 'atx203', 'kanet1234', 'sealseal', 'emrebuyukkose2', 'arrow823', 'dhvanil', 'dkshelat', 'mohabayman', 'ranasherif65', 'diamond92', 'ugur.cankaya.3718', 'ammareltalli', 'acn562', 'nabilah1403', 'yaseminablacandir', 'tamchouweng', 'ablahsaoud', 'sriharshap', 'mrefaat', 'bassamtarek', 'hamidausat', 'kakmeera1999', 'teoster50', 'nolmos96', 'abdurrahmn13', 'mmartinezsanchez', 'sandrabashara', 'zakhwan7', 'chengweiheng', 'nikalyaamani', 'happyleexin', 'williammitchell5818', 'rooban11', 'yeejou990318', 'kowjiajin', 'nihaosawaddee', 'david.garrido', 'guibill10', 'mohamedsameh', 'spazos7', 'tmi211', 'kie180039', 'worldlineusaf', 'mgk816', 'kie180079', 'shuming2']",7,"['dfl', 'antonio25', 'aronchino6', 'gombut', 'hermidaitor', 'iago', None]",398,"['oliviercharbonneau', 'miri23', 'ozgurkablan26', 'loisonchambers', 'tuberkargan_97', 'pranjal3', 'musabmalek0717', 'nadanasser1199', 'siemprewowthechami', 'staceyn2', 'vblanco.nico', 'abbesalaeddine', 'efrenhub', 'isabelmaria.vazquez', 'ahmedamr', 'shorouk_ossama', 'rikardberger', 'alancantu57', 'luciano.brignone', 'rahimnoorj', 'janeneil88', 'guttsfulltyagi', 'mjgebara14', 'kartal', 'gabrielyii99', 'aboone06', 'saegner2', 'manuelsomoza94', 'amani12345', 'youssefsherif22', 'j.haliburton', 'amr_ua07', 'evrenyigit', 'tingliang', 'kirankumar94', 'ahagras13', 'njgale01', 'al4995', 'smrdafdl', 'travisc2', 'dlee145', 'stambo', 'anthonyroux', 'ryanorem', 'moh.bahaa', 'ahchehyan', 'aimanadnan', 'veronica.mieites', 's_coriolis', 'trkmengkay', 'cbecker413', 'mcruces.fz', 'latecnologiameodia', 'gxiao2', 'emilechouinard', 'je_guilbert', 'yubai', 'sinasigurpinar', 'lauragdevesa', 'muvafikmelikkaya', 'kason.carroll', 'jbaggie2019', 'annahaozheng0606', 'jtorres17', 'ahmedayman2370', 'zikrizaki88995', 'yjenyiee155', '46harunakgul', 'alifzulkifli99', 'kaitlinh', 'tyy233', 'sdehoyos47', 'malgaca', 'lsleed', 'khazanv2', 'alexisdixon6', 'gc_1', 'jinsup2', 'rishu', 'amparo.castro.96', 'tbryan', 'martin32', 'michael.mechelay', 'akash140410107098', 'nowapoca', 'onaam8', 'pablosaavedra', 'camilolcastro97', 'khor', 'ankit6257', 'samashraf1', 'benoiturcotte', 'aishu98', 'rileyroca', 'david.peral.moran', 'kiruthikaabalu181996', 'taymacnichols', 'dhodapp', 'hermidaitor', 'nagihankececi', 'carlosvigo1997', 'moh.ashraf105', 'baleko12345', 'ikhbal', 'afeefz', 'kaustubh.shirpurkar', 'kie180031', 'bflores18', 'tdubnansky6', 'jorgecastelo5', 'andreadiazgar', 'david2397', 'bcperki2', 'melaniejkramer', 'rkchapman', 'jn1404', 'mateocampos', 'jzhan142', 'josepazmartin', 'brannon44', 'adfoz', 'avw2', 'youxing0309', 'scremin', 'lderemo', 'perezsarmar', 'ashutoshsinghhenry6', 'melroy_caeiro', 'viratbhatt007', 'fkl217', 'coderko3', 'alimatama', 'ammaralaa516', 'nadhnasorudin', 'adarsh123', 'jacquelinethardin', 'mjoza2', 'nihatyavuz', 'estebanrial', 'jinwoo2', 'adnanyuceer', 'danielfernandezcalo', 'berkaydean', 'cloudyoverhead', 'fred_dion', 'syedzakwan', 'e1150590', 'fcfrancapra94', 'amiruldanial99', 'ozbunar01', 'alecorti.pardo', 'electronica18', 'nourananwar123', 'olivier.gilbert.paquet', 'anibarseghyan', 'amlibrahim', 'neuroque', 'kychui2', 'shaf31', 'hong_gao', 'aronchino6', 'paul.aniruddha', 'carlosbesadaromero', 'mohaballam', 'pip29', 'apb5472', 'tuberkargan', 'hafizmokh99', 'javierisma98', 'fathy1104', 'corredoira', 'helenalecoq97', 'kimzihuang', 'muteki', 'iago', 'masitadonmez', 'nadja1', 'dancastaneda', 'ahmedsameh1698', 'rocio', 'mallen22', 'ffazul64', 'guoyao', 'ari6nd', 'kerryreto', 'pedrosiaba', 'michaelsaldana1', 'omarmagdy', 'vickytubio', 'ericrobles', 'soccadelic44', 'selena', 'aasifhameed99', 'damlakubattt', 'anxovidal8', 'exjamil', 'jahnavikachhia', 'joker632455', 'vincentpainchaud.vp', 'svo4321', 'zhixin2', 'yansi', 'asyrafaqil', 'xyz11', 'virajput299', 'ryanboucher', 'jpmcgee98', 'mariz', 'bhliu97', 'amrebrahim', 'abdulrahim2905', 'c.a.stupka', 'tonybocadillosgrandes', 'talwren', 'rxtodd', 'antonio25', 'farah26', 'tss3', 'abieday1704', 'mavanzato0418', 'gombut', 'facundovia', 'cristinacigarran', 'nazimmath3', 'baohl2', 'ales.gajdacz', 'elad.d', 'kie180028', 'wahidiah52', 'kyang37', 'arifjalani99', 'lino13', 'jaimefookinlannister', 'physquig', 'adriancheah', 'jarodm2', 'noureldin1999', 'michael2010814', 'ckim123', 'eddin21', 'jipiccardi', 'prabuddha_888253127', 'david_atef', 'kalebhilde', 'magic_ocean99', 'saipraneett', 'sanchjai', 'omardeyaa', 'pingan99', 'aaq', 'alidsjt', 'mengkem2', 'haclarke', 'oishikfaruque', 'ilou', 'aengm', 'janalorenzolumbreras', 'hilisa', 'carlosvillar54', 'vikazvereva', 'm939454', 'va844', 'pablobou4', 'ludovick.begin', 'maniphysics09', 'eduard25252598', 'apascao', 'xosegq16', 'adam562', 'lauramolinosmayo', 'amni99', 'kie180702', 'saharoaf', 'redzuan11', 'ypp200', 'kph2', 'martinzapata', 'kirolosehab99', 'restep2', 'seifhabib', 'maramtarek53', 'zehuahe2', 'azizijazam11', 'marcosanllo', 'aimansyaz99', 'elizametias12', 'juanmacano97', 'sparshagarwal1009', 'prakharbhargava0', 'njs035', 'alberfn', 'ramy_maged4', 'hmoulvi1', 'vanesagarcia', 'hf4', 'wowmuchchuck', 'mohammedemadeldin2000', 'gabrielyii', 'keerthisv', 'pythagoras2', 'xunyong', 'irenehb92', 'shradhap', 'mohameeddsamy', 'marianne.gratton.1', 'marcmagdy98', 'brknshn', 'gemma', 'lukunze1', 'caglanlee', 'desmondsoon', 'sebasket14', 'masonpb2', 'youssef2042000', 'retty8', 'bharath3', 'syin4', 'ethanmorse', 'ematson5897', 'jacobzeshleman', 'leejq', 'harshini9962', 'reemali99_', 'xxlilmontysignxx', 'ramonruiz.infor', 'atharva98', 'ahern0722', 'hishamzakaria20', 'cheokonn', 'adriangarea', 'jeanmichael.deschenes', 'samet1231234', 'mr4425', 'bluelobster', 'justin.lariviere.25', 'dcpang2', 'felivitullo87', 'puertarcd', 'farahsamir978', 'akozych2', 'nbs691', 'kie180073', 'anwar909', 'bleuminuit', 'atx203', 'kanet1234', 'sealseal', 'emrebuyukkose2', 'arrow823', 'dhvanil', 'nuanno97', 'dkshelat', 'mohabayman', 'ranasherif65', 'diamond92', 'ugur.cankaya.3718', 'ammareltalli', 'acn562', 'nabilah1403', 'yaseminablacandir', 'tamchouweng', 'ablahsaoud', 'sriharshap', 'mrefaat', 'bassamtarek', 'hamidausat', 'kakmeera1999', 'teoster50', 'nolmos96', 'abdurrahmn13', 'mmartinezsanchez', 'sandrabashara', 'zakhwan7', 'chengweiheng', 'nikalyaamani', 'acregodean', 'happyleexin', 'sarapl', 'williammitchell5818', None, 'rooban11', 'yeejou990318', 'kowjiajin', 'nihaosawaddee', 'maxernest', 'dfl', 'david.garrido', 'guibill10', 'mohamedsameh', 'spazos7', 'tmi211', 'kie180039', 'worldlineusaf', 'mgk816', 'kie180079', 'ledicia97', 'movi205', 'shuming2']"
1,32,391,53,33,"['xyz11', 'mengkem2', 'kychui2', 'pranjal3', 'bhliu97', 'staceyn2', 'gxiao2', 'bcperki2', 'masonpb2', 'tss3', 'bharath3', 'avw2', 'baohl2', 'khazanv2', 'saegner2', 'kph2', 'kyang37', 'jinsup2', 'coderko3', 'restep2', 'jacquelinethardin', 'zehuahe2', 'mjoza2', 'travisc2', 'dlee145', 'jinwoo2', 'dcpang2', 'jarodm2', 'ckim123', 'zhixin2', 'hf4', 'akozych2', 'shuming2']",358,"['oliviercharbonneau', 'miri23', 'ozgurkablan26', 'loisonchambers', 'tuberkargan_97', 'musabmalek0717', 'nadanasser1199', 'siemprewowthechami', 'vblanco.nico', 'abbesalaeddine', 'efrenhub', 'isabelmaria.vazquez', 'ahmedamr', 'shorouk_ossama', 'rikardberger', 'alancantu57', 'luciano.brignone', 'rahimnoorj', 'janeneil88', 'guttsfulltyagi', 'mjgebara14', 'kartal', 'gabrielyii99', 'aboone06', 'manuelsomoza94', 'amani12345', 'youssefsherif22', 'j.haliburton', 'amr_ua07', 'evrenyigit', 'tingliang', 'kirankumar94', 'ahagras13', 'njgale01', 'al4995', 'smrdafdl', 'stambo', 'anthonyroux', 'ryanorem', 'moh.bahaa', 'ahchehyan', 'aimanadnan', 'veronica.mieites', 's_coriolis', 'trkmengkay', 'cbecker413', 'mcruces.fz', 'latecnologiameodia', 'emilechouinard', 'je_guilbert', 'yubai', 'sinasigurpinar', 'lauragdevesa', 'muvafikmelikkaya', 'kason.carroll', 'jbaggie2019', 'annahaozheng0606', 'jtorres17', 'ahmedayman2370', 'zikrizaki88995', 'yjenyiee155', '46harunakgul', 'alifzulkifli99', 'kaitlinh', 'tyy233', 'sdehoyos47', 'malgaca', 'lsleed', 'alexisdixon6', 'gc_1', 'rishu', 'amparo.castro.96', 'tbryan', 'martin32', 'michael.mechelay', 'akash140410107098', 'nowapoca', 'onaam8', 'pablosaavedra', 'camilolcastro97', 'khor', 'ankit6257', 'samashraf1', 'benoiturcotte', 'aishu98', 'rileyroca', 'david.peral.moran', 'kiruthikaabalu181996', 'taymacnichols', 'dhodapp', 'nagihankececi', 'carlosvigo1997', 'moh.ashraf105', 'baleko12345', 'ikhbal', 'afeefz', 'kaustubh.shirpurkar', 'kie180031', 'bflores18', 'tdubnansky6', 'jorgecastelo5', 'andreadiazgar', 'david2397', 'melaniejkramer', 'rkchapman', 'jn1404', 'mateocampos', 'jzhan142', 'josepazmartin', 'brannon44', 'adfoz', 'youxing0309', 'scremin', 'lderemo', 'perezsarmar', 'ashutoshsinghhenry6', 'melroy_caeiro', 'viratbhatt007', 'fkl217', 'alimatama', 'ammaralaa516', 'nadhnasorudin', 'adarsh123', 'nihatyavuz', 'estebanrial', 'adnanyuceer', 'danielfernandezcalo', 'berkaydean', 'cloudyoverhead', 'fred_dion', 'syedzakwan', 'e1150590', 'fcfrancapra94', 'amiruldanial99', 'ozbunar01', 'alecorti.pardo', 'electronica18', 'nourananwar123', 'olivier.gilbert.paquet', 'anibarseghyan', 'amlibrahim', 'neuroque', 'shaf31', 'hong_gao', 'paul.aniruddha', 'carlosbesadaromero', 'mohaballam', 'pip29', 'apb5472', 'tuberkargan', 'hafizmokh99', 'javierisma98', 'fathy1104', 'corredoira', 'helenalecoq97', 'kimzihuang', 'muteki', 'masitadonmez', 'nadja1', 'dancastaneda', 'ahmedsameh1698', 'rocio', 'mallen22', 'ffazul64', 'guoyao', 'ari6nd', 'kerryreto', 'pedrosiaba', 'michaelsaldana1', 'omarmagdy', 'vickytubio', 'ericrobles', 'soccadelic44', 'selena', 'aasifhameed99', 'damlakubattt', 'anxovidal8', 'exjamil', 'jahnavikachhia', 'joker632455', 'vincentpainchaud.vp', 'svo4321', 'yansi', 'asyrafaqil', 'virajput299', 'ryanboucher', 'jpmcgee98', 'mariz', 'amrebrahim', 'abdulrahim2905', 'c.a.stupka', 'tonybocadillosgrandes', 'talwren', 'rxtodd', 'farah26', 'abieday1704', 'mavanzato0418', 'facundovia', 'cristinacigarran', 'nazimmath3', 'ales.gajdacz', 'elad.d', 'kie180028', 'wahidiah52', 'arifjalani99', 'lino13', 'jaimefookinlannister', 'physquig', 'adriancheah', 'noureldin1999', 'michael2010814', 'eddin21', 'jipiccardi', 'prabuddha_888253127', 'david_atef', 'kalebhilde', 'magic_ocean99', 'saipraneett', 'sanchjai', 'omardeyaa', 'pingan99', 'aaq', 'alidsjt', 'haclarke', 'oishikfaruque', 'ilou', 'aengm', 'janalorenzolumbreras', 'hilisa', 'carlosvillar54', 'vikazvereva', 'm939454', 'va844', 'pablobou4', 'ludovick.begin', 'maniphysics09', 'eduard25252598', 'apascao', 'xosegq16', 'adam562', 'lauramolinosmayo', 'amni99', 'kie180702', 'saharoaf', 'redzuan11', 'ypp200', 'martinzapata', 'kirolosehab99', 'seifhabib', 'maramtarek53', 'azizijazam11', 'marcosanllo', 'aimansyaz99', 'elizametias12', 'juanmacano97', 'sparshagarwal1009', 'prakharbhargava0', 'njs035', 'alberfn', 'ramy_maged4', 'hmoulvi1', 'vanesagarcia', 'wowmuchchuck', 'mohammedemadeldin2000', 'gabrielyii', 'keerthisv', 'pythagoras2', 'xunyong', 'irenehb92', 'shradhap', 'mohameeddsamy', 'marianne.gratton.1', 'marcmagdy98', 'brknshn', 'gemma', 'lukunze1', 'caglanlee', 'desmondsoon', 'sebasket14', 'youssef2042000', 'retty8', 'syin4', 'ethanmorse', 'ematson5897', 'jacobzeshleman', 'leejq', 'harshini9962', 'reemali99_', 'xxlilmontysignxx', 'ramonruiz.infor', 'atharva98', 'ahern0722', 'hishamzakaria20', 'cheokonn', 'adriangarea', 'jeanmichael.deschenes', 'samet1231234', 'mr4425', 'bluelobster', 'justin.lariviere.25', 'felivitullo87', 'puertarcd', 'farahsamir978', 'nbs691', 'kie180073', 'anwar909', 'bleuminuit', 'atx203', 'kanet1234', 'sealseal', 'emrebuyukkose2', 'arrow823', 'dhvanil', 'nuanno97', 'dkshelat', 'mohabayman', 'ranasherif65', 'diamond92', 'ugur.cankaya.3718', 'ammareltalli', 'acn562', 'nabilah1403', 'yaseminablacandir', 'tamchouweng', 'ablahsaoud', 'sriharshap', 'mrefaat', 'bassamtarek', 'hamidausat', 'kakmeera1999', 'teoster50', 'nolmos96', 'abdurrahmn13', 'mmartinezsanchez', 'sandrabashara', 'zakhwan7', 'chengweiheng', 'nikalyaamani', 'acregodean', 'happyleexin', 'sarapl', 'williammitchell5818', 'rooban11', 'yeejou990318', 'kowjiajin', 'nihaosawaddee', 'maxernest', 'david.garrido', 'guibill10', 'mohamedsameh', 'spazos7', 'tmi211', 'kie180039', 'worldlineusaf', 'mgk816', 'kie180079', 'ledicia97', 'movi205']",20,"['jmjin2', 'mtobah2', 'kv2', 'kfurbee2', 'juliaeb2', 'sili5', 'dplata2', 'rrmiriy2', 'spangnt2', 'rakam2', 'jiwu2', 'rsyuan2', 'juliajh2', 'joshua.leveillee', None, 'ellenrf2', 'clee152', 'scc3', 'rll2', 'aeh2']",411,"['oliviercharbonneau', 'miri23', 'ozgurkablan26', 'loisonchambers', 'tuberkargan_97', 'pranjal3', 'musabmalek0717', 'nadanasser1199', 'siemprewowthechami', 'staceyn2', 'vblanco.nico', 'abbesalaeddine', 'efrenhub', 'isabelmaria.vazquez', 'ahmedamr', 'shorouk_ossama', 'rikardberger', 'alancantu57', 'luciano.brignone', 'rahimnoorj', 'janeneil88', 'guttsfulltyagi', 'dplata2', 'mjgebara14', 'kartal', 'gabrielyii99', 'aboone06', 'saegner2', 'manuelsomoza94', 'amani12345', 'rsyuan2', 'youssefsherif22', 'j.haliburton', 'amr_ua07', 'evrenyigit', 'tingliang', 'kirankumar94', 'ahagras13', 'joshua.leveillee', 'njgale01', 'al4995', 'smrdafdl', 'travisc2', 'dlee145', 'stambo', 'anthonyroux', 'ryanorem', 'moh.bahaa', 'ahchehyan', 'aimanadnan', 'veronica.mieites', 's_coriolis', 'trkmengkay', 'cbecker413', 'mcruces.fz', 'latecnologiameodia', 'gxiao2', 'emilechouinard', 'je_guilbert', 'yubai', 'sinasigurpinar', 'lauragdevesa', 'muvafikmelikkaya', 'kason.carroll', 'jbaggie2019', 'annahaozheng0606', 'jtorres17', 'ahmedayman2370', 'zikrizaki88995', 'yjenyiee155', '46harunakgul', 'alifzulkifli99', 'kaitlinh', 'tyy233', 'sdehoyos47', 'malgaca', 'lsleed', 'khazanv2', 'alexisdixon6', 'gc_1', 'jinsup2', 'rishu', 'amparo.castro.96', 'tbryan', 'martin32', 'michael.mechelay', 'akash140410107098', 'nowapoca', 'onaam8', 'pablosaavedra', 'camilolcastro97', 'khor', 'ankit6257', 'samashraf1', 'scc3', 'benoiturcotte', 'aishu98', 'rileyroca', 'david.peral.moran', 'kiruthikaabalu181996', 'taymacnichols', 'dhodapp', 'nagihankececi', 'carlosvigo1997', 'moh.ashraf105', 'baleko12345', 'ikhbal', 'afeefz', 'kaustubh.shirpurkar', 'kie180031', 'bflores18', 'tdubnansky6', 'jorgecastelo5', 'andreadiazgar', 'david2397', 'bcperki2', 'melaniejkramer', 'rkchapman', 'jn1404', 'mateocampos', 'jzhan142', 'josepazmartin', 'brannon44', 'adfoz', 'sili5', 'avw2', 'youxing0309', 'scremin', 'lderemo', 'perezsarmar', 'ashutoshsinghhenry6', 'melroy_caeiro', 'viratbhatt007', 'fkl217', 'coderko3', 'alimatama', 'ammaralaa516', 'nadhnasorudin', 'adarsh123', 'jacquelinethardin', 'ellenrf2', 'mjoza2', 'nihatyavuz', 'estebanrial', 'jinwoo2', 'adnanyuceer', 'danielfernandezcalo', 'berkaydean', 'cloudyoverhead', 'fred_dion', 'syedzakwan', 'e1150590', 'fcfrancapra94', 'amiruldanial99', 'ozbunar01', 'alecorti.pardo', 'electronica18', 'nourananwar123', 'olivier.gilbert.paquet', 'anibarseghyan', 'amlibrahim', 'neuroque', 'kychui2', 'shaf31', 'hong_gao', 'paul.aniruddha', 'carlosbesadaromero', 'mohaballam', 'pip29', 'apb5472', 'tuberkargan', 'hafizmokh99', 'javierisma98', 'fathy1104', 'corredoira', 'helenalecoq97', 'kimzihuang', 'muteki', 'spangnt2', 'masitadonmez', 'nadja1', 'dancastaneda', 'ahmedsameh1698', 'rocio', 'mallen22', 'ffazul64', 'guoyao', 'ari6nd', 'kerryreto', 'pedrosiaba', 'michaelsaldana1', 'juliajh2', 'omarmagdy', 'vickytubio', 'ericrobles', 'soccadelic44', 'selena', 'aasifhameed99', 'damlakubattt', 'anxovidal8', 'exjamil', 'jahnavikachhia', 'joker632455', 'vincentpainchaud.vp', 'svo4321', 'zhixin2', 'yansi', 'asyrafaqil', 'xyz11', 'virajput299', 'ryanboucher', 'jpmcgee98', 'mariz', 'bhliu97', 'amrebrahim', 'jmjin2', 'abdulrahim2905', 'c.a.stupka', 'tonybocadillosgrandes', 'talwren', 'rxtodd', 'farah26', 'tss3', 'abieday1704', 'mavanzato0418', 'facundovia', 'cristinacigarran', 'rrmiriy2', 'nazimmath3', 'baohl2', 'ales.gajdacz', 'elad.d', 'kie180028', 'wahidiah52', 'kyang37', 'arifjalani99', 'lino13', 'jaimefookinlannister', 'physquig', 'adriancheah', 'jarodm2', 'noureldin1999', 'michael2010814', 'ckim123', 'eddin21', 'jipiccardi', 'prabuddha_888253127', 'david_atef', 'kalebhilde', 'magic_ocean99', 'saipraneett', 'sanchjai', 'omardeyaa', 'pingan99', 'aaq', 'alidsjt', 'mengkem2', 'haclarke', 'oishikfaruque', 'ilou', 'aengm', 'janalorenzolumbreras', 'hilisa', 'carlosvillar54', 'vikazvereva', 'm939454', 'va844', 'pablobou4', 'ludovick.begin', 'maniphysics09', 'eduard25252598', 'apascao', 'xosegq16', 'adam562', 'lauramolinosmayo', 'amni99', 'kie180702', 'saharoaf', 'redzuan11', 'ypp200', 'kph2', 'martinzapata', 'jiwu2', 'kirolosehab99', 'restep2', 'seifhabib', 'maramtarek53', 'zehuahe2', 'azizijazam11', 'marcosanllo', 'aimansyaz99', 'elizametias12', 'juanmacano97', 'clee152', 'sparshagarwal1009', 'prakharbhargava0', 'njs035', 'alberfn', 'ramy_maged4', 'hmoulvi1', 'vanesagarcia', 'hf4', 'wowmuchchuck', 'mohammedemadeldin2000', 'gabrielyii', 'keerthisv', 'pythagoras2', 'xunyong', 'irenehb92', 'shradhap', 'mohameeddsamy', 'marianne.gratton.1', 'marcmagdy98', 'brknshn', 'gemma', 'lukunze1', 'mtobah2', 'kv2', 'caglanlee', 'desmondsoon', 'kfurbee2', 'sebasket14', 'masonpb2', 'youssef2042000', 'retty8', 'bharath3', 'syin4', 'ethanmorse', 'ematson5897', 'rakam2', 'jacobzeshleman', 'leejq', 'harshini9962', 'reemali99_', 'xxlilmontysignxx', 'ramonruiz.infor', 'atharva98', 'ahern0722', 'hishamzakaria20', 'cheokonn', 'adriangarea', 'jeanmichael.deschenes', 'samet1231234', 'mr4425', 'bluelobster', 'justin.lariviere.25', 'dcpang2', 'rll2', 'felivitullo87', 'puertarcd', 'farahsamir978', 'akozych2', 'nbs691', 'kie180073', 'anwar909', 'bleuminuit', 'atx203', 'kanet1234', 'sealseal', 'emrebuyukkose2', 'arrow823', 'dhvanil', 'nuanno97', 'dkshelat', 'mohabayman', 'ranasherif65', 'diamond92', 'ugur.cankaya.3718', 'ammareltalli', 'acn562', 'nabilah1403', 'yaseminablacandir', 'juliaeb2', 'tamchouweng', 'ablahsaoud', 'sriharshap', 'mrefaat', 'bassamtarek', 'hamidausat', 'kakmeera1999', 'teoster50', 'nolmos96', 'abdurrahmn13', 'mmartinezsanchez', 'sandrabashara', 'zakhwan7', 'chengweiheng', 'nikalyaamani', 'acregodean', 'happyleexin', 'sarapl', 'williammitchell5818', None, 'rooban11', 'yeejou990318', 'kowjiajin', 'nihaosawaddee', 'maxernest', 'david.garrido', 'guibill10', 'mohamedsameh', 'spazos7', 'aeh2', 'tmi211', 'kie180039', 'worldlineusaf', 'mgk816', 'kie180079', 'ledicia97', 'movi205', 'shuming2']"
1,234,391,50,9,"['dcpang2', 'jinwoo2', 'tss3', 'kyang37', 'jinsup2', 'avw2', 'zhixin2', 'hf4', 'zehuahe2']",382,"['oliviercharbonneau', 'miri23', 'ozgurkablan26', 'loisonchambers', 'tuberkargan_97', 'pranjal3', 'musabmalek0717', 'nadanasser1199', 'siemprewowthechami', 'staceyn2', 'vblanco.nico', 'abbesalaeddine', 'efrenhub', 'isabelmaria.vazquez', 'ahmedamr', 'shorouk_ossama', 'rikardberger', 'alancantu57', 'luciano.brignone', 'rahimnoorj', 'janeneil88', 'guttsfulltyagi', 'mjgebara14', 'kartal', 'gabrielyii99', 'aboone06', 'saegner2', 'manuelsomoza94', 'amani12345', 'youssefsherif22', 'j.haliburton', 'amr_ua07', 'evrenyigit', 'tingliang', 'kirankumar94', 'ahagras13', 'njgale01', 'al4995', 'smrdafdl', 'travisc2', 'dlee145', 'stambo', 'anthonyroux', 'ryanorem', 'moh.bahaa', 'ahchehyan', 'aimanadnan', 'veronica.mieites', 's_coriolis', 'trkmengkay', 'cbecker413', 'mcruces.fz', 'latecnologiameodia', 'gxiao2', 'emilechouinard', 'je_guilbert', 'yubai', 'sinasigurpinar', 'lauragdevesa', 'muvafikmelikkaya', 'kason.carroll', 'jbaggie2019', 'annahaozheng0606', 'jtorres17', 'ahmedayman2370', 'zikrizaki88995', 'yjenyiee155', '46harunakgul', 'alifzulkifli99', 'kaitlinh', 'tyy233', 'sdehoyos47', 'malgaca', 'lsleed', 'khazanv2', 'alexisdixon6', 'gc_1', 'rishu', 'amparo.castro.96', 'tbryan', 'martin32', 'michael.mechelay', 'akash140410107098', 'nowapoca', 'onaam8', 'pablosaavedra', 'camilolcastro97', 'khor', 'ankit6257', 'samashraf1', 'benoiturcotte', 'aishu98', 'rileyroca', 'david.peral.moran', 'kiruthikaabalu181996', 'taymacnichols', 'dhodapp', 'nagihankececi', 'carlosvigo1997', 'moh.ashraf105', 'baleko12345', 'ikhbal', 'afeefz', 'kaustubh.shirpurkar', 'kie180031', 'bflores18', 'tdubnansky6', 'jorgecastelo5', 'andreadiazgar', 'david2397', 'bcperki2', 'melaniejkramer', 'rkchapman', 'jn1404', 'mateocampos', 'jzhan142', 'josepazmartin', 'brannon44', 'adfoz', 'youxing0309', 'scremin', 'lderemo', 'perezsarmar', 'ashutoshsinghhenry6', 'melroy_caeiro', 'viratbhatt007', 'fkl217', 'coderko3', 'alimatama', 'ammaralaa516', 'nadhnasorudin', 'adarsh123', 'jacquelinethardin', 'mjoza2', 'nihatyavuz', 'estebanrial', 'adnanyuceer', 'danielfernandezcalo', 'berkaydean', 'cloudyoverhead', 'fred_dion', 'syedzakwan', 'e1150590', 'fcfrancapra94', 'amiruldanial99', 'ozbunar01', 'alecorti.pardo', 'electronica18', 'nourananwar123', 'olivier.gilbert.paquet', 'anibarseghyan', 'amlibrahim', 'neuroque', 'kychui2', 'shaf31', 'hong_gao', 'paul.aniruddha', 'carlosbesadaromero', 'mohaballam', 'pip29', 'apb5472', 'tuberkargan', 'hafizmokh99', 'javierisma98', 'fathy1104', 'corredoira', 'helenalecoq97', 'kimzihuang', 'muteki', 'masitadonmez', 'nadja1', 'dancastaneda', 'ahmedsameh1698', 'rocio', 'mallen22', 'ffazul64', 'guoyao', 'ari6nd', 'kerryreto', 'pedrosiaba', 'michaelsaldana1', 'omarmagdy', 'vickytubio', 'ericrobles', 'soccadelic44', 'selena', 'aasifhameed99', 'damlakubattt', 'anxovidal8', 'exjamil', 'jahnavikachhia', 'joker632455', 'vincentpainchaud.vp', 'svo4321', 'yansi', 'asyrafaqil', 'xyz11', 'virajput299', 'ryanboucher', 'jpmcgee98', 'mariz', 'bhliu97', 'amrebrahim', 'abdulrahim2905', 'c.a.stupka', 'tonybocadillosgrandes', 'talwren', 'rxtodd', 'farah26', 'abieday1704', 'mavanzato0418', 'facundovia', 'cristinacigarran', 'nazimmath3', 'baohl2', 'ales.gajdacz', 'elad.d', 'kie180028', 'wahidiah52', 'arifjalani99', 'lino13', 'jaimefookinlannister', 'physquig', 'adriancheah', 'jarodm2', 'noureldin1999', 'michael2010814', 'ckim123', 'eddin21', 'jipiccardi', 'prabuddha_888253127', 'david_atef', 'kalebhilde', 'magic_ocean99', 'saipraneett', 'sanchjai', 'omardeyaa', 'pingan99', 'aaq', 'alidsjt', 'mengkem2', 'haclarke', 'oishikfaruque', 'ilou', 'aengm', 'janalorenzolumbreras', 'hilisa', 'carlosvillar54', 'vikazvereva', 'm939454', 'va844', 'pablobou4', 'ludovick.begin', 'maniphysics09', 'eduard25252598', 'apascao', 'xosegq16', 'adam562', 'lauramolinosmayo', 'amni99', 'kie180702', 'saharoaf', 'redzuan11', 'ypp200', 'kph2', 'martinzapata', 'kirolosehab99', 'restep2', 'seifhabib', 'maramtarek53', 'azizijazam11', 'marcosanllo', 'aimansyaz99', 'elizametias12', 'juanmacano97', 'sparshagarwal1009', 'prakharbhargava0', 'njs035', 'alberfn', 'ramy_maged4', 'hmoulvi1', 'vanesagarcia', 'wowmuchchuck', 'mohammedemadeldin2000', 'gabrielyii', 'keerthisv', 'pythagoras2', 'xunyong', 'irenehb92', 'shradhap', 'mohameeddsamy', 'marianne.gratton.1', 'marcmagdy98', 'brknshn', 'gemma', 'lukunze1', 'caglanlee', 'desmondsoon', 'sebasket14', 'masonpb2', 'youssef2042000', 'retty8', 'bharath3', 'syin4', 'ethanmorse', 'ematson5897', 'jacobzeshleman', 'leejq', 'harshini9962', 'reemali99_', 'xxlilmontysignxx', 'ramonruiz.infor', 'atharva98', 'ahern0722', 'hishamzakaria20', 'cheokonn', 'adriangarea', 'jeanmichael.deschenes', 'samet1231234', 'mr4425', 'bluelobster', 'justin.lariviere.25', 'felivitullo87', 'puertarcd', 'farahsamir978', 'akozych2', 'nbs691', 'kie180073', 'anwar909', 'bleuminuit', 'atx203', 'kanet1234', 'sealseal', 'emrebuyukkose2', 'arrow823', 'dhvanil', 'nuanno97', 'dkshelat', 'mohabayman', 'ranasherif65', 'diamond92', 'ugur.cankaya.3718', 'ammareltalli', 'acn562', 'nabilah1403', 'yaseminablacandir', 'tamchouweng', 'ablahsaoud', 'sriharshap', 'mrefaat', 'bassamtarek', 'hamidausat', 'kakmeera1999', 'teoster50', 'nolmos96', 'abdurrahmn13', 'mmartinezsanchez', 'sandrabashara', 'zakhwan7', 'chengweiheng', 'nikalyaamani', 'acregodean', 'happyleexin', 'sarapl', 'williammitchell5818', 'rooban11', 'yeejou990318', 'kowjiajin', 'nihaosawaddee', 'maxernest', 'david.garrido', 'guibill10', 'mohamedsameh', 'spazos7', 'tmi211', 'kie180039', 'worldlineusaf', 'mgk816', 'kie180079', 'ledicia97', 'movi205', 'shuming2']",41,"['wkeaty2', 'cbo3', 'chguo2', 'tsehgal2', 'jkubota2', 'anirula2', 'wsuk2', 'qiuhuic2', 'domanus2', 'lsienko2', 'jjwilde2', 'shirani', 'ssutyak2', 'edimare2', 'mblaauw2', 'srb2', 'danayun2', 'naisong2', 'conanw2', 'pittges2', 'pwalke9', 'jtkach2', 'tz11', 'vtagare2', 'jungeun5', 'ablee2', 'jgruber3', 'rhalton2', None, 'txyang2', 'joshuas8', 'gcangi2', 'hjr2', 'anunez38', 'iflueck2', 'mw21', 'kevinjl3', 'rvplank2', 'arhode2', 'chanmin2', 'omarma2']",432,"['oliviercharbonneau', 'miri23', 'ozgurkablan26', 'loisonchambers', 'tuberkargan_97', 'pranjal3', 'musabmalek0717', 'nadanasser1199', 'siemprewowthechami', 'staceyn2', 'vblanco.nico', 'abbesalaeddine', 'efrenhub', 'isabelmaria.vazquez', 'ahmedamr', 'shorouk_ossama', 'rikardberger', 'alancantu57', 'luciano.brignone', 'rahimnoorj', 'janeneil88', 'guttsfulltyagi', 'mjgebara14', 'kartal', 'gabrielyii99', 'aboone06', 'saegner2', 'manuelsomoza94', 'amani12345', 'youssefsherif22', 'j.haliburton', 'amr_ua07', 'evrenyigit', 'tingliang', 'kirankumar94', 'ahagras13', 'njgale01', 'al4995', 'smrdafdl', 'joshuas8', 'travisc2', 'dlee145', 'stambo', 'anthonyroux', 'ryanorem', 'moh.bahaa', 'ahchehyan', 'mw21', 'aimanadnan', 'veronica.mieites', 's_coriolis', 'trkmengkay', 'cbecker413', 'mcruces.fz', 'latecnologiameodia', 'gxiao2', 'emilechouinard', 'je_guilbert', 'yubai', 'sinasigurpinar', 'lauragdevesa', 'muvafikmelikkaya', 'kason.carroll', 'jbaggie2019', 'annahaozheng0606', 'jtorres17', 'ahmedayman2370', 'zikrizaki88995', 'yjenyiee155', '46harunakgul', 'alifzulkifli99', 'kaitlinh', 'tyy233', 'sdehoyos47', 'malgaca', 'lsleed', 'khazanv2', 'pwalke9', 'alexisdixon6', 'gc_1', 'jinsup2', 'rishu', 'amparo.castro.96', 'tbryan', 'martin32', 'michael.mechelay', 'akash140410107098', 'nowapoca', 'onaam8', 'pablosaavedra', 'ablee2', 'camilolcastro97', 'khor', 'ankit6257', 'samashraf1', 'benoiturcotte', 'aishu98', 'rileyroca', 'david.peral.moran', 'kiruthikaabalu181996', 'taymacnichols', 'rvplank2', 'dhodapp', 'nagihankececi', 'carlosvigo1997', 'moh.ashraf105', 'baleko12345', 'ikhbal', 'afeefz', 'wkeaty2', 'kaustubh.shirpurkar', 'kie180031', 'cbo3', 'bflores18', 'tdubnansky6', 'jorgecastelo5', 'andreadiazgar', 'david2397', 'bcperki2', 'melaniejkramer', 'rkchapman', 'wsuk2', 'jn1404', 'mateocampos', 'jzhan142', 'qiuhuic2', 'josepazmartin', 'brannon44', 'adfoz', 'ssutyak2', 'avw2', 'youxing0309', 'scremin', 'lderemo', 'perezsarmar', 'ashutoshsinghhenry6', 'naisong2', 'melroy_caeiro', 'viratbhatt007', 'fkl217', 'jtkach2', 'coderko3', 'alimatama', 'ammaralaa516', 'nadhnasorudin', 'adarsh123', 'jacquelinethardin', 'mjoza2', 'nihatyavuz', 'txyang2', 'estebanrial', 'jinwoo2', 'adnanyuceer', 'danielfernandezcalo', 'berkaydean', 'cloudyoverhead', 'fred_dion', 'syedzakwan', 'e1150590', 'fcfrancapra94', 'amiruldanial99', 'ozbunar01', 'alecorti.pardo', 'electronica18', 'nourananwar123', 'olivier.gilbert.paquet', 'anibarseghyan', 'amlibrahim', 'neuroque', 'kychui2', 'shaf31', 'hong_gao', 'paul.aniruddha', 'carlosbesadaromero', 'mohaballam', 'pip29', 'apb5472', 'tuberkargan', 'hafizmokh99', 'javierisma98', 'fathy1104', 'corredoira', 'helenalecoq97', 'kimzihuang', 'muteki', 'masitadonmez', 'nadja1', 'dancastaneda', 'ahmedsameh1698', 'mblaauw2', 'rocio', 'mallen22', 'ffazul64', 'guoyao', 'ari6nd', 'kerryreto', 'conanw2', 'pedrosiaba', 'michaelsaldana1', 'omarmagdy', 'vickytubio', 'ericrobles', 'soccadelic44', 'selena', 'aasifhameed99', 'damlakubattt', 'anxovidal8', 'exjamil', 'jahnavikachhia', 'joker632455', 'vincentpainchaud.vp', 'svo4321', 'iflueck2', 'zhixin2', 'kevinjl3', 'arhode2', 'yansi', 'asyrafaqil', 'xyz11', 'virajput299', 'ryanboucher', 'jpmcgee98', 'mariz', 'bhliu97', 'amrebrahim', 'jkubota2', 'anirula2', 'abdulrahim2905', 'c.a.stupka', 'domanus2', 'tonybocadillosgrandes', 'talwren', 'rxtodd', 'farah26', 'tss3', 'abieday1704', 'mavanzato0418', 'facundovia', 'cristinacigarran', 'edimare2', 'nazimmath3', 'baohl2', 'ales.gajdacz', 'elad.d', 'kie180028', 'wahidiah52', 'kyang37', 'arifjalani99', 'jgruber3', 'lino13', 'jaimefookinlannister', 'physquig', 'rhalton2', 'adriancheah', 'jarodm2', 'noureldin1999', 'michael2010814', 'ckim123', 'eddin21', 'jipiccardi', 'hjr2', 'anunez38', 'prabuddha_888253127', 'david_atef', 'kalebhilde', 'magic_ocean99', 'saipraneett', 'sanchjai', 'omardeyaa', 'pingan99', 'aaq', 'alidsjt', 'mengkem2', 'chguo2', 'haclarke', 'oishikfaruque', 'ilou', 'aengm', 'janalorenzolumbreras', 'hilisa', 'carlosvillar54', 'vikazvereva', 'm939454', 'va844', 'pablobou4', 'ludovick.begin', 'jjwilde2', 'maniphysics09', 'eduard25252598', 'apascao', 'shirani', 'xosegq16', 'danayun2', 'adam562', 'lauramolinosmayo', 'amni99', 'kie180702', 'pittges2', 'saharoaf', 'redzuan11', 'ypp200', 'kph2', 'martinzapata', 'kirolosehab99', 'jungeun5', 'restep2', 'seifhabib', 'maramtarek53', 'zehuahe2', 'azizijazam11', 'marcosanllo', 'aimansyaz99', 'elizametias12', 'juanmacano97', 'sparshagarwal1009', 'prakharbhargava0', 'njs035', 'alberfn', 'ramy_maged4', 'hmoulvi1', 'vanesagarcia', 'hf4', 'wowmuchchuck', 'mohammedemadeldin2000', 'gabrielyii', 'keerthisv', 'pythagoras2', 'xunyong', 'irenehb92', 'shradhap', 'omarma2', 'mohameeddsamy', 'marianne.gratton.1', 'marcmagdy98', 'brknshn', 'gemma', 'lukunze1', 'caglanlee', 'desmondsoon', 'sebasket14', 'masonpb2', 'youssef2042000', 'retty8', 'bharath3', 'syin4', 'ethanmorse', 'ematson5897', 'jacobzeshleman', 'leejq', 'harshini9962', 'reemali99_', 'xxlilmontysignxx', 'ramonruiz.infor', 'atharva98', 'ahern0722', 'hishamzakaria20', 'cheokonn', 'adriangarea', 'jeanmichael.deschenes', 'samet1231234', 'mr4425', 'bluelobster', 'justin.lariviere.25', 'dcpang2', 'gcangi2', 'felivitullo87', 'puertarcd', 'farahsamir978', 'chanmin2', 'akozych2', 'nbs691', 'kie180073', 'anwar909', 'bleuminuit', 'atx203', 'kanet1234', 'sealseal', 'emrebuyukkose2', 'arrow823', 'tsehgal2', 'dhvanil', 'nuanno97', 'dkshelat', 'mohabayman', 'ranasherif65', 'diamond92', 'ugur.cankaya.3718', 'ammareltalli', 'acn562', 'nabilah1403', 'lsienko2', 'yaseminablacandir', 'tamchouweng', 'ablahsaoud', 'sriharshap', 'mrefaat', 'bassamtarek', 'hamidausat', 'srb2', 'kakmeera1999', 'teoster50', 'nolmos96', 'abdurrahmn13', 'mmartinezsanchez', 'sandrabashara', 'zakhwan7', 'chengweiheng', 'nikalyaamani', 'tz11', 'vtagare2', 'acregodean', 'happyleexin', 'sarapl', 'williammitchell5818', None, 'rooban11', 'yeejou990318', 'kowjiajin', 'nihaosawaddee', 'maxernest', 'david.garrido', 'guibill10', 'mohamedsameh', 'spazos7', 'tmi211', 'kie180039', 'worldlineusaf', 'mgk816', 'kie180079', 'ledicia97', 'movi205', 'shuming2']"
1,18,391,46,42,"['miri23', 'alidsjt', 'loisonchambers', 'carlosbesadaromero', 'gemma', 'siemprewowthechami', 'vblanco.nico', 'janalorenzolumbreras', 'efrenhub', 'isabelmaria.vazquez', 'mateocampos', 'tonybocadillosgrandes', 'josepazmartin', 'adfoz', 'apascao', 'cristinacigarran', 'helenalecoq97', 'xosegq16', 'malgaca', 'mmartinezsanchez', 'pedrosiaba', 'adriangarea', 'martinzapata', 'alimatama', 'acregodean', 'amparo.castro.96', 'sarapl', 'vickytubio', 'camilolcastro97', 'maxernest', 'danielfernandezcalo', 'david.garrido', 'anxovidal8', 'puertarcd', 'alberfn', 'svo4321', 'alecorti.pardo', 'electronica18', 'veronica.mieites', 'vanesagarcia', 'ledicia97', 'movi205']",349,"['oliviercharbonneau', 'ozgurkablan26', 'tuberkargan_97', 'pranjal3', 'musabmalek0717', 'nadanasser1199', 'staceyn2', 'abbesalaeddine', 'ahmedamr', 'shorouk_ossama', 'rikardberger', 'alancantu57', 'luciano.brignone', 'rahimnoorj', 'janeneil88', 'guttsfulltyagi', 'mjgebara14', 'kartal', 'gabrielyii99', 'aboone06', 'saegner2', 'manuelsomoza94', 'amani12345', 'youssefsherif22', 'j.haliburton', 'amr_ua07', 'evrenyigit', 'tingliang', 'kirankumar94', 'ahagras13', 'njgale01', 'al4995', 'smrdafdl', 'travisc2', 'dlee145', 'stambo', 'anthonyroux', 'ryanorem', 'moh.bahaa', 'ahchehyan', 'aimanadnan', 's_coriolis', 'trkmengkay', 'cbecker413', 'mcruces.fz', 'latecnologiameodia', 'gxiao2', 'emilechouinard', 'je_guilbert', 'yubai', 'sinasigurpinar', 'lauragdevesa', 'muvafikmelikkaya', 'kason.carroll', 'jbaggie2019', 'annahaozheng0606', 'jtorres17', 'ahmedayman2370', 'zikrizaki88995', 'yjenyiee155', '46harunakgul', 'alifzulkifli99', 'kaitlinh', 'tyy233', 'sdehoyos47', 'lsleed', 'khazanv2', 'alexisdixon6', 'gc_1', 'jinsup2', 'rishu', 'tbryan', 'martin32', 'michael.mechelay', 'akash140410107098', 'nowapoca', 'onaam8', 'pablosaavedra', 'khor', 'ankit6257', 'samashraf1', 'benoiturcotte', 'aishu98', 'rileyroca', 'david.peral.moran', 'kiruthikaabalu181996', 'taymacnichols', 'dhodapp', 'nagihankececi', 'carlosvigo1997', 'moh.ashraf105', 'baleko12345', 'ikhbal', 'afeefz', 'kaustubh.shirpurkar', 'kie180031', 'bflores18', 'tdubnansky6', 'jorgecastelo5', 'andreadiazgar', 'david2397', 'bcperki2', 'melaniejkramer', 'rkchapman', 'jn1404', 'jzhan142', 'brannon44', 'avw2', 'youxing0309', 'scremin', 'lderemo', 'perezsarmar', 'ashutoshsinghhenry6', 'melroy_caeiro', 'viratbhatt007', 'fkl217', 'coderko3', 'ammaralaa516', 'nadhnasorudin', 'adarsh123', 'jacquelinethardin', 'mjoza2', 'nihatyavuz', 'estebanrial', 'jinwoo2', 'adnanyuceer', 'berkaydean', 'cloudyoverhead', 'fred_dion', 'syedzakwan', 'e1150590', 'fcfrancapra94', 'amiruldanial99', 'ozbunar01', 'nourananwar123', 'olivier.gilbert.paquet', 'anibarseghyan', 'amlibrahim', 'neuroque', 'kychui2', 'shaf31', 'hong_gao', 'paul.aniruddha', 'mohaballam', 'pip29', 'apb5472', 'tuberkargan', 'hafizmokh99', 'javierisma98', 'fathy1104', 'corredoira', 'kimzihuang', 'muteki', 'masitadonmez', 'nadja1', 'dancastaneda', 'ahmedsameh1698', 'rocio', 'mallen22', 'ffazul64', 'guoyao', 'ari6nd', 'kerryreto', 'michaelsaldana1', 'omarmagdy', 'ericrobles', 'soccadelic44', 'selena', 'aasifhameed99', 'damlakubattt', 'exjamil', 'jahnavikachhia', 'joker632455', 'vincentpainchaud.vp', 'zhixin2', 'yansi', 'asyrafaqil', 'xyz11', 'virajput299', 'ryanboucher', 'jpmcgee98', 'mariz', 'bhliu97', 'amrebrahim', 'abdulrahim2905', 'c.a.stupka', 'talwren', 'rxtodd', 'farah26', 'tss3', 'abieday1704', 'mavanzato0418', 'facundovia', 'nazimmath3', 'baohl2', 'ales.gajdacz', 'elad.d', 'kie180028', 'wahidiah52', 'kyang37', 'arifjalani99', 'lino13', 'jaimefookinlannister', 'physquig', 'adriancheah', 'jarodm2', 'noureldin1999', 'michael2010814', 'ckim123', 'eddin21', 'jipiccardi', 'prabuddha_888253127', 'david_atef', 'kalebhilde', 'magic_ocean99', 'saipraneett', 'sanchjai', 'omardeyaa', 'pingan99', 'aaq', 'mengkem2', 'haclarke', 'oishikfaruque', 'ilou', 'aengm', 'hilisa', 'carlosvillar54', 'vikazvereva', 'm939454', 'va844', 'pablobou4', 'ludovick.begin', 'maniphysics09', 'eduard25252598', 'adam562', 'lauramolinosmayo', 'amni99', 'kie180702', 'saharoaf', 'redzuan11', 'ypp200', 'kph2', 'kirolosehab99', 'restep2', 'seifhabib', 'maramtarek53', 'zehuahe2', 'azizijazam11', 'marcosanllo', 'aimansyaz99', 'elizametias12', 'juanmacano97', 'sparshagarwal1009', 'prakharbhargava0', 'njs035', 'ramy_maged4', 'hmoulvi1', 'hf4', 'wowmuchchuck', 'mohammedemadeldin2000', 'gabrielyii', 'keerthisv', 'pythagoras2', 'xunyong', 'irenehb92', 'shradhap', 'mohameeddsamy', 'marianne.gratton.1', 'marcmagdy98', 'brknshn', 'lukunze1', 'caglanlee', 'desmondsoon', 'sebasket14', 'masonpb2', 'youssef2042000', 'retty8', 'bharath3', 'syin4', 'ethanmorse', 'ematson5897', 'jacobzeshleman', 'leejq', 'harshini9962', 'reemali99_', 'xxlilmontysignxx', 'ramonruiz.infor', 'atharva98', 'ahern0722', 'hishamzakaria20', 'cheokonn', 'jeanmichael.deschenes', 'samet1231234', 'mr4425', 'bluelobster', 'justin.lariviere.25', 'dcpang2', 'felivitullo87', 'farahsamir978', 'akozych2', 'nbs691', 'kie180073', 'anwar909', 'bleuminuit', 'atx203', 'kanet1234', 'sealseal', 'emrebuyukkose2', 'arrow823', 'dhvanil', 'nuanno97', 'dkshelat', 'mohabayman', 'ranasherif65', 'diamond92', 'ugur.cankaya.3718', 'ammareltalli', 'acn562', 'nabilah1403', 'yaseminablacandir', 'tamchouweng', 'ablahsaoud', 'sriharshap', 'mrefaat', 'bassamtarek', 'hamidausat', 'kakmeera1999', 'teoster50', 'nolmos96', 'abdurrahmn13', 'sandrabashara', 'zakhwan7', 'chengweiheng', 'nikalyaamani', 'happyleexin', 'williammitchell5818', 'rooban11', 'yeejou990318', 'kowjiajin', 'nihaosawaddee', 'guibill10', 'mohamedsameh', 'spazos7', 'tmi211', 'kie180039', 'worldlineusaf', 'mgk816', 'kie180079', 'shuming2']",4,"['hermidaitor', 'iago', None, 'dfl']",395,"['oliviercharbonneau', 'miri23', 'ozgurkablan26', 'loisonchambers', 'tuberkargan_97', 'pranjal3', 'musabmalek0717', 'nadanasser1199', 'siemprewowthechami', 'staceyn2', 'vblanco.nico', 'abbesalaeddine', 'efrenhub', 'isabelmaria.vazquez', 'ahmedamr', 'shorouk_ossama', 'rikardberger', 'alancantu57', 'luciano.brignone', 'rahimnoorj', 'janeneil88', 'guttsfulltyagi', 'mjgebara14', 'kartal', 'gabrielyii99', 'aboone06', 'saegner2', 'manuelsomoza94', 'amani12345', 'youssefsherif22', 'j.haliburton', 'amr_ua07', 'evrenyigit', 'tingliang', 'kirankumar94', 'ahagras13', 'njgale01', 'al4995', 'smrdafdl', 'travisc2', 'dlee145', 'stambo', 'anthonyroux', 'ryanorem', 'moh.bahaa', 'ahchehyan', 'aimanadnan', 'veronica.mieites', 's_coriolis', 'trkmengkay', 'cbecker413', 'mcruces.fz', 'latecnologiameodia', 'gxiao2', 'emilechouinard', 'je_guilbert', 'yubai', 'sinasigurpinar', 'lauragdevesa', 'muvafikmelikkaya', 'kason.carroll', 'jbaggie2019', 'annahaozheng0606', 'jtorres17', 'ahmedayman2370', 'zikrizaki88995', 'yjenyiee155', '46harunakgul', 'alifzulkifli99', 'kaitlinh', 'tyy233', 'sdehoyos47', 'malgaca', 'lsleed', 'khazanv2', 'alexisdixon6', 'gc_1', 'jinsup2', 'rishu', 'amparo.castro.96', 'tbryan', 'martin32', 'michael.mechelay', 'akash140410107098', 'nowapoca', 'onaam8', 'pablosaavedra', 'camilolcastro97', 'khor', 'ankit6257', 'samashraf1', 'benoiturcotte', 'aishu98', 'rileyroca', 'david.peral.moran', 'kiruthikaabalu181996', 'taymacnichols', 'dhodapp', 'hermidaitor', 'nagihankececi', 'carlosvigo1997', 'moh.ashraf105', 'baleko12345', 'ikhbal', 'afeefz', 'kaustubh.shirpurkar', 'kie180031', 'bflores18', 'tdubnansky6', 'jorgecastelo5', 'andreadiazgar', 'david2397', 'bcperki2', 'melaniejkramer', 'rkchapman', 'jn1404', 'mateocampos', 'jzhan142', 'josepazmartin', 'brannon44', 'adfoz', 'avw2', 'youxing0309', 'scremin', 'lderemo', 'perezsarmar', 'ashutoshsinghhenry6', 'melroy_caeiro', 'viratbhatt007', 'fkl217', 'coderko3', 'alimatama', 'ammaralaa516', 'nadhnasorudin', 'adarsh123', 'jacquelinethardin', 'mjoza2', 'nihatyavuz', 'estebanrial', 'jinwoo2', 'adnanyuceer', 'danielfernandezcalo', 'berkaydean', 'cloudyoverhead', 'fred_dion', 'syedzakwan', 'e1150590', 'fcfrancapra94', 'amiruldanial99', 'ozbunar01', 'alecorti.pardo', 'electronica18', 'nourananwar123', 'olivier.gilbert.paquet', 'anibarseghyan', 'amlibrahim', 'neuroque', 'kychui2', 'shaf31', 'hong_gao', 'paul.aniruddha', 'carlosbesadaromero', 'mohaballam', 'pip29', 'apb5472', 'tuberkargan', 'hafizmokh99', 'javierisma98', 'fathy1104', 'corredoira', 'helenalecoq97', 'kimzihuang', 'muteki', 'iago', 'masitadonmez', 'nadja1', 'dancastaneda', 'ahmedsameh1698', 'rocio', 'mallen22', 'ffazul64', 'guoyao', 'ari6nd', 'kerryreto', 'pedrosiaba', 'michaelsaldana1', 'omarmagdy', 'vickytubio', 'ericrobles', 'soccadelic44', 'selena', 'aasifhameed99', 'damlakubattt', 'anxovidal8', 'exjamil', 'jahnavikachhia', 'joker632455', 'vincentpainchaud.vp', 'svo4321', 'zhixin2', 'yansi', 'asyrafaqil', 'xyz11', 'virajput299', 'ryanboucher', 'jpmcgee98', 'mariz', 'bhliu97', 'amrebrahim', 'abdulrahim2905', 'c.a.stupka', 'tonybocadillosgrandes', 'talwren', 'rxtodd', 'farah26', 'tss3', 'abieday1704', 'mavanzato0418', 'facundovia', 'cristinacigarran', 'nazimmath3', 'baohl2', 'ales.gajdacz', 'elad.d', 'kie180028', 'wahidiah52', 'kyang37', 'arifjalani99', 'lino13', 'jaimefookinlannister', 'physquig', 'adriancheah', 'jarodm2', 'noureldin1999', 'michael2010814', 'ckim123', 'eddin21', 'jipiccardi', 'prabuddha_888253127', 'david_atef', 'kalebhilde', 'magic_ocean99', 'saipraneett', 'sanchjai', 'omardeyaa', 'pingan99', 'aaq', 'alidsjt', 'mengkem2', 'haclarke', 'oishikfaruque', 'ilou', 'aengm', 'janalorenzolumbreras', 'hilisa', 'carlosvillar54', 'vikazvereva', 'm939454', 'va844', 'pablobou4', 'ludovick.begin', 'maniphysics09', 'eduard25252598', 'apascao', 'xosegq16', 'adam562', 'lauramolinosmayo', 'amni99', 'kie180702', 'saharoaf', 'redzuan11', 'ypp200', 'kph2', 'martinzapata', 'kirolosehab99', 'restep2', 'seifhabib', 'maramtarek53', 'zehuahe2', 'azizijazam11', 'marcosanllo', 'aimansyaz99', 'elizametias12', 'juanmacano97', 'sparshagarwal1009', 'prakharbhargava0', 'njs035', 'alberfn', 'ramy_maged4', 'hmoulvi1', 'vanesagarcia', 'hf4', 'wowmuchchuck', 'mohammedemadeldin2000', 'gabrielyii', 'keerthisv', 'pythagoras2', 'xunyong', 'irenehb92', 'shradhap', 'mohameeddsamy', 'marianne.gratton.1', 'marcmagdy98', 'brknshn', 'gemma', 'lukunze1', 'caglanlee', 'desmondsoon', 'sebasket14', 'masonpb2', 'youssef2042000', 'retty8', 'bharath3', 'syin4', 'ethanmorse', 'ematson5897', 'jacobzeshleman', 'leejq', 'harshini9962', 'reemali99_', 'xxlilmontysignxx', 'ramonruiz.infor', 'atharva98', 'ahern0722', 'hishamzakaria20', 'cheokonn', 'adriangarea', 'jeanmichael.deschenes', 'samet1231234', 'mr4425', 'bluelobster', 'justin.lariviere.25', 'dcpang2', 'felivitullo87', 'puertarcd', 'farahsamir978', 'akozych2', 'nbs691', 'kie180073', 'anwar909', 'bleuminuit', 'atx203', 'kanet1234', 'sealseal', 'emrebuyukkose2', 'arrow823', 'dhvanil', 'nuanno97', 'dkshelat', 'mohabayman', 'ranasherif65', 'diamond92', 'ugur.cankaya.3718', 'ammareltalli', 'acn562', 'nabilah1403', 'yaseminablacandir', 'tamchouweng', 'ablahsaoud', 'sriharshap', 'mrefaat', 'bassamtarek', 'hamidausat', 'kakmeera1999', 'teoster50', 'nolmos96', 'abdurrahmn13', 'mmartinezsanchez', 'sandrabashara', 'zakhwan7', 'chengweiheng', 'nikalyaamani', 'acregodean', 'happyleexin', 'sarapl', 'williammitchell5818', None, 'rooban11', 'yeejou990318', 'kowjiajin', 'nihaosawaddee', 'maxernest', 'dfl', 'david.garrido', 'guibill10', 'mohamedsameh', 'spazos7', 'tmi211', 'kie180039', 'worldlineusaf', 'mgk816', 'kie180079', 'ledicia97', 'movi205', 'shuming2']"
1,40,391,43,41,"['omardeyaa', 'mohameeddsamy', 'marcmagdy98', 'mariz', 'amrebrahim', 'nadanasser1199', 'mohabayman', 'ranasherif65', 'ammareltalli', 'mohaballam', 'ahmedamr', 'shorouk_ossama', 'ahmedayman2370', 'youssef2042000', 'farah26', 'fathy1104', 'mrefaat', 'bassamtarek', 'muteki', 'reemali99_', 'ahmedsameh1698', 'hishamzakaria20', 'sandrabashara', 'youssefsherif22', 'amr_ua07', 'kirolosehab99', 'seifhabib', 'ammaralaa516', 'maramtarek53', 'omarmagdy', 'elizametias12', 'noureldin1999', 'mohamedsameh', 'farahsamir978', 'moh.bahaa', 'david_atef', 'ramy_maged4', 'mohammedemadeldin2000', 'nourananwar123', 'moh.ashraf105', 'amlibrahim']",350,"['oliviercharbonneau', 'miri23', 'ozgurkablan26', 'loisonchambers', 'tuberkargan_97', 'pranjal3', 'musabmalek0717', 'siemprewowthechami', 'staceyn2', 'vblanco.nico', 'abbesalaeddine', 'efrenhub', 'isabelmaria.vazquez', 'rikardberger', 'alancantu57', 'luciano.brignone', 'rahimnoorj', 'janeneil88', 'guttsfulltyagi', 'mjgebara14', 'kartal', 'gabrielyii99', 'aboone06', 'saegner2', 'manuelsomoza94', 'amani12345', 'j.haliburton', 'evrenyigit', 'tingliang', 'kirankumar94', 'ahagras13', 'njgale01', 'al4995', 'smrdafdl', 'travisc2', 'dlee145', 'stambo', 'anthonyroux', 'ryanorem', 'ahchehyan', 'aimanadnan', 'veronica.mieites', 's_coriolis', 'trkmengkay', 'cbecker413', 'mcruces.fz', 'latecnologiameodia', 'gxiao2', 'emilechouinard', 'je_guilbert', 'yubai', 'sinasigurpinar', 'lauragdevesa', 'muvafikmelikkaya', 'kason.carroll', 'jbaggie2019', 'annahaozheng0606', 'jtorres17', 'zikrizaki88995', 'yjenyiee155', '46harunakgul', 'alifzulkifli99', 'kaitlinh', 'tyy233', 'sdehoyos47', 'malgaca', 'lsleed', 'khazanv2', 'alexisdixon6', 'gc_1', 'jinsup2', 'rishu', 'amparo.castro.96', 'tbryan', 'martin32', 'michael.mechelay', 'akash140410107098', 'nowapoca', 'onaam8', 'pablosaavedra', 'camilolcastro97', 'khor', 'ankit6257', 'samashraf1', 'benoiturcotte', 'aishu98', 'rileyroca', 'david.peral.moran', 'kiruthikaabalu181996', 'taymacnichols', 'dhodapp', 'nagihankececi', 'carlosvigo1997', 'baleko12345', 'ikhbal', 'afeefz', 'kaustubh.shirpurkar', 'kie180031', 'bflores18', 'tdubnansky6', 'jorgecastelo5', 'andreadiazgar', 'david2397', 'bcperki2', 'melaniejkramer', 'rkchapman', 'jn1404', 'mateocampos', 'jzhan142', 'josepazmartin', 'brannon44', 'adfoz', 'avw2', 'youxing0309', 'scremin', 'lderemo', 'perezsarmar', 'ashutoshsinghhenry6', 'melroy_caeiro', 'viratbhatt007', 'fkl217', 'coderko3', 'alimatama', 'nadhnasorudin', 'adarsh123', 'jacquelinethardin', 'mjoza2', 'nihatyavuz', 'estebanrial', 'jinwoo2', 'adnanyuceer', 'danielfernandezcalo', 'berkaydean', 'cloudyoverhead', 'fred_dion', 'syedzakwan', 'e1150590', 'fcfrancapra94', 'amiruldanial99', 'ozbunar01', 'alecorti.pardo', 'electronica18', 'olivier.gilbert.paquet', 'anibarseghyan', 'neuroque', 'kychui2', 'shaf31', 'hong_gao', 'paul.aniruddha', 'carlosbesadaromero', 'pip29', 'apb5472', 'tuberkargan', 'hafizmokh99', 'javierisma98', 'corredoira', 'helenalecoq97', 'kimzihuang', 'masitadonmez', 'nadja1', 'dancastaneda', 'rocio', 'mallen22', 'ffazul64', 'guoyao', 'ari6nd', 'kerryreto', 'pedrosiaba', 'michaelsaldana1', 'vickytubio', 'ericrobles', 'soccadelic44', 'selena', 'aasifhameed99', 'damlakubattt', 'anxovidal8', 'exjamil', 'jahnavikachhia', 'joker632455', 'vincentpainchaud.vp', 'svo4321', 'zhixin2', 'yansi', 'asyrafaqil', 'xyz11', 'virajput299', 'ryanboucher', 'jpmcgee98', 'bhliu97', 'abdulrahim2905', 'c.a.stupka', 'tonybocadillosgrandes', 'talwren', 'rxtodd', 'tss3', 'abieday1704', 'mavanzato0418', 'facundovia', 'cristinacigarran', 'nazimmath3', 'baohl2', 'ales.gajdacz', 'elad.d', 'kie180028', 'wahidiah52', 'kyang37', 'arifjalani99', 'lino13', 'jaimefookinlannister', 'physquig', 'adriancheah', 'jarodm2', 'michael2010814', 'ckim123', 'eddin21', 'jipiccardi', 'prabuddha_888253127', 'kalebhilde', 'magic_ocean99', 'saipraneett', 'sanchjai', 'pingan99', 'aaq', 'alidsjt', 'mengkem2', 'haclarke', 'oishikfaruque', 'ilou', 'aengm', 'janalorenzolumbreras', 'hilisa', 'carlosvillar54', 'vikazvereva', 'm939454', 'va844', 'pablobou4', 'ludovick.begin', 'maniphysics09', 'eduard25252598', 'apascao', 'xosegq16', 'adam562', 'lauramolinosmayo', 'amni99', 'kie180702', 'saharoaf', 'redzuan11', 'ypp200', 'kph2', 'martinzapata', 'restep2', 'zehuahe2', 'azizijazam11', 'marcosanllo', 'aimansyaz99', 'juanmacano97', 'sparshagarwal1009', 'prakharbhargava0', 'njs035', 'alberfn', 'hmoulvi1', 'vanesagarcia', 'hf4', 'wowmuchchuck', 'gabrielyii', 'keerthisv', 'pythagoras2', 'xunyong', 'irenehb92', 'shradhap', 'marianne.gratton.1', 'brknshn', 'gemma', 'lukunze1', 'caglanlee', 'desmondsoon', 'sebasket14', 'masonpb2', 'retty8', 'bharath3', 'syin4', 'ethanmorse', 'ematson5897', 'jacobzeshleman', 'leejq', 'harshini9962', 'xxlilmontysignxx', 'ramonruiz.infor', 'atharva98', 'ahern0722', 'cheokonn', 'adriangarea', 'jeanmichael.deschenes', 'samet1231234', 'mr4425', 'bluelobster', 'justin.lariviere.25', 'dcpang2', 'felivitullo87', 'puertarcd', 'akozych2', 'nbs691', 'kie180073', 'anwar909', 'bleuminuit', 'atx203', 'kanet1234', 'sealseal', 'emrebuyukkose2', 'arrow823', 'dhvanil', 'nuanno97', 'dkshelat', 'diamond92', 'ugur.cankaya.3718', 'acn562', 'nabilah1403', 'yaseminablacandir', 'tamchouweng', 'ablahsaoud', 'sriharshap', 'hamidausat', 'kakmeera1999', 'teoster50', 'nolmos96', 'abdurrahmn13', 'mmartinezsanchez', 'zakhwan7', 'chengweiheng', 'nikalyaamani', 'acregodean', 'happyleexin', 'sarapl', 'williammitchell5818', 'rooban11', 'yeejou990318', 'kowjiajin', 'nihaosawaddee', 'maxernest', 'david.garrido', 'guibill10', 'spazos7', 'tmi211', 'kie180039', 'worldlineusaf', 'mgk816', 'kie180079', 'ledicia97', 'movi205', 'shuming2']",2,"[None, 'omarmoatasem']",393,"['oliviercharbonneau', 'miri23', 'ozgurkablan26', 'loisonchambers', 'tuberkargan_97', 'pranjal3', 'musabmalek0717', 'nadanasser1199', 'siemprewowthechami', 'staceyn2', 'vblanco.nico', 'abbesalaeddine', 'efrenhub', 'isabelmaria.vazquez', 'ahmedamr', 'shorouk_ossama', 'rikardberger', 'alancantu57', 'luciano.brignone', 'rahimnoorj', 'janeneil88', 'guttsfulltyagi', 'mjgebara14', 'kartal', 'gabrielyii99', 'aboone06', 'saegner2', 'manuelsomoza94', 'amani12345', 'youssefsherif22', 'j.haliburton', 'amr_ua07', 'evrenyigit', 'tingliang', 'kirankumar94', 'ahagras13', 'njgale01', 'al4995', 'smrdafdl', 'travisc2', 'dlee145', 'stambo', 'anthonyroux', 'ryanorem', 'moh.bahaa', 'ahchehyan', 'aimanadnan', 'veronica.mieites', 's_coriolis', 'trkmengkay', 'cbecker413', 'mcruces.fz', 'latecnologiameodia', 'gxiao2', 'emilechouinard', 'je_guilbert', 'yubai', 'sinasigurpinar', 'lauragdevesa', 'muvafikmelikkaya', 'kason.carroll', 'jbaggie2019', 'annahaozheng0606', 'jtorres17', 'ahmedayman2370', 'zikrizaki88995', 'yjenyiee155', '46harunakgul', 'alifzulkifli99', 'kaitlinh', 'tyy233', 'sdehoyos47', 'malgaca', 'lsleed', 'khazanv2', 'alexisdixon6', 'gc_1', 'jinsup2', 'rishu', 'amparo.castro.96', 'tbryan', 'martin32', 'michael.mechelay', 'akash140410107098', 'nowapoca', 'onaam8', 'pablosaavedra', 'camilolcastro97', 'khor', 'ankit6257', 'samashraf1', 'benoiturcotte', 'aishu98', 'rileyroca', 'david.peral.moran', 'kiruthikaabalu181996', 'taymacnichols', 'dhodapp', 'nagihankececi', 'carlosvigo1997', 'moh.ashraf105', 'baleko12345', 'ikhbal', 'afeefz', 'kaustubh.shirpurkar', 'kie180031', 'bflores18', 'tdubnansky6', 'jorgecastelo5', 'andreadiazgar', 'david2397', 'bcperki2', 'melaniejkramer', 'rkchapman', 'jn1404', 'mateocampos', 'jzhan142', 'josepazmartin', 'brannon44', 'adfoz', 'avw2', 'youxing0309', 'scremin', 'lderemo', 'perezsarmar', 'ashutoshsinghhenry6', 'melroy_caeiro', 'viratbhatt007', 'fkl217', 'coderko3', 'alimatama', 'ammaralaa516', 'nadhnasorudin', 'adarsh123', 'jacquelinethardin', 'mjoza2', 'nihatyavuz', 'estebanrial', 'jinwoo2', 'adnanyuceer', 'danielfernandezcalo', 'berkaydean', 'cloudyoverhead', 'fred_dion', 'syedzakwan', 'e1150590', 'fcfrancapra94', 'amiruldanial99', 'ozbunar01', 'alecorti.pardo', 'electronica18', 'nourananwar123', 'olivier.gilbert.paquet', 'anibarseghyan', 'amlibrahim', 'neuroque', 'kychui2', 'shaf31', 'hong_gao', 'paul.aniruddha', 'carlosbesadaromero', 'mohaballam', 'pip29', 'apb5472', 'tuberkargan', 'hafizmokh99', 'javierisma98', 'fathy1104', 'corredoira', 'helenalecoq97', 'kimzihuang', 'muteki', 'masitadonmez', 'nadja1', 'dancastaneda', 'ahmedsameh1698', 'rocio', 'mallen22', 'ffazul64', 'guoyao', 'ari6nd', 'kerryreto', 'pedrosiaba', 'michaelsaldana1', 'omarmagdy', 'vickytubio', 'ericrobles', 'soccadelic44', 'selena', 'aasifhameed99', 'damlakubattt', 'anxovidal8', 'exjamil', 'jahnavikachhia', 'joker632455', 'vincentpainchaud.vp', 'svo4321', 'zhixin2', 'yansi', 'asyrafaqil', 'xyz11', 'virajput299', 'ryanboucher', 'jpmcgee98', 'mariz', 'bhliu97', 'amrebrahim', 'abdulrahim2905', 'c.a.stupka', 'tonybocadillosgrandes', 'talwren', 'rxtodd', 'farah26', 'tss3', 'abieday1704', 'mavanzato0418', 'facundovia', 'cristinacigarran', 'nazimmath3', 'baohl2', 'ales.gajdacz', 'elad.d', 'kie180028', 'wahidiah52', 'kyang37', 'arifjalani99', 'lino13', 'jaimefookinlannister', 'physquig', 'adriancheah', 'jarodm2', 'noureldin1999', 'michael2010814', 'ckim123', 'eddin21', 'jipiccardi', 'prabuddha_888253127', 'david_atef', 'kalebhilde', 'magic_ocean99', 'saipraneett', 'sanchjai', 'omardeyaa', 'pingan99', 'aaq', 'alidsjt', 'omarmoatasem', 'mengkem2', 'haclarke', 'oishikfaruque', 'ilou', 'aengm', 'janalorenzolumbreras', 'hilisa', 'carlosvillar54', 'vikazvereva', 'm939454', 'va844', 'pablobou4', 'ludovick.begin', 'maniphysics09', 'eduard25252598', 'apascao', 'xosegq16', 'adam562', 'lauramolinosmayo', 'amni99', 'kie180702', 'saharoaf', 'redzuan11', 'ypp200', 'kph2', 'martinzapata', 'kirolosehab99', 'restep2', 'seifhabib', 'maramtarek53', 'zehuahe2', 'azizijazam11', 'marcosanllo', 'aimansyaz99', 'elizametias12', 'juanmacano97', 'sparshagarwal1009', 'prakharbhargava0', 'njs035', 'alberfn', 'ramy_maged4', 'hmoulvi1', 'vanesagarcia', 'hf4', 'wowmuchchuck', 'mohammedemadeldin2000', 'gabrielyii', 'keerthisv', 'pythagoras2', 'xunyong', 'irenehb92', 'shradhap', 'mohameeddsamy', 'marianne.gratton.1', 'marcmagdy98', 'brknshn', 'gemma', 'lukunze1', 'caglanlee', 'desmondsoon', 'sebasket14', 'masonpb2', 'youssef2042000', 'retty8', 'bharath3', 'syin4', 'ethanmorse', 'ematson5897', 'jacobzeshleman', 'leejq', 'harshini9962', 'reemali99_', 'xxlilmontysignxx', 'ramonruiz.infor', 'atharva98', 'ahern0722', 'hishamzakaria20', 'cheokonn', 'adriangarea', 'jeanmichael.deschenes', 'samet1231234', 'mr4425', 'bluelobster', 'justin.lariviere.25', 'dcpang2', 'felivitullo87', 'puertarcd', 'farahsamir978', 'akozych2', 'nbs691', 'kie180073', 'anwar909', 'bleuminuit', 'atx203', 'kanet1234', 'sealseal', 'emrebuyukkose2', 'arrow823', 'dhvanil', 'nuanno97', 'dkshelat', 'mohabayman', 'ranasherif65', 'diamond92', 'ugur.cankaya.3718', 'ammareltalli', 'acn562', 'nabilah1403', 'yaseminablacandir', 'tamchouweng', 'ablahsaoud', 'sriharshap', 'mrefaat', 'bassamtarek', 'hamidausat', 'kakmeera1999', 'teoster50', 'nolmos96', 'abdurrahmn13', 'mmartinezsanchez', 'sandrabashara', 'zakhwan7', 'chengweiheng', 'nikalyaamani', 'acregodean', 'happyleexin', 'sarapl', 'williammitchell5818', None, 'rooban11', 'yeejou990318', 'kowjiajin', 'nihaosawaddee', 'maxernest', 'david.garrido', 'guibill10', 'mohamedsameh', 'spazos7', 'tmi211', 'kie180039', 'worldlineusaf', 'mgk816', 'kie180079', 'ledicia97', 'movi205', 'shuming2']"
1,35,391,38,33,"['miri23', 'loisonchambers', 'carlosbesadaromero', 'gemma', 'siemprewowthechami', 'jorgecastelo5', 'david2397', 'vblanco.nico', 'janalorenzolumbreras', 'andreadiazgar', 'isabelmaria.vazquez', 'josepazmartin', 'adfoz', 'apascao', 'cristinacigarran', 'corredoira', 'helenalecoq97', 'malgaca', 'pedrosiaba', 'manuelsomoza94', 'martinzapata', 'acregodean', 'martin32', 'lino13', 'sarapl', 'danielfernandezcalo', 'david.garrido', 'alberfn', 'svo4321', 'alecorti.pardo', 'veronica.mieites', 'vanesagarcia', 'ledicia97']",358,"['oliviercharbonneau', 'ozgurkablan26', 'tuberkargan_97', 'pranjal3', 'musabmalek0717', 'nadanasser1199', 'staceyn2', 'abbesalaeddine', 'efrenhub', 'ahmedamr', 'shorouk_ossama', 'rikardberger', 'alancantu57', 'luciano.brignone', 'rahimnoorj', 'janeneil88', 'guttsfulltyagi', 'mjgebara14', 'kartal', 'gabrielyii99', 'aboone06', 'saegner2', 'amani12345', 'youssefsherif22', 'j.haliburton', 'amr_ua07', 'evrenyigit', 'tingliang', 'kirankumar94', 'ahagras13', 'njgale01', 'al4995', 'smrdafdl', 'travisc2', 'dlee145', 'stambo', 'anthonyroux', 'ryanorem', 'moh.bahaa', 'ahchehyan', 'aimanadnan', 's_coriolis', 'trkmengkay', 'cbecker413', 'mcruces.fz', 'latecnologiameodia', 'gxiao2', 'emilechouinard', 'je_guilbert', 'yubai', 'sinasigurpinar', 'lauragdevesa', 'muvafikmelikkaya', 'kason.carroll', 'jbaggie2019', 'annahaozheng0606', 'jtorres17', 'ahmedayman2370', 'zikrizaki88995', 'yjenyiee155', '46harunakgul', 'alifzulkifli99', 'kaitlinh', 'tyy233', 'sdehoyos47', 'lsleed', 'khazanv2', 'alexisdixon6', 'gc_1', 'jinsup2', 'rishu', 'amparo.castro.96', 'tbryan', 'michael.mechelay', 'akash140410107098', 'nowapoca', 'onaam8', 'pablosaavedra', 'camilolcastro97', 'khor', 'ankit6257', 'samashraf1', 'benoiturcotte', 'aishu98', 'rileyroca', 'david.peral.moran', 'kiruthikaabalu181996', 'taymacnichols', 'dhodapp', 'nagihankececi', 'carlosvigo1997', 'moh.ashraf105', 'baleko12345', 'ikhbal', 'afeefz', 'kaustubh.shirpurkar', 'kie180031', 'bflores18', 'tdubnansky6', 'bcperki2', 'melaniejkramer', 'rkchapman', 'jn1404', 'mateocampos', 'jzhan142', 'brannon44', 'avw2', 'youxing0309', 'scremin', 'lderemo', 'perezsarmar', 'ashutoshsinghhenry6', 'melroy_caeiro', 'viratbhatt007', 'fkl217', 'coderko3', 'alimatama', 'ammaralaa516', 'nadhnasorudin', 'adarsh123', 'jacquelinethardin', 'mjoza2', 'nihatyavuz', 'estebanrial', 'jinwoo2', 'adnanyuceer', 'berkaydean', 'cloudyoverhead', 'fred_dion', 'syedzakwan', 'e1150590', 'fcfrancapra94', 'amiruldanial99', 'ozbunar01', 'electronica18', 'nourananwar123', 'olivier.gilbert.paquet', 'anibarseghyan', 'amlibrahim', 'neuroque', 'kychui2', 'shaf31', 'hong_gao', 'paul.aniruddha', 'mohaballam', 'pip29', 'apb5472', 'tuberkargan', 'hafizmokh99', 'javierisma98', 'fathy1104', 'kimzihuang', 'muteki', 'masitadonmez', 'nadja1', 'dancastaneda', 'ahmedsameh1698', 'rocio', 'mallen22', 'ffazul64', 'guoyao', 'ari6nd', 'kerryreto', 'michaelsaldana1', 'omarmagdy', 'vickytubio', 'ericrobles', 'soccadelic44', 'selena', 'aasifhameed99', 'damlakubattt', 'anxovidal8', 'exjamil', 'jahnavikachhia', 'joker632455', 'vincentpainchaud.vp', 'zhixin2', 'yansi', 'asyrafaqil', 'xyz11', 'virajput299', 'ryanboucher', 'jpmcgee98', 'mariz', 'bhliu97', 'amrebrahim', 'abdulrahim2905', 'c.a.stupka', 'tonybocadillosgrandes', 'talwren', 'rxtodd', 'farah26', 'tss3', 'abieday1704', 'mavanzato0418', 'facundovia', 'nazimmath3', 'baohl2', 'ales.gajdacz', 'elad.d', 'kie180028', 'wahidiah52', 'kyang37', 'arifjalani99', 'jaimefookinlannister', 'physquig', 'adriancheah', 'jarodm2', 'noureldin1999', 'michael2010814', 'ckim123', 'eddin21', 'jipiccardi', 'prabuddha_888253127', 'david_atef', 'kalebhilde', 'magic_ocean99', 'saipraneett', 'sanchjai', 'omardeyaa', 'pingan99', 'aaq', 'alidsjt', 'mengkem2', 'haclarke', 'oishikfaruque', 'ilou', 'aengm', 'hilisa', 'carlosvillar54', 'vikazvereva', 'm939454', 'va844', 'pablobou4', 'ludovick.begin', 'maniphysics09', 'eduard25252598', 'xosegq16', 'adam562', 'lauramolinosmayo', 'amni99', 'kie180702', 'saharoaf', 'redzuan11', 'ypp200', 'kph2', 'kirolosehab99', 'restep2', 'seifhabib', 'maramtarek53', 'zehuahe2', 'azizijazam11', 'marcosanllo', 'aimansyaz99', 'elizametias12', 'juanmacano97', 'sparshagarwal1009', 'prakharbhargava0', 'njs035', 'ramy_maged4', 'hmoulvi1', 'hf4', 'wowmuchchuck', 'mohammedemadeldin2000', 'gabrielyii', 'keerthisv', 'pythagoras2', 'xunyong', 'irenehb92', 'shradhap', 'mohameeddsamy', 'marianne.gratton.1', 'marcmagdy98', 'brknshn', 'lukunze1', 'caglanlee', 'desmondsoon', 'sebasket14', 'masonpb2', 'youssef2042000', 'retty8', 'bharath3', 'syin4', 'ethanmorse', 'ematson5897', 'jacobzeshleman', 'leejq', 'harshini9962', 'reemali99_', 'xxlilmontysignxx', 'ramonruiz.infor', 'atharva98', 'ahern0722', 'hishamzakaria20', 'cheokonn', 'adriangarea', 'jeanmichael.deschenes', 'samet1231234', 'mr4425', 'bluelobster', 'justin.lariviere.25', 'dcpang2', 'felivitullo87', 'puertarcd', 'farahsamir978', 'akozych2', 'nbs691', 'kie180073', 'anwar909', 'bleuminuit', 'atx203', 'kanet1234', 'sealseal', 'emrebuyukkose2', 'arrow823', 'dhvanil', 'nuanno97', 'dkshelat', 'mohabayman', 'ranasherif65', 'diamond92', 'ugur.cankaya.3718', 'ammareltalli', 'acn562', 'nabilah1403', 'yaseminablacandir', 'tamchouweng', 'ablahsaoud', 'sriharshap', 'mrefaat', 'bassamtarek', 'hamidausat', 'kakmeera1999', 'teoster50', 'nolmos96', 'abdurrahmn13', 'mmartinezsanchez', 'sandrabashara', 'zakhwan7', 'chengweiheng', 'nikalyaamani', 'happyleexin', 'williammitchell5818', 'rooban11', 'yeejou990318', 'kowjiajin', 'nihaosawaddee', 'maxernest', 'guibill10', 'mohamedsameh', 'spazos7', 'tmi211', 'kie180039', 'worldlineusaf', 'mgk816', 'kie180079', 'movi205', 'shuming2']",5,"['aronchino6', 'paularodriguez', 'hermidaitor', 'iago', None]",396,"['oliviercharbonneau', 'miri23', 'ozgurkablan26', 'loisonchambers', 'tuberkargan_97', 'pranjal3', 'musabmalek0717', 'nadanasser1199', 'siemprewowthechami', 'staceyn2', 'vblanco.nico', 'abbesalaeddine', 'efrenhub', 'isabelmaria.vazquez', 'ahmedamr', 'shorouk_ossama', 'rikardberger', 'alancantu57', 'luciano.brignone', 'rahimnoorj', 'janeneil88', 'guttsfulltyagi', 'mjgebara14', 'kartal', 'gabrielyii99', 'aboone06', 'saegner2', 'manuelsomoza94', 'amani12345', 'youssefsherif22', 'j.haliburton', 'amr_ua07', 'evrenyigit', 'tingliang', 'kirankumar94', 'ahagras13', 'njgale01', 'al4995', 'smrdafdl', 'travisc2', 'dlee145', 'stambo', 'anthonyroux', 'ryanorem', 'moh.bahaa', 'ahchehyan', 'aimanadnan', 'veronica.mieites', 's_coriolis', 'trkmengkay', 'cbecker413', 'mcruces.fz', 'latecnologiameodia', 'gxiao2', 'emilechouinard', 'je_guilbert', 'yubai', 'sinasigurpinar', 'lauragdevesa', 'muvafikmelikkaya', 'kason.carroll', 'jbaggie2019', 'annahaozheng0606', 'jtorres17', 'ahmedayman2370', 'zikrizaki88995', 'yjenyiee155', '46harunakgul', 'alifzulkifli99', 'kaitlinh', 'tyy233', 'sdehoyos47', 'malgaca', 'lsleed', 'khazanv2', 'alexisdixon6', 'gc_1', 'jinsup2', 'rishu', 'amparo.castro.96', 'tbryan', 'martin32', 'michael.mechelay', 'akash140410107098', 'nowapoca', 'onaam8', 'pablosaavedra', 'camilolcastro97', 'khor', 'ankit6257', 'samashraf1', 'benoiturcotte', 'aishu98', 'rileyroca', 'david.peral.moran', 'kiruthikaabalu181996', 'taymacnichols', 'dhodapp', 'hermidaitor', 'nagihankececi', 'carlosvigo1997', 'moh.ashraf105', 'baleko12345', 'ikhbal', 'afeefz', 'kaustubh.shirpurkar', 'kie180031', 'bflores18', 'tdubnansky6', 'jorgecastelo5', 'andreadiazgar', 'david2397', 'bcperki2', 'melaniejkramer', 'rkchapman', 'jn1404', 'mateocampos', 'jzhan142', 'josepazmartin', 'brannon44', 'adfoz', 'avw2', 'youxing0309', 'scremin', 'lderemo', 'perezsarmar', 'ashutoshsinghhenry6', 'melroy_caeiro', 'viratbhatt007', 'fkl217', 'coderko3', 'alimatama', 'ammaralaa516', 'nadhnasorudin', 'adarsh123', 'jacquelinethardin', 'mjoza2', 'nihatyavuz', 'estebanrial', 'jinwoo2', 'adnanyuceer', 'danielfernandezcalo', 'berkaydean', 'cloudyoverhead', 'fred_dion', 'syedzakwan', 'e1150590', 'fcfrancapra94', 'amiruldanial99', 'ozbunar01', 'alecorti.pardo', 'electronica18', 'nourananwar123', 'olivier.gilbert.paquet', 'anibarseghyan', 'amlibrahim', 'neuroque', 'kychui2', 'shaf31', 'hong_gao', 'aronchino6', 'paul.aniruddha', 'carlosbesadaromero', 'mohaballam', 'pip29', 'apb5472', 'tuberkargan', 'hafizmokh99', 'javierisma98', 'fathy1104', 'corredoira', 'helenalecoq97', 'kimzihuang', 'muteki', 'iago', 'masitadonmez', 'nadja1', 'dancastaneda', 'ahmedsameh1698', 'rocio', 'mallen22', 'ffazul64', 'guoyao', 'ari6nd', 'kerryreto', 'pedrosiaba', 'michaelsaldana1', 'omarmagdy', 'vickytubio', 'ericrobles', 'soccadelic44', 'selena', 'aasifhameed99', 'damlakubattt', 'anxovidal8', 'exjamil', 'jahnavikachhia', 'joker632455', 'vincentpainchaud.vp', 'svo4321', 'zhixin2', 'yansi', 'asyrafaqil', 'xyz11', 'virajput299', 'paularodriguez', 'ryanboucher', 'jpmcgee98', 'mariz', 'bhliu97', 'amrebrahim', 'abdulrahim2905', 'c.a.stupka', 'tonybocadillosgrandes', 'talwren', 'rxtodd', 'farah26', 'tss3', 'abieday1704', 'mavanzato0418', 'facundovia', 'cristinacigarran', 'nazimmath3', 'baohl2', 'ales.gajdacz', 'elad.d', 'kie180028', 'wahidiah52', 'kyang37', 'arifjalani99', 'lino13', 'jaimefookinlannister', 'physquig', 'adriancheah', 'jarodm2', 'noureldin1999', 'michael2010814', 'ckim123', 'eddin21', 'jipiccardi', 'prabuddha_888253127', 'david_atef', 'kalebhilde', 'magic_ocean99', 'saipraneett', 'sanchjai', 'omardeyaa', 'pingan99', 'aaq', 'alidsjt', 'mengkem2', 'haclarke', 'oishikfaruque', 'ilou', 'aengm', 'janalorenzolumbreras', 'hilisa', 'carlosvillar54', 'vikazvereva', 'm939454', 'va844', 'pablobou4', 'ludovick.begin', 'maniphysics09', 'eduard25252598', 'apascao', 'xosegq16', 'adam562', 'lauramolinosmayo', 'amni99', 'kie180702', 'saharoaf', 'redzuan11', 'ypp200', 'kph2', 'martinzapata', 'kirolosehab99', 'restep2', 'seifhabib', 'maramtarek53', 'zehuahe2', 'azizijazam11', 'marcosanllo', 'aimansyaz99', 'elizametias12', 'juanmacano97', 'sparshagarwal1009', 'prakharbhargava0', 'njs035', 'alberfn', 'ramy_maged4', 'hmoulvi1', 'vanesagarcia', 'hf4', 'wowmuchchuck', 'mohammedemadeldin2000', 'gabrielyii', 'keerthisv', 'pythagoras2', 'xunyong', 'irenehb92', 'shradhap', 'mohameeddsamy', 'marianne.gratton.1', 'marcmagdy98', 'brknshn', 'gemma', 'lukunze1', 'caglanlee', 'desmondsoon', 'sebasket14', 'masonpb2', 'youssef2042000', 'retty8', 'bharath3', 'syin4', 'ethanmorse', 'ematson5897', 'jacobzeshleman', 'leejq', 'harshini9962', 'reemali99_', 'xxlilmontysignxx', 'ramonruiz.infor', 'atharva98', 'ahern0722', 'hishamzakaria20', 'cheokonn', 'adriangarea', 'jeanmichael.deschenes', 'samet1231234', 'mr4425', 'bluelobster', 'justin.lariviere.25', 'dcpang2', 'felivitullo87', 'puertarcd', 'farahsamir978', 'akozych2', 'nbs691', 'kie180073', 'anwar909', 'bleuminuit', 'atx203', 'kanet1234', 'sealseal', 'emrebuyukkose2', 'arrow823', 'dhvanil', 'nuanno97', 'dkshelat', 'mohabayman', 'ranasherif65', 'diamond92', 'ugur.cankaya.3718', 'ammareltalli', 'acn562', 'nabilah1403', 'yaseminablacandir', 'tamchouweng', 'ablahsaoud', 'sriharshap', 'mrefaat', 'bassamtarek', 'hamidausat', 'kakmeera1999', 'teoster50', 'nolmos96', 'abdurrahmn13', 'mmartinezsanchez', 'sandrabashara', 'zakhwan7', 'chengweiheng', 'nikalyaamani', 'acregodean', 'happyleexin', 'sarapl', 'williammitchell5818', None, 'rooban11', 'yeejou990318', 'kowjiajin', 'nihaosawaddee', 'maxernest', 'david.garrido', 'guibill10', 'mohamedsameh', 'spazos7', 'tmi211', 'kie180039', 'worldlineusaf', 'mgk816', 'kie180079', 'ledicia97', 'movi205', 'shuming2']"
1,262,391,37,9,"['adnanyuceer', 'damlakubattt', 'evrenyigit', 'brknshn', '46harunakgul', 'ozbunar01', 'ugur.cankaya.3718', 'muvafikmelikkaya', 'nihatyavuz']",382,"['oliviercharbonneau', 'miri23', 'ozgurkablan26', 'loisonchambers', 'tuberkargan_97', 'pranjal3', 'musabmalek0717', 'nadanasser1199', 'siemprewowthechami', 'staceyn2', 'vblanco.nico', 'abbesalaeddine', 'efrenhub', 'isabelmaria.vazquez', 'ahmedamr', 'shorouk_ossama', 'rikardberger', 'alancantu57', 'luciano.brignone', 'rahimnoorj', 'janeneil88', 'guttsfulltyagi', 'mjgebara14', 'kartal', 'gabrielyii99', 'aboone06', 'saegner2', 'manuelsomoza94', 'amani12345', 'youssefsherif22', 'j.haliburton', 'amr_ua07', 'tingliang', 'kirankumar94', 'ahagras13', 'njgale01', 'al4995', 'smrdafdl', 'travisc2', 'dlee145', 'stambo', 'anthonyroux', 'ryanorem', 'moh.bahaa', 'ahchehyan', 'aimanadnan', 'veronica.mieites', 's_coriolis', 'trkmengkay', 'cbecker413', 'mcruces.fz', 'latecnologiameodia', 'gxiao2', 'emilechouinard', 'je_guilbert', 'yubai', 'sinasigurpinar', 'lauragdevesa', 'kason.carroll', 'jbaggie2019', 'annahaozheng0606', 'jtorres17', 'ahmedayman2370', 'zikrizaki88995', 'yjenyiee155', 'alifzulkifli99', 'kaitlinh', 'tyy233', 'sdehoyos47', 'malgaca', 'lsleed', 'khazanv2', 'alexisdixon6', 'gc_1', 'jinsup2', 'rishu', 'amparo.castro.96', 'tbryan', 'martin32', 'michael.mechelay', 'akash140410107098', 'nowapoca', 'onaam8', 'pablosaavedra', 'camilolcastro97', 'khor', 'ankit6257', 'samashraf1', 'benoiturcotte', 'aishu98', 'rileyroca', 'david.peral.moran', 'kiruthikaabalu181996', 'taymacnichols', 'dhodapp', 'nagihankececi', 'carlosvigo1997', 'moh.ashraf105', 'baleko12345', 'ikhbal', 'afeefz', 'kaustubh.shirpurkar', 'kie180031', 'bflores18', 'tdubnansky6', 'jorgecastelo5', 'andreadiazgar', 'david2397', 'bcperki2', 'melaniejkramer', 'rkchapman', 'jn1404', 'mateocampos', 'jzhan142', 'josepazmartin', 'brannon44', 'adfoz', 'avw2', 'youxing0309', 'scremin', 'lderemo', 'perezsarmar', 'ashutoshsinghhenry6', 'melroy_caeiro', 'viratbhatt007', 'fkl217', 'coderko3', 'alimatama', 'ammaralaa516', 'nadhnasorudin', 'adarsh123', 'jacquelinethardin', 'mjoza2', 'estebanrial', 'jinwoo2', 'danielfernandezcalo', 'berkaydean', 'cloudyoverhead', 'fred_dion', 'syedzakwan', 'e1150590', 'fcfrancapra94', 'amiruldanial99', 'alecorti.pardo', 'electronica18', 'nourananwar123', 'olivier.gilbert.paquet', 'anibarseghyan', 'amlibrahim', 'neuroque', 'kychui2', 'shaf31', 'hong_gao', 'paul.aniruddha', 'carlosbesadaromero', 'mohaballam', 'pip29', 'apb5472', 'tuberkargan', 'hafizmokh99', 'javierisma98', 'fathy1104', 'corredoira', 'helenalecoq97', 'kimzihuang', 'muteki', 'masitadonmez', 'nadja1', 'dancastaneda', 'ahmedsameh1698', 'rocio', 'mallen22', 'ffazul64', 'guoyao', 'ari6nd', 'kerryreto', 'pedrosiaba', 'michaelsaldana1', 'omarmagdy', 'vickytubio', 'ericrobles', 'soccadelic44', 'selena', 'aasifhameed99', 'anxovidal8', 'exjamil', 'jahnavikachhia', 'joker632455', 'vincentpainchaud.vp', 'svo4321', 'zhixin2', 'yansi', 'asyrafaqil', 'xyz11', 'virajput299', 'ryanboucher', 'jpmcgee98', 'mariz', 'bhliu97', 'amrebrahim', 'abdulrahim2905', 'c.a.stupka', 'tonybocadillosgrandes', 'talwren', 'rxtodd', 'farah26', 'tss3', 'abieday1704', 'mavanzato0418', 'facundovia', 'cristinacigarran', 'nazimmath3', 'baohl2', 'ales.gajdacz', 'elad.d', 'kie180028', 'wahidiah52', 'kyang37', 'arifjalani99', 'lino13', 'jaimefookinlannister', 'physquig', 'adriancheah', 'jarodm2', 'noureldin1999', 'michael2010814', 'ckim123', 'eddin21', 'jipiccardi', 'prabuddha_888253127', 'david_atef', 'kalebhilde', 'magic_ocean99', 'saipraneett', 'sanchjai', 'omardeyaa', 'pingan99', 'aaq', 'alidsjt', 'mengkem2', 'haclarke', 'oishikfaruque', 'ilou', 'aengm', 'janalorenzolumbreras', 'hilisa', 'carlosvillar54', 'vikazvereva', 'm939454', 'va844', 'pablobou4', 'ludovick.begin', 'maniphysics09', 'eduard25252598', 'apascao', 'xosegq16', 'adam562', 'lauramolinosmayo', 'amni99', 'kie180702', 'saharoaf', 'redzuan11', 'ypp200', 'kph2', 'martinzapata', 'kirolosehab99', 'restep2', 'seifhabib', 'maramtarek53', 'zehuahe2', 'azizijazam11', 'marcosanllo', 'aimansyaz99', 'elizametias12', 'juanmacano97', 'sparshagarwal1009', 'prakharbhargava0', 'njs035', 'alberfn', 'ramy_maged4', 'hmoulvi1', 'vanesagarcia', 'hf4', 'wowmuchchuck', 'mohammedemadeldin2000', 'gabrielyii', 'keerthisv', 'pythagoras2', 'xunyong', 'irenehb92', 'shradhap', 'mohameeddsamy', 'marianne.gratton.1', 'marcmagdy98', 'gemma', 'lukunze1', 'caglanlee', 'desmondsoon', 'sebasket14', 'masonpb2', 'youssef2042000', 'retty8', 'bharath3', 'syin4', 'ethanmorse', 'ematson5897', 'jacobzeshleman', 'leejq', 'harshini9962', 'reemali99_', 'xxlilmontysignxx', 'ramonruiz.infor', 'atharva98', 'ahern0722', 'hishamzakaria20', 'cheokonn', 'adriangarea', 'jeanmichael.deschenes', 'samet1231234', 'mr4425', 'bluelobster', 'justin.lariviere.25', 'dcpang2', 'felivitullo87', 'puertarcd', 'farahsamir978', 'akozych2', 'nbs691', 'kie180073', 'anwar909', 'bleuminuit', 'atx203', 'kanet1234', 'sealseal', 'emrebuyukkose2', 'arrow823', 'dhvanil', 'nuanno97', 'dkshelat', 'mohabayman', 'ranasherif65', 'diamond92', 'ammareltalli', 'acn562', 'nabilah1403', 'yaseminablacandir', 'tamchouweng', 'ablahsaoud', 'sriharshap', 'mrefaat', 'bassamtarek', 'hamidausat', 'kakmeera1999', 'teoster50', 'nolmos96', 'abdurrahmn13', 'mmartinezsanchez', 'sandrabashara', 'zakhwan7', 'chengweiheng', 'nikalyaamani', 'acregodean', 'happyleexin', 'sarapl', 'williammitchell5818', 'rooban11', 'yeejou990318', 'kowjiajin', 'nihaosawaddee', 'maxernest', 'david.garrido', 'guibill10', 'mohamedsameh', 'spazos7', 'tmi211', 'kie180039', 'worldlineusaf', 'mgk816', 'kie180079', 'ledicia97', 'movi205', 'shuming2']",28,"['cemkarts', 'esracolak.25', 'mevradilanerten', 'kganozcan', 'emre_krtn97', 'meltemsbreezes', 'melike_musal', 'afkali.120', 'furkanznkr', 'davuteee', 'frknznkr', 'oakbulut1997', 'irfancan571', 'berkanaydn16', 'melikemusal1', 'muratlevent', None, 'emre_citak_bil', 'haticesari333333', 'abcd5454', 'ilkaydost', 'omerfkazar22', 'abdurrahmn15', 'yunusbaskan', 'metehanmustafayalcin', 'furkanturk1352', 'cihanbuyuknacar', 'onurcanozavci']",419,"['oliviercharbonneau', 'miri23', 'ozgurkablan26', 'loisonchambers', 'tuberkargan_97', 'pranjal3', 'musabmalek0717', 'nadanasser1199', 'siemprewowthechami', 'staceyn2', 'vblanco.nico', 'abbesalaeddine', 'efrenhub', 'isabelmaria.vazquez', 'ahmedamr', 'shorouk_ossama', 'rikardberger', 'alancantu57', 'luciano.brignone', 'rahimnoorj', 'janeneil88', 'emre_krtn97', 'guttsfulltyagi', 'mjgebara14', 'kartal', 'gabrielyii99', 'aboone06', 'saegner2', 'manuelsomoza94', 'amani12345', 'youssefsherif22', 'j.haliburton', 'amr_ua07', 'evrenyigit', 'tingliang', 'kirankumar94', 'ahagras13', 'njgale01', 'al4995', 'smrdafdl', 'abcd5454', 'travisc2', 'dlee145', 'stambo', 'anthonyroux', 'ryanorem', 'moh.bahaa', 'ahchehyan', 'aimanadnan', 'veronica.mieites', 'metehanmustafayalcin', 's_coriolis', 'trkmengkay', 'cbecker413', 'mcruces.fz', 'latecnologiameodia', 'gxiao2', 'emilechouinard', 'je_guilbert', 'yubai', 'sinasigurpinar', 'lauragdevesa', 'muvafikmelikkaya', 'kason.carroll', 'jbaggie2019', 'annahaozheng0606', 'jtorres17', 'ahmedayman2370', 'cihanbuyuknacar', 'zikrizaki88995', 'yjenyiee155', '46harunakgul', 'alifzulkifli99', 'kaitlinh', 'tyy233', 'sdehoyos47', 'davuteee', 'malgaca', 'lsleed', 'khazanv2', 'alexisdixon6', 'gc_1', 'jinsup2', 'rishu', 'amparo.castro.96', 'tbryan', 'martin32', 'michael.mechelay', 'akash140410107098', 'nowapoca', 'onaam8', 'pablosaavedra', 'camilolcastro97', 'khor', 'ankit6257', 'samashraf1', 'benoiturcotte', 'aishu98', 'rileyroca', 'david.peral.moran', 'kiruthikaabalu181996', 'taymacnichols', 'dhodapp', 'nagihankececi', 'carlosvigo1997', 'moh.ashraf105', 'baleko12345', 'ikhbal', 'afeefz', 'kaustubh.shirpurkar', 'kie180031', 'bflores18', 'tdubnansky6', 'jorgecastelo5', 'andreadiazgar', 'david2397', 'bcperki2', 'melaniejkramer', 'rkchapman', 'jn1404', 'mateocampos', 'jzhan142', 'josepazmartin', 'brannon44', 'adfoz', 'avw2', 'youxing0309', 'scremin', 'lderemo', 'perezsarmar', 'ashutoshsinghhenry6', 'melroy_caeiro', 'viratbhatt007', 'oakbulut1997', 'fkl217', 'irfancan571', 'coderko3', 'alimatama', 'ammaralaa516', 'nadhnasorudin', 'adarsh123', 'jacquelinethardin', 'mjoza2', 'nihatyavuz', 'emre_citak_bil', 'estebanrial', 'jinwoo2', 'adnanyuceer', 'danielfernandezcalo', 'berkaydean', 'cloudyoverhead', 'fred_dion', 'syedzakwan', 'e1150590', 'fcfrancapra94', 'amiruldanial99', 'omerfkazar22', 'ozbunar01', 'alecorti.pardo', 'electronica18', 'abdurrahmn15', 'nourananwar123', 'olivier.gilbert.paquet', 'anibarseghyan', 'amlibrahim', 'neuroque', 'kychui2', 'shaf31', 'hong_gao', 'paul.aniruddha', 'carlosbesadaromero', 'mevradilanerten', 'mohaballam', 'pip29', 'apb5472', 'tuberkargan', 'hafizmokh99', 'javierisma98', 'fathy1104', 'meltemsbreezes', 'corredoira', 'helenalecoq97', 'kimzihuang', 'muteki', 'masitadonmez', 'nadja1', 'dancastaneda', 'ahmedsameh1698', 'rocio', 'mallen22', 'ffazul64', 'guoyao', 'ari6nd', 'kerryreto', 'furkanznkr', 'frknznkr', 'pedrosiaba', 'michaelsaldana1', 'omarmagdy', 'vickytubio', 'ericrobles', 'soccadelic44', 'selena', 'aasifhameed99', 'damlakubattt', 'anxovidal8', 'exjamil', 'jahnavikachhia', 'joker632455', 'vincentpainchaud.vp', 'svo4321', 'zhixin2', 'yunusbaskan', 'yansi', 'furkanturk1352', 'asyrafaqil', 'xyz11', 'virajput299', 'esracolak.25', 'ryanboucher', 'jpmcgee98', 'mariz', 'bhliu97', 'amrebrahim', 'abdulrahim2905', 'c.a.stupka', 'tonybocadillosgrandes', 'talwren', 'rxtodd', 'farah26', 'tss3', 'abieday1704', 'mavanzato0418', 'facundovia', 'cristinacigarran', 'melike_musal', 'nazimmath3', 'baohl2', 'ales.gajdacz', 'elad.d', 'kie180028', 'wahidiah52', 'kyang37', 'arifjalani99', 'lino13', 'jaimefookinlannister', 'physquig', 'muratlevent', 'adriancheah', 'jarodm2', 'noureldin1999', 'michael2010814', 'ckim123', 'eddin21', 'jipiccardi', 'prabuddha_888253127', 'david_atef', 'kalebhilde', 'magic_ocean99', 'saipraneett', 'sanchjai', 'cemkarts', 'omardeyaa', 'pingan99', 'aaq', 'alidsjt', 'mengkem2', 'haclarke', 'oishikfaruque', 'ilou', 'aengm', 'janalorenzolumbreras', 'hilisa', 'carlosvillar54', 'vikazvereva', 'm939454', 'va844', 'pablobou4', 'ludovick.begin', 'maniphysics09', 'eduard25252598', 'apascao', 'xosegq16', 'adam562', 'lauramolinosmayo', 'amni99', 'kie180702', 'saharoaf', 'redzuan11', 'ypp200', 'kph2', 'martinzapata', 'kirolosehab99', 'berkanaydn16', 'restep2', 'seifhabib', 'melikemusal1', 'maramtarek53', 'zehuahe2', 'azizijazam11', 'marcosanllo', 'aimansyaz99', 'elizametias12', 'juanmacano97', 'sparshagarwal1009', 'prakharbhargava0', 'njs035', 'alberfn', 'ramy_maged4', 'hmoulvi1', 'vanesagarcia', 'hf4', 'wowmuchchuck', 'mohammedemadeldin2000', 'gabrielyii', 'keerthisv', 'pythagoras2', 'xunyong', 'irenehb92', 'shradhap', 'onurcanozavci', 'mohameeddsamy', 'marianne.gratton.1', 'marcmagdy98', 'brknshn', 'gemma', 'lukunze1', 'kganozcan', 'caglanlee', 'desmondsoon', 'sebasket14', 'masonpb2', 'youssef2042000', 'retty8', 'bharath3', 'syin4', 'ethanmorse', 'ematson5897', 'jacobzeshleman', 'leejq', 'harshini9962', 'reemali99_', 'xxlilmontysignxx', 'ramonruiz.infor', 'atharva98', 'ahern0722', 'hishamzakaria20', 'cheokonn', 'adriangarea', 'jeanmichael.deschenes', 'samet1231234', 'mr4425', 'bluelobster', 'justin.lariviere.25', 'dcpang2', 'felivitullo87', 'puertarcd', 'ilkaydost', 'farahsamir978', 'akozych2', 'nbs691', 'kie180073', 'anwar909', 'bleuminuit', 'atx203', 'kanet1234', 'sealseal', 'emrebuyukkose2', 'arrow823', 'dhvanil', 'nuanno97', 'dkshelat', 'mohabayman', 'ranasherif65', 'diamond92', 'ugur.cankaya.3718', 'ammareltalli', 'acn562', 'nabilah1403', 'yaseminablacandir', 'tamchouweng', 'ablahsaoud', 'sriharshap', 'mrefaat', 'bassamtarek', 'hamidausat', 'afkali.120', 'kakmeera1999', 'teoster50', 'nolmos96', 'abdurrahmn13', 'mmartinezsanchez', 'sandrabashara', 'zakhwan7', 'chengweiheng', 'nikalyaamani', 'acregodean', 'happyleexin', 'sarapl', 'williammitchell5818', None, 'rooban11', 'haticesari333333', 'yeejou990318', 'kowjiajin', 'nihaosawaddee', 'maxernest', 'david.garrido', 'guibill10', 'mohamedsameh', 'spazos7', 'tmi211', 'kie180039', 'worldlineusaf', 'mgk816', 'kie180079', 'ledicia97', 'movi205', 'shuming2']"
1,275,391,36,16,"['nabilah1403', 'khor', 'amni99', 'kie180028', 'cheokonn', 'exjamil', 'hong_gao', 'zikrizaki88995', 'redzuan11', 'syedzakwan', 'tamchouweng', 'yjenyiee155', 'musabmalek0717', 'youxing0309', 'alifzulkifli99', 'desmondsoon']",375,"['oliviercharbonneau', 'miri23', 'ozgurkablan26', 'loisonchambers', 'tuberkargan_97', 'pranjal3', 'nadanasser1199', 'siemprewowthechami', 'staceyn2', 'vblanco.nico', 'abbesalaeddine', 'efrenhub', 'isabelmaria.vazquez', 'ahmedamr', 'shorouk_ossama', 'rikardberger', 'alancantu57', 'luciano.brignone', 'rahimnoorj', 'janeneil88', 'guttsfulltyagi', 'mjgebara14', 'kartal', 'gabrielyii99', 'aboone06', 'saegner2', 'manuelsomoza94', 'amani12345', 'youssefsherif22', 'j.haliburton', 'amr_ua07', 'evrenyigit', 'tingliang', 'kirankumar94', 'ahagras13', 'njgale01', 'al4995', 'smrdafdl', 'travisc2', 'dlee145', 'stambo', 'anthonyroux', 'ryanorem', 'moh.bahaa', 'ahchehyan', 'aimanadnan', 'veronica.mieites', 's_coriolis', 'trkmengkay', 'cbecker413', 'mcruces.fz', 'latecnologiameodia', 'gxiao2', 'emilechouinard', 'je_guilbert', 'yubai', 'sinasigurpinar', 'lauragdevesa', 'muvafikmelikkaya', 'kason.carroll', 'jbaggie2019', 'annahaozheng0606', 'jtorres17', 'ahmedayman2370', '46harunakgul', 'kaitlinh', 'tyy233', 'sdehoyos47', 'malgaca', 'lsleed', 'khazanv2', 'alexisdixon6', 'gc_1', 'jinsup2', 'rishu', 'amparo.castro.96', 'tbryan', 'martin32', 'michael.mechelay', 'akash140410107098', 'nowapoca', 'onaam8', 'pablosaavedra', 'camilolcastro97', 'ankit6257', 'samashraf1', 'benoiturcotte', 'aishu98', 'rileyroca', 'david.peral.moran', 'kiruthikaabalu181996', 'taymacnichols', 'dhodapp', 'nagihankececi', 'carlosvigo1997', 'moh.ashraf105', 'baleko12345', 'ikhbal', 'afeefz', 'kaustubh.shirpurkar', 'kie180031', 'bflores18', 'tdubnansky6', 'jorgecastelo5', 'andreadiazgar', 'david2397', 'bcperki2', 'melaniejkramer', 'rkchapman', 'jn1404', 'mateocampos', 'jzhan142', 'josepazmartin', 'brannon44', 'adfoz', 'avw2', 'scremin', 'lderemo', 'perezsarmar', 'ashutoshsinghhenry6', 'melroy_caeiro', 'viratbhatt007', 'fkl217', 'coderko3', 'alimatama', 'ammaralaa516', 'nadhnasorudin', 'adarsh123', 'jacquelinethardin', 'mjoza2', 'nihatyavuz', 'estebanrial', 'jinwoo2', 'adnanyuceer', 'danielfernandezcalo', 'berkaydean', 'cloudyoverhead', 'fred_dion', 'e1150590', 'fcfrancapra94', 'amiruldanial99', 'ozbunar01', 'alecorti.pardo', 'electronica18', 'nourananwar123', 'olivier.gilbert.paquet', 'anibarseghyan', 'amlibrahim', 'neuroque', 'kychui2', 'shaf31', 'paul.aniruddha', 'carlosbesadaromero', 'mohaballam', 'pip29', 'apb5472', 'tuberkargan', 'hafizmokh99', 'javierisma98', 'fathy1104', 'corredoira', 'helenalecoq97', 'kimzihuang', 'muteki', 'masitadonmez', 'nadja1', 'dancastaneda', 'ahmedsameh1698', 'rocio', 'mallen22', 'ffazul64', 'guoyao', 'ari6nd', 'kerryreto', 'pedrosiaba', 'michaelsaldana1', 'omarmagdy', 'vickytubio', 'ericrobles', 'soccadelic44', 'selena', 'aasifhameed99', 'damlakubattt', 'anxovidal8', 'jahnavikachhia', 'joker632455', 'vincentpainchaud.vp', 'svo4321', 'zhixin2', 'yansi', 'asyrafaqil', 'xyz11', 'virajput299', 'ryanboucher', 'jpmcgee98', 'mariz', 'bhliu97', 'amrebrahim', 'abdulrahim2905', 'c.a.stupka', 'tonybocadillosgrandes', 'talwren', 'rxtodd', 'farah26', 'tss3', 'abieday1704', 'mavanzato0418', 'facundovia', 'cristinacigarran', 'nazimmath3', 'baohl2', 'ales.gajdacz', 'elad.d', 'wahidiah52', 'kyang37', 'arifjalani99', 'lino13', 'jaimefookinlannister', 'physquig', 'adriancheah', 'jarodm2', 'noureldin1999', 'michael2010814', 'ckim123', 'eddin21', 'jipiccardi', 'prabuddha_888253127', 'david_atef', 'kalebhilde', 'magic_ocean99', 'saipraneett', 'sanchjai', 'omardeyaa', 'pingan99', 'aaq', 'alidsjt', 'mengkem2', 'haclarke', 'oishikfaruque', 'ilou', 'aengm', 'janalorenzolumbreras', 'hilisa', 'carlosvillar54', 'vikazvereva', 'm939454', 'va844', 'pablobou4', 'ludovick.begin', 'maniphysics09', 'eduard25252598', 'apascao', 'xosegq16', 'adam562', 'lauramolinosmayo', 'kie180702', 'saharoaf', 'ypp200', 'kph2', 'martinzapata', 'kirolosehab99', 'restep2', 'seifhabib', 'maramtarek53', 'zehuahe2', 'azizijazam11', 'marcosanllo', 'aimansyaz99', 'elizametias12', 'juanmacano97', 'sparshagarwal1009', 'prakharbhargava0', 'njs035', 'alberfn', 'ramy_maged4', 'hmoulvi1', 'vanesagarcia', 'hf4', 'wowmuchchuck', 'mohammedemadeldin2000', 'gabrielyii', 'keerthisv', 'pythagoras2', 'xunyong', 'irenehb92', 'shradhap', 'mohameeddsamy', 'marianne.gratton.1', 'marcmagdy98', 'brknshn', 'gemma', 'lukunze1', 'caglanlee', 'sebasket14', 'masonpb2', 'youssef2042000', 'retty8', 'bharath3', 'syin4', 'ethanmorse', 'ematson5897', 'jacobzeshleman', 'leejq', 'harshini9962', 'reemali99_', 'xxlilmontysignxx', 'ramonruiz.infor', 'atharva98', 'ahern0722', 'hishamzakaria20', 'adriangarea', 'jeanmichael.deschenes', 'samet1231234', 'mr4425', 'bluelobster', 'justin.lariviere.25', 'dcpang2', 'felivitullo87', 'puertarcd', 'farahsamir978', 'akozych2', 'nbs691', 'kie180073', 'anwar909', 'bleuminuit', 'atx203', 'kanet1234', 'sealseal', 'emrebuyukkose2', 'arrow823', 'dhvanil', 'nuanno97', 'dkshelat', 'mohabayman', 'ranasherif65', 'diamond92', 'ugur.cankaya.3718', 'ammareltalli', 'acn562', 'yaseminablacandir', 'ablahsaoud', 'sriharshap', 'mrefaat', 'bassamtarek', 'hamidausat', 'kakmeera1999', 'teoster50', 'nolmos96', 'abdurrahmn13', 'mmartinezsanchez', 'sandrabashara', 'zakhwan7', 'chengweiheng', 'nikalyaamani', 'acregodean', 'happyleexin', 'sarapl', 'williammitchell5818', 'rooban11', 'yeejou990318', 'kowjiajin', 'nihaosawaddee', 'maxernest', 'david.garrido', 'guibill10', 'mohamedsameh', 'spazos7', 'tmi211', 'kie180039', 'worldlineusaf', 'mgk816', 'kie180079', 'ledicia97', 'movi205', 'shuming2']",20,"['wanchin', 'mahafizuddin', '18081357278hjh', 'adamalfian__', 'chenyongchang', 'mouxingyu121314', 'wanwan1103', 'macbelieve', 'kishen260499', 'izzat2774', 'felice', None, 'aesaraismat', 'juneeee98', 'ashsaifullizan97', 'kie180029', 'jazlilong', 'zahrajl124', 'moontasirsoumik', 'yuchennn']",411,"['oliviercharbonneau', 'miri23', 'ozgurkablan26', 'loisonchambers', 'tuberkargan_97', 'pranjal3', 'musabmalek0717', 'nadanasser1199', 'siemprewowthechami', 'staceyn2', 'vblanco.nico', 'abbesalaeddine', 'efrenhub', 'isabelmaria.vazquez', 'chenyongchang', 'ahmedamr', 'shorouk_ossama', 'rikardberger', 'alancantu57', 'luciano.brignone', 'rahimnoorj', 'janeneil88', 'guttsfulltyagi', 'mjgebara14', 'wanwan1103', 'kartal', 'gabrielyii99', 'aboone06', 'izzat2774', 'saegner2', 'manuelsomoza94', 'amani12345', 'youssefsherif22', 'j.haliburton', 'amr_ua07', 'evrenyigit', 'tingliang', 'kirankumar94', 'ahagras13', 'njgale01', 'al4995', 'smrdafdl', 'travisc2', 'dlee145', 'stambo', 'anthonyroux', 'ryanorem', 'moh.bahaa', 'ahchehyan', 'aimanadnan', 'veronica.mieites', 's_coriolis', 'trkmengkay', 'cbecker413', 'mcruces.fz', 'latecnologiameodia', '18081357278hjh', 'gxiao2', 'emilechouinard', 'je_guilbert', 'yubai', 'adamalfian__', 'sinasigurpinar', 'lauragdevesa', 'muvafikmelikkaya', 'kason.carroll', 'jbaggie2019', 'annahaozheng0606', 'jtorres17', 'ahmedayman2370', 'zikrizaki88995', 'yjenyiee155', 'mouxingyu121314', '46harunakgul', 'alifzulkifli99', 'kaitlinh', 'tyy233', 'sdehoyos47', 'kishen260499', 'malgaca', 'lsleed', 'khazanv2', 'alexisdixon6', 'gc_1', 'felice', 'jinsup2', 'rishu', 'amparo.castro.96', 'tbryan', 'martin32', 'michael.mechelay', 'akash140410107098', 'nowapoca', 'onaam8', 'pablosaavedra', 'camilolcastro97', 'khor', 'ankit6257', 'samashraf1', 'benoiturcotte', 'aishu98', 'rileyroca', 'david.peral.moran', 'kiruthikaabalu181996', 'taymacnichols', 'dhodapp', 'nagihankececi', 'carlosvigo1997', 'moh.ashraf105', 'moontasirsoumik', 'baleko12345', 'ikhbal', 'afeefz', 'wanchin', 'kaustubh.shirpurkar', 'kie180031', 'bflores18', 'tdubnansky6', 'jorgecastelo5', 'andreadiazgar', 'david2397', 'bcperki2', 'melaniejkramer', 'rkchapman', 'jn1404', 'mateocampos', 'jzhan142', 'josepazmartin', 'brannon44', 'adfoz', 'avw2', 'youxing0309', 'scremin', 'lderemo', 'perezsarmar', 'ashutoshsinghhenry6', 'melroy_caeiro', 'viratbhatt007', 'fkl217', 'coderko3', 'alimatama', 'ammaralaa516', 'nadhnasorudin', 'adarsh123', 'jacquelinethardin', 'mjoza2', 'nihatyavuz', 'estebanrial', 'jinwoo2', 'adnanyuceer', 'danielfernandezcalo', 'berkaydean', 'cloudyoverhead', 'fred_dion', 'syedzakwan', 'e1150590', 'fcfrancapra94', 'kie180029', 'amiruldanial99', 'ozbunar01', 'alecorti.pardo', 'electronica18', 'nourananwar123', 'olivier.gilbert.paquet', 'anibarseghyan', 'amlibrahim', 'neuroque', 'kychui2', 'shaf31', 'hong_gao', 'paul.aniruddha', 'carlosbesadaromero', 'mohaballam', 'pip29', 'apb5472', 'tuberkargan', 'hafizmokh99', 'javierisma98', 'fathy1104', 'corredoira', 'helenalecoq97', 'kimzihuang', 'muteki', 'masitadonmez', 'nadja1', 'dancastaneda', 'ahmedsameh1698', 'rocio', 'mallen22', 'ffazul64', 'guoyao', 'ari6nd', 'kerryreto', 'macbelieve', 'pedrosiaba', 'michaelsaldana1', 'omarmagdy', 'vickytubio', 'ericrobles', 'soccadelic44', 'selena', 'aasifhameed99', 'damlakubattt', 'anxovidal8', 'exjamil', 'jahnavikachhia', 'joker632455', 'vincentpainchaud.vp', 'svo4321', 'zhixin2', 'yansi', 'asyrafaqil', 'xyz11', 'virajput299', 'ryanboucher', 'jpmcgee98', 'mariz', 'bhliu97', 'amrebrahim', 'abdulrahim2905', 'c.a.stupka', 'tonybocadillosgrandes', 'talwren', 'rxtodd', 'farah26', 'tss3', 'abieday1704', 'mavanzato0418', 'facundovia', 'cristinacigarran', 'nazimmath3', 'baohl2', 'ales.gajdacz', 'elad.d', 'kie180028', 'wahidiah52', 'kyang37', 'arifjalani99', 'lino13', 'jaimefookinlannister', 'physquig', 'adriancheah', 'jarodm2', 'noureldin1999', 'michael2010814', 'ckim123', 'eddin21', 'jipiccardi', 'prabuddha_888253127', 'david_atef', 'kalebhilde', 'magic_ocean99', 'yuchennn', 'saipraneett', 'sanchjai', 'omardeyaa', 'pingan99', 'aaq', 'alidsjt', 'mengkem2', 'haclarke', 'oishikfaruque', 'ilou', 'aengm', 'janalorenzolumbreras', 'hilisa', 'carlosvillar54', 'vikazvereva', 'm939454', 'va844', 'pablobou4', 'ludovick.begin', 'maniphysics09', 'eduard25252598', 'apascao', 'xosegq16', 'adam562', 'lauramolinosmayo', 'amni99', 'kie180702', 'saharoaf', 'redzuan11', 'ypp200', 'kph2', 'martinzapata', 'kirolosehab99', 'restep2', 'seifhabib', 'maramtarek53', 'zehuahe2', 'azizijazam11', 'marcosanllo', 'aimansyaz99', 'elizametias12', 'juanmacano97', 'aesaraismat', 'juneeee98', 'sparshagarwal1009', 'prakharbhargava0', 'njs035', 'alberfn', 'ramy_maged4', 'hmoulvi1', 'vanesagarcia', 'hf4', 'wowmuchchuck', 'mohammedemadeldin2000', 'gabrielyii', 'keerthisv', 'pythagoras2', 'xunyong', 'irenehb92', 'shradhap', 'mohameeddsamy', 'marianne.gratton.1', 'marcmagdy98', 'brknshn', 'gemma', 'lukunze1', 'caglanlee', 'desmondsoon', 'sebasket14', 'masonpb2', 'youssef2042000', 'retty8', 'bharath3', 'syin4', 'ethanmorse', 'ematson5897', 'jacobzeshleman', 'leejq', 'harshini9962', 'reemali99_', 'xxlilmontysignxx', 'ramonruiz.infor', 'atharva98', 'ahern0722', 'hishamzakaria20', 'cheokonn', 'adriangarea', 'jeanmichael.deschenes', 'samet1231234', 'mr4425', 'bluelobster', 'justin.lariviere.25', 'dcpang2', 'ashsaifullizan97', 'felivitullo87', 'puertarcd', 'farahsamir978', 'akozych2', 'nbs691', 'kie180073', 'anwar909', 'bleuminuit', 'atx203', 'kanet1234', 'sealseal', 'emrebuyukkose2', 'arrow823', 'mahafizuddin', 'dhvanil', 'nuanno97', 'dkshelat', 'mohabayman', 'ranasherif65', 'diamond92', 'ugur.cankaya.3718', 'ammareltalli', 'acn562', 'nabilah1403', 'yaseminablacandir', 'tamchouweng', 'ablahsaoud', 'sriharshap', 'mrefaat', 'bassamtarek', 'hamidausat', 'kakmeera1999', 'teoster50', 'nolmos96', 'abdurrahmn13', 'mmartinezsanchez', 'sandrabashara', 'zakhwan7', 'chengweiheng', 'nikalyaamani', 'acregodean', 'happyleexin', 'sarapl', 'williammitchell5818', None, 'rooban11', 'yeejou990318', 'kowjiajin', 'nihaosawaddee', 'maxernest', 'david.garrido', 'guibill10', 'mohamedsameh', 'spazos7', 'jazlilong', 'tmi211', 'kie180039', 'worldlineusaf', 'zahrajl124', 'mgk816', 'kie180079', 'ledicia97', 'movi205', 'shuming2']"
1,22,391,35,29,"['alidsjt', 'mcruces.fz', 'carlosbesadaromero', 'gemma', 'nuanno97', 'vblanco.nico', 'carlosvillar54', 'efrenhub', 'isabelmaria.vazquez', 'tonybocadillosgrandes', 'lauragdevesa', 'cristinacigarran', 'helenalecoq97', 'xosegq16', 'ramonruiz.infor', 'pedrosiaba', 'alimatama', 'acregodean', 'martin32', 'vickytubio', 'estebanrial', 'selena', 'juanmacano97', 'maxernest', 'david.peral.moran', 'alberfn', 'alecorti.pardo', 'electronica18', 'carlosvigo1997']",362,"['oliviercharbonneau', 'miri23', 'ozgurkablan26', 'loisonchambers', 'tuberkargan_97', 'pranjal3', 'musabmalek0717', 'nadanasser1199', 'siemprewowthechami', 'staceyn2', 'abbesalaeddine', 'ahmedamr', 'shorouk_ossama', 'rikardberger', 'alancantu57', 'luciano.brignone', 'rahimnoorj', 'janeneil88', 'guttsfulltyagi', 'mjgebara14', 'kartal', 'gabrielyii99', 'aboone06', 'saegner2', 'manuelsomoza94', 'amani12345', 'youssefsherif22', 'j.haliburton', 'amr_ua07', 'evrenyigit', 'tingliang', 'kirankumar94', 'ahagras13', 'njgale01', 'al4995', 'smrdafdl', 'travisc2', 'dlee145', 'stambo', 'anthonyroux', 'ryanorem', 'moh.bahaa', 'ahchehyan', 'aimanadnan', 'veronica.mieites', 's_coriolis', 'trkmengkay', 'cbecker413', 'latecnologiameodia', 'gxiao2', 'emilechouinard', 'je_guilbert', 'yubai', 'sinasigurpinar', 'muvafikmelikkaya', 'kason.carroll', 'jbaggie2019', 'annahaozheng0606', 'jtorres17', 'ahmedayman2370', 'zikrizaki88995', 'yjenyiee155', '46harunakgul', 'alifzulkifli99', 'kaitlinh', 'tyy233', 'sdehoyos47', 'malgaca', 'lsleed', 'khazanv2', 'alexisdixon6', 'gc_1', 'jinsup2', 'rishu', 'amparo.castro.96', 'tbryan', 'michael.mechelay', 'akash140410107098', 'nowapoca', 'onaam8', 'pablosaavedra', 'camilolcastro97', 'khor', 'ankit6257', 'samashraf1', 'benoiturcotte', 'aishu98', 'rileyroca', 'kiruthikaabalu181996', 'taymacnichols', 'dhodapp', 'nagihankececi', 'moh.ashraf105', 'baleko12345', 'ikhbal', 'afeefz', 'kaustubh.shirpurkar', 'kie180031', 'bflores18', 'tdubnansky6', 'jorgecastelo5', 'andreadiazgar', 'david2397', 'bcperki2', 'melaniejkramer', 'rkchapman', 'jn1404', 'mateocampos', 'jzhan142', 'josepazmartin', 'brannon44', 'adfoz', 'avw2', 'youxing0309', 'scremin', 'lderemo', 'perezsarmar', 'ashutoshsinghhenry6', 'melroy_caeiro', 'viratbhatt007', 'fkl217', 'coderko3', 'ammaralaa516', 'nadhnasorudin', 'adarsh123', 'jacquelinethardin', 'mjoza2', 'nihatyavuz', 'jinwoo2', 'adnanyuceer', 'danielfernandezcalo', 'berkaydean', 'cloudyoverhead', 'fred_dion', 'syedzakwan', 'e1150590', 'fcfrancapra94', 'amiruldanial99', 'ozbunar01', 'nourananwar123', 'olivier.gilbert.paquet', 'anibarseghyan', 'amlibrahim', 'neuroque', 'kychui2', 'shaf31', 'hong_gao', 'paul.aniruddha', 'mohaballam', 'pip29', 'apb5472', 'tuberkargan', 'hafizmokh99', 'javierisma98', 'fathy1104', 'corredoira', 'kimzihuang', 'muteki', 'masitadonmez', 'nadja1', 'dancastaneda', 'ahmedsameh1698', 'rocio', 'mallen22', 'ffazul64', 'guoyao', 'ari6nd', 'kerryreto', 'michaelsaldana1', 'omarmagdy', 'ericrobles', 'soccadelic44', 'aasifhameed99', 'damlakubattt', 'anxovidal8', 'exjamil', 'jahnavikachhia', 'joker632455', 'vincentpainchaud.vp', 'svo4321', 'zhixin2', 'yansi', 'asyrafaqil', 'xyz11', 'virajput299', 'ryanboucher', 'jpmcgee98', 'mariz', 'bhliu97', 'amrebrahim', 'abdulrahim2905', 'c.a.stupka', 'talwren', 'rxtodd', 'farah26', 'tss3', 'abieday1704', 'mavanzato0418', 'facundovia', 'nazimmath3', 'baohl2', 'ales.gajdacz', 'elad.d', 'kie180028', 'wahidiah52', 'kyang37', 'arifjalani99', 'lino13', 'jaimefookinlannister', 'physquig', 'adriancheah', 'jarodm2', 'noureldin1999', 'michael2010814', 'ckim123', 'eddin21', 'jipiccardi', 'prabuddha_888253127', 'david_atef', 'kalebhilde', 'magic_ocean99', 'saipraneett', 'sanchjai', 'omardeyaa', 'pingan99', 'aaq', 'mengkem2', 'haclarke', 'oishikfaruque', 'ilou', 'aengm', 'janalorenzolumbreras', 'hilisa', 'vikazvereva', 'm939454', 'va844', 'pablobou4', 'ludovick.begin', 'maniphysics09', 'eduard25252598', 'apascao', 'adam562', 'lauramolinosmayo', 'amni99', 'kie180702', 'saharoaf', 'redzuan11', 'ypp200', 'kph2', 'martinzapata', 'kirolosehab99', 'restep2', 'seifhabib', 'maramtarek53', 'zehuahe2', 'azizijazam11', 'marcosanllo', 'aimansyaz99', 'elizametias12', 'sparshagarwal1009', 'prakharbhargava0', 'njs035', 'ramy_maged4', 'hmoulvi1', 'vanesagarcia', 'hf4', 'wowmuchchuck', 'mohammedemadeldin2000', 'gabrielyii', 'keerthisv', 'pythagoras2', 'xunyong', 'irenehb92', 'shradhap', 'mohameeddsamy', 'marianne.gratton.1', 'marcmagdy98', 'brknshn', 'lukunze1', 'caglanlee', 'desmondsoon', 'sebasket14', 'masonpb2', 'youssef2042000', 'retty8', 'bharath3', 'syin4', 'ethanmorse', 'ematson5897', 'jacobzeshleman', 'leejq', 'harshini9962', 'reemali99_', 'xxlilmontysignxx', 'atharva98', 'ahern0722', 'hishamzakaria20', 'cheokonn', 'adriangarea', 'jeanmichael.deschenes', 'samet1231234', 'mr4425', 'bluelobster', 'justin.lariviere.25', 'dcpang2', 'felivitullo87', 'puertarcd', 'farahsamir978', 'akozych2', 'nbs691', 'kie180073', 'anwar909', 'bleuminuit', 'atx203', 'kanet1234', 'sealseal', 'emrebuyukkose2', 'arrow823', 'dhvanil', 'dkshelat', 'mohabayman', 'ranasherif65', 'diamond92', 'ugur.cankaya.3718', 'ammareltalli', 'acn562', 'nabilah1403', 'yaseminablacandir', 'tamchouweng', 'ablahsaoud', 'sriharshap', 'mrefaat', 'bassamtarek', 'hamidausat', 'kakmeera1999', 'teoster50', 'nolmos96', 'abdurrahmn13', 'mmartinezsanchez', 'sandrabashara', 'zakhwan7', 'chengweiheng', 'nikalyaamani', 'happyleexin', 'sarapl', 'williammitchell5818', 'rooban11', 'yeejou990318', 'kowjiajin', 'nihaosawaddee', 'david.garrido', 'guibill10', 'mohamedsameh', 'spazos7', 'tmi211', 'kie180039', 'worldlineusaf', 'mgk816', 'kie180079', 'ledicia97', 'movi205', 'shuming2']",6,"['dokun', 'dfl', 'antonio25', 'hermidaitor', 'iago', None]",397,"['oliviercharbonneau', 'miri23', 'ozgurkablan26', 'loisonchambers', 'tuberkargan_97', 'pranjal3', 'musabmalek0717', 'nadanasser1199', 'siemprewowthechami', 'staceyn2', 'vblanco.nico', 'abbesalaeddine', 'efrenhub', 'isabelmaria.vazquez', 'ahmedamr', 'shorouk_ossama', 'rikardberger', 'alancantu57', 'luciano.brignone', 'rahimnoorj', 'janeneil88', 'guttsfulltyagi', 'mjgebara14', 'kartal', 'gabrielyii99', 'aboone06', 'saegner2', 'manuelsomoza94', 'amani12345', 'youssefsherif22', 'j.haliburton', 'amr_ua07', 'evrenyigit', 'tingliang', 'kirankumar94', 'ahagras13', 'njgale01', 'al4995', 'smrdafdl', 'travisc2', 'dlee145', 'stambo', 'anthonyroux', 'ryanorem', 'moh.bahaa', 'ahchehyan', 'aimanadnan', 'veronica.mieites', 's_coriolis', 'trkmengkay', 'cbecker413', 'mcruces.fz', 'latecnologiameodia', 'gxiao2', 'emilechouinard', 'je_guilbert', 'yubai', 'sinasigurpinar', 'lauragdevesa', 'muvafikmelikkaya', 'kason.carroll', 'jbaggie2019', 'annahaozheng0606', 'jtorres17', 'ahmedayman2370', 'zikrizaki88995', 'yjenyiee155', '46harunakgul', 'alifzulkifli99', 'kaitlinh', 'tyy233', 'sdehoyos47', 'malgaca', 'lsleed', 'khazanv2', 'alexisdixon6', 'gc_1', 'jinsup2', 'rishu', 'amparo.castro.96', 'tbryan', 'martin32', 'michael.mechelay', 'akash140410107098', 'nowapoca', 'onaam8', 'pablosaavedra', 'camilolcastro97', 'khor', 'ankit6257', 'samashraf1', 'benoiturcotte', 'aishu98', 'rileyroca', 'david.peral.moran', 'kiruthikaabalu181996', 'taymacnichols', 'dhodapp', 'hermidaitor', 'nagihankececi', 'carlosvigo1997', 'moh.ashraf105', 'baleko12345', 'ikhbal', 'afeefz', 'kaustubh.shirpurkar', 'kie180031', 'bflores18', 'tdubnansky6', 'jorgecastelo5', 'andreadiazgar', 'david2397', 'bcperki2', 'melaniejkramer', 'rkchapman', 'jn1404', 'mateocampos', 'jzhan142', 'josepazmartin', 'brannon44', 'adfoz', 'avw2', 'youxing0309', 'scremin', 'lderemo', 'perezsarmar', 'ashutoshsinghhenry6', 'melroy_caeiro', 'viratbhatt007', 'fkl217', 'coderko3', 'alimatama', 'ammaralaa516', 'nadhnasorudin', 'adarsh123', 'jacquelinethardin', 'mjoza2', 'nihatyavuz', 'estebanrial', 'jinwoo2', 'adnanyuceer', 'danielfernandezcalo', 'berkaydean', 'cloudyoverhead', 'fred_dion', 'syedzakwan', 'e1150590', 'fcfrancapra94', 'amiruldanial99', 'ozbunar01', 'alecorti.pardo', 'electronica18', 'nourananwar123', 'olivier.gilbert.paquet', 'anibarseghyan', 'amlibrahim', 'neuroque', 'kychui2', 'shaf31', 'hong_gao', 'paul.aniruddha', 'carlosbesadaromero', 'mohaballam', 'pip29', 'apb5472', 'tuberkargan', 'hafizmokh99', 'javierisma98', 'fathy1104', 'corredoira', 'helenalecoq97', 'kimzihuang', 'muteki', 'iago', 'masitadonmez', 'nadja1', 'dancastaneda', 'ahmedsameh1698', 'rocio', 'mallen22', 'ffazul64', 'guoyao', 'ari6nd', 'kerryreto', 'pedrosiaba', 'michaelsaldana1', 'omarmagdy', 'vickytubio', 'ericrobles', 'soccadelic44', 'selena', 'aasifhameed99', 'damlakubattt', 'anxovidal8', 'exjamil', 'jahnavikachhia', 'joker632455', 'vincentpainchaud.vp', 'svo4321', 'zhixin2', 'yansi', 'asyrafaqil', 'xyz11', 'virajput299', 'ryanboucher', 'jpmcgee98', 'mariz', 'bhliu97', 'amrebrahim', 'abdulrahim2905', 'c.a.stupka', 'tonybocadillosgrandes', 'talwren', 'rxtodd', 'dokun', 'antonio25', 'farah26', 'tss3', 'abieday1704', 'mavanzato0418', 'facundovia', 'cristinacigarran', 'nazimmath3', 'baohl2', 'ales.gajdacz', 'elad.d', 'kie180028', 'wahidiah52', 'kyang37', 'arifjalani99', 'lino13', 'jaimefookinlannister', 'physquig', 'adriancheah', 'jarodm2', 'noureldin1999', 'michael2010814', 'ckim123', 'eddin21', 'jipiccardi', 'prabuddha_888253127', 'david_atef', 'kalebhilde', 'magic_ocean99', 'saipraneett', 'sanchjai', 'omardeyaa', 'pingan99', 'aaq', 'alidsjt', 'mengkem2', 'haclarke', 'oishikfaruque', 'ilou', 'aengm', 'janalorenzolumbreras', 'hilisa', 'carlosvillar54', 'vikazvereva', 'm939454', 'va844', 'pablobou4', 'ludovick.begin', 'maniphysics09', 'eduard25252598', 'apascao', 'xosegq16', 'adam562', 'lauramolinosmayo', 'amni99', 'kie180702', 'saharoaf', 'redzuan11', 'ypp200', 'kph2', 'martinzapata', 'kirolosehab99', 'restep2', 'seifhabib', 'maramtarek53', 'zehuahe2', 'azizijazam11', 'marcosanllo', 'aimansyaz99', 'elizametias12', 'juanmacano97', 'sparshagarwal1009', 'prakharbhargava0', 'njs035', 'alberfn', 'ramy_maged4', 'hmoulvi1', 'vanesagarcia', 'hf4', 'wowmuchchuck', 'mohammedemadeldin2000', 'gabrielyii', 'keerthisv', 'pythagoras2', 'xunyong', 'irenehb92', 'shradhap', 'mohameeddsamy', 'marianne.gratton.1', 'marcmagdy98', 'brknshn', 'gemma', 'lukunze1', 'caglanlee', 'desmondsoon', 'sebasket14', 'masonpb2', 'youssef2042000', 'retty8', 'bharath3', 'syin4', 'ethanmorse', 'ematson5897', 'jacobzeshleman', 'leejq', 'harshini9962', 'reemali99_', 'xxlilmontysignxx', 'ramonruiz.infor', 'atharva98', 'ahern0722', 'hishamzakaria20', 'cheokonn', 'adriangarea', 'jeanmichael.deschenes', 'samet1231234', 'mr4425', 'bluelobster', 'justin.lariviere.25', 'dcpang2', 'felivitullo87', 'puertarcd', 'farahsamir978', 'akozych2', 'nbs691', 'kie180073', 'anwar909', 'bleuminuit', 'atx203', 'kanet1234', 'sealseal', 'emrebuyukkose2', 'arrow823', 'dhvanil', 'nuanno97', 'dkshelat', 'mohabayman', 'ranasherif65', 'diamond92', 'ugur.cankaya.3718', 'ammareltalli', 'acn562', 'nabilah1403', 'yaseminablacandir', 'tamchouweng', 'ablahsaoud', 'sriharshap', 'mrefaat', 'bassamtarek', 'hamidausat', 'kakmeera1999', 'teoster50', 'nolmos96', 'abdurrahmn13', 'mmartinezsanchez', 'sandrabashara', 'zakhwan7', 'chengweiheng', 'nikalyaamani', 'acregodean', 'happyleexin', 'sarapl', 'williammitchell5818', None, 'rooban11', 'yeejou990318', 'kowjiajin', 'nihaosawaddee', 'maxernest', 'dfl', 'david.garrido', 'guibill10', 'mohamedsameh', 'spazos7', 'tmi211', 'kie180039', 'worldlineusaf', 'mgk816', 'kie180079', 'ledicia97', 'movi205', 'shuming2']"
1,24,391,28,16,"['trkmengkay', 'adnanyuceer', 'tuberkargan', 'damlakubattt', 'tuberkargan_97', 'yaseminablacandir', 'emrebuyukkose2', 'samet1231234', '46harunakgul', 'ozbunar01', 'nagihankececi', 'ugur.cankaya.3718', 'mgk816', 'caglanlee', 'muvafikmelikkaya', 'nihatyavuz']",375,"['oliviercharbonneau', 'miri23', 'ozgurkablan26', 'loisonchambers', 'pranjal3', 'musabmalek0717', 'nadanasser1199', 'siemprewowthechami', 'staceyn2', 'vblanco.nico', 'abbesalaeddine', 'efrenhub', 'isabelmaria.vazquez', 'ahmedamr', 'shorouk_ossama', 'rikardberger', 'alancantu57', 'luciano.brignone', 'rahimnoorj', 'janeneil88', 'guttsfulltyagi', 'mjgebara14', 'kartal', 'gabrielyii99', 'aboone06', 'saegner2', 'manuelsomoza94', 'amani12345', 'youssefsherif22', 'j.haliburton', 'amr_ua07', 'evrenyigit', 'tingliang', 'kirankumar94', 'ahagras13', 'njgale01', 'al4995', 'smrdafdl', 'travisc2', 'dlee145', 'stambo', 'anthonyroux', 'ryanorem', 'moh.bahaa', 'ahchehyan', 'aimanadnan', 'veronica.mieites', 's_coriolis', 'cbecker413', 'mcruces.fz', 'latecnologiameodia', 'gxiao2', 'emilechouinard', 'je_guilbert', 'yubai', 'sinasigurpinar', 'lauragdevesa', 'kason.carroll', 'jbaggie2019', 'annahaozheng0606', 'jtorres17', 'ahmedayman2370', 'zikrizaki88995', 'yjenyiee155', 'alifzulkifli99', 'kaitlinh', 'tyy233', 'sdehoyos47', 'malgaca', 'lsleed', 'khazanv2', 'alexisdixon6', 'gc_1', 'jinsup2', 'rishu', 'amparo.castro.96', 'tbryan', 'martin32', 'michael.mechelay', 'akash140410107098', 'nowapoca', 'onaam8', 'pablosaavedra', 'camilolcastro97', 'khor', 'ankit6257', 'samashraf1', 'benoiturcotte', 'aishu98', 'rileyroca', 'david.peral.moran', 'kiruthikaabalu181996', 'taymacnichols', 'dhodapp', 'carlosvigo1997', 'moh.ashraf105', 'baleko12345', 'ikhbal', 'afeefz', 'kaustubh.shirpurkar', 'kie180031', 'bflores18', 'tdubnansky6', 'jorgecastelo5', 'andreadiazgar', 'david2397', 'bcperki2', 'melaniejkramer', 'rkchapman', 'jn1404', 'mateocampos', 'jzhan142', 'josepazmartin', 'brannon44', 'adfoz', 'avw2', 'youxing0309', 'scremin', 'lderemo', 'perezsarmar', 'ashutoshsinghhenry6', 'melroy_caeiro', 'viratbhatt007', 'fkl217', 'coderko3', 'alimatama', 'ammaralaa516', 'nadhnasorudin', 'adarsh123', 'jacquelinethardin', 'mjoza2', 'estebanrial', 'jinwoo2', 'danielfernandezcalo', 'berkaydean', 'cloudyoverhead', 'fred_dion', 'syedzakwan', 'e1150590', 'fcfrancapra94', 'amiruldanial99', 'alecorti.pardo', 'electronica18', 'nourananwar123', 'olivier.gilbert.paquet', 'anibarseghyan', 'amlibrahim', 'neuroque', 'kychui2', 'shaf31', 'hong_gao', 'paul.aniruddha', 'carlosbesadaromero', 'mohaballam', 'pip29', 'apb5472', 'hafizmokh99', 'javierisma98', 'fathy1104', 'corredoira', 'helenalecoq97', 'kimzihuang', 'muteki', 'masitadonmez', 'nadja1', 'dancastaneda', 'ahmedsameh1698', 'rocio', 'mallen22', 'ffazul64', 'guoyao', 'ari6nd', 'kerryreto', 'pedrosiaba', 'michaelsaldana1', 'omarmagdy', 'vickytubio', 'ericrobles', 'soccadelic44', 'selena', 'aasifhameed99', 'anxovidal8', 'exjamil', 'jahnavikachhia', 'joker632455', 'vincentpainchaud.vp', 'svo4321', 'zhixin2', 'yansi', 'asyrafaqil', 'xyz11', 'virajput299', 'ryanboucher', 'jpmcgee98', 'mariz', 'bhliu97', 'amrebrahim', 'abdulrahim2905', 'c.a.stupka', 'tonybocadillosgrandes', 'talwren', 'rxtodd', 'farah26', 'tss3', 'abieday1704', 'mavanzato0418', 'facundovia', 'cristinacigarran', 'nazimmath3', 'baohl2', 'ales.gajdacz', 'elad.d', 'kie180028', 'wahidiah52', 'kyang37', 'arifjalani99', 'lino13', 'jaimefookinlannister', 'physquig', 'adriancheah', 'jarodm2', 'noureldin1999', 'michael2010814', 'ckim123', 'eddin21', 'jipiccardi', 'prabuddha_888253127', 'david_atef', 'kalebhilde', 'magic_ocean99', 'saipraneett', 'sanchjai', 'omardeyaa', 'pingan99', 'aaq', 'alidsjt', 'mengkem2', 'haclarke', 'oishikfaruque', 'ilou', 'aengm', 'janalorenzolumbreras', 'hilisa', 'carlosvillar54', 'vikazvereva', 'm939454', 'va844', 'pablobou4', 'ludovick.begin', 'maniphysics09', 'eduard25252598', 'apascao', 'xosegq16', 'adam562', 'lauramolinosmayo', 'amni99', 'kie180702', 'saharoaf', 'redzuan11', 'ypp200', 'kph2', 'martinzapata', 'kirolosehab99', 'restep2', 'seifhabib', 'maramtarek53', 'zehuahe2', 'azizijazam11', 'marcosanllo', 'aimansyaz99', 'elizametias12', 'juanmacano97', 'sparshagarwal1009', 'prakharbhargava0', 'njs035', 'alberfn', 'ramy_maged4', 'hmoulvi1', 'vanesagarcia', 'hf4', 'wowmuchchuck', 'mohammedemadeldin2000', 'gabrielyii', 'keerthisv', 'pythagoras2', 'xunyong', 'irenehb92', 'shradhap', 'mohameeddsamy', 'marianne.gratton.1', 'marcmagdy98', 'brknshn', 'gemma', 'lukunze1', 'desmondsoon', 'sebasket14', 'masonpb2', 'youssef2042000', 'retty8', 'bharath3', 'syin4', 'ethanmorse', 'ematson5897', 'jacobzeshleman', 'leejq', 'harshini9962', 'reemali99_', 'xxlilmontysignxx', 'ramonruiz.infor', 'atharva98', 'ahern0722', 'hishamzakaria20', 'cheokonn', 'adriangarea', 'jeanmichael.deschenes', 'mr4425', 'bluelobster', 'justin.lariviere.25', 'dcpang2', 'felivitullo87', 'puertarcd', 'farahsamir978', 'akozych2', 'nbs691', 'kie180073', 'anwar909', 'bleuminuit', 'atx203', 'kanet1234', 'sealseal', 'arrow823', 'dhvanil', 'nuanno97', 'dkshelat', 'mohabayman', 'ranasherif65', 'diamond92', 'ammareltalli', 'acn562', 'nabilah1403', 'tamchouweng', 'ablahsaoud', 'sriharshap', 'mrefaat', 'bassamtarek', 'hamidausat', 'kakmeera1999', 'teoster50', 'nolmos96', 'abdurrahmn13', 'mmartinezsanchez', 'sandrabashara', 'zakhwan7', 'chengweiheng', 'nikalyaamani', 'acregodean', 'happyleexin', 'sarapl', 'williammitchell5818', 'rooban11', 'yeejou990318', 'kowjiajin', 'nihaosawaddee', 'maxernest', 'david.garrido', 'guibill10', 'mohamedsameh', 'spazos7', 'tmi211', 'kie180039', 'worldlineusaf', 'kie180079', 'ledicia97', 'movi205', 'shuming2']",12,"['furcoskuner', 'frknznkr', 'oakbulut1997', 'e.erkul6060', 'mevradilanerten', 'fdirisaglik', 'abdurrahmn15', 'furkanefeyuceer', 'kganozcan', 'metehanmustafayalcin', None, 'davuteee']",403,"['oliviercharbonneau', 'miri23', 'ozgurkablan26', 'loisonchambers', 'tuberkargan_97', 'pranjal3', 'musabmalek0717', 'nadanasser1199', 'siemprewowthechami', 'staceyn2', 'vblanco.nico', 'abbesalaeddine', 'efrenhub', 'isabelmaria.vazquez', 'ahmedamr', 'shorouk_ossama', 'rikardberger', 'alancantu57', 'luciano.brignone', 'rahimnoorj', 'janeneil88', 'guttsfulltyagi', 'mjgebara14', 'kartal', 'gabrielyii99', 'aboone06', 'saegner2', 'manuelsomoza94', 'amani12345', 'youssefsherif22', 'j.haliburton', 'amr_ua07', 'evrenyigit', 'tingliang', 'kirankumar94', 'ahagras13', 'njgale01', 'al4995', 'smrdafdl', 'travisc2', 'dlee145', 'stambo', 'anthonyroux', 'ryanorem', 'moh.bahaa', 'ahchehyan', 'aimanadnan', 'veronica.mieites', 'furkanefeyuceer', 'metehanmustafayalcin', 's_coriolis', 'trkmengkay', 'cbecker413', 'mcruces.fz', 'latecnologiameodia', 'gxiao2', 'emilechouinard', 'je_guilbert', 'yubai', 'sinasigurpinar', 'lauragdevesa', 'muvafikmelikkaya', 'kason.carroll', 'jbaggie2019', 'annahaozheng0606', 'jtorres17', 'ahmedayman2370', 'zikrizaki88995', 'yjenyiee155', '46harunakgul', 'alifzulkifli99', 'kaitlinh', 'tyy233', 'sdehoyos47', 'davuteee', 'malgaca', 'lsleed', 'khazanv2', 'alexisdixon6', 'gc_1', 'jinsup2', 'rishu', 'amparo.castro.96', 'tbryan', 'martin32', 'michael.mechelay', 'akash140410107098', 'nowapoca', 'onaam8', 'pablosaavedra', 'camilolcastro97', 'khor', 'ankit6257', 'samashraf1', 'benoiturcotte', 'aishu98', 'rileyroca', 'david.peral.moran', 'kiruthikaabalu181996', 'taymacnichols', 'dhodapp', 'nagihankececi', 'carlosvigo1997', 'moh.ashraf105', 'baleko12345', 'ikhbal', 'afeefz', 'kaustubh.shirpurkar', 'kie180031', 'bflores18', 'tdubnansky6', 'jorgecastelo5', 'andreadiazgar', 'david2397', 'bcperki2', 'melaniejkramer', 'rkchapman', 'jn1404', 'mateocampos', 'jzhan142', 'josepazmartin', 'brannon44', 'adfoz', 'avw2', 'youxing0309', 'scremin', 'lderemo', 'perezsarmar', 'ashutoshsinghhenry6', 'melroy_caeiro', 'viratbhatt007', 'oakbulut1997', 'fkl217', 'coderko3', 'alimatama', 'ammaralaa516', 'nadhnasorudin', 'adarsh123', 'jacquelinethardin', 'mjoza2', 'nihatyavuz', 'estebanrial', 'jinwoo2', 'adnanyuceer', 'danielfernandezcalo', 'berkaydean', 'cloudyoverhead', 'fred_dion', 'syedzakwan', 'e1150590', 'fcfrancapra94', 'amiruldanial99', 'ozbunar01', 'alecorti.pardo', 'electronica18', 'abdurrahmn15', 'nourananwar123', 'olivier.gilbert.paquet', 'anibarseghyan', 'amlibrahim', 'neuroque', 'kychui2', 'shaf31', 'hong_gao', 'e.erkul6060', 'paul.aniruddha', 'carlosbesadaromero', 'mevradilanerten', 'mohaballam', 'pip29', 'apb5472', 'tuberkargan', 'hafizmokh99', 'javierisma98', 'fathy1104', 'corredoira', 'helenalecoq97', 'kimzihuang', 'muteki', 'masitadonmez', 'nadja1', 'dancastaneda', 'ahmedsameh1698', 'rocio', 'mallen22', 'ffazul64', 'guoyao', 'ari6nd', 'kerryreto', 'frknznkr', 'pedrosiaba', 'michaelsaldana1', 'omarmagdy', 'vickytubio', 'ericrobles', 'soccadelic44', 'selena', 'aasifhameed99', 'damlakubattt', 'anxovidal8', 'exjamil', 'jahnavikachhia', 'joker632455', 'vincentpainchaud.vp', 'svo4321', 'zhixin2', 'yansi', 'asyrafaqil', 'xyz11', 'virajput299', 'ryanboucher', 'jpmcgee98', 'mariz', 'bhliu97', 'amrebrahim', 'abdulrahim2905', 'c.a.stupka', 'tonybocadillosgrandes', 'talwren', 'rxtodd', 'farah26', 'tss3', 'abieday1704', 'mavanzato0418', 'facundovia', 'cristinacigarran', 'nazimmath3', 'baohl2', 'ales.gajdacz', 'elad.d', 'kie180028', 'wahidiah52', 'kyang37', 'arifjalani99', 'lino13', 'jaimefookinlannister', 'physquig', 'adriancheah', 'jarodm2', 'noureldin1999', 'michael2010814', 'ckim123', 'eddin21', 'jipiccardi', 'prabuddha_888253127', 'david_atef', 'kalebhilde', 'magic_ocean99', 'saipraneett', 'sanchjai', 'omardeyaa', 'pingan99', 'aaq', 'alidsjt', 'mengkem2', 'haclarke', 'oishikfaruque', 'ilou', 'aengm', 'janalorenzolumbreras', 'hilisa', 'carlosvillar54', 'vikazvereva', 'm939454', 'va844', 'pablobou4', 'ludovick.begin', 'maniphysics09', 'eduard25252598', 'apascao', 'xosegq16', 'adam562', 'lauramolinosmayo', 'amni99', 'kie180702', 'saharoaf', 'redzuan11', 'ypp200', 'kph2', 'martinzapata', 'kirolosehab99', 'restep2', 'seifhabib', 'maramtarek53', 'zehuahe2', 'azizijazam11', 'marcosanllo', 'aimansyaz99', 'elizametias12', 'juanmacano97', 'sparshagarwal1009', 'prakharbhargava0', 'njs035', 'alberfn', 'ramy_maged4', 'hmoulvi1', 'vanesagarcia', 'hf4', 'wowmuchchuck', 'mohammedemadeldin2000', 'gabrielyii', 'keerthisv', 'pythagoras2', 'xunyong', 'irenehb92', 'shradhap', 'mohameeddsamy', 'marianne.gratton.1', 'marcmagdy98', 'brknshn', 'gemma', 'lukunze1', 'kganozcan', 'caglanlee', 'desmondsoon', 'furcoskuner', 'sebasket14', 'masonpb2', 'youssef2042000', 'retty8', 'bharath3', 'syin4', 'ethanmorse', 'ematson5897', 'jacobzeshleman', 'leejq', 'harshini9962', 'reemali99_', 'xxlilmontysignxx', 'ramonruiz.infor', 'atharva98', 'ahern0722', 'hishamzakaria20', 'cheokonn', 'adriangarea', 'jeanmichael.deschenes', 'samet1231234', 'fdirisaglik', 'mr4425', 'bluelobster', 'justin.lariviere.25', 'dcpang2', 'felivitullo87', 'puertarcd', 'farahsamir978', 'akozych2', 'nbs691', 'kie180073', 'anwar909', 'bleuminuit', 'atx203', 'kanet1234', 'sealseal', 'emrebuyukkose2', 'arrow823', 'dhvanil', 'nuanno97', 'dkshelat', 'mohabayman', 'ranasherif65', 'diamond92', 'ugur.cankaya.3718', 'ammareltalli', 'acn562', 'nabilah1403', 'yaseminablacandir', 'tamchouweng', 'ablahsaoud', 'sriharshap', 'mrefaat', 'bassamtarek', 'hamidausat', 'kakmeera1999', 'teoster50', 'nolmos96', 'abdurrahmn13', 'mmartinezsanchez', 'sandrabashara', 'zakhwan7', 'chengweiheng', 'nikalyaamani', 'acregodean', 'happyleexin', 'sarapl', 'williammitchell5818', None, 'rooban11', 'yeejou990318', 'kowjiajin', 'nihaosawaddee', 'maxernest', 'david.garrido', 'guibill10', 'mohamedsameh', 'spazos7', 'tmi211', 'kie180039', 'worldlineusaf', 'mgk816', 'kie180079', 'ledicia97', 'movi205', 'shuming2']"
1,28,391,22,20,"['oliviercharbonneau', 'bleuminuit', 'marianne.gratton.1', 'emilechouinard', 'je_guilbert', 'sebasket14', 'ludovick.begin', 'gc_1', 'jeanmichael.deschenes', 'physquig', 'justin.lariviere.25', 'benoiturcotte', 'cloudyoverhead', 'anthonyroux', 'fred_dion', 'guibill10', 'vincentpainchaud.vp', 'olivier.gilbert.paquet', 'pythagoras2', 's_coriolis']",371,"['miri23', 'ozgurkablan26', 'loisonchambers', 'tuberkargan_97', 'pranjal3', 'musabmalek0717', 'nadanasser1199', 'siemprewowthechami', 'staceyn2', 'vblanco.nico', 'abbesalaeddine', 'efrenhub', 'isabelmaria.vazquez', 'ahmedamr', 'shorouk_ossama', 'rikardberger', 'alancantu57', 'luciano.brignone', 'rahimnoorj', 'janeneil88', 'guttsfulltyagi', 'mjgebara14', 'kartal', 'gabrielyii99', 'aboone06', 'saegner2', 'manuelsomoza94', 'amani12345', 'youssefsherif22', 'j.haliburton', 'amr_ua07', 'evrenyigit', 'tingliang', 'kirankumar94', 'ahagras13', 'njgale01', 'al4995', 'smrdafdl', 'travisc2', 'dlee145', 'stambo', 'ryanorem', 'moh.bahaa', 'ahchehyan', 'aimanadnan', 'veronica.mieites', 'trkmengkay', 'cbecker413', 'mcruces.fz', 'latecnologiameodia', 'gxiao2', 'yubai', 'sinasigurpinar', 'lauragdevesa', 'muvafikmelikkaya', 'kason.carroll', 'jbaggie2019', 'annahaozheng0606', 'jtorres17', 'ahmedayman2370', 'zikrizaki88995', 'yjenyiee155', '46harunakgul', 'alifzulkifli99', 'kaitlinh', 'tyy233', 'sdehoyos47', 'malgaca', 'lsleed', 'khazanv2', 'alexisdixon6', 'jinsup2', 'rishu', 'amparo.castro.96', 'tbryan', 'martin32', 'michael.mechelay', 'akash140410107098', 'nowapoca', 'onaam8', 'pablosaavedra', 'camilolcastro97', 'khor', 'ankit6257', 'samashraf1', 'aishu98', 'rileyroca', 'david.peral.moran', 'kiruthikaabalu181996', 'taymacnichols', 'dhodapp', 'nagihankececi', 'carlosvigo1997', 'moh.ashraf105', 'baleko12345', 'ikhbal', 'afeefz', 'kaustubh.shirpurkar', 'kie180031', 'bflores18', 'tdubnansky6', 'jorgecastelo5', 'andreadiazgar', 'david2397', 'bcperki2', 'melaniejkramer', 'rkchapman', 'jn1404', 'mateocampos', 'jzhan142', 'josepazmartin', 'brannon44', 'adfoz', 'avw2', 'youxing0309', 'scremin', 'lderemo', 'perezsarmar', 'ashutoshsinghhenry6', 'melroy_caeiro', 'viratbhatt007', 'fkl217', 'coderko3', 'alimatama', 'ammaralaa516', 'nadhnasorudin', 'adarsh123', 'jacquelinethardin', 'mjoza2', 'nihatyavuz', 'estebanrial', 'jinwoo2', 'adnanyuceer', 'danielfernandezcalo', 'berkaydean', 'syedzakwan', 'e1150590', 'fcfrancapra94', 'amiruldanial99', 'ozbunar01', 'alecorti.pardo', 'electronica18', 'nourananwar123', 'anibarseghyan', 'amlibrahim', 'neuroque', 'kychui2', 'shaf31', 'hong_gao', 'paul.aniruddha', 'carlosbesadaromero', 'mohaballam', 'pip29', 'apb5472', 'tuberkargan', 'hafizmokh99', 'javierisma98', 'fathy1104', 'corredoira', 'helenalecoq97', 'kimzihuang', 'muteki', 'masitadonmez', 'nadja1', 'dancastaneda', 'ahmedsameh1698', 'rocio', 'mallen22', 'ffazul64', 'guoyao', 'ari6nd', 'kerryreto', 'pedrosiaba', 'michaelsaldana1', 'omarmagdy', 'vickytubio', 'ericrobles', 'soccadelic44', 'selena', 'aasifhameed99', 'damlakubattt', 'anxovidal8', 'exjamil', 'jahnavikachhia', 'joker632455', 'svo4321', 'zhixin2', 'yansi', 'asyrafaqil', 'xyz11', 'virajput299', 'ryanboucher', 'jpmcgee98', 'mariz', 'bhliu97', 'amrebrahim', 'abdulrahim2905', 'c.a.stupka', 'tonybocadillosgrandes', 'talwren', 'rxtodd', 'farah26', 'tss3', 'abieday1704', 'mavanzato0418', 'facundovia', 'cristinacigarran', 'nazimmath3', 'baohl2', 'ales.gajdacz', 'elad.d', 'kie180028', 'wahidiah52', 'kyang37', 'arifjalani99', 'lino13', 'jaimefookinlannister', 'adriancheah', 'jarodm2', 'noureldin1999', 'michael2010814', 'ckim123', 'eddin21', 'jipiccardi', 'prabuddha_888253127', 'david_atef', 'kalebhilde', 'magic_ocean99', 'saipraneett', 'sanchjai', 'omardeyaa', 'pingan99', 'aaq', 'alidsjt', 'mengkem2', 'haclarke', 'oishikfaruque', 'ilou', 'aengm', 'janalorenzolumbreras', 'hilisa', 'carlosvillar54', 'vikazvereva', 'm939454', 'va844', 'pablobou4', 'maniphysics09', 'eduard25252598', 'apascao', 'xosegq16', 'adam562', 'lauramolinosmayo', 'amni99', 'kie180702', 'saharoaf', 'redzuan11', 'ypp200', 'kph2', 'martinzapata', 'kirolosehab99', 'restep2', 'seifhabib', 'maramtarek53', 'zehuahe2', 'azizijazam11', 'marcosanllo', 'aimansyaz99', 'elizametias12', 'juanmacano97', 'sparshagarwal1009', 'prakharbhargava0', 'njs035', 'alberfn', 'ramy_maged4', 'hmoulvi1', 'vanesagarcia', 'hf4', 'wowmuchchuck', 'mohammedemadeldin2000', 'gabrielyii', 'keerthisv', 'xunyong', 'irenehb92', 'shradhap', 'mohameeddsamy', 'marcmagdy98', 'brknshn', 'gemma', 'lukunze1', 'caglanlee', 'desmondsoon', 'masonpb2', 'youssef2042000', 'retty8', 'bharath3', 'syin4', 'ethanmorse', 'ematson5897', 'jacobzeshleman', 'leejq', 'harshini9962', 'reemali99_', 'xxlilmontysignxx', 'ramonruiz.infor', 'atharva98', 'ahern0722', 'hishamzakaria20', 'cheokonn', 'adriangarea', 'samet1231234', 'mr4425', 'bluelobster', 'dcpang2', 'felivitullo87', 'puertarcd', 'farahsamir978', 'akozych2', 'nbs691', 'kie180073', 'anwar909', 'atx203', 'kanet1234', 'sealseal', 'emrebuyukkose2', 'arrow823', 'dhvanil', 'nuanno97', 'dkshelat', 'mohabayman', 'ranasherif65', 'diamond92', 'ugur.cankaya.3718', 'ammareltalli', 'acn562', 'nabilah1403', 'yaseminablacandir', 'tamchouweng', 'ablahsaoud', 'sriharshap', 'mrefaat', 'bassamtarek', 'hamidausat', 'kakmeera1999', 'teoster50', 'nolmos96', 'abdurrahmn13', 'mmartinezsanchez', 'sandrabashara', 'zakhwan7', 'chengweiheng', 'nikalyaamani', 'acregodean', 'happyleexin', 'sarapl', 'williammitchell5818', 'rooban11', 'yeejou990318', 'kowjiajin', 'nihaosawaddee', 'maxernest', 'david.garrido', 'mohamedsameh', 'spazos7', 'tmi211', 'kie180039', 'worldlineusaf', 'mgk816', 'kie180079', 'ledicia97', 'movi205', 'shuming2']",2,"[None, 'comeulaval']",393,"['oliviercharbonneau', 'miri23', 'ozgurkablan26', 'loisonchambers', 'tuberkargan_97', 'pranjal3', 'musabmalek0717', 'nadanasser1199', 'siemprewowthechami', 'staceyn2', 'vblanco.nico', 'abbesalaeddine', 'efrenhub', 'isabelmaria.vazquez', 'ahmedamr', 'shorouk_ossama', 'rikardberger', 'alancantu57', 'luciano.brignone', 'rahimnoorj', 'janeneil88', 'guttsfulltyagi', 'mjgebara14', 'kartal', 'gabrielyii99', 'aboone06', 'saegner2', 'manuelsomoza94', 'amani12345', 'youssefsherif22', 'j.haliburton', 'amr_ua07', 'evrenyigit', 'tingliang', 'kirankumar94', 'ahagras13', 'njgale01', 'al4995', 'smrdafdl', 'travisc2', 'dlee145', 'stambo', 'anthonyroux', 'ryanorem', 'moh.bahaa', 'ahchehyan', 'aimanadnan', 'veronica.mieites', 's_coriolis', 'trkmengkay', 'cbecker413', 'mcruces.fz', 'latecnologiameodia', 'gxiao2', 'emilechouinard', 'je_guilbert', 'yubai', 'sinasigurpinar', 'lauragdevesa', 'muvafikmelikkaya', 'kason.carroll', 'jbaggie2019', 'annahaozheng0606', 'jtorres17', 'ahmedayman2370', 'zikrizaki88995', 'yjenyiee155', '46harunakgul', 'alifzulkifli99', 'kaitlinh', 'tyy233', 'sdehoyos47', 'malgaca', 'lsleed', 'khazanv2', 'alexisdixon6', 'gc_1', 'jinsup2', 'comeulaval', 'rishu', 'amparo.castro.96', 'tbryan', 'martin32', 'michael.mechelay', 'akash140410107098', 'nowapoca', 'onaam8', 'pablosaavedra', 'camilolcastro97', 'khor', 'ankit6257', 'samashraf1', 'benoiturcotte', 'aishu98', 'rileyroca', 'david.peral.moran', 'kiruthikaabalu181996', 'taymacnichols', 'dhodapp', 'nagihankececi', 'carlosvigo1997', 'moh.ashraf105', 'baleko12345', 'ikhbal', 'afeefz', 'kaustubh.shirpurkar', 'kie180031', 'bflores18', 'tdubnansky6', 'jorgecastelo5', 'andreadiazgar', 'david2397', 'bcperki2', 'melaniejkramer', 'rkchapman', 'jn1404', 'mateocampos', 'jzhan142', 'josepazmartin', 'brannon44', 'adfoz', 'avw2', 'youxing0309', 'scremin', 'lderemo', 'perezsarmar', 'ashutoshsinghhenry6', 'melroy_caeiro', 'viratbhatt007', 'fkl217', 'coderko3', 'alimatama', 'ammaralaa516', 'nadhnasorudin', 'adarsh123', 'jacquelinethardin', 'mjoza2', 'nihatyavuz', 'estebanrial', 'jinwoo2', 'adnanyuceer', 'danielfernandezcalo', 'berkaydean', 'cloudyoverhead', 'fred_dion', 'syedzakwan', 'e1150590', 'fcfrancapra94', 'amiruldanial99', 'ozbunar01', 'alecorti.pardo', 'electronica18', 'nourananwar123', 'olivier.gilbert.paquet', 'anibarseghyan', 'amlibrahim', 'neuroque', 'kychui2', 'shaf31', 'hong_gao', 'paul.aniruddha', 'carlosbesadaromero', 'mohaballam', 'pip29', 'apb5472', 'tuberkargan', 'hafizmokh99', 'javierisma98', 'fathy1104', 'corredoira', 'helenalecoq97', 'kimzihuang', 'muteki', 'masitadonmez', 'nadja1', 'dancastaneda', 'ahmedsameh1698', 'rocio', 'mallen22', 'ffazul64', 'guoyao', 'ari6nd', 'kerryreto', 'pedrosiaba', 'michaelsaldana1', 'omarmagdy', 'vickytubio', 'ericrobles', 'soccadelic44', 'selena', 'aasifhameed99', 'damlakubattt', 'anxovidal8', 'exjamil', 'jahnavikachhia', 'joker632455', 'vincentpainchaud.vp', 'svo4321', 'zhixin2', 'yansi', 'asyrafaqil', 'xyz11', 'virajput299', 'ryanboucher', 'jpmcgee98', 'mariz', 'bhliu97', 'amrebrahim', 'abdulrahim2905', 'c.a.stupka', 'tonybocadillosgrandes', 'talwren', 'rxtodd', 'farah26', 'tss3', 'abieday1704', 'mavanzato0418', 'facundovia', 'cristinacigarran', 'nazimmath3', 'baohl2', 'ales.gajdacz', 'elad.d', 'kie180028', 'wahidiah52', 'kyang37', 'arifjalani99', 'lino13', 'jaimefookinlannister', 'physquig', 'adriancheah', 'jarodm2', 'noureldin1999', 'michael2010814', 'ckim123', 'eddin21', 'jipiccardi', 'prabuddha_888253127', 'david_atef', 'kalebhilde', 'magic_ocean99', 'saipraneett', 'sanchjai', 'omardeyaa', 'pingan99', 'aaq', 'alidsjt', 'mengkem2', 'haclarke', 'oishikfaruque', 'ilou', 'aengm', 'janalorenzolumbreras', 'hilisa', 'carlosvillar54', 'vikazvereva', 'm939454', 'va844', 'pablobou4', 'ludovick.begin', 'maniphysics09', 'eduard25252598', 'apascao', 'xosegq16', 'adam562', 'lauramolinosmayo', 'amni99', 'kie180702', 'saharoaf', 'redzuan11', 'ypp200', 'kph2', 'martinzapata', 'kirolosehab99', 'restep2', 'seifhabib', 'maramtarek53', 'zehuahe2', 'azizijazam11', 'marcosanllo', 'aimansyaz99', 'elizametias12', 'juanmacano97', 'sparshagarwal1009', 'prakharbhargava0', 'njs035', 'alberfn', 'ramy_maged4', 'hmoulvi1', 'vanesagarcia', 'hf4', 'wowmuchchuck', 'mohammedemadeldin2000', 'gabrielyii', 'keerthisv', 'pythagoras2', 'xunyong', 'irenehb92', 'shradhap', 'mohameeddsamy', 'marianne.gratton.1', 'marcmagdy98', 'brknshn', 'gemma', 'lukunze1', 'caglanlee', 'desmondsoon', 'sebasket14', 'masonpb2', 'youssef2042000', 'retty8', 'bharath3', 'syin4', 'ethanmorse', 'ematson5897', 'jacobzeshleman', 'leejq', 'harshini9962', 'reemali99_', 'xxlilmontysignxx', 'ramonruiz.infor', 'atharva98', 'ahern0722', 'hishamzakaria20', 'cheokonn', 'adriangarea', 'jeanmichael.deschenes', 'samet1231234', 'mr4425', 'bluelobster', 'justin.lariviere.25', 'dcpang2', 'felivitullo87', 'puertarcd', 'farahsamir978', 'akozych2', 'nbs691', 'kie180073', 'anwar909', 'bleuminuit', 'atx203', 'kanet1234', 'sealseal', 'emrebuyukkose2', 'arrow823', 'dhvanil', 'nuanno97', 'dkshelat', 'mohabayman', 'ranasherif65', 'diamond92', 'ugur.cankaya.3718', 'ammareltalli', 'acn562', 'nabilah1403', 'yaseminablacandir', 'tamchouweng', 'ablahsaoud', 'sriharshap', 'mrefaat', 'bassamtarek', 'hamidausat', 'kakmeera1999', 'teoster50', 'nolmos96', 'abdurrahmn13', 'mmartinezsanchez', 'sandrabashara', 'zakhwan7', 'chengweiheng', 'nikalyaamani', 'acregodean', 'happyleexin', 'sarapl', 'williammitchell5818', None, 'rooban11', 'yeejou990318', 'kowjiajin', 'nihaosawaddee', 'maxernest', 'david.garrido', 'guibill10', 'mohamedsameh', 'spazos7', 'tmi211', 'kie180039', 'worldlineusaf', 'mgk816', 'kie180079', 'ledicia97', 'movi205', 'shuming2']"
1,29,391,22,19,"['virajput299', 'dhvanil', 'dkshelat', 'yubai', 'sriharshap', 'ashutoshsinghhenry6', 'viratbhatt007', 'kirankumar94', 'rishu', 'akash140410107098', 'soccadelic44', 'ankit6257', 'prabuddha_888253127', 'kiruthikaabalu181996', 'jahnavikachhia', 'hmoulvi1', 'kalebhilde', 'keerthisv', 'shradhap']",372,"['oliviercharbonneau', 'miri23', 'ozgurkablan26', 'loisonchambers', 'tuberkargan_97', 'pranjal3', 'musabmalek0717', 'nadanasser1199', 'siemprewowthechami', 'staceyn2', 'vblanco.nico', 'abbesalaeddine', 'efrenhub', 'isabelmaria.vazquez', 'ahmedamr', 'shorouk_ossama', 'rikardberger', 'alancantu57', 'luciano.brignone', 'rahimnoorj', 'janeneil88', 'guttsfulltyagi', 'mjgebara14', 'kartal', 'gabrielyii99', 'aboone06', 'saegner2', 'manuelsomoza94', 'amani12345', 'youssefsherif22', 'j.haliburton', 'amr_ua07', 'evrenyigit', 'tingliang', 'ahagras13', 'njgale01', 'al4995', 'smrdafdl', 'travisc2', 'dlee145', 'stambo', 'anthonyroux', 'ryanorem', 'moh.bahaa', 'ahchehyan', 'aimanadnan', 'veronica.mieites', 's_coriolis', 'trkmengkay', 'cbecker413', 'mcruces.fz', 'latecnologiameodia', 'gxiao2', 'emilechouinard', 'je_guilbert', 'sinasigurpinar', 'lauragdevesa', 'muvafikmelikkaya', 'kason.carroll', 'jbaggie2019', 'annahaozheng0606', 'jtorres17', 'ahmedayman2370', 'zikrizaki88995', 'yjenyiee155', '46harunakgul', 'alifzulkifli99', 'kaitlinh', 'tyy233', 'sdehoyos47', 'malgaca', 'lsleed', 'khazanv2', 'alexisdixon6', 'gc_1', 'jinsup2', 'amparo.castro.96', 'tbryan', 'martin32', 'michael.mechelay', 'nowapoca', 'onaam8', 'pablosaavedra', 'camilolcastro97', 'khor', 'samashraf1', 'benoiturcotte', 'aishu98', 'rileyroca', 'david.peral.moran', 'taymacnichols', 'dhodapp', 'nagihankececi', 'carlosvigo1997', 'moh.ashraf105', 'baleko12345', 'ikhbal', 'afeefz', 'kaustubh.shirpurkar', 'kie180031', 'bflores18', 'tdubnansky6', 'jorgecastelo5', 'andreadiazgar', 'david2397', 'bcperki2', 'melaniejkramer', 'rkchapman', 'jn1404', 'mateocampos', 'jzhan142', 'josepazmartin', 'brannon44', 'adfoz', 'avw2', 'youxing0309', 'scremin', 'lderemo', 'perezsarmar', 'melroy_caeiro', 'fkl217', 'coderko3', 'alimatama', 'ammaralaa516', 'nadhnasorudin', 'adarsh123', 'jacquelinethardin', 'mjoza2', 'nihatyavuz', 'estebanrial', 'jinwoo2', 'adnanyuceer', 'danielfernandezcalo', 'berkaydean', 'cloudyoverhead', 'fred_dion', 'syedzakwan', 'e1150590', 'fcfrancapra94', 'amiruldanial99', 'ozbunar01', 'alecorti.pardo', 'electronica18', 'nourananwar123', 'olivier.gilbert.paquet', 'anibarseghyan', 'amlibrahim', 'neuroque', 'kychui2', 'shaf31', 'hong_gao', 'paul.aniruddha', 'carlosbesadaromero', 'mohaballam', 'pip29', 'apb5472', 'tuberkargan', 'hafizmokh99', 'javierisma98', 'fathy1104', 'corredoira', 'helenalecoq97', 'kimzihuang', 'muteki', 'masitadonmez', 'nadja1', 'dancastaneda', 'ahmedsameh1698', 'rocio', 'mallen22', 'ffazul64', 'guoyao', 'ari6nd', 'kerryreto', 'pedrosiaba', 'michaelsaldana1', 'omarmagdy', 'vickytubio', 'ericrobles', 'selena', 'aasifhameed99', 'damlakubattt', 'anxovidal8', 'exjamil', 'joker632455', 'vincentpainchaud.vp', 'svo4321', 'zhixin2', 'yansi', 'asyrafaqil', 'xyz11', 'ryanboucher', 'jpmcgee98', 'mariz', 'bhliu97', 'amrebrahim', 'abdulrahim2905', 'c.a.stupka', 'tonybocadillosgrandes', 'talwren', 'rxtodd', 'farah26', 'tss3', 'abieday1704', 'mavanzato0418', 'facundovia', 'cristinacigarran', 'nazimmath3', 'baohl2', 'ales.gajdacz', 'elad.d', 'kie180028', 'wahidiah52', 'kyang37', 'arifjalani99', 'lino13', 'jaimefookinlannister', 'physquig', 'adriancheah', 'jarodm2', 'noureldin1999', 'michael2010814', 'ckim123', 'eddin21', 'jipiccardi', 'david_atef', 'magic_ocean99', 'saipraneett', 'sanchjai', 'omardeyaa', 'pingan99', 'aaq', 'alidsjt', 'mengkem2', 'haclarke', 'oishikfaruque', 'ilou', 'aengm', 'janalorenzolumbreras', 'hilisa', 'carlosvillar54', 'vikazvereva', 'm939454', 'va844', 'pablobou4', 'ludovick.begin', 'maniphysics09', 'eduard25252598', 'apascao', 'xosegq16', 'adam562', 'lauramolinosmayo', 'amni99', 'kie180702', 'saharoaf', 'redzuan11', 'ypp200', 'kph2', 'martinzapata', 'kirolosehab99', 'restep2', 'seifhabib', 'maramtarek53', 'zehuahe2', 'azizijazam11', 'marcosanllo', 'aimansyaz99', 'elizametias12', 'juanmacano97', 'sparshagarwal1009', 'prakharbhargava0', 'njs035', 'alberfn', 'ramy_maged4', 'vanesagarcia', 'hf4', 'wowmuchchuck', 'mohammedemadeldin2000', 'gabrielyii', 'pythagoras2', 'xunyong', 'irenehb92', 'mohameeddsamy', 'marianne.gratton.1', 'marcmagdy98', 'brknshn', 'gemma', 'lukunze1', 'caglanlee', 'desmondsoon', 'sebasket14', 'masonpb2', 'youssef2042000', 'retty8', 'bharath3', 'syin4', 'ethanmorse', 'ematson5897', 'jacobzeshleman', 'leejq', 'harshini9962', 'reemali99_', 'xxlilmontysignxx', 'ramonruiz.infor', 'atharva98', 'ahern0722', 'hishamzakaria20', 'cheokonn', 'adriangarea', 'jeanmichael.deschenes', 'samet1231234', 'mr4425', 'bluelobster', 'justin.lariviere.25', 'dcpang2', 'felivitullo87', 'puertarcd', 'farahsamir978', 'akozych2', 'nbs691', 'kie180073', 'anwar909', 'bleuminuit', 'atx203', 'kanet1234', 'sealseal', 'emrebuyukkose2', 'arrow823', 'nuanno97', 'mohabayman', 'ranasherif65', 'diamond92', 'ugur.cankaya.3718', 'ammareltalli', 'acn562', 'nabilah1403', 'yaseminablacandir', 'tamchouweng', 'ablahsaoud', 'mrefaat', 'bassamtarek', 'hamidausat', 'kakmeera1999', 'teoster50', 'nolmos96', 'abdurrahmn13', 'mmartinezsanchez', 'sandrabashara', 'zakhwan7', 'chengweiheng', 'nikalyaamani', 'acregodean', 'happyleexin', 'sarapl', 'williammitchell5818', 'rooban11', 'yeejou990318', 'kowjiajin', 'nihaosawaddee', 'maxernest', 'david.garrido', 'guibill10', 'mohamedsameh', 'spazos7', 'tmi211', 'kie180039', 'worldlineusaf', 'mgk816', 'kie180079', 'ledicia97', 'movi205', 'shuming2']",3,"['devajnparikh1995', 'dhara041992', None]",394,"['oliviercharbonneau', 'miri23', 'ozgurkablan26', 'loisonchambers', 'tuberkargan_97', 'pranjal3', 'musabmalek0717', 'nadanasser1199', 'siemprewowthechami', 'staceyn2', 'vblanco.nico', 'abbesalaeddine', 'efrenhub', 'isabelmaria.vazquez', 'ahmedamr', 'shorouk_ossama', 'rikardberger', 'alancantu57', 'luciano.brignone', 'rahimnoorj', 'janeneil88', 'guttsfulltyagi', 'mjgebara14', 'kartal', 'gabrielyii99', 'aboone06', 'saegner2', 'manuelsomoza94', 'amani12345', 'youssefsherif22', 'j.haliburton', 'amr_ua07', 'evrenyigit', 'tingliang', 'kirankumar94', 'ahagras13', 'njgale01', 'al4995', 'smrdafdl', 'travisc2', 'dlee145', 'stambo', 'anthonyroux', 'ryanorem', 'moh.bahaa', 'ahchehyan', 'aimanadnan', 'veronica.mieites', 's_coriolis', 'trkmengkay', 'cbecker413', 'mcruces.fz', 'latecnologiameodia', 'gxiao2', 'emilechouinard', 'je_guilbert', 'yubai', 'sinasigurpinar', 'lauragdevesa', 'muvafikmelikkaya', 'kason.carroll', 'jbaggie2019', 'annahaozheng0606', 'jtorres17', 'ahmedayman2370', 'zikrizaki88995', 'yjenyiee155', '46harunakgul', 'alifzulkifli99', 'kaitlinh', 'tyy233', 'sdehoyos47', 'malgaca', 'lsleed', 'devajnparikh1995', 'khazanv2', 'alexisdixon6', 'gc_1', 'jinsup2', 'rishu', 'amparo.castro.96', 'tbryan', 'martin32', 'michael.mechelay', 'akash140410107098', 'nowapoca', 'onaam8', 'pablosaavedra', 'camilolcastro97', 'khor', 'ankit6257', 'samashraf1', 'benoiturcotte', 'aishu98', 'rileyroca', 'david.peral.moran', 'kiruthikaabalu181996', 'taymacnichols', 'dhodapp', 'nagihankececi', 'carlosvigo1997', 'moh.ashraf105', 'baleko12345', 'ikhbal', 'afeefz', 'kaustubh.shirpurkar', 'kie180031', 'bflores18', 'tdubnansky6', 'jorgecastelo5', 'andreadiazgar', 'david2397', 'bcperki2', 'melaniejkramer', 'rkchapman', 'jn1404', 'mateocampos', 'jzhan142', 'josepazmartin', 'brannon44', 'adfoz', 'avw2', 'youxing0309', 'scremin', 'lderemo', 'perezsarmar', 'ashutoshsinghhenry6', 'melroy_caeiro', 'viratbhatt007', 'fkl217', 'coderko3', 'alimatama', 'ammaralaa516', 'nadhnasorudin', 'adarsh123', 'jacquelinethardin', 'mjoza2', 'nihatyavuz', 'estebanrial', 'jinwoo2', 'adnanyuceer', 'danielfernandezcalo', 'berkaydean', 'cloudyoverhead', 'fred_dion', 'syedzakwan', 'e1150590', 'fcfrancapra94', 'amiruldanial99', 'ozbunar01', 'alecorti.pardo', 'electronica18', 'nourananwar123', 'olivier.gilbert.paquet', 'anibarseghyan', 'amlibrahim', 'neuroque', 'kychui2', 'shaf31', 'hong_gao', 'paul.aniruddha', 'carlosbesadaromero', 'dhara041992', 'mohaballam', 'pip29', 'apb5472', 'tuberkargan', 'hafizmokh99', 'javierisma98', 'fathy1104', 'corredoira', 'helenalecoq97', 'kimzihuang', 'muteki', 'masitadonmez', 'nadja1', 'dancastaneda', 'ahmedsameh1698', 'rocio', 'mallen22', 'ffazul64', 'guoyao', 'ari6nd', 'kerryreto', 'pedrosiaba', 'michaelsaldana1', 'omarmagdy', 'vickytubio', 'ericrobles', 'soccadelic44', 'selena', 'aasifhameed99', 'damlakubattt', 'anxovidal8', 'exjamil', 'jahnavikachhia', 'joker632455', 'vincentpainchaud.vp', 'svo4321', 'zhixin2', 'yansi', 'asyrafaqil', 'xyz11', 'virajput299', 'ryanboucher', 'jpmcgee98', 'mariz', 'bhliu97', 'amrebrahim', 'abdulrahim2905', 'c.a.stupka', 'tonybocadillosgrandes', 'talwren', 'rxtodd', 'farah26', 'tss3', 'abieday1704', 'mavanzato0418', 'facundovia', 'cristinacigarran', 'nazimmath3', 'baohl2', 'ales.gajdacz', 'elad.d', 'kie180028', 'wahidiah52', 'kyang37', 'arifjalani99', 'lino13', 'jaimefookinlannister', 'physquig', 'adriancheah', 'jarodm2', 'noureldin1999', 'michael2010814', 'ckim123', 'eddin21', 'jipiccardi', 'prabuddha_888253127', 'david_atef', 'kalebhilde', 'magic_ocean99', 'saipraneett', 'sanchjai', 'omardeyaa', 'pingan99', 'aaq', 'alidsjt', 'mengkem2', 'haclarke', 'oishikfaruque', 'ilou', 'aengm', 'janalorenzolumbreras', 'hilisa', 'carlosvillar54', 'vikazvereva', 'm939454', 'va844', 'pablobou4', 'ludovick.begin', 'maniphysics09', 'eduard25252598', 'apascao', 'xosegq16', 'adam562', 'lauramolinosmayo', 'amni99', 'kie180702', 'saharoaf', 'redzuan11', 'ypp200', 'kph2', 'martinzapata', 'kirolosehab99', 'restep2', 'seifhabib', 'maramtarek53', 'zehuahe2', 'azizijazam11', 'marcosanllo', 'aimansyaz99', 'elizametias12', 'juanmacano97', 'sparshagarwal1009', 'prakharbhargava0', 'njs035', 'alberfn', 'ramy_maged4', 'hmoulvi1', 'vanesagarcia', 'hf4', 'wowmuchchuck', 'mohammedemadeldin2000', 'gabrielyii', 'keerthisv', 'pythagoras2', 'xunyong', 'irenehb92', 'shradhap', 'mohameeddsamy', 'marianne.gratton.1', 'marcmagdy98', 'brknshn', 'gemma', 'lukunze1', 'caglanlee', 'desmondsoon', 'sebasket14', 'masonpb2', 'youssef2042000', 'retty8', 'bharath3', 'syin4', 'ethanmorse', 'ematson5897', 'jacobzeshleman', 'leejq', 'harshini9962', 'reemali99_', 'xxlilmontysignxx', 'ramonruiz.infor', 'atharva98', 'ahern0722', 'hishamzakaria20', 'cheokonn', 'adriangarea', 'jeanmichael.deschenes', 'samet1231234', 'mr4425', 'bluelobster', 'justin.lariviere.25', 'dcpang2', 'felivitullo87', 'puertarcd', 'farahsamir978', 'akozych2', 'nbs691', 'kie180073', 'anwar909', 'bleuminuit', 'atx203', 'kanet1234', 'sealseal', 'emrebuyukkose2', 'arrow823', 'dhvanil', 'nuanno97', 'dkshelat', 'mohabayman', 'ranasherif65', 'diamond92', 'ugur.cankaya.3718', 'ammareltalli', 'acn562', 'nabilah1403', 'yaseminablacandir', 'tamchouweng', 'ablahsaoud', 'sriharshap', 'mrefaat', 'bassamtarek', 'hamidausat', 'kakmeera1999', 'teoster50', 'nolmos96', 'abdurrahmn13', 'mmartinezsanchez', 'sandrabashara', 'zakhwan7', 'chengweiheng', 'nikalyaamani', 'acregodean', 'happyleexin', 'sarapl', 'williammitchell5818', None, 'rooban11', 'yeejou990318', 'kowjiajin', 'nihaosawaddee', 'maxernest', 'david.garrido', 'guibill10', 'mohamedsameh', 'spazos7', 'tmi211', 'kie180039', 'worldlineusaf', 'mgk816', 'kie180079', 'ledicia97', 'movi205', 'shuming2']"
1,263,391,21,7,"['trkmengkay', 'ozgurkablan26', 'tuberkargan_97', 'emrebuyukkose2', 'brknshn', 'joker632455', 'sinasigurpinar']",384,"['oliviercharbonneau', 'miri23', 'loisonchambers', 'pranjal3', 'musabmalek0717', 'nadanasser1199', 'siemprewowthechami', 'staceyn2', 'vblanco.nico', 'abbesalaeddine', 'efrenhub', 'isabelmaria.vazquez', 'ahmedamr', 'shorouk_ossama', 'rikardberger', 'alancantu57', 'luciano.brignone', 'rahimnoorj', 'janeneil88', 'guttsfulltyagi', 'mjgebara14', 'kartal', 'gabrielyii99', 'aboone06', 'saegner2', 'manuelsomoza94', 'amani12345', 'youssefsherif22', 'j.haliburton', 'amr_ua07', 'evrenyigit', 'tingliang', 'kirankumar94', 'ahagras13', 'njgale01', 'al4995', 'smrdafdl', 'travisc2', 'dlee145', 'stambo', 'anthonyroux', 'ryanorem', 'moh.bahaa', 'ahchehyan', 'aimanadnan', 'veronica.mieites', 's_coriolis', 'cbecker413', 'mcruces.fz', 'latecnologiameodia', 'gxiao2', 'emilechouinard', 'je_guilbert', 'yubai', 'lauragdevesa', 'muvafikmelikkaya', 'kason.carroll', 'jbaggie2019', 'annahaozheng0606', 'jtorres17', 'ahmedayman2370', 'zikrizaki88995', 'yjenyiee155', '46harunakgul', 'alifzulkifli99', 'kaitlinh', 'tyy233', 'sdehoyos47', 'malgaca', 'lsleed', 'khazanv2', 'alexisdixon6', 'gc_1', 'jinsup2', 'rishu', 'amparo.castro.96', 'tbryan', 'martin32', 'michael.mechelay', 'akash140410107098', 'nowapoca', 'onaam8', 'pablosaavedra', 'camilolcastro97', 'khor', 'ankit6257', 'samashraf1', 'benoiturcotte', 'aishu98', 'rileyroca', 'david.peral.moran', 'kiruthikaabalu181996', 'taymacnichols', 'dhodapp', 'nagihankececi', 'carlosvigo1997', 'moh.ashraf105', 'baleko12345', 'ikhbal', 'afeefz', 'kaustubh.shirpurkar', 'kie180031', 'bflores18', 'tdubnansky6', 'jorgecastelo5', 'andreadiazgar', 'david2397', 'bcperki2', 'melaniejkramer', 'rkchapman', 'jn1404', 'mateocampos', 'jzhan142', 'josepazmartin', 'brannon44', 'adfoz', 'avw2', 'youxing0309', 'scremin', 'lderemo', 'perezsarmar', 'ashutoshsinghhenry6', 'melroy_caeiro', 'viratbhatt007', 'fkl217', 'coderko3', 'alimatama', 'ammaralaa516', 'nadhnasorudin', 'adarsh123', 'jacquelinethardin', 'mjoza2', 'nihatyavuz', 'estebanrial', 'jinwoo2', 'adnanyuceer', 'danielfernandezcalo', 'berkaydean', 'cloudyoverhead', 'fred_dion', 'syedzakwan', 'e1150590', 'fcfrancapra94', 'amiruldanial99', 'ozbunar01', 'alecorti.pardo', 'electronica18', 'nourananwar123', 'olivier.gilbert.paquet', 'anibarseghyan', 'amlibrahim', 'neuroque', 'kychui2', 'shaf31', 'hong_gao', 'paul.aniruddha', 'carlosbesadaromero', 'mohaballam', 'pip29', 'apb5472', 'tuberkargan', 'hafizmokh99', 'javierisma98', 'fathy1104', 'corredoira', 'helenalecoq97', 'kimzihuang', 'muteki', 'masitadonmez', 'nadja1', 'dancastaneda', 'ahmedsameh1698', 'rocio', 'mallen22', 'ffazul64', 'guoyao', 'ari6nd', 'kerryreto', 'pedrosiaba', 'michaelsaldana1', 'omarmagdy', 'vickytubio', 'ericrobles', 'soccadelic44', 'selena', 'aasifhameed99', 'damlakubattt', 'anxovidal8', 'exjamil', 'jahnavikachhia', 'vincentpainchaud.vp', 'svo4321', 'zhixin2', 'yansi', 'asyrafaqil', 'xyz11', 'virajput299', 'ryanboucher', 'jpmcgee98', 'mariz', 'bhliu97', 'amrebrahim', 'abdulrahim2905', 'c.a.stupka', 'tonybocadillosgrandes', 'talwren', 'rxtodd', 'farah26', 'tss3', 'abieday1704', 'mavanzato0418', 'facundovia', 'cristinacigarran', 'nazimmath3', 'baohl2', 'ales.gajdacz', 'elad.d', 'kie180028', 'wahidiah52', 'kyang37', 'arifjalani99', 'lino13', 'jaimefookinlannister', 'physquig', 'adriancheah', 'jarodm2', 'noureldin1999', 'michael2010814', 'ckim123', 'eddin21', 'jipiccardi', 'prabuddha_888253127', 'david_atef', 'kalebhilde', 'magic_ocean99', 'saipraneett', 'sanchjai', 'omardeyaa', 'pingan99', 'aaq', 'alidsjt', 'mengkem2', 'haclarke', 'oishikfaruque', 'ilou', 'aengm', 'janalorenzolumbreras', 'hilisa', 'carlosvillar54', 'vikazvereva', 'm939454', 'va844', 'pablobou4', 'ludovick.begin', 'maniphysics09', 'eduard25252598', 'apascao', 'xosegq16', 'adam562', 'lauramolinosmayo', 'amni99', 'kie180702', 'saharoaf', 'redzuan11', 'ypp200', 'kph2', 'martinzapata', 'kirolosehab99', 'restep2', 'seifhabib', 'maramtarek53', 'zehuahe2', 'azizijazam11', 'marcosanllo', 'aimansyaz99', 'elizametias12', 'juanmacano97', 'sparshagarwal1009', 'prakharbhargava0', 'njs035', 'alberfn', 'ramy_maged4', 'hmoulvi1', 'vanesagarcia', 'hf4', 'wowmuchchuck', 'mohammedemadeldin2000', 'gabrielyii', 'keerthisv', 'pythagoras2', 'xunyong', 'irenehb92', 'shradhap', 'mohameeddsamy', 'marianne.gratton.1', 'marcmagdy98', 'gemma', 'lukunze1', 'caglanlee', 'desmondsoon', 'sebasket14', 'masonpb2', 'youssef2042000', 'retty8', 'bharath3', 'syin4', 'ethanmorse', 'ematson5897', 'jacobzeshleman', 'leejq', 'harshini9962', 'reemali99_', 'xxlilmontysignxx', 'ramonruiz.infor', 'atharva98', 'ahern0722', 'hishamzakaria20', 'cheokonn', 'adriangarea', 'jeanmichael.deschenes', 'samet1231234', 'mr4425', 'bluelobster', 'justin.lariviere.25', 'dcpang2', 'felivitullo87', 'puertarcd', 'farahsamir978', 'akozych2', 'nbs691', 'kie180073', 'anwar909', 'bleuminuit', 'atx203', 'kanet1234', 'sealseal', 'arrow823', 'dhvanil', 'nuanno97', 'dkshelat', 'mohabayman', 'ranasherif65', 'diamond92', 'ugur.cankaya.3718', 'ammareltalli', 'acn562', 'nabilah1403', 'yaseminablacandir', 'tamchouweng', 'ablahsaoud', 'sriharshap', 'mrefaat', 'bassamtarek', 'hamidausat', 'kakmeera1999', 'teoster50', 'nolmos96', 'abdurrahmn13', 'mmartinezsanchez', 'sandrabashara', 'zakhwan7', 'chengweiheng', 'nikalyaamani', 'acregodean', 'happyleexin', 'sarapl', 'williammitchell5818', 'rooban11', 'yeejou990318', 'kowjiajin', 'nihaosawaddee', 'maxernest', 'david.garrido', 'guibill10', 'mohamedsameh', 'spazos7', 'tmi211', 'kie180039', 'worldlineusaf', 'mgk816', 'kie180079', 'ledicia97', 'movi205', 'shuming2']",14,"['ronal_denho_931', 'sudekoza', 'oakbulut1997', 'senanurcetin96', 'metalist_kaan', 'nihansulukoy', 'okanircann', 'polat.gokberk', 'elifisparta38', 'melisozkarr', 'ozgurdenizkozan', 'furkanturk1352', None, 'fatiherdgn25']",405,"['oliviercharbonneau', 'miri23', 'ozgurkablan26', 'loisonchambers', 'tuberkargan_97', 'pranjal3', 'musabmalek0717', 'nadanasser1199', 'siemprewowthechami', 'staceyn2', 'vblanco.nico', 'abbesalaeddine', 'efrenhub', 'isabelmaria.vazquez', 'ahmedamr', 'shorouk_ossama', 'rikardberger', 'alancantu57', 'luciano.brignone', 'rahimnoorj', 'janeneil88', 'nihansulukoy', 'guttsfulltyagi', 'mjgebara14', 'ozgurdenizkozan', 'kartal', 'gabrielyii99', 'aboone06', 'saegner2', 'manuelsomoza94', 'amani12345', 'youssefsherif22', 'j.haliburton', 'amr_ua07', 'evrenyigit', 'tingliang', 'kirankumar94', 'ahagras13', 'njgale01', 'al4995', 'smrdafdl', 'travisc2', 'dlee145', 'stambo', 'anthonyroux', 'ryanorem', 'moh.bahaa', 'ahchehyan', 'aimanadnan', 'veronica.mieites', 's_coriolis', 'trkmengkay', 'cbecker413', 'mcruces.fz', 'latecnologiameodia', 'gxiao2', 'emilechouinard', 'je_guilbert', 'yubai', 'sinasigurpinar', 'lauragdevesa', 'muvafikmelikkaya', 'kason.carroll', 'jbaggie2019', 'annahaozheng0606', 'jtorres17', 'ahmedayman2370', 'zikrizaki88995', 'yjenyiee155', '46harunakgul', 'elifisparta38', 'alifzulkifli99', 'kaitlinh', 'tyy233', 'sdehoyos47', 'malgaca', 'lsleed', 'khazanv2', 'alexisdixon6', 'gc_1', 'jinsup2', 'rishu', 'amparo.castro.96', 'tbryan', 'martin32', 'michael.mechelay', 'akash140410107098', 'nowapoca', 'onaam8', 'pablosaavedra', 'camilolcastro97', 'khor', 'ankit6257', 'samashraf1', 'sudekoza', 'benoiturcotte', 'aishu98', 'rileyroca', 'david.peral.moran', 'kiruthikaabalu181996', 'taymacnichols', 'dhodapp', 'nagihankececi', 'carlosvigo1997', 'moh.ashraf105', 'baleko12345', 'ikhbal', 'afeefz', 'kaustubh.shirpurkar', 'kie180031', 'bflores18', 'tdubnansky6', 'jorgecastelo5', 'andreadiazgar', 'david2397', 'bcperki2', 'melaniejkramer', 'rkchapman', 'melisozkarr', 'jn1404', 'mateocampos', 'jzhan142', 'josepazmartin', 'brannon44', 'metalist_kaan', 'adfoz', 'avw2', 'youxing0309', 'scremin', 'lderemo', 'perezsarmar', 'ashutoshsinghhenry6', 'melroy_caeiro', 'viratbhatt007', 'oakbulut1997', 'fkl217', 'coderko3', 'polat.gokberk', 'alimatama', 'ammaralaa516', 'nadhnasorudin', 'adarsh123', 'jacquelinethardin', 'mjoza2', 'nihatyavuz', 'estebanrial', 'jinwoo2', 'adnanyuceer', 'danielfernandezcalo', 'berkaydean', 'cloudyoverhead', 'fred_dion', 'syedzakwan', 'e1150590', 'fcfrancapra94', 'amiruldanial99', 'ozbunar01', 'alecorti.pardo', 'electronica18', 'nourananwar123', 'olivier.gilbert.paquet', 'anibarseghyan', 'amlibrahim', 'neuroque', 'kychui2', 'shaf31', 'hong_gao', 'paul.aniruddha', 'carlosbesadaromero', 'mohaballam', 'pip29', 'fatiherdgn25', 'ronal_denho_931', 'apb5472', 'tuberkargan', 'hafizmokh99', 'javierisma98', 'fathy1104', 'corredoira', 'helenalecoq97', 'kimzihuang', 'muteki', 'masitadonmez', 'nadja1', 'dancastaneda', 'ahmedsameh1698', 'rocio', 'mallen22', 'ffazul64', 'guoyao', 'ari6nd', 'kerryreto', 'pedrosiaba', 'michaelsaldana1', 'senanurcetin96', 'omarmagdy', 'vickytubio', 'ericrobles', 'soccadelic44', 'selena', 'aasifhameed99', 'damlakubattt', 'anxovidal8', 'exjamil', 'jahnavikachhia', 'joker632455', 'vincentpainchaud.vp', 'svo4321', 'zhixin2', 'yansi', 'furkanturk1352', 'asyrafaqil', 'xyz11', 'virajput299', 'ryanboucher', 'jpmcgee98', 'mariz', 'bhliu97', 'amrebrahim', 'abdulrahim2905', 'c.a.stupka', 'tonybocadillosgrandes', 'talwren', 'rxtodd', 'farah26', 'tss3', 'abieday1704', 'mavanzato0418', 'facundovia', 'cristinacigarran', 'nazimmath3', 'baohl2', 'ales.gajdacz', 'elad.d', 'kie180028', 'wahidiah52', 'kyang37', 'arifjalani99', 'lino13', 'jaimefookinlannister', 'physquig', 'adriancheah', 'jarodm2', 'noureldin1999', 'michael2010814', 'ckim123', 'eddin21', 'jipiccardi', 'prabuddha_888253127', 'david_atef', 'kalebhilde', 'magic_ocean99', 'saipraneett', 'sanchjai', 'omardeyaa', 'pingan99', 'aaq', 'alidsjt', 'mengkem2', 'haclarke', 'oishikfaruque', 'ilou', 'aengm', 'janalorenzolumbreras', 'hilisa', 'carlosvillar54', 'vikazvereva', 'm939454', 'va844', 'pablobou4', 'ludovick.begin', 'maniphysics09', 'eduard25252598', 'apascao', 'xosegq16', 'adam562', 'lauramolinosmayo', 'amni99', 'kie180702', 'saharoaf', 'redzuan11', 'ypp200', 'kph2', 'martinzapata', 'kirolosehab99', 'restep2', 'seifhabib', 'maramtarek53', 'zehuahe2', 'azizijazam11', 'marcosanllo', 'aimansyaz99', 'elizametias12', 'juanmacano97', 'sparshagarwal1009', 'prakharbhargava0', 'njs035', 'alberfn', 'ramy_maged4', 'hmoulvi1', 'vanesagarcia', 'hf4', 'wowmuchchuck', 'mohammedemadeldin2000', 'gabrielyii', 'keerthisv', 'pythagoras2', 'xunyong', 'irenehb92', 'shradhap', 'mohameeddsamy', 'marianne.gratton.1', 'marcmagdy98', 'brknshn', 'gemma', 'lukunze1', 'caglanlee', 'desmondsoon', 'sebasket14', 'masonpb2', 'youssef2042000', 'retty8', 'bharath3', 'syin4', 'ethanmorse', 'ematson5897', 'jacobzeshleman', 'leejq', 'harshini9962', 'reemali99_', 'xxlilmontysignxx', 'ramonruiz.infor', 'atharva98', 'ahern0722', 'hishamzakaria20', 'cheokonn', 'adriangarea', 'jeanmichael.deschenes', 'samet1231234', 'mr4425', 'bluelobster', 'justin.lariviere.25', 'dcpang2', 'felivitullo87', 'puertarcd', 'farahsamir978', 'akozych2', 'nbs691', 'kie180073', 'anwar909', 'bleuminuit', 'atx203', 'kanet1234', 'sealseal', 'emrebuyukkose2', 'arrow823', 'dhvanil', 'nuanno97', 'dkshelat', 'mohabayman', 'ranasherif65', 'diamond92', 'ugur.cankaya.3718', 'ammareltalli', 'acn562', 'nabilah1403', 'yaseminablacandir', 'tamchouweng', 'ablahsaoud', 'sriharshap', 'mrefaat', 'bassamtarek', 'hamidausat', 'kakmeera1999', 'teoster50', 'nolmos96', 'abdurrahmn13', 'mmartinezsanchez', 'sandrabashara', 'zakhwan7', 'chengweiheng', 'nikalyaamani', 'acregodean', 'happyleexin', 'sarapl', 'williammitchell5818', None, 'rooban11', 'yeejou990318', 'kowjiajin', 'nihaosawaddee', 'maxernest', 'david.garrido', 'guibill10', 'mohamedsameh', 'spazos7', 'okanircann', 'tmi211', 'kie180039', 'worldlineusaf', 'mgk816', 'kie180079', 'ledicia97', 'movi205', 'shuming2']"
1,118,391,17,1,['zhixin2'],390,"['oliviercharbonneau', 'miri23', 'ozgurkablan26', 'loisonchambers', 'tuberkargan_97', 'pranjal3', 'musabmalek0717', 'nadanasser1199', 'siemprewowthechami', 'staceyn2', 'vblanco.nico', 'abbesalaeddine', 'efrenhub', 'isabelmaria.vazquez', 'ahmedamr', 'shorouk_ossama', 'rikardberger', 'alancantu57', 'luciano.brignone', 'rahimnoorj', 'janeneil88', 'guttsfulltyagi', 'mjgebara14', 'kartal', 'gabrielyii99', 'aboone06', 'saegner2', 'manuelsomoza94', 'amani12345', 'youssefsherif22', 'j.haliburton', 'amr_ua07', 'evrenyigit', 'tingliang', 'kirankumar94', 'ahagras13', 'njgale01', 'al4995', 'smrdafdl', 'travisc2', 'dlee145', 'stambo', 'anthonyroux', 'ryanorem', 'moh.bahaa', 'ahchehyan', 'aimanadnan', 'veronica.mieites', 's_coriolis', 'trkmengkay', 'cbecker413', 'mcruces.fz', 'latecnologiameodia', 'gxiao2', 'emilechouinard', 'je_guilbert', 'yubai', 'sinasigurpinar', 'lauragdevesa', 'muvafikmelikkaya', 'kason.carroll', 'jbaggie2019', 'annahaozheng0606', 'jtorres17', 'ahmedayman2370', 'zikrizaki88995', 'yjenyiee155', '46harunakgul', 'alifzulkifli99', 'kaitlinh', 'tyy233', 'sdehoyos47', 'malgaca', 'lsleed', 'khazanv2', 'alexisdixon6', 'gc_1', 'jinsup2', 'rishu', 'amparo.castro.96', 'tbryan', 'martin32', 'michael.mechelay', 'akash140410107098', 'nowapoca', 'onaam8', 'pablosaavedra', 'camilolcastro97', 'khor', 'ankit6257', 'samashraf1', 'benoiturcotte', 'aishu98', 'rileyroca', 'david.peral.moran', 'kiruthikaabalu181996', 'taymacnichols', 'dhodapp', 'nagihankececi', 'carlosvigo1997', 'moh.ashraf105', 'baleko12345', 'ikhbal', 'afeefz', 'kaustubh.shirpurkar', 'kie180031', 'bflores18', 'tdubnansky6', 'jorgecastelo5', 'andreadiazgar', 'david2397', 'bcperki2', 'melaniejkramer', 'rkchapman', 'jn1404', 'mateocampos', 'jzhan142', 'josepazmartin', 'brannon44', 'adfoz', 'avw2', 'youxing0309', 'scremin', 'lderemo', 'perezsarmar', 'ashutoshsinghhenry6', 'melroy_caeiro', 'viratbhatt007', 'fkl217', 'coderko3', 'alimatama', 'ammaralaa516', 'nadhnasorudin', 'adarsh123', 'jacquelinethardin', 'mjoza2', 'nihatyavuz', 'estebanrial', 'jinwoo2', 'adnanyuceer', 'danielfernandezcalo', 'berkaydean', 'cloudyoverhead', 'fred_dion', 'syedzakwan', 'e1150590', 'fcfrancapra94', 'amiruldanial99', 'ozbunar01', 'alecorti.pardo', 'electronica18', 'nourananwar123', 'olivier.gilbert.paquet', 'anibarseghyan', 'amlibrahim', 'neuroque', 'kychui2', 'shaf31', 'hong_gao', 'paul.aniruddha', 'carlosbesadaromero', 'mohaballam', 'pip29', 'apb5472', 'tuberkargan', 'hafizmokh99', 'javierisma98', 'fathy1104', 'corredoira', 'helenalecoq97', 'kimzihuang', 'muteki', 'masitadonmez', 'nadja1', 'dancastaneda', 'ahmedsameh1698', 'rocio', 'mallen22', 'ffazul64', 'guoyao', 'ari6nd', 'kerryreto', 'pedrosiaba', 'michaelsaldana1', 'omarmagdy', 'vickytubio', 'ericrobles', 'soccadelic44', 'selena', 'aasifhameed99', 'damlakubattt', 'anxovidal8', 'exjamil', 'jahnavikachhia', 'joker632455', 'vincentpainchaud.vp', 'svo4321', 'yansi', 'asyrafaqil', 'xyz11', 'virajput299', 'ryanboucher', 'jpmcgee98', 'mariz', 'bhliu97', 'amrebrahim', 'abdulrahim2905', 'c.a.stupka', 'tonybocadillosgrandes', 'talwren', 'rxtodd', 'farah26', 'tss3', 'abieday1704', 'mavanzato0418', 'facundovia', 'cristinacigarran', 'nazimmath3', 'baohl2', 'ales.gajdacz', 'elad.d', 'kie180028', 'wahidiah52', 'kyang37', 'arifjalani99', 'lino13', 'jaimefookinlannister', 'physquig', 'adriancheah', 'jarodm2', 'noureldin1999', 'michael2010814', 'ckim123', 'eddin21', 'jipiccardi', 'prabuddha_888253127', 'david_atef', 'kalebhilde', 'magic_ocean99', 'saipraneett', 'sanchjai', 'omardeyaa', 'pingan99', 'aaq', 'alidsjt', 'mengkem2', 'haclarke', 'oishikfaruque', 'ilou', 'aengm', 'janalorenzolumbreras', 'hilisa', 'carlosvillar54', 'vikazvereva', 'm939454', 'va844', 'pablobou4', 'ludovick.begin', 'maniphysics09', 'eduard25252598', 'apascao', 'xosegq16', 'adam562', 'lauramolinosmayo', 'amni99', 'kie180702', 'saharoaf', 'redzuan11', 'ypp200', 'kph2', 'martinzapata', 'kirolosehab99', 'restep2', 'seifhabib', 'maramtarek53', 'zehuahe2', 'azizijazam11', 'marcosanllo', 'aimansyaz99', 'elizametias12', 'juanmacano97', 'sparshagarwal1009', 'prakharbhargava0', 'njs035', 'alberfn', 'ramy_maged4', 'hmoulvi1', 'vanesagarcia', 'hf4', 'wowmuchchuck', 'mohammedemadeldin2000', 'gabrielyii', 'keerthisv', 'pythagoras2', 'xunyong', 'irenehb92', 'shradhap', 'mohameeddsamy', 'marianne.gratton.1', 'marcmagdy98', 'brknshn', 'gemma', 'lukunze1', 'caglanlee', 'desmondsoon', 'sebasket14', 'masonpb2', 'youssef2042000', 'retty8', 'bharath3', 'syin4', 'ethanmorse', 'ematson5897', 'jacobzeshleman', 'leejq', 'harshini9962', 'reemali99_', 'xxlilmontysignxx', 'ramonruiz.infor', 'atharva98', 'ahern0722', 'hishamzakaria20', 'cheokonn', 'adriangarea', 'jeanmichael.deschenes', 'samet1231234', 'mr4425', 'bluelobster', 'justin.lariviere.25', 'dcpang2', 'felivitullo87', 'puertarcd', 'farahsamir978', 'akozych2', 'nbs691', 'kie180073', 'anwar909', 'bleuminuit', 'atx203', 'kanet1234', 'sealseal', 'emrebuyukkose2', 'arrow823', 'dhvanil', 'nuanno97', 'dkshelat', 'mohabayman', 'ranasherif65', 'diamond92', 'ugur.cankaya.3718', 'ammareltalli', 'acn562', 'nabilah1403', 'yaseminablacandir', 'tamchouweng', 'ablahsaoud', 'sriharshap', 'mrefaat', 'bassamtarek', 'hamidausat', 'kakmeera1999', 'teoster50', 'nolmos96', 'abdurrahmn13', 'mmartinezsanchez', 'sandrabashara', 'zakhwan7', 'chengweiheng', 'nikalyaamani', 'acregodean', 'happyleexin', 'sarapl', 'williammitchell5818', 'rooban11', 'yeejou990318', 'kowjiajin', 'nihaosawaddee', 'maxernest', 'david.garrido', 'guibill10', 'mohamedsameh', 'spazos7', 'tmi211', 'kie180039', 'worldlineusaf', 'mgk816', 'kie180079', 'ledicia97', 'movi205', 'shuming2']",16,"['eescudermilian', 'ollorentemartija', 'ychen261', 'ftadros', 'yzhou91', 'arehman4', 'ssengupta3', None, 'shamilt3', 'cpassolano', 'jerry0075566', 'kli47', 'ialonsogago', 'ojovinomarques', 'chinmayanandadm', 'barbaraldoriga5']",407,"['oliviercharbonneau', 'miri23', 'ozgurkablan26', 'loisonchambers', 'tuberkargan_97', 'ssengupta3', 'pranjal3', 'musabmalek0717', 'nadanasser1199', 'siemprewowthechami', 'staceyn2', 'vblanco.nico', 'abbesalaeddine', 'efrenhub', 'isabelmaria.vazquez', 'ahmedamr', 'shorouk_ossama', 'rikardberger', 'alancantu57', 'luciano.brignone', 'rahimnoorj', 'janeneil88', 'guttsfulltyagi', 'mjgebara14', 'kartal', 'gabrielyii99', 'aboone06', 'saegner2', 'manuelsomoza94', 'amani12345', 'youssefsherif22', 'j.haliburton', 'amr_ua07', 'evrenyigit', 'tingliang', 'kirankumar94', 'ahagras13', 'njgale01', 'al4995', 'smrdafdl', 'travisc2', 'dlee145', 'stambo', 'ollorentemartija', 'anthonyroux', 'ryanorem', 'moh.bahaa', 'ahchehyan', 'aimanadnan', 'veronica.mieites', 'kli47', 's_coriolis', 'trkmengkay', 'cbecker413', 'mcruces.fz', 'latecnologiameodia', 'gxiao2', 'emilechouinard', 'je_guilbert', 'yubai', 'sinasigurpinar', 'lauragdevesa', 'muvafikmelikkaya', 'kason.carroll', 'jbaggie2019', 'annahaozheng0606', 'jtorres17', 'ahmedayman2370', 'zikrizaki88995', 'yjenyiee155', '46harunakgul', 'alifzulkifli99', 'kaitlinh', 'tyy233', 'sdehoyos47', 'malgaca', 'lsleed', 'khazanv2', 'alexisdixon6', 'gc_1', 'jinsup2', 'rishu', 'amparo.castro.96', 'tbryan', 'martin32', 'michael.mechelay', 'akash140410107098', 'nowapoca', 'onaam8', 'pablosaavedra', 'camilolcastro97', 'khor', 'ankit6257', 'samashraf1', 'benoiturcotte', 'aishu98', 'rileyroca', 'david.peral.moran', 'kiruthikaabalu181996', 'taymacnichols', 'dhodapp', 'nagihankececi', 'carlosvigo1997', 'moh.ashraf105', 'baleko12345', 'ikhbal', 'afeefz', 'kaustubh.shirpurkar', 'kie180031', 'bflores18', 'tdubnansky6', 'jorgecastelo5', 'andreadiazgar', 'david2397', 'bcperki2', 'melaniejkramer', 'rkchapman', 'jn1404', 'mateocampos', 'jzhan142', 'josepazmartin', 'brannon44', 'arehman4', 'adfoz', 'avw2', 'youxing0309', 'scremin', 'lderemo', 'perezsarmar', 'ashutoshsinghhenry6', 'melroy_caeiro', 'viratbhatt007', 'fkl217', 'coderko3', 'alimatama', 'ammaralaa516', 'nadhnasorudin', 'adarsh123', 'jacquelinethardin', 'barbaraldoriga5', 'mjoza2', 'nihatyavuz', 'estebanrial', 'jinwoo2', 'adnanyuceer', 'danielfernandezcalo', 'berkaydean', 'cloudyoverhead', 'fred_dion', 'syedzakwan', 'e1150590', 'fcfrancapra94', 'amiruldanial99', 'ozbunar01', 'alecorti.pardo', 'electronica18', 'ojovinomarques', 'nourananwar123', 'olivier.gilbert.paquet', 'anibarseghyan', 'amlibrahim', 'neuroque', 'ychen261', 'kychui2', 'shaf31', 'hong_gao', 'paul.aniruddha', 'carlosbesadaromero', 'mohaballam', 'pip29', 'apb5472', 'tuberkargan', 'hafizmokh99', 'javierisma98', 'fathy1104', 'corredoira', 'helenalecoq97', 'kimzihuang', 'muteki', 'masitadonmez', 'nadja1', 'dancastaneda', 'ahmedsameh1698', 'rocio', 'mallen22', 'ffazul64', 'guoyao', 'ari6nd', 'kerryreto', 'pedrosiaba', 'michaelsaldana1', 'shamilt3', 'omarmagdy', 'vickytubio', 'ericrobles', 'soccadelic44', 'selena', 'aasifhameed99', 'damlakubattt', 'anxovidal8', 'exjamil', 'jahnavikachhia', 'joker632455', 'vincentpainchaud.vp', 'svo4321', 'zhixin2', 'yansi', 'asyrafaqil', 'xyz11', 'virajput299', 'ryanboucher', 'jpmcgee98', 'mariz', 'bhliu97', 'amrebrahim', 'abdulrahim2905', 'c.a.stupka', 'tonybocadillosgrandes', 'talwren', 'rxtodd', 'farah26', 'tss3', 'abieday1704', 'mavanzato0418', 'facundovia', 'cristinacigarran', 'nazimmath3', 'baohl2', 'ales.gajdacz', 'elad.d', 'kie180028', 'wahidiah52', 'kyang37', 'arifjalani99', 'lino13', 'jaimefookinlannister', 'physquig', 'ialonsogago', 'adriancheah', 'jarodm2', 'noureldin1999', 'michael2010814', 'ckim123', 'eddin21', 'jipiccardi', 'prabuddha_888253127', 'david_atef', 'kalebhilde', 'magic_ocean99', 'saipraneett', 'sanchjai', 'omardeyaa', 'pingan99', 'aaq', 'alidsjt', 'mengkem2', 'haclarke', 'oishikfaruque', 'ilou', 'aengm', 'janalorenzolumbreras', 'hilisa', 'carlosvillar54', 'vikazvereva', 'm939454', 'va844', 'pablobou4', 'ludovick.begin', 'maniphysics09', 'eduard25252598', 'apascao', 'cpassolano', 'xosegq16', 'adam562', 'lauramolinosmayo', 'amni99', 'kie180702', 'saharoaf', 'redzuan11', 'ypp200', 'kph2', 'martinzapata', 'kirolosehab99', 'restep2', 'seifhabib', 'maramtarek53', 'zehuahe2', 'azizijazam11', 'marcosanllo', 'aimansyaz99', 'elizametias12', 'juanmacano97', 'sparshagarwal1009', 'prakharbhargava0', 'njs035', 'alberfn', 'ramy_maged4', 'hmoulvi1', 'vanesagarcia', 'hf4', 'wowmuchchuck', 'mohammedemadeldin2000', 'gabrielyii', 'keerthisv', 'pythagoras2', 'xunyong', 'irenehb92', 'shradhap', 'mohameeddsamy', 'marianne.gratton.1', 'marcmagdy98', 'brknshn', 'gemma', 'lukunze1', 'caglanlee', 'desmondsoon', 'sebasket14', 'masonpb2', 'youssef2042000', 'retty8', 'bharath3', 'syin4', 'ethanmorse', 'ematson5897', 'jacobzeshleman', 'leejq', 'harshini9962', 'reemali99_', 'xxlilmontysignxx', 'ramonruiz.infor', 'atharva98', 'ahern0722', 'chinmayanandadm', 'hishamzakaria20', 'cheokonn', 'adriangarea', 'jeanmichael.deschenes', 'samet1231234', 'mr4425', 'bluelobster', 'justin.lariviere.25', 'dcpang2', 'ftadros', 'felivitullo87', 'puertarcd', 'farahsamir978', 'jerry0075566', 'akozych2', 'nbs691', 'kie180073', 'anwar909', 'bleuminuit', 'atx203', 'kanet1234', 'sealseal', 'emrebuyukkose2', 'arrow823', 'dhvanil', 'nuanno97', 'dkshelat', 'mohabayman', 'ranasherif65', 'diamond92', 'ugur.cankaya.3718', 'ammareltalli', 'acn562', 'nabilah1403', 'yaseminablacandir', 'tamchouweng', 'ablahsaoud', 'sriharshap', 'mrefaat', 'bassamtarek', 'hamidausat', 'kakmeera1999', 'teoster50', 'nolmos96', 'abdurrahmn13', 'mmartinezsanchez', 'sandrabashara', 'zakhwan7', 'chengweiheng', 'nikalyaamani', 'acregodean', 'happyleexin', 'sarapl', 'williammitchell5818', None, 'rooban11', 'yeejou990318', 'kowjiajin', 'eescudermilian', 'nihaosawaddee', 'maxernest', 'yzhou91', 'david.garrido', 'guibill10', 'mohamedsameh', 'spazos7', 'tmi211', 'kie180039', 'worldlineusaf', 'mgk816', 'kie180079', 'ledicia97', 'movi205', 'shuming2']"
1,15,391,16,12,"['aboone06', 'kaustubh.shirpurkar', 'j.haliburton', 'ryanboucher', 'jpmcgee98', 'dhodapp', 'haclarke', 'michael.mechelay', 'ethanmorse', 'ematson5897', 'melaniejkramer', 'c.a.stupka']",379,"['oliviercharbonneau', 'miri23', 'ozgurkablan26', 'loisonchambers', 'tuberkargan_97', 'pranjal3', 'musabmalek0717', 'nadanasser1199', 'siemprewowthechami', 'staceyn2', 'vblanco.nico', 'abbesalaeddine', 'efrenhub', 'isabelmaria.vazquez', 'ahmedamr', 'shorouk_ossama', 'rikardberger', 'alancantu57', 'luciano.brignone', 'rahimnoorj', 'janeneil88', 'guttsfulltyagi', 'mjgebara14', 'kartal', 'gabrielyii99', 'saegner2', 'manuelsomoza94', 'amani12345', 'youssefsherif22', 'amr_ua07', 'evrenyigit', 'tingliang', 'kirankumar94', 'ahagras13', 'njgale01', 'al4995', 'smrdafdl', 'travisc2', 'dlee145', 'stambo', 'anthonyroux', 'ryanorem', 'moh.bahaa', 'ahchehyan', 'aimanadnan', 'veronica.mieites', 's_coriolis', 'trkmengkay', 'cbecker413', 'mcruces.fz', 'latecnologiameodia', 'gxiao2', 'emilechouinard', 'je_guilbert', 'yubai', 'sinasigurpinar', 'lauragdevesa', 'muvafikmelikkaya', 'kason.carroll', 'jbaggie2019', 'annahaozheng0606', 'jtorres17', 'ahmedayman2370', 'zikrizaki88995', 'yjenyiee155', '46harunakgul', 'alifzulkifli99', 'kaitlinh', 'tyy233', 'sdehoyos47', 'malgaca', 'lsleed', 'khazanv2', 'alexisdixon6', 'gc_1', 'jinsup2', 'rishu', 'amparo.castro.96', 'tbryan', 'martin32', 'akash140410107098', 'nowapoca', 'onaam8', 'pablosaavedra', 'camilolcastro97', 'khor', 'ankit6257', 'samashraf1', 'benoiturcotte', 'aishu98', 'rileyroca', 'david.peral.moran', 'kiruthikaabalu181996', 'taymacnichols', 'nagihankececi', 'carlosvigo1997', 'moh.ashraf105', 'baleko12345', 'ikhbal', 'afeefz', 'kie180031', 'bflores18', 'tdubnansky6', 'jorgecastelo5', 'andreadiazgar', 'david2397', 'bcperki2', 'rkchapman', 'jn1404', 'mateocampos', 'jzhan142', 'josepazmartin', 'brannon44', 'adfoz', 'avw2', 'youxing0309', 'scremin', 'lderemo', 'perezsarmar', 'ashutoshsinghhenry6', 'melroy_caeiro', 'viratbhatt007', 'fkl217', 'coderko3', 'alimatama', 'ammaralaa516', 'nadhnasorudin', 'adarsh123', 'jacquelinethardin', 'mjoza2', 'nihatyavuz', 'estebanrial', 'jinwoo2', 'adnanyuceer', 'danielfernandezcalo', 'berkaydean', 'cloudyoverhead', 'fred_dion', 'syedzakwan', 'e1150590', 'fcfrancapra94', 'amiruldanial99', 'ozbunar01', 'alecorti.pardo', 'electronica18', 'nourananwar123', 'olivier.gilbert.paquet', 'anibarseghyan', 'amlibrahim', 'neuroque', 'kychui2', 'shaf31', 'hong_gao', 'paul.aniruddha', 'carlosbesadaromero', 'mohaballam', 'pip29', 'apb5472', 'tuberkargan', 'hafizmokh99', 'javierisma98', 'fathy1104', 'corredoira', 'helenalecoq97', 'kimzihuang', 'muteki', 'masitadonmez', 'nadja1', 'dancastaneda', 'ahmedsameh1698', 'rocio', 'mallen22', 'ffazul64', 'guoyao', 'ari6nd', 'kerryreto', 'pedrosiaba', 'michaelsaldana1', 'omarmagdy', 'vickytubio', 'ericrobles', 'soccadelic44', 'selena', 'aasifhameed99', 'damlakubattt', 'anxovidal8', 'exjamil', 'jahnavikachhia', 'joker632455', 'vincentpainchaud.vp', 'svo4321', 'zhixin2', 'yansi', 'asyrafaqil', 'xyz11', 'virajput299', 'mariz', 'bhliu97', 'amrebrahim', 'abdulrahim2905', 'tonybocadillosgrandes', 'talwren', 'rxtodd', 'farah26', 'tss3', 'abieday1704', 'mavanzato0418', 'facundovia', 'cristinacigarran', 'nazimmath3', 'baohl2', 'ales.gajdacz', 'elad.d', 'kie180028', 'wahidiah52', 'kyang37', 'arifjalani99', 'lino13', 'jaimefookinlannister', 'physquig', 'adriancheah', 'jarodm2', 'noureldin1999', 'michael2010814', 'ckim123', 'eddin21', 'jipiccardi', 'prabuddha_888253127', 'david_atef', 'kalebhilde', 'magic_ocean99', 'saipraneett', 'sanchjai', 'omardeyaa', 'pingan99', 'aaq', 'alidsjt', 'mengkem2', 'oishikfaruque', 'ilou', 'aengm', 'janalorenzolumbreras', 'hilisa', 'carlosvillar54', 'vikazvereva', 'm939454', 'va844', 'pablobou4', 'ludovick.begin', 'maniphysics09', 'eduard25252598', 'apascao', 'xosegq16', 'adam562', 'lauramolinosmayo', 'amni99', 'kie180702', 'saharoaf', 'redzuan11', 'ypp200', 'kph2', 'martinzapata', 'kirolosehab99', 'restep2', 'seifhabib', 'maramtarek53', 'zehuahe2', 'azizijazam11', 'marcosanllo', 'aimansyaz99', 'elizametias12', 'juanmacano97', 'sparshagarwal1009', 'prakharbhargava0', 'njs035', 'alberfn', 'ramy_maged4', 'hmoulvi1', 'vanesagarcia', 'hf4', 'wowmuchchuck', 'mohammedemadeldin2000', 'gabrielyii', 'keerthisv', 'pythagoras2', 'xunyong', 'irenehb92', 'shradhap', 'mohameeddsamy', 'marianne.gratton.1', 'marcmagdy98', 'brknshn', 'gemma', 'lukunze1', 'caglanlee', 'desmondsoon', 'sebasket14', 'masonpb2', 'youssef2042000', 'retty8', 'bharath3', 'syin4', 'jacobzeshleman', 'leejq', 'harshini9962', 'reemali99_', 'xxlilmontysignxx', 'ramonruiz.infor', 'atharva98', 'ahern0722', 'hishamzakaria20', 'cheokonn', 'adriangarea', 'jeanmichael.deschenes', 'samet1231234', 'mr4425', 'bluelobster', 'justin.lariviere.25', 'dcpang2', 'felivitullo87', 'puertarcd', 'farahsamir978', 'akozych2', 'nbs691', 'kie180073', 'anwar909', 'bleuminuit', 'atx203', 'kanet1234', 'sealseal', 'emrebuyukkose2', 'arrow823', 'dhvanil', 'nuanno97', 'dkshelat', 'mohabayman', 'ranasherif65', 'diamond92', 'ugur.cankaya.3718', 'ammareltalli', 'acn562', 'nabilah1403', 'yaseminablacandir', 'tamchouweng', 'ablahsaoud', 'sriharshap', 'mrefaat', 'bassamtarek', 'hamidausat', 'kakmeera1999', 'teoster50', 'nolmos96', 'abdurrahmn13', 'mmartinezsanchez', 'sandrabashara', 'zakhwan7', 'chengweiheng', 'nikalyaamani', 'acregodean', 'happyleexin', 'sarapl', 'williammitchell5818', 'rooban11', 'yeejou990318', 'kowjiajin', 'nihaosawaddee', 'maxernest', 'david.garrido', 'guibill10', 'mohamedsameh', 'spazos7', 'tmi211', 'kie180039', 'worldlineusaf', 'mgk816', 'kie180079', 'ledicia97', 'movi205', 'shuming2']",4,"['lobwedge', 'c1650713', None, 'cburke2020']",395,"['oliviercharbonneau', 'miri23', 'ozgurkablan26', 'loisonchambers', 'tuberkargan_97', 'pranjal3', 'musabmalek0717', 'nadanasser1199', 'siemprewowthechami', 'staceyn2', 'vblanco.nico', 'abbesalaeddine', 'efrenhub', 'isabelmaria.vazquez', 'ahmedamr', 'shorouk_ossama', 'rikardberger', 'alancantu57', 'luciano.brignone', 'rahimnoorj', 'janeneil88', 'guttsfulltyagi', 'mjgebara14', 'kartal', 'gabrielyii99', 'aboone06', 'saegner2', 'manuelsomoza94', 'amani12345', 'youssefsherif22', 'j.haliburton', 'amr_ua07', 'evrenyigit', 'tingliang', 'kirankumar94', 'ahagras13', 'njgale01', 'al4995', 'smrdafdl', 'travisc2', 'dlee145', 'stambo', 'anthonyroux', 'ryanorem', 'moh.bahaa', 'ahchehyan', 'aimanadnan', 'veronica.mieites', 's_coriolis', 'trkmengkay', 'lobwedge', 'cbecker413', 'mcruces.fz', 'latecnologiameodia', 'gxiao2', 'emilechouinard', 'je_guilbert', 'yubai', 'cburke2020', 'sinasigurpinar', 'lauragdevesa', 'muvafikmelikkaya', 'kason.carroll', 'jbaggie2019', 'annahaozheng0606', 'jtorres17', 'ahmedayman2370', 'zikrizaki88995', 'yjenyiee155', '46harunakgul', 'alifzulkifli99', 'kaitlinh', 'tyy233', 'sdehoyos47', 'malgaca', 'lsleed', 'khazanv2', 'alexisdixon6', 'gc_1', 'jinsup2', 'rishu', 'amparo.castro.96', 'tbryan', 'martin32', 'michael.mechelay', 'akash140410107098', 'nowapoca', 'onaam8', 'pablosaavedra', 'camilolcastro97', 'khor', 'ankit6257', 'samashraf1', 'benoiturcotte', 'aishu98', 'rileyroca', 'david.peral.moran', 'kiruthikaabalu181996', 'taymacnichols', 'dhodapp', 'nagihankececi', 'carlosvigo1997', 'moh.ashraf105', 'baleko12345', 'ikhbal', 'afeefz', 'kaustubh.shirpurkar', 'kie180031', 'bflores18', 'tdubnansky6', 'jorgecastelo5', 'andreadiazgar', 'david2397', 'bcperki2', 'melaniejkramer', 'rkchapman', 'jn1404', 'mateocampos', 'jzhan142', 'josepazmartin', 'brannon44', 'adfoz', 'avw2', 'youxing0309', 'scremin', 'lderemo', 'perezsarmar', 'ashutoshsinghhenry6', 'melroy_caeiro', 'viratbhatt007', 'fkl217', 'coderko3', 'alimatama', 'ammaralaa516', 'nadhnasorudin', 'adarsh123', 'jacquelinethardin', 'mjoza2', 'nihatyavuz', 'estebanrial', 'jinwoo2', 'adnanyuceer', 'danielfernandezcalo', 'berkaydean', 'cloudyoverhead', 'fred_dion', 'syedzakwan', 'e1150590', 'fcfrancapra94', 'amiruldanial99', 'ozbunar01', 'alecorti.pardo', 'electronica18', 'nourananwar123', 'olivier.gilbert.paquet', 'anibarseghyan', 'amlibrahim', 'neuroque', 'kychui2', 'shaf31', 'hong_gao', 'paul.aniruddha', 'carlosbesadaromero', 'mohaballam', 'pip29', 'apb5472', 'tuberkargan', 'hafizmokh99', 'javierisma98', 'fathy1104', 'corredoira', 'helenalecoq97', 'kimzihuang', 'muteki', 'masitadonmez', 'nadja1', 'dancastaneda', 'ahmedsameh1698', 'rocio', 'mallen22', 'ffazul64', 'guoyao', 'ari6nd', 'kerryreto', 'pedrosiaba', 'michaelsaldana1', 'omarmagdy', 'vickytubio', 'ericrobles', 'soccadelic44', 'selena', 'aasifhameed99', 'damlakubattt', 'anxovidal8', 'exjamil', 'jahnavikachhia', 'joker632455', 'vincentpainchaud.vp', 'svo4321', 'zhixin2', 'yansi', 'asyrafaqil', 'xyz11', 'virajput299', 'ryanboucher', 'jpmcgee98', 'mariz', 'bhliu97', 'amrebrahim', 'abdulrahim2905', 'c.a.stupka', 'tonybocadillosgrandes', 'talwren', 'rxtodd', 'farah26', 'tss3', 'abieday1704', 'mavanzato0418', 'facundovia', 'cristinacigarran', 'nazimmath3', 'baohl2', 'ales.gajdacz', 'elad.d', 'kie180028', 'wahidiah52', 'kyang37', 'arifjalani99', 'lino13', 'jaimefookinlannister', 'physquig', 'adriancheah', 'jarodm2', 'noureldin1999', 'michael2010814', 'ckim123', 'eddin21', 'jipiccardi', 'prabuddha_888253127', 'david_atef', 'kalebhilde', 'magic_ocean99', 'saipraneett', 'sanchjai', 'omardeyaa', 'pingan99', 'aaq', 'alidsjt', 'mengkem2', 'haclarke', 'oishikfaruque', 'ilou', 'aengm', 'janalorenzolumbreras', 'hilisa', 'carlosvillar54', 'vikazvereva', 'm939454', 'va844', 'pablobou4', 'ludovick.begin', 'maniphysics09', 'eduard25252598', 'apascao', 'xosegq16', 'adam562', 'lauramolinosmayo', 'amni99', 'kie180702', 'saharoaf', 'redzuan11', 'ypp200', 'kph2', 'martinzapata', 'kirolosehab99', 'restep2', 'seifhabib', 'maramtarek53', 'zehuahe2', 'azizijazam11', 'marcosanllo', 'aimansyaz99', 'elizametias12', 'juanmacano97', 'sparshagarwal1009', 'prakharbhargava0', 'njs035', 'alberfn', 'ramy_maged4', 'hmoulvi1', 'vanesagarcia', 'hf4', 'wowmuchchuck', 'mohammedemadeldin2000', 'gabrielyii', 'keerthisv', 'pythagoras2', 'xunyong', 'irenehb92', 'shradhap', 'mohameeddsamy', 'marianne.gratton.1', 'marcmagdy98', 'brknshn', 'gemma', 'lukunze1', 'caglanlee', 'desmondsoon', 'sebasket14', 'masonpb2', 'youssef2042000', 'retty8', 'bharath3', 'syin4', 'ethanmorse', 'ematson5897', 'jacobzeshleman', 'leejq', 'harshini9962', 'reemali99_', 'xxlilmontysignxx', 'ramonruiz.infor', 'atharva98', 'ahern0722', 'hishamzakaria20', 'cheokonn', 'adriangarea', 'jeanmichael.deschenes', 'samet1231234', 'mr4425', 'bluelobster', 'justin.lariviere.25', 'dcpang2', 'felivitullo87', 'puertarcd', 'farahsamir978', 'akozych2', 'nbs691', 'kie180073', 'anwar909', 'bleuminuit', 'atx203', 'kanet1234', 'sealseal', 'emrebuyukkose2', 'arrow823', 'dhvanil', 'nuanno97', 'dkshelat', 'mohabayman', 'ranasherif65', 'diamond92', 'ugur.cankaya.3718', 'ammareltalli', 'acn562', 'nabilah1403', 'c1650713', 'yaseminablacandir', 'tamchouweng', 'ablahsaoud', 'sriharshap', 'mrefaat', 'bassamtarek', 'hamidausat', 'kakmeera1999', 'teoster50', 'nolmos96', 'abdurrahmn13', 'mmartinezsanchez', 'sandrabashara', 'zakhwan7', 'chengweiheng', 'nikalyaamani', 'acregodean', 'happyleexin', 'sarapl', 'williammitchell5818', None, 'rooban11', 'yeejou990318', 'kowjiajin', 'nihaosawaddee', 'maxernest', 'david.garrido', 'guibill10', 'mohamedsameh', 'spazos7', 'tmi211', 'kie180039', 'worldlineusaf', 'mgk816', 'kie180079', 'ledicia97', 'movi205', 'shuming2']"
1,25,391,16,14,"['alidsjt', 'anxovidal8', 'pablobou4', 'retty8', 'camilolcastro97', 'carlosvigo1997', 'martin32', 'siemprewowthechami', 'alimatama', 'lino13', 'david2397', 'janalorenzolumbreras', 'efrenhub', 'movi205']",377,"['oliviercharbonneau', 'miri23', 'ozgurkablan26', 'loisonchambers', 'tuberkargan_97', 'pranjal3', 'musabmalek0717', 'nadanasser1199', 'staceyn2', 'vblanco.nico', 'abbesalaeddine', 'isabelmaria.vazquez', 'ahmedamr', 'shorouk_ossama', 'rikardberger', 'alancantu57', 'luciano.brignone', 'rahimnoorj', 'janeneil88', 'guttsfulltyagi', 'mjgebara14', 'kartal', 'gabrielyii99', 'aboone06', 'saegner2', 'manuelsomoza94', 'amani12345', 'youssefsherif22', 'j.haliburton', 'amr_ua07', 'evrenyigit', 'tingliang', 'kirankumar94', 'ahagras13', 'njgale01', 'al4995', 'smrdafdl', 'travisc2', 'dlee145', 'stambo', 'anthonyroux', 'ryanorem', 'moh.bahaa', 'ahchehyan', 'aimanadnan', 'veronica.mieites', 's_coriolis', 'trkmengkay', 'cbecker413', 'mcruces.fz', 'latecnologiameodia', 'gxiao2', 'emilechouinard', 'je_guilbert', 'yubai', 'sinasigurpinar', 'lauragdevesa', 'muvafikmelikkaya', 'kason.carroll', 'jbaggie2019', 'annahaozheng0606', 'jtorres17', 'ahmedayman2370', 'zikrizaki88995', 'yjenyiee155', '46harunakgul', 'alifzulkifli99', 'kaitlinh', 'tyy233', 'sdehoyos47', 'malgaca', 'lsleed', 'khazanv2', 'alexisdixon6', 'gc_1', 'jinsup2', 'rishu', 'amparo.castro.96', 'tbryan', 'michael.mechelay', 'akash140410107098', 'nowapoca', 'onaam8', 'pablosaavedra', 'khor', 'ankit6257', 'samashraf1', 'benoiturcotte', 'aishu98', 'rileyroca', 'david.peral.moran', 'kiruthikaabalu181996', 'taymacnichols', 'dhodapp', 'nagihankececi', 'moh.ashraf105', 'baleko12345', 'ikhbal', 'afeefz', 'kaustubh.shirpurkar', 'kie180031', 'bflores18', 'tdubnansky6', 'jorgecastelo5', 'andreadiazgar', 'bcperki2', 'melaniejkramer', 'rkchapman', 'jn1404', 'mateocampos', 'jzhan142', 'josepazmartin', 'brannon44', 'adfoz', 'avw2', 'youxing0309', 'scremin', 'lderemo', 'perezsarmar', 'ashutoshsinghhenry6', 'melroy_caeiro', 'viratbhatt007', 'fkl217', 'coderko3', 'ammaralaa516', 'nadhnasorudin', 'adarsh123', 'jacquelinethardin', 'mjoza2', 'nihatyavuz', 'estebanrial', 'jinwoo2', 'adnanyuceer', 'danielfernandezcalo', 'berkaydean', 'cloudyoverhead', 'fred_dion', 'syedzakwan', 'e1150590', 'fcfrancapra94', 'amiruldanial99', 'ozbunar01', 'alecorti.pardo', 'electronica18', 'nourananwar123', 'olivier.gilbert.paquet', 'anibarseghyan', 'amlibrahim', 'neuroque', 'kychui2', 'shaf31', 'hong_gao', 'paul.aniruddha', 'carlosbesadaromero', 'mohaballam', 'pip29', 'apb5472', 'tuberkargan', 'hafizmokh99', 'javierisma98', 'fathy1104', 'corredoira', 'helenalecoq97', 'kimzihuang', 'muteki', 'masitadonmez', 'nadja1', 'dancastaneda', 'ahmedsameh1698', 'rocio', 'mallen22', 'ffazul64', 'guoyao', 'ari6nd', 'kerryreto', 'pedrosiaba', 'michaelsaldana1', 'omarmagdy', 'vickytubio', 'ericrobles', 'soccadelic44', 'selena', 'aasifhameed99', 'damlakubattt', 'exjamil', 'jahnavikachhia', 'joker632455', 'vincentpainchaud.vp', 'svo4321', 'zhixin2', 'yansi', 'asyrafaqil', 'xyz11', 'virajput299', 'ryanboucher', 'jpmcgee98', 'mariz', 'bhliu97', 'amrebrahim', 'abdulrahim2905', 'c.a.stupka', 'tonybocadillosgrandes', 'talwren', 'rxtodd', 'farah26', 'tss3', 'abieday1704', 'mavanzato0418', 'facundovia', 'cristinacigarran', 'nazimmath3', 'baohl2', 'ales.gajdacz', 'elad.d', 'kie180028', 'wahidiah52', 'kyang37', 'arifjalani99', 'jaimefookinlannister', 'physquig', 'adriancheah', 'jarodm2', 'noureldin1999', 'michael2010814', 'ckim123', 'eddin21', 'jipiccardi', 'prabuddha_888253127', 'david_atef', 'kalebhilde', 'magic_ocean99', 'saipraneett', 'sanchjai', 'omardeyaa', 'pingan99', 'aaq', 'mengkem2', 'haclarke', 'oishikfaruque', 'ilou', 'aengm', 'hilisa', 'carlosvillar54', 'vikazvereva', 'm939454', 'va844', 'ludovick.begin', 'maniphysics09', 'eduard25252598', 'apascao', 'xosegq16', 'adam562', 'lauramolinosmayo', 'amni99', 'kie180702', 'saharoaf', 'redzuan11', 'ypp200', 'kph2', 'martinzapata', 'kirolosehab99', 'restep2', 'seifhabib', 'maramtarek53', 'zehuahe2', 'azizijazam11', 'marcosanllo', 'aimansyaz99', 'elizametias12', 'juanmacano97', 'sparshagarwal1009', 'prakharbhargava0', 'njs035', 'alberfn', 'ramy_maged4', 'hmoulvi1', 'vanesagarcia', 'hf4', 'wowmuchchuck', 'mohammedemadeldin2000', 'gabrielyii', 'keerthisv', 'pythagoras2', 'xunyong', 'irenehb92', 'shradhap', 'mohameeddsamy', 'marianne.gratton.1', 'marcmagdy98', 'brknshn', 'gemma', 'lukunze1', 'caglanlee', 'desmondsoon', 'sebasket14', 'masonpb2', 'youssef2042000', 'bharath3', 'syin4', 'ethanmorse', 'ematson5897', 'jacobzeshleman', 'leejq', 'harshini9962', 'reemali99_', 'xxlilmontysignxx', 'ramonruiz.infor', 'atharva98', 'ahern0722', 'hishamzakaria20', 'cheokonn', 'adriangarea', 'jeanmichael.deschenes', 'samet1231234', 'mr4425', 'bluelobster', 'justin.lariviere.25', 'dcpang2', 'felivitullo87', 'puertarcd', 'farahsamir978', 'akozych2', 'nbs691', 'kie180073', 'anwar909', 'bleuminuit', 'atx203', 'kanet1234', 'sealseal', 'emrebuyukkose2', 'arrow823', 'dhvanil', 'nuanno97', 'dkshelat', 'mohabayman', 'ranasherif65', 'diamond92', 'ugur.cankaya.3718', 'ammareltalli', 'acn562', 'nabilah1403', 'yaseminablacandir', 'tamchouweng', 'ablahsaoud', 'sriharshap', 'mrefaat', 'bassamtarek', 'hamidausat', 'kakmeera1999', 'teoster50', 'nolmos96', 'abdurrahmn13', 'mmartinezsanchez', 'sandrabashara', 'zakhwan7', 'chengweiheng', 'nikalyaamani', 'acregodean', 'happyleexin', 'sarapl', 'williammitchell5818', 'rooban11', 'yeejou990318', 'kowjiajin', 'nihaosawaddee', 'maxernest', 'david.garrido', 'guibill10', 'mohamedsameh', 'spazos7', 'tmi211', 'kie180039', 'worldlineusaf', 'mgk816', 'kie180079', 'ledicia97', 'shuming2']",2,"['iago', None]",393,"['oliviercharbonneau', 'miri23', 'ozgurkablan26', 'loisonchambers', 'tuberkargan_97', 'pranjal3', 'musabmalek0717', 'nadanasser1199', 'siemprewowthechami', 'staceyn2', 'vblanco.nico', 'abbesalaeddine', 'efrenhub', 'isabelmaria.vazquez', 'ahmedamr', 'shorouk_ossama', 'rikardberger', 'alancantu57', 'luciano.brignone', 'rahimnoorj', 'janeneil88', 'guttsfulltyagi', 'mjgebara14', 'kartal', 'gabrielyii99', 'aboone06', 'saegner2', 'manuelsomoza94', 'amani12345', 'youssefsherif22', 'j.haliburton', 'amr_ua07', 'evrenyigit', 'tingliang', 'kirankumar94', 'ahagras13', 'njgale01', 'al4995', 'smrdafdl', 'travisc2', 'dlee145', 'stambo', 'anthonyroux', 'ryanorem', 'moh.bahaa', 'ahchehyan', 'aimanadnan', 'veronica.mieites', 's_coriolis', 'trkmengkay', 'cbecker413', 'mcruces.fz', 'latecnologiameodia', 'gxiao2', 'emilechouinard', 'je_guilbert', 'yubai', 'sinasigurpinar', 'lauragdevesa', 'muvafikmelikkaya', 'kason.carroll', 'jbaggie2019', 'annahaozheng0606', 'jtorres17', 'ahmedayman2370', 'zikrizaki88995', 'yjenyiee155', '46harunakgul', 'alifzulkifli99', 'kaitlinh', 'tyy233', 'sdehoyos47', 'malgaca', 'lsleed', 'khazanv2', 'alexisdixon6', 'gc_1', 'jinsup2', 'rishu', 'amparo.castro.96', 'tbryan', 'martin32', 'michael.mechelay', 'akash140410107098', 'nowapoca', 'onaam8', 'pablosaavedra', 'camilolcastro97', 'khor', 'ankit6257', 'samashraf1', 'benoiturcotte', 'aishu98', 'rileyroca', 'david.peral.moran', 'kiruthikaabalu181996', 'taymacnichols', 'dhodapp', 'nagihankececi', 'carlosvigo1997', 'moh.ashraf105', 'baleko12345', 'ikhbal', 'afeefz', 'kaustubh.shirpurkar', 'kie180031', 'bflores18', 'tdubnansky6', 'jorgecastelo5', 'andreadiazgar', 'david2397', 'bcperki2', 'melaniejkramer', 'rkchapman', 'jn1404', 'mateocampos', 'jzhan142', 'josepazmartin', 'brannon44', 'adfoz', 'avw2', 'youxing0309', 'scremin', 'lderemo', 'perezsarmar', 'ashutoshsinghhenry6', 'melroy_caeiro', 'viratbhatt007', 'fkl217', 'coderko3', 'alimatama', 'ammaralaa516', 'nadhnasorudin', 'adarsh123', 'jacquelinethardin', 'mjoza2', 'nihatyavuz', 'estebanrial', 'jinwoo2', 'adnanyuceer', 'danielfernandezcalo', 'berkaydean', 'cloudyoverhead', 'fred_dion', 'syedzakwan', 'e1150590', 'fcfrancapra94', 'amiruldanial99', 'ozbunar01', 'alecorti.pardo', 'electronica18', 'nourananwar123', 'olivier.gilbert.paquet', 'anibarseghyan', 'amlibrahim', 'neuroque', 'kychui2', 'shaf31', 'hong_gao', 'paul.aniruddha', 'carlosbesadaromero', 'mohaballam', 'pip29', 'apb5472', 'tuberkargan', 'hafizmokh99', 'javierisma98', 'fathy1104', 'corredoira', 'helenalecoq97', 'kimzihuang', 'muteki', 'iago', 'masitadonmez', 'nadja1', 'dancastaneda', 'ahmedsameh1698', 'rocio', 'mallen22', 'ffazul64', 'guoyao', 'ari6nd', 'kerryreto', 'pedrosiaba', 'michaelsaldana1', 'omarmagdy', 'vickytubio', 'ericrobles', 'soccadelic44', 'selena', 'aasifhameed99', 'damlakubattt', 'anxovidal8', 'exjamil', 'jahnavikachhia', 'joker632455', 'vincentpainchaud.vp', 'svo4321', 'zhixin2', 'yansi', 'asyrafaqil', 'xyz11', 'virajput299', 'ryanboucher', 'jpmcgee98', 'mariz', 'bhliu97', 'amrebrahim', 'abdulrahim2905', 'c.a.stupka', 'tonybocadillosgrandes', 'talwren', 'rxtodd', 'farah26', 'tss3', 'abieday1704', 'mavanzato0418', 'facundovia', 'cristinacigarran', 'nazimmath3', 'baohl2', 'ales.gajdacz', 'elad.d', 'kie180028', 'wahidiah52', 'kyang37', 'arifjalani99', 'lino13', 'jaimefookinlannister', 'physquig', 'adriancheah', 'jarodm2', 'noureldin1999', 'michael2010814', 'ckim123', 'eddin21', 'jipiccardi', 'prabuddha_888253127', 'david_atef', 'kalebhilde', 'magic_ocean99', 'saipraneett', 'sanchjai', 'omardeyaa', 'pingan99', 'aaq', 'alidsjt', 'mengkem2', 'haclarke', 'oishikfaruque', 'ilou', 'aengm', 'janalorenzolumbreras', 'hilisa', 'carlosvillar54', 'vikazvereva', 'm939454', 'va844', 'pablobou4', 'ludovick.begin', 'maniphysics09', 'eduard25252598', 'apascao', 'xosegq16', 'adam562', 'lauramolinosmayo', 'amni99', 'kie180702', 'saharoaf', 'redzuan11', 'ypp200', 'kph2', 'martinzapata', 'kirolosehab99', 'restep2', 'seifhabib', 'maramtarek53', 'zehuahe2', 'azizijazam11', 'marcosanllo', 'aimansyaz99', 'elizametias12', 'juanmacano97', 'sparshagarwal1009', 'prakharbhargava0', 'njs035', 'alberfn', 'ramy_maged4', 'hmoulvi1', 'vanesagarcia', 'hf4', 'wowmuchchuck', 'mohammedemadeldin2000', 'gabrielyii', 'keerthisv', 'pythagoras2', 'xunyong', 'irenehb92', 'shradhap', 'mohameeddsamy', 'marianne.gratton.1', 'marcmagdy98', 'brknshn', 'gemma', 'lukunze1', 'caglanlee', 'desmondsoon', 'sebasket14', 'masonpb2', 'youssef2042000', 'retty8', 'bharath3', 'syin4', 'ethanmorse', 'ematson5897', 'jacobzeshleman', 'leejq', 'harshini9962', 'reemali99_', 'xxlilmontysignxx', 'ramonruiz.infor', 'atharva98', 'ahern0722', 'hishamzakaria20', 'cheokonn', 'adriangarea', 'jeanmichael.deschenes', 'samet1231234', 'mr4425', 'bluelobster', 'justin.lariviere.25', 'dcpang2', 'felivitullo87', 'puertarcd', 'farahsamir978', 'akozych2', 'nbs691', 'kie180073', 'anwar909', 'bleuminuit', 'atx203', 'kanet1234', 'sealseal', 'emrebuyukkose2', 'arrow823', 'dhvanil', 'nuanno97', 'dkshelat', 'mohabayman', 'ranasherif65', 'diamond92', 'ugur.cankaya.3718', 'ammareltalli', 'acn562', 'nabilah1403', 'yaseminablacandir', 'tamchouweng', 'ablahsaoud', 'sriharshap', 'mrefaat', 'bassamtarek', 'hamidausat', 'kakmeera1999', 'teoster50', 'nolmos96', 'abdurrahmn13', 'mmartinezsanchez', 'sandrabashara', 'zakhwan7', 'chengweiheng', 'nikalyaamani', 'acregodean', 'happyleexin', 'sarapl', 'williammitchell5818', None, 'rooban11', 'yeejou990318', 'kowjiajin', 'nihaosawaddee', 'maxernest', 'david.garrido', 'guibill10', 'mohamedsameh', 'spazos7', 'tmi211', 'kie180039', 'worldlineusaf', 'mgk816', 'kie180079', 'ledicia97', 'movi205', 'shuming2']"
1,37,391,16,12,"['lsleed', 'alidsjt', 'cristinacigarran', 'martin32', 'alimatama', 'electronica18', 'lino13', 'david2397', 'veronica.mieites', 'janalorenzolumbreras', 'movi205', 'perezsarmar']",379,"['oliviercharbonneau', 'miri23', 'ozgurkablan26', 'loisonchambers', 'tuberkargan_97', 'pranjal3', 'musabmalek0717', 'nadanasser1199', 'siemprewowthechami', 'staceyn2', 'vblanco.nico', 'abbesalaeddine', 'efrenhub', 'isabelmaria.vazquez', 'ahmedamr', 'shorouk_ossama', 'rikardberger', 'alancantu57', 'luciano.brignone', 'rahimnoorj', 'janeneil88', 'guttsfulltyagi', 'mjgebara14', 'kartal', 'gabrielyii99', 'aboone06', 'saegner2', 'manuelsomoza94', 'amani12345', 'youssefsherif22', 'j.haliburton', 'amr_ua07', 'evrenyigit', 'tingliang', 'kirankumar94', 'ahagras13', 'njgale01', 'al4995', 'smrdafdl', 'travisc2', 'dlee145', 'stambo', 'anthonyroux', 'ryanorem', 'moh.bahaa', 'ahchehyan', 'aimanadnan', 's_coriolis', 'trkmengkay', 'cbecker413', 'mcruces.fz', 'latecnologiameodia', 'gxiao2', 'emilechouinard', 'je_guilbert', 'yubai', 'sinasigurpinar', 'lauragdevesa', 'muvafikmelikkaya', 'kason.carroll', 'jbaggie2019', 'annahaozheng0606', 'jtorres17', 'ahmedayman2370', 'zikrizaki88995', 'yjenyiee155', '46harunakgul', 'alifzulkifli99', 'kaitlinh', 'tyy233', 'sdehoyos47', 'malgaca', 'khazanv2', 'alexisdixon6', 'gc_1', 'jinsup2', 'rishu', 'amparo.castro.96', 'tbryan', 'michael.mechelay', 'akash140410107098', 'nowapoca', 'onaam8', 'pablosaavedra', 'camilolcastro97', 'khor', 'ankit6257', 'samashraf1', 'benoiturcotte', 'aishu98', 'rileyroca', 'david.peral.moran', 'kiruthikaabalu181996', 'taymacnichols', 'dhodapp', 'nagihankececi', 'carlosvigo1997', 'moh.ashraf105', 'baleko12345', 'ikhbal', 'afeefz', 'kaustubh.shirpurkar', 'kie180031', 'bflores18', 'tdubnansky6', 'jorgecastelo5', 'andreadiazgar', 'bcperki2', 'melaniejkramer', 'rkchapman', 'jn1404', 'mateocampos', 'jzhan142', 'josepazmartin', 'brannon44', 'adfoz', 'avw2', 'youxing0309', 'scremin', 'lderemo', 'ashutoshsinghhenry6', 'melroy_caeiro', 'viratbhatt007', 'fkl217', 'coderko3', 'ammaralaa516', 'nadhnasorudin', 'adarsh123', 'jacquelinethardin', 'mjoza2', 'nihatyavuz', 'estebanrial', 'jinwoo2', 'adnanyuceer', 'danielfernandezcalo', 'berkaydean', 'cloudyoverhead', 'fred_dion', 'syedzakwan', 'e1150590', 'fcfrancapra94', 'amiruldanial99', 'ozbunar01', 'alecorti.pardo', 'nourananwar123', 'olivier.gilbert.paquet', 'anibarseghyan', 'amlibrahim', 'neuroque', 'kychui2', 'shaf31', 'hong_gao', 'paul.aniruddha', 'carlosbesadaromero', 'mohaballam', 'pip29', 'apb5472', 'tuberkargan', 'hafizmokh99', 'javierisma98', 'fathy1104', 'corredoira', 'helenalecoq97', 'kimzihuang', 'muteki', 'masitadonmez', 'nadja1', 'dancastaneda', 'ahmedsameh1698', 'rocio', 'mallen22', 'ffazul64', 'guoyao', 'ari6nd', 'kerryreto', 'pedrosiaba', 'michaelsaldana1', 'omarmagdy', 'vickytubio', 'ericrobles', 'soccadelic44', 'selena', 'aasifhameed99', 'damlakubattt', 'anxovidal8', 'exjamil', 'jahnavikachhia', 'joker632455', 'vincentpainchaud.vp', 'svo4321', 'zhixin2', 'yansi', 'asyrafaqil', 'xyz11', 'virajput299', 'ryanboucher', 'jpmcgee98', 'mariz', 'bhliu97', 'amrebrahim', 'abdulrahim2905', 'c.a.stupka', 'tonybocadillosgrandes', 'talwren', 'rxtodd', 'farah26', 'tss3', 'abieday1704', 'mavanzato0418', 'facundovia', 'nazimmath3', 'baohl2', 'ales.gajdacz', 'elad.d', 'kie180028', 'wahidiah52', 'kyang37', 'arifjalani99', 'jaimefookinlannister', 'physquig', 'adriancheah', 'jarodm2', 'noureldin1999', 'michael2010814', 'ckim123', 'eddin21', 'jipiccardi', 'prabuddha_888253127', 'david_atef', 'kalebhilde', 'magic_ocean99', 'saipraneett', 'sanchjai', 'omardeyaa', 'pingan99', 'aaq', 'mengkem2', 'haclarke', 'oishikfaruque', 'ilou', 'aengm', 'hilisa', 'carlosvillar54', 'vikazvereva', 'm939454', 'va844', 'pablobou4', 'ludovick.begin', 'maniphysics09', 'eduard25252598', 'apascao', 'xosegq16', 'adam562', 'lauramolinosmayo', 'amni99', 'kie180702', 'saharoaf', 'redzuan11', 'ypp200', 'kph2', 'martinzapata', 'kirolosehab99', 'restep2', 'seifhabib', 'maramtarek53', 'zehuahe2', 'azizijazam11', 'marcosanllo', 'aimansyaz99', 'elizametias12', 'juanmacano97', 'sparshagarwal1009', 'prakharbhargava0', 'njs035', 'alberfn', 'ramy_maged4', 'hmoulvi1', 'vanesagarcia', 'hf4', 'wowmuchchuck', 'mohammedemadeldin2000', 'gabrielyii', 'keerthisv', 'pythagoras2', 'xunyong', 'irenehb92', 'shradhap', 'mohameeddsamy', 'marianne.gratton.1', 'marcmagdy98', 'brknshn', 'gemma', 'lukunze1', 'caglanlee', 'desmondsoon', 'sebasket14', 'masonpb2', 'youssef2042000', 'retty8', 'bharath3', 'syin4', 'ethanmorse', 'ematson5897', 'jacobzeshleman', 'leejq', 'harshini9962', 'reemali99_', 'xxlilmontysignxx', 'ramonruiz.infor', 'atharva98', 'ahern0722', 'hishamzakaria20', 'cheokonn', 'adriangarea', 'jeanmichael.deschenes', 'samet1231234', 'mr4425', 'bluelobster', 'justin.lariviere.25', 'dcpang2', 'felivitullo87', 'puertarcd', 'farahsamir978', 'akozych2', 'nbs691', 'kie180073', 'anwar909', 'bleuminuit', 'atx203', 'kanet1234', 'sealseal', 'emrebuyukkose2', 'arrow823', 'dhvanil', 'nuanno97', 'dkshelat', 'mohabayman', 'ranasherif65', 'diamond92', 'ugur.cankaya.3718', 'ammareltalli', 'acn562', 'nabilah1403', 'yaseminablacandir', 'tamchouweng', 'ablahsaoud', 'sriharshap', 'mrefaat', 'bassamtarek', 'hamidausat', 'kakmeera1999', 'teoster50', 'nolmos96', 'abdurrahmn13', 'mmartinezsanchez', 'sandrabashara', 'zakhwan7', 'chengweiheng', 'nikalyaamani', 'acregodean', 'happyleexin', 'sarapl', 'williammitchell5818', 'rooban11', 'yeejou990318', 'kowjiajin', 'nihaosawaddee', 'maxernest', 'david.garrido', 'guibill10', 'mohamedsameh', 'spazos7', 'tmi211', 'kie180039', 'worldlineusaf', 'mgk816', 'kie180079', 'ledicia97', 'shuming2']",4,"['dokun', None, 'dfl', 'gombut']",395,"['oliviercharbonneau', 'miri23', 'ozgurkablan26', 'loisonchambers', 'tuberkargan_97', 'pranjal3', 'musabmalek0717', 'nadanasser1199', 'siemprewowthechami', 'staceyn2', 'vblanco.nico', 'abbesalaeddine', 'efrenhub', 'isabelmaria.vazquez', 'ahmedamr', 'shorouk_ossama', 'rikardberger', 'alancantu57', 'luciano.brignone', 'rahimnoorj', 'janeneil88', 'guttsfulltyagi', 'mjgebara14', 'kartal', 'gabrielyii99', 'aboone06', 'saegner2', 'manuelsomoza94', 'amani12345', 'youssefsherif22', 'j.haliburton', 'amr_ua07', 'evrenyigit', 'tingliang', 'kirankumar94', 'ahagras13', 'njgale01', 'al4995', 'smrdafdl', 'travisc2', 'dlee145', 'stambo', 'anthonyroux', 'ryanorem', 'moh.bahaa', 'ahchehyan', 'aimanadnan', 'veronica.mieites', 's_coriolis', 'trkmengkay', 'cbecker413', 'mcruces.fz', 'latecnologiameodia', 'gxiao2', 'emilechouinard', 'je_guilbert', 'yubai', 'sinasigurpinar', 'lauragdevesa', 'muvafikmelikkaya', 'kason.carroll', 'jbaggie2019', 'annahaozheng0606', 'jtorres17', 'ahmedayman2370', 'zikrizaki88995', 'yjenyiee155', '46harunakgul', 'alifzulkifli99', 'kaitlinh', 'tyy233', 'sdehoyos47', 'malgaca', 'lsleed', 'khazanv2', 'alexisdixon6', 'gc_1', 'jinsup2', 'rishu', 'amparo.castro.96', 'tbryan', 'martin32', 'michael.mechelay', 'akash140410107098', 'nowapoca', 'onaam8', 'pablosaavedra', 'camilolcastro97', 'khor', 'ankit6257', 'samashraf1', 'benoiturcotte', 'aishu98', 'rileyroca', 'david.peral.moran', 'kiruthikaabalu181996', 'taymacnichols', 'dhodapp', 'nagihankececi', 'carlosvigo1997', 'moh.ashraf105', 'baleko12345', 'ikhbal', 'afeefz', 'kaustubh.shirpurkar', 'kie180031', 'bflores18', 'tdubnansky6', 'jorgecastelo5', 'andreadiazgar', 'david2397', 'bcperki2', 'melaniejkramer', 'rkchapman', 'jn1404', 'mateocampos', 'jzhan142', 'josepazmartin', 'brannon44', 'adfoz', 'avw2', 'youxing0309', 'scremin', 'lderemo', 'perezsarmar', 'ashutoshsinghhenry6', 'melroy_caeiro', 'viratbhatt007', 'fkl217', 'coderko3', 'alimatama', 'ammaralaa516', 'nadhnasorudin', 'adarsh123', 'jacquelinethardin', 'mjoza2', 'nihatyavuz', 'estebanrial', 'jinwoo2', 'adnanyuceer', 'danielfernandezcalo', 'berkaydean', 'cloudyoverhead', 'fred_dion', 'syedzakwan', 'e1150590', 'fcfrancapra94', 'amiruldanial99', 'ozbunar01', 'alecorti.pardo', 'electronica18', 'nourananwar123', 'olivier.gilbert.paquet', 'anibarseghyan', 'amlibrahim', 'neuroque', 'kychui2', 'shaf31', 'hong_gao', 'paul.aniruddha', 'carlosbesadaromero', 'mohaballam', 'pip29', 'apb5472', 'tuberkargan', 'hafizmokh99', 'javierisma98', 'fathy1104', 'corredoira', 'helenalecoq97', 'kimzihuang', 'muteki', 'masitadonmez', 'nadja1', 'dancastaneda', 'ahmedsameh1698', 'rocio', 'mallen22', 'ffazul64', 'guoyao', 'ari6nd', 'kerryreto', 'pedrosiaba', 'michaelsaldana1', 'omarmagdy', 'vickytubio', 'ericrobles', 'soccadelic44', 'selena', 'aasifhameed99', 'damlakubattt', 'anxovidal8', 'exjamil', 'jahnavikachhia', 'joker632455', 'vincentpainchaud.vp', 'svo4321', 'zhixin2', 'yansi', 'asyrafaqil', 'xyz11', 'virajput299', 'ryanboucher', 'jpmcgee98', 'mariz', 'bhliu97', 'amrebrahim', 'abdulrahim2905', 'c.a.stupka', 'tonybocadillosgrandes', 'talwren', 'rxtodd', 'dokun', 'farah26', 'tss3', 'abieday1704', 'mavanzato0418', 'gombut', 'facundovia', 'cristinacigarran', 'nazimmath3', 'baohl2', 'ales.gajdacz', 'elad.d', 'kie180028', 'wahidiah52', 'kyang37', 'arifjalani99', 'lino13', 'jaimefookinlannister', 'physquig', 'adriancheah', 'jarodm2', 'noureldin1999', 'michael2010814', 'ckim123', 'eddin21', 'jipiccardi', 'prabuddha_888253127', 'david_atef', 'kalebhilde', 'magic_ocean99', 'saipraneett', 'sanchjai', 'omardeyaa', 'pingan99', 'aaq', 'alidsjt', 'mengkem2', 'haclarke', 'oishikfaruque', 'ilou', 'aengm', 'janalorenzolumbreras', 'hilisa', 'carlosvillar54', 'vikazvereva', 'm939454', 'va844', 'pablobou4', 'ludovick.begin', 'maniphysics09', 'eduard25252598', 'apascao', 'xosegq16', 'adam562', 'lauramolinosmayo', 'amni99', 'kie180702', 'saharoaf', 'redzuan11', 'ypp200', 'kph2', 'martinzapata', 'kirolosehab99', 'restep2', 'seifhabib', 'maramtarek53', 'zehuahe2', 'azizijazam11', 'marcosanllo', 'aimansyaz99', 'elizametias12', 'juanmacano97', 'sparshagarwal1009', 'prakharbhargava0', 'njs035', 'alberfn', 'ramy_maged4', 'hmoulvi1', 'vanesagarcia', 'hf4', 'wowmuchchuck', 'mohammedemadeldin2000', 'gabrielyii', 'keerthisv', 'pythagoras2', 'xunyong', 'irenehb92', 'shradhap', 'mohameeddsamy', 'marianne.gratton.1', 'marcmagdy98', 'brknshn', 'gemma', 'lukunze1', 'caglanlee', 'desmondsoon', 'sebasket14', 'masonpb2', 'youssef2042000', 'retty8', 'bharath3', 'syin4', 'ethanmorse', 'ematson5897', 'jacobzeshleman', 'leejq', 'harshini9962', 'reemali99_', 'xxlilmontysignxx', 'ramonruiz.infor', 'atharva98', 'ahern0722', 'hishamzakaria20', 'cheokonn', 'adriangarea', 'jeanmichael.deschenes', 'samet1231234', 'mr4425', 'bluelobster', 'justin.lariviere.25', 'dcpang2', 'felivitullo87', 'puertarcd', 'farahsamir978', 'akozych2', 'nbs691', 'kie180073', 'anwar909', 'bleuminuit', 'atx203', 'kanet1234', 'sealseal', 'emrebuyukkose2', 'arrow823', 'dhvanil', 'nuanno97', 'dkshelat', 'mohabayman', 'ranasherif65', 'diamond92', 'ugur.cankaya.3718', 'ammareltalli', 'acn562', 'nabilah1403', 'yaseminablacandir', 'tamchouweng', 'ablahsaoud', 'sriharshap', 'mrefaat', 'bassamtarek', 'hamidausat', 'kakmeera1999', 'teoster50', 'nolmos96', 'abdurrahmn13', 'mmartinezsanchez', 'sandrabashara', 'zakhwan7', 'chengweiheng', 'nikalyaamani', 'acregodean', 'happyleexin', 'sarapl', 'williammitchell5818', None, 'rooban11', 'yeejou990318', 'kowjiajin', 'nihaosawaddee', 'maxernest', 'dfl', 'david.garrido', 'guibill10', 'mohamedsameh', 'spazos7', 'tmi211', 'kie180039', 'worldlineusaf', 'mgk816', 'kie180079', 'ledicia97', 'movi205', 'shuming2']"
1,135,391,16,9,"['michael2010814', 'va844', 'atx203', 'fkl217', 'mr4425', 'tmi211', 'al4995', 'jn1404', 'tyy233']",382,"['oliviercharbonneau', 'miri23', 'ozgurkablan26', 'loisonchambers', 'tuberkargan_97', 'pranjal3', 'musabmalek0717', 'nadanasser1199', 'siemprewowthechami', 'staceyn2', 'vblanco.nico', 'abbesalaeddine', 'efrenhub', 'isabelmaria.vazquez', 'ahmedamr', 'shorouk_ossama', 'rikardberger', 'alancantu57', 'luciano.brignone', 'rahimnoorj', 'janeneil88', 'guttsfulltyagi', 'mjgebara14', 'kartal', 'gabrielyii99', 'aboone06', 'saegner2', 'manuelsomoza94', 'amani12345', 'youssefsherif22', 'j.haliburton', 'amr_ua07', 'evrenyigit', 'tingliang', 'kirankumar94', 'ahagras13', 'njgale01', 'smrdafdl', 'travisc2', 'dlee145', 'stambo', 'anthonyroux', 'ryanorem', 'moh.bahaa', 'ahchehyan', 'aimanadnan', 'veronica.mieites', 's_coriolis', 'trkmengkay', 'cbecker413', 'mcruces.fz', 'latecnologiameodia', 'gxiao2', 'emilechouinard', 'je_guilbert', 'yubai', 'sinasigurpinar', 'lauragdevesa', 'muvafikmelikkaya', 'kason.carroll', 'jbaggie2019', 'annahaozheng0606', 'jtorres17', 'ahmedayman2370', 'zikrizaki88995', 'yjenyiee155', '46harunakgul', 'alifzulkifli99', 'kaitlinh', 'sdehoyos47', 'malgaca', 'lsleed', 'khazanv2', 'alexisdixon6', 'gc_1', 'jinsup2', 'rishu', 'amparo.castro.96', 'tbryan', 'martin32', 'michael.mechelay', 'akash140410107098', 'nowapoca', 'onaam8', 'pablosaavedra', 'camilolcastro97', 'khor', 'ankit6257', 'samashraf1', 'benoiturcotte', 'aishu98', 'rileyroca', 'david.peral.moran', 'kiruthikaabalu181996', 'taymacnichols', 'dhodapp', 'nagihankececi', 'carlosvigo1997', 'moh.ashraf105', 'baleko12345', 'ikhbal', 'afeefz', 'kaustubh.shirpurkar', 'kie180031', 'bflores18', 'tdubnansky6', 'jorgecastelo5', 'andreadiazgar', 'david2397', 'bcperki2', 'melaniejkramer', 'rkchapman', 'mateocampos', 'jzhan142', 'josepazmartin', 'brannon44', 'adfoz', 'avw2', 'youxing0309', 'scremin', 'lderemo', 'perezsarmar', 'ashutoshsinghhenry6', 'melroy_caeiro', 'viratbhatt007', 'coderko3', 'alimatama', 'ammaralaa516', 'nadhnasorudin', 'adarsh123', 'jacquelinethardin', 'mjoza2', 'nihatyavuz', 'estebanrial', 'jinwoo2', 'adnanyuceer', 'danielfernandezcalo', 'berkaydean', 'cloudyoverhead', 'fred_dion', 'syedzakwan', 'e1150590', 'fcfrancapra94', 'amiruldanial99', 'ozbunar01', 'alecorti.pardo', 'electronica18', 'nourananwar123', 'olivier.gilbert.paquet', 'anibarseghyan', 'amlibrahim', 'neuroque', 'kychui2', 'shaf31', 'hong_gao', 'paul.aniruddha', 'carlosbesadaromero', 'mohaballam', 'pip29', 'apb5472', 'tuberkargan', 'hafizmokh99', 'javierisma98', 'fathy1104', 'corredoira', 'helenalecoq97', 'kimzihuang', 'muteki', 'masitadonmez', 'nadja1', 'dancastaneda', 'ahmedsameh1698', 'rocio', 'mallen22', 'ffazul64', 'guoyao', 'ari6nd', 'kerryreto', 'pedrosiaba', 'michaelsaldana1', 'omarmagdy', 'vickytubio', 'ericrobles', 'soccadelic44', 'selena', 'aasifhameed99', 'damlakubattt', 'anxovidal8', 'exjamil', 'jahnavikachhia', 'joker632455', 'vincentpainchaud.vp', 'svo4321', 'zhixin2', 'yansi', 'asyrafaqil', 'xyz11', 'virajput299', 'ryanboucher', 'jpmcgee98', 'mariz', 'bhliu97', 'amrebrahim', 'abdulrahim2905', 'c.a.stupka', 'tonybocadillosgrandes', 'talwren', 'rxtodd', 'farah26', 'tss3', 'abieday1704', 'mavanzato0418', 'facundovia', 'cristinacigarran', 'nazimmath3', 'baohl2', 'ales.gajdacz', 'elad.d', 'kie180028', 'wahidiah52', 'kyang37', 'arifjalani99', 'lino13', 'jaimefookinlannister', 'physquig', 'adriancheah', 'jarodm2', 'noureldin1999', 'ckim123', 'eddin21', 'jipiccardi', 'prabuddha_888253127', 'david_atef', 'kalebhilde', 'magic_ocean99', 'saipraneett', 'sanchjai', 'omardeyaa', 'pingan99', 'aaq', 'alidsjt', 'mengkem2', 'haclarke', 'oishikfaruque', 'ilou', 'aengm', 'janalorenzolumbreras', 'hilisa', 'carlosvillar54', 'vikazvereva', 'm939454', 'pablobou4', 'ludovick.begin', 'maniphysics09', 'eduard25252598', 'apascao', 'xosegq16', 'adam562', 'lauramolinosmayo', 'amni99', 'kie180702', 'saharoaf', 'redzuan11', 'ypp200', 'kph2', 'martinzapata', 'kirolosehab99', 'restep2', 'seifhabib', 'maramtarek53', 'zehuahe2', 'azizijazam11', 'marcosanllo', 'aimansyaz99', 'elizametias12', 'juanmacano97', 'sparshagarwal1009', 'prakharbhargava0', 'njs035', 'alberfn', 'ramy_maged4', 'hmoulvi1', 'vanesagarcia', 'hf4', 'wowmuchchuck', 'mohammedemadeldin2000', 'gabrielyii', 'keerthisv', 'pythagoras2', 'xunyong', 'irenehb92', 'shradhap', 'mohameeddsamy', 'marianne.gratton.1', 'marcmagdy98', 'brknshn', 'gemma', 'lukunze1', 'caglanlee', 'desmondsoon', 'sebasket14', 'masonpb2', 'youssef2042000', 'retty8', 'bharath3', 'syin4', 'ethanmorse', 'ematson5897', 'jacobzeshleman', 'leejq', 'harshini9962', 'reemali99_', 'xxlilmontysignxx', 'ramonruiz.infor', 'atharva98', 'ahern0722', 'hishamzakaria20', 'cheokonn', 'adriangarea', 'jeanmichael.deschenes', 'samet1231234', 'bluelobster', 'justin.lariviere.25', 'dcpang2', 'felivitullo87', 'puertarcd', 'farahsamir978', 'akozych2', 'nbs691', 'kie180073', 'anwar909', 'bleuminuit', 'kanet1234', 'sealseal', 'emrebuyukkose2', 'arrow823', 'dhvanil', 'nuanno97', 'dkshelat', 'mohabayman', 'ranasherif65', 'diamond92', 'ugur.cankaya.3718', 'ammareltalli', 'acn562', 'nabilah1403', 'yaseminablacandir', 'tamchouweng', 'ablahsaoud', 'sriharshap', 'mrefaat', 'bassamtarek', 'hamidausat', 'kakmeera1999', 'teoster50', 'nolmos96', 'abdurrahmn13', 'mmartinezsanchez', 'sandrabashara', 'zakhwan7', 'chengweiheng', 'nikalyaamani', 'acregodean', 'happyleexin', 'sarapl', 'williammitchell5818', 'rooban11', 'yeejou990318', 'kowjiajin', 'nihaosawaddee', 'maxernest', 'david.garrido', 'guibill10', 'mohamedsameh', 'spazos7', 'kie180039', 'worldlineusaf', 'mgk816', 'kie180079', 'ledicia97', 'movi205', 'shuming2']",7,"['xc882', 'erincrowe', 'mh4208', 'vmj226', 'cki210', None, 'ab6858']",398,"['oliviercharbonneau', 'miri23', 'ozgurkablan26', 'loisonchambers', 'tuberkargan_97', 'pranjal3', 'musabmalek0717', 'nadanasser1199', 'siemprewowthechami', 'staceyn2', 'vblanco.nico', 'abbesalaeddine', 'efrenhub', 'isabelmaria.vazquez', 'ahmedamr', 'shorouk_ossama', 'rikardberger', 'alancantu57', 'luciano.brignone', 'rahimnoorj', 'janeneil88', 'guttsfulltyagi', 'mjgebara14', 'kartal', 'gabrielyii99', 'aboone06', 'saegner2', 'manuelsomoza94', 'amani12345', 'youssefsherif22', 'j.haliburton', 'amr_ua07', 'evrenyigit', 'tingliang', 'kirankumar94', 'ahagras13', 'njgale01', 'al4995', 'smrdafdl', 'travisc2', 'dlee145', 'stambo', 'anthonyroux', 'ryanorem', 'moh.bahaa', 'ahchehyan', 'aimanadnan', 'veronica.mieites', 's_coriolis', 'trkmengkay', 'cbecker413', 'mcruces.fz', 'latecnologiameodia', 'gxiao2', 'emilechouinard', 'je_guilbert', 'yubai', 'sinasigurpinar', 'lauragdevesa', 'muvafikmelikkaya', 'kason.carroll', 'jbaggie2019', 'annahaozheng0606', 'jtorres17', 'ahmedayman2370', 'zikrizaki88995', 'yjenyiee155', '46harunakgul', 'alifzulkifli99', 'kaitlinh', 'tyy233', 'sdehoyos47', 'malgaca', 'lsleed', 'khazanv2', 'alexisdixon6', 'gc_1', 'jinsup2', 'rishu', 'amparo.castro.96', 'tbryan', 'martin32', 'michael.mechelay', 'akash140410107098', 'nowapoca', 'onaam8', 'pablosaavedra', 'camilolcastro97', 'khor', 'ankit6257', 'samashraf1', 'benoiturcotte', 'aishu98', 'rileyroca', 'david.peral.moran', 'kiruthikaabalu181996', 'taymacnichols', 'dhodapp', 'nagihankececi', 'carlosvigo1997', 'moh.ashraf105', 'baleko12345', 'ikhbal', 'afeefz', 'kaustubh.shirpurkar', 'kie180031', 'bflores18', 'tdubnansky6', 'jorgecastelo5', 'andreadiazgar', 'david2397', 'bcperki2', 'melaniejkramer', 'rkchapman', 'jn1404', 'mateocampos', 'jzhan142', 'josepazmartin', 'brannon44', 'erincrowe', 'adfoz', 'avw2', 'youxing0309', 'scremin', 'lderemo', 'perezsarmar', 'ashutoshsinghhenry6', 'melroy_caeiro', 'viratbhatt007', 'fkl217', 'coderko3', 'alimatama', 'ammaralaa516', 'nadhnasorudin', 'adarsh123', 'jacquelinethardin', 'mjoza2', 'nihatyavuz', 'estebanrial', 'jinwoo2', 'adnanyuceer', 'danielfernandezcalo', 'berkaydean', 'cloudyoverhead', 'fred_dion', 'syedzakwan', 'e1150590', 'fcfrancapra94', 'amiruldanial99', 'ozbunar01', 'alecorti.pardo', 'electronica18', 'nourananwar123', 'olivier.gilbert.paquet', 'anibarseghyan', 'amlibrahim', 'neuroque', 'kychui2', 'shaf31', 'hong_gao', 'paul.aniruddha', 'carlosbesadaromero', 'mohaballam', 'pip29', 'apb5472', 'tuberkargan', 'hafizmokh99', 'javierisma98', 'fathy1104', 'corredoira', 'helenalecoq97', 'kimzihuang', 'muteki', 'masitadonmez', 'nadja1', 'dancastaneda', 'ahmedsameh1698', 'rocio', 'mallen22', 'ffazul64', 'guoyao', 'ari6nd', 'kerryreto', 'pedrosiaba', 'michaelsaldana1', 'omarmagdy', 'vickytubio', 'ericrobles', 'soccadelic44', 'selena', 'xc882', 'aasifhameed99', 'damlakubattt', 'anxovidal8', 'exjamil', 'jahnavikachhia', 'joker632455', 'vincentpainchaud.vp', 'svo4321', 'zhixin2', 'yansi', 'asyrafaqil', 'xyz11', 'virajput299', 'ryanboucher', 'jpmcgee98', 'mariz', 'bhliu97', 'amrebrahim', 'abdulrahim2905', 'c.a.stupka', 'tonybocadillosgrandes', 'talwren', 'rxtodd', 'farah26', 'tss3', 'abieday1704', 'mavanzato0418', 'mh4208', 'facundovia', 'cristinacigarran', 'nazimmath3', 'baohl2', 'ales.gajdacz', 'elad.d', 'kie180028', 'wahidiah52', 'kyang37', 'arifjalani99', 'cki210', 'lino13', 'jaimefookinlannister', 'physquig', 'ab6858', 'adriancheah', 'jarodm2', 'noureldin1999', 'michael2010814', 'ckim123', 'eddin21', 'jipiccardi', 'prabuddha_888253127', 'david_atef', 'kalebhilde', 'magic_ocean99', 'saipraneett', 'sanchjai', 'omardeyaa', 'pingan99', 'aaq', 'alidsjt', 'mengkem2', 'haclarke', 'oishikfaruque', 'ilou', 'aengm', 'janalorenzolumbreras', 'hilisa', 'carlosvillar54', 'vikazvereva', 'm939454', 'va844', 'pablobou4', 'ludovick.begin', 'maniphysics09', 'eduard25252598', 'apascao', 'xosegq16', 'adam562', 'lauramolinosmayo', 'amni99', 'kie180702', 'saharoaf', 'redzuan11', 'ypp200', 'kph2', 'martinzapata', 'kirolosehab99', 'restep2', 'seifhabib', 'maramtarek53', 'zehuahe2', 'azizijazam11', 'marcosanllo', 'aimansyaz99', 'elizametias12', 'juanmacano97', 'sparshagarwal1009', 'prakharbhargava0', 'njs035', 'alberfn', 'ramy_maged4', 'hmoulvi1', 'vanesagarcia', 'hf4', 'wowmuchchuck', 'mohammedemadeldin2000', 'gabrielyii', 'keerthisv', 'pythagoras2', 'xunyong', 'irenehb92', 'shradhap', 'mohameeddsamy', 'marianne.gratton.1', 'marcmagdy98', 'brknshn', 'gemma', 'lukunze1', 'caglanlee', 'desmondsoon', 'sebasket14', 'masonpb2', 'youssef2042000', 'retty8', 'bharath3', 'syin4', 'ethanmorse', 'ematson5897', 'jacobzeshleman', 'leejq', 'harshini9962', 'reemali99_', 'xxlilmontysignxx', 'ramonruiz.infor', 'atharva98', 'ahern0722', 'hishamzakaria20', 'cheokonn', 'adriangarea', 'jeanmichael.deschenes', 'vmj226', 'samet1231234', 'mr4425', 'bluelobster', 'justin.lariviere.25', 'dcpang2', 'felivitullo87', 'puertarcd', 'farahsamir978', 'akozych2', 'nbs691', 'kie180073', 'anwar909', 'bleuminuit', 'atx203', 'kanet1234', 'sealseal', 'emrebuyukkose2', 'arrow823', 'dhvanil', 'nuanno97', 'dkshelat', 'mohabayman', 'ranasherif65', 'diamond92', 'ugur.cankaya.3718', 'ammareltalli', 'acn562', 'nabilah1403', 'yaseminablacandir', 'tamchouweng', 'ablahsaoud', 'sriharshap', 'mrefaat', 'bassamtarek', 'hamidausat', 'kakmeera1999', 'teoster50', 'nolmos96', 'abdurrahmn13', 'mmartinezsanchez', 'sandrabashara', 'zakhwan7', 'chengweiheng', 'nikalyaamani', 'acregodean', 'happyleexin', 'sarapl', 'williammitchell5818', None, 'rooban11', 'yeejou990318', 'kowjiajin', 'nihaosawaddee', 'maxernest', 'david.garrido', 'guibill10', 'mohamedsameh', 'spazos7', 'tmi211', 'kie180039', 'worldlineusaf', 'mgk816', 'kie180079', 'ledicia97', 'movi205', 'shuming2']"
1,10,391,15,1,['mr4425'],390,"['oliviercharbonneau', 'miri23', 'ozgurkablan26', 'loisonchambers', 'tuberkargan_97', 'pranjal3', 'musabmalek0717', 'nadanasser1199', 'siemprewowthechami', 'staceyn2', 'vblanco.nico', 'abbesalaeddine', 'efrenhub', 'isabelmaria.vazquez', 'ahmedamr', 'shorouk_ossama', 'rikardberger', 'alancantu57', 'luciano.brignone', 'rahimnoorj', 'janeneil88', 'guttsfulltyagi', 'mjgebara14', 'kartal', 'gabrielyii99', 'aboone06', 'saegner2', 'manuelsomoza94', 'amani12345', 'youssefsherif22', 'j.haliburton', 'amr_ua07', 'evrenyigit', 'tingliang', 'kirankumar94', 'ahagras13', 'njgale01', 'al4995', 'smrdafdl', 'travisc2', 'dlee145', 'stambo', 'anthonyroux', 'ryanorem', 'moh.bahaa', 'ahchehyan', 'aimanadnan', 'veronica.mieites', 's_coriolis', 'trkmengkay', 'cbecker413', 'mcruces.fz', 'latecnologiameodia', 'gxiao2', 'emilechouinard', 'je_guilbert', 'yubai', 'sinasigurpinar', 'lauragdevesa', 'muvafikmelikkaya', 'kason.carroll', 'jbaggie2019', 'annahaozheng0606', 'jtorres17', 'ahmedayman2370', 'zikrizaki88995', 'yjenyiee155', '46harunakgul', 'alifzulkifli99', 'kaitlinh', 'tyy233', 'sdehoyos47', 'malgaca', 'lsleed', 'khazanv2', 'alexisdixon6', 'gc_1', 'jinsup2', 'rishu', 'amparo.castro.96', 'tbryan', 'martin32', 'michael.mechelay', 'akash140410107098', 'nowapoca', 'onaam8', 'pablosaavedra', 'camilolcastro97', 'khor', 'ankit6257', 'samashraf1', 'benoiturcotte', 'aishu98', 'rileyroca', 'david.peral.moran', 'kiruthikaabalu181996', 'taymacnichols', 'dhodapp', 'nagihankececi', 'carlosvigo1997', 'moh.ashraf105', 'baleko12345', 'ikhbal', 'afeefz', 'kaustubh.shirpurkar', 'kie180031', 'bflores18', 'tdubnansky6', 'jorgecastelo5', 'andreadiazgar', 'david2397', 'bcperki2', 'melaniejkramer', 'rkchapman', 'jn1404', 'mateocampos', 'jzhan142', 'josepazmartin', 'brannon44', 'adfoz', 'avw2', 'youxing0309', 'scremin', 'lderemo', 'perezsarmar', 'ashutoshsinghhenry6', 'melroy_caeiro', 'viratbhatt007', 'fkl217', 'coderko3', 'alimatama', 'ammaralaa516', 'nadhnasorudin', 'adarsh123', 'jacquelinethardin', 'mjoza2', 'nihatyavuz', 'estebanrial', 'jinwoo2', 'adnanyuceer', 'danielfernandezcalo', 'berkaydean', 'cloudyoverhead', 'fred_dion', 'syedzakwan', 'e1150590', 'fcfrancapra94', 'amiruldanial99', 'ozbunar01', 'alecorti.pardo', 'electronica18', 'nourananwar123', 'olivier.gilbert.paquet', 'anibarseghyan', 'amlibrahim', 'neuroque', 'kychui2', 'shaf31', 'hong_gao', 'paul.aniruddha', 'carlosbesadaromero', 'mohaballam', 'pip29', 'apb5472', 'tuberkargan', 'hafizmokh99', 'javierisma98', 'fathy1104', 'corredoira', 'helenalecoq97', 'kimzihuang', 'muteki', 'masitadonmez', 'nadja1', 'dancastaneda', 'ahmedsameh1698', 'rocio', 'mallen22', 'ffazul64', 'guoyao', 'ari6nd', 'kerryreto', 'pedrosiaba', 'michaelsaldana1', 'omarmagdy', 'vickytubio', 'ericrobles', 'soccadelic44', 'selena', 'aasifhameed99', 'damlakubattt', 'anxovidal8', 'exjamil', 'jahnavikachhia', 'joker632455', 'vincentpainchaud.vp', 'svo4321', 'zhixin2', 'yansi', 'asyrafaqil', 'xyz11', 'virajput299', 'ryanboucher', 'jpmcgee98', 'mariz', 'bhliu97', 'amrebrahim', 'abdulrahim2905', 'c.a.stupka', 'tonybocadillosgrandes', 'talwren', 'rxtodd', 'farah26', 'tss3', 'abieday1704', 'mavanzato0418', 'facundovia', 'cristinacigarran', 'nazimmath3', 'baohl2', 'ales.gajdacz', 'elad.d', 'kie180028', 'wahidiah52', 'kyang37', 'arifjalani99', 'lino13', 'jaimefookinlannister', 'physquig', 'adriancheah', 'jarodm2', 'noureldin1999', 'michael2010814', 'ckim123', 'eddin21', 'jipiccardi', 'prabuddha_888253127', 'david_atef', 'kalebhilde', 'magic_ocean99', 'saipraneett', 'sanchjai', 'omardeyaa', 'pingan99', 'aaq', 'alidsjt', 'mengkem2', 'haclarke', 'oishikfaruque', 'ilou', 'aengm', 'janalorenzolumbreras', 'hilisa', 'carlosvillar54', 'vikazvereva', 'm939454', 'va844', 'pablobou4', 'ludovick.begin', 'maniphysics09', 'eduard25252598', 'apascao', 'xosegq16', 'adam562', 'lauramolinosmayo', 'amni99', 'kie180702', 'saharoaf', 'redzuan11', 'ypp200', 'kph2', 'martinzapata', 'kirolosehab99', 'restep2', 'seifhabib', 'maramtarek53', 'zehuahe2', 'azizijazam11', 'marcosanllo', 'aimansyaz99', 'elizametias12', 'juanmacano97', 'sparshagarwal1009', 'prakharbhargava0', 'njs035', 'alberfn', 'ramy_maged4', 'hmoulvi1', 'vanesagarcia', 'hf4', 'wowmuchchuck', 'mohammedemadeldin2000', 'gabrielyii', 'keerthisv', 'pythagoras2', 'xunyong', 'irenehb92', 'shradhap', 'mohameeddsamy', 'marianne.gratton.1', 'marcmagdy98', 'brknshn', 'gemma', 'lukunze1', 'caglanlee', 'desmondsoon', 'sebasket14', 'masonpb2', 'youssef2042000', 'retty8', 'bharath3', 'syin4', 'ethanmorse', 'ematson5897', 'jacobzeshleman', 'leejq', 'harshini9962', 'reemali99_', 'xxlilmontysignxx', 'ramonruiz.infor', 'atharva98', 'ahern0722', 'hishamzakaria20', 'cheokonn', 'adriangarea', 'jeanmichael.deschenes', 'samet1231234', 'bluelobster', 'justin.lariviere.25', 'dcpang2', 'felivitullo87', 'puertarcd', 'farahsamir978', 'akozych2', 'nbs691', 'kie180073', 'anwar909', 'bleuminuit', 'atx203', 'kanet1234', 'sealseal', 'emrebuyukkose2', 'arrow823', 'dhvanil', 'nuanno97', 'dkshelat', 'mohabayman', 'ranasherif65', 'diamond92', 'ugur.cankaya.3718', 'ammareltalli', 'acn562', 'nabilah1403', 'yaseminablacandir', 'tamchouweng', 'ablahsaoud', 'sriharshap', 'mrefaat', 'bassamtarek', 'hamidausat', 'kakmeera1999', 'teoster50', 'nolmos96', 'abdurrahmn13', 'mmartinezsanchez', 'sandrabashara', 'zakhwan7', 'chengweiheng', 'nikalyaamani', 'acregodean', 'happyleexin', 'sarapl', 'williammitchell5818', 'rooban11', 'yeejou990318', 'kowjiajin', 'nihaosawaddee', 'maxernest', 'david.garrido', 'guibill10', 'mohamedsameh', 'spazos7', 'tmi211', 'kie180039', 'worldlineusaf', 'mgk816', 'kie180079', 'ledicia97', 'movi205', 'shuming2']",14,"['ytsong95', 'weekmooz', 'sdyfbew', 'as12033', 'rc2975nyu', 'siao', 'ac7431', 'zh1246', 'zl2513', 'arunparth', None, 'kmamaniya', 'shubham.mahalank', 'lh2754']",405,"['oliviercharbonneau', 'miri23', 'ozgurkablan26', 'loisonchambers', 'tuberkargan_97', 'pranjal3', 'musabmalek0717', 'nadanasser1199', 'siemprewowthechami', 'staceyn2', 'vblanco.nico', 'abbesalaeddine', 'efrenhub', 'isabelmaria.vazquez', 'ahmedamr', 'shorouk_ossama', 'rikardberger', 'alancantu57', 'luciano.brignone', 'sdyfbew', 'rahimnoorj', 'janeneil88', 'guttsfulltyagi', 'mjgebara14', 'kartal', 'gabrielyii99', 'aboone06', 'saegner2', 'manuelsomoza94', 'amani12345', 'youssefsherif22', 'j.haliburton', 'amr_ua07', 'evrenyigit', 'tingliang', 'kirankumar94', 'ahagras13', 'njgale01', 'zh1246', 'al4995', 'smrdafdl', 'zl2513', 'travisc2', 'dlee145', 'stambo', 'ytsong95', 'anthonyroux', 'ryanorem', 'moh.bahaa', 'ahchehyan', 'aimanadnan', 'veronica.mieites', 's_coriolis', 'trkmengkay', 'cbecker413', 'mcruces.fz', 'latecnologiameodia', 'gxiao2', 'emilechouinard', 'je_guilbert', 'yubai', 'sinasigurpinar', 'lauragdevesa', 'muvafikmelikkaya', 'kason.carroll', 'jbaggie2019', 'annahaozheng0606', 'jtorres17', 'ahmedayman2370', 'zikrizaki88995', 'yjenyiee155', 'ac7431', '46harunakgul', 'alifzulkifli99', 'kaitlinh', 'tyy233', 'sdehoyos47', 'malgaca', 'lsleed', 'khazanv2', 'as12033', 'alexisdixon6', 'gc_1', 'jinsup2', 'rishu', 'amparo.castro.96', 'tbryan', 'martin32', 'michael.mechelay', 'akash140410107098', 'nowapoca', 'onaam8', 'pablosaavedra', 'camilolcastro97', 'khor', 'ankit6257', 'samashraf1', 'benoiturcotte', 'aishu98', 'rileyroca', 'david.peral.moran', 'kiruthikaabalu181996', 'taymacnichols', 'dhodapp', 'nagihankececi', 'carlosvigo1997', 'moh.ashraf105', 'baleko12345', 'ikhbal', 'afeefz', 'kaustubh.shirpurkar', 'kie180031', 'bflores18', 'tdubnansky6', 'jorgecastelo5', 'andreadiazgar', 'david2397', 'bcperki2', 'melaniejkramer', 'rkchapman', 'jn1404', 'mateocampos', 'jzhan142', 'josepazmartin', 'brannon44', 'adfoz', 'avw2', 'youxing0309', 'scremin', 'lderemo', 'perezsarmar', 'ashutoshsinghhenry6', 'melroy_caeiro', 'viratbhatt007', 'fkl217', 'coderko3', 'alimatama', 'ammaralaa516', 'nadhnasorudin', 'adarsh123', 'jacquelinethardin', 'mjoza2', 'nihatyavuz', 'lh2754', 'estebanrial', 'jinwoo2', 'adnanyuceer', 'danielfernandezcalo', 'berkaydean', 'cloudyoverhead', 'fred_dion', 'syedzakwan', 'e1150590', 'fcfrancapra94', 'amiruldanial99', 'ozbunar01', 'alecorti.pardo', 'electronica18', 'nourananwar123', 'olivier.gilbert.paquet', 'rc2975nyu', 'anibarseghyan', 'amlibrahim', 'neuroque', 'kychui2', 'shaf31', 'hong_gao', 'paul.aniruddha', 'carlosbesadaromero', 'mohaballam', 'pip29', 'apb5472', 'tuberkargan', 'hafizmokh99', 'javierisma98', 'fathy1104', 'corredoira', 'helenalecoq97', 'kimzihuang', 'muteki', 'masitadonmez', 'nadja1', 'dancastaneda', 'ahmedsameh1698', 'rocio', 'mallen22', 'ffazul64', 'guoyao', 'ari6nd', 'kerryreto', 'pedrosiaba', 'michaelsaldana1', 'omarmagdy', 'vickytubio', 'ericrobles', 'soccadelic44', 'selena', 'aasifhameed99', 'damlakubattt', 'anxovidal8', 'exjamil', 'jahnavikachhia', 'joker632455', 'vincentpainchaud.vp', 'svo4321', 'zhixin2', 'yansi', 'asyrafaqil', 'shubham.mahalank', 'xyz11', 'virajput299', 'ryanboucher', 'jpmcgee98', 'mariz', 'bhliu97', 'amrebrahim', 'abdulrahim2905', 'c.a.stupka', 'tonybocadillosgrandes', 'kmamaniya', 'talwren', 'rxtodd', 'farah26', 'tss3', 'abieday1704', 'mavanzato0418', 'facundovia', 'cristinacigarran', 'nazimmath3', 'baohl2', 'ales.gajdacz', 'elad.d', 'kie180028', 'wahidiah52', 'kyang37', 'arifjalani99', 'lino13', 'jaimefookinlannister', 'physquig', 'adriancheah', 'weekmooz', 'jarodm2', 'noureldin1999', 'michael2010814', 'ckim123', 'eddin21', 'jipiccardi', 'prabuddha_888253127', 'david_atef', 'kalebhilde', 'magic_ocean99', 'saipraneett', 'sanchjai', 'omardeyaa', 'pingan99', 'aaq', 'alidsjt', 'mengkem2', 'haclarke', 'oishikfaruque', 'ilou', 'aengm', 'janalorenzolumbreras', 'hilisa', 'carlosvillar54', 'vikazvereva', 'm939454', 'va844', 'pablobou4', 'ludovick.begin', 'maniphysics09', 'eduard25252598', 'apascao', 'xosegq16', 'adam562', 'lauramolinosmayo', 'amni99', 'kie180702', 'saharoaf', 'redzuan11', 'ypp200', 'kph2', 'martinzapata', 'kirolosehab99', 'restep2', 'seifhabib', 'maramtarek53', 'zehuahe2', 'azizijazam11', 'marcosanllo', 'aimansyaz99', 'elizametias12', 'juanmacano97', 'sparshagarwal1009', 'prakharbhargava0', 'njs035', 'alberfn', 'ramy_maged4', 'hmoulvi1', 'vanesagarcia', 'hf4', 'wowmuchchuck', 'mohammedemadeldin2000', 'gabrielyii', 'keerthisv', 'pythagoras2', 'xunyong', 'irenehb92', 'shradhap', 'arunparth', 'mohameeddsamy', 'marianne.gratton.1', 'marcmagdy98', 'brknshn', 'gemma', 'lukunze1', 'caglanlee', 'desmondsoon', 'sebasket14', 'masonpb2', 'youssef2042000', 'retty8', 'bharath3', 'syin4', 'ethanmorse', 'ematson5897', 'jacobzeshleman', 'leejq', 'harshini9962', 'reemali99_', 'xxlilmontysignxx', 'ramonruiz.infor', 'atharva98', 'ahern0722', 'hishamzakaria20', 'cheokonn', 'adriangarea', 'jeanmichael.deschenes', 'samet1231234', 'mr4425', 'bluelobster', 'justin.lariviere.25', 'dcpang2', 'felivitullo87', 'puertarcd', 'farahsamir978', 'akozych2', 'nbs691', 'kie180073', 'anwar909', 'bleuminuit', 'atx203', 'kanet1234', 'sealseal', 'emrebuyukkose2', 'arrow823', 'dhvanil', 'nuanno97', 'dkshelat', 'mohabayman', 'ranasherif65', 'diamond92', 'ugur.cankaya.3718', 'ammareltalli', 'acn562', 'nabilah1403', 'yaseminablacandir', 'siao', 'tamchouweng', 'ablahsaoud', 'sriharshap', 'mrefaat', 'bassamtarek', 'hamidausat', 'kakmeera1999', 'teoster50', 'nolmos96', 'abdurrahmn13', 'mmartinezsanchez', 'sandrabashara', 'zakhwan7', 'chengweiheng', 'nikalyaamani', 'acregodean', 'happyleexin', 'sarapl', 'williammitchell5818', None, 'rooban11', 'yeejou990318', 'kowjiajin', 'nihaosawaddee', 'maxernest', 'david.garrido', 'guibill10', 'mohamedsameh', 'spazos7', 'tmi211', 'kie180039', 'worldlineusaf', 'mgk816', 'kie180079', 'ledicia97', 'movi205', 'shuming2']"
1,23,391,15,13,"['annahaozheng0606', 'rikardberger', 'kartal', 'prakharbhargava0', 'paul.aniruddha', 'ilou', 'aengm', 'lukunze1', 'adarsh123', 'nazimmath3', 'hilisa', 'nadja1', 'scremin']",378,"['oliviercharbonneau', 'miri23', 'ozgurkablan26', 'loisonchambers', 'tuberkargan_97', 'pranjal3', 'musabmalek0717', 'nadanasser1199', 'siemprewowthechami', 'staceyn2', 'vblanco.nico', 'abbesalaeddine', 'efrenhub', 'isabelmaria.vazquez', 'ahmedamr', 'shorouk_ossama', 'alancantu57', 'luciano.brignone', 'rahimnoorj', 'janeneil88', 'guttsfulltyagi', 'mjgebara14', 'gabrielyii99', 'aboone06', 'saegner2', 'manuelsomoza94', 'amani12345', 'youssefsherif22', 'j.haliburton', 'amr_ua07', 'evrenyigit', 'tingliang', 'kirankumar94', 'ahagras13', 'njgale01', 'al4995', 'smrdafdl', 'travisc2', 'dlee145', 'stambo', 'anthonyroux', 'ryanorem', 'moh.bahaa', 'ahchehyan', 'aimanadnan', 'veronica.mieites', 's_coriolis', 'trkmengkay', 'cbecker413', 'mcruces.fz', 'latecnologiameodia', 'gxiao2', 'emilechouinard', 'je_guilbert', 'yubai', 'sinasigurpinar', 'lauragdevesa', 'muvafikmelikkaya', 'kason.carroll', 'jbaggie2019', 'jtorres17', 'ahmedayman2370', 'zikrizaki88995', 'yjenyiee155', '46harunakgul', 'alifzulkifli99', 'kaitlinh', 'tyy233', 'sdehoyos47', 'malgaca', 'lsleed', 'khazanv2', 'alexisdixon6', 'gc_1', 'jinsup2', 'rishu', 'amparo.castro.96', 'tbryan', 'martin32', 'michael.mechelay', 'akash140410107098', 'nowapoca', 'onaam8', 'pablosaavedra', 'camilolcastro97', 'khor', 'ankit6257', 'samashraf1', 'benoiturcotte', 'aishu98', 'rileyroca', 'david.peral.moran', 'kiruthikaabalu181996', 'taymacnichols', 'dhodapp', 'nagihankececi', 'carlosvigo1997', 'moh.ashraf105', 'baleko12345', 'ikhbal', 'afeefz', 'kaustubh.shirpurkar', 'kie180031', 'bflores18', 'tdubnansky6', 'jorgecastelo5', 'andreadiazgar', 'david2397', 'bcperki2', 'melaniejkramer', 'rkchapman', 'jn1404', 'mateocampos', 'jzhan142', 'josepazmartin', 'brannon44', 'adfoz', 'avw2', 'youxing0309', 'lderemo', 'perezsarmar', 'ashutoshsinghhenry6', 'melroy_caeiro', 'viratbhatt007', 'fkl217', 'coderko3', 'alimatama', 'ammaralaa516', 'nadhnasorudin', 'jacquelinethardin', 'mjoza2', 'nihatyavuz', 'estebanrial', 'jinwoo2', 'adnanyuceer', 'danielfernandezcalo', 'berkaydean', 'cloudyoverhead', 'fred_dion', 'syedzakwan', 'e1150590', 'fcfrancapra94', 'amiruldanial99', 'ozbunar01', 'alecorti.pardo', 'electronica18', 'nourananwar123', 'olivier.gilbert.paquet', 'anibarseghyan', 'amlibrahim', 'neuroque', 'kychui2', 'shaf31', 'hong_gao', 'carlosbesadaromero', 'mohaballam', 'pip29', 'apb5472', 'tuberkargan', 'hafizmokh99', 'javierisma98', 'fathy1104', 'corredoira', 'helenalecoq97', 'kimzihuang', 'muteki', 'masitadonmez', 'dancastaneda', 'ahmedsameh1698', 'rocio', 'mallen22', 'ffazul64', 'guoyao', 'ari6nd', 'kerryreto', 'pedrosiaba', 'michaelsaldana1', 'omarmagdy', 'vickytubio', 'ericrobles', 'soccadelic44', 'selena', 'aasifhameed99', 'damlakubattt', 'anxovidal8', 'exjamil', 'jahnavikachhia', 'joker632455', 'vincentpainchaud.vp', 'svo4321', 'zhixin2', 'yansi', 'asyrafaqil', 'xyz11', 'virajput299', 'ryanboucher', 'jpmcgee98', 'mariz', 'bhliu97', 'amrebrahim', 'abdulrahim2905', 'c.a.stupka', 'tonybocadillosgrandes', 'talwren', 'rxtodd', 'farah26', 'tss3', 'abieday1704', 'mavanzato0418', 'facundovia', 'cristinacigarran', 'baohl2', 'ales.gajdacz', 'elad.d', 'kie180028', 'wahidiah52', 'kyang37', 'arifjalani99', 'lino13', 'jaimefookinlannister', 'physquig', 'adriancheah', 'jarodm2', 'noureldin1999', 'michael2010814', 'ckim123', 'eddin21', 'jipiccardi', 'prabuddha_888253127', 'david_atef', 'kalebhilde', 'magic_ocean99', 'saipraneett', 'sanchjai', 'omardeyaa', 'pingan99', 'aaq', 'alidsjt', 'mengkem2', 'haclarke', 'oishikfaruque', 'janalorenzolumbreras', 'carlosvillar54', 'vikazvereva', 'm939454', 'va844', 'pablobou4', 'ludovick.begin', 'maniphysics09', 'eduard25252598', 'apascao', 'xosegq16', 'adam562', 'lauramolinosmayo', 'amni99', 'kie180702', 'saharoaf', 'redzuan11', 'ypp200', 'kph2', 'martinzapata', 'kirolosehab99', 'restep2', 'seifhabib', 'maramtarek53', 'zehuahe2', 'azizijazam11', 'marcosanllo', 'aimansyaz99', 'elizametias12', 'juanmacano97', 'sparshagarwal1009', 'njs035', 'alberfn', 'ramy_maged4', 'hmoulvi1', 'vanesagarcia', 'hf4', 'wowmuchchuck', 'mohammedemadeldin2000', 'gabrielyii', 'keerthisv', 'pythagoras2', 'xunyong', 'irenehb92', 'shradhap', 'mohameeddsamy', 'marianne.gratton.1', 'marcmagdy98', 'brknshn', 'gemma', 'caglanlee', 'desmondsoon', 'sebasket14', 'masonpb2', 'youssef2042000', 'retty8', 'bharath3', 'syin4', 'ethanmorse', 'ematson5897', 'jacobzeshleman', 'leejq', 'harshini9962', 'reemali99_', 'xxlilmontysignxx', 'ramonruiz.infor', 'atharva98', 'ahern0722', 'hishamzakaria20', 'cheokonn', 'adriangarea', 'jeanmichael.deschenes', 'samet1231234', 'mr4425', 'bluelobster', 'justin.lariviere.25', 'dcpang2', 'felivitullo87', 'puertarcd', 'farahsamir978', 'akozych2', 'nbs691', 'kie180073', 'anwar909', 'bleuminuit', 'atx203', 'kanet1234', 'sealseal', 'emrebuyukkose2', 'arrow823', 'dhvanil', 'nuanno97', 'dkshelat', 'mohabayman', 'ranasherif65', 'diamond92', 'ugur.cankaya.3718', 'ammareltalli', 'acn562', 'nabilah1403', 'yaseminablacandir', 'tamchouweng', 'ablahsaoud', 'sriharshap', 'mrefaat', 'bassamtarek', 'hamidausat', 'kakmeera1999', 'teoster50', 'nolmos96', 'abdurrahmn13', 'mmartinezsanchez', 'sandrabashara', 'zakhwan7', 'chengweiheng', 'nikalyaamani', 'acregodean', 'happyleexin', 'sarapl', 'williammitchell5818', 'rooban11', 'yeejou990318', 'kowjiajin', 'nihaosawaddee', 'maxernest', 'david.garrido', 'guibill10', 'mohamedsameh', 'spazos7', 'tmi211', 'kie180039', 'worldlineusaf', 'mgk816', 'kie180079', 'ledicia97', 'movi205', 'shuming2']",2,"['davyn', None]",393,"['oliviercharbonneau', 'miri23', 'ozgurkablan26', 'loisonchambers', 'tuberkargan_97', 'pranjal3', 'musabmalek0717', 'nadanasser1199', 'siemprewowthechami', 'staceyn2', 'vblanco.nico', 'abbesalaeddine', 'efrenhub', 'isabelmaria.vazquez', 'ahmedamr', 'shorouk_ossama', 'rikardberger', 'alancantu57', 'luciano.brignone', 'rahimnoorj', 'janeneil88', 'guttsfulltyagi', 'mjgebara14', 'kartal', 'gabrielyii99', 'aboone06', 'saegner2', 'manuelsomoza94', 'amani12345', 'youssefsherif22', 'j.haliburton', 'amr_ua07', 'evrenyigit', 'tingliang', 'kirankumar94', 'ahagras13', 'njgale01', 'al4995', 'smrdafdl', 'travisc2', 'dlee145', 'stambo', 'anthonyroux', 'ryanorem', 'moh.bahaa', 'ahchehyan', 'aimanadnan', 'veronica.mieites', 's_coriolis', 'trkmengkay', 'cbecker413', 'mcruces.fz', 'latecnologiameodia', 'gxiao2', 'emilechouinard', 'je_guilbert', 'yubai', 'sinasigurpinar', 'lauragdevesa', 'muvafikmelikkaya', 'kason.carroll', 'jbaggie2019', 'annahaozheng0606', 'jtorres17', 'ahmedayman2370', 'zikrizaki88995', 'yjenyiee155', '46harunakgul', 'alifzulkifli99', 'davyn', 'kaitlinh', 'tyy233', 'sdehoyos47', 'malgaca', 'lsleed', 'khazanv2', 'alexisdixon6', 'gc_1', 'jinsup2', 'rishu', 'amparo.castro.96', 'tbryan', 'martin32', 'michael.mechelay', 'akash140410107098', 'nowapoca', 'onaam8', 'pablosaavedra', 'camilolcastro97', 'khor', 'ankit6257', 'samashraf1', 'benoiturcotte', 'aishu98', 'rileyroca', 'david.peral.moran', 'kiruthikaabalu181996', 'taymacnichols', 'dhodapp', 'nagihankececi', 'carlosvigo1997', 'moh.ashraf105', 'baleko12345', 'ikhbal', 'afeefz', 'kaustubh.shirpurkar', 'kie180031', 'bflores18', 'tdubnansky6', 'jorgecastelo5', 'andreadiazgar', 'david2397', 'bcperki2', 'melaniejkramer', 'rkchapman', 'jn1404', 'mateocampos', 'jzhan142', 'josepazmartin', 'brannon44', 'adfoz', 'avw2', 'youxing0309', 'scremin', 'lderemo', 'perezsarmar', 'ashutoshsinghhenry6', 'melroy_caeiro', 'viratbhatt007', 'fkl217', 'coderko3', 'alimatama', 'ammaralaa516', 'nadhnasorudin', 'adarsh123', 'jacquelinethardin', 'mjoza2', 'nihatyavuz', 'estebanrial', 'jinwoo2', 'adnanyuceer', 'danielfernandezcalo', 'berkaydean', 'cloudyoverhead', 'fred_dion', 'syedzakwan', 'e1150590', 'fcfrancapra94', 'amiruldanial99', 'ozbunar01', 'alecorti.pardo', 'electronica18', 'nourananwar123', 'olivier.gilbert.paquet', 'anibarseghyan', 'amlibrahim', 'neuroque', 'kychui2', 'shaf31', 'hong_gao', 'paul.aniruddha', 'carlosbesadaromero', 'mohaballam', 'pip29', 'apb5472', 'tuberkargan', 'hafizmokh99', 'javierisma98', 'fathy1104', 'corredoira', 'helenalecoq97', 'kimzihuang', 'muteki', 'masitadonmez', 'nadja1', 'dancastaneda', 'ahmedsameh1698', 'rocio', 'mallen22', 'ffazul64', 'guoyao', 'ari6nd', 'kerryreto', 'pedrosiaba', 'michaelsaldana1', 'omarmagdy', 'vickytubio', 'ericrobles', 'soccadelic44', 'selena', 'aasifhameed99', 'damlakubattt', 'anxovidal8', 'exjamil', 'jahnavikachhia', 'joker632455', 'vincentpainchaud.vp', 'svo4321', 'zhixin2', 'yansi', 'asyrafaqil', 'xyz11', 'virajput299', 'ryanboucher', 'jpmcgee98', 'mariz', 'bhliu97', 'amrebrahim', 'abdulrahim2905', 'c.a.stupka', 'tonybocadillosgrandes', 'talwren', 'rxtodd', 'farah26', 'tss3', 'abieday1704', 'mavanzato0418', 'facundovia', 'cristinacigarran', 'nazimmath3', 'baohl2', 'ales.gajdacz', 'elad.d', 'kie180028', 'wahidiah52', 'kyang37', 'arifjalani99', 'lino13', 'jaimefookinlannister', 'physquig', 'adriancheah', 'jarodm2', 'noureldin1999', 'michael2010814', 'ckim123', 'eddin21', 'jipiccardi', 'prabuddha_888253127', 'david_atef', 'kalebhilde', 'magic_ocean99', 'saipraneett', 'sanchjai', 'omardeyaa', 'pingan99', 'aaq', 'alidsjt', 'mengkem2', 'haclarke', 'oishikfaruque', 'ilou', 'aengm', 'janalorenzolumbreras', 'hilisa', 'carlosvillar54', 'vikazvereva', 'm939454', 'va844', 'pablobou4', 'ludovick.begin', 'maniphysics09', 'eduard25252598', 'apascao', 'xosegq16', 'adam562', 'lauramolinosmayo', 'amni99', 'kie180702', 'saharoaf', 'redzuan11', 'ypp200', 'kph2', 'martinzapata', 'kirolosehab99', 'restep2', 'seifhabib', 'maramtarek53', 'zehuahe2', 'azizijazam11', 'marcosanllo', 'aimansyaz99', 'elizametias12', 'juanmacano97', 'sparshagarwal1009', 'prakharbhargava0', 'njs035', 'alberfn', 'ramy_maged4', 'hmoulvi1', 'vanesagarcia', 'hf4', 'wowmuchchuck', 'mohammedemadeldin2000', 'gabrielyii', 'keerthisv', 'pythagoras2', 'xunyong', 'irenehb92', 'shradhap', 'mohameeddsamy', 'marianne.gratton.1', 'marcmagdy98', 'brknshn', 'gemma', 'lukunze1', 'caglanlee', 'desmondsoon', 'sebasket14', 'masonpb2', 'youssef2042000', 'retty8', 'bharath3', 'syin4', 'ethanmorse', 'ematson5897', 'jacobzeshleman', 'leejq', 'harshini9962', 'reemali99_', 'xxlilmontysignxx', 'ramonruiz.infor', 'atharva98', 'ahern0722', 'hishamzakaria20', 'cheokonn', 'adriangarea', 'jeanmichael.deschenes', 'samet1231234', 'mr4425', 'bluelobster', 'justin.lariviere.25', 'dcpang2', 'felivitullo87', 'puertarcd', 'farahsamir978', 'akozych2', 'nbs691', 'kie180073', 'anwar909', 'bleuminuit', 'atx203', 'kanet1234', 'sealseal', 'emrebuyukkose2', 'arrow823', 'dhvanil', 'nuanno97', 'dkshelat', 'mohabayman', 'ranasherif65', 'diamond92', 'ugur.cankaya.3718', 'ammareltalli', 'acn562', 'nabilah1403', 'yaseminablacandir', 'tamchouweng', 'ablahsaoud', 'sriharshap', 'mrefaat', 'bassamtarek', 'hamidausat', 'kakmeera1999', 'teoster50', 'nolmos96', 'abdurrahmn13', 'mmartinezsanchez', 'sandrabashara', 'zakhwan7', 'chengweiheng', 'nikalyaamani', 'acregodean', 'happyleexin', 'sarapl', 'williammitchell5818', None, 'rooban11', 'yeejou990318', 'kowjiajin', 'nihaosawaddee', 'maxernest', 'david.garrido', 'guibill10', 'mohamedsameh', 'spazos7', 'tmi211', 'kie180039', 'worldlineusaf', 'mgk816', 'kie180079', 'ledicia97', 'movi205', 'shuming2']"
1,31,391,15,13,"['annahaozheng0606', 'rikardberger', 'kartal', 'prakharbhargava0', 'paul.aniruddha', 'ilou', 'aengm', 'lukunze1', 'adarsh123', 'nazimmath3', 'hilisa', 'nadja1', 'scremin']",378,"['oliviercharbonneau', 'miri23', 'ozgurkablan26', 'loisonchambers', 'tuberkargan_97', 'pranjal3', 'musabmalek0717', 'nadanasser1199', 'siemprewowthechami', 'staceyn2', 'vblanco.nico', 'abbesalaeddine', 'efrenhub', 'isabelmaria.vazquez', 'ahmedamr', 'shorouk_ossama', 'alancantu57', 'luciano.brignone', 'rahimnoorj', 'janeneil88', 'guttsfulltyagi', 'mjgebara14', 'gabrielyii99', 'aboone06', 'saegner2', 'manuelsomoza94', 'amani12345', 'youssefsherif22', 'j.haliburton', 'amr_ua07', 'evrenyigit', 'tingliang', 'kirankumar94', 'ahagras13', 'njgale01', 'al4995', 'smrdafdl', 'travisc2', 'dlee145', 'stambo', 'anthonyroux', 'ryanorem', 'moh.bahaa', 'ahchehyan', 'aimanadnan', 'veronica.mieites', 's_coriolis', 'trkmengkay', 'cbecker413', 'mcruces.fz', 'latecnologiameodia', 'gxiao2', 'emilechouinard', 'je_guilbert', 'yubai', 'sinasigurpinar', 'lauragdevesa', 'muvafikmelikkaya', 'kason.carroll', 'jbaggie2019', 'jtorres17', 'ahmedayman2370', 'zikrizaki88995', 'yjenyiee155', '46harunakgul', 'alifzulkifli99', 'kaitlinh', 'tyy233', 'sdehoyos47', 'malgaca', 'lsleed', 'khazanv2', 'alexisdixon6', 'gc_1', 'jinsup2', 'rishu', 'amparo.castro.96', 'tbryan', 'martin32', 'michael.mechelay', 'akash140410107098', 'nowapoca', 'onaam8', 'pablosaavedra', 'camilolcastro97', 'khor', 'ankit6257', 'samashraf1', 'benoiturcotte', 'aishu98', 'rileyroca', 'david.peral.moran', 'kiruthikaabalu181996', 'taymacnichols', 'dhodapp', 'nagihankececi', 'carlosvigo1997', 'moh.ashraf105', 'baleko12345', 'ikhbal', 'afeefz', 'kaustubh.shirpurkar', 'kie180031', 'bflores18', 'tdubnansky6', 'jorgecastelo5', 'andreadiazgar', 'david2397', 'bcperki2', 'melaniejkramer', 'rkchapman', 'jn1404', 'mateocampos', 'jzhan142', 'josepazmartin', 'brannon44', 'adfoz', 'avw2', 'youxing0309', 'lderemo', 'perezsarmar', 'ashutoshsinghhenry6', 'melroy_caeiro', 'viratbhatt007', 'fkl217', 'coderko3', 'alimatama', 'ammaralaa516', 'nadhnasorudin', 'jacquelinethardin', 'mjoza2', 'nihatyavuz', 'estebanrial', 'jinwoo2', 'adnanyuceer', 'danielfernandezcalo', 'berkaydean', 'cloudyoverhead', 'fred_dion', 'syedzakwan', 'e1150590', 'fcfrancapra94', 'amiruldanial99', 'ozbunar01', 'alecorti.pardo', 'electronica18', 'nourananwar123', 'olivier.gilbert.paquet', 'anibarseghyan', 'amlibrahim', 'neuroque', 'kychui2', 'shaf31', 'hong_gao', 'carlosbesadaromero', 'mohaballam', 'pip29', 'apb5472', 'tuberkargan', 'hafizmokh99', 'javierisma98', 'fathy1104', 'corredoira', 'helenalecoq97', 'kimzihuang', 'muteki', 'masitadonmez', 'dancastaneda', 'ahmedsameh1698', 'rocio', 'mallen22', 'ffazul64', 'guoyao', 'ari6nd', 'kerryreto', 'pedrosiaba', 'michaelsaldana1', 'omarmagdy', 'vickytubio', 'ericrobles', 'soccadelic44', 'selena', 'aasifhameed99', 'damlakubattt', 'anxovidal8', 'exjamil', 'jahnavikachhia', 'joker632455', 'vincentpainchaud.vp', 'svo4321', 'zhixin2', 'yansi', 'asyrafaqil', 'xyz11', 'virajput299', 'ryanboucher', 'jpmcgee98', 'mariz', 'bhliu97', 'amrebrahim', 'abdulrahim2905', 'c.a.stupka', 'tonybocadillosgrandes', 'talwren', 'rxtodd', 'farah26', 'tss3', 'abieday1704', 'mavanzato0418', 'facundovia', 'cristinacigarran', 'baohl2', 'ales.gajdacz', 'elad.d', 'kie180028', 'wahidiah52', 'kyang37', 'arifjalani99', 'lino13', 'jaimefookinlannister', 'physquig', 'adriancheah', 'jarodm2', 'noureldin1999', 'michael2010814', 'ckim123', 'eddin21', 'jipiccardi', 'prabuddha_888253127', 'david_atef', 'kalebhilde', 'magic_ocean99', 'saipraneett', 'sanchjai', 'omardeyaa', 'pingan99', 'aaq', 'alidsjt', 'mengkem2', 'haclarke', 'oishikfaruque', 'janalorenzolumbreras', 'carlosvillar54', 'vikazvereva', 'm939454', 'va844', 'pablobou4', 'ludovick.begin', 'maniphysics09', 'eduard25252598', 'apascao', 'xosegq16', 'adam562', 'lauramolinosmayo', 'amni99', 'kie180702', 'saharoaf', 'redzuan11', 'ypp200', 'kph2', 'martinzapata', 'kirolosehab99', 'restep2', 'seifhabib', 'maramtarek53', 'zehuahe2', 'azizijazam11', 'marcosanllo', 'aimansyaz99', 'elizametias12', 'juanmacano97', 'sparshagarwal1009', 'njs035', 'alberfn', 'ramy_maged4', 'hmoulvi1', 'vanesagarcia', 'hf4', 'wowmuchchuck', 'mohammedemadeldin2000', 'gabrielyii', 'keerthisv', 'pythagoras2', 'xunyong', 'irenehb92', 'shradhap', 'mohameeddsamy', 'marianne.gratton.1', 'marcmagdy98', 'brknshn', 'gemma', 'caglanlee', 'desmondsoon', 'sebasket14', 'masonpb2', 'youssef2042000', 'retty8', 'bharath3', 'syin4', 'ethanmorse', 'ematson5897', 'jacobzeshleman', 'leejq', 'harshini9962', 'reemali99_', 'xxlilmontysignxx', 'ramonruiz.infor', 'atharva98', 'ahern0722', 'hishamzakaria20', 'cheokonn', 'adriangarea', 'jeanmichael.deschenes', 'samet1231234', 'mr4425', 'bluelobster', 'justin.lariviere.25', 'dcpang2', 'felivitullo87', 'puertarcd', 'farahsamir978', 'akozych2', 'nbs691', 'kie180073', 'anwar909', 'bleuminuit', 'atx203', 'kanet1234', 'sealseal', 'emrebuyukkose2', 'arrow823', 'dhvanil', 'nuanno97', 'dkshelat', 'mohabayman', 'ranasherif65', 'diamond92', 'ugur.cankaya.3718', 'ammareltalli', 'acn562', 'nabilah1403', 'yaseminablacandir', 'tamchouweng', 'ablahsaoud', 'sriharshap', 'mrefaat', 'bassamtarek', 'hamidausat', 'kakmeera1999', 'teoster50', 'nolmos96', 'abdurrahmn13', 'mmartinezsanchez', 'sandrabashara', 'zakhwan7', 'chengweiheng', 'nikalyaamani', 'acregodean', 'happyleexin', 'sarapl', 'williammitchell5818', 'rooban11', 'yeejou990318', 'kowjiajin', 'nihaosawaddee', 'maxernest', 'david.garrido', 'guibill10', 'mohamedsameh', 'spazos7', 'tmi211', 'kie180039', 'worldlineusaf', 'mgk816', 'kie180079', 'ledicia97', 'movi205', 'shuming2']",2,"['davyn', None]",393,"['oliviercharbonneau', 'miri23', 'ozgurkablan26', 'loisonchambers', 'tuberkargan_97', 'pranjal3', 'musabmalek0717', 'nadanasser1199', 'siemprewowthechami', 'staceyn2', 'vblanco.nico', 'abbesalaeddine', 'efrenhub', 'isabelmaria.vazquez', 'ahmedamr', 'shorouk_ossama', 'rikardberger', 'alancantu57', 'luciano.brignone', 'rahimnoorj', 'janeneil88', 'guttsfulltyagi', 'mjgebara14', 'kartal', 'gabrielyii99', 'aboone06', 'saegner2', 'manuelsomoza94', 'amani12345', 'youssefsherif22', 'j.haliburton', 'amr_ua07', 'evrenyigit', 'tingliang', 'kirankumar94', 'ahagras13', 'njgale01', 'al4995', 'smrdafdl', 'travisc2', 'dlee145', 'stambo', 'anthonyroux', 'ryanorem', 'moh.bahaa', 'ahchehyan', 'aimanadnan', 'veronica.mieites', 's_coriolis', 'trkmengkay', 'cbecker413', 'mcruces.fz', 'latecnologiameodia', 'gxiao2', 'emilechouinard', 'je_guilbert', 'yubai', 'sinasigurpinar', 'lauragdevesa', 'muvafikmelikkaya', 'kason.carroll', 'jbaggie2019', 'annahaozheng0606', 'jtorres17', 'ahmedayman2370', 'zikrizaki88995', 'yjenyiee155', '46harunakgul', 'alifzulkifli99', 'davyn', 'kaitlinh', 'tyy233', 'sdehoyos47', 'malgaca', 'lsleed', 'khazanv2', 'alexisdixon6', 'gc_1', 'jinsup2', 'rishu', 'amparo.castro.96', 'tbryan', 'martin32', 'michael.mechelay', 'akash140410107098', 'nowapoca', 'onaam8', 'pablosaavedra', 'camilolcastro97', 'khor', 'ankit6257', 'samashraf1', 'benoiturcotte', 'aishu98', 'rileyroca', 'david.peral.moran', 'kiruthikaabalu181996', 'taymacnichols', 'dhodapp', 'nagihankececi', 'carlosvigo1997', 'moh.ashraf105', 'baleko12345', 'ikhbal', 'afeefz', 'kaustubh.shirpurkar', 'kie180031', 'bflores18', 'tdubnansky6', 'jorgecastelo5', 'andreadiazgar', 'david2397', 'bcperki2', 'melaniejkramer', 'rkchapman', 'jn1404', 'mateocampos', 'jzhan142', 'josepazmartin', 'brannon44', 'adfoz', 'avw2', 'youxing0309', 'scremin', 'lderemo', 'perezsarmar', 'ashutoshsinghhenry6', 'melroy_caeiro', 'viratbhatt007', 'fkl217', 'coderko3', 'alimatama', 'ammaralaa516', 'nadhnasorudin', 'adarsh123', 'jacquelinethardin', 'mjoza2', 'nihatyavuz', 'estebanrial', 'jinwoo2', 'adnanyuceer', 'danielfernandezcalo', 'berkaydean', 'cloudyoverhead', 'fred_dion', 'syedzakwan', 'e1150590', 'fcfrancapra94', 'amiruldanial99', 'ozbunar01', 'alecorti.pardo', 'electronica18', 'nourananwar123', 'olivier.gilbert.paquet', 'anibarseghyan', 'amlibrahim', 'neuroque', 'kychui2', 'shaf31', 'hong_gao', 'paul.aniruddha', 'carlosbesadaromero', 'mohaballam', 'pip29', 'apb5472', 'tuberkargan', 'hafizmokh99', 'javierisma98', 'fathy1104', 'corredoira', 'helenalecoq97', 'kimzihuang', 'muteki', 'masitadonmez', 'nadja1', 'dancastaneda', 'ahmedsameh1698', 'rocio', 'mallen22', 'ffazul64', 'guoyao', 'ari6nd', 'kerryreto', 'pedrosiaba', 'michaelsaldana1', 'omarmagdy', 'vickytubio', 'ericrobles', 'soccadelic44', 'selena', 'aasifhameed99', 'damlakubattt', 'anxovidal8', 'exjamil', 'jahnavikachhia', 'joker632455', 'vincentpainchaud.vp', 'svo4321', 'zhixin2', 'yansi', 'asyrafaqil', 'xyz11', 'virajput299', 'ryanboucher', 'jpmcgee98', 'mariz', 'bhliu97', 'amrebrahim', 'abdulrahim2905', 'c.a.stupka', 'tonybocadillosgrandes', 'talwren', 'rxtodd', 'farah26', 'tss3', 'abieday1704', 'mavanzato0418', 'facundovia', 'cristinacigarran', 'nazimmath3', 'baohl2', 'ales.gajdacz', 'elad.d', 'kie180028', 'wahidiah52', 'kyang37', 'arifjalani99', 'lino13', 'jaimefookinlannister', 'physquig', 'adriancheah', 'jarodm2', 'noureldin1999', 'michael2010814', 'ckim123', 'eddin21', 'jipiccardi', 'prabuddha_888253127', 'david_atef', 'kalebhilde', 'magic_ocean99', 'saipraneett', 'sanchjai', 'omardeyaa', 'pingan99', 'aaq', 'alidsjt', 'mengkem2', 'haclarke', 'oishikfaruque', 'ilou', 'aengm', 'janalorenzolumbreras', 'hilisa', 'carlosvillar54', 'vikazvereva', 'm939454', 'va844', 'pablobou4', 'ludovick.begin', 'maniphysics09', 'eduard25252598', 'apascao', 'xosegq16', 'adam562', 'lauramolinosmayo', 'amni99', 'kie180702', 'saharoaf', 'redzuan11', 'ypp200', 'kph2', 'martinzapata', 'kirolosehab99', 'restep2', 'seifhabib', 'maramtarek53', 'zehuahe2', 'azizijazam11', 'marcosanllo', 'aimansyaz99', 'elizametias12', 'juanmacano97', 'sparshagarwal1009', 'prakharbhargava0', 'njs035', 'alberfn', 'ramy_maged4', 'hmoulvi1', 'vanesagarcia', 'hf4', 'wowmuchchuck', 'mohammedemadeldin2000', 'gabrielyii', 'keerthisv', 'pythagoras2', 'xunyong', 'irenehb92', 'shradhap', 'mohameeddsamy', 'marianne.gratton.1', 'marcmagdy98', 'brknshn', 'gemma', 'lukunze1', 'caglanlee', 'desmondsoon', 'sebasket14', 'masonpb2', 'youssef2042000', 'retty8', 'bharath3', 'syin4', 'ethanmorse', 'ematson5897', 'jacobzeshleman', 'leejq', 'harshini9962', 'reemali99_', 'xxlilmontysignxx', 'ramonruiz.infor', 'atharva98', 'ahern0722', 'hishamzakaria20', 'cheokonn', 'adriangarea', 'jeanmichael.deschenes', 'samet1231234', 'mr4425', 'bluelobster', 'justin.lariviere.25', 'dcpang2', 'felivitullo87', 'puertarcd', 'farahsamir978', 'akozych2', 'nbs691', 'kie180073', 'anwar909', 'bleuminuit', 'atx203', 'kanet1234', 'sealseal', 'emrebuyukkose2', 'arrow823', 'dhvanil', 'nuanno97', 'dkshelat', 'mohabayman', 'ranasherif65', 'diamond92', 'ugur.cankaya.3718', 'ammareltalli', 'acn562', 'nabilah1403', 'yaseminablacandir', 'tamchouweng', 'ablahsaoud', 'sriharshap', 'mrefaat', 'bassamtarek', 'hamidausat', 'kakmeera1999', 'teoster50', 'nolmos96', 'abdurrahmn13', 'mmartinezsanchez', 'sandrabashara', 'zakhwan7', 'chengweiheng', 'nikalyaamani', 'acregodean', 'happyleexin', 'sarapl', 'williammitchell5818', None, 'rooban11', 'yeejou990318', 'kowjiajin', 'nihaosawaddee', 'maxernest', 'david.garrido', 'guibill10', 'mohamedsameh', 'spazos7', 'tmi211', 'kie180039', 'worldlineusaf', 'mgk816', 'kie180079', 'ledicia97', 'movi205', 'shuming2']"
1,20,391,14,8,"['va844', 'michael2010814', 'atx203', 'fkl217', 'tmi211', 'al4995', 'jn1404', 'tyy233']",383,"['oliviercharbonneau', 'miri23', 'ozgurkablan26', 'loisonchambers', 'tuberkargan_97', 'pranjal3', 'musabmalek0717', 'nadanasser1199', 'siemprewowthechami', 'staceyn2', 'vblanco.nico', 'abbesalaeddine', 'efrenhub', 'isabelmaria.vazquez', 'ahmedamr', 'shorouk_ossama', 'rikardberger', 'alancantu57', 'luciano.brignone', 'rahimnoorj', 'janeneil88', 'guttsfulltyagi', 'mjgebara14', 'kartal', 'gabrielyii99', 'aboone06', 'saegner2', 'manuelsomoza94', 'amani12345', 'youssefsherif22', 'j.haliburton', 'amr_ua07', 'evrenyigit', 'tingliang', 'kirankumar94', 'ahagras13', 'njgale01', 'smrdafdl', 'travisc2', 'dlee145', 'stambo', 'anthonyroux', 'ryanorem', 'moh.bahaa', 'ahchehyan', 'aimanadnan', 'veronica.mieites', 's_coriolis', 'trkmengkay', 'cbecker413', 'mcruces.fz', 'latecnologiameodia', 'gxiao2', 'emilechouinard', 'je_guilbert', 'yubai', 'sinasigurpinar', 'lauragdevesa', 'muvafikmelikkaya', 'kason.carroll', 'jbaggie2019', 'annahaozheng0606', 'jtorres17', 'ahmedayman2370', 'zikrizaki88995', 'yjenyiee155', '46harunakgul', 'alifzulkifli99', 'kaitlinh', 'sdehoyos47', 'malgaca', 'lsleed', 'khazanv2', 'alexisdixon6', 'gc_1', 'jinsup2', 'rishu', 'amparo.castro.96', 'tbryan', 'martin32', 'michael.mechelay', 'akash140410107098', 'nowapoca', 'onaam8', 'pablosaavedra', 'camilolcastro97', 'khor', 'ankit6257', 'samashraf1', 'benoiturcotte', 'aishu98', 'rileyroca', 'david.peral.moran', 'kiruthikaabalu181996', 'taymacnichols', 'dhodapp', 'nagihankececi', 'carlosvigo1997', 'moh.ashraf105', 'baleko12345', 'ikhbal', 'afeefz', 'kaustubh.shirpurkar', 'kie180031', 'bflores18', 'tdubnansky6', 'jorgecastelo5', 'andreadiazgar', 'david2397', 'bcperki2', 'melaniejkramer', 'rkchapman', 'mateocampos', 'jzhan142', 'josepazmartin', 'brannon44', 'adfoz', 'avw2', 'youxing0309', 'scremin', 'lderemo', 'perezsarmar', 'ashutoshsinghhenry6', 'melroy_caeiro', 'viratbhatt007', 'coderko3', 'alimatama', 'ammaralaa516', 'nadhnasorudin', 'adarsh123', 'jacquelinethardin', 'mjoza2', 'nihatyavuz', 'estebanrial', 'jinwoo2', 'adnanyuceer', 'danielfernandezcalo', 'berkaydean', 'cloudyoverhead', 'fred_dion', 'syedzakwan', 'e1150590', 'fcfrancapra94', 'amiruldanial99', 'ozbunar01', 'alecorti.pardo', 'electronica18', 'nourananwar123', 'olivier.gilbert.paquet', 'anibarseghyan', 'amlibrahim', 'neuroque', 'kychui2', 'shaf31', 'hong_gao', 'paul.aniruddha', 'carlosbesadaromero', 'mohaballam', 'pip29', 'apb5472', 'tuberkargan', 'hafizmokh99', 'javierisma98', 'fathy1104', 'corredoira', 'helenalecoq97', 'kimzihuang', 'muteki', 'masitadonmez', 'nadja1', 'dancastaneda', 'ahmedsameh1698', 'rocio', 'mallen22', 'ffazul64', 'guoyao', 'ari6nd', 'kerryreto', 'pedrosiaba', 'michaelsaldana1', 'omarmagdy', 'vickytubio', 'ericrobles', 'soccadelic44', 'selena', 'aasifhameed99', 'damlakubattt', 'anxovidal8', 'exjamil', 'jahnavikachhia', 'joker632455', 'vincentpainchaud.vp', 'svo4321', 'zhixin2', 'yansi', 'asyrafaqil', 'xyz11', 'virajput299', 'ryanboucher', 'jpmcgee98', 'mariz', 'bhliu97', 'amrebrahim', 'abdulrahim2905', 'c.a.stupka', 'tonybocadillosgrandes', 'talwren', 'rxtodd', 'farah26', 'tss3', 'abieday1704', 'mavanzato0418', 'facundovia', 'cristinacigarran', 'nazimmath3', 'baohl2', 'ales.gajdacz', 'elad.d', 'kie180028', 'wahidiah52', 'kyang37', 'arifjalani99', 'lino13', 'jaimefookinlannister', 'physquig', 'adriancheah', 'jarodm2', 'noureldin1999', 'ckim123', 'eddin21', 'jipiccardi', 'prabuddha_888253127', 'david_atef', 'kalebhilde', 'magic_ocean99', 'saipraneett', 'sanchjai', 'omardeyaa', 'pingan99', 'aaq', 'alidsjt', 'mengkem2', 'haclarke', 'oishikfaruque', 'ilou', 'aengm', 'janalorenzolumbreras', 'hilisa', 'carlosvillar54', 'vikazvereva', 'm939454', 'pablobou4', 'ludovick.begin', 'maniphysics09', 'eduard25252598', 'apascao', 'xosegq16', 'adam562', 'lauramolinosmayo', 'amni99', 'kie180702', 'saharoaf', 'redzuan11', 'ypp200', 'kph2', 'martinzapata', 'kirolosehab99', 'restep2', 'seifhabib', 'maramtarek53', 'zehuahe2', 'azizijazam11', 'marcosanllo', 'aimansyaz99', 'elizametias12', 'juanmacano97', 'sparshagarwal1009', 'prakharbhargava0', 'njs035', 'alberfn', 'ramy_maged4', 'hmoulvi1', 'vanesagarcia', 'hf4', 'wowmuchchuck', 'mohammedemadeldin2000', 'gabrielyii', 'keerthisv', 'pythagoras2', 'xunyong', 'irenehb92', 'shradhap', 'mohameeddsamy', 'marianne.gratton.1', 'marcmagdy98', 'brknshn', 'gemma', 'lukunze1', 'caglanlee', 'desmondsoon', 'sebasket14', 'masonpb2', 'youssef2042000', 'retty8', 'bharath3', 'syin4', 'ethanmorse', 'ematson5897', 'jacobzeshleman', 'leejq', 'harshini9962', 'reemali99_', 'xxlilmontysignxx', 'ramonruiz.infor', 'atharva98', 'ahern0722', 'hishamzakaria20', 'cheokonn', 'adriangarea', 'jeanmichael.deschenes', 'samet1231234', 'mr4425', 'bluelobster', 'justin.lariviere.25', 'dcpang2', 'felivitullo87', 'puertarcd', 'farahsamir978', 'akozych2', 'nbs691', 'kie180073', 'anwar909', 'bleuminuit', 'kanet1234', 'sealseal', 'emrebuyukkose2', 'arrow823', 'dhvanil', 'nuanno97', 'dkshelat', 'mohabayman', 'ranasherif65', 'diamond92', 'ugur.cankaya.3718', 'ammareltalli', 'acn562', 'nabilah1403', 'yaseminablacandir', 'tamchouweng', 'ablahsaoud', 'sriharshap', 'mrefaat', 'bassamtarek', 'hamidausat', 'kakmeera1999', 'teoster50', 'nolmos96', 'abdurrahmn13', 'mmartinezsanchez', 'sandrabashara', 'zakhwan7', 'chengweiheng', 'nikalyaamani', 'acregodean', 'happyleexin', 'sarapl', 'williammitchell5818', 'rooban11', 'yeejou990318', 'kowjiajin', 'nihaosawaddee', 'maxernest', 'david.garrido', 'guibill10', 'mohamedsameh', 'spazos7', 'kie180039', 'worldlineusaf', 'mgk816', 'kie180079', 'ledicia97', 'movi205', 'shuming2']",6,"['hellotate', 'ec3136', 'mqadir3', 'jsltradecorp', 'c.k.ishino', None]",397,"['oliviercharbonneau', 'miri23', 'ozgurkablan26', 'loisonchambers', 'tuberkargan_97', 'pranjal3', 'musabmalek0717', 'nadanasser1199', 'siemprewowthechami', 'staceyn2', 'vblanco.nico', 'abbesalaeddine', 'efrenhub', 'isabelmaria.vazquez', 'ahmedamr', 'shorouk_ossama', 'rikardberger', 'alancantu57', 'luciano.brignone', 'rahimnoorj', 'janeneil88', 'guttsfulltyagi', 'mjgebara14', 'kartal', 'gabrielyii99', 'aboone06', 'saegner2', 'manuelsomoza94', 'amani12345', 'youssefsherif22', 'j.haliburton', 'amr_ua07', 'evrenyigit', 'tingliang', 'kirankumar94', 'ahagras13', 'njgale01', 'al4995', 'smrdafdl', 'travisc2', 'dlee145', 'stambo', 'anthonyroux', 'ryanorem', 'moh.bahaa', 'ahchehyan', 'aimanadnan', 'veronica.mieites', 's_coriolis', 'trkmengkay', 'hellotate', 'cbecker413', 'mcruces.fz', 'latecnologiameodia', 'gxiao2', 'emilechouinard', 'je_guilbert', 'yubai', 'sinasigurpinar', 'lauragdevesa', 'muvafikmelikkaya', 'kason.carroll', 'jbaggie2019', 'annahaozheng0606', 'jtorres17', 'ahmedayman2370', 'zikrizaki88995', 'yjenyiee155', '46harunakgul', 'alifzulkifli99', 'kaitlinh', 'tyy233', 'sdehoyos47', 'malgaca', 'lsleed', 'khazanv2', 'alexisdixon6', 'gc_1', 'jinsup2', 'rishu', 'amparo.castro.96', 'tbryan', 'martin32', 'michael.mechelay', 'akash140410107098', 'nowapoca', 'onaam8', 'pablosaavedra', 'camilolcastro97', 'khor', 'ankit6257', 'samashraf1', 'benoiturcotte', 'aishu98', 'rileyroca', 'david.peral.moran', 'kiruthikaabalu181996', 'taymacnichols', 'dhodapp', 'nagihankececi', 'carlosvigo1997', 'moh.ashraf105', 'baleko12345', 'ikhbal', 'afeefz', 'kaustubh.shirpurkar', 'kie180031', 'bflores18', 'tdubnansky6', 'jorgecastelo5', 'andreadiazgar', 'david2397', 'bcperki2', 'melaniejkramer', 'rkchapman', 'jn1404', 'mateocampos', 'jzhan142', 'josepazmartin', 'brannon44', 'adfoz', 'avw2', 'youxing0309', 'scremin', 'lderemo', 'perezsarmar', 'ashutoshsinghhenry6', 'melroy_caeiro', 'viratbhatt007', 'fkl217', 'coderko3', 'alimatama', 'ammaralaa516', 'nadhnasorudin', 'adarsh123', 'jacquelinethardin', 'mjoza2', 'nihatyavuz', 'estebanrial', 'jinwoo2', 'adnanyuceer', 'danielfernandezcalo', 'berkaydean', 'cloudyoverhead', 'fred_dion', 'syedzakwan', 'e1150590', 'fcfrancapra94', 'amiruldanial99', 'ozbunar01', 'alecorti.pardo', 'electronica18', 'jsltradecorp', 'nourananwar123', 'olivier.gilbert.paquet', 'anibarseghyan', 'amlibrahim', 'neuroque', 'kychui2', 'shaf31', 'hong_gao', 'paul.aniruddha', 'carlosbesadaromero', 'mohaballam', 'pip29', 'apb5472', 'tuberkargan', 'hafizmokh99', 'javierisma98', 'fathy1104', 'corredoira', 'helenalecoq97', 'kimzihuang', 'muteki', 'masitadonmez', 'nadja1', 'dancastaneda', 'ahmedsameh1698', 'rocio', 'mallen22', 'ffazul64', 'guoyao', 'ari6nd', 'kerryreto', 'pedrosiaba', 'michaelsaldana1', 'omarmagdy', 'vickytubio', 'ericrobles', 'soccadelic44', 'selena', 'aasifhameed99', 'damlakubattt', 'anxovidal8', 'exjamil', 'jahnavikachhia', 'joker632455', 'vincentpainchaud.vp', 'svo4321', 'zhixin2', 'yansi', 'asyrafaqil', 'xyz11', 'virajput299', 'ryanboucher', 'jpmcgee98', 'mariz', 'bhliu97', 'amrebrahim', 'abdulrahim2905', 'c.a.stupka', 'tonybocadillosgrandes', 'talwren', 'rxtodd', 'farah26', 'tss3', 'abieday1704', 'mavanzato0418', 'facundovia', 'cristinacigarran', 'nazimmath3', 'baohl2', 'ales.gajdacz', 'elad.d', 'kie180028', 'wahidiah52', 'kyang37', 'arifjalani99', 'lino13', 'jaimefookinlannister', 'physquig', 'adriancheah', 'jarodm2', 'noureldin1999', 'michael2010814', 'ckim123', 'eddin21', 'jipiccardi', 'prabuddha_888253127', 'david_atef', 'kalebhilde', 'magic_ocean99', 'saipraneett', 'sanchjai', 'omardeyaa', 'pingan99', 'aaq', 'alidsjt', 'mengkem2', 'haclarke', 'oishikfaruque', 'ilou', 'aengm', 'janalorenzolumbreras', 'hilisa', 'carlosvillar54', 'vikazvereva', 'm939454', 'va844', 'pablobou4', 'ludovick.begin', 'maniphysics09', 'eduard25252598', 'apascao', 'xosegq16', 'adam562', 'lauramolinosmayo', 'amni99', 'kie180702', 'saharoaf', 'redzuan11', 'ypp200', 'kph2', 'martinzapata', 'kirolosehab99', 'restep2', 'seifhabib', 'maramtarek53', 'zehuahe2', 'azizijazam11', 'marcosanllo', 'aimansyaz99', 'elizametias12', 'juanmacano97', 'sparshagarwal1009', 'prakharbhargava0', 'njs035', 'alberfn', 'ramy_maged4', 'hmoulvi1', 'vanesagarcia', 'hf4', 'wowmuchchuck', 'mohammedemadeldin2000', 'gabrielyii', 'keerthisv', 'pythagoras2', 'xunyong', 'irenehb92', 'shradhap', 'mohameeddsamy', 'marianne.gratton.1', 'marcmagdy98', 'mqadir3', 'brknshn', 'gemma', 'lukunze1', 'caglanlee', 'desmondsoon', 'sebasket14', 'masonpb2', 'youssef2042000', 'retty8', 'bharath3', 'syin4', 'ethanmorse', 'ematson5897', 'jacobzeshleman', 'leejq', 'harshini9962', 'reemali99_', 'xxlilmontysignxx', 'ramonruiz.infor', 'atharva98', 'ahern0722', 'hishamzakaria20', 'cheokonn', 'adriangarea', 'jeanmichael.deschenes', 'samet1231234', 'mr4425', 'bluelobster', 'justin.lariviere.25', 'dcpang2', 'felivitullo87', 'puertarcd', 'ec3136', 'farahsamir978', 'akozych2', 'nbs691', 'kie180073', 'anwar909', 'bleuminuit', 'atx203', 'kanet1234', 'sealseal', 'emrebuyukkose2', 'arrow823', 'dhvanil', 'nuanno97', 'dkshelat', 'mohabayman', 'ranasherif65', 'diamond92', 'ugur.cankaya.3718', 'ammareltalli', 'acn562', 'nabilah1403', 'yaseminablacandir', 'tamchouweng', 'ablahsaoud', 'sriharshap', 'mrefaat', 'bassamtarek', 'c.k.ishino', 'hamidausat', 'kakmeera1999', 'teoster50', 'nolmos96', 'abdurrahmn13', 'mmartinezsanchez', 'sandrabashara', 'zakhwan7', 'chengweiheng', 'nikalyaamani', 'acregodean', 'happyleexin', 'sarapl', 'williammitchell5818', None, 'rooban11', 'yeejou990318', 'kowjiajin', 'nihaosawaddee', 'maxernest', 'david.garrido', 'guibill10', 'mohamedsameh', 'spazos7', 'tmi211', 'kie180039', 'worldlineusaf', 'mgk816', 'kie180079', 'ledicia97', 'movi205', 'shuming2']"
1,26,391,11,9,"['trkmengkay', 'tuberkargan', 'ozgurkablan26', 'tuberkargan_97', 'emrebuyukkose2', 'brknshn', 'evrenyigit', 'joker632455', 'mgk816']",382,"['oliviercharbonneau', 'miri23', 'loisonchambers', 'pranjal3', 'musabmalek0717', 'nadanasser1199', 'siemprewowthechami', 'staceyn2', 'vblanco.nico', 'abbesalaeddine', 'efrenhub', 'isabelmaria.vazquez', 'ahmedamr', 'shorouk_ossama', 'rikardberger', 'alancantu57', 'luciano.brignone', 'rahimnoorj', 'janeneil88', 'guttsfulltyagi', 'mjgebara14', 'kartal', 'gabrielyii99', 'aboone06', 'saegner2', 'manuelsomoza94', 'amani12345', 'youssefsherif22', 'j.haliburton', 'amr_ua07', 'tingliang', 'kirankumar94', 'ahagras13', 'njgale01', 'al4995', 'smrdafdl', 'travisc2', 'dlee145', 'stambo', 'anthonyroux', 'ryanorem', 'moh.bahaa', 'ahchehyan', 'aimanadnan', 'veronica.mieites', 's_coriolis', 'cbecker413', 'mcruces.fz', 'latecnologiameodia', 'gxiao2', 'emilechouinard', 'je_guilbert', 'yubai', 'sinasigurpinar', 'lauragdevesa', 'muvafikmelikkaya', 'kason.carroll', 'jbaggie2019', 'annahaozheng0606', 'jtorres17', 'ahmedayman2370', 'zikrizaki88995', 'yjenyiee155', '46harunakgul', 'alifzulkifli99', 'kaitlinh', 'tyy233', 'sdehoyos47', 'malgaca', 'lsleed', 'khazanv2', 'alexisdixon6', 'gc_1', 'jinsup2', 'rishu', 'amparo.castro.96', 'tbryan', 'martin32', 'michael.mechelay', 'akash140410107098', 'nowapoca', 'onaam8', 'pablosaavedra', 'camilolcastro97', 'khor', 'ankit6257', 'samashraf1', 'benoiturcotte', 'aishu98', 'rileyroca', 'david.peral.moran', 'kiruthikaabalu181996', 'taymacnichols', 'dhodapp', 'nagihankececi', 'carlosvigo1997', 'moh.ashraf105', 'baleko12345', 'ikhbal', 'afeefz', 'kaustubh.shirpurkar', 'kie180031', 'bflores18', 'tdubnansky6', 'jorgecastelo5', 'andreadiazgar', 'david2397', 'bcperki2', 'melaniejkramer', 'rkchapman', 'jn1404', 'mateocampos', 'jzhan142', 'josepazmartin', 'brannon44', 'adfoz', 'avw2', 'youxing0309', 'scremin', 'lderemo', 'perezsarmar', 'ashutoshsinghhenry6', 'melroy_caeiro', 'viratbhatt007', 'fkl217', 'coderko3', 'alimatama', 'ammaralaa516', 'nadhnasorudin', 'adarsh123', 'jacquelinethardin', 'mjoza2', 'nihatyavuz', 'estebanrial', 'jinwoo2', 'adnanyuceer', 'danielfernandezcalo', 'berkaydean', 'cloudyoverhead', 'fred_dion', 'syedzakwan', 'e1150590', 'fcfrancapra94', 'amiruldanial99', 'ozbunar01', 'alecorti.pardo', 'electronica18', 'nourananwar123', 'olivier.gilbert.paquet', 'anibarseghyan', 'amlibrahim', 'neuroque', 'kychui2', 'shaf31', 'hong_gao', 'paul.aniruddha', 'carlosbesadaromero', 'mohaballam', 'pip29', 'apb5472', 'hafizmokh99', 'javierisma98', 'fathy1104', 'corredoira', 'helenalecoq97', 'kimzihuang', 'muteki', 'masitadonmez', 'nadja1', 'dancastaneda', 'ahmedsameh1698', 'rocio', 'mallen22', 'ffazul64', 'guoyao', 'ari6nd', 'kerryreto', 'pedrosiaba', 'michaelsaldana1', 'omarmagdy', 'vickytubio', 'ericrobles', 'soccadelic44', 'selena', 'aasifhameed99', 'damlakubattt', 'anxovidal8', 'exjamil', 'jahnavikachhia', 'vincentpainchaud.vp', 'svo4321', 'zhixin2', 'yansi', 'asyrafaqil', 'xyz11', 'virajput299', 'ryanboucher', 'jpmcgee98', 'mariz', 'bhliu97', 'amrebrahim', 'abdulrahim2905', 'c.a.stupka', 'tonybocadillosgrandes', 'talwren', 'rxtodd', 'farah26', 'tss3', 'abieday1704', 'mavanzato0418', 'facundovia', 'cristinacigarran', 'nazimmath3', 'baohl2', 'ales.gajdacz', 'elad.d', 'kie180028', 'wahidiah52', 'kyang37', 'arifjalani99', 'lino13', 'jaimefookinlannister', 'physquig', 'adriancheah', 'jarodm2', 'noureldin1999', 'michael2010814', 'ckim123', 'eddin21', 'jipiccardi', 'prabuddha_888253127', 'david_atef', 'kalebhilde', 'magic_ocean99', 'saipraneett', 'sanchjai', 'omardeyaa', 'pingan99', 'aaq', 'alidsjt', 'mengkem2', 'haclarke', 'oishikfaruque', 'ilou', 'aengm', 'janalorenzolumbreras', 'hilisa', 'carlosvillar54', 'vikazvereva', 'm939454', 'va844', 'pablobou4', 'ludovick.begin', 'maniphysics09', 'eduard25252598', 'apascao', 'xosegq16', 'adam562', 'lauramolinosmayo', 'amni99', 'kie180702', 'saharoaf', 'redzuan11', 'ypp200', 'kph2', 'martinzapata', 'kirolosehab99', 'restep2', 'seifhabib', 'maramtarek53', 'zehuahe2', 'azizijazam11', 'marcosanllo', 'aimansyaz99', 'elizametias12', 'juanmacano97', 'sparshagarwal1009', 'prakharbhargava0', 'njs035', 'alberfn', 'ramy_maged4', 'hmoulvi1', 'vanesagarcia', 'hf4', 'wowmuchchuck', 'mohammedemadeldin2000', 'gabrielyii', 'keerthisv', 'pythagoras2', 'xunyong', 'irenehb92', 'shradhap', 'mohameeddsamy', 'marianne.gratton.1', 'marcmagdy98', 'gemma', 'lukunze1', 'caglanlee', 'desmondsoon', 'sebasket14', 'masonpb2', 'youssef2042000', 'retty8', 'bharath3', 'syin4', 'ethanmorse', 'ematson5897', 'jacobzeshleman', 'leejq', 'harshini9962', 'reemali99_', 'xxlilmontysignxx', 'ramonruiz.infor', 'atharva98', 'ahern0722', 'hishamzakaria20', 'cheokonn', 'adriangarea', 'jeanmichael.deschenes', 'samet1231234', 'mr4425', 'bluelobster', 'justin.lariviere.25', 'dcpang2', 'felivitullo87', 'puertarcd', 'farahsamir978', 'akozych2', 'nbs691', 'kie180073', 'anwar909', 'bleuminuit', 'atx203', 'kanet1234', 'sealseal', 'arrow823', 'dhvanil', 'nuanno97', 'dkshelat', 'mohabayman', 'ranasherif65', 'diamond92', 'ugur.cankaya.3718', 'ammareltalli', 'acn562', 'nabilah1403', 'yaseminablacandir', 'tamchouweng', 'ablahsaoud', 'sriharshap', 'mrefaat', 'bassamtarek', 'hamidausat', 'kakmeera1999', 'teoster50', 'nolmos96', 'abdurrahmn13', 'mmartinezsanchez', 'sandrabashara', 'zakhwan7', 'chengweiheng', 'nikalyaamani', 'acregodean', 'happyleexin', 'sarapl', 'williammitchell5818', 'rooban11', 'yeejou990318', 'kowjiajin', 'nihaosawaddee', 'maxernest', 'david.garrido', 'guibill10', 'mohamedsameh', 'spazos7', 'tmi211', 'kie180039', 'worldlineusaf', 'kie180079', 'ledicia97', 'movi205', 'shuming2']",2,"['nihansulukoy', None]",393,"['oliviercharbonneau', 'miri23', 'ozgurkablan26', 'loisonchambers', 'tuberkargan_97', 'pranjal3', 'musabmalek0717', 'nadanasser1199', 'siemprewowthechami', 'staceyn2', 'vblanco.nico', 'abbesalaeddine', 'efrenhub', 'isabelmaria.vazquez', 'ahmedamr', 'shorouk_ossama', 'rikardberger', 'alancantu57', 'luciano.brignone', 'rahimnoorj', 'janeneil88', 'nihansulukoy', 'guttsfulltyagi', 'mjgebara14', 'kartal', 'gabrielyii99', 'aboone06', 'saegner2', 'manuelsomoza94', 'amani12345', 'youssefsherif22', 'j.haliburton', 'amr_ua07', 'evrenyigit', 'tingliang', 'kirankumar94', 'ahagras13', 'njgale01', 'al4995', 'smrdafdl', 'travisc2', 'dlee145', 'stambo', 'anthonyroux', 'ryanorem', 'moh.bahaa', 'ahchehyan', 'aimanadnan', 'veronica.mieites', 's_coriolis', 'trkmengkay', 'cbecker413', 'mcruces.fz', 'latecnologiameodia', 'gxiao2', 'emilechouinard', 'je_guilbert', 'yubai', 'sinasigurpinar', 'lauragdevesa', 'muvafikmelikkaya', 'kason.carroll', 'jbaggie2019', 'annahaozheng0606', 'jtorres17', 'ahmedayman2370', 'zikrizaki88995', 'yjenyiee155', '46harunakgul', 'alifzulkifli99', 'kaitlinh', 'tyy233', 'sdehoyos47', 'malgaca', 'lsleed', 'khazanv2', 'alexisdixon6', 'gc_1', 'jinsup2', 'rishu', 'amparo.castro.96', 'tbryan', 'martin32', 'michael.mechelay', 'akash140410107098', 'nowapoca', 'onaam8', 'pablosaavedra', 'camilolcastro97', 'khor', 'ankit6257', 'samashraf1', 'benoiturcotte', 'aishu98', 'rileyroca', 'david.peral.moran', 'kiruthikaabalu181996', 'taymacnichols', 'dhodapp', 'nagihankececi', 'carlosvigo1997', 'moh.ashraf105', 'baleko12345', 'ikhbal', 'afeefz', 'kaustubh.shirpurkar', 'kie180031', 'bflores18', 'tdubnansky6', 'jorgecastelo5', 'andreadiazgar', 'david2397', 'bcperki2', 'melaniejkramer', 'rkchapman', 'jn1404', 'mateocampos', 'jzhan142', 'josepazmartin', 'brannon44', 'adfoz', 'avw2', 'youxing0309', 'scremin', 'lderemo', 'perezsarmar', 'ashutoshsinghhenry6', 'melroy_caeiro', 'viratbhatt007', 'fkl217', 'coderko3', 'alimatama', 'ammaralaa516', 'nadhnasorudin', 'adarsh123', 'jacquelinethardin', 'mjoza2', 'nihatyavuz', 'estebanrial', 'jinwoo2', 'adnanyuceer', 'danielfernandezcalo', 'berkaydean', 'cloudyoverhead', 'fred_dion', 'syedzakwan', 'e1150590', 'fcfrancapra94', 'amiruldanial99', 'ozbunar01', 'alecorti.pardo', 'electronica18', 'nourananwar123', 'olivier.gilbert.paquet', 'anibarseghyan', 'amlibrahim', 'neuroque', 'kychui2', 'shaf31', 'hong_gao', 'paul.aniruddha', 'carlosbesadaromero', 'mohaballam', 'pip29', 'apb5472', 'tuberkargan', 'hafizmokh99', 'javierisma98', 'fathy1104', 'corredoira', 'helenalecoq97', 'kimzihuang', 'muteki', 'masitadonmez', 'nadja1', 'dancastaneda', 'ahmedsameh1698', 'rocio', 'mallen22', 'ffazul64', 'guoyao', 'ari6nd', 'kerryreto', 'pedrosiaba', 'michaelsaldana1', 'omarmagdy', 'vickytubio', 'ericrobles', 'soccadelic44', 'selena', 'aasifhameed99', 'damlakubattt', 'anxovidal8', 'exjamil', 'jahnavikachhia', 'joker632455', 'vincentpainchaud.vp', 'svo4321', 'zhixin2', 'yansi', 'asyrafaqil', 'xyz11', 'virajput299', 'ryanboucher', 'jpmcgee98', 'mariz', 'bhliu97', 'amrebrahim', 'abdulrahim2905', 'c.a.stupka', 'tonybocadillosgrandes', 'talwren', 'rxtodd', 'farah26', 'tss3', 'abieday1704', 'mavanzato0418', 'facundovia', 'cristinacigarran', 'nazimmath3', 'baohl2', 'ales.gajdacz', 'elad.d', 'kie180028', 'wahidiah52', 'kyang37', 'arifjalani99', 'lino13', 'jaimefookinlannister', 'physquig', 'adriancheah', 'jarodm2', 'noureldin1999', 'michael2010814', 'ckim123', 'eddin21', 'jipiccardi', 'prabuddha_888253127', 'david_atef', 'kalebhilde', 'magic_ocean99', 'saipraneett', 'sanchjai', 'omardeyaa', 'pingan99', 'aaq', 'alidsjt', 'mengkem2', 'haclarke', 'oishikfaruque', 'ilou', 'aengm', 'janalorenzolumbreras', 'hilisa', 'carlosvillar54', 'vikazvereva', 'm939454', 'va844', 'pablobou4', 'ludovick.begin', 'maniphysics09', 'eduard25252598', 'apascao', 'xosegq16', 'adam562', 'lauramolinosmayo', 'amni99', 'kie180702', 'saharoaf', 'redzuan11', 'ypp200', 'kph2', 'martinzapata', 'kirolosehab99', 'restep2', 'seifhabib', 'maramtarek53', 'zehuahe2', 'azizijazam11', 'marcosanllo', 'aimansyaz99', 'elizametias12', 'juanmacano97', 'sparshagarwal1009', 'prakharbhargava0', 'njs035', 'alberfn', 'ramy_maged4', 'hmoulvi1', 'vanesagarcia', 'hf4', 'wowmuchchuck', 'mohammedemadeldin2000', 'gabrielyii', 'keerthisv', 'pythagoras2', 'xunyong', 'irenehb92', 'shradhap', 'mohameeddsamy', 'marianne.gratton.1', 'marcmagdy98', 'brknshn', 'gemma', 'lukunze1', 'caglanlee', 'desmondsoon', 'sebasket14', 'masonpb2', 'youssef2042000', 'retty8', 'bharath3', 'syin4', 'ethanmorse', 'ematson5897', 'jacobzeshleman', 'leejq', 'harshini9962', 'reemali99_', 'xxlilmontysignxx', 'ramonruiz.infor', 'atharva98', 'ahern0722', 'hishamzakaria20', 'cheokonn', 'adriangarea', 'jeanmichael.deschenes', 'samet1231234', 'mr4425', 'bluelobster', 'justin.lariviere.25', 'dcpang2', 'felivitullo87', 'puertarcd', 'farahsamir978', 'akozych2', 'nbs691', 'kie180073', 'anwar909', 'bleuminuit', 'atx203', 'kanet1234', 'sealseal', 'emrebuyukkose2', 'arrow823', 'dhvanil', 'nuanno97', 'dkshelat', 'mohabayman', 'ranasherif65', 'diamond92', 'ugur.cankaya.3718', 'ammareltalli', 'acn562', 'nabilah1403', 'yaseminablacandir', 'tamchouweng', 'ablahsaoud', 'sriharshap', 'mrefaat', 'bassamtarek', 'hamidausat', 'kakmeera1999', 'teoster50', 'nolmos96', 'abdurrahmn13', 'mmartinezsanchez', 'sandrabashara', 'zakhwan7', 'chengweiheng', 'nikalyaamani', 'acregodean', 'happyleexin', 'sarapl', 'williammitchell5818', None, 'rooban11', 'yeejou990318', 'kowjiajin', 'nihaosawaddee', 'maxernest', 'david.garrido', 'guibill10', 'mohamedsameh', 'spazos7', 'tmi211', 'kie180039', 'worldlineusaf', 'mgk816', 'kie180079', 'ledicia97', 'movi205', 'shuming2']"
1,43,391,11,10,"['berkaydean', 'rileyroca', 'cbecker413', 'njs035', 'jacobzeshleman', 'williammitchell5818', 'smrdafdl', 'kaitlinh', 'nbs691', 'talwren']",381,"['oliviercharbonneau', 'miri23', 'ozgurkablan26', 'loisonchambers', 'tuberkargan_97', 'pranjal3', 'musabmalek0717', 'nadanasser1199', 'siemprewowthechami', 'staceyn2', 'vblanco.nico', 'abbesalaeddine', 'efrenhub', 'isabelmaria.vazquez', 'ahmedamr', 'shorouk_ossama', 'rikardberger', 'alancantu57', 'luciano.brignone', 'rahimnoorj', 'janeneil88', 'guttsfulltyagi', 'mjgebara14', 'kartal', 'gabrielyii99', 'aboone06', 'saegner2', 'manuelsomoza94', 'amani12345', 'youssefsherif22', 'j.haliburton', 'amr_ua07', 'evrenyigit', 'tingliang', 'kirankumar94', 'ahagras13', 'njgale01', 'al4995', 'travisc2', 'dlee145', 'stambo', 'anthonyroux', 'ryanorem', 'moh.bahaa', 'ahchehyan', 'aimanadnan', 'veronica.mieites', 's_coriolis', 'trkmengkay', 'mcruces.fz', 'latecnologiameodia', 'gxiao2', 'emilechouinard', 'je_guilbert', 'yubai', 'sinasigurpinar', 'lauragdevesa', 'muvafikmelikkaya', 'kason.carroll', 'jbaggie2019', 'annahaozheng0606', 'jtorres17', 'ahmedayman2370', 'zikrizaki88995', 'yjenyiee155', '46harunakgul', 'alifzulkifli99', 'tyy233', 'sdehoyos47', 'malgaca', 'lsleed', 'khazanv2', 'alexisdixon6', 'gc_1', 'jinsup2', 'rishu', 'amparo.castro.96', 'tbryan', 'martin32', 'michael.mechelay', 'akash140410107098', 'nowapoca', 'onaam8', 'pablosaavedra', 'camilolcastro97', 'khor', 'ankit6257', 'samashraf1', 'benoiturcotte', 'aishu98', 'david.peral.moran', 'kiruthikaabalu181996', 'taymacnichols', 'dhodapp', 'nagihankececi', 'carlosvigo1997', 'moh.ashraf105', 'baleko12345', 'ikhbal', 'afeefz', 'kaustubh.shirpurkar', 'kie180031', 'bflores18', 'tdubnansky6', 'jorgecastelo5', 'andreadiazgar', 'david2397', 'bcperki2', 'melaniejkramer', 'rkchapman', 'jn1404', 'mateocampos', 'jzhan142', 'josepazmartin', 'brannon44', 'adfoz', 'avw2', 'youxing0309', 'scremin', 'lderemo', 'perezsarmar', 'ashutoshsinghhenry6', 'melroy_caeiro', 'viratbhatt007', 'fkl217', 'coderko3', 'alimatama', 'ammaralaa516', 'nadhnasorudin', 'adarsh123', 'jacquelinethardin', 'mjoza2', 'nihatyavuz', 'estebanrial', 'jinwoo2', 'adnanyuceer', 'danielfernandezcalo', 'cloudyoverhead', 'fred_dion', 'syedzakwan', 'e1150590', 'fcfrancapra94', 'amiruldanial99', 'ozbunar01', 'alecorti.pardo', 'electronica18', 'nourananwar123', 'olivier.gilbert.paquet', 'anibarseghyan', 'amlibrahim', 'neuroque', 'kychui2', 'shaf31', 'hong_gao', 'paul.aniruddha', 'carlosbesadaromero', 'mohaballam', 'pip29', 'apb5472', 'tuberkargan', 'hafizmokh99', 'javierisma98', 'fathy1104', 'corredoira', 'helenalecoq97', 'kimzihuang', 'muteki', 'masitadonmez', 'nadja1', 'dancastaneda', 'ahmedsameh1698', 'rocio', 'mallen22', 'ffazul64', 'guoyao', 'ari6nd', 'kerryreto', 'pedrosiaba', 'michaelsaldana1', 'omarmagdy', 'vickytubio', 'ericrobles', 'soccadelic44', 'selena', 'aasifhameed99', 'damlakubattt', 'anxovidal8', 'exjamil', 'jahnavikachhia', 'joker632455', 'vincentpainchaud.vp', 'svo4321', 'zhixin2', 'yansi', 'asyrafaqil', 'xyz11', 'virajput299', 'ryanboucher', 'jpmcgee98', 'mariz', 'bhliu97', 'amrebrahim', 'abdulrahim2905', 'c.a.stupka', 'tonybocadillosgrandes', 'rxtodd', 'farah26', 'tss3', 'abieday1704', 'mavanzato0418', 'facundovia', 'cristinacigarran', 'nazimmath3', 'baohl2', 'ales.gajdacz', 'elad.d', 'kie180028', 'wahidiah52', 'kyang37', 'arifjalani99', 'lino13', 'jaimefookinlannister', 'physquig', 'adriancheah', 'jarodm2', 'noureldin1999', 'michael2010814', 'ckim123', 'eddin21', 'jipiccardi', 'prabuddha_888253127', 'david_atef', 'kalebhilde', 'magic_ocean99', 'saipraneett', 'sanchjai', 'omardeyaa', 'pingan99', 'aaq', 'alidsjt', 'mengkem2', 'haclarke', 'oishikfaruque', 'ilou', 'aengm', 'janalorenzolumbreras', 'hilisa', 'carlosvillar54', 'vikazvereva', 'm939454', 'va844', 'pablobou4', 'ludovick.begin', 'maniphysics09', 'eduard25252598', 'apascao', 'xosegq16', 'adam562', 'lauramolinosmayo', 'amni99', 'kie180702', 'saharoaf', 'redzuan11', 'ypp200', 'kph2', 'martinzapata', 'kirolosehab99', 'restep2', 'seifhabib', 'maramtarek53', 'zehuahe2', 'azizijazam11', 'marcosanllo', 'aimansyaz99', 'elizametias12', 'juanmacano97', 'sparshagarwal1009', 'prakharbhargava0', 'alberfn', 'ramy_maged4', 'hmoulvi1', 'vanesagarcia', 'hf4', 'wowmuchchuck', 'mohammedemadeldin2000', 'gabrielyii', 'keerthisv', 'pythagoras2', 'xunyong', 'irenehb92', 'shradhap', 'mohameeddsamy', 'marianne.gratton.1', 'marcmagdy98', 'brknshn', 'gemma', 'lukunze1', 'caglanlee', 'desmondsoon', 'sebasket14', 'masonpb2', 'youssef2042000', 'retty8', 'bharath3', 'syin4', 'ethanmorse', 'ematson5897', 'leejq', 'harshini9962', 'reemali99_', 'xxlilmontysignxx', 'ramonruiz.infor', 'atharva98', 'ahern0722', 'hishamzakaria20', 'cheokonn', 'adriangarea', 'jeanmichael.deschenes', 'samet1231234', 'mr4425', 'bluelobster', 'justin.lariviere.25', 'dcpang2', 'felivitullo87', 'puertarcd', 'farahsamir978', 'akozych2', 'kie180073', 'anwar909', 'bleuminuit', 'atx203', 'kanet1234', 'sealseal', 'emrebuyukkose2', 'arrow823', 'dhvanil', 'nuanno97', 'dkshelat', 'mohabayman', 'ranasherif65', 'diamond92', 'ugur.cankaya.3718', 'ammareltalli', 'acn562', 'nabilah1403', 'yaseminablacandir', 'tamchouweng', 'ablahsaoud', 'sriharshap', 'mrefaat', 'bassamtarek', 'hamidausat', 'kakmeera1999', 'teoster50', 'nolmos96', 'abdurrahmn13', 'mmartinezsanchez', 'sandrabashara', 'zakhwan7', 'chengweiheng', 'nikalyaamani', 'acregodean', 'happyleexin', 'sarapl', 'rooban11', 'yeejou990318', 'kowjiajin', 'nihaosawaddee', 'maxernest', 'david.garrido', 'guibill10', 'mohamedsameh', 'spazos7', 'tmi211', 'kie180039', 'worldlineusaf', 'mgk816', 'kie180079', 'ledicia97', 'movi205', 'shuming2']",1,[None],392,"['oliviercharbonneau', 'miri23', 'ozgurkablan26', 'loisonchambers', 'tuberkargan_97', 'pranjal3', 'musabmalek0717', 'nadanasser1199', 'siemprewowthechami', 'staceyn2', 'vblanco.nico', 'abbesalaeddine', 'efrenhub', 'isabelmaria.vazquez', 'ahmedamr', 'shorouk_ossama', 'rikardberger', 'alancantu57', 'luciano.brignone', 'rahimnoorj', 'janeneil88', 'guttsfulltyagi', 'mjgebara14', 'kartal', 'gabrielyii99', 'aboone06', 'saegner2', 'manuelsomoza94', 'amani12345', 'youssefsherif22', 'j.haliburton', 'amr_ua07', 'evrenyigit', 'tingliang', 'kirankumar94', 'ahagras13', 'njgale01', 'al4995', 'smrdafdl', 'travisc2', 'dlee145', 'stambo', 'anthonyroux', 'ryanorem', 'moh.bahaa', 'ahchehyan', 'aimanadnan', 'veronica.mieites', 's_coriolis', 'trkmengkay', 'cbecker413', 'mcruces.fz', 'latecnologiameodia', 'gxiao2', 'emilechouinard', 'je_guilbert', 'yubai', 'sinasigurpinar', 'lauragdevesa', 'muvafikmelikkaya', 'kason.carroll', 'jbaggie2019', 'annahaozheng0606', 'jtorres17', 'ahmedayman2370', 'zikrizaki88995', 'yjenyiee155', '46harunakgul', 'alifzulkifli99', 'kaitlinh', 'tyy233', 'sdehoyos47', 'malgaca', 'lsleed', 'khazanv2', 'alexisdixon6', 'gc_1', 'jinsup2', 'rishu', 'amparo.castro.96', 'tbryan', 'martin32', 'michael.mechelay', 'akash140410107098', 'nowapoca', 'onaam8', 'pablosaavedra', 'camilolcastro97', 'khor', 'ankit6257', 'samashraf1', 'benoiturcotte', 'aishu98', 'rileyroca', 'david.peral.moran', 'kiruthikaabalu181996', 'taymacnichols', 'dhodapp', 'nagihankececi', 'carlosvigo1997', 'moh.ashraf105', 'baleko12345', 'ikhbal', 'afeefz', 'kaustubh.shirpurkar', 'kie180031', 'bflores18', 'tdubnansky6', 'jorgecastelo5', 'andreadiazgar', 'david2397', 'bcperki2', 'melaniejkramer', 'rkchapman', 'jn1404', 'mateocampos', 'jzhan142', 'josepazmartin', 'brannon44', 'adfoz', 'avw2', 'youxing0309', 'scremin', 'lderemo', 'perezsarmar', 'ashutoshsinghhenry6', 'melroy_caeiro', 'viratbhatt007', 'fkl217', 'coderko3', 'alimatama', 'ammaralaa516', 'nadhnasorudin', 'adarsh123', 'jacquelinethardin', 'mjoza2', 'nihatyavuz', 'estebanrial', 'jinwoo2', 'adnanyuceer', 'danielfernandezcalo', 'berkaydean', 'cloudyoverhead', 'fred_dion', 'syedzakwan', 'e1150590', 'fcfrancapra94', 'amiruldanial99', 'ozbunar01', 'alecorti.pardo', 'electronica18', 'nourananwar123', 'olivier.gilbert.paquet', 'anibarseghyan', 'amlibrahim', 'neuroque', 'kychui2', 'shaf31', 'hong_gao', 'paul.aniruddha', 'carlosbesadaromero', 'mohaballam', 'pip29', 'apb5472', 'tuberkargan', 'hafizmokh99', 'javierisma98', 'fathy1104', 'corredoira', 'helenalecoq97', 'kimzihuang', 'muteki', 'masitadonmez', 'nadja1', 'dancastaneda', 'ahmedsameh1698', 'rocio', 'mallen22', 'ffazul64', 'guoyao', 'ari6nd', 'kerryreto', 'pedrosiaba', 'michaelsaldana1', 'omarmagdy', 'vickytubio', 'ericrobles', 'soccadelic44', 'selena', 'aasifhameed99', 'damlakubattt', 'anxovidal8', 'exjamil', 'jahnavikachhia', 'joker632455', 'vincentpainchaud.vp', 'svo4321', 'zhixin2', 'yansi', 'asyrafaqil', 'xyz11', 'virajput299', 'ryanboucher', 'jpmcgee98', 'mariz', 'bhliu97', 'amrebrahim', 'abdulrahim2905', 'c.a.stupka', 'tonybocadillosgrandes', 'talwren', 'rxtodd', 'farah26', 'tss3', 'abieday1704', 'mavanzato0418', 'facundovia', 'cristinacigarran', 'nazimmath3', 'baohl2', 'ales.gajdacz', 'elad.d', 'kie180028', 'wahidiah52', 'kyang37', 'arifjalani99', 'lino13', 'jaimefookinlannister', 'physquig', 'adriancheah', 'jarodm2', 'noureldin1999', 'michael2010814', 'ckim123', 'eddin21', 'jipiccardi', 'prabuddha_888253127', 'david_atef', 'kalebhilde', 'magic_ocean99', 'saipraneett', 'sanchjai', 'omardeyaa', 'pingan99', 'aaq', 'alidsjt', 'mengkem2', 'haclarke', 'oishikfaruque', 'ilou', 'aengm', 'janalorenzolumbreras', 'hilisa', 'carlosvillar54', 'vikazvereva', 'm939454', 'va844', 'pablobou4', 'ludovick.begin', 'maniphysics09', 'eduard25252598', 'apascao', 'xosegq16', 'adam562', 'lauramolinosmayo', 'amni99', 'kie180702', 'saharoaf', 'redzuan11', 'ypp200', 'kph2', 'martinzapata', 'kirolosehab99', 'restep2', 'seifhabib', 'maramtarek53', 'zehuahe2', 'azizijazam11', 'marcosanllo', 'aimansyaz99', 'elizametias12', 'juanmacano97', 'sparshagarwal1009', 'prakharbhargava0', 'njs035', 'alberfn', 'ramy_maged4', 'hmoulvi1', 'vanesagarcia', 'hf4', 'wowmuchchuck', 'mohammedemadeldin2000', 'gabrielyii', 'keerthisv', 'pythagoras2', 'xunyong', 'irenehb92', 'shradhap', 'mohameeddsamy', 'marianne.gratton.1', 'marcmagdy98', 'brknshn', 'gemma', 'lukunze1', 'caglanlee', 'desmondsoon', 'sebasket14', 'masonpb2', 'youssef2042000', 'retty8', 'bharath3', 'syin4', 'ethanmorse', 'ematson5897', 'jacobzeshleman', 'leejq', 'harshini9962', 'reemali99_', 'xxlilmontysignxx', 'ramonruiz.infor', 'atharva98', 'ahern0722', 'hishamzakaria20', 'cheokonn', 'adriangarea', 'jeanmichael.deschenes', 'samet1231234', 'mr4425', 'bluelobster', 'justin.lariviere.25', 'dcpang2', 'felivitullo87', 'puertarcd', 'farahsamir978', 'akozych2', 'nbs691', 'kie180073', 'anwar909', 'bleuminuit', 'atx203', 'kanet1234', 'sealseal', 'emrebuyukkose2', 'arrow823', 'dhvanil', 'nuanno97', 'dkshelat', 'mohabayman', 'ranasherif65', 'diamond92', 'ugur.cankaya.3718', 'ammareltalli', 'acn562', 'nabilah1403', 'yaseminablacandir', 'tamchouweng', 'ablahsaoud', 'sriharshap', 'mrefaat', 'bassamtarek', 'hamidausat', 'kakmeera1999', 'teoster50', 'nolmos96', 'abdurrahmn13', 'mmartinezsanchez', 'sandrabashara', 'zakhwan7', 'chengweiheng', 'nikalyaamani', 'acregodean', 'happyleexin', 'sarapl', 'williammitchell5818', None, 'rooban11', 'yeejou990318', 'kowjiajin', 'nihaosawaddee', 'maxernest', 'david.garrido', 'guibill10', 'mohamedsameh', 'spazos7', 'tmi211', 'kie180039', 'worldlineusaf', 'mgk816', 'kie180079', 'ledicia97', 'movi205', 'shuming2']"
1,14,391,10,4,"['pablosaavedra', 'jipiccardi', 'felivitullo87', 'nowapoca']",387,"['oliviercharbonneau', 'miri23', 'ozgurkablan26', 'loisonchambers', 'tuberkargan_97', 'pranjal3', 'musabmalek0717', 'nadanasser1199', 'siemprewowthechami', 'staceyn2', 'vblanco.nico', 'abbesalaeddine', 'efrenhub', 'isabelmaria.vazquez', 'ahmedamr', 'shorouk_ossama', 'rikardberger', 'alancantu57', 'luciano.brignone', 'rahimnoorj', 'janeneil88', 'guttsfulltyagi', 'mjgebara14', 'kartal', 'gabrielyii99', 'aboone06', 'saegner2', 'manuelsomoza94', 'amani12345', 'youssefsherif22', 'j.haliburton', 'amr_ua07', 'evrenyigit', 'tingliang', 'kirankumar94', 'ahagras13', 'njgale01', 'al4995', 'smrdafdl', 'travisc2', 'dlee145', 'stambo', 'anthonyroux', 'ryanorem', 'moh.bahaa', 'ahchehyan', 'aimanadnan', 'veronica.mieites', 's_coriolis', 'trkmengkay', 'cbecker413', 'mcruces.fz', 'latecnologiameodia', 'gxiao2', 'emilechouinard', 'je_guilbert', 'yubai', 'sinasigurpinar', 'lauragdevesa', 'muvafikmelikkaya', 'kason.carroll', 'jbaggie2019', 'annahaozheng0606', 'jtorres17', 'ahmedayman2370', 'zikrizaki88995', 'yjenyiee155', '46harunakgul', 'alifzulkifli99', 'kaitlinh', 'tyy233', 'sdehoyos47', 'malgaca', 'lsleed', 'khazanv2', 'alexisdixon6', 'gc_1', 'jinsup2', 'rishu', 'amparo.castro.96', 'tbryan', 'martin32', 'michael.mechelay', 'akash140410107098', 'onaam8', 'camilolcastro97', 'khor', 'ankit6257', 'samashraf1', 'benoiturcotte', 'aishu98', 'rileyroca', 'david.peral.moran', 'kiruthikaabalu181996', 'taymacnichols', 'dhodapp', 'nagihankececi', 'carlosvigo1997', 'moh.ashraf105', 'baleko12345', 'ikhbal', 'afeefz', 'kaustubh.shirpurkar', 'kie180031', 'bflores18', 'tdubnansky6', 'jorgecastelo5', 'andreadiazgar', 'david2397', 'bcperki2', 'melaniejkramer', 'rkchapman', 'jn1404', 'mateocampos', 'jzhan142', 'josepazmartin', 'brannon44', 'adfoz', 'avw2', 'youxing0309', 'scremin', 'lderemo', 'perezsarmar', 'ashutoshsinghhenry6', 'melroy_caeiro', 'viratbhatt007', 'fkl217', 'coderko3', 'alimatama', 'ammaralaa516', 'nadhnasorudin', 'adarsh123', 'jacquelinethardin', 'mjoza2', 'nihatyavuz', 'estebanrial', 'jinwoo2', 'adnanyuceer', 'danielfernandezcalo', 'berkaydean', 'cloudyoverhead', 'fred_dion', 'syedzakwan', 'e1150590', 'fcfrancapra94', 'amiruldanial99', 'ozbunar01', 'alecorti.pardo', 'electronica18', 'nourananwar123', 'olivier.gilbert.paquet', 'anibarseghyan', 'amlibrahim', 'neuroque', 'kychui2', 'shaf31', 'hong_gao', 'paul.aniruddha', 'carlosbesadaromero', 'mohaballam', 'pip29', 'apb5472', 'tuberkargan', 'hafizmokh99', 'javierisma98', 'fathy1104', 'corredoira', 'helenalecoq97', 'kimzihuang', 'muteki', 'masitadonmez', 'nadja1', 'dancastaneda', 'ahmedsameh1698', 'rocio', 'mallen22', 'ffazul64', 'guoyao', 'ari6nd', 'kerryreto', 'pedrosiaba', 'michaelsaldana1', 'omarmagdy', 'vickytubio', 'ericrobles', 'soccadelic44', 'selena', 'aasifhameed99', 'damlakubattt', 'anxovidal8', 'exjamil', 'jahnavikachhia', 'joker632455', 'vincentpainchaud.vp', 'svo4321', 'zhixin2', 'yansi', 'asyrafaqil', 'xyz11', 'virajput299', 'ryanboucher', 'jpmcgee98', 'mariz', 'bhliu97', 'amrebrahim', 'abdulrahim2905', 'c.a.stupka', 'tonybocadillosgrandes', 'talwren', 'rxtodd', 'farah26', 'tss3', 'abieday1704', 'mavanzato0418', 'facundovia', 'cristinacigarran', 'nazimmath3', 'baohl2', 'ales.gajdacz', 'elad.d', 'kie180028', 'wahidiah52', 'kyang37', 'arifjalani99', 'lino13', 'jaimefookinlannister', 'physquig', 'adriancheah', 'jarodm2', 'noureldin1999', 'michael2010814', 'ckim123', 'eddin21', 'prabuddha_888253127', 'david_atef', 'kalebhilde', 'magic_ocean99', 'saipraneett', 'sanchjai', 'omardeyaa', 'pingan99', 'aaq', 'alidsjt', 'mengkem2', 'haclarke', 'oishikfaruque', 'ilou', 'aengm', 'janalorenzolumbreras', 'hilisa', 'carlosvillar54', 'vikazvereva', 'm939454', 'va844', 'pablobou4', 'ludovick.begin', 'maniphysics09', 'eduard25252598', 'apascao', 'xosegq16', 'adam562', 'lauramolinosmayo', 'amni99', 'kie180702', 'saharoaf', 'redzuan11', 'ypp200', 'kph2', 'martinzapata', 'kirolosehab99', 'restep2', 'seifhabib', 'maramtarek53', 'zehuahe2', 'azizijazam11', 'marcosanllo', 'aimansyaz99', 'elizametias12', 'juanmacano97', 'sparshagarwal1009', 'prakharbhargava0', 'njs035', 'alberfn', 'ramy_maged4', 'hmoulvi1', 'vanesagarcia', 'hf4', 'wowmuchchuck', 'mohammedemadeldin2000', 'gabrielyii', 'keerthisv', 'pythagoras2', 'xunyong', 'irenehb92', 'shradhap', 'mohameeddsamy', 'marianne.gratton.1', 'marcmagdy98', 'brknshn', 'gemma', 'lukunze1', 'caglanlee', 'desmondsoon', 'sebasket14', 'masonpb2', 'youssef2042000', 'retty8', 'bharath3', 'syin4', 'ethanmorse', 'ematson5897', 'jacobzeshleman', 'leejq', 'harshini9962', 'reemali99_', 'xxlilmontysignxx', 'ramonruiz.infor', 'atharva98', 'ahern0722', 'hishamzakaria20', 'cheokonn', 'adriangarea', 'jeanmichael.deschenes', 'samet1231234', 'mr4425', 'bluelobster', 'justin.lariviere.25', 'dcpang2', 'puertarcd', 'farahsamir978', 'akozych2', 'nbs691', 'kie180073', 'anwar909', 'bleuminuit', 'atx203', 'kanet1234', 'sealseal', 'emrebuyukkose2', 'arrow823', 'dhvanil', 'nuanno97', 'dkshelat', 'mohabayman', 'ranasherif65', 'diamond92', 'ugur.cankaya.3718', 'ammareltalli', 'acn562', 'nabilah1403', 'yaseminablacandir', 'tamchouweng', 'ablahsaoud', 'sriharshap', 'mrefaat', 'bassamtarek', 'hamidausat', 'kakmeera1999', 'teoster50', 'nolmos96', 'abdurrahmn13', 'mmartinezsanchez', 'sandrabashara', 'zakhwan7', 'chengweiheng', 'nikalyaamani', 'acregodean', 'happyleexin', 'sarapl', 'williammitchell5818', 'rooban11', 'yeejou990318', 'kowjiajin', 'nihaosawaddee', 'maxernest', 'david.garrido', 'guibill10', 'mohamedsameh', 'spazos7', 'tmi211', 'kie180039', 'worldlineusaf', 'mgk816', 'kie180079', 'ledicia97', 'movi205', 'shuming2']",6,"['adh30', 'juliandocev15868', 'spazos', 'damitepl', 'garx', None]",397,"['oliviercharbonneau', 'miri23', 'ozgurkablan26', 'loisonchambers', 'tuberkargan_97', 'pranjal3', 'musabmalek0717', 'nadanasser1199', 'siemprewowthechami', 'staceyn2', 'vblanco.nico', 'abbesalaeddine', 'efrenhub', 'isabelmaria.vazquez', 'ahmedamr', 'shorouk_ossama', 'rikardberger', 'alancantu57', 'luciano.brignone', 'rahimnoorj', 'janeneil88', 'guttsfulltyagi', 'mjgebara14', 'kartal', 'gabrielyii99', 'aboone06', 'saegner2', 'manuelsomoza94', 'amani12345', 'youssefsherif22', 'j.haliburton', 'amr_ua07', 'evrenyigit', 'tingliang', 'kirankumar94', 'ahagras13', 'njgale01', 'al4995', 'smrdafdl', 'travisc2', 'dlee145', 'stambo', 'anthonyroux', 'ryanorem', 'moh.bahaa', 'ahchehyan', 'aimanadnan', 'veronica.mieites', 's_coriolis', 'trkmengkay', 'cbecker413', 'mcruces.fz', 'latecnologiameodia', 'gxiao2', 'emilechouinard', 'je_guilbert', 'yubai', 'sinasigurpinar', 'lauragdevesa', 'muvafikmelikkaya', 'kason.carroll', 'jbaggie2019', 'annahaozheng0606', 'jtorres17', 'ahmedayman2370', 'zikrizaki88995', 'yjenyiee155', '46harunakgul', 'alifzulkifli99', 'kaitlinh', 'tyy233', 'sdehoyos47', 'malgaca', 'lsleed', 'khazanv2', 'alexisdixon6', 'gc_1', 'jinsup2', 'rishu', 'amparo.castro.96', 'tbryan', 'martin32', 'michael.mechelay', 'akash140410107098', 'nowapoca', 'onaam8', 'pablosaavedra', 'camilolcastro97', 'khor', 'ankit6257', 'samashraf1', 'benoiturcotte', 'aishu98', 'rileyroca', 'david.peral.moran', 'kiruthikaabalu181996', 'taymacnichols', 'dhodapp', 'nagihankececi', 'carlosvigo1997', 'moh.ashraf105', 'baleko12345', 'ikhbal', 'afeefz', 'kaustubh.shirpurkar', 'kie180031', 'bflores18', 'tdubnansky6', 'jorgecastelo5', 'andreadiazgar', 'david2397', 'bcperki2', 'melaniejkramer', 'rkchapman', 'jn1404', 'mateocampos', 'jzhan142', 'josepazmartin', 'brannon44', 'adfoz', 'avw2', 'youxing0309', 'scremin', 'lderemo', 'perezsarmar', 'ashutoshsinghhenry6', 'melroy_caeiro', 'viratbhatt007', 'fkl217', 'coderko3', 'alimatama', 'ammaralaa516', 'nadhnasorudin', 'adarsh123', 'jacquelinethardin', 'mjoza2', 'nihatyavuz', 'estebanrial', 'jinwoo2', 'adnanyuceer', 'danielfernandezcalo', 'berkaydean', 'cloudyoverhead', 'fred_dion', 'syedzakwan', 'e1150590', 'fcfrancapra94', 'amiruldanial99', 'ozbunar01', 'alecorti.pardo', 'electronica18', 'nourananwar123', 'olivier.gilbert.paquet', 'anibarseghyan', 'amlibrahim', 'neuroque', 'juliandocev15868', 'kychui2', 'shaf31', 'hong_gao', 'paul.aniruddha', 'carlosbesadaromero', 'mohaballam', 'pip29', 'apb5472', 'tuberkargan', 'hafizmokh99', 'javierisma98', 'fathy1104', 'corredoira', 'helenalecoq97', 'kimzihuang', 'muteki', 'masitadonmez', 'nadja1', 'dancastaneda', 'ahmedsameh1698', 'rocio', 'mallen22', 'ffazul64', 'guoyao', 'ari6nd', 'kerryreto', 'pedrosiaba', 'michaelsaldana1', 'omarmagdy', 'vickytubio', 'ericrobles', 'soccadelic44', 'selena', 'aasifhameed99', 'damlakubattt', 'anxovidal8', 'exjamil', 'jahnavikachhia', 'joker632455', 'vincentpainchaud.vp', 'svo4321', 'zhixin2', 'yansi', 'asyrafaqil', 'xyz11', 'virajput299', 'ryanboucher', 'jpmcgee98', 'mariz', 'bhliu97', 'amrebrahim', 'abdulrahim2905', 'c.a.stupka', 'tonybocadillosgrandes', 'talwren', 'rxtodd', 'farah26', 'tss3', 'abieday1704', 'mavanzato0418', 'facundovia', 'cristinacigarran', 'nazimmath3', 'baohl2', 'ales.gajdacz', 'elad.d', 'kie180028', 'wahidiah52', 'kyang37', 'arifjalani99', 'lino13', 'jaimefookinlannister', 'physquig', 'adriancheah', 'jarodm2', 'noureldin1999', 'michael2010814', 'ckim123', 'eddin21', 'jipiccardi', 'prabuddha_888253127', 'david_atef', 'kalebhilde', 'magic_ocean99', 'saipraneett', 'sanchjai', 'omardeyaa', 'pingan99', 'aaq', 'alidsjt', 'mengkem2', 'haclarke', 'oishikfaruque', 'ilou', 'aengm', 'janalorenzolumbreras', 'hilisa', 'carlosvillar54', 'vikazvereva', 'm939454', 'adh30', 'va844', 'pablobou4', 'ludovick.begin', 'maniphysics09', 'eduard25252598', 'apascao', 'xosegq16', 'adam562', 'lauramolinosmayo', 'amni99', 'kie180702', 'saharoaf', 'redzuan11', 'ypp200', 'kph2', 'martinzapata', 'kirolosehab99', 'restep2', 'seifhabib', 'maramtarek53', 'zehuahe2', 'azizijazam11', 'marcosanllo', 'aimansyaz99', 'elizametias12', 'juanmacano97', 'sparshagarwal1009', 'prakharbhargava0', 'spazos', 'njs035', 'alberfn', 'ramy_maged4', 'hmoulvi1', 'vanesagarcia', 'hf4', 'wowmuchchuck', 'mohammedemadeldin2000', 'gabrielyii', 'keerthisv', 'pythagoras2', 'xunyong', 'irenehb92', 'shradhap', 'mohameeddsamy', 'marianne.gratton.1', 'marcmagdy98', 'damitepl', 'brknshn', 'gemma', 'lukunze1', 'caglanlee', 'desmondsoon', 'sebasket14', 'masonpb2', 'youssef2042000', 'retty8', 'bharath3', 'syin4', 'garx', 'ethanmorse', 'ematson5897', 'jacobzeshleman', 'leejq', 'harshini9962', 'reemali99_', 'xxlilmontysignxx', 'ramonruiz.infor', 'atharva98', 'ahern0722', 'hishamzakaria20', 'cheokonn', 'adriangarea', 'jeanmichael.deschenes', 'samet1231234', 'mr4425', 'bluelobster', 'justin.lariviere.25', 'dcpang2', 'felivitullo87', 'puertarcd', 'farahsamir978', 'akozych2', 'nbs691', 'kie180073', 'anwar909', 'bleuminuit', 'atx203', 'kanet1234', 'sealseal', 'emrebuyukkose2', 'arrow823', 'dhvanil', 'nuanno97', 'dkshelat', 'mohabayman', 'ranasherif65', 'diamond92', 'ugur.cankaya.3718', 'ammareltalli', 'acn562', 'nabilah1403', 'yaseminablacandir', 'tamchouweng', 'ablahsaoud', 'sriharshap', 'mrefaat', 'bassamtarek', 'hamidausat', 'kakmeera1999', 'teoster50', 'nolmos96', 'abdurrahmn13', 'mmartinezsanchez', 'sandrabashara', 'zakhwan7', 'chengweiheng', 'nikalyaamani', 'acregodean', 'happyleexin', 'sarapl', 'williammitchell5818', None, 'rooban11', 'yeejou990318', 'kowjiajin', 'nihaosawaddee', 'maxernest', 'david.garrido', 'guibill10', 'mohamedsameh', 'spazos7', 'tmi211', 'kie180039', 'worldlineusaf', 'mgk816', 'kie180079', 'ledicia97', 'movi205', 'shuming2']"
1,16,391,10,5,"['elad.d', 'alancantu57', 'luciano.brignone', 'alexisdixon6', 'atharva98']",386,"['oliviercharbonneau', 'miri23', 'ozgurkablan26', 'loisonchambers', 'tuberkargan_97', 'pranjal3', 'musabmalek0717', 'nadanasser1199', 'siemprewowthechami', 'staceyn2', 'vblanco.nico', 'abbesalaeddine', 'efrenhub', 'isabelmaria.vazquez', 'ahmedamr', 'shorouk_ossama', 'rikardberger', 'rahimnoorj', 'janeneil88', 'guttsfulltyagi', 'mjgebara14', 'kartal', 'gabrielyii99', 'aboone06', 'saegner2', 'manuelsomoza94', 'amani12345', 'youssefsherif22', 'j.haliburton', 'amr_ua07', 'evrenyigit', 'tingliang', 'kirankumar94', 'ahagras13', 'njgale01', 'al4995', 'smrdafdl', 'travisc2', 'dlee145', 'stambo', 'anthonyroux', 'ryanorem', 'moh.bahaa', 'ahchehyan', 'aimanadnan', 'veronica.mieites', 's_coriolis', 'trkmengkay', 'cbecker413', 'mcruces.fz', 'latecnologiameodia', 'gxiao2', 'emilechouinard', 'je_guilbert', 'yubai', 'sinasigurpinar', 'lauragdevesa', 'muvafikmelikkaya', 'kason.carroll', 'jbaggie2019', 'annahaozheng0606', 'jtorres17', 'ahmedayman2370', 'zikrizaki88995', 'yjenyiee155', '46harunakgul', 'alifzulkifli99', 'kaitlinh', 'tyy233', 'sdehoyos47', 'malgaca', 'lsleed', 'khazanv2', 'gc_1', 'jinsup2', 'rishu', 'amparo.castro.96', 'tbryan', 'martin32', 'michael.mechelay', 'akash140410107098', 'nowapoca', 'onaam8', 'pablosaavedra', 'camilolcastro97', 'khor', 'ankit6257', 'samashraf1', 'benoiturcotte', 'aishu98', 'rileyroca', 'david.peral.moran', 'kiruthikaabalu181996', 'taymacnichols', 'dhodapp', 'nagihankececi', 'carlosvigo1997', 'moh.ashraf105', 'baleko12345', 'ikhbal', 'afeefz', 'kaustubh.shirpurkar', 'kie180031', 'bflores18', 'tdubnansky6', 'jorgecastelo5', 'andreadiazgar', 'david2397', 'bcperki2', 'melaniejkramer', 'rkchapman', 'jn1404', 'mateocampos', 'jzhan142', 'josepazmartin', 'brannon44', 'adfoz', 'avw2', 'youxing0309', 'scremin', 'lderemo', 'perezsarmar', 'ashutoshsinghhenry6', 'melroy_caeiro', 'viratbhatt007', 'fkl217', 'coderko3', 'alimatama', 'ammaralaa516', 'nadhnasorudin', 'adarsh123', 'jacquelinethardin', 'mjoza2', 'nihatyavuz', 'estebanrial', 'jinwoo2', 'adnanyuceer', 'danielfernandezcalo', 'berkaydean', 'cloudyoverhead', 'fred_dion', 'syedzakwan', 'e1150590', 'fcfrancapra94', 'amiruldanial99', 'ozbunar01', 'alecorti.pardo', 'electronica18', 'nourananwar123', 'olivier.gilbert.paquet', 'anibarseghyan', 'amlibrahim', 'neuroque', 'kychui2', 'shaf31', 'hong_gao', 'paul.aniruddha', 'carlosbesadaromero', 'mohaballam', 'pip29', 'apb5472', 'tuberkargan', 'hafizmokh99', 'javierisma98', 'fathy1104', 'corredoira', 'helenalecoq97', 'kimzihuang', 'muteki', 'masitadonmez', 'nadja1', 'dancastaneda', 'ahmedsameh1698', 'rocio', 'mallen22', 'ffazul64', 'guoyao', 'ari6nd', 'kerryreto', 'pedrosiaba', 'michaelsaldana1', 'omarmagdy', 'vickytubio', 'ericrobles', 'soccadelic44', 'selena', 'aasifhameed99', 'damlakubattt', 'anxovidal8', 'exjamil', 'jahnavikachhia', 'joker632455', 'vincentpainchaud.vp', 'svo4321', 'zhixin2', 'yansi', 'asyrafaqil', 'xyz11', 'virajput299', 'ryanboucher', 'jpmcgee98', 'mariz', 'bhliu97', 'amrebrahim', 'abdulrahim2905', 'c.a.stupka', 'tonybocadillosgrandes', 'talwren', 'rxtodd', 'farah26', 'tss3', 'abieday1704', 'mavanzato0418', 'facundovia', 'cristinacigarran', 'nazimmath3', 'baohl2', 'ales.gajdacz', 'kie180028', 'wahidiah52', 'kyang37', 'arifjalani99', 'lino13', 'jaimefookinlannister', 'physquig', 'adriancheah', 'jarodm2', 'noureldin1999', 'michael2010814', 'ckim123', 'eddin21', 'jipiccardi', 'prabuddha_888253127', 'david_atef', 'kalebhilde', 'magic_ocean99', 'saipraneett', 'sanchjai', 'omardeyaa', 'pingan99', 'aaq', 'alidsjt', 'mengkem2', 'haclarke', 'oishikfaruque', 'ilou', 'aengm', 'janalorenzolumbreras', 'hilisa', 'carlosvillar54', 'vikazvereva', 'm939454', 'va844', 'pablobou4', 'ludovick.begin', 'maniphysics09', 'eduard25252598', 'apascao', 'xosegq16', 'adam562', 'lauramolinosmayo', 'amni99', 'kie180702', 'saharoaf', 'redzuan11', 'ypp200', 'kph2', 'martinzapata', 'kirolosehab99', 'restep2', 'seifhabib', 'maramtarek53', 'zehuahe2', 'azizijazam11', 'marcosanllo', 'aimansyaz99', 'elizametias12', 'juanmacano97', 'sparshagarwal1009', 'prakharbhargava0', 'njs035', 'alberfn', 'ramy_maged4', 'hmoulvi1', 'vanesagarcia', 'hf4', 'wowmuchchuck', 'mohammedemadeldin2000', 'gabrielyii', 'keerthisv', 'pythagoras2', 'xunyong', 'irenehb92', 'shradhap', 'mohameeddsamy', 'marianne.gratton.1', 'marcmagdy98', 'brknshn', 'gemma', 'lukunze1', 'caglanlee', 'desmondsoon', 'sebasket14', 'masonpb2', 'youssef2042000', 'retty8', 'bharath3', 'syin4', 'ethanmorse', 'ematson5897', 'jacobzeshleman', 'leejq', 'harshini9962', 'reemali99_', 'xxlilmontysignxx', 'ramonruiz.infor', 'ahern0722', 'hishamzakaria20', 'cheokonn', 'adriangarea', 'jeanmichael.deschenes', 'samet1231234', 'mr4425', 'bluelobster', 'justin.lariviere.25', 'dcpang2', 'felivitullo87', 'puertarcd', 'farahsamir978', 'akozych2', 'nbs691', 'kie180073', 'anwar909', 'bleuminuit', 'atx203', 'kanet1234', 'sealseal', 'emrebuyukkose2', 'arrow823', 'dhvanil', 'nuanno97', 'dkshelat', 'mohabayman', 'ranasherif65', 'diamond92', 'ugur.cankaya.3718', 'ammareltalli', 'acn562', 'nabilah1403', 'yaseminablacandir', 'tamchouweng', 'ablahsaoud', 'sriharshap', 'mrefaat', 'bassamtarek', 'hamidausat', 'kakmeera1999', 'teoster50', 'nolmos96', 'abdurrahmn13', 'mmartinezsanchez', 'sandrabashara', 'zakhwan7', 'chengweiheng', 'nikalyaamani', 'acregodean', 'happyleexin', 'sarapl', 'williammitchell5818', 'rooban11', 'yeejou990318', 'kowjiajin', 'nihaosawaddee', 'maxernest', 'david.garrido', 'guibill10', 'mohamedsameh', 'spazos7', 'tmi211', 'kie180039', 'worldlineusaf', 'mgk816', 'kie180079', 'ledicia97', 'movi205', 'shuming2']",5,"['nayanpatel98', 'jairgnzlz1698', 'adhityaven', 'valeria.delgadorusso', None]",396,"['oliviercharbonneau', 'miri23', 'ozgurkablan26', 'loisonchambers', 'tuberkargan_97', 'pranjal3', 'musabmalek0717', 'nadanasser1199', 'siemprewowthechami', 'staceyn2', 'vblanco.nico', 'abbesalaeddine', 'efrenhub', 'isabelmaria.vazquez', 'ahmedamr', 'shorouk_ossama', 'rikardberger', 'alancantu57', 'luciano.brignone', 'rahimnoorj', 'janeneil88', 'guttsfulltyagi', 'mjgebara14', 'kartal', 'gabrielyii99', 'aboone06', 'saegner2', 'manuelsomoza94', 'amani12345', 'youssefsherif22', 'j.haliburton', 'amr_ua07', 'evrenyigit', 'tingliang', 'kirankumar94', 'ahagras13', 'njgale01', 'al4995', 'smrdafdl', 'travisc2', 'dlee145', 'stambo', 'anthonyroux', 'ryanorem', 'moh.bahaa', 'ahchehyan', 'aimanadnan', 'veronica.mieites', 's_coriolis', 'trkmengkay', 'cbecker413', 'mcruces.fz', 'latecnologiameodia', 'gxiao2', 'emilechouinard', 'je_guilbert', 'yubai', 'sinasigurpinar', 'lauragdevesa', 'muvafikmelikkaya', 'kason.carroll', 'jbaggie2019', 'annahaozheng0606', 'jtorres17', 'ahmedayman2370', 'zikrizaki88995', 'yjenyiee155', 'nayanpatel98', '46harunakgul', 'alifzulkifli99', 'kaitlinh', 'tyy233', 'sdehoyos47', 'malgaca', 'lsleed', 'khazanv2', 'alexisdixon6', 'gc_1', 'jinsup2', 'rishu', 'amparo.castro.96', 'tbryan', 'martin32', 'michael.mechelay', 'akash140410107098', 'nowapoca', 'onaam8', 'pablosaavedra', 'camilolcastro97', 'khor', 'ankit6257', 'samashraf1', 'benoiturcotte', 'aishu98', 'rileyroca', 'david.peral.moran', 'kiruthikaabalu181996', 'taymacnichols', 'dhodapp', 'nagihankececi', 'carlosvigo1997', 'moh.ashraf105', 'baleko12345', 'ikhbal', 'afeefz', 'kaustubh.shirpurkar', 'kie180031', 'bflores18', 'tdubnansky6', 'jorgecastelo5', 'andreadiazgar', 'david2397', 'bcperki2', 'melaniejkramer', 'rkchapman', 'adhityaven', 'jn1404', 'mateocampos', 'jzhan142', 'josepazmartin', 'brannon44', 'adfoz', 'avw2', 'youxing0309', 'scremin', 'lderemo', 'perezsarmar', 'ashutoshsinghhenry6', 'melroy_caeiro', 'viratbhatt007', 'fkl217', 'coderko3', 'alimatama', 'ammaralaa516', 'nadhnasorudin', 'adarsh123', 'jacquelinethardin', 'mjoza2', 'nihatyavuz', 'estebanrial', 'jinwoo2', 'adnanyuceer', 'danielfernandezcalo', 'berkaydean', 'cloudyoverhead', 'fred_dion', 'syedzakwan', 'e1150590', 'fcfrancapra94', 'amiruldanial99', 'ozbunar01', 'alecorti.pardo', 'electronica18', 'nourananwar123', 'olivier.gilbert.paquet', 'anibarseghyan', 'amlibrahim', 'neuroque', 'kychui2', 'shaf31', 'hong_gao', 'paul.aniruddha', 'carlosbesadaromero', 'mohaballam', 'pip29', 'apb5472', 'tuberkargan', 'hafizmokh99', 'javierisma98', 'fathy1104', 'corredoira', 'helenalecoq97', 'kimzihuang', 'muteki', 'masitadonmez', 'nadja1', 'dancastaneda', 'ahmedsameh1698', 'rocio', 'mallen22', 'ffazul64', 'guoyao', 'ari6nd', 'kerryreto', 'pedrosiaba', 'michaelsaldana1', 'omarmagdy', 'vickytubio', 'ericrobles', 'soccadelic44', 'selena', 'aasifhameed99', 'damlakubattt', 'anxovidal8', 'exjamil', 'jahnavikachhia', 'joker632455', 'vincentpainchaud.vp', 'svo4321', 'zhixin2', 'yansi', 'asyrafaqil', 'xyz11', 'virajput299', 'ryanboucher', 'jpmcgee98', 'mariz', 'bhliu97', 'amrebrahim', 'abdulrahim2905', 'c.a.stupka', 'tonybocadillosgrandes', 'talwren', 'rxtodd', 'farah26', 'tss3', 'abieday1704', 'mavanzato0418', 'facundovia', 'cristinacigarran', 'nazimmath3', 'baohl2', 'ales.gajdacz', 'elad.d', 'kie180028', 'wahidiah52', 'kyang37', 'arifjalani99', 'lino13', 'jaimefookinlannister', 'physquig', 'adriancheah', 'jarodm2', 'noureldin1999', 'michael2010814', 'ckim123', 'eddin21', 'jipiccardi', 'prabuddha_888253127', 'david_atef', 'kalebhilde', 'magic_ocean99', 'saipraneett', 'sanchjai', 'omardeyaa', 'pingan99', 'aaq', 'alidsjt', 'mengkem2', 'haclarke', 'oishikfaruque', 'ilou', 'aengm', 'janalorenzolumbreras', 'hilisa', 'carlosvillar54', 'valeria.delgadorusso', 'vikazvereva', 'm939454', 'va844', 'pablobou4', 'ludovick.begin', 'maniphysics09', 'eduard25252598', 'apascao', 'xosegq16', 'adam562', 'lauramolinosmayo', 'amni99', 'kie180702', 'saharoaf', 'redzuan11', 'ypp200', 'kph2', 'martinzapata', 'kirolosehab99', 'restep2', 'seifhabib', 'maramtarek53', 'jairgnzlz1698', 'zehuahe2', 'azizijazam11', 'marcosanllo', 'aimansyaz99', 'elizametias12', 'juanmacano97', 'sparshagarwal1009', 'prakharbhargava0', 'njs035', 'alberfn', 'ramy_maged4', 'hmoulvi1', 'vanesagarcia', 'hf4', 'wowmuchchuck', 'mohammedemadeldin2000', 'gabrielyii', 'keerthisv', 'pythagoras2', 'xunyong', 'irenehb92', 'shradhap', 'mohameeddsamy', 'marianne.gratton.1', 'marcmagdy98', 'brknshn', 'gemma', 'lukunze1', 'caglanlee', 'desmondsoon', 'sebasket14', 'masonpb2', 'youssef2042000', 'retty8', 'bharath3', 'syin4', 'ethanmorse', 'ematson5897', 'jacobzeshleman', 'leejq', 'harshini9962', 'reemali99_', 'xxlilmontysignxx', 'ramonruiz.infor', 'atharva98', 'ahern0722', 'hishamzakaria20', 'cheokonn', 'adriangarea', 'jeanmichael.deschenes', 'samet1231234', 'mr4425', 'bluelobster', 'justin.lariviere.25', 'dcpang2', 'felivitullo87', 'puertarcd', 'farahsamir978', 'akozych2', 'nbs691', 'kie180073', 'anwar909', 'bleuminuit', 'atx203', 'kanet1234', 'sealseal', 'emrebuyukkose2', 'arrow823', 'dhvanil', 'nuanno97', 'dkshelat', 'mohabayman', 'ranasherif65', 'diamond92', 'ugur.cankaya.3718', 'ammareltalli', 'acn562', 'nabilah1403', 'yaseminablacandir', 'tamchouweng', 'ablahsaoud', 'sriharshap', 'mrefaat', 'bassamtarek', 'hamidausat', 'kakmeera1999', 'teoster50', 'nolmos96', 'abdurrahmn13', 'mmartinezsanchez', 'sandrabashara', 'zakhwan7', 'chengweiheng', 'nikalyaamani', 'acregodean', 'happyleexin', 'sarapl', 'williammitchell5818', None, 'rooban11', 'yeejou990318', 'kowjiajin', 'nihaosawaddee', 'maxernest', 'david.garrido', 'guibill10', 'mohamedsameh', 'spazos7', 'tmi211', 'kie180039', 'worldlineusaf', 'mgk816', 'kie180079', 'ledicia97', 'movi205', 'shuming2']"
1,83,391,10,5,"['elad.d', 'alancantu57', 'luciano.brignone', 'alexisdixon6', 'atharva98']",386,"['oliviercharbonneau', 'miri23', 'ozgurkablan26', 'loisonchambers', 'tuberkargan_97', 'pranjal3', 'musabmalek0717', 'nadanasser1199', 'siemprewowthechami', 'staceyn2', 'vblanco.nico', 'abbesalaeddine', 'efrenhub', 'isabelmaria.vazquez', 'ahmedamr', 'shorouk_ossama', 'rikardberger', 'rahimnoorj', 'janeneil88', 'guttsfulltyagi', 'mjgebara14', 'kartal', 'gabrielyii99', 'aboone06', 'saegner2', 'manuelsomoza94', 'amani12345', 'youssefsherif22', 'j.haliburton', 'amr_ua07', 'evrenyigit', 'tingliang', 'kirankumar94', 'ahagras13', 'njgale01', 'al4995', 'smrdafdl', 'travisc2', 'dlee145', 'stambo', 'anthonyroux', 'ryanorem', 'moh.bahaa', 'ahchehyan', 'aimanadnan', 'veronica.mieites', 's_coriolis', 'trkmengkay', 'cbecker413', 'mcruces.fz', 'latecnologiameodia', 'gxiao2', 'emilechouinard', 'je_guilbert', 'yubai', 'sinasigurpinar', 'lauragdevesa', 'muvafikmelikkaya', 'kason.carroll', 'jbaggie2019', 'annahaozheng0606', 'jtorres17', 'ahmedayman2370', 'zikrizaki88995', 'yjenyiee155', '46harunakgul', 'alifzulkifli99', 'kaitlinh', 'tyy233', 'sdehoyos47', 'malgaca', 'lsleed', 'khazanv2', 'gc_1', 'jinsup2', 'rishu', 'amparo.castro.96', 'tbryan', 'martin32', 'michael.mechelay', 'akash140410107098', 'nowapoca', 'onaam8', 'pablosaavedra', 'camilolcastro97', 'khor', 'ankit6257', 'samashraf1', 'benoiturcotte', 'aishu98', 'rileyroca', 'david.peral.moran', 'kiruthikaabalu181996', 'taymacnichols', 'dhodapp', 'nagihankececi', 'carlosvigo1997', 'moh.ashraf105', 'baleko12345', 'ikhbal', 'afeefz', 'kaustubh.shirpurkar', 'kie180031', 'bflores18', 'tdubnansky6', 'jorgecastelo5', 'andreadiazgar', 'david2397', 'bcperki2', 'melaniejkramer', 'rkchapman', 'jn1404', 'mateocampos', 'jzhan142', 'josepazmartin', 'brannon44', 'adfoz', 'avw2', 'youxing0309', 'scremin', 'lderemo', 'perezsarmar', 'ashutoshsinghhenry6', 'melroy_caeiro', 'viratbhatt007', 'fkl217', 'coderko3', 'alimatama', 'ammaralaa516', 'nadhnasorudin', 'adarsh123', 'jacquelinethardin', 'mjoza2', 'nihatyavuz', 'estebanrial', 'jinwoo2', 'adnanyuceer', 'danielfernandezcalo', 'berkaydean', 'cloudyoverhead', 'fred_dion', 'syedzakwan', 'e1150590', 'fcfrancapra94', 'amiruldanial99', 'ozbunar01', 'alecorti.pardo', 'electronica18', 'nourananwar123', 'olivier.gilbert.paquet', 'anibarseghyan', 'amlibrahim', 'neuroque', 'kychui2', 'shaf31', 'hong_gao', 'paul.aniruddha', 'carlosbesadaromero', 'mohaballam', 'pip29', 'apb5472', 'tuberkargan', 'hafizmokh99', 'javierisma98', 'fathy1104', 'corredoira', 'helenalecoq97', 'kimzihuang', 'muteki', 'masitadonmez', 'nadja1', 'dancastaneda', 'ahmedsameh1698', 'rocio', 'mallen22', 'ffazul64', 'guoyao', 'ari6nd', 'kerryreto', 'pedrosiaba', 'michaelsaldana1', 'omarmagdy', 'vickytubio', 'ericrobles', 'soccadelic44', 'selena', 'aasifhameed99', 'damlakubattt', 'anxovidal8', 'exjamil', 'jahnavikachhia', 'joker632455', 'vincentpainchaud.vp', 'svo4321', 'zhixin2', 'yansi', 'asyrafaqil', 'xyz11', 'virajput299', 'ryanboucher', 'jpmcgee98', 'mariz', 'bhliu97', 'amrebrahim', 'abdulrahim2905', 'c.a.stupka', 'tonybocadillosgrandes', 'talwren', 'rxtodd', 'farah26', 'tss3', 'abieday1704', 'mavanzato0418', 'facundovia', 'cristinacigarran', 'nazimmath3', 'baohl2', 'ales.gajdacz', 'kie180028', 'wahidiah52', 'kyang37', 'arifjalani99', 'lino13', 'jaimefookinlannister', 'physquig', 'adriancheah', 'jarodm2', 'noureldin1999', 'michael2010814', 'ckim123', 'eddin21', 'jipiccardi', 'prabuddha_888253127', 'david_atef', 'kalebhilde', 'magic_ocean99', 'saipraneett', 'sanchjai', 'omardeyaa', 'pingan99', 'aaq', 'alidsjt', 'mengkem2', 'haclarke', 'oishikfaruque', 'ilou', 'aengm', 'janalorenzolumbreras', 'hilisa', 'carlosvillar54', 'vikazvereva', 'm939454', 'va844', 'pablobou4', 'ludovick.begin', 'maniphysics09', 'eduard25252598', 'apascao', 'xosegq16', 'adam562', 'lauramolinosmayo', 'amni99', 'kie180702', 'saharoaf', 'redzuan11', 'ypp200', 'kph2', 'martinzapata', 'kirolosehab99', 'restep2', 'seifhabib', 'maramtarek53', 'zehuahe2', 'azizijazam11', 'marcosanllo', 'aimansyaz99', 'elizametias12', 'juanmacano97', 'sparshagarwal1009', 'prakharbhargava0', 'njs035', 'alberfn', 'ramy_maged4', 'hmoulvi1', 'vanesagarcia', 'hf4', 'wowmuchchuck', 'mohammedemadeldin2000', 'gabrielyii', 'keerthisv', 'pythagoras2', 'xunyong', 'irenehb92', 'shradhap', 'mohameeddsamy', 'marianne.gratton.1', 'marcmagdy98', 'brknshn', 'gemma', 'lukunze1', 'caglanlee', 'desmondsoon', 'sebasket14', 'masonpb2', 'youssef2042000', 'retty8', 'bharath3', 'syin4', 'ethanmorse', 'ematson5897', 'jacobzeshleman', 'leejq', 'harshini9962', 'reemali99_', 'xxlilmontysignxx', 'ramonruiz.infor', 'ahern0722', 'hishamzakaria20', 'cheokonn', 'adriangarea', 'jeanmichael.deschenes', 'samet1231234', 'mr4425', 'bluelobster', 'justin.lariviere.25', 'dcpang2', 'felivitullo87', 'puertarcd', 'farahsamir978', 'akozych2', 'nbs691', 'kie180073', 'anwar909', 'bleuminuit', 'atx203', 'kanet1234', 'sealseal', 'emrebuyukkose2', 'arrow823', 'dhvanil', 'nuanno97', 'dkshelat', 'mohabayman', 'ranasherif65', 'diamond92', 'ugur.cankaya.3718', 'ammareltalli', 'acn562', 'nabilah1403', 'yaseminablacandir', 'tamchouweng', 'ablahsaoud', 'sriharshap', 'mrefaat', 'bassamtarek', 'hamidausat', 'kakmeera1999', 'teoster50', 'nolmos96', 'abdurrahmn13', 'mmartinezsanchez', 'sandrabashara', 'zakhwan7', 'chengweiheng', 'nikalyaamani', 'acregodean', 'happyleexin', 'sarapl', 'williammitchell5818', 'rooban11', 'yeejou990318', 'kowjiajin', 'nihaosawaddee', 'maxernest', 'david.garrido', 'guibill10', 'mohamedsameh', 'spazos7', 'tmi211', 'kie180039', 'worldlineusaf', 'mgk816', 'kie180079', 'ledicia97', 'movi205', 'shuming2']",5,"['nayanpatel98', 'jairgnzlz1698', 'adhityaven', 'valeria.delgadorusso', None]",396,"['oliviercharbonneau', 'miri23', 'ozgurkablan26', 'loisonchambers', 'tuberkargan_97', 'pranjal3', 'musabmalek0717', 'nadanasser1199', 'siemprewowthechami', 'staceyn2', 'vblanco.nico', 'abbesalaeddine', 'efrenhub', 'isabelmaria.vazquez', 'ahmedamr', 'shorouk_ossama', 'rikardberger', 'alancantu57', 'luciano.brignone', 'rahimnoorj', 'janeneil88', 'guttsfulltyagi', 'mjgebara14', 'kartal', 'gabrielyii99', 'aboone06', 'saegner2', 'manuelsomoza94', 'amani12345', 'youssefsherif22', 'j.haliburton', 'amr_ua07', 'evrenyigit', 'tingliang', 'kirankumar94', 'ahagras13', 'njgale01', 'al4995', 'smrdafdl', 'travisc2', 'dlee145', 'stambo', 'anthonyroux', 'ryanorem', 'moh.bahaa', 'ahchehyan', 'aimanadnan', 'veronica.mieites', 's_coriolis', 'trkmengkay', 'cbecker413', 'mcruces.fz', 'latecnologiameodia', 'gxiao2', 'emilechouinard', 'je_guilbert', 'yubai', 'sinasigurpinar', 'lauragdevesa', 'muvafikmelikkaya', 'kason.carroll', 'jbaggie2019', 'annahaozheng0606', 'jtorres17', 'ahmedayman2370', 'zikrizaki88995', 'yjenyiee155', 'nayanpatel98', '46harunakgul', 'alifzulkifli99', 'kaitlinh', 'tyy233', 'sdehoyos47', 'malgaca', 'lsleed', 'khazanv2', 'alexisdixon6', 'gc_1', 'jinsup2', 'rishu', 'amparo.castro.96', 'tbryan', 'martin32', 'michael.mechelay', 'akash140410107098', 'nowapoca', 'onaam8', 'pablosaavedra', 'camilolcastro97', 'khor', 'ankit6257', 'samashraf1', 'benoiturcotte', 'aishu98', 'rileyroca', 'david.peral.moran', 'kiruthikaabalu181996', 'taymacnichols', 'dhodapp', 'nagihankececi', 'carlosvigo1997', 'moh.ashraf105', 'baleko12345', 'ikhbal', 'afeefz', 'kaustubh.shirpurkar', 'kie180031', 'bflores18', 'tdubnansky6', 'jorgecastelo5', 'andreadiazgar', 'david2397', 'bcperki2', 'melaniejkramer', 'rkchapman', 'adhityaven', 'jn1404', 'mateocampos', 'jzhan142', 'josepazmartin', 'brannon44', 'adfoz', 'avw2', 'youxing0309', 'scremin', 'lderemo', 'perezsarmar', 'ashutoshsinghhenry6', 'melroy_caeiro', 'viratbhatt007', 'fkl217', 'coderko3', 'alimatama', 'ammaralaa516', 'nadhnasorudin', 'adarsh123', 'jacquelinethardin', 'mjoza2', 'nihatyavuz', 'estebanrial', 'jinwoo2', 'adnanyuceer', 'danielfernandezcalo', 'berkaydean', 'cloudyoverhead', 'fred_dion', 'syedzakwan', 'e1150590', 'fcfrancapra94', 'amiruldanial99', 'ozbunar01', 'alecorti.pardo', 'electronica18', 'nourananwar123', 'olivier.gilbert.paquet', 'anibarseghyan', 'amlibrahim', 'neuroque', 'kychui2', 'shaf31', 'hong_gao', 'paul.aniruddha', 'carlosbesadaromero', 'mohaballam', 'pip29', 'apb5472', 'tuberkargan', 'hafizmokh99', 'javierisma98', 'fathy1104', 'corredoira', 'helenalecoq97', 'kimzihuang', 'muteki', 'masitadonmez', 'nadja1', 'dancastaneda', 'ahmedsameh1698', 'rocio', 'mallen22', 'ffazul64', 'guoyao', 'ari6nd', 'kerryreto', 'pedrosiaba', 'michaelsaldana1', 'omarmagdy', 'vickytubio', 'ericrobles', 'soccadelic44', 'selena', 'aasifhameed99', 'damlakubattt', 'anxovidal8', 'exjamil', 'jahnavikachhia', 'joker632455', 'vincentpainchaud.vp', 'svo4321', 'zhixin2', 'yansi', 'asyrafaqil', 'xyz11', 'virajput299', 'ryanboucher', 'jpmcgee98', 'mariz', 'bhliu97', 'amrebrahim', 'abdulrahim2905', 'c.a.stupka', 'tonybocadillosgrandes', 'talwren', 'rxtodd', 'farah26', 'tss3', 'abieday1704', 'mavanzato0418', 'facundovia', 'cristinacigarran', 'nazimmath3', 'baohl2', 'ales.gajdacz', 'elad.d', 'kie180028', 'wahidiah52', 'kyang37', 'arifjalani99', 'lino13', 'jaimefookinlannister', 'physquig', 'adriancheah', 'jarodm2', 'noureldin1999', 'michael2010814', 'ckim123', 'eddin21', 'jipiccardi', 'prabuddha_888253127', 'david_atef', 'kalebhilde', 'magic_ocean99', 'saipraneett', 'sanchjai', 'omardeyaa', 'pingan99', 'aaq', 'alidsjt', 'mengkem2', 'haclarke', 'oishikfaruque', 'ilou', 'aengm', 'janalorenzolumbreras', 'hilisa', 'carlosvillar54', 'valeria.delgadorusso', 'vikazvereva', 'm939454', 'va844', 'pablobou4', 'ludovick.begin', 'maniphysics09', 'eduard25252598', 'apascao', 'xosegq16', 'adam562', 'lauramolinosmayo', 'amni99', 'kie180702', 'saharoaf', 'redzuan11', 'ypp200', 'kph2', 'martinzapata', 'kirolosehab99', 'restep2', 'seifhabib', 'maramtarek53', 'jairgnzlz1698', 'zehuahe2', 'azizijazam11', 'marcosanllo', 'aimansyaz99', 'elizametias12', 'juanmacano97', 'sparshagarwal1009', 'prakharbhargava0', 'njs035', 'alberfn', 'ramy_maged4', 'hmoulvi1', 'vanesagarcia', 'hf4', 'wowmuchchuck', 'mohammedemadeldin2000', 'gabrielyii', 'keerthisv', 'pythagoras2', 'xunyong', 'irenehb92', 'shradhap', 'mohameeddsamy', 'marianne.gratton.1', 'marcmagdy98', 'brknshn', 'gemma', 'lukunze1', 'caglanlee', 'desmondsoon', 'sebasket14', 'masonpb2', 'youssef2042000', 'retty8', 'bharath3', 'syin4', 'ethanmorse', 'ematson5897', 'jacobzeshleman', 'leejq', 'harshini9962', 'reemali99_', 'xxlilmontysignxx', 'ramonruiz.infor', 'atharva98', 'ahern0722', 'hishamzakaria20', 'cheokonn', 'adriangarea', 'jeanmichael.deschenes', 'samet1231234', 'mr4425', 'bluelobster', 'justin.lariviere.25', 'dcpang2', 'felivitullo87', 'puertarcd', 'farahsamir978', 'akozych2', 'nbs691', 'kie180073', 'anwar909', 'bleuminuit', 'atx203', 'kanet1234', 'sealseal', 'emrebuyukkose2', 'arrow823', 'dhvanil', 'nuanno97', 'dkshelat', 'mohabayman', 'ranasherif65', 'diamond92', 'ugur.cankaya.3718', 'ammareltalli', 'acn562', 'nabilah1403', 'yaseminablacandir', 'tamchouweng', 'ablahsaoud', 'sriharshap', 'mrefaat', 'bassamtarek', 'hamidausat', 'kakmeera1999', 'teoster50', 'nolmos96', 'abdurrahmn13', 'mmartinezsanchez', 'sandrabashara', 'zakhwan7', 'chengweiheng', 'nikalyaamani', 'acregodean', 'happyleexin', 'sarapl', 'williammitchell5818', None, 'rooban11', 'yeejou990318', 'kowjiajin', 'nihaosawaddee', 'maxernest', 'david.garrido', 'guibill10', 'mohamedsameh', 'spazos7', 'tmi211', 'kie180039', 'worldlineusaf', 'mgk816', 'kie180079', 'ledicia97', 'movi205', 'shuming2']"
1,39,391,9,7,"['guoyao', 'aimansyaz99', 'eddin21', 'janeneil88', 'youxing0309', 'kie180079', 'pip29']",384,"['oliviercharbonneau', 'miri23', 'ozgurkablan26', 'loisonchambers', 'tuberkargan_97', 'pranjal3', 'musabmalek0717', 'nadanasser1199', 'siemprewowthechami', 'staceyn2', 'vblanco.nico', 'abbesalaeddine', 'efrenhub', 'isabelmaria.vazquez', 'ahmedamr', 'shorouk_ossama', 'rikardberger', 'alancantu57', 'luciano.brignone', 'rahimnoorj', 'guttsfulltyagi', 'mjgebara14', 'kartal', 'gabrielyii99', 'aboone06', 'saegner2', 'manuelsomoza94', 'amani12345', 'youssefsherif22', 'j.haliburton', 'amr_ua07', 'evrenyigit', 'tingliang', 'kirankumar94', 'ahagras13', 'njgale01', 'al4995', 'smrdafdl', 'travisc2', 'dlee145', 'stambo', 'anthonyroux', 'ryanorem', 'moh.bahaa', 'ahchehyan', 'aimanadnan', 'veronica.mieites', 's_coriolis', 'trkmengkay', 'cbecker413', 'mcruces.fz', 'latecnologiameodia', 'gxiao2', 'emilechouinard', 'je_guilbert', 'yubai', 'sinasigurpinar', 'lauragdevesa', 'muvafikmelikkaya', 'kason.carroll', 'jbaggie2019', 'annahaozheng0606', 'jtorres17', 'ahmedayman2370', 'zikrizaki88995', 'yjenyiee155', '46harunakgul', 'alifzulkifli99', 'kaitlinh', 'tyy233', 'sdehoyos47', 'malgaca', 'lsleed', 'khazanv2', 'alexisdixon6', 'gc_1', 'jinsup2', 'rishu', 'amparo.castro.96', 'tbryan', 'martin32', 'michael.mechelay', 'akash140410107098', 'nowapoca', 'onaam8', 'pablosaavedra', 'camilolcastro97', 'khor', 'ankit6257', 'samashraf1', 'benoiturcotte', 'aishu98', 'rileyroca', 'david.peral.moran', 'kiruthikaabalu181996', 'taymacnichols', 'dhodapp', 'nagihankececi', 'carlosvigo1997', 'moh.ashraf105', 'baleko12345', 'ikhbal', 'afeefz', 'kaustubh.shirpurkar', 'kie180031', 'bflores18', 'tdubnansky6', 'jorgecastelo5', 'andreadiazgar', 'david2397', 'bcperki2', 'melaniejkramer', 'rkchapman', 'jn1404', 'mateocampos', 'jzhan142', 'josepazmartin', 'brannon44', 'adfoz', 'avw2', 'scremin', 'lderemo', 'perezsarmar', 'ashutoshsinghhenry6', 'melroy_caeiro', 'viratbhatt007', 'fkl217', 'coderko3', 'alimatama', 'ammaralaa516', 'nadhnasorudin', 'adarsh123', 'jacquelinethardin', 'mjoza2', 'nihatyavuz', 'estebanrial', 'jinwoo2', 'adnanyuceer', 'danielfernandezcalo', 'berkaydean', 'cloudyoverhead', 'fred_dion', 'syedzakwan', 'e1150590', 'fcfrancapra94', 'amiruldanial99', 'ozbunar01', 'alecorti.pardo', 'electronica18', 'nourananwar123', 'olivier.gilbert.paquet', 'anibarseghyan', 'amlibrahim', 'neuroque', 'kychui2', 'shaf31', 'hong_gao', 'paul.aniruddha', 'carlosbesadaromero', 'mohaballam', 'apb5472', 'tuberkargan', 'hafizmokh99', 'javierisma98', 'fathy1104', 'corredoira', 'helenalecoq97', 'kimzihuang', 'muteki', 'masitadonmez', 'nadja1', 'dancastaneda', 'ahmedsameh1698', 'rocio', 'mallen22', 'ffazul64', 'ari6nd', 'kerryreto', 'pedrosiaba', 'michaelsaldana1', 'omarmagdy', 'vickytubio', 'ericrobles', 'soccadelic44', 'selena', 'aasifhameed99', 'damlakubattt', 'anxovidal8', 'exjamil', 'jahnavikachhia', 'joker632455', 'vincentpainchaud.vp', 'svo4321', 'zhixin2', 'yansi', 'asyrafaqil', 'xyz11', 'virajput299', 'ryanboucher', 'jpmcgee98', 'mariz', 'bhliu97', 'amrebrahim', 'abdulrahim2905', 'c.a.stupka', 'tonybocadillosgrandes', 'talwren', 'rxtodd', 'farah26', 'tss3', 'abieday1704', 'mavanzato0418', 'facundovia', 'cristinacigarran', 'nazimmath3', 'baohl2', 'ales.gajdacz', 'elad.d', 'kie180028', 'wahidiah52', 'kyang37', 'arifjalani99', 'lino13', 'jaimefookinlannister', 'physquig', 'adriancheah', 'jarodm2', 'noureldin1999', 'michael2010814', 'ckim123', 'jipiccardi', 'prabuddha_888253127', 'david_atef', 'kalebhilde', 'magic_ocean99', 'saipraneett', 'sanchjai', 'omardeyaa', 'pingan99', 'aaq', 'alidsjt', 'mengkem2', 'haclarke', 'oishikfaruque', 'ilou', 'aengm', 'janalorenzolumbreras', 'hilisa', 'carlosvillar54', 'vikazvereva', 'm939454', 'va844', 'pablobou4', 'ludovick.begin', 'maniphysics09', 'eduard25252598', 'apascao', 'xosegq16', 'adam562', 'lauramolinosmayo', 'amni99', 'kie180702', 'saharoaf', 'redzuan11', 'ypp200', 'kph2', 'martinzapata', 'kirolosehab99', 'restep2', 'seifhabib', 'maramtarek53', 'zehuahe2', 'azizijazam11', 'marcosanllo', 'elizametias12', 'juanmacano97', 'sparshagarwal1009', 'prakharbhargava0', 'njs035', 'alberfn', 'ramy_maged4', 'hmoulvi1', 'vanesagarcia', 'hf4', 'wowmuchchuck', 'mohammedemadeldin2000', 'gabrielyii', 'keerthisv', 'pythagoras2', 'xunyong', 'irenehb92', 'shradhap', 'mohameeddsamy', 'marianne.gratton.1', 'marcmagdy98', 'brknshn', 'gemma', 'lukunze1', 'caglanlee', 'desmondsoon', 'sebasket14', 'masonpb2', 'youssef2042000', 'retty8', 'bharath3', 'syin4', 'ethanmorse', 'ematson5897', 'jacobzeshleman', 'leejq', 'harshini9962', 'reemali99_', 'xxlilmontysignxx', 'ramonruiz.infor', 'atharva98', 'ahern0722', 'hishamzakaria20', 'cheokonn', 'adriangarea', 'jeanmichael.deschenes', 'samet1231234', 'mr4425', 'bluelobster', 'justin.lariviere.25', 'dcpang2', 'felivitullo87', 'puertarcd', 'farahsamir978', 'akozych2', 'nbs691', 'kie180073', 'anwar909', 'bleuminuit', 'atx203', 'kanet1234', 'sealseal', 'emrebuyukkose2', 'arrow823', 'dhvanil', 'nuanno97', 'dkshelat', 'mohabayman', 'ranasherif65', 'diamond92', 'ugur.cankaya.3718', 'ammareltalli', 'acn562', 'nabilah1403', 'yaseminablacandir', 'tamchouweng', 'ablahsaoud', 'sriharshap', 'mrefaat', 'bassamtarek', 'hamidausat', 'kakmeera1999', 'teoster50', 'nolmos96', 'abdurrahmn13', 'mmartinezsanchez', 'sandrabashara', 'zakhwan7', 'chengweiheng', 'nikalyaamani', 'acregodean', 'happyleexin', 'sarapl', 'williammitchell5818', 'rooban11', 'yeejou990318', 'kowjiajin', 'nihaosawaddee', 'maxernest', 'david.garrido', 'guibill10', 'mohamedsameh', 'spazos7', 'tmi211', 'kie180039', 'worldlineusaf', 'mgk816', 'ledicia97', 'movi205', 'shuming2']",2,"[None, 'wafikamarudin']",393,"['oliviercharbonneau', 'miri23', 'ozgurkablan26', 'loisonchambers', 'tuberkargan_97', 'pranjal3', 'musabmalek0717', 'nadanasser1199', 'siemprewowthechami', 'staceyn2', 'vblanco.nico', 'abbesalaeddine', 'efrenhub', 'isabelmaria.vazquez', 'ahmedamr', 'shorouk_ossama', 'rikardberger', 'alancantu57', 'luciano.brignone', 'rahimnoorj', 'janeneil88', 'guttsfulltyagi', 'mjgebara14', 'kartal', 'gabrielyii99', 'aboone06', 'saegner2', 'manuelsomoza94', 'amani12345', 'youssefsherif22', 'j.haliburton', 'amr_ua07', 'evrenyigit', 'tingliang', 'kirankumar94', 'ahagras13', 'njgale01', 'al4995', 'smrdafdl', 'travisc2', 'dlee145', 'stambo', 'anthonyroux', 'ryanorem', 'moh.bahaa', 'ahchehyan', 'aimanadnan', 'veronica.mieites', 's_coriolis', 'trkmengkay', 'cbecker413', 'mcruces.fz', 'latecnologiameodia', 'gxiao2', 'emilechouinard', 'je_guilbert', 'yubai', 'sinasigurpinar', 'lauragdevesa', 'muvafikmelikkaya', 'kason.carroll', 'jbaggie2019', 'annahaozheng0606', 'jtorres17', 'ahmedayman2370', 'zikrizaki88995', 'yjenyiee155', '46harunakgul', 'alifzulkifli99', 'kaitlinh', 'tyy233', 'sdehoyos47', 'malgaca', 'lsleed', 'khazanv2', 'alexisdixon6', 'gc_1', 'jinsup2', 'rishu', 'amparo.castro.96', 'tbryan', 'martin32', 'michael.mechelay', 'akash140410107098', 'nowapoca', 'onaam8', 'pablosaavedra', 'camilolcastro97', 'khor', 'ankit6257', 'samashraf1', 'benoiturcotte', 'aishu98', 'rileyroca', 'david.peral.moran', 'kiruthikaabalu181996', 'taymacnichols', 'dhodapp', 'nagihankececi', 'carlosvigo1997', 'moh.ashraf105', 'baleko12345', 'ikhbal', 'afeefz', 'kaustubh.shirpurkar', 'kie180031', 'bflores18', 'tdubnansky6', 'jorgecastelo5', 'andreadiazgar', 'david2397', 'bcperki2', 'melaniejkramer', 'rkchapman', 'jn1404', 'mateocampos', 'jzhan142', 'josepazmartin', 'brannon44', 'adfoz', 'avw2', 'youxing0309', 'scremin', 'lderemo', 'perezsarmar', 'ashutoshsinghhenry6', 'melroy_caeiro', 'viratbhatt007', 'fkl217', 'coderko3', 'alimatama', 'ammaralaa516', 'nadhnasorudin', 'adarsh123', 'jacquelinethardin', 'mjoza2', 'nihatyavuz', 'estebanrial', 'jinwoo2', 'adnanyuceer', 'danielfernandezcalo', 'berkaydean', 'cloudyoverhead', 'fred_dion', 'syedzakwan', 'e1150590', 'fcfrancapra94', 'amiruldanial99', 'ozbunar01', 'alecorti.pardo', 'electronica18', 'wafikamarudin', 'nourananwar123', 'olivier.gilbert.paquet', 'anibarseghyan', 'amlibrahim', 'neuroque', 'kychui2', 'shaf31', 'hong_gao', 'paul.aniruddha', 'carlosbesadaromero', 'mohaballam', 'pip29', 'apb5472', 'tuberkargan', 'hafizmokh99', 'javierisma98', 'fathy1104', 'corredoira', 'helenalecoq97', 'kimzihuang', 'muteki', 'masitadonmez', 'nadja1', 'dancastaneda', 'ahmedsameh1698', 'rocio', 'mallen22', 'ffazul64', 'guoyao', 'ari6nd', 'kerryreto', 'pedrosiaba', 'michaelsaldana1', 'omarmagdy', 'vickytubio', 'ericrobles', 'soccadelic44', 'selena', 'aasifhameed99', 'damlakubattt', 'anxovidal8', 'exjamil', 'jahnavikachhia', 'joker632455', 'vincentpainchaud.vp', 'svo4321', 'zhixin2', 'yansi', 'asyrafaqil', 'xyz11', 'virajput299', 'ryanboucher', 'jpmcgee98', 'mariz', 'bhliu97', 'amrebrahim', 'abdulrahim2905', 'c.a.stupka', 'tonybocadillosgrandes', 'talwren', 'rxtodd', 'farah26', 'tss3', 'abieday1704', 'mavanzato0418', 'facundovia', 'cristinacigarran', 'nazimmath3', 'baohl2', 'ales.gajdacz', 'elad.d', 'kie180028', 'wahidiah52', 'kyang37', 'arifjalani99', 'lino13', 'jaimefookinlannister', 'physquig', 'adriancheah', 'jarodm2', 'noureldin1999', 'michael2010814', 'ckim123', 'eddin21', 'jipiccardi', 'prabuddha_888253127', 'david_atef', 'kalebhilde', 'magic_ocean99', 'saipraneett', 'sanchjai', 'omardeyaa', 'pingan99', 'aaq', 'alidsjt', 'mengkem2', 'haclarke', 'oishikfaruque', 'ilou', 'aengm', 'janalorenzolumbreras', 'hilisa', 'carlosvillar54', 'vikazvereva', 'm939454', 'va844', 'pablobou4', 'ludovick.begin', 'maniphysics09', 'eduard25252598', 'apascao', 'xosegq16', 'adam562', 'lauramolinosmayo', 'amni99', 'kie180702', 'saharoaf', 'redzuan11', 'ypp200', 'kph2', 'martinzapata', 'kirolosehab99', 'restep2', 'seifhabib', 'maramtarek53', 'zehuahe2', 'azizijazam11', 'marcosanllo', 'aimansyaz99', 'elizametias12', 'juanmacano97', 'sparshagarwal1009', 'prakharbhargava0', 'njs035', 'alberfn', 'ramy_maged4', 'hmoulvi1', 'vanesagarcia', 'hf4', 'wowmuchchuck', 'mohammedemadeldin2000', 'gabrielyii', 'keerthisv', 'pythagoras2', 'xunyong', 'irenehb92', 'shradhap', 'mohameeddsamy', 'marianne.gratton.1', 'marcmagdy98', 'brknshn', 'gemma', 'lukunze1', 'caglanlee', 'desmondsoon', 'sebasket14', 'masonpb2', 'youssef2042000', 'retty8', 'bharath3', 'syin4', 'ethanmorse', 'ematson5897', 'jacobzeshleman', 'leejq', 'harshini9962', 'reemali99_', 'xxlilmontysignxx', 'ramonruiz.infor', 'atharva98', 'ahern0722', 'hishamzakaria20', 'cheokonn', 'adriangarea', 'jeanmichael.deschenes', 'samet1231234', 'mr4425', 'bluelobster', 'justin.lariviere.25', 'dcpang2', 'felivitullo87', 'puertarcd', 'farahsamir978', 'akozych2', 'nbs691', 'kie180073', 'anwar909', 'bleuminuit', 'atx203', 'kanet1234', 'sealseal', 'emrebuyukkose2', 'arrow823', 'dhvanil', 'nuanno97', 'dkshelat', 'mohabayman', 'ranasherif65', 'diamond92', 'ugur.cankaya.3718', 'ammareltalli', 'acn562', 'nabilah1403', 'yaseminablacandir', 'tamchouweng', 'ablahsaoud', 'sriharshap', 'mrefaat', 'bassamtarek', 'hamidausat', 'kakmeera1999', 'teoster50', 'nolmos96', 'abdurrahmn13', 'mmartinezsanchez', 'sandrabashara', 'zakhwan7', 'chengweiheng', 'nikalyaamani', 'acregodean', 'happyleexin', 'sarapl', 'williammitchell5818', None, 'rooban11', 'yeejou990318', 'kowjiajin', 'nihaosawaddee', 'maxernest', 'david.garrido', 'guibill10', 'mohamedsameh', 'spazos7', 'tmi211', 'kie180039', 'worldlineusaf', 'mgk816', 'kie180079', 'ledicia97', 'movi205', 'shuming2']"
1,265,391,8,1,['nagihankececi'],390,"['oliviercharbonneau', 'miri23', 'ozgurkablan26', 'loisonchambers', 'tuberkargan_97', 'pranjal3', 'musabmalek0717', 'nadanasser1199', 'siemprewowthechami', 'staceyn2', 'vblanco.nico', 'abbesalaeddine', 'efrenhub', 'isabelmaria.vazquez', 'ahmedamr', 'shorouk_ossama', 'rikardberger', 'alancantu57', 'luciano.brignone', 'rahimnoorj', 'janeneil88', 'guttsfulltyagi', 'mjgebara14', 'kartal', 'gabrielyii99', 'aboone06', 'saegner2', 'manuelsomoza94', 'amani12345', 'youssefsherif22', 'j.haliburton', 'amr_ua07', 'evrenyigit', 'tingliang', 'kirankumar94', 'ahagras13', 'njgale01', 'al4995', 'smrdafdl', 'travisc2', 'dlee145', 'stambo', 'anthonyroux', 'ryanorem', 'moh.bahaa', 'ahchehyan', 'aimanadnan', 'veronica.mieites', 's_coriolis', 'trkmengkay', 'cbecker413', 'mcruces.fz', 'latecnologiameodia', 'gxiao2', 'emilechouinard', 'je_guilbert', 'yubai', 'sinasigurpinar', 'lauragdevesa', 'muvafikmelikkaya', 'kason.carroll', 'jbaggie2019', 'annahaozheng0606', 'jtorres17', 'ahmedayman2370', 'zikrizaki88995', 'yjenyiee155', '46harunakgul', 'alifzulkifli99', 'kaitlinh', 'tyy233', 'sdehoyos47', 'malgaca', 'lsleed', 'khazanv2', 'alexisdixon6', 'gc_1', 'jinsup2', 'rishu', 'amparo.castro.96', 'tbryan', 'martin32', 'michael.mechelay', 'akash140410107098', 'nowapoca', 'onaam8', 'pablosaavedra', 'camilolcastro97', 'khor', 'ankit6257', 'samashraf1', 'benoiturcotte', 'aishu98', 'rileyroca', 'david.peral.moran', 'kiruthikaabalu181996', 'taymacnichols', 'dhodapp', 'carlosvigo1997', 'moh.ashraf105', 'baleko12345', 'ikhbal', 'afeefz', 'kaustubh.shirpurkar', 'kie180031', 'bflores18', 'tdubnansky6', 'jorgecastelo5', 'andreadiazgar', 'david2397', 'bcperki2', 'melaniejkramer', 'rkchapman', 'jn1404', 'mateocampos', 'jzhan142', 'josepazmartin', 'brannon44', 'adfoz', 'avw2', 'youxing0309', 'scremin', 'lderemo', 'perezsarmar', 'ashutoshsinghhenry6', 'melroy_caeiro', 'viratbhatt007', 'fkl217', 'coderko3', 'alimatama', 'ammaralaa516', 'nadhnasorudin', 'adarsh123', 'jacquelinethardin', 'mjoza2', 'nihatyavuz', 'estebanrial', 'jinwoo2', 'adnanyuceer', 'danielfernandezcalo', 'berkaydean', 'cloudyoverhead', 'fred_dion', 'syedzakwan', 'e1150590', 'fcfrancapra94', 'amiruldanial99', 'ozbunar01', 'alecorti.pardo', 'electronica18', 'nourananwar123', 'olivier.gilbert.paquet', 'anibarseghyan', 'amlibrahim', 'neuroque', 'kychui2', 'shaf31', 'hong_gao', 'paul.aniruddha', 'carlosbesadaromero', 'mohaballam', 'pip29', 'apb5472', 'tuberkargan', 'hafizmokh99', 'javierisma98', 'fathy1104', 'corredoira', 'helenalecoq97', 'kimzihuang', 'muteki', 'masitadonmez', 'nadja1', 'dancastaneda', 'ahmedsameh1698', 'rocio', 'mallen22', 'ffazul64', 'guoyao', 'ari6nd', 'kerryreto', 'pedrosiaba', 'michaelsaldana1', 'omarmagdy', 'vickytubio', 'ericrobles', 'soccadelic44', 'selena', 'aasifhameed99', 'damlakubattt', 'anxovidal8', 'exjamil', 'jahnavikachhia', 'joker632455', 'vincentpainchaud.vp', 'svo4321', 'zhixin2', 'yansi', 'asyrafaqil', 'xyz11', 'virajput299', 'ryanboucher', 'jpmcgee98', 'mariz', 'bhliu97', 'amrebrahim', 'abdulrahim2905', 'c.a.stupka', 'tonybocadillosgrandes', 'talwren', 'rxtodd', 'farah26', 'tss3', 'abieday1704', 'mavanzato0418', 'facundovia', 'cristinacigarran', 'nazimmath3', 'baohl2', 'ales.gajdacz', 'elad.d', 'kie180028', 'wahidiah52', 'kyang37', 'arifjalani99', 'lino13', 'jaimefookinlannister', 'physquig', 'adriancheah', 'jarodm2', 'noureldin1999', 'michael2010814', 'ckim123', 'eddin21', 'jipiccardi', 'prabuddha_888253127', 'david_atef', 'kalebhilde', 'magic_ocean99', 'saipraneett', 'sanchjai', 'omardeyaa', 'pingan99', 'aaq', 'alidsjt', 'mengkem2', 'haclarke', 'oishikfaruque', 'ilou', 'aengm', 'janalorenzolumbreras', 'hilisa', 'carlosvillar54', 'vikazvereva', 'm939454', 'va844', 'pablobou4', 'ludovick.begin', 'maniphysics09', 'eduard25252598', 'apascao', 'xosegq16', 'adam562', 'lauramolinosmayo', 'amni99', 'kie180702', 'saharoaf', 'redzuan11', 'ypp200', 'kph2', 'martinzapata', 'kirolosehab99', 'restep2', 'seifhabib', 'maramtarek53', 'zehuahe2', 'azizijazam11', 'marcosanllo', 'aimansyaz99', 'elizametias12', 'juanmacano97', 'sparshagarwal1009', 'prakharbhargava0', 'njs035', 'alberfn', 'ramy_maged4', 'hmoulvi1', 'vanesagarcia', 'hf4', 'wowmuchchuck', 'mohammedemadeldin2000', 'gabrielyii', 'keerthisv', 'pythagoras2', 'xunyong', 'irenehb92', 'shradhap', 'mohameeddsamy', 'marianne.gratton.1', 'marcmagdy98', 'brknshn', 'gemma', 'lukunze1', 'caglanlee', 'desmondsoon', 'sebasket14', 'masonpb2', 'youssef2042000', 'retty8', 'bharath3', 'syin4', 'ethanmorse', 'ematson5897', 'jacobzeshleman', 'leejq', 'harshini9962', 'reemali99_', 'xxlilmontysignxx', 'ramonruiz.infor', 'atharva98', 'ahern0722', 'hishamzakaria20', 'cheokonn', 'adriangarea', 'jeanmichael.deschenes', 'samet1231234', 'mr4425', 'bluelobster', 'justin.lariviere.25', 'dcpang2', 'felivitullo87', 'puertarcd', 'farahsamir978', 'akozych2', 'nbs691', 'kie180073', 'anwar909', 'bleuminuit', 'atx203', 'kanet1234', 'sealseal', 'emrebuyukkose2', 'arrow823', 'dhvanil', 'nuanno97', 'dkshelat', 'mohabayman', 'ranasherif65', 'diamond92', 'ugur.cankaya.3718', 'ammareltalli', 'acn562', 'nabilah1403', 'yaseminablacandir', 'tamchouweng', 'ablahsaoud', 'sriharshap', 'mrefaat', 'bassamtarek', 'hamidausat', 'kakmeera1999', 'teoster50', 'nolmos96', 'abdurrahmn13', 'mmartinezsanchez', 'sandrabashara', 'zakhwan7', 'chengweiheng', 'nikalyaamani', 'acregodean', 'happyleexin', 'sarapl', 'williammitchell5818', 'rooban11', 'yeejou990318', 'kowjiajin', 'nihaosawaddee', 'maxernest', 'david.garrido', 'guibill10', 'mohamedsameh', 'spazos7', 'tmi211', 'kie180039', 'worldlineusaf', 'mgk816', 'kie180079', 'ledicia97', 'movi205', 'shuming2']",7,"['ulasgorcelioglu', 'mmert.bacak', 'yilmazberat1997', 'nihansulukoy', 'zubeydekal37', 'elifisparta38', None]",398,"['oliviercharbonneau', 'miri23', 'ozgurkablan26', 'loisonchambers', 'tuberkargan_97', 'pranjal3', 'musabmalek0717', 'nadanasser1199', 'siemprewowthechami', 'staceyn2', 'vblanco.nico', 'abbesalaeddine', 'efrenhub', 'isabelmaria.vazquez', 'ahmedamr', 'shorouk_ossama', 'rikardberger', 'alancantu57', 'luciano.brignone', 'rahimnoorj', 'janeneil88', 'nihansulukoy', 'guttsfulltyagi', 'mjgebara14', 'kartal', 'gabrielyii99', 'aboone06', 'saegner2', 'manuelsomoza94', 'amani12345', 'youssefsherif22', 'j.haliburton', 'amr_ua07', 'evrenyigit', 'tingliang', 'kirankumar94', 'ahagras13', 'njgale01', 'al4995', 'smrdafdl', 'travisc2', 'dlee145', 'stambo', 'anthonyroux', 'ryanorem', 'moh.bahaa', 'ahchehyan', 'aimanadnan', 'veronica.mieites', 's_coriolis', 'trkmengkay', 'cbecker413', 'mcruces.fz', 'latecnologiameodia', 'gxiao2', 'emilechouinard', 'je_guilbert', 'yubai', 'sinasigurpinar', 'lauragdevesa', 'muvafikmelikkaya', 'kason.carroll', 'jbaggie2019', 'annahaozheng0606', 'jtorres17', 'ahmedayman2370', 'zikrizaki88995', 'yjenyiee155', '46harunakgul', 'elifisparta38', 'alifzulkifli99', 'kaitlinh', 'tyy233', 'sdehoyos47', 'malgaca', 'lsleed', 'khazanv2', 'alexisdixon6', 'gc_1', 'jinsup2', 'rishu', 'amparo.castro.96', 'tbryan', 'martin32', 'michael.mechelay', 'akash140410107098', 'nowapoca', 'onaam8', 'pablosaavedra', 'camilolcastro97', 'khor', 'ankit6257', 'samashraf1', 'benoiturcotte', 'aishu98', 'rileyroca', 'david.peral.moran', 'kiruthikaabalu181996', 'taymacnichols', 'dhodapp', 'nagihankececi', 'carlosvigo1997', 'moh.ashraf105', 'baleko12345', 'ikhbal', 'mmert.bacak', 'afeefz', 'kaustubh.shirpurkar', 'kie180031', 'bflores18', 'tdubnansky6', 'jorgecastelo5', 'andreadiazgar', 'david2397', 'bcperki2', 'melaniejkramer', 'rkchapman', 'jn1404', 'mateocampos', 'jzhan142', 'josepazmartin', 'brannon44', 'adfoz', 'avw2', 'youxing0309', 'scremin', 'lderemo', 'perezsarmar', 'ashutoshsinghhenry6', 'melroy_caeiro', 'viratbhatt007', 'fkl217', 'coderko3', 'alimatama', 'ammaralaa516', 'nadhnasorudin', 'adarsh123', 'jacquelinethardin', 'mjoza2', 'nihatyavuz', 'estebanrial', 'jinwoo2', 'adnanyuceer', 'danielfernandezcalo', 'berkaydean', 'cloudyoverhead', 'fred_dion', 'syedzakwan', 'e1150590', 'fcfrancapra94', 'amiruldanial99', 'ozbunar01', 'alecorti.pardo', 'electronica18', 'nourananwar123', 'olivier.gilbert.paquet', 'anibarseghyan', 'amlibrahim', 'neuroque', 'kychui2', 'shaf31', 'hong_gao', 'paul.aniruddha', 'carlosbesadaromero', 'mohaballam', 'pip29', 'apb5472', 'tuberkargan', 'hafizmokh99', 'javierisma98', 'fathy1104', 'corredoira', 'helenalecoq97', 'kimzihuang', 'muteki', 'masitadonmez', 'nadja1', 'dancastaneda', 'ahmedsameh1698', 'rocio', 'mallen22', 'ffazul64', 'guoyao', 'ari6nd', 'kerryreto', 'pedrosiaba', 'michaelsaldana1', 'omarmagdy', 'vickytubio', 'ericrobles', 'soccadelic44', 'selena', 'aasifhameed99', 'damlakubattt', 'anxovidal8', 'exjamil', 'jahnavikachhia', 'joker632455', 'vincentpainchaud.vp', 'svo4321', 'zhixin2', 'yansi', 'asyrafaqil', 'xyz11', 'virajput299', 'ryanboucher', 'jpmcgee98', 'mariz', 'bhliu97', 'amrebrahim', 'abdulrahim2905', 'c.a.stupka', 'tonybocadillosgrandes', 'talwren', 'rxtodd', 'farah26', 'tss3', 'abieday1704', 'mavanzato0418', 'facundovia', 'cristinacigarran', 'nazimmath3', 'baohl2', 'ales.gajdacz', 'elad.d', 'kie180028', 'wahidiah52', 'kyang37', 'arifjalani99', 'lino13', 'jaimefookinlannister', 'physquig', 'adriancheah', 'jarodm2', 'noureldin1999', 'michael2010814', 'ckim123', 'eddin21', 'jipiccardi', 'prabuddha_888253127', 'david_atef', 'kalebhilde', 'magic_ocean99', 'saipraneett', 'sanchjai', 'omardeyaa', 'pingan99', 'aaq', 'alidsjt', 'mengkem2', 'haclarke', 'oishikfaruque', 'ilou', 'aengm', 'janalorenzolumbreras', 'hilisa', 'carlosvillar54', 'vikazvereva', 'm939454', 'va844', 'pablobou4', 'ludovick.begin', 'maniphysics09', 'eduard25252598', 'apascao', 'xosegq16', 'adam562', 'lauramolinosmayo', 'amni99', 'kie180702', 'saharoaf', 'redzuan11', 'ypp200', 'kph2', 'martinzapata', 'kirolosehab99', 'zubeydekal37', 'restep2', 'seifhabib', 'maramtarek53', 'zehuahe2', 'azizijazam11', 'marcosanllo', 'aimansyaz99', 'elizametias12', 'juanmacano97', 'ulasgorcelioglu', 'sparshagarwal1009', 'prakharbhargava0', 'njs035', 'alberfn', 'ramy_maged4', 'hmoulvi1', 'vanesagarcia', 'hf4', 'wowmuchchuck', 'mohammedemadeldin2000', 'gabrielyii', 'keerthisv', 'pythagoras2', 'xunyong', 'irenehb92', 'shradhap', 'mohameeddsamy', 'marianne.gratton.1', 'marcmagdy98', 'brknshn', 'gemma', 'lukunze1', 'caglanlee', 'desmondsoon', 'sebasket14', 'masonpb2', 'youssef2042000', 'retty8', 'bharath3', 'syin4', 'ethanmorse', 'ematson5897', 'jacobzeshleman', 'leejq', 'harshini9962', 'reemali99_', 'xxlilmontysignxx', 'ramonruiz.infor', 'atharva98', 'ahern0722', 'hishamzakaria20', 'cheokonn', 'adriangarea', 'yilmazberat1997', 'jeanmichael.deschenes', 'samet1231234', 'mr4425', 'bluelobster', 'justin.lariviere.25', 'dcpang2', 'felivitullo87', 'puertarcd', 'farahsamir978', 'akozych2', 'nbs691', 'kie180073', 'anwar909', 'bleuminuit', 'atx203', 'kanet1234', 'sealseal', 'emrebuyukkose2', 'arrow823', 'dhvanil', 'nuanno97', 'dkshelat', 'mohabayman', 'ranasherif65', 'diamond92', 'ugur.cankaya.3718', 'ammareltalli', 'acn562', 'nabilah1403', 'yaseminablacandir', 'tamchouweng', 'ablahsaoud', 'sriharshap', 'mrefaat', 'bassamtarek', 'hamidausat', 'kakmeera1999', 'teoster50', 'nolmos96', 'abdurrahmn13', 'mmartinezsanchez', 'sandrabashara', 'zakhwan7', 'chengweiheng', 'nikalyaamani', 'acregodean', 'happyleexin', 'sarapl', 'williammitchell5818', None, 'rooban11', 'yeejou990318', 'kowjiajin', 'nihaosawaddee', 'maxernest', 'david.garrido', 'guibill10', 'mohamedsameh', 'spazos7', 'tmi211', 'kie180039', 'worldlineusaf', 'mgk816', 'kie180079', 'ledicia97', 'movi205', 'shuming2']"
1,34,391,7,5,"['stambo', 'taymacnichols', 'worldlineusaf', 'njgale01', 'rkchapman']",386,"['oliviercharbonneau', 'miri23', 'ozgurkablan26', 'loisonchambers', 'tuberkargan_97', 'pranjal3', 'musabmalek0717', 'nadanasser1199', 'siemprewowthechami', 'staceyn2', 'vblanco.nico', 'abbesalaeddine', 'efrenhub', 'isabelmaria.vazquez', 'ahmedamr', 'shorouk_ossama', 'rikardberger', 'alancantu57', 'luciano.brignone', 'rahimnoorj', 'janeneil88', 'guttsfulltyagi', 'mjgebara14', 'kartal', 'gabrielyii99', 'aboone06', 'saegner2', 'manuelsomoza94', 'amani12345', 'youssefsherif22', 'j.haliburton', 'amr_ua07', 'evrenyigit', 'tingliang', 'kirankumar94', 'ahagras13', 'al4995', 'smrdafdl', 'travisc2', 'dlee145', 'anthonyroux', 'ryanorem', 'moh.bahaa', 'ahchehyan', 'aimanadnan', 'veronica.mieites', 's_coriolis', 'trkmengkay', 'cbecker413', 'mcruces.fz', 'latecnologiameodia', 'gxiao2', 'emilechouinard', 'je_guilbert', 'yubai', 'sinasigurpinar', 'lauragdevesa', 'muvafikmelikkaya', 'kason.carroll', 'jbaggie2019', 'annahaozheng0606', 'jtorres17', 'ahmedayman2370', 'zikrizaki88995', 'yjenyiee155', '46harunakgul', 'alifzulkifli99', 'kaitlinh', 'tyy233', 'sdehoyos47', 'malgaca', 'lsleed', 'khazanv2', 'alexisdixon6', 'gc_1', 'jinsup2', 'rishu', 'amparo.castro.96', 'tbryan', 'martin32', 'michael.mechelay', 'akash140410107098', 'nowapoca', 'onaam8', 'pablosaavedra', 'camilolcastro97', 'khor', 'ankit6257', 'samashraf1', 'benoiturcotte', 'aishu98', 'rileyroca', 'david.peral.moran', 'kiruthikaabalu181996', 'dhodapp', 'nagihankececi', 'carlosvigo1997', 'moh.ashraf105', 'baleko12345', 'ikhbal', 'afeefz', 'kaustubh.shirpurkar', 'kie180031', 'bflores18', 'tdubnansky6', 'jorgecastelo5', 'andreadiazgar', 'david2397', 'bcperki2', 'melaniejkramer', 'jn1404', 'mateocampos', 'jzhan142', 'josepazmartin', 'brannon44', 'adfoz', 'avw2', 'youxing0309', 'scremin', 'lderemo', 'perezsarmar', 'ashutoshsinghhenry6', 'melroy_caeiro', 'viratbhatt007', 'fkl217', 'coderko3', 'alimatama', 'ammaralaa516', 'nadhnasorudin', 'adarsh123', 'jacquelinethardin', 'mjoza2', 'nihatyavuz', 'estebanrial', 'jinwoo2', 'adnanyuceer', 'danielfernandezcalo', 'berkaydean', 'cloudyoverhead', 'fred_dion', 'syedzakwan', 'e1150590', 'fcfrancapra94', 'amiruldanial99', 'ozbunar01', 'alecorti.pardo', 'electronica18', 'nourananwar123', 'olivier.gilbert.paquet', 'anibarseghyan', 'amlibrahim', 'neuroque', 'kychui2', 'shaf31', 'hong_gao', 'paul.aniruddha', 'carlosbesadaromero', 'mohaballam', 'pip29', 'apb5472', 'tuberkargan', 'hafizmokh99', 'javierisma98', 'fathy1104', 'corredoira', 'helenalecoq97', 'kimzihuang', 'muteki', 'masitadonmez', 'nadja1', 'dancastaneda', 'ahmedsameh1698', 'rocio', 'mallen22', 'ffazul64', 'guoyao', 'ari6nd', 'kerryreto', 'pedrosiaba', 'michaelsaldana1', 'omarmagdy', 'vickytubio', 'ericrobles', 'soccadelic44', 'selena', 'aasifhameed99', 'damlakubattt', 'anxovidal8', 'exjamil', 'jahnavikachhia', 'joker632455', 'vincentpainchaud.vp', 'svo4321', 'zhixin2', 'yansi', 'asyrafaqil', 'xyz11', 'virajput299', 'ryanboucher', 'jpmcgee98', 'mariz', 'bhliu97', 'amrebrahim', 'abdulrahim2905', 'c.a.stupka', 'tonybocadillosgrandes', 'talwren', 'rxtodd', 'farah26', 'tss3', 'abieday1704', 'mavanzato0418', 'facundovia', 'cristinacigarran', 'nazimmath3', 'baohl2', 'ales.gajdacz', 'elad.d', 'kie180028', 'wahidiah52', 'kyang37', 'arifjalani99', 'lino13', 'jaimefookinlannister', 'physquig', 'adriancheah', 'jarodm2', 'noureldin1999', 'michael2010814', 'ckim123', 'eddin21', 'jipiccardi', 'prabuddha_888253127', 'david_atef', 'kalebhilde', 'magic_ocean99', 'saipraneett', 'sanchjai', 'omardeyaa', 'pingan99', 'aaq', 'alidsjt', 'mengkem2', 'haclarke', 'oishikfaruque', 'ilou', 'aengm', 'janalorenzolumbreras', 'hilisa', 'carlosvillar54', 'vikazvereva', 'm939454', 'va844', 'pablobou4', 'ludovick.begin', 'maniphysics09', 'eduard25252598', 'apascao', 'xosegq16', 'adam562', 'lauramolinosmayo', 'amni99', 'kie180702', 'saharoaf', 'redzuan11', 'ypp200', 'kph2', 'martinzapata', 'kirolosehab99', 'restep2', 'seifhabib', 'maramtarek53', 'zehuahe2', 'azizijazam11', 'marcosanllo', 'aimansyaz99', 'elizametias12', 'juanmacano97', 'sparshagarwal1009', 'prakharbhargava0', 'njs035', 'alberfn', 'ramy_maged4', 'hmoulvi1', 'vanesagarcia', 'hf4', 'wowmuchchuck', 'mohammedemadeldin2000', 'gabrielyii', 'keerthisv', 'pythagoras2', 'xunyong', 'irenehb92', 'shradhap', 'mohameeddsamy', 'marianne.gratton.1', 'marcmagdy98', 'brknshn', 'gemma', 'lukunze1', 'caglanlee', 'desmondsoon', 'sebasket14', 'masonpb2', 'youssef2042000', 'retty8', 'bharath3', 'syin4', 'ethanmorse', 'ematson5897', 'jacobzeshleman', 'leejq', 'harshini9962', 'reemali99_', 'xxlilmontysignxx', 'ramonruiz.infor', 'atharva98', 'ahern0722', 'hishamzakaria20', 'cheokonn', 'adriangarea', 'jeanmichael.deschenes', 'samet1231234', 'mr4425', 'bluelobster', 'justin.lariviere.25', 'dcpang2', 'felivitullo87', 'puertarcd', 'farahsamir978', 'akozych2', 'nbs691', 'kie180073', 'anwar909', 'bleuminuit', 'atx203', 'kanet1234', 'sealseal', 'emrebuyukkose2', 'arrow823', 'dhvanil', 'nuanno97', 'dkshelat', 'mohabayman', 'ranasherif65', 'diamond92', 'ugur.cankaya.3718', 'ammareltalli', 'acn562', 'nabilah1403', 'yaseminablacandir', 'tamchouweng', 'ablahsaoud', 'sriharshap', 'mrefaat', 'bassamtarek', 'hamidausat', 'kakmeera1999', 'teoster50', 'nolmos96', 'abdurrahmn13', 'mmartinezsanchez', 'sandrabashara', 'zakhwan7', 'chengweiheng', 'nikalyaamani', 'acregodean', 'happyleexin', 'sarapl', 'williammitchell5818', 'rooban11', 'yeejou990318', 'kowjiajin', 'nihaosawaddee', 'maxernest', 'david.garrido', 'guibill10', 'mohamedsameh', 'spazos7', 'tmi211', 'kie180039', 'mgk816', 'kie180079', 'ledicia97', 'movi205', 'shuming2']",2,"[None, 'jhendricks']",393,"['oliviercharbonneau', 'miri23', 'ozgurkablan26', 'loisonchambers', 'tuberkargan_97', 'pranjal3', 'musabmalek0717', 'nadanasser1199', 'siemprewowthechami', 'staceyn2', 'vblanco.nico', 'abbesalaeddine', 'efrenhub', 'isabelmaria.vazquez', 'ahmedamr', 'shorouk_ossama', 'rikardberger', 'alancantu57', 'luciano.brignone', 'rahimnoorj', 'janeneil88', 'guttsfulltyagi', 'mjgebara14', 'kartal', 'gabrielyii99', 'aboone06', 'saegner2', 'manuelsomoza94', 'amani12345', 'youssefsherif22', 'j.haliburton', 'amr_ua07', 'evrenyigit', 'tingliang', 'kirankumar94', 'ahagras13', 'njgale01', 'al4995', 'smrdafdl', 'travisc2', 'dlee145', 'stambo', 'anthonyroux', 'ryanorem', 'moh.bahaa', 'ahchehyan', 'aimanadnan', 'veronica.mieites', 's_coriolis', 'trkmengkay', 'cbecker413', 'mcruces.fz', 'latecnologiameodia', 'gxiao2', 'emilechouinard', 'je_guilbert', 'yubai', 'sinasigurpinar', 'lauragdevesa', 'muvafikmelikkaya', 'kason.carroll', 'jbaggie2019', 'annahaozheng0606', 'jtorres17', 'ahmedayman2370', 'zikrizaki88995', 'yjenyiee155', '46harunakgul', 'alifzulkifli99', 'kaitlinh', 'tyy233', 'sdehoyos47', 'malgaca', 'lsleed', 'khazanv2', 'alexisdixon6', 'gc_1', 'jinsup2', 'rishu', 'amparo.castro.96', 'tbryan', 'martin32', 'michael.mechelay', 'akash140410107098', 'nowapoca', 'onaam8', 'pablosaavedra', 'camilolcastro97', 'khor', 'ankit6257', 'samashraf1', 'benoiturcotte', 'aishu98', 'rileyroca', 'david.peral.moran', 'kiruthikaabalu181996', 'taymacnichols', 'dhodapp', 'nagihankececi', 'carlosvigo1997', 'moh.ashraf105', 'baleko12345', 'ikhbal', 'afeefz', 'kaustubh.shirpurkar', 'kie180031', 'bflores18', 'tdubnansky6', 'jorgecastelo5', 'andreadiazgar', 'david2397', 'bcperki2', 'melaniejkramer', 'rkchapman', 'jhendricks', 'jn1404', 'mateocampos', 'jzhan142', 'josepazmartin', 'brannon44', 'adfoz', 'avw2', 'youxing0309', 'scremin', 'lderemo', 'perezsarmar', 'ashutoshsinghhenry6', 'melroy_caeiro', 'viratbhatt007', 'fkl217', 'coderko3', 'alimatama', 'ammaralaa516', 'nadhnasorudin', 'adarsh123', 'jacquelinethardin', 'mjoza2', 'nihatyavuz', 'estebanrial', 'jinwoo2', 'adnanyuceer', 'danielfernandezcalo', 'berkaydean', 'cloudyoverhead', 'fred_dion', 'syedzakwan', 'e1150590', 'fcfrancapra94', 'amiruldanial99', 'ozbunar01', 'alecorti.pardo', 'electronica18', 'nourananwar123', 'olivier.gilbert.paquet', 'anibarseghyan', 'amlibrahim', 'neuroque', 'kychui2', 'shaf31', 'hong_gao', 'paul.aniruddha', 'carlosbesadaromero', 'mohaballam', 'pip29', 'apb5472', 'tuberkargan', 'hafizmokh99', 'javierisma98', 'fathy1104', 'corredoira', 'helenalecoq97', 'kimzihuang', 'muteki', 'masitadonmez', 'nadja1', 'dancastaneda', 'ahmedsameh1698', 'rocio', 'mallen22', 'ffazul64', 'guoyao', 'ari6nd', 'kerryreto', 'pedrosiaba', 'michaelsaldana1', 'omarmagdy', 'vickytubio', 'ericrobles', 'soccadelic44', 'selena', 'aasifhameed99', 'damlakubattt', 'anxovidal8', 'exjamil', 'jahnavikachhia', 'joker632455', 'vincentpainchaud.vp', 'svo4321', 'zhixin2', 'yansi', 'asyrafaqil', 'xyz11', 'virajput299', 'ryanboucher', 'jpmcgee98', 'mariz', 'bhliu97', 'amrebrahim', 'abdulrahim2905', 'c.a.stupka', 'tonybocadillosgrandes', 'talwren', 'rxtodd', 'farah26', 'tss3', 'abieday1704', 'mavanzato0418', 'facundovia', 'cristinacigarran', 'nazimmath3', 'baohl2', 'ales.gajdacz', 'elad.d', 'kie180028', 'wahidiah52', 'kyang37', 'arifjalani99', 'lino13', 'jaimefookinlannister', 'physquig', 'adriancheah', 'jarodm2', 'noureldin1999', 'michael2010814', 'ckim123', 'eddin21', 'jipiccardi', 'prabuddha_888253127', 'david_atef', 'kalebhilde', 'magic_ocean99', 'saipraneett', 'sanchjai', 'omardeyaa', 'pingan99', 'aaq', 'alidsjt', 'mengkem2', 'haclarke', 'oishikfaruque', 'ilou', 'aengm', 'janalorenzolumbreras', 'hilisa', 'carlosvillar54', 'vikazvereva', 'm939454', 'va844', 'pablobou4', 'ludovick.begin', 'maniphysics09', 'eduard25252598', 'apascao', 'xosegq16', 'adam562', 'lauramolinosmayo', 'amni99', 'kie180702', 'saharoaf', 'redzuan11', 'ypp200', 'kph2', 'martinzapata', 'kirolosehab99', 'restep2', 'seifhabib', 'maramtarek53', 'zehuahe2', 'azizijazam11', 'marcosanllo', 'aimansyaz99', 'elizametias12', 'juanmacano97', 'sparshagarwal1009', 'prakharbhargava0', 'njs035', 'alberfn', 'ramy_maged4', 'hmoulvi1', 'vanesagarcia', 'hf4', 'wowmuchchuck', 'mohammedemadeldin2000', 'gabrielyii', 'keerthisv', 'pythagoras2', 'xunyong', 'irenehb92', 'shradhap', 'mohameeddsamy', 'marianne.gratton.1', 'marcmagdy98', 'brknshn', 'gemma', 'lukunze1', 'caglanlee', 'desmondsoon', 'sebasket14', 'masonpb2', 'youssef2042000', 'retty8', 'bharath3', 'syin4', 'ethanmorse', 'ematson5897', 'jacobzeshleman', 'leejq', 'harshini9962', 'reemali99_', 'xxlilmontysignxx', 'ramonruiz.infor', 'atharva98', 'ahern0722', 'hishamzakaria20', 'cheokonn', 'adriangarea', 'jeanmichael.deschenes', 'samet1231234', 'mr4425', 'bluelobster', 'justin.lariviere.25', 'dcpang2', 'felivitullo87', 'puertarcd', 'farahsamir978', 'akozych2', 'nbs691', 'kie180073', 'anwar909', 'bleuminuit', 'atx203', 'kanet1234', 'sealseal', 'emrebuyukkose2', 'arrow823', 'dhvanil', 'nuanno97', 'dkshelat', 'mohabayman', 'ranasherif65', 'diamond92', 'ugur.cankaya.3718', 'ammareltalli', 'acn562', 'nabilah1403', 'yaseminablacandir', 'tamchouweng', 'ablahsaoud', 'sriharshap', 'mrefaat', 'bassamtarek', 'hamidausat', 'kakmeera1999', 'teoster50', 'nolmos96', 'abdurrahmn13', 'mmartinezsanchez', 'sandrabashara', 'zakhwan7', 'chengweiheng', 'nikalyaamani', 'acregodean', 'happyleexin', 'sarapl', 'williammitchell5818', None, 'rooban11', 'yeejou990318', 'kowjiajin', 'nihaosawaddee', 'maxernest', 'david.garrido', 'guibill10', 'mohamedsameh', 'spazos7', 'tmi211', 'kie180039', 'worldlineusaf', 'mgk816', 'kie180079', 'ledicia97', 'movi205', 'shuming2']"
1,38,391,7,5,"['stambo', 'taymacnichols', 'worldlineusaf', 'njgale01', 'rkchapman']",386,"['oliviercharbonneau', 'miri23', 'ozgurkablan26', 'loisonchambers', 'tuberkargan_97', 'pranjal3', 'musabmalek0717', 'nadanasser1199', 'siemprewowthechami', 'staceyn2', 'vblanco.nico', 'abbesalaeddine', 'efrenhub', 'isabelmaria.vazquez', 'ahmedamr', 'shorouk_ossama', 'rikardberger', 'alancantu57', 'luciano.brignone', 'rahimnoorj', 'janeneil88', 'guttsfulltyagi', 'mjgebara14', 'kartal', 'gabrielyii99', 'aboone06', 'saegner2', 'manuelsomoza94', 'amani12345', 'youssefsherif22', 'j.haliburton', 'amr_ua07', 'evrenyigit', 'tingliang', 'kirankumar94', 'ahagras13', 'al4995', 'smrdafdl', 'travisc2', 'dlee145', 'anthonyroux', 'ryanorem', 'moh.bahaa', 'ahchehyan', 'aimanadnan', 'veronica.mieites', 's_coriolis', 'trkmengkay', 'cbecker413', 'mcruces.fz', 'latecnologiameodia', 'gxiao2', 'emilechouinard', 'je_guilbert', 'yubai', 'sinasigurpinar', 'lauragdevesa', 'muvafikmelikkaya', 'kason.carroll', 'jbaggie2019', 'annahaozheng0606', 'jtorres17', 'ahmedayman2370', 'zikrizaki88995', 'yjenyiee155', '46harunakgul', 'alifzulkifli99', 'kaitlinh', 'tyy233', 'sdehoyos47', 'malgaca', 'lsleed', 'khazanv2', 'alexisdixon6', 'gc_1', 'jinsup2', 'rishu', 'amparo.castro.96', 'tbryan', 'martin32', 'michael.mechelay', 'akash140410107098', 'nowapoca', 'onaam8', 'pablosaavedra', 'camilolcastro97', 'khor', 'ankit6257', 'samashraf1', 'benoiturcotte', 'aishu98', 'rileyroca', 'david.peral.moran', 'kiruthikaabalu181996', 'dhodapp', 'nagihankececi', 'carlosvigo1997', 'moh.ashraf105', 'baleko12345', 'ikhbal', 'afeefz', 'kaustubh.shirpurkar', 'kie180031', 'bflores18', 'tdubnansky6', 'jorgecastelo5', 'andreadiazgar', 'david2397', 'bcperki2', 'melaniejkramer', 'jn1404', 'mateocampos', 'jzhan142', 'josepazmartin', 'brannon44', 'adfoz', 'avw2', 'youxing0309', 'scremin', 'lderemo', 'perezsarmar', 'ashutoshsinghhenry6', 'melroy_caeiro', 'viratbhatt007', 'fkl217', 'coderko3', 'alimatama', 'ammaralaa516', 'nadhnasorudin', 'adarsh123', 'jacquelinethardin', 'mjoza2', 'nihatyavuz', 'estebanrial', 'jinwoo2', 'adnanyuceer', 'danielfernandezcalo', 'berkaydean', 'cloudyoverhead', 'fred_dion', 'syedzakwan', 'e1150590', 'fcfrancapra94', 'amiruldanial99', 'ozbunar01', 'alecorti.pardo', 'electronica18', 'nourananwar123', 'olivier.gilbert.paquet', 'anibarseghyan', 'amlibrahim', 'neuroque', 'kychui2', 'shaf31', 'hong_gao', 'paul.aniruddha', 'carlosbesadaromero', 'mohaballam', 'pip29', 'apb5472', 'tuberkargan', 'hafizmokh99', 'javierisma98', 'fathy1104', 'corredoira', 'helenalecoq97', 'kimzihuang', 'muteki', 'masitadonmez', 'nadja1', 'dancastaneda', 'ahmedsameh1698', 'rocio', 'mallen22', 'ffazul64', 'guoyao', 'ari6nd', 'kerryreto', 'pedrosiaba', 'michaelsaldana1', 'omarmagdy', 'vickytubio', 'ericrobles', 'soccadelic44', 'selena', 'aasifhameed99', 'damlakubattt', 'anxovidal8', 'exjamil', 'jahnavikachhia', 'joker632455', 'vincentpainchaud.vp', 'svo4321', 'zhixin2', 'yansi', 'asyrafaqil', 'xyz11', 'virajput299', 'ryanboucher', 'jpmcgee98', 'mariz', 'bhliu97', 'amrebrahim', 'abdulrahim2905', 'c.a.stupka', 'tonybocadillosgrandes', 'talwren', 'rxtodd', 'farah26', 'tss3', 'abieday1704', 'mavanzato0418', 'facundovia', 'cristinacigarran', 'nazimmath3', 'baohl2', 'ales.gajdacz', 'elad.d', 'kie180028', 'wahidiah52', 'kyang37', 'arifjalani99', 'lino13', 'jaimefookinlannister', 'physquig', 'adriancheah', 'jarodm2', 'noureldin1999', 'michael2010814', 'ckim123', 'eddin21', 'jipiccardi', 'prabuddha_888253127', 'david_atef', 'kalebhilde', 'magic_ocean99', 'saipraneett', 'sanchjai', 'omardeyaa', 'pingan99', 'aaq', 'alidsjt', 'mengkem2', 'haclarke', 'oishikfaruque', 'ilou', 'aengm', 'janalorenzolumbreras', 'hilisa', 'carlosvillar54', 'vikazvereva', 'm939454', 'va844', 'pablobou4', 'ludovick.begin', 'maniphysics09', 'eduard25252598', 'apascao', 'xosegq16', 'adam562', 'lauramolinosmayo', 'amni99', 'kie180702', 'saharoaf', 'redzuan11', 'ypp200', 'kph2', 'martinzapata', 'kirolosehab99', 'restep2', 'seifhabib', 'maramtarek53', 'zehuahe2', 'azizijazam11', 'marcosanllo', 'aimansyaz99', 'elizametias12', 'juanmacano97', 'sparshagarwal1009', 'prakharbhargava0', 'njs035', 'alberfn', 'ramy_maged4', 'hmoulvi1', 'vanesagarcia', 'hf4', 'wowmuchchuck', 'mohammedemadeldin2000', 'gabrielyii', 'keerthisv', 'pythagoras2', 'xunyong', 'irenehb92', 'shradhap', 'mohameeddsamy', 'marianne.gratton.1', 'marcmagdy98', 'brknshn', 'gemma', 'lukunze1', 'caglanlee', 'desmondsoon', 'sebasket14', 'masonpb2', 'youssef2042000', 'retty8', 'bharath3', 'syin4', 'ethanmorse', 'ematson5897', 'jacobzeshleman', 'leejq', 'harshini9962', 'reemali99_', 'xxlilmontysignxx', 'ramonruiz.infor', 'atharva98', 'ahern0722', 'hishamzakaria20', 'cheokonn', 'adriangarea', 'jeanmichael.deschenes', 'samet1231234', 'mr4425', 'bluelobster', 'justin.lariviere.25', 'dcpang2', 'felivitullo87', 'puertarcd', 'farahsamir978', 'akozych2', 'nbs691', 'kie180073', 'anwar909', 'bleuminuit', 'atx203', 'kanet1234', 'sealseal', 'emrebuyukkose2', 'arrow823', 'dhvanil', 'nuanno97', 'dkshelat', 'mohabayman', 'ranasherif65', 'diamond92', 'ugur.cankaya.3718', 'ammareltalli', 'acn562', 'nabilah1403', 'yaseminablacandir', 'tamchouweng', 'ablahsaoud', 'sriharshap', 'mrefaat', 'bassamtarek', 'hamidausat', 'kakmeera1999', 'teoster50', 'nolmos96', 'abdurrahmn13', 'mmartinezsanchez', 'sandrabashara', 'zakhwan7', 'chengweiheng', 'nikalyaamani', 'acregodean', 'happyleexin', 'sarapl', 'williammitchell5818', 'rooban11', 'yeejou990318', 'kowjiajin', 'nihaosawaddee', 'maxernest', 'david.garrido', 'guibill10', 'mohamedsameh', 'spazos7', 'tmi211', 'kie180039', 'mgk816', 'kie180079', 'ledicia97', 'movi205', 'shuming2']",2,"[None, 'jhendricks']",393,"['oliviercharbonneau', 'miri23', 'ozgurkablan26', 'loisonchambers', 'tuberkargan_97', 'pranjal3', 'musabmalek0717', 'nadanasser1199', 'siemprewowthechami', 'staceyn2', 'vblanco.nico', 'abbesalaeddine', 'efrenhub', 'isabelmaria.vazquez', 'ahmedamr', 'shorouk_ossama', 'rikardberger', 'alancantu57', 'luciano.brignone', 'rahimnoorj', 'janeneil88', 'guttsfulltyagi', 'mjgebara14', 'kartal', 'gabrielyii99', 'aboone06', 'saegner2', 'manuelsomoza94', 'amani12345', 'youssefsherif22', 'j.haliburton', 'amr_ua07', 'evrenyigit', 'tingliang', 'kirankumar94', 'ahagras13', 'njgale01', 'al4995', 'smrdafdl', 'travisc2', 'dlee145', 'stambo', 'anthonyroux', 'ryanorem', 'moh.bahaa', 'ahchehyan', 'aimanadnan', 'veronica.mieites', 's_coriolis', 'trkmengkay', 'cbecker413', 'mcruces.fz', 'latecnologiameodia', 'gxiao2', 'emilechouinard', 'je_guilbert', 'yubai', 'sinasigurpinar', 'lauragdevesa', 'muvafikmelikkaya', 'kason.carroll', 'jbaggie2019', 'annahaozheng0606', 'jtorres17', 'ahmedayman2370', 'zikrizaki88995', 'yjenyiee155', '46harunakgul', 'alifzulkifli99', 'kaitlinh', 'tyy233', 'sdehoyos47', 'malgaca', 'lsleed', 'khazanv2', 'alexisdixon6', 'gc_1', 'jinsup2', 'rishu', 'amparo.castro.96', 'tbryan', 'martin32', 'michael.mechelay', 'akash140410107098', 'nowapoca', 'onaam8', 'pablosaavedra', 'camilolcastro97', 'khor', 'ankit6257', 'samashraf1', 'benoiturcotte', 'aishu98', 'rileyroca', 'david.peral.moran', 'kiruthikaabalu181996', 'taymacnichols', 'dhodapp', 'nagihankececi', 'carlosvigo1997', 'moh.ashraf105', 'baleko12345', 'ikhbal', 'afeefz', 'kaustubh.shirpurkar', 'kie180031', 'bflores18', 'tdubnansky6', 'jorgecastelo5', 'andreadiazgar', 'david2397', 'bcperki2', 'melaniejkramer', 'rkchapman', 'jhendricks', 'jn1404', 'mateocampos', 'jzhan142', 'josepazmartin', 'brannon44', 'adfoz', 'avw2', 'youxing0309', 'scremin', 'lderemo', 'perezsarmar', 'ashutoshsinghhenry6', 'melroy_caeiro', 'viratbhatt007', 'fkl217', 'coderko3', 'alimatama', 'ammaralaa516', 'nadhnasorudin', 'adarsh123', 'jacquelinethardin', 'mjoza2', 'nihatyavuz', 'estebanrial', 'jinwoo2', 'adnanyuceer', 'danielfernandezcalo', 'berkaydean', 'cloudyoverhead', 'fred_dion', 'syedzakwan', 'e1150590', 'fcfrancapra94', 'amiruldanial99', 'ozbunar01', 'alecorti.pardo', 'electronica18', 'nourananwar123', 'olivier.gilbert.paquet', 'anibarseghyan', 'amlibrahim', 'neuroque', 'kychui2', 'shaf31', 'hong_gao', 'paul.aniruddha', 'carlosbesadaromero', 'mohaballam', 'pip29', 'apb5472', 'tuberkargan', 'hafizmokh99', 'javierisma98', 'fathy1104', 'corredoira', 'helenalecoq97', 'kimzihuang', 'muteki', 'masitadonmez', 'nadja1', 'dancastaneda', 'ahmedsameh1698', 'rocio', 'mallen22', 'ffazul64', 'guoyao', 'ari6nd', 'kerryreto', 'pedrosiaba', 'michaelsaldana1', 'omarmagdy', 'vickytubio', 'ericrobles', 'soccadelic44', 'selena', 'aasifhameed99', 'damlakubattt', 'anxovidal8', 'exjamil', 'jahnavikachhia', 'joker632455', 'vincentpainchaud.vp', 'svo4321', 'zhixin2', 'yansi', 'asyrafaqil', 'xyz11', 'virajput299', 'ryanboucher', 'jpmcgee98', 'mariz', 'bhliu97', 'amrebrahim', 'abdulrahim2905', 'c.a.stupka', 'tonybocadillosgrandes', 'talwren', 'rxtodd', 'farah26', 'tss3', 'abieday1704', 'mavanzato0418', 'facundovia', 'cristinacigarran', 'nazimmath3', 'baohl2', 'ales.gajdacz', 'elad.d', 'kie180028', 'wahidiah52', 'kyang37', 'arifjalani99', 'lino13', 'jaimefookinlannister', 'physquig', 'adriancheah', 'jarodm2', 'noureldin1999', 'michael2010814', 'ckim123', 'eddin21', 'jipiccardi', 'prabuddha_888253127', 'david_atef', 'kalebhilde', 'magic_ocean99', 'saipraneett', 'sanchjai', 'omardeyaa', 'pingan99', 'aaq', 'alidsjt', 'mengkem2', 'haclarke', 'oishikfaruque', 'ilou', 'aengm', 'janalorenzolumbreras', 'hilisa', 'carlosvillar54', 'vikazvereva', 'm939454', 'va844', 'pablobou4', 'ludovick.begin', 'maniphysics09', 'eduard25252598', 'apascao', 'xosegq16', 'adam562', 'lauramolinosmayo', 'amni99', 'kie180702', 'saharoaf', 'redzuan11', 'ypp200', 'kph2', 'martinzapata', 'kirolosehab99', 'restep2', 'seifhabib', 'maramtarek53', 'zehuahe2', 'azizijazam11', 'marcosanllo', 'aimansyaz99', 'elizametias12', 'juanmacano97', 'sparshagarwal1009', 'prakharbhargava0', 'njs035', 'alberfn', 'ramy_maged4', 'hmoulvi1', 'vanesagarcia', 'hf4', 'wowmuchchuck', 'mohammedemadeldin2000', 'gabrielyii', 'keerthisv', 'pythagoras2', 'xunyong', 'irenehb92', 'shradhap', 'mohameeddsamy', 'marianne.gratton.1', 'marcmagdy98', 'brknshn', 'gemma', 'lukunze1', 'caglanlee', 'desmondsoon', 'sebasket14', 'masonpb2', 'youssef2042000', 'retty8', 'bharath3', 'syin4', 'ethanmorse', 'ematson5897', 'jacobzeshleman', 'leejq', 'harshini9962', 'reemali99_', 'xxlilmontysignxx', 'ramonruiz.infor', 'atharva98', 'ahern0722', 'hishamzakaria20', 'cheokonn', 'adriangarea', 'jeanmichael.deschenes', 'samet1231234', 'mr4425', 'bluelobster', 'justin.lariviere.25', 'dcpang2', 'felivitullo87', 'puertarcd', 'farahsamir978', 'akozych2', 'nbs691', 'kie180073', 'anwar909', 'bleuminuit', 'atx203', 'kanet1234', 'sealseal', 'emrebuyukkose2', 'arrow823', 'dhvanil', 'nuanno97', 'dkshelat', 'mohabayman', 'ranasherif65', 'diamond92', 'ugur.cankaya.3718', 'ammareltalli', 'acn562', 'nabilah1403', 'yaseminablacandir', 'tamchouweng', 'ablahsaoud', 'sriharshap', 'mrefaat', 'bassamtarek', 'hamidausat', 'kakmeera1999', 'teoster50', 'nolmos96', 'abdurrahmn13', 'mmartinezsanchez', 'sandrabashara', 'zakhwan7', 'chengweiheng', 'nikalyaamani', 'acregodean', 'happyleexin', 'sarapl', 'williammitchell5818', None, 'rooban11', 'yeejou990318', 'kowjiajin', 'nihaosawaddee', 'maxernest', 'david.garrido', 'guibill10', 'mohamedsameh', 'spazos7', 'tmi211', 'kie180039', 'worldlineusaf', 'mgk816', 'kie180079', 'ledicia97', 'movi205', 'shuming2']"
1,121,391,7,1,['zhixin2'],390,"['oliviercharbonneau', 'miri23', 'ozgurkablan26', 'loisonchambers', 'tuberkargan_97', 'pranjal3', 'musabmalek0717', 'nadanasser1199', 'siemprewowthechami', 'staceyn2', 'vblanco.nico', 'abbesalaeddine', 'efrenhub', 'isabelmaria.vazquez', 'ahmedamr', 'shorouk_ossama', 'rikardberger', 'alancantu57', 'luciano.brignone', 'rahimnoorj', 'janeneil88', 'guttsfulltyagi', 'mjgebara14', 'kartal', 'gabrielyii99', 'aboone06', 'saegner2', 'manuelsomoza94', 'amani12345', 'youssefsherif22', 'j.haliburton', 'amr_ua07', 'evrenyigit', 'tingliang', 'kirankumar94', 'ahagras13', 'njgale01', 'al4995', 'smrdafdl', 'travisc2', 'dlee145', 'stambo', 'anthonyroux', 'ryanorem', 'moh.bahaa', 'ahchehyan', 'aimanadnan', 'veronica.mieites', 's_coriolis', 'trkmengkay', 'cbecker413', 'mcruces.fz', 'latecnologiameodia', 'gxiao2', 'emilechouinard', 'je_guilbert', 'yubai', 'sinasigurpinar', 'lauragdevesa', 'muvafikmelikkaya', 'kason.carroll', 'jbaggie2019', 'annahaozheng0606', 'jtorres17', 'ahmedayman2370', 'zikrizaki88995', 'yjenyiee155', '46harunakgul', 'alifzulkifli99', 'kaitlinh', 'tyy233', 'sdehoyos47', 'malgaca', 'lsleed', 'khazanv2', 'alexisdixon6', 'gc_1', 'jinsup2', 'rishu', 'amparo.castro.96', 'tbryan', 'martin32', 'michael.mechelay', 'akash140410107098', 'nowapoca', 'onaam8', 'pablosaavedra', 'camilolcastro97', 'khor', 'ankit6257', 'samashraf1', 'benoiturcotte', 'aishu98', 'rileyroca', 'david.peral.moran', 'kiruthikaabalu181996', 'taymacnichols', 'dhodapp', 'nagihankececi', 'carlosvigo1997', 'moh.ashraf105', 'baleko12345', 'ikhbal', 'afeefz', 'kaustubh.shirpurkar', 'kie180031', 'bflores18', 'tdubnansky6', 'jorgecastelo5', 'andreadiazgar', 'david2397', 'bcperki2', 'melaniejkramer', 'rkchapman', 'jn1404', 'mateocampos', 'jzhan142', 'josepazmartin', 'brannon44', 'adfoz', 'avw2', 'youxing0309', 'scremin', 'lderemo', 'perezsarmar', 'ashutoshsinghhenry6', 'melroy_caeiro', 'viratbhatt007', 'fkl217', 'coderko3', 'alimatama', 'ammaralaa516', 'nadhnasorudin', 'adarsh123', 'jacquelinethardin', 'mjoza2', 'nihatyavuz', 'estebanrial', 'jinwoo2', 'adnanyuceer', 'danielfernandezcalo', 'berkaydean', 'cloudyoverhead', 'fred_dion', 'syedzakwan', 'e1150590', 'fcfrancapra94', 'amiruldanial99', 'ozbunar01', 'alecorti.pardo', 'electronica18', 'nourananwar123', 'olivier.gilbert.paquet', 'anibarseghyan', 'amlibrahim', 'neuroque', 'kychui2', 'shaf31', 'hong_gao', 'paul.aniruddha', 'carlosbesadaromero', 'mohaballam', 'pip29', 'apb5472', 'tuberkargan', 'hafizmokh99', 'javierisma98', 'fathy1104', 'corredoira', 'helenalecoq97', 'kimzihuang', 'muteki', 'masitadonmez', 'nadja1', 'dancastaneda', 'ahmedsameh1698', 'rocio', 'mallen22', 'ffazul64', 'guoyao', 'ari6nd', 'kerryreto', 'pedrosiaba', 'michaelsaldana1', 'omarmagdy', 'vickytubio', 'ericrobles', 'soccadelic44', 'selena', 'aasifhameed99', 'damlakubattt', 'anxovidal8', 'exjamil', 'jahnavikachhia', 'joker632455', 'vincentpainchaud.vp', 'svo4321', 'yansi', 'asyrafaqil', 'xyz11', 'virajput299', 'ryanboucher', 'jpmcgee98', 'mariz', 'bhliu97', 'amrebrahim', 'abdulrahim2905', 'c.a.stupka', 'tonybocadillosgrandes', 'talwren', 'rxtodd', 'farah26', 'tss3', 'abieday1704', 'mavanzato0418', 'facundovia', 'cristinacigarran', 'nazimmath3', 'baohl2', 'ales.gajdacz', 'elad.d', 'kie180028', 'wahidiah52', 'kyang37', 'arifjalani99', 'lino13', 'jaimefookinlannister', 'physquig', 'adriancheah', 'jarodm2', 'noureldin1999', 'michael2010814', 'ckim123', 'eddin21', 'jipiccardi', 'prabuddha_888253127', 'david_atef', 'kalebhilde', 'magic_ocean99', 'saipraneett', 'sanchjai', 'omardeyaa', 'pingan99', 'aaq', 'alidsjt', 'mengkem2', 'haclarke', 'oishikfaruque', 'ilou', 'aengm', 'janalorenzolumbreras', 'hilisa', 'carlosvillar54', 'vikazvereva', 'm939454', 'va844', 'pablobou4', 'ludovick.begin', 'maniphysics09', 'eduard25252598', 'apascao', 'xosegq16', 'adam562', 'lauramolinosmayo', 'amni99', 'kie180702', 'saharoaf', 'redzuan11', 'ypp200', 'kph2', 'martinzapata', 'kirolosehab99', 'restep2', 'seifhabib', 'maramtarek53', 'zehuahe2', 'azizijazam11', 'marcosanllo', 'aimansyaz99', 'elizametias12', 'juanmacano97', 'sparshagarwal1009', 'prakharbhargava0', 'njs035', 'alberfn', 'ramy_maged4', 'hmoulvi1', 'vanesagarcia', 'hf4', 'wowmuchchuck', 'mohammedemadeldin2000', 'gabrielyii', 'keerthisv', 'pythagoras2', 'xunyong', 'irenehb92', 'shradhap', 'mohameeddsamy', 'marianne.gratton.1', 'marcmagdy98', 'brknshn', 'gemma', 'lukunze1', 'caglanlee', 'desmondsoon', 'sebasket14', 'masonpb2', 'youssef2042000', 'retty8', 'bharath3', 'syin4', 'ethanmorse', 'ematson5897', 'jacobzeshleman', 'leejq', 'harshini9962', 'reemali99_', 'xxlilmontysignxx', 'ramonruiz.infor', 'atharva98', 'ahern0722', 'hishamzakaria20', 'cheokonn', 'adriangarea', 'jeanmichael.deschenes', 'samet1231234', 'mr4425', 'bluelobster', 'justin.lariviere.25', 'dcpang2', 'felivitullo87', 'puertarcd', 'farahsamir978', 'akozych2', 'nbs691', 'kie180073', 'anwar909', 'bleuminuit', 'atx203', 'kanet1234', 'sealseal', 'emrebuyukkose2', 'arrow823', 'dhvanil', 'nuanno97', 'dkshelat', 'mohabayman', 'ranasherif65', 'diamond92', 'ugur.cankaya.3718', 'ammareltalli', 'acn562', 'nabilah1403', 'yaseminablacandir', 'tamchouweng', 'ablahsaoud', 'sriharshap', 'mrefaat', 'bassamtarek', 'hamidausat', 'kakmeera1999', 'teoster50', 'nolmos96', 'abdurrahmn13', 'mmartinezsanchez', 'sandrabashara', 'zakhwan7', 'chengweiheng', 'nikalyaamani', 'acregodean', 'happyleexin', 'sarapl', 'williammitchell5818', 'rooban11', 'yeejou990318', 'kowjiajin', 'nihaosawaddee', 'maxernest', 'david.garrido', 'guibill10', 'mohamedsameh', 'spazos7', 'tmi211', 'kie180039', 'worldlineusaf', 'mgk816', 'kie180079', 'ledicia97', 'movi205', 'shuming2']",6,"['brokawat', 'arehman4', 'ssengupta3', 'jaketh2', 'chinmayanandadm', None]",397,"['oliviercharbonneau', 'miri23', 'ozgurkablan26', 'loisonchambers', 'tuberkargan_97', 'ssengupta3', 'pranjal3', 'musabmalek0717', 'nadanasser1199', 'siemprewowthechami', 'staceyn2', 'vblanco.nico', 'abbesalaeddine', 'efrenhub', 'isabelmaria.vazquez', 'ahmedamr', 'shorouk_ossama', 'rikardberger', 'alancantu57', 'luciano.brignone', 'rahimnoorj', 'janeneil88', 'guttsfulltyagi', 'mjgebara14', 'kartal', 'gabrielyii99', 'aboone06', 'saegner2', 'manuelsomoza94', 'amani12345', 'youssefsherif22', 'j.haliburton', 'amr_ua07', 'evrenyigit', 'tingliang', 'kirankumar94', 'ahagras13', 'njgale01', 'al4995', 'smrdafdl', 'travisc2', 'dlee145', 'stambo', 'anthonyroux', 'ryanorem', 'moh.bahaa', 'ahchehyan', 'aimanadnan', 'veronica.mieites', 's_coriolis', 'trkmengkay', 'cbecker413', 'mcruces.fz', 'latecnologiameodia', 'gxiao2', 'emilechouinard', 'je_guilbert', 'yubai', 'sinasigurpinar', 'lauragdevesa', 'muvafikmelikkaya', 'kason.carroll', 'jbaggie2019', 'annahaozheng0606', 'jtorres17', 'ahmedayman2370', 'zikrizaki88995', 'yjenyiee155', '46harunakgul', 'alifzulkifli99', 'kaitlinh', 'tyy233', 'sdehoyos47', 'malgaca', 'lsleed', 'khazanv2', 'alexisdixon6', 'gc_1', 'jinsup2', 'rishu', 'amparo.castro.96', 'tbryan', 'martin32', 'michael.mechelay', 'akash140410107098', 'nowapoca', 'onaam8', 'pablosaavedra', 'camilolcastro97', 'khor', 'ankit6257', 'samashraf1', 'benoiturcotte', 'aishu98', 'rileyroca', 'david.peral.moran', 'kiruthikaabalu181996', 'taymacnichols', 'dhodapp', 'nagihankececi', 'carlosvigo1997', 'moh.ashraf105', 'baleko12345', 'ikhbal', 'afeefz', 'kaustubh.shirpurkar', 'kie180031', 'bflores18', 'tdubnansky6', 'jorgecastelo5', 'andreadiazgar', 'david2397', 'bcperki2', 'melaniejkramer', 'rkchapman', 'jn1404', 'mateocampos', 'jzhan142', 'josepazmartin', 'brannon44', 'arehman4', 'adfoz', 'avw2', 'youxing0309', 'scremin', 'lderemo', 'perezsarmar', 'ashutoshsinghhenry6', 'melroy_caeiro', 'viratbhatt007', 'fkl217', 'coderko3', 'alimatama', 'ammaralaa516', 'nadhnasorudin', 'adarsh123', 'jacquelinethardin', 'mjoza2', 'nihatyavuz', 'estebanrial', 'jinwoo2', 'adnanyuceer', 'danielfernandezcalo', 'berkaydean', 'cloudyoverhead', 'fred_dion', 'syedzakwan', 'e1150590', 'fcfrancapra94', 'amiruldanial99', 'ozbunar01', 'alecorti.pardo', 'electronica18', 'nourananwar123', 'olivier.gilbert.paquet', 'anibarseghyan', 'amlibrahim', 'neuroque', 'kychui2', 'shaf31', 'hong_gao', 'paul.aniruddha', 'carlosbesadaromero', 'mohaballam', 'pip29', 'apb5472', 'tuberkargan', 'hafizmokh99', 'javierisma98', 'fathy1104', 'corredoira', 'helenalecoq97', 'kimzihuang', 'muteki', 'masitadonmez', 'nadja1', 'dancastaneda', 'ahmedsameh1698', 'rocio', 'mallen22', 'ffazul64', 'guoyao', 'ari6nd', 'kerryreto', 'pedrosiaba', 'michaelsaldana1', 'omarmagdy', 'vickytubio', 'ericrobles', 'soccadelic44', 'selena', 'aasifhameed99', 'damlakubattt', 'anxovidal8', 'exjamil', 'jahnavikachhia', 'joker632455', 'vincentpainchaud.vp', 'svo4321', 'zhixin2', 'yansi', 'asyrafaqil', 'xyz11', 'virajput299', 'ryanboucher', 'jpmcgee98', 'mariz', 'bhliu97', 'amrebrahim', 'abdulrahim2905', 'c.a.stupka', 'tonybocadillosgrandes', 'talwren', 'rxtodd', 'farah26', 'tss3', 'abieday1704', 'mavanzato0418', 'facundovia', 'cristinacigarran', 'nazimmath3', 'baohl2', 'ales.gajdacz', 'elad.d', 'kie180028', 'wahidiah52', 'kyang37', 'arifjalani99', 'lino13', 'jaimefookinlannister', 'physquig', 'jaketh2', 'adriancheah', 'jarodm2', 'noureldin1999', 'michael2010814', 'ckim123', 'eddin21', 'jipiccardi', 'prabuddha_888253127', 'david_atef', 'kalebhilde', 'magic_ocean99', 'saipraneett', 'sanchjai', 'omardeyaa', 'pingan99', 'aaq', 'alidsjt', 'mengkem2', 'haclarke', 'oishikfaruque', 'ilou', 'aengm', 'janalorenzolumbreras', 'hilisa', 'carlosvillar54', 'vikazvereva', 'm939454', 'va844', 'pablobou4', 'ludovick.begin', 'maniphysics09', 'eduard25252598', 'apascao', 'xosegq16', 'adam562', 'lauramolinosmayo', 'amni99', 'kie180702', 'saharoaf', 'redzuan11', 'ypp200', 'kph2', 'martinzapata', 'kirolosehab99', 'restep2', 'seifhabib', 'maramtarek53', 'zehuahe2', 'azizijazam11', 'marcosanllo', 'aimansyaz99', 'elizametias12', 'juanmacano97', 'sparshagarwal1009', 'prakharbhargava0', 'njs035', 'alberfn', 'ramy_maged4', 'hmoulvi1', 'vanesagarcia', 'hf4', 'wowmuchchuck', 'mohammedemadeldin2000', 'gabrielyii', 'keerthisv', 'pythagoras2', 'xunyong', 'irenehb92', 'shradhap', 'mohameeddsamy', 'marianne.gratton.1', 'marcmagdy98', 'brknshn', 'gemma', 'lukunze1', 'caglanlee', 'desmondsoon', 'sebasket14', 'masonpb2', 'youssef2042000', 'retty8', 'bharath3', 'syin4', 'ethanmorse', 'ematson5897', 'jacobzeshleman', 'leejq', 'harshini9962', 'reemali99_', 'xxlilmontysignxx', 'ramonruiz.infor', 'atharva98', 'ahern0722', 'chinmayanandadm', 'hishamzakaria20', 'cheokonn', 'adriangarea', 'jeanmichael.deschenes', 'samet1231234', 'mr4425', 'bluelobster', 'justin.lariviere.25', 'dcpang2', 'brokawat', 'felivitullo87', 'puertarcd', 'farahsamir978', 'akozych2', 'nbs691', 'kie180073', 'anwar909', 'bleuminuit', 'atx203', 'kanet1234', 'sealseal', 'emrebuyukkose2', 'arrow823', 'dhvanil', 'nuanno97', 'dkshelat', 'mohabayman', 'ranasherif65', 'diamond92', 'ugur.cankaya.3718', 'ammareltalli', 'acn562', 'nabilah1403', 'yaseminablacandir', 'tamchouweng', 'ablahsaoud', 'sriharshap', 'mrefaat', 'bassamtarek', 'hamidausat', 'kakmeera1999', 'teoster50', 'nolmos96', 'abdurrahmn13', 'mmartinezsanchez', 'sandrabashara', 'zakhwan7', 'chengweiheng', 'nikalyaamani', 'acregodean', 'happyleexin', 'sarapl', 'williammitchell5818', None, 'rooban11', 'yeejou990318', 'kowjiajin', 'nihaosawaddee', 'maxernest', 'david.garrido', 'guibill10', 'mohamedsameh', 'spazos7', 'tmi211', 'kie180039', 'worldlineusaf', 'mgk816', 'kie180079', 'ledicia97', 'movi205', 'shuming2']"
1,272,391,6,1,['perezsarmar'],390,"['oliviercharbonneau', 'miri23', 'ozgurkablan26', 'loisonchambers', 'tuberkargan_97', 'pranjal3', 'musabmalek0717', 'nadanasser1199', 'siemprewowthechami', 'staceyn2', 'vblanco.nico', 'abbesalaeddine', 'efrenhub', 'isabelmaria.vazquez', 'ahmedamr', 'shorouk_ossama', 'rikardberger', 'alancantu57', 'luciano.brignone', 'rahimnoorj', 'janeneil88', 'guttsfulltyagi', 'mjgebara14', 'kartal', 'gabrielyii99', 'aboone06', 'saegner2', 'manuelsomoza94', 'amani12345', 'youssefsherif22', 'j.haliburton', 'amr_ua07', 'evrenyigit', 'tingliang', 'kirankumar94', 'ahagras13', 'njgale01', 'al4995', 'smrdafdl', 'travisc2', 'dlee145', 'stambo', 'anthonyroux', 'ryanorem', 'moh.bahaa', 'ahchehyan', 'aimanadnan', 'veronica.mieites', 's_coriolis', 'trkmengkay', 'cbecker413', 'mcruces.fz', 'latecnologiameodia', 'gxiao2', 'emilechouinard', 'je_guilbert', 'yubai', 'sinasigurpinar', 'lauragdevesa', 'muvafikmelikkaya', 'kason.carroll', 'jbaggie2019', 'annahaozheng0606', 'jtorres17', 'ahmedayman2370', 'zikrizaki88995', 'yjenyiee155', '46harunakgul', 'alifzulkifli99', 'kaitlinh', 'tyy233', 'sdehoyos47', 'malgaca', 'lsleed', 'khazanv2', 'alexisdixon6', 'gc_1', 'jinsup2', 'rishu', 'amparo.castro.96', 'tbryan', 'martin32', 'michael.mechelay', 'akash140410107098', 'nowapoca', 'onaam8', 'pablosaavedra', 'camilolcastro97', 'khor', 'ankit6257', 'samashraf1', 'benoiturcotte', 'aishu98', 'rileyroca', 'david.peral.moran', 'kiruthikaabalu181996', 'taymacnichols', 'dhodapp', 'nagihankececi', 'carlosvigo1997', 'moh.ashraf105', 'baleko12345', 'ikhbal', 'afeefz', 'kaustubh.shirpurkar', 'kie180031', 'bflores18', 'tdubnansky6', 'jorgecastelo5', 'andreadiazgar', 'david2397', 'bcperki2', 'melaniejkramer', 'rkchapman', 'jn1404', 'mateocampos', 'jzhan142', 'josepazmartin', 'brannon44', 'adfoz', 'avw2', 'youxing0309', 'scremin', 'lderemo', 'ashutoshsinghhenry6', 'melroy_caeiro', 'viratbhatt007', 'fkl217', 'coderko3', 'alimatama', 'ammaralaa516', 'nadhnasorudin', 'adarsh123', 'jacquelinethardin', 'mjoza2', 'nihatyavuz', 'estebanrial', 'jinwoo2', 'adnanyuceer', 'danielfernandezcalo', 'berkaydean', 'cloudyoverhead', 'fred_dion', 'syedzakwan', 'e1150590', 'fcfrancapra94', 'amiruldanial99', 'ozbunar01', 'alecorti.pardo', 'electronica18', 'nourananwar123', 'olivier.gilbert.paquet', 'anibarseghyan', 'amlibrahim', 'neuroque', 'kychui2', 'shaf31', 'hong_gao', 'paul.aniruddha', 'carlosbesadaromero', 'mohaballam', 'pip29', 'apb5472', 'tuberkargan', 'hafizmokh99', 'javierisma98', 'fathy1104', 'corredoira', 'helenalecoq97', 'kimzihuang', 'muteki', 'masitadonmez', 'nadja1', 'dancastaneda', 'ahmedsameh1698', 'rocio', 'mallen22', 'ffazul64', 'guoyao', 'ari6nd', 'kerryreto', 'pedrosiaba', 'michaelsaldana1', 'omarmagdy', 'vickytubio', 'ericrobles', 'soccadelic44', 'selena', 'aasifhameed99', 'damlakubattt', 'anxovidal8', 'exjamil', 'jahnavikachhia', 'joker632455', 'vincentpainchaud.vp', 'svo4321', 'zhixin2', 'yansi', 'asyrafaqil', 'xyz11', 'virajput299', 'ryanboucher', 'jpmcgee98', 'mariz', 'bhliu97', 'amrebrahim', 'abdulrahim2905', 'c.a.stupka', 'tonybocadillosgrandes', 'talwren', 'rxtodd', 'farah26', 'tss3', 'abieday1704', 'mavanzato0418', 'facundovia', 'cristinacigarran', 'nazimmath3', 'baohl2', 'ales.gajdacz', 'elad.d', 'kie180028', 'wahidiah52', 'kyang37', 'arifjalani99', 'lino13', 'jaimefookinlannister', 'physquig', 'adriancheah', 'jarodm2', 'noureldin1999', 'michael2010814', 'ckim123', 'eddin21', 'jipiccardi', 'prabuddha_888253127', 'david_atef', 'kalebhilde', 'magic_ocean99', 'saipraneett', 'sanchjai', 'omardeyaa', 'pingan99', 'aaq', 'alidsjt', 'mengkem2', 'haclarke', 'oishikfaruque', 'ilou', 'aengm', 'janalorenzolumbreras', 'hilisa', 'carlosvillar54', 'vikazvereva', 'm939454', 'va844', 'pablobou4', 'ludovick.begin', 'maniphysics09', 'eduard25252598', 'apascao', 'xosegq16', 'adam562', 'lauramolinosmayo', 'amni99', 'kie180702', 'saharoaf', 'redzuan11', 'ypp200', 'kph2', 'martinzapata', 'kirolosehab99', 'restep2', 'seifhabib', 'maramtarek53', 'zehuahe2', 'azizijazam11', 'marcosanllo', 'aimansyaz99', 'elizametias12', 'juanmacano97', 'sparshagarwal1009', 'prakharbhargava0', 'njs035', 'alberfn', 'ramy_maged4', 'hmoulvi1', 'vanesagarcia', 'hf4', 'wowmuchchuck', 'mohammedemadeldin2000', 'gabrielyii', 'keerthisv', 'pythagoras2', 'xunyong', 'irenehb92', 'shradhap', 'mohameeddsamy', 'marianne.gratton.1', 'marcmagdy98', 'brknshn', 'gemma', 'lukunze1', 'caglanlee', 'desmondsoon', 'sebasket14', 'masonpb2', 'youssef2042000', 'retty8', 'bharath3', 'syin4', 'ethanmorse', 'ematson5897', 'jacobzeshleman', 'leejq', 'harshini9962', 'reemali99_', 'xxlilmontysignxx', 'ramonruiz.infor', 'atharva98', 'ahern0722', 'hishamzakaria20', 'cheokonn', 'adriangarea', 'jeanmichael.deschenes', 'samet1231234', 'mr4425', 'bluelobster', 'justin.lariviere.25', 'dcpang2', 'felivitullo87', 'puertarcd', 'farahsamir978', 'akozych2', 'nbs691', 'kie180073', 'anwar909', 'bleuminuit', 'atx203', 'kanet1234', 'sealseal', 'emrebuyukkose2', 'arrow823', 'dhvanil', 'nuanno97', 'dkshelat', 'mohabayman', 'ranasherif65', 'diamond92', 'ugur.cankaya.3718', 'ammareltalli', 'acn562', 'nabilah1403', 'yaseminablacandir', 'tamchouweng', 'ablahsaoud', 'sriharshap', 'mrefaat', 'bassamtarek', 'hamidausat', 'kakmeera1999', 'teoster50', 'nolmos96', 'abdurrahmn13', 'mmartinezsanchez', 'sandrabashara', 'zakhwan7', 'chengweiheng', 'nikalyaamani', 'acregodean', 'happyleexin', 'sarapl', 'williammitchell5818', 'rooban11', 'yeejou990318', 'kowjiajin', 'nihaosawaddee', 'maxernest', 'david.garrido', 'guibill10', 'mohamedsameh', 'spazos7', 'tmi211', 'kie180039', 'worldlineusaf', 'mgk816', 'kie180079', 'ledicia97', 'movi205', 'shuming2']",5,"['aronchino6', 'paularodriguez', 'gombut', 'pvalladaresfdez', None]",396,"['oliviercharbonneau', 'miri23', 'ozgurkablan26', 'loisonchambers', 'tuberkargan_97', 'pranjal3', 'musabmalek0717', 'nadanasser1199', 'siemprewowthechami', 'staceyn2', 'vblanco.nico', 'abbesalaeddine', 'efrenhub', 'isabelmaria.vazquez', 'ahmedamr', 'shorouk_ossama', 'rikardberger', 'alancantu57', 'luciano.brignone', 'rahimnoorj', 'janeneil88', 'guttsfulltyagi', 'mjgebara14', 'kartal', 'gabrielyii99', 'aboone06', 'saegner2', 'manuelsomoza94', 'amani12345', 'youssefsherif22', 'j.haliburton', 'amr_ua07', 'evrenyigit', 'tingliang', 'kirankumar94', 'ahagras13', 'njgale01', 'al4995', 'smrdafdl', 'travisc2', 'dlee145', 'stambo', 'anthonyroux', 'ryanorem', 'moh.bahaa', 'ahchehyan', 'aimanadnan', 'veronica.mieites', 's_coriolis', 'trkmengkay', 'cbecker413', 'mcruces.fz', 'latecnologiameodia', 'gxiao2', 'emilechouinard', 'je_guilbert', 'yubai', 'sinasigurpinar', 'lauragdevesa', 'muvafikmelikkaya', 'kason.carroll', 'jbaggie2019', 'annahaozheng0606', 'jtorres17', 'ahmedayman2370', 'zikrizaki88995', 'yjenyiee155', '46harunakgul', 'alifzulkifli99', 'kaitlinh', 'tyy233', 'sdehoyos47', 'malgaca', 'lsleed', 'khazanv2', 'alexisdixon6', 'gc_1', 'jinsup2', 'rishu', 'amparo.castro.96', 'tbryan', 'martin32', 'michael.mechelay', 'akash140410107098', 'nowapoca', 'onaam8', 'pablosaavedra', 'camilolcastro97', 'khor', 'ankit6257', 'samashraf1', 'benoiturcotte', 'aishu98', 'rileyroca', 'david.peral.moran', 'kiruthikaabalu181996', 'taymacnichols', 'dhodapp', 'nagihankececi', 'carlosvigo1997', 'moh.ashraf105', 'baleko12345', 'ikhbal', 'afeefz', 'kaustubh.shirpurkar', 'kie180031', 'bflores18', 'tdubnansky6', 'jorgecastelo5', 'andreadiazgar', 'david2397', 'bcperki2', 'melaniejkramer', 'rkchapman', 'jn1404', 'mateocampos', 'jzhan142', 'josepazmartin', 'brannon44', 'adfoz', 'avw2', 'youxing0309', 'scremin', 'lderemo', 'perezsarmar', 'ashutoshsinghhenry6', 'melroy_caeiro', 'viratbhatt007', 'fkl217', 'coderko3', 'alimatama', 'ammaralaa516', 'nadhnasorudin', 'adarsh123', 'jacquelinethardin', 'mjoza2', 'nihatyavuz', 'estebanrial', 'jinwoo2', 'adnanyuceer', 'danielfernandezcalo', 'berkaydean', 'cloudyoverhead', 'fred_dion', 'syedzakwan', 'e1150590', 'fcfrancapra94', 'amiruldanial99', 'ozbunar01', 'alecorti.pardo', 'electronica18', 'nourananwar123', 'olivier.gilbert.paquet', 'anibarseghyan', 'amlibrahim', 'neuroque', 'kychui2', 'shaf31', 'hong_gao', 'aronchino6', 'paul.aniruddha', 'carlosbesadaromero', 'mohaballam', 'pip29', 'apb5472', 'tuberkargan', 'hafizmokh99', 'javierisma98', 'fathy1104', 'corredoira', 'helenalecoq97', 'kimzihuang', 'muteki', 'masitadonmez', 'nadja1', 'dancastaneda', 'ahmedsameh1698', 'rocio', 'mallen22', 'ffazul64', 'guoyao', 'ari6nd', 'kerryreto', 'pedrosiaba', 'michaelsaldana1', 'omarmagdy', 'vickytubio', 'ericrobles', 'soccadelic44', 'selena', 'aasifhameed99', 'damlakubattt', 'anxovidal8', 'exjamil', 'jahnavikachhia', 'joker632455', 'vincentpainchaud.vp', 'svo4321', 'zhixin2', 'yansi', 'asyrafaqil', 'xyz11', 'virajput299', 'paularodriguez', 'ryanboucher', 'jpmcgee98', 'mariz', 'bhliu97', 'amrebrahim', 'abdulrahim2905', 'c.a.stupka', 'tonybocadillosgrandes', 'talwren', 'rxtodd', 'farah26', 'tss3', 'abieday1704', 'mavanzato0418', 'gombut', 'facundovia', 'cristinacigarran', 'nazimmath3', 'baohl2', 'ales.gajdacz', 'elad.d', 'kie180028', 'wahidiah52', 'kyang37', 'arifjalani99', 'lino13', 'jaimefookinlannister', 'physquig', 'adriancheah', 'jarodm2', 'noureldin1999', 'michael2010814', 'ckim123', 'eddin21', 'jipiccardi', 'prabuddha_888253127', 'david_atef', 'pvalladaresfdez', 'kalebhilde', 'magic_ocean99', 'saipraneett', 'sanchjai', 'omardeyaa', 'pingan99', 'aaq', 'alidsjt', 'mengkem2', 'haclarke', 'oishikfaruque', 'ilou', 'aengm', 'janalorenzolumbreras', 'hilisa', 'carlosvillar54', 'vikazvereva', 'm939454', 'va844', 'pablobou4', 'ludovick.begin', 'maniphysics09', 'eduard25252598', 'apascao', 'xosegq16', 'adam562', 'lauramolinosmayo', 'amni99', 'kie180702', 'saharoaf', 'redzuan11', 'ypp200', 'kph2', 'martinzapata', 'kirolosehab99', 'restep2', 'seifhabib', 'maramtarek53', 'zehuahe2', 'azizijazam11', 'marcosanllo', 'aimansyaz99', 'elizametias12', 'juanmacano97', 'sparshagarwal1009', 'prakharbhargava0', 'njs035', 'alberfn', 'ramy_maged4', 'hmoulvi1', 'vanesagarcia', 'hf4', 'wowmuchchuck', 'mohammedemadeldin2000', 'gabrielyii', 'keerthisv', 'pythagoras2', 'xunyong', 'irenehb92', 'shradhap', 'mohameeddsamy', 'marianne.gratton.1', 'marcmagdy98', 'brknshn', 'gemma', 'lukunze1', 'caglanlee', 'desmondsoon', 'sebasket14', 'masonpb2', 'youssef2042000', 'retty8', 'bharath3', 'syin4', 'ethanmorse', 'ematson5897', 'jacobzeshleman', 'leejq', 'harshini9962', 'reemali99_', 'xxlilmontysignxx', 'ramonruiz.infor', 'atharva98', 'ahern0722', 'hishamzakaria20', 'cheokonn', 'adriangarea', 'jeanmichael.deschenes', 'samet1231234', 'mr4425', 'bluelobster', 'justin.lariviere.25', 'dcpang2', 'felivitullo87', 'puertarcd', 'farahsamir978', 'akozych2', 'nbs691', 'kie180073', 'anwar909', 'bleuminuit', 'atx203', 'kanet1234', 'sealseal', 'emrebuyukkose2', 'arrow823', 'dhvanil', 'nuanno97', 'dkshelat', 'mohabayman', 'ranasherif65', 'diamond92', 'ugur.cankaya.3718', 'ammareltalli', 'acn562', 'nabilah1403', 'yaseminablacandir', 'tamchouweng', 'ablahsaoud', 'sriharshap', 'mrefaat', 'bassamtarek', 'hamidausat', 'kakmeera1999', 'teoster50', 'nolmos96', 'abdurrahmn13', 'mmartinezsanchez', 'sandrabashara', 'zakhwan7', 'chengweiheng', 'nikalyaamani', 'acregodean', 'happyleexin', 'sarapl', 'williammitchell5818', None, 'rooban11', 'yeejou990318', 'kowjiajin', 'nihaosawaddee', 'maxernest', 'david.garrido', 'guibill10', 'mohamedsameh', 'spazos7', 'tmi211', 'kie180039', 'worldlineusaf', 'mgk816', 'kie180079', 'ledicia97', 'movi205', 'shuming2']"
2,70,178,127,80,"['btestin14', 'ryan.wiebe', 'nt230', 'wstolz', 'itsmemario', 'tgiazzon', 'jkekre', 'mcrees', 'buck17', 'cputt', 'alyssamcnarney', 'anthonm', 'hkohart', 'dgreiwe', 'jstalbaum', 'rishiprasadha', 'akonopa', 'hess35', 'crhodine', 'tilley0', 'mingusnate', 'kjh94425', 'dodge4', 'mcclure8', 'nikhilcarneiro4', 'hkaakeh', 'herr13', 'nggoodie98', 'rsusler', 'imran3', 'vcotta', 'goh5', 'singh378', 'rileyedelaney', 'akreuter', 'osborn45', 'suhaira97', 'john1886', 'cmelchin', 'charlesma423', 'ryanwest1040', 'george7elias', 'rjleach', 'boninim', 'cclapham', 'fischermben', 'landon.glunt', 'ebergqu', 'nathanmoore', 'angbecker', 'ebehring', 'treyfinn98', 'canadaman87', 'mishra59', 'snowh5696', 'cartmaster007', 'baker428', 'munselltom', 'chiranth7954', 'shadow66666', 'talon34567', 'jacobglvn', 'jfolkers', 'joshuajkporter', 'suran9712', 'oliver67', 'asartor', 'jswetlik', 'maxwellfra16', 'garret28', 'cameronfritts12', 'kruege14', 'kknowlto', 'jskeens', 'acostab', 'jklaben', 'lmeehann', 'mccaul', 'yhoashi', 'rao53']",97,"['ggauthi', 'hungergame34', 'sahilshah16', 'fvora', 'taylo620', 'ellis71', 'bkiep', 'mnishat', 'conner.swift8', 'mikecpmonkey77', 'hdeboer00', 'evdaly', 'graha167', 'semond', 'tanderto', 'jdanek', 'deyu23huang', 'scoan', 'kgmcginley', 'nstreb', 'jaggarw', 'jmojazza', 'thedhowithpants', 'alineelquist', 'enadler', 'smanspencer', 'cmeiste', 'tobitrack55', 'wang4150', 'sweis97', 'bihmike', 'mart1226', 'fahughes1999', 'swttprsjtu', 'wbaioni', 'srasche', 'eiglehar', 'nbitner', 'kentoneriksen', 'dsfgdsfg', 'claszlo', 'khageman', 'benoit1', 'sknecht', 'lesteryhz', 'lsailor', 'aratkov', 'peter411', 'geyerg', 'isaaclandstoffer', 'reddy37', 'alexdobbins98', 'yeager5', 'bsmrdel', 'vpope', 'yang1206', 'ikobayas', 'robo698', 'lee2370', 'guenthee2020', 'justj', 'xy.sean.liu', 'jbartlin', 'lakmanligil', 'ashleydavis', 'ggolla', 'lise_lpz', 'ryry1644', 'dschull', 'cho246', 'hyndmanjustin', 'ling36', 'ggoldate', 'jschorfh', 'finn5', 'nhdorcy', 'manjaekim96', 'kirchhof', 'kskripakaran0810', 'mitchpohlman', 'rhellyer', 'jmacklem', 'zjohnson834', 'albrect', 'heinzt', 'mengelh', 'emcdonn', 'bean16', 'ayermemb', 'skantawa', 'lrussell71', 'simekc', 'snead', 'kico', 'rodri454', 'evandaele3', 'mlinsin']",47,"['htorsina', 'sfgdfgdfg', 'jwoon', 'kellhages37', 'white519', 'nmcphero', 'tylera2104', 'ehonebri', 'ckroger', 'kamranahmed', 'fahimvora12', 'agalema1027', 'swift8', 'draosmail', 'jacob_just', 'rachel318318', 'agarw105', 'akreilein', 'ksjolund', 'afalkenb', 'royriveraf', 'rice103', 'jacobpeterson698', 'rkwiatko', 'hanmoyuan1997', 'wdrummon', 'greid09', 'kkamiya', 'wallac68', 'spring12', 'dkilgor', 'psumner', 'davi1004', 'sammyknecht', 'sueprasad8214', 'hannahdeboer0015', 'kewlkahtz', 'batram197', 'brandt18', 'amckeska', 'bradsmrdel', 'mcclurez', 'kevinodonnell0878', 'aboza', 'k.ico246', 'shaunak0304', 'ikstealth']",224,"['ggauthi', 'hungergame34', 'tylera2104', 'sahilshah16', 'fvora', 'taylo620', 'btestin14', 'ellis71', 'bkiep', 'ryan.wiebe', 'jacob_just', 'nt230', 'wstolz', 'agarw105', 'mnishat', 'conner.swift8', 'itsmemario', 'afalkenb', 'tgiazzon', 'mikecpmonkey77', 'hdeboer00', 'evdaly', 'jkekre', 'semond', 'graha167', 'rkwiatko', 'mcrees', 'tanderto', 'jdanek', 'buck17', 'deyu23huang', 'scoan', 'psumner', 'kgmcginley', 'sammyknecht', 'nstreb', 'jaggarw', 'cputt', 'sueprasad8214', 'hannahdeboer0015', 'amckeska', 'mcclurez', 'alyssamcnarney', 'jmojazza', 'thedhowithpants', 'shaunak0304', 'anthonm', 'alineelquist', 'enadler', 'hkohart', 'dgreiwe', 'smanspencer', 'sfgdfgdfg', 'jstalbaum', 'fahimvora12', 'rishiprasadha', 'cmeiste', 'tobitrack55', 'swift8', 'draosmail', 'akonopa', 'hess35', 'wang4150', 'sweis97', 'bihmike', 'tilley0', 'mingusnate', 'kjh94425', 'crhodine', 'mart1226', 'fahughes1999', 'dodge4', 'rice103', 'mcclure8', 'nikhilcarneiro4', 'wbaioni', 'hkaakeh', 'swttprsjtu', 'kkamiya', 'herr13', 'srasche', 'nggoodie98', 'rsusler', 'eiglehar', 'imran3', 'nbitner', 'batram197', 'brandt18', 'kentoneriksen', 'dsfgdsfg', 'claszlo', 'bradsmrdel', 'khageman', 'benoit1', 'vcotta', 'goh5', 'sknecht', 'lesteryhz', 'lsailor', 'singh378', 'rileyedelaney', 'peter411', 'aratkov', 'geyerg', 'isaaclandstoffer', 'reddy37', 'alexdobbins98', 'akreuter', 'yeager5', 'bsmrdel', 'kamranahmed', 'osborn45', 'vpope', 'yang1206', 'ikobayas', 'suhaira97', 'akreilein', 'robo698', 'lee2370', 'john1886', 'guenthee2020', 'ryanwest1040', 'charlesma423', 'george7elias', 'cmelchin', 'xy.sean.liu', 'justj', 'ksjolund', 'rjleach', 'boninim', 'cclapham', 'fischermben', 'jbartlin', 'greid09', 'landon.glunt', 'spring12', 'ebergqu', 'lakmanligil', 'davi1004', 'nathanmoore', 'angbecker', 'ashleydavis', 'ggolla', 'kewlkahtz', 'lise_lpz', 'ebehring', 'treyfinn98', 'ryry1644', 'mishra59', 'dschull', 'canadaman87', 'aboza', 'snowh5696', 'cho246', 'hyndmanjustin', 'cartmaster007', 'baker428', 'ling36', 'munselltom', 'ggoldate', 'jschorfh', 'ikstealth', 'finn5', 'chiranth7954', 'htorsina', 'jwoon', 'kellhages37', 'white519', 'nmcphero', 'nhdorcy', 'shadow66666', 'ckroger', 'manjaekim96', 'ehonebri', 'talon34567', 'jacobglvn', 'agalema1027', 'jfolkers', 'joshuajkporter', 'rachel318318', 'suran9712', 'kirchhof', 'oliver67', 'kskripakaran0810', 'asartor', 'royriveraf', 'mitchpohlman', 'jacobpeterson698', 'jswetlik', 'rhellyer', 'garret28', 'jmacklem', 'maxwellfra16', 'cameronfritts12', 'zjohnson834', 'hanmoyuan1997', 'wdrummon', 'kruege14', 'albrect', 'wallac68', 'heinzt', 'dkilgor', 'mengelh', 'emcdonn', 'kknowlto', 'ayermemb', 'bean16', 'jskeens', 'skantawa', 'lrussell71', 'simekc', 'acostab', 'snead', 'jklaben', 'kevinodonnell0878', 'lmeehann', 'kico', 'mccaul', 'k.ico246', 'yhoashi', 'rodri454', 'evandaele3', 'rao53', 'mlinsin']"
2,216,178,126,83,"['ggauthi', 'btestin14', 'nt230', 'wstolz', 'itsmemario', 'conner.swift8', 'tgiazzon', 'evdaly', 'jkekre', 'mcrees', 'jdanek', 'kgmcginley', 'anthonm', 'dgreiwe', 'rishiprasadha', 'akonopa', 'hess35', 'tilley0', 'crhodine', 'mingusnate', 'kjh94425', 'mcclure8', 'nikhilcarneiro4', 'srasche', 'rsusler', 'dsfgdsfg', 'khageman', 'sknecht', 'goh5', 'singh378', 'rileyedelaney', 'geyerg', 'akreuter', 'yeager5', 'bsmrdel', 'vpope', 'suhaira97', 'ikobayas', 'yang1206', 'lee2370', 'john1886', 'justj', 'cmelchin', 'ryanwest1040', 'charlesma423', 'george7elias', 'boninim', 'cclapham', 'fischermben', 'landon.glunt', 'nathanmoore', 'angbecker', 'ggolla', 'ebehring', 'ryry1644', 'dschull', 'cartmaster007', 'hyndmanjustin', 'chiranth7954', 'nhdorcy', 'shadow66666', 'talon34567', 'jacobglvn', 'jfolkers', 'joshuajkporter', 'suran9712', 'oliver67', 'kskripakaran0810', 'asartor', 'maxwellfra16', 'garret28', 'zjohnson834', 'rhellyer', 'kruege14', 'albrect', 'heinzt', 'kknowlto', 'jskeens', 'acostab', 'lmeehann', 'kico', 'mccaul', 'rao53']",94,"['hungergame34', 'sahilshah16', 'fvora', 'taylo620', 'ellis71', 'bkiep', 'ryan.wiebe', 'mnishat', 'mikecpmonkey77', 'hdeboer00', 'graha167', 'semond', 'tanderto', 'buck17', 'deyu23huang', 'scoan', 'nstreb', 'jaggarw', 'cputt', 'alyssamcnarney', 'jmojazza', 'thedhowithpants', 'alineelquist', 'enadler', 'hkohart', 'smanspencer', 'jstalbaum', 'cmeiste', 'tobitrack55', 'wang4150', 'sweis97', 'bihmike', 'mart1226', 'fahughes1999', 'dodge4', 'swttprsjtu', 'wbaioni', 'hkaakeh', 'herr13', 'nggoodie98', 'eiglehar', 'imran3', 'nbitner', 'kentoneriksen', 'claszlo', 'benoit1', 'vcotta', 'lesteryhz', 'lsailor', 'aratkov', 'peter411', 'isaaclandstoffer', 'reddy37', 'alexdobbins98', 'osborn45', 'robo698', 'guenthee2020', 'xy.sean.liu', 'rjleach', 'jbartlin', 'ebergqu', 'lakmanligil', 'ashleydavis', 'lise_lpz', 'treyfinn98', 'canadaman87', 'mishra59', 'snowh5696', 'cho246', 'baker428', 'ling36', 'munselltom', 'ggoldate', 'jschorfh', 'finn5', 'manjaekim96', 'kirchhof', 'mitchpohlman', 'jswetlik', 'jmacklem', 'cameronfritts12', 'mengelh', 'emcdonn', 'bean16', 'ayermemb', 'skantawa', 'lrussell71', 'simekc', 'snead', 'jklaben', 'yhoashi', 'rodri454', 'evandaele3', 'mlinsin']",43,"['smit3180', 'arturotrevino', 'wan52', 'jwoon', 'caldwe29', 'shaw108', 'ehonebri', 'vwallema', 'huan1146', 'radhakr3', 'cpiepen', 'agalema1027', 'starr21', 'xng', 'eforti', 'jrohman', 'afalkenb', 'jkueche', 'nramli', 'ecronin', 'dkilgor', 'psumner', 'cbischof', 'akreilei', 'rao75', 'rwiebe', 'samm', 'sueprasad8214', 'chanwoo.lee.17', 'mcdona85', None, 'river132', 'amckeska', 'yizhizhang', 'selawada', 'tthieles', 'kevinodonnell0878', 'nafandi', 'purduechen2203', 'davids19', 'muelle77', 'aguyre', 'athoman']",220,"['ggauthi', 'hungergame34', 'arturotrevino', 'wan52', 'sahilshah16', 'fvora', 'taylo620', 'btestin14', 'vwallema', 'ellis71', 'starr21', 'bkiep', 'ryan.wiebe', 'nt230', 'wstolz', 'xng', 'mnishat', 'conner.swift8', 'itsmemario', 'eforti', 'afalkenb', 'tgiazzon', 'mikecpmonkey77', 'hdeboer00', 'evdaly', 'jkekre', 'semond', 'graha167', 'mcrees', 'tanderto', 'jdanek', 'buck17', 'deyu23huang', 'scoan', 'psumner', 'cbischof', 'kgmcginley', 'nstreb', 'jaggarw', 'cputt', 'sueprasad8214', 'amckeska', 'alyssamcnarney', 'nafandi', 'jmojazza', 'thedhowithpants', 'davids19', 'anthonm', 'alineelquist', 'enadler', 'hkohart', 'dgreiwe', 'smit3180', 'smanspencer', 'jstalbaum', 'rishiprasadha', 'cmeiste', 'tobitrack55', 'akonopa', 'hess35', 'wang4150', 'sweis97', 'bihmike', 'tilley0', 'mingusnate', 'kjh94425', 'crhodine', 'mart1226', 'fahughes1999', 'dodge4', 'mcclure8', 'nikhilcarneiro4', 'wbaioni', 'hkaakeh', 'swttprsjtu', 'herr13', 'srasche', 'nggoodie98', 'rsusler', 'rwiebe', 'eiglehar', 'imran3', 'nbitner', 'river132', 'kentoneriksen', 'dsfgdsfg', 'claszlo', 'selawada', 'tthieles', 'khageman', 'benoit1', 'vcotta', 'goh5', 'sknecht', 'lesteryhz', 'lsailor', 'muelle77', 'aguyre', 'singh378', 'rileyedelaney', 'peter411', 'aratkov', 'geyerg', 'isaaclandstoffer', 'reddy37', 'alexdobbins98', 'akreuter', 'yeager5', 'bsmrdel', 'osborn45', 'vpope', 'yang1206', 'ikobayas', 'suhaira97', 'robo698', 'lee2370', 'jrohman', 'john1886', 'guenthee2020', 'ryanwest1040', 'charlesma423', 'george7elias', 'cmelchin', 'xy.sean.liu', 'justj', 'rjleach', 'boninim', 'cclapham', 'fischermben', 'jbartlin', 'landon.glunt', 'ebergqu', 'lakmanligil', 'rao75', 'nathanmoore', 'angbecker', 'ashleydavis', 'samm', 'ggolla', 'chanwoo.lee.17', 'lise_lpz', 'ebehring', 'treyfinn98', 'ryry1644', 'mishra59', 'dschull', 'canadaman87', 'purduechen2203', 'snowh5696', 'cho246', 'hyndmanjustin', 'cartmaster007', 'baker428', 'ling36', 'munselltom', 'ggoldate', 'jschorfh', 'finn5', 'chiranth7954', 'jwoon', 'caldwe29', 'shaw108', 'nhdorcy', 'shadow66666', 'ehonebri', 'manjaekim96', 'talon34567', 'jacobglvn', 'huan1146', 'jfolkers', 'radhakr3', 'cpiepen', 'joshuajkporter', 'agalema1027', 'suran9712', 'kirchhof', 'oliver67', 'kskripakaran0810', 'asartor', 'mitchpohlman', 'jswetlik', 'rhellyer', 'garret28', 'jmacklem', 'maxwellfra16', 'cameronfritts12', 'zjohnson834', 'jkueche', 'kruege14', 'albrect', 'nramli', 'ecronin', 'heinzt', 'dkilgor', 'mengelh', 'akreilei', 'emcdonn', 'mcdona85', 'kknowlto', 'ayermemb', 'bean16', 'jskeens', 'skantawa', 'lrussell71', None, 'simekc', 'acostab', 'snead', 'yizhizhang', 'jklaben', 'kevinodonnell0878', 'lmeehann', 'kico', 'mccaul', 'yhoashi', 'rodri454', 'evandaele3', 'rao53', 'mlinsin', 'athoman']"
2,206,178,119,94,"['bkiep', 'ryan.wiebe', 'nt230', 'wstolz', 'itsmemario', 'conner.swift8', 'tgiazzon', 'evdaly', 'mcrees', 'tanderto', 'jdanek', 'buck17', 'scoan', 'kgmcginley', 'cputt', 'anthonm', 'alineelquist', 'jstalbaum', 'rishiprasadha', 'cmeiste', 'akonopa', 'hess35', 'wang4150', 'crhodine', 'mingusnate', 'kjh94425', 'dodge4', 'mcclure8', 'hkaakeh', 'herr13', 'srasche', 'nggoodie98', 'rsusler', 'nbitner', 'dsfgdsfg', 'benoit1', 'khageman', 'sknecht', 'goh5', 'lesteryhz', 'aratkov', 'akreuter', 'osborn45', 'robo698', 'john1886', 'guenthee2020', 'cmelchin', 'ryanwest1040', 'george7elias', 'justj', 'rjleach', 'boninim', 'cclapham', 'fischermben', 'jbartlin', 'landon.glunt', 'ebergqu', 'nathanmoore', 'angbecker', 'ebehring', 'ryry1644', 'canadaman87', 'dschull', 'mishra59', 'snowh5696', 'cartmaster007', 'baker428', 'finn5', 'nhdorcy', 'shadow66666', 'talon34567', 'jfolkers', 'joshuajkporter', 'suran9712', 'oliver67', 'asartor', 'jswetlik', 'maxwellfra16', 'garret28', 'zjohnson834', 'jmacklem', 'cameronfritts12', 'kruege14', 'albrect', 'heinzt', 'kknowlto', 'jskeens', 'jklaben', 'lmeehann', 'kico', 'mccaul', 'rodri454', 'evandaele3', 'rao53']",83,"['ggauthi', 'hungergame34', 'sahilshah16', 'fvora', 'taylo620', 'btestin14', 'ellis71', 'mnishat', 'mikecpmonkey77', 'hdeboer00', 'graha167', 'semond', 'jkekre', 'deyu23huang', 'nstreb', 'jaggarw', 'alyssamcnarney', 'jmojazza', 'thedhowithpants', 'enadler', 'hkohart', 'dgreiwe', 'smanspencer', 'tobitrack55', 'sweis97', 'bihmike', 'tilley0', 'mart1226', 'fahughes1999', 'swttprsjtu', 'nikhilcarneiro4', 'wbaioni', 'eiglehar', 'imran3', 'kentoneriksen', 'claszlo', 'vcotta', 'lsailor', 'singh378', 'rileyedelaney', 'peter411', 'geyerg', 'isaaclandstoffer', 'reddy37', 'alexdobbins98', 'yeager5', 'bsmrdel', 'vpope', 'yang1206', 'ikobayas', 'suhaira97', 'lee2370', 'charlesma423', 'xy.sean.liu', 'lakmanligil', 'ashleydavis', 'ggolla', 'lise_lpz', 'treyfinn98', 'cho246', 'hyndmanjustin', 'ling36', 'munselltom', 'ggoldate', 'jschorfh', 'chiranth7954', 'manjaekim96', 'jacobglvn', 'kirchhof', 'kskripakaran0810', 'mitchpohlman', 'rhellyer', 'mengelh', 'emcdonn', 'bean16', 'ayermemb', 'skantawa', 'lrussell71', 'simekc', 'acostab', 'snead', 'yhoashi', 'mlinsin']",25,"['htorsina', 'prasad25', 'rwasem', 'huan1146', 'radhakr3', 'agalema1027', 'amagro', 'afalkenb', 'nriaziat', 'smoinudd', 'kkamiya', 'akreilei', 'mzentner', 'julianjros', None, 'river132', 'yizhizhang', 'engineeringkenyahub', 'sumner3', 'mcclurez', 'kevinodonnell0878', 'inormile', 'jmaillet', 'rice125', 'athoman']",202,"['ggauthi', 'hungergame34', 'sahilshah16', 'fvora', 'taylo620', 'btestin14', 'ellis71', 'bkiep', 'ryan.wiebe', 'nt230', 'wstolz', 'mnishat', 'conner.swift8', 'itsmemario', 'afalkenb', 'tgiazzon', 'mikecpmonkey77', 'hdeboer00', 'evdaly', 'jkekre', 'semond', 'graha167', 'mcrees', 'tanderto', 'jdanek', 'buck17', 'deyu23huang', 'scoan', 'kgmcginley', 'nstreb', 'jaggarw', 'cputt', 'mcclurez', 'alyssamcnarney', 'jmojazza', 'thedhowithpants', 'jmaillet', 'anthonm', 'alineelquist', 'enadler', 'hkohart', 'dgreiwe', 'smanspencer', 'jstalbaum', 'rishiprasadha', 'cmeiste', 'tobitrack55', 'akonopa', 'hess35', 'wang4150', 'sweis97', 'bihmike', 'tilley0', 'mingusnate', 'kjh94425', 'crhodine', 'mart1226', 'fahughes1999', 'dodge4', 'nriaziat', 'mcclure8', 'nikhilcarneiro4', 'wbaioni', 'hkaakeh', 'swttprsjtu', 'kkamiya', 'herr13', 'srasche', 'nggoodie98', 'rsusler', 'eiglehar', 'imran3', 'nbitner', 'river132', 'kentoneriksen', 'dsfgdsfg', 'claszlo', 'khageman', 'benoit1', 'vcotta', 'inormile', 'goh5', 'sknecht', 'lesteryhz', 'lsailor', 'singh378', 'rileyedelaney', 'peter411', 'aratkov', 'geyerg', 'isaaclandstoffer', 'reddy37', 'alexdobbins98', 'akreuter', 'yeager5', 'bsmrdel', 'prasad25', 'rwasem', 'osborn45', 'vpope', 'yang1206', 'ikobayas', 'suhaira97', 'robo698', 'lee2370', 'amagro', 'john1886', 'guenthee2020', 'ryanwest1040', 'charlesma423', 'george7elias', 'cmelchin', 'xy.sean.liu', 'justj', 'rjleach', 'boninim', 'cclapham', 'fischermben', 'jbartlin', 'landon.glunt', 'ebergqu', 'lakmanligil', 'nathanmoore', 'angbecker', 'ashleydavis', 'julianjros', 'ggolla', 'lise_lpz', 'ebehring', 'treyfinn98', 'ryry1644', 'mishra59', 'dschull', 'canadaman87', 'engineeringkenyahub', 'snowh5696', 'cho246', 'hyndmanjustin', 'cartmaster007', 'baker428', 'ling36', 'munselltom', 'ggoldate', 'jschorfh', 'finn5', 'chiranth7954', 'htorsina', 'nhdorcy', 'shadow66666', 'manjaekim96', 'talon34567', 'jacobglvn', 'huan1146', 'jfolkers', 'radhakr3', 'agalema1027', 'joshuajkporter', 'suran9712', 'kirchhof', 'oliver67', 'kskripakaran0810', 'asartor', 'mitchpohlman', 'jswetlik', 'rhellyer', 'garret28', 'jmacklem', 'maxwellfra16', 'cameronfritts12', 'zjohnson834', 'smoinudd', 'kruege14', 'albrect', 'heinzt', 'mengelh', 'akreilei', 'emcdonn', 'mzentner', 'kknowlto', 'ayermemb', 'bean16', 'jskeens', 'skantawa', 'lrussell71', None, 'simekc', 'acostab', 'snead', 'yizhizhang', 'jklaben', 'sumner3', 'kevinodonnell0878', 'lmeehann', 'kico', 'mccaul', 'yhoashi', 'rodri454', 'evandaele3', 'rao53', 'mlinsin', 'rice125', 'athoman']"
2,207,178,82,74,"['ggauthi', 'akreuter', 'shadow66666', 'jacobglvn', 'btestin14', 'cmeiste', 'jfolkers', 'tobitrack55', 'joshuajkporter', 'ryan.wiebe', 'yang1206', 'nt230', 'wstolz', 'suhaira97', 'ikobayas', 'vpope', 'robo698', 'chiranth7954', 'conner.swift8', 'hess35', 'oliver67', 'kskripakaran0810', 'john1886', 'wang4150', 'tgiazzon', 'crhodine', 'bihmike', 'mingusnate', 'ryanwest1040', 'cmelchin', 'mart1226', 'dodge4', 'rjleach', 'cclapham', 'jkekre', 'semond', 'fischermben', 'garret28', 'mcclure8', 'zjohnson834', 'kruege14', 'landon.glunt', 'mcrees', 'heinzt', 'buck17', 'nggoodie98', 'mlinsin', 'rsusler', 'kgmcginley', 'nathanmoore', 'angbecker', 'jaggarw', 'cputt', 'kknowlto', 'jskeens', 'dsfgdsfg', 'acostab', 'ryry1644', 'khageman', 'treyfinn98', 'dschull', 'jklaben', 'sknecht', 'kico', 'mccaul', 'cartmaster007', 'hyndmanjustin', 'baker428', 'munselltom', 'rao53', 'anthonm', 'enadler', 'dgreiwe', 'rileyedelaney']",103,"['hungergame34', 'sahilshah16', 'fvora', 'taylo620', 'ellis71', 'bkiep', 'mnishat', 'itsmemario', 'mikecpmonkey77', 'hdeboer00', 'evdaly', 'graha167', 'tanderto', 'jdanek', 'deyu23huang', 'scoan', 'nstreb', 'alyssamcnarney', 'jmojazza', 'thedhowithpants', 'alineelquist', 'hkohart', 'smanspencer', 'jstalbaum', 'rishiprasadha', 'akonopa', 'sweis97', 'tilley0', 'kjh94425', 'fahughes1999', 'swttprsjtu', 'nikhilcarneiro4', 'wbaioni', 'hkaakeh', 'herr13', 'srasche', 'eiglehar', 'imran3', 'nbitner', 'kentoneriksen', 'claszlo', 'benoit1', 'vcotta', 'goh5', 'lesteryhz', 'lsailor', 'singh378', 'aratkov', 'peter411', 'geyerg', 'isaaclandstoffer', 'reddy37', 'alexdobbins98', 'yeager5', 'bsmrdel', 'osborn45', 'lee2370', 'justj', 'guenthee2020', 'charlesma423', 'george7elias', 'xy.sean.liu', 'boninim', 'jbartlin', 'ebergqu', 'lakmanligil', 'ashleydavis', 'ggolla', 'lise_lpz', 'ebehring', 'canadaman87', 'mishra59', 'snowh5696', 'cho246', 'ling36', 'ggoldate', 'jschorfh', 'finn5', 'nhdorcy', 'manjaekim96', 'talon34567', 'suran9712', 'kirchhof', 'asartor', 'mitchpohlman', 'jswetlik', 'rhellyer', 'maxwellfra16', 'jmacklem', 'cameronfritts12', 'albrect', 'mengelh', 'emcdonn', 'bean16', 'ayermemb', 'skantawa', 'lrussell71', 'simekc', 'snead', 'lmeehann', 'yhoashi', 'rodri454', 'evandaele3']",8,"['yizhizhang', 'athoman', 'kevinodonnell0878', 'akreilei', 'ziadan', 'rwasem', None, 'river132']",185,"['ggauthi', 'hungergame34', 'sahilshah16', 'fvora', 'taylo620', 'btestin14', 'ellis71', 'bkiep', 'ryan.wiebe', 'nt230', 'wstolz', 'mnishat', 'conner.swift8', 'itsmemario', 'tgiazzon', 'mikecpmonkey77', 'hdeboer00', 'evdaly', 'jkekre', 'semond', 'graha167', 'mcrees', 'tanderto', 'jdanek', 'buck17', 'deyu23huang', 'scoan', 'kgmcginley', 'nstreb', 'jaggarw', 'cputt', 'alyssamcnarney', 'jmojazza', 'thedhowithpants', 'anthonm', 'alineelquist', 'enadler', 'hkohart', 'dgreiwe', 'smanspencer', 'jstalbaum', 'rishiprasadha', 'cmeiste', 'tobitrack55', 'akonopa', 'hess35', 'wang4150', 'sweis97', 'bihmike', 'tilley0', 'mingusnate', 'kjh94425', 'crhodine', 'mart1226', 'fahughes1999', 'dodge4', 'mcclure8', 'nikhilcarneiro4', 'wbaioni', 'hkaakeh', 'swttprsjtu', 'herr13', 'srasche', 'nggoodie98', 'rsusler', 'eiglehar', 'imran3', 'nbitner', 'river132', 'kentoneriksen', 'dsfgdsfg', 'claszlo', 'khageman', 'benoit1', 'vcotta', 'goh5', 'sknecht', 'lesteryhz', 'lsailor', 'singh378', 'rileyedelaney', 'peter411', 'aratkov', 'geyerg', 'isaaclandstoffer', 'reddy37', 'alexdobbins98', 'akreuter', 'yeager5', 'bsmrdel', 'rwasem', 'osborn45', 'vpope', 'yang1206', 'ikobayas', 'suhaira97', 'robo698', 'lee2370', 'john1886', 'guenthee2020', 'ryanwest1040', 'charlesma423', 'george7elias', 'cmelchin', 'xy.sean.liu', 'justj', 'rjleach', 'boninim', 'cclapham', 'fischermben', 'jbartlin', 'landon.glunt', 'ebergqu', 'lakmanligil', 'nathanmoore', 'angbecker', 'ashleydavis', 'ggolla', 'lise_lpz', 'ebehring', 'treyfinn98', 'ryry1644', 'mishra59', 'dschull', 'canadaman87', 'snowh5696', 'cho246', 'hyndmanjustin', 'cartmaster007', 'baker428', 'ling36', 'munselltom', 'ggoldate', 'jschorfh', 'finn5', 'chiranth7954', 'nhdorcy', 'shadow66666', 'manjaekim96', 'talon34567', 'jacobglvn', 'jfolkers', 'joshuajkporter', 'suran9712', 'kirchhof', 'oliver67', 'kskripakaran0810', 'asartor', 'mitchpohlman', 'jswetlik', 'rhellyer', 'garret28', 'jmacklem', 'maxwellfra16', 'cameronfritts12', 'zjohnson834', 'kruege14', 'albrect', 'heinzt', 'mengelh', 'akreilei', 'emcdonn', 'kknowlto', 'ayermemb', 'bean16', 'jskeens', 'skantawa', 'lrussell71', None, 'simekc', 'acostab', 'snead', 'yizhizhang', 'jklaben', 'kevinodonnell0878', 'lmeehann', 'kico', 'mccaul', 'ziadan', 'yhoashi', 'rodri454', 'evandaele3', 'rao53', 'mlinsin', 'athoman']"
2,208,178,72,59,"['jstalbaum', 'alexdobbins98', 'shadow66666', 'talon34567', 'jfolkers', 'joshuajkporter', 'vpope', 'nt230', 'ikobayas', 'wstolz', 'mnishat', 'hess35', 'kskripakaran0810', 'john1886', 'justj', 'ryanwest1040', 'cmelchin', 'george7elias', 'crhodine', 'mingusnate', 'cclapham', 'evdaly', 'jkekre', 'jswetlik', 'fischermben', 'mcclure8', 'nikhilcarneiro4', 'jbartlin', 'kruege14', 'albrect', 'mcrees', 'heinzt', 'buck17', 'srasche', 'nggoodie98', 'rsusler', 'nathanmoore', 'angbecker', 'imran3', 'cputt', 'kknowlto', 'nbitner', 'lise_lpz', 'jskeens', 'canadaman87', 'dschull', 'jklaben', 'khageman', 'lmeehann', 'sknecht', 'kico', 'yhoashi', 'evandaele3', 'rao53', 'anthonm', 'enadler', 'hkohart', 'dgreiwe', 'rileyedelaney']",118,"['ggauthi', 'hungergame34', 'sahilshah16', 'fvora', 'taylo620', 'btestin14', 'ellis71', 'bkiep', 'ryan.wiebe', 'conner.swift8', 'itsmemario', 'tgiazzon', 'mikecpmonkey77', 'hdeboer00', 'graha167', 'semond', 'tanderto', 'jdanek', 'deyu23huang', 'scoan', 'kgmcginley', 'nstreb', 'jaggarw', 'alyssamcnarney', 'jmojazza', 'thedhowithpants', 'alineelquist', 'smanspencer', 'rishiprasadha', 'cmeiste', 'tobitrack55', 'akonopa', 'wang4150', 'sweis97', 'bihmike', 'tilley0', 'kjh94425', 'mart1226', 'fahughes1999', 'dodge4', 'swttprsjtu', 'wbaioni', 'hkaakeh', 'herr13', 'eiglehar', 'kentoneriksen', 'dsfgdsfg', 'claszlo', 'benoit1', 'vcotta', 'goh5', 'lesteryhz', 'lsailor', 'singh378', 'aratkov', 'peter411', 'geyerg', 'isaaclandstoffer', 'reddy37', 'akreuter', 'yeager5', 'bsmrdel', 'osborn45', 'yang1206', 'suhaira97', 'robo698', 'lee2370', 'guenthee2020', 'charlesma423', 'xy.sean.liu', 'rjleach', 'boninim', 'landon.glunt', 'ebergqu', 'lakmanligil', 'ashleydavis', 'ggolla', 'ebehring', 'treyfinn98', 'ryry1644', 'mishra59', 'snowh5696', 'cho246', 'hyndmanjustin', 'cartmaster007', 'baker428', 'ling36', 'munselltom', 'ggoldate', 'jschorfh', 'finn5', 'chiranth7954', 'nhdorcy', 'manjaekim96', 'jacobglvn', 'suran9712', 'kirchhof', 'oliver67', 'asartor', 'mitchpohlman', 'rhellyer', 'garret28', 'jmacklem', 'maxwellfra16', 'cameronfritts12', 'zjohnson834', 'mengelh', 'emcdonn', 'bean16', 'ayermemb', 'skantawa', 'lrussell71', 'simekc', 'acostab', 'snead', 'mccaul', 'rodri454', 'mlinsin']",13,"['htorsina', 'samt.buller', 'inormile', 'psumner', 'ksjolund', None, 'treinha', 'asartor7', 'nriaziat', 'samm', 'ramos39', 'rice125', 'kkamiya']",190,"['ggauthi', 'hungergame34', 'sahilshah16', 'fvora', 'taylo620', 'btestin14', 'ellis71', 'bkiep', 'ryan.wiebe', 'nt230', 'wstolz', 'mnishat', 'conner.swift8', 'itsmemario', 'tgiazzon', 'mikecpmonkey77', 'hdeboer00', 'evdaly', 'jkekre', 'semond', 'graha167', 'mcrees', 'tanderto', 'jdanek', 'buck17', 'deyu23huang', 'scoan', 'psumner', 'asartor7', 'kgmcginley', 'nstreb', 'jaggarw', 'cputt', 'alyssamcnarney', 'treinha', 'jmojazza', 'thedhowithpants', 'anthonm', 'alineelquist', 'enadler', 'hkohart', 'dgreiwe', 'smanspencer', 'jstalbaum', 'rishiprasadha', 'cmeiste', 'tobitrack55', 'akonopa', 'hess35', 'wang4150', 'sweis97', 'bihmike', 'tilley0', 'mingusnate', 'kjh94425', 'crhodine', 'mart1226', 'fahughes1999', 'dodge4', 'nriaziat', 'mcclure8', 'nikhilcarneiro4', 'wbaioni', 'hkaakeh', 'swttprsjtu', 'kkamiya', 'herr13', 'srasche', 'nggoodie98', 'rsusler', 'eiglehar', 'imran3', 'nbitner', 'kentoneriksen', 'dsfgdsfg', 'claszlo', 'khageman', 'benoit1', 'vcotta', 'inormile', 'goh5', 'sknecht', 'lesteryhz', 'lsailor', 'singh378', 'rileyedelaney', 'peter411', 'aratkov', 'geyerg', 'isaaclandstoffer', 'reddy37', 'alexdobbins98', 'akreuter', 'yeager5', 'bsmrdel', 'ramos39', 'osborn45', 'vpope', 'yang1206', 'ikobayas', 'suhaira97', 'robo698', 'lee2370', 'john1886', 'guenthee2020', 'ryanwest1040', 'charlesma423', 'george7elias', 'cmelchin', 'xy.sean.liu', 'justj', 'ksjolund', 'rjleach', 'boninim', 'cclapham', 'fischermben', 'jbartlin', 'landon.glunt', 'ebergqu', 'lakmanligil', 'nathanmoore', 'angbecker', 'ashleydavis', 'samm', 'ggolla', 'lise_lpz', 'ebehring', 'treyfinn98', 'ryry1644', 'mishra59', 'dschull', 'canadaman87', 'snowh5696', 'cho246', 'hyndmanjustin', 'cartmaster007', 'baker428', 'ling36', 'munselltom', 'ggoldate', 'jschorfh', 'finn5', 'chiranth7954', 'htorsina', 'nhdorcy', 'shadow66666', 'manjaekim96', 'talon34567', 'jacobglvn', 'jfolkers', 'joshuajkporter', 'suran9712', 'kirchhof', 'samt.buller', 'oliver67', 'kskripakaran0810', 'asartor', 'mitchpohlman', 'jswetlik', 'rhellyer', 'garret28', 'jmacklem', 'maxwellfra16', 'cameronfritts12', 'zjohnson834', 'kruege14', 'albrect', 'heinzt', 'mengelh', 'emcdonn', 'kknowlto', 'ayermemb', 'bean16', 'jskeens', 'skantawa', 'lrussell71', None, 'simekc', 'acostab', 'snead', 'jklaben', 'lmeehann', 'kico', 'mccaul', 'yhoashi', 'rodri454', 'evandaele3', 'rao53', 'mlinsin', 'rice125']"
3,267,169,61,59,"['raquelz48', 'dragonswrath', 'carlosmata', 'infinity444phi', 'cesarin159', 'aguade03', 'jisaucedo', 'drhodges', 'jarrah_5011', 'gisel.fregoso', 'ivan07guerrero', 'jgonza4643', 'jmckenzie', 'cynthia.oaxaca3', 'teck60osc', 'ahmad.abdulraheem', 'ponchitofam', 'joejones143', 'kirito', 'crojas7', 'hehasan', 'minjares.jesus.ths', 'vflombrana', 'osacosta', 'koagbita', 'asolis21', 'nsimla', 'oscarelozano', 'crysdbz.22', 'willbouns', 'alexmartinezzero', 'contiveros7', 'laarvizu', 'meni72', 'cgmartan', 'jorge1799', 'jscordero1', 'reyesmiguel888', 'anieto5', 'alanrayharr', 'daniboy12', 'diegoerickherrera', 'dterrazas3', 'cmflores10', 'dvillalva21', 'eliot9700', 'usuarez11', 'landa.esteban', 'jalujan8', 'xbaca', 'ivan0703', 'lrburgueno', 'lmelend1', 'fdo.glz', 'amarin2997', 'fvaldezroman', 'mmedina340', 'aramirez64', 'icasper2']",109,"['paularodriguez', 'mattbalisky', 'waheed.ahmed12', 'felipeballesteros1', 'yiyusiyang', 'felipedavidsp', 'mfrounchi3', 'chazzles', 'ankitubc', 'oconnomi', 'eren121313', 'varlamovand', 'cacost919', 'melike_musal', 'mohamedsaleh106', 'ydeokar24', 'fernajes', 'baili19', 'omar.sosa.quimica', 'saminsss', 'teh', 'islam_hisham', 'edwardleelk123', 'samiha_hassan', 'krusea', 'cemkarts', 'dakota1268', 'mollyrathore.18', 'norton.huang', 'megang1218', 'johngould1997', 'fatplatypus69', 'chenlingjie38', 'bnanojeff', 's.ganapathy.52', 'jpjauw', 'kareem.men3em', 'brunorodriguez1998', 'elgohari95', 'zubeydekal37', 'caoboxuan1998', 'austalavistababy', 'odemc', 'gandersen26', 'bpbkaminski', 'aralbevtt', 'yuejiaqi1', 'sophia00', 'shininamuthiora', 'walcottr', 'kellymyers', 'baatarb', 'mmert.bacak', 'nimakondori96', 'lamho', 'nyazdi', 'zachfu97', 'elie_9742', 'chen.hugh1998', 'josborne', 'adhikarr95', 'hzlzyuan', 'hm.am.da', 'kvziwc', 'metalist_kaan', 'fmyurtsever', 'raib', 'heiknen', 'paulrakowicz', 'parisa.esh', 'tarek20501', 'amevipin', 'chenxi9649', 'dusty5683', 'polat.gokberk', 'alek.konicki09', 'mrg31415926', 'emre_citak_bil', 'ilkaydost', 'kweze118', 'omerfkazar22', 'jdcanlas7', 'geberia', 'edwardmartyr', 'davinb', 'lusiyang93', 'masoudmokht', 'gurindergarcha98', 'vandphil', 'shaffert', 'atuftee', 'ronal_denho_931', 'mkrysicki', 'barrsw3', 'afkali.120', 'furkanznkr', 'muldowneyc2019', 'nmalshammari', 'iagord93', 'haticesari333333', 'keshavdidi', 'phonegamepc', 'quinnw115', 'djm1411', 'anoophundle', 'lee.johnny.2014', 'wynvlntkd', 'yunusbaskan', 'furkanturk1352']",2,"[None, 'parkita']",170,"['raquelz48', 'paularodriguez', 'mattbalisky', 'waheed.ahmed12', 'felipeballesteros1', 'jisaucedo', 'jgonza4643', 'yiyusiyang', 'ahmad.abdulraheem', 'felipedavidsp', 'mfrounchi3', 'kirito', 'ponchitofam', 'chazzles', 'ankitubc', 'oconnomi', 'eren121313', 'vflombrana', 'varlamovand', 'osacosta', 'cacost919', 'melike_musal', 'ydeokar24', 'mohamedsaleh106', 'fernajes', 'baili19', 'omar.sosa.quimica', 'contiveros7', 'saminsss', 'teh', 'islam_hisham', 'reyesmiguel888', 'edwardleelk123', 'dvillalva21', 'lrburgueno', 'fvaldezroman', 'samiha_hassan', 'krusea', 'cemkarts', 'dakota1268', 'mollyrathore.18', 'norton.huang', 'megang1218', 'johngould1997', 'ivan07guerrero', 'joejones143', 'hehasan', 'fatplatypus69', 'koagbita', 'chenlingjie38', 'bnanojeff', 's.ganapathy.52', 'jpjauw', 'kareem.men3em', 'willbouns', 'brunorodriguez1998', 'elgohari95', 'zubeydekal37', 'caoboxuan1998', 'austalavistababy', 'odemc', 'gandersen26', 'dterrazas3', 'bpbkaminski', 'landa.esteban', 'aralbevtt', 'yuejiaqi1', 'sophia00', 'shininamuthiora', 'walcottr', 'amarin2997', 'icasper2', 'baatarb', 'kellymyers', 'mmedina340', 'mmert.bacak', 'nimakondori96', 'lamho', 'nyazdi', 'aguade03', 'zachfu97', 'elie_9742', 'parkita', 'gisel.fregoso', 'chen.hugh1998', 'josborne', 'adhikarr95', 'jmckenzie', 'hm.am.da', 'hzlzyuan', 'kvziwc', 'minjares.jesus.ths', 'metalist_kaan', 'fmyurtsever', 'raib', 'heiknen', 'asolis21', 'paulrakowicz', 'parisa.esh', 'tarek20501', 'amevipin', 'alexmartinezzero', 'chenxi9649', 'dusty5683', 'polat.gokberk', 'alek.konicki09', 'cgmartan', 'jorge1799', 'mrg31415926', 'anieto5', 'emre_citak_bil', 'diegoerickherrera', 'cmflores10', 'usuarez11', 'eliot9700', 'ilkaydost', 'kweze118', 'omerfkazar22', 'ivan0703', 'jdcanlas7', 'cynthia.oaxaca3', 'geberia', 'edwardmartyr', 'davinb', 'lusiyang93', 'masoudmokht', 'dragonswrath', 'infinity444phi', 'carlosmata', 'cesarin159', 'gurindergarcha98', 'drhodges', 'vandphil', 'jarrah_5011', 'shaffert', 'teck60osc', 'atuftee', 'ronal_denho_931', 'crojas7', 'mkrysicki', 'barrsw3', 'nsimla', 'oscarelozano', 'afkali.120', 'furkanznkr', 'crysdbz.22', 'laarvizu', 'meni72', 'muldowneyc2019', 'nmalshammari', 'iagord93', 'jscordero1', None, 'haticesari333333', 'keshavdidi', 'alanrayharr', 'phonegamepc', 'daniboy12', 'quinnw115', 'djm1411', 'anoophundle', 'jalujan8', 'xbaca', 'lee.johnny.2014', 'lmelend1', 'wynvlntkd', 'fdo.glz', 'yunusbaskan', 'aramirez64', 'furkanturk1352']"
3,266,169,51,47,"['mollyrathore.18', 'lusiyang93', 'masoudmokht', 'davinb', 'mattbalisky', 'nimakondori96', 'norton.huang', 'felipeballesteros1', 'gurindergarcha98', 'nyazdi', 'zachfu97', 'chen.hugh1998', 'josborne', 'hzlzyuan', 'hm.am.da', 'felipedavidsp', 'kvziwc', 'ankitubc', 'fatplatypus69', 'varlamovand', 'chenlingjie38', 'bnanojeff', 'parisa.esh', 's.ganapathy.52', 'tarek20501', 'amevipin', 'baili19', 'chenxi9649', 'brunorodriguez1998', 'saminsss', 'caoboxuan1998', 'austalavistababy', 'mrg31415926', 'keshavdidi', 'phonegamepc', 'gandersen26', 'quinnw115', 'djm1411', 'anoophundle', 'bpbkaminski', 'edwardleelk123', 'lee.johnny.2014', 'jdcanlas7', 'yuejiaqi1', 'sophia00', 'shininamuthiora', 'samiha_hassan']",121,"['raquelz48', 'paularodriguez', 'waheed.ahmed12', 'jisaucedo', 'jgonza4643', 'yiyusiyang', 'ahmad.abdulraheem', 'mfrounchi3', 'ponchitofam', 'kirito', 'chazzles', 'oconnomi', 'eren121313', 'vflombrana', 'osacosta', 'cacost919', 'melike_musal', 'ydeokar24', 'mohamedsaleh106', 'fernajes', 'omar.sosa.quimica', 'contiveros7', 'teh', 'islam_hisham', 'reyesmiguel888', 'dvillalva21', 'lrburgueno', 'fvaldezroman', 'krusea', 'cemkarts', 'dakota1268', 'megang1218', 'johngould1997', 'ivan07guerrero', 'joejones143', 'hehasan', 'koagbita', 'jpjauw', 'kareem.men3em', 'willbouns', 'elgohari95', 'zubeydekal37', 'odemc', 'dterrazas3', 'landa.esteban', 'aralbevtt', 'walcottr', 'amarin2997', 'mmedina340', 'icasper2', 'kellymyers', 'baatarb', 'mmert.bacak', 'lamho', 'aguade03', 'elie_9742', 'gisel.fregoso', 'adhikarr95', 'jmckenzie', 'minjares.jesus.ths', 'metalist_kaan', 'fmyurtsever', 'raib', 'heiknen', 'asolis21', 'paulrakowicz', 'alexmartinezzero', 'dusty5683', 'polat.gokberk', 'alek.konicki09', 'cgmartan', 'jorge1799', 'anieto5', 'emre_citak_bil', 'diegoerickherrera', 'cmflores10', 'usuarez11', 'eliot9700', 'ilkaydost', 'kweze118', 'omerfkazar22', 'ivan0703', 'cynthia.oaxaca3', 'geberia', 'edwardmartyr', 'dragonswrath', 'infinity444phi', 'carlosmata', 'cesarin159', 'drhodges', 'vandphil', 'jarrah_5011', 'shaffert', 'teck60osc', 'atuftee', 'ronal_denho_931', 'crojas7', 'mkrysicki', 'barrsw3', 'nsimla', 'oscarelozano', 'afkali.120', 'furkanznkr', 'crysdbz.22', 'laarvizu', 'meni72', 'muldowneyc2019', 'nmalshammari', 'iagord93', 'jscordero1', 'haticesari333333', 'alanrayharr', 'daniboy12', 'jalujan8', 'xbaca', 'lmelend1', 'wynvlntkd', 'fdo.glz', 'yunusbaskan', 'aramirez64', 'furkanturk1352']",4,"['jerryli0711', 'bjugraj', 'evelynguo0505', None]",172,"['raquelz48', 'paularodriguez', 'mattbalisky', 'waheed.ahmed12', 'felipeballesteros1', 'jisaucedo', 'jgonza4643', 'yiyusiyang', 'ahmad.abdulraheem', 'felipedavidsp', 'mfrounchi3', 'kirito', 'ponchitofam', 'chazzles', 'ankitubc', 'oconnomi', 'eren121313', 'vflombrana', 'varlamovand', 'osacosta', 'cacost919', 'melike_musal', 'ydeokar24', 'mohamedsaleh106', 'fernajes', 'baili19', 'omar.sosa.quimica', 'contiveros7', 'saminsss', 'teh', 'islam_hisham', 'reyesmiguel888', 'edwardleelk123', 'dvillalva21', 'lrburgueno', 'fvaldezroman', 'samiha_hassan', 'krusea', 'cemkarts', 'dakota1268', 'mollyrathore.18', 'norton.huang', 'megang1218', 'johngould1997', 'ivan07guerrero', 'joejones143', 'hehasan', 'fatplatypus69', 'koagbita', 'chenlingjie38', 'bnanojeff', 's.ganapathy.52', 'jpjauw', 'kareem.men3em', 'willbouns', 'brunorodriguez1998', 'elgohari95', 'zubeydekal37', 'caoboxuan1998', 'austalavistababy', 'odemc', 'gandersen26', 'dterrazas3', 'bpbkaminski', 'landa.esteban', 'aralbevtt', 'yuejiaqi1', 'sophia00', 'shininamuthiora', 'walcottr', 'amarin2997', 'icasper2', 'baatarb', 'kellymyers', 'mmedina340', 'mmert.bacak', 'nimakondori96', 'lamho', 'nyazdi', 'aguade03', 'zachfu97', 'elie_9742', 'gisel.fregoso', 'chen.hugh1998', 'josborne', 'adhikarr95', 'jmckenzie', 'hm.am.da', 'hzlzyuan', 'kvziwc', 'minjares.jesus.ths', 'metalist_kaan', 'bjugraj', 'fmyurtsever', 'raib', 'heiknen', 'asolis21', 'paulrakowicz', 'parisa.esh', 'tarek20501', 'amevipin', 'alexmartinezzero', 'chenxi9649', 'dusty5683', 'polat.gokberk', 'alek.konicki09', 'cgmartan', 'jorge1799', 'mrg31415926', 'anieto5', 'emre_citak_bil', 'diegoerickherrera', 'cmflores10', 'usuarez11', 'eliot9700', 'ilkaydost', 'kweze118', 'omerfkazar22', 'ivan0703', 'jdcanlas7', 'cynthia.oaxaca3', 'geberia', 'edwardmartyr', 'davinb', 'lusiyang93', 'masoudmokht', 'dragonswrath', 'infinity444phi', 'carlosmata', 'cesarin159', 'gurindergarcha98', 'drhodges', 'vandphil', 'jarrah_5011', 'shaffert', 'jerryli0711', 'teck60osc', 'atuftee', 'ronal_denho_931', 'crojas7', 'mkrysicki', 'barrsw3', 'nsimla', 'oscarelozano', 'afkali.120', 'furkanznkr', 'crysdbz.22', 'evelynguo0505', 'laarvizu', 'meni72', 'muldowneyc2019', 'nmalshammari', 'iagord93', 'jscordero1', None, 'haticesari333333', 'keshavdidi', 'alanrayharr', 'phonegamepc', 'daniboy12', 'quinnw115', 'djm1411', 'anoophundle', 'jalujan8', 'xbaca', 'lee.johnny.2014', 'lmelend1', 'wynvlntkd', 'fdo.glz', 'yunusbaskan', 'aramirez64', 'furkanturk1352']"
3,35,169,38,1,['paularodriguez'],167,"['raquelz48', 'mattbalisky', 'waheed.ahmed12', 'felipeballesteros1', 'jisaucedo', 'jgonza4643', 'yiyusiyang', 'ahmad.abdulraheem', 'felipedavidsp', 'mfrounchi3', 'kirito', 'ponchitofam', 'chazzles', 'ankitubc', 'oconnomi', 'eren121313', 'vflombrana', 'varlamovand', 'osacosta', 'cacost919', 'melike_musal', 'ydeokar24', 'mohamedsaleh106', 'fernajes', 'baili19', 'omar.sosa.quimica', 'contiveros7', 'saminsss', 'teh', 'islam_hisham', 'reyesmiguel888', 'edwardleelk123', 'dvillalva21', 'lrburgueno', 'fvaldezroman', 'samiha_hassan', 'krusea', 'cemkarts', 'dakota1268', 'mollyrathore.18', 'norton.huang', 'megang1218', 'johngould1997', 'ivan07guerrero', 'joejones143', 'hehasan', 'fatplatypus69', 'koagbita', 'chenlingjie38', 'bnanojeff', 's.ganapathy.52', 'jpjauw', 'kareem.men3em', 'willbouns', 'brunorodriguez1998', 'elgohari95', 'zubeydekal37', 'caoboxuan1998', 'austalavistababy', 'odemc', 'gandersen26', 'dterrazas3', 'bpbkaminski', 'landa.esteban', 'aralbevtt', 'yuejiaqi1', 'sophia00', 'shininamuthiora', 'walcottr', 'amarin2997', 'icasper2', 'baatarb', 'kellymyers', 'mmedina340', 'mmert.bacak', 'nimakondori96', 'lamho', 'nyazdi', 'aguade03', 'zachfu97', 'elie_9742', 'gisel.fregoso', 'chen.hugh1998', 'josborne', 'adhikarr95', 'jmckenzie', 'hm.am.da', 'hzlzyuan', 'kvziwc', 'minjares.jesus.ths', 'metalist_kaan', 'fmyurtsever', 'raib', 'heiknen', 'asolis21', 'paulrakowicz', 'parisa.esh', 'tarek20501', 'amevipin', 'alexmartinezzero', 'chenxi9649', 'dusty5683', 'polat.gokberk', 'alek.konicki09', 'cgmartan', 'jorge1799', 'mrg31415926', 'anieto5', 'emre_citak_bil', 'diegoerickherrera', 'cmflores10', 'usuarez11', 'eliot9700', 'ilkaydost', 'kweze118', 'omerfkazar22', 'ivan0703', 'jdcanlas7', 'cynthia.oaxaca3', 'geberia', 'edwardmartyr', 'davinb', 'lusiyang93', 'masoudmokht', 'dragonswrath', 'infinity444phi', 'carlosmata', 'cesarin159', 'gurindergarcha98', 'drhodges', 'vandphil', 'jarrah_5011', 'shaffert', 'teck60osc', 'atuftee', 'ronal_denho_931', 'crojas7', 'mkrysicki', 'barrsw3', 'nsimla', 'oscarelozano', 'afkali.120', 'furkanznkr', 'crysdbz.22', 'laarvizu', 'meni72', 'muldowneyc2019', 'nmalshammari', 'iagord93', 'jscordero1', 'haticesari333333', 'keshavdidi', 'alanrayharr', 'phonegamepc', 'daniboy12', 'quinnw115', 'djm1411', 'anoophundle', 'jalujan8', 'xbaca', 'lee.johnny.2014', 'lmelend1', 'wynvlntkd', 'fdo.glz', 'yunusbaskan', 'aramirez64', 'furkanturk1352']",37,"['miri23', 'loisonchambers', 'aronchino6', 'carlosbesadaromero', 'gemma', 'siemprewowthechami', 'jorgecastelo5', 'david2397', 'vblanco.nico', 'janalorenzolumbreras', 'andreadiazgar', 'isabelmaria.vazquez', 'josepazmartin', 'adfoz', 'apascao', 'cristinacigarran', 'corredoira', 'helenalecoq97', 'iago', 'malgaca', 'pedrosiaba', 'manuelsomoza94', 'martinzapata', 'acregodean', 'martin32', 'lino13', 'sarapl', None, 'danielfernandezcalo', 'david.garrido', 'alberfn', 'hermidaitor', 'svo4321', 'alecorti.pardo', 'veronica.mieites', 'vanesagarcia', 'ledicia97']",205,"['miri23', 'raquelz48', 'loisonchambers', 'paularodriguez', 'mattbalisky', 'waheed.ahmed12', 'felipeballesteros1', 'siemprewowthechami', 'jisaucedo', 'vblanco.nico', 'jgonza4643', 'yiyusiyang', 'isabelmaria.vazquez', 'ahmad.abdulraheem', 'felipedavidsp', 'mfrounchi3', 'kirito', 'ponchitofam', 'chazzles', 'ankitubc', 'oconnomi', 'eren121313', 'vflombrana', 'varlamovand', 'osacosta', 'cacost919', 'cristinacigarran', 'melike_musal', 'ydeokar24', 'mohamedsaleh106', 'fernajes', 'baili19', 'omar.sosa.quimica', 'manuelsomoza94', 'contiveros7', 'saminsss', 'lino13', 'teh', 'islam_hisham', 'reyesmiguel888', 'edwardleelk123', 'dvillalva21', 'lrburgueno', 'veronica.mieites', 'fvaldezroman', 'samiha_hassan', 'krusea', 'cemkarts', 'dakota1268', 'mollyrathore.18', 'norton.huang', 'megang1218', 'johngould1997', 'ivan07guerrero', 'janalorenzolumbreras', 'joejones143', 'hehasan', 'fatplatypus69', 'apascao', 'koagbita', 'chenlingjie38', 'bnanojeff', 's.ganapathy.52', 'jpjauw', 'kareem.men3em', 'willbouns', 'malgaca', 'brunorodriguez1998', 'elgohari95', 'martinzapata', 'zubeydekal37', 'martin32', 'caoboxuan1998', 'austalavistababy', 'odemc', 'gandersen26', 'dterrazas3', 'bpbkaminski', 'landa.esteban', 'aralbevtt', 'alberfn', 'hermidaitor', 'vanesagarcia', 'yuejiaqi1', 'sophia00', 'shininamuthiora', 'walcottr', 'amarin2997', 'icasper2', 'baatarb', 'kellymyers', 'mmedina340', 'mmert.bacak', 'nimakondori96', 'lamho', 'nyazdi', 'gemma', 'aguade03', 'zachfu97', 'elie_9742', 'jorgecastelo5', 'gisel.fregoso', 'david2397', 'chen.hugh1998', 'andreadiazgar', 'josborne', 'adhikarr95', 'jmckenzie', 'hm.am.da', 'hzlzyuan', 'josepazmartin', 'kvziwc', 'minjares.jesus.ths', 'metalist_kaan', 'adfoz', 'fmyurtsever', 'raib', 'heiknen', 'asolis21', 'paulrakowicz', 'parisa.esh', 'tarek20501', 'amevipin', 'alexmartinezzero', 'chenxi9649', 'dusty5683', 'polat.gokberk', 'alek.konicki09', 'cgmartan', 'jorge1799', 'mrg31415926', 'anieto5', 'emre_citak_bil', 'diegoerickherrera', 'danielfernandezcalo', 'cmflores10', 'usuarez11', 'eliot9700', 'ilkaydost', 'kweze118', 'omerfkazar22', 'ivan0703', 'jdcanlas7', 'alecorti.pardo', 'cynthia.oaxaca3', 'geberia', 'edwardmartyr', 'davinb', 'lusiyang93', 'masoudmokht', 'dragonswrath', 'infinity444phi', 'carlosmata', 'aronchino6', 'cesarin159', 'gurindergarcha98', 'carlosbesadaromero', 'drhodges', 'vandphil', 'jarrah_5011', 'shaffert', 'teck60osc', 'atuftee', 'ronal_denho_931', 'crojas7', 'mkrysicki', 'barrsw3', 'corredoira', 'iago', 'nsimla', 'helenalecoq97', 'oscarelozano', 'afkali.120', 'furkanznkr', 'crysdbz.22', 'pedrosiaba', 'laarvizu', 'meni72', 'acregodean', 'muldowneyc2019', 'nmalshammari', 'iagord93', 'jscordero1', 'sarapl', None, 'haticesari333333', 'keshavdidi', 'alanrayharr', 'phonegamepc', 'daniboy12', 'quinnw115', 'djm1411', 'anoophundle', 'david.garrido', 'jalujan8', 'xbaca', 'lee.johnny.2014', 'lmelend1', 'wynvlntkd', 'svo4321', 'fdo.glz', 'yunusbaskan', 'aramirez64', 'furkanturk1352', 'ledicia97']"
3,262,169,37,10,"['cemkarts', 'emre_citak_bil', 'ilkaydost', 'omerfkazar22', 'melike_musal', 'yunusbaskan', 'furkanturk1352', 'afkali.120', 'furkanznkr', 'haticesari333333']",158,"['raquelz48', 'paularodriguez', 'mattbalisky', 'waheed.ahmed12', 'felipeballesteros1', 'jisaucedo', 'jgonza4643', 'yiyusiyang', 'ahmad.abdulraheem', 'felipedavidsp', 'mfrounchi3', 'kirito', 'ponchitofam', 'chazzles', 'ankitubc', 'oconnomi', 'eren121313', 'vflombrana', 'varlamovand', 'osacosta', 'cacost919', 'ydeokar24', 'mohamedsaleh106', 'fernajes', 'baili19', 'omar.sosa.quimica', 'contiveros7', 'saminsss', 'teh', 'islam_hisham', 'reyesmiguel888', 'edwardleelk123', 'dvillalva21', 'lrburgueno', 'fvaldezroman', 'samiha_hassan', 'krusea', 'dakota1268', 'mollyrathore.18', 'norton.huang', 'megang1218', 'johngould1997', 'ivan07guerrero', 'joejones143', 'hehasan', 'fatplatypus69', 'koagbita', 'chenlingjie38', 'bnanojeff', 's.ganapathy.52', 'jpjauw', 'kareem.men3em', 'willbouns', 'brunorodriguez1998', 'elgohari95', 'zubeydekal37', 'caoboxuan1998', 'austalavistababy', 'odemc', 'gandersen26', 'dterrazas3', 'bpbkaminski', 'landa.esteban', 'aralbevtt', 'yuejiaqi1', 'sophia00', 'shininamuthiora', 'walcottr', 'amarin2997', 'icasper2', 'baatarb', 'kellymyers', 'mmedina340', 'mmert.bacak', 'nimakondori96', 'lamho', 'nyazdi', 'aguade03', 'zachfu97', 'elie_9742', 'gisel.fregoso', 'chen.hugh1998', 'josborne', 'adhikarr95', 'jmckenzie', 'hm.am.da', 'hzlzyuan', 'kvziwc', 'minjares.jesus.ths', 'metalist_kaan', 'fmyurtsever', 'raib', 'heiknen', 'asolis21', 'paulrakowicz', 'parisa.esh', 'tarek20501', 'amevipin', 'alexmartinezzero', 'chenxi9649', 'dusty5683', 'polat.gokberk', 'alek.konicki09', 'cgmartan', 'jorge1799', 'mrg31415926', 'anieto5', 'diegoerickherrera', 'cmflores10', 'usuarez11', 'eliot9700', 'kweze118', 'ivan0703', 'jdcanlas7', 'cynthia.oaxaca3', 'geberia', 'edwardmartyr', 'davinb', 'lusiyang93', 'masoudmokht', 'dragonswrath', 'infinity444phi', 'carlosmata', 'cesarin159', 'gurindergarcha98', 'drhodges', 'vandphil', 'jarrah_5011', 'shaffert', 'teck60osc', 'atuftee', 'ronal_denho_931', 'crojas7', 'mkrysicki', 'barrsw3', 'nsimla', 'oscarelozano', 'crysdbz.22', 'laarvizu', 'meni72', 'muldowneyc2019', 'nmalshammari', 'iagord93', 'jscordero1', 'keshavdidi', 'alanrayharr', 'phonegamepc', 'daniboy12', 'quinnw115', 'djm1411', 'anoophundle', 'jalujan8', 'xbaca', 'lee.johnny.2014', 'lmelend1', 'wynvlntkd', 'fdo.glz', 'aramirez64']",27,"['esracolak.25', 'brknshn', 'mevradilanerten', 'kganozcan', 'ugur.cankaya.3718', 'muvafikmelikkaya', 'emre_krtn97', 'meltemsbreezes', '46harunakgul', 'davuteee', 'frknznkr', 'oakbulut1997', 'irfancan571', 'berkanaydn16', 'evrenyigit', 'melikemusal1', 'muratlevent', None, 'nihatyavuz', 'abcd5454', 'adnanyuceer', 'damlakubattt', 'ozbunar01', 'abdurrahmn15', 'metehanmustafayalcin', 'cihanbuyuknacar', 'onurcanozavci']",195,"['raquelz48', 'esracolak.25', 'paularodriguez', 'mattbalisky', 'waheed.ahmed12', 'felipeballesteros1', 'jisaucedo', 'jgonza4643', 'yiyusiyang', 'ahmad.abdulraheem', 'felipedavidsp', 'mfrounchi3', 'kirito', 'ponchitofam', 'chazzles', 'ankitubc', 'oconnomi', 'eren121313', 'vflombrana', 'varlamovand', 'emre_krtn97', 'osacosta', 'cacost919', 'melike_musal', 'ydeokar24', 'mohamedsaleh106', 'fernajes', 'baili19', 'omar.sosa.quimica', 'contiveros7', 'saminsss', 'evrenyigit', 'teh', 'islam_hisham', 'reyesmiguel888', 'muratlevent', 'abcd5454', 'edwardleelk123', 'dvillalva21', 'lrburgueno', 'metehanmustafayalcin', 'fvaldezroman', 'samiha_hassan', 'krusea', 'cemkarts', 'dakota1268', 'mollyrathore.18', 'norton.huang', 'megang1218', 'johngould1997', 'ivan07guerrero', 'muvafikmelikkaya', 'joejones143', 'hehasan', 'fatplatypus69', 'koagbita', '46harunakgul', 'chenlingjie38', 'bnanojeff', 's.ganapathy.52', 'jpjauw', 'kareem.men3em', 'davuteee', 'willbouns', 'brunorodriguez1998', 'elgohari95', 'berkanaydn16', 'zubeydekal37', 'caoboxuan1998', 'melikemusal1', 'austalavistababy', 'odemc', 'gandersen26', 'dterrazas3', 'bpbkaminski', 'landa.esteban', 'aralbevtt', 'yuejiaqi1', 'sophia00', 'shininamuthiora', 'walcottr', 'amarin2997', 'icasper2', 'baatarb', 'kellymyers', 'mmedina340', 'onurcanozavci', 'mmert.bacak', 'nimakondori96', 'brknshn', 'lamho', 'nyazdi', 'aguade03', 'zachfu97', 'elie_9742', 'kganozcan', 'gisel.fregoso', 'chen.hugh1998', 'josborne', 'adhikarr95', 'jmckenzie', 'hm.am.da', 'hzlzyuan', 'kvziwc', 'minjares.jesus.ths', 'metalist_kaan', 'fmyurtsever', 'raib', 'heiknen', 'asolis21', 'paulrakowicz', 'parisa.esh', 'tarek20501', 'amevipin', 'alexmartinezzero', 'chenxi9649', 'dusty5683', 'oakbulut1997', 'irfancan571', 'polat.gokberk', 'alek.konicki09', 'cgmartan', 'jorge1799', 'mrg31415926', 'nihatyavuz', 'anieto5', 'emre_citak_bil', 'diegoerickherrera', 'adnanyuceer', 'cmflores10', 'usuarez11', 'eliot9700', 'ilkaydost', 'kweze118', 'omerfkazar22', 'ivan0703', 'ozbunar01', 'jdcanlas7', 'abdurrahmn15', 'cynthia.oaxaca3', 'geberia', 'edwardmartyr', 'davinb', 'lusiyang93', 'masoudmokht', 'dragonswrath', 'infinity444phi', 'carlosmata', 'cesarin159', 'gurindergarcha98', 'mevradilanerten', 'drhodges', 'vandphil', 'jarrah_5011', 'shaffert', 'ugur.cankaya.3718', 'teck60osc', 'atuftee', 'ronal_denho_931', 'crojas7', 'mkrysicki', 'barrsw3', 'meltemsbreezes', 'nsimla', 'oscarelozano', 'afkali.120', 'furkanznkr', 'crysdbz.22', 'frknznkr', 'laarvizu', 'meni72', 'muldowneyc2019', 'nmalshammari', 'iagord93', 'jscordero1', None, 'haticesari333333', 'keshavdidi', 'alanrayharr', 'phonegamepc', 'daniboy12', 'quinnw115', 'damlakubattt', 'djm1411', 'anoophundle', 'jalujan8', 'xbaca', 'lee.johnny.2014', 'lmelend1', 'wynvlntkd', 'fdo.glz', 'yunusbaskan', 'aramirez64', 'furkanturk1352', 'cihanbuyuknacar']"
3,268,169,23,22,"['dakota1268', 'lamho', 'megang1218', 'vandphil', 'johngould1997', 'shaffert', 'adhikarr95', 'oconnomi', 'raib', 'barrsw3', 'paulrakowicz', 'cacost919', 'jpjauw', 'fernajes', 'muldowneyc2019', 'odemc', 'kweze118', 'wynvlntkd', 'kellymyers', 'walcottr', 'krusea', 'baatarb']",146,"['raquelz48', 'paularodriguez', 'mattbalisky', 'waheed.ahmed12', 'felipeballesteros1', 'jisaucedo', 'jgonza4643', 'yiyusiyang', 'ahmad.abdulraheem', 'felipedavidsp', 'mfrounchi3', 'kirito', 'ponchitofam', 'chazzles', 'ankitubc', 'eren121313', 'vflombrana', 'varlamovand', 'osacosta', 'melike_musal', 'ydeokar24', 'mohamedsaleh106', 'baili19', 'omar.sosa.quimica', 'contiveros7', 'saminsss', 'teh', 'islam_hisham', 'reyesmiguel888', 'edwardleelk123', 'dvillalva21', 'lrburgueno', 'fvaldezroman', 'samiha_hassan', 'cemkarts', 'mollyrathore.18', 'norton.huang', 'ivan07guerrero', 'joejones143', 'hehasan', 'fatplatypus69', 'koagbita', 'chenlingjie38', 'bnanojeff', 's.ganapathy.52', 'kareem.men3em', 'willbouns', 'brunorodriguez1998', 'elgohari95', 'zubeydekal37', 'caoboxuan1998', 'austalavistababy', 'gandersen26', 'dterrazas3', 'bpbkaminski', 'landa.esteban', 'aralbevtt', 'yuejiaqi1', 'sophia00', 'shininamuthiora', 'amarin2997', 'icasper2', 'mmedina340', 'mmert.bacak', 'nimakondori96', 'nyazdi', 'aguade03', 'zachfu97', 'elie_9742', 'gisel.fregoso', 'chen.hugh1998', 'josborne', 'jmckenzie', 'hm.am.da', 'hzlzyuan', 'kvziwc', 'minjares.jesus.ths', 'metalist_kaan', 'fmyurtsever', 'heiknen', 'asolis21', 'parisa.esh', 'tarek20501', 'amevipin', 'alexmartinezzero', 'chenxi9649', 'dusty5683', 'polat.gokberk', 'alek.konicki09', 'cgmartan', 'jorge1799', 'mrg31415926', 'anieto5', 'emre_citak_bil', 'diegoerickherrera', 'cmflores10', 'usuarez11', 'eliot9700', 'ilkaydost', 'omerfkazar22', 'ivan0703', 'jdcanlas7', 'cynthia.oaxaca3', 'geberia', 'edwardmartyr', 'davinb', 'lusiyang93', 'masoudmokht', 'dragonswrath', 'infinity444phi', 'carlosmata', 'cesarin159', 'gurindergarcha98', 'drhodges', 'jarrah_5011', 'teck60osc', 'atuftee', 'ronal_denho_931', 'crojas7', 'mkrysicki', 'nsimla', 'oscarelozano', 'afkali.120', 'furkanznkr', 'crysdbz.22', 'laarvizu', 'meni72', 'nmalshammari', 'iagord93', 'jscordero1', 'haticesari333333', 'keshavdidi', 'alanrayharr', 'phonegamepc', 'daniboy12', 'quinnw115', 'djm1411', 'anoophundle', 'jalujan8', 'xbaca', 'lee.johnny.2014', 'lmelend1', 'fdo.glz', 'yunusbaskan', 'aramirez64', 'furkanturk1352']",1,[None],169,"['raquelz48', 'paularodriguez', 'mattbalisky', 'waheed.ahmed12', 'felipeballesteros1', 'jisaucedo', 'jgonza4643', 'yiyusiyang', 'ahmad.abdulraheem', 'felipedavidsp', 'mfrounchi3', 'kirito', 'ponchitofam', 'chazzles', 'ankitubc', 'oconnomi', 'eren121313', 'vflombrana', 'varlamovand', 'osacosta', 'cacost919', 'melike_musal', 'ydeokar24', 'mohamedsaleh106', 'fernajes', 'baili19', 'omar.sosa.quimica', 'contiveros7', 'saminsss', 'teh', 'islam_hisham', 'reyesmiguel888', 'edwardleelk123', 'dvillalva21', 'lrburgueno', 'fvaldezroman', 'samiha_hassan', 'krusea', 'cemkarts', 'dakota1268', 'mollyrathore.18', 'norton.huang', 'megang1218', 'johngould1997', 'ivan07guerrero', 'joejones143', 'hehasan', 'fatplatypus69', 'koagbita', 'chenlingjie38', 'bnanojeff', 's.ganapathy.52', 'jpjauw', 'kareem.men3em', 'willbouns', 'brunorodriguez1998', 'elgohari95', 'zubeydekal37', 'caoboxuan1998', 'austalavistababy', 'odemc', 'gandersen26', 'dterrazas3', 'bpbkaminski', 'landa.esteban', 'aralbevtt', 'yuejiaqi1', 'sophia00', 'shininamuthiora', 'walcottr', 'amarin2997', 'icasper2', 'baatarb', 'kellymyers', 'mmedina340', 'mmert.bacak', 'nimakondori96', 'lamho', 'nyazdi', 'aguade03', 'zachfu97', 'elie_9742', 'gisel.fregoso', 'chen.hugh1998', 'josborne', 'adhikarr95', 'jmckenzie', 'hm.am.da', 'hzlzyuan', 'kvziwc', 'minjares.jesus.ths', 'metalist_kaan', 'fmyurtsever', 'raib', 'heiknen', 'asolis21', 'paulrakowicz', 'parisa.esh', 'tarek20501', 'amevipin', 'alexmartinezzero', 'chenxi9649', 'dusty5683', 'polat.gokberk', 'alek.konicki09', 'cgmartan', 'jorge1799', 'mrg31415926', 'anieto5', 'emre_citak_bil', 'diegoerickherrera', 'cmflores10', 'usuarez11', 'eliot9700', 'ilkaydost', 'kweze118', 'omerfkazar22', 'ivan0703', 'jdcanlas7', 'cynthia.oaxaca3', 'geberia', 'edwardmartyr', 'davinb', 'lusiyang93', 'masoudmokht', 'dragonswrath', 'infinity444phi', 'carlosmata', 'cesarin159', 'gurindergarcha98', 'drhodges', 'vandphil', 'jarrah_5011', 'shaffert', 'teck60osc', 'atuftee', 'ronal_denho_931', 'crojas7', 'mkrysicki', 'barrsw3', 'nsimla', 'oscarelozano', 'afkali.120', 'furkanznkr', 'crysdbz.22', 'laarvizu', 'meni72', 'muldowneyc2019', 'nmalshammari', 'iagord93', 'jscordero1', None, 'haticesari333333', 'keshavdidi', 'alanrayharr', 'phonegamepc', 'daniboy12', 'quinnw115', 'djm1411', 'anoophundle', 'jalujan8', 'xbaca', 'lee.johnny.2014', 'lmelend1', 'wynvlntkd', 'fdo.glz', 'yunusbaskan', 'aramirez64', 'furkanturk1352']"
3,263,169,21,4,"['polat.gokberk', 'furkanturk1352', 'ronal_denho_931', 'metalist_kaan']",164,"['raquelz48', 'paularodriguez', 'mattbalisky', 'waheed.ahmed12', 'felipeballesteros1', 'jisaucedo', 'jgonza4643', 'yiyusiyang', 'ahmad.abdulraheem', 'felipedavidsp', 'mfrounchi3', 'kirito', 'ponchitofam', 'chazzles', 'ankitubc', 'oconnomi', 'eren121313', 'vflombrana', 'varlamovand', 'osacosta', 'cacost919', 'melike_musal', 'ydeokar24', 'mohamedsaleh106', 'fernajes', 'baili19', 'omar.sosa.quimica', 'contiveros7', 'saminsss', 'teh', 'islam_hisham', 'reyesmiguel888', 'edwardleelk123', 'dvillalva21', 'lrburgueno', 'fvaldezroman', 'samiha_hassan', 'krusea', 'cemkarts', 'dakota1268', 'mollyrathore.18', 'norton.huang', 'megang1218', 'johngould1997', 'ivan07guerrero', 'joejones143', 'hehasan', 'fatplatypus69', 'koagbita', 'chenlingjie38', 'bnanojeff', 's.ganapathy.52', 'jpjauw', 'kareem.men3em', 'willbouns', 'brunorodriguez1998', 'elgohari95', 'zubeydekal37', 'caoboxuan1998', 'austalavistababy', 'odemc', 'gandersen26', 'dterrazas3', 'bpbkaminski', 'landa.esteban', 'aralbevtt', 'yuejiaqi1', 'sophia00', 'shininamuthiora', 'walcottr', 'amarin2997', 'icasper2', 'baatarb', 'kellymyers', 'mmedina340', 'mmert.bacak', 'nimakondori96', 'lamho', 'nyazdi', 'aguade03', 'zachfu97', 'elie_9742', 'gisel.fregoso', 'chen.hugh1998', 'josborne', 'adhikarr95', 'jmckenzie', 'hm.am.da', 'hzlzyuan', 'kvziwc', 'minjares.jesus.ths', 'fmyurtsever', 'raib', 'heiknen', 'asolis21', 'paulrakowicz', 'parisa.esh', 'tarek20501', 'amevipin', 'alexmartinezzero', 'chenxi9649', 'dusty5683', 'alek.konicki09', 'cgmartan', 'jorge1799', 'mrg31415926', 'anieto5', 'emre_citak_bil', 'diegoerickherrera', 'cmflores10', 'usuarez11', 'eliot9700', 'ilkaydost', 'kweze118', 'omerfkazar22', 'ivan0703', 'jdcanlas7', 'cynthia.oaxaca3', 'geberia', 'edwardmartyr', 'davinb', 'lusiyang93', 'masoudmokht', 'dragonswrath', 'infinity444phi', 'carlosmata', 'cesarin159', 'gurindergarcha98', 'drhodges', 'vandphil', 'jarrah_5011', 'shaffert', 'teck60osc', 'atuftee', 'crojas7', 'mkrysicki', 'barrsw3', 'nsimla', 'oscarelozano', 'afkali.120', 'furkanznkr', 'crysdbz.22', 'laarvizu', 'meni72', 'muldowneyc2019', 'nmalshammari', 'iagord93', 'jscordero1', 'haticesari333333', 'keshavdidi', 'alanrayharr', 'phonegamepc', 'daniboy12', 'quinnw115', 'djm1411', 'anoophundle', 'jalujan8', 'xbaca', 'lee.johnny.2014', 'lmelend1', 'wynvlntkd', 'fdo.glz', 'yunusbaskan', 'aramirez64']",17,"['trkmengkay', 'ozgurkablan26', 'oakbulut1997', 'senanurcetin96', 'tuberkargan_97', 'sudekoza', 'nihansulukoy', 'emrebuyukkose2', 'brknshn', 'okanircann', 'joker632455', 'elifisparta38', 'melisozkarr', 'ozgurdenizkozan', None, 'sinasigurpinar', 'fatiherdgn25']",185,"['raquelz48', 'ozgurkablan26', 'tuberkargan_97', 'paularodriguez', 'mattbalisky', 'waheed.ahmed12', 'felipeballesteros1', 'jisaucedo', 'jgonza4643', 'yiyusiyang', 'ahmad.abdulraheem', 'felipedavidsp', 'mfrounchi3', 'kirito', 'ponchitofam', 'chazzles', 'ankitubc', 'oconnomi', 'eren121313', 'vflombrana', 'varlamovand', 'nihansulukoy', 'osacosta', 'cacost919', 'melike_musal', 'ozgurdenizkozan', 'ydeokar24', 'mohamedsaleh106', 'fernajes', 'baili19', 'omar.sosa.quimica', 'contiveros7', 'saminsss', 'teh', 'islam_hisham', 'reyesmiguel888', 'edwardleelk123', 'dvillalva21', 'lrburgueno', 'fvaldezroman', 'samiha_hassan', 'krusea', 'trkmengkay', 'cemkarts', 'dakota1268', 'mollyrathore.18', 'norton.huang', 'megang1218', 'johngould1997', 'ivan07guerrero', 'sinasigurpinar', 'joejones143', 'hehasan', 'fatplatypus69', 'koagbita', 'chenlingjie38', 'bnanojeff', 'elifisparta38', 's.ganapathy.52', 'jpjauw', 'kareem.men3em', 'willbouns', 'brunorodriguez1998', 'elgohari95', 'zubeydekal37', 'caoboxuan1998', 'austalavistababy', 'odemc', 'gandersen26', 'dterrazas3', 'sudekoza', 'bpbkaminski', 'landa.esteban', 'aralbevtt', 'yuejiaqi1', 'sophia00', 'shininamuthiora', 'walcottr', 'amarin2997', 'icasper2', 'baatarb', 'kellymyers', 'mmedina340', 'mmert.bacak', 'nimakondori96', 'brknshn', 'lamho', 'nyazdi', 'aguade03', 'zachfu97', 'elie_9742', 'melisozkarr', 'gisel.fregoso', 'chen.hugh1998', 'josborne', 'adhikarr95', 'jmckenzie', 'hm.am.da', 'hzlzyuan', 'kvziwc', 'minjares.jesus.ths', 'metalist_kaan', 'fmyurtsever', 'raib', 'heiknen', 'asolis21', 'paulrakowicz', 'parisa.esh', 'tarek20501', 'amevipin', 'alexmartinezzero', 'chenxi9649', 'dusty5683', 'oakbulut1997', 'polat.gokberk', 'alek.konicki09', 'cgmartan', 'jorge1799', 'mrg31415926', 'anieto5', 'emre_citak_bil', 'diegoerickherrera', 'cmflores10', 'usuarez11', 'eliot9700', 'ilkaydost', 'kweze118', 'omerfkazar22', 'ivan0703', 'jdcanlas7', 'cynthia.oaxaca3', 'geberia', 'edwardmartyr', 'davinb', 'lusiyang93', 'masoudmokht', 'dragonswrath', 'infinity444phi', 'carlosmata', 'emrebuyukkose2', 'cesarin159', 'gurindergarcha98', 'drhodges', 'vandphil', 'jarrah_5011', 'shaffert', 'fatiherdgn25', 'teck60osc', 'atuftee', 'ronal_denho_931', 'crojas7', 'mkrysicki', 'barrsw3', 'nsimla', 'oscarelozano', 'afkali.120', 'furkanznkr', 'crysdbz.22', 'senanurcetin96', 'laarvizu', 'meni72', 'muldowneyc2019', 'nmalshammari', 'iagord93', 'jscordero1', None, 'haticesari333333', 'keshavdidi', 'alanrayharr', 'phonegamepc', 'daniboy12', 'quinnw115', 'djm1411', 'anoophundle', 'jalujan8', 'xbaca', 'lee.johnny.2014', 'lmelend1', 'wynvlntkd', 'okanircann', 'joker632455', 'fdo.glz', 'yunusbaskan', 'aramirez64', 'furkanturk1352']"
3,269,169,14,5,"['elgohari95', 'mohamedsaleh106', 'waheed.ahmed12', 'islam_hisham', 'kareem.men3em']",163,"['raquelz48', 'paularodriguez', 'mattbalisky', 'felipeballesteros1', 'jisaucedo', 'jgonza4643', 'yiyusiyang', 'ahmad.abdulraheem', 'felipedavidsp', 'mfrounchi3', 'kirito', 'ponchitofam', 'chazzles', 'ankitubc', 'oconnomi', 'eren121313', 'vflombrana', 'varlamovand', 'osacosta', 'cacost919', 'melike_musal', 'ydeokar24', 'fernajes', 'baili19', 'omar.sosa.quimica', 'contiveros7', 'saminsss', 'teh', 'reyesmiguel888', 'edwardleelk123', 'dvillalva21', 'lrburgueno', 'fvaldezroman', 'samiha_hassan', 'krusea', 'cemkarts', 'dakota1268', 'mollyrathore.18', 'norton.huang', 'megang1218', 'johngould1997', 'ivan07guerrero', 'joejones143', 'hehasan', 'fatplatypus69', 'koagbita', 'chenlingjie38', 'bnanojeff', 's.ganapathy.52', 'jpjauw', 'willbouns', 'brunorodriguez1998', 'zubeydekal37', 'caoboxuan1998', 'austalavistababy', 'odemc', 'gandersen26', 'dterrazas3', 'bpbkaminski', 'landa.esteban', 'aralbevtt', 'yuejiaqi1', 'sophia00', 'shininamuthiora', 'walcottr', 'amarin2997', 'icasper2', 'baatarb', 'kellymyers', 'mmedina340', 'mmert.bacak', 'nimakondori96', 'lamho', 'nyazdi', 'aguade03', 'zachfu97', 'elie_9742', 'gisel.fregoso', 'chen.hugh1998', 'josborne', 'adhikarr95', 'jmckenzie', 'hm.am.da', 'hzlzyuan', 'kvziwc', 'minjares.jesus.ths', 'metalist_kaan', 'fmyurtsever', 'raib', 'heiknen', 'asolis21', 'paulrakowicz', 'parisa.esh', 'tarek20501', 'amevipin', 'alexmartinezzero', 'chenxi9649', 'dusty5683', 'polat.gokberk', 'alek.konicki09', 'cgmartan', 'jorge1799', 'mrg31415926', 'anieto5', 'emre_citak_bil', 'diegoerickherrera', 'cmflores10', 'usuarez11', 'eliot9700', 'ilkaydost', 'kweze118', 'omerfkazar22', 'ivan0703', 'jdcanlas7', 'cynthia.oaxaca3', 'geberia', 'edwardmartyr', 'davinb', 'lusiyang93', 'masoudmokht', 'dragonswrath', 'infinity444phi', 'carlosmata', 'cesarin159', 'gurindergarcha98', 'drhodges', 'vandphil', 'jarrah_5011', 'shaffert', 'teck60osc', 'atuftee', 'ronal_denho_931', 'crojas7', 'mkrysicki', 'barrsw3', 'nsimla', 'oscarelozano', 'afkali.120', 'furkanznkr', 'crysdbz.22', 'laarvizu', 'meni72', 'muldowneyc2019', 'nmalshammari', 'iagord93', 'jscordero1', 'haticesari333333', 'keshavdidi', 'alanrayharr', 'phonegamepc', 'daniboy12', 'quinnw115', 'djm1411', 'anoophundle', 'jalujan8', 'xbaca', 'lee.johnny.2014', 'lmelend1', 'wynvlntkd', 'fdo.glz', 'yunusbaskan', 'aramirez64', 'furkanturk1352']",9,"[None, 'asmaa_abdelmegeed.', 'mohamedmsaad66', 'mohamed.h.mamdouh', 'basem.ali95', 'mhesham2018', 'ahmedraouf', 'bakr', 'mohamed.ah.omran']",177,"['raquelz48', 'paularodriguez', 'mattbalisky', 'waheed.ahmed12', 'felipeballesteros1', 'mohamedmsaad66', 'jisaucedo', 'jgonza4643', 'yiyusiyang', 'ahmad.abdulraheem', 'felipedavidsp', 'mfrounchi3', 'kirito', 'ponchitofam', 'chazzles', 'ankitubc', 'oconnomi', 'eren121313', 'vflombrana', 'varlamovand', 'osacosta', 'cacost919', 'melike_musal', 'ydeokar24', 'mohamedsaleh106', 'fernajes', 'baili19', 'omar.sosa.quimica', 'contiveros7', 'saminsss', 'teh', 'islam_hisham', 'reyesmiguel888', 'edwardleelk123', 'dvillalva21', 'asmaa_abdelmegeed.', 'lrburgueno', 'fvaldezroman', 'samiha_hassan', 'krusea', 'cemkarts', 'dakota1268', 'mollyrathore.18', 'norton.huang', 'megang1218', 'johngould1997', 'ivan07guerrero', 'joejones143', 'hehasan', 'fatplatypus69', 'koagbita', 'chenlingjie38', 'bnanojeff', 'basem.ali95', 's.ganapathy.52', 'jpjauw', 'mohamed.ah.omran', 'kareem.men3em', 'willbouns', 'brunorodriguez1998', 'elgohari95', 'zubeydekal37', 'caoboxuan1998', 'mhesham2018', 'austalavistababy', 'odemc', 'gandersen26', 'dterrazas3', 'bpbkaminski', 'landa.esteban', 'aralbevtt', 'yuejiaqi1', 'sophia00', 'shininamuthiora', 'walcottr', 'amarin2997', 'icasper2', 'baatarb', 'kellymyers', 'mmedina340', 'mmert.bacak', 'nimakondori96', 'lamho', 'nyazdi', 'aguade03', 'zachfu97', 'elie_9742', 'gisel.fregoso', 'chen.hugh1998', 'josborne', 'adhikarr95', 'jmckenzie', 'hm.am.da', 'hzlzyuan', 'kvziwc', 'minjares.jesus.ths', 'metalist_kaan', 'fmyurtsever', 'raib', 'heiknen', 'asolis21', 'paulrakowicz', 'parisa.esh', 'tarek20501', 'amevipin', 'alexmartinezzero', 'chenxi9649', 'dusty5683', 'polat.gokberk', 'mohamed.h.mamdouh', 'alek.konicki09', 'cgmartan', 'jorge1799', 'mrg31415926', 'anieto5', 'emre_citak_bil', 'diegoerickherrera', 'cmflores10', 'usuarez11', 'eliot9700', 'ilkaydost', 'kweze118', 'omerfkazar22', 'ivan0703', 'jdcanlas7', 'cynthia.oaxaca3', 'geberia', 'edwardmartyr', 'davinb', 'lusiyang93', 'masoudmokht', 'dragonswrath', 'infinity444phi', 'carlosmata', 'cesarin159', 'gurindergarcha98', 'drhodges', 'vandphil', 'jarrah_5011', 'shaffert', 'teck60osc', 'atuftee', 'ronal_denho_931', 'crojas7', 'mkrysicki', 'barrsw3', 'nsimla', 'ahmedraouf', 'oscarelozano', 'afkali.120', 'furkanznkr', 'crysdbz.22', 'laarvizu', 'meni72', 'muldowneyc2019', 'nmalshammari', 'iagord93', 'jscordero1', 'bakr', None, 'haticesari333333', 'keshavdidi', 'alanrayharr', 'phonegamepc', 'daniboy12', 'quinnw115', 'djm1411', 'anoophundle', 'jalujan8', 'xbaca', 'lee.johnny.2014', 'lmelend1', 'wynvlntkd', 'fdo.glz', 'yunusbaskan', 'aramirez64', 'furkanturk1352']"
3,265,169,8,2,"['mmert.bacak', 'zubeydekal37']",166,"['raquelz48', 'paularodriguez', 'mattbalisky', 'waheed.ahmed12', 'felipeballesteros1', 'jisaucedo', 'jgonza4643', 'yiyusiyang', 'ahmad.abdulraheem', 'felipedavidsp', 'mfrounchi3', 'kirito', 'ponchitofam', 'chazzles', 'ankitubc', 'oconnomi', 'eren121313', 'vflombrana', 'varlamovand', 'osacosta', 'cacost919', 'melike_musal', 'ydeokar24', 'mohamedsaleh106', 'fernajes', 'baili19', 'omar.sosa.quimica', 'contiveros7', 'saminsss', 'teh', 'islam_hisham', 'reyesmiguel888', 'edwardleelk123', 'dvillalva21', 'lrburgueno', 'fvaldezroman', 'samiha_hassan', 'krusea', 'cemkarts', 'dakota1268', 'mollyrathore.18', 'norton.huang', 'megang1218', 'johngould1997', 'ivan07guerrero', 'joejones143', 'hehasan', 'fatplatypus69', 'koagbita', 'chenlingjie38', 'bnanojeff', 's.ganapathy.52', 'jpjauw', 'kareem.men3em', 'willbouns', 'brunorodriguez1998', 'elgohari95', 'caoboxuan1998', 'austalavistababy', 'odemc', 'gandersen26', 'dterrazas3', 'bpbkaminski', 'landa.esteban', 'aralbevtt', 'yuejiaqi1', 'sophia00', 'shininamuthiora', 'walcottr', 'amarin2997', 'icasper2', 'baatarb', 'kellymyers', 'mmedina340', 'nimakondori96', 'lamho', 'nyazdi', 'aguade03', 'zachfu97', 'elie_9742', 'gisel.fregoso', 'chen.hugh1998', 'josborne', 'adhikarr95', 'jmckenzie', 'hm.am.da', 'hzlzyuan', 'kvziwc', 'minjares.jesus.ths', 'metalist_kaan', 'fmyurtsever', 'raib', 'heiknen', 'asolis21', 'paulrakowicz', 'parisa.esh', 'tarek20501', 'amevipin', 'alexmartinezzero', 'chenxi9649', 'dusty5683', 'polat.gokberk', 'alek.konicki09', 'cgmartan', 'jorge1799', 'mrg31415926', 'anieto5', 'emre_citak_bil', 'diegoerickherrera', 'cmflores10', 'usuarez11', 'eliot9700', 'ilkaydost', 'kweze118', 'omerfkazar22', 'ivan0703', 'jdcanlas7', 'cynthia.oaxaca3', 'geberia', 'edwardmartyr', 'davinb', 'lusiyang93', 'masoudmokht', 'dragonswrath', 'infinity444phi', 'carlosmata', 'cesarin159', 'gurindergarcha98', 'drhodges', 'vandphil', 'jarrah_5011', 'shaffert', 'teck60osc', 'atuftee', 'ronal_denho_931', 'crojas7', 'mkrysicki', 'barrsw3', 'nsimla', 'oscarelozano', 'afkali.120', 'furkanznkr', 'crysdbz.22', 'laarvizu', 'meni72', 'muldowneyc2019', 'nmalshammari', 'iagord93', 'jscordero1', 'haticesari333333', 'keshavdidi', 'alanrayharr', 'phonegamepc', 'daniboy12', 'quinnw115', 'djm1411', 'anoophundle', 'jalujan8', 'xbaca', 'lee.johnny.2014', 'lmelend1', 'wynvlntkd', 'fdo.glz', 'yunusbaskan', 'aramirez64', 'furkanturk1352']",6,"['ulasgorcelioglu', 'yilmazberat1997', 'nihansulukoy', 'elifisparta38', 'nagihankececi', None]",174,"['raquelz48', 'paularodriguez', 'mattbalisky', 'waheed.ahmed12', 'felipeballesteros1', 'jisaucedo', 'jgonza4643', 'yiyusiyang', 'ahmad.abdulraheem', 'felipedavidsp', 'mfrounchi3', 'kirito', 'ponchitofam', 'chazzles', 'ankitubc', 'oconnomi', 'eren121313', 'vflombrana', 'varlamovand', 'nihansulukoy', 'osacosta', 'cacost919', 'melike_musal', 'ydeokar24', 'mohamedsaleh106', 'fernajes', 'baili19', 'omar.sosa.quimica', 'contiveros7', 'saminsss', 'teh', 'islam_hisham', 'reyesmiguel888', 'edwardleelk123', 'dvillalva21', 'lrburgueno', 'fvaldezroman', 'samiha_hassan', 'krusea', 'cemkarts', 'dakota1268', 'mollyrathore.18', 'norton.huang', 'megang1218', 'johngould1997', 'ivan07guerrero', 'joejones143', 'hehasan', 'fatplatypus69', 'koagbita', 'chenlingjie38', 'bnanojeff', 'elifisparta38', 's.ganapathy.52', 'jpjauw', 'kareem.men3em', 'willbouns', 'brunorodriguez1998', 'elgohari95', 'zubeydekal37', 'caoboxuan1998', 'austalavistababy', 'odemc', 'gandersen26', 'dterrazas3', 'ulasgorcelioglu', 'bpbkaminski', 'landa.esteban', 'aralbevtt', 'yuejiaqi1', 'sophia00', 'shininamuthiora', 'walcottr', 'amarin2997', 'icasper2', 'baatarb', 'kellymyers', 'mmedina340', 'nagihankececi', 'mmert.bacak', 'nimakondori96', 'lamho', 'nyazdi', 'aguade03', 'zachfu97', 'elie_9742', 'gisel.fregoso', 'chen.hugh1998', 'josborne', 'adhikarr95', 'jmckenzie', 'hm.am.da', 'hzlzyuan', 'kvziwc', 'minjares.jesus.ths', 'metalist_kaan', 'fmyurtsever', 'raib', 'heiknen', 'asolis21', 'paulrakowicz', 'parisa.esh', 'tarek20501', 'amevipin', 'alexmartinezzero', 'chenxi9649', 'dusty5683', 'yilmazberat1997', 'polat.gokberk', 'alek.konicki09', 'cgmartan', 'jorge1799', 'mrg31415926', 'anieto5', 'emre_citak_bil', 'diegoerickherrera', 'cmflores10', 'usuarez11', 'eliot9700', 'ilkaydost', 'kweze118', 'omerfkazar22', 'ivan0703', 'jdcanlas7', 'cynthia.oaxaca3', 'geberia', 'edwardmartyr', 'davinb', 'lusiyang93', 'masoudmokht', 'dragonswrath', 'infinity444phi', 'carlosmata', 'cesarin159', 'gurindergarcha98', 'drhodges', 'vandphil', 'jarrah_5011', 'shaffert', 'teck60osc', 'atuftee', 'ronal_denho_931', 'crojas7', 'mkrysicki', 'barrsw3', 'nsimla', 'oscarelozano', 'afkali.120', 'furkanznkr', 'crysdbz.22', 'laarvizu', 'meni72', 'muldowneyc2019', 'nmalshammari', 'iagord93', 'jscordero1', None, 'haticesari333333', 'keshavdidi', 'alanrayharr', 'phonegamepc', 'daniboy12', 'quinnw115', 'djm1411', 'anoophundle', 'jalujan8', 'xbaca', 'lee.johnny.2014', 'lmelend1', 'wynvlntkd', 'fdo.glz', 'yunusbaskan', 'aramirez64', 'furkanturk1352']"
3,264,169,7,1,['dusty5683'],167,"['raquelz48', 'paularodriguez', 'mattbalisky', 'waheed.ahmed12', 'felipeballesteros1', 'jisaucedo', 'jgonza4643', 'yiyusiyang', 'ahmad.abdulraheem', 'felipedavidsp', 'mfrounchi3', 'kirito', 'ponchitofam', 'chazzles', 'ankitubc', 'oconnomi', 'eren121313', 'vflombrana', 'varlamovand', 'osacosta', 'cacost919', 'melike_musal', 'ydeokar24', 'mohamedsaleh106', 'fernajes', 'baili19', 'omar.sosa.quimica', 'contiveros7', 'saminsss', 'teh', 'islam_hisham', 'reyesmiguel888', 'edwardleelk123', 'dvillalva21', 'lrburgueno', 'fvaldezroman', 'samiha_hassan', 'krusea', 'cemkarts', 'dakota1268', 'mollyrathore.18', 'norton.huang', 'megang1218', 'johngould1997', 'ivan07guerrero', 'joejones143', 'hehasan', 'fatplatypus69', 'koagbita', 'chenlingjie38', 'bnanojeff', 's.ganapathy.52', 'jpjauw', 'kareem.men3em', 'willbouns', 'brunorodriguez1998', 'elgohari95', 'zubeydekal37', 'caoboxuan1998', 'austalavistababy', 'odemc', 'gandersen26', 'dterrazas3', 'bpbkaminski', 'landa.esteban', 'aralbevtt', 'yuejiaqi1', 'sophia00', 'shininamuthiora', 'walcottr', 'amarin2997', 'icasper2', 'baatarb', 'kellymyers', 'mmedina340', 'mmert.bacak', 'nimakondori96', 'lamho', 'nyazdi', 'aguade03', 'zachfu97', 'elie_9742', 'gisel.fregoso', 'chen.hugh1998', 'josborne', 'adhikarr95', 'jmckenzie', 'hm.am.da', 'hzlzyuan', 'kvziwc', 'minjares.jesus.ths', 'metalist_kaan', 'fmyurtsever', 'raib', 'heiknen', 'asolis21', 'paulrakowicz', 'parisa.esh', 'tarek20501', 'amevipin', 'alexmartinezzero', 'chenxi9649', 'polat.gokberk', 'alek.konicki09', 'cgmartan', 'jorge1799', 'mrg31415926', 'anieto5', 'emre_citak_bil', 'diegoerickherrera', 'cmflores10', 'usuarez11', 'eliot9700', 'ilkaydost', 'kweze118', 'omerfkazar22', 'ivan0703', 'jdcanlas7', 'cynthia.oaxaca3', 'geberia', 'edwardmartyr', 'davinb', 'lusiyang93', 'masoudmokht', 'dragonswrath', 'infinity444phi', 'carlosmata', 'cesarin159', 'gurindergarcha98', 'drhodges', 'vandphil', 'jarrah_5011', 'shaffert', 'teck60osc', 'atuftee', 'ronal_denho_931', 'crojas7', 'mkrysicki', 'barrsw3', 'nsimla', 'oscarelozano', 'afkali.120', 'furkanznkr', 'crysdbz.22', 'laarvizu', 'meni72', 'muldowneyc2019', 'nmalshammari', 'iagord93', 'jscordero1', 'haticesari333333', 'keshavdidi', 'alanrayharr', 'phonegamepc', 'daniboy12', 'quinnw115', 'djm1411', 'anoophundle', 'jalujan8', 'xbaca', 'lee.johnny.2014', 'lmelend1', 'wynvlntkd', 'fdo.glz', 'yunusbaskan', 'aramirez64', 'furkanturk1352']",6,"['benetcheverry', 'tarikk', 'denverlloyd', 'aaronbrown1', 'ahmedtaher', None]",174,"['raquelz48', 'paularodriguez', 'mattbalisky', 'waheed.ahmed12', 'felipeballesteros1', 'jisaucedo', 'jgonza4643', 'yiyusiyang', 'ahmad.abdulraheem', 'felipedavidsp', 'mfrounchi3', 'kirito', 'ponchitofam', 'chazzles', 'ankitubc', 'oconnomi', 'eren121313', 'vflombrana', 'varlamovand', 'osacosta', 'cacost919', 'melike_musal', 'ydeokar24', 'mohamedsaleh106', 'fernajes', 'baili19', 'omar.sosa.quimica', 'tarikk', 'contiveros7', 'saminsss', 'teh', 'islam_hisham', 'reyesmiguel888', 'edwardleelk123', 'dvillalva21', 'lrburgueno', 'fvaldezroman', 'samiha_hassan', 'krusea', 'cemkarts', 'dakota1268', 'mollyrathore.18', 'norton.huang', 'denverlloyd', 'megang1218', 'johngould1997', 'ivan07guerrero', 'joejones143', 'hehasan', 'fatplatypus69', 'koagbita', 'chenlingjie38', 'bnanojeff', 's.ganapathy.52', 'jpjauw', 'kareem.men3em', 'willbouns', 'brunorodriguez1998', 'elgohari95', 'benetcheverry', 'zubeydekal37', 'caoboxuan1998', 'austalavistababy', 'odemc', 'gandersen26', 'dterrazas3', 'bpbkaminski', 'landa.esteban', 'aralbevtt', 'yuejiaqi1', 'sophia00', 'shininamuthiora', 'walcottr', 'amarin2997', 'icasper2', 'baatarb', 'kellymyers', 'mmedina340', 'mmert.bacak', 'nimakondori96', 'lamho', 'nyazdi', 'aguade03', 'zachfu97', 'elie_9742', 'gisel.fregoso', 'chen.hugh1998', 'josborne', 'adhikarr95', 'jmckenzie', 'hm.am.da', 'hzlzyuan', 'kvziwc', 'minjares.jesus.ths', 'metalist_kaan', 'fmyurtsever', 'raib', 'heiknen', 'asolis21', 'paulrakowicz', 'parisa.esh', 'tarek20501', 'amevipin', 'alexmartinezzero', 'chenxi9649', 'dusty5683', 'polat.gokberk', 'aaronbrown1', 'alek.konicki09', 'cgmartan', 'jorge1799', 'mrg31415926', 'anieto5', 'emre_citak_bil', 'diegoerickherrera', 'cmflores10', 'usuarez11', 'eliot9700', 'ilkaydost', 'kweze118', 'omerfkazar22', 'ivan0703', 'jdcanlas7', 'cynthia.oaxaca3', 'geberia', 'edwardmartyr', 'davinb', 'lusiyang93', 'masoudmokht', 'dragonswrath', 'infinity444phi', 'carlosmata', 'cesarin159', 'gurindergarcha98', 'drhodges', 'vandphil', 'jarrah_5011', 'shaffert', 'ahmedtaher', 'teck60osc', 'atuftee', 'ronal_denho_931', 'crojas7', 'mkrysicki', 'barrsw3', 'nsimla', 'oscarelozano', 'afkali.120', 'furkanznkr', 'crysdbz.22', 'laarvizu', 'meni72', 'muldowneyc2019', 'nmalshammari', 'iagord93', 'jscordero1', None, 'haticesari333333', 'keshavdidi', 'alanrayharr', 'phonegamepc', 'daniboy12', 'quinnw115', 'djm1411', 'anoophundle', 'jalujan8', 'xbaca', 'lee.johnny.2014', 'lmelend1', 'wynvlntkd', 'fdo.glz', 'yunusbaskan', 'aramirez64', 'furkanturk1352']"
3,273,169,7,1,['elie_9742'],167,"['raquelz48', 'paularodriguez', 'mattbalisky', 'waheed.ahmed12', 'felipeballesteros1', 'jisaucedo', 'jgonza4643', 'yiyusiyang', 'ahmad.abdulraheem', 'felipedavidsp', 'mfrounchi3', 'kirito', 'ponchitofam', 'chazzles', 'ankitubc', 'oconnomi', 'eren121313', 'vflombrana', 'varlamovand', 'osacosta', 'cacost919', 'melike_musal', 'ydeokar24', 'mohamedsaleh106', 'fernajes', 'baili19', 'omar.sosa.quimica', 'contiveros7', 'saminsss', 'teh', 'islam_hisham', 'reyesmiguel888', 'edwardleelk123', 'dvillalva21', 'lrburgueno', 'fvaldezroman', 'samiha_hassan', 'krusea', 'cemkarts', 'dakota1268', 'mollyrathore.18', 'norton.huang', 'megang1218', 'johngould1997', 'ivan07guerrero', 'joejones143', 'hehasan', 'fatplatypus69', 'koagbita', 'chenlingjie38', 'bnanojeff', 's.ganapathy.52', 'jpjauw', 'kareem.men3em', 'willbouns', 'brunorodriguez1998', 'elgohari95', 'zubeydekal37', 'caoboxuan1998', 'austalavistababy', 'odemc', 'gandersen26', 'dterrazas3', 'bpbkaminski', 'landa.esteban', 'aralbevtt', 'yuejiaqi1', 'sophia00', 'shininamuthiora', 'walcottr', 'amarin2997', 'icasper2', 'baatarb', 'kellymyers', 'mmedina340', 'mmert.bacak', 'nimakondori96', 'lamho', 'nyazdi', 'aguade03', 'zachfu97', 'gisel.fregoso', 'chen.hugh1998', 'josborne', 'adhikarr95', 'jmckenzie', 'hm.am.da', 'hzlzyuan', 'kvziwc', 'minjares.jesus.ths', 'metalist_kaan', 'fmyurtsever', 'raib', 'heiknen', 'asolis21', 'paulrakowicz', 'parisa.esh', 'tarek20501', 'amevipin', 'alexmartinezzero', 'chenxi9649', 'dusty5683', 'polat.gokberk', 'alek.konicki09', 'cgmartan', 'jorge1799', 'mrg31415926', 'anieto5', 'emre_citak_bil', 'diegoerickherrera', 'cmflores10', 'usuarez11', 'eliot9700', 'ilkaydost', 'kweze118', 'omerfkazar22', 'ivan0703', 'jdcanlas7', 'cynthia.oaxaca3', 'geberia', 'edwardmartyr', 'davinb', 'lusiyang93', 'masoudmokht', 'dragonswrath', 'infinity444phi', 'carlosmata', 'cesarin159', 'gurindergarcha98', 'drhodges', 'vandphil', 'jarrah_5011', 'shaffert', 'teck60osc', 'atuftee', 'ronal_denho_931', 'crojas7', 'mkrysicki', 'barrsw3', 'nsimla', 'oscarelozano', 'afkali.120', 'furkanznkr', 'crysdbz.22', 'laarvizu', 'meni72', 'muldowneyc2019', 'nmalshammari', 'iagord93', 'jscordero1', 'haticesari333333', 'keshavdidi', 'alanrayharr', 'phonegamepc', 'daniboy12', 'quinnw115', 'djm1411', 'anoophundle', 'jalujan8', 'xbaca', 'lee.johnny.2014', 'lmelend1', 'wynvlntkd', 'fdo.glz', 'yunusbaskan', 'aramirez64', 'furkanturk1352']",6,"['bianca11', 'trevor.tartaglia', 'jonah.mauxion', 'maximelemieuxtanguay', None, 'alexis.perez183']",174,"['raquelz48', 'paularodriguez', 'mattbalisky', 'waheed.ahmed12', 'felipeballesteros1', 'jisaucedo', 'jgonza4643', 'yiyusiyang', 'ahmad.abdulraheem', 'felipedavidsp', 'mfrounchi3', 'kirito', 'ponchitofam', 'chazzles', 'ankitubc', 'oconnomi', 'eren121313', 'vflombrana', 'varlamovand', 'osacosta', 'cacost919', 'melike_musal', 'ydeokar24', 'mohamedsaleh106', 'fernajes', 'baili19', 'omar.sosa.quimica', 'contiveros7', 'saminsss', 'teh', 'islam_hisham', 'reyesmiguel888', 'edwardleelk123', 'dvillalva21', 'lrburgueno', 'fvaldezroman', 'samiha_hassan', 'krusea', 'cemkarts', 'dakota1268', 'mollyrathore.18', 'norton.huang', 'megang1218', 'johngould1997', 'ivan07guerrero', 'joejones143', 'hehasan', 'fatplatypus69', 'koagbita', 'chenlingjie38', 'bnanojeff', 's.ganapathy.52', 'jpjauw', 'kareem.men3em', 'willbouns', 'brunorodriguez1998', 'elgohari95', 'zubeydekal37', 'caoboxuan1998', 'trevor.tartaglia', 'jonah.mauxion', 'austalavistababy', 'alexis.perez183', 'odemc', 'gandersen26', 'dterrazas3', 'bpbkaminski', 'landa.esteban', 'aralbevtt', 'yuejiaqi1', 'sophia00', 'shininamuthiora', 'walcottr', 'amarin2997', 'icasper2', 'baatarb', 'kellymyers', 'mmedina340', 'mmert.bacak', 'nimakondori96', 'lamho', 'nyazdi', 'aguade03', 'zachfu97', 'elie_9742', 'gisel.fregoso', 'chen.hugh1998', 'josborne', 'adhikarr95', 'jmckenzie', 'hm.am.da', 'hzlzyuan', 'kvziwc', 'minjares.jesus.ths', 'metalist_kaan', 'fmyurtsever', 'raib', 'heiknen', 'asolis21', 'paulrakowicz', 'parisa.esh', 'tarek20501', 'amevipin', 'alexmartinezzero', 'chenxi9649', 'dusty5683', 'polat.gokberk', 'alek.konicki09', 'cgmartan', 'jorge1799', 'maximelemieuxtanguay', 'mrg31415926', 'anieto5', 'emre_citak_bil', 'diegoerickherrera', 'cmflores10', 'usuarez11', 'eliot9700', 'ilkaydost', 'kweze118', 'omerfkazar22', 'ivan0703', 'jdcanlas7', 'cynthia.oaxaca3', 'geberia', 'edwardmartyr', 'davinb', 'lusiyang93', 'masoudmokht', 'dragonswrath', 'infinity444phi', 'carlosmata', 'cesarin159', 'gurindergarcha98', 'drhodges', 'vandphil', 'jarrah_5011', 'shaffert', 'teck60osc', 'atuftee', 'ronal_denho_931', 'crojas7', 'mkrysicki', 'barrsw3', 'nsimla', 'oscarelozano', 'afkali.120', 'furkanznkr', 'crysdbz.22', 'bianca11', 'laarvizu', 'meni72', 'muldowneyc2019', 'nmalshammari', 'iagord93', 'jscordero1', None, 'haticesari333333', 'keshavdidi', 'alanrayharr', 'phonegamepc', 'daniboy12', 'quinnw115', 'djm1411', 'anoophundle', 'jalujan8', 'xbaca', 'lee.johnny.2014', 'lmelend1', 'wynvlntkd', 'fdo.glz', 'yunusbaskan', 'aramirez64', 'furkanturk1352']"
3,272,169,6,1,['paularodriguez'],167,"['raquelz48', 'mattbalisky', 'waheed.ahmed12', 'felipeballesteros1', 'jisaucedo', 'jgonza4643', 'yiyusiyang', 'ahmad.abdulraheem', 'felipedavidsp', 'mfrounchi3', 'kirito', 'ponchitofam', 'chazzles', 'ankitubc', 'oconnomi', 'eren121313', 'vflombrana', 'varlamovand', 'osacosta', 'cacost919', 'melike_musal', 'ydeokar24', 'mohamedsaleh106', 'fernajes', 'baili19', 'omar.sosa.quimica', 'contiveros7', 'saminsss', 'teh', 'islam_hisham', 'reyesmiguel888', 'edwardleelk123', 'dvillalva21', 'lrburgueno', 'fvaldezroman', 'samiha_hassan', 'krusea', 'cemkarts', 'dakota1268', 'mollyrathore.18', 'norton.huang', 'megang1218', 'johngould1997', 'ivan07guerrero', 'joejones143', 'hehasan', 'fatplatypus69', 'koagbita', 'chenlingjie38', 'bnanojeff', 's.ganapathy.52', 'jpjauw', 'kareem.men3em', 'willbouns', 'brunorodriguez1998', 'elgohari95', 'zubeydekal37', 'caoboxuan1998', 'austalavistababy', 'odemc', 'gandersen26', 'dterrazas3', 'bpbkaminski', 'landa.esteban', 'aralbevtt', 'yuejiaqi1', 'sophia00', 'shininamuthiora', 'walcottr', 'amarin2997', 'icasper2', 'baatarb', 'kellymyers', 'mmedina340', 'mmert.bacak', 'nimakondori96', 'lamho', 'nyazdi', 'aguade03', 'zachfu97', 'elie_9742', 'gisel.fregoso', 'chen.hugh1998', 'josborne', 'adhikarr95', 'jmckenzie', 'hm.am.da', 'hzlzyuan', 'kvziwc', 'minjares.jesus.ths', 'metalist_kaan', 'fmyurtsever', 'raib', 'heiknen', 'asolis21', 'paulrakowicz', 'parisa.esh', 'tarek20501', 'amevipin', 'alexmartinezzero', 'chenxi9649', 'dusty5683', 'polat.gokberk', 'alek.konicki09', 'cgmartan', 'jorge1799', 'mrg31415926', 'anieto5', 'emre_citak_bil', 'diegoerickherrera', 'cmflores10', 'usuarez11', 'eliot9700', 'ilkaydost', 'kweze118', 'omerfkazar22', 'ivan0703', 'jdcanlas7', 'cynthia.oaxaca3', 'geberia', 'edwardmartyr', 'davinb', 'lusiyang93', 'masoudmokht', 'dragonswrath', 'infinity444phi', 'carlosmata', 'cesarin159', 'gurindergarcha98', 'drhodges', 'vandphil', 'jarrah_5011', 'shaffert', 'teck60osc', 'atuftee', 'ronal_denho_931', 'crojas7', 'mkrysicki', 'barrsw3', 'nsimla', 'oscarelozano', 'afkali.120', 'furkanznkr', 'crysdbz.22', 'laarvizu', 'meni72', 'muldowneyc2019', 'nmalshammari', 'iagord93', 'jscordero1', 'haticesari333333', 'keshavdidi', 'alanrayharr', 'phonegamepc', 'daniboy12', 'quinnw115', 'djm1411', 'anoophundle', 'jalujan8', 'xbaca', 'lee.johnny.2014', 'lmelend1', 'wynvlntkd', 'fdo.glz', 'yunusbaskan', 'aramirez64', 'furkanturk1352']",5,"['aronchino6', 'gombut', 'pvalladaresfdez', None, 'perezsarmar']",173,"['raquelz48', 'paularodriguez', 'mattbalisky', 'waheed.ahmed12', 'felipeballesteros1', 'jisaucedo', 'jgonza4643', 'yiyusiyang', 'ahmad.abdulraheem', 'felipedavidsp', 'mfrounchi3', 'kirito', 'ponchitofam', 'chazzles', 'ankitubc', 'oconnomi', 'eren121313', 'vflombrana', 'varlamovand', 'gombut', 'osacosta', 'cacost919', 'melike_musal', 'ydeokar24', 'mohamedsaleh106', 'fernajes', 'baili19', 'omar.sosa.quimica', 'contiveros7', 'saminsss', 'teh', 'islam_hisham', 'reyesmiguel888', 'edwardleelk123', 'dvillalva21', 'lrburgueno', 'pvalladaresfdez', 'fvaldezroman', 'samiha_hassan', 'krusea', 'cemkarts', 'dakota1268', 'mollyrathore.18', 'norton.huang', 'megang1218', 'johngould1997', 'ivan07guerrero', 'joejones143', 'hehasan', 'fatplatypus69', 'koagbita', 'chenlingjie38', 'bnanojeff', 's.ganapathy.52', 'jpjauw', 'kareem.men3em', 'willbouns', 'brunorodriguez1998', 'elgohari95', 'zubeydekal37', 'caoboxuan1998', 'austalavistababy', 'odemc', 'gandersen26', 'dterrazas3', 'bpbkaminski', 'landa.esteban', 'aralbevtt', 'yuejiaqi1', 'sophia00', 'shininamuthiora', 'walcottr', 'amarin2997', 'icasper2', 'baatarb', 'kellymyers', 'mmedina340', 'mmert.bacak', 'nimakondori96', 'lamho', 'nyazdi', 'aguade03', 'zachfu97', 'elie_9742', 'gisel.fregoso', 'chen.hugh1998', 'josborne', 'adhikarr95', 'jmckenzie', 'hm.am.da', 'hzlzyuan', 'kvziwc', 'minjares.jesus.ths', 'metalist_kaan', 'fmyurtsever', 'raib', 'heiknen', 'asolis21', 'paulrakowicz', 'parisa.esh', 'tarek20501', 'amevipin', 'perezsarmar', 'alexmartinezzero', 'chenxi9649', 'dusty5683', 'polat.gokberk', 'alek.konicki09', 'cgmartan', 'jorge1799', 'mrg31415926', 'anieto5', 'emre_citak_bil', 'diegoerickherrera', 'cmflores10', 'usuarez11', 'eliot9700', 'ilkaydost', 'kweze118', 'omerfkazar22', 'ivan0703', 'jdcanlas7', 'cynthia.oaxaca3', 'geberia', 'edwardmartyr', 'davinb', 'lusiyang93', 'masoudmokht', 'dragonswrath', 'infinity444phi', 'carlosmata', 'aronchino6', 'cesarin159', 'gurindergarcha98', 'drhodges', 'vandphil', 'jarrah_5011', 'shaffert', 'teck60osc', 'atuftee', 'ronal_denho_931', 'crojas7', 'mkrysicki', 'barrsw3', 'nsimla', 'oscarelozano', 'afkali.120', 'furkanznkr', 'crysdbz.22', 'laarvizu', 'meni72', 'muldowneyc2019', 'nmalshammari', 'iagord93', 'jscordero1', None, 'haticesari333333', 'keshavdidi', 'alanrayharr', 'phonegamepc', 'daniboy12', 'quinnw115', 'djm1411', 'anoophundle', 'jalujan8', 'xbaca', 'lee.johnny.2014', 'lmelend1', 'wynvlntkd', 'fdo.glz', 'yunusbaskan', 'aramirez64', 'furkanturk1352']"
4,119,166,65,57,"['kcrawf', 'vkov', 'pinea', 'reisnerd', 'apielack', 'ccafmeye', 'tbarang', 'liutif', 'jyhoff', 'claudsnd', 'herrerag', 'dshah515', 'malhark', 'jbpeller', 'ggracevr', 'jeilers', 'jepi', 'katferg', 'mgratows', 'cjbmi', 'grfedele', 'kenmp', 'deanjac99', 'llsloan55555', 'asasa', 'dhruvtatke', 'lrhamp', 'narceci', 'ybeeker', 'maymephilbrick', 'alexzimm', 'sayanr', 'cdonahu', 'amandnic', 'zouhaox', 'snahe', 'optalmad', 'ldwillia', 'aapfel', 'nikaren', 'brokawat', 'healyjl', 'krislew', 'kmaxie', 'rexkhan', 'haileymk', 'scollard', 'alexshaw', 'danevans', 'rishavc', 'apdoyle', 'woodjosh', 'lwight', 'shirundo', 'rrwilson', 'dmcpher', 'saxman25']",108,"['ssengupta3', 'dwangy', 'yfchen87', 'monisanchezblanco', 'lenling', 'artrinity', 'ehsi', 'avibreg', 'jhardi9', 'iamavash', 'anfetre', 'mirandamiao', 'kobocc1994', 'mreed11', 'jkern3', 'ialonsogago', 'jaketh2', 'ollorentemartija', 'acleve', 'cdrewery', 'werforgerf4life', 'kli47', 'fphender', 'costalt', 'rlrob', 'lmorrissey', 'clindn', 'shawak', 'hregner2', 'annakcha', 'sebmuraru', 'myrta', 'nsk2', 'brenrice', 'mccartnt', 'ahmadubuntu', 'ajhorvath', 'brdemarc', 'cpassolano', 'dkatz4', 'ryougijc', 'mattfuentez10', 'dieguez999', 'leveill2', 'mlodriguito', 'rotenmax', 'amroe', 'blanzyt', 'ksallans', 'reedy', 'kartikghosh2008', 'allendc', 'jojoco', 'tdabney', 'ehai1234', 'joseam2', 'arehman4', 'solayinka', 'lmeddaugh', 'qzhang', 'ollinebg', 'chinmayanandadm', 'komen', 'hteutsch', 'umana2', 'hgaudin', 'eraeker', 'dmartinfernandezvald', 'tarnsangprad', 'barbaraldoriga5', 'serenad', 'higgin24', 'ftadros', 'tobias.m.egle', 'mayank4551', 'aalmohri', 'xzhan147', 'ojovinomarques', 'jerry0075566', 'dkfkadbs304', 'ssmate', 'ychen261', 'wbumbaca', 'moralist', 'shea.costner', 'jcobolopez', 'mviksne', 'tecatetrav', 'frasheski', 'stu', 'stapleton3', 'tmarkiew', 'liannaldo007', 'phamleminhthong', 'ggmorrow', 's.bikash', 'asadncepc', 'cjmichae', 'kjfrank2', 'davisloen', 'shamilt3', 'msross', 'saurabhchem09', 'pdstaubl', 'eescudermilian', 'yzhou91', 'bebling', 'yhu55']",8,"['amamj', 'lobbiam', 'alillig', 'stevexu', 'hoopesma', 'ralsmith', 'odonnelc', None]",173,"['kcrawf', 'vkov', 'pinea', 'ssengupta3', 'dwangy', 'yfchen87', 'liutif', 'monisanchezblanco', 'ralsmith', 'jyhoff', 'artrinity', 'lenling', 'ehsi', 'avibreg', 'jhardi9', 'iamavash', 'kenmp', 'anfetre', 'mirandamiao', 'dhruvtatke', 'kobocc1994', 'ybeeker', 'mreed11', 'alexzimm', 'cdonahu', 'jkern3', 'amandnic', 'optalmad', 'ialonsogago', 'jaketh2', 'nikaren', 'ollorentemartija', 'amamj', 'acleve', 'cdrewery', 'alexshaw', 'danevans', 'rishavc', 'apdoyle', 'werforgerf4life', 'kli47', 'fphender', 'shirundo', 'rrwilson', 'costalt', 'rlrob', 'lmorrissey', 'clindn', 'shawak', 'hregner2', 'annakcha', 'sebmuraru', 'myrta', 'nsk2', 'brenrice', 'claudsnd', 'jbpeller', 'mccartnt', 'jeilers', 'katferg', 'ahmadubuntu', 'cjbmi', 'ajhorvath', 'brdemarc', 'cpassolano', 'dkatz4', 'narceci', 'ryougijc', 'mattfuentez10', 'dieguez999', 'leveill2', 'ldwillia', 'odonnelc', 'mlodriguito', 'rotenmax', 'amroe', 'scollard', 'blanzyt', 'ksallans', 'reedy', 'kartikghosh2008', 'reisnerd', 'apielack', 'allendc', 'stevexu', 'tbarang', 'jojoco', 'tdabney', 'ehai1234', 'joseam2', 'ggracevr', 'arehman4', 'solayinka', 'lmeddaugh', 'qzhang', 'ollinebg', 'deanjac99', 'chinmayanandadm', 'komen', 'lrhamp', 'hteutsch', 'umana2', 'hgaudin', 'eraeker', 'dmartinfernandezvald', 'snahe', 'zouhaox', 'tarnsangprad', 'barbaraldoriga5', 'serenad', 'brokawat', 'higgin24', 'ftadros', 'tobias.m.egle', 'kmaxie', 'mayank4551', 'krislew', 'aalmohri', 'haileymk', 'xzhan147', 'woodjosh', 'lwight', 'ojovinomarques', 'jerry0075566', 'dkfkadbs304', 'ssmate', 'ychen261', 'wbumbaca', 'moralist', 'shea.costner', 'jcobolopez', 'ccafmeye', 'mviksne', 'tecatetrav', 'frasheski', 'hoopesma', 'stu', 'dshah515', 'malhark', 'herrerag', 'stapleton3', 'tmarkiew', 'jepi', 'mgratows', 'lobbiam', 'alillig', 'grfedele', 'liannaldo007', 'phamleminhthong', 'ggmorrow', 's.bikash', 'llsloan55555', 'asadncepc', 'cjmichae', 'asasa', 'kjfrank2', 'davisloen', 'maymephilbrick', 'sayanr', 'shamilt3', 'msross', 'saurabhchem09', 'aapfel', 'pdstaubl', None, 'eescudermilian', 'healyjl', 'yzhou91', 'rexkhan', 'bebling', 'yhu55', 'dmcpher', 'saxman25']"
4,120,166,63,11,"['hregner2', 'jhardi9', 'kjfrank2', 'xzhan147', 'nsk2', 'werforgerf4life', 'yhu55', 'leveill2', 'jaketh2', 'dkfkadbs304', 'joseam2']",154,"['kcrawf', 'vkov', 'pinea', 'ssengupta3', 'dwangy', 'yfchen87', 'liutif', 'monisanchezblanco', 'jyhoff', 'lenling', 'artrinity', 'ehsi', 'avibreg', 'iamavash', 'kenmp', 'anfetre', 'mirandamiao', 'dhruvtatke', 'kobocc1994', 'ybeeker', 'mreed11', 'alexzimm', 'cdonahu', 'jkern3', 'amandnic', 'optalmad', 'ialonsogago', 'nikaren', 'ollorentemartija', 'acleve', 'cdrewery', 'alexshaw', 'danevans', 'rishavc', 'apdoyle', 'kli47', 'shirundo', 'fphender', 'rrwilson', 'costalt', 'rlrob', 'lmorrissey', 'clindn', 'shawak', 'annakcha', 'sebmuraru', 'myrta', 'brenrice', 'claudsnd', 'jbpeller', 'mccartnt', 'jeilers', 'katferg', 'ahmadubuntu', 'cjbmi', 'ajhorvath', 'brdemarc', 'cpassolano', 'dkatz4', 'narceci', 'ryougijc', 'mattfuentez10', 'dieguez999', 'ldwillia', 'mlodriguito', 'rotenmax', 'amroe', 'scollard', 'blanzyt', 'ksallans', 'reedy', 'kartikghosh2008', 'reisnerd', 'apielack', 'allendc', 'tbarang', 'jojoco', 'tdabney', 'ehai1234', 'ggracevr', 'arehman4', 'solayinka', 'lmeddaugh', 'qzhang', 'ollinebg', 'deanjac99', 'chinmayanandadm', 'komen', 'lrhamp', 'hteutsch', 'umana2', 'hgaudin', 'eraeker', 'dmartinfernandezvald', 'snahe', 'zouhaox', 'tarnsangprad', 'barbaraldoriga5', 'serenad', 'brokawat', 'higgin24', 'ftadros', 'tobias.m.egle', 'kmaxie', 'mayank4551', 'krislew', 'aalmohri', 'haileymk', 'woodjosh', 'lwight', 'ojovinomarques', 'jerry0075566', 'ssmate', 'ychen261', 'wbumbaca', 'moralist', 'shea.costner', 'jcobolopez', 'ccafmeye', 'mviksne', 'tecatetrav', 'frasheski', 'stu', 'dshah515', 'malhark', 'herrerag', 'stapleton3', 'tmarkiew', 'jepi', 'mgratows', 'grfedele', 'liannaldo007', 'phamleminhthong', 'ggmorrow', 's.bikash', 'llsloan55555', 'asadncepc', 'cjmichae', 'asasa', 'davisloen', 'maymephilbrick', 'sayanr', 'shamilt3', 'msross', 'saurabhchem09', 'aapfel', 'pdstaubl', 'eescudermilian', 'healyjl', 'yzhou91', 'rexkhan', 'bebling', 'dmcpher', 'saxman25']",52,"['mengkem2', 'kychui2', 'pranjal3', 'jmjin2', 'bhliu97', 'myl3', 'staceyn2', 'bcperki2', 'mtobah2', 'kv2', 'kfurbee2', 'jzhan142', 'masonpb2', 'tss3', 'juliaeb2', 'bharath3', 'sili5', 'dplata2', 'rrmiriy2', 'nahmoda2', 'avw2', 'jingyiw3', 'rakam2', 'baohl2', 'khazanv2', 'saegner2', 'jiwu2', 'rsyuan2', 'kph2', 'juliajh2', 'isaxton2', 'coderko3', 'jinsup2', 'kyang37', 'restep2', 'joshua.leveillee', 'zehuahe2', 'mjoza2', 'ellenrf2', None, 'travisc2', 'dlee145', 'jinwoo2', 'dcpang2', 'scc3', 'jarodm2', 'ckim123', 'rll2', 'zhixin2', 'hf4', 'akozych2', 'shuming2']",217,"['kcrawf', 'vkov', 'pinea', 'ssengupta3', 'dwangy', 'yfchen87', 'jmjin2', 'pranjal3', 'bhliu97', 'liutif', 'monisanchezblanco', 'staceyn2', 'jyhoff', 'artrinity', 'lenling', 'ehsi', 'avibreg', 'jhardi9', 'iamavash', 'tss3', 'kenmp', 'dplata2', 'rrmiriy2', 'anfetre', 'mirandamiao', 'baohl2', 'dhruvtatke', 'kobocc1994', 'saegner2', 'ybeeker', 'mreed11', 'alexzimm', 'rsyuan2', 'kyang37', 'cdonahu', 'jkern3', 'amandnic', 'optalmad', 'ialonsogago', 'jaketh2', 'joshua.leveillee', 'nikaren', 'travisc2', 'ollorentemartija', 'dlee145', 'jarodm2', 'ckim123', 'acleve', 'cdrewery', 'alexshaw', 'danevans', 'rishavc', 'apdoyle', 'werforgerf4life', 'kli47', 'fphender', 'shirundo', 'rrwilson', 'costalt', 'rlrob', 'lmorrissey', 'clindn', 'shawak', 'hregner2', 'mengkem2', 'annakcha', 'sebmuraru', 'myrta', 'nsk2', 'brenrice', 'claudsnd', 'jbpeller', 'mccartnt', 'jeilers', 'katferg', 'ahmadubuntu', 'cjbmi', 'ajhorvath', 'brdemarc', 'cpassolano', 'dkatz4', 'narceci', 'khazanv2', 'ryougijc', 'mattfuentez10', 'jiwu2', 'kph2', 'jinsup2', 'dieguez999', 'restep2', 'leveill2', 'ldwillia', 'mlodriguito', 'zehuahe2', 'rotenmax', 'amroe', 'scc3', 'scollard', 'blanzyt', 'ksallans', 'hf4', 'reedy', 'kartikghosh2008', 'reisnerd', 'apielack', 'allendc', 'tbarang', 'jojoco', 'mtobah2', 'bcperki2', 'kv2', 'tdabney', 'ehai1234', 'joseam2', 'kfurbee2', 'jzhan142', 'masonpb2', 'ggracevr', 'arehman4', 'solayinka', 'lmeddaugh', 'qzhang', 'ollinebg', 'bharath3', 'sili5', 'nahmoda2', 'jingyiw3', 'avw2', 'deanjac99', 'rakam2', 'chinmayanandadm', 'komen', 'lrhamp', 'hteutsch', 'umana2', 'hgaudin', 'isaxton2', 'coderko3', 'eraeker', 'dmartinfernandezvald', 'snahe', 'zouhaox', 'tarnsangprad', 'barbaraldoriga5', 'mjoza2', 'ellenrf2', 'serenad', 'dcpang2', 'brokawat', 'jinwoo2', 'higgin24', 'ftadros', 'tobias.m.egle', 'kmaxie', 'mayank4551', 'krislew', 'rll2', 'aalmohri', 'haileymk', 'xzhan147', 'woodjosh', 'lwight', 'ojovinomarques', 'jerry0075566', 'akozych2', 'dkfkadbs304', 'ssmate', 'ychen261', 'wbumbaca', 'moralist', 'shea.costner', 'jcobolopez', 'kychui2', 'ccafmeye', 'mviksne', 'tecatetrav', 'frasheski', 'myl3', 'stu', 'dshah515', 'malhark', 'herrerag', 'stapleton3', 'tmarkiew', 'jepi', 'mgratows', 'juliaeb2', 'grfedele', 'liannaldo007', 'phamleminhthong', 'ggmorrow', 's.bikash', 'llsloan55555', 'asadncepc', 'cjmichae', 'asasa', 'kjfrank2', 'davisloen', 'maymephilbrick', 'sayanr', 'shamilt3', 'juliajh2', 'msross', 'saurabhchem09', 'aapfel', 'pdstaubl', None, 'eescudermilian', 'healyjl', 'yzhou91', 'rexkhan', 'bebling', 'yhu55', 'zhixin2', 'dmcpher', 'saxman25', 'shuming2']"
4,114,166,32,29,"['clindn', 'pinea', 'annakcha', 'apielack', 'allendc', 'dwangy', 'liutif', 'jojoco', 'brenrice', 'ehsi', 'malhark', 'avibreg', 'ggracevr', 'jepi', 'mgratows', 'cjbmi', 'brdemarc', 'hteutsch', 'ybeeker', 'hgaudin', 'eraeker', 'zouhaox', 'rotenmax', 'serenad', 'haileymk', 'blanzyt', 'ksallans', 'rishavc', 'reedy']",136,"['kcrawf', 'vkov', 'ssengupta3', 'yfchen87', 'monisanchezblanco', 'jyhoff', 'artrinity', 'lenling', 'jhardi9', 'iamavash', 'kenmp', 'anfetre', 'mirandamiao', 'dhruvtatke', 'kobocc1994', 'mreed11', 'alexzimm', 'cdonahu', 'jkern3', 'amandnic', 'optalmad', 'ialonsogago', 'jaketh2', 'nikaren', 'ollorentemartija', 'acleve', 'cdrewery', 'alexshaw', 'danevans', 'apdoyle', 'werforgerf4life', 'kli47', 'fphender', 'shirundo', 'rrwilson', 'costalt', 'rlrob', 'lmorrissey', 'shawak', 'hregner2', 'sebmuraru', 'myrta', 'nsk2', 'claudsnd', 'jbpeller', 'mccartnt', 'jeilers', 'katferg', 'ahmadubuntu', 'ajhorvath', 'cpassolano', 'dkatz4', 'narceci', 'ryougijc', 'mattfuentez10', 'dieguez999', 'leveill2', 'ldwillia', 'mlodriguito', 'amroe', 'scollard', 'kartikghosh2008', 'reisnerd', 'tbarang', 'tdabney', 'ehai1234', 'joseam2', 'arehman4', 'solayinka', 'lmeddaugh', 'qzhang', 'ollinebg', 'deanjac99', 'chinmayanandadm', 'komen', 'lrhamp', 'umana2', 'dmartinfernandezvald', 'snahe', 'tarnsangprad', 'barbaraldoriga5', 'brokawat', 'higgin24', 'ftadros', 'tobias.m.egle', 'kmaxie', 'mayank4551', 'krislew', 'aalmohri', 'xzhan147', 'woodjosh', 'lwight', 'ojovinomarques', 'jerry0075566', 'dkfkadbs304', 'ssmate', 'ychen261', 'wbumbaca', 'moralist', 'shea.costner', 'jcobolopez', 'ccafmeye', 'mviksne', 'tecatetrav', 'frasheski', 'stu', 'dshah515', 'herrerag', 'stapleton3', 'tmarkiew', 'grfedele', 'liannaldo007', 'phamleminhthong', 'ggmorrow', 's.bikash', 'llsloan55555', 'asadncepc', 'cjmichae', 'asasa', 'kjfrank2', 'davisloen', 'maymephilbrick', 'sayanr', 'shamilt3', 'msross', 'saurabhchem09', 'aapfel', 'pdstaubl', 'eescudermilian', 'healyjl', 'yzhou91', 'rexkhan', 'bebling', 'yhu55', 'dmcpher', 'saxman25']",3,"['leovall', None, 'mphilbri']",168,"['kcrawf', 'vkov', 'pinea', 'ssengupta3', 'dwangy', 'yfchen87', 'liutif', 'monisanchezblanco', 'jyhoff', 'artrinity', 'lenling', 'ehsi', 'avibreg', 'jhardi9', 'iamavash', 'kenmp', 'anfetre', 'mirandamiao', 'dhruvtatke', 'kobocc1994', 'ybeeker', 'mreed11', 'alexzimm', 'cdonahu', 'jkern3', 'amandnic', 'optalmad', 'ialonsogago', 'jaketh2', 'nikaren', 'ollorentemartija', 'acleve', 'cdrewery', 'alexshaw', 'danevans', 'rishavc', 'apdoyle', 'werforgerf4life', 'kli47', 'fphender', 'shirundo', 'rrwilson', 'costalt', 'rlrob', 'lmorrissey', 'clindn', 'shawak', 'hregner2', 'annakcha', 'sebmuraru', 'myrta', 'nsk2', 'brenrice', 'claudsnd', 'jbpeller', 'mccartnt', 'jeilers', 'katferg', 'ahmadubuntu', 'cjbmi', 'ajhorvath', 'brdemarc', 'cpassolano', 'dkatz4', 'narceci', 'ryougijc', 'mattfuentez10', 'dieguez999', 'leveill2', 'ldwillia', 'mlodriguito', 'rotenmax', 'amroe', 'scollard', 'blanzyt', 'ksallans', 'reedy', 'kartikghosh2008', 'reisnerd', 'apielack', 'allendc', 'tbarang', 'jojoco', 'tdabney', 'ehai1234', 'joseam2', 'mphilbri', 'leovall', 'ggracevr', 'arehman4', 'solayinka', 'lmeddaugh', 'qzhang', 'ollinebg', 'deanjac99', 'chinmayanandadm', 'komen', 'lrhamp', 'hteutsch', 'umana2', 'hgaudin', 'eraeker', 'dmartinfernandezvald', 'snahe', 'zouhaox', 'tarnsangprad', 'barbaraldoriga5', 'serenad', 'brokawat', 'higgin24', 'ftadros', 'tobias.m.egle', 'kmaxie', 'mayank4551', 'krislew', 'aalmohri', 'haileymk', 'xzhan147', 'woodjosh', 'lwight', 'ojovinomarques', 'jerry0075566', 'dkfkadbs304', 'ssmate', 'ychen261', 'wbumbaca', 'moralist', 'shea.costner', 'jcobolopez', 'ccafmeye', 'mviksne', 'tecatetrav', 'frasheski', 'stu', 'dshah515', 'malhark', 'herrerag', 'stapleton3', 'tmarkiew', 'jepi', 'mgratows', 'grfedele', 'liannaldo007', 'phamleminhthong', 'ggmorrow', 's.bikash', 'llsloan55555', 'asadncepc', 'cjmichae', 'asasa', 'kjfrank2', 'davisloen', 'maymephilbrick', 'sayanr', 'shamilt3', 'msross', 'saurabhchem09', 'aapfel', 'pdstaubl', None, 'eescudermilian', 'healyjl', 'yzhou91', 'rexkhan', 'bebling', 'yhu55', 'dmcpher', 'saxman25']"
4,123,166,28,15,"['ssmate', 'ryougijc', 'shea.costner', 'davisloen', 'tmarkiew', 'mattfuentez10', 'mreed11', 'fphender', 'mviksne', 'dieguez999', 'tecatetrav', 'cdrewery', 'msross', 'mirandamiao', 'stu']",150,"['kcrawf', 'vkov', 'pinea', 'ssengupta3', 'dwangy', 'yfchen87', 'liutif', 'monisanchezblanco', 'jyhoff', 'artrinity', 'lenling', 'ehsi', 'avibreg', 'jhardi9', 'iamavash', 'kenmp', 'anfetre', 'dhruvtatke', 'kobocc1994', 'ybeeker', 'alexzimm', 'cdonahu', 'jkern3', 'amandnic', 'optalmad', 'ialonsogago', 'jaketh2', 'nikaren', 'ollorentemartija', 'acleve', 'alexshaw', 'danevans', 'rishavc', 'apdoyle', 'werforgerf4life', 'kli47', 'shirundo', 'rrwilson', 'costalt', 'rlrob', 'lmorrissey', 'clindn', 'shawak', 'hregner2', 'annakcha', 'sebmuraru', 'myrta', 'nsk2', 'brenrice', 'claudsnd', 'jbpeller', 'mccartnt', 'jeilers', 'katferg', 'ahmadubuntu', 'cjbmi', 'ajhorvath', 'brdemarc', 'cpassolano', 'dkatz4', 'narceci', 'leveill2', 'ldwillia', 'mlodriguito', 'rotenmax', 'amroe', 'scollard', 'blanzyt', 'ksallans', 'reedy', 'kartikghosh2008', 'reisnerd', 'apielack', 'allendc', 'tbarang', 'jojoco', 'tdabney', 'ehai1234', 'joseam2', 'ggracevr', 'arehman4', 'solayinka', 'lmeddaugh', 'qzhang', 'ollinebg', 'deanjac99', 'chinmayanandadm', 'komen', 'lrhamp', 'hteutsch', 'umana2', 'hgaudin', 'eraeker', 'dmartinfernandezvald', 'snahe', 'zouhaox', 'tarnsangprad', 'barbaraldoriga5', 'serenad', 'brokawat', 'higgin24', 'ftadros', 'tobias.m.egle', 'kmaxie', 'mayank4551', 'krislew', 'aalmohri', 'haileymk', 'xzhan147', 'woodjosh', 'lwight', 'ojovinomarques', 'jerry0075566', 'dkfkadbs304', 'ychen261', 'wbumbaca', 'moralist', 'jcobolopez', 'ccafmeye', 'frasheski', 'dshah515', 'malhark', 'herrerag', 'stapleton3', 'jepi', 'mgratows', 'grfedele', 'liannaldo007', 'phamleminhthong', 'ggmorrow', 's.bikash', 'llsloan55555', 'asadncepc', 'cjmichae', 'asasa', 'kjfrank2', 'maymephilbrick', 'sayanr', 'shamilt3', 'saurabhchem09', 'aapfel', 'pdstaubl', 'eescudermilian', 'healyjl', 'yzhou91', 'rexkhan', 'bebling', 'yhu55', 'dmcpher', 'saxman25']",13,"['cintroli', 'racotter', 'juescami', 'iblackbu', 'alexbick09', 'benjaminvf', 'lbagbyy', 'ryougijc12', 'thomas.s.busse', None, 'eoreste', 'jhulfach', 'mbkivy']",178,"['kcrawf', 'racotter', 'vkov', 'pinea', 'ssengupta3', 'dwangy', 'yfchen87', 'liutif', 'monisanchezblanco', 'jyhoff', 'artrinity', 'lenling', 'ehsi', 'avibreg', 'jhardi9', 'iamavash', 'alexbick09', 'kenmp', 'anfetre', 'mirandamiao', 'thomas.s.busse', 'dhruvtatke', 'kobocc1994', 'juescami', 'ybeeker', 'mreed11', 'alexzimm', 'cdonahu', 'jkern3', 'amandnic', 'optalmad', 'ialonsogago', 'jaketh2', 'nikaren', 'ollorentemartija', 'acleve', 'cdrewery', 'alexshaw', 'danevans', 'rishavc', 'apdoyle', 'werforgerf4life', 'ryougijc12', 'kli47', 'fphender', 'shirundo', 'rrwilson', 'costalt', 'rlrob', 'lmorrissey', 'clindn', 'shawak', 'hregner2', 'annakcha', 'sebmuraru', 'myrta', 'nsk2', 'brenrice', 'jhulfach', 'claudsnd', 'jbpeller', 'mccartnt', 'jeilers', 'katferg', 'ahmadubuntu', 'cjbmi', 'ajhorvath', 'brdemarc', 'lbagbyy', 'cpassolano', 'dkatz4', 'narceci', 'ryougijc', 'mattfuentez10', 'iblackbu', 'dieguez999', 'leveill2', 'ldwillia', 'mlodriguito', 'rotenmax', 'benjaminvf', 'amroe', 'scollard', 'blanzyt', 'ksallans', 'reedy', 'kartikghosh2008', 'reisnerd', 'apielack', 'allendc', 'tbarang', 'jojoco', 'tdabney', 'ehai1234', 'joseam2', 'ggracevr', 'arehman4', 'solayinka', 'lmeddaugh', 'qzhang', 'ollinebg', 'deanjac99', 'chinmayanandadm', 'komen', 'lrhamp', 'hteutsch', 'umana2', 'hgaudin', 'eraeker', 'dmartinfernandezvald', 'snahe', 'zouhaox', 'tarnsangprad', 'barbaraldoriga5', 'serenad', 'cintroli', 'brokawat', 'higgin24', 'ftadros', 'tobias.m.egle', 'kmaxie', 'mayank4551', 'krislew', 'aalmohri', 'haileymk', 'xzhan147', 'woodjosh', 'lwight', 'ojovinomarques', 'jerry0075566', 'dkfkadbs304', 'mbkivy', 'ssmate', 'ychen261', 'wbumbaca', 'moralist', 'shea.costner', 'jcobolopez', 'ccafmeye', 'mviksne', 'tecatetrav', 'frasheski', 'stu', 'eoreste', 'dshah515', 'malhark', 'herrerag', 'stapleton3', 'tmarkiew', 'jepi', 'mgratows', 'grfedele', 'liannaldo007', 'phamleminhthong', 'ggmorrow', 's.bikash', 'llsloan55555', 'asadncepc', 'cjmichae', 'asasa', 'kjfrank2', 'davisloen', 'maymephilbrick', 'sayanr', 'shamilt3', 'msross', 'saurabhchem09', 'aapfel', 'pdstaubl', None, 'eescudermilian', 'healyjl', 'yzhou91', 'rexkhan', 'bebling', 'yhu55', 'dmcpher', 'saxman25']"
4,113,166,21,13,"['tdabney', 'lmorrissey', 'wbumbaca', 'stapleton3', 'komen', 'umana2', 'lmeddaugh', 'ajhorvath', 'jkern3', 'frasheski', 'tarnsangprad', 'lenling', 'dkatz4']",152,"['kcrawf', 'vkov', 'pinea', 'ssengupta3', 'dwangy', 'yfchen87', 'liutif', 'monisanchezblanco', 'jyhoff', 'artrinity', 'ehsi', 'avibreg', 'jhardi9', 'iamavash', 'kenmp', 'anfetre', 'mirandamiao', 'dhruvtatke', 'kobocc1994', 'ybeeker', 'mreed11', 'alexzimm', 'cdonahu', 'amandnic', 'optalmad', 'ialonsogago', 'jaketh2', 'nikaren', 'ollorentemartija', 'acleve', 'cdrewery', 'alexshaw', 'danevans', 'rishavc', 'apdoyle', 'werforgerf4life', 'kli47', 'fphender', 'shirundo', 'rrwilson', 'costalt', 'rlrob', 'clindn', 'shawak', 'hregner2', 'annakcha', 'sebmuraru', 'myrta', 'nsk2', 'brenrice', 'claudsnd', 'jbpeller', 'mccartnt', 'jeilers', 'katferg', 'ahmadubuntu', 'cjbmi', 'brdemarc', 'cpassolano', 'narceci', 'ryougijc', 'mattfuentez10', 'dieguez999', 'leveill2', 'ldwillia', 'mlodriguito', 'rotenmax', 'amroe', 'scollard', 'blanzyt', 'ksallans', 'reedy', 'kartikghosh2008', 'reisnerd', 'apielack', 'allendc', 'tbarang', 'jojoco', 'ehai1234', 'joseam2', 'ggracevr', 'arehman4', 'solayinka', 'qzhang', 'ollinebg', 'deanjac99', 'chinmayanandadm', 'lrhamp', 'hteutsch', 'hgaudin', 'eraeker', 'dmartinfernandezvald', 'snahe', 'zouhaox', 'barbaraldoriga5', 'serenad', 'brokawat', 'higgin24', 'ftadros', 'tobias.m.egle', 'kmaxie', 'mayank4551', 'krislew', 'aalmohri', 'haileymk', 'xzhan147', 'woodjosh', 'lwight', 'ojovinomarques', 'jerry0075566', 'dkfkadbs304', 'ssmate', 'ychen261', 'moralist', 'shea.costner', 'jcobolopez', 'ccafmeye', 'mviksne', 'tecatetrav', 'stu', 'dshah515', 'malhark', 'herrerag', 'tmarkiew', 'jepi', 'mgratows', 'grfedele', 'liannaldo007', 'phamleminhthong', 'ggmorrow', 's.bikash', 'llsloan55555', 'asadncepc', 'cjmichae', 'asasa', 'kjfrank2', 'davisloen', 'maymephilbrick', 'sayanr', 'shamilt3', 'msross', 'saurabhchem09', 'aapfel', 'pdstaubl', 'eescudermilian', 'healyjl', 'yzhou91', 'rexkhan', 'bebling', 'yhu55', 'dmcpher', 'saxman25']",8,"['silha2', 'dcai22', 'pathare2', 'gli92', None, 'zhr5513', 'ddmorgan', 'moldrem']",173,"['kcrawf', 'vkov', 'pinea', 'ssengupta3', 'dwangy', 'yfchen87', 'liutif', 'monisanchezblanco', 'jyhoff', 'artrinity', 'lenling', 'ehsi', 'avibreg', 'silha2', 'jhardi9', 'iamavash', 'kenmp', 'anfetre', 'mirandamiao', 'dhruvtatke', 'kobocc1994', 'ybeeker', 'mreed11', 'alexzimm', 'cdonahu', 'jkern3', 'amandnic', 'optalmad', 'ialonsogago', 'jaketh2', 'moldrem', 'nikaren', 'ollorentemartija', 'dcai22', 'pathare2', 'ddmorgan', 'acleve', 'cdrewery', 'alexshaw', 'danevans', 'rishavc', 'apdoyle', 'werforgerf4life', 'kli47', 'fphender', 'shirundo', 'rrwilson', 'costalt', 'rlrob', 'lmorrissey', 'clindn', 'shawak', 'hregner2', 'annakcha', 'sebmuraru', 'myrta', 'nsk2', 'brenrice', 'claudsnd', 'jbpeller', 'mccartnt', 'jeilers', 'katferg', 'ahmadubuntu', 'cjbmi', 'ajhorvath', 'brdemarc', 'cpassolano', 'dkatz4', 'narceci', 'gli92', 'ryougijc', 'mattfuentez10', 'dieguez999', 'leveill2', 'ldwillia', 'mlodriguito', 'rotenmax', 'amroe', 'scollard', 'blanzyt', 'ksallans', 'reedy', 'kartikghosh2008', 'reisnerd', 'apielack', 'allendc', 'tbarang', 'jojoco', 'tdabney', 'ehai1234', 'joseam2', 'ggracevr', 'arehman4', 'solayinka', 'lmeddaugh', 'qzhang', 'ollinebg', 'deanjac99', 'chinmayanandadm', 'komen', 'lrhamp', 'hteutsch', 'umana2', 'hgaudin', 'eraeker', 'dmartinfernandezvald', 'snahe', 'zouhaox', 'tarnsangprad', 'barbaraldoriga5', 'serenad', 'brokawat', 'higgin24', 'ftadros', 'tobias.m.egle', 'kmaxie', 'mayank4551', 'krislew', 'aalmohri', 'haileymk', 'xzhan147', 'woodjosh', 'lwight', 'ojovinomarques', 'jerry0075566', 'dkfkadbs304', 'ssmate', 'ychen261', 'wbumbaca', 'moralist', 'shea.costner', 'jcobolopez', 'ccafmeye', 'mviksne', 'tecatetrav', 'frasheski', 'stu', 'dshah515', 'malhark', 'herrerag', 'stapleton3', 'tmarkiew', 'jepi', 'mgratows', 'zhr5513', 'grfedele', 'liannaldo007', 'phamleminhthong', 'ggmorrow', 's.bikash', 'llsloan55555', 'asadncepc', 'cjmichae', 'asasa', 'kjfrank2', 'davisloen', 'maymephilbrick', 'sayanr', 'shamilt3', 'msross', 'saurabhchem09', 'aapfel', 'pdstaubl', None, 'eescudermilian', 'healyjl', 'yzhou91', 'rexkhan', 'bebling', 'yhu55', 'dmcpher', 'saxman25']"
4,115,166,21,18,"['eescudermilian', 'ollorentemartija', 'ychen261', 'ftadros', 'moralist', 'yzhou91', 'jcobolopez', 'arehman4', 'ojovinomarques', 'ssengupta3', 'shamilt3', 'cpassolano', 'dmartinfernandezvald', 'kli47', 'ialonsogago', 'jerry0075566', 'chinmayanandadm', 'barbaraldoriga5']",147,"['kcrawf', 'vkov', 'pinea', 'dwangy', 'yfchen87', 'liutif', 'monisanchezblanco', 'jyhoff', 'artrinity', 'lenling', 'ehsi', 'avibreg', 'jhardi9', 'iamavash', 'kenmp', 'anfetre', 'mirandamiao', 'dhruvtatke', 'kobocc1994', 'ybeeker', 'mreed11', 'alexzimm', 'cdonahu', 'jkern3', 'amandnic', 'optalmad', 'jaketh2', 'nikaren', 'acleve', 'cdrewery', 'alexshaw', 'danevans', 'rishavc', 'apdoyle', 'werforgerf4life', 'fphender', 'shirundo', 'rrwilson', 'costalt', 'rlrob', 'lmorrissey', 'clindn', 'shawak', 'hregner2', 'annakcha', 'sebmuraru', 'myrta', 'nsk2', 'brenrice', 'claudsnd', 'jbpeller', 'mccartnt', 'jeilers', 'katferg', 'ahmadubuntu', 'cjbmi', 'ajhorvath', 'brdemarc', 'dkatz4', 'narceci', 'ryougijc', 'mattfuentez10', 'dieguez999', 'leveill2', 'ldwillia', 'mlodriguito', 'rotenmax', 'amroe', 'scollard', 'blanzyt', 'ksallans', 'reedy', 'kartikghosh2008', 'reisnerd', 'apielack', 'allendc', 'tbarang', 'jojoco', 'tdabney', 'ehai1234', 'joseam2', 'ggracevr', 'solayinka', 'lmeddaugh', 'qzhang', 'ollinebg', 'deanjac99', 'komen', 'lrhamp', 'hteutsch', 'umana2', 'hgaudin', 'eraeker', 'snahe', 'zouhaox', 'tarnsangprad', 'serenad', 'brokawat', 'higgin24', 'tobias.m.egle', 'kmaxie', 'mayank4551', 'krislew', 'aalmohri', 'haileymk', 'xzhan147', 'woodjosh', 'lwight', 'dkfkadbs304', 'ssmate', 'wbumbaca', 'shea.costner', 'ccafmeye', 'mviksne', 'tecatetrav', 'frasheski', 'stu', 'dshah515', 'malhark', 'herrerag', 'stapleton3', 'tmarkiew', 'jepi', 'mgratows', 'grfedele', 'liannaldo007', 'phamleminhthong', 'ggmorrow', 's.bikash', 'llsloan55555', 'asadncepc', 'cjmichae', 'asasa', 'kjfrank2', 'davisloen', 'maymephilbrick', 'sayanr', 'msross', 'saurabhchem09', 'aapfel', 'pdstaubl', 'healyjl', 'rexkhan', 'bebling', 'yhu55', 'dmcpher', 'saxman25']",3,"[None, 'i.alonsog.7', 'inigoalonsogago']",168,"['kcrawf', 'vkov', 'pinea', 'ssengupta3', 'dwangy', 'yfchen87', 'liutif', 'monisanchezblanco', 'jyhoff', 'artrinity', 'lenling', 'ehsi', 'avibreg', 'jhardi9', 'iamavash', 'kenmp', 'anfetre', 'mirandamiao', 'i.alonsog.7', 'dhruvtatke', 'kobocc1994', 'ybeeker', 'mreed11', 'alexzimm', 'cdonahu', 'jkern3', 'amandnic', 'optalmad', 'ialonsogago', 'jaketh2', 'nikaren', 'ollorentemartija', 'acleve', 'cdrewery', 'alexshaw', 'danevans', 'rishavc', 'apdoyle', 'werforgerf4life', 'kli47', 'fphender', 'shirundo', 'rrwilson', 'costalt', 'rlrob', 'lmorrissey', 'clindn', 'shawak', 'hregner2', 'annakcha', 'sebmuraru', 'myrta', 'nsk2', 'brenrice', 'claudsnd', 'jbpeller', 'mccartnt', 'jeilers', 'katferg', 'ahmadubuntu', 'cjbmi', 'ajhorvath', 'brdemarc', 'cpassolano', 'dkatz4', 'narceci', 'ryougijc', 'mattfuentez10', 'dieguez999', 'leveill2', 'ldwillia', 'mlodriguito', 'rotenmax', 'amroe', 'scollard', 'blanzyt', 'ksallans', 'reedy', 'kartikghosh2008', 'reisnerd', 'apielack', 'allendc', 'tbarang', 'jojoco', 'tdabney', 'ehai1234', 'joseam2', 'ggracevr', 'arehman4', 'solayinka', 'lmeddaugh', 'qzhang', 'ollinebg', 'deanjac99', 'chinmayanandadm', 'komen', 'lrhamp', 'hteutsch', 'umana2', 'hgaudin', 'eraeker', 'dmartinfernandezvald', 'snahe', 'zouhaox', 'tarnsangprad', 'barbaraldoriga5', 'serenad', 'brokawat', 'higgin24', 'ftadros', 'tobias.m.egle', 'kmaxie', 'mayank4551', 'krislew', 'aalmohri', 'haileymk', 'xzhan147', 'woodjosh', 'lwight', 'ojovinomarques', 'jerry0075566', 'dkfkadbs304', 'ssmate', 'ychen261', 'wbumbaca', 'moralist', 'shea.costner', 'jcobolopez', 'ccafmeye', 'mviksne', 'tecatetrav', 'frasheski', 'stu', 'dshah515', 'malhark', 'herrerag', 'stapleton3', 'tmarkiew', 'jepi', 'mgratows', 'grfedele', 'liannaldo007', 'phamleminhthong', 'ggmorrow', 's.bikash', 'llsloan55555', 'asadncepc', 'cjmichae', 'asasa', 'kjfrank2', 'davisloen', 'maymephilbrick', 'sayanr', 'shamilt3', 'msross', 'saurabhchem09', 'aapfel', 'pdstaubl', None, 'eescudermilian', 'healyjl', 'yzhou91', 'rexkhan', 'bebling', 'inigoalonsogago', 'yhu55', 'dmcpher', 'saxman25']"
4,118,166,17,15,"['eescudermilian', 'ollorentemartija', 'ychen261', 'ftadros', 'yzhou91', 'arehman4', 'ssengupta3', 'shamilt3', 'cpassolano', 'jerry0075566', 'kli47', 'ialonsogago', 'ojovinomarques', 'chinmayanandadm', 'barbaraldoriga5']",150,"['kcrawf', 'vkov', 'pinea', 'dwangy', 'yfchen87', 'liutif', 'monisanchezblanco', 'jyhoff', 'artrinity', 'lenling', 'ehsi', 'avibreg', 'jhardi9', 'iamavash', 'kenmp', 'anfetre', 'mirandamiao', 'dhruvtatke', 'kobocc1994', 'ybeeker', 'mreed11', 'alexzimm', 'cdonahu', 'jkern3', 'amandnic', 'optalmad', 'jaketh2', 'nikaren', 'acleve', 'cdrewery', 'alexshaw', 'danevans', 'rishavc', 'apdoyle', 'werforgerf4life', 'fphender', 'shirundo', 'rrwilson', 'costalt', 'rlrob', 'lmorrissey', 'clindn', 'shawak', 'hregner2', 'annakcha', 'sebmuraru', 'myrta', 'nsk2', 'brenrice', 'claudsnd', 'jbpeller', 'mccartnt', 'jeilers', 'katferg', 'ahmadubuntu', 'cjbmi', 'ajhorvath', 'brdemarc', 'dkatz4', 'narceci', 'ryougijc', 'mattfuentez10', 'dieguez999', 'leveill2', 'ldwillia', 'mlodriguito', 'rotenmax', 'amroe', 'scollard', 'blanzyt', 'ksallans', 'reedy', 'kartikghosh2008', 'reisnerd', 'apielack', 'allendc', 'tbarang', 'jojoco', 'tdabney', 'ehai1234', 'joseam2', 'ggracevr', 'solayinka', 'lmeddaugh', 'qzhang', 'ollinebg', 'deanjac99', 'komen', 'lrhamp', 'hteutsch', 'umana2', 'hgaudin', 'eraeker', 'dmartinfernandezvald', 'snahe', 'zouhaox', 'tarnsangprad', 'serenad', 'brokawat', 'higgin24', 'tobias.m.egle', 'kmaxie', 'mayank4551', 'krislew', 'aalmohri', 'haileymk', 'xzhan147', 'woodjosh', 'lwight', 'dkfkadbs304', 'ssmate', 'wbumbaca', 'moralist', 'shea.costner', 'jcobolopez', 'ccafmeye', 'mviksne', 'tecatetrav', 'frasheski', 'stu', 'dshah515', 'malhark', 'herrerag', 'stapleton3', 'tmarkiew', 'jepi', 'mgratows', 'grfedele', 'liannaldo007', 'phamleminhthong', 'ggmorrow', 's.bikash', 'llsloan55555', 'asadncepc', 'cjmichae', 'asasa', 'kjfrank2', 'davisloen', 'maymephilbrick', 'sayanr', 'msross', 'saurabhchem09', 'aapfel', 'pdstaubl', 'healyjl', 'rexkhan', 'bebling', 'yhu55', 'dmcpher', 'saxman25']",2,"[None, 'zhixin2']",167,"['kcrawf', 'vkov', 'pinea', 'ssengupta3', 'dwangy', 'yfchen87', 'liutif', 'monisanchezblanco', 'jyhoff', 'artrinity', 'lenling', 'ehsi', 'avibreg', 'jhardi9', 'iamavash', 'kenmp', 'anfetre', 'mirandamiao', 'dhruvtatke', 'kobocc1994', 'ybeeker', 'mreed11', 'alexzimm', 'cdonahu', 'jkern3', 'amandnic', 'optalmad', 'ialonsogago', 'jaketh2', 'nikaren', 'ollorentemartija', 'acleve', 'cdrewery', 'alexshaw', 'danevans', 'rishavc', 'apdoyle', 'werforgerf4life', 'kli47', 'fphender', 'shirundo', 'rrwilson', 'costalt', 'rlrob', 'lmorrissey', 'clindn', 'shawak', 'hregner2', 'annakcha', 'sebmuraru', 'myrta', 'nsk2', 'brenrice', 'claudsnd', 'jbpeller', 'mccartnt', 'jeilers', 'katferg', 'ahmadubuntu', 'cjbmi', 'ajhorvath', 'brdemarc', 'cpassolano', 'dkatz4', 'narceci', 'ryougijc', 'mattfuentez10', 'dieguez999', 'leveill2', 'ldwillia', 'mlodriguito', 'rotenmax', 'amroe', 'scollard', 'blanzyt', 'ksallans', 'reedy', 'kartikghosh2008', 'reisnerd', 'apielack', 'allendc', 'tbarang', 'jojoco', 'tdabney', 'ehai1234', 'joseam2', 'ggracevr', 'arehman4', 'solayinka', 'lmeddaugh', 'qzhang', 'ollinebg', 'deanjac99', 'chinmayanandadm', 'komen', 'lrhamp', 'hteutsch', 'umana2', 'hgaudin', 'eraeker', 'dmartinfernandezvald', 'snahe', 'zouhaox', 'tarnsangprad', 'barbaraldoriga5', 'serenad', 'brokawat', 'higgin24', 'ftadros', 'tobias.m.egle', 'kmaxie', 'mayank4551', 'krislew', 'aalmohri', 'haileymk', 'xzhan147', 'woodjosh', 'lwight', 'ojovinomarques', 'jerry0075566', 'dkfkadbs304', 'ssmate', 'ychen261', 'wbumbaca', 'moralist', 'shea.costner', 'jcobolopez', 'ccafmeye', 'mviksne', 'tecatetrav', 'frasheski', 'stu', 'dshah515', 'malhark', 'herrerag', 'stapleton3', 'tmarkiew', 'jepi', 'mgratows', 'grfedele', 'liannaldo007', 'phamleminhthong', 'ggmorrow', 's.bikash', 'llsloan55555', 'asadncepc', 'cjmichae', 'asasa', 'kjfrank2', 'davisloen', 'maymephilbrick', 'sayanr', 'shamilt3', 'msross', 'saurabhchem09', 'aapfel', 'pdstaubl', None, 'eescudermilian', 'healyjl', 'yzhou91', 'rexkhan', 'bebling', 'yhu55', 'zhixin2', 'dmcpher', 'saxman25']"
4,66,166,12,9,"['mccartnt', 'amroe', 'shawak', 'aalmohri', 'bebling', 'acleve', 'anfetre', 'ggmorrow', 'jyhoff']",156,"['kcrawf', 'vkov', 'pinea', 'ssengupta3', 'dwangy', 'yfchen87', 'liutif', 'monisanchezblanco', 'artrinity', 'lenling', 'ehsi', 'avibreg', 'jhardi9', 'iamavash', 'kenmp', 'mirandamiao', 'dhruvtatke', 'kobocc1994', 'ybeeker', 'mreed11', 'alexzimm', 'cdonahu', 'jkern3', 'amandnic', 'optalmad', 'ialonsogago', 'jaketh2', 'nikaren', 'ollorentemartija', 'cdrewery', 'alexshaw', 'danevans', 'rishavc', 'apdoyle', 'werforgerf4life', 'kli47', 'fphender', 'shirundo', 'rrwilson', 'costalt', 'rlrob', 'lmorrissey', 'clindn', 'hregner2', 'annakcha', 'sebmuraru', 'myrta', 'nsk2', 'brenrice', 'claudsnd', 'jbpeller', 'jeilers', 'katferg', 'ahmadubuntu', 'cjbmi', 'ajhorvath', 'brdemarc', 'cpassolano', 'dkatz4', 'narceci', 'ryougijc', 'mattfuentez10', 'dieguez999', 'leveill2', 'ldwillia', 'mlodriguito', 'rotenmax', 'scollard', 'blanzyt', 'ksallans', 'reedy', 'kartikghosh2008', 'reisnerd', 'apielack', 'allendc', 'tbarang', 'jojoco', 'tdabney', 'ehai1234', 'joseam2', 'ggracevr', 'arehman4', 'solayinka', 'lmeddaugh', 'qzhang', 'ollinebg', 'deanjac99', 'chinmayanandadm', 'komen', 'lrhamp', 'hteutsch', 'umana2', 'hgaudin', 'eraeker', 'dmartinfernandezvald', 'snahe', 'zouhaox', 'tarnsangprad', 'barbaraldoriga5', 'serenad', 'brokawat', 'higgin24', 'ftadros', 'tobias.m.egle', 'kmaxie', 'mayank4551', 'krislew', 'haileymk', 'xzhan147', 'woodjosh', 'lwight', 'ojovinomarques', 'jerry0075566', 'dkfkadbs304', 'ssmate', 'ychen261', 'wbumbaca', 'moralist', 'shea.costner', 'jcobolopez', 'ccafmeye', 'mviksne', 'tecatetrav', 'frasheski', 'stu', 'dshah515', 'malhark', 'herrerag', 'stapleton3', 'tmarkiew', 'jepi', 'mgratows', 'grfedele', 'liannaldo007', 'phamleminhthong', 's.bikash', 'llsloan55555', 'asadncepc', 'cjmichae', 'asasa', 'kjfrank2', 'davisloen', 'maymephilbrick', 'sayanr', 'shamilt3', 'msross', 'saurabhchem09', 'aapfel', 'pdstaubl', 'eescudermilian', 'healyjl', 'yzhou91', 'rexkhan', 'yhu55', 'dmcpher', 'saxman25']",3,"['rebschro', None, 'kpgreenm']",168,"['kcrawf', 'vkov', 'pinea', 'ssengupta3', 'dwangy', 'yfchen87', 'liutif', 'monisanchezblanco', 'jyhoff', 'artrinity', 'lenling', 'ehsi', 'avibreg', 'jhardi9', 'iamavash', 'kenmp', 'anfetre', 'mirandamiao', 'dhruvtatke', 'kobocc1994', 'ybeeker', 'mreed11', 'alexzimm', 'kpgreenm', 'cdonahu', 'jkern3', 'amandnic', 'optalmad', 'ialonsogago', 'jaketh2', 'nikaren', 'ollorentemartija', 'acleve', 'cdrewery', 'alexshaw', 'danevans', 'rishavc', 'apdoyle', 'werforgerf4life', 'kli47', 'fphender', 'shirundo', 'rrwilson', 'costalt', 'rlrob', 'lmorrissey', 'clindn', 'shawak', 'hregner2', 'annakcha', 'sebmuraru', 'myrta', 'nsk2', 'brenrice', 'claudsnd', 'jbpeller', 'mccartnt', 'jeilers', 'katferg', 'ahmadubuntu', 'cjbmi', 'ajhorvath', 'brdemarc', 'cpassolano', 'dkatz4', 'narceci', 'ryougijc', 'mattfuentez10', 'dieguez999', 'leveill2', 'ldwillia', 'mlodriguito', 'rotenmax', 'rebschro', 'amroe', 'scollard', 'blanzyt', 'ksallans', 'reedy', 'kartikghosh2008', 'reisnerd', 'apielack', 'allendc', 'tbarang', 'jojoco', 'tdabney', 'ehai1234', 'joseam2', 'ggracevr', 'arehman4', 'solayinka', 'lmeddaugh', 'qzhang', 'ollinebg', 'deanjac99', 'chinmayanandadm', 'komen', 'lrhamp', 'hteutsch', 'umana2', 'hgaudin', 'eraeker', 'dmartinfernandezvald', 'snahe', 'zouhaox', 'tarnsangprad', 'barbaraldoriga5', 'serenad', 'brokawat', 'higgin24', 'ftadros', 'tobias.m.egle', 'kmaxie', 'mayank4551', 'krislew', 'aalmohri', 'haileymk', 'xzhan147', 'woodjosh', 'lwight', 'ojovinomarques', 'jerry0075566', 'dkfkadbs304', 'ssmate', 'ychen261', 'wbumbaca', 'moralist', 'shea.costner', 'jcobolopez', 'ccafmeye', 'mviksne', 'tecatetrav', 'frasheski', 'stu', 'dshah515', 'malhark', 'herrerag', 'stapleton3', 'tmarkiew', 'jepi', 'mgratows', 'grfedele', 'liannaldo007', 'phamleminhthong', 'ggmorrow', 's.bikash', 'llsloan55555', 'asadncepc', 'cjmichae', 'asasa', 'kjfrank2', 'davisloen', 'maymephilbrick', 'sayanr', 'shamilt3', 'msross', 'saurabhchem09', 'aapfel', 'pdstaubl', None, 'eescudermilian', 'healyjl', 'yzhou91', 'rexkhan', 'bebling', 'yhu55', 'dmcpher', 'saxman25']"
4,218,166,12,2,"['tecatetrav', 'davisloen']",163,"['kcrawf', 'vkov', 'pinea', 'ssengupta3', 'dwangy', 'yfchen87', 'liutif', 'monisanchezblanco', 'jyhoff', 'artrinity', 'lenling', 'ehsi', 'avibreg', 'jhardi9', 'iamavash', 'kenmp', 'anfetre', 'mirandamiao', 'dhruvtatke', 'kobocc1994', 'ybeeker', 'mreed11', 'alexzimm', 'cdonahu', 'jkern3', 'amandnic', 'optalmad', 'ialonsogago', 'jaketh2', 'nikaren', 'ollorentemartija', 'acleve', 'cdrewery', 'alexshaw', 'danevans', 'rishavc', 'apdoyle', 'werforgerf4life', 'kli47', 'fphender', 'shirundo', 'rrwilson', 'costalt', 'rlrob', 'lmorrissey', 'clindn', 'shawak', 'hregner2', 'annakcha', 'sebmuraru', 'myrta', 'nsk2', 'brenrice', 'claudsnd', 'jbpeller', 'mccartnt', 'jeilers', 'katferg', 'ahmadubuntu', 'cjbmi', 'ajhorvath', 'brdemarc', 'cpassolano', 'dkatz4', 'narceci', 'ryougijc', 'mattfuentez10', 'dieguez999', 'leveill2', 'ldwillia', 'mlodriguito', 'rotenmax', 'amroe', 'scollard', 'blanzyt', 'ksallans', 'reedy', 'kartikghosh2008', 'reisnerd', 'apielack', 'allendc', 'tbarang', 'jojoco', 'tdabney', 'ehai1234', 'joseam2', 'ggracevr', 'arehman4', 'solayinka', 'lmeddaugh', 'qzhang', 'ollinebg', 'deanjac99', 'chinmayanandadm', 'komen', 'lrhamp', 'hteutsch', 'umana2', 'hgaudin', 'eraeker', 'dmartinfernandezvald', 'snahe', 'zouhaox', 'tarnsangprad', 'barbaraldoriga5', 'serenad', 'brokawat', 'higgin24', 'ftadros', 'tobias.m.egle', 'kmaxie', 'mayank4551', 'krislew', 'aalmohri', 'haileymk', 'xzhan147', 'woodjosh', 'lwight', 'ojovinomarques', 'jerry0075566', 'dkfkadbs304', 'ssmate', 'ychen261', 'wbumbaca', 'moralist', 'shea.costner', 'jcobolopez', 'ccafmeye', 'mviksne', 'frasheski', 'stu', 'dshah515', 'malhark', 'herrerag', 'stapleton3', 'tmarkiew', 'jepi', 'mgratows', 'grfedele', 'liannaldo007', 'phamleminhthong', 'ggmorrow', 's.bikash', 'llsloan55555', 'asadncepc', 'cjmichae', 'asasa', 'kjfrank2', 'maymephilbrick', 'sayanr', 'shamilt3', 'msross', 'saurabhchem09', 'aapfel', 'pdstaubl', 'eescudermilian', 'healyjl', 'yzhou91', 'rexkhan', 'bebling', 'yhu55', 'dmcpher', 'saxman25']",10,"['racotter', 'surfingslow', 'iblackbu', 'lbagbyy', 'thomas.s.busse', 'jhulfach', None, 'eoreste', 'benjaminvf', 'mbkivy']",175,"['kcrawf', 'racotter', 'vkov', 'pinea', 'ssengupta3', 'dwangy', 'yfchen87', 'liutif', 'monisanchezblanco', 'jyhoff', 'artrinity', 'lenling', 'ehsi', 'avibreg', 'jhardi9', 'iamavash', 'kenmp', 'anfetre', 'mirandamiao', 'thomas.s.busse', 'dhruvtatke', 'kobocc1994', 'ybeeker', 'mreed11', 'alexzimm', 'cdonahu', 'jkern3', 'amandnic', 'optalmad', 'ialonsogago', 'jaketh2', 'nikaren', 'ollorentemartija', 'acleve', 'cdrewery', 'alexshaw', 'danevans', 'rishavc', 'apdoyle', 'werforgerf4life', 'kli47', 'fphender', 'shirundo', 'rrwilson', 'costalt', 'rlrob', 'lmorrissey', 'clindn', 'shawak', 'hregner2', 'annakcha', 'sebmuraru', 'myrta', 'nsk2', 'brenrice', 'jhulfach', 'claudsnd', 'jbpeller', 'mccartnt', 'jeilers', 'katferg', 'ahmadubuntu', 'cjbmi', 'ajhorvath', 'brdemarc', 'lbagbyy', 'cpassolano', 'dkatz4', 'narceci', 'ryougijc', 'mattfuentez10', 'iblackbu', 'dieguez999', 'leveill2', 'ldwillia', 'mlodriguito', 'rotenmax', 'benjaminvf', 'amroe', 'scollard', 'blanzyt', 'ksallans', 'reedy', 'kartikghosh2008', 'reisnerd', 'apielack', 'allendc', 'tbarang', 'jojoco', 'tdabney', 'ehai1234', 'joseam2', 'ggracevr', 'arehman4', 'solayinka', 'lmeddaugh', 'qzhang', 'ollinebg', 'deanjac99', 'chinmayanandadm', 'komen', 'lrhamp', 'hteutsch', 'umana2', 'hgaudin', 'eraeker', 'dmartinfernandezvald', 'snahe', 'zouhaox', 'tarnsangprad', 'barbaraldoriga5', 'serenad', 'brokawat', 'higgin24', 'ftadros', 'tobias.m.egle', 'kmaxie', 'mayank4551', 'krislew', 'aalmohri', 'haileymk', 'xzhan147', 'woodjosh', 'lwight', 'ojovinomarques', 'jerry0075566', 'dkfkadbs304', 'mbkivy', 'ssmate', 'ychen261', 'wbumbaca', 'moralist', 'shea.costner', 'jcobolopez', 'surfingslow', 'ccafmeye', 'mviksne', 'tecatetrav', 'frasheski', 'stu', 'eoreste', 'dshah515', 'malhark', 'herrerag', 'stapleton3', 'tmarkiew', 'jepi', 'mgratows', 'grfedele', 'liannaldo007', 'phamleminhthong', 'ggmorrow', 's.bikash', 'llsloan55555', 'asadncepc', 'cjmichae', 'asasa', 'kjfrank2', 'davisloen', 'maymephilbrick', 'sayanr', 'shamilt3', 'msross', 'saurabhchem09', 'aapfel', 'pdstaubl', None, 'eescudermilian', 'healyjl', 'yzhou91', 'rexkhan', 'bebling', 'yhu55', 'dmcpher', 'saxman25']"
4,122,166,11,8,"['mccartnt', 'amroe', 'shawak', 'aalmohri', 'bebling', 'acleve', 'ggmorrow', 'jyhoff']",157,"['kcrawf', 'vkov', 'pinea', 'ssengupta3', 'dwangy', 'yfchen87', 'liutif', 'monisanchezblanco', 'artrinity', 'lenling', 'ehsi', 'avibreg', 'jhardi9', 'iamavash', 'kenmp', 'anfetre', 'mirandamiao', 'dhruvtatke', 'kobocc1994', 'ybeeker', 'mreed11', 'alexzimm', 'cdonahu', 'jkern3', 'amandnic', 'optalmad', 'ialonsogago', 'jaketh2', 'nikaren', 'ollorentemartija', 'cdrewery', 'alexshaw', 'danevans', 'rishavc', 'apdoyle', 'werforgerf4life', 'kli47', 'fphender', 'shirundo', 'rrwilson', 'costalt', 'rlrob', 'lmorrissey', 'clindn', 'hregner2', 'annakcha', 'sebmuraru', 'myrta', 'nsk2', 'brenrice', 'claudsnd', 'jbpeller', 'jeilers', 'katferg', 'ahmadubuntu', 'cjbmi', 'ajhorvath', 'brdemarc', 'cpassolano', 'dkatz4', 'narceci', 'ryougijc', 'mattfuentez10', 'dieguez999', 'leveill2', 'ldwillia', 'mlodriguito', 'rotenmax', 'scollard', 'blanzyt', 'ksallans', 'reedy', 'kartikghosh2008', 'reisnerd', 'apielack', 'allendc', 'tbarang', 'jojoco', 'tdabney', 'ehai1234', 'joseam2', 'ggracevr', 'arehman4', 'solayinka', 'lmeddaugh', 'qzhang', 'ollinebg', 'deanjac99', 'chinmayanandadm', 'komen', 'lrhamp', 'hteutsch', 'umana2', 'hgaudin', 'eraeker', 'dmartinfernandezvald', 'snahe', 'zouhaox', 'tarnsangprad', 'barbaraldoriga5', 'serenad', 'brokawat', 'higgin24', 'ftadros', 'tobias.m.egle', 'kmaxie', 'mayank4551', 'krislew', 'haileymk', 'xzhan147', 'woodjosh', 'lwight', 'ojovinomarques', 'jerry0075566', 'dkfkadbs304', 'ssmate', 'ychen261', 'wbumbaca', 'moralist', 'shea.costner', 'jcobolopez', 'ccafmeye', 'mviksne', 'tecatetrav', 'frasheski', 'stu', 'dshah515', 'malhark', 'herrerag', 'stapleton3', 'tmarkiew', 'jepi', 'mgratows', 'grfedele', 'liannaldo007', 'phamleminhthong', 's.bikash', 'llsloan55555', 'asadncepc', 'cjmichae', 'asasa', 'kjfrank2', 'davisloen', 'maymephilbrick', 'sayanr', 'shamilt3', 'msross', 'saurabhchem09', 'aapfel', 'pdstaubl', 'eescudermilian', 'healyjl', 'yzhou91', 'rexkhan', 'yhu55', 'dmcpher', 'saxman25']",3,"['rebschro', None, 'kpgreenm']",168,"['kcrawf', 'vkov', 'pinea', 'ssengupta3', 'dwangy', 'yfchen87', 'liutif', 'monisanchezblanco', 'jyhoff', 'artrinity', 'lenling', 'ehsi', 'avibreg', 'jhardi9', 'iamavash', 'kenmp', 'anfetre', 'mirandamiao', 'dhruvtatke', 'kobocc1994', 'ybeeker', 'mreed11', 'alexzimm', 'kpgreenm', 'cdonahu', 'jkern3', 'amandnic', 'optalmad', 'ialonsogago', 'jaketh2', 'nikaren', 'ollorentemartija', 'acleve', 'cdrewery', 'alexshaw', 'danevans', 'rishavc', 'apdoyle', 'werforgerf4life', 'kli47', 'fphender', 'shirundo', 'rrwilson', 'costalt', 'rlrob', 'lmorrissey', 'clindn', 'shawak', 'hregner2', 'annakcha', 'sebmuraru', 'myrta', 'nsk2', 'brenrice', 'claudsnd', 'jbpeller', 'mccartnt', 'jeilers', 'katferg', 'ahmadubuntu', 'cjbmi', 'ajhorvath', 'brdemarc', 'cpassolano', 'dkatz4', 'narceci', 'ryougijc', 'mattfuentez10', 'dieguez999', 'leveill2', 'ldwillia', 'mlodriguito', 'rotenmax', 'rebschro', 'amroe', 'scollard', 'blanzyt', 'ksallans', 'reedy', 'kartikghosh2008', 'reisnerd', 'apielack', 'allendc', 'tbarang', 'jojoco', 'tdabney', 'ehai1234', 'joseam2', 'ggracevr', 'arehman4', 'solayinka', 'lmeddaugh', 'qzhang', 'ollinebg', 'deanjac99', 'chinmayanandadm', 'komen', 'lrhamp', 'hteutsch', 'umana2', 'hgaudin', 'eraeker', 'dmartinfernandezvald', 'snahe', 'zouhaox', 'tarnsangprad', 'barbaraldoriga5', 'serenad', 'brokawat', 'higgin24', 'ftadros', 'tobias.m.egle', 'kmaxie', 'mayank4551', 'krislew', 'aalmohri', 'haileymk', 'xzhan147', 'woodjosh', 'lwight', 'ojovinomarques', 'jerry0075566', 'dkfkadbs304', 'ssmate', 'ychen261', 'wbumbaca', 'moralist', 'shea.costner', 'jcobolopez', 'ccafmeye', 'mviksne', 'tecatetrav', 'frasheski', 'stu', 'dshah515', 'malhark', 'herrerag', 'stapleton3', 'tmarkiew', 'jepi', 'mgratows', 'grfedele', 'liannaldo007', 'phamleminhthong', 'ggmorrow', 's.bikash', 'llsloan55555', 'asadncepc', 'cjmichae', 'asasa', 'kjfrank2', 'davisloen', 'maymephilbrick', 'sayanr', 'shamilt3', 'msross', 'saurabhchem09', 'aapfel', 'pdstaubl', None, 'eescudermilian', 'healyjl', 'yzhou91', 'rexkhan', 'bebling', 'yhu55', 'dmcpher', 'saxman25']"
4,124,166,11,9,"['mccartnt', 'rlrob', 'amroe', 'shawak', 'aalmohri', 'bebling', 'acleve', 'anfetre', 'jyhoff']",156,"['kcrawf', 'vkov', 'pinea', 'ssengupta3', 'dwangy', 'yfchen87', 'liutif', 'monisanchezblanco', 'artrinity', 'lenling', 'ehsi', 'avibreg', 'jhardi9', 'iamavash', 'kenmp', 'mirandamiao', 'dhruvtatke', 'kobocc1994', 'ybeeker', 'mreed11', 'alexzimm', 'cdonahu', 'jkern3', 'amandnic', 'optalmad', 'ialonsogago', 'jaketh2', 'nikaren', 'ollorentemartija', 'cdrewery', 'alexshaw', 'danevans', 'rishavc', 'apdoyle', 'werforgerf4life', 'kli47', 'fphender', 'shirundo', 'rrwilson', 'costalt', 'lmorrissey', 'clindn', 'hregner2', 'annakcha', 'sebmuraru', 'myrta', 'nsk2', 'brenrice', 'claudsnd', 'jbpeller', 'jeilers', 'katferg', 'ahmadubuntu', 'cjbmi', 'ajhorvath', 'brdemarc', 'cpassolano', 'dkatz4', 'narceci', 'ryougijc', 'mattfuentez10', 'dieguez999', 'leveill2', 'ldwillia', 'mlodriguito', 'rotenmax', 'scollard', 'blanzyt', 'ksallans', 'reedy', 'kartikghosh2008', 'reisnerd', 'apielack', 'allendc', 'tbarang', 'jojoco', 'tdabney', 'ehai1234', 'joseam2', 'ggracevr', 'arehman4', 'solayinka', 'lmeddaugh', 'qzhang', 'ollinebg', 'deanjac99', 'chinmayanandadm', 'komen', 'lrhamp', 'hteutsch', 'umana2', 'hgaudin', 'eraeker', 'dmartinfernandezvald', 'snahe', 'zouhaox', 'tarnsangprad', 'barbaraldoriga5', 'serenad', 'brokawat', 'higgin24', 'ftadros', 'tobias.m.egle', 'kmaxie', 'mayank4551', 'krislew', 'haileymk', 'xzhan147', 'woodjosh', 'lwight', 'ojovinomarques', 'jerry0075566', 'dkfkadbs304', 'ssmate', 'ychen261', 'wbumbaca', 'moralist', 'shea.costner', 'jcobolopez', 'ccafmeye', 'mviksne', 'tecatetrav', 'frasheski', 'stu', 'dshah515', 'malhark', 'herrerag', 'stapleton3', 'tmarkiew', 'jepi', 'mgratows', 'grfedele', 'liannaldo007', 'phamleminhthong', 'ggmorrow', 's.bikash', 'llsloan55555', 'asadncepc', 'cjmichae', 'asasa', 'kjfrank2', 'davisloen', 'maymephilbrick', 'sayanr', 'shamilt3', 'msross', 'saurabhchem09', 'aapfel', 'pdstaubl', 'eescudermilian', 'healyjl', 'yzhou91', 'rexkhan', 'yhu55', 'dmcpher', 'saxman25']",2,"['dsfrei', None]",167,"['kcrawf', 'vkov', 'pinea', 'ssengupta3', 'dwangy', 'yfchen87', 'liutif', 'monisanchezblanco', 'jyhoff', 'artrinity', 'lenling', 'ehsi', 'avibreg', 'jhardi9', 'iamavash', 'kenmp', 'anfetre', 'mirandamiao', 'dhruvtatke', 'kobocc1994', 'ybeeker', 'mreed11', 'alexzimm', 'cdonahu', 'jkern3', 'amandnic', 'optalmad', 'ialonsogago', 'jaketh2', 'nikaren', 'ollorentemartija', 'acleve', 'cdrewery', 'alexshaw', 'danevans', 'rishavc', 'apdoyle', 'werforgerf4life', 'kli47', 'fphender', 'shirundo', 'rrwilson', 'costalt', 'rlrob', 'lmorrissey', 'clindn', 'shawak', 'hregner2', 'annakcha', 'sebmuraru', 'myrta', 'nsk2', 'brenrice', 'claudsnd', 'jbpeller', 'mccartnt', 'jeilers', 'katferg', 'ahmadubuntu', 'cjbmi', 'ajhorvath', 'brdemarc', 'cpassolano', 'dkatz4', 'narceci', 'ryougijc', 'mattfuentez10', 'dieguez999', 'leveill2', 'ldwillia', 'mlodriguito', 'rotenmax', 'amroe', 'scollard', 'blanzyt', 'ksallans', 'reedy', 'kartikghosh2008', 'reisnerd', 'apielack', 'allendc', 'tbarang', 'jojoco', 'tdabney', 'ehai1234', 'joseam2', 'ggracevr', 'arehman4', 'solayinka', 'lmeddaugh', 'qzhang', 'ollinebg', 'deanjac99', 'chinmayanandadm', 'dsfrei', 'komen', 'lrhamp', 'hteutsch', 'umana2', 'hgaudin', 'eraeker', 'dmartinfernandezvald', 'snahe', 'zouhaox', 'tarnsangprad', 'barbaraldoriga5', 'serenad', 'brokawat', 'higgin24', 'ftadros', 'tobias.m.egle', 'kmaxie', 'mayank4551', 'krislew', 'aalmohri', 'haileymk', 'xzhan147', 'woodjosh', 'lwight', 'ojovinomarques', 'jerry0075566', 'dkfkadbs304', 'ssmate', 'ychen261', 'wbumbaca', 'moralist', 'shea.costner', 'jcobolopez', 'ccafmeye', 'mviksne', 'tecatetrav', 'frasheski', 'stu', 'dshah515', 'malhark', 'herrerag', 'stapleton3', 'tmarkiew', 'jepi', 'mgratows', 'grfedele', 'liannaldo007', 'phamleminhthong', 'ggmorrow', 's.bikash', 'llsloan55555', 'asadncepc', 'cjmichae', 'asasa', 'kjfrank2', 'davisloen', 'maymephilbrick', 'sayanr', 'shamilt3', 'msross', 'saurabhchem09', 'aapfel', 'pdstaubl', None, 'eescudermilian', 'healyjl', 'yzhou91', 'rexkhan', 'bebling', 'yhu55', 'dmcpher', 'saxman25']"
4,125,166,10,6,"['davisloen', 'cdrewery', 'dieguez999', 'mviksne', 'msross', 'fphender']",159,"['kcrawf', 'vkov', 'pinea', 'ssengupta3', 'dwangy', 'yfchen87', 'liutif', 'monisanchezblanco', 'jyhoff', 'artrinity', 'lenling', 'ehsi', 'avibreg', 'jhardi9', 'iamavash', 'kenmp', 'anfetre', 'mirandamiao', 'dhruvtatke', 'kobocc1994', 'ybeeker', 'mreed11', 'alexzimm', 'cdonahu', 'jkern3', 'amandnic', 'optalmad', 'ialonsogago', 'jaketh2', 'nikaren', 'ollorentemartija', 'acleve', 'alexshaw', 'danevans', 'rishavc', 'apdoyle', 'werforgerf4life', 'kli47', 'shirundo', 'rrwilson', 'costalt', 'rlrob', 'lmorrissey', 'clindn', 'shawak', 'hregner2', 'annakcha', 'sebmuraru', 'myrta', 'nsk2', 'brenrice', 'claudsnd', 'jbpeller', 'mccartnt', 'jeilers', 'katferg', 'ahmadubuntu', 'cjbmi', 'ajhorvath', 'brdemarc', 'cpassolano', 'dkatz4', 'narceci', 'ryougijc', 'mattfuentez10', 'leveill2', 'ldwillia', 'mlodriguito', 'rotenmax', 'amroe', 'scollard', 'blanzyt', 'ksallans', 'reedy', 'kartikghosh2008', 'reisnerd', 'apielack', 'allendc', 'tbarang', 'jojoco', 'tdabney', 'ehai1234', 'joseam2', 'ggracevr', 'arehman4', 'solayinka', 'lmeddaugh', 'qzhang', 'ollinebg', 'deanjac99', 'chinmayanandadm', 'komen', 'lrhamp', 'hteutsch', 'umana2', 'hgaudin', 'eraeker', 'dmartinfernandezvald', 'snahe', 'zouhaox', 'tarnsangprad', 'barbaraldoriga5', 'serenad', 'brokawat', 'higgin24', 'ftadros', 'tobias.m.egle', 'kmaxie', 'mayank4551', 'krislew', 'aalmohri', 'haileymk', 'xzhan147', 'woodjosh', 'lwight', 'ojovinomarques', 'jerry0075566', 'dkfkadbs304', 'ssmate', 'ychen261', 'wbumbaca', 'moralist', 'shea.costner', 'jcobolopez', 'ccafmeye', 'tecatetrav', 'frasheski', 'stu', 'dshah515', 'malhark', 'herrerag', 'stapleton3', 'tmarkiew', 'jepi', 'mgratows', 'grfedele', 'liannaldo007', 'phamleminhthong', 'ggmorrow', 's.bikash', 'llsloan55555', 'asadncepc', 'cjmichae', 'asasa', 'kjfrank2', 'maymephilbrick', 'sayanr', 'shamilt3', 'saurabhchem09', 'aapfel', 'pdstaubl', 'eescudermilian', 'healyjl', 'yzhou91', 'rexkhan', 'bebling', 'yhu55', 'dmcpher', 'saxman25']",4,"['lbagbyy', None, 'racotter', 'thomas.s.busse']",169,"['kcrawf', 'racotter', 'vkov', 'pinea', 'ssengupta3', 'dwangy', 'yfchen87', 'liutif', 'monisanchezblanco', 'jyhoff', 'artrinity', 'lenling', 'ehsi', 'avibreg', 'jhardi9', 'iamavash', 'kenmp', 'anfetre', 'mirandamiao', 'thomas.s.busse', 'dhruvtatke', 'kobocc1994', 'ybeeker', 'mreed11', 'alexzimm', 'cdonahu', 'jkern3', 'amandnic', 'optalmad', 'ialonsogago', 'jaketh2', 'nikaren', 'ollorentemartija', 'acleve', 'cdrewery', 'alexshaw', 'danevans', 'rishavc', 'apdoyle', 'werforgerf4life', 'kli47', 'fphender', 'shirundo', 'rrwilson', 'costalt', 'rlrob', 'lmorrissey', 'clindn', 'shawak', 'hregner2', 'annakcha', 'sebmuraru', 'myrta', 'nsk2', 'brenrice', 'claudsnd', 'jbpeller', 'mccartnt', 'jeilers', 'katferg', 'ahmadubuntu', 'cjbmi', 'ajhorvath', 'brdemarc', 'lbagbyy', 'cpassolano', 'dkatz4', 'narceci', 'ryougijc', 'mattfuentez10', 'dieguez999', 'leveill2', 'ldwillia', 'mlodriguito', 'rotenmax', 'amroe', 'scollard', 'blanzyt', 'ksallans', 'reedy', 'kartikghosh2008', 'reisnerd', 'apielack', 'allendc', 'tbarang', 'jojoco', 'tdabney', 'ehai1234', 'joseam2', 'ggracevr', 'arehman4', 'solayinka', 'lmeddaugh', 'qzhang', 'ollinebg', 'deanjac99', 'chinmayanandadm', 'komen', 'lrhamp', 'hteutsch', 'umana2', 'hgaudin', 'eraeker', 'dmartinfernandezvald', 'snahe', 'zouhaox', 'tarnsangprad', 'barbaraldoriga5', 'serenad', 'brokawat', 'higgin24', 'ftadros', 'tobias.m.egle', 'kmaxie', 'mayank4551', 'krislew', 'aalmohri', 'haileymk', 'xzhan147', 'woodjosh', 'lwight', 'ojovinomarques', 'jerry0075566', 'dkfkadbs304', 'ssmate', 'ychen261', 'wbumbaca', 'moralist', 'shea.costner', 'jcobolopez', 'ccafmeye', 'mviksne', 'tecatetrav', 'frasheski', 'stu', 'dshah515', 'malhark', 'herrerag', 'stapleton3', 'tmarkiew', 'jepi', 'mgratows', 'grfedele', 'liannaldo007', 'phamleminhthong', 'ggmorrow', 's.bikash', 'llsloan55555', 'asadncepc', 'cjmichae', 'asasa', 'kjfrank2', 'davisloen', 'maymephilbrick', 'sayanr', 'shamilt3', 'msross', 'saurabhchem09', 'aapfel', 'pdstaubl', None, 'eescudermilian', 'healyjl', 'yzhou91', 'rexkhan', 'bebling', 'yhu55', 'dmcpher', 'saxman25']"
4,117,166,9,8,"['eescudermilian', 'ollorentemartija', 'jcobolopez', 'arehman4', 'shamilt3', 'dmartinfernandezvald', 'chinmayanandadm', 'barbaraldoriga5']",157,"['kcrawf', 'vkov', 'pinea', 'ssengupta3', 'dwangy', 'yfchen87', 'liutif', 'monisanchezblanco', 'jyhoff', 'artrinity', 'lenling', 'ehsi', 'avibreg', 'jhardi9', 'iamavash', 'kenmp', 'anfetre', 'mirandamiao', 'dhruvtatke', 'kobocc1994', 'ybeeker', 'mreed11', 'alexzimm', 'cdonahu', 'jkern3', 'amandnic', 'optalmad', 'ialonsogago', 'jaketh2', 'nikaren', 'acleve', 'cdrewery', 'alexshaw', 'danevans', 'rishavc', 'apdoyle', 'werforgerf4life', 'kli47', 'fphender', 'shirundo', 'rrwilson', 'costalt', 'rlrob', 'lmorrissey', 'clindn', 'shawak', 'hregner2', 'annakcha', 'sebmuraru', 'myrta', 'nsk2', 'brenrice', 'claudsnd', 'jbpeller', 'mccartnt', 'jeilers', 'katferg', 'ahmadubuntu', 'cjbmi', 'ajhorvath', 'brdemarc', 'cpassolano', 'dkatz4', 'narceci', 'ryougijc', 'mattfuentez10', 'dieguez999', 'leveill2', 'ldwillia', 'mlodriguito', 'rotenmax', 'amroe', 'scollard', 'blanzyt', 'ksallans', 'reedy', 'kartikghosh2008', 'reisnerd', 'apielack', 'allendc', 'tbarang', 'jojoco', 'tdabney', 'ehai1234', 'joseam2', 'ggracevr', 'solayinka', 'lmeddaugh', 'qzhang', 'ollinebg', 'deanjac99', 'komen', 'lrhamp', 'hteutsch', 'umana2', 'hgaudin', 'eraeker', 'snahe', 'zouhaox', 'tarnsangprad', 'serenad', 'brokawat', 'higgin24', 'ftadros', 'tobias.m.egle', 'kmaxie', 'mayank4551', 'krislew', 'aalmohri', 'haileymk', 'xzhan147', 'woodjosh', 'lwight', 'ojovinomarques', 'jerry0075566', 'dkfkadbs304', 'ssmate', 'ychen261', 'wbumbaca', 'moralist', 'shea.costner', 'ccafmeye', 'mviksne', 'tecatetrav', 'frasheski', 'stu', 'dshah515', 'malhark', 'herrerag', 'stapleton3', 'tmarkiew', 'jepi', 'mgratows', 'grfedele', 'liannaldo007', 'phamleminhthong', 'ggmorrow', 's.bikash', 'llsloan55555', 'asadncepc', 'cjmichae', 'asasa', 'kjfrank2', 'davisloen', 'maymephilbrick', 'sayanr', 'msross', 'saurabhchem09', 'aapfel', 'pdstaubl', 'healyjl', 'yzhou91', 'rexkhan', 'bebling', 'yhu55', 'dmcpher', 'saxman25']",1,[None],166,"['kcrawf', 'vkov', 'pinea', 'ssengupta3', 'dwangy', 'yfchen87', 'liutif', 'monisanchezblanco', 'jyhoff', 'artrinity', 'lenling', 'ehsi', 'avibreg', 'jhardi9', 'iamavash', 'kenmp', 'anfetre', 'mirandamiao', 'dhruvtatke', 'kobocc1994', 'ybeeker', 'mreed11', 'alexzimm', 'cdonahu', 'jkern3', 'amandnic', 'optalmad', 'ialonsogago', 'jaketh2', 'nikaren', 'ollorentemartija', 'acleve', 'cdrewery', 'alexshaw', 'danevans', 'rishavc', 'apdoyle', 'werforgerf4life', 'kli47', 'fphender', 'shirundo', 'rrwilson', 'costalt', 'rlrob', 'lmorrissey', 'clindn', 'shawak', 'hregner2', 'annakcha', 'sebmuraru', 'myrta', 'nsk2', 'brenrice', 'claudsnd', 'jbpeller', 'mccartnt', 'jeilers', 'katferg', 'ahmadubuntu', 'cjbmi', 'ajhorvath', 'brdemarc', 'cpassolano', 'dkatz4', 'narceci', 'ryougijc', 'mattfuentez10', 'dieguez999', 'leveill2', 'ldwillia', 'mlodriguito', 'rotenmax', 'amroe', 'scollard', 'blanzyt', 'ksallans', 'reedy', 'kartikghosh2008', 'reisnerd', 'apielack', 'allendc', 'tbarang', 'jojoco', 'tdabney', 'ehai1234', 'joseam2', 'ggracevr', 'arehman4', 'solayinka', 'lmeddaugh', 'qzhang', 'ollinebg', 'deanjac99', 'chinmayanandadm', 'komen', 'lrhamp', 'hteutsch', 'umana2', 'hgaudin', 'eraeker', 'dmartinfernandezvald', 'snahe', 'zouhaox', 'tarnsangprad', 'barbaraldoriga5', 'serenad', 'brokawat', 'higgin24', 'ftadros', 'tobias.m.egle', 'kmaxie', 'mayank4551', 'krislew', 'aalmohri', 'haileymk', 'xzhan147', 'woodjosh', 'lwight', 'ojovinomarques', 'jerry0075566', 'dkfkadbs304', 'ssmate', 'ychen261', 'wbumbaca', 'moralist', 'shea.costner', 'jcobolopez', 'ccafmeye', 'mviksne', 'tecatetrav', 'frasheski', 'stu', 'dshah515', 'malhark', 'herrerag', 'stapleton3', 'tmarkiew', 'jepi', 'mgratows', 'grfedele', 'liannaldo007', 'phamleminhthong', 'ggmorrow', 's.bikash', 'llsloan55555', 'asadncepc', 'cjmichae', 'asasa', 'kjfrank2', 'davisloen', 'maymephilbrick', 'sayanr', 'shamilt3', 'msross', 'saurabhchem09', 'aapfel', 'pdstaubl', None, 'eescudermilian', 'healyjl', 'yzhou91', 'rexkhan', 'bebling', 'yhu55', 'dmcpher', 'saxman25']"
4,112,166,7,1,['myrta'],164,"['kcrawf', 'vkov', 'pinea', 'ssengupta3', 'dwangy', 'yfchen87', 'liutif', 'monisanchezblanco', 'jyhoff', 'artrinity', 'lenling', 'ehsi', 'avibreg', 'jhardi9', 'iamavash', 'kenmp', 'anfetre', 'mirandamiao', 'dhruvtatke', 'kobocc1994', 'ybeeker', 'mreed11', 'alexzimm', 'cdonahu', 'jkern3', 'amandnic', 'optalmad', 'ialonsogago', 'jaketh2', 'nikaren', 'ollorentemartija', 'acleve', 'cdrewery', 'alexshaw', 'danevans', 'rishavc', 'apdoyle', 'werforgerf4life', 'kli47', 'fphender', 'shirundo', 'rrwilson', 'costalt', 'rlrob', 'lmorrissey', 'clindn', 'shawak', 'hregner2', 'annakcha', 'sebmuraru', 'nsk2', 'brenrice', 'claudsnd', 'jbpeller', 'mccartnt', 'jeilers', 'katferg', 'ahmadubuntu', 'cjbmi', 'ajhorvath', 'brdemarc', 'cpassolano', 'dkatz4', 'narceci', 'ryougijc', 'mattfuentez10', 'dieguez999', 'leveill2', 'ldwillia', 'mlodriguito', 'rotenmax', 'amroe', 'scollard', 'blanzyt', 'ksallans', 'reedy', 'kartikghosh2008', 'reisnerd', 'apielack', 'allendc', 'tbarang', 'jojoco', 'tdabney', 'ehai1234', 'joseam2', 'ggracevr', 'arehman4', 'solayinka', 'lmeddaugh', 'qzhang', 'ollinebg', 'deanjac99', 'chinmayanandadm', 'komen', 'lrhamp', 'hteutsch', 'umana2', 'hgaudin', 'eraeker', 'dmartinfernandezvald', 'snahe', 'zouhaox', 'tarnsangprad', 'barbaraldoriga5', 'serenad', 'brokawat', 'higgin24', 'ftadros', 'tobias.m.egle', 'kmaxie', 'mayank4551', 'krislew', 'aalmohri', 'haileymk', 'xzhan147', 'woodjosh', 'lwight', 'ojovinomarques', 'jerry0075566', 'dkfkadbs304', 'ssmate', 'ychen261', 'wbumbaca', 'moralist', 'shea.costner', 'jcobolopez', 'ccafmeye', 'mviksne', 'tecatetrav', 'frasheski', 'stu', 'dshah515', 'malhark', 'herrerag', 'stapleton3', 'tmarkiew', 'jepi', 'mgratows', 'grfedele', 'liannaldo007', 'phamleminhthong', 'ggmorrow', 's.bikash', 'llsloan55555', 'asadncepc', 'cjmichae', 'asasa', 'kjfrank2', 'davisloen', 'maymephilbrick', 'sayanr', 'shamilt3', 'msross', 'saurabhchem09', 'aapfel', 'pdstaubl', 'eescudermilian', 'healyjl', 'yzhou91', 'rexkhan', 'bebling', 'yhu55', 'dmcpher', 'saxman25']",6,"['nataliapinirtzi', 'echo570', None, 'paguado', 'ggreenediniz18', 'robbiemorrison1995']",171,"['kcrawf', 'vkov', 'pinea', 'ssengupta3', 'dwangy', 'yfchen87', 'liutif', 'monisanchezblanco', 'jyhoff', 'artrinity', 'lenling', 'ehsi', 'avibreg', 'jhardi9', 'iamavash', 'kenmp', 'anfetre', 'mirandamiao', 'echo570', 'dhruvtatke', 'kobocc1994', 'ybeeker', 'mreed11', 'alexzimm', 'cdonahu', 'jkern3', 'amandnic', 'optalmad', 'ialonsogago', 'jaketh2', 'paguado', 'nikaren', 'ollorentemartija', 'acleve', 'cdrewery', 'alexshaw', 'danevans', 'rishavc', 'apdoyle', 'werforgerf4life', 'kli47', 'fphender', 'shirundo', 'rrwilson', 'costalt', 'robbiemorrison1995', 'rlrob', 'lmorrissey', 'clindn', 'shawak', 'hregner2', 'annakcha', 'sebmuraru', 'myrta', 'nsk2', 'nataliapinirtzi', 'brenrice', 'ggreenediniz18', 'claudsnd', 'jbpeller', 'mccartnt', 'jeilers', 'katferg', 'ahmadubuntu', 'cjbmi', 'ajhorvath', 'brdemarc', 'cpassolano', 'dkatz4', 'narceci', 'ryougijc', 'mattfuentez10', 'dieguez999', 'leveill2', 'ldwillia', 'mlodriguito', 'rotenmax', 'amroe', 'scollard', 'blanzyt', 'ksallans', 'reedy', 'kartikghosh2008', 'reisnerd', 'apielack', 'allendc', 'tbarang', 'jojoco', 'tdabney', 'ehai1234', 'joseam2', 'ggracevr', 'arehman4', 'solayinka', 'lmeddaugh', 'qzhang', 'ollinebg', 'deanjac99', 'chinmayanandadm', 'komen', 'lrhamp', 'hteutsch', 'umana2', 'hgaudin', 'eraeker', 'dmartinfernandezvald', 'snahe', 'zouhaox', 'tarnsangprad', 'barbaraldoriga5', 'serenad', 'brokawat', 'higgin24', 'ftadros', 'tobias.m.egle', 'kmaxie', 'mayank4551', 'krislew', 'aalmohri', 'haileymk', 'xzhan147', 'woodjosh', 'lwight', 'ojovinomarques', 'jerry0075566', 'dkfkadbs304', 'ssmate', 'ychen261', 'wbumbaca', 'moralist', 'shea.costner', 'jcobolopez', 'ccafmeye', 'mviksne', 'tecatetrav', 'frasheski', 'stu', 'dshah515', 'malhark', 'herrerag', 'stapleton3', 'tmarkiew', 'jepi', 'mgratows', 'grfedele', 'liannaldo007', 'phamleminhthong', 'ggmorrow', 's.bikash', 'llsloan55555', 'asadncepc', 'cjmichae', 'asasa', 'kjfrank2', 'davisloen', 'maymephilbrick', 'sayanr', 'shamilt3', 'msross', 'saurabhchem09', 'aapfel', 'pdstaubl', None, 'eescudermilian', 'healyjl', 'yzhou91', 'rexkhan', 'bebling', 'yhu55', 'dmcpher', 'saxman25']"
4,116,166,7,6,"['annakcha', 'jepi', 'blanzyt', 'snahe', 'brenrice', 'ehsi']",159,"['kcrawf', 'vkov', 'pinea', 'ssengupta3', 'dwangy', 'yfchen87', 'liutif', 'monisanchezblanco', 'jyhoff', 'artrinity', 'lenling', 'avibreg', 'jhardi9', 'iamavash', 'kenmp', 'anfetre', 'mirandamiao', 'dhruvtatke', 'kobocc1994', 'ybeeker', 'mreed11', 'alexzimm', 'cdonahu', 'jkern3', 'amandnic', 'optalmad', 'ialonsogago', 'jaketh2', 'nikaren', 'ollorentemartija', 'acleve', 'cdrewery', 'alexshaw', 'danevans', 'rishavc', 'apdoyle', 'werforgerf4life', 'kli47', 'fphender', 'shirundo', 'rrwilson', 'costalt', 'rlrob', 'lmorrissey', 'clindn', 'shawak', 'hregner2', 'sebmuraru', 'myrta', 'nsk2', 'claudsnd', 'jbpeller', 'mccartnt', 'jeilers', 'katferg', 'ahmadubuntu', 'cjbmi', 'ajhorvath', 'brdemarc', 'cpassolano', 'dkatz4', 'narceci', 'ryougijc', 'mattfuentez10', 'dieguez999', 'leveill2', 'ldwillia', 'mlodriguito', 'rotenmax', 'amroe', 'scollard', 'ksallans', 'reedy', 'kartikghosh2008', 'reisnerd', 'apielack', 'allendc', 'tbarang', 'jojoco', 'tdabney', 'ehai1234', 'joseam2', 'ggracevr', 'arehman4', 'solayinka', 'lmeddaugh', 'qzhang', 'ollinebg', 'deanjac99', 'chinmayanandadm', 'komen', 'lrhamp', 'hteutsch', 'umana2', 'hgaudin', 'eraeker', 'dmartinfernandezvald', 'zouhaox', 'tarnsangprad', 'barbaraldoriga5', 'serenad', 'brokawat', 'higgin24', 'ftadros', 'tobias.m.egle', 'kmaxie', 'mayank4551', 'krislew', 'aalmohri', 'haileymk', 'xzhan147', 'woodjosh', 'lwight', 'ojovinomarques', 'jerry0075566', 'dkfkadbs304', 'ssmate', 'ychen261', 'wbumbaca', 'moralist', 'shea.costner', 'jcobolopez', 'ccafmeye', 'mviksne', 'tecatetrav', 'frasheski', 'stu', 'dshah515', 'malhark', 'herrerag', 'stapleton3', 'tmarkiew', 'mgratows', 'grfedele', 'liannaldo007', 'phamleminhthong', 'ggmorrow', 's.bikash', 'llsloan55555', 'asadncepc', 'cjmichae', 'asasa', 'kjfrank2', 'davisloen', 'maymephilbrick', 'sayanr', 'shamilt3', 'msross', 'saurabhchem09', 'aapfel', 'pdstaubl', 'eescudermilian', 'healyjl', 'yzhou91', 'rexkhan', 'bebling', 'yhu55', 'dmcpher', 'saxman25']",1,[None],166,"['kcrawf', 'vkov', 'pinea', 'ssengupta3', 'dwangy', 'yfchen87', 'liutif', 'monisanchezblanco', 'jyhoff', 'artrinity', 'lenling', 'ehsi', 'avibreg', 'jhardi9', 'iamavash', 'kenmp', 'anfetre', 'mirandamiao', 'dhruvtatke', 'kobocc1994', 'ybeeker', 'mreed11', 'alexzimm', 'cdonahu', 'jkern3', 'amandnic', 'optalmad', 'ialonsogago', 'jaketh2', 'nikaren', 'ollorentemartija', 'acleve', 'cdrewery', 'alexshaw', 'danevans', 'rishavc', 'apdoyle', 'werforgerf4life', 'kli47', 'fphender', 'shirundo', 'rrwilson', 'costalt', 'rlrob', 'lmorrissey', 'clindn', 'shawak', 'hregner2', 'annakcha', 'sebmuraru', 'myrta', 'nsk2', 'brenrice', 'claudsnd', 'jbpeller', 'mccartnt', 'jeilers', 'katferg', 'ahmadubuntu', 'cjbmi', 'ajhorvath', 'brdemarc', 'cpassolano', 'dkatz4', 'narceci', 'ryougijc', 'mattfuentez10', 'dieguez999', 'leveill2', 'ldwillia', 'mlodriguito', 'rotenmax', 'amroe', 'scollard', 'blanzyt', 'ksallans', 'reedy', 'kartikghosh2008', 'reisnerd', 'apielack', 'allendc', 'tbarang', 'jojoco', 'tdabney', 'ehai1234', 'joseam2', 'ggracevr', 'arehman4', 'solayinka', 'lmeddaugh', 'qzhang', 'ollinebg', 'deanjac99', 'chinmayanandadm', 'komen', 'lrhamp', 'hteutsch', 'umana2', 'hgaudin', 'eraeker', 'dmartinfernandezvald', 'snahe', 'zouhaox', 'tarnsangprad', 'barbaraldoriga5', 'serenad', 'brokawat', 'higgin24', 'ftadros', 'tobias.m.egle', 'kmaxie', 'mayank4551', 'krislew', 'aalmohri', 'haileymk', 'xzhan147', 'woodjosh', 'lwight', 'ojovinomarques', 'jerry0075566', 'dkfkadbs304', 'ssmate', 'ychen261', 'wbumbaca', 'moralist', 'shea.costner', 'jcobolopez', 'ccafmeye', 'mviksne', 'tecatetrav', 'frasheski', 'stu', 'dshah515', 'malhark', 'herrerag', 'stapleton3', 'tmarkiew', 'jepi', 'mgratows', 'grfedele', 'liannaldo007', 'phamleminhthong', 'ggmorrow', 's.bikash', 'llsloan55555', 'asadncepc', 'cjmichae', 'asasa', 'kjfrank2', 'davisloen', 'maymephilbrick', 'sayanr', 'shamilt3', 'msross', 'saurabhchem09', 'aapfel', 'pdstaubl', None, 'eescudermilian', 'healyjl', 'yzhou91', 'rexkhan', 'bebling', 'yhu55', 'dmcpher', 'saxman25']"
4,121,166,7,5,"['brokawat', 'arehman4', 'ssengupta3', 'jaketh2', 'chinmayanandadm']",160,"['kcrawf', 'vkov', 'pinea', 'dwangy', 'yfchen87', 'liutif', 'monisanchezblanco', 'jyhoff', 'artrinity', 'lenling', 'ehsi', 'avibreg', 'jhardi9', 'iamavash', 'kenmp', 'anfetre', 'mirandamiao', 'dhruvtatke', 'kobocc1994', 'ybeeker', 'mreed11', 'alexzimm', 'cdonahu', 'jkern3', 'amandnic', 'optalmad', 'ialonsogago', 'nikaren', 'ollorentemartija', 'acleve', 'cdrewery', 'alexshaw', 'danevans', 'rishavc', 'apdoyle', 'werforgerf4life', 'kli47', 'fphender', 'shirundo', 'rrwilson', 'costalt', 'rlrob', 'lmorrissey', 'clindn', 'shawak', 'hregner2', 'annakcha', 'sebmuraru', 'myrta', 'nsk2', 'brenrice', 'claudsnd', 'jbpeller', 'mccartnt', 'jeilers', 'katferg', 'ahmadubuntu', 'cjbmi', 'ajhorvath', 'brdemarc', 'cpassolano', 'dkatz4', 'narceci', 'ryougijc', 'mattfuentez10', 'dieguez999', 'leveill2', 'ldwillia', 'mlodriguito', 'rotenmax', 'amroe', 'scollard', 'blanzyt', 'ksallans', 'reedy', 'kartikghosh2008', 'reisnerd', 'apielack', 'allendc', 'tbarang', 'jojoco', 'tdabney', 'ehai1234', 'joseam2', 'ggracevr', 'solayinka', 'lmeddaugh', 'qzhang', 'ollinebg', 'deanjac99', 'komen', 'lrhamp', 'hteutsch', 'umana2', 'hgaudin', 'eraeker', 'dmartinfernandezvald', 'snahe', 'zouhaox', 'tarnsangprad', 'barbaraldoriga5', 'serenad', 'higgin24', 'ftadros', 'tobias.m.egle', 'kmaxie', 'mayank4551', 'krislew', 'aalmohri', 'haileymk', 'xzhan147', 'woodjosh', 'lwight', 'ojovinomarques', 'jerry0075566', 'dkfkadbs304', 'ssmate', 'ychen261', 'wbumbaca', 'moralist', 'shea.costner', 'jcobolopez', 'ccafmeye', 'mviksne', 'tecatetrav', 'frasheski', 'stu', 'dshah515', 'malhark', 'herrerag', 'stapleton3', 'tmarkiew', 'jepi', 'mgratows', 'grfedele', 'liannaldo007', 'phamleminhthong', 'ggmorrow', 's.bikash', 'llsloan55555', 'asadncepc', 'cjmichae', 'asasa', 'kjfrank2', 'davisloen', 'maymephilbrick', 'sayanr', 'shamilt3', 'msross', 'saurabhchem09', 'aapfel', 'pdstaubl', 'eescudermilian', 'healyjl', 'yzhou91', 'rexkhan', 'bebling', 'yhu55', 'dmcpher', 'saxman25']",2,"[None, 'zhixin2']",167,"['kcrawf', 'vkov', 'pinea', 'ssengupta3', 'dwangy', 'yfchen87', 'liutif', 'monisanchezblanco', 'jyhoff', 'artrinity', 'lenling', 'ehsi', 'avibreg', 'jhardi9', 'iamavash', 'kenmp', 'anfetre', 'mirandamiao', 'dhruvtatke', 'kobocc1994', 'ybeeker', 'mreed11', 'alexzimm', 'cdonahu', 'jkern3', 'amandnic', 'optalmad', 'ialonsogago', 'jaketh2', 'nikaren', 'ollorentemartija', 'acleve', 'cdrewery', 'alexshaw', 'danevans', 'rishavc', 'apdoyle', 'werforgerf4life', 'kli47', 'fphender', 'shirundo', 'rrwilson', 'costalt', 'rlrob', 'lmorrissey', 'clindn', 'shawak', 'hregner2', 'annakcha', 'sebmuraru', 'myrta', 'nsk2', 'brenrice', 'claudsnd', 'jbpeller', 'mccartnt', 'jeilers', 'katferg', 'ahmadubuntu', 'cjbmi', 'ajhorvath', 'brdemarc', 'cpassolano', 'dkatz4', 'narceci', 'ryougijc', 'mattfuentez10', 'dieguez999', 'leveill2', 'ldwillia', 'mlodriguito', 'rotenmax', 'amroe', 'scollard', 'blanzyt', 'ksallans', 'reedy', 'kartikghosh2008', 'reisnerd', 'apielack', 'allendc', 'tbarang', 'jojoco', 'tdabney', 'ehai1234', 'joseam2', 'ggracevr', 'arehman4', 'solayinka', 'lmeddaugh', 'qzhang', 'ollinebg', 'deanjac99', 'chinmayanandadm', 'komen', 'lrhamp', 'hteutsch', 'umana2', 'hgaudin', 'eraeker', 'dmartinfernandezvald', 'snahe', 'zouhaox', 'tarnsangprad', 'barbaraldoriga5', 'serenad', 'brokawat', 'higgin24', 'ftadros', 'tobias.m.egle', 'kmaxie', 'mayank4551', 'krislew', 'aalmohri', 'haileymk', 'xzhan147', 'woodjosh', 'lwight', 'ojovinomarques', 'jerry0075566', 'dkfkadbs304', 'ssmate', 'ychen261', 'wbumbaca', 'moralist', 'shea.costner', 'jcobolopez', 'ccafmeye', 'mviksne', 'tecatetrav', 'frasheski', 'stu', 'dshah515', 'malhark', 'herrerag', 'stapleton3', 'tmarkiew', 'jepi', 'mgratows', 'grfedele', 'liannaldo007', 'phamleminhthong', 'ggmorrow', 's.bikash', 'llsloan55555', 'asadncepc', 'cjmichae', 'asasa', 'kjfrank2', 'davisloen', 'maymephilbrick', 'sayanr', 'shamilt3', 'msross', 'saurabhchem09', 'aapfel', 'pdstaubl', None, 'eescudermilian', 'healyjl', 'yzhou91', 'rexkhan', 'bebling', 'yhu55', 'zhixin2', 'dmcpher', 'saxman25']"
5,70,113,127,29,"['sfgdfgdfg', 'kellhages37', 'white519', 'nmcphero', 'tylera2104', 'ckroger', 'kamranahmed', 'fahimvora12', 'swift8', 'draosmail', 'jacob_just', 'agarw105', 'akreilein', 'royriveraf', 'jacobpeterson698', 'rkwiatko', 'hanmoyuan1997', 'wdrummon', 'greid09', 'wallac68', 'spring12', 'sammyknecht', 'hannahdeboer0015', 'kewlkahtz', 'batram197', 'bradsmrdel', 'aboza', 'k.ico246', 'ikstealth']",83,"['luisafuentes19', 'premkhot5', 'haroonnishat27', 'evyn_routh', 'josephel534', 'sandeep4442', 'memoir56', 'davidgraham357', 'pgarciav', 'mbsmith18', 'drnnmurty', 'bilvin', 'sophivcool', 'champauzas', 'dbbt2015', 'saiadityav', 'lucasrodriguez', 'f2016588', 'rquardok1', 'bendavaji', 'rashida31', 'ext2a96', 'akriti', 'nowshinsharmily', 'bubleedas06', 'reshmithomas', 'liamarasta', 'danielpc76', 'iqrosaura', 'kkripaka', 'sharmarahul1597', 'libardo11chapal', 'groy56450', 'festum01', 'aniver', 'jolene2', 'eddierules001', 'limasallesdesouza', 'sasapu', 'kapoor1439', 'nkpuga', 'arran.yuan', 'ja.burgos', 'geravilla', 'raofthesun', 'paarthparekh2824', 'libin17', 'aswinshaji', 'arnoudonnink', 'rtsaimail', 'savannahlutz', 'ananddrishyam', 'ashishkanojia50', 'adungey2', 'trevinon', 'sai.234', 'dakshi88', 'fenixarn7', 'ichouqm', 'cnichol', 'dokekearu', 'richardfanchina', 'stewa263', 'gideon01', 'k38f273', 'evd15i019', 'miqdadraza', 'hattan.abuzaid', 'iseguano28', 'lfeltner', 'maddiexox25', 'askrobis', 'wbaioni40', 'richardzhang', 'amnaya', 'tasnim19', 'bgh6', 'esoar2000', 'ssbasim', 'ayushkr997', 'camilopereztovar', 'jnewman0', 'michaelkraft1512']",98,"['btestin14', 'ryan.wiebe', 'nt230', 'wstolz', 'itsmemario', 'afalkenb', 'tgiazzon', 'jkekre', 'mcrees', 'psumner', 'buck17', 'sueprasad8214', 'cputt', 'amckeska', 'mcclurez', 'alyssamcnarney', 'shaunak0304', 'anthonm', 'hkohart', 'dgreiwe', 'jstalbaum', 'rishiprasadha', 'akonopa', 'hess35', 'crhodine', 'tilley0', 'mingusnate', 'kjh94425', 'rice103', 'dodge4', 'mcclure8', 'nikhilcarneiro4', 'hkaakeh', 'kkamiya', 'herr13', 'nggoodie98', 'rsusler', 'imran3', 'brandt18', 'vcotta', 'goh5', 'singh378', 'rileyedelaney', 'akreuter', 'osborn45', 'suhaira97', 'ksjolund', 'john1886', 'cmelchin', 'charlesma423', 'george7elias', 'ryanwest1040', 'rjleach', 'boninim', 'cclapham', 'fischermben', 'landon.glunt', 'ebergqu', 'davi1004', 'nathanmoore', 'angbecker', 'ebehring', 'treyfinn98', 'canadaman87', 'mishra59', 'snowh5696', 'cartmaster007', 'baker428', 'munselltom', 'chiranth7954', 'htorsina', 'jwoon', 'shadow66666', 'ehonebri', 'talon34567', 'jacobglvn', 'agalema1027', 'jfolkers', 'joshuajkporter', 'rachel318318', 'suran9712', 'oliver67', 'asartor', 'jswetlik', 'maxwellfra16', 'garret28', 'cameronfritts12', 'kruege14', 'dkilgor', 'kknowlto', 'jskeens', 'acostab', 'jklaben', 'kevinodonnell0878', 'lmeehann', 'mccaul', 'yhoashi', 'rao53']",210,"['luisafuentes19', 'premkhot5', 'haroonnishat27', 'evyn_routh', 'tylera2104', 'btestin14', 'josephel534', 'jacob_just', 'ryan.wiebe', 'nt230', 'sandeep4442', 'agarw105', 'wstolz', 'itsmemario', 'afalkenb', 'tgiazzon', 'memoir56', 'rkwiatko', 'jkekre', 'mcrees', 'psumner', 'buck17', 'davidgraham357', 'pgarciav', 'mbsmith18', 'drnnmurty', 'sammyknecht', 'sueprasad8214', 'hannahdeboer0015', 'sophivcool', 'bilvin', 'cputt', 'amckeska', 'mcclurez', 'alyssamcnarney', 'champauzas', 'dbbt2015', 'saiadityav', 'lucasrodriguez', 'shaunak0304', 'anthonm', 'hkohart', 'dgreiwe', 'sfgdfgdfg', 'jstalbaum', 'f2016588', 'rquardok1', 'fahimvora12', 'rishiprasadha', 'bendavaji', 'rashida31', 'swift8', 'ext2a96', 'draosmail', 'akonopa', 'akriti', 'nowshinsharmily', 'bubleedas06', 'hess35', 'reshmithomas', 'liamarasta', 'crhodine', 'tilley0', 'danielpc76', 'mingusnate', 'kjh94425', 'rice103', 'iqrosaura', 'dodge4', 'kkripaka', 'sharmarahul1597', 'libardo11chapal', 'mcclure8', 'nikhilcarneiro4', 'hkaakeh', 'kkamiya', 'groy56450', 'herr13', 'festum01', 'aniver', 'nggoodie98', 'jolene2', 'rsusler', 'eddierules001', 'limasallesdesouza', 'sasapu', 'imran3', 'batram197', 'kapoor1439', 'brandt18', 'nkpuga', 'bradsmrdel', 'vcotta', 'goh5', 'arran.yuan', 'ja.burgos', 'singh378', 'rileyedelaney', 'geravilla', 'raofthesun', 'paarthparekh2824', 'libin17', 'aswinshaji', 'arnoudonnink', 'rtsaimail', 'akreuter', 'savannahlutz', 'ananddrishyam', 'ashishkanojia50', 'kamranahmed', 'osborn45', 'suhaira97', 'akreilein', 'ksjolund', 'adungey2', 'john1886', 'trevinon', 'sai.234', 'cmelchin', 'charlesma423', 'ryanwest1040', 'george7elias', 'rjleach', 'boninim', 'cclapham', 'dakshi88', 'fischermben', 'fenixarn7', 'greid09', 'spring12', 'landon.glunt', 'ebergqu', 'davi1004', 'nathanmoore', 'angbecker', 'kewlkahtz', 'ebehring', 'treyfinn98', 'canadaman87', 'mishra59', 'aboza', 'snowh5696', 'cartmaster007', 'baker428', 'ichouqm', 'munselltom', 'cnichol', 'ikstealth', 'chiranth7954', 'dokekearu', 'htorsina', 'richardfanchina', 'jwoon', 'kellhages37', 'white519', 'nmcphero', 'stewa263', 'ckroger', 'shadow66666', 'ehonebri', 'talon34567', 'gideon01', 'jacobglvn', 'agalema1027', 'jfolkers', 'k38f273', 'joshuajkporter', 'evd15i019', 'rachel318318', 'suran9712', 'oliver67', 'asartor', 'miqdadraza', 'hattan.abuzaid', 'royriveraf', 'jacobpeterson698', 'iseguano28', 'lfeltner', 'hanmoyuan1997', 'wdrummon', 'askrobis', 'wbaioni40', 'maddiexox25', 'jswetlik', 'richardzhang', 'garret28', 'maxwellfra16', 'wallac68', 'cameronfritts12', 'kruege14', 'dkilgor', 'amnaya', 'tasnim19', 'bgh6', 'kknowlto', 'esoar2000', 'jskeens', 'acostab', 'jklaben', 'kevinodonnell0878', 'lmeehann', 'mccaul', 'k.ico246', 'ssbasim', 'ayushkr997', 'yhoashi', 'camilopereztovar', 'rao53', 'jnewman0', 'michaelkraft1512']"
5,72,113,34,7,"['luisafuentes19', 'libardo11chapal', 'danielpc76', 'camilopereztovar', 'ja.burgos', 'sophivcool', 'fenixarn7']",105,"['premkhot5', 'haroonnishat27', 'evyn_routh', 'tylera2104', 'josephel534', 'jacob_just', 'sandeep4442', 'agarw105', 'memoir56', 'rkwiatko', 'davidgraham357', 'pgarciav', 'mbsmith18', 'drnnmurty', 'sammyknecht', 'hannahdeboer0015', 'bilvin', 'champauzas', 'dbbt2015', 'saiadityav', 'lucasrodriguez', 'sfgdfgdfg', 'f2016588', 'rquardok1', 'fahimvora12', 'bendavaji', 'rashida31', 'swift8', 'ext2a96', 'draosmail', 'akriti', 'nowshinsharmily', 'bubleedas06', 'reshmithomas', 'liamarasta', 'iqrosaura', 'kkripaka', 'sharmarahul1597', 'groy56450', 'festum01', 'aniver', 'jolene2', 'eddierules001', 'limasallesdesouza', 'sasapu', 'batram197', 'kapoor1439', 'nkpuga', 'bradsmrdel', 'arran.yuan', 'geravilla', 'raofthesun', 'paarthparekh2824', 'libin17', 'aswinshaji', 'arnoudonnink', 'rtsaimail', 'savannahlutz', 'ananddrishyam', 'ashishkanojia50', 'kamranahmed', 'akreilein', 'adungey2', 'trevinon', 'sai.234', 'dakshi88', 'greid09', 'spring12', 'kewlkahtz', 'aboza', 'ichouqm', 'cnichol', 'ikstealth', 'dokekearu', 'richardfanchina', 'kellhages37', 'white519', 'nmcphero', 'stewa263', 'ckroger', 'gideon01', 'k38f273', 'evd15i019', 'miqdadraza', 'hattan.abuzaid', 'royriveraf', 'jacobpeterson698', 'iseguano28', 'lfeltner', 'hanmoyuan1997', 'wdrummon', 'askrobis', 'wbaioni40', 'maddiexox25', 'richardzhang', 'wallac68', 'amnaya', 'tasnim19', 'bgh6', 'esoar2000', 'k.ico246', 'ssbasim', 'ayushkr997', 'jnewman0', 'michaelkraft1512']",27,"['danrako', 'jhon', 'sn.vargas', 'anfedepe', 'al.indavid10', 'jasonvazdel', 'jpnaranjo20', 'gabrielrueda99', 'mafeflorian7', 'yafarsolano', 'andresvm', 'jhonseebb', 'nlozano611', 'alvaro22martelo', 'jcac0908', 'juandavrp', 'ale_1201', 'isabellasalgadopin', None, 'jcbuitragoa1', 'josemajaramilloh', 'michaelj00', 'dr.sabogal', 'dhcomas', 'salomon.ulloque', 'vilmistirado', 'juliana9927']",139,"['luisafuentes19', 'paarthparekh2824', 'libin17', 'premkhot5', 'haroonnishat27', 'aswinshaji', 'arnoudonnink', 'evyn_routh', 'rtsaimail', 'danrako', 'tylera2104', 'savannahlutz', 'ananddrishyam', 'jhon', 'ashishkanojia50', 'kamranahmed', 'sn.vargas', 'josephel534', 'jacob_just', 'al.indavid10', 'sandeep4442', 'agarw105', 'akreilein', 'jasonvazdel', 'jpnaranjo20', 'gabrielrueda99', 'adungey2', 'trevinon', 'sai.234', 'memoir56', 'rkwiatko', 'dakshi88', 'andresvm', 'fenixarn7', 'greid09', 'jhonseebb', 'spring12', 'nlozano611', 'alvaro22martelo', 'davidgraham357', 'pgarciav', 'mbsmith18', 'drnnmurty', 'sammyknecht', 'hannahdeboer0015', 'sophivcool', 'bilvin', 'kewlkahtz', 'michaelj00', 'josemajaramilloh', 'aboza', 'champauzas', 'salomon.ulloque', 'dbbt2015', 'ichouqm', 'saiadityav', 'lucasrodriguez', 'cnichol', 'ikstealth', 'vilmistirado', 'mafeflorian7', 'dokekearu', 'juliana9927', 'richardfanchina', 'sfgdfgdfg', 'kellhages37', 'white519', 'nmcphero', 'jnewman0', 'f2016588', 'stewa263', 'ckroger', 'rquardok1', 'fahimvora12', 'gideon01', 'anfedepe', 'bendavaji', 'rashida31', 'swift8', 'ext2a96', 'draosmail', 'k38f273', 'evd15i019', 'akriti', 'nowshinsharmily', 'bubleedas06', 'yafarsolano', 'reshmithomas', 'liamarasta', 'miqdadraza', 'hattan.abuzaid', 'danielpc76', 'royriveraf', 'iqrosaura', 'jacobpeterson698', 'kkripaka', 'iseguano28', 'sharmarahul1597', 'lfeltner', 'hanmoyuan1997', 'libardo11chapal', 'wdrummon', 'askrobis', 'wbaioni40', 'maddiexox25', 'richardzhang', 'wallac68', 'groy56450', 'amnaya', 'tasnim19', 'jcac0908', 'bgh6', 'festum01', 'aniver', 'juandavrp', 'jolene2', 'ale_1201', 'isabellasalgadopin', 'eddierules001', 'limasallesdesouza', 'sasapu', 'batram197', 'kapoor1439', 'esoar2000', None, 'jcbuitragoa1', 'nkpuga', 'bradsmrdel', 'dr.sabogal', 'dhcomas', 'k.ico246', 'ssbasim', 'ayushkr997', 'arran.yuan', 'camilopereztovar', 'ja.burgos', 'michaelkraft1512', 'geravilla', 'raofthesun']"
5,75,113,20,1,['ext2a96'],111,"['luisafuentes19', 'paarthparekh2824', 'libin17', 'premkhot5', 'haroonnishat27', 'aswinshaji', 'arnoudonnink', 'evyn_routh', 'rtsaimail', 'tylera2104', 'savannahlutz', 'ananddrishyam', 'ashishkanojia50', 'kamranahmed', 'josephel534', 'jacob_just', 'sandeep4442', 'agarw105', 'akreilein', 'adungey2', 'trevinon', 'sai.234', 'memoir56', 'rkwiatko', 'dakshi88', 'fenixarn7', 'greid09', 'spring12', 'davidgraham357', 'pgarciav', 'mbsmith18', 'drnnmurty', 'sammyknecht', 'hannahdeboer0015', 'sophivcool', 'bilvin', 'kewlkahtz', 'aboza', 'champauzas', 'dbbt2015', 'ichouqm', 'saiadityav', 'lucasrodriguez', 'cnichol', 'ikstealth', 'dokekearu', 'richardfanchina', 'sfgdfgdfg', 'kellhages37', 'white519', 'nmcphero', 'jnewman0', 'f2016588', 'stewa263', 'ckroger', 'rquardok1', 'fahimvora12', 'gideon01', 'bendavaji', 'rashida31', 'swift8', 'draosmail', 'k38f273', 'evd15i019', 'akriti', 'nowshinsharmily', 'bubleedas06', 'reshmithomas', 'liamarasta', 'miqdadraza', 'hattan.abuzaid', 'danielpc76', 'royriveraf', 'iqrosaura', 'jacobpeterson698', 'kkripaka', 'iseguano28', 'sharmarahul1597', 'lfeltner', 'hanmoyuan1997', 'libardo11chapal', 'wdrummon', 'askrobis', 'wbaioni40', 'maddiexox25', 'richardzhang', 'wallac68', 'groy56450', 'amnaya', 'tasnim19', 'bgh6', 'festum01', 'aniver', 'jolene2', 'eddierules001', 'limasallesdesouza', 'sasapu', 'batram197', 'kapoor1439', 'esoar2000', 'nkpuga', 'bradsmrdel', 'k.ico246', 'ssbasim', 'ayushkr997', 'arran.yuan', 'camilopereztovar', 'ja.burgos', 'michaelkraft1512', 'geravilla', 'raofthesun']",19,"['battulga9192', 'bymbaa6789', 'davaa.byambasuren14', 't.byambadorj0282', 'anar', 'munkherdene593', 'dshinwes', 'anudarid6', 'puujeeulzii2', 'sdeegiimaa', 'bat0407', None, 'g.munkherdene13', 'ulziibaatar0324', 'ss0249571', 'sumyafire1', 'ubatbilig99', 'gundalai2000', 'watashi.legion']",131,"['luisafuentes19', 'paarthparekh2824', 'libin17', 'premkhot5', 'haroonnishat27', 'aswinshaji', 'arnoudonnink', 'evyn_routh', 'rtsaimail', 'bymbaa6789', 'tylera2104', 'savannahlutz', 'ananddrishyam', 'ashishkanojia50', 'kamranahmed', 'josephel534', 'jacob_just', 'davaa.byambasuren14', 'sandeep4442', 'agarw105', 'akreilein', 't.byambadorj0282', 'anar', 'munkherdene593', 'adungey2', 'trevinon', 'sai.234', 'memoir56', 'rkwiatko', 'dakshi88', 'fenixarn7', 'greid09', 'anudarid6', 'spring12', 'sdeegiimaa', 'bat0407', 'davidgraham357', 'pgarciav', 'mbsmith18', 'drnnmurty', 'sammyknecht', 'gundalai2000', 'hannahdeboer0015', 'sophivcool', 'bilvin', 'kewlkahtz', 'g.munkherdene13', 'aboza', 'champauzas', 'dbbt2015', 'ubatbilig99', 'ichouqm', 'saiadityav', 'lucasrodriguez', 'cnichol', 'ikstealth', 'watashi.legion', 'dokekearu', 'richardfanchina', 'sfgdfgdfg', 'battulga9192', 'kellhages37', 'white519', 'nmcphero', 'jnewman0', 'f2016588', 'stewa263', 'ckroger', 'rquardok1', 'fahimvora12', 'gideon01', 'bendavaji', 'rashida31', 'swift8', 'ext2a96', 'draosmail', 'k38f273', 'evd15i019', 'akriti', 'nowshinsharmily', 'bubleedas06', 'dshinwes', 'reshmithomas', 'liamarasta', 'miqdadraza', 'hattan.abuzaid', 'danielpc76', 'royriveraf', 'iqrosaura', 'jacobpeterson698', 'kkripaka', 'iseguano28', 'sharmarahul1597', 'lfeltner', 'hanmoyuan1997', 'libardo11chapal', 'wdrummon', 'askrobis', 'wbaioni40', 'maddiexox25', 'richardzhang', 'wallac68', 'groy56450', 'puujeeulzii2', 'amnaya', 'tasnim19', 'bgh6', 'festum01', 'aniver', 'jolene2', 'eddierules001', 'limasallesdesouza', 'sasapu', 'batram197', 'kapoor1439', 'esoar2000', None, 'ulziibaatar0324', 'nkpuga', 'bradsmrdel', 'ss0249571', 'sumyafire1', 'k.ico246', 'ssbasim', 'ayushkr997', 'arran.yuan', 'camilopereztovar', 'ja.burgos', 'michaelkraft1512', 'geravilla', 'raofthesun']"
5,80,113,18,1,['ja.burgos'],111,"['luisafuentes19', 'paarthparekh2824', 'libin17', 'premkhot5', 'haroonnishat27', 'aswinshaji', 'arnoudonnink', 'evyn_routh', 'rtsaimail', 'tylera2104', 'savannahlutz', 'ananddrishyam', 'ashishkanojia50', 'kamranahmed', 'josephel534', 'jacob_just', 'sandeep4442', 'agarw105', 'akreilein', 'adungey2', 'trevinon', 'sai.234', 'memoir56', 'rkwiatko', 'dakshi88', 'fenixarn7', 'greid09', 'spring12', 'davidgraham357', 'pgarciav', 'mbsmith18', 'drnnmurty', 'sammyknecht', 'hannahdeboer0015', 'sophivcool', 'bilvin', 'kewlkahtz', 'aboza', 'champauzas', 'dbbt2015', 'ichouqm', 'saiadityav', 'lucasrodriguez', 'cnichol', 'ikstealth', 'dokekearu', 'richardfanchina', 'sfgdfgdfg', 'kellhages37', 'white519', 'nmcphero', 'jnewman0', 'f2016588', 'stewa263', 'ckroger', 'rquardok1', 'fahimvora12', 'gideon01', 'bendavaji', 'rashida31', 'swift8', 'ext2a96', 'draosmail', 'k38f273', 'evd15i019', 'akriti', 'nowshinsharmily', 'bubleedas06', 'reshmithomas', 'liamarasta', 'miqdadraza', 'hattan.abuzaid', 'danielpc76', 'royriveraf', 'iqrosaura', 'jacobpeterson698', 'kkripaka', 'iseguano28', 'sharmarahul1597', 'lfeltner', 'hanmoyuan1997', 'libardo11chapal', 'wdrummon', 'askrobis', 'wbaioni40', 'maddiexox25', 'richardzhang', 'wallac68', 'groy56450', 'amnaya', 'tasnim19', 'bgh6', 'festum01', 'aniver', 'jolene2', 'eddierules001', 'limasallesdesouza', 'sasapu', 'batram197', 'kapoor1439', 'esoar2000', 'nkpuga', 'bradsmrdel', 'k.ico246', 'ssbasim', 'ayushkr997', 'arran.yuan', 'camilopereztovar', 'michaelkraft1512', 'geravilla', 'raofthesun']",17,"['michaelj00', 'josemajaramilloh', 'alejandra31g', 'jpnaranjo20', 'nlozano611', 'juanfecazuluaga', 'danrako', 'jcac0908', 'dhcomas', 'yafarsolano', 'juandavrp', 'ale_1201', 'ja.hernandezr1', 'andresvm', None, 'juliana9927', 'dard980311']",129,"['luisafuentes19', 'paarthparekh2824', 'libin17', 'premkhot5', 'haroonnishat27', 'aswinshaji', 'arnoudonnink', 'evyn_routh', 'rtsaimail', 'juanfecazuluaga', 'tylera2104', 'savannahlutz', 'ananddrishyam', 'danrako', 'ashishkanojia50', 'kamranahmed', 'josephel534', 'jacob_just', 'sandeep4442', 'agarw105', 'akreilein', 'jpnaranjo20', 'adungey2', 'trevinon', 'sai.234', 'ja.hernandezr1', 'memoir56', 'rkwiatko', 'dakshi88', 'andresvm', 'fenixarn7', 'greid09', 'alejandra31g', 'spring12', 'nlozano611', 'davidgraham357', 'pgarciav', 'mbsmith18', 'drnnmurty', 'sammyknecht', 'hannahdeboer0015', 'sophivcool', 'bilvin', 'kewlkahtz', 'michaelj00', 'josemajaramilloh', 'aboza', 'champauzas', 'dbbt2015', 'ichouqm', 'saiadityav', 'lucasrodriguez', 'cnichol', 'ikstealth', 'juliana9927', 'dokekearu', 'richardfanchina', 'sfgdfgdfg', 'kellhages37', 'white519', 'nmcphero', 'jnewman0', 'f2016588', 'stewa263', 'ckroger', 'rquardok1', 'fahimvora12', 'gideon01', 'bendavaji', 'rashida31', 'swift8', 'ext2a96', 'draosmail', 'k38f273', 'evd15i019', 'akriti', 'nowshinsharmily', 'bubleedas06', 'yafarsolano', 'reshmithomas', 'liamarasta', 'miqdadraza', 'hattan.abuzaid', 'danielpc76', 'royriveraf', 'iqrosaura', 'jacobpeterson698', 'kkripaka', 'iseguano28', 'sharmarahul1597', 'lfeltner', 'hanmoyuan1997', 'libardo11chapal', 'wdrummon', 'askrobis', 'wbaioni40', 'maddiexox25', 'richardzhang', 'wallac68', 'dard980311', 'groy56450', 'amnaya', 'tasnim19', 'jcac0908', 'bgh6', 'festum01', 'aniver', 'juandavrp', 'jolene2', 'ale_1201', 'eddierules001', 'limasallesdesouza', 'sasapu', 'batram197', 'kapoor1439', 'esoar2000', None, 'nkpuga', 'bradsmrdel', 'dhcomas', 'k.ico246', 'ssbasim', 'ayushkr997', 'arran.yuan', 'camilopereztovar', 'ja.burgos', 'michaelkraft1512', 'geravilla', 'raofthesun']"
5,71,113,15,1,['sasapu'],111,"['luisafuentes19', 'paarthparekh2824', 'libin17', 'premkhot5', 'haroonnishat27', 'aswinshaji', 'arnoudonnink', 'evyn_routh', 'rtsaimail', 'tylera2104', 'savannahlutz', 'ananddrishyam', 'ashishkanojia50', 'kamranahmed', 'josephel534', 'jacob_just', 'sandeep4442', 'agarw105', 'akreilein', 'adungey2', 'trevinon', 'sai.234', 'memoir56', 'rkwiatko', 'dakshi88', 'fenixarn7', 'greid09', 'spring12', 'davidgraham357', 'pgarciav', 'mbsmith18', 'drnnmurty', 'sammyknecht', 'hannahdeboer0015', 'sophivcool', 'bilvin', 'kewlkahtz', 'aboza', 'champauzas', 'dbbt2015', 'ichouqm', 'saiadityav', 'lucasrodriguez', 'cnichol', 'ikstealth', 'dokekearu', 'richardfanchina', 'sfgdfgdfg', 'kellhages37', 'white519', 'nmcphero', 'jnewman0', 'f2016588', 'stewa263', 'ckroger', 'rquardok1', 'fahimvora12', 'gideon01', 'bendavaji', 'rashida31', 'swift8', 'ext2a96', 'draosmail', 'k38f273', 'evd15i019', 'akriti', 'nowshinsharmily', 'bubleedas06', 'reshmithomas', 'liamarasta', 'miqdadraza', 'hattan.abuzaid', 'danielpc76', 'royriveraf', 'iqrosaura', 'jacobpeterson698', 'kkripaka', 'iseguano28', 'sharmarahul1597', 'lfeltner', 'hanmoyuan1997', 'libardo11chapal', 'wdrummon', 'askrobis', 'wbaioni40', 'maddiexox25', 'richardzhang', 'wallac68', 'groy56450', 'amnaya', 'tasnim19', 'bgh6', 'festum01', 'aniver', 'jolene2', 'eddierules001', 'limasallesdesouza', 'batram197', 'kapoor1439', 'esoar2000', 'nkpuga', 'bradsmrdel', 'k.ico246', 'ssbasim', 'ayushkr997', 'arran.yuan', 'camilopereztovar', 'ja.burgos', 'michaelkraft1512', 'geravilla', 'raofthesun']",14,"['matthewdonne141', 'pkulkarni', 'slamotte', 'rsepanek', 'fengsun', 'zwoods', 'jpweber', 'nshattuck', 'astam', 'nbonthala', 'nlochner', 'kgeorgadarel5', None, 'mbolognese']",126,"['luisafuentes19', 'paarthparekh2824', 'libin17', 'premkhot5', 'haroonnishat27', 'aswinshaji', 'arnoudonnink', 'evyn_routh', 'rtsaimail', 'tylera2104', 'savannahlutz', 'ananddrishyam', 'rsepanek', 'ashishkanojia50', 'kamranahmed', 'josephel534', 'jacob_just', 'sandeep4442', 'agarw105', 'akreilein', 'adungey2', 'trevinon', 'sai.234', 'memoir56', 'rkwiatko', 'dakshi88', 'fenixarn7', 'greid09', 'spring12', 'davidgraham357', 'pgarciav', 'mbsmith18', 'drnnmurty', 'sammyknecht', 'hannahdeboer0015', 'sophivcool', 'bilvin', 'kewlkahtz', 'matthewdonne141', 'aboza', 'champauzas', 'zwoods', 'dbbt2015', 'ichouqm', 'saiadityav', 'lucasrodriguez', 'cnichol', 'ikstealth', 'nbonthala', 'nlochner', 'dokekearu', 'richardfanchina', 'sfgdfgdfg', 'kellhages37', 'white519', 'nmcphero', 'jnewman0', 'f2016588', 'stewa263', 'ckroger', 'rquardok1', 'fahimvora12', 'gideon01', 'kgeorgadarel5', 'bendavaji', 'rashida31', 'swift8', 'ext2a96', 'draosmail', 'k38f273', 'evd15i019', 'akriti', 'nowshinsharmily', 'bubleedas06', 'reshmithomas', 'liamarasta', 'miqdadraza', 'jpweber', 'hattan.abuzaid', 'danielpc76', 'royriveraf', 'iqrosaura', 'jacobpeterson698', 'kkripaka', 'iseguano28', 'sharmarahul1597', 'lfeltner', 'hanmoyuan1997', 'libardo11chapal', 'wdrummon', 'askrobis', 'wbaioni40', 'maddiexox25', 'richardzhang', 'wallac68', 'groy56450', 'amnaya', 'tasnim19', 'pkulkarni', 'slamotte', 'bgh6', 'festum01', 'fengsun', 'aniver', 'jolene2', 'nshattuck', 'eddierules001', 'limasallesdesouza', 'sasapu', 'astam', 'batram197', 'kapoor1439', 'esoar2000', None, 'mbolognese', 'nkpuga', 'bradsmrdel', 'k.ico246', 'ssbasim', 'ayushkr997', 'arran.yuan', 'camilopereztovar', 'ja.burgos', 'michaelkraft1512', 'geravilla', 'raofthesun']"
5,68,113,13,1,['bubleedas06'],111,"['luisafuentes19', 'paarthparekh2824', 'libin17', 'premkhot5', 'haroonnishat27', 'aswinshaji', 'arnoudonnink', 'evyn_routh', 'rtsaimail', 'tylera2104', 'savannahlutz', 'ananddrishyam', 'ashishkanojia50', 'kamranahmed', 'josephel534', 'jacob_just', 'sandeep4442', 'agarw105', 'akreilein', 'adungey2', 'trevinon', 'sai.234', 'memoir56', 'rkwiatko', 'dakshi88', 'fenixarn7', 'greid09', 'spring12', 'davidgraham357', 'pgarciav', 'mbsmith18', 'drnnmurty', 'sammyknecht', 'hannahdeboer0015', 'sophivcool', 'bilvin', 'kewlkahtz', 'aboza', 'champauzas', 'dbbt2015', 'ichouqm', 'saiadityav', 'lucasrodriguez', 'cnichol', 'ikstealth', 'dokekearu', 'richardfanchina', 'sfgdfgdfg', 'kellhages37', 'white519', 'nmcphero', 'jnewman0', 'f2016588', 'stewa263', 'ckroger', 'rquardok1', 'fahimvora12', 'gideon01', 'bendavaji', 'rashida31', 'swift8', 'ext2a96', 'draosmail', 'k38f273', 'evd15i019', 'akriti', 'nowshinsharmily', 'reshmithomas', 'liamarasta', 'miqdadraza', 'hattan.abuzaid', 'danielpc76', 'royriveraf', 'iqrosaura', 'jacobpeterson698', 'kkripaka', 'iseguano28', 'sharmarahul1597', 'lfeltner', 'hanmoyuan1997', 'libardo11chapal', 'wdrummon', 'askrobis', 'wbaioni40', 'maddiexox25', 'richardzhang', 'wallac68', 'groy56450', 'amnaya', 'tasnim19', 'bgh6', 'festum01', 'aniver', 'jolene2', 'eddierules001', 'limasallesdesouza', 'sasapu', 'batram197', 'kapoor1439', 'esoar2000', 'nkpuga', 'bradsmrdel', 'k.ico246', 'ssbasim', 'ayushkr997', 'arran.yuan', 'camilopereztovar', 'ja.burgos', 'michaelkraft1512', 'geravilla', 'raofthesun']",12,"['mazharulislamshuvosikder', 'fahim78645', None, 'kabirsinthi', 'johayraprithula', 'misbah3229', 'akazad42801', 'mahi97', 'farhana14eshal', 'abirmamunurrahman', 'rivnatmihaf', 'tahsin2239']",124,"['luisafuentes19', 'paarthparekh2824', 'libin17', 'mazharulislamshuvosikder', 'premkhot5', 'haroonnishat27', 'aswinshaji', 'arnoudonnink', 'evyn_routh', 'rtsaimail', 'tylera2104', 'savannahlutz', 'ananddrishyam', 'ashishkanojia50', 'kamranahmed', 'johayraprithula', 'misbah3229', 'akazad42801', 'josephel534', 'jacob_just', 'sandeep4442', 'agarw105', 'akreilein', 'adungey2', 'trevinon', 'sai.234', 'memoir56', 'rkwiatko', 'dakshi88', 'rivnatmihaf', 'fenixarn7', 'greid09', 'spring12', 'kabirsinthi', 'davidgraham357', 'pgarciav', 'mbsmith18', 'drnnmurty', 'sammyknecht', 'hannahdeboer0015', 'sophivcool', 'bilvin', 'kewlkahtz', 'aboza', 'champauzas', 'dbbt2015', 'ichouqm', 'saiadityav', 'lucasrodriguez', 'cnichol', 'ikstealth', 'farhana14eshal', 'abirmamunurrahman', 'dokekearu', 'richardfanchina', 'sfgdfgdfg', 'kellhages37', 'white519', 'nmcphero', 'jnewman0', 'f2016588', 'fahim78645', 'stewa263', 'ckroger', 'rquardok1', 'fahimvora12', 'gideon01', 'bendavaji', 'rashida31', 'swift8', 'ext2a96', 'draosmail', 'k38f273', 'evd15i019', 'akriti', 'nowshinsharmily', 'bubleedas06', 'reshmithomas', 'liamarasta', 'miqdadraza', 'hattan.abuzaid', 'danielpc76', 'royriveraf', 'iqrosaura', 'jacobpeterson698', 'kkripaka', 'iseguano28', 'sharmarahul1597', 'lfeltner', 'hanmoyuan1997', 'libardo11chapal', 'wdrummon', 'askrobis', 'wbaioni40', 'maddiexox25', 'richardzhang', 'wallac68', 'tahsin2239', 'groy56450', 'amnaya', 'tasnim19', 'bgh6', 'festum01', 'aniver', 'jolene2', 'eddierules001', 'limasallesdesouza', 'sasapu', 'mahi97', 'batram197', 'kapoor1439', 'esoar2000', None, 'nkpuga', 'bradsmrdel', 'k.ico246', 'ssbasim', 'ayushkr997', 'arran.yuan', 'camilopereztovar', 'ja.burgos', 'michaelkraft1512', 'geravilla', 'raofthesun']"
6,160,76,70,67,"['karafong', 'tangyf', 'zjc710696154', 'acrutt', 'sarahywang', 'dogancansari1', 'jordanphillipburns', 'jimin_kim', 'jiwenbo', 'nisarg_barot', 'cestellos_blanco', 'justinxzhong', 'mattmcd1', 'liuzhenghao', 'aaronschwartz77', 'xinya_niu', 'normanzy98', 'ouyangce', 'zijiancai', 'sun314618', 'jordanpburns13', 'ymengmandy', 'wangshu16', 'zhuokaix', 'zjadidi', 'zengguobo', 'bengisu.sari', 'xiaoxi_huang', 'yuxl0722', 'jdagdelen', 'kfctoday1121', 'djay_kamat', 'lichenwang993', 'fxxku', 'yxy960524', 'lym7820', 'jinhua96', 'ellisrae', 'evargo', 'wyz', 'nwinner', 'abruefach', 'rundongli', 'cbcb512', 'ariannamaj', 'mpsherb', 'caglar.tamur', 'ryanzhang', 'chemnius1', 'yuchen0418', 'qixi_chen', 'paulceralde', 'chris_shan', 'yingzhi_sun', 'pceralde', 'samir.hossainy', 'mariacfolg', 'clarissa', 'luyaozhang420', 'dogancansari', 'jenniferdonohue', 'wuxinchun', 'alvinakam', 'zhongpc', 'zhengyanlun', 'msiron', 'xiaozhao']",8,"['rcm2184', 'jtvardner', 'jianzhou', 'km3400', 'dgl2126', 'afa2117', 'espottesmith', 'edjiang']",3,"['lrd19990503', None, 'tonyli']",78,"['karafong', 'tangyf', 'jtvardner', 'sarahywang', 'dogancansari1', 'jordanphillipburns', 'jiwenbo', 'nisarg_barot', 'cestellos_blanco', 'mattmcd1', 'liuzhenghao', 'espottesmith', 'ouyangce', 'sun314618', 'jordanpburns13', 'ymengmandy', 'wangshu16', 'zhuokaix', 'zjadidi', 'bengisu.sari', 'yuxl0722', 'kfctoday1121', 'lichenwang993', 'yxy960524', 'lym7820', 'jinhua96', 'ellisrae', 'jianzhou', 'km3400', 'abruefach', 'nwinner', 'cbcb512', 'ariannamaj', 'ryanzhang', 'caglar.tamur', 'chemnius1', 'yuchen0418', 'qixi_chen', 'yingzhi_sun', 'mariacfolg', 'luyaozhang420', 'dogancansari', 'jenniferdonohue', 'alvinakam', 'lrd19990503', 'tonyli', 'dgl2126', 'msiron', 'zjc710696154', 'acrutt', 'jimin_kim', 'justinxzhong', 'aaronschwartz77', 'normanzy98', 'xinya_niu', 'zijiancai', 'zengguobo', 'xiaoxi_huang', 'afa2117', 'jdagdelen', 'edjiang', 'djay_kamat', 'fxxku', 'evargo', 'wyz', 'rundongli', 'mpsherb', None, 'paulceralde', 'rcm2184', 'chris_shan', 'samir.hossainy', 'pceralde', 'clarissa', 'wuxinchun', 'zhongpc', 'zhengyanlun', 'xiaozhao']"
6,161,76,10,8,"['rcm2184', 'jtvardner', 'jianzhou', 'km3400', 'dgl2126', 'afa2117', 'espottesmith', 'edjiang']",67,"['karafong', 'tangyf', 'sarahywang', 'dogancansari1', 'jordanphillipburns', 'jiwenbo', 'nisarg_barot', 'cestellos_blanco', 'mattmcd1', 'liuzhenghao', 'ouyangce', 'sun314618', 'jordanpburns13', 'ymengmandy', 'wangshu16', 'zhuokaix', 'zjadidi', 'bengisu.sari', 'yuxl0722', 'kfctoday1121', 'lichenwang993', 'yxy960524', 'lym7820', 'jinhua96', 'ellisrae', 'abruefach', 'nwinner', 'cbcb512', 'ariannamaj', 'ryanzhang', 'caglar.tamur', 'chemnius1', 'yuchen0418', 'qixi_chen', 'yingzhi_sun', 'mariacfolg', 'luyaozhang420', 'dogancansari', 'jenniferdonohue', 'alvinakam', 'msiron', 'zjc710696154', 'acrutt', 'jimin_kim', 'justinxzhong', 'aaronschwartz77', 'normanzy98', 'xinya_niu', 'zijiancai', 'zengguobo', 'xiaoxi_huang', 'jdagdelen', 'djay_kamat', 'fxxku', 'evargo', 'wyz', 'rundongli', 'mpsherb', 'paulceralde', 'chris_shan', 'samir.hossainy', 'pceralde', 'clarissa', 'wuxinchun', 'zhongpc', 'zhengyanlun', 'xiaozhao']",2,"['aurban', None]",77,"['karafong', 'tangyf', 'jtvardner', 'sarahywang', 'dogancansari1', 'jordanphillipburns', 'jiwenbo', 'nisarg_barot', 'cestellos_blanco', 'mattmcd1', 'liuzhenghao', 'espottesmith', 'ouyangce', 'sun314618', 'jordanpburns13', 'ymengmandy', 'wangshu16', 'zhuokaix', 'zjadidi', 'bengisu.sari', 'yuxl0722', 'kfctoday1121', 'lichenwang993', 'yxy960524', 'lym7820', 'jinhua96', 'ellisrae', 'jianzhou', 'km3400', 'abruefach', 'nwinner', 'cbcb512', 'ariannamaj', 'ryanzhang', 'caglar.tamur', 'chemnius1', 'yuchen0418', 'qixi_chen', 'yingzhi_sun', 'mariacfolg', 'luyaozhang420', 'dogancansari', 'jenniferdonohue', 'alvinakam', 'dgl2126', 'msiron', 'zjc710696154', 'acrutt', 'jimin_kim', 'justinxzhong', 'aaronschwartz77', 'normanzy98', 'xinya_niu', 'zijiancai', 'zengguobo', 'xiaoxi_huang', 'afa2117', 'jdagdelen', 'edjiang', 'djay_kamat', 'fxxku', 'evargo', 'wyz', 'rundongli', 'mpsherb', None, 'paulceralde', 'rcm2184', 'chris_shan', 'samir.hossainy', 'pceralde', 'clarissa', 'wuxinchun', 'zhongpc', 'aurban', 'zhengyanlun', 'xiaozhao']"
6,162,76,8,7,"['rcm2184', 'jtvardner', 'jianzhou', 'km3400', 'afa2117', 'espottesmith', 'edjiang']",68,"['karafong', 'tangyf', 'sarahywang', 'dogancansari1', 'jordanphillipburns', 'jiwenbo', 'nisarg_barot', 'cestellos_blanco', 'mattmcd1', 'liuzhenghao', 'ouyangce', 'sun314618', 'jordanpburns13', 'ymengmandy', 'wangshu16', 'zhuokaix', 'zjadidi', 'bengisu.sari', 'yuxl0722', 'kfctoday1121', 'lichenwang993', 'yxy960524', 'lym7820', 'jinhua96', 'ellisrae', 'abruefach', 'nwinner', 'cbcb512', 'ariannamaj', 'ryanzhang', 'caglar.tamur', 'chemnius1', 'yuchen0418', 'qixi_chen', 'yingzhi_sun', 'mariacfolg', 'luyaozhang420', 'dogancansari', 'jenniferdonohue', 'alvinakam', 'dgl2126', 'msiron', 'zjc710696154', 'acrutt', 'jimin_kim', 'justinxzhong', 'aaronschwartz77', 'normanzy98', 'xinya_niu', 'zijiancai', 'zengguobo', 'xiaoxi_huang', 'jdagdelen', 'djay_kamat', 'fxxku', 'evargo', 'wyz', 'rundongli', 'mpsherb', 'paulceralde', 'chris_shan', 'samir.hossainy', 'pceralde', 'clarissa', 'wuxinchun', 'zhongpc', 'zhengyanlun', 'xiaozhao']",1,[None],76,"['karafong', 'tangyf', 'jtvardner', 'sarahywang', 'dogancansari1', 'jordanphillipburns', 'jiwenbo', 'nisarg_barot', 'cestellos_blanco', 'mattmcd1', 'liuzhenghao', 'espottesmith', 'ouyangce', 'sun314618', 'jordanpburns13', 'ymengmandy', 'wangshu16', 'zhuokaix', 'zjadidi', 'bengisu.sari', 'yuxl0722', 'kfctoday1121', 'lichenwang993', 'yxy960524', 'lym7820', 'jinhua96', 'ellisrae', 'jianzhou', 'km3400', 'abruefach', 'nwinner', 'cbcb512', 'ariannamaj', 'ryanzhang', 'caglar.tamur', 'chemnius1', 'yuchen0418', 'qixi_chen', 'yingzhi_sun', 'mariacfolg', 'luyaozhang420', 'dogancansari', 'jenniferdonohue', 'alvinakam', 'dgl2126', 'msiron', 'zjc710696154', 'acrutt', 'jimin_kim', 'justinxzhong', 'aaronschwartz77', 'normanzy98', 'xinya_niu', 'zijiancai', 'zengguobo', 'xiaoxi_huang', 'afa2117', 'jdagdelen', 'edjiang', 'djay_kamat', 'fxxku', 'evargo', 'wyz', 'rundongli', 'mpsherb', None, 'paulceralde', 'rcm2184', 'chris_shan', 'samir.hossainy', 'pceralde', 'clarissa', 'wuxinchun', 'zhongpc', 'zhengyanlun', 'xiaozhao']"
7,159,70,70,64,"['miguelangelgv', 'pablolgoso', 'claaudiaalvarez2', 'robee97', 'hikaru', 'ancap', 'nanopablo', 'josebruq', 'pedrojjs97', 'josesoto', 'ionemanuelmoralesrosales', 'albertodellop', 'adavidsubires', 'belen.moralesvega', 'gonzalogbb', 'fabhuecas9', 'cristinitaa23', 'lluis', 'lauramaz', 'eletorres', 'jmleyva', 'franciscojaviern1997', 'aloptor97', 'juanalejandro.delatorre.gonzalez', 'alberto_leon_cecilla', 'crisalle', 'isabellopezcasas', 'nachoagrela', 'davidgruano', 'pedromf', 'lucigd96', 'guidoah', 'carlosbarbero', 'fernandodiaz', 'rafaelleon', 'lamberto', 'carmengomezh16', 'jpnaviog', 'joseantoniocuestareina', 'mariadelman96', 'javier7', 'theresa5000', 'jesusestevez', 'mozom96', 'rokitocri', 'joaquinhernandez', 'kiarahervella', 'tatifersanchez', 'adrisantan25', 'enrique97', 'espi', 'karlosjusus', 'ricardodavid', 'danielserrano', 'juanfran', 'eduardito', 'jaigro97', 'ruben29', 'raulghuelma', 'mariatirado', 'adiaz97', 'malena23', 'mariofnavarro', 'paloma95']",5,"['juaniandujar', 'carloscarac', 'amontesplaza', 'christian71291mercado', 'abignu']",6,"['mcdyre', 'jotaeneeme', 'nanojuanjo', 'ghostcodmw2', 'inmatt', None]",75,"['miguelangelgv', 'hikaru', 'ancap', 'nanopablo', 'josebruq', 'ionemanuelmoralesrosales', 'adavidsubires', 'gonzalogbb', 'fabhuecas9', 'cristinitaa23', 'inmatt', 'lluis', 'lauramaz', 'eletorres', 'franciscojaviern1997', 'aloptor97', 'juanalejandro.delatorre.gonzalez', 'crisalle', 'isabellopezcasas', 'davidgruano', 'pedromf', 'lamberto', 'carmengomezh16', 'juaniandujar', 'carloscarac', 'joseantoniocuestareina', 'javier7', 'theresa5000', 'jesusestevez', 'rokitocri', 'joaquinhernandez', 'kiarahervella', 'espi', 'karlosjusus', 'danielserrano', 'eduardito', 'ruben29', 'raulghuelma', 'amontesplaza', 'adiaz97', 'malena23', 'mariofnavarro', 'claaudiaalvarez2', 'juanfran', 'pablolgoso', 'robee97', 'pedrojjs97', 'josesoto', 'albertodellop', 'belen.moralesvega', 'jotaeneeme', 'nanojuanjo', 'jmleyva', 'alberto_leon_cecilla', 'nachoagrela', 'lucigd96', 'guidoah', 'carlosbarbero', 'ghostcodmw2', 'fernandodiaz', 'rafaelleon', 'mcdyre', 'jpnaviog', 'mariadelman96', 'mozom96', 'tatifersanchez', 'adrisantan25', None, 'enrique97', 'ricardodavid', 'jaigro97', 'mariatirado', 'christian71291mercado', 'abignu', 'paloma95']"
7,158,70,69,58,"['miguelangelgv', 'pablolgoso', 'claaudiaalvarez2', 'robee97', 'hikaru', 'ancap', 'pedrojjs97', 'josesoto', 'ionemanuelmoralesrosales', 'albertodellop', 'adavidsubires', 'belen.moralesvega', 'gonzalogbb', 'fabhuecas9', 'cristinitaa23', 'lluis', 'lauramaz', 'eletorres', 'jmleyva', 'franciscojaviern1997', 'aloptor97', 'juanalejandro.delatorre.gonzalez', 'isabellopezcasas', 'crisalle', 'mariofnavarro', 'pedromf', 'davidgruano', 'guidoah', 'lucigd96', 'carlosbarbero', 'fernandodiaz', 'rafaelleon', 'lamberto', 'carmengomezh16', 'jpnaviog', 'juaniandujar', 'joseantoniocuestareina', 'mariadelman96', 'theresa5000', 'mozom96', 'rokitocri', 'kiarahervella', 'joaquinhernandez', 'tatifersanchez', 'enrique97', 'karlosjusus', 'espi', 'ricardodavid', 'danielserrano', 'eduardito', 'jaigro97', 'ruben29', 'amontesplaza', 'raulghuelma', 'mariatirado', 'adiaz97', 'abignu', 'juanfran']",11,"['nanopablo', 'alberto_leon_cecilla', 'josebruq', 'carloscarac', 'nachoagrela', 'javier7', 'christian71291mercado', 'jesusestevez', 'adrisantan25', 'malena23', 'paloma95']",11,"['marguiitar', 'luciag', 'mcdyre', 'pablitoelfantasma', None, 'antoniocaceres', 'jesusestevez1997', 'ramperrub', 'nanojuanjo', 'pablomartinhigueras', 'xandar']",80,"['miguelangelgv', 'marguiitar', 'hikaru', 'ancap', 'nanopablo', 'josebruq', 'ionemanuelmoralesrosales', 'adavidsubires', 'gonzalogbb', 'fabhuecas9', 'cristinitaa23', 'lluis', 'lauramaz', 'eletorres', 'luciag', 'franciscojaviern1997', 'aloptor97', 'juanalejandro.delatorre.gonzalez', 'crisalle', 'isabellopezcasas', 'davidgruano', 'pedromf', 'lamberto', 'carmengomezh16', 'juaniandujar', 'carloscarac', 'joseantoniocuestareina', 'javier7', 'theresa5000', 'jesusestevez', 'rokitocri', 'joaquinhernandez', 'kiarahervella', 'espi', 'karlosjusus', 'danielserrano', 'eduardito', 'ruben29', 'raulghuelma', 'amontesplaza', 'adiaz97', 'malena23', 'mariofnavarro', 'claaudiaalvarez2', 'juanfran', 'pablolgoso', 'robee97', 'pedrojjs97', 'josesoto', 'albertodellop', 'belen.moralesvega', 'nanojuanjo', 'jmleyva', 'pablitoelfantasma', 'alberto_leon_cecilla', 'nachoagrela', 'lucigd96', 'guidoah', 'carlosbarbero', 'fernandodiaz', 'pablomartinhigueras', 'rafaelleon', 'xandar', 'mcdyre', 'jpnaviog', 'mariadelman96', 'jesusestevez1997', 'mozom96', 'tatifersanchez', 'adrisantan25', None, 'enrique97', 'ricardodavid', 'jaigro97', 'mariatirado', 'christian71291mercado', 'antoniocaceres', 'ramperrub', 'abignu', 'paloma95']"
8,254,67,25,21,"['rkitchin', 'park736', 'jang144', 'oojedara', 'mhierlma', 'mckenz12', 'hharjono', 'jroar21', 'brand9', 'cmoneyro', 'kjbolek0826', 'ndonorio', 'novak35', 'haines18', 'cheng236', 'patel357', 'akirtley', 'sumamah', 'amaghare', 'smeriam', 'bird4']",45,"['singh509', 'wilso967', 'jpothula', 'ddelaure', 'jschuhle', 'rainswor', 'clark477', 'culver9', 'zthai', 'rralston', 'john2272', 'agrawa77', 'bjagielo', 'ekachel', 'nseiber', 'mgrande', 'deshmur', 'atramm', 'klieu', 'jdewavri', 'kalward', 'davendra', 'yaly', 'davis693', 'dcaples', 'shannah2014', 'amaheshw', 'mchmielo', 'jlebrun', 'tlemonds', 'pwhitmor', 'mfeitosa', 'seckart', 'jemcmill', 'nfantasi', 'sshivapr', 'kgarret', 'thewireddj', 'aardigo12', 'saltamim', 'smit3426', 'jcerimel', 'tverhoef', 'green248', 'meyer236']",4,"['cguarini', 'balasub9', None, 'jhartl']",70,"['rkitchin', 'ddelaure', 'jschuhle', 'rainswor', 'jang144', 'clark477', 'culver9', 'oojedara', 'zthai', 'balasub9', 'agrawa77', 'bjagielo', 'ekachel', 'nseiber', 'hharjono', 'mckenz12', 'mgrande', 'kalward', 'yaly', 'davis693', 'brand9', 'cmoneyro', 'dcaples', 'kjbolek0826', 'shannah2014', 'amaheshw', 'mchmielo', 'tlemonds', 'mfeitosa', 'cguarini', 'novak35', 'seckart', 'haines18', 'jemcmill', 'cheng236', 'patel357', 'sshivapr', 'kgarret', 'smit3426', 'smeriam', 'tverhoef', 'bird4', 'singh509', 'wilso967', 'jpothula', 'rralston', 'park736', 'john2272', 'mhierlma', 'jroar21', 'deshmur', 'atramm', 'klieu', 'jdewavri', 'davendra', 'jlebrun', 'ndonorio', 'pwhitmor', 'nfantasi', 'akirtley', 'thewireddj', 'aardigo12', None, 'sumamah', 'saltamim', 'jcerimel', 'amaghare', 'jhartl', 'green248', 'meyer236']"
8,255,67,12,11,"['singh509', 'wilso967', 'kalward', 'smit3426', 'culver9', 'john2272', 'dcaples', 'bjagielo', 'aardigo12', 'mchmielo', 'jlebrun']",55,"['rkitchin', 'ddelaure', 'jschuhle', 'rainswor', 'jang144', 'clark477', 'oojedara', 'zthai', 'agrawa77', 'ekachel', 'nseiber', 'hharjono', 'mckenz12', 'mgrande', 'yaly', 'davis693', 'brand9', 'cmoneyro', 'kjbolek0826', 'shannah2014', 'amaheshw', 'tlemonds', 'mfeitosa', 'novak35', 'seckart', 'haines18', 'jemcmill', 'cheng236', 'patel357', 'sshivapr', 'kgarret', 'smeriam', 'tverhoef', 'bird4', 'jpothula', 'rralston', 'park736', 'mhierlma', 'jroar21', 'deshmur', 'atramm', 'klieu', 'jdewavri', 'davendra', 'ndonorio', 'pwhitmor', 'nfantasi', 'akirtley', 'thewireddj', 'sumamah', 'saltamim', 'jcerimel', 'amaghare', 'green248', 'meyer236']",1,[None],67,"['rkitchin', 'ddelaure', 'jschuhle', 'rainswor', 'jang144', 'clark477', 'culver9', 'oojedara', 'zthai', 'agrawa77', 'bjagielo', 'ekachel', 'nseiber', 'hharjono', 'mckenz12', 'mgrande', 'kalward', 'yaly', 'davis693', 'brand9', 'cmoneyro', 'dcaples', 'kjbolek0826', 'shannah2014', 'amaheshw', 'mchmielo', 'tlemonds', 'mfeitosa', 'novak35', 'seckart', 'haines18', 'jemcmill', 'cheng236', 'patel357', 'sshivapr', 'kgarret', 'smit3426', 'smeriam', 'tverhoef', 'bird4', 'singh509', 'wilso967', 'jpothula', 'rralston', 'park736', 'john2272', 'mhierlma', 'jroar21', 'deshmur', 'atramm', 'klieu', 'jdewavri', 'davendra', 'jlebrun', 'ndonorio', 'pwhitmor', 'nfantasi', 'akirtley', 'thewireddj', 'aardigo12', None, 'sumamah', 'saltamim', 'jcerimel', 'amaghare', 'green248', 'meyer236']"
9,285,67,44,36,"['atamvaki', 'jboulayd', 'dast', 'sdhillo', 'hriddle', 'jtwaddle', 'zooks99', 'azalar', 'nfschadler', 'brenna13', 'myers283', 'vpatel', 'hali85', 'stewa207', 'jlueck', 'zyma', 'slagles', 'matthewguido', 'kole.mcginn', 'cole141', 'sgudeman', 'marcusgunyon', 'fmuehlem', 'knies0', 'ianbernander', 'krishn75', 'xie317', 'singh386', 'lin814', 'jmeneze', 'bfielde', 'mmulter', 'post10', 'batram', 'aharbin', 'jtonges']",30,"['dbai', 'soni12', 'bjendrus', 'aaryanp', 'pererak', 'jbarsima', 'sundara6', 'hardisura', 'ali85', 'wscottharding', 'rauche', 'spear1234', 'burnet19', 'cheeseballs99', 'haoyangliu', 'awassmer', 'cho160', 'ybommire', 'nschlei', 'ni45', 'mmoulin', 'klein61', 'kramer71', 'mmergent', 'anthonyjameskramer', 'vma2324', 'kim426', 'kswiatk9581', 'smit2805', 'danphoenix']",8,"['atkins18', 'marisol', 'kevinodonnell0878', 'afalkenb', 'blohithrao', 'kolispeter', None, 'rachel318318']",74,"['atamvaki', 'jboulayd', 'bjendrus', 'blohithrao', 'dast', 'aaryanp', 'sdhillo', 'jbarsima', 'hriddle', 'afalkenb', 'rauche', 'zooks99', 'myers283', 'vpatel', 'hali85', 'stewa207', 'jlueck', 'cheeseballs99', 'marisol', 'haoyangliu', 'zyma', 'matthewguido', 'ni45', 'mmoulin', 'kramer71', 'marcusgunyon', 'ianbernander', 'kim426', 'singh386', 'bfielde', 'post10', 'kolispeter', 'batram', 'smit2805', 'jtonges', 'slagles', 'dbai', 'soni12', 'pererak', 'rachel318318', 'sundara6', 'hardisura', 'ali85', 'wscottharding', 'jtwaddle', 'spear1234', 'azalar', 'nfschadler', 'brenna13', 'burnet19', 'awassmer', 'cho160', 'ybommire', 'kole.mcginn', 'nschlei', None, 'klein61', 'cole141', 'atkins18', 'sgudeman', 'kevinodonnell0878', 'mmergent', 'anthonyjameskramer', 'knies0', 'fmuehlem', 'vma2324', 'krishn75', 'xie317', 'kswiatk9581', 'lin814', 'jmeneze', 'mmulter', 'aharbin', 'danphoenix']"
9,286,67,40,33,"['jboulayd', 'bjendrus', 'dast', 'sdhillo', 'jbarsima', 'sundara6', 'ali85', 'hriddle', 'wscottharding', 'rauche', 'zooks99', 'azalar', 'nfschadler', 'myers283', 'stewa207', 'jlueck', 'cheeseballs99', 'zyma', 'awassmer', 'mmoulin', 'klein61', 'cole141', 'marcusgunyon', 'knies0', 'ianbernander', 'krishn75', 'xie317', 'kswiatk9581', 'bfielde', 'mmulter', 'post10', 'batram', 'aharbin']",33,"['atamvaki', 'dbai', 'soni12', 'aaryanp', 'pererak', 'hardisura', 'jtwaddle', 'spear1234', 'brenna13', 'vpatel', 'hali85', 'burnet19', 'haoyangliu', 'cho160', 'slagles', 'matthewguido', 'ybommire', 'kole.mcginn', 'nschlei', 'ni45', 'kramer71', 'sgudeman', 'mmergent', 'anthonyjameskramer', 'fmuehlem', 'vma2324', 'kim426', 'singh386', 'lin814', 'jmeneze', 'smit2805', 'danphoenix', 'jtonges']",7,"['ffrank', 'kevinodonnell0878', 'afalkenb', 'agalema1027', 'radhakr3', None, 'rachel318318']",73,"['atamvaki', 'jboulayd', 'bjendrus', 'dast', 'aaryanp', 'sdhillo', 'jbarsima', 'hriddle', 'afalkenb', 'rauche', 'zooks99', 'myers283', 'vpatel', 'hali85', 'stewa207', 'jlueck', 'cheeseballs99', 'haoyangliu', 'zyma', 'matthewguido', 'ni45', 'mmoulin', 'kramer71', 'marcusgunyon', 'ianbernander', 'kim426', 'singh386', 'bfielde', 'post10', 'batram', 'smit2805', 'jtonges', 'slagles', 'dbai', 'soni12', 'agalema1027', 'radhakr3', 'pererak', 'rachel318318', 'sundara6', 'hardisura', 'ali85', 'wscottharding', 'jtwaddle', 'spear1234', 'azalar', 'nfschadler', 'brenna13', 'burnet19', 'awassmer', 'cho160', 'ybommire', 'kole.mcginn', 'nschlei', None, 'klein61', 'ffrank', 'cole141', 'sgudeman', 'kevinodonnell0878', 'mmergent', 'anthonyjameskramer', 'knies0', 'fmuehlem', 'vma2324', 'krishn75', 'xie317', 'kswiatk9581', 'lin814', 'jmeneze', 'mmulter', 'aharbin', 'danphoenix']"
9,146,67,27,1,['ianbernander'],65,"['atamvaki', 'jboulayd', 'dbai', 'soni12', 'bjendrus', 'aaryanp', 'dast', 'sdhillo', 'pererak', 'jbarsima', 'sundara6', 'hardisura', 'ali85', 'hriddle', 'wscottharding', 'rauche', 'jtwaddle', 'zooks99', 'spear1234', 'azalar', 'nfschadler', 'brenna13', 'myers283', 'vpatel', 'hali85', 'stewa207', 'jlueck', 'burnet19', 'cheeseballs99', 'haoyangliu', 'zyma', 'awassmer', 'cho160', 'slagles', 'matthewguido', 'ybommire', 'kole.mcginn', 'nschlei', 'ni45', 'mmoulin', 'klein61', 'kramer71', 'cole141', 'sgudeman', 'marcusgunyon', 'mmergent', 'anthonyjameskramer', 'knies0', 'fmuehlem', 'vma2324', 'kim426', 'krishn75', 'singh386', 'xie317', 'kswiatk9581', 'lin814', 'jmeneze', 'bfielde', 'mmulter', 'post10', 'batram', 'aharbin', 'smit2805', 'danphoenix', 'jtonges']",26,"['psiripur', 'kswiatk', 'paulmather', 'peter496', 'ma130029', 'zhan1337', 'vkattaku', 'zhou646', 'kristiaan2017', 'alotaibi', 'unitas', 'mill1914', 'ian.strachan9', 'azadoks', 'alafzi', 'jverduzc', 'beck50', None, 'mandejan', 'dheeraj.peddireddy', 'atkins18', 'pkaundin', 'ddmckay', 'sabareesh169', 'abhivictor2', 'atunga']",92,"['atamvaki', 'jboulayd', 'kswiatk', 'paulmather', 'peter496', 'ma130029', 'bjendrus', 'dast', 'aaryanp', 'sdhillo', 'jbarsima', 'vkattaku', 'zhou646', 'hriddle', 'rauche', 'zooks99', 'myers283', 'vpatel', 'hali85', 'stewa207', 'jlueck', 'cheeseballs99', 'haoyangliu', 'zyma', 'matthewguido', 'ni45', 'mmoulin', 'kramer71', 'marcusgunyon', 'ianbernander', 'kim426', 'ddmckay', 'singh386', 'sabareesh169', 'bfielde', 'post10', 'batram', 'smit2805', 'abhivictor2', 'jtonges', 'slagles', 'psiripur', 'dbai', 'soni12', 'pererak', 'zhan1337', 'sundara6', 'hardisura', 'ali85', 'kristiaan2017', 'wscottharding', 'alotaibi', 'jtwaddle', 'spear1234', 'unitas', 'azalar', 'nfschadler', 'brenna13', 'mill1914', 'burnet19', 'ian.strachan9', 'awassmer', 'cho160', 'ybommire', 'kole.mcginn', 'azadoks', 'alafzi', 'jverduzc', 'nschlei', 'beck50', None, 'mandejan', 'klein61', 'dheeraj.peddireddy', 'cole141', 'atkins18', 'sgudeman', 'mmergent', 'anthonyjameskramer', 'knies0', 'fmuehlem', 'vma2324', 'krishn75', 'xie317', 'pkaundin', 'kswiatk9581', 'lin814', 'jmeneze', 'mmulter', 'aharbin', 'danphoenix', 'atunga']"
10,182,62,67,52,"['dhaval_1104', 'saumya15172', 'adityadiundi', 'manshi18207', 'smartvedi', 'prateek18211', 'shivani18223', 'neerupama18209', 'shubhesh18216', 'jasmine18202', 'shivam18214', 'sambhav14158', 'hnspoorthy', 'ankur14019', 'kunal15145', 'sagar17115', 'shubham18176', 'abhinavg', 'pankaj16176', 'tarun14168', 'akshay18193', 'avdesh15135', 'feraj.husain', 'puneet15159', 'anubhav15128', 'surabhi18217', 'shivam15177', 'maddineni18206', 'vaishali18220', 'ashish18157', 'anchal18155', 'puneet16178', 'rajat15162', 'arij18208', 'sagar15167', 'priyanka18169', 'sambeet15168', 'saurav15174', 'mridul15149', 'aparna18196', 'shaikh18213', 'tushar18218', 'gurpreet15140', 'sarthak16190', 'nowudontknowme', 'aminah', 'kumari18221', 'paras15154', 'ehtesham18199', 'subhadipporia', 'juilly', 'aman18194']",9,"['liusyang641', 'vedat969', 'akoglutayyip', 'elliott.rill', 'emre1344', 'lavanyanadarajan', 'michielin.alessandro', 'rafshezani', 'tttakoglu16000']",15,"['harsh16150', 'vishal16207', 'parth15156', 'shivam18215', 'aakash18191', 'imrajat', 'yogesh15193', 'harsh161500', 'rajat16182', 'sahil16184', 'dheeraj15138', 'studsuper50', 'shuchi18224', None, 'subhadip17124']",76,"['saumya15172', 'vishal16207', 'adityadiundi', 'imrajat', 'neerupama18209', 'michielin.alessandro', 'parth15156', 'yogesh15193', 'jasmine18202', 'shivam18214', 'dheeraj15138', 'tarun14168', 'akshay18193', 'shivam18215', 'akoglutayyip', 'surabhi18217', 'rajat15162', 'mridul15149', 'shaikh18213', 'tushar18218', 'dhaval_1104', 'manshi18207', 'smartvedi', 'prateek18211', 'harsh161500', 'rafshezani', 'abhinavg', 'vedat969', 'avdesh15135', 'feraj.husain', 'emre1344', 'lavanyanadarajan', 'maddineni18206', 'ashish18157', 'tttakoglu16000', 'liusyang641', 'aparna18196', 'aminah', 'ehtesham18199', 'subhadipporia', 'sahil16184', 'shivani18223', 'shubhesh18216', 'hnspoorthy', 'sagar17115', 'shuchi18224', 'shivam15177', 'vaishali18220', 'sagar15167', 'aakash18191', 'gurpreet15140', 'nowudontknowme', 'sambeet15168', 'aman18194', 'rajat16182', 'elliott.rill', 'harsh16150', 'sambhav14158', 'ankur14019', 'kunal15145', 'shubham18176', 'studsuper50', 'pankaj16176', 'puneet15159', 'anubhav15128', 'anchal18155', None, 'subhadip17124', 'puneet16178', 'arij18208', 'priyanka18169', 'saurav15174', 'sarthak16190', 'kumari18221', 'paras15154', 'juilly']"
10,185,62,19,3,"['akoglutayyip', 'vedat969', 'rafshezani']",58,"['dhaval_1104', 'saumya15172', 'adityadiundi', 'manshi18207', 'smartvedi', 'prateek18211', 'shivani18223', 'elliott.rill', 'neerupama18209', 'shubhesh18216', 'michielin.alessandro', 'jasmine18202', 'shivam18214', 'sambhav14158', 'hnspoorthy', 'ankur14019', 'kunal15145', 'sagar17115', 'shubham18176', 'abhinavg', 'pankaj16176', 'tarun14168', 'akshay18193', 'avdesh15135', 'feraj.husain', 'puneet15159', 'anubhav15128', 'emre1344', 'surabhi18217', 'shivam15177', 'lavanyanadarajan', 'maddineni18206', 'vaishali18220', 'ashish18157', 'anchal18155', 'tttakoglu16000', 'liusyang641', 'puneet16178', 'arij18208', 'sagar15167', 'priyanka18169', 'rajat15162', 'saurav15174', 'mridul15149', 'sambeet15168', 'aparna18196', 'shaikh18213', 'tushar18218', 'gurpreet15140', 'sarthak16190', 'nowudontknowme', 'aminah', 'kumari18221', 'paras15154', 'ehtesham18199', 'subhadipporia', 'juilly', 'aman18194']",16,"['furcoskuner', 'ulasgorcelioglu', 'frknznkr', 'esracolak.25', 'oakbulut1997', 'yilmazberat1997', 'emre_krtn97', 'berkanaydn16', 'mevradilanerten', 'melikemusal1', 'furkanefeyuceer', 'muratlevent', 'cihanbuyuknacar', None, 'onurcanozavci', 'abcd5454']",77,"['saumya15172', 'adityadiundi', 'esracolak.25', 'shivani18223', 'neerupama18209', 'shubhesh18216', 'michielin.alessandro', 'furcoskuner', 'jasmine18202', 'shivam18214', 'emre_krtn97', 'hnspoorthy', 'sagar17115', 'tarun14168', 'akshay18193', 'oakbulut1997', 'akoglutayyip', 'yilmazberat1997', 'surabhi18217', 'shivam15177', 'vaishali18220', 'muratlevent', 'abcd5454', 'rajat15162', 'sagar15167', 'mridul15149', 'gurpreet15140', 'shaikh18213', 'tushar18218', 'nowudontknowme', 'furkanefeyuceer', 'sambeet15168', 'aman18194', 'dhaval_1104', 'manshi18207', 'smartvedi', 'prateek18211', 'elliott.rill', 'mevradilanerten', 'cihanbuyuknacar', 'onurcanozavci', 'sambhav14158', 'ankur14019', 'kunal15145', 'shubham18176', 'rafshezani', 'abhinavg', 'pankaj16176', 'vedat969', 'frknznkr', 'avdesh15135', 'feraj.husain', 'puneet15159', 'anubhav15128', 'berkanaydn16', 'emre1344', 'lavanyanadarajan', 'melikemusal1', 'maddineni18206', 'ashish18157', 'anchal18155', None, 'tttakoglu16000', 'liusyang641', 'puneet16178', 'arij18208', 'priyanka18169', 'ulasgorcelioglu', 'saurav15174', 'aparna18196', 'sarthak16190', 'aminah', 'kumari18221', 'paras15154', 'ehtesham18199', 'subhadipporia', 'juilly']"
10,183,62,17,1,['lavanyanadarajan'],60,"['dhaval_1104', 'saumya15172', 'adityadiundi', 'manshi18207', 'smartvedi', 'prateek18211', 'shivani18223', 'elliott.rill', 'neerupama18209', 'shubhesh18216', 'michielin.alessandro', 'jasmine18202', 'shivam18214', 'sambhav14158', 'hnspoorthy', 'ankur14019', 'kunal15145', 'sagar17115', 'rafshezani', 'shubham18176', 'abhinavg', 'pankaj16176', 'tarun14168', 'akshay18193', 'vedat969', 'avdesh15135', 'feraj.husain', 'puneet15159', 'akoglutayyip', 'anubhav15128', 'emre1344', 'surabhi18217', 'shivam15177', 'maddineni18206', 'vaishali18220', 'ashish18157', 'anchal18155', 'tttakoglu16000', 'liusyang641', 'puneet16178', 'arij18208', 'sagar15167', 'priyanka18169', 'rajat15162', 'saurav15174', 'mridul15149', 'sambeet15168', 'aparna18196', 'shaikh18213', 'tushar18218', 'gurpreet15140', 'sarthak16190', 'nowudontknowme', 'aminah', 'kumari18221', 'paras15154', 'ehtesham18199', 'subhadipporia', 'juilly', 'aman18194']",16,"['juzairi08', 'thuvaskrishnan', 'thayyibathadmi', 'hairidesigner', None, 'shahrul_iqmal', 'aqilazman', 'syahmikml', 'syawalnaim2102', 'ccteh0196', 'hakimiikmal4', 'wahideen_wbk', 'sarmila.krishnan', 'yuva96', 'adrtee', 'tuanaiman']",77,"['saumya15172', 'adityadiundi', 'shivani18223', 'neerupama18209', 'shubhesh18216', 'ccteh0196', 'michielin.alessandro', 'shahrul_iqmal', 'juzairi08', 'thuvaskrishnan', 'jasmine18202', 'shivam18214', 'aqilazman', 'syahmikml', 'hnspoorthy', 'syawalnaim2102', 'sagar17115', 'wahideen_wbk', 'tuanaiman', 'tarun14168', 'akshay18193', 'akoglutayyip', 'surabhi18217', 'shivam15177', 'vaishali18220', 'rajat15162', 'sagar15167', 'mridul15149', 'gurpreet15140', 'shaikh18213', 'tushar18218', 'nowudontknowme', 'sambeet15168', 'hairidesigner', 'aman18194', 'dhaval_1104', 'manshi18207', 'smartvedi', 'prateek18211', 'elliott.rill', 'sarmila.krishnan', 'adrtee', 'sambhav14158', 'ankur14019', 'kunal15145', 'shubham18176', 'rafshezani', 'abhinavg', 'pankaj16176', 'vedat969', 'avdesh15135', 'feraj.husain', 'puneet15159', 'anubhav15128', 'emre1344', 'lavanyanadarajan', 'maddineni18206', 'ashish18157', 'anchal18155', None, 'tttakoglu16000', 'liusyang641', 'puneet16178', 'arij18208', 'priyanka18169', 'saurav15174', 'aparna18196', 'thayyibathadmi', 'sarthak16190', 'aminah', 'kumari18221', 'paras15154', 'hakimiikmal4', 'ehtesham18199', 'yuva96', 'subhadipporia', 'juilly']"
10,186,62,9,2,"['akoglutayyip', 'tttakoglu16000']",59,"['dhaval_1104', 'saumya15172', 'ehtesham18199', 'adityadiundi', 'manshi18207', 'smartvedi', 'prateek18211', 'shivani18223', 'elliott.rill', 'neerupama18209', 'shubhesh18216', 'michielin.alessandro', 'jasmine18202', 'shivam18214', 'sambhav14158', 'hnspoorthy', 'ankur14019', 'kunal15145', 'sagar17115', 'rafshezani', 'shubham18176', 'abhinavg', 'pankaj16176', 'tarun14168', 'akshay18193', 'vedat969', 'avdesh15135', 'feraj.husain', 'puneet15159', 'anubhav15128', 'emre1344', 'surabhi18217', 'shivam15177', 'lavanyanadarajan', 'maddineni18206', 'vaishali18220', 'ashish18157', 'anchal18155', 'liusyang641', 'puneet16178', 'arij18208', 'sagar15167', 'priyanka18169', 'rajat15162', 'saurav15174', 'mridul15149', 'aparna18196', 'shaikh18213', 'tushar18218', 'gurpreet15140', 'sarthak16190', 'nowudontknowme', 'aminah', 'kumari18221', 'paras15154', 'sambeet15168', 'subhadipporia', 'juilly', 'aman18194']",7,"['ulasgorcelioglu', 'okanircann', 'meltemsbreezes', 'melisozkarr', None, 'ozgurdenizkz', 'fatiherdgn25']",68,"['dhaval_1104', 'saumya15172', 'ehtesham18199', 'adityadiundi', 'manshi18207', 'smartvedi', 'prateek18211', 'shivani18223', 'elliott.rill', 'neerupama18209', 'shubhesh18216', 'michielin.alessandro', 'melisozkarr', 'fatiherdgn25', 'jasmine18202', 'shivam18214', 'sambhav14158', 'meltemsbreezes', 'hnspoorthy', 'ankur14019', 'kunal15145', 'sagar17115', 'rafshezani', 'shubham18176', 'abhinavg', 'pankaj16176', 'tarun14168', 'akshay18193', 'vedat969', 'avdesh15135', 'feraj.husain', 'puneet15159', 'akoglutayyip', 'anubhav15128', 'emre1344', 'surabhi18217', 'shivam15177', 'lavanyanadarajan', 'maddineni18206', 'vaishali18220', 'ashish18157', 'anchal18155', None, 'ozgurdenizkz', 'tttakoglu16000', 'liusyang641', 'puneet16178', 'arij18208', 'sagar15167', 'priyanka18169', 'rajat15162', 'saurav15174', 'mridul15149', 'ulasgorcelioglu', 'aparna18196', 'shaikh18213', 'tushar18218', 'gurpreet15140', 'sarthak16190', 'okanircann', 'nowudontknowme', 'aminah', 'kumari18221', 'paras15154', 'sambeet15168', 'subhadipporia', 'juilly', 'aman18194']"
11,36,55,54,1,['dfl'],53,"['preet58', 'navjinder12', 'hkz5032', 'oogii1998', 'manuel.guel', 'daniel.camacho', 'erick.padilla', 'jaw6297', 'bgutierrez', 'liamjthomson18948389', 'naharin10', 'tsendee', 'grhu996', 'tfs5093', 'gizemkaraca', 'luis.ascencio', 'jose.trujillo', 'dsm5388', 'sdyfbew', 'cjw5647', 'luzvani', 'siao', 'cesar.sanchez', 'fjj5032', 'ac7431', 'emilygroves18908496', 'davyn', 'as12033', 'nymkan756', 'mikeyu1997', 'djb84', 'tornado_u', 'kevinberwick', 'zh1246', 'rsc5261', 'luz.valtierra', 'saa5966', 'swagatam.chaitali', 'lh2754', 'ytsong95', 'jesus.lozano', 'weekmooz', 'arunparth', 'navaneeth.tp', 'wndgml3370', 'mauricio.lopez', 'shubham.mahalank', 'sgu20131429', 'tingbiao', 'cannansong', 'rc2975nyu', 'armando.martinez', 'yaozu']",53,"['alidsjt', 'loisonchambers', 'aronchino6', 'mcruces.fz', 'latecnologiameodia', 'carlosbesadaromero', 'gemma', 'nuanno97', 'vblanco.nico', 'janalorenzolumbreras', 'carlosvillar54', 'efrenhub', 'mateocampos', 'tonybocadillosgrandes', 'lauragdevesa', 'antonio25', 'pablobou4', 'retty8', 'gombut', 'cristinacigarran', 'corredoira', 'iago', 'helenalecoq97', 'xosegq16', 'ramonruiz.infor', 'perezsarmar', 'malgaca', 'pedrosiaba', 'martinzapata', 'alimatama', 'acregodean', 'amparo.castro.96', 'lino13', 'martin32', 'sarapl', 'vickytubio', 'camilolcastro97', None, 'marcosanllo', 'juanmacano97', 'maxernest', 'anxovidal8', 'david.peral.moran', 'puertarcd', 'hermidaitor', 'svo4321', 'alecorti.pardo', 'electronica18', 'veronica.mieites', 'vanesagarcia', 'carlosvigo1997', 'ledicia97', 'movi205']",107,"['preet58', 'navjinder12', 'manuel.guel', 'oogii1998', 'loisonchambers', 'jaw6297', 'carlosvigo1997', 'bgutierrez', 'gemma', 'naharin10', 'tsendee', 'movi205', 'vblanco.nico', 'efrenhub', 'grhu996', 'tonybocadillosgrandes', 'mateocampos', 'gizemkaraca', 'luis.ascencio', 'antonio25', 'sdyfbew', 'cjw5647', 'luzvani', 'retty8', 'cesar.sanchez', 'gombut', 'cristinacigarran', 'emilygroves18908496', 'ramonruiz.infor', 'perezsarmar', 'mikeyu1997', 'tornado_u', 'alimatama', 'lino13', 'kevinberwick', 'zh1246', 'saa5966', 'lh2754', 'ytsong95', 'jesus.lozano', 'weekmooz', 'navaneeth.tp', 'wndgml3370', 'mauricio.lopez', 'shubham.mahalank', 'sgu20131429', 'puertarcd', 'alecorti.pardo', 'electronica18', 'veronica.mieites', 'rc2975nyu', 'armando.martinez', 'yaozu', 'alidsjt', 'hkz5032', 'daniel.camacho', 'erick.padilla', 'aronchino6', 'latecnologiameodia', 'mcruces.fz', 'carlosbesadaromero', 'liamjthomson18948389', 'nuanno97', 'janalorenzolumbreras', 'carlosvillar54', 'lauragdevesa', 'tfs5093', 'dsm5388', 'jose.trujillo', 'pablobou4', 'siao', 'fjj5032', 'ac7431', 'corredoira', 'iago', 'helenalecoq97', 'davyn', 'xosegq16', 'malgaca', 'as12033', 'pedrosiaba', 'nymkan756', 'djb84', 'martinzapata', 'acregodean', 'amparo.castro.96', 'martin32', 'sarapl', 'rsc5261', 'vickytubio', 'camilolcastro97', 'luz.valtierra', None, 'marcosanllo', 'swagatam.chaitali', 'juanmacano97', 'dfl', 'maxernest', 'anxovidal8', 'david.peral.moran', 'hermidaitor', 'svo4321', 'vanesagarcia', 'cannansong', 'arunparth', 'ledicia97', 'tingbiao']"
11,18,55,46,1,['dfl'],53,"['preet58', 'navjinder12', 'hkz5032', 'oogii1998', 'manuel.guel', 'daniel.camacho', 'erick.padilla', 'jaw6297', 'bgutierrez', 'liamjthomson18948389', 'naharin10', 'tsendee', 'grhu996', 'tfs5093', 'gizemkaraca', 'luis.ascencio', 'jose.trujillo', 'dsm5388', 'sdyfbew', 'cjw5647', 'luzvani', 'siao', 'cesar.sanchez', 'fjj5032', 'ac7431', 'emilygroves18908496', 'davyn', 'as12033', 'nymkan756', 'mikeyu1997', 'djb84', 'tornado_u', 'kevinberwick', 'zh1246', 'rsc5261', 'luz.valtierra', 'saa5966', 'swagatam.chaitali', 'lh2754', 'ytsong95', 'jesus.lozano', 'weekmooz', 'arunparth', 'navaneeth.tp', 'wndgml3370', 'mauricio.lopez', 'shubham.mahalank', 'sgu20131429', 'tingbiao', 'cannansong', 'rc2975nyu', 'armando.martinez', 'yaozu']",45,"['miri23', 'alidsjt', 'loisonchambers', 'carlosbesadaromero', 'gemma', 'siemprewowthechami', 'vblanco.nico', 'janalorenzolumbreras', 'efrenhub', 'isabelmaria.vazquez', 'mateocampos', 'tonybocadillosgrandes', 'josepazmartin', 'adfoz', 'apascao', 'cristinacigarran', 'iago', 'helenalecoq97', 'xosegq16', 'malgaca', 'mmartinezsanchez', 'pedrosiaba', 'adriangarea', 'martinzapata', 'alimatama', 'acregodean', 'amparo.castro.96', 'sarapl', 'vickytubio', 'camilolcastro97', None, 'maxernest', 'danielfernandezcalo', 'david.garrido', 'anxovidal8', 'puertarcd', 'hermidaitor', 'alberfn', 'svo4321', 'alecorti.pardo', 'electronica18', 'veronica.mieites', 'vanesagarcia', 'ledicia97', 'movi205']",99,"['preet58', 'miri23', 'navjinder12', 'manuel.guel', 'oogii1998', 'loisonchambers', 'jaw6297', 'bgutierrez', 'gemma', 'naharin10', 'tsendee', 'siemprewowthechami', 'vblanco.nico', 'movi205', 'efrenhub', 'isabelmaria.vazquez', 'grhu996', 'tonybocadillosgrandes', 'mateocampos', 'gizemkaraca', 'josepazmartin', 'luis.ascencio', 'sdyfbew', 'cjw5647', 'luzvani', 'adfoz', 'cesar.sanchez', 'cristinacigarran', 'emilygroves18908496', 'adriangarea', 'mikeyu1997', 'tornado_u', 'alimatama', 'kevinberwick', 'zh1246', 'saa5966', 'lh2754', 'ytsong95', 'jesus.lozano', 'weekmooz', 'danielfernandezcalo', 'navaneeth.tp', 'wndgml3370', 'mauricio.lopez', 'shubham.mahalank', 'sgu20131429', 'puertarcd', 'alecorti.pardo', 'electronica18', 'veronica.mieites', 'rc2975nyu', 'armando.martinez', 'yaozu', 'alidsjt', 'hkz5032', 'daniel.camacho', 'erick.padilla', 'carlosbesadaromero', 'liamjthomson18948389', 'janalorenzolumbreras', 'tfs5093', 'dsm5388', 'jose.trujillo', 'siao', 'apascao', 'fjj5032', 'ac7431', 'iago', 'helenalecoq97', 'davyn', 'xosegq16', 'malgaca', 'mmartinezsanchez', 'as12033', 'pedrosiaba', 'nymkan756', 'djb84', 'martinzapata', 'acregodean', 'amparo.castro.96', 'sarapl', 'rsc5261', 'vickytubio', 'camilolcastro97', 'luz.valtierra', None, 'swagatam.chaitali', 'dfl', 'maxernest', 'david.garrido', 'anxovidal8', 'hermidaitor', 'alberfn', 'svo4321', 'vanesagarcia', 'cannansong', 'arunparth', 'ledicia97', 'tingbiao']"
11,22,55,35,1,['dfl'],53,"['preet58', 'navjinder12', 'hkz5032', 'oogii1998', 'manuel.guel', 'daniel.camacho', 'erick.padilla', 'jaw6297', 'bgutierrez', 'liamjthomson18948389', 'naharin10', 'tsendee', 'grhu996', 'tfs5093', 'gizemkaraca', 'luis.ascencio', 'jose.trujillo', 'dsm5388', 'sdyfbew', 'cjw5647', 'luzvani', 'siao', 'cesar.sanchez', 'fjj5032', 'ac7431', 'emilygroves18908496', 'davyn', 'as12033', 'nymkan756', 'mikeyu1997', 'djb84', 'tornado_u', 'kevinberwick', 'zh1246', 'rsc5261', 'luz.valtierra', 'saa5966', 'swagatam.chaitali', 'lh2754', 'ytsong95', 'jesus.lozano', 'weekmooz', 'arunparth', 'navaneeth.tp', 'wndgml3370', 'mauricio.lopez', 'shubham.mahalank', 'sgu20131429', 'tingbiao', 'cannansong', 'rc2975nyu', 'armando.martinez', 'yaozu']",34,"['alidsjt', 'mcruces.fz', 'carlosbesadaromero', 'gemma', 'nuanno97', 'vblanco.nico', 'carlosvillar54', 'efrenhub', 'isabelmaria.vazquez', 'tonybocadillosgrandes', 'lauragdevesa', 'dokun', 'antonio25', 'cristinacigarran', 'iago', 'helenalecoq97', 'xosegq16', 'ramonruiz.infor', 'pedrosiaba', 'alimatama', 'acregodean', 'martin32', 'vickytubio', None, 'estebanrial', 'selena', 'juanmacano97', 'maxernest', 'david.peral.moran', 'hermidaitor', 'alberfn', 'alecorti.pardo', 'electronica18', 'carlosvigo1997']",88,"['preet58', 'navjinder12', 'manuel.guel', 'oogii1998', 'jaw6297', 'carlosvigo1997', 'bgutierrez', 'gemma', 'naharin10', 'tsendee', 'vblanco.nico', 'efrenhub', 'isabelmaria.vazquez', 'grhu996', 'tonybocadillosgrandes', 'gizemkaraca', 'dokun', 'luis.ascencio', 'antonio25', 'sdyfbew', 'cjw5647', 'luzvani', 'cesar.sanchez', 'cristinacigarran', 'emilygroves18908496', 'ramonruiz.infor', 'mikeyu1997', 'tornado_u', 'alimatama', 'kevinberwick', 'zh1246', 'saa5966', 'lh2754', 'ytsong95', 'jesus.lozano', 'weekmooz', 'estebanrial', 'navaneeth.tp', 'wndgml3370', 'mauricio.lopez', 'shubham.mahalank', 'sgu20131429', 'alecorti.pardo', 'electronica18', 'rc2975nyu', 'armando.martinez', 'yaozu', 'alidsjt', 'hkz5032', 'daniel.camacho', 'erick.padilla', 'mcruces.fz', 'carlosbesadaromero', 'liamjthomson18948389', 'nuanno97', 'carlosvillar54', 'lauragdevesa', 'tfs5093', 'dsm5388', 'jose.trujillo', 'siao', 'fjj5032', 'ac7431', 'iago', 'helenalecoq97', 'davyn', 'xosegq16', 'as12033', 'pedrosiaba', 'nymkan756', 'djb84', 'acregodean', 'martin32', 'rsc5261', 'vickytubio', None, 'luz.valtierra', 'swagatam.chaitali', 'selena', 'juanmacano97', 'dfl', 'maxernest', 'david.peral.moran', 'hermidaitor', 'alberfn', 'cannansong', 'arunparth', 'tingbiao']"
11,6,55,33,4,"['tornado_u', 'nymkan756', 'tsendee', 'oogii1998']",50,"['preet58', 'navjinder12', 'hkz5032', 'manuel.guel', 'daniel.camacho', 'erick.padilla', 'jaw6297', 'bgutierrez', 'liamjthomson18948389', 'naharin10', 'grhu996', 'tfs5093', 'gizemkaraca', 'luis.ascencio', 'jose.trujillo', 'dsm5388', 'sdyfbew', 'cjw5647', 'luzvani', 'siao', 'cesar.sanchez', 'fjj5032', 'ac7431', 'arunparth', 'emilygroves18908496', 'davyn', 'as12033', 'mikeyu1997', 'djb84', 'kevinberwick', 'zh1246', 'rsc5261', 'luz.valtierra', 'saa5966', 'swagatam.chaitali', 'lh2754', 'ytsong95', 'jesus.lozano', 'dfl', 'weekmooz', 'navaneeth.tp', 'wndgml3370', 'mauricio.lopez', 'shubham.mahalank', 'sgu20131429', 'tingbiao', 'cannansong', 'rc2975nyu', 'armando.martinez', 'yaozu']",29,"['god4host0918', 'battulga9192', 'bymbaa6789', 'sdelgermaa47', 'svhbat98', 'davaa.byambasuren14', 'muujig1', 't.byambadorj0282', 'anar', 'munkherdene593', 'dshinwes', 'tengis', 'bz_5657', 'anudarid6', 'puujeeulzii2', 'sdeegiimaa', 'delgermaa', 'bat0407', None, 'g.munkherdene13', 'ulziibaatar0324', 'heroaxe.0701', 'bodio955', 'ss0249571', 'sumyafire1', 'ubatbilig99', 'dulguun1', 'gundalai2000', 'watashi.legion']",83,"['preet58', 'navjinder12', 'manuel.guel', 'oogii1998', 'bymbaa6789', 'jaw6297', 'svhbat98', 'bgutierrez', 'naharin10', 'tsendee', 'grhu996', 'davaa.byambasuren14', 'gizemkaraca', 'luis.ascencio', 't.byambadorj0282', 'anar', 'sdyfbew', 'munkherdene593', 'cjw5647', 'luzvani', 'cesar.sanchez', 'emilygroves18908496', 'anudarid6', 'sdeegiimaa', 'delgermaa', 'mikeyu1997', 'bat0407', 'tornado_u', 'kevinberwick', 'zh1246', 'g.munkherdene13', 'saa5966', 'lh2754', 'ytsong95', 'jesus.lozano', 'weekmooz', 'heroaxe.0701', 'navaneeth.tp', 'wndgml3370', 'mauricio.lopez', 'shubham.mahalank', 'sgu20131429', 'ubatbilig99', 'dulguun1', 'rc2975nyu', 'watashi.legion', 'armando.martinez', 'yaozu', 'god4host0918', 'hkz5032', 'battulga9192', 'daniel.camacho', 'erick.padilla', 'sdelgermaa47', 'liamjthomson18948389', 'muujig1', 'tfs5093', 'dsm5388', 'jose.trujillo', 'dshinwes', 'siao', 'fjj5032', 'ac7431', 'tengis', 'davyn', 'bz_5657', 'puujeeulzii2', 'as12033', 'nymkan756', 'djb84', 'rsc5261', None, 'luz.valtierra', 'swagatam.chaitali', 'ulziibaatar0324', 'dfl', 'bodio955', 'ss0249571', 'sumyafire1', 'cannansong', 'gundalai2000', 'arunparth', 'tingbiao']"
11,9,55,23,3,"['nymkan756', 'tsendee', 'oogii1998']",51,"['preet58', 'navjinder12', 'hkz5032', 'manuel.guel', 'daniel.camacho', 'erick.padilla', 'jaw6297', 'bgutierrez', 'liamjthomson18948389', 'naharin10', 'grhu996', 'tfs5093', 'gizemkaraca', 'luis.ascencio', 'jose.trujillo', 'dsm5388', 'sdyfbew', 'cjw5647', 'luzvani', 'siao', 'cesar.sanchez', 'fjj5032', 'ac7431', 'arunparth', 'emilygroves18908496', 'davyn', 'as12033', 'mikeyu1997', 'djb84', 'tornado_u', 'kevinberwick', 'zh1246', 'rsc5261', 'luz.valtierra', 'saa5966', 'swagatam.chaitali', 'lh2754', 'ytsong95', 'jesus.lozano', 'dfl', 'weekmooz', 'navaneeth.tp', 'wndgml3370', 'mauricio.lopez', 'shubham.mahalank', 'sgu20131429', 'tingbiao', 'cannansong', 'rc2975nyu', 'armando.martinez', 'yaozu']",20,"['god4host0918', 'battulga9192', 'bymbaa6789', 't.byambadorj0282', 'munkherdene593', 'dshinwes', 'bz_5657', 'anudarid6', 'puujeeulzii2', 'sdeegiimaa', 'delgermaa', 'bat0407', None, 'ulziibaatar0324', 'ss0249571', 'sumyafire1', 'ubatbilig99', 'dulguun1', 'gundalai2000', 'watashi.legion']",74,"['preet58', 'navjinder12', 'manuel.guel', 'oogii1998', 'bymbaa6789', 'jaw6297', 'bgutierrez', 'naharin10', 'tsendee', 'grhu996', 'gizemkaraca', 'luis.ascencio', 't.byambadorj0282', 'sdyfbew', 'munkherdene593', 'cjw5647', 'luzvani', 'cesar.sanchez', 'emilygroves18908496', 'anudarid6', 'sdeegiimaa', 'delgermaa', 'mikeyu1997', 'bat0407', 'tornado_u', 'kevinberwick', 'zh1246', 'saa5966', 'lh2754', 'ytsong95', 'jesus.lozano', 'weekmooz', 'navaneeth.tp', 'wndgml3370', 'mauricio.lopez', 'shubham.mahalank', 'sgu20131429', 'ubatbilig99', 'dulguun1', 'rc2975nyu', 'watashi.legion', 'armando.martinez', 'yaozu', 'god4host0918', 'hkz5032', 'battulga9192', 'daniel.camacho', 'erick.padilla', 'liamjthomson18948389', 'tfs5093', 'dsm5388', 'jose.trujillo', 'dshinwes', 'siao', 'fjj5032', 'ac7431', 'davyn', 'bz_5657', 'puujeeulzii2', 'as12033', 'nymkan756', 'djb84', 'rsc5261', None, 'luz.valtierra', 'swagatam.chaitali', 'ulziibaatar0324', 'dfl', 'ss0249571', 'sumyafire1', 'cannansong', 'gundalai2000', 'arunparth', 'tingbiao']"
11,7,55,18,8,"['hkz5032', 'cjw5647', 'mikeyu1997', 'jaw6297', 'fjj5032', 'cannansong', 'rsc5261', 'saa5966']",46,"['preet58', 'navjinder12', 'manuel.guel', 'oogii1998', 'daniel.camacho', 'erick.padilla', 'bgutierrez', 'liamjthomson18948389', 'naharin10', 'tsendee', 'grhu996', 'tfs5093', 'gizemkaraca', 'luis.ascencio', 'jose.trujillo', 'dsm5388', 'sdyfbew', 'luzvani', 'siao', 'cesar.sanchez', 'ac7431', 'emilygroves18908496', 'davyn', 'as12033', 'nymkan756', 'djb84', 'tornado_u', 'kevinberwick', 'zh1246', 'luz.valtierra', 'lh2754', 'swagatam.chaitali', 'ytsong95', 'jesus.lozano', 'weekmooz', 'dfl', 'arunparth', 'navaneeth.tp', 'wndgml3370', 'mauricio.lopez', 'shubham.mahalank', 'sgu20131429', 'tingbiao', 'rc2975nyu', 'armando.martinez', 'yaozu']",10,"['tzt74', 'jmc7066', 'rqm5425', 'kxz172', 'sxn266', 'e78yui', 'mxl5509', None, 'yvy5250', 'jmw6448']",64,"['preet58', 'navjinder12', 'hkz5032', 'manuel.guel', 'oogii1998', 'yvy5250', 'daniel.camacho', 'erick.padilla', 'jaw6297', 'bgutierrez', 'liamjthomson18948389', 'naharin10', 'tsendee', 'e78yui', 'grhu996', 'tfs5093', 'gizemkaraca', 'luis.ascencio', 'jose.trujillo', 'dsm5388', 'sdyfbew', 'rqm5425', 'cjw5647', 'luzvani', 'siao', 'cesar.sanchez', 'fjj5032', 'ac7431', 'emilygroves18908496', 'davyn', 'jmc7066', 'as12033', 'nymkan756', 'mikeyu1997', 'djb84', 'jmw6448', 'tornado_u', 'kxz172', 'armando.martinez', 'kevinberwick', 'zh1246', 'rsc5261', 'yaozu', 'mxl5509', 'luz.valtierra', None, 'saa5966', 'swagatam.chaitali', 'lh2754', 'ytsong95', 'jesus.lozano', 'dfl', 'weekmooz', 'navaneeth.tp', 'wndgml3370', 'mauricio.lopez', 'tzt74', 'sgu20131429', 'tingbiao', 'sxn266', 'cannansong', 'rc2975nyu', 'arunparth', 'shubham.mahalank']"
11,37,55,16,1,['dfl'],53,"['preet58', 'navjinder12', 'hkz5032', 'oogii1998', 'manuel.guel', 'daniel.camacho', 'erick.padilla', 'jaw6297', 'bgutierrez', 'liamjthomson18948389', 'naharin10', 'tsendee', 'grhu996', 'tfs5093', 'gizemkaraca', 'luis.ascencio', 'jose.trujillo', 'dsm5388', 'sdyfbew', 'cjw5647', 'luzvani', 'siao', 'cesar.sanchez', 'fjj5032', 'ac7431', 'emilygroves18908496', 'davyn', 'as12033', 'nymkan756', 'mikeyu1997', 'djb84', 'tornado_u', 'kevinberwick', 'zh1246', 'rsc5261', 'luz.valtierra', 'saa5966', 'swagatam.chaitali', 'lh2754', 'ytsong95', 'jesus.lozano', 'weekmooz', 'arunparth', 'navaneeth.tp', 'wndgml3370', 'mauricio.lopez', 'shubham.mahalank', 'sgu20131429', 'tingbiao', 'cannansong', 'rc2975nyu', 'armando.martinez', 'yaozu']",15,"['lsleed', 'dokun', 'alidsjt', 'gombut', 'cristinacigarran', 'martin32', 'alimatama', 'electronica18', 'lino13', 'david2397', 'veronica.mieites', 'janalorenzolumbreras', None, 'movi205', 'perezsarmar']",69,"['preet58', 'alidsjt', 'navjinder12', 'hkz5032', 'manuel.guel', 'oogii1998', 'daniel.camacho', 'erick.padilla', 'jaw6297', 'bgutierrez', 'liamjthomson18948389', 'naharin10', 'tsendee', 'david2397', 'movi205', 'janalorenzolumbreras', 'grhu996', 'tfs5093', 'gizemkaraca', 'dokun', 'luis.ascencio', 'jose.trujillo', 'dsm5388', 'sdyfbew', 'cjw5647', 'luzvani', 'siao', 'cesar.sanchez', 'gombut', 'fjj5032', 'ac7431', 'cristinacigarran', 'emilygroves18908496', 'davyn', 'perezsarmar', 'lsleed', 'as12033', 'nymkan756', 'mikeyu1997', 'djb84', 'tornado_u', 'martin32', 'armando.martinez', 'alimatama', 'lino13', 'kevinberwick', 'zh1246', 'rsc5261', 'yaozu', None, 'luz.valtierra', 'saa5966', 'swagatam.chaitali', 'lh2754', 'ytsong95', 'jesus.lozano', 'dfl', 'weekmooz', 'navaneeth.tp', 'wndgml3370', 'mauricio.lopez', 'sgu20131429', 'tingbiao', 'electronica18', 'veronica.mieites', 'cannansong', 'rc2975nyu', 'arunparth', 'shubham.mahalank']"
11,10,55,15,11,"['ytsong95', 'weekmooz', 'sdyfbew', 'as12033', 'rc2975nyu', 'siao', 'ac7431', 'zh1246', 'arunparth', 'shubham.mahalank', 'lh2754']",43,"['preet58', 'navjinder12', 'hkz5032', 'oogii1998', 'manuel.guel', 'daniel.camacho', 'erick.padilla', 'jaw6297', 'bgutierrez', 'liamjthomson18948389', 'naharin10', 'tsendee', 'grhu996', 'tfs5093', 'gizemkaraca', 'luis.ascencio', 'jose.trujillo', 'dsm5388', 'cjw5647', 'luzvani', 'cesar.sanchez', 'fjj5032', 'emilygroves18908496', 'davyn', 'nymkan756', 'mikeyu1997', 'djb84', 'tornado_u', 'kevinberwick', 'rsc5261', 'luz.valtierra', 'saa5966', 'swagatam.chaitali', 'jesus.lozano', 'dfl', 'navaneeth.tp', 'wndgml3370', 'mauricio.lopez', 'sgu20131429', 'tingbiao', 'cannansong', 'armando.martinez', 'yaozu']",4,"['mr4425', None, 'kmamaniya', 'zl2513']",58,"['preet58', 'navjinder12', 'hkz5032', 'manuel.guel', 'oogii1998', 'daniel.camacho', 'erick.padilla', 'jaw6297', 'bgutierrez', 'liamjthomson18948389', 'naharin10', 'tsendee', 'grhu996', 'kmamaniya', 'tfs5093', 'gizemkaraca', 'luis.ascencio', 'jose.trujillo', 'dsm5388', 'sdyfbew', 'cjw5647', 'luzvani', 'siao', 'cesar.sanchez', 'fjj5032', 'ac7431', 'emilygroves18908496', 'davyn', 'zl2513', 'as12033', 'nymkan756', 'mikeyu1997', 'djb84', 'tornado_u', 'armando.martinez', 'mr4425', 'kevinberwick', 'zh1246', 'rsc5261', 'yaozu', None, 'luz.valtierra', 'saa5966', 'swagatam.chaitali', 'lh2754', 'ytsong95', 'jesus.lozano', 'dfl', 'weekmooz', 'navaneeth.tp', 'wndgml3370', 'mauricio.lopez', 'sgu20131429', 'tingbiao', 'cannansong', 'rc2975nyu', 'arunparth', 'shubham.mahalank']"
11,23,55,15,1,['davyn'],53,"['preet58', 'navjinder12', 'hkz5032', 'oogii1998', 'manuel.guel', 'daniel.camacho', 'erick.padilla', 'jaw6297', 'bgutierrez', 'liamjthomson18948389', 'naharin10', 'tsendee', 'grhu996', 'tfs5093', 'gizemkaraca', 'luis.ascencio', 'jose.trujillo', 'dsm5388', 'sdyfbew', 'cjw5647', 'luzvani', 'siao', 'cesar.sanchez', 'fjj5032', 'ac7431', 'arunparth', 'emilygroves18908496', 'as12033', 'nymkan756', 'mikeyu1997', 'djb84', 'tornado_u', 'kevinberwick', 'zh1246', 'rsc5261', 'luz.valtierra', 'saa5966', 'swagatam.chaitali', 'lh2754', 'ytsong95', 'jesus.lozano', 'dfl', 'weekmooz', 'navaneeth.tp', 'wndgml3370', 'mauricio.lopez', 'shubham.mahalank', 'sgu20131429', 'tingbiao', 'cannansong', 'rc2975nyu', 'armando.martinez', 'yaozu']",14,"['annahaozheng0606', 'rikardberger', 'kartal', 'prakharbhargava0', 'paul.aniruddha', 'ilou', 'aengm', 'lukunze1', 'adarsh123', 'nazimmath3', 'hilisa', 'nadja1', 'scremin', None]",68,"['preet58', 'navjinder12', 'hkz5032', 'manuel.guel', 'oogii1998', 'daniel.camacho', 'erick.padilla', 'jaw6297', 'paul.aniruddha', 'bgutierrez', 'liamjthomson18948389', 'naharin10', 'tsendee', 'ilou', 'aengm', 'lukunze1', 'hilisa', 'grhu996', 'tfs5093', 'gizemkaraca', 'annahaozheng0606', 'luis.ascencio', 'jose.trujillo', 'dsm5388', 'sdyfbew', 'rikardberger', 'cjw5647', 'luzvani', 'siao', 'cesar.sanchez', 'fjj5032', 'ac7431', 'emilygroves18908496', 'nazimmath3', 'nadja1', 'davyn', 'scremin', 'kartal', 'as12033', 'nymkan756', 'mikeyu1997', 'djb84', 'tornado_u', 'armando.martinez', 'adarsh123', 'kevinberwick', 'zh1246', 'rsc5261', 'yaozu', None, 'luz.valtierra', 'saa5966', 'swagatam.chaitali', 'lh2754', 'ytsong95', 'jesus.lozano', 'dfl', 'weekmooz', 'navaneeth.tp', 'wndgml3370', 'mauricio.lopez', 'prakharbhargava0', 'sgu20131429', 'tingbiao', 'cannansong', 'rc2975nyu', 'arunparth', 'shubham.mahalank']"
11,31,55,15,1,['davyn'],53,"['preet58', 'navjinder12', 'hkz5032', 'oogii1998', 'manuel.guel', 'daniel.camacho', 'erick.padilla', 'jaw6297', 'bgutierrez', 'liamjthomson18948389', 'naharin10', 'tsendee', 'grhu996', 'tfs5093', 'gizemkaraca', 'luis.ascencio', 'jose.trujillo', 'dsm5388', 'sdyfbew', 'cjw5647', 'luzvani', 'siao', 'cesar.sanchez', 'fjj5032', 'ac7431', 'arunparth', 'emilygroves18908496', 'as12033', 'nymkan756', 'mikeyu1997', 'djb84', 'tornado_u', 'kevinberwick', 'zh1246', 'rsc5261', 'luz.valtierra', 'saa5966', 'swagatam.chaitali', 'lh2754', 'ytsong95', 'jesus.lozano', 'dfl', 'weekmooz', 'navaneeth.tp', 'wndgml3370', 'mauricio.lopez', 'shubham.mahalank', 'sgu20131429', 'tingbiao', 'cannansong', 'rc2975nyu', 'armando.martinez', 'yaozu']",14,"['annahaozheng0606', 'rikardberger', 'kartal', 'prakharbhargava0', 'paul.aniruddha', 'ilou', 'aengm', 'lukunze1', 'adarsh123', 'nazimmath3', 'hilisa', 'nadja1', 'scremin', None]",68,"['preet58', 'navjinder12', 'hkz5032', 'manuel.guel', 'oogii1998', 'daniel.camacho', 'erick.padilla', 'jaw6297', 'paul.aniruddha', 'bgutierrez', 'liamjthomson18948389', 'naharin10', 'tsendee', 'ilou', 'aengm', 'lukunze1', 'hilisa', 'grhu996', 'tfs5093', 'gizemkaraca', 'annahaozheng0606', 'luis.ascencio', 'jose.trujillo', 'dsm5388', 'sdyfbew', 'rikardberger', 'cjw5647', 'luzvani', 'siao', 'cesar.sanchez', 'fjj5032', 'ac7431', 'emilygroves18908496', 'nazimmath3', 'nadja1', 'davyn', 'scremin', 'kartal', 'as12033', 'nymkan756', 'mikeyu1997', 'djb84', 'tornado_u', 'armando.martinez', 'adarsh123', 'kevinberwick', 'zh1246', 'rsc5261', 'yaozu', None, 'luz.valtierra', 'saa5966', 'swagatam.chaitali', 'lh2754', 'ytsong95', 'jesus.lozano', 'dfl', 'weekmooz', 'navaneeth.tp', 'wndgml3370', 'mauricio.lopez', 'prakharbhargava0', 'sgu20131429', 'tingbiao', 'cannansong', 'rc2975nyu', 'arunparth', 'shubham.mahalank']"
11,12,55,12,11,"['jesus.lozano', 'luis.ascencio', 'jose.trujillo', 'manuel.guel', 'mauricio.lopez', 'erick.padilla', 'daniel.camacho', 'cesar.sanchez', 'bgutierrez', 'armando.martinez', 'luz.valtierra']",43,"['preet58', 'navjinder12', 'hkz5032', 'oogii1998', 'jaw6297', 'liamjthomson18948389', 'naharin10', 'tsendee', 'grhu996', 'tfs5093', 'gizemkaraca', 'dsm5388', 'sdyfbew', 'cjw5647', 'luzvani', 'siao', 'fjj5032', 'ac7431', 'emilygroves18908496', 'davyn', 'as12033', 'nymkan756', 'mikeyu1997', 'djb84', 'tornado_u', 'kevinberwick', 'zh1246', 'rsc5261', 'yaozu', 'saa5966', 'swagatam.chaitali', 'lh2754', 'ytsong95', 'dfl', 'weekmooz', 'navaneeth.tp', 'wndgml3370', 'sgu20131429', 'tingbiao', 'cannansong', 'rc2975nyu', 'arunparth', 'shubham.mahalank']",1,[None],55,"['preet58', 'navjinder12', 'hkz5032', 'manuel.guel', 'oogii1998', 'daniel.camacho', 'erick.padilla', 'jaw6297', 'bgutierrez', 'liamjthomson18948389', 'naharin10', 'tsendee', 'grhu996', 'tfs5093', 'gizemkaraca', 'luis.ascencio', 'jose.trujillo', 'dsm5388', 'sdyfbew', 'cjw5647', 'luzvani', 'siao', 'cesar.sanchez', 'fjj5032', 'ac7431', 'emilygroves18908496', 'davyn', 'as12033', 'nymkan756', 'mikeyu1997', 'djb84', 'tornado_u', 'armando.martinez', 'kevinberwick', 'zh1246', 'rsc5261', 'yaozu', None, 'luz.valtierra', 'saa5966', 'swagatam.chaitali', 'lh2754', 'ytsong95', 'jesus.lozano', 'dfl', 'weekmooz', 'navaneeth.tp', 'wndgml3370', 'mauricio.lopez', 'sgu20131429', 'tingbiao', 'cannansong', 'rc2975nyu', 'arunparth', 'shubham.mahalank']"
11,21,55,11,10,"['jesus.lozano', 'luis.ascencio', 'jose.trujillo', 'manuel.guel', 'mauricio.lopez', 'erick.padilla', 'luzvani', 'daniel.camacho', 'cesar.sanchez', 'armando.martinez']",44,"['preet58', 'navjinder12', 'hkz5032', 'oogii1998', 'jaw6297', 'bgutierrez', 'liamjthomson18948389', 'naharin10', 'tsendee', 'grhu996', 'tfs5093', 'gizemkaraca', 'dsm5388', 'sdyfbew', 'cjw5647', 'siao', 'fjj5032', 'ac7431', 'emilygroves18908496', 'davyn', 'as12033', 'nymkan756', 'mikeyu1997', 'djb84', 'tornado_u', 'kevinberwick', 'zh1246', 'rsc5261', 'yaozu', 'luz.valtierra', 'saa5966', 'swagatam.chaitali', 'lh2754', 'ytsong95', 'dfl', 'weekmooz', 'navaneeth.tp', 'wndgml3370', 'sgu20131429', 'tingbiao', 'cannansong', 'rc2975nyu', 'arunparth', 'shubham.mahalank']",1,[None],55,"['preet58', 'navjinder12', 'hkz5032', 'manuel.guel', 'oogii1998', 'daniel.camacho', 'erick.padilla', 'jaw6297', 'bgutierrez', 'liamjthomson18948389', 'naharin10', 'tsendee', 'grhu996', 'tfs5093', 'gizemkaraca', 'luis.ascencio', 'jose.trujillo', 'dsm5388', 'sdyfbew', 'cjw5647', 'luzvani', 'siao', 'cesar.sanchez', 'fjj5032', 'ac7431', 'emilygroves18908496', 'davyn', 'as12033', 'nymkan756', 'mikeyu1997', 'djb84', 'tornado_u', 'armando.martinez', 'kevinberwick', 'zh1246', 'rsc5261', 'yaozu', None, 'luz.valtierra', 'saa5966', 'swagatam.chaitali', 'lh2754', 'ytsong95', 'jesus.lozano', 'dfl', 'weekmooz', 'navaneeth.tp', 'wndgml3370', 'mauricio.lopez', 'sgu20131429', 'tingbiao', 'cannansong', 'rc2975nyu', 'arunparth', 'shubham.mahalank']"
11,8,55,10,9,"['jesus.lozano', 'luis.ascencio', 'jose.trujillo', 'manuel.guel', 'mauricio.lopez', 'erick.padilla', 'daniel.camacho', 'armando.martinez', 'luz.valtierra']",45,"['preet58', 'navjinder12', 'hkz5032', 'oogii1998', 'jaw6297', 'bgutierrez', 'liamjthomson18948389', 'naharin10', 'tsendee', 'grhu996', 'tfs5093', 'gizemkaraca', 'dsm5388', 'sdyfbew', 'cjw5647', 'luzvani', 'siao', 'cesar.sanchez', 'fjj5032', 'ac7431', 'emilygroves18908496', 'davyn', 'as12033', 'nymkan756', 'mikeyu1997', 'djb84', 'tornado_u', 'kevinberwick', 'zh1246', 'rsc5261', 'yaozu', 'saa5966', 'swagatam.chaitali', 'lh2754', 'ytsong95', 'dfl', 'weekmooz', 'navaneeth.tp', 'wndgml3370', 'sgu20131429', 'tingbiao', 'cannansong', 'rc2975nyu', 'arunparth', 'shubham.mahalank']",1,[None],55,"['preet58', 'navjinder12', 'hkz5032', 'manuel.guel', 'oogii1998', 'daniel.camacho', 'erick.padilla', 'jaw6297', 'bgutierrez', 'liamjthomson18948389', 'naharin10', 'tsendee', 'grhu996', 'tfs5093', 'gizemkaraca', 'luis.ascencio', 'jose.trujillo', 'dsm5388', 'sdyfbew', 'cjw5647', 'luzvani', 'siao', 'cesar.sanchez', 'fjj5032', 'ac7431', 'emilygroves18908496', 'davyn', 'as12033', 'nymkan756', 'mikeyu1997', 'djb84', 'tornado_u', 'armando.martinez', 'kevinberwick', 'zh1246', 'rsc5261', 'yaozu', None, 'luz.valtierra', 'saa5966', 'swagatam.chaitali', 'lh2754', 'ytsong95', 'jesus.lozano', 'dfl', 'weekmooz', 'navaneeth.tp', 'wndgml3370', 'mauricio.lopez', 'sgu20131429', 'tingbiao', 'cannansong', 'rc2975nyu', 'arunparth', 'shubham.mahalank']"
11,11,55,7,4,"['preet58', 'liamjthomson18948389', 'navjinder12', 'emilygroves18908496']",50,"['hkz5032', 'manuel.guel', 'oogii1998', 'daniel.camacho', 'erick.padilla', 'jaw6297', 'bgutierrez', 'naharin10', 'tsendee', 'grhu996', 'tfs5093', 'gizemkaraca', 'luis.ascencio', 'jose.trujillo', 'dsm5388', 'sdyfbew', 'cjw5647', 'luzvani', 'siao', 'cesar.sanchez', 'fjj5032', 'ac7431', 'davyn', 'as12033', 'nymkan756', 'mikeyu1997', 'djb84', 'tornado_u', 'armando.martinez', 'kevinberwick', 'zh1246', 'rsc5261', 'yaozu', 'luz.valtierra', 'saa5966', 'swagatam.chaitali', 'lh2754', 'ytsong95', 'jesus.lozano', 'dfl', 'weekmooz', 'navaneeth.tp', 'wndgml3370', 'mauricio.lopez', 'sgu20131429', 'tingbiao', 'cannansong', 'rc2975nyu', 'arunparth', 'shubham.mahalank']",3,"['seeyoong', None, 'ltu18935122']",57,"['seeyoong', 'preet58', 'navjinder12', 'hkz5032', 'manuel.guel', 'oogii1998', 'daniel.camacho', 'erick.padilla', 'jaw6297', 'bgutierrez', 'liamjthomson18948389', 'naharin10', 'tsendee', 'grhu996', 'tfs5093', 'gizemkaraca', 'luis.ascencio', 'jose.trujillo', 'dsm5388', 'sdyfbew', 'cjw5647', 'luzvani', 'siao', 'cesar.sanchez', 'fjj5032', 'ac7431', 'emilygroves18908496', 'davyn', 'as12033', 'nymkan756', 'mikeyu1997', 'djb84', 'tornado_u', 'armando.martinez', 'kevinberwick', 'zh1246', 'rsc5261', 'yaozu', None, 'luz.valtierra', 'ltu18935122', 'saa5966', 'swagatam.chaitali', 'lh2754', 'ytsong95', 'jesus.lozano', 'dfl', 'weekmooz', 'navaneeth.tp', 'wndgml3370', 'mauricio.lopez', 'sgu20131429', 'tingbiao', 'cannansong', 'rc2975nyu', 'arunparth', 'shubham.mahalank']"
11,137,55,7,4,"['preet58', 'liamjthomson18948389', 'navjinder12', 'emilygroves18908496']",50,"['hkz5032', 'manuel.guel', 'oogii1998', 'daniel.camacho', 'erick.padilla', 'jaw6297', 'bgutierrez', 'naharin10', 'tsendee', 'grhu996', 'tfs5093', 'gizemkaraca', 'luis.ascencio', 'jose.trujillo', 'dsm5388', 'sdyfbew', 'cjw5647', 'luzvani', 'siao', 'cesar.sanchez', 'fjj5032', 'ac7431', 'davyn', 'as12033', 'nymkan756', 'mikeyu1997', 'djb84', 'tornado_u', 'armando.martinez', 'kevinberwick', 'zh1246', 'rsc5261', 'yaozu', 'luz.valtierra', 'saa5966', 'swagatam.chaitali', 'lh2754', 'ytsong95', 'jesus.lozano', 'dfl', 'weekmooz', 'navaneeth.tp', 'wndgml3370', 'mauricio.lopez', 'sgu20131429', 'tingbiao', 'cannansong', 'rc2975nyu', 'arunparth', 'shubham.mahalank']",3,"['seeyoong', None, 'ltu18935122']",57,"['seeyoong', 'preet58', 'navjinder12', 'hkz5032', 'manuel.guel', 'oogii1998', 'daniel.camacho', 'erick.padilla', 'jaw6297', 'bgutierrez', 'liamjthomson18948389', 'naharin10', 'tsendee', 'grhu996', 'tfs5093', 'gizemkaraca', 'luis.ascencio', 'jose.trujillo', 'dsm5388', 'sdyfbew', 'cjw5647', 'luzvani', 'siao', 'cesar.sanchez', 'fjj5032', 'ac7431', 'emilygroves18908496', 'davyn', 'as12033', 'nymkan756', 'mikeyu1997', 'djb84', 'tornado_u', 'armando.martinez', 'kevinberwick', 'zh1246', 'rsc5261', 'yaozu', None, 'luz.valtierra', 'ltu18935122', 'saa5966', 'swagatam.chaitali', 'lh2754', 'ytsong95', 'jesus.lozano', 'dfl', 'weekmooz', 'navaneeth.tp', 'wndgml3370', 'mauricio.lopez', 'sgu20131429', 'tingbiao', 'cannansong', 'rc2975nyu', 'arunparth', 'shubham.mahalank']"
11,19,55,6,1,['tsendee'],53,"['preet58', 'navjinder12', 'hkz5032', 'manuel.guel', 'oogii1998', 'daniel.camacho', 'erick.padilla', 'jaw6297', 'bgutierrez', 'liamjthomson18948389', 'naharin10', 'grhu996', 'tfs5093', 'gizemkaraca', 'luis.ascencio', 'jose.trujillo', 'dsm5388', 'sdyfbew', 'cjw5647', 'luzvani', 'siao', 'cesar.sanchez', 'fjj5032', 'ac7431', 'emilygroves18908496', 'davyn', 'as12033', 'nymkan756', 'mikeyu1997', 'djb84', 'tornado_u', 'armando.martinez', 'kevinberwick', 'zh1246', 'rsc5261', 'yaozu', 'luz.valtierra', 'saa5966', 'swagatam.chaitali', 'lh2754', 'ytsong95', 'jesus.lozano', 'dfl', 'weekmooz', 'navaneeth.tp', 'wndgml3370', 'mauricio.lopez', 'sgu20131429', 'tingbiao', 'cannansong', 'rc2975nyu', 'arunparth', 'shubham.mahalank']",5,"['anudarid6', 'battulga9192', 'bymbaa6789', 'sumyafire1', None]",59,"['preet58', 'navjinder12', 'hkz5032', 'manuel.guel', 'oogii1998', 'battulga9192', 'daniel.camacho', 'erick.padilla', 'bymbaa6789', 'jaw6297', 'bgutierrez', 'liamjthomson18948389', 'naharin10', 'tsendee', 'grhu996', 'tfs5093', 'gizemkaraca', 'luis.ascencio', 'jose.trujillo', 'dsm5388', 'sdyfbew', 'cjw5647', 'luzvani', 'siao', 'cesar.sanchez', 'fjj5032', 'ac7431', 'emilygroves18908496', 'davyn', 'anudarid6', 'as12033', 'nymkan756', 'mikeyu1997', 'djb84', 'tornado_u', 'armando.martinez', 'kevinberwick', 'zh1246', 'rsc5261', 'yaozu', None, 'luz.valtierra', 'saa5966', 'swagatam.chaitali', 'lh2754', 'ytsong95', 'jesus.lozano', 'dfl', 'weekmooz', 'navaneeth.tp', 'wndgml3370', 'mauricio.lopez', 'sgu20131429', 'sumyafire1', 'tingbiao', 'cannansong', 'rc2975nyu', 'arunparth', 'shubham.mahalank']"
12,346,52,50,48,"['agustingiussani419', 'mazzoni100', 'gabriele.c396', 'lorenzolaveneziana96', 'andreaiadarola', 'cuiguiyang', 'wangshixian922', 'davide123', 'armankianirad', 'politecnico', 's264651', 'fefo.cardile', 'carmeladfr95', 'mariaclaradicesare14', 'mr.hejianlong', 'davide.fittipaldi', 'giacomosergi96', 'xiejin', 'giulialuparia', 'martap95', 'flaminia95', 'gasgas300', 'eddodavalos', 'luigi1996', 'marco.rave.mr', 'guochao', 'beatrice96', 'nichrh_95', 'a_giuliano', 'xale95', 'abdujalol.usmanov', 'cubo96on', 'fabiopastorino.1993', 'annapaolazingarelli96', 'saeed2428', 'behzod1996.06', 'fabry180', 'ilariabushati', 'maria.fazio', 'alby.luzio', 'chavezaugusto2', 'amirgrbn74', 'amatodanilo95', 'vittix96', 'michelemorani', 'riccardom96', 'zhangxiu000', 'frankcapone95']",3,"['luca.savigliano', 'massimiliano1995', 's266700']",2,"['matteo.fasano', None]",53,"['agustingiussani419', 'gabriele.c396', 'andreaiadarola', 'davide123', 'davide.fittipaldi', 'giacomosergi96', 'xiejin', 'giulialuparia', 'flaminia95', 'gasgas300', 'eddodavalos', 'luigi1996', 'marco.rave.mr', 'beatrice96', 'xale95', 'abdujalol.usmanov', 'cubo96on', 'annapaolazingarelli96', 'saeed2428', 'behzod1996.06', 'matteo.fasano', 'alby.luzio', 'chavezaugusto2', 'amirgrbn74', 'carmeladfr95', 'mazzoni100', 'lorenzolaveneziana96', 'massimiliano1995', 'cuiguiyang', 'wangshixian922', 'armankianirad', 'politecnico', 's264651', 'fefo.cardile', 'mariaclaradicesare14', 'mr.hejianlong', 's266700', 'martap95', 'guochao', 'nichrh_95', 'a_giuliano', 'fabiopastorino.1993', None, 'fabry180', 'ilariabushati', 'luca.savigliano', 'maria.fazio', 'amatodanilo95', 'vittix96', 'michelemorani', 'riccardom96', 'zhangxiu000', 'frankcapone95']"
13,217,50,52,48,"['malba', 'ziraza', 'mswin', 'ytaeyang', 'markwang', 'simba888', 'birdboy', 'dmolivei', 'alecr', 'saway', 'jkmason', 'makoli', 'jbuegel', 'jsputnam', 'bradyrob', 'aflorman', 'raetaylor', 'jiaminch', 'astrong', 'coll428', 'bjamadagni', 'jms094', 'jewski', 'rjbalbin', 'chiyuan97', 'mdengquist', 'shenghan19', 'ohyli1997', 'ethawsaw', 'ericzz35', 'kaigoodman', 'avignes31', 'pgcarls', 'edstone', 'cmsmudde', 'kganesan1', 'asdsgsg', 'priya9598', 'aleckschwartz', 'nshlesin', 'saffrondon', 'wgmoore', 'ehvicta', 'louzhong', 'itparson', 'adlwang', 'irphilli', 'dpsnider']",1,['surfingslow'],4,"['ksilva', None, 'petercarlson05', 'dllivsch']",53,"['ziraza', 'markwang', 'simba888', 'dllivsch', 'birdboy', 'alecr', 'saway', 'bradyrob', 'aflorman', 'jiaminch', 'astrong', 'jewski', 'rjbalbin', 'ericzz35', 'avignes31', 'edstone', 'cmsmudde', 'asdsgsg', 'nshlesin', 'wgmoore', 'ehvicta', 'ksilva', 'itparson', 'malba', 'mswin', 'surfingslow', 'ytaeyang', 'dmolivei', 'makoli', 'jkmason', 'jbuegel', 'jsputnam', 'raetaylor', 'bjamadagni', 'coll428', 'jms094', 'chiyuan97', 'mdengquist', 'shenghan19', 'ohyli1997', 'ethawsaw', 'kaigoodman', 'pgcarls', 'kganesan1', 'priya9598', 'aleckschwartz', 'petercarlson05', 'saffrondon', None, 'louzhong', 'adlwang', 'irphilli', 'dpsnider']"
13,218,50,12,1,['surfingslow'],48,"['malba', 'ziraza', 'mswin', 'ytaeyang', 'markwang', 'simba888', 'birdboy', 'dmolivei', 'alecr', 'saway', 'jkmason', 'makoli', 'jbuegel', 'jsputnam', 'bradyrob', 'aflorman', 'raetaylor', 'jiaminch', 'astrong', 'coll428', 'bjamadagni', 'jms094', 'jewski', 'rjbalbin', 'chiyuan97', 'mdengquist', 'shenghan19', 'ohyli1997', 'ethawsaw', 'ericzz35', 'kaigoodman', 'avignes31', 'pgcarls', 'edstone', 'cmsmudde', 'kganesan1', 'asdsgsg', 'priya9598', 'aleckschwartz', 'nshlesin', 'saffrondon', 'wgmoore', 'ehvicta', 'louzhong', 'itparson', 'adlwang', 'irphilli', 'dpsnider']",11,"['racotter', 'davisloen', 'iblackbu', 'lbagbyy', 'tecatetrav', 'thomas.s.busse', 'jhulfach', None, 'eoreste', 'benjaminvf', 'mbkivy']",60,"['malba', 'ziraza', 'mswin', 'racotter', 'surfingslow', 'ytaeyang', 'markwang', 'simba888', 'birdboy', 'dmolivei', 'alecr', 'tecatetrav', 'saway', 'makoli', 'jkmason', 'jbuegel', 'jsputnam', 'bradyrob', 'jhulfach', 'aflorman', 'eoreste', 'raetaylor', 'jiaminch', 'astrong', 'coll428', 'bjamadagni', 'jms094', 'jewski', 'rjbalbin', 'chiyuan97', 'mdengquist', 'lbagbyy', 'shenghan19', 'ohyli1997', 'ethawsaw', 'ericzz35', 'kaigoodman', 'thomas.s.busse', 'avignes31', 'pgcarls', 'davisloen', 'edstone', 'cmsmudde', 'kganesan1', 'asdsgsg', 'iblackbu', 'priya9598', 'aleckschwartz', 'nshlesin', 'saffrondon', 'wgmoore', None, 'benjaminvf', 'ehvicta', 'louzhong', 'itparson', 'adlwang', 'irphilli', 'dpsnider', 'mbkivy']"
14,51,49,50,48,"['genesisliang', 'jake2849', 'pedro.munoz003', 'rafe45921', 'smagpantay', 'sgulguleu', 'tawalker16', 'abeld23', 'zweisblatt', 'e.e.ladron', 'nmiller95', 'laurenlester', 'mql', 'brandon_gould', 'gandorofthewoods', 'colleenweller', 'niturrioz', 'kishanpateluf', 'k.schmelzle', 'jbausch97', 'christauffer98', 'lsigmund98', 'joshuajaime', 'vonh8704', 'ariheyd', 'mfnaviag', 'kevindestefano', 'kitts4114', 'amb0516', 'oliviabrandel36', 'gapittman', 'ria97alyssa', 'amberhawthorne', 'abloftus', 'ryanprescott', 'woodsnib', 'victoriawilliams1234', 'rschrope', 'nbontems', 'ibean', 'paycinena', 'aaronbar918', 'carsonallen704', 'bbenzenberg', 'flyingcodfish', 'eric4707', 'argho7x7', 'anthony7131998']",0,[],2,"[None, 'antural']",50,"['genesisliang', 'smagpantay', 'abeld23', 'zweisblatt', 'gandorofthewoods', 'brandon_gould', 'kishanpateluf', 'lsigmund98', 'christauffer98', 'mfnaviag', 'kitts4114', 'oliviabrandel36', 'gapittman', 'ria97alyssa', 'amberhawthorne', 'abloftus', 'ryanprescott', 'rschrope', 'nbontems', 'ibean', 'paycinena', 'aaronbar918', 'flyingcodfish', 'eric4707', 'argho7x7', 'jake2849', 'pedro.munoz003', 'rafe45921', 'sgulguleu', 'tawalker16', 'e.e.ladron', 'nmiller95', 'laurenlester', 'mql', 'colleenweller', 'niturrioz', 'k.schmelzle', 'jbausch97', 'joshuajaime', 'vonh8704', 'ariheyd', 'kevindestefano', 'amb0516', None, 'woodsnib', 'victoriawilliams1234', 'antural', 'carsonallen704', 'bbenzenberg', 'anthony7131998']"
14,279,49,48,46,"['genesisliang', 'jake2849', 'pedro.munoz003', 'smagpantay', 'sgulguleu', 'tawalker16', 'abeld23', 'zweisblatt', 'e.e.ladron', 'nmiller95', 'laurenlester', 'mql', 'brandon_gould', 'gandorofthewoods', 'colleenweller', 'kishanpateluf', 'lsigmund98', 'k.schmelzle', 'christauffer98', 'jbausch97', 'niturrioz', 'joshuajaime', 'vonh8704', 'ariheyd', 'mfnaviag', 'kevindestefano', 'kitts4114', 'amb0516', 'oliviabrandel36', 'gapittman', 'ria97alyssa', 'abloftus', 'ryanprescott', 'rschrope', 'woodsnib', 'victoriawilliams1234', 'amberhawthorne', 'nbontems', 'paycinena', 'ibean', 'carsonallen704', 'aaronbar918', 'bbenzenberg', 'flyingcodfish', 'eric4707', 'argho7x7']",2,"['rafe45921', 'anthony7131998']",2,"[None, 'antural']",50,"['genesisliang', 'smagpantay', 'abeld23', 'zweisblatt', 'gandorofthewoods', 'brandon_gould', 'kishanpateluf', 'lsigmund98', 'christauffer98', 'mfnaviag', 'kitts4114', 'oliviabrandel36', 'gapittman', 'ria97alyssa', 'amberhawthorne', 'abloftus', 'ryanprescott', 'rschrope', 'nbontems', 'ibean', 'paycinena', 'aaronbar918', 'flyingcodfish', 'eric4707', 'argho7x7', 'jake2849', 'pedro.munoz003', 'rafe45921', 'sgulguleu', 'tawalker16', 'e.e.ladron', 'nmiller95', 'laurenlester', 'mql', 'colleenweller', 'niturrioz', 'k.schmelzle', 'jbausch97', 'joshuajaime', 'vonh8704', 'ariheyd', 'kevindestefano', 'amb0516', None, 'woodsnib', 'victoriawilliams1234', 'antural', 'carsonallen704', 'bbenzenberg', 'anthony7131998']"
14,173,49,45,44,"['genesisliang', 'jake2849', 'pedro.munoz003', 'rafe45921', 'smagpantay', 'sgulguleu', 'tawalker16', 'abeld23', 'zweisblatt', 'e.e.ladron', 'laurenlester', 'mql', 'brandon_gould', 'gandorofthewoods', 'colleenweller', 'niturrioz', 'lsigmund98', 'christauffer98', 'jbausch97', 'joshuajaime', 'vonh8704', 'ariheyd', 'mfnaviag', 'kitts4114', 'amb0516', 'oliviabrandel36', 'gapittman', 'ria97alyssa', 'abloftus', 'ryanprescott', 'rschrope', 'woodsnib', 'victoriawilliams1234', 'amberhawthorne', 'nbontems', 'paycinena', 'ibean', 'carsonallen704', 'aaronbar918', 'bbenzenberg', 'flyingcodfish', 'eric4707', 'argho7x7', 'anthony7131998']",4,"['kevindestefano', 'kishanpateluf', 'nmiller95', 'k.schmelzle']",1,[None],49,"['genesisliang', 'smagpantay', 'abeld23', 'zweisblatt', 'gandorofthewoods', 'brandon_gould', 'kishanpateluf', 'lsigmund98', 'christauffer98', 'mfnaviag', 'kitts4114', 'oliviabrandel36', 'gapittman', 'ria97alyssa', 'amberhawthorne', 'abloftus', 'ryanprescott', 'rschrope', 'nbontems', 'ibean', 'paycinena', 'aaronbar918', 'flyingcodfish', 'eric4707', 'argho7x7', 'jake2849', 'pedro.munoz003', 'rafe45921', 'sgulguleu', 'tawalker16', 'e.e.ladron', 'nmiller95', 'laurenlester', 'mql', 'colleenweller', 'niturrioz', 'k.schmelzle', 'jbausch97', 'joshuajaime', 'vonh8704', 'ariheyd', 'kevindestefano', 'amb0516', None, 'woodsnib', 'victoriawilliams1234', 'carsonallen704', 'bbenzenberg', 'anthony7131998']"
14,280,49,18,17,"['genesisliang', 'ariheyd', 'nbontems', 'woodsnib', 'abeld23', 'ryanprescott', 'mfnaviag', 'mql', 'rafe45921', 'smagpantay', 'niturrioz', 'amb0516', 'flyingcodfish', 'gapittman', 'amberhawthorne', 'rschrope', 'anthony7131998']",31,"['jake2849', 'pedro.munoz003', 'sgulguleu', 'tawalker16', 'zweisblatt', 'e.e.ladron', 'nmiller95', 'laurenlester', 'gandorofthewoods', 'brandon_gould', 'colleenweller', 'kishanpateluf', 'k.schmelzle', 'lsigmund98', 'jbausch97', 'christauffer98', 'joshuajaime', 'vonh8704', 'kevindestefano', 'kitts4114', 'oliviabrandel36', 'ria97alyssa', 'abloftus', 'victoriawilliams1234', 'ibean', 'paycinena', 'aaronbar918', 'carsonallen704', 'bbenzenberg', 'eric4707', 'argho7x7']",1,[None],49,"['genesisliang', 'jake2849', 'pedro.munoz003', 'rafe45921', 'smagpantay', 'sgulguleu', 'tawalker16', 'abeld23', 'zweisblatt', 'e.e.ladron', 'nmiller95', 'laurenlester', 'mql', 'brandon_gould', 'gandorofthewoods', 'colleenweller', 'niturrioz', 'kishanpateluf', 'k.schmelzle', 'jbausch97', 'christauffer98', 'lsigmund98', 'joshuajaime', 'vonh8704', 'ariheyd', 'mfnaviag', 'kevindestefano', 'kitts4114', 'amb0516', 'oliviabrandel36', 'gapittman', 'ria97alyssa', 'amberhawthorne', 'abloftus', 'ryanprescott', 'woodsnib', 'victoriawilliams1234', 'rschrope', None, 'nbontems', 'ibean', 'paycinena', 'aaronbar918', 'carsonallen704', 'bbenzenberg', 'flyingcodfish', 'eric4707', 'argho7x7', 'anthony7131998']"
15,234,48,50,40,"['wkeaty2', 'cbo3', 'chguo2', 'tsehgal2', 'jkubota2', 'anirula2', 'wsuk2', 'qiuhuic2', 'domanus2', 'lsienko2', 'jjwilde2', 'shirani', 'ssutyak2', 'edimare2', 'mblaauw2', 'srb2', 'danayun2', 'naisong2', 'conanw2', 'pittges2', 'pwalke9', 'jtkach2', 'tz11', 'vtagare2', 'jungeun5', 'ablee2', 'rhalton2', 'jgruber3', 'txyang2', 'joshuas8', 'gcangi2', 'hjr2', 'anunez38', 'rvplank2', 'mw21', 'kevinjl3', 'iflueck2', 'arhode2', 'chanmin2', 'omarma2']",7,"['wtso2', 'peerawattn', 'chatchai.meena', 'marcin.d.gajewski', 'astropino', 'darkzeroman', 'wellyson']",10,"['dcpang2', 'jinwoo2', 'tss3', 'kyang37', None, 'jinsup2', 'avw2', 'zhixin2', 'hf4', 'zehuahe2']",57,"['wkeaty2', 'cbo3', 'jkubota2', 'anirula2', 'marcin.d.gajewski', 'wsuk2', 'darkzeroman', 'qiuhuic2', 'domanus2', 'wtso2', 'tss3', 'ssutyak2', 'avw2', 'astropino', 'edimare2', 'naisong2', 'kyang37', 'jtkach2', 'rhalton2', 'jgruber3', 'txyang2', 'joshuas8', 'dcpang2', 'jinwoo2', 'gcangi2', 'hjr2', 'anunez38', 'mw21', 'chanmin2', 'chguo2', 'tsehgal2', 'chatchai.meena', 'wellyson', 'lsienko2', 'jjwilde2', 'shirani', 'mblaauw2', 'srb2', 'danayun2', 'conanw2', 'pittges2', 'peerawattn', 'pwalke9', 'jinsup2', 'tz11', 'vtagare2', 'jungeun5', 'ablee2', 'zehuahe2', None, 'rvplank2', 'iflueck2', 'kevinjl3', 'zhixin2', 'hf4', 'arhode2', 'omarma2']"
16,68,43,13,10,"['mazharulislamshuvosikder', 'fahim78645', 'kabirsinthi', 'johayraprithula', 'misbah3229', 'akazad42801', 'mahi97', 'abirmamunurrahman', 'rivnatmihaf', 'tahsin2239']",32,"['prasannajit', 'aaro.lankinen', 'shrouk.e.zaki', 'abeyer', 'nancymaryrozario', 'dbsoni', 'granielharneabrenica', 'riditarahman', 'radahan', 'davod_nodet71', 'ejskoge', 'shitalnomi', 'ratul', 'f1hrishi.borate', 'slagernate', 'sanjay53', 'smural23', 'santanutalukder', 'boyang1724', 'no6', 'nishant27102', 'panchalamit270894', 'shannak', 'sreechakra', 'kiran1997', 'swadhin12a', 'milan2019', 'sebastiangurgul', 'frankccchin', 'm_maks_s', 'emaminejad', 'kvpshastri']",3,"['farhana14eshal', 'bubleedas06', None]",45,"['mazharulislamshuvosikder', 'prasannajit', 'aaro.lankinen', 'shrouk.e.zaki', 'abeyer', 'fahim78645', 'johayraprithula', 'nancymaryrozario', 'dbsoni', 'misbah3229', 'granielharneabrenica', 'akazad42801', 'riditarahman', 'radahan', 'davod_nodet71', 'bubleedas06', 'ejskoge', 'shitalnomi', 'ratul', 'f1hrishi.borate', 'slagernate', 'sanjay53', 'rivnatmihaf', 'tahsin2239', 'smural23', 'santanutalukder', 'boyang1724', 'no6', 'kabirsinthi', 'nishant27102', 'panchalamit270894', 'shannak', 'sreechakra', 'mahi97', None, 'kiran1997', 'swadhin12a', 'milan2019', 'sebastiangurgul', 'frankccchin', 'm_maks_s', 'farhana14eshal', 'emaminejad', 'abirmamunurrahman', 'kvpshastri']"
17,170,40,41,28,"['ee17btech11021', 'ananth7121999', 'pradeepmoturi', 'ee17btech11036', 'siddharthmanu500', 'ee17btech11013', 'ee17btech11014', 'ee17btech11012', 'ee17btech11050', 'sumanthcherupally', 'yash6499', 'dheerajracha', 'ee17btech11034', 'ee17btech11016', 'taruntejreddych', 'ee17btech11025', 'yogeshubbu', 'k.vamshika', 'es16btech11026', 'knsiddharth', 'prag', '124guna', 'ee17btech11037', 'falconrider10', 'pranjalshiv123', 'raktim', 'ee17btech11040', 'karthikp']",11,"['lorenzo.mazzoli', 'enricobaiano1', 'rakshu.gade', 'amritpal95', 'hassanmughal92', 'yury_matveyev', 'loris_ee', 'maicol41093', 'parimiamrit', 'federicozg96', 'alhawajri']",13,"['abhishek462000', 'ee17btech11048', 'yogeshsingiresu', None, 'ee17btech11009', 'ee17btech11030', 'ee17btech11011', 'amballaavinash', 'ee17btech11043', 'madhurima143', 'ee17btech11008', 'vallurureddykhaja', 'manideepvuppala']",52,"['amritpal95', 'ee17btech11021', 'ee17btech11036', 'ee17btech11014', 'federicozg96', 'ee17btech11012', 'ee17btech11009', 'yash6499', 'dheerajracha', 'ee17btech11011', 'ee17btech11016', 'k.vamshika', 'yogeshsingiresu', 'hassanmughal92', '124guna', 'pranjalshiv123', 'loris_ee', 'falconrider10', 'ananth7121999', 'ee17btech11030', 'karthikp', 'ee17btech11048', 'pradeepmoturi', 'siddharthmanu500', 'ee17btech11013', 'madhurima143', 'abhishek462000', 'ee17btech11008', 'manideepvuppala', 'ee17btech11050', 'rakshu.gade', 'sumanthcherupally', 'maicol41093', 'parimiamrit', 'ee17btech11034', 'ee17btech11043', 'taruntejreddych', 'alhawajri', 'ee17btech11025', 'yogeshubbu', 'lorenzo.mazzoli', 'enricobaiano1', 'es16btech11026', 'knsiddharth', 'prag', 'amballaavinash', 'vallurureddykhaja', None, 'ee17btech11037', 'yury_matveyev', 'raktim', 'ee17btech11040']"
17,169,40,34,29,"['ee17btech11021', 'pradeepmoturi', 'ee17btech11036', 'siddharthmanu500', 'ee17btech11014', 'ee17btech11013', 'ee17btech11012', 'ee17btech11050', 'sumanthcherupally', 'dheerajracha', 'yash6499', 'parimiamrit', 'ee17btech11034', 'ee17btech11016', 'taruntejreddych', 'ee17btech11025', 'yogeshubbu', 'ee17btech11040', 'k.vamshika', 'es16btech11026', 'knsiddharth', 'prag', '124guna', 'ee17btech11037', 'falconrider10', 'pranjalshiv123', 'raktim', 'ananth7121999', 'karthikp']",10,"['lorenzo.mazzoli', 'enricobaiano1', 'rakshu.gade', 'amritpal95', 'hassanmughal92', 'yury_matveyev', 'loris_ee', 'maicol41093', 'federicozg96', 'alhawajri']",5,"['ee17btech11006', 'ee17btech11048', 'kurakula.vamshika', 'emani', None]",44,"['ee17btech11006', 'ee17btech11048', 'amritpal95', 'ee17btech11021', 'pradeepmoturi', 'ee17btech11036', 'siddharthmanu500', 'ee17btech11013', 'ee17btech11014', 'federicozg96', 'ee17btech11012', 'ee17btech11050', 'rakshu.gade', 'sumanthcherupally', 'yash6499', 'dheerajracha', 'maicol41093', 'parimiamrit', 'ee17btech11034', 'ee17btech11016', 'taruntejreddych', 'alhawajri', 'ee17btech11025', 'yogeshubbu', 'lorenzo.mazzoli', 'enricobaiano1', 'ee17btech11040', 'k.vamshika', 'hassanmughal92', 'es16btech11026', 'knsiddharth', 'prag', '124guna', None, 'ee17btech11037', 'falconrider10', 'pranjalshiv123', 'kurakula.vamshika', 'yury_matveyev', 'loris_ee', 'emani', 'raktim', 'ananth7121999', 'karthikp']"
17,256,40,31,25,"['ee17btech11021', 'ananth7121999', 'pradeepmoturi', 'ee17btech11036', 'siddharthmanu500', 'ee17btech11014', 'ee17btech11013', 'ee17btech11012', 'ee17btech11050', 'sumanthcherupally', 'dheerajracha', 'ee17btech11034', 'ee17btech11016', 'taruntejreddych', 'ee17btech11025', 'k.vamshika', 'es16btech11026', 'knsiddharth', 'prag', '124guna', 'ee17btech11037', 'falconrider10', 'raktim', 'ee17btech11040', 'karthikp']",14,"['yogeshubbu', 'lorenzo.mazzoli', 'enricobaiano1', 'rakshu.gade', 'amritpal95', 'hassanmughal92', 'pranjalshiv123', 'yury_matveyev', 'yash6499', 'loris_ee', 'maicol41093', 'parimiamrit', 'federicozg96', 'alhawajri']",6,"['ee17btech11006', 'maaz777', 'aayusharora48', 'aakashdaswani', 'alexaagatha16', None]",45,"['ee17btech11006', 'amritpal95', 'ee17btech11021', 'pradeepmoturi', 'ee17btech11036', 'siddharthmanu500', 'ee17btech11013', 'ee17btech11014', 'alexaagatha16', 'federicozg96', 'ee17btech11012', 'ee17btech11050', 'rakshu.gade', 'sumanthcherupally', 'yash6499', 'dheerajracha', 'maaz777', 'maicol41093', 'parimiamrit', 'ee17btech11034', 'ee17btech11016', 'taruntejreddych', 'alhawajri', 'ee17btech11025', 'yogeshubbu', 'lorenzo.mazzoli', 'enricobaiano1', 'ee17btech11040', 'k.vamshika', 'hassanmughal92', 'es16btech11026', 'knsiddharth', 'prag', 'aakashdaswani', '124guna', None, 'ee17btech11037', 'falconrider10', 'pranjalshiv123', 'yury_matveyev', 'loris_ee', 'aayusharora48', 'raktim', 'ananth7121999', 'karthikp']"
17,171,40,10,1,['rakshu.gade'],38,"['amritpal95', 'ee17btech11021', 'ananth7121999', 'pradeepmoturi', 'ee17btech11036', 'siddharthmanu500', 'ee17btech11013', 'ee17btech11014', 'federicozg96', 'ee17btech11012', 'ee17btech11050', 'sumanthcherupally', 'yash6499', 'dheerajracha', 'maicol41093', 'parimiamrit', 'ee17btech11034', 'ee17btech11016', 'taruntejreddych', 'alhawajri', 'ee17btech11025', 'yogeshubbu', 'lorenzo.mazzoli', 'enricobaiano1', 'k.vamshika', 'hassanmughal92', 'es16btech11026', 'knsiddharth', 'prag', '124guna', 'ee17btech11037', 'falconrider10', 'pranjalshiv123', 'yury_matveyev', 'loris_ee', 'raktim', 'ee17btech11040', 'karthikp']",9,"['ameyabane', 'rahulkulkarni301', 'shivraj14', 'ajinkyametange', 'siddhikadam', 'ghodkebharati467', 'vineetkotariya', None, 'hbg2112']",48,"['ameyabane', 'amritpal95', 'ee17btech11021', 'pradeepmoturi', 'ajinkyametange', 'ee17btech11036', 'siddharthmanu500', 'ee17btech11013', 'ee17btech11014', 'federicozg96', 'ee17btech11012', 'ee17btech11050', 'rakshu.gade', 'sumanthcherupally', 'yash6499', 'dheerajracha', 'maicol41093', 'parimiamrit', 'ee17btech11034', 'siddhikadam', 'ee17btech11016', 'taruntejreddych', 'vineetkotariya', 'alhawajri', 'ee17btech11025', 'yogeshubbu', 'lorenzo.mazzoli', 'enricobaiano1', 'ee17btech11040', 'k.vamshika', 'rahulkulkarni301', 'hassanmughal92', 'es16btech11026', 'knsiddharth', 'prag', 'ghodkebharati467', '124guna', None, 'hbg2112', 'ee17btech11037', 'falconrider10', 'pranjalshiv123', 'shivraj14', 'yury_matveyev', 'loris_ee', 'raktim', 'ananth7121999', 'karthikp']"
17,257,40,8,6,"['sumanthcherupally', 'yash6499', 'ee17btech11036', 'raktim', 'ee17btech11014', 'ananth7121999']",33,"['amritpal95', 'ee17btech11021', 'pradeepmoturi', 'siddharthmanu500', 'ee17btech11013', 'federicozg96', 'ee17btech11012', 'ee17btech11050', 'rakshu.gade', 'dheerajracha', 'maicol41093', 'parimiamrit', 'ee17btech11034', 'ee17btech11016', 'taruntejreddych', 'alhawajri', 'ee17btech11025', 'yogeshubbu', 'lorenzo.mazzoli', 'enricobaiano1', 'ee17btech11040', 'k.vamshika', 'hassanmughal92', 'es16btech11026', 'knsiddharth', 'prag', '124guna', 'ee17btech11037', 'falconrider10', 'pranjalshiv123', 'yury_matveyev', 'loris_ee', 'karthikp']",2,"['ee17btech11006', None]",41,"['ee17btech11006', 'amritpal95', 'ee17btech11021', 'pradeepmoturi', 'ee17btech11036', 'siddharthmanu500', 'ee17btech11013', 'ee17btech11014', 'federicozg96', 'ee17btech11012', 'ee17btech11050', 'rakshu.gade', 'sumanthcherupally', 'yash6499', 'dheerajracha', 'maicol41093', 'parimiamrit', 'ee17btech11034', 'ee17btech11016', 'taruntejreddych', 'alhawajri', 'ee17btech11025', 'yogeshubbu', 'lorenzo.mazzoli', 'enricobaiano1', 'ee17btech11040', 'k.vamshika', 'hassanmughal92', 'es16btech11026', 'knsiddharth', 'prag', '124guna', None, 'ee17btech11037', 'falconrider10', 'pranjalshiv123', 'yury_matveyev', 'loris_ee', 'raktim', 'ananth7121999', 'karthikp']"
17,168,40,7,5,"['lorenzo.mazzoli', 'enricobaiano1', 'amritpal95', 'loris_ee', 'maicol41093']",34,"['ee17btech11021', 'pradeepmoturi', 'ee17btech11036', 'siddharthmanu500', 'ee17btech11013', 'ee17btech11014', 'federicozg96', 'ee17btech11012', 'ee17btech11050', 'rakshu.gade', 'sumanthcherupally', 'yash6499', 'dheerajracha', 'parimiamrit', 'ee17btech11034', 'ee17btech11016', 'taruntejreddych', 'alhawajri', 'ee17btech11025', 'yogeshubbu', 'ee17btech11040', 'k.vamshika', 'hassanmughal92', 'es16btech11026', 'knsiddharth', 'prag', '124guna', 'ee17btech11037', 'falconrider10', 'pranjalshiv123', 'yury_matveyev', 'raktim', 'ananth7121999', 'karthikp']",2,"[None, 'mattiasaccaggi']",41,"['amritpal95', 'ee17btech11021', 'pradeepmoturi', 'ee17btech11036', 'siddharthmanu500', 'ee17btech11013', 'ee17btech11014', 'federicozg96', 'ee17btech11012', 'ee17btech11050', 'rakshu.gade', 'sumanthcherupally', 'yash6499', 'dheerajracha', 'maicol41093', 'parimiamrit', 'ee17btech11034', 'ee17btech11016', 'taruntejreddych', 'alhawajri', 'ee17btech11025', 'yogeshubbu', 'lorenzo.mazzoli', 'enricobaiano1', 'ee17btech11040', 'k.vamshika', 'hassanmughal92', 'es16btech11026', 'knsiddharth', 'prag', '124guna', None, 'mattiasaccaggi', 'ee17btech11037', 'falconrider10', 'pranjalshiv123', 'yury_matveyev', 'loris_ee', 'raktim', 'ananth7121999', 'karthikp']"
17,259,40,7,4,"['yogeshubbu', 'falconrider10', 'raktim', 'ee17btech11014']",35,"['amritpal95', 'ee17btech11021', 'pradeepmoturi', 'ee17btech11036', 'siddharthmanu500', 'ee17btech11013', 'federicozg96', 'ee17btech11012', 'ee17btech11050', 'rakshu.gade', 'sumanthcherupally', 'yash6499', 'dheerajracha', 'maicol41093', 'parimiamrit', 'ee17btech11034', 'ee17btech11016', 'taruntejreddych', 'alhawajri', 'ee17btech11025', 'lorenzo.mazzoli', 'enricobaiano1', 'ee17btech11040', 'k.vamshika', 'hassanmughal92', 'es16btech11026', 'knsiddharth', 'prag', '124guna', 'ee17btech11037', 'pranjalshiv123', 'yury_matveyev', 'loris_ee', 'ananth7121999', 'karthikp']",3,"[None, 'ee17btech11009', 'manideepvuppala']",42,"['amritpal95', 'ee17btech11021', 'pradeepmoturi', 'ee17btech11036', 'siddharthmanu500', 'ee17btech11013', 'ee17btech11014', 'federicozg96', 'manideepvuppala', 'ee17btech11012', 'ee17btech11050', 'rakshu.gade', 'sumanthcherupally', 'ee17btech11009', 'yash6499', 'dheerajracha', 'maicol41093', 'parimiamrit', 'ee17btech11034', 'ee17btech11016', 'taruntejreddych', 'alhawajri', 'ee17btech11025', 'yogeshubbu', 'lorenzo.mazzoli', 'enricobaiano1', 'ee17btech11040', 'k.vamshika', 'hassanmughal92', 'es16btech11026', 'knsiddharth', 'prag', '124guna', None, 'ee17btech11037', 'falconrider10', 'pranjalshiv123', 'yury_matveyev', 'loris_ee', 'raktim', 'ananth7121999', 'karthikp']"
18,64,38,53,37,"['kabdulsayed', 'ritaj345', 'fatemah.aleid37', 'anwarekhrais1', 'nada96', 'moudhima', 'eng.nawafr', 'akalothainah59', 'hawraalsahhaf', 'heba.30936.aum', 'shaikhalameer97', 'mackintosha7', 'aishah', 'poyaka619', 'sarahnano1', 'aahmadi71995', 'hjyagout30936', 'mariamrald.2169', 'shahadalmotairi', 'shaikha.alameer97', 'fatemah96', 'mjmutairi', 'ahmadshamsaldeen96', 'fatemahkhaled1998', 'rzouf', 'fabualhasan6', 'youq8_1', 'atoooma18', 'hmdmyabb', 'shaikhahboareki', 'gooz1915', 'nopha96', 'saroom96', 'fajeralanzi56', 'fatmaaalsarhan39', 'asultan1996', 'alshammarih96']",0,[],16,"['bilel.neji', 'ruqaya30aum', 'akarar', 'abdullah.s.karar', 'rtalturkomani', 'farahaljasser97', 'cerebrus989', 'wafarag', 'hadeel.lsoc', 'teyrxq8', 'latifa', 'mjmutairi6', 'azizalshaban', 'fajer92', None, 'shaikhah30121']",53,"['anwarekhrais1', 'cerebrus989', 'nada96', 'moudhima', 'akalothainah59', 'hawraalsahhaf', 'heba.30936.aum', 'mackintosha7', 'sarahnano1', 'hjyagout30936', 'hadeel.lsoc', 'mariamrald.2169', 'shaikha.alameer97', 'fatemah96', 'fajer92', 'mjmutairi', 'akarar', 'ahmadshamsaldeen96', 'fatemahkhaled1998', 'teyrxq8', 'fabualhasan6', 'youq8_1', 'mjmutairi6', 'azizalshaban', 'nopha96', 'saroom96', 'ruqaya30aum', 'rtalturkomani', 'fatmaaalsarhan39', 'asultan1996', 'alshammarih96', 'bilel.neji', 'ritaj345', 'kabdulsayed', 'fatemah.aleid37', 'wafarag', 'eng.nawafr', 'shaikhalameer97', 'aishah', 'poyaka619', 'aahmadi71995', 'farahaljasser97', 'latifa', 'shahadalmotairi', 'shaikhah30121', 'rzouf', 'atoooma18', 'hmdmyabb', 'shaikhahboareki', 'gooz1915', None, 'abdullah.s.karar', 'fajeralanzi56']"
18,308,38,10,3,"['aishah', 'nopha96', 'heba.30936.aum']",34,"['kabdulsayed', 'ritaj345', 'fatemah.aleid37', 'anwarekhrais1', 'nada96', 'moudhima', 'eng.nawafr', 'akalothainah59', 'hawraalsahhaf', 'shaikhalameer97', 'mackintosha7', 'poyaka619', 'sarahnano1', 'aahmadi71995', 'hjyagout30936', 'mariamrald.2169', 'shahadalmotairi', 'shaikha.alameer97', 'fatemah96', 'mjmutairi', 'ahmadshamsaldeen96', 'fatemahkhaled1998', 'rzouf', 'fabualhasan6', 'youq8_1', 'atoooma18', 'hmdmyabb', 'shaikhahboareki', 'gooz1915', 'saroom96', 'fajeralanzi56', 'fatmaaalsarhan39', 'asultan1996', 'alshammarih96']",7,"['abstraxt', 's41751', 'anfal', 'wafarag', 'alyaasm96', 'bilaljaba', None]",44,"['ritaj345', 'kabdulsayed', 'fatemah.aleid37', 'anwarekhrais1', 's41751', 'wafarag', 'nada96', 'moudhima', 'alyaasm96', 'eng.nawafr', 'akalothainah59', 'hawraalsahhaf', 'shaikhalameer97', 'heba.30936.aum', 'mackintosha7', 'aishah', 'poyaka619', 'abstraxt', 'sarahnano1', 'aahmadi71995', 'hjyagout30936', 'mariamrald.2169', 'shahadalmotairi', 'shaikha.alameer97', 'bilaljaba', 'fatemah96', 'mjmutairi', 'ahmadshamsaldeen96', 'anfal', 'fatemahkhaled1998', 'rzouf', 'fabualhasan6', 'youq8_1', 'atoooma18', 'hmdmyabb', 'shaikhahboareki', 'gooz1915', 'nopha96', None, 'saroom96', 'fajeralanzi56', 'fatmaaalsarhan39', 'asultan1996', 'alshammarih96']"
19,373,36,42,35,"['parthbhide314', 'm8porterfield', 'delorm', 'willil13', 'yyf97', 'victor.chen623', 'jmweinstein2', 'pena.carlos056', 'jnlloyd10', 'hovhaa', 'hanchuan', 'dang4213', 'mimiwilliams', 'yangd9', 'iskatel42', 'ryleejc', 'kevindavis11', 'schasen97', 'pmehta97', 'alicechiu1126', 'alexperkins828', 'madigc3', 'atablizo6', 'abhishandy', 'keblinski', 'dkzr2015', 'millerp97', 'stormermatthew', 'apecoraro', 'keslern', 'kubicf', 'alianna.maguire', 'tgrounds33', 'quartincz', 'les']",0,[],7,"['naomi.williams903', 'kondrb', 'tashit', 'feraca', 'wenzhuoqun', 'macdoc', None]",42,"['parthbhide314', 'kondrb', 'delorm', 'tashit', 'willil13', 'yyf97', 'wenzhuoqun', 'jnlloyd10', 'hanchuan', 'mimiwilliams', 'iskatel42', 'ryleejc', 'feraca', 'macdoc', 'alexperkins828', 'atablizo6', 'keblinski', 'dkzr2015', 'quartincz', 'les', 'naomi.williams903', 'm8porterfield', 'victor.chen623', 'jmweinstein2', 'pena.carlos056', 'hovhaa', 'dang4213', 'yangd9', 'kevindavis11', 'schasen97', 'pmehta97', 'alicechiu1126', 'madigc3', 'abhishandy', 'millerp97', 'stormermatthew', 'apecoraro', None, 'keslern', 'kubicf', 'alianna.maguire', 'tgrounds33']"
19,370,36,39,34,"['parthbhide314', 'm8porterfield', 'delorm', 'willil13', 'yyf97', 'victor.chen623', 'jmweinstein2', 'pena.carlos056', 'jnlloyd10', 'hovhaa', 'hanchuan', 'dang4213', 'mimiwilliams', 'yangd9', 'iskatel42', 'ryleejc', 'kevindavis11', 'schasen97', 'pmehta97', 'alicechiu1126', 'alexperkins828', 'madigc3', 'atablizo6', 'abhishandy', 'dkzr2015', 'millerp97', 'stormermatthew', 'apecoraro', 'keslern', 'kubicf', 'alianna.maguire', 'tgrounds33', 'quartincz', 'les']",1,['keblinski'],5,"['kondrb', 'tashit', 'feraca', 'wenzhuoqun', None]",40,"['parthbhide314', 'kondrb', 'm8porterfield', 'delorm', 'tashit', 'willil13', 'yyf97', 'wenzhuoqun', 'victor.chen623', 'jmweinstein2', 'pena.carlos056', 'jnlloyd10', 'hanchuan', 'hovhaa', 'dang4213', 'mimiwilliams', 'yangd9', 'iskatel42', 'ryleejc', 'kevindavis11', 'feraca', 'schasen97', 'pmehta97', 'alicechiu1126', 'alexperkins828', 'madigc3', 'atablizo6', 'abhishandy', 'keblinski', 'dkzr2015', 'millerp97', 'stormermatthew', 'apecoraro', None, 'keslern', 'kubicf', 'alianna.maguire', 'tgrounds33', 'quartincz', 'les']"
19,371,36,36,31,"['parthbhide314', 'm8porterfield', 'delorm', 'willil13', 'yyf97', 'victor.chen623', 'pena.carlos056', 'jnlloyd10', 'hovhaa', 'hanchuan', 'dang4213', 'mimiwilliams', 'yangd9', 'iskatel42', 'ryleejc', 'kevindavis11', 'schasen97', 'pmehta97', 'alicechiu1126', 'alexperkins828', 'madigc3', 'atablizo6', 'dkzr2015', 'millerp97', 'stormermatthew', 'keslern', 'kubicf', 'alianna.maguire', 'tgrounds33', 'quartincz', 'les']",4,"['jmweinstein2', 'abhishandy', 'apecoraro', 'keblinski']",5,"['naomi.williams903', 'kondrb', 'wenzhuoqun', 'macdoc', None]",40,"['naomi.williams903', 'parthbhide314', 'kondrb', 'm8porterfield', 'delorm', 'willil13', 'yyf97', 'wenzhuoqun', 'victor.chen623', 'jmweinstein2', 'pena.carlos056', 'jnlloyd10', 'hanchuan', 'hovhaa', 'dang4213', 'mimiwilliams', 'yangd9', 'iskatel42', 'ryleejc', 'kevindavis11', 'schasen97', 'pmehta97', 'alicechiu1126', 'macdoc', 'alexperkins828', 'madigc3', 'atablizo6', 'abhishandy', 'keblinski', 'dkzr2015', 'millerp97', 'stormermatthew', 'apecoraro', None, 'keslern', 'kubicf', 'alianna.maguire', 'tgrounds33', 'quartincz', 'les']"
20,46,36,37,35,"['kpuncha', 'rgerbino', 'ealmesri', 'mfelixca', 'jhern148', 'trsauer', 'jcpowel8', 'baberge', 'abertra1', 'bpsmit20', 'amjorge1', 'nsandys', 'tienvo1', 'jstewa20', 'xzhan445', 'ttmccart', 'kmangers', 'gkim50', 'ksenturk', 'jesorian', 'maalkha1', 'tethingt', 'jdan2', 'jdsmit60', 'awirkusc', 'bsweekly', 'bhscobie', 'nsoderbe', 'coreymlh', 'dlirwin', 'gaross2', 'stweston', 'sterry6', 'jjgreen2', 'jasanc28']",0,[],2,"['yhzhang99', None]",37,"['kpuncha', 'rgerbino', 'ealmesri', 'mfelixca', 'jhern148', 'trsauer', 'jcpowel8', 'baberge', 'abertra1', 'bpsmit20', 'amjorge1', 'nsandys', 'tienvo1', 'xzhan445', 'jstewa20', 'ttmccart', 'kmangers', 'gkim50', 'ksenturk', 'jesorian', 'maalkha1', 'tethingt', 'jdan2', 'jdsmit60', 'awirkusc', 'bsweekly', None, 'bhscobie', 'nsoderbe', 'coreymlh', 'yhzhang99', 'dlirwin', 'gaross2', 'stweston', 'sterry6', 'jjgreen2', 'jasanc28']"
22,64,33,53,1,['rtalturkomani'],31,"['duha23', 'sarah9966', 'abanoub_ibrahim', 'malekderbas122', 'donthefalcon', 'ali996', 'alialjuma', 'ebrahim', 'esmarafi98', 'zahraaismail35928', 'huda98', 'himepi96', 'hasabelnaby92', 'nano_particle', 'anfal55', 'kaboagiza', 'zahraa142aum', 'mariam6697', 'alaa.ekaram', 'yousefalali_', 'taifsaleh22', 'yousefalnafea', 'saud80', 'a7med0galaxy', 'boomboom3abod', 'lujain26428', 'shaheen_098', 'ms.alqotifi', 'mhd148', 'webballen', 'ghadeer']",52,"['bilel.neji', 'kabdulsayed', 'ritaj345', 'fatemah.aleid37', 'anwarekhrais1', 'cerebrus989', 'wafarag', 'nada96', 'moudhima', 'eng.nawafr', 'akalothainah59', 'hawraalsahhaf', 'shaikhalameer97', 'heba.30936.aum', 'aishah', 'mackintosha7', 'poyaka619', 'sarahnano1', 'farahaljasser97', 'hjyagout30936', 'aahmadi71995', 'hadeel.lsoc', 'latifa', 'mariamrald.2169', 'shahadalmotairi', 'shaikha.alameer97', 'fatemah96', 'fajer92', 'mjmutairi', 'shaikhah30121', 'akarar', 'ahmadshamsaldeen96', 'fatemahkhaled1998', 'rzouf', 'teyrxq8', 'fabualhasan6', 'youq8_1', 'hmdmyabb', 'mjmutairi6', 'shaikhahboareki', 'atoooma18', 'azizalshaban', 'gooz1915', 'nopha96', None, 'saroom96', 'ruqaya30aum', 'abdullah.s.karar', 'fajeralanzi56', 'fatmaaalsarhan39', 'asultan1996', 'alshammarih96']",84,"['duha23', 'anwarekhrais1', 'cerebrus989', 'abanoub_ibrahim', 'malekderbas122', 'nada96', 'moudhima', 'akalothainah59', 'hawraalsahhaf', 'ali996', 'ebrahim', 'heba.30936.aum', 'mackintosha7', 'sarahnano1', 'hjyagout30936', 'hadeel.lsoc', 'mariamrald.2169', 'hasabelnaby92', 'himepi96', 'shaikha.alameer97', 'fatemah96', 'nano_particle', 'fajer92', 'anfal55', 'mjmutairi', 'kaboagiza', 'zahraa142aum', 'akarar', 'alaa.ekaram', 'ahmadshamsaldeen96', 'yousefalali_', 'fatemahkhaled1998', 'teyrxq8', 'fabualhasan6', 'youq8_1', 'mjmutairi6', 'azizalshaban', 'taifsaleh22', 'nopha96', 'yousefalnafea', 'saroom96', 'a7med0galaxy', 'boomboom3abod', 'ruqaya30aum', 'rtalturkomani', 'ms.alqotifi', 'fatmaaalsarhan39', 'mhd148', 'asultan1996', 'webballen', 'alshammarih96', 'bilel.neji', 'ritaj345', 'kabdulsayed', 'fatemah.aleid37', 'sarah9966', 'wafarag', 'eng.nawafr', 'donthefalcon', 'alialjuma', 'shaikhalameer97', 'aishah', 'poyaka619', 'farahaljasser97', 'aahmadi71995', 'esmarafi98', 'zahraaismail35928', 'latifa', 'huda98', 'shahadalmotairi', 'shaikhah30121', 'mariam6697', 'rzouf', 'hmdmyabb', 'atoooma18', 'shaikhahboareki', 'gooz1915', None, 'saud80', 'lujain26428', 'abdullah.s.karar', 'shaheen_098', 'fajeralanzi56', 'ghadeer']"
22,177,33,38,28,"['duha23', 'sarah9966', 'abanoub_ibrahim', 'malekderbas122', 'donthefalcon', 'ali996', 'alialjuma', 'ebrahim', 'esmarafi98', 'zahraaismail35928', 'huda98', 'himepi96', 'nano_particle', 'anfal55', 'zahraa142aum', 'mariam6697', 'alaa.ekaram', 'yousefalali_', 'taifsaleh22', 'yousefalnafea', 'saud80', 'a7med0galaxy', 'boomboom3abod', 'lujain26428', 'shaheen_098', 'ms.alqotifi', 'mhd148', 'ghadeer']",4,"['kaboagiza', 'webballen', 'hasabelnaby92', 'rtalturkomani']",10,"['ruqaya30aum', 'ssmmoo', 'akarar', 'abdullah.s.karar', 'reemaldalamah', 'cerebrus989', 'teyrxq8', 'daiyooona', 'rehamalrejeebah34', None]",42,"['duha23', 'ssmmoo', 'cerebrus989', 'sarah9966', 'abanoub_ibrahim', 'malekderbas122', 'donthefalcon', 'rehamalrejeebah34', 'ali996', 'ebrahim', 'alialjuma', 'reemaldalamah', 'esmarafi98', 'zahraaismail35928', 'huda98', 'himepi96', 'hasabelnaby92', 'nano_particle', 'anfal55', 'kaboagiza', 'zahraa142aum', 'mariam6697', 'akarar', 'alaa.ekaram', 'yousefalali_', 'teyrxq8', 'taifsaleh22', None, 'yousefalnafea', 'saud80', 'a7med0galaxy', 'boomboom3abod', 'ruqaya30aum', 'lujain26428', 'rtalturkomani', 'abdullah.s.karar', 'shaheen_098', 'ms.alqotifi', 'mhd148', 'daiyooona', 'webballen', 'ghadeer']"
23,354,33,37,28,"['judywei0101', 'xinranz1216104', 'neelb96', 'murlocking', 'robin1221', 'yuchun7', 'derekrsdhl', 'frankpan96', 'gibbsfree', 'osgarcia', 'aghazari', 'oleon95', 'pshir', 'ruoxia', 'davidkelly', 'ksanche32', 'shikamaru0922', 'arthurssu', 'yingjied', 'uclahuangxin', 'yihong0807', 'kfitzell29', 'boyao', 'chuang5679', 'jameskpenney', 'qianliu0120', 'viraatsh', 'curtis804']",4,"['mtmaccc', 'jameslewang1994', 'zy111693', 'creichen']",9,"['hmfei', 'tsaijuming', 'pochangshih', 'mfossella', 'hardikh94', 'federicobea95', 'shushujie', None, 'bndefru']",41,"['jameslewang1994', 'judywei0101', 'zy111693', 'creichen', 'pochangshih', 'xinranz1216104', 'neelb96', 'mtmaccc', 'murlocking', 'robin1221', 'yuchun7', 'derekrsdhl', 'frankpan96', 'gibbsfree', 'tsaijuming', 'osgarcia', 'hardikh94', 'aghazari', 'oleon95', 'pshir', 'federicobea95', 'ruoxia', 'davidkelly', 'ksanche32', 'shikamaru0922', 'arthurssu', 'hmfei', 'yingjied', 'uclahuangxin', 'yihong0807', 'kfitzell29', 'boyao', 'chuang5679', 'shushujie', None, 'jameskpenney', 'qianliu0120', 'viraatsh', 'mfossella', 'bndefru', 'curtis804']"
23,368,33,28,23,"['judywei0101', 'creichen', 'xinranz1216104', 'neelb96', 'murlocking', 'robin1221', 'yuchun7', 'derekrsdhl', 'frankpan96', 'osgarcia', 'aghazari', 'oleon95', 'ruoxia', 'ksanche32', 'shikamaru0922', 'uclahuangxin', 'yingjied', 'yihong0807', 'chuang5679', 'jameskpenney', 'qianliu0120', 'viraatsh', 'curtis804']",9,"['jameslewang1994', 'arthurssu', 'gibbsfree', 'zy111693', 'mtmaccc', 'kfitzell29', 'boyao', 'pshir', 'davidkelly']",5,"['mariah741', 'shaoyou', 'gig26', 'hardikh94', None]",37,"['jameslewang1994', 'judywei0101', 'zy111693', 'creichen', 'xinranz1216104', 'neelb96', 'mtmaccc', 'murlocking', 'robin1221', 'yuchun7', 'derekrsdhl', 'frankpan96', 'gibbsfree', 'gig26', 'osgarcia', 'hardikh94', 'aghazari', 'oleon95', 'pshir', 'ruoxia', 'davidkelly', 'ksanche32', 'shikamaru0922', 'arthurssu', 'yingjied', 'uclahuangxin', 'yihong0807', 'kfitzell29', 'boyao', 'chuang5679', None, 'jameskpenney', 'mariah741', 'qianliu0120', 'shaoyou', 'viraatsh', 'curtis804']"
23,355,33,7,6,"['zy111693', 'creichen', 'mtmaccc', 'robin1221', 'boyao', 'chuang5679']",26,"['jameslewang1994', 'judywei0101', 'xinranz1216104', 'neelb96', 'murlocking', 'yuchun7', 'derekrsdhl', 'frankpan96', 'gibbsfree', 'osgarcia', 'aghazari', 'oleon95', 'pshir', 'ruoxia', 'davidkelly', 'ksanche32', 'shikamaru0922', 'arthurssu', 'yingjied', 'uclahuangxin', 'yihong0807', 'kfitzell29', 'jameskpenney', 'qianliu0120', 'viraatsh', 'curtis804']",1,[None],33,"['jameslewang1994', 'judywei0101', 'zy111693', 'creichen', 'xinranz1216104', 'neelb96', 'mtmaccc', 'murlocking', 'robin1221', 'yuchun7', 'derekrsdhl', 'frankpan96', 'gibbsfree', 'osgarcia', 'aghazari', 'oleon95', 'pshir', 'ruoxia', 'davidkelly', 'ksanche32', 'shikamaru0922', 'arthurssu', 'yingjied', 'uclahuangxin', 'yihong0807', 'kfitzell29', 'boyao', 'chuang5679', None, 'jameskpenney', 'qianliu0120', 'viraatsh', 'curtis804']"
23,369,33,7,5,"['creichen', 'mtmaccc', 'neelb96', 'viraatsh', 'yuchun7']",27,"['jameslewang1994', 'judywei0101', 'zy111693', 'xinranz1216104', 'murlocking', 'robin1221', 'derekrsdhl', 'frankpan96', 'gibbsfree', 'osgarcia', 'aghazari', 'oleon95', 'pshir', 'ruoxia', 'davidkelly', 'ksanche32', 'shikamaru0922', 'arthurssu', 'yingjied', 'uclahuangxin', 'yihong0807', 'kfitzell29', 'boyao', 'chuang5679', 'jameskpenney', 'qianliu0120', 'curtis804']",2,"['hardikh94', None]",34,"['jameslewang1994', 'judywei0101', 'zy111693', 'creichen', 'xinranz1216104', 'neelb96', 'mtmaccc', 'murlocking', 'robin1221', 'yuchun7', 'derekrsdhl', 'frankpan96', 'gibbsfree', 'osgarcia', 'hardikh94', 'aghazari', 'oleon95', 'pshir', 'ruoxia', 'davidkelly', 'ksanche32', 'shikamaru0922', 'arthurssu', 'yingjied', 'uclahuangxin', 'yihong0807', 'kfitzell29', 'boyao', 'chuang5679', None, 'jameskpenney', 'qianliu0120', 'viraatsh', 'curtis804']"
24,80,33,18,3,"['alejandra31g', 'dard980311', 'juanfecazuluaga']",29,"['omarbello', 'haripriaganesh', 'yweng3', 'vibhav261', 'huang_yuelin', 'brooke93', 'jalassafi', 'hansungk969', 'victorjv88', 'victor15af', 'chola', 'goldubra', 'hyeonwook', 'shellholguin', 'ecantand', 'anandbhujade12', 'giannissp', 'zshi', 'pouya_es1984', 'swastiksinha1997', 'jhbernil', 'jaw419', 'shantanu.rpe', 'js3452', 'sylarsan', 'nchopper', 'hclee0908', 'taohidbinnur.tusher', 'victor.avila18']",15,"['michaelj00', 'josemajaramilloh', 'jpnaranjo20', 'nlozano611', 'danrako', 'jcac0908', 'dhcomas', 'yafarsolano', 'juandavrp', 'ale_1201', 'ja.hernandezr1', 'andresvm', 'ja.burgos', None, 'juliana9927']",47,"['omarbello', 'haripriaganesh', 'juanfecazuluaga', 'yweng3', 'danrako', 'vibhav261', 'ja.burgos', 'huang_yuelin', 'brooke93', 'jalassafi', 'jpnaranjo20', 'yafarsolano', 'hansungk969', 'ja.hernandezr1', 'andresvm', 'victorjv88', 'victor15af', 'goldubra', 'chola', 'dard980311', 'alejandra31g', 'hyeonwook', 'shellholguin', 'nlozano611', 'ecantand', 'jcac0908', 'anandbhujade12', 'giannissp', 'zshi', 'juandavrp', 'ale_1201', 'pouya_es1984', None, 'michaelj00', 'josemajaramilloh', 'swastiksinha1997', 'jhbernil', 'jaw419', 'dhcomas', 'shantanu.rpe', 'juliana9927', 'js3452', 'sylarsan', 'nchopper', 'hclee0908', 'taohidbinnur.tusher', 'victor.avila18']"
25,57,28,33,27,"['tfannin2', 'mongkuwuratii', 'tmurra21', 'ckotwic2', 'rfinerty54', 'kfriedel', 'aetim', 'dawson87', 'graceembrey', 'gmodano', 'sculloo', 'ecorazza', 'nbuchwal', 'congji1999', 'mgalvi11', 'cjupina', 'nhabre', 'tzhang01', 'mgreen32', 'akontrimas', 'bbode', 'mbicknese', 'galboum', 'dwalsh23', 'courtneyradz', 'lmcdono6', 'mbrett4']",0,[],6,"['sabrina0850', 'nkondrath', 'samalfit', 'rscafide', 'ogreene2', None]",33,"['tfannin2', 'mongkuwuratii', 'tmurra21', 'ckotwic2', 'rfinerty54', 'kfriedel', 'sabrina0850', 'aetim', 'dawson87', 'graceembrey', 'gmodano', 'samalfit', 'sculloo', 'ecorazza', 'nbuchwal', 'congji1999', 'mgalvi11', 'cjupina', 'nhabre', 'tzhang01', 'mgreen32', 'rscafide', 'akontrimas', 'bbode', 'mbicknese', None, 'galboum', 'dwalsh23', 'courtneyradz', 'nkondrath', 'lmcdono6', 'mbrett4', 'ogreene2']"
25,243,28,33,27,"['tfannin2', 'mongkuwuratii', 'tmurra21', 'ckotwic2', 'rfinerty54', 'kfriedel', 'aetim', 'dawson87', 'graceembrey', 'gmodano', 'sculloo', 'ecorazza', 'nbuchwal', 'congji1999', 'mgalvi11', 'cjupina', 'nhabre', 'tzhang01', 'mgreen32', 'akontrimas', 'bbode', 'mbicknese', 'galboum', 'dwalsh23', 'courtneyradz', 'lmcdono6', 'mbrett4']",0,[],6,"['sabrina0850', 'nkondrath', 'rscafide', 'ogreene2', 'whubschm', None]",33,"['tfannin2', 'mongkuwuratii', 'tmurra21', 'ckotwic2', 'rfinerty54', 'kfriedel', 'sabrina0850', 'aetim', 'dawson87', 'graceembrey', 'gmodano', 'sculloo', 'ecorazza', 'nbuchwal', 'congji1999', 'whubschm', 'mgalvi11', 'cjupina', 'nhabre', 'tzhang01', 'mgreen32', 'rscafide', 'akontrimas', 'bbode', 'mbicknese', None, 'galboum', 'dwalsh23', 'courtneyradz', 'nkondrath', 'lmcdono6', 'mbrett4', 'ogreene2']"
25,73,28,30,24,"['tfannin2', 'mongkuwuratii', 'ckotwic2', 'rfinerty54', 'aetim', 'dawson87', 'graceembrey', 'gmodano', 'sculloo', 'ecorazza', 'nbuchwal', 'congji1999', 'mgalvi11', 'nhabre', 'tzhang01', 'mgreen32', 'akontrimas', 'bbode', 'mbicknese', 'galboum', 'dwalsh23', 'courtneyradz', 'lmcdono6', 'mbrett4']",3,"['kfriedel', 'cjupina', 'tmurra21']",6,"['sabrina0850', 'nkondrath', 'samalfit', 'rscafide', 'ogreene2', None]",33,"['tfannin2', 'mongkuwuratii', 'tmurra21', 'ckotwic2', 'rfinerty54', 'kfriedel', 'sabrina0850', 'aetim', 'dawson87', 'graceembrey', 'gmodano', 'samalfit', 'sculloo', 'ecorazza', 'nbuchwal', 'congji1999', 'mgalvi11', 'cjupina', 'nhabre', 'tzhang01', 'mgreen32', 'rscafide', 'akontrimas', 'bbode', 'mbicknese', None, 'galboum', 'dwalsh23', 'courtneyradz', 'nkondrath', 'lmcdono6', 'mbrett4', 'ogreene2']"
25,292,28,29,26,"['tfannin2', 'tmurra21', 'ckotwic2', 'rfinerty54', 'kfriedel', 'aetim', 'dawson87', 'graceembrey', 'gmodano', 'sculloo', 'ecorazza', 'nbuchwal', 'congji1999', 'mgalvi11', 'cjupina', 'nhabre', 'tzhang01', 'mgreen32', 'akontrimas', 'bbode', 'mbicknese', 'galboum', 'dwalsh23', 'courtneyradz', 'lmcdono6', 'mbrett4']",1,['mongkuwuratii'],3,"['samalfit', None, 'ogreene2']",30,"['tfannin2', 'mongkuwuratii', 'tmurra21', 'ckotwic2', 'rfinerty54', 'kfriedel', 'aetim', 'dawson87', 'graceembrey', 'gmodano', 'samalfit', 'sculloo', 'ecorazza', 'nbuchwal', 'congji1999', 'mgalvi11', 'cjupina', 'nhabre', 'tzhang01', 'mgreen32', 'akontrimas', 'bbode', 'mbicknese', None, 'galboum', 'dwalsh23', 'courtneyradz', 'lmcdono6', 'mbrett4', 'ogreene2']"
25,77,28,18,14,"['tfannin2', 'cjupina', 'tzhang01', 'dawson87', 'ckotwic2', 'lmcdono6', 'mbrett4', 'mgreen32', 'rfinerty54', 'akontrimas', 'sculloo', 'bbode', 'mbicknese', 'congji1999']",13,"['kfriedel', 'dwalsh23', 'aetim', 'mgalvi11', 'mongkuwuratii', 'nhabre', 'courtneyradz', 'graceembrey', 'tmurra21', 'gmodano', 'ecorazza', 'nbuchwal', 'galboum']",4,"['samalfit', None, 'jegan12', 'ogreene2']",31,"['tfannin2', 'mongkuwuratii', 'tmurra21', 'ckotwic2', 'rfinerty54', 'kfriedel', 'aetim', 'dawson87', 'graceembrey', 'gmodano', 'samalfit', 'sculloo', 'ecorazza', 'nbuchwal', 'congji1999', 'mgalvi11', 'cjupina', 'nhabre', 'tzhang01', 'mgreen32', 'akontrimas', 'bbode', 'mbicknese', None, 'galboum', 'dwalsh23', 'courtneyradz', 'lmcdono6', 'mbrett4', 'ogreene2', 'jegan12']"
25,244,28,8,7,"['courtneyradz', 'gmodano', 'mbrett4', 'lmcdono6', 'rfinerty54', 'akontrimas', 'ecorazza']",20,"['tfannin2', 'mongkuwuratii', 'tmurra21', 'ckotwic2', 'kfriedel', 'aetim', 'dawson87', 'graceembrey', 'sculloo', 'nbuchwal', 'congji1999', 'mgalvi11', 'cjupina', 'nhabre', 'tzhang01', 'mgreen32', 'bbode', 'mbicknese', 'galboum', 'dwalsh23']",1,[None],28,"['tfannin2', 'mgalvi11', 'mongkuwuratii', 'cjupina', 'nhabre', 'tzhang01', 'tmurra21', 'ckotwic2', 'mgreen32', 'rfinerty54', 'akontrimas', 'bbode', 'mbicknese', None, 'galboum', 'kfriedel', 'dwalsh23', 'aetim', 'courtneyradz', 'dawson87', 'graceembrey', 'gmodano', 'lmcdono6', 'mbrett4', 'sculloo', 'ecorazza', 'nbuchwal', 'congji1999']"
25,291,28,7,3,"['mbrett4', 'mongkuwuratii', 'gmodano']",24,"['tfannin2', 'tmurra21', 'ckotwic2', 'rfinerty54', 'kfriedel', 'aetim', 'dawson87', 'graceembrey', 'sculloo', 'ecorazza', 'nbuchwal', 'congji1999', 'mgalvi11', 'cjupina', 'nhabre', 'tzhang01', 'mgreen32', 'akontrimas', 'bbode', 'mbicknese', 'galboum', 'dwalsh23', 'courtneyradz', 'lmcdono6']",4,"['sabrina0850', None, 'nkondrath', 'samalfit']",31,"['tfannin2', 'mgalvi11', 'mongkuwuratii', 'cjupina', 'nhabre', 'tzhang01', 'tmurra21', 'ckotwic2', 'mgreen32', 'rfinerty54', 'akontrimas', 'bbode', 'mbicknese', None, 'galboum', 'kfriedel', 'sabrina0850', 'dwalsh23', 'aetim', 'courtneyradz', 'dawson87', 'graceembrey', 'nkondrath', 'gmodano', 'lmcdono6', 'mbrett4', 'samalfit', 'sculloo', 'ecorazza', 'nbuchwal', 'congji1999']"
26,300,27,40,26,"['jufepas98', 'julissa.vigoya', 'juan98', 's.villamilp', 'apqc1998', 'jaardila', 'nicolash025', 'solerjavier7', 'jeisson1299', 'ma.mozo', 'maria.a.solano.otero', 'mugnier', 'nanoxzapata', 'df.pena12', 'alesk1208', 'ae.penagoss', 'felipehdz', 'uniandes1', 'cceballos1003', 'niko_abril_cruz', 'fabser7', 'gonzaloemr', 'kevinbernalru', 'sebas.villaba2002', 'v.cardonac1', 'svitery']",0,[],14,"['michaelj00', 'josemajaramilloh', 'jhonseebb', 'alejandra.tobo1', 'mafeflorian7', None, 'haroldsteven013', 'manolobetancur', 'ale_1201', 'sn.vargas', 'jchaparrog10', 'juliortegon', 'carlos.cg.gomez', 'adrianapquijanoc']",40,"['jufepas98', 'julissa.vigoya', 'juan98', 's.villamilp', 'apqc1998', 'sn.vargas', 'jaardila', 'solerjavier7', 'ma.mozo', 'mugnier', 'jhonseebb', 'df.pena12', 'alesk1208', 'ae.penagoss', 'haroldsteven013', 'felipehdz', 'uniandes1', 'michaelj00', 'josemajaramilloh', 'niko_abril_cruz', 'fabser7', 'kevinbernalru', 'v.cardonac1', 'juliortegon', 'mafeflorian7', 'nicolash025', 'carlos.cg.gomez', 'adrianapquijanoc', 'alejandra.tobo1', 'jeisson1299', 'manolobetancur', 'maria.a.solano.otero', 'nanoxzapata', 'jchaparrog10', 'ale_1201', None, 'cceballos1003', 'gonzaloemr', 'sebas.villaba2002', 'svitery']"
26,167,27,36,26,"['jufepas98', 'julissa.vigoya', 'juan98', 's.villamilp', 'apqc1998', 'jaardila', 'nicolash025', 'solerjavier7', 'jeisson1299', 'ma.mozo', 'maria.a.solano.otero', 'mugnier', 'nanoxzapata', 'df.pena12', 'alesk1208', 'ae.penagoss', 'felipehdz', 'uniandes1', 'cceballos1003', 'niko_abril_cruz', 'fabser7', 'gonzaloemr', 'kevinbernalru', 'sebas.villaba2002', 'v.cardonac1', 'svitery']",0,[],10,"['michaelj00', 'josemajaramilloh', 'mafeflorian7', 'juanpa10210', None, 'manolobetancur', 'ale_1201', 'sn.vargas', 'carlos.cg.gomez', 'jhonseebb']",36,"['jufepas98', 'julissa.vigoya', 'juan98', 's.villamilp', 'apqc1998', 'sn.vargas', 'jaardila', 'nicolash025', 'solerjavier7', 'carlos.cg.gomez', 'juanpa10210', 'jeisson1299', 'ma.mozo', 'manolobetancur', 'maria.a.solano.otero', 'mugnier', 'nanoxzapata', 'jhonseebb', 'df.pena12', 'alesk1208', 'ae.penagoss', 'felipehdz', 'uniandes1', 'ale_1201', None, 'cceballos1003', 'michaelj00', 'josemajaramilloh', 'niko_abril_cruz', 'fabser7', 'gonzaloemr', 'kevinbernalru', 'sebas.villaba2002', 'v.cardonac1', 'mafeflorian7', 'svitery']"
27,192,25,14,3,"['gohari95', 'ahmed_moustafa_94', 'serag']",21,"['djogot', 'ivansirovina', 'mmatic2010', 'ani.s18', 'matijapucek', 'dariosirovina0', 'mihovilberam', 'lovro.markovic', 'mjakovc', 'sagun434', 'goap23', 'skymasterrms', 'ipetrovecki', 'watson', 'mica5555', 'rohityadav7787', 'dominik76', 'matej.cinderela', 'vyasatnanohub2015', 'mica55', 'az49711']",11,"[None, 'asmaa_abdelmegeed.', 'mohamedmsaad66', 'mohamed.h.mamdouh', 'ahmed_raafat', 'basem.ali95', 'ahmedraouf', 'omarazooz', 'bakr', 'mohamed.ah.omran', 'ahmeis']",35,"['djogot', 'ivansirovina', 'ani.s18', 'mmatic2010', 'mohamedmsaad66', 'ahmed_raafat', 'serag', 'matijapucek', 'dariosirovina0', 'mihovilberam', 'lovro.markovic', 'mjakovc', 'basem.ali95', 'sagun434', 'ahmedraouf', 'omarazooz', 'mohamed.ah.omran', 'goap23', 'skymasterrms', 'ahmeis', 'ipetrovecki', 'watson', 'mica5555', 'rohityadav7787', 'mohamed.h.mamdouh', 'dominik76', 'bakr', None, 'matej.cinderela', 'vyasatnanohub2015', 'gohari95', 'mica55', 'asmaa_abdelmegeed.', 'az49711', 'ahmed_moustafa_94']"
27,196,25,11,9,"['djogot', 'dariosirovina0', 'mica5555', 'mihovilberam', 'ivansirovina', 'lovro.markovic', 'mmatic2010', 'dominik76', 'az49711']",15,"['ipetrovecki', 'watson', 'gohari95', 'matej.cinderela', 'rohityadav7787', 'mica55', 'ani.s18', 'mjakovc', 'ahmed_moustafa_94', 'serag', 'sagun434', 'matijapucek', 'goap23', 'skymasterrms', 'vyasatnanohub2015']",2,"[None, 'pero.djuric13']",26,"['djogot', 'ipetrovecki', 'watson', 'mica5555', 'rohityadav7787', 'ivansirovina', 'ani.s18', 'mmatic2010', 'dominik76', 'serag', 'matijapucek', None, 'matej.cinderela', 'vyasatnanohub2015', 'dariosirovina0', 'gohari95', 'mica55', 'mihovilberam', 'lovro.markovic', 'az49711', 'mjakovc', 'ahmed_moustafa_94', 'pero.djuric13', 'sagun434', 'goap23', 'skymasterrms']"
27,195,25,8,7,"['ipetrovecki', 'mica55', 'mihovilberam', 'ivansirovina', 'mmatic2010', 'matijapucek', 'matej.cinderela']",17,"['djogot', 'dariosirovina0', 'watson', 'mica5555', 'gohari95', 'rohityadav7787', 'lovro.markovic', 'ani.s18', 'dominik76', 'mjakovc', 'az49711', 'serag', 'ahmed_moustafa_94', 'sagun434', 'goap23', 'skymasterrms', 'vyasatnanohub2015']",1,[None],25,"['djogot', 'ipetrovecki', 'watson', 'mica5555', 'rohityadav7787', 'ivansirovina', 'ani.s18', 'mmatic2010', 'dominik76', 'serag', 'matijapucek', None, 'matej.cinderela', 'vyasatnanohub2015', 'dariosirovina0', 'gohari95', 'mica55', 'mihovilberam', 'lovro.markovic', 'az49711', 'mjakovc', 'ahmed_moustafa_94', 'sagun434', 'goap23', 'skymasterrms']"
27,193,25,7,6,"['dariosirovina0', 'ipetrovecki', 'ivansirovina', 'mmatic2010', 'matijapucek', 'matej.cinderela']",18,"['djogot', 'watson', 'mica5555', 'gohari95', 'mihovilberam', 'rohityadav7787', 'lovro.markovic', 'ani.s18', 'mica55', 'dominik76', 'mjakovc', 'az49711', 'serag', 'ahmed_moustafa_94', 'sagun434', 'goap23', 'skymasterrms', 'vyasatnanohub2015']",1,[None],25,"['djogot', 'ipetrovecki', 'watson', 'mica5555', 'rohityadav7787', 'ivansirovina', 'ani.s18', 'mmatic2010', 'dominik76', 'serag', 'matijapucek', None, 'matej.cinderela', 'vyasatnanohub2015', 'dariosirovina0', 'gohari95', 'mica55', 'mihovilberam', 'lovro.markovic', 'az49711', 'mjakovc', 'ahmed_moustafa_94', 'sagun434', 'goap23', 'skymasterrms']"
27,194,25,7,6,"['dariosirovina0', 'ipetrovecki', 'ivansirovina', 'mmatic2010', 'matijapucek', 'matej.cinderela']",18,"['djogot', 'watson', 'mica5555', 'gohari95', 'mihovilberam', 'rohityadav7787', 'lovro.markovic', 'ani.s18', 'mica55', 'dominik76', 'mjakovc', 'az49711', 'serag', 'ahmed_moustafa_94', 'sagun434', 'goap23', 'skymasterrms', 'vyasatnanohub2015']",1,[None],25,"['djogot', 'ipetrovecki', 'watson', 'mica5555', 'rohityadav7787', 'ivansirovina', 'ani.s18', 'mmatic2010', 'dominik76', 'serag', 'matijapucek', None, 'matej.cinderela', 'vyasatnanohub2015', 'dariosirovina0', 'gohari95', 'mica55', 'mihovilberam', 'lovro.markovic', 'az49711', 'mjakovc', 'ahmed_moustafa_94', 'sagun434', 'goap23', 'skymasterrms']"
28,311,24,50,11,"['akankshachandoskar1198', 'kajalbhoite04', 'pranalikothekar5', 'joishersweta17695', 'sourabhkothari16', 'rahulbirwadkar123', 'pjkarmokar', 'bhai0045', 'aditiramadwar', 'prajaktathorat24', 'gauribahatkar']",12,"['prathamesh.shivmare1', 'hsnnalwala7', 'omimore24', 'nicket9', 'pnrs.pratik', 'pratikkul26', 'rutujakamthe', 'adityakini21', 'pranjalijadhav0911', 'juileebharate10797', 'shripal17', 'piyamodhve']",39,"['sanket.r.makwana', 'sanjit', 'aishwaryahiwale97', 'sonalikharade5', 'rushikeshkharat18', 'dilipramgir', 'anujmhatre43', 'ajinkyasoman', 'anujmdeorukhkar', 'prathameshpatle13', 'priyankakamble', 'rishimud', 'ashu0497', 'aloksardesai97', 'salvir481', 'durgeshthorat4', 'rushikeshrane27', 'arpitgodbole7', 'rahulkadam7055', 'abhishektoraskar412', 'runakshi97', 'owais11', 'seemasaini282', 'ovrale', 'sukanyajadhav1997', 'rasikapednekar20', 'siddhesh.soyane', 'rohanotari21', None, 'divyassonawane', 'nikwade.damini95', 'arpitakudesia3011', 'aquibansari12377', 'sohammhas', 'kalyanisahib96', 'rakeshpatil9271', 'ashnavirdikar.av', 'zainabshah181997', 'kedar.kulkarni12']",62,"['prathamesh.shivmare1', 'akankshachandoskar1198', 'sanjit', 'pnrs.pratik', 'rahulbirwadkar123', 'rutujakamthe', 'adityakini21', 'dilipramgir', 'rushikeshkharat18', 'anujmhatre43', 'ajinkyasoman', 'prathameshpatle13', 'rishimud', 'ashu0497', 'salvir481', 'juileebharate10797', 'piyamodhve', 'rushikeshrane27', 'rahulkadam7055', 'abhishektoraskar412', 'runakshi97', 'joishersweta17695', 'sourabhkothari16', 'nicket9', 'pjkarmokar', 'sukanyajadhav1997', 'siddhesh.soyane', 'aditiramadwar', 'divyassonawane', 'kajalbhoite04', 'sohammhas', 'kalyanisahib96', 'rakeshpatil9271', 'ashnavirdikar.av', 'shripal17', 'sanket.r.makwana', 'hsnnalwala7', 'aishwaryahiwale97', 'omimore24', 'sonalikharade5', 'bhai0045', 'pranjalijadhav0911', 'anujmdeorukhkar', 'pranalikothekar5', 'priyankakamble', 'aloksardesai97', 'durgeshthorat4', 'prajaktathorat24', 'gauribahatkar', 'arpitgodbole7', 'owais11', 'seemasaini282', 'ovrale', 'rasikapednekar20', 'rohanotari21', None, 'nikwade.damini95', 'arpitakudesia3011', 'aquibansari12377', 'zainabshah181997', 'pratikkul26', 'kedar.kulkarni12']"
28,326,24,42,15,"['prathamesh.shivmare1', 'akankshachandoskar1198', 'kajalbhoite04', 'pranalikothekar5', 'hsnnalwala7', 'joishersweta17695', 'sourabhkothari16', 'pnrs.pratik', 'rahulbirwadkar123', 'bhai0045', 'gauribahatkar', 'aditiramadwar', 'pranjalijadhav0911', 'prajaktathorat24', 'shripal17']",8,"['omimore24', 'nicket9', 'pjkarmokar', 'rutujakamthe', 'adityakini21', 'juileebharate10797', 'pratikkul26', 'piyamodhve']",27,"['welingnamrata', 'sanjit', 'sonalikharade5', 'adisawant333', 'anujmdeorukhkar', 'prathameshpatle13', 'priyankakunde22', 'jinku5454', 'bendalneha', 'salvir481', 'urmil1700', 'arpitgodbole7', 'owais11', 'sukanyajadhav1997', 'rasikapednekar20', 'rakeshpatil3019', None, 'bhupeshpatil98', 'divyassonawane', 'arfat_24', 'aquibansari12377', 'rakeshpatil9271', 'aritramondal151', 'ashnavirdikar.av', 'rohit.elawadekar333', '100vichare', 'kedar.kulkarni12']",50,"['prathamesh.shivmare1', 'akankshachandoskar1198', 'sanjit', 'pnrs.pratik', 'rahulbirwadkar123', 'rutujakamthe', 'adityakini21', 'prathameshpatle13', 'priyankakunde22', 'salvir481', 'juileebharate10797', 'piyamodhve', 'joishersweta17695', 'sourabhkothari16', 'nicket9', 'pjkarmokar', 'sukanyajadhav1997', 'aditiramadwar', 'rakeshpatil3019', 'divyassonawane', 'kajalbhoite04', 'arfat_24', 'rakeshpatil9271', 'ashnavirdikar.av', 'rohit.elawadekar333', '100vichare', 'shripal17', 'welingnamrata', 'hsnnalwala7', 'omimore24', 'sonalikharade5', 'bhai0045', 'adisawant333', 'pranjalijadhav0911', 'anujmdeorukhkar', 'pranalikothekar5', 'jinku5454', 'bendalneha', 'prajaktathorat24', 'urmil1700', 'gauribahatkar', 'arpitgodbole7', 'owais11', 'rasikapednekar20', None, 'bhupeshpatil98', 'aquibansari12377', 'aritramondal151', 'pratikkul26', 'kedar.kulkarni12']"
28,313,24,22,4,"['rutujakamthe', 'omimore24', 'piyamodhve', 'rahulbirwadkar123']",19,"['prathamesh.shivmare1', 'akankshachandoskar1198', 'hsnnalwala7', 'shripal17', 'pnrs.pratik', 'bhai0045', 'adityakini21', 'pranjalijadhav0911', 'pranalikothekar5', 'juileebharate10797', 'prajaktathorat24', 'gauribahatkar', 'joishersweta17695', 'sourabhkothari16', 'nicket9', 'pjkarmokar', 'aditiramadwar', 'kajalbhoite04', 'pratikkul26']",18,"['inamdarshreyas5', 'sagar21', 'saritav.9600', 'swastik2', 'nanomems226', 'nageshjaiswar11', 'pranav123', 'tanvipalande', 'ashu0497', 'deep.patel', 'arushi.yadav', 'prachi.mujawar', 'shantanu123', 'akshaybhore7', None, 'max_mercury', 'verma_34dh', 'mayurpashte97']",41,"['prathamesh.shivmare1', 'akankshachandoskar1198', 'inamdarshreyas5', 'nanomems226', 'hsnnalwala7', 'shripal17', 'omimore24', 'pnrs.pratik', 'rahulbirwadkar123', 'rutujakamthe', 'bhai0045', 'adityakini21', 'pranjalijadhav0911', 'sagar21', 'saritav.9600', 'swastik2', 'pranalikothekar5', 'pranav123', 'ashu0497', 'deep.patel', 'prachi.mujawar', 'juileebharate10797', 'prajaktathorat24', 'gauribahatkar', 'piyamodhve', 'nageshjaiswar11', 'joishersweta17695', 'sourabhkothari16', 'nicket9', 'pjkarmokar', 'arushi.yadav', 'shantanu123', 'aditiramadwar', 'akshaybhore7', None, 'verma_34dh', 'mayurpashte97', 'kajalbhoite04', 'tanvipalande', 'pratikkul26', 'max_mercury']"
28,312,24,19,4,"['hsnnalwala7', 'pranjalijadhav0911', 'shripal17', 'pnrs.pratik']",19,"['prathamesh.shivmare1', 'akankshachandoskar1198', 'omimore24', 'rahulbirwadkar123', 'rutujakamthe', 'bhai0045', 'adityakini21', 'pranalikothekar5', 'juileebharate10797', 'prajaktathorat24', 'gauribahatkar', 'piyamodhve', 'joishersweta17695', 'sourabhkothari16', 'nicket9', 'pjkarmokar', 'aditiramadwar', 'kajalbhoite04', 'pratikkul26']",15,"['rms.maurya21', 'owais11', 'priyankakunde22', 'bhandarepranay9208', 'rishimud', 'rajashree.pimputkar', 'kaushiksawant93', 'siddhesh.soyane', 'prachi.mujawar', 'adisawant333', 'susmeetsukte', 'ardalvi85', None, 'max_mercury', 'divyassonawane']",38,"['prathamesh.shivmare1', 'akankshachandoskar1198', 'hsnnalwala7', 'shripal17', 'omimore24', 'pnrs.pratik', 'rahulbirwadkar123', 'rutujakamthe', 'bhai0045', 'adisawant333', 'adityakini21', 'pranjalijadhav0911', 'rms.maurya21', 'pranalikothekar5', 'priyankakunde22', 'rishimud', 'prachi.mujawar', 'juileebharate10797', 'susmeetsukte', 'prajaktathorat24', 'gauribahatkar', 'piyamodhve', 'owais11', 'joishersweta17695', 'bhandarepranay9208', 'sourabhkothari16', 'nicket9', 'kaushiksawant93', 'pjkarmokar', 'siddhesh.soyane', 'aditiramadwar', None, 'divyassonawane', 'kajalbhoite04', 'ardalvi85', 'rajashree.pimputkar', 'pratikkul26', 'max_mercury']"
28,314,24,10,1,['rutujakamthe'],22,"['prathamesh.shivmare1', 'akankshachandoskar1198', 'hsnnalwala7', 'omimore24', 'pnrs.pratik', 'rahulbirwadkar123', 'bhai0045', 'adityakini21', 'pranjalijadhav0911', 'pranalikothekar5', 'juileebharate10797', 'prajaktathorat24', 'gauribahatkar', 'piyamodhve', 'joishersweta17695', 'sourabhkothari16', 'nicket9', 'pjkarmokar', 'aditiramadwar', 'kajalbhoite04', 'pratikkul26', 'shripal17']",9,"['shantanupanigrahi98', 'pranav123', None, 'aloksardesai97', 'chetushirke', 'max_mercury', 'akshatask', 'mayanksamar786', 'sarika_bukkawar']",32,"['prathamesh.shivmare1', 'akankshachandoskar1198', 'shantanupanigrahi98', 'hsnnalwala7', 'joishersweta17695', 'omimore24', 'sourabhkothari16', 'pnrs.pratik', 'rahulbirwadkar123', 'nicket9', 'rutujakamthe', 'bhai0045', 'gauribahatkar', 'pjkarmokar', 'adityakini21', 'pranjalijadhav0911', 'aditiramadwar', 'max_mercury', 'mayanksamar786', None, 'sarika_bukkawar', 'kajalbhoite04', 'pranalikothekar5', 'pranav123', 'pratikkul26', 'aloksardesai97', 'chetushirke', 'akshatask', 'juileebharate10797', 'prajaktathorat24', 'shripal17', 'piyamodhve']"
28,325,24,8,5,"['omimore24', 'nicket9', 'adityakini21', 'juileebharate10797', 'piyamodhve']",18,"['prathamesh.shivmare1', 'akankshachandoskar1198', 'kajalbhoite04', 'pranalikothekar5', 'hsnnalwala7', 'joishersweta17695', 'sourabhkothari16', 'pratikkul26', 'pnrs.pratik', 'rahulbirwadkar123', 'pjkarmokar', 'rutujakamthe', 'bhai0045', 'gauribahatkar', 'aditiramadwar', 'pranjalijadhav0911', 'prajaktathorat24', 'shripal17']",3,"['inamdarshreyas5', 'rajashree.pimputkar', None]",26,"['prathamesh.shivmare1', 'akankshachandoskar1198', 'inamdarshreyas5', 'hsnnalwala7', 'rajashree.pimputkar', 'joishersweta17695', 'omimore24', 'sourabhkothari16', 'pnrs.pratik', 'rahulbirwadkar123', 'nicket9', 'rutujakamthe', 'bhai0045', 'gauribahatkar', 'pjkarmokar', 'adityakini21', 'pranjalijadhav0911', 'aditiramadwar', None, 'kajalbhoite04', 'pranalikothekar5', 'pratikkul26', 'juileebharate10797', 'prajaktathorat24', 'shripal17', 'piyamodhve']"
28,329,24,7,3,"['rutujakamthe', 'omimore24', 'piyamodhve']",20,"['prathamesh.shivmare1', 'akankshachandoskar1198', 'hsnnalwala7', 'pnrs.pratik', 'rahulbirwadkar123', 'bhai0045', 'adityakini21', 'pranjalijadhav0911', 'pranalikothekar5', 'juileebharate10797', 'prajaktathorat24', 'gauribahatkar', 'joishersweta17695', 'sourabhkothari16', 'nicket9', 'pjkarmokar', 'aditiramadwar', 'kajalbhoite04', 'pratikkul26', 'shripal17']",4,"['prachi.mujawar', 'rajashree.pimputkar', 'pranav123', None]",27,"['prathamesh.shivmare1', 'akankshachandoskar1198', 'hsnnalwala7', 'rajashree.pimputkar', 'joishersweta17695', 'omimore24', 'sourabhkothari16', 'pnrs.pratik', 'rahulbirwadkar123', 'nicket9', 'rutujakamthe', 'bhai0045', 'gauribahatkar', 'pjkarmokar', 'adityakini21', 'pranjalijadhav0911', 'aditiramadwar', None, 'kajalbhoite04', 'pranalikothekar5', 'pranav123', 'pratikkul26', 'prachi.mujawar', 'juileebharate10797', 'prajaktathorat24', 'shripal17', 'piyamodhve']"
29,311,24,50,12,"['rushikeshrane27', 'sanket.r.makwana', 'ajinkyasoman', 'nikwade.damini95', 'seemasaini282', 'runakshi97', 'aishwaryahiwale97', 'ovrale', 'siddhesh.soyane', 'kalyanisahib96', 'durgeshthorat4', 'zainabshah181997']",11,"['saritav.9600', 'rms.maurya21', 'nageshjaiswar11', 'bhandarepranay9208', 'tanvipalande', 'kaushiksawant93', 'urmilabachate20', 'shantanu123', 'ardalvi85', 'priyankasingh754', 'verma_34dh']",38,"['akankshachandoskar1198', 'sanjit', 'sonalikharade5', 'rahulbirwadkar123', 'bhai0045', 'rushikeshkharat18', 'dilipramgir', 'anujmhatre43', 'anujmdeorukhkar', 'pranalikothekar5', 'prathameshpatle13', 'priyankakamble', 'rishimud', 'ashu0497', 'aloksardesai97', 'salvir481', 'prajaktathorat24', 'gauribahatkar', 'arpitgodbole7', 'rahulkadam7055', 'abhishektoraskar412', 'owais11', 'joishersweta17695', 'sourabhkothari16', 'sukanyajadhav1997', 'rasikapednekar20', 'pjkarmokar', 'aditiramadwar', 'rohanotari21', None, 'divyassonawane', 'kajalbhoite04', 'arpitakudesia3011', 'aquibansari12377', 'sohammhas', 'rakeshpatil9271', 'ashnavirdikar.av', 'kedar.kulkarni12']",61,"['akankshachandoskar1198', 'sanjit', 'rahulbirwadkar123', 'dilipramgir', 'rushikeshkharat18', 'saritav.9600', 'ajinkyasoman', 'anujmhatre43', 'prathameshpatle13', 'rishimud', 'ashu0497', 'salvir481', 'rushikeshrane27', 'rahulkadam7055', 'nageshjaiswar11', 'abhishektoraskar412', 'runakshi97', 'bhandarepranay9208', 'joishersweta17695', 'sourabhkothari16', 'siddhesh.soyane', 'sukanyajadhav1997', 'pjkarmokar', 'shantanu123', 'aditiramadwar', 'divyassonawane', 'kajalbhoite04', 'sohammhas', 'tanvipalande', 'kalyanisahib96', 'rakeshpatil9271', 'ashnavirdikar.av', 'ardalvi85', 'sanket.r.makwana', 'aishwaryahiwale97', 'sonalikharade5', 'urmilabachate20', 'bhai0045', 'rms.maurya21', 'anujmdeorukhkar', 'pranalikothekar5', 'priyankakamble', 'aloksardesai97', 'durgeshthorat4', 'prajaktathorat24', 'gauribahatkar', 'arpitgodbole7', 'seemasaini282', 'owais11', 'ovrale', 'kaushiksawant93', 'rasikapednekar20', 'rohanotari21', None, 'verma_34dh', 'nikwade.damini95', 'arpitakudesia3011', 'aquibansari12377', 'priyankasingh754', 'zainabshah181997', 'kedar.kulkarni12']"
29,313,24,22,5,"['saritav.9600', 'nageshjaiswar11', 'tanvipalande', 'shantanu123', 'verma_34dh']",18,"['rushikeshrane27', 'sanket.r.makwana', 'ajinkyasoman', 'rms.maurya21', 'nikwade.damini95', 'seemasaini282', 'runakshi97', 'bhandarepranay9208', 'aishwaryahiwale97', 'ovrale', 'kaushiksawant93', 'urmilabachate20', 'siddhesh.soyane', 'kalyanisahib96', 'durgeshthorat4', 'ardalvi85', 'priyankasingh754', 'zainabshah181997']",17,"['inamdarshreyas5', 'sagar21', 'nanomems226', 'swastik2', 'pranav123', 'omimore24', 'ashu0497', 'rahulbirwadkar123', 'deep.patel', 'arushi.yadav', 'rutujakamthe', 'prachi.mujawar', 'akshaybhore7', 'max_mercury', None, 'piyamodhve', 'mayurpashte97']",40,"['inamdarshreyas5', 'sanket.r.makwana', 'nanomems226', 'aishwaryahiwale97', 'omimore24', 'rahulbirwadkar123', 'urmilabachate20', 'rutujakamthe', 'sagar21', 'saritav.9600', 'ajinkyasoman', 'rms.maurya21', 'swastik2', 'pranav123', 'ashu0497', 'deep.patel', 'prachi.mujawar', 'durgeshthorat4', 'piyamodhve', 'rushikeshrane27', 'nageshjaiswar11', 'seemasaini282', 'runakshi97', 'bhandarepranay9208', 'ovrale', 'kaushiksawant93', 'siddhesh.soyane', 'arushi.yadav', 'shantanu123', 'akshaybhore7', None, 'verma_34dh', 'mayurpashte97', 'nikwade.damini95', 'tanvipalande', 'kalyanisahib96', 'ardalvi85', 'priyankasingh754', 'zainabshah181997', 'max_mercury']"
29,312,24,19,5,"['rms.maurya21', 'bhandarepranay9208', 'kaushiksawant93', 'siddhesh.soyane', 'ardalvi85']",18,"['rushikeshrane27', 'sanket.r.makwana', 'saritav.9600', 'ajinkyasoman', 'nikwade.damini95', 'nageshjaiswar11', 'seemasaini282', 'runakshi97', 'aishwaryahiwale97', 'tanvipalande', 'ovrale', 'urmilabachate20', 'kalyanisahib96', 'shantanu123', 'durgeshthorat4', 'priyankasingh754', 'zainabshah181997', 'verma_34dh']",14,"['owais11', 'hsnnalwala7', 'priyankakunde22', 'shripal17', 'rishimud', 'pnrs.pratik', 'prachi.mujawar', 'adisawant333', 'pranjalijadhav0911', 'susmeetsukte', 'rajashree.pimputkar', None, 'max_mercury', 'divyassonawane']",37,"['sanket.r.makwana', 'hsnnalwala7', 'aishwaryahiwale97', 'pnrs.pratik', 'urmilabachate20', 'adisawant333', 'pranjalijadhav0911', 'saritav.9600', 'ajinkyasoman', 'rms.maurya21', 'priyankakunde22', 'rishimud', 'prachi.mujawar', 'durgeshthorat4', 'susmeetsukte', 'rushikeshrane27', 'nageshjaiswar11', 'seemasaini282', 'runakshi97', 'owais11', 'bhandarepranay9208', 'ovrale', 'kaushiksawant93', 'siddhesh.soyane', 'shantanu123', None, 'verma_34dh', 'divyassonawane', 'nikwade.damini95', 'tanvipalande', 'kalyanisahib96', 'ardalvi85', 'rajashree.pimputkar', 'priyankasingh754', 'zainabshah181997', 'shripal17', 'max_mercury']"
29,310,24,7,3,"['priyankasingh754', 'verma_34dh', 'urmilabachate20']",20,"['sanket.r.makwana', 'aishwaryahiwale97', 'saritav.9600', 'ajinkyasoman', 'rms.maurya21', 'durgeshthorat4', 'rushikeshrane27', 'nageshjaiswar11', 'seemasaini282', 'runakshi97', 'bhandarepranay9208', 'ovrale', 'kaushiksawant93', 'siddhesh.soyane', 'shantanu123', 'nikwade.damini95', 'tanvipalande', 'kalyanisahib96', 'ardalvi85', 'zainabshah181997']",4,"[None, 'ady24k', 'nanomems226', 'kiranjagdale292']",27,"['rushikeshrane27', 'sanket.r.makwana', 'nageshjaiswar11', 'nanomems226', 'seemasaini282', 'runakshi97', 'bhandarepranay9208', 'aishwaryahiwale97', 'ady24k', 'ovrale', 'kaushiksawant93', 'urmilabachate20', 'siddhesh.soyane', 'kiranjagdale292', 'shantanu123', None, 'verma_34dh', 'saritav.9600', 'ajinkyasoman', 'rms.maurya21', 'nikwade.damini95', 'tanvipalande', 'kalyanisahib96', 'durgeshthorat4', 'ardalvi85', 'priyankasingh754', 'zainabshah181997']"
30,139,24,25,18,"['nic', 'durnanoliver', 'garethdpeters', 'quentin_norris', 'anon5678', 'yaqingxia18', 'stevocan', 'marwanchehade1997', 'jinl0723', 'shelbyjnk', 'annemarie.zaccarin', 'grier', 'savvad', 'marwanchehade97', 'kalilio', 'tristanrenondin', 'omar23j', 'mehdi.akeddar']",5,"['tess.van.d123', 'nizamdelhi25', 'krishnamcgill', 'mahmudul.hasan.aust.eee', 'ksuman.d3']",7,"['szkopek', 'kydlandgong', 'sallychoi0222', 'winnienyakundi0', 'wjymontreal', 'catherine2019', None]",30,"['yaqingxia18', 'winnienyakundi0', 'wjymontreal', 'marwanchehade97', 'szkopek', 'quentin_norris', 'nizamdelhi25', 'savvad', 'grier', 'kalilio', 'tristanrenondin', 'mehdi.akeddar', 'nic', 'durnanoliver', 'kydlandgong', 'sallychoi0222', 'shelbyjnk', 'omar23j', 'mahmudul.hasan.aust.eee', None, 'garethdpeters', 'tess.van.d123', 'anon5678', 'stevocan', 'marwanchehade1997', 'jinl0723', 'annemarie.zaccarin', 'catherine2019', 'krishnamcgill', 'ksuman.d3']"
31,61,24,22,18,"['reing1ub', 'laura.burchell', 'turnergarrow', 'carmud', 'raanapooshimin', 'jakeerickson', 'juanmanu04', 'sofiaarranz', 'tmosh5', 'ajfriedlan', 'toto_bssnt', 'sandracheng', 'e.desroche', 'trix012', 'kiranpreet.birdee', 'hadiyamadi', 'will.salmon66', 'wdze1001']",5,"['takassa1986', '14ers4', 'cookiedabaker', 'mohamed.balboul', 'lzuluckti']",4,"['wolkoff.97', 'robknobel', None, 'waleed97']",27,"['reing1ub', 'cookiedabaker', 'sandracheng', 'hadiyamadi', 'lzuluckti', 'wdze1001', 'juanmanu04', 'ajfriedlan', 'e.desroche', 'kiranpreet.birdee', 'laura.burchell', 'turnergarrow', 'raanapooshimin', '14ers4', 'wolkoff.97', None, 'toto_bssnt', 'waleed97', 'carmud', 'jakeerickson', 'takassa1986', 'sofiaarranz', 'robknobel', 'tmosh5', 'trix012', 'mohamed.balboul', 'will.salmon66']"
31,59,24,18,16,"['reing1ub', 'carmud', 'turnergarrow', 'jakeerickson', 'raanapooshimin', '14ers4', 'sofiaarranz', 'juanmanu04', 'hadiyamadi', 'tmosh5', 'cookiedabaker', 'ajfriedlan', 'kiranpreet.birdee', 'toto_bssnt', 'will.salmon66', 'wdze1001']",7,"['laura.burchell', 'takassa1986', 'e.desroche', 'sandracheng', 'trix012', 'mohamed.balboul', 'lzuluckti']",2,"['robknobel', None]",25,"['reing1ub', 'cookiedabaker', 'sandracheng', 'hadiyamadi', 'lzuluckti', 'wdze1001', 'juanmanu04', 'ajfriedlan', 'e.desroche', 'kiranpreet.birdee', 'laura.burchell', 'turnergarrow', 'raanapooshimin', '14ers4', None, 'toto_bssnt', 'carmud', 'jakeerickson', 'takassa1986', 'sofiaarranz', 'robknobel', 'tmosh5', 'trix012', 'mohamed.balboul', 'will.salmon66']"
32,240,23,21,20,"['behe0119', 'ruva8462', 'brki4304', 'seet2841', 'nuum0371', 'jasc6140', 'sesh9366', 'erda6022', 'miev4575', 'tygo2823', 'shwo0146', 'jajo8985', 'juji9496', 'dyho9085', 'cije3835', 'rico4091', 'mast4941', 'vezh9312', 'ryni0948', 'chva6514']",2,"['azevgolatis', 'jeongdiana']",1,[None],23,"['behe0119', 'ruva8462', 'brki4304', 'azevgolatis', 'nuum0371', 'seet2841', 'jasc6140', 'sesh9366', 'erda6022', 'miev4575', 'tygo2823', 'shwo0146', 'jajo8985', 'juji9496', 'dyho9085', 'cije3835', 'rico4091', 'jeongdiana', None, 'mast4941', 'vezh9312', 'ryni0948', 'chva6514']"
33,275,23,36,14,"['aesaraismat', 'juneeee98', 'izzat2774', 'ashsaifullizan97', 'wanchin', 'kie180029', 'mouxingyu121314', '18081357278hjh', 'wanwan1103', 'adamalfian__', 'moontasirsoumik', 'chenyongchang', 'yuchennn', 'kishen260499']",8,"['amrelda7', 'aminnramli', 'fairuzzamzak', 'aaronmanning1999', 'tsluk', 'ibrahimabdelrahman', 'karim7_albaghdady', 'ahmedgemmy123']",22,"['hong_gao', 'mahafizuddin', 'musabmalek0717', 'desmondsoon', 'nabilah1403', 'zikrizaki88995', 'tamchouweng', 'yjenyiee155', 'youxing0309', 'alifzulkifli99', 'macbelieve', 'amni99', 'kie180028', 'cheokonn', 'redzuan11', 'felice', None, 'khor', 'exjamil', 'syedzakwan', 'jazlilong', 'zahrajl124']",44,"['aminnramli', 'wanchin', 'hong_gao', 'tsluk', 'mahafizuddin', '18081357278hjh', 'musabmalek0717', 'adamalfian__', 'desmondsoon', 'chenyongchang', 'nabilah1403', 'zikrizaki88995', 'karim7_albaghdady', 'tamchouweng', 'mouxingyu121314', 'yjenyiee155', 'wanwan1103', 'youxing0309', 'alifzulkifli99', 'macbelieve', 'kishen260499', 'aaronmanning1999', 'amni99', 'izzat2774', 'kie180028', 'cheokonn', 'redzuan11', 'felice', 'ahmedgemmy123', None, 'amrelda7', 'fairuzzamzak', 'aesaraismat', 'khor', 'juneeee98', 'ashsaifullizan97', 'exjamil', 'syedzakwan', 'ibrahimabdelrahman', 'kie180029', 'jazlilong', 'zahrajl124', 'moontasirsoumik', 'yuchennn']"
34,302,23,23,21,"['kakhil201', 'yaralahruthik', 'tumati.praneeth.17cse', 'jsiddhant12', 'nikita.agarwala.17cse', 'mansi.malik.17cse', 'nikita.arora.17csc', 'anushk123', 'naushik', 'mharshakishan', 'vishal.sharma.17csc', 'kurmala.vishnu.17ece', 'pnarasimha', 'm.ananya.17cse', 'imkrishh3', 'nkonsam', 'tanishqgarg', 'agarwallakshya', 'rahul.kalapala', 'rohit.sharma.17csc', 'codexas']",1,['zbrzubair.akhter'],2,"[None, 'omrahulchauhan']",24,"['kakhil201', 'yaralahruthik', 'tumati.praneeth.17cse', 'jsiddhant12', 'nikita.agarwala.17cse', 'mansi.malik.17cse', 'anushk123', 'nikita.arora.17csc', 'naushik', 'mharshakishan', 'vishal.sharma.17csc', 'omrahulchauhan', 'kurmala.vishnu.17ece', 'zbrzubair.akhter', 'pnarasimha', 'm.ananya.17cse', 'tanishqgarg', 'nkonsam', 'imkrishh3', None, 'agarwallakshya', 'rahul.kalapala', 'rohit.sharma.17csc', 'codexas']"
35,372,22,30,21,"['frankie.hdzfig', 'geflores343', 'laylet.rterrazas', 'mario_fernando', 'adrianrakes', 'glloperenah', 'salmacp7', 'rjimenez', 'luisv33985', 'pmuxea', 'augustocesk2034', 'aida.mir.cor', 'cielo', 'joseluis35', 'sergio.alejandro.pg', 'orgp', 'dabuce31', 'alan.ramirez096', 'karinamadrigal', 'luismunoz', 'esauar']",0,[],9,"['amadormpphy', 'redwing', 'portillo90', '21itzel.julio', 'yulissaevazquez', 'sebastianer', 'elizabeth_mendoza', None, 'euniceolay']",30,"['frankie.hdzfig', 'amadormpphy', 'geflores343', 'laylet.rterrazas', 'mario_fernando', 'redwing', 'portillo90', 'adrianrakes', 'glloperenah', 'elizabeth_mendoza', 'euniceolay', 'salmacp7', 'rjimenez', 'luisv33985', 'yulissaevazquez', 'pmuxea', 'luismunoz', 'augustocesk2034', 'aida.mir.cor', '21itzel.julio', None, 'joseluis35', 'sergio.alejandro.pg', 'orgp', 'dabuce31', 'alan.ramirez096', 'karinamadrigal', 'sebastianer', 'cielo', 'esauar']"
35,236,22,28,21,"['frankie.hdzfig', 'geflores343', 'laylet.rterrazas', 'mario_fernando', 'adrianrakes', 'glloperenah', 'salmacp7', 'rjimenez', 'luisv33985', 'pmuxea', 'augustocesk2034', 'aida.mir.cor', 'cielo', 'joseluis35', 'sergio.alejandro.pg', 'orgp', 'dabuce31', 'alan.ramirez096', 'karinamadrigal', 'luismunoz', 'esauar']",0,[],7,"['amadormpphy', 'redwing', '21itzel.julio', 'sebastianer', 'levi', 'arbol2416', None]",28,"['frankie.hdzfig', 'amadormpphy', 'geflores343', 'laylet.rterrazas', 'mario_fernando', 'redwing', 'adrianrakes', 'glloperenah', 'salmacp7', 'rjimenez', 'luisv33985', 'pmuxea', 'luismunoz', 'augustocesk2034', 'aida.mir.cor', '21itzel.julio', 'levi', 'arbol2416', None, 'joseluis35', 'sergio.alejandro.pg', 'orgp', 'dabuce31', 'alan.ramirez096', 'karinamadrigal', 'sebastianer', 'cielo', 'esauar']"
36,105,21,20,18,"['giozaffar', 'jackietung1219', 'giobarc', 'jonathan.tran.rmit', 'almuhib', 'alsallamin', 'pguerette', 'qinzhao', 'jab13877', 'markopeterkovic', 'genevieve.kunkel', 'akshaytexas88', 'kblandel', 'sal133', 'palmore', 'cli841', 'tworonko', 'gil.goviazin']",2,"['jkadoko', 'ianbakst']",2,"[None, 'buehler']",22,"['jackietung1219', 'jonathan.tran.rmit', 'almuhib', 'kblandel', 'palmore', 'giobarc', 'buehler', 'ianbakst', 'genevieve.kunkel', 'tworonko', 'gil.goviazin', 'alsallamin', 'giozaffar', 'pguerette', 'qinzhao', 'jab13877', None, 'cli841', 'markopeterkovic', 'sal133', 'jkadoko', 'akshaytexas88']"
36,360,21,20,18,"['giozaffar', 'jackietung1219', 'giobarc', 'jonathan.tran.rmit', 'almuhib', 'alsallamin', 'pguerette', 'qinzhao', 'jab13877', 'markopeterkovic', 'genevieve.kunkel', 'akshaytexas88', 'kblandel', 'sal133', 'palmore', 'cli841', 'tworonko', 'gil.goviazin']",2,"['jkadoko', 'ianbakst']",2,"[None, 'buehler']",22,"['jackietung1219', 'jonathan.tran.rmit', 'almuhib', 'kblandel', 'palmore', 'giobarc', 'buehler', 'ianbakst', 'genevieve.kunkel', 'tworonko', 'gil.goviazin', 'alsallamin', 'giozaffar', 'pguerette', 'qinzhao', 'jab13877', None, 'cli841', 'markopeterkovic', 'sal133', 'jkadoko', 'akshaytexas88']"
37,350,21,26,16,"['raiflyon', 'chrisjones', 'kendranoneman', 'tylerwebb508', 'arielweltner', 'jasonpowell1', 'claireadams', 'jiheonkwon', 'oliviamaryon', 'jesseschimpf', 'hunterg54', 'henrikunold', 'nathantokarz', 'kevinsaythavy', 'jameslamb', 'monetalberts']",4,"['jadamsmiller', 'alimustafa', 'gregorynoble27000', 'tic_ticboom']",10,"['johnpage', 'gregorynoble', 'cataanderson1103', 'samuelmcmurdie', 'forestswanson', 'arvincunningham', 'scottbirks', 'bradygarringer', None, 'michaeleppel']",30,"['kendranoneman', 'arvincunningham', 'scottbirks', 'bradygarringer', 'monetalberts', 'chrisjones', 'tylerwebb508', 'gregorynoble', 'cataanderson1103', 'alimustafa', 'jesseschimpf', 'nathantokarz', 'kevinsaythavy', 'tic_ticboom', 'raiflyon', 'johnpage', 'samuelmcmurdie', 'arielweltner', 'forestswanson', 'jasonpowell1', 'hunterg54', None, 'jameslamb', 'jadamsmiller', 'jiheonkwon', 'oliviamaryon', 'michaeleppel', 'claireadams', 'henrikunold', 'gregorynoble27000']"
37,349,21,25,18,"['raiflyon', 'jadamsmiller', 'chrisjones', 'tylerwebb508', 'gregorynoble27000', 'arielweltner', 'alimustafa', 'jasonpowell1', 'claireadams', 'jiheonkwon', 'oliviamaryon', 'jesseschimpf', 'hunterg54', 'henrikunold', 'nathantokarz', 'kevinsaythavy', 'jameslamb', 'monetalberts']",2,"['kendranoneman', 'tic_ticboom']",7,"['gregorynoble', 'cataanderson1103', 'forestswanson', 'lanlibsu', 'scottbirks', None, 'michaeleppel']",27,"['kendranoneman', 'lanlibsu', 'scottbirks', 'monetalberts', 'chrisjones', 'tylerwebb508', 'gregorynoble', 'cataanderson1103', 'alimustafa', 'jesseschimpf', 'nathantokarz', 'kevinsaythavy', 'tic_ticboom', 'raiflyon', 'arielweltner', 'forestswanson', 'jasonpowell1', 'hunterg54', None, 'jameslamb', 'jadamsmiller', 'jiheonkwon', 'oliviamaryon', 'michaeleppel', 'claireadams', 'henrikunold', 'gregorynoble27000']"
37,144,21,24,20,"['kendranoneman', 'monetalberts', 'chrisjones', 'tylerwebb508', 'alimustafa', 'jesseschimpf', 'nathantokarz', 'kevinsaythavy', 'tic_ticboom', 'raiflyon', 'arielweltner', 'jasonpowell1', 'hunterg54', 'jameslamb', 'jadamsmiller', 'jiheonkwon', 'oliviamaryon', 'claireadams', 'henrikunold', 'gregorynoble27000']",0,[],4,"['forestswanson', None, 'gregorynoble', 'lanlibsu']",24,"['kendranoneman', 'lanlibsu', 'monetalberts', 'chrisjones', 'tylerwebb508', 'gregorynoble', 'alimustafa', 'jesseschimpf', 'nathantokarz', 'kevinsaythavy', 'tic_ticboom', 'raiflyon', 'arielweltner', 'forestswanson', 'jasonpowell1', 'hunterg54', None, 'jameslamb', 'jadamsmiller', 'jiheonkwon', 'oliviamaryon', 'claireadams', 'henrikunold', 'gregorynoble27000']"
37,348,21,16,2,"['arielweltner', 'gregorynoble27000']",18,"['raiflyon', 'jadamsmiller', 'chrisjones', 'kendranoneman', 'tylerwebb508', 'alimustafa', 'jasonpowell1', 'claireadams', 'jiheonkwon', 'oliviamaryon', 'jameslamb', 'jesseschimpf', 'hunterg54', 'henrikunold', 'nathantokarz', 'kevinsaythavy', 'tic_ticboom', 'monetalberts']",14,"['gregorynoble', 'steve.r6531', 'samuelpedersen', 'stevejohns', 'addielupercio', 'andrewarmstrong858', 'lanlibsu', 'jordanvandegrift', 'sjriley', 'mar4557', 'tragon', None, 'timphero', 'embersikorski']",34,"['gregorynoble27000', 'kendranoneman', 'mar4557', 'steve.r6531', 'arielweltner', 'samuelpedersen', 'addielupercio', 'stevejohns', 'timphero', 'jasonpowell1', 'lanlibsu', 'jordanvandegrift', 'embersikorski', 'sjriley', 'hunterg54', None, 'jameslamb', 'monetalberts', 'jadamsmiller', 'chrisjones', 'tylerwebb508', 'gregorynoble', 'alimustafa', 'andrewarmstrong858', 'jiheonkwon', 'oliviamaryon', 'jesseschimpf', 'claireadams', 'henrikunold', 'tragon', 'nathantokarz', 'kevinsaythavy', 'tic_ticboom', 'raiflyon']"
38,94,20,22,19,"['sushantbabar2396', 'vitthalkhatmode', 'thush123', 'swara37', 'rutuja15el', 'shettyanish1294', 'aspal.rathod08', 'anishsagvekar9847', 'khamkar.amar2016', 'samir.kane143', 'asifhb21', 'nehashinde631', 'ridz21jan', 'shishirp97', 'uppalrishabh35', 'kartikkanchan95', 'anujchhabra25', '72parab', 'shruti1161997']",0,[],3,"['patilprasad0123', None, 'zeevd19']",22,"['sushantbabar2396', 'vitthalkhatmode', 'thush123', 'swara37', 'rutuja15el', 'shettyanish1294', 'aspal.rathod08', 'anishsagvekar9847', 'khamkar.amar2016', 'samir.kane143', 'asifhb21', 'patilprasad0123', 'nehashinde631', 'ridz21jan', 'shishirp97', None, 'uppalrishabh35', 'kartikkanchan95', 'anujchhabra25', '72parab', 'shruti1161997', 'zeevd19']"
38,319,20,22,19,"['sushantbabar2396', 'vitthalkhatmode', 'thush123', 'swara37', 'rutuja15el', 'shettyanish1294', 'aspal.rathod08', 'anishsagvekar9847', 'khamkar.amar2016', 'samir.kane143', 'asifhb21', 'nehashinde631', 'ridz21jan', 'shishirp97', 'uppalrishabh35', 'kartikkanchan95', 'anujchhabra25', '72parab', 'shruti1161997']",0,[],3,"['patilprasad0123', None, 'zeevd19']",22,"['sushantbabar2396', 'vitthalkhatmode', 'thush123', 'swara37', 'rutuja15el', 'shettyanish1294', 'aspal.rathod08', 'anishsagvekar9847', 'khamkar.amar2016', 'samir.kane143', 'asifhb21', 'patilprasad0123', 'nehashinde631', 'ridz21jan', 'shishirp97', None, 'uppalrishabh35', 'kartikkanchan95', 'anujchhabra25', '72parab', 'shruti1161997', 'zeevd19']"
39,311,20,50,12,"['arpitgodbole7', 'anujmdeorukhkar', 'owais11', 'sanjit', 'prathameshpatle13', 'sonalikharade5', 'sukanyajadhav1997', 'rasikapednekar20', 'salvir481', 'rakeshpatil9271', 'ashnavirdikar.av', 'divyassonawane']",7,"['priyankakunde22', 'javedptl', 'prachi.mujawar', 'adisawant333', 'rajashree.pimputkar', 'akshatask', 'max_mercury']",38,"['akankshachandoskar1198', 'sanket.r.makwana', 'aishwaryahiwale97', 'rahulbirwadkar123', 'bhai0045', 'rushikeshkharat18', 'dilipramgir', 'anujmhatre43', 'ajinkyasoman', 'pranalikothekar5', 'priyankakamble', 'rishimud', 'ashu0497', 'aloksardesai97', 'durgeshthorat4', 'prajaktathorat24', 'gauribahatkar', 'rushikeshrane27', 'rahulkadam7055', 'abhishektoraskar412', 'runakshi97', 'seemasaini282', 'joishersweta17695', 'sourabhkothari16', 'ovrale', 'siddhesh.soyane', 'pjkarmokar', 'aditiramadwar', 'rohanotari21', None, 'kajalbhoite04', 'nikwade.damini95', 'arpitakudesia3011', 'aquibansari12377', 'sohammhas', 'kalyanisahib96', 'zainabshah181997', 'kedar.kulkarni12']",57,"['akankshachandoskar1198', 'sanjit', 'rahulbirwadkar123', 'dilipramgir', 'rushikeshkharat18', 'anujmhatre43', 'ajinkyasoman', 'prathameshpatle13', 'priyankakunde22', 'rishimud', 'ashu0497', 'salvir481', 'rushikeshrane27', 'rahulkadam7055', 'abhishektoraskar412', 'runakshi97', 'joishersweta17695', 'sourabhkothari16', 'sukanyajadhav1997', 'siddhesh.soyane', 'pjkarmokar', 'aditiramadwar', 'divyassonawane', 'kajalbhoite04', 'sohammhas', 'kalyanisahib96', 'rakeshpatil9271', 'ashnavirdikar.av', 'rajashree.pimputkar', 'sanket.r.makwana', 'aishwaryahiwale97', 'sonalikharade5', 'bhai0045', 'adisawant333', 'anujmdeorukhkar', 'pranalikothekar5', 'priyankakamble', 'javedptl', 'aloksardesai97', 'prachi.mujawar', 'durgeshthorat4', 'prajaktathorat24', 'akshatask', 'gauribahatkar', 'arpitgodbole7', 'owais11', 'seemasaini282', 'ovrale', 'rasikapednekar20', 'rohanotari21', None, 'nikwade.damini95', 'arpitakudesia3011', 'aquibansari12377', 'zainabshah181997', 'max_mercury', 'kedar.kulkarni12']"
39,326,20,42,14,"['arpitgodbole7', 'anujmdeorukhkar', 'owais11', 'sanjit', 'prathameshpatle13', 'priyankakunde22', 'sonalikharade5', 'sukanyajadhav1997', 'rasikapednekar20', 'salvir481', 'adisawant333', 'rakeshpatil9271', 'ashnavirdikar.av', 'divyassonawane']",5,"['javedptl', 'prachi.mujawar', 'rajashree.pimputkar', 'akshatask', 'max_mercury']",28,"['prathamesh.shivmare1', 'akankshachandoskar1198', 'welingnamrata', 'hsnnalwala7', 'rahulbirwadkar123', 'pnrs.pratik', 'bhai0045', 'pranjalijadhav0911', 'pranalikothekar5', 'jinku5454', 'bendalneha', 'prajaktathorat24', 'urmil1700', 'gauribahatkar', 'joishersweta17695', 'sourabhkothari16', 'aditiramadwar', 'rakeshpatil3019', None, 'bhupeshpatil98', 'kajalbhoite04', 'arfat_24', 'aquibansari12377', 'aritramondal151', 'rohit.elawadekar333', '100vichare', 'shripal17', 'kedar.kulkarni12']",47,"['prathamesh.shivmare1', 'akankshachandoskar1198', 'welingnamrata', 'sanjit', 'hsnnalwala7', 'sonalikharade5', 'rahulbirwadkar123', 'pnrs.pratik', 'bhai0045', 'adisawant333', 'pranjalijadhav0911', 'anujmdeorukhkar', 'pranalikothekar5', 'prathameshpatle13', 'priyankakunde22', 'jinku5454', 'javedptl', 'bendalneha', 'salvir481', 'prachi.mujawar', 'prajaktathorat24', 'urmil1700', 'akshatask', 'gauribahatkar', 'arpitgodbole7', 'owais11', 'joishersweta17695', 'sourabhkothari16', 'sukanyajadhav1997', 'rasikapednekar20', 'aditiramadwar', 'rakeshpatil3019', None, 'divyassonawane', 'kajalbhoite04', 'bhupeshpatil98', 'arfat_24', 'aquibansari12377', '100vichare', 'rakeshpatil9271', 'aritramondal151', 'ashnavirdikar.av', 'rohit.elawadekar333', 'rajashree.pimputkar', 'shripal17', 'max_mercury', 'kedar.kulkarni12']"
39,313,20,22,2,"['prachi.mujawar', 'max_mercury']",17,"['arpitgodbole7', 'anujmdeorukhkar', 'owais11', 'sanjit', 'prathameshpatle13', 'priyankakunde22', 'sonalikharade5', 'javedptl', 'sukanyajadhav1997', 'rasikapednekar20', 'salvir481', 'adisawant333', 'rakeshpatil9271', 'ashnavirdikar.av', 'rajashree.pimputkar', 'akshatask', 'divyassonawane']",20,"['inamdarshreyas5', 'nanomems226', 'omimore24', 'rahulbirwadkar123', 'rutujakamthe', 'sagar21', 'saritav.9600', 'swastik2', 'pranav123', 'ashu0497', 'deep.patel', 'piyamodhve', 'nageshjaiswar11', 'arushi.yadav', 'shantanu123', 'akshaybhore7', None, 'verma_34dh', 'mayurpashte97', 'tanvipalande']",39,"['inamdarshreyas5', 'nanomems226', 'sanjit', 'sonalikharade5', 'omimore24', 'rahulbirwadkar123', 'rutujakamthe', 'adisawant333', 'sagar21', 'saritav.9600', 'anujmdeorukhkar', 'swastik2', 'prathameshpatle13', 'priyankakunde22', 'pranav123', 'javedptl', 'ashu0497', 'deep.patel', 'salvir481', 'prachi.mujawar', 'akshatask', 'piyamodhve', 'arpitgodbole7', 'nageshjaiswar11', 'owais11', 'sukanyajadhav1997', 'rasikapednekar20', 'arushi.yadav', 'shantanu123', 'akshaybhore7', None, 'verma_34dh', 'divyassonawane', 'mayurpashte97', 'tanvipalande', 'rakeshpatil9271', 'ashnavirdikar.av', 'rajashree.pimputkar', 'max_mercury']"
39,312,20,19,7,"['owais11', 'priyankakunde22', 'prachi.mujawar', 'adisawant333', 'rajashree.pimputkar', 'max_mercury', 'divyassonawane']",12,"['arpitgodbole7', 'anujmdeorukhkar', 'sanjit', 'prathameshpatle13', 'sonalikharade5', 'javedptl', 'sukanyajadhav1997', 'rasikapednekar20', 'salvir481', 'rakeshpatil9271', 'ashnavirdikar.av', 'akshatask']",12,"['rms.maurya21', 'hsnnalwala7', 'shripal17', 'bhandarepranay9208', 'rishimud', 'pnrs.pratik', 'kaushiksawant93', 'siddhesh.soyane', 'pranjalijadhav0911', 'susmeetsukte', 'ardalvi85', None]",31,"['sanjit', 'hsnnalwala7', 'sonalikharade5', 'pnrs.pratik', 'adisawant333', 'pranjalijadhav0911', 'anujmdeorukhkar', 'rms.maurya21', 'prathameshpatle13', 'priyankakunde22', 'rishimud', 'javedptl', 'salvir481', 'prachi.mujawar', 'susmeetsukte', 'akshatask', 'arpitgodbole7', 'owais11', 'bhandarepranay9208', 'kaushiksawant93', 'sukanyajadhav1997', 'rasikapednekar20', 'siddhesh.soyane', None, 'divyassonawane', 'rakeshpatil9271', 'ashnavirdikar.av', 'ardalvi85', 'rajashree.pimputkar', 'shripal17', 'max_mercury']"
39,246,20,17,3,"['prathameshpatle13', 'priyankakunde22', 'owais11']",16,"['arpitgodbole7', 'anujmdeorukhkar', 'sanjit', 'sonalikharade5', 'javedptl', 'sukanyajadhav1997', 'rasikapednekar20', 'salvir481', 'adisawant333', 'prachi.mujawar', 'rakeshpatil9271', 'ashnavirdikar.av', 'rajashree.pimputkar', 'akshatask', 'max_mercury', 'divyassonawane']",14,"['abhishektoraskar412', 'shraddhagadankush1998', 'priyankakamble', 'sohammhas', 'ashu0497', 'ankitagamare2218', 'siddhant8291', 'aloksardesai97', 'saketnaik', 'mayur.manve4', None, 'aritramondal151', 'arshan.ansari002', 'msawant869']",33,"['arpitgodbole7', 'owais11', 'sanjit', 'shraddhagadankush1998', 'abhishektoraskar412', 'sonalikharade5', 'sukanyajadhav1997', 'rasikapednekar20', 'adisawant333', 'msawant869', None, 'divyassonawane', 'anujmdeorukhkar', 'prathameshpatle13', 'priyankakunde22', 'priyankakamble', 'sohammhas', 'javedptl', 'ashu0497', 'ankitagamare2218', 'siddhant8291', 'aloksardesai97', 'saketnaik', 'salvir481', 'prachi.mujawar', 'rakeshpatil9271', 'ashnavirdikar.av', 'mayur.manve4', 'aritramondal151', 'rajashree.pimputkar', 'arshan.ansari002', 'akshatask', 'max_mercury']"
39,245,20,12,6,"['anujmdeorukhkar', 'owais11', 'javedptl', 'sukanyajadhav1997', 'salvir481', 'rajashree.pimputkar']",13,"['arpitgodbole7', 'sanjit', 'priyankakunde22', 'prathameshpatle13', 'sonalikharade5', 'rasikapednekar20', 'prachi.mujawar', 'adisawant333', 'rakeshpatil9271', 'ashnavirdikar.av', 'akshatask', 'max_mercury', 'divyassonawane']",6,"['gabru1803', 'ankitagamare2218', 'rohit.elawadekar333', 'rohanotari21', 'arshan.ansari002', None]",25,"['arpitgodbole7', 'gabru1803', 'owais11', 'sanjit', 'sonalikharade5', 'sukanyajadhav1997', 'rasikapednekar20', 'adisawant333', 'rohanotari21', None, 'divyassonawane', 'anujmdeorukhkar', 'prathameshpatle13', 'priyankakunde22', 'javedptl', 'ankitagamare2218', 'salvir481', 'prachi.mujawar', 'rakeshpatil9271', 'ashnavirdikar.av', 'rohit.elawadekar333', 'rajashree.pimputkar', 'arshan.ansari002', 'akshatask', 'max_mercury']"
39,249,20,12,1,['max_mercury'],18,"['arpitgodbole7', 'anujmdeorukhkar', 'owais11', 'sanjit', 'prathameshpatle13', 'priyankakunde22', 'sonalikharade5', 'javedptl', 'sukanyajadhav1997', 'rasikapednekar20', 'salvir481', 'adisawant333', 'prachi.mujawar', 'rakeshpatil9271', 'ashnavirdikar.av', 'rajashree.pimputkar', 'akshatask', 'divyassonawane']",11,"['rahulkadam7055', 'kedar.kulkarni12', 'kajaldevake30', 'neha10patade', 'roshanpoojari31', 'rishimud', 'pranay.kesarkar1', 'shelar.chetan4', 'dilipramgir', None, 'nandakale98']",30,"['arpitgodbole7', 'rahulkadam7055', 'kajaldevake30', 'owais11', 'sanjit', 'sonalikharade5', 'sukanyajadhav1997', 'rasikapednekar20', 'adisawant333', 'shelar.chetan4', 'roshanpoojari31', 'dilipramgir', None, 'nandakale98', 'divyassonawane', 'anujmdeorukhkar', 'neha10patade', 'prathameshpatle13', 'priyankakunde22', 'rishimud', 'javedptl', 'salvir481', 'prachi.mujawar', 'rakeshpatil9271', 'ashnavirdikar.av', 'pranay.kesarkar1', 'rajashree.pimputkar', 'akshatask', 'max_mercury', 'kedar.kulkarni12']"
39,314,20,10,2,"['akshatask', 'max_mercury']",17,"['arpitgodbole7', 'anujmdeorukhkar', 'owais11', 'sanjit', 'prathameshpatle13', 'priyankakunde22', 'sonalikharade5', 'javedptl', 'sukanyajadhav1997', 'rasikapednekar20', 'salvir481', 'adisawant333', 'prachi.mujawar', 'rakeshpatil9271', 'ashnavirdikar.av', 'rajashree.pimputkar', 'divyassonawane']",8,"['shantanupanigrahi98', 'pranav123', 'aloksardesai97', 'chetushirke', 'rutujakamthe', None, 'mayanksamar786', 'sarika_bukkawar']",27,"['arpitgodbole7', 'shantanupanigrahi98', 'owais11', 'sanjit', 'sonalikharade5', 'sukanyajadhav1997', 'rasikapednekar20', 'rutujakamthe', 'adisawant333', 'mayanksamar786', None, 'divyassonawane', 'sarika_bukkawar', 'anujmdeorukhkar', 'prathameshpatle13', 'priyankakunde22', 'pranav123', 'javedptl', 'aloksardesai97', 'chetushirke', 'salvir481', 'prachi.mujawar', 'rakeshpatil9271', 'ashnavirdikar.av', 'rajashree.pimputkar', 'akshatask', 'max_mercury']"
39,251,20,9,5,"['arpitgodbole7', 'sonalikharade5', 'rasikapednekar20', 'ashnavirdikar.av', 'akshatask']",14,"['anujmdeorukhkar', 'owais11', 'sanjit', 'priyankakunde22', 'prathameshpatle13', 'javedptl', 'sukanyajadhav1997', 'salvir481', 'adisawant333', 'prachi.mujawar', 'rakeshpatil9271', 'rajashree.pimputkar', 'max_mercury', 'divyassonawane']",4,"['dshantanu2902', 'iammayuri3', None, 'susmeetsukte']",23,"['arpitgodbole7', 'owais11', 'sanjit', 'sonalikharade5', 'sukanyajadhav1997', 'rasikapednekar20', 'adisawant333', 'iammayuri3', 'dshantanu2902', None, 'divyassonawane', 'anujmdeorukhkar', 'prathameshpatle13', 'priyankakunde22', 'javedptl', 'salvir481', 'prachi.mujawar', 'rakeshpatil9271', 'ashnavirdikar.av', 'susmeetsukte', 'rajashree.pimputkar', 'akshatask', 'max_mercury']"
39,325,20,8,1,['rajashree.pimputkar'],18,"['arpitgodbole7', 'anujmdeorukhkar', 'owais11', 'sanjit', 'prathameshpatle13', 'priyankakunde22', 'sonalikharade5', 'javedptl', 'sukanyajadhav1997', 'rasikapednekar20', 'salvir481', 'adisawant333', 'prachi.mujawar', 'rakeshpatil9271', 'ashnavirdikar.av', 'akshatask', 'max_mercury', 'divyassonawane']",7,"['inamdarshreyas5', 'omimore24', 'nicket9', 'adityakini21', 'juileebharate10797', None, 'piyamodhve']",26,"['inamdarshreyas5', 'arpitgodbole7', 'owais11', 'sanjit', 'sonalikharade5', 'omimore24', 'nicket9', 'sukanyajadhav1997', 'rasikapednekar20', 'adisawant333', 'adityakini21', None, 'divyassonawane', 'anujmdeorukhkar', 'prathameshpatle13', 'priyankakunde22', 'javedptl', 'salvir481', 'prachi.mujawar', 'rakeshpatil9271', 'ashnavirdikar.av', 'juileebharate10797', 'piyamodhve', 'rajashree.pimputkar', 'akshatask', 'max_mercury']"
39,329,20,7,2,"['rajashree.pimputkar', 'prachi.mujawar']",17,"['arpitgodbole7', 'anujmdeorukhkar', 'owais11', 'sanjit', 'prathameshpatle13', 'priyankakunde22', 'sonalikharade5', 'javedptl', 'sukanyajadhav1997', 'rasikapednekar20', 'salvir481', 'adisawant333', 'rakeshpatil9271', 'ashnavirdikar.av', 'akshatask', 'max_mercury', 'divyassonawane']",5,"['pranav123', 'omimore24', 'rutujakamthe', None, 'piyamodhve']",24,"['arpitgodbole7', 'owais11', 'sanjit', 'sonalikharade5', 'omimore24', 'sukanyajadhav1997', 'rasikapednekar20', 'rutujakamthe', 'adisawant333', None, 'divyassonawane', 'anujmdeorukhkar', 'prathameshpatle13', 'priyankakunde22', 'pranav123', 'javedptl', 'salvir481', 'prachi.mujawar', 'rakeshpatil9271', 'ashnavirdikar.av', 'piyamodhve', 'rajashree.pimputkar', 'akshatask', 'max_mercury']"
40,47,20,16,11,"['michele2', 'lia2708', 'tactyle', 'valentin1', 'susi', 'kzojer', 'evagasser', 'flipgard', 'martin92', 'nano_jack', 'millner89']",8,"['nixmoke', 't.chadzynski', 'jasmin.pfleger1997', 'michael.gobald', 'yacine', 'katharinaaa', 'praram', 'elmar.aichberger']",5,"['hirberm', 'christina20', 'katharina.m', 'birkam', None]",24,"['christina20', 'tactyle', 'susi', 'michael.gobald', 'kzojer', 'evagasser', 'katharinaaa', 'flipgard', 'martin92', 'praram', 'katharina.m', None, 'nixmoke', 'lia2708', 'michele2', 't.chadzynski', 'hirberm', 'valentin1', 'jasmin.pfleger1997', 'yacine', 'nano_jack', 'millner89', 'birkam', 'elmar.aichberger']"
40,48,20,13,12,"['michele2', 'lia2708', 'tactyle', 'valentin1', 'jasmin.pfleger1997', 'susi', 'michael.gobald', 'yacine', 'flipgard', 'katharinaaa', 'nano_jack', 'elmar.aichberger']",7,"['nixmoke', 't.chadzynski', 'kzojer', 'evagasser', 'martin92', 'praram', 'millner89']",1,[None],20,"['tactyle', 'susi', 'michael.gobald', 'kzojer', 'evagasser', 'katharinaaa', 'flipgard', 'martin92', 'praram', None, 'nixmoke', 'lia2708', 'michele2', 't.chadzynski', 'valentin1', 'jasmin.pfleger1997', 'yacine', 'nano_jack', 'millner89', 'elmar.aichberger']"
41,146,20,27,11,"['zhou646', 'kswiatk', 'ddmckay', 'alotaibi', 'peter496', 'ma130029', 'unitas', 'mandejan', 'mill1914', 'abhivictor2', 'zhan1337']",8,"['anavarka', 'ncummock', 'zhan3294', 'sandracore21', 'samantas', 'zguilian', 'jlburn31', 'bdw19971231']",16,"['vkattaku', 'atkins18', 'kristiaan2017', 'psiripur', 'pkaundin', 'ianbernander', 'paulmather', 'ian.strachan9', 'sabareesh169', 'azadoks', 'alafzi', 'jverduzc', 'beck50', None, 'dheeraj.peddireddy', 'atunga']",35,"['psiripur', 'kswiatk', 'anavarka', 'ncummock', 'zhan3294', 'paulmather', 'peter496', 'samantas', 'ma130029', 'zhan1337', 'vkattaku', 'zhou646', 'kristiaan2017', 'alotaibi', 'unitas', 'zguilian', 'mill1914', 'ian.strachan9', 'sandracore21', 'azadoks', 'alafzi', 'jverduzc', 'bdw19971231', 'beck50', 'jlburn31', 'mandejan', None, 'dheeraj.peddireddy', 'atkins18', 'pkaundin', 'ianbernander', 'ddmckay', 'sabareesh169', 'abhivictor2', 'atunga']"
41,149,20,17,1,['abhivictor2'],18,"['zhou646', 'kswiatk', 'anavarka', 'ncummock', 'zhan3294', 'sandracore21', 'alotaibi', 'peter496', 'ddmckay', 'samantas', 'ma130029', 'unitas', 'mandejan', 'zguilian', 'jlburn31', 'mill1914', 'zhan1337', 'bdw19971231']",16,"['vkattaku', 'desai61', 'mcclurez', 'mademoiselle0812', 'psiripur', 'tfleck', 'paulmather', 'huang714', 'sakin', 'alafzi', 'dbenham', 'jverduzc', 'jhartl', None, 'gjhanwar', 'atunga']",35,"['psiripur', 'kswiatk', 'anavarka', 'ncummock', 'zhan3294', 'sandracore21', 'tfleck', 'peter496', 'paulmather', 'samantas', 'ma130029', 'alafzi', 'jverduzc', 'bdw19971231', 'jlburn31', 'mandejan', None, 'zhan1337', 'gjhanwar', 'huang714', 'vkattaku', 'zhou646', 'mcclurez', 'mademoiselle0812', 'desai61', 'ddmckay', 'alotaibi', 'sakin', 'unitas', 'dbenham', 'jhartl', 'zguilian', 'mill1914', 'abhivictor2', 'atunga']"
41,145,20,11,3,"['ma130029', 'ncummock', 'mill1914']",16,"['zhou646', 'kswiatk', 'anavarka', 'zhan3294', 'sandracore21', 'alotaibi', 'peter496', 'ddmckay', 'samantas', 'unitas', 'zguilian', 'jlburn31', 'mandejan', 'abhivictor2', 'zhan1337', 'bdw19971231']",8,"['vkattaku', 'kkoradiy', 'paulmather', 'dcappell', 'sabareesh169', 'alafzi', 'pkolis', None]",27,"['kkoradiy', 'kswiatk', 'anavarka', 'ncummock', 'zhan3294', 'sandracore21', 'paulmather', 'peter496', 'samantas', 'ma130029', 'alafzi', 'pkolis', 'bdw19971231', 'jlburn31', 'mandejan', None, 'zhan1337', 'vkattaku', 'zhou646', 'ddmckay', 'alotaibi', 'dcappell', 'sabareesh169', 'unitas', 'zguilian', 'mill1914', 'abhivictor2']"
41,148,20,11,1,['mill1914'],18,"['zhou646', 'kswiatk', 'anavarka', 'ncummock', 'zhan3294', 'sandracore21', 'alotaibi', 'peter496', 'ddmckay', 'samantas', 'ma130029', 'unitas', 'zguilian', 'jlburn31', 'mandejan', 'abhivictor2', 'zhan1337', 'bdw19971231']",10,"['vkattaku', 'kristiaan2017', 'psiripur', 'desai61', 'paulmather', 'davi1004', 'jverduzc', 'kolispeter', None, 'huang714']",29,"['psiripur', 'kswiatk', 'anavarka', 'ncummock', 'zhan3294', 'sandracore21', 'paulmather', 'peter496', 'davi1004', 'samantas', 'ma130029', 'jverduzc', 'bdw19971231', 'jlburn31', 'mandejan', None, 'zhan1337', 'huang714', 'vkattaku', 'zhou646', 'kristiaan2017', 'desai61', 'kolispeter', 'ddmckay', 'alotaibi', 'unitas', 'zguilian', 'mill1914', 'abhivictor2']"
41,147,20,6,1,['mill1914'],18,"['zhou646', 'kswiatk', 'anavarka', 'ncummock', 'zhan3294', 'sandracore21', 'alotaibi', 'peter496', 'ddmckay', 'samantas', 'ma130029', 'unitas', 'zguilian', 'jlburn31', 'mandejan', 'abhivictor2', 'zhan1337', 'bdw19971231']",5,"['vkattaku', 'kristiaan2017', 'alafzi', 'jverduzc', None]",24,"['kswiatk', 'anavarka', 'ncummock', 'zhan3294', 'sandracore21', 'peter496', 'samantas', 'ma130029', 'alafzi', 'jverduzc', 'bdw19971231', 'jlburn31', 'mandejan', None, 'zhan1337', 'vkattaku', 'zhou646', 'kristiaan2017', 'ddmckay', 'alotaibi', 'unitas', 'zguilian', 'mill1914', 'abhivictor2']"
42,216,20,126,18,"['smit3180', 'nramli', 'xng', 'tthieles', 'caldwe29', 'eforti', 'shaw108', 'jrohman', 'cbischof', 'nafandi', 'rao75', 'davids19', 'vwallema', 'cpiepen', 'muelle77', 'aguyre', 'mcdona85', 'jkueche']",1,['gmclaugh'],108,"['ggauthi', 'geyerg', 'arturotrevino', 'wan52', 'akreuter', 'yeager5', 'bsmrdel', 'btestin14', 'starr21', 'vpope', 'nt230', 'wstolz', 'suhaira97', 'ikobayas', 'yang1206', 'lee2370', 'itsmemario', 'conner.swift8', 'john1886', 'afalkenb', 'tgiazzon', 'justj', 'cmelchin', 'ryanwest1040', 'charlesma423', 'george7elias', 'boninim', 'evdaly', 'jkekre', 'cclapham', 'fischermben', 'landon.glunt', 'mcrees', 'jdanek', 'psumner', 'kgmcginley', 'nathanmoore', 'angbecker', 'samm', 'sueprasad8214', 'ggolla', 'chanwoo.lee.17', 'amckeska', 'ebehring', 'ryry1644', 'dschull', 'purduechen2203', 'cartmaster007', 'hyndmanjustin', 'anthonm', 'dgreiwe', 'chiranth7954', 'jwoon', 'nhdorcy', 'ehonebri', 'shadow66666', 'talon34567', 'huan1146', 'rishiprasadha', 'radhakr3', 'jacobglvn', 'jfolkers', 'joshuajkporter', 'agalema1027', 'suran9712', 'akonopa', 'oliver67', 'hess35', 'kskripakaran0810', 'asartor', 'tilley0', 'crhodine', 'mingusnate', 'kjh94425', 'maxwellfra16', 'garret28', 'zjohnson834', 'rhellyer', 'mcclure8', 'nikhilcarneiro4', 'kruege14', 'albrect', 'ecronin', 'dkilgor', 'heinzt', 'akreilei', 'srasche', 'rsusler', 'rwiebe', 'kknowlto', None, 'river132', 'jskeens', 'yizhizhang', 'selawada', 'dsfgdsfg', 'acostab', 'khageman', 'kevinodonnell0878', 'lmeehann', 'sknecht', 'goh5', 'kico', 'mccaul', 'rao53', 'singh378', 'rileyedelaney', 'athoman']",127,"['ggauthi', 'arturotrevino', 'wan52', 'vwallema', 'btestin14', 'starr21', 'nt230', 'wstolz', 'xng', 'itsmemario', 'conner.swift8', 'eforti', 'afalkenb', 'tgiazzon', 'evdaly', 'jkekre', 'mcrees', 'cbischof', 'jdanek', 'psumner', 'kgmcginley', 'sueprasad8214', 'amckeska', 'nafandi', 'davids19', 'anthonm', 'dgreiwe', 'smit3180', 'rishiprasadha', 'akonopa', 'hess35', 'tilley0', 'crhodine', 'mingusnate', 'kjh94425', 'mcclure8', 'nikhilcarneiro4', 'srasche', 'rsusler', 'rwiebe', 'river132', 'selawada', 'dsfgdsfg', 'tthieles', 'khageman', 'sknecht', 'goh5', 'muelle77', 'aguyre', 'singh378', 'rileyedelaney', 'geyerg', 'akreuter', 'yeager5', 'bsmrdel', 'vpope', 'suhaira97', 'ikobayas', 'yang1206', 'lee2370', 'jrohman', 'john1886', 'justj', 'cmelchin', 'ryanwest1040', 'charlesma423', 'george7elias', 'boninim', 'cclapham', 'fischermben', 'landon.glunt', 'rao75', 'nathanmoore', 'angbecker', 'samm', 'ggolla', 'chanwoo.lee.17', 'ebehring', 'ryry1644', 'dschull', 'purduechen2203', 'cartmaster007', 'hyndmanjustin', 'chiranth7954', 'jwoon', 'caldwe29', 'shaw108', 'nhdorcy', 'ehonebri', 'shadow66666', 'talon34567', 'huan1146', 'cpiepen', 'radhakr3', 'jacobglvn', 'jfolkers', 'joshuajkporter', 'agalema1027', 'suran9712', 'oliver67', 'kskripakaran0810', 'asartor', 'maxwellfra16', 'garret28', 'zjohnson834', 'rhellyer', 'jkueche', 'kruege14', 'albrect', 'nramli', 'ecronin', 'dkilgor', 'heinzt', 'akreilei', 'gmclaugh', 'mcdona85', 'kknowlto', None, 'jskeens', 'yizhizhang', 'acostab', 'kevinodonnell0878', 'lmeehann', 'kico', 'mccaul', 'rao53', 'athoman']"
42,277,20,22,18,"['smit3180', 'nramli', 'xng', 'tthieles', 'caldwe29', 'jrohman', 'shaw108', 'nafandi', 'cbischof', 'rao75', 'davids19', 'vwallema', 'gmclaugh', 'cpiepen', 'muelle77', 'aguyre', 'mcdona85', 'jkueche']",1,['eforti'],4,"['starr21', None, 'wan52', 'mshisheh']",23,"['smit3180', 'wan52', 'caldwe29', 'shaw108', 'vwallema', 'cpiepen', 'starr21', 'xng', 'eforti', 'jrohman', 'mshisheh', 'jkueche', 'nramli', 'cbischof', 'rao75', 'gmclaugh', 'mcdona85', None, 'tthieles', 'nafandi', 'davids19', 'muelle77', 'aguyre']"
42,278,20,6,4,"['rao75', 'shaw108', 'cbischof', 'caldwe29']",15,"['smit3180', 'nramli', 'xng', 'tthieles', 'eforti', 'jrohman', 'nafandi', 'davids19', 'vwallema', 'gmclaugh', 'cpiepen', 'muelle77', 'aguyre', 'mcdona85', 'jkueche']",2,"['chunyuli', None]",21,"['smit3180', 'nramli', 'caldwe29', 'shaw108', 'cbischof', 'rao75', 'vwallema', 'gmclaugh', 'cpiepen', 'mcdona85', None, 'xng', 'tthieles', 'eforti', 'jrohman', 'nafandi', 'chunyuli', 'davids19', 'muelle77', 'aguyre', 'jkueche']"
43,354,20,37,1,['hmfei'],18,"['jinmo', 'ljm79541', 'cifer', 'zhaowenjuan', 'jklei', 'yuziboziguang', 'xiaoyy', 'gerrywong', 'limengxin180493', 'shushan1', 'liuweixun96', 'qisha', 'yu123', 'hujinding', 'huijunz123', 'mhn0830', 'md0318', 'xiaoyuwang']",36,"['judywei0101', 'pochangshih', 'xinranz1216104', 'neelb96', 'murlocking', 'robin1221', 'yuchun7', 'derekrsdhl', 'frankpan96', 'gibbsfree', 'tsaijuming', 'osgarcia', 'hardikh94', 'aghazari', 'oleon95', 'pshir', 'federicobea95', 'ruoxia', 'davidkelly', 'ksanche32', 'arthurssu', 'shikamaru0922', 'uclahuangxin', 'yingjied', 'yihong0807', 'kfitzell29', 'boyao', 'chuang5679', 'shushujie', None, 'jameskpenney', 'qianliu0120', 'viraatsh', 'mfossella', 'bndefru', 'curtis804']",55,"['jinmo', 'judywei0101', 'zhaowenjuan', 'jklei', 'pochangshih', 'xiaoyy', 'gerrywong', 'xinranz1216104', 'neelb96', 'murlocking', 'yu123', 'hujinding', 'robin1221', 'huijunz123', 'yuchun7', 'mhn0830', 'derekrsdhl', 'frankpan96', 'ljm79541', 'gibbsfree', 'tsaijuming', 'yuziboziguang', 'liuweixun96', 'osgarcia', 'hardikh94', 'aghazari', 'oleon95', 'federicobea95', 'pshir', 'ruoxia', 'davidkelly', 'ksanche32', 'hmfei', 'arthurssu', 'shikamaru0922', 'uclahuangxin', 'yingjied', 'curtis804', 'limengxin180493', 'shushan1', 'qisha', 'yihong0807', 'kfitzell29', 'boyao', 'chuang5679', 'shushujie', 'md0318', None, 'jameskpenney', 'cifer', 'qianliu0120', 'viraatsh', 'mfossella', 'bndefru', 'xiaoyuwang']"
43,102,20,20,16,"['jinmo', 'cifer', 'zhaowenjuan', 'jklei', 'yuziboziguang', 'xiaoyy', 'gerrywong', 'limengxin180493', 'shushan1', 'liuweixun96', 'qisha', 'yu123', 'huijunz123', 'mhn0830', 'md0318', 'xiaoyuwang']",3,"['hujinding', 'hmfei', 'ljm79541']",4,"['viki1', 'laofan', None, 'changjiu1']",23,"['jinmo', 'viki1', 'changjiu1', 'zhaowenjuan', 'jklei', 'xiaoyy', 'gerrywong', 'yu123', 'hujinding', 'huijunz123', 'mhn0830', 'ljm79541', 'yuziboziguang', 'laofan', 'liuweixun96', 'hmfei', 'limengxin180493', 'shushan1', 'qisha', 'md0318', None, 'cifer', 'xiaoyuwang']"
43,104,20,18,15,"['jinmo', 'ljm79541', 'cifer', 'zhaowenjuan', 'jklei', 'xiaoyy', 'shushan1', 'limengxin180493', 'qisha', 'liuweixun96', 'hujinding', 'yu123', 'huijunz123', 'mhn0830', 'md0318']",4,"['yuziboziguang', 'gerrywong', 'hmfei', 'xiaoyuwang']",3,"['viki1', 'laofan', None]",22,"['jinmo', 'viki1', 'hmfei', 'zhaowenjuan', 'jklei', 'xiaoyy', 'gerrywong', 'limengxin180493', 'shushan1', 'qisha', 'yu123', 'hujinding', 'huijunz123', 'mhn0830', 'md0318', None, 'ljm79541', 'cifer', 'yuziboziguang', 'laofan', 'liuweixun96', 'xiaoyuwang']"
43,359,20,10,8,"['jinmo', 'ljm79541', 'jklei', 'shushan1', 'hujinding', 'mhn0830', 'md0318', 'xiaoyuwang']",11,"['hmfei', 'cifer', 'zhaowenjuan', 'yuziboziguang', 'xiaoyy', 'gerrywong', 'limengxin180493', 'liuweixun96', 'qisha', 'yu123', 'huijunz123']",2,"['lifu.yan170457', None]",21,"['jinmo', 'hmfei', 'zhaowenjuan', 'jklei', 'xiaoyy', 'gerrywong', 'limengxin180493', 'shushan1', 'qisha', 'lifu.yan170457', 'yu123', 'hujinding', 'huijunz123', 'mhn0830', 'md0318', None, 'ljm79541', 'cifer', 'yuziboziguang', 'liuweixun96', 'xiaoyuwang']"
43,103,20,9,7,"['jinmo', 'xiaoyy', 'limengxin180493', 'yu123', 'mhn0830', 'md0318', 'xiaoyuwang']",12,"['hmfei', 'ljm79541', 'cifer', 'zhaowenjuan', 'jklei', 'yuziboziguang', 'gerrywong', 'shushan1', 'liuweixun96', 'qisha', 'hujinding', 'huijunz123']",2,"['laofan', None]",21,"['jinmo', 'hmfei', 'zhaowenjuan', 'jklei', 'xiaoyy', 'gerrywong', 'limengxin180493', 'shushan1', 'qisha', 'yu123', 'hujinding', 'huijunz123', 'mhn0830', 'md0318', None, 'ljm79541', 'cifer', 'yuziboziguang', 'laofan', 'liuweixun96', 'xiaoyuwang']"
44,374,19,16,15,"['shahzad.rida.rs', 'sohailnagra127', 'onlineclass96', 'zeaghamkapco13', 'arish.adil', 'shahzaib75', 'shujahrehman1', 'mehrwaqar786', 'rizwana', 'kaynatalvi', 'aminah87', 'reebaraza', 'hadia.fatima.ach', 'abs133', 'nbutt']",3,"['sajid72hussain', 'samreennazeer', 'hywong2']",1,[None],19,"['shahzad.rida.rs', 'sohailnagra127', 'shujahrehman1', 'hywong2', 'mehrwaqar786', 'hadia.fatima.ach', None, 'samreennazeer', 'zeaghamkapco13', 'onlineclass96', 'arish.adil', 'shahzaib75', 'rizwana', 'kaynatalvi', 'aminah87', 'reebaraza', 'sajid72hussain', 'abs133', 'nbutt']"
44,375,19,8,7,"['shahzad.rida.rs', 'shahzaib75', 'mehrwaqar786', 'kaynatalvi', 'hadia.fatima.ach', 'abs133', 'nbutt']",11,"['sohailnagra127', 'onlineclass96', 'zeaghamkapco13', 'arish.adil', 'shujahrehman1', 'rizwana', 'aminah87', 'reebaraza', 'sajid72hussain', 'samreennazeer', 'hywong2']",1,[None],19,"['shahzad.rida.rs', 'sohailnagra127', 'shujahrehman1', 'hywong2', 'mehrwaqar786', 'hadia.fatima.ach', None, 'samreennazeer', 'zeaghamkapco13', 'onlineclass96', 'arish.adil', 'shahzaib75', 'rizwana', 'kaynatalvi', 'aminah87', 'reebaraza', 'sajid72hussain', 'abs133', 'nbutt']"
45,253,19,35,16,"['jasonvazdel', 'jpnaranjo20', 'jcbuitragoa1', 'nlozano611', 'alvaro22martelo', 'dr.sabogal', 'danrako', 'jhon', 'jcac0908', 'dhcomas', 'salomon.ulloque', 'isabellasalgadopin', 'anfedepe', 'ja.hernandezr1', 'andresvm', 'vilmistirado']",2,"['al.indavid10', 'ad.gregory']",19,"['joshuakelev7', 'jf.cuevas', 'danielamedina9937', 'adrianapquijanoc', 'mchaparrobecerra', 'stephania_suarez', 'sv.rojas', 'kevin_ceron', 'miltonesteban.reyes', 'ale_1201', 'juliana.jaimes.27', None, 'ivanfsalgado', 'josemajaramilloh', 'michaelj00', 'da.ramirez14', 'alejagarzon', 'perez.l.carlos.a', 'marianak.holguinp']",37,"['danrako', 'jhon', 'joshuakelev7', 'anfedepe', 'ad.gregory', 'jf.cuevas', 'al.indavid10', 'adrianapquijanoc', 'jasonvazdel', 'jpnaranjo20', 'mchaparrobecerra', 'ja.hernandezr1', 'andresvm', 'stephania_suarez', 'perez.l.carlos.a', 'sv.rojas', 'nlozano611', 'alvaro22martelo', 'jcac0908', 'marianak.holguinp', 'kevin_ceron', 'miltonesteban.reyes', 'isabellasalgadopin', 'ale_1201', 'juliana.jaimes.27', None, 'jcbuitragoa1', 'ivanfsalgado', 'josemajaramilloh', 'michaelj00', 'da.ramirez14', 'alejagarzon', 'dr.sabogal', 'dhcomas', 'salomon.ulloque', 'vilmistirado', 'danielamedina9937']"
45,72,19,34,16,"['jasonvazdel', 'jpnaranjo20', 'jcbuitragoa1', 'nlozano611', 'alvaro22martelo', 'dr.sabogal', 'danrako', 'jhon', 'jcac0908', 'dhcomas', 'salomon.ulloque', 'al.indavid10', 'isabellasalgadopin', 'anfedepe', 'andresvm', 'vilmistirado']",2,"['ja.hernandezr1', 'ad.gregory']",18,"['luisafuentes19', 'josemajaramilloh', 'michaelj00', 'gabrielrueda99', 'mafeflorian7', 'yafarsolano', 'sophivcool', None, 'juliana9927', 'danielpc76', 'juandavrp', 'ale_1201', 'sn.vargas', 'camilopereztovar', 'ja.burgos', 'libardo11chapal', 'jhonseebb', 'fenixarn7']",36,"['luisafuentes19', 'danrako', 'jhon', 'sn.vargas', 'anfedepe', 'ad.gregory', 'al.indavid10', 'jasonvazdel', 'jpnaranjo20', 'gabrielrueda99', 'mafeflorian7', 'yafarsolano', 'danielpc76', 'ja.hernandezr1', 'andresvm', 'libardo11chapal', 'jhonseebb', 'fenixarn7', 'nlozano611', 'alvaro22martelo', 'jcac0908', 'juandavrp', 'isabellasalgadopin', 'ale_1201', 'sophivcool', None, 'jcbuitragoa1', 'josemajaramilloh', 'michaelj00', 'dr.sabogal', 'dhcomas', 'salomon.ulloque', 'camilopereztovar', 'ja.burgos', 'vilmistirado', 'juliana9927']"
45,80,19,18,7,"['jpnaranjo20', 'nlozano611', 'danrako', 'dhcomas', 'jcac0908', 'ja.hernandezr1', 'andresvm']",11,"['jasonvazdel', 'jcbuitragoa1', 'alvaro22martelo', 'dr.sabogal', 'jhon', 'salomon.ulloque', 'al.indavid10', 'isabellasalgadopin', 'anfedepe', 'ad.gregory', 'vilmistirado']",11,"['michaelj00', 'josemajaramilloh', 'alejandra31g', 'juanfecazuluaga', 'yafarsolano', 'juandavrp', 'ale_1201', 'ja.burgos', None, 'juliana9927', 'dard980311']",29,"['alejandra31g', 'nlozano611', 'alvaro22martelo', 'juanfecazuluaga', 'danrako', 'jhon', 'jcac0908', 'juandavrp', 'isabellasalgadopin', 'ale_1201', 'anfedepe', 'ad.gregory', 'al.indavid10', None, 'jasonvazdel', 'jpnaranjo20', 'jcbuitragoa1', 'michaelj00', 'josemajaramilloh', 'dr.sabogal', 'dhcomas', 'yafarsolano', 'salomon.ulloque', 'ja.hernandezr1', 'andresvm', 'ja.burgos', 'vilmistirado', 'juliana9927', 'dard980311']"
46,82,19,52,5,"['asadhussain765', 'sheebaishtiaque.102', 'ahmerinam99', 'mazeemkhanreal', 'ibeeey.a']",13,"['shweta2497', 'sraboni0015', 'kabirsaidul116', 'poojamstry', 'chimuelando2005', 'qinaixin11', 'starlitnight', 'mistryyohan550', 'rahuljai8267', 'mahdieh.shojaei.baghini', 'wenhairen123', 'gupta', 'a00517122']",47,"['hariskshah', 'hnihallani75', 'remshaa5', 'syedzainrock8', 'daanyaal', 'saqibkamal', 'farhanthespy', 'farahkareem5', 'areeba_khan', 'kashasan15', 'syedazainabhassan16', 'saba_nadeem91', 'moizraza10', 'ilsa.khalid', 'hassananwer1010', 'mamonarao01', 'shehzad_ahmed10', 'bhaifaiz77', 'm.naufil1', 'aqsaqasim10', 'owaisbashir26', 'taqdeesm3', 'khurramahmed1997', 'afnanmazhar', 'imtiazhira', 'mustafaarif12330', 'minhalrizvi98', 'shehzu94', 's.m.bahazad', 'habhutto2015', 'halamasood27', 'shayanali', 'shalalkhan18', None, 'khadimashoor437', 'aminahfatimah98', 'farahperveen72', 'saleem_008', 'hakeemorangzeb710', 'm.dawson', 'hamzaanwer', 'hamzaq44', 'el16009', 'aliirtaza98', 'faizanalibugti', 'iqra.javed1591997', 'fareha.saleem']",65,"['hariskshah', 'remshaa5', 'hnihallani75', 'poojamstry', 'areeba_khan', 'moizraza10', 'mahdieh.shojaei.baghini', 'shehzad_ahmed10', 'a00517122', 'asadhussain765', 'sheebaishtiaque.102', 'aqsaqasim10', 'starlitnight', 'taqdeesm3', 'rahuljai8267', 'afnanmazhar', 'mustafaarif12330', 'minhalrizvi98', 's.m.bahazad', 'habhutto2015', 'shalalkhan18', 'wenhairen123', 'gupta', 'm.dawson', 'el16009', 'aliirtaza98', 'faizanalibugti', 'fareha.saleem', 'syedzainrock8', 'daanyaal', 'saqibkamal', 'farhanthespy', 'farahkareem5', 'mazeemkhanreal', 'kashasan15', 'syedazainabhassan16', 'saba_nadeem91', 'hassananwer1010', 'ilsa.khalid', 'mamonarao01', 'bhaifaiz77', 'm.naufil1', 'sraboni0015', 'ahmerinam99', 'kabirsaidul116', 'qinaixin11', 'owaisbashir26', 'khurramahmed1997', 'imtiazhira', 'shweta2497', 'shehzu94', 'shayanali', 'chimuelando2005', 'halamasood27', 'mistryyohan550', None, 'khadimashoor437', 'aminahfatimah98', 'farahperveen72', 'saleem_008', 'hakeemorangzeb710', 'hamzaanwer', 'hamzaq44', 'ibeeey.a', 'iqra.javed1591997']"
47,2,18,19,16,"['gw014425', 'zachshue98', 'ericshanahan', 'dana.bandi', 'noyesjf', 'critcha', 'andrew.albert', 'jamesmkirk28', 'samuel.j.super', 'carlsam1', 'mark.s.mckee', 'jamese3', 'boucheag', 'basilefg', 'liptacj', 'rehraa5']",1,['bballben417'],3,"[None, 'valentjg', 'eastinje']",20,"['zachshue98', 'dana.bandi', 'ericshanahan', 'andrew.albert', 'jamesmkirk28', 'carlsam1', 'mark.s.mckee', 'jamese3', 'basilefg', 'gw014425', None, 'eastinje', 'noyesjf', 'valentjg', 'critcha', 'samuel.j.super', 'boucheag', 'bballben417', 'liptacj', 'rehraa5']"
47,3,18,19,15,"['zachshue98', 'ericshanahan', 'noyesjf', 'liptacj', 'critcha', 'andrew.albert', 'jamesmkirk28', 'samuel.j.super', 'carlsam1', 'mark.s.mckee', 'jamese3', 'boucheag', 'basilefg', 'bballben417', 'rehraa5']",2,"['gw014425', 'dana.bandi']",4,"['dougla1', None, 'macdonmk', 'eastinje']",21,"['zachshue98', 'dana.bandi', 'ericshanahan', 'andrew.albert', 'jamesmkirk28', 'carlsam1', 'mark.s.mckee', 'jamese3', 'macdonmk', 'basilefg', 'gw014425', None, 'eastinje', 'dougla1', 'noyesjf', 'critcha', 'samuel.j.super', 'boucheag', 'bballben417', 'liptacj', 'rehraa5']"
48,156,18,12,8,"['relmac', 'youssef_el_kantri', 'sourakkata', 'mohammed_drioueche', 'skyzelda', 'elrhomariy', 'driss.aabour', 'zouhirs']",9,"['rizkiyounes8991', 'ayoubmardi', 'mohammedch', 'youssraderraz1998', 'houria', 'younesghafiri2001', 'rachidardouz', 'ismail_laissaoui', 'medoubella']",4,"['ocama89', None, 'hamidallahoussama622', 'anas_mansouri']",21,"['rizkiyounes8991', 'relmac', 'sourakkata', 'mohammed_drioueche', 'mohammedch', 'youssraderraz1998', 'houria', 'younesghafiri2001', 'elrhomariy', 'driss.aabour', 'ismail_laissaoui', 'zouhirs', None, 'medoubella', 'hamidallahoussama622', 'ocama89', 'youssef_el_kantri', 'ayoubmardi', 'anas_mansouri', 'skyzelda', 'rachidardouz']"
48,155,18,10,6,"['youssef_el_kantri', 'mohammed_drioueche', 'mohammedch', 'elrhomariy', 'driss.aabour', 'zouhirs']",11,"['rizkiyounes8991', 'relmac', 'sourakkata', 'ayoubmardi', 'youssraderraz1998', 'houria', 'skyzelda', 'younesghafiri2001', 'rachidardouz', 'ismail_laissaoui', 'medoubella']",4,"['hicham.belkebir', None, 'hamidallahoussama622', 'zouhir_alami']",21,"['rizkiyounes8991', 'relmac', 'zouhir_alami', 'sourakkata', 'mohammed_drioueche', 'mohammedch', 'youssraderraz1998', 'houria', 'younesghafiri2001', 'elrhomariy', 'driss.aabour', 'ismail_laissaoui', 'zouhirs', None, 'medoubella', 'hamidallahoussama622', 'youssef_el_kantri', 'ayoubmardi', 'hicham.belkebir', 'skyzelda', 'rachidardouz']"
49,296,18,13,12,"['yeshwanthbugata', 'btl', 'ajitesh', 'agnessanjana', 'varshil01', 'vasuramadurgam', 'ushah', 'jlinxciv', 'raveenavijaya9', 'vinaykumarreddy1221', 'thanat.t', 'ruchibagwe']",5,"['tkm9255', 'bhagyashreejoshi', 'nasimghadyani', 'lokesh_mt2k17', 't.bhagyashri']",1,[None],18,"['yeshwanthbugata', 'agnessanjana', 'varshil01', 'vasuramadurgam', 'jlinxciv', 'vinaykumarreddy1221', 'thanat.t', None, 't.bhagyashri', 'tkm9255', 'bhagyashreejoshi', 'btl', 'ajitesh', 'nasimghadyani', 'ushah', 'raveenavijaya9', 'lokesh_mt2k17', 'ruchibagwe']"
50,90,17,17,11,"['kaustubh5354', 'rakh9000', 'sachinbavdane7', 'narayananiyer20', 'diptikarani', 'abhay.kshirsagar', 'itsme', 'vipra', 'pravin_bagade123', '2015sagar.baviskar', 'pvk']",5,"['hemant29', '2015anvita.rai', 'amruta.molawade', 'csangar', '2015rutuja.patil']",6,"['prajaktapatil', 'sayli8898', '2015nitish.nayak', 'lairai9', None, '2015sudipta.dinda']",22,"['rakh9000', 'prajaktapatil', 'sachinbavdane7', '2015anvita.rai', 'sayli8898', 'diptikarani', 'abhay.kshirsagar', 'itsme', 'vipra', 'pravin_bagade123', '2015sagar.baviskar', None, '2015sudipta.dinda', 'kaustubh5354', 'hemant29', 'narayananiyer20', '2015nitish.nayak', 'lairai9', 'amruta.molawade', 'csangar', 'pvk', '2015rutuja.patil']"
50,92,17,17,4,"['vipra', 'pravin_bagade123', '2015sagar.baviskar', 'pvk']",12,"['kaustubh5354', 'hemant29', 'rakh9000', 'sachinbavdane7', 'narayananiyer20', '2015anvita.rai', 'diptikarani', 'abhay.kshirsagar', 'itsme', 'csangar', 'amruta.molawade', '2015rutuja.patil']",13,"['2015bhushan.jadhav', '2015prachi.kothawade', 'adityagudal29', 'susmita1909', None, '2015dnyanal.berde', 'sayli8898', '2015samarpita.choudhuri', 'lairai9', '2015rushikesh.baraskar', 'virendra', '2015nishant.hirlekar', 'tejashree.khirawade']",29,"['rakh9000', 'sachinbavdane7', 'susmita1909', '2015dnyanal.berde', '2015anvita.rai', 'sayli8898', 'diptikarani', 'abhay.kshirsagar', 'itsme', '2015rushikesh.baraskar', 'vipra', 'pravin_bagade123', '2015sagar.baviskar', '2015nishant.hirlekar', None, 'tejashree.khirawade', 'kaustubh5354', 'hemant29', '2015bhushan.jadhav', '2015prachi.kothawade', 'adityagudal29', 'narayananiyer20', '2015samarpita.choudhuri', 'lairai9', 'amruta.molawade', 'csangar', 'pvk', 'virendra', '2015rutuja.patil']"
50,91,17,16,5,"['hemant29', '2015anvita.rai', 'itsme', 'amruta.molawade', '2015rutuja.patil']",11,"['kaustubh5354', 'rakh9000', 'sachinbavdane7', 'narayananiyer20', 'diptikarani', 'abhay.kshirsagar', 'csangar', 'vipra', 'pravin_bagade123', '2015sagar.baviskar', 'pvk']",11,"['2015deepak', '2015anuj.pakhare', 'ej2013.ankit.panvalkar', 'kaushal37', 'tanviwagh', '2015nitish.nayak', 'aartimaurya5', 'sahilberde', 'ujwala.pol', '2015mukul.sharma', None]",27,"['rakh9000', 'sachinbavdane7', '2015anvita.rai', 'tanviwagh', 'kaushal37', 'diptikarani', 'abhay.kshirsagar', 'itsme', 'vipra', 'pravin_bagade123', '2015sagar.baviskar', '2015mukul.sharma', None, 'kaustubh5354', 'hemant29', '2015anuj.pakhare', '2015deepak', 'ej2013.ankit.panvalkar', 'narayananiyer20', '2015nitish.nayak', 'aartimaurya5', 'amruta.molawade', 'sahilberde', 'csangar', 'pvk', 'ujwala.pol', '2015rutuja.patil']"
51,377,17,7,6,"['rc564', 'cl2563', 'sg742', 'yd366', 'alh277', 'spk52']",10,"['zhuoyi92', 'dz289', 'aixuanas', 'prof3paul', 'atif47', 'ruiningcn', 'bsong25', 'whjj1942', 'vsroba', 'woal7949']",1,[None],17,"['zhuoyi92', 'cl2563', 'aixuanas', 'atif47', 'ruiningcn', 'sg742', 'bsong25', 'alh277', 'vsroba', None, 'woal7949', 'rc564', 'dz289', 'prof3paul', 'yd366', 'spk52', 'whjj1942']"
52,233,17,13,11,"['derlet', 'matmat', 'valentinlafondrive', 'bharathn', 'moisesvazquez', 'yigitkuscu', 'ymeier', 'agiordan', 'recep.kubilay', 'dadaniel', 'addkol']",5,"['cprakash', 'hit_zsj', 'atourk2', 'adriengimonnet', 'elegoas']",2,"['rasoolahmad.a', None]",18,"['cprakash', 'derlet', 'yigitkuscu', 'ymeier', 'bharathn', None, 'hit_zsj', 'atourk2', 'valentinlafondrive', 'matmat', 'moisesvazquez', 'adriengimonnet', 'agiordan', 'recep.kubilay', 'elegoas', 'rasoolahmad.a', 'dadaniel', 'addkol']"
53,350,17,26,3,"['scottbirks', 'cataanderson1103', 'michaeleppel']",13,"['samuelpedersen', 'stevejohns', 'addielupercio', 'chemokine6', 'andrewarmstrong858', 'jordanvandegrift', 'anupra.chandran', 'yeetus_deletus', 'sjriley', 'mar4557', 'tragon', 'timphero', 'embersikorski']",23,"['kendranoneman', 'arvincunningham', 'bradygarringer', 'monetalberts', 'chrisjones', 'tylerwebb508', 'gregorynoble', 'jesseschimpf', 'nathantokarz', 'kevinsaythavy', 'raiflyon', 'johnpage', 'samuelmcmurdie', 'arielweltner', 'forestswanson', 'jasonpowell1', 'hunterg54', None, 'jameslamb', 'oliviamaryon', 'jiheonkwon', 'claireadams', 'henrikunold']",39,"['kendranoneman', 'samuelpedersen', 'stevejohns', 'addielupercio', 'arvincunningham', 'anupra.chandran', 'scottbirks', 'bradygarringer', 'monetalberts', 'chrisjones', 'tylerwebb508', 'gregorynoble', 'cataanderson1103', 'chemokine6', 'jesseschimpf', 'tragon', 'nathantokarz', 'claireadams', 'kevinsaythavy', 'embersikorski', 'raiflyon', 'johnpage', 'samuelmcmurdie', 'arielweltner', 'forestswanson', 'jasonpowell1', 'jordanvandegrift', 'yeetus_deletus', 'sjriley', 'hunterg54', None, 'jameslamb', 'andrewarmstrong858', 'oliviamaryon', 'jiheonkwon', 'michaeleppel', 'mar4557', 'henrikunold', 'timphero']"
53,349,17,25,3,"['scottbirks', 'cataanderson1103', 'michaeleppel']",13,"['samuelpedersen', 'stevejohns', 'addielupercio', 'chemokine6', 'andrewarmstrong858', 'jordanvandegrift', 'anupra.chandran', 'yeetus_deletus', 'sjriley', 'mar4557', 'tragon', 'timphero', 'embersikorski']",22,"['lanlibsu', 'monetalberts', 'chrisjones', 'tylerwebb508', 'gregorynoble', 'alimustafa', 'jesseschimpf', 'nathantokarz', 'kevinsaythavy', 'raiflyon', 'arielweltner', 'forestswanson', 'jasonpowell1', 'hunterg54', None, 'jameslamb', 'jadamsmiller', 'oliviamaryon', 'jiheonkwon', 'claireadams', 'henrikunold', 'gregorynoble27000']",38,"['gregorynoble27000', 'samuelpedersen', 'stevejohns', 'addielupercio', 'lanlibsu', 'anupra.chandran', 'scottbirks', 'monetalberts', 'chrisjones', 'tylerwebb508', 'gregorynoble', 'cataanderson1103', 'alimustafa', 'chemokine6', 'jesseschimpf', 'tragon', 'nathantokarz', 'claireadams', 'kevinsaythavy', 'embersikorski', 'raiflyon', 'arielweltner', 'forestswanson', 'jasonpowell1', 'jordanvandegrift', 'yeetus_deletus', 'sjriley', 'hunterg54', None, 'jameslamb', 'jadamsmiller', 'andrewarmstrong858', 'oliviamaryon', 'jiheonkwon', 'michaeleppel', 'mar4557', 'henrikunold', 'timphero']"
53,351,17,22,2,"['scottbirks', 'michaeleppel']",14,"['cataanderson1103', 'samuelpedersen', 'stevejohns', 'addielupercio', 'chemokine6', 'andrewarmstrong858', 'jordanvandegrift', 'anupra.chandran', 'yeetus_deletus', 'sjriley', 'mar4557', 'tragon', 'timphero', 'embersikorski']",20,"['steve.r6531', 'lynnkarriem1', 'arvincunningham', 'dallash', 'lanlibsu', 'bradygarringer', 'tylerjpoulsen', 'michaelhansen95', 'paigeskinner', 'johnpage', 'samuelmcmurdie', 'egraugnard', None, 'natefarris', 'austinmello', 'beckperrine', 'kyleelay', 'almastosius', 'tanyalu', 'kievdixon']",36,"['steve.r6531', 'samuelpedersen', 'stevejohns', 'addielupercio', 'lynnkarriem1', 'arvincunningham', 'lanlibsu', 'anupra.chandran', 'scottbirks', 'dallash', 'bradygarringer', 'tylerjpoulsen', 'cataanderson1103', 'chemokine6', 'michaelhansen95', 'tragon', 'embersikorski', 'paigeskinner', 'johnpage', 'samuelmcmurdie', 'jordanvandegrift', 'yeetus_deletus', 'egraugnard', 'sjriley', None, 'natefarris', 'austinmello', 'beckperrine', 'kyleelay', 'andrewarmstrong858', 'almastosius', 'michaeleppel', 'tanyalu', 'mar4557', 'kievdixon', 'timphero']"
53,348,17,16,10,"['samuelpedersen', 'stevejohns', 'addielupercio', 'andrewarmstrong858', 'jordanvandegrift', 'sjriley', 'mar4557', 'tragon', 'timphero', 'embersikorski']",6,"['cataanderson1103', 'chemokine6', 'yeetus_deletus', 'scottbirks', 'anupra.chandran', 'michaeleppel']",6,"['gregorynoble', 'steve.r6531', 'arielweltner', 'lanlibsu', None, 'gregorynoble27000']",22,"['timphero', 'gregorynoble27000', 'steve.r6531', 'samuelpedersen', 'stevejohns', 'addielupercio', 'arielweltner', 'jordanvandegrift', 'lanlibsu', 'anupra.chandran', 'scottbirks', 'yeetus_deletus', 'sjriley', None, 'gregorynoble', 'cataanderson1103', 'chemokine6', 'andrewarmstrong858', 'mar4557', 'tragon', 'michaeleppel', 'embersikorski']"
54,350,17,26,2,"['samuelmcmurdie', 'bradygarringer']",14,"['paigeskinner', 'austinmello', 'kyleelay', 'beckperrine', 'steve.r6531', 'lynnkarriem1', 'jonathanshoemaker', 'michaelhansen95', 'dallash', 'almastosius', 'tanyalu', 'tylerjpoulsen', 'kievdixon', 'natefarris']",24,"['kendranoneman', 'arvincunningham', 'scottbirks', 'monetalberts', 'chrisjones', 'tylerwebb508', 'gregorynoble', 'cataanderson1103', 'jesseschimpf', 'nathantokarz', 'kevinsaythavy', 'raiflyon', 'johnpage', 'arielweltner', 'forestswanson', 'jasonpowell1', 'hunterg54', None, 'jameslamb', 'oliviamaryon', 'jiheonkwon', 'claireadams', 'henrikunold', 'michaeleppel']",40,"['kendranoneman', 'steve.r6531', 'lynnkarriem1', 'jonathanshoemaker', 'dallash', 'arvincunningham', 'scottbirks', 'bradygarringer', 'tylerjpoulsen', 'monetalberts', 'chrisjones', 'tylerwebb508', 'gregorynoble', 'cataanderson1103', 'michaelhansen95', 'jesseschimpf', 'nathantokarz', 'kevinsaythavy', 'raiflyon', 'paigeskinner', 'johnpage', 'samuelmcmurdie', 'arielweltner', 'forestswanson', 'jasonpowell1', 'hunterg54', None, 'natefarris', 'jameslamb', 'austinmello', 'kyleelay', 'beckperrine', 'oliviamaryon', 'almastosius', 'jiheonkwon', 'tanyalu', 'claireadams', 'henrikunold', 'kievdixon', 'michaeleppel']"
54,351,17,22,15,"['paigeskinner', 'austinmello', 'kyleelay', 'samuelmcmurdie', 'steve.r6531', 'lynnkarriem1', 'beckperrine', 'michaelhansen95', 'dallash', 'almastosius', 'tanyalu', 'bradygarringer', 'tylerjpoulsen', 'kievdixon', 'natefarris']",1,['jonathanshoemaker'],7,"['johnpage', 'arvincunningham', 'lanlibsu', 'scottbirks', 'egraugnard', None, 'michaeleppel']",23,"['steve.r6531', 'lynnkarriem1', 'jonathanshoemaker', 'dallash', 'arvincunningham', 'lanlibsu', 'scottbirks', 'bradygarringer', 'tylerjpoulsen', 'michaelhansen95', 'paigeskinner', 'johnpage', 'samuelmcmurdie', 'egraugnard', None, 'natefarris', 'austinmello', 'kyleelay', 'beckperrine', 'almastosius', 'tanyalu', 'kievdixon', 'michaeleppel']"
54,348,17,16,1,['steve.r6531'],15,"['paigeskinner', 'austinmello', 'kyleelay', 'samuelmcmurdie', 'beckperrine', 'lynnkarriem1', 'jonathanshoemaker', 'michaelhansen95', 'dallash', 'almastosius', 'tanyalu', 'bradygarringer', 'tylerjpoulsen', 'kievdixon', 'natefarris']",15,"['timphero', 'gregorynoble', 'arielweltner', 'samuelpedersen', 'addielupercio', 'stevejohns', 'andrewarmstrong858', 'lanlibsu', 'jordanvandegrift', 'sjriley', 'mar4557', 'tragon', None, 'gregorynoble27000', 'embersikorski']",31,"['paigeskinner', 'timphero', 'samuelmcmurdie', 'steve.r6531', 'lynnkarriem1', 'jonathanshoemaker', 'arielweltner', 'samuelpedersen', 'addielupercio', 'stevejohns', 'dallash', 'lanlibsu', 'jordanvandegrift', 'sjriley', 'bradygarringer', 'tylerjpoulsen', None, 'natefarris', 'austinmello', 'kyleelay', 'beckperrine', 'gregorynoble', 'andrewarmstrong858', 'michaelhansen95', 'almastosius', 'tanyalu', 'mar4557', 'tragon', 'kievdixon', 'gregorynoble27000', 'embersikorski']"
54,356,17,13,11,"['paigeskinner', 'beckperrine', 'kyleelay', 'lynnkarriem1', 'michaelhansen95', 'dallash', 'almastosius', 'tanyalu', 'bradygarringer', 'tylerjpoulsen', 'natefarris']",5,"['austinmello', 'samuelmcmurdie', 'steve.r6531', 'jonathanshoemaker', 'kievdixon']",2,"['johnpage', None]",18,"['paigeskinner', 'johnpage', 'samuelmcmurdie', 'steve.r6531', 'lynnkarriem1', 'jonathanshoemaker', 'dallash', 'bradygarringer', 'tylerjpoulsen', None, 'natefarris', 'austinmello', 'kyleelay', 'beckperrine', 'michaelhansen95', 'almastosius', 'tanyalu', 'kievdixon']"
55,166,16,15,13,"['turley.connor.j', 'williamzhang0821', 'cforsythe', 'bravicor', 'tryeazel', 'neilwang', 'abigail.mrvos', 'sunbowen', 'jepatte2', 'azaleazheng', 'xixi.qin', 'xieyiabner', 'fanzhang0815']",2,"['raullaasner', 'throwthisaway1975']",2,"[None, 'yongshinkim0216']",17,"['turley.connor.j', 'williamzhang0821', 'bravicor', 'tryeazel', 'neilwang', 'raullaasner', 'sunbowen', 'jepatte2', 'azaleazheng', 'xixi.qin', 'xieyiabner', 'yongshinkim0216', None, 'fanzhang0815', 'cforsythe', 'abigail.mrvos', 'throwthisaway1975']"
56,84,16,29,3,"['samiyajabbar', 'rubarasheed5678', 's_huzaifa']",12,"['pbehera2', 'galanlopez.oal', 'aneshkumar13', 'ky', 'jaejin90', 'ksie', 'mr.x1375', 'yhsia', 'jsunp2', 'maxaplas', 'douw54', 'rmax04']",26,"['bismaraoluqman', 'hariskshah', 'owaisbukhari257', 'farahkareem5', 'areeba_khan', 'moizraza10', 'shehzad_ahmed10', 'ilsa.khalid', 'ateefasiddiqui', 'm.naufil1', 'sufzpq', 'kausarsaleem65', 'hareem.ahsan98', 'halamasood27', 'daanyaalnerd97', 'ashna', 'shalalkhan18', 'ibrahimahmedmughal', 'moonasayal', None, 'aminahfatimah98', 'hamzaanwer', 'hareemmustafa', 'bushradayo', 'iqra.javed1591997', 'fareha.saleem']",41,"['galanlopez.oal', 'bismaraoluqman', 'hariskshah', 'owaisbukhari257', 'farahkareem5', 's_huzaifa', 'areeba_khan', 'moizraza10', 'jsunp2', 'yhsia', 'ilsa.khalid', 'ateefasiddiqui', 'shehzad_ahmed10', 'pbehera2', 'm.naufil1', 'sufzpq', 'kausarsaleem65', 'mr.x1375', 'hareem.ahsan98', 'samiyajabbar', 'halamasood27', 'ksie', 'daanyaalnerd97', 'ashna', 'shalalkhan18', 'ibrahimahmedmughal', 'moonasayal', 'douw54', None, 'rubarasheed5678', 'rmax04', 'aminahfatimah98', 'ky', 'aneshkumar13', 'jaejin90', 'hamzaanwer', 'hareemmustafa', 'bushradayo', 'maxaplas', 'iqra.javed1591997', 'fareha.saleem']"
56,85,16,8,1,['ksie'],14,"['pbehera2', 'galanlopez.oal', 'aneshkumar13', 'ky', 'jaejin90', 'samiyajabbar', 's_huzaifa', 'mr.x1375', 'yhsia', 'jsunp2', 'maxaplas', 'douw54', 'rubarasheed5678', 'rmax04']",7,"['ppawelski', 'jamesdoty', 'mmei', 'carleydavis', 'bplamondon', None, 'stabatabaei']",22,"['galanlopez.oal', 'ppawelski', 'samiyajabbar', 'ksie', 's_huzaifa', 'jsunp2', 'bplamondon', 'yhsia', 'douw54', None, 'stabatabaei', 'rubarasheed5678', 'rmax04', 'pbehera2', 'ky', 'aneshkumar13', 'jaejin90', 'jamesdoty', 'mmei', 'mr.x1375', 'carleydavis', 'maxaplas']"
57,253,15,35,14,"['ivanfsalgado', 'sv.rojas', 'da.ramirez14', 'alejagarzon', 'mchaparrobecerra', 'joshuakelev7', 'kevin_ceron', 'miltonesteban.reyes', 'juliana.jaimes.27', 'stephania_suarez', 'jf.cuevas', 'danielamedina9937', 'perez.l.carlos.a', 'marianak.holguinp']",0,[],21,"['danrako', 'jhon', 'anfedepe', 'adrianapquijanoc', 'jasonvazdel', 'jpnaranjo20', 'ja.hernandezr1', 'andresvm', 'nlozano611', 'alvaro22martelo', 'jcac0908', 'ale_1201', 'isabellasalgadopin', None, 'jcbuitragoa1', 'josemajaramilloh', 'michaelj00', 'dr.sabogal', 'dhcomas', 'salomon.ulloque', 'vilmistirado']",35,"['danrako', 'jhon', 'joshuakelev7', 'anfedepe', 'jf.cuevas', 'danielamedina9937', 'adrianapquijanoc', 'jasonvazdel', 'jpnaranjo20', 'mchaparrobecerra', 'ja.hernandezr1', 'andresvm', 'stephania_suarez', 'sv.rojas', 'nlozano611', 'alvaro22martelo', 'jcac0908', 'kevin_ceron', 'miltonesteban.reyes', 'vilmistirado', 'ale_1201', 'isabellasalgadopin', 'juliana.jaimes.27', None, 'ivanfsalgado', 'josemajaramilloh', 'jcbuitragoa1', 'michaelj00', 'da.ramirez14', 'alejagarzon', 'dr.sabogal', 'dhcomas', 'salomon.ulloque', 'perez.l.carlos.a', 'marianak.holguinp']"
58,201,15,21,13,"['juzairi08', 'jaysaw3', 'thuvaskrishnan', 'shenvern1105', 'aqilazman', 'syahmikml', 'syawalnaim2102', 'hakimiikmal4', 'wahideen_wbk', 'liya', 'shahrul_iqmal', 'tuanaiman', 'derekliew7']",1,['peng123'],8,"['yuva96', 'turiyadeva', 'hairidesigner', 'thayyibathadmi', 'azzalea96agus', 'ccteh0196', None, 'adrtee']",22,"['shenvern1105', 'peng123', 'ccteh0196', 'shahrul_iqmal', 'adrtee', 'derekliew7', 'juzairi08', 'yuva96', 'jaysaw3', 'thuvaskrishnan', 'aqilazman', 'syahmikml', 'syawalnaim2102', 'wahideen_wbk', 'tuanaiman', 'turiyadeva', 'liya', None, 'thayyibathadmi', 'azzalea96agus', 'hakimiikmal4', 'hairidesigner']"
58,183,15,17,9,"['juzairi08', 'thuvaskrishnan', 'aqilazman', 'syawalnaim2102', 'syahmikml', 'hakimiikmal4', 'wahideen_wbk', 'shahrul_iqmal', 'tuanaiman']",5,"['jaysaw3', 'shenvern1105', 'peng123', 'liya', 'derekliew7']",8,"['yuva96', 'thayyibathadmi', None, 'lavanyanadarajan', 'ccteh0196', 'sarmila.krishnan', 'hairidesigner', 'adrtee']",22,"['hairidesigner', 'shenvern1105', 'peng123', 'lavanyanadarajan', 'ccteh0196', 'liya', 'sarmila.krishnan', 'shahrul_iqmal', None, 'adrtee', 'derekliew7', 'juzairi08', 'jaysaw3', 'thuvaskrishnan', 'thayyibathadmi', 'aqilazman', 'syahmikml', 'syawalnaim2102', 'hakimiikmal4', 'wahideen_wbk', 'yuva96', 'tuanaiman']"
58,179,15,15,11,"['juzairi08', 'jaysaw3', 'thuvaskrishnan', 'aqilazman', 'syahmikml', 'syawalnaim2102', 'hakimiikmal4', 'wahideen_wbk', 'liya', 'tuanaiman', 'derekliew7']",3,"['peng123', 'shenvern1105', 'shahrul_iqmal']",4,"['hairidesigner', 'thayyibathadmi', None, 'yuva96']",18,"['hairidesigner', 'shenvern1105', 'peng123', 'liya', 'shahrul_iqmal', None, 'derekliew7', 'juzairi08', 'jaysaw3', 'thuvaskrishnan', 'thayyibathadmi', 'aqilazman', 'syahmikml', 'syawalnaim2102', 'hakimiikmal4', 'wahideen_wbk', 'yuva96', 'tuanaiman']"
58,203,15,11,6,"['juzairi08', 'thuvaskrishnan', 'syahmikml', 'hakimiikmal4', 'wahideen_wbk', 'shahrul_iqmal']",8,"['jaysaw3', 'shenvern1105', 'aqilazman', 'syawalnaim2102', 'peng123', 'liya', 'tuanaiman', 'derekliew7']",5,"['thayyibathadmi', 'ccteh0196', 'sarmila.krishnan', None, 'adrtee']",19,"['shenvern1105', 'peng123', 'ccteh0196', 'liya', 'sarmila.krishnan', 'shahrul_iqmal', None, 'adrtee', 'derekliew7', 'juzairi08', 'jaysaw3', 'thuvaskrishnan', 'thayyibathadmi', 'aqilazman', 'syahmikml', 'syawalnaim2102', 'hakimiikmal4', 'wahideen_wbk', 'tuanaiman']"
59,206,15,119,7,"['sumner3', 'engineeringkenyahub', 'amagro', 'prasad25', 'mzentner', 'smoinudd', 'julianjros']",7,"['oaljowai', 'pmarepal', 'jmeiners09', 'tauhid93', 'cjlee328', 'sandeepnagar', 'carpediem']",112,"['akreuter', 'rwasem', 'osborn45', 'bkiep', 'ryan.wiebe', 'nt230', 'wstolz', 'robo698', 'itsmemario', 'conner.swift8', 'john1886', 'afalkenb', 'tgiazzon', 'guenthee2020', 'cmelchin', 'ryanwest1040', 'george7elias', 'justj', 'rjleach', 'boninim', 'evdaly', 'cclapham', 'fischermben', 'jbartlin', 'landon.glunt', 'mcrees', 'ebergqu', 'tanderto', 'jdanek', 'buck17', 'scoan', 'kgmcginley', 'nathanmoore', 'angbecker', 'cputt', 'ebehring', 'mcclurez', 'ryry1644', 'canadaman87', 'dschull', 'mishra59', 'snowh5696', 'cartmaster007', 'baker428', 'jmaillet', 'anthonm', 'alineelquist', 'finn5', 'htorsina', 'jstalbaum', 'nhdorcy', 'shadow66666', 'talon34567', 'huan1146', 'rishiprasadha', 'cmeiste', 'radhakr3', 'jfolkers', 'agalema1027', 'joshuajkporter', 'suran9712', 'akonopa', 'oliver67', 'hess35', 'asartor', 'wang4150', 'crhodine', 'nriaziat', 'kjh94425', 'mingusnate', 'dodge4', 'maxwellfra16', 'garret28', 'zjohnson834', 'jmacklem', 'mcclure8', 'cameronfritts12', 'hkaakeh', 'kkamiya', 'jswetlik', 'kruege14', 'albrect', 'heinzt', 'herr13', 'srasche', 'akreilei', 'nggoodie98', 'rsusler', 'kknowlto', 'nbitner', 'river132', None, 'jskeens', 'yizhizhang', 'dsfgdsfg', 'benoit1', 'khageman', 'inormile', 'jklaben', 'sknecht', 'goh5', 'lesteryhz', 'kevinodonnell0878', 'lmeehann', 'kico', 'mccaul', 'rodri454', 'evandaele3', 'rao53', 'rice125', 'athoman', 'aratkov']",126,"['sandeepnagar', 'bkiep', 'ryan.wiebe', 'nt230', 'wstolz', 'itsmemario', 'conner.swift8', 'afalkenb', 'tgiazzon', 'evdaly', 'mcrees', 'tanderto', 'jdanek', 'buck17', 'scoan', 'kgmcginley', 'cputt', 'mcclurez', 'pmarepal', 'jmaillet', 'anthonm', 'alineelquist', 'oaljowai', 'jstalbaum', 'rishiprasadha', 'cmeiste', 'akonopa', 'hess35', 'wang4150', 'crhodine', 'nriaziat', 'kjh94425', 'mingusnate', 'dodge4', 'mcclure8', 'hkaakeh', 'kkamiya', 'herr13', 'srasche', 'nggoodie98', 'rsusler', 'nbitner', 'river132', 'dsfgdsfg', 'benoit1', 'khageman', 'inormile', 'sknecht', 'goh5', 'lesteryhz', 'jmeiners09', 'tauhid93', 'aratkov', 'akreuter', 'prasad25', 'rwasem', 'cjlee328', 'osborn45', 'robo698', 'amagro', 'john1886', 'guenthee2020', 'cmelchin', 'ryanwest1040', 'george7elias', 'justj', 'rjleach', 'boninim', 'cclapham', 'fischermben', 'jbartlin', 'landon.glunt', 'ebergqu', 'nathanmoore', 'angbecker', 'julianjros', 'engineeringkenyahub', 'ebehring', 'ryry1644', 'canadaman87', 'dschull', 'mishra59', 'snowh5696', 'cartmaster007', 'baker428', 'finn5', 'htorsina', 'nhdorcy', 'shadow66666', 'talon34567', 'huan1146', 'radhakr3', 'jfolkers', 'agalema1027', 'joshuajkporter', 'suran9712', 'oliver67', 'asartor', 'smoinudd', 'maxwellfra16', 'garret28', 'zjohnson834', 'jmacklem', 'cameronfritts12', 'jswetlik', 'kruege14', 'albrect', 'heinzt', 'akreilei', 'mzentner', 'kknowlto', None, 'jskeens', 'yizhizhang', 'sumner3', 'jklaben', 'kevinodonnell0878', 'lmeehann', 'kico', 'mccaul', 'rodri454', 'evandaele3', 'rao53', 'rice125', 'athoman', 'carpediem']"
60,237,15,7,4,"['mschooljian', 'kylewang811', 'mbrasil14', 'celinespathias']",10,"['kilian.liss', 'vkurichenko', 'librandt', 'tnportone', 'bmaranville', 'shreya.sonal20', 'matasoyu9', 'dmurphy60', 'olafvanterve', 'komogortsev_sergey']",3,"['maitegoiriena', None, 'hanumansingh']",17,"['vkurichenko', 'mschooljian', 'librandt', 'tnportone', 'shreya.sonal20', 'matasoyu9', 'dmurphy60', 'bmaranville', None, 'komogortsev_sergey', 'kilian.liss', 'hanumansingh', 'maitegoiriena', 'kylewang811', 'celinespathias', 'olafvanterve', 'mbrasil14']"
62,98,15,39,9,"['prajaktapatil', '2015prachi.kothawade', '2015anuj.pakhare', 'kaushal37', 'aartimaurya5', 'lairai9', 'tanviwagh', '2015nitish.nayak', '2015soumya.chinthalapudi']",5,"['2015bhushan.jadhav', '2015dnyanal.berde', 'sayli8898', '2015sudipta.dinda', 'tejashree.khirawade']",30,"['shrutisneha.prasad', 'tanuj.udani', '2015vipra.arolkar', 'sachimalkan', 'aa9858203050', 'aniketozarkar', 'aakashmeshram', 'dhairyagada1997', '2015deepak', '2015omkar.tulaskar', 'ej2013.ankit.panvalkar', 'himanisheth98', 'ujwala.pol', '2015manas.kulkarni', 'rohit24k', 'ajitjadhav', 'sankalp8055', '2015varun.gokhale', 'zobe97', '2015pratik.warke', 'varunswadia', '2015mukul.sharma', None, '2015radhika.angolkar', '2015sanika.pathare', '2015rasika.wagh', '2015riya.maheshwari', '2015soham.sawant', 'shreyas.sshende', 'jayesh.bhosale']",44,"['shrutisneha.prasad', 'tanuj.udani', 'prajaktapatil', '2015vipra.arolkar', 'sachimalkan', 'aa9858203050', 'aniketozarkar', 'aakashmeshram', '2015sudipta.dinda', 'tejashree.khirawade', 'dhairyagada1997', '2015prachi.kothawade', '2015anuj.pakhare', '2015deepak', '2015omkar.tulaskar', 'ej2013.ankit.panvalkar', 'himanisheth98', 'aartimaurya5', 'lairai9', 'ujwala.pol', '2015manas.kulkarni', 'rohit24k', 'ajitjadhav', 'sankalp8055', '2015varun.gokhale', '2015dnyanal.berde', 'sayli8898', 'kaushal37', 'tanviwagh', 'zobe97', '2015pratik.warke', 'varunswadia', '2015soumya.chinthalapudi', '2015mukul.sharma', None, '2015radhika.angolkar', '2015bhushan.jadhav', '2015sanika.pathare', '2015rasika.wagh', '2015nitish.nayak', '2015riya.maheshwari', '2015soham.sawant', 'shreyas.sshende', 'jayesh.bhosale']"
62,100,15,19,3,"['2015nitish.nayak', 'prajaktapatil', '2015prachi.kothawade']",11,"['2015bhushan.jadhav', '2015anuj.pakhare', '2015dnyanal.berde', 'sayli8898', 'kaushal37', 'aartimaurya5', 'lairai9', 'tanviwagh', '2015soumya.chinthalapudi', '2015sudipta.dinda', 'tejashree.khirawade']",16,"['jainamshah697', 'yash.bhatia', '2015deepak', '2015vipra.arolkar', '2015manas.kulkarni', 'sankalp8055', None, 'pravinbagade123', '2015sanika.pathare', 'ej2013.ankit.panvalkar', '2015rasika.wagh', '2015jayanti.jha', '2015riya.maheshwari', 'neeiljain', 'abhi97', '2015radhika.angolkar']",30,"['jainamshah697', 'prajaktapatil', '2015vipra.arolkar', '2015sudipta.dinda', 'tejashree.khirawade', 'yash.bhatia', '2015prachi.kothawade', '2015anuj.pakhare', '2015deepak', 'pravinbagade123', 'ej2013.ankit.panvalkar', 'aartimaurya5', 'lairai9', 'neeiljain', 'sankalp8055', '2015dnyanal.berde', 'sayli8898', 'kaushal37', 'tanviwagh', '2015soumya.chinthalapudi', 'abhi97', None, '2015radhika.angolkar', '2015bhushan.jadhav', '2015sanika.pathare', '2015rasika.wagh', '2015nitish.nayak', '2015riya.maheshwari', '2015manas.kulkarni', '2015jayanti.jha']"
62,96,15,18,9,"['2015bhushan.jadhav', 'prajaktapatil', '2015prachi.kothawade', '2015dnyanal.berde', 'sayli8898', 'kaushal37', 'aartimaurya5', 'lairai9', 'tejashree.khirawade']",5,"['2015anuj.pakhare', 'tanviwagh', '2015nitish.nayak', '2015soumya.chinthalapudi', '2015sudipta.dinda']",9,"['shrutisneha.prasad', '2015vipra.arolkar', '2015mugdha.sonwane', '2015varun.gokhale', '2015rasika.wagh', '2015riya.maheshwari', '2015soham.sawant', None, 'hemant.wakchaure']",23,"['shrutisneha.prasad', 'prajaktapatil', '2015vipra.arolkar', '2015sudipta.dinda', 'tejashree.khirawade', '2015prachi.kothawade', '2015anuj.pakhare', 'aartimaurya5', 'lairai9', '2015varun.gokhale', '2015dnyanal.berde', '2015mugdha.sonwane', 'sayli8898', 'kaushal37', 'tanviwagh', '2015soumya.chinthalapudi', None, 'hemant.wakchaure', '2015bhushan.jadhav', '2015rasika.wagh', '2015nitish.nayak', '2015riya.maheshwari', '2015soham.sawant']"
62,90,15,17,5,"['prajaktapatil', 'sayli8898', '2015nitish.nayak', 'lairai9', '2015sudipta.dinda']",9,"['2015bhushan.jadhav', '2015prachi.kothawade', '2015anuj.pakhare', '2015dnyanal.berde', 'kaushal37', 'aartimaurya5', 'tanviwagh', '2015soumya.chinthalapudi', 'tejashree.khirawade']",12,"['kaustubh5354', 'rakh9000', 'vipra', 'sachinbavdane7', 'narayananiyer20', 'diptikarani', 'itsme', 'abhay.kshirsagar', 'pvk', 'pravin_bagade123', '2015sagar.baviskar', None]",26,"['rakh9000', 'prajaktapatil', 'sachinbavdane7', '2015dnyanal.berde', 'sayli8898', 'kaushal37', 'tanviwagh', 'diptikarani', 'itsme', 'abhay.kshirsagar', 'vipra', '2015soumya.chinthalapudi', 'pravin_bagade123', '2015sagar.baviskar', None, '2015sudipta.dinda', 'tejashree.khirawade', 'kaustubh5354', '2015bhushan.jadhav', '2015prachi.kothawade', '2015anuj.pakhare', 'narayananiyer20', '2015nitish.nayak', 'aartimaurya5', 'lairai9', 'pvk']"
62,92,15,17,6,"['2015bhushan.jadhav', '2015prachi.kothawade', '2015dnyanal.berde', 'sayli8898', 'lairai9', 'tejashree.khirawade']",8,"['prajaktapatil', '2015anuj.pakhare', 'kaushal37', 'aartimaurya5', 'tanviwagh', '2015nitish.nayak', '2015soumya.chinthalapudi', '2015sudipta.dinda']",11,"['2015sagar.baviskar', 'adityagudal29', 'susmita1909', None, '2015samarpita.choudhuri', '2015rushikesh.baraskar', 'vipra', 'pravin_bagade123', 'virendra', '2015nishant.hirlekar', 'pvk']",25,"['prajaktapatil', 'susmita1909', '2015dnyanal.berde', 'sayli8898', 'kaushal37', 'tanviwagh', '2015rushikesh.baraskar', 'vipra', '2015soumya.chinthalapudi', 'pravin_bagade123', '2015sagar.baviskar', '2015nishant.hirlekar', '2015sudipta.dinda', 'tejashree.khirawade', None, '2015bhushan.jadhav', '2015prachi.kothawade', '2015anuj.pakhare', 'adityagudal29', '2015nitish.nayak', 'aartimaurya5', 'lairai9', '2015samarpita.choudhuri', 'pvk', 'virendra']"
62,91,15,16,5,"['2015anuj.pakhare', 'kaushal37', 'aartimaurya5', 'tanviwagh', '2015nitish.nayak']",9,"['2015bhushan.jadhav', 'prajaktapatil', '2015prachi.kothawade', '2015dnyanal.berde', 'sayli8898', 'lairai9', '2015soumya.chinthalapudi', '2015sudipta.dinda', 'tejashree.khirawade']",11,"['hemant29', '2015deepak', 'ej2013.ankit.panvalkar', '2015anvita.rai', 'itsme', 'amruta.molawade', 'sahilberde', 'ujwala.pol', '2015mukul.sharma', None, '2015rutuja.patil']",25,"['prajaktapatil', '2015dnyanal.berde', 'sayli8898', 'kaushal37', 'tanviwagh', '2015anvita.rai', 'itsme', '2015soumya.chinthalapudi', '2015mukul.sharma', None, '2015sudipta.dinda', 'tejashree.khirawade', 'hemant29', '2015bhushan.jadhav', '2015prachi.kothawade', '2015anuj.pakhare', '2015deepak', 'ej2013.ankit.panvalkar', '2015nitish.nayak', 'aartimaurya5', 'lairai9', 'amruta.molawade', 'sahilberde', 'ujwala.pol', '2015rutuja.patil']"
62,99,15,13,1,['prajaktapatil'],13,"['2015bhushan.jadhav', '2015prachi.kothawade', '2015anuj.pakhare', '2015dnyanal.berde', 'sayli8898', 'kaushal37', 'aartimaurya5', 'lairai9', 'tanviwagh', '2015nitish.nayak', '2015soumya.chinthalapudi', '2015sudipta.dinda', 'tejashree.khirawade']",12,"['jainamshah697', 'yash.bhatia', '2015deepak', '2015vipra.arolkar', None, '2015supriya.khatri', '2015shaunak.athalye', '2015babu.adik', '2015vipul.jain', 'ujwala.pol', '2015manas.kulkarni', 'abhi97']",26,"['jainamshah697', 'prajaktapatil', '2015vipra.arolkar', '2015dnyanal.berde', 'sayli8898', 'kaushal37', 'tanviwagh', '2015soumya.chinthalapudi', 'abhi97', '2015sudipta.dinda', 'tejashree.khirawade', None, '2015bhushan.jadhav', 'yash.bhatia', '2015prachi.kothawade', '2015anuj.pakhare', '2015deepak', '2015supriya.khatri', '2015shaunak.athalye', '2015nitish.nayak', 'aartimaurya5', 'lairai9', '2015babu.adik', '2015vipul.jain', 'ujwala.pol', '2015manas.kulkarni']"
62,97,15,8,3,"['aartimaurya5', 'prajaktapatil', '2015anuj.pakhare']",11,"['2015bhushan.jadhav', '2015prachi.kothawade', '2015dnyanal.berde', 'sayli8898', 'kaushal37', 'tanviwagh', 'lairai9', '2015nitish.nayak', '2015soumya.chinthalapudi', '2015sudipta.dinda', 'tejashree.khirawade']",5,"['2015varun.gokhale', '2015rasika.wagh', '2015soham.sawant', None, 'shubham.sutrakar']",19,"['prajaktapatil', '2015varun.gokhale', '2015dnyanal.berde', 'sayli8898', 'kaushal37', 'tanviwagh', '2015soumya.chinthalapudi', None, '2015sudipta.dinda', 'tejashree.khirawade', '2015bhushan.jadhav', '2015prachi.kothawade', '2015anuj.pakhare', '2015rasika.wagh', '2015nitish.nayak', 'aartimaurya5', 'lairai9', '2015soham.sawant', 'shubham.sutrakar']"
62,95,15,7,2,"['2015soumya.chinthalapudi', 'lairai9']",12,"['2015bhushan.jadhav', 'prajaktapatil', '2015prachi.kothawade', '2015anuj.pakhare', '2015dnyanal.berde', 'sayli8898', 'kaushal37', 'aartimaurya5', 'tanviwagh', '2015nitish.nayak', '2015sudipta.dinda', 'tejashree.khirawade']",5,"['2015vipra.arolkar', None, 'arthaya.koyande28', '2015riya.maheshwari', 'abhi97']",19,"['prajaktapatil', '2015vipra.arolkar', '2015dnyanal.berde', 'sayli8898', 'kaushal37', 'tanviwagh', 'arthaya.koyande28', '2015soumya.chinthalapudi', None, '2015sudipta.dinda', 'tejashree.khirawade', 'abhi97', '2015bhushan.jadhav', '2015prachi.kothawade', '2015anuj.pakhare', '2015nitish.nayak', 'aartimaurya5', 'lairai9', '2015riya.maheshwari']"
63,262,15,37,6,"['emre_krtn97', 'berkanaydn16', 'kganozcan', 'muratlevent', 'cihanbuyuknacar', 'onurcanozavci']",8,"['ulasgorcelioglu', 'sudekoza', 'yilmazberat1997', 'kaya.emrah.26', 'elifisparta38', 'furkanefeyuceer', 'melisozkarr', 'fatiherdgn25']",31,"['cemkarts', 'esracolak.25', 'brknshn', 'mevradilanerten', 'ugur.cankaya.3718', 'muvafikmelikkaya', 'meltemsbreezes', '46harunakgul', 'melike_musal', 'afkali.120', 'furkanznkr', 'davuteee', 'frknznkr', 'oakbulut1997', 'irfancan571', 'evrenyigit', 'melikemusal1', None, 'nihatyavuz', 'haticesari333333', 'emre_citak_bil', 'abcd5454', 'adnanyuceer', 'damlakubattt', 'ilkaydost', 'omerfkazar22', 'ozbunar01', 'abdurrahmn15', 'yunusbaskan', 'metehanmustafayalcin', 'furkanturk1352']",45,"['cemkarts', 'esracolak.25', 'brknshn', 'mevradilanerten', 'melisozkarr', 'kganozcan', 'ugur.cankaya.3718', 'fatiherdgn25', 'muvafikmelikkaya', 'emre_krtn97', 'meltemsbreezes', '46harunakgul', 'melike_musal', 'elifisparta38', 'afkali.120', 'davuteee', 'furkanznkr', 'frknznkr', 'oakbulut1997', 'yilmazberat1997', 'irfancan571', 'berkanaydn16', 'evrenyigit', 'melikemusal1', 'muratlevent', None, 'nihatyavuz', 'haticesari333333', 'emre_citak_bil', 'abcd5454', 'adnanyuceer', 'ulasgorcelioglu', 'sudekoza', 'damlakubattt', 'ilkaydost', 'omerfkazar22', 'kaya.emrah.26', 'ozbunar01', 'abdurrahmn15', 'furkanefeyuceer', 'yunusbaskan', 'metehanmustafayalcin', 'furkanturk1352', 'cihanbuyuknacar', 'onurcanozavci']"
63,24,15,28,2,"['furkanefeyuceer', 'kganozcan']",12,"['ulasgorcelioglu', 'sudekoza', 'yilmazberat1997', 'emre_krtn97', 'berkanaydn16', 'kaya.emrah.26', 'elifisparta38', 'melisozkarr', 'muratlevent', 'cihanbuyuknacar', 'fatiherdgn25', 'onurcanozavci']",26,"['trkmengkay', 'tuberkargan_97', 'emrebuyukkose2', 'e.erkul6060', 'mevradilanerten', 'ugur.cankaya.3718', 'caglanlee', 'muvafikmelikkaya', 'furcoskuner', 'tuberkargan', 'yaseminablacandir', '46harunakgul', 'davuteee', 'frknznkr', 'oakbulut1997', 'samet1231234', 'fdirisaglik', None, 'nihatyavuz', 'adnanyuceer', 'damlakubattt', 'ozbunar01', 'abdurrahmn15', 'metehanmustafayalcin', 'nagihankececi', 'mgk816']",40,"['trkmengkay', 'tuberkargan_97', 'emrebuyukkose2', 'e.erkul6060', 'mevradilanerten', 'melisozkarr', 'kganozcan', 'ugur.cankaya.3718', 'caglanlee', 'fatiherdgn25', 'muvafikmelikkaya', 'furcoskuner', 'tuberkargan', 'yaseminablacandir', 'emre_krtn97', '46harunakgul', 'elifisparta38', 'davuteee', 'frknznkr', 'oakbulut1997', 'yilmazberat1997', 'berkanaydn16', 'samet1231234', 'fdirisaglik', 'muratlevent', None, 'nihatyavuz', 'adnanyuceer', 'ulasgorcelioglu', 'sudekoza', 'damlakubattt', 'kaya.emrah.26', 'ozbunar01', 'abdurrahmn15', 'furkanefeyuceer', 'metehanmustafayalcin', 'nagihankececi', 'mgk816', 'cihanbuyuknacar', 'onurcanozavci']"
63,263,15,21,4,"['fatiherdgn25', 'sudekoza', 'melisozkarr', 'elifisparta38']",10,"['ulasgorcelioglu', 'yilmazberat1997', 'emre_krtn97', 'berkanaydn16', 'kaya.emrah.26', 'furkanefeyuceer', 'kganozcan', 'muratlevent', 'cihanbuyuknacar', 'onurcanozavci']",17,"['trkmengkay', 'ronal_denho_931', 'ozgurkablan26', 'oakbulut1997', 'senanurcetin96', 'tuberkargan_97', 'nihansulukoy', 'emrebuyukkose2', 'metalist_kaan', 'brknshn', 'polat.gokberk', 'okanircann', 'joker632455', 'ozgurdenizkozan', 'furkanturk1352', None, 'sinasigurpinar']",31,"['trkmengkay', 'ozgurkablan26', 'tuberkargan_97', 'emrebuyukkose2', 'brknshn', 'melisozkarr', 'kganozcan', 'fatiherdgn25', 'sinasigurpinar', 'ronal_denho_931', 'nihansulukoy', 'emre_krtn97', 'metalist_kaan', 'elifisparta38', 'ozgurdenizkozan', 'oakbulut1997', 'senanurcetin96', 'yilmazberat1997', 'berkanaydn16', 'polat.gokberk', 'muratlevent', None, 'ulasgorcelioglu', 'sudekoza', 'okanircann', 'joker632455', 'kaya.emrah.26', 'furkanefeyuceer', 'furkanturk1352', 'cihanbuyuknacar', 'onurcanozavci']"
63,185,15,19,8,"['ulasgorcelioglu', 'yilmazberat1997', 'emre_krtn97', 'berkanaydn16', 'furkanefeyuceer', 'muratlevent', 'cihanbuyuknacar', 'onurcanozavci']",6,"['sudekoza', 'kaya.emrah.26', 'elifisparta38', 'melisozkarr', 'kganozcan', 'fatiherdgn25']",11,"['vedat969', 'furcoskuner', 'frknznkr', 'esracolak.25', 'oakbulut1997', 'akoglutayyip', 'mevradilanerten', 'melikemusal1', 'rafshezani', None, 'abcd5454']",25,"['esracolak.25', 'mevradilanerten', 'melisozkarr', 'kganozcan', 'fatiherdgn25', 'furcoskuner', 'emre_krtn97', 'elifisparta38', 'rafshezani', 'vedat969', 'frknznkr', 'oakbulut1997', 'yilmazberat1997', 'akoglutayyip', 'berkanaydn16', 'melikemusal1', 'muratlevent', None, 'abcd5454', 'ulasgorcelioglu', 'sudekoza', 'kaya.emrah.26', 'furkanefeyuceer', 'cihanbuyuknacar', 'onurcanozavci']"
63,205,15,16,6,"['yilmazberat1997', 'emre_krtn97', 'berkanaydn16', 'furkanefeyuceer', 'cihanbuyuknacar', 'onurcanozavci']",8,"['ulasgorcelioglu', 'sudekoza', 'kaya.emrah.26', 'elifisparta38', 'melisozkarr', 'kganozcan', 'muratlevent', 'fatiherdgn25']",10,"['furcoskuner', 'frknznkr', 'oakbulut1997', 'esracolak.25', 'e.erkul6060', 'fdirisaglik', 'mevradilanerten', 'melikemusal1', None, 'davuteee']",24,"['frknznkr', 'oakbulut1997', 'esracolak.25', 'yilmazberat1997', 'e.erkul6060', 'berkanaydn16', 'fdirisaglik', 'mevradilanerten', 'melikemusal1', 'melisozkarr', 'kganozcan', 'muratlevent', None, 'fatiherdgn25', 'furcoskuner', 'ulasgorcelioglu', 'sudekoza', 'emre_krtn97', 'kaya.emrah.26', 'elifisparta38', 'furkanefeyuceer', 'cihanbuyuknacar', 'davuteee', 'onurcanozavci']"
63,186,15,9,3,"['ulasgorcelioglu', 'fatiherdgn25', 'melisozkarr']",11,"['sudekoza', 'yilmazberat1997', 'emre_krtn97', 'berkanaydn16', 'kaya.emrah.26', 'elifisparta38', 'furkanefeyuceer', 'kganozcan', 'muratlevent', 'cihanbuyuknacar', 'onurcanozavci']",6,"['akoglutayyip', 'okanircann', 'meltemsbreezes', None, 'ozgurdenizkz', 'tttakoglu16000']",20,"['yilmazberat1997', 'akoglutayyip', 'berkanaydn16', 'melisozkarr', 'kganozcan', 'muratlevent', None, 'fatiherdgn25', 'ozgurdenizkz', 'tttakoglu16000', 'ulasgorcelioglu', 'sudekoza', 'emre_krtn97', 'meltemsbreezes', 'okanircann', 'kaya.emrah.26', 'elifisparta38', 'furkanefeyuceer', 'cihanbuyuknacar', 'onurcanozavci']"
63,265,15,8,3,"['yilmazberat1997', 'ulasgorcelioglu', 'elifisparta38']",11,"['sudekoza', 'emre_krtn97', 'berkanaydn16', 'kaya.emrah.26', 'furkanefeyuceer', 'kganozcan', 'melisozkarr', 'muratlevent', 'cihanbuyuknacar', 'fatiherdgn25', 'onurcanozavci']",5,"['mmert.bacak', 'nihansulukoy', 'zubeydekal37', 'nagihankececi', None]",19,"['mmert.bacak', 'yilmazberat1997', 'berkanaydn16', 'zubeydekal37', 'melisozkarr', 'kganozcan', 'muratlevent', None, 'fatiherdgn25', 'ulasgorcelioglu', 'sudekoza', 'nihansulukoy', 'emre_krtn97', 'kaya.emrah.26', 'elifisparta38', 'furkanefeyuceer', 'nagihankececi', 'cihanbuyuknacar', 'onurcanozavci']"
64,4,14,7,3,"['stefano.righi1994', 'enrico876', 'lorenzo.benatti']",10,"['dimuthuo', 'yyogi', 'abdulrahmangalal', 'davidegallo20', 'lisha11chris', 'ettoremasetti', 'riccardotassi', 'rcmyers78', 'tommasodegaetano', 'aymansaadhack']",4,"['gi.ga212', 'alessiobevilacqua', None, 'rubenasa']",17,"['dimuthuo', 'yyogi', 'abdulrahmangalal', 'davidegallo20', 'alessiobevilacqua', 'ettoremasetti', 'rubenasa', 'riccardotassi', 'aymansaadhack', None, 'gi.ga212', 'lisha11chris', 'lorenzo.benatti', 'rcmyers78', 'tommasodegaetano', 'stefano.righi1994', 'enrico876']"
65,364,14,16,9,"['feraya09', 'kelly.corella', 'luisca1968', 'dch_1018', 'arisansol01', 'dgsandoval', 'arisandi97', 'josesanchezmoreno2797', 'andrea.zu97']",4,"['dwc200', 'msalerno', 'huihuangxia', 'cganser']",7,"['sussitr8', 'clauchv', 'laurojasch', 'yosjimz', 'alpizar.kevin1', None, 'jose.acuvida']",20,"['sussitr8', 'luisca1968', 'arisansol01', 'dwc200', 'huihuangxia', 'laurojasch', 'yosjimz', 'alpizar.kevin1', 'andrea.zu97', None, 'jose.acuvida', 'feraya09', 'kelly.corella', 'clauchv', 'dch_1018', 'dgsandoval', 'cganser', 'arisandi97', 'msalerno', 'josesanchezmoreno2797']"
65,363,14,8,3,"['arisandi97', 'feraya09', 'andrea.zu97']",10,"['kelly.corella', 'luisca1968', 'dch_1018', 'arisansol01', 'dwc200', 'dgsandoval', 'huihuangxia', 'cganser', 'msalerno', 'josesanchezmoreno2797']",5,"['luisca1925', 'marissacerdas', 'jbhernadez1004', None, 'evyquiros.7']",18,"['luisca1968', 'arisansol01', 'dwc200', 'huihuangxia', 'marissacerdas', 'andrea.zu97', None, 'evyquiros.7', 'feraya09', 'kelly.corella', 'luisca1925', 'dch_1018', 'dgsandoval', 'cganser', 'arisandi97', 'jbhernadez1004', 'msalerno', 'josesanchezmoreno2797']"
66,98,14,39,9,"['rohit24k', 'tanuj.udani', 'aakashmeshram', 'dhairyagada1997', 'varunswadia', 'aniketozarkar', '2015soham.sawant', 'shreyas.sshende', 'jayesh.bhosale']",4,"['pakshal.m.shah', 'hemant.wakchaure', '2015harsha.kumar', 'singhshashank97']",30,"['shrutisneha.prasad', 'prajaktapatil', '2015vipra.arolkar', 'sachimalkan', 'aa9858203050', '2015anuj.pakhare', '2015prachi.kothawade', '2015deepak', '2015omkar.tulaskar', 'ej2013.ankit.panvalkar', 'himanisheth98', 'aartimaurya5', 'lairai9', 'ujwala.pol', 'sankalp8055', '2015varun.gokhale', 'tanviwagh', 'kaushal37', 'zobe97', '2015pratik.warke', '2015soumya.chinthalapudi', '2015mukul.sharma', None, '2015radhika.angolkar', '2015sanika.pathare', '2015rasika.wagh', '2015nitish.nayak', '2015riya.maheshwari', '2015manas.kulkarni', 'ajitjadhav']",43,"['shrutisneha.prasad', 'tanuj.udani', 'prajaktapatil', '2015vipra.arolkar', 'sachimalkan', 'aa9858203050', 'aniketozarkar', 'aakashmeshram', 'dhairyagada1997', '2015anuj.pakhare', '2015prachi.kothawade', '2015deepak', '2015omkar.tulaskar', 'ej2013.ankit.panvalkar', 'himanisheth98', 'aartimaurya5', 'lairai9', 'ujwala.pol', '2015manas.kulkarni', 'rohit24k', 'ajitjadhav', 'sankalp8055', '2015varun.gokhale', 'tanviwagh', 'kaushal37', 'zobe97', '2015pratik.warke', 'varunswadia', '2015soumya.chinthalapudi', '2015mukul.sharma', None, 'hemant.wakchaure', '2015radhika.angolkar', '2015sanika.pathare', '2015rasika.wagh', 'singhshashank97', '2015nitish.nayak', '2015harsha.kumar', 'pakshal.m.shah', '2015riya.maheshwari', '2015soham.sawant', 'shreyas.sshende', 'jayesh.bhosale']"
66,96,14,18,2,"['2015soham.sawant', 'hemant.wakchaure']",11,"['rohit24k', 'tanuj.udani', 'dhairyagada1997', 'singhshashank97', '2015harsha.kumar', 'varunswadia', 'pakshal.m.shah', 'aniketozarkar', 'aakashmeshram', 'shreyas.sshende', 'jayesh.bhosale']",16,"['shrutisneha.prasad', 'prajaktapatil', '2015bhushan.jadhav', '2015prachi.kothawade', '2015vipra.arolkar', '2015varun.gokhale', '2015dnyanal.berde', '2015mugdha.sonwane', '2015rasika.wagh', 'sayli8898', 'kaushal37', 'aartimaurya5', 'lairai9', '2015riya.maheshwari', None, 'tejashree.khirawade']",29,"['shrutisneha.prasad', 'tanuj.udani', 'prajaktapatil', '2015vipra.arolkar', '2015varun.gokhale', '2015dnyanal.berde', '2015mugdha.sonwane', 'sayli8898', 'kaushal37', 'varunswadia', 'aniketozarkar', 'aakashmeshram', None, 'dhairyagada1997', 'hemant.wakchaure', 'tejashree.khirawade', 'rohit24k', '2015bhushan.jadhav', '2015prachi.kothawade', '2015rasika.wagh', 'singhshashank97', 'aartimaurya5', 'lairai9', '2015harsha.kumar', 'pakshal.m.shah', '2015riya.maheshwari', '2015soham.sawant', 'shreyas.sshende', 'jayesh.bhosale']"
66,97,14,8,1,['2015soham.sawant'],12,"['rohit24k', 'tanuj.udani', 'dhairyagada1997', 'singhshashank97', '2015harsha.kumar', 'varunswadia', 'pakshal.m.shah', 'aniketozarkar', 'aakashmeshram', 'shreyas.sshende', 'jayesh.bhosale', 'hemant.wakchaure']",7,"['prajaktapatil', '2015anuj.pakhare', '2015varun.gokhale', '2015rasika.wagh', 'aartimaurya5', 'shubham.sutrakar', None]",20,"['tanuj.udani', 'prajaktapatil', '2015varun.gokhale', 'varunswadia', 'aniketozarkar', 'aakashmeshram', None, 'dhairyagada1997', 'hemant.wakchaure', 'shubham.sutrakar', 'rohit24k', '2015anuj.pakhare', '2015rasika.wagh', 'singhshashank97', 'aartimaurya5', '2015harsha.kumar', 'pakshal.m.shah', '2015soham.sawant', 'shreyas.sshende', 'jayesh.bhosale']"
67,82,14,52,13,"['hnihallani75', 'syedzainrock8', 'm.dawson', 'daanyaal', 'saqibkamal', 'habhutto2015', 'hamzaq44', 'hamzaanwer', 'khurramahmed1997', 'aliirtaza98', 'hassananwer1010', 'mamonarao01', 'shehzad_ahmed10']",0,[],39,"['hariskshah', 'remshaa5', 'farhanthespy', 'farahkareem5', 'mazeemkhanreal', 'areeba_khan', 'kashasan15', 'syedazainabhassan16', 'saba_nadeem91', 'moizraza10', 'ilsa.khalid', 'bhaifaiz77', 'asadhussain765', 'm.naufil1', 'sheebaishtiaque.102', 'aqsaqasim10', 'ahmerinam99', 'owaisbashir26', 'taqdeesm3', 'afnanmazhar', 'imtiazhira', 'mustafaarif12330', 'minhalrizvi98', 'shehzu94', 's.m.bahazad', 'shayanali', 'halamasood27', 'shalalkhan18', None, 'khadimashoor437', 'aminahfatimah98', 'farahperveen72', 'saleem_008', 'hakeemorangzeb710', 'el16009', 'ibeeey.a', 'faizanalibugti', 'iqra.javed1591997', 'fareha.saleem']",52,"['hariskshah', 'hnihallani75', 'remshaa5', 'areeba_khan', 'moizraza10', 'shehzad_ahmed10', 'asadhussain765', 'sheebaishtiaque.102', 'aqsaqasim10', 'taqdeesm3', 'afnanmazhar', 'mustafaarif12330', 'minhalrizvi98', 's.m.bahazad', 'habhutto2015', 'shalalkhan18', 'm.dawson', 'el16009', 'aliirtaza98', 'faizanalibugti', 'fareha.saleem', 'syedzainrock8', 'daanyaal', 'saqibkamal', 'farhanthespy', 'farahkareem5', 'mazeemkhanreal', 'kashasan15', 'syedazainabhassan16', 'saba_nadeem91', 'hassananwer1010', 'ilsa.khalid', 'mamonarao01', 'bhaifaiz77', 'm.naufil1', 'ahmerinam99', 'khurramahmed1997', 'owaisbashir26', 'imtiazhira', 'shehzu94', 'shayanali', 'halamasood27', None, 'khadimashoor437', 'aminahfatimah98', 'farahperveen72', 'saleem_008', 'hakeemorangzeb710', 'hamzaanwer', 'hamzaq44', 'ibeeey.a', 'iqra.javed1591997']"
67,134,14,40,9,"['syedzainrock8', 'm.dawson', 'saqibkamal', 'hamzaanwer', 'hamzaq44', 'aliirtaza98', 'hassananwer1010', 'mamonarao01', 'shehzad_ahmed10']",4,"['khurramahmed1997', 'daanyaal', 'habhutto2015', 'hnihallani75']",31,"['bismaraoluqman', 'hariskshah', 'farhanthespy', 'sabaq165', 'zainabnazeer456', 'areeba_khan', 'syedazainabhassan16', 'bhaifaiz77', 'm.naufil1', 'aqsaqasim10', 'bahazad.syed', 'waleedkhalid924', 'hareem.ahsan98', 'imtiazhira', 'mustafaarif12330', 'minhalrizvi98', 'bushrashahab01', 'shayanali', 'halamasood27', 'daanyaalnerd97', 'ashna', 'shalalkhan18', 'moonasayal', None, 'khadimashoor437', 'aminahfatimah98', 'saleem_008', 'el16009', 'bushradayo', 'iqra.javed1591997', 'fareha.saleem']",44,"['bismaraoluqman', 'hnihallani75', 'hariskshah', 'syedzainrock8', 'daanyaal', 'saqibkamal', 'farhanthespy', 'sabaq165', 'zainabnazeer456', 'areeba_khan', 'syedazainabhassan16', 'hassananwer1010', 'shehzad_ahmed10', 'mamonarao01', 'bhaifaiz77', 'm.naufil1', 'aqsaqasim10', 'bahazad.syed', 'khurramahmed1997', 'waleedkhalid924', 'hareem.ahsan98', 'imtiazhira', 'mustafaarif12330', 'minhalrizvi98', 'bushrashahab01', 'habhutto2015', 'shayanali', 'halamasood27', 'daanyaalnerd97', 'ashna', 'shalalkhan18', 'moonasayal', None, 'khadimashoor437', 'aminahfatimah98', 'saleem_008', 'm.dawson', 'hamzaanwer', 'hamzaq44', 'el16009', 'aliirtaza98', 'bushradayo', 'iqra.javed1591997', 'fareha.saleem']"
67,298,14,31,10,"['hnihallani75', 'syedzainrock8', 'm.dawson', 'daanyaal', 'habhutto2015', 'hamzaanwer', 'khurramahmed1997', 'hassananwer1010', 'mamonarao01', 'shehzad_ahmed10']",3,"['saqibkamal', 'aliirtaza98', 'hamzaq44']",21,"['hariskshah', 'zainabnazeer456', 'hariskaleemshah', 'sufzpq', 'aqsaqasim10', 'bahazad.syed', 'hareem.ahsan98', 'imtiazhira', 'mustafaarif12330', 'shayanali', 'halamasood27', 'ashna', None, 'zaheramusvi65', 'farahperveen72', 'saleem_008', 'dua1915', 'hakeemorangzeb710', 'bushradayo', 'iqra.javed1591997', 'mariamamin123']",34,"['hariskshah', 'hnihallani75', 'syedzainrock8', 'daanyaal', 'saqibkamal', 'zainabnazeer456', 'hassananwer1010', 'shehzad_ahmed10', 'mamonarao01', 'hariskaleemshah', 'aqsaqasim10', 'sufzpq', 'bahazad.syed', 'khurramahmed1997', 'hareem.ahsan98', 'imtiazhira', 'mustafaarif12330', 'habhutto2015', 'halamasood27', 'shayanali', 'ashna', None, 'zaheramusvi65', 'farahperveen72', 'saleem_008', 'dua1915', 'hakeemorangzeb710', 'm.dawson', 'hamzaanwer', 'hamzaq44', 'aliirtaza98', 'bushradayo', 'iqra.javed1591997', 'mariamamin123']"
67,84,14,29,2,"['shehzad_ahmed10', 'hamzaanwer']",11,"['hnihallani75', 'syedzainrock8', 'm.dawson', 'daanyaal', 'saqibkamal', 'habhutto2015', 'hamzaq44', 'khurramahmed1997', 'aliirtaza98', 'hassananwer1010', 'mamonarao01']",27,"['bismaraoluqman', 'hariskshah', 'owaisbukhari257', 'farahkareem5', 's_huzaifa', 'areeba_khan', 'moizraza10', 'ilsa.khalid', 'ateefasiddiqui', 'm.naufil1', 'sufzpq', 'kausarsaleem65', 'hareem.ahsan98', 'samiyajabbar', 'halamasood27', 'daanyaalnerd97', 'ashna', 'shalalkhan18', 'ibrahimahmedmughal', 'moonasayal', None, 'rubarasheed5678', 'aminahfatimah98', 'hareemmustafa', 'bushradayo', 'iqra.javed1591997', 'fareha.saleem']",40,"['bismaraoluqman', 'hnihallani75', 'hariskshah', 'owaisbukhari257', 'syedzainrock8', 'daanyaal', 'saqibkamal', 'farahkareem5', 's_huzaifa', 'areeba_khan', 'moizraza10', 'hassananwer1010', 'shehzad_ahmed10', 'mamonarao01', 'ilsa.khalid', 'ateefasiddiqui', 'm.naufil1', 'sufzpq', 'kausarsaleem65', 'khurramahmed1997', 'hareem.ahsan98', 'samiyajabbar', 'habhutto2015', 'halamasood27', 'daanyaalnerd97', 'ashna', 'shalalkhan18', 'ibrahimahmedmughal', 'moonasayal', None, 'rubarasheed5678', 'aminahfatimah98', 'm.dawson', 'hamzaanwer', 'hamzaq44', 'aliirtaza98', 'hareemmustafa', 'bushradayo', 'iqra.javed1591997', 'fareha.saleem']"
67,107,14,28,13,"['hnihallani75', 'syedzainrock8', 'm.dawson', 'daanyaal', 'saqibkamal', 'habhutto2015', 'hamzaq44', 'hamzaanwer', 'khurramahmed1997', 'aliirtaza98', 'hassananwer1010', 'mamonarao01', 'shehzad_ahmed10']",0,[],15,"['m.naufil1', 'hariskshah', 'aqsaqasim10', 'hakeemorangzeb710', 's.m.bahazad', None, 'halamasood27', 'taqdeesm3', 'saqlainsiddiqui40', 'imtiazhira', 'mustafaarif12330', 'minhalrizvi98', 'bhaifaiz77', 'aminahfatimah98', 'osamahkhan212']",28,"['hariskshah', 'hnihallani75', 'syedzainrock8', 'daanyaal', 'saqibkamal', 'hassananwer1010', 'shehzad_ahmed10', 'mamonarao01', 'bhaifaiz77', 'm.naufil1', 'aqsaqasim10', 'khurramahmed1997', 'taqdeesm3', 'saqlainsiddiqui40', 'imtiazhira', 'mustafaarif12330', 'minhalrizvi98', 'osamahkhan212', 's.m.bahazad', 'habhutto2015', 'halamasood27', None, 'aminahfatimah98', 'hakeemorangzeb710', 'm.dawson', 'hamzaanwer', 'hamzaq44', 'aliirtaza98']"
67,299,14,27,10,"['hnihallani75', 'syedzainrock8', 'm.dawson', 'saqibkamal', 'habhutto2015', 'hamzaanwer', 'khurramahmed1997', 'hassananwer1010', 'mamonarao01', 'shehzad_ahmed10']",3,"['daanyaal', 'aliirtaza98', 'hamzaq44']",17,"['farahperveen72', 'm.naufil1', 'afnan.mazhar', 'hariskshah', 'hakeemorangzeb710', 'shaheeradnankhan', 'talatbng945', 'halamasood27', 'sabaq165', 'ashna', 'iqra.javed1591997', 'imtiazhira', 'hamza.aslam3904', 'mustafaarif12330', 'hariskaleemshah', None, 'khadimashoor437']",30,"['hariskshah', 'hnihallani75', 'syedzainrock8', 'daanyaal', 'saqibkamal', 'sabaq165', 'hassananwer1010', 'shehzad_ahmed10', 'mamonarao01', 'hariskaleemshah', 'm.naufil1', 'khurramahmed1997', 'imtiazhira', 'mustafaarif12330', 'talatbng945', 'afnan.mazhar', 'habhutto2015', 'halamasood27', 'ashna', 'hamza.aslam3904', None, 'khadimashoor437', 'farahperveen72', 'hakeemorangzeb710', 'shaheeradnankhan', 'm.dawson', 'hamzaanwer', 'hamzaq44', 'aliirtaza98', 'iqra.javed1591997']"
67,297,14,20,4,"['m.dawson', 'aliirtaza98', 'hnihallani75', 'shehzad_ahmed10']",9,"['syedzainrock8', 'daanyaal', 'saqibkamal', 'habhutto2015', 'hamzaq44', 'hamzaanwer', 'khurramahmed1997', 'hassananwer1010', 'mamonarao01']",16,"['aamnakhursheed171997', 'bismaraoluqman', 'hariskshah', 'aqsaqasim10', 'sshuzaifa50', 'shaheeradnankhan', 'bahazad.syed', 'zainabnazeer456', 'moizraza10', 'syedazainabhassan16', 'smartshaheer123', 'saqlainsiddiqui40', 'imtiazhira', 'mustafaarif12330', 'talatbng945', None]",29,"['aamnakhursheed171997', 'bismaraoluqman', 'hnihallani75', 'hariskshah', 'syedzainrock8', 'daanyaal', 'saqibkamal', 'zainabnazeer456', 'moizraza10', 'syedazainabhassan16', 'hassananwer1010', 'shehzad_ahmed10', 'mamonarao01', 'aqsaqasim10', 'bahazad.syed', 'khurramahmed1997', 'saqlainsiddiqui40', 'imtiazhira', 'mustafaarif12330', 'talatbng945', 'habhutto2015', None, 'sshuzaifa50', 'shaheeradnankhan', 'm.dawson', 'hamzaanwer', 'hamzaq44', 'aliirtaza98', 'smartshaheer123']"
67,129,14,17,4,"['m.dawson', 'aliirtaza98', 'hnihallani75', 'shehzad_ahmed10']",9,"['syedzainrock8', 'daanyaal', 'saqibkamal', 'habhutto2015', 'hamzaq44', 'hamzaanwer', 'khurramahmed1997', 'hassananwer1010', 'mamonarao01']",13,"['hariskshah', 'sshuzaifa50', 'shaheeradnankhan', 'aqsaqasim10', 'bahazad.syed', 'moizraza10', 'syedazainabhassan16', 'smartshaheer123', 'saqlainsiddiqui40', 'imtiazhira', 'mustafaarif12330', 'talatbng945', None]",26,"['hariskshah', 'hnihallani75', 'syedzainrock8', 'daanyaal', 'saqibkamal', 'habhutto2015', 'moizraza10', 'syedazainabhassan16', 'hassananwer1010', 'shehzad_ahmed10', 'mamonarao01', None, 'sshuzaifa50', 'aqsaqasim10', 'shaheeradnankhan', 'm.dawson', 'bahazad.syed', 'hamzaanwer', 'hamzaq44', 'khurramahmed1997', 'aliirtaza98', 'smartshaheer123', 'saqlainsiddiqui40', 'imtiazhira', 'mustafaarif12330', 'talatbng945']"
67,276,14,17,10,"['hnihallani75', 'm.dawson', 'saqibkamal', 'habhutto2015', 'hamzaq44', 'khurramahmed1997', 'aliirtaza98', 'hassananwer1010', 'mamonarao01', 'shehzad_ahmed10']",3,"['syedzainrock8', 'daanyaal', 'hamzaanwer']",7,"['hariskshah', 'hakeemorangzeb710', 'halamasood27', 'taqdeesm3', None, 'bhaifaiz77', 'aminahfatimah98']",20,"['hariskshah', 'hnihallani75', 'syedzainrock8', 'daanyaal', 'saqibkamal', 'habhutto2015', 'halamasood27', 'hassananwer1010', 'shehzad_ahmed10', 'mamonarao01', None, 'bhaifaiz77', 'aminahfatimah98', 'hakeemorangzeb710', 'm.dawson', 'hamzaanwer', 'hamzaq44', 'khurramahmed1997', 'taqdeesm3', 'aliirtaza98']"
67,128,14,14,4,"['syedzainrock8', 'hassananwer1010', 'mamonarao01', 'hamzaq44']",9,"['hnihallani75', 'm.dawson', 'daanyaal', 'saqibkamal', 'habhutto2015', 'hamzaanwer', 'khurramahmed1997', 'aliirtaza98', 'shehzad_ahmed10']",10,"['bismaraoluqman', 'hariskshah', 'ashna', 'syedazainabhassan16', 'hareem.ahsan98', 'imtiazhira', 'iqra.javed1591997', None, 'bhaifaiz77', 'bushradayo']",23,"['bismaraoluqman', 'hnihallani75', 'hariskshah', 'syedzainrock8', 'daanyaal', 'saqibkamal', 'habhutto2015', 'ashna', 'syedazainabhassan16', 'hassananwer1010', 'shehzad_ahmed10', 'mamonarao01', None, 'bhaifaiz77', 'm.dawson', 'hamzaanwer', 'hamzaq44', 'khurramahmed1997', 'aliirtaza98', 'hareem.ahsan98', 'imtiazhira', 'iqra.javed1591997', 'bushradayo']"
68,224,13,12,11,"['barat.abid', 'elliotthook', 'abarbour', 'matthewhyder01', 'emilyg3110', 'simranc', 'angelaes', 'kd3591115', 'a_4cash', 'adflanaganlfc', 'ireland.gentile']",1,['hrkillian97'],1,[None],13,"['barat.abid', 'elliotthook', 'abarbour', 'emilyg3110', 'hrkillian97', 'a_4cash', 'adflanaganlfc', None, 'matthewhyder01', 'angelaes', 'simranc', 'kd3591115', 'ireland.gentile']"
69,171,13,10,1,['vineetkotariya'],11,"['cxy18', 'ejg5281', 'cruiyff', 'matan.bh1', 'jkbkaczmarek', 'jianyi.gao.1', 'rqp5233', 'sj', 'sourabhjindaliitr', 'vkumar21', 'chaitanyapasupuleti']",9,"['ameyabane', 'rahulkulkarni301', 'rakshu.gade', 'shivraj14', 'ajinkyametange', 'siddhikadam', 'ghodkebharati467', None, 'hbg2112']",21,"['ameyabane', 'rahulkulkarni301', 'cxy18', 'cruiyff', 'matan.bh1', 'ajinkyametange', 'ghodkebharati467', 'chaitanyapasupuleti', None, 'hbg2112', 'ejg5281', 'rakshu.gade', 'shivraj14', 'jkbkaczmarek', 'jianyi.gao.1', 'rqp5233', 'sj', 'sourabhjindaliitr', 'vkumar21', 'siddhikadam', 'vineetkotariya']"
70,98,13,39,8,"['2015vipra.arolkar', 'sankalp8055', '2015sanika.pathare', '2015rasika.wagh', 'zobe97', '2015riya.maheshwari', '2015manas.kulkarni', '2015radhika.angolkar']",4,"['naval29', 'shivanianekar13', 'abhi97', 'yash.bhatia']",31,"['shrutisneha.prasad', 'tanuj.udani', 'prajaktapatil', 'sachimalkan', 'aa9858203050', 'aniketozarkar', 'aakashmeshram', 'dhairyagada1997', '2015anuj.pakhare', '2015prachi.kothawade', '2015deepak', '2015omkar.tulaskar', 'ej2013.ankit.panvalkar', 'himanisheth98', 'aartimaurya5', 'lairai9', 'ujwala.pol', 'rohit24k', 'ajitjadhav', '2015varun.gokhale', 'tanviwagh', 'kaushal37', '2015pratik.warke', 'varunswadia', '2015soumya.chinthalapudi', '2015mukul.sharma', None, '2015nitish.nayak', '2015soham.sawant', 'shreyas.sshende', 'jayesh.bhosale']",43,"['shrutisneha.prasad', 'tanuj.udani', 'prajaktapatil', '2015vipra.arolkar', 'sachimalkan', 'aa9858203050', 'aniketozarkar', 'aakashmeshram', 'dhairyagada1997', 'yash.bhatia', '2015anuj.pakhare', '2015prachi.kothawade', '2015deepak', '2015omkar.tulaskar', 'ej2013.ankit.panvalkar', 'himanisheth98', 'aartimaurya5', 'lairai9', 'ujwala.pol', 'rohit24k', 'ajitjadhav', 'sankalp8055', '2015varun.gokhale', 'tanviwagh', 'kaushal37', 'zobe97', '2015soham.sawant', '2015pratik.warke', 'varunswadia', '2015soumya.chinthalapudi', '2015mukul.sharma', 'abhi97', None, '2015radhika.angolkar', 'naval29', 'shivanianekar13', '2015sanika.pathare', '2015rasika.wagh', '2015nitish.nayak', '2015riya.maheshwari', '2015manas.kulkarni', 'shreyas.sshende', 'jayesh.bhosale']"
70,100,13,19,9,"['yash.bhatia', '2015vipra.arolkar', 'sankalp8055', '2015sanika.pathare', '2015rasika.wagh', '2015riya.maheshwari', '2015manas.kulkarni', 'abhi97', '2015radhika.angolkar']",3,"['naval29', 'shivanianekar13', 'zobe97']",10,"['jainamshah697', 'prajaktapatil', '2015deepak', '2015prachi.kothawade', 'pravinbagade123', 'ej2013.ankit.panvalkar', '2015nitish.nayak', '2015jayanti.jha', 'neeiljain', None]",22,"['jainamshah697', 'prajaktapatil', '2015vipra.arolkar', 'sankalp8055', 'zobe97', 'abhi97', None, '2015radhika.angolkar', 'naval29', 'yash.bhatia', '2015prachi.kothawade', '2015deepak', 'shivanianekar13', '2015sanika.pathare', 'pravinbagade123', '2015rasika.wagh', 'ej2013.ankit.panvalkar', '2015nitish.nayak', 'neeiljain', '2015riya.maheshwari', '2015manas.kulkarni', '2015jayanti.jha']"
70,96,13,18,3,"['2015riya.maheshwari', '2015rasika.wagh', '2015vipra.arolkar']",9,"['naval29', 'yash.bhatia', 'shivanianekar13', 'sankalp8055', '2015sanika.pathare', 'zobe97', '2015manas.kulkarni', 'abhi97', '2015radhika.angolkar']",15,"['shrutisneha.prasad', 'prajaktapatil', '2015bhushan.jadhav', '2015prachi.kothawade', '2015varun.gokhale', '2015dnyanal.berde', '2015mugdha.sonwane', 'tejashree.khirawade', 'sayli8898', 'kaushal37', 'aartimaurya5', 'lairai9', '2015soham.sawant', None, 'hemant.wakchaure']",27,"['shrutisneha.prasad', 'prajaktapatil', '2015vipra.arolkar', 'sankalp8055', '2015varun.gokhale', '2015dnyanal.berde', '2015mugdha.sonwane', 'sayli8898', 'kaushal37', '2015soham.sawant', 'zobe97', 'abhi97', None, 'hemant.wakchaure', '2015radhika.angolkar', 'naval29', 'tejashree.khirawade', '2015bhushan.jadhav', 'yash.bhatia', '2015prachi.kothawade', 'shivanianekar13', '2015sanika.pathare', '2015rasika.wagh', 'aartimaurya5', 'lairai9', '2015riya.maheshwari', '2015manas.kulkarni']"
70,99,13,13,4,"['2015manas.kulkarni', 'abhi97', 'yash.bhatia', '2015vipra.arolkar']",8,"['naval29', 'shivanianekar13', 'sankalp8055', '2015sanika.pathare', '2015rasika.wagh', 'zobe97', '2015riya.maheshwari', '2015radhika.angolkar']",9,"['jainamshah697', 'prajaktapatil', '2015deepak', '2015supriya.khatri', '2015shaunak.athalye', '2015babu.adik', '2015vipul.jain', 'ujwala.pol', None]",21,"['jainamshah697', 'prajaktapatil', '2015vipra.arolkar', 'sankalp8055', 'zobe97', 'ujwala.pol', 'abhi97', None, '2015radhika.angolkar', 'naval29', 'yash.bhatia', '2015deepak', 'shivanianekar13', '2015sanika.pathare', '2015supriya.khatri', '2015rasika.wagh', '2015shaunak.athalye', '2015babu.adik', '2015vipul.jain', '2015riya.maheshwari', '2015manas.kulkarni']"
70,97,13,8,1,['2015rasika.wagh'],11,"['naval29', 'yash.bhatia', '2015vipra.arolkar', 'shivanianekar13', 'sankalp8055', '2015sanika.pathare', 'zobe97', '2015riya.maheshwari', '2015manas.kulkarni', 'abhi97', '2015radhika.angolkar']",7,"['prajaktapatil', '2015anuj.pakhare', '2015varun.gokhale', 'aartimaurya5', '2015soham.sawant', None, 'shubham.sutrakar']",19,"['prajaktapatil', '2015vipra.arolkar', 'sankalp8055', '2015varun.gokhale', '2015soham.sawant', 'zobe97', 'abhi97', None, '2015radhika.angolkar', 'naval29', 'yash.bhatia', '2015anuj.pakhare', 'shivanianekar13', '2015sanika.pathare', '2015rasika.wagh', 'aartimaurya5', '2015riya.maheshwari', '2015manas.kulkarni', 'shubham.sutrakar']"
70,95,13,7,3,"['2015riya.maheshwari', 'abhi97', '2015vipra.arolkar']",9,"['naval29', 'yash.bhatia', 'shivanianekar13', 'sankalp8055', '2015sanika.pathare', '2015rasika.wagh', 'zobe97', '2015manas.kulkarni', '2015radhika.angolkar']",4,"['2015soumya.chinthalapudi', None, 'arthaya.koyande28', 'lairai9']",16,"['2015vipra.arolkar', 'sankalp8055', 'zobe97', 'arthaya.koyande28', '2015soumya.chinthalapudi', 'abhi97', None, '2015radhika.angolkar', 'naval29', 'yash.bhatia', 'shivanianekar13', '2015sanika.pathare', '2015rasika.wagh', 'lairai9', '2015riya.maheshwari', '2015manas.kulkarni']"
71,163,12,10,9,"['chinmayi.kashyap28', 'sssmitha97', 'biotechnologybatch.2015', 'shabyashachi', 'meghasg898', 'manasashettys97', 'noorarfa09', 'noorulainfatima15', 'shwethajayakumar97']",2,"['bhavyabr2697', 'subra.aishwarya']",1,[None],12,"['biotechnologybatch.2015', 'meghasg898', 'noorarfa09', 'subra.aishwarya', None, 'chinmayi.kashyap28', 'sssmitha97', 'shabyashachi', 'manasashettys97', 'bhavyabr2697', 'noorulainfatima15', 'shwethajayakumar97']"
72,212,12,15,11,"['mshassan', 'maxgruen', 'atugman', 'soali', 'madfain', 'jackclar', 'gcantor', 'jkrzesni', 'eliphil', 'ajwhelan', 'youngs2']",0,[],4,"['rmneubau', 'fanbsun', None, 'nanoushe']",15,"['jackclar', 'gcantor', 'nanoushe', 'ajwhelan', 'rmneubau', None, 'mshassan', 'maxgruen', 'atugman', 'soali', 'madfain', 'jkrzesni', 'eliphil', 'fanbsun', 'youngs2']"
73,316,12,8,7,"['manalighorpade1697', 'shriya.h.joshi', 'viraktdoshi19', 'rahul.pradhan1997', 'mananshah30137', 'akshayrita20', 'ckargutkar96']",4,"['nande.manasi16', '1jyotsna1', 'riddhis2411', 'agarwal.gagan5101']",1,[None],12,"['viraktdoshi19', 'akshayrita20', '1jyotsna1', None, 'nande.manasi16', 'manalighorpade1697', 'shriya.h.joshi', 'riddhis2411', 'rahul.pradhan1997', 'agarwal.gagan5101', 'mananshah30137', 'ckargutkar96']"
73,318,12,8,4,"['nande.manasi16', '1jyotsna1', 'riddhis2411', 'agarwal.gagan5101']",7,"['manalighorpade1697', 'shriya.h.joshi', 'viraktdoshi19', 'rahul.pradhan1997', 'akshayrita20', 'mananshah30137', 'ckargutkar96']",4,"['ameysawant25597', None, 'yashsavle', 'himanisheth98']",15,"['viraktdoshi19', 'akshayrita20', 'ameysawant25597', '1jyotsna1', None, 'yashsavle', 'nande.manasi16', 'manalighorpade1697', 'shriya.h.joshi', 'riddhis2411', 'himanisheth98', 'rahul.pradhan1997', 'agarwal.gagan5101', 'mananshah30137', 'ckargutkar96']"
74,361,12,8,6,"['guilhermeazevedofis', 'methz', 'joaovictorlemes3', 'dionizio', 'tainaracescate', 'gabrielmontoro']",5,"['vaibhav.gupta.mst16', 'stefanyoofontes', 'menglingyuan.jlu', 'gabrielsousaez', 'bikash.patra']",2,"[None, 'brauliogabriel']",13,"['guilhermeazevedofis', 'methz', 'stefanyoofontes', 'joaovictorlemes3', 'gabrielsousaez', 'tainaracescate', 'brauliogabriel', None, 'bikash.patra', 'vaibhav.gupta.mst16', 'dionizio', 'gabrielmontoro', 'menglingyuan.jlu']"
75,170,12,41,9,"['ee17btech11048', 'yogeshsingiresu', 'vallurureddykhaja', 'ee17btech11011', 'amballaavinash', 'ee17btech11043', 'abhishek462000', 'ee17btech11030', 'ee17btech11008']",2,"['tjtasu2016', 'sachindev91']",32,"['ee17btech11021', 'pradeepmoturi', 'ee17btech11036', 'siddharthmanu500', 'ee17btech11014', 'ee17btech11013', 'madhurima143', 'manideepvuppala', 'ee17btech11012', 'ee17btech11050', 'sumanthcherupally', 'ee17btech11009', 'dheerajracha', 'yash6499', 'ee17btech11034', 'ee17btech11016', 'taruntejreddych', 'ee17btech11025', 'yogeshubbu', 'ee17btech11040', 'k.vamshika', 'es16btech11026', 'knsiddharth', 'prag', '124guna', None, 'ee17btech11037', 'falconrider10', 'pranjalshiv123', 'raktim', 'ananth7121999', 'karthikp']",43,"['ee17btech11048', 'ee17btech11021', 'pradeepmoturi', 'ee17btech11036', 'siddharthmanu500', 'ee17btech11014', 'ee17btech11013', 'abhishek462000', 'madhurima143', 'ee17btech11008', 'manideepvuppala', 'ee17btech11012', 'ee17btech11050', 'sumanthcherupally', 'ee17btech11009', 'dheerajracha', 'yash6499', 'ee17btech11011', 'ee17btech11034', 'ee17btech11043', 'ee17btech11016', 'taruntejreddych', 'ee17btech11025', 'yogeshubbu', 'ee17btech11040', 'yogeshsingiresu', 'k.vamshika', 'es16btech11026', 'knsiddharth', 'prag', 'amballaavinash', 'vallurureddykhaja', '124guna', None, 'ee17btech11037', 'falconrider10', 'pranjalshiv123', 'raktim', 'tjtasu2016', 'ananth7121999', 'ee17btech11030', 'karthikp', 'sachindev91']"
75,169,12,34,1,['ee17btech11048'],10,"['yogeshsingiresu', 'vallurureddykhaja', 'ee17btech11011', 'amballaavinash', 'ee17btech11043', 'tjtasu2016', 'abhishek462000', 'ee17btech11030', 'ee17btech11008', 'sachindev91']",33,"['ee17btech11006', 'ee17btech11021', 'pradeepmoturi', 'ee17btech11036', 'siddharthmanu500', 'ee17btech11014', 'ee17btech11013', 'ee17btech11012', 'ee17btech11050', 'sumanthcherupally', 'dheerajracha', 'yash6499', 'parimiamrit', 'ee17btech11034', 'ee17btech11016', 'taruntejreddych', 'ee17btech11025', 'yogeshubbu', 'ee17btech11040', 'k.vamshika', 'es16btech11026', 'knsiddharth', 'prag', '124guna', None, 'ee17btech11037', 'falconrider10', 'pranjalshiv123', 'kurakula.vamshika', 'emani', 'raktim', 'ananth7121999', 'karthikp']",44,"['ee17btech11006', 'ee17btech11048', 'ee17btech11021', 'pradeepmoturi', 'ee17btech11036', 'siddharthmanu500', 'ee17btech11014', 'ee17btech11013', 'abhishek462000', 'ee17btech11008', 'ee17btech11012', 'ee17btech11050', 'sumanthcherupally', 'dheerajracha', 'yash6499', 'parimiamrit', 'ee17btech11011', 'ee17btech11034', 'ee17btech11043', 'ee17btech11016', 'taruntejreddych', 'ee17btech11025', 'yogeshubbu', 'ee17btech11040', 'yogeshsingiresu', 'k.vamshika', 'es16btech11026', 'knsiddharth', 'prag', 'amballaavinash', 'vallurureddykhaja', '124guna', None, 'ee17btech11037', 'falconrider10', 'pranjalshiv123', 'kurakula.vamshika', 'emani', 'raktim', 'tjtasu2016', 'ananth7121999', 'ee17btech11030', 'karthikp', 'sachindev91']"
76,50,12,14,8,"['padmavlr01', 'divassingh.dagur2018', 'mdjunaid071', 'ds1akbarbasha', 'sreekanthsp', 'suvankar94', 'monunith', 'nivedhita123']",3,"['nikhilsai79', 'saipriya.tummala2018', 'elsa.george2018']",6,"['cp.praveen2018', 'mi.shanmugapriyan2018', 'prabhat_swain', 'kadiyamanusha', 'bose.sankha', None]",17,"['mi.shanmugapriyan2018', 'mdjunaid071', 'suvankar94', 'ds1akbarbasha', 'saipriya.tummala2018', None, 'nivedhita123', 'cp.praveen2018', 'padmavlr01', 'divassingh.dagur2018', 'prabhat_swain', 'kadiyamanusha', 'elsa.george2018', 'sreekanthsp', 'bose.sankha', 'monunith', 'nikhilsai79']"
76,52,12,13,10,"['padmavlr01', 'divassingh.dagur2018', 'mdjunaid071', 'elsa.george2018', 'sreekanthsp', 'suvankar94', 'ds1akbarbasha', 'saipriya.tummala2018', 'nikhilsai79', 'nivedhita123']",1,['monunith'],3,"['gnivetha05', 'junaidmd1996', None]",14,"['mdjunaid071', 'suvankar94', 'ds1akbarbasha', 'saipriya.tummala2018', 'gnivetha05', None, 'nivedhita123', 'junaidmd1996', 'padmavlr01', 'divassingh.dagur2018', 'elsa.george2018', 'sreekanthsp', 'monunith', 'nikhilsai79']"
76,49,12,12,5,"['elsa.george2018', 'sreekanthsp', 'monunith', 'saipriya.tummala2018', 'nikhilsai79']",6,"['padmavlr01', 'divassingh.dagur2018', 'mdjunaid071', 'suvankar94', 'ds1akbarbasha', 'nivedhita123']",7,"['shuruthipriyav', 'mi.shanmugapriyan2018', 'reneethgabriella.r', 'sarveshvaran', 'bose.sankha', None, 'mital.nanda2018']",18,"['mi.shanmugapriyan2018', 'mdjunaid071', 'reneethgabriella.r', 'sarveshvaran', 'suvankar94', 'ds1akbarbasha', 'saipriya.tummala2018', None, 'mital.nanda2018', 'nivedhita123', 'shuruthipriyav', 'padmavlr01', 'divassingh.dagur2018', 'elsa.george2018', 'sreekanthsp', 'bose.sankha', 'monunith', 'nikhilsai79']"
76,53,12,9,6,"['padmavlr01', 'ds1akbarbasha', 'elsa.george2018', 'suvankar94', 'monunith', 'saipriya.tummala2018']",5,"['divassingh.dagur2018', 'mdjunaid071', 'sreekanthsp', 'nikhilsai79', 'nivedhita123']",3,"['kyathamharikrishna', None, 'padmavlr']",14,"['padmavlr', 'mdjunaid071', 'kyathamharikrishna', 'suvankar94', 'ds1akbarbasha', 'saipriya.tummala2018', None, 'nivedhita123', 'padmavlr01', 'divassingh.dagur2018', 'elsa.george2018', 'sreekanthsp', 'monunith', 'nikhilsai79']"
77,157,12,20,11,"['matthewdonne141', 'pkulkarni', 'slamotte', 'jinyoungpark', 'fengsun', 'zwoods', 'jpweber', 'rsepanek', 'astam', 'kgeorgadarel5', 'mbolognese']",0,[],9,"['pfang', 'cjfoss', 'aksamija', 'dnarasimhara', 'nshattuck', 'pjaswal', 'nbonthala', 'nlochner', None]",20,"['aksamija', 'dnarasimhara', 'pkulkarni', 'cjfoss', 'jinyoungpark', 'slamotte', 'fengsun', 'rsepanek', 'nshattuck', 'kgeorgadarel5', 'astam', None, 'mbolognese', 'pfang', 'matthewdonne141', 'zwoods', 'jpweber', 'pjaswal', 'nbonthala', 'nlochner']"
77,175,12,20,11,"['matthewdonne141', 'pkulkarni', 'slamotte', 'jinyoungpark', 'fengsun', 'zwoods', 'jpweber', 'rsepanek', 'astam', 'kgeorgadarel5', 'mbolognese']",0,[],9,"['ternencexiong', 'pfang', 'cjfoss', 'srini999', 'nshattuck', 'pjaswal', 'nbonthala', 'nlochner', None]",20,"['cjfoss', 'pkulkarni', 'jinyoungpark', 'slamotte', 'fengsun', 'rsepanek', 'srini999', 'nshattuck', 'kgeorgadarel5', 'astam', None, 'mbolognese', 'ternencexiong', 'pfang', 'matthewdonne141', 'zwoods', 'jpweber', 'pjaswal', 'nbonthala', 'nlochner']"
77,271,12,20,11,"['matthewdonne141', 'pkulkarni', 'slamotte', 'jinyoungpark', 'fengsun', 'zwoods', 'jpweber', 'rsepanek', 'astam', 'kgeorgadarel5', 'mbolognese']",0,[],9,"['ternencexiong', 'pfang', 'cjfoss', 'srini999', 'nshattuck', 'pjaswal', 'nbonthala', 'nlochner', None]",20,"['cjfoss', 'pkulkarni', 'jinyoungpark', 'slamotte', 'fengsun', 'rsepanek', 'srini999', 'nshattuck', 'kgeorgadarel5', 'astam', None, 'mbolognese', 'ternencexiong', 'pfang', 'matthewdonne141', 'zwoods', 'jpweber', 'pjaswal', 'nbonthala', 'nlochner']"
77,55,12,16,10,"['matthewdonne141', 'pkulkarni', 'slamotte', 'jinyoungpark', 'fengsun', 'rsepanek', 'jpweber', 'astam', 'kgeorgadarel5', 'mbolognese']",1,['zwoods'],6,"['ternencexiong', 'cjfoss', 'pjaswal', 'nbonthala', 'nlochner', None]",17,"['cjfoss', 'pkulkarni', 'jinyoungpark', 'slamotte', 'fengsun', 'rsepanek', 'kgeorgadarel5', 'astam', None, 'mbolognese', 'ternencexiong', 'matthewdonne141', 'zwoods', 'jpweber', 'pjaswal', 'nbonthala', 'nlochner']"
77,71,12,15,10,"['matthewdonne141', 'pkulkarni', 'slamotte', 'fengsun', 'rsepanek', 'zwoods', 'jpweber', 'astam', 'kgeorgadarel5', 'mbolognese']",1,['jinyoungpark'],5,"['nshattuck', 'nbonthala', 'nlochner', 'sasapu', None]",16,"['pkulkarni', 'jinyoungpark', 'slamotte', 'fengsun', 'rsepanek', 'nshattuck', 'kgeorgadarel5', 'astam', 'sasapu', None, 'mbolognese', 'matthewdonne141', 'zwoods', 'jpweber', 'nbonthala', 'nlochner']"
77,79,12,11,8,"['matthewdonne141', 'jinyoungpark', 'slamotte', 'fengsun', 'zwoods', 'jpweber', 'kgeorgadarel5', 'mbolognese']",3,"['pkulkarni', 'rsepanek', 'astam']",3,"['pfang', None, 'nlochner']",14,"['pkulkarni', 'jinyoungpark', 'slamotte', 'fengsun', 'rsepanek', 'kgeorgadarel5', 'astam', None, 'mbolognese', 'pfang', 'matthewdonne141', 'zwoods', 'jpweber', 'nlochner']"
78,70,12,127,6,"['jwoon', 'dkilgor', 'rice103', 'shaunak0304', 'sueprasad8214', 'amckeska']",5,"['waters22', 'rrahimi', 'sburmesc', 'gessnergezzy', 'hgasper']",121,"['akreuter', 'tylera2104', 'kamranahmed', 'btestin14', 'osborn45', 'jacob_just', 'ryan.wiebe', 'nt230', 'agarw105', 'wstolz', 'suhaira97', 'akreilein', 'itsmemario', 'ksjolund', 'afalkenb', 'tgiazzon', 'john1886', 'cmelchin', 'charlesma423', 'ryanwest1040', 'george7elias', 'rjleach', 'boninim', 'rkwiatko', 'jkekre', 'cclapham', 'fischermben', 'greid09', 'spring12', 'mcrees', 'landon.glunt', 'ebergqu', 'psumner', 'buck17', 'davi1004', 'nathanmoore', 'angbecker', 'sammyknecht', 'hannahdeboer0015', 'cputt', 'kewlkahtz', 'ebehring', 'treyfinn98', 'mcclurez', 'canadaman87', 'mishra59', 'alyssamcnarney', 'aboza', 'snowh5696', 'cartmaster007', 'baker428', 'munselltom', 'anthonm', 'ikstealth', 'hkohart', 'dgreiwe', 'chiranth7954', 'htorsina', 'sfgdfgdfg', 'jstalbaum', 'kellhages37', 'white519', 'nmcphero', 'shadow66666', 'ckroger', 'ehonebri', 'talon34567', 'fahimvora12', 'jacobglvn', 'rishiprasadha', 'agalema1027', 'jfolkers', 'swift8', 'joshuajkporter', 'draosmail', 'rachel318318', 'suran9712', 'akonopa', 'oliver67', 'hess35', 'asartor', 'crhodine', 'tilley0', 'mingusnate', 'kjh94425', 'royriveraf', 'dodge4', 'jacobpeterson698', 'jswetlik', 'hanmoyuan1997', 'garret28', 'wdrummon', 'maxwellfra16', 'mcclure8', 'nikhilcarneiro4', 'hkaakeh', 'kkamiya', 'cameronfritts12', 'kruege14', 'wallac68', 'herr13', 'nggoodie98', 'rsusler', 'imran3', 'kknowlto', 'batram197', 'brandt18', 'jskeens', 'acostab', 'bradsmrdel', 'jklaben', 'kevinodonnell0878', 'vcotta', 'lmeehann', 'goh5', 'mccaul', 'k.ico246', 'yhoashi', 'rao53', 'singh378', 'rileyedelaney']",132,"['sburmesc', 'tylera2104', 'btestin14', 'jacob_just', 'ryan.wiebe', 'nt230', 'agarw105', 'wstolz', 'itsmemario', 'afalkenb', 'tgiazzon', 'rkwiatko', 'jkekre', 'mcrees', 'psumner', 'buck17', 'sammyknecht', 'sueprasad8214', 'hgasper', 'hannahdeboer0015', 'cputt', 'amckeska', 'mcclurez', 'alyssamcnarney', 'shaunak0304', 'anthonm', 'hkohart', 'dgreiwe', 'sfgdfgdfg', 'jstalbaum', 'fahimvora12', 'rishiprasadha', 'waters22', 'swift8', 'draosmail', 'akonopa', 'hess35', 'crhodine', 'tilley0', 'mingusnate', 'rice103', 'kjh94425', 'dodge4', 'mcclure8', 'nikhilcarneiro4', 'hkaakeh', 'kkamiya', 'herr13', 'nggoodie98', 'rsusler', 'imran3', 'batram197', 'brandt18', 'bradsmrdel', 'vcotta', 'goh5', 'singh378', 'rileyedelaney', 'akreuter', 'kamranahmed', 'osborn45', 'suhaira97', 'akreilein', 'ksjolund', 'john1886', 'cmelchin', 'charlesma423', 'ryanwest1040', 'george7elias', 'rjleach', 'boninim', 'cclapham', 'fischermben', 'greid09', 'spring12', 'landon.glunt', 'ebergqu', 'davi1004', 'nathanmoore', 'angbecker', 'kewlkahtz', 'ebehring', 'treyfinn98', 'canadaman87', 'mishra59', 'aboza', 'snowh5696', 'cartmaster007', 'baker428', 'munselltom', 'ikstealth', 'chiranth7954', 'htorsina', 'jwoon', 'kellhages37', 'white519', 'nmcphero', 'shadow66666', 'ckroger', 'ehonebri', 'talon34567', 'jacobglvn', 'agalema1027', 'jfolkers', 'joshuajkporter', 'rachel318318', 'suran9712', 'oliver67', 'asartor', 'gessnergezzy', 'royriveraf', 'jacobpeterson698', 'jswetlik', 'hanmoyuan1997', 'garret28', 'wdrummon', 'maxwellfra16', 'cameronfritts12', 'kruege14', 'wallac68', 'dkilgor', 'kknowlto', 'jskeens', 'acostab', 'rrahimi', 'jklaben', 'kevinodonnell0878', 'lmeehann', 'mccaul', 'k.ico246', 'yhoashi', 'rao53']"
78,216,12,126,4,"['sueprasad8214', 'jwoon', 'dkilgor', 'amckeska']",7,"['rrahimi', 'sburmesc', 'gessnergezzy', 'hgasper', 'rice103', 'shaunak0304', 'waters22']",122,"['ggauthi', 'geyerg', 'arturotrevino', 'wan52', 'akreuter', 'yeager5', 'bsmrdel', 'vwallema', 'btestin14', 'starr21', 'vpope', 'nt230', 'wstolz', 'suhaira97', 'ikobayas', 'yang1206', 'xng', 'lee2370', 'itsmemario', 'conner.swift8', 'eforti', 'jrohman', 'john1886', 'afalkenb', 'tgiazzon', 'justj', 'cmelchin', 'ryanwest1040', 'charlesma423', 'george7elias', 'boninim', 'evdaly', 'jkekre', 'cclapham', 'fischermben', 'landon.glunt', 'mcrees', 'jdanek', 'psumner', 'cbischof', 'rao75', 'kgmcginley', 'nathanmoore', 'angbecker', 'samm', 'ggolla', 'chanwoo.lee.17', 'ebehring', 'ryry1644', 'dschull', 'nafandi', 'purduechen2203', 'cartmaster007', 'hyndmanjustin', 'davids19', 'anthonm', 'dgreiwe', 'chiranth7954', 'smit3180', 'caldwe29', 'shaw108', 'nhdorcy', 'ehonebri', 'shadow66666', 'talon34567', 'huan1146', 'rishiprasadha', 'radhakr3', 'cpiepen', 'jacobglvn', 'jfolkers', 'joshuajkporter', 'agalema1027', 'suran9712', 'akonopa', 'oliver67', 'hess35', 'kskripakaran0810', 'asartor', 'tilley0', 'crhodine', 'mingusnate', 'kjh94425', 'maxwellfra16', 'garret28', 'zjohnson834', 'rhellyer', 'mcclure8', 'nikhilcarneiro4', 'jkueche', 'kruege14', 'albrect', 'nramli', 'ecronin', 'heinzt', 'akreilei', 'srasche', 'rsusler', 'rwiebe', 'mcdona85', 'kknowlto', None, 'river132', 'jskeens', 'yizhizhang', 'selawada', 'dsfgdsfg', 'acostab', 'tthieles', 'khageman', 'kevinodonnell0878', 'lmeehann', 'sknecht', 'goh5', 'kico', 'mccaul', 'rao53', 'muelle77', 'aguyre', 'singh378', 'rileyedelaney', 'athoman']",133,"['ggauthi', 'arturotrevino', 'wan52', 'sburmesc', 'vwallema', 'btestin14', 'starr21', 'nt230', 'wstolz', 'xng', 'itsmemario', 'conner.swift8', 'eforti', 'afalkenb', 'tgiazzon', 'evdaly', 'jkekre', 'mcrees', 'jdanek', 'psumner', 'cbischof', 'kgmcginley', 'sueprasad8214', 'hgasper', 'amckeska', 'nafandi', 'davids19', 'shaunak0304', 'anthonm', 'dgreiwe', 'smit3180', 'rishiprasadha', 'waters22', 'akonopa', 'hess35', 'tilley0', 'crhodine', 'mingusnate', 'rice103', 'kjh94425', 'mcclure8', 'nikhilcarneiro4', 'srasche', 'rsusler', 'rwiebe', 'river132', 'selawada', 'dsfgdsfg', 'tthieles', 'khageman', 'sknecht', 'goh5', 'muelle77', 'aguyre', 'singh378', 'rileyedelaney', 'geyerg', 'akreuter', 'yeager5', 'bsmrdel', 'vpope', 'suhaira97', 'ikobayas', 'yang1206', 'lee2370', 'jrohman', 'john1886', 'justj', 'cmelchin', 'ryanwest1040', 'charlesma423', 'george7elias', 'boninim', 'cclapham', 'fischermben', 'landon.glunt', 'rao75', 'nathanmoore', 'angbecker', 'samm', 'ggolla', 'chanwoo.lee.17', 'ebehring', 'ryry1644', 'dschull', 'purduechen2203', 'cartmaster007', 'hyndmanjustin', 'chiranth7954', 'jwoon', 'caldwe29', 'shaw108', 'nhdorcy', 'ehonebri', 'shadow66666', 'talon34567', 'huan1146', 'radhakr3', 'cpiepen', 'jacobglvn', 'jfolkers', 'joshuajkporter', 'agalema1027', 'suran9712', 'oliver67', 'kskripakaran0810', 'asartor', 'gessnergezzy', 'maxwellfra16', 'garret28', 'zjohnson834', 'rhellyer', 'jkueche', 'kruege14', 'albrect', 'nramli', 'ecronin', 'dkilgor', 'heinzt', 'akreilei', 'mcdona85', 'kknowlto', None, 'jskeens', 'yizhizhang', 'acostab', 'rrahimi', 'kevinodonnell0878', 'lmeehann', 'kico', 'mccaul', 'rao53', 'athoman']"
79,357,12,12,9,"['backster7915', 'psqkr0283', 'oribibim', 'rnjstjdgus5', 'tjdgusdbs8810', 'pjrinas', 'dayuff', 'bigstar0107', 'tochimailbox']",2,"['sinto8211', 'giri']",3,"['kinny', 'drygchung', None]",14,"['psqkr0283', 'kinny', 'drygchung', 'oribibim', 'rnjstjdgus5', 'bigstar0107', 'giri', None, 'sinto8211', 'backster7915', 'tjdgusdbs8810', 'pjrinas', 'dayuff', 'tochimailbox']"
79,130,12,9,7,"['backster7915', 'rnjstjdgus5', 'tjdgusdbs8810', 'pjrinas', 'dayuff', 'bigstar0107', 'tochimailbox']",4,"['sinto8211', 'giri', 'oribibim', 'psqkr0283']",2,"['drygchung', None]",13,"['psqkr0283', 'drygchung', 'oribibim', 'rnjstjdgus5', 'bigstar0107', 'giri', None, 'sinto8211', 'backster7915', 'tjdgusdbs8810', 'pjrinas', 'dayuff', 'tochimailbox']"
79,352,12,8,4,"['sinto8211', 'giri', 'bigstar0107', 'psqkr0283']",7,"['backster7915', 'oribibim', 'rnjstjdgus5', 'tjdgusdbs8810', 'pjrinas', 'dayuff', 'tochimailbox']",4,"['kinny', None, 'dbstjdgus8810', 'ssj7353']",15,"['psqkr0283', 'kinny', 'oribibim', 'rnjstjdgus5', 'bigstar0107', 'giri', 'dbstjdgus8810', None, 'sinto8211', 'backster7915', 'tjdgusdbs8810', 'pjrinas', 'dayuff', 'tochimailbox', 'ssj7353']"
79,353,12,8,6,"['backster7915', 'rnjstjdgus5', 'tjdgusdbs8810', 'pjrinas', 'bigstar0107', 'tochimailbox']",5,"['sinto8211', 'psqkr0283', 'oribibim', 'dayuff', 'giri']",2,"['drygchung', None]",13,"['psqkr0283', 'drygchung', 'oribibim', 'rnjstjdgus5', 'bigstar0107', 'giri', None, 'sinto8211', 'backster7915', 'tjdgusdbs8810', 'pjrinas', 'dayuff', 'tochimailbox']"
79,131,12,6,2,"['sinto8211', 'giri']",9,"['backster7915', 'psqkr0283', 'oribibim', 'rnjstjdgus5', 'tjdgusdbs8810', 'pjrinas', 'dayuff', 'bigstar0107', 'tochimailbox']",4,"['kinny', None, 'dbstjdgus8810', 'ssj7353']",15,"['sinto8211', 'psqkr0283', 'backster7915', 'kinny', 'oribibim', 'rnjstjdgus5', 'tjdgusdbs8810', None, 'pjrinas', 'dayuff', 'bigstar0107', 'giri', 'tochimailbox', 'dbstjdgus8810', 'ssj7353']"
79,358,12,6,4,"['sinto8211', 'giri', 'bigstar0107', 'psqkr0283']",7,"['backster7915', 'oribibim', 'rnjstjdgus5', 'tjdgusdbs8810', 'pjrinas', 'dayuff', 'tochimailbox']",2,"[None, 'ssj7353']",13,"['sinto8211', 'psqkr0283', 'backster7915', 'oribibim', 'rnjstjdgus5', 'tjdgusdbs8810', 'pjrinas', 'dayuff', 'bigstar0107', 'giri', 'tochimailbox', None, 'ssj7353']"
80,82,12,52,3,"['faizanalibugti', 'kashasan15', 'afnanmazhar']",8,"['mabigirco', 'camargome2013', 'kausarsaleem65', 'chris.png25', 'rg3brevverv', 'bplamondon', 'rsotadoy', 'bwilson']",49,"['hariskshah', 'remshaa5', 'hnihallani75', 'syedzainrock8', 'daanyaal', 'saqibkamal', 'farhanthespy', 'farahkareem5', 'mazeemkhanreal', 'areeba_khan', 'syedazainabhassan16', 'saba_nadeem91', 'moizraza10', 'hassananwer1010', 'ilsa.khalid', 'mamonarao01', 'shehzad_ahmed10', 'bhaifaiz77', 'asadhussain765', 'm.naufil1', 'sheebaishtiaque.102', 'aqsaqasim10', 'ahmerinam99', 'owaisbashir26', 'taqdeesm3', 'khurramahmed1997', 'imtiazhira', 'mustafaarif12330', 'minhalrizvi98', 'shehzu94', 's.m.bahazad', 'habhutto2015', 'halamasood27', 'shayanali', 'shalalkhan18', None, 'khadimashoor437', 'aminahfatimah98', 'farahperveen72', 'saleem_008', 'hakeemorangzeb710', 'm.dawson', 'hamzaanwer', 'hamzaq44', 'el16009', 'aliirtaza98', 'ibeeey.a', 'iqra.javed1591997', 'fareha.saleem']",60,"['hariskshah', 'remshaa5', 'camargome2013', 'hnihallani75', 'syedzainrock8', 'daanyaal', 'saqibkamal', 'rg3brevverv', 'farhanthespy', 'farahkareem5', 'mazeemkhanreal', 'areeba_khan', 'kashasan15', 'syedazainabhassan16', 'saba_nadeem91', 'moizraza10', 'hassananwer1010', 'ilsa.khalid', 'mamonarao01', 'shehzad_ahmed10', 'bhaifaiz77', 'mabigirco', 'asadhussain765', 'm.naufil1', 'sheebaishtiaque.102', 'aqsaqasim10', 'kausarsaleem65', 'ahmerinam99', 'chris.png25', 'owaisbashir26', 'taqdeesm3', 'khurramahmed1997', 'afnanmazhar', 'imtiazhira', 'mustafaarif12330', 'minhalrizvi98', 'shehzu94', 's.m.bahazad', 'habhutto2015', 'halamasood27', 'shayanali', 'shalalkhan18', 'bplamondon', 'rsotadoy', None, 'khadimashoor437', 'bwilson', 'aminahfatimah98', 'farahperveen72', 'saleem_008', 'hakeemorangzeb710', 'm.dawson', 'hamzaanwer', 'hamzaq44', 'el16009', 'aliirtaza98', 'ibeeey.a', 'faizanalibugti', 'iqra.javed1591997', 'fareha.saleem']"
80,84,12,29,1,['kausarsaleem65'],10,"['mabigirco', 'camargome2013', 'chris.png25', 'rg3brevverv', 'kashasan15', 'afnanmazhar', 'bplamondon', 'rsotadoy', 'faizanalibugti', 'bwilson']",28,"['bismaraoluqman', 'hariskshah', 'owaisbukhari257', 'farahkareem5', 's_huzaifa', 'areeba_khan', 'moizraza10', 'shehzad_ahmed10', 'ilsa.khalid', 'ateefasiddiqui', 'm.naufil1', 'sufzpq', 'hareem.ahsan98', 'samiyajabbar', 'halamasood27', 'daanyaalnerd97', 'ashna', 'shalalkhan18', 'ibrahimahmedmughal', 'moonasayal', None, 'rubarasheed5678', 'aminahfatimah98', 'hamzaanwer', 'hareemmustafa', 'bushradayo', 'iqra.javed1591997', 'fareha.saleem']",39,"['bismaraoluqman', 'hariskshah', 'camargome2013', 'owaisbukhari257', 'rg3brevverv', 'farahkareem5', 's_huzaifa', 'areeba_khan', 'kashasan15', 'moizraza10', 'ilsa.khalid', 'ateefasiddiqui', 'shehzad_ahmed10', 'mabigirco', 'm.naufil1', 'sufzpq', 'kausarsaleem65', 'chris.png25', 'afnanmazhar', 'hareem.ahsan98', 'samiyajabbar', 'halamasood27', 'daanyaalnerd97', 'ashna', 'shalalkhan18', 'ibrahimahmedmughal', 'moonasayal', 'bplamondon', 'rsotadoy', None, 'bwilson', 'rubarasheed5678', 'aminahfatimah98', 'hamzaanwer', 'hareemmustafa', 'bushradayo', 'faizanalibugti', 'iqra.javed1591997', 'fareha.saleem']"
80,85,12,8,1,['bplamondon'],10,"['mabigirco', 'camargome2013', 'kausarsaleem65', 'chris.png25', 'rg3brevverv', 'kashasan15', 'afnanmazhar', 'rsotadoy', 'faizanalibugti', 'bwilson']",7,"['ppawelski', 'jamesdoty', 'mmei', 'ksie', 'carleydavis', None, 'stabatabaei']",18,"['camargome2013', 'ppawelski', 'rg3brevverv', 'ksie', 'kashasan15', 'bplamondon', 'rsotadoy', None, 'stabatabaei', 'bwilson', 'mabigirco', 'kausarsaleem65', 'jamesdoty', 'mmei', 'chris.png25', 'afnanmazhar', 'carleydavis', 'faizanalibugti']"
81,326,11,42,4,"['100vichare', 'bhupeshpatil98', 'welingnamrata', 'rakeshpatil3019']",6,"['supriyasingh1230', 'joshinirmit', 'ashish123_', 'tapan.garge', 'vishaltalari.vt', 'yashtanvipalande']",38,"['prathamesh.shivmare1', 'akankshachandoskar1198', 'hsnnalwala7', 'sanjit', 'sonalikharade5', 'rahulbirwadkar123', 'pnrs.pratik', 'bhai0045', 'adisawant333', 'pranjalijadhav0911', 'anujmdeorukhkar', 'pranalikothekar5', 'prathameshpatle13', 'priyankakunde22', 'jinku5454', 'bendalneha', 'salvir481', 'prajaktathorat24', 'urmil1700', 'gauribahatkar', 'arpitgodbole7', 'owais11', 'joishersweta17695', 'sourabhkothari16', 'sukanyajadhav1997', 'rasikapednekar20', 'aditiramadwar', None, 'divyassonawane', 'kajalbhoite04', 'arfat_24', 'aquibansari12377', 'rakeshpatil9271', 'aritramondal151', 'ashnavirdikar.av', 'rohit.elawadekar333', 'shripal17', 'kedar.kulkarni12']",48,"['prathamesh.shivmare1', 'akankshachandoskar1198', 'welingnamrata', 'hsnnalwala7', 'sanjit', 'sonalikharade5', 'rahulbirwadkar123', 'pnrs.pratik', 'bhai0045', 'adisawant333', 'pranjalijadhav0911', 'yashtanvipalande', 'joshinirmit', 'anujmdeorukhkar', 'pranalikothekar5', 'prathameshpatle13', 'priyankakunde22', 'jinku5454', 'bendalneha', 'salvir481', 'prajaktathorat24', 'urmil1700', 'gauribahatkar', 'supriyasingh1230', 'arpitgodbole7', 'owais11', 'vishaltalari.vt', 'tapan.garge', 'joishersweta17695', 'sourabhkothari16', 'sukanyajadhav1997', 'rasikapednekar20', 'aditiramadwar', 'rakeshpatil3019', None, 'bhupeshpatil98', 'divyassonawane', 'kajalbhoite04', 'arfat_24', 'aquibansari12377', 'ashish123_', 'rakeshpatil9271', 'aritramondal151', 'ashnavirdikar.av', 'rohit.elawadekar333', '100vichare', 'shripal17', 'kedar.kulkarni12']"
81,327,11,25,2,"['joshinirmit', 'tapan.garge']",8,"['supriyasingh1230', 'welingnamrata', 'ashish123_', 'vishaltalari.vt', 'rakeshpatil3019', '100vichare', 'yashtanvipalande', 'bhupeshpatil98']",23,"['rahul.ys', 'sanjita.s', 'urvi.panchal', 'pawan.mojar', 'debosmita.b', 'sonali.gavkar', 'nikitamittal97', 'aditya.aher', 'jagruti.patil', 'neha.hg', 'gandhi.j', 'aniruddh.s', 'soureen.g', 'anushkumar', 'rohit.vhatkar', 'nikita.us', 'jesal.t', 'rohitkadam702', 'vaishnavimahukar28', None, 'rajas.b', 'sarika', 'smita.n']",33,"['welingnamrata', 'rahul.ys', 'sanjita.s', 'yashtanvipalande', 'urvi.panchal', 'pawan.mojar', 'joshinirmit', 'sonali.gavkar', 'nikitamittal97', 'debosmita.b', 'aditya.aher', 'jagruti.patil', 'neha.hg', 'gandhi.j', 'aniruddh.s', 'soureen.g', 'anushkumar', 'rohit.vhatkar', 'supriyasingh1230', 'nikita.us', 'jesal.t', 'vishaltalari.vt', 'tapan.garge', 'rohitkadam702', 'vaishnavimahukar28', 'rakeshpatil3019', None, 'bhupeshpatil98', 'rajas.b', 'sarika', 'smita.n', 'ashish123_', '100vichare']"
82,210,11,7,6,"['josephpatole23', 'aqibkazi10', 'megauripawar', 'tanvi2881998', 'morechinmay123', 'omkarjoshi403']",4,"['rohitm13797', 'shivam10', 'gaurav.kolapate54', 'shivalisshah']",1,[None],11,"['shivam10', 'josephpatole23', 'shivalisshah', 'aqibkazi10', 'gaurav.kolapate54', 'megauripawar', 'morechinmay123', 'tanvi2881998', 'omkarjoshi403', 'rohitm13797', None]"
83,191,11,10,7,"['yul_20397', 'artemivanov1', 'sasha61', 'celepharn', 'kosincevxx', 'yulia_20397', 'pereverzevaan17']",3,"['yobaniywaggon', 'silverbeats01', 'nykytas']",3,"['stas.gaev.98', None, 'katherynelperry']",13,"['stas.gaev.98', 'yul_20397', 'sasha61', 'pereverzevaan17', None, 'silverbeats01', 'yobaniywaggon', 'artemivanov1', 'katherynelperry', 'kosincevxx', 'yulia_20397', 'celepharn', 'nykytas']"
83,187,11,9,8,"['yul_20397', 'yobaniywaggon', 'artemivanov1', 'sasha61', 'kosincevxx', 'pereverzevaan17', 'nykytas', 'silverbeats01']",2,"['celepharn', 'yulia_20397']",1,[None],11,"['yul_20397', 'sasha61', 'pereverzevaan17', None, 'silverbeats01', 'yobaniywaggon', 'artemivanov1', 'kosincevxx', 'yulia_20397', 'celepharn', 'nykytas']"
83,294,11,8,7,"['yul_20397', 'artemivanov1', 'sasha61', 'kosincevxx', 'yulia_20397', 'pereverzevaan17', 'nykytas']",3,"['celepharn', 'yobaniywaggon', 'silverbeats01']",1,[None],11,"['yul_20397', 'yobaniywaggon', 'artemivanov1', 'sasha61', None, 'pereverzevaan17', 'kosincevxx', 'yulia_20397', 'celepharn', 'nykytas', 'silverbeats01']"
85,189,11,14,9,"['sshinde4', 'jthakka2', 'shuaifeng', 'sudarsan1995', 'zxu45', 'hhonarv1', 'darshna1604', 'luvpreet', 'yutingchen']",1,['xyzzhanggan'],5,"['szhan152', 'jayyflores', 'soham947', None, 'sharayu96']",15,"['szhan152', 'jayyflores', 'hhonarv1', 'sudarsan1995', 'zxu45', 'soham947', 'luvpreet', None, 'yutingchen', 'sshinde4', 'xyzzhanggan', 'jthakka2', 'shuaifeng', 'darshna1604', 'sharayu96']"
85,282,11,13,9,"['sshinde4', 'jthakka2', 'shuaifeng', 'sudarsan1995', 'zxu45', 'hhonarv1', 'darshna1604', 'luvpreet', 'yutingchen']",1,['xyzzhanggan'],4,"['szhan152', None, 'sharayu96', 'jayyflores']",14,"['szhan152', 'jayyflores', 'hhonarv1', 'sudarsan1995', 'zxu45', 'luvpreet', None, 'yutingchen', 'sshinde4', 'xyzzhanggan', 'jthakka2', 'shuaifeng', 'darshna1604', 'sharayu96']"
85,284,11,12,8,"['jthakka2', 'shuaifeng', 'sudarsan1995', 'zxu45', 'hhonarv1', 'darshna1604', 'luvpreet', 'sshinde4']",2,"['xyzzhanggan', 'yutingchen']",4,"['szhan152', None, 'jayyflores', 'soham947']",14,"['szhan152', 'jayyflores', 'hhonarv1', 'sudarsan1995', 'zxu45', 'soham947', 'luvpreet', None, 'yutingchen', 'sshinde4', 'xyzzhanggan', 'jthakka2', 'shuaifeng', 'darshna1604']"
85,283,11,8,7,"['xyzzhanggan', 'shuaifeng', 'sudarsan1995', 'hhonarv1', 'zxu45', 'darshna1604', 'yutingchen']",3,"['luvpreet', 'jthakka2', 'sshinde4']",1,[None],11,"['xyzzhanggan', 'jthakka2', 'shuaifeng', 'hhonarv1', 'sudarsan1995', 'zxu45', None, 'yutingchen', 'darshna1604', 'luvpreet', 'sshinde4']"
86,215,10,13,9,"['cindric19', 'avidov', 'aso', 'sabinadzafic1', 'pgazdek', 'metalian8', 'leonardokrleza', 'mfilipasic', 'andrejkontrec']",0,[],4,"['josipadiklic', 'goranka', None, 'juraj.ovcar']",13,"['cindric19', 'aso', 'goranka', 'metalian8', 'andrejkontrec', None, 'avidov', 'sabinadzafic1', 'pgazdek', 'leonardokrleza', 'josipadiklic', 'mfilipasic', 'juraj.ovcar']"
87,63,10,10,9,"['naz', 'hknucakg', 'dyagdi35', 'firatyalcin', 'defnenazguler', 'fyalcin', 'enessaitbesler', 'senlen09', 'paranbarlak']",0,[],1,[None],10,"['naz', 'defnenazguler', 'firatyalcin', 'fyalcin', 'enessaitbesler', None, 'hknucakg', 'dyagdi35', 'senlen09', 'paranbarlak']"
87,89,10,10,9,"['naz', 'hknucakg', 'dyagdi35', 'firatyalcin', 'defnenazguler', 'fyalcin', 'enessaitbesler', 'senlen09', 'paranbarlak']",0,[],1,[None],10,"['naz', 'defnenazguler', 'firatyalcin', 'fyalcin', 'enessaitbesler', None, 'hknucakg', 'dyagdi35', 'senlen09', 'paranbarlak']"
87,219,10,10,9,"['naz', 'hknucakg', 'dyagdi35', 'firatyalcin', 'defnenazguler', 'fyalcin', 'enessaitbesler', 'senlen09', 'paranbarlak']",0,[],1,[None],10,"['naz', 'defnenazguler', 'firatyalcin', 'fyalcin', 'enessaitbesler', None, 'hknucakg', 'dyagdi35', 'senlen09', 'paranbarlak']"
88,326,10,42,4,"['jinku5454', 'urmil1700', 'arfat_24', 'bendalneha']",5,"['aditya.aher', 'neha.hg', 'debosmita.b', 'anushkumar', 'rajas.b']",38,"['prathamesh.shivmare1', 'akankshachandoskar1198', 'welingnamrata', 'hsnnalwala7', 'sanjit', 'sonalikharade5', 'rahulbirwadkar123', 'pnrs.pratik', 'bhai0045', 'adisawant333', 'pranjalijadhav0911', 'anujmdeorukhkar', 'pranalikothekar5', 'prathameshpatle13', 'priyankakunde22', 'salvir481', 'prajaktathorat24', 'gauribahatkar', 'arpitgodbole7', 'owais11', 'joishersweta17695', 'sourabhkothari16', 'sukanyajadhav1997', 'rasikapednekar20', 'aditiramadwar', 'rakeshpatil3019', None, 'divyassonawane', 'kajalbhoite04', 'bhupeshpatil98', 'aquibansari12377', 'rakeshpatil9271', 'aritramondal151', 'ashnavirdikar.av', 'rohit.elawadekar333', '100vichare', 'shripal17', 'kedar.kulkarni12']",47,"['prathamesh.shivmare1', 'akankshachandoskar1198', 'welingnamrata', 'hsnnalwala7', 'sanjit', 'sonalikharade5', 'rahulbirwadkar123', 'pnrs.pratik', 'bhai0045', 'adisawant333', 'pranjalijadhav0911', 'debosmita.b', 'aditya.aher', 'anujmdeorukhkar', 'pranalikothekar5', 'jinku5454', 'prathameshpatle13', 'priyankakunde22', 'neha.hg', 'bendalneha', 'salvir481', 'anushkumar', 'prajaktathorat24', 'urmil1700', 'gauribahatkar', 'arpitgodbole7', 'owais11', 'joishersweta17695', 'sourabhkothari16', 'sukanyajadhav1997', 'rasikapednekar20', 'aditiramadwar', 'rakeshpatil3019', None, 'rajas.b', 'divyassonawane', 'kajalbhoite04', 'bhupeshpatil98', 'arfat_24', 'aquibansari12377', 'rakeshpatil9271', 'aritramondal151', 'ashnavirdikar.av', 'rohit.elawadekar333', '100vichare', 'shripal17', 'kedar.kulkarni12']"
88,327,10,25,5,"['aditya.aher', 'neha.hg', 'debosmita.b', 'anushkumar', 'rajas.b']",4,"['jinku5454', 'urmil1700', 'arfat_24', 'bendalneha']",20,"['rahul.ys', 'sanjita.s', 'urvi.panchal', 'pawan.mojar', 'joshinirmit', 'sonali.gavkar', 'nikitamittal97', 'jagruti.patil', 'gandhi.j', 'aniruddh.s', 'soureen.g', 'rohit.vhatkar', 'nikita.us', 'jesal.t', 'tapan.garge', 'rohitkadam702', 'vaishnavimahukar28', None, 'sarika', 'smita.n']",29,"['rahul.ys', 'sanjita.s', 'urvi.panchal', 'debosmita.b', 'pawan.mojar', 'joshinirmit', 'sonali.gavkar', 'nikitamittal97', 'aditya.aher', 'jagruti.patil', 'jinku5454', 'neha.hg', 'gandhi.j', 'aniruddh.s', 'bendalneha', 'soureen.g', 'anushkumar', 'urmil1700', 'rohit.vhatkar', 'nikita.us', 'jesal.t', 'tapan.garge', 'rohitkadam702', 'vaishnavimahukar28', None, 'rajas.b', 'arfat_24', 'sarika', 'smita.n']"
89,216,10,126,2,"['rwiebe', 'arturotrevino']",7,"['agrawa56', 'kfindley', 'oabegund', 'lehman25', 'bbaskara', 'ailer', 'wu795']",124,"['ggauthi', 'geyerg', 'wan52', 'akreuter', 'yeager5', 'bsmrdel', 'vwallema', 'btestin14', 'starr21', 'vpope', 'nt230', 'wstolz', 'suhaira97', 'ikobayas', 'yang1206', 'xng', 'lee2370', 'itsmemario', 'conner.swift8', 'eforti', 'jrohman', 'john1886', 'afalkenb', 'tgiazzon', 'justj', 'cmelchin', 'ryanwest1040', 'charlesma423', 'george7elias', 'boninim', 'evdaly', 'jkekre', 'cclapham', 'fischermben', 'landon.glunt', 'mcrees', 'jdanek', 'psumner', 'cbischof', 'rao75', 'kgmcginley', 'nathanmoore', 'angbecker', 'samm', 'sueprasad8214', 'ggolla', 'chanwoo.lee.17', 'amckeska', 'ebehring', 'ryry1644', 'dschull', 'nafandi', 'purduechen2203', 'cartmaster007', 'hyndmanjustin', 'davids19', 'anthonm', 'dgreiwe', 'chiranth7954', 'smit3180', 'jwoon', 'caldwe29', 'shaw108', 'nhdorcy', 'ehonebri', 'shadow66666', 'talon34567', 'huan1146', 'rishiprasadha', 'radhakr3', 'cpiepen', 'jacobglvn', 'jfolkers', 'joshuajkporter', 'agalema1027', 'suran9712', 'akonopa', 'oliver67', 'hess35', 'kskripakaran0810', 'asartor', 'tilley0', 'crhodine', 'mingusnate', 'kjh94425', 'maxwellfra16', 'garret28', 'zjohnson834', 'rhellyer', 'mcclure8', 'nikhilcarneiro4', 'jkueche', 'kruege14', 'albrect', 'nramli', 'ecronin', 'dkilgor', 'heinzt', 'akreilei', 'srasche', 'rsusler', 'mcdona85', 'kknowlto', None, 'river132', 'jskeens', 'yizhizhang', 'selawada', 'dsfgdsfg', 'acostab', 'tthieles', 'khageman', 'kevinodonnell0878', 'lmeehann', 'sknecht', 'goh5', 'kico', 'mccaul', 'rao53', 'muelle77', 'aguyre', 'singh378', 'rileyedelaney', 'athoman']",133,"['ggauthi', 'arturotrevino', 'wan52', 'vwallema', 'btestin14', 'starr21', 'nt230', 'wstolz', 'xng', 'itsmemario', 'conner.swift8', 'eforti', 'afalkenb', 'tgiazzon', 'evdaly', 'jkekre', 'mcrees', 'jdanek', 'psumner', 'cbischof', 'kgmcginley', 'sueprasad8214', 'amckeska', 'nafandi', 'davids19', 'anthonm', 'dgreiwe', 'smit3180', 'lehman25', 'ailer', 'rishiprasadha', 'akonopa', 'hess35', 'tilley0', 'crhodine', 'mingusnate', 'kjh94425', 'mcclure8', 'nikhilcarneiro4', 'srasche', 'rsusler', 'rwiebe', 'river132', 'selawada', 'dsfgdsfg', 'tthieles', 'khageman', 'sknecht', 'goh5', 'muelle77', 'aguyre', 'singh378', 'rileyedelaney', 'geyerg', 'akreuter', 'yeager5', 'bsmrdel', 'vpope', 'suhaira97', 'ikobayas', 'yang1206', 'lee2370', 'jrohman', 'john1886', 'justj', 'cmelchin', 'ryanwest1040', 'charlesma423', 'george7elias', 'boninim', 'cclapham', 'fischermben', 'landon.glunt', 'rao75', 'nathanmoore', 'angbecker', 'samm', 'ggolla', 'chanwoo.lee.17', 'ebehring', 'ryry1644', 'dschull', 'purduechen2203', 'bbaskara', 'cartmaster007', 'hyndmanjustin', 'chiranth7954', 'jwoon', 'oabegund', 'caldwe29', 'shaw108', 'nhdorcy', 'ehonebri', 'shadow66666', 'talon34567', 'huan1146', 'radhakr3', 'cpiepen', 'jacobglvn', 'jfolkers', 'joshuajkporter', 'agalema1027', 'suran9712', 'oliver67', 'kskripakaran0810', 'asartor', 'maxwellfra16', 'garret28', 'zjohnson834', 'rhellyer', 'jkueche', 'kruege14', 'albrect', 'nramli', 'ecronin', 'agrawa56', 'dkilgor', 'heinzt', 'akreilei', 'mcdona85', 'kknowlto', None, 'jskeens', 'yizhizhang', 'acostab', 'kfindley', 'kevinodonnell0878', 'lmeehann', 'kico', 'mccaul', 'wu795', 'rao53', 'athoman']"
91,249,10,12,6,"['kajaldevake30', 'neha10patade', 'shelar.chetan4', 'pranay.kesarkar1', 'roshanpoojari31', 'nandakale98']",3,"['vidushirazdan1308', 'a21shivam', 'ranajay1997']",6,"['rahulkadam7055', 'rishimud', 'dilipramgir', None, 'max_mercury', 'kedar.kulkarni12']",15,"['rahulkadam7055', 'kajaldevake30', 'roshanpoojari31', 'shelar.chetan4', 'vidushirazdan1308', 'dilipramgir', 'nandakale98', None, 'neha10patade', 'a21shivam', 'rishimud', 'ranajay1997', 'pranay.kesarkar1', 'max_mercury', 'kedar.kulkarni12']"
92,13,10,23,9,"['rociosg97', 'marinac1997', 'angelg844', 'carmenvelazquez6', 'henawho', 'moreparaya', 'gines', 'pedrogs12', 'abalro75']",0,[],14,"['mrrayman5', 'marinagonzalezpena10', 'lbh6294', 'saraolivares95', 'mpa102915', None, 'carlosisgg97', 'lolbelram', 'albaortolan', 'bbaquerizo', 'trianatc', 'claracaballero23', 'rgelena3', 'javiersalazarmoreno97']",23,"['saraolivares95', 'mpa102915', 'trianatc', 'javiersalazarmoreno97', 'mrrayman5', 'rociosg97', 'marinac1997', 'angelg844', 'carmenvelazquez6', 'henawho', 'carlosisgg97', 'claracaballero23', 'gines', 'pedrogs12', 'abalro75', 'lbh6294', 'lolbelram', 'albaortolan', None, 'marinagonzalezpena10', 'bbaquerizo', 'moreparaya', 'rgelena3']"
92,81,10,23,9,"['rociosg97', 'marinac1997', 'angelg844', 'carmenvelazquez6', 'henawho', 'moreparaya', 'gines', 'pedrogs12', 'abalro75']",0,[],14,"['mrrayman5', 'marinagonzalezpena10', 'lbh6294', 'saraolivares95', 'mpa102915', None, 'carlosisgg97', 'lolbelram', 'albaortolan', 'bbaquerizo', 'trianatc', 'claracaballero23', 'rgelena3', 'javiersalazarmoreno97']",23,"['saraolivares95', 'mpa102915', 'trianatc', 'javiersalazarmoreno97', 'mrrayman5', 'rociosg97', 'marinac1997', 'angelg844', 'carmenvelazquez6', 'henawho', 'carlosisgg97', 'claracaballero23', 'gines', 'pedrogs12', 'abalro75', 'lbh6294', 'lolbelram', 'albaortolan', None, 'marinagonzalezpena10', 'bbaquerizo', 'moreparaya', 'rgelena3']"
92,60,10,22,9,"['rociosg97', 'marinac1997', 'angelg844', 'carmenvelazquez6', 'henawho', 'moreparaya', 'gines', 'pedrogs12', 'abalro75']",0,[],13,"['mrrayman5', 'marinagonzalezpena10', 'lbh6294', 'saraolivares95', 'mpa102915', None, 'carlosisgg97', 'lolbelram', 'albaortolan', 'bbaquerizo', 'trianatc', 'rgelena3', 'javiersalazarmoreno97']",22,"['lbh6294', 'saraolivares95', 'mpa102915', 'lolbelram', 'albaortolan', 'trianatc', 'javiersalazarmoreno97', None, 'mrrayman5', 'marinagonzalezpena10', 'rociosg97', 'marinac1997', 'angelg844', 'carmenvelazquez6', 'henawho', 'carlosisgg97', 'bbaquerizo', 'moreparaya', 'gines', 'pedrogs12', 'abalro75', 'rgelena3']"
92,252,10,22,9,"['rociosg97', 'marinac1997', 'angelg844', 'carmenvelazquez6', 'henawho', 'moreparaya', 'gines', 'pedrogs12', 'abalro75']",0,[],13,"['nandoroldi', 'franrod.3viso', 'saraolivares95', None, 'mery2anervion', 'zacagonzalez96', 'carlosisgg97', 'albaortolan', 'trianatc', 'jomaes1997', 'elenarg', 'martin10p', 'pachecomyri']",22,"['saraolivares95', 'albaortolan', 'trianatc', 'elenarg', None, 'martin10p', 'nandoroldi', 'franrod.3viso', 'rociosg97', 'marinac1997', 'angelg844', 'carmenvelazquez6', 'henawho', 'carlosisgg97', 'mery2anervion', 'zacagonzalez96', 'moreparaya', 'jomaes1997', 'gines', 'pedrogs12', 'abalro75', 'pachecomyri']"
92,304,10,22,9,"['rociosg97', 'marinac1997', 'angelg844', 'carmenvelazquez6', 'henawho', 'moreparaya', 'gines', 'pedrogs12', 'abalro75']",0,[],13,"['marinagonzalezpena10', 'franrod.3viso', 'garciarivas97', None, 'mery2anervion', 'javiersalazarmoreno97', 'bbaquerizo', 'carlosclaragg', 'trianatc', 'pachecomyri', 'elenarg', 'martin10p', 'miguelr.r.galan']",22,"['trianatc', 'elenarg', 'javiersalazarmoreno97', 'martin10p', 'miguelr.r.galan', None, 'marinagonzalezpena10', 'franrod.3viso', 'rociosg97', 'marinac1997', 'angelg844', 'carmenvelazquez6', 'henawho', 'mery2anervion', 'bbaquerizo', 'carlosclaragg', 'moreparaya', 'gines', 'pedrogs12', 'abalro75', 'garciarivas97', 'pachecomyri']"
92,323,10,22,9,"['rociosg97', 'marinac1997', 'angelg844', 'carmenvelazquez6', 'henawho', 'moreparaya', 'gines', 'pedrogs12', 'abalro75']",0,[],13,"['nandoroldi', 'franrod.3viso', 'saraolivares95', None, 'mery2anervion', 'zacagonzalez96', 'carlosisgg97', 'albaortolan', 'trianatc', 'jomaes1997', 'elenarg', 'martin10p', 'pachecomyri']",22,"['saraolivares95', 'albaortolan', 'trianatc', 'elenarg', None, 'martin10p', 'nandoroldi', 'franrod.3viso', 'rociosg97', 'marinac1997', 'angelg844', 'carmenvelazquez6', 'henawho', 'carlosisgg97', 'mery2anervion', 'zacagonzalez96', 'moreparaya', 'jomaes1997', 'gines', 'pedrogs12', 'abalro75', 'pachecomyri']"
92,226,10,21,9,"['rociosg97', 'marinac1997', 'angelg844', 'carmenvelazquez6', 'henawho', 'moreparaya', 'gines', 'pedrogs12', 'abalro75']",0,[],12,"['mrrayman5', 'marinagonzalezpena10', 'lbh6294', 'saraolivares95', None, 'carlosisgg97', 'lolbelram', 'albaortolan', 'bbaquerizo', 'claracaballero23', 'rgelena3', 'javiersalazarmoreno97']",21,"['lbh6294', 'saraolivares95', 'lolbelram', 'albaortolan', 'javiersalazarmoreno97', None, 'mrrayman5', 'marinagonzalezpena10', 'rociosg97', 'marinac1997', 'angelg844', 'carmenvelazquez6', 'henawho', 'carlosisgg97', 'bbaquerizo', 'moreparaya', 'claracaballero23', 'gines', 'pedrogs12', 'abalro75', 'rgelena3']"
92,345,10,7,1,['carmenvelazquez6'],8,"['rociosg97', 'marinac1997', 'angelg844', 'henawho', 'moreparaya', 'gines', 'pedrogs12', 'abalro75']",6,"['zacagonzalez96', None, 'carlosisgg97', 'jomaes1997', 'elenarg', 'martin10p']",15,"['rociosg97', 'marinac1997', 'angelg844', 'carmenvelazquez6', 'henawho', 'zacagonzalez96', 'carlosisgg97', None, 'moreparaya', 'jomaes1997', 'gines', 'pedrogs12', 'abalro75', 'elenarg', 'martin10p']"
93,267,10,61,1,['parkita'],8,"['mohamedmsaad66', 'mohamed.h.mamdouh', 'mhesham2018', 'basem.ali95', 'ahmedraouf', 'bakr', 'mohamed.ah.omran', 'ahmeis']",60,"['raquelz48', 'carlosmata', 'dragonswrath', 'infinity444phi', 'cesarin159', 'aguade03', 'jisaucedo', 'drhodges', 'jarrah_5011', 'ivan07guerrero', 'gisel.fregoso', 'jgonza4643', 'jmckenzie', 'teck60osc', 'ahmad.abdulraheem', 'ponchitofam', 'joejones143', 'kirito', 'crojas7', 'hehasan', 'minjares.jesus.ths', 'vflombrana', 'osacosta', 'koagbita', 'asolis21', 'nsimla', 'oscarelozano', 'crysdbz.22', 'willbouns', 'alexmartinezzero', 'contiveros7', 'laarvizu', 'meni72', 'cgmartan', 'jorge1799', 'jscordero1', 'reyesmiguel888', None, 'anieto5', 'alanrayharr', 'daniboy12', 'diegoerickherrera', 'dterrazas3', 'cmflores10', 'fvaldezroman', 'dvillalva21', 'eliot9700', 'usuarez11', 'landa.esteban', 'jalujan8', 'xbaca', 'ivan0703', 'lrburgueno', 'lmelend1', 'fdo.glz', 'amarin2997', 'cynthia.oaxaca3', 'mmedina340', 'aramirez64', 'icasper2']",69,"['raquelz48', 'mohamedmsaad66', 'aguade03', 'jisaucedo', 'parkita', 'gisel.fregoso', 'jgonza4643', 'jmckenzie', 'ahmad.abdulraheem', 'ponchitofam', 'kirito', 'minjares.jesus.ths', 'vflombrana', 'osacosta', 'asolis21', 'ahmeis', 'alexmartinezzero', 'contiveros7', 'mohamed.h.mamdouh', 'cgmartan', 'jorge1799', 'reyesmiguel888', 'anieto5', 'diegoerickherrera', 'cmflores10', 'dvillalva21', 'eliot9700', 'usuarez11', 'ivan0703', 'lrburgueno', 'fvaldezroman', 'cynthia.oaxaca3', 'carlosmata', 'dragonswrath', 'infinity444phi', 'cesarin159', 'drhodges', 'jarrah_5011', 'ivan07guerrero', 'teck60osc', 'joejones143', 'crojas7', 'hehasan', 'koagbita', 'nsimla', 'basem.ali95', 'ahmedraouf', 'mohamed.ah.omran', 'oscarelozano', 'crysdbz.22', 'willbouns', 'laarvizu', 'meni72', 'mhesham2018', 'jscordero1', 'bakr', None, 'alanrayharr', 'daniboy12', 'dterrazas3', 'landa.esteban', 'jalujan8', 'xbaca', 'lmelend1', 'fdo.glz', 'amarin2997', 'mmedina340', 'aramirez64', 'icasper2']"
93,192,10,14,7,"['mohamedmsaad66', 'mohamed.h.mamdouh', 'basem.ali95', 'ahmedraouf', 'bakr', 'mohamed.ah.omran', 'ahmeis']",2,"['mhesham2018', 'parkita']",7,"['gohari95', 'asmaa_abdelmegeed.', 'ahmed_raafat', 'ahmed_moustafa_94', 'serag', 'omarazooz', None]",16,"['mohamedmsaad66', 'mohamed.h.mamdouh', 'ahmed_raafat', 'mhesham2018', 'serag', 'parkita', 'bakr', None, 'gohari95', 'asmaa_abdelmegeed.', 'basem.ali95', 'ahmed_moustafa_94', 'ahmedraouf', 'omarazooz', 'mohamed.ah.omran', 'ahmeis']"
93,269,10,14,7,"['mohamedmsaad66', 'mohamed.h.mamdouh', 'mhesham2018', 'basem.ali95', 'ahmedraouf', 'bakr', 'mohamed.ah.omran']",2,"['ahmeis', 'parkita']",7,"['elgohari95', 'asmaa_abdelmegeed.', 'mohamedsaleh106', 'waheed.ahmed12', 'islam_hisham', None, 'kareem.men3em']",16,"['elgohari95', 'kareem.men3em', 'waheed.ahmed12', 'mohamedmsaad66', 'mohamed.h.mamdouh', 'mhesham2018', 'parkita', 'islam_hisham', 'bakr', None, 'asmaa_abdelmegeed.', 'basem.ali95', 'ahmedraouf', 'mohamedsaleh106', 'mohamed.ah.omran', 'ahmeis']"
95,7,10,18,1,['e78yui'],8,"['ferrario.andrea', 'chakraborty.84', 'bpitcla', 'ascherr', 'pvlams', 'earchambault', 'nsadowski', 'ruining2']",17,"['tzt74', 'rqm5425', 'hkz5032', 'cjw5647', 'saa5966', 'mikeyu1997', 'jaw6297', 'jmw6448', 'fjj5032', 'kxz172', 'sxn266', 'cannansong', 'rsc5261', 'mxl5509', None, 'yvy5250', 'jmc7066']",26,"['jmc7066', 'ferrario.andrea', 'hkz5032', 'mikeyu1997', 'jaw6297', 'earchambault', 'pvlams', 'kxz172', 'e78yui', 'rsc5261', 'mxl5509', None, 'yvy5250', 'jmw6448', 'saa5966', 'tzt74', 'rqm5425', 'chakraborty.84', 'cjw5647', 'bpitcla', 'fjj5032', 'ascherr', 'sxn266', 'nsadowski', 'cannansong', 'ruining2']"
95,5,10,9,3,"['ascherr', 'bpitcla', 'ruining2']",6,"['ferrario.andrea', 'chakraborty.84', 'earchambault', 'pvlams', 'nsadowski', 'e78yui']",6,"[None, 'khhsu0724', 'yarbrough.josiah', 'reuben.mathew1995', 'marcjaikissoon', 'solomontolu5']",15,"['ruining2', 'ferrario.andrea', 'chakraborty.84', None, 'khhsu0724', 'yarbrough.josiah', 'ascherr', 'pvlams', 'earchambault', 'reuben.mathew1995', 'nsadowski', 'marcjaikissoon', 'e78yui', 'solomontolu5', 'bpitcla']"
96,132,10,7,5,"['fredhills', 'xibfeng', 'hamamines', 'ch630183', 'mccoombs']",4,"['rambrose', 'franpastor', 'dressler.reid', 'bauer96']",2,"['albd', None]",11,"['fredhills', 'xibfeng', 'hamamines', None, 'franpastor', 'bauer96', 'albd', 'dressler.reid', 'ch630183', 'rambrose', 'mccoombs']"
97,303,9,9,7,"['sapir', 'bar.zamed', 'jennyb1130', 'dimasin29.5', 'salea656', 'avirammm5', 'roby.zeevi']",1,['lyle'],2,"['heftsirag1982', None]",10,"['bar.zamed', 'jennyb1130', 'heftsirag1982', 'dimasin29.5', None, 'lyle', 'salea656', 'roby.zeevi', 'avirammm5', 'sapir']"
98,248,9,11,7,"['rajeev.moghe', 'sandesh.jain', 'prajaktakolekar', 'shreyagupta0807', 'rajvee.theultimate', 'amey.mahadik', 'darshana.mehta']",1,['prutha.atre'],4,"[None, 'kapil1410', 'anchal.jaiswal', 'sugandhanisrad1997']",12,"['rajeev.moghe', 'kapil1410', 'prajaktakolekar', 'shreyagupta0807', 'rajvee.theultimate', 'sugandhanisrad1997', None, 'sandesh.jain', 'prutha.atre', 'amey.mahadik', 'darshana.mehta', 'anchal.jaiswal']"
98,342,9,11,7,"['rajeev.moghe', 'sandesh.jain', 'prajaktakolekar', 'shreyagupta0807', 'rajvee.theultimate', 'amey.mahadik', 'darshana.mehta']",1,['prutha.atre'],4,"[None, 'kapil1410', 'anchal.jaiswal', 'sugandhanisrad1997']",12,"['rajeev.moghe', 'kapil1410', 'prajaktakolekar', 'shreyagupta0807', 'rajvee.theultimate', 'sugandhanisrad1997', None, 'sandesh.jain', 'prutha.atre', 'amey.mahadik', 'darshana.mehta', 'anchal.jaiswal']"
99,232,9,10,8,"['kramer73', 'rodri576', 'jake9903man', 'vollstedtjoseph', 'sam.mattingly57', 'christyt', 'crdieterlen', 'clark472']",0,[],2,"['flore159', None]",10,"['kramer73', 'rodri576', 'jake9903man', 'vollstedtjoseph', None, 'sam.mattingly57', 'flore159', 'crdieterlen', 'christyt', 'clark472']"
99,295,9,9,8,"['kramer73', 'rodri576', 'jake9903man', 'vollstedtjoseph', 'sam.mattingly57', 'christyt', 'crdieterlen', 'clark472']",0,[],1,[None],9,"['kramer73', 'rodri576', 'jake9903man', 'vollstedtjoseph', None, 'sam.mattingly57', 'crdieterlen', 'christyt', 'clark472']"
100,93,9,22,8,"['ajayphroust.ay', 'priyu0964', 'afsarkhan160', 'mani.mandude', 'rockey.anths', 'rohitnair77880', 'aadi', 'vixsnair']",0,[],14,"['mallickshrutik', 'shindedeepak129', 'sheetalwings97', 'kaustubhvaishampayan', 'anishnair1996', 'aa9858203050', 'smahamulkar1013', 'umeshlohote', 'arthaya.koyande28', 'shubham.yelange', 'shreyahonagekar04', 'patilprasad0123', None, 'zeevd19']",22,"['ajayphroust.ay', 'priyu0964', 'shindedeepak129', 'sheetalwings97', 'kaustubhvaishampayan', 'aa9858203050', 'mani.mandude', 'arthaya.koyande28', 'rohitnair77880', 'aadi', 'shreyahonagekar04', None, 'umeshlohote', 'vixsnair', 'mallickshrutik', 'afsarkhan160', 'anishnair1996', 'smahamulkar1013', 'rockey.anths', 'shubham.yelange', 'patilprasad0123', 'zeevd19']"
100,315,9,22,8,"['ajayphroust.ay', 'priyu0964', 'afsarkhan160', 'mani.mandude', 'rockey.anths', 'rohitnair77880', 'aadi', 'vixsnair']",0,[],14,"['mallickshrutik', 'shindedeepak129', 'sheetalwings97', 'kaustubhvaishampayan', 'anishnair1996', 'aa9858203050', 'smahamulkar1013', 'umeshlohote', 'arthaya.koyande28', 'shubham.yelange', 'shreyahonagekar04', 'patilprasad0123', None, 'zeevd19']",22,"['ajayphroust.ay', 'priyu0964', 'shindedeepak129', 'sheetalwings97', 'kaustubhvaishampayan', 'aa9858203050', 'mani.mandude', 'arthaya.koyande28', 'rohitnair77880', 'aadi', 'shreyahonagekar04', None, 'umeshlohote', 'vixsnair', 'mallickshrutik', 'afsarkhan160', 'anishnair1996', 'smahamulkar1013', 'rockey.anths', 'shubham.yelange', 'patilprasad0123', 'zeevd19']"
101,311,9,50,7,"['rahulkadam7055', 'priyankakamble', 'sohammhas', 'ashu0497', 'aloksardesai97', 'rohanotari21', 'dilipramgir']",1,['susmeetsukte'],43,"['akankshachandoskar1198', 'sanket.r.makwana', 'sanjit', 'aishwaryahiwale97', 'sonalikharade5', 'rahulbirwadkar123', 'bhai0045', 'rushikeshkharat18', 'anujmhatre43', 'ajinkyasoman', 'anujmdeorukhkar', 'pranalikothekar5', 'prathameshpatle13', 'rishimud', 'salvir481', 'durgeshthorat4', 'prajaktathorat24', 'gauribahatkar', 'rushikeshrane27', 'arpitgodbole7', 'abhishektoraskar412', 'runakshi97', 'owais11', 'seemasaini282', 'joishersweta17695', 'sourabhkothari16', 'ovrale', 'sukanyajadhav1997', 'rasikapednekar20', 'siddhesh.soyane', 'pjkarmokar', 'aditiramadwar', None, 'divyassonawane', 'kajalbhoite04', 'nikwade.damini95', 'arpitakudesia3011', 'aquibansari12377', 'kalyanisahib96', 'rakeshpatil9271', 'ashnavirdikar.av', 'zainabshah181997', 'kedar.kulkarni12']",51,"['akankshachandoskar1198', 'sanket.r.makwana', 'sanjit', 'aishwaryahiwale97', 'sonalikharade5', 'rahulbirwadkar123', 'bhai0045', 'dilipramgir', 'rushikeshkharat18', 'anujmhatre43', 'ajinkyasoman', 'anujmdeorukhkar', 'pranalikothekar5', 'prathameshpatle13', 'priyankakamble', 'rishimud', 'ashu0497', 'aloksardesai97', 'salvir481', 'durgeshthorat4', 'susmeetsukte', 'prajaktathorat24', 'gauribahatkar', 'rushikeshrane27', 'rahulkadam7055', 'arpitgodbole7', 'abhishektoraskar412', 'runakshi97', 'owais11', 'seemasaini282', 'joishersweta17695', 'sourabhkothari16', 'ovrale', 'sukanyajadhav1997', 'rasikapednekar20', 'siddhesh.soyane', 'pjkarmokar', 'aditiramadwar', 'rohanotari21', None, 'divyassonawane', 'kajalbhoite04', 'nikwade.damini95', 'arpitakudesia3011', 'aquibansari12377', 'sohammhas', 'kalyanisahib96', 'rakeshpatil9271', 'ashnavirdikar.av', 'zainabshah181997', 'kedar.kulkarni12']"
101,313,9,22,1,['ashu0497'],7,"['rahulkadam7055', 'priyankakamble', 'sohammhas', 'aloksardesai97', 'susmeetsukte', 'rohanotari21', 'dilipramgir']",21,"['inamdarshreyas5', 'nanomems226', 'omimore24', 'rahulbirwadkar123', 'rutujakamthe', 'sagar21', 'saritav.9600', 'swastik2', 'pranav123', 'deep.patel', 'prachi.mujawar', 'piyamodhve', 'nageshjaiswar11', 'arushi.yadav', 'shantanu123', 'akshaybhore7', None, 'verma_34dh', 'mayurpashte97', 'tanvipalande', 'max_mercury']",29,"['inamdarshreyas5', 'rahulkadam7055', 'nanomems226', 'nageshjaiswar11', 'omimore24', 'rahulbirwadkar123', 'arushi.yadav', 'rutujakamthe', 'shantanu123', 'akshaybhore7', 'max_mercury', 'rohanotari21', 'dilipramgir', None, 'verma_34dh', 'mayurpashte97', 'sagar21', 'saritav.9600', 'swastik2', 'priyankakamble', 'sohammhas', 'ashu0497', 'aloksardesai97', 'pranav123', 'deep.patel', 'tanvipalande', 'prachi.mujawar', 'susmeetsukte', 'piyamodhve']"
101,312,9,19,1,['susmeetsukte'],7,"['rahulkadam7055', 'priyankakamble', 'sohammhas', 'ashu0497', 'aloksardesai97', 'rohanotari21', 'dilipramgir']",18,"['rms.maurya21', 'owais11', 'hsnnalwala7', 'priyankakunde22', 'bhandarepranay9208', 'rishimud', 'shripal17', 'pnrs.pratik', 'kaushiksawant93', 'siddhesh.soyane', 'prachi.mujawar', 'adisawant333', 'pranjalijadhav0911', 'ardalvi85', 'rajashree.pimputkar', None, 'max_mercury', 'divyassonawane']",26,"['rahulkadam7055', 'owais11', 'hsnnalwala7', 'bhandarepranay9208', 'pnrs.pratik', 'kaushiksawant93', 'siddhesh.soyane', 'adisawant333', 'pranjalijadhav0911', 'ardalvi85', 'rohanotari21', 'dilipramgir', None, 'divyassonawane', 'rms.maurya21', 'priyankakunde22', 'priyankakamble', 'sohammhas', 'ashu0497', 'aloksardesai97', 'rishimud', 'prachi.mujawar', 'susmeetsukte', 'rajashree.pimputkar', 'shripal17', 'max_mercury']"
101,246,9,17,4,"['priyankakamble', 'ashu0497', 'aloksardesai97', 'sohammhas']",4,"['rohanotari21', 'rahulkadam7055', 'dilipramgir', 'susmeetsukte']",13,"['abhishektoraskar412', 'prathameshpatle13', 'priyankakunde22', 'shraddhagadankush1998', 'owais11', 'siddhant8291', 'ankitagamare2218', 'saketnaik', None, 'mayur.manve4', 'aritramondal151', 'arshan.ansari002', 'msawant869']",21,"['rahulkadam7055', 'owais11', 'shraddhagadankush1998', 'abhishektoraskar412', 'rohanotari21', 'dilipramgir', None, 'prathameshpatle13', 'priyankakunde22', 'priyankakamble', 'sohammhas', 'ashu0497', 'aloksardesai97', 'ankitagamare2218', 'siddhant8291', 'saketnaik', 'mayur.manve4', 'aritramondal151', 'susmeetsukte', 'arshan.ansari002', 'msawant869']"
101,245,9,12,1,['rohanotari21'],7,"['rahulkadam7055', 'priyankakamble', 'sohammhas', 'ashu0497', 'aloksardesai97', 'susmeetsukte', 'dilipramgir']",11,"['anujmdeorukhkar', 'gabru1803', 'owais11', 'javedptl', 'ankitagamare2218', 'sukanyajadhav1997', 'salvir481', 'rohit.elawadekar333', 'rajashree.pimputkar', 'arshan.ansari002', None]",19,"['rahulkadam7055', 'gabru1803', 'owais11', 'sukanyajadhav1997', 'rohanotari21', 'dilipramgir', None, 'anujmdeorukhkar', 'priyankakamble', 'sohammhas', 'ashu0497', 'aloksardesai97', 'javedptl', 'ankitagamare2218', 'salvir481', 'rohit.elawadekar333', 'susmeetsukte', 'rajashree.pimputkar', 'arshan.ansari002']"
101,249,9,12,2,"['rahulkadam7055', 'dilipramgir']",6,"['priyankakamble', 'sohammhas', 'ashu0497', 'aloksardesai97', 'susmeetsukte', 'rohanotari21']",10,"['kedar.kulkarni12', 'kajaldevake30', 'neha10patade', 'roshanpoojari31', 'rishimud', 'pranay.kesarkar1', 'shelar.chetan4', None, 'max_mercury', 'nandakale98']",18,"['rahulkadam7055', 'kajaldevake30', 'rohanotari21', 'dilipramgir', 'shelar.chetan4', 'roshanpoojari31', 'nandakale98', None, 'neha10patade', 'priyankakamble', 'sohammhas', 'ashu0497', 'aloksardesai97', 'rishimud', 'pranay.kesarkar1', 'susmeetsukte', 'max_mercury', 'kedar.kulkarni12']"
101,314,9,10,1,['aloksardesai97'],7,"['rahulkadam7055', 'priyankakamble', 'sohammhas', 'ashu0497', 'susmeetsukte', 'rohanotari21', 'dilipramgir']",9,"['shantanupanigrahi98', 'pranav123', None, 'chetushirke', 'rutujakamthe', 'max_mercury', 'akshatask', 'mayanksamar786', 'sarika_bukkawar']",17,"['rahulkadam7055', 'shantanupanigrahi98', 'priyankakamble', 'sohammhas', 'ashu0497', 'aloksardesai97', 'pranav123', None, 'chetushirke', 'rutujakamthe', 'susmeetsukte', 'max_mercury', 'rohanotari21', 'dilipramgir', 'akshatask', 'mayanksamar786', 'sarika_bukkawar']"
101,251,9,9,1,['susmeetsukte'],7,"['rahulkadam7055', 'priyankakamble', 'sohammhas', 'ashu0497', 'aloksardesai97', 'rohanotari21', 'dilipramgir']",8,"['arpitgodbole7', None, 'sonalikharade5', 'rasikapednekar20', 'iammayuri3', 'ashnavirdikar.av', 'dshantanu2902', 'akshatask']",16,"['rahulkadam7055', 'arpitgodbole7', 'priyankakamble', 'sohammhas', 'ashu0497', 'aloksardesai97', 'sonalikharade5', None, 'rasikapednekar20', 'iammayuri3', 'ashnavirdikar.av', 'susmeetsukte', 'dshantanu2902', 'rohanotari21', 'dilipramgir', 'akshatask']"
102,158,9,69,8,"['marguiitar', 'luciag', 'pablitoelfantasma', 'antoniocaceres', 'jesusestevez1997', 'ramperrub', 'pablomartinhigueras', 'xandar']",0,[],61,"['miguelangelgv', 'hikaru', 'ancap', 'ionemanuelmoralesrosales', 'adavidsubires', 'gonzalogbb', 'fabhuecas9', 'cristinitaa23', 'lluis', 'lauramaz', 'eletorres', 'franciscojaviern1997', 'aloptor97', 'juanalejandro.delatorre.gonzalez', 'isabellopezcasas', 'crisalle', 'pedromf', 'davidgruano', 'lamberto', 'carmengomezh16', 'juaniandujar', 'joseantoniocuestareina', 'theresa5000', 'rokitocri', 'kiarahervella', 'joaquinhernandez', 'karlosjusus', 'espi', 'danielserrano', 'eduardito', 'ruben29', 'amontesplaza', 'raulghuelma', 'adiaz97', 'claaudiaalvarez2', 'juanfran', 'mariofnavarro', 'pablolgoso', 'robee97', 'pedrojjs97', 'josesoto', 'albertodellop', 'belen.moralesvega', 'nanojuanjo', 'jmleyva', 'guidoah', 'lucigd96', 'carlosbarbero', 'fernandodiaz', 'rafaelleon', 'mcdyre', 'jpnaviog', 'mariadelman96', 'mozom96', 'tatifersanchez', None, 'enrique97', 'ricardodavid', 'jaigro97', 'mariatirado', 'abignu']",69,"['marguiitar', 'miguelangelgv', 'hikaru', 'ancap', 'ionemanuelmoralesrosales', 'adavidsubires', 'gonzalogbb', 'fabhuecas9', 'cristinitaa23', 'lluis', 'lauramaz', 'eletorres', 'luciag', 'franciscojaviern1997', 'aloptor97', 'juanalejandro.delatorre.gonzalez', 'isabellopezcasas', 'crisalle', 'pedromf', 'davidgruano', 'lamberto', 'carmengomezh16', 'juaniandujar', 'joseantoniocuestareina', 'theresa5000', 'rokitocri', 'kiarahervella', 'joaquinhernandez', 'karlosjusus', 'espi', 'danielserrano', 'eduardito', 'ruben29', 'amontesplaza', 'raulghuelma', 'adiaz97', 'claaudiaalvarez2', 'juanfran', 'mariofnavarro', 'pablolgoso', 'robee97', 'pedrojjs97', 'josesoto', 'albertodellop', 'belen.moralesvega', 'nanojuanjo', 'jmleyva', 'pablitoelfantasma', 'guidoah', 'lucigd96', 'carlosbarbero', 'fernandodiaz', 'pablomartinhigueras', 'xandar', 'rafaelleon', 'mcdyre', 'jpnaviog', 'mariadelman96', 'jesusestevez1997', 'mozom96', 'tatifersanchez', None, 'enrique97', 'ricardodavid', 'jaigro97', 'mariatirado', 'antoniocaceres', 'ramperrub', 'abignu']"
103,85,9,8,2,"['carleydavis', 'ppawelski']",6,"['hermanakagla', 'rjdavis0928', 'jjdemiguel', 'brunnagomess123', 'mcgiesoi', 'j1204jason']",6,"['jamesdoty', 'mmei', 'ksie', 'bplamondon', None, 'stabatabaei']",14,"['hermanakagla', 'rjdavis0928', 'jjdemiguel', 'ppawelski', 'jamesdoty', 'mmei', 'ksie', 'brunnagomess123', 'mcgiesoi', 'carleydavis', 'bplamondon', 'j1204jason', None, 'stabatabaei']"
105,208,9,72,4,"['ramos39', 'samt.buller', 'treinha', 'asartor7']",4,"['ahmed66', 'camach10', 'li1853', 'michaelgi962']",68,"['alexdobbins98', 'vpope', 'nt230', 'ikobayas', 'wstolz', 'mnishat', 'ksjolund', 'justj', 'ryanwest1040', 'cmelchin', 'george7elias', 'john1886', 'rileyedelaney', 'cclapham', 'evdaly', 'jkekre', 'fischermben', 'jbartlin', 'mcrees', 'psumner', 'buck17', 'nathanmoore', 'angbecker', 'samm', 'cputt', 'lise_lpz', 'canadaman87', 'dschull', 'anthonm', 'enadler', 'hkohart', 'dgreiwe', 'htorsina', 'jstalbaum', 'shadow66666', 'talon34567', 'jfolkers', 'joshuajkporter', 'hess35', 'kskripakaran0810', 'crhodine', 'nriaziat', 'mingusnate', 'jswetlik', 'mcclure8', 'nikhilcarneiro4', 'kkamiya', 'kruege14', 'albrect', 'heinzt', 'srasche', 'nggoodie98', 'rsusler', 'imran3', 'kknowlto', 'nbitner', None, 'jskeens', 'jklaben', 'khageman', 'inormile', 'lmeehann', 'sknecht', 'kico', 'yhoashi', 'evandaele3', 'rao53', 'rice125']",76,"['alexdobbins98', 'ramos39', 'vpope', 'nt230', 'ahmed66', 'ikobayas', 'wstolz', 'mnishat', 'li1853', 'ksjolund', 'justj', 'ryanwest1040', 'cmelchin', 'george7elias', 'john1886', 'rileyedelaney', 'cclapham', 'evdaly', 'jkekre', 'fischermben', 'jbartlin', 'mcrees', 'psumner', 'buck17', 'asartor7', 'nathanmoore', 'angbecker', 'samm', 'cputt', 'lise_lpz', 'camach10', 'canadaman87', 'dschull', 'treinha', 'michaelgi962', 'anthonm', 'enadler', 'hkohart', 'dgreiwe', 'htorsina', 'jstalbaum', 'shadow66666', 'talon34567', 'jfolkers', 'joshuajkporter', 'samt.buller', 'hess35', 'kskripakaran0810', 'crhodine', 'nriaziat', 'mingusnate', 'jswetlik', 'mcclure8', 'nikhilcarneiro4', 'kkamiya', 'kruege14', 'albrect', 'heinzt', 'srasche', 'nggoodie98', 'rsusler', 'imran3', 'kknowlto', 'nbitner', None, 'jskeens', 'jklaben', 'khageman', 'inormile', 'lmeehann', 'sknecht', 'kico', 'yhoashi', 'evandaele3', 'rao53', 'rice125']"
106,17,9,10,8,"['jesasa1', 'juanfran974', 'adrrommun', 'beatrizsp', 'francarpio96', 'ireparsi', 'anthongomez97', 'josecarlos']",0,[],2,"[None, 'luiscamu']",10,"['jesasa1', 'juanfran974', 'adrrommun', 'beatrizsp', 'francarpio96', 'ireparsi', 'luiscamu', 'anthongomez97', 'josecarlos', None]"
106,138,9,10,8,"['jesasa1', 'juanfran974', 'adrrommun', 'beatrizsp', 'francarpio96', 'ireparsi', 'anthongomez97', 'josecarlos']",0,[],2,"[None, 'luiscamu']",10,"['jesasa1', 'juanfran974', 'adrrommun', 'beatrizsp', 'francarpio96', 'ireparsi', 'luiscamu', 'anthongomez97', 'josecarlos', None]"
106,143,9,10,8,"['jesasa1', 'juanfran974', 'adrrommun', 'beatrizsp', 'francarpio96', 'ireparsi', 'anthongomez97', 'josecarlos']",0,[],2,"[None, 'luiscamu']",10,"['jesasa1', 'juanfran974', 'adrrommun', 'beatrizsp', 'francarpio96', 'ireparsi', 'luiscamu', 'anthongomez97', 'josecarlos', None]"
107,273,9,7,4,"['maximelemieuxtanguay', 'trevor.tartaglia', 'jonah.mauxion', 'alexis.perez183']",4,"['dpayne7', 'arturocastro94', 'andrea.masili', 'lgnbdnr']",3,"[None, 'bianca11', 'elie_9742']",11,"['andrea.masili', 'bianca11', 'arturocastro94', 'trevor.tartaglia', 'jonah.mauxion', 'elie_9742', 'dpayne7', 'maximelemieuxtanguay', None, 'alexis.perez183', 'lgnbdnr']"
108,86,9,12,8,"['jesusvg97', 'olgajimenez.ojn', 'elenavilchez3', 'martaveegas', 'marina17', 'irinamezquita', 'angelamgodoy7', 'elenams1997']",0,[],4,"['romero', None, 'andrea.crod96', 'pacocf96']",12,"['olgajimenez.ojn', 'martaveegas', 'angelamgodoy7', None, 'elenams1997', 'jesusvg97', 'romero', 'elenavilchez3', 'pacocf96', 'andrea.crod96', 'marina17', 'irinamezquita']"
108,41,9,10,8,"['jesusvg97', 'olgajimenez.ojn', 'elenavilchez3', 'martaveegas', 'marina17', 'irinamezquita', 'angelamgodoy7', 'elenams1997']",0,[],2,"['romero', None]",10,"['jesusvg97', 'olgajimenez.ojn', 'elenavilchez3', 'romero', 'martaveegas', 'marina17', 'irinamezquita', 'angelamgodoy7', None, 'elenams1997']"
108,87,9,10,8,"['jesusvg97', 'olgajimenez.ojn', 'elenavilchez3', 'martaveegas', 'marina17', 'irinamezquita', 'angelamgodoy7', 'elenams1997']",0,[],2,"[None, 'andrea.crod96']",10,"['jesusvg97', 'olgajimenez.ojn', 'elenavilchez3', 'martaveegas', 'andrea.crod96', 'marina17', 'irinamezquita', 'angelamgodoy7', None, 'elenams1997']"
108,227,9,10,8,"['jesusvg97', 'olgajimenez.ojn', 'elenavilchez3', 'martaveegas', 'marina17', 'irinamezquita', 'angelamgodoy7', 'elenams1997']",0,[],2,"[None, 'andrea.crod96']",10,"['jesusvg97', 'olgajimenez.ojn', 'elenavilchez3', 'martaveegas', 'andrea.crod96', 'marina17', 'irinamezquita', 'angelamgodoy7', None, 'elenams1997']"
108,44,9,9,7,"['olgajimenez.ojn', 'elenavilchez3', 'martaveegas', 'marina17', 'irinamezquita', 'angelamgodoy7', 'elenams1997']",1,['jesusvg97'],2,"['romero', None]",10,"['jesusvg97', 'olgajimenez.ojn', 'elenavilchez3', 'romero', 'martaveegas', 'marina17', 'irinamezquita', 'angelamgodoy7', None, 'elenams1997']"
108,62,9,9,7,"['olgajimenez.ojn', 'elenavilchez3', 'martaveegas', 'marina17', 'irinamezquita', 'angelamgodoy7', 'elenams1997']",1,['jesusvg97'],2,"['romero', None]",10,"['jesusvg97', 'olgajimenez.ojn', 'elenavilchez3', 'romero', 'martaveegas', 'marina17', 'irinamezquita', 'angelamgodoy7', None, 'elenams1997']"
108,88,9,6,5,"['olgajimenez.ojn', 'elenavilchez3', 'marina17', 'irinamezquita', 'elenams1997']",3,"['jesusvg97', 'angelamgodoy7', 'martaveegas']",1,[None],9,"['jesusvg97', 'olgajimenez.ojn', 'elenavilchez3', 'martaveegas', 'marina17', 'irinamezquita', 'angelamgodoy7', None, 'elenams1997']"
111,246,9,17,7,"['shraddhagadankush1998', 'siddhant8291', 'ankitagamare2218', 'saketnaik', 'mayur.manve4', 'arshan.ansari002', 'msawant869']",1,['gabru1803'],10,"['abhishektoraskar412', 'prathameshpatle13', 'priyankakunde22', 'priyankakamble', 'owais11', 'sohammhas', 'ashu0497', 'aloksardesai97', 'aritramondal151', None]",18,"['gabru1803', 'shraddhagadankush1998', 'owais11', 'abhishektoraskar412', None, 'prathameshpatle13', 'priyankakunde22', 'priyankakamble', 'sohammhas', 'siddhant8291', 'ankitagamare2218', 'saketnaik', 'ashu0497', 'aloksardesai97', 'mayur.manve4', 'aritramondal151', 'arshan.ansari002', 'msawant869']"
111,245,9,12,3,"['arshan.ansari002', 'gabru1803', 'ankitagamare2218']",5,"['shraddhagadankush1998', 'siddhant8291', 'saketnaik', 'mayur.manve4', 'msawant869']",9,"['anujmdeorukhkar', 'owais11', 'javedptl', 'sukanyajadhav1997', 'salvir481', 'rohit.elawadekar333', 'rajashree.pimputkar', 'rohanotari21', None]",17,"['gabru1803', 'shraddhagadankush1998', 'owais11', 'sukanyajadhav1997', 'rohanotari21', None, 'anujmdeorukhkar', 'siddhant8291', 'ankitagamare2218', 'saketnaik', 'javedptl', 'mayur.manve4', 'salvir481', 'rohit.elawadekar333', 'rajashree.pimputkar', 'arshan.ansari002', 'msawant869']"
114,321,8,9,7,"['markfds0712', 'adityachachad', 'yashivinz', 'dalvi.mahadev33', 'mikhailppinto2828', 'swapnaja73', 'ayushibhtngr96']",0,[],2,"['sebin.bc', None]",9,"['sebin.bc', 'mikhailppinto2828', 'swapnaja73', None, 'markfds0712', 'adityachachad', 'yashivinz', 'dalvi.mahadev33', 'ayushibhtngr96']"
115,258,8,10,4,"['spencer.travis97', 'craizk', 'maryesperancia', 'nathansadlab']",3,"['siu853667486', 'michaelroberto98', 'erickg']",6,"['vincentmarchio24', 'guxci2019', 'pointsedge', 'ampm1223', None, 'siu853936640']",13,"['guxci2019', 'spencer.travis97', 'ampm1223', 'maryesperancia', None, 'michaelroberto98', 'nathansadlab', 'craizk', 'vincentmarchio24', 'pointsedge', 'siu853667486', 'erickg', 'siu853936640']"
115,260,8,8,3,"['siu853667486', 'craizk', 'erickg']",4,"['spencer.travis97', 'michaelroberto98', 'maryesperancia', 'nathansadlab']",5,"['kramernolan4', 'mousaeid96', 'guxci2019', 'ampm1223', None]",12,"['kramernolan4', 'michaelroberto98', None, 'nathansadlab', 'mousaeid96', 'craizk', 'erickg', 'spencer.travis97', 'guxci2019', 'siu853667486', 'ampm1223', 'maryesperancia']"
115,261,8,7,1,['michaelroberto98'],6,"['maryesperancia', 'nathansadlab', 'craizk', 'spencer.travis97', 'siu853667486', 'erickg']",6,"['zunaidur.rashid', 'natexdog9800', 'ryleec23', 'xrazepridex', 'guxci2019', None]",13,"['michaelroberto98', 'zunaidur.rashid', 'natexdog9800', 'ryleec23', 'xrazepridex', 'nathansadlab', 'craizk', 'erickg', 'spencer.travis97', 'guxci2019', 'siu853667486', None, 'maryesperancia']"
116,106,8,8,7,"['quanquan5530', 'boyax', 'juangimenez', 'fbackl01', 'kg34', 'vincent.philip.fitzpatrick', 'latha']",0,[],1,[None],8,"['quanquan5530', 'boyax', 'juangimenez', 'fbackl01', 'kg34', None, 'vincent.philip.fitzpatrick', 'latha']"
117,327,8,25,7,"['sonali.gavkar', 'smita.n', 'nikita.us', 'jagruti.patil', 'rahul.ys', 'vaishnavimahukar28', 'sanjita.s']",0,[],18,"['joshinirmit', 'nikitamittal97', 'sarika', 'aditya.aher', 'jesal.t', 'tapan.garge', 'neha.hg', 'gandhi.j', 'aniruddh.s', 'rohitkadam702', None, 'soureen.g', 'anushkumar', 'urvi.panchal', 'rajas.b', 'rohit.vhatkar', 'pawan.mojar', 'debosmita.b']",25,"['rahul.ys', 'sanjita.s', 'urvi.panchal', 'pawan.mojar', 'joshinirmit', 'sonali.gavkar', 'nikitamittal97', 'debosmita.b', 'aditya.aher', 'jagruti.patil', 'neha.hg', 'gandhi.j', 'aniruddh.s', 'soureen.g', 'anushkumar', 'rohit.vhatkar', 'nikita.us', 'jesal.t', 'tapan.garge', 'rohitkadam702', 'vaishnavimahukar28', None, 'rajas.b', 'smita.n', 'sarika']"
117,340,8,19,7,"['sonali.gavkar', 'smita.n', 'nikita.us', 'jagruti.patil', 'rahul.ys', 'vaishnavimahukar28', 'sanjita.s']",0,[],12,"['kharatomkar24', 'sarika', 'vaishnavi.soni', 'rohitkadam702', None, 'anjana.bhave', 'gaurav.dangat', 'soureen.g', 'sandeep.sd', 'rohit.vhatkar', 'akshaykumar.ks', 'pawan.mojar']",19,"['kharatomkar24', 'nikita.us', 'rahul.ys', 'rohitkadam702', 'anjana.bhave', 'vaishnavimahukar28', 'sanjita.s', None, 'akshaykumar.ks', 'pawan.mojar', 'sonali.gavkar', 'smita.n', 'sarika', 'jagruti.patil', 'vaishnavi.soni', 'gaurav.dangat', 'soureen.g', 'sandeep.sd', 'rohit.vhatkar']"
117,307,8,18,6,"['sonali.gavkar', 'smita.n', 'nikita.us', 'rahul.ys', 'vaishnavimahukar28', 'sanjita.s']",1,['jagruti.patil'],12,"['kharatomkar24', 'nikitamittal97', 'rohitkadam702', 'siddhesh.y', 'yash.mhatre', 'prashb547', None, 'pawan.mojar', 'solo_c0p', 'rohit.vhatkar', 'shukla.s', 'urvi.panchal']",19,"['kharatomkar24', 'nikita.us', 'rahul.ys', 'rohitkadam702', 'siddhesh.y', 'yash.mhatre', 'vaishnavimahukar28', 'sanjita.s', 'solo_c0p', None, 'shukla.s', 'urvi.panchal', 'pawan.mojar', 'sonali.gavkar', 'nikitamittal97', 'smita.n', 'jagruti.patil', 'prashb547', 'rohit.vhatkar']"
117,209,8,16,7,"['sonali.gavkar', 'smita.n', 'nikita.us', 'jagruti.patil', 'rahul.ys', 'vaishnavimahukar28', 'sanjita.s']",0,[],9,"['nikitamittal97', 'siddhesh.y', 'gandhi.j', 'aniruddh.s', 'prashb547', 'omkar.kharat', None, 'shukla.s', 'urvi.panchal']",16,"['nikita.us', 'rahul.ys', 'siddhesh.y', 'omkar.kharat', 'vaishnavimahukar28', 'sanjita.s', None, 'shukla.s', 'urvi.panchal', 'sonali.gavkar', 'nikitamittal97', 'smita.n', 'jagruti.patil', 'gandhi.j', 'aniruddh.s', 'prashb547']"
117,338,8,14,7,"['sonali.gavkar', 'smita.n', 'nikita.us', 'jagruti.patil', 'rahul.ys', 'vaishnavimahukar28', 'sanjita.s']",0,[],7,"['kharatomkar24', 'vatsal23', 'ashok.bp', None, 'pranav.ss', 'rohit.vhatkar', 'akshaykumar.ks']",14,"['kharatomkar24', 'nikita.us', 'rahul.ys', 'vatsal23', 'vaishnavimahukar28', 'sanjita.s', 'pranav.ss', None, 'akshaykumar.ks', 'sonali.gavkar', 'smita.n', 'jagruti.patil', 'ashok.bp', 'rohit.vhatkar']"
117,305,8,10,3,"['nikita.us', 'sanjita.s', 'jagruti.patil']",4,"['sonali.gavkar', 'smita.n', 'vaishnavimahukar28', 'rahul.ys']",7,"['nikitamittal97', 'siddhesh.y', 'aniruddh.s', 'omkar.kharat', None, 'shukla.s', 'urvi.panchal']",14,"['nikita.us', 'rahul.ys', 'siddhesh.y', 'omkar.kharat', 'vaishnavimahukar28', 'sanjita.s', None, 'shukla.s', 'urvi.panchal', 'sonali.gavkar', 'nikitamittal97', 'smita.n', 'jagruti.patil', 'aniruddh.s']"
117,341,8,9,4,"['sonali.gavkar', 'smita.n', 'nikita.us', 'rahul.ys']",3,"['sanjita.s', 'vaishnavimahukar28', 'jagruti.patil']",5,"['vatsal23', 'ashok.bp', 'pranav.ss', None, 'akshaykumar.ks']",12,"['nikita.us', 'rahul.ys', 'vatsal23', 'vaishnavimahukar28', 'sanjita.s', 'pranav.ss', None, 'akshaykumar.ks', 'sonali.gavkar', 'smita.n', 'jagruti.patil', 'ashok.bp']"
117,306,8,8,1,['nikita.us'],6,"['sonali.gavkar', 'smita.n', 'jagruti.patil', 'rahul.ys', 'vaishnavimahukar28', 'sanjita.s']",7,"['siddhesh.y', 'aniruddh.s', 'gandhi.j', 'prashb547', 'omkar.kharat', None, 'shukla.s']",14,"['sonali.gavkar', 'smita.n', 'jagruti.patil', 'nikita.us', 'rahul.ys', 'siddhesh.y', 'aniruddh.s', 'gandhi.j', 'prashb547', 'omkar.kharat', 'vaishnavimahukar28', 'sanjita.s', None, 'shukla.s']"
117,330,8,8,4,"['nikita.us', 'sonali.gavkar', 'sanjita.s', 'jagruti.patil']",3,"['smita.n', 'vaishnavimahukar28', 'rahul.ys']",4,"['rohitkadam702', 'rohit.vhatkar', 'pawan.mojar', None]",11,"['sonali.gavkar', 'smita.n', 'jagruti.patil', 'nikita.us', 'rahul.ys', 'rohitkadam702', None, 'vaishnavimahukar28', 'sanjita.s', 'rohit.vhatkar', 'pawan.mojar']"
117,332,8,7,1,['jagruti.patil'],6,"['sonali.gavkar', 'smita.n', 'nikita.us', 'rahul.ys', 'vaishnavimahukar28', 'sanjita.s']",6,"['kharatomkar24', 'vatsal23', 'ashok.bp', 'vaishnavi.soni', 'aakashrai119', None]",13,"['sonali.gavkar', 'kharatomkar24', 'smita.n', 'jagruti.patil', 'nikita.us', 'rahul.ys', 'vatsal23', 'ashok.bp', 'vaishnavi.soni', 'aakashrai119', 'vaishnavimahukar28', 'sanjita.s', None]"
117,211,8,6,1,['sanjita.s'],6,"['sonali.gavkar', 'smita.n', 'nikita.us', 'jagruti.patil', 'rahul.ys', 'vaishnavimahukar28']",5,"['rohitkadam702', 'yash.mhatre', 'prashb547', 'solo_c0p', None]",12,"['sonali.gavkar', 'smita.n', 'jagruti.patil', 'nikita.us', 'rahul.ys', 'rohitkadam702', 'yash.mhatre', 'prashb547', 'vaishnavimahukar28', 'sanjita.s', 'solo_c0p', None]"
118,256,8,31,3,"['aayusharora48', 'aakashdaswani', 'maaz777']",4,"['sanugo', 'achoos.29', 'salarymm', 'tim.f.fischer']",28,"['ee17btech11006', 'ee17btech11021', 'ananth7121999', 'pradeepmoturi', 'ee17btech11036', 'siddharthmanu500', 'ee17btech11014', 'ee17btech11013', 'alexaagatha16', 'ee17btech11012', 'ee17btech11050', 'sumanthcherupally', 'dheerajracha', 'ee17btech11034', 'ee17btech11016', 'taruntejreddych', 'ee17btech11025', 'k.vamshika', 'es16btech11026', 'knsiddharth', 'prag', '124guna', None, 'ee17btech11037', 'falconrider10', 'raktim', 'ee17btech11040', 'karthikp']",35,"['ee17btech11006', 'ee17btech11021', 'ananth7121999', 'pradeepmoturi', 'ee17btech11036', 'siddharthmanu500', 'ee17btech11014', 'ee17btech11013', 'alexaagatha16', 'achoos.29', 'ee17btech11012', 'ee17btech11050', 'sumanthcherupally', 'dheerajracha', 'maaz777', 'ee17btech11034', 'ee17btech11016', 'taruntejreddych', 'ee17btech11025', 'k.vamshika', 'es16btech11026', 'knsiddharth', 'prag', 'aakashdaswani', 'salarymm', 'sanugo', '124guna', None, 'ee17btech11037', 'falconrider10', 'aayusharora48', 'tim.f.fischer', 'raktim', 'ee17btech11040', 'karthikp']"
120,313,8,22,7,"['inamdarshreyas5', 'sagar21', 'swastik2', 'deep.patel', 'arushi.yadav', 'akshaybhore7', 'mayurpashte97']",0,[],15,"['saritav.9600', 'nanomems226', 'nageshjaiswar11', 'pranav123', 'tanvipalande', 'omimore24', 'ashu0497', 'rahulbirwadkar123', 'rutujakamthe', 'prachi.mujawar', 'shantanu123', 'max_mercury', None, 'piyamodhve', 'verma_34dh']",22,"['inamdarshreyas5', 'nanomems226', 'nageshjaiswar11', 'omimore24', 'rahulbirwadkar123', 'arushi.yadav', 'rutujakamthe', 'shantanu123', 'akshaybhore7', 'max_mercury', None, 'verma_34dh', 'mayurpashte97', 'sagar21', 'saritav.9600', 'swastik2', 'pranav123', 'tanvipalande', 'deep.patel', 'ashu0497', 'prachi.mujawar', 'piyamodhve']"
120,325,8,8,1,['inamdarshreyas5'],6,"['sagar21', 'swastik2', 'deep.patel', 'arushi.yadav', 'akshaybhore7', 'mayurpashte97']",7,"['omimore24', 'nicket9', 'adityakini21', 'juileebharate10797', 'rajashree.pimputkar', None, 'piyamodhve']",14,"['inamdarshreyas5', 'sagar21', 'swastik2', 'deep.patel', 'omimore24', 'nicket9', 'arushi.yadav', 'akshaybhore7', 'adityakini21', 'juileebharate10797', 'rajashree.pimputkar', None, 'piyamodhve', 'mayurpashte97']"
120,328,8,8,6,"['sagar21', 'swastik2', 'deep.patel', 'arushi.yadav', 'akshaybhore7', 'mayurpashte97']",1,['inamdarshreyas5'],2,"[None, 'nanomems226']",9,"['inamdarshreyas5', 'sagar21', 'swastik2', 'nanomems226', 'deep.patel', 'arushi.yadav', 'akshaybhore7', None, 'mayurpashte97']"
120,337,8,7,6,"['sagar21', 'swastik2', 'deep.patel', 'arushi.yadav', 'akshaybhore7', 'mayurpashte97']",1,['inamdarshreyas5'],1,[None],8,"['inamdarshreyas5', 'sagar21', 'swastik2', 'deep.patel', 'arushi.yadav', 'akshaybhore7', None, 'mayurpashte97']"
123,182,8,67,7,"['harsh16150', 'vishal16207', 'parth15156', 'imrajat', 'rajat16182', 'sahil16184', 'dheeraj15138']",0,[],60,"['saumya15172', 'adityadiundi', 'shivani18223', 'shubhesh18216', 'neerupama18209', 'yogesh15193', 'jasmine18202', 'shivam18214', 'hnspoorthy', 'sagar17115', 'shuchi18224', 'tarun14168', 'akshay18193', 'shivam18215', 'surabhi18217', 'shivam15177', 'vaishali18220', 'rajat15162', 'sagar15167', 'aakash18191', 'mridul15149', 'gurpreet15140', 'shaikh18213', 'tushar18218', 'nowudontknowme', 'sambeet15168', 'aman18194', 'dhaval_1104', 'manshi18207', 'smartvedi', 'prateek18211', 'harsh161500', 'sambhav14158', 'kunal15145', 'shubham18176', 'ankur14019', 'studsuper50', 'abhinavg', 'pankaj16176', 'avdesh15135', 'feraj.husain', 'puneet15159', 'anubhav15128', 'maddineni18206', 'ashish18157', 'anchal18155', None, 'subhadip17124', 'puneet16178', 'arij18208', 'priyanka18169', 'saurav15174', 'aparna18196', 'sarthak16190', 'aminah', 'kumari18221', 'paras15154', 'ehtesham18199', 'subhadipporia', 'juilly']",67,"['saumya15172', 'vishal16207', 'adityadiundi', 'imrajat', 'sahil16184', 'shivani18223', 'shubhesh18216', 'neerupama18209', 'parth15156', 'yogesh15193', 'jasmine18202', 'shivam18214', 'hnspoorthy', 'sagar17115', 'dheeraj15138', 'shuchi18224', 'tarun14168', 'akshay18193', 'shivam18215', 'surabhi18217', 'shivam15177', 'vaishali18220', 'rajat15162', 'sagar15167', 'aakash18191', 'mridul15149', 'gurpreet15140', 'shaikh18213', 'tushar18218', 'nowudontknowme', 'sambeet15168', 'aman18194', 'dhaval_1104', 'manshi18207', 'smartvedi', 'rajat16182', 'prateek18211', 'harsh16150', 'harsh161500', 'sambhav14158', 'kunal15145', 'shubham18176', 'ankur14019', 'studsuper50', 'abhinavg', 'pankaj16176', 'avdesh15135', 'feraj.husain', 'puneet15159', 'anubhav15128', 'maddineni18206', 'ashish18157', 'anchal18155', None, 'subhadip17124', 'puneet16178', 'arij18208', 'priyanka18169', 'saurav15174', 'aparna18196', 'sarthak16190', 'aminah', 'kumari18221', 'paras15154', 'ehtesham18199', 'subhadipporia', 'juilly']"
123,204,8,11,7,"['harsh16150', 'vishal16207', 'parth15156', 'imrajat', 'rajat16182', 'sahil16184', 'dheeraj15138']",0,[],4,"['harsh161500', 'shivam18215', None, 'yogesh15193']",11,"['vishal16207', 'shivam18215', 'imrajat', 'rajat16182', 'sahil16184', None, 'harsh16150', 'parth15156', 'yogesh15193', 'harsh161500', 'dheeraj15138']"
125,136,7,15,6,"['isabelgopa', 'dguemes', 'alejandrorivelles21', 'carlo176', 'saraquaini96', 'elenalp']",0,[],9,"['mvp12x2atm', 'mladensokic', 'aleksa.viktorovic', 'jpedros100', 'mpa1', 'kaisasaara', 'olazz', None, 'cquimpo']",15,"['mvp12x2atm', 'isabelgopa', 'mpa1', None, 'cquimpo', 'elenalp', 'mladensokic', 'aleksa.viktorovic', 'dguemes', 'jpedros100', 'alejandrorivelles21', 'kaisasaara', 'carlo176', 'saraquaini96', 'olazz']"
125,180,7,15,6,"['isabelgopa', 'dguemes', 'alejandrorivelles21', 'carlo176', 'saraquaini96', 'elenalp']",0,[],9,"['mladensokic', 'aleksa.viktorovic', 'mpa1', 'brunodistefano8', 'kaisasaara', 'villalba.perez.miguel', 'olazz', None, 'cquimpo']",15,"['isabelgopa', 'mpa1', 'brunodistefano8', 'villalba.perez.miguel', None, 'cquimpo', 'elenalp', 'mladensokic', 'aleksa.viktorovic', 'dguemes', 'alejandrorivelles21', 'kaisasaara', 'carlo176', 'saraquaini96', 'olazz']"
125,197,7,15,6,"['isabelgopa', 'dguemes', 'alejandrorivelles21', 'carlo176', 'saraquaini96', 'elenalp']",0,[],9,"['mvp12x2atm', 'mladensokic', 'aleksa.viktorovic', 'jpedros100', 'mpa1', 'kaisasaara', 'olazz', None, 'cquimpo']",15,"['mvp12x2atm', 'isabelgopa', 'mpa1', None, 'cquimpo', 'elenalp', 'mladensokic', 'aleksa.viktorovic', 'dguemes', 'jpedros100', 'alejandrorivelles21', 'kaisasaara', 'carlo176', 'saraquaini96', 'olazz']"
125,198,7,15,6,"['isabelgopa', 'dguemes', 'alejandrorivelles21', 'carlo176', 'saraquaini96', 'elenalp']",0,[],9,"['mladensokic', 'eva', 'aleksa.viktorovic', 'mpa1', 'brunodistefano8', 'kaisasaara', 'villalba.perez.miguel', None, 'cquimpo']",15,"['isabelgopa', 'mpa1', 'brunodistefano8', 'villalba.perez.miguel', None, 'cquimpo', 'elenalp', 'mladensokic', 'eva', 'aleksa.viktorovic', 'dguemes', 'alejandrorivelles21', 'kaisasaara', 'carlo176', 'saraquaini96']"
125,178,7,14,6,"['isabelgopa', 'dguemes', 'alejandrorivelles21', 'carlo176', 'saraquaini96', 'elenalp']",0,[],8,"['mladensokic', 'mpa1', 'brunodistefano8', 'kaisasaara', 'villalba.perez.miguel', 'olazz', None, 'cquimpo']",14,"['isabelgopa', 'mpa1', 'brunodistefano8', 'villalba.perez.miguel', None, 'cquimpo', 'elenalp', 'mladensokic', 'dguemes', 'alejandrorivelles21', 'kaisasaara', 'carlo176', 'saraquaini96', 'olazz']"
125,141,7,12,3,"['saraquaini96', 'dguemes', 'alejandrorivelles21']",3,"['isabelgopa', 'carlo176', 'elenalp']",9,"['mladensokic', 'eva', 'aleksa.viktorovic', 'jpedros100', 'brunodistefano8', 'villalba.perez.miguel', 'olazz', None, 'cquimpo']",15,"['isabelgopa', 'brunodistefano8', 'villalba.perez.miguel', None, 'cquimpo', 'elenalp', 'mladensokic', 'eva', 'aleksa.viktorovic', 'dguemes', 'jpedros100', 'alejandrorivelles21', 'carlo176', 'saraquaini96', 'olazz']"
125,199,7,12,5,"['isabelgopa', 'alejandrorivelles21', 'carlo176', 'saraquaini96', 'elenalp']",1,['dguemes'],7,"['mladensokic', 'mpa1', 'brunodistefano8', 'kaisasaara', 'villalba.perez.miguel', None, 'cquimpo']",13,"['isabelgopa', 'mpa1', 'brunodistefano8', 'villalba.perez.miguel', None, 'cquimpo', 'elenalp', 'mladensokic', 'dguemes', 'alejandrorivelles21', 'kaisasaara', 'carlo176', 'saraquaini96']"
125,202,7,12,4,"['saraquaini96', 'dguemes', 'alejandrorivelles21', 'carlo176']",2,"['isabelgopa', 'elenalp']",8,"['mladensokic', 'eva', 'aleksa.viktorovic', 'brunodistefano8', 'kaisasaara', 'olazz', None, 'cquimpo']",14,"['isabelgopa', 'brunodistefano8', None, 'cquimpo', 'elenalp', 'mladensokic', 'eva', 'aleksa.viktorovic', 'dguemes', 'alejandrorivelles21', 'kaisasaara', 'carlo176', 'saraquaini96', 'olazz']"
125,365,7,12,6,"['isabelgopa', 'dguemes', 'alejandrorivelles21', 'carlo176', 'saraquaini96', 'elenalp']",0,[],6,"['eva', 'jpedros100', 'villalba.perez.miguel', 'olazz', None, 'cquimpo']",12,"['isabelgopa', 'villalba.perez.miguel', None, 'cquimpo', 'elenalp', 'eva', 'dguemes', 'jpedros100', 'alejandrorivelles21', 'carlo176', 'saraquaini96', 'olazz']"
125,181,7,11,4,"['saraquaini96', 'dguemes', 'alejandrorivelles21', 'carlo176']",2,"['isabelgopa', 'elenalp']",7,"['mladensokic', 'eva', 'aleksa.viktorovic', 'brunodistefano8', 'kaisasaara', 'villalba.perez.miguel', None]",13,"['isabelgopa', 'brunodistefano8', 'villalba.perez.miguel', None, 'elenalp', 'mladensokic', 'eva', 'aleksa.viktorovic', 'dguemes', 'alejandrorivelles21', 'kaisasaara', 'carlo176', 'saraquaini96']"
125,142,7,10,4,"['saraquaini96', 'dguemes', 'alejandrorivelles21', 'carlo176']",2,"['isabelgopa', 'elenalp']",6,"['mladensokic', 'eva', 'brunodistefano8', 'villalba.perez.miguel', None, 'cquimpo']",12,"['isabelgopa', 'brunodistefano8', 'villalba.perez.miguel', None, 'cquimpo', 'elenalp', 'mladensokic', 'eva', 'dguemes', 'alejandrorivelles21', 'carlo176', 'saraquaini96']"
125,140,7,9,4,"['saraquaini96', 'dguemes', 'isabelgopa', 'alejandrorivelles21']",2,"['carlo176', 'elenalp']",5,"['mladensokic', 'jpedros100', 'villalba.perez.miguel', 'olazz', None]",11,"['mladensokic', 'isabelgopa', 'dguemes', 'jpedros100', 'alejandrorivelles21', 'carlo176', 'villalba.perez.miguel', 'saraquaini96', 'olazz', None, 'elenalp']"
125,366,7,8,4,"['dguemes', 'isabelgopa', 'carlo176', 'elenalp']",2,"['saraquaini96', 'alejandrorivelles21']",4,"['olazz', None, 'cquimpo', 'villalba.perez.miguel']",10,"['isabelgopa', 'dguemes', 'alejandrorivelles21', 'carlo176', 'villalba.perez.miguel', 'saraquaini96', 'olazz', None, 'cquimpo', 'elenalp']"
125,200,7,7,2,"['saraquaini96', 'isabelgopa']",4,"['dguemes', 'alejandrorivelles21', 'carlo176', 'elenalp']",5,"['mladensokic', 'eva', 'kaisasaara', None, 'cquimpo']",11,"['mladensokic', 'isabelgopa', 'eva', 'dguemes', 'alejandrorivelles21', 'kaisasaara', 'carlo176', 'saraquaini96', None, 'cquimpo', 'elenalp']"
125,367,7,7,3,"['saraquaini96', 'dguemes', 'alejandrorivelles21']",3,"['isabelgopa', 'carlo176', 'elenalp']",4,"['jpedros100', 'brunodistefano8', 'villalba.perez.miguel', None]",10,"['isabelgopa', 'dguemes', 'jpedros100', 'alejandrorivelles21', 'brunodistefano8', 'carlo176', 'villalba.perez.miguel', 'saraquaini96', None, 'elenalp']"
127,20,7,14,4,"['c.k.ishino', 'jsltradecorp', 'ec3136', 'mqadir3']",2,"['cbzk', 'gsw']",10,"['hellotate', 'va844', 'michael2010814', 'atx203', None, 'fkl217', 'tmi211', 'al4995', 'jn1404', 'tyy233']",16,"['hellotate', 'atx203', 'fkl217', 'gsw', 'mqadir3', 'cbzk', 'al4995', 'jn1404', None, 'michael2010814', 'va844', 'ec3136', 'tmi211', 'jsltradecorp', 'c.k.ishino', 'tyy233']"
129,378,7,7,5,"['duanyunruisdu', 'czhao', 'wenzhao', 'xiaokong91', 'tcheng.gogo']",1,['aageo25'],2,"[None, 'leining']",8,"['duanyunruisdu', 'czhao', 'leining', 'wenzhao', 'xiaokong91', 'aageo25', 'tcheng.gogo', None]"
130,250,7,9,6,"['ankitwolf14', 'ishayadavie21', 'pshindekov', 'swastikadigha31', 'harshalisawant92', 'nevilpooniwala']",0,[],3,"[None, 'shettynisha131', 'sugandhanisrad1997']",9,"['ankitwolf14', 'ishayadavie21', 'pshindekov', None, 'swastikadigha31', 'harshalisawant92', 'nevilpooniwala', 'shettynisha131', 'sugandhanisrad1997']"
130,344,7,9,6,"['ankitwolf14', 'ishayadavie21', 'pshindekov', 'swastikadigha31', 'harshalisawant92', 'nevilpooniwala']",0,[],3,"[None, 'shettynisha131', 'sugandhanisrad1997']",9,"['ankitwolf14', 'ishayadavie21', 'pshindekov', None, 'swastikadigha31', 'harshalisawant92', 'nevilpooniwala', 'shettynisha131', 'sugandhanisrad1997']"
132,221,7,9,6,"['pglynch', 'jarebstock', 'hrichards42', 'adahik', 'rewiley', 'isstevens']",0,[],3,"['ndfan97', None, 'hmelzer']",9,"['pglynch', 'jarebstock', 'hmelzer', 'hrichards42', 'ndfan97', 'adahik', 'rewiley', None, 'isstevens']"
132,220,7,8,6,"['pglynch', 'jarebstock', 'hrichards42', 'adahik', 'rewiley', 'isstevens']",0,[],2,"[None, 'hmelzer']",8,"['pglynch', 'jarebstock', 'hmelzer', 'hrichards42', 'adahik', 'rewiley', None, 'isstevens']"
134,93,7,22,6,"['mallickshrutik', 'shindedeepak129', 'sheetalwings97', 'smahamulkar1013', 'shreyahonagekar04', 'umeshlohote']",0,[],16,"['ajayphroust.ay', 'priyu0964', 'kaustubhvaishampayan', 'afsarkhan160', 'anishnair1996', 'aadi', 'aa9858203050', 'zeevd19', 'arthaya.koyande28', 'shubham.yelange', 'rohitnair77880', 'rockey.anths', 'mani.mandude', 'patilprasad0123', None, 'vixsnair']",22,"['ajayphroust.ay', 'shindedeepak129', 'priyu0964', 'sheetalwings97', 'kaustubhvaishampayan', 'aa9858203050', 'arthaya.koyande28', 'mani.mandude', 'rohitnair77880', 'shreyahonagekar04', 'aadi', 'umeshlohote', None, 'vixsnair', 'mallickshrutik', 'afsarkhan160', 'anishnair1996', 'smahamulkar1013', 'shubham.yelange', 'rockey.anths', 'patilprasad0123', 'zeevd19']"
134,315,7,22,6,"['mallickshrutik', 'shindedeepak129', 'sheetalwings97', 'smahamulkar1013', 'shreyahonagekar04', 'umeshlohote']",0,[],16,"['ajayphroust.ay', 'priyu0964', 'kaustubhvaishampayan', 'afsarkhan160', 'anishnair1996', 'aadi', 'aa9858203050', 'zeevd19', 'arthaya.koyande28', 'shubham.yelange', 'rohitnair77880', 'rockey.anths', 'mani.mandude', 'patilprasad0123', None, 'vixsnair']",22,"['ajayphroust.ay', 'shindedeepak129', 'priyu0964', 'sheetalwings97', 'kaustubhvaishampayan', 'aa9858203050', 'arthaya.koyande28', 'mani.mandude', 'rohitnair77880', 'shreyahonagekar04', 'aadi', 'umeshlohote', None, 'vixsnair', 'mallickshrutik', 'afsarkhan160', 'anishnair1996', 'smahamulkar1013', 'shubham.yelange', 'rockey.anths', 'patilprasad0123', 'zeevd19']"
135,126,7,13,5,"['ichesser', 'raphaeldu', 'nothando21', 'graceml2', 'vishwasg']",1,['sjtuzhanglei'],8,"['kalan', 'mukherjeeatom', 'freshfoodhuang', 'tanni', 'skylarmays', 'adavar2', 'shushujie', None]",14,"['ichesser', 'raphaeldu', 'freshfoodhuang', 'nothando21', 'graceml2', 'skylarmays', 'adavar2', 'shushujie', 'vishwasg', None, 'kalan', 'sjtuzhanglei', 'tanni', 'mukherjeeatom']"
135,235,7,13,6,"['sjtuzhanglei', 'ichesser', 'raphaeldu', 'nothando21', 'graceml2', 'vishwasg']",0,[],7,"['kalan', 'mukherjeeatom', 'freshfoodhuang', 'tanni', 'adavar2', 'shushujie', None]",13,"['ichesser', 'raphaeldu', 'freshfoodhuang', 'nothando21', 'graceml2', 'adavar2', 'shushujie', 'vishwasg', None, 'kalan', 'sjtuzhanglei', 'tanni', 'mukherjeeatom']"
136,132,7,7,1,['albd'],5,"['eyupb.unlu', 'ender.forerunner', 'andervish', 'jesszlu', 'baszczu']",6,"['fredhills', 'xibfeng', 'hamamines', None, 'ch630183', 'mccoombs']",12,"['fredhills', 'eyupb.unlu', 'ender.forerunner', 'xibfeng', 'hamamines', 'andervish', 'jesszlu', 'albd', 'ch630183', 'baszczu', None, 'mccoombs']"
137,52,7,13,2,"['gnivetha05', 'junaidmd1996']",4,"['haidermoter2018', 'q76061036', 'osamaamer82', 'gsombrio']",11,"['padmavlr01', 'divassingh.dagur2018', 'mdjunaid071', 'elsa.george2018', 'sreekanthsp', 'suvankar94', 'ds1akbarbasha', 'saipriya.tummala2018', 'nikhilsai79', None, 'nivedhita123']",17,"['q76061036', 'mdjunaid071', 'suvankar94', 'gnivetha05', 'ds1akbarbasha', 'saipriya.tummala2018', None, 'nivedhita123', 'nikhilsai79', 'junaidmd1996', 'padmavlr01', 'divassingh.dagur2018', 'elsa.george2018', 'gsombrio', 'sreekanthsp', 'haidermoter2018', 'osamaamer82']"
138,112,7,7,4,"['echo570', 'paguado', 'nataliapinirtzi', 'robbiemorrison1995']",2,"['wastefellowfollowsraji', 'elham5661']",3,"['ggreenediniz18', None, 'myrta']",9,"['elham5661', 'myrta', 'wastefellowfollowsraji', 'nataliapinirtzi', 'echo570', None, 'paguado', 'ggreenediniz18', 'robbiemorrison1995']"
139,164,7,17,4,"['shubhangi6', 'aadityapatil77', 'patilvd7511vd', 'mrunalb1497']",2,"['shubhamyadav', 'sidved29']",13,"['suchitraravan77', '2509patilkomal', 'snehalavate3', 'sahilmagdum', 'utkarsha531998', 'ameysabnis134', 'kirannirmal57', 'sonalimiraje15', 'trishadesai1111', 'harkesayali19', 'priyupawar0797', 'rutujaamate68', None]",19,"['shubhamyadav', 'rutujaamate68', 'utkarsha531998', 'snehalavate3', 'aadityapatil77', 'ameysabnis134', 'shubhangi6', 'priyupawar0797', None, 'suchitraravan77', '2509patilkomal', 'sahilmagdum', 'kirannirmal57', 'sonalimiraje15', 'trishadesai1111', 'patilvd7511vd', 'harkesayali19', 'mrunalb1497', 'sidved29']"
139,293,7,17,6,"['shubhamyadav', 'aadityapatil77', 'shubhangi6', 'patilvd7511vd', 'mrunalb1497', 'sidved29']",0,[],11,"['revadekarchetan', 'snehalavate3', 'utkarsha531998', 'kirannirmal57', 'ameysabnis134', 'sonalimiraje15', 'trishadesai1111', 'harkesayali19', 'priyupawar0797', 'pavanmkodam', None]",17,"['shubhamyadav', 'utkarsha531998', 'snehalavate3', 'aadityapatil77', 'ameysabnis134', 'shubhangi6', 'priyupawar0797', 'pavanmkodam', None, 'revadekarchetan', 'kirannirmal57', 'sonalimiraje15', 'trishadesai1111', 'patilvd7511vd', 'harkesayali19', 'mrunalb1497', 'sidved29']"
139,213,7,12,3,"['shubhangi6', 'aadityapatil77', 'patilvd7511vd']",3,"['shubhamyadav', 'sidved29', 'mrunalb1497']",9,"['suchitraravan77', 'snehalavate3', 'sahilmagdum', 'kirannirmal57', 'ameysabnis134', 'sonalimiraje15', 'trishadesai1111', 'harkesayali19', None]",15,"['shubhamyadav', 'snehalavate3', 'aadityapatil77', 'ameysabnis134', 'shubhangi6', None, 'suchitraravan77', 'sahilmagdum', 'kirannirmal57', 'sonalimiraje15', 'trishadesai1111', 'patilvd7511vd', 'harkesayali19', 'mrunalb1497', 'sidved29']"
139,165,7,10,4,"['shubhamyadav', 'sidved29', 'aadityapatil77', 'mrunalb1497']",2,"['shubhangi6', 'patilvd7511vd']",6,"['snehalavate3', 'revadekarchetan', 'ameysabnis134', 'harkesayali19', 'pavanmkodam', None]",12,"['shubhamyadav', 'snehalavate3', 'aadityapatil77', 'ameysabnis134', 'shubhangi6', 'pavanmkodam', None, 'revadekarchetan', 'patilvd7511vd', 'harkesayali19', 'mrunalb1497', 'sidved29']"
139,214,7,8,3,"['shubhamyadav', 'sidved29', 'mrunalb1497']",3,"['shubhangi6', 'aadityapatil77', 'patilvd7511vd']",5,"['2509patilkomal', 'revadekarchetan', 'ameysabnis134', 'harkesayali19', None]",11,"['shubhamyadav', '2509patilkomal', 'revadekarchetan', 'aadityapatil77', 'ameysabnis134', 'shubhangi6', 'patilvd7511vd', 'harkesayali19', 'mrunalb1497', None, 'sidved29']"
140,70,7,127,3,"['psumner', 'ksjolund', 'ehonebri']",3,"['lswentor', 'ecronin', 'msakamot']",124,"['akreuter', 'tylera2104', 'kamranahmed', 'btestin14', 'osborn45', 'jacob_just', 'ryan.wiebe', 'nt230', 'agarw105', 'wstolz', 'suhaira97', 'akreilein', 'itsmemario', 'afalkenb', 'tgiazzon', 'john1886', 'cmelchin', 'charlesma423', 'ryanwest1040', 'george7elias', 'rjleach', 'boninim', 'rkwiatko', 'jkekre', 'cclapham', 'fischermben', 'greid09', 'spring12', 'mcrees', 'landon.glunt', 'ebergqu', 'buck17', 'davi1004', 'nathanmoore', 'angbecker', 'sammyknecht', 'sueprasad8214', 'hannahdeboer0015', 'cputt', 'kewlkahtz', 'amckeska', 'ebehring', 'treyfinn98', 'mcclurez', 'canadaman87', 'mishra59', 'alyssamcnarney', 'aboza', 'snowh5696', 'cartmaster007', 'baker428', 'munselltom', 'shaunak0304', 'anthonm', 'ikstealth', 'hkohart', 'dgreiwe', 'chiranth7954', 'htorsina', 'sfgdfgdfg', 'jwoon', 'jstalbaum', 'kellhages37', 'white519', 'nmcphero', 'shadow66666', 'ckroger', 'talon34567', 'fahimvora12', 'jacobglvn', 'rishiprasadha', 'agalema1027', 'jfolkers', 'swift8', 'joshuajkporter', 'draosmail', 'rachel318318', 'suran9712', 'akonopa', 'oliver67', 'hess35', 'asartor', 'crhodine', 'tilley0', 'mingusnate', 'kjh94425', 'rice103', 'royriveraf', 'dodge4', 'jacobpeterson698', 'jswetlik', 'hanmoyuan1997', 'garret28', 'wdrummon', 'maxwellfra16', 'mcclure8', 'nikhilcarneiro4', 'hkaakeh', 'kkamiya', 'cameronfritts12', 'kruege14', 'wallac68', 'dkilgor', 'herr13', 'nggoodie98', 'rsusler', 'imran3', 'kknowlto', 'batram197', 'brandt18', 'jskeens', 'acostab', 'bradsmrdel', 'jklaben', 'kevinodonnell0878', 'vcotta', 'lmeehann', 'goh5', 'mccaul', 'k.ico246', 'yhoashi', 'rao53', 'singh378', 'rileyedelaney']",130,"['tylera2104', 'btestin14', 'jacob_just', 'ryan.wiebe', 'nt230', 'agarw105', 'wstolz', 'itsmemario', 'afalkenb', 'tgiazzon', 'rkwiatko', 'jkekre', 'lswentor', 'mcrees', 'psumner', 'buck17', 'sammyknecht', 'sueprasad8214', 'hannahdeboer0015', 'cputt', 'amckeska', 'mcclurez', 'alyssamcnarney', 'shaunak0304', 'anthonm', 'hkohart', 'dgreiwe', 'sfgdfgdfg', 'jstalbaum', 'fahimvora12', 'rishiprasadha', 'swift8', 'draosmail', 'akonopa', 'hess35', 'crhodine', 'tilley0', 'mingusnate', 'kjh94425', 'rice103', 'dodge4', 'mcclure8', 'nikhilcarneiro4', 'hkaakeh', 'kkamiya', 'herr13', 'nggoodie98', 'rsusler', 'imran3', 'batram197', 'brandt18', 'bradsmrdel', 'vcotta', 'goh5', 'singh378', 'rileyedelaney', 'akreuter', 'kamranahmed', 'osborn45', 'suhaira97', 'akreilein', 'ksjolund', 'john1886', 'cmelchin', 'charlesma423', 'ryanwest1040', 'george7elias', 'rjleach', 'boninim', 'cclapham', 'fischermben', 'greid09', 'spring12', 'landon.glunt', 'ebergqu', 'davi1004', 'nathanmoore', 'angbecker', 'kewlkahtz', 'ebehring', 'treyfinn98', 'canadaman87', 'mishra59', 'aboza', 'snowh5696', 'cartmaster007', 'baker428', 'munselltom', 'ikstealth', 'chiranth7954', 'htorsina', 'jwoon', 'kellhages37', 'white519', 'nmcphero', 'ehonebri', 'shadow66666', 'ckroger', 'talon34567', 'jacobglvn', 'agalema1027', 'jfolkers', 'joshuajkporter', 'rachel318318', 'suran9712', 'oliver67', 'asartor', 'royriveraf', 'jacobpeterson698', 'jswetlik', 'hanmoyuan1997', 'garret28', 'wdrummon', 'maxwellfra16', 'cameronfritts12', 'kruege14', 'wallac68', 'ecronin', 'dkilgor', 'msakamot', 'kknowlto', 'jskeens', 'acostab', 'jklaben', 'kevinodonnell0878', 'lmeehann', 'mccaul', 'k.ico246', 'yhoashi', 'rao53']"
140,216,7,126,3,"['psumner', 'ecronin', 'ehonebri']",3,"['lswentor', 'ksjolund', 'msakamot']",123,"['ggauthi', 'geyerg', 'arturotrevino', 'wan52', 'akreuter', 'yeager5', 'bsmrdel', 'vwallema', 'btestin14', 'starr21', 'vpope', 'nt230', 'wstolz', 'suhaira97', 'ikobayas', 'yang1206', 'xng', 'lee2370', 'itsmemario', 'conner.swift8', 'eforti', 'jrohman', 'john1886', 'afalkenb', 'tgiazzon', 'justj', 'cmelchin', 'ryanwest1040', 'charlesma423', 'george7elias', 'boninim', 'evdaly', 'jkekre', 'cclapham', 'fischermben', 'landon.glunt', 'mcrees', 'jdanek', 'cbischof', 'rao75', 'kgmcginley', 'nathanmoore', 'angbecker', 'samm', 'sueprasad8214', 'ggolla', 'chanwoo.lee.17', 'amckeska', 'ebehring', 'ryry1644', 'dschull', 'nafandi', 'purduechen2203', 'cartmaster007', 'hyndmanjustin', 'davids19', 'anthonm', 'dgreiwe', 'chiranth7954', 'smit3180', 'jwoon', 'caldwe29', 'shaw108', 'nhdorcy', 'shadow66666', 'talon34567', 'huan1146', 'rishiprasadha', 'radhakr3', 'cpiepen', 'jacobglvn', 'jfolkers', 'joshuajkporter', 'agalema1027', 'suran9712', 'akonopa', 'oliver67', 'hess35', 'kskripakaran0810', 'asartor', 'tilley0', 'crhodine', 'mingusnate', 'kjh94425', 'maxwellfra16', 'garret28', 'zjohnson834', 'rhellyer', 'mcclure8', 'nikhilcarneiro4', 'jkueche', 'kruege14', 'albrect', 'nramli', 'dkilgor', 'heinzt', 'akreilei', 'srasche', 'rsusler', 'rwiebe', 'mcdona85', 'kknowlto', None, 'river132', 'jskeens', 'yizhizhang', 'selawada', 'dsfgdsfg', 'acostab', 'tthieles', 'khageman', 'kevinodonnell0878', 'lmeehann', 'sknecht', 'goh5', 'kico', 'mccaul', 'rao53', 'muelle77', 'aguyre', 'singh378', 'rileyedelaney', 'athoman']",129,"['ggauthi', 'arturotrevino', 'wan52', 'vwallema', 'btestin14', 'starr21', 'nt230', 'wstolz', 'xng', 'itsmemario', 'conner.swift8', 'eforti', 'afalkenb', 'tgiazzon', 'evdaly', 'jkekre', 'lswentor', 'mcrees', 'psumner', 'jdanek', 'cbischof', 'kgmcginley', 'sueprasad8214', 'amckeska', 'nafandi', 'davids19', 'anthonm', 'dgreiwe', 'smit3180', 'rishiprasadha', 'akonopa', 'hess35', 'tilley0', 'crhodine', 'mingusnate', 'kjh94425', 'mcclure8', 'nikhilcarneiro4', 'srasche', 'rsusler', 'rwiebe', 'river132', 'selawada', 'dsfgdsfg', 'tthieles', 'khageman', 'sknecht', 'goh5', 'muelle77', 'aguyre', 'singh378', 'rileyedelaney', 'geyerg', 'akreuter', 'yeager5', 'bsmrdel', 'vpope', 'suhaira97', 'ikobayas', 'yang1206', 'lee2370', 'jrohman', 'ksjolund', 'john1886', 'justj', 'cmelchin', 'ryanwest1040', 'charlesma423', 'george7elias', 'boninim', 'cclapham', 'fischermben', 'landon.glunt', 'rao75', 'nathanmoore', 'angbecker', 'samm', 'ggolla', 'chanwoo.lee.17', 'ebehring', 'ryry1644', 'dschull', 'purduechen2203', 'cartmaster007', 'hyndmanjustin', 'chiranth7954', 'jwoon', 'caldwe29', 'shaw108', 'nhdorcy', 'ehonebri', 'shadow66666', 'talon34567', 'huan1146', 'radhakr3', 'cpiepen', 'jacobglvn', 'jfolkers', 'joshuajkporter', 'agalema1027', 'suran9712', 'oliver67', 'kskripakaran0810', 'asartor', 'maxwellfra16', 'garret28', 'zjohnson834', 'rhellyer', 'jkueche', 'kruege14', 'albrect', 'nramli', 'ecronin', 'dkilgor', 'heinzt', 'akreilei', 'msakamot', 'mcdona85', 'kknowlto', None, 'jskeens', 'yizhizhang', 'acostab', 'kevinodonnell0878', 'lmeehann', 'kico', 'mccaul', 'rao53', 'athoman']"
140,208,7,72,2,"['psumner', 'ksjolund']",4,"['lswentor', 'ecronin', 'msakamot', 'ehonebri']",70,"['alexdobbins98', 'ramos39', 'vpope', 'nt230', 'ikobayas', 'wstolz', 'mnishat', 'justj', 'ryanwest1040', 'cmelchin', 'george7elias', 'john1886', 'rileyedelaney', 'cclapham', 'evdaly', 'jkekre', 'fischermben', 'jbartlin', 'mcrees', 'buck17', 'asartor7', 'nathanmoore', 'angbecker', 'samm', 'cputt', 'lise_lpz', 'canadaman87', 'dschull', 'treinha', 'anthonm', 'enadler', 'hkohart', 'dgreiwe', 'htorsina', 'jstalbaum', 'shadow66666', 'talon34567', 'jfolkers', 'joshuajkporter', 'samt.buller', 'hess35', 'kskripakaran0810', 'crhodine', 'nriaziat', 'mingusnate', 'jswetlik', 'mcclure8', 'nikhilcarneiro4', 'kkamiya', 'kruege14', 'albrect', 'heinzt', 'srasche', 'nggoodie98', 'rsusler', 'imran3', 'kknowlto', 'nbitner', None, 'jskeens', 'jklaben', 'khageman', 'inormile', 'lmeehann', 'sknecht', 'kico', 'yhoashi', 'evandaele3', 'rao53', 'rice125']",76,"['alexdobbins98', 'ramos39', 'vpope', 'nt230', 'ikobayas', 'wstolz', 'mnishat', 'ksjolund', 'justj', 'ryanwest1040', 'cmelchin', 'george7elias', 'john1886', 'rileyedelaney', 'cclapham', 'evdaly', 'jkekre', 'fischermben', 'lswentor', 'jbartlin', 'mcrees', 'psumner', 'buck17', 'asartor7', 'nathanmoore', 'angbecker', 'samm', 'cputt', 'lise_lpz', 'canadaman87', 'dschull', 'treinha', 'anthonm', 'enadler', 'hkohart', 'dgreiwe', 'htorsina', 'jstalbaum', 'ehonebri', 'shadow66666', 'talon34567', 'jfolkers', 'joshuajkporter', 'samt.buller', 'hess35', 'kskripakaran0810', 'crhodine', 'nriaziat', 'mingusnate', 'jswetlik', 'mcclure8', 'nikhilcarneiro4', 'kkamiya', 'kruege14', 'albrect', 'ecronin', 'heinzt', 'srasche', 'nggoodie98', 'rsusler', 'msakamot', 'imran3', 'kknowlto', 'nbitner', None, 'jskeens', 'jklaben', 'khageman', 'inormile', 'lmeehann', 'sknecht', 'kico', 'yhoashi', 'evandaele3', 'rao53', 'rice125']"
141,45,7,8,6,"['skkohei1102', 'saytt0923', 'shuhei55', 'moroikohei0529', 'yusuke_hamanaka', 'tell.your.world.2525']",0,[],2,"[None, 'kshimizu']",8,"['skkohei1102', 'shuhei55', 'saytt0923', 'kshimizu', 'moroikohei0529', 'yusuke_hamanaka', None, 'tell.your.world.2525']"
146,61,7,22,1,['waleed97'],5,"['hnobarani', 'zhufangjia941010', 'atoghraee', 'alecgantar', 'nsperger']",21,"['reing1ub', 'sandracheng', 'hadiyamadi', 'wdze1001', 'juanmanu04', 'ajfriedlan', 'e.desroche', 'kiranpreet.birdee', 'laura.burchell', 'turnergarrow', 'raanapooshimin', 'wolkoff.97', None, 'toto_bssnt', 'carmud', 'jakeerickson', 'sofiaarranz', 'robknobel', 'tmosh5', 'trix012', 'will.salmon66']",27,"['hnobarani', 'reing1ub', 'laura.burchell', 'turnergarrow', 'raanapooshimin', 'atoghraee', 'wolkoff.97', 'alecgantar', 'nsperger', 'sandracheng', None, 'hadiyamadi', 'waleed97', 'wdze1001', 'toto_bssnt', 'carmud', 'zhufangjia941010', 'jakeerickson', 'sofiaarranz', 'juanmanu04', 'robknobel', 'tmosh5', 'ajfriedlan', 'e.desroche', 'trix012', 'kiranpreet.birdee', 'will.salmon66']"
149,98,6,39,2,"['sachimalkan', 'himanisheth98']",3,"['ameysawant25597', 'jaineelnandu', 'yashsavle']",37,"['shrutisneha.prasad', 'tanuj.udani', 'prajaktapatil', '2015vipra.arolkar', 'aa9858203050', 'aniketozarkar', 'aakashmeshram', 'dhairyagada1997', '2015anuj.pakhare', '2015prachi.kothawade', '2015deepak', '2015omkar.tulaskar', 'ej2013.ankit.panvalkar', 'aartimaurya5', 'lairai9', 'ujwala.pol', 'jayesh.bhosale', 'ajitjadhav', 'sankalp8055', '2015varun.gokhale', 'tanviwagh', 'kaushal37', 'zobe97', '2015soham.sawant', '2015pratik.warke', 'varunswadia', '2015soumya.chinthalapudi', '2015mukul.sharma', None, '2015radhika.angolkar', '2015sanika.pathare', '2015rasika.wagh', '2015nitish.nayak', '2015riya.maheshwari', '2015manas.kulkarni', 'shreyas.sshende', 'rohit24k']",42,"['shrutisneha.prasad', 'tanuj.udani', 'prajaktapatil', '2015vipra.arolkar', 'sachimalkan', 'aa9858203050', 'ameysawant25597', 'aniketozarkar', 'aakashmeshram', 'jaineelnandu', 'yashsavle', 'dhairyagada1997', '2015anuj.pakhare', '2015prachi.kothawade', '2015deepak', '2015omkar.tulaskar', 'ej2013.ankit.panvalkar', 'himanisheth98', 'aartimaurya5', 'lairai9', 'ujwala.pol', '2015manas.kulkarni', 'rohit24k', 'ajitjadhav', 'sankalp8055', '2015varun.gokhale', 'tanviwagh', 'kaushal37', 'zobe97', '2015pratik.warke', 'varunswadia', '2015soumya.chinthalapudi', '2015mukul.sharma', None, '2015radhika.angolkar', '2015sanika.pathare', '2015rasika.wagh', '2015nitish.nayak', '2015riya.maheshwari', '2015soham.sawant', 'shreyas.sshende', 'jayesh.bhosale']"
149,318,6,8,3,"['ameysawant25597', 'yashsavle', 'himanisheth98']",2,"['sachimalkan', 'jaineelnandu']",5,"['nande.manasi16', 'riddhis2411', 'agarwal.gagan5101', '1jyotsna1', None]",10,"['nande.manasi16', 'sachimalkan', None, 'riddhis2411', 'himanisheth98', 'agarwal.gagan5101', 'ameysawant25597', '1jyotsna1', 'jaineelnandu', 'yashsavle']"
153,82,6,52,4,"['shalalkhan18', 'areeba_khan', 'farhanthespy', 'fareha.saleem']",1,['daanyaalnerd97'],48,"['hariskshah', 'remshaa5', 'hnihallani75', 'syedzainrock8', 'daanyaal', 'saqibkamal', 'farahkareem5', 'mazeemkhanreal', 'kashasan15', 'syedazainabhassan16', 'saba_nadeem91', 'moizraza10', 'hassananwer1010', 'ilsa.khalid', 'mamonarao01', 'shehzad_ahmed10', 'bhaifaiz77', 'asadhussain765', 'm.naufil1', 'sheebaishtiaque.102', 'aqsaqasim10', 'ahmerinam99', 'owaisbashir26', 'taqdeesm3', 'khurramahmed1997', 'afnanmazhar', 'imtiazhira', 'mustafaarif12330', 'minhalrizvi98', 'shehzu94', 's.m.bahazad', 'habhutto2015', 'halamasood27', 'shayanali', None, 'khadimashoor437', 'aminahfatimah98', 'farahperveen72', 'saleem_008', 'hakeemorangzeb710', 'm.dawson', 'hamzaanwer', 'hamzaq44', 'el16009', 'aliirtaza98', 'ibeeey.a', 'faizanalibugti', 'iqra.javed1591997']",53,"['hariskshah', 'remshaa5', 'hnihallani75', 'syedzainrock8', 'daanyaal', 'saqibkamal', 'farhanthespy', 'farahkareem5', 'mazeemkhanreal', 'areeba_khan', 'kashasan15', 'syedazainabhassan16', 'saba_nadeem91', 'moizraza10', 'hassananwer1010', 'ilsa.khalid', 'mamonarao01', 'shehzad_ahmed10', 'bhaifaiz77', 'asadhussain765', 'm.naufil1', 'sheebaishtiaque.102', 'aqsaqasim10', 'ahmerinam99', 'owaisbashir26', 'taqdeesm3', 'khurramahmed1997', 'afnanmazhar', 'imtiazhira', 'mustafaarif12330', 'minhalrizvi98', 'shehzu94', 's.m.bahazad', 'habhutto2015', 'halamasood27', 'daanyaalnerd97', 'shayanali', 'shalalkhan18', None, 'khadimashoor437', 'aminahfatimah98', 'farahperveen72', 'saleem_008', 'hakeemorangzeb710', 'm.dawson', 'hamzaanwer', 'hamzaq44', 'el16009', 'aliirtaza98', 'ibeeey.a', 'faizanalibugti', 'iqra.javed1591997', 'fareha.saleem']"
153,134,6,40,5,"['farhanthespy', 'daanyaalnerd97', 'shalalkhan18', 'areeba_khan', 'fareha.saleem']",0,[],35,"['bismaraoluqman', 'hariskshah', 'syedzainrock8', 'saqibkamal', 'sabaq165', 'zainabnazeer456', 'syedazainabhassan16', 'hassananwer1010', 'shehzad_ahmed10', 'mamonarao01', 'bhaifaiz77', 'm.naufil1', 'aqsaqasim10', 'bahazad.syed', 'waleedkhalid924', 'hareem.ahsan98', 'imtiazhira', 'mustafaarif12330', 'minhalrizvi98', 'bushrashahab01', 'shayanali', 'halamasood27', 'ashna', 'moonasayal', None, 'khadimashoor437', 'aminahfatimah98', 'saleem_008', 'm.dawson', 'hamzaanwer', 'hamzaq44', 'el16009', 'aliirtaza98', 'bushradayo', 'iqra.javed1591997']",40,"['bismaraoluqman', 'hariskshah', 'syedzainrock8', 'saqibkamal', 'farhanthespy', 'sabaq165', 'zainabnazeer456', 'areeba_khan', 'syedazainabhassan16', 'hassananwer1010', 'shehzad_ahmed10', 'mamonarao01', 'bhaifaiz77', 'm.naufil1', 'aqsaqasim10', 'bahazad.syed', 'waleedkhalid924', 'hareem.ahsan98', 'imtiazhira', 'mustafaarif12330', 'minhalrizvi98', 'bushrashahab01', 'shayanali', 'halamasood27', 'daanyaalnerd97', 'ashna', 'shalalkhan18', 'moonasayal', None, 'khadimashoor437', 'aminahfatimah98', 'saleem_008', 'm.dawson', 'hamzaanwer', 'hamzaq44', 'el16009', 'aliirtaza98', 'bushradayo', 'iqra.javed1591997', 'fareha.saleem']"
153,84,6,29,4,"['shalalkhan18', 'areeba_khan', 'daanyaalnerd97', 'fareha.saleem']",1,['farhanthespy'],25,"['bismaraoluqman', 'hariskshah', 'owaisbukhari257', 'samiyajabbar', 'farahkareem5', 'halamasood27', 's_huzaifa', 'ashna', 'moizraza10', 'ibrahimahmedmughal', 'moonasayal', 'ilsa.khalid', 'ateefasiddiqui', 'shehzad_ahmed10', None, 'rubarasheed5678', 'aminahfatimah98', 'm.naufil1', 'sufzpq', 'kausarsaleem65', 'hamzaanwer', 'hareemmustafa', 'hareem.ahsan98', 'iqra.javed1591997', 'bushradayo']",30,"['bismaraoluqman', 'hariskshah', 'owaisbukhari257', 'farhanthespy', 'farahkareem5', 's_huzaifa', 'areeba_khan', 'moizraza10', 'ilsa.khalid', 'ateefasiddiqui', 'shehzad_ahmed10', 'm.naufil1', 'sufzpq', 'kausarsaleem65', 'hareem.ahsan98', 'samiyajabbar', 'halamasood27', 'daanyaalnerd97', 'ashna', 'shalalkhan18', 'ibrahimahmedmughal', 'moonasayal', None, 'rubarasheed5678', 'aminahfatimah98', 'hamzaanwer', 'hareemmustafa', 'bushradayo', 'iqra.javed1591997', 'fareha.saleem']"
158,7,6,18,5,"['jmc7066', 'rqm5425', 'sxn266', 'yvy5250', 'jmw6448']",0,[],13,"['tzt74', 'hkz5032', 'cjw5647', 'mikeyu1997', 'jaw6297', 'fjj5032', 'kxz172', 'cannansong', 'e78yui', 'rsc5261', 'mxl5509', None, 'saa5966']",18,"['hkz5032', 'mikeyu1997', 'jaw6297', 'kxz172', 'e78yui', 'rsc5261', 'mxl5509', None, 'yvy5250', 'jmw6448', 'saa5966', 'tzt74', 'rqm5425', 'cjw5647', 'fjj5032', 'sxn266', 'cannansong', 'jmc7066']"
158,172,6,6,5,"['jmc7066', 'rqm5425', 'sxn266', 'yvy5250', 'jmw6448']",0,[],1,[None],6,"['jmc7066', 'rqm5425', 'sxn266', None, 'yvy5250', 'jmw6448']"
161,70,6,127,4,"['rachel318318', 'afalkenb', 'agalema1027', 'kevinodonnell0878']",1,['radhakr3'],123,"['akreuter', 'tylera2104', 'kamranahmed', 'btestin14', 'osborn45', 'jacob_just', 'ryan.wiebe', 'nt230', 'agarw105', 'wstolz', 'suhaira97', 'akreilein', 'itsmemario', 'ksjolund', 'tgiazzon', 'john1886', 'cmelchin', 'charlesma423', 'ryanwest1040', 'george7elias', 'rjleach', 'boninim', 'rkwiatko', 'jkekre', 'cclapham', 'fischermben', 'greid09', 'spring12', 'mcrees', 'landon.glunt', 'ebergqu', 'psumner', 'buck17', 'davi1004', 'nathanmoore', 'angbecker', 'sammyknecht', 'sueprasad8214', 'hannahdeboer0015', 'cputt', 'kewlkahtz', 'amckeska', 'ebehring', 'treyfinn98', 'mcclurez', 'canadaman87', 'mishra59', 'alyssamcnarney', 'aboza', 'snowh5696', 'cartmaster007', 'baker428', 'munselltom', 'shaunak0304', 'anthonm', 'ikstealth', 'hkohart', 'dgreiwe', 'chiranth7954', 'htorsina', 'sfgdfgdfg', 'jwoon', 'jstalbaum', 'kellhages37', 'white519', 'nmcphero', 'shadow66666', 'ckroger', 'ehonebri', 'talon34567', 'fahimvora12', 'jacobglvn', 'rishiprasadha', 'jfolkers', 'swift8', 'joshuajkporter', 'draosmail', 'suran9712', 'akonopa', 'oliver67', 'hess35', 'asartor', 'crhodine', 'tilley0', 'mingusnate', 'kjh94425', 'rice103', 'royriveraf', 'dodge4', 'jacobpeterson698', 'jswetlik', 'hanmoyuan1997', 'garret28', 'wdrummon', 'maxwellfra16', 'mcclure8', 'nikhilcarneiro4', 'hkaakeh', 'kkamiya', 'cameronfritts12', 'kruege14', 'wallac68', 'dkilgor', 'herr13', 'nggoodie98', 'rsusler', 'imran3', 'kknowlto', 'batram197', 'brandt18', 'jskeens', 'acostab', 'bradsmrdel', 'jklaben', 'vcotta', 'lmeehann', 'goh5', 'mccaul', 'k.ico246', 'yhoashi', 'rao53', 'singh378', 'rileyedelaney']",128,"['tylera2104', 'btestin14', 'jacob_just', 'ryan.wiebe', 'nt230', 'agarw105', 'wstolz', 'itsmemario', 'afalkenb', 'tgiazzon', 'rkwiatko', 'jkekre', 'mcrees', 'psumner', 'buck17', 'sammyknecht', 'sueprasad8214', 'hannahdeboer0015', 'cputt', 'amckeska', 'mcclurez', 'alyssamcnarney', 'shaunak0304', 'anthonm', 'hkohart', 'dgreiwe', 'sfgdfgdfg', 'jstalbaum', 'fahimvora12', 'rishiprasadha', 'swift8', 'draosmail', 'akonopa', 'hess35', 'crhodine', 'tilley0', 'mingusnate', 'kjh94425', 'rice103', 'dodge4', 'mcclure8', 'nikhilcarneiro4', 'hkaakeh', 'kkamiya', 'herr13', 'nggoodie98', 'rsusler', 'imran3', 'batram197', 'brandt18', 'bradsmrdel', 'vcotta', 'goh5', 'singh378', 'rileyedelaney', 'akreuter', 'kamranahmed', 'osborn45', 'suhaira97', 'akreilein', 'ksjolund', 'john1886', 'cmelchin', 'charlesma423', 'ryanwest1040', 'george7elias', 'rjleach', 'boninim', 'cclapham', 'fischermben', 'greid09', 'spring12', 'landon.glunt', 'ebergqu', 'davi1004', 'nathanmoore', 'angbecker', 'kewlkahtz', 'ebehring', 'treyfinn98', 'canadaman87', 'mishra59', 'aboza', 'snowh5696', 'cartmaster007', 'baker428', 'munselltom', 'ikstealth', 'chiranth7954', 'htorsina', 'jwoon', 'kellhages37', 'white519', 'nmcphero', 'shadow66666', 'ckroger', 'ehonebri', 'talon34567', 'agalema1027', 'radhakr3', 'jacobglvn', 'jfolkers', 'joshuajkporter', 'rachel318318', 'suran9712', 'oliver67', 'asartor', 'royriveraf', 'jacobpeterson698', 'jswetlik', 'hanmoyuan1997', 'garret28', 'wdrummon', 'maxwellfra16', 'cameronfritts12', 'kruege14', 'wallac68', 'dkilgor', 'kknowlto', 'jskeens', 'acostab', 'jklaben', 'kevinodonnell0878', 'lmeehann', 'mccaul', 'k.ico246', 'yhoashi', 'rao53']"
161,216,6,126,4,"['radhakr3', 'afalkenb', 'agalema1027', 'kevinodonnell0878']",1,['rachel318318'],122,"['ggauthi', 'geyerg', 'arturotrevino', 'wan52', 'akreuter', 'yeager5', 'bsmrdel', 'vwallema', 'btestin14', 'starr21', 'vpope', 'nt230', 'wstolz', 'suhaira97', 'ikobayas', 'yang1206', 'xng', 'lee2370', 'itsmemario', 'conner.swift8', 'eforti', 'jrohman', 'john1886', 'tgiazzon', 'justj', 'cmelchin', 'ryanwest1040', 'charlesma423', 'george7elias', 'boninim', 'evdaly', 'jkekre', 'cclapham', 'fischermben', 'landon.glunt', 'mcrees', 'jdanek', 'psumner', 'cbischof', 'rao75', 'kgmcginley', 'nathanmoore', 'angbecker', 'samm', 'sueprasad8214', 'ggolla', 'chanwoo.lee.17', 'amckeska', 'ebehring', 'ryry1644', 'dschull', 'nafandi', 'purduechen2203', 'cartmaster007', 'hyndmanjustin', 'davids19', 'anthonm', 'dgreiwe', 'chiranth7954', 'smit3180', 'jwoon', 'caldwe29', 'shaw108', 'nhdorcy', 'ehonebri', 'shadow66666', 'talon34567', 'huan1146', 'rishiprasadha', 'cpiepen', 'jacobglvn', 'jfolkers', 'joshuajkporter', 'suran9712', 'akonopa', 'oliver67', 'hess35', 'kskripakaran0810', 'asartor', 'tilley0', 'crhodine', 'mingusnate', 'kjh94425', 'maxwellfra16', 'garret28', 'zjohnson834', 'rhellyer', 'mcclure8', 'nikhilcarneiro4', 'jkueche', 'kruege14', 'albrect', 'nramli', 'ecronin', 'dkilgor', 'heinzt', 'akreilei', 'srasche', 'rsusler', 'rwiebe', 'mcdona85', 'kknowlto', None, 'river132', 'jskeens', 'yizhizhang', 'selawada', 'dsfgdsfg', 'acostab', 'tthieles', 'khageman', 'lmeehann', 'sknecht', 'goh5', 'kico', 'mccaul', 'rao53', 'muelle77', 'aguyre', 'singh378', 'rileyedelaney', 'athoman']",127,"['ggauthi', 'arturotrevino', 'wan52', 'vwallema', 'btestin14', 'starr21', 'nt230', 'wstolz', 'xng', 'itsmemario', 'conner.swift8', 'eforti', 'afalkenb', 'tgiazzon', 'evdaly', 'jkekre', 'mcrees', 'jdanek', 'psumner', 'cbischof', 'kgmcginley', 'sueprasad8214', 'amckeska', 'nafandi', 'davids19', 'anthonm', 'dgreiwe', 'smit3180', 'rishiprasadha', 'akonopa', 'hess35', 'tilley0', 'crhodine', 'mingusnate', 'kjh94425', 'mcclure8', 'nikhilcarneiro4', 'srasche', 'rsusler', 'rwiebe', 'river132', 'selawada', 'dsfgdsfg', 'tthieles', 'khageman', 'sknecht', 'goh5', 'muelle77', 'aguyre', 'singh378', 'rileyedelaney', 'geyerg', 'akreuter', 'yeager5', 'bsmrdel', 'vpope', 'suhaira97', 'ikobayas', 'yang1206', 'lee2370', 'jrohman', 'john1886', 'justj', 'cmelchin', 'ryanwest1040', 'charlesma423', 'george7elias', 'boninim', 'cclapham', 'fischermben', 'landon.glunt', 'rao75', 'nathanmoore', 'angbecker', 'samm', 'ggolla', 'chanwoo.lee.17', 'ebehring', 'ryry1644', 'dschull', 'purduechen2203', 'cartmaster007', 'hyndmanjustin', 'chiranth7954', 'jwoon', 'caldwe29', 'shaw108', 'nhdorcy', 'ehonebri', 'shadow66666', 'talon34567', 'agalema1027', 'radhakr3', 'huan1146', 'cpiepen', 'jacobglvn', 'jfolkers', 'joshuajkporter', 'rachel318318', 'suran9712', 'oliver67', 'kskripakaran0810', 'asartor', 'maxwellfra16', 'garret28', 'zjohnson834', 'rhellyer', 'jkueche', 'kruege14', 'albrect', 'nramli', 'ecronin', 'dkilgor', 'heinzt', 'akreilei', 'mcdona85', 'kknowlto', None, 'jskeens', 'yizhizhang', 'acostab', 'kevinodonnell0878', 'lmeehann', 'kico', 'mccaul', 'rao53', 'athoman']"
161,206,6,119,4,"['radhakr3', 'afalkenb', 'agalema1027', 'kevinodonnell0878']",1,['rachel318318'],115,"['akreuter', 'prasad25', 'rwasem', 'osborn45', 'bkiep', 'ryan.wiebe', 'nt230', 'wstolz', 'robo698', 'itsmemario', 'conner.swift8', 'amagro', 'john1886', 'tgiazzon', 'guenthee2020', 'cmelchin', 'ryanwest1040', 'george7elias', 'justj', 'rjleach', 'boninim', 'evdaly', 'cclapham', 'fischermben', 'jbartlin', 'landon.glunt', 'mcrees', 'ebergqu', 'tanderto', 'jdanek', 'buck17', 'scoan', 'kgmcginley', 'nathanmoore', 'angbecker', 'julianjros', 'cputt', 'ebehring', 'engineeringkenyahub', 'mcclurez', 'ryry1644', 'canadaman87', 'dschull', 'mishra59', 'snowh5696', 'cartmaster007', 'baker428', 'jmaillet', 'anthonm', 'alineelquist', 'finn5', 'htorsina', 'jstalbaum', 'nhdorcy', 'shadow66666', 'talon34567', 'huan1146', 'rishiprasadha', 'cmeiste', 'jfolkers', 'joshuajkporter', 'suran9712', 'akonopa', 'oliver67', 'hess35', 'asartor', 'wang4150', 'crhodine', 'nriaziat', 'kjh94425', 'mingusnate', 'dodge4', 'smoinudd', 'maxwellfra16', 'garret28', 'zjohnson834', 'jmacklem', 'mcclure8', 'cameronfritts12', 'hkaakeh', 'kkamiya', 'jswetlik', 'kruege14', 'albrect', 'heinzt', 'herr13', 'srasche', 'akreilei', 'nggoodie98', 'rsusler', 'mzentner', 'kknowlto', 'nbitner', 'river132', None, 'jskeens', 'yizhizhang', 'dsfgdsfg', 'sumner3', 'benoit1', 'khageman', 'inormile', 'jklaben', 'sknecht', 'goh5', 'lesteryhz', 'lmeehann', 'kico', 'mccaul', 'rodri454', 'evandaele3', 'rao53', 'rice125', 'athoman', 'aratkov']",120,"['akreuter', 'prasad25', 'rwasem', 'osborn45', 'bkiep', 'ryan.wiebe', 'nt230', 'wstolz', 'robo698', 'itsmemario', 'conner.swift8', 'amagro', 'john1886', 'afalkenb', 'tgiazzon', 'guenthee2020', 'cmelchin', 'ryanwest1040', 'george7elias', 'justj', 'rjleach', 'boninim', 'evdaly', 'cclapham', 'fischermben', 'jbartlin', 'landon.glunt', 'mcrees', 'ebergqu', 'tanderto', 'jdanek', 'buck17', 'scoan', 'kgmcginley', 'nathanmoore', 'angbecker', 'julianjros', 'cputt', 'ebehring', 'engineeringkenyahub', 'mcclurez', 'ryry1644', 'canadaman87', 'dschull', 'mishra59', 'snowh5696', 'cartmaster007', 'baker428', 'jmaillet', 'anthonm', 'alineelquist', 'finn5', 'htorsina', 'jstalbaum', 'nhdorcy', 'shadow66666', 'talon34567', 'agalema1027', 'radhakr3', 'rishiprasadha', 'cmeiste', 'huan1146', 'jfolkers', 'joshuajkporter', 'rachel318318', 'suran9712', 'akonopa', 'oliver67', 'hess35', 'asartor', 'wang4150', 'crhodine', 'nriaziat', 'kjh94425', 'mingusnate', 'dodge4', 'smoinudd', 'maxwellfra16', 'garret28', 'zjohnson834', 'jmacklem', 'mcclure8', 'cameronfritts12', 'hkaakeh', 'kkamiya', 'jswetlik', 'kruege14', 'albrect', 'heinzt', 'herr13', 'srasche', 'akreilei', 'nggoodie98', 'rsusler', 'mzentner', 'kknowlto', 'nbitner', 'river132', None, 'jskeens', 'yizhizhang', 'dsfgdsfg', 'sumner3', 'benoit1', 'kevinodonnell0878', 'khageman', 'inormile', 'sknecht', 'goh5', 'lesteryhz', 'jklaben', 'lmeehann', 'kico', 'mccaul', 'rodri454', 'evandaele3', 'rao53', 'rice125', 'athoman', 'aratkov']"
161,207,6,82,1,['kevinodonnell0878'],4,"['rachel318318', 'radhakr3', 'afalkenb', 'agalema1027']",81,"['ggauthi', 'akreuter', 'rwasem', 'btestin14', 'ryan.wiebe', 'yang1206', 'nt230', 'wstolz', 'suhaira97', 'ikobayas', 'vpope', 'robo698', 'conner.swift8', 'john1886', 'tgiazzon', 'ryanwest1040', 'cmelchin', 'rjleach', 'cclapham', 'jkekre', 'semond', 'fischermben', 'landon.glunt', 'mcrees', 'buck17', 'kgmcginley', 'nathanmoore', 'angbecker', 'jaggarw', 'cputt', 'ryry1644', 'treyfinn98', 'dschull', 'cartmaster007', 'hyndmanjustin', 'baker428', 'munselltom', 'anthonm', 'enadler', 'dgreiwe', 'chiranth7954', 'shadow66666', 'jacobglvn', 'cmeiste', 'jfolkers', 'tobitrack55', 'joshuajkporter', 'oliver67', 'hess35', 'kskripakaran0810', 'wang4150', 'crhodine', 'bihmike', 'mingusnate', 'mart1226', 'dodge4', 'garret28', 'zjohnson834', 'mcclure8', 'kruege14', 'heinzt', 'akreilei', 'nggoodie98', 'rsusler', 'kknowlto', None, 'river132', 'jskeens', 'yizhizhang', 'dsfgdsfg', 'acostab', 'khageman', 'jklaben', 'sknecht', 'kico', 'mccaul', 'ziadan', 'rao53', 'mlinsin', 'rileyedelaney', 'athoman']",86,"['ggauthi', 'akreuter', 'rwasem', 'btestin14', 'ryan.wiebe', 'yang1206', 'nt230', 'wstolz', 'suhaira97', 'ikobayas', 'vpope', 'robo698', 'conner.swift8', 'john1886', 'afalkenb', 'tgiazzon', 'ryanwest1040', 'cmelchin', 'rjleach', 'cclapham', 'jkekre', 'semond', 'fischermben', 'landon.glunt', 'mcrees', 'buck17', 'kgmcginley', 'nathanmoore', 'angbecker', 'jaggarw', 'cputt', 'ryry1644', 'treyfinn98', 'dschull', 'cartmaster007', 'hyndmanjustin', 'baker428', 'munselltom', 'anthonm', 'enadler', 'dgreiwe', 'chiranth7954', 'shadow66666', 'agalema1027', 'radhakr3', 'cmeiste', 'jacobglvn', 'tobitrack55', 'jfolkers', 'joshuajkporter', 'rachel318318', 'oliver67', 'hess35', 'kskripakaran0810', 'wang4150', 'crhodine', 'bihmike', 'mingusnate', 'mart1226', 'dodge4', 'garret28', 'zjohnson834', 'mcclure8', 'kruege14', 'heinzt', 'akreilei', 'nggoodie98', 'rsusler', 'kknowlto', None, 'river132', 'jskeens', 'yizhizhang', 'dsfgdsfg', 'acostab', 'khageman', 'kevinodonnell0878', 'jklaben', 'sknecht', 'kico', 'mccaul', 'ziadan', 'rao53', 'mlinsin', 'rileyedelaney', 'athoman']"
161,285,6,44,3,"['afalkenb', 'rachel318318', 'kevinodonnell0878']",2,"['agalema1027', 'radhakr3']",41,"['atamvaki', 'jboulayd', 'blohithrao', 'dast', 'sdhillo', 'hriddle', 'jtwaddle', 'zooks99', 'azalar', 'nfschadler', 'brenna13', 'myers283', 'vpatel', 'hali85', 'stewa207', 'jlueck', 'jtonges', 'marisol', 'zyma', 'matthewguido', 'kole.mcginn', None, 'atkins18', 'cole141', 'sgudeman', 'marcusgunyon', 'fmuehlem', 'knies0', 'ianbernander', 'krishn75', 'xie317', 'singh386', 'lin814', 'jmeneze', 'bfielde', 'mmulter', 'post10', 'kolispeter', 'batram', 'aharbin', 'slagles']",46,"['atamvaki', 'jboulayd', 'blohithrao', 'agalema1027', 'radhakr3', 'dast', 'sdhillo', 'rachel318318', 'hriddle', 'afalkenb', 'jtwaddle', 'zooks99', 'azalar', 'nfschadler', 'brenna13', 'myers283', 'vpatel', 'hali85', 'stewa207', 'jlueck', 'marisol', 'zyma', 'slagles', 'matthewguido', 'kole.mcginn', None, 'atkins18', 'cole141', 'sgudeman', 'marcusgunyon', 'kevinodonnell0878', 'fmuehlem', 'knies0', 'ianbernander', 'krishn75', 'xie317', 'singh386', 'lin814', 'jmeneze', 'bfielde', 'mmulter', 'post10', 'kolispeter', 'batram', 'aharbin', 'jtonges']"
161,286,6,40,5,"['kevinodonnell0878', 'afalkenb', 'agalema1027', 'radhakr3', 'rachel318318']",0,[],35,"['jboulayd', 'bjendrus', 'dast', 'sdhillo', 'jbarsima', 'sundara6', 'ali85', 'hriddle', 'wscottharding', 'rauche', 'zooks99', 'azalar', 'nfschadler', 'myers283', 'stewa207', 'jlueck', 'cheeseballs99', 'zyma', 'awassmer', None, 'mmoulin', 'klein61', 'ffrank', 'cole141', 'marcusgunyon', 'knies0', 'ianbernander', 'krishn75', 'xie317', 'kswiatk9581', 'bfielde', 'mmulter', 'post10', 'batram', 'aharbin']",40,"['jboulayd', 'bjendrus', 'agalema1027', 'radhakr3', 'dast', 'sdhillo', 'rachel318318', 'jbarsima', 'sundara6', 'ali85', 'hriddle', 'wscottharding', 'afalkenb', 'rauche', 'zooks99', 'azalar', 'nfschadler', 'myers283', 'stewa207', 'jlueck', 'cheeseballs99', 'zyma', 'awassmer', None, 'mmoulin', 'klein61', 'ffrank', 'cole141', 'marcusgunyon', 'kevinodonnell0878', 'knies0', 'ianbernander', 'krishn75', 'xie317', 'kswiatk9581', 'bfielde', 'mmulter', 'post10', 'batram', 'aharbin']"
162,363,6,8,4,"['jbhernadez1004', 'luisca1925', 'marissacerdas', 'evyquiros.7']",1,['pwalke23'],4,"['arisandi97', 'feraya09', None, 'andrea.zu97']",9,"['pwalke23', 'feraya09', 'luisca1925', 'marissacerdas', 'arisandi97', 'jbhernadez1004', None, 'andrea.zu97', 'evyquiros.7']"
165,114,6,32,2,"['leovall', 'mphilbri']",3,"['agambi', 'spelliz', 'rajpatra']",30,"['clindn', 'pinea', 'annakcha', 'apielack', 'allendc', 'dwangy', 'liutif', 'jojoco', 'brenrice', 'ehsi', 'malhark', 'avibreg', 'ggracevr', 'jepi', 'mgratows', 'cjbmi', 'brdemarc', 'hteutsch', 'ybeeker', 'hgaudin', 'eraeker', 'zouhaox', None, 'rotenmax', 'serenad', 'haileymk', 'blanzyt', 'ksallans', 'rishavc', 'reedy']",35,"['agambi', 'clindn', 'pinea', 'annakcha', 'apielack', 'allendc', 'rajpatra', 'dwangy', 'liutif', 'jojoco', 'brenrice', 'mphilbri', 'ehsi', 'leovall', 'malhark', 'spelliz', 'avibreg', 'ggracevr', 'jepi', 'mgratows', 'cjbmi', 'brdemarc', 'hteutsch', 'ybeeker', 'hgaudin', 'eraeker', 'zouhaox', None, 'rotenmax', 'serenad', 'haileymk', 'blanzyt', 'ksallans', 'rishavc', 'reedy']"
167,270,6,7,5,"['sjr0031', 'gpkelly', 'jamccauley', 'jphiggins', 'snjohnson1']",0,[],2,"[None, 'lefr95']",7,"['sjr0031', 'gpkelly', 'snjohnson1', 'jphiggins', 'jamccauley', None, 'lefr95']"
167,274,6,7,5,"['sjr0031', 'gpkelly', 'jamccauley', 'jphiggins', 'snjohnson1']",0,[],2,"[None, 'lefr95']",7,"['sjr0031', 'gpkelly', 'snjohnson1', 'jphiggins', 'jamccauley', None, 'lefr95']"
172,176,6,10,2,"['tasmitasmi', 'bchen026']",3,"['lc1d', 'xarkangelx', 'rostak1']",8,"['sshan009', 'seiginokishidan', None, 'heatinglemon', 'raymondnguyen51', 'ddawg', 'jpena017', 'nsciu001']",13,"['tasmitasmi', 'bchen026', 'sshan009', 'seiginokishidan', None, 'xarkangelx', 'heatinglemon', 'raymondnguyen51', 'rostak1', 'ddawg', 'lc1d', 'jpena017', 'nsciu001']"
