MClusterID,XClusterID,MClusterSize,XClusterSize,OverlapSize,OverlapMembers,MOnlySize,MOnlyMembers,XOnlySize,XOnlyMembers,CombinedSize,CombinedMembers
1,386,283,183,5,"['sgu20171552', 'vmike0426', 'sgu20171546', 'sug20171516', 'sgu20171596']",278,"['kirollos.atef99', 'farid1010', 'sgu20161468', 'nohaabdelazeem11', 'mohamedsamir2591998', 'ahmed_mohsen', 'pshrap37', 'karim..mohamed745', 'okanssabah', 'ozanemreercan', 'sgu20161506', 'daniel.', 'mmhanafy99', 'heshamelsedfy111', 'sgu20191512', 'sgu20151432', 'mai99mahdy', 'amr.m.araby', 'sgu20161512', 'mobahr', 'mephistokc', 'sgu20171492', 'maxwest', 'badryahmed33', 'mohamedelfeeky1', 'jchamarthi', 'michelhakim2001.mh', 'abdelrahman98', 'zazotop31', 'abdelrahmananwar', 'jisooyoon', 'michaelhelal99', 'sgu20171560', 'sgu20161466', 'aminsalah287', 'mayanmohamed', 'sgu20161541', 'joker.man2000000', 'ahmedramadan', 'omar_anwer', 'sgu20161508', 'amy', 'erhan26uzun', 'sadboijalal', 'sgu20161486', 'fayrouz21415', 'ataozirmak', 'boules', 'moh.nabil2050', 'nadakhaled', 'sgu20171588', 'fabio.signorelli', 'mohamed248688', 'abdelmoneim404', 'sgu20191492', 'sgu20151431', 'comebacktome', 'nadeenmagdyy', 'sal7ien1999', 'sgu20151426', 'tpcks96', 'romanynashaatmakeen', 'ampmstrawberryjam26', 'enesqwe', 'barkinsrc5', 'm.trika1999', 'ahmedyosre007', 'sgu20191494', 'youjiyeon', 'sgu20181504', 'dodynn29', 'rubenasa', 'mohameda.younis80', 'mohamed_a_mostafa', 'amr.ghoname.teaching', 'ahmedsaeed', 'sgu20161556', 'my1hunter', 'nada0abou0alsoud', 'sgu20181576', 'atknncvkkl', 'af5012175', 'kerolosmfawzy', 'sgu20161536', 'raneemgaber', 'tutku', 'zhenming', 'sgu20161497', 'sgu20161460', 'juni8472', 'raa199014', 'sgu20171582', 'reemayman101', 'youssefessawy', 'robikar', 'sgu20171510', 'esraayahia21', 'taha18499', 'sgu20171530', 'roshdy.aa', 'ahmedkamal', 'amrksh3198', 'ramezakram97', 'demonkaksh', 'mernaeshakfaheem', 'pamilapoopad', 'moataz12mokhtar', 'jualipa1995', 'metoyahia1999', 'hmsgsaad', 'bguillet', 'yaseensalah83', 'nayeramakram98', 'kminhsu', 'ahmedokasha1999', 'tpranto', 'sgu20171592', 'sgu20171566', 'marcomuzzarelli', 'sgu20171496', 'amartiger2020', 'melegy99', 'sgu20171528', 'tongmalual', 'sgu20191490', 'fatihakyurek26', 'yilmaazmert', 'abdelrahman_oun', 'nourmahmoud', 'ranasherif244', 'mustafamahmoud567', 'bassant.ahmed235', 'mayaralmazy', 'sgu20191550', 'ittopsk', 'sgu20191454', 'hosamshaher43', 'cyrillemagdi', 'salmatarek87', 'sug20182194', 'ebrahim.almohandes', 'sgu20191534', 'sgu20161507', 'sgu20191466', 'b715063minbyeongmoon', 'sgu20151500', 'bassant.ahmed20118', 'sgu20191496', 'wyattm', 'sgu20161516', 'mamoundiouri', 'sgu20161518', 'sgu20151461', 'sgu20171536', 'mohannadragab53', 'beoungwoo', 'abdulsamad', 'shadymagdy99', 'yubhop', 'jaeeun53', 'sgu20151414', 'abdoulkh', 'seifelawadi26', 'hosamabdallah00', 'btngana1', 'ramymohsen', 'nizquierdo', 'almekamobilya', 'sgu20171594', 'mayadamarie', 'werr011', 'karim20103200', 'sgu20181330', 'andrewmon', 'omaraly112', 'sgu20171534', 'sgu20151878', 'marwanahmad988', 'jpuko11', 'sohamamdooh', 'sgu20151434', 'raniamuhamed44', 'sgu20171564', 'zldrktgusrbs3242', 'yusufcheetos99', 'jihongkim', 'sgu20151428', 'ziad.amr201666', 'adham99', 'sgu20161528', 'jaegisehyun', 'sgu20151480', 'cbortlek', 'generalshephrd', 'abdulrahman.hussien1999', 'josef.me22', 'sgu20161488', 'mohamed.eid1014', 'harvovich', 'ardasavas6', 'manjunath216', 'tndukaife2018', 'jpuko00', 'getray.ah', 'their123', 'sgu20191462', 'alaa15eltehewey', 'ervndgn59', 'jihyeonlee', 'mohamed_98', 'ahmadatef580', 'habiba.elkassas', 'youssefsamiryoussef', 'abdallahhashim', 'haidy_emad', 'maged19991926', 'sgu20151421', 'omarnabih21', 'mahmodfarag2000', 'b919083', 'yahiahamimi', 'yashhiteshbh', 'ingyawad14', 'saga102938', 'sogang20191452', 'mpsingh', 'wodh97', 'ahmed_omar', 'youssefhassaan99', 'mirko.capodicasa', 'sgu20171516', 'ekicifatih0', 'ahmedmostafa5499', 'doraexplora', 'sgu20151488', 'ashraf.amr82', 'tanseerali', 'nada.abomoslim', 'sgu20151453', 'saca', 'mohamed.zna66', 'kareemmohamed68990', 'sgu20141461', 'sgu20161492', 'jlev713', 'm_feky', 'sgu20131274', 'mohamedsalah2', 'peterhorvath', 'sgu20171578', 'sgu20191476', 'sgu20171548', 'shrouk.a.emad', 'abdoelanwar99', 'tomymoty1', 'sgu20151467', 'rehab.sayed1231999', 'elsayedrafaat7', 'sgu20151507', 'rektxz', 'sgu20141740', 'hanmir', 'markashaf232', 'hye8913', 'ashraf_mohamed', 'fasd556.om', 'maged.magdy666', 'mariam123456789', 'sgu20171506', 'sgu20171503', 'dina.23elessawy', 'nourhanne.bahaa', 'a.ayman74', 'michael29699', 'marwanyasser133', 'taawsifrc', 'sgu20161538', 'faridmohammed98']",178,"['ardaulusan_14', 'espejodaniel6', 'liresaferizaj', 'verone.krasniqi', 'gjb56', 'artin.sermaxhaj', 'kastriotsalihu', 'edmondovalvo28', 'gentihyseni11', 'lookatfuture09', 'theharshit', 'keremino', 'mf3256', 'enkele', 'liviajanicew', 'kursatmutlu03', 'twcross11', 'kacp3r', 'jonathancollins55', 'kevinh88', 'tlsmarshall1', 'baczas996', 'jbertocc', 'rfneed', 'aleksandardunjic1999', 'bardha.januzi', 'fdirisaglik', 'jedelkind', 'hjhj8794', 'barbanataraheta', 'elona.rashica', 'jlanzoni18', 'jaylenwang', 'jasmina.rozek', 'atkncvkkl1', 'elona.gervalla', 'alberianatofaj', 'flamur', 'albina.ahmeti', 'albion', 'fidanhoxha', 'czes', 'nicolech73', 'redon.tahiri', 'dhilanr', 'lockbox30', 'hanife', 'elsaa', 'bayramdonmez96', 'cmunoz', 'enes.hasani', 'arnavsrivastava', 'ph33', 'smrf432', 'saxenapurva96', 'enweizhang732', 'karpuz', 'flamur.mustafa', 'ilir.jasharaj', 'cemaloz745', 'ft13', 'akdemirel99', 'reepl', 'kagangunes10', 'recaro13', 'yusufsabahoglu05', 'ekim.coskun19', 'donat.aliu147', 'musa.kadiri', 'sreevidya.c', 'nazifebeqiri59', 'andreheinzig', 'midie.merovci', 'jculp', 'albin.sejdiu', 'kfullen', 'yaohuichen', 'maan1742180', 'jmcveigh55', 'ducka.agata', 'jfmuller', 'kav68', 'klintiponari6', 'akshatpokharna7', 'ertugrul4101160', 'serhatiseri', '1jordanschwartz', 'njomza.ismaili', 'salem2', 'rita.kastrati', 'yellowturtle', 'szerefa', 'hary765', 'dkorakakis', 'domagoj.tomic', 'elton.kaqiu', 'samuelnxr', 'do356', 'mas2565', 'njomza.rexhepi3', 'lislimani', 'fabio.telesca', 'adonis.xhemajli', 'ml3566', 'koushik.cc', 'hanhdp99', 'pan_1238', 'yasinzgen', 'barbana.heta', 'erblina2berisha', 's.kasamatsu', 'krzysztof.golyga', 'laxman_18110093', 'solarwing', 'ben3862', 'artine.hoxha', 'florian.halimi1', 'acastro34', 'julinda.nasufi', 'canhuseyinnn', 'blerona.emini', 'patelba', 'ghosh_payel', 'zs2495', 'alpayy98', 'petrini', 'valeza.grainca', 'lendrit.ibrahimi', 'fraser_darling', 'tcp47', 'doruntina.hoti', 'mra4020', 'pospiechjoanna', 'burghoornniels', 'bernhardhaas55', 'qahoang', 'cristianololipops56', 'kianamon', 'ozcanguclu', 'clinlin9264', 'medinehajredini', 'davidosmanovic', 'bleon.alimi', 'andi.dika', 'bdn2113', 'emreyilmazel1996', 'taol190799', 'blerand.mjeku', 'emircansimsek', 'beskisehir', 'lado.filipovic', 'sara.haliti', 'jcjohnson', 'ora', 'cansecgin', 'cspiner', 'edgarm120397', 'lauragashi', 'piter15710', 'sd226', 'sakshi17jagtap', 'kv0001', 'aecarter', 'christianc2', 'nrcnaltinbas', 'scullyer16', 'lindkrasniqi', 'indyfisico', 'jpalko20', 'madharmes', 'erdonakrasniqi', 'bksharpe2021', 'gollner.laura', 'beni1', 'junchong10', 'lowen12', 'loreta.pajaziti1', 'hadesantiago17']",461,"['farid1010', 'ardaulusan_14', 'sgu20161468', 'nohaabdelazeem11', 'mohamedsamir2591998', 'espejodaniel6', 'verone.krasniqi', 'karim..mohamed745', 'okanssabah', 'ozanemreercan', 'sgu20161506', 'edmondovalvo28', 'sgu20191512', 'lookatfuture09', 'theharshit', 'mobahr', 'keremino', 'mf3256', 'kursatmutlu03', 'sgu20171492', 'twcross11', 'maxwest', 'badryahmed33', 'mohamedelfeeky1', 'jchamarthi', 'abdelrahman98', 'kevinh88', 'rfneed', 'aminsalah287', 'mayanmohamed', 'sgu20161541', 'aleksandardunjic1999', 'sgu20161486', 'bardha.januzi', 'fayrouz21415', 'fdirisaglik', 'jedelkind', 'jlanzoni18', 'barbanataraheta', 'sgu20171588', 'jasmina.rozek', 'mohamed248688', 'atkncvkkl1', 'sgu20191492', 'sgu20151431', 'comebacktome', 'nadeenmagdyy', 'flamur', 'tpcks96', 'romanynashaatmakeen', 'ampmstrawberryjam26', 'enesqwe', 'm.trika1999', 'ahmedyosre007', 'fidanhoxha', 'czes', 'nicolech73', 'redon.tahiri', 'sgu20181504', 'dodynn29', 'mohamed_a_mostafa', 'sgu20171552', 'sgu20161556', 'nada0abou0alsoud', 'dhilanr', 'lockbox30', 'hanife', 'sgu20181576', 'elsaa', 'af5012175', 'kerolosmfawzy', 'bayramdonmez96', 'raneemgaber', 'tutku', 'zhenming', 'sgu20161497', 'raa199014', 'ph33', 'smrf432', 'saxenapurva96', 'karpuz', 'reemayman101', 'youssefessawy', 'robikar', 'sgu20171510', 'esraayahia21', 'taha18499', 'ilir.jasharaj', 'sgu20171530', 'cemaloz745', 'ft13', 'ahmedkamal', 'akdemirel99', 'kagangunes10', 'amrksh3198', 'recaro13', 'yusufsabahoglu05', 'moataz12mokhtar', 'jualipa1995', 'musa.kadiri', 'hmsgsaad', 'bguillet', 'yaseensalah83', 'sreevidya.c', 'kminhsu', 'andreheinzig', 'ahmedokasha1999', 'tpranto', 'sgu20171592', 'sgu20171566', 'marcomuzzarelli', 'midie.merovci', 'jculp', 'albin.sejdiu', 'kfullen', 'jmcveigh55', 'jfmuller', 'yilmaazmert', 'ducka.agata', 'abdelrahman_oun', 'nourmahmoud', 'ranasherif244', 'mustafamahmoud567', 'klintiponari6', 'bassant.ahmed235', 'mayaralmazy', 'sgu20191550', 'sgu20191454', 'salmatarek87', 'serhatiseri', 'sgu20161507', 'sgu20191496', 'wyattm', 'sgu20161516', 'sgu20161518', 'mohannadragab53', 'hary765', 'abdulsamad', 'dkorakakis', 'yubhop', 'domagoj.tomic', 'samuelnxr', 'sgu20151414', 'do356', 'abdoulkh', 'seifelawadi26', 'hosamabdallah00', 'btngana1', 'ramymohsen', 'nizquierdo', 'almekamobilya', 'sgu20171594', 'mayadamarie', 'werr011', 'njomza.rexhepi3', 'sgu20181330', 'adonis.xhemajli', 'ml3566', 'koushik.cc', 'hanhdp99', 'erblina2berisha', 'sug20171516', 'sohamamdooh', 'sgu20171564', 'zldrktgusrbs3242', 'yusufcheetos99', 'krzysztof.golyga', 'jihongkim', 'sgu20151428', 'ziad.amr201666', 'adham99', 'sgu20161528', 'solarwing', 'sgu20151480', 'artine.hoxha', 'florian.halimi1', 'julinda.nasufi', 'canhuseyinnn', 'josef.me22', 'sgu20161488', 'blerona.emini', 'harvovich', 'ardasavas6', 'patelba', 'getray.ah', 'their123', 'zs2495', 'alpayy98', 'petrini', 'jihyeonlee', 'mohamed_98', 'fraser_darling', 'tcp47', 'mra4020', 'haidy_emad', 'omarnabih21', 'burghoornniels', 'bernhardhaas55', 'ingyawad14', 'cristianololipops56', 'ozcanguclu', 'clinlin9264', 'wodh97', 'davidosmanovic', 'ahmed_omar', 'youssefhassaan99', 'bdn2113', 'sgu20171516', 'ahmedmostafa5499', 'doraexplora', 'ashraf.amr82', 'emircansimsek', 'beskisehir', 'nada.abomoslim', 'sgu20151453', 'saca', 'kareemmohamed68990', 'sgu20141461', 'sara.haliti', 'jcjohnson', 'ora', 'lauragashi', 'sgu20131274', 'mohamedsalah2', 'sgu20171548', 'tomymoty1', 'sgu20151467', 'rehab.sayed1231999', 'aecarter', 'sgu20141740', 'hanmir', 'christianc2', 'hye8913', 'ashraf_mohamed', 'maged.magdy666', 'mariam123456789', 'sgu20171506', 'lindkrasniqi', 'jpalko20', 'nourhanne.bahaa', 'a.ayman74', 'marwanyasser133', 'erdonakrasniqi', 'sgu20161538', 'loreta.pajaziti1', 'hadesantiago17', 'kirollos.atef99', 'ahmed_mohsen', 'liresaferizaj', 'gjb56', 'pshrap37', 'daniel.', 'mmhanafy99', 'artin.sermaxhaj', 'kastriotsalihu', 'heshamelsedfy111', 'vmike0426', 'sgu20151432', 'amr.m.araby', 'mai99mahdy', 'sgu20161512', 'gentihyseni11', 'mephistokc', 'enkele', 'liviajanicew', 'michelhakim2001.mh', 'kacp3r', 'zazotop31', 'jonathancollins55', 'abdelrahmananwar', 'jisooyoon', 'tlsmarshall1', 'michaelhelal99', 'baczas996', 'sgu20171560', 'jbertocc', 'sgu20161466', 'joker.man2000000', 'ahmedramadan', 'omar_anwer', 'sgu20161508', 'amy', 'erhan26uzun', 'sadboijalal', 'ataozirmak', 'boules', 'hjhj8794', 'moh.nabil2050', 'nadakhaled', 'elona.rashica', 'fabio.signorelli', 'jaylenwang', 'elona.gervalla', 'abdelmoneim404', 'alberianatofaj', 'sal7ien1999', 'sgu20151426', 'albina.ahmeti', 'barkinsrc5', 'sgu20191494', 'albion', 'youjiyeon', 'rubenasa', 'mohameda.younis80', 'amr.ghoname.teaching', 'ahmedsaeed', 'my1hunter', 'atknncvkkl', 'sgu20161536', 'cmunoz', 'sgu20161460', 'juni8472', 'enes.hasani', 'sgu20171582', 'arnavsrivastava', 'enweizhang732', 'flamur.mustafa', 'roshdy.aa', 'reepl', 'ramezakram97', 'demonkaksh', 'mernaeshakfaheem', 'ekim.coskun19', 'pamilapoopad', 'donat.aliu147', 'metoyahia1999', 'nayeramakram98', 'nazifebeqiri59', 'sgu20171496', 'amartiger2020', 'yaohuichen', 'melegy99', 'sgu20171528', 'tongmalual', 'sgu20191490', 'fatihakyurek26', 'maan1742180', 'kav68', 'akshatpokharna7', 'ittopsk', 'hosamshaher43', 'cyrillemagdi', 'ertugrul4101160', 'sug20182194', 'ebrahim.almohandes', 'sgu20191534', '1jordanschwartz', 'sgu20191466', 'b715063minbyeongmoon', 'sgu20151500', 'bassant.ahmed20118', 'njomza.ismaili', 'salem2', 'mamoundiouri', 'sgu20151461', 'sgu20171536', 'rita.kastrati', 'yellowturtle', 'beoungwoo', 'szerefa', 'shadymagdy99', 'jaeeun53', 'elton.kaqiu', 'mas2565', 'karim20103200', 'lislimani', 'fabio.telesca', 'andrewmon', 'omaraly112', 'sgu20171534', 'sgu20151878', 'marwanahmad988', 'pan_1238', 'barbana.heta', 'jpuko11', 'sgu20171546', 'sgu20151434', 'raniamuhamed44', 's.kasamatsu', 'laxman_18110093', 'ben3862', 'jaegisehyun', 'cbortlek', 'generalshephrd', 'acastro34', 'abdulrahman.hussien1999', 'mohamed.eid1014', 'manjunath216', 'ghosh_payel', 'tndukaife2018', 'jpuko00', 'sgu20191462', 'alaa15eltehewey', 'ervndgn59', 'valeza.grainca', 'lendrit.ibrahimi', 'ahmadatef580', 'habiba.elkassas', 'youssefsamiryoussef', 'abdallahhashim', 'doruntina.hoti', 'maged19991926', 'sgu20151421', 'mahmodfarag2000', 'b919083', 'pospiechjoanna', 'yahiahamimi', 'yashhiteshbh', 'qahoang', 'saga102938', 'kianamon', 'sogang20191452', 'mpsingh', 'medinehajredini', 'andi.dika', 'bleon.alimi', 'taol190799', 'mirko.capodicasa', 'emreyilmazel1996', 'sgu20171596', 'blerand.mjeku', 'ekicifatih0', 'sgu20151488', 'tanseerali', 'lado.filipovic', 'mohamed.zna66', 'cansecgin', 'sgu20161492', 'jlev713', 'cspiner', 'm_feky', 'edgarm120397', 'piter15710', 'sd226', 'peterhorvath', 'sgu20171578', 'sgu20191476', 'sakshi17jagtap', 'shrouk.a.emad', 'kv0001', 'abdoelanwar99', 'elsayedrafaat7', 'sgu20151507', 'rektxz', 'markashaf232', 'nrcnaltinbas', 'scullyer16', 'fasd556.om', 'indyfisico', 'sgu20171503', 'dina.23elessawy', 'madharmes', 'michael29699', 'taawsifrc', 'bksharpe2021', 'gollner.laura', 'beni1', 'junchong10', 'lowen12', 'yasinzgen', 'faridmohammed98']"
1,23,283,147,136,"['kirollos.atef99', 'farid1010', 'mohamedsamir2591998', 'nohaabdelazeem11', 'ahmed_mohsen', 'daniel.', 'mmhanafy99', 'heshamelsedfy111', 'amr.m.araby', 'mai99mahdy', 'mobahr', 'michelhakim2001.mh', 'badryahmed33', 'zazotop31', 'mohamedelfeeky1', 'abdelrahman98', 'abdelrahmananwar', 'michaelhelal99', 'aminsalah287', 'mayanmohamed', 'omar_anwer', 'joker.man2000000', 'amy', 'sadboijalal', 'fayrouz21415', 'boules', 'nadakhaled', 'moh.nabil2050', 'mohamed248688', 'abdelmoneim404', 'nadeenmagdyy', 'sal7ien1999', 'romanynashaatmakeen', 'm.trika1999', 'ahmedyosre007', 'dodynn29', 'mohameda.younis80', 'mohamed_a_mostafa', 'amr.ghoname.teaching', 'ahmedsaeed', 'nada0abou0alsoud', 'af5012175', 'kerolosmfawzy', 'raneemgaber', 'raa199014', 'reemayman101', 'youssefessawy', 'esraayahia21', 'taha18499', 'ahmedkamal', 'amrksh3198', 'ramezakram97', 'mernaeshakfaheem', 'moataz12mokhtar', 'jualipa1995', 'metoyahia1999', 'hmsgsaad', 'yaseensalah83', 'nayeramakram98', 'ahmedokasha1999', 'amartiger2020', 'tongmalual', 'melegy99', 'abdelrahman_oun', 'nourmahmoud', 'ranasherif244', 'mustafamahmoud567', 'mayaralmazy', 'bassant.ahmed235', 'hosamshaher43', 'cyrillemagdi', 'salmatarek87', 'ebrahim.almohandes', 'bassant.ahmed20118', 'mohannadragab53', 'shadymagdy99', 'abdoulkh', 'seifelawadi26', 'btngana1', 'karim20103200', 'hosamabdallah00', 'ramymohsen', 'mayadamarie', 'omaraly112', 'marwanahmad988', 'raniamuhamed44', 'sohamamdooh', 'yusufcheetos99', 'ziad.amr201666', 'adham99', 'generalshephrd', 'abdulrahman.hussien1999', 'josef.me22', 'mohamed.eid1014', 'harvovich', 'getray.ah', 'alaa15eltehewey', 'mohamed_98', 'ahmadatef580', 'abdallahhashim', 'youssefsamiryoussef', 'habiba.elkassas', 'haidy_emad', 'maged19991926', 'omarnabih21', 'mahmodfarag2000', 'yahiahamimi', 'ingyawad14', 'ahmed_omar', 'youssefhassaan99', 'ahmedmostafa5499', 'doraexplora', 'ashraf.amr82', 'nada.abomoslim', 'saca', 'mohamed.zna66', 'kareemmohamed68990', 'm_feky', 'mohamedsalah2', 'shrouk.a.emad', 'elsayedrafaat7', 'tomymoty1', 'abdoelanwar99', 'rehab.sayed1231999', 'rektxz', 'markashaf232', 'ashraf_mohamed', 'fasd556.om', 'maged.magdy666', 'mariam123456789', 'dina.23elessawy', 'nourhanne.bahaa', 'a.ayman74', 'michael29699', 'marwanyasser133', 'faridmohammed98']",147,"['sgu20161468', 'pshrap37', 'karim..mohamed745', 'okanssabah', 'ozanemreercan', 'sgu20161506', 'vmike0426', 'sgu20151432', 'sgu20191512', 'sgu20161512', 'mephistokc', 'sgu20171492', 'maxwest', 'jchamarthi', 'jisooyoon', 'sgu20171560', 'sgu20161466', 'ahmedramadan', 'sgu20161541', 'sgu20161508', 'erhan26uzun', 'sgu20161486', 'ataozirmak', 'sgu20171588', 'fabio.signorelli', 'sgu20191492', 'sgu20151431', 'comebacktome', 'sgu20151426', 'tpcks96', 'ampmstrawberryjam26', 'enesqwe', 'barkinsrc5', 'sgu20191494', 'youjiyeon', 'sgu20181504', 'rubenasa', 'sgu20171552', 'sgu20161556', 'my1hunter', 'sgu20181576', 'atknncvkkl', 'sgu20161536', 'zhenming', 'tutku', 'sgu20161497', 'sgu20161460', 'juni8472', 'sgu20171582', 'robikar', 'sgu20171510', 'sgu20171530', 'roshdy.aa', 'demonkaksh', 'pamilapoopad', 'bguillet', 'kminhsu', 'tpranto', 'sgu20171592', 'sgu20171566', 'marcomuzzarelli', 'sgu20171496', 'sgu20171528', 'sgu20191490', 'fatihakyurek26', 'yilmaazmert', 'sgu20191550', 'ittopsk', 'sgu20191454', 'sug20182194', 'sgu20191534', 'sgu20191466', 'sgu20161507', 'sgu20151500', 'b715063minbyeongmoon', 'sgu20191496', 'wyattm', 'sgu20161516', 'mamoundiouri', 'sgu20161518', 'sgu20151461', 'sgu20171536', 'beoungwoo', 'abdulsamad', 'jaeeun53', 'yubhop', 'sgu20151414', 'nizquierdo', 'almekamobilya', 'sgu20171594', 'werr011', 'andrewmon', 'sgu20181330', 'sgu20171534', 'sgu20151878', 'jpuko11', 'sug20171516', 'sgu20171546', 'sgu20151434', 'sgu20171564', 'zldrktgusrbs3242', 'jihongkim', 'sgu20151428', 'jaegisehyun', 'sgu20161528', 'cbortlek', 'sgu20151480', 'sgu20161488', 'manjunath216', 'ardasavas6', 'tndukaife2018', 'jpuko00', 'their123', 'sgu20191462', 'ervndgn59', 'jihyeonlee', 'sgu20151421', 'b919083', 'yashhiteshbh', 'saga102938', 'sogang20191452', 'mpsingh', 'wodh97', 'mirko.capodicasa', 'sgu20171596', 'sgu20171516', 'ekicifatih0', 'sgu20151488', 'tanseerali', 'sgu20151453', 'sgu20141461', 'sgu20161492', 'jlev713', 'sgu20131274', 'peterhorvath', 'sgu20171578', 'sgu20191476', 'sgu20171548', 'sgu20151467', 'sgu20151507', 'sgu20141740', 'hanmir', 'hye8913', 'sgu20171506', 'sgu20171503', 'taawsifrc', 'sgu20161538']",11,"['youlianafouad17', 'ranaashraf129', 'medoshaban816', 'eyadafify', 'hehaftw', 'engahmedsalahfathy', 'mostafasaleh054', 'seifahmedamer', 'mohamedhamdy1120000', 'sarawaelahmed22', None]",294,"['farid1010', 'sgu20161468', 'nohaabdelazeem11', 'mohamedsamir2591998', 'karim..mohamed745', 'okanssabah', 'ozanemreercan', 'sgu20161506', 'sgu20191512', 'mobahr', 'sgu20171492', 'maxwest', 'badryahmed33', 'mohamedelfeeky1', 'jchamarthi', 'abdelrahman98', 'aminsalah287', 'mayanmohamed', 'sgu20161541', 'sgu20161486', 'fayrouz21415', 'sgu20171588', 'mohamed248688', 'sgu20191492', 'sgu20151431', 'comebacktome', 'nadeenmagdyy', 'tpcks96', 'romanynashaatmakeen', 'ampmstrawberryjam26', 'enesqwe', 'eyadafify', 'm.trika1999', 'ahmedyosre007', 'sgu20181504', 'dodynn29', 'mohamed_a_mostafa', 'sgu20171552', 'sgu20161556', 'nada0abou0alsoud', 'sgu20181576', 'af5012175', 'kerolosmfawzy', 'raneemgaber', 'tutku', 'zhenming', 'sgu20161497', 'seifahmedamer', 'raa199014', 'reemayman101', 'youssefessawy', 'robikar', 'sgu20171510', 'esraayahia21', 'taha18499', 'sgu20171530', 'ahmedkamal', 'amrksh3198', 'moataz12mokhtar', 'jualipa1995', 'hmsgsaad', 'bguillet', 'yaseensalah83', 'kminhsu', 'ahmedokasha1999', 'tpranto', 'sgu20171592', 'sgu20171566', 'marcomuzzarelli', 'yilmaazmert', 'abdelrahman_oun', 'nourmahmoud', 'ranasherif244', 'mustafamahmoud567', 'bassant.ahmed235', 'mayaralmazy', 'sgu20191550', 'sgu20191454', 'salmatarek87', 'sgu20161507', 'sgu20191496', 'wyattm', 'sgu20161516', 'medoshaban816', 'sgu20161518', 'mohannadragab53', 'abdulsamad', 'yubhop', 'sgu20151414', 'abdoulkh', 'seifelawadi26', 'hosamabdallah00', 'btngana1', 'ramymohsen', 'nizquierdo', 'almekamobilya', 'sgu20171594', 'mayadamarie', 'werr011', 'sgu20181330', 'engahmedsalahfathy', 'sug20171516', 'sohamamdooh', 'sgu20171564', 'zldrktgusrbs3242', 'yusufcheetos99', 'jihongkim', 'sgu20151428', 'ziad.amr201666', 'adham99', 'sgu20161528', 'sgu20151480', 'josef.me22', 'sgu20161488', 'harvovich', 'ardasavas6', 'getray.ah', 'their123', 'jihyeonlee', 'mohamed_98', 'haidy_emad', 'omarnabih21', 'mohamedhamdy1120000', 'ingyawad14', 'wodh97', 'ahmed_omar', 'youssefhassaan99', 'sgu20171516', 'ahmedmostafa5499', 'doraexplora', 'ashraf.amr82', 'nada.abomoslim', 'sgu20151453', 'saca', 'kareemmohamed68990', 'sgu20141461', 'sgu20131274', 'mohamedsalah2', 'sgu20171548', 'tomymoty1', 'sgu20151467', 'rehab.sayed1231999', 'sgu20141740', 'hanmir', 'hye8913', 'ashraf_mohamed', 'maged.magdy666', 'mariam123456789', 'sgu20171506', 'nourhanne.bahaa', 'a.ayman74', 'marwanyasser133', 'sgu20161538', 'kirollos.atef99', 'ahmed_mohsen', 'hehaftw', 'pshrap37', 'daniel.', 'mmhanafy99', 'heshamelsedfy111', 'vmike0426', 'sgu20151432', 'amr.m.araby', 'mai99mahdy', 'sgu20161512', 'mephistokc', 'michelhakim2001.mh', 'zazotop31', 'abdelrahmananwar', 'jisooyoon', 'michaelhelal99', 'sgu20171560', 'sgu20161466', 'joker.man2000000', 'ahmedramadan', 'omar_anwer', 'youlianafouad17', 'sgu20161508', 'amy', 'erhan26uzun', 'sadboijalal', 'ataozirmak', 'boules', 'moh.nabil2050', 'nadakhaled', 'sarawaelahmed22', 'fabio.signorelli', 'abdelmoneim404', 'sal7ien1999', 'sgu20151426', 'barkinsrc5', 'sgu20191494', 'youjiyeon', 'rubenasa', 'mohameda.younis80', 'amr.ghoname.teaching', 'ahmedsaeed', 'my1hunter', 'atknncvkkl', 'sgu20161536', 'sgu20161460', 'juni8472', 'sgu20171582', 'roshdy.aa', 'ramezakram97', 'demonkaksh', 'mernaeshakfaheem', 'pamilapoopad', 'metoyahia1999', 'nayeramakram98', 'sgu20171496', 'mostafasaleh054', 'amartiger2020', 'melegy99', 'sgu20171528', 'tongmalual', 'sgu20191490', None, 'fatihakyurek26', 'ittopsk', 'hosamshaher43', 'cyrillemagdi', 'sug20182194', 'ebrahim.almohandes', 'sgu20191534', 'sgu20191466', 'b715063minbyeongmoon', 'sgu20151500', 'bassant.ahmed20118', 'ranaashraf129', 'mamoundiouri', 'sgu20151461', 'sgu20171536', 'beoungwoo', 'shadymagdy99', 'jaeeun53', 'karim20103200', 'andrewmon', 'omaraly112', 'sgu20171534', 'sgu20151878', 'marwanahmad988', 'jpuko11', 'sgu20171546', 'sgu20151434', 'raniamuhamed44', 'jaegisehyun', 'cbortlek', 'generalshephrd', 'abdulrahman.hussien1999', 'mohamed.eid1014', 'manjunath216', 'tndukaife2018', 'jpuko00', 'sgu20191462', 'alaa15eltehewey', 'ervndgn59', 'ahmadatef580', 'habiba.elkassas', 'youssefsamiryoussef', 'abdallahhashim', 'maged19991926', 'sgu20151421', 'mahmodfarag2000', 'b919083', 'yahiahamimi', 'yashhiteshbh', 'saga102938', 'sogang20191452', 'mpsingh', 'mirko.capodicasa', 'sgu20171596', 'ekicifatih0', 'sgu20151488', 'tanseerali', 'mohamed.zna66', 'sgu20161492', 'jlev713', 'm_feky', 'peterhorvath', 'sgu20171578', 'sgu20191476', 'shrouk.a.emad', 'abdoelanwar99', 'elsayedrafaat7', 'sgu20151507', 'rektxz', 'markashaf232', 'fasd556.om', 'sgu20171503', 'dina.23elessawy', 'michael29699', 'taawsifrc', 'faridmohammed98']"
1,21,283,137,101,"['sgu20161468', 'pshrap37', 'sgu20161506', 'vmike0426', 'sgu20151432', 'sgu20191512', 'sgu20161512', 'mephistokc', 'sgu20171492', 'jisooyoon', 'sgu20171560', 'sgu20161466', 'sgu20161541', 'sgu20161508', 'sgu20161486', 'sgu20171588', 'sgu20191492', 'sgu20151431', 'comebacktome', 'sgu20151426', 'tpcks96', 'sgu20191494', 'youjiyeon', 'sgu20181504', 'sgu20161556', 'my1hunter', 'sgu20171552', 'sgu20181576', 'sgu20161536', 'sgu20161497', 'sgu20161460', 'juni8472', 'sgu20171582', 'sgu20171510', 'sgu20171530', 'sgu20171592', 'sgu20171566', 'sgu20171496', 'sgu20171528', 'sgu20191490', 'sgu20191550', 'ittopsk', 'sgu20191454', 'sgu20191534', 'sgu20191466', 'sgu20161507', 'sgu20151500', 'b715063minbyeongmoon', 'sgu20191496', 'sgu20161518', 'sgu20151461', 'sgu20171536', 'beoungwoo', 'jaeeun53', 'yubhop', 'sgu20151414', 'sgu20171594', 'werr011', 'andrewmon', 'sgu20181330', 'sgu20171534', 'sgu20151878', 'jpuko11', 'sug20171516', 'sgu20171546', 'sgu20151434', 'zldrktgusrbs3242', 'sgu20171564', 'jihongkim', 'sgu20151428', 'jaegisehyun', 'sgu20161528', 'sgu20151480', 'sgu20161488', 'jpuko00', 'their123', 'sgu20191462', 'jihyeonlee', 'sgu20151421', 'b919083', 'saga102938', 'sogang20191452', 'wodh97', 'sgu20171596', 'sgu20171516', 'sgu20151488', 'sgu20151453', 'sgu20141461', 'sgu20161492', 'sgu20131274', 'sgu20171578', 'sgu20191476', 'sgu20171548', 'sgu20151507', 'sgu20151467', 'sgu20141740', 'hanmir', 'hye8913', 'sgu20171503', 'sgu20171506', 'sgu20161538']",182,"['kirollos.atef99', 'farid1010', 'mohamedsamir2591998', 'nohaabdelazeem11', 'ahmed_mohsen', 'karim..mohamed745', 'okanssabah', 'ozanemreercan', 'daniel.', 'mmhanafy99', 'heshamelsedfy111', 'amr.m.araby', 'mai99mahdy', 'mobahr', 'maxwest', 'badryahmed33', 'mohamedelfeeky1', 'jchamarthi', 'michelhakim2001.mh', 'abdelrahman98', 'zazotop31', 'abdelrahmananwar', 'michaelhelal99', 'aminsalah287', 'mayanmohamed', 'joker.man2000000', 'ahmedramadan', 'omar_anwer', 'amy', 'erhan26uzun', 'sadboijalal', 'fayrouz21415', 'ataozirmak', 'boules', 'moh.nabil2050', 'nadakhaled', 'fabio.signorelli', 'mohamed248688', 'abdelmoneim404', 'nadeenmagdyy', 'sal7ien1999', 'romanynashaatmakeen', 'ampmstrawberryjam26', 'enesqwe', 'barkinsrc5', 'm.trika1999', 'ahmedyosre007', 'dodynn29', 'rubenasa', 'mohameda.younis80', 'mohamed_a_mostafa', 'amr.ghoname.teaching', 'ahmedsaeed', 'nada0abou0alsoud', 'atknncvkkl', 'af5012175', 'kerolosmfawzy', 'raneemgaber', 'tutku', 'zhenming', 'raa199014', 'reemayman101', 'youssefessawy', 'robikar', 'esraayahia21', 'taha18499', 'roshdy.aa', 'ahmedkamal', 'amrksh3198', 'ramezakram97', 'demonkaksh', 'mernaeshakfaheem', 'pamilapoopad', 'moataz12mokhtar', 'jualipa1995', 'metoyahia1999', 'hmsgsaad', 'bguillet', 'yaseensalah83', 'nayeramakram98', 'kminhsu', 'ahmedokasha1999', 'tpranto', 'marcomuzzarelli', 'amartiger2020', 'melegy99', 'tongmalual', 'fatihakyurek26', 'yilmaazmert', 'abdelrahman_oun', 'nourmahmoud', 'ranasherif244', 'mustafamahmoud567', 'bassant.ahmed235', 'mayaralmazy', 'hosamshaher43', 'cyrillemagdi', 'salmatarek87', 'sug20182194', 'ebrahim.almohandes', 'bassant.ahmed20118', 'wyattm', 'sgu20161516', 'mamoundiouri', 'mohannadragab53', 'abdulsamad', 'shadymagdy99', 'abdoulkh', 'seifelawadi26', 'hosamabdallah00', 'btngana1', 'ramymohsen', 'nizquierdo', 'almekamobilya', 'mayadamarie', 'karim20103200', 'omaraly112', 'marwanahmad988', 'raniamuhamed44', 'sohamamdooh', 'yusufcheetos99', 'ziad.amr201666', 'adham99', 'cbortlek', 'generalshephrd', 'abdulrahman.hussien1999', 'josef.me22', 'mohamed.eid1014', 'harvovich', 'ardasavas6', 'manjunath216', 'tndukaife2018', 'getray.ah', 'alaa15eltehewey', 'ervndgn59', 'mohamed_98', 'ahmadatef580', 'habiba.elkassas', 'youssefsamiryoussef', 'abdallahhashim', 'haidy_emad', 'maged19991926', 'omarnabih21', 'mahmodfarag2000', 'yahiahamimi', 'yashhiteshbh', 'ingyawad14', 'mpsingh', 'ahmed_omar', 'youssefhassaan99', 'mirko.capodicasa', 'ekicifatih0', 'ahmedmostafa5499', 'doraexplora', 'tanseerali', 'ashraf.amr82', 'nada.abomoslim', 'saca', 'mohamed.zna66', 'kareemmohamed68990', 'jlev713', 'm_feky', 'mohamedsalah2', 'peterhorvath', 'shrouk.a.emad', 'abdoelanwar99', 'tomymoty1', 'rehab.sayed1231999', 'elsayedrafaat7', 'rektxz', 'markashaf232', 'ashraf_mohamed', 'fasd556.om', 'maged.magdy666', 'mariam123456789', 'dina.23elessawy', 'nourhanne.bahaa', 'a.ayman74', 'michael29699', 'marwanyasser133', 'taawsifrc', 'faridmohammed98']",36,"['eomhyobin1227', 'kdm52', 'sgu20141475', 'jihwanch1', 'sgu20151313', 'aaddss3210', 'eogksakdhkd', 'sgu20181572', 'sgu20141410', 'sgu20151508', 'kimsw9506', 'gunso', 'jgyyeong', 'hyuk8041', 'ansckdqja123', 'dldmsrbx', 'sgu20161523', '112zxczxc', 'poweroftrust', 'b619100', 'b515037', 'sgu20161450', 'kdy3894', 'sohny94', 'b615057', None, 'poby', 'ehrnjs326', 'tjwjdqja5', 'tjwldbsdbs', 'sgu20171573', 'euem789', 'wndud5258', 'terry0511', 'ksw950828', 'chaems322']",319,"['farid1010', 'sgu20161468', 'nohaabdelazeem11', 'mohamedsamir2591998', 'karim..mohamed745', 'okanssabah', 'ozanemreercan', 'sgu20161506', 'sgu20191512', 'sgu20141410', 'mobahr', 'sgu20171492', 'maxwest', 'badryahmed33', 'mohamedelfeeky1', 'jchamarthi', 'abdelrahman98', 'aminsalah287', 'mayanmohamed', 'sgu20161541', 'kdy3894', 'sgu20161486', 'sohny94', 'fayrouz21415', 'sgu20171588', 'mohamed248688', 'sgu20191492', 'sgu20151431', 'comebacktome', 'nadeenmagdyy', 'tpcks96', 'romanynashaatmakeen', 'ampmstrawberryjam26', 'enesqwe', 'm.trika1999', 'ahmedyosre007', 'sgu20181504', 'dodynn29', 'mohamed_a_mostafa', 'sgu20171552', 'sgu20161556', 'nada0abou0alsoud', 'sgu20181576', 'af5012175', 'kerolosmfawzy', 'sgu20151313', 'raneemgaber', 'tutku', 'zhenming', 'sgu20161497', 'raa199014', 'reemayman101', 'youssefessawy', 'robikar', 'sgu20171510', 'esraayahia21', 'taha18499', 'sgu20171530', 'ahmedkamal', 'ansckdqja123', 'amrksh3198', 'sgu20161523', 'b619100', 'moataz12mokhtar', 'jualipa1995', 'hmsgsaad', 'bguillet', 'yaseensalah83', 'kminhsu', 'ahmedokasha1999', 'tpranto', 'sgu20171592', 'sgu20171566', 'marcomuzzarelli', 'yilmaazmert', 'abdelrahman_oun', 'nourmahmoud', 'ranasherif244', 'mustafamahmoud567', 'bassant.ahmed235', 'mayaralmazy', 'sgu20191550', 'wndud5258', 'sgu20191454', 'salmatarek87', 'sgu20161507', 'sgu20191496', 'wyattm', 'sgu20161516', 'kdm52', 'sgu20161518', 'mohannadragab53', 'abdulsamad', 'yubhop', 'sgu20151414', 'abdoulkh', 'seifelawadi26', 'hosamabdallah00', 'btngana1', 'ramymohsen', 'nizquierdo', 'almekamobilya', 'sgu20171594', 'mayadamarie', 'werr011', 'gunso', 'sgu20181330', 'dldmsrbx', 'poweroftrust', 'sug20171516', 'sohamamdooh', 'sgu20171564', 'zldrktgusrbs3242', 'yusufcheetos99', 'jihongkim', 'sgu20151428', 'ziad.amr201666', 'adham99', 'sgu20161528', 'sgu20151480', 'josef.me22', 'sgu20161488', 'b615057', 'harvovich', 'ardasavas6', 'getray.ah', 'their123', 'jihyeonlee', 'mohamed_98', 'euem789', 'haidy_emad', 'omarnabih21', 'ingyawad14', 'aaddss3210', 'wodh97', 'ahmed_omar', 'youssefhassaan99', 'sgu20171516', 'ahmedmostafa5499', 'doraexplora', 'ashraf.amr82', 'nada.abomoslim', 'sgu20151453', 'saca', 'kareemmohamed68990', 'sgu20141461', 'sgu20131274', 'mohamedsalah2', 'sgu20171548', 'tomymoty1', 'sgu20151467', 'rehab.sayed1231999', 'sgu20141740', 'hanmir', 'hye8913', 'ashraf_mohamed', 'maged.magdy666', 'mariam123456789', 'sgu20171506', 'sgu20171573', 'nourhanne.bahaa', 'a.ayman74', 'marwanyasser133', 'sgu20161538', 'kirollos.atef99', 'eomhyobin1227', 'ahmed_mohsen', 'pshrap37', 'daniel.', 'mmhanafy99', 'heshamelsedfy111', 'vmike0426', 'sgu20151432', 'amr.m.araby', 'eogksakdhkd', 'mai99mahdy', 'sgu20161512', 'mephistokc', 'michelhakim2001.mh', 'hyuk8041', 'zazotop31', 'abdelrahmananwar', 'jisooyoon', 'michaelhelal99', '112zxczxc', 'sgu20171560', 'sgu20161466', 'joker.man2000000', 'ahmedramadan', 'omar_anwer', 'sgu20161508', 'amy', 'erhan26uzun', 'sadboijalal', 'ataozirmak', 'boules', 'moh.nabil2050', 'nadakhaled', 'fabio.signorelli', 'abdelmoneim404', 'sal7ien1999', 'sgu20151426', 'ehrnjs326', 'barkinsrc5', 'sgu20191494', 'terry0511', 'youjiyeon', 'ksw950828', 'rubenasa', 'mohameda.younis80', 'amr.ghoname.teaching', 'ahmedsaeed', 'my1hunter', 'sgu20141475', 'atknncvkkl', 'sgu20161536', 'sgu20161460', 'juni8472', 'sgu20171582', 'roshdy.aa', 'ramezakram97', 'demonkaksh', 'mernaeshakfaheem', 'pamilapoopad', 'metoyahia1999', 'sgu20161450', 'nayeramakram98', 'sgu20171496', 'amartiger2020', 'melegy99', 'sgu20171528', 'tongmalual', 'sgu20191490', None, 'fatihakyurek26', 'tjwjdqja5', 'ittopsk', 'hosamshaher43', 'cyrillemagdi', 'sug20182194', 'ebrahim.almohandes', 'sgu20191534', 'sgu20191466', 'b715063minbyeongmoon', 'sgu20151500', 'bassant.ahmed20118', 'mamoundiouri', 'sgu20151461', 'sgu20171536', 'beoungwoo', 'shadymagdy99', 'jaeeun53', 'karim20103200', 'sgu20151508', 'andrewmon', 'omaraly112', 'jgyyeong', 'sgu20171534', 'sgu20151878', 'marwanahmad988', 'jpuko11', 'sgu20171546', 'sgu20151434', 'raniamuhamed44', 'b515037', 'jaegisehyun', 'cbortlek', 'generalshephrd', 'abdulrahman.hussien1999', 'mohamed.eid1014', 'manjunath216', 'tndukaife2018', 'jpuko00', 'sgu20191462', 'alaa15eltehewey', 'ervndgn59', 'tjwldbsdbs', 'ahmadatef580', 'habiba.elkassas', 'youssefsamiryoussef', 'abdallahhashim', 'maged19991926', 'sgu20151421', 'mahmodfarag2000', 'b919083', 'chaems322', 'yahiahamimi', 'yashhiteshbh', 'saga102938', 'sogang20191452', 'jihwanch1', 'mpsingh', 'sgu20181572', 'mirko.capodicasa', 'sgu20171596', 'kimsw9506', 'ekicifatih0', 'sgu20151488', 'tanseerali', 'mohamed.zna66', 'sgu20161492', 'jlev713', 'm_feky', 'peterhorvath', 'sgu20171578', 'sgu20191476', 'shrouk.a.emad', 'abdoelanwar99', 'elsayedrafaat7', 'sgu20151507', 'rektxz', 'markashaf232', 'poby', 'fasd556.om', 'sgu20171503', 'dina.23elessawy', 'michael29699', 'taawsifrc', 'faridmohammed98']"
1,397,283,72,15,"['ahmedsaeed', 'ahmedramadan', 'romanynashaatmakeen', 'mohamedsalah2', 'zazotop31', 'ahmedokasha1999', 'michaelhelal99', 'heshamelsedfy111', 'amr.m.araby', 'saca', 'harvovich', 'rektxz', 'mernaeshakfaheem', 'mohameda.younis80', 'btngana1']",268,"['kirollos.atef99', 'farid1010', 'sgu20161468', 'nohaabdelazeem11', 'mohamedsamir2591998', 'ahmed_mohsen', 'pshrap37', 'karim..mohamed745', 'okanssabah', 'ozanemreercan', 'sgu20161506', 'daniel.', 'mmhanafy99', 'vmike0426', 'sgu20191512', 'sgu20151432', 'mai99mahdy', 'sgu20161512', 'mobahr', 'mephistokc', 'sgu20171492', 'maxwest', 'badryahmed33', 'mohamedelfeeky1', 'jchamarthi', 'michelhakim2001.mh', 'abdelrahman98', 'abdelrahmananwar', 'jisooyoon', 'sgu20171560', 'sgu20161466', 'aminsalah287', 'mayanmohamed', 'sgu20161541', 'joker.man2000000', 'omar_anwer', 'sgu20161508', 'amy', 'erhan26uzun', 'sadboijalal', 'sgu20161486', 'fayrouz21415', 'ataozirmak', 'boules', 'moh.nabil2050', 'nadakhaled', 'sgu20171588', 'fabio.signorelli', 'mohamed248688', 'abdelmoneim404', 'sgu20191492', 'sgu20151431', 'comebacktome', 'nadeenmagdyy', 'sal7ien1999', 'sgu20151426', 'tpcks96', 'ampmstrawberryjam26', 'enesqwe', 'barkinsrc5', 'm.trika1999', 'ahmedyosre007', 'sgu20191494', 'youjiyeon', 'sgu20181504', 'dodynn29', 'rubenasa', 'mohamed_a_mostafa', 'amr.ghoname.teaching', 'sgu20171552', 'sgu20161556', 'nada0abou0alsoud', 'my1hunter', 'sgu20181576', 'atknncvkkl', 'af5012175', 'kerolosmfawzy', 'sgu20161536', 'raneemgaber', 'tutku', 'zhenming', 'sgu20161497', 'sgu20161460', 'juni8472', 'raa199014', 'sgu20171582', 'reemayman101', 'youssefessawy', 'robikar', 'sgu20171510', 'esraayahia21', 'taha18499', 'sgu20171530', 'roshdy.aa', 'ahmedkamal', 'amrksh3198', 'ramezakram97', 'demonkaksh', 'pamilapoopad', 'moataz12mokhtar', 'jualipa1995', 'metoyahia1999', 'hmsgsaad', 'bguillet', 'yaseensalah83', 'nayeramakram98', 'kminhsu', 'tpranto', 'sgu20171592', 'sgu20171566', 'marcomuzzarelli', 'sgu20171496', 'amartiger2020', 'melegy99', 'sgu20171528', 'tongmalual', 'sgu20191490', 'fatihakyurek26', 'yilmaazmert', 'abdelrahman_oun', 'nourmahmoud', 'ranasherif244', 'mustafamahmoud567', 'bassant.ahmed235', 'mayaralmazy', 'sgu20191550', 'ittopsk', 'sgu20191454', 'hosamshaher43', 'cyrillemagdi', 'salmatarek87', 'sug20182194', 'ebrahim.almohandes', 'sgu20191534', 'sgu20161507', 'sgu20191466', 'b715063minbyeongmoon', 'sgu20151500', 'bassant.ahmed20118', 'sgu20191496', 'wyattm', 'sgu20161516', 'mamoundiouri', 'sgu20161518', 'sgu20151461', 'sgu20171536', 'mohannadragab53', 'beoungwoo', 'abdulsamad', 'shadymagdy99', 'yubhop', 'jaeeun53', 'sgu20151414', 'abdoulkh', 'seifelawadi26', 'hosamabdallah00', 'ramymohsen', 'mayadamarie', 'nizquierdo', 'almekamobilya', 'sgu20171594', 'werr011', 'karim20103200', 'andrewmon', 'sgu20181330', 'omaraly112', 'sgu20171534', 'sgu20151878', 'marwanahmad988', 'jpuko11', 'sug20171516', 'sohamamdooh', 'sgu20171546', 'sgu20171564', 'zldrktgusrbs3242', 'yusufcheetos99', 'sgu20151434', 'raniamuhamed44', 'jihongkim', 'sgu20151428', 'ziad.amr201666', 'adham99', 'sgu20161528', 'jaegisehyun', 'sgu20151480', 'cbortlek', 'generalshephrd', 'abdulrahman.hussien1999', 'josef.me22', 'sgu20161488', 'mohamed.eid1014', 'manjunath216', 'ardasavas6', 'tndukaife2018', 'jpuko00', 'getray.ah', 'their123', 'sgu20191462', 'alaa15eltehewey', 'ervndgn59', 'jihyeonlee', 'mohamed_98', 'ahmadatef580', 'habiba.elkassas', 'youssefsamiryoussef', 'abdallahhashim', 'haidy_emad', 'maged19991926', 'sgu20151421', 'omarnabih21', 'mahmodfarag2000', 'b919083', 'yahiahamimi', 'yashhiteshbh', 'ingyawad14', 'saga102938', 'sogang20191452', 'mpsingh', 'wodh97', 'ahmed_omar', 'youssefhassaan99', 'mirko.capodicasa', 'sgu20171596', 'sgu20171516', 'ekicifatih0', 'ahmedmostafa5499', 'doraexplora', 'sgu20151488', 'ashraf.amr82', 'tanseerali', 'nada.abomoslim', 'sgu20151453', 'mohamed.zna66', 'kareemmohamed68990', 'sgu20141461', 'sgu20161492', 'jlev713', 'm_feky', 'sgu20131274', 'peterhorvath', 'sgu20171578', 'sgu20191476', 'sgu20171548', 'shrouk.a.emad', 'abdoelanwar99', 'tomymoty1', 'sgu20151467', 'rehab.sayed1231999', 'elsayedrafaat7', 'sgu20151507', 'sgu20141740', 'hanmir', 'markashaf232', 'hye8913', 'ashraf_mohamed', 'fasd556.om', 'maged.magdy666', 'mariam123456789', 'sgu20171506', 'sgu20171503', 'dina.23elessawy', 'nourhanne.bahaa', 'a.ayman74', 'michael29699', 'marwanyasser133', 'taawsifrc', 'sgu20161538', 'faridmohammed98']",57,"['salem2', 'lockbox30', 'sprawozdaniezlabow', 'medoshaban816', 'cristianololipops56', 'krystiankoszucki', 'sebabalt', 'haripriya', 'cmc2374', 'edwardmirkin', 'jts2176', 'woj_25', 'johnlanghout', 'andrea_russo90', 'martyna.bladosz97', 'thebigchester', 'mohamed_2116', 'kaka1341', 'zajaclukasz140', 'marvel', 'amilkovicz', 'stefaelfi', 'olchor', 'transalper', 'fied0029', 'rafal123', 'kumarraina619', 'kareemk08', 'pzanasi', 'myousef42', 'tezaagnieszka', 'abdooo', 'kuba321', 'jendryka.j', 'gharrison78', 'm.zhu', 's154641', 'bryckadominika', 'jatin97', 'e.steinebronn', None, 'indyfisico', 's159813', 'jhh2197', 'deepika07', 'merhuem', 'martak846', 'kpolcyn', 'anna2222', 'pirokiki', 'josephwilliams11', 'narndt', 'manny', 'lampy84', 'misterszycha', 'sebastian.wachowski', 'ch3401']",340,"['farid1010', 'sgu20161468', 'nohaabdelazeem11', 'mohamedsamir2591998', 'karim..mohamed745', 'okanssabah', 'ozanemreercan', 'sgu20161506', 'cmc2374', 'sgu20191512', 'mobahr', 'sgu20171492', 'martyna.bladosz97', 'maxwest', 'badryahmed33', 'mohamedelfeeky1', 'jchamarthi', 'abdelrahman98', 'transalper', 'aminsalah287', 'mayanmohamed', 'sgu20161541', 'sgu20161486', 'fayrouz21415', 'bryckadominika', 'sgu20171588', 'mohamed248688', 'sgu20191492', 'sgu20151431', 'comebacktome', 'nadeenmagdyy', 'tpcks96', 'romanynashaatmakeen', 'ampmstrawberryjam26', 'enesqwe', 'm.trika1999', 'ahmedyosre007', 'josephwilliams11', 'misterszycha', 'sgu20181504', 'dodynn29', 'mohamed_a_mostafa', 'sgu20171552', 'sgu20161556', 'nada0abou0alsoud', 'lockbox30', 'sebabalt', 'sgu20181576', 'haripriya', 'af5012175', 'kerolosmfawzy', 'raneemgaber', 'tutku', 'zhenming', 'sgu20161497', 'raa199014', 'reemayman101', 'youssefessawy', 'robikar', 'sgu20171510', 'esraayahia21', 'taha18499', 'sgu20171530', 'ahmedkamal', 'amrksh3198', 'stefaelfi', 'olchor', 'moataz12mokhtar', 'jualipa1995', 'hmsgsaad', 'bguillet', 'yaseensalah83', 'kminhsu', 'ahmedokasha1999', 'tpranto', 'sgu20171592', 'sgu20171566', 'marcomuzzarelli', 'gharrison78', 'yilmaazmert', 'abdelrahman_oun', 'nourmahmoud', 'ranasherif244', 'mustafamahmoud567', 'bassant.ahmed235', 'mayaralmazy', 'sgu20191550', 'sgu20191454', 'salmatarek87', 'sgu20161507', 'sgu20191496', 'wyattm', 'sgu20161516', 'medoshaban816', 'sgu20161518', 'mohannadragab53', 'abdulsamad', 'yubhop', 'edwardmirkin', 'sgu20151414', 'abdoulkh', 'seifelawadi26', 'hosamabdallah00', 'btngana1', 'ramymohsen', 'nizquierdo', 'almekamobilya', 'sgu20171594', 'mayadamarie', 'werr011', 'sgu20181330', 'mohamed_2116', 'sug20171516', 'sohamamdooh', 'sgu20171564', 'zldrktgusrbs3242', 'yusufcheetos99', 'fied0029', 'jihongkim', 'sgu20151428', 'ziad.amr201666', 'adham99', 'sgu20161528', 'pzanasi', 'sgu20151480', 'josef.me22', 'sgu20161488', 'harvovich', 'ardasavas6', 's154641', 'e.steinebronn', 'getray.ah', 'their123', 'jihyeonlee', 'mohamed_98', 'pirokiki', 'haidy_emad', 'lampy84', 'omarnabih21', 'sebastian.wachowski', 'ingyawad14', 'sprawozdaniezlabow', 'cristianololipops56', 'krystiankoszucki', 'wodh97', 'ahmed_omar', 'youssefhassaan99', 'sgu20171516', 'ahmedmostafa5499', 'doraexplora', 'ashraf.amr82', 'nada.abomoslim', 'thebigchester', 'kaka1341', 'zajaclukasz140', 'sgu20151453', 'saca', 'amilkovicz', 'kareemmohamed68990', 'sgu20141461', 'sgu20131274', 'mohamedsalah2', 'myousef42', 'tezaagnieszka', 'sgu20171548', 'tomymoty1', 'sgu20151467', 'rehab.sayed1231999', 'abdooo', 'sgu20141740', 'hanmir', 'hye8913', 'ashraf_mohamed', 'maged.magdy666', 'mariam123456789', 'sgu20171506', 'martak846', 'nourhanne.bahaa', 'a.ayman74', 'marwanyasser133', 'sgu20161538', 'kirollos.atef99', 'ahmed_mohsen', 'pshrap37', 'daniel.', 'mmhanafy99', 'heshamelsedfy111', 'vmike0426', 'sgu20151432', 'amr.m.araby', 'mai99mahdy', 'sgu20161512', 'mephistokc', 'michelhakim2001.mh', 'zazotop31', 'abdelrahmananwar', 'jisooyoon', 'michaelhelal99', 'sgu20171560', 'sgu20161466', 'joker.man2000000', 'ahmedramadan', 'omar_anwer', 'sgu20161508', 'amy', 'erhan26uzun', 'kareemk08', 'sadboijalal', 'ataozirmak', 'boules', 'm.zhu', 'moh.nabil2050', 'nadakhaled', 'fabio.signorelli', 'abdelmoneim404', 'sal7ien1999', 'sgu20151426', 'barkinsrc5', 'sgu20191494', 'youjiyeon', 'manny', 'rubenasa', 'mohameda.younis80', 'amr.ghoname.teaching', 'ahmedsaeed', 'my1hunter', 'atknncvkkl', 'sgu20161536', 'sgu20161460', 'juni8472', 'sgu20171582', 'johnlanghout', 'roshdy.aa', 'ramezakram97', 'demonkaksh', 'mernaeshakfaheem', 'pamilapoopad', 'metoyahia1999', 'nayeramakram98', 'sgu20171496', 'amartiger2020', 'melegy99', 'sgu20171528', 'tongmalual', 'sgu20191490', None, 'fatihakyurek26', 'merhuem', 'ittopsk', 'hosamshaher43', 'cyrillemagdi', 'sug20182194', 'ch3401', 'ebrahim.almohandes', 'sgu20191534', 'sgu20191466', 'b715063minbyeongmoon', 'sgu20151500', 'bassant.ahmed20118', 'salem2', 'mamoundiouri', 'sgu20151461', 'sgu20171536', 'beoungwoo', 'shadymagdy99', 'jaeeun53', 'karim20103200', 'andrea_russo90', 'andrewmon', 'omaraly112', 'sgu20171534', 'sgu20151878', 'marwanahmad988', 'marvel', 'jpuko11', 'sgu20171546', 'sgu20151434', 'raniamuhamed44', 'rafal123', 'kumarraina619', 'jaegisehyun', 'cbortlek', 'generalshephrd', 'abdulrahman.hussien1999', 'jendryka.j', 'mohamed.eid1014', 'manjunath216', 'tndukaife2018', 'jatin97', 'jpuko00', 'sgu20191462', 'alaa15eltehewey', 'ervndgn59', 's159813', 'jhh2197', 'deepika07', 'ahmadatef580', 'habiba.elkassas', 'youssefsamiryoussef', 'abdallahhashim', 'maged19991926', 'sgu20151421', 'mahmodfarag2000', 'b919083', 'yahiahamimi', 'yashhiteshbh', 'saga102938', 'sogang20191452', 'mpsingh', 'jts2176', 'woj_25', 'mirko.capodicasa', 'sgu20171596', 'ekicifatih0', 'sgu20151488', 'tanseerali', 'mohamed.zna66', 'sgu20161492', 'jlev713', 'm_feky', 'peterhorvath', 'sgu20171578', 'sgu20191476', 'shrouk.a.emad', 'abdoelanwar99', 'elsayedrafaat7', 'sgu20151507', 'kuba321', 'rektxz', 'markashaf232', 'fasd556.om', 'indyfisico', 'sgu20171503', 'dina.23elessawy', 'kpolcyn', 'anna2222', 'narndt', 'michael29699', 'taawsifrc', 'faridmohammed98']"
1,356,283,59,54,"['ahmedsaeed', 'farid1010', 'nohaabdelazeem11', 'ahmed_mohsen', 'kerolosmfawzy', 'shadymagdy99', 'heshamelsedfy111', 'amr.m.araby', 'ahmed_omar', 'mai99mahdy', 'seifelawadi26', 'abdoulkh', 'btngana1', 'ramymohsen', 'reemayman101', 'ahmedmostafa5499', 'zazotop31', 'ahmedkamal', 'marwanahmad988', 'amrksh3198', 'saca', 'michaelhelal99', 'kareemmohamed68990', 'mernaeshakfaheem', 'yusufcheetos99', 'moataz12mokhtar', 'aminsalah287', 'ziad.amr201666', 'omar_anwer', 'joker.man2000000', 'amy', 'mohamedsalah2', 'yaseensalah83', 'sadboijalal', 'ahmedokasha1999', 'abdoelanwar99', 'tomymoty1', 'mohamed.eid1014', 'harvovich', 'rektxz', 'markashaf232', 'mohamed248688', 'maged.magdy666', 'nourmahmoud', 'romanynashaatmakeen', 'abdallahhashim', 'm.trika1999', 'ahmedyosre007', 'nourhanne.bahaa', 'a.ayman74', 'maged19991926', 'cyrillemagdi', 'mohameda.younis80', 'bassant.ahmed20118']",229,"['sgu20161468', 'mohamedsamir2591998', 'karim..mohamed745', 'okanssabah', 'ozanemreercan', 'sgu20161506', 'sgu20191512', 'mobahr', 'sgu20171492', 'maxwest', 'badryahmed33', 'mohamedelfeeky1', 'jchamarthi', 'abdelrahman98', 'mayanmohamed', 'sgu20161541', 'sgu20161486', 'fayrouz21415', 'sgu20171588', 'sgu20191492', 'sgu20151431', 'comebacktome', 'nadeenmagdyy', 'tpcks96', 'ampmstrawberryjam26', 'enesqwe', 'sgu20181504', 'dodynn29', 'mohamed_a_mostafa', 'sgu20171552', 'sgu20161556', 'nada0abou0alsoud', 'sgu20181576', 'af5012175', 'raneemgaber', 'tutku', 'zhenming', 'sgu20161497', 'raa199014', 'youssefessawy', 'robikar', 'sgu20171510', 'esraayahia21', 'taha18499', 'sgu20171530', 'jualipa1995', 'hmsgsaad', 'bguillet', 'kminhsu', 'tpranto', 'sgu20171592', 'sgu20171566', 'marcomuzzarelli', 'yilmaazmert', 'abdelrahman_oun', 'ranasherif244', 'mustafamahmoud567', 'bassant.ahmed235', 'mayaralmazy', 'sgu20191550', 'sgu20191454', 'salmatarek87', 'sgu20161507', 'sgu20191496', 'wyattm', 'sgu20161516', 'sgu20161518', 'mohannadragab53', 'abdulsamad', 'yubhop', 'sgu20151414', 'hosamabdallah00', 'nizquierdo', 'almekamobilya', 'sgu20171594', 'mayadamarie', 'werr011', 'sgu20181330', 'sug20171516', 'sohamamdooh', 'sgu20171564', 'zldrktgusrbs3242', 'jihongkim', 'sgu20151428', 'adham99', 'sgu20161528', 'sgu20151480', 'josef.me22', 'sgu20161488', 'ardasavas6', 'getray.ah', 'their123', 'jihyeonlee', 'mohamed_98', 'haidy_emad', 'omarnabih21', 'ingyawad14', 'wodh97', 'youssefhassaan99', 'sgu20171516', 'doraexplora', 'ashraf.amr82', 'nada.abomoslim', 'sgu20151453', 'sgu20141461', 'sgu20131274', 'sgu20171548', 'sgu20151467', 'rehab.sayed1231999', 'sgu20141740', 'hanmir', 'hye8913', 'ashraf_mohamed', 'mariam123456789', 'sgu20171506', 'marwanyasser133', 'sgu20161538', 'kirollos.atef99', 'pshrap37', 'daniel.', 'mmhanafy99', 'vmike0426', 'sgu20151432', 'sgu20161512', 'mephistokc', 'michelhakim2001.mh', 'abdelrahmananwar', 'jisooyoon', 'sgu20171560', 'sgu20161466', 'ahmedramadan', 'sgu20161508', 'erhan26uzun', 'ataozirmak', 'boules', 'moh.nabil2050', 'nadakhaled', 'fabio.signorelli', 'abdelmoneim404', 'sal7ien1999', 'sgu20151426', 'barkinsrc5', 'sgu20191494', 'youjiyeon', 'rubenasa', 'amr.ghoname.teaching', 'my1hunter', 'atknncvkkl', 'sgu20161536', 'sgu20161460', 'juni8472', 'sgu20171582', 'roshdy.aa', 'ramezakram97', 'demonkaksh', 'pamilapoopad', 'metoyahia1999', 'nayeramakram98', 'sgu20171496', 'amartiger2020', 'melegy99', 'sgu20171528', 'tongmalual', 'sgu20191490', 'fatihakyurek26', 'ittopsk', 'hosamshaher43', 'sug20182194', 'ebrahim.almohandes', 'sgu20191534', 'sgu20191466', 'b715063minbyeongmoon', 'sgu20151500', 'mamoundiouri', 'sgu20151461', 'sgu20171536', 'beoungwoo', 'jaeeun53', 'karim20103200', 'andrewmon', 'omaraly112', 'sgu20171534', 'sgu20151878', 'jpuko11', 'sgu20171546', 'sgu20151434', 'raniamuhamed44', 'jaegisehyun', 'cbortlek', 'generalshephrd', 'abdulrahman.hussien1999', 'manjunath216', 'tndukaife2018', 'jpuko00', 'sgu20191462', 'alaa15eltehewey', 'ervndgn59', 'ahmadatef580', 'habiba.elkassas', 'youssefsamiryoussef', 'sgu20151421', 'mahmodfarag2000', 'b919083', 'yahiahamimi', 'yashhiteshbh', 'saga102938', 'sogang20191452', 'mpsingh', 'mirko.capodicasa', 'sgu20171596', 'ekicifatih0', 'sgu20151488', 'tanseerali', 'mohamed.zna66', 'sgu20161492', 'jlev713', 'm_feky', 'peterhorvath', 'sgu20171578', 'sgu20191476', 'shrouk.a.emad', 'elsayedrafaat7', 'sgu20151507', 'fasd556.om', 'sgu20171503', 'dina.23elessawy', 'michael29699', 'taawsifrc', 'faridmohammed98']",5,"['medoshaban816', 'kareemk08', 'abdooo', None, 'ahhamed93']",288,"['farid1010', 'sgu20161468', 'nohaabdelazeem11', 'mohamedsamir2591998', 'karim..mohamed745', 'okanssabah', 'ozanemreercan', 'sgu20161506', 'sgu20191512', 'mobahr', 'sgu20171492', 'maxwest', 'badryahmed33', 'mohamedelfeeky1', 'jchamarthi', 'abdelrahman98', 'aminsalah287', 'mayanmohamed', 'sgu20161541', 'sgu20161486', 'fayrouz21415', 'sgu20171588', 'mohamed248688', 'sgu20191492', 'sgu20151431', 'comebacktome', 'nadeenmagdyy', 'tpcks96', 'romanynashaatmakeen', 'ampmstrawberryjam26', 'enesqwe', 'm.trika1999', 'ahmedyosre007', 'sgu20181504', 'dodynn29', 'mohamed_a_mostafa', 'sgu20171552', 'sgu20161556', 'nada0abou0alsoud', 'sgu20181576', 'af5012175', 'kerolosmfawzy', 'raneemgaber', 'tutku', 'zhenming', 'sgu20161497', 'raa199014', 'reemayman101', 'youssefessawy', 'robikar', 'sgu20171510', 'esraayahia21', 'taha18499', 'sgu20171530', 'ahmedkamal', 'amrksh3198', 'moataz12mokhtar', 'jualipa1995', 'hmsgsaad', 'bguillet', 'yaseensalah83', 'kminhsu', 'ahmedokasha1999', 'tpranto', 'sgu20171592', 'sgu20171566', 'marcomuzzarelli', 'yilmaazmert', 'abdelrahman_oun', 'nourmahmoud', 'ranasherif244', 'mustafamahmoud567', 'bassant.ahmed235', 'mayaralmazy', 'sgu20191550', 'sgu20191454', 'salmatarek87', 'sgu20161507', 'sgu20191496', 'wyattm', 'sgu20161516', 'medoshaban816', 'sgu20161518', 'mohannadragab53', 'abdulsamad', 'yubhop', 'sgu20151414', 'abdoulkh', 'seifelawadi26', 'hosamabdallah00', 'btngana1', 'ramymohsen', 'nizquierdo', 'almekamobilya', 'sgu20171594', 'mayadamarie', 'werr011', 'ahhamed93', 'sgu20181330', 'sug20171516', 'sohamamdooh', 'sgu20171564', 'zldrktgusrbs3242', 'yusufcheetos99', 'jihongkim', 'sgu20151428', 'ziad.amr201666', 'adham99', 'sgu20161528', 'sgu20151480', 'josef.me22', 'sgu20161488', 'harvovich', 'ardasavas6', 'getray.ah', 'their123', 'jihyeonlee', 'mohamed_98', 'haidy_emad', 'omarnabih21', 'ingyawad14', 'wodh97', 'ahmed_omar', 'youssefhassaan99', 'sgu20171516', 'ahmedmostafa5499', 'doraexplora', 'ashraf.amr82', 'nada.abomoslim', 'sgu20151453', 'saca', 'kareemmohamed68990', 'sgu20141461', 'sgu20131274', 'mohamedsalah2', 'sgu20171548', 'tomymoty1', 'sgu20151467', 'rehab.sayed1231999', 'abdooo', 'sgu20141740', 'hanmir', 'hye8913', 'ashraf_mohamed', 'maged.magdy666', 'mariam123456789', 'sgu20171506', 'nourhanne.bahaa', 'a.ayman74', 'marwanyasser133', 'sgu20161538', 'kirollos.atef99', 'ahmed_mohsen', 'pshrap37', 'daniel.', 'mmhanafy99', 'heshamelsedfy111', 'vmike0426', 'sgu20151432', 'amr.m.araby', 'mai99mahdy', 'sgu20161512', 'mephistokc', 'michelhakim2001.mh', 'zazotop31', 'abdelrahmananwar', 'jisooyoon', 'michaelhelal99', 'sgu20171560', 'sgu20161466', 'joker.man2000000', 'ahmedramadan', 'omar_anwer', 'sgu20161508', 'amy', 'erhan26uzun', 'kareemk08', 'sadboijalal', 'ataozirmak', 'boules', 'moh.nabil2050', 'nadakhaled', 'fabio.signorelli', 'abdelmoneim404', 'sal7ien1999', 'sgu20151426', 'barkinsrc5', 'sgu20191494', 'youjiyeon', 'rubenasa', 'mohameda.younis80', 'amr.ghoname.teaching', 'ahmedsaeed', 'my1hunter', 'atknncvkkl', 'sgu20161536', 'sgu20161460', 'juni8472', 'sgu20171582', 'roshdy.aa', 'ramezakram97', 'demonkaksh', 'mernaeshakfaheem', 'pamilapoopad', 'metoyahia1999', 'nayeramakram98', 'sgu20171496', 'amartiger2020', 'melegy99', 'sgu20171528', 'tongmalual', 'sgu20191490', None, 'fatihakyurek26', 'ittopsk', 'hosamshaher43', 'cyrillemagdi', 'sug20182194', 'ebrahim.almohandes', 'sgu20191534', 'sgu20191466', 'b715063minbyeongmoon', 'sgu20151500', 'bassant.ahmed20118', 'mamoundiouri', 'sgu20151461', 'sgu20171536', 'beoungwoo', 'shadymagdy99', 'jaeeun53', 'karim20103200', 'andrewmon', 'omaraly112', 'sgu20171534', 'sgu20151878', 'marwanahmad988', 'jpuko11', 'sgu20171546', 'sgu20151434', 'raniamuhamed44', 'jaegisehyun', 'cbortlek', 'generalshephrd', 'abdulrahman.hussien1999', 'mohamed.eid1014', 'manjunath216', 'tndukaife2018', 'jpuko00', 'sgu20191462', 'alaa15eltehewey', 'ervndgn59', 'ahmadatef580', 'habiba.elkassas', 'youssefsamiryoussef', 'abdallahhashim', 'maged19991926', 'sgu20151421', 'mahmodfarag2000', 'b919083', 'yahiahamimi', 'yashhiteshbh', 'saga102938', 'sogang20191452', 'mpsingh', 'mirko.capodicasa', 'sgu20171596', 'ekicifatih0', 'sgu20151488', 'tanseerali', 'mohamed.zna66', 'sgu20161492', 'jlev713', 'm_feky', 'peterhorvath', 'sgu20171578', 'sgu20191476', 'shrouk.a.emad', 'abdoelanwar99', 'elsayedrafaat7', 'sgu20151507', 'rektxz', 'markashaf232', 'fasd556.om', 'sgu20171503', 'dina.23elessawy', 'michael29699', 'taawsifrc', 'faridmohammed98']"
1,398,283,43,16,"['reemayman101', 'moataz12mokhtar', 'mohamedsamir2591998', 'nohaabdelazeem11', 'mohamedsalah2', 'ahmadatef580', 'ahmedokasha1999', 'm.trika1999', 'a.ayman74', 'maged19991926', 'heshamelsedfy111', 'rektxz', 'mai99mahdy', 'ramymohsen', 'mohamed248688', 'ashraf_mohamed']",267,"['farid1010', 'sgu20161468', 'karim..mohamed745', 'okanssabah', 'ozanemreercan', 'sgu20161506', 'sgu20191512', 'mobahr', 'sgu20171492', 'maxwest', 'badryahmed33', 'mohamedelfeeky1', 'jchamarthi', 'abdelrahman98', 'aminsalah287', 'mayanmohamed', 'sgu20161541', 'sgu20161486', 'fayrouz21415', 'sgu20171588', 'sgu20191492', 'sgu20151431', 'comebacktome', 'nadeenmagdyy', 'tpcks96', 'romanynashaatmakeen', 'ampmstrawberryjam26', 'enesqwe', 'ahmedyosre007', 'sgu20181504', 'dodynn29', 'mohamed_a_mostafa', 'sgu20171552', 'sgu20161556', 'nada0abou0alsoud', 'sgu20181576', 'af5012175', 'kerolosmfawzy', 'raneemgaber', 'tutku', 'zhenming', 'sgu20161497', 'raa199014', 'youssefessawy', 'robikar', 'sgu20171510', 'esraayahia21', 'taha18499', 'sgu20171530', 'ahmedkamal', 'amrksh3198', 'jualipa1995', 'hmsgsaad', 'bguillet', 'yaseensalah83', 'kminhsu', 'tpranto', 'sgu20171592', 'sgu20171566', 'marcomuzzarelli', 'yilmaazmert', 'abdelrahman_oun', 'nourmahmoud', 'ranasherif244', 'mustafamahmoud567', 'bassant.ahmed235', 'mayaralmazy', 'sgu20191550', 'sgu20191454', 'salmatarek87', 'sgu20161507', 'sgu20191496', 'wyattm', 'sgu20161516', 'sgu20161518', 'mohannadragab53', 'abdulsamad', 'yubhop', 'sgu20151414', 'abdoulkh', 'seifelawadi26', 'hosamabdallah00', 'btngana1', 'nizquierdo', 'almekamobilya', 'sgu20171594', 'mayadamarie', 'werr011', 'sgu20181330', 'sug20171516', 'sohamamdooh', 'sgu20171564', 'zldrktgusrbs3242', 'yusufcheetos99', 'jihongkim', 'sgu20151428', 'ziad.amr201666', 'adham99', 'sgu20161528', 'sgu20151480', 'josef.me22', 'sgu20161488', 'harvovich', 'ardasavas6', 'getray.ah', 'their123', 'jihyeonlee', 'mohamed_98', 'haidy_emad', 'omarnabih21', 'ingyawad14', 'wodh97', 'ahmed_omar', 'youssefhassaan99', 'sgu20171516', 'ahmedmostafa5499', 'doraexplora', 'ashraf.amr82', 'nada.abomoslim', 'sgu20151453', 'saca', 'kareemmohamed68990', 'sgu20141461', 'sgu20131274', 'sgu20171548', 'tomymoty1', 'sgu20151467', 'rehab.sayed1231999', 'sgu20141740', 'hanmir', 'hye8913', 'maged.magdy666', 'mariam123456789', 'sgu20171506', 'nourhanne.bahaa', 'marwanyasser133', 'sgu20161538', 'kirollos.atef99', 'ahmed_mohsen', 'pshrap37', 'daniel.', 'mmhanafy99', 'vmike0426', 'sgu20151432', 'amr.m.araby', 'sgu20161512', 'mephistokc', 'michelhakim2001.mh', 'zazotop31', 'abdelrahmananwar', 'jisooyoon', 'michaelhelal99', 'sgu20171560', 'sgu20161466', 'joker.man2000000', 'ahmedramadan', 'omar_anwer', 'sgu20161508', 'amy', 'erhan26uzun', 'sadboijalal', 'ataozirmak', 'boules', 'moh.nabil2050', 'nadakhaled', 'fabio.signorelli', 'abdelmoneim404', 'sal7ien1999', 'sgu20151426', 'barkinsrc5', 'sgu20191494', 'youjiyeon', 'rubenasa', 'mohameda.younis80', 'amr.ghoname.teaching', 'ahmedsaeed', 'my1hunter', 'atknncvkkl', 'sgu20161536', 'sgu20161460', 'juni8472', 'sgu20171582', 'roshdy.aa', 'ramezakram97', 'demonkaksh', 'mernaeshakfaheem', 'pamilapoopad', 'metoyahia1999', 'nayeramakram98', 'sgu20171496', 'amartiger2020', 'melegy99', 'sgu20171528', 'tongmalual', 'sgu20191490', 'fatihakyurek26', 'ittopsk', 'hosamshaher43', 'cyrillemagdi', 'sug20182194', 'ebrahim.almohandes', 'sgu20191534', 'sgu20191466', 'b715063minbyeongmoon', 'sgu20151500', 'bassant.ahmed20118', 'mamoundiouri', 'sgu20151461', 'sgu20171536', 'beoungwoo', 'shadymagdy99', 'jaeeun53', 'karim20103200', 'andrewmon', 'omaraly112', 'sgu20171534', 'sgu20151878', 'marwanahmad988', 'jpuko11', 'sgu20171546', 'sgu20151434', 'raniamuhamed44', 'jaegisehyun', 'cbortlek', 'generalshephrd', 'abdulrahman.hussien1999', 'mohamed.eid1014', 'manjunath216', 'tndukaife2018', 'jpuko00', 'sgu20191462', 'alaa15eltehewey', 'ervndgn59', 'habiba.elkassas', 'youssefsamiryoussef', 'abdallahhashim', 'sgu20151421', 'mahmodfarag2000', 'b919083', 'yahiahamimi', 'yashhiteshbh', 'saga102938', 'sogang20191452', 'mpsingh', 'mirko.capodicasa', 'sgu20171596', 'ekicifatih0', 'sgu20151488', 'tanseerali', 'mohamed.zna66', 'sgu20161492', 'jlev713', 'm_feky', 'peterhorvath', 'sgu20171578', 'sgu20191476', 'shrouk.a.emad', 'abdoelanwar99', 'elsayedrafaat7', 'sgu20151507', 'markashaf232', 'fasd556.om', 'sgu20171503', 'dina.23elessawy', 'michael29699', 'taawsifrc', 'faridmohammed98']",27,"['ranaashraf129', 'medoshaban816', 'ahmedsamy888844', 'seifahmedamer', 'ahmedhamdyhalawa', 'ahhamed93', 'midoayman248', 'yumna.ghoneim', 'ronaldo2391999', 'mennamohamedhanafy392', 'ahmedmamin', 'karimtarek', 'youlianafouad17', 'sondossalah66', 'kareemk08', 'mostafa.maher591999', 'abdooo', 'mostafasaleh054', 'mohmedshimaa25', 'youssefelrouby4', None, 'ahmed.khaled.201420', 'seif8128', 'mohamedhamdy1120000', 'mahmoud.maree2010', 'mohamed_hesham', 'muhmedsalahm']",310,"['farid1010', 'sgu20161468', 'nohaabdelazeem11', 'mohamedsamir2591998', 'karim..mohamed745', 'okanssabah', 'ozanemreercan', 'sgu20161506', 'sgu20191512', 'mobahr', 'sgu20171492', 'maxwest', 'badryahmed33', 'mohamedelfeeky1', 'jchamarthi', 'abdelrahman98', 'mennamohamedhanafy392', 'aminsalah287', 'mayanmohamed', 'sgu20161541', 'sgu20161486', 'fayrouz21415', 'sgu20171588', 'mohamed248688', 'sgu20191492', 'sgu20151431', 'comebacktome', 'nadeenmagdyy', 'tpcks96', 'romanynashaatmakeen', 'ampmstrawberryjam26', 'enesqwe', 'm.trika1999', 'ahmedyosre007', 'sgu20181504', 'dodynn29', 'mohamed_a_mostafa', 'sgu20171552', 'sgu20161556', 'nada0abou0alsoud', 'sgu20181576', 'af5012175', 'kerolosmfawzy', 'raneemgaber', 'tutku', 'zhenming', 'sgu20161497', 'seifahmedamer', 'raa199014', 'reemayman101', 'youssefessawy', 'robikar', 'sgu20171510', 'esraayahia21', 'taha18499', 'sgu20171530', 'ahmedkamal', 'amrksh3198', 'moataz12mokhtar', 'jualipa1995', 'hmsgsaad', 'bguillet', 'yaseensalah83', 'sondossalah66', 'kminhsu', 'ahmedokasha1999', 'tpranto', 'sgu20171592', 'sgu20171566', 'marcomuzzarelli', 'yilmaazmert', 'abdelrahman_oun', 'nourmahmoud', 'ranasherif244', 'mustafamahmoud567', 'bassant.ahmed235', 'mayaralmazy', 'sgu20191550', 'sgu20191454', 'salmatarek87', 'sgu20161507', 'sgu20191496', 'wyattm', 'sgu20161516', 'medoshaban816', 'ahmedsamy888844', 'sgu20161518', 'mohannadragab53', 'abdulsamad', 'yubhop', 'sgu20151414', 'ahmedhamdyhalawa', 'abdoulkh', 'seifelawadi26', 'hosamabdallah00', 'btngana1', 'ramymohsen', 'nizquierdo', 'almekamobilya', 'sgu20171594', 'mayadamarie', 'werr011', 'ahhamed93', 'sgu20181330', 'ronaldo2391999', 'sug20171516', 'sohamamdooh', 'sgu20171564', 'zldrktgusrbs3242', 'yusufcheetos99', 'jihongkim', 'sgu20151428', 'ziad.amr201666', 'adham99', 'sgu20161528', 'sgu20151480', 'josef.me22', 'sgu20161488', 'harvovich', 'ardasavas6', 'getray.ah', 'their123', 'jihyeonlee', 'mohamed_98', 'haidy_emad', 'omarnabih21', 'mohamedhamdy1120000', 'ingyawad14', 'wodh97', 'ahmed_omar', 'youssefhassaan99', 'sgu20171516', 'ahmedmostafa5499', 'doraexplora', 'ashraf.amr82', 'nada.abomoslim', 'sgu20151453', 'saca', 'kareemmohamed68990', 'sgu20141461', 'sgu20131274', 'mohamedsalah2', 'sgu20171548', 'tomymoty1', 'sgu20151467', 'rehab.sayed1231999', 'abdooo', 'sgu20141740', 'hanmir', 'hye8913', 'ashraf_mohamed', 'maged.magdy666', 'mariam123456789', 'sgu20171506', 'nourhanne.bahaa', 'a.ayman74', 'marwanyasser133', 'sgu20161538', 'mahmoud.maree2010', 'kirollos.atef99', 'ahmed_mohsen', 'pshrap37', 'daniel.', 'mmhanafy99', 'heshamelsedfy111', 'vmike0426', 'sgu20151432', 'amr.m.araby', 'mai99mahdy', 'sgu20161512', 'mephistokc', 'michelhakim2001.mh', 'zazotop31', 'abdelrahmananwar', 'jisooyoon', 'michaelhelal99', 'sgu20171560', 'sgu20161466', 'joker.man2000000', 'ahmedramadan', 'omar_anwer', 'youlianafouad17', 'sgu20161508', 'amy', 'erhan26uzun', 'kareemk08', 'sadboijalal', 'mostafa.maher591999', 'ataozirmak', 'boules', 'moh.nabil2050', 'nadakhaled', 'fabio.signorelli', 'abdelmoneim404', 'sal7ien1999', 'sgu20151426', 'barkinsrc5', 'sgu20191494', 'youjiyeon', 'rubenasa', 'mohameda.younis80', 'amr.ghoname.teaching', 'ahmedsaeed', 'my1hunter', 'atknncvkkl', 'sgu20161536', 'sgu20161460', 'juni8472', 'sgu20171582', 'midoayman248', 'yumna.ghoneim', 'roshdy.aa', 'ramezakram97', 'demonkaksh', 'mernaeshakfaheem', 'pamilapoopad', 'metoyahia1999', 'karimtarek', 'nayeramakram98', 'sgu20171496', 'mostafasaleh054', 'amartiger2020', 'melegy99', 'sgu20171528', 'tongmalual', 'sgu20191490', 'youssefelrouby4', 'fatihakyurek26', None, 'ittopsk', 'hosamshaher43', 'cyrillemagdi', 'sug20182194', 'ebrahim.almohandes', 'sgu20191534', 'sgu20191466', 'b715063minbyeongmoon', 'sgu20151500', 'bassant.ahmed20118', 'ranaashraf129', 'mamoundiouri', 'sgu20151461', 'sgu20171536', 'beoungwoo', 'shadymagdy99', 'jaeeun53', 'karim20103200', 'andrewmon', 'omaraly112', 'sgu20171534', 'sgu20151878', 'marwanahmad988', 'jpuko11', 'sgu20171546', 'sgu20151434', 'raniamuhamed44', 'ahmedmamin', 'jaegisehyun', 'cbortlek', 'generalshephrd', 'abdulrahman.hussien1999', 'mohamed.eid1014', 'manjunath216', 'tndukaife2018', 'jpuko00', 'sgu20191462', 'alaa15eltehewey', 'ervndgn59', 'seif8128', 'ahmadatef580', 'habiba.elkassas', 'youssefsamiryoussef', 'abdallahhashim', 'maged19991926', 'sgu20151421', 'mahmodfarag2000', 'b919083', 'muhmedsalahm', 'yahiahamimi', 'yashhiteshbh', 'saga102938', 'sogang20191452', 'mpsingh', 'mirko.capodicasa', 'sgu20171596', 'ekicifatih0', 'sgu20151488', 'tanseerali', 'mohamed.zna66', 'sgu20161492', 'jlev713', 'm_feky', 'peterhorvath', 'sgu20171578', 'sgu20191476', 'shrouk.a.emad', 'abdoelanwar99', 'elsayedrafaat7', 'sgu20151507', 'mohmedshimaa25', 'rektxz', 'markashaf232', 'fasd556.om', 'sgu20171503', 'dina.23elessawy', 'ahmed.khaled.201420', 'michael29699', 'taawsifrc', 'mohamed_hesham', 'faridmohammed98']"
1,255,283,35,2,"['sgu20171496', 'sgu20171566']",281,"['farid1010', 'sgu20161468', 'nohaabdelazeem11', 'mohamedsamir2591998', 'karim..mohamed745', 'okanssabah', 'ozanemreercan', 'sgu20161506', 'sgu20191512', 'mobahr', 'sgu20171492', 'maxwest', 'badryahmed33', 'mohamedelfeeky1', 'jchamarthi', 'abdelrahman98', 'aminsalah287', 'mayanmohamed', 'sgu20161541', 'sgu20161486', 'fayrouz21415', 'sgu20171588', 'mohamed248688', 'sgu20191492', 'sgu20151431', 'comebacktome', 'nadeenmagdyy', 'tpcks96', 'romanynashaatmakeen', 'ampmstrawberryjam26', 'enesqwe', 'm.trika1999', 'ahmedyosre007', 'sgu20181504', 'dodynn29', 'mohamed_a_mostafa', 'sgu20171552', 'sgu20161556', 'nada0abou0alsoud', 'sgu20181576', 'af5012175', 'kerolosmfawzy', 'raneemgaber', 'tutku', 'zhenming', 'sgu20161497', 'raa199014', 'reemayman101', 'youssefessawy', 'robikar', 'sgu20171510', 'esraayahia21', 'taha18499', 'sgu20171530', 'ahmedkamal', 'amrksh3198', 'moataz12mokhtar', 'jualipa1995', 'hmsgsaad', 'bguillet', 'yaseensalah83', 'kminhsu', 'ahmedokasha1999', 'tpranto', 'sgu20171592', 'marcomuzzarelli', 'yilmaazmert', 'abdelrahman_oun', 'nourmahmoud', 'ranasherif244', 'mustafamahmoud567', 'bassant.ahmed235', 'mayaralmazy', 'sgu20191550', 'sgu20191454', 'salmatarek87', 'sgu20161507', 'sgu20191496', 'wyattm', 'sgu20161516', 'sgu20161518', 'mohannadragab53', 'abdulsamad', 'yubhop', 'sgu20151414', 'abdoulkh', 'seifelawadi26', 'hosamabdallah00', 'btngana1', 'ramymohsen', 'nizquierdo', 'almekamobilya', 'sgu20171594', 'mayadamarie', 'werr011', 'sgu20181330', 'sug20171516', 'sohamamdooh', 'sgu20171564', 'zldrktgusrbs3242', 'yusufcheetos99', 'jihongkim', 'sgu20151428', 'ziad.amr201666', 'adham99', 'sgu20161528', 'sgu20151480', 'josef.me22', 'sgu20161488', 'harvovich', 'ardasavas6', 'getray.ah', 'their123', 'jihyeonlee', 'mohamed_98', 'haidy_emad', 'omarnabih21', 'ingyawad14', 'wodh97', 'ahmed_omar', 'youssefhassaan99', 'sgu20171516', 'ahmedmostafa5499', 'doraexplora', 'ashraf.amr82', 'nada.abomoslim', 'sgu20151453', 'saca', 'kareemmohamed68990', 'sgu20141461', 'sgu20131274', 'mohamedsalah2', 'sgu20171548', 'tomymoty1', 'sgu20151467', 'rehab.sayed1231999', 'sgu20141740', 'hanmir', 'hye8913', 'ashraf_mohamed', 'maged.magdy666', 'mariam123456789', 'sgu20171506', 'nourhanne.bahaa', 'a.ayman74', 'marwanyasser133', 'sgu20161538', 'kirollos.atef99', 'ahmed_mohsen', 'pshrap37', 'daniel.', 'mmhanafy99', 'heshamelsedfy111', 'vmike0426', 'sgu20151432', 'amr.m.araby', 'mai99mahdy', 'sgu20161512', 'mephistokc', 'michelhakim2001.mh', 'zazotop31', 'abdelrahmananwar', 'jisooyoon', 'michaelhelal99', 'sgu20171560', 'sgu20161466', 'joker.man2000000', 'ahmedramadan', 'omar_anwer', 'sgu20161508', 'amy', 'erhan26uzun', 'sadboijalal', 'ataozirmak', 'boules', 'moh.nabil2050', 'nadakhaled', 'fabio.signorelli', 'abdelmoneim404', 'sal7ien1999', 'sgu20151426', 'barkinsrc5', 'sgu20191494', 'youjiyeon', 'rubenasa', 'mohameda.younis80', 'amr.ghoname.teaching', 'ahmedsaeed', 'my1hunter', 'atknncvkkl', 'sgu20161536', 'sgu20161460', 'juni8472', 'sgu20171582', 'roshdy.aa', 'ramezakram97', 'demonkaksh', 'mernaeshakfaheem', 'pamilapoopad', 'metoyahia1999', 'nayeramakram98', 'amartiger2020', 'melegy99', 'sgu20171528', 'tongmalual', 'sgu20191490', 'fatihakyurek26', 'ittopsk', 'hosamshaher43', 'cyrillemagdi', 'sug20182194', 'ebrahim.almohandes', 'sgu20191534', 'sgu20191466', 'b715063minbyeongmoon', 'sgu20151500', 'bassant.ahmed20118', 'mamoundiouri', 'sgu20151461', 'sgu20171536', 'beoungwoo', 'shadymagdy99', 'jaeeun53', 'karim20103200', 'andrewmon', 'omaraly112', 'sgu20171534', 'sgu20151878', 'marwanahmad988', 'jpuko11', 'sgu20171546', 'sgu20151434', 'raniamuhamed44', 'jaegisehyun', 'cbortlek', 'generalshephrd', 'abdulrahman.hussien1999', 'mohamed.eid1014', 'manjunath216', 'tndukaife2018', 'jpuko00', 'sgu20191462', 'alaa15eltehewey', 'ervndgn59', 'ahmadatef580', 'habiba.elkassas', 'youssefsamiryoussef', 'abdallahhashim', 'maged19991926', 'sgu20151421', 'mahmodfarag2000', 'b919083', 'yahiahamimi', 'yashhiteshbh', 'saga102938', 'sogang20191452', 'mpsingh', 'mirko.capodicasa', 'sgu20171596', 'ekicifatih0', 'sgu20151488', 'tanseerali', 'mohamed.zna66', 'sgu20161492', 'jlev713', 'm_feky', 'peterhorvath', 'sgu20171578', 'sgu20191476', 'shrouk.a.emad', 'abdoelanwar99', 'elsayedrafaat7', 'sgu20151507', 'rektxz', 'markashaf232', 'fasd556.om', 'sgu20171503', 'dina.23elessawy', 'michael29699', 'taawsifrc', 'faridmohammed98']",33,"['thko1014', 'sgu20141475', 'skarndgksqlc', 'sgu20161477', 'sgu20141341', 'sgu20181520', 'sepsep2000', 'sgu20181572', 'wkddbs97', 'chlqjawls789', 'jtj1012', 'sgu20161526', 'sgu20161542', 'gio960830', 'kevinon21', 'ehdwnse', 'sgu20171509', 'pook0612', 'sgu201514116', '97kkdh', 'heo9507123', 'sgu20171593', '112zxczxc', 'kyhee5020', 'taehojung', 'sgu20161527', 'deu02214', None, 'sgu20151285', 'sgu20171573', 'sgu20161510', 'pumpkin07', 'sgu20161519']",316,"['farid1010', 'sgu20161468', 'nohaabdelazeem11', 'mohamedsamir2591998', 'karim..mohamed745', 'okanssabah', 'ozanemreercan', 'sgu20161506', 'skarndgksqlc', 'sepsep2000', 'sgu20191512', 'mobahr', 'sgu20171492', 'maxwest', 'badryahmed33', 'mohamedelfeeky1', 'jchamarthi', 'abdelrahman98', 'heo9507123', 'aminsalah287', 'mayanmohamed', 'sgu20161541', 'sgu20161486', 'fayrouz21415', 'sgu20171588', 'mohamed248688', 'sgu20191492', 'sgu20151431', 'comebacktome', 'nadeenmagdyy', 'tpcks96', 'romanynashaatmakeen', 'ampmstrawberryjam26', 'enesqwe', 'm.trika1999', 'ahmedyosre007', 'sgu20181504', 'dodynn29', 'mohamed_a_mostafa', 'sgu20171552', 'sgu20161556', 'nada0abou0alsoud', 'sgu20181576', 'af5012175', 'kerolosmfawzy', 'raneemgaber', 'tutku', 'zhenming', 'sgu20161497', 'raa199014', 'wkddbs97', 'chlqjawls789', 'reemayman101', 'youssefessawy', 'robikar', 'sgu20171510', 'esraayahia21', 'taha18499', 'sgu20161542', 'sgu20171530', 'ahmedkamal', 'amrksh3198', 'moataz12mokhtar', 'jualipa1995', 'hmsgsaad', 'bguillet', 'yaseensalah83', 'kminhsu', 'ahmedokasha1999', 'tpranto', 'sgu20171592', 'sgu20171566', 'marcomuzzarelli', 'yilmaazmert', 'abdelrahman_oun', 'nourmahmoud', 'ranasherif244', 'mustafamahmoud567', 'bassant.ahmed235', 'mayaralmazy', 'sgu20191550', 'sgu20191454', 'salmatarek87', 'sgu20161507', 'sgu20191496', 'wyattm', 'sgu20161516', 'sgu20161518', 'mohannadragab53', 'sgu20141341', 'abdulsamad', 'yubhop', 'sgu20151414', 'abdoulkh', 'seifelawadi26', 'hosamabdallah00', 'btngana1', 'ramymohsen', 'nizquierdo', 'almekamobilya', 'sgu20171594', 'mayadamarie', 'werr011', 'sgu20161526', 'sgu20181330', 'pook0612', 'sgu20171593', 'sug20171516', 'sohamamdooh', 'sgu20171564', 'zldrktgusrbs3242', 'yusufcheetos99', 'jihongkim', 'sgu20151428', 'ziad.amr201666', 'adham99', 'sgu20161528', 'sgu20151480', 'josef.me22', 'sgu20161488', 'harvovich', 'ardasavas6', 'getray.ah', 'their123', 'sgu20151285', 'jihyeonlee', 'mohamed_98', 'haidy_emad', 'omarnabih21', 'ingyawad14', 'wodh97', 'ahmed_omar', 'youssefhassaan99', 'sgu20171516', 'ahmedmostafa5499', 'doraexplora', 'ashraf.amr82', 'nada.abomoslim', 'sgu20151453', 'saca', 'kareemmohamed68990', 'sgu20141461', 'sgu20131274', 'mohamedsalah2', 'sgu20171548', 'tomymoty1', 'sgu20151467', 'rehab.sayed1231999', 'sgu20141740', 'hanmir', 'hye8913', 'ashraf_mohamed', 'maged.magdy666', 'mariam123456789', 'sgu20171506', 'sgu20171573', 'nourhanne.bahaa', 'a.ayman74', 'marwanyasser133', 'sgu20161538', 'sgu20161519', 'kirollos.atef99', 'ahmed_mohsen', 'pshrap37', 'daniel.', 'mmhanafy99', 'heshamelsedfy111', 'vmike0426', 'sgu20151432', 'amr.m.araby', 'mai99mahdy', 'sgu20161512', 'jtj1012', 'mephistokc', 'michelhakim2001.mh', 'zazotop31', 'abdelrahmananwar', 'jisooyoon', 'michaelhelal99', '112zxczxc', 'sgu20171560', 'sgu20161466', 'joker.man2000000', 'ahmedramadan', 'omar_anwer', 'sgu20161508', 'amy', 'erhan26uzun', 'sadboijalal', 'ataozirmak', 'boules', 'moh.nabil2050', 'nadakhaled', 'fabio.signorelli', 'abdelmoneim404', 'sal7ien1999', 'sgu20151426', 'barkinsrc5', 'sgu20191494', 'youjiyeon', 'rubenasa', 'mohameda.younis80', 'amr.ghoname.teaching', 'ahmedsaeed', 'my1hunter', 'sgu20141475', 'atknncvkkl', 'sgu20161536', 'sgu20161477', 'sgu20161460', 'juni8472', 'sgu20171582', 'kevinon21', 'roshdy.aa', 'ehdwnse', 'sgu201514116', '97kkdh', 'ramezakram97', 'demonkaksh', 'mernaeshakfaheem', 'kyhee5020', 'pamilapoopad', 'metoyahia1999', 'nayeramakram98', 'sgu20171496', 'amartiger2020', 'deu02214', 'melegy99', 'sgu20171528', 'tongmalual', 'sgu20191490', None, 'fatihakyurek26', 'ittopsk', 'hosamshaher43', 'cyrillemagdi', 'sug20182194', 'ebrahim.almohandes', 'sgu20191534', 'sgu20191466', 'b715063minbyeongmoon', 'sgu20151500', 'bassant.ahmed20118', 'mamoundiouri', 'sgu20151461', 'sgu20171536', 'beoungwoo', 'shadymagdy99', 'jaeeun53', 'sgu20181520', 'karim20103200', 'andrewmon', 'omaraly112', 'sgu20171534', 'sgu20151878', 'marwanahmad988', 'jpuko11', 'sgu20171546', 'sgu20151434', 'raniamuhamed44', 'jaegisehyun', 'cbortlek', 'generalshephrd', 'abdulrahman.hussien1999', 'mohamed.eid1014', 'manjunath216', 'tndukaife2018', 'jpuko00', 'sgu20191462', 'alaa15eltehewey', 'ervndgn59', 'ahmadatef580', 'pumpkin07', 'habiba.elkassas', 'youssefsamiryoussef', 'abdallahhashim', 'maged19991926', 'sgu20151421', 'mahmodfarag2000', 'b919083', 'yahiahamimi', 'yashhiteshbh', 'saga102938', 'thko1014', 'sogang20191452', 'mpsingh', 'sgu20181572', 'mirko.capodicasa', 'sgu20171596', 'ekicifatih0', 'gio960830', 'sgu20151488', 'tanseerali', 'sgu20171509', 'mohamed.zna66', 'sgu20161492', 'jlev713', 'm_feky', 'peterhorvath', 'sgu20171578', 'sgu20191476', 'taehojung', 'shrouk.a.emad', 'abdoelanwar99', 'elsayedrafaat7', 'sgu20151507', 'rektxz', 'sgu20161527', 'markashaf232', 'fasd556.om', 'sgu20171503', 'dina.23elessawy', 'sgu20161510', 'michael29699', 'taawsifrc', 'faridmohammed98']"
1,11,283,27,1,['manjunath216'],282,"['farid1010', 'sgu20161468', 'nohaabdelazeem11', 'mohamedsamir2591998', 'karim..mohamed745', 'okanssabah', 'ozanemreercan', 'sgu20161506', 'sgu20191512', 'mobahr', 'sgu20171492', 'maxwest', 'badryahmed33', 'mohamedelfeeky1', 'jchamarthi', 'abdelrahman98', 'aminsalah287', 'mayanmohamed', 'sgu20161541', 'sgu20161486', 'fayrouz21415', 'sgu20171588', 'mohamed248688', 'sgu20191492', 'sgu20151431', 'comebacktome', 'nadeenmagdyy', 'tpcks96', 'romanynashaatmakeen', 'ampmstrawberryjam26', 'enesqwe', 'm.trika1999', 'ahmedyosre007', 'sgu20181504', 'dodynn29', 'mohamed_a_mostafa', 'sgu20171552', 'sgu20161556', 'nada0abou0alsoud', 'sgu20181576', 'af5012175', 'kerolosmfawzy', 'raneemgaber', 'tutku', 'zhenming', 'sgu20161497', 'raa199014', 'reemayman101', 'youssefessawy', 'robikar', 'sgu20171510', 'esraayahia21', 'taha18499', 'sgu20171530', 'ahmedkamal', 'amrksh3198', 'moataz12mokhtar', 'jualipa1995', 'hmsgsaad', 'bguillet', 'yaseensalah83', 'kminhsu', 'ahmedokasha1999', 'tpranto', 'sgu20171592', 'sgu20171566', 'marcomuzzarelli', 'yilmaazmert', 'abdelrahman_oun', 'nourmahmoud', 'ranasherif244', 'mustafamahmoud567', 'bassant.ahmed235', 'mayaralmazy', 'sgu20191550', 'sgu20191454', 'salmatarek87', 'sgu20161507', 'sgu20191496', 'wyattm', 'sgu20161516', 'sgu20161518', 'mohannadragab53', 'abdulsamad', 'yubhop', 'sgu20151414', 'abdoulkh', 'seifelawadi26', 'hosamabdallah00', 'btngana1', 'ramymohsen', 'nizquierdo', 'almekamobilya', 'sgu20171594', 'mayadamarie', 'werr011', 'sgu20181330', 'sug20171516', 'sohamamdooh', 'sgu20171564', 'zldrktgusrbs3242', 'yusufcheetos99', 'jihongkim', 'sgu20151428', 'ziad.amr201666', 'adham99', 'sgu20161528', 'sgu20151480', 'josef.me22', 'sgu20161488', 'harvovich', 'ardasavas6', 'getray.ah', 'their123', 'jihyeonlee', 'mohamed_98', 'haidy_emad', 'omarnabih21', 'ingyawad14', 'wodh97', 'ahmed_omar', 'youssefhassaan99', 'sgu20171516', 'ahmedmostafa5499', 'doraexplora', 'ashraf.amr82', 'nada.abomoslim', 'sgu20151453', 'saca', 'kareemmohamed68990', 'sgu20141461', 'sgu20131274', 'mohamedsalah2', 'sgu20171548', 'tomymoty1', 'sgu20151467', 'rehab.sayed1231999', 'sgu20141740', 'hanmir', 'hye8913', 'ashraf_mohamed', 'maged.magdy666', 'mariam123456789', 'sgu20171506', 'nourhanne.bahaa', 'a.ayman74', 'marwanyasser133', 'sgu20161538', 'kirollos.atef99', 'ahmed_mohsen', 'pshrap37', 'daniel.', 'mmhanafy99', 'heshamelsedfy111', 'vmike0426', 'sgu20151432', 'amr.m.araby', 'mai99mahdy', 'sgu20161512', 'mephistokc', 'michelhakim2001.mh', 'zazotop31', 'abdelrahmananwar', 'jisooyoon', 'michaelhelal99', 'sgu20171560', 'sgu20161466', 'joker.man2000000', 'ahmedramadan', 'omar_anwer', 'sgu20161508', 'amy', 'erhan26uzun', 'sadboijalal', 'ataozirmak', 'boules', 'moh.nabil2050', 'nadakhaled', 'fabio.signorelli', 'abdelmoneim404', 'sal7ien1999', 'sgu20151426', 'barkinsrc5', 'sgu20191494', 'youjiyeon', 'rubenasa', 'mohameda.younis80', 'amr.ghoname.teaching', 'ahmedsaeed', 'my1hunter', 'atknncvkkl', 'sgu20161536', 'sgu20161460', 'juni8472', 'sgu20171582', 'roshdy.aa', 'ramezakram97', 'demonkaksh', 'mernaeshakfaheem', 'pamilapoopad', 'metoyahia1999', 'nayeramakram98', 'sgu20171496', 'amartiger2020', 'melegy99', 'sgu20171528', 'tongmalual', 'sgu20191490', 'fatihakyurek26', 'ittopsk', 'hosamshaher43', 'cyrillemagdi', 'sug20182194', 'ebrahim.almohandes', 'sgu20191534', 'sgu20191466', 'b715063minbyeongmoon', 'sgu20151500', 'bassant.ahmed20118', 'mamoundiouri', 'sgu20151461', 'sgu20171536', 'beoungwoo', 'shadymagdy99', 'jaeeun53', 'karim20103200', 'andrewmon', 'omaraly112', 'sgu20171534', 'sgu20151878', 'marwanahmad988', 'jpuko11', 'sgu20171546', 'sgu20151434', 'raniamuhamed44', 'jaegisehyun', 'cbortlek', 'generalshephrd', 'abdulrahman.hussien1999', 'mohamed.eid1014', 'tndukaife2018', 'jpuko00', 'sgu20191462', 'alaa15eltehewey', 'ervndgn59', 'ahmadatef580', 'habiba.elkassas', 'youssefsamiryoussef', 'abdallahhashim', 'maged19991926', 'sgu20151421', 'mahmodfarag2000', 'b919083', 'yahiahamimi', 'yashhiteshbh', 'saga102938', 'sogang20191452', 'mpsingh', 'mirko.capodicasa', 'sgu20171596', 'ekicifatih0', 'sgu20151488', 'tanseerali', 'mohamed.zna66', 'sgu20161492', 'jlev713', 'm_feky', 'peterhorvath', 'sgu20171578', 'sgu20191476', 'shrouk.a.emad', 'abdoelanwar99', 'elsayedrafaat7', 'sgu20151507', 'rektxz', 'markashaf232', 'fasd556.om', 'sgu20171503', 'dina.23elessawy', 'michael29699', 'taawsifrc', 'faridmohammed98']",26,"['irohith', 'bananavati', 'varshit', 'ee19btech11042', 'likhita26', 'kpranav', 'ee19btech11006', 'ee19btech11030', 'srijithreddypakala001', 'chandramouli', 'jithin', 'sathvikaithagoni', 'sravanthi1', 'sakeths', 'alankritha', 'smaran43', 'ee19btech11022', 'oves', 'charitha2002', None, 'nishanth_kannan', 'ee19btech11033', 'mahima444', 'abhishekgautam011', 'sathvik', 'ee19btech11010']",309,"['farid1010', 'sgu20161468', 'nohaabdelazeem11', 'mohamedsamir2591998', 'karim..mohamed745', 'okanssabah', 'ozanemreercan', 'sgu20161506', 'sgu20191512', 'mobahr', 'sgu20171492', 'maxwest', 'badryahmed33', 'mohamedelfeeky1', 'jchamarthi', 'abdelrahman98', 'alankritha', 'aminsalah287', 'mayanmohamed', 'sgu20161541', 'sgu20161486', 'fayrouz21415', 'oves', 'sgu20171588', 'mohamed248688', 'sgu20191492', 'sgu20151431', 'comebacktome', 'nadeenmagdyy', 'tpcks96', 'romanynashaatmakeen', 'ampmstrawberryjam26', 'enesqwe', 'm.trika1999', 'ahmedyosre007', 'ee19btech11010', 'sgu20181504', 'dodynn29', 'mohamed_a_mostafa', 'sgu20171552', 'sgu20161556', 'nada0abou0alsoud', 'sgu20181576', 'af5012175', 'kerolosmfawzy', 'raneemgaber', 'tutku', 'zhenming', 'sgu20161497', 'raa199014', 'reemayman101', 'youssefessawy', 'robikar', 'sgu20171510', 'esraayahia21', 'taha18499', 'sgu20171530', 'ahmedkamal', 'sakeths', 'amrksh3198', 'moataz12mokhtar', 'jualipa1995', 'hmsgsaad', 'bguillet', 'yaseensalah83', 'kminhsu', 'ahmedokasha1999', 'tpranto', 'sgu20171592', 'sgu20171566', 'marcomuzzarelli', 'yilmaazmert', 'abdelrahman_oun', 'nourmahmoud', 'ranasherif244', 'mustafamahmoud567', 'bassant.ahmed235', 'mayaralmazy', 'sgu20191550', 'sgu20191454', 'salmatarek87', 'sathvik', 'sgu20161507', 'sgu20191496', 'wyattm', 'sgu20161516', 'sgu20161518', 'mohannadragab53', 'abdulsamad', 'yubhop', 'sgu20151414', 'ee19btech11006', 'abdoulkh', 'seifelawadi26', 'hosamabdallah00', 'btngana1', 'ramymohsen', 'nizquierdo', 'almekamobilya', 'sgu20171594', 'mayadamarie', 'werr011', 'srijithreddypakala001', 'sgu20181330', 'sug20171516', 'sohamamdooh', 'sgu20171564', 'zldrktgusrbs3242', 'yusufcheetos99', 'jihongkim', 'sgu20151428', 'ziad.amr201666', 'adham99', 'sgu20161528', 'sgu20151480', 'josef.me22', 'sgu20161488', 'harvovich', 'ardasavas6', 'getray.ah', 'their123', 'jihyeonlee', 'mohamed_98', 'haidy_emad', 'omarnabih21', 'ingyawad14', 'wodh97', 'ahmed_omar', 'kpranav', 'youssefhassaan99', 'sgu20171516', 'ahmedmostafa5499', 'doraexplora', 'ashraf.amr82', 'jithin', 'nada.abomoslim', 'sathvikaithagoni', 'sgu20151453', 'saca', 'kareemmohamed68990', 'sgu20141461', 'sgu20131274', 'mohamedsalah2', 'sgu20171548', 'tomymoty1', 'sgu20151467', 'rehab.sayed1231999', 'sgu20141740', 'hanmir', 'hye8913', 'ashraf_mohamed', 'maged.magdy666', 'mariam123456789', 'sgu20171506', 'nourhanne.bahaa', 'a.ayman74', 'marwanyasser133', 'sgu20161538', 'kirollos.atef99', 'irohith', 'bananavati', 'ahmed_mohsen', 'varshit', 'pshrap37', 'daniel.', 'mmhanafy99', 'likhita26', 'heshamelsedfy111', 'vmike0426', 'sgu20151432', 'amr.m.araby', 'mai99mahdy', 'sgu20161512', 'mephistokc', 'chandramouli', 'michelhakim2001.mh', 'zazotop31', 'abdelrahmananwar', 'jisooyoon', 'michaelhelal99', 'sgu20171560', 'sgu20161466', 'joker.man2000000', 'ahmedramadan', 'omar_anwer', 'sgu20161508', 'amy', 'erhan26uzun', 'sadboijalal', 'ataozirmak', 'boules', 'charitha2002', 'moh.nabil2050', 'nadakhaled', 'fabio.signorelli', 'ee19btech11033', 'abdelmoneim404', 'sal7ien1999', 'sgu20151426', 'barkinsrc5', 'sgu20191494', 'mahima444', 'youjiyeon', 'abhishekgautam011', 'rubenasa', 'mohameda.younis80', 'amr.ghoname.teaching', 'ahmedsaeed', 'my1hunter', 'atknncvkkl', 'sgu20161536', 'ee19btech11042', 'sgu20161460', 'juni8472', 'sgu20171582', 'ee19btech11030', 'roshdy.aa', 'sravanthi1', 'ramezakram97', 'demonkaksh', 'mernaeshakfaheem', 'pamilapoopad', 'metoyahia1999', 'nayeramakram98', 'sgu20171496', 'amartiger2020', 'melegy99', 'sgu20171528', 'tongmalual', 'sgu20191490', None, 'fatihakyurek26', 'ittopsk', 'hosamshaher43', 'cyrillemagdi', 'sug20182194', 'ebrahim.almohandes', 'sgu20191534', 'sgu20191466', 'b715063minbyeongmoon', 'sgu20151500', 'bassant.ahmed20118', 'mamoundiouri', 'sgu20151461', 'sgu20171536', 'beoungwoo', 'shadymagdy99', 'jaeeun53', 'karim20103200', 'andrewmon', 'omaraly112', 'sgu20171534', 'sgu20151878', 'marwanahmad988', 'jpuko11', 'sgu20171546', 'sgu20151434', 'raniamuhamed44', 'jaegisehyun', 'cbortlek', 'generalshephrd', 'abdulrahman.hussien1999', 'mohamed.eid1014', 'manjunath216', 'tndukaife2018', 'jpuko00', 'nishanth_kannan', 'sgu20191462', 'alaa15eltehewey', 'ervndgn59', 'ahmadatef580', 'habiba.elkassas', 'youssefsamiryoussef', 'abdallahhashim', 'maged19991926', 'sgu20151421', 'mahmodfarag2000', 'b919083', 'yahiahamimi', 'yashhiteshbh', 'saga102938', 'sogang20191452', 'mpsingh', 'mirko.capodicasa', 'sgu20171596', 'ekicifatih0', 'sgu20151488', 'tanseerali', 'mohamed.zna66', 'sgu20161492', 'jlev713', 'm_feky', 'smaran43', 'peterhorvath', 'sgu20171578', 'sgu20191476', 'shrouk.a.emad', 'ee19btech11022', 'abdoelanwar99', 'elsayedrafaat7', 'sgu20151507', 'rektxz', 'markashaf232', 'fasd556.om', 'sgu20171503', 'dina.23elessawy', 'michael29699', 'taawsifrc', 'faridmohammed98']"
1,20,283,25,14,"['hye8913', 'comebacktome', 'my1hunter', 'b919083', 'pshrap37', 'youjiyeon', 'wodh97', 'juni8472', 'jpuko11', 'hanmir', 'jpuko00', 'zldrktgusrbs3242', 'their123', 'b715063minbyeongmoon']",269,"['farid1010', 'sgu20161468', 'nohaabdelazeem11', 'mohamedsamir2591998', 'karim..mohamed745', 'okanssabah', 'ozanemreercan', 'sgu20161506', 'sgu20191512', 'mobahr', 'sgu20171492', 'maxwest', 'badryahmed33', 'mohamedelfeeky1', 'jchamarthi', 'abdelrahman98', 'aminsalah287', 'mayanmohamed', 'sgu20161541', 'sgu20161486', 'fayrouz21415', 'sgu20171588', 'mohamed248688', 'sgu20191492', 'sgu20151431', 'nadeenmagdyy', 'tpcks96', 'romanynashaatmakeen', 'ampmstrawberryjam26', 'enesqwe', 'm.trika1999', 'ahmedyosre007', 'sgu20181504', 'dodynn29', 'mohamed_a_mostafa', 'sgu20171552', 'sgu20161556', 'nada0abou0alsoud', 'sgu20181576', 'af5012175', 'kerolosmfawzy', 'raneemgaber', 'tutku', 'zhenming', 'sgu20161497', 'raa199014', 'reemayman101', 'youssefessawy', 'robikar', 'sgu20171510', 'esraayahia21', 'taha18499', 'sgu20171530', 'ahmedkamal', 'amrksh3198', 'moataz12mokhtar', 'jualipa1995', 'hmsgsaad', 'bguillet', 'yaseensalah83', 'kminhsu', 'ahmedokasha1999', 'tpranto', 'sgu20171592', 'sgu20171566', 'marcomuzzarelli', 'yilmaazmert', 'abdelrahman_oun', 'nourmahmoud', 'ranasherif244', 'mustafamahmoud567', 'bassant.ahmed235', 'mayaralmazy', 'sgu20191550', 'sgu20191454', 'salmatarek87', 'sgu20161507', 'sgu20191496', 'wyattm', 'sgu20161516', 'sgu20161518', 'mohannadragab53', 'abdulsamad', 'yubhop', 'sgu20151414', 'abdoulkh', 'seifelawadi26', 'hosamabdallah00', 'btngana1', 'ramymohsen', 'nizquierdo', 'almekamobilya', 'sgu20171594', 'mayadamarie', 'werr011', 'sgu20181330', 'sug20171516', 'sohamamdooh', 'sgu20171564', 'yusufcheetos99', 'jihongkim', 'sgu20151428', 'ziad.amr201666', 'adham99', 'sgu20161528', 'sgu20151480', 'josef.me22', 'sgu20161488', 'harvovich', 'ardasavas6', 'getray.ah', 'jihyeonlee', 'mohamed_98', 'haidy_emad', 'omarnabih21', 'ingyawad14', 'ahmed_omar', 'youssefhassaan99', 'sgu20171516', 'ahmedmostafa5499', 'doraexplora', 'ashraf.amr82', 'nada.abomoslim', 'sgu20151453', 'saca', 'kareemmohamed68990', 'sgu20141461', 'sgu20131274', 'mohamedsalah2', 'sgu20171548', 'tomymoty1', 'sgu20151467', 'rehab.sayed1231999', 'sgu20141740', 'ashraf_mohamed', 'maged.magdy666', 'mariam123456789', 'sgu20171506', 'nourhanne.bahaa', 'a.ayman74', 'marwanyasser133', 'sgu20161538', 'kirollos.atef99', 'ahmed_mohsen', 'daniel.', 'mmhanafy99', 'heshamelsedfy111', 'vmike0426', 'sgu20151432', 'amr.m.araby', 'mai99mahdy', 'sgu20161512', 'mephistokc', 'michelhakim2001.mh', 'zazotop31', 'abdelrahmananwar', 'jisooyoon', 'michaelhelal99', 'sgu20171560', 'sgu20161466', 'joker.man2000000', 'ahmedramadan', 'omar_anwer', 'sgu20161508', 'amy', 'erhan26uzun', 'sadboijalal', 'ataozirmak', 'boules', 'moh.nabil2050', 'nadakhaled', 'fabio.signorelli', 'abdelmoneim404', 'sal7ien1999', 'sgu20151426', 'barkinsrc5', 'sgu20191494', 'rubenasa', 'mohameda.younis80', 'amr.ghoname.teaching', 'ahmedsaeed', 'atknncvkkl', 'sgu20161536', 'sgu20161460', 'sgu20171582', 'roshdy.aa', 'ramezakram97', 'demonkaksh', 'mernaeshakfaheem', 'pamilapoopad', 'metoyahia1999', 'nayeramakram98', 'sgu20171496', 'amartiger2020', 'melegy99', 'sgu20171528', 'tongmalual', 'sgu20191490', 'fatihakyurek26', 'ittopsk', 'hosamshaher43', 'cyrillemagdi', 'sug20182194', 'ebrahim.almohandes', 'sgu20191534', 'sgu20191466', 'sgu20151500', 'bassant.ahmed20118', 'mamoundiouri', 'sgu20151461', 'sgu20171536', 'beoungwoo', 'shadymagdy99', 'jaeeun53', 'karim20103200', 'andrewmon', 'omaraly112', 'sgu20171534', 'sgu20151878', 'marwanahmad988', 'sgu20171546', 'sgu20151434', 'raniamuhamed44', 'jaegisehyun', 'cbortlek', 'generalshephrd', 'abdulrahman.hussien1999', 'mohamed.eid1014', 'manjunath216', 'tndukaife2018', 'sgu20191462', 'alaa15eltehewey', 'ervndgn59', 'ahmadatef580', 'habiba.elkassas', 'youssefsamiryoussef', 'abdallahhashim', 'maged19991926', 'sgu20151421', 'mahmodfarag2000', 'yahiahamimi', 'yashhiteshbh', 'saga102938', 'sogang20191452', 'mpsingh', 'mirko.capodicasa', 'sgu20171596', 'ekicifatih0', 'sgu20151488', 'tanseerali', 'mohamed.zna66', 'sgu20161492', 'jlev713', 'm_feky', 'peterhorvath', 'sgu20171578', 'sgu20191476', 'shrouk.a.emad', 'abdoelanwar99', 'elsayedrafaat7', 'sgu20151507', 'rektxz', 'markashaf232', 'fasd556.om', 'sgu20171503', 'dina.23elessawy', 'michael29699', 'taawsifrc', 'faridmohammed98']",11,"['eomhyobin1227', 'kimsw9506', 'kdm52', 'tjwldbsdbs', 'jgyyeong', 'aaddss3210', 'dldmsrbx', 'terry0511', 'poweroftrust', None, 'b619100']",294,"['farid1010', 'sgu20161468', 'nohaabdelazeem11', 'mohamedsamir2591998', 'karim..mohamed745', 'okanssabah', 'ozanemreercan', 'sgu20161506', 'sgu20191512', 'mobahr', 'sgu20171492', 'maxwest', 'badryahmed33', 'mohamedelfeeky1', 'jchamarthi', 'abdelrahman98', 'aminsalah287', 'mayanmohamed', 'sgu20161541', 'sgu20161486', 'fayrouz21415', 'sgu20171588', 'mohamed248688', 'sgu20191492', 'sgu20151431', 'comebacktome', 'nadeenmagdyy', 'tpcks96', 'romanynashaatmakeen', 'ampmstrawberryjam26', 'enesqwe', 'm.trika1999', 'ahmedyosre007', 'sgu20181504', 'dodynn29', 'mohamed_a_mostafa', 'sgu20171552', 'sgu20161556', 'nada0abou0alsoud', 'sgu20181576', 'af5012175', 'kerolosmfawzy', 'raneemgaber', 'tutku', 'zhenming', 'sgu20161497', 'raa199014', 'reemayman101', 'youssefessawy', 'robikar', 'sgu20171510', 'esraayahia21', 'taha18499', 'sgu20171530', 'ahmedkamal', 'amrksh3198', 'b619100', 'moataz12mokhtar', 'jualipa1995', 'hmsgsaad', 'bguillet', 'yaseensalah83', 'kminhsu', 'ahmedokasha1999', 'tpranto', 'sgu20171592', 'sgu20171566', 'marcomuzzarelli', 'yilmaazmert', 'abdelrahman_oun', 'nourmahmoud', 'ranasherif244', 'mustafamahmoud567', 'bassant.ahmed235', 'mayaralmazy', 'sgu20191550', 'sgu20191454', 'salmatarek87', 'sgu20161507', 'sgu20191496', 'wyattm', 'sgu20161516', 'kdm52', 'sgu20161518', 'mohannadragab53', 'abdulsamad', 'yubhop', 'sgu20151414', 'abdoulkh', 'seifelawadi26', 'hosamabdallah00', 'btngana1', 'ramymohsen', 'nizquierdo', 'almekamobilya', 'sgu20171594', 'mayadamarie', 'werr011', 'sgu20181330', 'dldmsrbx', 'poweroftrust', 'sug20171516', 'sohamamdooh', 'sgu20171564', 'zldrktgusrbs3242', 'yusufcheetos99', 'jihongkim', 'sgu20151428', 'ziad.amr201666', 'adham99', 'sgu20161528', 'sgu20151480', 'josef.me22', 'sgu20161488', 'harvovich', 'ardasavas6', 'getray.ah', 'their123', 'jihyeonlee', 'mohamed_98', 'haidy_emad', 'omarnabih21', 'ingyawad14', 'aaddss3210', 'wodh97', 'ahmed_omar', 'youssefhassaan99', 'sgu20171516', 'ahmedmostafa5499', 'doraexplora', 'ashraf.amr82', 'nada.abomoslim', 'sgu20151453', 'saca', 'kareemmohamed68990', 'sgu20141461', 'sgu20131274', 'mohamedsalah2', 'sgu20171548', 'tomymoty1', 'sgu20151467', 'rehab.sayed1231999', 'sgu20141740', 'hanmir', 'hye8913', 'ashraf_mohamed', 'maged.magdy666', 'mariam123456789', 'sgu20171506', 'nourhanne.bahaa', 'a.ayman74', 'marwanyasser133', 'sgu20161538', 'kirollos.atef99', 'eomhyobin1227', 'ahmed_mohsen', 'pshrap37', 'daniel.', 'mmhanafy99', 'heshamelsedfy111', 'vmike0426', 'sgu20151432', 'amr.m.araby', 'mai99mahdy', 'sgu20161512', 'mephistokc', 'michelhakim2001.mh', 'zazotop31', 'abdelrahmananwar', 'jisooyoon', 'michaelhelal99', 'sgu20171560', 'sgu20161466', 'joker.man2000000', 'ahmedramadan', 'omar_anwer', 'sgu20161508', 'amy', 'erhan26uzun', 'sadboijalal', 'ataozirmak', 'boules', 'moh.nabil2050', 'nadakhaled', 'fabio.signorelli', 'abdelmoneim404', 'sal7ien1999', 'sgu20151426', 'barkinsrc5', 'sgu20191494', 'terry0511', 'youjiyeon', 'rubenasa', 'mohameda.younis80', 'amr.ghoname.teaching', 'ahmedsaeed', 'my1hunter', 'atknncvkkl', 'sgu20161536', 'sgu20161460', 'juni8472', 'sgu20171582', 'roshdy.aa', 'ramezakram97', 'demonkaksh', 'mernaeshakfaheem', 'pamilapoopad', 'metoyahia1999', 'nayeramakram98', 'sgu20171496', 'amartiger2020', 'melegy99', 'sgu20171528', 'tongmalual', 'sgu20191490', None, 'fatihakyurek26', 'ittopsk', 'hosamshaher43', 'cyrillemagdi', 'sug20182194', 'ebrahim.almohandes', 'sgu20191534', 'sgu20191466', 'b715063minbyeongmoon', 'sgu20151500', 'bassant.ahmed20118', 'mamoundiouri', 'sgu20151461', 'sgu20171536', 'beoungwoo', 'shadymagdy99', 'jaeeun53', 'karim20103200', 'andrewmon', 'omaraly112', 'jgyyeong', 'sgu20171534', 'sgu20151878', 'marwanahmad988', 'jpuko11', 'sgu20171546', 'sgu20151434', 'raniamuhamed44', 'jaegisehyun', 'cbortlek', 'generalshephrd', 'abdulrahman.hussien1999', 'mohamed.eid1014', 'manjunath216', 'tndukaife2018', 'jpuko00', 'sgu20191462', 'alaa15eltehewey', 'ervndgn59', 'tjwldbsdbs', 'ahmadatef580', 'habiba.elkassas', 'youssefsamiryoussef', 'abdallahhashim', 'maged19991926', 'sgu20151421', 'mahmodfarag2000', 'b919083', 'yahiahamimi', 'yashhiteshbh', 'saga102938', 'sogang20191452', 'mpsingh', 'mirko.capodicasa', 'sgu20171596', 'kimsw9506', 'ekicifatih0', 'sgu20151488', 'tanseerali', 'mohamed.zna66', 'sgu20161492', 'jlev713', 'm_feky', 'peterhorvath', 'sgu20171578', 'sgu20191476', 'shrouk.a.emad', 'abdoelanwar99', 'elsayedrafaat7', 'sgu20151507', 'rektxz', 'markashaf232', 'fasd556.om', 'sgu20171503', 'dina.23elessawy', 'michael29699', 'taawsifrc', 'faridmohammed98']"
1,24,283,20,4,"['cbortlek', 'atknncvkkl', 'ekicifatih0', 'ardasavas6']",279,"['farid1010', 'sgu20161468', 'nohaabdelazeem11', 'mohamedsamir2591998', 'karim..mohamed745', 'okanssabah', 'ozanemreercan', 'sgu20161506', 'sgu20191512', 'mobahr', 'sgu20171492', 'maxwest', 'badryahmed33', 'mohamedelfeeky1', 'jchamarthi', 'abdelrahman98', 'aminsalah287', 'mayanmohamed', 'sgu20161541', 'sgu20161486', 'fayrouz21415', 'sgu20171588', 'mohamed248688', 'sgu20191492', 'sgu20151431', 'comebacktome', 'nadeenmagdyy', 'tpcks96', 'romanynashaatmakeen', 'ampmstrawberryjam26', 'enesqwe', 'm.trika1999', 'ahmedyosre007', 'sgu20181504', 'dodynn29', 'mohamed_a_mostafa', 'sgu20171552', 'sgu20161556', 'nada0abou0alsoud', 'sgu20181576', 'af5012175', 'kerolosmfawzy', 'raneemgaber', 'tutku', 'zhenming', 'sgu20161497', 'raa199014', 'reemayman101', 'youssefessawy', 'robikar', 'sgu20171510', 'esraayahia21', 'taha18499', 'sgu20171530', 'ahmedkamal', 'amrksh3198', 'moataz12mokhtar', 'jualipa1995', 'hmsgsaad', 'bguillet', 'yaseensalah83', 'kminhsu', 'ahmedokasha1999', 'tpranto', 'sgu20171592', 'sgu20171566', 'marcomuzzarelli', 'yilmaazmert', 'abdelrahman_oun', 'nourmahmoud', 'ranasherif244', 'mustafamahmoud567', 'bassant.ahmed235', 'mayaralmazy', 'sgu20191550', 'sgu20191454', 'salmatarek87', 'sgu20161507', 'sgu20191496', 'wyattm', 'sgu20161516', 'sgu20161518', 'mohannadragab53', 'abdulsamad', 'yubhop', 'sgu20151414', 'abdoulkh', 'seifelawadi26', 'hosamabdallah00', 'btngana1', 'ramymohsen', 'nizquierdo', 'almekamobilya', 'sgu20171594', 'mayadamarie', 'werr011', 'sgu20181330', 'sug20171516', 'sohamamdooh', 'sgu20171564', 'zldrktgusrbs3242', 'yusufcheetos99', 'jihongkim', 'sgu20151428', 'ziad.amr201666', 'adham99', 'sgu20161528', 'sgu20151480', 'josef.me22', 'sgu20161488', 'harvovich', 'getray.ah', 'their123', 'jihyeonlee', 'mohamed_98', 'haidy_emad', 'omarnabih21', 'ingyawad14', 'wodh97', 'ahmed_omar', 'youssefhassaan99', 'sgu20171516', 'ahmedmostafa5499', 'doraexplora', 'ashraf.amr82', 'nada.abomoslim', 'sgu20151453', 'saca', 'kareemmohamed68990', 'sgu20141461', 'sgu20131274', 'mohamedsalah2', 'sgu20171548', 'tomymoty1', 'sgu20151467', 'rehab.sayed1231999', 'sgu20141740', 'hanmir', 'hye8913', 'ashraf_mohamed', 'maged.magdy666', 'mariam123456789', 'sgu20171506', 'nourhanne.bahaa', 'a.ayman74', 'marwanyasser133', 'sgu20161538', 'kirollos.atef99', 'ahmed_mohsen', 'pshrap37', 'daniel.', 'mmhanafy99', 'heshamelsedfy111', 'vmike0426', 'sgu20151432', 'amr.m.araby', 'mai99mahdy', 'sgu20161512', 'mephistokc', 'michelhakim2001.mh', 'zazotop31', 'abdelrahmananwar', 'jisooyoon', 'michaelhelal99', 'sgu20171560', 'sgu20161466', 'joker.man2000000', 'ahmedramadan', 'omar_anwer', 'sgu20161508', 'amy', 'erhan26uzun', 'sadboijalal', 'ataozirmak', 'boules', 'moh.nabil2050', 'nadakhaled', 'fabio.signorelli', 'abdelmoneim404', 'sal7ien1999', 'sgu20151426', 'barkinsrc5', 'sgu20191494', 'youjiyeon', 'rubenasa', 'mohameda.younis80', 'amr.ghoname.teaching', 'ahmedsaeed', 'my1hunter', 'sgu20161536', 'sgu20161460', 'juni8472', 'sgu20171582', 'roshdy.aa', 'ramezakram97', 'demonkaksh', 'mernaeshakfaheem', 'pamilapoopad', 'metoyahia1999', 'nayeramakram98', 'sgu20171496', 'amartiger2020', 'melegy99', 'sgu20171528', 'tongmalual', 'sgu20191490', 'fatihakyurek26', 'ittopsk', 'hosamshaher43', 'cyrillemagdi', 'sug20182194', 'ebrahim.almohandes', 'sgu20191534', 'sgu20191466', 'b715063minbyeongmoon', 'sgu20151500', 'bassant.ahmed20118', 'mamoundiouri', 'sgu20151461', 'sgu20171536', 'beoungwoo', 'shadymagdy99', 'jaeeun53', 'karim20103200', 'andrewmon', 'omaraly112', 'sgu20171534', 'sgu20151878', 'marwanahmad988', 'jpuko11', 'sgu20171546', 'sgu20151434', 'raniamuhamed44', 'jaegisehyun', 'generalshephrd', 'abdulrahman.hussien1999', 'mohamed.eid1014', 'manjunath216', 'tndukaife2018', 'jpuko00', 'sgu20191462', 'alaa15eltehewey', 'ervndgn59', 'ahmadatef580', 'habiba.elkassas', 'youssefsamiryoussef', 'abdallahhashim', 'maged19991926', 'sgu20151421', 'mahmodfarag2000', 'b919083', 'yahiahamimi', 'yashhiteshbh', 'saga102938', 'sogang20191452', 'mpsingh', 'mirko.capodicasa', 'sgu20171596', 'sgu20151488', 'tanseerali', 'mohamed.zna66', 'sgu20161492', 'jlev713', 'm_feky', 'peterhorvath', 'sgu20171578', 'sgu20191476', 'shrouk.a.emad', 'abdoelanwar99', 'elsayedrafaat7', 'sgu20151507', 'rektxz', 'markashaf232', 'fasd556.om', 'sgu20171503', 'dina.23elessawy', 'michael29699', 'taawsifrc', 'faridmohammed98']",16,"['garfon61', 'testeremre70', 'eminakdemir93', 'muvafikmelikkaya', 'koningmehmet', 'ronmesdofb', 'karabayemre10', 'utkubala63', 'alex10', 'afkali.120', 'veyseleee123', 'emrecitakk', 'sflt317', 'mrgiraffe', None, 'selcukvatansever05']",299,"['farid1010', 'sgu20161468', 'nohaabdelazeem11', 'mohamedsamir2591998', 'karim..mohamed745', 'okanssabah', 'ozanemreercan', 'sgu20161506', 'sgu20191512', 'mobahr', 'sgu20171492', 'maxwest', 'badryahmed33', 'mohamedelfeeky1', 'jchamarthi', 'abdelrahman98', 'aminsalah287', 'mayanmohamed', 'sgu20161541', 'sgu20161486', 'fayrouz21415', 'sgu20171588', 'mohamed248688', 'sgu20191492', 'sgu20151431', 'comebacktome', 'nadeenmagdyy', 'tpcks96', 'romanynashaatmakeen', 'ampmstrawberryjam26', 'enesqwe', 'm.trika1999', 'ahmedyosre007', 'sgu20181504', 'dodynn29', 'mohamed_a_mostafa', 'sgu20171552', 'sgu20161556', 'nada0abou0alsoud', 'sgu20181576', 'af5012175', 'kerolosmfawzy', 'raneemgaber', 'tutku', 'zhenming', 'sgu20161497', 'raa199014', 'reemayman101', 'youssefessawy', 'robikar', 'sgu20171510', 'esraayahia21', 'taha18499', 'sgu20171530', 'ahmedkamal', 'amrksh3198', 'moataz12mokhtar', 'jualipa1995', 'hmsgsaad', 'bguillet', 'yaseensalah83', 'kminhsu', 'ahmedokasha1999', 'tpranto', 'sgu20171592', 'sgu20171566', 'marcomuzzarelli', 'utkubala63', 'karabayemre10', 'yilmaazmert', 'abdelrahman_oun', 'nourmahmoud', 'ranasherif244', 'mustafamahmoud567', 'bassant.ahmed235', 'mayaralmazy', 'sgu20191550', 'sgu20191454', 'salmatarek87', 'sgu20161507', 'sgu20191496', 'wyattm', 'sgu20161516', 'sgu20161518', 'eminakdemir93', 'mohannadragab53', 'abdulsamad', 'yubhop', 'sgu20151414', 'abdoulkh', 'seifelawadi26', 'hosamabdallah00', 'btngana1', 'ramymohsen', 'nizquierdo', 'almekamobilya', 'sgu20171594', 'mayadamarie', 'werr011', 'sgu20181330', 'sug20171516', 'sohamamdooh', 'sgu20171564', 'zldrktgusrbs3242', 'yusufcheetos99', 'jihongkim', 'sgu20151428', 'ziad.amr201666', 'adham99', 'sgu20161528', 'sgu20151480', 'josef.me22', 'sgu20161488', 'harvovich', 'ardasavas6', 'getray.ah', 'their123', 'jihyeonlee', 'mohamed_98', 'ronmesdofb', 'haidy_emad', 'omarnabih21', 'ingyawad14', 'wodh97', 'ahmed_omar', 'youssefhassaan99', 'sgu20171516', 'ahmedmostafa5499', 'doraexplora', 'ashraf.amr82', 'nada.abomoslim', 'sgu20151453', 'saca', 'kareemmohamed68990', 'sgu20141461', 'sgu20131274', 'mohamedsalah2', 'sgu20171548', 'tomymoty1', 'sgu20151467', 'rehab.sayed1231999', 'afkali.120', 'sgu20141740', 'hanmir', 'hye8913', 'ashraf_mohamed', 'maged.magdy666', 'mariam123456789', 'sgu20171506', 'nourhanne.bahaa', 'a.ayman74', 'marwanyasser133', 'sgu20161538', 'kirollos.atef99', 'ahmed_mohsen', 'pshrap37', 'daniel.', 'mmhanafy99', 'heshamelsedfy111', 'vmike0426', 'sgu20151432', 'amr.m.araby', 'mai99mahdy', 'sgu20161512', 'selcukvatansever05', 'mephistokc', 'michelhakim2001.mh', 'zazotop31', 'abdelrahmananwar', 'jisooyoon', 'michaelhelal99', 'sgu20171560', 'sgu20161466', 'joker.man2000000', 'ahmedramadan', 'omar_anwer', 'sgu20161508', 'amy', 'erhan26uzun', 'sadboijalal', 'ataozirmak', 'boules', 'moh.nabil2050', 'nadakhaled', 'fabio.signorelli', 'abdelmoneim404', 'sal7ien1999', 'sgu20151426', 'garfon61', 'barkinsrc5', 'sgu20191494', 'youjiyeon', 'rubenasa', 'alex10', 'mohameda.younis80', 'amr.ghoname.teaching', 'ahmedsaeed', 'my1hunter', 'atknncvkkl', 'sgu20161536', 'sgu20161460', 'juni8472', 'sgu20171582', 'roshdy.aa', 'ramezakram97', 'demonkaksh', 'mernaeshakfaheem', 'pamilapoopad', 'metoyahia1999', 'nayeramakram98', 'sgu20171496', 'amartiger2020', 'melegy99', 'sgu20171528', 'tongmalual', 'sgu20191490', None, 'fatihakyurek26', 'ittopsk', 'koningmehmet', 'hosamshaher43', 'cyrillemagdi', 'sug20182194', 'ebrahim.almohandes', 'sgu20191534', 'sgu20191466', 'b715063minbyeongmoon', 'sgu20151500', 'bassant.ahmed20118', 'mamoundiouri', 'sgu20151461', 'sgu20171536', 'beoungwoo', 'shadymagdy99', 'jaeeun53', 'karim20103200', 'andrewmon', 'omaraly112', 'sgu20171534', 'sgu20151878', 'marwanahmad988', 'emrecitakk', 'jpuko11', 'sgu20171546', 'sgu20151434', 'raniamuhamed44', 'jaegisehyun', 'cbortlek', 'generalshephrd', 'abdulrahman.hussien1999', 'mohamed.eid1014', 'manjunath216', 'sflt317', 'tndukaife2018', 'jpuko00', 'sgu20191462', 'alaa15eltehewey', 'ervndgn59', 'ahmadatef580', 'habiba.elkassas', 'youssefsamiryoussef', 'abdallahhashim', 'maged19991926', 'sgu20151421', 'mahmodfarag2000', 'b919083', 'yahiahamimi', 'yashhiteshbh', 'saga102938', 'sogang20191452', 'mpsingh', 'veyseleee123', 'mirko.capodicasa', 'sgu20171596', 'ekicifatih0', 'sgu20151488', 'tanseerali', 'muvafikmelikkaya', 'mohamed.zna66', 'mrgiraffe', 'sgu20161492', 'jlev713', 'm_feky', 'peterhorvath', 'sgu20171578', 'sgu20191476', 'shrouk.a.emad', 'testeremre70', 'abdoelanwar99', 'elsayedrafaat7', 'sgu20151507', 'rektxz', 'markashaf232', 'fasd556.om', 'sgu20171503', 'dina.23elessawy', 'michael29699', 'taawsifrc', 'faridmohammed98']"
1,352,283,19,18,"['sgu20171594', 'sgu20171552', 'comebacktome', 'sgu20171492', 'sgu20161508', 'sgu20161518', 'sgu20171548', 'pshrap37', 'ittopsk', 'sgu20161488', 'hanmir', 'vmike0426', 'sgu20171546', 'sug20171516', 'sgu20191534', 'sgu20171596', 'zldrktgusrbs3242', 'their123']",265,"['farid1010', 'sgu20161468', 'nohaabdelazeem11', 'mohamedsamir2591998', 'karim..mohamed745', 'okanssabah', 'ozanemreercan', 'sgu20161506', 'sgu20191512', 'mobahr', 'maxwest', 'badryahmed33', 'mohamedelfeeky1', 'jchamarthi', 'abdelrahman98', 'aminsalah287', 'mayanmohamed', 'sgu20161541', 'sgu20161486', 'fayrouz21415', 'sgu20171588', 'mohamed248688', 'sgu20191492', 'sgu20151431', 'nadeenmagdyy', 'tpcks96', 'romanynashaatmakeen', 'ampmstrawberryjam26', 'enesqwe', 'm.trika1999', 'ahmedyosre007', 'sgu20181504', 'dodynn29', 'mohamed_a_mostafa', 'sgu20161556', 'nada0abou0alsoud', 'sgu20181576', 'af5012175', 'kerolosmfawzy', 'raneemgaber', 'tutku', 'zhenming', 'sgu20161497', 'raa199014', 'reemayman101', 'youssefessawy', 'robikar', 'sgu20171510', 'esraayahia21', 'taha18499', 'sgu20171530', 'ahmedkamal', 'amrksh3198', 'moataz12mokhtar', 'jualipa1995', 'hmsgsaad', 'bguillet', 'yaseensalah83', 'kminhsu', 'ahmedokasha1999', 'tpranto', 'sgu20171592', 'sgu20171566', 'marcomuzzarelli', 'yilmaazmert', 'abdelrahman_oun', 'nourmahmoud', 'ranasherif244', 'mustafamahmoud567', 'bassant.ahmed235', 'mayaralmazy', 'sgu20191550', 'sgu20191454', 'salmatarek87', 'sgu20161507', 'sgu20191496', 'wyattm', 'sgu20161516', 'mohannadragab53', 'abdulsamad', 'yubhop', 'sgu20151414', 'abdoulkh', 'seifelawadi26', 'hosamabdallah00', 'btngana1', 'ramymohsen', 'nizquierdo', 'almekamobilya', 'mayadamarie', 'werr011', 'sgu20181330', 'sohamamdooh', 'sgu20171564', 'yusufcheetos99', 'jihongkim', 'sgu20151428', 'ziad.amr201666', 'adham99', 'sgu20161528', 'sgu20151480', 'josef.me22', 'harvovich', 'ardasavas6', 'getray.ah', 'jihyeonlee', 'mohamed_98', 'haidy_emad', 'omarnabih21', 'ingyawad14', 'wodh97', 'ahmed_omar', 'youssefhassaan99', 'sgu20171516', 'ahmedmostafa5499', 'doraexplora', 'ashraf.amr82', 'nada.abomoslim', 'sgu20151453', 'saca', 'kareemmohamed68990', 'sgu20141461', 'sgu20131274', 'mohamedsalah2', 'tomymoty1', 'sgu20151467', 'rehab.sayed1231999', 'sgu20141740', 'hye8913', 'ashraf_mohamed', 'maged.magdy666', 'mariam123456789', 'sgu20171506', 'nourhanne.bahaa', 'a.ayman74', 'marwanyasser133', 'sgu20161538', 'kirollos.atef99', 'ahmed_mohsen', 'daniel.', 'mmhanafy99', 'heshamelsedfy111', 'sgu20151432', 'amr.m.araby', 'mai99mahdy', 'sgu20161512', 'mephistokc', 'michelhakim2001.mh', 'zazotop31', 'abdelrahmananwar', 'jisooyoon', 'michaelhelal99', 'sgu20171560', 'sgu20161466', 'joker.man2000000', 'ahmedramadan', 'omar_anwer', 'amy', 'erhan26uzun', 'sadboijalal', 'ataozirmak', 'boules', 'moh.nabil2050', 'nadakhaled', 'fabio.signorelli', 'abdelmoneim404', 'sal7ien1999', 'sgu20151426', 'barkinsrc5', 'sgu20191494', 'youjiyeon', 'rubenasa', 'mohameda.younis80', 'amr.ghoname.teaching', 'ahmedsaeed', 'my1hunter', 'atknncvkkl', 'sgu20161536', 'sgu20161460', 'juni8472', 'sgu20171582', 'roshdy.aa', 'ramezakram97', 'demonkaksh', 'mernaeshakfaheem', 'pamilapoopad', 'metoyahia1999', 'nayeramakram98', 'sgu20171496', 'amartiger2020', 'melegy99', 'sgu20171528', 'tongmalual', 'sgu20191490', 'fatihakyurek26', 'hosamshaher43', 'cyrillemagdi', 'sug20182194', 'ebrahim.almohandes', 'sgu20191466', 'b715063minbyeongmoon', 'sgu20151500', 'bassant.ahmed20118', 'mamoundiouri', 'sgu20151461', 'sgu20171536', 'beoungwoo', 'shadymagdy99', 'jaeeun53', 'karim20103200', 'andrewmon', 'omaraly112', 'sgu20171534', 'sgu20151878', 'marwanahmad988', 'jpuko11', 'sgu20151434', 'raniamuhamed44', 'jaegisehyun', 'cbortlek', 'generalshephrd', 'abdulrahman.hussien1999', 'mohamed.eid1014', 'manjunath216', 'tndukaife2018', 'jpuko00', 'sgu20191462', 'alaa15eltehewey', 'ervndgn59', 'ahmadatef580', 'habiba.elkassas', 'youssefsamiryoussef', 'abdallahhashim', 'maged19991926', 'sgu20151421', 'mahmodfarag2000', 'b919083', 'yahiahamimi', 'yashhiteshbh', 'saga102938', 'sogang20191452', 'mpsingh', 'mirko.capodicasa', 'ekicifatih0', 'sgu20151488', 'tanseerali', 'mohamed.zna66', 'sgu20161492', 'jlev713', 'm_feky', 'peterhorvath', 'sgu20171578', 'sgu20191476', 'shrouk.a.emad', 'abdoelanwar99', 'elsayedrafaat7', 'sgu20151507', 'rektxz', 'markashaf232', 'fasd556.om', 'sgu20171503', 'dina.23elessawy', 'michael29699', 'taawsifrc', 'faridmohammed98']",1,[None],284,"['farid1010', 'sgu20161468', 'nohaabdelazeem11', 'mohamedsamir2591998', 'karim..mohamed745', 'okanssabah', 'ozanemreercan', 'sgu20161506', 'sgu20191512', 'mobahr', 'sgu20171492', 'maxwest', 'badryahmed33', 'mohamedelfeeky1', 'jchamarthi', 'abdelrahman98', 'aminsalah287', 'mayanmohamed', 'sgu20161541', 'sgu20161486', 'fayrouz21415', 'sgu20171588', 'mohamed248688', 'sgu20191492', 'sgu20151431', 'comebacktome', 'nadeenmagdyy', 'tpcks96', 'romanynashaatmakeen', 'ampmstrawberryjam26', 'enesqwe', 'm.trika1999', 'ahmedyosre007', 'sgu20181504', 'dodynn29', 'mohamed_a_mostafa', 'sgu20171552', 'sgu20161556', 'nada0abou0alsoud', 'sgu20181576', 'af5012175', 'kerolosmfawzy', 'raneemgaber', 'tutku', 'zhenming', 'sgu20161497', 'raa199014', 'reemayman101', 'youssefessawy', 'robikar', 'sgu20171510', 'esraayahia21', 'taha18499', 'sgu20171530', 'ahmedkamal', 'amrksh3198', 'moataz12mokhtar', 'jualipa1995', 'hmsgsaad', 'bguillet', 'yaseensalah83', 'kminhsu', 'ahmedokasha1999', 'tpranto', 'sgu20171592', 'sgu20171566', 'marcomuzzarelli', 'yilmaazmert', 'abdelrahman_oun', 'nourmahmoud', 'ranasherif244', 'mustafamahmoud567', 'bassant.ahmed235', 'mayaralmazy', 'sgu20191550', 'sgu20191454', 'salmatarek87', 'sgu20161507', 'sgu20191496', 'wyattm', 'sgu20161516', 'sgu20161518', 'mohannadragab53', 'abdulsamad', 'yubhop', 'sgu20151414', 'abdoulkh', 'seifelawadi26', 'hosamabdallah00', 'btngana1', 'ramymohsen', 'nizquierdo', 'almekamobilya', 'sgu20171594', 'mayadamarie', 'werr011', 'sgu20181330', 'sug20171516', 'sohamamdooh', 'sgu20171564', 'zldrktgusrbs3242', 'yusufcheetos99', 'jihongkim', 'sgu20151428', 'ziad.amr201666', 'adham99', 'sgu20161528', 'sgu20151480', 'josef.me22', 'sgu20161488', 'harvovich', 'ardasavas6', 'getray.ah', 'their123', 'jihyeonlee', 'mohamed_98', 'haidy_emad', 'omarnabih21', 'ingyawad14', 'wodh97', 'ahmed_omar', 'youssefhassaan99', 'sgu20171516', 'ahmedmostafa5499', 'doraexplora', 'ashraf.amr82', 'nada.abomoslim', 'sgu20151453', 'saca', 'kareemmohamed68990', 'sgu20141461', 'sgu20131274', 'mohamedsalah2', 'sgu20171548', 'tomymoty1', 'sgu20151467', 'rehab.sayed1231999', 'sgu20141740', 'hanmir', 'hye8913', 'ashraf_mohamed', 'maged.magdy666', 'mariam123456789', 'sgu20171506', 'nourhanne.bahaa', 'a.ayman74', 'marwanyasser133', 'sgu20161538', 'kirollos.atef99', 'ahmed_mohsen', 'pshrap37', 'daniel.', 'mmhanafy99', 'heshamelsedfy111', 'vmike0426', 'sgu20151432', 'amr.m.araby', 'mai99mahdy', 'sgu20161512', 'mephistokc', 'michelhakim2001.mh', 'zazotop31', 'abdelrahmananwar', 'jisooyoon', 'michaelhelal99', 'sgu20171560', 'sgu20161466', 'joker.man2000000', 'ahmedramadan', 'omar_anwer', 'sgu20161508', 'amy', 'erhan26uzun', 'sadboijalal', 'ataozirmak', 'boules', 'moh.nabil2050', 'nadakhaled', 'fabio.signorelli', 'abdelmoneim404', 'sal7ien1999', 'sgu20151426', 'barkinsrc5', 'sgu20191494', 'youjiyeon', 'rubenasa', 'mohameda.younis80', 'amr.ghoname.teaching', 'ahmedsaeed', 'my1hunter', 'atknncvkkl', 'sgu20161536', 'sgu20161460', 'juni8472', 'sgu20171582', 'roshdy.aa', 'ramezakram97', 'demonkaksh', 'mernaeshakfaheem', 'pamilapoopad', 'metoyahia1999', 'nayeramakram98', 'sgu20171496', 'amartiger2020', 'melegy99', 'sgu20171528', 'tongmalual', 'sgu20191490', None, 'fatihakyurek26', 'ittopsk', 'hosamshaher43', 'cyrillemagdi', 'sug20182194', 'ebrahim.almohandes', 'sgu20191534', 'sgu20191466', 'b715063minbyeongmoon', 'sgu20151500', 'bassant.ahmed20118', 'mamoundiouri', 'sgu20151461', 'sgu20171536', 'beoungwoo', 'shadymagdy99', 'jaeeun53', 'karim20103200', 'andrewmon', 'omaraly112', 'sgu20171534', 'sgu20151878', 'marwanahmad988', 'jpuko11', 'sgu20171546', 'sgu20151434', 'raniamuhamed44', 'jaegisehyun', 'cbortlek', 'generalshephrd', 'abdulrahman.hussien1999', 'mohamed.eid1014', 'manjunath216', 'tndukaife2018', 'jpuko00', 'sgu20191462', 'alaa15eltehewey', 'ervndgn59', 'ahmadatef580', 'habiba.elkassas', 'youssefsamiryoussef', 'abdallahhashim', 'maged19991926', 'sgu20151421', 'mahmodfarag2000', 'b919083', 'yahiahamimi', 'yashhiteshbh', 'saga102938', 'sogang20191452', 'mpsingh', 'mirko.capodicasa', 'sgu20171596', 'ekicifatih0', 'sgu20151488', 'tanseerali', 'mohamed.zna66', 'sgu20161492', 'jlev713', 'm_feky', 'peterhorvath', 'sgu20171578', 'sgu20191476', 'shrouk.a.emad', 'abdoelanwar99', 'elsayedrafaat7', 'sgu20151507', 'rektxz', 'markashaf232', 'fasd556.om', 'sgu20171503', 'dina.23elessawy', 'michael29699', 'taawsifrc', 'faridmohammed98']"
1,26,283,15,5,"['yilmaazmert', 'erhan26uzun', 'enesqwe', 'ozanemreercan', 'fatihakyurek26']",278,"['farid1010', 'sgu20161468', 'nohaabdelazeem11', 'mohamedsamir2591998', 'karim..mohamed745', 'okanssabah', 'sgu20161506', 'sgu20191512', 'mobahr', 'sgu20171492', 'maxwest', 'badryahmed33', 'mohamedelfeeky1', 'jchamarthi', 'abdelrahman98', 'aminsalah287', 'mayanmohamed', 'sgu20161541', 'sgu20161486', 'fayrouz21415', 'sgu20171588', 'mohamed248688', 'sgu20191492', 'sgu20151431', 'comebacktome', 'nadeenmagdyy', 'tpcks96', 'romanynashaatmakeen', 'ampmstrawberryjam26', 'm.trika1999', 'ahmedyosre007', 'sgu20181504', 'dodynn29', 'mohamed_a_mostafa', 'sgu20171552', 'sgu20161556', 'nada0abou0alsoud', 'sgu20181576', 'af5012175', 'kerolosmfawzy', 'raneemgaber', 'tutku', 'zhenming', 'sgu20161497', 'raa199014', 'reemayman101', 'youssefessawy', 'robikar', 'sgu20171510', 'esraayahia21', 'taha18499', 'sgu20171530', 'ahmedkamal', 'amrksh3198', 'moataz12mokhtar', 'jualipa1995', 'hmsgsaad', 'bguillet', 'yaseensalah83', 'kminhsu', 'ahmedokasha1999', 'tpranto', 'sgu20171592', 'sgu20171566', 'marcomuzzarelli', 'abdelrahman_oun', 'nourmahmoud', 'ranasherif244', 'mustafamahmoud567', 'bassant.ahmed235', 'mayaralmazy', 'sgu20191550', 'sgu20191454', 'salmatarek87', 'sgu20161507', 'sgu20191496', 'wyattm', 'sgu20161516', 'sgu20161518', 'mohannadragab53', 'abdulsamad', 'yubhop', 'sgu20151414', 'abdoulkh', 'seifelawadi26', 'hosamabdallah00', 'btngana1', 'ramymohsen', 'nizquierdo', 'almekamobilya', 'sgu20171594', 'mayadamarie', 'werr011', 'sgu20181330', 'sug20171516', 'sohamamdooh', 'sgu20171564', 'zldrktgusrbs3242', 'yusufcheetos99', 'jihongkim', 'sgu20151428', 'ziad.amr201666', 'adham99', 'sgu20161528', 'sgu20151480', 'josef.me22', 'sgu20161488', 'harvovich', 'ardasavas6', 'getray.ah', 'their123', 'jihyeonlee', 'mohamed_98', 'haidy_emad', 'omarnabih21', 'ingyawad14', 'wodh97', 'ahmed_omar', 'youssefhassaan99', 'sgu20171516', 'ahmedmostafa5499', 'doraexplora', 'ashraf.amr82', 'nada.abomoslim', 'sgu20151453', 'saca', 'kareemmohamed68990', 'sgu20141461', 'sgu20131274', 'mohamedsalah2', 'sgu20171548', 'tomymoty1', 'sgu20151467', 'rehab.sayed1231999', 'sgu20141740', 'hanmir', 'hye8913', 'ashraf_mohamed', 'maged.magdy666', 'mariam123456789', 'sgu20171506', 'nourhanne.bahaa', 'a.ayman74', 'marwanyasser133', 'sgu20161538', 'kirollos.atef99', 'ahmed_mohsen', 'pshrap37', 'daniel.', 'mmhanafy99', 'heshamelsedfy111', 'vmike0426', 'sgu20151432', 'amr.m.araby', 'mai99mahdy', 'sgu20161512', 'mephistokc', 'michelhakim2001.mh', 'zazotop31', 'abdelrahmananwar', 'jisooyoon', 'michaelhelal99', 'sgu20171560', 'sgu20161466', 'joker.man2000000', 'ahmedramadan', 'omar_anwer', 'sgu20161508', 'amy', 'sadboijalal', 'ataozirmak', 'boules', 'moh.nabil2050', 'nadakhaled', 'fabio.signorelli', 'abdelmoneim404', 'sal7ien1999', 'sgu20151426', 'barkinsrc5', 'sgu20191494', 'youjiyeon', 'rubenasa', 'mohameda.younis80', 'amr.ghoname.teaching', 'ahmedsaeed', 'my1hunter', 'atknncvkkl', 'sgu20161536', 'sgu20161460', 'juni8472', 'sgu20171582', 'roshdy.aa', 'ramezakram97', 'demonkaksh', 'mernaeshakfaheem', 'pamilapoopad', 'metoyahia1999', 'nayeramakram98', 'sgu20171496', 'amartiger2020', 'melegy99', 'sgu20171528', 'tongmalual', 'sgu20191490', 'ittopsk', 'hosamshaher43', 'cyrillemagdi', 'sug20182194', 'ebrahim.almohandes', 'sgu20191534', 'sgu20191466', 'b715063minbyeongmoon', 'sgu20151500', 'bassant.ahmed20118', 'mamoundiouri', 'sgu20151461', 'sgu20171536', 'beoungwoo', 'shadymagdy99', 'jaeeun53', 'karim20103200', 'andrewmon', 'omaraly112', 'sgu20171534', 'sgu20151878', 'marwanahmad988', 'jpuko11', 'sgu20171546', 'sgu20151434', 'raniamuhamed44', 'jaegisehyun', 'cbortlek', 'generalshephrd', 'abdulrahman.hussien1999', 'mohamed.eid1014', 'manjunath216', 'tndukaife2018', 'jpuko00', 'sgu20191462', 'alaa15eltehewey', 'ervndgn59', 'ahmadatef580', 'habiba.elkassas', 'youssefsamiryoussef', 'abdallahhashim', 'maged19991926', 'sgu20151421', 'mahmodfarag2000', 'b919083', 'yahiahamimi', 'yashhiteshbh', 'saga102938', 'sogang20191452', 'mpsingh', 'mirko.capodicasa', 'sgu20171596', 'ekicifatih0', 'sgu20151488', 'tanseerali', 'mohamed.zna66', 'sgu20161492', 'jlev713', 'm_feky', 'peterhorvath', 'sgu20171578', 'sgu20191476', 'shrouk.a.emad', 'abdoelanwar99', 'elsayedrafaat7', 'sgu20151507', 'rektxz', 'markashaf232', 'fasd556.om', 'sgu20171503', 'dina.23elessawy', 'michael29699', 'taawsifrc', 'faridmohammed98']",10,"['samimorsoglu', 'byzayh13', 'esraboran71', 'furkan069906', 'mseyfullahcelik', 'serhatiseri', 'yamakonurcan', None, 'salcaburak', 'uzunnurdan']",293,"['farid1010', 'sgu20161468', 'nohaabdelazeem11', 'mohamedsamir2591998', 'karim..mohamed745', 'okanssabah', 'ozanemreercan', 'sgu20161506', 'sgu20191512', 'mobahr', 'sgu20171492', 'maxwest', 'badryahmed33', 'mohamedelfeeky1', 'jchamarthi', 'abdelrahman98', 'aminsalah287', 'mayanmohamed', 'sgu20161541', 'sgu20161486', 'fayrouz21415', 'sgu20171588', 'mohamed248688', 'sgu20191492', 'sgu20151431', 'comebacktome', 'nadeenmagdyy', 'samimorsoglu', 'tpcks96', 'romanynashaatmakeen', 'ampmstrawberryjam26', 'enesqwe', 'm.trika1999', 'ahmedyosre007', 'sgu20181504', 'dodynn29', 'mohamed_a_mostafa', 'sgu20171552', 'sgu20161556', 'nada0abou0alsoud', 'sgu20181576', 'af5012175', 'kerolosmfawzy', 'raneemgaber', 'tutku', 'zhenming', 'sgu20161497', 'raa199014', 'reemayman101', 'youssefessawy', 'robikar', 'sgu20171510', 'esraayahia21', 'taha18499', 'sgu20171530', 'ahmedkamal', 'mseyfullahcelik', 'amrksh3198', 'moataz12mokhtar', 'jualipa1995', 'hmsgsaad', 'bguillet', 'yaseensalah83', 'kminhsu', 'ahmedokasha1999', 'tpranto', 'sgu20171592', 'sgu20171566', 'marcomuzzarelli', 'yilmaazmert', 'abdelrahman_oun', 'nourmahmoud', 'ranasherif244', 'mustafamahmoud567', 'bassant.ahmed235', 'mayaralmazy', 'sgu20191550', 'sgu20191454', 'salmatarek87', 'serhatiseri', 'sgu20161507', 'sgu20191496', 'wyattm', 'sgu20161516', 'sgu20161518', 'mohannadragab53', 'abdulsamad', 'yubhop', 'sgu20151414', 'abdoulkh', 'seifelawadi26', 'hosamabdallah00', 'btngana1', 'ramymohsen', 'nizquierdo', 'almekamobilya', 'sgu20171594', 'mayadamarie', 'werr011', 'sgu20181330', 'sug20171516', 'sohamamdooh', 'sgu20171564', 'zldrktgusrbs3242', 'yusufcheetos99', 'jihongkim', 'sgu20151428', 'ziad.amr201666', 'adham99', 'sgu20161528', 'sgu20151480', 'josef.me22', 'sgu20161488', 'harvovich', 'ardasavas6', 'getray.ah', 'their123', 'uzunnurdan', 'jihyeonlee', 'mohamed_98', 'haidy_emad', 'omarnabih21', 'ingyawad14', 'wodh97', 'ahmed_omar', 'youssefhassaan99', 'sgu20171516', 'ahmedmostafa5499', 'doraexplora', 'ashraf.amr82', 'nada.abomoslim', 'sgu20151453', 'saca', 'kareemmohamed68990', 'sgu20141461', 'sgu20131274', 'mohamedsalah2', 'sgu20171548', 'tomymoty1', 'sgu20151467', 'rehab.sayed1231999', 'sgu20141740', 'hanmir', 'hye8913', 'ashraf_mohamed', 'maged.magdy666', 'mariam123456789', 'sgu20171506', 'nourhanne.bahaa', 'a.ayman74', 'marwanyasser133', 'sgu20161538', 'kirollos.atef99', 'ahmed_mohsen', 'pshrap37', 'daniel.', 'mmhanafy99', 'heshamelsedfy111', 'vmike0426', 'sgu20151432', 'amr.m.araby', 'mai99mahdy', 'sgu20161512', 'mephistokc', 'byzayh13', 'michelhakim2001.mh', 'zazotop31', 'abdelrahmananwar', 'jisooyoon', 'michaelhelal99', 'sgu20171560', 'sgu20161466', 'joker.man2000000', 'ahmedramadan', 'omar_anwer', 'sgu20161508', 'amy', 'erhan26uzun', 'sadboijalal', 'ataozirmak', 'boules', 'moh.nabil2050', 'nadakhaled', 'fabio.signorelli', 'abdelmoneim404', 'sal7ien1999', 'sgu20151426', 'barkinsrc5', 'sgu20191494', 'furkan069906', 'youjiyeon', 'rubenasa', 'mohameda.younis80', 'amr.ghoname.teaching', 'ahmedsaeed', 'my1hunter', 'atknncvkkl', 'sgu20161536', 'sgu20161460', 'juni8472', 'sgu20171582', 'salcaburak', 'roshdy.aa', 'esraboran71', 'ramezakram97', 'demonkaksh', 'mernaeshakfaheem', 'pamilapoopad', 'metoyahia1999', 'nayeramakram98', 'sgu20171496', 'amartiger2020', 'melegy99', 'sgu20171528', 'tongmalual', 'sgu20191490', None, 'fatihakyurek26', 'ittopsk', 'hosamshaher43', 'cyrillemagdi', 'sug20182194', 'ebrahim.almohandes', 'sgu20191534', 'sgu20191466', 'b715063minbyeongmoon', 'sgu20151500', 'bassant.ahmed20118', 'mamoundiouri', 'sgu20151461', 'sgu20171536', 'beoungwoo', 'shadymagdy99', 'jaeeun53', 'karim20103200', 'andrewmon', 'omaraly112', 'sgu20171534', 'sgu20151878', 'marwanahmad988', 'jpuko11', 'sgu20171546', 'sgu20151434', 'raniamuhamed44', 'jaegisehyun', 'cbortlek', 'generalshephrd', 'abdulrahman.hussien1999', 'mohamed.eid1014', 'manjunath216', 'tndukaife2018', 'jpuko00', 'sgu20191462', 'alaa15eltehewey', 'ervndgn59', 'ahmadatef580', 'habiba.elkassas', 'youssefsamiryoussef', 'abdallahhashim', 'maged19991926', 'sgu20151421', 'mahmodfarag2000', 'b919083', 'yahiahamimi', 'yashhiteshbh', 'saga102938', 'sogang20191452', 'mpsingh', 'mirko.capodicasa', 'sgu20171596', 'ekicifatih0', 'sgu20151488', 'tanseerali', 'mohamed.zna66', 'sgu20161492', 'jlev713', 'm_feky', 'peterhorvath', 'sgu20171578', 'sgu20191476', 'shrouk.a.emad', 'abdoelanwar99', 'elsayedrafaat7', 'sgu20151507', 'rektxz', 'markashaf232', 'yamakonurcan', 'fasd556.om', 'sgu20171503', 'dina.23elessawy', 'michael29699', 'taawsifrc', 'faridmohammed98']"
1,18,283,14,1,['maxwest'],282,"['farid1010', 'sgu20161468', 'nohaabdelazeem11', 'mohamedsamir2591998', 'karim..mohamed745', 'okanssabah', 'ozanemreercan', 'sgu20161506', 'sgu20191512', 'mobahr', 'sgu20171492', 'badryahmed33', 'mohamedelfeeky1', 'jchamarthi', 'abdelrahman98', 'aminsalah287', 'mayanmohamed', 'sgu20161541', 'sgu20161486', 'fayrouz21415', 'sgu20171588', 'mohamed248688', 'sgu20191492', 'sgu20151431', 'comebacktome', 'nadeenmagdyy', 'tpcks96', 'romanynashaatmakeen', 'ampmstrawberryjam26', 'enesqwe', 'm.trika1999', 'ahmedyosre007', 'sgu20181504', 'dodynn29', 'mohamed_a_mostafa', 'sgu20171552', 'sgu20161556', 'nada0abou0alsoud', 'sgu20181576', 'af5012175', 'kerolosmfawzy', 'raneemgaber', 'tutku', 'zhenming', 'sgu20161497', 'raa199014', 'reemayman101', 'youssefessawy', 'robikar', 'sgu20171510', 'esraayahia21', 'taha18499', 'sgu20171530', 'ahmedkamal', 'amrksh3198', 'moataz12mokhtar', 'jualipa1995', 'hmsgsaad', 'bguillet', 'yaseensalah83', 'kminhsu', 'ahmedokasha1999', 'tpranto', 'sgu20171592', 'sgu20171566', 'marcomuzzarelli', 'yilmaazmert', 'abdelrahman_oun', 'nourmahmoud', 'ranasherif244', 'mustafamahmoud567', 'bassant.ahmed235', 'mayaralmazy', 'sgu20191550', 'sgu20191454', 'salmatarek87', 'sgu20161507', 'sgu20191496', 'wyattm', 'sgu20161516', 'sgu20161518', 'mohannadragab53', 'abdulsamad', 'yubhop', 'sgu20151414', 'abdoulkh', 'seifelawadi26', 'hosamabdallah00', 'btngana1', 'ramymohsen', 'nizquierdo', 'almekamobilya', 'sgu20171594', 'mayadamarie', 'werr011', 'sgu20181330', 'sug20171516', 'sohamamdooh', 'sgu20171564', 'zldrktgusrbs3242', 'yusufcheetos99', 'jihongkim', 'sgu20151428', 'ziad.amr201666', 'adham99', 'sgu20161528', 'sgu20151480', 'josef.me22', 'sgu20161488', 'harvovich', 'ardasavas6', 'getray.ah', 'their123', 'jihyeonlee', 'mohamed_98', 'haidy_emad', 'omarnabih21', 'ingyawad14', 'wodh97', 'ahmed_omar', 'youssefhassaan99', 'sgu20171516', 'ahmedmostafa5499', 'doraexplora', 'ashraf.amr82', 'nada.abomoslim', 'sgu20151453', 'saca', 'kareemmohamed68990', 'sgu20141461', 'sgu20131274', 'mohamedsalah2', 'sgu20171548', 'tomymoty1', 'sgu20151467', 'rehab.sayed1231999', 'sgu20141740', 'hanmir', 'hye8913', 'ashraf_mohamed', 'maged.magdy666', 'mariam123456789', 'sgu20171506', 'nourhanne.bahaa', 'a.ayman74', 'marwanyasser133', 'sgu20161538', 'kirollos.atef99', 'ahmed_mohsen', 'pshrap37', 'daniel.', 'mmhanafy99', 'heshamelsedfy111', 'vmike0426', 'sgu20151432', 'amr.m.araby', 'mai99mahdy', 'sgu20161512', 'mephistokc', 'michelhakim2001.mh', 'zazotop31', 'abdelrahmananwar', 'jisooyoon', 'michaelhelal99', 'sgu20171560', 'sgu20161466', 'joker.man2000000', 'ahmedramadan', 'omar_anwer', 'sgu20161508', 'amy', 'erhan26uzun', 'sadboijalal', 'ataozirmak', 'boules', 'moh.nabil2050', 'nadakhaled', 'fabio.signorelli', 'abdelmoneim404', 'sal7ien1999', 'sgu20151426', 'barkinsrc5', 'sgu20191494', 'youjiyeon', 'rubenasa', 'mohameda.younis80', 'amr.ghoname.teaching', 'ahmedsaeed', 'my1hunter', 'atknncvkkl', 'sgu20161536', 'sgu20161460', 'juni8472', 'sgu20171582', 'roshdy.aa', 'ramezakram97', 'demonkaksh', 'mernaeshakfaheem', 'pamilapoopad', 'metoyahia1999', 'nayeramakram98', 'sgu20171496', 'amartiger2020', 'melegy99', 'sgu20171528', 'tongmalual', 'sgu20191490', 'fatihakyurek26', 'ittopsk', 'hosamshaher43', 'cyrillemagdi', 'sug20182194', 'ebrahim.almohandes', 'sgu20191534', 'sgu20191466', 'b715063minbyeongmoon', 'sgu20151500', 'bassant.ahmed20118', 'mamoundiouri', 'sgu20151461', 'sgu20171536', 'beoungwoo', 'shadymagdy99', 'jaeeun53', 'karim20103200', 'andrewmon', 'omaraly112', 'sgu20171534', 'sgu20151878', 'marwanahmad988', 'jpuko11', 'sgu20171546', 'sgu20151434', 'raniamuhamed44', 'jaegisehyun', 'cbortlek', 'generalshephrd', 'abdulrahman.hussien1999', 'mohamed.eid1014', 'manjunath216', 'tndukaife2018', 'jpuko00', 'sgu20191462', 'alaa15eltehewey', 'ervndgn59', 'ahmadatef580', 'habiba.elkassas', 'youssefsamiryoussef', 'abdallahhashim', 'maged19991926', 'sgu20151421', 'mahmodfarag2000', 'b919083', 'yahiahamimi', 'yashhiteshbh', 'saga102938', 'sogang20191452', 'mpsingh', 'mirko.capodicasa', 'sgu20171596', 'ekicifatih0', 'sgu20151488', 'tanseerali', 'mohamed.zna66', 'sgu20161492', 'jlev713', 'm_feky', 'peterhorvath', 'sgu20171578', 'sgu20191476', 'shrouk.a.emad', 'abdoelanwar99', 'elsayedrafaat7', 'sgu20151507', 'rektxz', 'markashaf232', 'fasd556.om', 'sgu20171503', 'dina.23elessawy', 'michael29699', 'taawsifrc', 'faridmohammed98']",13,"[None, 'ttruman', 'ostanley', 'irobertson', 'procchetti', 'wlongwf', 'oscarglenister', 'azheng1', 'cpattinson', 'anakhl', 'paolo.rocchetti.96', 'specialkay', 'rasd232']",296,"['farid1010', 'sgu20161468', 'nohaabdelazeem11', 'mohamedsamir2591998', 'karim..mohamed745', 'okanssabah', 'ozanemreercan', 'sgu20161506', 'sgu20191512', 'mobahr', 'sgu20171492', 'maxwest', 'badryahmed33', 'mohamedelfeeky1', 'jchamarthi', 'abdelrahman98', 'aminsalah287', 'mayanmohamed', 'sgu20161541', 'sgu20161486', 'fayrouz21415', 'sgu20171588', 'mohamed248688', 'sgu20191492', 'sgu20151431', 'comebacktome', 'nadeenmagdyy', 'tpcks96', 'romanynashaatmakeen', 'ampmstrawberryjam26', 'enesqwe', 'm.trika1999', 'ahmedyosre007', 'sgu20181504', 'dodynn29', 'mohamed_a_mostafa', 'sgu20171552', 'sgu20161556', 'nada0abou0alsoud', 'sgu20181576', 'af5012175', 'kerolosmfawzy', 'raneemgaber', 'tutku', 'zhenming', 'sgu20161497', 'raa199014', 'reemayman101', 'youssefessawy', 'robikar', 'sgu20171510', 'esraayahia21', 'taha18499', 'sgu20171530', 'ahmedkamal', 'amrksh3198', 'moataz12mokhtar', 'jualipa1995', 'hmsgsaad', 'bguillet', 'yaseensalah83', 'kminhsu', 'ahmedokasha1999', 'tpranto', 'sgu20171592', 'sgu20171566', 'marcomuzzarelli', 'yilmaazmert', 'abdelrahman_oun', 'nourmahmoud', 'ranasherif244', 'mustafamahmoud567', 'bassant.ahmed235', 'mayaralmazy', 'sgu20191550', 'sgu20191454', 'salmatarek87', 'sgu20161507', 'sgu20191496', 'wyattm', 'sgu20161516', 'sgu20161518', 'mohannadragab53', 'abdulsamad', 'yubhop', 'sgu20151414', 'cpattinson', 'abdoulkh', 'seifelawadi26', 'hosamabdallah00', 'btngana1', 'ramymohsen', 'nizquierdo', 'almekamobilya', 'sgu20171594', 'mayadamarie', 'werr011', 'sgu20181330', 'sug20171516', 'sohamamdooh', 'sgu20171564', 'zldrktgusrbs3242', 'yusufcheetos99', 'jihongkim', 'sgu20151428', 'ziad.amr201666', 'adham99', 'sgu20161528', 'sgu20151480', 'josef.me22', 'sgu20161488', 'harvovich', 'ardasavas6', 'anakhl', 'getray.ah', 'their123', 'jihyeonlee', 'mohamed_98', 'haidy_emad', 'omarnabih21', 'ingyawad14', 'wodh97', 'ahmed_omar', 'youssefhassaan99', 'sgu20171516', 'ahmedmostafa5499', 'doraexplora', 'ashraf.amr82', 'nada.abomoslim', 'sgu20151453', 'saca', 'kareemmohamed68990', 'sgu20141461', 'sgu20131274', 'mohamedsalah2', 'sgu20171548', 'tomymoty1', 'sgu20151467', 'rehab.sayed1231999', 'sgu20141740', 'hanmir', 'hye8913', 'ashraf_mohamed', 'maged.magdy666', 'mariam123456789', 'sgu20171506', 'nourhanne.bahaa', 'a.ayman74', 'marwanyasser133', 'sgu20161538', 'kirollos.atef99', 'ahmed_mohsen', 'pshrap37', 'daniel.', 'mmhanafy99', 'heshamelsedfy111', 'vmike0426', 'sgu20151432', 'amr.m.araby', 'mai99mahdy', 'sgu20161512', 'mephistokc', 'michelhakim2001.mh', 'zazotop31', 'abdelrahmananwar', 'jisooyoon', 'michaelhelal99', 'sgu20171560', 'sgu20161466', 'joker.man2000000', 'ahmedramadan', 'omar_anwer', 'sgu20161508', 'amy', 'erhan26uzun', 'sadboijalal', 'ataozirmak', 'boules', 'moh.nabil2050', 'nadakhaled', 'fabio.signorelli', 'abdelmoneim404', 'sal7ien1999', 'sgu20151426', 'barkinsrc5', 'sgu20191494', 'youjiyeon', 'azheng1', 'rubenasa', 'mohameda.younis80', 'amr.ghoname.teaching', 'ahmedsaeed', 'my1hunter', 'atknncvkkl', 'sgu20161536', 'ostanley', 'sgu20161460', 'juni8472', 'sgu20171582', 'roshdy.aa', 'ramezakram97', 'demonkaksh', 'mernaeshakfaheem', 'pamilapoopad', 'metoyahia1999', 'nayeramakram98', 'sgu20171496', 'amartiger2020', 'melegy99', 'sgu20171528', 'tongmalual', 'sgu20191490', None, 'fatihakyurek26', 'ittopsk', 'hosamshaher43', 'cyrillemagdi', 'sug20182194', 'ebrahim.almohandes', 'sgu20191534', 'sgu20191466', 'b715063minbyeongmoon', 'sgu20151500', 'bassant.ahmed20118', 'mamoundiouri', 'sgu20151461', 'sgu20171536', 'irobertson', 'beoungwoo', 'shadymagdy99', 'jaeeun53', 'karim20103200', 'andrewmon', 'ttruman', 'omaraly112', 'sgu20171534', 'sgu20151878', 'marwanahmad988', 'jpuko11', 'sgu20171546', 'sgu20151434', 'raniamuhamed44', 'jaegisehyun', 'cbortlek', 'generalshephrd', 'abdulrahman.hussien1999', 'mohamed.eid1014', 'manjunath216', 'tndukaife2018', 'jpuko00', 'sgu20191462', 'alaa15eltehewey', 'procchetti', 'ervndgn59', 'ahmadatef580', 'habiba.elkassas', 'youssefsamiryoussef', 'abdallahhashim', 'maged19991926', 'sgu20151421', 'mahmodfarag2000', 'b919083', 'yahiahamimi', 'yashhiteshbh', 'saga102938', 'sogang20191452', 'mpsingh', 'wlongwf', 'mirko.capodicasa', 'sgu20171596', 'specialkay', 'rasd232', 'ekicifatih0', 'sgu20151488', 'tanseerali', 'mohamed.zna66', 'sgu20161492', 'jlev713', 'm_feky', 'peterhorvath', 'sgu20171578', 'sgu20191476', 'shrouk.a.emad', 'abdoelanwar99', 'elsayedrafaat7', 'sgu20151507', 'rektxz', 'markashaf232', 'oscarglenister', 'fasd556.om', 'sgu20171503', 'dina.23elessawy', 'michael29699', 'taawsifrc', 'paolo.rocchetti.96', 'faridmohammed98']"
1,27,283,13,1,['ataozirmak'],282,"['farid1010', 'sgu20161468', 'nohaabdelazeem11', 'mohamedsamir2591998', 'karim..mohamed745', 'okanssabah', 'ozanemreercan', 'sgu20161506', 'sgu20191512', 'mobahr', 'sgu20171492', 'maxwest', 'badryahmed33', 'mohamedelfeeky1', 'jchamarthi', 'abdelrahman98', 'aminsalah287', 'mayanmohamed', 'sgu20161541', 'sgu20161486', 'fayrouz21415', 'sgu20171588', 'mohamed248688', 'sgu20191492', 'sgu20151431', 'comebacktome', 'nadeenmagdyy', 'tpcks96', 'romanynashaatmakeen', 'ampmstrawberryjam26', 'enesqwe', 'm.trika1999', 'ahmedyosre007', 'sgu20181504', 'dodynn29', 'mohamed_a_mostafa', 'sgu20171552', 'sgu20161556', 'nada0abou0alsoud', 'sgu20181576', 'af5012175', 'kerolosmfawzy', 'raneemgaber', 'tutku', 'zhenming', 'sgu20161497', 'raa199014', 'reemayman101', 'youssefessawy', 'robikar', 'sgu20171510', 'esraayahia21', 'taha18499', 'sgu20171530', 'ahmedkamal', 'amrksh3198', 'moataz12mokhtar', 'jualipa1995', 'hmsgsaad', 'bguillet', 'yaseensalah83', 'kminhsu', 'ahmedokasha1999', 'tpranto', 'sgu20171592', 'sgu20171566', 'marcomuzzarelli', 'yilmaazmert', 'abdelrahman_oun', 'nourmahmoud', 'ranasherif244', 'mustafamahmoud567', 'bassant.ahmed235', 'mayaralmazy', 'sgu20191550', 'sgu20191454', 'salmatarek87', 'sgu20161507', 'sgu20191496', 'wyattm', 'sgu20161516', 'sgu20161518', 'mohannadragab53', 'abdulsamad', 'yubhop', 'sgu20151414', 'abdoulkh', 'seifelawadi26', 'hosamabdallah00', 'btngana1', 'ramymohsen', 'nizquierdo', 'almekamobilya', 'sgu20171594', 'mayadamarie', 'werr011', 'sgu20181330', 'sug20171516', 'sohamamdooh', 'sgu20171564', 'zldrktgusrbs3242', 'yusufcheetos99', 'jihongkim', 'sgu20151428', 'ziad.amr201666', 'adham99', 'sgu20161528', 'sgu20151480', 'josef.me22', 'sgu20161488', 'harvovich', 'ardasavas6', 'getray.ah', 'their123', 'jihyeonlee', 'mohamed_98', 'haidy_emad', 'omarnabih21', 'ingyawad14', 'wodh97', 'ahmed_omar', 'youssefhassaan99', 'sgu20171516', 'ahmedmostafa5499', 'doraexplora', 'ashraf.amr82', 'nada.abomoslim', 'sgu20151453', 'saca', 'kareemmohamed68990', 'sgu20141461', 'sgu20131274', 'mohamedsalah2', 'sgu20171548', 'tomymoty1', 'sgu20151467', 'rehab.sayed1231999', 'sgu20141740', 'hanmir', 'hye8913', 'ashraf_mohamed', 'maged.magdy666', 'mariam123456789', 'sgu20171506', 'nourhanne.bahaa', 'a.ayman74', 'marwanyasser133', 'sgu20161538', 'kirollos.atef99', 'ahmed_mohsen', 'pshrap37', 'daniel.', 'mmhanafy99', 'heshamelsedfy111', 'vmike0426', 'sgu20151432', 'amr.m.araby', 'mai99mahdy', 'sgu20161512', 'mephistokc', 'michelhakim2001.mh', 'zazotop31', 'abdelrahmananwar', 'jisooyoon', 'michaelhelal99', 'sgu20171560', 'sgu20161466', 'joker.man2000000', 'ahmedramadan', 'omar_anwer', 'sgu20161508', 'amy', 'erhan26uzun', 'sadboijalal', 'boules', 'moh.nabil2050', 'nadakhaled', 'fabio.signorelli', 'abdelmoneim404', 'sal7ien1999', 'sgu20151426', 'barkinsrc5', 'sgu20191494', 'youjiyeon', 'rubenasa', 'mohameda.younis80', 'amr.ghoname.teaching', 'ahmedsaeed', 'my1hunter', 'atknncvkkl', 'sgu20161536', 'sgu20161460', 'juni8472', 'sgu20171582', 'roshdy.aa', 'ramezakram97', 'demonkaksh', 'mernaeshakfaheem', 'pamilapoopad', 'metoyahia1999', 'nayeramakram98', 'sgu20171496', 'amartiger2020', 'melegy99', 'sgu20171528', 'tongmalual', 'sgu20191490', 'fatihakyurek26', 'ittopsk', 'hosamshaher43', 'cyrillemagdi', 'sug20182194', 'ebrahim.almohandes', 'sgu20191534', 'sgu20191466', 'b715063minbyeongmoon', 'sgu20151500', 'bassant.ahmed20118', 'mamoundiouri', 'sgu20151461', 'sgu20171536', 'beoungwoo', 'shadymagdy99', 'jaeeun53', 'karim20103200', 'andrewmon', 'omaraly112', 'sgu20171534', 'sgu20151878', 'marwanahmad988', 'jpuko11', 'sgu20171546', 'sgu20151434', 'raniamuhamed44', 'jaegisehyun', 'cbortlek', 'generalshephrd', 'abdulrahman.hussien1999', 'mohamed.eid1014', 'manjunath216', 'tndukaife2018', 'jpuko00', 'sgu20191462', 'alaa15eltehewey', 'ervndgn59', 'ahmadatef580', 'habiba.elkassas', 'youssefsamiryoussef', 'abdallahhashim', 'maged19991926', 'sgu20151421', 'mahmodfarag2000', 'b919083', 'yahiahamimi', 'yashhiteshbh', 'saga102938', 'sogang20191452', 'mpsingh', 'mirko.capodicasa', 'sgu20171596', 'ekicifatih0', 'sgu20151488', 'tanseerali', 'mohamed.zna66', 'sgu20161492', 'jlev713', 'm_feky', 'peterhorvath', 'sgu20171578', 'sgu20191476', 'shrouk.a.emad', 'abdoelanwar99', 'elsayedrafaat7', 'sgu20151507', 'rektxz', 'markashaf232', 'fasd556.om', 'sgu20171503', 'dina.23elessawy', 'michael29699', 'taawsifrc', 'faridmohammed98']",12,"['talayhalil2626', 'serhatkahraman183', 'emircansimsek', 'metobomm', '86kemal86', 'murattdo', 'mehmetaliyas1998', 'mseyfullahcelik', 'behlul', 'alibatuhanozturk', 'mrgiraffe', None]",295,"['farid1010', 'sgu20161468', 'nohaabdelazeem11', 'mohamedsamir2591998', 'karim..mohamed745', 'okanssabah', 'ozanemreercan', 'sgu20161506', 'sgu20191512', 'mobahr', 'sgu20171492', 'maxwest', 'badryahmed33', 'mohamedelfeeky1', 'jchamarthi', 'abdelrahman98', 'murattdo', 'aminsalah287', 'mayanmohamed', 'sgu20161541', 'metobomm', 'sgu20161486', 'fayrouz21415', 'sgu20171588', 'mohamed248688', 'sgu20191492', 'sgu20151431', 'comebacktome', 'nadeenmagdyy', 'tpcks96', 'romanynashaatmakeen', 'ampmstrawberryjam26', 'enesqwe', 'm.trika1999', 'ahmedyosre007', 'sgu20181504', 'dodynn29', 'mohamed_a_mostafa', 'talayhalil2626', 'sgu20171552', 'sgu20161556', 'nada0abou0alsoud', 'sgu20181576', 'af5012175', 'kerolosmfawzy', 'raneemgaber', 'tutku', 'zhenming', 'sgu20161497', 'raa199014', 'alibatuhanozturk', 'reemayman101', 'youssefessawy', 'robikar', 'sgu20171510', 'esraayahia21', 'taha18499', 'sgu20171530', 'ahmedkamal', 'mseyfullahcelik', 'amrksh3198', 'moataz12mokhtar', 'jualipa1995', 'hmsgsaad', 'bguillet', 'yaseensalah83', 'kminhsu', 'ahmedokasha1999', 'tpranto', 'sgu20171592', 'sgu20171566', 'marcomuzzarelli', 'yilmaazmert', 'abdelrahman_oun', 'nourmahmoud', 'ranasherif244', 'mustafamahmoud567', 'bassant.ahmed235', 'mayaralmazy', 'sgu20191550', 'sgu20191454', 'salmatarek87', 'sgu20161507', 'sgu20191496', 'wyattm', 'sgu20161516', 'sgu20161518', 'mohannadragab53', 'abdulsamad', 'yubhop', 'sgu20151414', 'abdoulkh', 'seifelawadi26', 'hosamabdallah00', 'btngana1', 'ramymohsen', 'nizquierdo', 'almekamobilya', 'sgu20171594', 'mayadamarie', 'werr011', 'sgu20181330', 'sug20171516', 'sohamamdooh', 'sgu20171564', 'zldrktgusrbs3242', 'yusufcheetos99', 'jihongkim', 'sgu20151428', 'ziad.amr201666', 'adham99', 'sgu20161528', 'sgu20151480', 'josef.me22', 'sgu20161488', 'harvovich', 'ardasavas6', 'getray.ah', 'their123', 'jihyeonlee', 'mohamed_98', 'haidy_emad', 'omarnabih21', 'ingyawad14', 'wodh97', 'ahmed_omar', 'youssefhassaan99', 'sgu20171516', 'ahmedmostafa5499', 'doraexplora', 'ashraf.amr82', 'emircansimsek', 'nada.abomoslim', 'sgu20151453', 'saca', 'kareemmohamed68990', 'sgu20141461', 'sgu20131274', 'mohamedsalah2', 'sgu20171548', 'tomymoty1', 'sgu20151467', 'rehab.sayed1231999', 'sgu20141740', 'hanmir', 'hye8913', 'ashraf_mohamed', 'maged.magdy666', 'mariam123456789', 'sgu20171506', 'nourhanne.bahaa', 'a.ayman74', 'marwanyasser133', 'sgu20161538', 'kirollos.atef99', 'ahmed_mohsen', 'pshrap37', 'daniel.', 'mmhanafy99', 'heshamelsedfy111', 'vmike0426', 'sgu20151432', 'amr.m.araby', 'mai99mahdy', 'sgu20161512', 'mephistokc', 'michelhakim2001.mh', 'zazotop31', 'abdelrahmananwar', 'jisooyoon', 'michaelhelal99', 'sgu20171560', 'sgu20161466', 'joker.man2000000', 'ahmedramadan', 'omar_anwer', 'sgu20161508', 'amy', 'erhan26uzun', 'sadboijalal', 'ataozirmak', 'behlul', 'boules', 'moh.nabil2050', 'nadakhaled', 'fabio.signorelli', 'abdelmoneim404', 'sal7ien1999', 'sgu20151426', 'barkinsrc5', 'sgu20191494', 'youjiyeon', 'rubenasa', 'mohameda.younis80', 'amr.ghoname.teaching', 'ahmedsaeed', 'my1hunter', 'atknncvkkl', 'sgu20161536', '86kemal86', 'sgu20161460', 'juni8472', 'sgu20171582', 'roshdy.aa', 'ramezakram97', 'demonkaksh', 'mernaeshakfaheem', 'pamilapoopad', 'metoyahia1999', 'nayeramakram98', 'mehmetaliyas1998', 'sgu20171496', 'amartiger2020', 'melegy99', 'sgu20171528', 'tongmalual', 'sgu20191490', None, 'fatihakyurek26', 'ittopsk', 'hosamshaher43', 'cyrillemagdi', 'sug20182194', 'ebrahim.almohandes', 'sgu20191534', 'sgu20191466', 'b715063minbyeongmoon', 'sgu20151500', 'bassant.ahmed20118', 'mamoundiouri', 'sgu20151461', 'sgu20171536', 'beoungwoo', 'shadymagdy99', 'jaeeun53', 'karim20103200', 'andrewmon', 'omaraly112', 'sgu20171534', 'sgu20151878', 'marwanahmad988', 'jpuko11', 'sgu20171546', 'sgu20151434', 'raniamuhamed44', 'jaegisehyun', 'cbortlek', 'generalshephrd', 'abdulrahman.hussien1999', 'mohamed.eid1014', 'manjunath216', 'tndukaife2018', 'jpuko00', 'sgu20191462', 'alaa15eltehewey', 'ervndgn59', 'serhatkahraman183', 'ahmadatef580', 'habiba.elkassas', 'youssefsamiryoussef', 'abdallahhashim', 'maged19991926', 'sgu20151421', 'mahmodfarag2000', 'b919083', 'yahiahamimi', 'yashhiteshbh', 'saga102938', 'sogang20191452', 'mpsingh', 'mirko.capodicasa', 'sgu20171596', 'ekicifatih0', 'sgu20151488', 'tanseerali', 'mohamed.zna66', 'mrgiraffe', 'sgu20161492', 'jlev713', 'm_feky', 'peterhorvath', 'sgu20171578', 'sgu20191476', 'shrouk.a.emad', 'abdoelanwar99', 'elsayedrafaat7', 'sgu20151507', 'rektxz', 'markashaf232', 'fasd556.om', 'sgu20171503', 'dina.23elessawy', 'michael29699', 'taawsifrc', 'faridmohammed98']"
1,15,283,12,1,['manjunath216'],282,"['farid1010', 'sgu20161468', 'nohaabdelazeem11', 'mohamedsamir2591998', 'karim..mohamed745', 'okanssabah', 'ozanemreercan', 'sgu20161506', 'sgu20191512', 'mobahr', 'sgu20171492', 'maxwest', 'badryahmed33', 'mohamedelfeeky1', 'jchamarthi', 'abdelrahman98', 'aminsalah287', 'mayanmohamed', 'sgu20161541', 'sgu20161486', 'fayrouz21415', 'sgu20171588', 'mohamed248688', 'sgu20191492', 'sgu20151431', 'comebacktome', 'nadeenmagdyy', 'tpcks96', 'romanynashaatmakeen', 'ampmstrawberryjam26', 'enesqwe', 'm.trika1999', 'ahmedyosre007', 'sgu20181504', 'dodynn29', 'mohamed_a_mostafa', 'sgu20171552', 'sgu20161556', 'nada0abou0alsoud', 'sgu20181576', 'af5012175', 'kerolosmfawzy', 'raneemgaber', 'tutku', 'zhenming', 'sgu20161497', 'raa199014', 'reemayman101', 'youssefessawy', 'robikar', 'sgu20171510', 'esraayahia21', 'taha18499', 'sgu20171530', 'ahmedkamal', 'amrksh3198', 'moataz12mokhtar', 'jualipa1995', 'hmsgsaad', 'bguillet', 'yaseensalah83', 'kminhsu', 'ahmedokasha1999', 'tpranto', 'sgu20171592', 'sgu20171566', 'marcomuzzarelli', 'yilmaazmert', 'abdelrahman_oun', 'nourmahmoud', 'ranasherif244', 'mustafamahmoud567', 'bassant.ahmed235', 'mayaralmazy', 'sgu20191550', 'sgu20191454', 'salmatarek87', 'sgu20161507', 'sgu20191496', 'wyattm', 'sgu20161516', 'sgu20161518', 'mohannadragab53', 'abdulsamad', 'yubhop', 'sgu20151414', 'abdoulkh', 'seifelawadi26', 'hosamabdallah00', 'btngana1', 'ramymohsen', 'nizquierdo', 'almekamobilya', 'sgu20171594', 'mayadamarie', 'werr011', 'sgu20181330', 'sug20171516', 'sohamamdooh', 'sgu20171564', 'zldrktgusrbs3242', 'yusufcheetos99', 'jihongkim', 'sgu20151428', 'ziad.amr201666', 'adham99', 'sgu20161528', 'sgu20151480', 'josef.me22', 'sgu20161488', 'harvovich', 'ardasavas6', 'getray.ah', 'their123', 'jihyeonlee', 'mohamed_98', 'haidy_emad', 'omarnabih21', 'ingyawad14', 'wodh97', 'ahmed_omar', 'youssefhassaan99', 'sgu20171516', 'ahmedmostafa5499', 'doraexplora', 'ashraf.amr82', 'nada.abomoslim', 'sgu20151453', 'saca', 'kareemmohamed68990', 'sgu20141461', 'sgu20131274', 'mohamedsalah2', 'sgu20171548', 'tomymoty1', 'sgu20151467', 'rehab.sayed1231999', 'sgu20141740', 'hanmir', 'hye8913', 'ashraf_mohamed', 'maged.magdy666', 'mariam123456789', 'sgu20171506', 'nourhanne.bahaa', 'a.ayman74', 'marwanyasser133', 'sgu20161538', 'kirollos.atef99', 'ahmed_mohsen', 'pshrap37', 'daniel.', 'mmhanafy99', 'heshamelsedfy111', 'vmike0426', 'sgu20151432', 'amr.m.araby', 'mai99mahdy', 'sgu20161512', 'mephistokc', 'michelhakim2001.mh', 'zazotop31', 'abdelrahmananwar', 'jisooyoon', 'michaelhelal99', 'sgu20171560', 'sgu20161466', 'joker.man2000000', 'ahmedramadan', 'omar_anwer', 'sgu20161508', 'amy', 'erhan26uzun', 'sadboijalal', 'ataozirmak', 'boules', 'moh.nabil2050', 'nadakhaled', 'fabio.signorelli', 'abdelmoneim404', 'sal7ien1999', 'sgu20151426', 'barkinsrc5', 'sgu20191494', 'youjiyeon', 'rubenasa', 'mohameda.younis80', 'amr.ghoname.teaching', 'ahmedsaeed', 'my1hunter', 'atknncvkkl', 'sgu20161536', 'sgu20161460', 'juni8472', 'sgu20171582', 'roshdy.aa', 'ramezakram97', 'demonkaksh', 'mernaeshakfaheem', 'pamilapoopad', 'metoyahia1999', 'nayeramakram98', 'sgu20171496', 'amartiger2020', 'melegy99', 'sgu20171528', 'tongmalual', 'sgu20191490', 'fatihakyurek26', 'ittopsk', 'hosamshaher43', 'cyrillemagdi', 'sug20182194', 'ebrahim.almohandes', 'sgu20191534', 'sgu20191466', 'b715063minbyeongmoon', 'sgu20151500', 'bassant.ahmed20118', 'mamoundiouri', 'sgu20151461', 'sgu20171536', 'beoungwoo', 'shadymagdy99', 'jaeeun53', 'karim20103200', 'andrewmon', 'omaraly112', 'sgu20171534', 'sgu20151878', 'marwanahmad988', 'jpuko11', 'sgu20171546', 'sgu20151434', 'raniamuhamed44', 'jaegisehyun', 'cbortlek', 'generalshephrd', 'abdulrahman.hussien1999', 'mohamed.eid1014', 'tndukaife2018', 'jpuko00', 'sgu20191462', 'alaa15eltehewey', 'ervndgn59', 'ahmadatef580', 'habiba.elkassas', 'youssefsamiryoussef', 'abdallahhashim', 'maged19991926', 'sgu20151421', 'mahmodfarag2000', 'b919083', 'yahiahamimi', 'yashhiteshbh', 'saga102938', 'sogang20191452', 'mpsingh', 'mirko.capodicasa', 'sgu20171596', 'ekicifatih0', 'sgu20151488', 'tanseerali', 'mohamed.zna66', 'sgu20161492', 'jlev713', 'm_feky', 'peterhorvath', 'sgu20171578', 'sgu20191476', 'shrouk.a.emad', 'abdoelanwar99', 'elsayedrafaat7', 'sgu20151507', 'rektxz', 'markashaf232', 'fasd556.om', 'sgu20171503', 'dina.23elessawy', 'michael29699', 'taawsifrc', 'faridmohammed98']",11,"['uday_kiran', 'gauthamy', 'anand358', 'jithin', 'phantomscythe1738', 'saisatyaprasaanth', 'noone', 'ee19btech11010', 'yagneek', None, 'pkohli24']",294,"['farid1010', 'sgu20161468', 'nohaabdelazeem11', 'mohamedsamir2591998', 'karim..mohamed745', 'okanssabah', 'ozanemreercan', 'sgu20161506', 'sgu20191512', 'mobahr', 'sgu20171492', 'maxwest', 'badryahmed33', 'mohamedelfeeky1', 'jchamarthi', 'abdelrahman98', 'aminsalah287', 'mayanmohamed', 'sgu20161541', 'sgu20161486', 'fayrouz21415', 'sgu20171588', 'mohamed248688', 'sgu20191492', 'sgu20151431', 'comebacktome', 'nadeenmagdyy', 'tpcks96', 'romanynashaatmakeen', 'ampmstrawberryjam26', 'enesqwe', 'm.trika1999', 'ahmedyosre007', 'ee19btech11010', 'sgu20181504', 'dodynn29', 'mohamed_a_mostafa', 'sgu20171552', 'sgu20161556', 'nada0abou0alsoud', 'sgu20181576', 'af5012175', 'kerolosmfawzy', 'raneemgaber', 'tutku', 'zhenming', 'sgu20161497', 'raa199014', 'yagneek', 'reemayman101', 'youssefessawy', 'robikar', 'sgu20171510', 'esraayahia21', 'taha18499', 'sgu20171530', 'ahmedkamal', 'amrksh3198', 'moataz12mokhtar', 'jualipa1995', 'hmsgsaad', 'bguillet', 'yaseensalah83', 'kminhsu', 'ahmedokasha1999', 'tpranto', 'sgu20171592', 'sgu20171566', 'marcomuzzarelli', 'yilmaazmert', 'abdelrahman_oun', 'nourmahmoud', 'ranasherif244', 'mustafamahmoud567', 'bassant.ahmed235', 'mayaralmazy', 'sgu20191550', 'sgu20191454', 'salmatarek87', 'sgu20161507', 'sgu20191496', 'wyattm', 'sgu20161516', 'sgu20161518', 'mohannadragab53', 'abdulsamad', 'yubhop', 'sgu20151414', 'abdoulkh', 'seifelawadi26', 'hosamabdallah00', 'btngana1', 'ramymohsen', 'nizquierdo', 'almekamobilya', 'sgu20171594', 'mayadamarie', 'werr011', 'sgu20181330', 'sug20171516', 'sohamamdooh', 'sgu20171564', 'zldrktgusrbs3242', 'yusufcheetos99', 'jihongkim', 'sgu20151428', 'ziad.amr201666', 'adham99', 'sgu20161528', 'sgu20151480', 'josef.me22', 'sgu20161488', 'harvovich', 'ardasavas6', 'getray.ah', 'their123', 'jihyeonlee', 'mohamed_98', 'gauthamy', 'haidy_emad', 'omarnabih21', 'ingyawad14', 'wodh97', 'ahmed_omar', 'youssefhassaan99', 'sgu20171516', 'ahmedmostafa5499', 'doraexplora', 'ashraf.amr82', 'jithin', 'nada.abomoslim', 'sgu20151453', 'saca', 'kareemmohamed68990', 'sgu20141461', 'sgu20131274', 'mohamedsalah2', 'sgu20171548', 'tomymoty1', 'sgu20151467', 'rehab.sayed1231999', 'sgu20141740', 'hanmir', 'hye8913', 'ashraf_mohamed', 'maged.magdy666', 'mariam123456789', 'sgu20171506', 'anand358', 'nourhanne.bahaa', 'a.ayman74', 'marwanyasser133', 'noone', 'sgu20161538', 'kirollos.atef99', 'ahmed_mohsen', 'pshrap37', 'daniel.', 'mmhanafy99', 'heshamelsedfy111', 'vmike0426', 'sgu20151432', 'amr.m.araby', 'mai99mahdy', 'sgu20161512', 'mephistokc', 'michelhakim2001.mh', 'zazotop31', 'abdelrahmananwar', 'jisooyoon', 'michaelhelal99', 'sgu20171560', 'sgu20161466', 'joker.man2000000', 'ahmedramadan', 'omar_anwer', 'sgu20161508', 'amy', 'erhan26uzun', 'sadboijalal', 'ataozirmak', 'boules', 'moh.nabil2050', 'nadakhaled', 'fabio.signorelli', 'abdelmoneim404', 'sal7ien1999', 'sgu20151426', 'barkinsrc5', 'sgu20191494', 'youjiyeon', 'rubenasa', 'mohameda.younis80', 'amr.ghoname.teaching', 'ahmedsaeed', 'my1hunter', 'atknncvkkl', 'sgu20161536', 'sgu20161460', 'juni8472', 'sgu20171582', 'roshdy.aa', 'ramezakram97', 'demonkaksh', 'mernaeshakfaheem', 'pkohli24', 'pamilapoopad', 'metoyahia1999', 'uday_kiran', 'nayeramakram98', 'saisatyaprasaanth', 'sgu20171496', 'amartiger2020', 'melegy99', 'sgu20171528', 'tongmalual', 'sgu20191490', None, 'fatihakyurek26', 'ittopsk', 'hosamshaher43', 'cyrillemagdi', 'sug20182194', 'ebrahim.almohandes', 'sgu20191534', 'sgu20191466', 'b715063minbyeongmoon', 'sgu20151500', 'bassant.ahmed20118', 'mamoundiouri', 'sgu20151461', 'sgu20171536', 'beoungwoo', 'shadymagdy99', 'jaeeun53', 'karim20103200', 'andrewmon', 'omaraly112', 'sgu20171534', 'sgu20151878', 'marwanahmad988', 'jpuko11', 'sgu20171546', 'sgu20151434', 'raniamuhamed44', 'jaegisehyun', 'cbortlek', 'generalshephrd', 'abdulrahman.hussien1999', 'mohamed.eid1014', 'manjunath216', 'tndukaife2018', 'jpuko00', 'sgu20191462', 'alaa15eltehewey', 'ervndgn59', 'ahmadatef580', 'habiba.elkassas', 'youssefsamiryoussef', 'abdallahhashim', 'maged19991926', 'sgu20151421', 'mahmodfarag2000', 'b919083', 'yahiahamimi', 'yashhiteshbh', 'saga102938', 'sogang20191452', 'mpsingh', 'phantomscythe1738', 'mirko.capodicasa', 'sgu20171596', 'ekicifatih0', 'sgu20151488', 'tanseerali', 'mohamed.zna66', 'sgu20161492', 'jlev713', 'm_feky', 'peterhorvath', 'sgu20171578', 'sgu20191476', 'shrouk.a.emad', 'abdoelanwar99', 'elsayedrafaat7', 'sgu20151507', 'rektxz', 'markashaf232', 'fasd556.om', 'sgu20171503', 'dina.23elessawy', 'michael29699', 'taawsifrc', 'faridmohammed98']"
1,22,283,8,4,"['jisooyoon', 'juni8472', 'pshrap37', 'ittopsk']",279,"['farid1010', 'sgu20161468', 'nohaabdelazeem11', 'mohamedsamir2591998', 'karim..mohamed745', 'okanssabah', 'ozanemreercan', 'sgu20161506', 'sgu20191512', 'mobahr', 'sgu20171492', 'maxwest', 'badryahmed33', 'mohamedelfeeky1', 'jchamarthi', 'abdelrahman98', 'aminsalah287', 'mayanmohamed', 'sgu20161541', 'sgu20161486', 'fayrouz21415', 'sgu20171588', 'mohamed248688', 'sgu20191492', 'sgu20151431', 'comebacktome', 'nadeenmagdyy', 'tpcks96', 'romanynashaatmakeen', 'ampmstrawberryjam26', 'enesqwe', 'm.trika1999', 'ahmedyosre007', 'sgu20181504', 'dodynn29', 'mohamed_a_mostafa', 'sgu20171552', 'sgu20161556', 'nada0abou0alsoud', 'sgu20181576', 'af5012175', 'kerolosmfawzy', 'raneemgaber', 'tutku', 'zhenming', 'sgu20161497', 'raa199014', 'reemayman101', 'youssefessawy', 'robikar', 'sgu20171510', 'esraayahia21', 'taha18499', 'sgu20171530', 'ahmedkamal', 'amrksh3198', 'moataz12mokhtar', 'jualipa1995', 'hmsgsaad', 'bguillet', 'yaseensalah83', 'kminhsu', 'ahmedokasha1999', 'tpranto', 'sgu20171592', 'sgu20171566', 'marcomuzzarelli', 'yilmaazmert', 'abdelrahman_oun', 'nourmahmoud', 'ranasherif244', 'mustafamahmoud567', 'bassant.ahmed235', 'mayaralmazy', 'sgu20191550', 'sgu20191454', 'salmatarek87', 'sgu20161507', 'sgu20191496', 'wyattm', 'sgu20161516', 'sgu20161518', 'mohannadragab53', 'abdulsamad', 'yubhop', 'sgu20151414', 'abdoulkh', 'seifelawadi26', 'hosamabdallah00', 'btngana1', 'ramymohsen', 'nizquierdo', 'almekamobilya', 'sgu20171594', 'mayadamarie', 'werr011', 'sgu20181330', 'sug20171516', 'sohamamdooh', 'sgu20171564', 'zldrktgusrbs3242', 'yusufcheetos99', 'jihongkim', 'sgu20151428', 'ziad.amr201666', 'adham99', 'sgu20161528', 'sgu20151480', 'josef.me22', 'sgu20161488', 'harvovich', 'ardasavas6', 'getray.ah', 'their123', 'jihyeonlee', 'mohamed_98', 'haidy_emad', 'omarnabih21', 'ingyawad14', 'wodh97', 'ahmed_omar', 'youssefhassaan99', 'sgu20171516', 'ahmedmostafa5499', 'doraexplora', 'ashraf.amr82', 'nada.abomoslim', 'sgu20151453', 'saca', 'kareemmohamed68990', 'sgu20141461', 'sgu20131274', 'mohamedsalah2', 'sgu20171548', 'tomymoty1', 'sgu20151467', 'rehab.sayed1231999', 'sgu20141740', 'hanmir', 'hye8913', 'ashraf_mohamed', 'maged.magdy666', 'mariam123456789', 'sgu20171506', 'nourhanne.bahaa', 'a.ayman74', 'marwanyasser133', 'sgu20161538', 'kirollos.atef99', 'ahmed_mohsen', 'daniel.', 'mmhanafy99', 'heshamelsedfy111', 'vmike0426', 'sgu20151432', 'amr.m.araby', 'mai99mahdy', 'sgu20161512', 'mephistokc', 'michelhakim2001.mh', 'zazotop31', 'abdelrahmananwar', 'michaelhelal99', 'sgu20171560', 'sgu20161466', 'joker.man2000000', 'ahmedramadan', 'omar_anwer', 'sgu20161508', 'amy', 'erhan26uzun', 'sadboijalal', 'ataozirmak', 'boules', 'moh.nabil2050', 'nadakhaled', 'fabio.signorelli', 'abdelmoneim404', 'sal7ien1999', 'sgu20151426', 'barkinsrc5', 'sgu20191494', 'youjiyeon', 'rubenasa', 'mohameda.younis80', 'amr.ghoname.teaching', 'ahmedsaeed', 'my1hunter', 'atknncvkkl', 'sgu20161536', 'sgu20161460', 'sgu20171582', 'roshdy.aa', 'ramezakram97', 'demonkaksh', 'mernaeshakfaheem', 'pamilapoopad', 'metoyahia1999', 'nayeramakram98', 'sgu20171496', 'amartiger2020', 'melegy99', 'sgu20171528', 'tongmalual', 'sgu20191490', 'fatihakyurek26', 'hosamshaher43', 'cyrillemagdi', 'sug20182194', 'ebrahim.almohandes', 'sgu20191534', 'sgu20191466', 'b715063minbyeongmoon', 'sgu20151500', 'bassant.ahmed20118', 'mamoundiouri', 'sgu20151461', 'sgu20171536', 'beoungwoo', 'shadymagdy99', 'jaeeun53', 'karim20103200', 'andrewmon', 'omaraly112', 'sgu20171534', 'sgu20151878', 'marwanahmad988', 'jpuko11', 'sgu20171546', 'sgu20151434', 'raniamuhamed44', 'jaegisehyun', 'cbortlek', 'generalshephrd', 'abdulrahman.hussien1999', 'mohamed.eid1014', 'manjunath216', 'tndukaife2018', 'jpuko00', 'sgu20191462', 'alaa15eltehewey', 'ervndgn59', 'ahmadatef580', 'habiba.elkassas', 'youssefsamiryoussef', 'abdallahhashim', 'maged19991926', 'sgu20151421', 'mahmodfarag2000', 'b919083', 'yahiahamimi', 'yashhiteshbh', 'saga102938', 'sogang20191452', 'mpsingh', 'mirko.capodicasa', 'sgu20171596', 'ekicifatih0', 'sgu20151488', 'tanseerali', 'mohamed.zna66', 'sgu20161492', 'jlev713', 'm_feky', 'peterhorvath', 'sgu20171578', 'sgu20191476', 'shrouk.a.emad', 'abdoelanwar99', 'elsayedrafaat7', 'sgu20151507', 'rektxz', 'markashaf232', 'fasd556.om', 'sgu20171503', 'dina.23elessawy', 'michael29699', 'taawsifrc', 'faridmohammed98']",4,"['sgu20151313', None, 'ehrnjs326', 'sgu20171573']",287,"['farid1010', 'sgu20161468', 'nohaabdelazeem11', 'mohamedsamir2591998', 'karim..mohamed745', 'okanssabah', 'ozanemreercan', 'sgu20161506', 'sgu20191512', 'mobahr', 'sgu20171492', 'maxwest', 'badryahmed33', 'mohamedelfeeky1', 'jchamarthi', 'abdelrahman98', 'aminsalah287', 'mayanmohamed', 'sgu20161541', 'sgu20161486', 'fayrouz21415', 'sgu20171588', 'mohamed248688', 'sgu20191492', 'sgu20151431', 'comebacktome', 'nadeenmagdyy', 'tpcks96', 'romanynashaatmakeen', 'ampmstrawberryjam26', 'enesqwe', 'm.trika1999', 'ahmedyosre007', 'sgu20181504', 'dodynn29', 'mohamed_a_mostafa', 'sgu20171552', 'sgu20161556', 'nada0abou0alsoud', 'sgu20181576', 'af5012175', 'kerolosmfawzy', 'sgu20151313', 'raneemgaber', 'tutku', 'zhenming', 'sgu20161497', 'raa199014', 'reemayman101', 'youssefessawy', 'robikar', 'sgu20171510', 'esraayahia21', 'taha18499', 'sgu20171530', 'ahmedkamal', 'amrksh3198', 'moataz12mokhtar', 'jualipa1995', 'hmsgsaad', 'bguillet', 'yaseensalah83', 'kminhsu', 'ahmedokasha1999', 'tpranto', 'sgu20171592', 'sgu20171566', 'marcomuzzarelli', 'yilmaazmert', 'abdelrahman_oun', 'nourmahmoud', 'ranasherif244', 'mustafamahmoud567', 'bassant.ahmed235', 'mayaralmazy', 'sgu20191550', 'sgu20191454', 'salmatarek87', 'sgu20161507', 'sgu20191496', 'wyattm', 'sgu20161516', 'sgu20161518', 'mohannadragab53', 'abdulsamad', 'yubhop', 'sgu20151414', 'abdoulkh', 'seifelawadi26', 'hosamabdallah00', 'btngana1', 'ramymohsen', 'nizquierdo', 'almekamobilya', 'sgu20171594', 'mayadamarie', 'werr011', 'sgu20181330', 'sug20171516', 'sohamamdooh', 'sgu20171564', 'zldrktgusrbs3242', 'yusufcheetos99', 'jihongkim', 'sgu20151428', 'ziad.amr201666', 'adham99', 'sgu20161528', 'sgu20151480', 'josef.me22', 'sgu20161488', 'harvovich', 'ardasavas6', 'getray.ah', 'their123', 'jihyeonlee', 'mohamed_98', 'haidy_emad', 'omarnabih21', 'ingyawad14', 'wodh97', 'ahmed_omar', 'youssefhassaan99', 'sgu20171516', 'ahmedmostafa5499', 'doraexplora', 'ashraf.amr82', 'nada.abomoslim', 'sgu20151453', 'saca', 'kareemmohamed68990', 'sgu20141461', 'sgu20131274', 'mohamedsalah2', 'sgu20171548', 'tomymoty1', 'sgu20151467', 'rehab.sayed1231999', 'sgu20141740', 'hanmir', 'hye8913', 'ashraf_mohamed', 'maged.magdy666', 'mariam123456789', 'sgu20171506', 'sgu20171573', 'nourhanne.bahaa', 'a.ayman74', 'marwanyasser133', 'sgu20161538', 'kirollos.atef99', 'ahmed_mohsen', 'pshrap37', 'daniel.', 'mmhanafy99', 'heshamelsedfy111', 'vmike0426', 'sgu20151432', 'amr.m.araby', 'mai99mahdy', 'sgu20161512', 'mephistokc', 'michelhakim2001.mh', 'zazotop31', 'abdelrahmananwar', 'jisooyoon', 'michaelhelal99', 'sgu20171560', 'sgu20161466', 'joker.man2000000', 'ahmedramadan', 'omar_anwer', 'sgu20161508', 'amy', 'erhan26uzun', 'sadboijalal', 'ataozirmak', 'boules', 'moh.nabil2050', 'nadakhaled', 'fabio.signorelli', 'abdelmoneim404', 'sal7ien1999', 'sgu20151426', 'ehrnjs326', 'barkinsrc5', 'sgu20191494', 'youjiyeon', 'rubenasa', 'mohameda.younis80', 'amr.ghoname.teaching', 'ahmedsaeed', 'my1hunter', 'atknncvkkl', 'sgu20161536', 'sgu20161460', 'juni8472', 'sgu20171582', 'roshdy.aa', 'ramezakram97', 'demonkaksh', 'mernaeshakfaheem', 'pamilapoopad', 'metoyahia1999', 'nayeramakram98', 'sgu20171496', 'amartiger2020', 'melegy99', 'sgu20171528', 'tongmalual', 'sgu20191490', None, 'fatihakyurek26', 'ittopsk', 'hosamshaher43', 'cyrillemagdi', 'sug20182194', 'ebrahim.almohandes', 'sgu20191534', 'sgu20191466', 'b715063minbyeongmoon', 'sgu20151500', 'bassant.ahmed20118', 'mamoundiouri', 'sgu20151461', 'sgu20171536', 'beoungwoo', 'shadymagdy99', 'jaeeun53', 'karim20103200', 'andrewmon', 'omaraly112', 'sgu20171534', 'sgu20151878', 'marwanahmad988', 'jpuko11', 'sgu20171546', 'sgu20151434', 'raniamuhamed44', 'jaegisehyun', 'cbortlek', 'generalshephrd', 'abdulrahman.hussien1999', 'mohamed.eid1014', 'manjunath216', 'tndukaife2018', 'jpuko00', 'sgu20191462', 'alaa15eltehewey', 'ervndgn59', 'ahmadatef580', 'habiba.elkassas', 'youssefsamiryoussef', 'abdallahhashim', 'maged19991926', 'sgu20151421', 'mahmodfarag2000', 'b919083', 'yahiahamimi', 'yashhiteshbh', 'saga102938', 'sogang20191452', 'mpsingh', 'mirko.capodicasa', 'sgu20171596', 'ekicifatih0', 'sgu20151488', 'tanseerali', 'mohamed.zna66', 'sgu20161492', 'jlev713', 'm_feky', 'peterhorvath', 'sgu20171578', 'sgu20191476', 'shrouk.a.emad', 'abdoelanwar99', 'elsayedrafaat7', 'sgu20151507', 'rektxz', 'markashaf232', 'fasd556.om', 'sgu20171503', 'dina.23elessawy', 'michael29699', 'taawsifrc', 'faridmohammed98']"
1,28,283,8,1,['barkinsrc5'],282,"['farid1010', 'sgu20161468', 'nohaabdelazeem11', 'mohamedsamir2591998', 'karim..mohamed745', 'okanssabah', 'ozanemreercan', 'sgu20161506', 'sgu20191512', 'mobahr', 'sgu20171492', 'maxwest', 'badryahmed33', 'mohamedelfeeky1', 'jchamarthi', 'abdelrahman98', 'aminsalah287', 'mayanmohamed', 'sgu20161541', 'sgu20161486', 'fayrouz21415', 'sgu20171588', 'mohamed248688', 'sgu20191492', 'sgu20151431', 'comebacktome', 'nadeenmagdyy', 'tpcks96', 'romanynashaatmakeen', 'ampmstrawberryjam26', 'enesqwe', 'm.trika1999', 'ahmedyosre007', 'sgu20181504', 'dodynn29', 'mohamed_a_mostafa', 'sgu20171552', 'sgu20161556', 'nada0abou0alsoud', 'sgu20181576', 'af5012175', 'kerolosmfawzy', 'raneemgaber', 'tutku', 'zhenming', 'sgu20161497', 'raa199014', 'reemayman101', 'youssefessawy', 'robikar', 'sgu20171510', 'esraayahia21', 'taha18499', 'sgu20171530', 'ahmedkamal', 'amrksh3198', 'moataz12mokhtar', 'jualipa1995', 'hmsgsaad', 'bguillet', 'yaseensalah83', 'kminhsu', 'ahmedokasha1999', 'tpranto', 'sgu20171592', 'sgu20171566', 'marcomuzzarelli', 'yilmaazmert', 'abdelrahman_oun', 'nourmahmoud', 'ranasherif244', 'mustafamahmoud567', 'bassant.ahmed235', 'mayaralmazy', 'sgu20191550', 'sgu20191454', 'salmatarek87', 'sgu20161507', 'sgu20191496', 'wyattm', 'sgu20161516', 'sgu20161518', 'mohannadragab53', 'abdulsamad', 'yubhop', 'sgu20151414', 'abdoulkh', 'seifelawadi26', 'hosamabdallah00', 'btngana1', 'ramymohsen', 'nizquierdo', 'almekamobilya', 'sgu20171594', 'mayadamarie', 'werr011', 'sgu20181330', 'sug20171516', 'sohamamdooh', 'sgu20171564', 'zldrktgusrbs3242', 'yusufcheetos99', 'jihongkim', 'sgu20151428', 'ziad.amr201666', 'adham99', 'sgu20161528', 'sgu20151480', 'josef.me22', 'sgu20161488', 'harvovich', 'ardasavas6', 'getray.ah', 'their123', 'jihyeonlee', 'mohamed_98', 'haidy_emad', 'omarnabih21', 'ingyawad14', 'wodh97', 'ahmed_omar', 'youssefhassaan99', 'sgu20171516', 'ahmedmostafa5499', 'doraexplora', 'ashraf.amr82', 'nada.abomoslim', 'sgu20151453', 'saca', 'kareemmohamed68990', 'sgu20141461', 'sgu20131274', 'mohamedsalah2', 'sgu20171548', 'tomymoty1', 'sgu20151467', 'rehab.sayed1231999', 'sgu20141740', 'hanmir', 'hye8913', 'ashraf_mohamed', 'maged.magdy666', 'mariam123456789', 'sgu20171506', 'nourhanne.bahaa', 'a.ayman74', 'marwanyasser133', 'sgu20161538', 'kirollos.atef99', 'ahmed_mohsen', 'pshrap37', 'daniel.', 'mmhanafy99', 'heshamelsedfy111', 'vmike0426', 'sgu20151432', 'amr.m.araby', 'mai99mahdy', 'sgu20161512', 'mephistokc', 'michelhakim2001.mh', 'zazotop31', 'abdelrahmananwar', 'jisooyoon', 'michaelhelal99', 'sgu20171560', 'sgu20161466', 'joker.man2000000', 'ahmedramadan', 'omar_anwer', 'sgu20161508', 'amy', 'erhan26uzun', 'sadboijalal', 'ataozirmak', 'boules', 'moh.nabil2050', 'nadakhaled', 'fabio.signorelli', 'abdelmoneim404', 'sal7ien1999', 'sgu20151426', 'sgu20191494', 'youjiyeon', 'rubenasa', 'mohameda.younis80', 'amr.ghoname.teaching', 'ahmedsaeed', 'my1hunter', 'atknncvkkl', 'sgu20161536', 'sgu20161460', 'juni8472', 'sgu20171582', 'roshdy.aa', 'ramezakram97', 'demonkaksh', 'mernaeshakfaheem', 'pamilapoopad', 'metoyahia1999', 'nayeramakram98', 'sgu20171496', 'amartiger2020', 'melegy99', 'sgu20171528', 'tongmalual', 'sgu20191490', 'fatihakyurek26', 'ittopsk', 'hosamshaher43', 'cyrillemagdi', 'sug20182194', 'ebrahim.almohandes', 'sgu20191534', 'sgu20191466', 'b715063minbyeongmoon', 'sgu20151500', 'bassant.ahmed20118', 'mamoundiouri', 'sgu20151461', 'sgu20171536', 'beoungwoo', 'shadymagdy99', 'jaeeun53', 'karim20103200', 'andrewmon', 'omaraly112', 'sgu20171534', 'sgu20151878', 'marwanahmad988', 'jpuko11', 'sgu20171546', 'sgu20151434', 'raniamuhamed44', 'jaegisehyun', 'cbortlek', 'generalshephrd', 'abdulrahman.hussien1999', 'mohamed.eid1014', 'manjunath216', 'tndukaife2018', 'jpuko00', 'sgu20191462', 'alaa15eltehewey', 'ervndgn59', 'ahmadatef580', 'habiba.elkassas', 'youssefsamiryoussef', 'abdallahhashim', 'maged19991926', 'sgu20151421', 'mahmodfarag2000', 'b919083', 'yahiahamimi', 'yashhiteshbh', 'saga102938', 'sogang20191452', 'mpsingh', 'mirko.capodicasa', 'sgu20171596', 'ekicifatih0', 'sgu20151488', 'tanseerali', 'mohamed.zna66', 'sgu20161492', 'jlev713', 'm_feky', 'peterhorvath', 'sgu20171578', 'sgu20191476', 'shrouk.a.emad', 'abdoelanwar99', 'elsayedrafaat7', 'sgu20151507', 'rektxz', 'markashaf232', 'fasd556.om', 'sgu20171503', 'dina.23elessawy', 'michael29699', 'taawsifrc', 'faridmohammed98']",7,"['muhammet.korkmaz29', 'alpayy98', 'garfon61', 'evren_aydin6', 'goknur.derinoz', 'smrf432', None]",290,"['farid1010', 'sgu20161468', 'nohaabdelazeem11', 'mohamedsamir2591998', 'karim..mohamed745', 'okanssabah', 'ozanemreercan', 'sgu20161506', 'sgu20191512', 'mobahr', 'sgu20171492', 'maxwest', 'badryahmed33', 'mohamedelfeeky1', 'jchamarthi', 'abdelrahman98', 'aminsalah287', 'mayanmohamed', 'sgu20161541', 'sgu20161486', 'fayrouz21415', 'sgu20171588', 'mohamed248688', 'sgu20191492', 'sgu20151431', 'comebacktome', 'nadeenmagdyy', 'tpcks96', 'romanynashaatmakeen', 'ampmstrawberryjam26', 'enesqwe', 'm.trika1999', 'ahmedyosre007', 'sgu20181504', 'dodynn29', 'mohamed_a_mostafa', 'sgu20171552', 'sgu20161556', 'nada0abou0alsoud', 'sgu20181576', 'af5012175', 'kerolosmfawzy', 'raneemgaber', 'tutku', 'zhenming', 'sgu20161497', 'raa199014', 'smrf432', 'reemayman101', 'youssefessawy', 'robikar', 'sgu20171510', 'esraayahia21', 'taha18499', 'sgu20171530', 'ahmedkamal', 'goknur.derinoz', 'amrksh3198', 'moataz12mokhtar', 'jualipa1995', 'hmsgsaad', 'bguillet', 'yaseensalah83', 'kminhsu', 'ahmedokasha1999', 'tpranto', 'sgu20171592', 'sgu20171566', 'marcomuzzarelli', 'yilmaazmert', 'abdelrahman_oun', 'nourmahmoud', 'ranasherif244', 'mustafamahmoud567', 'bassant.ahmed235', 'mayaralmazy', 'sgu20191550', 'sgu20191454', 'salmatarek87', 'sgu20161507', 'sgu20191496', 'wyattm', 'sgu20161516', 'sgu20161518', 'mohannadragab53', 'abdulsamad', 'yubhop', 'sgu20151414', 'abdoulkh', 'seifelawadi26', 'hosamabdallah00', 'btngana1', 'ramymohsen', 'nizquierdo', 'almekamobilya', 'sgu20171594', 'mayadamarie', 'werr011', 'sgu20181330', 'sug20171516', 'sohamamdooh', 'sgu20171564', 'zldrktgusrbs3242', 'yusufcheetos99', 'jihongkim', 'sgu20151428', 'ziad.amr201666', 'adham99', 'sgu20161528', 'sgu20151480', 'josef.me22', 'sgu20161488', 'harvovich', 'ardasavas6', 'getray.ah', 'their123', 'alpayy98', 'jihyeonlee', 'mohamed_98', 'haidy_emad', 'omarnabih21', 'ingyawad14', 'wodh97', 'ahmed_omar', 'youssefhassaan99', 'sgu20171516', 'ahmedmostafa5499', 'doraexplora', 'ashraf.amr82', 'nada.abomoslim', 'sgu20151453', 'saca', 'kareemmohamed68990', 'sgu20141461', 'sgu20131274', 'mohamedsalah2', 'sgu20171548', 'tomymoty1', 'sgu20151467', 'rehab.sayed1231999', 'sgu20141740', 'hanmir', 'hye8913', 'ashraf_mohamed', 'maged.magdy666', 'mariam123456789', 'sgu20171506', 'nourhanne.bahaa', 'a.ayman74', 'marwanyasser133', 'sgu20161538', 'kirollos.atef99', 'ahmed_mohsen', 'pshrap37', 'daniel.', 'mmhanafy99', 'evren_aydin6', 'heshamelsedfy111', 'vmike0426', 'sgu20151432', 'amr.m.araby', 'mai99mahdy', 'sgu20161512', 'mephistokc', 'michelhakim2001.mh', 'zazotop31', 'abdelrahmananwar', 'jisooyoon', 'michaelhelal99', 'sgu20171560', 'sgu20161466', 'joker.man2000000', 'ahmedramadan', 'omar_anwer', 'sgu20161508', 'amy', 'erhan26uzun', 'sadboijalal', 'ataozirmak', 'boules', 'moh.nabil2050', 'nadakhaled', 'fabio.signorelli', 'abdelmoneim404', 'sal7ien1999', 'sgu20151426', 'garfon61', 'barkinsrc5', 'sgu20191494', 'youjiyeon', 'rubenasa', 'mohameda.younis80', 'amr.ghoname.teaching', 'ahmedsaeed', 'my1hunter', 'atknncvkkl', 'sgu20161536', 'sgu20161460', 'juni8472', 'sgu20171582', 'roshdy.aa', 'ramezakram97', 'demonkaksh', 'mernaeshakfaheem', 'pamilapoopad', 'metoyahia1999', 'nayeramakram98', 'sgu20171496', 'amartiger2020', 'melegy99', 'sgu20171528', 'tongmalual', 'sgu20191490', None, 'fatihakyurek26', 'ittopsk', 'hosamshaher43', 'cyrillemagdi', 'sug20182194', 'ebrahim.almohandes', 'sgu20191534', 'sgu20191466', 'b715063minbyeongmoon', 'sgu20151500', 'bassant.ahmed20118', 'mamoundiouri', 'sgu20151461', 'sgu20171536', 'beoungwoo', 'shadymagdy99', 'jaeeun53', 'karim20103200', 'andrewmon', 'omaraly112', 'sgu20171534', 'sgu20151878', 'marwanahmad988', 'jpuko11', 'sgu20171546', 'sgu20151434', 'raniamuhamed44', 'muhammet.korkmaz29', 'jaegisehyun', 'cbortlek', 'generalshephrd', 'abdulrahman.hussien1999', 'mohamed.eid1014', 'manjunath216', 'tndukaife2018', 'jpuko00', 'sgu20191462', 'alaa15eltehewey', 'ervndgn59', 'ahmadatef580', 'habiba.elkassas', 'youssefsamiryoussef', 'abdallahhashim', 'maged19991926', 'sgu20151421', 'mahmodfarag2000', 'b919083', 'yahiahamimi', 'yashhiteshbh', 'saga102938', 'sogang20191452', 'mpsingh', 'mirko.capodicasa', 'sgu20171596', 'ekicifatih0', 'sgu20151488', 'tanseerali', 'mohamed.zna66', 'sgu20161492', 'jlev713', 'm_feky', 'peterhorvath', 'sgu20171578', 'sgu20191476', 'shrouk.a.emad', 'abdoelanwar99', 'elsayedrafaat7', 'sgu20151507', 'rektxz', 'markashaf232', 'fasd556.om', 'sgu20171503', 'dina.23elessawy', 'michael29699', 'taawsifrc', 'faridmohammed98']"
1,353,283,8,5,"['my1hunter', 'sgu20171492', 'sgu20161508', 'sogang20191452', 'sgu20191534']",278,"['farid1010', 'sgu20161468', 'nohaabdelazeem11', 'mohamedsamir2591998', 'karim..mohamed745', 'okanssabah', 'ozanemreercan', 'sgu20161506', 'sgu20191512', 'mobahr', 'maxwest', 'badryahmed33', 'mohamedelfeeky1', 'jchamarthi', 'abdelrahman98', 'aminsalah287', 'mayanmohamed', 'sgu20161541', 'sgu20161486', 'fayrouz21415', 'sgu20171588', 'mohamed248688', 'sgu20191492', 'sgu20151431', 'comebacktome', 'nadeenmagdyy', 'tpcks96', 'romanynashaatmakeen', 'ampmstrawberryjam26', 'enesqwe', 'm.trika1999', 'ahmedyosre007', 'sgu20181504', 'dodynn29', 'mohamed_a_mostafa', 'sgu20171552', 'sgu20161556', 'nada0abou0alsoud', 'sgu20181576', 'af5012175', 'kerolosmfawzy', 'raneemgaber', 'tutku', 'zhenming', 'sgu20161497', 'raa199014', 'reemayman101', 'youssefessawy', 'robikar', 'sgu20171510', 'esraayahia21', 'taha18499', 'sgu20171530', 'ahmedkamal', 'amrksh3198', 'moataz12mokhtar', 'jualipa1995', 'hmsgsaad', 'bguillet', 'yaseensalah83', 'kminhsu', 'ahmedokasha1999', 'tpranto', 'sgu20171592', 'sgu20171566', 'marcomuzzarelli', 'yilmaazmert', 'abdelrahman_oun', 'nourmahmoud', 'ranasherif244', 'mustafamahmoud567', 'bassant.ahmed235', 'mayaralmazy', 'sgu20191550', 'sgu20191454', 'salmatarek87', 'sgu20161507', 'sgu20191496', 'wyattm', 'sgu20161516', 'sgu20161518', 'mohannadragab53', 'abdulsamad', 'yubhop', 'sgu20151414', 'abdoulkh', 'seifelawadi26', 'hosamabdallah00', 'btngana1', 'ramymohsen', 'nizquierdo', 'almekamobilya', 'sgu20171594', 'mayadamarie', 'werr011', 'sgu20181330', 'sug20171516', 'sohamamdooh', 'sgu20171564', 'zldrktgusrbs3242', 'yusufcheetos99', 'jihongkim', 'sgu20151428', 'ziad.amr201666', 'adham99', 'sgu20161528', 'sgu20151480', 'josef.me22', 'sgu20161488', 'harvovich', 'ardasavas6', 'getray.ah', 'their123', 'jihyeonlee', 'mohamed_98', 'haidy_emad', 'omarnabih21', 'ingyawad14', 'wodh97', 'ahmed_omar', 'youssefhassaan99', 'sgu20171516', 'ahmedmostafa5499', 'doraexplora', 'ashraf.amr82', 'nada.abomoslim', 'sgu20151453', 'saca', 'kareemmohamed68990', 'sgu20141461', 'sgu20131274', 'mohamedsalah2', 'sgu20171548', 'tomymoty1', 'sgu20151467', 'rehab.sayed1231999', 'sgu20141740', 'hanmir', 'hye8913', 'ashraf_mohamed', 'maged.magdy666', 'mariam123456789', 'sgu20171506', 'nourhanne.bahaa', 'a.ayman74', 'marwanyasser133', 'sgu20161538', 'kirollos.atef99', 'ahmed_mohsen', 'pshrap37', 'daniel.', 'mmhanafy99', 'heshamelsedfy111', 'vmike0426', 'sgu20151432', 'amr.m.araby', 'mai99mahdy', 'sgu20161512', 'mephistokc', 'michelhakim2001.mh', 'zazotop31', 'abdelrahmananwar', 'jisooyoon', 'michaelhelal99', 'sgu20171560', 'sgu20161466', 'joker.man2000000', 'ahmedramadan', 'omar_anwer', 'amy', 'erhan26uzun', 'sadboijalal', 'ataozirmak', 'boules', 'moh.nabil2050', 'nadakhaled', 'fabio.signorelli', 'abdelmoneim404', 'sal7ien1999', 'sgu20151426', 'barkinsrc5', 'sgu20191494', 'youjiyeon', 'rubenasa', 'mohameda.younis80', 'amr.ghoname.teaching', 'ahmedsaeed', 'atknncvkkl', 'sgu20161536', 'sgu20161460', 'juni8472', 'sgu20171582', 'roshdy.aa', 'ramezakram97', 'demonkaksh', 'mernaeshakfaheem', 'pamilapoopad', 'metoyahia1999', 'nayeramakram98', 'sgu20171496', 'amartiger2020', 'melegy99', 'sgu20171528', 'tongmalual', 'sgu20191490', 'fatihakyurek26', 'ittopsk', 'hosamshaher43', 'cyrillemagdi', 'sug20182194', 'ebrahim.almohandes', 'sgu20191466', 'b715063minbyeongmoon', 'sgu20151500', 'bassant.ahmed20118', 'mamoundiouri', 'sgu20151461', 'sgu20171536', 'beoungwoo', 'shadymagdy99', 'jaeeun53', 'karim20103200', 'andrewmon', 'omaraly112', 'sgu20171534', 'sgu20151878', 'marwanahmad988', 'jpuko11', 'sgu20171546', 'sgu20151434', 'raniamuhamed44', 'jaegisehyun', 'cbortlek', 'generalshephrd', 'abdulrahman.hussien1999', 'mohamed.eid1014', 'manjunath216', 'tndukaife2018', 'jpuko00', 'sgu20191462', 'alaa15eltehewey', 'ervndgn59', 'ahmadatef580', 'habiba.elkassas', 'youssefsamiryoussef', 'abdallahhashim', 'maged19991926', 'sgu20151421', 'mahmodfarag2000', 'b919083', 'yahiahamimi', 'yashhiteshbh', 'saga102938', 'mpsingh', 'mirko.capodicasa', 'sgu20171596', 'ekicifatih0', 'sgu20151488', 'tanseerali', 'mohamed.zna66', 'sgu20161492', 'jlev713', 'm_feky', 'peterhorvath', 'sgu20171578', 'sgu20191476', 'shrouk.a.emad', 'abdoelanwar99', 'elsayedrafaat7', 'sgu20151507', 'rektxz', 'markashaf232', 'fasd556.om', 'sgu20171503', 'dina.23elessawy', 'michael29699', 'taawsifrc', 'faridmohammed98']",3,"['sgu20141410', None, 'sgu20171573']",286,"['farid1010', 'sgu20161468', 'nohaabdelazeem11', 'mohamedsamir2591998', 'karim..mohamed745', 'okanssabah', 'ozanemreercan', 'sgu20161506', 'sgu20191512', 'sgu20141410', 'mobahr', 'sgu20171492', 'maxwest', 'badryahmed33', 'mohamedelfeeky1', 'jchamarthi', 'abdelrahman98', 'aminsalah287', 'mayanmohamed', 'sgu20161541', 'sgu20161486', 'fayrouz21415', 'sgu20171588', 'mohamed248688', 'sgu20191492', 'sgu20151431', 'comebacktome', 'nadeenmagdyy', 'tpcks96', 'romanynashaatmakeen', 'ampmstrawberryjam26', 'enesqwe', 'm.trika1999', 'ahmedyosre007', 'sgu20181504', 'dodynn29', 'mohamed_a_mostafa', 'sgu20171552', 'sgu20161556', 'nada0abou0alsoud', 'sgu20181576', 'af5012175', 'kerolosmfawzy', 'raneemgaber', 'tutku', 'zhenming', 'sgu20161497', 'raa199014', 'reemayman101', 'youssefessawy', 'robikar', 'sgu20171510', 'esraayahia21', 'taha18499', 'sgu20171530', 'ahmedkamal', 'amrksh3198', 'moataz12mokhtar', 'jualipa1995', 'hmsgsaad', 'bguillet', 'yaseensalah83', 'kminhsu', 'ahmedokasha1999', 'tpranto', 'sgu20171592', 'sgu20171566', 'marcomuzzarelli', 'yilmaazmert', 'abdelrahman_oun', 'nourmahmoud', 'ranasherif244', 'mustafamahmoud567', 'bassant.ahmed235', 'mayaralmazy', 'sgu20191550', 'sgu20191454', 'salmatarek87', 'sgu20161507', 'sgu20191496', 'wyattm', 'sgu20161516', 'sgu20161518', 'mohannadragab53', 'abdulsamad', 'yubhop', 'sgu20151414', 'abdoulkh', 'seifelawadi26', 'hosamabdallah00', 'btngana1', 'ramymohsen', 'nizquierdo', 'almekamobilya', 'sgu20171594', 'mayadamarie', 'werr011', 'sgu20181330', 'sug20171516', 'sohamamdooh', 'sgu20171564', 'zldrktgusrbs3242', 'yusufcheetos99', 'jihongkim', 'sgu20151428', 'ziad.amr201666', 'adham99', 'sgu20161528', 'sgu20151480', 'josef.me22', 'sgu20161488', 'harvovich', 'ardasavas6', 'getray.ah', 'their123', 'jihyeonlee', 'mohamed_98', 'haidy_emad', 'omarnabih21', 'ingyawad14', 'wodh97', 'ahmed_omar', 'youssefhassaan99', 'sgu20171516', 'ahmedmostafa5499', 'doraexplora', 'ashraf.amr82', 'nada.abomoslim', 'sgu20151453', 'saca', 'kareemmohamed68990', 'sgu20141461', 'sgu20131274', 'mohamedsalah2', 'sgu20171548', 'tomymoty1', 'sgu20151467', 'rehab.sayed1231999', 'sgu20141740', 'hanmir', 'hye8913', 'ashraf_mohamed', 'maged.magdy666', 'mariam123456789', 'sgu20171506', 'sgu20171573', 'nourhanne.bahaa', 'a.ayman74', 'marwanyasser133', 'sgu20161538', 'kirollos.atef99', 'ahmed_mohsen', 'pshrap37', 'daniel.', 'mmhanafy99', 'heshamelsedfy111', 'vmike0426', 'sgu20151432', 'amr.m.araby', 'mai99mahdy', 'sgu20161512', 'mephistokc', 'michelhakim2001.mh', 'zazotop31', 'abdelrahmananwar', 'jisooyoon', 'michaelhelal99', 'sgu20171560', 'sgu20161466', 'joker.man2000000', 'ahmedramadan', 'omar_anwer', 'sgu20161508', 'amy', 'erhan26uzun', 'sadboijalal', 'ataozirmak', 'boules', 'moh.nabil2050', 'nadakhaled', 'fabio.signorelli', 'abdelmoneim404', 'sal7ien1999', 'sgu20151426', 'barkinsrc5', 'sgu20191494', 'youjiyeon', 'rubenasa', 'mohameda.younis80', 'amr.ghoname.teaching', 'ahmedsaeed', 'my1hunter', 'atknncvkkl', 'sgu20161536', 'sgu20161460', 'juni8472', 'sgu20171582', 'roshdy.aa', 'ramezakram97', 'demonkaksh', 'mernaeshakfaheem', 'pamilapoopad', 'metoyahia1999', 'nayeramakram98', 'sgu20171496', 'amartiger2020', 'melegy99', 'sgu20171528', 'tongmalual', 'sgu20191490', None, 'fatihakyurek26', 'ittopsk', 'hosamshaher43', 'cyrillemagdi', 'sug20182194', 'ebrahim.almohandes', 'sgu20191534', 'sgu20191466', 'b715063minbyeongmoon', 'sgu20151500', 'bassant.ahmed20118', 'mamoundiouri', 'sgu20151461', 'sgu20171536', 'beoungwoo', 'shadymagdy99', 'jaeeun53', 'karim20103200', 'andrewmon', 'omaraly112', 'sgu20171534', 'sgu20151878', 'marwanahmad988', 'jpuko11', 'sgu20171546', 'sgu20151434', 'raniamuhamed44', 'jaegisehyun', 'cbortlek', 'generalshephrd', 'abdulrahman.hussien1999', 'mohamed.eid1014', 'manjunath216', 'tndukaife2018', 'jpuko00', 'sgu20191462', 'alaa15eltehewey', 'ervndgn59', 'ahmadatef580', 'habiba.elkassas', 'youssefsamiryoussef', 'abdallahhashim', 'maged19991926', 'sgu20151421', 'mahmodfarag2000', 'b919083', 'yahiahamimi', 'yashhiteshbh', 'saga102938', 'sogang20191452', 'mpsingh', 'mirko.capodicasa', 'sgu20171596', 'ekicifatih0', 'sgu20151488', 'tanseerali', 'mohamed.zna66', 'sgu20161492', 'jlev713', 'm_feky', 'peterhorvath', 'sgu20171578', 'sgu20191476', 'shrouk.a.emad', 'abdoelanwar99', 'elsayedrafaat7', 'sgu20151507', 'rektxz', 'markashaf232', 'fasd556.om', 'sgu20171503', 'dina.23elessawy', 'michael29699', 'taawsifrc', 'faridmohammed98']"
2,222,223,151,141,"['ahaseno', 'lamz', 'rvannucc', 'balsudea', 'jflatto', 'jnedohin', 'khan318', 'alfanon', 'hickey22', 'strangn', 'ngallek', 'wils1010', 'wang4229', 'ncubides', 'salves', 'liu2512', 'jjavier', 'npfeffer', 'cohen83', 'tksrhktkfka', 'gwyman', 'blabell', 'marks65', 'rsahagun', 'kim1857', 'mnesci18', 'gould27', 'rojas30', 'costel14', 'xng', 'wen126', 'bhausman', 'gesosav', 'gfeldbe', 'burson', 'farrowm', 'rschene', 'kayuba', 'pseifert', 'cleinhei', 'ddilksan', 'gcrim', 'lee3777', 'psandlin', 'rmarcha', 'pasperry', 'hanson90', 'mart1852', 'ichavan', 'wlindse', 'beck160', 'jngassaf', 'hardin44', 'bhardw10', 'teng26', 'biglera', 'jsching', 'schakinala02', 'mayhew0', 'hhackett', 'hedges9', 'romack0', 'kundu5', 'nrrobins', 'wrigh577', 'chang635', 'mciccon', 'skhomphe', 'ecobos', 'mgobry', 'msiliton', 'vmimsbor', 'iwus', 'kmuenpra', 'song666', 'cliffom', 'anomi', 'xu1392', 'vfarrell', 'christer913', 'zhao969', 'raghavauppuluri13', 'coope348', 'xu1493', 'lheirty', 'rgadre', 'yu915', 'dcowden', 'nbabusis', 'eerivona', 'ahockma', 'rasbb31', 'mobernes', 'nessc', 'moreno80', 'hanna35', 'zrainey', 'pate1260', 'mart1773', 'englis15', 'kbonvill', 'potter56', 'stinsons', 'ameyerja', 'tamicon', 'tkedlaya', 'mmahale', 'harri870', 'wong313', 'tao97', 'jwosiak', 'rgodjali', 'barrer10', 'hong286', 'fdiago', 'tlirette', 'ebarranc', 'jmushru', 'jczhu', 'holman10', 'pbaugh', 'nmeer', 'nbwilkin', 'bsfar', 'knigh114', 'goel53', 'bayuan', 'butkus0', 'doyle109', 'mmaga', 'rlopezpa', 'evans415', 'gomez195', 'long320', 'eavey', 'asinks', 'mill2708', 'spohle', 'mvillel', 'nganti', 'wang4444']",81,"['ssabrol', 'zhou1120', 'tang540', 'dkholode', 'li3806', 'peng232', 'john2055', 'nburnsid', 'wsaw', 'strohlc', 'lee3312', 'perez353', 'kerr40', 'jang186', 'peng229', 'kgurung', 'lu807', 'zhan3514', 'seltzer', 'hogan54', 'gulley3', 'uajmal', 'lu768', 'wu1723', 'xie347', 'mjacks', 'arora112', 'pghantas', 'cho313', 'tran201', 'aaiyanna', 'peng236', 'li3345', 'chen_length', 'yang1795', 'pham88', 'ochoudhr', 'rapph', 'lolcott', 'sriniv96', 'nguye521', 'bjesiek', 'dai185', 'chang658', 'dvenugop', 'sfaruqi', 'mnabulsi', 'ztillett', 'pan300', 'liang289', 'woodsonj', 'huan1487', 'li3617', 'le153', 'rfarage', 'huan1408', 'mohdraml', 'jmworthi', 'mtorrisi', 'fgoode', 'jturcott', 'murph449', 'palme', 'campb418', 'tripati', 'adivish', 'lopez333', 'raghavcast', 'dcoomber', 'herna397', 'rodri532', 'young600', 'rshrishi', 'matredwa', 'tzyen', 'vishwand', 'kwon175', 'hcandass', 'jwaterwo', 'mai22', 'malon112']",10,"['tmoore', 'rjammula', 'woods183', 'carr94', 'clancy6', 'estockwe', 'rkeyser', 'peck28', 'ebasem', None]",232,"['ahaseno', 'lamz', 'ssabrol', 'rvannucc', 'jflatto', 'alfanon', 'hickey22', 'li3806', 'peng232', 'clancy6', 'wils1010', 'liu2512', 'jjavier', 'npfeffer', 'nburnsid', 'wsaw', 'lee3312', 'tksrhktkfka', 'blabell', 'jang186', 'gould27', 'rsahagun', 'mnesci18', 'rojas30', 'kgurung', 'xng', 'zhan3514', 'gesosav', 'hogan54', 'burson', 'lu768', 'farrowm', 'xie347', 'rschene', 'cleinhei', 'cho313', 'lee3777', 'peng236', 'li3345', 'yang1795', 'pasperry', 'hanson90', 'pham88', 'mart1852', 'hardin44', 'sriniv96', 'nguye521', 'biglera', 'dai185', 'hhackett', 'romack0', 'wrigh577', 'mciccon', 'skhomphe', 'mgobry', 'ecobos', 'vmimsbor', 'cliffom', 'christer913', 'le153', 'zhao969', 'coope348', 'lheirty', 'rgadre', 'ahockma', 'rasbb31', 'mobernes', 'rfarage', 'nessc', 'huan1408', 'zrainey', 'pate1260', 'potter56', 'ameyerja', 'mmahale', 'barrer10', 'mtorrisi', 'tlirette', 'ebarranc', 'jmushru', 'jturcott', 'ebasem', 'nmeer', 'nbwilkin', 'bsfar', 'bayuan', 'dcoomber', 'herna397', 'butkus0', 'mmaga', 'rjammula', 'tzyen', 'gomez195', 'asinks', 'eavey', 'mvillel', 'nganti', 'jwaterwo', 'wang4444', 'eerivona', 'mohdraml', 'malon112', 'balsudea', 'jnedohin', 'khan318', 'zhou1120', 'tang540', 'dkholode', 'strangn', 'ngallek', 'john2055', 'wang4229', 'ncubides', 'salves', 'cohen83', 'strohlc', 'perez353', 'kerr40', 'gwyman', 'marks65', 'peng229', 'kim1857', 'costel14', 'lu807', 'wen126', 'seltzer', 'bhausman', 'gfeldbe', 'gulley3', 'uajmal', 'wu1723', 'kayuba', 'mjacks', 'arora112', 'pseifert', 'ddilksan', 'pghantas', 'gcrim', 'tran201', 'aaiyanna', 'psandlin', 'chen_length', 'rmarcha', 'wlindse', 'ichavan', 'beck160', 'ochoudhr', 'jngassaf', 'rapph', 'lolcott', None, 'bhardw10', 'teng26', 'bjesiek', 'jsching', 'schakinala02', 'mayhew0', 'chang658', 'hedges9', 'dvenugop', 'sfaruqi', 'peck28', 'mnabulsi', 'kundu5', 'ztillett', 'nrrobins', 'chang635', 'pan300', 'liang289', 'woodsonj', 'msiliton', 'estockwe', 'iwus', 'kmuenpra', 'huan1487', 'song666', 'anomi', 'li3617', 'xu1392', 'vfarrell', 'raghavauppuluri13', 'xu1493', 'yu915', 'dcowden', 'tmoore', 'nbabusis', 'hanna35', 'moreno80', 'mart1773', 'englis15', 'kbonvill', 'stinsons', 'tamicon', 'tkedlaya', 'carr94', 'jmworthi', 'rkeyser', 'harri870', 'wong313', 'tao97', 'jwosiak', 'rgodjali', 'hong286', 'fdiago', 'fgoode', 'holman10', 'pbaugh', 'jczhu', 'murph449', 'palme', 'campb418', 'tripati', 'adivish', 'lopez333', 'knigh114', 'woods183', 'goel53', 'raghavcast', 'rodri532', 'doyle109', 'young600', 'rlopezpa', 'matredwa', 'rshrishi', 'evans415', 'vishwand', 'long320', 'mill2708', 'spohle', 'kwon175', 'hcandass', 'mai22']"
2,223,223,21,19,"['mtorrisi', 'ssabrol', 'hogan54', 'liang289', 'fgoode', 'zhou1120', 'tang540', 'murph449', 'cho313', 'dcoomber', 'john2055', 'matredwa', 'moreno80', 'bjesiek', 'jmworthi', 'hedges9', 'sfaruqi', 'jwaterwo', 'mohdraml']",203,"['ahaseno', 'lamz', 'balsudea', 'rvannucc', 'jflatto', 'jnedohin', 'khan318', 'alfanon', 'dkholode', 'hickey22', 'li3806', 'peng232', 'strangn', 'ngallek', 'wils1010', 'wang4229', 'ncubides', 'salves', 'liu2512', 'jjavier', 'npfeffer', 'cohen83', 'nburnsid', 'wsaw', 'strohlc', 'lee3312', 'perez353', 'kerr40', 'tksrhktkfka', 'gwyman', 'blabell', 'marks65', 'jang186', 'peng229', 'gould27', 'rsahagun', 'mnesci18', 'kim1857', 'rojas30', 'kgurung', 'lu807', 'xng', 'zhan3514', 'wen126', 'seltzer', 'bhausman', 'gesosav', 'gfeldbe', 'burson', 'gulley3', 'uajmal', 'lu768', 'wu1723', 'farrowm', 'xie347', 'rschene', 'kayuba', 'mjacks', 'arora112', 'pseifert', 'cleinhei', 'ddilksan', 'pghantas', 'gcrim', 'tran201', 'aaiyanna', 'lee3777', 'psandlin', 'peng236', 'li3345', 'chen_length', 'yang1795', 'pasperry', 'wlindse', 'pham88', 'ichavan', 'hanson90', 'rmarcha', 'mart1852', 'beck160', 'ochoudhr', 'jngassaf', 'hardin44', 'rapph', 'lolcott', 'sriniv96', 'bhardw10', 'teng26', 'nguye521', 'biglera', 'dai185', 'jsching', 'schakinala02', 'mayhew0', 'chang658', 'hhackett', 'romack0', 'dvenugop', 'mnabulsi', 'kundu5', 'ztillett', 'nrrobins', 'wrigh577', 'chang635', 'pan300', 'mciccon', 'wang4444', 'skhomphe', 'mgobry', 'woodsonj', 'ecobos', 'msiliton', 'vmimsbor', 'iwus', 'mai22', 'kmuenpra', 'huan1487', 'song666', 'cliffom', 'anomi', 'li3617', 'xu1392', 'vfarrell', 'christer913', 'le153', 'zhao969', 'raghavauppuluri13', 'coope348', 'xu1493', 'lheirty', 'rgadre', 'yu915', 'dcowden', 'nbabusis', 'eerivona', 'ahockma', 'rasbb31', 'mobernes', 'rfarage', 'nessc', 'hanna35', 'huan1408', 'zrainey', 'mart1773', 'pate1260', 'englis15', 'kbonvill', 'potter56', 'stinsons', 'ameyerja', 'tamicon', 'tkedlaya', 'mmahale', 'harri870', 'wong313', 'tao97', 'jwosiak', 'rgodjali', 'hong286', 'barrer10', 'fdiago', 'tlirette', 'ebarranc', 'jmushru', 'holman10', 'pbaugh', 'jturcott', 'jczhu', 'nmeer', 'palme', 'campb418', 'tripati', 'adivish', 'lopez333', 'nbwilkin', 'bsfar', 'knigh114', 'goel53', 'raghavcast', 'bayuan', 'herna397', 'rodri532', 'doyle109', 'butkus0', 'mmaga', 'young600', 'rlopezpa', 'rshrishi', 'evans415', 'tzyen', 'vishwand', 'gomez195', 'long320', 'asinks', 'eavey', 'mill2708', 'spohle', 'kwon175', 'hcandass', 'mvillel', 'nganti', 'costel14', 'malon112']",2,"['clancy6', None]",224,"['ahaseno', 'lamz', 'ssabrol', 'balsudea', 'rvannucc', 'jflatto', 'jnedohin', 'khan318', 'alfanon', 'zhou1120', 'tang540', 'dkholode', 'hickey22', 'li3806', 'peng232', 'strangn', 'clancy6', 'ngallek', 'wils1010', 'john2055', 'wang4229', 'ncubides', 'salves', 'liu2512', 'jjavier', 'npfeffer', 'cohen83', 'nburnsid', 'wsaw', 'strohlc', 'lee3312', 'perez353', 'kerr40', 'tksrhktkfka', 'gwyman', 'blabell', 'marks65', 'jang186', 'peng229', 'gould27', 'rsahagun', 'mnesci18', 'kim1857', 'rojas30', 'kgurung', 'lu807', 'xng', 'zhan3514', 'wen126', 'seltzer', 'bhausman', 'gesosav', 'gfeldbe', 'hogan54', 'burson', 'gulley3', 'uajmal', 'lu768', 'wu1723', 'farrowm', 'xie347', 'rschene', 'kayuba', 'mjacks', 'arora112', 'pseifert', 'cleinhei', 'ddilksan', 'cho313', 'pghantas', 'gcrim', 'tran201', 'aaiyanna', 'lee3777', 'psandlin', 'peng236', 'li3345', 'chen_length', 'yang1795', 'pasperry', 'wlindse', 'pham88', 'ichavan', 'hanson90', 'rmarcha', 'mart1852', 'beck160', 'ochoudhr', 'jngassaf', 'hardin44', 'rapph', 'lolcott', 'sriniv96', None, 'bhardw10', 'teng26', 'nguye521', 'bjesiek', 'biglera', 'dai185', 'jsching', 'schakinala02', 'mayhew0', 'chang658', 'hhackett', 'hedges9', 'romack0', 'dvenugop', 'sfaruqi', 'mnabulsi', 'kundu5', 'ztillett', 'nrrobins', 'wrigh577', 'chang635', 'pan300', 'mciccon', 'wang4444', 'liang289', 'skhomphe', 'mgobry', 'woodsonj', 'ecobos', 'msiliton', 'vmimsbor', 'iwus', 'mai22', 'kmuenpra', 'huan1487', 'song666', 'cliffom', 'anomi', 'li3617', 'xu1392', 'vfarrell', 'christer913', 'le153', 'zhao969', 'raghavauppuluri13', 'coope348', 'xu1493', 'lheirty', 'rgadre', 'yu915', 'dcowden', 'nbabusis', 'eerivona', 'ahockma', 'rasbb31', 'mobernes', 'rfarage', 'nessc', 'hanna35', 'huan1408', 'moreno80', 'zrainey', 'mart1773', 'pate1260', 'englis15', 'kbonvill', 'potter56', 'stinsons', 'ameyerja', 'mohdraml', 'tamicon', 'tkedlaya', 'jmworthi', 'mmahale', 'harri870', 'wong313', 'tao97', 'jwosiak', 'rgodjali', 'hong286', 'mtorrisi', 'barrer10', 'fdiago', 'tlirette', 'ebarranc', 'jmushru', 'fgoode', 'holman10', 'pbaugh', 'jturcott', 'jczhu', 'nmeer', 'murph449', 'palme', 'campb418', 'tripati', 'adivish', 'lopez333', 'nbwilkin', 'bsfar', 'knigh114', 'goel53', 'raghavcast', 'bayuan', 'dcoomber', 'herna397', 'rodri532', 'doyle109', 'butkus0', 'mmaga', 'young600', 'rlopezpa', 'matredwa', 'rshrishi', 'evans415', 'tzyen', 'vishwand', 'gomez195', 'long320', 'asinks', 'eavey', 'mill2708', 'spohle', 'kwon175', 'hcandass', 'mvillel', 'nganti', 'jwaterwo', 'costel14', 'malon112']"
2,224,223,8,7,"['pham88', 'adivish', 'woodsonj', 'ochoudhr', 'tran201', 'bayuan', 'perez353']",215,"['ahaseno', 'lamz', 'ssabrol', 'balsudea', 'rvannucc', 'jflatto', 'jnedohin', 'khan318', 'alfanon', 'zhou1120', 'tang540', 'dkholode', 'hickey22', 'li3806', 'peng232', 'strangn', 'ngallek', 'wils1010', 'john2055', 'wang4229', 'ncubides', 'salves', 'liu2512', 'jjavier', 'npfeffer', 'cohen83', 'nburnsid', 'wsaw', 'strohlc', 'lee3312', 'kerr40', 'tksrhktkfka', 'gwyman', 'blabell', 'marks65', 'jang186', 'peng229', 'gould27', 'rsahagun', 'mnesci18', 'kim1857', 'rojas30', 'kgurung', 'lu807', 'xng', 'zhan3514', 'wen126', 'seltzer', 'bhausman', 'gesosav', 'gfeldbe', 'hogan54', 'burson', 'gulley3', 'uajmal', 'lu768', 'wu1723', 'farrowm', 'xie347', 'rschene', 'kayuba', 'mjacks', 'arora112', 'pseifert', 'cleinhei', 'ddilksan', 'cho313', 'pghantas', 'gcrim', 'aaiyanna', 'lee3777', 'psandlin', 'peng236', 'li3345', 'chen_length', 'yang1795', 'pasperry', 'wlindse', 'ichavan', 'hanson90', 'rmarcha', 'mart1852', 'beck160', 'jngassaf', 'hardin44', 'rapph', 'lolcott', 'sriniv96', 'bhardw10', 'teng26', 'nguye521', 'bjesiek', 'biglera', 'dai185', 'jsching', 'schakinala02', 'mayhew0', 'chang658', 'hhackett', 'hedges9', 'romack0', 'dvenugop', 'sfaruqi', 'mnabulsi', 'kundu5', 'ztillett', 'nrrobins', 'wrigh577', 'chang635', 'pan300', 'mciccon', 'wang4444', 'liang289', 'skhomphe', 'mgobry', 'ecobos', 'msiliton', 'vmimsbor', 'iwus', 'mai22', 'kmuenpra', 'huan1487', 'song666', 'cliffom', 'anomi', 'li3617', 'xu1392', 'vfarrell', 'christer913', 'le153', 'zhao969', 'raghavauppuluri13', 'coope348', 'xu1493', 'lheirty', 'rgadre', 'yu915', 'dcowden', 'nbabusis', 'eerivona', 'ahockma', 'rasbb31', 'mobernes', 'rfarage', 'nessc', 'hanna35', 'huan1408', 'moreno80', 'zrainey', 'mart1773', 'pate1260', 'englis15', 'kbonvill', 'potter56', 'stinsons', 'ameyerja', 'mohdraml', 'tamicon', 'tkedlaya', 'jmworthi', 'mmahale', 'harri870', 'wong313', 'tao97', 'jwosiak', 'rgodjali', 'hong286', 'mtorrisi', 'barrer10', 'fdiago', 'tlirette', 'ebarranc', 'jmushru', 'fgoode', 'holman10', 'pbaugh', 'jturcott', 'jczhu', 'nmeer', 'murph449', 'palme', 'campb418', 'tripati', 'lopez333', 'nbwilkin', 'bsfar', 'knigh114', 'goel53', 'raghavcast', 'dcoomber', 'herna397', 'rodri532', 'doyle109', 'butkus0', 'mmaga', 'young600', 'rlopezpa', 'matredwa', 'rshrishi', 'evans415', 'tzyen', 'vishwand', 'gomez195', 'long320', 'asinks', 'eavey', 'mill2708', 'spohle', 'kwon175', 'hcandass', 'mvillel', 'nganti', 'jwaterwo', 'costel14', 'malon112']",1,[None],223,"['ahaseno', 'lamz', 'ssabrol', 'balsudea', 'rvannucc', 'jflatto', 'jnedohin', 'khan318', 'alfanon', 'zhou1120', 'tang540', 'dkholode', 'hickey22', 'li3806', 'peng232', 'strangn', 'ngallek', 'wils1010', 'john2055', 'wang4229', 'ncubides', 'salves', 'liu2512', 'jjavier', 'npfeffer', 'cohen83', 'nburnsid', 'wsaw', 'strohlc', 'lee3312', 'perez353', 'kerr40', 'tksrhktkfka', 'gwyman', 'blabell', 'marks65', 'jang186', 'peng229', 'gould27', 'rsahagun', 'mnesci18', 'kim1857', 'rojas30', 'kgurung', 'lu807', 'xng', 'zhan3514', 'wen126', 'seltzer', 'bhausman', 'gesosav', 'gfeldbe', 'hogan54', 'burson', 'gulley3', 'uajmal', 'lu768', 'wu1723', 'farrowm', 'xie347', 'rschene', 'kayuba', 'mjacks', 'arora112', 'pseifert', 'cleinhei', 'ddilksan', 'cho313', 'pghantas', 'gcrim', 'tran201', 'aaiyanna', 'lee3777', 'psandlin', 'peng236', 'li3345', 'chen_length', 'yang1795', 'pasperry', 'wlindse', 'pham88', 'ichavan', 'hanson90', 'rmarcha', 'mart1852', 'beck160', 'ochoudhr', 'jngassaf', 'hardin44', 'rapph', 'lolcott', 'sriniv96', None, 'bhardw10', 'teng26', 'nguye521', 'bjesiek', 'biglera', 'dai185', 'jsching', 'schakinala02', 'mayhew0', 'chang658', 'hhackett', 'hedges9', 'romack0', 'dvenugop', 'sfaruqi', 'mnabulsi', 'kundu5', 'ztillett', 'nrrobins', 'wrigh577', 'chang635', 'pan300', 'mciccon', 'wang4444', 'liang289', 'skhomphe', 'mgobry', 'woodsonj', 'ecobos', 'msiliton', 'vmimsbor', 'iwus', 'mai22', 'kmuenpra', 'huan1487', 'song666', 'cliffom', 'anomi', 'li3617', 'xu1392', 'vfarrell', 'christer913', 'le153', 'zhao969', 'raghavauppuluri13', 'coope348', 'xu1493', 'lheirty', 'rgadre', 'yu915', 'dcowden', 'nbabusis', 'eerivona', 'ahockma', 'rasbb31', 'mobernes', 'rfarage', 'nessc', 'hanna35', 'huan1408', 'moreno80', 'zrainey', 'mart1773', 'pate1260', 'englis15', 'kbonvill', 'potter56', 'stinsons', 'ameyerja', 'mohdraml', 'tamicon', 'tkedlaya', 'jmworthi', 'mmahale', 'harri870', 'wong313', 'tao97', 'jwosiak', 'rgodjali', 'hong286', 'mtorrisi', 'barrer10', 'fdiago', 'tlirette', 'ebarranc', 'jmushru', 'fgoode', 'holman10', 'pbaugh', 'jturcott', 'jczhu', 'nmeer', 'murph449', 'palme', 'campb418', 'tripati', 'adivish', 'lopez333', 'nbwilkin', 'bsfar', 'knigh114', 'goel53', 'raghavcast', 'bayuan', 'dcoomber', 'herna397', 'rodri532', 'doyle109', 'butkus0', 'mmaga', 'young600', 'rlopezpa', 'matredwa', 'rshrishi', 'evans415', 'tzyen', 'vishwand', 'gomez195', 'long320', 'asinks', 'eavey', 'mill2708', 'spohle', 'kwon175', 'hcandass', 'mvillel', 'nganti', 'jwaterwo', 'costel14', 'malon112']"
3,386,209,183,7,"['ozcanguclu', 'kagangunes10', 'yasinzgen', 'serhatiseri', 'taol190799', 'emreyilmazel1996', 'karpuz']",201,"['mgk816', 'cmergil39', 'mcsonic', 'prosdocimi.m', 'dleon3', 'yunusyeo768', 'evren_aydin6', 'mtakcali', 'emreoney', 'mapayan5', 'swarupadhyay777', 'esulekaplan', 'kenanke', 'fztrnetflix', 'nsener45', 'ekin.gezer', 'joker632455', 'ganesh25', 'okanozkann95', 'murattdo', 'roy227', 'ezelbilgili42', 'burak.baha00', 'youlianafouad17', 'salvalenzuela12', 'isma', 'metobomm', 'enesdinler1', 'krishna.mp', 'jmoya5', 'almelnz2005', 'fjduran3', 'sarawaelahmed22', 'ryckmonster', 'macolmenero', 'bsanchez', 'venkitesh.s', 'garfon61', 'nnurceylan95', 'w.edgarfamous', 'furkan069906', 'arivera35', 'agmendez14', 'alex10', 'jozrik', 'omerdmrc16', 'bertansafak', 'ajortega6', 'zeynep', 'mahmutcanki', 'mstff.1clkk', 'kumar_shubham', 'mmozcan4', 'alibatuhanozturk', 'jadelira201', 'arif.ozkan5806', 'sigalam', 'shrreya07', 'blogan', 'esraboran71', 'mseyfullahcelik', 'chrisodomx', 'dmitry.stor', '1967hamzausta', 'goknur.derinoz', 'garciaje34454', 'afurkanbudak42', 'ufuk', 'diaz.carlos4499', 'kemre9827', 'scopigno', 'brs21', 'nikharv.19110125', 'halilibrahimtiken', 'ege.ert7', 'fdominguez6', 'ademfurkan', 'havvafatmaozbay', 'sayed.aftabahmad786', 'gtzintzarov', 'mehmetaliyas1998', 'ceydabayrak581', 'elembengisu', 'ferhbk97', 'dblancarte', 'mmb', 'utkubala63', 'mertisleyen96', 'iremnurfiliz', 'dragon28540', 'elifindir', 'sebastiangarcia695', 'koningmehmet', 'shaawanalmutairi', 'aadelgado4', 'jagallegos7', 'altinbasnurcan09', 'druiz20', 'pongbrayan', 'bmendoza4', 'mustafa.kaya0798507', 'pmhernandez4', 'paras128', 'klc.mrt.1926', 'windl', 'rmartinez5', 'lerner', 'banoth.dinesh', 'furkan2072', 'fatihyorgun1996', 'sai.mrr', 'drhodges', 'simayozbay', 'erencanarslan70', 'choudhary_s', 'emregonen', 'murat.ozeee', 'anurag_kurle', 'emrecitakk', 'ardelarosa', 'yash.mh', 'furkan552senturk', 'shashi.sarraf', 'mehmettasdelen26', 'kanwat.pranav', 'cancetinkaya1201', 'saineeth', 'sflt317', 'ncmagra54', 'aileyvaa', 'mustafayigitesen', 'uzunnurdan', 'eliffsu.koc', 'halilalp', 'jessica.satyarthi', 'ensarerol26', 'klayydar', 'azazimalii', 'gurhankopcaz', 'jyothishjaggarapu225', 'anjaligawai', 'naveen143', 'abcd5454', 'kaanbjk27', 'erdicany', 'alikanadli7', 'serdememen', 'jessgomez100', 'tolga.ozyurt24', 'dhyanasivadas311', 'blassselva', 'wuizar99', 'ozcankutlu15', 'funsal', 'sabriyebayrakcinur', 'mumi1478', 'veyseleee123', 'kingkireeti', 'rhamwey', 'evelyn.f1975', 'haticeterzibali', 'xavier160mg', 'berksaldr', 'njgarcia5', 'jayopp32', 'jarellano1204', 'muvafikmelikkaya', 'gullit0725', 'jasmine43.jp', 'mrgiraffe', 'irem.karagoz33', 'rebecasalcido', 'jatin.us', 'esuna006', 'haoliu', 'aayushik', 'emre.ibil', 'burakbeyazt', 'testeremre70', 'ezelbilgili', 'anilboran0671', 'bryang511', 'yamakonurcan', 'yorumhesabimsa', 'kodaar', 'carlosquinonez80', 'sai.ssm', 'zilmidegne', 'michaelpov', 'anand.satyam', 'berkc', 'selinyasaci98', 'orancagdas', 'ninad.ps', 'sonerkar', 'tugbakoyuncu99', 'yusmar', 'kaankuncak', 'ulises98', 'kagankilicaslan28', 'petersan901']",176,"['ardaulusan_14', 'espejodaniel6', 'liresaferizaj', 'verone.krasniqi', 'gjb56', 'artin.sermaxhaj', 'kastriotsalihu', 'edmondovalvo28', 'vmike0426', 'gentihyseni11', 'lookatfuture09', 'theharshit', 'keremino', 'mf3256', 'enkele', 'liviajanicew', 'kursatmutlu03', 'twcross11', 'kacp3r', 'jonathancollins55', 'kevinh88', 'tlsmarshall1', 'baczas996', 'jbertocc', 'rfneed', 'aleksandardunjic1999', 'bardha.januzi', 'fdirisaglik', 'jedelkind', 'hjhj8794', 'barbanataraheta', 'elona.rashica', 'jlanzoni18', 'jaylenwang', 'jasmina.rozek', 'atkncvkkl1', 'elona.gervalla', 'alberianatofaj', 'flamur', 'albina.ahmeti', 'albion', 'fidanhoxha', 'czes', 'nicolech73', 'redon.tahiri', 'dhilanr', 'lockbox30', 'sgu20171552', 'hanife', 'elsaa', 'bayramdonmez96', 'cmunoz', 'enes.hasani', 'arnavsrivastava', 'ph33', 'smrf432', 'saxenapurva96', 'enweizhang732', 'flamur.mustafa', 'ilir.jasharaj', 'cemaloz745', 'ft13', 'akdemirel99', 'reepl', 'recaro13', 'yusufsabahoglu05', 'ekim.coskun19', 'donat.aliu147', 'musa.kadiri', 'sreevidya.c', 'nazifebeqiri59', 'andreheinzig', 'midie.merovci', 'jculp', 'albin.sejdiu', 'kfullen', 'yaohuichen', 'maan1742180', 'jmcveigh55', 'ducka.agata', 'jfmuller', 'kav68', 'klintiponari6', 'akshatpokharna7', 'ertugrul4101160', '1jordanschwartz', 'njomza.ismaili', 'salem2', 'rita.kastrati', 'yellowturtle', 'szerefa', 'hary765', 'dkorakakis', 'domagoj.tomic', 'elton.kaqiu', 'samuelnxr', 'do356', 'mas2565', 'njomza.rexhepi3', 'lislimani', 'fabio.telesca', 'adonis.xhemajli', 'ml3566', 'koushik.cc', 'hanhdp99', 'pan_1238', 'barbana.heta', 'erblina2berisha', 's.kasamatsu', 'sug20171516', 'sgu20171546', 'krzysztof.golyga', 'laxman_18110093', 'solarwing', 'ben3862', 'artine.hoxha', 'florian.halimi1', 'acastro34', 'julinda.nasufi', 'canhuseyinnn', 'blerona.emini', 'patelba', 'ghosh_payel', 'zs2495', 'alpayy98', 'petrini', 'valeza.grainca', 'lendrit.ibrahimi', 'fraser_darling', 'tcp47', 'doruntina.hoti', 'mra4020', 'pospiechjoanna', 'burghoornniels', 'bernhardhaas55', 'qahoang', 'cristianololipops56', 'kianamon', 'clinlin9264', 'medinehajredini', 'davidosmanovic', 'bleon.alimi', 'andi.dika', 'bdn2113', 'sgu20171596', 'blerand.mjeku', 'emircansimsek', 'beskisehir', 'lado.filipovic', 'sara.haliti', 'jcjohnson', 'ora', 'cansecgin', 'cspiner', 'edgarm120397', 'lauragashi', 'piter15710', 'sd226', 'sakshi17jagtap', 'kv0001', 'aecarter', 'christianc2', 'nrcnaltinbas', 'scullyer16', 'lindkrasniqi', 'indyfisico', 'jpalko20', 'madharmes', 'erdonakrasniqi', 'bksharpe2021', 'gollner.laura', 'beni1', 'junchong10', 'lowen12', 'loreta.pajaziti1', 'hadesantiago17']",384,"['mgk816', 'ardaulusan_14', 'cmergil39', 'espejodaniel6', 'verone.krasniqi', 'dleon3', 'mtakcali', 'edmondovalvo28', 'lookatfuture09', 'swarupadhyay777', 'theharshit', 'keremino', 'mf3256', 'nsener45', 'kursatmutlu03', 'joker632455', 'twcross11', 'okanozkann95', 'murattdo', 'kevinh88', 'roy227', 'rfneed', 'burak.baha00', 'metobomm', 'aleksandardunjic1999', 'bardha.januzi', 'enesdinler1', 'krishna.mp', 'fdirisaglik', 'jedelkind', 'jmoya5', 'jlanzoni18', 'barbanataraheta', 'jasmina.rozek', 'atkncvkkl1', 'flamur', 'macolmenero', 'bsanchez', 'venkitesh.s', 'nnurceylan95', 'fidanhoxha', 'czes', 'nicolech73', 'redon.tahiri', 'arivera35', 'agmendez14', 'dhilanr', 'lockbox30', 'sgu20171552', 'hanife', 'elsaa', 'ajortega6', 'mahmutcanki', 'bayramdonmez96', 'mstff.1clkk', 'kumar_shubham', 'mmozcan4', 'ph33', 'alibatuhanozturk', 'smrf432', 'arif.ozkan5806', 'karpuz', 'saxenapurva96', 'ilir.jasharaj', 'cemaloz745', 'ft13', 'shrreya07', 'mseyfullahcelik', 'garciaje34454', 'kagangunes10', '1967hamzausta', 'goknur.derinoz', 'afurkanbudak42', 'akdemirel99', 'recaro13', 'ufuk', 'diaz.carlos4499', 'yusufsabahoglu05', 'musa.kadiri', 'sreevidya.c', 'brs21', 'nikharv.19110125', 'fdominguez6', 'andreheinzig', 'midie.merovci', 'jculp', 'elembengisu', 'mmb', 'albin.sejdiu', 'kfullen', 'utkubala63', 'jmcveigh55', 'jfmuller', 'ducka.agata', 'iremnurfiliz', 'dragon28540', 'elifindir', 'sebastiangarcia695', 'klintiponari6', 'serhatiseri', 'shaawanalmutairi', 'aadelgado4', 'jagallegos7', 'altinbasnurcan09', 'bmendoza4', 'pongbrayan', 'pmhernandez4', 'hary765', 'windl', 'dkorakakis', 'rmartinez5', 'domagoj.tomic', 'samuelnxr', 'do356', 'fatihyorgun1996', 'njomza.rexhepi3', 'adonis.xhemajli', 'erencanarslan70', 'ml3566', 'choudhary_s', 'koushik.cc', 'emregonen', 'murat.ozeee', 'hanhdp99', 'erblina2berisha', 'ardelarosa', 'sug20171516', 'yash.mh', 'krzysztof.golyga', 'solarwing', 'furkan552senturk', 'artine.hoxha', 'florian.halimi1', 'julinda.nasufi', 'canhuseyinnn', 'blerona.emini', 'kanwat.pranav', 'patelba', 'ncmagra54', 'aileyvaa', 'zs2495', 'uzunnurdan', 'alpayy98', 'petrini', 'jessica.satyarthi', 'fraser_darling', 'tcp47', 'jyothishjaggarapu225', 'mra4020', 'anjaligawai', 'kaanbjk27', 'alikanadli7', 'burghoornniels', 'bernhardhaas55', 'jessgomez100', 'tolga.ozyurt24', 'cristianololipops56', 'ozcanguclu', 'dhyanasivadas311', 'blassselva', 'clinlin9264', 'sabriyebayrakcinur', 'davidosmanovic', 'mumi1478', 'bdn2113', 'rhamwey', 'evelyn.f1975', 'haticeterzibali', 'emircansimsek', 'beskisehir', 'jarellano1204', 'gullit0725', 'sara.haliti', 'jcjohnson', 'ora', 'irem.karagoz33', 'lauragashi', 'jatin.us', 'esuna006', 'aayushik', 'burakbeyazt', 'aecarter', 'ezelbilgili', 'anilboran0671', 'christianc2', 'kodaar', 'carlosquinonez80', 'lindkrasniqi', 'sai.ssm', 'zilmidegne', 'anand.satyam', 'berkc', 'selinyasaci98', 'jpalko20', 'orancagdas', 'erdonakrasniqi', 'yusmar', 'kagankilicaslan28', 'loreta.pajaziti1', 'hadesantiago17', 'mcsonic', 'prosdocimi.m', 'liresaferizaj', 'gjb56', 'artin.sermaxhaj', 'yunusyeo768', 'evren_aydin6', 'kastriotsalihu', 'vmike0426', 'emreoney', 'gentihyseni11', 'mapayan5', 'esulekaplan', 'kenanke', 'fztrnetflix', 'enkele', 'liviajanicew', 'ekin.gezer', 'ganesh25', 'kacp3r', 'jonathancollins55', 'tlsmarshall1', 'baczas996', 'jbertocc', 'ezelbilgili42', 'youlianafouad17', 'salvalenzuela12', 'isma', 'almelnz2005', 'fjduran3', 'sarawaelahmed22', 'hjhj8794', 'elona.rashica', 'jaylenwang', 'elona.gervalla', 'alberianatofaj', 'ryckmonster', 'albina.ahmeti', 'garfon61', 'albion', 'furkan069906', 'w.edgarfamous', 'alex10', 'jozrik', 'omerdmrc16', 'bertansafak', 'zeynep', 'cmunoz', 'enes.hasani', 'arnavsrivastava', 'jadelira201', 'enweizhang732', 'flamur.mustafa', 'sigalam', 'blogan', 'esraboran71', 'chrisodomx', 'dmitry.stor', 'reepl', 'kemre9827', 'ekim.coskun19', 'scopigno', 'donat.aliu147', 'ademfurkan', 'halilibrahimtiken', 'ege.ert7', 'nazifebeqiri59', 'havvafatmaozbay', 'sayed.aftabahmad786', 'gtzintzarov', 'mehmetaliyas1998', 'ceydabayrak581', 'dblancarte', 'ferhbk97', 'yaohuichen', 'mertisleyen96', 'maan1742180', 'kav68', 'akshatpokharna7', 'koningmehmet', 'ertugrul4101160', '1jordanschwartz', 'njomza.ismaili', 'salem2', 'druiz20', 'mustafa.kaya0798507', 'paras128', 'klc.mrt.1926', 'rita.kastrati', 'yellowturtle', 'szerefa', 'lerner', 'banoth.dinesh', 'furkan2072', 'drhodges', 'sai.mrr', 'simayozbay', 'elton.kaqiu', 'mas2565', 'lislimani', 'fabio.telesca', 'anurag_kurle', 'pan_1238', 'barbana.heta', 'emrecitakk', 's.kasamatsu', 'sgu20171546', 'laxman_18110093', 'ben3862', 'acastro34', 'shashi.sarraf', 'mehmettasdelen26', 'cancetinkaya1201', 'saineeth', 'sflt317', 'ghosh_payel', 'mustafayigitesen', 'eliffsu.koc', 'halilalp', 'valeza.grainca', 'lendrit.ibrahimi', 'ensarerol26', 'klayydar', 'azazimalii', 'doruntina.hoti', 'gurhankopcaz', 'naveen143', 'abcd5454', 'erdicany', 'pospiechjoanna', 'serdememen', 'qahoang', 'kianamon', 'lowen12', 'wuizar99', 'ozcankutlu15', 'funsal', 'medinehajredini', 'andi.dika', 'bleon.alimi', 'veyseleee123', 'kingkireeti', 'taol190799', 'emreyilmazel1996', 'sgu20171596', 'blerand.mjeku', 'xavier160mg', 'berksaldr', 'njgarcia5', 'jayopp32', 'muvafikmelikkaya', 'lado.filipovic', 'jasmine43.jp', 'mrgiraffe', 'cansecgin', 'cspiner', 'rebecasalcido', 'edgarm120397', 'piter15710', 'sd226', 'sakshi17jagtap', 'haoliu', 'kv0001', 'emre.ibil', 'testeremre70', 'bryang511', 'yamakonurcan', 'yorumhesabimsa', 'nrcnaltinbas', 'scullyer16', 'indyfisico', 'michaelpov', 'ninad.ps', 'sonerkar', 'madharmes', 'tugbakoyuncu99', 'bksharpe2021', 'gollner.laura', 'beni1', 'kaankuncak', 'ulises98', 'junchong10', 'petersan901', 'yasinzgen']"
3,23,209,147,2,"['sarawaelahmed22', 'youlianafouad17']",206,"['mgk816', 'cmergil39', 'mcsonic', 'prosdocimi.m', 'dleon3', 'yunusyeo768', 'evren_aydin6', 'mtakcali', 'emreoney', 'mapayan5', 'swarupadhyay777', 'esulekaplan', 'kenanke', 'fztrnetflix', 'nsener45', 'ekin.gezer', 'joker632455', 'ganesh25', 'okanozkann95', 'murattdo', 'roy227', 'ezelbilgili42', 'burak.baha00', 'salvalenzuela12', 'isma', 'metobomm', 'enesdinler1', 'krishna.mp', 'jmoya5', 'almelnz2005', 'fjduran3', 'ryckmonster', 'macolmenero', 'bsanchez', 'venkitesh.s', 'garfon61', 'nnurceylan95', 'w.edgarfamous', 'furkan069906', 'arivera35', 'agmendez14', 'alex10', 'jozrik', 'omerdmrc16', 'bertansafak', 'ajortega6', 'zeynep', 'mahmutcanki', 'mstff.1clkk', 'kumar_shubham', 'mmozcan4', 'alibatuhanozturk', 'jadelira201', 'arif.ozkan5806', 'karpuz', 'sigalam', 'shrreya07', 'blogan', 'esraboran71', 'mseyfullahcelik', 'chrisodomx', 'kagangunes10', '1967hamzausta', 'dmitry.stor', 'goknur.derinoz', 'garciaje34454', 'afurkanbudak42', 'ufuk', 'diaz.carlos4499', 'kemre9827', 'scopigno', 'brs21', 'nikharv.19110125', 'halilibrahimtiken', 'ege.ert7', 'fdominguez6', 'ademfurkan', 'havvafatmaozbay', 'sayed.aftabahmad786', 'gtzintzarov', 'mehmetaliyas1998', 'ceydabayrak581', 'elembengisu', 'ferhbk97', 'dblancarte', 'mmb', 'utkubala63', 'mertisleyen96', 'iremnurfiliz', 'dragon28540', 'elifindir', 'sebastiangarcia695', 'koningmehmet', 'serhatiseri', 'shaawanalmutairi', 'aadelgado4', 'jagallegos7', 'altinbasnurcan09', 'druiz20', 'pongbrayan', 'bmendoza4', 'mustafa.kaya0798507', 'pmhernandez4', 'paras128', 'klc.mrt.1926', 'windl', 'rmartinez5', 'lerner', 'banoth.dinesh', 'furkan2072', 'fatihyorgun1996', 'sai.mrr', 'drhodges', 'simayozbay', 'erencanarslan70', 'choudhary_s', 'emregonen', 'murat.ozeee', 'anurag_kurle', 'emrecitakk', 'ardelarosa', 'yash.mh', 'furkan552senturk', 'shashi.sarraf', 'mehmettasdelen26', 'kanwat.pranav', 'cancetinkaya1201', 'saineeth', 'sflt317', 'ncmagra54', 'aileyvaa', 'mustafayigitesen', 'uzunnurdan', 'eliffsu.koc', 'halilalp', 'jessica.satyarthi', 'ensarerol26', 'klayydar', 'azazimalii', 'gurhankopcaz', 'jyothishjaggarapu225', 'anjaligawai', 'naveen143', 'abcd5454', 'kaanbjk27', 'erdicany', 'alikanadli7', 'serdememen', 'jessgomez100', 'tolga.ozyurt24', 'ozcanguclu', 'dhyanasivadas311', 'blassselva', 'wuizar99', 'ozcankutlu15', 'funsal', 'sabriyebayrakcinur', 'mumi1478', 'veyseleee123', 'kingkireeti', 'taol190799', 'emreyilmazel1996', 'rhamwey', 'evelyn.f1975', 'haticeterzibali', 'xavier160mg', 'berksaldr', 'njgarcia5', 'jayopp32', 'jarellano1204', 'muvafikmelikkaya', 'gullit0725', 'jasmine43.jp', 'mrgiraffe', 'irem.karagoz33', 'rebecasalcido', 'jatin.us', 'esuna006', 'haoliu', 'aayushik', 'emre.ibil', 'burakbeyazt', 'testeremre70', 'ezelbilgili', 'anilboran0671', 'bryang511', 'yamakonurcan', 'yorumhesabimsa', 'kodaar', 'carlosquinonez80', 'sai.ssm', 'zilmidegne', 'michaelpov', 'anand.satyam', 'berkc', 'selinyasaci98', 'orancagdas', 'ninad.ps', 'sonerkar', 'tugbakoyuncu99', 'yusmar', 'kaankuncak', 'ulises98', 'kagankilicaslan28', 'petersan901', 'yasinzgen']",145,"['kirollos.atef99', 'farid1010', 'mohamedsamir2591998', 'nohaabdelazeem11', 'ahmed_mohsen', 'hehaftw', 'daniel.', 'mmhanafy99', 'heshamelsedfy111', 'amr.m.araby', 'mai99mahdy', 'mobahr', 'michelhakim2001.mh', 'badryahmed33', 'zazotop31', 'mohamedelfeeky1', 'abdelrahman98', 'abdelrahmananwar', 'michaelhelal99', 'aminsalah287', 'mayanmohamed', 'omar_anwer', 'joker.man2000000', 'amy', 'sadboijalal', 'fayrouz21415', 'boules', 'nadakhaled', 'moh.nabil2050', 'mohamed248688', 'abdelmoneim404', 'nadeenmagdyy', 'sal7ien1999', 'romanynashaatmakeen', 'eyadafify', 'm.trika1999', 'ahmedyosre007', 'dodynn29', 'mohameda.younis80', 'mohamed_a_mostafa', 'amr.ghoname.teaching', 'ahmedsaeed', 'nada0abou0alsoud', 'af5012175', 'kerolosmfawzy', 'raneemgaber', 'seifahmedamer', 'raa199014', 'reemayman101', 'youssefessawy', 'esraayahia21', 'taha18499', 'ahmedkamal', 'amrksh3198', 'ramezakram97', 'mernaeshakfaheem', 'moataz12mokhtar', 'jualipa1995', 'metoyahia1999', 'hmsgsaad', 'yaseensalah83', 'nayeramakram98', 'ahmedokasha1999', 'mostafasaleh054', 'amartiger2020', 'tongmalual', 'melegy99', None, 'abdelrahman_oun', 'nourmahmoud', 'ranasherif244', 'mustafamahmoud567', 'mayaralmazy', 'bassant.ahmed235', 'hosamshaher43', 'cyrillemagdi', 'salmatarek87', 'ebrahim.almohandes', 'bassant.ahmed20118', 'ranaashraf129', 'medoshaban816', 'mohannadragab53', 'shadymagdy99', 'abdoulkh', 'seifelawadi26', 'btngana1', 'karim20103200', 'hosamabdallah00', 'ramymohsen', 'mayadamarie', 'omaraly112', 'engahmedsalahfathy', 'marwanahmad988', 'raniamuhamed44', 'sohamamdooh', 'yusufcheetos99', 'ziad.amr201666', 'adham99', 'generalshephrd', 'abdulrahman.hussien1999', 'josef.me22', 'mohamed.eid1014', 'harvovich', 'getray.ah', 'alaa15eltehewey', 'mohamed_98', 'ahmadatef580', 'abdallahhashim', 'youssefsamiryoussef', 'habiba.elkassas', 'haidy_emad', 'maged19991926', 'omarnabih21', 'mohamedhamdy1120000', 'mahmodfarag2000', 'yahiahamimi', 'ingyawad14', 'ahmed_omar', 'youssefhassaan99', 'ahmedmostafa5499', 'doraexplora', 'ashraf.amr82', 'nada.abomoslim', 'saca', 'mohamed.zna66', 'kareemmohamed68990', 'm_feky', 'mohamedsalah2', 'shrouk.a.emad', 'elsayedrafaat7', 'tomymoty1', 'abdoelanwar99', 'rehab.sayed1231999', 'rektxz', 'markashaf232', 'ashraf_mohamed', 'fasd556.om', 'maged.magdy666', 'mariam123456789', 'dina.23elessawy', 'nourhanne.bahaa', 'a.ayman74', 'michael29699', 'marwanyasser133', 'faridmohammed98']",353,"['mgk816', 'farid1010', 'mohamedsamir2591998', 'cmergil39', 'nohaabdelazeem11', 'dleon3', 'mtakcali', 'swarupadhyay777', 'mobahr', 'nsener45', 'joker632455', 'okanozkann95', 'badryahmed33', 'mohamedelfeeky1', 'murattdo', 'abdelrahman98', 'roy227', 'burak.baha00', 'aminsalah287', 'mayanmohamed', 'metobomm', 'enesdinler1', 'fayrouz21415', 'krishna.mp', 'jmoya5', 'mohamed248688', 'nadeenmagdyy', 'macolmenero', 'romanynashaatmakeen', 'bsanchez', 'venkitesh.s', 'eyadafify', 'nnurceylan95', 'm.trika1999', 'ahmedyosre007', 'arivera35', 'agmendez14', 'dodynn29', 'mohamed_a_mostafa', 'nada0abou0alsoud', 'ajortega6', 'mahmutcanki', 'af5012175', 'kerolosmfawzy', 'raneemgaber', 'mstff.1clkk', 'seifahmedamer', 'kumar_shubham', 'mmozcan4', 'raa199014', 'alibatuhanozturk', 'arif.ozkan5806', 'karpuz', 'reemayman101', 'youssefessawy', 'esraayahia21', 'taha18499', 'shrreya07', 'ahmedkamal', 'mseyfullahcelik', 'garciaje34454', 'kagangunes10', '1967hamzausta', 'goknur.derinoz', 'afurkanbudak42', 'amrksh3198', 'ufuk', 'diaz.carlos4499', 'moataz12mokhtar', 'jualipa1995', 'hmsgsaad', 'yaseensalah83', 'brs21', 'nikharv.19110125', 'fdominguez6', 'ahmedokasha1999', 'elembengisu', 'mmb', 'utkubala63', 'abdelrahman_oun', 'nourmahmoud', 'iremnurfiliz', 'dragon28540', 'elifindir', 'ranasherif244', 'sebastiangarcia695', 'mustafamahmoud567', 'mayaralmazy', 'bassant.ahmed235', 'salmatarek87', 'serhatiseri', 'shaawanalmutairi', 'aadelgado4', 'jagallegos7', 'altinbasnurcan09', 'bmendoza4', 'pongbrayan', 'medoshaban816', 'pmhernandez4', 'mohannadragab53', 'windl', 'rmartinez5', 'fatihyorgun1996', 'abdoulkh', 'seifelawadi26', 'btngana1', 'hosamabdallah00', 'ramymohsen', 'mayadamarie', 'erencanarslan70', 'choudhary_s', 'engahmedsalahfathy', 'emregonen', 'murat.ozeee', 'ardelarosa', 'sohamamdooh', 'yash.mh', 'yusufcheetos99', 'ziad.amr201666', 'adham99', 'furkan552senturk', 'josef.me22', 'kanwat.pranav', 'harvovich', 'ncmagra54', 'aileyvaa', 'getray.ah', 'uzunnurdan', 'jessica.satyarthi', 'mohamed_98', 'jyothishjaggarapu225', 'anjaligawai', 'haidy_emad', 'kaanbjk27', 'omarnabih21', 'mohamedhamdy1120000', 'alikanadli7', 'jessgomez100', 'tolga.ozyurt24', 'ingyawad14', 'ozcanguclu', 'dhyanasivadas311', 'blassselva', 'sabriyebayrakcinur', 'mumi1478', 'ahmed_omar', 'youssefhassaan99', 'rhamwey', 'evelyn.f1975', 'haticeterzibali', 'ahmedmostafa5499', 'doraexplora', 'ashraf.amr82', 'jarellano1204', 'nada.abomoslim', 'gullit0725', 'saca', 'kareemmohamed68990', 'irem.karagoz33', 'jatin.us', 'esuna006', 'mohamedsalah2', 'aayushik', 'burakbeyazt', 'tomymoty1', 'rehab.sayed1231999', 'ezelbilgili', 'anilboran0671', 'kodaar', 'ashraf_mohamed', 'carlosquinonez80', 'maged.magdy666', 'mariam123456789', 'sai.ssm', 'zilmidegne', 'anand.satyam', 'berkc', 'selinyasaci98', 'orancagdas', 'nourhanne.bahaa', 'a.ayman74', 'marwanyasser133', 'yusmar', 'kagankilicaslan28', 'kirollos.atef99', 'mcsonic', 'prosdocimi.m', 'ahmed_mohsen', 'hehaftw', 'daniel.', 'mmhanafy99', 'yunusyeo768', 'evren_aydin6', 'heshamelsedfy111', 'amr.m.araby', 'emreoney', 'mai99mahdy', 'mapayan5', 'esulekaplan', 'kenanke', 'fztrnetflix', 'ekin.gezer', 'ganesh25', 'michelhakim2001.mh', 'zazotop31', 'abdelrahmananwar', 'michaelhelal99', 'ezelbilgili42', 'youlianafouad17', 'joker.man2000000', 'omar_anwer', 'salvalenzuela12', 'amy', 'isma', 'sadboijalal', 'boules', 'almelnz2005', 'fjduran3', 'sarawaelahmed22', 'nadakhaled', 'moh.nabil2050', 'abdelmoneim404', 'ryckmonster', 'sal7ien1999', 'garfon61', 'furkan069906', 'w.edgarfamous', 'alex10', 'mohameda.younis80', 'amr.ghoname.teaching', 'ahmedsaeed', 'jozrik', 'omerdmrc16', 'bertansafak', 'zeynep', 'jadelira201', 'sigalam', 'blogan', 'esraboran71', 'chrisodomx', 'dmitry.stor', 'ramezakram97', 'mernaeshakfaheem', 'kemre9827', 'scopigno', 'metoyahia1999', 'ademfurkan', 'halilibrahimtiken', 'ege.ert7', 'nayeramakram98', 'havvafatmaozbay', 'sayed.aftabahmad786', 'gtzintzarov', 'mehmetaliyas1998', 'ceydabayrak581', 'dblancarte', 'ferhbk97', 'mostafasaleh054', 'amartiger2020', 'tongmalual', 'melegy99', None, 'mertisleyen96', 'koningmehmet', 'hosamshaher43', 'cyrillemagdi', 'ebrahim.almohandes', 'bassant.ahmed20118', 'ranaashraf129', 'druiz20', 'mustafa.kaya0798507', 'paras128', 'klc.mrt.1926', 'shadymagdy99', 'lerner', 'banoth.dinesh', 'furkan2072', 'drhodges', 'sai.mrr', 'simayozbay', 'karim20103200', 'omaraly112', 'marwanahmad988', 'anurag_kurle', 'emrecitakk', 'raniamuhamed44', 'generalshephrd', 'shashi.sarraf', 'mehmettasdelen26', 'abdulrahman.hussien1999', 'cancetinkaya1201', 'mohamed.eid1014', 'saineeth', 'sflt317', 'mustafayigitesen', 'alaa15eltehewey', 'eliffsu.koc', 'halilalp', 'ensarerol26', 'klayydar', 'azazimalii', 'ahmadatef580', 'abdallahhashim', 'youssefsamiryoussef', 'gurhankopcaz', 'habiba.elkassas', 'maged19991926', 'naveen143', 'abcd5454', 'erdicany', 'mahmodfarag2000', 'serdememen', 'yahiahamimi', 'wuizar99', 'ozcankutlu15', 'funsal', 'veyseleee123', 'kingkireeti', 'taol190799', 'emreyilmazel1996', 'xavier160mg', 'berksaldr', 'njgarcia5', 'jayopp32', 'muvafikmelikkaya', 'mohamed.zna66', 'jasmine43.jp', 'mrgiraffe', 'm_feky', 'rebecasalcido', 'haoliu', 'emre.ibil', 'shrouk.a.emad', 'testeremre70', 'elsayedrafaat7', 'abdoelanwar99', 'rektxz', 'bryang511', 'markashaf232', 'yamakonurcan', 'yorumhesabimsa', 'fasd556.om', 'dina.23elessawy', 'michaelpov', 'ninad.ps', 'sonerkar', 'michael29699', 'tugbakoyuncu99', 'kaankuncak', 'ulises98', 'petersan901', 'yasinzgen', 'faridmohammed98']"
3,394,209,56,47,"['jagallegos7', 'bmendoza4', 'druiz20', 'cmergil39', 'jessgomez100', 'pongbrayan', 'mcsonic', 'pmhernandez4', 'ajortega6', 'wuizar99', 'dleon3', 'rmartinez5', 'drhodges', 'mapayan5', 'jadelira201', 'evelyn.f1975', 'sigalam', 'blogan', 'njgarcia5', 'jarellano1204', 'garciaje34454', 'chrisodomx', 'ardelarosa', 'diaz.carlos4499', 'jasmine43.jp', 'roy227', 'rebecasalcido', 'salvalenzuela12', 'fdominguez6', 'isma', 'dblancarte', 'ferhbk97', 'almelnz2005', 'bryang511', 'jmoya5', 'aileyvaa', 'fjduran3', 'carlosquinonez80', 'macolmenero', 'bsanchez', 'klayydar', 'sebastiangarcia695', 'w.edgarfamous', 'agmendez14', 'arivera35', 'ulises98', 'petersan901']",161,"['mgk816', 'prosdocimi.m', 'yunusyeo768', 'evren_aydin6', 'mtakcali', 'emreoney', 'swarupadhyay777', 'esulekaplan', 'kenanke', 'fztrnetflix', 'nsener45', 'ekin.gezer', 'joker632455', 'ganesh25', 'okanozkann95', 'murattdo', 'ezelbilgili42', 'burak.baha00', 'youlianafouad17', 'metobomm', 'enesdinler1', 'krishna.mp', 'sarawaelahmed22', 'ryckmonster', 'venkitesh.s', 'garfon61', 'nnurceylan95', 'furkan069906', 'alex10', 'jozrik', 'omerdmrc16', 'bertansafak', 'mahmutcanki', 'zeynep', 'mstff.1clkk', 'kumar_shubham', 'mmozcan4', 'alibatuhanozturk', 'arif.ozkan5806', 'karpuz', 'shrreya07', 'esraboran71', 'mseyfullahcelik', 'dmitry.stor', 'kagangunes10', '1967hamzausta', 'goknur.derinoz', 'afurkanbudak42', 'ufuk', 'kemre9827', 'scopigno', 'brs21', 'nikharv.19110125', 'halilibrahimtiken', 'ege.ert7', 'ademfurkan', 'havvafatmaozbay', 'sayed.aftabahmad786', 'gtzintzarov', 'mehmetaliyas1998', 'ceydabayrak581', 'elembengisu', 'mmb', 'utkubala63', 'mertisleyen96', 'iremnurfiliz', 'dragon28540', 'elifindir', 'koningmehmet', 'serhatiseri', 'shaawanalmutairi', 'aadelgado4', 'altinbasnurcan09', 'mustafa.kaya0798507', 'paras128', 'klc.mrt.1926', 'windl', 'lerner', 'banoth.dinesh', 'furkan2072', 'fatihyorgun1996', 'sai.mrr', 'simayozbay', 'erencanarslan70', 'choudhary_s', 'emregonen', 'murat.ozeee', 'anurag_kurle', 'emrecitakk', 'yash.mh', 'furkan552senturk', 'shashi.sarraf', 'mehmettasdelen26', 'kanwat.pranav', 'cancetinkaya1201', 'saineeth', 'sflt317', 'ncmagra54', 'mustafayigitesen', 'uzunnurdan', 'eliffsu.koc', 'halilalp', 'jessica.satyarthi', 'ensarerol26', 'azazimalii', 'gurhankopcaz', 'jyothishjaggarapu225', 'anjaligawai', 'naveen143', 'abcd5454', 'kaanbjk27', 'erdicany', 'alikanadli7', 'serdememen', 'tolga.ozyurt24', 'ozcanguclu', 'dhyanasivadas311', 'blassselva', 'ozcankutlu15', 'funsal', 'sabriyebayrakcinur', 'mumi1478', 'veyseleee123', 'kingkireeti', 'taol190799', 'emreyilmazel1996', 'rhamwey', 'xavier160mg', 'haticeterzibali', 'berksaldr', 'jayopp32', 'muvafikmelikkaya', 'gullit0725', 'mrgiraffe', 'irem.karagoz33', 'jatin.us', 'esuna006', 'haoliu', 'aayushik', 'emre.ibil', 'burakbeyazt', 'testeremre70', 'ezelbilgili', 'anilboran0671', 'yamakonurcan', 'yorumhesabimsa', 'kodaar', 'sai.ssm', 'zilmidegne', 'michaelpov', 'anand.satyam', 'berkc', 'selinyasaci98', 'orancagdas', 'ninad.ps', 'sonerkar', 'tugbakoyuncu99', 'yusmar', 'kaankuncak', 'kagankilicaslan28', 'yasinzgen']",9,"['espejodaniel6', 'gfacio2011', 'acastro34', 'recaro13', 'alvarez5', 'achaid03', 'christianc2', None, 'jfmuller']",217,"['mgk816', 'cmergil39', 'mcsonic', 'prosdocimi.m', 'espejodaniel6', 'dleon3', 'yunusyeo768', 'evren_aydin6', 'mtakcali', 'emreoney', 'mapayan5', 'swarupadhyay777', 'esulekaplan', 'kenanke', 'fztrnetflix', 'nsener45', 'ekin.gezer', 'joker632455', 'ganesh25', 'okanozkann95', 'murattdo', 'roy227', 'ezelbilgili42', 'burak.baha00', 'youlianafouad17', 'salvalenzuela12', 'isma', 'metobomm', 'enesdinler1', 'krishna.mp', 'jmoya5', 'almelnz2005', 'fjduran3', 'sarawaelahmed22', 'ryckmonster', 'macolmenero', 'bsanchez', 'venkitesh.s', 'garfon61', 'nnurceylan95', 'w.edgarfamous', 'furkan069906', 'arivera35', 'agmendez14', 'alvarez5', 'alex10', 'jozrik', 'omerdmrc16', 'bertansafak', 'ajortega6', 'zeynep', 'mahmutcanki', 'mstff.1clkk', 'kumar_shubham', 'mmozcan4', 'alibatuhanozturk', 'jadelira201', 'arif.ozkan5806', 'karpuz', 'sigalam', 'shrreya07', 'blogan', 'esraboran71', 'mseyfullahcelik', 'chrisodomx', 'kagangunes10', '1967hamzausta', 'dmitry.stor', 'goknur.derinoz', 'garciaje34454', 'afurkanbudak42', 'ufuk', 'diaz.carlos4499', 'kemre9827', 'recaro13', 'scopigno', 'brs21', 'nikharv.19110125', 'halilibrahimtiken', 'ege.ert7', 'fdominguez6', 'ademfurkan', 'havvafatmaozbay', 'gfacio2011', 'sayed.aftabahmad786', 'gtzintzarov', 'mehmetaliyas1998', 'ceydabayrak581', 'elembengisu', 'ferhbk97', 'dblancarte', 'mmb', 'utkubala63', None, 'mertisleyen96', 'jfmuller', 'iremnurfiliz', 'dragon28540', 'elifindir', 'sebastiangarcia695', 'koningmehmet', 'serhatiseri', 'shaawanalmutairi', 'aadelgado4', 'jagallegos7', 'altinbasnurcan09', 'druiz20', 'pongbrayan', 'bmendoza4', 'mustafa.kaya0798507', 'pmhernandez4', 'paras128', 'klc.mrt.1926', 'windl', 'rmartinez5', 'lerner', 'banoth.dinesh', 'furkan2072', 'fatihyorgun1996', 'sai.mrr', 'drhodges', 'simayozbay', 'erencanarslan70', 'choudhary_s', 'emregonen', 'murat.ozeee', 'anurag_kurle', 'emrecitakk', 'ardelarosa', 'yash.mh', 'furkan552senturk', 'acastro34', 'shashi.sarraf', 'mehmettasdelen26', 'kanwat.pranav', 'cancetinkaya1201', 'saineeth', 'sflt317', 'achaid03', 'ncmagra54', 'aileyvaa', 'mustafayigitesen', 'uzunnurdan', 'eliffsu.koc', 'halilalp', 'jessica.satyarthi', 'ensarerol26', 'klayydar', 'azazimalii', 'gurhankopcaz', 'jyothishjaggarapu225', 'anjaligawai', 'naveen143', 'abcd5454', 'kaanbjk27', 'erdicany', 'alikanadli7', 'serdememen', 'jessgomez100', 'tolga.ozyurt24', 'ozcanguclu', 'dhyanasivadas311', 'blassselva', 'wuizar99', 'ozcankutlu15', 'funsal', 'sabriyebayrakcinur', 'mumi1478', 'veyseleee123', 'kingkireeti', 'taol190799', 'emreyilmazel1996', 'rhamwey', 'evelyn.f1975', 'haticeterzibali', 'xavier160mg', 'berksaldr', 'njgarcia5', 'jayopp32', 'jarellano1204', 'muvafikmelikkaya', 'gullit0725', 'jasmine43.jp', 'mrgiraffe', 'irem.karagoz33', 'rebecasalcido', 'jatin.us', 'esuna006', 'haoliu', 'aayushik', 'emre.ibil', 'burakbeyazt', 'testeremre70', 'ezelbilgili', 'anilboran0671', 'bryang511', 'yamakonurcan', 'christianc2', 'yorumhesabimsa', 'kodaar', 'carlosquinonez80', 'sai.ssm', 'zilmidegne', 'michaelpov', 'anand.satyam', 'berkc', 'selinyasaci98', 'orancagdas', 'ninad.ps', 'sonerkar', 'tugbakoyuncu99', 'yusmar', 'kaankuncak', 'ulises98', 'kagankilicaslan28', 'petersan901', 'yasinzgen']"
3,398,209,43,1,['youlianafouad17'],207,"['mgk816', 'cmergil39', 'mcsonic', 'prosdocimi.m', 'dleon3', 'yunusyeo768', 'evren_aydin6', 'mtakcali', 'emreoney', 'mapayan5', 'swarupadhyay777', 'esulekaplan', 'kenanke', 'fztrnetflix', 'nsener45', 'ekin.gezer', 'joker632455', 'ganesh25', 'okanozkann95', 'murattdo', 'roy227', 'ezelbilgili42', 'burak.baha00', 'salvalenzuela12', 'isma', 'metobomm', 'enesdinler1', 'krishna.mp', 'jmoya5', 'almelnz2005', 'fjduran3', 'sarawaelahmed22', 'ryckmonster', 'macolmenero', 'bsanchez', 'venkitesh.s', 'garfon61', 'nnurceylan95', 'w.edgarfamous', 'furkan069906', 'arivera35', 'agmendez14', 'alex10', 'jozrik', 'omerdmrc16', 'bertansafak', 'ajortega6', 'zeynep', 'mahmutcanki', 'mstff.1clkk', 'kumar_shubham', 'mmozcan4', 'alibatuhanozturk', 'jadelira201', 'arif.ozkan5806', 'karpuz', 'sigalam', 'shrreya07', 'blogan', 'esraboran71', 'mseyfullahcelik', 'chrisodomx', 'kagangunes10', '1967hamzausta', 'dmitry.stor', 'goknur.derinoz', 'garciaje34454', 'afurkanbudak42', 'ufuk', 'diaz.carlos4499', 'kemre9827', 'scopigno', 'brs21', 'nikharv.19110125', 'halilibrahimtiken', 'ege.ert7', 'fdominguez6', 'ademfurkan', 'havvafatmaozbay', 'sayed.aftabahmad786', 'gtzintzarov', 'mehmetaliyas1998', 'ceydabayrak581', 'elembengisu', 'ferhbk97', 'dblancarte', 'mmb', 'utkubala63', 'mertisleyen96', 'iremnurfiliz', 'dragon28540', 'elifindir', 'sebastiangarcia695', 'koningmehmet', 'serhatiseri', 'shaawanalmutairi', 'aadelgado4', 'jagallegos7', 'altinbasnurcan09', 'druiz20', 'pongbrayan', 'bmendoza4', 'mustafa.kaya0798507', 'pmhernandez4', 'paras128', 'klc.mrt.1926', 'windl', 'rmartinez5', 'lerner', 'banoth.dinesh', 'furkan2072', 'fatihyorgun1996', 'sai.mrr', 'drhodges', 'simayozbay', 'erencanarslan70', 'choudhary_s', 'emregonen', 'murat.ozeee', 'anurag_kurle', 'emrecitakk', 'ardelarosa', 'yash.mh', 'furkan552senturk', 'shashi.sarraf', 'mehmettasdelen26', 'kanwat.pranav', 'cancetinkaya1201', 'saineeth', 'sflt317', 'ncmagra54', 'aileyvaa', 'mustafayigitesen', 'uzunnurdan', 'eliffsu.koc', 'halilalp', 'jessica.satyarthi', 'ensarerol26', 'klayydar', 'azazimalii', 'gurhankopcaz', 'jyothishjaggarapu225', 'anjaligawai', 'naveen143', 'abcd5454', 'kaanbjk27', 'erdicany', 'alikanadli7', 'serdememen', 'jessgomez100', 'tolga.ozyurt24', 'ozcanguclu', 'dhyanasivadas311', 'blassselva', 'wuizar99', 'ozcankutlu15', 'funsal', 'sabriyebayrakcinur', 'mumi1478', 'veyseleee123', 'kingkireeti', 'taol190799', 'emreyilmazel1996', 'rhamwey', 'evelyn.f1975', 'haticeterzibali', 'xavier160mg', 'berksaldr', 'njgarcia5', 'jayopp32', 'jarellano1204', 'muvafikmelikkaya', 'gullit0725', 'jasmine43.jp', 'mrgiraffe', 'irem.karagoz33', 'rebecasalcido', 'jatin.us', 'esuna006', 'haoliu', 'aayushik', 'emre.ibil', 'burakbeyazt', 'testeremre70', 'ezelbilgili', 'anilboran0671', 'bryang511', 'yamakonurcan', 'yorumhesabimsa', 'kodaar', 'carlosquinonez80', 'sai.ssm', 'zilmidegne', 'michaelpov', 'anand.satyam', 'berkc', 'selinyasaci98', 'orancagdas', 'ninad.ps', 'sonerkar', 'tugbakoyuncu99', 'yusmar', 'kaankuncak', 'ulises98', 'kagankilicaslan28', 'petersan901', 'yasinzgen']",42,"['ranaashraf129', 'mohamedsamir2591998', 'medoshaban816', 'nohaabdelazeem11', 'ahmedsamy888844', 'heshamelsedfy111', 'seifahmedamer', 'ahmedhamdyhalawa', 'mai99mahdy', 'ramymohsen', 'ahhamed93', 'midoayman248', 'yumna.ghoneim', 'reemayman101', 'ronaldo2391999', 'mennamohamedhanafy392', 'ahmedmamin', 'moataz12mokhtar', 'karimtarek', 'sondossalah66', 'kareemk08', 'mohamedsalah2', 'mostafa.maher591999', 'ahmedokasha1999', 'abdooo', 'mostafasaleh054', 'mohmedshimaa25', 'rektxz', 'youssefelrouby4', None, 'mohamed248688', 'ashraf_mohamed', 'ahmed.khaled.201420', 'seif8128', 'ahmadatef580', 'm.trika1999', 'a.ayman74', 'maged19991926', 'mohamedhamdy1120000', 'mahmoud.maree2010', 'mohamed_hesham', 'muhmedsalahm']",250,"['mgk816', 'mohamedsamir2591998', 'cmergil39', 'nohaabdelazeem11', 'mcsonic', 'prosdocimi.m', 'dleon3', 'yunusyeo768', 'evren_aydin6', 'heshamelsedfy111', 'mtakcali', 'emreoney', 'mahmoud.maree2010', 'mai99mahdy', 'mapayan5', 'swarupadhyay777', 'esulekaplan', 'kenanke', 'fztrnetflix', 'nsener45', 'ekin.gezer', 'joker632455', 'ganesh25', 'okanozkann95', 'murattdo', 'roy227', 'ezelbilgili42', 'mennamohamedhanafy392', 'burak.baha00', 'youlianafouad17', 'mostafa.maher591999', 'salvalenzuela12', 'kareemk08', 'isma', 'metobomm', 'enesdinler1', 'krishna.mp', 'jmoya5', 'almelnz2005', 'fjduran3', 'sarawaelahmed22', 'mohamed248688', 'ryckmonster', 'macolmenero', 'bsanchez', 'venkitesh.s', 'garfon61', 'nnurceylan95', 'w.edgarfamous', 'furkan069906', 'm.trika1999', 'arivera35', 'agmendez14', 'alex10', 'jozrik', 'omerdmrc16', 'bertansafak', 'ajortega6', 'zeynep', 'mahmutcanki', 'mstff.1clkk', 'seifahmedamer', 'kumar_shubham', 'mmozcan4', 'alibatuhanozturk', 'jadelira201', 'arif.ozkan5806', 'karpuz', 'midoayman248', 'yumna.ghoneim', 'reemayman101', 'sigalam', 'shrreya07', 'blogan', 'esraboran71', 'mseyfullahcelik', 'chrisodomx', 'kagangunes10', '1967hamzausta', 'dmitry.stor', 'goknur.derinoz', 'garciaje34454', 'afurkanbudak42', 'ufuk', 'diaz.carlos4499', 'kemre9827', 'scopigno', 'moataz12mokhtar', 'karimtarek', 'sondossalah66', 'brs21', 'nikharv.19110125', 'halilibrahimtiken', 'ege.ert7', 'fdominguez6', 'ademfurkan', 'havvafatmaozbay', 'ahmedokasha1999', 'sayed.aftabahmad786', 'gtzintzarov', 'mehmetaliyas1998', 'ceydabayrak581', 'elembengisu', 'ferhbk97', 'dblancarte', 'mmb', 'mostafasaleh054', 'utkubala63', 'youssefelrouby4', 'mertisleyen96', None, 'iremnurfiliz', 'dragon28540', 'elifindir', 'sebastiangarcia695', 'koningmehmet', 'serhatiseri', 'shaawanalmutairi', 'aadelgado4', 'jagallegos7', 'altinbasnurcan09', 'druiz20', 'pongbrayan', 'bmendoza4', 'mustafa.kaya0798507', 'ranaashraf129', 'pmhernandez4', 'medoshaban816', 'paras128', 'klc.mrt.1926', 'ahmedsamy888844', 'windl', 'rmartinez5', 'lerner', 'banoth.dinesh', 'furkan2072', 'fatihyorgun1996', 'sai.mrr', 'drhodges', 'simayozbay', 'ahmedhamdyhalawa', 'ramymohsen', 'ahhamed93', 'erencanarslan70', 'choudhary_s', 'ronaldo2391999', 'emregonen', 'murat.ozeee', 'anurag_kurle', 'emrecitakk', 'ardelarosa', 'yash.mh', 'ahmedmamin', 'furkan552senturk', 'shashi.sarraf', 'mehmettasdelen26', 'kanwat.pranav', 'cancetinkaya1201', 'saineeth', 'sflt317', 'ncmagra54', 'aileyvaa', 'mustafayigitesen', 'uzunnurdan', 'eliffsu.koc', 'halilalp', 'jessica.satyarthi', 'seif8128', 'ensarerol26', 'klayydar', 'azazimalii', 'ahmadatef580', 'gurhankopcaz', 'jyothishjaggarapu225', 'anjaligawai', 'naveen143', 'abcd5454', 'maged19991926', 'kaanbjk27', 'mohamedhamdy1120000', 'erdicany', 'alikanadli7', 'muhmedsalahm', 'serdememen', 'jessgomez100', 'tolga.ozyurt24', 'ozcanguclu', 'dhyanasivadas311', 'blassselva', 'wuizar99', 'ozcankutlu15', 'funsal', 'sabriyebayrakcinur', 'mumi1478', 'veyseleee123', 'kingkireeti', 'taol190799', 'emreyilmazel1996', 'rhamwey', 'evelyn.f1975', 'haticeterzibali', 'xavier160mg', 'berksaldr', 'njgarcia5', 'jayopp32', 'jarellano1204', 'muvafikmelikkaya', 'gullit0725', 'jasmine43.jp', 'mrgiraffe', 'irem.karagoz33', 'rebecasalcido', 'jatin.us', 'esuna006', 'mohamedsalah2', 'haoliu', 'aayushik', 'emre.ibil', 'burakbeyazt', 'testeremre70', 'abdooo', 'mohmedshimaa25', 'ezelbilgili', 'anilboran0671', 'bryang511', 'rektxz', 'yamakonurcan', 'yorumhesabimsa', 'kodaar', 'ashraf_mohamed', 'carlosquinonez80', 'sai.ssm', 'zilmidegne', 'michaelpov', 'anand.satyam', 'berkc', 'selinyasaci98', 'ahmed.khaled.201420', 'orancagdas', 'ninad.ps', 'sonerkar', 'a.ayman74', 'tugbakoyuncu99', 'yusmar', 'kaankuncak', 'ulises98', 'kagankilicaslan28', 'mohamed_hesham', 'petersan901', 'yasinzgen']"
3,389,209,42,29,"['mgk816', 'tolga.ozyurt24', 'alikanadli7', 'ozcankutlu15', 'veyseleee123', 'fatihyorgun1996', 'emreyilmazel1996', 'arif.ozkan5806', 'berksaldr', 'haticeterzibali', 'joker632455', 'okanozkann95', 'murat.ozeee', 'goknur.derinoz', 'burak.baha00', 'esuna006', 'ademfurkan', 'ege.ert7', 'anilboran0671', 'sflt317', 'yorumhesabimsa', 'utkubala63', 'zilmidegne', 'elifindir', 'furkan069906', 'koningmehmet', 'sonerkar', 'alex10', 'kagankilicaslan28']",179,"['cmergil39', 'mcsonic', 'prosdocimi.m', 'dleon3', 'yunusyeo768', 'evren_aydin6', 'mtakcali', 'emreoney', 'mapayan5', 'swarupadhyay777', 'esulekaplan', 'kenanke', 'fztrnetflix', 'nsener45', 'ekin.gezer', 'ganesh25', 'murattdo', 'roy227', 'ezelbilgili42', 'youlianafouad17', 'salvalenzuela12', 'isma', 'metobomm', 'enesdinler1', 'krishna.mp', 'jmoya5', 'almelnz2005', 'fjduran3', 'sarawaelahmed22', 'ryckmonster', 'macolmenero', 'bsanchez', 'venkitesh.s', 'garfon61', 'nnurceylan95', 'w.edgarfamous', 'arivera35', 'agmendez14', 'jozrik', 'omerdmrc16', 'bertansafak', 'ajortega6', 'zeynep', 'mahmutcanki', 'mstff.1clkk', 'kumar_shubham', 'mmozcan4', 'alibatuhanozturk', 'jadelira201', 'karpuz', 'sigalam', 'shrreya07', 'blogan', 'esraboran71', 'mseyfullahcelik', 'chrisodomx', 'kagangunes10', '1967hamzausta', 'dmitry.stor', 'garciaje34454', 'afurkanbudak42', 'ufuk', 'diaz.carlos4499', 'kemre9827', 'scopigno', 'brs21', 'nikharv.19110125', 'halilibrahimtiken', 'fdominguez6', 'havvafatmaozbay', 'sayed.aftabahmad786', 'gtzintzarov', 'mehmetaliyas1998', 'ceydabayrak581', 'elembengisu', 'ferhbk97', 'dblancarte', 'mmb', 'mertisleyen96', 'iremnurfiliz', 'dragon28540', 'sebastiangarcia695', 'serhatiseri', 'shaawanalmutairi', 'aadelgado4', 'jagallegos7', 'altinbasnurcan09', 'druiz20', 'pongbrayan', 'bmendoza4', 'mustafa.kaya0798507', 'pmhernandez4', 'paras128', 'klc.mrt.1926', 'windl', 'rmartinez5', 'lerner', 'banoth.dinesh', 'furkan2072', 'sai.mrr', 'drhodges', 'simayozbay', 'erencanarslan70', 'choudhary_s', 'emregonen', 'anurag_kurle', 'emrecitakk', 'ardelarosa', 'yash.mh', 'furkan552senturk', 'shashi.sarraf', 'mehmettasdelen26', 'kanwat.pranav', 'cancetinkaya1201', 'saineeth', 'ncmagra54', 'aileyvaa', 'mustafayigitesen', 'uzunnurdan', 'eliffsu.koc', 'halilalp', 'jessica.satyarthi', 'ensarerol26', 'klayydar', 'azazimalii', 'gurhankopcaz', 'jyothishjaggarapu225', 'anjaligawai', 'naveen143', 'abcd5454', 'kaanbjk27', 'erdicany', 'serdememen', 'jessgomez100', 'ozcanguclu', 'dhyanasivadas311', 'blassselva', 'wuizar99', 'funsal', 'sabriyebayrakcinur', 'mumi1478', 'kingkireeti', 'taol190799', 'rhamwey', 'evelyn.f1975', 'xavier160mg', 'njgarcia5', 'jayopp32', 'jarellano1204', 'muvafikmelikkaya', 'gullit0725', 'jasmine43.jp', 'mrgiraffe', 'irem.karagoz33', 'rebecasalcido', 'jatin.us', 'haoliu', 'aayushik', 'emre.ibil', 'burakbeyazt', 'testeremre70', 'ezelbilgili', 'bryang511', 'yamakonurcan', 'kodaar', 'carlosquinonez80', 'sai.ssm', 'michaelpov', 'anand.satyam', 'berkc', 'selinyasaci98', 'orancagdas', 'ninad.ps', 'tugbakoyuncu99', 'yusmar', 'kaankuncak', 'ulises98', 'petersan901', 'yasinzgen']",13,"['muhammet.korkmaz29', 'ardaulusan_14', 'batu.oztrkk', 'kizilinozlem', 'svlksknsms', 'oknky', 'liswfa123', 'cdogukan09', 'tapur500', 'cansecgin', None, 'salcaburak', 'atkncvkkl1']",221,"['mgk816', 'ardaulusan_14', 'cmergil39', 'mcsonic', 'prosdocimi.m', 'dleon3', 'yunusyeo768', 'evren_aydin6', 'mtakcali', 'emreoney', 'mapayan5', 'swarupadhyay777', 'esulekaplan', 'kenanke', 'fztrnetflix', 'nsener45', 'ekin.gezer', 'joker632455', 'ganesh25', 'okanozkann95', 'murattdo', 'roy227', 'ezelbilgili42', 'burak.baha00', 'youlianafouad17', 'salvalenzuela12', 'isma', 'metobomm', 'enesdinler1', 'krishna.mp', 'jmoya5', 'almelnz2005', 'fjduran3', 'sarawaelahmed22', 'atkncvkkl1', 'batu.oztrkk', 'ryckmonster', 'macolmenero', 'bsanchez', 'venkitesh.s', 'garfon61', 'nnurceylan95', 'w.edgarfamous', 'furkan069906', 'arivera35', 'agmendez14', 'alex10', 'jozrik', 'omerdmrc16', 'bertansafak', 'ajortega6', 'zeynep', 'mahmutcanki', 'mstff.1clkk', 'kumar_shubham', 'mmozcan4', 'alibatuhanozturk', 'jadelira201', 'arif.ozkan5806', 'karpuz', 'salcaburak', 'kizilinozlem', 'sigalam', 'shrreya07', 'blogan', 'esraboran71', 'svlksknsms', 'mseyfullahcelik', 'chrisodomx', 'kagangunes10', '1967hamzausta', 'dmitry.stor', 'goknur.derinoz', 'garciaje34454', 'afurkanbudak42', 'ufuk', 'diaz.carlos4499', 'kemre9827', 'scopigno', 'brs21', 'nikharv.19110125', 'halilibrahimtiken', 'ege.ert7', 'fdominguez6', 'ademfurkan', 'havvafatmaozbay', 'sayed.aftabahmad786', 'gtzintzarov', 'mehmetaliyas1998', 'ceydabayrak581', 'elembengisu', 'ferhbk97', 'dblancarte', 'mmb', 'utkubala63', None, 'mertisleyen96', 'iremnurfiliz', 'dragon28540', 'elifindir', 'sebastiangarcia695', 'koningmehmet', 'serhatiseri', 'tapur500', 'shaawanalmutairi', 'aadelgado4', 'jagallegos7', 'altinbasnurcan09', 'druiz20', 'pongbrayan', 'bmendoza4', 'mustafa.kaya0798507', 'pmhernandez4', 'paras128', 'klc.mrt.1926', 'windl', 'rmartinez5', 'lerner', 'banoth.dinesh', 'furkan2072', 'fatihyorgun1996', 'sai.mrr', 'drhodges', 'simayozbay', 'erencanarslan70', 'choudhary_s', 'emregonen', 'murat.ozeee', 'anurag_kurle', 'emrecitakk', 'ardelarosa', 'yash.mh', 'muhammet.korkmaz29', 'furkan552senturk', 'oknky', 'shashi.sarraf', 'mehmettasdelen26', 'kanwat.pranav', 'cancetinkaya1201', 'saineeth', 'sflt317', 'ncmagra54', 'aileyvaa', 'mustafayigitesen', 'uzunnurdan', 'eliffsu.koc', 'halilalp', 'jessica.satyarthi', 'ensarerol26', 'klayydar', 'azazimalii', 'liswfa123', 'gurhankopcaz', 'jyothishjaggarapu225', 'anjaligawai', 'naveen143', 'abcd5454', 'kaanbjk27', 'erdicany', 'alikanadli7', 'serdememen', 'jessgomez100', 'tolga.ozyurt24', 'ozcanguclu', 'dhyanasivadas311', 'blassselva', 'wuizar99', 'ozcankutlu15', 'funsal', 'sabriyebayrakcinur', 'mumi1478', 'veyseleee123', 'kingkireeti', 'taol190799', 'emreyilmazel1996', 'rhamwey', 'evelyn.f1975', 'haticeterzibali', 'xavier160mg', 'berksaldr', 'njgarcia5', 'jayopp32', 'jarellano1204', 'muvafikmelikkaya', 'gullit0725', 'cdogukan09', 'jasmine43.jp', 'mrgiraffe', 'cansecgin', 'irem.karagoz33', 'rebecasalcido', 'jatin.us', 'esuna006', 'haoliu', 'aayushik', 'emre.ibil', 'burakbeyazt', 'testeremre70', 'ezelbilgili', 'anilboran0671', 'bryang511', 'yamakonurcan', 'yorumhesabimsa', 'kodaar', 'carlosquinonez80', 'sai.ssm', 'zilmidegne', 'michaelpov', 'anand.satyam', 'berkc', 'selinyasaci98', 'orancagdas', 'ninad.ps', 'sonerkar', 'tugbakoyuncu99', 'yusmar', 'kaankuncak', 'ulises98', 'kagankilicaslan28', 'petersan901', 'yasinzgen']"
3,388,209,37,22,"['ozcanguclu', 'sabriyebayrakcinur', 'yunusyeo768', 'mtakcali', 'lerner', 'taol190799', 'alibatuhanozturk', 'esulekaplan', 'fztrnetflix', 'nsener45', 'emregonen', 'murattdo', 'mrgiraffe', 'furkan552senturk', 'emre.ibil', 'mehmettasdelen26', 'cancetinkaya1201', 'mustafayigitesen', 'iremnurfiliz', 'ensarerol26', 'garfon61', 'tugbakoyuncu99']",186,"['mgk816', 'cmergil39', 'mcsonic', 'prosdocimi.m', 'dleon3', 'evren_aydin6', 'emreoney', 'mapayan5', 'swarupadhyay777', 'kenanke', 'ekin.gezer', 'joker632455', 'ganesh25', 'okanozkann95', 'roy227', 'ezelbilgili42', 'burak.baha00', 'youlianafouad17', 'salvalenzuela12', 'isma', 'metobomm', 'enesdinler1', 'krishna.mp', 'jmoya5', 'almelnz2005', 'fjduran3', 'sarawaelahmed22', 'ryckmonster', 'macolmenero', 'bsanchez', 'venkitesh.s', 'nnurceylan95', 'w.edgarfamous', 'furkan069906', 'arivera35', 'agmendez14', 'alex10', 'jozrik', 'omerdmrc16', 'bertansafak', 'ajortega6', 'zeynep', 'mahmutcanki', 'mstff.1clkk', 'kumar_shubham', 'mmozcan4', 'jadelira201', 'arif.ozkan5806', 'karpuz', 'sigalam', 'shrreya07', 'blogan', 'esraboran71', 'mseyfullahcelik', 'chrisodomx', 'kagangunes10', '1967hamzausta', 'dmitry.stor', 'goknur.derinoz', 'garciaje34454', 'afurkanbudak42', 'ufuk', 'diaz.carlos4499', 'kemre9827', 'scopigno', 'brs21', 'nikharv.19110125', 'halilibrahimtiken', 'ege.ert7', 'fdominguez6', 'ademfurkan', 'havvafatmaozbay', 'sayed.aftabahmad786', 'gtzintzarov', 'mehmetaliyas1998', 'ceydabayrak581', 'elembengisu', 'ferhbk97', 'dblancarte', 'mmb', 'utkubala63', 'mertisleyen96', 'dragon28540', 'elifindir', 'sebastiangarcia695', 'koningmehmet', 'serhatiseri', 'shaawanalmutairi', 'aadelgado4', 'jagallegos7', 'altinbasnurcan09', 'druiz20', 'pongbrayan', 'bmendoza4', 'mustafa.kaya0798507', 'pmhernandez4', 'paras128', 'klc.mrt.1926', 'windl', 'rmartinez5', 'banoth.dinesh', 'furkan2072', 'fatihyorgun1996', 'sai.mrr', 'drhodges', 'simayozbay', 'erencanarslan70', 'choudhary_s', 'murat.ozeee', 'anurag_kurle', 'emrecitakk', 'ardelarosa', 'yash.mh', 'shashi.sarraf', 'kanwat.pranav', 'saineeth', 'sflt317', 'ncmagra54', 'aileyvaa', 'uzunnurdan', 'eliffsu.koc', 'halilalp', 'jessica.satyarthi', 'klayydar', 'azazimalii', 'gurhankopcaz', 'jyothishjaggarapu225', 'anjaligawai', 'naveen143', 'abcd5454', 'kaanbjk27', 'erdicany', 'alikanadli7', 'serdememen', 'jessgomez100', 'tolga.ozyurt24', 'dhyanasivadas311', 'blassselva', 'wuizar99', 'ozcankutlu15', 'funsal', 'mumi1478', 'veyseleee123', 'kingkireeti', 'emreyilmazel1996', 'rhamwey', 'evelyn.f1975', 'haticeterzibali', 'xavier160mg', 'berksaldr', 'njgarcia5', 'jayopp32', 'jarellano1204', 'muvafikmelikkaya', 'gullit0725', 'jasmine43.jp', 'irem.karagoz33', 'rebecasalcido', 'jatin.us', 'esuna006', 'haoliu', 'aayushik', 'burakbeyazt', 'testeremre70', 'ezelbilgili', 'anilboran0671', 'bryang511', 'yamakonurcan', 'yorumhesabimsa', 'kodaar', 'carlosquinonez80', 'sai.ssm', 'zilmidegne', 'michaelpov', 'anand.satyam', 'berkc', 'selinyasaci98', 'orancagdas', 'ninad.ps', 'sonerkar', 'yusmar', 'kaankuncak', 'ulises98', 'kagankilicaslan28', 'petersan901', 'yasinzgen']",15,"[None, 'corezyadigar26', 'kemal1188', 'emircansimsek', 'bayramdonmez96', 'buseduygut', 'behlul', 'kappa123', 'kurafcskn', 'afkali.120', 'raistlin1923', 'trkmengkay', 'alpdogann061', 'dumpnit', 'keryfly']",223,"['mgk816', 'cmergil39', 'corezyadigar26', 'mcsonic', 'prosdocimi.m', 'dleon3', 'yunusyeo768', 'evren_aydin6', 'mtakcali', 'emreoney', 'mapayan5', 'swarupadhyay777', 'esulekaplan', 'kenanke', 'fztrnetflix', 'nsener45', 'ekin.gezer', 'joker632455', 'ganesh25', 'okanozkann95', 'murattdo', 'kurafcskn', 'roy227', 'ezelbilgili42', 'burak.baha00', 'youlianafouad17', 'salvalenzuela12', 'isma', 'metobomm', 'enesdinler1', 'krishna.mp', 'behlul', 'jmoya5', 'almelnz2005', 'fjduran3', 'sarawaelahmed22', 'alpdogann061', 'ryckmonster', 'macolmenero', 'bsanchez', 'venkitesh.s', 'garfon61', 'nnurceylan95', 'w.edgarfamous', 'furkan069906', 'arivera35', 'agmendez14', 'trkmengkay', 'alex10', 'jozrik', 'kemal1188', 'omerdmrc16', 'bertansafak', 'ajortega6', 'zeynep', 'mahmutcanki', 'bayramdonmez96', 'mstff.1clkk', 'kumar_shubham', 'mmozcan4', 'alibatuhanozturk', 'jadelira201', 'arif.ozkan5806', 'karpuz', 'sigalam', 'shrreya07', 'blogan', 'esraboran71', 'buseduygut', 'mseyfullahcelik', 'chrisodomx', 'kagangunes10', '1967hamzausta', 'dmitry.stor', 'goknur.derinoz', 'garciaje34454', 'afurkanbudak42', 'ufuk', 'diaz.carlos4499', 'kemre9827', 'scopigno', 'brs21', 'nikharv.19110125', 'halilibrahimtiken', 'ege.ert7', 'fdominguez6', 'ademfurkan', 'havvafatmaozbay', 'sayed.aftabahmad786', 'gtzintzarov', 'mehmetaliyas1998', 'ceydabayrak581', 'elembengisu', 'ferhbk97', 'dblancarte', 'mmb', 'utkubala63', None, 'mertisleyen96', 'iremnurfiliz', 'dragon28540', 'elifindir', 'sebastiangarcia695', 'koningmehmet', 'serhatiseri', 'shaawanalmutairi', 'keryfly', 'aadelgado4', 'jagallegos7', 'altinbasnurcan09', 'druiz20', 'pongbrayan', 'bmendoza4', 'mustafa.kaya0798507', 'pmhernandez4', 'paras128', 'klc.mrt.1926', 'windl', 'rmartinez5', 'lerner', 'banoth.dinesh', 'furkan2072', 'fatihyorgun1996', 'sai.mrr', 'drhodges', 'simayozbay', 'erencanarslan70', 'choudhary_s', 'emregonen', 'murat.ozeee', 'anurag_kurle', 'emrecitakk', 'ardelarosa', 'yash.mh', 'dumpnit', 'furkan552senturk', 'shashi.sarraf', 'mehmettasdelen26', 'kanwat.pranav', 'cancetinkaya1201', 'saineeth', 'sflt317', 'raistlin1923', 'ncmagra54', 'aileyvaa', 'mustafayigitesen', 'uzunnurdan', 'eliffsu.koc', 'halilalp', 'jessica.satyarthi', 'ensarerol26', 'klayydar', 'azazimalii', 'gurhankopcaz', 'jyothishjaggarapu225', 'anjaligawai', 'naveen143', 'abcd5454', 'kaanbjk27', 'erdicany', 'alikanadli7', 'serdememen', 'jessgomez100', 'tolga.ozyurt24', 'ozcanguclu', 'dhyanasivadas311', 'blassselva', 'wuizar99', 'ozcankutlu15', 'funsal', 'sabriyebayrakcinur', 'mumi1478', 'veyseleee123', 'kingkireeti', 'taol190799', 'emreyilmazel1996', 'rhamwey', 'evelyn.f1975', 'haticeterzibali', 'xavier160mg', 'berksaldr', 'emircansimsek', 'njgarcia5', 'jayopp32', 'jarellano1204', 'muvafikmelikkaya', 'gullit0725', 'jasmine43.jp', 'mrgiraffe', 'irem.karagoz33', 'rebecasalcido', 'jatin.us', 'esuna006', 'haoliu', 'aayushik', 'emre.ibil', 'burakbeyazt', 'testeremre70', 'kappa123', 'ezelbilgili', 'anilboran0671', 'bryang511', 'afkali.120', 'yamakonurcan', 'yorumhesabimsa', 'kodaar', 'carlosquinonez80', 'sai.ssm', 'zilmidegne', 'michaelpov', 'anand.satyam', 'berkc', 'selinyasaci98', 'orancagdas', 'ninad.ps', 'sonerkar', 'tugbakoyuncu99', 'yusmar', 'kaankuncak', 'ulises98', 'kagankilicaslan28', 'petersan901', 'yasinzgen']"
3,390,209,32,20,"['omerdmrc16', 'klc.mrt.1926', 'mahmutcanki', 'zeynep', 'evren_aydin6', 'furkan2072', 'mmozcan4', 'simayozbay', 'esulekaplan', 'erencanarslan70', 'mseyfullahcelik', '1967hamzausta', 'brs21', 'mehmettasdelen26', 'mmb', 'mertisleyen96', 'uzunnurdan', 'halilalp', 'berkc', 'erdicany']",188,"['mgk816', 'cmergil39', 'mcsonic', 'prosdocimi.m', 'dleon3', 'yunusyeo768', 'mtakcali', 'emreoney', 'mapayan5', 'swarupadhyay777', 'kenanke', 'fztrnetflix', 'nsener45', 'ekin.gezer', 'joker632455', 'ganesh25', 'okanozkann95', 'murattdo', 'roy227', 'ezelbilgili42', 'burak.baha00', 'youlianafouad17', 'salvalenzuela12', 'isma', 'metobomm', 'enesdinler1', 'krishna.mp', 'jmoya5', 'almelnz2005', 'fjduran3', 'sarawaelahmed22', 'ryckmonster', 'macolmenero', 'bsanchez', 'venkitesh.s', 'garfon61', 'nnurceylan95', 'w.edgarfamous', 'furkan069906', 'arivera35', 'agmendez14', 'alex10', 'jozrik', 'bertansafak', 'ajortega6', 'mstff.1clkk', 'kumar_shubham', 'alibatuhanozturk', 'jadelira201', 'arif.ozkan5806', 'karpuz', 'sigalam', 'shrreya07', 'blogan', 'esraboran71', 'chrisodomx', 'kagangunes10', 'dmitry.stor', 'goknur.derinoz', 'garciaje34454', 'afurkanbudak42', 'ufuk', 'diaz.carlos4499', 'kemre9827', 'scopigno', 'nikharv.19110125', 'halilibrahimtiken', 'ege.ert7', 'fdominguez6', 'ademfurkan', 'havvafatmaozbay', 'sayed.aftabahmad786', 'gtzintzarov', 'mehmetaliyas1998', 'ceydabayrak581', 'elembengisu', 'ferhbk97', 'dblancarte', 'utkubala63', 'iremnurfiliz', 'dragon28540', 'elifindir', 'sebastiangarcia695', 'koningmehmet', 'serhatiseri', 'shaawanalmutairi', 'aadelgado4', 'jagallegos7', 'altinbasnurcan09', 'druiz20', 'pongbrayan', 'bmendoza4', 'mustafa.kaya0798507', 'pmhernandez4', 'paras128', 'windl', 'rmartinez5', 'lerner', 'banoth.dinesh', 'fatihyorgun1996', 'sai.mrr', 'drhodges', 'choudhary_s', 'emregonen', 'murat.ozeee', 'anurag_kurle', 'emrecitakk', 'ardelarosa', 'yash.mh', 'furkan552senturk', 'shashi.sarraf', 'kanwat.pranav', 'cancetinkaya1201', 'saineeth', 'sflt317', 'ncmagra54', 'aileyvaa', 'mustafayigitesen', 'eliffsu.koc', 'jessica.satyarthi', 'ensarerol26', 'klayydar', 'azazimalii', 'gurhankopcaz', 'jyothishjaggarapu225', 'anjaligawai', 'naveen143', 'abcd5454', 'kaanbjk27', 'alikanadli7', 'serdememen', 'jessgomez100', 'tolga.ozyurt24', 'ozcanguclu', 'dhyanasivadas311', 'blassselva', 'wuizar99', 'ozcankutlu15', 'funsal', 'sabriyebayrakcinur', 'mumi1478', 'veyseleee123', 'kingkireeti', 'taol190799', 'emreyilmazel1996', 'rhamwey', 'evelyn.f1975', 'haticeterzibali', 'xavier160mg', 'berksaldr', 'njgarcia5', 'jayopp32', 'jarellano1204', 'muvafikmelikkaya', 'gullit0725', 'jasmine43.jp', 'mrgiraffe', 'irem.karagoz33', 'rebecasalcido', 'jatin.us', 'esuna006', 'haoliu', 'aayushik', 'emre.ibil', 'burakbeyazt', 'testeremre70', 'ezelbilgili', 'anilboran0671', 'bryang511', 'yamakonurcan', 'yorumhesabimsa', 'kodaar', 'carlosquinonez80', 'sai.ssm', 'zilmidegne', 'michaelpov', 'anand.satyam', 'selinyasaci98', 'orancagdas', 'ninad.ps', 'sonerkar', 'tugbakoyuncu99', 'yusmar', 'kaankuncak', 'ulises98', 'kagankilicaslan28', 'petersan901', 'yasinzgen']",12,"['sd226', 'nanouser321', 'fatih2626', 'iremkaratas', 'buseduygut', 'doguhanyucel', 'akdemirel99', 'afkali.120', 'lookatfuture09', None, 'neslihannayy', 'keryfly']",220,"['mgk816', 'cmergil39', 'mcsonic', 'prosdocimi.m', 'dleon3', 'yunusyeo768', 'evren_aydin6', 'mtakcali', 'emreoney', 'mapayan5', 'swarupadhyay777', 'lookatfuture09', 'esulekaplan', 'kenanke', 'fztrnetflix', 'nsener45', 'ekin.gezer', 'joker632455', 'ganesh25', 'okanozkann95', 'murattdo', 'akdemirel99', 'roy227', 'ezelbilgili42', 'burak.baha00', 'youlianafouad17', 'salvalenzuela12', 'isma', 'metobomm', 'enesdinler1', 'krishna.mp', 'jmoya5', 'almelnz2005', 'fjduran3', 'sarawaelahmed22', 'ryckmonster', 'macolmenero', 'bsanchez', 'venkitesh.s', 'garfon61', 'nnurceylan95', 'w.edgarfamous', 'furkan069906', 'arivera35', 'agmendez14', 'alex10', 'jozrik', 'fatih2626', 'omerdmrc16', 'iremkaratas', 'bertansafak', 'ajortega6', 'zeynep', 'mahmutcanki', 'mstff.1clkk', 'kumar_shubham', 'mmozcan4', 'alibatuhanozturk', 'jadelira201', 'arif.ozkan5806', 'karpuz', 'sigalam', 'shrreya07', 'blogan', 'esraboran71', 'buseduygut', 'mseyfullahcelik', 'chrisodomx', 'kagangunes10', '1967hamzausta', 'dmitry.stor', 'goknur.derinoz', 'garciaje34454', 'afurkanbudak42', 'ufuk', 'diaz.carlos4499', 'kemre9827', 'scopigno', 'brs21', 'nikharv.19110125', 'halilibrahimtiken', 'ege.ert7', 'fdominguez6', 'ademfurkan', 'havvafatmaozbay', 'sayed.aftabahmad786', 'gtzintzarov', 'mehmetaliyas1998', 'ceydabayrak581', 'elembengisu', 'ferhbk97', 'dblancarte', 'mmb', 'utkubala63', None, 'mertisleyen96', 'iremnurfiliz', 'dragon28540', 'elifindir', 'sebastiangarcia695', 'koningmehmet', 'serhatiseri', 'shaawanalmutairi', 'keryfly', 'aadelgado4', 'jagallegos7', 'altinbasnurcan09', 'druiz20', 'pongbrayan', 'bmendoza4', 'mustafa.kaya0798507', 'nanouser321', 'pmhernandez4', 'paras128', 'klc.mrt.1926', 'windl', 'rmartinez5', 'lerner', 'banoth.dinesh', 'furkan2072', 'fatihyorgun1996', 'sai.mrr', 'drhodges', 'simayozbay', 'erencanarslan70', 'choudhary_s', 'emregonen', 'murat.ozeee', 'anurag_kurle', 'emrecitakk', 'ardelarosa', 'yash.mh', 'furkan552senturk', 'shashi.sarraf', 'mehmettasdelen26', 'kanwat.pranav', 'cancetinkaya1201', 'saineeth', 'sflt317', 'ncmagra54', 'aileyvaa', 'mustafayigitesen', 'uzunnurdan', 'eliffsu.koc', 'halilalp', 'jessica.satyarthi', 'ensarerol26', 'klayydar', 'azazimalii', 'gurhankopcaz', 'jyothishjaggarapu225', 'anjaligawai', 'naveen143', 'abcd5454', 'kaanbjk27', 'erdicany', 'alikanadli7', 'neslihannayy', 'serdememen', 'jessgomez100', 'tolga.ozyurt24', 'ozcanguclu', 'dhyanasivadas311', 'blassselva', 'wuizar99', 'ozcankutlu15', 'funsal', 'doguhanyucel', 'sabriyebayrakcinur', 'mumi1478', 'veyseleee123', 'kingkireeti', 'taol190799', 'emreyilmazel1996', 'rhamwey', 'evelyn.f1975', 'haticeterzibali', 'xavier160mg', 'berksaldr', 'njgarcia5', 'jayopp32', 'jarellano1204', 'muvafikmelikkaya', 'gullit0725', 'jasmine43.jp', 'mrgiraffe', 'irem.karagoz33', 'rebecasalcido', 'jatin.us', 'esuna006', 'sd226', 'haoliu', 'aayushik', 'emre.ibil', 'burakbeyazt', 'testeremre70', 'ezelbilgili', 'anilboran0671', 'bryang511', 'afkali.120', 'yamakonurcan', 'yorumhesabimsa', 'kodaar', 'carlosquinonez80', 'sai.ssm', 'zilmidegne', 'michaelpov', 'anand.satyam', 'berkc', 'selinyasaci98', 'orancagdas', 'ninad.ps', 'sonerkar', 'tugbakoyuncu99', 'yusmar', 'kaankuncak', 'ulises98', 'kagankilicaslan28', 'petersan901', 'yasinzgen']"
3,170,209,22,10,"['esulekaplan', 'nsener45', 'ozcanguclu', 'selinyasaci98', 'okanozkann95', 'bertansafak', 'ozcankutlu15', 'muvafikmelikkaya', 'murat.ozeee', 'serdememen']",198,"['mgk816', 'cmergil39', 'mcsonic', 'prosdocimi.m', 'dleon3', 'yunusyeo768', 'evren_aydin6', 'mtakcali', 'emreoney', 'mapayan5', 'swarupadhyay777', 'kenanke', 'fztrnetflix', 'ekin.gezer', 'joker632455', 'ganesh25', 'murattdo', 'roy227', 'ezelbilgili42', 'burak.baha00', 'youlianafouad17', 'salvalenzuela12', 'isma', 'metobomm', 'enesdinler1', 'krishna.mp', 'jmoya5', 'almelnz2005', 'fjduran3', 'sarawaelahmed22', 'ryckmonster', 'macolmenero', 'bsanchez', 'venkitesh.s', 'garfon61', 'nnurceylan95', 'w.edgarfamous', 'furkan069906', 'arivera35', 'agmendez14', 'alex10', 'jozrik', 'omerdmrc16', 'ajortega6', 'zeynep', 'mahmutcanki', 'mstff.1clkk', 'kumar_shubham', 'mmozcan4', 'alibatuhanozturk', 'jadelira201', 'arif.ozkan5806', 'karpuz', 'sigalam', 'shrreya07', 'blogan', 'esraboran71', 'mseyfullahcelik', 'chrisodomx', 'kagangunes10', '1967hamzausta', 'dmitry.stor', 'goknur.derinoz', 'garciaje34454', 'afurkanbudak42', 'ufuk', 'diaz.carlos4499', 'kemre9827', 'scopigno', 'brs21', 'nikharv.19110125', 'halilibrahimtiken', 'ege.ert7', 'fdominguez6', 'ademfurkan', 'havvafatmaozbay', 'sayed.aftabahmad786', 'gtzintzarov', 'mehmetaliyas1998', 'ceydabayrak581', 'elembengisu', 'ferhbk97', 'dblancarte', 'mmb', 'utkubala63', 'mertisleyen96', 'iremnurfiliz', 'dragon28540', 'elifindir', 'sebastiangarcia695', 'koningmehmet', 'serhatiseri', 'shaawanalmutairi', 'aadelgado4', 'jagallegos7', 'altinbasnurcan09', 'druiz20', 'pongbrayan', 'bmendoza4', 'mustafa.kaya0798507', 'pmhernandez4', 'paras128', 'klc.mrt.1926', 'windl', 'rmartinez5', 'lerner', 'banoth.dinesh', 'furkan2072', 'fatihyorgun1996', 'sai.mrr', 'drhodges', 'simayozbay', 'erencanarslan70', 'choudhary_s', 'emregonen', 'anurag_kurle', 'emrecitakk', 'ardelarosa', 'yash.mh', 'furkan552senturk', 'shashi.sarraf', 'mehmettasdelen26', 'kanwat.pranav', 'cancetinkaya1201', 'saineeth', 'sflt317', 'ncmagra54', 'aileyvaa', 'mustafayigitesen', 'uzunnurdan', 'eliffsu.koc', 'halilalp', 'jessica.satyarthi', 'ensarerol26', 'klayydar', 'azazimalii', 'gurhankopcaz', 'jyothishjaggarapu225', 'anjaligawai', 'naveen143', 'abcd5454', 'kaanbjk27', 'erdicany', 'alikanadli7', 'jessgomez100', 'tolga.ozyurt24', 'dhyanasivadas311', 'blassselva', 'wuizar99', 'funsal', 'sabriyebayrakcinur', 'mumi1478', 'veyseleee123', 'kingkireeti', 'taol190799', 'emreyilmazel1996', 'rhamwey', 'evelyn.f1975', 'haticeterzibali', 'xavier160mg', 'berksaldr', 'njgarcia5', 'jayopp32', 'jarellano1204', 'gullit0725', 'jasmine43.jp', 'mrgiraffe', 'irem.karagoz33', 'rebecasalcido', 'jatin.us', 'esuna006', 'haoliu', 'aayushik', 'emre.ibil', 'burakbeyazt', 'testeremre70', 'ezelbilgili', 'anilboran0671', 'bryang511', 'yamakonurcan', 'yorumhesabimsa', 'kodaar', 'carlosquinonez80', 'sai.ssm', 'zilmidegne', 'michaelpov', 'anand.satyam', 'berkc', 'orancagdas', 'ninad.ps', 'sonerkar', 'tugbakoyuncu99', 'yusmar', 'kaankuncak', 'ulises98', 'kagankilicaslan28', 'petersan901', 'yasinzgen']",12,"['esracengiz', 'batu.oztrkk', 'aknramazan26', 'isiilhocek', 'kizilinozlem', 'liswfa123', 'buseduygut', 'huseyinkaraaslan12', 'tapur500', 'berkcmn', 'gnskdr52', None]",220,"['mgk816', 'cmergil39', 'mcsonic', 'prosdocimi.m', 'dleon3', 'yunusyeo768', 'evren_aydin6', 'mtakcali', 'emreoney', 'mapayan5', 'swarupadhyay777', 'esulekaplan', 'kenanke', 'fztrnetflix', 'nsener45', 'ekin.gezer', 'joker632455', 'ganesh25', 'okanozkann95', 'murattdo', 'roy227', 'ezelbilgili42', 'esracengiz', 'burak.baha00', 'youlianafouad17', 'salvalenzuela12', 'isma', 'metobomm', 'enesdinler1', 'krishna.mp', 'jmoya5', 'almelnz2005', 'fjduran3', 'sarawaelahmed22', 'batu.oztrkk', 'ryckmonster', 'macolmenero', 'bsanchez', 'venkitesh.s', 'garfon61', 'nnurceylan95', 'w.edgarfamous', 'furkan069906', 'arivera35', 'agmendez14', 'alex10', 'jozrik', 'omerdmrc16', 'bertansafak', 'ajortega6', 'zeynep', 'mahmutcanki', 'mstff.1clkk', 'kumar_shubham', 'mmozcan4', 'alibatuhanozturk', 'jadelira201', 'arif.ozkan5806', 'karpuz', 'kizilinozlem', 'sigalam', 'shrreya07', 'blogan', 'esraboran71', 'buseduygut', 'mseyfullahcelik', 'chrisodomx', 'kagangunes10', '1967hamzausta', 'dmitry.stor', 'goknur.derinoz', 'garciaje34454', 'afurkanbudak42', 'ufuk', 'diaz.carlos4499', 'kemre9827', 'huseyinkaraaslan12', 'scopigno', 'brs21', 'nikharv.19110125', 'halilibrahimtiken', 'ege.ert7', 'fdominguez6', 'ademfurkan', 'havvafatmaozbay', 'sayed.aftabahmad786', 'gtzintzarov', 'mehmetaliyas1998', 'ceydabayrak581', 'elembengisu', 'ferhbk97', 'dblancarte', 'mmb', 'utkubala63', None, 'mertisleyen96', 'iremnurfiliz', 'dragon28540', 'elifindir', 'sebastiangarcia695', 'koningmehmet', 'serhatiseri', 'tapur500', 'shaawanalmutairi', 'aadelgado4', 'jagallegos7', 'altinbasnurcan09', 'druiz20', 'pongbrayan', 'bmendoza4', 'mustafa.kaya0798507', 'pmhernandez4', 'paras128', 'klc.mrt.1926', 'windl', 'rmartinez5', 'lerner', 'banoth.dinesh', 'furkan2072', 'fatihyorgun1996', 'sai.mrr', 'drhodges', 'simayozbay', 'erencanarslan70', 'aknramazan26', 'choudhary_s', 'emregonen', 'murat.ozeee', 'anurag_kurle', 'emrecitakk', 'ardelarosa', 'yash.mh', 'furkan552senturk', 'shashi.sarraf', 'mehmettasdelen26', 'kanwat.pranav', 'cancetinkaya1201', 'saineeth', 'sflt317', 'ncmagra54', 'aileyvaa', 'mustafayigitesen', 'berkcmn', 'uzunnurdan', 'eliffsu.koc', 'halilalp', 'jessica.satyarthi', 'ensarerol26', 'klayydar', 'azazimalii', 'liswfa123', 'gurhankopcaz', 'jyothishjaggarapu225', 'anjaligawai', 'naveen143', 'abcd5454', 'kaanbjk27', 'erdicany', 'alikanadli7', 'gnskdr52', 'serdememen', 'jessgomez100', 'tolga.ozyurt24', 'ozcanguclu', 'dhyanasivadas311', 'isiilhocek', 'blassselva', 'wuizar99', 'ozcankutlu15', 'funsal', 'sabriyebayrakcinur', 'mumi1478', 'veyseleee123', 'kingkireeti', 'taol190799', 'emreyilmazel1996', 'rhamwey', 'evelyn.f1975', 'haticeterzibali', 'xavier160mg', 'berksaldr', 'njgarcia5', 'jayopp32', 'jarellano1204', 'muvafikmelikkaya', 'gullit0725', 'jasmine43.jp', 'mrgiraffe', 'irem.karagoz33', 'rebecasalcido', 'jatin.us', 'esuna006', 'haoliu', 'aayushik', 'emre.ibil', 'burakbeyazt', 'testeremre70', 'ezelbilgili', 'anilboran0671', 'bryang511', 'yamakonurcan', 'yorumhesabimsa', 'kodaar', 'carlosquinonez80', 'sai.ssm', 'zilmidegne', 'michaelpov', 'anand.satyam', 'berkc', 'selinyasaci98', 'orancagdas', 'ninad.ps', 'sonerkar', 'tugbakoyuncu99', 'yusmar', 'kaankuncak', 'ulises98', 'kagankilicaslan28', 'petersan901', 'yasinzgen']"
3,24,209,20,10,"['garfon61', 'testeremre70', 'muvafikmelikkaya', 'koningmehmet', 'sflt317', 'veyseleee123', 'emrecitakk', 'alex10', 'mrgiraffe', 'utkubala63']",198,"['mgk816', 'cmergil39', 'mcsonic', 'prosdocimi.m', 'dleon3', 'yunusyeo768', 'evren_aydin6', 'mtakcali', 'emreoney', 'mapayan5', 'swarupadhyay777', 'esulekaplan', 'kenanke', 'fztrnetflix', 'nsener45', 'ekin.gezer', 'joker632455', 'ganesh25', 'okanozkann95', 'murattdo', 'roy227', 'ezelbilgili42', 'burak.baha00', 'youlianafouad17', 'salvalenzuela12', 'isma', 'metobomm', 'enesdinler1', 'krishna.mp', 'jmoya5', 'almelnz2005', 'fjduran3', 'sarawaelahmed22', 'ryckmonster', 'macolmenero', 'bsanchez', 'venkitesh.s', 'nnurceylan95', 'w.edgarfamous', 'furkan069906', 'arivera35', 'agmendez14', 'jozrik', 'omerdmrc16', 'bertansafak', 'ajortega6', 'zeynep', 'mahmutcanki', 'mstff.1clkk', 'kumar_shubham', 'mmozcan4', 'alibatuhanozturk', 'jadelira201', 'arif.ozkan5806', 'karpuz', 'sigalam', 'shrreya07', 'blogan', 'esraboran71', 'mseyfullahcelik', 'chrisodomx', 'kagangunes10', '1967hamzausta', 'dmitry.stor', 'goknur.derinoz', 'garciaje34454', 'afurkanbudak42', 'ufuk', 'diaz.carlos4499', 'kemre9827', 'scopigno', 'brs21', 'nikharv.19110125', 'halilibrahimtiken', 'ege.ert7', 'fdominguez6', 'ademfurkan', 'havvafatmaozbay', 'sayed.aftabahmad786', 'gtzintzarov', 'mehmetaliyas1998', 'ceydabayrak581', 'elembengisu', 'ferhbk97', 'dblancarte', 'mmb', 'mertisleyen96', 'iremnurfiliz', 'dragon28540', 'elifindir', 'sebastiangarcia695', 'serhatiseri', 'shaawanalmutairi', 'aadelgado4', 'jagallegos7', 'altinbasnurcan09', 'druiz20', 'pongbrayan', 'bmendoza4', 'mustafa.kaya0798507', 'pmhernandez4', 'paras128', 'klc.mrt.1926', 'windl', 'rmartinez5', 'lerner', 'banoth.dinesh', 'furkan2072', 'fatihyorgun1996', 'sai.mrr', 'drhodges', 'simayozbay', 'erencanarslan70', 'choudhary_s', 'emregonen', 'murat.ozeee', 'anurag_kurle', 'ardelarosa', 'yash.mh', 'furkan552senturk', 'shashi.sarraf', 'mehmettasdelen26', 'kanwat.pranav', 'cancetinkaya1201', 'saineeth', 'ncmagra54', 'aileyvaa', 'mustafayigitesen', 'uzunnurdan', 'eliffsu.koc', 'halilalp', 'jessica.satyarthi', 'ensarerol26', 'klayydar', 'azazimalii', 'gurhankopcaz', 'jyothishjaggarapu225', 'anjaligawai', 'naveen143', 'abcd5454', 'kaanbjk27', 'erdicany', 'alikanadli7', 'serdememen', 'jessgomez100', 'tolga.ozyurt24', 'ozcanguclu', 'dhyanasivadas311', 'blassselva', 'wuizar99', 'ozcankutlu15', 'funsal', 'sabriyebayrakcinur', 'mumi1478', 'kingkireeti', 'taol190799', 'emreyilmazel1996', 'rhamwey', 'evelyn.f1975', 'haticeterzibali', 'xavier160mg', 'berksaldr', 'njgarcia5', 'jayopp32', 'jarellano1204', 'gullit0725', 'jasmine43.jp', 'irem.karagoz33', 'rebecasalcido', 'jatin.us', 'esuna006', 'haoliu', 'aayushik', 'emre.ibil', 'burakbeyazt', 'ezelbilgili', 'anilboran0671', 'bryang511', 'yamakonurcan', 'yorumhesabimsa', 'kodaar', 'carlosquinonez80', 'sai.ssm', 'zilmidegne', 'michaelpov', 'anand.satyam', 'berkc', 'selinyasaci98', 'orancagdas', 'ninad.ps', 'sonerkar', 'tugbakoyuncu99', 'yusmar', 'kaankuncak', 'ulises98', 'kagankilicaslan28', 'petersan901', 'yasinzgen']",10,"['ekicifatih0', 'cbortlek', 'atknncvkkl', 'eminakdemir93', 'ronmesdofb', 'afkali.120', 'ardasavas6', 'karabayemre10', None, 'selcukvatansever05']",218,"['mgk816', 'cmergil39', 'mcsonic', 'prosdocimi.m', 'dleon3', 'yunusyeo768', 'evren_aydin6', 'mtakcali', 'emreoney', 'mapayan5', 'swarupadhyay777', 'selcukvatansever05', 'esulekaplan', 'kenanke', 'fztrnetflix', 'nsener45', 'ekin.gezer', 'joker632455', 'ganesh25', 'okanozkann95', 'murattdo', 'roy227', 'ezelbilgili42', 'burak.baha00', 'youlianafouad17', 'salvalenzuela12', 'isma', 'metobomm', 'enesdinler1', 'krishna.mp', 'jmoya5', 'almelnz2005', 'fjduran3', 'sarawaelahmed22', 'ryckmonster', 'macolmenero', 'bsanchez', 'venkitesh.s', 'garfon61', 'nnurceylan95', 'w.edgarfamous', 'furkan069906', 'arivera35', 'agmendez14', 'alex10', 'jozrik', 'omerdmrc16', 'atknncvkkl', 'bertansafak', 'ajortega6', 'zeynep', 'mahmutcanki', 'mstff.1clkk', 'kumar_shubham', 'mmozcan4', 'alibatuhanozturk', 'jadelira201', 'arif.ozkan5806', 'karpuz', 'sigalam', 'shrreya07', 'blogan', 'esraboran71', 'mseyfullahcelik', 'chrisodomx', 'kagangunes10', '1967hamzausta', 'dmitry.stor', 'goknur.derinoz', 'garciaje34454', 'afurkanbudak42', 'ufuk', 'diaz.carlos4499', 'kemre9827', 'scopigno', 'brs21', 'nikharv.19110125', 'halilibrahimtiken', 'ege.ert7', 'fdominguez6', 'ademfurkan', 'havvafatmaozbay', 'sayed.aftabahmad786', 'gtzintzarov', 'mehmetaliyas1998', 'ceydabayrak581', 'elembengisu', 'ferhbk97', 'dblancarte', 'mmb', 'utkubala63', None, 'mertisleyen96', 'karabayemre10', 'iremnurfiliz', 'dragon28540', 'elifindir', 'sebastiangarcia695', 'koningmehmet', 'serhatiseri', 'shaawanalmutairi', 'aadelgado4', 'jagallegos7', 'altinbasnurcan09', 'druiz20', 'pongbrayan', 'bmendoza4', 'mustafa.kaya0798507', 'pmhernandez4', 'paras128', 'klc.mrt.1926', 'eminakdemir93', 'windl', 'rmartinez5', 'lerner', 'banoth.dinesh', 'furkan2072', 'fatihyorgun1996', 'sai.mrr', 'drhodges', 'simayozbay', 'erencanarslan70', 'choudhary_s', 'emregonen', 'murat.ozeee', 'anurag_kurle', 'emrecitakk', 'ardelarosa', 'yash.mh', 'furkan552senturk', 'cbortlek', 'shashi.sarraf', 'mehmettasdelen26', 'kanwat.pranav', 'cancetinkaya1201', 'saineeth', 'sflt317', 'ardasavas6', 'ncmagra54', 'aileyvaa', 'mustafayigitesen', 'uzunnurdan', 'eliffsu.koc', 'halilalp', 'jessica.satyarthi', 'ensarerol26', 'klayydar', 'azazimalii', 'gurhankopcaz', 'jyothishjaggarapu225', 'ronmesdofb', 'anjaligawai', 'naveen143', 'abcd5454', 'kaanbjk27', 'erdicany', 'alikanadli7', 'serdememen', 'jessgomez100', 'tolga.ozyurt24', 'ozcanguclu', 'dhyanasivadas311', 'blassselva', 'wuizar99', 'ozcankutlu15', 'funsal', 'sabriyebayrakcinur', 'mumi1478', 'veyseleee123', 'kingkireeti', 'taol190799', 'emreyilmazel1996', 'rhamwey', 'evelyn.f1975', 'haticeterzibali', 'xavier160mg', 'berksaldr', 'ekicifatih0', 'njgarcia5', 'jayopp32', 'jarellano1204', 'muvafikmelikkaya', 'gullit0725', 'jasmine43.jp', 'mrgiraffe', 'irem.karagoz33', 'rebecasalcido', 'jatin.us', 'esuna006', 'haoliu', 'aayushik', 'emre.ibil', 'burakbeyazt', 'testeremre70', 'ezelbilgili', 'anilboran0671', 'bryang511', 'afkali.120', 'yamakonurcan', 'yorumhesabimsa', 'kodaar', 'carlosquinonez80', 'sai.ssm', 'zilmidegne', 'michaelpov', 'anand.satyam', 'berkc', 'selinyasaci98', 'orancagdas', 'ninad.ps', 'sonerkar', 'tugbakoyuncu99', 'yusmar', 'kaankuncak', 'ulises98', 'kagankilicaslan28', 'petersan901', 'yasinzgen']"
3,346,209,16,5,"['mgk816', 'koningmehmet', 'sonerkar', 'emreyilmazel1996', 'utkubala63']",203,"['cmergil39', 'mcsonic', 'prosdocimi.m', 'dleon3', 'yunusyeo768', 'evren_aydin6', 'mtakcali', 'emreoney', 'mapayan5', 'swarupadhyay777', 'esulekaplan', 'kenanke', 'fztrnetflix', 'nsener45', 'ekin.gezer', 'joker632455', 'ganesh25', 'okanozkann95', 'murattdo', 'roy227', 'ezelbilgili42', 'burak.baha00', 'youlianafouad17', 'salvalenzuela12', 'isma', 'metobomm', 'enesdinler1', 'krishna.mp', 'jmoya5', 'almelnz2005', 'fjduran3', 'sarawaelahmed22', 'ryckmonster', 'macolmenero', 'bsanchez', 'venkitesh.s', 'garfon61', 'nnurceylan95', 'w.edgarfamous', 'furkan069906', 'arivera35', 'agmendez14', 'alex10', 'jozrik', 'omerdmrc16', 'bertansafak', 'ajortega6', 'zeynep', 'mahmutcanki', 'mstff.1clkk', 'kumar_shubham', 'mmozcan4', 'alibatuhanozturk', 'jadelira201', 'arif.ozkan5806', 'karpuz', 'sigalam', 'shrreya07', 'blogan', 'esraboran71', 'mseyfullahcelik', 'chrisodomx', 'kagangunes10', '1967hamzausta', 'dmitry.stor', 'goknur.derinoz', 'garciaje34454', 'afurkanbudak42', 'ufuk', 'diaz.carlos4499', 'kemre9827', 'scopigno', 'brs21', 'nikharv.19110125', 'halilibrahimtiken', 'ege.ert7', 'fdominguez6', 'ademfurkan', 'havvafatmaozbay', 'sayed.aftabahmad786', 'gtzintzarov', 'mehmetaliyas1998', 'ceydabayrak581', 'elembengisu', 'ferhbk97', 'dblancarte', 'mmb', 'mertisleyen96', 'iremnurfiliz', 'dragon28540', 'elifindir', 'sebastiangarcia695', 'serhatiseri', 'shaawanalmutairi', 'aadelgado4', 'jagallegos7', 'altinbasnurcan09', 'druiz20', 'pongbrayan', 'bmendoza4', 'mustafa.kaya0798507', 'pmhernandez4', 'paras128', 'klc.mrt.1926', 'windl', 'rmartinez5', 'lerner', 'banoth.dinesh', 'furkan2072', 'fatihyorgun1996', 'sai.mrr', 'drhodges', 'simayozbay', 'erencanarslan70', 'choudhary_s', 'emregonen', 'murat.ozeee', 'anurag_kurle', 'emrecitakk', 'ardelarosa', 'yash.mh', 'furkan552senturk', 'shashi.sarraf', 'mehmettasdelen26', 'kanwat.pranav', 'cancetinkaya1201', 'saineeth', 'sflt317', 'ncmagra54', 'aileyvaa', 'mustafayigitesen', 'uzunnurdan', 'eliffsu.koc', 'halilalp', 'jessica.satyarthi', 'ensarerol26', 'klayydar', 'azazimalii', 'gurhankopcaz', 'jyothishjaggarapu225', 'anjaligawai', 'naveen143', 'abcd5454', 'kaanbjk27', 'erdicany', 'alikanadli7', 'serdememen', 'jessgomez100', 'tolga.ozyurt24', 'ozcanguclu', 'dhyanasivadas311', 'blassselva', 'wuizar99', 'ozcankutlu15', 'funsal', 'sabriyebayrakcinur', 'mumi1478', 'veyseleee123', 'kingkireeti', 'taol190799', 'rhamwey', 'evelyn.f1975', 'haticeterzibali', 'xavier160mg', 'berksaldr', 'njgarcia5', 'jayopp32', 'jarellano1204', 'muvafikmelikkaya', 'gullit0725', 'jasmine43.jp', 'mrgiraffe', 'irem.karagoz33', 'rebecasalcido', 'jatin.us', 'esuna006', 'haoliu', 'aayushik', 'emre.ibil', 'burakbeyazt', 'testeremre70', 'ezelbilgili', 'anilboran0671', 'bryang511', 'yamakonurcan', 'yorumhesabimsa', 'kodaar', 'carlosquinonez80', 'sai.ssm', 'zilmidegne', 'michaelpov', 'anand.satyam', 'berkc', 'selinyasaci98', 'orancagdas', 'ninad.ps', 'tugbakoyuncu99', 'yusmar', 'kaankuncak', 'ulises98', 'kagankilicaslan28', 'petersan901', 'yasinzgen']",11,"['keremino', 'alpayy98', 'ardaulusan_14', 'batu.oztrkk', 'alikanadl6', 'svlksknsms', 'oknky', 'ronmesdofb', 'cansecgin', None, 'atkncvkkl1']",219,"['mgk816', 'ardaulusan_14', 'cmergil39', 'mcsonic', 'prosdocimi.m', 'dleon3', 'yunusyeo768', 'evren_aydin6', 'mtakcali', 'emreoney', 'mapayan5', 'swarupadhyay777', 'esulekaplan', 'kenanke', 'fztrnetflix', 'keremino', 'nsener45', 'ekin.gezer', 'joker632455', 'ganesh25', 'alikanadl6', 'okanozkann95', 'murattdo', 'roy227', 'ezelbilgili42', 'burak.baha00', 'youlianafouad17', 'salvalenzuela12', 'isma', 'metobomm', 'enesdinler1', 'krishna.mp', 'jmoya5', 'almelnz2005', 'fjduran3', 'sarawaelahmed22', 'atkncvkkl1', 'batu.oztrkk', 'ryckmonster', 'macolmenero', 'bsanchez', 'venkitesh.s', 'garfon61', 'nnurceylan95', 'w.edgarfamous', 'furkan069906', 'arivera35', 'agmendez14', 'alex10', 'jozrik', 'omerdmrc16', 'bertansafak', 'ajortega6', 'zeynep', 'mahmutcanki', 'mstff.1clkk', 'kumar_shubham', 'mmozcan4', 'alibatuhanozturk', 'jadelira201', 'arif.ozkan5806', 'karpuz', 'sigalam', 'shrreya07', 'blogan', 'esraboran71', 'svlksknsms', 'mseyfullahcelik', 'chrisodomx', 'kagangunes10', '1967hamzausta', 'dmitry.stor', 'goknur.derinoz', 'garciaje34454', 'afurkanbudak42', 'ufuk', 'diaz.carlos4499', 'kemre9827', 'scopigno', 'brs21', 'nikharv.19110125', 'halilibrahimtiken', 'ege.ert7', 'fdominguez6', 'ademfurkan', 'havvafatmaozbay', 'sayed.aftabahmad786', 'gtzintzarov', 'mehmetaliyas1998', 'ceydabayrak581', 'elembengisu', 'ferhbk97', 'dblancarte', 'mmb', 'utkubala63', None, 'mertisleyen96', 'iremnurfiliz', 'dragon28540', 'elifindir', 'sebastiangarcia695', 'koningmehmet', 'serhatiseri', 'shaawanalmutairi', 'aadelgado4', 'jagallegos7', 'altinbasnurcan09', 'druiz20', 'pongbrayan', 'bmendoza4', 'mustafa.kaya0798507', 'pmhernandez4', 'paras128', 'klc.mrt.1926', 'windl', 'rmartinez5', 'lerner', 'banoth.dinesh', 'furkan2072', 'fatihyorgun1996', 'sai.mrr', 'drhodges', 'simayozbay', 'erencanarslan70', 'choudhary_s', 'emregonen', 'murat.ozeee', 'anurag_kurle', 'emrecitakk', 'ardelarosa', 'yash.mh', 'furkan552senturk', 'oknky', 'shashi.sarraf', 'mehmettasdelen26', 'kanwat.pranav', 'cancetinkaya1201', 'saineeth', 'sflt317', 'ncmagra54', 'aileyvaa', 'mustafayigitesen', 'uzunnurdan', 'alpayy98', 'eliffsu.koc', 'halilalp', 'jessica.satyarthi', 'ensarerol26', 'klayydar', 'azazimalii', 'gurhankopcaz', 'jyothishjaggarapu225', 'ronmesdofb', 'anjaligawai', 'naveen143', 'abcd5454', 'kaanbjk27', 'erdicany', 'alikanadli7', 'serdememen', 'jessgomez100', 'tolga.ozyurt24', 'ozcanguclu', 'dhyanasivadas311', 'blassselva', 'wuizar99', 'ozcankutlu15', 'funsal', 'sabriyebayrakcinur', 'mumi1478', 'veyseleee123', 'kingkireeti', 'taol190799', 'emreyilmazel1996', 'rhamwey', 'evelyn.f1975', 'haticeterzibali', 'xavier160mg', 'berksaldr', 'njgarcia5', 'jayopp32', 'jarellano1204', 'muvafikmelikkaya', 'gullit0725', 'jasmine43.jp', 'mrgiraffe', 'cansecgin', 'irem.karagoz33', 'rebecasalcido', 'jatin.us', 'esuna006', 'haoliu', 'aayushik', 'emre.ibil', 'burakbeyazt', 'testeremre70', 'ezelbilgili', 'anilboran0671', 'bryang511', 'yamakonurcan', 'yorumhesabimsa', 'kodaar', 'carlosquinonez80', 'sai.ssm', 'zilmidegne', 'michaelpov', 'anand.satyam', 'berkc', 'selinyasaci98', 'orancagdas', 'ninad.ps', 'sonerkar', 'tugbakoyuncu99', 'yusmar', 'kaankuncak', 'ulises98', 'kagankilicaslan28', 'petersan901', 'yasinzgen']"
3,26,209,15,6,"['esraboran71', 'furkan069906', 'mseyfullahcelik', 'serhatiseri', 'yamakonurcan', 'uzunnurdan']",202,"['mgk816', 'cmergil39', 'mcsonic', 'prosdocimi.m', 'dleon3', 'yunusyeo768', 'evren_aydin6', 'mtakcali', 'emreoney', 'mapayan5', 'swarupadhyay777', 'esulekaplan', 'kenanke', 'fztrnetflix', 'nsener45', 'ekin.gezer', 'joker632455', 'ganesh25', 'okanozkann95', 'murattdo', 'roy227', 'ezelbilgili42', 'burak.baha00', 'youlianafouad17', 'salvalenzuela12', 'isma', 'metobomm', 'enesdinler1', 'krishna.mp', 'jmoya5', 'almelnz2005', 'fjduran3', 'sarawaelahmed22', 'ryckmonster', 'macolmenero', 'bsanchez', 'venkitesh.s', 'garfon61', 'nnurceylan95', 'w.edgarfamous', 'arivera35', 'agmendez14', 'alex10', 'jozrik', 'omerdmrc16', 'bertansafak', 'ajortega6', 'zeynep', 'mahmutcanki', 'mstff.1clkk', 'kumar_shubham', 'mmozcan4', 'alibatuhanozturk', 'jadelira201', 'arif.ozkan5806', 'karpuz', 'sigalam', 'shrreya07', 'blogan', 'chrisodomx', 'kagangunes10', '1967hamzausta', 'dmitry.stor', 'goknur.derinoz', 'garciaje34454', 'afurkanbudak42', 'ufuk', 'diaz.carlos4499', 'kemre9827', 'scopigno', 'brs21', 'nikharv.19110125', 'halilibrahimtiken', 'ege.ert7', 'fdominguez6', 'ademfurkan', 'havvafatmaozbay', 'sayed.aftabahmad786', 'gtzintzarov', 'mehmetaliyas1998', 'ceydabayrak581', 'elembengisu', 'ferhbk97', 'dblancarte', 'mmb', 'utkubala63', 'mertisleyen96', 'iremnurfiliz', 'dragon28540', 'elifindir', 'sebastiangarcia695', 'koningmehmet', 'shaawanalmutairi', 'aadelgado4', 'jagallegos7', 'altinbasnurcan09', 'druiz20', 'pongbrayan', 'bmendoza4', 'mustafa.kaya0798507', 'pmhernandez4', 'paras128', 'klc.mrt.1926', 'windl', 'rmartinez5', 'lerner', 'banoth.dinesh', 'furkan2072', 'fatihyorgun1996', 'sai.mrr', 'drhodges', 'simayozbay', 'erencanarslan70', 'choudhary_s', 'emregonen', 'murat.ozeee', 'anurag_kurle', 'emrecitakk', 'ardelarosa', 'yash.mh', 'furkan552senturk', 'shashi.sarraf', 'mehmettasdelen26', 'kanwat.pranav', 'cancetinkaya1201', 'saineeth', 'sflt317', 'ncmagra54', 'aileyvaa', 'mustafayigitesen', 'eliffsu.koc', 'halilalp', 'jessica.satyarthi', 'ensarerol26', 'klayydar', 'azazimalii', 'gurhankopcaz', 'jyothishjaggarapu225', 'anjaligawai', 'naveen143', 'abcd5454', 'kaanbjk27', 'erdicany', 'alikanadli7', 'serdememen', 'jessgomez100', 'tolga.ozyurt24', 'ozcanguclu', 'dhyanasivadas311', 'blassselva', 'wuizar99', 'ozcankutlu15', 'funsal', 'sabriyebayrakcinur', 'mumi1478', 'veyseleee123', 'kingkireeti', 'taol190799', 'emreyilmazel1996', 'rhamwey', 'evelyn.f1975', 'haticeterzibali', 'xavier160mg', 'berksaldr', 'njgarcia5', 'jayopp32', 'jarellano1204', 'muvafikmelikkaya', 'gullit0725', 'jasmine43.jp', 'mrgiraffe', 'irem.karagoz33', 'rebecasalcido', 'jatin.us', 'esuna006', 'haoliu', 'aayushik', 'emre.ibil', 'burakbeyazt', 'testeremre70', 'ezelbilgili', 'anilboran0671', 'bryang511', 'yorumhesabimsa', 'kodaar', 'carlosquinonez80', 'sai.ssm', 'zilmidegne', 'michaelpov', 'anand.satyam', 'berkc', 'selinyasaci98', 'orancagdas', 'ninad.ps', 'sonerkar', 'tugbakoyuncu99', 'yusmar', 'kaankuncak', 'ulises98', 'kagankilicaslan28', 'petersan901', 'yasinzgen']",9,"['yilmaazmert', 'samimorsoglu', 'byzayh13', 'erhan26uzun', 'enesqwe', 'ozanemreercan', None, 'salcaburak', 'fatihakyurek26']",217,"['mgk816', 'cmergil39', 'mcsonic', 'prosdocimi.m', 'dleon3', 'yunusyeo768', 'evren_aydin6', 'ozanemreercan', 'mtakcali', 'emreoney', 'mapayan5', 'swarupadhyay777', 'esulekaplan', 'kenanke', 'fztrnetflix', 'nsener45', 'byzayh13', 'ekin.gezer', 'joker632455', 'ganesh25', 'okanozkann95', 'murattdo', 'roy227', 'ezelbilgili42', 'burak.baha00', 'youlianafouad17', 'salvalenzuela12', 'isma', 'erhan26uzun', 'metobomm', 'enesdinler1', 'krishna.mp', 'jmoya5', 'almelnz2005', 'fjduran3', 'sarawaelahmed22', 'ryckmonster', 'macolmenero', 'samimorsoglu', 'bsanchez', 'venkitesh.s', 'enesqwe', 'garfon61', 'nnurceylan95', 'w.edgarfamous', 'furkan069906', 'arivera35', 'agmendez14', 'alex10', 'jozrik', 'omerdmrc16', 'bertansafak', 'ajortega6', 'zeynep', 'mahmutcanki', 'mstff.1clkk', 'kumar_shubham', 'mmozcan4', 'alibatuhanozturk', 'jadelira201', 'arif.ozkan5806', 'karpuz', 'salcaburak', 'sigalam', 'shrreya07', 'blogan', 'esraboran71', 'mseyfullahcelik', 'chrisodomx', 'kagangunes10', '1967hamzausta', 'dmitry.stor', 'goknur.derinoz', 'garciaje34454', 'afurkanbudak42', 'ufuk', 'diaz.carlos4499', 'kemre9827', 'scopigno', 'brs21', 'nikharv.19110125', 'halilibrahimtiken', 'ege.ert7', 'fdominguez6', 'ademfurkan', 'havvafatmaozbay', 'sayed.aftabahmad786', 'gtzintzarov', 'mehmetaliyas1998', 'ceydabayrak581', 'elembengisu', 'ferhbk97', 'dblancarte', 'mmb', 'utkubala63', None, 'mertisleyen96', 'fatihakyurek26', 'yilmaazmert', 'iremnurfiliz', 'dragon28540', 'elifindir', 'sebastiangarcia695', 'koningmehmet', 'serhatiseri', 'shaawanalmutairi', 'aadelgado4', 'jagallegos7', 'altinbasnurcan09', 'druiz20', 'pongbrayan', 'bmendoza4', 'mustafa.kaya0798507', 'pmhernandez4', 'paras128', 'klc.mrt.1926', 'windl', 'rmartinez5', 'lerner', 'banoth.dinesh', 'furkan2072', 'fatihyorgun1996', 'sai.mrr', 'drhodges', 'simayozbay', 'erencanarslan70', 'choudhary_s', 'emregonen', 'murat.ozeee', 'anurag_kurle', 'emrecitakk', 'ardelarosa', 'yash.mh', 'furkan552senturk', 'shashi.sarraf', 'mehmettasdelen26', 'kanwat.pranav', 'cancetinkaya1201', 'saineeth', 'sflt317', 'ncmagra54', 'aileyvaa', 'mustafayigitesen', 'uzunnurdan', 'eliffsu.koc', 'halilalp', 'jessica.satyarthi', 'ensarerol26', 'klayydar', 'azazimalii', 'gurhankopcaz', 'jyothishjaggarapu225', 'anjaligawai', 'naveen143', 'abcd5454', 'kaanbjk27', 'erdicany', 'alikanadli7', 'serdememen', 'jessgomez100', 'tolga.ozyurt24', 'ozcanguclu', 'dhyanasivadas311', 'blassselva', 'wuizar99', 'ozcankutlu15', 'funsal', 'sabriyebayrakcinur', 'mumi1478', 'veyseleee123', 'kingkireeti', 'taol190799', 'emreyilmazel1996', 'rhamwey', 'evelyn.f1975', 'haticeterzibali', 'xavier160mg', 'berksaldr', 'njgarcia5', 'jayopp32', 'jarellano1204', 'muvafikmelikkaya', 'gullit0725', 'jasmine43.jp', 'mrgiraffe', 'irem.karagoz33', 'rebecasalcido', 'jatin.us', 'esuna006', 'haoliu', 'aayushik', 'emre.ibil', 'burakbeyazt', 'testeremre70', 'ezelbilgili', 'anilboran0671', 'bryang511', 'yamakonurcan', 'yorumhesabimsa', 'kodaar', 'carlosquinonez80', 'sai.ssm', 'zilmidegne', 'michaelpov', 'anand.satyam', 'berkc', 'selinyasaci98', 'orancagdas', 'ninad.ps', 'sonerkar', 'tugbakoyuncu99', 'yusmar', 'kaankuncak', 'ulises98', 'kagankilicaslan28', 'petersan901', 'yasinzgen']"
3,372,209,15,1,['naveen143'],207,"['mgk816', 'cmergil39', 'mcsonic', 'prosdocimi.m', 'dleon3', 'yunusyeo768', 'evren_aydin6', 'mtakcali', 'emreoney', 'mapayan5', 'swarupadhyay777', 'esulekaplan', 'kenanke', 'fztrnetflix', 'nsener45', 'ekin.gezer', 'joker632455', 'ganesh25', 'okanozkann95', 'murattdo', 'roy227', 'ezelbilgili42', 'burak.baha00', 'youlianafouad17', 'salvalenzuela12', 'isma', 'metobomm', 'enesdinler1', 'krishna.mp', 'jmoya5', 'almelnz2005', 'fjduran3', 'sarawaelahmed22', 'ryckmonster', 'macolmenero', 'bsanchez', 'venkitesh.s', 'garfon61', 'nnurceylan95', 'w.edgarfamous', 'furkan069906', 'arivera35', 'agmendez14', 'alex10', 'jozrik', 'omerdmrc16', 'bertansafak', 'ajortega6', 'zeynep', 'mahmutcanki', 'mstff.1clkk', 'kumar_shubham', 'mmozcan4', 'alibatuhanozturk', 'jadelira201', 'arif.ozkan5806', 'karpuz', 'sigalam', 'shrreya07', 'blogan', 'esraboran71', 'mseyfullahcelik', 'chrisodomx', 'kagangunes10', '1967hamzausta', 'dmitry.stor', 'goknur.derinoz', 'garciaje34454', 'afurkanbudak42', 'ufuk', 'diaz.carlos4499', 'kemre9827', 'scopigno', 'brs21', 'nikharv.19110125', 'halilibrahimtiken', 'ege.ert7', 'fdominguez6', 'ademfurkan', 'havvafatmaozbay', 'sayed.aftabahmad786', 'gtzintzarov', 'mehmetaliyas1998', 'ceydabayrak581', 'elembengisu', 'ferhbk97', 'dblancarte', 'mmb', 'utkubala63', 'mertisleyen96', 'iremnurfiliz', 'dragon28540', 'elifindir', 'sebastiangarcia695', 'koningmehmet', 'serhatiseri', 'shaawanalmutairi', 'aadelgado4', 'jagallegos7', 'altinbasnurcan09', 'druiz20', 'pongbrayan', 'bmendoza4', 'mustafa.kaya0798507', 'pmhernandez4', 'paras128', 'klc.mrt.1926', 'windl', 'rmartinez5', 'lerner', 'banoth.dinesh', 'furkan2072', 'fatihyorgun1996', 'sai.mrr', 'drhodges', 'simayozbay', 'erencanarslan70', 'choudhary_s', 'emregonen', 'murat.ozeee', 'anurag_kurle', 'emrecitakk', 'ardelarosa', 'yash.mh', 'furkan552senturk', 'shashi.sarraf', 'mehmettasdelen26', 'kanwat.pranav', 'cancetinkaya1201', 'saineeth', 'sflt317', 'ncmagra54', 'aileyvaa', 'mustafayigitesen', 'uzunnurdan', 'eliffsu.koc', 'halilalp', 'jessica.satyarthi', 'ensarerol26', 'klayydar', 'azazimalii', 'gurhankopcaz', 'jyothishjaggarapu225', 'anjaligawai', 'abcd5454', 'kaanbjk27', 'erdicany', 'alikanadli7', 'serdememen', 'jessgomez100', 'tolga.ozyurt24', 'ozcanguclu', 'dhyanasivadas311', 'blassselva', 'wuizar99', 'ozcankutlu15', 'funsal', 'sabriyebayrakcinur', 'mumi1478', 'veyseleee123', 'kingkireeti', 'taol190799', 'emreyilmazel1996', 'rhamwey', 'evelyn.f1975', 'haticeterzibali', 'xavier160mg', 'berksaldr', 'njgarcia5', 'jayopp32', 'jarellano1204', 'muvafikmelikkaya', 'gullit0725', 'jasmine43.jp', 'mrgiraffe', 'irem.karagoz33', 'rebecasalcido', 'jatin.us', 'esuna006', 'haoliu', 'aayushik', 'emre.ibil', 'burakbeyazt', 'testeremre70', 'ezelbilgili', 'anilboran0671', 'bryang511', 'yamakonurcan', 'yorumhesabimsa', 'kodaar', 'carlosquinonez80', 'sai.ssm', 'zilmidegne', 'michaelpov', 'anand.satyam', 'berkc', 'selinyasaci98', 'orancagdas', 'ninad.ps', 'sonerkar', 'tugbakoyuncu99', 'yusmar', 'kaankuncak', 'ulises98', 'kagankilicaslan28', 'petersan901', 'yasinzgen']",14,"['venkatesh960', 'mani1218', 'mansur', 'ganeshpasupuleti2000', 'thirupathiraomeesala5', 'surendramadhiboyina1215', 'k.venu459rc', 'leelakrishna', 'atlapragna', 'puneeth5136', 'chennareddy', 'imranshaik', None, 'bhuvaneswaribunny0813']",222,"['mgk816', 'cmergil39', 'mcsonic', 'prosdocimi.m', 'k.venu459rc', 'dleon3', 'yunusyeo768', 'evren_aydin6', 'mtakcali', 'emreoney', 'mapayan5', 'swarupadhyay777', 'esulekaplan', 'kenanke', 'fztrnetflix', 'nsener45', 'mani1218', 'ekin.gezer', 'joker632455', 'ganesh25', 'okanozkann95', 'murattdo', 'roy227', 'ezelbilgili42', 'bhuvaneswaribunny0813', 'burak.baha00', 'youlianafouad17', 'salvalenzuela12', 'isma', 'metobomm', 'enesdinler1', 'krishna.mp', 'jmoya5', 'almelnz2005', 'fjduran3', 'sarawaelahmed22', 'ryckmonster', 'macolmenero', 'thirupathiraomeesala5', 'bsanchez', 'venkitesh.s', 'garfon61', 'nnurceylan95', 'w.edgarfamous', 'furkan069906', 'arivera35', 'agmendez14', 'alex10', 'jozrik', 'omerdmrc16', 'surendramadhiboyina1215', 'bertansafak', 'ajortega6', 'zeynep', 'mahmutcanki', 'mstff.1clkk', 'atlapragna', 'puneeth5136', 'kumar_shubham', 'mmozcan4', 'alibatuhanozturk', 'jadelira201', 'arif.ozkan5806', 'karpuz', 'sigalam', 'shrreya07', 'blogan', 'esraboran71', 'mseyfullahcelik', 'chrisodomx', 'kagangunes10', '1967hamzausta', 'dmitry.stor', 'goknur.derinoz', 'garciaje34454', 'afurkanbudak42', 'ufuk', 'diaz.carlos4499', 'kemre9827', 'scopigno', 'brs21', 'nikharv.19110125', 'halilibrahimtiken', 'ege.ert7', 'fdominguez6', 'ademfurkan', 'havvafatmaozbay', 'sayed.aftabahmad786', 'gtzintzarov', 'mehmetaliyas1998', 'ceydabayrak581', 'elembengisu', 'ferhbk97', 'dblancarte', 'mmb', 'utkubala63', None, 'mertisleyen96', 'iremnurfiliz', 'dragon28540', 'elifindir', 'sebastiangarcia695', 'koningmehmet', 'serhatiseri', 'shaawanalmutairi', 'aadelgado4', 'jagallegos7', 'altinbasnurcan09', 'druiz20', 'pongbrayan', 'bmendoza4', 'mustafa.kaya0798507', 'pmhernandez4', 'paras128', 'klc.mrt.1926', 'leelakrishna', 'windl', 'rmartinez5', 'lerner', 'banoth.dinesh', 'furkan2072', 'fatihyorgun1996', 'sai.mrr', 'drhodges', 'simayozbay', 'erencanarslan70', 'choudhary_s', 'emregonen', 'murat.ozeee', 'anurag_kurle', 'emrecitakk', 'ardelarosa', 'yash.mh', 'furkan552senturk', 'shashi.sarraf', 'mehmettasdelen26', 'kanwat.pranav', 'cancetinkaya1201', 'saineeth', 'sflt317', 'ncmagra54', 'aileyvaa', 'mustafayigitesen', 'uzunnurdan', 'eliffsu.koc', 'halilalp', 'jessica.satyarthi', 'mansur', 'ensarerol26', 'klayydar', 'azazimalii', 'gurhankopcaz', 'jyothishjaggarapu225', 'anjaligawai', 'naveen143', 'abcd5454', 'kaanbjk27', 'erdicany', 'alikanadli7', 'serdememen', 'jessgomez100', 'tolga.ozyurt24', 'ozcanguclu', 'dhyanasivadas311', 'ganeshpasupuleti2000', 'blassselva', 'wuizar99', 'ozcankutlu15', 'funsal', 'sabriyebayrakcinur', 'mumi1478', 'veyseleee123', 'kingkireeti', 'taol190799', 'emreyilmazel1996', 'chennareddy', 'venkatesh960', 'rhamwey', 'evelyn.f1975', 'haticeterzibali', 'xavier160mg', 'berksaldr', 'njgarcia5', 'jayopp32', 'jarellano1204', 'muvafikmelikkaya', 'gullit0725', 'jasmine43.jp', 'mrgiraffe', 'irem.karagoz33', 'rebecasalcido', 'jatin.us', 'esuna006', 'haoliu', 'aayushik', 'emre.ibil', 'burakbeyazt', 'testeremre70', 'ezelbilgili', 'anilboran0671', 'bryang511', 'yamakonurcan', 'yorumhesabimsa', 'kodaar', 'carlosquinonez80', 'sai.ssm', 'zilmidegne', 'michaelpov', 'anand.satyam', 'berkc', 'selinyasaci98', 'orancagdas', 'ninad.ps', 'sonerkar', 'tugbakoyuncu99', 'yusmar', 'kaankuncak', 'ulises98', 'kagankilicaslan28', 'imranshaik', 'petersan901', 'yasinzgen']"
3,549,209,14,5,"['berksaldr', 'dragon28540', 'haticeterzibali', 'havvafatmaozbay', 'sonerkar']",203,"['mgk816', 'cmergil39', 'mcsonic', 'prosdocimi.m', 'dleon3', 'yunusyeo768', 'evren_aydin6', 'mtakcali', 'emreoney', 'mapayan5', 'swarupadhyay777', 'esulekaplan', 'kenanke', 'fztrnetflix', 'nsener45', 'ekin.gezer', 'joker632455', 'ganesh25', 'okanozkann95', 'murattdo', 'roy227', 'ezelbilgili42', 'burak.baha00', 'youlianafouad17', 'salvalenzuela12', 'isma', 'metobomm', 'enesdinler1', 'krishna.mp', 'jmoya5', 'almelnz2005', 'fjduran3', 'sarawaelahmed22', 'ryckmonster', 'macolmenero', 'bsanchez', 'venkitesh.s', 'garfon61', 'nnurceylan95', 'w.edgarfamous', 'furkan069906', 'arivera35', 'agmendez14', 'alex10', 'jozrik', 'omerdmrc16', 'bertansafak', 'ajortega6', 'zeynep', 'mahmutcanki', 'mstff.1clkk', 'kumar_shubham', 'mmozcan4', 'alibatuhanozturk', 'jadelira201', 'arif.ozkan5806', 'karpuz', 'sigalam', 'shrreya07', 'blogan', 'esraboran71', 'mseyfullahcelik', 'chrisodomx', 'kagangunes10', '1967hamzausta', 'dmitry.stor', 'goknur.derinoz', 'garciaje34454', 'afurkanbudak42', 'ufuk', 'diaz.carlos4499', 'kemre9827', 'scopigno', 'brs21', 'nikharv.19110125', 'halilibrahimtiken', 'ege.ert7', 'fdominguez6', 'ademfurkan', 'sayed.aftabahmad786', 'gtzintzarov', 'mehmetaliyas1998', 'ceydabayrak581', 'elembengisu', 'ferhbk97', 'dblancarte', 'mmb', 'utkubala63', 'mertisleyen96', 'iremnurfiliz', 'elifindir', 'sebastiangarcia695', 'koningmehmet', 'serhatiseri', 'shaawanalmutairi', 'aadelgado4', 'jagallegos7', 'altinbasnurcan09', 'druiz20', 'pongbrayan', 'bmendoza4', 'mustafa.kaya0798507', 'pmhernandez4', 'paras128', 'klc.mrt.1926', 'windl', 'rmartinez5', 'lerner', 'banoth.dinesh', 'furkan2072', 'fatihyorgun1996', 'sai.mrr', 'drhodges', 'simayozbay', 'erencanarslan70', 'choudhary_s', 'emregonen', 'murat.ozeee', 'anurag_kurle', 'emrecitakk', 'ardelarosa', 'yash.mh', 'furkan552senturk', 'shashi.sarraf', 'mehmettasdelen26', 'kanwat.pranav', 'cancetinkaya1201', 'saineeth', 'sflt317', 'ncmagra54', 'aileyvaa', 'mustafayigitesen', 'uzunnurdan', 'eliffsu.koc', 'halilalp', 'jessica.satyarthi', 'ensarerol26', 'klayydar', 'azazimalii', 'gurhankopcaz', 'jyothishjaggarapu225', 'anjaligawai', 'naveen143', 'abcd5454', 'kaanbjk27', 'erdicany', 'alikanadli7', 'serdememen', 'jessgomez100', 'tolga.ozyurt24', 'ozcanguclu', 'dhyanasivadas311', 'blassselva', 'wuizar99', 'ozcankutlu15', 'funsal', 'sabriyebayrakcinur', 'mumi1478', 'veyseleee123', 'kingkireeti', 'taol190799', 'emreyilmazel1996', 'rhamwey', 'evelyn.f1975', 'xavier160mg', 'njgarcia5', 'jayopp32', 'jarellano1204', 'muvafikmelikkaya', 'gullit0725', 'jasmine43.jp', 'mrgiraffe', 'irem.karagoz33', 'rebecasalcido', 'jatin.us', 'esuna006', 'haoliu', 'aayushik', 'emre.ibil', 'burakbeyazt', 'testeremre70', 'ezelbilgili', 'anilboran0671', 'bryang511', 'yamakonurcan', 'yorumhesabimsa', 'kodaar', 'carlosquinonez80', 'sai.ssm', 'zilmidegne', 'michaelpov', 'anand.satyam', 'berkc', 'selinyasaci98', 'orancagdas', 'ninad.ps', 'tugbakoyuncu99', 'yusmar', 'kaankuncak', 'ulises98', 'kagankilicaslan28', 'petersan901', 'yasinzgen']",9,"['abdulkadirnergiz', 'ah.sa.eskicioz', 'furkanbudak42', 'giray', 'raistlin1923', 'alifiratcobanoglu', 'cansecgin', None, 'wgip18']",217,"['mgk816', 'cmergil39', 'mcsonic', 'prosdocimi.m', 'dleon3', 'yunusyeo768', 'evren_aydin6', 'mtakcali', 'emreoney', 'mapayan5', 'swarupadhyay777', 'esulekaplan', 'kenanke', 'fztrnetflix', 'abdulkadirnergiz', 'nsener45', 'ekin.gezer', 'joker632455', 'ganesh25', 'okanozkann95', 'murattdo', 'roy227', 'ezelbilgili42', 'burak.baha00', 'youlianafouad17', 'salvalenzuela12', 'isma', 'metobomm', 'enesdinler1', 'krishna.mp', 'jmoya5', 'almelnz2005', 'fjduran3', 'sarawaelahmed22', 'ryckmonster', 'macolmenero', 'bsanchez', 'venkitesh.s', 'garfon61', 'furkanbudak42', 'nnurceylan95', 'w.edgarfamous', 'furkan069906', 'giray', 'arivera35', 'agmendez14', 'alex10', 'jozrik', 'omerdmrc16', 'bertansafak', 'ajortega6', 'zeynep', 'mahmutcanki', 'mstff.1clkk', 'kumar_shubham', 'mmozcan4', 'alibatuhanozturk', 'jadelira201', 'arif.ozkan5806', 'karpuz', 'wgip18', 'sigalam', 'shrreya07', 'blogan', 'esraboran71', 'mseyfullahcelik', 'chrisodomx', 'kagangunes10', '1967hamzausta', 'dmitry.stor', 'goknur.derinoz', 'garciaje34454', 'afurkanbudak42', 'ufuk', 'diaz.carlos4499', 'kemre9827', 'scopigno', 'brs21', 'nikharv.19110125', 'halilibrahimtiken', 'ege.ert7', 'fdominguez6', 'ademfurkan', 'havvafatmaozbay', 'sayed.aftabahmad786', 'gtzintzarov', 'mehmetaliyas1998', 'ceydabayrak581', 'elembengisu', 'ferhbk97', 'dblancarte', 'mmb', 'utkubala63', None, 'mertisleyen96', 'iremnurfiliz', 'dragon28540', 'elifindir', 'sebastiangarcia695', 'koningmehmet', 'serhatiseri', 'shaawanalmutairi', 'aadelgado4', 'jagallegos7', 'altinbasnurcan09', 'druiz20', 'pongbrayan', 'bmendoza4', 'mustafa.kaya0798507', 'pmhernandez4', 'paras128', 'klc.mrt.1926', 'windl', 'rmartinez5', 'lerner', 'banoth.dinesh', 'furkan2072', 'fatihyorgun1996', 'sai.mrr', 'drhodges', 'simayozbay', 'erencanarslan70', 'choudhary_s', 'emregonen', 'murat.ozeee', 'anurag_kurle', 'emrecitakk', 'ardelarosa', 'yash.mh', 'furkan552senturk', 'shashi.sarraf', 'mehmettasdelen26', 'kanwat.pranav', 'cancetinkaya1201', 'saineeth', 'sflt317', 'raistlin1923', 'ncmagra54', 'aileyvaa', 'mustafayigitesen', 'uzunnurdan', 'eliffsu.koc', 'halilalp', 'jessica.satyarthi', 'ensarerol26', 'klayydar', 'azazimalii', 'gurhankopcaz', 'jyothishjaggarapu225', 'anjaligawai', 'naveen143', 'abcd5454', 'kaanbjk27', 'erdicany', 'alikanadli7', 'serdememen', 'jessgomez100', 'tolga.ozyurt24', 'ozcanguclu', 'dhyanasivadas311', 'blassselva', 'wuizar99', 'ozcankutlu15', 'funsal', 'sabriyebayrakcinur', 'mumi1478', 'veyseleee123', 'kingkireeti', 'taol190799', 'emreyilmazel1996', 'rhamwey', 'evelyn.f1975', 'haticeterzibali', 'xavier160mg', 'berksaldr', 'njgarcia5', 'jayopp32', 'jarellano1204', 'muvafikmelikkaya', 'gullit0725', 'alifiratcobanoglu', 'jasmine43.jp', 'mrgiraffe', 'cansecgin', 'irem.karagoz33', 'rebecasalcido', 'jatin.us', 'esuna006', 'ah.sa.eskicioz', 'haoliu', 'aayushik', 'emre.ibil', 'burakbeyazt', 'testeremre70', 'ezelbilgili', 'anilboran0671', 'bryang511', 'yamakonurcan', 'yorumhesabimsa', 'kodaar', 'carlosquinonez80', 'sai.ssm', 'zilmidegne', 'michaelpov', 'anand.satyam', 'berkc', 'selinyasaci98', 'orancagdas', 'ninad.ps', 'sonerkar', 'tugbakoyuncu99', 'yusmar', 'kaankuncak', 'ulises98', 'kagankilicaslan28', 'petersan901', 'yasinzgen']"
3,27,209,13,6,"['metobomm', 'murattdo', 'mehmetaliyas1998', 'mseyfullahcelik', 'alibatuhanozturk', 'mrgiraffe']",202,"['mgk816', 'cmergil39', 'mcsonic', 'prosdocimi.m', 'dleon3', 'yunusyeo768', 'evren_aydin6', 'mtakcali', 'emreoney', 'mapayan5', 'swarupadhyay777', 'esulekaplan', 'kenanke', 'fztrnetflix', 'nsener45', 'ekin.gezer', 'joker632455', 'ganesh25', 'okanozkann95', 'roy227', 'ezelbilgili42', 'burak.baha00', 'youlianafouad17', 'salvalenzuela12', 'isma', 'enesdinler1', 'krishna.mp', 'jmoya5', 'almelnz2005', 'fjduran3', 'sarawaelahmed22', 'ryckmonster', 'macolmenero', 'bsanchez', 'venkitesh.s', 'garfon61', 'nnurceylan95', 'w.edgarfamous', 'furkan069906', 'arivera35', 'agmendez14', 'alex10', 'jozrik', 'omerdmrc16', 'bertansafak', 'ajortega6', 'zeynep', 'mahmutcanki', 'mstff.1clkk', 'kumar_shubham', 'mmozcan4', 'jadelira201', 'arif.ozkan5806', 'karpuz', 'sigalam', 'shrreya07', 'blogan', 'esraboran71', 'chrisodomx', 'kagangunes10', '1967hamzausta', 'dmitry.stor', 'goknur.derinoz', 'garciaje34454', 'afurkanbudak42', 'ufuk', 'diaz.carlos4499', 'kemre9827', 'scopigno', 'brs21', 'nikharv.19110125', 'halilibrahimtiken', 'ege.ert7', 'fdominguez6', 'ademfurkan', 'havvafatmaozbay', 'sayed.aftabahmad786', 'gtzintzarov', 'ceydabayrak581', 'elembengisu', 'ferhbk97', 'dblancarte', 'mmb', 'utkubala63', 'mertisleyen96', 'iremnurfiliz', 'dragon28540', 'elifindir', 'sebastiangarcia695', 'koningmehmet', 'serhatiseri', 'shaawanalmutairi', 'aadelgado4', 'jagallegos7', 'altinbasnurcan09', 'druiz20', 'pongbrayan', 'bmendoza4', 'mustafa.kaya0798507', 'pmhernandez4', 'paras128', 'klc.mrt.1926', 'windl', 'rmartinez5', 'lerner', 'banoth.dinesh', 'furkan2072', 'fatihyorgun1996', 'sai.mrr', 'drhodges', 'simayozbay', 'erencanarslan70', 'choudhary_s', 'emregonen', 'murat.ozeee', 'anurag_kurle', 'emrecitakk', 'ardelarosa', 'yash.mh', 'furkan552senturk', 'shashi.sarraf', 'mehmettasdelen26', 'kanwat.pranav', 'cancetinkaya1201', 'saineeth', 'sflt317', 'ncmagra54', 'aileyvaa', 'mustafayigitesen', 'uzunnurdan', 'eliffsu.koc', 'halilalp', 'jessica.satyarthi', 'ensarerol26', 'klayydar', 'azazimalii', 'gurhankopcaz', 'jyothishjaggarapu225', 'anjaligawai', 'naveen143', 'abcd5454', 'kaanbjk27', 'erdicany', 'alikanadli7', 'serdememen', 'jessgomez100', 'tolga.ozyurt24', 'ozcanguclu', 'dhyanasivadas311', 'blassselva', 'wuizar99', 'ozcankutlu15', 'funsal', 'sabriyebayrakcinur', 'mumi1478', 'veyseleee123', 'kingkireeti', 'taol190799', 'emreyilmazel1996', 'rhamwey', 'evelyn.f1975', 'haticeterzibali', 'xavier160mg', 'berksaldr', 'njgarcia5', 'jayopp32', 'jarellano1204', 'muvafikmelikkaya', 'gullit0725', 'jasmine43.jp', 'irem.karagoz33', 'rebecasalcido', 'jatin.us', 'esuna006', 'haoliu', 'aayushik', 'emre.ibil', 'burakbeyazt', 'testeremre70', 'ezelbilgili', 'anilboran0671', 'bryang511', 'yamakonurcan', 'yorumhesabimsa', 'kodaar', 'carlosquinonez80', 'sai.ssm', 'zilmidegne', 'michaelpov', 'anand.satyam', 'berkc', 'selinyasaci98', 'orancagdas', 'ninad.ps', 'sonerkar', 'tugbakoyuncu99', 'yusmar', 'kaankuncak', 'ulises98', 'kagankilicaslan28', 'petersan901', 'yasinzgen']",7,"['talayhalil2626', 'serhatkahraman183', 'emircansimsek', '86kemal86', 'ataozirmak', 'behlul', None]",215,"['mgk816', 'cmergil39', 'mcsonic', 'prosdocimi.m', 'dleon3', 'yunusyeo768', 'evren_aydin6', 'mtakcali', 'emreoney', 'mapayan5', 'swarupadhyay777', 'esulekaplan', 'kenanke', 'fztrnetflix', 'nsener45', 'ekin.gezer', 'joker632455', 'ganesh25', 'okanozkann95', 'murattdo', 'roy227', 'ezelbilgili42', 'burak.baha00', 'youlianafouad17', 'salvalenzuela12', 'isma', 'metobomm', 'enesdinler1', 'ataozirmak', 'krishna.mp', 'behlul', 'jmoya5', 'almelnz2005', 'fjduran3', 'sarawaelahmed22', 'ryckmonster', 'macolmenero', 'bsanchez', 'venkitesh.s', 'garfon61', 'nnurceylan95', 'w.edgarfamous', 'furkan069906', 'arivera35', 'agmendez14', 'alex10', 'talayhalil2626', 'jozrik', 'omerdmrc16', 'bertansafak', 'ajortega6', 'zeynep', 'mahmutcanki', '86kemal86', 'mstff.1clkk', 'kumar_shubham', 'mmozcan4', 'alibatuhanozturk', 'jadelira201', 'arif.ozkan5806', 'karpuz', 'sigalam', 'shrreya07', 'blogan', 'esraboran71', 'mseyfullahcelik', 'chrisodomx', 'kagangunes10', '1967hamzausta', 'dmitry.stor', 'goknur.derinoz', 'garciaje34454', 'afurkanbudak42', 'ufuk', 'diaz.carlos4499', 'kemre9827', 'scopigno', 'brs21', 'nikharv.19110125', 'halilibrahimtiken', 'ege.ert7', 'fdominguez6', 'ademfurkan', 'havvafatmaozbay', 'sayed.aftabahmad786', 'gtzintzarov', 'mehmetaliyas1998', 'ceydabayrak581', 'elembengisu', 'ferhbk97', 'dblancarte', 'mmb', 'utkubala63', None, 'mertisleyen96', 'iremnurfiliz', 'dragon28540', 'elifindir', 'sebastiangarcia695', 'koningmehmet', 'serhatiseri', 'shaawanalmutairi', 'aadelgado4', 'jagallegos7', 'altinbasnurcan09', 'druiz20', 'pongbrayan', 'bmendoza4', 'mustafa.kaya0798507', 'pmhernandez4', 'paras128', 'klc.mrt.1926', 'windl', 'rmartinez5', 'lerner', 'banoth.dinesh', 'furkan2072', 'fatihyorgun1996', 'sai.mrr', 'drhodges', 'simayozbay', 'erencanarslan70', 'choudhary_s', 'emregonen', 'murat.ozeee', 'anurag_kurle', 'emrecitakk', 'ardelarosa', 'yash.mh', 'furkan552senturk', 'shashi.sarraf', 'mehmettasdelen26', 'kanwat.pranav', 'cancetinkaya1201', 'saineeth', 'sflt317', 'ncmagra54', 'aileyvaa', 'mustafayigitesen', 'uzunnurdan', 'eliffsu.koc', 'halilalp', 'jessica.satyarthi', 'serhatkahraman183', 'ensarerol26', 'klayydar', 'azazimalii', 'gurhankopcaz', 'jyothishjaggarapu225', 'anjaligawai', 'naveen143', 'abcd5454', 'kaanbjk27', 'erdicany', 'alikanadli7', 'serdememen', 'jessgomez100', 'tolga.ozyurt24', 'ozcanguclu', 'dhyanasivadas311', 'blassselva', 'wuizar99', 'ozcankutlu15', 'funsal', 'sabriyebayrakcinur', 'mumi1478', 'veyseleee123', 'kingkireeti', 'taol190799', 'emreyilmazel1996', 'rhamwey', 'evelyn.f1975', 'haticeterzibali', 'xavier160mg', 'berksaldr', 'emircansimsek', 'njgarcia5', 'jayopp32', 'jarellano1204', 'muvafikmelikkaya', 'gullit0725', 'jasmine43.jp', 'mrgiraffe', 'irem.karagoz33', 'rebecasalcido', 'jatin.us', 'esuna006', 'haoliu', 'aayushik', 'emre.ibil', 'burakbeyazt', 'testeremre70', 'ezelbilgili', 'anilboran0671', 'bryang511', 'yamakonurcan', 'yorumhesabimsa', 'kodaar', 'carlosquinonez80', 'sai.ssm', 'zilmidegne', 'michaelpov', 'anand.satyam', 'berkc', 'selinyasaci98', 'orancagdas', 'ninad.ps', 'sonerkar', 'tugbakoyuncu99', 'yusmar', 'kaankuncak', 'ulises98', 'kagankilicaslan28', 'petersan901', 'yasinzgen']"
3,171,209,13,4,"['simayozbay', 'orancagdas', 'mahmutcanki', 'arif.ozkan5806']",204,"['mgk816', 'cmergil39', 'mcsonic', 'prosdocimi.m', 'dleon3', 'yunusyeo768', 'evren_aydin6', 'mtakcali', 'emreoney', 'mapayan5', 'swarupadhyay777', 'esulekaplan', 'kenanke', 'fztrnetflix', 'nsener45', 'ekin.gezer', 'joker632455', 'ganesh25', 'okanozkann95', 'murattdo', 'roy227', 'ezelbilgili42', 'burak.baha00', 'youlianafouad17', 'salvalenzuela12', 'isma', 'metobomm', 'enesdinler1', 'krishna.mp', 'jmoya5', 'almelnz2005', 'fjduran3', 'sarawaelahmed22', 'ryckmonster', 'macolmenero', 'bsanchez', 'venkitesh.s', 'garfon61', 'nnurceylan95', 'w.edgarfamous', 'furkan069906', 'arivera35', 'agmendez14', 'alex10', 'jozrik', 'omerdmrc16', 'bertansafak', 'ajortega6', 'zeynep', 'mstff.1clkk', 'kumar_shubham', 'mmozcan4', 'alibatuhanozturk', 'jadelira201', 'karpuz', 'sigalam', 'shrreya07', 'blogan', 'esraboran71', 'mseyfullahcelik', 'chrisodomx', 'kagangunes10', '1967hamzausta', 'dmitry.stor', 'goknur.derinoz', 'garciaje34454', 'afurkanbudak42', 'ufuk', 'diaz.carlos4499', 'kemre9827', 'scopigno', 'brs21', 'nikharv.19110125', 'halilibrahimtiken', 'ege.ert7', 'fdominguez6', 'ademfurkan', 'havvafatmaozbay', 'sayed.aftabahmad786', 'gtzintzarov', 'mehmetaliyas1998', 'ceydabayrak581', 'elembengisu', 'ferhbk97', 'dblancarte', 'mmb', 'utkubala63', 'mertisleyen96', 'iremnurfiliz', 'dragon28540', 'elifindir', 'sebastiangarcia695', 'koningmehmet', 'serhatiseri', 'shaawanalmutairi', 'aadelgado4', 'jagallegos7', 'altinbasnurcan09', 'druiz20', 'pongbrayan', 'bmendoza4', 'mustafa.kaya0798507', 'pmhernandez4', 'paras128', 'klc.mrt.1926', 'windl', 'rmartinez5', 'lerner', 'banoth.dinesh', 'furkan2072', 'fatihyorgun1996', 'sai.mrr', 'drhodges', 'erencanarslan70', 'choudhary_s', 'emregonen', 'murat.ozeee', 'anurag_kurle', 'emrecitakk', 'ardelarosa', 'yash.mh', 'furkan552senturk', 'shashi.sarraf', 'mehmettasdelen26', 'kanwat.pranav', 'cancetinkaya1201', 'saineeth', 'sflt317', 'ncmagra54', 'aileyvaa', 'mustafayigitesen', 'uzunnurdan', 'eliffsu.koc', 'halilalp', 'jessica.satyarthi', 'ensarerol26', 'klayydar', 'azazimalii', 'gurhankopcaz', 'jyothishjaggarapu225', 'anjaligawai', 'naveen143', 'abcd5454', 'kaanbjk27', 'erdicany', 'alikanadli7', 'serdememen', 'jessgomez100', 'tolga.ozyurt24', 'ozcanguclu', 'dhyanasivadas311', 'blassselva', 'wuizar99', 'ozcankutlu15', 'funsal', 'sabriyebayrakcinur', 'mumi1478', 'veyseleee123', 'kingkireeti', 'taol190799', 'emreyilmazel1996', 'rhamwey', 'evelyn.f1975', 'haticeterzibali', 'xavier160mg', 'berksaldr', 'njgarcia5', 'jayopp32', 'jarellano1204', 'muvafikmelikkaya', 'gullit0725', 'jasmine43.jp', 'mrgiraffe', 'irem.karagoz33', 'rebecasalcido', 'jatin.us', 'esuna006', 'haoliu', 'aayushik', 'emre.ibil', 'burakbeyazt', 'testeremre70', 'ezelbilgili', 'anilboran0671', 'bryang511', 'yamakonurcan', 'yorumhesabimsa', 'kodaar', 'carlosquinonez80', 'sai.ssm', 'zilmidegne', 'michaelpov', 'anand.satyam', 'berkc', 'selinyasaci98', 'ninad.ps', 'sonerkar', 'tugbakoyuncu99', 'yusmar', 'kaankuncak', 'ulises98', 'kagankilicaslan28', 'petersan901', 'yasinzgen']",9,"['ern2323', 'kaayaa40', 'isiilhocek', 'atakanerdogann1', 'aydin', 'atibolemi', 'stsaw97', 'slamshottr', None]",217,"['mgk816', 'cmergil39', 'aydin', 'mcsonic', 'prosdocimi.m', 'dleon3', 'yunusyeo768', 'evren_aydin6', 'mtakcali', 'emreoney', 'mapayan5', 'swarupadhyay777', 'esulekaplan', 'kenanke', 'fztrnetflix', 'nsener45', 'ekin.gezer', 'joker632455', 'ganesh25', 'okanozkann95', 'murattdo', 'roy227', 'ezelbilgili42', 'burak.baha00', 'youlianafouad17', 'salvalenzuela12', 'isma', 'metobomm', 'enesdinler1', 'krishna.mp', 'jmoya5', 'almelnz2005', 'fjduran3', 'sarawaelahmed22', 'ryckmonster', 'macolmenero', 'bsanchez', 'venkitesh.s', 'garfon61', 'nnurceylan95', 'w.edgarfamous', 'furkan069906', 'arivera35', 'agmendez14', 'alex10', 'jozrik', 'omerdmrc16', 'bertansafak', 'ajortega6', 'zeynep', 'mahmutcanki', 'mstff.1clkk', 'kumar_shubham', 'mmozcan4', 'alibatuhanozturk', 'jadelira201', 'arif.ozkan5806', 'karpuz', 'atakanerdogann1', 'sigalam', 'shrreya07', 'blogan', 'esraboran71', 'mseyfullahcelik', 'chrisodomx', 'kagangunes10', '1967hamzausta', 'dmitry.stor', 'goknur.derinoz', 'garciaje34454', 'afurkanbudak42', 'ufuk', 'diaz.carlos4499', 'kemre9827', 'scopigno', 'brs21', 'nikharv.19110125', 'halilibrahimtiken', 'ege.ert7', 'fdominguez6', 'ademfurkan', 'havvafatmaozbay', 'sayed.aftabahmad786', 'gtzintzarov', 'mehmetaliyas1998', 'ceydabayrak581', 'elembengisu', 'ferhbk97', 'dblancarte', 'mmb', 'stsaw97', 'utkubala63', None, 'mertisleyen96', 'iremnurfiliz', 'dragon28540', 'elifindir', 'sebastiangarcia695', 'koningmehmet', 'serhatiseri', 'shaawanalmutairi', 'aadelgado4', 'jagallegos7', 'altinbasnurcan09', 'druiz20', 'pongbrayan', 'bmendoza4', 'mustafa.kaya0798507', 'pmhernandez4', 'paras128', 'klc.mrt.1926', 'windl', 'rmartinez5', 'lerner', 'banoth.dinesh', 'furkan2072', 'fatihyorgun1996', 'sai.mrr', 'drhodges', 'simayozbay', 'erencanarslan70', 'kaayaa40', 'choudhary_s', 'emregonen', 'murat.ozeee', 'slamshottr', 'anurag_kurle', 'emrecitakk', 'ardelarosa', 'yash.mh', 'furkan552senturk', 'shashi.sarraf', 'mehmettasdelen26', 'kanwat.pranav', 'cancetinkaya1201', 'saineeth', 'sflt317', 'ncmagra54', 'aileyvaa', 'mustafayigitesen', 'uzunnurdan', 'ern2323', 'eliffsu.koc', 'halilalp', 'jessica.satyarthi', 'ensarerol26', 'klayydar', 'azazimalii', 'gurhankopcaz', 'jyothishjaggarapu225', 'anjaligawai', 'naveen143', 'abcd5454', 'kaanbjk27', 'erdicany', 'alikanadli7', 'serdememen', 'jessgomez100', 'tolga.ozyurt24', 'ozcanguclu', 'dhyanasivadas311', 'isiilhocek', 'blassselva', 'atibolemi', 'wuizar99', 'ozcankutlu15', 'funsal', 'sabriyebayrakcinur', 'mumi1478', 'veyseleee123', 'kingkireeti', 'taol190799', 'emreyilmazel1996', 'rhamwey', 'evelyn.f1975', 'haticeterzibali', 'xavier160mg', 'berksaldr', 'njgarcia5', 'jayopp32', 'jarellano1204', 'muvafikmelikkaya', 'gullit0725', 'jasmine43.jp', 'mrgiraffe', 'irem.karagoz33', 'rebecasalcido', 'jatin.us', 'esuna006', 'haoliu', 'aayushik', 'emre.ibil', 'burakbeyazt', 'testeremre70', 'ezelbilgili', 'anilboran0671', 'bryang511', 'yamakonurcan', 'yorumhesabimsa', 'kodaar', 'carlosquinonez80', 'sai.ssm', 'zilmidegne', 'michaelpov', 'anand.satyam', 'berkc', 'selinyasaci98', 'orancagdas', 'ninad.ps', 'sonerkar', 'tugbakoyuncu99', 'yusmar', 'kaankuncak', 'ulises98', 'kagankilicaslan28', 'petersan901', 'yasinzgen']"
3,377,209,13,1,['naveen143'],207,"['mgk816', 'cmergil39', 'mcsonic', 'prosdocimi.m', 'dleon3', 'yunusyeo768', 'evren_aydin6', 'mtakcali', 'emreoney', 'mapayan5', 'swarupadhyay777', 'esulekaplan', 'kenanke', 'fztrnetflix', 'nsener45', 'ekin.gezer', 'joker632455', 'ganesh25', 'okanozkann95', 'murattdo', 'roy227', 'ezelbilgili42', 'burak.baha00', 'youlianafouad17', 'salvalenzuela12', 'isma', 'metobomm', 'enesdinler1', 'krishna.mp', 'jmoya5', 'almelnz2005', 'fjduran3', 'sarawaelahmed22', 'ryckmonster', 'macolmenero', 'bsanchez', 'venkitesh.s', 'garfon61', 'nnurceylan95', 'w.edgarfamous', 'furkan069906', 'arivera35', 'agmendez14', 'alex10', 'jozrik', 'omerdmrc16', 'bertansafak', 'ajortega6', 'zeynep', 'mahmutcanki', 'mstff.1clkk', 'kumar_shubham', 'mmozcan4', 'alibatuhanozturk', 'jadelira201', 'arif.ozkan5806', 'karpuz', 'sigalam', 'shrreya07', 'blogan', 'esraboran71', 'mseyfullahcelik', 'chrisodomx', 'kagangunes10', '1967hamzausta', 'dmitry.stor', 'goknur.derinoz', 'garciaje34454', 'afurkanbudak42', 'ufuk', 'diaz.carlos4499', 'kemre9827', 'scopigno', 'brs21', 'nikharv.19110125', 'halilibrahimtiken', 'ege.ert7', 'fdominguez6', 'ademfurkan', 'havvafatmaozbay', 'sayed.aftabahmad786', 'gtzintzarov', 'mehmetaliyas1998', 'ceydabayrak581', 'elembengisu', 'ferhbk97', 'dblancarte', 'mmb', 'utkubala63', 'mertisleyen96', 'iremnurfiliz', 'dragon28540', 'elifindir', 'sebastiangarcia695', 'koningmehmet', 'serhatiseri', 'shaawanalmutairi', 'aadelgado4', 'jagallegos7', 'altinbasnurcan09', 'druiz20', 'pongbrayan', 'bmendoza4', 'mustafa.kaya0798507', 'pmhernandez4', 'paras128', 'klc.mrt.1926', 'windl', 'rmartinez5', 'lerner', 'banoth.dinesh', 'furkan2072', 'fatihyorgun1996', 'sai.mrr', 'drhodges', 'simayozbay', 'erencanarslan70', 'choudhary_s', 'emregonen', 'murat.ozeee', 'anurag_kurle', 'emrecitakk', 'ardelarosa', 'yash.mh', 'furkan552senturk', 'shashi.sarraf', 'mehmettasdelen26', 'kanwat.pranav', 'cancetinkaya1201', 'saineeth', 'sflt317', 'ncmagra54', 'aileyvaa', 'mustafayigitesen', 'uzunnurdan', 'eliffsu.koc', 'halilalp', 'jessica.satyarthi', 'ensarerol26', 'klayydar', 'azazimalii', 'gurhankopcaz', 'jyothishjaggarapu225', 'anjaligawai', 'abcd5454', 'kaanbjk27', 'erdicany', 'alikanadli7', 'serdememen', 'jessgomez100', 'tolga.ozyurt24', 'ozcanguclu', 'dhyanasivadas311', 'blassselva', 'wuizar99', 'ozcankutlu15', 'funsal', 'sabriyebayrakcinur', 'mumi1478', 'veyseleee123', 'kingkireeti', 'taol190799', 'emreyilmazel1996', 'rhamwey', 'evelyn.f1975', 'haticeterzibali', 'xavier160mg', 'berksaldr', 'njgarcia5', 'jayopp32', 'jarellano1204', 'muvafikmelikkaya', 'gullit0725', 'jasmine43.jp', 'mrgiraffe', 'irem.karagoz33', 'rebecasalcido', 'jatin.us', 'esuna006', 'haoliu', 'aayushik', 'emre.ibil', 'burakbeyazt', 'testeremre70', 'ezelbilgili', 'anilboran0671', 'bryang511', 'yamakonurcan', 'yorumhesabimsa', 'kodaar', 'carlosquinonez80', 'sai.ssm', 'zilmidegne', 'michaelpov', 'anand.satyam', 'berkc', 'selinyasaci98', 'orancagdas', 'ninad.ps', 'sonerkar', 'tugbakoyuncu99', 'yusmar', 'kaankuncak', 'ulises98', 'kagankilicaslan28', 'petersan901', 'yasinzgen']",12,"['venkatesh960', 'thirupathiraomeesala5', 'ganeshpasupuleti2000', 'mansur', 'valaparthi', 'jammigunpulasrinivasarao', 'surendramadhiboyina1215', 'srujan1218', 'atlapragna', 'puneeth5136', 'chennareddy', None]",220,"['mgk816', 'cmergil39', 'mcsonic', 'prosdocimi.m', 'dleon3', 'yunusyeo768', 'evren_aydin6', 'mtakcali', 'emreoney', 'mapayan5', 'swarupadhyay777', 'esulekaplan', 'kenanke', 'fztrnetflix', 'nsener45', 'ekin.gezer', 'joker632455', 'ganesh25', 'okanozkann95', 'murattdo', 'roy227', 'ezelbilgili42', 'burak.baha00', 'youlianafouad17', 'salvalenzuela12', 'isma', 'metobomm', 'enesdinler1', 'krishna.mp', 'jmoya5', 'almelnz2005', 'fjduran3', 'sarawaelahmed22', 'ryckmonster', 'macolmenero', 'thirupathiraomeesala5', 'bsanchez', 'venkitesh.s', 'garfon61', 'nnurceylan95', 'w.edgarfamous', 'furkan069906', 'srujan1218', 'arivera35', 'agmendez14', 'alex10', 'jozrik', 'omerdmrc16', 'surendramadhiboyina1215', 'bertansafak', 'ajortega6', 'zeynep', 'mahmutcanki', 'mstff.1clkk', 'atlapragna', 'puneeth5136', 'kumar_shubham', 'mmozcan4', 'alibatuhanozturk', 'jadelira201', 'arif.ozkan5806', 'karpuz', 'sigalam', 'shrreya07', 'blogan', 'esraboran71', 'mseyfullahcelik', 'chrisodomx', 'kagangunes10', '1967hamzausta', 'dmitry.stor', 'goknur.derinoz', 'garciaje34454', 'afurkanbudak42', 'ufuk', 'diaz.carlos4499', 'kemre9827', 'scopigno', 'brs21', 'nikharv.19110125', 'halilibrahimtiken', 'ege.ert7', 'fdominguez6', 'ademfurkan', 'havvafatmaozbay', 'sayed.aftabahmad786', 'gtzintzarov', 'mehmetaliyas1998', 'ceydabayrak581', 'elembengisu', 'ferhbk97', 'dblancarte', 'mmb', 'utkubala63', None, 'mertisleyen96', 'iremnurfiliz', 'dragon28540', 'elifindir', 'jammigunpulasrinivasarao', 'sebastiangarcia695', 'koningmehmet', 'serhatiseri', 'shaawanalmutairi', 'aadelgado4', 'jagallegos7', 'altinbasnurcan09', 'druiz20', 'pongbrayan', 'bmendoza4', 'mustafa.kaya0798507', 'pmhernandez4', 'paras128', 'klc.mrt.1926', 'windl', 'rmartinez5', 'lerner', 'banoth.dinesh', 'furkan2072', 'fatihyorgun1996', 'sai.mrr', 'drhodges', 'simayozbay', 'erencanarslan70', 'choudhary_s', 'emregonen', 'murat.ozeee', 'anurag_kurle', 'emrecitakk', 'ardelarosa', 'yash.mh', 'furkan552senturk', 'shashi.sarraf', 'mehmettasdelen26', 'kanwat.pranav', 'cancetinkaya1201', 'saineeth', 'sflt317', 'ncmagra54', 'aileyvaa', 'mustafayigitesen', 'uzunnurdan', 'eliffsu.koc', 'halilalp', 'jessica.satyarthi', 'mansur', 'ensarerol26', 'klayydar', 'azazimalii', 'gurhankopcaz', 'jyothishjaggarapu225', 'anjaligawai', 'naveen143', 'abcd5454', 'kaanbjk27', 'erdicany', 'alikanadli7', 'serdememen', 'jessgomez100', 'tolga.ozyurt24', 'ozcanguclu', 'dhyanasivadas311', 'ganeshpasupuleti2000', 'blassselva', 'wuizar99', 'ozcankutlu15', 'funsal', 'sabriyebayrakcinur', 'mumi1478', 'veyseleee123', 'kingkireeti', 'taol190799', 'emreyilmazel1996', 'chennareddy', 'venkatesh960', 'rhamwey', 'evelyn.f1975', 'haticeterzibali', 'xavier160mg', 'berksaldr', 'valaparthi', 'njgarcia5', 'jayopp32', 'jarellano1204', 'muvafikmelikkaya', 'gullit0725', 'jasmine43.jp', 'mrgiraffe', 'irem.karagoz33', 'rebecasalcido', 'jatin.us', 'esuna006', 'haoliu', 'aayushik', 'emre.ibil', 'burakbeyazt', 'testeremre70', 'ezelbilgili', 'anilboran0671', 'bryang511', 'yamakonurcan', 'yorumhesabimsa', 'kodaar', 'carlosquinonez80', 'sai.ssm', 'zilmidegne', 'michaelpov', 'anand.satyam', 'berkc', 'selinyasaci98', 'orancagdas', 'ninad.ps', 'sonerkar', 'tugbakoyuncu99', 'yusmar', 'kaankuncak', 'ulises98', 'kagankilicaslan28', 'petersan901', 'yasinzgen']"
3,137,209,11,1,['jayopp32'],207,"['mgk816', 'cmergil39', 'mcsonic', 'prosdocimi.m', 'dleon3', 'yunusyeo768', 'evren_aydin6', 'mtakcali', 'emreoney', 'mapayan5', 'swarupadhyay777', 'esulekaplan', 'kenanke', 'fztrnetflix', 'nsener45', 'ekin.gezer', 'joker632455', 'ganesh25', 'okanozkann95', 'murattdo', 'roy227', 'ezelbilgili42', 'burak.baha00', 'youlianafouad17', 'salvalenzuela12', 'isma', 'metobomm', 'enesdinler1', 'krishna.mp', 'jmoya5', 'almelnz2005', 'fjduran3', 'sarawaelahmed22', 'ryckmonster', 'macolmenero', 'bsanchez', 'venkitesh.s', 'garfon61', 'nnurceylan95', 'w.edgarfamous', 'furkan069906', 'arivera35', 'agmendez14', 'alex10', 'jozrik', 'omerdmrc16', 'bertansafak', 'ajortega6', 'zeynep', 'mahmutcanki', 'mstff.1clkk', 'kumar_shubham', 'mmozcan4', 'alibatuhanozturk', 'jadelira201', 'arif.ozkan5806', 'karpuz', 'sigalam', 'shrreya07', 'blogan', 'esraboran71', 'mseyfullahcelik', 'chrisodomx', 'kagangunes10', '1967hamzausta', 'dmitry.stor', 'goknur.derinoz', 'garciaje34454', 'afurkanbudak42', 'ufuk', 'diaz.carlos4499', 'kemre9827', 'scopigno', 'brs21', 'nikharv.19110125', 'halilibrahimtiken', 'ege.ert7', 'fdominguez6', 'ademfurkan', 'havvafatmaozbay', 'sayed.aftabahmad786', 'gtzintzarov', 'mehmetaliyas1998', 'ceydabayrak581', 'elembengisu', 'ferhbk97', 'dblancarte', 'mmb', 'utkubala63', 'mertisleyen96', 'iremnurfiliz', 'dragon28540', 'elifindir', 'sebastiangarcia695', 'koningmehmet', 'serhatiseri', 'shaawanalmutairi', 'aadelgado4', 'jagallegos7', 'altinbasnurcan09', 'druiz20', 'pongbrayan', 'bmendoza4', 'mustafa.kaya0798507', 'pmhernandez4', 'paras128', 'klc.mrt.1926', 'windl', 'rmartinez5', 'lerner', 'banoth.dinesh', 'furkan2072', 'fatihyorgun1996', 'sai.mrr', 'drhodges', 'simayozbay', 'erencanarslan70', 'choudhary_s', 'emregonen', 'murat.ozeee', 'anurag_kurle', 'emrecitakk', 'ardelarosa', 'yash.mh', 'furkan552senturk', 'shashi.sarraf', 'mehmettasdelen26', 'kanwat.pranav', 'cancetinkaya1201', 'saineeth', 'sflt317', 'ncmagra54', 'aileyvaa', 'mustafayigitesen', 'uzunnurdan', 'eliffsu.koc', 'halilalp', 'jessica.satyarthi', 'ensarerol26', 'klayydar', 'azazimalii', 'gurhankopcaz', 'jyothishjaggarapu225', 'anjaligawai', 'naveen143', 'abcd5454', 'kaanbjk27', 'erdicany', 'alikanadli7', 'serdememen', 'jessgomez100', 'tolga.ozyurt24', 'ozcanguclu', 'dhyanasivadas311', 'blassselva', 'wuizar99', 'ozcankutlu15', 'funsal', 'sabriyebayrakcinur', 'mumi1478', 'veyseleee123', 'kingkireeti', 'taol190799', 'emreyilmazel1996', 'rhamwey', 'evelyn.f1975', 'haticeterzibali', 'xavier160mg', 'berksaldr', 'njgarcia5', 'jarellano1204', 'muvafikmelikkaya', 'gullit0725', 'jasmine43.jp', 'mrgiraffe', 'irem.karagoz33', 'rebecasalcido', 'jatin.us', 'esuna006', 'haoliu', 'aayushik', 'emre.ibil', 'burakbeyazt', 'testeremre70', 'ezelbilgili', 'anilboran0671', 'bryang511', 'yamakonurcan', 'yorumhesabimsa', 'kodaar', 'carlosquinonez80', 'sai.ssm', 'zilmidegne', 'michaelpov', 'anand.satyam', 'berkc', 'selinyasaci98', 'orancagdas', 'ninad.ps', 'sonerkar', 'tugbakoyuncu99', 'yusmar', 'kaankuncak', 'ulises98', 'kagankilicaslan28', 'petersan901', 'yasinzgen']",10,"['edgarm120397', 'qahoang', 'abarzabar', 'ml3566', 'twcross11', 'gedaliakoehler', 'tcp47', 'nicolech73', 'kevinh88', None]",218,"['mgk816', 'cmergil39', 'mcsonic', 'prosdocimi.m', 'dleon3', 'yunusyeo768', 'evren_aydin6', 'mtakcali', 'emreoney', 'mapayan5', 'swarupadhyay777', 'esulekaplan', 'kenanke', 'fztrnetflix', 'nsener45', 'ekin.gezer', 'joker632455', 'ganesh25', 'twcross11', 'okanozkann95', 'murattdo', 'kevinh88', 'roy227', 'ezelbilgili42', 'burak.baha00', 'youlianafouad17', 'salvalenzuela12', 'isma', 'metobomm', 'enesdinler1', 'krishna.mp', 'jmoya5', 'almelnz2005', 'fjduran3', 'sarawaelahmed22', 'ryckmonster', 'macolmenero', 'bsanchez', 'venkitesh.s', 'garfon61', 'nnurceylan95', 'w.edgarfamous', 'furkan069906', 'nicolech73', 'arivera35', 'agmendez14', 'alex10', 'jozrik', 'omerdmrc16', 'bertansafak', 'ajortega6', 'zeynep', 'mahmutcanki', 'mstff.1clkk', 'kumar_shubham', 'mmozcan4', 'alibatuhanozturk', 'jadelira201', 'arif.ozkan5806', 'karpuz', 'sigalam', 'shrreya07', 'blogan', 'esraboran71', 'mseyfullahcelik', 'chrisodomx', 'kagangunes10', '1967hamzausta', 'dmitry.stor', 'goknur.derinoz', 'garciaje34454', 'afurkanbudak42', 'ufuk', 'diaz.carlos4499', 'kemre9827', 'scopigno', 'brs21', 'nikharv.19110125', 'halilibrahimtiken', 'ege.ert7', 'fdominguez6', 'ademfurkan', 'havvafatmaozbay', 'sayed.aftabahmad786', 'gtzintzarov', 'mehmetaliyas1998', 'ceydabayrak581', 'elembengisu', 'ferhbk97', 'dblancarte', 'mmb', 'utkubala63', None, 'mertisleyen96', 'iremnurfiliz', 'dragon28540', 'elifindir', 'sebastiangarcia695', 'koningmehmet', 'serhatiseri', 'shaawanalmutairi', 'aadelgado4', 'jagallegos7', 'altinbasnurcan09', 'druiz20', 'pongbrayan', 'bmendoza4', 'mustafa.kaya0798507', 'pmhernandez4', 'paras128', 'klc.mrt.1926', 'windl', 'rmartinez5', 'lerner', 'banoth.dinesh', 'furkan2072', 'fatihyorgun1996', 'sai.mrr', 'drhodges', 'simayozbay', 'erencanarslan70', 'ml3566', 'choudhary_s', 'emregonen', 'murat.ozeee', 'anurag_kurle', 'emrecitakk', 'ardelarosa', 'yash.mh', 'abarzabar', 'furkan552senturk', 'shashi.sarraf', 'mehmettasdelen26', 'kanwat.pranav', 'cancetinkaya1201', 'saineeth', 'sflt317', 'ncmagra54', 'aileyvaa', 'mustafayigitesen', 'uzunnurdan', 'eliffsu.koc', 'halilalp', 'jessica.satyarthi', 'ensarerol26', 'klayydar', 'azazimalii', 'tcp47', 'gurhankopcaz', 'jyothishjaggarapu225', 'anjaligawai', 'naveen143', 'abcd5454', 'kaanbjk27', 'erdicany', 'alikanadli7', 'serdememen', 'jessgomez100', 'tolga.ozyurt24', 'qahoang', 'ozcanguclu', 'dhyanasivadas311', 'blassselva', 'wuizar99', 'ozcankutlu15', 'funsal', 'sabriyebayrakcinur', 'mumi1478', 'veyseleee123', 'kingkireeti', 'taol190799', 'emreyilmazel1996', 'rhamwey', 'evelyn.f1975', 'haticeterzibali', 'xavier160mg', 'berksaldr', 'njgarcia5', 'gedaliakoehler', 'jayopp32', 'jarellano1204', 'muvafikmelikkaya', 'gullit0725', 'jasmine43.jp', 'mrgiraffe', 'irem.karagoz33', 'rebecasalcido', 'jatin.us', 'esuna006', 'edgarm120397', 'haoliu', 'aayushik', 'emre.ibil', 'burakbeyazt', 'testeremre70', 'ezelbilgili', 'anilboran0671', 'bryang511', 'yamakonurcan', 'yorumhesabimsa', 'kodaar', 'carlosquinonez80', 'sai.ssm', 'zilmidegne', 'michaelpov', 'anand.satyam', 'berkc', 'selinyasaci98', 'orancagdas', 'ninad.ps', 'sonerkar', 'tugbakoyuncu99', 'yusmar', 'kaankuncak', 'ulises98', 'kagankilicaslan28', 'petersan901', 'yasinzgen']"
3,391,209,11,8,"['jatin.us', 'sai.ssm', 'jessica.satyarthi', 'anand.satyam', 'choudhary_s', 'nikharv.19110125', 'anjaligawai', 'swarupadhyay777']",200,"['mgk816', 'cmergil39', 'mcsonic', 'prosdocimi.m', 'dleon3', 'yunusyeo768', 'evren_aydin6', 'mtakcali', 'emreoney', 'mapayan5', 'esulekaplan', 'kenanke', 'fztrnetflix', 'nsener45', 'ekin.gezer', 'joker632455', 'ganesh25', 'okanozkann95', 'murattdo', 'roy227', 'ezelbilgili42', 'burak.baha00', 'youlianafouad17', 'salvalenzuela12', 'isma', 'metobomm', 'enesdinler1', 'krishna.mp', 'jmoya5', 'almelnz2005', 'fjduran3', 'sarawaelahmed22', 'ryckmonster', 'macolmenero', 'bsanchez', 'venkitesh.s', 'garfon61', 'nnurceylan95', 'w.edgarfamous', 'furkan069906', 'arivera35', 'agmendez14', 'alex10', 'jozrik', 'omerdmrc16', 'bertansafak', 'ajortega6', 'zeynep', 'mahmutcanki', 'mstff.1clkk', 'kumar_shubham', 'mmozcan4', 'alibatuhanozturk', 'jadelira201', 'arif.ozkan5806', 'karpuz', 'sigalam', 'shrreya07', 'blogan', 'esraboran71', 'mseyfullahcelik', 'chrisodomx', 'kagangunes10', '1967hamzausta', 'dmitry.stor', 'goknur.derinoz', 'garciaje34454', 'afurkanbudak42', 'ufuk', 'diaz.carlos4499', 'kemre9827', 'scopigno', 'brs21', 'halilibrahimtiken', 'ege.ert7', 'fdominguez6', 'ademfurkan', 'havvafatmaozbay', 'sayed.aftabahmad786', 'gtzintzarov', 'mehmetaliyas1998', 'ceydabayrak581', 'elembengisu', 'ferhbk97', 'dblancarte', 'mmb', 'utkubala63', 'mertisleyen96', 'iremnurfiliz', 'dragon28540', 'elifindir', 'sebastiangarcia695', 'koningmehmet', 'serhatiseri', 'shaawanalmutairi', 'aadelgado4', 'jagallegos7', 'altinbasnurcan09', 'druiz20', 'pongbrayan', 'bmendoza4', 'mustafa.kaya0798507', 'pmhernandez4', 'paras128', 'klc.mrt.1926', 'windl', 'rmartinez5', 'lerner', 'banoth.dinesh', 'furkan2072', 'fatihyorgun1996', 'sai.mrr', 'drhodges', 'simayozbay', 'erencanarslan70', 'emregonen', 'murat.ozeee', 'anurag_kurle', 'emrecitakk', 'ardelarosa', 'yash.mh', 'furkan552senturk', 'shashi.sarraf', 'mehmettasdelen26', 'kanwat.pranav', 'cancetinkaya1201', 'saineeth', 'sflt317', 'ncmagra54', 'aileyvaa', 'mustafayigitesen', 'uzunnurdan', 'eliffsu.koc', 'halilalp', 'ensarerol26', 'klayydar', 'azazimalii', 'gurhankopcaz', 'jyothishjaggarapu225', 'naveen143', 'abcd5454', 'kaanbjk27', 'erdicany', 'alikanadli7', 'serdememen', 'jessgomez100', 'tolga.ozyurt24', 'ozcanguclu', 'dhyanasivadas311', 'blassselva', 'wuizar99', 'ozcankutlu15', 'funsal', 'sabriyebayrakcinur', 'mumi1478', 'veyseleee123', 'kingkireeti', 'taol190799', 'emreyilmazel1996', 'rhamwey', 'evelyn.f1975', 'haticeterzibali', 'xavier160mg', 'berksaldr', 'njgarcia5', 'jayopp32', 'jarellano1204', 'muvafikmelikkaya', 'gullit0725', 'jasmine43.jp', 'mrgiraffe', 'irem.karagoz33', 'rebecasalcido', 'esuna006', 'haoliu', 'aayushik', 'emre.ibil', 'burakbeyazt', 'testeremre70', 'ezelbilgili', 'anilboran0671', 'bryang511', 'yamakonurcan', 'yorumhesabimsa', 'kodaar', 'carlosquinonez80', 'zilmidegne', 'michaelpov', 'berkc', 'selinyasaci98', 'orancagdas', 'ninad.ps', 'sonerkar', 'tugbakoyuncu99', 'yusmar', 'kaankuncak', 'ulises98', 'kagankilicaslan28', 'petersan901', 'yasinzgen']",3,"[None, 'kmr_dheeraj', 'dsharda']",211,"['mgk816', 'cmergil39', 'mcsonic', 'prosdocimi.m', 'dleon3', 'yunusyeo768', 'evren_aydin6', 'mtakcali', 'emreoney', 'mapayan5', 'swarupadhyay777', 'esulekaplan', 'kenanke', 'fztrnetflix', 'nsener45', 'ekin.gezer', 'joker632455', 'ganesh25', 'okanozkann95', 'murattdo', 'roy227', 'ezelbilgili42', 'burak.baha00', 'youlianafouad17', 'salvalenzuela12', 'isma', 'metobomm', 'enesdinler1', 'krishna.mp', 'jmoya5', 'almelnz2005', 'fjduran3', 'sarawaelahmed22', 'ryckmonster', 'macolmenero', 'bsanchez', 'venkitesh.s', 'garfon61', 'nnurceylan95', 'w.edgarfamous', 'furkan069906', 'arivera35', 'agmendez14', 'alex10', 'jozrik', 'omerdmrc16', 'bertansafak', 'ajortega6', 'zeynep', 'mahmutcanki', 'mstff.1clkk', 'kumar_shubham', 'mmozcan4', 'alibatuhanozturk', 'jadelira201', 'arif.ozkan5806', 'karpuz', 'sigalam', 'shrreya07', 'blogan', 'esraboran71', 'mseyfullahcelik', 'chrisodomx', 'kagangunes10', '1967hamzausta', 'dmitry.stor', 'goknur.derinoz', 'garciaje34454', 'afurkanbudak42', 'ufuk', 'diaz.carlos4499', 'kemre9827', 'scopigno', 'brs21', 'nikharv.19110125', 'halilibrahimtiken', 'ege.ert7', 'fdominguez6', 'ademfurkan', 'havvafatmaozbay', 'sayed.aftabahmad786', 'gtzintzarov', 'mehmetaliyas1998', 'ceydabayrak581', 'elembengisu', 'ferhbk97', 'dblancarte', 'mmb', 'utkubala63', None, 'mertisleyen96', 'iremnurfiliz', 'dragon28540', 'elifindir', 'sebastiangarcia695', 'koningmehmet', 'serhatiseri', 'shaawanalmutairi', 'aadelgado4', 'jagallegos7', 'altinbasnurcan09', 'druiz20', 'pongbrayan', 'bmendoza4', 'mustafa.kaya0798507', 'pmhernandez4', 'paras128', 'klc.mrt.1926', 'windl', 'rmartinez5', 'lerner', 'banoth.dinesh', 'furkan2072', 'fatihyorgun1996', 'sai.mrr', 'drhodges', 'simayozbay', 'erencanarslan70', 'choudhary_s', 'emregonen', 'murat.ozeee', 'anurag_kurle', 'emrecitakk', 'ardelarosa', 'yash.mh', 'dsharda', 'furkan552senturk', 'shashi.sarraf', 'mehmettasdelen26', 'kanwat.pranav', 'cancetinkaya1201', 'saineeth', 'sflt317', 'ncmagra54', 'aileyvaa', 'mustafayigitesen', 'uzunnurdan', 'eliffsu.koc', 'halilalp', 'jessica.satyarthi', 'ensarerol26', 'klayydar', 'azazimalii', 'gurhankopcaz', 'jyothishjaggarapu225', 'anjaligawai', 'naveen143', 'abcd5454', 'kaanbjk27', 'erdicany', 'alikanadli7', 'serdememen', 'jessgomez100', 'tolga.ozyurt24', 'kmr_dheeraj', 'ozcanguclu', 'dhyanasivadas311', 'blassselva', 'wuizar99', 'ozcankutlu15', 'funsal', 'sabriyebayrakcinur', 'mumi1478', 'veyseleee123', 'kingkireeti', 'taol190799', 'emreyilmazel1996', 'rhamwey', 'evelyn.f1975', 'haticeterzibali', 'xavier160mg', 'berksaldr', 'njgarcia5', 'jayopp32', 'jarellano1204', 'muvafikmelikkaya', 'gullit0725', 'jasmine43.jp', 'mrgiraffe', 'irem.karagoz33', 'rebecasalcido', 'jatin.us', 'esuna006', 'haoliu', 'aayushik', 'emre.ibil', 'burakbeyazt', 'testeremre70', 'ezelbilgili', 'anilboran0671', 'bryang511', 'yamakonurcan', 'yorumhesabimsa', 'kodaar', 'carlosquinonez80', 'sai.ssm', 'zilmidegne', 'michaelpov', 'anand.satyam', 'berkc', 'selinyasaci98', 'orancagdas', 'ninad.ps', 'sonerkar', 'tugbakoyuncu99', 'yusmar', 'kaankuncak', 'ulises98', 'kagankilicaslan28', 'petersan901', 'yasinzgen']"
3,395,209,11,2,"['ganesh25', 'naveen143']",206,"['mgk816', 'cmergil39', 'mcsonic', 'prosdocimi.m', 'dleon3', 'yunusyeo768', 'evren_aydin6', 'mtakcali', 'emreoney', 'mapayan5', 'swarupadhyay777', 'esulekaplan', 'kenanke', 'fztrnetflix', 'nsener45', 'ekin.gezer', 'joker632455', 'okanozkann95', 'murattdo', 'roy227', 'ezelbilgili42', 'burak.baha00', 'youlianafouad17', 'salvalenzuela12', 'isma', 'metobomm', 'enesdinler1', 'krishna.mp', 'jmoya5', 'almelnz2005', 'fjduran3', 'sarawaelahmed22', 'ryckmonster', 'macolmenero', 'bsanchez', 'venkitesh.s', 'garfon61', 'nnurceylan95', 'w.edgarfamous', 'furkan069906', 'arivera35', 'agmendez14', 'alex10', 'jozrik', 'omerdmrc16', 'bertansafak', 'ajortega6', 'zeynep', 'mahmutcanki', 'mstff.1clkk', 'kumar_shubham', 'mmozcan4', 'alibatuhanozturk', 'jadelira201', 'arif.ozkan5806', 'karpuz', 'sigalam', 'shrreya07', 'blogan', 'esraboran71', 'mseyfullahcelik', 'chrisodomx', 'kagangunes10', '1967hamzausta', 'dmitry.stor', 'goknur.derinoz', 'garciaje34454', 'afurkanbudak42', 'ufuk', 'diaz.carlos4499', 'kemre9827', 'scopigno', 'brs21', 'nikharv.19110125', 'halilibrahimtiken', 'ege.ert7', 'fdominguez6', 'ademfurkan', 'havvafatmaozbay', 'sayed.aftabahmad786', 'gtzintzarov', 'mehmetaliyas1998', 'ceydabayrak581', 'elembengisu', 'ferhbk97', 'dblancarte', 'mmb', 'utkubala63', 'mertisleyen96', 'iremnurfiliz', 'dragon28540', 'elifindir', 'sebastiangarcia695', 'koningmehmet', 'serhatiseri', 'shaawanalmutairi', 'aadelgado4', 'jagallegos7', 'altinbasnurcan09', 'druiz20', 'pongbrayan', 'bmendoza4', 'mustafa.kaya0798507', 'pmhernandez4', 'paras128', 'klc.mrt.1926', 'windl', 'rmartinez5', 'lerner', 'banoth.dinesh', 'furkan2072', 'fatihyorgun1996', 'sai.mrr', 'drhodges', 'simayozbay', 'erencanarslan70', 'choudhary_s', 'emregonen', 'murat.ozeee', 'anurag_kurle', 'emrecitakk', 'ardelarosa', 'yash.mh', 'furkan552senturk', 'shashi.sarraf', 'mehmettasdelen26', 'kanwat.pranav', 'cancetinkaya1201', 'saineeth', 'sflt317', 'ncmagra54', 'aileyvaa', 'mustafayigitesen', 'uzunnurdan', 'eliffsu.koc', 'halilalp', 'jessica.satyarthi', 'ensarerol26', 'klayydar', 'azazimalii', 'gurhankopcaz', 'jyothishjaggarapu225', 'anjaligawai', 'abcd5454', 'kaanbjk27', 'erdicany', 'alikanadli7', 'serdememen', 'jessgomez100', 'tolga.ozyurt24', 'ozcanguclu', 'dhyanasivadas311', 'blassselva', 'wuizar99', 'ozcankutlu15', 'funsal', 'sabriyebayrakcinur', 'mumi1478', 'veyseleee123', 'kingkireeti', 'taol190799', 'emreyilmazel1996', 'rhamwey', 'evelyn.f1975', 'haticeterzibali', 'xavier160mg', 'berksaldr', 'njgarcia5', 'jayopp32', 'jarellano1204', 'muvafikmelikkaya', 'gullit0725', 'jasmine43.jp', 'mrgiraffe', 'irem.karagoz33', 'rebecasalcido', 'jatin.us', 'esuna006', 'haoliu', 'aayushik', 'emre.ibil', 'burakbeyazt', 'testeremre70', 'ezelbilgili', 'anilboran0671', 'bryang511', 'yamakonurcan', 'yorumhesabimsa', 'kodaar', 'carlosquinonez80', 'sai.ssm', 'zilmidegne', 'michaelpov', 'anand.satyam', 'berkc', 'selinyasaci98', 'orancagdas', 'ninad.ps', 'sonerkar', 'tugbakoyuncu99', 'yusmar', 'kaankuncak', 'ulises98', 'kagankilicaslan28', 'petersan901', 'yasinzgen']",9,"['venkatesh960', 'thirupathiraomeesala5', 'chennareddym193', 'gummalasainathreddy', 'puneeth5136', 'sakevinay953', 'gkumarreddy', 'imranshaik', None]",217,"['mgk816', 'cmergil39', 'mcsonic', 'prosdocimi.m', 'dleon3', 'yunusyeo768', 'evren_aydin6', 'mtakcali', 'emreoney', 'mapayan5', 'swarupadhyay777', 'esulekaplan', 'kenanke', 'fztrnetflix', 'nsener45', 'ekin.gezer', 'joker632455', 'ganesh25', 'okanozkann95', 'murattdo', 'gkumarreddy', 'roy227', 'ezelbilgili42', 'burak.baha00', 'youlianafouad17', 'salvalenzuela12', 'isma', 'metobomm', 'enesdinler1', 'krishna.mp', 'gummalasainathreddy', 'jmoya5', 'almelnz2005', 'fjduran3', 'sarawaelahmed22', 'ryckmonster', 'macolmenero', 'thirupathiraomeesala5', 'chennareddym193', 'bsanchez', 'venkitesh.s', 'garfon61', 'nnurceylan95', 'w.edgarfamous', 'furkan069906', 'arivera35', 'agmendez14', 'alex10', 'jozrik', 'omerdmrc16', 'bertansafak', 'ajortega6', 'zeynep', 'mahmutcanki', 'mstff.1clkk', 'puneeth5136', 'kumar_shubham', 'mmozcan4', 'alibatuhanozturk', 'jadelira201', 'arif.ozkan5806', 'karpuz', 'sigalam', 'shrreya07', 'blogan', 'esraboran71', 'mseyfullahcelik', 'chrisodomx', 'kagangunes10', '1967hamzausta', 'dmitry.stor', 'goknur.derinoz', 'garciaje34454', 'afurkanbudak42', 'ufuk', 'diaz.carlos4499', 'kemre9827', 'sakevinay953', 'scopigno', 'brs21', 'nikharv.19110125', 'halilibrahimtiken', 'ege.ert7', 'fdominguez6', 'ademfurkan', 'havvafatmaozbay', 'sayed.aftabahmad786', 'gtzintzarov', 'mehmetaliyas1998', 'ceydabayrak581', 'elembengisu', 'ferhbk97', 'dblancarte', 'mmb', 'utkubala63', None, 'mertisleyen96', 'iremnurfiliz', 'dragon28540', 'elifindir', 'sebastiangarcia695', 'koningmehmet', 'serhatiseri', 'shaawanalmutairi', 'aadelgado4', 'jagallegos7', 'altinbasnurcan09', 'druiz20', 'pongbrayan', 'bmendoza4', 'mustafa.kaya0798507', 'pmhernandez4', 'paras128', 'klc.mrt.1926', 'windl', 'rmartinez5', 'lerner', 'banoth.dinesh', 'furkan2072', 'fatihyorgun1996', 'sai.mrr', 'drhodges', 'simayozbay', 'erencanarslan70', 'choudhary_s', 'emregonen', 'murat.ozeee', 'anurag_kurle', 'emrecitakk', 'ardelarosa', 'yash.mh', 'furkan552senturk', 'shashi.sarraf', 'mehmettasdelen26', 'kanwat.pranav', 'cancetinkaya1201', 'saineeth', 'sflt317', 'ncmagra54', 'aileyvaa', 'mustafayigitesen', 'uzunnurdan', 'eliffsu.koc', 'halilalp', 'jessica.satyarthi', 'ensarerol26', 'klayydar', 'azazimalii', 'gurhankopcaz', 'jyothishjaggarapu225', 'anjaligawai', 'naveen143', 'abcd5454', 'kaanbjk27', 'erdicany', 'alikanadli7', 'serdememen', 'jessgomez100', 'tolga.ozyurt24', 'ozcanguclu', 'dhyanasivadas311', 'blassselva', 'wuizar99', 'ozcankutlu15', 'funsal', 'sabriyebayrakcinur', 'mumi1478', 'veyseleee123', 'kingkireeti', 'taol190799', 'emreyilmazel1996', 'venkatesh960', 'rhamwey', 'evelyn.f1975', 'haticeterzibali', 'xavier160mg', 'berksaldr', 'njgarcia5', 'jayopp32', 'jarellano1204', 'muvafikmelikkaya', 'gullit0725', 'jasmine43.jp', 'mrgiraffe', 'irem.karagoz33', 'rebecasalcido', 'jatin.us', 'esuna006', 'haoliu', 'aayushik', 'emre.ibil', 'burakbeyazt', 'testeremre70', 'ezelbilgili', 'anilboran0671', 'bryang511', 'yamakonurcan', 'yorumhesabimsa', 'kodaar', 'carlosquinonez80', 'sai.ssm', 'zilmidegne', 'michaelpov', 'anand.satyam', 'berkc', 'selinyasaci98', 'orancagdas', 'ninad.ps', 'sonerkar', 'tugbakoyuncu99', 'yusmar', 'kaankuncak', 'ulises98', 'kagankilicaslan28', 'imranshaik', 'petersan901', 'yasinzgen']"
3,347,209,10,3,"['taol190799', 'mtakcali', 'ozcanguclu']",205,"['mgk816', 'cmergil39', 'mcsonic', 'prosdocimi.m', 'dleon3', 'yunusyeo768', 'evren_aydin6', 'emreoney', 'mapayan5', 'swarupadhyay777', 'esulekaplan', 'kenanke', 'fztrnetflix', 'nsener45', 'ekin.gezer', 'joker632455', 'ganesh25', 'okanozkann95', 'murattdo', 'roy227', 'ezelbilgili42', 'burak.baha00', 'youlianafouad17', 'salvalenzuela12', 'isma', 'metobomm', 'enesdinler1', 'krishna.mp', 'jmoya5', 'almelnz2005', 'fjduran3', 'sarawaelahmed22', 'ryckmonster', 'macolmenero', 'bsanchez', 'venkitesh.s', 'garfon61', 'nnurceylan95', 'w.edgarfamous', 'furkan069906', 'arivera35', 'agmendez14', 'alex10', 'jozrik', 'omerdmrc16', 'bertansafak', 'ajortega6', 'zeynep', 'mahmutcanki', 'mstff.1clkk', 'kumar_shubham', 'mmozcan4', 'alibatuhanozturk', 'jadelira201', 'arif.ozkan5806', 'karpuz', 'sigalam', 'shrreya07', 'blogan', 'esraboran71', 'mseyfullahcelik', 'chrisodomx', 'kagangunes10', '1967hamzausta', 'dmitry.stor', 'goknur.derinoz', 'garciaje34454', 'afurkanbudak42', 'ufuk', 'diaz.carlos4499', 'kemre9827', 'scopigno', 'brs21', 'nikharv.19110125', 'halilibrahimtiken', 'ege.ert7', 'fdominguez6', 'ademfurkan', 'havvafatmaozbay', 'sayed.aftabahmad786', 'gtzintzarov', 'mehmetaliyas1998', 'ceydabayrak581', 'elembengisu', 'ferhbk97', 'dblancarte', 'mmb', 'utkubala63', 'mertisleyen96', 'iremnurfiliz', 'dragon28540', 'elifindir', 'sebastiangarcia695', 'koningmehmet', 'serhatiseri', 'shaawanalmutairi', 'aadelgado4', 'jagallegos7', 'altinbasnurcan09', 'druiz20', 'pongbrayan', 'bmendoza4', 'mustafa.kaya0798507', 'pmhernandez4', 'paras128', 'klc.mrt.1926', 'windl', 'rmartinez5', 'lerner', 'banoth.dinesh', 'furkan2072', 'fatihyorgun1996', 'sai.mrr', 'drhodges', 'simayozbay', 'erencanarslan70', 'choudhary_s', 'emregonen', 'murat.ozeee', 'anurag_kurle', 'emrecitakk', 'ardelarosa', 'yash.mh', 'furkan552senturk', 'shashi.sarraf', 'mehmettasdelen26', 'kanwat.pranav', 'cancetinkaya1201', 'saineeth', 'sflt317', 'ncmagra54', 'aileyvaa', 'mustafayigitesen', 'uzunnurdan', 'eliffsu.koc', 'halilalp', 'jessica.satyarthi', 'ensarerol26', 'klayydar', 'azazimalii', 'gurhankopcaz', 'jyothishjaggarapu225', 'anjaligawai', 'naveen143', 'abcd5454', 'kaanbjk27', 'erdicany', 'alikanadli7', 'serdememen', 'jessgomez100', 'tolga.ozyurt24', 'dhyanasivadas311', 'blassselva', 'wuizar99', 'ozcankutlu15', 'funsal', 'sabriyebayrakcinur', 'mumi1478', 'veyseleee123', 'kingkireeti', 'emreyilmazel1996', 'rhamwey', 'evelyn.f1975', 'haticeterzibali', 'xavier160mg', 'berksaldr', 'njgarcia5', 'jayopp32', 'jarellano1204', 'muvafikmelikkaya', 'gullit0725', 'jasmine43.jp', 'mrgiraffe', 'irem.karagoz33', 'rebecasalcido', 'jatin.us', 'esuna006', 'haoliu', 'aayushik', 'emre.ibil', 'burakbeyazt', 'testeremre70', 'ezelbilgili', 'anilboran0671', 'bryang511', 'yamakonurcan', 'yorumhesabimsa', 'kodaar', 'carlosquinonez80', 'sai.ssm', 'zilmidegne', 'michaelpov', 'anand.satyam', 'berkc', 'selinyasaci98', 'orancagdas', 'ninad.ps', 'sonerkar', 'tugbakoyuncu99', 'yusmar', 'kaankuncak', 'ulises98', 'kagankilicaslan28', 'petersan901', 'yasinzgen']",7,"[None, 'kemal1188', 'emircansimsek', 'bayramdonmez96', 'behlul', 'yusufsabahoglu05', 'dumpnit']",215,"['mgk816', 'cmergil39', 'mcsonic', 'prosdocimi.m', 'dleon3', 'yunusyeo768', 'evren_aydin6', 'mtakcali', 'emreoney', 'mapayan5', 'swarupadhyay777', 'esulekaplan', 'kenanke', 'fztrnetflix', 'nsener45', 'ekin.gezer', 'joker632455', 'ganesh25', 'okanozkann95', 'murattdo', 'roy227', 'ezelbilgili42', 'burak.baha00', 'youlianafouad17', 'salvalenzuela12', 'isma', 'metobomm', 'enesdinler1', 'krishna.mp', 'behlul', 'jmoya5', 'almelnz2005', 'fjduran3', 'sarawaelahmed22', 'ryckmonster', 'macolmenero', 'bsanchez', 'venkitesh.s', 'garfon61', 'nnurceylan95', 'w.edgarfamous', 'furkan069906', 'arivera35', 'agmendez14', 'alex10', 'jozrik', 'kemal1188', 'omerdmrc16', 'bertansafak', 'ajortega6', 'zeynep', 'mahmutcanki', 'bayramdonmez96', 'mstff.1clkk', 'kumar_shubham', 'mmozcan4', 'alibatuhanozturk', 'jadelira201', 'arif.ozkan5806', 'karpuz', 'sigalam', 'shrreya07', 'blogan', 'esraboran71', 'mseyfullahcelik', 'chrisodomx', 'kagangunes10', '1967hamzausta', 'dmitry.stor', 'goknur.derinoz', 'garciaje34454', 'afurkanbudak42', 'ufuk', 'diaz.carlos4499', 'kemre9827', 'yusufsabahoglu05', 'scopigno', 'brs21', 'nikharv.19110125', 'halilibrahimtiken', 'ege.ert7', 'fdominguez6', 'ademfurkan', 'havvafatmaozbay', 'sayed.aftabahmad786', 'gtzintzarov', 'mehmetaliyas1998', 'ceydabayrak581', 'elembengisu', 'ferhbk97', 'dblancarte', 'mmb', 'utkubala63', None, 'mertisleyen96', 'iremnurfiliz', 'dragon28540', 'elifindir', 'sebastiangarcia695', 'koningmehmet', 'serhatiseri', 'shaawanalmutairi', 'aadelgado4', 'jagallegos7', 'altinbasnurcan09', 'druiz20', 'pongbrayan', 'bmendoza4', 'mustafa.kaya0798507', 'pmhernandez4', 'paras128', 'klc.mrt.1926', 'windl', 'rmartinez5', 'lerner', 'banoth.dinesh', 'furkan2072', 'fatihyorgun1996', 'sai.mrr', 'drhodges', 'simayozbay', 'erencanarslan70', 'choudhary_s', 'emregonen', 'murat.ozeee', 'anurag_kurle', 'emrecitakk', 'ardelarosa', 'yash.mh', 'dumpnit', 'furkan552senturk', 'shashi.sarraf', 'mehmettasdelen26', 'kanwat.pranav', 'cancetinkaya1201', 'saineeth', 'sflt317', 'ncmagra54', 'aileyvaa', 'mustafayigitesen', 'uzunnurdan', 'eliffsu.koc', 'halilalp', 'jessica.satyarthi', 'ensarerol26', 'klayydar', 'azazimalii', 'gurhankopcaz', 'jyothishjaggarapu225', 'anjaligawai', 'naveen143', 'abcd5454', 'kaanbjk27', 'erdicany', 'alikanadli7', 'serdememen', 'jessgomez100', 'tolga.ozyurt24', 'ozcanguclu', 'dhyanasivadas311', 'blassselva', 'wuizar99', 'ozcankutlu15', 'funsal', 'sabriyebayrakcinur', 'mumi1478', 'veyseleee123', 'kingkireeti', 'taol190799', 'emreyilmazel1996', 'rhamwey', 'evelyn.f1975', 'haticeterzibali', 'xavier160mg', 'berksaldr', 'emircansimsek', 'njgarcia5', 'jayopp32', 'jarellano1204', 'muvafikmelikkaya', 'gullit0725', 'jasmine43.jp', 'mrgiraffe', 'irem.karagoz33', 'rebecasalcido', 'jatin.us', 'esuna006', 'haoliu', 'aayushik', 'emre.ibil', 'burakbeyazt', 'testeremre70', 'ezelbilgili', 'anilboran0671', 'bryang511', 'yamakonurcan', 'yorumhesabimsa', 'kodaar', 'carlosquinonez80', 'sai.ssm', 'zilmidegne', 'michaelpov', 'anand.satyam', 'berkc', 'selinyasaci98', 'orancagdas', 'ninad.ps', 'sonerkar', 'tugbakoyuncu99', 'yusmar', 'kaankuncak', 'ulises98', 'kagankilicaslan28', 'petersan901', 'yasinzgen']"
3,548,209,9,2,"['mseyfullahcelik', 'mertisleyen96']",206,"['mgk816', 'cmergil39', 'mcsonic', 'prosdocimi.m', 'dleon3', 'yunusyeo768', 'evren_aydin6', 'mtakcali', 'emreoney', 'mapayan5', 'swarupadhyay777', 'esulekaplan', 'kenanke', 'fztrnetflix', 'nsener45', 'ekin.gezer', 'joker632455', 'ganesh25', 'okanozkann95', 'murattdo', 'roy227', 'ezelbilgili42', 'burak.baha00', 'youlianafouad17', 'salvalenzuela12', 'isma', 'metobomm', 'enesdinler1', 'krishna.mp', 'jmoya5', 'almelnz2005', 'fjduran3', 'sarawaelahmed22', 'ryckmonster', 'macolmenero', 'bsanchez', 'venkitesh.s', 'garfon61', 'nnurceylan95', 'w.edgarfamous', 'furkan069906', 'arivera35', 'agmendez14', 'alex10', 'jozrik', 'omerdmrc16', 'bertansafak', 'ajortega6', 'zeynep', 'mahmutcanki', 'mstff.1clkk', 'kumar_shubham', 'mmozcan4', 'alibatuhanozturk', 'jadelira201', 'arif.ozkan5806', 'karpuz', 'sigalam', 'shrreya07', 'blogan', 'esraboran71', 'chrisodomx', 'kagangunes10', '1967hamzausta', 'dmitry.stor', 'goknur.derinoz', 'garciaje34454', 'afurkanbudak42', 'ufuk', 'diaz.carlos4499', 'kemre9827', 'scopigno', 'brs21', 'nikharv.19110125', 'halilibrahimtiken', 'ege.ert7', 'fdominguez6', 'ademfurkan', 'havvafatmaozbay', 'sayed.aftabahmad786', 'gtzintzarov', 'mehmetaliyas1998', 'ceydabayrak581', 'elembengisu', 'ferhbk97', 'dblancarte', 'mmb', 'utkubala63', 'iremnurfiliz', 'dragon28540', 'elifindir', 'sebastiangarcia695', 'koningmehmet', 'serhatiseri', 'shaawanalmutairi', 'aadelgado4', 'jagallegos7', 'altinbasnurcan09', 'druiz20', 'pongbrayan', 'bmendoza4', 'mustafa.kaya0798507', 'pmhernandez4', 'paras128', 'klc.mrt.1926', 'windl', 'rmartinez5', 'lerner', 'banoth.dinesh', 'furkan2072', 'fatihyorgun1996', 'sai.mrr', 'drhodges', 'simayozbay', 'erencanarslan70', 'choudhary_s', 'emregonen', 'murat.ozeee', 'anurag_kurle', 'emrecitakk', 'ardelarosa', 'yash.mh', 'furkan552senturk', 'shashi.sarraf', 'mehmettasdelen26', 'kanwat.pranav', 'cancetinkaya1201', 'saineeth', 'sflt317', 'ncmagra54', 'aileyvaa', 'mustafayigitesen', 'uzunnurdan', 'eliffsu.koc', 'halilalp', 'jessica.satyarthi', 'ensarerol26', 'klayydar', 'azazimalii', 'gurhankopcaz', 'jyothishjaggarapu225', 'anjaligawai', 'naveen143', 'abcd5454', 'kaanbjk27', 'erdicany', 'alikanadli7', 'serdememen', 'jessgomez100', 'tolga.ozyurt24', 'ozcanguclu', 'dhyanasivadas311', 'blassselva', 'wuizar99', 'ozcankutlu15', 'funsal', 'sabriyebayrakcinur', 'mumi1478', 'veyseleee123', 'kingkireeti', 'taol190799', 'emreyilmazel1996', 'rhamwey', 'evelyn.f1975', 'haticeterzibali', 'xavier160mg', 'berksaldr', 'njgarcia5', 'jayopp32', 'jarellano1204', 'muvafikmelikkaya', 'gullit0725', 'jasmine43.jp', 'mrgiraffe', 'irem.karagoz33', 'rebecasalcido', 'jatin.us', 'esuna006', 'haoliu', 'aayushik', 'emre.ibil', 'burakbeyazt', 'testeremre70', 'ezelbilgili', 'anilboran0671', 'bryang511', 'yamakonurcan', 'yorumhesabimsa', 'kodaar', 'carlosquinonez80', 'sai.ssm', 'zilmidegne', 'michaelpov', 'anand.satyam', 'berkc', 'selinyasaci98', 'orancagdas', 'ninad.ps', 'sonerkar', 'tugbakoyuncu99', 'yusmar', 'kaankuncak', 'ulises98', 'kagankilicaslan28', 'petersan901', 'yasinzgen']",7,"['sd226', 'samimorsoglu', None, 'byzayh13', 'yavuzselimeskicumali', 'aydoganaali19', 'oneyyemre']",215,"['mgk816', 'cmergil39', 'mcsonic', 'prosdocimi.m', 'dleon3', 'yunusyeo768', 'evren_aydin6', 'mtakcali', 'emreoney', 'mapayan5', 'swarupadhyay777', 'esulekaplan', 'kenanke', 'fztrnetflix', 'nsener45', 'byzayh13', 'ekin.gezer', 'joker632455', 'ganesh25', 'okanozkann95', 'murattdo', 'roy227', 'ezelbilgili42', 'burak.baha00', 'youlianafouad17', 'salvalenzuela12', 'isma', 'metobomm', 'enesdinler1', 'krishna.mp', 'jmoya5', 'almelnz2005', 'fjduran3', 'sarawaelahmed22', 'ryckmonster', 'macolmenero', 'samimorsoglu', 'bsanchez', 'venkitesh.s', 'garfon61', 'nnurceylan95', 'w.edgarfamous', 'furkan069906', 'arivera35', 'agmendez14', 'alex10', 'jozrik', 'omerdmrc16', 'bertansafak', 'ajortega6', 'zeynep', 'mahmutcanki', 'mstff.1clkk', 'kumar_shubham', 'mmozcan4', 'alibatuhanozturk', 'jadelira201', 'arif.ozkan5806', 'karpuz', 'sigalam', 'shrreya07', 'blogan', 'esraboran71', 'mseyfullahcelik', 'chrisodomx', 'kagangunes10', '1967hamzausta', 'dmitry.stor', 'goknur.derinoz', 'garciaje34454', 'afurkanbudak42', 'ufuk', 'diaz.carlos4499', 'kemre9827', 'scopigno', 'brs21', 'nikharv.19110125', 'halilibrahimtiken', 'ege.ert7', 'fdominguez6', 'ademfurkan', 'havvafatmaozbay', 'sayed.aftabahmad786', 'gtzintzarov', 'mehmetaliyas1998', 'ceydabayrak581', 'elembengisu', 'ferhbk97', 'dblancarte', 'mmb', 'utkubala63', None, 'mertisleyen96', 'iremnurfiliz', 'dragon28540', 'elifindir', 'sebastiangarcia695', 'koningmehmet', 'serhatiseri', 'shaawanalmutairi', 'oneyyemre', 'aadelgado4', 'jagallegos7', 'altinbasnurcan09', 'druiz20', 'pongbrayan', 'bmendoza4', 'mustafa.kaya0798507', 'pmhernandez4', 'paras128', 'klc.mrt.1926', 'windl', 'rmartinez5', 'lerner', 'banoth.dinesh', 'furkan2072', 'fatihyorgun1996', 'sai.mrr', 'drhodges', 'simayozbay', 'erencanarslan70', 'choudhary_s', 'emregonen', 'murat.ozeee', 'anurag_kurle', 'emrecitakk', 'ardelarosa', 'yash.mh', 'aydoganaali19', 'furkan552senturk', 'shashi.sarraf', 'mehmettasdelen26', 'kanwat.pranav', 'cancetinkaya1201', 'saineeth', 'sflt317', 'ncmagra54', 'aileyvaa', 'mustafayigitesen', 'yavuzselimeskicumali', 'uzunnurdan', 'eliffsu.koc', 'halilalp', 'jessica.satyarthi', 'ensarerol26', 'klayydar', 'azazimalii', 'gurhankopcaz', 'jyothishjaggarapu225', 'anjaligawai', 'naveen143', 'abcd5454', 'kaanbjk27', 'erdicany', 'alikanadli7', 'serdememen', 'jessgomez100', 'tolga.ozyurt24', 'ozcanguclu', 'dhyanasivadas311', 'blassselva', 'wuizar99', 'ozcankutlu15', 'funsal', 'sabriyebayrakcinur', 'mumi1478', 'veyseleee123', 'kingkireeti', 'taol190799', 'emreyilmazel1996', 'rhamwey', 'evelyn.f1975', 'haticeterzibali', 'xavier160mg', 'berksaldr', 'njgarcia5', 'jayopp32', 'jarellano1204', 'muvafikmelikkaya', 'gullit0725', 'jasmine43.jp', 'mrgiraffe', 'irem.karagoz33', 'rebecasalcido', 'jatin.us', 'esuna006', 'sd226', 'haoliu', 'aayushik', 'emre.ibil', 'burakbeyazt', 'testeremre70', 'ezelbilgili', 'anilboran0671', 'bryang511', 'yamakonurcan', 'yorumhesabimsa', 'kodaar', 'carlosquinonez80', 'sai.ssm', 'zilmidegne', 'michaelpov', 'anand.satyam', 'berkc', 'selinyasaci98', 'orancagdas', 'ninad.ps', 'sonerkar', 'tugbakoyuncu99', 'yusmar', 'kaankuncak', 'ulises98', 'kagankilicaslan28', 'petersan901', 'yasinzgen']"
3,550,209,9,4,"['tugbakoyuncu99', 'mrgiraffe', 'metobomm', 'mumi1478']",204,"['mgk816', 'cmergil39', 'mcsonic', 'prosdocimi.m', 'dleon3', 'yunusyeo768', 'evren_aydin6', 'mtakcali', 'emreoney', 'mapayan5', 'swarupadhyay777', 'esulekaplan', 'kenanke', 'fztrnetflix', 'nsener45', 'ekin.gezer', 'joker632455', 'ganesh25', 'okanozkann95', 'murattdo', 'roy227', 'ezelbilgili42', 'burak.baha00', 'youlianafouad17', 'salvalenzuela12', 'isma', 'enesdinler1', 'krishna.mp', 'jmoya5', 'almelnz2005', 'fjduran3', 'sarawaelahmed22', 'ryckmonster', 'macolmenero', 'bsanchez', 'venkitesh.s', 'garfon61', 'nnurceylan95', 'w.edgarfamous', 'furkan069906', 'arivera35', 'agmendez14', 'alex10', 'jozrik', 'omerdmrc16', 'bertansafak', 'ajortega6', 'zeynep', 'mahmutcanki', 'mstff.1clkk', 'kumar_shubham', 'mmozcan4', 'alibatuhanozturk', 'jadelira201', 'arif.ozkan5806', 'karpuz', 'sigalam', 'shrreya07', 'blogan', 'esraboran71', 'mseyfullahcelik', 'chrisodomx', 'kagangunes10', '1967hamzausta', 'dmitry.stor', 'goknur.derinoz', 'garciaje34454', 'afurkanbudak42', 'ufuk', 'diaz.carlos4499', 'kemre9827', 'scopigno', 'brs21', 'nikharv.19110125', 'halilibrahimtiken', 'ege.ert7', 'fdominguez6', 'ademfurkan', 'havvafatmaozbay', 'sayed.aftabahmad786', 'gtzintzarov', 'mehmetaliyas1998', 'ceydabayrak581', 'elembengisu', 'ferhbk97', 'dblancarte', 'mmb', 'utkubala63', 'mertisleyen96', 'iremnurfiliz', 'dragon28540', 'elifindir', 'sebastiangarcia695', 'koningmehmet', 'serhatiseri', 'shaawanalmutairi', 'aadelgado4', 'jagallegos7', 'altinbasnurcan09', 'druiz20', 'pongbrayan', 'bmendoza4', 'mustafa.kaya0798507', 'pmhernandez4', 'paras128', 'klc.mrt.1926', 'windl', 'rmartinez5', 'lerner', 'banoth.dinesh', 'furkan2072', 'fatihyorgun1996', 'sai.mrr', 'drhodges', 'simayozbay', 'erencanarslan70', 'choudhary_s', 'emregonen', 'murat.ozeee', 'anurag_kurle', 'emrecitakk', 'ardelarosa', 'yash.mh', 'furkan552senturk', 'shashi.sarraf', 'mehmettasdelen26', 'kanwat.pranav', 'cancetinkaya1201', 'saineeth', 'sflt317', 'ncmagra54', 'aileyvaa', 'mustafayigitesen', 'uzunnurdan', 'eliffsu.koc', 'halilalp', 'jessica.satyarthi', 'ensarerol26', 'klayydar', 'azazimalii', 'gurhankopcaz', 'jyothishjaggarapu225', 'anjaligawai', 'naveen143', 'abcd5454', 'kaanbjk27', 'erdicany', 'alikanadli7', 'serdememen', 'jessgomez100', 'tolga.ozyurt24', 'ozcanguclu', 'dhyanasivadas311', 'blassselva', 'wuizar99', 'ozcankutlu15', 'funsal', 'sabriyebayrakcinur', 'veyseleee123', 'kingkireeti', 'taol190799', 'emreyilmazel1996', 'rhamwey', 'evelyn.f1975', 'haticeterzibali', 'xavier160mg', 'berksaldr', 'njgarcia5', 'jayopp32', 'jarellano1204', 'muvafikmelikkaya', 'gullit0725', 'jasmine43.jp', 'irem.karagoz33', 'rebecasalcido', 'jatin.us', 'esuna006', 'haoliu', 'aayushik', 'emre.ibil', 'burakbeyazt', 'testeremre70', 'ezelbilgili', 'anilboran0671', 'bryang511', 'yamakonurcan', 'yorumhesabimsa', 'kodaar', 'carlosquinonez80', 'sai.ssm', 'zilmidegne', 'michaelpov', 'anand.satyam', 'berkc', 'selinyasaci98', 'orancagdas', 'ninad.ps', 'sonerkar', 'yusmar', 'kaankuncak', 'ulises98', 'kagankilicaslan28', 'petersan901', 'yasinzgen']",5,"[None, 'byzayh13', '86kemal86', 'dsevvaldogann', 'dumpnit']",213,"['mgk816', 'cmergil39', 'mcsonic', 'prosdocimi.m', 'dleon3', 'yunusyeo768', 'evren_aydin6', 'mtakcali', 'emreoney', 'mapayan5', 'swarupadhyay777', 'esulekaplan', 'kenanke', 'fztrnetflix', 'nsener45', 'byzayh13', 'ekin.gezer', 'joker632455', 'ganesh25', 'okanozkann95', 'murattdo', 'dsevvaldogann', 'roy227', 'ezelbilgili42', 'burak.baha00', 'youlianafouad17', 'salvalenzuela12', 'isma', 'metobomm', 'enesdinler1', 'krishna.mp', 'jmoya5', 'almelnz2005', 'fjduran3', 'sarawaelahmed22', 'ryckmonster', 'macolmenero', 'bsanchez', 'venkitesh.s', 'garfon61', 'nnurceylan95', 'w.edgarfamous', 'furkan069906', 'arivera35', 'agmendez14', 'alex10', 'jozrik', 'omerdmrc16', 'bertansafak', 'ajortega6', 'zeynep', 'mahmutcanki', '86kemal86', 'mstff.1clkk', 'kumar_shubham', 'mmozcan4', 'alibatuhanozturk', 'jadelira201', 'arif.ozkan5806', 'karpuz', 'sigalam', 'shrreya07', 'blogan', 'esraboran71', 'mseyfullahcelik', 'chrisodomx', 'kagangunes10', '1967hamzausta', 'dmitry.stor', 'goknur.derinoz', 'garciaje34454', 'afurkanbudak42', 'ufuk', 'diaz.carlos4499', 'kemre9827', 'scopigno', 'brs21', 'nikharv.19110125', 'halilibrahimtiken', 'ege.ert7', 'fdominguez6', 'ademfurkan', 'havvafatmaozbay', 'sayed.aftabahmad786', 'gtzintzarov', 'mehmetaliyas1998', 'ceydabayrak581', 'elembengisu', 'ferhbk97', 'dblancarte', 'mmb', 'utkubala63', None, 'mertisleyen96', 'iremnurfiliz', 'dragon28540', 'elifindir', 'sebastiangarcia695', 'koningmehmet', 'serhatiseri', 'shaawanalmutairi', 'aadelgado4', 'jagallegos7', 'altinbasnurcan09', 'druiz20', 'pongbrayan', 'bmendoza4', 'mustafa.kaya0798507', 'pmhernandez4', 'paras128', 'klc.mrt.1926', 'windl', 'rmartinez5', 'lerner', 'banoth.dinesh', 'furkan2072', 'fatihyorgun1996', 'sai.mrr', 'drhodges', 'simayozbay', 'erencanarslan70', 'choudhary_s', 'emregonen', 'murat.ozeee', 'anurag_kurle', 'emrecitakk', 'ardelarosa', 'yash.mh', 'dumpnit', 'furkan552senturk', 'shashi.sarraf', 'mehmettasdelen26', 'kanwat.pranav', 'cancetinkaya1201', 'saineeth', 'sflt317', 'ncmagra54', 'aileyvaa', 'mustafayigitesen', 'uzunnurdan', 'eliffsu.koc', 'halilalp', 'jessica.satyarthi', 'ensarerol26', 'klayydar', 'azazimalii', 'gurhankopcaz', 'jyothishjaggarapu225', 'anjaligawai', 'naveen143', 'abcd5454', 'kaanbjk27', 'erdicany', 'alikanadli7', 'serdememen', 'jessgomez100', 'tolga.ozyurt24', 'ozcanguclu', 'dhyanasivadas311', 'blassselva', 'wuizar99', 'ozcankutlu15', 'funsal', 'sabriyebayrakcinur', 'mumi1478', 'veyseleee123', 'kingkireeti', 'taol190799', 'emreyilmazel1996', 'rhamwey', 'evelyn.f1975', 'haticeterzibali', 'xavier160mg', 'berksaldr', 'njgarcia5', 'jayopp32', 'jarellano1204', 'muvafikmelikkaya', 'gullit0725', 'jasmine43.jp', 'mrgiraffe', 'irem.karagoz33', 'rebecasalcido', 'jatin.us', 'esuna006', 'haoliu', 'aayushik', 'emre.ibil', 'burakbeyazt', 'testeremre70', 'ezelbilgili', 'anilboran0671', 'bryang511', 'yamakonurcan', 'yorumhesabimsa', 'kodaar', 'carlosquinonez80', 'sai.ssm', 'zilmidegne', 'michaelpov', 'anand.satyam', 'berkc', 'selinyasaci98', 'orancagdas', 'ninad.ps', 'sonerkar', 'tugbakoyuncu99', 'yusmar', 'kaankuncak', 'ulises98', 'kagankilicaslan28', 'petersan901', 'yasinzgen']"
3,28,209,8,3,"['evren_aydin6', 'garfon61', 'goknur.derinoz']",205,"['mgk816', 'cmergil39', 'mcsonic', 'prosdocimi.m', 'dleon3', 'yunusyeo768', 'mtakcali', 'emreoney', 'mapayan5', 'swarupadhyay777', 'esulekaplan', 'kenanke', 'fztrnetflix', 'nsener45', 'ekin.gezer', 'joker632455', 'ganesh25', 'okanozkann95', 'murattdo', 'roy227', 'ezelbilgili42', 'burak.baha00', 'youlianafouad17', 'salvalenzuela12', 'isma', 'metobomm', 'enesdinler1', 'krishna.mp', 'jmoya5', 'almelnz2005', 'fjduran3', 'sarawaelahmed22', 'ryckmonster', 'macolmenero', 'bsanchez', 'venkitesh.s', 'nnurceylan95', 'w.edgarfamous', 'furkan069906', 'arivera35', 'agmendez14', 'alex10', 'jozrik', 'omerdmrc16', 'bertansafak', 'ajortega6', 'zeynep', 'mahmutcanki', 'mstff.1clkk', 'kumar_shubham', 'mmozcan4', 'alibatuhanozturk', 'jadelira201', 'arif.ozkan5806', 'karpuz', 'sigalam', 'shrreya07', 'blogan', 'esraboran71', 'mseyfullahcelik', 'chrisodomx', 'kagangunes10', '1967hamzausta', 'dmitry.stor', 'garciaje34454', 'afurkanbudak42', 'ufuk', 'diaz.carlos4499', 'kemre9827', 'scopigno', 'brs21', 'nikharv.19110125', 'halilibrahimtiken', 'ege.ert7', 'fdominguez6', 'ademfurkan', 'havvafatmaozbay', 'sayed.aftabahmad786', 'gtzintzarov', 'mehmetaliyas1998', 'ceydabayrak581', 'elembengisu', 'ferhbk97', 'dblancarte', 'mmb', 'utkubala63', 'mertisleyen96', 'iremnurfiliz', 'dragon28540', 'elifindir', 'sebastiangarcia695', 'koningmehmet', 'serhatiseri', 'shaawanalmutairi', 'aadelgado4', 'jagallegos7', 'altinbasnurcan09', 'druiz20', 'pongbrayan', 'bmendoza4', 'mustafa.kaya0798507', 'pmhernandez4', 'paras128', 'klc.mrt.1926', 'windl', 'rmartinez5', 'lerner', 'banoth.dinesh', 'furkan2072', 'fatihyorgun1996', 'sai.mrr', 'drhodges', 'simayozbay', 'erencanarslan70', 'choudhary_s', 'emregonen', 'murat.ozeee', 'anurag_kurle', 'emrecitakk', 'ardelarosa', 'yash.mh', 'furkan552senturk', 'shashi.sarraf', 'mehmettasdelen26', 'kanwat.pranav', 'cancetinkaya1201', 'saineeth', 'sflt317', 'ncmagra54', 'aileyvaa', 'mustafayigitesen', 'uzunnurdan', 'eliffsu.koc', 'halilalp', 'jessica.satyarthi', 'ensarerol26', 'klayydar', 'azazimalii', 'gurhankopcaz', 'jyothishjaggarapu225', 'anjaligawai', 'naveen143', 'abcd5454', 'kaanbjk27', 'erdicany', 'alikanadli7', 'serdememen', 'jessgomez100', 'tolga.ozyurt24', 'ozcanguclu', 'dhyanasivadas311', 'blassselva', 'wuizar99', 'ozcankutlu15', 'funsal', 'sabriyebayrakcinur', 'mumi1478', 'veyseleee123', 'kingkireeti', 'taol190799', 'emreyilmazel1996', 'rhamwey', 'evelyn.f1975', 'haticeterzibali', 'xavier160mg', 'berksaldr', 'njgarcia5', 'jayopp32', 'jarellano1204', 'muvafikmelikkaya', 'gullit0725', 'jasmine43.jp', 'mrgiraffe', 'irem.karagoz33', 'rebecasalcido', 'jatin.us', 'esuna006', 'haoliu', 'aayushik', 'emre.ibil', 'burakbeyazt', 'testeremre70', 'ezelbilgili', 'anilboran0671', 'bryang511', 'yamakonurcan', 'yorumhesabimsa', 'kodaar', 'carlosquinonez80', 'sai.ssm', 'zilmidegne', 'michaelpov', 'anand.satyam', 'berkc', 'selinyasaci98', 'orancagdas', 'ninad.ps', 'sonerkar', 'tugbakoyuncu99', 'yusmar', 'kaankuncak', 'ulises98', 'kagankilicaslan28', 'petersan901', 'yasinzgen']",5,"['muhammet.korkmaz29', 'alpayy98', 'barkinsrc5', 'smrf432', None]",213,"['mgk816', 'cmergil39', 'mcsonic', 'prosdocimi.m', 'dleon3', 'yunusyeo768', 'evren_aydin6', 'mtakcali', 'emreoney', 'mapayan5', 'swarupadhyay777', 'esulekaplan', 'kenanke', 'fztrnetflix', 'nsener45', 'ekin.gezer', 'joker632455', 'ganesh25', 'okanozkann95', 'murattdo', 'roy227', 'ezelbilgili42', 'burak.baha00', 'youlianafouad17', 'salvalenzuela12', 'isma', 'metobomm', 'enesdinler1', 'krishna.mp', 'jmoya5', 'almelnz2005', 'fjduran3', 'sarawaelahmed22', 'ryckmonster', 'macolmenero', 'bsanchez', 'venkitesh.s', 'garfon61', 'barkinsrc5', 'nnurceylan95', 'w.edgarfamous', 'furkan069906', 'arivera35', 'agmendez14', 'alex10', 'jozrik', 'omerdmrc16', 'bertansafak', 'ajortega6', 'zeynep', 'mahmutcanki', 'mstff.1clkk', 'kumar_shubham', 'mmozcan4', 'alibatuhanozturk', 'jadelira201', 'smrf432', 'arif.ozkan5806', 'karpuz', 'sigalam', 'shrreya07', 'blogan', 'esraboran71', 'mseyfullahcelik', 'chrisodomx', 'kagangunes10', '1967hamzausta', 'dmitry.stor', 'goknur.derinoz', 'garciaje34454', 'afurkanbudak42', 'ufuk', 'diaz.carlos4499', 'kemre9827', 'scopigno', 'brs21', 'nikharv.19110125', 'halilibrahimtiken', 'ege.ert7', 'fdominguez6', 'ademfurkan', 'havvafatmaozbay', 'sayed.aftabahmad786', 'gtzintzarov', 'mehmetaliyas1998', 'ceydabayrak581', 'elembengisu', 'ferhbk97', 'dblancarte', 'mmb', 'utkubala63', None, 'mertisleyen96', 'iremnurfiliz', 'dragon28540', 'elifindir', 'sebastiangarcia695', 'koningmehmet', 'serhatiseri', 'shaawanalmutairi', 'aadelgado4', 'jagallegos7', 'altinbasnurcan09', 'druiz20', 'pongbrayan', 'bmendoza4', 'mustafa.kaya0798507', 'pmhernandez4', 'paras128', 'klc.mrt.1926', 'windl', 'rmartinez5', 'lerner', 'banoth.dinesh', 'furkan2072', 'fatihyorgun1996', 'sai.mrr', 'drhodges', 'simayozbay', 'erencanarslan70', 'choudhary_s', 'emregonen', 'murat.ozeee', 'anurag_kurle', 'emrecitakk', 'ardelarosa', 'yash.mh', 'muhammet.korkmaz29', 'furkan552senturk', 'shashi.sarraf', 'mehmettasdelen26', 'kanwat.pranav', 'cancetinkaya1201', 'saineeth', 'sflt317', 'ncmagra54', 'aileyvaa', 'mustafayigitesen', 'uzunnurdan', 'alpayy98', 'eliffsu.koc', 'halilalp', 'jessica.satyarthi', 'ensarerol26', 'klayydar', 'azazimalii', 'gurhankopcaz', 'jyothishjaggarapu225', 'anjaligawai', 'naveen143', 'abcd5454', 'kaanbjk27', 'erdicany', 'alikanadli7', 'serdememen', 'jessgomez100', 'tolga.ozyurt24', 'ozcanguclu', 'dhyanasivadas311', 'blassselva', 'wuizar99', 'ozcankutlu15', 'funsal', 'sabriyebayrakcinur', 'mumi1478', 'veyseleee123', 'kingkireeti', 'taol190799', 'emreyilmazel1996', 'rhamwey', 'evelyn.f1975', 'haticeterzibali', 'xavier160mg', 'berksaldr', 'njgarcia5', 'jayopp32', 'jarellano1204', 'muvafikmelikkaya', 'gullit0725', 'jasmine43.jp', 'mrgiraffe', 'irem.karagoz33', 'rebecasalcido', 'jatin.us', 'esuna006', 'haoliu', 'aayushik', 'emre.ibil', 'burakbeyazt', 'testeremre70', 'ezelbilgili', 'anilboran0671', 'bryang511', 'yamakonurcan', 'yorumhesabimsa', 'kodaar', 'carlosquinonez80', 'sai.ssm', 'zilmidegne', 'michaelpov', 'anand.satyam', 'berkc', 'selinyasaci98', 'orancagdas', 'ninad.ps', 'sonerkar', 'tugbakoyuncu99', 'yusmar', 'kaankuncak', 'ulises98', 'kagankilicaslan28', 'petersan901', 'yasinzgen']"
3,172,209,8,3,"['mehmettasdelen26', 'eliffsu.koc', 'emregonen']",205,"['mgk816', 'cmergil39', 'mcsonic', 'prosdocimi.m', 'dleon3', 'yunusyeo768', 'evren_aydin6', 'mtakcali', 'emreoney', 'mapayan5', 'swarupadhyay777', 'esulekaplan', 'kenanke', 'fztrnetflix', 'nsener45', 'ekin.gezer', 'joker632455', 'ganesh25', 'okanozkann95', 'murattdo', 'roy227', 'ezelbilgili42', 'burak.baha00', 'youlianafouad17', 'salvalenzuela12', 'isma', 'metobomm', 'enesdinler1', 'krishna.mp', 'jmoya5', 'almelnz2005', 'fjduran3', 'sarawaelahmed22', 'ryckmonster', 'macolmenero', 'bsanchez', 'venkitesh.s', 'garfon61', 'nnurceylan95', 'w.edgarfamous', 'furkan069906', 'arivera35', 'agmendez14', 'alex10', 'jozrik', 'omerdmrc16', 'bertansafak', 'ajortega6', 'zeynep', 'mahmutcanki', 'mstff.1clkk', 'kumar_shubham', 'mmozcan4', 'alibatuhanozturk', 'jadelira201', 'arif.ozkan5806', 'karpuz', 'sigalam', 'shrreya07', 'blogan', 'esraboran71', 'mseyfullahcelik', 'chrisodomx', 'kagangunes10', '1967hamzausta', 'dmitry.stor', 'goknur.derinoz', 'garciaje34454', 'afurkanbudak42', 'ufuk', 'diaz.carlos4499', 'kemre9827', 'scopigno', 'brs21', 'nikharv.19110125', 'halilibrahimtiken', 'ege.ert7', 'fdominguez6', 'ademfurkan', 'havvafatmaozbay', 'sayed.aftabahmad786', 'gtzintzarov', 'mehmetaliyas1998', 'ceydabayrak581', 'elembengisu', 'ferhbk97', 'dblancarte', 'mmb', 'utkubala63', 'mertisleyen96', 'iremnurfiliz', 'dragon28540', 'elifindir', 'sebastiangarcia695', 'koningmehmet', 'serhatiseri', 'shaawanalmutairi', 'aadelgado4', 'jagallegos7', 'altinbasnurcan09', 'druiz20', 'pongbrayan', 'bmendoza4', 'mustafa.kaya0798507', 'pmhernandez4', 'paras128', 'klc.mrt.1926', 'windl', 'rmartinez5', 'lerner', 'banoth.dinesh', 'furkan2072', 'fatihyorgun1996', 'sai.mrr', 'drhodges', 'simayozbay', 'erencanarslan70', 'choudhary_s', 'murat.ozeee', 'anurag_kurle', 'emrecitakk', 'ardelarosa', 'yash.mh', 'furkan552senturk', 'shashi.sarraf', 'kanwat.pranav', 'cancetinkaya1201', 'saineeth', 'sflt317', 'ncmagra54', 'aileyvaa', 'mustafayigitesen', 'uzunnurdan', 'halilalp', 'jessica.satyarthi', 'ensarerol26', 'klayydar', 'azazimalii', 'gurhankopcaz', 'jyothishjaggarapu225', 'anjaligawai', 'naveen143', 'abcd5454', 'kaanbjk27', 'erdicany', 'alikanadli7', 'serdememen', 'jessgomez100', 'tolga.ozyurt24', 'ozcanguclu', 'dhyanasivadas311', 'blassselva', 'wuizar99', 'ozcankutlu15', 'funsal', 'sabriyebayrakcinur', 'mumi1478', 'veyseleee123', 'kingkireeti', 'taol190799', 'emreyilmazel1996', 'rhamwey', 'evelyn.f1975', 'haticeterzibali', 'xavier160mg', 'berksaldr', 'njgarcia5', 'jayopp32', 'jarellano1204', 'muvafikmelikkaya', 'gullit0725', 'jasmine43.jp', 'mrgiraffe', 'irem.karagoz33', 'rebecasalcido', 'jatin.us', 'esuna006', 'haoliu', 'aayushik', 'emre.ibil', 'burakbeyazt', 'testeremre70', 'ezelbilgili', 'anilboran0671', 'bryang511', 'yamakonurcan', 'yorumhesabimsa', 'kodaar', 'carlosquinonez80', 'sai.ssm', 'zilmidegne', 'michaelpov', 'anand.satyam', 'berkc', 'selinyasaci98', 'orancagdas', 'ninad.ps', 'sonerkar', 'tugbakoyuncu99', 'yusmar', 'kaankuncak', 'ulises98', 'kagankilicaslan28', 'petersan901', 'yasinzgen']",5,"['yadigarcorez', None, 'elif.kocc33', 'fdirisaglik', 'burakalperen87']",213,"['mgk816', 'cmergil39', 'mcsonic', 'prosdocimi.m', 'dleon3', 'yunusyeo768', 'evren_aydin6', 'mtakcali', 'emreoney', 'mapayan5', 'swarupadhyay777', 'esulekaplan', 'kenanke', 'fztrnetflix', 'nsener45', 'ekin.gezer', 'joker632455', 'ganesh25', 'okanozkann95', 'murattdo', 'roy227', 'ezelbilgili42', 'burak.baha00', 'youlianafouad17', 'salvalenzuela12', 'isma', 'metobomm', 'enesdinler1', 'krishna.mp', 'fdirisaglik', 'jmoya5', 'almelnz2005', 'fjduran3', 'sarawaelahmed22', 'ryckmonster', 'macolmenero', 'bsanchez', 'venkitesh.s', 'garfon61', 'nnurceylan95', 'w.edgarfamous', 'furkan069906', 'arivera35', 'agmendez14', 'alex10', 'jozrik', 'omerdmrc16', 'bertansafak', 'ajortega6', 'zeynep', 'mahmutcanki', 'mstff.1clkk', 'kumar_shubham', 'mmozcan4', 'alibatuhanozturk', 'jadelira201', 'arif.ozkan5806', 'karpuz', 'sigalam', 'shrreya07', 'blogan', 'esraboran71', 'mseyfullahcelik', 'chrisodomx', 'kagangunes10', '1967hamzausta', 'dmitry.stor', 'goknur.derinoz', 'garciaje34454', 'afurkanbudak42', 'ufuk', 'diaz.carlos4499', 'kemre9827', 'scopigno', 'brs21', 'nikharv.19110125', 'halilibrahimtiken', 'ege.ert7', 'fdominguez6', 'ademfurkan', 'havvafatmaozbay', 'sayed.aftabahmad786', 'gtzintzarov', 'mehmetaliyas1998', 'ceydabayrak581', 'elembengisu', 'ferhbk97', 'dblancarte', 'mmb', 'utkubala63', None, 'mertisleyen96', 'iremnurfiliz', 'dragon28540', 'elifindir', 'sebastiangarcia695', 'burakalperen87', 'koningmehmet', 'serhatiseri', 'shaawanalmutairi', 'aadelgado4', 'jagallegos7', 'altinbasnurcan09', 'druiz20', 'pongbrayan', 'bmendoza4', 'mustafa.kaya0798507', 'pmhernandez4', 'paras128', 'klc.mrt.1926', 'windl', 'rmartinez5', 'lerner', 'banoth.dinesh', 'furkan2072', 'fatihyorgun1996', 'sai.mrr', 'drhodges', 'simayozbay', 'erencanarslan70', 'choudhary_s', 'emregonen', 'murat.ozeee', 'anurag_kurle', 'emrecitakk', 'ardelarosa', 'yash.mh', 'furkan552senturk', 'shashi.sarraf', 'mehmettasdelen26', 'kanwat.pranav', 'cancetinkaya1201', 'saineeth', 'sflt317', 'ncmagra54', 'aileyvaa', 'mustafayigitesen', 'uzunnurdan', 'yadigarcorez', 'eliffsu.koc', 'halilalp', 'jessica.satyarthi', 'ensarerol26', 'klayydar', 'azazimalii', 'gurhankopcaz', 'jyothishjaggarapu225', 'anjaligawai', 'naveen143', 'abcd5454', 'kaanbjk27', 'erdicany', 'alikanadli7', 'serdememen', 'jessgomez100', 'tolga.ozyurt24', 'ozcanguclu', 'dhyanasivadas311', 'blassselva', 'wuizar99', 'ozcankutlu15', 'funsal', 'sabriyebayrakcinur', 'mumi1478', 'veyseleee123', 'kingkireeti', 'taol190799', 'emreyilmazel1996', 'rhamwey', 'evelyn.f1975', 'haticeterzibali', 'xavier160mg', 'berksaldr', 'njgarcia5', 'jayopp32', 'jarellano1204', 'muvafikmelikkaya', 'gullit0725', 'jasmine43.jp', 'mrgiraffe', 'irem.karagoz33', 'rebecasalcido', 'jatin.us', 'esuna006', 'haoliu', 'aayushik', 'emre.ibil', 'burakbeyazt', 'testeremre70', 'elif.kocc33', 'ezelbilgili', 'anilboran0671', 'bryang511', 'yamakonurcan', 'yorumhesabimsa', 'kodaar', 'carlosquinonez80', 'sai.ssm', 'zilmidegne', 'michaelpov', 'anand.satyam', 'berkc', 'selinyasaci98', 'orancagdas', 'ninad.ps', 'sonerkar', 'tugbakoyuncu99', 'yusmar', 'kaankuncak', 'ulises98', 'kagankilicaslan28', 'petersan901', 'yasinzgen']"
3,349,209,8,1,['brs21'],207,"['mgk816', 'cmergil39', 'mcsonic', 'prosdocimi.m', 'dleon3', 'yunusyeo768', 'evren_aydin6', 'mtakcali', 'emreoney', 'mapayan5', 'swarupadhyay777', 'esulekaplan', 'kenanke', 'fztrnetflix', 'nsener45', 'ekin.gezer', 'joker632455', 'ganesh25', 'okanozkann95', 'murattdo', 'roy227', 'ezelbilgili42', 'burak.baha00', 'youlianafouad17', 'salvalenzuela12', 'isma', 'metobomm', 'enesdinler1', 'krishna.mp', 'jmoya5', 'almelnz2005', 'fjduran3', 'sarawaelahmed22', 'ryckmonster', 'macolmenero', 'bsanchez', 'venkitesh.s', 'garfon61', 'nnurceylan95', 'w.edgarfamous', 'furkan069906', 'arivera35', 'agmendez14', 'alex10', 'jozrik', 'omerdmrc16', 'bertansafak', 'ajortega6', 'zeynep', 'mahmutcanki', 'mstff.1clkk', 'kumar_shubham', 'mmozcan4', 'alibatuhanozturk', 'jadelira201', 'arif.ozkan5806', 'karpuz', 'sigalam', 'shrreya07', 'blogan', 'esraboran71', 'mseyfullahcelik', 'chrisodomx', 'kagangunes10', '1967hamzausta', 'dmitry.stor', 'goknur.derinoz', 'garciaje34454', 'afurkanbudak42', 'ufuk', 'diaz.carlos4499', 'kemre9827', 'scopigno', 'nikharv.19110125', 'halilibrahimtiken', 'ege.ert7', 'fdominguez6', 'ademfurkan', 'havvafatmaozbay', 'sayed.aftabahmad786', 'gtzintzarov', 'mehmetaliyas1998', 'ceydabayrak581', 'elembengisu', 'ferhbk97', 'dblancarte', 'mmb', 'utkubala63', 'mertisleyen96', 'iremnurfiliz', 'dragon28540', 'elifindir', 'sebastiangarcia695', 'koningmehmet', 'serhatiseri', 'shaawanalmutairi', 'aadelgado4', 'jagallegos7', 'altinbasnurcan09', 'druiz20', 'pongbrayan', 'bmendoza4', 'mustafa.kaya0798507', 'pmhernandez4', 'paras128', 'klc.mrt.1926', 'windl', 'rmartinez5', 'lerner', 'banoth.dinesh', 'furkan2072', 'fatihyorgun1996', 'sai.mrr', 'drhodges', 'simayozbay', 'erencanarslan70', 'choudhary_s', 'emregonen', 'murat.ozeee', 'anurag_kurle', 'emrecitakk', 'ardelarosa', 'yash.mh', 'furkan552senturk', 'shashi.sarraf', 'mehmettasdelen26', 'kanwat.pranav', 'cancetinkaya1201', 'saineeth', 'sflt317', 'ncmagra54', 'aileyvaa', 'mustafayigitesen', 'uzunnurdan', 'eliffsu.koc', 'halilalp', 'jessica.satyarthi', 'ensarerol26', 'klayydar', 'azazimalii', 'gurhankopcaz', 'jyothishjaggarapu225', 'anjaligawai', 'naveen143', 'abcd5454', 'kaanbjk27', 'erdicany', 'alikanadli7', 'serdememen', 'jessgomez100', 'tolga.ozyurt24', 'ozcanguclu', 'dhyanasivadas311', 'blassselva', 'wuizar99', 'ozcankutlu15', 'funsal', 'sabriyebayrakcinur', 'mumi1478', 'veyseleee123', 'kingkireeti', 'taol190799', 'emreyilmazel1996', 'rhamwey', 'evelyn.f1975', 'haticeterzibali', 'xavier160mg', 'berksaldr', 'njgarcia5', 'jayopp32', 'jarellano1204', 'muvafikmelikkaya', 'gullit0725', 'jasmine43.jp', 'mrgiraffe', 'irem.karagoz33', 'rebecasalcido', 'jatin.us', 'esuna006', 'haoliu', 'aayushik', 'emre.ibil', 'burakbeyazt', 'testeremre70', 'ezelbilgili', 'anilboran0671', 'bryang511', 'yamakonurcan', 'yorumhesabimsa', 'kodaar', 'carlosquinonez80', 'sai.ssm', 'zilmidegne', 'michaelpov', 'anand.satyam', 'berkc', 'selinyasaci98', 'orancagdas', 'ninad.ps', 'sonerkar', 'tugbakoyuncu99', 'yusmar', 'kaankuncak', 'ulises98', 'kagankilicaslan28', 'petersan901', 'yasinzgen']",7,"['sd226', 'nanouser321', 'lookatfuture09', 'iremkaratas', 'akdemirel99', 'cansecgin', None]",215,"['mgk816', 'cmergil39', 'mcsonic', 'prosdocimi.m', 'dleon3', 'yunusyeo768', 'evren_aydin6', 'mtakcali', 'emreoney', 'mapayan5', 'swarupadhyay777', 'lookatfuture09', 'esulekaplan', 'kenanke', 'fztrnetflix', 'nsener45', 'ekin.gezer', 'joker632455', 'ganesh25', 'okanozkann95', 'murattdo', 'akdemirel99', 'roy227', 'ezelbilgili42', 'burak.baha00', 'youlianafouad17', 'salvalenzuela12', 'isma', 'metobomm', 'enesdinler1', 'krishna.mp', 'jmoya5', 'almelnz2005', 'fjduran3', 'sarawaelahmed22', 'ryckmonster', 'macolmenero', 'bsanchez', 'venkitesh.s', 'garfon61', 'nnurceylan95', 'w.edgarfamous', 'furkan069906', 'arivera35', 'agmendez14', 'alex10', 'jozrik', 'omerdmrc16', 'iremkaratas', 'bertansafak', 'ajortega6', 'zeynep', 'mahmutcanki', 'mstff.1clkk', 'kumar_shubham', 'mmozcan4', 'alibatuhanozturk', 'jadelira201', 'arif.ozkan5806', 'karpuz', 'sigalam', 'shrreya07', 'blogan', 'esraboran71', 'mseyfullahcelik', 'chrisodomx', 'kagangunes10', '1967hamzausta', 'dmitry.stor', 'goknur.derinoz', 'garciaje34454', 'afurkanbudak42', 'ufuk', 'diaz.carlos4499', 'kemre9827', 'scopigno', 'brs21', 'nikharv.19110125', 'halilibrahimtiken', 'ege.ert7', 'fdominguez6', 'ademfurkan', 'havvafatmaozbay', 'sayed.aftabahmad786', 'gtzintzarov', 'mehmetaliyas1998', 'ceydabayrak581', 'elembengisu', 'ferhbk97', 'dblancarte', 'mmb', 'utkubala63', None, 'mertisleyen96', 'iremnurfiliz', 'dragon28540', 'elifindir', 'sebastiangarcia695', 'koningmehmet', 'serhatiseri', 'shaawanalmutairi', 'aadelgado4', 'jagallegos7', 'altinbasnurcan09', 'druiz20', 'pongbrayan', 'bmendoza4', 'mustafa.kaya0798507', 'nanouser321', 'pmhernandez4', 'paras128', 'klc.mrt.1926', 'windl', 'rmartinez5', 'lerner', 'banoth.dinesh', 'furkan2072', 'fatihyorgun1996', 'sai.mrr', 'drhodges', 'simayozbay', 'erencanarslan70', 'choudhary_s', 'emregonen', 'murat.ozeee', 'anurag_kurle', 'emrecitakk', 'ardelarosa', 'yash.mh', 'furkan552senturk', 'shashi.sarraf', 'mehmettasdelen26', 'kanwat.pranav', 'cancetinkaya1201', 'saineeth', 'sflt317', 'ncmagra54', 'aileyvaa', 'mustafayigitesen', 'uzunnurdan', 'eliffsu.koc', 'halilalp', 'jessica.satyarthi', 'ensarerol26', 'klayydar', 'azazimalii', 'gurhankopcaz', 'jyothishjaggarapu225', 'anjaligawai', 'naveen143', 'abcd5454', 'kaanbjk27', 'erdicany', 'alikanadli7', 'serdememen', 'jessgomez100', 'tolga.ozyurt24', 'ozcanguclu', 'dhyanasivadas311', 'blassselva', 'wuizar99', 'ozcankutlu15', 'funsal', 'sabriyebayrakcinur', 'mumi1478', 'veyseleee123', 'kingkireeti', 'taol190799', 'emreyilmazel1996', 'rhamwey', 'evelyn.f1975', 'haticeterzibali', 'xavier160mg', 'berksaldr', 'njgarcia5', 'jayopp32', 'jarellano1204', 'muvafikmelikkaya', 'gullit0725', 'jasmine43.jp', 'mrgiraffe', 'cansecgin', 'irem.karagoz33', 'rebecasalcido', 'jatin.us', 'esuna006', 'sd226', 'haoliu', 'aayushik', 'emre.ibil', 'burakbeyazt', 'testeremre70', 'ezelbilgili', 'anilboran0671', 'bryang511', 'yamakonurcan', 'yorumhesabimsa', 'kodaar', 'carlosquinonez80', 'sai.ssm', 'zilmidegne', 'michaelpov', 'anand.satyam', 'berkc', 'selinyasaci98', 'orancagdas', 'ninad.ps', 'sonerkar', 'tugbakoyuncu99', 'yusmar', 'kaankuncak', 'ulises98', 'kagankilicaslan28', 'petersan901', 'yasinzgen']"
3,350,209,8,3,"['yasinzgen', 'serdememen', 'havvafatmaozbay']",205,"['mgk816', 'cmergil39', 'mcsonic', 'prosdocimi.m', 'dleon3', 'yunusyeo768', 'evren_aydin6', 'mtakcali', 'emreoney', 'mapayan5', 'swarupadhyay777', 'esulekaplan', 'kenanke', 'fztrnetflix', 'nsener45', 'ekin.gezer', 'joker632455', 'ganesh25', 'okanozkann95', 'murattdo', 'roy227', 'ezelbilgili42', 'burak.baha00', 'youlianafouad17', 'salvalenzuela12', 'isma', 'metobomm', 'enesdinler1', 'krishna.mp', 'jmoya5', 'almelnz2005', 'fjduran3', 'sarawaelahmed22', 'ryckmonster', 'macolmenero', 'bsanchez', 'venkitesh.s', 'garfon61', 'nnurceylan95', 'w.edgarfamous', 'furkan069906', 'arivera35', 'agmendez14', 'alex10', 'jozrik', 'omerdmrc16', 'bertansafak', 'ajortega6', 'zeynep', 'mahmutcanki', 'mstff.1clkk', 'kumar_shubham', 'mmozcan4', 'alibatuhanozturk', 'jadelira201', 'arif.ozkan5806', 'karpuz', 'sigalam', 'shrreya07', 'blogan', 'esraboran71', 'mseyfullahcelik', 'chrisodomx', 'kagangunes10', '1967hamzausta', 'dmitry.stor', 'goknur.derinoz', 'garciaje34454', 'afurkanbudak42', 'ufuk', 'diaz.carlos4499', 'kemre9827', 'scopigno', 'brs21', 'nikharv.19110125', 'halilibrahimtiken', 'ege.ert7', 'fdominguez6', 'ademfurkan', 'sayed.aftabahmad786', 'gtzintzarov', 'mehmetaliyas1998', 'ceydabayrak581', 'elembengisu', 'ferhbk97', 'dblancarte', 'mmb', 'utkubala63', 'mertisleyen96', 'iremnurfiliz', 'dragon28540', 'elifindir', 'sebastiangarcia695', 'koningmehmet', 'serhatiseri', 'shaawanalmutairi', 'aadelgado4', 'jagallegos7', 'altinbasnurcan09', 'druiz20', 'pongbrayan', 'bmendoza4', 'mustafa.kaya0798507', 'pmhernandez4', 'paras128', 'klc.mrt.1926', 'windl', 'rmartinez5', 'lerner', 'banoth.dinesh', 'furkan2072', 'fatihyorgun1996', 'sai.mrr', 'drhodges', 'simayozbay', 'erencanarslan70', 'choudhary_s', 'emregonen', 'murat.ozeee', 'anurag_kurle', 'emrecitakk', 'ardelarosa', 'yash.mh', 'furkan552senturk', 'shashi.sarraf', 'mehmettasdelen26', 'kanwat.pranav', 'cancetinkaya1201', 'saineeth', 'sflt317', 'ncmagra54', 'aileyvaa', 'mustafayigitesen', 'uzunnurdan', 'eliffsu.koc', 'halilalp', 'jessica.satyarthi', 'ensarerol26', 'klayydar', 'azazimalii', 'gurhankopcaz', 'jyothishjaggarapu225', 'anjaligawai', 'naveen143', 'abcd5454', 'kaanbjk27', 'erdicany', 'alikanadli7', 'jessgomez100', 'tolga.ozyurt24', 'ozcanguclu', 'dhyanasivadas311', 'blassselva', 'wuizar99', 'ozcankutlu15', 'funsal', 'sabriyebayrakcinur', 'mumi1478', 'veyseleee123', 'kingkireeti', 'taol190799', 'emreyilmazel1996', 'rhamwey', 'evelyn.f1975', 'haticeterzibali', 'xavier160mg', 'berksaldr', 'njgarcia5', 'jayopp32', 'jarellano1204', 'muvafikmelikkaya', 'gullit0725', 'jasmine43.jp', 'mrgiraffe', 'irem.karagoz33', 'rebecasalcido', 'jatin.us', 'esuna006', 'haoliu', 'aayushik', 'emre.ibil', 'burakbeyazt', 'testeremre70', 'ezelbilgili', 'anilboran0671', 'bryang511', 'yamakonurcan', 'yorumhesabimsa', 'kodaar', 'carlosquinonez80', 'sai.ssm', 'zilmidegne', 'michaelpov', 'anand.satyam', 'berkc', 'selinyasaci98', 'orancagdas', 'ninad.ps', 'sonerkar', 'tugbakoyuncu99', 'yusmar', 'kaankuncak', 'ulises98', 'kagankilicaslan28', 'petersan901']",5,"['ozumkocaman9', 'atakanerdogann1', 'smrf432', None, 'ekim.coskun19']",213,"['mgk816', 'cmergil39', 'mcsonic', 'prosdocimi.m', 'dleon3', 'yunusyeo768', 'evren_aydin6', 'mtakcali', 'emreoney', 'mapayan5', 'swarupadhyay777', 'esulekaplan', 'kenanke', 'fztrnetflix', 'nsener45', 'ekin.gezer', 'joker632455', 'ganesh25', 'okanozkann95', 'murattdo', 'roy227', 'ezelbilgili42', 'burak.baha00', 'youlianafouad17', 'salvalenzuela12', 'isma', 'metobomm', 'enesdinler1', 'krishna.mp', 'jmoya5', 'almelnz2005', 'fjduran3', 'sarawaelahmed22', 'ryckmonster', 'macolmenero', 'bsanchez', 'venkitesh.s', 'garfon61', 'nnurceylan95', 'w.edgarfamous', 'furkan069906', 'arivera35', 'agmendez14', 'alex10', 'ozumkocaman9', 'jozrik', 'omerdmrc16', 'bertansafak', 'ajortega6', 'zeynep', 'mahmutcanki', 'mstff.1clkk', 'kumar_shubham', 'mmozcan4', 'alibatuhanozturk', 'jadelira201', 'smrf432', 'arif.ozkan5806', 'karpuz', 'atakanerdogann1', 'sigalam', 'shrreya07', 'blogan', 'esraboran71', 'mseyfullahcelik', 'chrisodomx', 'kagangunes10', '1967hamzausta', 'dmitry.stor', 'goknur.derinoz', 'garciaje34454', 'afurkanbudak42', 'ufuk', 'diaz.carlos4499', 'kemre9827', 'ekim.coskun19', 'scopigno', 'brs21', 'nikharv.19110125', 'halilibrahimtiken', 'ege.ert7', 'fdominguez6', 'ademfurkan', 'havvafatmaozbay', 'sayed.aftabahmad786', 'gtzintzarov', 'mehmetaliyas1998', 'ceydabayrak581', 'elembengisu', 'ferhbk97', 'dblancarte', 'mmb', 'utkubala63', None, 'mertisleyen96', 'iremnurfiliz', 'dragon28540', 'elifindir', 'sebastiangarcia695', 'koningmehmet', 'serhatiseri', 'shaawanalmutairi', 'aadelgado4', 'jagallegos7', 'altinbasnurcan09', 'druiz20', 'pongbrayan', 'bmendoza4', 'mustafa.kaya0798507', 'pmhernandez4', 'paras128', 'klc.mrt.1926', 'windl', 'rmartinez5', 'lerner', 'banoth.dinesh', 'furkan2072', 'fatihyorgun1996', 'sai.mrr', 'drhodges', 'simayozbay', 'erencanarslan70', 'choudhary_s', 'emregonen', 'murat.ozeee', 'anurag_kurle', 'emrecitakk', 'ardelarosa', 'yash.mh', 'furkan552senturk', 'shashi.sarraf', 'mehmettasdelen26', 'kanwat.pranav', 'cancetinkaya1201', 'saineeth', 'sflt317', 'ncmagra54', 'aileyvaa', 'mustafayigitesen', 'uzunnurdan', 'eliffsu.koc', 'halilalp', 'jessica.satyarthi', 'ensarerol26', 'klayydar', 'azazimalii', 'gurhankopcaz', 'jyothishjaggarapu225', 'anjaligawai', 'naveen143', 'abcd5454', 'kaanbjk27', 'erdicany', 'alikanadli7', 'serdememen', 'jessgomez100', 'tolga.ozyurt24', 'ozcanguclu', 'dhyanasivadas311', 'blassselva', 'wuizar99', 'ozcankutlu15', 'funsal', 'sabriyebayrakcinur', 'mumi1478', 'veyseleee123', 'kingkireeti', 'taol190799', 'emreyilmazel1996', 'rhamwey', 'evelyn.f1975', 'haticeterzibali', 'xavier160mg', 'berksaldr', 'njgarcia5', 'jayopp32', 'jarellano1204', 'muvafikmelikkaya', 'gullit0725', 'jasmine43.jp', 'mrgiraffe', 'irem.karagoz33', 'rebecasalcido', 'jatin.us', 'esuna006', 'haoliu', 'aayushik', 'emre.ibil', 'burakbeyazt', 'testeremre70', 'ezelbilgili', 'anilboran0671', 'bryang511', 'yamakonurcan', 'yorumhesabimsa', 'kodaar', 'carlosquinonez80', 'sai.ssm', 'zilmidegne', 'michaelpov', 'anand.satyam', 'berkc', 'selinyasaci98', 'orancagdas', 'ninad.ps', 'sonerkar', 'tugbakoyuncu99', 'yusmar', 'kaankuncak', 'ulises98', 'kagankilicaslan28', 'petersan901', 'yasinzgen']"
3,25,209,7,3,"['murat.ozeee', 'nsener45', 'ozcanguclu']",205,"['mgk816', 'cmergil39', 'mcsonic', 'prosdocimi.m', 'dleon3', 'yunusyeo768', 'evren_aydin6', 'mtakcali', 'emreoney', 'mapayan5', 'swarupadhyay777', 'esulekaplan', 'kenanke', 'fztrnetflix', 'ekin.gezer', 'joker632455', 'ganesh25', 'okanozkann95', 'murattdo', 'roy227', 'ezelbilgili42', 'burak.baha00', 'youlianafouad17', 'salvalenzuela12', 'isma', 'metobomm', 'enesdinler1', 'krishna.mp', 'jmoya5', 'almelnz2005', 'fjduran3', 'sarawaelahmed22', 'ryckmonster', 'macolmenero', 'bsanchez', 'venkitesh.s', 'garfon61', 'nnurceylan95', 'w.edgarfamous', 'furkan069906', 'arivera35', 'agmendez14', 'alex10', 'jozrik', 'omerdmrc16', 'bertansafak', 'ajortega6', 'zeynep', 'mahmutcanki', 'mstff.1clkk', 'kumar_shubham', 'mmozcan4', 'alibatuhanozturk', 'jadelira201', 'arif.ozkan5806', 'karpuz', 'sigalam', 'shrreya07', 'blogan', 'esraboran71', 'mseyfullahcelik', 'chrisodomx', 'kagangunes10', '1967hamzausta', 'dmitry.stor', 'goknur.derinoz', 'garciaje34454', 'afurkanbudak42', 'ufuk', 'diaz.carlos4499', 'kemre9827', 'scopigno', 'brs21', 'nikharv.19110125', 'halilibrahimtiken', 'ege.ert7', 'fdominguez6', 'ademfurkan', 'havvafatmaozbay', 'sayed.aftabahmad786', 'gtzintzarov', 'mehmetaliyas1998', 'ceydabayrak581', 'elembengisu', 'ferhbk97', 'dblancarte', 'mmb', 'utkubala63', 'mertisleyen96', 'iremnurfiliz', 'dragon28540', 'elifindir', 'sebastiangarcia695', 'koningmehmet', 'serhatiseri', 'shaawanalmutairi', 'aadelgado4', 'jagallegos7', 'altinbasnurcan09', 'druiz20', 'pongbrayan', 'bmendoza4', 'mustafa.kaya0798507', 'pmhernandez4', 'paras128', 'klc.mrt.1926', 'windl', 'rmartinez5', 'lerner', 'banoth.dinesh', 'furkan2072', 'fatihyorgun1996', 'sai.mrr', 'drhodges', 'simayozbay', 'erencanarslan70', 'choudhary_s', 'emregonen', 'anurag_kurle', 'emrecitakk', 'ardelarosa', 'yash.mh', 'furkan552senturk', 'shashi.sarraf', 'mehmettasdelen26', 'kanwat.pranav', 'cancetinkaya1201', 'saineeth', 'sflt317', 'ncmagra54', 'aileyvaa', 'mustafayigitesen', 'uzunnurdan', 'eliffsu.koc', 'halilalp', 'jessica.satyarthi', 'ensarerol26', 'klayydar', 'azazimalii', 'gurhankopcaz', 'jyothishjaggarapu225', 'anjaligawai', 'naveen143', 'abcd5454', 'kaanbjk27', 'erdicany', 'alikanadli7', 'serdememen', 'jessgomez100', 'tolga.ozyurt24', 'dhyanasivadas311', 'blassselva', 'wuizar99', 'ozcankutlu15', 'funsal', 'sabriyebayrakcinur', 'mumi1478', 'veyseleee123', 'kingkireeti', 'taol190799', 'emreyilmazel1996', 'rhamwey', 'evelyn.f1975', 'haticeterzibali', 'xavier160mg', 'berksaldr', 'njgarcia5', 'jayopp32', 'jarellano1204', 'muvafikmelikkaya', 'gullit0725', 'jasmine43.jp', 'mrgiraffe', 'irem.karagoz33', 'rebecasalcido', 'jatin.us', 'esuna006', 'haoliu', 'aayushik', 'emre.ibil', 'burakbeyazt', 'testeremre70', 'ezelbilgili', 'anilboran0671', 'bryang511', 'yamakonurcan', 'yorumhesabimsa', 'kodaar', 'carlosquinonez80', 'sai.ssm', 'zilmidegne', 'michaelpov', 'anand.satyam', 'berkc', 'selinyasaci98', 'orancagdas', 'ninad.ps', 'sonerkar', 'tugbakoyuncu99', 'yusmar', 'kaankuncak', 'ulises98', 'kagankilicaslan28', 'petersan901', 'yasinzgen']",4,"['gnskdr52', 'tapur500', None, 'kizilinozlem']",212,"['mgk816', 'cmergil39', 'mcsonic', 'prosdocimi.m', 'dleon3', 'yunusyeo768', 'evren_aydin6', 'mtakcali', 'emreoney', 'mapayan5', 'swarupadhyay777', 'esulekaplan', 'kenanke', 'fztrnetflix', 'nsener45', 'ekin.gezer', 'joker632455', 'ganesh25', 'okanozkann95', 'murattdo', 'roy227', 'ezelbilgili42', 'burak.baha00', 'youlianafouad17', 'salvalenzuela12', 'isma', 'metobomm', 'enesdinler1', 'krishna.mp', 'jmoya5', 'almelnz2005', 'fjduran3', 'sarawaelahmed22', 'ryckmonster', 'macolmenero', 'bsanchez', 'venkitesh.s', 'garfon61', 'nnurceylan95', 'w.edgarfamous', 'furkan069906', 'arivera35', 'agmendez14', 'alex10', 'jozrik', 'omerdmrc16', 'bertansafak', 'ajortega6', 'zeynep', 'mahmutcanki', 'mstff.1clkk', 'kumar_shubham', 'mmozcan4', 'alibatuhanozturk', 'jadelira201', 'arif.ozkan5806', 'karpuz', 'kizilinozlem', 'sigalam', 'shrreya07', 'blogan', 'esraboran71', 'mseyfullahcelik', 'chrisodomx', 'kagangunes10', '1967hamzausta', 'dmitry.stor', 'goknur.derinoz', 'garciaje34454', 'afurkanbudak42', 'ufuk', 'diaz.carlos4499', 'kemre9827', 'scopigno', 'brs21', 'nikharv.19110125', 'halilibrahimtiken', 'ege.ert7', 'fdominguez6', 'ademfurkan', 'havvafatmaozbay', 'sayed.aftabahmad786', 'gtzintzarov', 'mehmetaliyas1998', 'ceydabayrak581', 'elembengisu', 'ferhbk97', 'dblancarte', 'mmb', 'utkubala63', None, 'mertisleyen96', 'iremnurfiliz', 'dragon28540', 'elifindir', 'sebastiangarcia695', 'koningmehmet', 'serhatiseri', 'tapur500', 'shaawanalmutairi', 'aadelgado4', 'jagallegos7', 'altinbasnurcan09', 'druiz20', 'pongbrayan', 'bmendoza4', 'mustafa.kaya0798507', 'pmhernandez4', 'paras128', 'klc.mrt.1926', 'windl', 'rmartinez5', 'lerner', 'banoth.dinesh', 'furkan2072', 'fatihyorgun1996', 'sai.mrr', 'drhodges', 'simayozbay', 'erencanarslan70', 'choudhary_s', 'emregonen', 'murat.ozeee', 'anurag_kurle', 'emrecitakk', 'ardelarosa', 'yash.mh', 'furkan552senturk', 'shashi.sarraf', 'mehmettasdelen26', 'kanwat.pranav', 'cancetinkaya1201', 'saineeth', 'sflt317', 'ncmagra54', 'aileyvaa', 'mustafayigitesen', 'uzunnurdan', 'eliffsu.koc', 'halilalp', 'jessica.satyarthi', 'ensarerol26', 'klayydar', 'azazimalii', 'gurhankopcaz', 'jyothishjaggarapu225', 'anjaligawai', 'naveen143', 'abcd5454', 'kaanbjk27', 'erdicany', 'alikanadli7', 'gnskdr52', 'serdememen', 'jessgomez100', 'tolga.ozyurt24', 'ozcanguclu', 'dhyanasivadas311', 'blassselva', 'wuizar99', 'ozcankutlu15', 'funsal', 'sabriyebayrakcinur', 'mumi1478', 'veyseleee123', 'kingkireeti', 'taol190799', 'emreyilmazel1996', 'rhamwey', 'evelyn.f1975', 'haticeterzibali', 'xavier160mg', 'berksaldr', 'njgarcia5', 'jayopp32', 'jarellano1204', 'muvafikmelikkaya', 'gullit0725', 'jasmine43.jp', 'mrgiraffe', 'irem.karagoz33', 'rebecasalcido', 'jatin.us', 'esuna006', 'haoliu', 'aayushik', 'emre.ibil', 'burakbeyazt', 'testeremre70', 'ezelbilgili', 'anilboran0671', 'bryang511', 'yamakonurcan', 'yorumhesabimsa', 'kodaar', 'carlosquinonez80', 'sai.ssm', 'zilmidegne', 'michaelpov', 'anand.satyam', 'berkc', 'selinyasaci98', 'orancagdas', 'ninad.ps', 'sonerkar', 'tugbakoyuncu99', 'yusmar', 'kaankuncak', 'ulises98', 'kagankilicaslan28', 'petersan901', 'yasinzgen']"
3,393,209,7,4,"['azazimalii', 'kemre9827', 'metobomm', 'enesdinler1']",204,"['mgk816', 'cmergil39', 'mcsonic', 'prosdocimi.m', 'dleon3', 'yunusyeo768', 'evren_aydin6', 'mtakcali', 'emreoney', 'mapayan5', 'swarupadhyay777', 'esulekaplan', 'kenanke', 'fztrnetflix', 'nsener45', 'ekin.gezer', 'joker632455', 'ganesh25', 'okanozkann95', 'murattdo', 'roy227', 'ezelbilgili42', 'burak.baha00', 'youlianafouad17', 'salvalenzuela12', 'isma', 'krishna.mp', 'jmoya5', 'almelnz2005', 'fjduran3', 'sarawaelahmed22', 'ryckmonster', 'macolmenero', 'bsanchez', 'venkitesh.s', 'garfon61', 'nnurceylan95', 'w.edgarfamous', 'furkan069906', 'arivera35', 'agmendez14', 'alex10', 'jozrik', 'omerdmrc16', 'bertansafak', 'ajortega6', 'zeynep', 'mahmutcanki', 'mstff.1clkk', 'kumar_shubham', 'mmozcan4', 'alibatuhanozturk', 'jadelira201', 'arif.ozkan5806', 'karpuz', 'sigalam', 'shrreya07', 'blogan', 'esraboran71', 'mseyfullahcelik', 'chrisodomx', 'kagangunes10', '1967hamzausta', 'dmitry.stor', 'goknur.derinoz', 'garciaje34454', 'afurkanbudak42', 'ufuk', 'diaz.carlos4499', 'scopigno', 'brs21', 'nikharv.19110125', 'halilibrahimtiken', 'ege.ert7', 'fdominguez6', 'ademfurkan', 'havvafatmaozbay', 'sayed.aftabahmad786', 'gtzintzarov', 'mehmetaliyas1998', 'ceydabayrak581', 'elembengisu', 'ferhbk97', 'dblancarte', 'mmb', 'utkubala63', 'mertisleyen96', 'iremnurfiliz', 'dragon28540', 'elifindir', 'sebastiangarcia695', 'koningmehmet', 'serhatiseri', 'shaawanalmutairi', 'aadelgado4', 'jagallegos7', 'altinbasnurcan09', 'druiz20', 'pongbrayan', 'bmendoza4', 'mustafa.kaya0798507', 'pmhernandez4', 'paras128', 'klc.mrt.1926', 'windl', 'rmartinez5', 'lerner', 'banoth.dinesh', 'furkan2072', 'fatihyorgun1996', 'sai.mrr', 'drhodges', 'simayozbay', 'erencanarslan70', 'choudhary_s', 'emregonen', 'murat.ozeee', 'anurag_kurle', 'emrecitakk', 'ardelarosa', 'yash.mh', 'furkan552senturk', 'shashi.sarraf', 'mehmettasdelen26', 'kanwat.pranav', 'cancetinkaya1201', 'saineeth', 'sflt317', 'ncmagra54', 'aileyvaa', 'mustafayigitesen', 'uzunnurdan', 'eliffsu.koc', 'halilalp', 'jessica.satyarthi', 'ensarerol26', 'klayydar', 'gurhankopcaz', 'jyothishjaggarapu225', 'anjaligawai', 'naveen143', 'abcd5454', 'kaanbjk27', 'erdicany', 'alikanadli7', 'serdememen', 'jessgomez100', 'tolga.ozyurt24', 'ozcanguclu', 'dhyanasivadas311', 'blassselva', 'wuizar99', 'ozcankutlu15', 'funsal', 'sabriyebayrakcinur', 'mumi1478', 'veyseleee123', 'kingkireeti', 'taol190799', 'emreyilmazel1996', 'rhamwey', 'evelyn.f1975', 'haticeterzibali', 'xavier160mg', 'berksaldr', 'njgarcia5', 'jayopp32', 'jarellano1204', 'muvafikmelikkaya', 'gullit0725', 'jasmine43.jp', 'mrgiraffe', 'irem.karagoz33', 'rebecasalcido', 'jatin.us', 'esuna006', 'haoliu', 'aayushik', 'emre.ibil', 'burakbeyazt', 'testeremre70', 'ezelbilgili', 'anilboran0671', 'bryang511', 'yamakonurcan', 'yorumhesabimsa', 'kodaar', 'carlosquinonez80', 'sai.ssm', 'zilmidegne', 'michaelpov', 'anand.satyam', 'berkc', 'selinyasaci98', 'orancagdas', 'ninad.ps', 'sonerkar', 'tugbakoyuncu99', 'yusmar', 'kaankuncak', 'ulises98', 'kagankilicaslan28', 'petersan901', 'yasinzgen']",3,"['beskisehir', None, 'cemaloz745']",211,"['mgk816', 'cmergil39', 'mcsonic', 'prosdocimi.m', 'dleon3', 'yunusyeo768', 'evren_aydin6', 'mtakcali', 'emreoney', 'mapayan5', 'swarupadhyay777', 'esulekaplan', 'kenanke', 'fztrnetflix', 'nsener45', 'ekin.gezer', 'joker632455', 'ganesh25', 'okanozkann95', 'murattdo', 'roy227', 'ezelbilgili42', 'burak.baha00', 'youlianafouad17', 'salvalenzuela12', 'isma', 'metobomm', 'enesdinler1', 'krishna.mp', 'jmoya5', 'almelnz2005', 'fjduran3', 'sarawaelahmed22', 'ryckmonster', 'macolmenero', 'bsanchez', 'venkitesh.s', 'garfon61', 'nnurceylan95', 'w.edgarfamous', 'furkan069906', 'arivera35', 'agmendez14', 'alex10', 'jozrik', 'omerdmrc16', 'bertansafak', 'ajortega6', 'zeynep', 'mahmutcanki', 'mstff.1clkk', 'kumar_shubham', 'mmozcan4', 'alibatuhanozturk', 'jadelira201', 'arif.ozkan5806', 'karpuz', 'cemaloz745', 'sigalam', 'shrreya07', 'blogan', 'esraboran71', 'mseyfullahcelik', 'chrisodomx', 'kagangunes10', '1967hamzausta', 'dmitry.stor', 'goknur.derinoz', 'garciaje34454', 'afurkanbudak42', 'ufuk', 'diaz.carlos4499', 'kemre9827', 'scopigno', 'brs21', 'nikharv.19110125', 'halilibrahimtiken', 'ege.ert7', 'fdominguez6', 'ademfurkan', 'havvafatmaozbay', 'sayed.aftabahmad786', 'gtzintzarov', 'mehmetaliyas1998', 'ceydabayrak581', 'elembengisu', 'ferhbk97', 'dblancarte', 'mmb', 'utkubala63', None, 'mertisleyen96', 'iremnurfiliz', 'dragon28540', 'elifindir', 'sebastiangarcia695', 'koningmehmet', 'serhatiseri', 'shaawanalmutairi', 'aadelgado4', 'jagallegos7', 'altinbasnurcan09', 'druiz20', 'pongbrayan', 'bmendoza4', 'mustafa.kaya0798507', 'pmhernandez4', 'paras128', 'klc.mrt.1926', 'windl', 'rmartinez5', 'lerner', 'banoth.dinesh', 'furkan2072', 'fatihyorgun1996', 'sai.mrr', 'drhodges', 'simayozbay', 'erencanarslan70', 'choudhary_s', 'emregonen', 'murat.ozeee', 'anurag_kurle', 'emrecitakk', 'ardelarosa', 'yash.mh', 'furkan552senturk', 'shashi.sarraf', 'mehmettasdelen26', 'kanwat.pranav', 'cancetinkaya1201', 'saineeth', 'sflt317', 'ncmagra54', 'aileyvaa', 'mustafayigitesen', 'uzunnurdan', 'eliffsu.koc', 'halilalp', 'jessica.satyarthi', 'ensarerol26', 'klayydar', 'azazimalii', 'gurhankopcaz', 'jyothishjaggarapu225', 'anjaligawai', 'naveen143', 'abcd5454', 'kaanbjk27', 'erdicany', 'alikanadli7', 'serdememen', 'jessgomez100', 'tolga.ozyurt24', 'ozcanguclu', 'dhyanasivadas311', 'blassselva', 'wuizar99', 'ozcankutlu15', 'funsal', 'sabriyebayrakcinur', 'mumi1478', 'veyseleee123', 'kingkireeti', 'taol190799', 'emreyilmazel1996', 'rhamwey', 'evelyn.f1975', 'haticeterzibali', 'xavier160mg', 'berksaldr', 'njgarcia5', 'beskisehir', 'jayopp32', 'jarellano1204', 'muvafikmelikkaya', 'gullit0725', 'jasmine43.jp', 'mrgiraffe', 'irem.karagoz33', 'rebecasalcido', 'jatin.us', 'esuna006', 'haoliu', 'aayushik', 'emre.ibil', 'burakbeyazt', 'testeremre70', 'ezelbilgili', 'anilboran0671', 'bryang511', 'yamakonurcan', 'yorumhesabimsa', 'kodaar', 'carlosquinonez80', 'sai.ssm', 'zilmidegne', 'michaelpov', 'anand.satyam', 'berkc', 'selinyasaci98', 'orancagdas', 'ninad.ps', 'sonerkar', 'tugbakoyuncu99', 'yusmar', 'kaankuncak', 'ulises98', 'kagankilicaslan28', 'petersan901', 'yasinzgen']"
3,234,209,6,3,"['ademfurkan', 'yunusyeo768', 'anilboran0671']",205,"['mgk816', 'cmergil39', 'mcsonic', 'prosdocimi.m', 'dleon3', 'evren_aydin6', 'mtakcali', 'emreoney', 'mapayan5', 'swarupadhyay777', 'esulekaplan', 'kenanke', 'fztrnetflix', 'nsener45', 'ekin.gezer', 'joker632455', 'ganesh25', 'okanozkann95', 'murattdo', 'roy227', 'ezelbilgili42', 'burak.baha00', 'youlianafouad17', 'salvalenzuela12', 'isma', 'metobomm', 'enesdinler1', 'krishna.mp', 'jmoya5', 'almelnz2005', 'fjduran3', 'sarawaelahmed22', 'ryckmonster', 'macolmenero', 'bsanchez', 'venkitesh.s', 'garfon61', 'nnurceylan95', 'w.edgarfamous', 'furkan069906', 'arivera35', 'agmendez14', 'alex10', 'jozrik', 'omerdmrc16', 'bertansafak', 'ajortega6', 'zeynep', 'mahmutcanki', 'mstff.1clkk', 'kumar_shubham', 'mmozcan4', 'alibatuhanozturk', 'jadelira201', 'arif.ozkan5806', 'karpuz', 'sigalam', 'shrreya07', 'blogan', 'esraboran71', 'mseyfullahcelik', 'chrisodomx', 'kagangunes10', '1967hamzausta', 'dmitry.stor', 'goknur.derinoz', 'garciaje34454', 'afurkanbudak42', 'ufuk', 'diaz.carlos4499', 'kemre9827', 'scopigno', 'brs21', 'nikharv.19110125', 'halilibrahimtiken', 'ege.ert7', 'fdominguez6', 'havvafatmaozbay', 'sayed.aftabahmad786', 'gtzintzarov', 'mehmetaliyas1998', 'ceydabayrak581', 'elembengisu', 'ferhbk97', 'dblancarte', 'mmb', 'utkubala63', 'mertisleyen96', 'iremnurfiliz', 'dragon28540', 'elifindir', 'sebastiangarcia695', 'koningmehmet', 'serhatiseri', 'shaawanalmutairi', 'aadelgado4', 'jagallegos7', 'altinbasnurcan09', 'druiz20', 'pongbrayan', 'bmendoza4', 'mustafa.kaya0798507', 'pmhernandez4', 'paras128', 'klc.mrt.1926', 'windl', 'rmartinez5', 'lerner', 'banoth.dinesh', 'furkan2072', 'fatihyorgun1996', 'sai.mrr', 'drhodges', 'simayozbay', 'erencanarslan70', 'choudhary_s', 'emregonen', 'murat.ozeee', 'anurag_kurle', 'emrecitakk', 'ardelarosa', 'yash.mh', 'furkan552senturk', 'shashi.sarraf', 'mehmettasdelen26', 'kanwat.pranav', 'cancetinkaya1201', 'saineeth', 'sflt317', 'ncmagra54', 'aileyvaa', 'mustafayigitesen', 'uzunnurdan', 'eliffsu.koc', 'halilalp', 'jessica.satyarthi', 'ensarerol26', 'klayydar', 'azazimalii', 'gurhankopcaz', 'jyothishjaggarapu225', 'anjaligawai', 'naveen143', 'abcd5454', 'kaanbjk27', 'erdicany', 'alikanadli7', 'serdememen', 'jessgomez100', 'tolga.ozyurt24', 'ozcanguclu', 'dhyanasivadas311', 'blassselva', 'wuizar99', 'ozcankutlu15', 'funsal', 'sabriyebayrakcinur', 'mumi1478', 'veyseleee123', 'kingkireeti', 'taol190799', 'emreyilmazel1996', 'rhamwey', 'evelyn.f1975', 'haticeterzibali', 'xavier160mg', 'berksaldr', 'njgarcia5', 'jayopp32', 'jarellano1204', 'muvafikmelikkaya', 'gullit0725', 'jasmine43.jp', 'mrgiraffe', 'irem.karagoz33', 'rebecasalcido', 'jatin.us', 'esuna006', 'haoliu', 'aayushik', 'emre.ibil', 'burakbeyazt', 'testeremre70', 'ezelbilgili', 'bryang511', 'yamakonurcan', 'yorumhesabimsa', 'kodaar', 'carlosquinonez80', 'sai.ssm', 'zilmidegne', 'michaelpov', 'anand.satyam', 'berkc', 'selinyasaci98', 'orancagdas', 'ninad.ps', 'sonerkar', 'tugbakoyuncu99', 'yusmar', 'kaankuncak', 'ulises98', 'kagankilicaslan28', 'petersan901', 'yasinzgen']",3,"[None, 'kereminoo', 'mustafalbayrak1998']",211,"['mgk816', 'cmergil39', 'mcsonic', 'prosdocimi.m', 'dleon3', 'yunusyeo768', 'evren_aydin6', 'mtakcali', 'emreoney', 'mapayan5', 'swarupadhyay777', 'kereminoo', 'esulekaplan', 'kenanke', 'fztrnetflix', 'nsener45', 'ekin.gezer', 'joker632455', 'ganesh25', 'okanozkann95', 'murattdo', 'roy227', 'ezelbilgili42', 'burak.baha00', 'youlianafouad17', 'salvalenzuela12', 'isma', 'metobomm', 'enesdinler1', 'krishna.mp', 'jmoya5', 'almelnz2005', 'fjduran3', 'sarawaelahmed22', 'ryckmonster', 'macolmenero', 'bsanchez', 'venkitesh.s', 'garfon61', 'nnurceylan95', 'w.edgarfamous', 'furkan069906', 'arivera35', 'agmendez14', 'alex10', 'jozrik', 'omerdmrc16', 'bertansafak', 'ajortega6', 'zeynep', 'mahmutcanki', 'mstff.1clkk', 'kumar_shubham', 'mmozcan4', 'alibatuhanozturk', 'jadelira201', 'arif.ozkan5806', 'karpuz', 'sigalam', 'shrreya07', 'blogan', 'esraboran71', 'mseyfullahcelik', 'chrisodomx', 'kagangunes10', '1967hamzausta', 'dmitry.stor', 'goknur.derinoz', 'garciaje34454', 'afurkanbudak42', 'ufuk', 'diaz.carlos4499', 'kemre9827', 'scopigno', 'brs21', 'nikharv.19110125', 'halilibrahimtiken', 'ege.ert7', 'fdominguez6', 'ademfurkan', 'havvafatmaozbay', 'mustafalbayrak1998', 'sayed.aftabahmad786', 'gtzintzarov', 'mehmetaliyas1998', 'ceydabayrak581', 'elembengisu', 'ferhbk97', 'dblancarte', 'mmb', 'utkubala63', None, 'mertisleyen96', 'iremnurfiliz', 'dragon28540', 'elifindir', 'sebastiangarcia695', 'koningmehmet', 'serhatiseri', 'shaawanalmutairi', 'aadelgado4', 'jagallegos7', 'altinbasnurcan09', 'druiz20', 'pongbrayan', 'bmendoza4', 'mustafa.kaya0798507', 'pmhernandez4', 'paras128', 'klc.mrt.1926', 'windl', 'rmartinez5', 'lerner', 'banoth.dinesh', 'furkan2072', 'fatihyorgun1996', 'sai.mrr', 'drhodges', 'simayozbay', 'erencanarslan70', 'choudhary_s', 'emregonen', 'murat.ozeee', 'anurag_kurle', 'emrecitakk', 'ardelarosa', 'yash.mh', 'furkan552senturk', 'shashi.sarraf', 'mehmettasdelen26', 'kanwat.pranav', 'cancetinkaya1201', 'saineeth', 'sflt317', 'ncmagra54', 'aileyvaa', 'mustafayigitesen', 'uzunnurdan', 'eliffsu.koc', 'halilalp', 'jessica.satyarthi', 'ensarerol26', 'klayydar', 'azazimalii', 'gurhankopcaz', 'jyothishjaggarapu225', 'anjaligawai', 'naveen143', 'abcd5454', 'kaanbjk27', 'erdicany', 'alikanadli7', 'serdememen', 'jessgomez100', 'tolga.ozyurt24', 'ozcanguclu', 'dhyanasivadas311', 'blassselva', 'wuizar99', 'ozcankutlu15', 'funsal', 'sabriyebayrakcinur', 'mumi1478', 'veyseleee123', 'kingkireeti', 'taol190799', 'emreyilmazel1996', 'rhamwey', 'evelyn.f1975', 'haticeterzibali', 'xavier160mg', 'berksaldr', 'njgarcia5', 'jayopp32', 'jarellano1204', 'muvafikmelikkaya', 'gullit0725', 'jasmine43.jp', 'mrgiraffe', 'irem.karagoz33', 'rebecasalcido', 'jatin.us', 'esuna006', 'haoliu', 'aayushik', 'emre.ibil', 'burakbeyazt', 'testeremre70', 'ezelbilgili', 'anilboran0671', 'bryang511', 'yamakonurcan', 'yorumhesabimsa', 'kodaar', 'carlosquinonez80', 'sai.ssm', 'zilmidegne', 'michaelpov', 'anand.satyam', 'berkc', 'selinyasaci98', 'orancagdas', 'ninad.ps', 'sonerkar', 'tugbakoyuncu99', 'yusmar', 'kaankuncak', 'ulises98', 'kagankilicaslan28', 'petersan901', 'yasinzgen']"
3,262,209,6,1,['esulekaplan'],207,"['mgk816', 'cmergil39', 'mcsonic', 'prosdocimi.m', 'dleon3', 'yunusyeo768', 'evren_aydin6', 'mtakcali', 'emreoney', 'mapayan5', 'swarupadhyay777', 'kenanke', 'fztrnetflix', 'nsener45', 'ekin.gezer', 'joker632455', 'ganesh25', 'okanozkann95', 'murattdo', 'roy227', 'ezelbilgili42', 'burak.baha00', 'youlianafouad17', 'salvalenzuela12', 'isma', 'metobomm', 'enesdinler1', 'krishna.mp', 'jmoya5', 'almelnz2005', 'fjduran3', 'sarawaelahmed22', 'ryckmonster', 'macolmenero', 'bsanchez', 'venkitesh.s', 'garfon61', 'nnurceylan95', 'w.edgarfamous', 'furkan069906', 'arivera35', 'agmendez14', 'alex10', 'jozrik', 'omerdmrc16', 'bertansafak', 'ajortega6', 'zeynep', 'mahmutcanki', 'mstff.1clkk', 'kumar_shubham', 'mmozcan4', 'alibatuhanozturk', 'jadelira201', 'arif.ozkan5806', 'karpuz', 'sigalam', 'shrreya07', 'blogan', 'esraboran71', 'mseyfullahcelik', 'chrisodomx', 'kagangunes10', '1967hamzausta', 'dmitry.stor', 'goknur.derinoz', 'garciaje34454', 'afurkanbudak42', 'ufuk', 'diaz.carlos4499', 'kemre9827', 'scopigno', 'brs21', 'nikharv.19110125', 'halilibrahimtiken', 'ege.ert7', 'fdominguez6', 'ademfurkan', 'havvafatmaozbay', 'sayed.aftabahmad786', 'gtzintzarov', 'mehmetaliyas1998', 'ceydabayrak581', 'elembengisu', 'ferhbk97', 'dblancarte', 'mmb', 'utkubala63', 'mertisleyen96', 'iremnurfiliz', 'dragon28540', 'elifindir', 'sebastiangarcia695', 'koningmehmet', 'serhatiseri', 'shaawanalmutairi', 'aadelgado4', 'jagallegos7', 'altinbasnurcan09', 'druiz20', 'pongbrayan', 'bmendoza4', 'mustafa.kaya0798507', 'pmhernandez4', 'paras128', 'klc.mrt.1926', 'windl', 'rmartinez5', 'lerner', 'banoth.dinesh', 'furkan2072', 'fatihyorgun1996', 'sai.mrr', 'drhodges', 'simayozbay', 'erencanarslan70', 'choudhary_s', 'emregonen', 'murat.ozeee', 'anurag_kurle', 'emrecitakk', 'ardelarosa', 'yash.mh', 'furkan552senturk', 'shashi.sarraf', 'mehmettasdelen26', 'kanwat.pranav', 'cancetinkaya1201', 'saineeth', 'sflt317', 'ncmagra54', 'aileyvaa', 'mustafayigitesen', 'uzunnurdan', 'eliffsu.koc', 'halilalp', 'jessica.satyarthi', 'ensarerol26', 'klayydar', 'azazimalii', 'gurhankopcaz', 'jyothishjaggarapu225', 'anjaligawai', 'naveen143', 'abcd5454', 'kaanbjk27', 'erdicany', 'alikanadli7', 'serdememen', 'jessgomez100', 'tolga.ozyurt24', 'ozcanguclu', 'dhyanasivadas311', 'blassselva', 'wuizar99', 'ozcankutlu15', 'funsal', 'sabriyebayrakcinur', 'mumi1478', 'veyseleee123', 'kingkireeti', 'taol190799', 'emreyilmazel1996', 'rhamwey', 'evelyn.f1975', 'haticeterzibali', 'xavier160mg', 'berksaldr', 'njgarcia5', 'jayopp32', 'jarellano1204', 'muvafikmelikkaya', 'gullit0725', 'jasmine43.jp', 'mrgiraffe', 'irem.karagoz33', 'rebecasalcido', 'jatin.us', 'esuna006', 'haoliu', 'aayushik', 'emre.ibil', 'burakbeyazt', 'testeremre70', 'ezelbilgili', 'anilboran0671', 'bryang511', 'yamakonurcan', 'yorumhesabimsa', 'kodaar', 'carlosquinonez80', 'sai.ssm', 'zilmidegne', 'michaelpov', 'anand.satyam', 'berkc', 'selinyasaci98', 'orancagdas', 'ninad.ps', 'sonerkar', 'tugbakoyuncu99', 'yusmar', 'kaankuncak', 'ulises98', 'kagankilicaslan28', 'petersan901', 'yasinzgen']",5,"['aknramazan26', 'liswfa123', 'buseduygut', 'tapur500', None]",213,"['mgk816', 'cmergil39', 'mcsonic', 'prosdocimi.m', 'dleon3', 'yunusyeo768', 'evren_aydin6', 'mtakcali', 'emreoney', 'mapayan5', 'swarupadhyay777', 'esulekaplan', 'kenanke', 'fztrnetflix', 'nsener45', 'ekin.gezer', 'joker632455', 'ganesh25', 'okanozkann95', 'murattdo', 'roy227', 'ezelbilgili42', 'burak.baha00', 'youlianafouad17', 'salvalenzuela12', 'isma', 'metobomm', 'enesdinler1', 'krishna.mp', 'jmoya5', 'almelnz2005', 'fjduran3', 'sarawaelahmed22', 'ryckmonster', 'macolmenero', 'bsanchez', 'venkitesh.s', 'garfon61', 'nnurceylan95', 'w.edgarfamous', 'furkan069906', 'arivera35', 'agmendez14', 'alex10', 'jozrik', 'omerdmrc16', 'bertansafak', 'ajortega6', 'zeynep', 'mahmutcanki', 'mstff.1clkk', 'kumar_shubham', 'mmozcan4', 'alibatuhanozturk', 'jadelira201', 'arif.ozkan5806', 'karpuz', 'sigalam', 'shrreya07', 'blogan', 'esraboran71', 'buseduygut', 'mseyfullahcelik', 'chrisodomx', 'kagangunes10', '1967hamzausta', 'dmitry.stor', 'goknur.derinoz', 'garciaje34454', 'afurkanbudak42', 'ufuk', 'diaz.carlos4499', 'kemre9827', 'scopigno', 'brs21', 'nikharv.19110125', 'halilibrahimtiken', 'ege.ert7', 'fdominguez6', 'ademfurkan', 'havvafatmaozbay', 'sayed.aftabahmad786', 'gtzintzarov', 'mehmetaliyas1998', 'ceydabayrak581', 'elembengisu', 'ferhbk97', 'dblancarte', 'mmb', 'utkubala63', None, 'mertisleyen96', 'iremnurfiliz', 'dragon28540', 'elifindir', 'sebastiangarcia695', 'koningmehmet', 'serhatiseri', 'tapur500', 'shaawanalmutairi', 'aadelgado4', 'jagallegos7', 'altinbasnurcan09', 'druiz20', 'pongbrayan', 'bmendoza4', 'mustafa.kaya0798507', 'pmhernandez4', 'paras128', 'klc.mrt.1926', 'windl', 'rmartinez5', 'lerner', 'banoth.dinesh', 'furkan2072', 'fatihyorgun1996', 'sai.mrr', 'drhodges', 'simayozbay', 'erencanarslan70', 'aknramazan26', 'choudhary_s', 'emregonen', 'murat.ozeee', 'anurag_kurle', 'emrecitakk', 'ardelarosa', 'yash.mh', 'furkan552senturk', 'shashi.sarraf', 'mehmettasdelen26', 'kanwat.pranav', 'cancetinkaya1201', 'saineeth', 'sflt317', 'ncmagra54', 'aileyvaa', 'mustafayigitesen', 'uzunnurdan', 'eliffsu.koc', 'halilalp', 'jessica.satyarthi', 'ensarerol26', 'klayydar', 'azazimalii', 'liswfa123', 'gurhankopcaz', 'jyothishjaggarapu225', 'anjaligawai', 'naveen143', 'abcd5454', 'kaanbjk27', 'erdicany', 'alikanadli7', 'serdememen', 'jessgomez100', 'tolga.ozyurt24', 'ozcanguclu', 'dhyanasivadas311', 'blassselva', 'wuizar99', 'ozcankutlu15', 'funsal', 'sabriyebayrakcinur', 'mumi1478', 'veyseleee123', 'kingkireeti', 'taol190799', 'emreyilmazel1996', 'rhamwey', 'evelyn.f1975', 'haticeterzibali', 'xavier160mg', 'berksaldr', 'njgarcia5', 'jayopp32', 'jarellano1204', 'muvafikmelikkaya', 'gullit0725', 'jasmine43.jp', 'mrgiraffe', 'irem.karagoz33', 'rebecasalcido', 'jatin.us', 'esuna006', 'haoliu', 'aayushik', 'emre.ibil', 'burakbeyazt', 'testeremre70', 'ezelbilgili', 'anilboran0671', 'bryang511', 'yamakonurcan', 'yorumhesabimsa', 'kodaar', 'carlosquinonez80', 'sai.ssm', 'zilmidegne', 'michaelpov', 'anand.satyam', 'berkc', 'selinyasaci98', 'orancagdas', 'ninad.ps', 'sonerkar', 'tugbakoyuncu99', 'yusmar', 'kaankuncak', 'ulises98', 'kagankilicaslan28', 'petersan901', 'yasinzgen']"
3,392,209,6,2,"['serdememen', 'havvafatmaozbay']",206,"['mgk816', 'cmergil39', 'mcsonic', 'prosdocimi.m', 'dleon3', 'yunusyeo768', 'evren_aydin6', 'mtakcali', 'emreoney', 'mapayan5', 'swarupadhyay777', 'esulekaplan', 'kenanke', 'fztrnetflix', 'nsener45', 'ekin.gezer', 'joker632455', 'ganesh25', 'okanozkann95', 'murattdo', 'roy227', 'ezelbilgili42', 'burak.baha00', 'youlianafouad17', 'salvalenzuela12', 'isma', 'metobomm', 'enesdinler1', 'krishna.mp', 'jmoya5', 'almelnz2005', 'fjduran3', 'sarawaelahmed22', 'ryckmonster', 'macolmenero', 'bsanchez', 'venkitesh.s', 'garfon61', 'nnurceylan95', 'w.edgarfamous', 'furkan069906', 'arivera35', 'agmendez14', 'alex10', 'jozrik', 'omerdmrc16', 'bertansafak', 'ajortega6', 'zeynep', 'mahmutcanki', 'mstff.1clkk', 'kumar_shubham', 'mmozcan4', 'alibatuhanozturk', 'jadelira201', 'arif.ozkan5806', 'karpuz', 'sigalam', 'shrreya07', 'blogan', 'esraboran71', 'mseyfullahcelik', 'chrisodomx', 'kagangunes10', '1967hamzausta', 'dmitry.stor', 'goknur.derinoz', 'garciaje34454', 'afurkanbudak42', 'ufuk', 'diaz.carlos4499', 'kemre9827', 'scopigno', 'brs21', 'nikharv.19110125', 'halilibrahimtiken', 'ege.ert7', 'fdominguez6', 'ademfurkan', 'sayed.aftabahmad786', 'gtzintzarov', 'mehmetaliyas1998', 'ceydabayrak581', 'elembengisu', 'ferhbk97', 'dblancarte', 'mmb', 'utkubala63', 'mertisleyen96', 'iremnurfiliz', 'dragon28540', 'elifindir', 'sebastiangarcia695', 'koningmehmet', 'serhatiseri', 'shaawanalmutairi', 'aadelgado4', 'jagallegos7', 'altinbasnurcan09', 'druiz20', 'pongbrayan', 'bmendoza4', 'mustafa.kaya0798507', 'pmhernandez4', 'paras128', 'klc.mrt.1926', 'windl', 'rmartinez5', 'lerner', 'banoth.dinesh', 'furkan2072', 'fatihyorgun1996', 'sai.mrr', 'drhodges', 'simayozbay', 'erencanarslan70', 'choudhary_s', 'emregonen', 'murat.ozeee', 'anurag_kurle', 'emrecitakk', 'ardelarosa', 'yash.mh', 'furkan552senturk', 'shashi.sarraf', 'mehmettasdelen26', 'kanwat.pranav', 'cancetinkaya1201', 'saineeth', 'sflt317', 'ncmagra54', 'aileyvaa', 'mustafayigitesen', 'uzunnurdan', 'eliffsu.koc', 'halilalp', 'jessica.satyarthi', 'ensarerol26', 'klayydar', 'azazimalii', 'gurhankopcaz', 'jyothishjaggarapu225', 'anjaligawai', 'naveen143', 'abcd5454', 'kaanbjk27', 'erdicany', 'alikanadli7', 'jessgomez100', 'tolga.ozyurt24', 'ozcanguclu', 'dhyanasivadas311', 'blassselva', 'wuizar99', 'ozcankutlu15', 'funsal', 'sabriyebayrakcinur', 'mumi1478', 'veyseleee123', 'kingkireeti', 'taol190799', 'emreyilmazel1996', 'rhamwey', 'evelyn.f1975', 'haticeterzibali', 'xavier160mg', 'berksaldr', 'njgarcia5', 'jayopp32', 'jarellano1204', 'muvafikmelikkaya', 'gullit0725', 'jasmine43.jp', 'mrgiraffe', 'irem.karagoz33', 'rebecasalcido', 'jatin.us', 'esuna006', 'haoliu', 'aayushik', 'emre.ibil', 'burakbeyazt', 'testeremre70', 'ezelbilgili', 'anilboran0671', 'bryang511', 'yamakonurcan', 'yorumhesabimsa', 'kodaar', 'carlosquinonez80', 'sai.ssm', 'zilmidegne', 'michaelpov', 'anand.satyam', 'berkc', 'selinyasaci98', 'orancagdas', 'ninad.ps', 'sonerkar', 'tugbakoyuncu99', 'yusmar', 'kaankuncak', 'ulises98', 'kagankilicaslan28', 'petersan901', 'yasinzgen']",4,"['ozumkocaman9', 'smrf432', None, 'atakanerdogann1']",212,"['mgk816', 'cmergil39', 'mcsonic', 'prosdocimi.m', 'dleon3', 'yunusyeo768', 'evren_aydin6', 'mtakcali', 'emreoney', 'mapayan5', 'swarupadhyay777', 'esulekaplan', 'kenanke', 'fztrnetflix', 'nsener45', 'ekin.gezer', 'joker632455', 'ganesh25', 'okanozkann95', 'murattdo', 'roy227', 'ezelbilgili42', 'burak.baha00', 'youlianafouad17', 'salvalenzuela12', 'isma', 'metobomm', 'enesdinler1', 'krishna.mp', 'jmoya5', 'almelnz2005', 'fjduran3', 'sarawaelahmed22', 'ryckmonster', 'macolmenero', 'bsanchez', 'venkitesh.s', 'garfon61', 'nnurceylan95', 'w.edgarfamous', 'furkan069906', 'arivera35', 'agmendez14', 'alex10', 'ozumkocaman9', 'jozrik', 'omerdmrc16', 'bertansafak', 'ajortega6', 'zeynep', 'mahmutcanki', 'mstff.1clkk', 'kumar_shubham', 'mmozcan4', 'alibatuhanozturk', 'jadelira201', 'smrf432', 'arif.ozkan5806', 'karpuz', 'atakanerdogann1', 'sigalam', 'shrreya07', 'blogan', 'esraboran71', 'mseyfullahcelik', 'chrisodomx', 'kagangunes10', '1967hamzausta', 'dmitry.stor', 'goknur.derinoz', 'garciaje34454', 'afurkanbudak42', 'ufuk', 'diaz.carlos4499', 'kemre9827', 'scopigno', 'brs21', 'nikharv.19110125', 'halilibrahimtiken', 'ege.ert7', 'fdominguez6', 'ademfurkan', 'havvafatmaozbay', 'sayed.aftabahmad786', 'gtzintzarov', 'mehmetaliyas1998', 'ceydabayrak581', 'elembengisu', 'ferhbk97', 'dblancarte', 'mmb', 'utkubala63', None, 'mertisleyen96', 'iremnurfiliz', 'dragon28540', 'elifindir', 'sebastiangarcia695', 'koningmehmet', 'serhatiseri', 'shaawanalmutairi', 'aadelgado4', 'jagallegos7', 'altinbasnurcan09', 'druiz20', 'pongbrayan', 'bmendoza4', 'mustafa.kaya0798507', 'pmhernandez4', 'paras128', 'klc.mrt.1926', 'windl', 'rmartinez5', 'lerner', 'banoth.dinesh', 'furkan2072', 'fatihyorgun1996', 'sai.mrr', 'drhodges', 'simayozbay', 'erencanarslan70', 'choudhary_s', 'emregonen', 'murat.ozeee', 'anurag_kurle', 'emrecitakk', 'ardelarosa', 'yash.mh', 'furkan552senturk', 'shashi.sarraf', 'mehmettasdelen26', 'kanwat.pranav', 'cancetinkaya1201', 'saineeth', 'sflt317', 'ncmagra54', 'aileyvaa', 'mustafayigitesen', 'uzunnurdan', 'eliffsu.koc', 'halilalp', 'jessica.satyarthi', 'ensarerol26', 'klayydar', 'azazimalii', 'gurhankopcaz', 'jyothishjaggarapu225', 'anjaligawai', 'naveen143', 'abcd5454', 'kaanbjk27', 'erdicany', 'alikanadli7', 'serdememen', 'jessgomez100', 'tolga.ozyurt24', 'ozcanguclu', 'dhyanasivadas311', 'blassselva', 'wuizar99', 'ozcankutlu15', 'funsal', 'sabriyebayrakcinur', 'mumi1478', 'veyseleee123', 'kingkireeti', 'taol190799', 'emreyilmazel1996', 'rhamwey', 'evelyn.f1975', 'haticeterzibali', 'xavier160mg', 'berksaldr', 'njgarcia5', 'jayopp32', 'jarellano1204', 'muvafikmelikkaya', 'gullit0725', 'jasmine43.jp', 'mrgiraffe', 'irem.karagoz33', 'rebecasalcido', 'jatin.us', 'esuna006', 'haoliu', 'aayushik', 'emre.ibil', 'burakbeyazt', 'testeremre70', 'ezelbilgili', 'anilboran0671', 'bryang511', 'yamakonurcan', 'yorumhesabimsa', 'kodaar', 'carlosquinonez80', 'sai.ssm', 'zilmidegne', 'michaelpov', 'anand.satyam', 'berkc', 'selinyasaci98', 'orancagdas', 'ninad.ps', 'sonerkar', 'tugbakoyuncu99', 'yusmar', 'kaankuncak', 'ulises98', 'kagankilicaslan28', 'petersan901', 'yasinzgen']"
4,40,183,172,3,"['rohitrane500', 'jaimindesai', 'ankit.manani']",179,"['nookalaarpan12', 'mlreum', 'michaelg1137', 'vishrut240501', 'ishika.raghuwanshi', 'haopolin', 'ayush2801', 'malhar.vairale1812', 'moghimil', 'aditichaturvedi', 'sahil.patil', 'keeganchafin', 'musmau82', 'sanskar.laddha', 'mitash0404', 'dhiraj.choudhari', 'pratham.solanki02', 'shahid_ms10', 'tirthpatel', 'klinner', 'surajsarjes', 'divija.shringarpure', 'nurfazrina', 'jaidamani42', 'bilal2912', 'marcelo.rodrigues', 'mjm2164', 'parth.bywar', 'nagrechavarun', 'niranjan.badhe', 'bhavika.vaishnavi', 'sneha15weakey', 'aryandali1412', 'mansi007mtvlsi20', 'antoniopml', 'manan.arora', 'nln85', 'hrishikesh28', 'g1', 'sneee', 'dhananjay23', 'akshada.hadal', 'darshansomani8', 'saikrishnam', 'sandeep.suthar', 'shweta0208', 'aftabrafiq', 'nayana.19mvd7003', 'h1tenbafna', 'anushka.pilena', 'prathamm12', 'omkar.pawar', 'smriti.islur', 'keshav_thosar', 'husain.challawala', 'umang.agarwal', 'aditya.umalkar', 'adrao', 'aryan.dali', 'poseidon_1909', 'gauripethkar', 'kartheekbogi25', 'adnan.mohiddin', 'hevila', 'sayaliayre22', 'brianfaires', 'tdbuechler', 'darshan.tater', 'lohanpeixoto', 'ritik.koul', 'oindrella', 'dbayko', 'aditi.bagwe', 'bstelter', 'truptigopinath', 'kadamyogesh31', 'brianterry', 'sneha.savarkar', 'mcrussell', 'khushi.agrawal', 'nanohubrc', 'avyeshbhatnagar46', 'pushkarsutar999', 'siddhant11', 'swapnil.mandavilli', 'trustme20times', 'jayesh_bane', 'siddhant.kamlaskar', 'giridhar.19mvd7004', 'jxc85295', 'dwx', 'katiyar_ravins', 'pushkar.sutar', 'atharvasonavane', 'niharika1528', 'prerna.arora', 'yugandhara.wadikar', 'sohel.datta', 'crystalv', 'nimratkaur', 'sayak.pramanik', 'p20vl003', 'pulkit.chaudhari', 'anuj.chavan', 'richa.motwani', 'swaraj.salunke', 'prabhat.kumar', 'oanhtran97', 'arwaje.364', 'yuvraj.purohit', 'sudhanshu128', 'aryansolanki', 'prioslimon', 'marcelobr07', 'deekshapalll', 'cxxpxx19', 'hqwbu1stq9', 'bilalsani2912', 'chetana.kamalkar', 'sarasheth60', 'venkata.revanth', 'manas.tiwari', 'abhinav.pallayil', 'iq.rodriguez.1989', 'vivek.thakkar', 'soumyawbut8730', 'boonesmith', 'khushi.patni', 'chinmay.walinjkar', 'shivang123', 'nushin01', 'devansh.palliyath', 'ajji.pavan', 'hargobind.singh', 'shivamvermaid1', 'kadenanderson1', 'shubham.sawant', 'omkar.shinde', 'ps12345', 'dylan_ds0uza', 'junwin', 'anupriya.dasgupta', 'alexiscanez', 'ramprasad.19mvd7002', 'vduenas', 'megala1997', 'shivamthakur04', 'misschayla12', 'siddharthmohanty812', 'sanskarmbadjatia', 'nicolelphan', 'samay.gada', 'ashish.jingar', 'cpierce14', 'shannon', 'vishal.lohar', 'rohit.desai', 'ranitibdewal', 'anthonyc1', 'eeshaanasodekar', 'maitri.vora', 'vinayak.tripathi', 'anshalpadole30', 'aryaman.gokarn', 'wtakeda', 'lokesh.patil', 'ganesharpan.nookala', 'vraj.b', 'jainhitanshu588', 'aniket.gawade', 'vaibhav.raina', 'ajvillani', 'pranay.tiwari', 'i.mirasifali', 'njenkins', 'victorigor', 'elmar.aichberger', 'jadhavakashb143', 'sanskruti.joshi29']",169,"['pas2', 'chaitanyatamhankar36', 'ankit.ns', 'sachin9', 'mahavirchavda921', '8122vivian', 'vrushali.sule', 'rameshbabu1234', 'amol.kerkar', 'zoheb.mir', 'siddhant.d', 'animesh.prasad', 'sohamshah888', 'rohan.sanghavi', 'advikmaniar', 'bhaskar.a', 'hirenkachhadiya', 'mrunali.khedkar', 'meet29', 'swapnalimakdey25', 'mehuldoshi', 'gauravpandey123', 'niketh', 'tiwarisuraj5769', 'jaypandya99', 'niharika.somani', 'arya1998', 'soham.ms', 'uttamkumar.m', 'h.bilkhu', 'r.mungekar', 'p.ambelkar', 'akshay.pathak', 'nitish.r', 'pooja.nambiar', 'aatman.mehta', 'pranav.mistry', 'm.veer', 'arpanbiswas', 'fenny.m', 'pratik.lodha', 'malhar.k', 'nirav.ls', 'sohamk45', 'pranali.nc', 'sangeetamjoshi', 'jmd', 'meheru.p', 'ishanali.k', 'devashri.n', 'antimhr', 'ankitachavan2708', 'rushabh.shah8', 'mayuresh.shirke', 'karan.ap', 'patel.prakash', 'aynaiksatam', 'aadesh.u', 'hitesh.vadgama', 'aayush.butala', 'surajr17', 'yukta.rane', 'param05', 'vinit.js', 'hardik.hp', 'lovleshsingh99', 'amodini8295', 'divya.manikantan', 'kaushal2531999', 'aatifa.bi', 'karan.ys', 'onkarjoshi', 'pulkeet.g', 'meetudiii', 'kavya.moolya', 'paras14', 'pktingare23', '8284yash', None, 'pratik.lodha.pl', 'pragya.g', 'manavj.jain', 'pritha.roy', 'poonam2499', 'aman.savla', 'zohebmir006', 'anubhav.bose', 'hiralmistry9', 'sunny.kanojia', 'n.sumra', 'bhavin14', 'shivani.anajria', 'anuragmandke4', 'vipulrkt', 'kartiksrivastava', 'aniket09', 'vedant.modak', 'mihir.khara', 'dhruvik.shah', 'mohil.khona', 'gauri.bane', 'khushboo.darji', 'aditi.b2409', 'ashirwad.b', 'apujara', 'yash.dalvi', 'utsav.maisheri', 'tejal.kadu', 'dipansh.m', 'rajveersingh.k', 'wrathgod123', 'kanojias75', 'p.hodshil', 'siddharth.vaidya', 'shraddha.bw', 'sherylcorina', 'pranavkumar.t', 'pranjal8287', 'purvi.rane', 'pradnya.koli', 'shubhammore', 'patel.ad', 'rahil.t', 'saloni.kaveri', 'anjali.golani', 'simran.mulik', 'rutwik.patel', 'proabdurrasheed', 'aryaman1712021', 'ayum.halwai', 'kaushal.g', 'keval23', 'rashi.singhal', 'bharatan.r', 'chaitanya.tambat', 'dhairya.maisheri', 'gmp', 'anamay.m', 'tarun96', '8275joel', 'anilthosar', 'uttamkumarmishra76652', 'saeesh.aher', 'nibha.desai', 'kshemal_gupte', 'pranav.garg', 'jayd1529', 'harsh.vasani', 'nikhil.naredla', 'saptarshi.k', 'gauri.rp', 'iamstark9', 'sumitdupate19', 'kmmahuvarkar', 'daamini11', 'saloni_talathi', 'anirudh9911', 'xavierallem', 'c.tamhankar', 'rinkalkeniya', 'sunlovesrahul', 'panchal.vp', 'nipunshah', 'suraj.dm', 'aynkushadav0', 'tejaswini.shelar', 'pratz98', 's.mahetaliya', 'rishi.molia']",351,"['nookalaarpan12', 'mlreum', 'vishrut240501', 'ankit.ns', 'sachin9', '8122vivian', 'vrushali.sule', 'ishika.raghuwanshi', 'ayush2801', 'aditichaturvedi', 'sanskar.laddha', 'sohamshah888', 'advikmaniar', 'bhaskar.a', 'klinner', 'surajsarjes', 'mrunali.khedkar', 'jaidamani42', 'bilal2912', 'mehuldoshi', 'niketh', 'niranjan.badhe', 'h.bilkhu', 'r.mungekar', 'aryandali1412', 'mansi007mtvlsi20', 'antoniopml', 'pooja.nambiar', 'aatman.mehta', 'pranav.mistry', 'm.veer', 'arpanbiswas', 'hrishikesh28', 'sohamk45', 'dhananjay23', 'pranali.nc', 'jmd', 'saikrishnam', 'sandeep.suthar', 'devashri.n', 'antimhr', 'shweta0208', 'rushabh.shah8', 'aftabrafiq', 'mayuresh.shirke', 'h1tenbafna', 'prathamm12', 'patel.prakash', 'aynaiksatam', 'omkar.pawar', 'hitesh.vadgama', 'aayush.butala', 'yukta.rane', 'umang.agarwal', 'husain.challawala', 'aditya.umalkar', 'lovleshsingh99', 'aatifa.bi', 'pulkeet.g', 'kartheekbogi25', 'paras14', 'pktingare23', '8284yash', 'hevila', 'sayaliayre22', 'pratik.lodha.pl', 'pragya.g', 'rohitrane500', 'manavj.jain', 'pritha.roy', 'brianfaires', 'tdbuechler', 'ritik.koul', 'lohanpeixoto', 'aman.savla', 'zohebmir006', 'anubhav.bose', 'aditi.bagwe', 'truptigopinath', 'kadamyogesh31', 'sunny.kanojia', 'n.sumra', 'brianterry', 'sneha.savarkar', 'bhavin14', 'avyeshbhatnagar46', 'kartiksrivastava', 'siddhant11', 'giridhar.19mvd7004', 'vedant.modak', 'jxc85295', 'dwx', 'katiyar_ravins', 'atharvasonavane', 'khushboo.darji', 'aditi.b2409', 'ashirwad.b', 'sayak.pramanik', 'p20vl003', 'pulkit.chaudhari', 'richa.motwani', 'yash.dalvi', 'utsav.maisheri', 'tejal.kadu', 'swaraj.salunke', 'prabhat.kumar', 'dipansh.m', 'oanhtran97', 'yuvraj.purohit', 'sudhanshu128', 'rajveersingh.k', 'p.hodshil', 'siddharth.vaidya', 'shraddha.bw', 'sherylcorina', 'pranjal8287', 'purvi.rane', 'pradnya.koli', 'cxxpxx19', 'hqwbu1stq9', 'bilalsani2912', 'anjali.golani', 'saloni.kaveri', 'sarasheth60', 'venkata.revanth', 'simran.mulik', 'manas.tiwari', 'abhinav.pallayil', 'soumyawbut8730', 'ayum.halwai', 'khushi.patni', 'chinmay.walinjkar', 'keval23', 'bharatan.r', 'jaimindesai', 'chaitanya.tambat', 'dhairya.maisheri', 'nushin01', 'devansh.palliyath', 'ajji.pavan', 'hargobind.singh', 'shivamvermaid1', 'anamay.m', 'tarun96', 'ps12345', 'anupriya.dasgupta', 'alexiscanez', 'anilthosar', 'ramprasad.19mvd7002', 'saeesh.aher', 'vduenas', 'nibha.desai', 'megala1997', 'jayd1529', 'misschayla12', 'nikhil.naredla', 'samay.gada', 'ashish.jingar', 'gauri.rp', 'iamstark9', 'sumitdupate19', 'daamini11', 'shannon', 'saloni_talathi', 'rohit.desai', 'ranitibdewal', 'anthonyc1', 'sunlovesrahul', 'panchal.vp', 'nipunshah', 'anshalpadole30', 'aynkushadav0', 'aryaman.gokarn', 'wtakeda', 'vraj.b', 'jainhitanshu588', 'pratz98', 'vaibhav.raina', 'pranay.tiwari', 'ankit.manani', 'jadhavakashb143', 'chaitanyatamhankar36', 'michaelg1137', 'pas2', 'mahavirchavda921', 'rameshbabu1234', 'haopolin', 'malhar.vairale1812', 'amol.kerkar', 'zoheb.mir', 'moghimil', 'sahil.patil', 'keeganchafin', 'musmau82', 'siddhant.d', 'animesh.prasad', 'mitash0404', 'rohan.sanghavi', 'dhiraj.choudhari', 'tirthpatel', 'pratham.solanki02', 'shahid_ms10', 'divija.shringarpure', 'hirenkachhadiya', 'nurfazrina', 'meet29', 'swapnalimakdey25', 'marcelo.rodrigues', 'mjm2164', 'parth.bywar', 'gauravpandey123', 'nagrechavarun', 'bhavika.vaishnavi', 'tiwarisuraj5769', 'jaypandya99', 'niharika.somani', 'sneha15weakey', 'arya1998', 'soham.ms', 'uttamkumar.m', 'p.ambelkar', 'akshay.pathak', 'nitish.r', 'manan.arora', 'nln85', 'fenny.m', 'pratik.lodha', 'malhar.k', 'sneee', 'g1', 'nirav.ls', 'akshada.hadal', 'sangeetamjoshi', 'darshansomani8', 'meheru.p', 'ishanali.k', 'ankitachavan2708', 'nayana.19mvd7003', 'anushka.pilena', 'karan.ap', 'aadesh.u', 'smriti.islur', 'param05', 'surajr17', 'keshav_thosar', 'adrao', 'vinit.js', 'hardik.hp', 'aryan.dali', 'amodini8295', 'divya.manikantan', 'poseidon_1909', 'kaushal2531999', 'karan.ys', 'onkarjoshi', 'gauripethkar', 'meetudiii', 'kavya.moolya', 'adnan.mohiddin', None, 'poonam2499', 'darshan.tater', 'oindrella', 'dbayko', 'bstelter', 'hiralmistry9', 'mcrussell', 'khushi.agrawal', 'shivani.anajria', 'anuragmandke4', 'nanohubrc', 'vipulrkt', 'pushkarsutar999', 'swapnil.mandavilli', 'aniket09', 'trustme20times', 'jayesh_bane', 'siddhant.kamlaskar', 'pushkar.sutar', 'mihir.khara', 'dhruvik.shah', 'mohil.khona', 'gauri.bane', 'niharika1528', 'prerna.arora', 'yugandhara.wadikar', 'sohel.datta', 'crystalv', 'nimratkaur', 'anuj.chavan', 'apujara', 'arwaje.364', 'aryansolanki', 'wrathgod123', 'prioslimon', 'marcelobr07', 'kanojias75', 'deekshapalll', 'pranavkumar.t', 'shubhammore', 'patel.ad', 'chetana.kamalkar', 'rahil.t', 'rutwik.patel', 'proabdurrasheed', 'iq.rodriguez.1989', 'aryaman1712021', 'vivek.thakkar', 'boonesmith', 'kaushal.g', 'rashi.singhal', 'gmp', 'shivang123', '8275joel', 'kadenanderson1', 'shubham.sawant', 'omkar.shinde', 'dylan_ds0uza', 'junwin', 'uttamkumarmishra76652', 'kshemal_gupte', 'pranav.garg', 'shivamthakur04', 'harsh.vasani', 'siddharthmohanty812', 'sanskarmbadjatia', 'nicolelphan', 'saptarshi.k', 'cpierce14', 'kmmahuvarkar', 'anirudh9911', 'xavierallem', 'c.tamhankar', 'vishal.lohar', 'rinkalkeniya', 'eeshaanasodekar', 'maitri.vora', 'suraj.dm', 'vinayak.tripathi', 'tejaswini.shelar', 'lokesh.patil', 'ganesharpan.nookala', 'aniket.gawade', 'victorigor', 'ajvillani', 'i.mirasifali', 'njenkins', 'elmar.aichberger', 's.mahetaliya', 'rishi.molia', 'sanskruti.joshi29']"
4,50,183,105,74,"['nookalaarpan12', 'abhinav.pallayil', 'vivek.thakkar', 'dhananjay23', 'akshada.hadal', 'khushi.patni', 'saikrishnam', 'truptigopinath', 'chinmay.walinjkar', 'jaimindesai', 'sneha.savarkar', 'shweta0208', 'ayush2801', 'hargobind.singh', 'prathamm12', 'aditichaturvedi', 'anushka.pilena', 'pushkarsutar999', 'siddhant11', 'swapnil.mandavilli', 'shubham.sawant', 'omkar.shinde', 'sanskar.laddha', 'mitash0404', 'omkar.pawar', 'trustme20times', 'jayesh_bane', 'pushkar.sutar', 'dhiraj.choudhari', 'dylan_ds0uza', 'atharvasonavane', 'husain.challawala', 'niharika1528', 'aditya.umalkar', 'tirthpatel', 'adrao', 'prerna.arora', 'divija.shringarpure', 'sohel.datta', 'anupriya.dasgupta', 'shivamthakur04', 'nimratkaur', 'jaidamani42', 'aryan.dali', 'anuj.chavan', 'richa.motwani', 'bilal2912', 'pulkit.chaudhari', 'siddharthmohanty812', 'yuvraj.purohit', 'sudhanshu128', 'vishal.lohar', 'aryansolanki', 'adnan.mohiddin', 'sayaliayre22', 'eeshaanasodekar', 'deekshapalll', 'maitri.vora', 'rohitrane500', 'lokesh.patil', 'vraj.b', 'ganesharpan.nookala', 'cxxpxx19', 'jainhitanshu588', 'bilalsani2912', 'aniket.gawade', 'manan.arora', 'darshan.tater', 'sarasheth60', 'pranay.tiwari', 'ankit.manani', 'oindrella', 'sneee', 'manas.tiwari']",108,"['mlreum', 'michaelg1137', 'vishrut240501', 'ishika.raghuwanshi', 'haopolin', 'malhar.vairale1812', 'moghimil', 'sahil.patil', 'keeganchafin', 'musmau82', 'shahid_ms10', 'pratham.solanki02', 'surajsarjes', 'klinner', 'nurfazrina', 'marcelo.rodrigues', 'mjm2164', 'parth.bywar', 'nagrechavarun', 'niranjan.badhe', 'bhavika.vaishnavi', 'sneha15weakey', 'aryandali1412', 'mansi007mtvlsi20', 'antoniopml', 'nln85', 'hrishikesh28', 'g1', 'darshansomani8', 'sandeep.suthar', 'aftabrafiq', 'nayana.19mvd7003', 'h1tenbafna', 'smriti.islur', 'keshav_thosar', 'umang.agarwal', 'poseidon_1909', 'gauripethkar', 'kartheekbogi25', 'hevila', 'brianfaires', 'tdbuechler', 'ritik.koul', 'lohanpeixoto', 'dbayko', 'aditi.bagwe', 'bstelter', 'kadamyogesh31', 'brianterry', 'mcrussell', 'khushi.agrawal', 'nanohubrc', 'avyeshbhatnagar46', 'giridhar.19mvd7004', 'siddhant.kamlaskar', 'jxc85295', 'dwx', 'katiyar_ravins', 'yugandhara.wadikar', 'crystalv', 'sayak.pramanik', 'p20vl003', 'swaraj.salunke', 'prabhat.kumar', 'oanhtran97', 'arwaje.364', 'prioslimon', 'marcelobr07', 'hqwbu1stq9', 'chetana.kamalkar', 'venkata.revanth', 'iq.rodriguez.1989', 'soumyawbut8730', 'boonesmith', 'shivang123', 'nushin01', 'devansh.palliyath', 'ajji.pavan', 'shivamvermaid1', 'kadenanderson1', 'ps12345', 'junwin', 'alexiscanez', 'ramprasad.19mvd7002', 'vduenas', 'megala1997', 'misschayla12', 'sanskarmbadjatia', 'nicolelphan', 'samay.gada', 'ashish.jingar', 'cpierce14', 'shannon', 'rohit.desai', 'ranitibdewal', 'anthonyc1', 'vinayak.tripathi', 'anshalpadole30', 'aryaman.gokarn', 'wtakeda', 'vaibhav.raina', 'ajvillani', 'victorigor', 'i.mirasifali', 'njenkins', 'elmar.aichberger', 'jadhavakashb143', 'sanskruti.joshi29']",31,"['aryaman1712021', 'sohamk45', 'sangeetamjoshi', '8122vivian', 'apoorva.limaye', 'anuragmandke4', 'tarun96', 'verma07anand', 'nibha.desai', 'kshemal_gupte', 'saeesh.aher', 'aniket.nadkarni', 'lovleshsingh99', 'divya.manikantan', 'rathod_spce', 'sumitdupate19', 'anirudh9911', 'tiwarisuraj5769', 'rinkalkeniya', 'niharika.somani', 'h.bilkhu', 'varun.kamath', 'sunlovesrahul', 'keval09', None, 'vedant', 'anjali.golani', 'arohishinde2302', 'arpanbiswas', 'mayur07', 'aditya.patwardhan']",213,"['nookalaarpan12', 'mlreum', 'michaelg1137', 'vishrut240501', '8122vivian', 'ishika.raghuwanshi', 'haopolin', 'ayush2801', 'malhar.vairale1812', 'moghimil', 'aditichaturvedi', 'sahil.patil', 'keeganchafin', 'musmau82', 'sanskar.laddha', 'mitash0404', 'dhiraj.choudhari', 'tirthpatel', 'pratham.solanki02', 'shahid_ms10', 'klinner', 'surajsarjes', 'divija.shringarpure', 'nurfazrina', 'jaidamani42', 'bilal2912', 'marcelo.rodrigues', 'mjm2164', 'parth.bywar', 'rathod_spce', 'nagrechavarun', 'niranjan.badhe', 'bhavika.vaishnavi', 'tiwarisuraj5769', 'niharika.somani', 'h.bilkhu', 'sneha15weakey', 'aryandali1412', 'mansi007mtvlsi20', 'antoniopml', 'manan.arora', 'nln85', 'arpanbiswas', 'hrishikesh28', 'sneee', 'g1', 'sohamk45', 'dhananjay23', 'akshada.hadal', 'sangeetamjoshi', 'darshansomani8', 'saikrishnam', 'sandeep.suthar', 'shweta0208', 'aftabrafiq', 'nayana.19mvd7003', 'h1tenbafna', 'anushka.pilena', 'prathamm12', 'omkar.pawar', 'smriti.islur', 'keshav_thosar', 'husain.challawala', 'umang.agarwal', 'aditya.umalkar', 'adrao', 'lovleshsingh99', 'aryan.dali', 'divya.manikantan', 'poseidon_1909', 'gauripethkar', 'kartheekbogi25', 'adnan.mohiddin', 'hevila', 'sayaliayre22', None, 'rohitrane500', 'vedant', 'brianfaires', 'tdbuechler', 'darshan.tater', 'lohanpeixoto', 'ritik.koul', 'arohishinde2302', 'oindrella', 'dbayko', 'aditya.patwardhan', 'aditi.bagwe', 'bstelter', 'truptigopinath', 'kadamyogesh31', 'brianterry', 'sneha.savarkar', 'mcrussell', 'khushi.agrawal', 'anuragmandke4', 'nanohubrc', 'avyeshbhatnagar46', 'pushkarsutar999', 'siddhant11', 'swapnil.mandavilli', 'trustme20times', 'jayesh_bane', 'siddhant.kamlaskar', 'giridhar.19mvd7004', 'jxc85295', 'dwx', 'katiyar_ravins', 'pushkar.sutar', 'atharvasonavane', 'niharika1528', 'prerna.arora', 'yugandhara.wadikar', 'sohel.datta', 'crystalv', 'nimratkaur', 'sayak.pramanik', 'p20vl003', 'pulkit.chaudhari', 'anuj.chavan', 'richa.motwani', 'swaraj.salunke', 'prabhat.kumar', 'oanhtran97', 'arwaje.364', 'yuvraj.purohit', 'sudhanshu128', 'aryansolanki', 'prioslimon', 'marcelobr07', 'deekshapalll', 'cxxpxx19', 'hqwbu1stq9', 'bilalsani2912', 'chetana.kamalkar', 'anjali.golani', 'sarasheth60', 'venkata.revanth', 'mayur07', 'manas.tiwari', 'abhinav.pallayil', 'iq.rodriguez.1989', 'aryaman1712021', 'vivek.thakkar', 'soumyawbut8730', 'boonesmith', 'khushi.patni', 'chinmay.walinjkar', 'jaimindesai', 'apoorva.limaye', 'shivang123', 'nushin01', 'devansh.palliyath', 'ajji.pavan', 'hargobind.singh', 'shivamvermaid1', 'verma07anand', 'tarun96', 'kadenanderson1', 'shubham.sawant', 'omkar.shinde', 'ps12345', 'dylan_ds0uza', 'junwin', 'anupriya.dasgupta', 'alexiscanez', 'ramprasad.19mvd7002', 'nibha.desai', 'vduenas', 'kshemal_gupte', 'saeesh.aher', 'megala1997', 'shivamthakur04', 'misschayla12', 'siddharthmohanty812', 'sanskarmbadjatia', 'aniket.nadkarni', 'nicolelphan', 'samay.gada', 'ashish.jingar', 'cpierce14', 'sumitdupate19', 'shannon', 'anirudh9911', 'rinkalkeniya', 'vishal.lohar', 'rohit.desai', 'ranitibdewal', 'anthonyc1', 'varun.kamath', 'sunlovesrahul', 'keval09', 'eeshaanasodekar', 'maitri.vora', 'vinayak.tripathi', 'anshalpadole30', 'aryaman.gokarn', 'wtakeda', 'lokesh.patil', 'ganesharpan.nookala', 'vraj.b', 'jainhitanshu588', 'aniket.gawade', 'vaibhav.raina', 'ajvillani', 'pranay.tiwari', 'ankit.manani', 'i.mirasifali', 'njenkins', 'elmar.aichberger', 'victorigor', 'jadhavakashb143', 'sanskruti.joshi29']"
4,54,183,26,22,"['michaelg1137', 'boonesmith', 'bstelter', 'mcrussell', 'nushin01', 'kadenanderson1', 'dwx', 'junwin', 'alexiscanez', 'vduenas', 'klinner', 'nurfazrina', 'nicolelphan', 'mjm2164', 'cpierce14', 'oanhtran97', 'anthonyc1', 'prioslimon', 'hqwbu1stq9', 'tdbuechler', 'njenkins', 'dbayko']",160,"['nookalaarpan12', 'mlreum', 'vishrut240501', 'ishika.raghuwanshi', 'haopolin', 'ayush2801', 'malhar.vairale1812', 'moghimil', 'aditichaturvedi', 'sahil.patil', 'keeganchafin', 'musmau82', 'sanskar.laddha', 'mitash0404', 'dhiraj.choudhari', 'tirthpatel', 'pratham.solanki02', 'shahid_ms10', 'surajsarjes', 'divija.shringarpure', 'jaidamani42', 'bilal2912', 'marcelo.rodrigues', 'parth.bywar', 'nagrechavarun', 'niranjan.badhe', 'bhavika.vaishnavi', 'sneha15weakey', 'aryandali1412', 'mansi007mtvlsi20', 'antoniopml', 'manan.arora', 'nln85', 'hrishikesh28', 'sneee', 'g1', 'dhananjay23', 'akshada.hadal', 'darshansomani8', 'saikrishnam', 'sandeep.suthar', 'shweta0208', 'aftabrafiq', 'nayana.19mvd7003', 'h1tenbafna', 'anushka.pilena', 'prathamm12', 'omkar.pawar', 'smriti.islur', 'keshav_thosar', 'husain.challawala', 'umang.agarwal', 'aditya.umalkar', 'adrao', 'aryan.dali', 'poseidon_1909', 'gauripethkar', 'kartheekbogi25', 'adnan.mohiddin', 'hevila', 'sayaliayre22', 'rohitrane500', 'brianfaires', 'darshan.tater', 'lohanpeixoto', 'ritik.koul', 'oindrella', 'aditi.bagwe', 'truptigopinath', 'kadamyogesh31', 'brianterry', 'sneha.savarkar', 'khushi.agrawal', 'nanohubrc', 'avyeshbhatnagar46', 'pushkarsutar999', 'siddhant11', 'swapnil.mandavilli', 'trustme20times', 'jayesh_bane', 'siddhant.kamlaskar', 'giridhar.19mvd7004', 'jxc85295', 'katiyar_ravins', 'pushkar.sutar', 'atharvasonavane', 'niharika1528', 'prerna.arora', 'yugandhara.wadikar', 'sohel.datta', 'crystalv', 'nimratkaur', 'sayak.pramanik', 'p20vl003', 'pulkit.chaudhari', 'anuj.chavan', 'richa.motwani', 'swaraj.salunke', 'prabhat.kumar', 'arwaje.364', 'yuvraj.purohit', 'sudhanshu128', 'aryansolanki', 'marcelobr07', 'deekshapalll', 'cxxpxx19', 'bilalsani2912', 'chetana.kamalkar', 'sarasheth60', 'venkata.revanth', 'manas.tiwari', 'abhinav.pallayil', 'iq.rodriguez.1989', 'vivek.thakkar', 'soumyawbut8730', 'khushi.patni', 'chinmay.walinjkar', 'jaimindesai', 'shivang123', 'devansh.palliyath', 'ajji.pavan', 'hargobind.singh', 'shivamvermaid1', 'shubham.sawant', 'omkar.shinde', 'ps12345', 'dylan_ds0uza', 'anupriya.dasgupta', 'ramprasad.19mvd7002', 'megala1997', 'shivamthakur04', 'misschayla12', 'siddharthmohanty812', 'sanskarmbadjatia', 'samay.gada', 'ashish.jingar', 'shannon', 'vishal.lohar', 'rohit.desai', 'ranitibdewal', 'eeshaanasodekar', 'maitri.vora', 'vinayak.tripathi', 'anshalpadole30', 'aryaman.gokarn', 'wtakeda', 'lokesh.patil', 'ganesharpan.nookala', 'vraj.b', 'jainhitanshu588', 'aniket.gawade', 'vaibhav.raina', 'ajvillani', 'pranay.tiwari', 'ankit.manani', 'i.mirasifali', 'elmar.aichberger', 'victorigor', 'jadhavakashb143', 'sanskruti.joshi29']",4,"['biggie', None, 'mai95', 'ryanwestley']",186,"['nookalaarpan12', 'mlreum', 'michaelg1137', 'vishrut240501', 'ishika.raghuwanshi', 'haopolin', 'ayush2801', 'malhar.vairale1812', 'moghimil', 'aditichaturvedi', 'sahil.patil', 'keeganchafin', 'musmau82', 'sanskar.laddha', 'mitash0404', 'dhiraj.choudhari', 'tirthpatel', 'pratham.solanki02', 'shahid_ms10', 'klinner', 'surajsarjes', 'divija.shringarpure', 'nurfazrina', 'jaidamani42', 'bilal2912', 'marcelo.rodrigues', 'mjm2164', 'parth.bywar', 'nagrechavarun', 'niranjan.badhe', 'bhavika.vaishnavi', 'sneha15weakey', 'aryandali1412', 'mansi007mtvlsi20', 'antoniopml', 'manan.arora', 'ryanwestley', 'nln85', 'hrishikesh28', 'sneee', 'g1', 'dhananjay23', 'akshada.hadal', 'darshansomani8', 'saikrishnam', 'sandeep.suthar', 'shweta0208', 'aftabrafiq', 'nayana.19mvd7003', 'h1tenbafna', 'anushka.pilena', 'prathamm12', 'omkar.pawar', 'smriti.islur', 'keshav_thosar', 'husain.challawala', 'umang.agarwal', 'aditya.umalkar', 'adrao', 'aryan.dali', 'poseidon_1909', 'gauripethkar', 'kartheekbogi25', 'adnan.mohiddin', 'hevila', 'sayaliayre22', None, 'rohitrane500', 'brianfaires', 'tdbuechler', 'darshan.tater', 'lohanpeixoto', 'ritik.koul', 'oindrella', 'dbayko', 'aditi.bagwe', 'bstelter', 'truptigopinath', 'kadamyogesh31', 'brianterry', 'sneha.savarkar', 'mcrussell', 'khushi.agrawal', 'nanohubrc', 'avyeshbhatnagar46', 'pushkarsutar999', 'siddhant11', 'biggie', 'swapnil.mandavilli', 'trustme20times', 'jayesh_bane', 'siddhant.kamlaskar', 'giridhar.19mvd7004', 'jxc85295', 'dwx', 'katiyar_ravins', 'pushkar.sutar', 'atharvasonavane', 'niharika1528', 'prerna.arora', 'yugandhara.wadikar', 'sohel.datta', 'crystalv', 'nimratkaur', 'sayak.pramanik', 'p20vl003', 'pulkit.chaudhari', 'anuj.chavan', 'richa.motwani', 'swaraj.salunke', 'prabhat.kumar', 'oanhtran97', 'arwaje.364', 'yuvraj.purohit', 'sudhanshu128', 'aryansolanki', 'prioslimon', 'marcelobr07', 'deekshapalll', 'cxxpxx19', 'hqwbu1stq9', 'bilalsani2912', 'chetana.kamalkar', 'sarasheth60', 'venkata.revanth', 'manas.tiwari', 'abhinav.pallayil', 'iq.rodriguez.1989', 'vivek.thakkar', 'soumyawbut8730', 'boonesmith', 'khushi.patni', 'chinmay.walinjkar', 'jaimindesai', 'shivang123', 'nushin01', 'devansh.palliyath', 'ajji.pavan', 'hargobind.singh', 'shivamvermaid1', 'kadenanderson1', 'shubham.sawant', 'omkar.shinde', 'ps12345', 'dylan_ds0uza', 'junwin', 'anupriya.dasgupta', 'alexiscanez', 'ramprasad.19mvd7002', 'vduenas', 'megala1997', 'shivamthakur04', 'misschayla12', 'siddharthmohanty812', 'sanskarmbadjatia', 'nicolelphan', 'samay.gada', 'ashish.jingar', 'cpierce14', 'shannon', 'vishal.lohar', 'rohit.desai', 'ranitibdewal', 'anthonyc1', 'eeshaanasodekar', 'maitri.vora', 'vinayak.tripathi', 'anshalpadole30', 'aryaman.gokarn', 'wtakeda', 'lokesh.patil', 'ganesharpan.nookala', 'vraj.b', 'jainhitanshu588', 'aniket.gawade', 'mai95', 'vaibhav.raina', 'ajvillani', 'pranay.tiwari', 'ankit.manani', 'i.mirasifali', 'njenkins', 'elmar.aichberger', 'victorigor', 'jadhavakashb143', 'sanskruti.joshi29']"
4,51,183,18,16,"['malhar.vairale1812', 'siddharthmohanty812', 'p20vl003', 'rohitrane500', 'avyeshbhatnagar46', 'g1', 'parth.bywar', 'sahil.patil', 'saikrishnam', 'vinayak.tripathi', 'umang.agarwal', 'pratham.solanki02', 'yugandhara.wadikar', 'khushi.agrawal', 'surajsarjes', 'anshalpadole30']",166,"['nookalaarpan12', 'mlreum', 'michaelg1137', 'vishrut240501', 'ishika.raghuwanshi', 'haopolin', 'ayush2801', 'moghimil', 'aditichaturvedi', 'keeganchafin', 'musmau82', 'sanskar.laddha', 'mitash0404', 'dhiraj.choudhari', 'tirthpatel', 'shahid_ms10', 'klinner', 'divija.shringarpure', 'nurfazrina', 'jaidamani42', 'bilal2912', 'marcelo.rodrigues', 'mjm2164', 'nagrechavarun', 'niranjan.badhe', 'bhavika.vaishnavi', 'sneha15weakey', 'aryandali1412', 'mansi007mtvlsi20', 'antoniopml', 'manan.arora', 'nln85', 'hrishikesh28', 'sneee', 'dhananjay23', 'akshada.hadal', 'darshansomani8', 'sandeep.suthar', 'shweta0208', 'aftabrafiq', 'nayana.19mvd7003', 'h1tenbafna', 'anushka.pilena', 'prathamm12', 'omkar.pawar', 'smriti.islur', 'keshav_thosar', 'husain.challawala', 'aditya.umalkar', 'adrao', 'aryan.dali', 'poseidon_1909', 'gauripethkar', 'kartheekbogi25', 'adnan.mohiddin', 'hevila', 'sayaliayre22', 'brianfaires', 'tdbuechler', 'darshan.tater', 'lohanpeixoto', 'ritik.koul', 'oindrella', 'dbayko', 'aditi.bagwe', 'bstelter', 'truptigopinath', 'kadamyogesh31', 'brianterry', 'sneha.savarkar', 'mcrussell', 'nanohubrc', 'pushkarsutar999', 'siddhant11', 'swapnil.mandavilli', 'trustme20times', 'jayesh_bane', 'siddhant.kamlaskar', 'giridhar.19mvd7004', 'jxc85295', 'dwx', 'katiyar_ravins', 'pushkar.sutar', 'atharvasonavane', 'niharika1528', 'prerna.arora', 'sohel.datta', 'crystalv', 'nimratkaur', 'sayak.pramanik', 'pulkit.chaudhari', 'anuj.chavan', 'richa.motwani', 'swaraj.salunke', 'prabhat.kumar', 'oanhtran97', 'arwaje.364', 'yuvraj.purohit', 'sudhanshu128', 'aryansolanki', 'prioslimon', 'marcelobr07', 'deekshapalll', 'cxxpxx19', 'hqwbu1stq9', 'bilalsani2912', 'chetana.kamalkar', 'sarasheth60', 'venkata.revanth', 'manas.tiwari', 'abhinav.pallayil', 'iq.rodriguez.1989', 'vivek.thakkar', 'soumyawbut8730', 'boonesmith', 'khushi.patni', 'chinmay.walinjkar', 'jaimindesai', 'shivang123', 'nushin01', 'devansh.palliyath', 'ajji.pavan', 'hargobind.singh', 'shivamvermaid1', 'kadenanderson1', 'shubham.sawant', 'omkar.shinde', 'ps12345', 'dylan_ds0uza', 'junwin', 'anupriya.dasgupta', 'alexiscanez', 'ramprasad.19mvd7002', 'vduenas', 'megala1997', 'shivamthakur04', 'misschayla12', 'sanskarmbadjatia', 'nicolelphan', 'samay.gada', 'ashish.jingar', 'cpierce14', 'shannon', 'vishal.lohar', 'rohit.desai', 'ranitibdewal', 'anthonyc1', 'eeshaanasodekar', 'maitri.vora', 'aryaman.gokarn', 'wtakeda', 'lokesh.patil', 'ganesharpan.nookala', 'vraj.b', 'jainhitanshu588', 'aniket.gawade', 'vaibhav.raina', 'ajvillani', 'pranay.tiwari', 'ankit.manani', 'i.mirasifali', 'njenkins', 'elmar.aichberger', 'victorigor', 'jadhavakashb143', 'sanskruti.joshi29']",2,"[None, 'anirudh9911']",184,"['nookalaarpan12', 'mlreum', 'michaelg1137', 'vishrut240501', 'ishika.raghuwanshi', 'haopolin', 'ayush2801', 'malhar.vairale1812', 'moghimil', 'aditichaturvedi', 'sahil.patil', 'keeganchafin', 'musmau82', 'sanskar.laddha', 'mitash0404', 'dhiraj.choudhari', 'tirthpatel', 'pratham.solanki02', 'shahid_ms10', 'klinner', 'surajsarjes', 'divija.shringarpure', 'nurfazrina', 'jaidamani42', 'bilal2912', 'marcelo.rodrigues', 'mjm2164', 'parth.bywar', 'nagrechavarun', 'niranjan.badhe', 'bhavika.vaishnavi', 'sneha15weakey', 'aryandali1412', 'mansi007mtvlsi20', 'antoniopml', 'manan.arora', 'nln85', 'hrishikesh28', 'sneee', 'g1', 'dhananjay23', 'akshada.hadal', 'darshansomani8', 'saikrishnam', 'sandeep.suthar', 'shweta0208', 'aftabrafiq', 'nayana.19mvd7003', 'h1tenbafna', 'anushka.pilena', 'prathamm12', 'omkar.pawar', 'smriti.islur', 'keshav_thosar', 'husain.challawala', 'umang.agarwal', 'aditya.umalkar', 'adrao', 'aryan.dali', 'poseidon_1909', 'gauripethkar', 'kartheekbogi25', 'adnan.mohiddin', 'hevila', 'sayaliayre22', None, 'rohitrane500', 'brianfaires', 'tdbuechler', 'darshan.tater', 'lohanpeixoto', 'ritik.koul', 'oindrella', 'dbayko', 'aditi.bagwe', 'bstelter', 'truptigopinath', 'kadamyogesh31', 'brianterry', 'sneha.savarkar', 'mcrussell', 'khushi.agrawal', 'nanohubrc', 'avyeshbhatnagar46', 'pushkarsutar999', 'siddhant11', 'swapnil.mandavilli', 'trustme20times', 'jayesh_bane', 'siddhant.kamlaskar', 'giridhar.19mvd7004', 'jxc85295', 'dwx', 'katiyar_ravins', 'pushkar.sutar', 'atharvasonavane', 'niharika1528', 'prerna.arora', 'yugandhara.wadikar', 'sohel.datta', 'crystalv', 'nimratkaur', 'sayak.pramanik', 'p20vl003', 'pulkit.chaudhari', 'anuj.chavan', 'richa.motwani', 'swaraj.salunke', 'prabhat.kumar', 'oanhtran97', 'arwaje.364', 'yuvraj.purohit', 'sudhanshu128', 'aryansolanki', 'prioslimon', 'marcelobr07', 'deekshapalll', 'cxxpxx19', 'hqwbu1stq9', 'bilalsani2912', 'chetana.kamalkar', 'sarasheth60', 'venkata.revanth', 'manas.tiwari', 'abhinav.pallayil', 'iq.rodriguez.1989', 'vivek.thakkar', 'soumyawbut8730', 'boonesmith', 'khushi.patni', 'chinmay.walinjkar', 'jaimindesai', 'shivang123', 'nushin01', 'devansh.palliyath', 'ajji.pavan', 'hargobind.singh', 'shivamvermaid1', 'kadenanderson1', 'shubham.sawant', 'omkar.shinde', 'ps12345', 'dylan_ds0uza', 'junwin', 'anupriya.dasgupta', 'alexiscanez', 'ramprasad.19mvd7002', 'vduenas', 'megala1997', 'shivamthakur04', 'misschayla12', 'siddharthmohanty812', 'sanskarmbadjatia', 'nicolelphan', 'samay.gada', 'ashish.jingar', 'cpierce14', 'shannon', 'anirudh9911', 'vishal.lohar', 'rohit.desai', 'ranitibdewal', 'anthonyc1', 'eeshaanasodekar', 'maitri.vora', 'vinayak.tripathi', 'anshalpadole30', 'aryaman.gokarn', 'wtakeda', 'lokesh.patil', 'ganesharpan.nookala', 'vraj.b', 'jainhitanshu588', 'aniket.gawade', 'vaibhav.raina', 'ajvillani', 'pranay.tiwari', 'ankit.manani', 'i.mirasifali', 'njenkins', 'elmar.aichberger', 'victorigor', 'jadhavakashb143', 'sanskruti.joshi29']"
4,48,183,14,3,"['antoniopml', 'marcelo.rodrigues', 'marcelobr07']",179,"['nookalaarpan12', 'mlreum', 'michaelg1137', 'vishrut240501', 'ishika.raghuwanshi', 'haopolin', 'ayush2801', 'malhar.vairale1812', 'moghimil', 'aditichaturvedi', 'sahil.patil', 'keeganchafin', 'musmau82', 'sanskar.laddha', 'mitash0404', 'dhiraj.choudhari', 'tirthpatel', 'pratham.solanki02', 'shahid_ms10', 'klinner', 'surajsarjes', 'divija.shringarpure', 'nurfazrina', 'jaidamani42', 'bilal2912', 'mjm2164', 'parth.bywar', 'nagrechavarun', 'niranjan.badhe', 'bhavika.vaishnavi', 'sneha15weakey', 'aryandali1412', 'mansi007mtvlsi20', 'manan.arora', 'nln85', 'hrishikesh28', 'sneee', 'g1', 'dhananjay23', 'akshada.hadal', 'darshansomani8', 'saikrishnam', 'sandeep.suthar', 'shweta0208', 'aftabrafiq', 'nayana.19mvd7003', 'h1tenbafna', 'anushka.pilena', 'prathamm12', 'omkar.pawar', 'smriti.islur', 'keshav_thosar', 'husain.challawala', 'umang.agarwal', 'aditya.umalkar', 'adrao', 'aryan.dali', 'poseidon_1909', 'gauripethkar', 'kartheekbogi25', 'adnan.mohiddin', 'hevila', 'sayaliayre22', 'rohitrane500', 'brianfaires', 'tdbuechler', 'darshan.tater', 'lohanpeixoto', 'ritik.koul', 'oindrella', 'dbayko', 'aditi.bagwe', 'bstelter', 'truptigopinath', 'kadamyogesh31', 'brianterry', 'sneha.savarkar', 'mcrussell', 'khushi.agrawal', 'nanohubrc', 'avyeshbhatnagar46', 'pushkarsutar999', 'siddhant11', 'swapnil.mandavilli', 'trustme20times', 'jayesh_bane', 'siddhant.kamlaskar', 'giridhar.19mvd7004', 'jxc85295', 'dwx', 'katiyar_ravins', 'pushkar.sutar', 'atharvasonavane', 'niharika1528', 'prerna.arora', 'yugandhara.wadikar', 'sohel.datta', 'crystalv', 'nimratkaur', 'sayak.pramanik', 'p20vl003', 'pulkit.chaudhari', 'anuj.chavan', 'richa.motwani', 'swaraj.salunke', 'prabhat.kumar', 'oanhtran97', 'arwaje.364', 'yuvraj.purohit', 'sudhanshu128', 'aryansolanki', 'prioslimon', 'deekshapalll', 'cxxpxx19', 'hqwbu1stq9', 'bilalsani2912', 'chetana.kamalkar', 'sarasheth60', 'venkata.revanth', 'manas.tiwari', 'abhinav.pallayil', 'iq.rodriguez.1989', 'vivek.thakkar', 'soumyawbut8730', 'boonesmith', 'khushi.patni', 'chinmay.walinjkar', 'jaimindesai', 'shivang123', 'nushin01', 'devansh.palliyath', 'ajji.pavan', 'hargobind.singh', 'shivamvermaid1', 'kadenanderson1', 'shubham.sawant', 'omkar.shinde', 'ps12345', 'dylan_ds0uza', 'junwin', 'anupriya.dasgupta', 'alexiscanez', 'ramprasad.19mvd7002', 'vduenas', 'megala1997', 'shivamthakur04', 'misschayla12', 'siddharthmohanty812', 'sanskarmbadjatia', 'nicolelphan', 'samay.gada', 'ashish.jingar', 'cpierce14', 'shannon', 'vishal.lohar', 'rohit.desai', 'ranitibdewal', 'anthonyc1', 'eeshaanasodekar', 'maitri.vora', 'vinayak.tripathi', 'anshalpadole30', 'aryaman.gokarn', 'wtakeda', 'lokesh.patil', 'ganesharpan.nookala', 'vraj.b', 'jainhitanshu588', 'aniket.gawade', 'vaibhav.raina', 'ajvillani', 'pranay.tiwari', 'ankit.manani', 'i.mirasifali', 'njenkins', 'elmar.aichberger', 'victorigor', 'jadhavakashb143', 'sanskruti.joshi29']",11,"[None, 'dariogui', 'eduardaamaral30', 'victorfidelis', 'ricardqueiroz', 'brunaeloisa', 'rodrigoluna1', 'yurimdias', 'diomadson', 'sidney.hca', 'rosiivaldo']",193,"['nookalaarpan12', 'mlreum', 'michaelg1137', 'vishrut240501', 'ishika.raghuwanshi', 'haopolin', 'ayush2801', 'malhar.vairale1812', 'moghimil', 'aditichaturvedi', 'sahil.patil', 'keeganchafin', 'musmau82', 'sanskar.laddha', 'mitash0404', 'dhiraj.choudhari', 'tirthpatel', 'pratham.solanki02', 'shahid_ms10', 'klinner', 'surajsarjes', 'divija.shringarpure', 'nurfazrina', 'jaidamani42', 'bilal2912', 'marcelo.rodrigues', 'mjm2164', 'parth.bywar', 'nagrechavarun', 'niranjan.badhe', 'bhavika.vaishnavi', 'sneha15weakey', 'aryandali1412', 'mansi007mtvlsi20', 'antoniopml', 'manan.arora', 'nln85', 'hrishikesh28', 'sneee', 'g1', 'dariogui', 'dhananjay23', 'akshada.hadal', 'darshansomani8', 'saikrishnam', 'sandeep.suthar', 'shweta0208', 'aftabrafiq', 'nayana.19mvd7003', 'h1tenbafna', 'anushka.pilena', 'prathamm12', 'omkar.pawar', 'smriti.islur', 'keshav_thosar', 'husain.challawala', 'umang.agarwal', 'aditya.umalkar', 'adrao', 'aryan.dali', 'poseidon_1909', 'gauripethkar', 'kartheekbogi25', 'adnan.mohiddin', 'hevila', 'sayaliayre22', None, 'rohitrane500', 'brianfaires', 'tdbuechler', 'darshan.tater', 'lohanpeixoto', 'ritik.koul', 'oindrella', 'dbayko', 'aditi.bagwe', 'bstelter', 'truptigopinath', 'kadamyogesh31', 'brunaeloisa', 'brianterry', 'sneha.savarkar', 'mcrussell', 'khushi.agrawal', 'nanohubrc', 'avyeshbhatnagar46', 'pushkarsutar999', 'siddhant11', 'ricardqueiroz', 'swapnil.mandavilli', 'trustme20times', 'jayesh_bane', 'siddhant.kamlaskar', 'giridhar.19mvd7004', 'jxc85295', 'dwx', 'katiyar_ravins', 'pushkar.sutar', 'atharvasonavane', 'niharika1528', 'prerna.arora', 'yugandhara.wadikar', 'sidney.hca', 'sohel.datta', 'crystalv', 'nimratkaur', 'sayak.pramanik', 'p20vl003', 'pulkit.chaudhari', 'anuj.chavan', 'richa.motwani', 'swaraj.salunke', 'prabhat.kumar', 'oanhtran97', 'arwaje.364', 'yuvraj.purohit', 'sudhanshu128', 'aryansolanki', 'prioslimon', 'marcelobr07', 'diomadson', 'deekshapalll', 'cxxpxx19', 'victorfidelis', 'hqwbu1stq9', 'bilalsani2912', 'chetana.kamalkar', 'sarasheth60', 'yurimdias', 'venkata.revanth', 'rosiivaldo', 'manas.tiwari', 'abhinav.pallayil', 'iq.rodriguez.1989', 'vivek.thakkar', 'soumyawbut8730', 'boonesmith', 'khushi.patni', 'chinmay.walinjkar', 'jaimindesai', 'shivang123', 'nushin01', 'devansh.palliyath', 'ajji.pavan', 'hargobind.singh', 'shivamvermaid1', 'kadenanderson1', 'shubham.sawant', 'omkar.shinde', 'ps12345', 'rodrigoluna1', 'dylan_ds0uza', 'junwin', 'anupriya.dasgupta', 'alexiscanez', 'ramprasad.19mvd7002', 'vduenas', 'megala1997', 'shivamthakur04', 'misschayla12', 'siddharthmohanty812', 'sanskarmbadjatia', 'nicolelphan', 'samay.gada', 'ashish.jingar', 'cpierce14', 'eduardaamaral30', 'shannon', 'vishal.lohar', 'rohit.desai', 'ranitibdewal', 'anthonyc1', 'eeshaanasodekar', 'maitri.vora', 'vinayak.tripathi', 'anshalpadole30', 'aryaman.gokarn', 'wtakeda', 'lokesh.patil', 'ganesharpan.nookala', 'vraj.b', 'jainhitanshu588', 'aniket.gawade', 'vaibhav.raina', 'ajvillani', 'pranay.tiwari', 'ankit.manani', 'i.mirasifali', 'njenkins', 'elmar.aichberger', 'victorigor', 'jadhavakashb143', 'sanskruti.joshi29']"
4,52,183,13,12,"['malhar.vairale1812', 'parth.bywar', 'swaraj.salunke', 'niranjan.badhe', 'rohit.desai', 'ranitibdewal', 'keshav_thosar', 'venkata.revanth', 'husain.challawala', 'jadhavakashb143', 'vinayak.tripathi', 'sanskruti.joshi29']",170,"['nookalaarpan12', 'mlreum', 'michaelg1137', 'vishrut240501', 'ishika.raghuwanshi', 'haopolin', 'ayush2801', 'moghimil', 'aditichaturvedi', 'sahil.patil', 'keeganchafin', 'musmau82', 'sanskar.laddha', 'mitash0404', 'dhiraj.choudhari', 'tirthpatel', 'pratham.solanki02', 'shahid_ms10', 'klinner', 'surajsarjes', 'divija.shringarpure', 'nurfazrina', 'jaidamani42', 'bilal2912', 'marcelo.rodrigues', 'mjm2164', 'nagrechavarun', 'bhavika.vaishnavi', 'sneha15weakey', 'aryandali1412', 'mansi007mtvlsi20', 'antoniopml', 'manan.arora', 'nln85', 'hrishikesh28', 'sneee', 'g1', 'dhananjay23', 'akshada.hadal', 'darshansomani8', 'saikrishnam', 'sandeep.suthar', 'shweta0208', 'aftabrafiq', 'nayana.19mvd7003', 'h1tenbafna', 'anushka.pilena', 'prathamm12', 'omkar.pawar', 'smriti.islur', 'umang.agarwal', 'aditya.umalkar', 'adrao', 'aryan.dali', 'poseidon_1909', 'gauripethkar', 'kartheekbogi25', 'adnan.mohiddin', 'hevila', 'sayaliayre22', 'rohitrane500', 'brianfaires', 'tdbuechler', 'darshan.tater', 'lohanpeixoto', 'ritik.koul', 'oindrella', 'dbayko', 'aditi.bagwe', 'bstelter', 'truptigopinath', 'kadamyogesh31', 'brianterry', 'sneha.savarkar', 'mcrussell', 'khushi.agrawal', 'nanohubrc', 'avyeshbhatnagar46', 'pushkarsutar999', 'siddhant11', 'swapnil.mandavilli', 'trustme20times', 'jayesh_bane', 'siddhant.kamlaskar', 'giridhar.19mvd7004', 'jxc85295', 'dwx', 'katiyar_ravins', 'pushkar.sutar', 'atharvasonavane', 'niharika1528', 'prerna.arora', 'yugandhara.wadikar', 'sohel.datta', 'crystalv', 'nimratkaur', 'sayak.pramanik', 'p20vl003', 'pulkit.chaudhari', 'anuj.chavan', 'richa.motwani', 'prabhat.kumar', 'oanhtran97', 'arwaje.364', 'yuvraj.purohit', 'sudhanshu128', 'aryansolanki', 'prioslimon', 'marcelobr07', 'deekshapalll', 'cxxpxx19', 'hqwbu1stq9', 'bilalsani2912', 'chetana.kamalkar', 'sarasheth60', 'manas.tiwari', 'abhinav.pallayil', 'iq.rodriguez.1989', 'vivek.thakkar', 'soumyawbut8730', 'boonesmith', 'khushi.patni', 'chinmay.walinjkar', 'jaimindesai', 'shivang123', 'nushin01', 'devansh.palliyath', 'ajji.pavan', 'hargobind.singh', 'shivamvermaid1', 'kadenanderson1', 'shubham.sawant', 'omkar.shinde', 'ps12345', 'dylan_ds0uza', 'junwin', 'anupriya.dasgupta', 'alexiscanez', 'ramprasad.19mvd7002', 'vduenas', 'megala1997', 'shivamthakur04', 'misschayla12', 'siddharthmohanty812', 'sanskarmbadjatia', 'nicolelphan', 'samay.gada', 'ashish.jingar', 'cpierce14', 'shannon', 'vishal.lohar', 'anthonyc1', 'eeshaanasodekar', 'maitri.vora', 'anshalpadole30', 'aryaman.gokarn', 'wtakeda', 'lokesh.patil', 'ganesharpan.nookala', 'vraj.b', 'jainhitanshu588', 'aniket.gawade', 'vaibhav.raina', 'ajvillani', 'pranay.tiwari', 'ankit.manani', 'i.mirasifali', 'njenkins', 'elmar.aichberger', 'victorigor']",1,[None],183,"['nookalaarpan12', 'mlreum', 'michaelg1137', 'vishrut240501', 'ishika.raghuwanshi', 'haopolin', 'ayush2801', 'malhar.vairale1812', 'moghimil', 'aditichaturvedi', 'sahil.patil', 'keeganchafin', 'musmau82', 'sanskar.laddha', 'mitash0404', 'dhiraj.choudhari', 'tirthpatel', 'pratham.solanki02', 'shahid_ms10', 'klinner', 'surajsarjes', 'divija.shringarpure', 'nurfazrina', 'jaidamani42', 'bilal2912', 'marcelo.rodrigues', 'mjm2164', 'parth.bywar', 'nagrechavarun', 'niranjan.badhe', 'bhavika.vaishnavi', 'sneha15weakey', 'aryandali1412', 'mansi007mtvlsi20', 'antoniopml', 'manan.arora', 'nln85', 'hrishikesh28', 'sneee', 'g1', 'dhananjay23', 'akshada.hadal', 'darshansomani8', 'saikrishnam', 'sandeep.suthar', 'shweta0208', 'aftabrafiq', 'nayana.19mvd7003', 'h1tenbafna', 'anushka.pilena', 'prathamm12', 'omkar.pawar', 'smriti.islur', 'keshav_thosar', 'husain.challawala', 'umang.agarwal', 'aditya.umalkar', 'adrao', 'aryan.dali', 'poseidon_1909', 'gauripethkar', 'kartheekbogi25', 'adnan.mohiddin', 'hevila', 'sayaliayre22', None, 'rohitrane500', 'brianfaires', 'tdbuechler', 'darshan.tater', 'lohanpeixoto', 'ritik.koul', 'oindrella', 'dbayko', 'aditi.bagwe', 'bstelter', 'truptigopinath', 'kadamyogesh31', 'brianterry', 'sneha.savarkar', 'mcrussell', 'khushi.agrawal', 'nanohubrc', 'avyeshbhatnagar46', 'pushkarsutar999', 'siddhant11', 'swapnil.mandavilli', 'trustme20times', 'jayesh_bane', 'siddhant.kamlaskar', 'giridhar.19mvd7004', 'jxc85295', 'dwx', 'katiyar_ravins', 'pushkar.sutar', 'atharvasonavane', 'niharika1528', 'prerna.arora', 'yugandhara.wadikar', 'sohel.datta', 'crystalv', 'nimratkaur', 'sayak.pramanik', 'p20vl003', 'pulkit.chaudhari', 'anuj.chavan', 'richa.motwani', 'swaraj.salunke', 'prabhat.kumar', 'oanhtran97', 'arwaje.364', 'yuvraj.purohit', 'sudhanshu128', 'aryansolanki', 'prioslimon', 'marcelobr07', 'deekshapalll', 'cxxpxx19', 'hqwbu1stq9', 'bilalsani2912', 'chetana.kamalkar', 'sarasheth60', 'venkata.revanth', 'manas.tiwari', 'abhinav.pallayil', 'iq.rodriguez.1989', 'vivek.thakkar', 'soumyawbut8730', 'boonesmith', 'khushi.patni', 'chinmay.walinjkar', 'jaimindesai', 'shivang123', 'nushin01', 'devansh.palliyath', 'ajji.pavan', 'hargobind.singh', 'shivamvermaid1', 'kadenanderson1', 'shubham.sawant', 'omkar.shinde', 'ps12345', 'dylan_ds0uza', 'junwin', 'anupriya.dasgupta', 'alexiscanez', 'ramprasad.19mvd7002', 'vduenas', 'megala1997', 'shivamthakur04', 'misschayla12', 'siddharthmohanty812', 'sanskarmbadjatia', 'nicolelphan', 'samay.gada', 'ashish.jingar', 'cpierce14', 'shannon', 'vishal.lohar', 'rohit.desai', 'ranitibdewal', 'anthonyc1', 'eeshaanasodekar', 'maitri.vora', 'vinayak.tripathi', 'anshalpadole30', 'aryaman.gokarn', 'wtakeda', 'lokesh.patil', 'ganesharpan.nookala', 'vraj.b', 'jainhitanshu588', 'aniket.gawade', 'vaibhav.raina', 'ajvillani', 'pranay.tiwari', 'ankit.manani', 'i.mirasifali', 'njenkins', 'elmar.aichberger', 'victorigor', 'jadhavakashb143', 'sanskruti.joshi29']"
4,53,183,13,1,['megala1997'],181,"['nookalaarpan12', 'mlreum', 'michaelg1137', 'vishrut240501', 'ishika.raghuwanshi', 'haopolin', 'ayush2801', 'malhar.vairale1812', 'moghimil', 'aditichaturvedi', 'sahil.patil', 'keeganchafin', 'musmau82', 'sanskar.laddha', 'mitash0404', 'dhiraj.choudhari', 'tirthpatel', 'pratham.solanki02', 'shahid_ms10', 'klinner', 'surajsarjes', 'divija.shringarpure', 'nurfazrina', 'jaidamani42', 'bilal2912', 'marcelo.rodrigues', 'mjm2164', 'parth.bywar', 'nagrechavarun', 'niranjan.badhe', 'bhavika.vaishnavi', 'sneha15weakey', 'aryandali1412', 'mansi007mtvlsi20', 'antoniopml', 'manan.arora', 'nln85', 'hrishikesh28', 'sneee', 'g1', 'dhananjay23', 'akshada.hadal', 'darshansomani8', 'saikrishnam', 'sandeep.suthar', 'shweta0208', 'aftabrafiq', 'nayana.19mvd7003', 'h1tenbafna', 'anushka.pilena', 'prathamm12', 'omkar.pawar', 'smriti.islur', 'keshav_thosar', 'husain.challawala', 'umang.agarwal', 'aditya.umalkar', 'adrao', 'aryan.dali', 'poseidon_1909', 'gauripethkar', 'kartheekbogi25', 'adnan.mohiddin', 'hevila', 'sayaliayre22', 'rohitrane500', 'brianfaires', 'tdbuechler', 'darshan.tater', 'lohanpeixoto', 'ritik.koul', 'oindrella', 'dbayko', 'aditi.bagwe', 'bstelter', 'truptigopinath', 'kadamyogesh31', 'brianterry', 'sneha.savarkar', 'mcrussell', 'khushi.agrawal', 'nanohubrc', 'avyeshbhatnagar46', 'pushkarsutar999', 'siddhant11', 'swapnil.mandavilli', 'trustme20times', 'jayesh_bane', 'siddhant.kamlaskar', 'giridhar.19mvd7004', 'jxc85295', 'dwx', 'katiyar_ravins', 'pushkar.sutar', 'atharvasonavane', 'niharika1528', 'prerna.arora', 'yugandhara.wadikar', 'sohel.datta', 'crystalv', 'nimratkaur', 'sayak.pramanik', 'p20vl003', 'pulkit.chaudhari', 'anuj.chavan', 'richa.motwani', 'swaraj.salunke', 'prabhat.kumar', 'oanhtran97', 'arwaje.364', 'yuvraj.purohit', 'sudhanshu128', 'aryansolanki', 'prioslimon', 'marcelobr07', 'deekshapalll', 'cxxpxx19', 'hqwbu1stq9', 'bilalsani2912', 'chetana.kamalkar', 'sarasheth60', 'venkata.revanth', 'manas.tiwari', 'abhinav.pallayil', 'iq.rodriguez.1989', 'vivek.thakkar', 'soumyawbut8730', 'boonesmith', 'khushi.patni', 'chinmay.walinjkar', 'jaimindesai', 'shivang123', 'nushin01', 'devansh.palliyath', 'ajji.pavan', 'hargobind.singh', 'shivamvermaid1', 'kadenanderson1', 'shubham.sawant', 'omkar.shinde', 'ps12345', 'dylan_ds0uza', 'junwin', 'anupriya.dasgupta', 'alexiscanez', 'ramprasad.19mvd7002', 'vduenas', 'shivamthakur04', 'misschayla12', 'siddharthmohanty812', 'sanskarmbadjatia', 'nicolelphan', 'samay.gada', 'ashish.jingar', 'cpierce14', 'shannon', 'vishal.lohar', 'rohit.desai', 'ranitibdewal', 'anthonyc1', 'eeshaanasodekar', 'maitri.vora', 'vinayak.tripathi', 'anshalpadole30', 'aryaman.gokarn', 'wtakeda', 'lokesh.patil', 'ganesharpan.nookala', 'vraj.b', 'jainhitanshu588', 'aniket.gawade', 'vaibhav.raina', 'ajvillani', 'pranay.tiwari', 'ankit.manani', 'i.mirasifali', 'njenkins', 'elmar.aichberger', 'victorigor', 'jadhavakashb143', 'sanskruti.joshi29']",12,"['aimenfatimah', 'dyana4152', 'hziq97', 'megala97', 'hln_04', 'azimighani', 'sham1997', 'syafiqah97', 'dayana83', 'nilamsarib081810464', None, 'nurazwab081810444']",194,"['nookalaarpan12', 'aimenfatimah', 'mlreum', 'michaelg1137', 'vishrut240501', 'ishika.raghuwanshi', 'haopolin', 'ayush2801', 'malhar.vairale1812', 'moghimil', 'aditichaturvedi', 'sahil.patil', 'keeganchafin', 'musmau82', 'sanskar.laddha', 'mitash0404', 'dhiraj.choudhari', 'dayana83', 'tirthpatel', 'pratham.solanki02', 'shahid_ms10', 'klinner', 'surajsarjes', 'divija.shringarpure', 'nilamsarib081810464', 'nurfazrina', 'jaidamani42', 'bilal2912', 'marcelo.rodrigues', 'mjm2164', 'parth.bywar', 'nagrechavarun', 'niranjan.badhe', 'bhavika.vaishnavi', 'sneha15weakey', 'nurazwab081810444', 'aryandali1412', 'mansi007mtvlsi20', 'antoniopml', 'manan.arora', 'nln85', 'hrishikesh28', 'sneee', 'g1', 'dhananjay23', 'akshada.hadal', 'darshansomani8', 'saikrishnam', 'sandeep.suthar', 'shweta0208', 'aftabrafiq', 'nayana.19mvd7003', 'h1tenbafna', 'anushka.pilena', 'prathamm12', 'omkar.pawar', 'smriti.islur', 'syafiqah97', 'keshav_thosar', 'husain.challawala', 'umang.agarwal', 'aditya.umalkar', 'adrao', 'aryan.dali', 'megala97', 'poseidon_1909', 'gauripethkar', 'kartheekbogi25', 'adnan.mohiddin', 'hevila', 'sayaliayre22', None, 'rohitrane500', 'azimighani', 'brianfaires', 'tdbuechler', 'darshan.tater', 'lohanpeixoto', 'ritik.koul', 'oindrella', 'dbayko', 'aditi.bagwe', 'bstelter', 'truptigopinath', 'kadamyogesh31', 'brianterry', 'sneha.savarkar', 'mcrussell', 'khushi.agrawal', 'nanohubrc', 'avyeshbhatnagar46', 'hziq97', 'pushkarsutar999', 'siddhant11', 'swapnil.mandavilli', 'trustme20times', 'jayesh_bane', 'siddhant.kamlaskar', 'giridhar.19mvd7004', 'jxc85295', 'dwx', 'katiyar_ravins', 'pushkar.sutar', 'atharvasonavane', 'niharika1528', 'prerna.arora', 'yugandhara.wadikar', 'sohel.datta', 'crystalv', 'nimratkaur', 'sayak.pramanik', 'p20vl003', 'pulkit.chaudhari', 'anuj.chavan', 'richa.motwani', 'swaraj.salunke', 'prabhat.kumar', 'oanhtran97', 'arwaje.364', 'yuvraj.purohit', 'sudhanshu128', 'aryansolanki', 'prioslimon', 'marcelobr07', 'deekshapalll', 'hln_04', 'cxxpxx19', 'hqwbu1stq9', 'bilalsani2912', 'chetana.kamalkar', 'sarasheth60', 'venkata.revanth', 'manas.tiwari', 'abhinav.pallayil', 'iq.rodriguez.1989', 'vivek.thakkar', 'soumyawbut8730', 'boonesmith', 'khushi.patni', 'chinmay.walinjkar', 'jaimindesai', 'shivang123', 'nushin01', 'devansh.palliyath', 'ajji.pavan', 'hargobind.singh', 'shivamvermaid1', 'kadenanderson1', 'shubham.sawant', 'omkar.shinde', 'ps12345', 'dylan_ds0uza', 'junwin', 'anupriya.dasgupta', 'alexiscanez', 'ramprasad.19mvd7002', 'vduenas', 'megala1997', 'shivamthakur04', 'misschayla12', 'siddharthmohanty812', 'sanskarmbadjatia', 'dyana4152', 'nicolelphan', 'samay.gada', 'ashish.jingar', 'cpierce14', 'shannon', 'vishal.lohar', 'rohit.desai', 'ranitibdewal', 'anthonyc1', 'eeshaanasodekar', 'maitri.vora', 'vinayak.tripathi', 'anshalpadole30', 'aryaman.gokarn', 'wtakeda', 'lokesh.patil', 'ganesharpan.nookala', 'vraj.b', 'jainhitanshu588', 'aniket.gawade', 'sham1997', 'vaibhav.raina', 'ajvillani', 'pranay.tiwari', 'ankit.manani', 'i.mirasifali', 'njenkins', 'elmar.aichberger', 'victorigor', 'jadhavakashb143', 'sanskruti.joshi29']"
4,47,183,11,2,"['rohitrane500', 'hrishikesh28']",180,"['nookalaarpan12', 'mlreum', 'michaelg1137', 'vishrut240501', 'ishika.raghuwanshi', 'haopolin', 'ayush2801', 'malhar.vairale1812', 'moghimil', 'aditichaturvedi', 'sahil.patil', 'keeganchafin', 'musmau82', 'sanskar.laddha', 'mitash0404', 'dhiraj.choudhari', 'tirthpatel', 'pratham.solanki02', 'shahid_ms10', 'klinner', 'surajsarjes', 'divija.shringarpure', 'nurfazrina', 'jaidamani42', 'bilal2912', 'marcelo.rodrigues', 'mjm2164', 'parth.bywar', 'nagrechavarun', 'niranjan.badhe', 'bhavika.vaishnavi', 'sneha15weakey', 'aryandali1412', 'mansi007mtvlsi20', 'antoniopml', 'manan.arora', 'nln85', 'sneee', 'g1', 'dhananjay23', 'akshada.hadal', 'darshansomani8', 'saikrishnam', 'sandeep.suthar', 'shweta0208', 'aftabrafiq', 'nayana.19mvd7003', 'h1tenbafna', 'anushka.pilena', 'prathamm12', 'omkar.pawar', 'smriti.islur', 'keshav_thosar', 'husain.challawala', 'umang.agarwal', 'aditya.umalkar', 'adrao', 'aryan.dali', 'poseidon_1909', 'gauripethkar', 'kartheekbogi25', 'adnan.mohiddin', 'hevila', 'sayaliayre22', 'brianfaires', 'tdbuechler', 'darshan.tater', 'lohanpeixoto', 'ritik.koul', 'oindrella', 'dbayko', 'aditi.bagwe', 'bstelter', 'truptigopinath', 'kadamyogesh31', 'brianterry', 'sneha.savarkar', 'mcrussell', 'khushi.agrawal', 'nanohubrc', 'avyeshbhatnagar46', 'pushkarsutar999', 'siddhant11', 'swapnil.mandavilli', 'trustme20times', 'jayesh_bane', 'siddhant.kamlaskar', 'giridhar.19mvd7004', 'jxc85295', 'dwx', 'katiyar_ravins', 'pushkar.sutar', 'atharvasonavane', 'niharika1528', 'prerna.arora', 'yugandhara.wadikar', 'sohel.datta', 'crystalv', 'nimratkaur', 'sayak.pramanik', 'p20vl003', 'pulkit.chaudhari', 'anuj.chavan', 'richa.motwani', 'swaraj.salunke', 'prabhat.kumar', 'oanhtran97', 'arwaje.364', 'yuvraj.purohit', 'sudhanshu128', 'aryansolanki', 'prioslimon', 'marcelobr07', 'deekshapalll', 'cxxpxx19', 'hqwbu1stq9', 'bilalsani2912', 'chetana.kamalkar', 'sarasheth60', 'venkata.revanth', 'manas.tiwari', 'abhinav.pallayil', 'iq.rodriguez.1989', 'vivek.thakkar', 'soumyawbut8730', 'boonesmith', 'khushi.patni', 'chinmay.walinjkar', 'jaimindesai', 'shivang123', 'nushin01', 'devansh.palliyath', 'ajji.pavan', 'hargobind.singh', 'shivamvermaid1', 'kadenanderson1', 'shubham.sawant', 'omkar.shinde', 'ps12345', 'dylan_ds0uza', 'junwin', 'anupriya.dasgupta', 'alexiscanez', 'ramprasad.19mvd7002', 'vduenas', 'megala1997', 'shivamthakur04', 'misschayla12', 'siddharthmohanty812', 'sanskarmbadjatia', 'nicolelphan', 'samay.gada', 'ashish.jingar', 'cpierce14', 'shannon', 'vishal.lohar', 'rohit.desai', 'ranitibdewal', 'anthonyc1', 'eeshaanasodekar', 'maitri.vora', 'vinayak.tripathi', 'anshalpadole30', 'aryaman.gokarn', 'wtakeda', 'lokesh.patil', 'ganesharpan.nookala', 'vraj.b', 'jainhitanshu588', 'aniket.gawade', 'vaibhav.raina', 'ajvillani', 'pranay.tiwari', 'ankit.manani', 'i.mirasifali', 'njenkins', 'elmar.aichberger', 'victorigor', 'jadhavakashb143', 'sanskruti.joshi29']",9,"['tarun96', 'rathod_spce', 'sangeetamjoshi', 'sumitdupate19', 'vedant.modak', 'tiwarisuraj5769', 'anuragmandke4', 'kshemal_gupte', None]",191,"['nookalaarpan12', 'mlreum', 'michaelg1137', 'vishrut240501', 'ishika.raghuwanshi', 'haopolin', 'ayush2801', 'malhar.vairale1812', 'moghimil', 'aditichaturvedi', 'sahil.patil', 'keeganchafin', 'musmau82', 'sanskar.laddha', 'mitash0404', 'dhiraj.choudhari', 'tirthpatel', 'pratham.solanki02', 'shahid_ms10', 'klinner', 'surajsarjes', 'divija.shringarpure', 'nurfazrina', 'jaidamani42', 'bilal2912', 'marcelo.rodrigues', 'mjm2164', 'parth.bywar', 'rathod_spce', 'nagrechavarun', 'niranjan.badhe', 'bhavika.vaishnavi', 'tiwarisuraj5769', 'sneha15weakey', 'aryandali1412', 'mansi007mtvlsi20', 'antoniopml', 'manan.arora', 'nln85', 'hrishikesh28', 'sneee', 'g1', 'dhananjay23', 'akshada.hadal', 'sangeetamjoshi', 'darshansomani8', 'saikrishnam', 'sandeep.suthar', 'shweta0208', 'aftabrafiq', 'nayana.19mvd7003', 'h1tenbafna', 'anushka.pilena', 'prathamm12', 'omkar.pawar', 'smriti.islur', 'keshav_thosar', 'husain.challawala', 'umang.agarwal', 'aditya.umalkar', 'adrao', 'aryan.dali', 'poseidon_1909', 'gauripethkar', 'kartheekbogi25', 'adnan.mohiddin', 'hevila', 'sayaliayre22', None, 'rohitrane500', 'brianfaires', 'tdbuechler', 'darshan.tater', 'lohanpeixoto', 'ritik.koul', 'oindrella', 'dbayko', 'aditi.bagwe', 'bstelter', 'truptigopinath', 'kadamyogesh31', 'brianterry', 'sneha.savarkar', 'mcrussell', 'khushi.agrawal', 'anuragmandke4', 'nanohubrc', 'avyeshbhatnagar46', 'pushkarsutar999', 'siddhant11', 'swapnil.mandavilli', 'trustme20times', 'jayesh_bane', 'siddhant.kamlaskar', 'giridhar.19mvd7004', 'jxc85295', 'dwx', 'katiyar_ravins', 'pushkar.sutar', 'atharvasonavane', 'niharika1528', 'prerna.arora', 'yugandhara.wadikar', 'sohel.datta', 'crystalv', 'nimratkaur', 'sayak.pramanik', 'p20vl003', 'pulkit.chaudhari', 'anuj.chavan', 'richa.motwani', 'swaraj.salunke', 'prabhat.kumar', 'oanhtran97', 'arwaje.364', 'vedant.modak', 'yuvraj.purohit', 'sudhanshu128', 'aryansolanki', 'prioslimon', 'marcelobr07', 'deekshapalll', 'cxxpxx19', 'hqwbu1stq9', 'bilalsani2912', 'chetana.kamalkar', 'sarasheth60', 'venkata.revanth', 'manas.tiwari', 'abhinav.pallayil', 'iq.rodriguez.1989', 'vivek.thakkar', 'soumyawbut8730', 'boonesmith', 'khushi.patni', 'chinmay.walinjkar', 'jaimindesai', 'shivang123', 'nushin01', 'devansh.palliyath', 'ajji.pavan', 'hargobind.singh', 'shivamvermaid1', 'tarun96', 'kadenanderson1', 'shubham.sawant', 'omkar.shinde', 'ps12345', 'dylan_ds0uza', 'junwin', 'anupriya.dasgupta', 'alexiscanez', 'ramprasad.19mvd7002', 'vduenas', 'kshemal_gupte', 'megala1997', 'shivamthakur04', 'misschayla12', 'siddharthmohanty812', 'sanskarmbadjatia', 'nicolelphan', 'samay.gada', 'ashish.jingar', 'cpierce14', 'sumitdupate19', 'shannon', 'vishal.lohar', 'rohit.desai', 'ranitibdewal', 'anthonyc1', 'eeshaanasodekar', 'maitri.vora', 'vinayak.tripathi', 'anshalpadole30', 'aryaman.gokarn', 'wtakeda', 'lokesh.patil', 'ganesharpan.nookala', 'vraj.b', 'jainhitanshu588', 'aniket.gawade', 'vaibhav.raina', 'ajvillani', 'pranay.tiwari', 'ankit.manani', 'i.mirasifali', 'njenkins', 'elmar.aichberger', 'victorigor', 'jadhavakashb143', 'sanskruti.joshi29']"
4,55,183,11,10,"['malhar.vairale1812', 'sanskarmbadjatia', 'swaraj.salunke', 'mitash0404', 'vinayak.tripathi', 'ranitibdewal', 'sayaliayre22', 'shahid_ms10', 'anshalpadole30', 'sanskruti.joshi29']",172,"['nookalaarpan12', 'mlreum', 'michaelg1137', 'vishrut240501', 'ishika.raghuwanshi', 'haopolin', 'ayush2801', 'moghimil', 'aditichaturvedi', 'sahil.patil', 'keeganchafin', 'musmau82', 'sanskar.laddha', 'dhiraj.choudhari', 'tirthpatel', 'pratham.solanki02', 'klinner', 'surajsarjes', 'divija.shringarpure', 'nurfazrina', 'jaidamani42', 'bilal2912', 'marcelo.rodrigues', 'mjm2164', 'parth.bywar', 'nagrechavarun', 'niranjan.badhe', 'bhavika.vaishnavi', 'sneha15weakey', 'aryandali1412', 'mansi007mtvlsi20', 'antoniopml', 'manan.arora', 'nln85', 'hrishikesh28', 'sneee', 'g1', 'dhananjay23', 'akshada.hadal', 'darshansomani8', 'saikrishnam', 'sandeep.suthar', 'shweta0208', 'aftabrafiq', 'nayana.19mvd7003', 'h1tenbafna', 'anushka.pilena', 'prathamm12', 'omkar.pawar', 'smriti.islur', 'keshav_thosar', 'husain.challawala', 'umang.agarwal', 'aditya.umalkar', 'adrao', 'aryan.dali', 'poseidon_1909', 'gauripethkar', 'kartheekbogi25', 'adnan.mohiddin', 'hevila', 'rohitrane500', 'brianfaires', 'tdbuechler', 'darshan.tater', 'lohanpeixoto', 'ritik.koul', 'oindrella', 'dbayko', 'aditi.bagwe', 'bstelter', 'truptigopinath', 'kadamyogesh31', 'brianterry', 'sneha.savarkar', 'mcrussell', 'khushi.agrawal', 'nanohubrc', 'avyeshbhatnagar46', 'pushkarsutar999', 'siddhant11', 'swapnil.mandavilli', 'trustme20times', 'jayesh_bane', 'siddhant.kamlaskar', 'giridhar.19mvd7004', 'jxc85295', 'dwx', 'katiyar_ravins', 'pushkar.sutar', 'atharvasonavane', 'niharika1528', 'prerna.arora', 'yugandhara.wadikar', 'sohel.datta', 'crystalv', 'nimratkaur', 'sayak.pramanik', 'p20vl003', 'pulkit.chaudhari', 'anuj.chavan', 'richa.motwani', 'prabhat.kumar', 'oanhtran97', 'arwaje.364', 'yuvraj.purohit', 'sudhanshu128', 'aryansolanki', 'prioslimon', 'marcelobr07', 'deekshapalll', 'cxxpxx19', 'hqwbu1stq9', 'bilalsani2912', 'chetana.kamalkar', 'sarasheth60', 'venkata.revanth', 'manas.tiwari', 'abhinav.pallayil', 'iq.rodriguez.1989', 'vivek.thakkar', 'soumyawbut8730', 'boonesmith', 'khushi.patni', 'chinmay.walinjkar', 'jaimindesai', 'shivang123', 'nushin01', 'devansh.palliyath', 'ajji.pavan', 'hargobind.singh', 'shivamvermaid1', 'kadenanderson1', 'shubham.sawant', 'omkar.shinde', 'ps12345', 'dylan_ds0uza', 'junwin', 'anupriya.dasgupta', 'alexiscanez', 'ramprasad.19mvd7002', 'vduenas', 'megala1997', 'shivamthakur04', 'misschayla12', 'siddharthmohanty812', 'nicolelphan', 'samay.gada', 'ashish.jingar', 'cpierce14', 'shannon', 'vishal.lohar', 'rohit.desai', 'anthonyc1', 'eeshaanasodekar', 'maitri.vora', 'aryaman.gokarn', 'wtakeda', 'lokesh.patil', 'ganesharpan.nookala', 'vraj.b', 'jainhitanshu588', 'aniket.gawade', 'vaibhav.raina', 'ajvillani', 'pranay.tiwari', 'ankit.manani', 'i.mirasifali', 'njenkins', 'elmar.aichberger', 'victorigor', 'jadhavakashb143']",1,[None],183,"['nookalaarpan12', 'mlreum', 'michaelg1137', 'vishrut240501', 'ishika.raghuwanshi', 'haopolin', 'ayush2801', 'malhar.vairale1812', 'moghimil', 'aditichaturvedi', 'sahil.patil', 'keeganchafin', 'musmau82', 'sanskar.laddha', 'mitash0404', 'dhiraj.choudhari', 'tirthpatel', 'pratham.solanki02', 'shahid_ms10', 'klinner', 'surajsarjes', 'divija.shringarpure', 'nurfazrina', 'jaidamani42', 'bilal2912', 'marcelo.rodrigues', 'mjm2164', 'parth.bywar', 'nagrechavarun', 'niranjan.badhe', 'bhavika.vaishnavi', 'sneha15weakey', 'aryandali1412', 'mansi007mtvlsi20', 'antoniopml', 'manan.arora', 'nln85', 'hrishikesh28', 'sneee', 'g1', 'dhananjay23', 'akshada.hadal', 'darshansomani8', 'saikrishnam', 'sandeep.suthar', 'shweta0208', 'aftabrafiq', 'nayana.19mvd7003', 'h1tenbafna', 'anushka.pilena', 'prathamm12', 'omkar.pawar', 'smriti.islur', 'keshav_thosar', 'husain.challawala', 'umang.agarwal', 'aditya.umalkar', 'adrao', 'aryan.dali', 'poseidon_1909', 'gauripethkar', 'kartheekbogi25', 'adnan.mohiddin', 'hevila', 'sayaliayre22', None, 'rohitrane500', 'brianfaires', 'tdbuechler', 'darshan.tater', 'lohanpeixoto', 'ritik.koul', 'oindrella', 'dbayko', 'aditi.bagwe', 'bstelter', 'truptigopinath', 'kadamyogesh31', 'brianterry', 'sneha.savarkar', 'mcrussell', 'khushi.agrawal', 'nanohubrc', 'avyeshbhatnagar46', 'pushkarsutar999', 'siddhant11', 'swapnil.mandavilli', 'trustme20times', 'jayesh_bane', 'siddhant.kamlaskar', 'giridhar.19mvd7004', 'jxc85295', 'dwx', 'katiyar_ravins', 'pushkar.sutar', 'atharvasonavane', 'niharika1528', 'prerna.arora', 'yugandhara.wadikar', 'sohel.datta', 'crystalv', 'nimratkaur', 'sayak.pramanik', 'p20vl003', 'pulkit.chaudhari', 'anuj.chavan', 'richa.motwani', 'swaraj.salunke', 'prabhat.kumar', 'oanhtran97', 'arwaje.364', 'yuvraj.purohit', 'sudhanshu128', 'aryansolanki', 'prioslimon', 'marcelobr07', 'deekshapalll', 'cxxpxx19', 'hqwbu1stq9', 'bilalsani2912', 'chetana.kamalkar', 'sarasheth60', 'venkata.revanth', 'manas.tiwari', 'abhinav.pallayil', 'iq.rodriguez.1989', 'vivek.thakkar', 'soumyawbut8730', 'boonesmith', 'khushi.patni', 'chinmay.walinjkar', 'jaimindesai', 'shivang123', 'nushin01', 'devansh.palliyath', 'ajji.pavan', 'hargobind.singh', 'shivamvermaid1', 'kadenanderson1', 'shubham.sawant', 'omkar.shinde', 'ps12345', 'dylan_ds0uza', 'junwin', 'anupriya.dasgupta', 'alexiscanez', 'ramprasad.19mvd7002', 'vduenas', 'megala1997', 'shivamthakur04', 'misschayla12', 'siddharthmohanty812', 'sanskarmbadjatia', 'nicolelphan', 'samay.gada', 'ashish.jingar', 'cpierce14', 'shannon', 'vishal.lohar', 'rohit.desai', 'ranitibdewal', 'anthonyc1', 'eeshaanasodekar', 'maitri.vora', 'vinayak.tripathi', 'anshalpadole30', 'aryaman.gokarn', 'wtakeda', 'lokesh.patil', 'ganesharpan.nookala', 'vraj.b', 'jainhitanshu588', 'aniket.gawade', 'vaibhav.raina', 'ajvillani', 'pranay.tiwari', 'ankit.manani', 'i.mirasifali', 'njenkins', 'elmar.aichberger', 'victorigor', 'jadhavakashb143', 'sanskruti.joshi29']"
4,56,183,11,9,"['malhar.vairale1812', 'avyeshbhatnagar46', 'richa.motwani', 'vivek.thakkar', 'sahil.patil', 'siddhant.kamlaskar', 'sayaliayre22', 'vinayak.tripathi', 'devansh.palliyath']",173,"['nookalaarpan12', 'mlreum', 'michaelg1137', 'vishrut240501', 'ishika.raghuwanshi', 'haopolin', 'ayush2801', 'moghimil', 'aditichaturvedi', 'keeganchafin', 'musmau82', 'sanskar.laddha', 'mitash0404', 'dhiraj.choudhari', 'tirthpatel', 'pratham.solanki02', 'shahid_ms10', 'klinner', 'surajsarjes', 'divija.shringarpure', 'nurfazrina', 'jaidamani42', 'bilal2912', 'marcelo.rodrigues', 'mjm2164', 'parth.bywar', 'nagrechavarun', 'niranjan.badhe', 'bhavika.vaishnavi', 'sneha15weakey', 'aryandali1412', 'mansi007mtvlsi20', 'antoniopml', 'manan.arora', 'nln85', 'hrishikesh28', 'sneee', 'g1', 'dhananjay23', 'akshada.hadal', 'darshansomani8', 'saikrishnam', 'sandeep.suthar', 'shweta0208', 'aftabrafiq', 'nayana.19mvd7003', 'h1tenbafna', 'anushka.pilena', 'prathamm12', 'omkar.pawar', 'smriti.islur', 'keshav_thosar', 'husain.challawala', 'umang.agarwal', 'aditya.umalkar', 'adrao', 'aryan.dali', 'poseidon_1909', 'gauripethkar', 'kartheekbogi25', 'adnan.mohiddin', 'hevila', 'rohitrane500', 'brianfaires', 'tdbuechler', 'darshan.tater', 'lohanpeixoto', 'ritik.koul', 'oindrella', 'dbayko', 'aditi.bagwe', 'bstelter', 'truptigopinath', 'kadamyogesh31', 'brianterry', 'sneha.savarkar', 'mcrussell', 'khushi.agrawal', 'nanohubrc', 'pushkarsutar999', 'siddhant11', 'swapnil.mandavilli', 'trustme20times', 'jayesh_bane', 'giridhar.19mvd7004', 'jxc85295', 'dwx', 'katiyar_ravins', 'pushkar.sutar', 'atharvasonavane', 'niharika1528', 'prerna.arora', 'yugandhara.wadikar', 'sohel.datta', 'crystalv', 'nimratkaur', 'sayak.pramanik', 'p20vl003', 'pulkit.chaudhari', 'anuj.chavan', 'swaraj.salunke', 'prabhat.kumar', 'oanhtran97', 'arwaje.364', 'yuvraj.purohit', 'sudhanshu128', 'aryansolanki', 'prioslimon', 'marcelobr07', 'deekshapalll', 'cxxpxx19', 'hqwbu1stq9', 'bilalsani2912', 'chetana.kamalkar', 'sarasheth60', 'venkata.revanth', 'manas.tiwari', 'abhinav.pallayil', 'iq.rodriguez.1989', 'soumyawbut8730', 'boonesmith', 'khushi.patni', 'chinmay.walinjkar', 'jaimindesai', 'shivang123', 'nushin01', 'ajji.pavan', 'hargobind.singh', 'shivamvermaid1', 'kadenanderson1', 'shubham.sawant', 'omkar.shinde', 'ps12345', 'dylan_ds0uza', 'junwin', 'anupriya.dasgupta', 'alexiscanez', 'ramprasad.19mvd7002', 'vduenas', 'megala1997', 'shivamthakur04', 'misschayla12', 'siddharthmohanty812', 'sanskarmbadjatia', 'nicolelphan', 'samay.gada', 'ashish.jingar', 'cpierce14', 'shannon', 'vishal.lohar', 'rohit.desai', 'ranitibdewal', 'anthonyc1', 'eeshaanasodekar', 'maitri.vora', 'anshalpadole30', 'aryaman.gokarn', 'wtakeda', 'lokesh.patil', 'ganesharpan.nookala', 'vraj.b', 'jainhitanshu588', 'aniket.gawade', 'vaibhav.raina', 'ajvillani', 'pranay.tiwari', 'ankit.manani', 'i.mirasifali', 'njenkins', 'elmar.aichberger', 'victorigor', 'jadhavakashb143', 'sanskruti.joshi29']",2,"[None, 'shraddha2002']",184,"['nookalaarpan12', 'mlreum', 'michaelg1137', 'vishrut240501', 'ishika.raghuwanshi', 'haopolin', 'ayush2801', 'malhar.vairale1812', 'moghimil', 'aditichaturvedi', 'sahil.patil', 'keeganchafin', 'musmau82', 'sanskar.laddha', 'mitash0404', 'dhiraj.choudhari', 'tirthpatel', 'pratham.solanki02', 'shahid_ms10', 'klinner', 'surajsarjes', 'divija.shringarpure', 'nurfazrina', 'jaidamani42', 'bilal2912', 'marcelo.rodrigues', 'mjm2164', 'parth.bywar', 'nagrechavarun', 'niranjan.badhe', 'bhavika.vaishnavi', 'sneha15weakey', 'aryandali1412', 'mansi007mtvlsi20', 'antoniopml', 'manan.arora', 'nln85', 'hrishikesh28', 'sneee', 'g1', 'dhananjay23', 'akshada.hadal', 'darshansomani8', 'saikrishnam', 'sandeep.suthar', 'shweta0208', 'aftabrafiq', 'nayana.19mvd7003', 'h1tenbafna', 'anushka.pilena', 'prathamm12', 'omkar.pawar', 'smriti.islur', 'keshav_thosar', 'husain.challawala', 'umang.agarwal', 'aditya.umalkar', 'adrao', 'aryan.dali', 'poseidon_1909', 'gauripethkar', 'kartheekbogi25', 'adnan.mohiddin', 'hevila', 'sayaliayre22', None, 'rohitrane500', 'brianfaires', 'tdbuechler', 'darshan.tater', 'lohanpeixoto', 'ritik.koul', 'oindrella', 'dbayko', 'aditi.bagwe', 'bstelter', 'truptigopinath', 'kadamyogesh31', 'brianterry', 'sneha.savarkar', 'mcrussell', 'khushi.agrawal', 'nanohubrc', 'avyeshbhatnagar46', 'pushkarsutar999', 'siddhant11', 'swapnil.mandavilli', 'trustme20times', 'jayesh_bane', 'siddhant.kamlaskar', 'giridhar.19mvd7004', 'jxc85295', 'dwx', 'katiyar_ravins', 'pushkar.sutar', 'atharvasonavane', 'niharika1528', 'prerna.arora', 'yugandhara.wadikar', 'sohel.datta', 'crystalv', 'nimratkaur', 'sayak.pramanik', 'p20vl003', 'pulkit.chaudhari', 'anuj.chavan', 'richa.motwani', 'swaraj.salunke', 'prabhat.kumar', 'oanhtran97', 'arwaje.364', 'yuvraj.purohit', 'sudhanshu128', 'aryansolanki', 'prioslimon', 'marcelobr07', 'shraddha2002', 'deekshapalll', 'cxxpxx19', 'hqwbu1stq9', 'bilalsani2912', 'chetana.kamalkar', 'sarasheth60', 'venkata.revanth', 'manas.tiwari', 'abhinav.pallayil', 'iq.rodriguez.1989', 'vivek.thakkar', 'soumyawbut8730', 'boonesmith', 'khushi.patni', 'chinmay.walinjkar', 'jaimindesai', 'shivang123', 'nushin01', 'devansh.palliyath', 'ajji.pavan', 'hargobind.singh', 'shivamvermaid1', 'kadenanderson1', 'shubham.sawant', 'omkar.shinde', 'ps12345', 'dylan_ds0uza', 'junwin', 'anupriya.dasgupta', 'alexiscanez', 'ramprasad.19mvd7002', 'vduenas', 'megala1997', 'shivamthakur04', 'misschayla12', 'siddharthmohanty812', 'sanskarmbadjatia', 'nicolelphan', 'samay.gada', 'ashish.jingar', 'cpierce14', 'shannon', 'vishal.lohar', 'rohit.desai', 'ranitibdewal', 'anthonyc1', 'eeshaanasodekar', 'maitri.vora', 'vinayak.tripathi', 'anshalpadole30', 'aryaman.gokarn', 'wtakeda', 'lokesh.patil', 'ganesharpan.nookala', 'vraj.b', 'jainhitanshu588', 'aniket.gawade', 'vaibhav.raina', 'ajvillani', 'pranay.tiwari', 'ankit.manani', 'i.mirasifali', 'njenkins', 'elmar.aichberger', 'victorigor', 'jadhavakashb143', 'sanskruti.joshi29']"
4,59,183,10,4,"['nookalaarpan12', 'rohitrane500', 'ankit.manani', 'anupriya.dasgupta']",178,"['mlreum', 'michaelg1137', 'vishrut240501', 'ishika.raghuwanshi', 'haopolin', 'ayush2801', 'malhar.vairale1812', 'moghimil', 'aditichaturvedi', 'sahil.patil', 'keeganchafin', 'musmau82', 'sanskar.laddha', 'mitash0404', 'dhiraj.choudhari', 'tirthpatel', 'pratham.solanki02', 'shahid_ms10', 'klinner', 'surajsarjes', 'divija.shringarpure', 'nurfazrina', 'jaidamani42', 'bilal2912', 'marcelo.rodrigues', 'mjm2164', 'parth.bywar', 'nagrechavarun', 'niranjan.badhe', 'bhavika.vaishnavi', 'sneha15weakey', 'aryandali1412', 'mansi007mtvlsi20', 'antoniopml', 'manan.arora', 'nln85', 'hrishikesh28', 'sneee', 'g1', 'dhananjay23', 'akshada.hadal', 'darshansomani8', 'saikrishnam', 'sandeep.suthar', 'shweta0208', 'aftabrafiq', 'nayana.19mvd7003', 'h1tenbafna', 'anushka.pilena', 'prathamm12', 'omkar.pawar', 'smriti.islur', 'keshav_thosar', 'husain.challawala', 'umang.agarwal', 'aditya.umalkar', 'adrao', 'aryan.dali', 'poseidon_1909', 'gauripethkar', 'kartheekbogi25', 'adnan.mohiddin', 'hevila', 'sayaliayre22', 'brianfaires', 'tdbuechler', 'darshan.tater', 'lohanpeixoto', 'ritik.koul', 'oindrella', 'dbayko', 'aditi.bagwe', 'bstelter', 'truptigopinath', 'kadamyogesh31', 'brianterry', 'sneha.savarkar', 'mcrussell', 'khushi.agrawal', 'nanohubrc', 'avyeshbhatnagar46', 'pushkarsutar999', 'siddhant11', 'swapnil.mandavilli', 'trustme20times', 'jayesh_bane', 'siddhant.kamlaskar', 'giridhar.19mvd7004', 'jxc85295', 'dwx', 'katiyar_ravins', 'pushkar.sutar', 'atharvasonavane', 'niharika1528', 'prerna.arora', 'yugandhara.wadikar', 'sohel.datta', 'crystalv', 'nimratkaur', 'sayak.pramanik', 'p20vl003', 'pulkit.chaudhari', 'anuj.chavan', 'richa.motwani', 'swaraj.salunke', 'prabhat.kumar', 'oanhtran97', 'arwaje.364', 'yuvraj.purohit', 'sudhanshu128', 'aryansolanki', 'prioslimon', 'marcelobr07', 'deekshapalll', 'cxxpxx19', 'hqwbu1stq9', 'bilalsani2912', 'chetana.kamalkar', 'sarasheth60', 'venkata.revanth', 'manas.tiwari', 'abhinav.pallayil', 'iq.rodriguez.1989', 'vivek.thakkar', 'soumyawbut8730', 'boonesmith', 'khushi.patni', 'chinmay.walinjkar', 'jaimindesai', 'shivang123', 'nushin01', 'devansh.palliyath', 'ajji.pavan', 'hargobind.singh', 'shivamvermaid1', 'kadenanderson1', 'shubham.sawant', 'omkar.shinde', 'ps12345', 'dylan_ds0uza', 'junwin', 'alexiscanez', 'ramprasad.19mvd7002', 'vduenas', 'megala1997', 'shivamthakur04', 'misschayla12', 'siddharthmohanty812', 'sanskarmbadjatia', 'nicolelphan', 'samay.gada', 'ashish.jingar', 'cpierce14', 'shannon', 'vishal.lohar', 'rohit.desai', 'ranitibdewal', 'anthonyc1', 'eeshaanasodekar', 'maitri.vora', 'vinayak.tripathi', 'anshalpadole30', 'aryaman.gokarn', 'wtakeda', 'lokesh.patil', 'ganesharpan.nookala', 'vraj.b', 'jainhitanshu588', 'aniket.gawade', 'vaibhav.raina', 'ajvillani', 'pranay.tiwari', 'i.mirasifali', 'njenkins', 'elmar.aichberger', 'victorigor', 'jadhavakashb143', 'sanskruti.joshi29']",6,"['divya.manikantan', 'apoorva.limaye', 'aniket.nadkarni', 'vikas.ms', None, 'simran.mulik']",188,"['nookalaarpan12', 'mlreum', 'michaelg1137', 'vishrut240501', 'ishika.raghuwanshi', 'haopolin', 'ayush2801', 'malhar.vairale1812', 'moghimil', 'aditichaturvedi', 'sahil.patil', 'keeganchafin', 'musmau82', 'sanskar.laddha', 'mitash0404', 'dhiraj.choudhari', 'tirthpatel', 'pratham.solanki02', 'shahid_ms10', 'klinner', 'surajsarjes', 'divija.shringarpure', 'nurfazrina', 'jaidamani42', 'bilal2912', 'marcelo.rodrigues', 'mjm2164', 'parth.bywar', 'nagrechavarun', 'niranjan.badhe', 'bhavika.vaishnavi', 'sneha15weakey', 'aryandali1412', 'mansi007mtvlsi20', 'antoniopml', 'manan.arora', 'nln85', 'hrishikesh28', 'sneee', 'g1', 'dhananjay23', 'akshada.hadal', 'darshansomani8', 'saikrishnam', 'sandeep.suthar', 'shweta0208', 'aftabrafiq', 'nayana.19mvd7003', 'h1tenbafna', 'anushka.pilena', 'prathamm12', 'omkar.pawar', 'smriti.islur', 'keshav_thosar', 'husain.challawala', 'umang.agarwal', 'aditya.umalkar', 'adrao', 'aryan.dali', 'divya.manikantan', 'poseidon_1909', 'gauripethkar', 'kartheekbogi25', 'adnan.mohiddin', 'hevila', 'sayaliayre22', None, 'rohitrane500', 'brianfaires', 'tdbuechler', 'darshan.tater', 'lohanpeixoto', 'ritik.koul', 'oindrella', 'dbayko', 'aditi.bagwe', 'bstelter', 'truptigopinath', 'kadamyogesh31', 'brianterry', 'sneha.savarkar', 'mcrussell', 'khushi.agrawal', 'nanohubrc', 'avyeshbhatnagar46', 'pushkarsutar999', 'siddhant11', 'swapnil.mandavilli', 'trustme20times', 'jayesh_bane', 'siddhant.kamlaskar', 'giridhar.19mvd7004', 'jxc85295', 'dwx', 'katiyar_ravins', 'pushkar.sutar', 'atharvasonavane', 'niharika1528', 'prerna.arora', 'yugandhara.wadikar', 'vikas.ms', 'sohel.datta', 'crystalv', 'nimratkaur', 'sayak.pramanik', 'p20vl003', 'pulkit.chaudhari', 'anuj.chavan', 'richa.motwani', 'swaraj.salunke', 'prabhat.kumar', 'oanhtran97', 'arwaje.364', 'yuvraj.purohit', 'sudhanshu128', 'aryansolanki', 'prioslimon', 'marcelobr07', 'deekshapalll', 'cxxpxx19', 'hqwbu1stq9', 'bilalsani2912', 'chetana.kamalkar', 'sarasheth60', 'venkata.revanth', 'simran.mulik', 'manas.tiwari', 'abhinav.pallayil', 'iq.rodriguez.1989', 'vivek.thakkar', 'soumyawbut8730', 'boonesmith', 'khushi.patni', 'chinmay.walinjkar', 'jaimindesai', 'apoorva.limaye', 'shivang123', 'nushin01', 'devansh.palliyath', 'ajji.pavan', 'hargobind.singh', 'shivamvermaid1', 'kadenanderson1', 'shubham.sawant', 'omkar.shinde', 'ps12345', 'dylan_ds0uza', 'junwin', 'anupriya.dasgupta', 'alexiscanez', 'ramprasad.19mvd7002', 'vduenas', 'aniket.nadkarni', 'megala1997', 'shivamthakur04', 'misschayla12', 'siddharthmohanty812', 'sanskarmbadjatia', 'nicolelphan', 'samay.gada', 'ashish.jingar', 'cpierce14', 'shannon', 'vishal.lohar', 'rohit.desai', 'ranitibdewal', 'anthonyc1', 'eeshaanasodekar', 'maitri.vora', 'vinayak.tripathi', 'anshalpadole30', 'aryaman.gokarn', 'wtakeda', 'lokesh.patil', 'ganesharpan.nookala', 'vraj.b', 'jainhitanshu588', 'aniket.gawade', 'vaibhav.raina', 'ajvillani', 'pranay.tiwari', 'ankit.manani', 'i.mirasifali', 'njenkins', 'elmar.aichberger', 'victorigor', 'jadhavakashb143', 'sanskruti.joshi29']"
4,49,183,8,5,"['nicolelphan', 'wtakeda', 'moghimil', 'tdbuechler', 'ajvillani']",177,"['nookalaarpan12', 'mlreum', 'michaelg1137', 'vishrut240501', 'ishika.raghuwanshi', 'haopolin', 'ayush2801', 'malhar.vairale1812', 'aditichaturvedi', 'sahil.patil', 'keeganchafin', 'musmau82', 'sanskar.laddha', 'mitash0404', 'dhiraj.choudhari', 'tirthpatel', 'pratham.solanki02', 'shahid_ms10', 'klinner', 'surajsarjes', 'divija.shringarpure', 'nurfazrina', 'jaidamani42', 'bilal2912', 'marcelo.rodrigues', 'mjm2164', 'parth.bywar', 'nagrechavarun', 'niranjan.badhe', 'bhavika.vaishnavi', 'sneha15weakey', 'aryandali1412', 'mansi007mtvlsi20', 'antoniopml', 'manan.arora', 'nln85', 'hrishikesh28', 'sneee', 'g1', 'dhananjay23', 'akshada.hadal', 'darshansomani8', 'saikrishnam', 'sandeep.suthar', 'shweta0208', 'aftabrafiq', 'nayana.19mvd7003', 'h1tenbafna', 'anushka.pilena', 'prathamm12', 'omkar.pawar', 'smriti.islur', 'keshav_thosar', 'husain.challawala', 'umang.agarwal', 'aditya.umalkar', 'adrao', 'aryan.dali', 'poseidon_1909', 'gauripethkar', 'kartheekbogi25', 'adnan.mohiddin', 'hevila', 'sayaliayre22', 'rohitrane500', 'brianfaires', 'darshan.tater', 'lohanpeixoto', 'ritik.koul', 'oindrella', 'dbayko', 'aditi.bagwe', 'bstelter', 'truptigopinath', 'kadamyogesh31', 'brianterry', 'sneha.savarkar', 'mcrussell', 'khushi.agrawal', 'nanohubrc', 'avyeshbhatnagar46', 'pushkarsutar999', 'siddhant11', 'swapnil.mandavilli', 'trustme20times', 'jayesh_bane', 'siddhant.kamlaskar', 'giridhar.19mvd7004', 'jxc85295', 'dwx', 'katiyar_ravins', 'pushkar.sutar', 'atharvasonavane', 'niharika1528', 'prerna.arora', 'yugandhara.wadikar', 'sohel.datta', 'crystalv', 'nimratkaur', 'sayak.pramanik', 'p20vl003', 'pulkit.chaudhari', 'anuj.chavan', 'richa.motwani', 'swaraj.salunke', 'prabhat.kumar', 'oanhtran97', 'arwaje.364', 'yuvraj.purohit', 'sudhanshu128', 'aryansolanki', 'prioslimon', 'marcelobr07', 'deekshapalll', 'cxxpxx19', 'hqwbu1stq9', 'bilalsani2912', 'chetana.kamalkar', 'sarasheth60', 'venkata.revanth', 'manas.tiwari', 'abhinav.pallayil', 'iq.rodriguez.1989', 'vivek.thakkar', 'soumyawbut8730', 'boonesmith', 'khushi.patni', 'chinmay.walinjkar', 'jaimindesai', 'shivang123', 'nushin01', 'devansh.palliyath', 'ajji.pavan', 'hargobind.singh', 'shivamvermaid1', 'kadenanderson1', 'shubham.sawant', 'omkar.shinde', 'ps12345', 'dylan_ds0uza', 'junwin', 'anupriya.dasgupta', 'alexiscanez', 'ramprasad.19mvd7002', 'vduenas', 'megala1997', 'shivamthakur04', 'misschayla12', 'siddharthmohanty812', 'sanskarmbadjatia', 'samay.gada', 'ashish.jingar', 'cpierce14', 'shannon', 'vishal.lohar', 'rohit.desai', 'ranitibdewal', 'anthonyc1', 'eeshaanasodekar', 'maitri.vora', 'vinayak.tripathi', 'anshalpadole30', 'aryaman.gokarn', 'lokesh.patil', 'ganesharpan.nookala', 'vraj.b', 'jainhitanshu588', 'aniket.gawade', 'vaibhav.raina', 'pranay.tiwari', 'ankit.manani', 'i.mirasifali', 'njenkins', 'elmar.aichberger', 'victorigor', 'jadhavakashb143', 'sanskruti.joshi29']",3,"['biggie', None, 'mai95']",185,"['nookalaarpan12', 'mlreum', 'michaelg1137', 'vishrut240501', 'ishika.raghuwanshi', 'haopolin', 'ayush2801', 'malhar.vairale1812', 'moghimil', 'aditichaturvedi', 'sahil.patil', 'keeganchafin', 'musmau82', 'sanskar.laddha', 'mitash0404', 'dhiraj.choudhari', 'tirthpatel', 'pratham.solanki02', 'shahid_ms10', 'klinner', 'surajsarjes', 'divija.shringarpure', 'nurfazrina', 'jaidamani42', 'bilal2912', 'marcelo.rodrigues', 'mjm2164', 'parth.bywar', 'nagrechavarun', 'niranjan.badhe', 'bhavika.vaishnavi', 'sneha15weakey', 'aryandali1412', 'mansi007mtvlsi20', 'antoniopml', 'manan.arora', 'nln85', 'hrishikesh28', 'sneee', 'g1', 'dhananjay23', 'akshada.hadal', 'darshansomani8', 'saikrishnam', 'sandeep.suthar', 'shweta0208', 'aftabrafiq', 'nayana.19mvd7003', 'h1tenbafna', 'anushka.pilena', 'prathamm12', 'omkar.pawar', 'smriti.islur', 'keshav_thosar', 'husain.challawala', 'umang.agarwal', 'aditya.umalkar', 'adrao', 'aryan.dali', 'poseidon_1909', 'gauripethkar', 'kartheekbogi25', 'adnan.mohiddin', 'hevila', 'sayaliayre22', None, 'rohitrane500', 'brianfaires', 'tdbuechler', 'darshan.tater', 'lohanpeixoto', 'ritik.koul', 'oindrella', 'dbayko', 'aditi.bagwe', 'bstelter', 'truptigopinath', 'kadamyogesh31', 'brianterry', 'sneha.savarkar', 'mcrussell', 'khushi.agrawal', 'nanohubrc', 'avyeshbhatnagar46', 'pushkarsutar999', 'siddhant11', 'biggie', 'swapnil.mandavilli', 'trustme20times', 'jayesh_bane', 'siddhant.kamlaskar', 'giridhar.19mvd7004', 'jxc85295', 'dwx', 'katiyar_ravins', 'pushkar.sutar', 'atharvasonavane', 'niharika1528', 'prerna.arora', 'yugandhara.wadikar', 'sohel.datta', 'crystalv', 'nimratkaur', 'sayak.pramanik', 'p20vl003', 'pulkit.chaudhari', 'anuj.chavan', 'richa.motwani', 'swaraj.salunke', 'prabhat.kumar', 'oanhtran97', 'arwaje.364', 'yuvraj.purohit', 'sudhanshu128', 'aryansolanki', 'prioslimon', 'marcelobr07', 'deekshapalll', 'cxxpxx19', 'hqwbu1stq9', 'bilalsani2912', 'chetana.kamalkar', 'sarasheth60', 'venkata.revanth', 'manas.tiwari', 'abhinav.pallayil', 'iq.rodriguez.1989', 'vivek.thakkar', 'soumyawbut8730', 'boonesmith', 'khushi.patni', 'chinmay.walinjkar', 'jaimindesai', 'shivang123', 'nushin01', 'devansh.palliyath', 'ajji.pavan', 'hargobind.singh', 'shivamvermaid1', 'kadenanderson1', 'shubham.sawant', 'omkar.shinde', 'ps12345', 'dylan_ds0uza', 'junwin', 'anupriya.dasgupta', 'alexiscanez', 'ramprasad.19mvd7002', 'vduenas', 'megala1997', 'shivamthakur04', 'misschayla12', 'siddharthmohanty812', 'sanskarmbadjatia', 'nicolelphan', 'samay.gada', 'ashish.jingar', 'cpierce14', 'shannon', 'vishal.lohar', 'rohit.desai', 'ranitibdewal', 'anthonyc1', 'eeshaanasodekar', 'maitri.vora', 'vinayak.tripathi', 'anshalpadole30', 'aryaman.gokarn', 'wtakeda', 'lokesh.patil', 'ganesharpan.nookala', 'vraj.b', 'jainhitanshu588', 'aniket.gawade', 'mai95', 'vaibhav.raina', 'ajvillani', 'pranay.tiwari', 'ankit.manani', 'i.mirasifali', 'njenkins', 'elmar.aichberger', 'victorigor', 'jadhavakashb143', 'sanskruti.joshi29']"
5,40,132,172,112,"['chaitanyatamhankar36', 'pas2', 'ankit.ns', 'sachin9', 'vrushali.sule', 'rameshbabu1234', 'amol.kerkar', 'zoheb.mir', 'animesh.prasad', 'sohamshah888', 'advikmaniar', 'bhaskar.a', 'hirenkachhadiya', 'mrunali.khedkar', 'gauravpandey123', 'niharika.somani', 'jaypandya99', 'soham.ms', 'uttamkumar.m', 'r.mungekar', 'p.ambelkar', 'akshay.pathak', 'nitish.r', 'pooja.nambiar', 'aatman.mehta', 'pranav.mistry', 'm.veer', 'fenny.m', 'malhar.k', 'nirav.ls', 'pranali.nc', 'jmd', 'meheru.p', 'ishanali.k', 'devashri.n', 'rushabh.shah8', 'mayuresh.shirke', 'karan.ap', 'patel.prakash', 'yukta.rane', 'param05', 'surajr17', 'aayush.butala', 'rishi.molia', 'vinit.js', 'hardik.hp', 'kaushal2531999', 'karan.ys', 'onkarjoshi', 'pulkeet.g', 'meetudiii', 'paras14', 'pktingare23', 'pratik.lodha.pl', 'pragya.g', 'pritha.roy', 'aman.savla', 'zohebmir006', 'hiralmistry9', 'n.sumra', 'shivani.anajria', 'vipulrkt', 'kartiksrivastava', 'aniket09', 'vedant.modak', 'mihir.khara', 'dhruvik.shah', 'mohil.khona', 'khushboo.darji', 'ashirwad.b', 'yash.dalvi', 'utsav.maisheri', 'tejal.kadu', 'dipansh.m', 'p.hodshil', 'siddharth.vaidya', 'shraddha.bw', 'pranavkumar.t', 'purvi.rane', 'pradnya.koli', 'shubhammore', 'patel.ad', 'rahil.t', 'saloni.kaveri', 'proabdurrasheed', 'ayum.halwai', 'kaushal.g', 'keval23', 'rashi.singhal', 'bharatan.r', 'chaitanya.tambat', 'dhairya.maisheri', 'gmp', 'anamay.m', 'uttamkumarmishra76652', 'harsh.vasani', 'pranav.garg', 'jayd1529', 'nikhil.naredla', 'saptarshi.k', 'gauri.rp', 'iamstark9', 'daamini11', 'saloni_talathi', 'rinkalkeniya', 'c.tamhankar', 'panchal.vp', 'nipunshah', 'suraj.dm', 'tejaswini.shelar', 's.mahetaliya', 'kavya.moolya']",19,"['shantanu.saraf', 'k24406820', 'myers432', 'dhairya.kamdar', 'suvigya1', 'sureshs', 'burak', 'vrushali.padia', 'r.srivastava', 'bhagyeshri.o', 'soham.sheth', 'inderjitsingh', 'khjj940901', 'inderjitsingh87', 'sohini', 'ryanwestley', 'saurabh.bodke', 'pratik.chudiwale', 'mansi.kurhade']",60,"['aryaman1712021', 'sohamk45', 'anubhav.bose', 'sangeetamjoshi', 'mahavirchavda921', '8122vivian', 'sunny.kanojia', 'jaimindesai', 'ankitachavan2708', 'antimhr', 'bhavin14', 'anuragmandke4', 'tarun96', '8275joel', 'siddhant.d', 'aynaiksatam', 'rohan.sanghavi', 'aadesh.u', 'hitesh.vadgama', 'gauri.bane', 'anilthosar', 'saeesh.aher', 'nibha.desai', 'kshemal_gupte', 'aditi.b2409', 'lovleshsingh99', 'meet29', 'swapnalimakdey25', 'amodini8295', 'divya.manikantan', 'aatifa.bi', 'apujara', 'mehuldoshi', 'niketh', 'sumitdupate19', 'kmmahuvarkar', 'rutwik.patel', 'anirudh9911', 'tiwarisuraj5769', 'xavierallem', 'rajveersingh.k', 'arya1998', 'h.bilkhu', '8284yash', 'wrathgod123', 'kanojias75', 'sunlovesrahul', None, 'aynkushadav0', 'sherylcorina', 'rohitrane500', 'pranjal8287', 'manavj.jain', 'pratz98', 'poonam2499', 'anjali.golani', 'arpanbiswas', 'ankit.manani', 'pratik.lodha', 'simran.mulik']",191,"['pas2', 'chaitanyatamhankar36', 'k24406820', 'ankit.ns', 'sachin9', 'mahavirchavda921', '8122vivian', 'vrushali.sule', 'rameshbabu1234', 'amol.kerkar', 'zoheb.mir', 'animesh.prasad', 'siddhant.d', 'sohamshah888', 'bhagyeshri.o', 'rohan.sanghavi', 'advikmaniar', 'bhaskar.a', 'hirenkachhadiya', 'mrunali.khedkar', 'meet29', 'swapnalimakdey25', 'mehuldoshi', 'gauravpandey123', 'niketh', 'tiwarisuraj5769', 'niharika.somani', 'jaypandya99', 'soham.ms', 'uttamkumar.m', 'arya1998', 'h.bilkhu', 'r.mungekar', 'p.ambelkar', 'akshay.pathak', 'nitish.r', 'pooja.nambiar', 'ryanwestley', 'aatman.mehta', 'pranav.mistry', 'm.veer', 'arpanbiswas', 'fenny.m', 'pratik.lodha', 'malhar.k', 'nirav.ls', 'sohamk45', 'pranali.nc', 'sangeetamjoshi', 'jmd', 'meheru.p', 'myers432', 'ishanali.k', 'devashri.n', 'antimhr', 'ankitachavan2708', 'rushabh.shah8', 'mayuresh.shirke', 'karan.ap', 'patel.prakash', 'aynaiksatam', 'aadesh.u', 'yukta.rane', 'param05', 'surajr17', 'aayush.butala', 'hitesh.vadgama', 'vinit.js', 'hardik.hp', 'lovleshsingh99', 'amodini8295', 'kaushal2531999', 'divya.manikantan', 'aatifa.bi', 'karan.ys', 'onkarjoshi', 'pulkeet.g', 'meetudiii', 'kavya.moolya', 'paras14', 'pktingare23', '8284yash', None, 'pratik.lodha.pl', 'pragya.g', 'rohitrane500', 'manavj.jain', 'pritha.roy', 'poonam2499', 'aman.savla', 'zohebmir006', 'shantanu.saraf', 'anubhav.bose', 'hiralmistry9', 'sunny.kanojia', 'n.sumra', 'bhavin14', 'shivani.anajria', 'vipulrkt', 'anuragmandke4', 'burak', 'sureshs', 'kartiksrivastava', 'aniket09', 'vedant.modak', 'mihir.khara', 'dhruvik.shah', 'mohil.khona', 'gauri.bane', 'inderjitsingh', 'khushboo.darji', 'ashirwad.b', 'aditi.b2409', 'apujara', 'yash.dalvi', 'utsav.maisheri', 'tejal.kadu', 'dipansh.m', 'rajveersingh.k', 'wrathgod123', 'kanojias75', 'p.hodshil', 'siddharth.vaidya', 'shraddha.bw', 'sherylcorina', 'pranavkumar.t', 'pranjal8287', 'purvi.rane', 'pradnya.koli', 'shubhammore', 'patel.ad', 'rahil.t', 'saloni.kaveri', 'anjali.golani', 'saurabh.bodke', 'simran.mulik', 'rutwik.patel', 'proabdurrasheed', 'aryaman1712021', 'ayum.halwai', 'kaushal.g', 'keval23', 'rashi.singhal', 'dhairya.kamdar', 'bharatan.r', 'suvigya1', 'chaitanya.tambat', 'dhairya.maisheri', 'gmp', 'jaimindesai', 'anamay.m', 'tarun96', 'vrushali.padia', '8275joel', 'r.srivastava', 'soham.sheth', 'uttamkumarmishra76652', 'anilthosar', 'saeesh.aher', 'nibha.desai', 'kshemal_gupte', 'harsh.vasani', 'pranav.garg', 'jayd1529', 'nikhil.naredla', 'saptarshi.k', 'gauri.rp', 'khjj940901', 'iamstark9', 'sumitdupate19', 'kmmahuvarkar', 'daamini11', 'saloni_talathi', 'inderjitsingh87', 'rinkalkeniya', 'c.tamhankar', 'sohini', 'anirudh9911', 'panchal.vp', 'xavierallem', 'sunlovesrahul', 'nipunshah', 'suraj.dm', 'aynkushadav0', 'tejaswini.shelar', 'pratz98', 'pratik.chudiwale', 'mansi.kurhade', 'ankit.manani', 's.mahetaliya', 'rishi.molia']"
5,50,132,105,2,"['rinkalkeniya', 'niharika.somani']",129,"['chaitanyatamhankar36', 'pas2', 'k24406820', 'ankit.ns', 'sachin9', 'vrushali.sule', 'rameshbabu1234', 'amol.kerkar', 'zoheb.mir', 'animesh.prasad', 'sohamshah888', 'bhagyeshri.o', 'advikmaniar', 'bhaskar.a', 'hirenkachhadiya', 'mrunali.khedkar', 'gauravpandey123', 'jaypandya99', 'uttamkumar.m', 'soham.ms', 'r.mungekar', 'p.ambelkar', 'akshay.pathak', 'nitish.r', 'pooja.nambiar', 'ryanwestley', 'aatman.mehta', 'pranav.mistry', 'm.veer', 'fenny.m', 'malhar.k', 'nirav.ls', 'pranali.nc', 'jmd', 'meheru.p', 'myers432', 'ishanali.k', 'devashri.n', 'rushabh.shah8', 'mayuresh.shirke', 'karan.ap', 'patel.prakash', 'yukta.rane', 'param05', 'surajr17', 'aayush.butala', 'rishi.molia', 'vinit.js', 'hardik.hp', 'kaushal2531999', 'karan.ys', 'onkarjoshi', 'pulkeet.g', 'meetudiii', 'paras14', 'pktingare23', 'pratik.lodha.pl', 'pragya.g', 'pritha.roy', 'aman.savla', 'zohebmir006', 'shantanu.saraf', 'hiralmistry9', 'n.sumra', 'shivani.anajria', 'vipulrkt', 'burak', 'sureshs', 'kartiksrivastava', 'aniket09', 'vedant.modak', 'mihir.khara', 'dhruvik.shah', 'mohil.khona', 'inderjitsingh', 'khushboo.darji', 'ashirwad.b', 'yash.dalvi', 'utsav.maisheri', 'tejal.kadu', 'dipansh.m', 'p.hodshil', 'siddharth.vaidya', 'shraddha.bw', 'pranavkumar.t', 'purvi.rane', 'pradnya.koli', 'shubhammore', 'patel.ad', 'rahil.t', 'saloni.kaveri', 'saurabh.bodke', 'proabdurrasheed', 'ayum.halwai', 'kaushal.g', 'keval23', 'rashi.singhal', 'dhairya.kamdar', 'bharatan.r', 'suvigya1', 'chaitanya.tambat', 'dhairya.maisheri', 'gmp', 'anamay.m', 'vrushali.padia', 'r.srivastava', 'soham.sheth', 'uttamkumarmishra76652', 'harsh.vasani', 'pranav.garg', 'jayd1529', 'nikhil.naredla', 'saptarshi.k', 'gauri.rp', 'khjj940901', 'iamstark9', 'daamini11', 'saloni_talathi', 'inderjitsingh87', 'c.tamhankar', 'sohini', 'panchal.vp', 'nipunshah', 'suraj.dm', 'tejaswini.shelar', 'pratik.chudiwale', 'mansi.kurhade', 's.mahetaliya', 'kavya.moolya']",103,"['nookalaarpan12', '8122vivian', 'ayush2801', 'aditichaturvedi', 'sanskar.laddha', 'mitash0404', 'dhiraj.choudhari', 'tirthpatel', 'divija.shringarpure', 'jaidamani42', 'bilal2912', 'rathod_spce', 'tiwarisuraj5769', 'h.bilkhu', 'manan.arora', 'arpanbiswas', 'sneee', 'sohamk45', 'dhananjay23', 'akshada.hadal', 'sangeetamjoshi', 'saikrishnam', 'shweta0208', 'prathamm12', 'anushka.pilena', 'omkar.pawar', 'husain.challawala', 'aditya.umalkar', 'adrao', 'lovleshsingh99', 'aryan.dali', 'divya.manikantan', 'adnan.mohiddin', 'sayaliayre22', None, 'rohitrane500', 'vedant', 'arohishinde2302', 'darshan.tater', 'oindrella', 'aditya.patwardhan', 'truptigopinath', 'sneha.savarkar', 'anuragmandke4', 'pushkarsutar999', 'siddhant11', 'swapnil.mandavilli', 'trustme20times', 'jayesh_bane', 'verma07anand', 'pushkar.sutar', 'atharvasonavane', 'niharika1528', 'prerna.arora', 'sohel.datta', 'nimratkaur', 'anuj.chavan', 'richa.motwani', 'pulkit.chaudhari', 'yuvraj.purohit', 'sudhanshu128', 'aryansolanki', 'deekshapalll', 'cxxpxx19', 'bilalsani2912', 'anjali.golani', 'sarasheth60', 'mayur07', 'manas.tiwari', 'abhinav.pallayil', 'aryaman1712021', 'vivek.thakkar', 'khushi.patni', 'chinmay.walinjkar', 'jaimindesai', 'apoorva.limaye', 'hargobind.singh', 'tarun96', 'shubham.sawant', 'omkar.shinde', 'dylan_ds0uza', 'anupriya.dasgupta', 'nibha.desai', 'kshemal_gupte', 'saeesh.aher', 'aniket.nadkarni', 'shivamthakur04', 'siddharthmohanty812', 'sumitdupate19', 'anirudh9911', 'vishal.lohar', 'varun.kamath', 'sunlovesrahul', 'keval09', 'eeshaanasodekar', 'maitri.vora', 'lokesh.patil', 'vraj.b', 'ganesharpan.nookala', 'jainhitanshu588', 'aniket.gawade', 'pranay.tiwari', 'ankit.manani']",234,"['nookalaarpan12', 'pas2', 'chaitanyatamhankar36', 'k24406820', 'ankit.ns', 'sachin9', '8122vivian', 'vrushali.sule', 'rameshbabu1234', 'ayush2801', 'amol.kerkar', 'zoheb.mir', 'aditichaturvedi', 'animesh.prasad', 'sohamshah888', 'bhagyeshri.o', 'sanskar.laddha', 'mitash0404', 'advikmaniar', 'bhaskar.a', 'dhiraj.choudhari', 'tirthpatel', 'hirenkachhadiya', 'divija.shringarpure', 'mrunali.khedkar', 'jaidamani42', 'bilal2912', 'rathod_spce', 'gauravpandey123', 'tiwarisuraj5769', 'niharika.somani', 'jaypandya99', 'soham.ms', 'uttamkumar.m', 'h.bilkhu', 'r.mungekar', 'p.ambelkar', 'akshay.pathak', 'nitish.r', 'pooja.nambiar', 'manan.arora', 'ryanwestley', 'aatman.mehta', 'pranav.mistry', 'm.veer', 'arpanbiswas', 'fenny.m', 'malhar.k', 'sneee', 'nirav.ls', 'sohamk45', 'pranali.nc', 'dhananjay23', 'jmd', 'akshada.hadal', 'sangeetamjoshi', 'saikrishnam', 'meheru.p', 'myers432', 'ishanali.k', 'devashri.n', 'shweta0208', 'rushabh.shah8', 'mayuresh.shirke', 'prathamm12', 'anushka.pilena', 'karan.ap', 'patel.prakash', 'omkar.pawar', 'yukta.rane', 'param05', 'surajr17', 'aayush.butala', 'husain.challawala', 'aditya.umalkar', 'vinit.js', 'adrao', 'hardik.hp', 'lovleshsingh99', 'aryan.dali', 'kaushal2531999', 'divya.manikantan', 'karan.ys', 'onkarjoshi', 'pulkeet.g', 'meetudiii', 'kavya.moolya', 'paras14', 'pktingare23', 'adnan.mohiddin', 'sayaliayre22', None, 'pratik.lodha.pl', 'pragya.g', 'rohitrane500', 'vedant', 'pritha.roy', 'arohishinde2302', 'darshan.tater', 'oindrella', 'aman.savla', 'aditya.patwardhan', 'zohebmir006', 'shantanu.saraf', 'truptigopinath', 'hiralmistry9', 'n.sumra', 'sneha.savarkar', 'shivani.anajria', 'vipulrkt', 'anuragmandke4', 'burak', 'sureshs', 'kartiksrivastava', 'pushkarsutar999', 'siddhant11', 'swapnil.mandavilli', 'aniket09', 'trustme20times', 'vedant.modak', 'jayesh_bane', 'verma07anand', 'mihir.khara', 'pushkar.sutar', 'dhruvik.shah', 'mohil.khona', 'atharvasonavane', 'niharika1528', 'prerna.arora', 'inderjitsingh', 'khushboo.darji', 'sohel.datta', 'ashirwad.b', 'nimratkaur', 'anuj.chavan', 'richa.motwani', 'pulkit.chaudhari', 'yash.dalvi', 'utsav.maisheri', 'tejal.kadu', 'dipansh.m', 'yuvraj.purohit', 'sudhanshu128', 'aryansolanki', 'p.hodshil', 'siddharth.vaidya', 'deekshapalll', 'shraddha.bw', 'pranavkumar.t', 'purvi.rane', 'pradnya.koli', 'cxxpxx19', 'shubhammore', 'patel.ad', 'bilalsani2912', 'rahil.t', 'saloni.kaveri', 'anjali.golani', 'saurabh.bodke', 'sarasheth60', 'mayur07', 'manas.tiwari', 'proabdurrasheed', 'abhinav.pallayil', 'aryaman1712021', 'vivek.thakkar', 'ayum.halwai', 'kaushal.g', 'khushi.patni', 'chinmay.walinjkar', 'keval23', 'rashi.singhal', 'dhairya.kamdar', 'bharatan.r', 'suvigya1', 'chaitanya.tambat', 'dhairya.maisheri', 'gmp', 'jaimindesai', 'apoorva.limaye', 'anamay.m', 'hargobind.singh', 'tarun96', 'vrushali.padia', 'r.srivastava', 'shubham.sawant', 'omkar.shinde', 'dylan_ds0uza', 'soham.sheth', 'uttamkumarmishra76652', 'anupriya.dasgupta', 'nibha.desai', 'kshemal_gupte', 'saeesh.aher', 'aniket.nadkarni', 'harsh.vasani', 'pranav.garg', 'jayd1529', 'shivamthakur04', 'nikhil.naredla', 'siddharthmohanty812', 'saptarshi.k', 'gauri.rp', 'khjj940901', 'iamstark9', 'sumitdupate19', 'daamini11', 'saloni_talathi', 'inderjitsingh87', 'rinkalkeniya', 'c.tamhankar', 'sohini', 'anirudh9911', 'panchal.vp', 'vishal.lohar', 'varun.kamath', 'sunlovesrahul', 'keval09', 'eeshaanasodekar', 'maitri.vora', 'nipunshah', 'suraj.dm', 'tejaswini.shelar', 'lokesh.patil', 'vraj.b', 'ganesharpan.nookala', 'jainhitanshu588', 'aniket.gawade', 'pratik.chudiwale', 'pranay.tiwari', 'mansi.kurhade', 'ankit.manani', 's.mahetaliya', 'rishi.molia']"
5,164,132,69,60,"['nirav.ls', 'ayum.halwai', 'kaushal.g', 'jmd', 'sachin9', 'rashi.singhal', 'meheru.p', 'bharatan.r', 'ishanali.k', 'gmp', 'dhairya.maisheri', 'devashri.n', 'shivani.anajria', 'vipulrkt', 'amol.kerkar', 'patel.prakash', 'vedant.modak', 'yukta.rane', 'mihir.khara', 'bhaskar.a', 'dhruvik.shah', 'mohil.khona', 'advikmaniar', 'aayush.butala', 'surajr17', 'uttamkumarmishra76652', 'khushboo.darji', 'mrunali.khedkar', 'ashirwad.b', 'hardik.hp', 'pranav.garg', 'kaushal2531999', 'saptarshi.k', 'utsav.maisheri', 'tejal.kadu', 'karan.ys', 'gauravpandey123', 'dipansh.m', 'onkarjoshi', 'pulkeet.g', 'c.tamhankar', 'jaypandya99', 'soham.ms', 'p.hodshil', 'siddharth.vaidya', 'p.ambelkar', 'shraddha.bw', 'r.mungekar', 'suraj.dm', 'akshay.pathak', 'purvi.rane', 'pradnya.koli', 'nitish.r', 'shubhammore', 'patel.ad', 'pooja.nambiar', 'pranav.mistry', 's.mahetaliya', 'kavya.moolya', 'proabdurrasheed']",71,"['zohebmir006', 'chaitanyatamhankar36', 'pas2', 'shantanu.saraf', 'k24406820', 'ankit.ns', 'pranali.nc', 'keval23', 'hiralmistry9', 'myers432', 'dhairya.kamdar', 'vrushali.sule', 'suvigya1', 'n.sumra', 'chaitanya.tambat', 'rameshbabu1234', 'rushabh.shah8', 'anamay.m', 'burak', 'sureshs', 'vrushali.padia', 'zoheb.mir', 'mayuresh.shirke', 'kartiksrivastava', 'r.srivastava', 'karan.ap', 'animesh.prasad', 'aniket09', 'sohamshah888', 'bhagyeshri.o', 'param05', 'soham.sheth', 'inderjitsingh', 'vinit.js', 'hirenkachhadiya', 'harsh.vasani', 'jayd1529', 'nikhil.naredla', 'yash.dalvi', 'gauri.rp', 'khjj940901', 'iamstark9', 'daamini11', 'meetudiii', 'saloni_talathi', 'inderjitsingh87', 'rinkalkeniya', 'niharika.somani', 'uttamkumar.m', 'paras14', 'pktingare23', 'sohini', 'panchal.vp', 'nipunshah', 'pratik.lodha.pl', 'pragya.g', 'tejaswini.shelar', 'pranavkumar.t', 'pritha.roy', 'rahil.t', 'ryanwestley', 'aatman.mehta', 'm.veer', 'saloni.kaveri', 'saurabh.bodke', 'pratik.chudiwale', 'mansi.kurhade', 'fenny.m', 'malhar.k', 'aman.savla', 'rishi.molia']",9,"['apujara', 'anubhav.bose', 'siddhant.d', 'aynaiksatam', 'kmmahuvarkar', 'rohan.sanghavi', 'anilthosar', None, 'rutwik.patel']",140,"['pas2', 'chaitanyatamhankar36', 'k24406820', 'ankit.ns', 'sachin9', 'vrushali.sule', 'rameshbabu1234', 'amol.kerkar', 'zoheb.mir', 'animesh.prasad', 'siddhant.d', 'sohamshah888', 'bhagyeshri.o', 'rohan.sanghavi', 'advikmaniar', 'bhaskar.a', 'hirenkachhadiya', 'mrunali.khedkar', 'gauravpandey123', 'niharika.somani', 'jaypandya99', 'soham.ms', 'uttamkumar.m', 'r.mungekar', 'p.ambelkar', 'akshay.pathak', 'nitish.r', 'pooja.nambiar', 'ryanwestley', 'aatman.mehta', 'pranav.mistry', 'm.veer', 'fenny.m', 'malhar.k', 'nirav.ls', 'pranali.nc', 'jmd', 'meheru.p', 'myers432', 'ishanali.k', 'devashri.n', 'rushabh.shah8', 'mayuresh.shirke', 'karan.ap', 'patel.prakash', 'aynaiksatam', 'yukta.rane', 'param05', 'surajr17', 'aayush.butala', 'vinit.js', 'hardik.hp', 'kaushal2531999', 'karan.ys', 'onkarjoshi', 'pulkeet.g', 'meetudiii', 'kavya.moolya', 'paras14', 'pktingare23', None, 'pratik.lodha.pl', 'pragya.g', 'pritha.roy', 'aman.savla', 'zohebmir006', 'shantanu.saraf', 'anubhav.bose', 'hiralmistry9', 'n.sumra', 'shivani.anajria', 'vipulrkt', 'burak', 'sureshs', 'kartiksrivastava', 'aniket09', 'vedant.modak', 'mihir.khara', 'dhruvik.shah', 'mohil.khona', 'inderjitsingh', 'khushboo.darji', 'ashirwad.b', 'apujara', 'yash.dalvi', 'utsav.maisheri', 'tejal.kadu', 'dipansh.m', 'p.hodshil', 'siddharth.vaidya', 'shraddha.bw', 'pranavkumar.t', 'purvi.rane', 'pradnya.koli', 'shubhammore', 'patel.ad', 'rahil.t', 'saloni.kaveri', 'saurabh.bodke', 'rutwik.patel', 'proabdurrasheed', 'ayum.halwai', 'kaushal.g', 'keval23', 'rashi.singhal', 'dhairya.kamdar', 'bharatan.r', 'suvigya1', 'chaitanya.tambat', 'dhairya.maisheri', 'gmp', 'anamay.m', 'vrushali.padia', 'r.srivastava', 'soham.sheth', 'uttamkumarmishra76652', 'anilthosar', 'harsh.vasani', 'pranav.garg', 'jayd1529', 'nikhil.naredla', 'saptarshi.k', 'gauri.rp', 'khjj940901', 'iamstark9', 'kmmahuvarkar', 'daamini11', 'saloni_talathi', 'inderjitsingh87', 'rinkalkeniya', 'c.tamhankar', 'sohini', 'panchal.vp', 'nipunshah', 'suraj.dm', 'tejaswini.shelar', 'pratik.chudiwale', 'mansi.kurhade', 's.mahetaliya', 'rishi.molia']"
5,54,132,26,1,['ryanwestley'],130,"['pas2', 'chaitanyatamhankar36', 'k24406820', 'ankit.ns', 'sachin9', 'vrushali.sule', 'rameshbabu1234', 'amol.kerkar', 'zoheb.mir', 'animesh.prasad', 'sohamshah888', 'bhagyeshri.o', 'advikmaniar', 'bhaskar.a', 'hirenkachhadiya', 'mrunali.khedkar', 'gauravpandey123', 'niharika.somani', 'jaypandya99', 'soham.ms', 'uttamkumar.m', 'r.mungekar', 'p.ambelkar', 'akshay.pathak', 'nitish.r', 'pooja.nambiar', 'aatman.mehta', 'pranav.mistry', 'm.veer', 'fenny.m', 'malhar.k', 'nirav.ls', 'pranali.nc', 'jmd', 'meheru.p', 'myers432', 'ishanali.k', 'devashri.n', 'rushabh.shah8', 'mayuresh.shirke', 'karan.ap', 'patel.prakash', 'yukta.rane', 'param05', 'surajr17', 'aayush.butala', 'vinit.js', 'hardik.hp', 'kaushal2531999', 'karan.ys', 'onkarjoshi', 'pulkeet.g', 'meetudiii', 'kavya.moolya', 'paras14', 'pktingare23', 'pratik.lodha.pl', 'pragya.g', 'pritha.roy', 'aman.savla', 'zohebmir006', 'shantanu.saraf', 'hiralmistry9', 'n.sumra', 'shivani.anajria', 'vipulrkt', 'burak', 'sureshs', 'kartiksrivastava', 'aniket09', 'vedant.modak', 'mihir.khara', 'dhruvik.shah', 'mohil.khona', 'inderjitsingh', 'khushboo.darji', 'ashirwad.b', 'yash.dalvi', 'utsav.maisheri', 'tejal.kadu', 'dipansh.m', 'p.hodshil', 'siddharth.vaidya', 'shraddha.bw', 'pranavkumar.t', 'purvi.rane', 'pradnya.koli', 'shubhammore', 'patel.ad', 'rahil.t', 'saloni.kaveri', 'saurabh.bodke', 'proabdurrasheed', 'ayum.halwai', 'kaushal.g', 'keval23', 'rashi.singhal', 'dhairya.kamdar', 'bharatan.r', 'suvigya1', 'chaitanya.tambat', 'dhairya.maisheri', 'gmp', 'anamay.m', 'vrushali.padia', 'r.srivastava', 'soham.sheth', 'uttamkumarmishra76652', 'harsh.vasani', 'pranav.garg', 'jayd1529', 'nikhil.naredla', 'saptarshi.k', 'gauri.rp', 'khjj940901', 'iamstark9', 'daamini11', 'saloni_talathi', 'inderjitsingh87', 'rinkalkeniya', 'c.tamhankar', 'sohini', 'panchal.vp', 'nipunshah', 'suraj.dm', 'tejaswini.shelar', 'pratik.chudiwale', 'mansi.kurhade', 's.mahetaliya', 'rishi.molia']",25,"['michaelg1137', 'boonesmith', 'bstelter', 'mcrussell', 'nushin01', 'kadenanderson1', 'biggie', 'dwx', 'junwin', 'alexiscanez', 'vduenas', 'klinner', 'nurfazrina', 'nicolelphan', 'mjm2164', 'cpierce14', 'oanhtran97', 'anthonyc1', 'prioslimon', None, 'hqwbu1stq9', 'mai95', 'tdbuechler', 'njenkins', 'dbayko']",156,"['pas2', 'chaitanyatamhankar36', 'michaelg1137', 'k24406820', 'ankit.ns', 'sachin9', 'vrushali.sule', 'rameshbabu1234', 'amol.kerkar', 'zoheb.mir', 'animesh.prasad', 'sohamshah888', 'bhagyeshri.o', 'advikmaniar', 'bhaskar.a', 'hirenkachhadiya', 'klinner', 'mrunali.khedkar', 'nurfazrina', 'mjm2164', 'gauravpandey123', 'niharika.somani', 'jaypandya99', 'soham.ms', 'uttamkumar.m', 'r.mungekar', 'p.ambelkar', 'akshay.pathak', 'nitish.r', 'pooja.nambiar', 'ryanwestley', 'aatman.mehta', 'pranav.mistry', 'm.veer', 'fenny.m', 'malhar.k', 'nirav.ls', 'pranali.nc', 'jmd', 'meheru.p', 'myers432', 'ishanali.k', 'devashri.n', 'rushabh.shah8', 'mayuresh.shirke', 'karan.ap', 'patel.prakash', 'yukta.rane', 'param05', 'surajr17', 'aayush.butala', 'vinit.js', 'hardik.hp', 'kaushal2531999', 'karan.ys', 'onkarjoshi', 'pulkeet.g', 'meetudiii', 'kavya.moolya', 'paras14', 'pktingare23', None, 'pratik.lodha.pl', 'pragya.g', 'pritha.roy', 'tdbuechler', 'aman.savla', 'dbayko', 'zohebmir006', 'shantanu.saraf', 'bstelter', 'hiralmistry9', 'n.sumra', 'mcrussell', 'shivani.anajria', 'vipulrkt', 'burak', 'sureshs', 'kartiksrivastava', 'biggie', 'aniket09', 'vedant.modak', 'mihir.khara', 'dwx', 'dhruvik.shah', 'mohil.khona', 'inderjitsingh', 'khushboo.darji', 'ashirwad.b', 'yash.dalvi', 'utsav.maisheri', 'tejal.kadu', 'dipansh.m', 'oanhtran97', 'prioslimon', 'p.hodshil', 'siddharth.vaidya', 'shraddha.bw', 'pranavkumar.t', 'purvi.rane', 'pradnya.koli', 'shubhammore', 'patel.ad', 'hqwbu1stq9', 'rahil.t', 'saloni.kaveri', 'saurabh.bodke', 'proabdurrasheed', 'boonesmith', 'ayum.halwai', 'kaushal.g', 'keval23', 'rashi.singhal', 'dhairya.kamdar', 'bharatan.r', 'suvigya1', 'chaitanya.tambat', 'dhairya.maisheri', 'gmp', 'nushin01', 'anamay.m', 'vrushali.padia', 'kadenanderson1', 'r.srivastava', 'junwin', 'soham.sheth', 'uttamkumarmishra76652', 'alexiscanez', 'vduenas', 'harsh.vasani', 'pranav.garg', 'jayd1529', 'nikhil.naredla', 'saptarshi.k', 'gauri.rp', 'khjj940901', 'nicolelphan', 'cpierce14', 'iamstark9', 'daamini11', 'saloni_talathi', 'inderjitsingh87', 'rinkalkeniya', 'c.tamhankar', 'sohini', 'panchal.vp', 'anthonyc1', 'nipunshah', 'suraj.dm', 'tejaswini.shelar', 'mai95', 'pratik.chudiwale', 'mansi.kurhade', 'njenkins', 's.mahetaliya', 'rishi.molia']"
5,165,132,26,15,"['gauri.rp', 'sachin9', 'vedant.modak', 'hiralmistry9', 'yukta.rane', 'rinkalkeniya', 'niharika.somani', 'paras14', 'pranav.garg', 'm.veer', 'malhar.k', 'hirenkachhadiya', 'pratik.lodha.pl', 'harsh.vasani', 'jayd1529']",116,"['pas2', 'chaitanyatamhankar36', 'k24406820', 'ankit.ns', 'vrushali.sule', 'rameshbabu1234', 'amol.kerkar', 'zoheb.mir', 'animesh.prasad', 'sohamshah888', 'bhagyeshri.o', 'advikmaniar', 'bhaskar.a', 'mrunali.khedkar', 'gauravpandey123', 'jaypandya99', 'soham.ms', 'uttamkumar.m', 'r.mungekar', 'p.ambelkar', 'akshay.pathak', 'nitish.r', 'pooja.nambiar', 'ryanwestley', 'aatman.mehta', 'pranav.mistry', 'fenny.m', 'nirav.ls', 'pranali.nc', 'jmd', 'meheru.p', 'myers432', 'ishanali.k', 'devashri.n', 'rushabh.shah8', 'mayuresh.shirke', 'karan.ap', 'patel.prakash', 'param05', 'surajr17', 'aayush.butala', 'vinit.js', 'hardik.hp', 'kaushal2531999', 'karan.ys', 'onkarjoshi', 'pulkeet.g', 'meetudiii', 'kavya.moolya', 'pktingare23', 'pragya.g', 'pritha.roy', 'aman.savla', 'zohebmir006', 'shantanu.saraf', 'n.sumra', 'shivani.anajria', 'vipulrkt', 'burak', 'sureshs', 'kartiksrivastava', 'aniket09', 'mihir.khara', 'dhruvik.shah', 'mohil.khona', 'inderjitsingh', 'khushboo.darji', 'ashirwad.b', 'yash.dalvi', 'utsav.maisheri', 'tejal.kadu', 'dipansh.m', 'p.hodshil', 'siddharth.vaidya', 'shraddha.bw', 'pranavkumar.t', 'purvi.rane', 'pradnya.koli', 'shubhammore', 'patel.ad', 'rahil.t', 'saloni.kaveri', 'saurabh.bodke', 'proabdurrasheed', 'ayum.halwai', 'kaushal.g', 'keval23', 'rashi.singhal', 'dhairya.kamdar', 'bharatan.r', 'suvigya1', 'chaitanya.tambat', 'dhairya.maisheri', 'gmp', 'anamay.m', 'vrushali.padia', 'r.srivastava', 'soham.sheth', 'uttamkumarmishra76652', 'nikhil.naredla', 'saptarshi.k', 'khjj940901', 'iamstark9', 'daamini11', 'saloni_talathi', 'inderjitsingh87', 'c.tamhankar', 'sohini', 'panchal.vp', 'nipunshah', 'suraj.dm', 'tejaswini.shelar', 'pratik.chudiwale', 'mansi.kurhade', 's.mahetaliya', 'rishi.molia']",11,"['aryaman1712021', 'divya.manikantan', 'mehuldoshi', 'anirudh9911', 'anjali.golani', 'h.bilkhu', 'gauri.bane', 'keval09', 'mayur07', 'saeesh.aher', None]",142,"['pas2', 'chaitanyatamhankar36', 'k24406820', 'ankit.ns', 'sachin9', 'vrushali.sule', 'rameshbabu1234', 'amol.kerkar', 'zoheb.mir', 'animesh.prasad', 'sohamshah888', 'bhagyeshri.o', 'advikmaniar', 'bhaskar.a', 'hirenkachhadiya', 'mrunali.khedkar', 'mehuldoshi', 'gauravpandey123', 'niharika.somani', 'jaypandya99', 'soham.ms', 'uttamkumar.m', 'h.bilkhu', 'r.mungekar', 'p.ambelkar', 'akshay.pathak', 'nitish.r', 'pooja.nambiar', 'ryanwestley', 'aatman.mehta', 'pranav.mistry', 'm.veer', 'fenny.m', 'malhar.k', 'nirav.ls', 'pranali.nc', 'jmd', 'meheru.p', 'myers432', 'ishanali.k', 'devashri.n', 'rushabh.shah8', 'mayuresh.shirke', 'karan.ap', 'patel.prakash', 'yukta.rane', 'param05', 'surajr17', 'aayush.butala', 'vinit.js', 'hardik.hp', 'kaushal2531999', 'divya.manikantan', 'karan.ys', 'onkarjoshi', 'pulkeet.g', 'meetudiii', 'kavya.moolya', 'paras14', 'pktingare23', None, 'pratik.lodha.pl', 'pragya.g', 'pritha.roy', 'aman.savla', 'zohebmir006', 'shantanu.saraf', 'hiralmistry9', 'n.sumra', 'shivani.anajria', 'vipulrkt', 'burak', 'sureshs', 'kartiksrivastava', 'aniket09', 'vedant.modak', 'mihir.khara', 'dhruvik.shah', 'mohil.khona', 'gauri.bane', 'inderjitsingh', 'khushboo.darji', 'ashirwad.b', 'yash.dalvi', 'utsav.maisheri', 'tejal.kadu', 'dipansh.m', 'p.hodshil', 'siddharth.vaidya', 'shraddha.bw', 'pranavkumar.t', 'purvi.rane', 'pradnya.koli', 'shubhammore', 'patel.ad', 'rahil.t', 'saloni.kaveri', 'anjali.golani', 'saurabh.bodke', 'mayur07', 'proabdurrasheed', 'aryaman1712021', 'ayum.halwai', 'kaushal.g', 'keval23', 'rashi.singhal', 'dhairya.kamdar', 'bharatan.r', 'suvigya1', 'chaitanya.tambat', 'dhairya.maisheri', 'gmp', 'anamay.m', 'vrushali.padia', 'r.srivastava', 'soham.sheth', 'uttamkumarmishra76652', 'saeesh.aher', 'harsh.vasani', 'pranav.garg', 'jayd1529', 'nikhil.naredla', 'saptarshi.k', 'gauri.rp', 'khjj940901', 'iamstark9', 'daamini11', 'saloni_talathi', 'inderjitsingh87', 'rinkalkeniya', 'c.tamhankar', 'sohini', 'anirudh9911', 'panchal.vp', 'keval09', 'nipunshah', 'suraj.dm', 'tejaswini.shelar', 'pratik.chudiwale', 'mansi.kurhade', 's.mahetaliya', 'rishi.molia']"
5,41,132,20,17,"['mayuresh.shirke', 'pas2', 'nikhil.naredla', 'shantanu.saraf', 'r.srivastava', 'ankit.ns', 'pranali.nc', 'patel.prakash', 'gauri.rp', 'tejal.kadu', 'yukta.rane', 'vrushali.sule', 'siddharth.vaidya', 'panchal.vp', 'inderjitsingh', 'rushabh.shah8', 'suraj.dm']",114,"['chaitanyatamhankar36', 'k24406820', 'sachin9', 'rameshbabu1234', 'amol.kerkar', 'zoheb.mir', 'animesh.prasad', 'sohamshah888', 'bhagyeshri.o', 'advikmaniar', 'bhaskar.a', 'hirenkachhadiya', 'mrunali.khedkar', 'gauravpandey123', 'niharika.somani', 'jaypandya99', 'soham.ms', 'uttamkumar.m', 'r.mungekar', 'p.ambelkar', 'akshay.pathak', 'nitish.r', 'pooja.nambiar', 'ryanwestley', 'aatman.mehta', 'pranav.mistry', 'm.veer', 'fenny.m', 'malhar.k', 'nirav.ls', 'jmd', 'meheru.p', 'myers432', 'ishanali.k', 'devashri.n', 'karan.ap', 'param05', 'surajr17', 'aayush.butala', 'vinit.js', 'hardik.hp', 'kaushal2531999', 'karan.ys', 'onkarjoshi', 'pulkeet.g', 'meetudiii', 'kavya.moolya', 'paras14', 'pktingare23', 'pratik.lodha.pl', 'pragya.g', 'pritha.roy', 'aman.savla', 'zohebmir006', 'hiralmistry9', 'n.sumra', 'shivani.anajria', 'vipulrkt', 'burak', 'sureshs', 'kartiksrivastava', 'aniket09', 'vedant.modak', 'mihir.khara', 'dhruvik.shah', 'mohil.khona', 'khushboo.darji', 'ashirwad.b', 'yash.dalvi', 'utsav.maisheri', 'dipansh.m', 'p.hodshil', 'shraddha.bw', 'pranavkumar.t', 'purvi.rane', 'pradnya.koli', 'shubhammore', 'patel.ad', 'rahil.t', 'saloni.kaveri', 'saurabh.bodke', 'proabdurrasheed', 'ayum.halwai', 'kaushal.g', 'keval23', 'rashi.singhal', 'dhairya.kamdar', 'bharatan.r', 'suvigya1', 'chaitanya.tambat', 'dhairya.maisheri', 'gmp', 'anamay.m', 'vrushali.padia', 'soham.sheth', 'uttamkumarmishra76652', 'harsh.vasani', 'pranav.garg', 'jayd1529', 'saptarshi.k', 'khjj940901', 'iamstark9', 'daamini11', 'saloni_talathi', 'inderjitsingh87', 'rinkalkeniya', 'c.tamhankar', 'sohini', 'nipunshah', 'tejaswini.shelar', 'pratik.chudiwale', 'mansi.kurhade', 's.mahetaliya', 'rishi.molia']",3,"['siddhant.d', None, 'poonam2499']",134,"['pas2', 'chaitanyatamhankar36', 'k24406820', 'ankit.ns', 'sachin9', 'vrushali.sule', 'rameshbabu1234', 'amol.kerkar', 'zoheb.mir', 'animesh.prasad', 'siddhant.d', 'sohamshah888', 'bhagyeshri.o', 'advikmaniar', 'bhaskar.a', 'hirenkachhadiya', 'mrunali.khedkar', 'gauravpandey123', 'niharika.somani', 'jaypandya99', 'soham.ms', 'uttamkumar.m', 'r.mungekar', 'p.ambelkar', 'akshay.pathak', 'nitish.r', 'pooja.nambiar', 'ryanwestley', 'aatman.mehta', 'pranav.mistry', 'm.veer', 'fenny.m', 'malhar.k', 'nirav.ls', 'pranali.nc', 'jmd', 'meheru.p', 'myers432', 'ishanali.k', 'devashri.n', 'rushabh.shah8', 'mayuresh.shirke', 'karan.ap', 'patel.prakash', 'yukta.rane', 'param05', 'surajr17', 'aayush.butala', 'vinit.js', 'hardik.hp', 'kaushal2531999', 'karan.ys', 'onkarjoshi', 'pulkeet.g', 'meetudiii', 'kavya.moolya', 'paras14', 'pktingare23', None, 'pratik.lodha.pl', 'pragya.g', 'pritha.roy', 'poonam2499', 'aman.savla', 'zohebmir006', 'shantanu.saraf', 'hiralmistry9', 'n.sumra', 'shivani.anajria', 'vipulrkt', 'burak', 'sureshs', 'kartiksrivastava', 'aniket09', 'vedant.modak', 'mihir.khara', 'dhruvik.shah', 'mohil.khona', 'inderjitsingh', 'khushboo.darji', 'ashirwad.b', 'yash.dalvi', 'utsav.maisheri', 'tejal.kadu', 'dipansh.m', 'p.hodshil', 'siddharth.vaidya', 'shraddha.bw', 'pranavkumar.t', 'purvi.rane', 'pradnya.koli', 'shubhammore', 'patel.ad', 'rahil.t', 'saloni.kaveri', 'saurabh.bodke', 'proabdurrasheed', 'ayum.halwai', 'kaushal.g', 'keval23', 'rashi.singhal', 'dhairya.kamdar', 'bharatan.r', 'suvigya1', 'chaitanya.tambat', 'dhairya.maisheri', 'gmp', 'anamay.m', 'vrushali.padia', 'r.srivastava', 'soham.sheth', 'uttamkumarmishra76652', 'harsh.vasani', 'pranav.garg', 'jayd1529', 'nikhil.naredla', 'saptarshi.k', 'gauri.rp', 'khjj940901', 'iamstark9', 'daamini11', 'saloni_talathi', 'inderjitsingh87', 'rinkalkeniya', 'c.tamhankar', 'sohini', 'panchal.vp', 'nipunshah', 'suraj.dm', 'tejaswini.shelar', 'pratik.chudiwale', 'mansi.kurhade', 's.mahetaliya', 'rishi.molia']"
5,42,132,18,14,"['yash.dalvi', 'daamini11', 'aniket09', 'bhagyeshri.o', 'rahil.t', 'pranav.mistry', 'dhairya.kamdar', 'advikmaniar', 'pratik.chudiwale', 'panchal.vp', 'saurabh.bodke', 'mansi.kurhade', 'sureshs', 'tejaswini.shelar']",117,"['pas2', 'chaitanyatamhankar36', 'k24406820', 'ankit.ns', 'sachin9', 'vrushali.sule', 'rameshbabu1234', 'amol.kerkar', 'zoheb.mir', 'animesh.prasad', 'sohamshah888', 'bhaskar.a', 'hirenkachhadiya', 'mrunali.khedkar', 'gauravpandey123', 'niharika.somani', 'jaypandya99', 'soham.ms', 'uttamkumar.m', 'r.mungekar', 'p.ambelkar', 'akshay.pathak', 'nitish.r', 'pooja.nambiar', 'ryanwestley', 'aatman.mehta', 'm.veer', 'fenny.m', 'malhar.k', 'nirav.ls', 'pranali.nc', 'jmd', 'meheru.p', 'myers432', 'ishanali.k', 'devashri.n', 'rushabh.shah8', 'mayuresh.shirke', 'karan.ap', 'patel.prakash', 'yukta.rane', 'param05', 'surajr17', 'aayush.butala', 'vinit.js', 'hardik.hp', 'kaushal2531999', 'karan.ys', 'onkarjoshi', 'pulkeet.g', 'meetudiii', 'kavya.moolya', 'paras14', 'pktingare23', 'pratik.lodha.pl', 'pragya.g', 'pritha.roy', 'aman.savla', 'zohebmir006', 'shantanu.saraf', 'hiralmistry9', 'n.sumra', 'shivani.anajria', 'vipulrkt', 'burak', 'kartiksrivastava', 'vedant.modak', 'mihir.khara', 'dhruvik.shah', 'mohil.khona', 'inderjitsingh', 'khushboo.darji', 'ashirwad.b', 'utsav.maisheri', 'tejal.kadu', 'dipansh.m', 'p.hodshil', 'siddharth.vaidya', 'shraddha.bw', 'pranavkumar.t', 'purvi.rane', 'pradnya.koli', 'shubhammore', 'patel.ad', 'saloni.kaveri', 'proabdurrasheed', 'ayum.halwai', 'kaushal.g', 'keval23', 'rashi.singhal', 'bharatan.r', 'suvigya1', 'chaitanya.tambat', 'dhairya.maisheri', 'gmp', 'anamay.m', 'vrushali.padia', 'r.srivastava', 'soham.sheth', 'uttamkumarmishra76652', 'harsh.vasani', 'pranav.garg', 'jayd1529', 'nikhil.naredla', 'saptarshi.k', 'gauri.rp', 'khjj940901', 'iamstark9', 'saloni_talathi', 'inderjitsingh87', 'rinkalkeniya', 'c.tamhankar', 'sohini', 'nipunshah', 'suraj.dm', 's.mahetaliya', 'rishi.molia']",4,"['pratz98', 'bhagyeshri', 'taher.c', None]",135,"['pas2', 'chaitanyatamhankar36', 'k24406820', 'ankit.ns', 'sachin9', 'vrushali.sule', 'rameshbabu1234', 'amol.kerkar', 'zoheb.mir', 'animesh.prasad', 'sohamshah888', 'bhagyeshri.o', 'advikmaniar', 'bhaskar.a', 'hirenkachhadiya', 'mrunali.khedkar', 'gauravpandey123', 'niharika.somani', 'jaypandya99', 'soham.ms', 'uttamkumar.m', 'r.mungekar', 'p.ambelkar', 'akshay.pathak', 'nitish.r', 'pooja.nambiar', 'ryanwestley', 'aatman.mehta', 'pranav.mistry', 'm.veer', 'fenny.m', 'malhar.k', 'nirav.ls', 'pranali.nc', 'jmd', 'meheru.p', 'myers432', 'ishanali.k', 'devashri.n', 'rushabh.shah8', 'mayuresh.shirke', 'taher.c', 'karan.ap', 'patel.prakash', 'yukta.rane', 'param05', 'surajr17', 'aayush.butala', 'vinit.js', 'hardik.hp', 'kaushal2531999', 'karan.ys', 'onkarjoshi', 'pulkeet.g', 'meetudiii', 'kavya.moolya', 'paras14', 'pktingare23', None, 'pratik.lodha.pl', 'pragya.g', 'pritha.roy', 'aman.savla', 'zohebmir006', 'shantanu.saraf', 'hiralmistry9', 'n.sumra', 'shivani.anajria', 'vipulrkt', 'burak', 'sureshs', 'kartiksrivastava', 'aniket09', 'vedant.modak', 'mihir.khara', 'dhruvik.shah', 'mohil.khona', 'inderjitsingh', 'khushboo.darji', 'ashirwad.b', 'yash.dalvi', 'utsav.maisheri', 'tejal.kadu', 'dipansh.m', 'p.hodshil', 'siddharth.vaidya', 'shraddha.bw', 'pranavkumar.t', 'purvi.rane', 'pradnya.koli', 'shubhammore', 'patel.ad', 'rahil.t', 'saloni.kaveri', 'saurabh.bodke', 'proabdurrasheed', 'ayum.halwai', 'kaushal.g', 'keval23', 'rashi.singhal', 'dhairya.kamdar', 'bharatan.r', 'suvigya1', 'chaitanya.tambat', 'dhairya.maisheri', 'gmp', 'anamay.m', 'vrushali.padia', 'r.srivastava', 'bhagyeshri', 'soham.sheth', 'uttamkumarmishra76652', 'harsh.vasani', 'pranav.garg', 'jayd1529', 'nikhil.naredla', 'saptarshi.k', 'gauri.rp', 'khjj940901', 'iamstark9', 'daamini11', 'saloni_talathi', 'inderjitsingh87', 'rinkalkeniya', 'c.tamhankar', 'sohini', 'panchal.vp', 'nipunshah', 'suraj.dm', 'tejaswini.shelar', 'pratz98', 'pratik.chudiwale', 'mansi.kurhade', 's.mahetaliya', 'rishi.molia']"
5,43,132,12,8,"['daamini11', 'aniket09', 'bhagyeshri.o', 'pranav.mistry', 'pratik.chudiwale', 'saurabh.bodke', 'mansi.kurhade', 'tejaswini.shelar']",123,"['pas2', 'chaitanyatamhankar36', 'k24406820', 'ankit.ns', 'sachin9', 'vrushali.sule', 'rameshbabu1234', 'amol.kerkar', 'zoheb.mir', 'animesh.prasad', 'sohamshah888', 'advikmaniar', 'bhaskar.a', 'hirenkachhadiya', 'mrunali.khedkar', 'gauravpandey123', 'niharika.somani', 'jaypandya99', 'soham.ms', 'uttamkumar.m', 'r.mungekar', 'p.ambelkar', 'akshay.pathak', 'nitish.r', 'pooja.nambiar', 'ryanwestley', 'aatman.mehta', 'm.veer', 'fenny.m', 'malhar.k', 'nirav.ls', 'pranali.nc', 'jmd', 'meheru.p', 'myers432', 'ishanali.k', 'devashri.n', 'rushabh.shah8', 'mayuresh.shirke', 'karan.ap', 'patel.prakash', 'yukta.rane', 'param05', 'surajr17', 'aayush.butala', 'vinit.js', 'hardik.hp', 'kaushal2531999', 'karan.ys', 'onkarjoshi', 'pulkeet.g', 'meetudiii', 'kavya.moolya', 'paras14', 'pktingare23', 'pratik.lodha.pl', 'pragya.g', 'pritha.roy', 'aman.savla', 'zohebmir006', 'shantanu.saraf', 'hiralmistry9', 'n.sumra', 'shivani.anajria', 'vipulrkt', 'burak', 'sureshs', 'kartiksrivastava', 'vedant.modak', 'mihir.khara', 'dhruvik.shah', 'mohil.khona', 'inderjitsingh', 'khushboo.darji', 'ashirwad.b', 'yash.dalvi', 'utsav.maisheri', 'tejal.kadu', 'dipansh.m', 'p.hodshil', 'siddharth.vaidya', 'shraddha.bw', 'pranavkumar.t', 'purvi.rane', 'pradnya.koli', 'shubhammore', 'patel.ad', 'rahil.t', 'saloni.kaveri', 'proabdurrasheed', 'ayum.halwai', 'kaushal.g', 'keval23', 'rashi.singhal', 'dhairya.kamdar', 'bharatan.r', 'suvigya1', 'chaitanya.tambat', 'dhairya.maisheri', 'gmp', 'anamay.m', 'vrushali.padia', 'r.srivastava', 'soham.sheth', 'uttamkumarmishra76652', 'harsh.vasani', 'pranav.garg', 'jayd1529', 'nikhil.naredla', 'saptarshi.k', 'gauri.rp', 'khjj940901', 'iamstark9', 'saloni_talathi', 'inderjitsingh87', 'rinkalkeniya', 'c.tamhankar', 'sohini', 'panchal.vp', 'nipunshah', 'suraj.dm', 's.mahetaliya', 'rishi.molia']",4,"['wissenschaftler', None, 'sherylcorina', 'antimhr']",135,"['pas2', 'chaitanyatamhankar36', 'k24406820', 'ankit.ns', 'sachin9', 'vrushali.sule', 'rameshbabu1234', 'amol.kerkar', 'zoheb.mir', 'animesh.prasad', 'sohamshah888', 'bhagyeshri.o', 'wissenschaftler', 'advikmaniar', 'bhaskar.a', 'hirenkachhadiya', 'mrunali.khedkar', 'gauravpandey123', 'niharika.somani', 'jaypandya99', 'soham.ms', 'uttamkumar.m', 'r.mungekar', 'p.ambelkar', 'akshay.pathak', 'nitish.r', 'pooja.nambiar', 'ryanwestley', 'aatman.mehta', 'pranav.mistry', 'm.veer', 'fenny.m', 'malhar.k', 'nirav.ls', 'pranali.nc', 'jmd', 'meheru.p', 'myers432', 'ishanali.k', 'devashri.n', 'antimhr', 'rushabh.shah8', 'mayuresh.shirke', 'karan.ap', 'patel.prakash', 'yukta.rane', 'param05', 'surajr17', 'aayush.butala', 'vinit.js', 'hardik.hp', 'kaushal2531999', 'karan.ys', 'onkarjoshi', 'pulkeet.g', 'meetudiii', 'kavya.moolya', 'paras14', 'pktingare23', None, 'pratik.lodha.pl', 'pragya.g', 'pritha.roy', 'aman.savla', 'zohebmir006', 'shantanu.saraf', 'hiralmistry9', 'n.sumra', 'shivani.anajria', 'vipulrkt', 'burak', 'sureshs', 'kartiksrivastava', 'aniket09', 'vedant.modak', 'mihir.khara', 'dhruvik.shah', 'mohil.khona', 'inderjitsingh', 'khushboo.darji', 'ashirwad.b', 'yash.dalvi', 'utsav.maisheri', 'tejal.kadu', 'dipansh.m', 'p.hodshil', 'siddharth.vaidya', 'shraddha.bw', 'sherylcorina', 'pranavkumar.t', 'purvi.rane', 'pradnya.koli', 'shubhammore', 'patel.ad', 'rahil.t', 'saloni.kaveri', 'saurabh.bodke', 'proabdurrasheed', 'ayum.halwai', 'kaushal.g', 'keval23', 'rashi.singhal', 'dhairya.kamdar', 'bharatan.r', 'suvigya1', 'chaitanya.tambat', 'dhairya.maisheri', 'gmp', 'anamay.m', 'vrushali.padia', 'r.srivastava', 'soham.sheth', 'uttamkumarmishra76652', 'harsh.vasani', 'pranav.garg', 'jayd1529', 'nikhil.naredla', 'saptarshi.k', 'gauri.rp', 'khjj940901', 'iamstark9', 'daamini11', 'saloni_talathi', 'inderjitsingh87', 'rinkalkeniya', 'c.tamhankar', 'sohini', 'panchal.vp', 'nipunshah', 'suraj.dm', 'tejaswini.shelar', 'pratik.chudiwale', 'mansi.kurhade', 's.mahetaliya', 'rishi.molia']"
5,44,132,11,8,"['yash.dalvi', 'pranali.nc', 'daamini11', 'rahil.t', 'bhagyeshri.o', 'pratik.chudiwale', 'mansi.kurhade', 'tejaswini.shelar']",123,"['pas2', 'chaitanyatamhankar36', 'k24406820', 'ankit.ns', 'sachin9', 'vrushali.sule', 'rameshbabu1234', 'amol.kerkar', 'zoheb.mir', 'animesh.prasad', 'sohamshah888', 'advikmaniar', 'bhaskar.a', 'hirenkachhadiya', 'mrunali.khedkar', 'gauravpandey123', 'niharika.somani', 'jaypandya99', 'soham.ms', 'uttamkumar.m', 'r.mungekar', 'p.ambelkar', 'akshay.pathak', 'nitish.r', 'pooja.nambiar', 'ryanwestley', 'aatman.mehta', 'pranav.mistry', 'm.veer', 'fenny.m', 'malhar.k', 'nirav.ls', 'jmd', 'meheru.p', 'myers432', 'ishanali.k', 'devashri.n', 'rushabh.shah8', 'mayuresh.shirke', 'karan.ap', 'patel.prakash', 'yukta.rane', 'param05', 'surajr17', 'aayush.butala', 'vinit.js', 'hardik.hp', 'kaushal2531999', 'karan.ys', 'onkarjoshi', 'pulkeet.g', 'meetudiii', 'kavya.moolya', 'paras14', 'pktingare23', 'pratik.lodha.pl', 'pragya.g', 'pritha.roy', 'aman.savla', 'zohebmir006', 'shantanu.saraf', 'hiralmistry9', 'n.sumra', 'shivani.anajria', 'vipulrkt', 'burak', 'sureshs', 'kartiksrivastava', 'aniket09', 'vedant.modak', 'mihir.khara', 'dhruvik.shah', 'mohil.khona', 'inderjitsingh', 'khushboo.darji', 'ashirwad.b', 'utsav.maisheri', 'tejal.kadu', 'dipansh.m', 'p.hodshil', 'siddharth.vaidya', 'shraddha.bw', 'pranavkumar.t', 'purvi.rane', 'pradnya.koli', 'shubhammore', 'patel.ad', 'saloni.kaveri', 'saurabh.bodke', 'proabdurrasheed', 'ayum.halwai', 'kaushal.g', 'keval23', 'rashi.singhal', 'dhairya.kamdar', 'bharatan.r', 'suvigya1', 'chaitanya.tambat', 'dhairya.maisheri', 'gmp', 'anamay.m', 'vrushali.padia', 'r.srivastava', 'soham.sheth', 'uttamkumarmishra76652', 'harsh.vasani', 'pranav.garg', 'jayd1529', 'nikhil.naredla', 'saptarshi.k', 'gauri.rp', 'khjj940901', 'iamstark9', 'saloni_talathi', 'inderjitsingh87', 'rinkalkeniya', 'c.tamhankar', 'sohini', 'panchal.vp', 'nipunshah', 'suraj.dm', 's.mahetaliya', 'rishi.molia']",3,"['bhavin14', None, 'antimhr']",134,"['pas2', 'chaitanyatamhankar36', 'k24406820', 'ankit.ns', 'sachin9', 'vrushali.sule', 'rameshbabu1234', 'amol.kerkar', 'zoheb.mir', 'animesh.prasad', 'sohamshah888', 'bhagyeshri.o', 'advikmaniar', 'bhaskar.a', 'hirenkachhadiya', 'mrunali.khedkar', 'gauravpandey123', 'niharika.somani', 'jaypandya99', 'soham.ms', 'uttamkumar.m', 'r.mungekar', 'p.ambelkar', 'akshay.pathak', 'nitish.r', 'pooja.nambiar', 'ryanwestley', 'aatman.mehta', 'pranav.mistry', 'm.veer', 'fenny.m', 'malhar.k', 'nirav.ls', 'pranali.nc', 'jmd', 'meheru.p', 'myers432', 'ishanali.k', 'devashri.n', 'antimhr', 'rushabh.shah8', 'mayuresh.shirke', 'karan.ap', 'patel.prakash', 'yukta.rane', 'param05', 'surajr17', 'aayush.butala', 'vinit.js', 'hardik.hp', 'kaushal2531999', 'karan.ys', 'onkarjoshi', 'pulkeet.g', 'meetudiii', 'kavya.moolya', 'paras14', 'pktingare23', None, 'pratik.lodha.pl', 'pragya.g', 'pritha.roy', 'aman.savla', 'zohebmir006', 'shantanu.saraf', 'hiralmistry9', 'n.sumra', 'bhavin14', 'shivani.anajria', 'vipulrkt', 'burak', 'sureshs', 'kartiksrivastava', 'aniket09', 'vedant.modak', 'mihir.khara', 'dhruvik.shah', 'mohil.khona', 'inderjitsingh', 'khushboo.darji', 'ashirwad.b', 'yash.dalvi', 'utsav.maisheri', 'tejal.kadu', 'dipansh.m', 'p.hodshil', 'siddharth.vaidya', 'shraddha.bw', 'pranavkumar.t', 'purvi.rane', 'pradnya.koli', 'shubhammore', 'patel.ad', 'rahil.t', 'saloni.kaveri', 'saurabh.bodke', 'proabdurrasheed', 'ayum.halwai', 'kaushal.g', 'keval23', 'rashi.singhal', 'dhairya.kamdar', 'bharatan.r', 'suvigya1', 'chaitanya.tambat', 'dhairya.maisheri', 'gmp', 'anamay.m', 'vrushali.padia', 'r.srivastava', 'soham.sheth', 'uttamkumarmishra76652', 'harsh.vasani', 'pranav.garg', 'jayd1529', 'nikhil.naredla', 'saptarshi.k', 'gauri.rp', 'khjj940901', 'iamstark9', 'daamini11', 'saloni_talathi', 'inderjitsingh87', 'rinkalkeniya', 'c.tamhankar', 'sohini', 'panchal.vp', 'nipunshah', 'suraj.dm', 'tejaswini.shelar', 'pratik.chudiwale', 'mansi.kurhade', 's.mahetaliya', 'rishi.molia']"
5,47,132,11,1,['vedant.modak'],130,"['pas2', 'chaitanyatamhankar36', 'k24406820', 'ankit.ns', 'sachin9', 'vrushali.sule', 'rameshbabu1234', 'amol.kerkar', 'zoheb.mir', 'animesh.prasad', 'sohamshah888', 'bhagyeshri.o', 'advikmaniar', 'bhaskar.a', 'hirenkachhadiya', 'mrunali.khedkar', 'gauravpandey123', 'niharika.somani', 'jaypandya99', 'soham.ms', 'uttamkumar.m', 'r.mungekar', 'p.ambelkar', 'akshay.pathak', 'nitish.r', 'pooja.nambiar', 'ryanwestley', 'aatman.mehta', 'pranav.mistry', 'm.veer', 'fenny.m', 'malhar.k', 'nirav.ls', 'pranali.nc', 'jmd', 'meheru.p', 'myers432', 'ishanali.k', 'devashri.n', 'rushabh.shah8', 'mayuresh.shirke', 'karan.ap', 'patel.prakash', 'yukta.rane', 'param05', 'surajr17', 'aayush.butala', 'vinit.js', 'hardik.hp', 'kaushal2531999', 'karan.ys', 'onkarjoshi', 'pulkeet.g', 'meetudiii', 'kavya.moolya', 'paras14', 'pktingare23', 'pratik.lodha.pl', 'pragya.g', 'pritha.roy', 'aman.savla', 'zohebmir006', 'shantanu.saraf', 'hiralmistry9', 'n.sumra', 'shivani.anajria', 'vipulrkt', 'burak', 'sureshs', 'kartiksrivastava', 'aniket09', 'mihir.khara', 'dhruvik.shah', 'mohil.khona', 'inderjitsingh', 'khushboo.darji', 'ashirwad.b', 'yash.dalvi', 'utsav.maisheri', 'tejal.kadu', 'dipansh.m', 'p.hodshil', 'siddharth.vaidya', 'shraddha.bw', 'pranavkumar.t', 'purvi.rane', 'pradnya.koli', 'shubhammore', 'patel.ad', 'rahil.t', 'saloni.kaveri', 'saurabh.bodke', 'proabdurrasheed', 'ayum.halwai', 'kaushal.g', 'keval23', 'rashi.singhal', 'dhairya.kamdar', 'bharatan.r', 'suvigya1', 'chaitanya.tambat', 'dhairya.maisheri', 'gmp', 'anamay.m', 'vrushali.padia', 'r.srivastava', 'soham.sheth', 'uttamkumarmishra76652', 'harsh.vasani', 'pranav.garg', 'jayd1529', 'nikhil.naredla', 'saptarshi.k', 'gauri.rp', 'khjj940901', 'iamstark9', 'daamini11', 'saloni_talathi', 'inderjitsingh87', 'rinkalkeniya', 'c.tamhankar', 'sohini', 'panchal.vp', 'nipunshah', 'suraj.dm', 'tejaswini.shelar', 'pratik.chudiwale', 'mansi.kurhade', 's.mahetaliya', 'rishi.molia']",10,"['tarun96', 'rohitrane500', 'rathod_spce', 'sangeetamjoshi', 'sumitdupate19', 'tiwarisuraj5769', 'hrishikesh28', 'anuragmandke4', 'kshemal_gupte', None]",141,"['pas2', 'chaitanyatamhankar36', 'k24406820', 'ankit.ns', 'sachin9', 'vrushali.sule', 'rameshbabu1234', 'amol.kerkar', 'zoheb.mir', 'animesh.prasad', 'sohamshah888', 'bhagyeshri.o', 'advikmaniar', 'bhaskar.a', 'hirenkachhadiya', 'mrunali.khedkar', 'rathod_spce', 'gauravpandey123', 'tiwarisuraj5769', 'niharika.somani', 'jaypandya99', 'soham.ms', 'uttamkumar.m', 'r.mungekar', 'p.ambelkar', 'akshay.pathak', 'nitish.r', 'pooja.nambiar', 'ryanwestley', 'aatman.mehta', 'pranav.mistry', 'm.veer', 'fenny.m', 'malhar.k', 'hrishikesh28', 'nirav.ls', 'pranali.nc', 'sangeetamjoshi', 'jmd', 'meheru.p', 'myers432', 'ishanali.k', 'devashri.n', 'rushabh.shah8', 'mayuresh.shirke', 'karan.ap', 'patel.prakash', 'yukta.rane', 'param05', 'surajr17', 'aayush.butala', 'vinit.js', 'hardik.hp', 'kaushal2531999', 'karan.ys', 'onkarjoshi', 'pulkeet.g', 'meetudiii', 'kavya.moolya', 'paras14', 'pktingare23', None, 'pratik.lodha.pl', 'pragya.g', 'rohitrane500', 'pritha.roy', 'aman.savla', 'zohebmir006', 'shantanu.saraf', 'hiralmistry9', 'n.sumra', 'shivani.anajria', 'vipulrkt', 'anuragmandke4', 'burak', 'sureshs', 'kartiksrivastava', 'aniket09', 'vedant.modak', 'mihir.khara', 'dhruvik.shah', 'mohil.khona', 'inderjitsingh', 'khushboo.darji', 'ashirwad.b', 'yash.dalvi', 'utsav.maisheri', 'tejal.kadu', 'dipansh.m', 'p.hodshil', 'siddharth.vaidya', 'shraddha.bw', 'pranavkumar.t', 'purvi.rane', 'pradnya.koli', 'shubhammore', 'patel.ad', 'rahil.t', 'saloni.kaveri', 'saurabh.bodke', 'proabdurrasheed', 'ayum.halwai', 'kaushal.g', 'keval23', 'rashi.singhal', 'dhairya.kamdar', 'bharatan.r', 'suvigya1', 'chaitanya.tambat', 'dhairya.maisheri', 'gmp', 'anamay.m', 'tarun96', 'vrushali.padia', 'r.srivastava', 'soham.sheth', 'uttamkumarmishra76652', 'kshemal_gupte', 'harsh.vasani', 'pranav.garg', 'jayd1529', 'nikhil.naredla', 'saptarshi.k', 'gauri.rp', 'khjj940901', 'iamstark9', 'sumitdupate19', 'daamini11', 'saloni_talathi', 'inderjitsingh87', 'rinkalkeniya', 'c.tamhankar', 'sohini', 'panchal.vp', 'nipunshah', 'suraj.dm', 'tejaswini.shelar', 'pratik.chudiwale', 'mansi.kurhade', 's.mahetaliya', 'rishi.molia']"
5,166,132,11,8,"['saptarshi.k', 'pranali.nc', 'hiralmistry9', 'niharika.somani', 'paras14', 'p.ambelkar', 'harsh.vasani', 'jayd1529']",123,"['pas2', 'chaitanyatamhankar36', 'k24406820', 'ankit.ns', 'sachin9', 'vrushali.sule', 'rameshbabu1234', 'amol.kerkar', 'zoheb.mir', 'animesh.prasad', 'sohamshah888', 'bhagyeshri.o', 'advikmaniar', 'bhaskar.a', 'hirenkachhadiya', 'mrunali.khedkar', 'gauravpandey123', 'jaypandya99', 'soham.ms', 'uttamkumar.m', 'r.mungekar', 'akshay.pathak', 'nitish.r', 'pooja.nambiar', 'ryanwestley', 'aatman.mehta', 'pranav.mistry', 'm.veer', 'fenny.m', 'malhar.k', 'nirav.ls', 'jmd', 'meheru.p', 'myers432', 'ishanali.k', 'devashri.n', 'rushabh.shah8', 'mayuresh.shirke', 'karan.ap', 'patel.prakash', 'yukta.rane', 'param05', 'surajr17', 'aayush.butala', 'vinit.js', 'hardik.hp', 'kaushal2531999', 'karan.ys', 'onkarjoshi', 'pulkeet.g', 'meetudiii', 'kavya.moolya', 'pktingare23', 'pratik.lodha.pl', 'pragya.g', 'pritha.roy', 'aman.savla', 'zohebmir006', 'shantanu.saraf', 'n.sumra', 'shivani.anajria', 'vipulrkt', 'burak', 'sureshs', 'kartiksrivastava', 'aniket09', 'vedant.modak', 'mihir.khara', 'dhruvik.shah', 'mohil.khona', 'inderjitsingh', 'khushboo.darji', 'ashirwad.b', 'yash.dalvi', 'utsav.maisheri', 'tejal.kadu', 'dipansh.m', 'p.hodshil', 'siddharth.vaidya', 'shraddha.bw', 'pranavkumar.t', 'purvi.rane', 'pradnya.koli', 'shubhammore', 'patel.ad', 'rahil.t', 'saloni.kaveri', 'saurabh.bodke', 'proabdurrasheed', 'ayum.halwai', 'kaushal.g', 'keval23', 'rashi.singhal', 'dhairya.kamdar', 'bharatan.r', 'suvigya1', 'chaitanya.tambat', 'dhairya.maisheri', 'gmp', 'anamay.m', 'vrushali.padia', 'r.srivastava', 'soham.sheth', 'uttamkumarmishra76652', 'pranav.garg', 'nikhil.naredla', 'gauri.rp', 'khjj940901', 'iamstark9', 'daamini11', 'saloni_talathi', 'inderjitsingh87', 'rinkalkeniya', 'c.tamhankar', 'sohini', 'panchal.vp', 'nipunshah', 'suraj.dm', 'tejaswini.shelar', 'pratik.chudiwale', 'mansi.kurhade', 's.mahetaliya', 'rishi.molia']",3,"['aryaman1712021', None, 'anirudh9911']",134,"['pas2', 'chaitanyatamhankar36', 'k24406820', 'ankit.ns', 'sachin9', 'vrushali.sule', 'rameshbabu1234', 'amol.kerkar', 'zoheb.mir', 'animesh.prasad', 'sohamshah888', 'bhagyeshri.o', 'advikmaniar', 'bhaskar.a', 'hirenkachhadiya', 'mrunali.khedkar', 'gauravpandey123', 'niharika.somani', 'jaypandya99', 'soham.ms', 'uttamkumar.m', 'r.mungekar', 'p.ambelkar', 'akshay.pathak', 'nitish.r', 'pooja.nambiar', 'ryanwestley', 'aatman.mehta', 'pranav.mistry', 'm.veer', 'fenny.m', 'malhar.k', 'nirav.ls', 'pranali.nc', 'jmd', 'meheru.p', 'myers432', 'ishanali.k', 'devashri.n', 'rushabh.shah8', 'mayuresh.shirke', 'karan.ap', 'patel.prakash', 'yukta.rane', 'param05', 'surajr17', 'aayush.butala', 'vinit.js', 'hardik.hp', 'kaushal2531999', 'karan.ys', 'onkarjoshi', 'pulkeet.g', 'meetudiii', 'kavya.moolya', 'paras14', 'pktingare23', None, 'pratik.lodha.pl', 'pragya.g', 'pritha.roy', 'aman.savla', 'zohebmir006', 'shantanu.saraf', 'hiralmistry9', 'n.sumra', 'shivani.anajria', 'vipulrkt', 'burak', 'sureshs', 'kartiksrivastava', 'aniket09', 'vedant.modak', 'mihir.khara', 'dhruvik.shah', 'mohil.khona', 'inderjitsingh', 'khushboo.darji', 'ashirwad.b', 'yash.dalvi', 'utsav.maisheri', 'tejal.kadu', 'dipansh.m', 'p.hodshil', 'siddharth.vaidya', 'shraddha.bw', 'pranavkumar.t', 'purvi.rane', 'pradnya.koli', 'shubhammore', 'patel.ad', 'rahil.t', 'saloni.kaveri', 'saurabh.bodke', 'proabdurrasheed', 'aryaman1712021', 'ayum.halwai', 'kaushal.g', 'keval23', 'rashi.singhal', 'dhairya.kamdar', 'bharatan.r', 'suvigya1', 'chaitanya.tambat', 'dhairya.maisheri', 'gmp', 'anamay.m', 'vrushali.padia', 'r.srivastava', 'soham.sheth', 'uttamkumarmishra76652', 'harsh.vasani', 'pranav.garg', 'jayd1529', 'nikhil.naredla', 'saptarshi.k', 'gauri.rp', 'khjj940901', 'iamstark9', 'daamini11', 'saloni_talathi', 'inderjitsingh87', 'rinkalkeniya', 'c.tamhankar', 'sohini', 'anirudh9911', 'panchal.vp', 'nipunshah', 'suraj.dm', 'tejaswini.shelar', 'pratik.chudiwale', 'mansi.kurhade', 's.mahetaliya', 'rishi.molia']"
5,167,132,11,9,"['pranavkumar.t', 'kartiksrivastava', 'keval23', 'meetudiii', 'saloni_talathi', 'aatman.mehta', 'fenny.m', 'rushabh.shah8', 'nipunshah']",122,"['pas2', 'chaitanyatamhankar36', 'k24406820', 'ankit.ns', 'sachin9', 'vrushali.sule', 'rameshbabu1234', 'amol.kerkar', 'zoheb.mir', 'animesh.prasad', 'sohamshah888', 'bhagyeshri.o', 'advikmaniar', 'bhaskar.a', 'hirenkachhadiya', 'mrunali.khedkar', 'gauravpandey123', 'niharika.somani', 'jaypandya99', 'soham.ms', 'uttamkumar.m', 'r.mungekar', 'p.ambelkar', 'akshay.pathak', 'nitish.r', 'pooja.nambiar', 'ryanwestley', 'pranav.mistry', 'm.veer', 'malhar.k', 'nirav.ls', 'pranali.nc', 'jmd', 'meheru.p', 'myers432', 'ishanali.k', 'devashri.n', 'mayuresh.shirke', 'karan.ap', 'patel.prakash', 'yukta.rane', 'param05', 'surajr17', 'aayush.butala', 'vinit.js', 'hardik.hp', 'kaushal2531999', 'karan.ys', 'onkarjoshi', 'pulkeet.g', 'kavya.moolya', 'paras14', 'pktingare23', 'pratik.lodha.pl', 'pragya.g', 'pritha.roy', 'aman.savla', 'zohebmir006', 'shantanu.saraf', 'hiralmistry9', 'n.sumra', 'shivani.anajria', 'vipulrkt', 'burak', 'sureshs', 'aniket09', 'vedant.modak', 'mihir.khara', 'dhruvik.shah', 'mohil.khona', 'inderjitsingh', 'khushboo.darji', 'ashirwad.b', 'yash.dalvi', 'utsav.maisheri', 'tejal.kadu', 'dipansh.m', 'p.hodshil', 'siddharth.vaidya', 'shraddha.bw', 'purvi.rane', 'pradnya.koli', 'shubhammore', 'patel.ad', 'rahil.t', 'saloni.kaveri', 'saurabh.bodke', 'proabdurrasheed', 'ayum.halwai', 'kaushal.g', 'rashi.singhal', 'dhairya.kamdar', 'bharatan.r', 'suvigya1', 'chaitanya.tambat', 'dhairya.maisheri', 'gmp', 'anamay.m', 'vrushali.padia', 'r.srivastava', 'soham.sheth', 'uttamkumarmishra76652', 'harsh.vasani', 'pranav.garg', 'jayd1529', 'nikhil.naredla', 'saptarshi.k', 'gauri.rp', 'khjj940901', 'iamstark9', 'daamini11', 'inderjitsingh87', 'rinkalkeniya', 'c.tamhankar', 'sohini', 'panchal.vp', 'suraj.dm', 'tejaswini.shelar', 'pratik.chudiwale', 'mansi.kurhade', 's.mahetaliya', 'rishi.molia']",2,"['rajveersingh.k', None]",133,"['pas2', 'chaitanyatamhankar36', 'k24406820', 'ankit.ns', 'sachin9', 'vrushali.sule', 'rameshbabu1234', 'amol.kerkar', 'zoheb.mir', 'animesh.prasad', 'sohamshah888', 'bhagyeshri.o', 'advikmaniar', 'bhaskar.a', 'hirenkachhadiya', 'mrunali.khedkar', 'gauravpandey123', 'niharika.somani', 'jaypandya99', 'soham.ms', 'uttamkumar.m', 'r.mungekar', 'p.ambelkar', 'akshay.pathak', 'nitish.r', 'pooja.nambiar', 'ryanwestley', 'aatman.mehta', 'pranav.mistry', 'm.veer', 'fenny.m', 'malhar.k', 'nirav.ls', 'pranali.nc', 'jmd', 'meheru.p', 'myers432', 'ishanali.k', 'devashri.n', 'rushabh.shah8', 'mayuresh.shirke', 'karan.ap', 'patel.prakash', 'yukta.rane', 'param05', 'surajr17', 'aayush.butala', 'vinit.js', 'hardik.hp', 'kaushal2531999', 'karan.ys', 'onkarjoshi', 'pulkeet.g', 'meetudiii', 'kavya.moolya', 'paras14', 'pktingare23', None, 'pratik.lodha.pl', 'pragya.g', 'pritha.roy', 'aman.savla', 'zohebmir006', 'shantanu.saraf', 'hiralmistry9', 'n.sumra', 'shivani.anajria', 'vipulrkt', 'burak', 'sureshs', 'kartiksrivastava', 'aniket09', 'vedant.modak', 'mihir.khara', 'dhruvik.shah', 'mohil.khona', 'inderjitsingh', 'khushboo.darji', 'ashirwad.b', 'yash.dalvi', 'utsav.maisheri', 'tejal.kadu', 'dipansh.m', 'rajveersingh.k', 'p.hodshil', 'siddharth.vaidya', 'shraddha.bw', 'pranavkumar.t', 'purvi.rane', 'pradnya.koli', 'shubhammore', 'patel.ad', 'rahil.t', 'saloni.kaveri', 'saurabh.bodke', 'proabdurrasheed', 'ayum.halwai', 'kaushal.g', 'keval23', 'rashi.singhal', 'dhairya.kamdar', 'bharatan.r', 'suvigya1', 'chaitanya.tambat', 'dhairya.maisheri', 'gmp', 'anamay.m', 'vrushali.padia', 'r.srivastava', 'soham.sheth', 'uttamkumarmishra76652', 'harsh.vasani', 'pranav.garg', 'jayd1529', 'nikhil.naredla', 'saptarshi.k', 'gauri.rp', 'khjj940901', 'iamstark9', 'daamini11', 'saloni_talathi', 'inderjitsingh87', 'rinkalkeniya', 'c.tamhankar', 'sohini', 'panchal.vp', 'nipunshah', 'suraj.dm', 'tejaswini.shelar', 'pratik.chudiwale', 'mansi.kurhade', 's.mahetaliya', 'rishi.molia']"
5,168,132,9,7,"['pranavkumar.t', 'zoheb.mir', 'keval23', 'saloni_talathi', 'aatman.mehta', 'fenny.m', 'vinit.js']",124,"['pas2', 'chaitanyatamhankar36', 'k24406820', 'ankit.ns', 'sachin9', 'vrushali.sule', 'rameshbabu1234', 'amol.kerkar', 'animesh.prasad', 'sohamshah888', 'bhagyeshri.o', 'advikmaniar', 'bhaskar.a', 'hirenkachhadiya', 'mrunali.khedkar', 'gauravpandey123', 'niharika.somani', 'jaypandya99', 'soham.ms', 'uttamkumar.m', 'r.mungekar', 'p.ambelkar', 'akshay.pathak', 'nitish.r', 'pooja.nambiar', 'ryanwestley', 'pranav.mistry', 'm.veer', 'malhar.k', 'nirav.ls', 'pranali.nc', 'jmd', 'meheru.p', 'myers432', 'ishanali.k', 'devashri.n', 'rushabh.shah8', 'mayuresh.shirke', 'karan.ap', 'patel.prakash', 'yukta.rane', 'param05', 'surajr17', 'aayush.butala', 'hardik.hp', 'kaushal2531999', 'karan.ys', 'onkarjoshi', 'pulkeet.g', 'meetudiii', 'kavya.moolya', 'paras14', 'pktingare23', 'pratik.lodha.pl', 'pragya.g', 'pritha.roy', 'aman.savla', 'zohebmir006', 'shantanu.saraf', 'hiralmistry9', 'n.sumra', 'shivani.anajria', 'vipulrkt', 'burak', 'sureshs', 'kartiksrivastava', 'aniket09', 'vedant.modak', 'mihir.khara', 'dhruvik.shah', 'mohil.khona', 'inderjitsingh', 'khushboo.darji', 'ashirwad.b', 'yash.dalvi', 'utsav.maisheri', 'tejal.kadu', 'dipansh.m', 'p.hodshil', 'siddharth.vaidya', 'shraddha.bw', 'purvi.rane', 'pradnya.koli', 'shubhammore', 'patel.ad', 'rahil.t', 'saloni.kaveri', 'saurabh.bodke', 'proabdurrasheed', 'ayum.halwai', 'kaushal.g', 'rashi.singhal', 'dhairya.kamdar', 'bharatan.r', 'suvigya1', 'chaitanya.tambat', 'dhairya.maisheri', 'gmp', 'anamay.m', 'vrushali.padia', 'r.srivastava', 'soham.sheth', 'uttamkumarmishra76652', 'harsh.vasani', 'pranav.garg', 'jayd1529', 'nikhil.naredla', 'saptarshi.k', 'gauri.rp', 'khjj940901', 'iamstark9', 'daamini11', 'inderjitsingh87', 'rinkalkeniya', 'c.tamhankar', 'sohini', 'panchal.vp', 'nipunshah', 'suraj.dm', 'tejaswini.shelar', 'pratik.chudiwale', 'mansi.kurhade', 's.mahetaliya', 'rishi.molia']",2,"['rajveersingh.k', None]",133,"['pas2', 'chaitanyatamhankar36', 'k24406820', 'ankit.ns', 'sachin9', 'vrushali.sule', 'rameshbabu1234', 'amol.kerkar', 'zoheb.mir', 'animesh.prasad', 'sohamshah888', 'bhagyeshri.o', 'advikmaniar', 'bhaskar.a', 'hirenkachhadiya', 'mrunali.khedkar', 'gauravpandey123', 'niharika.somani', 'jaypandya99', 'soham.ms', 'uttamkumar.m', 'r.mungekar', 'p.ambelkar', 'akshay.pathak', 'nitish.r', 'pooja.nambiar', 'ryanwestley', 'aatman.mehta', 'pranav.mistry', 'm.veer', 'fenny.m', 'malhar.k', 'nirav.ls', 'pranali.nc', 'jmd', 'meheru.p', 'myers432', 'ishanali.k', 'devashri.n', 'rushabh.shah8', 'mayuresh.shirke', 'karan.ap', 'patel.prakash', 'yukta.rane', 'param05', 'surajr17', 'aayush.butala', 'vinit.js', 'hardik.hp', 'kaushal2531999', 'karan.ys', 'onkarjoshi', 'pulkeet.g', 'meetudiii', 'kavya.moolya', 'paras14', 'pktingare23', None, 'pratik.lodha.pl', 'pragya.g', 'pritha.roy', 'aman.savla', 'zohebmir006', 'shantanu.saraf', 'hiralmistry9', 'n.sumra', 'shivani.anajria', 'vipulrkt', 'burak', 'sureshs', 'kartiksrivastava', 'aniket09', 'vedant.modak', 'mihir.khara', 'dhruvik.shah', 'mohil.khona', 'inderjitsingh', 'khushboo.darji', 'ashirwad.b', 'yash.dalvi', 'utsav.maisheri', 'tejal.kadu', 'dipansh.m', 'rajveersingh.k', 'p.hodshil', 'siddharth.vaidya', 'shraddha.bw', 'pranavkumar.t', 'purvi.rane', 'pradnya.koli', 'shubhammore', 'patel.ad', 'rahil.t', 'saloni.kaveri', 'saurabh.bodke', 'proabdurrasheed', 'ayum.halwai', 'kaushal.g', 'keval23', 'rashi.singhal', 'dhairya.kamdar', 'bharatan.r', 'suvigya1', 'chaitanya.tambat', 'dhairya.maisheri', 'gmp', 'anamay.m', 'vrushali.padia', 'r.srivastava', 'soham.sheth', 'uttamkumarmishra76652', 'harsh.vasani', 'pranav.garg', 'jayd1529', 'nikhil.naredla', 'saptarshi.k', 'gauri.rp', 'khjj940901', 'iamstark9', 'daamini11', 'saloni_talathi', 'inderjitsingh87', 'rinkalkeniya', 'c.tamhankar', 'sohini', 'panchal.vp', 'nipunshah', 'suraj.dm', 'tejaswini.shelar', 'pratik.chudiwale', 'mansi.kurhade', 's.mahetaliya', 'rishi.molia']"
5,45,132,6,5,"['kartiksrivastava', 'saloni_talathi', 'aatman.mehta', 'fenny.m', 'nipunshah']",126,"['pas2', 'chaitanyatamhankar36', 'k24406820', 'ankit.ns', 'sachin9', 'vrushali.sule', 'rameshbabu1234', 'amol.kerkar', 'zoheb.mir', 'animesh.prasad', 'sohamshah888', 'bhagyeshri.o', 'advikmaniar', 'bhaskar.a', 'hirenkachhadiya', 'mrunali.khedkar', 'gauravpandey123', 'niharika.somani', 'jaypandya99', 'soham.ms', 'uttamkumar.m', 'r.mungekar', 'p.ambelkar', 'akshay.pathak', 'nitish.r', 'pooja.nambiar', 'ryanwestley', 'pranav.mistry', 'm.veer', 'malhar.k', 'nirav.ls', 'pranali.nc', 'jmd', 'meheru.p', 'myers432', 'ishanali.k', 'devashri.n', 'rushabh.shah8', 'mayuresh.shirke', 'karan.ap', 'patel.prakash', 'yukta.rane', 'param05', 'surajr17', 'aayush.butala', 'vinit.js', 'hardik.hp', 'kaushal2531999', 'karan.ys', 'onkarjoshi', 'pulkeet.g', 'meetudiii', 'kavya.moolya', 'paras14', 'pktingare23', 'pratik.lodha.pl', 'pragya.g', 'pritha.roy', 'aman.savla', 'zohebmir006', 'shantanu.saraf', 'hiralmistry9', 'n.sumra', 'shivani.anajria', 'vipulrkt', 'burak', 'sureshs', 'aniket09', 'vedant.modak', 'mihir.khara', 'dhruvik.shah', 'mohil.khona', 'inderjitsingh', 'khushboo.darji', 'ashirwad.b', 'yash.dalvi', 'utsav.maisheri', 'tejal.kadu', 'dipansh.m', 'p.hodshil', 'siddharth.vaidya', 'shraddha.bw', 'pranavkumar.t', 'purvi.rane', 'pradnya.koli', 'shubhammore', 'patel.ad', 'rahil.t', 'saloni.kaveri', 'saurabh.bodke', 'proabdurrasheed', 'ayum.halwai', 'kaushal.g', 'keval23', 'rashi.singhal', 'dhairya.kamdar', 'bharatan.r', 'suvigya1', 'chaitanya.tambat', 'dhairya.maisheri', 'gmp', 'anamay.m', 'vrushali.padia', 'r.srivastava', 'soham.sheth', 'uttamkumarmishra76652', 'harsh.vasani', 'pranav.garg', 'jayd1529', 'nikhil.naredla', 'saptarshi.k', 'gauri.rp', 'khjj940901', 'iamstark9', 'daamini11', 'inderjitsingh87', 'rinkalkeniya', 'c.tamhankar', 'sohini', 'panchal.vp', 'suraj.dm', 'tejaswini.shelar', 'pratik.chudiwale', 'mansi.kurhade', 's.mahetaliya', 'rishi.molia']",1,[None],132,"['pas2', 'chaitanyatamhankar36', 'k24406820', 'ankit.ns', 'sachin9', 'vrushali.sule', 'rameshbabu1234', 'amol.kerkar', 'zoheb.mir', 'animesh.prasad', 'sohamshah888', 'bhagyeshri.o', 'advikmaniar', 'bhaskar.a', 'hirenkachhadiya', 'mrunali.khedkar', 'gauravpandey123', 'niharika.somani', 'jaypandya99', 'soham.ms', 'uttamkumar.m', 'r.mungekar', 'p.ambelkar', 'akshay.pathak', 'nitish.r', 'pooja.nambiar', 'ryanwestley', 'aatman.mehta', 'pranav.mistry', 'm.veer', 'fenny.m', 'malhar.k', 'nirav.ls', 'pranali.nc', 'jmd', 'meheru.p', 'myers432', 'ishanali.k', 'devashri.n', 'rushabh.shah8', 'mayuresh.shirke', 'karan.ap', 'patel.prakash', 'yukta.rane', 'param05', 'surajr17', 'aayush.butala', 'vinit.js', 'hardik.hp', 'kaushal2531999', 'karan.ys', 'onkarjoshi', 'pulkeet.g', 'meetudiii', 'kavya.moolya', 'paras14', 'pktingare23', None, 'pratik.lodha.pl', 'pragya.g', 'pritha.roy', 'aman.savla', 'zohebmir006', 'shantanu.saraf', 'hiralmistry9', 'n.sumra', 'shivani.anajria', 'vipulrkt', 'burak', 'sureshs', 'kartiksrivastava', 'aniket09', 'vedant.modak', 'mihir.khara', 'dhruvik.shah', 'mohil.khona', 'inderjitsingh', 'khushboo.darji', 'ashirwad.b', 'yash.dalvi', 'utsav.maisheri', 'tejal.kadu', 'dipansh.m', 'p.hodshil', 'siddharth.vaidya', 'shraddha.bw', 'pranavkumar.t', 'purvi.rane', 'pradnya.koli', 'shubhammore', 'patel.ad', 'rahil.t', 'saloni.kaveri', 'saurabh.bodke', 'proabdurrasheed', 'ayum.halwai', 'kaushal.g', 'keval23', 'rashi.singhal', 'dhairya.kamdar', 'bharatan.r', 'suvigya1', 'chaitanya.tambat', 'dhairya.maisheri', 'gmp', 'anamay.m', 'vrushali.padia', 'r.srivastava', 'soham.sheth', 'uttamkumarmishra76652', 'harsh.vasani', 'pranav.garg', 'jayd1529', 'nikhil.naredla', 'saptarshi.k', 'gauri.rp', 'khjj940901', 'iamstark9', 'daamini11', 'saloni_talathi', 'inderjitsingh87', 'rinkalkeniya', 'c.tamhankar', 'sohini', 'panchal.vp', 'nipunshah', 'suraj.dm', 'tejaswini.shelar', 'pratik.chudiwale', 'mansi.kurhade', 's.mahetaliya', 'rishi.molia']"
5,46,132,6,5,"['kartiksrivastava', 'saloni_talathi', 'aatman.mehta', 'fenny.m', 'nipunshah']",126,"['pas2', 'chaitanyatamhankar36', 'k24406820', 'ankit.ns', 'sachin9', 'vrushali.sule', 'rameshbabu1234', 'amol.kerkar', 'zoheb.mir', 'animesh.prasad', 'sohamshah888', 'bhagyeshri.o', 'advikmaniar', 'bhaskar.a', 'hirenkachhadiya', 'mrunali.khedkar', 'gauravpandey123', 'niharika.somani', 'jaypandya99', 'soham.ms', 'uttamkumar.m', 'r.mungekar', 'p.ambelkar', 'akshay.pathak', 'nitish.r', 'pooja.nambiar', 'ryanwestley', 'pranav.mistry', 'm.veer', 'malhar.k', 'nirav.ls', 'pranali.nc', 'jmd', 'meheru.p', 'myers432', 'ishanali.k', 'devashri.n', 'rushabh.shah8', 'mayuresh.shirke', 'karan.ap', 'patel.prakash', 'yukta.rane', 'param05', 'surajr17', 'aayush.butala', 'vinit.js', 'hardik.hp', 'kaushal2531999', 'karan.ys', 'onkarjoshi', 'pulkeet.g', 'meetudiii', 'kavya.moolya', 'paras14', 'pktingare23', 'pratik.lodha.pl', 'pragya.g', 'pritha.roy', 'aman.savla', 'zohebmir006', 'shantanu.saraf', 'hiralmistry9', 'n.sumra', 'shivani.anajria', 'vipulrkt', 'burak', 'sureshs', 'aniket09', 'vedant.modak', 'mihir.khara', 'dhruvik.shah', 'mohil.khona', 'inderjitsingh', 'khushboo.darji', 'ashirwad.b', 'yash.dalvi', 'utsav.maisheri', 'tejal.kadu', 'dipansh.m', 'p.hodshil', 'siddharth.vaidya', 'shraddha.bw', 'pranavkumar.t', 'purvi.rane', 'pradnya.koli', 'shubhammore', 'patel.ad', 'rahil.t', 'saloni.kaveri', 'saurabh.bodke', 'proabdurrasheed', 'ayum.halwai', 'kaushal.g', 'keval23', 'rashi.singhal', 'dhairya.kamdar', 'bharatan.r', 'suvigya1', 'chaitanya.tambat', 'dhairya.maisheri', 'gmp', 'anamay.m', 'vrushali.padia', 'r.srivastava', 'soham.sheth', 'uttamkumarmishra76652', 'harsh.vasani', 'pranav.garg', 'jayd1529', 'nikhil.naredla', 'saptarshi.k', 'gauri.rp', 'khjj940901', 'iamstark9', 'daamini11', 'inderjitsingh87', 'rinkalkeniya', 'c.tamhankar', 'sohini', 'panchal.vp', 'suraj.dm', 'tejaswini.shelar', 'pratik.chudiwale', 'mansi.kurhade', 's.mahetaliya', 'rishi.molia']",1,[None],132,"['pas2', 'chaitanyatamhankar36', 'k24406820', 'ankit.ns', 'sachin9', 'vrushali.sule', 'rameshbabu1234', 'amol.kerkar', 'zoheb.mir', 'animesh.prasad', 'sohamshah888', 'bhagyeshri.o', 'advikmaniar', 'bhaskar.a', 'hirenkachhadiya', 'mrunali.khedkar', 'gauravpandey123', 'niharika.somani', 'jaypandya99', 'soham.ms', 'uttamkumar.m', 'r.mungekar', 'p.ambelkar', 'akshay.pathak', 'nitish.r', 'pooja.nambiar', 'ryanwestley', 'aatman.mehta', 'pranav.mistry', 'm.veer', 'fenny.m', 'malhar.k', 'nirav.ls', 'pranali.nc', 'jmd', 'meheru.p', 'myers432', 'ishanali.k', 'devashri.n', 'rushabh.shah8', 'mayuresh.shirke', 'karan.ap', 'patel.prakash', 'yukta.rane', 'param05', 'surajr17', 'aayush.butala', 'vinit.js', 'hardik.hp', 'kaushal2531999', 'karan.ys', 'onkarjoshi', 'pulkeet.g', 'meetudiii', 'kavya.moolya', 'paras14', 'pktingare23', None, 'pratik.lodha.pl', 'pragya.g', 'pritha.roy', 'aman.savla', 'zohebmir006', 'shantanu.saraf', 'hiralmistry9', 'n.sumra', 'shivani.anajria', 'vipulrkt', 'burak', 'sureshs', 'kartiksrivastava', 'aniket09', 'vedant.modak', 'mihir.khara', 'dhruvik.shah', 'mohil.khona', 'inderjitsingh', 'khushboo.darji', 'ashirwad.b', 'yash.dalvi', 'utsav.maisheri', 'tejal.kadu', 'dipansh.m', 'p.hodshil', 'siddharth.vaidya', 'shraddha.bw', 'pranavkumar.t', 'purvi.rane', 'pradnya.koli', 'shubhammore', 'patel.ad', 'rahil.t', 'saloni.kaveri', 'saurabh.bodke', 'proabdurrasheed', 'ayum.halwai', 'kaushal.g', 'keval23', 'rashi.singhal', 'dhairya.kamdar', 'bharatan.r', 'suvigya1', 'chaitanya.tambat', 'dhairya.maisheri', 'gmp', 'anamay.m', 'vrushali.padia', 'r.srivastava', 'soham.sheth', 'uttamkumarmishra76652', 'harsh.vasani', 'pranav.garg', 'jayd1529', 'nikhil.naredla', 'saptarshi.k', 'gauri.rp', 'khjj940901', 'iamstark9', 'daamini11', 'saloni_talathi', 'inderjitsingh87', 'rinkalkeniya', 'c.tamhankar', 'sohini', 'panchal.vp', 'nipunshah', 'suraj.dm', 'tejaswini.shelar', 'pratik.chudiwale', 'mansi.kurhade', 's.mahetaliya', 'rishi.molia']"
6,319,104,28,26,"['salvatore1', 'alesdu12', 'davide1234', 'danilo_cammarata', 'isaacdelpe', 'mattiagallobruno99', 'saradipa01', 'lorenzo_riggi', 's268950', 'vincenzopioelia', 'federica_bader', 'martamusso', 'angelodaroma00', 'diego_moriondo', 'christian.bodo', 'matteoc98', 'francesco.pelle', 'giuseppe00', 'ilaria', 'eliabronzo03', 'andriguli00', 'edoardo', 'chidzahi', 'margheritabruno0', 'lucanepote2000', 'kevinetor.piccati']",77,"['albispace99', 'frac98', 'esachet', 'etx.dan', 'vicarius', 'gervasio', 'marcoghiglia', 'giulia.cornara', 'chiesaottavia', 'lorenzobraia', 'gabriele.fasolis', 'valentinamarino', 'martamac', 'emanuele.staiessi', 'rguo4', 'art3m1sf0wl', 'deepslakshmi', 'giuseppe.divincenzo21', 'amadomat', 'shwetabhagat59', 'albertopolato', 'giubileigaia', 'lindafabs', 'ga.costa', 'robertobellelli', 'luca.posa', 'santux01', 'river5966', 'mattebogg', 'enricomanfredi', 'sabitas1966', 'luigipuppo', 'gerardo.castagno', 's270685', 'andreacomberiati', 'webtechshri', 'gregoriocolombo12', 'michele.blasco', 'sergio_fierro', 'giordanocomencini', 'gabriele_gatti', 's269258', 'dvlom', 'alemarchei', 'edo.bonaventura', 'lorenzo_menon', 'giuseppep', 's269938', 'barbarazacco', 'lollo', 'stdiohs123', 'alessiofrigato00', 'enricovalentini', 'ciabattarichri', 'tarta56', 'natalia.loizzo1', 'pietrog', 'sabina.olenic', 'ivanelefante09', 'federicaderrico', 'lucabozza', 'scal', 'matildebidone', 'mattiamode', 'niaz_eee', 'ivan271', 'murgia915', 'lucacasassa', 'abubakrjaved93', 'danielebersano', 's205676', 'miriam.piccinini00', 'ari15', 'davibarbero', 'simona_zetta', 'tausenrico00', 'crhistian.sinche']",2,"['giulianaberetta', None]",105,"['albispace99', 'frac98', 'alesdu12', 'davide1234', 'esachet', 'danilo_cammarata', 'isaacdelpe', 'luigipuppo', 'gerardo.castagno', 's270685', 'mattiagallobruno99', 'andreacomberiati', 'saradipa01', 'lorenzo_riggi', 'webtechshri', 's268950', 'etx.dan', 'vicarius', 'federica_bader', 'martamusso', 'diego_moriondo', 'gregoriocolombo12', 'michele.blasco', 'sergio_fierro', 'gervasio', 'giordanocomencini', 'giulia.cornara', 'marcoghiglia', 'gabriele_gatti', 's269258', 'chiesaottavia', 'lorenzobraia', 'gabriele.fasolis', 'dvlom', 'alemarchei', 'edo.bonaventura', 'giulianaberetta', 'lorenzo_menon', 'valentinamarino', 'martamac', 'emanuele.staiessi', 'giuseppep', 'francesco.pelle', 's269938', 'rguo4', 'giuseppe00', 'art3m1sf0wl', 'barbarazacco', 'eliabronzo03', 'deepslakshmi', 'giuseppe.divincenzo21', 'edoardo', 'lollo', 'stdiohs123', 'amadomat', 'alessiofrigato00', 'enricovalentini', 'chidzahi', 'ciabattarichri', 'lucanepote2000', 'tarta56', 'salvatore1', 'shwetabhagat59', 'albertopolato', 'giubileigaia', 'natalia.loizzo1', 'lindafabs', 'pietrog', 'sabina.olenic', 'ivanelefante09', 'federicaderrico', 'ga.costa', 'lucabozza', 'scal', 'margheritabruno0', 'matildebidone', 'vincenzopioelia', 'mattiamode', 'crhistian.sinche', 'niaz_eee', 'angelodaroma00', 'christian.bodo', 'ivan271', 'robertobellelli', 'murgia915', 'luca.posa', 'lucacasassa', 'abubakrjaved93', 'danielebersano', 'santux01', 'matteoc98', None, 's205676', 'ilaria', 'andriguli00', 'river5966', 'miriam.piccinini00', 'ari15', 'davibarbero', 'mattebogg', 'enricomanfredi', 'sabitas1966', 'simona_zetta', 'tausenrico00', 'kevinetor.piccati']"
6,323,104,21,18,"['danielebersano', 'giuseppe00', 'barbarazacco', 'lucanepote2000', 'eliabronzo03', 'frac98', 'davide1234', 'edoardo', 'miriam.piccinini00', 'kevinetor.piccati', 'isaacdelpe', 'simona_zetta', 'chidzahi', 'lorenzo_menon', 'margheritabruno0', 'francesco.pelle', 'martamusso', 'pietrog']",85,"['albispace99', 'alesdu12', 'esachet', 'danilo_cammarata', 'luigipuppo', 'gerardo.castagno', 's270685', 'mattiagallobruno99', 'andreacomberiati', 'saradipa01', 'lorenzo_riggi', 'webtechshri', 's268950', 'etx.dan', 'vicarius', 'federica_bader', 'diego_moriondo', 'gregoriocolombo12', 'michele.blasco', 'sergio_fierro', 'gervasio', 'giordanocomencini', 'giulia.cornara', 'marcoghiglia', 'gabriele_gatti', 's269258', 'chiesaottavia', 'lorenzobraia', 'gabriele.fasolis', 'dvlom', 'alemarchei', 'edo.bonaventura', 'valentinamarino', 'martamac', 'emanuele.staiessi', 'giuseppep', 's269938', 'rguo4', 'art3m1sf0wl', 'deepslakshmi', 'giuseppe.divincenzo21', 'lollo', 'stdiohs123', 'amadomat', 'alessiofrigato00', 'enricovalentini', 'ciabattarichri', 'tarta56', 'salvatore1', 'shwetabhagat59', 'albertopolato', 'giubileigaia', 'natalia.loizzo1', 'lindafabs', 'sabina.olenic', 'ivanelefante09', 'federicaderrico', 'ga.costa', 'lucabozza', 'scal', 'matildebidone', 'vincenzopioelia', 'mattiamode', 'crhistian.sinche', 'niaz_eee', 'angelodaroma00', 'christian.bodo', 'ivan271', 'robertobellelli', 'murgia915', 'luca.posa', 'lucacasassa', 'abubakrjaved93', 'santux01', 'matteoc98', 's205676', 'ilaria', 'andriguli00', 'river5966', 'ari15', 'davibarbero', 'mattebogg', 'enricomanfredi', 'sabitas1966', 'tausenrico00']",3,"['giulianaberetta', None, 'marcocapuuu']",106,"['albispace99', 'frac98', 'alesdu12', 'davide1234', 'esachet', 'danilo_cammarata', 'isaacdelpe', 'luigipuppo', 'gerardo.castagno', 's270685', 'mattiagallobruno99', 'andreacomberiati', 'saradipa01', 'lorenzo_riggi', 'webtechshri', 's268950', 'etx.dan', 'vicarius', 'federica_bader', 'martamusso', 'diego_moriondo', 'gregoriocolombo12', 'michele.blasco', 'sergio_fierro', 'gervasio', 'giordanocomencini', 'giulia.cornara', 'marcoghiglia', 'gabriele_gatti', 's269258', 'chiesaottavia', 'lorenzobraia', 'gabriele.fasolis', 'dvlom', 'alemarchei', 'edo.bonaventura', 'giulianaberetta', 'lorenzo_menon', 'valentinamarino', 'marcocapuuu', 'martamac', 'emanuele.staiessi', 'giuseppep', 'francesco.pelle', 's269938', 'rguo4', 'giuseppe00', 'art3m1sf0wl', 'barbarazacco', 'eliabronzo03', 'deepslakshmi', 'giuseppe.divincenzo21', 'edoardo', 'lollo', 'stdiohs123', 'amadomat', 'alessiofrigato00', 'enricovalentini', 'chidzahi', 'ciabattarichri', 'lucanepote2000', 'tarta56', 'salvatore1', 'shwetabhagat59', 'albertopolato', 'giubileigaia', 'natalia.loizzo1', 'lindafabs', 'pietrog', 'sabina.olenic', 'ivanelefante09', 'federicaderrico', 'ga.costa', 'lucabozza', 'scal', 'margheritabruno0', 'matildebidone', 'vincenzopioelia', 'mattiamode', 'crhistian.sinche', 'niaz_eee', 'angelodaroma00', 'christian.bodo', 'ivan271', 'robertobellelli', 'murgia915', 'luca.posa', 'lucacasassa', 'abubakrjaved93', 'danielebersano', 'santux01', 'matteoc98', None, 's205676', 'ilaria', 'andriguli00', 'river5966', 'miriam.piccinini00', 'ari15', 'davibarbero', 'mattebogg', 'enricomanfredi', 'sabitas1966', 'simona_zetta', 'tausenrico00', 'kevinetor.piccati']"
6,322,104,15,13,"['art3m1sf0wl', 'giuseppe.divincenzo21', 'alessiofrigato00', 'gregoriocolombo12', 'alemarchei', 'mattebogg', 'albertopolato', 'sergio_fierro', 'tausenrico00', 'michele.blasco', 'ciabattarichri', 'ivanelefante09', 'federicaderrico']",90,"['albispace99', 'frac98', 'alesdu12', 'davide1234', 'esachet', 'danilo_cammarata', 'isaacdelpe', 'luigipuppo', 'gerardo.castagno', 's270685', 'mattiagallobruno99', 'andreacomberiati', 'saradipa01', 'lorenzo_riggi', 'webtechshri', 's268950', 'etx.dan', 'vicarius', 'federica_bader', 'martamusso', 'diego_moriondo', 'gervasio', 'giordanocomencini', 'giulia.cornara', 'marcoghiglia', 'gabriele_gatti', 's269258', 'chiesaottavia', 'lorenzobraia', 'gabriele.fasolis', 'dvlom', 'edo.bonaventura', 'lorenzo_menon', 'valentinamarino', 'martamac', 'emanuele.staiessi', 'giuseppep', 'francesco.pelle', 's269938', 'rguo4', 'giuseppe00', 'barbarazacco', 'eliabronzo03', 'deepslakshmi', 'edoardo', 'lollo', 'stdiohs123', 'amadomat', 'enricovalentini', 'chidzahi', 'lucanepote2000', 'tarta56', 'salvatore1', 'shwetabhagat59', 'giubileigaia', 'natalia.loizzo1', 'lindafabs', 'pietrog', 'sabina.olenic', 'ga.costa', 'lucabozza', 'scal', 'margheritabruno0', 'matildebidone', 'vincenzopioelia', 'mattiamode', 'crhistian.sinche', 'niaz_eee', 'angelodaroma00', 'christian.bodo', 'ivan271', 'robertobellelli', 'murgia915', 'luca.posa', 'lucacasassa', 'abubakrjaved93', 'danielebersano', 'santux01', 'matteoc98', 's205676', 'ilaria', 'andriguli00', 'river5966', 'miriam.piccinini00', 'ari15', 'davibarbero', 'enricomanfredi', 'sabitas1966', 'simona_zetta', 'kevinetor.piccati']",2,"['giulianaberetta', None]",105,"['albispace99', 'frac98', 'alesdu12', 'davide1234', 'esachet', 'danilo_cammarata', 'isaacdelpe', 'luigipuppo', 'gerardo.castagno', 's270685', 'mattiagallobruno99', 'andreacomberiati', 'saradipa01', 'lorenzo_riggi', 'webtechshri', 's268950', 'etx.dan', 'vicarius', 'federica_bader', 'martamusso', 'diego_moriondo', 'gregoriocolombo12', 'michele.blasco', 'sergio_fierro', 'gervasio', 'giordanocomencini', 'giulia.cornara', 'marcoghiglia', 'gabriele_gatti', 's269258', 'chiesaottavia', 'lorenzobraia', 'gabriele.fasolis', 'dvlom', 'alemarchei', 'edo.bonaventura', 'giulianaberetta', 'lorenzo_menon', 'valentinamarino', 'martamac', 'emanuele.staiessi', 'giuseppep', 'francesco.pelle', 's269938', 'rguo4', 'giuseppe00', 'art3m1sf0wl', 'barbarazacco', 'eliabronzo03', 'deepslakshmi', 'giuseppe.divincenzo21', 'edoardo', 'lollo', 'stdiohs123', 'amadomat', 'alessiofrigato00', 'enricovalentini', 'chidzahi', 'ciabattarichri', 'lucanepote2000', 'tarta56', 'salvatore1', 'shwetabhagat59', 'albertopolato', 'giubileigaia', 'natalia.loizzo1', 'lindafabs', 'pietrog', 'sabina.olenic', 'ivanelefante09', 'federicaderrico', 'ga.costa', 'lucabozza', 'scal', 'margheritabruno0', 'matildebidone', 'vincenzopioelia', 'mattiamode', 'crhistian.sinche', 'niaz_eee', 'angelodaroma00', 'christian.bodo', 'ivan271', 'robertobellelli', 'murgia915', 'luca.posa', 'lucacasassa', 'abubakrjaved93', 'danielebersano', 'santux01', 'matteoc98', None, 's205676', 'ilaria', 'andriguli00', 'river5966', 'miriam.piccinini00', 'ari15', 'davibarbero', 'mattebogg', 'enricomanfredi', 'sabitas1966', 'simona_zetta', 'tausenrico00', 'kevinetor.piccati']"
6,321,104,9,6,"['ilaria', 'lorenzobraia', 'enricovalentini', 'gerardo.castagno', 'crhistian.sinche', 's205676']",97,"['albispace99', 'frac98', 'alesdu12', 'davide1234', 'esachet', 'danilo_cammarata', 'isaacdelpe', 'luigipuppo', 's270685', 'mattiagallobruno99', 'andreacomberiati', 'saradipa01', 'lorenzo_riggi', 'webtechshri', 's268950', 'etx.dan', 'vicarius', 'federica_bader', 'martamusso', 'diego_moriondo', 'gregoriocolombo12', 'michele.blasco', 'sergio_fierro', 'gervasio', 'giordanocomencini', 'giulia.cornara', 'marcoghiglia', 'gabriele_gatti', 's269258', 'chiesaottavia', 'gabriele.fasolis', 'dvlom', 'alemarchei', 'edo.bonaventura', 'lorenzo_menon', 'valentinamarino', 'martamac', 'emanuele.staiessi', 'giuseppep', 'francesco.pelle', 's269938', 'rguo4', 'giuseppe00', 'art3m1sf0wl', 'barbarazacco', 'eliabronzo03', 'deepslakshmi', 'giuseppe.divincenzo21', 'edoardo', 'lollo', 'stdiohs123', 'amadomat', 'alessiofrigato00', 'chidzahi', 'ciabattarichri', 'lucanepote2000', 'tarta56', 'salvatore1', 'shwetabhagat59', 'albertopolato', 'giubileigaia', 'natalia.loizzo1', 'lindafabs', 'pietrog', 'sabina.olenic', 'ivanelefante09', 'federicaderrico', 'ga.costa', 'lucabozza', 'scal', 'margheritabruno0', 'matildebidone', 'vincenzopioelia', 'mattiamode', 'niaz_eee', 'angelodaroma00', 'christian.bodo', 'ivan271', 'robertobellelli', 'murgia915', 'luca.posa', 'lucacasassa', 'abubakrjaved93', 'danielebersano', 'santux01', 'matteoc98', 'andriguli00', 'river5966', 'miriam.piccinini00', 'ari15', 'davibarbero', 'mattebogg', 'enricomanfredi', 'sabitas1966', 'simona_zetta', 'tausenrico00', 'kevinetor.piccati']",3,"['antonio.ocarino', None, 'riky_casty']",106,"['albispace99', 'frac98', 'alesdu12', 'davide1234', 'esachet', 'danilo_cammarata', 'isaacdelpe', 'luigipuppo', 'gerardo.castagno', 's270685', 'mattiagallobruno99', 'andreacomberiati', 'saradipa01', 'lorenzo_riggi', 'webtechshri', 's268950', 'etx.dan', 'vicarius', 'federica_bader', 'martamusso', 'diego_moriondo', 'gregoriocolombo12', 'michele.blasco', 'sergio_fierro', 'gervasio', 'giordanocomencini', 'giulia.cornara', 'marcoghiglia', 'gabriele_gatti', 's269258', 'chiesaottavia', 'lorenzobraia', 'gabriele.fasolis', 'dvlom', 'alemarchei', 'edo.bonaventura', 'lorenzo_menon', 'valentinamarino', 'martamac', 'emanuele.staiessi', 'giuseppep', 'francesco.pelle', 's269938', 'rguo4', 'giuseppe00', 'art3m1sf0wl', 'barbarazacco', 'eliabronzo03', 'deepslakshmi', 'giuseppe.divincenzo21', 'edoardo', 'lollo', 'stdiohs123', 'amadomat', 'alessiofrigato00', 'enricovalentini', 'chidzahi', 'ciabattarichri', 'lucanepote2000', 'tarta56', 'salvatore1', 'shwetabhagat59', 'albertopolato', 'giubileigaia', 'natalia.loizzo1', 'lindafabs', 'pietrog', 'sabina.olenic', 'ivanelefante09', 'federicaderrico', 'ga.costa', 'lucabozza', 'scal', 'margheritabruno0', 'matildebidone', 'vincenzopioelia', 'mattiamode', 'crhistian.sinche', 'niaz_eee', 'angelodaroma00', 'christian.bodo', 'ivan271', 'antonio.ocarino', 'robertobellelli', 'murgia915', 'luca.posa', 'lucacasassa', 'abubakrjaved93', 'danielebersano', 'santux01', 'matteoc98', None, 's205676', 'ilaria', 'andriguli00', 'river5966', 'miriam.piccinini00', 'ari15', 'davibarbero', 'mattebogg', 'enricomanfredi', 'sabitas1966', 'simona_zetta', 'tausenrico00', 'riky_casty', 'kevinetor.piccati']"
6,320,104,8,6,"['salvatore1', 'gabriele.fasolis', 'davibarbero', 'emanuele.staiessi', 'lucacasassa', 'ga.costa']",97,"['albispace99', 'frac98', 'alesdu12', 'davide1234', 'esachet', 'danilo_cammarata', 'isaacdelpe', 'luigipuppo', 'gerardo.castagno', 's270685', 'mattiagallobruno99', 'andreacomberiati', 'saradipa01', 'lorenzo_riggi', 'webtechshri', 's268950', 'etx.dan', 'vicarius', 'federica_bader', 'martamusso', 'diego_moriondo', 'gregoriocolombo12', 'michele.blasco', 'sergio_fierro', 'gervasio', 'giordanocomencini', 'giulia.cornara', 'marcoghiglia', 'gabriele_gatti', 's269258', 'chiesaottavia', 'lorenzobraia', 'dvlom', 'alemarchei', 'edo.bonaventura', 'lorenzo_menon', 'valentinamarino', 'martamac', 'giuseppep', 'francesco.pelle', 's269938', 'rguo4', 'giuseppe00', 'art3m1sf0wl', 'barbarazacco', 'eliabronzo03', 'deepslakshmi', 'giuseppe.divincenzo21', 'edoardo', 'lollo', 'stdiohs123', 'amadomat', 'alessiofrigato00', 'enricovalentini', 'chidzahi', 'ciabattarichri', 'lucanepote2000', 'tarta56', 'shwetabhagat59', 'albertopolato', 'giubileigaia', 'natalia.loizzo1', 'lindafabs', 'pietrog', 'sabina.olenic', 'ivanelefante09', 'federicaderrico', 'lucabozza', 'scal', 'margheritabruno0', 'matildebidone', 'vincenzopioelia', 'mattiamode', 'crhistian.sinche', 'niaz_eee', 'angelodaroma00', 'christian.bodo', 'ivan271', 'robertobellelli', 'murgia915', 'luca.posa', 'abubakrjaved93', 'danielebersano', 'santux01', 'matteoc98', 's205676', 'ilaria', 'andriguli00', 'river5966', 'miriam.piccinini00', 'ari15', 'mattebogg', 'enricomanfredi', 'sabitas1966', 'simona_zetta', 'tausenrico00', 'kevinetor.piccati']",2,"['brrmatteo', None]",105,"['albispace99', 'frac98', 'alesdu12', 'davide1234', 'esachet', 'danilo_cammarata', 'isaacdelpe', 'luigipuppo', 'gerardo.castagno', 's270685', 'mattiagallobruno99', 'andreacomberiati', 'saradipa01', 'lorenzo_riggi', 'webtechshri', 's268950', 'etx.dan', 'vicarius', 'federica_bader', 'martamusso', 'diego_moriondo', 'gregoriocolombo12', 'michele.blasco', 'sergio_fierro', 'gervasio', 'giordanocomencini', 'giulia.cornara', 'marcoghiglia', 'gabriele_gatti', 's269258', 'chiesaottavia', 'lorenzobraia', 'gabriele.fasolis', 'dvlom', 'alemarchei', 'edo.bonaventura', 'lorenzo_menon', 'valentinamarino', 'martamac', 'emanuele.staiessi', 'giuseppep', 'francesco.pelle', 's269938', 'rguo4', 'giuseppe00', 'art3m1sf0wl', 'barbarazacco', 'eliabronzo03', 'deepslakshmi', 'giuseppe.divincenzo21', 'edoardo', 'lollo', 'stdiohs123', 'amadomat', 'alessiofrigato00', 'enricovalentini', 'chidzahi', 'ciabattarichri', 'lucanepote2000', 'tarta56', 'salvatore1', 'shwetabhagat59', 'albertopolato', 'giubileigaia', 'natalia.loizzo1', 'lindafabs', 'pietrog', 'sabina.olenic', 'ivanelefante09', 'federicaderrico', 'ga.costa', 'lucabozza', 'scal', 'margheritabruno0', 'matildebidone', 'vincenzopioelia', 'mattiamode', 'crhistian.sinche', 'niaz_eee', 'angelodaroma00', 'christian.bodo', 'ivan271', 'brrmatteo', 'robertobellelli', 'murgia915', 'luca.posa', 'lucacasassa', 'abubakrjaved93', 'danielebersano', 'santux01', 'matteoc98', None, 's205676', 'ilaria', 'andriguli00', 'river5966', 'miriam.piccinini00', 'ari15', 'davibarbero', 'mattebogg', 'enricomanfredi', 'sabitas1966', 'simona_zetta', 'tausenrico00', 'kevinetor.piccati']"
7,303,99,74,71,"['rohanv2', 'jiapeiy2', 'mblaauw2', 'mabdal6', 'varuns5', 'xuwenting2000', 'jaboyce2', 'michal3', 'pgardo2', 'lucasrc2', 'azatar3', 'allibur', 'hyunbin2', 'coleck2', 'bsutton3', 'konicek3', 'corynne2', 'sujays2', 'dlee230', 'mlarson7', 'megangb2', 'haoyuli3', 'aatass2', 'bshiang2', 'jlakomy2', 'glevita2', 'jiaruil4', 'jkubota2', 'jordanm7', 'rdelara2', 'jripper2', 'hanzhi2', 'daniel13', 'jrswan2', 'alexmf2', 'jkelle30', 'myassin3', 'msedlak2', 'teb4', 'loutris2', 'kyang37', 'sbhujle2', 'wmendoza1455', 'bremig2', 'mderka3', 'jaeyong2', 'adamato2', 'ninume2', 'wx5', 'schumer2', 'talhat2', 'ns23', 'dosman3', 'amaloto2', 'micahpr2', 'dl20', 'lrs3', 'luketk2', 'huizhit2', 'samuelf4', 'meeraj2', 'bonianp2', 'haibog2', 'noahrh3', 'ewilli47', 'aswett2', 'msaada2', 'zanh2', 'nathane3', 'ymyu2', 'phn4']",27,"['sskala2', 'jihoonp2', 'pmcnutt2', 'alfadel2', 'alekhb2', 'gezhaoxuan', 'dcpang2', 'agallardo96', 'tjoung2', 'hakanyvs', 'kacperr2', 'ericli4', 'sk4', 'vanshg2', 'trishag3', 'swathy123', 'agilani2', 'zhangsj0209', 'ak37', 'ziruiw2', 'aldolp2', 'acnunes2', 'yoonjae3', 'kdapathak', 'depew2', 'chguo2', 'magnaye2']",3,"['kevinkw3', None, 'jornia2']",101,"['varuns5', 'mabdal6', 'alfadel2', 'bsutton3', 'agallardo96', 'jiaruil4', 'jripper2', 'teb4', 'bremig2', 'agilani2', 'zhangsj0209', 'adamato2', 'ninume2', 'wx5', 'dosman3', 'samuelf4', 'acnunes2', 'huizhit2', 'luketk2', 'depew2', 'bonianp2', 'chguo2', 'msaada2', 'haoyuli3', 'jihoonp2', 'allibur', 'gezhaoxuan', 'dcpang2', 'corynne2', 'aatass2', 'jlakomy2', 'bshiang2', 'hakanyvs', 'jkubota2', 'rdelara2', 'sk4', 'vanshg2', 'loutris2', 'kyang37', 'wmendoza1455', 'schumer2', 'talhat2', 'ak37', None, 'ns23', 'ziruiw2', 'alexmf2', 'nathane3', 'daniel13', 'dl20', 'ymyu2', 'rohanv2', 'jiapeiy2', 'pmcnutt2', 'pgardo2', 'lucasrc2', 'jornia2', 'alekhb2', 'kevinkw3', 'hyunbin2', 'konicek3', 'sujays2', 'dlee230', 'jordanm7', 'ericli4', 'mderka3', 'jaeyong2', 'micahpr2', 'lrs3', 'yoonjae3', 'kdapathak', 'aswett2', 'magnaye2', 'sskala2', 'mblaauw2', 'xuwenting2000', 'jaboyce2', 'michal3', 'azatar3', 'coleck2', 'mlarson7', 'megangb2', 'tjoung2', 'kacperr2', 'glevita2', 'hanzhi2', 'jrswan2', 'jkelle30', 'myassin3', 'msedlak2', 'sbhujle2', 'trishag3', 'swathy123', 'amaloto2', 'aldolp2', 'meeraj2', 'haibog2', 'noahrh3', 'ewilli47', 'zanh2', 'phn4']"
7,304,99,10,9,"['rohanv2', 'msedlak2', 'pmcnutt2', 'kdapathak', 'jaboyce2', 'bremig2', 'depew2', 'kacperr2', 'magnaye2']",89,"['varuns5', 'mabdal6', 'jiapeiy2', 'pgardo2', 'lucasrc2', 'alfadel2', 'alekhb2', 'hyunbin2', 'bsutton3', 'konicek3', 'sujays2', 'dlee230', 'agallardo96', 'jiaruil4', 'jordanm7', 'ericli4', 'jripper2', 'alexmf2', 'teb4', 'mderka3', 'agilani2', 'jaeyong2', 'zhangsj0209', 'adamato2', 'ninume2', 'wx5', 'dosman3', 'micahpr2', 'samuelf4', 'acnunes2', 'huizhit2', 'luketk2', 'lrs3', 'yoonjae3', 'bonianp2', 'chguo2', 'msaada2', 'aswett2', 'haoyuli3', 'sskala2', 'mblaauw2', 'jihoonp2', 'xuwenting2000', 'zanh2', 'michal3', 'nathane3', 'allibur', 'azatar3', 'gezhaoxuan', 'coleck2', 'dcpang2', 'corynne2', 'mlarson7', 'megangb2', 'tjoung2', 'aatass2', 'jlakomy2', 'bshiang2', 'hakanyvs', 'glevita2', 'jkubota2', 'rdelara2', 'sk4', 'hanzhi2', 'vanshg2', 'jrswan2', 'loutris2', 'jkelle30', 'myassin3', 'kyang37', 'sbhujle2', 'wmendoza1455', 'trishag3', 'swathy123', 'schumer2', 'talhat2', 'ak37', 'ns23', 'ziruiw2', 'amaloto2', 'aldolp2', 'meeraj2', 'haibog2', 'noahrh3', 'ewilli47', 'daniel13', 'dl20', 'ymyu2', 'phn4']",1,[None],99,"['rohanv2', 'varuns5', 'mabdal6', 'jiapeiy2', 'pmcnutt2', 'pgardo2', 'lucasrc2', 'alfadel2', 'alekhb2', 'hyunbin2', 'bsutton3', 'konicek3', 'sujays2', 'dlee230', 'agallardo96', 'jiaruil4', 'jordanm7', 'ericli4', 'jripper2', 'alexmf2', 'teb4', 'bremig2', 'mderka3', 'agilani2', 'jaeyong2', 'zhangsj0209', 'adamato2', 'ninume2', 'wx5', 'dosman3', 'micahpr2', 'samuelf4', 'acnunes2', 'huizhit2', 'luketk2', 'lrs3', 'yoonjae3', 'kdapathak', 'depew2', 'bonianp2', 'chguo2', 'msaada2', 'aswett2', 'magnaye2', 'haoyuli3', 'sskala2', 'mblaauw2', 'jihoonp2', 'xuwenting2000', 'zanh2', 'jaboyce2', 'michal3', 'nathane3', 'allibur', 'azatar3', 'gezhaoxuan', 'coleck2', 'dcpang2', 'corynne2', 'mlarson7', 'megangb2', 'tjoung2', 'aatass2', 'jlakomy2', 'bshiang2', 'hakanyvs', 'kacperr2', 'glevita2', 'jkubota2', 'rdelara2', 'sk4', 'hanzhi2', 'vanshg2', 'jrswan2', 'loutris2', 'jkelle30', 'myassin3', 'msedlak2', 'kyang37', 'sbhujle2', 'wmendoza1455', 'trishag3', 'swathy123', 'schumer2', 'talhat2', 'ak37', None, 'ns23', 'ziruiw2', 'amaloto2', 'aldolp2', 'meeraj2', 'haibog2', 'noahrh3', 'ewilli47', 'daniel13', 'dl20', 'ymyu2', 'phn4']"
7,305,99,8,7,"['myassin3', 'mabdal6', 'micahpr2', 'acnunes2', 'bremig2', 'agilani2', 'ericli4']",91,"['rohanv2', 'varuns5', 'jiapeiy2', 'pmcnutt2', 'pgardo2', 'lucasrc2', 'alfadel2', 'alekhb2', 'hyunbin2', 'bsutton3', 'konicek3', 'sujays2', 'dlee230', 'agallardo96', 'jiaruil4', 'jordanm7', 'jripper2', 'alexmf2', 'teb4', 'mderka3', 'jaeyong2', 'zhangsj0209', 'adamato2', 'ninume2', 'wx5', 'dosman3', 'samuelf4', 'huizhit2', 'luketk2', 'lrs3', 'yoonjae3', 'kdapathak', 'depew2', 'bonianp2', 'chguo2', 'msaada2', 'aswett2', 'magnaye2', 'haoyuli3', 'sskala2', 'mblaauw2', 'jihoonp2', 'xuwenting2000', 'zanh2', 'jaboyce2', 'michal3', 'nathane3', 'allibur', 'azatar3', 'gezhaoxuan', 'coleck2', 'dcpang2', 'corynne2', 'mlarson7', 'megangb2', 'tjoung2', 'aatass2', 'jlakomy2', 'bshiang2', 'hakanyvs', 'kacperr2', 'glevita2', 'jkubota2', 'rdelara2', 'sk4', 'hanzhi2', 'vanshg2', 'jrswan2', 'loutris2', 'jkelle30', 'msedlak2', 'kyang37', 'sbhujle2', 'wmendoza1455', 'trishag3', 'swathy123', 'schumer2', 'talhat2', 'ak37', 'ns23', 'ziruiw2', 'amaloto2', 'aldolp2', 'meeraj2', 'haibog2', 'noahrh3', 'ewilli47', 'daniel13', 'dl20', 'ymyu2', 'phn4']",1,[None],99,"['rohanv2', 'varuns5', 'mabdal6', 'jiapeiy2', 'pmcnutt2', 'pgardo2', 'lucasrc2', 'alfadel2', 'alekhb2', 'hyunbin2', 'bsutton3', 'konicek3', 'sujays2', 'dlee230', 'agallardo96', 'jiaruil4', 'jordanm7', 'ericli4', 'jripper2', 'alexmf2', 'teb4', 'bremig2', 'mderka3', 'agilani2', 'jaeyong2', 'zhangsj0209', 'adamato2', 'ninume2', 'wx5', 'dosman3', 'micahpr2', 'samuelf4', 'acnunes2', 'huizhit2', 'luketk2', 'lrs3', 'yoonjae3', 'kdapathak', 'depew2', 'bonianp2', 'chguo2', 'msaada2', 'aswett2', 'magnaye2', 'haoyuli3', 'sskala2', 'mblaauw2', 'jihoonp2', 'xuwenting2000', 'zanh2', 'jaboyce2', 'michal3', 'nathane3', 'allibur', 'azatar3', 'gezhaoxuan', 'coleck2', 'dcpang2', 'corynne2', 'mlarson7', 'megangb2', 'tjoung2', 'aatass2', 'jlakomy2', 'bshiang2', 'hakanyvs', 'kacperr2', 'glevita2', 'jkubota2', 'rdelara2', 'sk4', 'hanzhi2', 'vanshg2', 'jrswan2', 'loutris2', 'jkelle30', 'myassin3', 'msedlak2', 'kyang37', 'sbhujle2', 'wmendoza1455', 'trishag3', 'swathy123', 'schumer2', 'talhat2', 'ak37', None, 'ns23', 'ziruiw2', 'amaloto2', 'aldolp2', 'meeraj2', 'haibog2', 'noahrh3', 'ewilli47', 'daniel13', 'dl20', 'ymyu2', 'phn4']"
8,222,92,151,4,"['rjammula', 'clancy6', 'estockwe', 'rkeyser']",87,"['ramkumaa', 'hshrote', 'kapurdue20', 'nqmain', 'ggathura', 'ctavs002', 'dick21', 'carvalho', 'cfeustel', 'nvorrasa', 'cdunn', 'liu1837', 'wang4039', 'missahaq', 'mill2201', 'jack.t.roy42', 'seanm', 'ctorger', 'ztowne', 'zosterlo', 'rfranco', 'mfroelic', 'akhairul', 'lpl', 'amasaeng', 'sachdev6', 'balpert', 'clark600', 'chen2467', 'kiaramcclue', 'li2978', 'liang377', 'jsendon', 'konstantin', 'ahmad44', 'cmandrel', 'smit3522', 'lucasmartin', 'ysy39714', 'kim2841', 'chakra26', 'popp4', 'kalothm', 'huan1260', 'yu780', 'liu1809', 'bauer85', 'aalhabsi', 'lhoppenr', 'bianchik', 'sujal.yagnik', 'randy14rhh2', 'acarrilh', 'cstrider', 'mxlin01', 'imran1', 'scott483', 'acharter16', 'cannon333', 'igueth', 'vfebus', 'campb294', 'audyavar', 'dildyks', 'wells130', 'york33', 'haoyangliu', 'jvanwing', 'mlennar', 'jacobczajac', 'beshay', 'park439', 'kerre', 'anindobagchi', 'marysemak', 'jzwierz', 'gdadlani', 'crawfo76', 'kleber0', 'jabarigarraway', 'yang1098', 'azovko', 'atkins27', 'boston2', 'lararipe', 'noah.stern99', 'dhanixv0']",147,"['ahaseno', 'lamz', 'rvannucc', 'balsudea', 'jflatto', 'jnedohin', 'khan318', 'alfanon', 'hickey22', 'strangn', 'ngallek', 'wils1010', 'wang4229', 'ncubides', 'salves', 'liu2512', 'jjavier', 'npfeffer', 'cohen83', 'tksrhktkfka', 'gwyman', 'blabell', 'marks65', 'rsahagun', 'kim1857', 'mnesci18', 'gould27', 'rojas30', 'costel14', 'xng', 'wen126', 'bhausman', 'gesosav', 'gfeldbe', 'burson', 'farrowm', 'rschene', 'kayuba', 'pseifert', 'cleinhei', 'ddilksan', 'gcrim', 'lee3777', 'psandlin', 'rmarcha', 'pasperry', 'hanson90', 'mart1852', 'ichavan', 'wlindse', 'beck160', 'jngassaf', 'hardin44', None, 'bhardw10', 'teng26', 'biglera', 'jsching', 'schakinala02', 'mayhew0', 'hhackett', 'hedges9', 'romack0', 'peck28', 'kundu5', 'nrrobins', 'wrigh577', 'chang635', 'mciccon', 'skhomphe', 'ecobos', 'mgobry', 'msiliton', 'vmimsbor', 'iwus', 'kmuenpra', 'song666', 'cliffom', 'anomi', 'xu1392', 'vfarrell', 'christer913', 'zhao969', 'raghavauppuluri13', 'coope348', 'xu1493', 'lheirty', 'rgadre', 'yu915', 'dcowden', 'tmoore', 'nbabusis', 'eerivona', 'ahockma', 'rasbb31', 'mobernes', 'nessc', 'moreno80', 'hanna35', 'zrainey', 'pate1260', 'mart1773', 'englis15', 'kbonvill', 'potter56', 'stinsons', 'ameyerja', 'tamicon', 'tkedlaya', 'carr94', 'mmahale', 'harri870', 'wong313', 'tao97', 'jwosiak', 'rgodjali', 'barrer10', 'hong286', 'fdiago', 'tlirette', 'ebarranc', 'jmushru', 'jczhu', 'holman10', 'pbaugh', 'ebasem', 'nmeer', 'nbwilkin', 'bsfar', 'knigh114', 'woods183', 'goel53', 'bayuan', 'butkus0', 'doyle109', 'mmaga', 'rlopezpa', 'evans415', 'gomez195', 'long320', 'eavey', 'asinks', 'mill2708', 'spohle', 'mvillel', 'nganti', 'wang4444']",238,"['ahaseno', 'lamz', 'ramkumaa', 'hshrote', 'rvannucc', 'balsudea', 'jflatto', 'kapurdue20', 'jnedohin', 'nqmain', 'ggathura', 'khan318', 'alfanon', 'ctavs002', 'dick21', 'carvalho', 'cfeustel', 'nvorrasa', 'hickey22', 'cdunn', 'liu1837', 'strangn', 'wang4039', 'missahaq', 'clancy6', 'mill2201', 'jack.t.roy42', 'ngallek', 'seanm', 'wils1010', 'ctorger', 'ztowne', 'zosterlo', 'rfranco', 'mfroelic', 'wang4229', 'ncubides', 'salves', 'liu2512', 'jjavier', 'npfeffer', 'cohen83', 'akhairul', 'lpl', 'tksrhktkfka', 'gwyman', 'amasaeng', 'blabell', 'sachdev6', 'balpert', 'clark600', 'chen2467', 'kiaramcclue', 'marks65', 'li2978', 'rsahagun', 'kim1857', 'mnesci18', 'gould27', 'rojas30', 'costel14', 'liang377', 'xng', 'wen126', 'bhausman', 'jsendon', 'konstantin', 'ahmad44', 'cmandrel', 'gesosav', 'gfeldbe', 'smit3522', 'lucasmartin', 'burson', 'ysy39714', 'kim2841', 'farrowm', 'rschene', 'chakra26', 'kayuba', 'pseifert', 'cleinhei', 'popp4', 'kalothm', 'ddilksan', 'huan1260', 'gcrim', 'yu780', 'lee3777', 'psandlin', 'liu1809', 'bauer85', 'rmarcha', 'pasperry', 'hanson90', 'mart1852', 'ichavan', 'wlindse', 'aalhabsi', 'lhoppenr', 'beck160', 'bianchik', 'jngassaf', 'hardin44', None, 'bhardw10', 'teng26', 'biglera', 'jsching', 'schakinala02', 'mayhew0', 'sujal.yagnik', 'hhackett', 'hedges9', 'randy14rhh2', 'romack0', 'peck28', 'kundu5', 'acarrilh', 'nrrobins', 'wrigh577', 'chang635', 'mciccon', 'cstrider', 'mxlin01', 'skhomphe', 'ecobos', 'imran1', 'mgobry', 'estockwe', 'msiliton', 'vmimsbor', 'iwus', 'kmuenpra', 'scott483', 'song666', 'cliffom', 'anomi', 'acharter16', 'xu1392', 'vfarrell', 'christer913', 'cannon333', 'zhao969', 'igueth', 'raghavauppuluri13', 'coope348', 'xu1493', 'vfebus', 'lheirty', 'rgadre', 'yu915', 'dcowden', 'campb294', 'tmoore', 'nbabusis', 'eerivona', 'ahockma', 'rasbb31', 'mobernes', 'nessc', 'moreno80', 'hanna35', 'audyavar', 'zrainey', 'dildyks', 'pate1260', 'mart1773', 'englis15', 'kbonvill', 'potter56', 'wells130', 'stinsons', 'ameyerja', 'tamicon', 'york33', 'tkedlaya', 'carr94', 'rkeyser', 'mmahale', 'harri870', 'haoyangliu', 'wong313', 'tao97', 'jvanwing', 'jwosiak', 'rgodjali', 'barrer10', 'hong286', 'fdiago', 'mlennar', 'tlirette', 'jacobczajac', 'ebarranc', 'jmushru', 'jczhu', 'holman10', 'pbaugh', 'ebasem', 'beshay', 'nmeer', 'park439', 'kerre', 'nbwilkin', 'anindobagchi', 'marysemak', 'bsfar', 'jzwierz', 'gdadlani', 'knigh114', 'woods183', 'goel53', 'crawfo76', 'kleber0', 'bayuan', 'jabarigarraway', 'yang1098', 'butkus0', 'doyle109', 'mmaga', 'azovko', 'rlopezpa', 'rjammula', 'evans415', 'gomez195', 'long320', 'eavey', 'asinks', 'mill2708', 'atkins27', 'boston2', 'lararipe', 'spohle', 'mvillel', 'noah.stern99', 'nganti', 'dhanixv0', 'wang4444']"
8,270,92,115,53,"['jsendon', 'ahmad44', 'hshrote', 'smit3522', 'cstrider', 'mlennar', 'nqmain', 'imran1', 'estockwe', 'jacobczajac', 'kim2841', 'dick21', 'carvalho', 'beshay', 'acharter16', 'cfeustel', 'cdunn', 'popp4', 'huan1260', 'missahaq', 'jzwierz', 'mill2201', 'jack.t.roy42', 'crawfo76', 'kleber0', 'yu780', 'vfebus', 'mfroelic', 'rfranco', 'campb294', 'jabarigarraway', 'bauer85', 'yang1098', 'azovko', 'rjammula', 'aalhabsi', 'akhairul', 'lhoppenr', 'bianchik', 'audyavar', 'dildyks', 'lararipe', 'sachdev6', 'balpert', 'clark600', 'li2978', 'sujal.yagnik', 'rkeyser', 'randy14rhh2', 'haoyangliu', 'noah.stern99', 'dhanixv0', 'acarrilh']",38,"['konstantin', 'cmandrel', 'ramkumaa', 'lucasmartin', 'mxlin01', 'kapurdue20', 'ggathura', 'ctavs002', 'ysy39714', 'scott483', 'nvorrasa', 'chakra26', 'liu1837', 'park439', 'kalothm', 'wang4039', 'cannon333', 'kerre', 'anindobagchi', 'marysemak', 'gdadlani', 'igueth', 'clancy6', 'seanm', 'ztowne', 'ctorger', 'zosterlo', 'liu1809', 'lpl', 'atkins27', 'boston2', 'wells130', 'amasaeng', 'chen2467', 'kiaramcclue', 'york33', 'liang377', 'jvanwing']",62,"['claytkg', 'bohangni', 'boyer23', 'kbalon2599', 'nhelstro', 'aomoniy', 'shonnigf', 'king399', 'hamadeo', 'aklitzin', 'tcounse', 'amatus', 'hartm109', 'wheffern', 'rookie7201', 'aaryanp', 'lorenz17', 'wu1283', 'rach', 'webbie.mao', 'wiley29', 'malone99', 'jkliebh', 'cdiscoe', 'max_pack', 'czrelak', 'hogan46', 'nquick', 'ayusabrina.asas', 'glut3n', 'cdenoo', 'kerr32', 'li3422', 'carls127', 'swiftl116', 'mills21rdp', 'dmarcha', 'kerr38', 'castil77', 'dawson41', 'mglimche', 'alexge', 'lazaraleksic', 'lucas120', 'harter4', None, 'gu256', 'jayaramm', 'ngeer', 'lcaspari', 'mqz857277715', 'beckpe', 'pdahlstr', 'glaneve', 'zyao16811', 'hutchi47', 'duarte3', 'robin498', 'joecasella252', 'huan1318', 'soni12', 'campb335']",153,"['ramkumaa', 'hshrote', 'kbalon2599', 'nhelstro', 'kapurdue20', 'shonnigf', 'nqmain', 'ggathura', 'aklitzin', 'ctavs002', 'hartm109', 'dick21', 'carvalho', 'rookie7201', 'aaryanp', 'cfeustel', 'nvorrasa', 'cdunn', 'rach', 'webbie.mao', 'liu1837', 'wang4039', 'missahaq', 'clancy6', 'mill2201', 'jack.t.roy42', 'seanm', 'ctorger', 'ztowne', 'zosterlo', 'rfranco', 'mfroelic', 'cdenoo', 'glut3n', 'mills21rdp', 'dmarcha', 'kerr38', 'akhairul', 'lpl', 'mglimche', 'lcaspari', 'amasaeng', 'sachdev6', 'balpert', 'clark600', 'chen2467', 'kiaramcclue', 'li2978', 'robin498', 'liang377', 'jsendon', 'konstantin', 'ahmad44', 'cmandrel', 'smit3522', 'lucasmartin', 'hamadeo', 'tcounse', 'ysy39714', 'kim2841', 'lorenz17', 'chakra26', 'wiley29', 'popp4', 'malone99', 'kalothm', 'huan1260', 'max_pack', 'nquick', 'yu780', 'liu1809', 'bauer85', 'carls127', 'castil77', 'aalhabsi', 'lhoppenr', 'bianchik', 'alexge', None, 'gu256', 'mqz857277715', 'glaneve', 'sujal.yagnik', 'randy14rhh2', 'soni12', 'acarrilh', 'cstrider', 'mxlin01', 'king399', 'imran1', 'estockwe', 'amatus', 'wheffern', 'scott483', 'acharter16', 'jkliebh', 'cannon333', 'igueth', 'czrelak', 'ayusabrina.asas', 'vfebus', 'campb294', 'li3422', 'dawson41', 'audyavar', 'dildyks', 'harter4', 'wells130', 'beckpe', 'pdahlstr', 'zyao16811', 'hutchi47', 'duarte3', 'york33', 'joecasella252', 'rkeyser', 'haoyangliu', 'campb335', 'jvanwing', 'claytkg', 'bohangni', 'boyer23', 'mlennar', 'aomoniy', 'jacobczajac', 'beshay', 'wu1283', 'park439', 'kerre', 'anindobagchi', 'marysemak', 'cdiscoe', 'jzwierz', 'gdadlani', 'hogan46', 'crawfo76', 'kleber0', 'jabarigarraway', 'yang1098', 'kerr32', 'azovko', 'swiftl116', 'rjammula', 'lazaraleksic', 'lucas120', 'jayaramm', 'atkins27', 'boston2', 'ngeer', 'lararipe', 'huan1318', 'noah.stern99', 'dhanixv0']"
8,273,92,107,47,"['jsendon', 'ahmad44', 'hshrote', 'cstrider', 'mlennar', 'nqmain', 'imran1', 'estockwe', 'kim2841', 'dick21', 'carvalho', 'beshay', 'cfeustel', 'cdunn', 'huan1260', 'jzwierz', 'mill2201', 'jack.t.roy42', 'crawfo76', 'kleber0', 'yu780', 'vfebus', 'mfroelic', 'rfranco', 'campb294', 'jabarigarraway', 'bauer85', 'yang1098', 'azovko', 'rjammula', 'aalhabsi', 'akhairul', 'bianchik', 'audyavar', 'dildyks', 'lararipe', 'sachdev6', 'balpert', 'clark600', 'li2978', 'sujal.yagnik', 'rkeyser', 'randy14rhh2', 'haoyangliu', 'noah.stern99', 'dhanixv0', 'acarrilh']",44,"['konstantin', 'cmandrel', 'ramkumaa', 'smit3522', 'lucasmartin', 'mxlin01', 'kapurdue20', 'jacobczajac', 'ggathura', 'ctavs002', 'ysy39714', 'scott483', 'acharter16', 'nvorrasa', 'chakra26', 'liu1837', 'popp4', 'kalothm', 'wang4039', 'cannon333', 'park439', 'kerre', 'missahaq', 'anindobagchi', 'igueth', 'clancy6', 'marysemak', 'gdadlani', 'seanm', 'ztowne', 'ctorger', 'zosterlo', 'liu1809', 'lhoppenr', 'lpl', 'atkins27', 'boston2', 'wells130', 'amasaeng', 'chen2467', 'kiaramcclue', 'york33', 'liang377', 'jvanwing']",60,"['claytkg', 'bohangni', 'boyer23', 'kbalon2599', 'nhelstro', 'aomoniy', 'king399', 'hamadeo', 'aklitzin', 'tcounse', 'amatus', 'hartm109', 'wheffern', 'rookie7201', 'lorenz17', 'ehultman', 'wu1283', 'rach', 'webbie.mao', 'wiley29', 'malone99', 'jkliebh', 'kortee', 'max_pack', 'czrelak', 'hogan46', 'nquick', 'ayusabrina.asas', 'cdenoo', 'kerr32', 'li3422', 'carls127', 'swiftl116', 'dmarcha', 'kerr38', 'castil77', 'mglimche', 'alexge', 'lazaraleksic', 'hrubyr', 'harter4', 'lucas120', None, 'gu256', 'sboelitz', 'scroskey', 'jayaramm', 'ngeer', 'mqz857277715', 'beckpe', 'pdahlstr', 'glaneve', 'zyao16811', 'hutchi47', 'duarte3', 'robin498', 'joecasella252', 'soni12', 'mullin21', 'campb335']",151,"['ramkumaa', 'hshrote', 'kbalon2599', 'nhelstro', 'kapurdue20', 'nqmain', 'ggathura', 'aklitzin', 'ctavs002', 'hartm109', 'dick21', 'carvalho', 'rookie7201', 'cfeustel', 'nvorrasa', 'cdunn', 'rach', 'webbie.mao', 'liu1837', 'wang4039', 'missahaq', 'clancy6', 'mill2201', 'jack.t.roy42', 'seanm', 'ctorger', 'ztowne', 'zosterlo', 'rfranco', 'mfroelic', 'cdenoo', 'dmarcha', 'kerr38', 'akhairul', 'lpl', 'mglimche', 'sboelitz', 'amasaeng', 'sachdev6', 'balpert', 'clark600', 'chen2467', 'kiaramcclue', 'li2978', 'robin498', 'liang377', 'jsendon', 'konstantin', 'ahmad44', 'cmandrel', 'smit3522', 'lucasmartin', 'hamadeo', 'tcounse', 'ysy39714', 'kim2841', 'lorenz17', 'chakra26', 'wiley29', 'popp4', 'malone99', 'kalothm', 'huan1260', 'max_pack', 'nquick', 'yu780', 'liu1809', 'bauer85', 'carls127', 'castil77', 'aalhabsi', 'lhoppenr', 'bianchik', 'alexge', None, 'gu256', 'scroskey', 'mqz857277715', 'glaneve', 'sujal.yagnik', 'randy14rhh2', 'soni12', 'acarrilh', 'cstrider', 'mxlin01', 'king399', 'imran1', 'estockwe', 'amatus', 'wheffern', 'scott483', 'acharter16', 'jkliebh', 'cannon333', 'igueth', 'czrelak', 'ayusabrina.asas', 'vfebus', 'campb294', 'li3422', 'audyavar', 'dildyks', 'harter4', 'wells130', 'beckpe', 'pdahlstr', 'zyao16811', 'hutchi47', 'duarte3', 'york33', 'joecasella252', 'rkeyser', 'haoyangliu', 'mullin21', 'campb335', 'jvanwing', 'claytkg', 'bohangni', 'boyer23', 'mlennar', 'aomoniy', 'jacobczajac', 'beshay', 'ehultman', 'wu1283', 'park439', 'kerre', 'kortee', 'anindobagchi', 'marysemak', 'jzwierz', 'gdadlani', 'hogan46', 'crawfo76', 'kleber0', 'jabarigarraway', 'yang1098', 'kerr32', 'azovko', 'swiftl116', 'rjammula', 'lazaraleksic', 'hrubyr', 'lucas120', 'jayaramm', 'atkins27', 'boston2', 'ngeer', 'lararipe', 'noah.stern99', 'dhanixv0']"
8,217,92,40,22,"['jacobczajac', 'nqmain', 'estockwe', 'kim2841', 'beshay', 'carvalho', 'cdunn', 'cannon333', 'huan1260', 'missahaq', 'jabarigarraway', 'yang1098', 'aalhabsi', 'akhairul', 'lararipe', 'sachdev6', 'balpert', 'clark600', 'li2978', 'randy14rhh2', 'dhanixv0', 'acarrilh']",69,"['jsendon', 'konstantin', 'ahmad44', 'cmandrel', 'ramkumaa', 'hshrote', 'smit3522', 'lucasmartin', 'cstrider', 'kapurdue20', 'mxlin01', 'imran1', 'ggathura', 'mlennar', 'ctavs002', 'ysy39714', 'dick21', 'scott483', 'acharter16', 'cfeustel', 'nvorrasa', 'chakra26', 'liu1837', 'popp4', 'kalothm', 'wang4039', 'park439', 'kerre', 'anindobagchi', 'marysemak', 'jzwierz', 'igueth', 'clancy6', 'gdadlani', 'mill2201', 'jack.t.roy42', 'crawfo76', 'seanm', 'yu780', 'vfebus', 'kleber0', 'ztowne', 'ctorger', 'rfranco', 'mfroelic', 'zosterlo', 'liu1809', 'bauer85', 'campb294', 'azovko', 'rjammula', 'lhoppenr', 'bianchik', 'lpl', 'audyavar', 'dildyks', 'atkins27', 'boston2', 'wells130', 'amasaeng', 'chen2467', 'kiaramcclue', 'york33', 'sujal.yagnik', 'rkeyser', 'noah.stern99', 'haoyangliu', 'liang377', 'jvanwing']",18,"['lopez400', 'kerr35', 'mosterk', 'wiley29', 'shah443', 'anifalak', 'barker56', 'kocher1', 'wells89', 'aalruhai', 'mchrisiglesias717', 'sboelitz', 'lucywagner', 'cwalchle', None, 'malhamm', 'arayapro', 'scroskey']",109,"['ramkumaa', 'hshrote', 'cstrider', 'mxlin01', 'kapurdue20', 'nqmain', 'ggathura', 'imran1', 'estockwe', 'barker56', 'ctavs002', 'dick21', 'carvalho', 'scott483', 'acharter16', 'cfeustel', 'nvorrasa', 'cdunn', 'liu1837', 'cannon333', 'wang4039', 'missahaq', 'igueth', 'clancy6', 'mill2201', 'jack.t.roy42', 'wells89', 'seanm', 'vfebus', 'kocher1', 'ctorger', 'ztowne', 'zosterlo', 'rfranco', 'mfroelic', 'campb294', 'akhairul', 'lpl', 'audyavar', 'dildyks', 'sboelitz', 'lopez400', 'wells130', 'amasaeng', 'kerr35', 'sachdev6', 'balpert', 'clark600', 'chen2467', 'kiaramcclue', 'li2978', 'york33', 'anifalak', 'rkeyser', 'haoyangliu', 'cwalchle', 'liang377', 'jvanwing', 'jsendon', 'konstantin', 'ahmad44', 'cmandrel', 'smit3522', 'lucasmartin', 'mlennar', 'jacobczajac', 'ysy39714', 'kim2841', 'mchrisiglesias717', 'beshay', 'chakra26', 'wiley29', 'popp4', 'park439', 'kalothm', 'kerre', 'anindobagchi', 'marysemak', 'huan1260', 'jzwierz', 'gdadlani', 'crawfo76', 'kleber0', 'yu780', 'malhamm', 'arayapro', 'liu1809', 'jabarigarraway', 'bauer85', 'yang1098', 'aalruhai', 'azovko', 'mosterk', 'rjammula', 'aalhabsi', 'lhoppenr', 'bianchik', 'shah443', None, 'atkins27', 'boston2', 'scroskey', 'lararipe', 'sujal.yagnik', 'randy14rhh2', 'noah.stern99', 'lucywagner', 'dhanixv0', 'acarrilh']"
8,271,92,33,12,"['chakra26', 'wells130', 'cdunn', 'jvanwing', 'chen2467', 'gdadlani', 'york33', 'clancy6', 'haoyangliu', 'ctorger', 'zosterlo', 'boston2']",79,"['ramkumaa', 'hshrote', 'kapurdue20', 'nqmain', 'ggathura', 'ctavs002', 'dick21', 'carvalho', 'cfeustel', 'nvorrasa', 'liu1837', 'wang4039', 'missahaq', 'mill2201', 'jack.t.roy42', 'seanm', 'ztowne', 'mfroelic', 'rfranco', 'akhairul', 'lpl', 'amasaeng', 'sachdev6', 'balpert', 'clark600', 'kiaramcclue', 'li2978', 'liang377', 'jsendon', 'konstantin', 'ahmad44', 'cmandrel', 'smit3522', 'lucasmartin', 'ysy39714', 'kim2841', 'popp4', 'kalothm', 'huan1260', 'yu780', 'liu1809', 'bauer85', 'aalhabsi', 'lhoppenr', 'bianchik', 'sujal.yagnik', 'randy14rhh2', 'acarrilh', 'cstrider', 'mxlin01', 'imran1', 'estockwe', 'scott483', 'acharter16', 'cannon333', 'igueth', 'vfebus', 'campb294', 'audyavar', 'dildyks', 'rkeyser', 'mlennar', 'jacobczajac', 'beshay', 'park439', 'kerre', 'anindobagchi', 'marysemak', 'jzwierz', 'crawfo76', 'kleber0', 'jabarigarraway', 'yang1098', 'azovko', 'rjammula', 'atkins27', 'lararipe', 'noah.stern99', 'dhanixv0']",21,"['ktbrode22', 'aguarner', 'lfabries', 'pike14', 'tchen135', 'sarawhite99', 'ldefrei', 'hall488', 'mohamadn', 'eklueppe', 'kkrinnin', 'mtallman', 'elutgen', None, 'ronny927', 'jayaramm', 'mpugsley', 'gotoa', 'wu1326', 'camronn.hale', 'campb335']",112,"['ktbrode22', 'ramkumaa', 'hshrote', 'cstrider', 'mxlin01', 'kapurdue20', 'nqmain', 'ggathura', 'imran1', 'estockwe', 'ctavs002', 'dick21', 'carvalho', 'scott483', 'acharter16', 'cfeustel', 'nvorrasa', 'cdunn', 'liu1837', 'cannon333', 'wang4039', 'missahaq', 'igueth', 'clancy6', 'mill2201', 'jack.t.roy42', 'ldefrei', 'seanm', 'vfebus', 'ctorger', 'ztowne', 'zosterlo', 'rfranco', 'mfroelic', 'campb294', 'eklueppe', 'akhairul', 'lpl', 'audyavar', 'dildyks', 'kkrinnin', 'elutgen', 'ronny927', 'wells130', 'amasaeng', 'mpugsley', 'sachdev6', 'balpert', 'clark600', 'chen2467', 'kiaramcclue', 'li2978', 'york33', 'rkeyser', 'wu1326', 'haoyangliu', 'camronn.hale', 'liang377', 'campb335', 'jvanwing', 'jsendon', 'konstantin', 'ahmad44', 'cmandrel', 'aguarner', 'smit3522', 'lucasmartin', 'mlennar', 'jacobczajac', 'lfabries', 'pike14', 'tchen135', 'ysy39714', 'kim2841', 'beshay', 'chakra26', 'sarawhite99', 'popp4', 'park439', 'kalothm', 'kerre', 'anindobagchi', 'marysemak', 'huan1260', 'jzwierz', 'gdadlani', 'crawfo76', 'kleber0', 'yu780', 'hall488', 'liu1809', 'jabarigarraway', 'bauer85', 'yang1098', 'mohamadn', 'azovko', 'rjammula', 'aalhabsi', 'lhoppenr', 'bianchik', 'mtallman', None, 'jayaramm', 'atkins27', 'boston2', 'gotoa', 'lararipe', 'sujal.yagnik', 'randy14rhh2', 'noah.stern99', 'dhanixv0', 'acarrilh']"
8,223,92,21,1,['clancy6'],90,"['ramkumaa', 'hshrote', 'cstrider', 'mxlin01', 'kapurdue20', 'nqmain', 'ggathura', 'imran1', 'estockwe', 'ctavs002', 'dick21', 'carvalho', 'scott483', 'acharter16', 'cfeustel', 'nvorrasa', 'cdunn', 'liu1837', 'cannon333', 'wang4039', 'missahaq', 'igueth', 'mill2201', 'jack.t.roy42', 'seanm', 'vfebus', 'ctorger', 'ztowne', 'zosterlo', 'rfranco', 'mfroelic', 'campb294', 'akhairul', 'lpl', 'audyavar', 'dildyks', 'wells130', 'amasaeng', 'sachdev6', 'balpert', 'clark600', 'chen2467', 'kiaramcclue', 'li2978', 'york33', 'rkeyser', 'haoyangliu', 'liang377', 'jvanwing', 'jsendon', 'konstantin', 'ahmad44', 'cmandrel', 'smit3522', 'lucasmartin', 'mlennar', 'jacobczajac', 'ysy39714', 'kim2841', 'beshay', 'chakra26', 'popp4', 'park439', 'kalothm', 'kerre', 'anindobagchi', 'marysemak', 'huan1260', 'jzwierz', 'gdadlani', 'crawfo76', 'kleber0', 'yu780', 'liu1809', 'jabarigarraway', 'bauer85', 'yang1098', 'azovko', 'rjammula', 'aalhabsi', 'lhoppenr', 'bianchik', 'atkins27', 'boston2', 'lararipe', 'sujal.yagnik', 'randy14rhh2', 'noah.stern99', 'dhanixv0', 'acarrilh']",20,"['mtorrisi', 'ssabrol', 'hogan54', 'liang289', 'fgoode', 'zhou1120', 'tang540', 'murph449', 'cho313', 'dcoomber', 'john2055', 'matredwa', 'moreno80', None, 'bjesiek', 'jmworthi', 'hedges9', 'sfaruqi', 'jwaterwo', 'mohdraml']",111,"['ramkumaa', 'ssabrol', 'hshrote', 'cstrider', 'mxlin01', 'liang289', 'kapurdue20', 'nqmain', 'ggathura', 'imran1', 'estockwe', 'ctavs002', 'zhou1120', 'dick21', 'tang540', 'carvalho', 'scott483', 'acharter16', 'cfeustel', 'nvorrasa', 'cdunn', 'liu1837', 'cannon333', 'wang4039', 'missahaq', 'igueth', 'clancy6', 'mill2201', 'jack.t.roy42', 'seanm', 'vfebus', 'john2055', 'ctorger', 'ztowne', 'zosterlo', 'rfranco', 'mfroelic', 'campb294', 'akhairul', 'moreno80', 'lpl', 'audyavar', 'dildyks', 'wells130', 'amasaeng', 'mohdraml', 'sachdev6', 'balpert', 'clark600', 'chen2467', 'kiaramcclue', 'li2978', 'york33', 'jmworthi', 'rkeyser', 'haoyangliu', 'liang377', 'jvanwing', 'jsendon', 'konstantin', 'ahmad44', 'cmandrel', 'mtorrisi', 'smit3522', 'lucasmartin', 'hogan54', 'mlennar', 'jacobczajac', 'ysy39714', 'kim2841', 'fgoode', 'beshay', 'chakra26', 'murph449', 'popp4', 'park439', 'kalothm', 'kerre', 'anindobagchi', 'marysemak', 'huan1260', 'jzwierz', 'gdadlani', 'cho313', 'crawfo76', 'kleber0', 'yu780', 'dcoomber', 'liu1809', 'jabarigarraway', 'bauer85', 'yang1098', 'azovko', 'matredwa', 'rjammula', 'aalhabsi', 'lhoppenr', 'bianchik', None, 'atkins27', 'boston2', 'lararipe', 'bjesiek', 'sujal.yagnik', 'hedges9', 'randy14rhh2', 'noah.stern99', 'sfaruqi', 'dhanixv0', 'jwaterwo', 'acarrilh']"
8,218,92,10,6,"['chakra26', 'wells130', 'bauer85', 'cdunn', 'marysemak', 'jvanwing']",85,"['ramkumaa', 'hshrote', 'cstrider', 'mxlin01', 'kapurdue20', 'nqmain', 'ggathura', 'imran1', 'estockwe', 'ctavs002', 'dick21', 'carvalho', 'scott483', 'acharter16', 'cfeustel', 'nvorrasa', 'liu1837', 'cannon333', 'wang4039', 'missahaq', 'igueth', 'clancy6', 'mill2201', 'jack.t.roy42', 'seanm', 'vfebus', 'ctorger', 'ztowne', 'zosterlo', 'rfranco', 'mfroelic', 'campb294', 'akhairul', 'lpl', 'audyavar', 'dildyks', 'amasaeng', 'sachdev6', 'balpert', 'clark600', 'chen2467', 'kiaramcclue', 'li2978', 'york33', 'rkeyser', 'haoyangliu', 'liang377', 'jsendon', 'konstantin', 'ahmad44', 'cmandrel', 'smit3522', 'lucasmartin', 'mlennar', 'jacobczajac', 'ysy39714', 'kim2841', 'beshay', 'popp4', 'park439', 'kalothm', 'kerre', 'anindobagchi', 'huan1260', 'jzwierz', 'gdadlani', 'crawfo76', 'kleber0', 'yu780', 'liu1809', 'jabarigarraway', 'yang1098', 'azovko', 'rjammula', 'aalhabsi', 'lhoppenr', 'bianchik', 'atkins27', 'boston2', 'lararipe', 'sujal.yagnik', 'randy14rhh2', 'noah.stern99', 'dhanixv0', 'acarrilh']",4,"['sen16', 'jsomm99', 'elutgen', None]",95,"['ramkumaa', 'hshrote', 'cstrider', 'mxlin01', 'kapurdue20', 'nqmain', 'ggathura', 'imran1', 'estockwe', 'ctavs002', 'dick21', 'carvalho', 'scott483', 'acharter16', 'cfeustel', 'nvorrasa', 'cdunn', 'liu1837', 'cannon333', 'wang4039', 'jsomm99', 'missahaq', 'igueth', 'clancy6', 'mill2201', 'jack.t.roy42', 'seanm', 'vfebus', 'ctorger', 'ztowne', 'zosterlo', 'rfranco', 'mfroelic', 'campb294', 'akhairul', 'lpl', 'audyavar', 'dildyks', 'elutgen', 'wells130', 'amasaeng', 'sen16', 'sachdev6', 'balpert', 'clark600', 'chen2467', 'kiaramcclue', 'li2978', 'york33', 'rkeyser', 'haoyangliu', 'liang377', 'jvanwing', 'jsendon', 'konstantin', 'ahmad44', 'cmandrel', 'smit3522', 'lucasmartin', 'mlennar', 'jacobczajac', 'ysy39714', 'kim2841', 'beshay', 'chakra26', 'popp4', 'park439', 'kalothm', 'kerre', 'anindobagchi', 'marysemak', 'huan1260', 'jzwierz', 'gdadlani', 'crawfo76', 'kleber0', 'yu780', 'liu1809', 'jabarigarraway', 'bauer85', 'yang1098', 'azovko', 'rjammula', 'aalhabsi', 'lhoppenr', 'bianchik', None, 'atkins27', 'boston2', 'lararipe', 'sujal.yagnik', 'randy14rhh2', 'noah.stern99', 'dhanixv0', 'acarrilh']"
8,276,92,10,2,"['cannon333', 'missahaq']",89,"['ramkumaa', 'hshrote', 'cstrider', 'mxlin01', 'kapurdue20', 'nqmain', 'ggathura', 'imran1', 'estockwe', 'ctavs002', 'dick21', 'carvalho', 'scott483', 'acharter16', 'cfeustel', 'nvorrasa', 'cdunn', 'liu1837', 'wang4039', 'igueth', 'clancy6', 'mill2201', 'jack.t.roy42', 'seanm', 'vfebus', 'ctorger', 'ztowne', 'zosterlo', 'rfranco', 'mfroelic', 'campb294', 'akhairul', 'lpl', 'audyavar', 'dildyks', 'wells130', 'amasaeng', 'sachdev6', 'balpert', 'clark600', 'chen2467', 'kiaramcclue', 'li2978', 'york33', 'rkeyser', 'haoyangliu', 'liang377', 'jvanwing', 'jsendon', 'konstantin', 'ahmad44', 'cmandrel', 'smit3522', 'lucasmartin', 'mlennar', 'jacobczajac', 'ysy39714', 'kim2841', 'beshay', 'chakra26', 'popp4', 'park439', 'kalothm', 'kerre', 'anindobagchi', 'marysemak', 'huan1260', 'jzwierz', 'gdadlani', 'crawfo76', 'kleber0', 'yu780', 'liu1809', 'jabarigarraway', 'bauer85', 'yang1098', 'azovko', 'rjammula', 'aalhabsi', 'lhoppenr', 'bianchik', 'atkins27', 'boston2', 'lararipe', 'sujal.yagnik', 'randy14rhh2', 'noah.stern99', 'dhanixv0', 'acarrilh']",8,"['jacobkimsahngin', 'kdoutt', 'mikav', 'bkipp', 'sun530', 'chris260', None, 'zcahill']",99,"['ramkumaa', 'hshrote', 'cstrider', 'mxlin01', 'kapurdue20', 'nqmain', 'ggathura', 'imran1', 'estockwe', 'ctavs002', 'dick21', 'sun530', 'carvalho', 'scott483', 'acharter16', 'cfeustel', 'nvorrasa', 'cdunn', 'liu1837', 'cannon333', 'wang4039', 'missahaq', 'igueth', 'clancy6', 'mill2201', 'jack.t.roy42', 'seanm', 'vfebus', 'ctorger', 'ztowne', 'zosterlo', 'rfranco', 'mfroelic', 'campb294', 'jacobkimsahngin', 'zcahill', 'akhairul', 'lpl', 'audyavar', 'dildyks', 'chris260', 'wells130', 'amasaeng', 'sachdev6', 'balpert', 'clark600', 'chen2467', 'kiaramcclue', 'li2978', 'york33', 'rkeyser', 'haoyangliu', 'liang377', 'jvanwing', 'jsendon', 'konstantin', 'ahmad44', 'cmandrel', 'smit3522', 'lucasmartin', 'mlennar', 'jacobczajac', 'bkipp', 'ysy39714', 'kim2841', 'beshay', 'chakra26', 'popp4', 'park439', 'kalothm', 'kerre', 'anindobagchi', 'marysemak', 'huan1260', 'jzwierz', 'gdadlani', 'crawfo76', 'kleber0', 'yu780', 'liu1809', 'jabarigarraway', 'bauer85', 'yang1098', 'azovko', 'rjammula', 'aalhabsi', 'lhoppenr', 'bianchik', None, 'atkins27', 'boston2', 'lararipe', 'kdoutt', 'mikav', 'sujal.yagnik', 'randy14rhh2', 'noah.stern99', 'dhanixv0', 'acarrilh']"
8,272,92,9,5,"['konstantin', 'scott483', 'cannon333', 'ztowne', 'atkins27']",86,"['ramkumaa', 'hshrote', 'cstrider', 'mxlin01', 'kapurdue20', 'nqmain', 'ggathura', 'imran1', 'estockwe', 'ctavs002', 'dick21', 'carvalho', 'acharter16', 'cfeustel', 'nvorrasa', 'cdunn', 'liu1837', 'wang4039', 'missahaq', 'igueth', 'clancy6', 'mill2201', 'jack.t.roy42', 'seanm', 'vfebus', 'ctorger', 'zosterlo', 'rfranco', 'mfroelic', 'campb294', 'akhairul', 'lpl', 'audyavar', 'dildyks', 'wells130', 'amasaeng', 'sachdev6', 'balpert', 'clark600', 'chen2467', 'kiaramcclue', 'li2978', 'york33', 'rkeyser', 'haoyangliu', 'liang377', 'jvanwing', 'jsendon', 'ahmad44', 'cmandrel', 'smit3522', 'lucasmartin', 'mlennar', 'jacobczajac', 'ysy39714', 'kim2841', 'beshay', 'chakra26', 'popp4', 'park439', 'kalothm', 'kerre', 'anindobagchi', 'marysemak', 'huan1260', 'jzwierz', 'gdadlani', 'crawfo76', 'kleber0', 'yu780', 'liu1809', 'jabarigarraway', 'bauer85', 'yang1098', 'azovko', 'rjammula', 'aalhabsi', 'lhoppenr', 'bianchik', 'boston2', 'lararipe', 'sujal.yagnik', 'randy14rhh2', 'noah.stern99', 'dhanixv0', 'acarrilh']",4,"['yueziang98', None, 'mitchellw0815', 'nklockow']",95,"['ramkumaa', 'hshrote', 'cstrider', 'mxlin01', 'kapurdue20', 'nqmain', 'ggathura', 'imran1', 'estockwe', 'ctavs002', 'dick21', 'carvalho', 'scott483', 'acharter16', 'cfeustel', 'nvorrasa', 'cdunn', 'liu1837', 'cannon333', 'wang4039', 'missahaq', 'igueth', 'clancy6', 'mill2201', 'jack.t.roy42', 'seanm', 'vfebus', 'ctorger', 'ztowne', 'zosterlo', 'rfranco', 'mfroelic', 'campb294', 'akhairul', 'lpl', 'audyavar', 'dildyks', 'wells130', 'amasaeng', 'sachdev6', 'balpert', 'clark600', 'chen2467', 'kiaramcclue', 'yueziang98', 'li2978', 'york33', 'rkeyser', 'haoyangliu', 'liang377', 'jvanwing', 'jsendon', 'konstantin', 'ahmad44', 'cmandrel', 'smit3522', 'lucasmartin', 'mlennar', 'jacobczajac', 'nklockow', 'ysy39714', 'kim2841', 'beshay', 'chakra26', 'popp4', 'park439', 'kalothm', 'kerre', 'anindobagchi', 'marysemak', 'huan1260', 'jzwierz', 'gdadlani', 'crawfo76', 'kleber0', 'yu780', 'liu1809', 'jabarigarraway', 'bauer85', 'yang1098', 'azovko', 'rjammula', 'aalhabsi', 'lhoppenr', 'bianchik', None, 'atkins27', 'boston2', 'lararipe', 'sujal.yagnik', 'randy14rhh2', 'noah.stern99', 'mitchellw0815', 'dhanixv0', 'acarrilh']"
8,216,92,8,5,"['azovko', 'popp4', 'chen2467', 'haoyangliu', 'scott483']",86,"['ramkumaa', 'hshrote', 'cstrider', 'mxlin01', 'kapurdue20', 'nqmain', 'ggathura', 'imran1', 'estockwe', 'ctavs002', 'dick21', 'carvalho', 'acharter16', 'cfeustel', 'nvorrasa', 'cdunn', 'liu1837', 'cannon333', 'wang4039', 'missahaq', 'igueth', 'clancy6', 'mill2201', 'jack.t.roy42', 'seanm', 'vfebus', 'ctorger', 'ztowne', 'zosterlo', 'rfranco', 'mfroelic', 'campb294', 'akhairul', 'lpl', 'audyavar', 'dildyks', 'wells130', 'amasaeng', 'sachdev6', 'balpert', 'clark600', 'kiaramcclue', 'li2978', 'york33', 'rkeyser', 'liang377', 'jvanwing', 'jsendon', 'konstantin', 'ahmad44', 'cmandrel', 'smit3522', 'lucasmartin', 'mlennar', 'jacobczajac', 'ysy39714', 'kim2841', 'beshay', 'chakra26', 'park439', 'kalothm', 'kerre', 'anindobagchi', 'marysemak', 'huan1260', 'jzwierz', 'gdadlani', 'crawfo76', 'kleber0', 'yu780', 'liu1809', 'jabarigarraway', 'bauer85', 'yang1098', 'rjammula', 'aalhabsi', 'lhoppenr', 'bianchik', 'atkins27', 'boston2', 'lararipe', 'sujal.yagnik', 'randy14rhh2', 'noah.stern99', 'dhanixv0', 'acarrilh']",3,"['yao201', None, 'natesj9898']",94,"['ramkumaa', 'hshrote', 'cstrider', 'mxlin01', 'kapurdue20', 'nqmain', 'ggathura', 'imran1', 'estockwe', 'ctavs002', 'dick21', 'carvalho', 'scott483', 'acharter16', 'cfeustel', 'nvorrasa', 'cdunn', 'liu1837', 'cannon333', 'wang4039', 'missahaq', 'igueth', 'clancy6', 'mill2201', 'jack.t.roy42', 'yao201', 'seanm', 'vfebus', 'ctorger', 'ztowne', 'zosterlo', 'rfranco', 'mfroelic', 'campb294', 'akhairul', 'lpl', 'audyavar', 'dildyks', 'wells130', 'amasaeng', 'natesj9898', 'sachdev6', 'balpert', 'clark600', 'chen2467', 'kiaramcclue', 'li2978', 'york33', 'rkeyser', 'haoyangliu', 'liang377', 'jvanwing', 'jsendon', 'konstantin', 'ahmad44', 'cmandrel', 'smit3522', 'lucasmartin', 'mlennar', 'jacobczajac', 'ysy39714', 'kim2841', 'beshay', 'chakra26', 'popp4', 'park439', 'kalothm', 'kerre', 'anindobagchi', 'marysemak', 'huan1260', 'jzwierz', 'gdadlani', 'crawfo76', 'kleber0', 'yu780', 'liu1809', 'jabarigarraway', 'bauer85', 'yang1098', 'azovko', 'rjammula', 'aalhabsi', 'lhoppenr', 'bianchik', None, 'atkins27', 'boston2', 'lararipe', 'sujal.yagnik', 'randy14rhh2', 'noah.stern99', 'dhanixv0', 'acarrilh']"
8,219,92,8,4,"['jsendon', 'hshrote', 'jack.t.roy42', 'ramkumaa']",87,"['cstrider', 'mxlin01', 'kapurdue20', 'nqmain', 'ggathura', 'imran1', 'estockwe', 'ctavs002', 'dick21', 'carvalho', 'scott483', 'acharter16', 'cfeustel', 'nvorrasa', 'cdunn', 'liu1837', 'cannon333', 'wang4039', 'missahaq', 'igueth', 'clancy6', 'mill2201', 'seanm', 'vfebus', 'ctorger', 'ztowne', 'zosterlo', 'rfranco', 'mfroelic', 'campb294', 'akhairul', 'lpl', 'audyavar', 'dildyks', 'wells130', 'amasaeng', 'sachdev6', 'balpert', 'clark600', 'chen2467', 'kiaramcclue', 'li2978', 'york33', 'rkeyser', 'haoyangliu', 'liang377', 'jvanwing', 'konstantin', 'ahmad44', 'cmandrel', 'smit3522', 'lucasmartin', 'mlennar', 'jacobczajac', 'ysy39714', 'kim2841', 'beshay', 'chakra26', 'popp4', 'park439', 'kalothm', 'kerre', 'anindobagchi', 'marysemak', 'huan1260', 'jzwierz', 'gdadlani', 'crawfo76', 'kleber0', 'yu780', 'liu1809', 'jabarigarraway', 'bauer85', 'yang1098', 'azovko', 'rjammula', 'aalhabsi', 'lhoppenr', 'bianchik', 'atkins27', 'boston2', 'lararipe', 'sujal.yagnik', 'randy14rhh2', 'noah.stern99', 'dhanixv0', 'acarrilh']",4,"['fan264', 'ajmuegge', 'wheffern', None]",95,"['fan264', 'ramkumaa', 'hshrote', 'cstrider', 'mxlin01', 'kapurdue20', 'nqmain', 'ggathura', 'imran1', 'estockwe', 'wheffern', 'ctavs002', 'dick21', 'carvalho', 'scott483', 'acharter16', 'cfeustel', 'nvorrasa', 'cdunn', 'liu1837', 'cannon333', 'wang4039', 'missahaq', 'igueth', 'clancy6', 'mill2201', 'jack.t.roy42', 'seanm', 'vfebus', 'ctorger', 'ztowne', 'zosterlo', 'rfranco', 'mfroelic', 'campb294', 'akhairul', 'lpl', 'audyavar', 'dildyks', 'wells130', 'amasaeng', 'sachdev6', 'balpert', 'clark600', 'chen2467', 'kiaramcclue', 'li2978', 'york33', 'rkeyser', 'haoyangliu', 'liang377', 'jvanwing', 'jsendon', 'konstantin', 'ahmad44', 'cmandrel', 'smit3522', 'lucasmartin', 'mlennar', 'jacobczajac', 'ysy39714', 'kim2841', 'beshay', 'chakra26', 'ajmuegge', 'popp4', 'park439', 'kalothm', 'kerre', 'anindobagchi', 'marysemak', 'huan1260', 'jzwierz', 'gdadlani', 'crawfo76', 'kleber0', 'yu780', 'liu1809', 'jabarigarraway', 'bauer85', 'yang1098', 'azovko', 'rjammula', 'aalhabsi', 'lhoppenr', 'bianchik', None, 'atkins27', 'boston2', 'lararipe', 'sujal.yagnik', 'randy14rhh2', 'noah.stern99', 'dhanixv0', 'acarrilh']"
8,221,92,8,1,['seanm'],90,"['ramkumaa', 'hshrote', 'cstrider', 'mxlin01', 'kapurdue20', 'nqmain', 'ggathura', 'imran1', 'estockwe', 'ctavs002', 'dick21', 'carvalho', 'scott483', 'acharter16', 'cfeustel', 'nvorrasa', 'cdunn', 'liu1837', 'cannon333', 'wang4039', 'missahaq', 'igueth', 'clancy6', 'mill2201', 'jack.t.roy42', 'vfebus', 'ctorger', 'ztowne', 'zosterlo', 'rfranco', 'mfroelic', 'campb294', 'akhairul', 'lpl', 'audyavar', 'dildyks', 'wells130', 'amasaeng', 'sachdev6', 'balpert', 'clark600', 'chen2467', 'kiaramcclue', 'li2978', 'york33', 'rkeyser', 'haoyangliu', 'liang377', 'jvanwing', 'jsendon', 'konstantin', 'ahmad44', 'cmandrel', 'smit3522', 'lucasmartin', 'mlennar', 'jacobczajac', 'ysy39714', 'kim2841', 'beshay', 'chakra26', 'popp4', 'park439', 'kalothm', 'kerre', 'anindobagchi', 'marysemak', 'huan1260', 'jzwierz', 'gdadlani', 'crawfo76', 'kleber0', 'yu780', 'liu1809', 'jabarigarraway', 'bauer85', 'yang1098', 'azovko', 'rjammula', 'aalhabsi', 'lhoppenr', 'bianchik', 'atkins27', 'boston2', 'lararipe', 'sujal.yagnik', 'randy14rhh2', 'noah.stern99', 'dhanixv0', 'acarrilh']",7,"['bermel', 'iczajkow', 'akanbi104', 'anirudhsivarajan23', 'liys3095', 'vasilj', None]",98,"['ramkumaa', 'hshrote', 'cstrider', 'mxlin01', 'kapurdue20', 'nqmain', 'ggathura', 'imran1', 'estockwe', 'ctavs002', 'dick21', 'carvalho', 'scott483', 'acharter16', 'cfeustel', 'nvorrasa', 'cdunn', 'liu1837', 'cannon333', 'wang4039', 'missahaq', 'igueth', 'clancy6', 'mill2201', 'jack.t.roy42', 'seanm', 'vfebus', 'ctorger', 'ztowne', 'zosterlo', 'rfranco', 'mfroelic', 'campb294', 'bermel', 'akhairul', 'lpl', 'audyavar', 'dildyks', 'wells130', 'amasaeng', 'sachdev6', 'balpert', 'clark600', 'chen2467', 'kiaramcclue', 'li2978', 'york33', 'rkeyser', 'haoyangliu', 'liang377', 'jvanwing', 'jsendon', 'konstantin', 'ahmad44', 'cmandrel', 'anirudhsivarajan23', 'smit3522', 'lucasmartin', 'mlennar', 'jacobczajac', 'ysy39714', 'kim2841', 'beshay', 'chakra26', 'iczajkow', 'akanbi104', 'popp4', 'park439', 'kalothm', 'kerre', 'anindobagchi', 'marysemak', 'huan1260', 'jzwierz', 'gdadlani', 'crawfo76', 'kleber0', 'yu780', 'liu1809', 'jabarigarraway', 'bauer85', 'yang1098', 'azovko', 'rjammula', 'aalhabsi', 'lhoppenr', 'bianchik', None, 'atkins27', 'boston2', 'lararipe', 'liys3095', 'sujal.yagnik', 'randy14rhh2', 'noah.stern99', 'vasilj', 'dhanixv0', 'acarrilh']"
8,215,92,6,3,"['popp4', 'smit3522', 'noah.stern99']",88,"['ramkumaa', 'hshrote', 'cstrider', 'mxlin01', 'kapurdue20', 'nqmain', 'ggathura', 'imran1', 'estockwe', 'ctavs002', 'dick21', 'carvalho', 'scott483', 'acharter16', 'cfeustel', 'nvorrasa', 'cdunn', 'liu1837', 'cannon333', 'wang4039', 'missahaq', 'igueth', 'clancy6', 'mill2201', 'jack.t.roy42', 'seanm', 'vfebus', 'ctorger', 'ztowne', 'zosterlo', 'rfranco', 'mfroelic', 'campb294', 'akhairul', 'lpl', 'audyavar', 'dildyks', 'wells130', 'amasaeng', 'sachdev6', 'balpert', 'clark600', 'chen2467', 'kiaramcclue', 'li2978', 'york33', 'rkeyser', 'haoyangliu', 'liang377', 'jvanwing', 'jsendon', 'konstantin', 'ahmad44', 'cmandrel', 'lucasmartin', 'mlennar', 'jacobczajac', 'ysy39714', 'kim2841', 'beshay', 'chakra26', 'park439', 'kalothm', 'kerre', 'anindobagchi', 'marysemak', 'huan1260', 'jzwierz', 'gdadlani', 'crawfo76', 'kleber0', 'yu780', 'liu1809', 'jabarigarraway', 'bauer85', 'yang1098', 'azovko', 'rjammula', 'aalhabsi', 'lhoppenr', 'bianchik', 'atkins27', 'boston2', 'lararipe', 'sujal.yagnik', 'randy14rhh2', 'dhanixv0', 'acarrilh']",3,"[None, 'yao201', 'arayapro']",94,"['ramkumaa', 'hshrote', 'cstrider', 'mxlin01', 'kapurdue20', 'nqmain', 'ggathura', 'imran1', 'estockwe', 'ctavs002', 'dick21', 'carvalho', 'scott483', 'acharter16', 'cfeustel', 'nvorrasa', 'cdunn', 'liu1837', 'cannon333', 'wang4039', 'missahaq', 'igueth', 'clancy6', 'mill2201', 'jack.t.roy42', 'yao201', 'seanm', 'vfebus', 'ctorger', 'ztowne', 'zosterlo', 'rfranco', 'mfroelic', 'campb294', 'akhairul', 'lpl', 'audyavar', 'dildyks', 'wells130', 'amasaeng', 'sachdev6', 'balpert', 'clark600', 'chen2467', 'kiaramcclue', 'li2978', 'york33', 'rkeyser', 'haoyangliu', 'liang377', 'jvanwing', 'jsendon', 'konstantin', 'ahmad44', 'cmandrel', 'smit3522', 'lucasmartin', 'mlennar', 'jacobczajac', 'ysy39714', 'kim2841', 'beshay', 'chakra26', 'popp4', 'park439', 'kalothm', 'kerre', 'anindobagchi', 'marysemak', 'huan1260', 'jzwierz', 'gdadlani', 'crawfo76', 'kleber0', 'yu780', 'arayapro', 'liu1809', 'jabarigarraway', 'bauer85', 'yang1098', 'azovko', 'rjammula', 'aalhabsi', 'lhoppenr', 'bianchik', None, 'atkins27', 'boston2', 'lararipe', 'sujal.yagnik', 'randy14rhh2', 'noah.stern99', 'dhanixv0', 'acarrilh']"
8,275,92,6,1,['cannon333'],90,"['ramkumaa', 'hshrote', 'cstrider', 'mxlin01', 'kapurdue20', 'nqmain', 'ggathura', 'imran1', 'estockwe', 'ctavs002', 'dick21', 'carvalho', 'scott483', 'acharter16', 'cfeustel', 'nvorrasa', 'cdunn', 'liu1837', 'wang4039', 'missahaq', 'igueth', 'clancy6', 'mill2201', 'jack.t.roy42', 'seanm', 'vfebus', 'ctorger', 'ztowne', 'zosterlo', 'rfranco', 'mfroelic', 'campb294', 'akhairul', 'lpl', 'audyavar', 'dildyks', 'wells130', 'amasaeng', 'sachdev6', 'balpert', 'clark600', 'chen2467', 'kiaramcclue', 'li2978', 'york33', 'rkeyser', 'haoyangliu', 'liang377', 'jvanwing', 'jsendon', 'konstantin', 'ahmad44', 'cmandrel', 'smit3522', 'lucasmartin', 'mlennar', 'jacobczajac', 'ysy39714', 'kim2841', 'beshay', 'chakra26', 'popp4', 'park439', 'kalothm', 'kerre', 'anindobagchi', 'marysemak', 'huan1260', 'jzwierz', 'gdadlani', 'crawfo76', 'kleber0', 'yu780', 'liu1809', 'jabarigarraway', 'bauer85', 'yang1098', 'azovko', 'rjammula', 'aalhabsi', 'lhoppenr', 'bianchik', 'atkins27', 'boston2', 'lararipe', 'sujal.yagnik', 'randy14rhh2', 'noah.stern99', 'dhanixv0', 'acarrilh']",5,"['lee3541', 'lee3753', 'kngupta', 'sburowfl', None]",96,"['ramkumaa', 'lee3541', 'hshrote', 'cstrider', 'mxlin01', 'kapurdue20', 'nqmain', 'ggathura', 'imran1', 'estockwe', 'kngupta', 'ctavs002', 'dick21', 'carvalho', 'scott483', 'acharter16', 'cfeustel', 'nvorrasa', 'cdunn', 'liu1837', 'cannon333', 'wang4039', 'missahaq', 'igueth', 'clancy6', 'mill2201', 'jack.t.roy42', 'seanm', 'vfebus', 'ctorger', 'ztowne', 'zosterlo', 'rfranco', 'mfroelic', 'campb294', 'lee3753', 'akhairul', 'lpl', 'audyavar', 'dildyks', 'wells130', 'amasaeng', 'sachdev6', 'balpert', 'clark600', 'chen2467', 'kiaramcclue', 'li2978', 'york33', 'rkeyser', 'haoyangliu', 'sburowfl', 'liang377', 'jvanwing', 'jsendon', 'konstantin', 'ahmad44', 'cmandrel', 'smit3522', 'lucasmartin', 'mlennar', 'jacobczajac', 'ysy39714', 'kim2841', 'beshay', 'chakra26', 'popp4', 'park439', 'kalothm', 'kerre', 'anindobagchi', 'marysemak', 'huan1260', 'jzwierz', 'gdadlani', 'crawfo76', 'kleber0', 'yu780', 'liu1809', 'jabarigarraway', 'bauer85', 'yang1098', 'azovko', 'rjammula', 'aalhabsi', 'lhoppenr', 'bianchik', None, 'atkins27', 'boston2', 'lararipe', 'sujal.yagnik', 'randy14rhh2', 'noah.stern99', 'dhanixv0', 'acarrilh']"
9,255,92,35,16,"['sgu20161542', 'sgu20151285', 'gio960830', 'sgu20161510', 'thko1014', 'kevinon21', 'pumpkin07', '97kkdh', 'sgu20161477', 'sgu20141341', 'sgu20161519', 'deu02214', 'sgu20171593', 'wkddbs97', 'kyhee5020', 'sgu20161526']",75,"['suhail17201', 'ridhi19209', 'ghanmnashdhyab', 'sandra.pillai9', 'akshat20137', 'romesh17184', 'saxenaakshat13', 'amkreddy', 'manikantesh.karimikonda', 'trupti.bharati2020', 'yash19203', 'rohansonar74', 'siddhant16199', 'arun19139', 'riya19192', 'heenakaushik', 'prabhat19186', 'chellaramaswamy', 'nikhil128562019', 'umang2409mittal', 'sareenjatin02', 'ah7221', 'saiteja123', 'mukul19147', 'subodh19161', 'prajual', 'kipkoechvictor3', 'wcatalan', 'arijitnitaece20vlsi', 'pratibha19152', 'somya17198', 'harilavanya', 'janani01101998', 'hemasudha', 'devesh16145', 'saipavan123', 'mummudi12', 'prashant19151', 'thaikus', 'antoniomorchonsabadell', 'poojabe', 'puneet19189', 'monu25', 'shadowm85', 'piyush17173', 'dy.ngu57', 'marinagomezcollazo', 'sarthak_aditya', 'kaylalee', 'tharunkumar.guduru2020', 'kuntal.sarkar2020', 'tushar19163', 'abhishek20200', 'albertopf', 'soham', 'sunil16202', 'usamabangz', 'anaghabinu', 'siddharth.shekhar18', 'nasim_k', 'mounodeep', 'srijani.pal2020', 'shubhi17195', 'yashwanth_babu', 'sangw', 'rupali19158', 'singhsanskriti7', 'amareswar72', 'viplow.singh58.vs', 'manu20187', 'nikhil1285620', 'rajat19154', 'daxpatel1105', 'jyothiprakash', 'ushaukat9']",19,"['sgu20141475', 'skarndgksqlc', 'sepsep2000', 'sgu20181520', 'sgu20181572', 'chlqjawls789', 'jtj1012', 'ehdwnse', 'sgu20171509', 'pook0612', 'sgu201514116', 'heo9507123', '112zxczxc', 'taehojung', 'sgu20171496', 'sgu20171566', 'sgu20161527', None, 'sgu20171573']",110,"['suhail17201', 'ridhi19209', 'sandra.pillai9', 'akshat20137', 'romesh17184', 'saxenaakshat13', 'manikantesh.karimikonda', 'trupti.bharati2020', 'skarndgksqlc', 'yash19203', 'rohansonar74', 'sgu20141341', 'sgu20181520', 'sepsep2000', 'arun19139', 'prabhat19186', 'jtj1012', 'sgu20161526', 'nikhil128562019', 'ah7221', 'saiteja123', 'pook0612', 'pratibha19152', 'heo9507123', 'sgu20171593', '112zxczxc', 'janani01101998', 'devesh16145', 'mummudi12', 'antoniomorchonsabadell', 'thaikus', 'poojabe', 'monu25', 'piyush17173', 'marinagomezcollazo', 'kaylalee', 'tharunkumar.guduru2020', 'kuntal.sarkar2020', 'tushar19163', 'siddharth.shekhar18', 'mounodeep', 'srijani.pal2020', 'shubhi17195', 'sgu20151285', 'pumpkin07', 'amareswar72', 'ushaukat9', 'ghanmnashdhyab', 'amkreddy', 'thko1014', 'sgu20141475', 'sgu20161477', 'siddhant16199', 'sgu20181572', 'wkddbs97', 'riya19192', 'heenakaushik', 'chellaramaswamy', 'chlqjawls789', 'sgu20161542', 'umang2409mittal', 'sareenjatin02', 'gio960830', 'mukul19147', 'subodh19161', 'kevinon21', 'ehdwnse', 'sgu20171509', 'prajual', 'kipkoechvictor3', '97kkdh', 'wcatalan', 'arijitnitaece20vlsi', 'sgu201514116', 'somya17198', 'harilavanya', 'kyhee5020', 'hemasudha', 'saipavan123', 'prashant19151', 'puneet19189', 'taehojung', 'shadowm85', 'dy.ngu57', 'sarthak_aditya', 'sgu20171496', 'abhishek20200', 'sgu20171566', 'sunil16202', 'usamabangz', 'albertopf', 'soham', 'sgu20161527', 'deu02214', 'anaghabinu', None, 'nasim_k', 'sgu20161510', 'sangw', 'rupali19158', 'yashwanth_babu', 'singhsanskriti7', 'sgu20171573', 'viplow.singh58.vs', 'manu20187', 'nikhil1285620', 'rajat19154', 'daxpatel1105', 'sgu20161519', 'jyothiprakash']"
9,256,92,35,19,"['suhail17201', 'akshat20137', 'romesh17184', 'saxenaakshat13', 'yash19203', 'siddhant16199', 'arun19139', 'prabhat19186', 'subodh19161', 'pratibha19152', 'puneet19189', 'sarthak_aditya', 'sunil16202', 'mounodeep', 'shubhi17195', 'yashwanth_babu', 'rupali19158', 'viplow.singh58.vs', 'rajat19154']",72,"['ridhi19209', 'ghanmnashdhyab', 'sandra.pillai9', 'amkreddy', 'manikantesh.karimikonda', 'thko1014', 'trupti.bharati2020', 'sgu20161477', 'sgu20141341', 'rohansonar74', 'wkddbs97', 'riya19192', 'heenakaushik', 'chellaramaswamy', 'sgu20161526', 'nikhil128562019', 'sgu20161542', 'umang2409mittal', 'sareenjatin02', 'ah7221', 'saiteja123', 'gio960830', 'kevinon21', 'mukul19147', 'prajual', 'kipkoechvictor3', '97kkdh', 'wcatalan', 'arijitnitaece20vlsi', 'somya17198', 'harilavanya', 'sgu20171593', 'janani01101998', 'kyhee5020', 'hemasudha', 'devesh16145', 'saipavan123', 'mummudi12', 'prashant19151', 'thaikus', 'antoniomorchonsabadell', 'poojabe', 'monu25', 'shadowm85', 'piyush17173', 'dy.ngu57', 'marinagomezcollazo', 'kaylalee', 'tharunkumar.guduru2020', 'kuntal.sarkar2020', 'tushar19163', 'abhishek20200', 'albertopf', 'soham', 'usamabangz', 'deu02214', 'anaghabinu', 'siddharth.shekhar18', 'nasim_k', 'sgu20151285', 'srijani.pal2020', 'sgu20161510', 'sangw', 'singhsanskriti7', 'pumpkin07', 'amareswar72', 'manu20187', 'nikhil1285620', 'daxpatel1105', 'sgu20161519', 'jyothiprakash', 'ushaukat9']",16,"['rajni19155', 'sarvagya19159', 'abhinavg', 'abhishek19138', 'shubham20155', 'yashgupta.ece.msit', 'tushar19200', 'mansi17165', 'diksha19145', 'vishal19201', 'pranav19207', 'apurva1516', 'himanshi19142', None, 'nitig', 'sharkin19172']",107,"['suhail17201', 'ridhi19209', 'sandra.pillai9', 'akshat20137', 'romesh17184', 'saxenaakshat13', 'rajni19155', 'manikantesh.karimikonda', 'trupti.bharati2020', 'yash19203', 'rohansonar74', 'sgu20141341', 'diksha19145', 'arun19139', 'sharkin19172', 'prabhat19186', 'sgu20161526', 'nikhil128562019', 'nitig', 'mansi17165', 'ah7221', 'saiteja123', 'sarvagya19159', 'pratibha19152', 'sgu20171593', 'janani01101998', 'devesh16145', 'mummudi12', 'antoniomorchonsabadell', 'thaikus', 'poojabe', 'monu25', 'piyush17173', 'abhinavg', 'abhishek19138', 'marinagomezcollazo', 'kaylalee', 'tharunkumar.guduru2020', 'kuntal.sarkar2020', 'tushar19163', 'vishal19201', 'siddharth.shekhar18', 'mounodeep', 'srijani.pal2020', 'shubhi17195', 'sgu20151285', 'pumpkin07', 'amareswar72', 'ushaukat9', 'ghanmnashdhyab', 'amkreddy', 'thko1014', 'yashgupta.ece.msit', 'sgu20161477', 'siddhant16199', 'wkddbs97', 'riya19192', 'heenakaushik', 'chellaramaswamy', 'apurva1516', 'sgu20161542', 'umang2409mittal', 'sareenjatin02', 'gio960830', 'mukul19147', 'subodh19161', 'kevinon21', 'prajual', 'kipkoechvictor3', '97kkdh', 'wcatalan', 'arijitnitaece20vlsi', 'somya17198', 'harilavanya', 'kyhee5020', 'hemasudha', 'himanshi19142', 'saipavan123', 'prashant19151', 'puneet19189', 'shadowm85', 'shubham20155', 'dy.ngu57', 'sarthak_aditya', 'abhishek20200', 'sunil16202', 'usamabangz', 'albertopf', 'soham', 'pranav19207', 'deu02214', 'anaghabinu', None, 'nasim_k', 'sgu20161510', 'sangw', 'rupali19158', 'yashwanth_babu', 'singhsanskriti7', 'tushar19200', 'viplow.singh58.vs', 'manu20187', 'nikhil1285620', 'rajat19154', 'daxpatel1105', 'sgu20161519', 'jyothiprakash']"
9,257,92,17,10,"['akshat20137', 'umang2409mittal', 'sareenjatin02', 'poojabe', 'piyush17173', 'dy.ngu57', 'yash19203', 'pratibha19152', 'rajat19154', 'devesh16145']",81,"['suhail17201', 'ridhi19209', 'sandra.pillai9', 'romesh17184', 'saxenaakshat13', 'manikantesh.karimikonda', 'trupti.bharati2020', 'rohansonar74', 'sgu20141341', 'arun19139', 'prabhat19186', 'sgu20161526', 'nikhil128562019', 'ah7221', 'saiteja123', 'sgu20171593', 'janani01101998', 'mummudi12', 'antoniomorchonsabadell', 'thaikus', 'monu25', 'marinagomezcollazo', 'kaylalee', 'tharunkumar.guduru2020', 'kuntal.sarkar2020', 'tushar19163', 'siddharth.shekhar18', 'mounodeep', 'srijani.pal2020', 'shubhi17195', 'sgu20151285', 'pumpkin07', 'amareswar72', 'ushaukat9', 'ghanmnashdhyab', 'amkreddy', 'thko1014', 'sgu20161477', 'siddhant16199', 'wkddbs97', 'riya19192', 'heenakaushik', 'chellaramaswamy', 'sgu20161542', 'gio960830', 'mukul19147', 'subodh19161', 'kevinon21', 'prajual', 'kipkoechvictor3', '97kkdh', 'wcatalan', 'arijitnitaece20vlsi', 'somya17198', 'harilavanya', 'kyhee5020', 'hemasudha', 'saipavan123', 'prashant19151', 'puneet19189', 'shadowm85', 'sarthak_aditya', 'abhishek20200', 'sunil16202', 'usamabangz', 'albertopf', 'soham', 'deu02214', 'anaghabinu', 'nasim_k', 'sgu20161510', 'sangw', 'rupali19158', 'yashwanth_babu', 'singhsanskriti7', 'viplow.singh58.vs', 'manu20187', 'nikhil1285620', 'daxpatel1105', 'sgu20161519', 'jyothiprakash']",7,"['chotukrishna90', 'jyoti_sharma', 'devendra123', 'yashgupta.ece.msit', 'parekhr', 'himanshi19142', None]",98,"['suhail17201', 'ridhi19209', 'sandra.pillai9', 'akshat20137', 'romesh17184', 'saxenaakshat13', 'manikantesh.karimikonda', 'trupti.bharati2020', 'yash19203', 'rohansonar74', 'sgu20141341', 'arun19139', 'prabhat19186', 'sgu20161526', 'nikhil128562019', 'ah7221', 'saiteja123', 'pratibha19152', 'sgu20171593', 'janani01101998', 'devesh16145', 'mummudi12', 'antoniomorchonsabadell', 'thaikus', 'chotukrishna90', 'poojabe', 'monu25', 'piyush17173', 'marinagomezcollazo', 'kaylalee', 'tharunkumar.guduru2020', 'kuntal.sarkar2020', 'tushar19163', 'parekhr', 'siddharth.shekhar18', 'mounodeep', 'srijani.pal2020', 'shubhi17195', 'sgu20151285', 'pumpkin07', 'amareswar72', 'ushaukat9', 'ghanmnashdhyab', 'amkreddy', 'thko1014', 'jyoti_sharma', 'devendra123', 'yashgupta.ece.msit', 'sgu20161477', 'siddhant16199', 'wkddbs97', 'riya19192', 'heenakaushik', 'chellaramaswamy', 'sgu20161542', 'umang2409mittal', 'sareenjatin02', 'gio960830', 'mukul19147', 'subodh19161', 'kevinon21', 'prajual', 'kipkoechvictor3', '97kkdh', 'wcatalan', 'arijitnitaece20vlsi', 'somya17198', 'harilavanya', 'kyhee5020', 'hemasudha', 'himanshi19142', 'saipavan123', 'prashant19151', 'puneet19189', 'shadowm85', 'dy.ngu57', 'sarthak_aditya', 'abhishek20200', 'sunil16202', 'usamabangz', 'albertopf', 'soham', 'deu02214', 'anaghabinu', None, 'nasim_k', 'sgu20161510', 'sangw', 'rupali19158', 'yashwanth_babu', 'singhsanskriti7', 'viplow.singh58.vs', 'manu20187', 'nikhil1285620', 'rajat19154', 'daxpatel1105', 'sgu20161519', 'jyothiprakash']"
9,252,92,16,3,"['heenakaushik', 'amareswar72', 'arijitnitaece20vlsi']",88,"['suhail17201', 'ridhi19209', 'sandra.pillai9', 'akshat20137', 'romesh17184', 'saxenaakshat13', 'manikantesh.karimikonda', 'trupti.bharati2020', 'yash19203', 'rohansonar74', 'sgu20141341', 'arun19139', 'prabhat19186', 'sgu20161526', 'nikhil128562019', 'ah7221', 'saiteja123', 'pratibha19152', 'sgu20171593', 'janani01101998', 'devesh16145', 'mummudi12', 'antoniomorchonsabadell', 'thaikus', 'poojabe', 'monu25', 'piyush17173', 'marinagomezcollazo', 'kaylalee', 'tharunkumar.guduru2020', 'kuntal.sarkar2020', 'tushar19163', 'siddharth.shekhar18', 'mounodeep', 'srijani.pal2020', 'shubhi17195', 'sgu20151285', 'pumpkin07', 'ushaukat9', 'ghanmnashdhyab', 'amkreddy', 'thko1014', 'sgu20161477', 'siddhant16199', 'wkddbs97', 'riya19192', 'chellaramaswamy', 'sgu20161542', 'umang2409mittal', 'sareenjatin02', 'gio960830', 'mukul19147', 'subodh19161', 'kevinon21', 'prajual', 'kipkoechvictor3', '97kkdh', 'wcatalan', 'somya17198', 'harilavanya', 'kyhee5020', 'hemasudha', 'saipavan123', 'prashant19151', 'puneet19189', 'shadowm85', 'dy.ngu57', 'sarthak_aditya', 'abhishek20200', 'sunil16202', 'usamabangz', 'albertopf', 'soham', 'deu02214', 'anaghabinu', 'nasim_k', 'sgu20161510', 'sangw', 'rupali19158', 'yashwanth_babu', 'singhsanskriti7', 'viplow.singh58.vs', 'manu20187', 'nikhil1285620', 'rajat19154', 'daxpatel1105', 'sgu20161519', 'jyothiprakash']",13,"[None, 'saindane.apurva', 'pavantv', 'ssdivyadeepti', 'sreekanthnambi205', 'sumitdupate19', 'sneha9211', 'sandra.b2020', 'kprudhvired', 'shalaka.bhandarkar2020', 'sneha.kaushik2020', 'snehakurle1995', 'nikhil.singh2020']",104,"['suhail17201', 'ridhi19209', 'sandra.pillai9', 'akshat20137', 'romesh17184', 'saxenaakshat13', 'manikantesh.karimikonda', 'trupti.bharati2020', 'sneha9211', 'yash19203', 'rohansonar74', 'sgu20141341', 'arun19139', 'prabhat19186', 'sgu20161526', 'nikhil128562019', 'sneha.kaushik2020', 'sandra.b2020', 'ah7221', 'saiteja123', 'pratibha19152', 'sgu20171593', 'janani01101998', 'devesh16145', 'mummudi12', 'antoniomorchonsabadell', 'thaikus', 'pavantv', 'poojabe', 'monu25', 'piyush17173', 'marinagomezcollazo', 'kaylalee', 'tharunkumar.guduru2020', 'kuntal.sarkar2020', 'tushar19163', 'siddharth.shekhar18', 'mounodeep', 'srijani.pal2020', 'shubhi17195', 'sgu20151285', 'pumpkin07', 'amareswar72', 'ushaukat9', 'ghanmnashdhyab', 'amkreddy', 'thko1014', 'sgu20161477', 'siddhant16199', 'wkddbs97', 'riya19192', 'heenakaushik', 'chellaramaswamy', 'sgu20161542', 'umang2409mittal', 'sareenjatin02', 'gio960830', 'mukul19147', 'saindane.apurva', 'subodh19161', 'kevinon21', 'prajual', 'kipkoechvictor3', '97kkdh', 'wcatalan', 'arijitnitaece20vlsi', 'kprudhvired', 'somya17198', 'harilavanya', 'kyhee5020', 'hemasudha', 'saipavan123', 'snehakurle1995', 'nikhil.singh2020', 'prashant19151', 'puneet19189', 'sumitdupate19', 'shadowm85', 'dy.ngu57', 'sarthak_aditya', 'abhishek20200', 'sunil16202', 'usamabangz', 'albertopf', 'soham', 'shalaka.bhandarkar2020', 'deu02214', 'anaghabinu', 'sreekanthnambi205', None, 'nasim_k', 'sgu20161510', 'sangw', 'rupali19158', 'yashwanth_babu', 'singhsanskriti7', 'ssdivyadeepti', 'viplow.singh58.vs', 'manu20187', 'nikhil1285620', 'rajat19154', 'daxpatel1105', 'sgu20161519', 'jyothiprakash']"
9,251,92,13,6,"['sandra.pillai9', 'amkreddy', 'manikantesh.karimikonda', 'hemasudha', 'jyothiprakash', 'saipavan123']",85,"['suhail17201', 'ridhi19209', 'akshat20137', 'romesh17184', 'saxenaakshat13', 'trupti.bharati2020', 'yash19203', 'rohansonar74', 'sgu20141341', 'arun19139', 'prabhat19186', 'sgu20161526', 'nikhil128562019', 'ah7221', 'saiteja123', 'pratibha19152', 'sgu20171593', 'janani01101998', 'devesh16145', 'mummudi12', 'antoniomorchonsabadell', 'thaikus', 'poojabe', 'monu25', 'piyush17173', 'marinagomezcollazo', 'kaylalee', 'tharunkumar.guduru2020', 'kuntal.sarkar2020', 'tushar19163', 'siddharth.shekhar18', 'mounodeep', 'srijani.pal2020', 'shubhi17195', 'sgu20151285', 'pumpkin07', 'amareswar72', 'ushaukat9', 'ghanmnashdhyab', 'thko1014', 'sgu20161477', 'siddhant16199', 'wkddbs97', 'riya19192', 'heenakaushik', 'chellaramaswamy', 'sgu20161542', 'umang2409mittal', 'sareenjatin02', 'gio960830', 'mukul19147', 'subodh19161', 'kevinon21', 'prajual', 'kipkoechvictor3', '97kkdh', 'wcatalan', 'arijitnitaece20vlsi', 'somya17198', 'harilavanya', 'kyhee5020', 'prashant19151', 'puneet19189', 'shadowm85', 'dy.ngu57', 'sarthak_aditya', 'abhishek20200', 'sunil16202', 'usamabangz', 'albertopf', 'soham', 'deu02214', 'anaghabinu', 'nasim_k', 'sgu20161510', 'sangw', 'rupali19158', 'yashwanth_babu', 'singhsanskriti7', 'viplow.singh58.vs', 'manu20187', 'nikhil1285620', 'rajat19154', 'daxpatel1105', 'sgu20161519']",7,"['sreeker_tirunagari', 'vuppala.bharath2020', 'avulamanojkumarreddy', 'rishmitha', 'anandsai462', None, 'sandra.b2020']",98,"['suhail17201', 'ridhi19209', 'sandra.pillai9', 'akshat20137', 'romesh17184', 'saxenaakshat13', 'manikantesh.karimikonda', 'trupti.bharati2020', 'yash19203', 'rohansonar74', 'sgu20141341', 'arun19139', 'prabhat19186', 'sgu20161526', 'nikhil128562019', 'sandra.b2020', 'ah7221', 'saiteja123', 'pratibha19152', 'sgu20171593', 'janani01101998', 'devesh16145', 'mummudi12', 'antoniomorchonsabadell', 'thaikus', 'poojabe', 'monu25', 'piyush17173', 'marinagomezcollazo', 'kaylalee', 'tharunkumar.guduru2020', 'kuntal.sarkar2020', 'tushar19163', 'siddharth.shekhar18', 'mounodeep', 'srijani.pal2020', 'shubhi17195', 'sgu20151285', 'pumpkin07', 'amareswar72', 'avulamanojkumarreddy', 'ushaukat9', 'sreeker_tirunagari', 'ghanmnashdhyab', 'amkreddy', 'thko1014', 'sgu20161477', 'siddhant16199', 'wkddbs97', 'riya19192', 'heenakaushik', 'chellaramaswamy', 'sgu20161542', 'umang2409mittal', 'sareenjatin02', 'gio960830', 'mukul19147', 'subodh19161', 'kevinon21', 'prajual', 'kipkoechvictor3', '97kkdh', 'wcatalan', 'arijitnitaece20vlsi', 'somya17198', 'harilavanya', 'rishmitha', 'kyhee5020', 'hemasudha', 'anandsai462', 'saipavan123', 'prashant19151', 'puneet19189', 'shadowm85', 'dy.ngu57', 'sarthak_aditya', 'abhishek20200', 'sunil16202', 'usamabangz', 'albertopf', 'soham', 'deu02214', 'anaghabinu', None, 'nasim_k', 'sgu20161510', 'sangw', 'rupali19158', 'yashwanth_babu', 'singhsanskriti7', 'vuppala.bharath2020', 'viplow.singh58.vs', 'manu20187', 'nikhil1285620', 'rajat19154', 'daxpatel1105', 'sgu20161519', 'jyothiprakash']"
9,259,92,9,6,"['ridhi19209', 'akshat20137', 'prashant19151', 'rupali19158', 'nikhil1285620', 'nikhil128562019']",85,"['suhail17201', 'sandra.pillai9', 'romesh17184', 'saxenaakshat13', 'manikantesh.karimikonda', 'trupti.bharati2020', 'yash19203', 'rohansonar74', 'sgu20141341', 'arun19139', 'prabhat19186', 'sgu20161526', 'ah7221', 'saiteja123', 'pratibha19152', 'sgu20171593', 'janani01101998', 'devesh16145', 'mummudi12', 'antoniomorchonsabadell', 'thaikus', 'poojabe', 'monu25', 'piyush17173', 'marinagomezcollazo', 'kaylalee', 'tharunkumar.guduru2020', 'kuntal.sarkar2020', 'tushar19163', 'siddharth.shekhar18', 'mounodeep', 'srijani.pal2020', 'shubhi17195', 'sgu20151285', 'pumpkin07', 'amareswar72', 'ushaukat9', 'ghanmnashdhyab', 'amkreddy', 'thko1014', 'sgu20161477', 'siddhant16199', 'wkddbs97', 'riya19192', 'heenakaushik', 'chellaramaswamy', 'sgu20161542', 'umang2409mittal', 'sareenjatin02', 'gio960830', 'mukul19147', 'subodh19161', 'kevinon21', 'prajual', 'kipkoechvictor3', '97kkdh', 'wcatalan', 'arijitnitaece20vlsi', 'somya17198', 'harilavanya', 'kyhee5020', 'hemasudha', 'saipavan123', 'puneet19189', 'shadowm85', 'dy.ngu57', 'sarthak_aditya', 'abhishek20200', 'sunil16202', 'usamabangz', 'albertopf', 'soham', 'deu02214', 'anaghabinu', 'nasim_k', 'sgu20161510', 'sangw', 'yashwanth_babu', 'singhsanskriti7', 'viplow.singh58.vs', 'manu20187', 'rajat19154', 'daxpatel1105', 'sgu20161519', 'jyothiprakash']",3,"['deeksha19169', 'shubham20155', None]",94,"['suhail17201', 'ridhi19209', 'sandra.pillai9', 'akshat20137', 'romesh17184', 'saxenaakshat13', 'manikantesh.karimikonda', 'trupti.bharati2020', 'yash19203', 'rohansonar74', 'sgu20141341', 'deeksha19169', 'arun19139', 'prabhat19186', 'sgu20161526', 'nikhil128562019', 'ah7221', 'saiteja123', 'pratibha19152', 'sgu20171593', 'janani01101998', 'devesh16145', 'mummudi12', 'antoniomorchonsabadell', 'thaikus', 'poojabe', 'monu25', 'piyush17173', 'marinagomezcollazo', 'kaylalee', 'tharunkumar.guduru2020', 'kuntal.sarkar2020', 'tushar19163', 'siddharth.shekhar18', 'mounodeep', 'srijani.pal2020', 'shubhi17195', 'sgu20151285', 'pumpkin07', 'amareswar72', 'ushaukat9', 'ghanmnashdhyab', 'amkreddy', 'thko1014', 'sgu20161477', 'siddhant16199', 'wkddbs97', 'riya19192', 'heenakaushik', 'chellaramaswamy', 'sgu20161542', 'umang2409mittal', 'sareenjatin02', 'gio960830', 'mukul19147', 'subodh19161', 'kevinon21', 'prajual', 'kipkoechvictor3', '97kkdh', 'wcatalan', 'arijitnitaece20vlsi', 'somya17198', 'harilavanya', 'kyhee5020', 'hemasudha', 'saipavan123', 'prashant19151', 'puneet19189', 'shadowm85', 'shubham20155', 'dy.ngu57', 'sarthak_aditya', 'abhishek20200', 'sunil16202', 'usamabangz', 'albertopf', 'soham', 'deu02214', 'anaghabinu', None, 'nasim_k', 'sgu20161510', 'sangw', 'rupali19158', 'yashwanth_babu', 'singhsanskriti7', 'viplow.singh58.vs', 'manu20187', 'nikhil1285620', 'rajat19154', 'daxpatel1105', 'sgu20161519', 'jyothiprakash']"
9,253,92,8,4,"['chellaramaswamy', 'mummudi12', 'harilavanya', 'prajual']",87,"['suhail17201', 'ridhi19209', 'sandra.pillai9', 'akshat20137', 'romesh17184', 'saxenaakshat13', 'manikantesh.karimikonda', 'trupti.bharati2020', 'yash19203', 'rohansonar74', 'sgu20141341', 'arun19139', 'prabhat19186', 'sgu20161526', 'nikhil128562019', 'ah7221', 'saiteja123', 'pratibha19152', 'sgu20171593', 'janani01101998', 'devesh16145', 'antoniomorchonsabadell', 'thaikus', 'poojabe', 'monu25', 'piyush17173', 'marinagomezcollazo', 'kaylalee', 'tharunkumar.guduru2020', 'kuntal.sarkar2020', 'tushar19163', 'siddharth.shekhar18', 'mounodeep', 'srijani.pal2020', 'shubhi17195', 'sgu20151285', 'pumpkin07', 'amareswar72', 'ushaukat9', 'ghanmnashdhyab', 'amkreddy', 'thko1014', 'sgu20161477', 'siddhant16199', 'wkddbs97', 'riya19192', 'heenakaushik', 'sgu20161542', 'umang2409mittal', 'sareenjatin02', 'gio960830', 'mukul19147', 'subodh19161', 'kevinon21', 'kipkoechvictor3', '97kkdh', 'wcatalan', 'arijitnitaece20vlsi', 'somya17198', 'kyhee5020', 'hemasudha', 'saipavan123', 'prashant19151', 'puneet19189', 'shadowm85', 'dy.ngu57', 'sarthak_aditya', 'abhishek20200', 'sunil16202', 'usamabangz', 'albertopf', 'soham', 'deu02214', 'anaghabinu', 'nasim_k', 'sgu20161510', 'sangw', 'rupali19158', 'yashwanth_babu', 'singhsanskriti7', 'viplow.singh58.vs', 'manu20187', 'nikhil1285620', 'rajat19154', 'daxpatel1105', 'sgu20161519', 'jyothiprakash']",4,"['renjurajuc', None, 'akshara.kairali2020', 'sanjana123']",95,"['suhail17201', 'ridhi19209', 'sandra.pillai9', 'akshat20137', 'romesh17184', 'saxenaakshat13', 'manikantesh.karimikonda', 'trupti.bharati2020', 'yash19203', 'rohansonar74', 'sgu20141341', 'arun19139', 'prabhat19186', 'sgu20161526', 'nikhil128562019', 'ah7221', 'saiteja123', 'pratibha19152', 'sgu20171593', 'janani01101998', 'devesh16145', 'mummudi12', 'antoniomorchonsabadell', 'thaikus', 'poojabe', 'monu25', 'piyush17173', 'marinagomezcollazo', 'kaylalee', 'tharunkumar.guduru2020', 'kuntal.sarkar2020', 'tushar19163', 'siddharth.shekhar18', 'mounodeep', 'srijani.pal2020', 'shubhi17195', 'sgu20151285', 'renjurajuc', 'pumpkin07', 'amareswar72', 'ushaukat9', 'ghanmnashdhyab', 'amkreddy', 'thko1014', 'sgu20161477', 'siddhant16199', 'wkddbs97', 'riya19192', 'heenakaushik', 'chellaramaswamy', 'akshara.kairali2020', 'sgu20161542', 'umang2409mittal', 'sareenjatin02', 'gio960830', 'mukul19147', 'subodh19161', 'kevinon21', 'prajual', 'kipkoechvictor3', '97kkdh', 'wcatalan', 'arijitnitaece20vlsi', 'somya17198', 'harilavanya', 'kyhee5020', 'hemasudha', 'saipavan123', 'prashant19151', 'puneet19189', 'shadowm85', 'dy.ngu57', 'sarthak_aditya', 'abhishek20200', 'sunil16202', 'usamabangz', 'albertopf', 'soham', 'deu02214', 'anaghabinu', None, 'nasim_k', 'sanjana123', 'sgu20161510', 'sangw', 'rupali19158', 'yashwanth_babu', 'singhsanskriti7', 'viplow.singh58.vs', 'manu20187', 'nikhil1285620', 'rajat19154', 'daxpatel1105', 'sgu20161519', 'jyothiprakash']"
9,267,92,7,3,"['shubhi17195', 'romesh17184', 'yashwanth_babu']",88,"['suhail17201', 'ridhi19209', 'sandra.pillai9', 'akshat20137', 'saxenaakshat13', 'manikantesh.karimikonda', 'trupti.bharati2020', 'yash19203', 'rohansonar74', 'sgu20141341', 'arun19139', 'prabhat19186', 'sgu20161526', 'nikhil128562019', 'ah7221', 'saiteja123', 'pratibha19152', 'sgu20171593', 'janani01101998', 'devesh16145', 'mummudi12', 'antoniomorchonsabadell', 'thaikus', 'poojabe', 'monu25', 'piyush17173', 'marinagomezcollazo', 'kaylalee', 'tharunkumar.guduru2020', 'kuntal.sarkar2020', 'tushar19163', 'siddharth.shekhar18', 'mounodeep', 'srijani.pal2020', 'sgu20151285', 'pumpkin07', 'amareswar72', 'ushaukat9', 'ghanmnashdhyab', 'amkreddy', 'thko1014', 'sgu20161477', 'siddhant16199', 'wkddbs97', 'riya19192', 'heenakaushik', 'chellaramaswamy', 'sgu20161542', 'umang2409mittal', 'sareenjatin02', 'gio960830', 'mukul19147', 'subodh19161', 'kevinon21', 'prajual', 'kipkoechvictor3', '97kkdh', 'wcatalan', 'arijitnitaece20vlsi', 'somya17198', 'harilavanya', 'kyhee5020', 'hemasudha', 'saipavan123', 'prashant19151', 'puneet19189', 'shadowm85', 'dy.ngu57', 'sarthak_aditya', 'abhishek20200', 'sunil16202', 'usamabangz', 'albertopf', 'soham', 'deu02214', 'anaghabinu', 'nasim_k', 'sgu20161510', 'sangw', 'rupali19158', 'singhsanskriti7', 'viplow.singh58.vs', 'manu20187', 'nikhil1285620', 'rajat19154', 'daxpatel1105', 'sgu20161519', 'jyothiprakash']",4,"['sarvagya19159', 'diksha19145', None, 'vishal19201']",95,"['suhail17201', 'ridhi19209', 'sandra.pillai9', 'akshat20137', 'romesh17184', 'saxenaakshat13', 'manikantesh.karimikonda', 'trupti.bharati2020', 'yash19203', 'rohansonar74', 'sgu20141341', 'diksha19145', 'arun19139', 'prabhat19186', 'sgu20161526', 'nikhil128562019', 'ah7221', 'saiteja123', 'sarvagya19159', 'pratibha19152', 'sgu20171593', 'janani01101998', 'devesh16145', 'mummudi12', 'antoniomorchonsabadell', 'thaikus', 'poojabe', 'monu25', 'piyush17173', 'marinagomezcollazo', 'kaylalee', 'tharunkumar.guduru2020', 'kuntal.sarkar2020', 'tushar19163', 'vishal19201', 'siddharth.shekhar18', 'mounodeep', 'srijani.pal2020', 'shubhi17195', 'sgu20151285', 'pumpkin07', 'amareswar72', 'ushaukat9', 'ghanmnashdhyab', 'amkreddy', 'thko1014', 'sgu20161477', 'siddhant16199', 'wkddbs97', 'riya19192', 'heenakaushik', 'chellaramaswamy', 'sgu20161542', 'umang2409mittal', 'sareenjatin02', 'gio960830', 'mukul19147', 'subodh19161', 'kevinon21', 'prajual', 'kipkoechvictor3', '97kkdh', 'wcatalan', 'arijitnitaece20vlsi', 'somya17198', 'harilavanya', 'kyhee5020', 'hemasudha', 'saipavan123', 'prashant19151', 'puneet19189', 'shadowm85', 'dy.ngu57', 'sarthak_aditya', 'abhishek20200', 'sunil16202', 'usamabangz', 'albertopf', 'soham', 'deu02214', 'anaghabinu', None, 'nasim_k', 'sgu20161510', 'sangw', 'rupali19158', 'yashwanth_babu', 'singhsanskriti7', 'viplow.singh58.vs', 'manu20187', 'nikhil1285620', 'rajat19154', 'daxpatel1105', 'sgu20161519', 'jyothiprakash']"
9,268,92,7,1,['wcatalan'],90,"['suhail17201', 'ridhi19209', 'sandra.pillai9', 'akshat20137', 'romesh17184', 'saxenaakshat13', 'manikantesh.karimikonda', 'trupti.bharati2020', 'yash19203', 'rohansonar74', 'sgu20141341', 'arun19139', 'prabhat19186', 'sgu20161526', 'nikhil128562019', 'ah7221', 'saiteja123', 'pratibha19152', 'sgu20171593', 'janani01101998', 'devesh16145', 'mummudi12', 'antoniomorchonsabadell', 'thaikus', 'poojabe', 'monu25', 'piyush17173', 'marinagomezcollazo', 'kaylalee', 'tharunkumar.guduru2020', 'kuntal.sarkar2020', 'tushar19163', 'siddharth.shekhar18', 'mounodeep', 'srijani.pal2020', 'shubhi17195', 'sgu20151285', 'pumpkin07', 'amareswar72', 'ushaukat9', 'ghanmnashdhyab', 'amkreddy', 'thko1014', 'sgu20161477', 'siddhant16199', 'wkddbs97', 'riya19192', 'heenakaushik', 'chellaramaswamy', 'sgu20161542', 'umang2409mittal', 'sareenjatin02', 'gio960830', 'mukul19147', 'subodh19161', 'kevinon21', 'prajual', 'kipkoechvictor3', '97kkdh', 'arijitnitaece20vlsi', 'somya17198', 'harilavanya', 'kyhee5020', 'hemasudha', 'saipavan123', 'prashant19151', 'puneet19189', 'shadowm85', 'dy.ngu57', 'sarthak_aditya', 'abhishek20200', 'sunil16202', 'usamabangz', 'albertopf', 'soham', 'deu02214', 'anaghabinu', 'nasim_k', 'sgu20161510', 'sangw', 'rupali19158', 'yashwanth_babu', 'singhsanskriti7', 'viplow.singh58.vs', 'manu20187', 'nikhil1285620', 'rajat19154', 'daxpatel1105', 'sgu20161519', 'jyothiprakash']",6,"['deepthi31', 'generalsherman123', 'josephnguyen42', 'henrylin14', 'jtam7501', None]",97,"['suhail17201', 'ridhi19209', 'sandra.pillai9', 'akshat20137', 'romesh17184', 'saxenaakshat13', 'manikantesh.karimikonda', 'trupti.bharati2020', 'yash19203', 'rohansonar74', 'sgu20141341', 'arun19139', 'prabhat19186', 'sgu20161526', 'nikhil128562019', 'ah7221', 'saiteja123', 'pratibha19152', 'josephnguyen42', 'sgu20171593', 'janani01101998', 'devesh16145', 'mummudi12', 'antoniomorchonsabadell', 'thaikus', 'poojabe', 'monu25', 'piyush17173', 'marinagomezcollazo', 'kaylalee', 'tharunkumar.guduru2020', 'kuntal.sarkar2020', 'tushar19163', 'siddharth.shekhar18', 'mounodeep', 'srijani.pal2020', 'shubhi17195', 'sgu20151285', 'pumpkin07', 'amareswar72', 'ushaukat9', 'ghanmnashdhyab', 'amkreddy', 'thko1014', 'generalsherman123', 'sgu20161477', 'siddhant16199', 'henrylin14', 'wkddbs97', 'riya19192', 'heenakaushik', 'chellaramaswamy', 'sgu20161542', 'umang2409mittal', 'sareenjatin02', 'gio960830', 'mukul19147', 'subodh19161', 'kevinon21', 'prajual', 'kipkoechvictor3', '97kkdh', 'wcatalan', 'arijitnitaece20vlsi', 'somya17198', 'harilavanya', 'kyhee5020', 'hemasudha', 'saipavan123', 'prashant19151', 'deepthi31', 'puneet19189', 'shadowm85', 'dy.ngu57', 'sarthak_aditya', 'abhishek20200', 'sunil16202', 'usamabangz', 'albertopf', 'soham', 'jtam7501', 'deu02214', 'anaghabinu', None, 'nasim_k', 'sgu20161510', 'sangw', 'rupali19158', 'yashwanth_babu', 'singhsanskriti7', 'viplow.singh58.vs', 'manu20187', 'nikhil1285620', 'rajat19154', 'daxpatel1105', 'sgu20161519', 'jyothiprakash']"
9,318,92,6,1,['gio960830'],90,"['suhail17201', 'ridhi19209', 'sandra.pillai9', 'akshat20137', 'romesh17184', 'saxenaakshat13', 'manikantesh.karimikonda', 'trupti.bharati2020', 'yash19203', 'rohansonar74', 'sgu20141341', 'arun19139', 'prabhat19186', 'sgu20161526', 'nikhil128562019', 'ah7221', 'saiteja123', 'pratibha19152', 'sgu20171593', 'janani01101998', 'devesh16145', 'mummudi12', 'antoniomorchonsabadell', 'thaikus', 'poojabe', 'monu25', 'piyush17173', 'marinagomezcollazo', 'kaylalee', 'tharunkumar.guduru2020', 'kuntal.sarkar2020', 'tushar19163', 'siddharth.shekhar18', 'mounodeep', 'srijani.pal2020', 'shubhi17195', 'sgu20151285', 'pumpkin07', 'amareswar72', 'ushaukat9', 'ghanmnashdhyab', 'amkreddy', 'thko1014', 'sgu20161477', 'siddhant16199', 'wkddbs97', 'riya19192', 'heenakaushik', 'chellaramaswamy', 'sgu20161542', 'umang2409mittal', 'sareenjatin02', 'mukul19147', 'subodh19161', 'kevinon21', 'prajual', 'kipkoechvictor3', '97kkdh', 'wcatalan', 'arijitnitaece20vlsi', 'somya17198', 'harilavanya', 'kyhee5020', 'hemasudha', 'saipavan123', 'prashant19151', 'puneet19189', 'shadowm85', 'dy.ngu57', 'sarthak_aditya', 'abhishek20200', 'sunil16202', 'usamabangz', 'albertopf', 'soham', 'deu02214', 'anaghabinu', 'nasim_k', 'sgu20161510', 'sangw', 'rupali19158', 'yashwanth_babu', 'singhsanskriti7', 'viplow.singh58.vs', 'manu20187', 'nikhil1285620', 'rajat19154', 'daxpatel1105', 'sgu20161519', 'jyothiprakash']",5,"['taehojung', 'sgu201514116', 'sgu20181520', 'sepsep2000', None]",96,"['suhail17201', 'ridhi19209', 'sandra.pillai9', 'akshat20137', 'romesh17184', 'saxenaakshat13', 'manikantesh.karimikonda', 'trupti.bharati2020', 'yash19203', 'rohansonar74', 'sgu20141341', 'sgu20181520', 'sepsep2000', 'arun19139', 'prabhat19186', 'sgu20161526', 'nikhil128562019', 'ah7221', 'saiteja123', 'pratibha19152', 'sgu20171593', 'janani01101998', 'devesh16145', 'mummudi12', 'antoniomorchonsabadell', 'thaikus', 'poojabe', 'monu25', 'piyush17173', 'marinagomezcollazo', 'kaylalee', 'tharunkumar.guduru2020', 'kuntal.sarkar2020', 'tushar19163', 'siddharth.shekhar18', 'mounodeep', 'srijani.pal2020', 'shubhi17195', 'sgu20151285', 'pumpkin07', 'amareswar72', 'ushaukat9', 'ghanmnashdhyab', 'amkreddy', 'thko1014', 'sgu20161477', 'siddhant16199', 'wkddbs97', 'riya19192', 'heenakaushik', 'chellaramaswamy', 'sgu20161542', 'umang2409mittal', 'sareenjatin02', 'gio960830', 'mukul19147', 'subodh19161', 'kevinon21', 'sgu201514116', 'prajual', 'kipkoechvictor3', '97kkdh', 'wcatalan', 'arijitnitaece20vlsi', 'somya17198', 'harilavanya', 'kyhee5020', 'hemasudha', 'saipavan123', 'prashant19151', 'puneet19189', 'taehojung', 'shadowm85', 'dy.ngu57', 'sarthak_aditya', 'abhishek20200', 'sunil16202', 'usamabangz', 'albertopf', 'soham', 'deu02214', 'anaghabinu', None, 'nasim_k', 'sgu20161510', 'sangw', 'rupali19158', 'yashwanth_babu', 'singhsanskriti7', 'viplow.singh58.vs', 'manu20187', 'nikhil1285620', 'rajat19154', 'daxpatel1105', 'sgu20161519', 'jyothiprakash']"
10,220,86,19,16,"['ncaiwu', 'zheng545', 'fifauefa12', 'li3402', 'zh1806855308', 'park1142', 'sun875', 'song617', 'hou125', 'ljx6220118', 'shen441', 'zhou1012', 'jwhitford', 'hegartya', 'frengifo', 'wang4022']",69,"['lu752', 'ihu', 'yerin.park0307', 'zqubain', 'blanke16', 'husky523', 'park828', 'csuganeh', 'han563', 'mengqi0409', 'kkm97183', 'oconno39', 'little62', 'ray5d', 'wpavlick', 'lmeira2001', 'ntollett', 'jasoncai', 'owenguapp', 'hall532', 'jcabanfl', 'dchurkin', 'li3495', 'kang401', '7erimyszsy2001m', 'jess24', 'vpillai002', 'samfu199103', 'rdheer', 'cdavin', 'asaady', 'yin181', 'kang226', 'anirudhsivarajan23', 'chen3261', 'ipatino', 'park1155', 'dcinarli', 'adrianbarflores', 'vincenzomazur00', 'fappiagy', 'tonywu', 'rgutwein', 'ericshuisyy', 'vmazur', 'nickverastegui2020', 'chen3269', 'akanbi104', 'hfulford', 'kcunnane', 'dtaveeva', 'rodri680', 'menon43', 'zhao986', 'lo90', 'masonj10251', 'huubach123', 'raschellin', 'cchad2019', 'ho171', 'pzinfon', 'onlyforyiming', 'gxy20001012', 'snamgung', 'toth39', 'song487', 'liys3095', 'guo545', 'vasilj']",3,"['tmoore', None, 'gu256']",88,"['lu752', 'ncaiwu', 'ihu', 'park1142', 'ljx6220118', 'yerin.park0307', 'zqubain', 'blanke16', 'husky523', 'li3402', 'sun875', 'park828', 'csuganeh', 'han563', 'mengqi0409', 'kkm97183', 'oconno39', 'little62', 'ray5d', 'wpavlick', 'lmeira2001', 'ntollett', 'zh1806855308', 'jasoncai', 'tmoore', 'owenguapp', 'hall532', 'jcabanfl', 'dchurkin', 'jwhitford', 'hegartya', 'li3495', 'kang401', '7erimyszsy2001m', 'jess24', 'vpillai002', 'hou125', 'samfu199103', 'rdheer', 'cdavin', 'asaady', 'yin181', 'zheng545', 'fifauefa12', 'kang226', 'anirudhsivarajan23', 'chen3261', 'ipatino', 'park1155', 'dcinarli', 'adrianbarflores', 'vincenzomazur00', 'zhou1012', 'fappiagy', 'tonywu', 'rgutwein', 'ericshuisyy', 'vmazur', 'nickverastegui2020', 'chen3269', 'akanbi104', 'hfulford', 'kcunnane', 'dtaveeva', 'rodri680', 'wang4022', 'menon43', 'zhao986', 'lo90', 'masonj10251', 'huubach123', 'raschellin', 'cchad2019', None, 'gu256', 'ho171', 'pzinfon', 'song617', 'onlyforyiming', 'gxy20001012', 'snamgung', 'toth39', 'song487', 'liys3095', 'shen441', 'guo545', 'vasilj', 'frengifo']"
10,221,86,8,4,"['liys3095', 'akanbi104', 'anirudhsivarajan23', 'vasilj']",81,"['lu752', 'ncaiwu', 'ihu', 'park1142', 'ljx6220118', 'yerin.park0307', 'zqubain', 'blanke16', 'husky523', 'li3402', 'sun875', 'park828', 'csuganeh', 'han563', 'mengqi0409', 'kkm97183', 'oconno39', 'little62', 'ray5d', 'wpavlick', 'lmeira2001', 'ntollett', 'zh1806855308', 'jasoncai', 'owenguapp', 'hall532', 'jcabanfl', 'dchurkin', 'jwhitford', 'hegartya', 'li3495', 'kang401', '7erimyszsy2001m', 'jess24', 'vpillai002', 'hou125', 'samfu199103', 'rdheer', 'cdavin', 'asaady', 'yin181', 'zheng545', 'fifauefa12', 'kang226', 'chen3261', 'ipatino', 'park1155', 'dcinarli', 'adrianbarflores', 'vincenzomazur00', 'zhou1012', 'fappiagy', 'tonywu', 'rgutwein', 'ericshuisyy', 'vmazur', 'nickverastegui2020', 'chen3269', 'hfulford', 'kcunnane', 'dtaveeva', 'rodri680', 'wang4022', 'menon43', 'zhao986', 'lo90', 'masonj10251', 'huubach123', 'raschellin', 'cchad2019', 'ho171', 'pzinfon', 'song617', 'onlyforyiming', 'gxy20001012', 'snamgung', 'toth39', 'song487', 'shen441', 'guo545', 'frengifo']",4,"['bermel', None, 'iczajkow', 'seanm']",89,"['lu752', 'ncaiwu', 'ihu', 'park1142', 'ljx6220118', 'yerin.park0307', 'zqubain', 'blanke16', 'husky523', 'li3402', 'sun875', 'park828', 'csuganeh', 'han563', 'mengqi0409', 'kkm97183', 'oconno39', 'seanm', 'little62', 'ray5d', 'wpavlick', 'lmeira2001', 'bermel', 'ntollett', 'zh1806855308', 'jasoncai', 'owenguapp', 'hall532', 'jcabanfl', 'dchurkin', 'jwhitford', 'hegartya', 'li3495', 'kang401', '7erimyszsy2001m', 'jess24', 'vpillai002', 'hou125', 'samfu199103', 'rdheer', 'cdavin', 'asaady', 'yin181', 'zheng545', 'fifauefa12', 'kang226', 'anirudhsivarajan23', 'chen3261', 'ipatino', 'park1155', 'dcinarli', 'adrianbarflores', 'vincenzomazur00', 'zhou1012', 'fappiagy', 'tonywu', 'rgutwein', 'ericshuisyy', 'vmazur', 'nickverastegui2020', 'chen3269', 'iczajkow', 'akanbi104', 'hfulford', 'kcunnane', 'dtaveeva', 'rodri680', 'wang4022', 'menon43', 'zhao986', 'lo90', 'masonj10251', 'huubach123', 'raschellin', 'cchad2019', None, 'ho171', 'pzinfon', 'song617', 'onlyforyiming', 'gxy20001012', 'snamgung', 'toth39', 'song487', 'liys3095', 'shen441', 'guo545', 'vasilj', 'frengifo']"
11,270,85,115,48,"['claytkg', 'bohangni', 'boyer23', 'nhelstro', 'kbalon2599', 'aomoniy', 'shonnigf', 'king399', 'hamadeo', 'aklitzin', 'tcounse', 'amatus', 'rookie7201', 'aaryanp', 'lorenz17', 'wu1283', 'rach', 'webbie.mao', 'malone99', 'jkliebh', 'cdiscoe', 'max_pack', 'czrelak', 'hogan46', 'ayusabrina.asas', 'glut3n', 'kerr32', 'carls127', 'swiftl116', 'mills21rdp', 'dmarcha', 'castil77', 'dawson41', 'mglimche', 'alexge', 'lazaraleksic', 'harter4', 'jayaramm', 'ngeer', 'mqz857277715', 'pdahlstr', 'beckpe', 'zyao16811', 'duarte3', 'joecasella252', 'huan1318', 'soni12', 'campb335']",36,"['ktbrode22', 'aguarner', 'cthamara', 'lfabries', 'tchen135', 'tarighat.amir', 'nklockow', 'bi29', 'lee1965', 'sarawhite99', 'jimmyzhu', 'jin315', 'ldefrei', 'gabriel.ddcosta', 'hall488', 'slavasorkin', 'eklueppe', 'holt47', 'mchrisiglesias', 'campb339', 'kkrinnin', 'mtallman', 'ronny927', 'fergsjw', 'jamesmallett', 'chen2505', 'mpugsley', 'gotoa', 'lu668', 'yueziang98', 'clark665', 'wu1326', 'hatmut', 'mitchellw0815', 'camronn.hale', 'skhayyat']",67,"['jsendon', 'ahmad44', 'hshrote', 'smit3522', 'cstrider', 'mlennar', 'nqmain', 'imran1', 'estockwe', 'jacobczajac', 'wheffern', 'hartm109', 'kim2841', 'dick21', 'carvalho', 'beshay', 'acharter16', 'cfeustel', 'cdunn', 'wiley29', 'popp4', 'huan1260', 'missahaq', 'jzwierz', 'mill2201', 'jack.t.roy42', 'nquick', 'kleber0', 'yu780', 'vfebus', 'crawfo76', 'cdenoo', 'mfroelic', 'rfranco', 'campb294', 'jabarigarraway', 'bauer85', 'li3422', 'yang1098', 'azovko', 'rjammula', 'kerr38', 'aalhabsi', 'akhairul', 'lhoppenr', 'bianchik', 'audyavar', 'lucas120', 'dildyks', None, 'gu256', 'lcaspari', 'lararipe', 'sachdev6', 'balpert', 'clark600', 'glaneve', 'hutchi47', 'li2978', 'robin498', 'sujal.yagnik', 'rkeyser', 'randy14rhh2', 'haoyangliu', 'noah.stern99', 'dhanixv0', 'acarrilh']",151,"['nhelstro', 'kbalon2599', 'hshrote', 'shonnigf', 'nqmain', 'aklitzin', 'hartm109', 'dick21', 'carvalho', 'rookie7201', 'aaryanp', 'cfeustel', 'cdunn', 'rach', 'webbie.mao', 'missahaq', 'mill2201', 'jack.t.roy42', 'glut3n', 'cdenoo', 'mfroelic', 'rfranco', 'mills21rdp', 'dmarcha', 'kerr38', 'eklueppe', 'akhairul', 'mglimche', 'lcaspari', 'jamesmallett', 'chen2505', 'sachdev6', 'balpert', 'clark600', 'clark665', 'li2978', 'robin498', 'wu1326', 'hatmut', 'jsendon', 'ahmad44', 'smit3522', 'lfabries', 'hamadeo', 'tcounse', 'kim2841', 'lorenz17', 'wiley29', 'popp4', 'malone99', 'huan1260', 'max_pack', 'nquick', 'yu780', 'hall488', 'bauer85', 'carls127', 'slavasorkin', 'castil77', 'aalhabsi', 'lhoppenr', 'bianchik', 'alexge', 'campb339', None, 'gu256', 'mqz857277715', 'glaneve', 'sujal.yagnik', 'soni12', 'randy14rhh2', 'acarrilh', 'skhayyat', 'ktbrode22', 'cstrider', 'cthamara', 'king399', 'imran1', 'amatus', 'tarighat.amir', 'estockwe', 'wheffern', 'acharter16', 'bi29', 'lee1965', 'jkliebh', 'czrelak', 'jimmyzhu', 'ldefrei', 'gabriel.ddcosta', 'ayusabrina.asas', 'vfebus', 'campb294', 'li3422', 'dawson41', 'holt47', 'audyavar', 'harter4', 'kkrinnin', 'dildyks', 'ronny927', 'mpugsley', 'pdahlstr', 'beckpe', 'lu668', 'zyao16811', 'hutchi47', 'yueziang98', 'duarte3', 'joecasella252', 'rkeyser', 'haoyangliu', 'camronn.hale', 'campb335', 'claytkg', 'bohangni', 'boyer23', 'aguarner', 'aomoniy', 'mlennar', 'tchen135', 'jacobczajac', 'beshay', 'wu1283', 'sarawhite99', 'cdiscoe', 'jzwierz', 'hogan46', 'jin315', 'kleber0', 'crawfo76', 'jabarigarraway', 'kerr32', 'yang1098', 'azovko', 'swiftl116', 'rjammula', 'lazaraleksic', 'mchrisiglesias', 'lucas120', 'mtallman', 'fergsjw', 'jayaramm', 'ngeer', 'gotoa', 'lararipe', 'huan1318', 'noah.stern99', 'mitchellw0815', 'nklockow', 'dhanixv0']"
11,273,85,107,41,"['claytkg', 'bohangni', 'boyer23', 'nhelstro', 'kbalon2599', 'aomoniy', 'king399', 'hamadeo', 'aklitzin', 'tcounse', 'amatus', 'rookie7201', 'lorenz17', 'wu1283', 'rach', 'webbie.mao', 'malone99', 'jkliebh', 'max_pack', 'czrelak', 'hogan46', 'ayusabrina.asas', 'kerr32', 'carls127', 'swiftl116', 'dmarcha', 'castil77', 'mglimche', 'alexge', 'lazaraleksic', 'harter4', 'jayaramm', 'ngeer', 'mqz857277715', 'pdahlstr', 'beckpe', 'zyao16811', 'duarte3', 'joecasella252', 'soni12', 'campb335']",43,"['ktbrode22', 'aguarner', 'cthamara', 'shonnigf', 'lfabries', 'tchen135', 'tarighat.amir', 'nklockow', 'aaryanp', 'bi29', 'lee1965', 'sarawhite99', 'cdiscoe', 'jimmyzhu', 'jin315', 'ldefrei', 'gabriel.ddcosta', 'glut3n', 'hall488', 'slavasorkin', 'mills21rdp', 'eklueppe', 'dawson41', 'holt47', 'mchrisiglesias', 'campb339', 'kkrinnin', 'mtallman', 'ronny927', 'fergsjw', 'jamesmallett', 'chen2505', 'mpugsley', 'gotoa', 'lu668', 'yueziang98', 'clark665', 'huan1318', 'wu1326', 'hatmut', 'mitchellw0815', 'camronn.hale', 'skhayyat']",66,"['jsendon', 'ahmad44', 'hshrote', 'cstrider', 'mlennar', 'nqmain', 'imran1', 'estockwe', 'wheffern', 'hartm109', 'kim2841', 'dick21', 'carvalho', 'beshay', 'cfeustel', 'ehultman', 'cdunn', 'wiley29', 'kortee', 'huan1260', 'jzwierz', 'mill2201', 'jack.t.roy42', 'nquick', 'kleber0', 'yu780', 'vfebus', 'crawfo76', 'cdenoo', 'mfroelic', 'rfranco', 'campb294', 'jabarigarraway', 'bauer85', 'li3422', 'yang1098', 'azovko', 'rjammula', 'kerr38', 'aalhabsi', 'akhairul', 'bianchik', 'audyavar', 'hrubyr', 'lucas120', 'dildyks', None, 'gu256', 'sboelitz', 'scroskey', 'lararipe', 'sachdev6', 'balpert', 'clark600', 'glaneve', 'hutchi47', 'li2978', 'robin498', 'sujal.yagnik', 'rkeyser', 'randy14rhh2', 'haoyangliu', 'noah.stern99', 'dhanixv0', 'mullin21', 'acarrilh']",150,"['nhelstro', 'kbalon2599', 'hshrote', 'shonnigf', 'nqmain', 'aklitzin', 'hartm109', 'dick21', 'carvalho', 'rookie7201', 'aaryanp', 'cfeustel', 'cdunn', 'rach', 'webbie.mao', 'mill2201', 'jack.t.roy42', 'glut3n', 'cdenoo', 'mfroelic', 'rfranco', 'mills21rdp', 'dmarcha', 'kerr38', 'eklueppe', 'akhairul', 'mglimche', 'sboelitz', 'jamesmallett', 'chen2505', 'sachdev6', 'balpert', 'clark600', 'clark665', 'li2978', 'robin498', 'wu1326', 'hatmut', 'jsendon', 'ahmad44', 'lfabries', 'hamadeo', 'tcounse', 'kim2841', 'lorenz17', 'wiley29', 'malone99', 'huan1260', 'max_pack', 'nquick', 'yu780', 'hall488', 'bauer85', 'carls127', 'slavasorkin', 'castil77', 'aalhabsi', 'bianchik', 'alexge', 'campb339', None, 'gu256', 'scroskey', 'mqz857277715', 'glaneve', 'sujal.yagnik', 'soni12', 'randy14rhh2', 'acarrilh', 'skhayyat', 'ktbrode22', 'cstrider', 'cthamara', 'king399', 'imran1', 'amatus', 'tarighat.amir', 'estockwe', 'wheffern', 'bi29', 'lee1965', 'jkliebh', 'czrelak', 'jimmyzhu', 'ldefrei', 'gabriel.ddcosta', 'ayusabrina.asas', 'vfebus', 'campb294', 'li3422', 'dawson41', 'holt47', 'audyavar', 'harter4', 'kkrinnin', 'dildyks', 'ronny927', 'mpugsley', 'pdahlstr', 'beckpe', 'lu668', 'zyao16811', 'hutchi47', 'yueziang98', 'duarte3', 'joecasella252', 'rkeyser', 'haoyangliu', 'camronn.hale', 'mullin21', 'campb335', 'claytkg', 'bohangni', 'boyer23', 'aguarner', 'aomoniy', 'mlennar', 'tchen135', 'beshay', 'ehultman', 'wu1283', 'sarawhite99', 'kortee', 'cdiscoe', 'jzwierz', 'hogan46', 'jin315', 'kleber0', 'crawfo76', 'jabarigarraway', 'kerr32', 'yang1098', 'azovko', 'swiftl116', 'rjammula', 'lazaraleksic', 'mchrisiglesias', 'hrubyr', 'lucas120', 'mtallman', 'fergsjw', 'jayaramm', 'ngeer', 'gotoa', 'lararipe', 'huan1318', 'noah.stern99', 'mitchellw0815', 'nklockow', 'dhanixv0']"
11,271,85,33,17,"['mpugsley', 'gotoa', 'ktbrode22', 'sarawhite99', 'aguarner', 'eklueppe', 'camronn.hale', 'lfabries', 'tchen135', 'mtallman', 'campb335', 'wu1326', 'ldefrei', 'kkrinnin', 'ronny927', 'hall488', 'jayaramm']",67,"['claytkg', 'bohangni', 'boyer23', 'nhelstro', 'kbalon2599', 'cthamara', 'aomoniy', 'shonnigf', 'king399', 'hamadeo', 'aklitzin', 'tcounse', 'amatus', 'tarighat.amir', 'nklockow', 'rookie7201', 'aaryanp', 'lorenz17', 'bi29', 'lee1965', 'wu1283', 'rach', 'webbie.mao', 'malone99', 'jkliebh', 'cdiscoe', 'max_pack', 'czrelak', 'jimmyzhu', 'hogan46', 'jin315', 'gabriel.ddcosta', 'ayusabrina.asas', 'glut3n', 'kerr32', 'carls127', 'slavasorkin', 'swiftl116', 'mills21rdp', 'dmarcha', 'castil77', 'dawson41', 'holt47', 'mglimche', 'alexge', 'lazaraleksic', 'campb339', 'harter4', 'mchrisiglesias', 'fergsjw', 'ngeer', 'jamesmallett', 'chen2505', 'mqz857277715', 'pdahlstr', 'beckpe', 'lu668', 'zyao16811', 'yueziang98', 'clark665', 'duarte3', 'joecasella252', 'huan1318', 'hatmut', 'soni12', 'mitchellw0815', 'skhayyat']",16,"['chakra26', 'mohamadn', None, 'cdunn', 'wells130', 'jvanwing', 'chen2467', 'gdadlani', 'york33', 'pike14', 'clancy6', 'elutgen', 'haoyangliu', 'ctorger', 'zosterlo', 'boston2']",100,"['ktbrode22', 'nhelstro', 'kbalon2599', 'cthamara', 'shonnigf', 'king399', 'amatus', 'aklitzin', 'tarighat.amir', 'rookie7201', 'aaryanp', 'bi29', 'lee1965', 'cdunn', 'rach', 'webbie.mao', 'jkliebh', 'czrelak', 'clancy6', 'jimmyzhu', 'ldefrei', 'gabriel.ddcosta', 'ayusabrina.asas', 'glut3n', 'ctorger', 'zosterlo', 'mills21rdp', 'dmarcha', 'eklueppe', 'dawson41', 'holt47', 'mglimche', 'harter4', 'kkrinnin', 'elutgen', 'ronny927', 'wells130', 'jamesmallett', 'chen2505', 'mpugsley', 'pdahlstr', 'beckpe', 'lu668', 'zyao16811', 'chen2467', 'yueziang98', 'clark665', 'duarte3', 'york33', 'joecasella252', 'wu1326', 'hatmut', 'haoyangliu', 'camronn.hale', 'campb335', 'jvanwing', 'claytkg', 'bohangni', 'boyer23', 'aguarner', 'aomoniy', 'lfabries', 'tchen135', 'hamadeo', 'tcounse', 'pike14', 'lorenz17', 'chakra26', 'wu1283', 'sarawhite99', 'malone99', 'cdiscoe', 'gdadlani', 'max_pack', 'hogan46', 'jin315', 'hall488', 'kerr32', 'mohamadn', 'carls127', 'slavasorkin', 'swiftl116', 'castil77', 'alexge', 'lazaraleksic', 'mchrisiglesias', 'campb339', 'mtallman', 'fergsjw', None, 'jayaramm', 'ngeer', 'boston2', 'mqz857277715', 'gotoa', 'huan1318', 'soni12', 'mitchellw0815', 'nklockow', 'skhayyat']"
11,272,85,9,3,"['yueziang98', 'mitchellw0815', 'nklockow']",81,"['ktbrode22', 'nhelstro', 'kbalon2599', 'cthamara', 'shonnigf', 'king399', 'amatus', 'aklitzin', 'tarighat.amir', 'rookie7201', 'aaryanp', 'bi29', 'lee1965', 'rach', 'webbie.mao', 'jkliebh', 'czrelak', 'jimmyzhu', 'ldefrei', 'gabriel.ddcosta', 'ayusabrina.asas', 'glut3n', 'mills21rdp', 'dmarcha', 'eklueppe', 'dawson41', 'holt47', 'mglimche', 'harter4', 'kkrinnin', 'ronny927', 'jamesmallett', 'chen2505', 'mpugsley', 'pdahlstr', 'beckpe', 'lu668', 'zyao16811', 'clark665', 'duarte3', 'joecasella252', 'wu1326', 'hatmut', 'camronn.hale', 'campb335', 'claytkg', 'bohangni', 'boyer23', 'aguarner', 'aomoniy', 'lfabries', 'tchen135', 'hamadeo', 'tcounse', 'lorenz17', 'wu1283', 'sarawhite99', 'malone99', 'cdiscoe', 'max_pack', 'hogan46', 'jin315', 'hall488', 'kerr32', 'carls127', 'slavasorkin', 'swiftl116', 'castil77', 'alexge', 'lazaraleksic', 'mchrisiglesias', 'campb339', 'mtallman', 'fergsjw', 'jayaramm', 'ngeer', 'mqz857277715', 'gotoa', 'huan1318', 'soni12', 'skhayyat']",6,"['konstantin', None, 'scott483', 'cannon333', 'ztowne', 'atkins27']",90,"['ktbrode22', 'nhelstro', 'kbalon2599', 'cthamara', 'shonnigf', 'king399', 'amatus', 'aklitzin', 'tarighat.amir', 'scott483', 'rookie7201', 'aaryanp', 'bi29', 'lee1965', 'rach', 'webbie.mao', 'jkliebh', 'cannon333', 'czrelak', 'jimmyzhu', 'ldefrei', 'gabriel.ddcosta', 'ayusabrina.asas', 'glut3n', 'ztowne', 'mills21rdp', 'dmarcha', 'eklueppe', 'dawson41', 'holt47', 'mglimche', 'harter4', 'kkrinnin', 'ronny927', 'jamesmallett', 'chen2505', 'mpugsley', 'pdahlstr', 'beckpe', 'lu668', 'zyao16811', 'yueziang98', 'clark665', 'duarte3', 'joecasella252', 'wu1326', 'hatmut', 'camronn.hale', 'campb335', 'claytkg', 'konstantin', 'bohangni', 'boyer23', 'aguarner', 'aomoniy', 'lfabries', 'tchen135', 'hamadeo', 'tcounse', 'lorenz17', 'wu1283', 'sarawhite99', 'malone99', 'cdiscoe', 'max_pack', 'hogan46', 'jin315', 'hall488', 'kerr32', 'carls127', 'slavasorkin', 'swiftl116', 'castil77', 'alexge', 'lazaraleksic', 'mchrisiglesias', 'campb339', 'mtallman', 'fergsjw', None, 'jayaramm', 'ngeer', 'atkins27', 'mqz857277715', 'gotoa', 'huan1318', 'soni12', 'mitchellw0815', 'nklockow', 'skhayyat']"
12,386,83,183,69,"['espejodaniel6', 'liresaferizaj', 'elsaa', 'verone.krasniqi', 'medinehajredini', 'artin.sermaxhaj', 'domagoj.tomic', 'kastriotsalihu', 'andi.dika', 'enes.hasani', 'elton.kaqiu', 'bleon.alimi', 'gentihyseni11', 'lookatfuture09', 'njomza.rexhepi3', 'keremino', 'flamur.mustafa', 'ilir.jasharaj', 'lislimani', 'adonis.xhemajli', 'blerand.mjeku', 'koushik.cc', 'jonathancollins55', 'recaro13', 'barbana.heta', 'erblina2berisha', 's.kasamatsu', 'donat.aliu147', 'lauragashi', 'solarwing', 'musa.kadiri', 'artine.hoxha', 'florian.halimi1', 'nazifebeqiri59', 'acastro34', 'julinda.nasufi', 'bardha.januzi', 'midie.merovci', 'blerona.emini', 'patelba', 'hjhj8794', 'barbanataraheta', 'elona.rashica', 'albin.sejdiu', 'yaohuichen', 'jaylenwang', 'kfullen', 'christianc2', 'nrcnaltinbas', 'alberianatofaj', 'elona.gervalla', 'jfmuller', 'lindkrasniqi', 'petrini', 'flamur', 'valeza.grainca', 'lendrit.ibrahimi', 'albina.ahmeti', 'albion', 'fidanhoxha', 'klintiponari6', 'doruntina.hoti', 'redon.tahiri', 'erdonakrasniqi', 'bksharpe2021', 'beni1', 'junchong10', 'loreta.pajaziti1', 'njomza.ismaili']",13,"['ozumkocaman9', 'nanouser321', 'busracengiz', 'svlksknsms', 'kingiskey', 'agarcia180', 'iremkaratas', 'oknky', 'exmartinezh', 'patelavi257', 'theurgeboat', 'albertomoreno17', 'kamisetty1']",114,"['ardaulusan_14', 'gjb56', 'edmondovalvo28', 'vmike0426', 'theharshit', 'mf3256', 'enkele', 'liviajanicew', 'kursatmutlu03', 'twcross11', 'kacp3r', 'kevinh88', 'tlsmarshall1', 'baczas996', 'jbertocc', 'rfneed', 'aleksandardunjic1999', 'fdirisaglik', 'jedelkind', 'jlanzoni18', 'jasmina.rozek', 'atkncvkkl1', 'czes', 'nicolech73', 'dhilanr', 'lockbox30', 'sgu20171552', 'hanife', 'bayramdonmez96', 'cmunoz', 'arnavsrivastava', 'ph33', 'smrf432', 'saxenapurva96', 'enweizhang732', 'karpuz', 'cemaloz745', 'ft13', 'akdemirel99', 'reepl', 'kagangunes10', 'yusufsabahoglu05', 'ekim.coskun19', 'sreevidya.c', 'andreheinzig', 'jculp', 'maan1742180', 'jmcveigh55', 'ducka.agata', 'kav68', 'akshatpokharna7', 'ertugrul4101160', 'serhatiseri', '1jordanschwartz', 'salem2', 'rita.kastrati', 'yellowturtle', 'szerefa', 'hary765', 'dkorakakis', 'samuelnxr', 'do356', 'mas2565', 'fabio.telesca', 'ml3566', 'hanhdp99', 'pan_1238', 'yasinzgen', 'sug20171516', 'sgu20171546', 'krzysztof.golyga', 'laxman_18110093', 'ben3862', 'canhuseyinnn', 'ghosh_payel', 'zs2495', 'alpayy98', 'fraser_darling', 'tcp47', 'mra4020', 'pospiechjoanna', 'burghoornniels', 'bernhardhaas55', 'qahoang', 'cristianololipops56', 'kianamon', 'ozcanguclu', 'clinlin9264', 'davidosmanovic', 'bdn2113', 'emreyilmazel1996', 'taol190799', 'sgu20171596', 'emircansimsek', 'beskisehir', 'lado.filipovic', 'sara.haliti', 'jcjohnson', 'ora', 'cansecgin', 'cspiner', 'edgarm120397', 'piter15710', 'sd226', 'sakshi17jagtap', 'kv0001', 'aecarter', 'scullyer16', 'indyfisico', 'jpalko20', 'madharmes', 'gollner.laura', 'lowen12', 'hadesantiago17']",196,"['ardaulusan_14', 'espejodaniel6', 'agarcia180', 'verone.krasniqi', 'edmondovalvo28', 'lookatfuture09', 'theharshit', 'keremino', 'mf3256', 'kursatmutlu03', 'twcross11', 'kevinh88', 'rfneed', 'aleksandardunjic1999', 'bardha.januzi', 'fdirisaglik', 'jedelkind', 'jlanzoni18', 'barbanataraheta', 'jasmina.rozek', 'atkncvkkl1', 'flamur', 'fidanhoxha', 'czes', 'nicolech73', 'redon.tahiri', 'ozumkocaman9', 'dhilanr', 'lockbox30', 'sgu20171552', 'hanife', 'elsaa', 'iremkaratas', 'bayramdonmez96', 'ph33', 'smrf432', 'saxenapurva96', 'karpuz', 'ilir.jasharaj', 'cemaloz745', 'ft13', 'akdemirel99', 'recaro13', 'kagangunes10', 'yusufsabahoglu05', 'musa.kadiri', 'sreevidya.c', 'andreheinzig', 'midie.merovci', 'jculp', 'albin.sejdiu', 'kfullen', 'jfmuller', 'jmcveigh55', 'ducka.agata', 'klintiponari6', 'serhatiseri', 'domagoj.tomic', 'hary765', 'dkorakakis', 'samuelnxr', 'do356', 'njomza.rexhepi3', 'adonis.xhemajli', 'koushik.cc', 'kingiskey', 'ml3566', 'hanhdp99', 'erblina2berisha', 'sug20171516', 'krzysztof.golyga', 'solarwing', 'artine.hoxha', 'florian.halimi1', 'oknky', 'julinda.nasufi', 'canhuseyinnn', 'blerona.emini', 'patelba', 'zs2495', 'alpayy98', 'petrini', 'fraser_darling', 'tcp47', 'mra4020', 'burghoornniels', 'bernhardhaas55', 'cristianololipops56', 'ozcanguclu', 'clinlin9264', 'davidosmanovic', 'bdn2113', 'emircansimsek', 'beskisehir', 'sara.haliti', 'jcjohnson', 'ora', 'lauragashi', 'aecarter', 'christianc2', 'lindkrasniqi', 'jpalko20', 'erdonakrasniqi', 'loreta.pajaziti1', 'hadesantiago17', 'liresaferizaj', 'gjb56', 'patelavi257', 'artin.sermaxhaj', 'kastriotsalihu', 'vmike0426', 'gentihyseni11', 'albertomoreno17', 'enkele', 'liviajanicew', 'kacp3r', 'jonathancollins55', 'theurgeboat', 'tlsmarshall1', 'baczas996', 'jbertocc', 'hjhj8794', 'elona.rashica', 'jaylenwang', 'elona.gervalla', 'alberianatofaj', 'albina.ahmeti', 'albion', 'busracengiz', 'cmunoz', 'enes.hasani', 'arnavsrivastava', 'enweizhang732', 'flamur.mustafa', 'svlksknsms', 'reepl', 'kamisetty1', 'ekim.coskun19', 'donat.aliu147', 'nazifebeqiri59', 'yaohuichen', 'maan1742180', 'kav68', 'akshatpokharna7', 'ertugrul4101160', '1jordanschwartz', 'njomza.ismaili', 'salem2', 'nanouser321', 'rita.kastrati', 'yellowturtle', 'szerefa', 'elton.kaqiu', 'mas2565', 'lislimani', 'fabio.telesca', 'pan_1238', 'barbana.heta', 's.kasamatsu', 'sgu20171546', 'laxman_18110093', 'ben3862', 'acastro34', 'ghosh_payel', 'valeza.grainca', 'lendrit.ibrahimi', 'exmartinezh', 'doruntina.hoti', 'pospiechjoanna', 'qahoang', 'kianamon', 'medinehajredini', 'andi.dika', 'bleon.alimi', 'taol190799', 'emreyilmazel1996', 'sgu20171596', 'blerand.mjeku', 'lado.filipovic', 'cansecgin', 'cspiner', 'edgarm120397', 'piter15710', 'sd226', 'sakshi17jagtap', 'kv0001', 'nrcnaltinbas', 'scullyer16', 'indyfisico', 'madharmes', 'bksharpe2021', 'gollner.laura', 'beni1', 'junchong10', 'lowen12', 'yasinzgen']"
12,345,83,74,46,"['elsaa', 'verone.krasniqi', 'medinehajredini', 'artin.sermaxhaj', 'kastriotsalihu', 'andi.dika', 'elton.kaqiu', 'bleon.alimi', 'enes.hasani', 'gentihyseni11', 'njomza.rexhepi3', 'lislimani', 'flamur.mustafa', 'blerand.mjeku', 'ilir.jasharaj', 'adonis.xhemajli', 'barbana.heta', 'erblina2berisha', 'donat.aliu147', 'lauragashi', 'musa.kadiri', 'florian.halimi1', 'nazifebeqiri59', 'julinda.nasufi', 'bardha.januzi', 'midie.merovci', 'blerona.emini', 'barbanataraheta', 'elona.rashica', 'albin.sejdiu', 'alberianatofaj', 'elona.gervalla', 'lindkrasniqi', 'flamur', 'valeza.grainca', 'lendrit.ibrahimi', 'albina.ahmeti', 'albion', 'fidanhoxha', 'doruntina.hoti', 'klintiponari6', 'redon.tahiri', 'erdonakrasniqi', 'beni1', 'loreta.pajaziti1', 'njomza.ismaili']",36,"['ozumkocaman9', 'nanouser321', 'busracengiz', 'espejodaniel6', 'liresaferizaj', 'agarcia180', 'iremkaratas', 'patelavi257', 'domagoj.tomic', 'lookatfuture09', 'albertomoreno17', 'keremino', 'koushik.cc', 'kingiskey', 'svlksknsms', 'jonathancollins55', 'theurgeboat', 'recaro13', 's.kasamatsu', 'kamisetty1', 'solarwing', 'artine.hoxha', 'oknky', 'acastro34', 'patelba', 'hjhj8794', 'kfullen', 'yaohuichen', 'christianc2', 'jaylenwang', 'nrcnaltinbas', 'jfmuller', 'petrini', 'exmartinezh', 'bksharpe2021', 'junchong10']",28,"['blerim.makiqi', 'rita.kastrati', 'learta.haliti', 'donat', 'enkele', 'vlere.tahiri', 'armir.qurdina', 'albina.maloku1', 'elmedina.sadiku', 'sara.haliti', 'ora', 'arlinda.berisha', 'albin.keqmezi', 'endrit.kuleta', 'bleona.curri', 'gentrim.canolli', 'diare.daqi', 'blerina.haziri', 'durim.polloshka2', 'avdullahmaloku1', 'djellza.bicaj', None, 'flamurmustafa', 'nida.islami26', 'kadrije.simnica', 'lirone.bytyci', 'andi.hasanaj', 'bleon.misini']",110,"['espejodaniel6', 'liresaferizaj', 'agarcia180', 'verone.krasniqi', 'patelavi257', 'artin.sermaxhaj', 'kastriotsalihu', 'gentihyseni11', 'lookatfuture09', 'albertomoreno17', 'keremino', 'donat', 'enkele', 'vlere.tahiri', 'armir.qurdina', 'albina.maloku1', 'jonathancollins55', 'theurgeboat', 'arlinda.berisha', 'bardha.januzi', 'diare.daqi', 'blerina.haziri', 'durim.polloshka2', 'hjhj8794', 'barbanataraheta', 'elona.rashica', 'djellza.bicaj', 'jaylenwang', 'elona.gervalla', 'alberianatofaj', 'flamur', 'albina.ahmeti', 'albion', 'fidanhoxha', 'redon.tahiri', 'ozumkocaman9', 'busracengiz', 'elsaa', 'iremkaratas', 'enes.hasani', 'flamur.mustafa', 'ilir.jasharaj', 'svlksknsms', 'elmedina.sadiku', 'recaro13', 'kamisetty1', 'albin.keqmezi', 'donat.aliu147', 'musa.kadiri', 'endrit.kuleta', 'nazifebeqiri59', 'bleona.curri', 'gentrim.canolli', 'midie.merovci', 'albin.sejdiu', 'yaohuichen', 'kfullen', None, 'jfmuller', 'klintiponari6', 'lirone.bytyci', 'bleon.misini', 'njomza.ismaili', 'nanouser321', 'blerim.makiqi', 'rita.kastrati', 'domagoj.tomic', 'elton.kaqiu', 'njomza.rexhepi3', 'lislimani', 'adonis.xhemajli', 'koushik.cc', 'kingiskey', 'barbana.heta', 'erblina2berisha', 's.kasamatsu', 'solarwing', 'artine.hoxha', 'florian.halimi1', 'oknky', 'acastro34', 'julinda.nasufi', 'blerona.emini', 'patelba', 'petrini', 'valeza.grainca', 'lendrit.ibrahimi', 'exmartinezh', 'kadrije.simnica', 'doruntina.hoti', 'andi.hasanaj', 'medinehajredini', 'andi.dika', 'bleon.alimi', 'learta.haliti', 'blerand.mjeku', 'sara.haliti', 'ora', 'lauragashi', 'avdullahmaloku1', 'christianc2', 'nrcnaltinbas', 'flamurmustafa', 'lindkrasniqi', 'nida.islami26', 'erdonakrasniqi', 'bksharpe2021', 'beni1', 'junchong10', 'loreta.pajaziti1']"
12,394,83,56,5,"['espejodaniel6', 'acastro34', 'recaro13', 'christianc2', 'jfmuller']",77,"['liresaferizaj', 'agarcia180', 'verone.krasniqi', 'patelavi257', 'artin.sermaxhaj', 'kastriotsalihu', 'gentihyseni11', 'lookatfuture09', 'albertomoreno17', 'keremino', 'jonathancollins55', 'theurgeboat', 'bardha.januzi', 'hjhj8794', 'barbanataraheta', 'elona.rashica', 'jaylenwang', 'alberianatofaj', 'elona.gervalla', 'flamur', 'albina.ahmeti', 'albion', 'fidanhoxha', 'redon.tahiri', 'ozumkocaman9', 'busracengiz', 'elsaa', 'iremkaratas', 'enes.hasani', 'flamur.mustafa', 'ilir.jasharaj', 'svlksknsms', 'kamisetty1', 'donat.aliu147', 'musa.kadiri', 'nazifebeqiri59', 'midie.merovci', 'albin.sejdiu', 'yaohuichen', 'kfullen', 'klintiponari6', 'njomza.ismaili', 'nanouser321', 'domagoj.tomic', 'elton.kaqiu', 'njomza.rexhepi3', 'lislimani', 'adonis.xhemajli', 'koushik.cc', 'kingiskey', 'barbana.heta', 'erblina2berisha', 's.kasamatsu', 'solarwing', 'artine.hoxha', 'florian.halimi1', 'oknky', 'julinda.nasufi', 'blerona.emini', 'patelba', 'petrini', 'valeza.grainca', 'lendrit.ibrahimi', 'exmartinezh', 'doruntina.hoti', 'medinehajredini', 'andi.dika', 'bleon.alimi', 'blerand.mjeku', 'lauragashi', 'nrcnaltinbas', 'lindkrasniqi', 'erdonakrasniqi', 'bksharpe2021', 'beni1', 'junchong10', 'loreta.pajaziti1']",51,"['jagallegos7', 'bmendoza4', 'druiz20', 'cmergil39', 'jessgomez100', 'pongbrayan', 'mcsonic', 'pmhernandez4', 'ajortega6', 'wuizar99', 'dleon3', 'rmartinez5', 'drhodges', 'mapayan5', 'jadelira201', 'evelyn.f1975', 'sigalam', 'blogan', 'njgarcia5', 'jarellano1204', 'garciaje34454', 'chrisodomx', 'ardelarosa', 'diaz.carlos4499', 'jasmine43.jp', 'roy227', 'rebecasalcido', 'salvalenzuela12', 'fdominguez6', 'isma', 'gfacio2011', 'dblancarte', 'ferhbk97', 'almelnz2005', 'achaid03', 'bryang511', 'aileyvaa', 'jmoya5', 'fjduran3', None, 'carlosquinonez80', 'macolmenero', 'bsanchez', 'klayydar', 'sebastiangarcia695', 'w.edgarfamous', 'alvarez5', 'agmendez14', 'arivera35', 'ulises98', 'petersan901']",133,"['jagallegos7', 'bmendoza4', 'nanouser321', 'druiz20', 'cmergil39', 'pongbrayan', 'mcsonic', 'espejodaniel6', 'liresaferizaj', 'agarcia180', 'verone.krasniqi', 'pmhernandez4', 'patelavi257', 'artin.sermaxhaj', 'domagoj.tomic', 'dleon3', 'kastriotsalihu', 'rmartinez5', 'elton.kaqiu', 'drhodges', 'gentihyseni11', 'lookatfuture09', 'mapayan5', 'albertomoreno17', 'njomza.rexhepi3', 'keremino', 'lislimani', 'adonis.xhemajli', 'koushik.cc', 'kingiskey', 'jonathancollins55', 'theurgeboat', 'barbana.heta', 'erblina2berisha', 's.kasamatsu', 'ardelarosa', 'roy227', 'solarwing', 'artine.hoxha', 'salvalenzuela12', 'florian.halimi1', 'oknky', 'acastro34', 'julinda.nasufi', 'isma', 'bardha.januzi', 'blerona.emini', 'patelba', 'hjhj8794', 'barbanataraheta', 'elona.rashica', 'almelnz2005', 'achaid03', 'jaylenwang', 'aileyvaa', 'jmoya5', 'fjduran3', 'elona.gervalla', 'alberianatofaj', 'petrini', 'flamur', 'macolmenero', 'valeza.grainca', 'lendrit.ibrahimi', 'bsanchez', 'klayydar', 'albina.ahmeti', 'exmartinezh', 'albion', 'fidanhoxha', 'doruntina.hoti', 'w.edgarfamous', 'redon.tahiri', 'alvarez5', 'agmendez14', 'arivera35', 'ozumkocaman9', 'jessgomez100', 'busracengiz', 'elsaa', 'iremkaratas', 'ajortega6', 'wuizar99', 'medinehajredini', 'andi.dika', 'bleon.alimi', 'enes.hasani', 'jadelira201', 'flamur.mustafa', 'blerand.mjeku', 'ilir.jasharaj', 'evelyn.f1975', 'svlksknsms', 'sigalam', 'blogan', 'njgarcia5', 'jarellano1204', 'garciaje34454', 'recaro13', 'chrisodomx', 'jasmine43.jp', 'diaz.carlos4499', 'kamisetty1', 'donat.aliu147', 'lauragashi', 'rebecasalcido', 'musa.kadiri', 'fdominguez6', 'nazifebeqiri59', 'gfacio2011', 'midie.merovci', 'dblancarte', 'ferhbk97', 'albin.sejdiu', 'yaohuichen', 'kfullen', 'christianc2', 'bryang511', 'nrcnaltinbas', None, 'jfmuller', 'carlosquinonez80', 'lindkrasniqi', 'sebastiangarcia695', 'klintiponari6', 'erdonakrasniqi', 'bksharpe2021', 'beni1', 'ulises98', 'junchong10', 'petersan901', 'loreta.pajaziti1', 'njomza.ismaili']"
12,389,83,42,2,"['svlksknsms', 'oknky']",80,"['espejodaniel6', 'liresaferizaj', 'agarcia180', 'verone.krasniqi', 'patelavi257', 'artin.sermaxhaj', 'kastriotsalihu', 'gentihyseni11', 'lookatfuture09', 'albertomoreno17', 'keremino', 'jonathancollins55', 'theurgeboat', 'bardha.januzi', 'hjhj8794', 'barbanataraheta', 'elona.rashica', 'jaylenwang', 'elona.gervalla', 'alberianatofaj', 'flamur', 'albina.ahmeti', 'albion', 'fidanhoxha', 'redon.tahiri', 'ozumkocaman9', 'busracengiz', 'elsaa', 'iremkaratas', 'enes.hasani', 'flamur.mustafa', 'ilir.jasharaj', 'recaro13', 'kamisetty1', 'donat.aliu147', 'musa.kadiri', 'nazifebeqiri59', 'midie.merovci', 'albin.sejdiu', 'yaohuichen', 'kfullen', 'jfmuller', 'klintiponari6', 'njomza.ismaili', 'nanouser321', 'domagoj.tomic', 'elton.kaqiu', 'njomza.rexhepi3', 'lislimani', 'adonis.xhemajli', 'koushik.cc', 'kingiskey', 'barbana.heta', 'erblina2berisha', 's.kasamatsu', 'solarwing', 'artine.hoxha', 'florian.halimi1', 'acastro34', 'julinda.nasufi', 'blerona.emini', 'patelba', 'petrini', 'valeza.grainca', 'lendrit.ibrahimi', 'exmartinezh', 'doruntina.hoti', 'medinehajredini', 'andi.dika', 'bleon.alimi', 'blerand.mjeku', 'lauragashi', 'christianc2', 'nrcnaltinbas', 'lindkrasniqi', 'erdonakrasniqi', 'bksharpe2021', 'beni1', 'junchong10', 'loreta.pajaziti1']",40,"['mgk816', 'ardaulusan_14', 'tolga.ozyurt24', 'alikanadli7', 'ozcankutlu15', 'veyseleee123', 'fatihyorgun1996', 'emreyilmazel1996', 'arif.ozkan5806', 'salcaburak', 'berksaldr', 'haticeterzibali', 'joker632455', 'kizilinozlem', 'okanozkann95', 'murat.ozeee', 'goknur.derinoz', 'cdogukan09', 'cansecgin', 'muhammet.korkmaz29', 'burak.baha00', 'esuna006', 'ademfurkan', 'ege.ert7', 'anilboran0671', 'sflt317', 'yorumhesabimsa', 'utkubala63', None, 'atkncvkkl1', 'batu.oztrkk', 'zilmidegne', 'elifindir', 'liswfa123', 'furkan069906', 'koningmehmet', 'sonerkar', 'tapur500', 'alex10', 'kagankilicaslan28']",122,"['mgk816', 'ardaulusan_14', 'nanouser321', 'espejodaniel6', 'liresaferizaj', 'agarcia180', 'verone.krasniqi', 'patelavi257', 'artin.sermaxhaj', 'domagoj.tomic', 'kastriotsalihu', 'elton.kaqiu', 'fatihyorgun1996', 'gentihyseni11', 'lookatfuture09', 'albertomoreno17', 'njomza.rexhepi3', 'keremino', 'lislimani', 'adonis.xhemajli', 'koushik.cc', 'kingiskey', 'joker632455', 'okanozkann95', 'jonathancollins55', 'murat.ozeee', 'theurgeboat', 'barbana.heta', 'erblina2berisha', 's.kasamatsu', 'muhammet.korkmaz29', 'burak.baha00', 'solarwing', 'artine.hoxha', 'florian.halimi1', 'oknky', 'acastro34', 'julinda.nasufi', 'bardha.januzi', 'blerona.emini', 'patelba', 'hjhj8794', 'barbanataraheta', 'elona.rashica', 'sflt317', 'jaylenwang', 'elona.gervalla', 'alberianatofaj', 'atkncvkkl1', 'petrini', 'flamur', 'batu.oztrkk', 'valeza.grainca', 'lendrit.ibrahimi', 'liswfa123', 'albina.ahmeti', 'exmartinezh', 'albion', 'fidanhoxha', 'doruntina.hoti', 'furkan069906', 'redon.tahiri', 'alex10', 'alikanadli7', 'ozumkocaman9', 'tolga.ozyurt24', 'busracengiz', 'elsaa', 'iremkaratas', 'ozcankutlu15', 'medinehajredini', 'andi.dika', 'bleon.alimi', 'enes.hasani', 'veyseleee123', 'emreyilmazel1996', 'salcaburak', 'arif.ozkan5806', 'flamur.mustafa', 'blerand.mjeku', 'ilir.jasharaj', 'berksaldr', 'haticeterzibali', 'kizilinozlem', 'svlksknsms', 'tapur500', 'recaro13', 'goknur.derinoz', 'cdogukan09', 'cansecgin', 'kamisetty1', 'donat.aliu147', 'lauragashi', 'esuna006', 'musa.kadiri', 'ademfurkan', 'nazifebeqiri59', 'ege.ert7', 'midie.merovci', 'anilboran0671', 'albin.sejdiu', 'yaohuichen', 'kfullen', 'christianc2', 'nrcnaltinbas', 'yorumhesabimsa', 'utkubala63', 'jfmuller', None, 'lindkrasniqi', 'zilmidegne', 'elifindir', 'klintiponari6', 'koningmehmet', 'sonerkar', 'erdonakrasniqi', 'bksharpe2021', 'beni1', 'kagankilicaslan28', 'junchong10', 'loreta.pajaziti1', 'njomza.ismaili']"
12,390,83,32,3,"['lookatfuture09', 'iremkaratas', 'nanouser321']",79,"['espejodaniel6', 'liresaferizaj', 'agarcia180', 'verone.krasniqi', 'patelavi257', 'artin.sermaxhaj', 'kastriotsalihu', 'gentihyseni11', 'albertomoreno17', 'keremino', 'jonathancollins55', 'theurgeboat', 'bardha.januzi', 'hjhj8794', 'barbanataraheta', 'elona.rashica', 'jaylenwang', 'alberianatofaj', 'elona.gervalla', 'flamur', 'albina.ahmeti', 'albion', 'fidanhoxha', 'redon.tahiri', 'ozumkocaman9', 'busracengiz', 'elsaa', 'enes.hasani', 'flamur.mustafa', 'ilir.jasharaj', 'svlksknsms', 'recaro13', 'kamisetty1', 'donat.aliu147', 'musa.kadiri', 'nazifebeqiri59', 'midie.merovci', 'albin.sejdiu', 'yaohuichen', 'kfullen', 'jfmuller', 'klintiponari6', 'njomza.ismaili', 'domagoj.tomic', 'elton.kaqiu', 'njomza.rexhepi3', 'lislimani', 'adonis.xhemajli', 'koushik.cc', 'kingiskey', 'barbana.heta', 'erblina2berisha', 's.kasamatsu', 'solarwing', 'artine.hoxha', 'florian.halimi1', 'oknky', 'acastro34', 'julinda.nasufi', 'blerona.emini', 'patelba', 'petrini', 'valeza.grainca', 'lendrit.ibrahimi', 'exmartinezh', 'doruntina.hoti', 'medinehajredini', 'andi.dika', 'bleon.alimi', 'blerand.mjeku', 'lauragashi', 'christianc2', 'nrcnaltinbas', 'lindkrasniqi', 'erdonakrasniqi', 'bksharpe2021', 'beni1', 'junchong10', 'loreta.pajaziti1']",29,"['fatih2626', 'omerdmrc16', 'klc.mrt.1926', 'zeynep', 'mahmutcanki', 'doguhanyucel', 'evren_aydin6', 'furkan2072', 'mmozcan4', 'simayozbay', 'esulekaplan', 'erencanarslan70', 'buseduygut', 'mseyfullahcelik', 'akdemirel99', '1967hamzausta', 'sd226', 'brs21', 'mehmettasdelen26', 'mmb', 'afkali.120', None, 'mertisleyen96', 'uzunnurdan', 'halilalp', 'berkc', 'erdicany', 'neslihannayy', 'keryfly']",111,"['nanouser321', 'espejodaniel6', 'liresaferizaj', 'agarcia180', 'verone.krasniqi', 'klc.mrt.1926', 'patelavi257', 'artin.sermaxhaj', 'domagoj.tomic', 'evren_aydin6', 'kastriotsalihu', 'elton.kaqiu', 'furkan2072', 'gentihyseni11', 'simayozbay', 'lookatfuture09', 'albertomoreno17', 'njomza.rexhepi3', 'keremino', 'lislimani', 'esulekaplan', 'adonis.xhemajli', 'erencanarslan70', 'koushik.cc', 'kingiskey', 'jonathancollins55', 'theurgeboat', 'barbana.heta', 'erblina2berisha', 's.kasamatsu', 'solarwing', 'artine.hoxha', 'florian.halimi1', 'oknky', 'acastro34', 'julinda.nasufi', 'bardha.januzi', 'mehmettasdelen26', 'blerona.emini', 'patelba', 'hjhj8794', 'barbanataraheta', 'elona.rashica', 'jaylenwang', 'elona.gervalla', 'alberianatofaj', 'uzunnurdan', 'petrini', 'flamur', 'halilalp', 'valeza.grainca', 'lendrit.ibrahimi', 'albina.ahmeti', 'exmartinezh', 'albion', 'fidanhoxha', 'doruntina.hoti', 'redon.tahiri', 'erdicany', 'neslihannayy', 'ozumkocaman9', 'fatih2626', 'busracengiz', 'elsaa', 'iremkaratas', 'omerdmrc16', 'mahmutcanki', 'zeynep', 'medinehajredini', 'doguhanyucel', 'andi.dika', 'bleon.alimi', 'enes.hasani', 'mmozcan4', 'flamur.mustafa', 'blerand.mjeku', 'ilir.jasharaj', 'svlksknsms', 'buseduygut', 'mseyfullahcelik', 'akdemirel99', 'recaro13', '1967hamzausta', 'kamisetty1', 'donat.aliu147', 'lauragashi', 'sd226', 'musa.kadiri', 'brs21', 'nazifebeqiri59', 'midie.merovci', 'mmb', 'albin.sejdiu', 'yaohuichen', 'kfullen', 'christianc2', 'afkali.120', 'nrcnaltinbas', None, 'mertisleyen96', 'jfmuller', 'lindkrasniqi', 'berkc', 'klintiponari6', 'erdonakrasniqi', 'bksharpe2021', 'beni1', 'junchong10', 'loreta.pajaziti1', 'keryfly', 'njomza.ismaili']"
12,346,83,16,3,"['keremino', 'svlksknsms', 'oknky']",79,"['nanouser321', 'espejodaniel6', 'liresaferizaj', 'agarcia180', 'verone.krasniqi', 'patelavi257', 'artin.sermaxhaj', 'domagoj.tomic', 'kastriotsalihu', 'elton.kaqiu', 'gentihyseni11', 'lookatfuture09', 'albertomoreno17', 'njomza.rexhepi3', 'lislimani', 'adonis.xhemajli', 'koushik.cc', 'kingiskey', 'jonathancollins55', 'theurgeboat', 'barbana.heta', 'erblina2berisha', 's.kasamatsu', 'solarwing', 'artine.hoxha', 'florian.halimi1', 'acastro34', 'julinda.nasufi', 'bardha.januzi', 'blerona.emini', 'patelba', 'hjhj8794', 'barbanataraheta', 'elona.rashica', 'jaylenwang', 'elona.gervalla', 'alberianatofaj', 'petrini', 'flamur', 'valeza.grainca', 'lendrit.ibrahimi', 'albina.ahmeti', 'exmartinezh', 'albion', 'fidanhoxha', 'doruntina.hoti', 'redon.tahiri', 'ozumkocaman9', 'busracengiz', 'elsaa', 'iremkaratas', 'medinehajredini', 'andi.dika', 'bleon.alimi', 'enes.hasani', 'flamur.mustafa', 'blerand.mjeku', 'ilir.jasharaj', 'recaro13', 'kamisetty1', 'donat.aliu147', 'lauragashi', 'musa.kadiri', 'nazifebeqiri59', 'midie.merovci', 'albin.sejdiu', 'yaohuichen', 'kfullen', 'christianc2', 'nrcnaltinbas', 'jfmuller', 'lindkrasniqi', 'klintiponari6', 'erdonakrasniqi', 'bksharpe2021', 'beni1', 'junchong10', 'loreta.pajaziti1', 'njomza.ismaili']",13,"['mgk816', 'ardaulusan_14', 'batu.oztrkk', 'alpayy98', None, 'alikanadl6', 'ronmesdofb', 'sonerkar', 'koningmehmet', 'emreyilmazel1996', 'cansecgin', 'utkubala63', 'atkncvkkl1']",95,"['mgk816', 'ardaulusan_14', 'nanouser321', 'espejodaniel6', 'liresaferizaj', 'agarcia180', 'verone.krasniqi', 'patelavi257', 'artin.sermaxhaj', 'domagoj.tomic', 'kastriotsalihu', 'elton.kaqiu', 'gentihyseni11', 'lookatfuture09', 'albertomoreno17', 'njomza.rexhepi3', 'keremino', 'lislimani', 'adonis.xhemajli', 'koushik.cc', 'kingiskey', 'alikanadl6', 'jonathancollins55', 'theurgeboat', 'barbana.heta', 'erblina2berisha', 's.kasamatsu', 'solarwing', 'artine.hoxha', 'florian.halimi1', 'oknky', 'acastro34', 'julinda.nasufi', 'bardha.januzi', 'blerona.emini', 'patelba', 'hjhj8794', 'barbanataraheta', 'elona.rashica', 'jaylenwang', 'elona.gervalla', 'alberianatofaj', 'alpayy98', 'atkncvkkl1', 'petrini', 'flamur', 'batu.oztrkk', 'valeza.grainca', 'lendrit.ibrahimi', 'albina.ahmeti', 'exmartinezh', 'albion', 'fidanhoxha', 'doruntina.hoti', 'ronmesdofb', 'redon.tahiri', 'ozumkocaman9', 'busracengiz', 'elsaa', 'iremkaratas', 'medinehajredini', 'andi.dika', 'bleon.alimi', 'enes.hasani', 'emreyilmazel1996', 'flamur.mustafa', 'blerand.mjeku', 'ilir.jasharaj', 'svlksknsms', 'recaro13', 'cansecgin', 'kamisetty1', 'donat.aliu147', 'lauragashi', 'musa.kadiri', 'nazifebeqiri59', 'midie.merovci', 'albin.sejdiu', 'yaohuichen', 'kfullen', 'christianc2', 'nrcnaltinbas', 'utkubala63', None, 'jfmuller', 'lindkrasniqi', 'klintiponari6', 'sonerkar', 'koningmehmet', 'erdonakrasniqi', 'bksharpe2021', 'beni1', 'junchong10', 'loreta.pajaziti1', 'njomza.ismaili']"
12,343,83,10,6,"['lislimani', 'lindkrasniqi', 'kastriotsalihu', 'bleon.alimi', 'andi.dika', 'erblina2berisha']",76,"['nanouser321', 'espejodaniel6', 'liresaferizaj', 'agarcia180', 'verone.krasniqi', 'patelavi257', 'artin.sermaxhaj', 'domagoj.tomic', 'elton.kaqiu', 'gentihyseni11', 'lookatfuture09', 'albertomoreno17', 'njomza.rexhepi3', 'keremino', 'adonis.xhemajli', 'koushik.cc', 'kingiskey', 'jonathancollins55', 'theurgeboat', 'barbana.heta', 's.kasamatsu', 'solarwing', 'artine.hoxha', 'florian.halimi1', 'oknky', 'acastro34', 'julinda.nasufi', 'bardha.januzi', 'blerona.emini', 'patelba', 'hjhj8794', 'barbanataraheta', 'elona.rashica', 'jaylenwang', 'elona.gervalla', 'alberianatofaj', 'petrini', 'flamur', 'valeza.grainca', 'lendrit.ibrahimi', 'albina.ahmeti', 'exmartinezh', 'albion', 'fidanhoxha', 'doruntina.hoti', 'redon.tahiri', 'ozumkocaman9', 'busracengiz', 'elsaa', 'iremkaratas', 'medinehajredini', 'enes.hasani', 'flamur.mustafa', 'blerand.mjeku', 'ilir.jasharaj', 'svlksknsms', 'recaro13', 'kamisetty1', 'donat.aliu147', 'lauragashi', 'musa.kadiri', 'nazifebeqiri59', 'midie.merovci', 'albin.sejdiu', 'yaohuichen', 'kfullen', 'christianc2', 'nrcnaltinbas', 'jfmuller', 'klintiponari6', 'erdonakrasniqi', 'bksharpe2021', 'beni1', 'junchong10', 'loreta.pajaziti1', 'njomza.ismaili']",4,"['bleon.misini', None, 'celtinaosmanaj', 'gentrim.canolli']",86,"['nanouser321', 'espejodaniel6', 'liresaferizaj', 'agarcia180', 'verone.krasniqi', 'patelavi257', 'artin.sermaxhaj', 'domagoj.tomic', 'kastriotsalihu', 'elton.kaqiu', 'gentihyseni11', 'lookatfuture09', 'albertomoreno17', 'njomza.rexhepi3', 'keremino', 'lislimani', 'adonis.xhemajli', 'koushik.cc', 'kingiskey', 'jonathancollins55', 'theurgeboat', 'barbana.heta', 'erblina2berisha', 's.kasamatsu', 'solarwing', 'artine.hoxha', 'florian.halimi1', 'oknky', 'acastro34', 'julinda.nasufi', 'bardha.januzi', 'blerona.emini', 'patelba', 'hjhj8794', 'barbanataraheta', 'elona.rashica', 'celtinaosmanaj', 'jaylenwang', 'elona.gervalla', 'alberianatofaj', 'petrini', 'flamur', 'valeza.grainca', 'lendrit.ibrahimi', 'albina.ahmeti', 'exmartinezh', 'albion', 'fidanhoxha', 'doruntina.hoti', 'redon.tahiri', 'ozumkocaman9', 'busracengiz', 'elsaa', 'iremkaratas', 'medinehajredini', 'andi.dika', 'bleon.alimi', 'enes.hasani', 'flamur.mustafa', 'blerand.mjeku', 'ilir.jasharaj', 'svlksknsms', 'recaro13', 'kamisetty1', 'donat.aliu147', 'lauragashi', 'musa.kadiri', 'nazifebeqiri59', 'gentrim.canolli', 'midie.merovci', 'albin.sejdiu', 'yaohuichen', 'kfullen', 'christianc2', 'nrcnaltinbas', None, 'jfmuller', 'lindkrasniqi', 'klintiponari6', 'erdonakrasniqi', 'bksharpe2021', 'beni1', 'bleon.misini', 'junchong10', 'loreta.pajaziti1', 'njomza.ismaili']"
12,349,83,8,3,"['lookatfuture09', 'iremkaratas', 'nanouser321']",79,"['espejodaniel6', 'liresaferizaj', 'agarcia180', 'verone.krasniqi', 'patelavi257', 'artin.sermaxhaj', 'domagoj.tomic', 'kastriotsalihu', 'elton.kaqiu', 'gentihyseni11', 'albertomoreno17', 'njomza.rexhepi3', 'keremino', 'lislimani', 'adonis.xhemajli', 'koushik.cc', 'kingiskey', 'jonathancollins55', 'theurgeboat', 'barbana.heta', 'erblina2berisha', 's.kasamatsu', 'solarwing', 'artine.hoxha', 'florian.halimi1', 'oknky', 'acastro34', 'julinda.nasufi', 'bardha.januzi', 'blerona.emini', 'patelba', 'hjhj8794', 'barbanataraheta', 'elona.rashica', 'jaylenwang', 'elona.gervalla', 'alberianatofaj', 'petrini', 'flamur', 'valeza.grainca', 'lendrit.ibrahimi', 'albina.ahmeti', 'exmartinezh', 'albion', 'fidanhoxha', 'doruntina.hoti', 'redon.tahiri', 'ozumkocaman9', 'busracengiz', 'elsaa', 'medinehajredini', 'andi.dika', 'bleon.alimi', 'enes.hasani', 'flamur.mustafa', 'blerand.mjeku', 'ilir.jasharaj', 'svlksknsms', 'recaro13', 'kamisetty1', 'donat.aliu147', 'lauragashi', 'musa.kadiri', 'nazifebeqiri59', 'midie.merovci', 'albin.sejdiu', 'yaohuichen', 'kfullen', 'christianc2', 'nrcnaltinbas', 'jfmuller', 'lindkrasniqi', 'klintiponari6', 'erdonakrasniqi', 'bksharpe2021', 'beni1', 'junchong10', 'loreta.pajaziti1', 'njomza.ismaili']",5,"['sd226', 'brs21', 'akdemirel99', 'cansecgin', None]",87,"['nanouser321', 'espejodaniel6', 'liresaferizaj', 'agarcia180', 'verone.krasniqi', 'patelavi257', 'artin.sermaxhaj', 'domagoj.tomic', 'kastriotsalihu', 'elton.kaqiu', 'gentihyseni11', 'lookatfuture09', 'albertomoreno17', 'njomza.rexhepi3', 'keremino', 'lislimani', 'adonis.xhemajli', 'koushik.cc', 'kingiskey', 'jonathancollins55', 'theurgeboat', 'barbana.heta', 'erblina2berisha', 's.kasamatsu', 'solarwing', 'artine.hoxha', 'florian.halimi1', 'oknky', 'acastro34', 'julinda.nasufi', 'bardha.januzi', 'blerona.emini', 'patelba', 'hjhj8794', 'barbanataraheta', 'elona.rashica', 'jaylenwang', 'elona.gervalla', 'alberianatofaj', 'petrini', 'flamur', 'valeza.grainca', 'lendrit.ibrahimi', 'albina.ahmeti', 'exmartinezh', 'albion', 'fidanhoxha', 'doruntina.hoti', 'redon.tahiri', 'ozumkocaman9', 'busracengiz', 'elsaa', 'iremkaratas', 'medinehajredini', 'andi.dika', 'bleon.alimi', 'enes.hasani', 'flamur.mustafa', 'blerand.mjeku', 'ilir.jasharaj', 'svlksknsms', 'akdemirel99', 'recaro13', 'cansecgin', 'kamisetty1', 'donat.aliu147', 'lauragashi', 'sd226', 'musa.kadiri', 'brs21', 'nazifebeqiri59', 'midie.merovci', 'albin.sejdiu', 'yaohuichen', 'kfullen', 'christianc2', 'nrcnaltinbas', None, 'jfmuller', 'lindkrasniqi', 'klintiponari6', 'erdonakrasniqi', 'bksharpe2021', 'beni1', 'junchong10', 'loreta.pajaziti1', 'njomza.ismaili']"
12,350,83,8,1,['ozumkocaman9'],81,"['nanouser321', 'espejodaniel6', 'liresaferizaj', 'agarcia180', 'verone.krasniqi', 'patelavi257', 'artin.sermaxhaj', 'domagoj.tomic', 'kastriotsalihu', 'elton.kaqiu', 'gentihyseni11', 'lookatfuture09', 'albertomoreno17', 'njomza.rexhepi3', 'keremino', 'lislimani', 'adonis.xhemajli', 'koushik.cc', 'kingiskey', 'jonathancollins55', 'theurgeboat', 'barbana.heta', 'erblina2berisha', 's.kasamatsu', 'solarwing', 'artine.hoxha', 'florian.halimi1', 'oknky', 'acastro34', 'julinda.nasufi', 'bardha.januzi', 'blerona.emini', 'patelba', 'hjhj8794', 'barbanataraheta', 'elona.rashica', 'jaylenwang', 'elona.gervalla', 'alberianatofaj', 'petrini', 'flamur', 'valeza.grainca', 'lendrit.ibrahimi', 'albina.ahmeti', 'exmartinezh', 'albion', 'fidanhoxha', 'doruntina.hoti', 'redon.tahiri', 'busracengiz', 'elsaa', 'iremkaratas', 'medinehajredini', 'andi.dika', 'bleon.alimi', 'enes.hasani', 'flamur.mustafa', 'blerand.mjeku', 'ilir.jasharaj', 'svlksknsms', 'recaro13', 'kamisetty1', 'donat.aliu147', 'lauragashi', 'musa.kadiri', 'nazifebeqiri59', 'midie.merovci', 'albin.sejdiu', 'yaohuichen', 'kfullen', 'christianc2', 'nrcnaltinbas', 'jfmuller', 'lindkrasniqi', 'klintiponari6', 'erdonakrasniqi', 'bksharpe2021', 'beni1', 'junchong10', 'loreta.pajaziti1', 'njomza.ismaili']",7,"['atakanerdogann1', 'havvafatmaozbay', 'serdememen', 'smrf432', None, 'yasinzgen', 'ekim.coskun19']",89,"['nanouser321', 'espejodaniel6', 'liresaferizaj', 'agarcia180', 'verone.krasniqi', 'patelavi257', 'artin.sermaxhaj', 'domagoj.tomic', 'kastriotsalihu', 'elton.kaqiu', 'gentihyseni11', 'lookatfuture09', 'albertomoreno17', 'njomza.rexhepi3', 'keremino', 'lislimani', 'adonis.xhemajli', 'koushik.cc', 'kingiskey', 'jonathancollins55', 'theurgeboat', 'barbana.heta', 'erblina2berisha', 's.kasamatsu', 'solarwing', 'artine.hoxha', 'florian.halimi1', 'oknky', 'acastro34', 'julinda.nasufi', 'bardha.januzi', 'blerona.emini', 'patelba', 'hjhj8794', 'barbanataraheta', 'elona.rashica', 'jaylenwang', 'elona.gervalla', 'alberianatofaj', 'petrini', 'flamur', 'valeza.grainca', 'lendrit.ibrahimi', 'albina.ahmeti', 'exmartinezh', 'albion', 'fidanhoxha', 'doruntina.hoti', 'redon.tahiri', 'serdememen', 'ozumkocaman9', 'busracengiz', 'elsaa', 'iremkaratas', 'medinehajredini', 'andi.dika', 'bleon.alimi', 'enes.hasani', 'smrf432', 'flamur.mustafa', 'blerand.mjeku', 'ilir.jasharaj', 'atakanerdogann1', 'svlksknsms', 'recaro13', 'kamisetty1', 'ekim.coskun19', 'donat.aliu147', 'lauragashi', 'musa.kadiri', 'nazifebeqiri59', 'havvafatmaozbay', 'midie.merovci', 'albin.sejdiu', 'yaohuichen', 'kfullen', 'christianc2', 'nrcnaltinbas', None, 'jfmuller', 'lindkrasniqi', 'klintiponari6', 'erdonakrasniqi', 'bksharpe2021', 'beni1', 'junchong10', 'loreta.pajaziti1', 'yasinzgen', 'njomza.ismaili']"
12,392,83,6,1,['ozumkocaman9'],81,"['nanouser321', 'espejodaniel6', 'liresaferizaj', 'agarcia180', 'verone.krasniqi', 'patelavi257', 'artin.sermaxhaj', 'domagoj.tomic', 'kastriotsalihu', 'elton.kaqiu', 'gentihyseni11', 'lookatfuture09', 'albertomoreno17', 'njomza.rexhepi3', 'keremino', 'lislimani', 'adonis.xhemajli', 'koushik.cc', 'kingiskey', 'jonathancollins55', 'theurgeboat', 'barbana.heta', 'erblina2berisha', 's.kasamatsu', 'solarwing', 'artine.hoxha', 'florian.halimi1', 'oknky', 'acastro34', 'julinda.nasufi', 'bardha.januzi', 'blerona.emini', 'patelba', 'hjhj8794', 'barbanataraheta', 'elona.rashica', 'jaylenwang', 'elona.gervalla', 'alberianatofaj', 'petrini', 'flamur', 'valeza.grainca', 'lendrit.ibrahimi', 'albina.ahmeti', 'exmartinezh', 'albion', 'fidanhoxha', 'doruntina.hoti', 'redon.tahiri', 'busracengiz', 'elsaa', 'iremkaratas', 'medinehajredini', 'andi.dika', 'bleon.alimi', 'enes.hasani', 'flamur.mustafa', 'blerand.mjeku', 'ilir.jasharaj', 'svlksknsms', 'recaro13', 'kamisetty1', 'donat.aliu147', 'lauragashi', 'musa.kadiri', 'nazifebeqiri59', 'midie.merovci', 'albin.sejdiu', 'yaohuichen', 'kfullen', 'christianc2', 'nrcnaltinbas', 'jfmuller', 'lindkrasniqi', 'klintiponari6', 'erdonakrasniqi', 'bksharpe2021', 'beni1', 'junchong10', 'loreta.pajaziti1', 'njomza.ismaili']",5,"['atakanerdogann1', 'havvafatmaozbay', 'smrf432', None, 'serdememen']",87,"['nanouser321', 'espejodaniel6', 'liresaferizaj', 'agarcia180', 'verone.krasniqi', 'patelavi257', 'artin.sermaxhaj', 'domagoj.tomic', 'kastriotsalihu', 'elton.kaqiu', 'gentihyseni11', 'lookatfuture09', 'albertomoreno17', 'njomza.rexhepi3', 'keremino', 'lislimani', 'adonis.xhemajli', 'koushik.cc', 'kingiskey', 'jonathancollins55', 'theurgeboat', 'barbana.heta', 'erblina2berisha', 's.kasamatsu', 'solarwing', 'artine.hoxha', 'florian.halimi1', 'oknky', 'acastro34', 'julinda.nasufi', 'bardha.januzi', 'blerona.emini', 'patelba', 'hjhj8794', 'barbanataraheta', 'elona.rashica', 'jaylenwang', 'elona.gervalla', 'alberianatofaj', 'petrini', 'flamur', 'valeza.grainca', 'lendrit.ibrahimi', 'albina.ahmeti', 'exmartinezh', 'albion', 'fidanhoxha', 'doruntina.hoti', 'redon.tahiri', 'serdememen', 'ozumkocaman9', 'busracengiz', 'elsaa', 'iremkaratas', 'medinehajredini', 'andi.dika', 'bleon.alimi', 'enes.hasani', 'smrf432', 'flamur.mustafa', 'blerand.mjeku', 'ilir.jasharaj', 'atakanerdogann1', 'svlksknsms', 'recaro13', 'kamisetty1', 'donat.aliu147', 'lauragashi', 'musa.kadiri', 'nazifebeqiri59', 'havvafatmaozbay', 'midie.merovci', 'albin.sejdiu', 'yaohuichen', 'kfullen', 'christianc2', 'nrcnaltinbas', None, 'jfmuller', 'lindkrasniqi', 'klintiponari6', 'erdonakrasniqi', 'bksharpe2021', 'beni1', 'junchong10', 'loreta.pajaziti1', 'njomza.ismaili']"
13,11,71,27,22,"['irohith', 'varshit', 'ee19btech11042', 'likhita26', 'kpranav', 'ee19btech11006', 'ee19btech11030', 'chandramouli', 'jithin', 'sathvikaithagoni', 'sravanthi1', 'sakeths', 'alankritha', 'smaran43', 'ee19btech11022', 'charitha2002', 'nishanth_kannan', 'ee19btech11033', 'mahima444', 'abhishekgautam011', 'sathvik', 'ee19btech11010']",48,"['elenasoli', 'zn13366', 'mohamedteama', 'ostanley', 'manjunath_216', 'phantomscythe1738', 'harshith', 'ee19btech11049', 'msreekaran', 'rmaehdalf', 'yagneek', 'ee19btech11026', 'ee19btech11019', 'sohamk11', 'setsoafia', 'ee19btech11027', 'greyrj', 'vinayakn', 'ee19btech11009', 'geetha0802', 'ee19btech11035', 'marwaneg', 'barfieldja', 'manikarnika1009', 'pkohli24', 'smsoomi', 'xanderwill', 'uday_kiran', 'vohp', 'dufflab', 'saisatyaprasaanth', 'walterses', 'maanetid', 'sanabai', 'ee19btech11040scv', 'sanketranade', 'batestm', 'udaykiran', 'gauthamy', 'anand358', 'dominicsjc', 'mingruij', 'greent1', 'bymbaa6789', 'sherifms777', 'paolo.rocchetti.96', 'carboni235069', 'ee19btech11002']",5,"['bananavati', 'oves', 'srijithreddypakala001', 'manjunath216', None]",75,"['irohith', 'bananavati', 'varshit', 'likhita26', 'rmaehdalf', 'ee19btech11006', 'srijithreddypakala001', 'chandramouli', 'setsoafia', 'greyrj', 'vinayakn', 'ee19btech11009', 'geetha0802', 'ee19btech11035', 'marwaneg', 'manikarnika1009', 'alankritha', 'smsoomi', 'xanderwill', 'vohp', 'dufflab', 'oves', 'walterses', 'charitha2002', 'manjunath216', 'sanabai', 'nishanth_kannan', 'ee19btech11033', 'batestm', 'udaykiran', 'gauthamy', 'dominicsjc', 'mahima444', 'abhishekgautam011', 'ee19btech11010', 'ee19btech11002', 'elenasoli', 'zn13366', 'mohamedteama', 'ostanley', 'ee19btech11042', 'manjunath_216', 'phantomscythe1738', 'harshith', 'ee19btech11049', 'kpranav', 'msreekaran', 'ee19btech11026', 'ee19btech11019', 'ee19btech11030', 'yagneek', 'sohamk11', 'ee19btech11027', 'jithin', 'sathvikaithagoni', 'sravanthi1', 'sakeths', 'barfieldja', 'pkohli24', 'smaran43', 'uday_kiran', 'ee19btech11022', 'saisatyaprasaanth', 'maanetid', None, 'ee19btech11040scv', 'sanketranade', 'anand358', 'mingruij', 'greent1', 'sathvik', 'bymbaa6789', 'sherifms777', 'paolo.rocchetti.96', 'carboni235069']"
13,6,71,26,6,"['batestm', 'xanderwill', 'greyrj', 'dufflab', 'walterses', 'barfieldja']",64,"['irohith', 'elenasoli', 'zn13366', 'mohamedteama', 'varshit', 'ostanley', 'ee19btech11042', 'manjunath_216', 'phantomscythe1738', 'harshith', 'likhita26', 'ee19btech11049', 'msreekaran', 'rmaehdalf', 'ee19btech11026', 'kpranav', 'ee19btech11006', 'ee19btech11019', 'ee19btech11030', 'yagneek', 'sohamk11', 'chandramouli', 'setsoafia', 'ee19btech11027', 'jithin', 'vinayakn', 'ee19btech11009', 'sathvikaithagoni', 'geetha0802', 'sravanthi1', 'sakeths', 'ee19btech11035', 'marwaneg', 'manikarnika1009', 'pkohli24', 'alankritha', 'smaran43', 'smsoomi', 'uday_kiran', 'vohp', 'ee19btech11022', 'saisatyaprasaanth', 'charitha2002', 'maanetid', 'sanabai', 'nishanth_kannan', 'ee19btech11033', 'ee19btech11040scv', 'sanketranade', 'udaykiran', 'gauthamy', 'anand358', 'dominicsjc', 'mingruij', 'mahima444', 'abhishekgautam011', 'greent1', 'ee19btech11010', 'sathvik', 'bymbaa6789', 'sherifms777', 'paolo.rocchetti.96', 'carboni235069', 'ee19btech11002']",20,"['macalintalca', 'stonerockjp', 'assirs', 'nikhatzhn', 'nikita.d.popel', 'audreykluis', 'georgejt', 'vavrutin', 'escamillaa', 'joneswm3', 'amras', 'tinglet', 'andaryyn', 'hufferec', 'nguyenk35', 'uozgur', None, 'lawrencead2', 'duongkh', 'jonesdc7']",90,"['irohith', 'macalintalca', 'stonerockjp', 'varshit', 'assirs', 'nikhatzhn', 'likhita26', 'rmaehdalf', 'nikita.d.popel', 'ee19btech11006', 'georgejt', 'chandramouli', 'setsoafia', 'greyrj', 'vinayakn', 'ee19btech11009', 'amras', 'geetha0802', 'ee19btech11035', 'marwaneg', 'manikarnika1009', 'alankritha', 'smsoomi', 'xanderwill', 'tinglet', 'vohp', 'dufflab', 'walterses', 'charitha2002', 'hufferec', 'nguyenk35', 'uozgur', 'sanabai', 'nishanth_kannan', 'ee19btech11033', 'lawrencead2', 'batestm', 'udaykiran', 'gauthamy', 'dominicsjc', 'mahima444', 'abhishekgautam011', 'ee19btech11010', 'ee19btech11002', 'elenasoli', 'zn13366', 'mohamedteama', 'ostanley', 'ee19btech11042', 'manjunath_216', 'phantomscythe1738', 'harshith', 'ee19btech11049', 'kpranav', 'msreekaran', 'ee19btech11026', 'ee19btech11019', 'ee19btech11030', 'yagneek', 'audreykluis', 'vavrutin', 'sohamk11', 'ee19btech11027', 'jithin', 'escamillaa', 'joneswm3', 'sathvikaithagoni', 'sravanthi1', 'sakeths', 'barfieldja', 'pkohli24', 'smaran43', 'uday_kiran', 'ee19btech11022', 'andaryyn', 'saisatyaprasaanth', 'maanetid', None, 'ee19btech11040scv', 'sanketranade', 'duongkh', 'jonesdc7', 'anand358', 'mingruij', 'greent1', 'sathvik', 'bymbaa6789', 'sherifms777', 'paolo.rocchetti.96', 'carboni235069']"
13,17,71,23,1,['rmaehdalf'],69,"['irohith', 'elenasoli', 'zn13366', 'mohamedteama', 'varshit', 'ostanley', 'ee19btech11042', 'manjunath_216', 'phantomscythe1738', 'harshith', 'likhita26', 'msreekaran', 'ee19btech11049', 'kpranav', 'ee19btech11026', 'yagneek', 'ee19btech11006', 'ee19btech11019', 'ee19btech11030', 'sohamk11', 'chandramouli', 'setsoafia', 'ee19btech11027', 'jithin', 'greyrj', 'vinayakn', 'ee19btech11009', 'sathvikaithagoni', 'geetha0802', 'sravanthi1', 'sakeths', 'ee19btech11035', 'marwaneg', 'barfieldja', 'manikarnika1009', 'pkohli24', 'alankritha', 'smaran43', 'smsoomi', 'xanderwill', 'uday_kiran', 'vohp', 'ee19btech11022', 'dufflab', 'saisatyaprasaanth', 'walterses', 'charitha2002', 'maanetid', 'sanabai', 'nishanth_kannan', 'ee19btech11033', 'ee19btech11040scv', 'sanketranade', 'batestm', 'udaykiran', 'gauthamy', 'anand358', 'dominicsjc', 'mingruij', 'mahima444', 'abhishekgautam011', 'greent1', 'ee19btech11010', 'sathvik', 'bymbaa6789', 'sherifms777', 'paolo.rocchetti.96', 'carboni235069', 'ee19btech11002']",22,"['kdm52', 'jihwanch1', 'aaddss3210', 'eogksakdhkd', '01024461660a', 'kimsw9506', 'gunso', 'hyuk8041', 'ansckdqja123', 'b515037', 'kdy3894', 'sohny94', 'b615057', None, 'tjwjdqja5', 'ehrnjs326', 'euem789', 'wndud5258', 'terry0511', 'zhesun', 'ksw950828', 'chaems322']",92,"['irohith', 'kdm52', 'varshit', 'likhita26', 'eogksakdhkd', 'rmaehdalf', '01024461660a', 'ee19btech11006', 'gunso', 'chandramouli', 'setsoafia', 'greyrj', 'hyuk8041', 'vinayakn', 'ee19btech11009', 'geetha0802', 'ee19btech11035', 'marwaneg', 'manikarnika1009', 'b515037', 'alankritha', 'smsoomi', 'xanderwill', 'kdy3894', 'vohp', 'sohny94', 'dufflab', 'walterses', 'charitha2002', 'b615057', 'sanabai', 'nishanth_kannan', 'ee19btech11033', 'batestm', 'ehrnjs326', 'udaykiran', 'gauthamy', 'euem789', 'dominicsjc', 'mahima444', 'terry0511', 'abhishekgautam011', 'ee19btech11010', 'ksw950828', 'chaems322', 'ee19btech11002', 'elenasoli', 'zn13366', 'mohamedteama', 'jihwanch1', 'ostanley', 'ee19btech11042', 'manjunath_216', 'phantomscythe1738', 'harshith', 'aaddss3210', 'ee19btech11049', 'kpranav', 'msreekaran', 'ee19btech11026', 'ee19btech11019', 'ee19btech11030', 'yagneek', 'kimsw9506', 'sohamk11', 'ee19btech11027', 'jithin', 'ansckdqja123', 'sathvikaithagoni', 'sravanthi1', 'sakeths', 'barfieldja', 'pkohli24', 'smaran43', 'uday_kiran', 'ee19btech11022', 'saisatyaprasaanth', 'maanetid', None, 'ee19btech11040scv', 'sanketranade', 'tjwjdqja5', 'anand358', 'mingruij', 'wndud5258', 'zhesun', 'greent1', 'sathvik', 'bymbaa6789', 'sherifms777', 'paolo.rocchetti.96', 'carboni235069']"
13,16,71,16,1,['xanderwill'],69,"['irohith', 'varshit', 'likhita26', 'rmaehdalf', 'ee19btech11006', 'chandramouli', 'setsoafia', 'greyrj', 'vinayakn', 'ee19btech11009', 'geetha0802', 'ee19btech11035', 'marwaneg', 'manikarnika1009', 'alankritha', 'smsoomi', 'vohp', 'dufflab', 'walterses', 'charitha2002', 'sanabai', 'nishanth_kannan', 'ee19btech11033', 'batestm', 'udaykiran', 'gauthamy', 'dominicsjc', 'mahima444', 'abhishekgautam011', 'ee19btech11010', 'ee19btech11002', 'elenasoli', 'zn13366', 'mohamedteama', 'ostanley', 'ee19btech11042', 'manjunath_216', 'phantomscythe1738', 'harshith', 'ee19btech11049', 'kpranav', 'msreekaran', 'ee19btech11026', 'ee19btech11019', 'ee19btech11030', 'yagneek', 'sohamk11', 'ee19btech11027', 'jithin', 'sathvikaithagoni', 'sravanthi1', 'sakeths', 'barfieldja', 'pkohli24', 'smaran43', 'uday_kiran', 'ee19btech11022', 'saisatyaprasaanth', 'maanetid', 'ee19btech11040scv', 'sanketranade', 'anand358', 'mingruij', 'greent1', 'sathvik', 'bymbaa6789', 'sherifms777', 'paolo.rocchetti.96', 'carboni235069']",15,"['lawrencead2', 'macalintalca', 'duongkh', 'stonerockjp', 'jonesdc7', 'tinglet', 'andaryyn', 'escamillaa', 'joneswm3', 'nikhatzhn', 'hufferec', 'nguyenk35', 'audreykluis', 'georgejt', None]",85,"['irohith', 'macalintalca', 'stonerockjp', 'varshit', 'nikhatzhn', 'likhita26', 'rmaehdalf', 'ee19btech11006', 'georgejt', 'chandramouli', 'setsoafia', 'greyrj', 'vinayakn', 'ee19btech11009', 'geetha0802', 'ee19btech11035', 'marwaneg', 'manikarnika1009', 'alankritha', 'smsoomi', 'xanderwill', 'tinglet', 'vohp', 'dufflab', 'walterses', 'charitha2002', 'hufferec', 'nguyenk35', 'sanabai', 'nishanth_kannan', 'ee19btech11033', 'lawrencead2', 'batestm', 'udaykiran', 'gauthamy', 'dominicsjc', 'mahima444', 'abhishekgautam011', 'ee19btech11010', 'ee19btech11002', 'elenasoli', 'zn13366', 'mohamedteama', 'ostanley', 'ee19btech11042', 'manjunath_216', 'phantomscythe1738', 'harshith', 'ee19btech11049', 'kpranav', 'msreekaran', 'ee19btech11026', 'ee19btech11019', 'ee19btech11030', 'yagneek', 'audreykluis', 'sohamk11', 'ee19btech11027', 'jithin', 'escamillaa', 'joneswm3', 'sathvikaithagoni', 'sravanthi1', 'sakeths', 'barfieldja', 'pkohli24', 'smaran43', 'uday_kiran', 'ee19btech11022', 'andaryyn', 'saisatyaprasaanth', 'maanetid', None, 'ee19btech11040scv', 'sanketranade', 'duongkh', 'jonesdc7', 'anand358', 'mingruij', 'greent1', 'sathvik', 'bymbaa6789', 'sherifms777', 'paolo.rocchetti.96', 'carboni235069']"
13,18,71,14,2,"['paolo.rocchetti.96', 'ostanley']",68,"['irohith', 'varshit', 'likhita26', 'rmaehdalf', 'ee19btech11006', 'chandramouli', 'setsoafia', 'greyrj', 'vinayakn', 'ee19btech11009', 'geetha0802', 'ee19btech11035', 'marwaneg', 'manikarnika1009', 'alankritha', 'smsoomi', 'xanderwill', 'vohp', 'dufflab', 'walterses', 'charitha2002', 'sanabai', 'nishanth_kannan', 'ee19btech11033', 'batestm', 'udaykiran', 'gauthamy', 'dominicsjc', 'mahima444', 'abhishekgautam011', 'ee19btech11010', 'ee19btech11002', 'elenasoli', 'zn13366', 'mohamedteama', 'ee19btech11042', 'manjunath_216', 'phantomscythe1738', 'harshith', 'ee19btech11049', 'kpranav', 'msreekaran', 'ee19btech11026', 'ee19btech11019', 'ee19btech11030', 'yagneek', 'sohamk11', 'ee19btech11027', 'jithin', 'sathvikaithagoni', 'sravanthi1', 'sakeths', 'barfieldja', 'pkohli24', 'smaran43', 'uday_kiran', 'ee19btech11022', 'saisatyaprasaanth', 'maanetid', 'ee19btech11040scv', 'sanketranade', 'anand358', 'mingruij', 'greent1', 'sathvik', 'bymbaa6789', 'sherifms777', 'carboni235069']",12,"['ttruman', 'maxwest', 'irobertson', 'procchetti', 'wlongwf', 'oscarglenister', 'azheng1', 'cpattinson', 'anakhl', None, 'specialkay', 'rasd232']",82,"['irohith', 'varshit', 'irobertson', 'likhita26', 'rmaehdalf', 'cpattinson', 'ee19btech11006', 'chandramouli', 'setsoafia', 'ttruman', 'maxwest', 'greyrj', 'vinayakn', 'ee19btech11009', 'geetha0802', 'ee19btech11035', 'marwaneg', 'manikarnika1009', 'alankritha', 'smsoomi', 'xanderwill', 'vohp', 'dufflab', 'walterses', 'charitha2002', 'sanabai', 'anakhl', 'nishanth_kannan', 'ee19btech11033', 'procchetti', 'batestm', 'udaykiran', 'gauthamy', 'dominicsjc', 'mahima444', 'abhishekgautam011', 'ee19btech11010', 'azheng1', 'ee19btech11002', 'elenasoli', 'zn13366', 'mohamedteama', 'ostanley', 'ee19btech11042', 'manjunath_216', 'phantomscythe1738', 'harshith', 'wlongwf', 'ee19btech11049', 'kpranav', 'msreekaran', 'ee19btech11026', 'ee19btech11019', 'ee19btech11030', 'yagneek', 'specialkay', 'rasd232', 'sohamk11', 'ee19btech11027', 'jithin', 'sathvikaithagoni', 'sravanthi1', 'sakeths', 'barfieldja', 'pkohli24', 'smaran43', 'uday_kiran', 'ee19btech11022', 'saisatyaprasaanth', 'maanetid', None, 'oscarglenister', 'ee19btech11040scv', 'sanketranade', 'anand358', 'mingruij', 'greent1', 'sathvik', 'bymbaa6789', 'sherifms777', 'paolo.rocchetti.96', 'carboni235069']"
13,342,71,14,1,['xanderwill'],69,"['irohith', 'varshit', 'likhita26', 'rmaehdalf', 'ee19btech11006', 'chandramouli', 'setsoafia', 'greyrj', 'vinayakn', 'ee19btech11009', 'geetha0802', 'ee19btech11035', 'marwaneg', 'manikarnika1009', 'alankritha', 'smsoomi', 'vohp', 'dufflab', 'walterses', 'charitha2002', 'sanabai', 'nishanth_kannan', 'ee19btech11033', 'batestm', 'udaykiran', 'gauthamy', 'dominicsjc', 'mahima444', 'abhishekgautam011', 'ee19btech11010', 'ee19btech11002', 'elenasoli', 'zn13366', 'mohamedteama', 'ostanley', 'ee19btech11042', 'manjunath_216', 'phantomscythe1738', 'harshith', 'ee19btech11049', 'kpranav', 'msreekaran', 'ee19btech11026', 'ee19btech11019', 'ee19btech11030', 'yagneek', 'sohamk11', 'ee19btech11027', 'jithin', 'sathvikaithagoni', 'sravanthi1', 'sakeths', 'barfieldja', 'pkohli24', 'smaran43', 'uday_kiran', 'ee19btech11022', 'saisatyaprasaanth', 'maanetid', 'ee19btech11040scv', 'sanketranade', 'anand358', 'mingruij', 'greent1', 'sathvik', 'bymbaa6789', 'sherifms777', 'paolo.rocchetti.96', 'carboni235069']",13,"['lawrencead2', 'macalintalca', 'duongkh', 'stonerockjp', 'jonesdc7', 'escamillaa', 'andaryyn', 'joneswm3', 'nikhatzhn', 'hufferec', 'audreykluis', 'georgejt', None]",83,"['irohith', 'macalintalca', 'stonerockjp', 'varshit', 'nikhatzhn', 'likhita26', 'rmaehdalf', 'ee19btech11006', 'georgejt', 'chandramouli', 'setsoafia', 'greyrj', 'vinayakn', 'ee19btech11009', 'geetha0802', 'ee19btech11035', 'marwaneg', 'manikarnika1009', 'alankritha', 'smsoomi', 'xanderwill', 'vohp', 'dufflab', 'walterses', 'charitha2002', 'hufferec', 'sanabai', 'nishanth_kannan', 'ee19btech11033', 'lawrencead2', 'batestm', 'udaykiran', 'gauthamy', 'dominicsjc', 'mahima444', 'abhishekgautam011', 'ee19btech11010', 'ee19btech11002', 'elenasoli', 'zn13366', 'mohamedteama', 'ostanley', 'ee19btech11042', 'manjunath_216', 'phantomscythe1738', 'harshith', 'ee19btech11049', 'kpranav', 'msreekaran', 'ee19btech11026', 'ee19btech11019', 'ee19btech11030', 'yagneek', 'audreykluis', 'sohamk11', 'ee19btech11027', 'jithin', 'escamillaa', 'joneswm3', 'sathvikaithagoni', 'sravanthi1', 'sakeths', 'barfieldja', 'pkohli24', 'smaran43', 'uday_kiran', 'ee19btech11022', 'andaryyn', 'saisatyaprasaanth', 'maanetid', None, 'ee19btech11040scv', 'sanketranade', 'duongkh', 'jonesdc7', 'anand358', 'mingruij', 'greent1', 'sathvik', 'bymbaa6789', 'sherifms777', 'paolo.rocchetti.96', 'carboni235069']"
13,15,71,12,9,"['uday_kiran', 'gauthamy', 'anand358', 'jithin', 'phantomscythe1738', 'saisatyaprasaanth', 'ee19btech11010', 'yagneek', 'pkohli24']",61,"['irohith', 'varshit', 'likhita26', 'rmaehdalf', 'ee19btech11006', 'chandramouli', 'setsoafia', 'greyrj', 'vinayakn', 'ee19btech11009', 'geetha0802', 'ee19btech11035', 'marwaneg', 'manikarnika1009', 'alankritha', 'smsoomi', 'xanderwill', 'vohp', 'dufflab', 'walterses', 'charitha2002', 'sanabai', 'nishanth_kannan', 'ee19btech11033', 'batestm', 'udaykiran', 'dominicsjc', 'mahima444', 'abhishekgautam011', 'ee19btech11002', 'elenasoli', 'zn13366', 'mohamedteama', 'ostanley', 'ee19btech11042', 'manjunath_216', 'harshith', 'ee19btech11049', 'kpranav', 'msreekaran', 'ee19btech11026', 'ee19btech11019', 'ee19btech11030', 'sohamk11', 'ee19btech11027', 'sathvikaithagoni', 'sravanthi1', 'sakeths', 'barfieldja', 'smaran43', 'ee19btech11022', 'maanetid', 'ee19btech11040scv', 'sanketranade', 'mingruij', 'greent1', 'sathvik', 'bymbaa6789', 'sherifms777', 'paolo.rocchetti.96', 'carboni235069']",3,"[None, 'manjunath216', 'noone']",73,"['irohith', 'varshit', 'likhita26', 'rmaehdalf', 'ee19btech11006', 'chandramouli', 'setsoafia', 'greyrj', 'vinayakn', 'ee19btech11009', 'geetha0802', 'ee19btech11035', 'marwaneg', 'manikarnika1009', 'alankritha', 'smsoomi', 'xanderwill', 'vohp', 'dufflab', 'walterses', 'charitha2002', 'manjunath216', 'sanabai', 'nishanth_kannan', 'ee19btech11033', 'batestm', 'udaykiran', 'gauthamy', 'dominicsjc', 'mahima444', 'abhishekgautam011', 'ee19btech11010', 'ee19btech11002', 'elenasoli', 'zn13366', 'mohamedteama', 'ostanley', 'ee19btech11042', 'manjunath_216', 'phantomscythe1738', 'harshith', 'ee19btech11049', 'kpranav', 'msreekaran', 'ee19btech11026', 'ee19btech11019', 'ee19btech11030', 'yagneek', 'sohamk11', 'ee19btech11027', 'jithin', 'sathvikaithagoni', 'sravanthi1', 'sakeths', 'barfieldja', 'pkohli24', 'smaran43', 'uday_kiran', 'ee19btech11022', 'saisatyaprasaanth', 'maanetid', None, 'ee19btech11040scv', 'sanketranade', 'anand358', 'mingruij', 'greent1', 'sathvik', 'bymbaa6789', 'noone', 'sherifms777', 'paolo.rocchetti.96', 'carboni235069']"
13,13,71,7,6,"['udaykiran', 'gauthamy', 'anand358', 'manjunath_216', 'manikarnika1009', 'pkohli24']",64,"['irohith', 'varshit', 'likhita26', 'rmaehdalf', 'ee19btech11006', 'chandramouli', 'setsoafia', 'greyrj', 'vinayakn', 'ee19btech11009', 'geetha0802', 'ee19btech11035', 'marwaneg', 'alankritha', 'smsoomi', 'xanderwill', 'vohp', 'dufflab', 'walterses', 'charitha2002', 'sanabai', 'nishanth_kannan', 'ee19btech11033', 'batestm', 'dominicsjc', 'mahima444', 'abhishekgautam011', 'ee19btech11010', 'ee19btech11002', 'elenasoli', 'zn13366', 'mohamedteama', 'ostanley', 'ee19btech11042', 'phantomscythe1738', 'harshith', 'ee19btech11049', 'kpranav', 'msreekaran', 'ee19btech11026', 'ee19btech11019', 'ee19btech11030', 'yagneek', 'sohamk11', 'ee19btech11027', 'jithin', 'sathvikaithagoni', 'sravanthi1', 'sakeths', 'barfieldja', 'smaran43', 'uday_kiran', 'ee19btech11022', 'saisatyaprasaanth', 'maanetid', 'ee19btech11040scv', 'sanketranade', 'mingruij', 'greent1', 'sathvik', 'bymbaa6789', 'sherifms777', 'paolo.rocchetti.96', 'carboni235069']",1,[None],71,"['irohith', 'varshit', 'likhita26', 'rmaehdalf', 'ee19btech11006', 'chandramouli', 'setsoafia', 'greyrj', 'vinayakn', 'ee19btech11009', 'geetha0802', 'ee19btech11035', 'marwaneg', 'manikarnika1009', 'alankritha', 'smsoomi', 'xanderwill', 'vohp', 'dufflab', 'walterses', 'charitha2002', 'sanabai', 'nishanth_kannan', 'ee19btech11033', 'batestm', 'udaykiran', 'gauthamy', 'dominicsjc', 'mahima444', 'abhishekgautam011', 'ee19btech11010', 'ee19btech11002', 'elenasoli', 'zn13366', 'mohamedteama', 'ostanley', 'ee19btech11042', 'manjunath_216', 'phantomscythe1738', 'harshith', 'ee19btech11049', 'kpranav', 'msreekaran', 'ee19btech11026', 'ee19btech11019', 'ee19btech11030', 'yagneek', 'sohamk11', 'ee19btech11027', 'jithin', 'sathvikaithagoni', 'sravanthi1', 'sakeths', 'barfieldja', 'pkohli24', 'smaran43', 'uday_kiran', 'ee19btech11022', 'saisatyaprasaanth', 'maanetid', None, 'ee19btech11040scv', 'sanketranade', 'anand358', 'mingruij', 'greent1', 'sathvik', 'bymbaa6789', 'sherifms777', 'paolo.rocchetti.96', 'carboni235069']"
14,112,66,35,29,"['nikhil.gupta', 'atorres559', 'yue_chen196', 'jmyamartinez5', 'lamalamaduck1', 'cynthiahjt', 'thebalconyart1st', 'preethiraghavan827', 'jonwatkins', 'andygama', 'everettmorton5', 'robert.puccinelli', 'kevin_joslin', 'emre.kusakci', 'jimothy369', 'nyathescholar', 'sakshi_shah', 'cdjensen', 'pamela.george', 'jameslo319', 'kurtismb', 'ckwok3', 'limjianhua', 'ari_3_1415', 'magana272', 'mmcd2523', 'efwawrzynek', 'sophia.mahfouz', 'eunkim']",36,"['sajid.kaist', 'hwilliam', 'ncalv028', 'fgh0798', 'libardo11chapal', 'li17.jimmy', 'kbma', 'chenhoemeng', 'zlesemanksu', 'chrisstian9614', 'arg542190', 'christineahn0109', 'shreya1024', 'ehchong', 'mcoupin', 'lesliegomez', 'charlottelao', 'biomemes', 'taohid.tuhser', 'genderentropic22', 'tdm040', 'midhun', 'diegoespinoza', 'saahil12', 'davirobe66', 'nicolasweird', 'jvl2xv', 'ehuntley', 'tarik.elmelegy', 'nsersch', 'bryam11122113', 'npowers', 'pnsaipranavi', 'josesalomonperaltamontes', 'mariam5671', 'jjiang0305']",6,"['sjing', 'jimin_kim', 'naatessema', 'noelledavis', 'lonso559', None]",71,"['nikhil.gupta', 'sajid.kaist', 'atorres559', 'libardo11chapal', 'li17.jimmy', 'jmyamartinez5', 'cynthiahjt', 'lamalamaduck1', 'lonso559', 'thebalconyart1st', 'jonwatkins', 'everettmorton5', 'zlesemanksu', 'sjing', 'robert.puccinelli', 'arg542190', 'christineahn0109', 'kevin_joslin', 'noelledavis', 'ehchong', 'mcoupin', 'charlottelao', 'biomemes', 'taohid.tuhser', 'naatessema', 'jameslo319', 'kurtismb', 'nicolasweird', 'jimin_kim', 'tarik.elmelegy', 'ari_3_1415', 'npowers', 'mmcd2523', 'sophia.mahfouz', 'jjiang0305', 'yue_chen196', 'hwilliam', 'ncalv028', 'fgh0798', 'kbma', 'chenhoemeng', 'preethiraghavan827', 'andygama', 'chrisstian9614', 'shreya1024', 'emre.kusakci', 'jimothy369', 'lesliegomez', 'nyathescholar', 'sakshi_shah', 'cdjensen', 'pamela.george', 'genderentropic22', 'tdm040', 'ckwok3', 'midhun', 'diegoespinoza', 'saahil12', 'davirobe66', 'jvl2xv', 'ehuntley', None, 'limjianhua', 'nsersch', 'bryam11122113', 'magana272', 'efwawrzynek', 'pnsaipranavi', 'josesalomonperaltamontes', 'mariam5671', 'eunkim']"
14,109,66,30,2,"['libardo11chapal', 'bryam11122113']",63,"['nikhil.gupta', 'sajid.kaist', 'atorres559', 'yue_chen196', 'hwilliam', 'ncalv028', 'fgh0798', 'li17.jimmy', 'kbma', 'jmyamartinez5', 'cynthiahjt', 'lamalamaduck1', 'jjiang0305', 'chenhoemeng', 'preethiraghavan827', 'thebalconyart1st', 'jonwatkins', 'andygama', 'everettmorton5', 'zlesemanksu', 'chrisstian9614', 'robert.puccinelli', 'arg542190', 'christineahn0109', 'kevin_joslin', 'shreya1024', 'emre.kusakci', 'jimothy369', 'ehchong', 'mcoupin', 'lesliegomez', 'charlottelao', 'nyathescholar', 'biomemes', 'sakshi_shah', 'taohid.tuhser', 'cdjensen', 'pamela.george', 'genderentropic22', 'jameslo319', 'kurtismb', 'tdm040', 'ckwok3', 'midhun', 'diegoespinoza', 'saahil12', 'davirobe66', 'nicolasweird', 'jvl2xv', 'ehuntley', 'limjianhua', 'tarik.elmelegy', 'nsersch', 'ari_3_1415', 'npowers', 'magana272', 'mmcd2523', 'efwawrzynek', 'sophia.mahfouz', 'pnsaipranavi', 'josesalomonperaltamontes', 'mariam5671', 'eunkim']",28,"['jdanielguzman264', 'criscams', 'sophyav', 'juandbolivarc', 'pablosc500', 'alejandro21', 'mangel.hc1109', 'lamarce2016', 'ibuitron', 'af.martinezt', 'mividaeseltamal25', 'i.buitron', 'dm.zambrano', 'pgalindo3105', 'maidy', 's.rodrigueza', 'd0kma', 'juandita810', 'gicchirivi', None, 'sguerra339', 'nguerreronaranjo', 'catalinavargas025', 'davidspa05', 'am1923', 'susme2020', 'juanfhcardona', 'sergioprieto.mm']",93,"['nikhil.gupta', 'criscams', 'sajid.kaist', 'atorres559', 'libardo11chapal', 'li17.jimmy', 'jmyamartinez5', 'cynthiahjt', 'lamalamaduck1', 'alejandro21', 'thebalconyart1st', 'jonwatkins', 'lamarce2016', 'everettmorton5', 'zlesemanksu', 'robert.puccinelli', 'arg542190', 'christineahn0109', 'kevin_joslin', 'dm.zambrano', 'ehchong', 'mcoupin', 'charlottelao', 'maidy', 'biomemes', 'taohid.tuhser', 'd0kma', 'juandita810', 'jameslo319', 'kurtismb', 'gicchirivi', 'sguerra339', 'nguerreronaranjo', 'nicolasweird', 'davidspa05', 'tarik.elmelegy', 'ari_3_1415', 'npowers', 'mmcd2523', 'juanfhcardona', 'sophia.mahfouz', 'jjiang0305', 'jdanielguzman264', 'sophyav', 'yue_chen196', 'hwilliam', 'ncalv028', 'fgh0798', 'juandbolivarc', 'sergioprieto.mm', 'pablosc500', 'kbma', 'chenhoemeng', 'preethiraghavan827', 'mangel.hc1109', 'andygama', 'chrisstian9614', 'ibuitron', 'af.martinezt', 'mividaeseltamal25', 'i.buitron', 'shreya1024', 'emre.kusakci', 'jimothy369', 'pgalindo3105', 'lesliegomez', 'nyathescholar', 'sakshi_shah', 'cdjensen', 'pamela.george', 'genderentropic22', 's.rodrigueza', 'tdm040', 'ckwok3', 'midhun', 'diegoespinoza', 'saahil12', 'davirobe66', 'jvl2xv', 'ehuntley', None, 'catalinavargas025', 'limjianhua', 'am1923', 'nsersch', 'susme2020', 'bryam11122113', 'magana272', 'efwawrzynek', 'pnsaipranavi', 'josesalomonperaltamontes', 'mariam5671', 'eunkim']"
14,111,66,24,2,"['biomemes', 'jvl2xv']",63,"['nikhil.gupta', 'sajid.kaist', 'atorres559', 'yue_chen196', 'hwilliam', 'ncalv028', 'fgh0798', 'libardo11chapal', 'li17.jimmy', 'kbma', 'jmyamartinez5', 'cynthiahjt', 'lamalamaduck1', 'jjiang0305', 'chenhoemeng', 'preethiraghavan827', 'thebalconyart1st', 'jonwatkins', 'andygama', 'everettmorton5', 'zlesemanksu', 'chrisstian9614', 'robert.puccinelli', 'arg542190', 'christineahn0109', 'kevin_joslin', 'shreya1024', 'emre.kusakci', 'jimothy369', 'ehchong', 'mcoupin', 'lesliegomez', 'charlottelao', 'nyathescholar', 'sakshi_shah', 'taohid.tuhser', 'cdjensen', 'pamela.george', 'genderentropic22', 'jameslo319', 'kurtismb', 'tdm040', 'ckwok3', 'midhun', 'diegoespinoza', 'saahil12', 'davirobe66', 'nicolasweird', 'ehuntley', 'limjianhua', 'tarik.elmelegy', 'nsersch', 'ari_3_1415', 'npowers', 'bryam11122113', 'mmcd2523', 'magana272', 'sophia.mahfouz', 'efwawrzynek', 'pnsaipranavi', 'josesalomonperaltamontes', 'mariam5671', 'eunkim']",22,"['jdanielguzman264', 'criscams', 'srabanti', 'anguye22', 'lamarce2016', 'dm.zambrano', 'alcastaneda', 'diego.rojas1130', 'noelledavis', 'goar.ayrapetyan', 'naatessema', 'caitlincramer12', 'd0kma', 'anirbantwin', 'lorselgi', 'dning', 'luisferayala', None, 'andres201719819', 'nguerreronaranjo', 'josealejoclaro1999', 'sergioprieto.mm']",87,"['nikhil.gupta', 'criscams', 'sajid.kaist', 'atorres559', 'libardo11chapal', 'li17.jimmy', 'jmyamartinez5', 'cynthiahjt', 'lamalamaduck1', 'thebalconyart1st', 'anguye22', 'jonwatkins', 'lamarce2016', 'everettmorton5', 'zlesemanksu', 'robert.puccinelli', 'arg542190', 'christineahn0109', 'kevin_joslin', 'dm.zambrano', 'alcastaneda', 'noelledavis', 'ehchong', 'mcoupin', 'charlottelao', 'goar.ayrapetyan', 'biomemes', 'taohid.tuhser', 'naatessema', 'd0kma', 'anirbantwin', 'jameslo319', 'kurtismb', 'dning', 'andres201719819', 'nicolasweird', 'nguerreronaranjo', 'tarik.elmelegy', 'ari_3_1415', 'npowers', 'mmcd2523', 'sophia.mahfouz', 'jjiang0305', 'jdanielguzman264', 'srabanti', 'yue_chen196', 'hwilliam', 'ncalv028', 'fgh0798', 'sergioprieto.mm', 'kbma', 'chenhoemeng', 'preethiraghavan827', 'andygama', 'chrisstian9614', 'shreya1024', 'emre.kusakci', 'jimothy369', 'diego.rojas1130', 'lesliegomez', 'nyathescholar', 'sakshi_shah', 'cdjensen', 'caitlincramer12', 'pamela.george', 'genderentropic22', 'lorselgi', 'tdm040', 'luisferayala', 'ckwok3', 'midhun', 'diegoespinoza', 'saahil12', 'davirobe66', 'jvl2xv', 'ehuntley', None, 'limjianhua', 'josealejoclaro1999', 'nsersch', 'bryam11122113', 'magana272', 'efwawrzynek', 'pnsaipranavi', 'josesalomonperaltamontes', 'mariam5671', 'eunkim']"
14,103,66,14,1,['shreya1024'],64,"['nikhil.gupta', 'sajid.kaist', 'atorres559', 'libardo11chapal', 'li17.jimmy', 'jmyamartinez5', 'cynthiahjt', 'lamalamaduck1', 'thebalconyart1st', 'jonwatkins', 'everettmorton5', 'zlesemanksu', 'robert.puccinelli', 'arg542190', 'christineahn0109', 'kevin_joslin', 'ehchong', 'mcoupin', 'charlottelao', 'biomemes', 'taohid.tuhser', 'jameslo319', 'kurtismb', 'nicolasweird', 'tarik.elmelegy', 'ari_3_1415', 'npowers', 'mmcd2523', 'sophia.mahfouz', 'jjiang0305', 'yue_chen196', 'hwilliam', 'ncalv028', 'fgh0798', 'kbma', 'chenhoemeng', 'preethiraghavan827', 'andygama', 'chrisstian9614', 'emre.kusakci', 'jimothy369', 'lesliegomez', 'nyathescholar', 'sakshi_shah', 'cdjensen', 'pamela.george', 'genderentropic22', 'tdm040', 'ckwok3', 'midhun', 'diegoespinoza', 'saahil12', 'davirobe66', 'jvl2xv', 'ehuntley', 'limjianhua', 'nsersch', 'bryam11122113', 'magana272', 'efwawrzynek', 'pnsaipranavi', 'josesalomonperaltamontes', 'mariam5671', 'eunkim']",13,"['gandmdanda', None, 'arsalan.siddique007', 'jigyasha2001', 'zeeshanttps', 'osmosium', 'madhur1999', 'naruto_uzamaki', 'gauravrai1207', 'thisisprajjwal', 'nktanurag2020', 'ashuy0501', 'slowbutdetermined']",78,"['nikhil.gupta', 'sajid.kaist', 'atorres559', 'libardo11chapal', 'li17.jimmy', 'jmyamartinez5', 'cynthiahjt', 'lamalamaduck1', 'thebalconyart1st', 'gandmdanda', 'jonwatkins', 'everettmorton5', 'zlesemanksu', 'jigyasha2001', 'robert.puccinelli', 'arg542190', 'christineahn0109', 'kevin_joslin', 'thisisprajjwal', 'ehchong', 'mcoupin', 'charlottelao', 'biomemes', 'taohid.tuhser', 'jameslo319', 'kurtismb', 'naruto_uzamaki', 'nicolasweird', 'tarik.elmelegy', 'ari_3_1415', 'npowers', 'mmcd2523', 'sophia.mahfouz', 'jjiang0305', 'yue_chen196', 'hwilliam', 'ncalv028', 'fgh0798', 'madhur1999', 'kbma', 'nktanurag2020', 'chenhoemeng', 'preethiraghavan827', 'andygama', 'arsalan.siddique007', 'chrisstian9614', 'shreya1024', 'emre.kusakci', 'jimothy369', 'gauravrai1207', 'ashuy0501', 'lesliegomez', 'nyathescholar', 'sakshi_shah', 'slowbutdetermined', 'cdjensen', 'pamela.george', 'genderentropic22', 'osmosium', 'tdm040', 'ckwok3', 'midhun', 'diegoespinoza', 'saahil12', 'davirobe66', 'jvl2xv', 'ehuntley', None, 'limjianhua', 'zeeshanttps', 'nsersch', 'bryam11122113', 'magana272', 'efwawrzynek', 'pnsaipranavi', 'josesalomonperaltamontes', 'mariam5671', 'eunkim']"
14,113,66,7,6,"['nikhil.gupta', 'yue_chen196', 'genderentropic22', 'li17.jimmy', 'thebalconyart1st', 'nyathescholar']",59,"['sajid.kaist', 'atorres559', 'libardo11chapal', 'jmyamartinez5', 'cynthiahjt', 'lamalamaduck1', 'jonwatkins', 'everettmorton5', 'zlesemanksu', 'robert.puccinelli', 'arg542190', 'christineahn0109', 'kevin_joslin', 'ehchong', 'mcoupin', 'charlottelao', 'biomemes', 'taohid.tuhser', 'jameslo319', 'kurtismb', 'nicolasweird', 'tarik.elmelegy', 'ari_3_1415', 'npowers', 'mmcd2523', 'sophia.mahfouz', 'jjiang0305', 'hwilliam', 'ncalv028', 'fgh0798', 'kbma', 'chenhoemeng', 'preethiraghavan827', 'andygama', 'chrisstian9614', 'shreya1024', 'emre.kusakci', 'jimothy369', 'lesliegomez', 'sakshi_shah', 'cdjensen', 'pamela.george', 'tdm040', 'ckwok3', 'midhun', 'diegoespinoza', 'saahil12', 'davirobe66', 'jvl2xv', 'ehuntley', 'limjianhua', 'nsersch', 'bryam11122113', 'magana272', 'efwawrzynek', 'pnsaipranavi', 'josesalomonperaltamontes', 'mariam5671', 'eunkim']",1,[None],66,"['nikhil.gupta', 'sajid.kaist', 'atorres559', 'libardo11chapal', 'li17.jimmy', 'jmyamartinez5', 'cynthiahjt', 'lamalamaduck1', 'thebalconyart1st', 'jonwatkins', 'everettmorton5', 'zlesemanksu', 'robert.puccinelli', 'arg542190', 'christineahn0109', 'kevin_joslin', 'ehchong', 'mcoupin', 'charlottelao', 'biomemes', 'taohid.tuhser', 'jameslo319', 'kurtismb', 'nicolasweird', 'tarik.elmelegy', 'ari_3_1415', 'npowers', 'mmcd2523', 'sophia.mahfouz', 'jjiang0305', 'yue_chen196', 'hwilliam', 'ncalv028', 'fgh0798', 'kbma', 'chenhoemeng', 'preethiraghavan827', 'andygama', 'chrisstian9614', 'shreya1024', 'emre.kusakci', 'jimothy369', 'lesliegomez', 'nyathescholar', 'sakshi_shah', 'cdjensen', 'pamela.george', 'genderentropic22', 'tdm040', 'ckwok3', 'midhun', 'diegoespinoza', 'saahil12', 'davirobe66', 'jvl2xv', 'ehuntley', None, 'limjianhua', 'nsersch', 'bryam11122113', 'magana272', 'efwawrzynek', 'pnsaipranavi', 'josesalomonperaltamontes', 'mariam5671', 'eunkim']"
14,114,66,6,5,"['nikhil.gupta', 'yue_chen196', 'li17.jimmy', 'thebalconyart1st', 'nyathescholar']",60,"['sajid.kaist', 'atorres559', 'libardo11chapal', 'jmyamartinez5', 'cynthiahjt', 'lamalamaduck1', 'jonwatkins', 'everettmorton5', 'zlesemanksu', 'robert.puccinelli', 'arg542190', 'christineahn0109', 'kevin_joslin', 'ehchong', 'mcoupin', 'charlottelao', 'biomemes', 'taohid.tuhser', 'jameslo319', 'kurtismb', 'nicolasweird', 'tarik.elmelegy', 'ari_3_1415', 'npowers', 'mmcd2523', 'sophia.mahfouz', 'jjiang0305', 'hwilliam', 'ncalv028', 'fgh0798', 'kbma', 'chenhoemeng', 'preethiraghavan827', 'andygama', 'chrisstian9614', 'shreya1024', 'emre.kusakci', 'jimothy369', 'lesliegomez', 'sakshi_shah', 'cdjensen', 'pamela.george', 'genderentropic22', 'tdm040', 'ckwok3', 'midhun', 'diegoespinoza', 'saahil12', 'davirobe66', 'jvl2xv', 'ehuntley', 'limjianhua', 'nsersch', 'bryam11122113', 'magana272', 'efwawrzynek', 'pnsaipranavi', 'josesalomonperaltamontes', 'mariam5671', 'eunkim']",1,[None],66,"['nikhil.gupta', 'sajid.kaist', 'atorres559', 'libardo11chapal', 'li17.jimmy', 'jmyamartinez5', 'cynthiahjt', 'lamalamaduck1', 'thebalconyart1st', 'jonwatkins', 'everettmorton5', 'zlesemanksu', 'robert.puccinelli', 'arg542190', 'christineahn0109', 'kevin_joslin', 'ehchong', 'mcoupin', 'charlottelao', 'biomemes', 'taohid.tuhser', 'jameslo319', 'kurtismb', 'nicolasweird', 'tarik.elmelegy', 'ari_3_1415', 'npowers', 'mmcd2523', 'sophia.mahfouz', 'jjiang0305', 'yue_chen196', 'hwilliam', 'ncalv028', 'fgh0798', 'kbma', 'chenhoemeng', 'preethiraghavan827', 'andygama', 'chrisstian9614', 'shreya1024', 'emre.kusakci', 'jimothy369', 'lesliegomez', 'nyathescholar', 'sakshi_shah', 'cdjensen', 'pamela.george', 'genderentropic22', 'tdm040', 'ckwok3', 'midhun', 'diegoespinoza', 'saahil12', 'davirobe66', 'jvl2xv', 'ehuntley', None, 'limjianhua', 'nsersch', 'bryam11122113', 'magana272', 'efwawrzynek', 'pnsaipranavi', 'josesalomonperaltamontes', 'mariam5671', 'eunkim']"
15,109,57,30,1,['i.buitron'],55,"['jvarkey', 'umisra', 'ashrithanandini', 'tag12340000', 'maharshpatel1709', 'opp4578', 'linnmry', 'amanzoor', 'saurabhshah1505', 'nktanurag2020', 'lychen', 'prabhas123', 'vudeshmukh', 'mayankk64', 'areicks2', 'skh2150', 'ganapathy61', 'arsalan.siddique007', 'mcordelia08', 'siddharth14415', 'gangadharareddy8976', 'joel12', 'cekendri', 'shyamjee1212', 'abhitrivediair1', 'adityasamantaroy1', 'j294lee', 'gauravrai1207', 'kindaman17', 'sareddymeghanareddy', 'kiara143uttu', 'abhi_abhinav14', 'jawarsingh2002', 'sephalishradha', 'srikarvirat12', 'pankajsngh2000', 'abhinav1149', 'osmosium', 'rhedl', 'klnagy', 'bahagencay', 'gaurav_kumar', 'srivardhan1008', 'mu.s.hamad', 'abhiraj1', 'zeeshanttps', 'aakankshasingla123', 'abhigupta.4g', 'jagadeeshpadamuttam', 'akshatporwal2001', 'patil.anish99', 'amitmax123', 'prasanthkanakala', '73102sumit', 'slowbutdetermined']",29,"['jdanielguzman264', 'criscams', 'sophyav', 'juandbolivarc', 'libardo11chapal', 'pablosc500', 'alejandro21', 'mangel.hc1109', 'lamarce2016', 'ibuitron', 'af.martinezt', 'mividaeseltamal25', 'dm.zambrano', 'pgalindo3105', 'maidy', 's.rodrigueza', 'd0kma', 'juandita810', 'gicchirivi', None, 'sguerra339', 'nguerreronaranjo', 'catalinavargas025', 'davidspa05', 'am1923', 'susme2020', 'bryam11122113', 'juanfhcardona', 'sergioprieto.mm']",85,"['jvarkey', 'criscams', 'tag12340000', 'libardo11chapal', 'linnmry', 'amanzoor', 'saurabhshah1505', 'alejandro21', 'vudeshmukh', 'areicks2', 'lamarce2016', 'ganapathy61', 'shyamjee1212', 'abhitrivediair1', 'j294lee', 'dm.zambrano', 'kindaman17', 'kiara143uttu', 'maidy', 'jawarsingh2002', 'abhinav1149', 'd0kma', 'juandita810', 'rhedl', 'klnagy', 'gicchirivi', 'sguerra339', 'nguerreronaranjo', 'davidspa05', 'gaurav_kumar', 'aakankshasingla123', 'abhiraj1', 'abhigupta.4g', 'juanfhcardona', 'patil.anish99', 'prasanthkanakala', '73102sumit', 'jdanielguzman264', 'umisra', 'sophyav', 'ashrithanandini', 'juandbolivarc', 'maharshpatel1709', 'opp4578', 'pablosc500', 'nktanurag2020', 'prabhas123', 'lychen', 'mayankk64', 'mangel.hc1109', 'skh2150', 'arsalan.siddique007', 'ibuitron', 'mcordelia08', 'siddharth14415', 'gangadharareddy8976', 'joel12', 'i.buitron', 'cekendri', 'af.martinezt', 'mividaeseltamal25', 'adityasamantaroy1', 'gauravrai1207', 'pgalindo3105', 'sareddymeghanareddy', 'abhi_abhinav14', 'sephalishradha', 'srikarvirat12', 'pankajsngh2000', 'osmosium', 's.rodrigueza', None, 'bahagencay', 'catalinavargas025', 'srivardhan1008', 'mu.s.hamad', 'zeeshanttps', 'am1923', 'jagadeeshpadamuttam', 'susme2020', 'bryam11122113', 'akshatporwal2001', 'amitmax123', 'sergioprieto.mm', 'slowbutdetermined']"
15,101,57,14,1,['areicks2'],55,"['jvarkey', 'umisra', 'ashrithanandini', 'tag12340000', 'maharshpatel1709', 'opp4578', 'linnmry', 'amanzoor', 'saurabhshah1505', 'nktanurag2020', 'lychen', 'prabhas123', 'vudeshmukh', 'mayankk64', 'skh2150', 'ganapathy61', 'arsalan.siddique007', 'mcordelia08', 'siddharth14415', 'gangadharareddy8976', 'joel12', 'i.buitron', 'shyamjee1212', 'cekendri', 'abhitrivediair1', 'adityasamantaroy1', 'j294lee', 'gauravrai1207', 'kindaman17', 'sareddymeghanareddy', 'kiara143uttu', 'abhi_abhinav14', 'jawarsingh2002', 'sephalishradha', 'srikarvirat12', 'pankajsngh2000', 'abhinav1149', 'osmosium', 'rhedl', 'klnagy', 'bahagencay', 'gaurav_kumar', 'srivardhan1008', 'mu.s.hamad', 'abhiraj1', 'zeeshanttps', 'aakankshasingla123', 'abhigupta.4g', 'jagadeeshpadamuttam', 'akshatporwal2001', 'patil.anish99', 'amitmax123', 'prasanthkanakala', '73102sumit', 'slowbutdetermined']",13,"['gandmdanda', None, 'ishahid.me', 'rohan2804', 'yakarsh09', 'dhushyanth5602', 'jagadjaina06', 'sakshisingh7985252', 'vishal_bhushan_', 'vikmeena2009', 'thisisprajjwal', 'check11', 'mzentner']",69,"['jvarkey', 'mzentner', 'umisra', 'ishahid.me', 'ashrithanandini', 'tag12340000', 'maharshpatel1709', 'sakshisingh7985252', 'opp4578', 'linnmry', 'amanzoor', 'saurabhshah1505', 'nktanurag2020', 'prabhas123', 'lychen', 'vudeshmukh', 'mayankk64', 'areicks2', 'vishal_bhushan_', 'gandmdanda', 'skh2150', 'ganapathy61', 'arsalan.siddique007', 'mcordelia08', 'siddharth14415', 'gangadharareddy8976', 'joel12', 'i.buitron', 'shyamjee1212', 'cekendri', 'abhitrivediair1', 'adityasamantaroy1', 'j294lee', 'vikmeena2009', 'gauravrai1207', 'kindaman17', 'thisisprajjwal', 'sareddymeghanareddy', 'kiara143uttu', 'abhi_abhinav14', 'jawarsingh2002', 'rohan2804', 'sephalishradha', 'srikarvirat12', 'pankajsngh2000', 'yakarsh09', 'dhushyanth5602', 'abhinav1149', 'osmosium', 'rhedl', 'klnagy', None, 'bahagencay', 'gaurav_kumar', 'srivardhan1008', 'mu.s.hamad', 'abhiraj1', 'zeeshanttps', 'aakankshasingla123', 'abhigupta.4g', 'jagadeeshpadamuttam', 'jagadjaina06', 'akshatporwal2001', 'patil.anish99', 'amitmax123', 'prasanthkanakala', 'check11', '73102sumit', 'slowbutdetermined']"
15,103,57,14,6,"['arsalan.siddique007', 'zeeshanttps', 'osmosium', 'gauravrai1207', 'nktanurag2020', 'slowbutdetermined']",50,"['jvarkey', 'umisra', 'ashrithanandini', 'tag12340000', 'maharshpatel1709', 'opp4578', 'linnmry', 'amanzoor', 'saurabhshah1505', 'lychen', 'prabhas123', 'vudeshmukh', 'mayankk64', 'areicks2', 'skh2150', 'ganapathy61', 'mcordelia08', 'siddharth14415', 'gangadharareddy8976', 'joel12', 'i.buitron', 'shyamjee1212', 'cekendri', 'abhitrivediair1', 'adityasamantaroy1', 'j294lee', 'kindaman17', 'sareddymeghanareddy', 'kiara143uttu', 'abhi_abhinav14', 'jawarsingh2002', 'sephalishradha', 'srikarvirat12', 'pankajsngh2000', 'abhinav1149', 'rhedl', 'klnagy', 'bahagencay', 'gaurav_kumar', 'srivardhan1008', 'mu.s.hamad', 'abhiraj1', 'aakankshasingla123', 'abhigupta.4g', 'jagadeeshpadamuttam', 'akshatporwal2001', 'patil.anish99', 'amitmax123', 'prasanthkanakala', '73102sumit']",8,"['gandmdanda', None, 'jigyasha2001', 'madhur1999', 'shreya1024', 'naruto_uzamaki', 'thisisprajjwal', 'ashuy0501']",64,"['jvarkey', 'umisra', 'ashrithanandini', 'tag12340000', 'maharshpatel1709', 'madhur1999', 'opp4578', 'linnmry', 'amanzoor', 'saurabhshah1505', 'nktanurag2020', 'prabhas123', 'lychen', 'vudeshmukh', 'mayankk64', 'areicks2', 'gandmdanda', 'skh2150', 'ganapathy61', 'arsalan.siddique007', 'mcordelia08', 'siddharth14415', 'gangadharareddy8976', 'joel12', 'i.buitron', 'shyamjee1212', 'cekendri', 'jigyasha2001', 'abhitrivediair1', 'adityasamantaroy1', 'j294lee', 'shreya1024', 'gauravrai1207', 'kindaman17', 'thisisprajjwal', 'sareddymeghanareddy', 'kiara143uttu', 'ashuy0501', 'abhi_abhinav14', 'jawarsingh2002', 'sephalishradha', 'srikarvirat12', 'pankajsngh2000', 'abhinav1149', 'osmosium', 'rhedl', 'naruto_uzamaki', 'klnagy', None, 'bahagencay', 'gaurav_kumar', 'srivardhan1008', 'mu.s.hamad', 'abhiraj1', 'zeeshanttps', 'aakankshasingla123', 'abhigupta.4g', 'jagadeeshpadamuttam', 'akshatporwal2001', 'patil.anish99', 'amitmax123', 'prasanthkanakala', '73102sumit', 'slowbutdetermined']"
15,102,57,9,3,"['gangadharareddy8976', 'sephalishradha', 'amitmax123']",53,"['jvarkey', 'umisra', 'ashrithanandini', 'tag12340000', 'maharshpatel1709', 'opp4578', 'linnmry', 'amanzoor', 'saurabhshah1505', 'nktanurag2020', 'prabhas123', 'lychen', 'vudeshmukh', 'mayankk64', 'areicks2', 'skh2150', 'ganapathy61', 'arsalan.siddique007', 'mcordelia08', 'siddharth14415', 'joel12', 'i.buitron', 'shyamjee1212', 'cekendri', 'abhitrivediair1', 'adityasamantaroy1', 'j294lee', 'gauravrai1207', 'kindaman17', 'sareddymeghanareddy', 'kiara143uttu', 'abhi_abhinav14', 'jawarsingh2002', 'srikarvirat12', 'pankajsngh2000', 'abhinav1149', 'osmosium', 'rhedl', 'klnagy', 'bahagencay', 'gaurav_kumar', 'srivardhan1008', 'mu.s.hamad', 'abhiraj1', 'zeeshanttps', 'aakankshasingla123', 'abhigupta.4g', 'jagadeeshpadamuttam', 'akshatporwal2001', 'patil.anish99', 'prasanthkanakala', '73102sumit', 'slowbutdetermined']",6,"['hritik11', 'pavansaidundangi', 'madhur1999', 'diksha11', 'thisisprajjwal', None]",62,"['jvarkey', 'umisra', 'ashrithanandini', 'tag12340000', 'maharshpatel1709', 'madhur1999', 'opp4578', 'linnmry', 'amanzoor', 'saurabhshah1505', 'nktanurag2020', 'prabhas123', 'lychen', 'vudeshmukh', 'mayankk64', 'areicks2', 'skh2150', 'ganapathy61', 'arsalan.siddique007', 'mcordelia08', 'siddharth14415', 'gangadharareddy8976', 'joel12', 'i.buitron', 'shyamjee1212', 'cekendri', 'abhitrivediair1', 'adityasamantaroy1', 'j294lee', 'diksha11', 'gauravrai1207', 'kindaman17', 'thisisprajjwal', 'sareddymeghanareddy', 'kiara143uttu', 'abhi_abhinav14', 'jawarsingh2002', 'hritik11', 'sephalishradha', 'srikarvirat12', 'pankajsngh2000', 'abhinav1149', 'osmosium', 'rhedl', 'klnagy', None, 'bahagencay', 'gaurav_kumar', 'srivardhan1008', 'mu.s.hamad', 'abhiraj1', 'zeeshanttps', 'aakankshasingla123', 'abhigupta.4g', 'jagadeeshpadamuttam', 'pavansaidundangi', 'akshatporwal2001', 'patil.anish99', 'amitmax123', 'prasanthkanakala', '73102sumit', 'slowbutdetermined']"
15,104,57,7,5,"['srivardhan1008', 'joel12', 'srikarvirat12', 'jagadeeshpadamuttam', 'abhi_abhinav14']",51,"['jvarkey', 'umisra', 'ashrithanandini', 'tag12340000', 'maharshpatel1709', 'opp4578', 'linnmry', 'amanzoor', 'saurabhshah1505', 'nktanurag2020', 'prabhas123', 'lychen', 'vudeshmukh', 'mayankk64', 'areicks2', 'skh2150', 'ganapathy61', 'arsalan.siddique007', 'mcordelia08', 'siddharth14415', 'gangadharareddy8976', 'i.buitron', 'shyamjee1212', 'cekendri', 'abhitrivediair1', 'adityasamantaroy1', 'j294lee', 'gauravrai1207', 'kindaman17', 'sareddymeghanareddy', 'kiara143uttu', 'jawarsingh2002', 'sephalishradha', 'pankajsngh2000', 'abhinav1149', 'osmosium', 'rhedl', 'klnagy', 'bahagencay', 'gaurav_kumar', 'mu.s.hamad', 'abhiraj1', 'zeeshanttps', 'aakankshasingla123', 'abhigupta.4g', 'akshatporwal2001', 'patil.anish99', 'amitmax123', 'prasanthkanakala', '73102sumit', 'slowbutdetermined']",2,"[None, 'joelrathnam49']",58,"['jvarkey', 'umisra', 'ashrithanandini', 'tag12340000', 'maharshpatel1709', 'opp4578', 'linnmry', 'amanzoor', 'saurabhshah1505', 'nktanurag2020', 'prabhas123', 'lychen', 'vudeshmukh', 'mayankk64', 'areicks2', 'joelrathnam49', 'skh2150', 'ganapathy61', 'arsalan.siddique007', 'mcordelia08', 'siddharth14415', 'gangadharareddy8976', 'joel12', 'i.buitron', 'shyamjee1212', 'cekendri', 'abhitrivediair1', 'adityasamantaroy1', 'j294lee', 'gauravrai1207', 'kindaman17', 'sareddymeghanareddy', 'kiara143uttu', 'abhi_abhinav14', 'jawarsingh2002', 'sephalishradha', 'srikarvirat12', 'pankajsngh2000', 'abhinav1149', 'osmosium', 'rhedl', 'klnagy', None, 'bahagencay', 'gaurav_kumar', 'srivardhan1008', 'mu.s.hamad', 'abhiraj1', 'zeeshanttps', 'aakankshasingla123', 'abhigupta.4g', 'jagadeeshpadamuttam', 'akshatporwal2001', 'patil.anish99', 'amitmax123', 'prasanthkanakala', '73102sumit', 'slowbutdetermined']"
15,105,57,7,4,"['patil.anish99', 'abhigupta.4g', 'vudeshmukh', 'saurabhshah1505']",52,"['jvarkey', 'umisra', 'ashrithanandini', 'tag12340000', 'maharshpatel1709', 'opp4578', 'linnmry', 'amanzoor', 'nktanurag2020', 'prabhas123', 'lychen', 'mayankk64', 'areicks2', 'skh2150', 'ganapathy61', 'arsalan.siddique007', 'mcordelia08', 'siddharth14415', 'gangadharareddy8976', 'joel12', 'i.buitron', 'shyamjee1212', 'cekendri', 'abhitrivediair1', 'adityasamantaroy1', 'j294lee', 'gauravrai1207', 'kindaman17', 'sareddymeghanareddy', 'kiara143uttu', 'abhi_abhinav14', 'jawarsingh2002', 'sephalishradha', 'srikarvirat12', 'pankajsngh2000', 'abhinav1149', 'osmosium', 'rhedl', 'klnagy', 'bahagencay', 'gaurav_kumar', 'srivardhan1008', 'mu.s.hamad', 'abhiraj1', 'zeeshanttps', 'aakankshasingla123', 'jagadeeshpadamuttam', 'akshatporwal2001', 'amitmax123', 'prasanthkanakala', '73102sumit', 'slowbutdetermined']",3,"['jagadjaina06', None, 'hrishita14']",59,"['jvarkey', 'umisra', 'ashrithanandini', 'hrishita14', 'tag12340000', 'maharshpatel1709', 'opp4578', 'linnmry', 'amanzoor', 'saurabhshah1505', 'nktanurag2020', 'prabhas123', 'lychen', 'vudeshmukh', 'mayankk64', 'areicks2', 'skh2150', 'ganapathy61', 'arsalan.siddique007', 'mcordelia08', 'siddharth14415', 'gangadharareddy8976', 'joel12', 'i.buitron', 'shyamjee1212', 'cekendri', 'abhitrivediair1', 'adityasamantaroy1', 'j294lee', 'gauravrai1207', 'kindaman17', 'sareddymeghanareddy', 'kiara143uttu', 'abhi_abhinav14', 'jawarsingh2002', 'sephalishradha', 'srikarvirat12', 'pankajsngh2000', 'abhinav1149', 'osmosium', 'rhedl', 'klnagy', None, 'bahagencay', 'gaurav_kumar', 'srivardhan1008', 'mu.s.hamad', 'abhiraj1', 'zeeshanttps', 'aakankshasingla123', 'abhigupta.4g', 'jagadeeshpadamuttam', 'jagadjaina06', 'akshatporwal2001', 'patil.anish99', 'amitmax123', 'prasanthkanakala', '73102sumit', 'slowbutdetermined']"
15,106,57,7,2,"['kiara143uttu', 'abhigupta.4g']",54,"['jvarkey', 'umisra', 'ashrithanandini', 'tag12340000', 'maharshpatel1709', 'opp4578', 'linnmry', 'amanzoor', 'saurabhshah1505', 'nktanurag2020', 'prabhas123', 'lychen', 'vudeshmukh', 'mayankk64', 'areicks2', 'skh2150', 'ganapathy61', 'arsalan.siddique007', 'mcordelia08', 'siddharth14415', 'gangadharareddy8976', 'joel12', 'i.buitron', 'shyamjee1212', 'cekendri', 'abhitrivediair1', 'adityasamantaroy1', 'j294lee', 'gauravrai1207', 'kindaman17', 'sareddymeghanareddy', 'abhi_abhinav14', 'jawarsingh2002', 'sephalishradha', 'srikarvirat12', 'pankajsngh2000', 'abhinav1149', 'osmosium', 'rhedl', 'klnagy', 'bahagencay', 'gaurav_kumar', 'srivardhan1008', 'mu.s.hamad', 'abhiraj1', 'zeeshanttps', 'aakankshasingla123', 'jagadeeshpadamuttam', 'akshatporwal2001', 'patil.anish99', 'amitmax123', 'prasanthkanakala', '73102sumit', 'slowbutdetermined']",5,"[None, 'hritik11', 'madhur1999', 'ashuy0501', 'champ.divs1739']",61,"['jvarkey', 'umisra', 'ashrithanandini', 'tag12340000', 'maharshpatel1709', 'madhur1999', 'opp4578', 'linnmry', 'amanzoor', 'saurabhshah1505', 'nktanurag2020', 'prabhas123', 'lychen', 'vudeshmukh', 'mayankk64', 'areicks2', 'skh2150', 'ganapathy61', 'arsalan.siddique007', 'mcordelia08', 'siddharth14415', 'gangadharareddy8976', 'joel12', 'i.buitron', 'shyamjee1212', 'cekendri', 'abhitrivediair1', 'adityasamantaroy1', 'j294lee', 'gauravrai1207', 'kindaman17', 'sareddymeghanareddy', 'kiara143uttu', 'ashuy0501', 'champ.divs1739', 'abhi_abhinav14', 'jawarsingh2002', 'hritik11', 'sephalishradha', 'srikarvirat12', 'pankajsngh2000', 'abhinav1149', 'osmosium', 'rhedl', 'klnagy', None, 'bahagencay', 'gaurav_kumar', 'srivardhan1008', 'mu.s.hamad', 'abhiraj1', 'zeeshanttps', 'aakankshasingla123', 'abhigupta.4g', 'jagadeeshpadamuttam', 'akshatporwal2001', 'patil.anish99', 'amitmax123', 'prasanthkanakala', '73102sumit', 'slowbutdetermined']"
16,83,56,15,9,"['yun90', 'kolispeter', 'mcclain5', 'proycho', 'arao53', 'adamg', 'jchavezg', 'sniverty', 'chance.a.norris']",46,"['jglazar', 'paul.j.gasper', 'uhu', 'durgaa', 'cindyyw2', 'aabdulmuin', 'clara.nyby', 'els119', 'lewan94', 'biswas19', 'ipark008', 'nissrin', 'leq2', 'stephentlam', 'qingjie.li219', 'sedaoturak', 'abhik_jee', 'leggart', 'omsuarez', 'hyunjae', 'anna_mal', 'peterfalamoun', 'aeb', 'roberta24', 'qkwnstn', 'jnpatricio4', 'btclingman', 'kmukherj', 'jain171', 'dereskibs', 'terencekswong', 'kwhitham', 'zsiefker', 'zli627', 'sp1709', 'sosna', 'selimthegrim', 'bhar24', 'a7x', 'pagkain', 'zjackson', 'ajacobth', 'devroy', 'edhamlet', 'jhorwath', 'dvaca3']",6,"['yuan310', 'peoplesj', 'pham89', 'sun530', None, 'brajabif']",61,"['jglazar', 'yun90', 'paul.j.gasper', 'uhu', 'peoplesj', 'durgaa', 'proycho', 'arao53', 'cindyyw2', 'aabdulmuin', 'jchavezg', 'clara.nyby', 'sniverty', 'els119', 'sun530', 'lewan94', 'yuan310', 'brajabif', 'biswas19', 'ipark008', 'nissrin', 'leq2', 'stephentlam', 'qingjie.li219', 'omsuarez', 'sedaoturak', 'leggart', 'abhik_jee', 'hyunjae', 'anna_mal', 'peterfalamoun', 'aeb', 'roberta24', 'mcclain5', 'qkwnstn', 'jnpatricio4', 'pham89', 'btclingman', 'adamg', 'chance.a.norris', 'kmukherj', 'jain171', 'dereskibs', 'terencekswong', None, 'kolispeter', 'kwhitham', 'zsiefker', 'zli627', 'sp1709', 'sosna', 'selimthegrim', 'bhar24', 'a7x', 'pagkain', 'zjackson', 'ajacobth', 'devroy', 'edhamlet', 'jhorwath', 'dvaca3']"
16,84,56,6,3,"['aeb', 'biswas19', 'ajacobth']",52,"['jglazar', 'yun90', 'paul.j.gasper', 'uhu', 'durgaa', 'proycho', 'arao53', 'cindyyw2', 'aabdulmuin', 'jchavezg', 'clara.nyby', 'sniverty', 'els119', 'lewan94', 'ipark008', 'nissrin', 'leq2', 'stephentlam', 'qingjie.li219', 'omsuarez', 'sedaoturak', 'leggart', 'abhik_jee', 'hyunjae', 'anna_mal', 'peterfalamoun', 'roberta24', 'mcclain5', 'qkwnstn', 'jnpatricio4', 'btclingman', 'adamg', 'chance.a.norris', 'kmukherj', 'jain171', 'dereskibs', 'terencekswong', 'kolispeter', 'kwhitham', 'zsiefker', 'zli627', 'sp1709', 'sosna', 'selimthegrim', 'bhar24', 'a7x', 'pagkain', 'zjackson', 'devroy', 'edhamlet', 'jhorwath', 'dvaca3']",3,"['rahulfranklin', 'oyesilyu', None]",58,"['jglazar', 'yun90', 'paul.j.gasper', 'uhu', 'durgaa', 'proycho', 'arao53', 'cindyyw2', 'aabdulmuin', 'jchavezg', 'clara.nyby', 'sniverty', 'els119', 'lewan94', 'biswas19', 'ipark008', 'nissrin', 'leq2', 'stephentlam', 'qingjie.li219', 'omsuarez', 'sedaoturak', 'leggart', 'abhik_jee', 'hyunjae', 'anna_mal', 'oyesilyu', 'peterfalamoun', 'aeb', 'roberta24', 'mcclain5', 'qkwnstn', 'jnpatricio4', 'btclingman', 'adamg', 'chance.a.norris', 'kmukherj', 'jain171', 'dereskibs', 'terencekswong', None, 'kolispeter', 'kwhitham', 'zsiefker', 'zli627', 'sp1709', 'sosna', 'selimthegrim', 'bhar24', 'a7x', 'pagkain', 'zjackson', 'ajacobth', 'devroy', 'edhamlet', 'jhorwath', 'rahulfranklin', 'dvaca3']"
17,461,56,39,37,"['suwanaphansah', 'sipahpon', 'phutaret.ha', 'kanlaya_supasathian', 'thatsanee.sr', 'phakphum.ph', 'nithiphoom_kku', 'sangusasiri.se', 'patirattori', 'yanawit', 'nitiratcharit', 'chukaitmatra', 'witchayapon.ma', 'samira_onmee', 'kreetha.apaisom', 'ketmanee', 'wipakorn', 'amikach', 'ppongkumsri', 'mussatorn', 'mmkbmild', 'niranut.mint', 'niranut_onsuratum', 'sasicha.kl', 'kanya_nat', 'parita_ju', 'sarunmu', 'mahatouchth', 'wassak_rodpoung', 'theerapong', 'at_atchareeya', 'piyachat.daenkaeo', 'pornwanutma', 'anantawat', 'prapatsonsomkrut', 'walailak', 'warisarach']",18,"['saadmazam', 'birajdarshiwam', 'chonthicha.kr', 'abdulrahmanyasser95', 'aneirinellis', 'jyorex', 'leshij', 'adeutsch', 'ye.econophy.hao', 'tjager', 'wipakorn.mu', 'liuyiran', 'khaled.mohamed', 'rumo_comp', 'puwachirawit', 'hazamarripa', 'caseygessaman', 'mubanmuangsomkid']",2,"['zaw9104', None]",57,"['suwanaphansah', 'sipahpon', 'phutaret.ha', 'tjager', 'wipakorn.mu', 'caseygessaman', 'nitiratcharit', 'chukaitmatra', 'leshij', 'kreetha.apaisom', 'ketmanee', 'wipakorn', 'ppongkumsri', 'abdulrahmanyasser95', 'niranut.mint', 'liuyiran', 'niranut_onsuratum', 'puwachirawit', 'kanya_nat', 'parita_ju', 'sarunmu', 'wassak_rodpoung', 'theerapong', 'piyachat.daenkaeo', 'pornwanutma', 'anantawat', 'walailak', 'ye.econophy.hao', 'saadmazam', 'kanlaya_supasathian', 'thatsanee.sr', 'phakphum.ph', 'khaled.mohamed', 'nithiphoom_kku', 'sangusasiri.se', 'mubanmuangsomkid', 'yanawit', 'patirattori', 'chonthicha.kr', 'witchayapon.ma', 'samira_onmee', 'amikach', 'mussatorn', 'mmkbmild', 'adeutsch', 'rumo_comp', 'sasicha.kl', 'hazamarripa', 'aneirinellis', 'zaw9104', None, 'mahatouchth', 'jyorex', 'at_atchareeya', 'prapatsonsomkrut', 'birajdarshiwam', 'warisarach']"
17,462,56,13,12,"['kanlaya_supasathian', 'chonthicha.kr', 'patirattori', 'witchayapon.ma', 'wassak_rodpoung', 'thatsanee.sr', 'at_atchareeya', 'phakphum.ph', 'wipakorn.mu', 'yanawit', 'mubanmuangsomkid', 'wipakorn']",43,"['suwanaphansah', 'saadmazam', 'phutaret.ha', 'sipahpon', 'walailak', 'tjager', 'khaled.mohamed', 'nithiphoom_kku', 'sangusasiri.se', 'caseygessaman', 'nitiratcharit', 'chukaitmatra', 'leshij', 'samira_onmee', 'kreetha.apaisom', 'ketmanee', 'amikach', 'ppongkumsri', 'mussatorn', 'abdulrahmanyasser95', 'niranut.mint', 'mmkbmild', 'adeutsch', 'liuyiran', 'rumo_comp', 'niranut_onsuratum', 'puwachirawit', 'sasicha.kl', 'hazamarripa', 'aneirinellis', 'kanya_nat', 'parita_ju', 'sarunmu', 'mahatouchth', 'jyorex', 'theerapong', 'piyachat.daenkaeo', 'pornwanutma', 'anantawat', 'prapatsonsomkrut', 'birajdarshiwam', 'ye.econophy.hao', 'warisarach']",1,[None],56,"['suwanaphansah', 'saadmazam', 'phutaret.ha', 'kanlaya_supasathian', 'sipahpon', 'thatsanee.sr', 'tjager', 'phakphum.ph', 'wipakorn.mu', 'khaled.mohamed', 'nithiphoom_kku', 'sangusasiri.se', 'caseygessaman', 'mubanmuangsomkid', 'yanawit', 'patirattori', 'birajdarshiwam', 'chonthicha.kr', 'nitiratcharit', 'chukaitmatra', 'witchayapon.ma', 'leshij', 'samira_onmee', 'kreetha.apaisom', 'ketmanee', 'wipakorn', 'amikach', 'ppongkumsri', 'mussatorn', 'abdulrahmanyasser95', 'niranut.mint', 'mmkbmild', 'adeutsch', 'liuyiran', 'rumo_comp', 'niranut_onsuratum', 'puwachirawit', 'sasicha.kl', 'hazamarripa', 'aneirinellis', 'kanya_nat', None, 'parita_ju', 'sarunmu', 'mahatouchth', 'jyorex', 'wassak_rodpoung', 'theerapong', 'at_atchareeya', 'piyachat.daenkaeo', 'pornwanutma', 'anantawat', 'prapatsonsomkrut', 'walailak', 'ye.econophy.hao', 'warisarach']"
17,460,56,11,1,['hazamarripa'],54,"['suwanaphansah', 'saadmazam', 'phutaret.ha', 'kanlaya_supasathian', 'sipahpon', 'thatsanee.sr', 'tjager', 'phakphum.ph', 'wipakorn.mu', 'khaled.mohamed', 'nithiphoom_kku', 'sangusasiri.se', 'caseygessaman', 'mubanmuangsomkid', 'yanawit', 'patirattori', 'birajdarshiwam', 'chonthicha.kr', 'nitiratcharit', 'chukaitmatra', 'witchayapon.ma', 'leshij', 'samira_onmee', 'kreetha.apaisom', 'ketmanee', 'wipakorn', 'amikach', 'ppongkumsri', 'mussatorn', 'abdulrahmanyasser95', 'niranut.mint', 'mmkbmild', 'adeutsch', 'liuyiran', 'rumo_comp', 'niranut_onsuratum', 'puwachirawit', 'sasicha.kl', 'aneirinellis', 'kanya_nat', 'parita_ju', 'sarunmu', 'mahatouchth', 'jyorex', 'wassak_rodpoung', 'theerapong', 'at_atchareeya', 'piyachat.daenkaeo', 'pornwanutma', 'anantawat', 'prapatsonsomkrut', 'walailak', 'ye.econophy.hao', 'warisarach']",10,"[None, 'stella', 'ivizzh', 'ginazavala8', 'ajmirelesme', 'celinechiong', 'jordanhitter41', 'michaelnava380', 'mr.alannunez', 'katia011']",65,"['suwanaphansah', 'saadmazam', 'phutaret.ha', 'kanlaya_supasathian', 'sipahpon', 'thatsanee.sr', 'tjager', 'phakphum.ph', 'wipakorn.mu', 'khaled.mohamed', 'nithiphoom_kku', 'jordanhitter41', 'sangusasiri.se', 'caseygessaman', 'mubanmuangsomkid', 'yanawit', 'patirattori', 'birajdarshiwam', 'chonthicha.kr', 'nitiratcharit', 'chukaitmatra', 'witchayapon.ma', 'leshij', 'samira_onmee', 'kreetha.apaisom', 'ajmirelesme', 'ketmanee', 'michaelnava380', 'mr.alannunez', 'wipakorn', 'amikach', 'ppongkumsri', 'mussatorn', 'abdulrahmanyasser95', 'niranut.mint', 'mmkbmild', 'adeutsch', 'ginazavala8', 'celinechiong', 'liuyiran', 'rumo_comp', 'niranut_onsuratum', 'puwachirawit', 'sasicha.kl', 'hazamarripa', 'aneirinellis', 'kanya_nat', None, 'katia011', 'parita_ju', 'sarunmu', 'mahatouchth', 'jyorex', 'wassak_rodpoung', 'theerapong', 'stella', 'ivizzh', 'at_atchareeya', 'piyachat.daenkaeo', 'pornwanutma', 'anantawat', 'prapatsonsomkrut', 'walailak', 'ye.econophy.hao', 'warisarach']"
17,465,56,10,1,['hazamarripa'],54,"['suwanaphansah', 'saadmazam', 'phutaret.ha', 'kanlaya_supasathian', 'sipahpon', 'thatsanee.sr', 'tjager', 'phakphum.ph', 'wipakorn.mu', 'khaled.mohamed', 'nithiphoom_kku', 'sangusasiri.se', 'caseygessaman', 'mubanmuangsomkid', 'yanawit', 'patirattori', 'birajdarshiwam', 'chonthicha.kr', 'nitiratcharit', 'chukaitmatra', 'witchayapon.ma', 'leshij', 'samira_onmee', 'kreetha.apaisom', 'ketmanee', 'wipakorn', 'amikach', 'ppongkumsri', 'mussatorn', 'abdulrahmanyasser95', 'niranut.mint', 'mmkbmild', 'adeutsch', 'liuyiran', 'rumo_comp', 'niranut_onsuratum', 'puwachirawit', 'sasicha.kl', 'aneirinellis', 'kanya_nat', 'parita_ju', 'sarunmu', 'mahatouchth', 'jyorex', 'wassak_rodpoung', 'theerapong', 'at_atchareeya', 'piyachat.daenkaeo', 'pornwanutma', 'anantawat', 'prapatsonsomkrut', 'walailak', 'ye.econophy.hao', 'warisarach']",9,"[None, 'stellaq', 'stella', 'ivizzh', 'ginazavala8', 'celinechiong', 'jordanhitter41', 'mr.alannunez', 'katia011']",64,"['suwanaphansah', 'saadmazam', 'phutaret.ha', 'kanlaya_supasathian', 'sipahpon', 'thatsanee.sr', 'tjager', 'phakphum.ph', 'wipakorn.mu', 'khaled.mohamed', 'nithiphoom_kku', 'jordanhitter41', 'sangusasiri.se', 'caseygessaman', 'mubanmuangsomkid', 'yanawit', 'patirattori', 'birajdarshiwam', 'chonthicha.kr', 'nitiratcharit', 'chukaitmatra', 'witchayapon.ma', 'leshij', 'stellaq', 'samira_onmee', 'kreetha.apaisom', 'ketmanee', 'mr.alannunez', 'wipakorn', 'amikach', 'ppongkumsri', 'mussatorn', 'abdulrahmanyasser95', 'niranut.mint', 'mmkbmild', 'adeutsch', 'ginazavala8', 'celinechiong', 'liuyiran', 'rumo_comp', 'niranut_onsuratum', 'puwachirawit', 'sasicha.kl', 'hazamarripa', 'aneirinellis', 'kanya_nat', None, 'katia011', 'parita_ju', 'sarunmu', 'mahatouchth', 'jyorex', 'wassak_rodpoung', 'theerapong', 'stella', 'ivizzh', 'at_atchareeya', 'piyachat.daenkaeo', 'pornwanutma', 'anantawat', 'prapatsonsomkrut', 'walailak', 'ye.econophy.hao', 'warisarach']"
17,464,56,7,1,['hazamarripa'],54,"['suwanaphansah', 'saadmazam', 'phutaret.ha', 'kanlaya_supasathian', 'sipahpon', 'thatsanee.sr', 'tjager', 'phakphum.ph', 'wipakorn.mu', 'khaled.mohamed', 'nithiphoom_kku', 'sangusasiri.se', 'caseygessaman', 'mubanmuangsomkid', 'yanawit', 'patirattori', 'birajdarshiwam', 'chonthicha.kr', 'nitiratcharit', 'chukaitmatra', 'witchayapon.ma', 'leshij', 'samira_onmee', 'kreetha.apaisom', 'ketmanee', 'wipakorn', 'amikach', 'ppongkumsri', 'mussatorn', 'abdulrahmanyasser95', 'niranut.mint', 'mmkbmild', 'adeutsch', 'liuyiran', 'rumo_comp', 'niranut_onsuratum', 'puwachirawit', 'sasicha.kl', 'aneirinellis', 'kanya_nat', 'parita_ju', 'sarunmu', 'mahatouchth', 'jyorex', 'wassak_rodpoung', 'theerapong', 'at_atchareeya', 'piyachat.daenkaeo', 'pornwanutma', 'anantawat', 'prapatsonsomkrut', 'walailak', 'ye.econophy.hao', 'warisarach']",6,"[None, 'stellaq', 'celinechiong', 'jordanhitter41', 'mr.alannunez', 'katia011']",61,"['suwanaphansah', 'saadmazam', 'phutaret.ha', 'kanlaya_supasathian', 'sipahpon', 'thatsanee.sr', 'tjager', 'phakphum.ph', 'wipakorn.mu', 'khaled.mohamed', 'nithiphoom_kku', 'jordanhitter41', 'sangusasiri.se', 'caseygessaman', 'mubanmuangsomkid', 'yanawit', 'patirattori', 'birajdarshiwam', 'chonthicha.kr', 'nitiratcharit', 'chukaitmatra', 'witchayapon.ma', 'leshij', 'stellaq', 'samira_onmee', 'kreetha.apaisom', 'ketmanee', 'mr.alannunez', 'wipakorn', 'amikach', 'ppongkumsri', 'mussatorn', 'abdulrahmanyasser95', 'niranut.mint', 'mmkbmild', 'adeutsch', 'celinechiong', 'liuyiran', 'rumo_comp', 'niranut_onsuratum', 'puwachirawit', 'sasicha.kl', 'hazamarripa', 'aneirinellis', 'kanya_nat', None, 'katia011', 'parita_ju', 'sarunmu', 'mahatouchth', 'jyorex', 'wassak_rodpoung', 'theerapong', 'at_atchareeya', 'piyachat.daenkaeo', 'pornwanutma', 'anantawat', 'prapatsonsomkrut', 'walailak', 'ye.econophy.hao', 'warisarach']"
18,303,56,74,2,"['kevinkw3', 'jornia2']",53,"['bethnowadnick', 'agrind2', 'zachlc66', 'akshays6', 'hjr2', 'wm12', 'hchaieb', 'jiming2', 'haoran7', 'syndeev15', 'jonathanaguilera789', 'dhodges3', 'ericy3', 'danayun2', 'maoh2', 'hmpatel4', 'karoche3', 'likithreddy', 'mgoodman', 'tsehgal2', 'rjosh009', 'aarondh2', 'kkang14', 'jnb4', 'dkpatel3', 'xc29', 'danny32', 'nobuta2333', 'jyz2', 'xiuzhaohong', 'kais.ammar1980', 'jleeman2', 'qz3', 'sl117', 'justpham27', 'baconztaco', 'jxo414', 'sofiamv2', 'abhirs2', 'kaungthu', 'ganeshvasantada', 'shuming2', 'nathanl5', 'chinta_b170971me', 'anishas4', 'yifeil5', 'junzed2', 'pimpitcha78', 'kalkan.i.halil', 'cholas2', 'lzaczek2', 'nbh5237', 'cyoung27']",72,"['rohanv2', 'jiapeiy2', 'mblaauw2', 'mabdal6', 'varuns5', 'xuwenting2000', 'jaboyce2', 'michal3', 'pgardo2', 'lucasrc2', 'azatar3', 'allibur', 'hyunbin2', 'coleck2', 'bsutton3', 'konicek3', 'corynne2', 'sujays2', 'dlee230', 'mlarson7', 'megangb2', 'haoyuli3', 'aatass2', 'bshiang2', 'jlakomy2', 'glevita2', 'jiaruil4', 'jkubota2', 'jordanm7', 'rdelara2', 'jripper2', 'hanzhi2', 'daniel13', 'jrswan2', 'alexmf2', 'jkelle30', 'myassin3', 'msedlak2', 'teb4', 'loutris2', 'kyang37', 'sbhujle2', 'wmendoza1455', 'bremig2', 'mderka3', 'jaeyong2', 'adamato2', 'ninume2', 'wx5', 'schumer2', 'talhat2', None, 'dosman3', 'ns23', 'micahpr2', 'amaloto2', 'lrs3', 'luketk2', 'huizhit2', 'samuelf4', 'meeraj2', 'dl20', 'bonianp2', 'haibog2', 'noahrh3', 'ewilli47', 'aswett2', 'msaada2', 'zanh2', 'nathane3', 'ymyu2', 'phn4']",127,"['varuns5', 'bethnowadnick', 'mabdal6', 'hjr2', 'bsutton3', 'jiaruil4', 'jripper2', 'aarondh2', 'teb4', 'dkpatel3', 'xiuzhaohong', 'nobuta2333', 'bremig2', 'adamato2', 'ninume2', 'wx5', 'dosman3', 'justpham27', 'luketk2', 'huizhit2', 'samuelf4', 'jxo414', 'sofiamv2', 'kaungthu', 'bonianp2', 'kalkan.i.halil', 'msaada2', 'haoyuli3', 'cyoung27', 'wm12', 'allibur', 'jonathanaguilera789', 'danayun2', 'maoh2', 'corynne2', 'aatass2', 'bshiang2', 'jlakomy2', 'jkubota2', 'mgoodman', 'tsehgal2', 'rdelara2', 'loutris2', 'kyang37', 'wmendoza1455', 'danny32', 'jyz2', 'kais.ammar1980', 'schumer2', 'qz3', 'talhat2', None, 'ns23', 'sl117', 'abhirs2', 'chinta_b170971me', 'shuming2', 'nathanl5', 'yifeil5', 'lzaczek2', 'daniel13', 'alexmf2', 'nathane3', 'ymyu2', 'dl20', 'rohanv2', 'jiapeiy2', 'agrind2', 'zachlc66', 'akshays6', 'pgardo2', 'jornia2', 'lucasrc2', 'jiming2', 'kevinkw3', 'hyunbin2', 'syndeev15', 'dhodges3', 'konicek3', 'hmpatel4', 'sujays2', 'dlee230', 'jordanm7', 'xc29', 'jleeman2', 'mderka3', 'jaeyong2', 'micahpr2', 'baconztaco', 'lrs3', 'ganeshvasantada', 'anishas4', 'junzed2', 'pimpitcha78', 'aswett2', 'nbh5237', 'mblaauw2', 'xuwenting2000', 'jaboyce2', 'michal3', 'hchaieb', 'haoran7', 'azatar3', 'coleck2', 'ericy3', 'mlarson7', 'karoche3', 'megangb2', 'likithreddy', 'glevita2', 'rjosh009', 'hanzhi2', 'jrswan2', 'kkang14', 'jkelle30', 'myassin3', 'jnb4', 'msedlak2', 'sbhujle2', 'amaloto2', 'meeraj2', 'haibog2', 'noahrh3', 'ewilli47', 'cholas2', 'zanh2', 'phn4']"
18,308,56,20,17,"['sl117', 'agrind2', 'hmpatel4', 'kkang14', 'dkpatel3', 'nobuta2333', 'jyz2', 'hjr2', 'wm12', 'nathanl5', 'jleeman2', 'anishas4', 'kevinkw3', 'cholas2', 'mgoodman', 'lzaczek2', 'danayun2']",38,"['bethnowadnick', 'zachlc66', 'akshays6', 'jornia2', 'hchaieb', 'jiming2', 'haoran7', 'syndeev15', 'jonathanaguilera789', 'dhodges3', 'ericy3', 'maoh2', 'karoche3', 'likithreddy', 'tsehgal2', 'rjosh009', 'aarondh2', 'jnb4', 'xc29', 'danny32', 'xiuzhaohong', 'kais.ammar1980', 'qz3', 'justpham27', 'baconztaco', 'jxo414', 'sofiamv2', 'abhirs2', 'kaungthu', 'ganeshvasantada', 'shuming2', 'chinta_b170971me', 'yifeil5', 'junzed2', 'pimpitcha78', 'kalkan.i.halil', 'nbh5237', 'cyoung27']",3,"['sva2', None, 'a.schleife']",58,"['sva2', 'bethnowadnick', 'agrind2', 'zachlc66', 'akshays6', 'hjr2', 'wm12', 'hchaieb', 'jornia2', 'jiming2', 'kevinkw3', 'haoran7', 'syndeev15', 'dhodges3', 'jonathanaguilera789', 'ericy3', 'danayun2', 'maoh2', 'hmpatel4', 'karoche3', 'likithreddy', 'mgoodman', 'tsehgal2', 'rjosh009', 'aarondh2', 'kkang14', 'jnb4', 'dkpatel3', 'xc29', 'danny32', 'nobuta2333', 'jyz2', 'xiuzhaohong', 'kais.ammar1980', 'jleeman2', 'qz3', None, 'a.schleife', 'sl117', 'justpham27', 'baconztaco', 'jxo414', 'sofiamv2', 'abhirs2', 'kaungthu', 'ganeshvasantada', 'shuming2', 'nathanl5', 'chinta_b170971me', 'anishas4', 'yifeil5', 'junzed2', 'pimpitcha78', 'kalkan.i.halil', 'cholas2', 'lzaczek2', 'nbh5237', 'cyoung27']"
18,310,56,9,7,"['sofiamv2', 'akshays6', 'jyz2', 'jornia2', 'anishas4', 'cholas2', 'tsehgal2']",48,"['bethnowadnick', 'agrind2', 'zachlc66', 'hjr2', 'wm12', 'hchaieb', 'jiming2', 'kevinkw3', 'haoran7', 'syndeev15', 'dhodges3', 'jonathanaguilera789', 'ericy3', 'danayun2', 'maoh2', 'hmpatel4', 'karoche3', 'likithreddy', 'mgoodman', 'rjosh009', 'aarondh2', 'kkang14', 'jnb4', 'dkpatel3', 'xc29', 'danny32', 'nobuta2333', 'xiuzhaohong', 'kais.ammar1980', 'jleeman2', 'qz3', 'sl117', 'justpham27', 'baconztaco', 'jxo414', 'abhirs2', 'kaungthu', 'ganeshvasantada', 'shuming2', 'nathanl5', 'chinta_b170971me', 'yifeil5', 'junzed2', 'pimpitcha78', 'kalkan.i.halil', 'lzaczek2', 'nbh5237', 'cyoung27']",2,"[None, 'mnw3']",57,"['bethnowadnick', 'agrind2', 'zachlc66', 'akshays6', 'hjr2', 'wm12', 'hchaieb', 'jornia2', 'jiming2', 'kevinkw3', 'haoran7', 'syndeev15', 'dhodges3', 'jonathanaguilera789', 'ericy3', 'danayun2', 'maoh2', 'hmpatel4', 'karoche3', 'likithreddy', 'mnw3', 'mgoodman', 'tsehgal2', 'rjosh009', 'aarondh2', 'kkang14', 'jnb4', 'dkpatel3', 'xc29', 'danny32', 'nobuta2333', 'jyz2', 'xiuzhaohong', 'kais.ammar1980', 'jleeman2', 'qz3', None, 'sl117', 'justpham27', 'baconztaco', 'jxo414', 'sofiamv2', 'abhirs2', 'kaungthu', 'ganeshvasantada', 'shuming2', 'nathanl5', 'chinta_b170971me', 'anishas4', 'yifeil5', 'junzed2', 'pimpitcha78', 'kalkan.i.halil', 'cholas2', 'lzaczek2', 'nbh5237', 'cyoung27']"
18,309,56,8,6,"['abhirs2', 'akshays6', 'jornia2', 'anishas4', 'lzaczek2', 'kkang14']",49,"['bethnowadnick', 'agrind2', 'zachlc66', 'hjr2', 'wm12', 'hchaieb', 'jiming2', 'kevinkw3', 'haoran7', 'syndeev15', 'dhodges3', 'jonathanaguilera789', 'ericy3', 'danayun2', 'maoh2', 'hmpatel4', 'karoche3', 'likithreddy', 'mgoodman', 'tsehgal2', 'rjosh009', 'aarondh2', 'jnb4', 'dkpatel3', 'xc29', 'danny32', 'nobuta2333', 'jyz2', 'xiuzhaohong', 'kais.ammar1980', 'jleeman2', 'qz3', 'sl117', 'justpham27', 'baconztaco', 'jxo414', 'sofiamv2', 'kaungthu', 'ganeshvasantada', 'shuming2', 'nathanl5', 'chinta_b170971me', 'yifeil5', 'junzed2', 'pimpitcha78', 'kalkan.i.halil', 'cholas2', 'nbh5237', 'cyoung27']",2,"[None, 'hf4']",57,"['bethnowadnick', 'agrind2', 'zachlc66', 'akshays6', 'hjr2', 'wm12', 'hchaieb', 'jornia2', 'jiming2', 'kevinkw3', 'haoran7', 'syndeev15', 'dhodges3', 'jonathanaguilera789', 'ericy3', 'hf4', 'danayun2', 'maoh2', 'hmpatel4', 'karoche3', 'likithreddy', 'mgoodman', 'tsehgal2', 'rjosh009', 'aarondh2', 'kkang14', 'jnb4', 'dkpatel3', 'xc29', 'danny32', 'nobuta2333', 'jyz2', 'xiuzhaohong', 'kais.ammar1980', 'jleeman2', 'qz3', None, 'sl117', 'justpham27', 'baconztaco', 'jxo414', 'sofiamv2', 'abhirs2', 'kaungthu', 'ganeshvasantada', 'shuming2', 'nathanl5', 'chinta_b170971me', 'anishas4', 'yifeil5', 'junzed2', 'pimpitcha78', 'kalkan.i.halil', 'cholas2', 'lzaczek2', 'nbh5237', 'cyoung27']"
18,312,56,8,6,"['bethnowadnick', 'baconztaco', 'zachlc66', 'kaungthu', 'syndeev15', 'cyoung27']",49,"['agrind2', 'akshays6', 'hjr2', 'wm12', 'hchaieb', 'jornia2', 'jiming2', 'kevinkw3', 'haoran7', 'dhodges3', 'jonathanaguilera789', 'ericy3', 'danayun2', 'maoh2', 'hmpatel4', 'karoche3', 'likithreddy', 'mgoodman', 'tsehgal2', 'rjosh009', 'aarondh2', 'kkang14', 'jnb4', 'dkpatel3', 'xc29', 'danny32', 'nobuta2333', 'jyz2', 'xiuzhaohong', 'kais.ammar1980', 'jleeman2', 'qz3', 'sl117', 'justpham27', 'jxo414', 'sofiamv2', 'abhirs2', 'ganeshvasantada', 'shuming2', 'nathanl5', 'chinta_b170971me', 'anishas4', 'yifeil5', 'junzed2', 'pimpitcha78', 'kalkan.i.halil', 'cholas2', 'lzaczek2', 'nbh5237']",2,"[None, 'beth.nowadnick']",57,"['bethnowadnick', 'agrind2', 'zachlc66', 'akshays6', 'hjr2', 'wm12', 'hchaieb', 'jornia2', 'jiming2', 'kevinkw3', 'haoran7', 'syndeev15', 'dhodges3', 'jonathanaguilera789', 'ericy3', 'beth.nowadnick', 'danayun2', 'maoh2', 'hmpatel4', 'karoche3', 'likithreddy', 'mgoodman', 'tsehgal2', 'rjosh009', 'aarondh2', 'kkang14', 'jnb4', 'dkpatel3', 'xc29', 'danny32', 'nobuta2333', 'jyz2', 'xiuzhaohong', 'kais.ammar1980', 'jleeman2', 'qz3', None, 'sl117', 'justpham27', 'baconztaco', 'jxo414', 'sofiamv2', 'abhirs2', 'kaungthu', 'ganeshvasantada', 'shuming2', 'nathanl5', 'chinta_b170971me', 'anishas4', 'yifeil5', 'junzed2', 'pimpitcha78', 'kalkan.i.halil', 'cholas2', 'lzaczek2', 'nbh5237', 'cyoung27']"
19,4,51,52,48,"['murasyu811', 'null1682', 'kyoppei0516', 'shota5963', 'aaaa1111', 'koma2039', 'ryusuketoda', 'rena0912', 'fujii3', 'hurezemitcu346', 'abcd0603sk', 'eito', 'masakiyamucha', 'ayaka', 'soccerlove.0404', 'kentaro.nakamura', 'akikusa', 'jungwoo219', 'g1815086tcu', 'momoe14', 'akayagi1227', 'twobow92', 'account01', 'g1815059', 'kawa1', 'ken22', 'higuchiyuta', 'ryobucchi21', 'satosatoryo', 'denkidenshi', 'agata0723', 'ohnobaske1515', 'g1815026', 'eeg1815003', 'narycan', 'akouno95', 'g1815081', 'jg14g', 'kawasrino', 'tecyartha10', 'g1815002', 'kick.n.bio1998', 'sake', 'seiga', 'yuichi0330', 'g1815083', 'tomoya223', 'hiroaki24']",2,"['shion', 'emi0502']",4,"['yutaka3991', 'tanakeru', None, 'yutaro0605']",54,"['murasyu811', 'null1682', 'aaaa1111', 'ryusuketoda', 'rena0912', 'fujii3', 'hurezemitcu346', 'abcd0603sk', 'ayaka', 'soccerlove.0404', 'masakiyamucha', 'kentaro.nakamura', 'akikusa', 'jungwoo219', 'yutaka3991', 'g1815086tcu', 'account01', 'g1815026', 'eeg1815003', 'narycan', 'akouno95', 'jg14g', 'yutaro0605', 'g1815002', 'kyoppei0516', 'shota5963', 'koma2039', 'eito', 'momoe14', 'emi0502', 'akayagi1227', 'twobow92', 'g1815059', 'kawa1', 'ken22', 'higuchiyuta', 'ryobucchi21', 'satosatoryo', 'denkidenshi', 'agata0723', 'ohnobaske1515', 'shion', 'tanakeru', None, 'g1815081', 'kawasrino', 'tecyartha10', 'kick.n.bio1998', 'sake', 'seiga', 'yuichi0330', 'g1815083', 'tomoya223', 'hiroaki24']"
19,39,51,51,47,"['murasyu811', 'null1682', 'kyoppei0516', 'shota5963', 'aaaa1111', 'koma2039', 'ryusuketoda', 'rena0912', 'fujii3', 'hurezemitcu346', 'abcd0603sk', 'eito', 'masakiyamucha', 'ayaka', 'soccerlove.0404', 'kentaro.nakamura', 'akikusa', 'jungwoo219', 'g1815086tcu', 'momoe14', 'akayagi1227', 'twobow92', 'account01', 'g1815059', 'kawa1', 'ken22', 'higuchiyuta', 'ryobucchi21', 'satosatoryo', 'denkidenshi', 'agata0723', 'ohnobaske1515', 'g1815026', 'eeg1815003', 'narycan', 'akouno95', 'g1815081', 'jg14g', 'kawasrino', 'tecyartha10', 'g1815002', 'kick.n.bio1998', 'sake', 'yuichi0330', 'g1815083', 'tomoya223', 'hiroaki24']",3,"['shion', 'emi0502', 'seiga']",4,"['tanakeru', None, 'athlete.kento', 'yutaro0605']",54,"['murasyu811', 'null1682', 'aaaa1111', 'ryusuketoda', 'rena0912', 'fujii3', 'hurezemitcu346', 'abcd0603sk', 'ayaka', 'soccerlove.0404', 'masakiyamucha', 'kentaro.nakamura', 'akikusa', 'jungwoo219', 'g1815086tcu', 'account01', 'g1815026', 'eeg1815003', 'narycan', 'akouno95', 'jg14g', 'yutaro0605', 'g1815002', 'kyoppei0516', 'shota5963', 'koma2039', 'eito', 'momoe14', 'athlete.kento', 'emi0502', 'akayagi1227', 'twobow92', 'g1815059', 'kawa1', 'ken22', 'higuchiyuta', 'ryobucchi21', 'satosatoryo', 'denkidenshi', 'agata0723', 'ohnobaske1515', 'shion', 'tanakeru', None, 'g1815081', 'kawasrino', 'tecyartha10', 'kick.n.bio1998', 'sake', 'seiga', 'yuichi0330', 'g1815083', 'tomoya223', 'hiroaki24']"
19,333,51,50,46,"['murasyu811', 'null1682', 'kyoppei0516', 'shota5963', 'aaaa1111', 'koma2039', 'rena0912', 'fujii3', 'hurezemitcu346', 'abcd0603sk', 'eito', 'soccerlove.0404', 'ayaka', 'masakiyamucha', 'kentaro.nakamura', 'akikusa', 'jungwoo219', 'momoe14', 'g1815086tcu', 'akayagi1227', 'twobow92', 'account01', 'g1815059', 'kawa1', 'ken22', 'higuchiyuta', 'ryobucchi21', 'satosatoryo', 'agata0723', 'ohnobaske1515', 'g1815026', 'eeg1815003', 'narycan', 'akouno95', 'jg14g', 'g1815081', 'kawasrino', 'tecyartha10', 'kick.n.bio1998', 'g1815002', 'seiga', 'sake', 'yuichi0330', 'g1815083', 'tomoya223', 'hiroaki24']",4,"['shion', 'emi0502', 'ryusuketoda', 'denkidenshi']",4,"['atsu272', 'tanakeru', None, 'athlete.kento']",54,"['murasyu811', 'null1682', 'aaaa1111', 'ryusuketoda', 'rena0912', 'fujii3', 'hurezemitcu346', 'abcd0603sk', 'ayaka', 'soccerlove.0404', 'masakiyamucha', 'kentaro.nakamura', 'akikusa', 'jungwoo219', 'g1815086tcu', 'account01', 'g1815026', 'eeg1815003', 'narycan', 'akouno95', 'jg14g', 'g1815002', 'kyoppei0516', 'shota5963', 'atsu272', 'koma2039', 'eito', 'momoe14', 'athlete.kento', 'emi0502', 'akayagi1227', 'twobow92', 'g1815059', 'kawa1', 'ken22', 'higuchiyuta', 'ryobucchi21', 'satosatoryo', 'denkidenshi', 'agata0723', 'ohnobaske1515', 'shion', 'tanakeru', None, 'g1815081', 'kawasrino', 'tecyartha10', 'kick.n.bio1998', 'sake', 'seiga', 'yuichi0330', 'g1815083', 'tomoya223', 'hiroaki24']"
19,3,51,49,45,"['murasyu811', 'null1682', 'kyoppei0516', 'shota5963', 'aaaa1111', 'ryusuketoda', 'koma2039', 'rena0912', 'fujii3', 'hurezemitcu346', 'abcd0603sk', 'eito', 'soccerlove.0404', 'ayaka', 'masakiyamucha', 'kentaro.nakamura', 'jungwoo219', 'momoe14', 'g1815086tcu', 'akayagi1227', 'twobow92', 'account01', 'g1815059', 'kawa1', 'ken22', 'higuchiyuta', 'denkidenshi', 'satosatoryo', 'ohnobaske1515', 'g1815026', 'eeg1815003', 'narycan', 'akouno95', 'jg14g', 'g1815081', 'kawasrino', 'tecyartha10', 'kick.n.bio1998', 'g1815002', 'seiga', 'sake', 'yuichi0330', 'g1815083', 'tomoya223', 'hiroaki24']",5,"['ryobucchi21', 'akikusa', 'agata0723', 'emi0502', 'shion']",4,"['yutaka3991', None, 'athlete.kento', 'yutaro0605']",54,"['murasyu811', 'null1682', 'aaaa1111', 'ryusuketoda', 'rena0912', 'fujii3', 'hurezemitcu346', 'abcd0603sk', 'ayaka', 'soccerlove.0404', 'masakiyamucha', 'kentaro.nakamura', 'akikusa', 'jungwoo219', 'yutaka3991', 'g1815086tcu', 'account01', 'g1815026', 'eeg1815003', 'narycan', 'akouno95', 'jg14g', 'yutaro0605', 'g1815002', 'kyoppei0516', 'shota5963', 'koma2039', 'eito', 'momoe14', 'athlete.kento', 'emi0502', 'akayagi1227', 'twobow92', 'g1815059', 'kawa1', 'ken22', 'higuchiyuta', 'ryobucchi21', 'satosatoryo', 'denkidenshi', 'agata0723', 'ohnobaske1515', 'shion', None, 'g1815081', 'kawasrino', 'tecyartha10', 'kick.n.bio1998', 'sake', 'seiga', 'yuichi0330', 'g1815083', 'tomoya223', 'hiroaki24']"
19,269,51,49,47,"['null1682', 'kyoppei0516', 'shota5963', 'aaaa1111', 'ryusuketoda', 'koma2039', 'rena0912', 'fujii3', 'hurezemitcu346', 'abcd0603sk', 'eito', 'soccerlove.0404', 'ayaka', 'masakiyamucha', 'kentaro.nakamura', 'akikusa', 'jungwoo219', 'momoe14', 'g1815086tcu', 'akayagi1227', 'twobow92', 'account01', 'g1815059', 'kawa1', 'ken22', 'higuchiyuta', 'ryobucchi21', 'satosatoryo', 'denkidenshi', 'agata0723', 'ohnobaske1515', 'g1815026', 'eeg1815003', 'narycan', 'akouno95', 'jg14g', 'g1815081', 'kawasrino', 'tecyartha10', 'kick.n.bio1998', 'g1815002', 'seiga', 'sake', 'yuichi0330', 'g1815083', 'tomoya223', 'hiroaki24']",3,"['shion', 'emi0502', 'murasyu811']",2,"['tanakeru', None]",52,"['murasyu811', 'null1682', 'aaaa1111', 'ryusuketoda', 'rena0912', 'fujii3', 'hurezemitcu346', 'abcd0603sk', 'ayaka', 'soccerlove.0404', 'masakiyamucha', 'kentaro.nakamura', 'akikusa', 'jungwoo219', 'g1815086tcu', 'account01', 'g1815026', 'eeg1815003', 'narycan', 'akouno95', 'jg14g', 'g1815002', 'kyoppei0516', 'shota5963', 'koma2039', 'eito', 'momoe14', 'emi0502', 'akayagi1227', 'twobow92', 'g1815059', 'kawa1', 'ken22', 'higuchiyuta', 'ryobucchi21', 'satosatoryo', 'denkidenshi', 'agata0723', 'ohnobaske1515', 'shion', 'tanakeru', None, 'g1815081', 'kawasrino', 'tecyartha10', 'kick.n.bio1998', 'sake', 'seiga', 'yuichi0330', 'g1815083', 'tomoya223', 'hiroaki24']"
19,163,51,48,46,"['murasyu811', 'null1682', 'kyoppei0516', 'shota5963', 'aaaa1111', 'ryusuketoda', 'koma2039', 'rena0912', 'fujii3', 'hurezemitcu346', 'abcd0603sk', 'eito', 'soccerlove.0404', 'ayaka', 'masakiyamucha', 'kentaro.nakamura', 'akikusa', 'jungwoo219', 'momoe14', 'g1815086tcu', 'akayagi1227', 'account01', 'g1815059', 'kawa1', 'ken22', 'higuchiyuta', 'ryobucchi21', 'satosatoryo', 'denkidenshi', 'agata0723', 'ohnobaske1515', 'g1815026', 'narycan', 'akouno95', 'jg14g', 'g1815081', 'kawasrino', 'tecyartha10', 'kick.n.bio1998', 'g1815002', 'seiga', 'sake', 'yuichi0330', 'g1815083', 'tomoya223', 'hiroaki24']",4,"['twobow92', 'emi0502', 'shion', 'eeg1815003']",2,"[None, 'yutaro0605']",52,"['murasyu811', 'null1682', 'aaaa1111', 'ryusuketoda', 'rena0912', 'fujii3', 'hurezemitcu346', 'abcd0603sk', 'ayaka', 'soccerlove.0404', 'masakiyamucha', 'kentaro.nakamura', 'akikusa', 'jungwoo219', 'g1815086tcu', 'account01', 'g1815026', 'eeg1815003', 'narycan', 'akouno95', 'jg14g', 'yutaro0605', 'g1815002', 'kyoppei0516', 'shota5963', 'koma2039', 'eito', 'momoe14', 'emi0502', 'akayagi1227', 'twobow92', 'g1815059', 'kawa1', 'ken22', 'higuchiyuta', 'ryobucchi21', 'satosatoryo', 'denkidenshi', 'agata0723', 'ohnobaske1515', 'shion', None, 'g1815081', 'kawasrino', 'tecyartha10', 'kick.n.bio1998', 'sake', 'seiga', 'yuichi0330', 'g1815083', 'tomoya223', 'hiroaki24']"
19,402,51,48,46,"['murasyu811', 'null1682', 'kyoppei0516', 'shota5963', 'aaaa1111', 'ryusuketoda', 'koma2039', 'rena0912', 'fujii3', 'hurezemitcu346', 'abcd0603sk', 'eito', 'soccerlove.0404', 'ayaka', 'masakiyamucha', 'kentaro.nakamura', 'akikusa', 'jungwoo219', 'momoe14', 'g1815086tcu', 'akayagi1227', 'twobow92', 'account01', 'g1815059', 'kawa1', 'higuchiyuta', 'ryobucchi21', 'satosatoryo', 'denkidenshi', 'agata0723', 'ohnobaske1515', 'g1815026', 'eeg1815003', 'narycan', 'akouno95', 'jg14g', 'g1815081', 'kawasrino', 'tecyartha10', 'kick.n.bio1998', 'seiga', 'sake', 'yuichi0330', 'g1815083', 'tomoya223', 'hiroaki24']",4,"['g1815002', 'ken22', 'emi0502', 'shion']",2,"[None, 'yutaro0605']",52,"['murasyu811', 'null1682', 'aaaa1111', 'ryusuketoda', 'rena0912', 'fujii3', 'hurezemitcu346', 'abcd0603sk', 'ayaka', 'soccerlove.0404', 'masakiyamucha', 'kentaro.nakamura', 'akikusa', 'jungwoo219', 'g1815086tcu', 'account01', 'g1815026', 'eeg1815003', 'narycan', 'akouno95', 'jg14g', 'yutaro0605', 'g1815002', 'kyoppei0516', 'shota5963', 'koma2039', 'eito', 'momoe14', 'emi0502', 'akayagi1227', 'twobow92', 'g1815059', 'kawa1', 'ken22', 'higuchiyuta', 'ryobucchi21', 'satosatoryo', 'denkidenshi', 'agata0723', 'ohnobaske1515', 'shion', None, 'g1815081', 'kawasrino', 'tecyartha10', 'kick.n.bio1998', 'sake', 'seiga', 'yuichi0330', 'g1815083', 'tomoya223', 'hiroaki24']"
19,411,51,48,46,"['murasyu811', 'null1682', 'kyoppei0516', 'shota5963', 'aaaa1111', 'ryusuketoda', 'koma2039', 'rena0912', 'hurezemitcu346', 'abcd0603sk', 'eito', 'soccerlove.0404', 'ayaka', 'masakiyamucha', 'kentaro.nakamura', 'jungwoo219', 'momoe14', 'g1815086tcu', 'akayagi1227', 'twobow92', 'account01', 'g1815059', 'kawa1', 'ken22', 'higuchiyuta', 'ryobucchi21', 'satosatoryo', 'denkidenshi', 'agata0723', 'ohnobaske1515', 'g1815026', 'eeg1815003', 'narycan', 'akouno95', 'jg14g', 'g1815081', 'kawasrino', 'tecyartha10', 'kick.n.bio1998', 'g1815002', 'seiga', 'sake', 'yuichi0330', 'g1815083', 'tomoya223', 'hiroaki24']",4,"['fujii3', 'emi0502', 'akikusa', 'shion']",2,"['tanakeru', None]",52,"['murasyu811', 'null1682', 'aaaa1111', 'ryusuketoda', 'rena0912', 'fujii3', 'hurezemitcu346', 'abcd0603sk', 'ayaka', 'soccerlove.0404', 'masakiyamucha', 'kentaro.nakamura', 'akikusa', 'jungwoo219', 'g1815086tcu', 'account01', 'g1815026', 'eeg1815003', 'narycan', 'akouno95', 'jg14g', 'g1815002', 'kyoppei0516', 'shota5963', 'koma2039', 'eito', 'momoe14', 'emi0502', 'akayagi1227', 'twobow92', 'g1815059', 'kawa1', 'ken22', 'higuchiyuta', 'ryobucchi21', 'satosatoryo', 'denkidenshi', 'agata0723', 'ohnobaske1515', 'shion', 'tanakeru', None, 'g1815081', 'kawasrino', 'tecyartha10', 'kick.n.bio1998', 'sake', 'seiga', 'yuichi0330', 'g1815083', 'tomoya223', 'hiroaki24']"
20,232,47,7,3,"['zuoanwuwu', 'mnagara', 'yloaizal']",43,"['li3261', 'ruchika_mahajan', 'sergiodegioia', 'tangli666', 'tjczec01', 'huyaoqiao', 'darrenwen2013', 'twagner697', 'majomcandiani', 'jorgeabelaramburo', 'leo782', 'aniruddha.dive', 'yevgenmel', 'ffasulo', 'sushree', 'menghaoyoung', 'jskryza', 'mzhuang', 'luqman.saleem', 'garora92', 'mateusz.najsztub', 'ecolinam', 'subhajit123', 'sohyun929', 'jinsong4', 'abhijithananthan', 'plasmallan', 'kbschmid', 'usman0311', 'ilknur.icke', 'suman.kumari', 'tmamani', 'danie110', 'apokhrel', 'trost', 'kavyamendu', 'starkekr.ks', 'mneup001', 'arellano82', 'nh_turja', 'mostafa2020', 'markleightonfisher', 'jgeiger']",4,"['bmahaja', None, '3ksnn64', 'saad2']",50,"['li3261', 'mnagara', 'zuoanwuwu', 'ruchika_mahajan', 'sergiodegioia', 'tangli666', 'tjczec01', 'huyaoqiao', 'darrenwen2013', 'twagner697', 'majomcandiani', 'jorgeabelaramburo', 'leo782', 'aniruddha.dive', 'yevgenmel', 'ffasulo', 'sushree', 'yloaizal', 'menghaoyoung', 'saad2', 'jskryza', 'mzhuang', 'luqman.saleem', 'garora92', 'mateusz.najsztub', 'ecolinam', 'subhajit123', 'sohyun929', 'jinsong4', 'abhijithananthan', 'plasmallan', 'kbschmid', 'usman0311', 'ilknur.icke', 'suman.kumari', 'tmamani', 'bmahaja', 'danie110', 'apokhrel', None, 'trost', 'kavyamendu', 'starkekr.ks', 'mneup001', 'arellano82', 'nh_turja', 'mostafa2020', '3ksnn64', 'markleightonfisher', 'jgeiger']"
21,154,45,22,21,"['lidialacal', 'e.carlosperzruiz', 'sakuripet', 'narg', 'e.aromerosoriano', 'e.martavilchezs', 'icarter', 'r4ulgr', 'srdguezb', 'alvaromaz1997', 'juanan', 'ingcarlosperzruiz', 'carlos_electronicengineer97', 'di.pol.riera', 'jorge.ramirez', 'pablori97', 'houeix', 'fabiohenao', 'pacoviar98', 'mathwalt', 'raulromeromad']",23,"['anganasjc', 'joyshreekonwar23', 'divyanshushah66', 'priyanshugupta806', 'maulinraval.mech', 'drewjpurchase', 'conan.dewitt', 'vaibhavbingale', 'martavilchezs', 'gabrielbarrionuevovasco', 'admolina', 'harshc2018', 'jaimelt', 'bjndrasharma81', 'brijeshdrummer', 'carloslanzas', 'jitendraparmar1918', 'toshit_kumar', 'ilakulkarni0', 'amitprakash30', 'grollono', 'jkrieger', 'ranjuk1808']",1,[None],45,"['lidialacal', 'e.carlosperzruiz', 'sakuripet', 'narg', 'e.aromerosoriano', 'anganasjc', 'joyshreekonwar23', 'e.martavilchezs', 'divyanshushah66', 'icarter', 'srdguezb', 'r4ulgr', 'priyanshugupta806', 'maulinraval.mech', 'drewjpurchase', 'alvaromaz1997', 'conan.dewitt', 'vaibhavbingale', 'martavilchezs', 'gabrielbarrionuevovasco', 'admolina', 'harshc2018', 'juanan', 'jaimelt', 'bjndrasharma81', 'ingcarlosperzruiz', 'carlos_electronicengineer97', 'di.pol.riera', 'jorge.ramirez', 'pablori97', None, 'brijeshdrummer', 'houeix', 'carloslanzas', 'jitendraparmar1918', 'toshit_kumar', 'ilakulkarni0', 'pacoviar98', 'amitprakash30', 'fabiohenao', 'grollono', 'mathwalt', 'jkrieger', 'ranjuk1808', 'raulromeromad']"
21,155,45,15,14,"['houeix', 'alvaromaz1997', 'e.aromerosoriano', 'martavilchezs', 'gabrielbarrionuevovasco', 'e.carlosperzruiz', 'e.martavilchezs', 'juanan', 'jaimelt', 'r4ulgr', 'grollono', 'ingcarlosperzruiz', 'raulromeromad', 'pablori97']",30,"['lidialacal', 'sakuripet', 'narg', 'anganasjc', 'joyshreekonwar23', 'divyanshushah66', 'icarter', 'srdguezb', 'priyanshugupta806', 'maulinraval.mech', 'drewjpurchase', 'conan.dewitt', 'vaibhavbingale', 'harshc2018', 'admolina', 'bjndrasharma81', 'carlos_electronicengineer97', 'di.pol.riera', 'jorge.ramirez', 'brijeshdrummer', 'carloslanzas', 'jitendraparmar1918', 'toshit_kumar', 'ilakulkarni0', 'pacoviar98', 'amitprakash30', 'fabiohenao', 'mathwalt', 'jkrieger', 'ranjuk1808']",1,[None],45,"['lidialacal', 'e.carlosperzruiz', 'sakuripet', 'narg', 'e.aromerosoriano', 'anganasjc', 'joyshreekonwar23', 'e.martavilchezs', 'divyanshushah66', 'icarter', 'srdguezb', 'r4ulgr', 'priyanshugupta806', 'maulinraval.mech', 'drewjpurchase', 'alvaromaz1997', 'conan.dewitt', 'vaibhavbingale', 'martavilchezs', 'gabrielbarrionuevovasco', 'admolina', 'harshc2018', 'juanan', 'jaimelt', 'bjndrasharma81', 'ingcarlosperzruiz', 'carlos_electronicengineer97', 'di.pol.riera', 'jorge.ramirez', 'pablori97', None, 'brijeshdrummer', 'houeix', 'carloslanzas', 'jitendraparmar1918', 'toshit_kumar', 'ilakulkarni0', 'pacoviar98', 'amitprakash30', 'fabiohenao', 'grollono', 'mathwalt', 'jkrieger', 'ranjuk1808', 'raulromeromad']"
21,153,45,7,6,"['admolina', 'fabiohenao', 'juanan', 'r4ulgr', 'ingcarlosperzruiz', 'pablori97']",38,"['lidialacal', 'e.carlosperzruiz', 'sakuripet', 'narg', 'e.aromerosoriano', 'anganasjc', 'joyshreekonwar23', 'e.martavilchezs', 'divyanshushah66', 'icarter', 'srdguezb', 'priyanshugupta806', 'maulinraval.mech', 'drewjpurchase', 'alvaromaz1997', 'conan.dewitt', 'vaibhavbingale', 'martavilchezs', 'gabrielbarrionuevovasco', 'harshc2018', 'jaimelt', 'bjndrasharma81', 'carlos_electronicengineer97', 'di.pol.riera', 'jorge.ramirez', 'brijeshdrummer', 'houeix', 'carloslanzas', 'jitendraparmar1918', 'toshit_kumar', 'ilakulkarni0', 'pacoviar98', 'amitprakash30', 'grollono', 'mathwalt', 'jkrieger', 'ranjuk1808', 'raulromeromad']",1,[None],45,"['lidialacal', 'e.carlosperzruiz', 'sakuripet', 'narg', 'e.aromerosoriano', 'anganasjc', 'joyshreekonwar23', 'e.martavilchezs', 'divyanshushah66', 'icarter', 'srdguezb', 'r4ulgr', 'priyanshugupta806', 'maulinraval.mech', 'drewjpurchase', 'alvaromaz1997', 'conan.dewitt', 'vaibhavbingale', 'martavilchezs', 'gabrielbarrionuevovasco', 'admolina', 'harshc2018', 'juanan', 'jaimelt', 'bjndrasharma81', 'ingcarlosperzruiz', 'carlos_electronicengineer97', 'di.pol.riera', 'jorge.ramirez', 'pablori97', None, 'brijeshdrummer', 'houeix', 'carloslanzas', 'jitendraparmar1918', 'toshit_kumar', 'ilakulkarni0', 'pacoviar98', 'amitprakash30', 'fabiohenao', 'grollono', 'mathwalt', 'jkrieger', 'ranjuk1808', 'raulromeromad']"
22,540,44,16,14,"['antia.bote.chamorro', 'bea.lop456', 'carlosmr121314', 'borjafdez6', 'mfernandezsibon', 'marco17', 'borxa', 'taniagrandeg', 'claraaaaaaaaaaaaaaaaaaaaaaaaaa', 'davidpaz', 'veronica.rialdozo', 'gomezicia', 'olallanf', 'elenavl00']",29,"['vanesadeanromero', 'saraferlo1994', 'lukas', 'daniellyz1989', '4bpablocastro', 'wilkore', 'albacifuentes', 'ruth.gallego10', 'hq833038', 'tomyglezrivas1997', 'anaskaraga', '4b1adela', 'antoniorp', 'antorevelo29', 'anbotanavazquez234', 'charlineradola', 'gwkim323', 'anda1800275', 'oihane', 'ttundy', 'lelaina218', 'ccmorenoro', 'rlaalstj1016', 'saraaf', 'paulaabeledo01', 'cristalfralleone', 'esaantia1996', 'jenibiotech', 'judithks']",2,"['paulaabeledo26', None]",45,"['vanesadeanromero', 'saraferlo1994', 'lukas', 'daniellyz1989', '4bpablocastro', 'borxa', 'wilkore', 'albacifuentes', 'ruth.gallego10', 'hq833038', 'tomyglezrivas1997', 'anaskaraga', '4b1adela', 'taniagrandeg', 'antoniorp', 'antorevelo29', 'gomezicia', 'anbotanavazquez234', 'charlineradola', 'gwkim323', 'paulaabeledo26', 'anda1800275', 'bea.lop456', 'oihane', 'carlosmr121314', 'borjafdez6', 'ttundy', 'lelaina218', 'veronica.rialdozo', 'ccmorenoro', None, 'rlaalstj1016', 'saraaf', 'antia.bote.chamorro', 'paulaabeledo01', 'cristalfralleone', 'esaantia1996', 'jenibiotech', 'mfernandezsibon', 'marco17', 'claraaaaaaaaaaaaaaaaaaaaaaaaaa', 'davidpaz', 'elenavl00', 'olallanf', 'judithks']"
22,541,44,10,9,"['tomyglezrivas1997', 'oihane', '4b1adela', 'cristalfralleone', 'esaantia1996', 'mfernandezsibon', 'antoniorp', 'veronica.rialdozo', 'anbotanavazquez234']",34,"['vanesadeanromero', 'saraferlo1994', 'lukas', 'daniellyz1989', '4bpablocastro', 'borxa', 'wilkore', 'albacifuentes', 'ruth.gallego10', 'hq833038', 'anaskaraga', 'taniagrandeg', 'antorevelo29', 'gomezicia', 'charlineradola', 'gwkim323', 'anda1800275', 'bea.lop456', 'carlosmr121314', 'borjafdez6', 'ttundy', 'lelaina218', 'ccmorenoro', 'rlaalstj1016', 'saraaf', 'antia.bote.chamorro', 'paulaabeledo01', 'jenibiotech', 'claraaaaaaaaaaaaaaaaaaaaaaaaaa', 'marco17', 'davidpaz', 'elenavl00', 'olallanf', 'judithks']",1,[None],44,"['vanesadeanromero', 'saraferlo1994', 'lukas', 'daniellyz1989', '4bpablocastro', 'borxa', 'wilkore', 'albacifuentes', 'ruth.gallego10', 'hq833038', 'tomyglezrivas1997', 'anaskaraga', '4b1adela', 'taniagrandeg', 'antoniorp', 'antorevelo29', 'gomezicia', 'anbotanavazquez234', 'charlineradola', 'gwkim323', 'anda1800275', 'bea.lop456', 'oihane', 'carlosmr121314', 'borjafdez6', 'ttundy', 'lelaina218', 'veronica.rialdozo', 'ccmorenoro', None, 'rlaalstj1016', 'saraaf', 'antia.bote.chamorro', 'paulaabeledo01', 'cristalfralleone', 'esaantia1996', 'jenibiotech', 'mfernandezsibon', 'marco17', 'claraaaaaaaaaaaaaaaaaaaaaaaaaa', 'davidpaz', 'elenavl00', 'olallanf', 'judithks']"
23,501,43,9,4,"['jlheller', 'kochenma', 'jxu2019', 'vporubsky']",38,"['kyungdaeko', 'nimaa', 'mahdijaber', 'bruno_pereira', 'fortouna.yannick974', 'luiscolon', 'kw97', 'antonellalr24', 'samuelbharti', 'nanyang0714', 'zhihaotao', 'eden.hornung', 'hungyiwu', 'jason.sinclair20', 'beatriz.diaz', 'georgeau', 'phil.luthert', 'restel', 'al.rizzo90', 'gjfelix2005', 'tiam.heydari', 'reallylilly', 'kmyers2', 'jgreene', 'poorani.bcbb', 'david.w.ray', 'edelmira.valero', 'lagger.cyril', 'cwelsh2', 'ald23', 'duncahm', 'kyan', 'gp2e18', 'ssafdar1', 'ishujain4695', 'madisonyoung', 'debashish.roy', 'annamartb']",5,"[None, 'hsauro', 'lpsmith', 'huiyuanyang', 'bochenma']",47,"['kyungdaeko', 'nimaa', 'mahdijaber', 'kochenma', 'bruno_pereira', 'jxu2019', 'fortouna.yannick974', 'luiscolon', 'kw97', 'antonellalr24', 'jlheller', 'samuelbharti', 'nanyang0714', 'huiyuanyang', 'zhihaotao', 'bochenma', 'eden.hornung', 'hungyiwu', 'jason.sinclair20', 'beatriz.diaz', 'georgeau', 'phil.luthert', 'restel', 'al.rizzo90', 'gjfelix2005', 'tiam.heydari', 'reallylilly', 'hsauro', 'kmyers2', 'jgreene', 'poorani.bcbb', 'david.w.ray', 'edelmira.valero', 'lagger.cyril', 'cwelsh2', 'ald23', None, 'duncahm', 'kyan', 'gp2e18', 'ssafdar1', 'ishujain4695', 'madisonyoung', 'debashish.roy', 'vporubsky', 'lpsmith', 'annamartb']"
23,503,43,7,3,"['madisonyoung', 'poorani.bcbb', 'jason.sinclair20']",39,"['kyungdaeko', 'nimaa', 'mahdijaber', 'kochenma', 'bruno_pereira', 'jxu2019', 'fortouna.yannick974', 'luiscolon', 'kw97', 'antonellalr24', 'jlheller', 'samuelbharti', 'nanyang0714', 'zhihaotao', 'eden.hornung', 'hungyiwu', 'beatriz.diaz', 'georgeau', 'phil.luthert', 'restel', 'al.rizzo90', 'gjfelix2005', 'tiam.heydari', 'reallylilly', 'kmyers2', 'jgreene', 'david.w.ray', 'edelmira.valero', 'lagger.cyril', 'cwelsh2', 'ald23', 'duncahm', 'kyan', 'gp2e18', 'ssafdar1', 'ishujain4695', 'debashish.roy', 'vporubsky', 'annamartb']",4,"['jlacsina', 'abchitnis', None, 'ratnadeep.mukherjee']",46,"['kyungdaeko', 'ratnadeep.mukherjee', 'nimaa', 'mahdijaber', 'kochenma', 'bruno_pereira', 'jxu2019', 'fortouna.yannick974', 'luiscolon', 'kw97', 'antonellalr24', 'jlheller', 'samuelbharti', 'nanyang0714', 'zhihaotao', 'eden.hornung', 'hungyiwu', 'jason.sinclair20', 'beatriz.diaz', 'georgeau', 'phil.luthert', 'restel', 'al.rizzo90', 'gjfelix2005', 'tiam.heydari', 'reallylilly', 'kmyers2', 'jgreene', 'poorani.bcbb', 'david.w.ray', 'edelmira.valero', 'lagger.cyril', 'cwelsh2', 'ald23', None, 'duncahm', 'kyan', 'jlacsina', 'gp2e18', 'ssafdar1', 'abchitnis', 'ishujain4695', 'madisonyoung', 'debashish.roy', 'vporubsky', 'annamartb']"
23,502,43,6,1,['kw97'],41,"['kyungdaeko', 'nimaa', 'mahdijaber', 'kochenma', 'bruno_pereira', 'jxu2019', 'fortouna.yannick974', 'luiscolon', 'antonellalr24', 'jlheller', 'samuelbharti', 'nanyang0714', 'zhihaotao', 'eden.hornung', 'hungyiwu', 'jason.sinclair20', 'beatriz.diaz', 'georgeau', 'phil.luthert', 'restel', 'al.rizzo90', 'gjfelix2005', 'tiam.heydari', 'reallylilly', 'kmyers2', 'jgreene', 'poorani.bcbb', 'david.w.ray', 'edelmira.valero', 'lagger.cyril', 'cwelsh2', 'ald23', 'duncahm', 'kyan', 'gp2e18', 'ssafdar1', 'ishujain4695', 'madisonyoung', 'debashish.roy', 'vporubsky', 'annamartb']",5,"['joaponte', 'andysomogyi', 'glazier', 'joelvanin', None]",47,"['kyungdaeko', 'nimaa', 'mahdijaber', 'kochenma', 'bruno_pereira', 'jxu2019', 'fortouna.yannick974', 'luiscolon', 'kw97', 'antonellalr24', 'jlheller', 'samuelbharti', 'nanyang0714', 'zhihaotao', 'eden.hornung', 'hungyiwu', 'jason.sinclair20', 'beatriz.diaz', 'georgeau', 'phil.luthert', 'restel', 'al.rizzo90', 'gjfelix2005', 'joelvanin', 'tiam.heydari', 'joaponte', 'andysomogyi', 'reallylilly', 'kmyers2', 'jgreene', 'poorani.bcbb', 'david.w.ray', 'edelmira.valero', 'glazier', 'lagger.cyril', 'cwelsh2', 'ald23', None, 'duncahm', 'kyan', 'gp2e18', 'ssafdar1', 'ishujain4695', 'madisonyoung', 'debashish.roy', 'vporubsky', 'annamartb']"
23,504,43,6,1,['kw97'],41,"['kyungdaeko', 'nimaa', 'mahdijaber', 'kochenma', 'bruno_pereira', 'jxu2019', 'fortouna.yannick974', 'luiscolon', 'antonellalr24', 'jlheller', 'samuelbharti', 'nanyang0714', 'zhihaotao', 'eden.hornung', 'hungyiwu', 'jason.sinclair20', 'beatriz.diaz', 'georgeau', 'phil.luthert', 'restel', 'al.rizzo90', 'gjfelix2005', 'tiam.heydari', 'reallylilly', 'kmyers2', 'jgreene', 'poorani.bcbb', 'david.w.ray', 'edelmira.valero', 'lagger.cyril', 'cwelsh2', 'ald23', 'duncahm', 'kyan', 'gp2e18', 'ssafdar1', 'ishujain4695', 'madisonyoung', 'debashish.roy', 'vporubsky', 'annamartb']",5,"['joaponte', 'andysomogyi', 'glazier', 'joelvanin', None]",47,"['kyungdaeko', 'nimaa', 'mahdijaber', 'kochenma', 'bruno_pereira', 'jxu2019', 'fortouna.yannick974', 'luiscolon', 'kw97', 'antonellalr24', 'jlheller', 'samuelbharti', 'nanyang0714', 'zhihaotao', 'eden.hornung', 'hungyiwu', 'jason.sinclair20', 'beatriz.diaz', 'georgeau', 'phil.luthert', 'restel', 'al.rizzo90', 'gjfelix2005', 'joelvanin', 'tiam.heydari', 'joaponte', 'andysomogyi', 'reallylilly', 'kmyers2', 'jgreene', 'poorani.bcbb', 'david.w.ray', 'edelmira.valero', 'glazier', 'lagger.cyril', 'cwelsh2', 'ald23', None, 'duncahm', 'kyan', 'gp2e18', 'ssafdar1', 'ishujain4695', 'madisonyoung', 'debashish.roy', 'vporubsky', 'annamartb']"
24,66,42,28,26,"['ldalcomune', 'jciorciari', 'dunyea.grant', 'riseley', 'alfredosardinas', 'xspathari', 'chasef07', 'ryan.erickson', 'davisrash', 'melhr', 'jack.mcfarlane', 'dmiles1', 'roxetteg', 'rpatel2', 'sophid7', 'nataliefranklin', 'akiagabb', 'david.garcia', 'abdulquadriabiru', 'aplummer', 'jerryzhang', 'corby.bertolett', 'dfg99', 'jthompson1', 'ryan.holzhausen', 'snijumudheen']",15,"['hbock', 'bayleemfoster', 'cdkuchera', 'danpc3', 'khangle', 'karimnihal', 'stephen.thomas', 'pniraula', 'bhat.yashasvi', 'a.greco', 'tristanoshea888', 'thomastymecki', 'zsoviero', 'a.salinas', 'lichen444']",2,"['akiagabbidon', None]",43,"['ldalcomune', 'jciorciari', 'bayleemfoster', 'dunyea.grant', 'a.greco', 'tristanoshea888', 'riseley', 'alfredosardinas', 'xspathari', 'a.salinas', 'chasef07', 'ryan.erickson', 'davisrash', 'cdkuchera', 'melhr', 'khangle', 'karimnihal', 'jack.mcfarlane', 'roxetteg', 'dmiles1', 'rpatel2', 'lichen444', 'sophid7', 'nataliefranklin', 'akiagabb', 'david.garcia', 'hbock', 'stephen.thomas', 'pniraula', 'thomastymecki', 'abdulquadriabiru', 'aplummer', 'corby.bertolett', 'jerryzhang', None, 'dfg99', 'danpc3', 'bhat.yashasvi', 'akiagabbidon', 'jthompson1', 'ryan.holzhausen', 'snijumudheen', 'zsoviero']"
24,241,42,26,25,"['ldalcomune', 'jciorciari', 'dunyea.grant', 'riseley', 'alfredosardinas', 'chasef07', 'ryan.erickson', 'davisrash', 'melhr', 'jack.mcfarlane', 'dmiles1', 'roxetteg', 'rpatel2', 'nataliefranklin', 'sophid7', 'akiagabb', 'david.garcia', 'abdulquadriabiru', 'aplummer', 'jerryzhang', 'corby.bertolett', 'danpc3', 'jthompson1', 'ryan.holzhausen', 'snijumudheen']",16,"['hbock', 'bayleemfoster', 'cdkuchera', 'dfg99', 'khangle', 'karimnihal', 'stephen.thomas', 'pniraula', 'bhat.yashasvi', 'a.greco', 'tristanoshea888', 'thomastymecki', 'zsoviero', 'xspathari', 'a.salinas', 'lichen444']",1,[None],42,"['ldalcomune', 'jciorciari', 'bayleemfoster', 'dunyea.grant', 'a.greco', 'tristanoshea888', 'riseley', 'alfredosardinas', 'xspathari', 'a.salinas', 'chasef07', 'ryan.erickson', 'davisrash', 'cdkuchera', 'melhr', 'khangle', 'karimnihal', 'jack.mcfarlane', 'roxetteg', 'dmiles1', 'rpatel2', 'lichen444', 'sophid7', 'nataliefranklin', 'akiagabb', 'david.garcia', 'hbock', 'stephen.thomas', 'pniraula', 'thomastymecki', 'abdulquadriabiru', 'aplummer', 'corby.bertolett', 'jerryzhang', None, 'dfg99', 'danpc3', 'bhat.yashasvi', 'jthompson1', 'ryan.holzhausen', 'snijumudheen', 'zsoviero']"
24,406,42,25,24,"['ldalcomune', 'jciorciari', 'dunyea.grant', 'riseley', 'alfredosardinas', 'xspathari', 'chasef07', 'ryan.erickson', 'davisrash', 'melhr', 'jack.mcfarlane', 'dmiles1', 'roxetteg', 'rpatel2', 'nataliefranklin', 'akiagabb', 'david.garcia', 'abdulquadriabiru', 'aplummer', 'jerryzhang', 'corby.bertolett', 'jthompson1', 'ryan.holzhausen', 'snijumudheen']",17,"['sophid7', 'hbock', 'bayleemfoster', 'cdkuchera', 'dfg99', 'khangle', 'karimnihal', 'stephen.thomas', 'pniraula', 'danpc3', 'bhat.yashasvi', 'a.greco', 'tristanoshea888', 'thomastymecki', 'zsoviero', 'a.salinas', 'lichen444']",1,[None],42,"['ldalcomune', 'jciorciari', 'bayleemfoster', 'dunyea.grant', 'a.greco', 'tristanoshea888', 'riseley', 'alfredosardinas', 'xspathari', 'a.salinas', 'chasef07', 'ryan.erickson', 'davisrash', 'cdkuchera', 'melhr', 'khangle', 'karimnihal', 'jack.mcfarlane', 'roxetteg', 'dmiles1', 'rpatel2', 'lichen444', 'sophid7', 'nataliefranklin', 'akiagabb', 'david.garcia', 'hbock', 'stephen.thomas', 'pniraula', 'thomastymecki', 'abdulquadriabiru', 'aplummer', 'corby.bertolett', 'jerryzhang', None, 'dfg99', 'danpc3', 'bhat.yashasvi', 'jthompson1', 'ryan.holzhausen', 'snijumudheen', 'zsoviero']"
24,491,42,13,1,['davisrash'],40,"['ldalcomune', 'jciorciari', 'bayleemfoster', 'dunyea.grant', 'a.greco', 'tristanoshea888', 'riseley', 'alfredosardinas', 'xspathari', 'a.salinas', 'chasef07', 'ryan.erickson', 'cdkuchera', 'melhr', 'khangle', 'karimnihal', 'jack.mcfarlane', 'roxetteg', 'dmiles1', 'rpatel2', 'lichen444', 'sophid7', 'nataliefranklin', 'akiagabb', 'david.garcia', 'hbock', 'stephen.thomas', 'pniraula', 'thomastymecki', 'abdulquadriabiru', 'aplummer', 'corby.bertolett', 'jerryzhang', 'dfg99', 'danpc3', 'bhat.yashasvi', 'jthompson1', 'ryan.holzhausen', 'snijumudheen', 'zsoviero']",12,"['sferekides', 'yangning8109', 'fatmonk996', 'gfcortes', 'zihuanteng', 'drewth1', 'daniel.olis', 'fzwake', 'cadema', 'splocker', None, 'benjamin.gorman']",53,"['ldalcomune', 'sferekides', 'jciorciari', 'bayleemfoster', 'zihuanteng', 'dunyea.grant', 'a.greco', 'tristanoshea888', 'daniel.olis', 'riseley', 'alfredosardinas', 'xspathari', 'a.salinas', 'chasef07', 'fatmonk996', 'ryan.erickson', 'davisrash', 'cdkuchera', 'gfcortes', 'melhr', 'khangle', 'karimnihal', 'jack.mcfarlane', 'roxetteg', 'dmiles1', 'rpatel2', 'lichen444', 'sophid7', 'nataliefranklin', 'akiagabb', 'david.garcia', 'hbock', 'stephen.thomas', 'pniraula', 'drewth1', 'thomastymecki', 'abdulquadriabiru', 'fzwake', 'aplummer', 'corby.bertolett', 'jerryzhang', 'cadema', None, 'yangning8109', 'dfg99', 'danpc3', 'bhat.yashasvi', 'jthompson1', 'ryan.holzhausen', 'snijumudheen', 'splocker', 'zsoviero', 'benjamin.gorman']"
24,407,42,9,8,"['bayleemfoster', 'danpc3', 'stephen.thomas', 'bhat.yashasvi', 'pniraula', 'a.greco', 'abdulquadriabiru', 'zsoviero']",33,"['ldalcomune', 'jciorciari', 'dunyea.grant', 'tristanoshea888', 'riseley', 'alfredosardinas', 'xspathari', 'a.salinas', 'chasef07', 'ryan.erickson', 'davisrash', 'cdkuchera', 'melhr', 'khangle', 'karimnihal', 'jack.mcfarlane', 'roxetteg', 'dmiles1', 'rpatel2', 'lichen444', 'sophid7', 'nataliefranklin', 'akiagabb', 'david.garcia', 'hbock', 'thomastymecki', 'aplummer', 'corby.bertolett', 'jerryzhang', 'dfg99', 'jthompson1', 'ryan.holzhausen', 'snijumudheen']",1,[None],42,"['ldalcomune', 'jciorciari', 'bayleemfoster', 'dunyea.grant', 'a.greco', 'tristanoshea888', 'riseley', 'alfredosardinas', 'xspathari', 'a.salinas', 'chasef07', 'ryan.erickson', 'davisrash', 'cdkuchera', 'melhr', 'khangle', 'karimnihal', 'jack.mcfarlane', 'roxetteg', 'dmiles1', 'rpatel2', 'lichen444', 'sophid7', 'nataliefranklin', 'akiagabb', 'david.garcia', 'hbock', 'stephen.thomas', 'pniraula', 'thomastymecki', 'abdulquadriabiru', 'aplummer', 'corby.bertolett', 'jerryzhang', None, 'dfg99', 'danpc3', 'bhat.yashasvi', 'jthompson1', 'ryan.holzhausen', 'snijumudheen', 'zsoviero']"
24,67,42,7,6,"['bayleemfoster', 'stephen.thomas', 'bhat.yashasvi', 'pniraula', 'a.greco', 'zsoviero']",35,"['ldalcomune', 'jciorciari', 'dunyea.grant', 'tristanoshea888', 'riseley', 'alfredosardinas', 'xspathari', 'a.salinas', 'chasef07', 'ryan.erickson', 'davisrash', 'cdkuchera', 'melhr', 'khangle', 'karimnihal', 'jack.mcfarlane', 'roxetteg', 'dmiles1', 'rpatel2', 'lichen444', 'sophid7', 'nataliefranklin', 'akiagabb', 'david.garcia', 'hbock', 'thomastymecki', 'abdulquadriabiru', 'aplummer', 'corby.bertolett', 'jerryzhang', 'dfg99', 'danpc3', 'jthompson1', 'ryan.holzhausen', 'snijumudheen']",1,[None],42,"['ldalcomune', 'jciorciari', 'bayleemfoster', 'dunyea.grant', 'a.greco', 'tristanoshea888', 'riseley', 'alfredosardinas', 'xspathari', 'a.salinas', 'chasef07', 'ryan.erickson', 'davisrash', 'cdkuchera', 'melhr', 'khangle', 'karimnihal', 'jack.mcfarlane', 'roxetteg', 'dmiles1', 'rpatel2', 'lichen444', 'sophid7', 'nataliefranklin', 'akiagabb', 'david.garcia', 'hbock', 'stephen.thomas', 'pniraula', 'thomastymecki', 'abdulquadriabiru', 'aplummer', 'corby.bertolett', 'jerryzhang', None, 'dfg99', 'danpc3', 'bhat.yashasvi', 'jthompson1', 'ryan.holzhausen', 'snijumudheen', 'zsoviero']"
25,328,39,33,32,"['ew2fv', 'jeb5gr', 'lcs5ta', 'cr6ye', 'ak9za', 'dm8ca', 'ba9mm', 'rainamourad', 'zg8hc', 'nid5xq', 'azh5kn', 'sei3hk', 'wpb4bp', 'bph6n', 'lh4aw', 'sck3yy', 'emd8xm', 'mic5jy', 'sg2dk', 'sf2nc', 'hln7cc', 'cmp4nd', 'aad9nt', 'mtl5xd', 'egw6vx', 'reidpowell98', 'medhinir', 'sg2hf', 'ep2au', 'ttl7px', 'eeb7kw', 'jgs8wh']",6,"['ara5cf', 'aap4dg', 'ss9wa', 'crl3ar', 'pcc6vb', 'src3dh']",1,[None],39,"['ew2fv', 'aap4dg', 'jeb5gr', 'lcs5ta', 'cr6ye', 'ak9za', 'dm8ca', 'pcc6vb', 'rainamourad', 'ba9mm', 'ara5cf', 'zg8hc', 'nid5xq', 'azh5kn', 'sei3hk', 'bph6n', 'wpb4bp', 'lh4aw', 'crl3ar', 'sck3yy', 'emd8xm', 'mic5jy', 'sg2dk', 'sf2nc', 'hln7cc', 'cmp4nd', 'aad9nt', 'mtl5xd', None, 'egw6vx', 'reidpowell98', 'sg2hf', 'medhinir', 'ep2au', 'ttl7px', 'ss9wa', 'eeb7kw', 'jgs8wh', 'src3dh']"
26,87,39,26,20,"['caldwe29', 'nmcphero', 'kohn2', 'jrohman', 'carr71', 'snobbe', 'starr21', 'sachdev0', 'hopem', 'ababiukm', 'tlichti', 'kboateng', 'owellbor', 'pmort', 'jkphero', 'mthoenen', 'harmon55', 'apapay', 'kelly238', 'mbalog']",18,"['comchem', 'gmclaugh', 'park710', 'nafandi', 'weiss58', 'ray19970727', 'smit3180', 'tthieles', 'afiaqamar', 'conrad43', 'kjacobi', '98triathlete', 'chen2515', 'niemannj', 'cnotting', 'bkeunek', 'dwething', 'iwoodhou']",6,"['bmckenz', 'iczajkow', 'adams386', 'tgoldbe', 'hschroad', None]",44,"['bmckenz', 'gmclaugh', 'caldwe29', 'nmcphero', 'nafandi', 'ray19970727', 'kohn2', 'jrohman', 'carr71', 'bkeunek', 'dwething', 'snobbe', 'starr21', 'sachdev0', 'hopem', 'ababiukm', 'iczajkow', 'kboateng', 'tlichti', 'weiss58', 'smit3180', 'kjacobi', 'owellbor', 'niemannj', 'pmort', 'cnotting', 'iwoodhou', 'jkphero', 'comchem', 'tthieles', 'afiaqamar', '98triathlete', 'mthoenen', 'harmon55', 'tgoldbe', 'hschroad', None, 'park710', 'apapay', 'conrad43', 'chen2515', 'adams386', 'kelly238', 'mbalog']"
26,88,39,14,12,"['gmclaugh', 'caldwe29', 'park710', 'weiss58', 'tthieles', 'conrad43', 'smit3180', 'kjacobi', 'niemannj', 'cnotting', 'dwething', 'iwoodhou']",26,"['nmcphero', 'nafandi', 'ray19970727', 'kohn2', 'jrohman', 'carr71', 'bkeunek', 'snobbe', 'starr21', 'sachdev0', 'ababiukm', 'kboateng', 'tlichti', 'owellbor', 'pmort', 'kelly238', 'jkphero', 'comchem', 'afiaqamar', '98triathlete', 'mthoenen', 'harmon55', 'apapay', 'chen2515', 'hopem', 'mbalog']",2,"['aguyre', None]",40,"['gmclaugh', 'caldwe29', 'nmcphero', 'nafandi', 'ray19970727', 'kohn2', 'jrohman', 'carr71', 'bkeunek', 'dwething', 'snobbe', 'starr21', 'sachdev0', 'hopem', 'ababiukm', 'kboateng', 'tlichti', 'weiss58', 'smit3180', 'kjacobi', 'owellbor', 'niemannj', 'pmort', 'cnotting', 'iwoodhou', 'jkphero', 'comchem', 'tthieles', 'afiaqamar', '98triathlete', 'aguyre', 'mthoenen', 'harmon55', None, 'park710', 'apapay', 'conrad43', 'chen2515', 'kelly238', 'mbalog']"
26,85,39,11,8,"['ababiukm', 'nmcphero', 'apapay', 'jrohman', '98triathlete', 'pmort', 'mthoenen', 'kelly238']",30,"['gmclaugh', 'caldwe29', 'nafandi', 'ray19970727', 'kohn2', 'carr71', 'bkeunek', 'dwething', 'snobbe', 'starr21', 'sachdev0', 'kboateng', 'tlichti', 'weiss58', 'smit3180', 'kjacobi', 'owellbor', 'niemannj', 'cnotting', 'iwoodhou', 'jkphero', 'comchem', 'tthieles', 'afiaqamar', 'harmon55', 'park710', 'conrad43', 'chen2515', 'hopem', 'mbalog']",3,"['adams386', None, 'hschroad']",41,"['gmclaugh', 'caldwe29', 'nmcphero', 'nafandi', 'ray19970727', 'kohn2', 'jrohman', 'carr71', 'bkeunek', 'dwething', 'snobbe', 'starr21', 'sachdev0', 'hopem', 'ababiukm', 'kboateng', 'tlichti', 'weiss58', 'smit3180', 'kjacobi', 'owellbor', 'niemannj', 'pmort', 'cnotting', 'iwoodhou', 'jkphero', 'comchem', 'tthieles', 'afiaqamar', '98triathlete', 'mthoenen', 'harmon55', 'hschroad', None, 'park710', 'apapay', 'conrad43', 'chen2515', 'adams386', 'kelly238', 'mbalog']"
26,86,39,7,5,"['gmclaugh', 'caldwe29', 'tthieles', 'conrad43', 'niemannj']",33,"['nmcphero', 'nafandi', 'ray19970727', 'kohn2', 'jrohman', 'carr71', 'bkeunek', 'dwething', 'snobbe', 'starr21', 'sachdev0', 'hopem', 'ababiukm', 'kboateng', 'tlichti', 'weiss58', 'smit3180', 'kjacobi', 'owellbor', 'pmort', 'cnotting', 'iwoodhou', 'jkphero', 'comchem', 'afiaqamar', '98triathlete', 'mthoenen', 'harmon55', 'park710', 'apapay', 'chen2515', 'kelly238', 'mbalog']",2,"['aguyre', None]",40,"['gmclaugh', 'caldwe29', 'nmcphero', 'nafandi', 'ray19970727', 'kohn2', 'jrohman', 'carr71', 'bkeunek', 'dwething', 'snobbe', 'starr21', 'sachdev0', 'hopem', 'ababiukm', 'kboateng', 'tlichti', 'weiss58', 'smit3180', 'kjacobi', 'owellbor', 'niemannj', 'pmort', 'cnotting', 'iwoodhou', 'jkphero', 'comchem', 'tthieles', 'afiaqamar', '98triathlete', 'aguyre', 'mthoenen', 'harmon55', None, 'park710', 'apapay', 'conrad43', 'chen2515', 'kelly238', 'mbalog']"
27,373,37,31,3,"['alex.oesterling', 'thomas.owens2000', 'nickchak21']",33,"['pncho7', 'ericqibamboo', 'madelyncecchini', 'simg48', 'anamees2018', 'sanikaggupte', 'mrosetai', 'ryan0129', 'akhufstetler', 'shreysambhwani', 'rdemma.andy', 'georgehong365', 'liavcueto', 'diegochll', 'xinyumzhang', 'gavro', 'lu.fogolin', 'pballentine', 'cayschuval', 'waterdragon2145', 'nanoschettewi', 'nonstopeve', 'jacknastas', 'tikagergaia', 'isabellak', 'jonsandoval229', 'fboamps', 'alexqxu', 'tavianjin', 'tendralsonofvend', 'mdensel2', 'kjwhite452', 'shufanwen0516']",28,"['johnkym', 'dhilanr', 'edr2126', 'cmc2374', 'sesh9366', 'bdn2113', 'gruneskrokodil', 'briannab', 'shuvob1', 'robikecs', 'ardagenc', 'rom2110', 'alasaif', 'mwm2166', 'jlanzoni18', 'vintila131', 'ckr.bits', None, 'kav68', 'jhh2197', 'mz2715', 'fraser_darling', 'julianlencina96', 'shdksl95', 'ttj2108', 'dra2137', 'tran_dang0709', '1jordanschwartz']",64,"['pncho7', 'johnkym', 'dhilanr', 'ericqibamboo', 'madelyncecchini', 'simg48', 'anamees2018', 'sanikaggupte', 'edr2126', 'cmc2374', 'mrosetai', 'sesh9366', 'bdn2113', 'gruneskrokodil', 'ryan0129', 'briannab', 'shuvob1', 'akhufstetler', 'shreysambhwani', 'robikecs', 'rdemma.andy', 'georgehong365', 'liavcueto', 'ardagenc', 'alex.oesterling', 'diegochll', 'xinyumzhang', 'gavro', 'lu.fogolin', 'rom2110', 'pballentine', 'cayschuval', 'waterdragon2145', 'nanoschettewi', 'nonstopeve', 'jacknastas', 'tikagergaia', 'isabellak', 'alasaif', 'mwm2166', 'jonsandoval229', 'nickchak21', 'jlanzoni18', 'vintila131', 'ckr.bits', 'fboamps', None, 'alexqxu', 'shufanwen0516', 'kav68', 'jhh2197', 'tavianjin', 'tendralsonofvend', 'mz2715', 'fraser_darling', 'julianlencina96', 'mdensel2', 'kjwhite452', 'shdksl95', 'ttj2108', 'dra2137', 'tran_dang0709', '1jordanschwartz', 'thomas.owens2000']"
27,280,37,24,18,"['cayschuval', 'shufanwen0516', 'tendralsonofvend', 'rdemma.andy', 'nonstopeve', 'tikagergaia', 'liavcueto', 'madelyncecchini', 'jacknastas', 'isabellak', 'alex.oesterling', 'diegochll', 'mdensel2', 'mrosetai', 'jonsandoval229', 'gavro', 'lu.fogolin', 'pballentine']",18,"['pncho7', 'shreysambhwani', 'waterdragon2145', 'nanoschettewi', 'ericqibamboo', 'tavianjin', 'georgehong365', 'simg48', 'anamees2018', 'sanikaggupte', 'kjwhite452', 'nickchak21', 'xinyumzhang', 'ryan0129', 'fboamps', 'thomas.owens2000', 'alexqxu', 'akhufstetler']",6,"['ece230sucks', 'nwilli43', 'papagameplayer', 'stdy3c8', 'ameer50', None]",42,"['pncho7', 'nwilli43', 'papagameplayer', 'ericqibamboo', 'madelyncecchini', 'simg48', 'anamees2018', 'sanikaggupte', 'mrosetai', 'ryan0129', 'akhufstetler', 'shreysambhwani', 'rdemma.andy', 'stdy3c8', 'georgehong365', 'liavcueto', 'alex.oesterling', 'diegochll', 'xinyumzhang', 'gavro', 'lu.fogolin', 'pballentine', 'cayschuval', 'waterdragon2145', 'nanoschettewi', 'nonstopeve', 'jacknastas', 'tikagergaia', 'isabellak', 'jonsandoval229', 'nickchak21', 'fboamps', None, 'alexqxu', 'shufanwen0516', 'ece230sucks', 'tavianjin', 'tendralsonofvend', 'ameer50', 'mdensel2', 'kjwhite452', 'thomas.owens2000']"
27,238,37,23,18,"['cayschuval', 'shufanwen0516', 'tendralsonofvend', 'rdemma.andy', 'nonstopeve', 'jacknastas', 'liavcueto', 'tikagergaia', 'isabellak', 'mdensel2', 'alex.oesterling', 'diegochll', 'mrosetai', 'jonsandoval229', 'gavro', 'lu.fogolin', 'pballentine', 'akhufstetler']",18,"['pncho7', 'shreysambhwani', 'waterdragon2145', 'nanoschettewi', 'ericqibamboo', 'tavianjin', 'madelyncecchini', 'simg48', 'anamees2018', 'sanikaggupte', 'georgehong365', 'kjwhite452', 'nickchak21', 'xinyumzhang', 'ryan0129', 'fboamps', 'thomas.owens2000', 'alexqxu']",5,"['ece230sucks', 'stdy3c8', 'cdcalahn', '1jordanschwartz', None]",41,"['pncho7', 'ericqibamboo', 'madelyncecchini', 'simg48', 'anamees2018', 'sanikaggupte', 'mrosetai', 'ryan0129', 'akhufstetler', 'shreysambhwani', 'rdemma.andy', 'stdy3c8', 'georgehong365', 'liavcueto', 'alex.oesterling', 'diegochll', 'xinyumzhang', 'gavro', 'lu.fogolin', 'pballentine', 'cayschuval', 'waterdragon2145', 'nanoschettewi', 'nonstopeve', 'jacknastas', 'tikagergaia', 'isabellak', 'jonsandoval229', 'nickchak21', 'cdcalahn', 'fboamps', None, 'alexqxu', 'shufanwen0516', 'ece230sucks', 'tavianjin', 'tendralsonofvend', 'mdensel2', 'kjwhite452', '1jordanschwartz', 'thomas.owens2000']"
27,240,37,23,19,"['mrosetai', 'akhufstetler', 'rdemma.andy', 'liavcueto', 'alex.oesterling', 'diegochll', 'xinyumzhang', 'gavro', 'lu.fogolin', 'pballentine', 'cayschuval', 'nonstopeve', 'jacknastas', 'tikagergaia', 'isabellak', 'jonsandoval229', 'tendralsonofvend', 'mdensel2', 'shufanwen0516']",17,"['pncho7', 'shreysambhwani', 'waterdragon2145', 'nanoschettewi', 'ericqibamboo', 'tavianjin', 'madelyncecchini', 'simg48', 'anamees2018', 'sanikaggupte', 'georgehong365', 'kjwhite452', 'nickchak21', 'ryan0129', 'fboamps', 'thomas.owens2000', 'alexqxu']",4,"['1jordanschwartz', None, 'cdcalahn', 'stdy3c8']",40,"['pncho7', 'ericqibamboo', 'madelyncecchini', 'simg48', 'anamees2018', 'sanikaggupte', 'mrosetai', 'ryan0129', 'akhufstetler', 'shreysambhwani', 'rdemma.andy', 'stdy3c8', 'georgehong365', 'liavcueto', 'alex.oesterling', 'diegochll', 'xinyumzhang', 'gavro', 'lu.fogolin', 'pballentine', 'cayschuval', 'waterdragon2145', 'nanoschettewi', 'nonstopeve', 'jacknastas', 'tikagergaia', 'isabellak', 'jonsandoval229', 'nickchak21', 'cdcalahn', 'fboamps', None, 'alexqxu', 'shufanwen0516', 'tavianjin', 'tendralsonofvend', 'mdensel2', 'kjwhite452', '1jordanschwartz', 'thomas.owens2000']"
27,374,37,23,17,"['cayschuval', 'shufanwen0516', 'nanoschettewi', 'rdemma.andy', 'nonstopeve', 'tikagergaia', 'liavcueto', 'jacknastas', 'isabellak', 'mdensel2', 'alex.oesterling', 'diegochll', 'mrosetai', 'jonsandoval229', 'gavro', 'lu.fogolin', 'tendralsonofvend']",19,"['pncho7', 'ericqibamboo', 'madelyncecchini', 'simg48', 'anamees2018', 'sanikaggupte', 'ryan0129', 'akhufstetler', 'shreysambhwani', 'georgehong365', 'xinyumzhang', 'pballentine', 'waterdragon2145', 'nickchak21', 'fboamps', 'alexqxu', 'tavianjin', 'kjwhite452', 'thomas.owens2000']",6,"['nwilli43', 'jaydoherty', 'cdcalahn', '1jordanschwartz', None, 'aarondfranklin']",42,"['pncho7', 'nwilli43', 'ericqibamboo', 'madelyncecchini', 'simg48', 'anamees2018', 'sanikaggupte', 'mrosetai', 'ryan0129', 'akhufstetler', 'shreysambhwani', 'rdemma.andy', 'georgehong365', 'liavcueto', 'alex.oesterling', 'diegochll', 'xinyumzhang', 'gavro', 'lu.fogolin', 'pballentine', 'cayschuval', 'waterdragon2145', 'nanoschettewi', 'nonstopeve', 'jacknastas', 'tikagergaia', 'isabellak', 'jaydoherty', 'jonsandoval229', 'nickchak21', 'cdcalahn', 'fboamps', None, 'alexqxu', 'shufanwen0516', 'tavianjin', 'tendralsonofvend', 'mdensel2', 'kjwhite452', '1jordanschwartz', 'thomas.owens2000', 'aarondfranklin']"
27,376,37,17,1,['alexqxu'],35,"['pncho7', 'ericqibamboo', 'madelyncecchini', 'simg48', 'anamees2018', 'sanikaggupte', 'mrosetai', 'ryan0129', 'akhufstetler', 'shreysambhwani', 'thomas.owens2000', 'rdemma.andy', 'georgehong365', 'liavcueto', 'alex.oesterling', 'diegochll', 'xinyumzhang', 'gavro', 'lu.fogolin', 'pballentine', 'cayschuval', 'waterdragon2145', 'nanoschettewi', 'nonstopeve', 'jacknastas', 'tikagergaia', 'isabellak', 'jonsandoval229', 'nickchak21', 'fboamps', 'tavianjin', 'tendralsonofvend', 'mdensel2', 'kjwhite452', 'shufanwen0516']",16,"['johnkym', 'qz2422', 'jhh2197', 'ak4291', 'omg29', 'gjb56', 'mkalra', 'rht2119', 'esg2167', 'mwm2166', 'zh2388', 'dra2137', 'rom2110', 'ch3401', None, 'briannab']",52,"['pncho7', 'johnkym', 'ericqibamboo', 'gjb56', 'madelyncecchini', 'simg48', 'anamees2018', 'sanikaggupte', 'mkalra', 'rht2119', 'mrosetai', 'ryan0129', 'briannab', 'akhufstetler', 'shreysambhwani', 'rdemma.andy', 'omg29', 'georgehong365', 'liavcueto', 'zh2388', 'alex.oesterling', 'diegochll', 'xinyumzhang', 'gavro', 'lu.fogolin', 'rom2110', 'pballentine', 'cayschuval', 'waterdragon2145', 'nanoschettewi', 'nonstopeve', 'jacknastas', 'tikagergaia', 'isabellak', 'esg2167', 'mwm2166', 'jonsandoval229', 'nickchak21', 'fboamps', None, 'alexqxu', 'shufanwen0516', 'jhh2197', 'qz2422', 'tavianjin', 'tendralsonofvend', 'ak4291', 'mdensel2', 'kjwhite452', 'dra2137', 'ch3401', 'thomas.owens2000']"
27,239,37,16,1,['alexqxu'],35,"['pncho7', 'ericqibamboo', 'madelyncecchini', 'simg48', 'anamees2018', 'sanikaggupte', 'mrosetai', 'ryan0129', 'akhufstetler', 'shreysambhwani', 'thomas.owens2000', 'rdemma.andy', 'georgehong365', 'liavcueto', 'alex.oesterling', 'diegochll', 'xinyumzhang', 'gavro', 'lu.fogolin', 'pballentine', 'cayschuval', 'waterdragon2145', 'nanoschettewi', 'nonstopeve', 'jacknastas', 'tikagergaia', 'isabellak', 'jonsandoval229', 'nickchak21', 'fboamps', 'tavianjin', 'tendralsonofvend', 'mdensel2', 'kjwhite452', 'shufanwen0516']",15,"['tsw2135', 'johnkym', 'qz2422', 'jhh2197', 'ak4291', 'mkalra', 'rht2119', 'esg2167', 'mwm2166', 'aio2118', 'rom2110', 'ch3401', 'bdn2113', None, 'briannab']",51,"['pncho7', 'johnkym', 'ericqibamboo', 'madelyncecchini', 'simg48', 'anamees2018', 'sanikaggupte', 'mkalra', 'rht2119', 'mrosetai', 'bdn2113', 'ryan0129', 'briannab', 'akhufstetler', 'tsw2135', 'shreysambhwani', 'rdemma.andy', 'georgehong365', 'liavcueto', 'alex.oesterling', 'diegochll', 'xinyumzhang', 'gavro', 'lu.fogolin', 'rom2110', 'pballentine', 'cayschuval', 'waterdragon2145', 'nanoschettewi', 'nonstopeve', 'jacknastas', 'tikagergaia', 'isabellak', 'esg2167', 'aio2118', 'mwm2166', 'jonsandoval229', 'nickchak21', 'fboamps', None, 'alexqxu', 'shufanwen0516', 'jhh2197', 'qz2422', 'tavianjin', 'tendralsonofvend', 'ak4291', 'mdensel2', 'kjwhite452', 'ch3401', 'thomas.owens2000']"
27,371,37,6,1,['pballentine'],35,"['pncho7', 'ericqibamboo', 'madelyncecchini', 'simg48', 'anamees2018', 'sanikaggupte', 'mrosetai', 'ryan0129', 'akhufstetler', 'shreysambhwani', 'rdemma.andy', 'georgehong365', 'liavcueto', 'alex.oesterling', 'diegochll', 'xinyumzhang', 'gavro', 'lu.fogolin', 'cayschuval', 'waterdragon2145', 'nanoschettewi', 'nonstopeve', 'jacknastas', 'tikagergaia', 'isabellak', 'jonsandoval229', 'nickchak21', 'fboamps', 'alexqxu', 'shufanwen0516', 'tavianjin', 'tendralsonofvend', 'mdensel2', 'kjwhite452', 'thomas.owens2000']",5,"['prof.alqulaiaa', 'qpzmal7024', 'natelson', 'hatem.babaa', None]",41,"['pncho7', 'prof.alqulaiaa', 'ericqibamboo', 'madelyncecchini', 'simg48', 'anamees2018', 'sanikaggupte', 'mrosetai', 'ryan0129', 'akhufstetler', 'shreysambhwani', 'rdemma.andy', 'georgehong365', 'liavcueto', 'alex.oesterling', 'diegochll', 'xinyumzhang', 'gavro', 'lu.fogolin', 'hatem.babaa', 'pballentine', 'cayschuval', 'waterdragon2145', 'nanoschettewi', 'qpzmal7024', 'nonstopeve', 'jacknastas', 'tikagergaia', 'isabellak', 'jonsandoval229', 'nickchak21', 'fboamps', None, 'alexqxu', 'shufanwen0516', 'tavianjin', 'tendralsonofvend', 'mdensel2', 'kjwhite452', 'natelson', 'thomas.owens2000']"
28,545,37,41,29,"['mohammad182', 'emiliochausse', 'genuinedavidb', 'hannahmartin', 'jamesknowltonsmith', 'jegiroua', 'jamesshannon', 'loganchai2', 'semajlchap', 'tracerbullet76', 'stonewburgan', 'ahbuchanan', 'isabelgamez22', 'jdoubt1', 'bkohlbush', 'alex18.cushing', 'anguskojimoto', 'alisonchomp', 'dkava', 'masongariepy', 'bdenicho', 'dgonz155', 'clarissa0223', 'ryltakayesu', 'thucmy', 'bolling1999', 'dreyes26', 'daisyk2000', 'ruiqq']",7,"['nkrog', 'kkuehn', 'gunnar90', 'j_seid', 'sudraco90', 'qsengstake', 'arashakhavi']",12,"['kevinibrhm7', 'emilyhaykoupian', 'jkamlet', 'eschlocker', 'robin94payne', 'kristinababayev', 'tfoo', 'coryschauer', 'bradsam', 'wmanampe', 'lautenba', None]",48,"['emiliochausse', 'hannahmartin', 'jamesknowltonsmith', 'jegiroua', 'wmanampe', 'sudraco90', 'semajlchap', 'stonewburgan', 'ahbuchanan', 'kevinibrhm7', 'kristinababayev', 'isabelgamez22', 'bkohlbush', 'alex18.cushing', 'anguskojimoto', 'alisonchomp', 'dkava', 'lautenba', 'bdenicho', 'dgonz155', 'nkrog', 'robin94payne', 'thucmy', 'bolling1999', 'bradsam', 'dreyes26', 'kkuehn', 'mohammad182', 'genuinedavidb', 'eschlocker', 'jamesshannon', 'gunnar90', 'j_seid', 'loganchai2', 'arashakhavi', 'tracerbullet76', 'emilyhaykoupian', 'jdoubt1', 'qsengstake', 'masongariepy', None, 'jkamlet', 'clarissa0223', 'ryltakayesu', 'tfoo', 'coryschauer', 'daisyk2000', 'ruiqq']"
28,287,37,39,29,"['mohammad182', 'emiliochausse', 'genuinedavidb', 'hannahmartin', 'jamesknowltonsmith', 'jegiroua', 'jamesshannon', 'sudraco90', 'loganchai2', 'semajlchap', 'tracerbullet76', 'stonewburgan', 'ahbuchanan', 'isabelgamez22', 'jdoubt1', 'bkohlbush', 'alex18.cushing', 'anguskojimoto', 'alisonchomp', 'dkava', 'masongariepy', 'bdenicho', 'dgonz155', 'clarissa0223', 'ryltakayesu', 'thucmy', 'dreyes26', 'daisyk2000', 'ruiqq']",7,"['nkrog', 'kkuehn', 'bolling1999', 'gunnar90', 'j_seid', 'qsengstake', 'arashakhavi']",10,"['jkamlet', 'eschlocker', 'bradsa4105', 'robin94payne', 'kristinababayev', 'tfoo', 'maxivonwelczeck', 'wmanampe', 'kbaylor', None]",46,"['bradsa4105', 'kkuehn', 'mohammad182', 'emiliochausse', 'genuinedavidb', 'hannahmartin', 'jamesknowltonsmith', 'eschlocker', 'jegiroua', 'jamesshannon', 'gunnar90', 'j_seid', 'maxivonwelczeck', 'wmanampe', 'sudraco90', 'loganchai2', 'arashakhavi', 'semajlchap', 'tracerbullet76', 'stonewburgan', 'ahbuchanan', 'kristinababayev', 'isabelgamez22', 'jdoubt1', 'bkohlbush', 'alex18.cushing', 'anguskojimoto', 'alisonchomp', 'dkava', 'kbaylor', 'qsengstake', 'masongariepy', 'bdenicho', None, 'dgonz155', 'nkrog', 'jkamlet', 'clarissa0223', 'robin94payne', 'ryltakayesu', 'thucmy', 'bolling1999', 'tfoo', 'dreyes26', 'daisyk2000', 'ruiqq']"
28,410,37,39,29,"['mohammad182', 'emiliochausse', 'genuinedavidb', 'hannahmartin', 'jamesknowltonsmith', 'jegiroua', 'jamesshannon', 'sudraco90', 'loganchai2', 'semajlchap', 'tracerbullet76', 'stonewburgan', 'ahbuchanan', 'isabelgamez22', 'jdoubt1', 'bkohlbush', 'alex18.cushing', 'alisonchomp', 'dkava', 'masongariepy', 'bdenicho', 'dgonz155', 'clarissa0223', 'ryltakayesu', 'thucmy', 'bolling1999', 'dreyes26', 'daisyk2000', 'ruiqq']",7,"['nkrog', 'kkuehn', 'gunnar90', 'j_seid', 'anguskojimoto', 'qsengstake', 'arashakhavi']",10,"['kevinibrhm7', 'robin94payne', 'bradsa4105', 'kristinababayev', 'tfoo', 'maxivonwelczeck', 'wmanampe', 'kbaylor', 'lautenba', None]",46,"['bradsa4105', 'kkuehn', 'mohammad182', 'emiliochausse', 'genuinedavidb', 'hannahmartin', 'jamesknowltonsmith', 'jegiroua', 'jamesshannon', 'gunnar90', 'j_seid', 'maxivonwelczeck', 'wmanampe', 'sudraco90', 'loganchai2', 'arashakhavi', 'semajlchap', 'tracerbullet76', 'stonewburgan', 'ahbuchanan', 'kevinibrhm7', 'kristinababayev', 'isabelgamez22', 'jdoubt1', 'bkohlbush', 'alex18.cushing', 'anguskojimoto', 'alisonchomp', 'dkava', 'kbaylor', 'qsengstake', 'masongariepy', 'bdenicho', 'lautenba', None, 'dgonz155', 'nkrog', 'robin94payne', 'clarissa0223', 'ryltakayesu', 'thucmy', 'bolling1999', 'tfoo', 'dreyes26', 'daisyk2000', 'ruiqq']"
28,542,37,36,28,"['mohammad182', 'emiliochausse', 'genuinedavidb', 'hannahmartin', 'jamesknowltonsmith', 'jegiroua', 'jamesshannon', 'loganchai2', 'semajlchap', 'tracerbullet76', 'stonewburgan', 'ahbuchanan', 'bkohlbush', 'jdoubt1', 'isabelgamez22', 'alex18.cushing', 'anguskojimoto', 'alisonchomp', 'dkava', 'masongariepy', 'dgonz155', 'clarissa0223', 'ryltakayesu', 'bolling1999', 'thucmy', 'dreyes26', 'daisyk2000', 'ruiqq']",8,"['bdenicho', 'nkrog', 'kkuehn', 'gunnar90', 'j_seid', 'sudraco90', 'qsengstake', 'arashakhavi']",8,"['kevinibrhm7', 'emilyhaykoupian', 'jkamlet', 'tfoo', 'coryschauer', 'bradsam', 'wmanampe', None]",44,"['kkuehn', 'mohammad182', 'emiliochausse', 'genuinedavidb', 'hannahmartin', 'jamesknowltonsmith', 'jegiroua', 'jamesshannon', 'gunnar90', 'j_seid', 'wmanampe', 'sudraco90', 'loganchai2', 'arashakhavi', 'semajlchap', 'tracerbullet76', 'stonewburgan', 'ahbuchanan', 'kevinibrhm7', 'emilyhaykoupian', 'isabelgamez22', 'jdoubt1', 'bkohlbush', 'alex18.cushing', 'anguskojimoto', 'alisonchomp', 'dkava', 'qsengstake', 'masongariepy', 'bdenicho', None, 'dgonz155', 'nkrog', 'jkamlet', 'clarissa0223', 'ryltakayesu', 'thucmy', 'bolling1999', 'tfoo', 'coryschauer', 'bradsam', 'dreyes26', 'daisyk2000', 'ruiqq']"
28,409,37,28,23,"['mohammad182', 'emiliochausse', 'genuinedavidb', 'hannahmartin', 'jamesshannon', 'sudraco90', 'loganchai2', 'semajlchap', 'tracerbullet76', 'stonewburgan', 'bkohlbush', 'isabelgamez22', 'anguskojimoto', 'alisonchomp', 'dkava', 'masongariepy', 'bdenicho', 'dgonz155', 'clarissa0223', 'thucmy', 'dreyes26', 'daisyk2000', 'ruiqq']",13,"['nkrog', 'ahbuchanan', 'kkuehn', 'jegiroua', 'ryltakayesu', 'jdoubt1', 'bolling1999', 'gunnar90', 'j_seid', 'alex18.cushing', 'jamesknowltonsmith', 'qsengstake', 'arashakhavi']",5,"['kevinibrhm7', 'bradsa4105', 'maxivonwelczeck', 'kbaylor', None]",41,"['bradsa4105', 'kkuehn', 'mohammad182', 'emiliochausse', 'genuinedavidb', 'hannahmartin', 'jamesknowltonsmith', 'jegiroua', 'jamesshannon', 'gunnar90', 'j_seid', 'maxivonwelczeck', 'sudraco90', 'loganchai2', 'arashakhavi', 'semajlchap', 'tracerbullet76', 'stonewburgan', 'ahbuchanan', 'kevinibrhm7', 'isabelgamez22', 'jdoubt1', 'bkohlbush', 'alex18.cushing', 'anguskojimoto', 'alisonchomp', 'dkava', 'kbaylor', 'qsengstake', 'masongariepy', 'bdenicho', None, 'dgonz155', 'nkrog', 'clarissa0223', 'ryltakayesu', 'thucmy', 'bolling1999', 'dreyes26', 'daisyk2000', 'ruiqq']"
28,547,37,18,16,"['stonewburgan', 'ahbuchanan', 'clarissa0223', 'mohammad182', 'isabelgamez22', 'jdoubt1', 'jegiroua', 'emiliochausse', 'bolling1999', 'genuinedavidb', 'anguskojimoto', 'thucmy', 'daisyk2000', 'masongariepy', 'loganchai2', 'semajlchap']",20,"['kkuehn', 'hannahmartin', 'jamesknowltonsmith', 'jamesshannon', 'gunnar90', 'j_seid', 'sudraco90', 'arashakhavi', 'tracerbullet76', 'bkohlbush', 'alex18.cushing', 'alisonchomp', 'dkava', 'qsengstake', 'bdenicho', 'dgonz155', 'nkrog', 'ryltakayesu', 'dreyes26', 'ruiqq']",2,"['coryschauer', None]",38,"['kkuehn', 'mohammad182', 'emiliochausse', 'genuinedavidb', 'hannahmartin', 'jamesknowltonsmith', 'jegiroua', 'jamesshannon', 'gunnar90', 'j_seid', 'sudraco90', 'loganchai2', 'arashakhavi', 'semajlchap', 'tracerbullet76', 'stonewburgan', 'ahbuchanan', 'isabelgamez22', 'jdoubt1', 'bkohlbush', 'alex18.cushing', 'anguskojimoto', 'alisonchomp', 'dkava', 'qsengstake', 'masongariepy', 'bdenicho', None, 'dgonz155', 'nkrog', 'clarissa0223', 'ryltakayesu', 'thucmy', 'bolling1999', 'coryschauer', 'dreyes26', 'daisyk2000', 'ruiqq']"
29,503,36,7,2,"['jlacsina', 'abchitnis']",33,"['katiecroft14', 'toshi', 'pluthert', 'brunamanzini', 'rabea', 'ceciayzam4', '1120140384yang', 'biancasantos', 'yuan777', 'temitope746', 'qiqi77', 'dfagbemi', 'kamogelomatenchi', 'james108', 'veronikapfann', 'junyang', 'jezamora92', 'mjakstaite', 'codewarrior', 'orhundavarci', 'sharmilla8', 'jr33', 'ejcurcio', 'd_lynch', 'sdrsunny', 'nfatima', 'anaespiritosanto2020', 'mere', 'baudelairefox', 'nareshk2904', 'divyojs', 'men218', 'monicaumesh']",5,"['jason.sinclair20', 'ratnadeep.mukherjee', 'poorani.bcbb', 'madisonyoung', None]",40,"['katiecroft14', 'toshi', 'pluthert', 'brunamanzini', 'rabea', 'ratnadeep.mukherjee', 'ceciayzam4', '1120140384yang', 'biancasantos', 'yuan777', 'temitope746', 'jason.sinclair20', 'qiqi77', 'dfagbemi', 'kamogelomatenchi', 'james108', 'veronikapfann', 'junyang', 'jezamora92', 'mjakstaite', 'codewarrior', 'orhundavarci', 'sharmilla8', 'jr33', 'ejcurcio', 'd_lynch', 'poorani.bcbb', 'sdrsunny', None, 'nfatima', 'jlacsina', 'anaespiritosanto2020', 'mere', 'baudelairefox', 'abchitnis', 'madisonyoung', 'nareshk2904', 'divyojs', 'men218', 'monicaumesh']"
30,210,35,11,10,"['adl233', 'sks6502', 'ada27', 'zzl244', 'jxw6098', 'ixd4', 'stiphany', 'pja5158', 'kak6117', 'iec5014']",24,"['yuguan', 'siweichen', 'yixicheng', 'psangkarat', 'liumaochuan1996', 'sowmiyar', 'mxh592', 'mesutk', 'mzp523', 'shiqilu97', 'jeffliu', 'yaodingl', 'huyang1', 'jianyingasd', 'khaas', 'qinyin', 'zetingh', 'liuziwei1072969', 'yixuwang5', 'yigyang', 'hongyuanh', 'yangyige', 'yuezhangw', 'xinyuj1']",1,[None],35,"['yuguan', 'siweichen', 'yixicheng', 'psangkarat', 'liumaochuan1996', 'sowmiyar', 'mxh592', 'mesutk', 'sks6502', 'stiphany', 'mzp523', 'shiqilu97', 'ada27', 'jeffliu', 'yaodingl', 'huyang1', 'jianyingasd', 'khaas', 'adl233', 'qinyin', 'zetingh', 'ixd4', 'pja5158', 'kak6117', None, 'iec5014', 'liuziwei1072969', 'yixuwang5', 'yigyang', 'hongyuanh', 'zzl244', 'jxw6098', 'yangyige', 'yuezhangw', 'xinyuj1']"
30,211,35,7,5,"['yixicheng', 'psangkarat', 'yangyige', 'yaodingl', 'jeffliu']",29,"['yuguan', 'siweichen', 'liumaochuan1996', 'sowmiyar', 'mxh592', 'mesutk', 'sks6502', 'stiphany', 'mzp523', 'shiqilu97', 'ada27', 'huyang1', 'jianyingasd', 'khaas', 'adl233', 'qinyin', 'zetingh', 'ixd4', 'pja5158', 'kak6117', 'iec5014', 'liuziwei1072969', 'yixuwang5', 'yigyang', 'hongyuanh', 'zzl244', 'jxw6098', 'yuezhangw', 'xinyuj1']",2,"[None, 'atanesha']",36,"['yuguan', 'siweichen', 'yixicheng', 'psangkarat', 'liumaochuan1996', 'sowmiyar', 'mxh592', 'mesutk', 'sks6502', 'stiphany', 'mzp523', 'shiqilu97', 'ada27', 'jeffliu', 'yaodingl', 'huyang1', 'jianyingasd', 'khaas', 'adl233', 'qinyin', 'atanesha', 'zetingh', 'ixd4', 'pja5158', 'kak6117', None, 'iec5014', 'liuziwei1072969', 'yixuwang5', 'yigyang', 'hongyuanh', 'zzl244', 'jxw6098', 'yangyige', 'yuezhangw', 'xinyuj1']"
30,212,35,7,6,"['jianyingasd', 'khaas', 'yixuwang5', 'yixicheng', 'psangkarat', 'yaodingl']",28,"['yuguan', 'siweichen', 'liumaochuan1996', 'sowmiyar', 'mxh592', 'mesutk', 'sks6502', 'stiphany', 'mzp523', 'shiqilu97', 'ada27', 'jeffliu', 'huyang1', 'adl233', 'qinyin', 'zetingh', 'ixd4', 'pja5158', 'kak6117', 'iec5014', 'liuziwei1072969', 'yigyang', 'hongyuanh', 'zzl244', 'jxw6098', 'yangyige', 'yuezhangw', 'xinyuj1']",1,[None],35,"['yuguan', 'siweichen', 'yixicheng', 'psangkarat', 'liumaochuan1996', 'sowmiyar', 'mxh592', 'mesutk', 'sks6502', 'stiphany', 'mzp523', 'shiqilu97', 'ada27', 'jeffliu', 'yaodingl', 'huyang1', 'jianyingasd', 'khaas', 'adl233', 'qinyin', 'zetingh', 'ixd4', 'pja5158', 'kak6117', None, 'iec5014', 'liuziwei1072969', 'yixuwang5', 'yigyang', 'hongyuanh', 'zzl244', 'jxw6098', 'yangyige', 'yuezhangw', 'xinyuj1']"
31,124,32,39,25,"['elijahellison3', 'ro3t3ch', 'rdcurtis20', 'cesokol', 'jacksonhilton', 'larsmatthys', 'tloutfi', 'mgovers', 'nickamarasinghe', 'rebeccawinger', 'lfhunter', 'harrisonvdw', 'tvaughn27', 'mitchellschrader', 'faithann2020', 'gavinschmidtke', 'jyang120', 'ejg70', 'mfriend', 'camdengallen', 'muwafaq09', 'marcushawley', 'jacksonfradd', 'mbholland', 'caiustoygrace']",6,"['eschulz19', 'josue.clavijo', 'sophiatiu', 'nmelisso', 'jlee895', 'nathan1656']",14,"['rstallin', 'rdilauro', None, 'maxjorgenson', 'calebhall27', 'lornstil', 'hughfordyce', 'ckrawczy', 'kshimanuki', 'jacobreed', 'mgwong132', 'mbkivy', 'meverson', 'kwang02']",45,"['elijahellison3', 'ro3t3ch', 'maxjorgenson', 'cesokol', 'sophiatiu', 'jacksonhilton', 'larsmatthys', 'mbkivy', 'tloutfi', 'mgovers', 'rstallin', 'nickamarasinghe', 'rebeccawinger', 'lfhunter', 'nmelisso', 'harrisonvdw', 'tvaughn27', 'mitchellschrader', 'kwang02', 'jyang120', 'kshimanuki', 'ckrawczy', 'meverson', 'marcushawley', 'jacksonfradd', 'mbholland', 'josue.clavijo', 'lornstil', 'jlee895', 'hughfordyce', 'rdcurtis20', 'mgwong132', 'eschulz19', 'rdilauro', 'calebhall27', 'nathan1656', 'jacobreed', 'faithann2020', 'gavinschmidtke', 'ejg70', None, 'mfriend', 'camdengallen', 'muwafaq09', 'caiustoygrace']"
32,538,32,41,7,"['rileywinters', 'abiaggne', 'mathieucerankows', 'nmckibben', 'nathanthemetalsguy20', 'quinnhulse', 'cfackrell']",24,"['bharathrajsr', 'bmananya98', 'manish21', 'srishti04', 'joshuafadeley', 'priyankarajwani519', 'henrikunold', 'mkarimpour5', 'manishcjoshi23', 'aviprak17', 'vyshakhcb', 'emilyepstein', 'omegaoj4', 'anusharma145', 'ajaykprkz', 'andrewpratyush', 'augusto.montero2014', 'sreejithpc', 'ashlynmasterson', 'jdhues', 'ashokphy', 'mayziehoudek', 'ankit477.nith', 'neha02']",34,"['dominikpanchenko', 'shanepalmer', 'miaklopfenstein', 'cfranc01', 'nicholasmckibben', 'lanlibsu', 'monicaleibowitz', 'arielweltner', 'haileemunoz', 'nickawieber', 'kincaidgraff', 'makaylaturner', 'forestswanson', 'fereshtehrajabik', 'egraugnard', 'kaeleenovich', 'maddymckenzie', 'kylerayers320', 'cassidyhoward', 'kaileejones', 'chrisjones', 'kentonburns', 'tristanolsen', 'iankerby', 'sophiamitchell', 'madilynpaul', 'tylerhamer', 'oliviamaryon', 'isaacwolstenholme25', None, 'joshuarussell', 'annaliestipton', 'mar4557', 'davidespey']",65,"['dominikpanchenko', 'rileywinters', 'bharathrajsr', 'miaklopfenstein', 'bmananya98', 'nicholasmckibben', 'cfranc01', 'lanlibsu', 'monicaleibowitz', 'arielweltner', 'nickawieber', 'manish21', 'mathieucerankows', 'srishti04', 'joshuafadeley', 'henrikunold', 'mkarimpour5', 'kylerayers320', 'kaileejones', 'manishcjoshi23', 'kentonburns', 'tristanolsen', 'anusharma145', 'madilynpaul', 'cfackrell', 'augusto.montero2014', 'joshuarussell', 'sreejithpc', 'mar4557', 'ashlynmasterson', 'jdhues', 'davidespey', 'shanepalmer', 'haileemunoz', 'kincaidgraff', 'abiaggne', 'makaylaturner', 'forestswanson', 'fereshtehrajabik', 'egraugnard', 'quinnhulse', 'priyankarajwani519', 'nathanthemetalsguy20', 'kaeleenovich', 'maddymckenzie', 'cassidyhoward', 'chrisjones', 'aviprak17', 'vyshakhcb', 'emilyepstein', 'omegaoj4', 'iankerby', 'ajaykprkz', 'sophiamitchell', 'tylerhamer', 'andrewpratyush', 'oliviamaryon', 'isaacwolstenholme25', None, 'annaliestipton', 'nmckibben', 'ashokphy', 'mayziehoudek', 'ankit477.nith', 'neha02']"
32,537,32,15,1,['rileywinters'],30,"['bharathrajsr', 'bmananya98', 'manish21', 'abiaggne', 'mathieucerankows', 'srishti04', 'joshuafadeley', 'quinnhulse', 'priyankarajwani519', 'henrikunold', 'nathanthemetalsguy20', 'mkarimpour5', 'manishcjoshi23', 'aviprak17', 'vyshakhcb', 'emilyepstein', 'omegaoj4', 'anusharma145', 'ajaykprkz', 'cfackrell', 'andrewpratyush', 'augusto.montero2014', 'sreejithpc', 'ashlynmasterson', 'nmckibben', 'jdhues', 'ashokphy', 'mayziehoudek', 'ankit477.nith', 'neha02']",14,"['annaliestipton', None, 'tristanolsen', 'fereshtehrajabik', 'egraugnard', 'nicholasmckibben', 'nickawieber', 'kaeleenovich', 'maddymckenzie', 'arielweltner', 'lanlibsu', 'chrisjones', 'joshuarussell', 'oliviamaryon']",45,"['rileywinters', 'bharathrajsr', 'bmananya98', 'nicholasmckibben', 'lanlibsu', 'arielweltner', 'nickawieber', 'manish21', 'abiaggne', 'mathieucerankows', 'fereshtehrajabik', 'egraugnard', 'srishti04', 'joshuafadeley', 'quinnhulse', 'priyankarajwani519', 'henrikunold', 'nathanthemetalsguy20', 'kaeleenovich', 'maddymckenzie', 'mkarimpour5', 'chrisjones', 'manishcjoshi23', 'aviprak17', 'tristanolsen', 'vyshakhcb', 'emilyepstein', 'omegaoj4', 'anusharma145', 'ajaykprkz', 'cfackrell', 'andrewpratyush', 'oliviamaryon', None, 'augusto.montero2014', 'joshuarussell', 'annaliestipton', 'sreejithpc', 'ashlynmasterson', 'nmckibben', 'jdhues', 'ashokphy', 'mayziehoudek', 'ankit477.nith', 'neha02']"
32,490,32,6,4,"['cfackrell', 'rileywinters', 'nathanthemetalsguy20', 'quinnhulse']",27,"['manishcjoshi23', 'aviprak17', 'bharathrajsr', 'vyshakhcb', 'emilyepstein', 'omegaoj4', 'bmananya98', 'anusharma145', 'ajaykprkz', 'andrewpratyush', 'manish21', 'augusto.montero2014', 'abiaggne', 'mathieucerankows', 'sreejithpc', 'ashlynmasterson', 'nmckibben', 'jdhues', 'ashokphy', 'srishti04', 'joshuafadeley', 'mayziehoudek', 'priyankarajwani519', 'henrikunold', 'ankit477.nith', 'mkarimpour5', 'neha02']",2,"[None, 'maddymckenzie']",33,"['manishcjoshi23', 'rileywinters', 'aviprak17', 'bharathrajsr', 'vyshakhcb', 'emilyepstein', 'omegaoj4', 'bmananya98', 'anusharma145', 'ajaykprkz', 'cfackrell', 'andrewpratyush', None, 'manish21', 'augusto.montero2014', 'abiaggne', 'mathieucerankows', 'sreejithpc', 'ashlynmasterson', 'nmckibben', 'jdhues', 'ashokphy', 'srishti04', 'joshuafadeley', 'mayziehoudek', 'quinnhulse', 'priyankarajwani519', 'henrikunold', 'nathanthemetalsguy20', 'maddymckenzie', 'ankit477.nith', 'mkarimpour5', 'neha02']"
33,538,32,41,16,"['dominikpanchenko', 'kentonburns', 'annaliestipton', 'mar4557', 'shanepalmer', 'egraugnard', 'madilynpaul', 'cfranc01', 'maddymckenzie', 'cassidyhoward', 'kaileejones', 'sophiamitchell', 'kaeleenovich', 'monicaleibowitz', 'haileemunoz', 'kincaidgraff']",15,"['taehwanynu', 'melvinjoseph', 'pacheco.cojal.bl', 'msehuni', 'abraaocnjr', 'paulmad', 'gianni_silverio', 'angye.larryshipper123', 'mih11234', 'frankfbc18', 'shannondillon', 'dkjnc', 'maxcook', 'cobraluka', 'branko.kautero']",25,"['rileywinters', 'miaklopfenstein', 'nicholasmckibben', 'lanlibsu', 'arielweltner', 'nickawieber', 'mathieucerankows', 'abiaggne', 'makaylaturner', 'forestswanson', 'fereshtehrajabik', 'quinnhulse', 'nathanthemetalsguy20', 'kylerayers320', 'chrisjones', 'tristanolsen', 'iankerby', 'oliviamaryon', 'tylerhamer', 'cfackrell', 'isaacwolstenholme25', None, 'joshuarussell', 'nmckibben', 'davidespey']",56,"['dominikpanchenko', 'rileywinters', 'miaklopfenstein', 'cfranc01', 'gianni_silverio', 'nicholasmckibben', 'lanlibsu', 'monicaleibowitz', 'arielweltner', 'maxcook', 'nickawieber', 'mathieucerankows', 'msehuni', 'dkjnc', 'kylerayers320', 'abraaocnjr', 'kaileejones', 'kentonburns', 'tristanolsen', 'madilynpaul', 'cfackrell', 'branko.kautero', 'joshuarussell', 'mar4557', 'frankfbc18', 'davidespey', 'shanepalmer', 'pacheco.cojal.bl', 'cobraluka', 'haileemunoz', 'kincaidgraff', 'taehwanynu', 'abiaggne', 'makaylaturner', 'forestswanson', 'fereshtehrajabik', 'egraugnard', 'paulmad', 'quinnhulse', 'nathanthemetalsguy20', 'kaeleenovich', 'maddymckenzie', 'cassidyhoward', 'chrisjones', 'iankerby', 'angye.larryshipper123', 'sophiamitchell', 'shannondillon', 'tylerhamer', 'melvinjoseph', 'oliviamaryon', 'isaacwolstenholme25', None, 'annaliestipton', 'nmckibben', 'mih11234']"
33,537,32,15,4,"['annaliestipton', 'egraugnard', 'kaeleenovich', 'maddymckenzie']",27,"['dominikpanchenko', 'shanepalmer', 'pacheco.cojal.bl', 'cfranc01', 'gianni_silverio', 'monicaleibowitz', 'maxcook', 'haileemunoz', 'cobraluka', 'kincaidgraff', 'taehwanynu', 'msehuni', 'paulmad', 'dkjnc', 'abraaocnjr', 'kaileejones', 'cassidyhoward', 'kentonburns', 'angye.larryshipper123', 'sophiamitchell', 'shannondillon', 'madilynpaul', 'melvinjoseph', 'branko.kautero', 'mar4557', 'mih11234', 'frankfbc18']",11,"['rileywinters', None, 'tristanolsen', 'fereshtehrajabik', 'nicholasmckibben', 'nickawieber', 'lanlibsu', 'arielweltner', 'chrisjones', 'joshuarussell', 'oliviamaryon']",42,"['dominikpanchenko', 'rileywinters', 'shanepalmer', 'pacheco.cojal.bl', 'cfranc01', 'gianni_silverio', 'nicholasmckibben', 'lanlibsu', 'monicaleibowitz', 'arielweltner', 'maxcook', 'cobraluka', 'haileemunoz', 'kincaidgraff', 'nickawieber', 'taehwanynu', 'fereshtehrajabik', 'egraugnard', 'msehuni', 'paulmad', 'dkjnc', 'maddymckenzie', 'kaeleenovich', 'cassidyhoward', 'abraaocnjr', 'kaileejones', 'chrisjones', 'kentonburns', 'tristanolsen', 'angye.larryshipper123', 'sophiamitchell', 'shannondillon', 'madilynpaul', 'oliviamaryon', 'melvinjoseph', None, 'branko.kautero', 'joshuarussell', 'annaliestipton', 'mar4557', 'mih11234', 'frankfbc18']"
33,536,32,14,1,['cobraluka'],30,"['dominikpanchenko', 'shanepalmer', 'pacheco.cojal.bl', 'cfranc01', 'gianni_silverio', 'monicaleibowitz', 'maxcook', 'haileemunoz', 'kincaidgraff', 'taehwanynu', 'egraugnard', 'msehuni', 'paulmad', 'dkjnc', 'maddymckenzie', 'kaeleenovich', 'abraaocnjr', 'kaileejones', 'cassidyhoward', 'kentonburns', 'angye.larryshipper123', 'sophiamitchell', 'shannondillon', 'madilynpaul', 'melvinjoseph', 'branko.kautero', 'annaliestipton', 'mar4557', 'mih11234', 'frankfbc18']",13,"['mpajas', 'nikolajevic77', 'nzaluski', 'dskukan76', 'teo.lozinski', 'markobond', 'luka.cavaliere.lokas', 'damjan', 'martina444', 'iborcic', 'iversic7', 'pope.zd', None]",44,"['dominikpanchenko', 'shanepalmer', 'pacheco.cojal.bl', 'cfranc01', 'gianni_silverio', 'iversic7', 'monicaleibowitz', 'maxcook', 'cobraluka', 'haileemunoz', 'kincaidgraff', 'taehwanynu', 'markobond', 'luka.cavaliere.lokas', 'egraugnard', 'msehuni', 'paulmad', 'pope.zd', 'dkjnc', 'maddymckenzie', 'kaeleenovich', 'cassidyhoward', 'abraaocnjr', 'kaileejones', 'kentonburns', 'mpajas', 'nikolajevic77', 'martina444', 'angye.larryshipper123', 'iborcic', 'sophiamitchell', 'shannondillon', 'madilynpaul', 'melvinjoseph', None, 'branko.kautero', 'annaliestipton', 'mar4557', 'nzaluski', 'teo.lozinski', 'dskukan76', 'damjan', 'mih11234', 'frankfbc18']"
33,227,32,11,1,['branko.kautero'],30,"['dominikpanchenko', 'shanepalmer', 'pacheco.cojal.bl', 'cfranc01', 'gianni_silverio', 'monicaleibowitz', 'maxcook', 'haileemunoz', 'cobraluka', 'kincaidgraff', 'taehwanynu', 'egraugnard', 'msehuni', 'paulmad', 'dkjnc', 'maddymckenzie', 'kaeleenovich', 'abraaocnjr', 'kaileejones', 'cassidyhoward', 'kentonburns', 'angye.larryshipper123', 'sophiamitchell', 'shannondillon', 'madilynpaul', 'melvinjoseph', 'annaliestipton', 'mar4557', 'mih11234', 'frankfbc18']",10,"['mpajas', 'nikolajevic77', None, 'bakickarolina', 'dskukan76', 'martina444', 'manikic', 'iversic7', 'iborcic', 'aparunov']",41,"['dominikpanchenko', 'shanepalmer', 'pacheco.cojal.bl', 'cfranc01', 'gianni_silverio', 'manikic', 'iversic7', 'monicaleibowitz', 'maxcook', 'cobraluka', 'haileemunoz', 'kincaidgraff', 'aparunov', 'taehwanynu', 'egraugnard', 'msehuni', 'paulmad', 'dkjnc', 'maddymckenzie', 'kaeleenovich', 'cassidyhoward', 'abraaocnjr', 'kaileejones', 'kentonburns', 'mpajas', 'nikolajevic77', 'martina444', 'angye.larryshipper123', 'iborcic', 'sophiamitchell', 'shannondillon', 'madilynpaul', 'melvinjoseph', None, 'branko.kautero', 'annaliestipton', 'mar4557', 'bakickarolina', 'dskukan76', 'mih11234', 'frankfbc18']"
33,279,32,10,1,['mih11234'],30,"['dominikpanchenko', 'shanepalmer', 'pacheco.cojal.bl', 'cfranc01', 'gianni_silverio', 'monicaleibowitz', 'maxcook', 'haileemunoz', 'cobraluka', 'kincaidgraff', 'taehwanynu', 'egraugnard', 'msehuni', 'paulmad', 'dkjnc', 'maddymckenzie', 'kaeleenovich', 'abraaocnjr', 'kaileejones', 'cassidyhoward', 'kentonburns', 'angye.larryshipper123', 'sophiamitchell', 'shannondillon', 'madilynpaul', 'melvinjoseph', 'branko.kautero', 'annaliestipton', 'mar4557', 'frankfbc18']",9,"['mpajas', 'markobond', 'dskukan76', 'luka.cavaliere.lokas', 'damjan', 'manikic', 'iborcic', 'pope.zd', None]",40,"['dominikpanchenko', 'shanepalmer', 'pacheco.cojal.bl', 'cfranc01', 'gianni_silverio', 'manikic', 'monicaleibowitz', 'maxcook', 'cobraluka', 'haileemunoz', 'kincaidgraff', 'taehwanynu', 'markobond', 'luka.cavaliere.lokas', 'egraugnard', 'msehuni', 'paulmad', 'pope.zd', 'dkjnc', 'maddymckenzie', 'kaeleenovich', 'cassidyhoward', 'abraaocnjr', 'kaileejones', 'kentonburns', 'mpajas', 'angye.larryshipper123', 'iborcic', 'sophiamitchell', 'shannondillon', 'madilynpaul', 'melvinjoseph', None, 'branko.kautero', 'annaliestipton', 'mar4557', 'dskukan76', 'damjan', 'mih11234', 'frankfbc18']"
33,284,32,10,1,['mih11234'],30,"['dominikpanchenko', 'shanepalmer', 'pacheco.cojal.bl', 'cfranc01', 'gianni_silverio', 'monicaleibowitz', 'maxcook', 'haileemunoz', 'cobraluka', 'kincaidgraff', 'taehwanynu', 'egraugnard', 'msehuni', 'paulmad', 'dkjnc', 'maddymckenzie', 'kaeleenovich', 'abraaocnjr', 'kaileejones', 'cassidyhoward', 'kentonburns', 'angye.larryshipper123', 'sophiamitchell', 'shannondillon', 'madilynpaul', 'melvinjoseph', 'branko.kautero', 'annaliestipton', 'mar4557', 'frankfbc18']",9,"['mpajas', 'markobond', 'dskukan76', 'luka.cavaliere.lokas', 'damjan', 'manikic', 'iborcic', 'pope.zd', None]",40,"['dominikpanchenko', 'shanepalmer', 'pacheco.cojal.bl', 'cfranc01', 'gianni_silverio', 'manikic', 'monicaleibowitz', 'maxcook', 'cobraluka', 'haileemunoz', 'kincaidgraff', 'taehwanynu', 'markobond', 'luka.cavaliere.lokas', 'egraugnard', 'msehuni', 'paulmad', 'pope.zd', 'dkjnc', 'maddymckenzie', 'kaeleenovich', 'cassidyhoward', 'abraaocnjr', 'kaileejones', 'kentonburns', 'mpajas', 'angye.larryshipper123', 'iborcic', 'sophiamitchell', 'shannondillon', 'madilynpaul', 'melvinjoseph', None, 'branko.kautero', 'annaliestipton', 'mar4557', 'dskukan76', 'damjan', 'mih11234', 'frankfbc18']"
33,533,32,9,4,"['kentonburns', 'cassidyhoward', 'shannondillon', 'shanepalmer']",27,"['dominikpanchenko', 'pacheco.cojal.bl', 'cfranc01', 'gianni_silverio', 'monicaleibowitz', 'maxcook', 'haileemunoz', 'cobraluka', 'kincaidgraff', 'taehwanynu', 'egraugnard', 'msehuni', 'paulmad', 'dkjnc', 'maddymckenzie', 'kaeleenovich', 'abraaocnjr', 'kaileejones', 'angye.larryshipper123', 'sophiamitchell', 'madilynpaul', 'melvinjoseph', 'branko.kautero', 'annaliestipton', 'mar4557', 'mih11234', 'frankfbc18']",5,"['fereshtehrajabik', 'nicjohnson', 'nickawieber', 'lanlibsu', None]",36,"['dominikpanchenko', 'shanepalmer', 'pacheco.cojal.bl', 'cfranc01', 'gianni_silverio', 'lanlibsu', 'monicaleibowitz', 'maxcook', 'cobraluka', 'haileemunoz', 'kincaidgraff', 'nickawieber', 'taehwanynu', 'fereshtehrajabik', 'egraugnard', 'msehuni', 'paulmad', 'dkjnc', 'maddymckenzie', 'kaeleenovich', 'cassidyhoward', 'abraaocnjr', 'kaileejones', 'kentonburns', 'angye.larryshipper123', 'sophiamitchell', 'shannondillon', 'madilynpaul', 'melvinjoseph', None, 'branko.kautero', 'annaliestipton', 'mar4557', 'mih11234', 'frankfbc18', 'nicjohnson']"
33,535,32,8,2,"['kentonburns', 'cassidyhoward']",29,"['dominikpanchenko', 'shanepalmer', 'pacheco.cojal.bl', 'cfranc01', 'gianni_silverio', 'monicaleibowitz', 'maxcook', 'haileemunoz', 'cobraluka', 'kincaidgraff', 'taehwanynu', 'egraugnard', 'msehuni', 'paulmad', 'dkjnc', 'maddymckenzie', 'kaeleenovich', 'abraaocnjr', 'kaileejones', 'angye.larryshipper123', 'sophiamitchell', 'shannondillon', 'madilynpaul', 'melvinjoseph', 'branko.kautero', 'annaliestipton', 'mar4557', 'mih11234', 'frankfbc18']",6,"['tristanolsen', 'fereshtehrajabik', 'nickawieber', 'lanlibsu', None, 'joshuarussell']",37,"['dominikpanchenko', 'shanepalmer', 'pacheco.cojal.bl', 'cfranc01', 'gianni_silverio', 'lanlibsu', 'monicaleibowitz', 'maxcook', 'cobraluka', 'haileemunoz', 'kincaidgraff', 'nickawieber', 'taehwanynu', 'fereshtehrajabik', 'egraugnard', 'msehuni', 'paulmad', 'dkjnc', 'maddymckenzie', 'kaeleenovich', 'cassidyhoward', 'abraaocnjr', 'kaileejones', 'kentonburns', 'tristanolsen', 'angye.larryshipper123', 'sophiamitchell', 'shannondillon', 'madilynpaul', 'melvinjoseph', None, 'branko.kautero', 'joshuarussell', 'annaliestipton', 'mar4557', 'mih11234', 'frankfbc18']"
33,490,32,6,1,['maddymckenzie'],30,"['dominikpanchenko', 'kentonburns', 'shanepalmer', 'pacheco.cojal.bl', 'angye.larryshipper123', 'cfranc01', 'gianni_silverio', 'sophiamitchell', 'shannondillon', 'monicaleibowitz', 'madilynpaul', 'maxcook', 'melvinjoseph', 'cobraluka', 'haileemunoz', 'kincaidgraff', 'branko.kautero', 'taehwanynu', 'annaliestipton', 'mar4557', 'egraugnard', 'msehuni', 'mih11234', 'paulmad', 'frankfbc18', 'cassidyhoward', 'dkjnc', 'kaeleenovich', 'abraaocnjr', 'kaileejones']",5,"['rileywinters', 'nathanthemetalsguy20', 'quinnhulse', 'cfackrell', None]",36,"['dominikpanchenko', 'kentonburns', 'rileywinters', 'shanepalmer', 'pacheco.cojal.bl', 'angye.larryshipper123', 'cfranc01', 'gianni_silverio', 'sophiamitchell', 'shannondillon', 'monicaleibowitz', 'madilynpaul', 'maxcook', 'melvinjoseph', 'cfackrell', 'cobraluka', 'haileemunoz', 'kincaidgraff', 'branko.kautero', 'taehwanynu', 'annaliestipton', None, 'mar4557', 'egraugnard', 'msehuni', 'mih11234', 'paulmad', 'frankfbc18', 'cassidyhoward', 'nathanthemetalsguy20', 'quinnhulse', 'dkjnc', 'maddymckenzie', 'kaeleenovich', 'abraaocnjr', 'kaileejones']"
33,534,32,6,2,"['kentonburns', 'cassidyhoward']",29,"['dominikpanchenko', 'shanepalmer', 'pacheco.cojal.bl', 'angye.larryshipper123', 'cfranc01', 'gianni_silverio', 'sophiamitchell', 'shannondillon', 'monicaleibowitz', 'madilynpaul', 'maxcook', 'melvinjoseph', 'cobraluka', 'haileemunoz', 'kincaidgraff', 'branko.kautero', 'taehwanynu', 'annaliestipton', 'mar4557', 'egraugnard', 'msehuni', 'mih11234', 'paulmad', 'frankfbc18', 'dkjnc', 'maddymckenzie', 'kaeleenovich', 'abraaocnjr', 'kaileejones']",4,"['oliviamaryon', 'fereshtehrajabik', None, 'lanlibsu']",35,"['dominikpanchenko', 'kentonburns', 'shanepalmer', 'pacheco.cojal.bl', 'angye.larryshipper123', 'cfranc01', 'gianni_silverio', 'sophiamitchell', 'shannondillon', 'lanlibsu', 'monicaleibowitz', 'madilynpaul', 'maxcook', 'melvinjoseph', 'oliviamaryon', 'cobraluka', 'haileemunoz', 'kincaidgraff', 'branko.kautero', 'taehwanynu', 'annaliestipton', None, 'mar4557', 'fereshtehrajabik', 'egraugnard', 'msehuni', 'mih11234', 'paulmad', 'frankfbc18', 'cassidyhoward', 'dkjnc', 'maddymckenzie', 'kaeleenovich', 'abraaocnjr', 'kaileejones']"
34,50,31,105,4,"['arohishinde2302', 'apoorva.limaye', 'vedant', 'aniket.nadkarni']",26,"['aimenfatimah', 'muhd_amir97', 'hziq97', 'syafiqah97', 'azrulaiman', 'dayana83', 'wanalhafiz97', 'nilamsarib081810464', 'huzaimahb081810113', 'fadhil123', 'megala97', 'famirk65', 'fahmim95', 'nurelmiera99', 'shraddha2002', 'tasnimnasir96', 'tafa97', 'nurazwab081810444', 'azimighani', 'imansulaiman', 'eddie97', 'sham1997', 'yurimdias', 'sagundalairajendran', 'dharmindran', 'kelvinho0313']",101,"['nookalaarpan12', '8122vivian', 'ayush2801', 'aditichaturvedi', 'sanskar.laddha', 'mitash0404', 'dhiraj.choudhari', 'tirthpatel', 'divija.shringarpure', 'jaidamani42', 'bilal2912', 'rathod_spce', 'tiwarisuraj5769', 'niharika.somani', 'h.bilkhu', 'manan.arora', 'arpanbiswas', 'sneee', 'sohamk45', 'dhananjay23', 'akshada.hadal', 'sangeetamjoshi', 'saikrishnam', 'shweta0208', 'prathamm12', 'anushka.pilena', 'omkar.pawar', 'husain.challawala', 'aditya.umalkar', 'adrao', 'lovleshsingh99', 'aryan.dali', 'divya.manikantan', 'adnan.mohiddin', 'sayaliayre22', None, 'rohitrane500', 'darshan.tater', 'oindrella', 'aditya.patwardhan', 'truptigopinath', 'sneha.savarkar', 'anuragmandke4', 'pushkarsutar999', 'siddhant11', 'swapnil.mandavilli', 'trustme20times', 'jayesh_bane', 'verma07anand', 'pushkar.sutar', 'atharvasonavane', 'niharika1528', 'prerna.arora', 'sohel.datta', 'nimratkaur', 'anuj.chavan', 'richa.motwani', 'pulkit.chaudhari', 'yuvraj.purohit', 'sudhanshu128', 'aryansolanki', 'deekshapalll', 'cxxpxx19', 'bilalsani2912', 'anjali.golani', 'sarasheth60', 'mayur07', 'manas.tiwari', 'abhinav.pallayil', 'aryaman1712021', 'vivek.thakkar', 'khushi.patni', 'chinmay.walinjkar', 'jaimindesai', 'hargobind.singh', 'tarun96', 'shubham.sawant', 'omkar.shinde', 'dylan_ds0uza', 'anupriya.dasgupta', 'nibha.desai', 'kshemal_gupte', 'saeesh.aher', 'shivamthakur04', 'siddharthmohanty812', 'sumitdupate19', 'anirudh9911', 'rinkalkeniya', 'vishal.lohar', 'varun.kamath', 'sunlovesrahul', 'keval09', 'eeshaanasodekar', 'maitri.vora', 'lokesh.patil', 'vraj.b', 'ganesharpan.nookala', 'jainhitanshu588', 'aniket.gawade', 'pranay.tiwari', 'ankit.manani']",131,"['aimenfatimah', 'nookalaarpan12', '8122vivian', 'ayush2801', 'aditichaturvedi', 'sanskar.laddha', 'mitash0404', 'azrulaiman', 'dayana83', 'dhiraj.choudhari', 'wanalhafiz97', 'tirthpatel', 'nilamsarib081810464', 'divija.shringarpure', 'jaidamani42', 'bilal2912', 'rathod_spce', 'fahmim95', 'tiwarisuraj5769', 'niharika.somani', 'h.bilkhu', 'nurazwab081810444', 'tafa97', 'manan.arora', 'arpanbiswas', 'sneee', 'sohamk45', 'dhananjay23', 'akshada.hadal', 'sangeetamjoshi', 'saikrishnam', 'shweta0208', 'prathamm12', 'anushka.pilena', 'omkar.pawar', 'syafiqah97', 'husain.challawala', 'aditya.umalkar', 'adrao', 'lovleshsingh99', 'aryan.dali', 'divya.manikantan', 'megala97', 'nurelmiera99', 'adnan.mohiddin', 'sayaliayre22', None, 'rohitrane500', 'azimighani', 'vedant', 'eddie97', 'arohishinde2302', 'darshan.tater', 'oindrella', 'dharmindran', 'kelvinho0313', 'aditya.patwardhan', 'truptigopinath', 'sneha.savarkar', 'anuragmandke4', 'hziq97', 'pushkarsutar999', 'siddhant11', 'swapnil.mandavilli', 'trustme20times', 'jayesh_bane', 'verma07anand', 'pushkar.sutar', 'atharvasonavane', 'niharika1528', 'prerna.arora', 'sohel.datta', 'fadhil123', 'nimratkaur', 'anuj.chavan', 'richa.motwani', 'pulkit.chaudhari', 'yuvraj.purohit', 'sudhanshu128', 'aryansolanki', 'shraddha2002', 'deekshapalll', 'imansulaiman', 'cxxpxx19', 'bilalsani2912', 'anjali.golani', 'sarasheth60', 'yurimdias', 'mayur07', 'manas.tiwari', 'abhinav.pallayil', 'aryaman1712021', 'vivek.thakkar', 'khushi.patni', 'chinmay.walinjkar', 'jaimindesai', 'apoorva.limaye', 'muhd_amir97', 'hargobind.singh', 'tarun96', 'shubham.sawant', 'omkar.shinde', 'dylan_ds0uza', 'anupriya.dasgupta', 'nibha.desai', 'aniket.nadkarni', 'kshemal_gupte', 'saeesh.aher', 'huzaimahb081810113', 'shivamthakur04', 'siddharthmohanty812', 'famirk65', 'sumitdupate19', 'anirudh9911', 'rinkalkeniya', 'vishal.lohar', 'varun.kamath', 'sunlovesrahul', 'keval09', 'eeshaanasodekar', 'tasnimnasir96', 'maitri.vora', 'lokesh.patil', 'vraj.b', 'ganesharpan.nookala', 'jainhitanshu588', 'aniket.gawade', 'sham1997', 'pranay.tiwari', 'ankit.manani', 'sagundalairajendran']"
34,57,31,20,17,"['aimenfatimah', 'fadhil123', 'hziq97', 'megala97', 'famirk65', 'tasnimnasir96', 'imansulaiman', 'azimighani', 'fahmim95', 'nurelmiera99', 'eddie97', 'sham1997', 'syafiqah97', 'nurazwab081810444', 'dharmindran', 'nilamsarib081810464', 'tafa97']",13,"['vedant', 'azrulaiman', 'arohishinde2302', 'dayana83', 'apoorva.limaye', 'muhd_amir97', 'wanalhafiz97', 'shraddha2002', 'yurimdias', 'sagundalairajendran', 'aniket.nadkarni', 'kelvinho0313', 'huzaimahb081810113']",3,"['dyana4152', None, 'hln_04']",33,"['aimenfatimah', 'apoorva.limaye', 'muhd_amir97', 'hziq97', 'syafiqah97', 'azrulaiman', 'dayana83', 'wanalhafiz97', 'nilamsarib081810464', 'aniket.nadkarni', 'huzaimahb081810113', 'fadhil123', 'dyana4152', 'megala97', 'famirk65', 'fahmim95', 'nurelmiera99', 'shraddha2002', 'tasnimnasir96', None, 'nurazwab081810444', 'tafa97', 'azimighani', 'vedant', 'imansulaiman', 'hln_04', 'eddie97', 'sham1997', 'arohishinde2302', 'yurimdias', 'sagundalairajendran', 'dharmindran', 'kelvinho0313']"
34,62,31,19,14,"['fadhil123', 'megala97', 'imansulaiman', 'tasnimnasir96', 'azimighani', 'nurelmiera99', 'sham1997', 'syafiqah97', 'nurazwab081810444', 'wanalhafiz97', 'dharmindran', 'nilamsarib081810464', 'tafa97', 'huzaimahb081810113']",16,"['aimenfatimah', 'hziq97', 'famirk65', 'vedant', 'fahmim95', 'eddie97', 'azrulaiman', 'arohishinde2302', 'apoorva.limaye', 'muhd_amir97', 'dayana83', 'yurimdias', 'shraddha2002', 'sagundalairajendran', 'aniket.nadkarni', 'kelvinho0313']",5,"['dyana4152', 'hln_04', 'iven2020', 'muhammadfahmim2020', None]",35,"['aimenfatimah', 'apoorva.limaye', 'muhd_amir97', 'muhammadfahmim2020', 'hziq97', 'syafiqah97', 'azrulaiman', 'dayana83', 'wanalhafiz97', 'nilamsarib081810464', 'aniket.nadkarni', 'huzaimahb081810113', 'fadhil123', 'dyana4152', 'megala97', 'famirk65', 'fahmim95', 'nurelmiera99', 'shraddha2002', 'tasnimnasir96', None, 'nurazwab081810444', 'tafa97', 'azimighani', 'vedant', 'imansulaiman', 'hln_04', 'eddie97', 'sham1997', 'arohishinde2302', 'yurimdias', 'sagundalairajendran', 'iven2020', 'dharmindran', 'kelvinho0313']"
34,48,31,14,1,['yurimdias'],29,"['aimenfatimah', 'apoorva.limaye', 'muhd_amir97', 'hziq97', 'syafiqah97', 'azrulaiman', 'dayana83', 'wanalhafiz97', 'nilamsarib081810464', 'aniket.nadkarni', 'huzaimahb081810113', 'fadhil123', 'megala97', 'famirk65', 'fahmim95', 'nurelmiera99', 'shraddha2002', 'tasnimnasir96', 'nurazwab081810444', 'tafa97', 'azimighani', 'vedant', 'imansulaiman', 'eddie97', 'sham1997', 'arohishinde2302', 'sagundalairajendran', 'dharmindran', 'kelvinho0313']",13,"[None, 'dariogui', 'eduardaamaral30', 'marcelo.rodrigues', 'victorfidelis', 'ricardqueiroz', 'antoniopml', 'brunaeloisa', 'rodrigoluna1', 'marcelobr07', 'diomadson', 'sidney.hca', 'rosiivaldo']",43,"['aimenfatimah', 'dariogui', 'brunaeloisa', 'apoorva.limaye', 'muhd_amir97', 'hziq97', 'ricardqueiroz', 'syafiqah97', 'rodrigoluna1', 'azrulaiman', 'dayana83', 'wanalhafiz97', 'nilamsarib081810464', 'aniket.nadkarni', 'sidney.hca', 'huzaimahb081810113', 'fadhil123', 'megala97', 'famirk65', 'marcelo.rodrigues', 'eduardaamaral30', 'fahmim95', 'nurelmiera99', 'shraddha2002', 'marcelobr07', 'diomadson', 'tasnimnasir96', None, 'nurazwab081810444', 'tafa97', 'azimighani', 'vedant', 'imansulaiman', 'victorfidelis', 'antoniopml', 'eddie97', 'sham1997', 'arohishinde2302', 'yurimdias', 'sagundalairajendran', 'rosiivaldo', 'dharmindran', 'kelvinho0313']"
34,53,31,13,9,"['aimenfatimah', 'hziq97', 'azimighani', 'megala97', 'sham1997', 'syafiqah97', 'dayana83', 'nilamsarib081810464', 'nurazwab081810444']",21,"['apoorva.limaye', 'muhd_amir97', 'azrulaiman', 'wanalhafiz97', 'aniket.nadkarni', 'huzaimahb081810113', 'fadhil123', 'famirk65', 'fahmim95', 'nurelmiera99', 'shraddha2002', 'tasnimnasir96', 'tafa97', 'vedant', 'imansulaiman', 'eddie97', 'arohishinde2302', 'yurimdias', 'sagundalairajendran', 'dharmindran', 'kelvinho0313']",4,"['dyana4152', None, 'hln_04', 'megala1997']",34,"['aimenfatimah', 'apoorva.limaye', 'muhd_amir97', 'hziq97', 'syafiqah97', 'azrulaiman', 'dayana83', 'wanalhafiz97', 'nilamsarib081810464', 'aniket.nadkarni', 'megala1997', 'huzaimahb081810113', 'fadhil123', 'dyana4152', 'megala97', 'famirk65', 'fahmim95', 'nurelmiera99', 'shraddha2002', 'tasnimnasir96', None, 'nurazwab081810444', 'tafa97', 'azimighani', 'vedant', 'imansulaiman', 'hln_04', 'eddie97', 'sham1997', 'arohishinde2302', 'yurimdias', 'sagundalairajendran', 'dharmindran', 'kelvinho0313']"
34,64,31,12,9,"['aimenfatimah', 'hziq97', 'megala97', 'nurelmiera99', 'sham1997', 'syafiqah97', 'azrulaiman', 'nilamsarib081810464', 'huzaimahb081810113']",21,"['apoorva.limaye', 'muhd_amir97', 'dayana83', 'wanalhafiz97', 'aniket.nadkarni', 'fadhil123', 'famirk65', 'fahmim95', 'shraddha2002', 'tasnimnasir96', 'tafa97', 'nurazwab081810444', 'azimighani', 'vedant', 'imansulaiman', 'eddie97', 'arohishinde2302', 'yurimdias', 'sagundalairajendran', 'dharmindran', 'kelvinho0313']",3,"['dyana4152', None, 'hln_04']",33,"['aimenfatimah', 'apoorva.limaye', 'muhd_amir97', 'hziq97', 'syafiqah97', 'azrulaiman', 'dayana83', 'wanalhafiz97', 'nilamsarib081810464', 'aniket.nadkarni', 'huzaimahb081810113', 'fadhil123', 'dyana4152', 'megala97', 'famirk65', 'fahmim95', 'nurelmiera99', 'shraddha2002', 'tasnimnasir96', None, 'nurazwab081810444', 'tafa97', 'azimighani', 'vedant', 'imansulaiman', 'hln_04', 'eddie97', 'sham1997', 'arohishinde2302', 'yurimdias', 'sagundalairajendran', 'dharmindran', 'kelvinho0313']"
34,65,31,12,10,"['aimenfatimah', 'megala97', 'famirk65', 'nurelmiera99', 'sham1997', 'dayana83', 'wanalhafiz97', 'tasnimnasir96', 'nurazwab081810444', 'huzaimahb081810113']",20,"['apoorva.limaye', 'muhd_amir97', 'hziq97', 'syafiqah97', 'azrulaiman', 'nilamsarib081810464', 'aniket.nadkarni', 'fadhil123', 'fahmim95', 'shraddha2002', 'tafa97', 'azimighani', 'vedant', 'imansulaiman', 'eddie97', 'arohishinde2302', 'yurimdias', 'sagundalairajendran', 'dharmindran', 'kelvinho0313']",2,"['dyana4152', None]",32,"['aimenfatimah', 'apoorva.limaye', 'muhd_amir97', 'hziq97', 'syafiqah97', 'azrulaiman', 'dayana83', 'wanalhafiz97', 'nilamsarib081810464', 'aniket.nadkarni', 'huzaimahb081810113', 'fadhil123', 'dyana4152', 'megala97', 'famirk65', 'fahmim95', 'nurelmiera99', 'shraddha2002', 'tasnimnasir96', None, 'nurazwab081810444', 'tafa97', 'azimighani', 'vedant', 'imansulaiman', 'eddie97', 'sham1997', 'arohishinde2302', 'yurimdias', 'sagundalairajendran', 'dharmindran', 'kelvinho0313']"
34,56,31,11,1,['shraddha2002'],29,"['aimenfatimah', 'apoorva.limaye', 'muhd_amir97', 'hziq97', 'syafiqah97', 'azrulaiman', 'dayana83', 'wanalhafiz97', 'nilamsarib081810464', 'aniket.nadkarni', 'huzaimahb081810113', 'fadhil123', 'megala97', 'famirk65', 'fahmim95', 'nurelmiera99', 'tasnimnasir96', 'tafa97', 'nurazwab081810444', 'azimighani', 'vedant', 'imansulaiman', 'eddie97', 'sham1997', 'arohishinde2302', 'yurimdias', 'sagundalairajendran', 'dharmindran', 'kelvinho0313']",10,"['malhar.vairale1812', 'avyeshbhatnagar46', 'richa.motwani', 'vivek.thakkar', 'sahil.patil', 'siddhant.kamlaskar', 'sayaliayre22', None, 'vinayak.tripathi', 'devansh.palliyath']",40,"['aimenfatimah', 'vivek.thakkar', 'apoorva.limaye', 'muhd_amir97', 'devansh.palliyath', 'malhar.vairale1812', 'avyeshbhatnagar46', 'hziq97', 'sahil.patil', 'syafiqah97', 'siddhant.kamlaskar', 'azrulaiman', 'dayana83', 'wanalhafiz97', 'nilamsarib081810464', 'aniket.nadkarni', 'huzaimahb081810113', 'fadhil123', 'richa.motwani', 'megala97', 'famirk65', 'fahmim95', 'nurelmiera99', 'shraddha2002', 'sayaliayre22', 'tasnimnasir96', None, 'nurazwab081810444', 'tafa97', 'vinayak.tripathi', 'azimighani', 'vedant', 'imansulaiman', 'eddie97', 'sham1997', 'arohishinde2302', 'yurimdias', 'sagundalairajendran', 'dharmindran', 'kelvinho0313']"
34,59,31,10,2,"['apoorva.limaye', 'aniket.nadkarni']",28,"['aimenfatimah', 'muhd_amir97', 'hziq97', 'syafiqah97', 'azrulaiman', 'dayana83', 'wanalhafiz97', 'nilamsarib081810464', 'huzaimahb081810113', 'fadhil123', 'megala97', 'famirk65', 'fahmim95', 'nurelmiera99', 'shraddha2002', 'tasnimnasir96', 'tafa97', 'nurazwab081810444', 'azimighani', 'vedant', 'imansulaiman', 'eddie97', 'sham1997', 'arohishinde2302', 'yurimdias', 'sagundalairajendran', 'dharmindran', 'kelvinho0313']",8,"['nookalaarpan12', 'rohitrane500', 'divya.manikantan', 'ankit.manani', 'anupriya.dasgupta', 'vikas.ms', None, 'simran.mulik']",38,"['aimenfatimah', 'nookalaarpan12', 'apoorva.limaye', 'muhd_amir97', 'hziq97', 'syafiqah97', 'azrulaiman', 'dayana83', 'wanalhafiz97', 'anupriya.dasgupta', 'nilamsarib081810464', 'aniket.nadkarni', 'vikas.ms', 'huzaimahb081810113', 'fadhil123', 'divya.manikantan', 'megala97', 'famirk65', 'fahmim95', 'nurelmiera99', 'shraddha2002', 'tasnimnasir96', None, 'nurazwab081810444', 'tafa97', 'simran.mulik', 'rohitrane500', 'azimighani', 'vedant', 'imansulaiman', 'eddie97', 'sham1997', 'arohishinde2302', 'yurimdias', 'ankit.manani', 'sagundalairajendran', 'dharmindran', 'kelvinho0313']"
34,63,31,8,5,"['nurelmiera99', 'syafiqah97', 'muhd_amir97', 'tasnimnasir96', 'kelvinho0313']",25,"['aimenfatimah', 'apoorva.limaye', 'hziq97', 'azrulaiman', 'dayana83', 'wanalhafiz97', 'nilamsarib081810464', 'aniket.nadkarni', 'huzaimahb081810113', 'fadhil123', 'megala97', 'famirk65', 'fahmim95', 'shraddha2002', 'tafa97', 'nurazwab081810444', 'azimighani', 'vedant', 'imansulaiman', 'eddie97', 'sham1997', 'arohishinde2302', 'yurimdias', 'sagundalairajendran', 'dharmindran']",3,"['muhammadfahmim2020', None, 'hln_04']",33,"['aimenfatimah', 'apoorva.limaye', 'muhd_amir97', 'muhammadfahmim2020', 'hziq97', 'syafiqah97', 'azrulaiman', 'dayana83', 'wanalhafiz97', 'nilamsarib081810464', 'aniket.nadkarni', 'huzaimahb081810113', 'fadhil123', 'megala97', 'famirk65', 'fahmim95', 'nurelmiera99', 'shraddha2002', 'tasnimnasir96', None, 'nurazwab081810444', 'tafa97', 'azimighani', 'vedant', 'imansulaiman', 'hln_04', 'eddie97', 'sham1997', 'arohishinde2302', 'yurimdias', 'sagundalairajendran', 'dharmindran', 'kelvinho0313']"
34,58,31,7,6,"['imansulaiman', 'fahmim95', 'eddie97', 'muhd_amir97', 'tasnimnasir96', 'kelvinho0313']",24,"['aimenfatimah', 'apoorva.limaye', 'hziq97', 'syafiqah97', 'azrulaiman', 'dayana83', 'wanalhafiz97', 'nilamsarib081810464', 'aniket.nadkarni', 'huzaimahb081810113', 'fadhil123', 'megala97', 'famirk65', 'nurelmiera99', 'shraddha2002', 'tafa97', 'nurazwab081810444', 'azimighani', 'vedant', 'sham1997', 'arohishinde2302', 'yurimdias', 'sagundalairajendran', 'dharmindran']",1,[None],31,"['aimenfatimah', 'fadhil123', 'megala97', 'famirk65', 'fahmim95', 'nurelmiera99', 'apoorva.limaye', 'muhd_amir97', 'shraddha2002', 'tasnimnasir96', None, 'nurazwab081810444', 'tafa97', 'hziq97', 'azimighani', 'vedant', 'imansulaiman', 'nilamsarib081810464', 'eddie97', 'sham1997', 'syafiqah97', 'azrulaiman', 'arohishinde2302', 'dayana83', 'yurimdias', 'wanalhafiz97', 'sagundalairajendran', 'aniket.nadkarni', 'dharmindran', 'kelvinho0313', 'huzaimahb081810113']"
35,302,31,14,11,"['emilywm', 'theodore1193', 'matt_bliss', 'barberthomas9', 'tobynoahhawk', 'samjago1', 'xhu', 'jezzemy22', 'nuttyh123', 'ailishwatts10', 'nanohub_account']",19,"['lochlanmcgregor', 'xxsunpeng', 'shemsar', 'joshfeast01', 'hxllywilson', 'roryrayland', 'alexbrown2', 'rumendhesi', 'claudiaduval007', 'holzmitchell', 'tom.bush411', 'davidnutt', 'ka010343', 'akirahomu', 'chardredge00', 'raghuramilango', 'adamshepp', 'cdavies', 'avni12']",3,"['hrithika05', None, 'romilly.hryczanek']",33,"['lochlanmcgregor', 'romilly.hryczanek', 'xxsunpeng', 'samjago1', 'jezzemy22', 'hrithika05', 'nanohub_account', 'emilywm', 'shemsar', 'matt_bliss', 'joshfeast01', 'hxllywilson', 'xhu', 'roryrayland', 'cdavies', 'ailishwatts10', 'alexbrown2', 'rumendhesi', 'claudiaduval007', 'holzmitchell', 'theodore1193', 'barberthomas9', 'tom.bush411', 'davidnutt', 'ka010343', None, 'akirahomu', 'tobynoahhawk', 'chardredge00', 'raghuramilango', 'adamshepp', 'nuttyh123', 'avni12']"
35,299,31,9,8,"['rumendhesi', 'claudiaduval007', 'shemsar', 'joshfeast01', 'chardredge00', 'adamshepp', 'cdavies', 'avni12']",22,"['lochlanmcgregor', 'xxsunpeng', 'samjago1', 'jezzemy22', 'nanohub_account', 'emilywm', 'matt_bliss', 'hxllywilson', 'xhu', 'roryrayland', 'ailishwatts10', 'alexbrown2', 'holzmitchell', 'theodore1193', 'barberthomas9', 'tom.bush411', 'davidnutt', 'ka010343', 'akirahomu', 'tobynoahhawk', 'raghuramilango', 'nuttyh123']",1,[None],31,"['lochlanmcgregor', 'xxsunpeng', 'samjago1', 'jezzemy22', 'nanohub_account', 'emilywm', 'shemsar', 'matt_bliss', 'joshfeast01', 'hxllywilson', 'xhu', 'roryrayland', 'cdavies', 'ailishwatts10', 'alexbrown2', 'rumendhesi', 'claudiaduval007', 'holzmitchell', 'theodore1193', 'barberthomas9', 'tom.bush411', 'davidnutt', 'ka010343', None, 'akirahomu', 'tobynoahhawk', 'chardredge00', 'raghuramilango', 'adamshepp', 'nuttyh123', 'avni12']"
35,300,31,9,8,"['rumendhesi', 'holzmitchell', 'lochlanmcgregor', 'chardredge00', 'hxllywilson', 'cdavies', 'avni12', 'nanohub_account']",22,"['xxsunpeng', 'samjago1', 'jezzemy22', 'emilywm', 'shemsar', 'matt_bliss', 'joshfeast01', 'xhu', 'roryrayland', 'ailishwatts10', 'alexbrown2', 'claudiaduval007', 'theodore1193', 'barberthomas9', 'tom.bush411', 'davidnutt', 'ka010343', 'akirahomu', 'tobynoahhawk', 'raghuramilango', 'adamshepp', 'nuttyh123']",1,[None],31,"['lochlanmcgregor', 'xxsunpeng', 'samjago1', 'jezzemy22', 'nanohub_account', 'emilywm', 'shemsar', 'matt_bliss', 'joshfeast01', 'hxllywilson', 'xhu', 'roryrayland', 'cdavies', 'ailishwatts10', 'alexbrown2', 'rumendhesi', 'claudiaduval007', 'holzmitchell', 'theodore1193', 'barberthomas9', 'tom.bush411', 'davidnutt', 'ka010343', None, 'akirahomu', 'tobynoahhawk', 'chardredge00', 'raghuramilango', 'adamshepp', 'nuttyh123', 'avni12']"
35,301,31,6,4,"['holzmitchell', 'roryrayland', 'ka010343', 'tom.bush411']",26,"['rumendhesi', 'claudiaduval007', 'lochlanmcgregor', 'theodore1193', 'barberthomas9', 'xxsunpeng', 'samjago1', 'jezzemy22', 'davidnutt', 'avni12', 'nuttyh123', 'nanohub_account', 'emilywm', 'shemsar', 'matt_bliss', 'joshfeast01', 'akirahomu', 'tobynoahhawk', 'chardredge00', 'raghuramilango', 'adamshepp', 'hxllywilson', 'xhu', 'cdavies', 'ailishwatts10', 'alexbrown2']",2,"['hrithika05', None]",32,"['rumendhesi', 'claudiaduval007', 'holzmitchell', 'lochlanmcgregor', 'theodore1193', 'barberthomas9', 'tom.bush411', 'xxsunpeng', 'samjago1', 'jezzemy22', 'davidnutt', 'ka010343', 'avni12', 'hrithika05', 'nuttyh123', None, 'nanohub_account', 'emilywm', 'roryrayland', 'shemsar', 'matt_bliss', 'joshfeast01', 'akirahomu', 'tobynoahhawk', 'chardredge00', 'raghuramilango', 'adamshepp', 'hxllywilson', 'xhu', 'cdavies', 'ailishwatts10', 'alexbrown2']"
36,101,30,14,9,"['gandmdanda', 'rohan2804', 'yakarsh09', 'dhushyanth5602', 'jagadjaina06', 'sakshisingh7985252', 'vikmeena2009', 'thisisprajjwal', 'check11']",20,"['margarita.lisovenko', 'hrishita14', 'ankit717', 'shreyaswikriti', 'deepu_13', 'goyaladitya223', 'jigyasha2001', 'diksha11', 'ashuy0501', 'champ.divs1739', 'hritik11', 'rohithbvs5995', 'naruto_uzamaki', 'nbpvm12engg', 'pavansaidundangi', 'valeria.alvarado', 'linux', 'ovd0312', 'jonnakutieshwar13', 'abhi1']",5,"['mzentner', 'ishahid.me', 'areicks2', None, 'vishal_bhushan_']",34,"['margarita.lisovenko', 'mzentner', 'ishahid.me', 'hrishita14', 'ankit717', 'shreyaswikriti', 'sakshisingh7985252', 'deepu_13', 'goyaladitya223', 'areicks2', 'vishal_bhushan_', 'gandmdanda', 'jigyasha2001', 'diksha11', 'vikmeena2009', 'thisisprajjwal', 'ashuy0501', 'champ.divs1739', 'rohan2804', 'hritik11', 'yakarsh09', 'rohithbvs5995', 'dhushyanth5602', 'naruto_uzamaki', None, 'nbpvm12engg', 'pavansaidundangi', 'jagadjaina06', 'valeria.alvarado', 'linux', 'check11', 'ovd0312', 'jonnakutieshwar13', 'abhi1']"
36,103,30,14,5,"['gandmdanda', 'jigyasha2001', 'naruto_uzamaki', 'thisisprajjwal', 'ashuy0501']",24,"['margarita.lisovenko', 'hrishita14', 'ankit717', 'shreyaswikriti', 'sakshisingh7985252', 'deepu_13', 'goyaladitya223', 'diksha11', 'vikmeena2009', 'champ.divs1739', 'rohan2804', 'hritik11', 'yakarsh09', 'rohithbvs5995', 'dhushyanth5602', 'nbpvm12engg', 'pavansaidundangi', 'jagadjaina06', 'valeria.alvarado', 'linux', 'check11', 'ovd0312', 'jonnakutieshwar13', 'abhi1']",9,"['arsalan.siddique007', 'zeeshanttps', 'osmosium', 'madhur1999', 'shreya1024', 'gauravrai1207', 'nktanurag2020', None, 'slowbutdetermined']",38,"['margarita.lisovenko', 'hrishita14', 'ankit717', 'shreyaswikriti', 'sakshisingh7985252', 'deepu_13', 'madhur1999', 'nktanurag2020', 'goyaladitya223', 'gandmdanda', 'jigyasha2001', 'arsalan.siddique007', 'diksha11', 'shreya1024', 'vikmeena2009', 'gauravrai1207', 'thisisprajjwal', 'ashuy0501', 'champ.divs1739', 'slowbutdetermined', 'rohan2804', 'hritik11', 'yakarsh09', 'rohithbvs5995', 'dhushyanth5602', 'osmosium', 'naruto_uzamaki', None, 'nbpvm12engg', 'zeeshanttps', 'pavansaidundangi', 'jagadjaina06', 'valeria.alvarado', 'linux', 'check11', 'ovd0312', 'jonnakutieshwar13', 'abhi1']"
36,102,30,9,4,"['diksha11', 'pavansaidundangi', 'thisisprajjwal', 'hritik11']",25,"['margarita.lisovenko', 'hrishita14', 'ankit717', 'shreyaswikriti', 'sakshisingh7985252', 'deepu_13', 'goyaladitya223', 'gandmdanda', 'jigyasha2001', 'vikmeena2009', 'ashuy0501', 'champ.divs1739', 'rohan2804', 'yakarsh09', 'rohithbvs5995', 'dhushyanth5602', 'naruto_uzamaki', 'nbpvm12engg', 'jagadjaina06', 'valeria.alvarado', 'linux', 'check11', 'ovd0312', 'jonnakutieshwar13', 'abhi1']",5,"['gangadharareddy8976', 'sephalishradha', 'madhur1999', 'amitmax123', None]",34,"['margarita.lisovenko', 'hrishita14', 'ankit717', 'shreyaswikriti', 'sakshisingh7985252', 'deepu_13', 'madhur1999', 'goyaladitya223', 'gandmdanda', 'jigyasha2001', 'gangadharareddy8976', 'diksha11', 'vikmeena2009', 'thisisprajjwal', 'ashuy0501', 'champ.divs1739', 'rohan2804', 'hritik11', 'sephalishradha', 'yakarsh09', 'rohithbvs5995', 'dhushyanth5602', 'naruto_uzamaki', None, 'nbpvm12engg', 'pavansaidundangi', 'jagadjaina06', 'amitmax123', 'valeria.alvarado', 'linux', 'check11', 'ovd0312', 'jonnakutieshwar13', 'abhi1']"
36,105,30,7,2,"['jagadjaina06', 'hrishita14']",27,"['margarita.lisovenko', 'ankit717', 'shreyaswikriti', 'sakshisingh7985252', 'deepu_13', 'goyaladitya223', 'gandmdanda', 'jigyasha2001', 'diksha11', 'vikmeena2009', 'thisisprajjwal', 'ashuy0501', 'champ.divs1739', 'rohan2804', 'hritik11', 'yakarsh09', 'rohithbvs5995', 'dhushyanth5602', 'naruto_uzamaki', 'nbpvm12engg', 'pavansaidundangi', 'valeria.alvarado', 'linux', 'check11', 'ovd0312', 'jonnakutieshwar13', 'abhi1']",5,"['abhigupta.4g', 'patil.anish99', 'vudeshmukh', 'saurabhshah1505', None]",34,"['margarita.lisovenko', 'hrishita14', 'rohan2804', 'ankit717', 'hritik11', 'yakarsh09', 'check11', 'rohithbvs5995', 'shreyaswikriti', 'dhushyanth5602', 'sakshisingh7985252', 'deepu_13', 'naruto_uzamaki', 'saurabhshah1505', None, 'nbpvm12engg', 'goyaladitya223', 'vudeshmukh', 'gandmdanda', 'jigyasha2001', 'pavansaidundangi', 'abhigupta.4g', 'jagadjaina06', 'diksha11', 'vikmeena2009', 'patil.anish99', 'thisisprajjwal', 'valeria.alvarado', 'linux', 'jonnakutieshwar13', 'ashuy0501', 'ovd0312', 'champ.divs1739', 'abhi1']"
36,106,30,7,3,"['ashuy0501', 'champ.divs1739', 'hritik11']",26,"['margarita.lisovenko', 'hrishita14', 'ankit717', 'shreyaswikriti', 'sakshisingh7985252', 'deepu_13', 'goyaladitya223', 'gandmdanda', 'jigyasha2001', 'diksha11', 'vikmeena2009', 'thisisprajjwal', 'rohan2804', 'yakarsh09', 'rohithbvs5995', 'dhushyanth5602', 'naruto_uzamaki', 'nbpvm12engg', 'pavansaidundangi', 'jagadjaina06', 'valeria.alvarado', 'linux', 'check11', 'ovd0312', 'jonnakutieshwar13', 'abhi1']",4,"['abhigupta.4g', 'kiara143uttu', None, 'madhur1999']",33,"['margarita.lisovenko', 'hrishita14', 'rohan2804', 'ankit717', 'hritik11', 'yakarsh09', 'check11', 'rohithbvs5995', 'shreyaswikriti', 'dhushyanth5602', 'sakshisingh7985252', 'deepu_13', 'madhur1999', 'naruto_uzamaki', None, 'nbpvm12engg', 'goyaladitya223', 'gandmdanda', 'jigyasha2001', 'pavansaidundangi', 'abhigupta.4g', 'jagadjaina06', 'diksha11', 'vikmeena2009', 'thisisprajjwal', 'valeria.alvarado', 'linux', 'jonnakutieshwar13', 'kiara143uttu', 'ashuy0501', 'ovd0312', 'champ.divs1739', 'abhi1']"
37,181,29,98,4,"['sail', 'hvr', 'jwat', 'alotaibi']",24,"['ams32', 'zmbrown2', 'amlansen100', 'jzhou339', 'kcheung22', 'cwils24', 'ndawson', 'lsanche7', 'machterman', 'tamara_soto', 'cmousoul', 'engelsudoka', 'yccadver', 'bryanleecruz', 'melaniehacopian', 'paulmather', 'ibojanini', 'dbsgh0919', 'simon.foo', 'ebonyflower2018', 'chloesharp0916', 'ang18', 'sefinley', 'oliverpichardo']",94,"['psalek', 'federicozappaterra', 'ryan103', 'seo71', 'ziyang', 'fixa', 'paulsonj', 'desai61', 'esalata', 'hamastahir19', 'mcclurez', 'jverduzc', 'mistry7', 'ggrechis', 'chientzulin', 'dhalbroo', 'cwishard', 'mfarnell', 'mrouleau', 'dsdubbel', 'zchang', 'hnowak', 'aharroun', 'maldonl', 'ctrautma', 'qu34', 'jiang556', 'jwichlin', 'chris167', 'alafzi', 'abaniiss', 'naik26', 'olson171', 'ahads', 'mnoftz1157', 'arebassa', 'hanweizhou', 'hess35', 'sbachawa', 'xiaoli94', 'jaweibel', 'shah484', 'aprahara', 'rojas23', 'ren102', None, 'ferdoush', 'buchanaw', 'oerturk', 'rgeorgi', 'kim3247', 'ssudhak', 'mademoiselle0812', 'kdille', 'choyc', 'rapplet', 'trezitorul', 'zrhan', 'pravi', 'wang4084', 'fansler', 'odonne33', 'dfarache', 'bhatt16', 'maciasi', 'jeffkayser', 'nyudewit', 'asatput', 'sharm316', 'park1267', 'cwalchle', 'wsenior', 'hguangshuai', 'hong263', 'xils2009', 'strachan', 'dely', 'venkat_pulletikurthi', 'jwaimin', 'hua49', 'yadav35', 'rangarohit.s', 'psonalka', 'cemegoak', 'faltens', 'black161', 'haejik', 'dhoupt', 'csaerome', 'marisol', 'morisett', 'herna522', 'nmsnodgr', 'phill342']",122,"['ams32', 'mademoiselle0812', 'psalek', 'federicozappaterra', 'kdille', 'ryan103', 'seo71', 'ziyang', 'hvr', 'fixa', 'choyc', 'paulsonj', 'desai61', 'jwat', 'esalata', 'rapplet', 'trezitorul', 'alotaibi', 'zrhan', 'hamastahir19', 'pravi', 'mcclurez', 'machterman', 'wang4084', 'jverduzc', 'fansler', 'mistry7', 'ggrechis', 'odonne33', 'dfarache', 'bhatt16', 'chientzulin', 'maciasi', 'engelsudoka', 'dhalbroo', 'cwishard', 'jeffkayser', 'paulmather', 'nyudewit', 'asatput', 'sharm316', 'mfarnell', 'mrouleau', 'dbsgh0919', 'dsdubbel', 'zchang', 'hnowak', 'park1267', 'ebonyflower2018', 'aharroun', 'maldonl', 'ctrautma', 'cwalchle', 'ang18', 'hguangshuai', 'jiang556', 'qu34', 'wsenior', 'hong263', 'jwichlin', 'xils2009', 'strachan', 'chris167', 'alafzi', 'abaniiss', 'zmbrown2', 'jzhou339', 'amlansen100', 'naik26', 'olson171', 'ahads', 'mnoftz1157', 'dely', 'venkat_pulletikurthi', 'arebassa', 'jwaimin', 'hua49', 'yadav35', 'kcheung22', 'hanweizhou', 'cwils24', 'ndawson', 'lsanche7', 'hess35', 'sbachawa', 'rangarohit.s', 'psonalka', 'cemegoak', 'xiaoli94', 'tamara_soto', 'cmousoul', 'jaweibel', 'faltens', 'yccadver', 'shah484', 'bryanleecruz', 'aprahara', 'black161', 'melaniehacopian', 'rojas23', 'haejik', 'ibojanini', 'ren102', None, 'dhoupt', 'csaerome', 'ferdoush', 'marisol', 'morisett', 'buchanaw', 'simon.foo', 'herna522', 'oerturk', 'rgeorgi', 'nmsnodgr', 'kim3247', 'sail', 'ssudhak', 'phill342', 'chloesharp0916', 'sefinley', 'oliverpichardo']"
37,179,29,9,2,"['jwat', 'paulmather']",26,"['ams32', 'zmbrown2', 'amlansen100', 'jzhou339', 'hvr', 'kcheung22', 'cwils24', 'ndawson', 'lsanche7', 'alotaibi', 'machterman', 'tamara_soto', 'cmousoul', 'engelsudoka', 'yccadver', 'bryanleecruz', 'melaniehacopian', 'ibojanini', 'dbsgh0919', 'simon.foo', 'ebonyflower2018', 'sail', 'chloesharp0916', 'ang18', 'sefinley', 'oliverpichardo']",7,"['desai61', 'dely', 'ahads', 'jwaimin', 'jverduzc', None, 'ggrechis']",35,"['ams32', 'tamara_soto', 'cmousoul', 'engelsudoka', 'zmbrown2', 'jzhou339', 'amlansen100', 'yccadver', 'bryanleecruz', 'dely', 'melaniehacopian', 'ahads', 'paulmather', 'hvr', 'ibojanini', 'jwaimin', 'jverduzc', None, 'kcheung22', 'cwils24', 'ndawson', 'jwat', 'lsanche7', 'dbsgh0919', 'desai61', 'simon.foo', 'alotaibi', 'ebonyflower2018', 'sail', 'machterman', 'chloesharp0916', 'ang18', 'sefinley', 'oliverpichardo', 'ggrechis']"
37,178,29,8,5,"['yccadver', 'machterman', 'ibojanini', 'ang18', 'kcheung22']",23,"['ams32', 'zmbrown2', 'amlansen100', 'jzhou339', 'hvr', 'cwils24', 'ndawson', 'jwat', 'lsanche7', 'alotaibi', 'tamara_soto', 'cmousoul', 'engelsudoka', 'bryanleecruz', 'melaniehacopian', 'paulmather', 'dbsgh0919', 'simon.foo', 'ebonyflower2018', 'sail', 'chloesharp0916', 'sefinley', 'oliverpichardo']",3,"['yccdharma', 'venusng0630', None]",31,"['ams32', 'tamara_soto', 'cmousoul', 'engelsudoka', 'zmbrown2', 'jzhou339', 'amlansen100', 'yccadver', 'bryanleecruz', 'melaniehacopian', 'paulmather', 'hvr', 'ibojanini', None, 'kcheung22', 'yccdharma', 'cwils24', 'ndawson', 'jwat', 'lsanche7', 'dbsgh0919', 'venusng0630', 'simon.foo', 'alotaibi', 'ebonyflower2018', 'sail', 'machterman', 'chloesharp0916', 'ang18', 'sefinley', 'oliverpichardo']"
37,180,29,8,5,"['yccadver', 'melaniehacopian', 'machterman', 'ibojanini', 'kcheung22']",23,"['ams32', 'zmbrown2', 'amlansen100', 'jzhou339', 'hvr', 'cwils24', 'ndawson', 'jwat', 'lsanche7', 'alotaibi', 'tamara_soto', 'cmousoul', 'engelsudoka', 'bryanleecruz', 'paulmather', 'dbsgh0919', 'simon.foo', 'ebonyflower2018', 'sail', 'chloesharp0916', 'ang18', 'sefinley', 'oliverpichardo']",3,"['yccdharma', 'venusng0630', None]",31,"['ams32', 'tamara_soto', 'cmousoul', 'engelsudoka', 'zmbrown2', 'jzhou339', 'amlansen100', 'yccadver', 'bryanleecruz', 'melaniehacopian', 'paulmather', 'hvr', 'ibojanini', None, 'kcheung22', 'yccdharma', 'cwils24', 'ndawson', 'jwat', 'lsanche7', 'dbsgh0919', 'venusng0630', 'simon.foo', 'alotaibi', 'ebonyflower2018', 'sail', 'machterman', 'chloesharp0916', 'ang18', 'sefinley', 'oliverpichardo']"
38,246,28,20,17,"['jdelgadocastano46', 'javierld1993', 'aitorarredondo1', 'vilella.tania', '97miguelsanchez', 'martaha', 'irelealr', 'beatriz.navarro', 'ornellaricciardi', 'ivancampuzanoval', 'soheil_mtr', 'nacho96', 'd.alfonso', 'capi97', 'vilray', 'miguel.blevita98', 'guilleasens']",10,"['jjgalera', 'vuppala.bharath2020', 'andrea.cdiaz', 'daxpatel11', 'itziar.slozano', 'ashmisaikia2', 'celialucas', 'maazallah', 'pedritocabanas', 'izquierdopais']",3,"['yukyoungryu86', 'albosca', None]",30,"['yukyoungryu86', 'jjgalera', 'celialucas', 'irelealr', 'albosca', 'aitorarredondo1', 'itziar.slozano', 'maazallah', 'soheil_mtr', 'nacho96', 'd.alfonso', 'vilray', 'miguel.blevita98', 'beatriz.navarro', 'izquierdopais', 'guilleasens', 'vilella.tania', 'martaha', 'ornellaricciardi', 'pedritocabanas', None, 'capi97', 'jdelgadocastano46', 'javierld1993', 'vuppala.bharath2020', 'andrea.cdiaz', 'daxpatel11', 'ashmisaikia2', 'ivancampuzanoval', '97miguelsanchez']"
38,245,28,19,17,"['javierld1993', 'jjgalera', 'aitorarredondo1', 'miguel.blevita98', 'vilella.tania', 'jdelgadocastano46', 'andrea.cdiaz', '97miguelsanchez', 'martaha', 'irelealr', 'ornellaricciardi', 'ivancampuzanoval', 'soheil_mtr', 'd.alfonso', 'vilray', 'beatriz.navarro', 'capi97']",10,"['vuppala.bharath2020', 'daxpatel11', 'itziar.slozano', 'izquierdopais', 'ashmisaikia2', 'celialucas', 'maazallah', 'pedritocabanas', 'nacho96', 'guilleasens']",2,"['yukyoungryu86', None]",29,"['yukyoungryu86', 'jjgalera', 'celialucas', 'irelealr', 'aitorarredondo1', 'itziar.slozano', 'maazallah', 'soheil_mtr', 'nacho96', 'd.alfonso', 'vilray', 'miguel.blevita98', 'beatriz.navarro', 'izquierdopais', 'guilleasens', 'vilella.tania', 'martaha', 'ornellaricciardi', 'pedritocabanas', None, 'capi97', 'jdelgadocastano46', 'javierld1993', 'vuppala.bharath2020', 'andrea.cdiaz', 'daxpatel11', 'ashmisaikia2', 'ivancampuzanoval', '97miguelsanchez']"
38,251,28,13,1,['vuppala.bharath2020'],26,"['jjgalera', 'celialucas', 'irelealr', 'aitorarredondo1', 'itziar.slozano', 'maazallah', 'soheil_mtr', 'nacho96', 'd.alfonso', 'vilray', 'miguel.blevita98', 'beatriz.navarro', 'izquierdopais', 'guilleasens', 'vilella.tania', 'martaha', 'ornellaricciardi', 'pedritocabanas', 'capi97', 'jdelgadocastano46', 'javierld1993', 'andrea.cdiaz', 'daxpatel11', 'ashmisaikia2', 'ivancampuzanoval', '97miguelsanchez']",12,"['sreeker_tirunagari', 'sandra.pillai9', 'amkreddy', 'manikantesh.karimikonda', 'jyothiprakash', 'avulamanojkumarreddy', 'rishmitha', 'hemasudha', 'anandsai462', None, 'sandra.b2020', 'saipavan123']",39,"['sreeker_tirunagari', 'sandra.pillai9', 'jjgalera', 'amkreddy', 'manikantesh.karimikonda', 'celialucas', 'irelealr', 'sandra.b2020', 'aitorarredondo1', 'itziar.slozano', 'maazallah', 'soheil_mtr', 'nacho96', 'd.alfonso', 'rishmitha', 'vilray', 'hemasudha', 'miguel.blevita98', 'beatriz.navarro', 'izquierdopais', 'guilleasens', 'anandsai462', 'saipavan123', 'vilella.tania', 'martaha', 'ornellaricciardi', 'pedritocabanas', None, 'capi97', 'jdelgadocastano46', 'javierld1993', 'vuppala.bharath2020', 'andrea.cdiaz', 'daxpatel11', 'ashmisaikia2', 'ivancampuzanoval', 'avulamanojkumarreddy', '97miguelsanchez', 'jyothiprakash']"
38,244,28,12,10,"['javierld1993', 'jjgalera', 'martaha', 'beatriz.navarro', 'ivancampuzanoval', 'soheil_mtr', 'guilleasens', '97miguelsanchez', 'miguel.blevita98', 'capi97']",17,"['jdelgadocastano46', 'aitorarredondo1', 'vuppala.bharath2020', 'vilella.tania', 'andrea.cdiaz', 'itziar.slozano', 'daxpatel11', 'ashmisaikia2', 'celialucas', 'irelealr', 'maazallah', 'ornellaricciardi', 'pedritocabanas', 'nacho96', 'd.alfonso', 'vilray', 'izquierdopais']",2,"['yukyoungryu86', None]",29,"['yukyoungryu86', 'jjgalera', 'celialucas', 'irelealr', 'aitorarredondo1', 'itziar.slozano', 'maazallah', 'soheil_mtr', 'nacho96', 'd.alfonso', 'vilray', 'miguel.blevita98', 'beatriz.navarro', 'izquierdopais', 'guilleasens', 'vilella.tania', 'martaha', 'ornellaricciardi', 'pedritocabanas', None, 'capi97', 'jdelgadocastano46', 'javierld1993', 'vuppala.bharath2020', 'andrea.cdiaz', 'daxpatel11', 'ashmisaikia2', 'ivancampuzanoval', '97miguelsanchez']"
39,458,27,21,17,"['anthonyle5696', 'vj84', 'mjm697', 'hieutrinh1229', 'tc636', 'ylam20', 'jyk38', 'hieutrinh0401', 'jparks', 'nashita.akanda', 'clanum675', 'brycopp', 'sure25', 'n.h.trung171', 'lkline02', 'loveyourlobe', 'awhowcroft']",9,"['lh669', 'joeywutamu', 'njbanks', 'vab66', 'alesha1arshad', 'y123', 'steviparker', 'drarcade99', 'chasejiannotti']",4,"['dmr5688', 'sohlbergk', None, 'jto5096']",30,"['jto5096', 'hieutrinh0401', 'jparks', 'n.h.trung171', 'lkline02', 'loveyourlobe', 'hieutrinh1229', 'clanum675', 'alesha1arshad', 'sohlbergk', 'drarcade99', 'anthonyle5696', 'lh669', 'mjm697', 'tc636', 'joeywutamu', 'njbanks', 'nashita.akanda', 'y123', 'sure25', 'steviparker', 'brycopp', None, 'awhowcroft', 'chasejiannotti', 'ylam20', 'jyk38', 'dmr5688', 'vj84', 'vab66']"
40,330,27,22,18,"['iyeng', 'yshim2', 'jlabarge', 'pkoiral1', 'ziyihe5', 'mpatoary', 'tienvo1', 'rayyoub1', 'jacharje', 'krusyn', 'xuhan', 'jxie72', 'sayyoub1', 'zhizhouh', 'hlriley', 'aaltaya1', 'gzhou18', 'keerthisuram']",8,"['acquadiaprile', 'mmieir', 'pbrudnyi', 'mvkane', 'sos850516', 'mmckay3', 'jprospe1', 'jmart174']",4,"['nrosenb1', None, 'vasileska', 'asnaray2']",30,"['pbrudnyi', 'asnaray2', 'jxie72', 'jmart174', 'sayyoub1', 'vasileska', 'aaltaya1', 'keerthisuram', 'yshim2', 'jlabarge', 'pkoiral1', 'rayyoub1', 'tienvo1', 'jprospe1', 'hlriley', 'acquadiaprile', 'iyeng', 'mmieir', 'mvkane', 'sos850516', 'mmckay3', 'krusyn', 'xuhan', 'gzhou18', None, 'ziyihe5', 'mpatoary', 'jacharje', 'zhizhouh', 'nrosenb1']"
41,527,26,21,17,"['mjwilkin', 'bwebler', 'rburnley', 'meizhonl', 'samihab', 'yuyang', 'liuxing', 'jingyuta', 'dlanigan', 'ahwang', 'spattabi', 'jpauza', 'mayabhat', 'mbapat', 'mochsend', 'rrailkar', 'xinshenw']",8,"['bjchung', 'jpwilson', 'iron_boy809', 'bagili', 'jpyeon', 'xuesenx', 'mokamura98', 'sigdel2018']",4,"[None, 'ashadman', 'anqiq66', 'jcaulkin']",29,"['ashadman', 'bjchung', 'samihab', 'yuyang', 'liuxing', 'ahwang', 'xuesenx', 'mokamura98', 'sigdel2018', 'bwebler', 'jpwilson', 'anqiq66', 'jpyeon', 'mochsend', 'xinshenw', 'mjwilkin', 'rburnley', 'jingyuta', 'spattabi', 'jpauza', 'bagili', 'mbapat', 'rrailkar', None, 'meizhonl', 'dlanigan', 'jcaulkin', 'iron_boy809', 'mayabhat']"
41,532,26,12,4,"['mjwilkin', 'jingyuta', 'jpauza', 'bjchung']",21,"['samihab', 'yuyang', 'liuxing', 'ahwang', 'xuesenx', 'mokamura98', 'sigdel2018', 'bwebler', 'jpwilson', 'jpyeon', 'xinshenw', 'mochsend', 'rburnley', 'spattabi', 'bagili', 'mbapat', 'rrailkar', 'meizhonl', 'dlanigan', 'iron_boy809', 'mayabhat']",8,"['lingxiam', 'siyugao12', 'jcaulkin', 'anqiq66', 'sethiraj', 'shengjif', 'shipraks', None]",33,"['mjwilkin', 'rburnley', 'bjchung', 'samihab', 'yuyang', 'liuxing', 'jingyuta', 'siyugao12', 'ahwang', 'spattabi', 'jpauza', 'bagili', 'mayabhat', 'mbapat', 'rrailkar', 'xuesenx', 'sethiraj', 'mokamura98', 'shengjif', 'shipraks', None, 'sigdel2018', 'lingxiam', 'bwebler', 'meizhonl', 'dlanigan', 'jcaulkin', 'jpwilson', 'iron_boy809', 'anqiq66', 'jpyeon', 'mochsend', 'xinshenw']"
41,530,26,7,5,"['meizhonl', 'bjchung', 'liuxing', 'jingyuta', 'mbapat']",20,"['samihab', 'yuyang', 'ahwang', 'xuesenx', 'mokamura98', 'sigdel2018', 'bwebler', 'jpwilson', 'jpyeon', 'xinshenw', 'mochsend', 'mjwilkin', 'rburnley', 'spattabi', 'jpauza', 'bagili', 'rrailkar', 'dlanigan', 'iron_boy809', 'mayabhat']",2,"['jcaulkin', None]",27,"['mjwilkin', 'rburnley', 'bjchung', 'samihab', 'yuyang', 'liuxing', 'jingyuta', 'ahwang', 'spattabi', 'jpauza', 'bagili', 'mayabhat', 'mbapat', 'rrailkar', 'xuesenx', 'mokamura98', None, 'sigdel2018', 'bwebler', 'meizhonl', 'dlanigan', 'jcaulkin', 'jpwilson', 'iron_boy809', 'jpyeon', 'mochsend', 'xinshenw']"
41,531,26,7,5,"['meizhonl', 'bjchung', 'liuxing', 'jingyuta', 'mbapat']",20,"['samihab', 'yuyang', 'ahwang', 'xuesenx', 'mokamura98', 'sigdel2018', 'bwebler', 'jpwilson', 'jpyeon', 'xinshenw', 'mochsend', 'mjwilkin', 'rburnley', 'spattabi', 'jpauza', 'bagili', 'rrailkar', 'dlanigan', 'iron_boy809', 'mayabhat']",2,"['jcaulkin', None]",27,"['mjwilkin', 'rburnley', 'bjchung', 'samihab', 'yuyang', 'liuxing', 'jingyuta', 'ahwang', 'spattabi', 'jpauza', 'bagili', 'mayabhat', 'mbapat', 'rrailkar', 'xuesenx', 'mokamura98', None, 'sigdel2018', 'bwebler', 'meizhonl', 'dlanigan', 'jcaulkin', 'jpwilson', 'iron_boy809', 'jpyeon', 'mochsend', 'xinshenw']"
42,325,26,24,13,"['mvidali', 'oreomodi', 'ncm1', 'bbamidel', 'rtlockar', 'kaufmazc', 'eglockwo', 'dawsthom', 'logcleav', 'thayik', 'dmc2', 'schmija', 'cooyoung']",12,"['etatman', 'giagonza', 'katestinson', 'barnecle', 'badunawa', 'jonott', 'proesler', 'jyadav', 'ajfunari', 'alshamsm', 'bzettek', 'carmhern']",11,"['cookce', 'inavarre', 'algodfre', 'hayesde', 'josbella', 'dehansen', 'thommoor', 'loghouch', 'garrfair', None, 'middletc']",36,"['giagonza', 'cookce', 'proesler', 'dawsthom', 'jyadav', 'ajfunari', 'dehansen', 'thommoor', 'schmija', 'carmhern', 'middletc', 'ncm1', 'oreomodi', 'rtlockar', 'eglockwo', 'hayesde', 'alshamsm', 'dmc2', 'garrfair', 'cooyoung', 'mvidali', 'etatman', 'kaufmazc', 'katestinson', 'inavarre', 'barnecle', 'josbella', None, 'algodfre', 'bbamidel', 'badunawa', 'jonott', 'logcleav', 'thayik', 'bzettek', 'loghouch']"
42,327,26,24,14,"['mvidali', 'oreomodi', 'ncm1', 'bbamidel', 'rtlockar', 'kaufmazc', 'eglockwo', 'badunawa', 'dawsthom', 'logcleav', 'thayik', 'dmc2', 'schmija', 'cooyoung']",11,"['etatman', 'giagonza', 'katestinson', 'barnecle', 'jonott', 'proesler', 'jyadav', 'ajfunari', 'alshamsm', 'bzettek', 'carmhern']",10,"['cookce', 'inavarre', 'algodfre', 'hayesde', 'dehansen', 'thommoor', 'loghouch', 'garrfair', None, 'middletc']",35,"['giagonza', 'cookce', 'proesler', 'dawsthom', 'jyadav', 'ajfunari', 'dehansen', 'thommoor', 'schmija', 'carmhern', 'middletc', 'ncm1', 'oreomodi', 'rtlockar', 'eglockwo', 'hayesde', 'alshamsm', 'dmc2', 'garrfair', 'cooyoung', 'mvidali', 'etatman', 'kaufmazc', 'katestinson', 'inavarre', 'barnecle', None, 'algodfre', 'bbamidel', 'badunawa', 'jonott', 'logcleav', 'thayik', 'bzettek', 'loghouch']"
42,329,26,24,15,"['mvidali', 'oreomodi', 'ncm1', 'bbamidel', 'rtlockar', 'kaufmazc', 'eglockwo', 'jonott', 'dawsthom', 'logcleav', 'thayik', 'dmc2', 'schmija', 'cooyoung', 'carmhern']",10,"['etatman', 'giagonza', 'katestinson', 'barnecle', 'badunawa', 'proesler', 'jyadav', 'alshamsm', 'ajfunari', 'bzettek']",9,"['cookce', 'inavarre', 'algodfre', 'dehansen', 'thommoor', 'loghouch', 'garrfair', None, 'middletc']",34,"['giagonza', 'cookce', 'proesler', 'dawsthom', 'jyadav', 'ajfunari', 'dehansen', 'thommoor', 'schmija', 'carmhern', 'middletc', 'ncm1', 'oreomodi', 'rtlockar', 'eglockwo', 'alshamsm', 'dmc2', 'garrfair', 'cooyoung', 'mvidali', 'etatman', 'kaufmazc', 'katestinson', 'inavarre', 'barnecle', None, 'algodfre', 'bbamidel', 'badunawa', 'jonott', 'logcleav', 'thayik', 'bzettek', 'loghouch']"
42,525,26,24,14,"['oreomodi', 'ncm1', 'bbamidel', 'rtlockar', 'kaufmazc', 'eglockwo', 'badunawa', 'jonott', 'dawsthom', 'logcleav', 'thayik', 'dmc2', 'schmija', 'cooyoung']",11,"['mvidali', 'etatman', 'giagonza', 'katestinson', 'barnecle', 'proesler', 'jyadav', 'ajfunari', 'alshamsm', 'bzettek', 'carmhern']",10,"['cookce', 'inavarre', 'algodfre', 'josbella', 'dehansen', 'thommoor', 'loghouch', 'garrfair', None, 'middletc']",35,"['giagonza', 'cookce', 'proesler', 'dawsthom', 'jyadav', 'ajfunari', 'dehansen', 'thommoor', 'schmija', 'carmhern', 'middletc', 'ncm1', 'oreomodi', 'rtlockar', 'eglockwo', 'alshamsm', 'dmc2', 'garrfair', 'cooyoung', 'mvidali', 'etatman', 'kaufmazc', 'katestinson', 'inavarre', 'barnecle', 'josbella', None, 'algodfre', 'bbamidel', 'badunawa', 'jonott', 'logcleav', 'thayik', 'bzettek', 'loghouch']"
42,524,26,11,5,"['mvidali', 'etatman', 'eglockwo', 'jonott', 'cooyoung']",20,"['giagonza', 'proesler', 'dawsthom', 'jyadav', 'ajfunari', 'schmija', 'carmhern', 'ncm1', 'oreomodi', 'rtlockar', 'alshamsm', 'dmc2', 'kaufmazc', 'katestinson', 'barnecle', 'bbamidel', 'badunawa', 'logcleav', 'thayik', 'bzettek']",6,"['ryan.lockard22', 'ntprobst', 'hayesde', 'josbella', 'mfmitsch', None]",31,"['mvidali', 'etatman', 'kaufmazc', 'giagonza', 'katestinson', 'barnecle', 'ntprobst', 'proesler', 'dawsthom', 'josbella', 'jyadav', 'ajfunari', 'mfmitsch', 'schmija', None, 'carmhern', 'ryan.lockard22', 'ncm1', 'oreomodi', 'bbamidel', 'rtlockar', 'eglockwo', 'badunawa', 'jonott', 'logcleav', 'hayesde', 'thayik', 'alshamsm', 'dmc2', 'bzettek', 'cooyoung']"
42,326,26,6,5,"['giagonza', 'thayik', 'ajfunari', 'bzettek', 'carmhern']",20,"['proesler', 'dawsthom', 'jyadav', 'schmija', 'ncm1', 'oreomodi', 'rtlockar', 'eglockwo', 'alshamsm', 'dmc2', 'cooyoung', 'mvidali', 'etatman', 'kaufmazc', 'katestinson', 'barnecle', 'bbamidel', 'badunawa', 'jonott', 'logcleav']",1,[None],26,"['mvidali', 'etatman', 'kaufmazc', 'giagonza', 'katestinson', 'barnecle', 'proesler', 'dawsthom', 'jyadav', 'ajfunari', 'schmija', None, 'carmhern', 'ncm1', 'oreomodi', 'bbamidel', 'rtlockar', 'eglockwo', 'badunawa', 'jonott', 'logcleav', 'thayik', 'alshamsm', 'dmc2', 'bzettek', 'cooyoung']"
42,526,26,6,5,"['giagonza', 'thayik', 'ajfunari', 'bzettek', 'carmhern']",20,"['proesler', 'dawsthom', 'jyadav', 'schmija', 'ncm1', 'oreomodi', 'rtlockar', 'eglockwo', 'alshamsm', 'dmc2', 'cooyoung', 'mvidali', 'etatman', 'kaufmazc', 'katestinson', 'barnecle', 'bbamidel', 'badunawa', 'jonott', 'logcleav']",1,[None],26,"['mvidali', 'etatman', 'kaufmazc', 'giagonza', 'katestinson', 'barnecle', 'proesler', 'dawsthom', 'jyadav', 'ajfunari', 'schmija', None, 'carmhern', 'ncm1', 'oreomodi', 'bbamidel', 'rtlockar', 'eglockwo', 'badunawa', 'jonott', 'logcleav', 'thayik', 'alshamsm', 'dmc2', 'bzettek', 'cooyoung']"
43,538,26,41,1,['chrisjones'],24,"['nate.johnvincent_1998', 'loreibelle', 'yup', 'jbjunio4', 'dbgatus', 'kfqpzzwa', 'mgang123', 'jaceyong24', 'lettersand23', 'hillano1', 'naisukaizu', 'slescayo', 'dj1garza', 'echotypist', 'lrpengson', 'mattmabborang', 'egevio', 'cfbaldo', 'mpsherb', 'jgmartecio', 'manas14295', 'tmrodriguez', 'iegonzaga', 'tonidicc']",40,"['dominikpanchenko', 'rileywinters', 'shanepalmer', 'miaklopfenstein', 'nicholasmckibben', 'cfranc01', 'lanlibsu', 'monicaleibowitz', 'arielweltner', 'haileemunoz', 'nickawieber', 'kincaidgraff', 'mathieucerankows', 'abiaggne', 'makaylaturner', 'forestswanson', 'fereshtehrajabik', 'egraugnard', 'quinnhulse', 'nathanthemetalsguy20', 'kaeleenovich', 'maddymckenzie', 'kylerayers320', 'cassidyhoward', 'kaileejones', 'kentonburns', 'tristanolsen', 'iankerby', 'sophiamitchell', 'madilynpaul', 'tylerhamer', 'oliviamaryon', 'cfackrell', 'isaacwolstenholme25', None, 'joshuarussell', 'annaliestipton', 'mar4557', 'nmckibben', 'davidespey']",65,"['dominikpanchenko', 'rileywinters', 'miaklopfenstein', 'nicholasmckibben', 'cfranc01', 'lanlibsu', 'monicaleibowitz', 'arielweltner', 'nickawieber', 'yup', 'jbjunio4', 'dbgatus', 'kfqpzzwa', 'mathieucerankows', 'mgang123', 'jaceyong24', 'kylerayers320', 'kaileejones', 'slescayo', 'kentonburns', 'dj1garza', 'tristanolsen', 'echotypist', 'lrpengson', 'mattmabborang', 'madilynpaul', 'cfackrell', 'joshuarussell', 'mar4557', 'cfbaldo', 'manas14295', 'davidespey', 'tonidicc', 'shanepalmer', 'nate.johnvincent_1998', 'loreibelle', 'haileemunoz', 'kincaidgraff', 'abiaggne', 'makaylaturner', 'forestswanson', 'fereshtehrajabik', 'egraugnard', 'lettersand23', 'hillano1', 'quinnhulse', 'nathanthemetalsguy20', 'kaeleenovich', 'maddymckenzie', 'chrisjones', 'naisukaizu', 'cassidyhoward', 'iankerby', 'sophiamitchell', 'tylerhamer', 'oliviamaryon', 'isaacwolstenholme25', None, 'annaliestipton', 'egevio', 'jgmartecio', 'mpsherb', 'nmckibben', 'tmrodriguez', 'iegonzaga']"
43,537,26,15,1,['chrisjones'],24,"['nate.johnvincent_1998', 'loreibelle', 'yup', 'jbjunio4', 'dbgatus', 'kfqpzzwa', 'mgang123', 'jaceyong24', 'lettersand23', 'hillano1', 'naisukaizu', 'slescayo', 'dj1garza', 'echotypist', 'lrpengson', 'mattmabborang', 'egevio', 'cfbaldo', 'mpsherb', 'jgmartecio', 'manas14295', 'tmrodriguez', 'iegonzaga', 'tonidicc']",14,"['rileywinters', 'annaliestipton', None, 'tristanolsen', 'fereshtehrajabik', 'egraugnard', 'nicholasmckibben', 'kaeleenovich', 'maddymckenzie', 'arielweltner', 'lanlibsu', 'nickawieber', 'joshuarussell', 'oliviamaryon']",39,"['rileywinters', 'nate.johnvincent_1998', 'loreibelle', 'nicholasmckibben', 'lanlibsu', 'arielweltner', 'nickawieber', 'yup', 'jbjunio4', 'dbgatus', 'kfqpzzwa', 'mgang123', 'jaceyong24', 'fereshtehrajabik', 'egraugnard', 'lettersand23', 'hillano1', 'kaeleenovich', 'maddymckenzie', 'chrisjones', 'naisukaizu', 'slescayo', 'dj1garza', 'tristanolsen', 'echotypist', 'lrpengson', 'mattmabborang', 'oliviamaryon', None, 'joshuarussell', 'annaliestipton', 'egevio', 'cfbaldo', 'mpsherb', 'jgmartecio', 'manas14295', 'tmrodriguez', 'iegonzaga', 'tonidicc']"
43,141,26,13,11,"['dbgatus', 'dj1garza', 'nate.johnvincent_1998', 'loreibelle', 'jgmartecio', 'mgang123', 'lrpengson', 'jaceyong24', 'mattmabborang', 'tmrodriguez', 'tonidicc']",14,"['jbjunio4', 'kfqpzzwa', 'chrisjones', 'egevio', 'cfbaldo', 'mpsherb', 'echotypist', 'lettersand23', 'slescayo', 'manas14295', 'hillano1', 'iegonzaga', 'naisukaizu', 'yup']",2,"[None, 'roberto_louis_moran']",27,"['nate.johnvincent_1998', 'loreibelle', 'yup', 'roberto_louis_moran', 'jbjunio4', 'dbgatus', 'kfqpzzwa', 'mgang123', 'jaceyong24', 'lettersand23', 'hillano1', 'chrisjones', 'naisukaizu', 'slescayo', 'dj1garza', 'echotypist', 'lrpengson', 'mattmabborang', None, 'egevio', 'cfbaldo', 'mpsherb', 'jgmartecio', 'manas14295', 'tmrodriguez', 'iegonzaga', 'tonidicc']"
43,140,26,12,10,"['jbjunio4', 'dbgatus', 'loreibelle', 'jgmartecio', 'mgang123', 'lrpengson', 'jaceyong24', 'tmrodriguez', 'mattmabborang', 'tonidicc']",15,"['kfqpzzwa', 'chrisjones', 'dj1garza', 'nate.johnvincent_1998', 'egevio', 'cfbaldo', 'mpsherb', 'echotypist', 'lettersand23', 'slescayo', 'manas14295', 'hillano1', 'iegonzaga', 'naisukaizu', 'yup']",2,"['evianaguilar', None]",27,"['chrisjones', 'dj1garza', 'nate.johnvincent_1998', 'loreibelle', 'echotypist', 'lrpengson', 'tonidicc', 'mattmabborang', None, 'yup', 'jbjunio4', 'dbgatus', 'kfqpzzwa', 'mgang123', 'jaceyong24', 'egevio', 'cfbaldo', 'mpsherb', 'lettersand23', 'jgmartecio', 'manas14295', 'hillano1', 'evianaguilar', 'tmrodriguez', 'iegonzaga', 'naisukaizu', 'slescayo']"
43,143,26,10,8,"['jbjunio4', 'dbgatus', 'mgang123', 'jgmartecio', 'jaceyong24', 'lrpengson', 'tmrodriguez', 'tonidicc']",17,"['kfqpzzwa', 'chrisjones', 'dj1garza', 'nate.johnvincent_1998', 'loreibelle', 'egevio', 'cfbaldo', 'echotypist', 'mpsherb', 'lettersand23', 'slescayo', 'manas14295', 'hillano1', 'mattmabborang', 'iegonzaga', 'naisukaizu', 'yup']",2,"[None, 'aria8']",27,"['chrisjones', 'dj1garza', 'nate.johnvincent_1998', 'loreibelle', 'aria8', 'echotypist', 'lrpengson', 'tonidicc', 'mattmabborang', None, 'yup', 'jbjunio4', 'dbgatus', 'kfqpzzwa', 'mgang123', 'jaceyong24', 'egevio', 'cfbaldo', 'mpsherb', 'lettersand23', 'jgmartecio', 'manas14295', 'hillano1', 'tmrodriguez', 'iegonzaga', 'naisukaizu', 'slescayo']"
43,142,26,8,7,"['dbgatus', 'mgang123', 'jgmartecio', 'jaceyong24', 'lrpengson', 'tmrodriguez', 'naisukaizu']",18,"['jbjunio4', 'kfqpzzwa', 'dj1garza', 'nate.johnvincent_1998', 'loreibelle', 'egevio', 'cfbaldo', 'echotypist', 'mpsherb', 'lettersand23', 'slescayo', 'manas14295', 'tonidicc', 'hillano1', 'mattmabborang', 'iegonzaga', 'chrisjones', 'yup']",1,[None],26,"['chrisjones', 'dj1garza', 'nate.johnvincent_1998', 'loreibelle', 'echotypist', 'lrpengson', 'tonidicc', 'mattmabborang', None, 'yup', 'jbjunio4', 'dbgatus', 'kfqpzzwa', 'mgang123', 'jaceyong24', 'egevio', 'cfbaldo', 'mpsherb', 'lettersand23', 'jgmartecio', 'manas14295', 'hillano1', 'tmrodriguez', 'iegonzaga', 'naisukaizu', 'slescayo']"
43,144,26,8,6,"['dbgatus', 'jgmartecio', 'jaceyong24', 'lrpengson', 'tmrodriguez', 'tonidicc']",19,"['nate.johnvincent_1998', 'loreibelle', 'yup', 'jbjunio4', 'kfqpzzwa', 'mgang123', 'lettersand23', 'hillano1', 'chrisjones', 'naisukaizu', 'slescayo', 'dj1garza', 'echotypist', 'mattmabborang', 'egevio', 'cfbaldo', 'mpsherb', 'manas14295', 'iegonzaga']",2,"[None, 'aria8']",27,"['chrisjones', 'dj1garza', 'nate.johnvincent_1998', 'loreibelle', 'aria8', 'echotypist', 'lrpengson', 'tonidicc', 'mattmabborang', None, 'yup', 'jbjunio4', 'dbgatus', 'kfqpzzwa', 'mgang123', 'jaceyong24', 'egevio', 'cfbaldo', 'mpsherb', 'lettersand23', 'jgmartecio', 'manas14295', 'hillano1', 'tmrodriguez', 'iegonzaga', 'naisukaizu', 'slescayo']"
44,217,25,40,5,"['kerr35', 'anifalak', 'wells89', 'mchrisiglesias717', 'malhamm']",19,"['fan264', 'zhu709', 'livingfossil', 'moyb', 'ajmuegge', 'jsomm99', 'faraz24hr', 'haroumou', 'bmoy9000', 'fnase0', 'keller', 'dludwin', 'hemanijugal', 'rharwoo', 'dmangeri', 'hart136', 'sen16', 'post16', 'dryoo']",35,"['jacobczajac', 'nqmain', 'estockwe', 'barker56', 'kim2841', 'beshay', 'carvalho', 'cdunn', 'wiley29', 'cannon333', 'huan1260', 'missahaq', 'kocher1', 'aalruhai', 'arayapro', 'yang1098', 'jabarigarraway', 'mosterk', 'aalhabsi', 'akhairul', 'shah443', None, 'sboelitz', 'scroskey', 'lopez400', 'lararipe', 'sachdev6', 'balpert', 'clark600', 'li2978', 'cwalchle', 'randy14rhh2', 'lucywagner', 'dhanixv0', 'acarrilh']",59,"['fan264', 'zhu709', 'nqmain', 'estockwe', 'barker56', 'carvalho', 'cdunn', 'cannon333', 'jsomm99', 'faraz24hr', 'missahaq', 'haroumou', 'wells89', 'kocher1', 'dludwin', 'hemanijugal', 'akhairul', 'sboelitz', 'dmangeri', 'lopez400', 'kerr35', 'sen16', 'sachdev6', 'balpert', 'clark600', 'anifalak', 'li2978', 'dryoo', 'cwalchle', 'jacobczajac', 'livingfossil', 'kim2841', 'mchrisiglesias717', 'beshay', 'moyb', 'ajmuegge', 'wiley29', 'huan1260', 'bmoy9000', 'fnase0', 'malhamm', 'keller', 'arayapro', 'jabarigarraway', 'yang1098', 'aalruhai', 'mosterk', 'aalhabsi', 'shah443', 'rharwoo', None, 'scroskey', 'hart136', 'lararipe', 'post16', 'randy14rhh2', 'lucywagner', 'dhanixv0', 'acarrilh']"
44,218,25,10,2,"['sen16', 'jsomm99']",22,"['fan264', 'zhu709', 'livingfossil', 'mchrisiglesias717', 'moyb', 'ajmuegge', 'faraz24hr', 'haroumou', 'wells89', 'bmoy9000', 'fnase0', 'malhamm', 'keller', 'dludwin', 'hemanijugal', 'rharwoo', 'dmangeri', 'hart136', 'kerr35', 'post16', 'anifalak', 'dryoo']",8,"['chakra26', 'wells130', 'bauer85', 'cdunn', 'marysemak', 'elutgen', None, 'jvanwing']",32,"['dludwin', 'bauer85', 'fan264', 'hemanijugal', 'zhu709', 'livingfossil', 'elutgen', 'mchrisiglesias717', 'rharwoo', None, 'moyb', 'dmangeri', 'hart136', 'kerr35', 'sen16', 'ajmuegge', 'chakra26', 'wells130', 'post16', 'cdunn', 'jsomm99', 'faraz24hr', 'marysemak', 'anifalak', 'haroumou', 'dryoo', 'wells89', 'bmoy9000', 'fnase0', 'malhamm', 'keller', 'jvanwing']"
44,219,25,8,2,"['fan264', 'ajmuegge']",22,"['zhu709', 'livingfossil', 'mchrisiglesias717', 'moyb', 'jsomm99', 'faraz24hr', 'haroumou', 'wells89', 'bmoy9000', 'fnase0', 'malhamm', 'keller', 'dludwin', 'hemanijugal', 'rharwoo', 'dmangeri', 'hart136', 'kerr35', 'sen16', 'post16', 'anifalak', 'dryoo']",6,"['jsendon', 'ramkumaa', 'hshrote', 'wheffern', 'jack.t.roy42', None]",30,"['dludwin', 'jsendon', 'fan264', 'hemanijugal', 'zhu709', 'ramkumaa', 'hshrote', 'livingfossil', 'wheffern', 'mchrisiglesias717', 'rharwoo', None, 'moyb', 'dmangeri', 'hart136', 'kerr35', 'sen16', 'ajmuegge', 'post16', 'jsomm99', 'faraz24hr', 'anifalak', 'haroumou', 'dryoo', 'wells89', 'jack.t.roy42', 'bmoy9000', 'fnase0', 'malhamm', 'keller']"
47,23,23,147,2,"['mostafasaleh054', 'ranaashraf129']",20,"['ahmedsamy888844', 'jaeang2019', 'ge.6cg7', 'ahmedhamdyhalawa', 'rana0100555', 's162368', 'midoayman248', 'sara.deghidy', 'ronaldo2391999', 'medosayed2020', 'mennamohamedhanafy392', 'ahmedmamin', 'karimtarek', 'mostafa.maher591999', 'sondossalah66', 'youssefelrouby4', 'mohamed1699', 'seif8128', 'ds44420', 'mahmoud.maree2010']",145,"['kirollos.atef99', 'farid1010', 'mohamedsamir2591998', 'nohaabdelazeem11', 'ahmed_mohsen', 'hehaftw', 'daniel.', 'mmhanafy99', 'heshamelsedfy111', 'amr.m.araby', 'mai99mahdy', 'mobahr', 'michelhakim2001.mh', 'badryahmed33', 'zazotop31', 'mohamedelfeeky1', 'abdelrahman98', 'abdelrahmananwar', 'michaelhelal99', 'aminsalah287', 'youlianafouad17', 'mayanmohamed', 'omar_anwer', 'amy', 'joker.man2000000', 'sadboijalal', 'fayrouz21415', 'boules', 'nadakhaled', 'moh.nabil2050', 'sarawaelahmed22', 'mohamed248688', 'abdelmoneim404', 'nadeenmagdyy', 'sal7ien1999', 'romanynashaatmakeen', 'eyadafify', 'm.trika1999', 'ahmedyosre007', 'dodynn29', 'mohameda.younis80', 'mohamed_a_mostafa', 'amr.ghoname.teaching', 'ahmedsaeed', 'nada0abou0alsoud', 'af5012175', 'kerolosmfawzy', 'raneemgaber', 'seifahmedamer', 'raa199014', 'reemayman101', 'youssefessawy', 'esraayahia21', 'taha18499', 'ahmedkamal', 'amrksh3198', 'ramezakram97', 'mernaeshakfaheem', 'moataz12mokhtar', 'jualipa1995', 'metoyahia1999', 'hmsgsaad', 'yaseensalah83', 'nayeramakram98', 'ahmedokasha1999', 'amartiger2020', 'tongmalual', 'melegy99', None, 'abdelrahman_oun', 'nourmahmoud', 'ranasherif244', 'mustafamahmoud567', 'mayaralmazy', 'bassant.ahmed235', 'hosamshaher43', 'cyrillemagdi', 'salmatarek87', 'ebrahim.almohandes', 'bassant.ahmed20118', 'medoshaban816', 'mohannadragab53', 'shadymagdy99', 'abdoulkh', 'seifelawadi26', 'btngana1', 'karim20103200', 'hosamabdallah00', 'ramymohsen', 'mayadamarie', 'omaraly112', 'engahmedsalahfathy', 'marwanahmad988', 'raniamuhamed44', 'sohamamdooh', 'yusufcheetos99', 'ziad.amr201666', 'adham99', 'generalshephrd', 'abdulrahman.hussien1999', 'josef.me22', 'mohamed.eid1014', 'harvovich', 'getray.ah', 'alaa15eltehewey', 'mohamed_98', 'ahmadatef580', 'abdallahhashim', 'youssefsamiryoussef', 'habiba.elkassas', 'haidy_emad', 'maged19991926', 'omarnabih21', 'mohamedhamdy1120000', 'mahmodfarag2000', 'yahiahamimi', 'ingyawad14', 'ahmed_omar', 'youssefhassaan99', 'ahmedmostafa5499', 'doraexplora', 'ashraf.amr82', 'nada.abomoslim', 'saca', 'mohamed.zna66', 'kareemmohamed68990', 'm_feky', 'mohamedsalah2', 'shrouk.a.emad', 'elsayedrafaat7', 'tomymoty1', 'abdoelanwar99', 'rehab.sayed1231999', 'rektxz', 'markashaf232', 'ashraf_mohamed', 'fasd556.om', 'maged.magdy666', 'mariam123456789', 'dina.23elessawy', 'nourhanne.bahaa', 'a.ayman74', 'michael29699', 'marwanyasser133', 'faridmohammed98']",167,"['kirollos.atef99', 'farid1010', 'mohamedsamir2591998', 'nohaabdelazeem11', 'ahmed_mohsen', 'hehaftw', 'daniel.', 'mmhanafy99', 'heshamelsedfy111', 'amr.m.araby', 'mai99mahdy', 'mobahr', 'michelhakim2001.mh', 'badryahmed33', 'zazotop31', 'mohamedelfeeky1', 'abdelrahman98', 'abdelrahmananwar', 'michaelhelal99', 'mennamohamedhanafy392', 'aminsalah287', 'youlianafouad17', 'mayanmohamed', 'mostafa.maher591999', 'omar_anwer', 'amy', 'joker.man2000000', 'sadboijalal', 'fayrouz21415', 'boules', 'nadakhaled', 'moh.nabil2050', 'sarawaelahmed22', 'mohamed248688', 'abdelmoneim404', 'nadeenmagdyy', 'sal7ien1999', 'romanynashaatmakeen', 'eyadafify', 'm.trika1999', 'ahmedyosre007', 'dodynn29', 'mohameda.younis80', 'mohamed_a_mostafa', 'amr.ghoname.teaching', 'ahmedsaeed', 'nada0abou0alsoud', 'af5012175', 'kerolosmfawzy', 'raneemgaber', 'seifahmedamer', 'raa199014', 'midoayman248', 'reemayman101', 'youssefessawy', 'esraayahia21', 'taha18499', 'ahmedkamal', 'amrksh3198', 'ramezakram97', 'mernaeshakfaheem', 'moataz12mokhtar', 'jualipa1995', 'karimtarek', 'metoyahia1999', 'hmsgsaad', 'sondossalah66', 'yaseensalah83', 'nayeramakram98', 'ahmedokasha1999', 'mostafasaleh054', 'amartiger2020', 'tongmalual', 'melegy99', 'youssefelrouby4', None, 'abdelrahman_oun', 'nourmahmoud', 'ranasherif244', 'mustafamahmoud567', 'mayaralmazy', 'bassant.ahmed235', 'hosamshaher43', 'cyrillemagdi', 'salmatarek87', 'ebrahim.almohandes', 'bassant.ahmed20118', 'ranaashraf129', 'medoshaban816', 'ahmedsamy888844', 'mohannadragab53', 'shadymagdy99', 'ahmedhamdyhalawa', 'abdoulkh', 'seifelawadi26', 'btngana1', 'karim20103200', 'hosamabdallah00', 'ramymohsen', 'mayadamarie', 'omaraly112', 'ronaldo2391999', 'engahmedsalahfathy', 'marwanahmad988', 'raniamuhamed44', 'sohamamdooh', 'ahmedmamin', 'yusufcheetos99', 'ziad.amr201666', 'adham99', 'generalshephrd', 'abdulrahman.hussien1999', 'josef.me22', 'mohamed.eid1014', 'harvovich', 'getray.ah', 'alaa15eltehewey', 'seif8128', 'mohamed_98', 'ahmadatef580', 'abdallahhashim', 'youssefsamiryoussef', 'habiba.elkassas', 'haidy_emad', 'maged19991926', 'ds44420', 'omarnabih21', 'mohamedhamdy1120000', 'mahmodfarag2000', 'yahiahamimi', 'ingyawad14', 'jaeang2019', 'ge.6cg7', 'ahmed_omar', 'youssefhassaan99', 'rana0100555', 's162368', 'sara.deghidy', 'ahmedmostafa5499', 'doraexplora', 'ashraf.amr82', 'nada.abomoslim', 'medosayed2020', 'saca', 'mohamed.zna66', 'kareemmohamed68990', 'm_feky', 'mohamedsalah2', 'shrouk.a.emad', 'elsayedrafaat7', 'tomymoty1', 'abdoelanwar99', 'rehab.sayed1231999', 'rektxz', 'markashaf232', 'mohamed1699', 'ashraf_mohamed', 'fasd556.om', 'maged.magdy666', 'mariam123456789', 'dina.23elessawy', 'nourhanne.bahaa', 'a.ayman74', 'michael29699', 'marwanyasser133', 'mahmoud.maree2010', 'faridmohammed98']"
47,398,23,43,14,"['midoayman248', 'ranaashraf129', 'karimtarek', 'youssefelrouby4', 'mostafa.maher591999', 'ahmedsamy888844', 'sondossalah66', 'seif8128', 'ronaldo2391999', 'mennamohamedhanafy392', 'mostafasaleh054', 'ahmedhamdyhalawa', 'mahmoud.maree2010', 'ahmedmamin']",8,"['s162368', 'sara.deghidy', 'jaeang2019', 'ge.6cg7', 'medosayed2020', 'ds44420', 'mohamed1699', 'rana0100555']",29,"['mohamedsamir2591998', 'medoshaban816', 'nohaabdelazeem11', 'heshamelsedfy111', 'seifahmedamer', 'mai99mahdy', 'ramymohsen', 'ahhamed93', 'yumna.ghoneim', 'reemayman101', 'moataz12mokhtar', 'youlianafouad17', 'kareemk08', 'mohamedsalah2', 'ahmedokasha1999', 'abdooo', 'mohmedshimaa25', 'rektxz', None, 'mohamed248688', 'ashraf_mohamed', 'ahmed.khaled.201420', 'ahmadatef580', 'm.trika1999', 'a.ayman74', 'maged19991926', 'mohamedhamdy1120000', 'mohamed_hesham', 'muhmedsalahm']",51,"['ranaashraf129', 'mohamedsamir2591998', 'nohaabdelazeem11', 'medoshaban816', 'ahmedsamy888844', 'heshamelsedfy111', 'ahmedhamdyhalawa', 'mai99mahdy', 'ramymohsen', 'ahhamed93', 'ronaldo2391999', 'mennamohamedhanafy392', 'ahmedmamin', 'youlianafouad17', 'mostafa.maher591999', 'kareemk08', 'mohamed248688', 'seif8128', 'ahmadatef580', 'm.trika1999', 'maged19991926', 'ds44420', 'mohamedhamdy1120000', 'muhmedsalahm', 'jaeang2019', 'ge.6cg7', 'seifahmedamer', 'rana0100555', 's162368', 'midoayman248', 'yumna.ghoneim', 'reemayman101', 'sara.deghidy', 'medosayed2020', 'moataz12mokhtar', 'karimtarek', 'sondossalah66', 'mohamedsalah2', 'ahmedokasha1999', 'abdooo', 'mostafasaleh054', 'mohmedshimaa25', 'rektxz', 'youssefelrouby4', 'mohamed1699', None, 'ashraf_mohamed', 'ahmed.khaled.201420', 'a.ayman74', 'mahmoud.maree2010', 'mohamed_hesham']"
47,400,23,8,1,['s162368'],21,"['ranaashraf129', 'ahmedsamy888844', 'jaeang2019', 'ge.6cg7', 'ahmedhamdyhalawa', 'rana0100555', 'midoayman248', 'sara.deghidy', 'ronaldo2391999', 'medosayed2020', 'mennamohamedhanafy392', 'ahmedmamin', 'karimtarek', 'mostafa.maher591999', 'sondossalah66', 'mostafasaleh054', 'youssefelrouby4', 'mohamed1699', 'seif8128', 'ds44420', 'mahmoud.maree2010']",7,"['maateusz.jankowski', 'studentmaria2020', 's159813', 'anna2222', 'asianano', 's154641', None]",29,"['ranaashraf129', 'karimtarek', 'studentmaria2020', 'mostafa.maher591999', 'ahmedsamy888844', 'sondossalah66', 'jaeang2019', 'ge.6cg7', 'mostafasaleh054', 's154641', 'ahmedhamdyhalawa', 'youssefelrouby4', 'mohamed1699', None, 'rana0100555', 's162368', 'midoayman248', 'maateusz.jankowski', 's159813', 'sara.deghidy', 'seif8128', 'anna2222', 'ronaldo2391999', 'asianano', 'mennamohamedhanafy392', 'medosayed2020', 'ds44420', 'mahmoud.maree2010', 'ahmedmamin']"
48,2,22,9,6,"['ivannamelnikovic6', 'maks2002', 'kjiva', 'tolchenn', 'kondaurov.semion', 'grygorytest']",15,"['helen15_31', 'chechetkin.em', 'manasa12', 'heloisa.dellandrea', 'danielfdezcalo', 'antonionito1993', 'gena.popesky', 'carlosrodriguez', 'sghozaly.ghozaly', 'cristiansaven', 'deividfariadesouza', 'valeriamg', 'elenajuanmartos', 'anpilogov', 'daniil_babynin']",3,"['lordipsi', None, 'ozerova_19']",24,"['ivannamelnikovic6', 'ozerova_19', 'heloisa.dellandrea', 'danielfdezcalo', 'maks2002', 'antonionito1993', 'kjiva', 'sghozaly.ghozaly', 'kondaurov.semion', 'tolchenn', 'daniil_babynin', 'grygorytest', 'elenajuanmartos', None, 'carlosrodriguez', 'helen15_31', 'chechetkin.em', 'manasa12', 'lordipsi', 'gena.popesky', 'cristiansaven', 'deividfariadesouza', 'valeriamg', 'anpilogov']"
49,313,22,8,5,"['cenxiaoxiao', 'cen_jiejie', 'cenxiaoquan', 'liuxiaoxiao', 'liuxiaocen']",16,"['slee3', 'ppxmg', 'komogortsev_sergey', 'sofiraviolo', 'g.decostr', 'anuma232', 'shivangi', 'm.salguero', 'jaypala999', 'galiy_sha', 'vll_krsk', 'piyush.agarwal19921', 'jfbarron82', 'changjiangphy', 'daniilskripko', 'ph19resch01002']",3,"[None, 'cenliu', 'liuxiaoquan123']",24,"['sofiraviolo', 'cenliu', 'piyush.agarwal19921', 'liuxiaoxiao', 'cen_jiejie', 'daniilskripko', 'ph19resch01002', None, 'liuxiaocen', 'liuxiaoquan123', 'slee3', 'ppxmg', 'komogortsev_sergey', 'shivangi', 'g.decostr', 'anuma232', 'm.salguero', 'jaypala999', 'galiy_sha', 'cenxiaoxiao', 'vll_krsk', 'jfbarron82', 'cenxiaoquan', 'changjiangphy']"
50,118,21,34,15,"['laibasaqib307', 'syedaurooj562', 'asif4001007', 'masud4000020', 'zahid4006555', 'nadeem4000465', 'ullah4005098', 'faiz4000626', 'sarfaraz4001312', 'syedamairazia', 'mahmood4030218', 'anwar4003031', 'sana.312', 'suhaib', 'innocent.fazeel66']",5,"['supernova.es99', 'hemakrish', 'newsince2', 'andrea.trost1998', 'kourosh.motiepor']",19,"['masroor4002808', 'salehabano.ned', 'unaisshazan', 'aamna123', 'mariaali8099', 'rukhsara347', 'abdullah99', 'rayyaan99', 'rameesa', 'finalartpythoncoder', 'anwer4001570', 'frmazharp', 'boysmart724', 'areejasad16', None, 'talib4005300', 'hashmi4001891', 'manaljamshed', 'faiza.iqbal680']",39,"['masroor4002808', 'salehabano.ned', 'newsince2', 'unaisshazan', 'zahid4006555', 'nadeem4000465', 'ullah4005098', 'aamna123', 'syedamairazia', 'mahmood4030218', 'suhaib', 'innocent.fazeel66', 'mariaali8099', 'rukhsara347', 'laibasaqib307', 'andrea.trost1998', 'abdullah99', 'rayyaan99', 'rameesa', 'anwar4003031', 'finalartpythoncoder', 'asif4001007', 'anwer4001570', 'syedaurooj562', 'supernova.es99', 'frmazharp', 'hemakrish', 'boysmart724', 'faiz4000626', 'areejasad16', 'masud4000020', None, 'sana.312', 'talib4005300', 'hashmi4001891', 'manaljamshed', 'sarfaraz4001312', 'faiza.iqbal680', 'kourosh.motiepor']"
51,173,21,22,16,"['princecyril', 'yzw994', 'sindhureddy', 'cesil', 'mohammada', 'linran', 'patels10', 'yuzhang', 'lokeshbabut', 'yiyang3', 'bharatpulaparthi', 'nmthakkar', 'junqianx', 'paleyv', 'jiaweiguo', 'vishak']",4,"['yuzhang2', 'de3', 'yujian1', 'atulacharya']",6,"['princetheverlastin', 'bharatp', 'xjq2267200611', 'bsai2048', 'rahulgahlot', None]",26,"['princetheverlastin', 'yzw994', 'yujian1', 'rahulgahlot', 'vishak', 'sindhureddy', 'patels10', 'bharatp', 'xjq2267200611', 'bharatpulaparthi', 'paleyv', 'yuzhang2', 'atulacharya', 'yuzhang', 'yiyang3', 'bsai2048', 'nmthakkar', 'de3', None, 'cesil', 'mohammada', 'lokeshbabut', 'junqianx', 'princecyril', 'jiaweiguo', 'linran']"
51,100,21,19,14,"['princecyril', 'yzw994', 'sindhureddy', 'cesil', 'mohammada', 'patels10', 'lokeshbabut', 'yiyang3', 'bharatpulaparthi', 'nmthakkar', 'junqianx', 'paleyv', 'jiaweiguo', 'linran']",6,"['atulacharya', 'yujian1', 'yuzhang', 'de3', 'yuzhang2', 'vishak']",5,"['sivaravula', 'yiyang1107', 'zheweny', None, 'ravitejanuka']",25,"['yzw994', 'yujian1', 'vishak', 'ravitejanuka', 'sindhureddy', 'patels10', 'bharatpulaparthi', 'yiyang1107', 'paleyv', 'yuzhang2', 'atulacharya', 'sivaravula', 'yuzhang', 'yiyang3', 'nmthakkar', 'zheweny', 'de3', None, 'cesil', 'mohammada', 'lokeshbabut', 'junqianx', 'princecyril', 'jiaweiguo', 'linran']"
52,276,21,10,6,"['jacobkimsahngin', 'kdoutt', 'mikav', 'bkipp', 'chris260', 'zcahill']",14,"['ggaglio', 'jbrittne', 'beers2', 'mlaud', 'camp19', 'slouderm', 'madeleiney', 'akoka', 'kim3398', 'rshobe', 'king595', 'jkbuhler49', 'garris21', 'gbidna']",4,"['cannon333', 'sun530', None, 'missahaq']",24,"['jacobkimsahngin', 'camp19', 'slouderm', 'madeleiney', 'rshobe', 'bkipp', 'gbidna', 'garris21', 'sun530', 'chris260', None, 'ggaglio', 'jbrittne', 'beers2', 'mlaud', 'kdoutt', 'cannon333', 'akoka', 'mikav', 'kim3398', 'king595', 'jkbuhler49', 'missahaq', 'zcahill']"
54,408,21,9,7,"['vaibhavsrivastav653', 'p20vl019', 'p20vl001', 'p20vl011', '12422rahulkumar', 'kumarmanjeet614', 'kinakeal']",13,"['debanjalirarhi', 'p20vl018', 'p20vl016', 'p20vl017', 'rohitvrm57', 'p20vl010', 'p20vl012', 'p20vl002', 'p20vl022', 'p20vl021', 'sainadhreddy', 'p20vl005', 'p20vl004']",2,"[None, 'shradha.bhandare']",22,"['p20vl018', 'rohitvrm57', 'p20vl010', 'shradha.bhandare', 'p20vl011', '12422rahulkumar', 'p20vl012', None, 'kinakeal', 'debanjalirarhi', 'p20vl016', 'p20vl017', 'vaibhavsrivastav653', 'p20vl002', 'p20vl019', 'p20vl001', 'p20vl022', 'p20vl021', 'sainadhreddy', 'p20vl005', 'kumarmanjeet614', 'p20vl004']"
55,380,21,28,3,"['tjwhite7700', 'tuongtran1231', 'ogiyenkod111']",17,"['younat', 'armandosuarez1500', 'miguelz21', 'fernandogarcia8490', 'elpapi.salas13', 'javier_guadian', 'fermart1223', 'eshika.p', 'bratanandrei97', 'irandanielaorozco', 'raducatrina21', 'marcosdan8a', 'edwingarcia1219', 'khaledanas', 'proleoivanportilloluna', 'brisavd', 'lizbeth.alejandra.guajardo']",25,"['qahoang', 'lockbox30', 'kianamon', 'nando97', 'do356', 'mf3256', 'ml3566', 'xg69', 'omg29', 'wookunjeon', 'tjb339', 'gedaliakoehler', 'kevinh88', 'kp825', 'cspiner', 'abarzabar', 'saf339', 'aleksandardunjic1999', None, 'jmcveigh55', 'jpalko20', 'tcp47', 'nicolech73', 'mra4020', 'cno34']",45,"['lockbox30', 'qahoang', 'kianamon', 'nando97', 'tuongtran1231', 'do356', 'khaledanas', 'mf3256', 'armandosuarez1500', 'elpapi.salas13', 'ml3566', 'xg69', 'omg29', 'wookunjeon', 'tjb339', 'eshika.p', 'gedaliakoehler', 'kevinh88', 'kp825', 'tjwhite7700', 'marcosdan8a', 'brisavd', 'cspiner', 'younat', 'miguelz21', 'fernandogarcia8490', 'abarzabar', 'javier_guadian', 'saf339', 'aleksandardunjic1999', 'irandanielaorozco', None, 'proleoivanportilloluna', 'jmcveigh55', 'jpalko20', 'ogiyenkod111', 'tcp47', 'nicolech73', 'bratanandrei97', 'mra4020', 'raducatrina21', 'cno34', 'edwingarcia1219', 'fermart1223', 'lizbeth.alejandra.guajardo']"
55,382,21,12,6,"['miguelz21', 'fernandogarcia8490', 'elpapi.salas13', 'marcosdan8a', 'brisavd', 'lizbeth.alejandra.guajardo']",14,"['younat', 'armandosuarez1500', 'javier_guadian', 'fermart1223', 'ogiyenkod111', 'eshika.p', 'bratanandrei97', 'tjwhite7700', 'irandanielaorozco', 'tuongtran1231', 'raducatrina21', 'edwingarcia1219', 'khaledanas', 'proleoivanportilloluna']",6,"['jimenezph', 'stellaq', 'stella', 'gabrielav', 'alvaromarquez5944', None]",26,"['younat', 'jimenezph', 'miguelz21', 'fernandogarcia8490', 'javier_guadian', 'fermart1223', 'irandanielaorozco', 'tuongtran1231', 'alvaromarquez5944', 'khaledanas', None, 'proleoivanportilloluna', 'armandosuarez1500', 'elpapi.salas13', 'stellaq', 'ogiyenkod111', 'stella', 'eshika.p', 'gabrielav', 'bratanandrei97', 'tjwhite7700', 'raducatrina21', 'marcosdan8a', 'edwingarcia1219', 'brisavd', 'lizbeth.alejandra.guajardo']"
55,383,21,12,1,['khaledanas'],19,"['tuongtran1231', 'armandosuarez1500', 'elpapi.salas13', 'eshika.p', 'tjwhite7700', 'marcosdan8a', 'brisavd', 'younat', 'miguelz21', 'fernandogarcia8490', 'javier_guadian', 'irandanielaorozco', 'proleoivanportilloluna', 'ogiyenkod111', 'bratanandrei97', 'raducatrina21', 'edwingarcia1219', 'fermart1223', 'lizbeth.alejandra.guajardo']",11,"['khuloodeid178', 'zahraalshaiba', None, 'sabt.yo', 'rehab.hussain', 'riddlerahm007', 'ayahalmosawi', 'ahmedkazim', 'r.h.alamri00', 'alia.alhammadi', 'maabelmuzamil']",31,"['alia.alhammadi', 'younat', 'khuloodeid178', 'miguelz21', 'zahraalshaiba', 'fernandogarcia8490', 'sabt.yo', 'javier_guadian', 'fermart1223', 'riddlerahm007', 'irandanielaorozco', 'tuongtran1231', 'khaledanas', None, 'proleoivanportilloluna', 'armandosuarez1500', 'elpapi.salas13', 'rehab.hussain', 'ogiyenkod111', 'eshika.p', 'bratanandrei97', 'ayahalmosawi', 'tjwhite7700', 'raducatrina21', 'ahmedkazim', 'marcosdan8a', 'edwingarcia1219', 'r.h.alamri00', 'brisavd', 'maabelmuzamil', 'lizbeth.alejandra.guajardo']"
55,381,21,7,2,"['bratanandrei97', 'raducatrina21']",18,"['younat', 'armandosuarez1500', 'miguelz21', 'fernandogarcia8490', 'elpapi.salas13', 'javier_guadian', 'fermart1223', 'ogiyenkod111', 'eshika.p', 'tjwhite7700', 'irandanielaorozco', 'tuongtran1231', 'marcosdan8a', 'edwingarcia1219', 'khaledanas', 'proleoivanportilloluna', 'brisavd', 'lizbeth.alejandra.guajardo']",5,"['mariutamarius97', 'robikecs', 'ramonasuruianu98', 'spam97', None]",25,"['younat', 'miguelz21', 'fernandogarcia8490', 'javier_guadian', 'fermart1223', 'irandanielaorozco', 'tuongtran1231', 'khaledanas', None, 'proleoivanportilloluna', 'mariutamarius97', 'armandosuarez1500', 'robikecs', 'elpapi.salas13', 'ogiyenkod111', 'eshika.p', 'ramonasuruianu98', 'bratanandrei97', 'tjwhite7700', 'raducatrina21', 'marcosdan8a', 'edwingarcia1219', 'spam97', 'brisavd', 'lizbeth.alejandra.guajardo']"
56,109,21,30,15,"['nguerreronaranjo', 'mangel.hc1109', 'criscams', 'sophyav', 'catalinavargas025', 'ibuitron', 'am1923', 'af.martinezt', 'mividaeseltamal25', 'susme2020', 's.rodrigueza', 'pablosc500', 'alejandro21', 'gicchirivi', 'sguerra339']",5,"['juanjosearevalo', 'crishanderhr', 'juanjose62976', 'cristiansanlo', 'af.manrique']",15,"['jdanielguzman264', 'lamarce2016', 'davidspa05', 'juandbolivarc', 'i.buitron', 'sergioprieto.mm', 'libardo11chapal', 'd0kma', 'bryam11122113', 'dm.zambrano', 'juandita810', 'juanfhcardona', 'pgalindo3105', None, 'maidy']",35,"['jdanielguzman264', 'criscams', 'sophyav', 'juandbolivarc', 'libardo11chapal', 'pablosc500', 'alejandro21', 'juanjose62976', 'mangel.hc1109', 'lamarce2016', 'ibuitron', 'af.martinezt', 'mividaeseltamal25', 'i.buitron', 'dm.zambrano', 'pgalindo3105', 'cristiansanlo', 'maidy', 's.rodrigueza', 'juanjosearevalo', 'crishanderhr', 'd0kma', 'juandita810', 'gicchirivi', None, 'af.manrique', 'nguerreronaranjo', 'sguerra339', 'catalinavargas025', 'davidspa05', 'am1923', 'susme2020', 'bryam11122113', 'juanfhcardona', 'sergioprieto.mm']"
56,123,21,27,15,"['nguerreronaranjo', 'mangel.hc1109', 'criscams', 'sophyav', 'catalinavargas025', 'ibuitron', 'am1923', 'af.martinezt', 'mividaeseltamal25', 'susme2020', 's.rodrigueza', 'crishanderhr', 'pablosc500', 'alejandro21', 'gicchirivi']",5,"['sguerra339', 'juanjosearevalo', 'juanjose62976', 'cristiansanlo', 'af.manrique']",12,"['jdanielguzman264', 'lamarce2016', 'davidspa05', 'juandbolivarc', 'sergioprieto.mm', 'd0kma', 'dm.zambrano', 'juandita810', 'pgalindo3105', 'diego.rojas1130', None, 'maidy']",32,"['jdanielguzman264', 'criscams', 'sophyav', 'juandbolivarc', 'pablosc500', 'alejandro21', 'juanjose62976', 'mangel.hc1109', 'lamarce2016', 'ibuitron', 'af.martinezt', 'mividaeseltamal25', 'dm.zambrano', 'pgalindo3105', 'diego.rojas1130', 'cristiansanlo', 'maidy', 's.rodrigueza', 'juanjosearevalo', 'crishanderhr', 'd0kma', 'juandita810', 'gicchirivi', None, 'af.manrique', 'nguerreronaranjo', 'sguerra339', 'catalinavargas025', 'davidspa05', 'am1923', 'susme2020', 'sergioprieto.mm']"
56,335,21,25,14,"['nguerreronaranjo', 'mangel.hc1109', 'criscams', 'sophyav', 'catalinavargas025', 'ibuitron', 'am1923', 'mividaeseltamal25', 'susme2020', 'crishanderhr', 'pablosc500', 'alejandro21', 'gicchirivi', 'sguerra339']",6,"['af.martinezt', 'juanjosearevalo', 's.rodrigueza', 'juanjose62976', 'cristiansanlo', 'af.manrique']",11,"['jdanielguzman264', 'andresmachuca21', 'lamarce2016', 'davidspa05', 'juandbolivarc', 'sergioprieto.mm', 'dm.zambrano', 'juandita810', 'juanfhcardona', 'diego.rojas1130', None]",31,"['jdanielguzman264', 'criscams', 'sophyav', 'juandbolivarc', 'pablosc500', 'alejandro21', 'juanjose62976', 'mangel.hc1109', 'lamarce2016', 'andresmachuca21', 'ibuitron', 'af.martinezt', 'mividaeseltamal25', 'dm.zambrano', 'diego.rojas1130', 'cristiansanlo', 's.rodrigueza', 'juanjosearevalo', 'crishanderhr', 'juandita810', 'gicchirivi', None, 'af.manrique', 'nguerreronaranjo', 'sguerra339', 'catalinavargas025', 'davidspa05', 'am1923', 'susme2020', 'juanfhcardona', 'sergioprieto.mm']"
56,111,21,24,2,"['nguerreronaranjo', 'criscams']",18,"['mangel.hc1109', 'catalinavargas025', 'sophyav', 'gicchirivi', 'sguerra339', 'ibuitron', 'am1923', 'af.martinezt', 'mividaeseltamal25', 'susme2020', 's.rodrigueza', 'juanjosearevalo', 'crishanderhr', 'pablosc500', 'alejandro21', 'juanjose62976', 'cristiansanlo', 'af.manrique']",22,"['jdanielguzman264', 'srabanti', 'anguye22', 'lamarce2016', 'dm.zambrano', 'alcastaneda', 'diego.rojas1130', 'noelledavis', 'goar.ayrapetyan', 'biomemes', 'naatessema', 'caitlincramer12', 'd0kma', 'anirbantwin', 'lorselgi', 'dning', 'luisferayala', None, 'andres201719819', 'jvl2xv', 'josealejoclaro1999', 'sergioprieto.mm']",42,"['jdanielguzman264', 'criscams', 'sophyav', 'srabanti', 'pablosc500', 'alejandro21', 'juanjose62976', 'anguye22', 'mangel.hc1109', 'lamarce2016', 'ibuitron', 'af.martinezt', 'mividaeseltamal25', 'dm.zambrano', 'alcastaneda', 'diego.rojas1130', 'noelledavis', 'cristiansanlo', 'goar.ayrapetyan', 'biomemes', 'naatessema', 'caitlincramer12', 's.rodrigueza', 'juanjosearevalo', 'crishanderhr', 'd0kma', 'anirbantwin', 'lorselgi', 'dning', 'gicchirivi', 'luisferayala', None, 'af.manrique', 'nguerreronaranjo', 'sguerra339', 'andres201719819', 'catalinavargas025', 'jvl2xv', 'am1923', 'josealejoclaro1999', 'susme2020', 'sergioprieto.mm']"
56,336,21,6,3,"['am1923', 'pablosc500', 'sguerra339']",17,"['nguerreronaranjo', 'mangel.hc1109', 'criscams', 'sophyav', 'gicchirivi', 'catalinavargas025', 'ibuitron', 'af.martinezt', 'mividaeseltamal25', 'susme2020', 's.rodrigueza', 'juanjosearevalo', 'crishanderhr', 'alejandro21', 'juanjose62976', 'cristiansanlo', 'af.manrique']",3,"['juandbolivarc', None, 'pgalindo3105']",23,"['criscams', 'sophyav', 'juandbolivarc', 's.rodrigueza', 'juanjosearevalo', 'crishanderhr', 'pablosc500', 'alejandro21', 'juanjose62976', 'gicchirivi', None, 'af.manrique', 'nguerreronaranjo', 'mangel.hc1109', 'sguerra339', 'catalinavargas025', 'ibuitron', 'am1923', 'af.martinezt', 'mividaeseltamal25', 'susme2020', 'pgalindo3105', 'cristiansanlo']"
57,76,20,21,17,"['ahmed.mohie7', 'abdelrahman99', 'nouramin2000', 'habibafoudah', 'mohamedeslam22.me', 'ahmedhegazyy', 'mazenkhaled123456789', 'amr171', 'omarrsamerr', 'moodyhatem2015', 'zeyadelghaly', 'youssef2042000', 'mariamhanyw99', 'hanaamr2000.hanaamr', 'rahmaahmeed4', 'nadaeleish', 'ehabk137']",2,"['farahelgayar', 'mahmoudredaa358']",4,"['fareedadeda31', 'gengergogo', None, 'ammaralaa516']",23,"['farahelgayar', 'fareedadeda31', 'nouramin2000', 'ahmedhegazyy', 'gengergogo', 'moodyhatem2015', 'mahmoudredaa358', 'mariamhanyw99', 'ammaralaa516', 'ahmed.mohie7', 'mohamedeslam22.me', 'amr171', 'youssef2042000', 'nadaeleish', 'ehabk137', 'abdelrahman99', 'habibafoudah', 'omarrsamerr', 'zeyadelghaly', None, 'mazenkhaled123456789', 'hanaamr2000.hanaamr', 'rahmaahmeed4']"
58,483,20,7,6,"['jnan9651', 'zainab99', 'yiraq6575', 'gbxgnc95', 'hajerjaber998', 'amer.96']",13,"['hesanenyasser', 'taktomali6', 'safa28', 'hubei.alamiri96', 'kyanalhnyn280', 'matteocasula', 'gpolizia4', 'nosaqamar', 'fofaf1541', 'pzndiqnkdwc', 'azsn3579', 'ahmead.hameed.21', 'nello.mascia.nm']",1,[None],20,"['jnan9651', 'safa28', 'zainab99', 'fofaf1541', 'hajerjaber998', 'pzndiqnkdwc', 'azsn3579', None, 'amer.96', 'hesanenyasser', 'taktomali6', 'hubei.alamiri96', 'yiraq6575', 'matteocasula', 'kyanalhnyn280', 'gpolizia4', 'nosaqamar', 'gbxgnc95', 'ahmead.hameed.21', 'nello.mascia.nm']"
59,543,20,31,14,"['dgwthree', 'stacrm', 'alexfbrodsky', 'cbear3289', 'kongf', 'vot5', 'feifeicash', 'pagliv', 'ningpingwang3', 'bertel010', 'nabeelbukhari1989', 'malcolmmcclymonds', 'amatos99', 'ka99a']",5,"['hawksr21', 'xiaolin0720', 'miranda.mudlock', 'tesla1545', 'nicholasvbest']",17,"[None, 'aidenglennon', 'akryzanski', 'sam.e.wiegand', 'cata3rd', 'coglia', 'rmahserjian', 'lphuang', 'bernsc', 'giatrzaska', 'lbarba', 'xiaofeizeng11', 'sumati.rangaraj', 'zueeluee', 'omrieilat222', 'danloucksbaer', 'morroa2secondtime']",36,"['dgwthree', 'vot5', 'feifeicash', 'rmahserjian', 'ningpingwang3', 'nicholasvbest', 'stacrm', 'aidenglennon', 'miranda.mudlock', 'xiaolin0720', 'omrieilat222', 'danloucksbaer', 'cbear3289', 'amatos99', 'akryzanski', 'sam.e.wiegand', 'pagliv', 'bertel010', 'tesla1545', 'bernsc', 'giatrzaska', 'lbarba', 'xiaofeizeng11', 'malcolmmcclymonds', None, 'morroa2secondtime', 'ka99a', 'hawksr21', 'alexfbrodsky', 'kongf', 'cata3rd', 'lphuang', 'nabeelbukhari1989', 'zueeluee', 'coglia', 'sumati.rangaraj']"
59,546,20,31,14,"['dgwthree', 'stacrm', 'alexfbrodsky', 'cbear3289', 'kongf', 'vot5', 'feifeicash', 'pagliv', 'ningpingwang3', 'bertel010', 'nabeelbukhari1989', 'malcolmmcclymonds', 'amatos99', 'ka99a']",5,"['hawksr21', 'xiaolin0720', 'miranda.mudlock', 'tesla1545', 'nicholasvbest']",17,"[None, 'aidenglennon', 'akryzanski', 'sam.e.wiegand', 'cata3rd', 'coglia', 'rmahserjian', 'lphuang', 'bernsc', 'giatrzaska', 'lbarba', 'xiaofeizeng11', 'sumati.rangaraj', 'zueeluee', 'omrieilat222', 'danloucksbaer', 'morroa2secondtime']",36,"['dgwthree', 'vot5', 'feifeicash', 'rmahserjian', 'ningpingwang3', 'nicholasvbest', 'stacrm', 'aidenglennon', 'miranda.mudlock', 'xiaolin0720', 'omrieilat222', 'danloucksbaer', 'cbear3289', 'amatos99', 'akryzanski', 'sam.e.wiegand', 'pagliv', 'bertel010', 'tesla1545', 'bernsc', 'giatrzaska', 'lbarba', 'xiaofeizeng11', 'malcolmmcclymonds', None, 'morroa2secondtime', 'ka99a', 'hawksr21', 'alexfbrodsky', 'kongf', 'cata3rd', 'lphuang', 'nabeelbukhari1989', 'zueeluee', 'coglia', 'sumati.rangaraj']"
59,307,20,30,13,"['stacrm', 'alexfbrodsky', 'cbear3289', 'kongf', 'vot5', 'feifeicash', 'pagliv', 'ningpingwang3', 'bertel010', 'nabeelbukhari1989', 'malcolmmcclymonds', 'amatos99', 'ka99a']",6,"['dgwthree', 'hawksr21', 'xiaolin0720', 'miranda.mudlock', 'tesla1545', 'nicholasvbest']",17,"[None, 'aidenglennon', 'akryzanski', 'sam.e.wiegand', 'cata3rd', 'coglia', 'rmahserjian', 'lphuang', 'bernsc', 'giatrzaska', 'lbarba', 'xiaofeizeng11', 'sumati.rangaraj', 'zueeluee', 'omrieilat222', 'danloucksbaer', 'morroa2secondtime']",36,"['dgwthree', 'vot5', 'feifeicash', 'rmahserjian', 'ningpingwang3', 'nicholasvbest', 'stacrm', 'aidenglennon', 'miranda.mudlock', 'xiaolin0720', 'omrieilat222', 'danloucksbaer', 'cbear3289', 'amatos99', 'akryzanski', 'sam.e.wiegand', 'pagliv', 'bertel010', 'tesla1545', 'bernsc', 'giatrzaska', 'lbarba', 'xiaofeizeng11', 'malcolmmcclymonds', None, 'morroa2secondtime', 'ka99a', 'hawksr21', 'alexfbrodsky', 'kongf', 'cata3rd', 'lphuang', 'nabeelbukhari1989', 'zueeluee', 'coglia', 'sumati.rangaraj']"
59,306,20,29,12,"['stacrm', 'alexfbrodsky', 'kongf', 'vot5', 'pagliv', 'ningpingwang3', 'bertel010', 'nabeelbukhari1989', 'amatos99', 'malcolmmcclymonds', 'cbear3289', 'ka99a']",7,"['dgwthree', 'hawksr21', 'feifeicash', 'xiaolin0720', 'miranda.mudlock', 'tesla1545', 'nicholasvbest']",17,"[None, 'aidenglennon', 'akryzanski', 'sam.e.wiegand', 'cata3rd', 'coglia', 'rmahserjian', 'lphuang', 'bernsc', 'giatrzaska', 'lbarba', 'xiaofeizeng11', 'sumati.rangaraj', 'zueeluee', 'omrieilat222', 'danloucksbaer', 'morroa2secondtime']",36,"['dgwthree', 'vot5', 'feifeicash', 'rmahserjian', 'ningpingwang3', 'nicholasvbest', 'stacrm', 'aidenglennon', 'miranda.mudlock', 'xiaolin0720', 'omrieilat222', 'danloucksbaer', 'cbear3289', 'amatos99', 'akryzanski', 'sam.e.wiegand', 'pagliv', 'bertel010', 'tesla1545', 'bernsc', 'giatrzaska', 'lbarba', 'xiaofeizeng11', 'malcolmmcclymonds', None, 'morroa2secondtime', 'ka99a', 'hawksr21', 'alexfbrodsky', 'kongf', 'cata3rd', 'lphuang', 'nabeelbukhari1989', 'zueeluee', 'coglia', 'sumati.rangaraj']"
59,544,20,28,12,"['stacrm', 'alexfbrodsky', 'kongf', 'vot5', 'pagliv', 'ningpingwang3', 'bertel010', 'nabeelbukhari1989', 'amatos99', 'malcolmmcclymonds', 'cbear3289', 'ka99a']",7,"['dgwthree', 'hawksr21', 'feifeicash', 'xiaolin0720', 'miranda.mudlock', 'tesla1545', 'nicholasvbest']",16,"[None, 'aidenglennon', 'akryzanski', 'sam.e.wiegand', 'cata3rd', 'coglia', 'rmahserjian', 'bernsc', 'giatrzaska', 'lbarba', 'xiaofeizeng11', 'sumati.rangaraj', 'zueeluee', 'omrieilat222', 'danloucksbaer', 'morroa2secondtime']",35,"['dgwthree', 'vot5', 'feifeicash', 'rmahserjian', 'ningpingwang3', 'nicholasvbest', 'stacrm', 'aidenglennon', 'miranda.mudlock', 'xiaolin0720', 'omrieilat222', 'danloucksbaer', 'cbear3289', 'amatos99', 'akryzanski', 'sam.e.wiegand', 'pagliv', 'bertel010', 'tesla1545', 'bernsc', 'giatrzaska', 'lbarba', 'xiaofeizeng11', 'malcolmmcclymonds', None, 'morroa2secondtime', 'ka99a', 'hawksr21', 'alexfbrodsky', 'kongf', 'cata3rd', 'nabeelbukhari1989', 'zueeluee', 'coglia', 'sumati.rangaraj']"
60,383,20,12,9,"['zahraalshaiba', 'rehab.hussain', 'sabt.yo', 'riddlerahm007', 'ayahalmosawi', 'ahmedkazim', 'r.h.alamri00', 'alia.alhammadi', 'maabelmuzamil']",10,"['david.wel.samuel', 'salmaeisa', 'najwankaaki', 'tomatotumtum', 'sp3696', 'tomshalvey', 'ashaalan', 'yusuf500', 'alixmelo', 'alialrubaye']",3,"['khuloodeid178', 'khaledanas', None]",22,"['zahraalshaiba', 'maabelmuzamil', 'khuloodeid178', 'sabt.yo', 'tomatotumtum', 'sp3696', 'riddlerahm007', 'yusuf500', 'alixmelo', 'khaledanas', None, 'david.wel.samuel', 'salmaeisa', 'rehab.hussain', 'najwankaaki', 'tomshalvey', 'ashaalan', 'ayahalmosawi', 'ahmedkazim', 'r.h.alamri00', 'alia.alhammadi', 'alialrubaye']"
60,473,20,11,6,"['rehab.hussain', 'riddlerahm007', 'yusuf500', 'ayahalmosawi', 'r.h.alamri00', 'maabelmuzamil']",13,"['david.wel.samuel', 'salmaeisa', 'zahraalshaiba', 'sabt.yo', 'najwankaaki', 'tomatotumtum', 'sp3696', 'tomshalvey', 'ashaalan', 'alixmelo', 'ahmedkazim', 'alia.alhammadi', 'alialrubaye']",5,"['abeerabdullah192', 'pangracious', 'afra.alfaasii', 'yusuf1337', None]",24,"['zahraalshaiba', 'maabelmuzamil', 'sabt.yo', 'tomatotumtum', 'sp3696', 'riddlerahm007', 'yusuf500', 'alixmelo', None, 'david.wel.samuel', 'salmaeisa', 'abeerabdullah192', 'rehab.hussain', 'najwankaaki', 'pangracious', 'afra.alfaasii', 'tomshalvey', 'ashaalan', 'yusuf1337', 'ayahalmosawi', 'ahmedkazim', 'r.h.alamri00', 'alia.alhammadi', 'alialrubaye']"
60,474,20,11,8,"['sabt.yo', 'rehab.hussain', 'yusuf500', 'ayahalmosawi', 'ahmedkazim', 'r.h.alamri00', 'alia.alhammadi', 'maabelmuzamil']",11,"['david.wel.samuel', 'salmaeisa', 'zahraalshaiba', 'najwankaaki', 'tomatotumtum', 'sp3696', 'riddlerahm007', 'tomshalvey', 'ashaalan', 'alixmelo', 'alialrubaye']",3,"['mohammad.alsayegh', None, 'yusuf1337']",22,"['zahraalshaiba', 'maabelmuzamil', 'sabt.yo', 'tomatotumtum', 'sp3696', 'riddlerahm007', 'yusuf500', 'mohammad.alsayegh', 'alixmelo', None, 'david.wel.samuel', 'salmaeisa', 'rehab.hussain', 'najwankaaki', 'tomshalvey', 'ashaalan', 'yusuf1337', 'ayahalmosawi', 'ahmedkazim', 'r.h.alamri00', 'alia.alhammadi', 'alialrubaye']"
63,297,19,19,15,"['sarafitz', 'vinallen', 'nshigley', 'yaxzhong', 'jjjewett', 'kaegarci', 'ametzman', 'ccerwin', 'ahmorrow', 'leecin', 'mvperkin', 'cdbasile', 'cvultori', 'dob', 'ejendres']",3,"['maxbultm', 'wilwils', 'pkraj']",4,"['jasakadu', 'vinitab', None, 'hddrabek']",22,"['wilwils', 'sarafitz', 'vinallen', 'vinitab', 'kaegarci', 'jasakadu', 'hddrabek', 'ccerwin', 'mvperkin', 'yaxzhong', None, 'dob', 'ejendres', 'maxbultm', 'nshigley', 'jjjewett', 'ametzman', 'pkraj', 'ahmorrow', 'leecin', 'cdbasile', 'cvultori']"
64,148,19,12,9,"['dshah515', 'nmchamp', 'alexzimm', 'nikaren', 'saxman25', 'ajcharm', 'tleonar', 'lwight', 'epeachus']",9,"['jcmillare33', 'jepi', 'tarunisree', 't.hirohito', 'k1singh1nano1', 'jeilers', 'hikmetburcugencer', 'rcrollan', 'pabitrasuna96']",3,"['ralsmith', None, 'kthorn01']",21,"['dshah515', 'nmchamp', 'jepi', 'tarunisree', 'jcmillare33', 'ajcharm', 'jeilers', 'lwight', 'hikmetburcugencer', 'kthorn01', 'epeachus', None, 'alexzimm', 'nikaren', 't.hirohito', 'k1singh1nano1', 'ralsmith', 'saxman25', 'tleonar', 'rcrollan', 'pabitrasuna96']"
65,416,19,61,6,"['ucotul', 'jartalej', 'sundara4', 'sarode', 'assafh', 'salina15']",12,"['kulkar70', 'nwarin', 'jsbookworm', 'torre188', 'amasia', 'li13175', 'freyn581', 'geist2', 'evans341', 'alberti', 'acartwr', 'reploglj']",55,"['afelicel', 'hesquiv', 'abhinand', 'federicozappaterra', 'ryan103', 'abaniiss', 'naik26', 'olson171', 'mnoftz1157', 'jprom', 'venkat_pulletikurthi', 'arebassa', 'fixa', 'yadav35', 'paulsonj', 'hess35', 'sbachawa', 'disaacar', 'esalata', 'zrhan', 'jianwen97', 'pravi', 'zhu891', 'ahmed153', 'fansler', 'mistry7', 'tstagge', 'cemegoak', 'odonne33', 'chand101', 'maciasi', 'miftikhar', 'aprahara', 'cwishard', 'rojas23', 'nyudewit', 'ren102', 'asatput', None, 'csaerome', 'mrouleau', 'ferdoush', 'zchang', 'karonss60', 'hnowak', 'park1267', 'hansookim', 'rgeorgi', 'kim3247', 'phill342', 'aharroun', 'maldonl', 'ctrautma', 'wsenior', 'hong263']",73,"['afelicel', 'hesquiv', 'abhinand', 'federicozappaterra', 'ryan103', 'assafh', 'evans341', 'alberti', 'fixa', 'acartwr', 'paulsonj', 'esalata', 'zrhan', 'pravi', 'zhu891', 'ahmed153', 'fansler', 'mistry7', 'odonne33', 'chand101', 'maciasi', 'miftikhar', 'freyn581', 'geist2', 'cwishard', 'nyudewit', 'asatput', 'mrouleau', 'nwarin', 'ucotul', 'zchang', 'sundara4', 'hnowak', 'park1267', 'hansookim', 'aharroun', 'maldonl', 'ctrautma', 'wsenior', 'hong263', 'jsbookworm', 'abaniiss', 'naik26', 'olson171', 'mnoftz1157', 'jprom', 'venkat_pulletikurthi', 'arebassa', 'salina15', 'yadav35', 'hess35', 'li13175', 'sbachawa', 'disaacar', 'sarode', 'jianwen97', 'tstagge', 'cemegoak', 'torre188', 'aprahara', 'rojas23', 'ren102', None, 'csaerome', 'kulkar70', 'amasia', 'jartalej', 'ferdoush', 'karonss60', 'rgeorgi', 'kim3247', 'phill342', 'reploglj']"
65,430,19,47,6,"['ucotul', 'jartalej', 'sundara4', 'sarode', 'assafh', 'salina15']",12,"['kulkar70', 'nwarin', 'jsbookworm', 'torre188', 'amasia', 'li13175', 'freyn581', 'geist2', 'evans341', 'alberti', 'acartwr', 'reploglj']",41,"['afelicel', 'hesquiv', 'federicozappaterra', 'abaniiss', 'xiong49', 'naik26', 'mnoftz1157', 'jprom', 'venkat_pulletikurthi', 'fixa', 'yadav35', 'paulsonj', 'hanweizhou', 'disaacar', 'pravi', 'zhu891', 'ahmed153', 'fansler', 'odonne33', 'cemegoak', 'tstagge', 'zhan51', 'chand101', 'maciasi', 'miftikhar', 'aprahara', 'rojas23', 'ren102', 'nyudewit', None, 'csaerome', 'mrouleau', 'ferdoush', 'zchang', 'hnowak', 'garret28', 'aharroun', 'maldonl', 'ctrautma', 'wsenior', 'hong263']",59,"['afelicel', 'hesquiv', 'federicozappaterra', 'xiong49', 'assafh', 'evans341', 'alberti', 'fixa', 'acartwr', 'paulsonj', 'pravi', 'zhu891', 'ahmed153', 'fansler', 'odonne33', 'zhan51', 'chand101', 'maciasi', 'miftikhar', 'freyn581', 'geist2', 'nyudewit', 'mrouleau', 'nwarin', 'ucotul', 'zchang', 'sundara4', 'hnowak', 'garret28', 'aharroun', 'maldonl', 'ctrautma', 'wsenior', 'hong263', 'jsbookworm', 'abaniiss', 'naik26', 'mnoftz1157', 'jprom', 'venkat_pulletikurthi', 'salina15', 'yadav35', 'hanweizhou', 'li13175', 'disaacar', 'sarode', 'cemegoak', 'tstagge', 'torre188', 'aprahara', 'rojas23', 'ren102', None, 'csaerome', 'kulkar70', 'amasia', 'jartalej', 'ferdoush', 'reploglj']"
65,433,19,46,6,"['ucotul', 'jartalej', 'sundara4', 'sarode', 'assafh', 'salina15']",12,"['kulkar70', 'nwarin', 'jsbookworm', 'torre188', 'amasia', 'li13175', 'freyn581', 'geist2', 'evans341', 'alberti', 'acartwr', 'reploglj']",40,"['mademoiselle0812', 'hesquiv', 'federicozappaterra', 'ryan103', 'abaniiss', 'mnoftz1157', 'jprom', 'sthurman95', 'arebassa', 'fixa', 'yadav35', 'paulsonj', 'hess35', 'sbachawa', 'disaacar', 'caduartec', 'pravi', 'zhu891', 'ahmed153', 'fansler', 'odonne33', 'maciasi', 'miftikhar', 'aprahara', 'black161', 'rojas23', 'nyudewit', None, 'csaerome', 'mrouleau', 'ferdoush', 'zchang', 'park1267', 'hnowak', 'garret28', 'aharroun', 'maldonl', 'ctrautma', 'wsenior', 'hong263']",58,"['mademoiselle0812', 'hesquiv', 'federicozappaterra', 'ryan103', 'assafh', 'evans341', 'alberti', 'fixa', 'acartwr', 'paulsonj', 'pravi', 'zhu891', 'ahmed153', 'fansler', 'odonne33', 'maciasi', 'miftikhar', 'freyn581', 'geist2', 'nyudewit', 'mrouleau', 'nwarin', 'ucotul', 'zchang', 'sundara4', 'park1267', 'hnowak', 'garret28', 'aharroun', 'maldonl', 'ctrautma', 'wsenior', 'hong263', 'jsbookworm', 'abaniiss', 'mnoftz1157', 'jprom', 'sthurman95', 'arebassa', 'salina15', 'yadav35', 'hess35', 'li13175', 'sbachawa', 'disaacar', 'caduartec', 'sarode', 'torre188', 'aprahara', 'black161', 'rojas23', None, 'csaerome', 'kulkar70', 'amasia', 'jartalej', 'ferdoush', 'reploglj']"
65,446,19,44,5,"['ucotul', 'sundara4', 'sarode', 'assafh', 'salina15']",13,"['kulkar70', 'nwarin', 'jsbookworm', 'torre188', 'amasia', 'li13175', 'jartalej', 'freyn581', 'geist2', 'evans341', 'alberti', 'acartwr', 'reploglj']",39,"['hesquiv', 'federicozappaterra', 'abaniiss', 'mnoftz1157', 'jprom', 'sthurman95', 'venkat_pulletikurthi', 'arebassa', 'fixa', 'yadav35', 'paulsonj', 'hess35', 'sbachawa', 'disaacar', 'caduartec', 'zrhan', 'pravi', 'zhu891', 'ahmed153', 'fansler', 'odonne33', 'mistry7', 'cemegoak', 'khandel4', 'maciasi', 'miftikhar', 'aprahara', 'black161', 'rojas23', 'ren102', 'nyudewit', None, 'ferdoush', 'zchang', 'aharroun', 'maldonl', 'ctrautma', 'wsenior', 'hong263']",57,"['jsbookworm', 'hesquiv', 'federicozappaterra', 'abaniiss', 'mnoftz1157', 'assafh', 'jprom', 'sthurman95', 'venkat_pulletikurthi', 'evans341', 'alberti', 'arebassa', 'fixa', 'salina15', 'acartwr', 'yadav35', 'paulsonj', 'hess35', 'li13175', 'sbachawa', 'disaacar', 'caduartec', 'sarode', 'zrhan', 'pravi', 'zhu891', 'ahmed153', 'fansler', 'odonne33', 'mistry7', 'cemegoak', 'khandel4', 'torre188', 'maciasi', 'miftikhar', 'freyn581', 'aprahara', 'geist2', 'black161', 'rojas23', 'ren102', 'nyudewit', None, 'kulkar70', 'amasia', 'nwarin', 'ucotul', 'jartalej', 'sundara4', 'ferdoush', 'zchang', 'aharroun', 'maldonl', 'ctrautma', 'wsenior', 'hong263', 'reploglj']"
65,440,19,39,6,"['ucotul', 'jartalej', 'sundara4', 'sarode', 'assafh', 'salina15']",12,"['kulkar70', 'nwarin', 'jsbookworm', 'torre188', 'amasia', 'li13175', 'freyn581', 'geist2', 'evans341', 'alberti', 'acartwr', 'reploglj']",33,"['hesquiv', 'abaniiss', 'mnoftz1157', 'jprom', 'venkat_pulletikurthi', 'arebassa', 'fixa', 'yadav35', 'paulsonj', 'hess35', 'sbachawa', 'disaacar', 'pravi', 'ahmed153', 'fansler', 'odonne33', 'tstagge', 'maciasi', 'miftikhar', 'aprahara', 'rojas23', 'ren102', 'nyudewit', None, 'csaerome', 'mrouleau', 'ferdoush', 'jgilvey', 'zchang', 'hnowak', 'aharroun', 'maldonl', 'ctrautma']",51,"['jsbookworm', 'hesquiv', 'abaniiss', 'mnoftz1157', 'assafh', 'jprom', 'venkat_pulletikurthi', 'evans341', 'alberti', 'arebassa', 'fixa', 'salina15', 'acartwr', 'yadav35', 'paulsonj', 'hess35', 'li13175', 'sbachawa', 'disaacar', 'sarode', 'pravi', 'ahmed153', 'fansler', 'odonne33', 'tstagge', 'torre188', 'maciasi', 'miftikhar', 'freyn581', 'aprahara', 'geist2', 'rojas23', 'ren102', 'nyudewit', None, 'csaerome', 'mrouleau', 'kulkar70', 'amasia', 'nwarin', 'ucotul', 'jartalej', 'sundara4', 'ferdoush', 'jgilvey', 'zchang', 'hnowak', 'aharroun', 'maldonl', 'ctrautma', 'reploglj']"
65,198,19,22,1,['salina15'],17,"['kulkar70', 'nwarin', 'jsbookworm', 'torre188', 'amasia', 'li13175', 'ucotul', 'jartalej', 'freyn581', 'sundara4', 'sarode', 'geist2', 'assafh', 'evans341', 'alberti', 'acartwr', 'reploglj']",21,"['abaniiss', 'sthurman95', 'jprom', 'venkat_pulletikurthi', 'hess35', 'sbachawa', 'zhu891', 'ahmed153', 'miftikhar', 'rsakhare', 'kevindurex', None, 'csaerome', 'mrouleau', 'ferdoush', 'zchang', 'kennelt', 'phill342', 'aharroun', 'maldonl', 'hong263']",39,"['jsbookworm', 'abaniiss', 'sthurman95', 'assafh', 'jprom', 'venkat_pulletikurthi', 'evans341', 'alberti', 'salina15', 'acartwr', 'hess35', 'li13175', 'sbachawa', 'sarode', 'zhu891', 'ahmed153', 'torre188', 'miftikhar', 'freyn581', 'geist2', 'rsakhare', 'kevindurex', None, 'csaerome', 'mrouleau', 'kulkar70', 'amasia', 'nwarin', 'ucotul', 'jartalej', 'sundara4', 'ferdoush', 'zchang', 'kennelt', 'phill342', 'aharroun', 'maldonl', 'hong263', 'reploglj']"
65,432,19,20,1,['amasia'],17,"['kulkar70', 'nwarin', 'jsbookworm', 'torre188', 'li13175', 'ucotul', 'jartalej', 'sundara4', 'freyn581', 'sarode', 'geist2', 'assafh', 'evans341', 'alberti', 'salina15', 'acartwr', 'reploglj']",19,"['jwichlin', 'seo71', 'xiong49', 'zhan3695', 'adandeka', 'fixa', 'hua49', 'hanweizhou', 'vkwarten', 'caduartec', 'mpollar', 'ericks44', None, 'dsdubbel', 'jgilvey', 'marisol', 'park1267', 'rgeorgi', 'garret28']",37,"['jwichlin', 'jsbookworm', 'seo71', 'xiong49', 'zhan3695', 'assafh', 'adandeka', 'evans341', 'alberti', 'fixa', 'salina15', 'acartwr', 'hua49', 'hanweizhou', 'li13175', 'vkwarten', 'caduartec', 'sarode', 'mpollar', 'torre188', 'freyn581', 'geist2', 'ericks44', None, 'dsdubbel', 'kulkar70', 'amasia', 'nwarin', 'ucotul', 'jartalej', 'sundara4', 'jgilvey', 'marisol', 'park1267', 'rgeorgi', 'garret28', 'reploglj']"
65,437,19,19,1,['amasia'],17,"['kulkar70', 'nwarin', 'jsbookworm', 'torre188', 'li13175', 'ucotul', 'jartalej', 'sundara4', 'freyn581', 'sarode', 'geist2', 'assafh', 'evans341', 'alberti', 'salina15', 'acartwr', 'reploglj']",18,"['dsdubbel', 'jwichlin', 'jgilvey', None, 'marisol', 'vkwarten', 'seo71', 'xiong49', 'caduartec', 'ericks44', 'park1267', 'rgeorgi', 'garret28', 'jschirck', 'rojas23', 'hmackins', 'fixa', 'hua49']",36,"['jwichlin', 'jsbookworm', 'torre188', 'freyn581', 'seo71', 'xiong49', 'geist2', 'assafh', 'rojas23', 'evans341', 'alberti', 'ericks44', 'fixa', 'salina15', 'acartwr', 'hua49', None, 'dsdubbel', 'kulkar70', 'amasia', 'nwarin', 'li13175', 'ucotul', 'jartalej', 'sundara4', 'vkwarten', 'jgilvey', 'caduartec', 'marisol', 'park1267', 'rgeorgi', 'sarode', 'garret28', 'jschirck', 'hmackins', 'reploglj']"
65,442,19,15,1,['amasia'],17,"['kulkar70', 'nwarin', 'jsbookworm', 'torre188', 'li13175', 'ucotul', 'jartalej', 'sundara4', 'freyn581', 'sarode', 'geist2', 'assafh', 'evans341', 'alberti', 'salina15', 'acartwr', 'reploglj']",14,"['hanweizhou', 'dsdubbel', 'jgilvey', 'marisol', None, 'hmackins', 'caduartec', 'xiong49', 'seo71', 'rgeorgi', 'garret28', 'ericks44', 'fixa', 'hua49']",32,"['jsbookworm', 'torre188', 'freyn581', 'seo71', 'xiong49', 'geist2', 'assafh', 'evans341', 'alberti', 'ericks44', 'fixa', 'salina15', 'acartwr', 'hua49', None, 'hanweizhou', 'dsdubbel', 'kulkar70', 'amasia', 'nwarin', 'li13175', 'ucotul', 'jartalej', 'sundara4', 'jgilvey', 'marisol', 'caduartec', 'rgeorgi', 'sarode', 'garret28', 'hmackins', 'reploglj']"
65,447,19,14,1,['amasia'],17,"['kulkar70', 'nwarin', 'jsbookworm', 'torre188', 'li13175', 'ucotul', 'jartalej', 'sundara4', 'freyn581', 'sarode', 'geist2', 'assafh', 'evans341', 'alberti', 'salina15', 'acartwr', 'reploglj']",13,"['hanweizhou', 'jwichlin', 'jgilvey', 'marisol', 'dsdubbel', None, 'caduartec', 'xiong49', 'park1267', 'olson171', 'ericks44', 'fixa', 'hua49']",31,"['jwichlin', 'jsbookworm', 'torre188', 'freyn581', 'xiong49', 'olson171', 'geist2', 'assafh', 'evans341', 'alberti', 'ericks44', 'fixa', 'salina15', 'acartwr', 'hua49', None, 'hanweizhou', 'dsdubbel', 'kulkar70', 'amasia', 'nwarin', 'li13175', 'ucotul', 'jartalej', 'sundara4', 'jgilvey', 'marisol', 'caduartec', 'park1267', 'sarode', 'reploglj']"
65,422,19,10,1,['li13175'],17,"['kulkar70', 'nwarin', 'jsbookworm', 'torre188', 'amasia', 'ucotul', 'jartalej', 'sundara4', 'freyn581', 'sarode', 'geist2', 'assafh', 'evans341', 'alberti', 'salina15', 'acartwr', 'reploglj']",9,"['zhan51', 'zhan3742', 'hnowak', 'ericks44', 'maldonl', 'chen2058', 'mrfrye', 'bsule', None]",27,"['jsbookworm', 'torre188', 'zhan51', 'freyn581', 'geist2', 'assafh', 'evans341', 'alberti', 'ericks44', 'bsule', 'salina15', 'acartwr', None, 'kulkar70', 'amasia', 'nwarin', 'li13175', 'ucotul', 'jartalej', 'sundara4', 'zhan3742', 'hnowak', 'sarode', 'maldonl', 'chen2058', 'mrfrye', 'reploglj']"
65,419,19,9,1,['reploglj'],17,"['kulkar70', 'nwarin', 'jsbookworm', 'torre188', 'amasia', 'li13175', 'ucotul', 'jartalej', 'freyn581', 'sundara4', 'sarode', 'geist2', 'assafh', 'evans341', 'alberti', 'salina15', 'acartwr']",8,"['bboren', 'syfoo', 'nseiber', 'bmarott', 'kedminis', 'cline56', None, 'gault2']",26,"['jsbookworm', 'torre188', 'bboren', 'syfoo', 'gault2', 'freyn581', 'bmarott', 'geist2', 'assafh', 'evans341', 'alberti', 'cline56', 'salina15', 'acartwr', None, 'kulkar70', 'amasia', 'nwarin', 'li13175', 'ucotul', 'jartalej', 'sundara4', 'nseiber', 'kedminis', 'sarode', 'reploglj']"
65,423,19,9,2,"['jsbookworm', 'acartwr']",16,"['kulkar70', 'nwarin', 'amasia', 'torre188', 'li13175', 'ucotul', 'jartalej', 'sundara4', 'freyn581', 'sarode', 'geist2', 'assafh', 'evans341', 'alberti', 'salina15', 'reploglj']",7,"['li2641', 'danm07', 'yikangyu', 'kessle10', 'wang4612', 'akazemi', None]",25,"['jsbookworm', 'torre188', 'freyn581', 'geist2', 'assafh', 'kessle10', 'evans341', 'alberti', 'salina15', 'acartwr', None, 'kulkar70', 'amasia', 'nwarin', 'li13175', 'ucotul', 'jartalej', 'sundara4', 'li2641', 'sarode', 'danm07', 'yikangyu', 'wang4612', 'akazemi', 'reploglj']"
65,420,19,8,2,"['jsbookworm', 'acartwr']",16,"['kulkar70', 'nwarin', 'amasia', 'torre188', 'li13175', 'ucotul', 'jartalej', 'sundara4', 'freyn581', 'sarode', 'geist2', 'assafh', 'evans341', 'alberti', 'salina15', 'reploglj']",6,"['yang1520', 'danm07', 'wang4612', 'kessle10', 'akazemi', None]",24,"['jsbookworm', 'torre188', 'yang1520', 'freyn581', 'geist2', 'assafh', 'kessle10', 'evans341', 'alberti', 'salina15', 'acartwr', None, 'kulkar70', 'amasia', 'nwarin', 'li13175', 'ucotul', 'jartalej', 'sundara4', 'sarode', 'danm07', 'wang4612', 'akazemi', 'reploglj']"
65,421,19,8,2,"['geist2', 'alberti']",16,"['kulkar70', 'nwarin', 'jsbookworm', 'torre188', 'amasia', 'li13175', 'ucotul', 'jartalej', 'freyn581', 'sundara4', 'sarode', 'assafh', 'evans341', 'salina15', 'acartwr', 'reploglj']",6,"['wils1182', 'dsodhi', 'jgrenn', 'mpollar', 'bparkins', None]",24,"['jsbookworm', 'torre188', 'freyn581', 'wils1182', 'jgrenn', 'geist2', 'assafh', 'evans341', 'alberti', 'salina15', 'acartwr', None, 'kulkar70', 'amasia', 'nwarin', 'li13175', 'ucotul', 'jartalej', 'sundara4', 'dsodhi', 'sarode', 'mpollar', 'bparkins', 'reploglj']"
65,438,19,8,2,"['jartalej', 'li13175']",16,"['kulkar70', 'nwarin', 'jsbookworm', 'torre188', 'amasia', 'ucotul', 'sundara4', 'freyn581', 'sarode', 'geist2', 'assafh', 'evans341', 'alberti', 'salina15', 'acartwr', 'reploglj']",6,"['davis657', 'zhan3742', 'danm07', 'chen2058', 'mrfrye', None]",24,"['jsbookworm', 'torre188', 'davis657', 'freyn581', 'geist2', 'assafh', 'evans341', 'alberti', 'salina15', 'acartwr', None, 'kulkar70', 'amasia', 'nwarin', 'li13175', 'ucotul', 'jartalej', 'sundara4', 'zhan3742', 'sarode', 'danm07', 'chen2058', 'mrfrye', 'reploglj']"
65,443,19,8,1,['li13175'],17,"['kulkar70', 'nwarin', 'jsbookworm', 'torre188', 'amasia', 'ucotul', 'jartalej', 'sundara4', 'freyn581', 'sarode', 'geist2', 'assafh', 'evans341', 'alberti', 'salina15', 'acartwr', 'reploglj']",7,"['hess35', 'disaacar', 'danm07', 'chen2058', 'mrfrye', 'bsule', None]",25,"['jsbookworm', 'torre188', 'freyn581', 'geist2', 'assafh', 'evans341', 'alberti', 'bsule', 'salina15', 'acartwr', None, 'kulkar70', 'amasia', 'nwarin', 'li13175', 'ucotul', 'jartalej', 'sundara4', 'hess35', 'disaacar', 'sarode', 'danm07', 'chen2058', 'mrfrye', 'reploglj']"
65,187,19,7,1,['li13175'],17,"['kulkar70', 'nwarin', 'jsbookworm', 'torre188', 'amasia', 'ucotul', 'jartalej', 'sundara4', 'freyn581', 'sarode', 'geist2', 'assafh', 'evans341', 'alberti', 'salina15', 'acartwr', 'reploglj']",6,"['hess35', 'zhan3742', 'danm07', 'mrfrye', 'bsule', None]",24,"['jsbookworm', 'torre188', 'freyn581', 'geist2', 'assafh', 'evans341', 'alberti', 'bsule', 'salina15', 'acartwr', None, 'kulkar70', 'amasia', 'nwarin', 'li13175', 'ucotul', 'jartalej', 'sundara4', 'hess35', 'zhan3742', 'sarode', 'danm07', 'mrfrye', 'reploglj']"
65,426,19,7,1,['reploglj'],17,"['kulkar70', 'nwarin', 'jsbookworm', 'torre188', 'amasia', 'li13175', 'ucotul', 'jartalej', 'freyn581', 'sundara4', 'sarode', 'geist2', 'assafh', 'evans341', 'alberti', 'salina15', 'acartwr']",6,"['jhofmei', 'syfoo', 'nseiber', 'bmarott', 'cline56', None]",24,"['jsbookworm', 'torre188', 'syfoo', 'freyn581', 'bmarott', 'geist2', 'assafh', 'evans341', 'alberti', 'cline56', 'salina15', 'acartwr', None, 'kulkar70', 'amasia', 'nwarin', 'li13175', 'ucotul', 'jartalej', 'sundara4', 'jhofmei', 'nseiber', 'sarode', 'reploglj']"
65,427,19,7,2,"['geist2', 'alberti']",16,"['kulkar70', 'nwarin', 'jsbookworm', 'torre188', 'amasia', 'li13175', 'ucotul', 'jartalej', 'freyn581', 'sundara4', 'sarode', 'assafh', 'evans341', 'salina15', 'acartwr', 'reploglj']",5,"['wils1182', 'jgrenn', 'mpollar', 'bparkins', None]",23,"['jsbookworm', 'torre188', 'freyn581', 'wils1182', 'jgrenn', 'geist2', 'assafh', 'evans341', 'alberti', 'salina15', 'acartwr', None, 'kulkar70', 'amasia', 'nwarin', 'li13175', 'ucotul', 'jartalej', 'sundara4', 'sarode', 'mpollar', 'bparkins', 'reploglj']"
65,429,19,7,2,"['geist2', 'alberti']",16,"['kulkar70', 'nwarin', 'jsbookworm', 'torre188', 'amasia', 'li13175', 'ucotul', 'jartalej', 'freyn581', 'sundara4', 'sarode', 'assafh', 'evans341', 'salina15', 'acartwr', 'reploglj']",5,"['wils1182', 'jgrenn', 'mpollar', 'bparkins', None]",23,"['jsbookworm', 'torre188', 'freyn581', 'wils1182', 'jgrenn', 'geist2', 'assafh', 'evans341', 'alberti', 'salina15', 'acartwr', None, 'kulkar70', 'amasia', 'nwarin', 'li13175', 'ucotul', 'jartalej', 'sundara4', 'sarode', 'mpollar', 'bparkins', 'reploglj']"
65,444,19,7,1,['freyn581'],17,"['kulkar70', 'nwarin', 'jsbookworm', 'torre188', 'amasia', 'li13175', 'ucotul', 'jartalej', 'sundara4', 'sarode', 'geist2', 'assafh', 'evans341', 'alberti', 'salina15', 'acartwr', 'reploglj']",6,"['mrouleau', 'bboren', 'peter569', 'disaacar', 'kedminis', None]",24,"['jsbookworm', 'torre188', 'bboren', 'peter569', 'freyn581', 'geist2', 'assafh', 'evans341', 'alberti', 'salina15', 'acartwr', None, 'mrouleau', 'kulkar70', 'amasia', 'nwarin', 'li13175', 'ucotul', 'jartalej', 'sundara4', 'disaacar', 'kedminis', 'sarode', 'reploglj']"
65,424,19,6,1,['torre188'],17,"['kulkar70', 'nwarin', 'jsbookworm', 'li13175', 'amasia', 'ucotul', 'jartalej', 'sundara4', 'freyn581', 'sarode', 'geist2', 'assafh', 'evans341', 'alberti', 'salina15', 'acartwr', 'reploglj']",5,"['mdoolit', 'foropeza', 'rabdulra', 'shouzayn', None]",23,"['jsbookworm', 'torre188', 'freyn581', 'rabdulra', 'geist2', 'assafh', 'evans341', 'alberti', 'salina15', 'acartwr', None, 'kulkar70', 'amasia', 'nwarin', 'li13175', 'ucotul', 'jartalej', 'sundara4', 'mdoolit', 'foropeza', 'shouzayn', 'sarode', 'reploglj']"
65,435,19,6,1,['freyn581'],17,"['kulkar70', 'nwarin', 'jsbookworm', 'torre188', 'amasia', 'li13175', 'ucotul', 'jartalej', 'sundara4', 'sarode', 'geist2', 'assafh', 'evans341', 'alberti', 'salina15', 'acartwr', 'reploglj']",5,"['englanj', 'jhofmei', 'hkim21', 'kedminis', None]",23,"['jsbookworm', 'torre188', 'freyn581', 'geist2', 'assafh', 'evans341', 'alberti', 'salina15', 'acartwr', None, 'englanj', 'kulkar70', 'amasia', 'nwarin', 'li13175', 'ucotul', 'jartalej', 'sundara4', 'jhofmei', 'hkim21', 'kedminis', 'sarode', 'reploglj']"
65,439,19,6,1,['freyn581'],17,"['kulkar70', 'nwarin', 'jsbookworm', 'torre188', 'amasia', 'li13175', 'ucotul', 'jartalej', 'sundara4', 'sarode', 'geist2', 'assafh', 'evans341', 'alberti', 'salina15', 'acartwr', 'reploglj']",5,"['bboren', 'hkim21', 'sprovost', 'kedminis', None]",23,"['jsbookworm', 'torre188', 'bboren', 'sprovost', 'freyn581', 'geist2', 'assafh', 'evans341', 'alberti', 'salina15', 'acartwr', None, 'kulkar70', 'amasia', 'nwarin', 'li13175', 'ucotul', 'jartalej', 'sundara4', 'hkim21', 'kedminis', 'sarode', 'reploglj']"
65,441,19,6,1,['freyn581'],17,"['kulkar70', 'nwarin', 'jsbookworm', 'torre188', 'amasia', 'li13175', 'ucotul', 'jartalej', 'sundara4', 'sarode', 'geist2', 'assafh', 'evans341', 'alberti', 'salina15', 'acartwr', 'reploglj']",5,"['bboren', 'peter569', 'sprovost', 'kedminis', None]",23,"['jsbookworm', 'torre188', 'bboren', 'peter569', 'sprovost', 'freyn581', 'geist2', 'assafh', 'evans341', 'alberti', 'salina15', 'acartwr', None, 'kulkar70', 'amasia', 'nwarin', 'li13175', 'ucotul', 'jartalej', 'sundara4', 'kedminis', 'sarode', 'reploglj']"
65,448,19,6,2,"['freyn581', 'reploglj']",16,"['kulkar70', 'nwarin', 'jsbookworm', 'torre188', 'amasia', 'li13175', 'ucotul', 'jartalej', 'sundara4', 'sarode', 'geist2', 'assafh', 'evans341', 'alberti', 'salina15', 'acartwr']",4,"['seufer', None, 'kedminis', 'hkim21']",22,"['jsbookworm', 'torre188', 'freyn581', 'geist2', 'assafh', 'evans341', 'alberti', 'seufer', 'salina15', 'acartwr', None, 'kulkar70', 'amasia', 'nwarin', 'li13175', 'ucotul', 'jartalej', 'sundara4', 'hkim21', 'kedminis', 'sarode', 'reploglj']"
66,552,19,14,12,"['jc3496', 'nis29', 'rrg74', 'krg66', 'jjh377', 'al2493', 'jpm432', 'akn52', 'anc95', 'rss364', 'ksc225', 'jg2337']",6,"['cml66', 'masudvalavi', 'jz854', 'xingyuwang000', 'joshgabriel92', 'jro277']",2,"['lt448', None]",20,"['akn52', 'nis29', 'rrg74', 'krg66', 'masudvalavi', 'jjh377', None, 'jg2337', 'jc3496', 'lt448', 'cml66', 'jz854', 'al2493', 'xingyuwang000', 'jpm432', 'joshgabriel92', 'anc95', 'rss364', 'ksc225', 'jro277']"
67,375,19,34,3,"['wookunjeon13', 'maheleta', 'huucuong0517']",15,"['bajabaja890', 'zndorado', 'shreshankar', 'jbestavas1', 'prof.alqulaiaa', 'mikexue7', 'soujusalvankar', 'tjyoth123', 'jaydoherty', 'vinodhkumar.cc', 'ferrario.andrea', 'd.s.kirankumarreddy', 'chenyuewang', 'alexander.zzy', 'aarondfranklin']",31,"['lockbox30', 'kianamon', 'gjb56', 'icd29', 'monkasirsaber98', 'nando97', 'hary765', 'do356', 'enweizhang732', 'mf3256', 'hlp54', 'ml3566', 'xg69', 'twcross11', 'omg29', 'gedaliakoehler', 'kp825', 'kevinh88', 'pan_1238', 'ben3862', 'saf339', 'anthschr', 'jlanzoni18', None, 'jmcveigh55', 'sabbate1992', 'mtb336', 'jpalko20', 'nicolech73', 'phimanhcuong1', 'skythaker5']",49,"['wookunjeon13', 'bajabaja890', 'lockbox30', 'prof.alqulaiaa', 'kianamon', 'maheleta', 'gjb56', 'icd29', 'monkasirsaber98', 'nando97', 'hary765', 'soujusalvankar', 'chenyuewang', 'do356', 'tjyoth123', 'enweizhang732', 'mf3256', 'shreshankar', 'zndorado', 'hlp54', 'ml3566', 'xg69', 'twcross11', 'omg29', 'gedaliakoehler', 'kp825', 'kevinh88', 'huucuong0517', 'vinodhkumar.cc', 'ferrario.andrea', 'd.s.kirankumarreddy', 'pan_1238', 'alexander.zzy', 'ben3862', 'mikexue7', 'saf339', 'anthschr', 'jaydoherty', 'jlanzoni18', None, 'jmcveigh55', 'jbestavas1', 'sabbate1992', 'mtb336', 'jpalko20', 'nicolech73', 'phimanhcuong1', 'skythaker5', 'aarondfranklin']"
67,374,19,23,2,"['jaydoherty', 'aarondfranklin']",16,"['wookunjeon13', 'bajabaja890', 'shreshankar', 'zndorado', 'prof.alqulaiaa', 'jbestavas1', 'mikexue7', 'maheleta', 'soujusalvankar', 'huucuong0517', 'vinodhkumar.cc', 'ferrario.andrea', 'd.s.kirankumarreddy', 'chenyuewang', 'alexander.zzy', 'tjyoth123']",21,"['nwilli43', 'mrosetai', 'rdemma.andy', 'liavcueto', 'alex.oesterling', 'diegochll', 'gavro', 'lu.fogolin', 'cayschuval', 'nanoschettewi', 'nonstopeve', 'tikagergaia', 'jacknastas', 'isabellak', 'cdcalahn', 'jonsandoval229', None, 'shufanwen0516', 'mdensel2', '1jordanschwartz', 'tendralsonofvend']",39,"['wookunjeon13', 'bajabaja890', 'nwilli43', 'prof.alqulaiaa', 'maheleta', 'mrosetai', 'soujusalvankar', 'chenyuewang', 'tjyoth123', 'shreshankar', 'zndorado', 'rdemma.andy', 'liavcueto', 'huucuong0517', 'alex.oesterling', 'diegochll', 'vinodhkumar.cc', 'ferrario.andrea', 'd.s.kirankumarreddy', 'gavro', 'lu.fogolin', 'alexander.zzy', 'cayschuval', 'nanoschettewi', 'mikexue7', 'nonstopeve', 'tikagergaia', 'jacknastas', 'isabellak', 'jaydoherty', 'cdcalahn', 'jonsandoval229', None, 'shufanwen0516', 'jbestavas1', 'mdensel2', '1jordanschwartz', 'tendralsonofvend', 'aarondfranklin']"
67,370,19,14,2,"['zndorado', 'jbestavas1']",16,"['wookunjeon13', 'bajabaja890', 'shreshankar', 'prof.alqulaiaa', 'mikexue7', 'maheleta', 'soujusalvankar', 'tjyoth123', 'jaydoherty', 'huucuong0517', 'vinodhkumar.cc', 'ferrario.andrea', 'd.s.kirankumarreddy', 'chenyuewang', 'alexander.zzy', 'aarondfranklin']",12,"[None, 'stellaq', 'lesliet', 'ivizzh', 'ginazavala8', 'ajmirelesme', 'celinechiong', 'aepadilla4', 'jordanhitter41', 'mr.alannunez', 'katia011', 'hectz96']",30,"['wookunjeon13', 'bajabaja890', 'prof.alqulaiaa', 'mikexue7', 'maheleta', 'lesliet', 'ginazavala8', 'jaydoherty', 'celinechiong', 'jordanhitter41', 'soujusalvankar', 'chenyuewang', None, 'tjyoth123', 'katia011', 'shreshankar', 'zndorado', 'jbestavas1', 'stellaq', 'mr.alannunez', 'ivizzh', 'ajmirelesme', 'huucuong0517', 'vinodhkumar.cc', 'ferrario.andrea', 'd.s.kirankumarreddy', 'aepadilla4', 'alexander.zzy', 'aarondfranklin', 'hectz96']"
67,371,19,6,1,['prof.alqulaiaa'],17,"['wookunjeon13', 'bajabaja890', 'shreshankar', 'jbestavas1', 'zndorado', 'mikexue7', 'maheleta', 'soujusalvankar', 'tjyoth123', 'jaydoherty', 'huucuong0517', 'vinodhkumar.cc', 'ferrario.andrea', 'd.s.kirankumarreddy', 'chenyuewang', 'alexander.zzy', 'aarondfranklin']",5,"['qpzmal7024', 'natelson', 'hatem.babaa', None, 'pballentine']",23,"['wookunjeon13', 'bajabaja890', 'prof.alqulaiaa', 'mikexue7', 'maheleta', 'qpzmal7024', 'jaydoherty', 'soujusalvankar', 'chenyuewang', None, 'tjyoth123', 'shreshankar', 'zndorado', 'jbestavas1', 'huucuong0517', 'vinodhkumar.cc', 'ferrario.andrea', 'd.s.kirankumarreddy', 'natelson', 'hatem.babaa', 'alexander.zzy', 'pballentine', 'aarondfranklin']"
68,90,18,15,12,"['ealhussei', 'jjames1', 'tchalleng', 'andrea4', 'aivanovic', 'bwieland', 'sschlaud03', 'dbarry', 'eauner', 'rrockafel', 'msaucedoc', 'faldawood']",5,"['jdpinedac', 'vgromakov', 'ebeckmon', 'kssachin', 'miracluez']",3,"['mmorley', None, 'hjiang']",20,"['vgromakov', 'ebeckmon', 'kssachin', 'bwieland', 'aivanovic', 'hjiang', 'jjames1', 'msaucedoc', None, 'ealhussei', 'jdpinedac', 'tchalleng', 'andrea4', 'miracluez', 'dbarry', 'sschlaud03', 'mmorley', 'eauner', 'rrockafel', 'faldawood']"
68,91,18,13,12,"['ealhussei', 'jjames1', 'vgromakov', 'tchalleng', 'ebeckmon', 'andrea4', 'bwieland', 'dbarry', 'eauner', 'rrockafel', 'msaucedoc', 'faldawood']",5,"['jdpinedac', 'aivanovic', 'kssachin', 'miracluez', 'sschlaud03']",1,[None],18,"['vgromakov', 'ebeckmon', 'kssachin', 'bwieland', 'aivanovic', 'jjames1', 'msaucedoc', None, 'ealhussei', 'jdpinedac', 'tchalleng', 'andrea4', 'miracluez', 'dbarry', 'sschlaud03', 'eauner', 'rrockafel', 'faldawood']"
68,92,18,12,10,"['ealhussei', 'andrea4', 'ebeckmon', 'bwieland', 'aivanovic', 'sschlaud03', 'dbarry', 'eauner', 'rrockafel', 'msaucedoc']",7,"['jdpinedac', 'vgromakov', 'tchalleng', 'kssachin', 'miracluez', 'jjames1', 'faldawood']",2,"[None, 'hjiang']",19,"['vgromakov', 'ebeckmon', 'kssachin', 'bwieland', 'aivanovic', 'hjiang', 'jjames1', 'msaucedoc', None, 'ealhussei', 'jdpinedac', 'tchalleng', 'andrea4', 'miracluez', 'dbarry', 'sschlaud03', 'eauner', 'rrockafel', 'faldawood']"
68,95,18,10,9,"['jjames1', 'tchalleng', 'andrea4', 'ebeckmon', 'dbarry', 'eauner', 'rrockafel', 'msaucedoc', 'faldawood']",8,"['ealhussei', 'jdpinedac', 'vgromakov', 'aivanovic', 'kssachin', 'bwieland', 'miracluez', 'sschlaud03']",1,[None],18,"['vgromakov', 'ebeckmon', 'kssachin', 'bwieland', 'aivanovic', 'jjames1', 'msaucedoc', None, 'ealhussei', 'jdpinedac', 'tchalleng', 'andrea4', 'miracluez', 'dbarry', 'sschlaud03', 'eauner', 'rrockafel', 'faldawood']"
69,270,18,115,10,"['lcaspari', 'li3422', 'wiley29', 'hutchi47', 'kerr38', 'robin498', 'lucas120', 'hartm109', 'nquick', 'cdenoo']",7,"['pbreymey', 'barker56', 'lucywagner', 'elutgen', 'sboelitz', 'zzipf', 'aalruhai']",105,"['hshrote', 'kbalon2599', 'nhelstro', 'cstrider', 'shonnigf', 'nqmain', 'king399', 'imran1', 'aklitzin', 'estockwe', 'amatus', 'wheffern', 'dick21', 'carvalho', 'rookie7201', 'aaryanp', 'acharter16', 'cfeustel', 'cdunn', 'rach', 'webbie.mao', 'jkliebh', 'missahaq', 'czrelak', 'mill2201', 'jack.t.roy42', 'ayusabrina.asas', 'vfebus', 'mfroelic', 'rfranco', 'glut3n', 'campb294', 'mills21rdp', 'dmarcha', 'dawson41', 'akhairul', 'mglimche', 'audyavar', 'harter4', 'dildyks', 'beckpe', 'pdahlstr', 'sachdev6', 'balpert', 'clark600', 'zyao16811', 'duarte3', 'li2978', 'joecasella252', 'rkeyser', 'haoyangliu', 'campb335', 'claytkg', 'jsendon', 'ahmad44', 'bohangni', 'boyer23', 'smit3522', 'aomoniy', 'mlennar', 'jacobczajac', 'hamadeo', 'tcounse', 'kim2841', 'beshay', 'lorenz17', 'wu1283', 'popp4', 'malone99', 'cdiscoe', 'huan1260', 'jzwierz', 'max_pack', 'hogan46', 'kleber0', 'crawfo76', 'yu780', 'jabarigarraway', 'kerr32', 'bauer85', 'yang1098', 'carls127', 'azovko', 'swiftl116', 'rjammula', 'castil77', 'aalhabsi', 'lhoppenr', 'bianchik', 'alexge', 'lazaraleksic', None, 'gu256', 'jayaramm', 'ngeer', 'mqz857277715', 'lararipe', 'glaneve', 'huan1318', 'sujal.yagnik', 'soni12', 'randy14rhh2', 'noah.stern99', 'dhanixv0', 'acarrilh']",122,"['hshrote', 'kbalon2599', 'nhelstro', 'shonnigf', 'nqmain', 'aklitzin', 'barker56', 'hartm109', 'dick21', 'carvalho', 'rookie7201', 'aaryanp', 'cfeustel', 'cdunn', 'rach', 'webbie.mao', 'missahaq', 'mill2201', 'jack.t.roy42', 'cdenoo', 'mfroelic', 'rfranco', 'glut3n', 'mills21rdp', 'kerr38', 'dmarcha', 'akhairul', 'mglimche', 'sboelitz', 'lcaspari', 'sachdev6', 'balpert', 'clark600', 'li2978', 'robin498', 'jsendon', 'ahmad44', 'smit3522', 'hamadeo', 'tcounse', 'kim2841', 'lorenz17', 'wiley29', 'popp4', 'malone99', 'huan1260', 'max_pack', 'nquick', 'yu780', 'bauer85', 'carls127', 'castil77', 'aalhabsi', 'lhoppenr', 'bianchik', 'alexge', None, 'gu256', 'mqz857277715', 'glaneve', 'sujal.yagnik', 'soni12', 'randy14rhh2', 'acarrilh', 'cstrider', 'king399', 'imran1', 'estockwe', 'amatus', 'wheffern', 'acharter16', 'jkliebh', 'czrelak', 'ayusabrina.asas', 'vfebus', 'campb294', 'li3422', 'dawson41', 'audyavar', 'elutgen', 'harter4', 'dildyks', 'beckpe', 'pdahlstr', 'hutchi47', 'zyao16811', 'duarte3', 'joecasella252', 'rkeyser', 'haoyangliu', 'campb335', 'claytkg', 'bohangni', 'boyer23', 'aomoniy', 'mlennar', 'jacobczajac', 'beshay', 'wu1283', 'pbreymey', 'cdiscoe', 'jzwierz', 'hogan46', 'kleber0', 'crawfo76', 'aalruhai', 'jabarigarraway', 'kerr32', 'yang1098', 'azovko', 'swiftl116', 'rjammula', 'lazaraleksic', 'lucas120', 'jayaramm', 'ngeer', 'lararipe', 'huan1318', 'lucywagner', 'noah.stern99', 'dhanixv0', 'zzipf']"
69,273,18,107,10,"['li3422', 'wiley29', 'hutchi47', 'kerr38', 'robin498', 'lucas120', 'hartm109', 'nquick', 'cdenoo', 'sboelitz']",7,"['lcaspari', 'pbreymey', 'barker56', 'lucywagner', 'elutgen', 'zzipf', 'aalruhai']",97,"['hshrote', 'kbalon2599', 'nhelstro', 'cstrider', 'king399', 'nqmain', 'imran1', 'estockwe', 'aklitzin', 'amatus', 'wheffern', 'dick21', 'carvalho', 'rookie7201', 'cfeustel', 'cdunn', 'rach', 'webbie.mao', 'jkliebh', 'czrelak', 'mill2201', 'jack.t.roy42', 'ayusabrina.asas', 'vfebus', 'mfroelic', 'rfranco', 'campb294', 'dmarcha', 'akhairul', 'mglimche', 'audyavar', 'harter4', 'dildyks', 'beckpe', 'pdahlstr', 'sachdev6', 'balpert', 'clark600', 'zyao16811', 'duarte3', 'li2978', 'joecasella252', 'rkeyser', 'haoyangliu', 'mullin21', 'campb335', 'claytkg', 'jsendon', 'ahmad44', 'bohangni', 'boyer23', 'mlennar', 'aomoniy', 'hamadeo', 'tcounse', 'kim2841', 'beshay', 'lorenz17', 'ehultman', 'wu1283', 'malone99', 'kortee', 'huan1260', 'jzwierz', 'max_pack', 'hogan46', 'kleber0', 'crawfo76', 'yu780', 'jabarigarraway', 'kerr32', 'bauer85', 'yang1098', 'carls127', 'azovko', 'swiftl116', 'rjammula', 'castil77', 'aalhabsi', 'bianchik', 'alexge', 'lazaraleksic', 'hrubyr', None, 'gu256', 'jayaramm', 'scroskey', 'ngeer', 'mqz857277715', 'lararipe', 'glaneve', 'sujal.yagnik', 'soni12', 'randy14rhh2', 'noah.stern99', 'dhanixv0', 'acarrilh']",114,"['hshrote', 'kbalon2599', 'nhelstro', 'cstrider', 'king399', 'nqmain', 'imran1', 'estockwe', 'aklitzin', 'barker56', 'amatus', 'hartm109', 'wheffern', 'dick21', 'carvalho', 'rookie7201', 'cfeustel', 'cdunn', 'rach', 'webbie.mao', 'jkliebh', 'czrelak', 'mill2201', 'jack.t.roy42', 'ayusabrina.asas', 'vfebus', 'cdenoo', 'mfroelic', 'rfranco', 'campb294', 'li3422', 'kerr38', 'dmarcha', 'akhairul', 'mglimche', 'audyavar', 'elutgen', 'harter4', 'dildyks', 'sboelitz', 'lcaspari', 'beckpe', 'pdahlstr', 'sachdev6', 'hutchi47', 'balpert', 'clark600', 'zyao16811', 'duarte3', 'li2978', 'robin498', 'joecasella252', 'rkeyser', 'haoyangliu', 'mullin21', 'campb335', 'claytkg', 'jsendon', 'ahmad44', 'bohangni', 'boyer23', 'mlennar', 'aomoniy', 'hamadeo', 'tcounse', 'kim2841', 'beshay', 'lorenz17', 'ehultman', 'wu1283', 'wiley29', 'pbreymey', 'malone99', 'kortee', 'dhanixv0', 'huan1260', 'jzwierz', 'max_pack', 'hogan46', 'nquick', 'kleber0', 'crawfo76', 'yu780', 'aalruhai', 'jabarigarraway', 'kerr32', 'bauer85', 'yang1098', 'carls127', 'azovko', 'swiftl116', 'rjammula', 'castil77', 'aalhabsi', 'bianchik', 'alexge', 'lazaraleksic', 'hrubyr', 'lucas120', None, 'gu256', 'jayaramm', 'scroskey', 'ngeer', 'mqz857277715', 'lararipe', 'glaneve', 'sujal.yagnik', 'lucywagner', 'soni12', 'randy14rhh2', 'noah.stern99', 'zzipf', 'acarrilh']"
69,217,18,40,5,"['wiley29', 'barker56', 'lucywagner', 'aalruhai', 'sboelitz']",12,"['lcaspari', 'li3422', 'pbreymey', 'hutchi47', 'kerr38', 'zzipf', 'robin498', 'lucas120', 'elutgen', 'hartm109', 'nquick', 'cdenoo']",35,"['jacobczajac', 'nqmain', 'estockwe', 'kim2841', 'mchrisiglesias717', 'beshay', 'carvalho', 'cdunn', 'cannon333', 'huan1260', 'missahaq', 'wells89', 'kocher1', 'malhamm', 'arayapro', 'jabarigarraway', 'yang1098', 'mosterk', 'aalhabsi', 'akhairul', 'shah443', None, 'scroskey', 'lopez400', 'kerr35', 'lararipe', 'sachdev6', 'balpert', 'clark600', 'anifalak', 'li2978', 'cwalchle', 'randy14rhh2', 'dhanixv0', 'acarrilh']",52,"['jacobczajac', 'nqmain', 'estockwe', 'barker56', 'hartm109', 'kim2841', 'mchrisiglesias717', 'carvalho', 'beshay', 'cdunn', 'wiley29', 'pbreymey', 'cannon333', 'huan1260', 'missahaq', 'nquick', 'wells89', 'kocher1', 'cdenoo', 'malhamm', 'aalruhai', 'arayapro', 'jabarigarraway', 'yang1098', 'li3422', 'mosterk', 'kerr38', 'aalhabsi', 'akhairul', 'lucas120', 'elutgen', 'shah443', None, 'sboelitz', 'scroskey', 'lcaspari', 'lopez400', 'kerr35', 'lararipe', 'sachdev6', 'hutchi47', 'balpert', 'clark600', 'anifalak', 'robin498', 'li2978', 'cwalchle', 'lucywagner', 'randy14rhh2', 'dhanixv0', 'zzipf', 'acarrilh']"
69,271,18,33,1,['elutgen'],16,"['lcaspari', 'li3422', 'wiley29', 'pbreymey', 'hutchi47', 'kerr38', 'zzipf', 'robin498', 'barker56', 'lucas120', 'hartm109', 'nquick', 'lucywagner', 'sboelitz', 'cdenoo', 'aalruhai']",32,"['ktbrode22', 'aguarner', 'lfabries', 'pike14', 'tchen135', 'chakra26', 'cdunn', 'sarawhite99', 'gdadlani', 'clancy6', 'ldefrei', 'ctorger', 'hall488', 'zosterlo', 'mohamadn', 'eklueppe', 'kkrinnin', 'mtallman', 'ronny927', None, 'jayaramm', 'boston2', 'wells130', 'mpugsley', 'gotoa', 'chen2467', 'york33', 'wu1326', 'haoyangliu', 'camronn.hale', 'campb335', 'jvanwing']",49,"['ktbrode22', 'aguarner', 'lfabries', 'pike14', 'tchen135', 'barker56', 'hartm109', 'chakra26', 'cdunn', 'wiley29', 'pbreymey', 'sarawhite99', 'gdadlani', 'clancy6', 'nquick', 'ldefrei', 'cdenoo', 'ctorger', 'aalruhai', 'hall488', 'zosterlo', 'li3422', 'mohamadn', 'kerr38', 'eklueppe', 'lucas120', 'elutgen', 'kkrinnin', 'mtallman', 'ronny927', None, 'sboelitz', 'jayaramm', 'boston2', 'lcaspari', 'wells130', 'mpugsley', 'gotoa', 'hutchi47', 'chen2467', 'york33', 'robin498', 'wu1326', 'lucywagner', 'haoyangliu', 'camronn.hale', 'zzipf', 'campb335', 'jvanwing']"
69,285,18,32,16,"['lcaspari', 'li3422', 'wiley29', 'pbreymey', 'hutchi47', 'kerr38', 'zzipf', 'robin498', 'barker56', 'lucas120', 'hartm109', 'nquick', 'lucywagner', 'sboelitz', 'cdenoo', 'aalruhai']",1,['elutgen'],16,"['pickera', 'epiergal', 'lopez400', 'jmacatan', 'perkintj', 'gjensen', 'dmassow', 'selizond', 'reger1', 'rcerne', 'iclyde', 'zhan2846', 'nlieu', 'yang837', None, 'gu256']",33,"['epiergal', 'dmassow', 'barker56', 'hartm109', 'perkintj', 'wiley29', 'pbreymey', 'selizond', 'rcerne', 'zhan2846', 'nquick', 'cdenoo', 'aalruhai', 'pickera', 'li3422', 'kerr38', 'lucas120', 'elutgen', 'yang837', None, 'gu256', 'sboelitz', 'lcaspari', 'lopez400', 'jmacatan', 'gjensen', 'hutchi47', 'reger1', 'robin498', 'iclyde', 'nlieu', 'lucywagner', 'zzipf']"
69,554,18,29,15,"['lcaspari', 'li3422', 'wiley29', 'pbreymey', 'kerr38', 'zzipf', 'robin498', 'barker56', 'lucas120', 'hartm109', 'nquick', 'lucywagner', 'sboelitz', 'cdenoo', 'aalruhai']",2,"['hutchi47', 'elutgen']",14,"['pickera', 'epiergal', 'lopez400', None, 'perkintj', 'jmacatan', 'selizond', 'reger1', 'rcerne', 'iclyde', 'nlieu', 'yang837', 'dmassow', 'gu256']",31,"['epiergal', 'dmassow', 'barker56', 'hartm109', 'perkintj', 'wiley29', 'pbreymey', 'selizond', 'rcerne', 'nquick', 'cdenoo', 'aalruhai', 'pickera', 'li3422', 'kerr38', 'lucas120', 'elutgen', 'yang837', None, 'gu256', 'sboelitz', 'lcaspari', 'lopez400', 'jmacatan', 'hutchi47', 'reger1', 'robin498', 'iclyde', 'nlieu', 'lucywagner', 'zzipf']"
69,401,18,24,14,"['lcaspari', 'li3422', 'pbreymey', 'hutchi47', 'kerr38', 'zzipf', 'robin498', 'barker56', 'lucas120', 'hartm109', 'nquick', 'lucywagner', 'cdenoo', 'sboelitz']",3,"['aalruhai', 'elutgen', 'wiley29']",10,"['pickera', 'epiergal', 'lopez400', 'jmacatan', 'dmassow', 'gjensen', 'reger1', 'nlieu', None, 'gu256']",27,"['epiergal', 'dmassow', 'barker56', 'hartm109', 'wiley29', 'pbreymey', 'nquick', 'cdenoo', 'aalruhai', 'pickera', 'li3422', 'kerr38', 'lucas120', 'elutgen', None, 'gu256', 'sboelitz', 'lcaspari', 'lopez400', 'jmacatan', 'gjensen', 'hutchi47', 'reger1', 'robin498', 'nlieu', 'lucywagner', 'zzipf']"
69,175,18,21,1,['sboelitz'],16,"['lcaspari', 'li3422', 'wiley29', 'pbreymey', 'hutchi47', 'kerr38', 'zzipf', 'robin498', 'barker56', 'lucas120', 'elutgen', 'hartm109', 'nquick', 'lucywagner', 'cdenoo', 'aalruhai']",20,"['ehultman', 'kortee', 'baile261', 'jeast9867', 'kocher1', 'layyar', 'pickera', 'flore170', 'sganivet', 'pattiya_p', 'schro118', 'hrubyr', None, 'scroskey', 'lopez400', 'glaneve', 'jarvis8', 'hillej', 'mullin21', 'lake14']",37,"['barker56', 'hartm109', 'ehultman', 'wiley29', 'pbreymey', 'kortee', 'baile261', 'jeast9867', 'nquick', 'kocher1', 'layyar', 'cdenoo', 'aalruhai', 'pickera', 'li3422', 'flore170', 'sganivet', 'pattiya_p', 'kerr38', 'schro118', 'hrubyr', 'lucas120', 'elutgen', 'mullin21', None, 'sboelitz', 'scroskey', 'lcaspari', 'lopez400', 'hutchi47', 'glaneve', 'jarvis8', 'robin498', 'lucywagner', 'hillej', 'zzipf', 'lake14']"
69,218,18,10,1,['elutgen'],16,"['lcaspari', 'li3422', 'wiley29', 'pbreymey', 'hutchi47', 'kerr38', 'zzipf', 'robin498', 'barker56', 'lucas120', 'hartm109', 'nquick', 'lucywagner', 'sboelitz', 'cdenoo', 'aalruhai']",9,"['chakra26', 'wells130', 'sen16', 'bauer85', 'cdunn', 'jsomm99', 'marysemak', None, 'jvanwing']",26,"['bauer85', 'li3422', 'kerr38', 'barker56', 'lucas120', 'elutgen', 'hartm109', None, 'sboelitz', 'lcaspari', 'chakra26', 'wells130', 'sen16', 'cdunn', 'wiley29', 'pbreymey', 'hutchi47', 'zzipf', 'jsomm99', 'marysemak', 'robin498', 'nquick', 'lucywagner', 'cdenoo', 'aalruhai', 'jvanwing']"
69,288,18,8,2,"['kerr38', 'cdenoo']",15,"['lcaspari', 'li3422', 'wiley29', 'pbreymey', 'hutchi47', 'sboelitz', 'robin498', 'barker56', 'lucas120', 'elutgen', 'hartm109', 'nquick', 'lucywagner', 'zzipf', 'aalruhai']",6,"['pickera', 'jmacatan', None, 'nlieu', 'dmassow', 'gu256']",23,"['pickera', 'li3422', 'dmassow', 'kerr38', 'barker56', 'lucas120', 'elutgen', 'hartm109', None, 'gu256', 'sboelitz', 'lcaspari', 'jmacatan', 'wiley29', 'pbreymey', 'hutchi47', 'zzipf', 'robin498', 'nlieu', 'nquick', 'lucywagner', 'cdenoo', 'aalruhai']"
69,286,18,7,1,['elutgen'],16,"['lcaspari', 'li3422', 'wiley29', 'pbreymey', 'hutchi47', 'kerr38', 'zzipf', 'robin498', 'barker56', 'lucas120', 'hartm109', 'nquick', 'lucywagner', 'sboelitz', 'cdenoo', 'aalruhai']",6,"['jdomasky', 'mohamadn', 'everbru', 'zzmola', 'mullert', None]",23,"['jdomasky', 'li3422', 'mohamadn', 'kerr38', 'barker56', 'lucas120', 'elutgen', 'hartm109', None, 'sboelitz', 'lcaspari', 'everbru', 'zzmola', 'wiley29', 'pbreymey', 'hutchi47', 'zzipf', 'robin498', 'nquick', 'lucywagner', 'mullert', 'cdenoo', 'aalruhai']"
69,553,18,7,5,"['li3422', 'wiley29', 'hutchi47', 'lucas120', 'zzipf']",12,"['lcaspari', 'pbreymey', 'kerr38', 'robin498', 'barker56', 'nquick', 'elutgen', 'hartm109', 'lucywagner', 'sboelitz', 'cdenoo', 'aalruhai']",2,"[None, 'reger1']",19,"['li3422', 'kerr38', 'barker56', 'lucas120', 'elutgen', 'hartm109', None, 'sboelitz', 'lcaspari', 'wiley29', 'pbreymey', 'hutchi47', 'zzipf', 'reger1', 'robin498', 'nquick', 'lucywagner', 'cdenoo', 'aalruhai']"
69,555,18,7,1,['elutgen'],16,"['lcaspari', 'li3422', 'wiley29', 'pbreymey', 'hutchi47', 'kerr38', 'zzipf', 'robin498', 'barker56', 'lucas120', 'hartm109', 'nquick', 'lucywagner', 'sboelitz', 'cdenoo', 'aalruhai']",6,"['jdomasky', 'mohamadn', 'everbru', 'zzmola', 'mullert', None]",23,"['jdomasky', 'li3422', 'mohamadn', 'kerr38', 'barker56', 'lucas120', 'elutgen', 'hartm109', None, 'sboelitz', 'lcaspari', 'everbru', 'zzmola', 'wiley29', 'pbreymey', 'hutchi47', 'zzipf', 'robin498', 'nquick', 'lucywagner', 'mullert', 'cdenoo', 'aalruhai']"
70,414,18,18,12,"['abua423', 'jttaylor', 'tjdealba', 'patrblackmon', 'egalloway', 'dansparrow99', 'rajpatel.823', 'anagpal', 'ericmiller465', 'l_miranda_h', 'bus16713', 'lobwedge']",5,"['7036418841r', 'shaikmansurmaari143', 'lukeislucky98', 'chris.caney', 'ullaskperuvaje']",6,"[None, 'prestons117', 'chanceanders', 'jeffreyfisherii', 'wsyhuang', 'arizaman']",23,"['abua423', 'patrblackmon', 'egalloway', 'dansparrow99', 'rajpatel.823', 'l_miranda_h', 'bus16713', 'chris.caney', 'ullaskperuvaje', None, 'lobwedge', 'ericmiller465', '7036418841r', 'jttaylor', 'tjdealba', 'prestons117', 'anagpal', 'shaikmansurmaari143', 'chanceanders', 'lukeislucky98', 'jeffreyfisherii', 'wsyhuang', 'arizaman']"
71,21,18,137,16,"['kimsw9506', 'gunso', 'tjwjdqja5', 'kdy3894', 'euem789', 'jihwanch1', 'sohny94', 'wndud5258', 'aaddss3210', 'terry0511', 'ansckdqja123', 'b615057', 'eogksakdhkd', 'ksw950828', 'chaems322', 'b515037']",1,['bananavati'],121,"['eomhyobin1227', 'sgu20161468', 'pshrap37', 'sgu20161506', 'vmike0426', 'sgu20191512', 'sgu20151432', 'sgu20161512', 'sgu20141410', 'mephistokc', 'sgu20171492', 'hyuk8041', 'jisooyoon', '112zxczxc', 'sgu20171560', 'sgu20161466', 'sgu20161541', 'sgu20161508', 'sgu20161486', 'sgu20171588', 'sgu20191492', 'sgu20151431', 'comebacktome', 'sgu20151426', 'ehrnjs326', 'tpcks96', 'sgu20191494', 'youjiyeon', 'sgu20181504', 'sgu20161556', 'my1hunter', 'sgu20171552', 'sgu20141475', 'sgu20181576', 'sgu20161536', 'sgu20151313', 'sgu20161497', 'sgu20161460', 'juni8472', 'sgu20171582', 'sgu20171510', 'sgu20171530', 'sgu20161523', 'b619100', 'sgu20161450', 'sgu20171592', 'sgu20171566', 'sgu20171496', 'sgu20171528', None, 'sgu20191490', 'sgu20191550', 'ittopsk', 'sgu20191454', 'sgu20191534', 'sgu20161507', 'sgu20191466', 'sgu20151500', 'b715063minbyeongmoon', 'sgu20191496', 'kdm52', 'sgu20161518', 'sgu20151461', 'sgu20171536', 'beoungwoo', 'jaeeun53', 'yubhop', 'sgu20151414', 'sgu20151508', 'sgu20171594', 'werr011', 'andrewmon', 'sgu20181330', 'jgyyeong', 'sgu20171534', 'dldmsrbx', 'sgu20151878', 'poweroftrust', 'jpuko11', 'sug20171516', 'sgu20171546', 'sgu20151434', 'zldrktgusrbs3242', 'sgu20171564', 'jihongkim', 'sgu20151428', 'jaegisehyun', 'sgu20161528', 'sgu20151480', 'sgu20161488', 'jpuko00', 'their123', 'sgu20191462', 'jihyeonlee', 'tjwldbsdbs', 'sgu20151421', 'b919083', 'saga102938', 'sogang20191452', 'wodh97', 'sgu20181572', 'sgu20171596', 'sgu20171516', 'sgu20151488', 'sgu20151453', 'sgu20141461', 'sgu20161492', 'sgu20131274', 'sgu20171578', 'sgu20191476', 'sgu20171548', 'sgu20151507', 'sgu20151467', 'sgu20141740', 'hanmir', 'poby', 'hye8913', 'sgu20171503', 'sgu20171506', 'sgu20171573', 'sgu20161538']",138,"['eomhyobin1227', 'sgu20161468', 'bananavati', 'pshrap37', 'sgu20161506', 'eogksakdhkd', 'vmike0426', 'sgu20191512', 'sgu20151432', 'sgu20161512', 'sgu20141410', 'mephistokc', 'sgu20171492', 'hyuk8041', 'jisooyoon', '112zxczxc', 'sgu20171560', 'sgu20161466', 'sgu20161541', 'sgu20161508', 'kdy3894', 'sohny94', 'sgu20161486', 'sgu20171588', 'sgu20191492', 'sgu20151431', 'comebacktome', 'sgu20151426', 'ehrnjs326', 'tpcks96', 'sgu20191494', 'terry0511', 'youjiyeon', 'ksw950828', 'sgu20181504', 'sgu20161556', 'my1hunter', 'sgu20171552', 'sgu20141475', 'sgu20181576', 'sgu20161536', 'sgu20151313', 'sgu20161497', 'sgu20161460', 'juni8472', 'sgu20171582', 'sgu20171510', 'sgu20171530', 'ansckdqja123', 'sgu20161523', 'b619100', 'sgu20161450', 'sgu20171592', 'sgu20171566', 'sgu20171496', 'sgu20171528', None, 'sgu20191490', 'tjwjdqja5', 'sgu20191550', 'wndud5258', 'ittopsk', 'sgu20191454', 'sgu20191534', 'sgu20161507', 'sgu20191466', 'sgu20151500', 'b715063minbyeongmoon', 'sgu20191496', 'kdm52', 'sgu20161518', 'sgu20151461', 'sgu20171536', 'beoungwoo', 'jaeeun53', 'yubhop', 'sgu20151414', 'sgu20151508', 'sgu20171594', 'werr011', 'gunso', 'andrewmon', 'sgu20181330', 'jgyyeong', 'sgu20171534', 'dldmsrbx', 'sgu20151878', 'poweroftrust', 'jpuko11', 'sug20171516', 'sgu20171546', 'sgu20151434', 'zldrktgusrbs3242', 'sgu20171564', 'b515037', 'jihongkim', 'sgu20151428', 'jaegisehyun', 'sgu20161528', 'sgu20151480', 'sgu20161488', 'b615057', 'jpuko00', 'their123', 'sgu20191462', 'jihyeonlee', 'tjwldbsdbs', 'euem789', 'sgu20151421', 'chaems322', 'b919083', 'saga102938', 'sogang20191452', 'jihwanch1', 'aaddss3210', 'wodh97', 'sgu20181572', 'sgu20171596', 'sgu20171516', 'kimsw9506', 'sgu20151488', 'sgu20151453', 'sgu20141461', 'sgu20161492', 'sgu20131274', 'sgu20171578', 'sgu20191476', 'sgu20171548', 'sgu20151507', 'sgu20151467', 'sgu20141740', 'hanmir', 'poby', 'hye8913', 'sgu20171503', 'sgu20171506', 'sgu20171573', 'sgu20161538']"
71,11,18,27,1,['bananavati'],16,"['kimsw9506', 'gunso', 'tjwjdqja5', 'kdy3894', 'euem789', 'jihwanch1', 'sohny94', 'wndud5258', 'aaddss3210', 'terry0511', 'ansckdqja123', 'b615057', 'eogksakdhkd', 'ksw950828', 'chaems322', 'b515037']",26,"['irohith', 'varshit', 'ee19btech11042', 'likhita26', 'kpranav', 'ee19btech11006', 'ee19btech11030', 'srijithreddypakala001', 'chandramouli', 'jithin', 'sathvikaithagoni', 'sravanthi1', 'sakeths', 'alankritha', 'smaran43', 'ee19btech11022', 'oves', 'charitha2002', 'manjunath216', None, 'nishanth_kannan', 'ee19btech11033', 'mahima444', 'abhishekgautam011', 'sathvik', 'ee19btech11010']",43,"['irohith', 'bananavati', 'varshit', 'jihwanch1', 'ee19btech11042', 'aaddss3210', 'likhita26', 'eogksakdhkd', 'kpranav', 'ee19btech11006', 'srijithreddypakala001', 'ee19btech11030', 'kimsw9506', 'gunso', 'chandramouli', 'jithin', 'ansckdqja123', 'sathvikaithagoni', 'sravanthi1', 'sakeths', 'b515037', 'alankritha', 'smaran43', 'kdy3894', 'ee19btech11022', 'sohny94', 'oves', 'b615057', 'charitha2002', 'manjunath216', None, 'nishanth_kannan', 'ee19btech11033', 'tjwjdqja5', 'euem789', 'wndud5258', 'terry0511', 'mahima444', 'abhishekgautam011', 'sathvik', 'ksw950828', 'ee19btech11010', 'chaems322']"
71,20,18,25,3,"['terry0511', 'kimsw9506', 'aaddss3210']",14,"['gunso', 'tjwjdqja5', 'bananavati', 'kdy3894', 'euem789', 'jihwanch1', 'sohny94', 'wndud5258', 'ansckdqja123', 'b615057', 'eogksakdhkd', 'ksw950828', 'chaems322', 'b515037']",22,"['eomhyobin1227', 'my1hunter', 'kdm52', 'pshrap37', 'wodh97', 'juni8472', 'jgyyeong', 'dldmsrbx', 'poweroftrust', 'jpuko11', 'zldrktgusrbs3242', 'b619100', 'hanmir', 'jpuko00', 'hye8913', None, 'their123', 'comebacktome', 'tjwldbsdbs', 'youjiyeon', 'b919083', 'b715063minbyeongmoon']",39,"['eomhyobin1227', 'my1hunter', 'bananavati', 'kdm52', 'jihwanch1', 'pshrap37', 'aaddss3210', 'wodh97', 'eogksakdhkd', 'juni8472', 'kimsw9506', 'gunso', 'jgyyeong', 'ansckdqja123', 'dldmsrbx', 'poweroftrust', 'jpuko11', 'b619100', 'zldrktgusrbs3242', 'b515037', 'kdy3894', 'sohny94', 'b919083', 'b615057', 'hanmir', None, 'hye8913', 'jpuko00', 'their123', 'comebacktome', 'tjwjdqja5', 'tjwldbsdbs', 'euem789', 'wndud5258', 'terry0511', 'youjiyeon', 'ksw950828', 'chaems322', 'b715063minbyeongmoon']"
71,17,18,23,16,"['kimsw9506', 'gunso', 'tjwjdqja5', 'kdy3894', 'euem789', 'jihwanch1', 'sohny94', 'wndud5258', 'aaddss3210', 'terry0511', 'ansckdqja123', 'b615057', 'eogksakdhkd', 'ksw950828', 'chaems322', 'b515037']",1,['bananavati'],7,"['ehrnjs326', 'kdm52', 'rmaehdalf', 'hyuk8041', 'zhesun', '01024461660a', None]",24,"['bananavati', 'kdm52', 'jihwanch1', 'aaddss3210', 'eogksakdhkd', '01024461660a', 'rmaehdalf', 'kimsw9506', 'gunso', 'hyuk8041', 'ansckdqja123', 'b515037', 'kdy3894', 'sohny94', 'b615057', None, 'tjwjdqja5', 'ehrnjs326', 'euem789', 'wndud5258', 'terry0511', 'zhesun', 'ksw950828', 'chaems322']"
71,14,18,21,16,"['kimsw9506', 'gunso', 'tjwjdqja5', 'kdy3894', 'euem789', 'jihwanch1', 'sohny94', 'wndud5258', 'aaddss3210', 'terry0511', 'ansckdqja123', 'b615057', 'eogksakdhkd', 'ksw950828', 'chaems322', 'b515037']",1,['bananavati'],5,"['ehrnjs326', 'kdm52', 'hyuk8041', '01024461660a', None]",22,"['bananavati', 'kdm52', 'jihwanch1', 'aaddss3210', 'eogksakdhkd', '01024461660a', 'kimsw9506', 'gunso', 'hyuk8041', 'ansckdqja123', 'b515037', 'kdy3894', 'sohny94', 'b615057', None, 'tjwjdqja5', 'ehrnjs326', 'euem789', 'wndud5258', 'terry0511', 'ksw950828', 'chaems322']"
71,10,18,18,14,"['kimsw9506', 'gunso', 'tjwjdqja5', 'euem789', 'sohny94', 'wndud5258', 'aaddss3210', 'terry0511', 'ansckdqja123', 'b615057', 'eogksakdhkd', 'ksw950828', 'chaems322', 'b515037']",3,"['kdy3894', 'jihwanch1', 'bananavati']",4,"['poby', None, 'ehrnjs326', '01024461660a']",21,"['bananavati', 'kdy3894', 'jihwanch1', 'sohny94', 'aaddss3210', 'b615057', 'eogksakdhkd', '01024461660a', None, 'poby', 'kimsw9506', 'gunso', 'tjwjdqja5', 'ehrnjs326', 'euem789', 'wndud5258', 'terry0511', 'ansckdqja123', 'ksw950828', 'chaems322', 'b515037']"
71,341,18,7,5,"['jihwanch1', 'sohny94', 'b615057', 'ksw950828', 'b515037']",12,"['kimsw9506', 'gunso', 'tjwjdqja5', 'bananavati', 'kdy3894', 'euem789', 'wndud5258', 'aaddss3210', 'terry0511', 'ansckdqja123', 'eogksakdhkd', 'chaems322']",2,"[None, 'ehrnjs326']",19,"['bananavati', 'kdy3894', 'jihwanch1', 'sohny94', 'aaddss3210', 'b615057', 'eogksakdhkd', None, 'kimsw9506', 'gunso', 'tjwjdqja5', 'ehrnjs326', 'euem789', 'wndud5258', 'terry0511', 'ansckdqja123', 'ksw950828', 'chaems322', 'b515037']"
72,118,18,34,1,['rukhsara347'],16,"['g.sadeghian.ut', 'carotm2002', 'triumvrate85', 'karankmr832', 'aldmoreau', 'karlgdanielsen', 'anniz19', 'danrodmar10', 'lotussensor20', 'carlosc6', 'aly.mattar', 'kristelsolera', 'f.depiano6', 'figueroa.natalia64', 'rosefarahiyan', 'rehmaniffat61']",33,"['masroor4002808', 'salehabano.ned', 'unaisshazan', 'zahid4006555', 'nadeem4000465', 'ullah4005098', 'aamna123', 'syedamairazia', 'mahmood4030218', 'suhaib', 'mariaali8099', 'laibasaqib307', 'abdullah99', 'rayyaan99', 'rameesa', 'anwar4003031', 'finalartpythoncoder', 'asif4001007', 'anwer4001570', 'syedaurooj562', 'frmazharp', 'boysmart724', 'faiz4000626', 'areejasad16', 'masud4000020', None, 'sana.312', 'talib4005300', 'hashmi4001891', 'manaljamshed', 'sarfaraz4001312', 'faiza.iqbal680', 'innocent.fazeel66']",50,"['masroor4002808', 'carotm2002', 'salehabano.ned', 'unaisshazan', 'zahid4006555', 'nadeem4000465', 'ullah4005098', 'aamna123', 'figueroa.natalia64', 'syedamairazia', 'mahmood4030218', 'suhaib', 'rukhsara347', 'mariaali8099', 'laibasaqib307', 'triumvrate85', 'aldmoreau', 'abdullah99', 'g.sadeghian.ut', 'f.depiano6', 'rayyaan99', 'rameesa', 'finalartpythoncoder', 'anwar4003031', 'rehmaniffat61', 'anwer4001570', 'asif4001007', 'syedaurooj562', 'karankmr832', 'frmazharp', 'boysmart724', 'anniz19', 'danrodmar10', 'faiz4000626', 'areejasad16', 'rosefarahiyan', 'masud4000020', None, 'sana.312', 'talib4005300', 'karlgdanielsen', 'hashmi4001891', 'lotussensor20', 'carlosc6', 'manaljamshed', 'aly.mattar', 'kristelsolera', 'sarfaraz4001312', 'faiza.iqbal680', 'innocent.fazeel66']"
72,119,18,11,1,['danrodmar10'],16,"['rukhsara347', 'g.sadeghian.ut', 'carotm2002', 'triumvrate85', 'karankmr832', 'aldmoreau', 'karlgdanielsen', 'anniz19', 'lotussensor20', 'carlosc6', 'aly.mattar', 'kristelsolera', 'f.depiano6', 'figueroa.natalia64', 'rosefarahiyan', 'rehmaniffat61']",10,"['smadrigalb247', None, 'juanpabloramirezserrano2123', 'caro.vargasz97', 'dayana.acuna1996', 'mofdz', 'barbozaroger31', 'adrianacorderoretana', 'yes99iqi', 'carla.gomezquiros']",27,"['juanpabloramirezserrano2123', 'carotm2002', 'karankmr832', 'dayana.acuna1996', 'anniz19', 'danrodmar10', 'adrianacorderoretana', 'figueroa.natalia64', 'rosefarahiyan', 'yes99iqi', 'carla.gomezquiros', None, 'rukhsara347', 'g.sadeghian.ut', 'smadrigalb247', 'caro.vargasz97', 'triumvrate85', 'aldmoreau', 'karlgdanielsen', 'mofdz', 'lotussensor20', 'carlosc6', 'aly.mattar', 'kristelsolera', 'barbozaroger31', 'f.depiano6', 'rehmaniffat61']"
73,295,17,9,7,"['francisco.costa72', 'florival12', 'leondy', 'ruip1998', 'filipacmota', 'clarisseribeiro', 'rafaelvilarinho66']",9,"['pablo98martinluna', 'diogobaptista', 'hfaria', 'vivianasousa', 'arturandrishak735', 'zenrg', 'brunofernandesdrummer', 'vlodurou', 'joaoduarteazevedo']",2,"['jnieder', None]",18,"['francisco.costa72', 'pablo98martinluna', 'florival12', 'hfaria', 'jnieder', None, 'leondy', 'rafaelvilarinho66', 'diogobaptista', 'vivianasousa', 'arturandrishak735', 'zenrg', 'brunofernandesdrummer', 'vlodurou', 'ruip1998', 'filipacmota', 'clarisseribeiro', 'joaoduarteazevedo']"
73,296,17,9,7,"['francisco.costa72', 'diogobaptista', 'florival12', 'hfaria', 'zenrg', 'brunofernandesdrummer', 'vlodurou']",9,"['pablo98martinluna', 'vivianasousa', 'arturandrishak735', 'leondy', 'rafaelvilarinho66', 'ruip1998', 'filipacmota', 'clarisseribeiro', 'joaoduarteazevedo']",2,"['carlosgil1999', None]",18,"['francisco.costa72', 'pablo98martinluna', 'florival12', 'hfaria', None, 'leondy', 'rafaelvilarinho66', 'diogobaptista', 'vivianasousa', 'arturandrishak735', 'zenrg', 'brunofernandesdrummer', 'vlodurou', 'carlosgil1999', 'ruip1998', 'filipacmota', 'clarisseribeiro', 'joaoduarteazevedo']"
74,170,17,22,2,"['berkcmn', 'isiilhocek']",14,"['yadigarcorez', 'kaayaa40', 'aydin', 'atibolemi', 'elif.kocc33', 'mertkaggle', 'rishikasen666', 'fatmamatter111', 'dlwltjq321', 'sedagunees', 'sevas98', 'stsaw97', 'slamshottr', 'burakalperen87']",20,"['ozcanguclu', 'bertansafak', 'ozcankutlu15', 'esulekaplan', 'nsener45', 'aknramazan26', 'kizilinozlem', 'okanozkann95', 'muvafikmelikkaya', 'murat.ozeee', 'buseduygut', 'huseyinkaraaslan12', 'esracengiz', None, 'batu.oztrkk', 'selinyasaci98', 'liswfa123', 'tapur500', 'gnskdr52', 'serdememen']",36,"['isiilhocek', 'aydin', 'ozcanguclu', 'atibolemi', 'bertansafak', 'ozcankutlu15', 'sedagunees', 'esulekaplan', 'nsener45', 'kaayaa40', 'aknramazan26', 'kizilinozlem', 'mertkaggle', 'okanozkann95', 'rishikasen666', 'fatmamatter111', 'muvafikmelikkaya', 'murat.ozeee', 'buseduygut', 'huseyinkaraaslan12', 'esracengiz', 'elif.kocc33', 'stsaw97', 'berkcmn', None, 'yadigarcorez', 'batu.oztrkk', 'selinyasaci98', 'liswfa123', 'dlwltjq321', 'sevas98', 'gnskdr52', 'tapur500', 'slamshottr', 'burakalperen87', 'serdememen']"
74,171,17,13,6,"['kaayaa40', 'isiilhocek', 'aydin', 'atibolemi', 'stsaw97', 'slamshottr']",10,"['yadigarcorez', 'mertkaggle', 'elif.kocc33', 'rishikasen666', 'fatmamatter111', 'dlwltjq321', 'sedagunees', 'sevas98', 'berkcmn', 'burakalperen87']",7,"['ern2323', 'atakanerdogann1', 'orancagdas', 'mahmutcanki', 'simayozbay', None, 'arif.ozkan5806']",23,"['isiilhocek', 'aydin', 'elif.kocc33', 'atibolemi', 'mahmutcanki', 'sedagunees', 'stsaw97', 'berkcmn', 'simayozbay', None, 'arif.ozkan5806', 'ern2323', 'yadigarcorez', 'kaayaa40', 'atakanerdogann1', 'mertkaggle', 'orancagdas', 'rishikasen666', 'fatmamatter111', 'dlwltjq321', 'sevas98', 'slamshottr', 'burakalperen87']"
74,172,17,8,3,"['yadigarcorez', 'burakalperen87', 'elif.kocc33']",13,"['kaayaa40', 'isiilhocek', 'aydin', 'mertkaggle', 'atibolemi', 'rishikasen666', 'fatmamatter111', 'dlwltjq321', 'sedagunees', 'sevas98', 'stsaw97', 'berkcmn', 'slamshottr']",5,"['eliffsu.koc', 'emregonen', 'mehmettasdelen26', 'fdirisaglik', None]",21,"['isiilhocek', 'aydin', 'elif.kocc33', 'atibolemi', 'mehmettasdelen26', 'sedagunees', 'fdirisaglik', 'stsaw97', 'berkcmn', None, 'yadigarcorez', 'eliffsu.koc', 'kaayaa40', 'mertkaggle', 'emregonen', 'rishikasen666', 'fatmamatter111', 'dlwltjq321', 'sevas98', 'slamshottr', 'burakalperen87']"
75,280,17,24,3,"['ece230sucks', 'papagameplayer', 'stdy3c8']",13,"['alpanakamal.555', 'jgk23', 'hilda.molin', 'carlvt', 'jinicutie1', 'haominl1997', 'alexmet', 'henglund', 'willinf', 'alexjimenez9910', 'chloew0808', 'mrunal1511', 'ottoridemar']",21,"['nwilli43', 'madelyncecchini', 'mrosetai', 'rdemma.andy', 'liavcueto', 'alex.oesterling', 'diegochll', 'gavro', 'lu.fogolin', 'pballentine', 'cayschuval', 'nonstopeve', 'tikagergaia', 'jacknastas', 'isabellak', 'jonsandoval229', None, 'tendralsonofvend', 'ameer50', 'mdensel2', 'shufanwen0516']",37,"['alpanakamal.555', 'nwilli43', 'papagameplayer', 'madelyncecchini', 'mrosetai', 'alexmet', 'jgk23', 'hilda.molin', 'stdy3c8', 'rdemma.andy', 'liavcueto', 'willinf', 'alex.oesterling', 'diegochll', 'chloew0808', 'gavro', 'lu.fogolin', 'pballentine', 'cayschuval', 'carlvt', 'nonstopeve', 'tikagergaia', 'jinicutie1', 'jacknastas', 'isabellak', 'henglund', 'jonsandoval229', 'haominl1997', None, 'shufanwen0516', 'ece230sucks', 'tendralsonofvend', 'ameer50', 'mdensel2', 'alexjimenez9910', 'mrunal1511', 'ottoridemar']"
75,238,17,23,2,"['ece230sucks', 'stdy3c8']",14,"['alpanakamal.555', 'jgk23', 'hilda.molin', 'papagameplayer', 'carlvt', 'jinicutie1', 'haominl1997', 'alexmet', 'henglund', 'willinf', 'alexjimenez9910', 'chloew0808', 'mrunal1511', 'ottoridemar']",21,"['mrosetai', 'akhufstetler', 'rdemma.andy', 'liavcueto', 'alex.oesterling', 'diegochll', 'gavro', 'lu.fogolin', 'pballentine', 'cayschuval', 'nonstopeve', 'jacknastas', 'tikagergaia', 'isabellak', 'cdcalahn', 'jonsandoval229', None, 'tendralsonofvend', 'mdensel2', '1jordanschwartz', 'shufanwen0516']",37,"['alpanakamal.555', 'papagameplayer', 'mrosetai', 'alexmet', 'akhufstetler', 'jgk23', 'hilda.molin', 'stdy3c8', 'rdemma.andy', 'liavcueto', 'willinf', 'alex.oesterling', 'diegochll', 'chloew0808', 'gavro', 'lu.fogolin', 'pballentine', '1jordanschwartz', 'cayschuval', 'carlvt', 'nonstopeve', 'jacknastas', 'jinicutie1', 'tikagergaia', 'isabellak', 'henglund', 'cdcalahn', 'jonsandoval229', 'haominl1997', None, 'shufanwen0516', 'ece230sucks', 'tendralsonofvend', 'mdensel2', 'alexjimenez9910', 'mrunal1511', 'ottoridemar']"
75,240,17,23,1,['stdy3c8'],15,"['alpanakamal.555', 'ece230sucks', 'jgk23', 'hilda.molin', 'papagameplayer', 'carlvt', 'jinicutie1', 'haominl1997', 'alexmet', 'henglund', 'willinf', 'alexjimenez9910', 'chloew0808', 'mrunal1511', 'ottoridemar']",22,"['mrosetai', 'akhufstetler', 'rdemma.andy', 'liavcueto', 'alex.oesterling', 'diegochll', 'xinyumzhang', 'gavro', 'lu.fogolin', 'pballentine', 'cayschuval', 'nonstopeve', 'jacknastas', 'tikagergaia', 'isabellak', 'cdcalahn', 'jonsandoval229', None, 'tendralsonofvend', 'mdensel2', '1jordanschwartz', 'shufanwen0516']",38,"['alpanakamal.555', 'papagameplayer', 'mrosetai', 'alexmet', 'akhufstetler', 'jgk23', 'hilda.molin', 'stdy3c8', 'rdemma.andy', 'liavcueto', 'willinf', 'alex.oesterling', 'diegochll', 'chloew0808', 'xinyumzhang', 'gavro', 'lu.fogolin', 'pballentine', '1jordanschwartz', 'cayschuval', 'carlvt', 'nonstopeve', 'jacknastas', 'jinicutie1', 'tikagergaia', 'isabellak', 'henglund', 'cdcalahn', 'jonsandoval229', 'haominl1997', None, 'shufanwen0516', 'ece230sucks', 'tendralsonofvend', 'mdensel2', 'alexjimenez9910', 'mrunal1511', 'ottoridemar']"
75,281,17,16,8,"['hilda.molin', 'carlvt', 'mrunal1511', 'alexmet', 'henglund', 'willinf', 'haominl1997', 'ottoridemar']",8,"['alpanakamal.555', 'ece230sucks', 'jgk23', 'papagameplayer', 'stdy3c8', 'jinicutie1', 'alexjimenez9910', 'chloew0808']",8,"['gunta72', 'shikhararvind', 'sotmas', 'thackettt', 'chenxiwang', 'krk40', 'xxxxiaofan', None]",24,"['gunta72', 'alpanakamal.555', 'papagameplayer', 'carlvt', 'jinicutie1', 'henglund', 'chenxiwang', 'xxxxiaofan', 'alexmet', 'haominl1997', None, 'shikhararvind', 'sotmas', 'ece230sucks', 'jgk23', 'hilda.molin', 'stdy3c8', 'thackettt', 'willinf', 'alexjimenez9910', 'krk40', 'chloew0808', 'mrunal1511', 'ottoridemar']"
75,317,17,13,6,"['hilda.molin', 'haominl1997', 'mrunal1511', 'henglund', 'willinf', 'alexmet']",10,"['alpanakamal.555', 'ece230sucks', 'jgk23', 'papagameplayer', 'stdy3c8', 'carlvt', 'jinicutie1', 'alexjimenez9910', 'chloew0808', 'ottoridemar']",7,"['shikhararvind', 'sotmas', 'gunta72', 'chenxiwang', 'krk40', 'xxxxiaofan', None]",23,"['gunta72', 'alpanakamal.555', 'papagameplayer', 'carlvt', 'jinicutie1', 'henglund', 'chenxiwang', 'xxxxiaofan', 'alexmet', 'haominl1997', None, 'shikhararvind', 'sotmas', 'ece230sucks', 'jgk23', 'hilda.molin', 'stdy3c8', 'willinf', 'alexjimenez9910', 'krk40', 'chloew0808', 'mrunal1511', 'ottoridemar']"
76,397,16,72,13,"['martak846', 'sebabalt', 'kpolcyn', 'krystiankoszucki', 'pirokiki', 'kuba321', 'zajaclukasz140', 'misterszycha', 'stefaelfi', 'woj_25', 'bryckadominika', 'olchor', 'rafal123']",2,"['carrie2151', 'szymonkrolak']",59,"['salem2', 'medoshaban816', 'cmc2374', 'edwardmirkin', 'heshamelsedfy111', 'amr.m.araby', 'btngana1', 'andrea_russo90', 'martyna.bladosz97', 'zazotop31', 'mohamed_2116', 'michaelhelal99', 'marvel', 'transalper', 'fied0029', 'kumarraina619', 'ahmedramadan', 'kareemk08', 'pzanasi', 'jendryka.j', 'harvovich', 'm.zhu', 's154641', 'jatin97', 'e.steinebronn', 's159813', 'jhh2197', 'deepika07', 'romanynashaatmakeen', 'josephwilliams11', 'manny', 'lampy84', 'sebastian.wachowski', 'mohameda.younis80', 'ahmedsaeed', 'sprawozdaniezlabow', 'lockbox30', 'cristianololipops56', 'haripriya', 'jts2176', 'johnlanghout', 'thebigchester', 'kaka1341', 'amilkovicz', 'saca', 'mernaeshakfaheem', 'mohamedsalah2', 'myousef42', 'tezaagnieszka', 'ahmedokasha1999', 'abdooo', 'gharrison78', 'rektxz', None, 'indyfisico', 'merhuem', 'anna2222', 'narndt', 'ch3401']",74,"['salem2', 'medoshaban816', 'cmc2374', 'edwardmirkin', 'heshamelsedfy111', 'amr.m.araby', 'btngana1', 'andrea_russo90', 'martyna.bladosz97', 'zazotop31', 'mohamed_2116', 'michaelhelal99', 'marvel', 'carrie2151', 'transalper', 'rafal123', 'fied0029', 'kumarraina619', 'ahmedramadan', 'kareemk08', 'pzanasi', 'jendryka.j', 'harvovich', 'm.zhu', 's154641', 'bryckadominika', 'jatin97', 'e.steinebronn', 's159813', 'jhh2197', 'deepika07', 'romanynashaatmakeen', 'pirokiki', 'josephwilliams11', 'manny', 'lampy84', 'misterszycha', 'szymonkrolak', 'sebastian.wachowski', 'mohameda.younis80', 'ahmedsaeed', 'sprawozdaniezlabow', 'sebabalt', 'lockbox30', 'krystiankoszucki', 'cristianololipops56', 'haripriya', 'jts2176', 'woj_25', 'johnlanghout', 'thebigchester', 'kaka1341', 'zajaclukasz140', 'amilkovicz', 'saca', 'stefaelfi', 'mernaeshakfaheem', 'olchor', 'mohamedsalah2', 'myousef42', 'tezaagnieszka', 'ahmedokasha1999', 'abdooo', 'kuba321', 'gharrison78', 'rektxz', None, 'indyfisico', 'merhuem', 'martak846', 'kpolcyn', 'anna2222', 'narndt', 'ch3401']"
76,493,16,19,6,"['martak846', 'kpolcyn', 'kuba321', 'zajaclukasz140', 'misterszycha', 'olchor']",9,"['sebabalt', 'krystiankoszucki', 'pirokiki', 'woj_25', 'stefaelfi', 'szymonkrolak', 'bryckadominika', 'carrie2151', 'rafal123']",13,"['julka97', 'piter15710', None, 's166102', 'paulina.rudzinska.99', 'ducka.agata', 'pospiechjoanna', 'dagmarakaliska', 'oliwia.b97', 'asianano', 'thebigchester', 'jasmina.rozek', 'krzysztof.golyga']",28,"['sebabalt', 'krystiankoszucki', 'dagmarakaliska', 'oliwia.b97', 'woj_25', 'julka97', 'asianano', 'thebigchester', 'zajaclukasz140', 'stefaelfi', 'olchor', 'carrie2151', 'rafal123', 'krzysztof.golyga', 'piter15710', 'kuba321', 'bryckadominika', 'jasmina.rozek', None, 's166102', 'paulina.rudzinska.99', 'ducka.agata', 'martak846', 'kpolcyn', 'pirokiki', 'misterszycha', 'szymonkrolak', 'pospiechjoanna']"
76,290,16,12,8,"['martak846', 'sebabalt', 'krystiankoszucki', 'pirokiki', 'stefaelfi', 'szymonkrolak', 'bryckadominika', 'carrie2151']",7,"['kpolcyn', 'kuba321', 'zajaclukasz140', 'misterszycha', 'woj_25', 'olchor', 'rafal123']",4,"['agares', 'zuzia12095', None, 'jjdominika99']",19,"['sebabalt', 'krystiankoszucki', 'agares', 'carrie2151', 'kuba321', 'woj_25', 'bryckadominika', None, 'martak846', 'kpolcyn', 'pirokiki', 'zajaclukasz140', 'misterszycha', 'stefaelfi', 'szymonkrolak', 'zuzia12095', 'olchor', 'jjdominika99', 'rafal123']"
76,292,16,12,5,"['kpolcyn', 'kuba321', 'zajaclukasz140', 'misterszycha', 'rafal123']",10,"['martak846', 'sebabalt', 'krystiankoszucki', 'pirokiki', 'carrie2151', 'woj_25', 'stefaelfi', 'szymonkrolak', 'bryckadominika', 'olchor']",7,"['studentmaria2020', 'bednarski.michal.12', 'asianano', 'thebigchester', 's160102', None, 'gennolaskolnyk']",22,"['studentmaria2020', 'sebabalt', 'krystiankoszucki', 'bednarski.michal.12', 's160102', 'carrie2151', 'kuba321', 'woj_25', 'bryckadominika', None, 'gennolaskolnyk', 'martak846', 'kpolcyn', 'pirokiki', 'asianano', 'thebigchester', 'zajaclukasz140', 'misterszycha', 'stefaelfi', 'szymonkrolak', 'olchor', 'rafal123']"
76,357,16,12,6,"['sebabalt', 'kpolcyn', 'kuba321', 'zajaclukasz140', 'misterszycha', 'olchor']",9,"['martak846', 'krystiankoszucki', 'pirokiki', 'woj_25', 'stefaelfi', 'szymonkrolak', 'bryckadominika', 'carrie2151', 'rafal123']",6,"['julka97', 'sprawozdaniezlabow', 'asianano', 'kaka1341', None, 's166102']",21,"['sprawozdaniezlabow', 'sebabalt', 'krystiankoszucki', 'carrie2151', 'kuba321', 'woj_25', 'bryckadominika', None, 's166102', 'julka97', 'martak846', 'kpolcyn', 'pirokiki', 'asianano', 'kaka1341', 'zajaclukasz140', 'misterszycha', 'stefaelfi', 'szymonkrolak', 'olchor', 'rafal123']"
76,354,16,11,8,"['martak846', 'sebabalt', 'krystiankoszucki', 'pirokiki', 'stefaelfi', 'szymonkrolak', 'bryckadominika', 'carrie2151']",7,"['kpolcyn', 'kuba321', 'zajaclukasz140', 'misterszycha', 'woj_25', 'olchor', 'rafal123']",3,"[None, 'bpaulinaanna', 'sebastian.wachowski']",18,"['sebabalt', 'bpaulinaanna', 'krystiankoszucki', 'carrie2151', 'kuba321', 'woj_25', 'bryckadominika', None, 'martak846', 'kpolcyn', 'pirokiki', 'zajaclukasz140', 'misterszycha', 'stefaelfi', 'szymonkrolak', 'olchor', 'rafal123', 'sebastian.wachowski']"
76,495,16,11,6,"['sebabalt', 'krystiankoszucki', 'pirokiki', 'stefaelfi', 'szymonkrolak', 'bryckadominika']",9,"['martak846', 'kpolcyn', 'carrie2151', 'kuba321', 'zajaclukasz140', 'misterszycha', 'woj_25', 'olchor', 'rafal123']",5,"['pospiechjoanna', 'czes', 'baczas996', 'sebastian.wachowski', None]",20,"['sebabalt', 'krystiankoszucki', 'carrie2151', 'kuba321', 'woj_25', 'bryckadominika', None, 'martak846', 'kpolcyn', 'pospiechjoanna', 'pirokiki', 'czes', 'zajaclukasz140', 'misterszycha', 'stefaelfi', 'szymonkrolak', 'baczas996', 'olchor', 'rafal123', 'sebastian.wachowski']"
76,355,16,8,4,"['misterszycha', 'olchor', 'sebabalt', 'kpolcyn']",11,"['martak846', 'krystiankoszucki', 'pirokiki', 'woj_25', 'kuba321', 'zajaclukasz140', 'stefaelfi', 'szymonkrolak', 'bryckadominika', 'carrie2151', 'rafal123']",4,"['thebigchester', 'julka97', None, 'asianano']",19,"['sebabalt', 'krystiankoszucki', 'carrie2151', 'kuba321', 'woj_25', 'bryckadominika', None, 'julka97', 'martak846', 'kpolcyn', 'pirokiki', 'asianano', 'thebigchester', 'zajaclukasz140', 'misterszycha', 'stefaelfi', 'szymonkrolak', 'olchor', 'rafal123']"
76,358,16,8,4,"['kuba321', 'zajaclukasz140', 'sebabalt', 'misterszycha']",11,"['martak846', 'kpolcyn', 'krystiankoszucki', 'pirokiki', 'carrie2151', 'woj_25', 'stefaelfi', 'szymonkrolak', 'bryckadominika', 'olchor', 'rafal123']",4,"['kaka1341', None, 'sprawozdaniezlabow', 's166102']",19,"['sprawozdaniezlabow', 'sebabalt', 'krystiankoszucki', 'carrie2151', 'kuba321', 'woj_25', 'bryckadominika', None, 's166102', 'martak846', 'kpolcyn', 'pirokiki', 'kaka1341', 'zajaclukasz140', 'misterszycha', 'stefaelfi', 'szymonkrolak', 'olchor', 'rafal123']"
76,291,16,6,2,"['carrie2151', 'rafal123']",13,"['martak846', 'sebabalt', 'kpolcyn', 'krystiankoszucki', 'pirokiki', 'woj_25', 'kuba321', 'zajaclukasz140', 'misterszycha', 'stefaelfi', 'szymonkrolak', 'bryckadominika', 'olchor']",4,"['thebigchester', 'gennolaskolnyk', None, 's160115']",19,"['sebabalt', 'krystiankoszucki', 'carrie2151', 'kuba321', 's160115', 'woj_25', 'bryckadominika', None, 'gennolaskolnyk', 'martak846', 'kpolcyn', 'pirokiki', 'thebigchester', 'zajaclukasz140', 'misterszycha', 'stefaelfi', 'szymonkrolak', 'olchor', 'rafal123']"
76,494,16,6,4,"['szymonkrolak', 'sebabalt', 'stefaelfi', 'krystiankoszucki']",11,"['martak846', 'kpolcyn', 'pirokiki', 'carrie2151', 'kuba321', 'zajaclukasz140', 'misterszycha', 'woj_25', 'bryckadominika', 'olchor', 'rafal123']",2,"[None, 'yellowturtle']",17,"['sebabalt', 'krystiankoszucki', 'carrie2151', 'yellowturtle', 'kuba321', 'woj_25', 'bryckadominika', None, 'martak846', 'kpolcyn', 'pirokiki', 'zajaclukasz140', 'misterszycha', 'stefaelfi', 'szymonkrolak', 'olchor', 'rafal123']"
77,459,16,14,12,"['maxwell.wigdahl', 'andrew.bauer', 'matteo.matalon', 'joseph.pizzimenti', 'jacob.smith', 'john.lake', 'jack.rodgers', 'connor.tierney', 'christopher.fletcher', 'cullen.devries', 'nina.mohs', 'robert.cappy']",3,"['ahmetslurm', 'edalpha1', 'kalen.mcnamara']",2,"['marielkolker', None]",17,"['maxwell.wigdahl', 'matteo.matalon', 'ahmetslurm', 'edalpha1', 'cullen.devries', None, 'andrew.bauer', 'jacob.smith', 'john.lake', 'joseph.pizzimenti', 'kalen.mcnamara', 'jack.rodgers', 'connor.tierney', 'marielkolker', 'christopher.fletcher', 'nina.mohs', 'robert.cappy']"
78,225,16,7,6,"['gktcmorse', 'emmanuelgeorgoudis', 'princeofthenutella', 'doolittlea', 'abhiks', 'bmiller1900']",9,"['edharchenko97', 'johnsnowhasswag', 'mackenzieb1', 'huston209', 'stearnsp', 'weaverj1', 'nreny77', 'troydeluca', 'winchb']",1,[None],16,"['edharchenko97', 'johnsnowhasswag', 'stearnsp', 'emmanuelgeorgoudis', 'princeofthenutella', 'winchb', 'abhiks', None, 'mackenzieb1', 'huston209', 'weaverj1', 'doolittlea', 'gktcmorse', 'nreny77', 'troydeluca', 'bmiller1900']"
78,226,16,7,1,['princeofthenutella'],14,"['edharchenko97', 'johnsnowhasswag', 'mackenzieb1', 'huston209', 'stearnsp', 'weaverj1', 'doolittlea', 'gktcmorse', 'emmanuelgeorgoudis', 'nreny77', 'troydeluca', 'winchb', 'abhiks', 'bmiller1900']",6,"['walshs4', 'matins', 'rooneyw17', 'mattorsie92', None, 'octoberb']",21,"['edharchenko97', 'johnsnowhasswag', 'matins', 'stearnsp', 'emmanuelgeorgoudis', 'princeofthenutella', 'rooneyw17', 'winchb', 'abhiks', None, 'octoberb', 'mackenzieb1', 'walshs4', 'huston209', 'weaverj1', 'doolittlea', 'gktcmorse', 'nreny77', 'troydeluca', 'mattorsie92', 'bmiller1900']"
79,397,16,72,13,"['merhuem', 'deepika07', 'kareemk08', 'pzanasi', 'martyna.bladosz97', 'abdooo', 'manny', 'kaka1341', 'edwardmirkin', 's154641', 'amilkovicz', 'marvel', 'transalper']",2,"['m.imran.mustafa', 'ahhamed93']",59,"['salem2', 'medoshaban816', 'cmc2374', 'heshamelsedfy111', 'amr.m.araby', 'btngana1', 'andrea_russo90', 'zazotop31', 'mohamed_2116', 'michaelhelal99', 'fied0029', 'rafal123', 'kumarraina619', 'ahmedramadan', 'jendryka.j', 'harvovich', 'm.zhu', 'bryckadominika', 'jatin97', 'e.steinebronn', 's159813', 'jhh2197', 'romanynashaatmakeen', 'pirokiki', 'josephwilliams11', 'lampy84', 'misterszycha', 'sebastian.wachowski', 'mohameda.younis80', 'ahmedsaeed', 'sprawozdaniezlabow', 'lockbox30', 'cristianololipops56', 'krystiankoszucki', 'sebabalt', 'haripriya', 'jts2176', 'woj_25', 'johnlanghout', 'thebigchester', 'zajaclukasz140', 'saca', 'stefaelfi', 'mernaeshakfaheem', 'olchor', 'mohamedsalah2', 'myousef42', 'tezaagnieszka', 'ahmedokasha1999', 'kuba321', 'gharrison78', 'rektxz', None, 'indyfisico', 'martak846', 'kpolcyn', 'anna2222', 'narndt', 'ch3401']",74,"['salem2', 'medoshaban816', 'cmc2374', 'edwardmirkin', 'heshamelsedfy111', 'amr.m.araby', 'btngana1', 'ahhamed93', 'andrea_russo90', 'martyna.bladosz97', 'zazotop31', 'mohamed_2116', 'michaelhelal99', 'marvel', 'transalper', 'fied0029', 'rafal123', 'kumarraina619', 'ahmedramadan', 'kareemk08', 'pzanasi', 'jendryka.j', 's154641', 'harvovich', 'm.zhu', 'bryckadominika', 'jatin97', 'e.steinebronn', 's159813', 'jhh2197', 'deepika07', 'romanynashaatmakeen', 'pirokiki', 'josephwilliams11', 'manny', 'lampy84', 'misterszycha', 'sebastian.wachowski', 'mohameda.younis80', 'ahmedsaeed', 'sprawozdaniezlabow', 'lockbox30', 'cristianololipops56', 'krystiankoszucki', 'sebabalt', 'haripriya', 'jts2176', 'woj_25', 'johnlanghout', 'thebigchester', 'kaka1341', 'm.imran.mustafa', 'zajaclukasz140', 'amilkovicz', 'saca', 'stefaelfi', 'mernaeshakfaheem', 'olchor', 'mohamedsalah2', 'myousef42', 'tezaagnieszka', 'ahmedokasha1999', 'abdooo', 'kuba321', 'gharrison78', 'rektxz', None, 'merhuem', 'indyfisico', 'martak846', 'kpolcyn', 'anna2222', 'narndt', 'ch3401']"
79,356,16,59,3,"['abdooo', 'ahhamed93', 'kareemk08']",12,"['merhuem', 'deepika07', 'pzanasi', 'martyna.bladosz97', 'manny', 'kaka1341', 'm.imran.mustafa', 'edwardmirkin', 's154641', 'amilkovicz', 'marvel', 'transalper']",56,"['ahmedsaeed', 'farid1010', 'medoshaban816', 'nohaabdelazeem11', 'ahmed_mohsen', 'kerolosmfawzy', 'shadymagdy99', 'heshamelsedfy111', 'amr.m.araby', 'ahmed_omar', 'mai99mahdy', 'seifelawadi26', 'abdoulkh', 'btngana1', 'ramymohsen', 'reemayman101', 'ahmedmostafa5499', 'zazotop31', 'ahmedkamal', 'marwanahmad988', 'amrksh3198', 'saca', 'michaelhelal99', 'kareemmohamed68990', 'mernaeshakfaheem', 'yusufcheetos99', 'moataz12mokhtar', 'aminsalah287', 'ziad.amr201666', 'omar_anwer', 'joker.man2000000', 'amy', 'mohamedsalah2', 'yaseensalah83', 'sadboijalal', 'ahmedokasha1999', 'abdoelanwar99', 'tomymoty1', 'mohamed.eid1014', 'harvovich', 'rektxz', 'markashaf232', None, 'mohamed248688', 'maged.magdy666', 'nourmahmoud', 'romanynashaatmakeen', 'abdallahhashim', 'm.trika1999', 'ahmedyosre007', 'nourhanne.bahaa', 'a.ayman74', 'maged19991926', 'cyrillemagdi', 'mohameda.younis80', 'bassant.ahmed20118']",71,"['farid1010', 'nohaabdelazeem11', 'medoshaban816', 'ahmed_mohsen', 'shadymagdy99', 'edwardmirkin', 'heshamelsedfy111', 'amr.m.araby', 'mai99mahdy', 'abdoulkh', 'seifelawadi26', 'ramymohsen', 'ahhamed93', 'btngana1', 'martyna.bladosz97', 'zazotop31', 'marwanahmad988', 'marvel', 'michaelhelal99', 'transalper', 'yusufcheetos99', 'aminsalah287', 'ziad.amr201666', 'omar_anwer', 'joker.man2000000', 'kareemk08', 'pzanasi', 'amy', 'sadboijalal', 'mohamed.eid1014', 's154641', 'harvovich', 'mohamed248688', 'deepika07', 'romanynashaatmakeen', 'abdallahhashim', 'm.trika1999', 'ahmedyosre007', 'manny', 'maged19991926', 'mohameda.younis80', 'ahmedsaeed', 'kerolosmfawzy', 'ahmed_omar', 'reemayman101', 'ahmedmostafa5499', 'ahmedkamal', 'kaka1341', 'm.imran.mustafa', 'amilkovicz', 'amrksh3198', 'saca', 'kareemmohamed68990', 'mernaeshakfaheem', 'moataz12mokhtar', 'yaseensalah83', 'mohamedsalah2', 'ahmedokasha1999', 'abdoelanwar99', 'abdooo', 'tomymoty1', 'rektxz', 'markashaf232', None, 'merhuem', 'maged.magdy666', 'nourmahmoud', 'nourhanne.bahaa', 'a.ayman74', 'cyrillemagdi', 'bassant.ahmed20118']"
79,398,16,43,3,"['abdooo', 'ahhamed93', 'kareemk08']",12,"['merhuem', 'deepika07', 'pzanasi', 'martyna.bladosz97', 'manny', 'kaka1341', 'm.imran.mustafa', 'edwardmirkin', 's154641', 'amilkovicz', 'marvel', 'transalper']",40,"['ranaashraf129', 'mohamedsamir2591998', 'medoshaban816', 'nohaabdelazeem11', 'ahmedsamy888844', 'heshamelsedfy111', 'seifahmedamer', 'ahmedhamdyhalawa', 'mai99mahdy', 'ramymohsen', 'midoayman248', 'yumna.ghoneim', 'reemayman101', 'ronaldo2391999', 'mennamohamedhanafy392', 'ahmedmamin', 'moataz12mokhtar', 'karimtarek', 'youlianafouad17', 'sondossalah66', 'mostafa.maher591999', 'mohamedsalah2', 'ahmedokasha1999', 'mostafasaleh054', 'mohmedshimaa25', 'rektxz', 'youssefelrouby4', None, 'mohamed248688', 'ashraf_mohamed', 'ahmed.khaled.201420', 'seif8128', 'ahmadatef580', 'm.trika1999', 'a.ayman74', 'maged19991926', 'mohamedhamdy1120000', 'mahmoud.maree2010', 'mohamed_hesham', 'muhmedsalahm']",55,"['ranaashraf129', 'mohamedsamir2591998', 'nohaabdelazeem11', 'medoshaban816', 'ahmedsamy888844', 'edwardmirkin', 'heshamelsedfy111', 'seifahmedamer', 'mai99mahdy', 'ahmedhamdyhalawa', 'ramymohsen', 'ahhamed93', 'midoayman248', 'yumna.ghoneim', 'reemayman101', 'martyna.bladosz97', 'ronaldo2391999', 'kaka1341', 'm.imran.mustafa', 'amilkovicz', 'marvel', 'ahmedmamin', 'transalper', 'mennamohamedhanafy392', 'moataz12mokhtar', 'karimtarek', 'youlianafouad17', 'sondossalah66', 'kareemk08', 'pzanasi', 'mohamedsalah2', 'mostafa.maher591999', 'ahmedokasha1999', 'abdooo', 'mostafasaleh054', 'mohmedshimaa25', 's154641', 'rektxz', 'youssefelrouby4', None, 'mohamed248688', 'ashraf_mohamed', 'merhuem', 'deepika07', 'ahmed.khaled.201420', 'seif8128', 'ahmadatef580', 'm.trika1999', 'manny', 'a.ayman74', 'maged19991926', 'mohamedhamdy1120000', 'mahmoud.maree2010', 'mohamed_hesham', 'muhmedsalahm']"
79,357,16,12,1,['kaka1341'],14,"['merhuem', 'deepika07', 'kareemk08', 'pzanasi', 'martyna.bladosz97', 'abdooo', 'manny', 'm.imran.mustafa', 'edwardmirkin', 's154641', 'amilkovicz', 'marvel', 'transalper', 'ahhamed93']",11,"['julka97', None, 'sprawozdaniezlabow', 'sebabalt', 'kpolcyn', 'asianano', 'kuba321', 'zajaclukasz140', 'misterszycha', 'olchor', 's166102']",26,"['sprawozdaniezlabow', 'sebabalt', 'kareemk08', 'pzanasi', 'abdooo', 'kuba321', 'edwardmirkin', 's154641', None, 'ahhamed93', 's166102', 'merhuem', 'julka97', 'deepika07', 'kpolcyn', 'martyna.bladosz97', 'asianano', 'manny', 'kaka1341', 'm.imran.mustafa', 'zajaclukasz140', 'amilkovicz', 'marvel', 'misterszycha', 'olchor', 'transalper']"
79,359,16,9,3,"['martyna.bladosz97', 'amilkovicz', 's154641']",12,"['merhuem', 'deepika07', 'kareemk08', 'pzanasi', 'abdooo', 'manny', 'kaka1341', 'm.imran.mustafa', 'edwardmirkin', 'marvel', 'transalper', 'ahhamed93']",6,"['maateusz.jankowski', 's159813', 'sprawozdaniezlabow', 'anna2222', 'asianano', None]",21,"['sprawozdaniezlabow', 'kareemk08', 'pzanasi', 'abdooo', 'edwardmirkin', 's154641', None, 'ahhamed93', 'merhuem', 'maateusz.jankowski', 's159813', 'deepika07', 'martyna.bladosz97', 'anna2222', 'asianano', 'manny', 'kaka1341', 'm.imran.mustafa', 'amilkovicz', 'marvel', 'transalper']"
79,358,16,8,1,['kaka1341'],14,"['merhuem', 'deepika07', 'kareemk08', 'pzanasi', 'martyna.bladosz97', 'abdooo', 'manny', 'm.imran.mustafa', 'edwardmirkin', 's154641', 'amilkovicz', 'marvel', 'transalper', 'ahhamed93']",7,"['sprawozdaniezlabow', 'sebabalt', 'kuba321', 'zajaclukasz140', 'misterszycha', None, 's166102']",22,"['sprawozdaniezlabow', 'sebabalt', 'kareemk08', 'pzanasi', 'abdooo', 'kuba321', 'edwardmirkin', 's154641', None, 'ahhamed93', 's166102', 'merhuem', 'deepika07', 'martyna.bladosz97', 'manny', 'kaka1341', 'm.imran.mustafa', 'zajaclukasz140', 'amilkovicz', 'marvel', 'misterszycha', 'transalper']"
79,400,16,8,1,['s154641'],14,"['merhuem', 'deepika07', 'kareemk08', 'pzanasi', 'martyna.bladosz97', 'abdooo', 'manny', 'kaka1341', 'm.imran.mustafa', 'edwardmirkin', 'amilkovicz', 'marvel', 'transalper', 'ahhamed93']",7,"['s162368', 'maateusz.jankowski', 'studentmaria2020', 's159813', 'anna2222', 'asianano', None]",22,"['studentmaria2020', 'kareemk08', 'pzanasi', 'abdooo', 'edwardmirkin', 's154641', None, 'ahhamed93', 'merhuem', 's162368', 'maateusz.jankowski', 'deepika07', 's159813', 'martyna.bladosz97', 'anna2222', 'asianano', 'manny', 'kaka1341', 'm.imran.mustafa', 'amilkovicz', 'marvel', 'transalper']"
80,177,15,17,14,"['sgci14', 'sgci02', 'sgci10', 'sgci08', 'sgci07', 'sgci03', 'sgci11', 'sgci13', 'sgci05', 'sgci12', 'sgci04', 'sgci06', 'sgci01', 'sgci09']",0,[],3,"['ford.l.piano.guitar', None, 'jeffkayser']",17,"['sgci14', 'sgci02', 'sgci10', 'ford.l.piano.guitar', 'sgci03', 'sgci11', 'sgci05', 'sgci12', 'jeffkayser', None, 'sgci13', 'sgci08', 'sgci07', 'sgci04', 'sgci06', 'sgci01', 'sgci09']"
80,89,15,16,14,"['sgci14', 'sgci02', 'sgci10', 'sgci08', 'sgci07', 'sgci03', 'sgci11', 'sgci13', 'sgci05', 'sgci12', 'sgci04', 'sgci06', 'sgci01', 'sgci09']",0,[],2,"[None, 'jeffkayser']",16,"['sgci14', 'sgci02', 'sgci10', 'sgci03', 'sgci11', 'sgci05', 'sgci12', 'jeffkayser', None, 'sgci13', 'sgci08', 'sgci07', 'sgci04', 'sgci06', 'sgci01', 'sgci09']"
80,230,15,16,14,"['sgci14', 'sgci02', 'sgci10', 'sgci08', 'sgci07', 'sgci03', 'sgci11', 'sgci13', 'sgci05', 'sgci12', 'sgci04', 'sgci06', 'sgci01', 'sgci09']",0,[],2,"[None, 'jeffkayser']",16,"['sgci14', 'sgci02', 'sgci10', 'sgci03', 'sgci11', 'sgci05', 'sgci12', 'jeffkayser', None, 'sgci13', 'sgci08', 'sgci07', 'sgci04', 'sgci06', 'sgci01', 'sgci09']"
80,337,15,16,14,"['sgci14', 'sgci02', 'sgci10', 'sgci08', 'sgci07', 'sgci03', 'sgci11', 'sgci13', 'sgci05', 'sgci12', 'sgci04', 'sgci06', 'sgci01', 'sgci09']",0,[],2,"[None, 'jeffkayser']",16,"['sgci14', 'sgci02', 'sgci10', 'sgci03', 'sgci11', 'sgci05', 'sgci12', 'jeffkayser', None, 'sgci13', 'sgci08', 'sgci07', 'sgci04', 'sgci06', 'sgci01', 'sgci09']"
81,543,15,31,12,"['aidenglennon', 'cata3rd', 'sam.e.wiegand', 'akryzanski', 'danloucksbaer', 'giatrzaska', 'bernsc', 'lbarba', 'zueeluee', 'omrieilat222', 'coglia', 'sumati.rangaraj']",2,"['lij32', 'lfonseca1002']",19,"['dgwthree', 'vot5', 'feifeicash', 'rmahserjian', 'ningpingwang3', 'stacrm', 'amatos99', 'cbear3289', 'pagliv', 'bertel010', 'xiaofeizeng11', 'malcolmmcclymonds', None, 'morroa2secondtime', 'ka99a', 'kongf', 'alexfbrodsky', 'lphuang', 'nabeelbukhari1989']",33,"['dgwthree', 'vot5', 'feifeicash', 'rmahserjian', 'lij32', 'ningpingwang3', 'stacrm', 'aidenglennon', 'omrieilat222', 'danloucksbaer', 'cbear3289', 'amatos99', 'akryzanski', 'sam.e.wiegand', 'pagliv', 'bertel010', 'giatrzaska', 'bernsc', 'lbarba', 'xiaofeizeng11', 'malcolmmcclymonds', None, 'morroa2secondtime', 'ka99a', 'kongf', 'alexfbrodsky', 'cata3rd', 'lphuang', 'nabeelbukhari1989', 'zueeluee', 'coglia', 'sumati.rangaraj', 'lfonseca1002']"
81,546,15,31,12,"['aidenglennon', 'cata3rd', 'sam.e.wiegand', 'akryzanski', 'danloucksbaer', 'giatrzaska', 'bernsc', 'lbarba', 'zueeluee', 'omrieilat222', 'coglia', 'sumati.rangaraj']",2,"['lij32', 'lfonseca1002']",19,"['dgwthree', 'vot5', 'feifeicash', 'rmahserjian', 'ningpingwang3', 'stacrm', 'amatos99', 'cbear3289', 'pagliv', 'bertel010', 'xiaofeizeng11', 'malcolmmcclymonds', None, 'morroa2secondtime', 'ka99a', 'kongf', 'alexfbrodsky', 'lphuang', 'nabeelbukhari1989']",33,"['dgwthree', 'vot5', 'feifeicash', 'rmahserjian', 'lij32', 'ningpingwang3', 'stacrm', 'aidenglennon', 'omrieilat222', 'danloucksbaer', 'cbear3289', 'amatos99', 'akryzanski', 'sam.e.wiegand', 'pagliv', 'bertel010', 'giatrzaska', 'bernsc', 'lbarba', 'xiaofeizeng11', 'malcolmmcclymonds', None, 'morroa2secondtime', 'ka99a', 'kongf', 'alexfbrodsky', 'cata3rd', 'lphuang', 'nabeelbukhari1989', 'zueeluee', 'coglia', 'sumati.rangaraj', 'lfonseca1002']"
81,307,15,30,12,"['aidenglennon', 'cata3rd', 'sam.e.wiegand', 'akryzanski', 'danloucksbaer', 'giatrzaska', 'bernsc', 'lbarba', 'zueeluee', 'omrieilat222', 'coglia', 'sumati.rangaraj']",2,"['lij32', 'lfonseca1002']",18,"['stacrm', 'kongf', 'alexfbrodsky', 'morroa2secondtime', 'vot5', 'feifeicash', 'rmahserjian', 'pagliv', 'ningpingwang3', 'bertel010', 'lphuang', 'xiaofeizeng11', 'nabeelbukhari1989', 'amatos99', 'malcolmmcclymonds', None, 'cbear3289', 'ka99a']",32,"['vot5', 'feifeicash', 'rmahserjian', 'lij32', 'ningpingwang3', 'stacrm', 'aidenglennon', 'omrieilat222', 'danloucksbaer', 'cbear3289', 'amatos99', 'akryzanski', 'sam.e.wiegand', 'pagliv', 'bertel010', 'giatrzaska', 'bernsc', 'lbarba', 'xiaofeizeng11', 'malcolmmcclymonds', None, 'morroa2secondtime', 'ka99a', 'kongf', 'alexfbrodsky', 'cata3rd', 'lphuang', 'nabeelbukhari1989', 'zueeluee', 'coglia', 'sumati.rangaraj', 'lfonseca1002']"
81,306,15,29,12,"['aidenglennon', 'cata3rd', 'sam.e.wiegand', 'akryzanski', 'danloucksbaer', 'giatrzaska', 'bernsc', 'lbarba', 'zueeluee', 'omrieilat222', 'coglia', 'sumati.rangaraj']",2,"['lij32', 'lfonseca1002']",17,"['stacrm', 'kongf', 'alexfbrodsky', 'morroa2secondtime', 'vot5', 'rmahserjian', 'pagliv', 'ningpingwang3', 'bertel010', 'lphuang', 'xiaofeizeng11', 'nabeelbukhari1989', 'amatos99', 'malcolmmcclymonds', None, 'cbear3289', 'ka99a']",31,"['vot5', 'rmahserjian', 'lij32', 'ningpingwang3', 'stacrm', 'aidenglennon', 'omrieilat222', 'danloucksbaer', 'cbear3289', 'amatos99', 'akryzanski', 'sam.e.wiegand', 'pagliv', 'bertel010', 'giatrzaska', 'bernsc', 'lbarba', 'xiaofeizeng11', 'malcolmmcclymonds', None, 'morroa2secondtime', 'ka99a', 'kongf', 'alexfbrodsky', 'cata3rd', 'lphuang', 'nabeelbukhari1989', 'zueeluee', 'coglia', 'sumati.rangaraj', 'lfonseca1002']"
81,544,15,28,12,"['aidenglennon', 'cata3rd', 'sam.e.wiegand', 'akryzanski', 'danloucksbaer', 'giatrzaska', 'bernsc', 'lbarba', 'zueeluee', 'omrieilat222', 'coglia', 'sumati.rangaraj']",2,"['lij32', 'lfonseca1002']",16,"['stacrm', 'kongf', 'alexfbrodsky', 'morroa2secondtime', 'vot5', 'rmahserjian', 'pagliv', 'ningpingwang3', 'bertel010', 'xiaofeizeng11', 'nabeelbukhari1989', 'amatos99', 'malcolmmcclymonds', None, 'cbear3289', 'ka99a']",30,"['vot5', 'rmahserjian', 'lij32', 'ningpingwang3', 'stacrm', 'aidenglennon', 'omrieilat222', 'danloucksbaer', 'cbear3289', 'amatos99', 'akryzanski', 'sam.e.wiegand', 'pagliv', 'bertel010', 'giatrzaska', 'bernsc', 'lbarba', 'xiaofeizeng11', 'malcolmmcclymonds', None, 'morroa2secondtime', 'ka99a', 'kongf', 'alexfbrodsky', 'cata3rd', 'nabeelbukhari1989', 'zueeluee', 'coglia', 'sumati.rangaraj', 'lfonseca1002']"
81,311,15,9,7,"['cata3rd', 'akryzanski', 'sam.e.wiegand', 'bernsc', 'lbarba', 'giatrzaska', 'zueeluee']",7,"['aidenglennon', 'danloucksbaer', 'lij32', 'omrieilat222', 'coglia', 'sumati.rangaraj', 'lfonseca1002']",2,"[None, 'morroa2secondtime']",16,"['akryzanski', 'sam.e.wiegand', 'danloucksbaer', 'lij32', 'giatrzaska', 'bernsc', 'lbarba', None, 'morroa2secondtime', 'cata3rd', 'aidenglennon', 'zueeluee', 'omrieilat222', 'coglia', 'sumati.rangaraj', 'lfonseca1002']"
82,293,14,24,12,"['snr5198', 'wangyuyang0306', 'jjg5869', 'mxh644', 'jec5779', 'yxy181', 'bas602', 'mva6513', 'sad5622', 'taylorhufnagel', 'shen7', 'aut213']",1,['dmr5688'],12,"['jrm6441', 'ojb6', 'jto5096', 'ash5559', 'lassejensen', 'zxf4', 'yqw5477', 'gxc195', 'joc5522', 'cmg6243', 'frb12', None]",25,"['jto5096', 'mxh644', 'zxf4', 'jec5779', 'joc5522', 'sad5622', 'aut213', 'snr5198', 'wangyuyang0306', 'jjg5869', 'bas602', 'shen7', 'ash5559', 'lassejensen', 'yxy181', 'cmg6243', None, 'ojb6', 'jrm6441', 'yqw5477', 'gxc195', 'dmr5688', 'mva6513', 'frb12', 'taylorhufnagel']"
82,458,14,21,1,['dmr5688'],12,"['snr5198', 'wangyuyang0306', 'jjg5869', 'mxh644', 'jec5779', 'yxy181', 'bas602', 'mva6513', 'sad5622', 'taylorhufnagel', 'shen7', 'aut213']",20,"['jto5096', 'hieutrinh0401', 'jparks', 'n.h.trung171', 'lkline02', 'loveyourlobe', 'hieutrinh1229', 'clanum675', 'sohlbergk', 'anthonyle5696', 'mjm697', 'tc636', 'nashita.akanda', 'sure25', None, 'brycopp', 'awhowcroft', 'ylam20', 'jyk38', 'vj84']",33,"['jto5096', 'hieutrinh0401', 'mxh644', 'jparks', 'jec5779', 'sad5622', 'n.h.trung171', 'lkline02', 'loveyourlobe', 'aut213', 'snr5198', 'hieutrinh1229', 'wangyuyang0306', 'jjg5869', 'clanum675', 'bas602', 'sohlbergk', 'shen7', 'anthonyle5696', 'mjm697', 'tc636', 'nashita.akanda', 'yxy181', 'sure25', None, 'brycopp', 'awhowcroft', 'ylam20', 'jyk38', 'dmr5688', 'vj84', 'mva6513', 'taylorhufnagel']"
82,456,14,19,12,"['snr5198', 'wangyuyang0306', 'jjg5869', 'mxh644', 'jec5779', 'yxy181', 'bas602', 'mva6513', 'sad5622', 'taylorhufnagel', 'shen7', 'aut213']",1,['dmr5688'],7,"['jrm6441', None, 'jto5096', 'ash5559', 'lassejensen', 'cmg6243', 'ojb6']",20,"['jto5096', 'mxh644', 'jec5779', 'sad5622', 'aut213', 'snr5198', 'wangyuyang0306', 'jjg5869', 'bas602', 'shen7', 'ash5559', 'lassejensen', 'yxy181', 'cmg6243', 'ojb6', None, 'jrm6441', 'dmr5688', 'mva6513', 'taylorhufnagel']"
82,294,14,17,10,"['snr5198', 'wangyuyang0306', 'mxh644', 'jec5779', 'yxy181', 'bas602', 'mva6513', 'sad5622', 'shen7', 'aut213']",3,"['jjg5869', 'dmr5688', 'taylorhufnagel']",7,"['jrm6441', None, 'jto5096', 'ash5559', 'lassejensen', 'cmg6243', 'ojb6']",20,"['jto5096', 'ash5559', 'lassejensen', 'mxh644', 'jec5779', 'yxy181', 'sad5622', 'cmg6243', 'ojb6', None, 'aut213', 'jrm6441', 'snr5198', 'wangyuyang0306', 'jjg5869', 'dmr5688', 'bas602', 'mva6513', 'taylorhufnagel', 'shen7']"
82,457,14,12,6,"['snr5198', 'wangyuyang0306', 'mva6513', 'sad5622', 'shen7', 'aut213']",7,"['jjg5869', 'mxh644', 'jec5779', 'dmr5688', 'yxy181', 'bas602', 'taylorhufnagel']",6,"['jrm6441', 'jto5096', 'lassejensen', 'jrmagraw98', 'cmg6243', None]",19,"['jto5096', 'lassejensen', 'mxh644', 'jec5779', 'jrmagraw98', 'yxy181', 'sad5622', 'cmg6243', None, 'aut213', 'jrm6441', 'snr5198', 'wangyuyang0306', 'jjg5869', 'dmr5688', 'bas602', 'mva6513', 'taylorhufnagel', 'shen7']"
83,298,14,14,13,"['scarlett_res', 'dtapia', 'efren_rangel', 'gaxel85', 'a00827109', 'mario961', 'a01235509', 'a01378710', 'a01750434', 'ericksanchez', 'alfonsoga', 'jesse.goiz', 'michellebriones']",0,[],1,[None],14,"['scarlett_res', 'dtapia', 'efren_rangel', 'gaxel85', 'mario961', 'a01378710', 'ericksanchez', None, 'a00827109', 'a01235509', 'a01750434', 'alfonsoga', 'jesse.goiz', 'michellebriones']"
85,484,14,8,7,"['junda23', 'ajb6177', 'ljg5355', 'djb84', 'kxz172', 'tux42', 'ssh29']",6,"['stefano.lai', 'afj5306', 'madmaxcesar', 'javimven', 'surajrao22', 'sxb701']",1,[None],14,"['junda23', 'ajb6177', 'djb84', 'javimven', 'surajrao22', 'tux42', None, 'stefano.lai', 'ljg5355', 'afj5306', 'madmaxcesar', 'kxz172', 'sxb701', 'ssh29']"
87,379,14,40,5,"['jasmingc', 'lawrencead2', 'jonesdc7', 'joneswm3', 'nikhatzhn']",8,"['macalintalca', 'duongkh', 'tomlinw2', 'escamillaa', 'holderj3', 'hufferec', 'nguyenk35', 'georgejt']",35,"['salem2', 'jimenezph', 'dhilanr', 'kianamon', 'stonerockjp', 'dkorakakis', 'rosariopronsato', 'markus.ratzke', 'audreykluis', 'ronak_devda', 'nsule', 'theharshit', 'robikecs', 'yuwang', 'gabrielav', 'lado.filipovic', 'carosepulveda99', 'epiccinini', 'kv0001', 'alasaif', 'aecarter', 'vintila131', None, 'maan1742180', 'jmcveigh55', 'indyfisico', 'kav68', 'fraser_darling', 'mamathews', 'tcp47', 'julianlencina96', 'dra2137', 'tusharmore', 'tran_dang0709', 'hadesantiago17']",48,"['salem2', 'macalintalca', 'jimenezph', 'dhilanr', 'kianamon', 'stonerockjp', 'nikhatzhn', 'dkorakakis', 'rosariopronsato', 'markus.ratzke', 'ronak_devda', 'georgejt', 'audreykluis', 'nsule', 'theharshit', 'robikecs', 'yuwang', 'escamillaa', 'joneswm3', 'gabrielav', 'lado.filipovic', 'carosepulveda99', 'epiccinini', 'tomlinw2', 'kv0001', 'holderj3', 'alasaif', 'aecarter', 'hufferec', 'nguyenk35', 'vintila131', None, 'maan1742180', 'jasmingc', 'jmcveigh55', 'lawrencead2', 'duongkh', 'indyfisico', 'kav68', 'jonesdc7', 'fraser_darling', 'mamathews', 'tcp47', 'julianlencina96', 'dra2137', 'tusharmore', 'tran_dang0709', 'hadesantiago17']"
87,6,14,26,10,"['lawrencead2', 'macalintalca', 'duongkh', 'jonesdc7', 'escamillaa', 'joneswm3', 'nikhatzhn', 'hufferec', 'nguyenk35', 'georgejt']",3,"['jasmingc', 'tomlinw2', 'holderj3']",16,"['batestm', 'xanderwill', 'stonerockjp', 'uozgur', 'assirs', 'greyrj', 'tinglet', 'amras', 'andaryyn', 'dufflab', 'walterses', 'nikita.d.popel', 'barfieldja', 'audreykluis', None, 'vavrutin']",29,"['macalintalca', 'stonerockjp', 'assirs', 'nikhatzhn', 'audreykluis', 'georgejt', 'nikita.d.popel', 'vavrutin', 'escamillaa', 'greyrj', 'joneswm3', 'amras', 'barfieldja', 'xanderwill', 'tomlinw2', 'tinglet', 'andaryyn', 'holderj3', 'dufflab', 'walterses', 'hufferec', 'nguyenk35', 'uozgur', None, 'jasmingc', 'lawrencead2', 'duongkh', 'batestm', 'jonesdc7']"
87,121,14,19,10,"['lawrencead2', 'macalintalca', 'duongkh', 'jonesdc7', 'escamillaa', 'joneswm3', 'nikhatzhn', 'hufferec', 'nguyenk35', 'georgejt']",3,"['jasmingc', 'tomlinw2', 'holderj3']",9,"['stonerockjp', 'assirs', 'tinglet', 'andaryyn', 'amras', 'nikita.d.popel', 'audreykluis', None, 'vavrutin']",22,"['macalintalca', 'stonerockjp', 'assirs', 'nikhatzhn', 'audreykluis', 'georgejt', 'nikita.d.popel', 'vavrutin', 'escamillaa', 'joneswm3', 'amras', 'tomlinw2', 'tinglet', 'andaryyn', 'holderj3', 'hufferec', 'nguyenk35', None, 'jasmingc', 'lawrencead2', 'duongkh', 'jonesdc7']"
87,16,14,16,10,"['lawrencead2', 'macalintalca', 'duongkh', 'jonesdc7', 'escamillaa', 'joneswm3', 'nikhatzhn', 'hufferec', 'nguyenk35', 'georgejt']",3,"['jasmingc', 'tomlinw2', 'holderj3']",6,"['xanderwill', 'stonerockjp', 'tinglet', 'andaryyn', 'audreykluis', None]",19,"['macalintalca', 'xanderwill', 'stonerockjp', 'tomlinw2', 'tinglet', 'andaryyn', 'holderj3', 'nikhatzhn', 'hufferec', 'nguyenk35', 'audreykluis', 'georgejt', None, 'jasmingc', 'lawrencead2', 'duongkh', 'jonesdc7', 'escamillaa', 'joneswm3']"
87,342,14,14,9,"['lawrencead2', 'macalintalca', 'duongkh', 'jonesdc7', 'escamillaa', 'joneswm3', 'nikhatzhn', 'hufferec', 'georgejt']",4,"['jasmingc', 'tomlinw2', 'nguyenk35', 'holderj3']",5,"['xanderwill', 'stonerockjp', 'andaryyn', 'audreykluis', None]",18,"['macalintalca', 'xanderwill', 'stonerockjp', 'tomlinw2', 'andaryyn', 'holderj3', 'nikhatzhn', 'hufferec', 'nguyenk35', 'audreykluis', 'georgejt', None, 'jasmingc', 'lawrencead2', 'duongkh', 'jonesdc7', 'escamillaa', 'joneswm3']"
88,453,13,14,12,"['tylerwatson1318', 'cameronklabunde', 'troyekinnett', 'zackary.titus', 'ijcloran22', 'awjamiso22', 'mecobos08', 'paulschmitt8', 'arotaru22', 'maddoxlee33', 'jacobrprice66', 'dabeastmyers']",0,[],2,"['achivington98', None]",14,"['achivington98', 'tylerwatson1318', 'cameronklabunde', 'troyekinnett', 'ijcloran22', 'paulschmitt8', 'arotaru22', 'maddoxlee33', 'jacobrprice66', None, 'dabeastmyers', 'zackary.titus', 'awjamiso22', 'mecobos08']"
88,454,13,10,8,"['cameronklabunde', 'troyekinnett', 'zackary.titus', 'ijcloran22', 'mecobos08', 'arotaru22', 'jacobrprice66', 'dabeastmyers']",4,"['awjamiso22', 'maddoxlee33', 'paulschmitt8', 'tylerwatson1318']",2,"['achivington98', None]",14,"['achivington98', 'tylerwatson1318', 'cameronklabunde', 'troyekinnett', 'ijcloran22', 'paulschmitt8', 'arotaru22', 'maddoxlee33', 'jacobrprice66', None, 'dabeastmyers', 'zackary.titus', 'awjamiso22', 'mecobos08']"
88,451,13,8,7,"['tylerwatson1318', 'zackary.titus', 'paulschmitt8', 'arotaru22', 'maddoxlee33', 'jacobrprice66', 'dabeastmyers']",5,"['cameronklabunde', 'troyekinnett', 'ijcloran22', 'awjamiso22', 'mecobos08']",1,[None],13,"['tylerwatson1318', 'cameronklabunde', 'troyekinnett', 'ijcloran22', 'paulschmitt8', 'arotaru22', 'maddoxlee33', 'jacobrprice66', None, 'dabeastmyers', 'zackary.titus', 'awjamiso22', 'mecobos08']"
88,455,13,8,6,"['tylerwatson1318', 'zackary.titus', 'ijcloran22', 'awjamiso22', 'mecobos08', 'jacobrprice66']",6,"['cameronklabunde', 'troyekinnett', 'maddoxlee33', 'paulschmitt8', 'arotaru22', 'dabeastmyers']",2,"['achivington98', None]",14,"['achivington98', 'tylerwatson1318', 'cameronklabunde', 'troyekinnett', 'ijcloran22', 'paulschmitt8', 'arotaru22', 'maddoxlee33', 'jacobrprice66', None, 'dabeastmyers', 'zackary.titus', 'awjamiso22', 'mecobos08']"
88,452,13,7,5,"['cameronklabunde', 'troyekinnett', 'ijcloran22', 'awjamiso22', 'mecobos08']",7,"['tylerwatson1318', 'zackary.titus', 'maddoxlee33', 'arotaru22', 'paulschmitt8', 'jacobrprice66', 'dabeastmyers']",2,"['achivington98', None]",14,"['achivington98', 'tylerwatson1318', 'cameronklabunde', 'troyekinnett', 'ijcloran22', 'paulschmitt8', 'arotaru22', 'maddoxlee33', 'jacobrprice66', None, 'dabeastmyers', 'zackary.titus', 'awjamiso22', 'mecobos08']"
90,226,13,7,5,"['walshs4', 'matins', 'rooneyw17', 'mattorsie92', 'octoberb']",7,"['lestageg', 'ashleytampellini', 'kosmas176', 'joachima', 'liamfitz6l', 'mattroberts10', 'kirke']",2,"[None, 'princeofthenutella']",14,"['lestageg', 'kosmas176', 'matins', 'joachima', 'princeofthenutella', 'mattroberts10', 'rooneyw17', None, 'octoberb', 'ashleytampellini', 'walshs4', 'liamfitz6l', 'kirke', 'mattorsie92']"
91,370,13,14,1,['hectz96'],11,"['chaithra.19ec010', 'leandro_herzog97', 'varalakshmi.19ec084', 'spazos', 'hrishikanayak9', 'hemanth.19ec019', 'prajwal', 'kfrozen', 'lohith.19ec026', 'menaka_1401', 'mike.meng.shine']",13,"['zndorado', 'jbestavas1', None, 'stellaq', 'lesliet', 'ivizzh', 'ginazavala8', 'ajmirelesme', 'celinechiong', 'aepadilla4', 'jordanhitter41', 'mr.alannunez', 'katia011']",25,"['leandro_herzog97', 'varalakshmi.19ec084', 'lesliet', 'ginazavala8', 'hectz96', 'celinechiong', 'hemanth.19ec019', 'prajwal', 'jordanhitter41', None, 'menaka_1401', 'katia011', 'chaithra.19ec010', 'zndorado', 'jbestavas1', 'stellaq', 'spazos', 'ivizzh', 'ajmirelesme', 'hrishikanayak9', 'aepadilla4', 'kfrozen', 'lohith.19ec026', 'mr.alannunez', 'mike.meng.shine']"
92,491,13,13,9,"['sferekides', 'fatmonk996', 'gfcortes', 'zihuanteng', 'drewth1', 'daniel.olis', 'splocker', 'cadema', 'benjamin.gorman']",3,"['sahilagarwal', 'ahmedan', 'hadrienroy']",4,"['yangning8109', 'fzwake', 'davisrash', None]",16,"['sferekides', 'zihuanteng', 'drewth1', 'daniel.olis', 'hadrienroy', 'cadema', 'fzwake', None, 'fatmonk996', 'ahmedan', 'yangning8109', 'gfcortes', 'davisrash', 'splocker', 'sahilagarwal', 'benjamin.gorman']"
93,169,13,8,6,"['blakebroussard2021', 'dcadena', 'btarcher', 'kalin', 'rmcdermett', 'jshall99']",6,"['rawoofeen', 'baggaprashant5', 'lalit.rawat02', 'sriharsha4b0', 'zhxhao007', 'nbduggarut']",2,"[None, 'joefriedman81']",14,"['rawoofeen', 'blakebroussard2021', 'dcadena', 'joefriedman81', 'lalit.rawat02', 'kalin', 'btarcher', 'zhxhao007', None, 'nbduggarut', 'baggaprashant5', 'sriharsha4b0', 'rmcdermett', 'jshall99']"
95,133,12,14,7,"['brodyas2', 'ajnobbe2', 'avonder2', 'weihuas2', 'conanlh2', 'anirula2', 'ab20']",4,"['jproche2', 'hwang267', 'gauravg2', 'cps4']",7,"['annam4', 'nusratj2', 'jrm9', 'sujaysp2', None, 'yck2', 'cem3']",18,"['jproche2', 'cps4', 'brodyas2', 'annam4', 'nusratj2', 'conanlh2', 'anirula2', 'sujaysp2', None, 'cem3', 'ab20', 'hwang267', 'avonder2', 'gauravg2', 'weihuas2', 'jrm9', 'yck2', 'ajnobbe2']"
95,160,12,12,7,"['brodyas2', 'ajnobbe2', 'avonder2', 'weihuas2', 'conanlh2', 'anirula2', 'ab20']",4,"['jproche2', 'hwang267', 'gauravg2', 'cps4']",5,"['danielyeechankim', 'choquett', 'wnorth2', 'sujaysp2', None]",16,"['jproche2', 'cps4', 'brodyas2', 'choquett', 'conanlh2', 'wnorth2', 'anirula2', 'sujaysp2', None, 'ab20', 'hwang267', 'danielyeechankim', 'avonder2', 'gauravg2', 'weihuas2', 'ajnobbe2']"
97,78,12,20,6,"['raarora', 'amcminn1', 'jjacoby3', 'cdwebb2', 'jcsorian', 'pblam']",5,"['mfreem11', 'a.mangacu', 'jjfox1', 'kfinch2', 'mclarizi']",14,"['wtruxes1', 'amkoss', 'chramsey', 'ajmart47', 'arbenede', 'frmedina', 'yzhao296', 'gchoi13', 'maltarfa', 'menelso8', 'slee511', None, 'jbarteld', 'dshin25']",25,"['wtruxes1', 'raarora', 'yzhao296', 'gchoi13', 'maltarfa', 'jcsorian', 'slee511', 'pblam', None, 'amkoss', 'ajmart47', 'mfreem11', 'a.mangacu', 'mclarizi', 'jjfox1', 'frmedina', 'jjacoby3', 'arbenede', 'kfinch2', 'menelso8', 'cdwebb2', 'amcminn1', 'chramsey', 'jbarteld', 'dshin25']"
97,331,12,10,4,"['raarora', 'pblam', 'cdwebb2', 'jcsorian']",7,"['mfreem11', 'a.mangacu', 'mclarizi', 'jjfox1', 'jjacoby3', 'kfinch2', 'amcminn1']",6,"['skwalker', 'ylisova', 'pbaikadi96', 'maltarfa', 'nrosenb1', None]",17,"['skwalker', 'ylisova', 'raarora', 'maltarfa', 'jcsorian', 'pblam', None, 'mfreem11', 'a.mangacu', 'mclarizi', 'jjfox1', 'pbaikadi96', 'jjacoby3', 'kfinch2', 'cdwebb2', 'amcminn1', 'nrosenb1']"
97,80,12,6,1,['jjacoby3'],10,"['mfreem11', 'raarora', 'a.mangacu', 'jjfox1', 'mclarizi', 'kfinch2', 'cdwebb2', 'amcminn1', 'jcsorian', 'pblam']",5,"['cyang130', 'pbaikadi96', 'yzhao296', None, 'dshin25']",16,"[None, 'cyang130', 'mfreem11', 'a.mangacu', 'raarora', 'jjfox1', 'amcminn1', 'jjacoby3', 'yzhao296', 'kfinch2', 'pbaikadi96', 'cdwebb2', 'mclarizi', 'jcsorian', 'pblam', 'dshin25']"
98,40,12,172,7,"['aryaman1712021', 'mehuldoshi', 'anjali.golani', 'h.bilkhu', 'arya1998', 'arpanbiswas', 'saeesh.aher']",4,"['keval09', 'siddharth_dumbre', 'mai95', 'mayur07']",165,"['chaitanyatamhankar36', 'pas2', 'ankit.ns', 'sachin9', 'mahavirchavda921', '8122vivian', 'vrushali.sule', 'rameshbabu1234', 'amol.kerkar', 'zoheb.mir', 'siddhant.d', 'animesh.prasad', 'sohamshah888', 'rohan.sanghavi', 'advikmaniar', 'bhaskar.a', 'hirenkachhadiya', 'mrunali.khedkar', 'meet29', 'swapnalimakdey25', 'gauravpandey123', 'niketh', 'tiwarisuraj5769', 'jaypandya99', 'niharika.somani', 'soham.ms', 'uttamkumar.m', 'r.mungekar', 'p.ambelkar', 'akshay.pathak', 'nitish.r', 'pooja.nambiar', 'aatman.mehta', 'pranav.mistry', 'm.veer', 'fenny.m', 'pratik.lodha', 'malhar.k', 'nirav.ls', 'sohamk45', 'pranali.nc', 'sangeetamjoshi', 'jmd', 'meheru.p', 'ishanali.k', 'devashri.n', 'antimhr', 'ankitachavan2708', 'rushabh.shah8', 'mayuresh.shirke', 'karan.ap', 'patel.prakash', 'aynaiksatam', 'aadesh.u', 'hitesh.vadgama', 'aayush.butala', 'surajr17', 'yukta.rane', 'param05', 'rishi.molia', 'vinit.js', 'hardik.hp', 'lovleshsingh99', 'amodini8295', 'divya.manikantan', 'kaushal2531999', 'aatifa.bi', 'karan.ys', 'onkarjoshi', 'pulkeet.g', 'meetudiii', 'paras14', 'pktingare23', '8284yash', None, 'pratik.lodha.pl', 'pragya.g', 'rohitrane500', 'manavj.jain', 'pritha.roy', 'poonam2499', 'aman.savla', 'zohebmir006', 'anubhav.bose', 'hiralmistry9', 'sunny.kanojia', 'n.sumra', 'bhavin14', 'shivani.anajria', 'anuragmandke4', 'vipulrkt', 'kartiksrivastava', 'aniket09', 'vedant.modak', 'mihir.khara', 'dhruvik.shah', 'mohil.khona', 'gauri.bane', 'khushboo.darji', 'aditi.b2409', 'ashirwad.b', 'apujara', 'yash.dalvi', 'utsav.maisheri', 'tejal.kadu', 'dipansh.m', 'rajveersingh.k', 'wrathgod123', 'kanojias75', 'p.hodshil', 'siddharth.vaidya', 'shraddha.bw', 'sherylcorina', 'pranavkumar.t', 'pranjal8287', 'purvi.rane', 'pradnya.koli', 'shubhammore', 'patel.ad', 'rahil.t', 'saloni.kaveri', 'simran.mulik', 'rutwik.patel', 'proabdurrasheed', 'ayum.halwai', 'kaushal.g', 'keval23', 'rashi.singhal', 'bharatan.r', 'jaimindesai', 'chaitanya.tambat', 'dhairya.maisheri', 'gmp', 'anamay.m', 'tarun96', '8275joel', 'anilthosar', 'uttamkumarmishra76652', 'nibha.desai', 'kshemal_gupte', 'pranav.garg', 'jayd1529', 'harsh.vasani', 'nikhil.naredla', 'saptarshi.k', 'gauri.rp', 'iamstark9', 'sumitdupate19', 'kmmahuvarkar', 'daamini11', 'saloni_talathi', 'anirudh9911', 'xavierallem', 'c.tamhankar', 'rinkalkeniya', 'sunlovesrahul', 'panchal.vp', 'nipunshah', 'suraj.dm', 'aynkushadav0', 'tejaswini.shelar', 'pratz98', 'ankit.manani', 's.mahetaliya', 'kavya.moolya']",176,"['chaitanyatamhankar36', 'pas2', 'ankit.ns', 'sachin9', 'mahavirchavda921', '8122vivian', 'vrushali.sule', 'rameshbabu1234', 'amol.kerkar', 'zoheb.mir', 'siddhant.d', 'animesh.prasad', 'sohamshah888', 'rohan.sanghavi', 'advikmaniar', 'bhaskar.a', 'hirenkachhadiya', 'mrunali.khedkar', 'meet29', 'swapnalimakdey25', 'mehuldoshi', 'gauravpandey123', 'niketh', 'tiwarisuraj5769', 'jaypandya99', 'h.bilkhu', 'arya1998', 'niharika.somani', 'soham.ms', 'uttamkumar.m', 'r.mungekar', 'p.ambelkar', 'akshay.pathak', 'nitish.r', 'pooja.nambiar', 'aatman.mehta', 'pranav.mistry', 'm.veer', 'arpanbiswas', 'fenny.m', 'pratik.lodha', 'malhar.k', 'nirav.ls', 'sohamk45', 'pranali.nc', 'sangeetamjoshi', 'jmd', 'meheru.p', 'ishanali.k', 'devashri.n', 'antimhr', 'ankitachavan2708', 'rushabh.shah8', 'mayuresh.shirke', 'karan.ap', 'patel.prakash', 'aynaiksatam', 'aadesh.u', 'hitesh.vadgama', 'aayush.butala', 'surajr17', 'yukta.rane', 'param05', 'vinit.js', 'hardik.hp', 'lovleshsingh99', 'amodini8295', 'divya.manikantan', 'kaushal2531999', 'aatifa.bi', 'karan.ys', 'onkarjoshi', 'pulkeet.g', 'meetudiii', 'kavya.moolya', 'paras14', 'pktingare23', '8284yash', None, 'siddharth_dumbre', 'pratik.lodha.pl', 'pragya.g', 'rohitrane500', 'manavj.jain', 'pritha.roy', 'poonam2499', 'aman.savla', 'zohebmir006', 'anubhav.bose', 'hiralmistry9', 'sunny.kanojia', 'n.sumra', 'bhavin14', 'shivani.anajria', 'anuragmandke4', 'vipulrkt', 'kartiksrivastava', 'aniket09', 'vedant.modak', 'mihir.khara', 'dhruvik.shah', 'mohil.khona', 'gauri.bane', 'khushboo.darji', 'aditi.b2409', 'ashirwad.b', 'apujara', 'yash.dalvi', 'utsav.maisheri', 'tejal.kadu', 'dipansh.m', 'rajveersingh.k', 'wrathgod123', 'kanojias75', 'p.hodshil', 'siddharth.vaidya', 'shraddha.bw', 'sherylcorina', 'pranavkumar.t', 'pranjal8287', 'purvi.rane', 'pradnya.koli', 'shubhammore', 'patel.ad', 'anjali.golani', 'rahil.t', 'saloni.kaveri', 'mayur07', 'simran.mulik', 'rutwik.patel', 'proabdurrasheed', 'aryaman1712021', 'ayum.halwai', 'kaushal.g', 'keval23', 'rashi.singhal', 'bharatan.r', 'jaimindesai', 'chaitanya.tambat', 'dhairya.maisheri', 'gmp', 'anamay.m', 'tarun96', '8275joel', 'anilthosar', 'uttamkumarmishra76652', 'saeesh.aher', 'nibha.desai', 'kshemal_gupte', 'pranav.garg', 'jayd1529', 'harsh.vasani', 'nikhil.naredla', 'saptarshi.k', 'gauri.rp', 'iamstark9', 'sumitdupate19', 'kmmahuvarkar', 'daamini11', 'saloni_talathi', 'anirudh9911', 'xavierallem', 'c.tamhankar', 'rinkalkeniya', 'sunlovesrahul', 'panchal.vp', 'keval09', 'nipunshah', 'suraj.dm', 'aynkushadav0', 'tejaswini.shelar', 'pratz98', 'mai95', 'ankit.manani', 's.mahetaliya', 'rishi.molia']"
98,50,12,105,7,"['aryaman1712021', 'anjali.golani', 'h.bilkhu', 'keval09', 'arpanbiswas', 'mayur07', 'saeesh.aher']",4,"['mehuldoshi', 'arya1998', 'mai95', 'siddharth_dumbre']",98,"['nookalaarpan12', 'truptigopinath', '8122vivian', 'sneha.savarkar', 'anuragmandke4', 'ayush2801', 'aditichaturvedi', 'pushkarsutar999', 'siddhant11', 'swapnil.mandavilli', 'sanskar.laddha', 'mitash0404', 'trustme20times', 'jayesh_bane', 'verma07anand', 'pushkar.sutar', 'dhiraj.choudhari', 'atharvasonavane', 'niharika1528', 'prerna.arora', 'tirthpatel', 'divija.shringarpure', 'sohel.datta', 'nimratkaur', 'jaidamani42', 'anuj.chavan', 'richa.motwani', 'pulkit.chaudhari', 'bilal2912', 'rathod_spce', 'tiwarisuraj5769', 'yuvraj.purohit', 'niharika.somani', 'sudhanshu128', 'aryansolanki', 'deekshapalll', 'cxxpxx19', 'bilalsani2912', 'manan.arora', 'sarasheth60', 'sneee', 'manas.tiwari', 'abhinav.pallayil', 'vivek.thakkar', 'sohamk45', 'dhananjay23', 'akshada.hadal', 'sangeetamjoshi', 'saikrishnam', 'khushi.patni', 'chinmay.walinjkar', 'jaimindesai', 'apoorva.limaye', 'shweta0208', 'hargobind.singh', 'tarun96', 'prathamm12', 'anushka.pilena', 'shubham.sawant', 'omkar.shinde', 'omkar.pawar', 'dylan_ds0uza', 'husain.challawala', 'anupriya.dasgupta', 'aditya.umalkar', 'adrao', 'nibha.desai', 'kshemal_gupte', 'aniket.nadkarni', 'shivamthakur04', 'lovleshsingh99', 'siddharthmohanty812', 'aryan.dali', 'divya.manikantan', 'sumitdupate19', 'anirudh9911', 'rinkalkeniya', 'vishal.lohar', 'varun.kamath', 'sunlovesrahul', 'adnan.mohiddin', 'sayaliayre22', 'eeshaanasodekar', 'maitri.vora', None, 'rohitrane500', 'vedant', 'lokesh.patil', 'vraj.b', 'ganesharpan.nookala', 'jainhitanshu588', 'aniket.gawade', 'arohishinde2302', 'darshan.tater', 'pranay.tiwari', 'ankit.manani', 'oindrella', 'aditya.patwardhan']",109,"['nookalaarpan12', 'truptigopinath', '8122vivian', 'sneha.savarkar', 'anuragmandke4', 'ayush2801', 'aditichaturvedi', 'pushkarsutar999', 'siddhant11', 'swapnil.mandavilli', 'sanskar.laddha', 'mitash0404', 'trustme20times', 'jayesh_bane', 'verma07anand', 'pushkar.sutar', 'dhiraj.choudhari', 'atharvasonavane', 'niharika1528', 'prerna.arora', 'tirthpatel', 'divija.shringarpure', 'sohel.datta', 'nimratkaur', 'jaidamani42', 'anuj.chavan', 'richa.motwani', 'pulkit.chaudhari', 'bilal2912', 'rathod_spce', 'mehuldoshi', 'tiwarisuraj5769', 'yuvraj.purohit', 'niharika.somani', 'h.bilkhu', 'arya1998', 'sudhanshu128', 'aryansolanki', 'deekshapalll', 'cxxpxx19', 'bilalsani2912', 'anjali.golani', 'manan.arora', 'sarasheth60', 'arpanbiswas', 'mayur07', 'sneee', 'manas.tiwari', 'aryaman1712021', 'abhinav.pallayil', 'vivek.thakkar', 'sohamk45', 'dhananjay23', 'akshada.hadal', 'sangeetamjoshi', 'saikrishnam', 'khushi.patni', 'chinmay.walinjkar', 'jaimindesai', 'apoorva.limaye', 'shweta0208', 'hargobind.singh', 'tarun96', 'prathamm12', 'anushka.pilena', 'shubham.sawant', 'omkar.shinde', 'omkar.pawar', 'dylan_ds0uza', 'husain.challawala', 'anupriya.dasgupta', 'aditya.umalkar', 'saeesh.aher', 'adrao', 'nibha.desai', 'kshemal_gupte', 'aniket.nadkarni', 'shivamthakur04', 'lovleshsingh99', 'siddharthmohanty812', 'aryan.dali', 'divya.manikantan', 'sumitdupate19', 'anirudh9911', 'rinkalkeniya', 'vishal.lohar', 'varun.kamath', 'sunlovesrahul', 'keval09', 'adnan.mohiddin', 'sayaliayre22', 'eeshaanasodekar', 'maitri.vora', None, 'siddharth_dumbre', 'rohitrane500', 'vedant', 'lokesh.patil', 'vraj.b', 'ganesharpan.nookala', 'jainhitanshu588', 'mai95', 'aniket.gawade', 'arohishinde2302', 'darshan.tater', 'pranay.tiwari', 'ankit.manani', 'oindrella', 'aditya.patwardhan']"
98,54,12,26,1,['mai95'],10,"['aryaman1712021', 'mehuldoshi', 'anjali.golani', 'h.bilkhu', 'arya1998', 'arpanbiswas', 'keval09', 'mayur07', 'saeesh.aher', 'siddharth_dumbre']",25,"['michaelg1137', 'boonesmith', 'bstelter', 'mcrussell', 'nushin01', 'kadenanderson1', 'biggie', 'dwx', 'junwin', 'alexiscanez', 'vduenas', 'klinner', 'nurfazrina', 'nicolelphan', 'mjm2164', 'cpierce14', 'oanhtran97', 'anthonyc1', 'prioslimon', None, 'hqwbu1stq9', 'ryanwestley', 'tdbuechler', 'njenkins', 'dbayko']",36,"['aryaman1712021', 'michaelg1137', 'boonesmith', 'bstelter', 'mcrussell', 'nushin01', 'kadenanderson1', 'biggie', 'dwx', 'junwin', 'alexiscanez', 'saeesh.aher', 'vduenas', 'klinner', 'nurfazrina', 'nicolelphan', 'mjm2164', 'cpierce14', 'mehuldoshi', 'oanhtran97', 'h.bilkhu', 'arya1998', 'keval09', 'anthonyc1', 'prioslimon', None, 'siddharth_dumbre', 'hqwbu1stq9', 'mai95', 'anjali.golani', 'ryanwestley', 'tdbuechler', 'arpanbiswas', 'njenkins', 'mayur07', 'dbayko']"
98,165,12,26,7,"['aryaman1712021', 'mehuldoshi', 'anjali.golani', 'h.bilkhu', 'keval09', 'mayur07', 'saeesh.aher']",4,"['siddharth_dumbre', 'arya1998', 'arpanbiswas', 'mai95']",19,"['sachin9', 'hiralmistry9', 'vedant.modak', 'yukta.rane', 'gauri.bane', 'hirenkachhadiya', 'pranav.garg', 'harsh.vasani', 'jayd1529', 'divya.manikantan', 'gauri.rp', 'anirudh9911', 'rinkalkeniya', 'niharika.somani', 'paras14', None, 'pratik.lodha.pl', 'm.veer', 'malhar.k']",30,"['aryaman1712021', 'sachin9', 'hiralmistry9', 'vedant.modak', 'yukta.rane', 'gauri.bane', 'saeesh.aher', 'hirenkachhadiya', 'harsh.vasani', 'pranav.garg', 'jayd1529', 'divya.manikantan', 'gauri.rp', 'mehuldoshi', 'anirudh9911', 'rinkalkeniya', 'niharika.somani', 'h.bilkhu', 'arya1998', 'keval09', 'paras14', None, 'siddharth_dumbre', 'pratik.lodha.pl', 'mai95', 'anjali.golani', 'm.veer', 'arpanbiswas', 'mayur07', 'malhar.k']"
98,5,12,14,8,"['aryaman1712021', 'mehuldoshi', 'anjali.golani', 'h.bilkhu', 'arpanbiswas', 'keval09', 'mayur07', 'saeesh.aher']",3,"['siddharth_dumbre', 'arya1998', 'mai95']",6,"['divya.manikantan', 'anirudh9911', 'bhargavikaslikar', 'gauri.bane', 'tanmaykhanolkar', None]",17,"['aryaman1712021', 'divya.manikantan', 'mehuldoshi', 'anirudh9911', 'h.bilkhu', 'arya1998', 'keval09', 'tanmaykhanolkar', None, 'siddharth_dumbre', 'mai95', 'anjali.golani', 'bhargavikaslikar', 'arpanbiswas', 'gauri.bane', 'mayur07', 'saeesh.aher']"
98,166,12,11,1,['aryaman1712021'],10,"['mehuldoshi', 'mai95', 'anjali.golani', 'arya1998', 'h.bilkhu', 'arpanbiswas', 'keval09', 'mayur07', 'saeesh.aher', 'siddharth_dumbre']",10,"['saptarshi.k', 'pranali.nc', 'hiralmistry9', 'anirudh9911', 'p.ambelkar', 'niharika.somani', 'paras14', None, 'harsh.vasani', 'jayd1529']",21,"['aryaman1712021', 'saptarshi.k', 'mehuldoshi', 'pranali.nc', 'anirudh9911', 'hiralmistry9', 'niharika.somani', 'h.bilkhu', 'arya1998', 'keval09', 'paras14', None, 'siddharth_dumbre', 'p.ambelkar', 'mai95', 'anjali.golani', 'arpanbiswas', 'mayur07', 'saeesh.aher', 'harsh.vasani', 'jayd1529']"
98,49,12,8,1,['mai95'],10,"['aryaman1712021', 'mehuldoshi', 'anjali.golani', 'h.bilkhu', 'arya1998', 'arpanbiswas', 'keval09', 'mayur07', 'saeesh.aher', 'siddharth_dumbre']",7,"['nicolelphan', 'wtakeda', 'moghimil', 'biggie', 'tdbuechler', 'ajvillani', None]",18,"['aryaman1712021', 'nicolelphan', 'mehuldoshi', 'h.bilkhu', 'arya1998', 'keval09', None, 'siddharth_dumbre', 'wtakeda', 'moghimil', 'biggie', 'mai95', 'anjali.golani', 'tdbuechler', 'ajvillani', 'arpanbiswas', 'mayur07', 'saeesh.aher']"
100,368,12,26,11,"['cea7', 'weiweij', 'cg55', 'henryyang', 'dtl4', 'rl71', 'ww40', 'rx8', 're15', 'jl230', 'hx25']",0,[],15,"['ys69', 'lostinsocorro', 'dk49', 'js177', 'bds6', 'ft13', 'qpzmal7024', 'sl137', 'natelson', 'ciril', 'ph33', 'nsule', None, 'danydet15', 'avilaalba']",26,"['weiweij', 'rl71', 'ph33', 'nsule', 're15', 'ys69', 'ft13', 'ciril', 'sl137', 'jl230', 'avilaalba', 'lostinsocorro', 'dk49', 'cea7', 'qpzmal7024', 'cg55', 'dtl4', 'ww40', 'rx8', None, 'hx25', 'js177', 'bds6', 'henryyang', 'natelson', 'danydet15']"
100,339,12,12,5,"['cea7', 'cg55', 'dtl4', 'rl71', 're15']",6,"['weiweij', 'henryyang', 'rx8', 'ww40', 'jl230', 'hx25']",7,"['ys69', 'bds6', 'sl137', 'natelson', 'ph33', None, 'js177']",18,"['cea7', 'weiweij', 'cg55', 'dtl4', 'rl71', 'ww40', 'rx8', 'ph33', None, 'hx25', 're15', 'js177', 'ys69', 'bds6', 'henryyang', 'natelson', 'sl137', 'jl230']"
103,66,11,28,1,['akiagabbidon'],9,"['srishtisingh10071996', '2020eem1022', 'jaiswalsagar51', 'rahul997397', 'kummara', 'kanupriya', 'brajeshbeec', 'nmani', '2020eem1019']",27,"['ldalcomune', 'jciorciari', 'dunyea.grant', 'riseley', 'alfredosardinas', 'xspathari', 'chasef07', 'ryan.erickson', 'davisrash', 'melhr', 'jack.mcfarlane', 'dmiles1', 'roxetteg', 'rpatel2', 'sophid7', 'nataliefranklin', 'akiagabb', 'david.garcia', 'abdulquadriabiru', 'aplummer', 'jerryzhang', 'corby.bertolett', None, 'dfg99', 'jthompson1', 'ryan.holzhausen', 'snijumudheen']",37,"['ldalcomune', 'jciorciari', 'dunyea.grant', 'riseley', 'alfredosardinas', 'brajeshbeec', 'kummara', 'xspathari', 'chasef07', 'ryan.erickson', 'davisrash', 'melhr', 'jack.mcfarlane', 'dmiles1', 'roxetteg', 'rpatel2', 'kanupriya', 'nmani', '2020eem1019', 'sophid7', 'nataliefranklin', 'akiagabb', 'david.garcia', '2020eem1022', 'abdulquadriabiru', 'aplummer', 'jerryzhang', 'corby.bertolett', None, 'dfg99', 'akiagabbidon', 'jthompson1', 'ryan.holzhausen', 'snijumudheen', 'srishtisingh10071996', 'jaiswalsagar51', 'rahul997397']"
105,174,11,11,10,"['espeva18', 'greg.cano42', 'jackymathews24', 'andrew.lepage', 'jfortn71142', 'spencerspeltz', 'spitz', 'brydzia', 'jordann777', 'leej17']",0,[],1,[None],11,"['greg.cano42', 'jackymathews24', 'andrew.lepage', 'spitz', 'jordann777', None, 'espeva18', 'jfortn71142', 'spencerspeltz', 'brydzia', 'leej17']"
106,345,11,74,7,"['donat', 'vlere.tahiri', 'nida.islami26', 'elmedina.sadiku', 'durim.polloshka2', 'bleon.misini', 'djellza.bicaj']",3,"['rina.jasharaj', 'muytjswp87', 'arita.azizi']",67,"['blerim.makiqi', 'verone.krasniqi', 'rita.kastrati', 'artin.sermaxhaj', 'kastriotsalihu', 'elton.kaqiu', 'gentihyseni11', 'njomza.rexhepi3', 'lislimani', 'enkele', 'adonis.xhemajli', 'armir.qurdina', 'albina.maloku1', 'barbana.heta', 'erblina2berisha', 'arlinda.berisha', 'florian.halimi1', 'julinda.nasufi', 'bardha.januzi', 'blerona.emini', 'diare.daqi', 'blerina.haziri', 'barbanataraheta', 'elona.rashica', 'alberianatofaj', 'elona.gervalla', 'flamur', 'valeza.grainca', 'lendrit.ibrahimi', 'albina.ahmeti', 'kadrije.simnica', 'albion', 'fidanhoxha', 'doruntina.hoti', 'redon.tahiri', 'andi.hasanaj', 'elsaa', 'medinehajredini', 'andi.dika', 'bleon.alimi', 'enes.hasani', 'learta.haliti', 'flamur.mustafa', 'blerand.mjeku', 'ilir.jasharaj', 'sara.haliti', 'ora', 'albin.keqmezi', 'donat.aliu147', 'lauragashi', 'musa.kadiri', 'endrit.kuleta', 'nazifebeqiri59', 'bleona.curri', 'gentrim.canolli', 'midie.merovci', 'avdullahmaloku1', 'albin.sejdiu', None, 'flamurmustafa', 'lindkrasniqi', 'klintiponari6', 'lirone.bytyci', 'erdonakrasniqi', 'beni1', 'loreta.pajaziti1', 'njomza.ismaili']",77,"['blerim.makiqi', 'verone.krasniqi', 'rita.kastrati', 'artin.sermaxhaj', 'kastriotsalihu', 'elton.kaqiu', 'gentihyseni11', 'njomza.rexhepi3', 'lislimani', 'donat', 'vlere.tahiri', 'enkele', 'adonis.xhemajli', 'armir.qurdina', 'albina.maloku1', 'rina.jasharaj', 'barbana.heta', 'erblina2berisha', 'arlinda.berisha', 'florian.halimi1', 'julinda.nasufi', 'bardha.januzi', 'blerona.emini', 'diare.daqi', 'blerina.haziri', 'durim.polloshka2', 'barbanataraheta', 'elona.rashica', 'djellza.bicaj', 'alberianatofaj', 'elona.gervalla', 'flamur', 'valeza.grainca', 'lendrit.ibrahimi', 'albina.ahmeti', 'kadrije.simnica', 'albion', 'fidanhoxha', 'doruntina.hoti', 'redon.tahiri', 'andi.hasanaj', 'elsaa', 'medinehajredini', 'andi.dika', 'bleon.alimi', 'enes.hasani', 'learta.haliti', 'flamur.mustafa', 'blerand.mjeku', 'ilir.jasharaj', 'elmedina.sadiku', 'sara.haliti', 'ora', 'muytjswp87', 'albin.keqmezi', 'donat.aliu147', 'lauragashi', 'musa.kadiri', 'endrit.kuleta', 'arita.azizi', 'nazifebeqiri59', 'bleona.curri', 'gentrim.canolli', 'midie.merovci', 'avdullahmaloku1', 'albin.sejdiu', None, 'flamurmustafa', 'lindkrasniqi', 'nida.islami26', 'klintiponari6', 'lirone.bytyci', 'erdonakrasniqi', 'beni1', 'bleon.misini', 'loreta.pajaziti1', 'njomza.ismaili']"
106,343,11,10,1,['bleon.misini'],9,"['donat', 'vlere.tahiri', 'nida.islami26', 'arita.azizi', 'elmedina.sadiku', 'rina.jasharaj', 'durim.polloshka2', 'djellza.bicaj', 'muytjswp87']",9,"['lislimani', 'lindkrasniqi', 'gentrim.canolli', 'kastriotsalihu', 'bleon.alimi', 'celtinaosmanaj', 'andi.dika', 'erblina2berisha', None]",19,"['arita.azizi', 'gentrim.canolli', 'kastriotsalihu', 'bleon.alimi', 'durim.polloshka2', 'celtinaosmanaj', 'andi.dika', 'djellza.bicaj', None, 'lislimani', 'donat', 'vlere.tahiri', 'lindkrasniqi', 'nida.islami26', 'elmedina.sadiku', 'rina.jasharaj', 'erblina2berisha', 'bleon.misini', 'muytjswp87']"
107,35,11,9,5,"['brittany.n.smith', 'thurant', 'hmeikle', 'judithdominguez', 'crichardson1399']",5,"['astiff', 'leehampton06', 'dalelee2008', 'rg300', 'mkrasner']",4,"['bzhang09', None, 'xiexiexiewanrong', 'apc2150']",14,"['brittany.n.smith', 'astiff', 'leehampton06', 'dalelee2008', 'thurant', 'hmeikle', 'mkrasner', 'judithdominguez', 'apc2150', None, 'xiexiexiewanrong', 'rg300', 'bzhang09', 'crichardson1399']"
107,36,11,6,4,"['brittany.n.smith', 'astiff', 'judithdominguez', 'thurant']",6,"['leehampton06', 'dalelee2008', 'rg300', 'hmeikle', 'mkrasner', 'crichardson1399']",2,"['bzhang09', None]",12,"['brittany.n.smith', 'astiff', 'leehampton06', 'dalelee2008', 'thurant', 'rg300', 'hmeikle', 'mkrasner', 'judithdominguez', 'bzhang09', 'crichardson1399', None]"
109,81,10,9,5,"['javierg40084', 'jacob.stehle', 'oc52600', 'jahlani.mccrumby', 'dilibertojared']",4,"['alicenila.m', 'rnuqui12', 'dyost_1799', '123wendyronquillo123']",4,"['jesus122999', 'imtiaza20', None, 'imransmailbox']",13,"['jesus122999', 'imtiaza20', 'javierg40084', None, 'dyost_1799', 'rnuqui12', '123wendyronquillo123', 'imransmailbox', 'jacob.stehle', 'alicenila.m', 'oc52600', 'jahlani.mccrumby', 'dilibertojared']"
110,81,10,9,3,"['jesus122999', 'imtiaza20', 'imransmailbox']",6,"['lekialeon', 'mulatsilac', 'lukasfong25', 'donovanbercasiopowayhigh', 'diegocelaya839', 'huy.truong.game']",6,"['javierg40084', None, 'jacob.stehle', 'oc52600', 'jahlani.mccrumby', 'dilibertojared']",15,"['jesus122999', 'imtiaza20', 'javierg40084', 'lekialeon', None, 'huy.truong.game', 'lukasfong25', 'donovanbercasiopowayhigh', 'diegocelaya839', 'imransmailbox', 'jacob.stehle', 'oc52600', 'jahlani.mccrumby', 'mulatsilac', 'dilibertojared']"
112,124,10,39,7,"['maxjorgenson', 'calebhall27', 'lornstil', 'mgwong132', 'ckrawczy', 'meverson', 'kwang02']",2,"['donesto', 'sudiptamajumder17']",32,"['elijahellison3', 'ro3t3ch', 'rdcurtis20', 'cesokol', 'jacksonhilton', 'larsmatthys', 'mbkivy', 'tloutfi', 'mgovers', 'rstallin', 'rdilauro', 'nickamarasinghe', 'rebeccawinger', 'lfhunter', 'jacobreed', 'harrisonvdw', 'tvaughn27', 'mitchellschrader', 'faithann2020', 'gavinschmidtke', 'jyang120', 'kshimanuki', 'ejg70', None, 'mfriend', 'muwafaq09', 'camdengallen', 'marcushawley', 'jacksonfradd', 'mbholland', 'caiustoygrace', 'hughfordyce']",41,"['elijahellison3', 'ro3t3ch', 'maxjorgenson', 'rdcurtis20', 'cesokol', 'jacksonhilton', 'larsmatthys', 'donesto', 'mgwong132', 'mbkivy', 'tloutfi', 'mgovers', 'rstallin', 'rdilauro', 'nickamarasinghe', 'rebeccawinger', 'calebhall27', 'lfhunter', 'jacobreed', 'kwang02', 'tvaughn27', 'mitchellschrader', 'faithann2020', 'harrisonvdw', 'sudiptamajumder17', 'gavinschmidtke', 'jyang120', 'kshimanuki', 'ejg70', 'ckrawczy', 'meverson', 'mfriend', 'muwafaq09', 'camdengallen', 'marcushawley', None, 'jacksonfradd', 'mbholland', 'lornstil', 'caiustoygrace', 'hughfordyce']"
112,116,10,7,6,"['maxjorgenson', 'lornstil', 'mgwong132', 'ckrawczy', 'meverson', 'kwang02']",3,"['donesto', 'sudiptamajumder17', 'calebhall27']",1,[None],10,"[None, 'sudiptamajumder17', 'maxjorgenson', 'calebhall27', 'lornstil', 'donesto', 'mgwong132', 'ckrawczy', 'meverson', 'kwang02']"
113,386,10,183,1,['fraser_darling'],8,"['arauggio', 'tnpatel', 'yuwang', 'julianlencina96', 'gabrielav', 'rosariopronsato', 'carosepulveda99', 'epiccinini']",182,"['ardaulusan_14', 'espejodaniel6', 'liresaferizaj', 'verone.krasniqi', 'gjb56', 'artin.sermaxhaj', 'kastriotsalihu', 'edmondovalvo28', 'vmike0426', 'gentihyseni11', 'lookatfuture09', 'theharshit', 'keremino', 'mf3256', 'enkele', 'liviajanicew', 'kursatmutlu03', 'twcross11', 'kacp3r', 'jonathancollins55', 'kevinh88', 'tlsmarshall1', 'baczas996', 'jbertocc', 'rfneed', 'aleksandardunjic1999', 'bardha.januzi', 'fdirisaglik', 'jedelkind', 'hjhj8794', 'barbanataraheta', 'elona.rashica', 'jlanzoni18', 'jaylenwang', 'jasmina.rozek', 'atkncvkkl1', 'elona.gervalla', 'alberianatofaj', 'flamur', 'albina.ahmeti', 'albion', 'fidanhoxha', 'czes', 'nicolech73', 'redon.tahiri', 'dhilanr', 'lockbox30', 'sgu20171552', 'hanife', 'elsaa', 'bayramdonmez96', 'cmunoz', 'enes.hasani', 'arnavsrivastava', 'ph33', 'smrf432', 'saxenapurva96', 'enweizhang732', 'karpuz', 'flamur.mustafa', 'ilir.jasharaj', 'cemaloz745', 'ft13', 'akdemirel99', 'reepl', 'kagangunes10', 'recaro13', 'yusufsabahoglu05', 'ekim.coskun19', 'donat.aliu147', 'musa.kadiri', 'sreevidya.c', 'nazifebeqiri59', 'andreheinzig', 'midie.merovci', 'jculp', 'albin.sejdiu', 'kfullen', 'yaohuichen', 'maan1742180', 'jmcveigh55', 'ducka.agata', 'jfmuller', 'kav68', 'klintiponari6', 'akshatpokharna7', 'ertugrul4101160', 'serhatiseri', '1jordanschwartz', 'njomza.ismaili', 'salem2', 'rita.kastrati', 'yellowturtle', 'szerefa', 'hary765', 'dkorakakis', 'domagoj.tomic', 'elton.kaqiu', 'samuelnxr', 'do356', 'mas2565', 'njomza.rexhepi3', 'lislimani', 'fabio.telesca', 'adonis.xhemajli', 'ml3566', 'koushik.cc', 'hanhdp99', 'pan_1238', 'barbana.heta', 'erblina2berisha', 's.kasamatsu', 'sug20171516', 'sgu20171546', 'krzysztof.golyga', 'laxman_18110093', 'solarwing', 'ben3862', 'artine.hoxha', 'florian.halimi1', 'acastro34', 'julinda.nasufi', 'canhuseyinnn', 'blerona.emini', 'patelba', 'ghosh_payel', 'zs2495', 'alpayy98', 'petrini', 'valeza.grainca', 'lendrit.ibrahimi', 'tcp47', 'doruntina.hoti', 'mra4020', 'pospiechjoanna', 'burghoornniels', 'bernhardhaas55', 'qahoang', 'cristianololipops56', 'kianamon', 'ozcanguclu', 'clinlin9264', 'medinehajredini', 'davidosmanovic', 'bleon.alimi', 'andi.dika', 'bdn2113', 'emreyilmazel1996', 'taol190799', 'sgu20171596', 'blerand.mjeku', 'emircansimsek', 'beskisehir', 'lado.filipovic', 'sara.haliti', 'jcjohnson', 'ora', 'cansecgin', 'cspiner', 'edgarm120397', 'lauragashi', 'piter15710', 'sd226', 'hadesantiago17', 'sakshi17jagtap', 'kv0001', 'aecarter', 'christianc2', 'nrcnaltinbas', 'scullyer16', 'lindkrasniqi', 'indyfisico', 'jpalko20', 'madharmes', 'erdonakrasniqi', 'bksharpe2021', 'gollner.laura', 'beni1', 'junchong10', 'lowen12', 'loreta.pajaziti1', 'yasinzgen']",191,"['ardaulusan_14', 'espejodaniel6', 'liresaferizaj', 'verone.krasniqi', 'gjb56', 'artin.sermaxhaj', 'kastriotsalihu', 'edmondovalvo28', 'vmike0426', 'gentihyseni11', 'lookatfuture09', 'theharshit', 'keremino', 'mf3256', 'enkele', 'liviajanicew', 'kursatmutlu03', 'twcross11', 'kacp3r', 'jonathancollins55', 'gabrielav', 'kevinh88', 'tlsmarshall1', 'baczas996', 'jbertocc', 'rfneed', 'aleksandardunjic1999', 'bardha.januzi', 'fdirisaglik', 'jedelkind', 'hjhj8794', 'barbanataraheta', 'elona.rashica', 'jlanzoni18', 'jaylenwang', 'jasmina.rozek', 'atkncvkkl1', 'elona.gervalla', 'alberianatofaj', 'flamur', 'albina.ahmeti', 'albion', 'julianlencina96', 'fidanhoxha', 'czes', 'nicolech73', 'redon.tahiri', 'tnpatel', 'dhilanr', 'lockbox30', 'sgu20171552', 'hanife', 'elsaa', 'bayramdonmez96', 'cmunoz', 'rosariopronsato', 'enes.hasani', 'arnavsrivastava', 'ph33', 'smrf432', 'saxenapurva96', 'enweizhang732', 'karpuz', 'flamur.mustafa', 'ilir.jasharaj', 'cemaloz745', 'ft13', 'akdemirel99', 'reepl', 'kagangunes10', 'recaro13', 'yusufsabahoglu05', 'epiccinini', 'ekim.coskun19', 'donat.aliu147', 'musa.kadiri', 'sreevidya.c', 'nazifebeqiri59', 'andreheinzig', 'midie.merovci', 'jculp', 'albin.sejdiu', 'kfullen', 'yaohuichen', 'maan1742180', 'jmcveigh55', 'ducka.agata', 'jfmuller', 'kav68', 'klintiponari6', 'akshatpokharna7', 'ertugrul4101160', 'serhatiseri', '1jordanschwartz', 'njomza.ismaili', 'salem2', 'rita.kastrati', 'yellowturtle', 'szerefa', 'hary765', 'dkorakakis', 'domagoj.tomic', 'elton.kaqiu', 'samuelnxr', 'do356', 'mas2565', 'njomza.rexhepi3', 'lislimani', 'fabio.telesca', 'adonis.xhemajli', 'ml3566', 'koushik.cc', 'hanhdp99', 'pan_1238', 'yasinzgen', 'barbana.heta', 'erblina2berisha', 's.kasamatsu', 'sug20171516', 'sgu20171546', 'krzysztof.golyga', 'laxman_18110093', 'solarwing', 'ben3862', 'artine.hoxha', 'florian.halimi1', 'acastro34', 'julinda.nasufi', 'canhuseyinnn', 'blerona.emini', 'patelba', 'ghosh_payel', 'zs2495', 'alpayy98', 'petrini', 'valeza.grainca', 'lendrit.ibrahimi', 'fraser_darling', 'tcp47', 'doruntina.hoti', 'mra4020', 'pospiechjoanna', 'burghoornniels', 'bernhardhaas55', 'qahoang', 'cristianololipops56', 'kianamon', 'ozcanguclu', 'clinlin9264', 'medinehajredini', 'davidosmanovic', 'bleon.alimi', 'andi.dika', 'bdn2113', 'emreyilmazel1996', 'taol190799', 'sgu20171596', 'blerand.mjeku', 'yuwang', 'emircansimsek', 'beskisehir', 'lado.filipovic', 'sara.haliti', 'jcjohnson', 'carosepulveda99', 'ora', 'cansecgin', 'cspiner', 'edgarm120397', 'lauragashi', 'piter15710', 'sd226', 'sakshi17jagtap', 'kv0001', 'aecarter', 'christianc2', 'nrcnaltinbas', 'scullyer16', 'lindkrasniqi', 'indyfisico', 'arauggio', 'jpalko20', 'madharmes', 'erdonakrasniqi', 'bksharpe2021', 'gollner.laura', 'beni1', 'junchong10', 'lowen12', 'loreta.pajaziti1', 'hadesantiago17']"
113,379,10,40,7,"['fraser_darling', 'yuwang', 'julianlencina96', 'gabrielav', 'rosariopronsato', 'carosepulveda99', 'epiccinini']",2,"['tnpatel', 'arauggio']",33,"['salem2', 'jimenezph', 'dhilanr', 'kianamon', 'stonerockjp', 'nikhatzhn', 'dkorakakis', 'markus.ratzke', 'ronak_devda', 'audreykluis', 'nsule', 'theharshit', 'robikecs', 'joneswm3', 'lado.filipovic', 'kv0001', 'alasaif', 'aecarter', 'vintila131', None, 'maan1742180', 'jmcveigh55', 'indyfisico', 'lawrencead2', 'kav68', 'jasmingc', 'jonesdc7', 'mamathews', 'tcp47', 'dra2137', 'tusharmore', 'tran_dang0709', 'hadesantiago17']",42,"['salem2', 'jimenezph', 'dhilanr', 'kianamon', 'stonerockjp', 'nikhatzhn', 'dkorakakis', 'rosariopronsato', 'markus.ratzke', 'ronak_devda', 'audreykluis', 'nsule', 'theharshit', 'robikecs', 'yuwang', 'joneswm3', 'gabrielav', 'lado.filipovic', 'carosepulveda99', 'epiccinini', 'kv0001', 'alasaif', 'aecarter', 'vintila131', None, 'maan1742180', 'jmcveigh55', 'indyfisico', 'lawrencead2', 'kav68', 'jasmingc', 'arauggio', 'jonesdc7', 'fraser_darling', 'mamathews', 'tcp47', 'julianlencina96', 'dra2137', 'tusharmore', 'tran_dang0709', 'tnpatel', 'hadesantiago17']"
113,373,10,31,2,"['fraser_darling', 'julianlencina96']",7,"['arauggio', 'tnpatel', 'yuwang', 'gabrielav', 'rosariopronsato', 'carosepulveda99', 'epiccinini']",29,"['johnkym', 'dhilanr', 'edr2126', 'cmc2374', 'sesh9366', 'bdn2113', 'gruneskrokodil', 'briannab', 'shuvob1', 'robikecs', 'ardagenc', 'alex.oesterling', 'rom2110', 'alasaif', 'mwm2166', 'nickchak21', 'jlanzoni18', 'vintila131', 'ckr.bits', None, 'kav68', 'jhh2197', 'mz2715', 'shdksl95', 'ttj2108', 'dra2137', 'tran_dang0709', '1jordanschwartz', 'thomas.owens2000']",38,"['johnkym', 'dhilanr', 'edr2126', 'cmc2374', 'rosariopronsato', 'sesh9366', 'bdn2113', 'gruneskrokodil', 'briannab', 'shuvob1', 'robikecs', 'yuwang', 'gabrielav', 'ardagenc', 'alex.oesterling', 'rom2110', 'carosepulveda99', 'epiccinini', '1jordanschwartz', 'alasaif', 'mwm2166', 'nickchak21', 'jlanzoni18', 'vintila131', 'ckr.bits', None, 'kav68', 'jhh2197', 'arauggio', 'mz2715', 'fraser_darling', 'julianlencina96', 'shdksl95', 'ttj2108', 'dra2137', 'tran_dang0709', 'tnpatel', 'thomas.owens2000']"
113,382,10,12,1,['gabrielav'],8,"['arauggio', 'tnpatel', 'fraser_darling', 'yuwang', 'julianlencina96', 'rosariopronsato', 'carosepulveda99', 'epiccinini']",11,"['jimenezph', 'miguelz21', 'fernandogarcia8490', 'elpapi.salas13', 'stellaq', 'stella', 'marcosdan8a', 'alvaromarquez5944', None, 'brisavd', 'lizbeth.alejandra.guajardo']",20,"['jimenezph', 'miguelz21', 'fernandogarcia8490', 'rosariopronsato', 'alvaromarquez5944', 'tnpatel', None, 'arauggio', 'elpapi.salas13', 'fraser_darling', 'yuwang', 'stellaq', 'stella', 'julianlencina96', 'gabrielav', 'marcosdan8a', 'carosepulveda99', 'epiccinini', 'brisavd', 'lizbeth.alejandra.guajardo']"
114,469,10,9,7,"['yifuguo3', 'bdli2', 'xihangw2', 'ycchiu2', 'yitengw2', 'hanwool2', 'pch3']",2,"['pbm2', 'sili5']",2,"['shaloo', None]",11,"['yifuguo3', None, 'bdli2', 'shaloo', 'xihangw2', 'ycchiu2', 'yitengw2', 'sili5', 'hanwool2', 'pch3', 'pbm2']"
117,78,10,20,5,"['amkoss', 'wtruxes1', 'ajmart47', 'arbenede', 'slee511']",4,"['daiweili2018', 'bit1120150892', 'ralvar38', 'yetian1997']",15,"[None, 'raarora', 'frmedina', 'yzhao296', 'gchoi13', 'jjacoby3', 'amcminn1', 'maltarfa', 'menelso8', 'cdwebb2', 'jcsorian', 'chramsey', 'pblam', 'jbarteld', 'dshin25']",24,"['wtruxes1', 'bit1120150892', 'raarora', 'yzhao296', 'yetian1997', 'gchoi13', 'daiweili2018', 'maltarfa', 'jcsorian', 'slee511', 'pblam', None, 'amkoss', 'ajmart47', 'arbenede', 'frmedina', 'jjacoby3', 'menelso8', 'cdwebb2', 'amcminn1', 'chramsey', 'dshin25', 'jbarteld', 'ralvar38']"
118,40,10,172,6,"['aatifa.bi', 'kanojias75', 'sunny.kanojia', 'ankitachavan2708', 'bhavin14', 'aditi.b2409']",3,"['govindyadav05806', 'sayandip3116', 'giridharcool96']",166,"['chaitanyatamhankar36', 'pas2', 'ankit.ns', 'sachin9', 'mahavirchavda921', '8122vivian', 'vrushali.sule', 'rameshbabu1234', 'amol.kerkar', 'zoheb.mir', 'siddhant.d', 'animesh.prasad', 'sohamshah888', 'rohan.sanghavi', 'advikmaniar', 'bhaskar.a', 'hirenkachhadiya', 'mrunali.khedkar', 'meet29', 'swapnalimakdey25', 'mehuldoshi', 'gauravpandey123', 'niketh', 'tiwarisuraj5769', 'jaypandya99', 'niharika.somani', 'arya1998', 'soham.ms', 'uttamkumar.m', 'h.bilkhu', 'r.mungekar', 'p.ambelkar', 'akshay.pathak', 'nitish.r', 'pooja.nambiar', 'aatman.mehta', 'pranav.mistry', 'm.veer', 'arpanbiswas', 'fenny.m', 'pratik.lodha', 'malhar.k', 'nirav.ls', 'sohamk45', 'pranali.nc', 'sangeetamjoshi', 'jmd', 'meheru.p', 'ishanali.k', 'devashri.n', 'antimhr', 'rushabh.shah8', 'mayuresh.shirke', 'karan.ap', 'patel.prakash', 'aynaiksatam', 'aadesh.u', 'hitesh.vadgama', 'aayush.butala', 'surajr17', 'yukta.rane', 'param05', 'rishi.molia', 'vinit.js', 'hardik.hp', 'lovleshsingh99', 'amodini8295', 'divya.manikantan', 'kaushal2531999', 'karan.ys', 'onkarjoshi', 'pulkeet.g', 'meetudiii', 'paras14', 'pktingare23', '8284yash', None, 'pratik.lodha.pl', 'pragya.g', 'rohitrane500', 'manavj.jain', 'pritha.roy', 'poonam2499', 'aman.savla', 'zohebmir006', 'anubhav.bose', 'hiralmistry9', 'n.sumra', 'shivani.anajria', 'anuragmandke4', 'vipulrkt', 'kartiksrivastava', 'aniket09', 'vedant.modak', 'mihir.khara', 'dhruvik.shah', 'mohil.khona', 'gauri.bane', 'khushboo.darji', 'ashirwad.b', 'apujara', 'yash.dalvi', 'utsav.maisheri', 'tejal.kadu', 'dipansh.m', 'rajveersingh.k', 'wrathgod123', 'p.hodshil', 'siddharth.vaidya', 'shraddha.bw', 'sherylcorina', 'pranavkumar.t', 'pranjal8287', 'purvi.rane', 'pradnya.koli', 'shubhammore', 'patel.ad', 'rahil.t', 'saloni.kaveri', 'anjali.golani', 'simran.mulik', 'rutwik.patel', 'proabdurrasheed', 'aryaman1712021', 'ayum.halwai', 'kaushal.g', 'keval23', 'rashi.singhal', 'bharatan.r', 'jaimindesai', 'chaitanya.tambat', 'dhairya.maisheri', 'gmp', 'anamay.m', 'tarun96', '8275joel', 'anilthosar', 'uttamkumarmishra76652', 'saeesh.aher', 'nibha.desai', 'kshemal_gupte', 'pranav.garg', 'jayd1529', 'harsh.vasani', 'nikhil.naredla', 'saptarshi.k', 'gauri.rp', 'iamstark9', 'sumitdupate19', 'kmmahuvarkar', 'daamini11', 'saloni_talathi', 'anirudh9911', 'xavierallem', 'c.tamhankar', 'rinkalkeniya', 'sunlovesrahul', 'panchal.vp', 'nipunshah', 'suraj.dm', 'aynkushadav0', 'tejaswini.shelar', 'pratz98', 'ankit.manani', 's.mahetaliya', 'kavya.moolya']",175,"['chaitanyatamhankar36', 'pas2', 'ankit.ns', 'sachin9', 'mahavirchavda921', '8122vivian', 'vrushali.sule', 'rameshbabu1234', 'amol.kerkar', 'zoheb.mir', 'siddhant.d', 'animesh.prasad', 'sohamshah888', 'rohan.sanghavi', 'advikmaniar', 'bhaskar.a', 'hirenkachhadiya', 'mrunali.khedkar', 'meet29', 'swapnalimakdey25', 'mehuldoshi', 'gauravpandey123', 'niketh', 'tiwarisuraj5769', 'jaypandya99', 'niharika.somani', 'sayandip3116', 'arya1998', 'soham.ms', 'uttamkumar.m', 'h.bilkhu', 'r.mungekar', 'p.ambelkar', 'akshay.pathak', 'nitish.r', 'pooja.nambiar', 'aatman.mehta', 'pranav.mistry', 'm.veer', 'arpanbiswas', 'fenny.m', 'pratik.lodha', 'malhar.k', 'nirav.ls', 'sohamk45', 'pranali.nc', 'sangeetamjoshi', 'jmd', 'meheru.p', 'ishanali.k', 'devashri.n', 'ankitachavan2708', 'antimhr', 'rushabh.shah8', 'mayuresh.shirke', 'karan.ap', 'patel.prakash', 'aynaiksatam', 'aadesh.u', 'hitesh.vadgama', 'aayush.butala', 'surajr17', 'yukta.rane', 'param05', 'vinit.js', 'hardik.hp', 'lovleshsingh99', 'amodini8295', 'divya.manikantan', 'kaushal2531999', 'aatifa.bi', 'karan.ys', 'onkarjoshi', 'pulkeet.g', 'meetudiii', 'kavya.moolya', 'paras14', 'pktingare23', '8284yash', None, 'pratik.lodha.pl', 'pragya.g', 'rohitrane500', 'manavj.jain', 'pritha.roy', 'poonam2499', 'aman.savla', 'zohebmir006', 'anubhav.bose', 'hiralmistry9', 'sunny.kanojia', 'n.sumra', 'bhavin14', 'shivani.anajria', 'anuragmandke4', 'vipulrkt', 'kartiksrivastava', 'giridharcool96', 'aniket09', 'vedant.modak', 'govindyadav05806', 'mihir.khara', 'dhruvik.shah', 'mohil.khona', 'gauri.bane', 'khushboo.darji', 'aditi.b2409', 'ashirwad.b', 'apujara', 'yash.dalvi', 'utsav.maisheri', 'tejal.kadu', 'dipansh.m', 'rajveersingh.k', 'wrathgod123', 'kanojias75', 'p.hodshil', 'siddharth.vaidya', 'shraddha.bw', 'sherylcorina', 'pranavkumar.t', 'pranjal8287', 'purvi.rane', 'pradnya.koli', 'shubhammore', 'patel.ad', 'rahil.t', 'saloni.kaveri', 'anjali.golani', 'simran.mulik', 'rutwik.patel', 'proabdurrasheed', 'aryaman1712021', 'ayum.halwai', 'kaushal.g', 'keval23', 'rashi.singhal', 'bharatan.r', 'jaimindesai', 'chaitanya.tambat', 'dhairya.maisheri', 'gmp', 'anamay.m', 'tarun96', '8275joel', 'anilthosar', 'uttamkumarmishra76652', 'saeesh.aher', 'nibha.desai', 'kshemal_gupte', 'pranav.garg', 'jayd1529', 'harsh.vasani', 'nikhil.naredla', 'saptarshi.k', 'gauri.rp', 'iamstark9', 'sumitdupate19', 'kmmahuvarkar', 'daamini11', 'saloni_talathi', 'anirudh9911', 'xavierallem', 'c.tamhankar', 'rinkalkeniya', 'sunlovesrahul', 'panchal.vp', 'nipunshah', 'suraj.dm', 'aynkushadav0', 'tejaswini.shelar', 'pratz98', 'ankit.manani', 's.mahetaliya', 'rishi.molia']"
118,44,10,11,1,['bhavin14'],8,"['aatifa.bi', 'giridharcool96', 'ankitachavan2708', 'sunny.kanojia', 'govindyadav05806', 'sayandip3116', 'kanojias75', 'aditi.b2409']",10,"['yash.dalvi', 'pranali.nc', 'daamini11', 'rahil.t', 'bhagyeshri.o', 'pratik.chudiwale', 'mansi.kurhade', 'antimhr', None, 'tejaswini.shelar']",19,"['aatifa.bi', 'yash.dalvi', 'pranali.nc', 'daamini11', 'sunny.kanojia', 'sayandip3116', 'kanojias75', 'ankitachavan2708', 'bhavin14', 'antimhr', None, 'tejaswini.shelar', 'giridharcool96', 'bhagyeshri.o', 'rahil.t', 'govindyadav05806', 'pratik.chudiwale', 'mansi.kurhade', 'aditi.b2409']"
120,93,9,17,3,"['adrianyabut1998', 'reidwotton', 'yousefibr']",5,"['johnt.13.31', 'zhao.shiqi.art', 'sh2ahmed', 'sum112358', 'natekre']",14,"['camrmartin', 'aidanlusc', 'cacrimi', 'andrewbright44', 'justin8lai', 'oliverhorner98', 'x683li', 'lgrodrig', 'lexirousseau', 'laurah9817', 'jacktinmouth21', 'penelopoff', None, 'cjgmalla']",22,"['camrmartin', 'reidwotton', 'yousefibr', 'cacrimi', 'oliverhorner98', 'x683li', 'lexirousseau', 'laurah9817', 'jacktinmouth21', None, 'johnt.13.31', 'zhao.shiqi.art', 'aidanlusc', 'sh2ahmed', 'adrianyabut1998', 'sum112358', 'justin8lai', 'natekre', 'lgrodrig', 'penelopoff', 'andrewbright44', 'cjgmalla']"
120,151,9,8,6,"['johnt.13.31', 'zhao.shiqi.art', 'reidwotton', 'adrianyabut1998', 'yousefibr', 'natekre']",2,"['sum112358', 'sh2ahmed']",2,"['miasangabriel', None]",10,"['johnt.13.31', 'zhao.shiqi.art', 'reidwotton', 'miasangabriel', 'sh2ahmed', 'yousefibr', 'adrianyabut1998', 'sum112358', 'natekre', None]"
120,94,9,6,3,"['johnt.13.31', 'natekre', 'adrianyabut1998']",5,"['zhao.shiqi.art', 'reidwotton', 'sum112358', 'sh2ahmed', 'yousefibr']",3,"['miasangabriel', None, 'a37campb']",11,"['johnt.13.31', 'zhao.shiqi.art', 'reidwotton', 'miasangabriel', 'sh2ahmed', 'yousefibr', 'adrianyabut1998', 'sum112358', 'natekre', 'a37campb', None]"
120,96,9,6,5,"['johnt.13.31', 'zhao.shiqi.art', 'reidwotton', 'yousefibr', 'natekre']",3,"['sum112358', 'sh2ahmed', 'adrianyabut1998']",1,[None],9,"['johnt.13.31', 'zhao.shiqi.art', 'reidwotton', 'sh2ahmed', 'yousefibr', 'adrianyabut1998', 'sum112358', 'natekre', None]"
122,93,9,17,7,"['camrmartin', 'aidanlusc', 'oliverhorner98', 'lgrodrig', 'lexirousseau', 'laurah9817', 'andrewbright44']",1,['glazaris'],10,"['reidwotton', 'adrianyabut1998', 'yousefibr', 'cacrimi', 'justin8lai', 'x683li', 'jacktinmouth21', 'penelopoff', None, 'cjgmalla']",18,"['camrmartin', 'reidwotton', 'yousefibr', 'oliverhorner98', 'cacrimi', 'x683li', 'glazaris', 'lexirousseau', 'laurah9817', 'jacktinmouth21', None, 'aidanlusc', 'adrianyabut1998', 'justin8lai', 'lgrodrig', 'penelopoff', 'andrewbright44', 'cjgmalla']"
122,466,9,10,6,"['camrmartin', 'aidanlusc', 'lgrodrig', 'glazaris', 'laurah9817', 'andrewbright44']",2,"['oliverhorner98', 'lexirousseau']",4,"['hashembilal1998', '2x3luffy', None, 'emmab']",12,"['camrmartin', '2x3luffy', 'aidanlusc', 'emmab', None, 'andrewbright44', 'hashembilal1998', 'lgrodrig', 'glazaris', 'lexirousseau', 'laurah9817', 'oliverhorner98']"
122,463,9,7,5,"['camrmartin', 'aidanlusc', 'oliverhorner98', 'laurah9817', 'andrewbright44']",3,"['lgrodrig', 'glazaris', 'lexirousseau']",2,"[None, 'emmab']",10,"['camrmartin', 'aidanlusc', 'emmab', None, 'andrewbright44', 'lgrodrig', 'glazaris', 'lexirousseau', 'laurah9817', 'oliverhorner98']"
123,213,9,10,4,"['xphuah', 'pangn', 'kdecocke', 'nmokavid']",4,"['rsabatel', 'ahmad68', 'smoranka', 'giesler']",6,"['jamesbarnard', 'saad2', 'peter676', 'murra191', 'rahulfranklin', None]",14,"['xphuah', 'pangn', 'jamesbarnard', 'smoranka', 'giesler', 'saad2', 'peter676', 'nmokavid', 'ahmad68', 'murra191', 'kdecocke', 'rahulfranklin', None, 'rsabatel']"
123,214,9,7,2,"['smoranka', 'rsabatel']",6,"['xphuah', 'pangn', 'giesler', 'ahmad68', 'kdecocke', 'nmokavid']",5,"['sinclai3', 'smit4180', 'shen544', 'aluktuke', None]",13,"['xphuah', 'pangn', 'smoranka', 'giesler', 'sinclai3', 'nmokavid', 'ahmad68', 'smit4180', 'kdecocke', 'shen544', 'aluktuke', None, 'rsabatel']"
124,549,9,14,4,"['giray', 'furkanbudak42', 'wgip18', 'ah.sa.eskicioz']",4,"['dsevvaldogann', 'yavuzselimeskicumali', 'uralburak', 'aydoganaali19']",10,"['abdulkadirnergiz', 'berksaldr', 'dragon28540', 'haticeterzibali', 'havvafatmaozbay', 'sonerkar', 'raistlin1923', 'alifiratcobanoglu', 'cansecgin', None]",18,"['ah.sa.eskicioz', 'havvafatmaozbay', 'raistlin1923', 'yavuzselimeskicumali', None, 'wgip18', 'abdulkadirnergiz', 'berksaldr', 'haticeterzibali', 'dragon28540', 'furkanbudak42', 'sonerkar', 'giray', 'dsevvaldogann', 'alifiratcobanoglu', 'uralburak', 'cansecgin', 'aydoganaali19']"
124,548,9,9,2,"['yavuzselimeskicumali', 'aydoganaali19']",6,"['ah.sa.eskicioz', 'furkanbudak42', 'giray', 'dsevvaldogann', 'uralburak', 'wgip18']",7,"['sd226', 'samimorsoglu', 'byzayh13', 'mseyfullahcelik', None, 'mertisleyen96', 'oneyyemre']",15,"['sd226', 'samimorsoglu', None, 'byzayh13', 'ah.sa.eskicioz', 'furkanbudak42', 'giray', 'dsevvaldogann', 'mseyfullahcelik', 'oneyyemre', 'uralburak', 'yavuzselimeskicumali', 'aydoganaali19', 'mertisleyen96', 'wgip18']"
124,550,9,9,1,['dsevvaldogann'],7,"['ah.sa.eskicioz', 'furkanbudak42', 'giray', 'uralburak', 'yavuzselimeskicumali', 'aydoganaali19', 'wgip18']",8,"[None, 'byzayh13', 'metobomm', '86kemal86', 'tugbakoyuncu99', 'mumi1478', 'mrgiraffe', 'dumpnit']",16,"[None, 'mrgiraffe', 'byzayh13', 'ah.sa.eskicioz', 'furkanbudak42', 'metobomm', '86kemal86', 'giray', 'dsevvaldogann', 'tugbakoyuncu99', 'mumi1478', 'dumpnit', 'uralburak', 'yavuzselimeskicumali', 'aydoganaali19', 'wgip18']"
126,345,9,74,6,"['albin.keqmezi', 'blerim.makiqi', 'albina.maloku1', 'bleona.curri', 'avdullahmaloku1', 'arlinda.berisha']",2,"['alikanadl6', 'nit.sheik']",68,"['verone.krasniqi', 'rita.kastrati', 'artin.sermaxhaj', 'kastriotsalihu', 'elton.kaqiu', 'gentihyseni11', 'njomza.rexhepi3', 'lislimani', 'donat', 'enkele', 'vlere.tahiri', 'adonis.xhemajli', 'armir.qurdina', 'barbana.heta', 'erblina2berisha', 'florian.halimi1', 'julinda.nasufi', 'bardha.januzi', 'blerona.emini', 'diare.daqi', 'blerina.haziri', 'durim.polloshka2', 'barbanataraheta', 'elona.rashica', 'djellza.bicaj', 'alberianatofaj', 'elona.gervalla', 'flamur', 'valeza.grainca', 'lendrit.ibrahimi', 'albina.ahmeti', 'kadrije.simnica', 'albion', 'fidanhoxha', 'doruntina.hoti', 'redon.tahiri', 'andi.hasanaj', 'elsaa', 'medinehajredini', 'andi.dika', 'bleon.alimi', 'enes.hasani', 'learta.haliti', 'flamur.mustafa', 'blerand.mjeku', 'ilir.jasharaj', 'elmedina.sadiku', 'sara.haliti', 'ora', 'donat.aliu147', 'lauragashi', 'musa.kadiri', 'endrit.kuleta', 'nazifebeqiri59', 'gentrim.canolli', 'midie.merovci', 'albin.sejdiu', None, 'flamurmustafa', 'lindkrasniqi', 'nida.islami26', 'klintiponari6', 'lirone.bytyci', 'erdonakrasniqi', 'beni1', 'bleon.misini', 'loreta.pajaziti1', 'njomza.ismaili']",76,"['blerim.makiqi', 'verone.krasniqi', 'rita.kastrati', 'artin.sermaxhaj', 'kastriotsalihu', 'elton.kaqiu', 'gentihyseni11', 'njomza.rexhepi3', 'lislimani', 'donat', 'enkele', 'vlere.tahiri', 'adonis.xhemajli', 'armir.qurdina', 'alikanadl6', 'albina.maloku1', 'barbana.heta', 'erblina2berisha', 'arlinda.berisha', 'florian.halimi1', 'julinda.nasufi', 'bardha.januzi', 'blerona.emini', 'diare.daqi', 'blerina.haziri', 'durim.polloshka2', 'barbanataraheta', 'elona.rashica', 'djellza.bicaj', 'alberianatofaj', 'elona.gervalla', 'flamur', 'valeza.grainca', 'lendrit.ibrahimi', 'albina.ahmeti', 'kadrije.simnica', 'albion', 'fidanhoxha', 'doruntina.hoti', 'redon.tahiri', 'andi.hasanaj', 'elsaa', 'medinehajredini', 'andi.dika', 'bleon.alimi', 'enes.hasani', 'learta.haliti', 'flamur.mustafa', 'blerand.mjeku', 'ilir.jasharaj', 'nit.sheik', 'elmedina.sadiku', 'sara.haliti', 'ora', 'albin.keqmezi', 'donat.aliu147', 'lauragashi', 'musa.kadiri', 'endrit.kuleta', 'nazifebeqiri59', 'bleona.curri', 'gentrim.canolli', 'midie.merovci', 'avdullahmaloku1', 'albin.sejdiu', None, 'flamurmustafa', 'lindkrasniqi', 'nida.islami26', 'klintiponari6', 'lirone.bytyci', 'erdonakrasniqi', 'beni1', 'bleon.misini', 'loreta.pajaziti1', 'njomza.ismaili']"
126,346,9,16,1,['alikanadl6'],7,"['albin.keqmezi', 'nit.sheik', 'blerim.makiqi', 'albina.maloku1', 'bleona.curri', 'avdullahmaloku1', 'arlinda.berisha']",15,"['keremino', 'mgk816', 'ardaulusan_14', 'batu.oztrkk', 'alpayy98', None, 'svlksknsms', 'oknky', 'ronmesdofb', 'sonerkar', 'koningmehmet', 'emreyilmazel1996', 'cansecgin', 'utkubala63', 'atkncvkkl1']",23,"['albin.keqmezi', 'mgk816', 'ardaulusan_14', 'blerim.makiqi', 'oknky', 'bleona.curri', 'avdullahmaloku1', 'emreyilmazel1996', 'utkubala63', None, 'atkncvkkl1', 'keremino', 'alpayy98', 'batu.oztrkk', 'nit.sheik', 'cansecgin', 'alikanadl6', 'albina.maloku1', 'svlksknsms', 'ronmesdofb', 'sonerkar', 'koningmehmet', 'arlinda.berisha']"
127,485,9,11,8,"['vanderph', 'shermanm42', 'barrsw3', 'jacksonbrennecke', 'pearsoalmailgvsuedu', 'cartwrij', 'rakowicp', 'zuidemad']",0,[],3,"[None, 'huntercvp', 'jiaolh']",11,"['shermanm42', 'huntercvp', 'zuidemad', None, 'jiaolh', 'vanderph', 'barrsw3', 'jacksonbrennecke', 'pearsoalmailgvsuedu', 'cartwrij', 'rakowicp']"
127,499,9,7,6,"['vanderph', 'shermanm42', 'jacksonbrennecke', 'pearsoalmailgvsuedu', 'rakowicp', 'zuidemad']",2,"['barrsw3', 'cartwrij']",1,[None],9,"['vanderph', 'shermanm42', 'barrsw3', 'jacksonbrennecke', 'pearsoalmailgvsuedu', 'cartwrij', 'rakowicp', 'zuidemad', None]"
128,252,9,16,4,"['shalaka.bhandarkar2020', 'snehakurle1995', 'sandra.b2020', 'ssdivyadeepti']",4,"['sreeker_tirunagari', 'bichu.sajeev2020', 'nasimmuhammedk', 'sanjana123']",12,"[None, 'saindane.apurva', 'pavantv', 'sumitdupate19', 'sneha9211', 'amareswar72', 'arijitnitaece20vlsi', 'kprudhvired', 'sreekanthnambi205', 'heenakaushik', 'sneha.kaushik2020', 'nikhil.singh2020']",20,"['sreeker_tirunagari', 'pavantv', 'sumitdupate19', 'sneha9211', 'shalaka.bhandarkar2020', 'sreekanthnambi205', 'heenakaushik', 'sneha.kaushik2020', 'sandra.b2020', None, 'nasimmuhammedk', 'sanjana123', 'saindane.apurva', 'ssdivyadeepti', 'amareswar72', 'arijitnitaece20vlsi', 'kprudhvired', 'bichu.sajeev2020', 'snehakurle1995', 'nikhil.singh2020']"
128,251,9,13,2,"['sreeker_tirunagari', 'sandra.b2020']",6,"['nasimmuhammedk', 'sanjana123', 'ssdivyadeepti', 'bichu.sajeev2020', 'shalaka.bhandarkar2020', 'snehakurle1995']",11,"['sandra.pillai9', 'vuppala.bharath2020', 'amkreddy', 'manikantesh.karimikonda', 'avulamanojkumarreddy', 'rishmitha', 'hemasudha', 'anandsai462', None, 'jyothiprakash', 'saipavan123']",19,"['sreeker_tirunagari', 'sandra.pillai9', 'amkreddy', 'manikantesh.karimikonda', 'shalaka.bhandarkar2020', None, 'sandra.b2020', 'nasimmuhammedk', 'sanjana123', 'vuppala.bharath2020', 'ssdivyadeepti', 'jyothiprakash', 'bichu.sajeev2020', 'avulamanojkumarreddy', 'rishmitha', 'hemasudha', 'anandsai462', 'snehakurle1995', 'saipavan123']"
128,265,9,9,4,"['shalaka.bhandarkar2020', 'snehakurle1995', 'sandra.b2020', 'ssdivyadeepti']",4,"['sreeker_tirunagari', 'bichu.sajeev2020', 'nasimmuhammedk', 'sanjana123']",5,"[None, 'pavantv', 'sneha9211', 'sneha.kaushik2020', 'nikhil.singh2020']",13,"['sreeker_tirunagari', 'nasimmuhammedk', None, 'sanjana123', 'pavantv', 'ssdivyadeepti', 'sandra.b2020', 'sneha9211', 'bichu.sajeev2020', 'shalaka.bhandarkar2020', 'sneha.kaushik2020', 'snehakurle1995', 'nikhil.singh2020']"
128,253,9,8,1,['sanjana123'],7,"['sreeker_tirunagari', 'nasimmuhammedk', 'ssdivyadeepti', 'snehakurle1995', 'bichu.sajeev2020', 'shalaka.bhandarkar2020', 'sandra.b2020']",7,"['mummudi12', None, 'renjurajuc', 'prajual', 'harilavanya', 'chellaramaswamy', 'akshara.kairali2020']",15,"['sreeker_tirunagari', 'nasimmuhammedk', 'mummudi12', 'sanjana123', None, 'ssdivyadeepti', 'renjurajuc', 'sandra.b2020', 'prajual', 'bichu.sajeev2020', 'harilavanya', 'shalaka.bhandarkar2020', 'chellaramaswamy', 'akshara.kairali2020', 'snehakurle1995']"
129,552,9,14,1,['lt448'],7,"['renh.tom', 'rzb0215', 'bennychen58', 'ars21031960', 'ptkempisty', 'yanzhenxin', 'chen.5797']",13,"['jc3496', None, 'nis29', 'rrg74', 'krg66', 'jjh377', 'al2493', 'jpm432', 'akn52', 'anc95', 'rss364', 'ksc225', 'jg2337']",21,"['nis29', 'ksc225', 'rrg74', 'krg66', 'bennychen58', 'jjh377', None, 'jg2337', 'jc3496', 'lt448', 'renh.tom', 'rzb0215', 'ars21031960', 'al2493', 'jpm432', 'ptkempisty', 'akn52', 'yanzhenxin', 'chen.5797', 'rss364', 'anc95']"
132,112,9,35,2,"['lonso559', 'jimin_kim']",6,"['cake0521', 'alcastaneda', 'jezelllee', 'luisferayala', 'cahn0109', 'arsany']",33,"['nikhil.gupta', 'atorres559', 'yue_chen196', 'jmyamartinez5', 'lamalamaduck1', 'cynthiahjt', 'thebalconyart1st', 'preethiraghavan827', 'jonwatkins', 'andygama', 'everettmorton5', 'sjing', 'robert.puccinelli', 'kevin_joslin', 'emre.kusakci', 'jimothy369', 'noelledavis', 'nyathescholar', 'sakshi_shah', 'cdjensen', 'naatessema', 'pamela.george', 'jameslo319', 'kurtismb', 'ckwok3', None, 'limjianhua', 'ari_3_1415', 'magana272', 'mmcd2523', 'efwawrzynek', 'sophia.mahfouz', 'eunkim']",41,"['nikhil.gupta', 'atorres559', 'yue_chen196', 'jmyamartinez5', 'lamalamaduck1', 'cynthiahjt', 'lonso559', 'preethiraghavan827', 'thebalconyart1st', 'cake0521', 'jonwatkins', 'andygama', 'everettmorton5', 'sjing', 'robert.puccinelli', 'kevin_joslin', 'alcastaneda', 'emre.kusakci', 'jimothy369', 'noelledavis', 'eunkim', 'nyathescholar', 'sakshi_shah', 'cdjensen', 'naatessema', 'pamela.george', 'jameslo319', 'kurtismb', 'luisferayala', 'ckwok3', None, 'jezelllee', 'limjianhua', 'jimin_kim', 'ari_3_1415', 'magana272', 'mmcd2523', 'efwawrzynek', 'sophia.mahfouz', 'cahn0109', 'arsany']"
132,111,9,24,2,"['luisferayala', 'alcastaneda']",6,"['cake0521', 'jimin_kim', 'lonso559', 'jezelllee', 'cahn0109', 'arsany']",22,"['jdanielguzman264', 'criscams', 'srabanti', 'anguye22', 'lamarce2016', 'dm.zambrano', 'diego.rojas1130', 'noelledavis', 'goar.ayrapetyan', 'biomemes', 'naatessema', 'caitlincramer12', 'd0kma', 'anirbantwin', 'lorselgi', 'dning', None, 'andres201719819', 'jvl2xv', 'nguerreronaranjo', 'josealejoclaro1999', 'sergioprieto.mm']",30,"['jdanielguzman264', 'criscams', 'srabanti', 'sergioprieto.mm', 'lonso559', 'anguye22', 'cake0521', 'lamarce2016', 'dm.zambrano', 'alcastaneda', 'diego.rojas1130', 'noelledavis', 'goar.ayrapetyan', 'biomemes', 'naatessema', 'caitlincramer12', 'd0kma', 'anirbantwin', 'lorselgi', 'dning', 'luisferayala', None, 'jezelllee', 'andres201719819', 'jvl2xv', 'nguerreronaranjo', 'jimin_kim', 'josealejoclaro1999', 'cahn0109', 'arsany']"
134,118,8,34,6,"['talib4005300', 'boysmart724', 'unaisshazan', 'abdullah99', 'rayyaan99', 'areejasad16']",1,['mohammadrezash585'],28,"['masroor4002808', 'salehabano.ned', 'zahid4006555', 'nadeem4000465', 'ullah4005098', 'aamna123', 'syedamairazia', 'mahmood4030218', 'suhaib', 'mariaali8099', 'rukhsara347', 'laibasaqib307', 'rameesa', 'finalartpythoncoder', 'anwar4003031', 'anwer4001570', 'asif4001007', 'syedaurooj562', 'frmazharp', 'faiz4000626', 'masud4000020', None, 'sana.312', 'hashmi4001891', 'manaljamshed', 'sarfaraz4001312', 'faiza.iqbal680', 'innocent.fazeel66']",35,"['masroor4002808', 'salehabano.ned', 'unaisshazan', 'zahid4006555', 'nadeem4000465', 'ullah4005098', 'aamna123', 'syedamairazia', 'mahmood4030218', 'suhaib', 'mariaali8099', 'rukhsara347', 'laibasaqib307', 'mohammadrezash585', 'abdullah99', 'rayyaan99', 'rameesa', 'finalartpythoncoder', 'anwar4003031', 'anwer4001570', 'asif4001007', 'syedaurooj562', 'frmazharp', 'boysmart724', 'faiz4000626', 'areejasad16', 'masud4000020', None, 'sana.312', 'talib4005300', 'hashmi4001891', 'manaljamshed', 'sarfaraz4001312', 'faiza.iqbal680', 'innocent.fazeel66']"
136,538,8,41,7,"['makaylaturner', 'miaklopfenstein', 'iankerby', 'davidespey', 'tylerhamer', 'kylerayers320', 'isaacwolstenholme25']",0,[],34,"['dominikpanchenko', 'rileywinters', 'shanepalmer', 'nicholasmckibben', 'cfranc01', 'lanlibsu', 'monicaleibowitz', 'arielweltner', 'nickawieber', 'haileemunoz', 'kincaidgraff', 'mathieucerankows', 'abiaggne', 'forestswanson', 'fereshtehrajabik', 'egraugnard', 'quinnhulse', 'nathanthemetalsguy20', 'kaeleenovich', 'maddymckenzie', 'cassidyhoward', 'kaileejones', 'chrisjones', 'kentonburns', 'tristanolsen', 'sophiamitchell', 'madilynpaul', 'oliviamaryon', 'cfackrell', None, 'joshuarussell', 'annaliestipton', 'mar4557', 'nmckibben']",41,"['dominikpanchenko', 'rileywinters', 'shanepalmer', 'miaklopfenstein', 'nicholasmckibben', 'cfranc01', 'lanlibsu', 'monicaleibowitz', 'arielweltner', 'nickawieber', 'haileemunoz', 'kincaidgraff', 'mathieucerankows', 'abiaggne', 'makaylaturner', 'forestswanson', 'fereshtehrajabik', 'egraugnard', 'quinnhulse', 'nathanthemetalsguy20', 'kaeleenovich', 'maddymckenzie', 'kylerayers320', 'cassidyhoward', 'kaileejones', 'chrisjones', 'kentonburns', 'tristanolsen', 'iankerby', 'sophiamitchell', 'madilynpaul', 'tylerhamer', 'oliviamaryon', 'cfackrell', 'isaacwolstenholme25', None, 'joshuarussell', 'annaliestipton', 'mar4557', 'nmckibben', 'davidespey']"
137,370,8,14,5,"['ivizzh', 'ginazavala8', 'ajmirelesme', 'mr.alannunez', 'katia011']",2,"['tksnzl', 'barriosdariana']",9,"['zndorado', 'jbestavas1', 'stellaq', 'lesliet', 'celinechiong', 'aepadilla4', 'jordanhitter41', None, 'hectz96']",16,"['lesliet', 'barriosdariana', 'ginazavala8', 'celinechiong', 'jordanhitter41', None, 'katia011', 'zndorado', 'jbestavas1', 'stellaq', 'ivizzh', 'ajmirelesme', 'aepadilla4', 'tksnzl', 'mr.alannunez', 'hectz96']"
137,460,8,11,5,"['ivizzh', 'ginazavala8', 'ajmirelesme', 'mr.alannunez', 'katia011']",2,"['tksnzl', 'barriosdariana']",6,"['michaelnava380', 'stella', 'celinechiong', 'jordanhitter41', 'hazamarripa', None]",13,"['michaelnava380', 'barriosdariana', 'ginazavala8', 'celinechiong', 'jordanhitter41', 'hazamarripa', None, 'katia011', 'stella', 'ivizzh', 'ajmirelesme', 'tksnzl', 'mr.alannunez']"
137,465,8,10,4,"['katia011', 'mr.alannunez', 'ivizzh', 'ginazavala8']",3,"['tksnzl', 'barriosdariana', 'ajmirelesme']",6,"['stellaq', 'stella', 'celinechiong', 'jordanhitter41', 'hazamarripa', None]",13,"['barriosdariana', 'ginazavala8', 'celinechiong', 'jordanhitter41', 'hazamarripa', None, 'katia011', 'stellaq', 'stella', 'ivizzh', 'ajmirelesme', 'tksnzl', 'mr.alannunez']"
137,340,8,7,3,"['mr.alannunez', 'ginazavala8', 'ajmirelesme']",4,"['tksnzl', 'barriosdariana', 'ivizzh', 'katia011']",4,"['stellaq', None, 'aepadilla4', 'jordanhitter41']",11,"[None, 'stellaq', 'barriosdariana', 'ivizzh', 'ginazavala8', 'ajmirelesme', 'aepadilla4', 'jordanhitter41', 'tksnzl', 'mr.alannunez', 'katia011']"
137,385,8,7,2,"['katia011', 'ginazavala8']",5,"['barriosdariana', 'ivizzh', 'ajmirelesme', 'tksnzl', 'mr.alannunez']",5,"['stellaq', 'lesliet', 'celinechiong', 'jordanhitter41', None]",12,"[None, 'stellaq', 'lesliet', 'barriosdariana', 'ivizzh', 'ginazavala8', 'ajmirelesme', 'celinechiong', 'jordanhitter41', 'tksnzl', 'mr.alannunez', 'katia011']"
137,464,8,7,2,"['mr.alannunez', 'katia011']",5,"['barriosdariana', 'ivizzh', 'ginazavala8', 'ajmirelesme', 'tksnzl']",5,"['stellaq', 'celinechiong', 'jordanhitter41', 'hazamarripa', None]",12,"[None, 'stellaq', 'barriosdariana', 'ivizzh', 'ginazavala8', 'ajmirelesme', 'celinechiong', 'jordanhitter41', 'hazamarripa', 'tksnzl', 'mr.alannunez', 'katia011']"
137,467,8,6,3,"['ivizzh', 'ginazavala8', 'ajmirelesme']",4,"['tksnzl', 'barriosdariana', 'mr.alannunez', 'katia011']",3,"['stellaq', 'michaelnava380', None]",10,"['michaelnava380', None, 'stellaq', 'barriosdariana', 'ivizzh', 'ginazavala8', 'ajmirelesme', 'tksnzl', 'mr.alannunez', 'katia011']"
138,386,8,183,7,"['piter15710', 'czes', 'yellowturtle', 'jasmina.rozek', 'baczas996', 'pospiechjoanna', 'krzysztof.golyga']",0,[],176,"['ardaulusan_14', 'espejodaniel6', 'liresaferizaj', 'verone.krasniqi', 'gjb56', 'artin.sermaxhaj', 'kastriotsalihu', 'edmondovalvo28', 'vmike0426', 'gentihyseni11', 'lookatfuture09', 'theharshit', 'keremino', 'mf3256', 'enkele', 'liviajanicew', 'kursatmutlu03', 'twcross11', 'kacp3r', 'jonathancollins55', 'kevinh88', 'tlsmarshall1', 'jbertocc', 'rfneed', 'aleksandardunjic1999', 'bardha.januzi', 'fdirisaglik', 'jedelkind', 'hjhj8794', 'barbanataraheta', 'elona.rashica', 'jlanzoni18', 'jaylenwang', 'atkncvkkl1', 'elona.gervalla', 'alberianatofaj', 'flamur', 'albina.ahmeti', 'albion', 'fidanhoxha', 'nicolech73', 'redon.tahiri', 'dhilanr', 'lockbox30', 'sgu20171552', 'hanife', 'elsaa', 'bayramdonmez96', 'cmunoz', 'enes.hasani', 'arnavsrivastava', 'ph33', 'smrf432', 'saxenapurva96', 'enweizhang732', 'karpuz', 'flamur.mustafa', 'ilir.jasharaj', 'cemaloz745', 'ft13', 'akdemirel99', 'reepl', 'kagangunes10', 'recaro13', 'yusufsabahoglu05', 'ekim.coskun19', 'donat.aliu147', 'musa.kadiri', 'sreevidya.c', 'nazifebeqiri59', 'andreheinzig', 'midie.merovci', 'jculp', 'albin.sejdiu', 'kfullen', 'yaohuichen', 'maan1742180', 'jmcveigh55', 'ducka.agata', 'jfmuller', 'kav68', 'klintiponari6', 'akshatpokharna7', 'ertugrul4101160', 'serhatiseri', '1jordanschwartz', 'njomza.ismaili', 'salem2', 'rita.kastrati', 'szerefa', 'hary765', 'dkorakakis', 'domagoj.tomic', 'elton.kaqiu', 'samuelnxr', 'do356', 'mas2565', 'njomza.rexhepi3', 'lislimani', 'fabio.telesca', 'adonis.xhemajli', 'ml3566', 'koushik.cc', 'hanhdp99', 'pan_1238', 'barbana.heta', 'erblina2berisha', 's.kasamatsu', 'sug20171516', 'sgu20171546', 'laxman_18110093', 'solarwing', 'ben3862', 'artine.hoxha', 'florian.halimi1', 'acastro34', 'julinda.nasufi', 'canhuseyinnn', 'blerona.emini', 'patelba', 'ghosh_payel', 'zs2495', 'alpayy98', 'petrini', 'valeza.grainca', 'lendrit.ibrahimi', 'fraser_darling', 'tcp47', 'doruntina.hoti', 'mra4020', 'burghoornniels', 'bernhardhaas55', 'qahoang', 'cristianololipops56', 'kianamon', 'ozcanguclu', 'clinlin9264', 'medinehajredini', 'davidosmanovic', 'bleon.alimi', 'andi.dika', 'bdn2113', 'emreyilmazel1996', 'taol190799', 'sgu20171596', 'blerand.mjeku', 'emircansimsek', 'beskisehir', 'lado.filipovic', 'sara.haliti', 'jcjohnson', 'ora', 'cansecgin', 'cspiner', 'edgarm120397', 'lauragashi', 'sd226', 'hadesantiago17', 'sakshi17jagtap', 'kv0001', 'aecarter', 'christianc2', 'nrcnaltinbas', 'scullyer16', 'lindkrasniqi', 'indyfisico', 'jpalko20', 'madharmes', 'erdonakrasniqi', 'bksharpe2021', 'gollner.laura', 'beni1', 'junchong10', 'lowen12', 'loreta.pajaziti1', 'yasinzgen']",183,"['ardaulusan_14', 'espejodaniel6', 'liresaferizaj', 'verone.krasniqi', 'gjb56', 'artin.sermaxhaj', 'kastriotsalihu', 'edmondovalvo28', 'vmike0426', 'gentihyseni11', 'lookatfuture09', 'theharshit', 'keremino', 'mf3256', 'enkele', 'liviajanicew', 'kursatmutlu03', 'twcross11', 'kacp3r', 'jonathancollins55', 'kevinh88', 'tlsmarshall1', 'baczas996', 'jbertocc', 'rfneed', 'aleksandardunjic1999', 'bardha.januzi', 'fdirisaglik', 'jedelkind', 'hjhj8794', 'barbanataraheta', 'elona.rashica', 'jlanzoni18', 'jaylenwang', 'jasmina.rozek', 'atkncvkkl1', 'elona.gervalla', 'alberianatofaj', 'flamur', 'albina.ahmeti', 'albion', 'fidanhoxha', 'czes', 'nicolech73', 'redon.tahiri', 'dhilanr', 'lockbox30', 'sgu20171552', 'hanife', 'elsaa', 'bayramdonmez96', 'cmunoz', 'enes.hasani', 'arnavsrivastava', 'ph33', 'smrf432', 'saxenapurva96', 'enweizhang732', 'karpuz', 'flamur.mustafa', 'ilir.jasharaj', 'cemaloz745', 'ft13', 'akdemirel99', 'reepl', 'kagangunes10', 'recaro13', 'yusufsabahoglu05', 'ekim.coskun19', 'donat.aliu147', 'musa.kadiri', 'sreevidya.c', 'nazifebeqiri59', 'andreheinzig', 'midie.merovci', 'jculp', 'albin.sejdiu', 'kfullen', 'yaohuichen', 'maan1742180', 'jmcveigh55', 'ducka.agata', 'jfmuller', 'kav68', 'klintiponari6', 'akshatpokharna7', 'ertugrul4101160', 'serhatiseri', '1jordanschwartz', 'njomza.ismaili', 'salem2', 'rita.kastrati', 'yellowturtle', 'szerefa', 'hary765', 'dkorakakis', 'domagoj.tomic', 'elton.kaqiu', 'samuelnxr', 'do356', 'mas2565', 'njomza.rexhepi3', 'lislimani', 'fabio.telesca', 'adonis.xhemajli', 'ml3566', 'koushik.cc', 'hanhdp99', 'pan_1238', 'yasinzgen', 'barbana.heta', 'erblina2berisha', 's.kasamatsu', 'sug20171516', 'sgu20171546', 'krzysztof.golyga', 'laxman_18110093', 'solarwing', 'ben3862', 'artine.hoxha', 'florian.halimi1', 'acastro34', 'julinda.nasufi', 'canhuseyinnn', 'blerona.emini', 'patelba', 'ghosh_payel', 'zs2495', 'alpayy98', 'petrini', 'valeza.grainca', 'lendrit.ibrahimi', 'fraser_darling', 'tcp47', 'doruntina.hoti', 'mra4020', 'pospiechjoanna', 'burghoornniels', 'bernhardhaas55', 'qahoang', 'cristianololipops56', 'kianamon', 'ozcanguclu', 'clinlin9264', 'medinehajredini', 'davidosmanovic', 'bleon.alimi', 'andi.dika', 'bdn2113', 'emreyilmazel1996', 'taol190799', 'sgu20171596', 'blerand.mjeku', 'emircansimsek', 'beskisehir', 'lado.filipovic', 'sara.haliti', 'jcjohnson', 'ora', 'cansecgin', 'cspiner', 'piter15710', 'edgarm120397', 'lauragashi', 'sd226', 'sakshi17jagtap', 'kv0001', 'aecarter', 'christianc2', 'nrcnaltinbas', 'scullyer16', 'lindkrasniqi', 'indyfisico', 'jpalko20', 'madharmes', 'erdonakrasniqi', 'bksharpe2021', 'gollner.laura', 'beni1', 'junchong10', 'lowen12', 'loreta.pajaziti1', 'hadesantiago17']"
138,493,8,19,4,"['piter15710', 'pospiechjoanna', 'krzysztof.golyga', 'jasmina.rozek']",3,"['baczas996', 'czes', 'yellowturtle']",15,"['julka97', 'paulina.rudzinska.99', None, 'ducka.agata', 'martak846', 'kpolcyn', 'dagmarakaliska', 'oliwia.b97', 'asianano', 'thebigchester', 'kuba321', 'zajaclukasz140', 'misterszycha', 'olchor', 's166102']",22,"['piter15710', 'dagmarakaliska', 'oliwia.b97', 'yellowturtle', 'kuba321', 'olchor', 'jasmina.rozek', None, 's166102', 'julka97', 'paulina.rudzinska.99', 'ducka.agata', 'martak846', 'kpolcyn', 'asianano', 'czes', 'thebigchester', 'zajaclukasz140', 'baczas996', 'misterszycha', 'pospiechjoanna', 'krzysztof.golyga']"
138,495,8,11,3,"['pospiechjoanna', 'baczas996', 'czes']",4,"['krzysztof.golyga', 'piter15710', 'jasmina.rozek', 'yellowturtle']",8,"['sebabalt', 'krystiankoszucki', 'pirokiki', 'stefaelfi', 'szymonkrolak', 'bryckadominika', None, 'sebastian.wachowski']",15,"['piter15710', 'sebabalt', 'krystiankoszucki', 'yellowturtle', 'bryckadominika', 'jasmina.rozek', None, 'pirokiki', 'czes', 'baczas996', 'stefaelfi', 'szymonkrolak', 'pospiechjoanna', 'krzysztof.golyga', 'sebastian.wachowski']"
138,494,8,6,1,['yellowturtle'],6,"['piter15710', 'czes', 'jasmina.rozek', 'baczas996', 'pospiechjoanna', 'krzysztof.golyga']",5,"['sebabalt', 'krystiankoszucki', 'stefaelfi', 'szymonkrolak', None]",12,"['piter15710', None, 'sebabalt', 'krystiankoszucki', 'pospiechjoanna', 'czes', 'yellowturtle', 'baczas996', 'stefaelfi', 'szymonkrolak', 'jasmina.rozek', 'krzysztof.golyga']"
139,266,8,8,6,"['abdulla', 'phoenix101799', 'msayeh', 'siu853700612', 'tjemmmic', 'sajjadea']",1,['dw2020nh'],2,"[None, 'prairiegreta']",9,"['prairiegreta', 'abdulla', 'phoenix101799', 'msayeh', 'siu853700612', 'tjemmmic', 'sajjadea', None, 'dw2020nh']"
141,238,8,23,1,['cdcalahn'],6,"['valaparthi', 'lkturk17', 'bsf14', 'jcho.1260', 'bw13241324', 'jimenezaj07']",22,"['mrosetai', 'akhufstetler', 'rdemma.andy', 'stdy3c8', 'liavcueto', 'alex.oesterling', 'diegochll', 'gavro', 'lu.fogolin', 'pballentine', 'cayschuval', 'nonstopeve', 'jacknastas', 'tikagergaia', 'isabellak', 'jonsandoval229', None, 'ece230sucks', 'tendralsonofvend', 'mdensel2', '1jordanschwartz', 'shufanwen0516']",29,"['cayschuval', 'lkturk17', 'bsf14', 'nonstopeve', 'jacknastas', 'tikagergaia', 'isabellak', 'bw13241324', 'cdcalahn', 'mrosetai', 'jimenezaj07', 'jonsandoval229', None, 'akhufstetler', 'shufanwen0516', 'ece230sucks', 'valaparthi', 'tendralsonofvend', 'rdemma.andy', 'stdy3c8', 'jcho.1260', 'liavcueto', 'mdensel2', 'alex.oesterling', 'diegochll', 'gavro', 'lu.fogolin', '1jordanschwartz', 'pballentine']"
141,240,8,23,1,['cdcalahn'],6,"['valaparthi', 'lkturk17', 'bsf14', 'jcho.1260', 'bw13241324', 'jimenezaj07']",22,"['mrosetai', 'akhufstetler', 'rdemma.andy', 'stdy3c8', 'liavcueto', 'alex.oesterling', 'diegochll', 'xinyumzhang', 'gavro', 'lu.fogolin', 'pballentine', 'cayschuval', 'nonstopeve', 'jacknastas', 'tikagergaia', 'isabellak', 'jonsandoval229', None, 'tendralsonofvend', 'mdensel2', '1jordanschwartz', 'shufanwen0516']",29,"['cayschuval', 'lkturk17', 'bsf14', 'nonstopeve', 'jacknastas', 'tikagergaia', 'isabellak', 'bw13241324', 'cdcalahn', 'mrosetai', 'jimenezaj07', 'jonsandoval229', None, 'akhufstetler', 'shufanwen0516', 'valaparthi', 'tendralsonofvend', 'rdemma.andy', 'stdy3c8', 'jcho.1260', 'liavcueto', 'mdensel2', 'alex.oesterling', 'diegochll', 'xinyumzhang', 'gavro', 'lu.fogolin', '1jordanschwartz', 'pballentine']"
141,374,8,23,1,['cdcalahn'],6,"['valaparthi', 'lkturk17', 'bsf14', 'jcho.1260', 'bw13241324', 'jimenezaj07']",22,"['nwilli43', 'mrosetai', 'rdemma.andy', 'liavcueto', 'alex.oesterling', 'diegochll', 'gavro', 'lu.fogolin', 'cayschuval', 'nanoschettewi', 'nonstopeve', 'tikagergaia', 'jacknastas', 'isabellak', 'jaydoherty', 'jonsandoval229', None, 'shufanwen0516', 'mdensel2', '1jordanschwartz', 'tendralsonofvend', 'aarondfranklin']",29,"['cayschuval', 'nwilli43', 'lkturk17', 'nanoschettewi', 'bsf14', 'nonstopeve', 'tikagergaia', 'jacknastas', 'isabellak', 'jaydoherty', 'bw13241324', 'cdcalahn', 'mrosetai', 'jimenezaj07', 'jonsandoval229', None, 'shufanwen0516', 'valaparthi', 'rdemma.andy', 'jcho.1260', 'liavcueto', 'mdensel2', 'alex.oesterling', 'diegochll', 'gavro', 'lu.fogolin', '1jordanschwartz', 'tendralsonofvend', 'aarondfranklin']"
141,377,8,13,1,['valaparthi'],6,"['lkturk17', 'bsf14', 'jcho.1260', 'cdcalahn', 'bw13241324', 'jimenezaj07']",12,"['venkatesh960', 'thirupathiraomeesala5', 'ganeshpasupuleti2000', 'mansur', 'jammigunpulasrinivasarao', 'surendramadhiboyina1215', 'srujan1218', 'naveen143', 'atlapragna', 'puneeth5136', 'chennareddy', None]",19,"['lkturk17', 'ganeshpasupuleti2000', 'bsf14', 'surendramadhiboyina1215', 'atlapragna', 'bw13241324', 'cdcalahn', 'puneeth5136', 'jimenezaj07', 'chennareddy', None, 'venkatesh960', 'valaparthi', 'thirupathiraomeesala5', 'mansur', 'jammigunpulasrinivasarao', 'jcho.1260', 'srujan1218', 'naveen143']"
145,488,8,9,6,"['talalahmed', 'jordymach', 'rasdb', 'aaryal', 'gcolacion', 'joechen1996']",1,['mingyang'],3,"['vitany', None, 'shaho007']",10,"['vitany', 'jordymach', 'mingyang', None, 'shaho007', 'talalahmed', 'rasdb', 'aaryal', 'gcolacion', 'joechen1996']"
145,486,8,7,4,"['mingyang', 'aaryal', 'gcolacion', 'joechen1996']",3,"['rasdb', 'jordymach', 'talalahmed']",3,"['shakiba.sadeghi', 'vitany', None]",10,"['vitany', 'talalahmed', 'jordymach', 'shakiba.sadeghi', 'mingyang', 'rasdb', 'aaryal', None, 'gcolacion', 'joechen1996']"
145,487,8,7,5,"['talalahmed', 'jordymach', 'mingyang', 'rasdb', 'joechen1996']",2,"['aaryal', 'gcolacion']",2,"['vitany', None]",9,"['vitany', 'talalahmed', 'jordymach', 'mingyang', 'rasdb', 'aaryal', None, 'gcolacion', 'joechen1996']"
145,334,8,6,3,"['mingyang', 'gcolacion', 'joechen1996']",4,"['rasdb', 'jordymach', 'aaryal', 'talalahmed']",3,"['shakiba.sadeghi', 'vitany', None]",10,"['vitany', 'talalahmed', 'jordymach', 'shakiba.sadeghi', 'mingyang', 'rasdb', 'aaryal', None, 'gcolacion', 'joechen1996']"
147,345,8,74,6,"['endrit.kuleta', 'lirone.bytyci', 'diare.daqi', 'andi.hasanaj', 'learta.haliti', 'flamurmustafa']",1,['lcontreb'],68,"['blerim.makiqi', 'verone.krasniqi', 'rita.kastrati', 'artin.sermaxhaj', 'kastriotsalihu', 'elton.kaqiu', 'gentihyseni11', 'njomza.rexhepi3', 'lislimani', 'donat', 'enkele', 'vlere.tahiri', 'adonis.xhemajli', 'armir.qurdina', 'albina.maloku1', 'barbana.heta', 'erblina2berisha', 'arlinda.berisha', 'florian.halimi1', 'julinda.nasufi', 'bardha.januzi', 'blerona.emini', 'blerina.haziri', 'durim.polloshka2', 'barbanataraheta', 'elona.rashica', 'djellza.bicaj', 'alberianatofaj', 'elona.gervalla', 'flamur', 'valeza.grainca', 'lendrit.ibrahimi', 'albina.ahmeti', 'kadrije.simnica', 'albion', 'fidanhoxha', 'doruntina.hoti', 'redon.tahiri', 'elsaa', 'medinehajredini', 'andi.dika', 'bleon.alimi', 'enes.hasani', 'flamur.mustafa', 'blerand.mjeku', 'ilir.jasharaj', 'elmedina.sadiku', 'sara.haliti', 'ora', 'albin.keqmezi', 'donat.aliu147', 'lauragashi', 'musa.kadiri', 'nazifebeqiri59', 'bleona.curri', 'gentrim.canolli', 'midie.merovci', 'avdullahmaloku1', 'albin.sejdiu', None, 'lindkrasniqi', 'nida.islami26', 'klintiponari6', 'erdonakrasniqi', 'beni1', 'bleon.misini', 'loreta.pajaziti1', 'njomza.ismaili']",75,"['blerim.makiqi', 'verone.krasniqi', 'rita.kastrati', 'artin.sermaxhaj', 'lcontreb', 'kastriotsalihu', 'elton.kaqiu', 'gentihyseni11', 'njomza.rexhepi3', 'lislimani', 'donat', 'enkele', 'vlere.tahiri', 'adonis.xhemajli', 'armir.qurdina', 'albina.maloku1', 'barbana.heta', 'erblina2berisha', 'arlinda.berisha', 'florian.halimi1', 'julinda.nasufi', 'bardha.januzi', 'blerona.emini', 'diare.daqi', 'blerina.haziri', 'durim.polloshka2', 'barbanataraheta', 'elona.rashica', 'djellza.bicaj', 'alberianatofaj', 'elona.gervalla', 'flamur', 'valeza.grainca', 'lendrit.ibrahimi', 'albina.ahmeti', 'kadrije.simnica', 'albion', 'fidanhoxha', 'doruntina.hoti', 'redon.tahiri', 'andi.hasanaj', 'elsaa', 'medinehajredini', 'andi.dika', 'bleon.alimi', 'enes.hasani', 'learta.haliti', 'flamur.mustafa', 'blerand.mjeku', 'ilir.jasharaj', 'elmedina.sadiku', 'sara.haliti', 'ora', 'albin.keqmezi', 'donat.aliu147', 'lauragashi', 'musa.kadiri', 'endrit.kuleta', 'nazifebeqiri59', 'bleona.curri', 'gentrim.canolli', 'midie.merovci', 'avdullahmaloku1', 'albin.sejdiu', None, 'flamurmustafa', 'lindkrasniqi', 'nida.islami26', 'klintiponari6', 'lirone.bytyci', 'erdonakrasniqi', 'beni1', 'bleon.misini', 'loreta.pajaziti1', 'njomza.ismaili']"
149,98,8,18,7,"['jtian22', 'ysun98', 'xuejunli', 'jiananz', 'dsaha7', 'ssunka5', 'inandi2']",0,[],11,"['jadkin3', 'bvarug2', 'jrojas21', 'alamic2', 'jbrahm2', 'bsapko2', 'cwang261', 'memu2', 'sindh2', None, 'sunyn811']",18,"['jtian22', 'jrojas21', 'alamic2', 'jbrahm2', 'ssunka5', 'memu2', 'inandi2', None, 'sunyn811', 'jadkin3', 'bvarug2', 'ysun98', 'xuejunli', 'bsapko2', 'jiananz', 'cwang261', 'dsaha7', 'sindh2']"
149,149,8,12,6,"['jtian22', 'ysun98', 'jiananz', 'dsaha7', 'ssunka5', 'inandi2']",1,['xuejunli'],6,"['jadkin3', 'bvarug2', 'jrojas21', 'jbrahm2', 'sindh2', None]",13,"['jtian22', 'jrojas21', 'jbrahm2', 'ssunka5', 'inandi2', None, 'jadkin3', 'bvarug2', 'ysun98', 'xuejunli', 'jiananz', 'dsaha7', 'sindh2']"
149,99,8,10,5,"['ysun98', 'jiananz', 'dsaha7', 'ssunka5', 'inandi2']",2,"['xuejunli', 'jtian22']",5,"['jadkin3', 'bvarug2', 'jrojas21', 'sindh2', None]",12,"['jtian22', 'jrojas21', 'ssunka5', 'inandi2', None, 'jadkin3', 'bvarug2', 'ysun98', 'xuejunli', 'jiananz', 'dsaha7', 'sindh2']"
149,145,8,10,6,"['jtian22', 'ysun98', 'xuejunli', 'dsaha7', 'ssunka5', 'inandi2']",1,['jiananz'],4,"['sindh2', 'jadkin3', 'jrojas21', None]",11,"['jtian22', 'jrojas21', 'ssunka5', 'inandi2', None, 'jadkin3', 'ysun98', 'xuejunli', 'jiananz', 'dsaha7', 'sindh2']"
149,147,8,10,3,"['jtian22', 'xuejunli', 'ysun98']",4,"['dsaha7', 'ssunka5', 'inandi2', 'jiananz']",7,"['jadkin3', 'bvarug2', 'jrojas21', 'alamic2', 'cwang261', 'sindh2', None]",14,"['jtian22', 'jrojas21', 'alamic2', 'ssunka5', 'inandi2', None, 'jadkin3', 'bvarug2', 'ysun98', 'xuejunli', 'jiananz', 'cwang261', 'dsaha7', 'sindh2']"
149,97,8,8,5,"['xuejunli', 'jiananz', 'dsaha7', 'ssunka5', 'inandi2']",2,"['jtian22', 'ysun98']",3,"['sindh2', None, 'cwang261']",10,"['sindh2', 'ysun98', 'jtian22', 'xuejunli', 'jiananz', 'cwang261', 'dsaha7', 'ssunka5', 'inandi2', None]"
149,146,8,8,5,"['xuejunli', 'jiananz', 'dsaha7', 'ssunka5', 'inandi2']",2,"['jtian22', 'ysun98']",3,"['sindh2', None, 'cwang261']",10,"['sindh2', 'ysun98', 'jtian22', 'xuejunli', 'jiananz', 'cwang261', 'dsaha7', 'ssunka5', 'inandi2', None]"
149,150,8,6,3,"['dsaha7', 'xuejunli', 'ysun98']",4,"['ssunka5', 'inandi2', 'jiananz', 'jtian22']",3,"['sindh2', None, 'bvarug2']",10,"['sindh2', 'bvarug2', 'ysun98', 'jtian22', 'xuejunli', 'jiananz', 'dsaha7', 'ssunka5', 'inandi2', None]"
150,120,8,11,2,"['pamemolinarivera', 'dcb2398']",5,"['kristelsolerad', 'luiarrare1', 'vanni', 'ankit24soni', 'sangwonoh']",9,"['smadrigalb247', 'juanpabloramirezserrano2123', 'caro.vargasz97', 'dayana.acuna1996', 'barbozaroger31', 'adrianacorderoretana', 'yes99iqi', None, 'fabrizio.arias611']",16,"['dcb2398', 'juanpabloramirezserrano2123', 'dayana.acuna1996', 'vanni', 'pamemolinarivera', 'adrianacorderoretana', 'yes99iqi', None, 'fabrizio.arias611', 'smadrigalb247', 'caro.vargasz97', 'kristelsolerad', 'luiarrare1', 'ankit24soni', 'barbozaroger31', 'sangwonoh']"
151,368,8,26,1,['sl137'],6,"['adityabhagavathi.kandala', 'carlosnm', 'sukomolde', 'tobias.hach', 'is20mtech11002', 'didonatoandres']",25,"['weiweij', 'rl71', 'ph33', 'nsule', 're15', 'ys69', 'ft13', 'ciril', 'jl230', 'avilaalba', 'lostinsocorro', 'dk49', 'cea7', 'qpzmal7024', 'cg55', 'dtl4', 'ww40', 'rx8', None, 'hx25', 'js177', 'bds6', 'henryyang', 'natelson', 'danydet15']",32,"['weiweij', 'rl71', 'tobias.hach', 'ph33', 'nsule', 're15', 'didonatoandres', 'adityabhagavathi.kandala', 'ys69', 'ft13', 'ciril', 'sl137', 'jl230', 'avilaalba', 'lostinsocorro', 'dk49', 'cea7', 'qpzmal7024', 'carlosnm', 'cg55', 'dtl4', 'ww40', 'rx8', 'is20mtech11002', None, 'hx25', 'js177', 'bds6', 'henryyang', 'sukomolde', 'natelson', 'danydet15']"
151,339,8,12,1,['sl137'],6,"['adityabhagavathi.kandala', 'carlosnm', 'sukomolde', 'tobias.hach', 'is20mtech11002', 'didonatoandres']",11,"['ys69', 'bds6', 'cea7', 'cg55', 'dtl4', 'rl71', 'natelson', 'ph33', None, 're15', 'js177']",18,"['cea7', 'carlosnm', 'cg55', 'dtl4', 'rl71', 'tobias.hach', 'ph33', 'is20mtech11002', None, 're15', 'didonatoandres', 'js177', 'adityabhagavathi.kandala', 'ys69', 'bds6', 'sukomolde', 'natelson', 'sl137']"
151,365,8,9,3,"['adityabhagavathi.kandala', 'carlosnm', 'didonatoandres']",4,"['sl137', 'is20mtech11002', 'sukomolde', 'tobias.hach']",6,"['kumarraina619', 'nsule', 'paulatkeio', 'kumarreddy', 'sqlim94', None]",13,"['kumarraina619', 'carlosnm', 'tobias.hach', 'is20mtech11002', 'nsule', None, 'didonatoandres', 'adityabhagavathi.kandala', 'paulatkeio', 'sukomolde', 'kumarreddy', 'sl137', 'sqlim94']"
153,413,8,20,2,"['vinay.vishnani', 'shradha.bhandare']",5,"['sart05', 'manaswi.rananavare', 'lance.fernandes', 'ria_shah', 'sameep.pote']",18,"['nikhilch', 'jameel5137', 'dharmendra5146', 'chennareddym193', 'mansur', 'jammigunpulasrinivasarao', 'surendramadhiboyina1215', 'k.venu459rc', 'himavanthchitrala', 'srujan1218', 'puneeth5136', 'atlapragna', 'sakevinay953', 'sujan81', 'gkumarreddy', 'chennareddy', 'imranshaik', None]",25,"['nikhilch', 'jameel5137', 'ria_shah', 'surendramadhiboyina1215', 'k.venu459rc', 'shradha.bhandare', 'atlapragna', 'puneeth5136', 'sujan81', 'chennareddy', 'vinay.vishnani', None, 'sameep.pote', 'sart05', 'manaswi.rananavare', 'lance.fernandes', 'dharmendra5146', 'chennareddym193', 'mansur', 'jammigunpulasrinivasarao', 'himavanthchitrala', 'srujan1218', 'sakevinay953', 'gkumarreddy', 'imranshaik']"
153,498,8,10,4,"['sart05', 'ria_shah', 'vinay.vishnani', 'manaswi.rananavare']",3,"['shradha.bhandare', 'lance.fernandes', 'sameep.pote']",6,"['dhrumilparikh598', 'gausd1855', 'ishank991998', 'pooja.rathod', None, 'shruti.worlikar']",13,"['dhrumilparikh598', 'ria_shah', 'gausd1855', 'shradha.bhandare', 'ishank991998', 'pooja.rathod', 'vinay.vishnani', None, 'shruti.worlikar', 'sameep.pote', 'sart05', 'manaswi.rananavare', 'lance.fernandes']"
153,405,8,9,4,"['sart05', 'ria_shah', 'vinay.vishnani', 'manaswi.rananavare']",3,"['shradha.bhandare', 'lance.fernandes', 'sameep.pote']",5,"['dhrumilparikh598', 'gausd1855', 'pooja.rathod', None, 'shruti.worlikar']",12,"['dhrumilparikh598', 'ria_shah', 'gausd1855', 'shradha.bhandare', 'pooja.rathod', 'vinay.vishnani', None, 'shruti.worlikar', 'sameep.pote', 'sart05', 'manaswi.rananavare', 'lance.fernandes']"
153,408,8,9,1,['shradha.bhandare'],6,"['sart05', 'manaswi.rananavare', 'lance.fernandes', 'ria_shah', 'vinay.vishnani', 'sameep.pote']",8,"['vaibhavsrivastav653', 'p20vl019', 'p20vl001', 'p20vl011', '12422rahulkumar', 'kumarmanjeet614', None, 'kinakeal']",15,"['ria_shah', 'shradha.bhandare', 'p20vl011', '12422rahulkumar', 'vinay.vishnani', None, 'kinakeal', 'sameep.pote', 'sart05', 'manaswi.rananavare', 'lance.fernandes', 'vaibhavsrivastav653', 'p20vl019', 'p20vl001', 'kumarmanjeet614']"
153,412,8,8,4,"['ria_shah', 'vinay.vishnani', 'manaswi.rananavare', 'sameep.pote']",3,"['sart05', 'shradha.bhandare', 'lance.fernandes']",4,"['syworlikar', 'gausd1855', None, 'dhrumilparikh598']",11,"['sart05', None, 'manaswi.rananavare', 'lance.fernandes', 'dhrumilparikh598', 'ria_shah', 'gausd1855', 'shradha.bhandare', 'syworlikar', 'vinay.vishnani', 'sameep.pote']"
153,497,8,7,1,['vinay.vishnani'],6,"['sart05', 'manaswi.rananavare', 'lance.fernandes', 'ria_shah', 'shradha.bhandare', 'sameep.pote']",6,"['dhrumilparikh598', 'gausd1855', 'ishank991998', 'pooja.rathod', None, 'shruti.worlikar']",13,"['sart05', None, 'manaswi.rananavare', 'lance.fernandes', 'dhrumilparikh598', 'ria_shah', 'gausd1855', 'shradha.bhandare', 'ishank991998', 'pooja.rathod', 'vinay.vishnani', 'shruti.worlikar', 'sameep.pote']"
154,252,8,16,1,['sneha.kaushik2020'],6,"['saikrishnakanth2020', 'anju96senan96', 'anandsai462', 'rishmitha', 'lokesh916', 'krishnendubanik97']",15,"['saindane.apurva', 'pavantv', 'ssdivyadeepti', 'sreekanthnambi205', 'sumitdupate19', 'sneha9211', 'amareswar72', 'sandra.b2020', 'arijitnitaece20vlsi', 'kprudhvired', 'shalaka.bhandarkar2020', 'heenakaushik', None, 'snehakurle1995', 'nikhil.singh2020']",22,"['pavantv', 'sumitdupate19', 'sneha9211', 'shalaka.bhandarkar2020', 'sreekanthnambi205', 'heenakaushik', 'lokesh916', 'sneha.kaushik2020', None, 'sandra.b2020', 'krishnendubanik97', 'saikrishnakanth2020', 'saindane.apurva', 'ssdivyadeepti', 'amareswar72', 'anju96senan96', 'arijitnitaece20vlsi', 'kprudhvired', 'rishmitha', 'anandsai462', 'snehakurle1995', 'nikhil.singh2020']"
154,251,8,13,2,"['rishmitha', 'anandsai462']",5,"['saikrishnakanth2020', 'anju96senan96', 'lokesh916', 'sneha.kaushik2020', 'krishnendubanik97']",11,"['sreeker_tirunagari', 'sandra.pillai9', 'vuppala.bharath2020', 'amkreddy', 'manikantesh.karimikonda', 'jyothiprakash', 'avulamanojkumarreddy', 'hemasudha', None, 'sandra.b2020', 'saipavan123']",18,"['sreeker_tirunagari', 'sandra.pillai9', 'amkreddy', 'manikantesh.karimikonda', 'lokesh916', 'sneha.kaushik2020', 'sandra.b2020', None, 'krishnendubanik97', 'saikrishnakanth2020', 'vuppala.bharath2020', 'anju96senan96', 'avulamanojkumarreddy', 'rishmitha', 'hemasudha', 'anandsai462', 'jyothiprakash', 'saipavan123']"
154,265,8,9,1,['sneha.kaushik2020'],6,"['saikrishnakanth2020', 'anju96senan96', 'anandsai462', 'rishmitha', 'lokesh916', 'krishnendubanik97']",8,"['pavantv', 'ssdivyadeepti', 'sandra.b2020', 'sneha9211', 'shalaka.bhandarkar2020', None, 'snehakurle1995', 'nikhil.singh2020']",15,"['pavantv', 'sneha9211', 'shalaka.bhandarkar2020', 'lokesh916', 'sneha.kaushik2020', None, 'sandra.b2020', 'krishnendubanik97', 'saikrishnakanth2020', 'ssdivyadeepti', 'anju96senan96', 'rishmitha', 'anandsai462', 'snehakurle1995', 'nikhil.singh2020']"
159,117,7,12,2,"['bshrshahnawaz', 'ahmshakeel99']",4,"['farity', 'zmr', 'drmonaatta', 'salam171048']",10,"['mariaali8099', 'masroor4002808', 'bilaltehseen', 'frmazharp', 'salehabano.ned', 'manaljamshed', 'malik.mohdali25', 'rameesa', None, 'imtiazhira']",16,"['masroor4002808', 'bilaltehseen', 'frmazharp', 'salehabano.ned', 'salam171048', None, 'imtiazhira', 'farity', 'mariaali8099', 'drmonaatta', 'zmr', 'bshrshahnawaz', 'manaljamshed', 'malik.mohdali25', 'rameesa', 'ahmshakeel99']"
161,489,7,10,6,"['water03203', 'observer6', 'daiki', 'keisukeozeki', 'steikum', 'kurebayashi211']",0,[],4,"['youyou114514', 'imaeda', None, 'rz4921141']",10,"['water03203', 'keisukeozeki', 'kurebayashi211', 'rz4921141', None, 'youyou114514', 'observer6', 'daiki', 'imaeda', 'steikum']"
166,112,7,35,1,['naatessema'],5,"['szivanovic', 'hongt98', 'lorselgi', 'fvachon', 'dning']",34,"['nikhil.gupta', 'atorres559', 'yue_chen196', 'jmyamartinez5', 'lamalamaduck1', 'cynthiahjt', 'lonso559', 'preethiraghavan827', 'thebalconyart1st', 'jonwatkins', 'andygama', 'everettmorton5', 'sjing', 'robert.puccinelli', 'kevin_joslin', 'emre.kusakci', 'jimothy369', 'noelledavis', 'nyathescholar', 'sakshi_shah', 'cdjensen', 'pamela.george', 'jameslo319', 'kurtismb', 'ckwok3', None, 'limjianhua', 'jimin_kim', 'ari_3_1415', 'magana272', 'mmcd2523', 'efwawrzynek', 'sophia.mahfouz', 'eunkim']",40,"['nikhil.gupta', 'atorres559', 'szivanovic', 'yue_chen196', 'jmyamartinez5', 'lamalamaduck1', 'cynthiahjt', 'lonso559', 'preethiraghavan827', 'thebalconyart1st', 'jonwatkins', 'andygama', 'everettmorton5', 'sjing', 'robert.puccinelli', 'kevin_joslin', 'emre.kusakci', 'jimothy369', 'fvachon', 'noelledavis', 'nyathescholar', 'sakshi_shah', 'naatessema', 'cdjensen', 'hongt98', 'pamela.george', 'lorselgi', 'jameslo319', 'kurtismb', 'dning', 'ckwok3', None, 'limjianhua', 'jimin_kim', 'ari_3_1415', 'magana272', 'mmcd2523', 'efwawrzynek', 'sophia.mahfouz', 'eunkim']"
166,111,7,24,3,"['dning', 'lorselgi', 'naatessema']",3,"['hongt98', 'fvachon', 'szivanovic']",21,"['jdanielguzman264', 'criscams', 'srabanti', 'anguye22', 'lamarce2016', 'dm.zambrano', 'alcastaneda', 'diego.rojas1130', 'noelledavis', 'goar.ayrapetyan', 'biomemes', 'caitlincramer12', 'd0kma', 'anirbantwin', 'luisferayala', None, 'andres201719819', 'jvl2xv', 'nguerreronaranjo', 'josealejoclaro1999', 'sergioprieto.mm']",27,"['goar.ayrapetyan', 'biomemes', 'jdanielguzman264', 'criscams', 'srabanti', 'naatessema', 'szivanovic', 'hongt98', 'caitlincramer12', 'd0kma', 'anirbantwin', 'lorselgi', 'dning', 'luisferayala', None, 'anguye22', 'andres201719819', 'jvl2xv', 'lamarce2016', 'nguerreronaranjo', 'josealejoclaro1999', 'dm.zambrano', 'alcastaneda', 'fvachon', 'diego.rojas1130', 'noelledavis', 'sergioprieto.mm']"
167,242,7,17,5,"['sunyj20', 'panryan800', 'piaozhihong16', 'zexin.f', 'lixb20']",1,['nicktotw'],12,"['zhanke99k', 'brady1116', 'rongdell', 'lmt', 'hemiao1', 'gy20', 'lvsiqi227', 'weiyexin10', 'hzp271828', 'dml19', 'pukai20', None]",18,"['zhanke99k', 'rongdell', 'hemiao1', 'gy20', 'hzp271828', 'panryan800', 'piaozhihong16', None, 'nicktotw', 'sunyj20', 'brady1116', 'lmt', 'lvsiqi227', 'weiyexin10', 'dml19', 'pukai20', 'zexin.f', 'lixb20']"
167,249,7,17,5,"['nicktotw', 'sunyj20', 'piaozhihong16', 'zexin.f', 'lixb20']",1,['panryan800'],12,"['brady1116', 'rongdell', 'lmt', 'hemiao1', 'gy20', 'lvsiqi227', 'weiyexin10', 'hzp271828', 'dml19', 'pukai20', None, 'arton']",18,"['rongdell', 'hemiao1', 'gy20', 'hzp271828', 'panryan800', 'piaozhihong16', None, 'nicktotw', 'sunyj20', 'arton', 'brady1116', 'lmt', 'lvsiqi227', 'weiyexin10', 'dml19', 'pukai20', 'zexin.f', 'lixb20']"
167,263,7,17,4,"['zexin.f', 'sunyj20', 'lixb20', 'piaozhihong16']",2,"['panryan800', 'nicktotw']",13,"['zhanke99k', 'brady1116', 'rongdell', 'lmt', 'hemiao1', 'gy20', 'lvsiqi227', 'dml19', 'pukai20', 'chao.w', 'xinkang', None, 'arton']",19,"['zhanke99k', 'rongdell', 'hemiao1', 'gy20', 'panryan800', 'piaozhihong16', None, 'nicktotw', 'sunyj20', 'arton', 'brady1116', 'lmt', 'lvsiqi227', 'dml19', 'pukai20', 'chao.w', 'zexin.f', 'xinkang', 'lixb20']"
167,236,7,13,4,"['zexin.f', 'sunyj20', 'lixb20', 'piaozhihong16']",2,"['panryan800', 'nicktotw']",9,"['brady1116', 'rongdell', 'lmt', 'gy20', 'hzp271828', 'chao.w', 'xinkang', None, 'arton']",15,"['rongdell', 'gy20', 'hzp271828', 'panryan800', 'piaozhihong16', None, 'nicktotw', 'sunyj20', 'arton', 'brady1116', 'lmt', 'chao.w', 'xinkang', 'zexin.f', 'lixb20']"
167,243,7,8,3,"['zexin.f', 'sunyj20', 'piaozhihong16']",3,"['panryan800', 'nicktotw', 'lixb20']",5,"['brady1116', 'lvsiqi227', 'weiyexin10', 'gy20', None]",11,"['nicktotw', 'sunyj20', 'brady1116', 'lvsiqi227', 'weiyexin10', 'gy20', 'panryan800', 'piaozhihong16', 'zexin.f', None, 'lixb20']"
172,117,7,12,1,['malik.mohdali25'],5,"['jdylansmith', 'armanyaghouti', 'miguelpanizolaiz', 'm.modabberan', 'nanonano12']",11,"['mariaali8099', 'masroor4002808', 'bilaltehseen', 'frmazharp', 'salehabano.ned', 'manaljamshed', 'bshrshahnawaz', 'rameesa', 'ahmshakeel99', None, 'imtiazhira']",17,"['masroor4002808', 'bilaltehseen', 'jdylansmith', 'frmazharp', 'salehabano.ned', 'armanyaghouti', 'm.modabberan', None, 'imtiazhira', 'mariaali8099', 'miguelpanizolaiz', 'nanonano12', 'manaljamshed', 'bshrshahnawaz', 'malik.mohdali25', 'rameesa', 'ahmshakeel99']"
174,119,7,11,4,"['yes99iqi', 'caro.vargasz97', 'adrianacorderoretana', 'dayana.acuna1996']",2,"['nikjo504', 'wibapor626']",7,"['smadrigalb247', None, 'juanpabloramirezserrano2123', 'mofdz', 'danrodmar10', 'barbozaroger31', 'carla.gomezquiros']",13,"['nikjo504', 'wibapor626', 'juanpabloramirezserrano2123', 'dayana.acuna1996', 'danrodmar10', 'adrianacorderoretana', 'yes99iqi', 'carla.gomezquiros', None, 'smadrigalb247', 'caro.vargasz97', 'mofdz', 'barbozaroger31']"
174,120,7,11,4,"['yes99iqi', 'caro.vargasz97', 'adrianacorderoretana', 'dayana.acuna1996']",2,"['nikjo504', 'wibapor626']",7,"['smadrigalb247', 'juanpabloramirezserrano2123', 'dcb2398', 'pamemolinarivera', 'barbozaroger31', None, 'fabrizio.arias611']",13,"['nikjo504', 'wibapor626', 'juanpabloramirezserrano2123', 'dcb2398', 'dayana.acuna1996', 'pamemolinarivera', 'adrianacorderoretana', 'yes99iqi', None, 'fabrizio.arias611', 'smadrigalb247', 'caro.vargasz97', 'barbozaroger31']"
175,76,7,21,1,['fareedadeda31'],5,"['ariel110', 'shakilahmedaiubeeemba', 'mohammad.ullah09', 'ankushchunn', 'rupeshdutta']",20,"['nouramin2000', 'ahmedhegazyy', 'gengergogo', 'moodyhatem2015', 'mariamhanyw99', 'ammaralaa516', 'ahmed.mohie7', 'mohamedeslam22.me', 'amr171', 'youssef2042000', 'nadaeleish', 'ehabk137', 'abdelrahman99', 'habibafoudah', 'omarrsamerr', 'zeyadelghaly', None, 'mazenkhaled123456789', 'hanaamr2000.hanaamr', 'rahmaahmeed4']",26,"['fareedadeda31', 'abdelrahman99', 'nouramin2000', 'ariel110', 'habibafoudah', 'shakilahmedaiubeeemba', 'ahmedhegazyy', 'omarrsamerr', 'gengergogo', 'moodyhatem2015', 'zeyadelghaly', 'mariamhanyw99', 'ammaralaa516', 'rupeshdutta', None, 'ahmed.mohie7', 'mohamedeslam22.me', 'mazenkhaled123456789', 'mohammad.ullah09', 'amr171', 'ankushchunn', 'youssef2042000', 'hanaamr2000.hanaamr', 'rahmaahmeed4', 'nadaeleish', 'ehabk137']"
176,173,7,22,4,"['princetheverlastin', 'rahulgahlot', 'bharatp', 'bsai2048']",2,"['edwinedg96', 'chrisp']",18,"['princecyril', 'yzw994', 'sindhureddy', 'cesil', 'mohammada', 'linran', 'patels10', 'yuzhang', 'lokeshbabut', 'xjq2267200611', 'yiyang3', 'bharatpulaparthi', 'nmthakkar', 'junqianx', 'paleyv', None, 'jiaweiguo', 'vishak']",24,"['edwinedg96', 'princetheverlastin', 'yzw994', 'yuzhang', 'yiyang3', 'bsai2048', 'nmthakkar', 'rahulgahlot', None, 'vishak', 'princecyril', 'sindhureddy', 'cesil', 'mohammada', 'patels10', 'bharatp', 'chrisp', 'xjq2267200611', 'lokeshbabut', 'bharatpulaparthi', 'junqianx', 'paleyv', 'jiaweiguo', 'linran']"
180,124,6,39,4,"['rstallin', 'rdilauro', 'kshimanuki', 'hughfordyce']",1,['shaneglasser'],35,"['elijahellison3', 'ro3t3ch', 'maxjorgenson', 'rdcurtis20', 'cesokol', 'jacksonhilton', 'larsmatthys', 'mgwong132', 'mbkivy', 'tloutfi', 'mgovers', 'nickamarasinghe', 'rebeccawinger', 'calebhall27', 'lfhunter', 'jacobreed', 'kwang02', 'tvaughn27', 'mitchellschrader', 'faithann2020', 'harrisonvdw', 'gavinschmidtke', 'jyang120', 'ejg70', 'ckrawczy', 'meverson', 'mfriend', 'muwafaq09', 'camdengallen', 'marcushawley', None, 'jacksonfradd', 'mbholland', 'lornstil', 'caiustoygrace']",40,"['elijahellison3', 'ro3t3ch', 'maxjorgenson', 'rdcurtis20', 'cesokol', 'jacksonhilton', 'larsmatthys', 'mgwong132', 'mbkivy', 'tloutfi', 'mgovers', 'rstallin', 'rdilauro', 'nickamarasinghe', 'rebeccawinger', 'calebhall27', 'lfhunter', 'jacobreed', 'kwang02', 'tvaughn27', 'mitchellschrader', 'faithann2020', 'harrisonvdw', 'gavinschmidtke', 'jyang120', 'kshimanuki', 'ejg70', 'ckrawczy', 'meverson', 'mfriend', 'muwafaq09', 'camdengallen', 'shaneglasser', 'marcushawley', None, 'jacksonfradd', 'mbholland', 'lornstil', 'caiustoygrace', 'hughfordyce']"
180,492,6,7,4,"['rstallin', 'rdilauro', 'kshimanuki', 'hughfordyce']",1,['shaneglasser'],3,"['jacobreed', 'mbkivy', None]",8,"['shaneglasser', 'rstallin', 'rdilauro', 'kshimanuki', 'jacobreed', 'mbkivy', None, 'hughfordyce']"
181,182,6,33,1,['vdharman'],4,"['liturbur', 'mill1914', 'ssaradhi', 'ajclazarus88']",32,"['jwichlin', 'xils2009', 'strachan', 'peoplesj', 'seo71', 'xiong49', 'olson171', 'adandeka', 'fixa', 'cpiepen', 'hua49', 'hanweizhou', 'caduartec', 'mpollar', 'jschirck', 'mcclurez', 'dfarache', 'rplotner', 'balasub9', 'aguyre', 'rojas23', 'ericks44', 'gekco', None, 'csaerome', 'mfarnell', 'dsdubbel', 'marisol', 'park1267', 'rgeorgi', 'garret28', 'jiang556']",37,"['jwichlin', 'xils2009', 'strachan', 'liturbur', 'peoplesj', 'mill1914', 'seo71', 'xiong49', 'olson171', 'ajclazarus88', 'adandeka', 'fixa', 'cpiepen', 'hua49', 'hanweizhou', 'caduartec', 'mpollar', 'jschirck', 'mcclurez', 'dfarache', 'rplotner', 'balasub9', 'aguyre', 'rojas23', 'ericks44', 'ssaradhi', 'vdharman', 'gekco', None, 'csaerome', 'mfarnell', 'dsdubbel', 'marisol', 'park1267', 'rgeorgi', 'garret28', 'jiang556']"
187,24,6,20,1,['selcukvatansever05'],4,"['umutcan447', 'samimorsoglu', 'byzayh13', 'kaankaankaan']",19,"['atknncvkkl', 'eminakdemir93', 'veyseleee123', 'ekicifatih0', 'muvafikmelikkaya', 'emrecitakk', 'mrgiraffe', 'cbortlek', 'testeremre70', 'afkali.120', 'sflt317', 'ardasavas6', 'utkubala63', None, 'karabayemre10', 'garfon61', 'koningmehmet', 'ronmesdofb', 'alex10']",24,"['cbortlek', 'atknncvkkl', 'testeremre70', 'eminakdemir93', 'afkali.120', 'veyseleee123', 'sflt317', 'ardasavas6', None, 'selcukvatansever05', 'karabayemre10', 'utkubala63', 'samimorsoglu', 'ekicifatih0', 'byzayh13', 'garfon61', 'muvafikmelikkaya', 'koningmehmet', 'ronmesdofb', 'umutcan447', 'kaankaankaan', 'emrecitakk', 'alex10', 'mrgiraffe']"
187,26,6,15,2,"['samimorsoglu', 'byzayh13']",3,"['umutcan447', 'selcukvatansever05', 'kaankaankaan']",13,"['yilmaazmert', 'uzunnurdan', 'erhan26uzun', 'enesqwe', 'esraboran71', 'furkan069906', 'mseyfullahcelik', 'ozanemreercan', 'serhatiseri', 'yamakonurcan', None, 'salcaburak', 'fatihakyurek26']",18,"['erhan26uzun', 'ozanemreercan', 'yamakonurcan', None, 'selcukvatansever05', 'salcaburak', 'fatihakyurek26', 'uzunnurdan', 'yilmaazmert', 'samimorsoglu', 'byzayh13', 'enesqwe', 'esraboran71', 'furkan069906', 'mseyfullahcelik', 'umutcan447', 'kaankaankaan', 'serhatiseri']"
187,548,6,9,2,"['samimorsoglu', 'byzayh13']",3,"['umutcan447', 'selcukvatansever05', 'kaankaankaan']",7,"['sd226', None, 'mseyfullahcelik', 'yavuzselimeskicumali', 'aydoganaali19', 'mertisleyen96', 'oneyyemre']",12,"['sd226', 'samimorsoglu', None, 'byzayh13', 'mseyfullahcelik', 'umutcan447', 'kaankaankaan', 'yavuzselimeskicumali', 'aydoganaali19', 'selcukvatansever05', 'mertisleyen96', 'oneyyemre']"
187,550,6,9,1,['byzayh13'],4,"['umutcan447', 'samimorsoglu', 'selcukvatansever05', 'kaankaankaan']",8,"[None, 'metobomm', '86kemal86', 'dsevvaldogann', 'tugbakoyuncu99', 'mumi1478', 'mrgiraffe', 'dumpnit']",13,"[None, 'samimorsoglu', 'byzayh13', 'metobomm', '86kemal86', 'dsevvaldogann', 'umutcan447', 'tugbakoyuncu99', 'kaankaankaan', 'mumi1478', 'mrgiraffe', 'dumpnit', 'selcukvatansever05']"
191,48,6,14,3,"['brunaeloisa', 'rosiivaldo', 'rodrigoluna1']",2,"['natalia.rafaele', 'andrelfv']",11,"['dariogui', 'eduardaamaral30', 'marcelo.rodrigues', 'victorfidelis', 'ricardqueiroz', 'antoniopml', 'yurimdias', 'marcelobr07', 'diomadson', 'sidney.hca', None]",16,"['dariogui', 'marcelo.rodrigues', 'eduardaamaral30', 'brunaeloisa', 'marcelobr07', 'diomadson', None, 'natalia.rafaele', 'rosiivaldo', 'victorfidelis', 'ricardqueiroz', 'antoniopml', 'rodrigoluna1', 'yurimdias', 'sidney.hca', 'andrelfv']"
191,60,6,7,1,['rodrigoluna1'],4,"['brunaeloisa', 'natalia.rafaele', 'rosiivaldo', 'andrelfv']",6,"['dariogui', 'victorfidelis', 'ricardqueiroz', 'danielsousaflor2014', 'sidney.hca', None]",11,"['natalia.rafaele', None, 'dariogui', 'rosiivaldo', 'victorfidelis', 'ricardqueiroz', 'danielsousaflor2014', 'brunaeloisa', 'rodrigoluna1', 'sidney.hca', 'andrelfv']"
191,126,6,7,2,"['brunaeloisa', 'rodrigoluna1']",3,"['andrelfv', 'natalia.rafaele', 'rosiivaldo']",5,"['ricardqueiroz', 'fllaviinhox', 'sidney.hca', None, 'ppandrade']",10,"['natalia.rafaele', None, 'rosiivaldo', 'ricardqueiroz', 'fllaviinhox', 'brunaeloisa', 'rodrigoluna1', 'sidney.hca', 'andrelfv', 'ppandrade']"
191,315,6,6,2,"['brunaeloisa', 'rodrigoluna1']",3,"['andrelfv', 'natalia.rafaele', 'rosiivaldo']",4,"['ricardqueiroz', None, 'fllaviinhox', 'ppandrade']",9,"['natalia.rafaele', None, 'rosiivaldo', 'ricardqueiroz', 'fllaviinhox', 'brunaeloisa', 'rodrigoluna1', 'andrelfv', 'ppandrade']"
191,316,6,6,1,['rodrigoluna1'],4,"['brunaeloisa', 'natalia.rafaele', 'rosiivaldo', 'andrelfv']",5,"['dariogui', 'erikcampelo', 'ricardqueiroz', 'fllaviinhox', None]",10,"['natalia.rafaele', None, 'dariogui', 'erikcampelo', 'rosiivaldo', 'ricardqueiroz', 'fllaviinhox', 'brunaeloisa', 'rodrigoluna1', 'andrelfv']"
192,181,6,98,1,['dhoupt'],4,"['wasif.zaheer', 'rmogollo', 'sachy8', 'wang4668']",97,"['mademoiselle0812', 'psalek', 'federicozappaterra', 'kdille', 'ryan103', 'seo71', 'ziyang', 'fixa', 'hvr', 'choyc', 'paulsonj', 'desai61', 'jwat', 'esalata', 'rapplet', 'trezitorul', 'alotaibi', 'zrhan', 'hamastahir19', 'pravi', 'mcclurez', 'wang4084', 'jverduzc', 'fansler', 'mistry7', 'ggrechis', 'odonne33', 'dfarache', 'bhatt16', 'chientzulin', 'maciasi', 'dhalbroo', 'cwishard', 'jeffkayser', 'nyudewit', 'asatput', 'sharm316', 'mfarnell', 'mrouleau', 'dsdubbel', 'zchang', 'hnowak', 'park1267', 'aharroun', 'maldonl', 'ctrautma', 'cwalchle', 'hguangshuai', 'jiang556', 'qu34', 'wsenior', 'hong263', 'jwichlin', 'xils2009', 'strachan', 'chris167', 'alafzi', 'abaniiss', 'dely', 'naik26', 'olson171', 'ahads', 'mnoftz1157', 'venkat_pulletikurthi', 'arebassa', 'jwaimin', 'hua49', 'yadav35', 'hanweizhou', 'hess35', 'sbachawa', 'rangarohit.s', 'psonalka', 'cemegoak', 'xiaoli94', 'jaweibel', 'faltens', 'shah484', 'aprahara', 'black161', 'rojas23', 'haejik', 'ren102', None, 'csaerome', 'ferdoush', 'marisol', 'morisett', 'buchanaw', 'herna522', 'oerturk', 'rgeorgi', 'nmsnodgr', 'kim3247', 'sail', 'ssudhak', 'phill342']",102,"['mademoiselle0812', 'psalek', 'federicozappaterra', 'kdille', 'ryan103', 'seo71', 'ziyang', 'fixa', 'hvr', 'choyc', 'paulsonj', 'desai61', 'jwat', 'wang4668', 'esalata', 'rapplet', 'trezitorul', 'sachy8', 'alotaibi', 'zrhan', 'hamastahir19', 'pravi', 'mcclurez', 'wang4084', 'jverduzc', 'fansler', 'mistry7', 'ggrechis', 'odonne33', 'dfarache', 'bhatt16', 'chientzulin', 'maciasi', 'dhalbroo', 'cwishard', 'jeffkayser', 'nyudewit', 'asatput', 'sharm316', 'mfarnell', 'mrouleau', 'dsdubbel', 'zchang', 'hnowak', 'park1267', 'aharroun', 'maldonl', 'ctrautma', 'cwalchle', 'hguangshuai', 'jiang556', 'qu34', 'wsenior', 'hong263', 'jwichlin', 'rmogollo', 'xils2009', 'strachan', 'chris167', 'alafzi', 'abaniiss', 'dely', 'naik26', 'olson171', 'ahads', 'mnoftz1157', 'venkat_pulletikurthi', 'arebassa', 'jwaimin', 'hua49', 'yadav35', 'hanweizhou', 'hess35', 'sbachawa', 'rangarohit.s', 'psonalka', 'cemegoak', 'xiaoli94', 'jaweibel', 'faltens', 'shah484', 'aprahara', 'black161', 'rojas23', 'haejik', 'ren102', 'dhoupt', None, 'csaerome', 'ferdoush', 'marisol', 'morisett', 'buchanaw', 'herna522', 'oerturk', 'rgeorgi', 'nmsnodgr', 'kim3247', 'sail', 'ssudhak', 'phill342', 'wasif.zaheer']"
196,397,6,72,1,['s159813'],4,"['maateusz.jankowski', 'bpaulinaanna', 'kanies5497', 'dagmarakaliska']",71,"['salem2', 'medoshaban816', 'cmc2374', 'edwardmirkin', 'heshamelsedfy111', 'amr.m.araby', 'btngana1', 'andrea_russo90', 'martyna.bladosz97', 'zazotop31', 'mohamed_2116', 'michaelhelal99', 'marvel', 'transalper', 'fied0029', 'rafal123', 'kumarraina619', 'ahmedramadan', 'kareemk08', 'pzanasi', 'jendryka.j', 'harvovich', 'm.zhu', 's154641', 'bryckadominika', 'jatin97', 'e.steinebronn', 'jhh2197', 'deepika07', 'romanynashaatmakeen', 'pirokiki', 'josephwilliams11', 'manny', 'lampy84', 'misterszycha', 'sebastian.wachowski', 'mohameda.younis80', 'ahmedsaeed', 'sprawozdaniezlabow', 'lockbox30', 'cristianololipops56', 'krystiankoszucki', 'sebabalt', 'haripriya', 'jts2176', 'woj_25', 'johnlanghout', 'thebigchester', 'kaka1341', 'zajaclukasz140', 'amilkovicz', 'saca', 'stefaelfi', 'mernaeshakfaheem', 'olchor', 'mohamedsalah2', 'myousef42', 'tezaagnieszka', 'ahmedokasha1999', 'abdooo', 'kuba321', 'gharrison78', 'rektxz', None, 'indyfisico', 'merhuem', 'martak846', 'kpolcyn', 'anna2222', 'narndt', 'ch3401']",76,"['salem2', 'medoshaban816', 'cmc2374', 'edwardmirkin', 'heshamelsedfy111', 'amr.m.araby', 'btngana1', 'andrea_russo90', 'martyna.bladosz97', 'zazotop31', 'mohamed_2116', 'michaelhelal99', 'marvel', 'transalper', 'fied0029', 'rafal123', 'kumarraina619', 'ahmedramadan', 'kareemk08', 'pzanasi', 'jendryka.j', 'harvovich', 'm.zhu', 's154641', 'bryckadominika', 'jatin97', 'e.steinebronn', 's159813', 'jhh2197', 'deepika07', 'romanynashaatmakeen', 'pirokiki', 'josephwilliams11', 'manny', 'lampy84', 'misterszycha', 'kanies5497', 'sebastian.wachowski', 'mohameda.younis80', 'ahmedsaeed', 'sprawozdaniezlabow', 'bpaulinaanna', 'lockbox30', 'cristianololipops56', 'krystiankoszucki', 'sebabalt', 'dagmarakaliska', 'haripriya', 'jts2176', 'woj_25', 'johnlanghout', 'maateusz.jankowski', 'thebigchester', 'kaka1341', 'zajaclukasz140', 'amilkovicz', 'saca', 'stefaelfi', 'mernaeshakfaheem', 'olchor', 'mohamedsalah2', 'myousef42', 'tezaagnieszka', 'ahmedokasha1999', 'abdooo', 'kuba321', 'gharrison78', 'rektxz', None, 'indyfisico', 'merhuem', 'martak846', 'kpolcyn', 'anna2222', 'narndt', 'ch3401']"
196,493,6,19,1,['dagmarakaliska'],4,"['maateusz.jankowski', 'kanies5497', 'bpaulinaanna', 's159813']",18,"['julka97', 'piter15710', None, 's166102', 'paulina.rudzinska.99', 'ducka.agata', 'martak846', 'kpolcyn', 'pospiechjoanna', 'oliwia.b97', 'asianano', 'jasmina.rozek', 'thebigchester', 'kuba321', 'zajaclukasz140', 'misterszycha', 'olchor', 'krzysztof.golyga']",23,"['piter15710', 'bpaulinaanna', 'dagmarakaliska', 'oliwia.b97', 'kuba321', 'jasmina.rozek', None, 's166102', 'julka97', 'maateusz.jankowski', 's159813', 'paulina.rudzinska.99', 'ducka.agata', 'martak846', 'kpolcyn', 'pospiechjoanna', 'asianano', 'thebigchester', 'zajaclukasz140', 'misterszycha', 'kanies5497', 'olchor', 'krzysztof.golyga']"
196,354,6,11,1,['bpaulinaanna'],4,"['maateusz.jankowski', 'kanies5497', 's159813', 'dagmarakaliska']",10,"[None, 'martak846', 'sebabalt', 'krystiankoszucki', 'pirokiki', 'stefaelfi', 'szymonkrolak', 'bryckadominika', 'carrie2151', 'sebastian.wachowski']",15,"['bpaulinaanna', 'sebabalt', 'krystiankoszucki', 'dagmarakaliska', 'bryckadominika', None, 'maateusz.jankowski', 's159813', 'martak846', 'pirokiki', 'szymonkrolak', 'kanies5497', 'stefaelfi', 'carrie2151', 'sebastian.wachowski']"
196,359,6,9,2,"['maateusz.jankowski', 's159813']",3,"['dagmarakaliska', 'bpaulinaanna', 'kanies5497']",7,"['sprawozdaniezlabow', 'martyna.bladosz97', 'anna2222', 'asianano', 'amilkovicz', 's154641', None]",12,"['maateusz.jankowski', 's159813', 'sprawozdaniezlabow', 'bpaulinaanna', 'martyna.bladosz97', 'anna2222', 'dagmarakaliska', 'asianano', 'amilkovicz', 's154641', 'kanies5497', None]"
196,400,6,8,2,"['maateusz.jankowski', 's159813']",3,"['dagmarakaliska', 'bpaulinaanna', 'kanies5497']",6,"['s162368', 'studentmaria2020', 'anna2222', 'asianano', 's154641', None]",11,"['s162368', 'maateusz.jankowski', 's159813', 'studentmaria2020', 'bpaulinaanna', 'anna2222', 'dagmarakaliska', 'asianano', 's154641', 'kanies5497', None]"
199,271,6,33,1,['mohamadn'],4,"['epiergal', 'everbru', 'dmassow', 'nlieu']",32,"['ktbrode22', 'aguarner', 'lfabries', 'pike14', 'tchen135', 'chakra26', 'cdunn', 'sarawhite99', 'gdadlani', 'clancy6', 'ldefrei', 'ctorger', 'hall488', 'zosterlo', 'eklueppe', 'kkrinnin', 'mtallman', 'elutgen', 'ronny927', None, 'jayaramm', 'boston2', 'wells130', 'mpugsley', 'gotoa', 'chen2467', 'york33', 'wu1326', 'haoyangliu', 'camronn.hale', 'campb335', 'jvanwing']",37,"['epiergal', 'ktbrode22', 'aguarner', 'lfabries', 'pike14', 'tchen135', 'chakra26', 'everbru', 'cdunn', 'sarawhite99', 'gdadlani', 'clancy6', 'ldefrei', 'ctorger', 'hall488', 'zosterlo', 'mohamadn', 'eklueppe', 'kkrinnin', 'mtallman', 'elutgen', 'ronny927', None, 'jayaramm', 'boston2', 'wells130', 'mpugsley', 'gotoa', 'chen2467', 'york33', 'nlieu', 'wu1326', 'haoyangliu', 'camronn.hale', 'dmassow', 'campb335', 'jvanwing']"
199,285,6,32,3,"['epiergal', 'nlieu', 'dmassow']",2,"['mohamadn', 'everbru']",29,"['barker56', 'hartm109', 'perkintj', 'wiley29', 'pbreymey', 'selizond', 'rcerne', 'zhan2846', 'nquick', 'cdenoo', 'aalruhai', 'pickera', 'li3422', 'kerr38', 'lucas120', 'yang837', None, 'gu256', 'sboelitz', 'lopez400', 'jmacatan', 'lcaspari', 'gjensen', 'hutchi47', 'zzipf', 'reger1', 'robin498', 'iclyde', 'lucywagner']",34,"['epiergal', 'barker56', 'hartm109', 'everbru', 'perkintj', 'wiley29', 'pbreymey', 'selizond', 'rcerne', 'zhan2846', 'nquick', 'cdenoo', 'aalruhai', 'pickera', 'mohamadn', 'li3422', 'kerr38', 'lucas120', 'yang837', None, 'gu256', 'sboelitz', 'lopez400', 'jmacatan', 'lcaspari', 'gjensen', 'hutchi47', 'zzipf', 'reger1', 'robin498', 'iclyde', 'nlieu', 'lucywagner', 'dmassow']"
199,554,6,29,3,"['epiergal', 'nlieu', 'dmassow']",2,"['mohamadn', 'everbru']",26,"['pickera', 'li3422', 'kerr38', 'barker56', 'lucas120', 'hartm109', 'yang837', None, 'gu256', 'sboelitz', 'lopez400', 'jmacatan', 'lcaspari', 'perkintj', 'wiley29', 'pbreymey', 'zzipf', 'selizond', 'reger1', 'robin498', 'rcerne', 'iclyde', 'aalruhai', 'nquick', 'lucywagner', 'cdenoo']",31,"['epiergal', 'barker56', 'hartm109', 'everbru', 'perkintj', 'wiley29', 'pbreymey', 'selizond', 'rcerne', 'nquick', 'cdenoo', 'aalruhai', 'pickera', 'mohamadn', 'li3422', 'kerr38', 'lucas120', 'yang837', None, 'gu256', 'sboelitz', 'lopez400', 'jmacatan', 'lcaspari', 'zzipf', 'reger1', 'robin498', 'iclyde', 'nlieu', 'lucywagner', 'dmassow']"
199,401,6,24,3,"['epiergal', 'nlieu', 'dmassow']",2,"['mohamadn', 'everbru']",21,"['pickera', 'li3422', 'kerr38', 'barker56', 'lucas120', 'hartm109', None, 'gu256', 'sboelitz', 'lopez400', 'jmacatan', 'lcaspari', 'gjensen', 'pbreymey', 'hutchi47', 'zzipf', 'reger1', 'robin498', 'nquick', 'lucywagner', 'cdenoo']",26,"['pickera', 'epiergal', 'mohamadn', 'li3422', 'kerr38', 'barker56', 'lucas120', 'hartm109', None, 'gu256', 'sboelitz', 'lopez400', 'jmacatan', 'everbru', 'lcaspari', 'gjensen', 'pbreymey', 'hutchi47', 'zzipf', 'reger1', 'robin498', 'nlieu', 'nquick', 'lucywagner', 'dmassow', 'cdenoo']"
199,288,6,8,2,"['nlieu', 'dmassow']",3,"['epiergal', 'mohamadn', 'everbru']",6,"['pickera', 'jmacatan', 'kerr38', None, 'gu256', 'cdenoo']",11,"['pickera', 'epiergal', 'mohamadn', 'everbru', 'jmacatan', None, 'kerr38', 'nlieu', 'dmassow', 'gu256', 'cdenoo']"
199,286,6,7,2,"['mohamadn', 'everbru']",3,"['epiergal', 'nlieu', 'dmassow']",5,"['jdomasky', 'zzmola', 'elutgen', 'mullert', None]",10,"['jdomasky', 'epiergal', 'mohamadn', 'everbru', None, 'zzmola', 'nlieu', 'elutgen', 'mullert', 'dmassow']"
199,555,6,7,2,"['mohamadn', 'everbru']",3,"['epiergal', 'nlieu', 'dmassow']",5,"['jdomasky', 'zzmola', 'elutgen', 'mullert', None]",10,"['jdomasky', 'epiergal', 'mohamadn', 'everbru', None, 'zzmola', 'nlieu', 'elutgen', 'mullert', 'dmassow']"
200,40,6,172,5,"['apujara', 'anubhav.bose', 'siddhant.d', 'poonam2499', 'rutwik.patel']",0,[],167,"['chaitanyatamhankar36', 'pas2', 'ankit.ns', 'sachin9', 'mahavirchavda921', '8122vivian', 'vrushali.sule', 'rameshbabu1234', 'amol.kerkar', 'zoheb.mir', 'animesh.prasad', 'sohamshah888', 'rohan.sanghavi', 'advikmaniar', 'bhaskar.a', 'hirenkachhadiya', 'mrunali.khedkar', 'meet29', 'swapnalimakdey25', 'mehuldoshi', 'gauravpandey123', 'niketh', 'tiwarisuraj5769', 'jaypandya99', 'niharika.somani', 'arya1998', 'soham.ms', 'uttamkumar.m', 'h.bilkhu', 'r.mungekar', 'p.ambelkar', 'akshay.pathak', 'nitish.r', 'pooja.nambiar', 'aatman.mehta', 'pranav.mistry', 'm.veer', 'arpanbiswas', 'fenny.m', 'pratik.lodha', 'malhar.k', 'nirav.ls', 'sohamk45', 'pranali.nc', 'sangeetamjoshi', 'jmd', 'meheru.p', 'ishanali.k', 'devashri.n', 'antimhr', 'ankitachavan2708', 'rushabh.shah8', 'mayuresh.shirke', 'karan.ap', 'patel.prakash', 'aynaiksatam', 'aadesh.u', 'hitesh.vadgama', 'aayush.butala', 'surajr17', 'yukta.rane', 'param05', 'rishi.molia', 'vinit.js', 'hardik.hp', 'lovleshsingh99', 'amodini8295', 'divya.manikantan', 'kaushal2531999', 'aatifa.bi', 'karan.ys', 'onkarjoshi', 'pulkeet.g', 'meetudiii', 'paras14', 'pktingare23', '8284yash', None, 'pratik.lodha.pl', 'pragya.g', 'rohitrane500', 'manavj.jain', 'pritha.roy', 'aman.savla', 'zohebmir006', 'hiralmistry9', 'sunny.kanojia', 'n.sumra', 'bhavin14', 'shivani.anajria', 'anuragmandke4', 'vipulrkt', 'kartiksrivastava', 'aniket09', 'vedant.modak', 'mihir.khara', 'dhruvik.shah', 'mohil.khona', 'gauri.bane', 'khushboo.darji', 'aditi.b2409', 'ashirwad.b', 'yash.dalvi', 'utsav.maisheri', 'tejal.kadu', 'dipansh.m', 'rajveersingh.k', 'wrathgod123', 'kanojias75', 'p.hodshil', 'siddharth.vaidya', 'shraddha.bw', 'sherylcorina', 'pranavkumar.t', 'pranjal8287', 'purvi.rane', 'pradnya.koli', 'shubhammore', 'patel.ad', 'rahil.t', 'saloni.kaveri', 'anjali.golani', 'simran.mulik', 'proabdurrasheed', 'aryaman1712021', 'ayum.halwai', 'kaushal.g', 'keval23', 'rashi.singhal', 'bharatan.r', 'jaimindesai', 'chaitanya.tambat', 'dhairya.maisheri', 'gmp', 'anamay.m', 'tarun96', '8275joel', 'anilthosar', 'uttamkumarmishra76652', 'saeesh.aher', 'nibha.desai', 'kshemal_gupte', 'pranav.garg', 'jayd1529', 'harsh.vasani', 'nikhil.naredla', 'saptarshi.k', 'gauri.rp', 'iamstark9', 'sumitdupate19', 'kmmahuvarkar', 'daamini11', 'saloni_talathi', 'anirudh9911', 'xavierallem', 'c.tamhankar', 'rinkalkeniya', 'sunlovesrahul', 'panchal.vp', 'nipunshah', 'suraj.dm', 'aynkushadav0', 'tejaswini.shelar', 'pratz98', 'ankit.manani', 's.mahetaliya', 'kavya.moolya']",172,"['chaitanyatamhankar36', 'pas2', 'ankit.ns', 'sachin9', 'mahavirchavda921', '8122vivian', 'vrushali.sule', 'rameshbabu1234', 'amol.kerkar', 'zoheb.mir', 'siddhant.d', 'animesh.prasad', 'sohamshah888', 'rohan.sanghavi', 'advikmaniar', 'bhaskar.a', 'hirenkachhadiya', 'mrunali.khedkar', 'meet29', 'swapnalimakdey25', 'mehuldoshi', 'gauravpandey123', 'niketh', 'tiwarisuraj5769', 'jaypandya99', 'niharika.somani', 'arya1998', 'soham.ms', 'uttamkumar.m', 'h.bilkhu', 'r.mungekar', 'p.ambelkar', 'akshay.pathak', 'nitish.r', 'pooja.nambiar', 'aatman.mehta', 'pranav.mistry', 'm.veer', 'arpanbiswas', 'fenny.m', 'pratik.lodha', 'malhar.k', 'nirav.ls', 'sohamk45', 'pranali.nc', 'sangeetamjoshi', 'jmd', 'meheru.p', 'ishanali.k', 'devashri.n', 'antimhr', 'ankitachavan2708', 'rushabh.shah8', 'mayuresh.shirke', 'karan.ap', 'patel.prakash', 'aynaiksatam', 'aadesh.u', 'hitesh.vadgama', 'aayush.butala', 'surajr17', 'yukta.rane', 'param05', 'vinit.js', 'hardik.hp', 'lovleshsingh99', 'amodini8295', 'divya.manikantan', 'kaushal2531999', 'aatifa.bi', 'karan.ys', 'onkarjoshi', 'pulkeet.g', 'meetudiii', 'kavya.moolya', 'paras14', 'pktingare23', '8284yash', None, 'pratik.lodha.pl', 'pragya.g', 'rohitrane500', 'manavj.jain', 'pritha.roy', 'poonam2499', 'aman.savla', 'zohebmir006', 'anubhav.bose', 'hiralmistry9', 'sunny.kanojia', 'n.sumra', 'bhavin14', 'shivani.anajria', 'anuragmandke4', 'vipulrkt', 'kartiksrivastava', 'aniket09', 'vedant.modak', 'mihir.khara', 'dhruvik.shah', 'mohil.khona', 'gauri.bane', 'khushboo.darji', 'aditi.b2409', 'ashirwad.b', 'apujara', 'yash.dalvi', 'utsav.maisheri', 'tejal.kadu', 'dipansh.m', 'rajveersingh.k', 'wrathgod123', 'kanojias75', 'p.hodshil', 'siddharth.vaidya', 'shraddha.bw', 'sherylcorina', 'pranavkumar.t', 'pranjal8287', 'purvi.rane', 'pradnya.koli', 'shubhammore', 'patel.ad', 'rahil.t', 'saloni.kaveri', 'anjali.golani', 'rutwik.patel', 'simran.mulik', 'proabdurrasheed', 'aryaman1712021', 'ayum.halwai', 'kaushal.g', 'keval23', 'rashi.singhal', 'bharatan.r', 'jaimindesai', 'chaitanya.tambat', 'dhairya.maisheri', 'gmp', 'anamay.m', 'tarun96', '8275joel', 'anilthosar', 'uttamkumarmishra76652', 'saeesh.aher', 'nibha.desai', 'kshemal_gupte', 'pranav.garg', 'jayd1529', 'harsh.vasani', 'nikhil.naredla', 'saptarshi.k', 'gauri.rp', 'iamstark9', 'sumitdupate19', 'kmmahuvarkar', 'daamini11', 'saloni_talathi', 'anirudh9911', 'xavierallem', 'c.tamhankar', 'rinkalkeniya', 'sunlovesrahul', 'panchal.vp', 'nipunshah', 'suraj.dm', 'aynkushadav0', 'tejaswini.shelar', 'pratz98', 'ankit.manani', 's.mahetaliya', 'rishi.molia']"
200,164,6,69,4,"['siddhant.d', 'apujara', 'rutwik.patel', 'anubhav.bose']",1,['poonam2499'],65,"['sachin9', 'shivani.anajria', 'vipulrkt', 'amol.kerkar', 'rohan.sanghavi', 'vedant.modak', 'mihir.khara', 'bhaskar.a', 'dhruvik.shah', 'mohil.khona', 'advikmaniar', 'khushboo.darji', 'mrunali.khedkar', 'ashirwad.b', 'utsav.maisheri', 'tejal.kadu', 'gauravpandey123', 'dipansh.m', 'jaypandya99', 'soham.ms', 'p.hodshil', 'siddharth.vaidya', 'p.ambelkar', 'shraddha.bw', 'r.mungekar', 'akshay.pathak', 'purvi.rane', 'pradnya.koli', 'nitish.r', 'shubhammore', 'patel.ad', 'pooja.nambiar', 'pranav.mistry', 'proabdurrasheed', 'nirav.ls', 'ayum.halwai', 'kaushal.g', 'jmd', 'rashi.singhal', 'meheru.p', 'bharatan.r', 'ishanali.k', 'gmp', 'dhairya.maisheri', 'devashri.n', 'patel.prakash', 'aynaiksatam', 'yukta.rane', 'aayush.butala', 'surajr17', 'uttamkumarmishra76652', 'anilthosar', 'hardik.hp', 'pranav.garg', 'kaushal2531999', 'saptarshi.k', 'karan.ys', 'onkarjoshi', 'kmmahuvarkar', 'pulkeet.g', 'c.tamhankar', 'suraj.dm', None, 's.mahetaliya', 'kavya.moolya']",70,"['anubhav.bose', 'sachin9', 'shivani.anajria', 'vipulrkt', 'amol.kerkar', 'siddhant.d', 'rohan.sanghavi', 'vedant.modak', 'mihir.khara', 'bhaskar.a', 'dhruvik.shah', 'mohil.khona', 'advikmaniar', 'khushboo.darji', 'mrunali.khedkar', 'ashirwad.b', 'apujara', 'utsav.maisheri', 'tejal.kadu', 'gauravpandey123', 'dipansh.m', 'jaypandya99', 'soham.ms', 'p.hodshil', 'siddharth.vaidya', 'p.ambelkar', 'shraddha.bw', 'r.mungekar', 'akshay.pathak', 'purvi.rane', 'pradnya.koli', 'nitish.r', 'shubhammore', 'patel.ad', 'pooja.nambiar', 'pranav.mistry', 'rutwik.patel', 'proabdurrasheed', 'nirav.ls', 'ayum.halwai', 'kaushal.g', 'jmd', 'rashi.singhal', 'meheru.p', 'bharatan.r', 'ishanali.k', 'gmp', 'dhairya.maisheri', 'devashri.n', 'patel.prakash', 'aynaiksatam', 'yukta.rane', 'aayush.butala', 'surajr17', 'uttamkumarmishra76652', 'anilthosar', 'hardik.hp', 'pranav.garg', 'kaushal2531999', 'saptarshi.k', 'karan.ys', 'onkarjoshi', 'kmmahuvarkar', 'pulkeet.g', 'c.tamhankar', 'suraj.dm', None, 'poonam2499', 's.mahetaliya', 'kavya.moolya']"
200,41,6,20,2,"['siddhant.d', 'poonam2499']",3,"['apujara', 'rutwik.patel', 'anubhav.bose']",18,"['mayuresh.shirke', 'pas2', 'nikhil.naredla', 'shantanu.saraf', 'r.srivastava', 'ankit.ns', 'pranali.nc', 'patel.prakash', 'gauri.rp', 'tejal.kadu', 'suraj.dm', 'yukta.rane', 'vrushali.sule', 'siddharth.vaidya', 'panchal.vp', 'inderjitsingh', 'rushabh.shah8', None]",23,"['apujara', 'pas2', 'nikhil.naredla', 'shantanu.saraf', 'anubhav.bose', 'ankit.ns', 'pranali.nc', 'gauri.rp', 'tejal.kadu', 'vrushali.sule', 'panchal.vp', 'rushabh.shah8', 'siddharth.vaidya', None, 'suraj.dm', 'mayuresh.shirke', 'r.srivastava', 'patel.prakash', 'siddhant.d', 'poonam2499', 'yukta.rane', 'inderjitsingh', 'rutwik.patel']"
