MClusterID,XClusterID,MClusterSize,XClusterSize,OverlapSize,OverlapMembers,MOnlySize,MOnlyMembers,XOnlySize,XOnlyMembers,CombinedSize,CombinedMembers
1,32,392,70,66,"['tamchouweng', 'yeejou990318', 'redzuan11', 'adriancheah', 'arifjalani99', 'leejq', 'xunyong', 'asyrafaqil', 'rooban11', 'zikrizaki88995', 'miloaismanis', 'baleko12345', 'azizijazam11', 'anwar909', 'amni99', 'kakmeera1999', 'kie180702', 'tingliang', 'nikalyaamani', 'desmondsoon', 'musabmalek0717', 'kie180079', 'aimanadnan', 'sealseal', 'kimzihuang', 'janeneil88', 'zakhwan7', 'kie180028', 'ari6nd', 'happyleexin', 'pip29', 'hong_gao', 'yjenyiee155', 'ablahsaoud', 'abieday1704', 'kie180073', 'ahchehyan', 'nihaosawaddee', 'pingan99', 'alifzulkifli99', 'magic_ocean99', 'guoyao', 'ffazul64', 'shaf31', 'nabilah1403', 'melroy_caeiro', 'aimansyaz99', 'wahidiah52', 'khor', 'm939454', 'chengweiheng', 'cheokonn', 'yansi', 'afeefz', 'gabrielyii99', 'gabrielyii', 'abdulrahim2905', 'kie180039', 'exjamil', 'hafizmokh99', 'nadhnasorudin', 'kowjiajin', 'syedzakwan', 'harshini9962', 'kie180031', 'rahimnoorj']",326,"['miri23', 'mohamedsameh', 'reemali99_', 'gc_1', 'kerryreto', 'je_guilbert', 'jorgecastelo5', 'spazos7', 'soccadelic44', 'ahern0722', 'benoiturcotte', 'noureldin1999', 'alberfn', 'guttsfulltyagi', 'mavanzato0418', 'rkchapman', 'guibill10', 'michael2010814', 'omardeyaa', 'irenehb92', 'sandrabashara', 'nihatyavuz', 'akozych2', 'vikazvereva', 'danielfernandezcalo', 'anthonyroux', 'arrow823', 'annahaozheng0606', 'rocio', 'masonpb2', 'samashraf1', 'kirankumar94', 'prabuddha_888253127', 'carlosvigo1997', 'muvafikmelikkaya', 'amrebrahim', 'jtorres17', 'jzhan142', 'samet1231234', 'avw2', 'ahmedsameh1698', 'acn562', 'moh.bahaa', 'youssefsherif22', 'mjgebara14', 'camilolcastro97', 'bcperki2', 'ahmedayman2370', 'rishu', 'ranasherif65', 'kyang37', 'nuanno97', 'smrdafdl', 'brknshn', 'jbaggie2019', 'youssef2042000', 'olivier.gilbert.paquet', 'saipraneett', 'prakharbhargava0', 'hf4', 'nadja1', 'teoster50', 'mohaballam', 'ryanorem', 'shradhap', 'va844', 'neuroque', 'seifhabib', 'anibarseghyan', 'williammitchell5818', 'mjoza2', 'mariz', 'virajput299', 'bleuminuit', 'paul.aniruddha', 'melaniejkramer', 'oliviercharbonneau', 'ilou', 'evrenyigit', 'emilechouinard', 'pythagoras2', 'kason.carroll', 'malgaca', 'carlosvillar54', 'ckim123', 'kychui2', 'kanet1234', 'mohabayman', 'sanchjai', 'nbs691', 'oishikfaruque', 'lauragdevesa', 'nowapoca', 'ahagras13', 'akash140410107098', 'chithong', 'saharoaf', 'svo4321', 'lino13', 'vblanco.nico', 'alidsjt', 'dlee145', 'stambo', 'lauramolinosmayo', 'mateocampos', 'hamidausat', 'retty8', 'sebasket14', 'marcmagdy98', 'janalorenzolumbreras', 'marianne.gratton.1', 'trkmengkay', 'youxing0309', 'nourananwar123', 'puertarcd', 'felivitullo87', 'manuelsomoza94', 'alecorti.pardo', 'muteki', 'corredoira', 'jinsup2', 'staceyn2', 'kaitlinh', 'cbecker413', 'adam562', 'haclarke', 'xosegq16', 'e1150590', 'kalebhilde', 'jaimefookinlannister', 'tonybocadillosgrandes', 'wowmuchchuck', 'hishamzakaria20', 'rxtodd', 'sarapl', 'alimatama', 'jahnavikachhia', 'alexisdixon6', 'saegner2', 'pranjal3', 'berkaydean', 'sparshagarwal1009', 'xyz11', 'david.peral.moran', 'isabelmaria.vazquez', 'aishu98', 'nadanasser1199', 'keerthisv', 'mcruces.fz', 'tuberkargan_97', 'worldlineusaf', 'bharath3', 'cloudyoverhead', 'dhvanil', 'ramy_maged4', 'lsleed', 'zhixin2', 'sriharshap', 'tyy233', 'njs035', 'nolmos96', 'shorouk_ossama', 'kaustubh.shirpurkar', 'pedrosiaba', 'coderko3', 'alancantu57', 'baohl2', 'mengkem2', 'selena', 'tdubnansky6', 'ypp200', 'aengm', 'kartal', 'jacquelinethardin', 'mohameeddsamy', 'jipiccardi', 'amlibrahim', 'dcpang2', 'elizametias12', 'efrenhub', 'mrefaat', 'ethanmorse', 'taymacnichols', 'ryanboucher', 'kirolosehab99', 'carlosbesadaromero', 'ericrobles', 'gxiao2', 'anxovidal8', 'damlakubattt', 'andreadiazgar', 'lukunze1', 'joker632455', 'shuming2', 'j.haliburton', 'ozbunar01', 'ugur.cankaya.3718', 'sinasigurpinar', 'tuberkargan', 'jarodm2', 'amiruldanial99', 'ammaralaa516', 'juanmacano97', 'maxernest', 'marcosanllo', 'viratbhatt007', 'facundovia', 'michaelsaldana1', 'bassamtarek', 'abbesalaeddine', 'restep2', 'estebanrial', 'martinzapata', '46harunakgul', 'talwren', 'mohammedemadeldin2000', 'jeanmichael.deschenes', 'mmartinezsanchez', 'emrebuyukkose2', 'luciano.brignone', 'ahmedamr', 'omarmagdy', 'abdurrahmn13', 'sdehoyos47', 'apascao', 'yubai', 'vincentpainchaud.vp', 'nagihankececi', 'nazimmath3', 'apb5472', 'rikardberger', 'mr4425', 'jacobzeshleman', 'kiruthikaabalu181996', 'ikhbal', 'michael.mechelay', 'david_atef', 'yaseminablacandir', 'c.a.stupka', 'amparo.castro.96', 'dhodapp', 'fkl217', 'farahsamir978', 'atharva98', 'kph2', 'hilisa', 'fred_dion', 'pvalladaresfdez', 'dancastaneda', 'jn1404', 'atx203', 'ammareltalli', 'amani12345', 'aaq', 'ledicia97', 'adriangarea', 'onaam8', 'zehuahe2', 'siemprewowthechami', 'justin.lariviere.25', 'tbryan', 'ludovick.begin', 'tss3', 'david2397', 'tmi211', 'physquig', 'mallen22', 'amr_ua07', 'fcfrancapra94', 'cristinacigarran', 'vanesagarcia', 'adnanyuceer', 'fathy1104', 'perezsarmar', 'al4995', 'helenalecoq97', 'caglanlee', 'jpmcgee98', 'ales.gajdacz', 'masitadonmez', 'eddin21', 'gemma', 'hmoulvi1', 'elad.d', 'xxlilmontysignxx', 'farah26', 'latecnologiameodia', 'vickytubio', 'ozgurkablan26', 'lderemo', 'ankit6257', 'javierisma98', 'david.garrido', 'adarsh123', 'rileyroca', 'movi205', 'acregodean', 'pablosaavedra', 'maramtarek53', 's_coriolis', 'josepazmartin', 'travisc2', 'electronica18', 'bhliu97', 'ematson5897', 'ashutoshsinghhenry6', 'martin32', 'maniphysics09', 'eduard25252598', 'moh.ashraf105', 'pablobou4', 'khazanv2', 'ramonruiz.infor', 'brannon44', 'scremin', 'aasifhameed99', 'aboone06', 'bluelobster', 'veronica.mieites', 'jinwoo2', 'syin4', 'diamond92', 'bflores18', 'njgale01', 'mgk816', 'dkshelat']",4,"['jazlilong', 'mahafizuddin', 'fitrimohdyunus99', 'firdaushusnoruddin99']",396,"['miri23', 'mohamedsameh', 'reemali99_', 'gc_1', 'kerryreto', 'zikrizaki88995', 'je_guilbert', 'jorgecastelo5', 'spazos7', 'soccadelic44', 'ahern0722', 'benoiturcotte', 'noureldin1999', 'alberfn', 'guttsfulltyagi', 'mavanzato0418', 'rkchapman', 'guibill10', 'ari6nd', 'michael2010814', 'happyleexin', 'omardeyaa', 'hong_gao', 'irenehb92', 'sandrabashara', 'nihatyavuz', 'akozych2', 'vikazvereva', 'danielfernandezcalo', 'anthonyroux', 'arrow823', 'aimansyaz99', 'annahaozheng0606', 'rocio', 'masonpb2', 'samashraf1', 'kirankumar94', 'prabuddha_888253127', 'carlosvigo1997', 'muvafikmelikkaya', 'amrebrahim', 'jtorres17', 'jzhan142', 'syedzakwan', 'samet1231234', 'kie180028', 'nadhnasorudin', 'avw2', 'ahmedsameh1698', 'acn562', 'moh.bahaa', 'arifjalani99', 'youssefsherif22', 'asyrafaqil', 'mjgebara14', 'camilolcastro97', 'bcperki2', 'azizijazam11', 'ahmedayman2370', 'rishu', 'ranasherif65', 'kyang37', 'nuanno97', 'smrdafdl', 'brknshn', 'jbaggie2019', 'youssef2042000', 'olivier.gilbert.paquet', 'saipraneett', 'prakharbhargava0', 'hf4', 'nadja1', 'teoster50', 'mohaballam', 'ryanorem', 'shradhap', 'va844', 'neuroque', 'seifhabib', 'anibarseghyan', 'williammitchell5818', 'pingan99', 'mjoza2', 'mariz', 'virajput299', 'bleuminuit', 'ffazul64', 'paul.aniruddha', 'melaniejkramer', 'oliviercharbonneau', 'ilou', 'chengweiheng', 'evrenyigit', 'emilechouinard', 'pythagoras2', 'kason.carroll', 'malgaca', 'kie180031', 'carlosvillar54', 'ckim123', 'kychui2', 'kanet1234', 'mohabayman', 'sanchjai', 'nbs691', 'oishikfaruque', 'lauragdevesa', 'fitrimohdyunus99', 'nowapoca', 'ahagras13', 'akash140410107098', 'chithong', 'saharoaf', 'amni99', 'svo4321', 'lino13', 'vblanco.nico', 'aimanadnan', 'alidsjt', 'dlee145', 'stambo', 'lauramolinosmayo', 'mateocampos', 'hamidausat', 'yjenyiee155', 'retty8', 'sebasket14', 'marcmagdy98', 'janalorenzolumbreras', 'marianne.gratton.1', 'trkmengkay', 'shaf31', 'youxing0309', 'nourananwar123', 'puertarcd', 'felivitullo87', 'manuelsomoza94', 'alecorti.pardo', 'muteki', 'corredoira', 'gabrielyii', 'jinsup2', 'staceyn2', 'kaitlinh', 'cbecker413', 'adam562', 'haclarke', 'xosegq16', 'e1150590', 'jazlilong', 'kalebhilde', 'adriancheah', 'jaimefookinlannister', 'tonybocadillosgrandes', 'rooban11', 'wowmuchchuck', 'xunyong', 'hishamzakaria20', 'rxtodd', 'sarapl', 'alimatama', 'jahnavikachhia', 'alexisdixon6', 'saegner2', 'pranjal3', 'berkaydean', 'baleko12345', 'sparshagarwal1009', 'xyz11', 'david.peral.moran', 'tingliang', 'isabelmaria.vazquez', 'aishu98', 'nadanasser1199', 'desmondsoon', 'keerthisv', 'musabmalek0717', 'mcruces.fz', 'tuberkargan_97', 'worldlineusaf', 'sealseal', 'bharath3', 'cloudyoverhead', 'dhvanil', 'ramy_maged4', 'lsleed', 'zhixin2', 'sriharshap', 'tyy233', 'njs035', 'ablahsaoud', 'nolmos96', 'shorouk_ossama', 'kaustubh.shirpurkar', 'pedrosiaba', 'coderko3', 'alifzulkifli99', 'alancantu57', 'baohl2', 'mengkem2', 'selena', 'tdubnansky6', 'ypp200', 'aengm', 'kartal', 'jacquelinethardin', 'mohameeddsamy', 'jipiccardi', 'amlibrahim', 'rahimnoorj', 'dcpang2', 'tamchouweng', 'elizametias12', 'efrenhub', 'mrefaat', 'ethanmorse', 'taymacnichols', 'ryanboucher', 'kirolosehab99', 'carlosbesadaromero', 'ericrobles', 'janeneil88', 'gxiao2', 'kimzihuang', 'anxovidal8', 'damlakubattt', 'andreadiazgar', 'lukunze1', 'joker632455', 'shuming2', 'j.haliburton', 'abieday1704', 'ozbunar01', 'ugur.cankaya.3718', 'nihaosawaddee', 'magic_ocean99', 'sinasigurpinar', 'tuberkargan', 'jarodm2', 'nabilah1403', 'amiruldanial99', 'yansi', 'cheokonn', 'ammaralaa516', 'juanmacano97', 'maxernest', 'marcosanllo', 'viratbhatt007', 'facundovia', 'michaelsaldana1', 'kie180073', 'bassamtarek', 'abbesalaeddine', 'restep2', 'estebanrial', 'martinzapata', '46harunakgul', 'talwren', 'leejq', 'mohammedemadeldin2000', 'jeanmichael.deschenes', 'miloaismanis', 'mmartinezsanchez', 'emrebuyukkose2', 'luciano.brignone', 'anwar909', 'ahmedamr', 'omarmagdy', 'abdurrahmn13', 'nikalyaamani', 'sdehoyos47', 'apascao', 'yubai', 'vincentpainchaud.vp', 'nagihankececi', 'nazimmath3', 'apb5472', 'rikardberger', 'mr4425', 'jacobzeshleman', 'guoyao', 'kiruthikaabalu181996', 'ikhbal', 'michael.mechelay', 'khor', 'david_atef', 'yaseminablacandir', 'c.a.stupka', 'amparo.castro.96', 'dhodapp', 'fkl217', 'farahsamir978', 'mahafizuddin', 'kie180039', 'atharva98', 'kph2', 'hafizmokh99', 'hilisa', 'kowjiajin', 'fred_dion', 'harshini9962', 'pvalladaresfdez', 'dancastaneda', 'jn1404', 'atx203', 'ammareltalli', 'amani12345', 'aaq', 'ledicia97', 'adriangarea', 'onaam8', 'firdaushusnoruddin99', 'zehuahe2', 'siemprewowthechami', 'justin.lariviere.25', 'tbryan', 'ludovick.begin', 'tss3', 'david2397', 'tmi211', 'kie180079', 'physquig', 'zakhwan7', 'mallen22', 'amr_ua07', 'pip29', 'fcfrancapra94', 'cristinacigarran', 'vanesagarcia', 'adnanyuceer', 'fathy1104', 'perezsarmar', 'al4995', 'melroy_caeiro', 'helenalecoq97', 'caglanlee', 'afeefz', 'jpmcgee98', 'ales.gajdacz', 'masitadonmez', 'eddin21', 'gemma', 'hmoulvi1', 'elad.d', 'xxlilmontysignxx', 'farah26', 'latecnologiameodia', 'abdulrahim2905', 'exjamil', 'vickytubio', 'ozgurkablan26', 'lderemo', 'ankit6257', 'javierisma98', 'redzuan11', 'yeejou990318', 'david.garrido', 'adarsh123', 'rileyroca', 'movi205', 'acregodean', 'pablosaavedra', 'maramtarek53', 's_coriolis', 'kakmeera1999', 'josepazmartin', 'travisc2', 'electronica18', 'kie180702', 'bhliu97', 'ematson5897', 'ashutoshsinghhenry6', 'martin32', 'maniphysics09', 'eduard25252598', 'moh.ashraf105', 'pablobou4', 'khazanv2', 'ahchehyan', 'ramonruiz.infor', 'brannon44', 'scremin', 'aasifhameed99', 'wahidiah52', 'm939454', 'aboone06', 'bluelobster', 'gabrielyii99', 'veronica.mieites', 'jinwoo2', 'syin4', 'diamond92', 'bflores18', 'njgale01', 'mgk816', 'dkshelat']"
1,25,392,62,31,"['dcpang2', 'ckim123', 'restep2', 'kychui2', 'saegner2', 'bcperki2', 'pranjal3', 'travisc2', 'zehuahe2', 'bhliu97', 'kyang37', 'tss3', 'bharath3', 'dlee145', 'hf4', 'zhixin2', 'shuming2', 'khazanv2', 'akozych2', 'coderko3', 'mjoza2', 'baohl2', 'mengkem2', 'jarodm2', 'masonpb2', 'jinsup2', 'jinwoo2', 'staceyn2', 'kph2', 'jzhan142', 'avw2']",361,"['miri23', 'mohamedsameh', 'reemali99_', 'gc_1', 'kerryreto', 'zikrizaki88995', 'je_guilbert', 'jorgecastelo5', 'spazos7', 'soccadelic44', 'ahern0722', 'benoiturcotte', 'noureldin1999', 'alberfn', 'guttsfulltyagi', 'mavanzato0418', 'rkchapman', 'guibill10', 'ari6nd', 'michael2010814', 'happyleexin', 'omardeyaa', 'hong_gao', 'irenehb92', 'sandrabashara', 'nihatyavuz', 'vikazvereva', 'danielfernandezcalo', 'anthonyroux', 'arrow823', 'aimansyaz99', 'annahaozheng0606', 'rocio', 'samashraf1', 'kirankumar94', 'prabuddha_888253127', 'carlosvigo1997', 'muvafikmelikkaya', 'amrebrahim', 'jtorres17', 'syedzakwan', 'samet1231234', 'kie180028', 'nadhnasorudin', 'ahmedsameh1698', 'acn562', 'moh.bahaa', 'arifjalani99', 'youssefsherif22', 'asyrafaqil', 'mjgebara14', 'camilolcastro97', 'azizijazam11', 'ahmedayman2370', 'rishu', 'ranasherif65', 'nuanno97', 'smrdafdl', 'brknshn', 'jbaggie2019', 'youssef2042000', 'olivier.gilbert.paquet', 'saipraneett', 'prakharbhargava0', 'nadja1', 'teoster50', 'mohaballam', 'ryanorem', 'shradhap', 'va844', 'neuroque', 'seifhabib', 'anibarseghyan', 'williammitchell5818', 'pingan99', 'mariz', 'virajput299', 'bleuminuit', 'ffazul64', 'paul.aniruddha', 'melaniejkramer', 'oliviercharbonneau', 'ilou', 'chengweiheng', 'evrenyigit', 'emilechouinard', 'pythagoras2', 'kason.carroll', 'malgaca', 'kie180031', 'carlosvillar54', 'kanet1234', 'mohabayman', 'sanchjai', 'nbs691', 'oishikfaruque', 'lauragdevesa', 'nowapoca', 'ahagras13', 'akash140410107098', 'chithong', 'saharoaf', 'amni99', 'svo4321', 'lino13', 'vblanco.nico', 'aimanadnan', 'alidsjt', 'stambo', 'lauramolinosmayo', 'mateocampos', 'hamidausat', 'yjenyiee155', 'retty8', 'sebasket14', 'marcmagdy98', 'janalorenzolumbreras', 'marianne.gratton.1', 'trkmengkay', 'shaf31', 'youxing0309', 'nourananwar123', 'puertarcd', 'felivitullo87', 'manuelsomoza94', 'alecorti.pardo', 'muteki', 'corredoira', 'gabrielyii', 'kaitlinh', 'cbecker413', 'adam562', 'haclarke', 'xosegq16', 'e1150590', 'kalebhilde', 'adriancheah', 'jaimefookinlannister', 'tonybocadillosgrandes', 'rooban11', 'wowmuchchuck', 'xunyong', 'hishamzakaria20', 'rxtodd', 'sarapl', 'alimatama', 'jahnavikachhia', 'alexisdixon6', 'berkaydean', 'baleko12345', 'sparshagarwal1009', 'xyz11', 'david.peral.moran', 'tingliang', 'isabelmaria.vazquez', 'aishu98', 'nadanasser1199', 'desmondsoon', 'keerthisv', 'musabmalek0717', 'mcruces.fz', 'tuberkargan_97', 'worldlineusaf', 'sealseal', 'cloudyoverhead', 'dhvanil', 'ramy_maged4', 'lsleed', 'sriharshap', 'tyy233', 'njs035', 'ablahsaoud', 'nolmos96', 'shorouk_ossama', 'kaustubh.shirpurkar', 'pedrosiaba', 'alifzulkifli99', 'alancantu57', 'selena', 'tdubnansky6', 'ypp200', 'aengm', 'kartal', 'jacquelinethardin', 'mohameeddsamy', 'jipiccardi', 'amlibrahim', 'rahimnoorj', 'tamchouweng', 'elizametias12', 'efrenhub', 'mrefaat', 'ethanmorse', 'taymacnichols', 'ryanboucher', 'kirolosehab99', 'carlosbesadaromero', 'ericrobles', 'janeneil88', 'gxiao2', 'kimzihuang', 'anxovidal8', 'damlakubattt', 'andreadiazgar', 'lukunze1', 'joker632455', 'j.haliburton', 'abieday1704', 'ozbunar01', 'ugur.cankaya.3718', 'nihaosawaddee', 'magic_ocean99', 'sinasigurpinar', 'tuberkargan', 'nabilah1403', 'amiruldanial99', 'yansi', 'cheokonn', 'ammaralaa516', 'juanmacano97', 'maxernest', 'marcosanllo', 'viratbhatt007', 'facundovia', 'michaelsaldana1', 'kie180073', 'bassamtarek', 'abbesalaeddine', 'estebanrial', 'martinzapata', '46harunakgul', 'talwren', 'leejq', 'mohammedemadeldin2000', 'jeanmichael.deschenes', 'miloaismanis', 'mmartinezsanchez', 'emrebuyukkose2', 'luciano.brignone', 'anwar909', 'ahmedamr', 'omarmagdy', 'abdurrahmn13', 'nikalyaamani', 'sdehoyos47', 'apascao', 'yubai', 'vincentpainchaud.vp', 'nagihankececi', 'nazimmath3', 'apb5472', 'rikardberger', 'mr4425', 'jacobzeshleman', 'guoyao', 'kiruthikaabalu181996', 'ikhbal', 'michael.mechelay', 'khor', 'david_atef', 'yaseminablacandir', 'c.a.stupka', 'amparo.castro.96', 'dhodapp', 'fkl217', 'farahsamir978', 'kie180039', 'atharva98', 'hafizmokh99', 'hilisa', 'kowjiajin', 'fred_dion', 'harshini9962', 'pvalladaresfdez', 'dancastaneda', 'jn1404', 'atx203', 'ammareltalli', 'amani12345', 'aaq', 'ledicia97', 'adriangarea', 'onaam8', 'siemprewowthechami', 'justin.lariviere.25', 'tbryan', 'ludovick.begin', 'david2397', 'tmi211', 'kie180079', 'physquig', 'zakhwan7', 'mallen22', 'amr_ua07', 'pip29', 'fcfrancapra94', 'cristinacigarran', 'vanesagarcia', 'adnanyuceer', 'fathy1104', 'perezsarmar', 'al4995', 'melroy_caeiro', 'helenalecoq97', 'caglanlee', 'afeefz', 'jpmcgee98', 'ales.gajdacz', 'masitadonmez', 'eddin21', 'gemma', 'hmoulvi1', 'elad.d', 'xxlilmontysignxx', 'farah26', 'latecnologiameodia', 'abdulrahim2905', 'exjamil', 'vickytubio', 'ozgurkablan26', 'lderemo', 'ankit6257', 'javierisma98', 'redzuan11', 'yeejou990318', 'david.garrido', 'adarsh123', 'rileyroca', 'movi205', 'acregodean', 'pablosaavedra', 'maramtarek53', 's_coriolis', 'kakmeera1999', 'josepazmartin', 'electronica18', 'kie180702', 'ematson5897', 'ashutoshsinghhenry6', 'martin32', 'maniphysics09', 'eduard25252598', 'moh.ashraf105', 'pablobou4', 'ahchehyan', 'ramonruiz.infor', 'brannon44', 'scremin', 'aasifhameed99', 'wahidiah52', 'm939454', 'aboone06', 'bluelobster', 'gabrielyii99', 'veronica.mieites', 'syin4', 'diamond92', 'bflores18', 'njgale01', 'mgk816', 'dkshelat']",31,"['kv2', 'jingyiw3', 'xzhan147', 'jhardi9', 'jiwu2', 'juliaeb2', 'sili5', 'jmjin2', 'joseam2', 'juliajh2', 'nahmoda2', 'dkfkadbs304', 'dplata2', 'rrmiriy2', 'rakam2', 'kfurbee2', 'rsyuan2', 'yhu55', 'jaketh2', 'joshua.leveillee', 'myl3', 'rll2', 'kjfrank2', 'scc3', 'werforgerf4life', 'hregner2', 'ellenrf2', 'mtobah2', 'leveill2', 'isaxton2', 'nsk2']",423,"['kv2', 'miri23', 'mohamedsameh', 'jhardi9', 'reemali99_', 'gc_1', 'kerryreto', 'zikrizaki88995', 'je_guilbert', 'jorgecastelo5', 'spazos7', 'soccadelic44', 'ahern0722', 'benoiturcotte', 'noureldin1999', 'rrmiriy2', 'alberfn', 'guttsfulltyagi', 'mavanzato0418', 'rkchapman', 'guibill10', 'ari6nd', 'michael2010814', 'happyleexin', 'omardeyaa', 'rsyuan2', 'hong_gao', 'irenehb92', 'sandrabashara', 'nihatyavuz', 'akozych2', 'vikazvereva', 'danielfernandezcalo', 'myl3', 'anthonyroux', 'arrow823', 'aimansyaz99', 'annahaozheng0606', 'rocio', 'masonpb2', 'hregner2', 'werforgerf4life', 'samashraf1', 'kirankumar94', 'prabuddha_888253127', 'carlosvigo1997', 'muvafikmelikkaya', 'amrebrahim', 'jtorres17', 'jzhan142', 'scc3', 'syedzakwan', 'samet1231234', 'kie180028', 'nadhnasorudin', 'avw2', 'ahmedsameh1698', 'acn562', 'moh.bahaa', 'arifjalani99', 'youssefsherif22', 'asyrafaqil', 'mjgebara14', 'camilolcastro97', 'bcperki2', 'juliajh2', 'azizijazam11', 'ahmedayman2370', 'rishu', 'ranasherif65', 'kyang37', 'nuanno97', 'smrdafdl', 'brknshn', 'jbaggie2019', 'youssef2042000', 'olivier.gilbert.paquet', 'saipraneett', 'prakharbhargava0', 'hf4', 'nadja1', 'teoster50', 'mohaballam', 'ryanorem', 'shradhap', 'va844', 'neuroque', 'seifhabib', 'anibarseghyan', 'williammitchell5818', 'pingan99', 'mjoza2', 'mariz', 'virajput299', 'bleuminuit', 'ffazul64', 'rll2', 'paul.aniruddha', 'melaniejkramer', 'oliviercharbonneau', 'ilou', 'chengweiheng', 'evrenyigit', 'emilechouinard', 'pythagoras2', 'kason.carroll', 'malgaca', 'kie180031', 'jiwu2', 'carlosvillar54', 'ckim123', 'kychui2', 'kanet1234', 'mohabayman', 'juliaeb2', 'sanchjai', 'nbs691', 'oishikfaruque', 'lauragdevesa', 'nowapoca', 'ahagras13', 'akash140410107098', 'chithong', 'saharoaf', 'amni99', 'dplata2', 'svo4321', 'lino13', 'vblanco.nico', 'aimanadnan', 'alidsjt', 'dlee145', 'stambo', 'lauramolinosmayo', 'mateocampos', 'hamidausat', 'yjenyiee155', 'retty8', 'sebasket14', 'marcmagdy98', 'janalorenzolumbreras', 'marianne.gratton.1', 'trkmengkay', 'shaf31', 'youxing0309', 'nourananwar123', 'puertarcd', 'felivitullo87', 'manuelsomoza94', 'alecorti.pardo', 'muteki', 'corredoira', 'gabrielyii', 'ellenrf2', 'jinsup2', 'isaxton2', 'staceyn2', 'kaitlinh', 'cbecker413', 'adam562', 'haclarke', 'xosegq16', 'e1150590', 'kalebhilde', 'adriancheah', 'jaimefookinlannister', 'tonybocadillosgrandes', 'rooban11', 'wowmuchchuck', 'xunyong', 'joseam2', 'hishamzakaria20', 'rxtodd', 'sarapl', 'alimatama', 'jahnavikachhia', 'alexisdixon6', 'saegner2', 'pranjal3', 'berkaydean', 'baleko12345', 'sparshagarwal1009', 'xyz11', 'david.peral.moran', 'tingliang', 'isabelmaria.vazquez', 'aishu98', 'nadanasser1199', 'desmondsoon', 'keerthisv', 'musabmalek0717', 'mcruces.fz', 'tuberkargan_97', 'kfurbee2', 'worldlineusaf', 'sealseal', 'bharath3', 'cloudyoverhead', 'dhvanil', 'ramy_maged4', 'lsleed', 'zhixin2', 'sriharshap', 'tyy233', 'njs035', 'ablahsaoud', 'nolmos96', 'shorouk_ossama', 'kaustubh.shirpurkar', 'yhu55', 'pedrosiaba', 'coderko3', 'alifzulkifli99', 'alancantu57', 'baohl2', 'mengkem2', 'selena', 'tdubnansky6', 'ypp200', 'aengm', 'kartal', 'leveill2', 'jacquelinethardin', 'mohameeddsamy', 'jipiccardi', 'amlibrahim', 'rahimnoorj', 'dcpang2', 'tamchouweng', 'xzhan147', 'elizametias12', 'efrenhub', 'mrefaat', 'ethanmorse', 'taymacnichols', 'ryanboucher', 'kirolosehab99', 'carlosbesadaromero', 'ericrobles', 'janeneil88', 'gxiao2', 'kimzihuang', 'anxovidal8', 'damlakubattt', 'andreadiazgar', 'lukunze1', 'joker632455', 'shuming2', 'j.haliburton', 'abieday1704', 'ozbunar01', 'ugur.cankaya.3718', 'nihaosawaddee', 'magic_ocean99', 'sinasigurpinar', 'tuberkargan', 'jarodm2', 'nabilah1403', 'amiruldanial99', 'yansi', 'cheokonn', 'ammaralaa516', 'juanmacano97', 'maxernest', 'marcosanllo', 'mtobah2', 'viratbhatt007', 'facundovia', 'michaelsaldana1', 'kie180073', 'bassamtarek', 'abbesalaeddine', 'restep2', 'estebanrial', 'martinzapata', '46harunakgul', 'talwren', 'leejq', 'mohammedemadeldin2000', 'jeanmichael.deschenes', 'miloaismanis', 'mmartinezsanchez', 'emrebuyukkose2', 'luciano.brignone', 'anwar909', 'ahmedamr', 'omarmagdy', 'abdurrahmn13', 'nahmoda2', 'nikalyaamani', 'rakam2', 'sdehoyos47', 'apascao', 'yubai', 'vincentpainchaud.vp', 'nagihankececi', 'nazimmath3', 'apb5472', 'rikardberger', 'mr4425', 'jacobzeshleman', 'guoyao', 'kiruthikaabalu181996', 'ikhbal', 'michael.mechelay', 'khor', 'david_atef', 'yaseminablacandir', 'c.a.stupka', 'amparo.castro.96', 'dhodapp', 'fkl217', 'farahsamir978', 'kie180039', 'atharva98', 'kph2', 'hafizmokh99', 'hilisa', 'kowjiajin', 'fred_dion', 'harshini9962', 'pvalladaresfdez', 'dancastaneda', 'jingyiw3', 'jn1404', 'atx203', 'ammareltalli', 'amani12345', 'aaq', 'ledicia97', 'adriangarea', 'onaam8', 'zehuahe2', 'siemprewowthechami', 'dkfkadbs304', 'justin.lariviere.25', 'tbryan', 'ludovick.begin', 'tss3', 'david2397', 'tmi211', 'kie180079', 'physquig', 'zakhwan7', 'mallen22', 'amr_ua07', 'pip29', 'fcfrancapra94', 'cristinacigarran', 'vanesagarcia', 'adnanyuceer', 'jaketh2', 'fathy1104', 'joshua.leveillee', 'perezsarmar', 'al4995', 'kjfrank2', 'melroy_caeiro', 'helenalecoq97', 'caglanlee', 'afeefz', 'jpmcgee98', 'ales.gajdacz', 'masitadonmez', 'eddin21', 'gemma', 'hmoulvi1', 'elad.d', 'xxlilmontysignxx', 'farah26', 'latecnologiameodia', 'abdulrahim2905', 'exjamil', 'vickytubio', 'ozgurkablan26', 'lderemo', 'ankit6257', 'nsk2', 'javierisma98', 'redzuan11', 'yeejou990318', 'david.garrido', 'sili5', 'adarsh123', 'rileyroca', 'jmjin2', 'movi205', 'acregodean', 'pablosaavedra', 'maramtarek53', 's_coriolis', 'kakmeera1999', 'josepazmartin', 'travisc2', 'electronica18', 'kie180702', 'bhliu97', 'ematson5897', 'ashutoshsinghhenry6', 'martin32', 'maniphysics09', 'eduard25252598', 'moh.ashraf105', 'pablobou4', 'khazanv2', 'ahchehyan', 'ramonruiz.infor', 'brannon44', 'scremin', 'aasifhameed99', 'wahidiah52', 'm939454', 'aboone06', 'bluelobster', 'gabrielyii99', 'veronica.mieites', 'jinwoo2', 'syin4', 'diamond92', 'bflores18', 'njgale01', 'mgk816', 'dkshelat']"
1,13,392,56,53,"['e1150590', 'dancastaneda', 'acn562', 'kanet1234', 'jaimefookinlannister', 'michaelsaldana1', 'amani12345', 'sanchjai', 'ethanmorse', 'oishikfaruque', 'aaq', 'wowmuchchuck', 'mjgebara14', 'ahern0722', 'rxtodd', 'onaam8', 'alexisdixon6', 'ryanboucher', 'luciano.brignone', 'aishu98', 'ematson5897', 'tbryan', 'mavanzato0418', 'ericrobles', 'sdehoyos47', 'jbaggie2019', 'saipraneett', 'teoster50', 'hamidausat', 'j.haliburton', 'nolmos96', 'kaustubh.shirpurkar', 'anibarseghyan', 'alancantu57', 'brannon44', 'melaniejkramer', 'tdubnansky6', 'michael.mechelay', 'ypp200', 'jpmcgee98', 'aboone06', 'c.a.stupka', 'samashraf1', 'dhodapp', 'elad.d', 'xxlilmontysignxx', 'kason.carroll', 'atharva98', 'bflores18', 'lderemo', 'jtorres17', 'haclarke', 'javierisma98']",339,"['miri23', 'mohamedsameh', 'reemali99_', 'gc_1', 'kerryreto', 'zikrizaki88995', 'je_guilbert', 'jorgecastelo5', 'spazos7', 'soccadelic44', 'benoiturcotte', 'noureldin1999', 'alberfn', 'guttsfulltyagi', 'rkchapman', 'guibill10', 'ari6nd', 'michael2010814', 'happyleexin', 'omardeyaa', 'hong_gao', 'irenehb92', 'sandrabashara', 'nihatyavuz', 'akozych2', 'vikazvereva', 'danielfernandezcalo', 'anthonyroux', 'arrow823', 'aimansyaz99', 'annahaozheng0606', 'rocio', 'masonpb2', 'kirankumar94', 'prabuddha_888253127', 'carlosvigo1997', 'muvafikmelikkaya', 'amrebrahim', 'jzhan142', 'syedzakwan', 'samet1231234', 'kie180028', 'nadhnasorudin', 'avw2', 'ahmedsameh1698', 'moh.bahaa', 'arifjalani99', 'youssefsherif22', 'asyrafaqil', 'camilolcastro97', 'bcperki2', 'azizijazam11', 'ahmedayman2370', 'rishu', 'ranasherif65', 'kyang37', 'nuanno97', 'smrdafdl', 'brknshn', 'youssef2042000', 'olivier.gilbert.paquet', 'prakharbhargava0', 'hf4', 'nadja1', 'mohaballam', 'ryanorem', 'shradhap', 'va844', 'neuroque', 'seifhabib', 'williammitchell5818', 'pingan99', 'mjoza2', 'mariz', 'virajput299', 'bleuminuit', 'ffazul64', 'paul.aniruddha', 'oliviercharbonneau', 'ilou', 'chengweiheng', 'evrenyigit', 'emilechouinard', 'pythagoras2', 'malgaca', 'kie180031', 'carlosvillar54', 'ckim123', 'kychui2', 'mohabayman', 'nbs691', 'lauragdevesa', 'nowapoca', 'ahagras13', 'akash140410107098', 'chithong', 'saharoaf', 'amni99', 'svo4321', 'lino13', 'vblanco.nico', 'aimanadnan', 'alidsjt', 'dlee145', 'stambo', 'lauramolinosmayo', 'mateocampos', 'yjenyiee155', 'retty8', 'sebasket14', 'marcmagdy98', 'janalorenzolumbreras', 'marianne.gratton.1', 'trkmengkay', 'shaf31', 'youxing0309', 'nourananwar123', 'puertarcd', 'felivitullo87', 'manuelsomoza94', 'alecorti.pardo', 'muteki', 'corredoira', 'gabrielyii', 'jinsup2', 'staceyn2', 'kaitlinh', 'cbecker413', 'adam562', 'xosegq16', 'kalebhilde', 'adriancheah', 'tonybocadillosgrandes', 'rooban11', 'xunyong', 'hishamzakaria20', 'sarapl', 'alimatama', 'jahnavikachhia', 'saegner2', 'pranjal3', 'berkaydean', 'baleko12345', 'sparshagarwal1009', 'xyz11', 'david.peral.moran', 'tingliang', 'isabelmaria.vazquez', 'nadanasser1199', 'desmondsoon', 'keerthisv', 'musabmalek0717', 'mcruces.fz', 'tuberkargan_97', 'worldlineusaf', 'sealseal', 'bharath3', 'cloudyoverhead', 'dhvanil', 'ramy_maged4', 'lsleed', 'zhixin2', 'sriharshap', 'tyy233', 'njs035', 'ablahsaoud', 'shorouk_ossama', 'pedrosiaba', 'coderko3', 'alifzulkifli99', 'baohl2', 'mengkem2', 'selena', 'aengm', 'kartal', 'jacquelinethardin', 'mohameeddsamy', 'jipiccardi', 'amlibrahim', 'rahimnoorj', 'dcpang2', 'tamchouweng', 'elizametias12', 'efrenhub', 'mrefaat', 'taymacnichols', 'kirolosehab99', 'carlosbesadaromero', 'janeneil88', 'gxiao2', 'kimzihuang', 'anxovidal8', 'damlakubattt', 'andreadiazgar', 'lukunze1', 'joker632455', 'shuming2', 'abieday1704', 'ozbunar01', 'ugur.cankaya.3718', 'nihaosawaddee', 'magic_ocean99', 'sinasigurpinar', 'tuberkargan', 'jarodm2', 'nabilah1403', 'amiruldanial99', 'yansi', 'cheokonn', 'ammaralaa516', 'juanmacano97', 'maxernest', 'marcosanllo', 'viratbhatt007', 'facundovia', 'kie180073', 'bassamtarek', 'abbesalaeddine', 'restep2', 'estebanrial', 'martinzapata', '46harunakgul', 'talwren', 'leejq', 'mohammedemadeldin2000', 'jeanmichael.deschenes', 'miloaismanis', 'mmartinezsanchez', 'emrebuyukkose2', 'anwar909', 'ahmedamr', 'omarmagdy', 'abdurrahmn13', 'nikalyaamani', 'apascao', 'yubai', 'vincentpainchaud.vp', 'nagihankececi', 'nazimmath3', 'apb5472', 'rikardberger', 'mr4425', 'jacobzeshleman', 'guoyao', 'kiruthikaabalu181996', 'ikhbal', 'khor', 'david_atef', 'yaseminablacandir', 'amparo.castro.96', 'fkl217', 'farahsamir978', 'kie180039', 'kph2', 'hafizmokh99', 'hilisa', 'kowjiajin', 'fred_dion', 'harshini9962', 'pvalladaresfdez', 'jn1404', 'atx203', 'ammareltalli', 'ledicia97', 'adriangarea', 'zehuahe2', 'siemprewowthechami', 'justin.lariviere.25', 'ludovick.begin', 'tss3', 'david2397', 'tmi211', 'kie180079', 'physquig', 'zakhwan7', 'mallen22', 'amr_ua07', 'pip29', 'fcfrancapra94', 'cristinacigarran', 'vanesagarcia', 'adnanyuceer', 'fathy1104', 'perezsarmar', 'al4995', 'melroy_caeiro', 'helenalecoq97', 'caglanlee', 'afeefz', 'ales.gajdacz', 'masitadonmez', 'eddin21', 'gemma', 'hmoulvi1', 'farah26', 'latecnologiameodia', 'abdulrahim2905', 'exjamil', 'vickytubio', 'ozgurkablan26', 'ankit6257', 'redzuan11', 'yeejou990318', 'david.garrido', 'adarsh123', 'rileyroca', 'movi205', 'acregodean', 'pablosaavedra', 'maramtarek53', 's_coriolis', 'kakmeera1999', 'josepazmartin', 'travisc2', 'electronica18', 'kie180702', 'bhliu97', 'ashutoshsinghhenry6', 'martin32', 'maniphysics09', 'eduard25252598', 'moh.ashraf105', 'pablobou4', 'khazanv2', 'ahchehyan', 'ramonruiz.infor', 'scremin', 'aasifhameed99', 'wahidiah52', 'm939454', 'bluelobster', 'gabrielyii99', 'veronica.mieites', 'jinwoo2', 'syin4', 'diamond92', 'njgale01', 'mgk816', 'dkshelat']",3,"['lobwedge', 'darielysp', 'billsnow']",395,"['miri23', 'mohamedsameh', 'reemali99_', 'gc_1', 'kerryreto', 'zikrizaki88995', 'je_guilbert', 'jorgecastelo5', 'spazos7', 'soccadelic44', 'ahern0722', 'benoiturcotte', 'noureldin1999', 'alberfn', 'guttsfulltyagi', 'mavanzato0418', 'rkchapman', 'guibill10', 'ari6nd', 'michael2010814', 'happyleexin', 'omardeyaa', 'hong_gao', 'irenehb92', 'sandrabashara', 'nihatyavuz', 'akozych2', 'vikazvereva', 'danielfernandezcalo', 'anthonyroux', 'arrow823', 'aimansyaz99', 'annahaozheng0606', 'rocio', 'masonpb2', 'samashraf1', 'kirankumar94', 'prabuddha_888253127', 'carlosvigo1997', 'muvafikmelikkaya', 'amrebrahim', 'jtorres17', 'jzhan142', 'syedzakwan', 'samet1231234', 'kie180028', 'nadhnasorudin', 'avw2', 'ahmedsameh1698', 'acn562', 'moh.bahaa', 'arifjalani99', 'youssefsherif22', 'asyrafaqil', 'mjgebara14', 'camilolcastro97', 'bcperki2', 'azizijazam11', 'ahmedayman2370', 'rishu', 'ranasherif65', 'kyang37', 'nuanno97', 'smrdafdl', 'brknshn', 'jbaggie2019', 'youssef2042000', 'olivier.gilbert.paquet', 'saipraneett', 'prakharbhargava0', 'hf4', 'nadja1', 'teoster50', 'mohaballam', 'ryanorem', 'shradhap', 'va844', 'neuroque', 'seifhabib', 'anibarseghyan', 'williammitchell5818', 'pingan99', 'mjoza2', 'mariz', 'virajput299', 'bleuminuit', 'ffazul64', 'paul.aniruddha', 'melaniejkramer', 'oliviercharbonneau', 'ilou', 'chengweiheng', 'evrenyigit', 'emilechouinard', 'pythagoras2', 'kason.carroll', 'malgaca', 'kie180031', 'carlosvillar54', 'ckim123', 'kychui2', 'kanet1234', 'mohabayman', 'sanchjai', 'nbs691', 'oishikfaruque', 'lauragdevesa', 'nowapoca', 'ahagras13', 'akash140410107098', 'chithong', 'saharoaf', 'amni99', 'svo4321', 'lino13', 'vblanco.nico', 'aimanadnan', 'alidsjt', 'dlee145', 'stambo', 'lobwedge', 'lauramolinosmayo', 'mateocampos', 'hamidausat', 'yjenyiee155', 'retty8', 'sebasket14', 'marcmagdy98', 'janalorenzolumbreras', 'marianne.gratton.1', 'trkmengkay', 'shaf31', 'youxing0309', 'nourananwar123', 'puertarcd', 'felivitullo87', 'manuelsomoza94', 'alecorti.pardo', 'muteki', 'corredoira', 'gabrielyii', 'jinsup2', 'staceyn2', 'kaitlinh', 'cbecker413', 'adam562', 'haclarke', 'xosegq16', 'e1150590', 'kalebhilde', 'adriancheah', 'jaimefookinlannister', 'tonybocadillosgrandes', 'rooban11', 'wowmuchchuck', 'xunyong', 'hishamzakaria20', 'rxtodd', 'sarapl', 'alimatama', 'jahnavikachhia', 'alexisdixon6', 'saegner2', 'pranjal3', 'berkaydean', 'baleko12345', 'sparshagarwal1009', 'xyz11', 'david.peral.moran', 'tingliang', 'isabelmaria.vazquez', 'aishu98', 'nadanasser1199', 'desmondsoon', 'keerthisv', 'musabmalek0717', 'mcruces.fz', 'tuberkargan_97', 'worldlineusaf', 'sealseal', 'bharath3', 'cloudyoverhead', 'dhvanil', 'ramy_maged4', 'lsleed', 'zhixin2', 'sriharshap', 'billsnow', 'tyy233', 'njs035', 'ablahsaoud', 'nolmos96', 'shorouk_ossama', 'kaustubh.shirpurkar', 'pedrosiaba', 'coderko3', 'alifzulkifli99', 'alancantu57', 'baohl2', 'mengkem2', 'selena', 'tdubnansky6', 'ypp200', 'aengm', 'kartal', 'jacquelinethardin', 'mohameeddsamy', 'jipiccardi', 'amlibrahim', 'rahimnoorj', 'dcpang2', 'tamchouweng', 'elizametias12', 'efrenhub', 'mrefaat', 'ethanmorse', 'taymacnichols', 'ryanboucher', 'kirolosehab99', 'carlosbesadaromero', 'ericrobles', 'janeneil88', 'gxiao2', 'kimzihuang', 'anxovidal8', 'damlakubattt', 'andreadiazgar', 'lukunze1', 'joker632455', 'shuming2', 'j.haliburton', 'abieday1704', 'ozbunar01', 'ugur.cankaya.3718', 'nihaosawaddee', 'magic_ocean99', 'sinasigurpinar', 'tuberkargan', 'jarodm2', 'nabilah1403', 'amiruldanial99', 'yansi', 'cheokonn', 'ammaralaa516', 'juanmacano97', 'maxernest', 'marcosanllo', 'viratbhatt007', 'facundovia', 'michaelsaldana1', 'kie180073', 'bassamtarek', 'abbesalaeddine', 'restep2', 'estebanrial', 'martinzapata', '46harunakgul', 'talwren', 'leejq', 'mohammedemadeldin2000', 'jeanmichael.deschenes', 'miloaismanis', 'mmartinezsanchez', 'emrebuyukkose2', 'luciano.brignone', 'anwar909', 'ahmedamr', 'omarmagdy', 'abdurrahmn13', 'nikalyaamani', 'sdehoyos47', 'apascao', 'yubai', 'vincentpainchaud.vp', 'nagihankececi', 'nazimmath3', 'apb5472', 'rikardberger', 'mr4425', 'jacobzeshleman', 'guoyao', 'kiruthikaabalu181996', 'ikhbal', 'michael.mechelay', 'khor', 'david_atef', 'yaseminablacandir', 'c.a.stupka', 'amparo.castro.96', 'dhodapp', 'fkl217', 'farahsamir978', 'kie180039', 'atharva98', 'kph2', 'hafizmokh99', 'hilisa', 'kowjiajin', 'fred_dion', 'harshini9962', 'pvalladaresfdez', 'dancastaneda', 'jn1404', 'atx203', 'ammareltalli', 'amani12345', 'aaq', 'ledicia97', 'adriangarea', 'onaam8', 'zehuahe2', 'siemprewowthechami', 'justin.lariviere.25', 'tbryan', 'ludovick.begin', 'tss3', 'david2397', 'tmi211', 'kie180079', 'physquig', 'zakhwan7', 'mallen22', 'amr_ua07', 'pip29', 'fcfrancapra94', 'cristinacigarran', 'vanesagarcia', 'adnanyuceer', 'fathy1104', 'perezsarmar', 'al4995', 'melroy_caeiro', 'helenalecoq97', 'caglanlee', 'afeefz', 'jpmcgee98', 'ales.gajdacz', 'masitadonmez', 'eddin21', 'gemma', 'hmoulvi1', 'elad.d', 'xxlilmontysignxx', 'farah26', 'latecnologiameodia', 'abdulrahim2905', 'exjamil', 'vickytubio', 'ozgurkablan26', 'lderemo', 'ankit6257', 'javierisma98', 'redzuan11', 'yeejou990318', 'david.garrido', 'adarsh123', 'rileyroca', 'movi205', 'acregodean', 'pablosaavedra', 'maramtarek53', 's_coriolis', 'kakmeera1999', 'josepazmartin', 'travisc2', 'electronica18', 'kie180702', 'bhliu97', 'ematson5897', 'ashutoshsinghhenry6', 'darielysp', 'martin32', 'maniphysics09', 'eduard25252598', 'moh.ashraf105', 'pablobou4', 'khazanv2', 'ahchehyan', 'ramonruiz.infor', 'brannon44', 'scremin', 'aasifhameed99', 'wahidiah52', 'm939454', 'aboone06', 'bluelobster', 'gabrielyii99', 'veronica.mieites', 'jinwoo2', 'syin4', 'diamond92', 'bflores18', 'njgale01', 'mgk816', 'dkshelat']"
1,28,392,53,46,"['carlosvillar54', 'efrenhub', 'tonybocadillosgrandes', 'martinzapata', 'movi205', 'ledicia97', 'lauragdevesa', 'acregodean', 'sarapl', 'alimatama', 'camilolcastro97', 'carlosbesadaromero', 'electronica18', 'svo4321', 'david.peral.moran', 'mcruces.fz', 'nuanno97', 'lino13', 'vblanco.nico', 'alidsjt', 'anxovidal8', 'martin32', 'mateocampos', 'retty8', 'pablobou4', 'vanesagarcia', 'cristinacigarran', 'janalorenzolumbreras', 'pedrosiaba', 'ramonruiz.infor', 'perezsarmar', 'helenalecoq97', 'puertarcd', 'gemma', 'alecorti.pardo', 'juanmacano97', 'amparo.castro.96', 'maxernest', 'veronica.mieites', 'corredoira', 'marcosanllo', 'latecnologiameodia', 'carlosvigo1997', 'vickytubio', 'xosegq16', 'malgaca']",346,"['miri23', 'mohamedsameh', 'reemali99_', 'gc_1', 'kerryreto', 'zikrizaki88995', 'je_guilbert', 'jorgecastelo5', 'spazos7', 'soccadelic44', 'ahern0722', 'benoiturcotte', 'noureldin1999', 'alberfn', 'guttsfulltyagi', 'mavanzato0418', 'rkchapman', 'guibill10', 'ari6nd', 'michael2010814', 'happyleexin', 'omardeyaa', 'hong_gao', 'irenehb92', 'sandrabashara', 'nihatyavuz', 'akozych2', 'vikazvereva', 'danielfernandezcalo', 'anthonyroux', 'arrow823', 'aimansyaz99', 'annahaozheng0606', 'rocio', 'masonpb2', 'samashraf1', 'kirankumar94', 'prabuddha_888253127', 'muvafikmelikkaya', 'amrebrahim', 'jtorres17', 'jzhan142', 'syedzakwan', 'samet1231234', 'kie180028', 'nadhnasorudin', 'avw2', 'ahmedsameh1698', 'acn562', 'moh.bahaa', 'arifjalani99', 'youssefsherif22', 'asyrafaqil', 'mjgebara14', 'bcperki2', 'azizijazam11', 'ahmedayman2370', 'rishu', 'ranasherif65', 'kyang37', 'smrdafdl', 'brknshn', 'jbaggie2019', 'youssef2042000', 'olivier.gilbert.paquet', 'saipraneett', 'prakharbhargava0', 'hf4', 'nadja1', 'teoster50', 'mohaballam', 'ryanorem', 'shradhap', 'va844', 'neuroque', 'seifhabib', 'anibarseghyan', 'williammitchell5818', 'pingan99', 'mjoza2', 'mariz', 'virajput299', 'bleuminuit', 'ffazul64', 'paul.aniruddha', 'melaniejkramer', 'oliviercharbonneau', 'ilou', 'chengweiheng', 'evrenyigit', 'emilechouinard', 'pythagoras2', 'kason.carroll', 'kie180031', 'ckim123', 'kychui2', 'kanet1234', 'mohabayman', 'sanchjai', 'nbs691', 'oishikfaruque', 'nowapoca', 'ahagras13', 'akash140410107098', 'chithong', 'saharoaf', 'amni99', 'aimanadnan', 'dlee145', 'stambo', 'lauramolinosmayo', 'hamidausat', 'yjenyiee155', 'sebasket14', 'marcmagdy98', 'marianne.gratton.1', 'trkmengkay', 'shaf31', 'youxing0309', 'nourananwar123', 'felivitullo87', 'manuelsomoza94', 'muteki', 'gabrielyii', 'jinsup2', 'staceyn2', 'kaitlinh', 'cbecker413', 'adam562', 'haclarke', 'e1150590', 'kalebhilde', 'adriancheah', 'jaimefookinlannister', 'rooban11', 'wowmuchchuck', 'xunyong', 'hishamzakaria20', 'rxtodd', 'jahnavikachhia', 'alexisdixon6', 'saegner2', 'pranjal3', 'berkaydean', 'baleko12345', 'sparshagarwal1009', 'xyz11', 'tingliang', 'isabelmaria.vazquez', 'aishu98', 'nadanasser1199', 'desmondsoon', 'keerthisv', 'musabmalek0717', 'tuberkargan_97', 'worldlineusaf', 'sealseal', 'bharath3', 'cloudyoverhead', 'dhvanil', 'ramy_maged4', 'lsleed', 'zhixin2', 'sriharshap', 'tyy233', 'njs035', 'ablahsaoud', 'nolmos96', 'shorouk_ossama', 'kaustubh.shirpurkar', 'coderko3', 'alifzulkifli99', 'alancantu57', 'baohl2', 'mengkem2', 'selena', 'tdubnansky6', 'ypp200', 'aengm', 'kartal', 'jacquelinethardin', 'mohameeddsamy', 'jipiccardi', 'amlibrahim', 'rahimnoorj', 'dcpang2', 'tamchouweng', 'elizametias12', 'mrefaat', 'ethanmorse', 'taymacnichols', 'ryanboucher', 'kirolosehab99', 'ericrobles', 'janeneil88', 'gxiao2', 'kimzihuang', 'damlakubattt', 'andreadiazgar', 'lukunze1', 'joker632455', 'shuming2', 'j.haliburton', 'abieday1704', 'ozbunar01', 'ugur.cankaya.3718', 'nihaosawaddee', 'magic_ocean99', 'sinasigurpinar', 'tuberkargan', 'jarodm2', 'nabilah1403', 'amiruldanial99', 'yansi', 'cheokonn', 'ammaralaa516', 'viratbhatt007', 'facundovia', 'michaelsaldana1', 'kie180073', 'bassamtarek', 'abbesalaeddine', 'restep2', 'estebanrial', '46harunakgul', 'talwren', 'leejq', 'mohammedemadeldin2000', 'jeanmichael.deschenes', 'miloaismanis', 'mmartinezsanchez', 'emrebuyukkose2', 'luciano.brignone', 'anwar909', 'ahmedamr', 'omarmagdy', 'abdurrahmn13', 'nikalyaamani', 'sdehoyos47', 'apascao', 'yubai', 'vincentpainchaud.vp', 'nagihankececi', 'nazimmath3', 'apb5472', 'rikardberger', 'mr4425', 'jacobzeshleman', 'guoyao', 'kiruthikaabalu181996', 'ikhbal', 'michael.mechelay', 'khor', 'david_atef', 'yaseminablacandir', 'c.a.stupka', 'dhodapp', 'fkl217', 'farahsamir978', 'kie180039', 'atharva98', 'kph2', 'hafizmokh99', 'hilisa', 'kowjiajin', 'fred_dion', 'harshini9962', 'pvalladaresfdez', 'dancastaneda', 'jn1404', 'atx203', 'ammareltalli', 'amani12345', 'aaq', 'adriangarea', 'onaam8', 'zehuahe2', 'siemprewowthechami', 'justin.lariviere.25', 'tbryan', 'ludovick.begin', 'tss3', 'david2397', 'tmi211', 'kie180079', 'physquig', 'zakhwan7', 'mallen22', 'amr_ua07', 'pip29', 'fcfrancapra94', 'adnanyuceer', 'fathy1104', 'al4995', 'melroy_caeiro', 'caglanlee', 'afeefz', 'jpmcgee98', 'ales.gajdacz', 'masitadonmez', 'eddin21', 'hmoulvi1', 'elad.d', 'xxlilmontysignxx', 'farah26', 'abdulrahim2905', 'exjamil', 'ozgurkablan26', 'lderemo', 'ankit6257', 'javierisma98', 'redzuan11', 'yeejou990318', 'david.garrido', 'adarsh123', 'rileyroca', 'pablosaavedra', 'maramtarek53', 's_coriolis', 'kakmeera1999', 'josepazmartin', 'travisc2', 'kie180702', 'bhliu97', 'ematson5897', 'ashutoshsinghhenry6', 'maniphysics09', 'eduard25252598', 'moh.ashraf105', 'khazanv2', 'ahchehyan', 'brannon44', 'scremin', 'aasifhameed99', 'wahidiah52', 'm939454', 'aboone06', 'bluelobster', 'gabrielyii99', 'jinwoo2', 'syin4', 'diamond92', 'bflores18', 'njgale01', 'mgk816', 'dkshelat']",7,"['gombut', 'aronchino6', 'antonio25', 'hermidaitor', 'iago', 'loisonchambers', 'dfl']",399,"['miri23', 'mohamedsameh', 'reemali99_', 'gc_1', 'kerryreto', 'zikrizaki88995', 'je_guilbert', 'jorgecastelo5', 'spazos7', 'soccadelic44', 'ahern0722', 'benoiturcotte', 'noureldin1999', 'alberfn', 'guttsfulltyagi', 'mavanzato0418', 'loisonchambers', 'rkchapman', 'guibill10', 'ari6nd', 'michael2010814', 'happyleexin', 'omardeyaa', 'hong_gao', 'irenehb92', 'sandrabashara', 'nihatyavuz', 'akozych2', 'vikazvereva', 'danielfernandezcalo', 'anthonyroux', 'arrow823', 'aimansyaz99', 'annahaozheng0606', 'rocio', 'masonpb2', 'samashraf1', 'kirankumar94', 'prabuddha_888253127', 'carlosvigo1997', 'muvafikmelikkaya', 'amrebrahim', 'jtorres17', 'jzhan142', 'syedzakwan', 'samet1231234', 'kie180028', 'nadhnasorudin', 'avw2', 'ahmedsameh1698', 'acn562', 'moh.bahaa', 'arifjalani99', 'youssefsherif22', 'asyrafaqil', 'mjgebara14', 'camilolcastro97', 'bcperki2', 'azizijazam11', 'ahmedayman2370', 'rishu', 'ranasherif65', 'kyang37', 'nuanno97', 'smrdafdl', 'brknshn', 'jbaggie2019', 'youssef2042000', 'olivier.gilbert.paquet', 'saipraneett', 'prakharbhargava0', 'hf4', 'nadja1', 'teoster50', 'mohaballam', 'ryanorem', 'shradhap', 'va844', 'neuroque', 'seifhabib', 'anibarseghyan', 'williammitchell5818', 'pingan99', 'mjoza2', 'mariz', 'virajput299', 'bleuminuit', 'ffazul64', 'paul.aniruddha', 'melaniejkramer', 'oliviercharbonneau', 'ilou', 'chengweiheng', 'evrenyigit', 'emilechouinard', 'pythagoras2', 'kason.carroll', 'malgaca', 'kie180031', 'carlosvillar54', 'ckim123', 'kychui2', 'kanet1234', 'mohabayman', 'sanchjai', 'nbs691', 'oishikfaruque', 'iago', 'lauragdevesa', 'nowapoca', 'ahagras13', 'akash140410107098', 'chithong', 'saharoaf', 'amni99', 'svo4321', 'lino13', 'vblanco.nico', 'aimanadnan', 'alidsjt', 'dlee145', 'stambo', 'lauramolinosmayo', 'mateocampos', 'hamidausat', 'yjenyiee155', 'retty8', 'sebasket14', 'marcmagdy98', 'janalorenzolumbreras', 'marianne.gratton.1', 'trkmengkay', 'shaf31', 'youxing0309', 'nourananwar123', 'puertarcd', 'felivitullo87', 'manuelsomoza94', 'alecorti.pardo', 'muteki', 'corredoira', 'gabrielyii', 'jinsup2', 'staceyn2', 'kaitlinh', 'cbecker413', 'adam562', 'haclarke', 'xosegq16', 'e1150590', 'kalebhilde', 'adriancheah', 'jaimefookinlannister', 'tonybocadillosgrandes', 'rooban11', 'wowmuchchuck', 'xunyong', 'hishamzakaria20', 'rxtodd', 'sarapl', 'alimatama', 'jahnavikachhia', 'alexisdixon6', 'saegner2', 'pranjal3', 'berkaydean', 'baleko12345', 'sparshagarwal1009', 'xyz11', 'david.peral.moran', 'tingliang', 'isabelmaria.vazquez', 'aishu98', 'nadanasser1199', 'desmondsoon', 'keerthisv', 'musabmalek0717', 'mcruces.fz', 'tuberkargan_97', 'worldlineusaf', 'sealseal', 'bharath3', 'dfl', 'cloudyoverhead', 'dhvanil', 'ramy_maged4', 'lsleed', 'zhixin2', 'sriharshap', 'tyy233', 'njs035', 'ablahsaoud', 'nolmos96', 'shorouk_ossama', 'kaustubh.shirpurkar', 'pedrosiaba', 'coderko3', 'alifzulkifli99', 'alancantu57', 'baohl2', 'mengkem2', 'selena', 'tdubnansky6', 'ypp200', 'aengm', 'kartal', 'jacquelinethardin', 'mohameeddsamy', 'jipiccardi', 'amlibrahim', 'rahimnoorj', 'dcpang2', 'tamchouweng', 'elizametias12', 'efrenhub', 'mrefaat', 'ethanmorse', 'taymacnichols', 'ryanboucher', 'kirolosehab99', 'carlosbesadaromero', 'aronchino6', 'ericrobles', 'janeneil88', 'gxiao2', 'kimzihuang', 'anxovidal8', 'damlakubattt', 'andreadiazgar', 'lukunze1', 'joker632455', 'shuming2', 'j.haliburton', 'abieday1704', 'ozbunar01', 'ugur.cankaya.3718', 'nihaosawaddee', 'magic_ocean99', 'sinasigurpinar', 'tuberkargan', 'jarodm2', 'nabilah1403', 'amiruldanial99', 'yansi', 'cheokonn', 'ammaralaa516', 'juanmacano97', 'maxernest', 'marcosanllo', 'viratbhatt007', 'facundovia', 'michaelsaldana1', 'kie180073', 'bassamtarek', 'abbesalaeddine', 'restep2', 'estebanrial', 'martinzapata', '46harunakgul', 'talwren', 'leejq', 'mohammedemadeldin2000', 'jeanmichael.deschenes', 'miloaismanis', 'mmartinezsanchez', 'emrebuyukkose2', 'luciano.brignone', 'anwar909', 'ahmedamr', 'omarmagdy', 'abdurrahmn13', 'nikalyaamani', 'sdehoyos47', 'apascao', 'yubai', 'vincentpainchaud.vp', 'nagihankececi', 'nazimmath3', 'apb5472', 'rikardberger', 'mr4425', 'jacobzeshleman', 'guoyao', 'kiruthikaabalu181996', 'ikhbal', 'michael.mechelay', 'khor', 'david_atef', 'yaseminablacandir', 'c.a.stupka', 'amparo.castro.96', 'dhodapp', 'fkl217', 'farahsamir978', 'kie180039', 'atharva98', 'kph2', 'hafizmokh99', 'hilisa', 'kowjiajin', 'fred_dion', 'harshini9962', 'pvalladaresfdez', 'dancastaneda', 'jn1404', 'atx203', 'ammareltalli', 'amani12345', 'aaq', 'ledicia97', 'adriangarea', 'onaam8', 'zehuahe2', 'siemprewowthechami', 'justin.lariviere.25', 'tbryan', 'ludovick.begin', 'tss3', 'david2397', 'tmi211', 'kie180079', 'physquig', 'zakhwan7', 'mallen22', 'amr_ua07', 'pip29', 'fcfrancapra94', 'cristinacigarran', 'vanesagarcia', 'adnanyuceer', 'antonio25', 'fathy1104', 'perezsarmar', 'al4995', 'melroy_caeiro', 'helenalecoq97', 'caglanlee', 'afeefz', 'jpmcgee98', 'ales.gajdacz', 'masitadonmez', 'eddin21', 'gemma', 'hmoulvi1', 'gombut', 'elad.d', 'xxlilmontysignxx', 'farah26', 'latecnologiameodia', 'abdulrahim2905', 'exjamil', 'vickytubio', 'ozgurkablan26', 'lderemo', 'ankit6257', 'javierisma98', 'redzuan11', 'yeejou990318', 'david.garrido', 'adarsh123', 'rileyroca', 'movi205', 'acregodean', 'pablosaavedra', 'maramtarek53', 's_coriolis', 'kakmeera1999', 'josepazmartin', 'travisc2', 'electronica18', 'kie180702', 'bhliu97', 'ematson5897', 'ashutoshsinghhenry6', 'martin32', 'maniphysics09', 'eduard25252598', 'moh.ashraf105', 'pablobou4', 'khazanv2', 'ahchehyan', 'hermidaitor', 'ramonruiz.infor', 'brannon44', 'scremin', 'aasifhameed99', 'wahidiah52', 'm939454', 'aboone06', 'bluelobster', 'gabrielyii99', 'veronica.mieites', 'jinwoo2', 'syin4', 'diamond92', 'bflores18', 'njgale01', 'mgk816', 'dkshelat']"
1,125,392,49,9,"['dcpang2', 'zehuahe2', 'jinsup2', 'kyang37', 'tss3', 'jinwoo2', 'hf4', 'avw2', 'zhixin2']",383,"['miri23', 'mohamedsameh', 'reemali99_', 'gc_1', 'kerryreto', 'zikrizaki88995', 'je_guilbert', 'jorgecastelo5', 'spazos7', 'soccadelic44', 'ahern0722', 'benoiturcotte', 'noureldin1999', 'alberfn', 'guttsfulltyagi', 'mavanzato0418', 'rkchapman', 'guibill10', 'ari6nd', 'michael2010814', 'happyleexin', 'omardeyaa', 'hong_gao', 'irenehb92', 'sandrabashara', 'nihatyavuz', 'akozych2', 'vikazvereva', 'danielfernandezcalo', 'anthonyroux', 'arrow823', 'aimansyaz99', 'annahaozheng0606', 'rocio', 'masonpb2', 'samashraf1', 'kirankumar94', 'prabuddha_888253127', 'carlosvigo1997', 'muvafikmelikkaya', 'amrebrahim', 'jtorres17', 'jzhan142', 'syedzakwan', 'samet1231234', 'kie180028', 'nadhnasorudin', 'ahmedsameh1698', 'acn562', 'moh.bahaa', 'arifjalani99', 'youssefsherif22', 'asyrafaqil', 'mjgebara14', 'camilolcastro97', 'bcperki2', 'azizijazam11', 'ahmedayman2370', 'rishu', 'ranasherif65', 'nuanno97', 'smrdafdl', 'brknshn', 'jbaggie2019', 'youssef2042000', 'olivier.gilbert.paquet', 'saipraneett', 'prakharbhargava0', 'nadja1', 'teoster50', 'mohaballam', 'ryanorem', 'shradhap', 'va844', 'neuroque', 'seifhabib', 'anibarseghyan', 'williammitchell5818', 'pingan99', 'mjoza2', 'mariz', 'virajput299', 'bleuminuit', 'ffazul64', 'paul.aniruddha', 'melaniejkramer', 'oliviercharbonneau', 'ilou', 'chengweiheng', 'evrenyigit', 'emilechouinard', 'pythagoras2', 'kason.carroll', 'malgaca', 'kie180031', 'carlosvillar54', 'ckim123', 'kychui2', 'kanet1234', 'mohabayman', 'sanchjai', 'nbs691', 'oishikfaruque', 'lauragdevesa', 'nowapoca', 'ahagras13', 'akash140410107098', 'chithong', 'saharoaf', 'amni99', 'svo4321', 'lino13', 'vblanco.nico', 'aimanadnan', 'alidsjt', 'dlee145', 'stambo', 'lauramolinosmayo', 'mateocampos', 'hamidausat', 'yjenyiee155', 'retty8', 'sebasket14', 'marcmagdy98', 'janalorenzolumbreras', 'marianne.gratton.1', 'trkmengkay', 'shaf31', 'youxing0309', 'nourananwar123', 'puertarcd', 'felivitullo87', 'manuelsomoza94', 'alecorti.pardo', 'muteki', 'corredoira', 'gabrielyii', 'staceyn2', 'kaitlinh', 'cbecker413', 'adam562', 'haclarke', 'xosegq16', 'e1150590', 'kalebhilde', 'adriancheah', 'jaimefookinlannister', 'tonybocadillosgrandes', 'rooban11', 'wowmuchchuck', 'xunyong', 'hishamzakaria20', 'rxtodd', 'sarapl', 'alimatama', 'jahnavikachhia', 'alexisdixon6', 'saegner2', 'pranjal3', 'berkaydean', 'baleko12345', 'sparshagarwal1009', 'xyz11', 'david.peral.moran', 'tingliang', 'isabelmaria.vazquez', 'aishu98', 'nadanasser1199', 'desmondsoon', 'keerthisv', 'musabmalek0717', 'mcruces.fz', 'tuberkargan_97', 'worldlineusaf', 'sealseal', 'bharath3', 'cloudyoverhead', 'dhvanil', 'ramy_maged4', 'lsleed', 'sriharshap', 'tyy233', 'njs035', 'ablahsaoud', 'nolmos96', 'shorouk_ossama', 'kaustubh.shirpurkar', 'pedrosiaba', 'coderko3', 'alifzulkifli99', 'alancantu57', 'baohl2', 'mengkem2', 'selena', 'tdubnansky6', 'ypp200', 'aengm', 'kartal', 'jacquelinethardin', 'mohameeddsamy', 'jipiccardi', 'amlibrahim', 'rahimnoorj', 'tamchouweng', 'elizametias12', 'efrenhub', 'mrefaat', 'ethanmorse', 'taymacnichols', 'ryanboucher', 'kirolosehab99', 'carlosbesadaromero', 'ericrobles', 'janeneil88', 'gxiao2', 'kimzihuang', 'anxovidal8', 'damlakubattt', 'andreadiazgar', 'lukunze1', 'joker632455', 'shuming2', 'j.haliburton', 'abieday1704', 'ozbunar01', 'ugur.cankaya.3718', 'nihaosawaddee', 'magic_ocean99', 'sinasigurpinar', 'tuberkargan', 'jarodm2', 'nabilah1403', 'amiruldanial99', 'yansi', 'cheokonn', 'ammaralaa516', 'juanmacano97', 'maxernest', 'marcosanllo', 'viratbhatt007', 'facundovia', 'michaelsaldana1', 'kie180073', 'bassamtarek', 'abbesalaeddine', 'restep2', 'estebanrial', 'martinzapata', '46harunakgul', 'talwren', 'leejq', 'mohammedemadeldin2000', 'jeanmichael.deschenes', 'miloaismanis', 'mmartinezsanchez', 'emrebuyukkose2', 'luciano.brignone', 'anwar909', 'ahmedamr', 'omarmagdy', 'abdurrahmn13', 'nikalyaamani', 'sdehoyos47', 'apascao', 'yubai', 'vincentpainchaud.vp', 'nagihankececi', 'nazimmath3', 'apb5472', 'rikardberger', 'mr4425', 'jacobzeshleman', 'guoyao', 'kiruthikaabalu181996', 'ikhbal', 'michael.mechelay', 'khor', 'david_atef', 'yaseminablacandir', 'c.a.stupka', 'amparo.castro.96', 'dhodapp', 'fkl217', 'farahsamir978', 'kie180039', 'atharva98', 'kph2', 'hafizmokh99', 'hilisa', 'kowjiajin', 'fred_dion', 'harshini9962', 'pvalladaresfdez', 'dancastaneda', 'jn1404', 'atx203', 'ammareltalli', 'amani12345', 'aaq', 'ledicia97', 'adriangarea', 'onaam8', 'siemprewowthechami', 'justin.lariviere.25', 'tbryan', 'ludovick.begin', 'david2397', 'tmi211', 'kie180079', 'physquig', 'zakhwan7', 'mallen22', 'amr_ua07', 'pip29', 'fcfrancapra94', 'cristinacigarran', 'vanesagarcia', 'adnanyuceer', 'fathy1104', 'perezsarmar', 'al4995', 'melroy_caeiro', 'helenalecoq97', 'caglanlee', 'afeefz', 'jpmcgee98', 'ales.gajdacz', 'masitadonmez', 'eddin21', 'gemma', 'hmoulvi1', 'elad.d', 'xxlilmontysignxx', 'farah26', 'latecnologiameodia', 'abdulrahim2905', 'exjamil', 'vickytubio', 'ozgurkablan26', 'lderemo', 'ankit6257', 'javierisma98', 'redzuan11', 'yeejou990318', 'david.garrido', 'adarsh123', 'rileyroca', 'movi205', 'acregodean', 'pablosaavedra', 'maramtarek53', 's_coriolis', 'kakmeera1999', 'josepazmartin', 'travisc2', 'electronica18', 'kie180702', 'bhliu97', 'ematson5897', 'ashutoshsinghhenry6', 'martin32', 'maniphysics09', 'eduard25252598', 'moh.ashraf105', 'pablobou4', 'khazanv2', 'ahchehyan', 'ramonruiz.infor', 'brannon44', 'scremin', 'aasifhameed99', 'wahidiah52', 'm939454', 'aboone06', 'bluelobster', 'gabrielyii99', 'veronica.mieites', 'syin4', 'diamond92', 'bflores18', 'njgale01', 'mgk816', 'dkshelat']",40,"['anunez38', 'rhalton2', 'pwalke9', 'kevinjl3', 'cbo3', 'danayun2', 'rvplank2', 'mw21', 'chguo2', 'ablee2', 'jgruber3', 'arhode2', 'wkeaty2', 'conanw2', 'vtagare2', 'tsehgal2', 'qiuhuic2', 'joshuas8', 'gcangi2', 'pittges2', 'domanus2', 'shirani', 'srb2', 'iflueck2', 'jtkach2', 'edimare2', 'ssutyak2', 'jkubota2', 'tz11', 'wsuk2', 'hjr2', 'lsienko2', 'anirula2', 'jjwilde2', 'chanmin2', 'txyang2', 'omarma2', 'naisong2', 'jungeun5', 'mblaauw2']",432,"['miri23', 'mohamedsameh', 'reemali99_', 'gc_1', 'kerryreto', 'zikrizaki88995', 'arhode2', 'je_guilbert', 'jorgecastelo5', 'spazos7', 'soccadelic44', 'ahern0722', 'benoiturcotte', 'noureldin1999', 'tsehgal2', 'alberfn', 'guttsfulltyagi', 'mavanzato0418', 'rkchapman', 'guibill10', 'ari6nd', 'michael2010814', 'happyleexin', 'omardeyaa', 'hong_gao', 'irenehb92', 'sandrabashara', 'nihatyavuz', 'akozych2', 'vikazvereva', 'danielfernandezcalo', 'anthonyroux', 'arrow823', 'aimansyaz99', 'annahaozheng0606', 'rocio', 'masonpb2', 'samashraf1', 'kirankumar94', 'prabuddha_888253127', 'carlosvigo1997', 'muvafikmelikkaya', 'amrebrahim', 'jtorres17', 'jzhan142', 'syedzakwan', 'samet1231234', 'kie180028', 'nadhnasorudin', 'avw2', 'ahmedsameh1698', 'pwalke9', 'acn562', 'moh.bahaa', 'arifjalani99', 'youssefsherif22', 'asyrafaqil', 'mjgebara14', 'camilolcastro97', 'bcperki2', 'azizijazam11', 'ahmedayman2370', 'rishu', 'ranasherif65', 'kyang37', 'qiuhuic2', 'nuanno97', 'smrdafdl', 'brknshn', 'jbaggie2019', 'youssef2042000', 'olivier.gilbert.paquet', 'saipraneett', 'prakharbhargava0', 'hf4', 'nadja1', 'teoster50', 'mohaballam', 'ryanorem', 'shradhap', 'va844', 'ssutyak2', 'neuroque', 'seifhabib', 'anibarseghyan', 'williammitchell5818', 'pingan99', 'mjoza2', 'mariz', 'virajput299', 'bleuminuit', 'ffazul64', 'paul.aniruddha', 'melaniejkramer', 'oliviercharbonneau', 'ilou', 'chengweiheng', 'evrenyigit', 'emilechouinard', 'pythagoras2', 'kason.carroll', 'malgaca', 'kie180031', 'carlosvillar54', 'ckim123', 'kychui2', 'kanet1234', 'mohabayman', 'chguo2', 'sanchjai', 'nbs691', 'oishikfaruque', 'jgruber3', 'lauragdevesa', 'nowapoca', 'ahagras13', 'akash140410107098', 'chithong', 'conanw2', 'saharoaf', 'amni99', 'svo4321', 'lino13', 'vblanco.nico', 'pittges2', 'aimanadnan', 'alidsjt', 'dlee145', 'stambo', 'lauramolinosmayo', 'srb2', 'mateocampos', 'hamidausat', 'yjenyiee155', 'retty8', 'sebasket14', 'marcmagdy98', 'janalorenzolumbreras', 'marianne.gratton.1', 'trkmengkay', 'shaf31', 'youxing0309', 'nourananwar123', 'puertarcd', 'felivitullo87', 'manuelsomoza94', 'alecorti.pardo', 'muteki', 'corredoira', 'gabrielyii', 'jinsup2', 'staceyn2', 'kaitlinh', 'cbecker413', 'adam562', 'haclarke', 'xosegq16', 'e1150590', 'kalebhilde', 'rvplank2', 'adriancheah', 'jaimefookinlannister', 'tonybocadillosgrandes', 'rooban11', 'wowmuchchuck', 'xunyong', 'hishamzakaria20', 'rxtodd', 'sarapl', 'alimatama', 'jahnavikachhia', 'alexisdixon6', 'saegner2', 'pranjal3', 'berkaydean', 'baleko12345', 'sparshagarwal1009', 'xyz11', 'david.peral.moran', 'tingliang', 'isabelmaria.vazquez', 'aishu98', 'nadanasser1199', 'desmondsoon', 'keerthisv', 'musabmalek0717', 'mcruces.fz', 'tuberkargan_97', 'worldlineusaf', 'sealseal', 'bharath3', 'cloudyoverhead', 'dhvanil', 'ramy_maged4', 'lsleed', 'zhixin2', 'sriharshap', 'tyy233', 'njs035', 'ablahsaoud', 'nolmos96', 'shorouk_ossama', 'kaustubh.shirpurkar', 'hjr2', 'pedrosiaba', 'coderko3', 'alifzulkifli99', 'alancantu57', 'baohl2', 'mengkem2', 'chanmin2', 'selena', 'tdubnansky6', 'ypp200', 'aengm', 'kartal', 'jacquelinethardin', 'jungeun5', 'mohameeddsamy', 'jipiccardi', 'amlibrahim', 'rahimnoorj', 'dcpang2', 'tamchouweng', 'elizametias12', 'efrenhub', 'mrefaat', 'mw21', 'ethanmorse', 'taymacnichols', 'ryanboucher', 'kirolosehab99', 'vtagare2', 'carlosbesadaromero', 'joshuas8', 'ericrobles', 'janeneil88', 'gxiao2', 'kimzihuang', 'anxovidal8', 'damlakubattt', 'andreadiazgar', 'lukunze1', 'joker632455', 'domanus2', 'shirani', 'shuming2', 'jkubota2', 'j.haliburton', 'abieday1704', 'ozbunar01', 'ugur.cankaya.3718', 'nihaosawaddee', 'magic_ocean99', 'sinasigurpinar', 'tuberkargan', 'jarodm2', 'nabilah1403', 'amiruldanial99', 'yansi', 'cheokonn', 'ammaralaa516', 'juanmacano97', 'maxernest', 'marcosanllo', 'viratbhatt007', 'facundovia', 'naisong2', 'mblaauw2', 'michaelsaldana1', 'kie180073', 'anunez38', 'rhalton2', 'kevinjl3', 'bassamtarek', 'abbesalaeddine', 'restep2', 'estebanrial', 'martinzapata', '46harunakgul', 'talwren', 'leejq', 'mohammedemadeldin2000', 'jeanmichael.deschenes', 'miloaismanis', 'mmartinezsanchez', 'emrebuyukkose2', 'luciano.brignone', 'anwar909', 'ahmedamr', 'omarmagdy', 'abdurrahmn13', 'nikalyaamani', 'sdehoyos47', 'gcangi2', 'apascao', 'yubai', 'vincentpainchaud.vp', 'nagihankececi', 'nazimmath3', 'apb5472', 'jtkach2', 'rikardberger', 'wsuk2', 'mr4425', 'jacobzeshleman', 'lsienko2', 'guoyao', 'kiruthikaabalu181996', 'jjwilde2', 'ikhbal', 'michael.mechelay', 'khor', 'david_atef', 'yaseminablacandir', 'c.a.stupka', 'amparo.castro.96', 'dhodapp', 'txyang2', 'fkl217', 'farahsamir978', 'kie180039', 'atharva98', 'kph2', 'hafizmokh99', 'hilisa', 'kowjiajin', 'fred_dion', 'harshini9962', 'pvalladaresfdez', 'dancastaneda', 'cbo3', 'danayun2', 'jn1404', 'atx203', 'ablee2', 'ammareltalli', 'amani12345', 'aaq', 'ledicia97', 'adriangarea', 'wkeaty2', 'onaam8', 'zehuahe2', 'siemprewowthechami', 'justin.lariviere.25', 'tbryan', 'ludovick.begin', 'tss3', 'david2397', 'tmi211', 'kie180079', 'physquig', 'zakhwan7', 'mallen22', 'amr_ua07', 'pip29', 'fcfrancapra94', 'cristinacigarran', 'vanesagarcia', 'tz11', 'adnanyuceer', 'fathy1104', 'perezsarmar', 'al4995', 'melroy_caeiro', 'helenalecoq97', 'caglanlee', 'afeefz', 'jpmcgee98', 'ales.gajdacz', 'masitadonmez', 'eddin21', 'gemma', 'hmoulvi1', 'elad.d', 'xxlilmontysignxx', 'farah26', 'latecnologiameodia', 'abdulrahim2905', 'exjamil', 'vickytubio', 'ozgurkablan26', 'lderemo', 'ankit6257', 'javierisma98', 'redzuan11', 'yeejou990318', 'david.garrido', 'adarsh123', 'rileyroca', 'movi205', 'acregodean', 'pablosaavedra', 'maramtarek53', 's_coriolis', 'kakmeera1999', 'josepazmartin', 'travisc2', 'electronica18', 'kie180702', 'bhliu97', 'ematson5897', 'ashutoshsinghhenry6', 'martin32', 'maniphysics09', 'eduard25252598', 'iflueck2', 'moh.ashraf105', 'edimare2', 'pablobou4', 'khazanv2', 'ahchehyan', 'ramonruiz.infor', 'brannon44', 'anirula2', 'scremin', 'aasifhameed99', 'wahidiah52', 'm939454', 'aboone06', 'bluelobster', 'gabrielyii99', 'veronica.mieites', 'jinwoo2', 'syin4', 'diamond92', 'bflores18', 'njgale01', 'omarma2', 'mgk816', 'dkshelat']"
1,16,392,45,40,"['miri23', 'david.garrido', 'efrenhub', 'tonybocadillosgrandes', 'martinzapata', 'movi205', 'ledicia97', 'acregodean', 'adriangarea', 'sarapl', 'alimatama', 'camilolcastro97', 'mmartinezsanchez', 'josepazmartin', 'siemprewowthechami', 'carlosbesadaromero', 'electronica18', 'svo4321', 'isabelmaria.vazquez', 'alberfn', 'vblanco.nico', 'alidsjt', 'apascao', 'anxovidal8', 'mateocampos', 'cristinacigarran', 'vanesagarcia', 'janalorenzolumbreras', 'pedrosiaba', 'danielfernandezcalo', 'helenalecoq97', 'puertarcd', 'gemma', 'alecorti.pardo', 'amparo.castro.96', 'maxernest', 'veronica.mieites', 'vickytubio', 'xosegq16', 'malgaca']",352,"['mohamedsameh', 'reemali99_', 'gc_1', 'kerryreto', 'zikrizaki88995', 'je_guilbert', 'jorgecastelo5', 'spazos7', 'soccadelic44', 'ahern0722', 'benoiturcotte', 'noureldin1999', 'guttsfulltyagi', 'mavanzato0418', 'rkchapman', 'guibill10', 'ari6nd', 'michael2010814', 'happyleexin', 'omardeyaa', 'hong_gao', 'irenehb92', 'sandrabashara', 'nihatyavuz', 'akozych2', 'vikazvereva', 'anthonyroux', 'arrow823', 'aimansyaz99', 'annahaozheng0606', 'rocio', 'masonpb2', 'samashraf1', 'kirankumar94', 'prabuddha_888253127', 'carlosvigo1997', 'muvafikmelikkaya', 'amrebrahim', 'jtorres17', 'jzhan142', 'syedzakwan', 'samet1231234', 'kie180028', 'nadhnasorudin', 'avw2', 'ahmedsameh1698', 'acn562', 'moh.bahaa', 'arifjalani99', 'youssefsherif22', 'asyrafaqil', 'mjgebara14', 'bcperki2', 'azizijazam11', 'ahmedayman2370', 'rishu', 'ranasherif65', 'kyang37', 'nuanno97', 'smrdafdl', 'brknshn', 'jbaggie2019', 'youssef2042000', 'olivier.gilbert.paquet', 'saipraneett', 'prakharbhargava0', 'hf4', 'nadja1', 'teoster50', 'mohaballam', 'ryanorem', 'shradhap', 'va844', 'neuroque', 'seifhabib', 'anibarseghyan', 'williammitchell5818', 'pingan99', 'mjoza2', 'mariz', 'virajput299', 'bleuminuit', 'ffazul64', 'paul.aniruddha', 'melaniejkramer', 'oliviercharbonneau', 'ilou', 'chengweiheng', 'evrenyigit', 'emilechouinard', 'pythagoras2', 'kason.carroll', 'kie180031', 'carlosvillar54', 'ckim123', 'kychui2', 'kanet1234', 'mohabayman', 'sanchjai', 'nbs691', 'oishikfaruque', 'lauragdevesa', 'nowapoca', 'ahagras13', 'akash140410107098', 'chithong', 'saharoaf', 'amni99', 'lino13', 'aimanadnan', 'dlee145', 'stambo', 'lauramolinosmayo', 'hamidausat', 'yjenyiee155', 'retty8', 'sebasket14', 'marcmagdy98', 'marianne.gratton.1', 'trkmengkay', 'shaf31', 'youxing0309', 'nourananwar123', 'felivitullo87', 'manuelsomoza94', 'muteki', 'corredoira', 'gabrielyii', 'jinsup2', 'staceyn2', 'kaitlinh', 'cbecker413', 'adam562', 'haclarke', 'e1150590', 'kalebhilde', 'adriancheah', 'jaimefookinlannister', 'rooban11', 'wowmuchchuck', 'xunyong', 'hishamzakaria20', 'rxtodd', 'jahnavikachhia', 'alexisdixon6', 'saegner2', 'pranjal3', 'berkaydean', 'baleko12345', 'sparshagarwal1009', 'xyz11', 'david.peral.moran', 'tingliang', 'aishu98', 'nadanasser1199', 'desmondsoon', 'keerthisv', 'musabmalek0717', 'mcruces.fz', 'tuberkargan_97', 'worldlineusaf', 'sealseal', 'bharath3', 'cloudyoverhead', 'dhvanil', 'ramy_maged4', 'lsleed', 'zhixin2', 'sriharshap', 'tyy233', 'njs035', 'ablahsaoud', 'nolmos96', 'shorouk_ossama', 'kaustubh.shirpurkar', 'coderko3', 'alifzulkifli99', 'alancantu57', 'baohl2', 'mengkem2', 'selena', 'tdubnansky6', 'ypp200', 'aengm', 'kartal', 'jacquelinethardin', 'mohameeddsamy', 'jipiccardi', 'amlibrahim', 'rahimnoorj', 'dcpang2', 'tamchouweng', 'elizametias12', 'mrefaat', 'ethanmorse', 'taymacnichols', 'ryanboucher', 'kirolosehab99', 'ericrobles', 'janeneil88', 'gxiao2', 'kimzihuang', 'damlakubattt', 'andreadiazgar', 'lukunze1', 'joker632455', 'shuming2', 'j.haliburton', 'abieday1704', 'ozbunar01', 'ugur.cankaya.3718', 'nihaosawaddee', 'magic_ocean99', 'sinasigurpinar', 'tuberkargan', 'jarodm2', 'nabilah1403', 'amiruldanial99', 'yansi', 'cheokonn', 'ammaralaa516', 'juanmacano97', 'marcosanllo', 'viratbhatt007', 'facundovia', 'michaelsaldana1', 'kie180073', 'bassamtarek', 'abbesalaeddine', 'restep2', 'estebanrial', '46harunakgul', 'talwren', 'leejq', 'mohammedemadeldin2000', 'jeanmichael.deschenes', 'miloaismanis', 'emrebuyukkose2', 'luciano.brignone', 'anwar909', 'ahmedamr', 'omarmagdy', 'abdurrahmn13', 'nikalyaamani', 'sdehoyos47', 'yubai', 'vincentpainchaud.vp', 'nagihankececi', 'nazimmath3', 'apb5472', 'rikardberger', 'mr4425', 'jacobzeshleman', 'guoyao', 'kiruthikaabalu181996', 'ikhbal', 'michael.mechelay', 'khor', 'david_atef', 'yaseminablacandir', 'c.a.stupka', 'dhodapp', 'fkl217', 'farahsamir978', 'kie180039', 'atharva98', 'kph2', 'hafizmokh99', 'hilisa', 'kowjiajin', 'fred_dion', 'harshini9962', 'pvalladaresfdez', 'dancastaneda', 'jn1404', 'atx203', 'ammareltalli', 'amani12345', 'aaq', 'onaam8', 'zehuahe2', 'justin.lariviere.25', 'tbryan', 'ludovick.begin', 'tss3', 'david2397', 'tmi211', 'kie180079', 'physquig', 'zakhwan7', 'mallen22', 'amr_ua07', 'pip29', 'fcfrancapra94', 'adnanyuceer', 'fathy1104', 'perezsarmar', 'al4995', 'melroy_caeiro', 'caglanlee', 'afeefz', 'jpmcgee98', 'ales.gajdacz', 'masitadonmez', 'eddin21', 'hmoulvi1', 'elad.d', 'xxlilmontysignxx', 'farah26', 'latecnologiameodia', 'abdulrahim2905', 'exjamil', 'ozgurkablan26', 'lderemo', 'ankit6257', 'javierisma98', 'redzuan11', 'yeejou990318', 'adarsh123', 'rileyroca', 'pablosaavedra', 'maramtarek53', 's_coriolis', 'kakmeera1999', 'travisc2', 'kie180702', 'bhliu97', 'ematson5897', 'ashutoshsinghhenry6', 'martin32', 'maniphysics09', 'eduard25252598', 'moh.ashraf105', 'pablobou4', 'khazanv2', 'ahchehyan', 'ramonruiz.infor', 'brannon44', 'scremin', 'aasifhameed99', 'wahidiah52', 'm939454', 'aboone06', 'bluelobster', 'gabrielyii99', 'jinwoo2', 'syin4', 'diamond92', 'bflores18', 'njgale01', 'mgk816', 'dkshelat']",5,"['hermidaitor', 'iago', 'loisonchambers', 'dfl', 'adfoz']",397,"['miri23', 'mohamedsameh', 'reemali99_', 'gc_1', 'kerryreto', 'zikrizaki88995', 'je_guilbert', 'jorgecastelo5', 'spazos7', 'soccadelic44', 'ahern0722', 'benoiturcotte', 'noureldin1999', 'alberfn', 'guttsfulltyagi', 'mavanzato0418', 'loisonchambers', 'rkchapman', 'guibill10', 'ari6nd', 'michael2010814', 'happyleexin', 'omardeyaa', 'hong_gao', 'irenehb92', 'sandrabashara', 'nihatyavuz', 'akozych2', 'vikazvereva', 'danielfernandezcalo', 'anthonyroux', 'arrow823', 'aimansyaz99', 'annahaozheng0606', 'rocio', 'masonpb2', 'samashraf1', 'kirankumar94', 'prabuddha_888253127', 'carlosvigo1997', 'muvafikmelikkaya', 'amrebrahim', 'jtorres17', 'jzhan142', 'syedzakwan', 'samet1231234', 'kie180028', 'nadhnasorudin', 'avw2', 'ahmedsameh1698', 'acn562', 'moh.bahaa', 'arifjalani99', 'youssefsherif22', 'asyrafaqil', 'mjgebara14', 'camilolcastro97', 'bcperki2', 'azizijazam11', 'ahmedayman2370', 'rishu', 'ranasherif65', 'kyang37', 'nuanno97', 'smrdafdl', 'brknshn', 'jbaggie2019', 'youssef2042000', 'olivier.gilbert.paquet', 'saipraneett', 'prakharbhargava0', 'hf4', 'nadja1', 'teoster50', 'mohaballam', 'ryanorem', 'shradhap', 'va844', 'neuroque', 'seifhabib', 'anibarseghyan', 'williammitchell5818', 'pingan99', 'mjoza2', 'mariz', 'virajput299', 'bleuminuit', 'ffazul64', 'paul.aniruddha', 'melaniejkramer', 'oliviercharbonneau', 'ilou', 'chengweiheng', 'evrenyigit', 'emilechouinard', 'pythagoras2', 'kason.carroll', 'malgaca', 'kie180031', 'carlosvillar54', 'ckim123', 'kychui2', 'kanet1234', 'mohabayman', 'sanchjai', 'nbs691', 'oishikfaruque', 'iago', 'lauragdevesa', 'nowapoca', 'ahagras13', 'akash140410107098', 'chithong', 'saharoaf', 'amni99', 'svo4321', 'lino13', 'vblanco.nico', 'aimanadnan', 'alidsjt', 'dlee145', 'stambo', 'lauramolinosmayo', 'mateocampos', 'hamidausat', 'yjenyiee155', 'retty8', 'sebasket14', 'marcmagdy98', 'janalorenzolumbreras', 'marianne.gratton.1', 'trkmengkay', 'shaf31', 'youxing0309', 'nourananwar123', 'puertarcd', 'felivitullo87', 'manuelsomoza94', 'alecorti.pardo', 'muteki', 'corredoira', 'gabrielyii', 'jinsup2', 'staceyn2', 'kaitlinh', 'cbecker413', 'adam562', 'haclarke', 'xosegq16', 'adfoz', 'e1150590', 'kalebhilde', 'adriancheah', 'jaimefookinlannister', 'tonybocadillosgrandes', 'rooban11', 'wowmuchchuck', 'xunyong', 'hishamzakaria20', 'rxtodd', 'sarapl', 'alimatama', 'jahnavikachhia', 'alexisdixon6', 'saegner2', 'pranjal3', 'berkaydean', 'baleko12345', 'sparshagarwal1009', 'xyz11', 'david.peral.moran', 'tingliang', 'isabelmaria.vazquez', 'aishu98', 'nadanasser1199', 'desmondsoon', 'keerthisv', 'musabmalek0717', 'mcruces.fz', 'tuberkargan_97', 'worldlineusaf', 'sealseal', 'bharath3', 'dfl', 'cloudyoverhead', 'dhvanil', 'ramy_maged4', 'lsleed', 'zhixin2', 'sriharshap', 'tyy233', 'njs035', 'ablahsaoud', 'nolmos96', 'shorouk_ossama', 'kaustubh.shirpurkar', 'pedrosiaba', 'coderko3', 'alifzulkifli99', 'alancantu57', 'baohl2', 'mengkem2', 'selena', 'tdubnansky6', 'ypp200', 'aengm', 'kartal', 'jacquelinethardin', 'mohameeddsamy', 'jipiccardi', 'amlibrahim', 'rahimnoorj', 'dcpang2', 'tamchouweng', 'elizametias12', 'efrenhub', 'mrefaat', 'ethanmorse', 'taymacnichols', 'ryanboucher', 'kirolosehab99', 'carlosbesadaromero', 'ericrobles', 'janeneil88', 'gxiao2', 'kimzihuang', 'anxovidal8', 'damlakubattt', 'andreadiazgar', 'lukunze1', 'joker632455', 'shuming2', 'j.haliburton', 'abieday1704', 'ozbunar01', 'ugur.cankaya.3718', 'nihaosawaddee', 'magic_ocean99', 'sinasigurpinar', 'tuberkargan', 'jarodm2', 'nabilah1403', 'amiruldanial99', 'yansi', 'cheokonn', 'ammaralaa516', 'juanmacano97', 'maxernest', 'marcosanllo', 'viratbhatt007', 'facundovia', 'michaelsaldana1', 'kie180073', 'bassamtarek', 'abbesalaeddine', 'restep2', 'estebanrial', 'martinzapata', '46harunakgul', 'talwren', 'leejq', 'mohammedemadeldin2000', 'jeanmichael.deschenes', 'miloaismanis', 'mmartinezsanchez', 'emrebuyukkose2', 'luciano.brignone', 'anwar909', 'ahmedamr', 'omarmagdy', 'abdurrahmn13', 'nikalyaamani', 'sdehoyos47', 'apascao', 'yubai', 'vincentpainchaud.vp', 'nagihankececi', 'nazimmath3', 'apb5472', 'rikardberger', 'mr4425', 'jacobzeshleman', 'guoyao', 'kiruthikaabalu181996', 'ikhbal', 'michael.mechelay', 'khor', 'david_atef', 'yaseminablacandir', 'c.a.stupka', 'amparo.castro.96', 'dhodapp', 'fkl217', 'farahsamir978', 'kie180039', 'atharva98', 'kph2', 'hafizmokh99', 'hilisa', 'kowjiajin', 'fred_dion', 'harshini9962', 'pvalladaresfdez', 'dancastaneda', 'jn1404', 'atx203', 'ammareltalli', 'amani12345', 'aaq', 'ledicia97', 'adriangarea', 'onaam8', 'zehuahe2', 'siemprewowthechami', 'justin.lariviere.25', 'tbryan', 'ludovick.begin', 'tss3', 'david2397', 'tmi211', 'kie180079', 'physquig', 'zakhwan7', 'mallen22', 'amr_ua07', 'pip29', 'fcfrancapra94', 'cristinacigarran', 'vanesagarcia', 'adnanyuceer', 'fathy1104', 'perezsarmar', 'al4995', 'melroy_caeiro', 'helenalecoq97', 'caglanlee', 'afeefz', 'jpmcgee98', 'ales.gajdacz', 'masitadonmez', 'eddin21', 'gemma', 'hmoulvi1', 'elad.d', 'xxlilmontysignxx', 'farah26', 'latecnologiameodia', 'abdulrahim2905', 'exjamil', 'vickytubio', 'ozgurkablan26', 'lderemo', 'ankit6257', 'javierisma98', 'redzuan11', 'yeejou990318', 'david.garrido', 'adarsh123', 'rileyroca', 'movi205', 'acregodean', 'pablosaavedra', 'maramtarek53', 's_coriolis', 'kakmeera1999', 'josepazmartin', 'travisc2', 'electronica18', 'kie180702', 'bhliu97', 'ematson5897', 'ashutoshsinghhenry6', 'martin32', 'maniphysics09', 'eduard25252598', 'moh.ashraf105', 'pablobou4', 'khazanv2', 'ahchehyan', 'hermidaitor', 'ramonruiz.infor', 'brannon44', 'scremin', 'aasifhameed99', 'wahidiah52', 'm939454', 'aboone06', 'bluelobster', 'gabrielyii99', 'veronica.mieites', 'jinwoo2', 'syin4', 'diamond92', 'bflores18', 'njgale01', 'mgk816', 'dkshelat']"
1,30,392,42,41,"['ahmedsameh1698', 'bassamtarek', 'elizametias12', 'mohamedsameh', 'reemali99_', 'moh.bahaa', 'mohabayman', 'mrefaat', 'mohammedemadeldin2000', 'ammareltalli', 'youssefsherif22', 'maramtarek53', 'hishamzakaria20', 'kirolosehab99', 'ahmedamr', 'noureldin1999', 'omarmagdy', 'ahmedayman2370', 'nadanasser1199', 'ranasherif65', 'youssef2042000', 'omardeyaa', 'mohaballam', 'ramy_maged4', 'amr_ua07', 'moh.ashraf105', 'seifhabib', 'marcmagdy98', 'shorouk_ossama', 'sandrabashara', 'mariz', 'fathy1104', 'nourananwar123', 'ammaralaa516', 'david_atef', 'muteki', 'farahsamir978', 'farah26', 'amrebrahim', 'mohameeddsamy', 'amlibrahim']",351,"['miri23', 'gc_1', 'kerryreto', 'zikrizaki88995', 'je_guilbert', 'jorgecastelo5', 'spazos7', 'soccadelic44', 'ahern0722', 'benoiturcotte', 'alberfn', 'guttsfulltyagi', 'mavanzato0418', 'rkchapman', 'guibill10', 'ari6nd', 'michael2010814', 'happyleexin', 'hong_gao', 'irenehb92', 'nihatyavuz', 'akozych2', 'vikazvereva', 'danielfernandezcalo', 'anthonyroux', 'arrow823', 'aimansyaz99', 'annahaozheng0606', 'rocio', 'masonpb2', 'samashraf1', 'kirankumar94', 'prabuddha_888253127', 'carlosvigo1997', 'muvafikmelikkaya', 'jtorres17', 'jzhan142', 'syedzakwan', 'samet1231234', 'kie180028', 'nadhnasorudin', 'avw2', 'acn562', 'arifjalani99', 'asyrafaqil', 'mjgebara14', 'camilolcastro97', 'bcperki2', 'azizijazam11', 'rishu', 'kyang37', 'nuanno97', 'smrdafdl', 'brknshn', 'jbaggie2019', 'olivier.gilbert.paquet', 'saipraneett', 'prakharbhargava0', 'hf4', 'nadja1', 'teoster50', 'ryanorem', 'shradhap', 'va844', 'neuroque', 'anibarseghyan', 'williammitchell5818', 'pingan99', 'mjoza2', 'virajput299', 'bleuminuit', 'ffazul64', 'paul.aniruddha', 'melaniejkramer', 'oliviercharbonneau', 'ilou', 'chengweiheng', 'evrenyigit', 'emilechouinard', 'pythagoras2', 'kason.carroll', 'malgaca', 'kie180031', 'carlosvillar54', 'ckim123', 'kychui2', 'kanet1234', 'sanchjai', 'nbs691', 'oishikfaruque', 'lauragdevesa', 'nowapoca', 'ahagras13', 'akash140410107098', 'chithong', 'saharoaf', 'amni99', 'svo4321', 'lino13', 'vblanco.nico', 'aimanadnan', 'alidsjt', 'dlee145', 'stambo', 'lauramolinosmayo', 'mateocampos', 'hamidausat', 'yjenyiee155', 'retty8', 'sebasket14', 'janalorenzolumbreras', 'marianne.gratton.1', 'trkmengkay', 'shaf31', 'youxing0309', 'puertarcd', 'felivitullo87', 'manuelsomoza94', 'alecorti.pardo', 'corredoira', 'gabrielyii', 'jinsup2', 'staceyn2', 'kaitlinh', 'cbecker413', 'adam562', 'haclarke', 'xosegq16', 'e1150590', 'kalebhilde', 'adriancheah', 'jaimefookinlannister', 'tonybocadillosgrandes', 'rooban11', 'wowmuchchuck', 'xunyong', 'rxtodd', 'sarapl', 'alimatama', 'jahnavikachhia', 'alexisdixon6', 'saegner2', 'pranjal3', 'berkaydean', 'baleko12345', 'sparshagarwal1009', 'xyz11', 'david.peral.moran', 'tingliang', 'isabelmaria.vazquez', 'aishu98', 'desmondsoon', 'keerthisv', 'musabmalek0717', 'mcruces.fz', 'tuberkargan_97', 'worldlineusaf', 'sealseal', 'bharath3', 'cloudyoverhead', 'dhvanil', 'lsleed', 'zhixin2', 'sriharshap', 'tyy233', 'njs035', 'ablahsaoud', 'nolmos96', 'kaustubh.shirpurkar', 'pedrosiaba', 'coderko3', 'alifzulkifli99', 'alancantu57', 'baohl2', 'mengkem2', 'selena', 'tdubnansky6', 'ypp200', 'aengm', 'kartal', 'jacquelinethardin', 'jipiccardi', 'rahimnoorj', 'dcpang2', 'tamchouweng', 'efrenhub', 'ethanmorse', 'taymacnichols', 'ryanboucher', 'carlosbesadaromero', 'ericrobles', 'janeneil88', 'gxiao2', 'kimzihuang', 'anxovidal8', 'damlakubattt', 'andreadiazgar', 'lukunze1', 'joker632455', 'shuming2', 'j.haliburton', 'abieday1704', 'ozbunar01', 'ugur.cankaya.3718', 'nihaosawaddee', 'magic_ocean99', 'sinasigurpinar', 'tuberkargan', 'jarodm2', 'nabilah1403', 'amiruldanial99', 'yansi', 'cheokonn', 'juanmacano97', 'maxernest', 'marcosanllo', 'viratbhatt007', 'facundovia', 'michaelsaldana1', 'kie180073', 'abbesalaeddine', 'restep2', 'estebanrial', 'martinzapata', '46harunakgul', 'talwren', 'leejq', 'jeanmichael.deschenes', 'miloaismanis', 'mmartinezsanchez', 'emrebuyukkose2', 'luciano.brignone', 'anwar909', 'abdurrahmn13', 'nikalyaamani', 'sdehoyos47', 'apascao', 'yubai', 'vincentpainchaud.vp', 'nagihankececi', 'nazimmath3', 'apb5472', 'rikardberger', 'mr4425', 'jacobzeshleman', 'guoyao', 'kiruthikaabalu181996', 'ikhbal', 'michael.mechelay', 'khor', 'yaseminablacandir', 'c.a.stupka', 'amparo.castro.96', 'dhodapp', 'fkl217', 'kie180039', 'atharva98', 'kph2', 'hafizmokh99', 'hilisa', 'kowjiajin', 'fred_dion', 'harshini9962', 'pvalladaresfdez', 'dancastaneda', 'jn1404', 'atx203', 'amani12345', 'aaq', 'ledicia97', 'adriangarea', 'onaam8', 'zehuahe2', 'siemprewowthechami', 'justin.lariviere.25', 'tbryan', 'ludovick.begin', 'tss3', 'david2397', 'tmi211', 'kie180079', 'physquig', 'zakhwan7', 'mallen22', 'pip29', 'fcfrancapra94', 'cristinacigarran', 'vanesagarcia', 'adnanyuceer', 'perezsarmar', 'al4995', 'melroy_caeiro', 'helenalecoq97', 'caglanlee', 'afeefz', 'jpmcgee98', 'ales.gajdacz', 'masitadonmez', 'eddin21', 'gemma', 'hmoulvi1', 'elad.d', 'xxlilmontysignxx', 'latecnologiameodia', 'abdulrahim2905', 'exjamil', 'vickytubio', 'ozgurkablan26', 'lderemo', 'ankit6257', 'javierisma98', 'redzuan11', 'yeejou990318', 'david.garrido', 'adarsh123', 'rileyroca', 'movi205', 'acregodean', 'pablosaavedra', 's_coriolis', 'kakmeera1999', 'josepazmartin', 'travisc2', 'electronica18', 'kie180702', 'bhliu97', 'ematson5897', 'ashutoshsinghhenry6', 'martin32', 'maniphysics09', 'eduard25252598', 'pablobou4', 'khazanv2', 'ahchehyan', 'ramonruiz.infor', 'brannon44', 'scremin', 'aasifhameed99', 'wahidiah52', 'm939454', 'aboone06', 'bluelobster', 'gabrielyii99', 'veronica.mieites', 'jinwoo2', 'syin4', 'diamond92', 'bflores18', 'njgale01', 'mgk816', 'dkshelat']",1,['omarmoatasem'],393,"['miri23', 'mohamedsameh', 'reemali99_', 'gc_1', 'kerryreto', 'zikrizaki88995', 'je_guilbert', 'jorgecastelo5', 'spazos7', 'soccadelic44', 'ahern0722', 'benoiturcotte', 'noureldin1999', 'alberfn', 'guttsfulltyagi', 'mavanzato0418', 'rkchapman', 'guibill10', 'ari6nd', 'michael2010814', 'happyleexin', 'omardeyaa', 'hong_gao', 'irenehb92', 'sandrabashara', 'nihatyavuz', 'akozych2', 'vikazvereva', 'danielfernandezcalo', 'anthonyroux', 'arrow823', 'aimansyaz99', 'annahaozheng0606', 'rocio', 'masonpb2', 'samashraf1', 'kirankumar94', 'prabuddha_888253127', 'carlosvigo1997', 'muvafikmelikkaya', 'amrebrahim', 'jtorres17', 'jzhan142', 'syedzakwan', 'samet1231234', 'kie180028', 'nadhnasorudin', 'avw2', 'ahmedsameh1698', 'acn562', 'moh.bahaa', 'arifjalani99', 'youssefsherif22', 'asyrafaqil', 'mjgebara14', 'camilolcastro97', 'bcperki2', 'azizijazam11', 'ahmedayman2370', 'rishu', 'ranasherif65', 'kyang37', 'nuanno97', 'smrdafdl', 'brknshn', 'jbaggie2019', 'youssef2042000', 'olivier.gilbert.paquet', 'saipraneett', 'prakharbhargava0', 'hf4', 'nadja1', 'teoster50', 'mohaballam', 'ryanorem', 'shradhap', 'va844', 'neuroque', 'seifhabib', 'anibarseghyan', 'williammitchell5818', 'pingan99', 'mjoza2', 'mariz', 'virajput299', 'bleuminuit', 'ffazul64', 'paul.aniruddha', 'melaniejkramer', 'oliviercharbonneau', 'ilou', 'chengweiheng', 'evrenyigit', 'emilechouinard', 'pythagoras2', 'kason.carroll', 'malgaca', 'kie180031', 'carlosvillar54', 'ckim123', 'kychui2', 'kanet1234', 'mohabayman', 'sanchjai', 'nbs691', 'oishikfaruque', 'lauragdevesa', 'nowapoca', 'ahagras13', 'akash140410107098', 'chithong', 'saharoaf', 'amni99', 'svo4321', 'lino13', 'vblanco.nico', 'aimanadnan', 'alidsjt', 'dlee145', 'stambo', 'lauramolinosmayo', 'mateocampos', 'hamidausat', 'yjenyiee155', 'retty8', 'sebasket14', 'marcmagdy98', 'janalorenzolumbreras', 'marianne.gratton.1', 'trkmengkay', 'shaf31', 'youxing0309', 'nourananwar123', 'puertarcd', 'felivitullo87', 'manuelsomoza94', 'alecorti.pardo', 'muteki', 'corredoira', 'gabrielyii', 'jinsup2', 'staceyn2', 'kaitlinh', 'cbecker413', 'adam562', 'haclarke', 'xosegq16', 'e1150590', 'kalebhilde', 'adriancheah', 'jaimefookinlannister', 'tonybocadillosgrandes', 'rooban11', 'wowmuchchuck', 'xunyong', 'hishamzakaria20', 'rxtodd', 'sarapl', 'alimatama', 'jahnavikachhia', 'alexisdixon6', 'saegner2', 'pranjal3', 'berkaydean', 'baleko12345', 'sparshagarwal1009', 'xyz11', 'david.peral.moran', 'tingliang', 'isabelmaria.vazquez', 'aishu98', 'nadanasser1199', 'desmondsoon', 'keerthisv', 'musabmalek0717', 'mcruces.fz', 'tuberkargan_97', 'worldlineusaf', 'sealseal', 'bharath3', 'cloudyoverhead', 'dhvanil', 'ramy_maged4', 'lsleed', 'zhixin2', 'sriharshap', 'tyy233', 'njs035', 'ablahsaoud', 'nolmos96', 'shorouk_ossama', 'kaustubh.shirpurkar', 'pedrosiaba', 'coderko3', 'alifzulkifli99', 'alancantu57', 'baohl2', 'mengkem2', 'selena', 'tdubnansky6', 'omarmoatasem', 'ypp200', 'aengm', 'kartal', 'jacquelinethardin', 'mohameeddsamy', 'jipiccardi', 'amlibrahim', 'rahimnoorj', 'dcpang2', 'tamchouweng', 'elizametias12', 'efrenhub', 'mrefaat', 'ethanmorse', 'taymacnichols', 'ryanboucher', 'kirolosehab99', 'carlosbesadaromero', 'ericrobles', 'janeneil88', 'gxiao2', 'kimzihuang', 'anxovidal8', 'damlakubattt', 'andreadiazgar', 'lukunze1', 'joker632455', 'shuming2', 'j.haliburton', 'abieday1704', 'ozbunar01', 'ugur.cankaya.3718', 'nihaosawaddee', 'magic_ocean99', 'sinasigurpinar', 'tuberkargan', 'jarodm2', 'nabilah1403', 'amiruldanial99', 'yansi', 'cheokonn', 'ammaralaa516', 'juanmacano97', 'maxernest', 'marcosanllo', 'viratbhatt007', 'facundovia', 'michaelsaldana1', 'kie180073', 'bassamtarek', 'abbesalaeddine', 'restep2', 'estebanrial', 'martinzapata', '46harunakgul', 'talwren', 'leejq', 'mohammedemadeldin2000', 'jeanmichael.deschenes', 'miloaismanis', 'mmartinezsanchez', 'emrebuyukkose2', 'luciano.brignone', 'anwar909', 'ahmedamr', 'omarmagdy', 'abdurrahmn13', 'nikalyaamani', 'sdehoyos47', 'apascao', 'yubai', 'vincentpainchaud.vp', 'nagihankececi', 'nazimmath3', 'apb5472', 'rikardberger', 'mr4425', 'jacobzeshleman', 'guoyao', 'kiruthikaabalu181996', 'ikhbal', 'michael.mechelay', 'khor', 'david_atef', 'yaseminablacandir', 'c.a.stupka', 'amparo.castro.96', 'dhodapp', 'fkl217', 'farahsamir978', 'kie180039', 'atharva98', 'kph2', 'hafizmokh99', 'hilisa', 'kowjiajin', 'fred_dion', 'harshini9962', 'pvalladaresfdez', 'dancastaneda', 'jn1404', 'atx203', 'ammareltalli', 'amani12345', 'aaq', 'ledicia97', 'adriangarea', 'onaam8', 'zehuahe2', 'siemprewowthechami', 'justin.lariviere.25', 'tbryan', 'ludovick.begin', 'tss3', 'david2397', 'tmi211', 'kie180079', 'physquig', 'zakhwan7', 'mallen22', 'amr_ua07', 'pip29', 'fcfrancapra94', 'cristinacigarran', 'vanesagarcia', 'adnanyuceer', 'fathy1104', 'perezsarmar', 'al4995', 'melroy_caeiro', 'helenalecoq97', 'caglanlee', 'afeefz', 'jpmcgee98', 'ales.gajdacz', 'masitadonmez', 'eddin21', 'gemma', 'hmoulvi1', 'elad.d', 'xxlilmontysignxx', 'farah26', 'latecnologiameodia', 'abdulrahim2905', 'exjamil', 'vickytubio', 'ozgurkablan26', 'lderemo', 'ankit6257', 'javierisma98', 'redzuan11', 'yeejou990318', 'david.garrido', 'adarsh123', 'rileyroca', 'movi205', 'acregodean', 'pablosaavedra', 'maramtarek53', 's_coriolis', 'kakmeera1999', 'josepazmartin', 'travisc2', 'electronica18', 'kie180702', 'bhliu97', 'ematson5897', 'ashutoshsinghhenry6', 'martin32', 'maniphysics09', 'eduard25252598', 'moh.ashraf105', 'pablobou4', 'khazanv2', 'ahchehyan', 'ramonruiz.infor', 'brannon44', 'scremin', 'aasifhameed99', 'wahidiah52', 'm939454', 'aboone06', 'bluelobster', 'gabrielyii99', 'veronica.mieites', 'jinwoo2', 'syin4', 'diamond92', 'bflores18', 'njgale01', 'mgk816', 'dkshelat']"
1,27,392,37,31,"['miri23', 'david.garrido', 'martinzapata', 'ledicia97', 'acregodean', 'jorgecastelo5', 'sarapl', 'josepazmartin', 'siemprewowthechami', 'carlosbesadaromero', 'svo4321', 'isabelmaria.vazquez', 'alberfn', 'lino13', 'vblanco.nico', 'david2397', 'apascao', 'martin32', 'andreadiazgar', 'cristinacigarran', 'vanesagarcia', 'janalorenzolumbreras', 'pedrosiaba', 'danielfernandezcalo', 'helenalecoq97', 'gemma', 'alecorti.pardo', 'manuelsomoza94', 'corredoira', 'veronica.mieites', 'malgaca']",361,"['mohamedsameh', 'reemali99_', 'gc_1', 'kerryreto', 'zikrizaki88995', 'je_guilbert', 'spazos7', 'soccadelic44', 'ahern0722', 'benoiturcotte', 'noureldin1999', 'guttsfulltyagi', 'mavanzato0418', 'rkchapman', 'guibill10', 'ari6nd', 'michael2010814', 'happyleexin', 'omardeyaa', 'hong_gao', 'irenehb92', 'sandrabashara', 'nihatyavuz', 'akozych2', 'vikazvereva', 'anthonyroux', 'arrow823', 'aimansyaz99', 'annahaozheng0606', 'rocio', 'masonpb2', 'samashraf1', 'kirankumar94', 'prabuddha_888253127', 'carlosvigo1997', 'muvafikmelikkaya', 'amrebrahim', 'jtorres17', 'jzhan142', 'syedzakwan', 'samet1231234', 'kie180028', 'nadhnasorudin', 'avw2', 'ahmedsameh1698', 'acn562', 'moh.bahaa', 'arifjalani99', 'youssefsherif22', 'asyrafaqil', 'mjgebara14', 'camilolcastro97', 'bcperki2', 'azizijazam11', 'ahmedayman2370', 'rishu', 'ranasherif65', 'kyang37', 'nuanno97', 'smrdafdl', 'brknshn', 'jbaggie2019', 'youssef2042000', 'olivier.gilbert.paquet', 'saipraneett', 'prakharbhargava0', 'hf4', 'nadja1', 'teoster50', 'mohaballam', 'ryanorem', 'shradhap', 'va844', 'neuroque', 'seifhabib', 'anibarseghyan', 'williammitchell5818', 'pingan99', 'mjoza2', 'mariz', 'virajput299', 'bleuminuit', 'ffazul64', 'paul.aniruddha', 'melaniejkramer', 'oliviercharbonneau', 'ilou', 'chengweiheng', 'evrenyigit', 'emilechouinard', 'pythagoras2', 'kason.carroll', 'kie180031', 'carlosvillar54', 'ckim123', 'kychui2', 'kanet1234', 'mohabayman', 'sanchjai', 'nbs691', 'oishikfaruque', 'lauragdevesa', 'nowapoca', 'ahagras13', 'akash140410107098', 'chithong', 'saharoaf', 'amni99', 'aimanadnan', 'alidsjt', 'dlee145', 'stambo', 'lauramolinosmayo', 'mateocampos', 'hamidausat', 'yjenyiee155', 'retty8', 'sebasket14', 'marcmagdy98', 'marianne.gratton.1', 'trkmengkay', 'shaf31', 'youxing0309', 'nourananwar123', 'puertarcd', 'felivitullo87', 'muteki', 'gabrielyii', 'jinsup2', 'staceyn2', 'kaitlinh', 'cbecker413', 'adam562', 'haclarke', 'xosegq16', 'e1150590', 'kalebhilde', 'adriancheah', 'jaimefookinlannister', 'tonybocadillosgrandes', 'rooban11', 'wowmuchchuck', 'xunyong', 'hishamzakaria20', 'rxtodd', 'alimatama', 'jahnavikachhia', 'alexisdixon6', 'saegner2', 'pranjal3', 'berkaydean', 'baleko12345', 'sparshagarwal1009', 'xyz11', 'david.peral.moran', 'tingliang', 'aishu98', 'nadanasser1199', 'desmondsoon', 'keerthisv', 'musabmalek0717', 'mcruces.fz', 'tuberkargan_97', 'worldlineusaf', 'sealseal', 'bharath3', 'cloudyoverhead', 'dhvanil', 'ramy_maged4', 'lsleed', 'zhixin2', 'sriharshap', 'tyy233', 'njs035', 'ablahsaoud', 'nolmos96', 'shorouk_ossama', 'kaustubh.shirpurkar', 'coderko3', 'alifzulkifli99', 'alancantu57', 'baohl2', 'mengkem2', 'selena', 'tdubnansky6', 'ypp200', 'aengm', 'kartal', 'jacquelinethardin', 'mohameeddsamy', 'jipiccardi', 'amlibrahim', 'rahimnoorj', 'dcpang2', 'tamchouweng', 'elizametias12', 'efrenhub', 'mrefaat', 'ethanmorse', 'taymacnichols', 'ryanboucher', 'kirolosehab99', 'ericrobles', 'janeneil88', 'gxiao2', 'kimzihuang', 'anxovidal8', 'damlakubattt', 'lukunze1', 'joker632455', 'shuming2', 'j.haliburton', 'abieday1704', 'ozbunar01', 'ugur.cankaya.3718', 'nihaosawaddee', 'magic_ocean99', 'sinasigurpinar', 'tuberkargan', 'jarodm2', 'nabilah1403', 'amiruldanial99', 'yansi', 'cheokonn', 'ammaralaa516', 'juanmacano97', 'maxernest', 'marcosanllo', 'viratbhatt007', 'facundovia', 'michaelsaldana1', 'kie180073', 'bassamtarek', 'abbesalaeddine', 'restep2', 'estebanrial', '46harunakgul', 'talwren', 'leejq', 'mohammedemadeldin2000', 'jeanmichael.deschenes', 'miloaismanis', 'mmartinezsanchez', 'emrebuyukkose2', 'luciano.brignone', 'anwar909', 'ahmedamr', 'omarmagdy', 'abdurrahmn13', 'nikalyaamani', 'sdehoyos47', 'yubai', 'vincentpainchaud.vp', 'nagihankececi', 'nazimmath3', 'apb5472', 'rikardberger', 'mr4425', 'jacobzeshleman', 'guoyao', 'kiruthikaabalu181996', 'ikhbal', 'michael.mechelay', 'khor', 'david_atef', 'yaseminablacandir', 'c.a.stupka', 'amparo.castro.96', 'dhodapp', 'fkl217', 'farahsamir978', 'kie180039', 'atharva98', 'kph2', 'hafizmokh99', 'hilisa', 'kowjiajin', 'fred_dion', 'harshini9962', 'pvalladaresfdez', 'dancastaneda', 'jn1404', 'atx203', 'ammareltalli', 'amani12345', 'aaq', 'adriangarea', 'onaam8', 'zehuahe2', 'justin.lariviere.25', 'tbryan', 'ludovick.begin', 'tss3', 'tmi211', 'kie180079', 'physquig', 'zakhwan7', 'mallen22', 'amr_ua07', 'pip29', 'fcfrancapra94', 'adnanyuceer', 'fathy1104', 'perezsarmar', 'al4995', 'melroy_caeiro', 'caglanlee', 'afeefz', 'jpmcgee98', 'ales.gajdacz', 'masitadonmez', 'eddin21', 'hmoulvi1', 'elad.d', 'xxlilmontysignxx', 'farah26', 'latecnologiameodia', 'abdulrahim2905', 'exjamil', 'vickytubio', 'ozgurkablan26', 'lderemo', 'ankit6257', 'javierisma98', 'redzuan11', 'yeejou990318', 'adarsh123', 'rileyroca', 'movi205', 'pablosaavedra', 'maramtarek53', 's_coriolis', 'kakmeera1999', 'travisc2', 'electronica18', 'kie180702', 'bhliu97', 'ematson5897', 'ashutoshsinghhenry6', 'maniphysics09', 'eduard25252598', 'moh.ashraf105', 'pablobou4', 'khazanv2', 'ahchehyan', 'ramonruiz.infor', 'brannon44', 'scremin', 'aasifhameed99', 'wahidiah52', 'm939454', 'aboone06', 'bluelobster', 'gabrielyii99', 'jinwoo2', 'syin4', 'diamond92', 'bflores18', 'njgale01', 'mgk816', 'dkshelat']",6,"['aronchino6', 'hermidaitor', 'iago', 'loisonchambers', 'adfoz', 'paularodriguez']",398,"['miri23', 'mohamedsameh', 'reemali99_', 'gc_1', 'kerryreto', 'zikrizaki88995', 'je_guilbert', 'jorgecastelo5', 'spazos7', 'soccadelic44', 'ahern0722', 'benoiturcotte', 'noureldin1999', 'alberfn', 'guttsfulltyagi', 'mavanzato0418', 'loisonchambers', 'rkchapman', 'guibill10', 'ari6nd', 'michael2010814', 'happyleexin', 'omardeyaa', 'hong_gao', 'irenehb92', 'sandrabashara', 'nihatyavuz', 'akozych2', 'vikazvereva', 'danielfernandezcalo', 'anthonyroux', 'arrow823', 'aimansyaz99', 'annahaozheng0606', 'rocio', 'masonpb2', 'samashraf1', 'kirankumar94', 'prabuddha_888253127', 'carlosvigo1997', 'muvafikmelikkaya', 'amrebrahim', 'jtorres17', 'jzhan142', 'syedzakwan', 'samet1231234', 'kie180028', 'nadhnasorudin', 'avw2', 'ahmedsameh1698', 'acn562', 'moh.bahaa', 'arifjalani99', 'youssefsherif22', 'asyrafaqil', 'mjgebara14', 'camilolcastro97', 'bcperki2', 'azizijazam11', 'ahmedayman2370', 'rishu', 'ranasherif65', 'kyang37', 'nuanno97', 'smrdafdl', 'brknshn', 'jbaggie2019', 'youssef2042000', 'olivier.gilbert.paquet', 'saipraneett', 'prakharbhargava0', 'hf4', 'nadja1', 'teoster50', 'mohaballam', 'ryanorem', 'shradhap', 'va844', 'neuroque', 'seifhabib', 'anibarseghyan', 'williammitchell5818', 'pingan99', 'mjoza2', 'mariz', 'virajput299', 'bleuminuit', 'ffazul64', 'paul.aniruddha', 'melaniejkramer', 'oliviercharbonneau', 'ilou', 'chengweiheng', 'evrenyigit', 'emilechouinard', 'pythagoras2', 'kason.carroll', 'malgaca', 'kie180031', 'carlosvillar54', 'ckim123', 'kychui2', 'kanet1234', 'mohabayman', 'sanchjai', 'nbs691', 'oishikfaruque', 'iago', 'lauragdevesa', 'nowapoca', 'ahagras13', 'akash140410107098', 'chithong', 'saharoaf', 'amni99', 'svo4321', 'lino13', 'vblanco.nico', 'aimanadnan', 'alidsjt', 'dlee145', 'stambo', 'lauramolinosmayo', 'mateocampos', 'hamidausat', 'yjenyiee155', 'retty8', 'sebasket14', 'marcmagdy98', 'janalorenzolumbreras', 'marianne.gratton.1', 'trkmengkay', 'shaf31', 'youxing0309', 'nourananwar123', 'puertarcd', 'felivitullo87', 'manuelsomoza94', 'alecorti.pardo', 'muteki', 'corredoira', 'gabrielyii', 'jinsup2', 'staceyn2', 'kaitlinh', 'cbecker413', 'adam562', 'haclarke', 'xosegq16', 'adfoz', 'e1150590', 'kalebhilde', 'adriancheah', 'jaimefookinlannister', 'tonybocadillosgrandes', 'rooban11', 'wowmuchchuck', 'xunyong', 'hishamzakaria20', 'rxtodd', 'sarapl', 'alimatama', 'jahnavikachhia', 'alexisdixon6', 'saegner2', 'pranjal3', 'berkaydean', 'baleko12345', 'sparshagarwal1009', 'xyz11', 'david.peral.moran', 'tingliang', 'isabelmaria.vazquez', 'aishu98', 'nadanasser1199', 'desmondsoon', 'keerthisv', 'musabmalek0717', 'mcruces.fz', 'tuberkargan_97', 'worldlineusaf', 'sealseal', 'bharath3', 'cloudyoverhead', 'dhvanil', 'ramy_maged4', 'lsleed', 'zhixin2', 'sriharshap', 'tyy233', 'njs035', 'ablahsaoud', 'nolmos96', 'shorouk_ossama', 'kaustubh.shirpurkar', 'pedrosiaba', 'coderko3', 'alifzulkifli99', 'alancantu57', 'baohl2', 'mengkem2', 'paularodriguez', 'selena', 'tdubnansky6', 'ypp200', 'aengm', 'kartal', 'jacquelinethardin', 'mohameeddsamy', 'jipiccardi', 'amlibrahim', 'rahimnoorj', 'dcpang2', 'tamchouweng', 'elizametias12', 'efrenhub', 'mrefaat', 'ethanmorse', 'taymacnichols', 'ryanboucher', 'kirolosehab99', 'carlosbesadaromero', 'aronchino6', 'ericrobles', 'janeneil88', 'gxiao2', 'kimzihuang', 'anxovidal8', 'damlakubattt', 'andreadiazgar', 'lukunze1', 'joker632455', 'shuming2', 'j.haliburton', 'abieday1704', 'ozbunar01', 'ugur.cankaya.3718', 'nihaosawaddee', 'magic_ocean99', 'sinasigurpinar', 'tuberkargan', 'jarodm2', 'nabilah1403', 'amiruldanial99', 'yansi', 'cheokonn', 'ammaralaa516', 'juanmacano97', 'maxernest', 'marcosanllo', 'viratbhatt007', 'facundovia', 'michaelsaldana1', 'kie180073', 'bassamtarek', 'abbesalaeddine', 'restep2', 'estebanrial', 'martinzapata', '46harunakgul', 'talwren', 'leejq', 'mohammedemadeldin2000', 'jeanmichael.deschenes', 'miloaismanis', 'mmartinezsanchez', 'emrebuyukkose2', 'luciano.brignone', 'anwar909', 'ahmedamr', 'omarmagdy', 'abdurrahmn13', 'nikalyaamani', 'sdehoyos47', 'apascao', 'yubai', 'vincentpainchaud.vp', 'nagihankececi', 'nazimmath3', 'apb5472', 'rikardberger', 'mr4425', 'jacobzeshleman', 'guoyao', 'kiruthikaabalu181996', 'ikhbal', 'michael.mechelay', 'khor', 'david_atef', 'yaseminablacandir', 'c.a.stupka', 'amparo.castro.96', 'dhodapp', 'fkl217', 'farahsamir978', 'kie180039', 'atharva98', 'kph2', 'hafizmokh99', 'hilisa', 'kowjiajin', 'fred_dion', 'harshini9962', 'pvalladaresfdez', 'dancastaneda', 'jn1404', 'atx203', 'ammareltalli', 'amani12345', 'aaq', 'ledicia97', 'adriangarea', 'onaam8', 'zehuahe2', 'siemprewowthechami', 'justin.lariviere.25', 'tbryan', 'ludovick.begin', 'tss3', 'david2397', 'tmi211', 'kie180079', 'physquig', 'zakhwan7', 'mallen22', 'amr_ua07', 'pip29', 'fcfrancapra94', 'cristinacigarran', 'vanesagarcia', 'adnanyuceer', 'fathy1104', 'perezsarmar', 'al4995', 'melroy_caeiro', 'helenalecoq97', 'caglanlee', 'afeefz', 'jpmcgee98', 'ales.gajdacz', 'masitadonmez', 'eddin21', 'gemma', 'hmoulvi1', 'elad.d', 'xxlilmontysignxx', 'farah26', 'latecnologiameodia', 'abdulrahim2905', 'exjamil', 'vickytubio', 'ozgurkablan26', 'lderemo', 'ankit6257', 'javierisma98', 'redzuan11', 'yeejou990318', 'david.garrido', 'adarsh123', 'rileyroca', 'movi205', 'acregodean', 'pablosaavedra', 'maramtarek53', 's_coriolis', 'kakmeera1999', 'josepazmartin', 'travisc2', 'electronica18', 'kie180702', 'bhliu97', 'ematson5897', 'ashutoshsinghhenry6', 'martin32', 'maniphysics09', 'eduard25252598', 'moh.ashraf105', 'pablobou4', 'khazanv2', 'ahchehyan', 'hermidaitor', 'ramonruiz.infor', 'brannon44', 'scremin', 'aasifhameed99', 'wahidiah52', 'm939454', 'aboone06', 'bluelobster', 'gabrielyii99', 'veronica.mieites', 'jinwoo2', 'syin4', 'diamond92', 'bflores18', 'njgale01', 'mgk816', 'dkshelat']"
1,20,392,36,9,"['evrenyigit', 'ozbunar01', 'adnanyuceer', '46harunakgul', 'ugur.cankaya.3718', 'nihatyavuz', 'muvafikmelikkaya', 'brknshn', 'damlakubattt']",383,"['miri23', 'mohamedsameh', 'reemali99_', 'gc_1', 'kerryreto', 'zikrizaki88995', 'je_guilbert', 'jorgecastelo5', 'spazos7', 'soccadelic44', 'ahern0722', 'benoiturcotte', 'noureldin1999', 'alberfn', 'guttsfulltyagi', 'mavanzato0418', 'rkchapman', 'guibill10', 'ari6nd', 'michael2010814', 'happyleexin', 'omardeyaa', 'hong_gao', 'irenehb92', 'sandrabashara', 'akozych2', 'vikazvereva', 'danielfernandezcalo', 'anthonyroux', 'arrow823', 'aimansyaz99', 'annahaozheng0606', 'rocio', 'masonpb2', 'samashraf1', 'kirankumar94', 'prabuddha_888253127', 'carlosvigo1997', 'amrebrahim', 'jtorres17', 'jzhan142', 'syedzakwan', 'samet1231234', 'kie180028', 'nadhnasorudin', 'avw2', 'ahmedsameh1698', 'acn562', 'moh.bahaa', 'arifjalani99', 'youssefsherif22', 'asyrafaqil', 'mjgebara14', 'camilolcastro97', 'bcperki2', 'azizijazam11', 'ahmedayman2370', 'rishu', 'ranasherif65', 'kyang37', 'nuanno97', 'smrdafdl', 'jbaggie2019', 'youssef2042000', 'olivier.gilbert.paquet', 'saipraneett', 'prakharbhargava0', 'hf4', 'nadja1', 'teoster50', 'mohaballam', 'ryanorem', 'shradhap', 'va844', 'neuroque', 'seifhabib', 'anibarseghyan', 'williammitchell5818', 'pingan99', 'mjoza2', 'mariz', 'virajput299', 'bleuminuit', 'ffazul64', 'paul.aniruddha', 'melaniejkramer', 'oliviercharbonneau', 'ilou', 'chengweiheng', 'emilechouinard', 'pythagoras2', 'kason.carroll', 'malgaca', 'kie180031', 'carlosvillar54', 'ckim123', 'kychui2', 'kanet1234', 'mohabayman', 'sanchjai', 'nbs691', 'oishikfaruque', 'lauragdevesa', 'nowapoca', 'ahagras13', 'akash140410107098', 'chithong', 'saharoaf', 'amni99', 'svo4321', 'lino13', 'vblanco.nico', 'aimanadnan', 'alidsjt', 'dlee145', 'stambo', 'lauramolinosmayo', 'mateocampos', 'hamidausat', 'yjenyiee155', 'retty8', 'sebasket14', 'marcmagdy98', 'janalorenzolumbreras', 'marianne.gratton.1', 'trkmengkay', 'shaf31', 'youxing0309', 'nourananwar123', 'puertarcd', 'felivitullo87', 'manuelsomoza94', 'alecorti.pardo', 'muteki', 'corredoira', 'gabrielyii', 'jinsup2', 'staceyn2', 'kaitlinh', 'cbecker413', 'adam562', 'haclarke', 'xosegq16', 'e1150590', 'kalebhilde', 'adriancheah', 'jaimefookinlannister', 'tonybocadillosgrandes', 'rooban11', 'wowmuchchuck', 'xunyong', 'hishamzakaria20', 'rxtodd', 'sarapl', 'alimatama', 'jahnavikachhia', 'alexisdixon6', 'saegner2', 'pranjal3', 'berkaydean', 'baleko12345', 'sparshagarwal1009', 'xyz11', 'david.peral.moran', 'tingliang', 'isabelmaria.vazquez', 'aishu98', 'nadanasser1199', 'desmondsoon', 'keerthisv', 'musabmalek0717', 'mcruces.fz', 'tuberkargan_97', 'worldlineusaf', 'sealseal', 'bharath3', 'cloudyoverhead', 'dhvanil', 'ramy_maged4', 'lsleed', 'zhixin2', 'sriharshap', 'tyy233', 'njs035', 'ablahsaoud', 'nolmos96', 'shorouk_ossama', 'kaustubh.shirpurkar', 'pedrosiaba', 'coderko3', 'alifzulkifli99', 'alancantu57', 'baohl2', 'mengkem2', 'selena', 'tdubnansky6', 'ypp200', 'aengm', 'kartal', 'jacquelinethardin', 'mohameeddsamy', 'jipiccardi', 'amlibrahim', 'rahimnoorj', 'dcpang2', 'tamchouweng', 'elizametias12', 'efrenhub', 'mrefaat', 'ethanmorse', 'taymacnichols', 'ryanboucher', 'kirolosehab99', 'carlosbesadaromero', 'ericrobles', 'janeneil88', 'gxiao2', 'kimzihuang', 'anxovidal8', 'andreadiazgar', 'lukunze1', 'joker632455', 'shuming2', 'j.haliburton', 'abieday1704', 'nihaosawaddee', 'magic_ocean99', 'sinasigurpinar', 'tuberkargan', 'jarodm2', 'nabilah1403', 'amiruldanial99', 'yansi', 'cheokonn', 'ammaralaa516', 'juanmacano97', 'maxernest', 'marcosanllo', 'viratbhatt007', 'facundovia', 'michaelsaldana1', 'kie180073', 'bassamtarek', 'abbesalaeddine', 'restep2', 'estebanrial', 'martinzapata', 'talwren', 'leejq', 'mohammedemadeldin2000', 'jeanmichael.deschenes', 'miloaismanis', 'mmartinezsanchez', 'emrebuyukkose2', 'luciano.brignone', 'anwar909', 'ahmedamr', 'omarmagdy', 'abdurrahmn13', 'nikalyaamani', 'sdehoyos47', 'apascao', 'yubai', 'vincentpainchaud.vp', 'nagihankececi', 'nazimmath3', 'apb5472', 'rikardberger', 'mr4425', 'jacobzeshleman', 'guoyao', 'kiruthikaabalu181996', 'ikhbal', 'michael.mechelay', 'khor', 'david_atef', 'yaseminablacandir', 'c.a.stupka', 'amparo.castro.96', 'dhodapp', 'fkl217', 'farahsamir978', 'kie180039', 'atharva98', 'kph2', 'hafizmokh99', 'hilisa', 'kowjiajin', 'fred_dion', 'harshini9962', 'pvalladaresfdez', 'dancastaneda', 'jn1404', 'atx203', 'ammareltalli', 'amani12345', 'aaq', 'ledicia97', 'adriangarea', 'onaam8', 'zehuahe2', 'siemprewowthechami', 'justin.lariviere.25', 'tbryan', 'ludovick.begin', 'tss3', 'david2397', 'tmi211', 'kie180079', 'physquig', 'zakhwan7', 'mallen22', 'amr_ua07', 'pip29', 'fcfrancapra94', 'cristinacigarran', 'vanesagarcia', 'fathy1104', 'perezsarmar', 'al4995', 'melroy_caeiro', 'helenalecoq97', 'caglanlee', 'afeefz', 'jpmcgee98', 'ales.gajdacz', 'masitadonmez', 'eddin21', 'gemma', 'hmoulvi1', 'elad.d', 'xxlilmontysignxx', 'farah26', 'latecnologiameodia', 'abdulrahim2905', 'exjamil', 'vickytubio', 'ozgurkablan26', 'lderemo', 'ankit6257', 'javierisma98', 'redzuan11', 'yeejou990318', 'david.garrido', 'adarsh123', 'rileyroca', 'movi205', 'acregodean', 'pablosaavedra', 'maramtarek53', 's_coriolis', 'kakmeera1999', 'josepazmartin', 'travisc2', 'electronica18', 'kie180702', 'bhliu97', 'ematson5897', 'ashutoshsinghhenry6', 'martin32', 'maniphysics09', 'eduard25252598', 'moh.ashraf105', 'pablobou4', 'khazanv2', 'ahchehyan', 'ramonruiz.infor', 'brannon44', 'scremin', 'aasifhameed99', 'wahidiah52', 'm939454', 'aboone06', 'bluelobster', 'gabrielyii99', 'veronica.mieites', 'jinwoo2', 'syin4', 'diamond92', 'bflores18', 'njgale01', 'mgk816', 'dkshelat']",27,"['emre_citak_bil', 'melike_musal', 'emre_krtn97', 'cemkarts', 'furkanturk1352', 'kganozcan', 'esracolak.25', 'abdurrahmn15', 'melikemusal1', 'yunusbaskan', 'abcd5454', 'irfancan571', 'furkanznkr', 'metehanmustafayalcin', 'haticesari333333', 'frknznkr', 'berkanaydn16', 'ilkaydost', 'meltemsbreezes', 'oakbulut1997', 'onurcanozavci', 'mevradilanerten', 'cihanbuyuknacar', 'muratlevent', 'davuteee', 'afkali.120', 'omerfkazar22']",419,"['miri23', 'mohamedsameh', 'reemali99_', 'gc_1', 'kerryreto', 'zikrizaki88995', 'je_guilbert', 'jorgecastelo5', 'spazos7', 'soccadelic44', 'ahern0722', 'benoiturcotte', 'noureldin1999', 'alberfn', 'guttsfulltyagi', 'mavanzato0418', 'rkchapman', 'guibill10', 'ari6nd', 'michael2010814', 'happyleexin', 'omardeyaa', 'hong_gao', 'irenehb92', 'sandrabashara', 'nihatyavuz', 'akozych2', 'vikazvereva', 'danielfernandezcalo', 'berkanaydn16', 'anthonyroux', 'oakbulut1997', 'arrow823', 'aimansyaz99', 'annahaozheng0606', 'rocio', 'masonpb2', 'samashraf1', 'kirankumar94', 'prabuddha_888253127', 'carlosvigo1997', 'muvafikmelikkaya', 'amrebrahim', 'jtorres17', 'jzhan142', 'afkali.120', 'syedzakwan', 'samet1231234', 'kie180028', 'nadhnasorudin', 'avw2', 'ahmedsameh1698', 'acn562', 'moh.bahaa', 'arifjalani99', 'furkanturk1352', 'youssefsherif22', 'asyrafaqil', 'mjgebara14', 'camilolcastro97', 'bcperki2', 'azizijazam11', 'ahmedayman2370', 'rishu', 'ranasherif65', 'kyang37', 'nuanno97', 'smrdafdl', 'brknshn', 'jbaggie2019', 'youssef2042000', 'olivier.gilbert.paquet', 'saipraneett', 'prakharbhargava0', 'hf4', 'nadja1', 'teoster50', 'mohaballam', 'ryanorem', 'shradhap', 'va844', 'neuroque', 'seifhabib', 'anibarseghyan', 'williammitchell5818', 'pingan99', 'mjoza2', 'mariz', 'virajput299', 'bleuminuit', 'ffazul64', 'paul.aniruddha', 'melaniejkramer', 'oliviercharbonneau', 'ilou', 'chengweiheng', 'evrenyigit', 'emilechouinard', 'pythagoras2', 'kason.carroll', 'davuteee', 'malgaca', 'kie180031', 'carlosvillar54', 'ckim123', 'kychui2', 'kanet1234', 'mohabayman', 'sanchjai', 'nbs691', 'oishikfaruque', 'lauragdevesa', 'nowapoca', 'ahagras13', 'akash140410107098', 'chithong', 'saharoaf', 'amni99', 'svo4321', 'abcd5454', 'irfancan571', 'lino13', 'vblanco.nico', 'aimanadnan', 'alidsjt', 'dlee145', 'stambo', 'lauramolinosmayo', 'mateocampos', 'hamidausat', 'yjenyiee155', 'retty8', 'sebasket14', 'marcmagdy98', 'janalorenzolumbreras', 'marianne.gratton.1', 'frknznkr', 'trkmengkay', 'shaf31', 'youxing0309', 'nourananwar123', 'puertarcd', 'felivitullo87', 'manuelsomoza94', 'alecorti.pardo', 'muteki', 'corredoira', 'gabrielyii', 'jinsup2', 'staceyn2', 'kaitlinh', 'cbecker413', 'adam562', 'haclarke', 'xosegq16', 'omerfkazar22', 'emre_citak_bil', 'e1150590', 'kalebhilde', 'adriancheah', 'jaimefookinlannister', 'tonybocadillosgrandes', 'rooban11', 'wowmuchchuck', 'xunyong', 'hishamzakaria20', 'rxtodd', 'sarapl', 'alimatama', 'jahnavikachhia', 'alexisdixon6', 'saegner2', 'pranjal3', 'berkaydean', 'baleko12345', 'sparshagarwal1009', 'xyz11', 'david.peral.moran', 'tingliang', 'isabelmaria.vazquez', 'aishu98', 'nadanasser1199', 'desmondsoon', 'keerthisv', 'musabmalek0717', 'mcruces.fz', 'tuberkargan_97', 'worldlineusaf', 'sealseal', 'bharath3', 'cloudyoverhead', 'dhvanil', 'ramy_maged4', 'lsleed', 'zhixin2', 'sriharshap', 'tyy233', 'njs035', 'ablahsaoud', 'nolmos96', 'shorouk_ossama', 'kaustubh.shirpurkar', 'pedrosiaba', 'coderko3', 'alifzulkifli99', 'alancantu57', 'baohl2', 'mengkem2', 'selena', 'tdubnansky6', 'ypp200', 'aengm', 'kartal', 'muratlevent', 'jacquelinethardin', 'mohameeddsamy', 'jipiccardi', 'amlibrahim', 'rahimnoorj', 'dcpang2', 'tamchouweng', 'melike_musal', 'elizametias12', 'efrenhub', 'mrefaat', 'emre_krtn97', 'ethanmorse', 'melikemusal1', 'taymacnichols', 'ryanboucher', 'kirolosehab99', 'yunusbaskan', 'carlosbesadaromero', 'ericrobles', 'janeneil88', 'gxiao2', 'kimzihuang', 'anxovidal8', 'damlakubattt', 'andreadiazgar', 'lukunze1', 'joker632455', 'shuming2', 'j.haliburton', 'abieday1704', 'ozbunar01', 'ugur.cankaya.3718', 'nihaosawaddee', 'magic_ocean99', 'sinasigurpinar', 'tuberkargan', 'jarodm2', 'nabilah1403', 'amiruldanial99', 'yansi', 'mevradilanerten', 'cheokonn', 'ammaralaa516', 'juanmacano97', 'cihanbuyuknacar', 'maxernest', 'marcosanllo', 'viratbhatt007', 'facundovia', 'michaelsaldana1', 'kie180073', 'bassamtarek', 'abbesalaeddine', 'restep2', 'estebanrial', 'martinzapata', '46harunakgul', 'talwren', 'leejq', 'mohammedemadeldin2000', 'esracolak.25', 'jeanmichael.deschenes', 'miloaismanis', 'mmartinezsanchez', 'emrebuyukkose2', 'luciano.brignone', 'anwar909', 'ahmedamr', 'omarmagdy', 'abdurrahmn13', 'nikalyaamani', 'sdehoyos47', 'metehanmustafayalcin', 'apascao', 'yubai', 'vincentpainchaud.vp', 'nagihankececi', 'nazimmath3', 'apb5472', 'rikardberger', 'mr4425', 'jacobzeshleman', 'guoyao', 'meltemsbreezes', 'kiruthikaabalu181996', 'ikhbal', 'michael.mechelay', 'khor', 'david_atef', 'yaseminablacandir', 'c.a.stupka', 'amparo.castro.96', 'dhodapp', 'fkl217', 'farahsamir978', 'kie180039', 'atharva98', 'kph2', 'hafizmokh99', 'hilisa', 'kowjiajin', 'fred_dion', 'harshini9962', 'pvalladaresfdez', 'dancastaneda', 'jn1404', 'cemkarts', 'atx203', 'ammareltalli', 'amani12345', 'aaq', 'ledicia97', 'adriangarea', 'onaam8', 'zehuahe2', 'siemprewowthechami', 'justin.lariviere.25', 'tbryan', 'ludovick.begin', 'tss3', 'furkanznkr', 'david2397', 'tmi211', 'kie180079', 'physquig', 'zakhwan7', 'mallen22', 'amr_ua07', 'pip29', 'fcfrancapra94', 'cristinacigarran', 'vanesagarcia', 'adnanyuceer', 'fathy1104', 'ilkaydost', 'perezsarmar', 'al4995', 'onurcanozavci', 'melroy_caeiro', 'helenalecoq97', 'caglanlee', 'afeefz', 'jpmcgee98', 'ales.gajdacz', 'masitadonmez', 'eddin21', 'gemma', 'hmoulvi1', 'elad.d', 'xxlilmontysignxx', 'farah26', 'latecnologiameodia', 'abdulrahim2905', 'exjamil', 'vickytubio', 'ozgurkablan26', 'lderemo', 'ankit6257', 'javierisma98', 'redzuan11', 'yeejou990318', 'david.garrido', 'adarsh123', 'rileyroca', 'kganozcan', 'movi205', 'acregodean', 'pablosaavedra', 'maramtarek53', 'abdurrahmn15', 's_coriolis', 'kakmeera1999', 'josepazmartin', 'travisc2', 'electronica18', 'kie180702', 'bhliu97', 'ematson5897', 'ashutoshsinghhenry6', 'martin32', 'maniphysics09', 'eduard25252598', 'haticesari333333', 'moh.ashraf105', 'pablobou4', 'khazanv2', 'ahchehyan', 'ramonruiz.infor', 'brannon44', 'scremin', 'aasifhameed99', 'wahidiah52', 'm939454', 'aboone06', 'bluelobster', 'gabrielyii99', 'veronica.mieites', 'jinwoo2', 'syin4', 'diamond92', 'bflores18', 'njgale01', 'mgk816', 'dkshelat']"
1,151,392,35,16,"['cheokonn', 'amni99', 'tamchouweng', 'redzuan11', 'hong_gao', 'yjenyiee155', 'desmondsoon', 'musabmalek0717', 'exjamil', 'zikrizaki88995', 'alifzulkifli99', 'syedzakwan', 'nabilah1403', 'youxing0309', 'kie180028', 'khor']",376,"['miri23', 'mohamedsameh', 'reemali99_', 'gc_1', 'kerryreto', 'je_guilbert', 'jorgecastelo5', 'spazos7', 'soccadelic44', 'ahern0722', 'benoiturcotte', 'noureldin1999', 'alberfn', 'guttsfulltyagi', 'mavanzato0418', 'rkchapman', 'guibill10', 'ari6nd', 'michael2010814', 'happyleexin', 'omardeyaa', 'irenehb92', 'sandrabashara', 'nihatyavuz', 'akozych2', 'vikazvereva', 'danielfernandezcalo', 'anthonyroux', 'arrow823', 'aimansyaz99', 'annahaozheng0606', 'rocio', 'masonpb2', 'samashraf1', 'kirankumar94', 'prabuddha_888253127', 'carlosvigo1997', 'muvafikmelikkaya', 'amrebrahim', 'jtorres17', 'jzhan142', 'samet1231234', 'nadhnasorudin', 'avw2', 'ahmedsameh1698', 'acn562', 'moh.bahaa', 'arifjalani99', 'youssefsherif22', 'asyrafaqil', 'mjgebara14', 'camilolcastro97', 'bcperki2', 'azizijazam11', 'ahmedayman2370', 'rishu', 'ranasherif65', 'kyang37', 'nuanno97', 'smrdafdl', 'brknshn', 'jbaggie2019', 'youssef2042000', 'olivier.gilbert.paquet', 'saipraneett', 'prakharbhargava0', 'hf4', 'nadja1', 'teoster50', 'mohaballam', 'ryanorem', 'shradhap', 'va844', 'neuroque', 'seifhabib', 'anibarseghyan', 'williammitchell5818', 'pingan99', 'mjoza2', 'mariz', 'virajput299', 'bleuminuit', 'ffazul64', 'paul.aniruddha', 'melaniejkramer', 'oliviercharbonneau', 'ilou', 'chengweiheng', 'evrenyigit', 'emilechouinard', 'pythagoras2', 'kason.carroll', 'malgaca', 'kie180031', 'carlosvillar54', 'ckim123', 'kychui2', 'kanet1234', 'mohabayman', 'sanchjai', 'nbs691', 'oishikfaruque', 'lauragdevesa', 'nowapoca', 'ahagras13', 'akash140410107098', 'chithong', 'saharoaf', 'svo4321', 'lino13', 'vblanco.nico', 'aimanadnan', 'alidsjt', 'dlee145', 'stambo', 'lauramolinosmayo', 'mateocampos', 'hamidausat', 'retty8', 'sebasket14', 'marcmagdy98', 'janalorenzolumbreras', 'marianne.gratton.1', 'trkmengkay', 'shaf31', 'nourananwar123', 'puertarcd', 'felivitullo87', 'manuelsomoza94', 'alecorti.pardo', 'muteki', 'corredoira', 'gabrielyii', 'jinsup2', 'staceyn2', 'kaitlinh', 'cbecker413', 'adam562', 'haclarke', 'xosegq16', 'e1150590', 'kalebhilde', 'adriancheah', 'jaimefookinlannister', 'tonybocadillosgrandes', 'rooban11', 'wowmuchchuck', 'xunyong', 'hishamzakaria20', 'rxtodd', 'sarapl', 'alimatama', 'jahnavikachhia', 'alexisdixon6', 'saegner2', 'pranjal3', 'berkaydean', 'baleko12345', 'sparshagarwal1009', 'xyz11', 'david.peral.moran', 'tingliang', 'isabelmaria.vazquez', 'aishu98', 'nadanasser1199', 'keerthisv', 'mcruces.fz', 'tuberkargan_97', 'worldlineusaf', 'sealseal', 'bharath3', 'cloudyoverhead', 'dhvanil', 'ramy_maged4', 'lsleed', 'zhixin2', 'sriharshap', 'tyy233', 'njs035', 'ablahsaoud', 'nolmos96', 'shorouk_ossama', 'kaustubh.shirpurkar', 'pedrosiaba', 'coderko3', 'alancantu57', 'baohl2', 'mengkem2', 'selena', 'tdubnansky6', 'ypp200', 'aengm', 'kartal', 'jacquelinethardin', 'mohameeddsamy', 'jipiccardi', 'amlibrahim', 'rahimnoorj', 'dcpang2', 'elizametias12', 'efrenhub', 'mrefaat', 'ethanmorse', 'taymacnichols', 'ryanboucher', 'kirolosehab99', 'carlosbesadaromero', 'ericrobles', 'janeneil88', 'gxiao2', 'kimzihuang', 'anxovidal8', 'damlakubattt', 'andreadiazgar', 'lukunze1', 'joker632455', 'shuming2', 'j.haliburton', 'abieday1704', 'ozbunar01', 'ugur.cankaya.3718', 'nihaosawaddee', 'magic_ocean99', 'sinasigurpinar', 'tuberkargan', 'jarodm2', 'amiruldanial99', 'yansi', 'ammaralaa516', 'juanmacano97', 'maxernest', 'marcosanllo', 'viratbhatt007', 'facundovia', 'michaelsaldana1', 'kie180073', 'bassamtarek', 'abbesalaeddine', 'restep2', 'estebanrial', 'martinzapata', '46harunakgul', 'talwren', 'leejq', 'mohammedemadeldin2000', 'jeanmichael.deschenes', 'miloaismanis', 'mmartinezsanchez', 'emrebuyukkose2', 'luciano.brignone', 'anwar909', 'ahmedamr', 'omarmagdy', 'abdurrahmn13', 'nikalyaamani', 'sdehoyos47', 'apascao', 'yubai', 'vincentpainchaud.vp', 'nagihankececi', 'nazimmath3', 'apb5472', 'rikardberger', 'mr4425', 'jacobzeshleman', 'guoyao', 'kiruthikaabalu181996', 'ikhbal', 'michael.mechelay', 'david_atef', 'yaseminablacandir', 'c.a.stupka', 'amparo.castro.96', 'dhodapp', 'fkl217', 'farahsamir978', 'kie180039', 'atharva98', 'kph2', 'hafizmokh99', 'hilisa', 'kowjiajin', 'fred_dion', 'harshini9962', 'pvalladaresfdez', 'dancastaneda', 'jn1404', 'atx203', 'ammareltalli', 'amani12345', 'aaq', 'ledicia97', 'adriangarea', 'onaam8', 'zehuahe2', 'siemprewowthechami', 'justin.lariviere.25', 'tbryan', 'ludovick.begin', 'tss3', 'david2397', 'tmi211', 'kie180079', 'physquig', 'zakhwan7', 'mallen22', 'amr_ua07', 'pip29', 'fcfrancapra94', 'cristinacigarran', 'vanesagarcia', 'adnanyuceer', 'fathy1104', 'perezsarmar', 'al4995', 'melroy_caeiro', 'helenalecoq97', 'caglanlee', 'afeefz', 'jpmcgee98', 'ales.gajdacz', 'masitadonmez', 'eddin21', 'gemma', 'hmoulvi1', 'elad.d', 'xxlilmontysignxx', 'farah26', 'latecnologiameodia', 'abdulrahim2905', 'vickytubio', 'ozgurkablan26', 'lderemo', 'ankit6257', 'javierisma98', 'yeejou990318', 'david.garrido', 'adarsh123', 'rileyroca', 'movi205', 'acregodean', 'pablosaavedra', 'maramtarek53', 's_coriolis', 'kakmeera1999', 'josepazmartin', 'travisc2', 'electronica18', 'kie180702', 'bhliu97', 'ematson5897', 'ashutoshsinghhenry6', 'martin32', 'maniphysics09', 'eduard25252598', 'moh.ashraf105', 'pablobou4', 'khazanv2', 'ahchehyan', 'ramonruiz.infor', 'brannon44', 'scremin', 'aasifhameed99', 'wahidiah52', 'm939454', 'aboone06', 'bluelobster', 'gabrielyii99', 'veronica.mieites', 'jinwoo2', 'syin4', 'diamond92', 'bflores18', 'njgale01', 'mgk816', 'dkshelat']",19,"['jazlilong', 'chenyongchang', 'juneeee98', 'ashsaifullizan97', 'wanwan1103', 'kishen260499', 'macbelieve', 'yuchennn', 'kie180029', 'mouxingyu121314', 'moontasirsoumik', 'adamalfian__', 'izzat2774', 'wanchin', '18081357278hjh', 'mahafizuddin', 'felice', 'zahrajl124', 'aesaraismat']",411,"['miri23', 'mohamedsameh', 'reemali99_', 'gc_1', 'wanwan1103', 'kerryreto', 'zikrizaki88995', 'je_guilbert', 'jorgecastelo5', 'spazos7', 'soccadelic44', 'ahern0722', 'benoiturcotte', 'noureldin1999', 'alberfn', 'guttsfulltyagi', 'mavanzato0418', 'yuchennn', 'rkchapman', 'guibill10', 'ari6nd', 'michael2010814', 'happyleexin', 'omardeyaa', 'hong_gao', 'irenehb92', 'sandrabashara', 'nihatyavuz', 'akozych2', 'vikazvereva', 'danielfernandezcalo', 'anthonyroux', 'arrow823', 'aimansyaz99', 'annahaozheng0606', 'rocio', 'masonpb2', 'samashraf1', 'kirankumar94', 'prabuddha_888253127', 'carlosvigo1997', 'muvafikmelikkaya', 'amrebrahim', 'jtorres17', 'jzhan142', 'syedzakwan', 'samet1231234', 'kie180028', 'nadhnasorudin', 'avw2', 'ahmedsameh1698', 'acn562', 'juneeee98', 'moh.bahaa', 'arifjalani99', 'youssefsherif22', 'asyrafaqil', 'mjgebara14', 'camilolcastro97', 'bcperki2', 'azizijazam11', 'ahmedayman2370', 'rishu', 'ranasherif65', 'kyang37', 'nuanno97', 'smrdafdl', 'brknshn', 'jbaggie2019', 'youssef2042000', 'olivier.gilbert.paquet', 'saipraneett', 'prakharbhargava0', 'hf4', 'nadja1', 'teoster50', 'mohaballam', 'ryanorem', 'shradhap', 'va844', 'neuroque', 'seifhabib', 'anibarseghyan', 'williammitchell5818', 'pingan99', 'mjoza2', 'mariz', 'virajput299', 'bleuminuit', 'ffazul64', 'paul.aniruddha', 'melaniejkramer', 'oliviercharbonneau', 'ilou', 'chengweiheng', 'evrenyigit', 'emilechouinard', 'pythagoras2', 'kason.carroll', 'felice', 'malgaca', 'kie180031', 'carlosvillar54', 'ckim123', 'kychui2', 'kanet1234', 'mohabayman', 'sanchjai', 'nbs691', 'oishikfaruque', 'lauragdevesa', 'nowapoca', 'ahagras13', 'akash140410107098', 'chithong', 'saharoaf', 'amni99', 'svo4321', 'lino13', 'vblanco.nico', 'aimanadnan', 'alidsjt', 'dlee145', 'stambo', 'lauramolinosmayo', 'mateocampos', 'adamalfian__', 'hamidausat', 'yjenyiee155', 'retty8', 'sebasket14', 'marcmagdy98', 'janalorenzolumbreras', 'marianne.gratton.1', 'trkmengkay', 'shaf31', 'youxing0309', 'nourananwar123', 'puertarcd', 'felivitullo87', 'manuelsomoza94', 'alecorti.pardo', 'muteki', 'corredoira', 'gabrielyii', 'jinsup2', 'staceyn2', 'kaitlinh', 'cbecker413', 'adam562', 'haclarke', 'xosegq16', 'e1150590', 'jazlilong', 'kalebhilde', 'adriancheah', 'jaimefookinlannister', 'tonybocadillosgrandes', 'rooban11', 'wowmuchchuck', 'xunyong', 'hishamzakaria20', 'rxtodd', 'sarapl', 'alimatama', 'jahnavikachhia', 'alexisdixon6', 'saegner2', 'pranjal3', 'berkaydean', 'baleko12345', 'sparshagarwal1009', 'xyz11', 'david.peral.moran', 'tingliang', 'isabelmaria.vazquez', 'aishu98', 'nadanasser1199', 'desmondsoon', 'keerthisv', 'musabmalek0717', 'mcruces.fz', 'tuberkargan_97', 'worldlineusaf', 'sealseal', 'bharath3', 'cloudyoverhead', 'dhvanil', 'ramy_maged4', 'lsleed', 'zhixin2', 'sriharshap', 'tyy233', 'njs035', 'ablahsaoud', 'nolmos96', 'shorouk_ossama', 'kaustubh.shirpurkar', 'pedrosiaba', 'coderko3', 'alifzulkifli99', 'alancantu57', 'baohl2', 'mengkem2', 'selena', 'tdubnansky6', 'ypp200', 'aengm', 'kartal', 'jacquelinethardin', 'mohameeddsamy', 'jipiccardi', 'amlibrahim', 'rahimnoorj', 'dcpang2', 'tamchouweng', 'elizametias12', 'efrenhub', 'mrefaat', 'ethanmorse', 'taymacnichols', 'ryanboucher', 'kirolosehab99', 'carlosbesadaromero', 'ericrobles', 'janeneil88', 'gxiao2', 'kimzihuang', 'kie180029', 'anxovidal8', 'damlakubattt', 'andreadiazgar', 'lukunze1', 'joker632455', 'shuming2', 'j.haliburton', 'abieday1704', 'ozbunar01', 'ugur.cankaya.3718', 'nihaosawaddee', 'magic_ocean99', 'sinasigurpinar', 'tuberkargan', 'jarodm2', 'nabilah1403', 'amiruldanial99', 'yansi', 'cheokonn', 'ammaralaa516', 'juanmacano97', 'maxernest', 'marcosanllo', 'viratbhatt007', 'facundovia', 'michaelsaldana1', 'kie180073', 'bassamtarek', 'abbesalaeddine', 'restep2', 'estebanrial', 'martinzapata', '46harunakgul', 'talwren', 'leejq', 'mohammedemadeldin2000', 'jeanmichael.deschenes', 'miloaismanis', 'mmartinezsanchez', 'emrebuyukkose2', 'luciano.brignone', 'anwar909', 'ahmedamr', 'omarmagdy', 'abdurrahmn13', 'nikalyaamani', 'sdehoyos47', 'apascao', 'yubai', 'vincentpainchaud.vp', 'nagihankececi', 'nazimmath3', 'mouxingyu121314', 'apb5472', 'rikardberger', 'mr4425', 'jacobzeshleman', 'guoyao', 'kiruthikaabalu181996', 'ikhbal', 'michael.mechelay', 'khor', 'david_atef', 'yaseminablacandir', 'c.a.stupka', 'amparo.castro.96', 'dhodapp', 'fkl217', 'farahsamir978', 'mahafizuddin', 'kie180039', 'atharva98', 'kph2', 'hafizmokh99', 'hilisa', 'kowjiajin', 'fred_dion', 'harshini9962', 'pvalladaresfdez', 'dancastaneda', 'chenyongchang', 'jn1404', 'ashsaifullizan97', 'atx203', 'ammareltalli', 'amani12345', 'aaq', 'ledicia97', 'adriangarea', 'onaam8', 'zehuahe2', 'siemprewowthechami', 'justin.lariviere.25', 'macbelieve', 'tbryan', 'ludovick.begin', 'tss3', 'david2397', 'tmi211', 'kie180079', 'physquig', 'zakhwan7', 'mallen22', 'amr_ua07', 'pip29', 'fcfrancapra94', 'cristinacigarran', 'vanesagarcia', 'izzat2774', 'adnanyuceer', 'fathy1104', 'perezsarmar', 'al4995', 'melroy_caeiro', 'helenalecoq97', 'caglanlee', 'afeefz', 'jpmcgee98', 'ales.gajdacz', 'masitadonmez', 'eddin21', 'gemma', 'hmoulvi1', '18081357278hjh', 'elad.d', 'xxlilmontysignxx', 'farah26', 'latecnologiameodia', 'abdulrahim2905', 'exjamil', 'vickytubio', 'zahrajl124', 'ozgurkablan26', 'lderemo', 'ankit6257', 'aesaraismat', 'javierisma98', 'redzuan11', 'yeejou990318', 'david.garrido', 'adarsh123', 'rileyroca', 'movi205', 'acregodean', 'pablosaavedra', 'maramtarek53', 's_coriolis', 'kishen260499', 'kakmeera1999', 'josepazmartin', 'travisc2', 'electronica18', 'kie180702', 'bhliu97', 'ematson5897', 'ashutoshsinghhenry6', 'martin32', 'maniphysics09', 'eduard25252598', 'moontasirsoumik', 'moh.ashraf105', 'pablobou4', 'khazanv2', 'ahchehyan', 'ramonruiz.infor', 'brannon44', 'wanchin', 'scremin', 'aasifhameed99', 'wahidiah52', 'm939454', 'aboone06', 'bluelobster', 'gabrielyii99', 'veronica.mieites', 'jinwoo2', 'syin4', 'diamond92', 'bflores18', 'njgale01', 'mgk816', 'dkshelat']"
1,18,392,34,29,"['carlosvillar54', 'efrenhub', 'tonybocadillosgrandes', 'estebanrial', 'lauragdevesa', 'acregodean', 'alimatama', 'carlosbesadaromero', 'electronica18', 'david.peral.moran', 'isabelmaria.vazquez', 'alberfn', 'mcruces.fz', 'nuanno97', 'vblanco.nico', 'alidsjt', 'martin32', 'cristinacigarran', 'pedrosiaba', 'ramonruiz.infor', 'selena', 'helenalecoq97', 'gemma', 'alecorti.pardo', 'juanmacano97', 'maxernest', 'carlosvigo1997', 'vickytubio', 'xosegq16']",363,"['miri23', 'mohamedsameh', 'reemali99_', 'gc_1', 'kerryreto', 'zikrizaki88995', 'je_guilbert', 'jorgecastelo5', 'spazos7', 'soccadelic44', 'ahern0722', 'benoiturcotte', 'noureldin1999', 'guttsfulltyagi', 'mavanzato0418', 'rkchapman', 'guibill10', 'ari6nd', 'michael2010814', 'happyleexin', 'omardeyaa', 'hong_gao', 'irenehb92', 'sandrabashara', 'nihatyavuz', 'akozych2', 'vikazvereva', 'danielfernandezcalo', 'anthonyroux', 'arrow823', 'aimansyaz99', 'annahaozheng0606', 'rocio', 'masonpb2', 'samashraf1', 'kirankumar94', 'prabuddha_888253127', 'muvafikmelikkaya', 'amrebrahim', 'jtorres17', 'jzhan142', 'syedzakwan', 'samet1231234', 'kie180028', 'nadhnasorudin', 'avw2', 'ahmedsameh1698', 'acn562', 'moh.bahaa', 'arifjalani99', 'youssefsherif22', 'asyrafaqil', 'mjgebara14', 'camilolcastro97', 'bcperki2', 'azizijazam11', 'ahmedayman2370', 'rishu', 'ranasherif65', 'kyang37', 'smrdafdl', 'brknshn', 'jbaggie2019', 'youssef2042000', 'olivier.gilbert.paquet', 'saipraneett', 'prakharbhargava0', 'hf4', 'nadja1', 'teoster50', 'mohaballam', 'ryanorem', 'shradhap', 'va844', 'neuroque', 'seifhabib', 'anibarseghyan', 'williammitchell5818', 'pingan99', 'mjoza2', 'mariz', 'virajput299', 'bleuminuit', 'ffazul64', 'paul.aniruddha', 'melaniejkramer', 'oliviercharbonneau', 'ilou', 'chengweiheng', 'evrenyigit', 'emilechouinard', 'pythagoras2', 'kason.carroll', 'malgaca', 'kie180031', 'ckim123', 'kychui2', 'kanet1234', 'mohabayman', 'sanchjai', 'nbs691', 'oishikfaruque', 'nowapoca', 'ahagras13', 'akash140410107098', 'chithong', 'saharoaf', 'amni99', 'svo4321', 'lino13', 'aimanadnan', 'dlee145', 'stambo', 'lauramolinosmayo', 'mateocampos', 'hamidausat', 'yjenyiee155', 'retty8', 'sebasket14', 'marcmagdy98', 'janalorenzolumbreras', 'marianne.gratton.1', 'trkmengkay', 'shaf31', 'youxing0309', 'nourananwar123', 'puertarcd', 'felivitullo87', 'manuelsomoza94', 'muteki', 'corredoira', 'gabrielyii', 'jinsup2', 'staceyn2', 'kaitlinh', 'cbecker413', 'adam562', 'haclarke', 'e1150590', 'kalebhilde', 'adriancheah', 'jaimefookinlannister', 'rooban11', 'wowmuchchuck', 'xunyong', 'hishamzakaria20', 'rxtodd', 'sarapl', 'jahnavikachhia', 'alexisdixon6', 'saegner2', 'pranjal3', 'berkaydean', 'baleko12345', 'sparshagarwal1009', 'xyz11', 'tingliang', 'aishu98', 'nadanasser1199', 'desmondsoon', 'keerthisv', 'musabmalek0717', 'tuberkargan_97', 'worldlineusaf', 'sealseal', 'bharath3', 'cloudyoverhead', 'dhvanil', 'ramy_maged4', 'lsleed', 'zhixin2', 'sriharshap', 'tyy233', 'njs035', 'ablahsaoud', 'nolmos96', 'shorouk_ossama', 'kaustubh.shirpurkar', 'coderko3', 'alifzulkifli99', 'alancantu57', 'baohl2', 'mengkem2', 'tdubnansky6', 'ypp200', 'aengm', 'kartal', 'jacquelinethardin', 'mohameeddsamy', 'jipiccardi', 'amlibrahim', 'rahimnoorj', 'dcpang2', 'tamchouweng', 'elizametias12', 'mrefaat', 'ethanmorse', 'taymacnichols', 'ryanboucher', 'kirolosehab99', 'ericrobles', 'janeneil88', 'gxiao2', 'kimzihuang', 'anxovidal8', 'damlakubattt', 'andreadiazgar', 'lukunze1', 'joker632455', 'shuming2', 'j.haliburton', 'abieday1704', 'ozbunar01', 'ugur.cankaya.3718', 'nihaosawaddee', 'magic_ocean99', 'sinasigurpinar', 'tuberkargan', 'jarodm2', 'nabilah1403', 'amiruldanial99', 'yansi', 'cheokonn', 'ammaralaa516', 'marcosanllo', 'viratbhatt007', 'facundovia', 'michaelsaldana1', 'kie180073', 'bassamtarek', 'abbesalaeddine', 'restep2', 'martinzapata', '46harunakgul', 'talwren', 'leejq', 'mohammedemadeldin2000', 'jeanmichael.deschenes', 'miloaismanis', 'mmartinezsanchez', 'emrebuyukkose2', 'luciano.brignone', 'anwar909', 'ahmedamr', 'omarmagdy', 'abdurrahmn13', 'nikalyaamani', 'sdehoyos47', 'apascao', 'yubai', 'vincentpainchaud.vp', 'nagihankececi', 'nazimmath3', 'apb5472', 'rikardberger', 'mr4425', 'jacobzeshleman', 'guoyao', 'kiruthikaabalu181996', 'ikhbal', 'michael.mechelay', 'khor', 'david_atef', 'yaseminablacandir', 'c.a.stupka', 'amparo.castro.96', 'dhodapp', 'fkl217', 'farahsamir978', 'kie180039', 'atharva98', 'kph2', 'hafizmokh99', 'hilisa', 'kowjiajin', 'fred_dion', 'harshini9962', 'pvalladaresfdez', 'dancastaneda', 'jn1404', 'atx203', 'ammareltalli', 'amani12345', 'aaq', 'ledicia97', 'adriangarea', 'onaam8', 'zehuahe2', 'siemprewowthechami', 'justin.lariviere.25', 'tbryan', 'ludovick.begin', 'tss3', 'david2397', 'tmi211', 'kie180079', 'physquig', 'zakhwan7', 'mallen22', 'amr_ua07', 'pip29', 'fcfrancapra94', 'vanesagarcia', 'adnanyuceer', 'fathy1104', 'perezsarmar', 'al4995', 'melroy_caeiro', 'caglanlee', 'afeefz', 'jpmcgee98', 'ales.gajdacz', 'masitadonmez', 'eddin21', 'hmoulvi1', 'elad.d', 'xxlilmontysignxx', 'farah26', 'latecnologiameodia', 'abdulrahim2905', 'exjamil', 'ozgurkablan26', 'lderemo', 'ankit6257', 'javierisma98', 'redzuan11', 'yeejou990318', 'david.garrido', 'adarsh123', 'rileyroca', 'movi205', 'pablosaavedra', 'maramtarek53', 's_coriolis', 'kakmeera1999', 'josepazmartin', 'travisc2', 'kie180702', 'bhliu97', 'ematson5897', 'ashutoshsinghhenry6', 'maniphysics09', 'eduard25252598', 'moh.ashraf105', 'pablobou4', 'khazanv2', 'ahchehyan', 'brannon44', 'scremin', 'aasifhameed99', 'wahidiah52', 'm939454', 'aboone06', 'bluelobster', 'gabrielyii99', 'veronica.mieites', 'jinwoo2', 'syin4', 'diamond92', 'bflores18', 'njgale01', 'mgk816', 'dkshelat']",5,"['dokun', 'antonio25', 'hermidaitor', 'iago', 'dfl']",397,"['miri23', 'mohamedsameh', 'reemali99_', 'gc_1', 'kerryreto', 'zikrizaki88995', 'je_guilbert', 'jorgecastelo5', 'spazos7', 'soccadelic44', 'ahern0722', 'benoiturcotte', 'noureldin1999', 'alberfn', 'guttsfulltyagi', 'mavanzato0418', 'rkchapman', 'guibill10', 'ari6nd', 'michael2010814', 'happyleexin', 'omardeyaa', 'hong_gao', 'irenehb92', 'sandrabashara', 'nihatyavuz', 'akozych2', 'vikazvereva', 'danielfernandezcalo', 'anthonyroux', 'arrow823', 'aimansyaz99', 'annahaozheng0606', 'rocio', 'masonpb2', 'samashraf1', 'kirankumar94', 'prabuddha_888253127', 'carlosvigo1997', 'muvafikmelikkaya', 'amrebrahim', 'jtorres17', 'jzhan142', 'syedzakwan', 'samet1231234', 'kie180028', 'nadhnasorudin', 'avw2', 'ahmedsameh1698', 'acn562', 'moh.bahaa', 'arifjalani99', 'youssefsherif22', 'asyrafaqil', 'mjgebara14', 'camilolcastro97', 'bcperki2', 'azizijazam11', 'ahmedayman2370', 'rishu', 'ranasherif65', 'kyang37', 'nuanno97', 'smrdafdl', 'brknshn', 'jbaggie2019', 'youssef2042000', 'olivier.gilbert.paquet', 'saipraneett', 'prakharbhargava0', 'hf4', 'nadja1', 'teoster50', 'mohaballam', 'ryanorem', 'shradhap', 'va844', 'neuroque', 'seifhabib', 'anibarseghyan', 'williammitchell5818', 'pingan99', 'mjoza2', 'mariz', 'virajput299', 'bleuminuit', 'ffazul64', 'paul.aniruddha', 'melaniejkramer', 'oliviercharbonneau', 'ilou', 'chengweiheng', 'evrenyigit', 'emilechouinard', 'pythagoras2', 'kason.carroll', 'malgaca', 'kie180031', 'carlosvillar54', 'ckim123', 'kychui2', 'kanet1234', 'mohabayman', 'sanchjai', 'nbs691', 'oishikfaruque', 'iago', 'lauragdevesa', 'nowapoca', 'ahagras13', 'akash140410107098', 'chithong', 'saharoaf', 'amni99', 'svo4321', 'lino13', 'vblanco.nico', 'aimanadnan', 'alidsjt', 'dlee145', 'stambo', 'lauramolinosmayo', 'mateocampos', 'hamidausat', 'yjenyiee155', 'retty8', 'sebasket14', 'marcmagdy98', 'janalorenzolumbreras', 'marianne.gratton.1', 'trkmengkay', 'shaf31', 'youxing0309', 'nourananwar123', 'puertarcd', 'felivitullo87', 'manuelsomoza94', 'alecorti.pardo', 'muteki', 'corredoira', 'gabrielyii', 'jinsup2', 'staceyn2', 'kaitlinh', 'cbecker413', 'adam562', 'haclarke', 'xosegq16', 'e1150590', 'kalebhilde', 'adriancheah', 'jaimefookinlannister', 'tonybocadillosgrandes', 'rooban11', 'wowmuchchuck', 'xunyong', 'hishamzakaria20', 'rxtodd', 'sarapl', 'alimatama', 'jahnavikachhia', 'alexisdixon6', 'saegner2', 'pranjal3', 'berkaydean', 'baleko12345', 'sparshagarwal1009', 'xyz11', 'david.peral.moran', 'tingliang', 'isabelmaria.vazquez', 'aishu98', 'nadanasser1199', 'desmondsoon', 'keerthisv', 'musabmalek0717', 'mcruces.fz', 'tuberkargan_97', 'worldlineusaf', 'sealseal', 'bharath3', 'dfl', 'cloudyoverhead', 'dhvanil', 'ramy_maged4', 'lsleed', 'zhixin2', 'sriharshap', 'tyy233', 'njs035', 'ablahsaoud', 'nolmos96', 'shorouk_ossama', 'kaustubh.shirpurkar', 'pedrosiaba', 'coderko3', 'alifzulkifli99', 'alancantu57', 'baohl2', 'mengkem2', 'selena', 'tdubnansky6', 'ypp200', 'aengm', 'kartal', 'jacquelinethardin', 'mohameeddsamy', 'jipiccardi', 'amlibrahim', 'rahimnoorj', 'dcpang2', 'tamchouweng', 'elizametias12', 'efrenhub', 'mrefaat', 'ethanmorse', 'taymacnichols', 'ryanboucher', 'kirolosehab99', 'carlosbesadaromero', 'ericrobles', 'janeneil88', 'gxiao2', 'kimzihuang', 'anxovidal8', 'damlakubattt', 'andreadiazgar', 'lukunze1', 'joker632455', 'shuming2', 'j.haliburton', 'abieday1704', 'ozbunar01', 'ugur.cankaya.3718', 'nihaosawaddee', 'magic_ocean99', 'sinasigurpinar', 'tuberkargan', 'jarodm2', 'nabilah1403', 'amiruldanial99', 'yansi', 'cheokonn', 'ammaralaa516', 'juanmacano97', 'maxernest', 'marcosanllo', 'viratbhatt007', 'facundovia', 'michaelsaldana1', 'kie180073', 'bassamtarek', 'abbesalaeddine', 'restep2', 'estebanrial', 'martinzapata', '46harunakgul', 'talwren', 'leejq', 'mohammedemadeldin2000', 'jeanmichael.deschenes', 'miloaismanis', 'mmartinezsanchez', 'emrebuyukkose2', 'luciano.brignone', 'anwar909', 'ahmedamr', 'omarmagdy', 'abdurrahmn13', 'nikalyaamani', 'sdehoyos47', 'apascao', 'yubai', 'vincentpainchaud.vp', 'nagihankececi', 'nazimmath3', 'apb5472', 'rikardberger', 'dokun', 'mr4425', 'jacobzeshleman', 'guoyao', 'kiruthikaabalu181996', 'ikhbal', 'michael.mechelay', 'khor', 'david_atef', 'yaseminablacandir', 'c.a.stupka', 'amparo.castro.96', 'dhodapp', 'fkl217', 'farahsamir978', 'kie180039', 'atharva98', 'kph2', 'hafizmokh99', 'hilisa', 'kowjiajin', 'fred_dion', 'harshini9962', 'pvalladaresfdez', 'dancastaneda', 'jn1404', 'atx203', 'ammareltalli', 'amani12345', 'aaq', 'ledicia97', 'adriangarea', 'onaam8', 'zehuahe2', 'siemprewowthechami', 'justin.lariviere.25', 'tbryan', 'ludovick.begin', 'tss3', 'david2397', 'tmi211', 'kie180079', 'physquig', 'zakhwan7', 'mallen22', 'amr_ua07', 'pip29', 'fcfrancapra94', 'cristinacigarran', 'vanesagarcia', 'adnanyuceer', 'antonio25', 'fathy1104', 'perezsarmar', 'al4995', 'melroy_caeiro', 'helenalecoq97', 'caglanlee', 'afeefz', 'jpmcgee98', 'ales.gajdacz', 'masitadonmez', 'eddin21', 'gemma', 'hmoulvi1', 'elad.d', 'xxlilmontysignxx', 'farah26', 'latecnologiameodia', 'abdulrahim2905', 'exjamil', 'vickytubio', 'ozgurkablan26', 'lderemo', 'ankit6257', 'javierisma98', 'redzuan11', 'yeejou990318', 'david.garrido', 'adarsh123', 'rileyroca', 'movi205', 'acregodean', 'pablosaavedra', 'maramtarek53', 's_coriolis', 'kakmeera1999', 'josepazmartin', 'travisc2', 'electronica18', 'kie180702', 'bhliu97', 'ematson5897', 'ashutoshsinghhenry6', 'martin32', 'maniphysics09', 'eduard25252598', 'moh.ashraf105', 'pablobou4', 'khazanv2', 'ahchehyan', 'hermidaitor', 'ramonruiz.infor', 'brannon44', 'scremin', 'aasifhameed99', 'wahidiah52', 'm939454', 'aboone06', 'bluelobster', 'gabrielyii99', 'veronica.mieites', 'jinwoo2', 'syin4', 'diamond92', 'bflores18', 'njgale01', 'mgk816', 'dkshelat']"
1,23,392,21,20,"['gc_1', 'je_guilbert', 'jeanmichael.deschenes', 's_coriolis', 'benoiturcotte', 'justin.lariviere.25', 'ludovick.begin', 'olivier.gilbert.paquet', 'physquig', 'cloudyoverhead', 'vincentpainchaud.vp', 'guibill10', 'sebasket14', 'marianne.gratton.1', 'bleuminuit', 'anthonyroux', 'oliviercharbonneau', 'emilechouinard', 'pythagoras2', 'fred_dion']",372,"['miri23', 'mohamedsameh', 'reemali99_', 'kerryreto', 'zikrizaki88995', 'jorgecastelo5', 'spazos7', 'soccadelic44', 'ahern0722', 'noureldin1999', 'alberfn', 'guttsfulltyagi', 'mavanzato0418', 'rkchapman', 'ari6nd', 'michael2010814', 'happyleexin', 'omardeyaa', 'hong_gao', 'irenehb92', 'sandrabashara', 'nihatyavuz', 'akozych2', 'vikazvereva', 'danielfernandezcalo', 'arrow823', 'aimansyaz99', 'annahaozheng0606', 'rocio', 'masonpb2', 'samashraf1', 'kirankumar94', 'prabuddha_888253127', 'carlosvigo1997', 'muvafikmelikkaya', 'amrebrahim', 'jtorres17', 'jzhan142', 'syedzakwan', 'samet1231234', 'kie180028', 'nadhnasorudin', 'avw2', 'ahmedsameh1698', 'acn562', 'moh.bahaa', 'arifjalani99', 'youssefsherif22', 'asyrafaqil', 'mjgebara14', 'camilolcastro97', 'bcperki2', 'azizijazam11', 'ahmedayman2370', 'rishu', 'ranasherif65', 'kyang37', 'nuanno97', 'smrdafdl', 'brknshn', 'jbaggie2019', 'youssef2042000', 'saipraneett', 'prakharbhargava0', 'hf4', 'nadja1', 'teoster50', 'mohaballam', 'ryanorem', 'shradhap', 'va844', 'neuroque', 'seifhabib', 'anibarseghyan', 'williammitchell5818', 'pingan99', 'mjoza2', 'mariz', 'virajput299', 'ffazul64', 'paul.aniruddha', 'melaniejkramer', 'ilou', 'chengweiheng', 'evrenyigit', 'kason.carroll', 'malgaca', 'kie180031', 'carlosvillar54', 'ckim123', 'kychui2', 'kanet1234', 'mohabayman', 'sanchjai', 'nbs691', 'oishikfaruque', 'lauragdevesa', 'nowapoca', 'ahagras13', 'akash140410107098', 'chithong', 'saharoaf', 'amni99', 'svo4321', 'lino13', 'vblanco.nico', 'aimanadnan', 'alidsjt', 'dlee145', 'stambo', 'lauramolinosmayo', 'mateocampos', 'hamidausat', 'yjenyiee155', 'retty8', 'marcmagdy98', 'janalorenzolumbreras', 'trkmengkay', 'shaf31', 'youxing0309', 'nourananwar123', 'puertarcd', 'felivitullo87', 'manuelsomoza94', 'alecorti.pardo', 'muteki', 'corredoira', 'gabrielyii', 'jinsup2', 'staceyn2', 'kaitlinh', 'cbecker413', 'adam562', 'haclarke', 'xosegq16', 'e1150590', 'kalebhilde', 'adriancheah', 'jaimefookinlannister', 'tonybocadillosgrandes', 'rooban11', 'wowmuchchuck', 'xunyong', 'hishamzakaria20', 'rxtodd', 'sarapl', 'alimatama', 'jahnavikachhia', 'alexisdixon6', 'saegner2', 'pranjal3', 'berkaydean', 'baleko12345', 'sparshagarwal1009', 'xyz11', 'david.peral.moran', 'tingliang', 'isabelmaria.vazquez', 'aishu98', 'nadanasser1199', 'desmondsoon', 'keerthisv', 'musabmalek0717', 'mcruces.fz', 'tuberkargan_97', 'worldlineusaf', 'sealseal', 'bharath3', 'dhvanil', 'ramy_maged4', 'lsleed', 'zhixin2', 'sriharshap', 'tyy233', 'njs035', 'ablahsaoud', 'nolmos96', 'shorouk_ossama', 'kaustubh.shirpurkar', 'pedrosiaba', 'coderko3', 'alifzulkifli99', 'alancantu57', 'baohl2', 'mengkem2', 'selena', 'tdubnansky6', 'ypp200', 'aengm', 'kartal', 'jacquelinethardin', 'mohameeddsamy', 'jipiccardi', 'amlibrahim', 'rahimnoorj', 'dcpang2', 'tamchouweng', 'elizametias12', 'efrenhub', 'mrefaat', 'ethanmorse', 'taymacnichols', 'ryanboucher', 'kirolosehab99', 'carlosbesadaromero', 'ericrobles', 'janeneil88', 'gxiao2', 'kimzihuang', 'anxovidal8', 'damlakubattt', 'andreadiazgar', 'lukunze1', 'joker632455', 'shuming2', 'j.haliburton', 'abieday1704', 'ozbunar01', 'ugur.cankaya.3718', 'nihaosawaddee', 'magic_ocean99', 'sinasigurpinar', 'tuberkargan', 'jarodm2', 'nabilah1403', 'amiruldanial99', 'yansi', 'cheokonn', 'ammaralaa516', 'juanmacano97', 'maxernest', 'marcosanllo', 'viratbhatt007', 'facundovia', 'michaelsaldana1', 'kie180073', 'bassamtarek', 'abbesalaeddine', 'restep2', 'estebanrial', 'martinzapata', '46harunakgul', 'talwren', 'leejq', 'mohammedemadeldin2000', 'miloaismanis', 'mmartinezsanchez', 'emrebuyukkose2', 'luciano.brignone', 'anwar909', 'ahmedamr', 'omarmagdy', 'abdurrahmn13', 'nikalyaamani', 'sdehoyos47', 'apascao', 'yubai', 'nagihankececi', 'nazimmath3', 'apb5472', 'rikardberger', 'mr4425', 'jacobzeshleman', 'guoyao', 'kiruthikaabalu181996', 'ikhbal', 'michael.mechelay', 'khor', 'david_atef', 'yaseminablacandir', 'c.a.stupka', 'amparo.castro.96', 'dhodapp', 'fkl217', 'farahsamir978', 'kie180039', 'atharva98', 'kph2', 'hafizmokh99', 'hilisa', 'kowjiajin', 'harshini9962', 'pvalladaresfdez', 'dancastaneda', 'jn1404', 'atx203', 'ammareltalli', 'amani12345', 'aaq', 'ledicia97', 'adriangarea', 'onaam8', 'zehuahe2', 'siemprewowthechami', 'tbryan', 'tss3', 'david2397', 'tmi211', 'kie180079', 'zakhwan7', 'mallen22', 'amr_ua07', 'pip29', 'fcfrancapra94', 'cristinacigarran', 'vanesagarcia', 'adnanyuceer', 'fathy1104', 'perezsarmar', 'al4995', 'melroy_caeiro', 'helenalecoq97', 'caglanlee', 'afeefz', 'jpmcgee98', 'ales.gajdacz', 'masitadonmez', 'eddin21', 'gemma', 'hmoulvi1', 'elad.d', 'xxlilmontysignxx', 'farah26', 'latecnologiameodia', 'abdulrahim2905', 'exjamil', 'vickytubio', 'ozgurkablan26', 'lderemo', 'ankit6257', 'javierisma98', 'redzuan11', 'yeejou990318', 'david.garrido', 'adarsh123', 'rileyroca', 'movi205', 'acregodean', 'pablosaavedra', 'maramtarek53', 'kakmeera1999', 'josepazmartin', 'travisc2', 'electronica18', 'kie180702', 'bhliu97', 'ematson5897', 'ashutoshsinghhenry6', 'martin32', 'maniphysics09', 'eduard25252598', 'moh.ashraf105', 'pablobou4', 'khazanv2', 'ahchehyan', 'ramonruiz.infor', 'brannon44', 'scremin', 'aasifhameed99', 'wahidiah52', 'm939454', 'aboone06', 'bluelobster', 'gabrielyii99', 'veronica.mieites', 'jinwoo2', 'syin4', 'diamond92', 'bflores18', 'njgale01', 'mgk816', 'dkshelat']",1,['comeulaval'],393,"['miri23', 'mohamedsameh', 'reemali99_', 'gc_1', 'kerryreto', 'zikrizaki88995', 'je_guilbert', 'jorgecastelo5', 'spazos7', 'soccadelic44', 'ahern0722', 'benoiturcotte', 'noureldin1999', 'alberfn', 'guttsfulltyagi', 'mavanzato0418', 'rkchapman', 'guibill10', 'ari6nd', 'michael2010814', 'happyleexin', 'omardeyaa', 'hong_gao', 'irenehb92', 'sandrabashara', 'nihatyavuz', 'akozych2', 'vikazvereva', 'danielfernandezcalo', 'anthonyroux', 'arrow823', 'aimansyaz99', 'annahaozheng0606', 'rocio', 'masonpb2', 'samashraf1', 'kirankumar94', 'prabuddha_888253127', 'carlosvigo1997', 'muvafikmelikkaya', 'amrebrahim', 'jtorres17', 'jzhan142', 'syedzakwan', 'samet1231234', 'kie180028', 'nadhnasorudin', 'avw2', 'ahmedsameh1698', 'acn562', 'moh.bahaa', 'arifjalani99', 'youssefsherif22', 'asyrafaqil', 'mjgebara14', 'camilolcastro97', 'bcperki2', 'azizijazam11', 'ahmedayman2370', 'rishu', 'ranasherif65', 'kyang37', 'nuanno97', 'smrdafdl', 'brknshn', 'jbaggie2019', 'youssef2042000', 'olivier.gilbert.paquet', 'saipraneett', 'prakharbhargava0', 'hf4', 'nadja1', 'teoster50', 'mohaballam', 'ryanorem', 'shradhap', 'va844', 'neuroque', 'seifhabib', 'anibarseghyan', 'williammitchell5818', 'pingan99', 'mjoza2', 'mariz', 'virajput299', 'bleuminuit', 'ffazul64', 'paul.aniruddha', 'melaniejkramer', 'oliviercharbonneau', 'ilou', 'chengweiheng', 'evrenyigit', 'emilechouinard', 'pythagoras2', 'kason.carroll', 'malgaca', 'kie180031', 'carlosvillar54', 'ckim123', 'kychui2', 'kanet1234', 'mohabayman', 'sanchjai', 'nbs691', 'oishikfaruque', 'lauragdevesa', 'nowapoca', 'ahagras13', 'akash140410107098', 'chithong', 'saharoaf', 'amni99', 'svo4321', 'lino13', 'vblanco.nico', 'aimanadnan', 'alidsjt', 'dlee145', 'stambo', 'lauramolinosmayo', 'mateocampos', 'hamidausat', 'yjenyiee155', 'retty8', 'sebasket14', 'marcmagdy98', 'janalorenzolumbreras', 'marianne.gratton.1', 'trkmengkay', 'shaf31', 'youxing0309', 'nourananwar123', 'puertarcd', 'felivitullo87', 'manuelsomoza94', 'alecorti.pardo', 'muteki', 'corredoira', 'gabrielyii', 'jinsup2', 'staceyn2', 'kaitlinh', 'cbecker413', 'adam562', 'haclarke', 'xosegq16', 'e1150590', 'kalebhilde', 'adriancheah', 'jaimefookinlannister', 'tonybocadillosgrandes', 'rooban11', 'wowmuchchuck', 'xunyong', 'hishamzakaria20', 'rxtodd', 'sarapl', 'alimatama', 'jahnavikachhia', 'alexisdixon6', 'saegner2', 'pranjal3', 'berkaydean', 'baleko12345', 'sparshagarwal1009', 'xyz11', 'david.peral.moran', 'tingliang', 'isabelmaria.vazquez', 'aishu98', 'nadanasser1199', 'desmondsoon', 'keerthisv', 'musabmalek0717', 'mcruces.fz', 'tuberkargan_97', 'worldlineusaf', 'sealseal', 'bharath3', 'cloudyoverhead', 'dhvanil', 'ramy_maged4', 'lsleed', 'zhixin2', 'sriharshap', 'tyy233', 'njs035', 'ablahsaoud', 'nolmos96', 'shorouk_ossama', 'kaustubh.shirpurkar', 'pedrosiaba', 'coderko3', 'alifzulkifli99', 'alancantu57', 'baohl2', 'mengkem2', 'selena', 'tdubnansky6', 'ypp200', 'aengm', 'kartal', 'jacquelinethardin', 'mohameeddsamy', 'jipiccardi', 'amlibrahim', 'rahimnoorj', 'dcpang2', 'tamchouweng', 'elizametias12', 'efrenhub', 'mrefaat', 'ethanmorse', 'taymacnichols', 'ryanboucher', 'kirolosehab99', 'carlosbesadaromero', 'ericrobles', 'janeneil88', 'gxiao2', 'kimzihuang', 'anxovidal8', 'damlakubattt', 'andreadiazgar', 'lukunze1', 'joker632455', 'shuming2', 'j.haliburton', 'abieday1704', 'ozbunar01', 'ugur.cankaya.3718', 'nihaosawaddee', 'magic_ocean99', 'sinasigurpinar', 'tuberkargan', 'jarodm2', 'nabilah1403', 'amiruldanial99', 'yansi', 'cheokonn', 'ammaralaa516', 'juanmacano97', 'maxernest', 'marcosanllo', 'viratbhatt007', 'facundovia', 'michaelsaldana1', 'kie180073', 'bassamtarek', 'abbesalaeddine', 'restep2', 'estebanrial', 'martinzapata', '46harunakgul', 'talwren', 'leejq', 'mohammedemadeldin2000', 'jeanmichael.deschenes', 'miloaismanis', 'mmartinezsanchez', 'emrebuyukkose2', 'luciano.brignone', 'anwar909', 'ahmedamr', 'omarmagdy', 'abdurrahmn13', 'nikalyaamani', 'sdehoyos47', 'apascao', 'yubai', 'vincentpainchaud.vp', 'nagihankececi', 'nazimmath3', 'apb5472', 'rikardberger', 'mr4425', 'jacobzeshleman', 'guoyao', 'kiruthikaabalu181996', 'ikhbal', 'michael.mechelay', 'khor', 'david_atef', 'yaseminablacandir', 'c.a.stupka', 'amparo.castro.96', 'dhodapp', 'fkl217', 'farahsamir978', 'kie180039', 'atharva98', 'kph2', 'hafizmokh99', 'hilisa', 'kowjiajin', 'fred_dion', 'harshini9962', 'pvalladaresfdez', 'dancastaneda', 'jn1404', 'atx203', 'ammareltalli', 'amani12345', 'aaq', 'ledicia97', 'adriangarea', 'onaam8', 'zehuahe2', 'siemprewowthechami', 'justin.lariviere.25', 'tbryan', 'ludovick.begin', 'tss3', 'david2397', 'tmi211', 'kie180079', 'physquig', 'zakhwan7', 'mallen22', 'amr_ua07', 'pip29', 'fcfrancapra94', 'cristinacigarran', 'vanesagarcia', 'adnanyuceer', 'fathy1104', 'perezsarmar', 'al4995', 'melroy_caeiro', 'helenalecoq97', 'caglanlee', 'afeefz', 'jpmcgee98', 'ales.gajdacz', 'masitadonmez', 'eddin21', 'gemma', 'hmoulvi1', 'elad.d', 'xxlilmontysignxx', 'farah26', 'latecnologiameodia', 'abdulrahim2905', 'exjamil', 'vickytubio', 'ozgurkablan26', 'lderemo', 'ankit6257', 'javierisma98', 'redzuan11', 'yeejou990318', 'david.garrido', 'adarsh123', 'rileyroca', 'movi205', 'acregodean', 'pablosaavedra', 'maramtarek53', 's_coriolis', 'kakmeera1999', 'josepazmartin', 'travisc2', 'electronica18', 'kie180702', 'bhliu97', 'ematson5897', 'ashutoshsinghhenry6', 'martin32', 'maniphysics09', 'eduard25252598', 'moh.ashraf105', 'comeulaval', 'pablobou4', 'khazanv2', 'ahchehyan', 'ramonruiz.infor', 'brannon44', 'scremin', 'aasifhameed99', 'wahidiah52', 'm939454', 'aboone06', 'bluelobster', 'gabrielyii99', 'veronica.mieites', 'jinwoo2', 'syin4', 'diamond92', 'bflores18', 'njgale01', 'mgk816', 'dkshelat']"
1,24,392,21,19,"['kalebhilde', 'soccadelic44', 'jahnavikachhia', 'akash140410107098', 'rishu', 'keerthisv', 'ashutoshsinghhenry6', 'yubai', 'dhvanil', 'sriharshap', 'shradhap', 'virajput299', 'kiruthikaabalu181996', 'hmoulvi1', 'kirankumar94', 'prabuddha_888253127', 'viratbhatt007', 'ankit6257', 'dkshelat']",373,"['miri23', 'mohamedsameh', 'reemali99_', 'gc_1', 'kerryreto', 'zikrizaki88995', 'je_guilbert', 'jorgecastelo5', 'spazos7', 'ahern0722', 'benoiturcotte', 'noureldin1999', 'alberfn', 'guttsfulltyagi', 'mavanzato0418', 'rkchapman', 'guibill10', 'ari6nd', 'michael2010814', 'happyleexin', 'omardeyaa', 'hong_gao', 'irenehb92', 'sandrabashara', 'nihatyavuz', 'akozych2', 'vikazvereva', 'danielfernandezcalo', 'anthonyroux', 'arrow823', 'aimansyaz99', 'annahaozheng0606', 'rocio', 'masonpb2', 'samashraf1', 'carlosvigo1997', 'muvafikmelikkaya', 'amrebrahim', 'jtorres17', 'jzhan142', 'syedzakwan', 'samet1231234', 'kie180028', 'nadhnasorudin', 'avw2', 'ahmedsameh1698', 'acn562', 'moh.bahaa', 'arifjalani99', 'youssefsherif22', 'asyrafaqil', 'mjgebara14', 'camilolcastro97', 'bcperki2', 'azizijazam11', 'ahmedayman2370', 'ranasherif65', 'kyang37', 'nuanno97', 'smrdafdl', 'brknshn', 'jbaggie2019', 'youssef2042000', 'olivier.gilbert.paquet', 'saipraneett', 'prakharbhargava0', 'hf4', 'nadja1', 'teoster50', 'mohaballam', 'ryanorem', 'va844', 'neuroque', 'seifhabib', 'anibarseghyan', 'williammitchell5818', 'pingan99', 'mjoza2', 'mariz', 'bleuminuit', 'ffazul64', 'paul.aniruddha', 'melaniejkramer', 'oliviercharbonneau', 'ilou', 'chengweiheng', 'evrenyigit', 'emilechouinard', 'pythagoras2', 'kason.carroll', 'malgaca', 'kie180031', 'carlosvillar54', 'ckim123', 'kychui2', 'kanet1234', 'mohabayman', 'sanchjai', 'nbs691', 'oishikfaruque', 'lauragdevesa', 'nowapoca', 'ahagras13', 'chithong', 'saharoaf', 'amni99', 'svo4321', 'lino13', 'vblanco.nico', 'aimanadnan', 'alidsjt', 'dlee145', 'stambo', 'lauramolinosmayo', 'mateocampos', 'hamidausat', 'yjenyiee155', 'retty8', 'sebasket14', 'marcmagdy98', 'janalorenzolumbreras', 'marianne.gratton.1', 'trkmengkay', 'shaf31', 'youxing0309', 'nourananwar123', 'puertarcd', 'felivitullo87', 'manuelsomoza94', 'alecorti.pardo', 'muteki', 'corredoira', 'gabrielyii', 'jinsup2', 'staceyn2', 'kaitlinh', 'cbecker413', 'adam562', 'haclarke', 'xosegq16', 'e1150590', 'adriancheah', 'jaimefookinlannister', 'tonybocadillosgrandes', 'rooban11', 'wowmuchchuck', 'xunyong', 'hishamzakaria20', 'rxtodd', 'sarapl', 'alimatama', 'alexisdixon6', 'saegner2', 'pranjal3', 'berkaydean', 'baleko12345', 'sparshagarwal1009', 'xyz11', 'david.peral.moran', 'tingliang', 'isabelmaria.vazquez', 'aishu98', 'nadanasser1199', 'desmondsoon', 'musabmalek0717', 'mcruces.fz', 'tuberkargan_97', 'worldlineusaf', 'sealseal', 'bharath3', 'cloudyoverhead', 'ramy_maged4', 'lsleed', 'zhixin2', 'tyy233', 'njs035', 'ablahsaoud', 'nolmos96', 'shorouk_ossama', 'kaustubh.shirpurkar', 'pedrosiaba', 'coderko3', 'alifzulkifli99', 'alancantu57', 'baohl2', 'mengkem2', 'selena', 'tdubnansky6', 'ypp200', 'aengm', 'kartal', 'jacquelinethardin', 'mohameeddsamy', 'jipiccardi', 'amlibrahim', 'rahimnoorj', 'dcpang2', 'tamchouweng', 'elizametias12', 'efrenhub', 'mrefaat', 'ethanmorse', 'taymacnichols', 'ryanboucher', 'kirolosehab99', 'carlosbesadaromero', 'ericrobles', 'janeneil88', 'gxiao2', 'kimzihuang', 'anxovidal8', 'damlakubattt', 'andreadiazgar', 'lukunze1', 'joker632455', 'shuming2', 'j.haliburton', 'abieday1704', 'ozbunar01', 'ugur.cankaya.3718', 'nihaosawaddee', 'magic_ocean99', 'sinasigurpinar', 'tuberkargan', 'jarodm2', 'nabilah1403', 'amiruldanial99', 'yansi', 'cheokonn', 'ammaralaa516', 'juanmacano97', 'maxernest', 'marcosanllo', 'facundovia', 'michaelsaldana1', 'kie180073', 'bassamtarek', 'abbesalaeddine', 'restep2', 'estebanrial', 'martinzapata', '46harunakgul', 'talwren', 'leejq', 'mohammedemadeldin2000', 'jeanmichael.deschenes', 'miloaismanis', 'mmartinezsanchez', 'emrebuyukkose2', 'luciano.brignone', 'anwar909', 'ahmedamr', 'omarmagdy', 'abdurrahmn13', 'nikalyaamani', 'sdehoyos47', 'apascao', 'vincentpainchaud.vp', 'nagihankececi', 'nazimmath3', 'apb5472', 'rikardberger', 'mr4425', 'jacobzeshleman', 'guoyao', 'ikhbal', 'michael.mechelay', 'khor', 'david_atef', 'yaseminablacandir', 'c.a.stupka', 'amparo.castro.96', 'dhodapp', 'fkl217', 'farahsamir978', 'kie180039', 'atharva98', 'kph2', 'hafizmokh99', 'hilisa', 'kowjiajin', 'fred_dion', 'harshini9962', 'pvalladaresfdez', 'dancastaneda', 'jn1404', 'atx203', 'ammareltalli', 'amani12345', 'aaq', 'ledicia97', 'adriangarea', 'onaam8', 'zehuahe2', 'siemprewowthechami', 'justin.lariviere.25', 'tbryan', 'ludovick.begin', 'tss3', 'david2397', 'tmi211', 'kie180079', 'physquig', 'zakhwan7', 'mallen22', 'amr_ua07', 'pip29', 'fcfrancapra94', 'cristinacigarran', 'vanesagarcia', 'adnanyuceer', 'fathy1104', 'perezsarmar', 'al4995', 'melroy_caeiro', 'helenalecoq97', 'caglanlee', 'afeefz', 'jpmcgee98', 'ales.gajdacz', 'masitadonmez', 'eddin21', 'gemma', 'elad.d', 'xxlilmontysignxx', 'farah26', 'latecnologiameodia', 'abdulrahim2905', 'exjamil', 'vickytubio', 'ozgurkablan26', 'lderemo', 'javierisma98', 'redzuan11', 'yeejou990318', 'david.garrido', 'adarsh123', 'rileyroca', 'movi205', 'acregodean', 'pablosaavedra', 'maramtarek53', 's_coriolis', 'kakmeera1999', 'josepazmartin', 'travisc2', 'electronica18', 'kie180702', 'bhliu97', 'ematson5897', 'martin32', 'maniphysics09', 'eduard25252598', 'moh.ashraf105', 'pablobou4', 'khazanv2', 'ahchehyan', 'ramonruiz.infor', 'brannon44', 'scremin', 'aasifhameed99', 'wahidiah52', 'm939454', 'aboone06', 'bluelobster', 'gabrielyii99', 'veronica.mieites', 'jinwoo2', 'syin4', 'diamond92', 'bflores18', 'njgale01', 'mgk816']",2,"['dhara041992', 'devajnparikh1995']",394,"['miri23', 'mohamedsameh', 'reemali99_', 'gc_1', 'kerryreto', 'zikrizaki88995', 'je_guilbert', 'jorgecastelo5', 'spazos7', 'soccadelic44', 'ahern0722', 'devajnparikh1995', 'benoiturcotte', 'noureldin1999', 'alberfn', 'guttsfulltyagi', 'mavanzato0418', 'rkchapman', 'guibill10', 'ari6nd', 'michael2010814', 'happyleexin', 'omardeyaa', 'hong_gao', 'irenehb92', 'sandrabashara', 'nihatyavuz', 'akozych2', 'vikazvereva', 'danielfernandezcalo', 'anthonyroux', 'arrow823', 'aimansyaz99', 'annahaozheng0606', 'rocio', 'masonpb2', 'samashraf1', 'kirankumar94', 'prabuddha_888253127', 'carlosvigo1997', 'muvafikmelikkaya', 'amrebrahim', 'jtorres17', 'jzhan142', 'syedzakwan', 'samet1231234', 'kie180028', 'nadhnasorudin', 'avw2', 'ahmedsameh1698', 'acn562', 'moh.bahaa', 'arifjalani99', 'youssefsherif22', 'asyrafaqil', 'mjgebara14', 'camilolcastro97', 'bcperki2', 'azizijazam11', 'ahmedayman2370', 'rishu', 'ranasherif65', 'kyang37', 'nuanno97', 'smrdafdl', 'brknshn', 'jbaggie2019', 'youssef2042000', 'olivier.gilbert.paquet', 'saipraneett', 'prakharbhargava0', 'hf4', 'nadja1', 'teoster50', 'mohaballam', 'ryanorem', 'shradhap', 'va844', 'neuroque', 'seifhabib', 'anibarseghyan', 'williammitchell5818', 'pingan99', 'mjoza2', 'mariz', 'virajput299', 'bleuminuit', 'ffazul64', 'paul.aniruddha', 'melaniejkramer', 'oliviercharbonneau', 'ilou', 'chengweiheng', 'evrenyigit', 'emilechouinard', 'pythagoras2', 'kason.carroll', 'malgaca', 'kie180031', 'carlosvillar54', 'ckim123', 'kychui2', 'kanet1234', 'mohabayman', 'sanchjai', 'nbs691', 'oishikfaruque', 'lauragdevesa', 'nowapoca', 'ahagras13', 'akash140410107098', 'chithong', 'saharoaf', 'amni99', 'svo4321', 'lino13', 'vblanco.nico', 'aimanadnan', 'alidsjt', 'dlee145', 'stambo', 'lauramolinosmayo', 'mateocampos', 'hamidausat', 'yjenyiee155', 'retty8', 'sebasket14', 'marcmagdy98', 'janalorenzolumbreras', 'marianne.gratton.1', 'trkmengkay', 'shaf31', 'youxing0309', 'nourananwar123', 'puertarcd', 'felivitullo87', 'manuelsomoza94', 'alecorti.pardo', 'muteki', 'corredoira', 'gabrielyii', 'jinsup2', 'staceyn2', 'kaitlinh', 'cbecker413', 'adam562', 'haclarke', 'xosegq16', 'e1150590', 'kalebhilde', 'adriancheah', 'jaimefookinlannister', 'tonybocadillosgrandes', 'rooban11', 'wowmuchchuck', 'xunyong', 'hishamzakaria20', 'rxtodd', 'sarapl', 'alimatama', 'jahnavikachhia', 'alexisdixon6', 'saegner2', 'pranjal3', 'berkaydean', 'baleko12345', 'sparshagarwal1009', 'xyz11', 'david.peral.moran', 'tingliang', 'isabelmaria.vazquez', 'aishu98', 'nadanasser1199', 'desmondsoon', 'keerthisv', 'musabmalek0717', 'mcruces.fz', 'tuberkargan_97', 'worldlineusaf', 'sealseal', 'bharath3', 'cloudyoverhead', 'dhvanil', 'ramy_maged4', 'lsleed', 'zhixin2', 'sriharshap', 'tyy233', 'njs035', 'ablahsaoud', 'nolmos96', 'shorouk_ossama', 'kaustubh.shirpurkar', 'pedrosiaba', 'coderko3', 'alifzulkifli99', 'alancantu57', 'baohl2', 'mengkem2', 'selena', 'tdubnansky6', 'ypp200', 'aengm', 'kartal', 'jacquelinethardin', 'mohameeddsamy', 'dhara041992', 'jipiccardi', 'amlibrahim', 'rahimnoorj', 'dcpang2', 'tamchouweng', 'elizametias12', 'efrenhub', 'mrefaat', 'ethanmorse', 'taymacnichols', 'ryanboucher', 'kirolosehab99', 'carlosbesadaromero', 'ericrobles', 'janeneil88', 'gxiao2', 'kimzihuang', 'anxovidal8', 'damlakubattt', 'andreadiazgar', 'lukunze1', 'joker632455', 'shuming2', 'j.haliburton', 'abieday1704', 'ozbunar01', 'ugur.cankaya.3718', 'nihaosawaddee', 'magic_ocean99', 'sinasigurpinar', 'tuberkargan', 'jarodm2', 'nabilah1403', 'amiruldanial99', 'yansi', 'cheokonn', 'ammaralaa516', 'juanmacano97', 'maxernest', 'marcosanllo', 'viratbhatt007', 'facundovia', 'michaelsaldana1', 'kie180073', 'bassamtarek', 'abbesalaeddine', 'restep2', 'estebanrial', 'martinzapata', '46harunakgul', 'talwren', 'leejq', 'mohammedemadeldin2000', 'jeanmichael.deschenes', 'miloaismanis', 'mmartinezsanchez', 'emrebuyukkose2', 'luciano.brignone', 'anwar909', 'ahmedamr', 'omarmagdy', 'abdurrahmn13', 'nikalyaamani', 'sdehoyos47', 'apascao', 'yubai', 'vincentpainchaud.vp', 'nagihankececi', 'nazimmath3', 'apb5472', 'rikardberger', 'mr4425', 'jacobzeshleman', 'guoyao', 'kiruthikaabalu181996', 'ikhbal', 'michael.mechelay', 'khor', 'david_atef', 'yaseminablacandir', 'c.a.stupka', 'amparo.castro.96', 'dhodapp', 'fkl217', 'farahsamir978', 'kie180039', 'atharva98', 'kph2', 'hafizmokh99', 'hilisa', 'kowjiajin', 'fred_dion', 'harshini9962', 'pvalladaresfdez', 'dancastaneda', 'jn1404', 'atx203', 'ammareltalli', 'amani12345', 'aaq', 'ledicia97', 'adriangarea', 'onaam8', 'zehuahe2', 'siemprewowthechami', 'justin.lariviere.25', 'tbryan', 'ludovick.begin', 'tss3', 'david2397', 'tmi211', 'kie180079', 'physquig', 'zakhwan7', 'mallen22', 'amr_ua07', 'pip29', 'fcfrancapra94', 'cristinacigarran', 'vanesagarcia', 'adnanyuceer', 'fathy1104', 'perezsarmar', 'al4995', 'melroy_caeiro', 'helenalecoq97', 'caglanlee', 'afeefz', 'jpmcgee98', 'ales.gajdacz', 'masitadonmez', 'eddin21', 'gemma', 'hmoulvi1', 'elad.d', 'xxlilmontysignxx', 'farah26', 'latecnologiameodia', 'abdulrahim2905', 'exjamil', 'vickytubio', 'ozgurkablan26', 'lderemo', 'ankit6257', 'javierisma98', 'redzuan11', 'yeejou990318', 'david.garrido', 'adarsh123', 'rileyroca', 'movi205', 'acregodean', 'pablosaavedra', 'maramtarek53', 's_coriolis', 'kakmeera1999', 'josepazmartin', 'travisc2', 'electronica18', 'kie180702', 'bhliu97', 'ematson5897', 'ashutoshsinghhenry6', 'martin32', 'maniphysics09', 'eduard25252598', 'moh.ashraf105', 'pablobou4', 'khazanv2', 'ahchehyan', 'ramonruiz.infor', 'brannon44', 'scremin', 'aasifhameed99', 'wahidiah52', 'm939454', 'aboone06', 'bluelobster', 'gabrielyii99', 'veronica.mieites', 'jinwoo2', 'syin4', 'diamond92', 'bflores18', 'njgale01', 'mgk816', 'dkshelat']"
1,22,392,20,7,"['tuberkargan_97', 'trkmengkay', 'ozgurkablan26', 'brknshn', 'sinasigurpinar', 'joker632455', 'emrebuyukkose2']",385,"['miri23', 'mohamedsameh', 'reemali99_', 'gc_1', 'kerryreto', 'zikrizaki88995', 'je_guilbert', 'jorgecastelo5', 'spazos7', 'soccadelic44', 'ahern0722', 'benoiturcotte', 'noureldin1999', 'alberfn', 'guttsfulltyagi', 'mavanzato0418', 'rkchapman', 'guibill10', 'ari6nd', 'michael2010814', 'happyleexin', 'omardeyaa', 'hong_gao', 'irenehb92', 'sandrabashara', 'nihatyavuz', 'akozych2', 'vikazvereva', 'danielfernandezcalo', 'anthonyroux', 'arrow823', 'aimansyaz99', 'annahaozheng0606', 'rocio', 'masonpb2', 'samashraf1', 'kirankumar94', 'prabuddha_888253127', 'carlosvigo1997', 'muvafikmelikkaya', 'amrebrahim', 'jtorres17', 'jzhan142', 'syedzakwan', 'samet1231234', 'kie180028', 'nadhnasorudin', 'avw2', 'ahmedsameh1698', 'acn562', 'moh.bahaa', 'arifjalani99', 'youssefsherif22', 'asyrafaqil', 'mjgebara14', 'camilolcastro97', 'bcperki2', 'azizijazam11', 'ahmedayman2370', 'rishu', 'ranasherif65', 'kyang37', 'nuanno97', 'smrdafdl', 'jbaggie2019', 'youssef2042000', 'olivier.gilbert.paquet', 'saipraneett', 'prakharbhargava0', 'hf4', 'nadja1', 'teoster50', 'mohaballam', 'ryanorem', 'shradhap', 'va844', 'neuroque', 'seifhabib', 'anibarseghyan', 'williammitchell5818', 'pingan99', 'mjoza2', 'mariz', 'virajput299', 'bleuminuit', 'ffazul64', 'paul.aniruddha', 'melaniejkramer', 'oliviercharbonneau', 'ilou', 'chengweiheng', 'evrenyigit', 'emilechouinard', 'pythagoras2', 'kason.carroll', 'malgaca', 'kie180031', 'carlosvillar54', 'ckim123', 'kychui2', 'kanet1234', 'mohabayman', 'sanchjai', 'nbs691', 'oishikfaruque', 'lauragdevesa', 'nowapoca', 'ahagras13', 'akash140410107098', 'chithong', 'saharoaf', 'amni99', 'svo4321', 'lino13', 'vblanco.nico', 'aimanadnan', 'alidsjt', 'dlee145', 'stambo', 'lauramolinosmayo', 'mateocampos', 'hamidausat', 'yjenyiee155', 'retty8', 'sebasket14', 'marcmagdy98', 'janalorenzolumbreras', 'marianne.gratton.1', 'shaf31', 'youxing0309', 'nourananwar123', 'puertarcd', 'felivitullo87', 'manuelsomoza94', 'alecorti.pardo', 'muteki', 'corredoira', 'gabrielyii', 'jinsup2', 'staceyn2', 'kaitlinh', 'cbecker413', 'adam562', 'haclarke', 'xosegq16', 'e1150590', 'kalebhilde', 'adriancheah', 'jaimefookinlannister', 'tonybocadillosgrandes', 'rooban11', 'wowmuchchuck', 'xunyong', 'hishamzakaria20', 'rxtodd', 'sarapl', 'alimatama', 'jahnavikachhia', 'alexisdixon6', 'saegner2', 'pranjal3', 'berkaydean', 'baleko12345', 'sparshagarwal1009', 'xyz11', 'david.peral.moran', 'tingliang', 'isabelmaria.vazquez', 'aishu98', 'nadanasser1199', 'desmondsoon', 'keerthisv', 'musabmalek0717', 'mcruces.fz', 'worldlineusaf', 'sealseal', 'bharath3', 'cloudyoverhead', 'dhvanil', 'ramy_maged4', 'lsleed', 'zhixin2', 'sriharshap', 'tyy233', 'njs035', 'ablahsaoud', 'nolmos96', 'shorouk_ossama', 'kaustubh.shirpurkar', 'pedrosiaba', 'coderko3', 'alifzulkifli99', 'alancantu57', 'baohl2', 'mengkem2', 'selena', 'tdubnansky6', 'ypp200', 'aengm', 'kartal', 'jacquelinethardin', 'mohameeddsamy', 'jipiccardi', 'amlibrahim', 'rahimnoorj', 'dcpang2', 'tamchouweng', 'elizametias12', 'efrenhub', 'mrefaat', 'ethanmorse', 'taymacnichols', 'ryanboucher', 'kirolosehab99', 'carlosbesadaromero', 'ericrobles', 'janeneil88', 'gxiao2', 'kimzihuang', 'anxovidal8', 'damlakubattt', 'andreadiazgar', 'lukunze1', 'shuming2', 'j.haliburton', 'abieday1704', 'ozbunar01', 'ugur.cankaya.3718', 'nihaosawaddee', 'magic_ocean99', 'tuberkargan', 'jarodm2', 'nabilah1403', 'amiruldanial99', 'yansi', 'cheokonn', 'ammaralaa516', 'juanmacano97', 'maxernest', 'marcosanllo', 'viratbhatt007', 'facundovia', 'michaelsaldana1', 'kie180073', 'bassamtarek', 'abbesalaeddine', 'restep2', 'estebanrial', 'martinzapata', '46harunakgul', 'talwren', 'leejq', 'mohammedemadeldin2000', 'jeanmichael.deschenes', 'miloaismanis', 'mmartinezsanchez', 'luciano.brignone', 'anwar909', 'ahmedamr', 'omarmagdy', 'abdurrahmn13', 'nikalyaamani', 'sdehoyos47', 'apascao', 'yubai', 'vincentpainchaud.vp', 'nagihankececi', 'nazimmath3', 'apb5472', 'rikardberger', 'mr4425', 'jacobzeshleman', 'guoyao', 'kiruthikaabalu181996', 'ikhbal', 'michael.mechelay', 'khor', 'david_atef', 'yaseminablacandir', 'c.a.stupka', 'amparo.castro.96', 'dhodapp', 'fkl217', 'farahsamir978', 'kie180039', 'atharva98', 'kph2', 'hafizmokh99', 'hilisa', 'kowjiajin', 'fred_dion', 'harshini9962', 'pvalladaresfdez', 'dancastaneda', 'jn1404', 'atx203', 'ammareltalli', 'amani12345', 'aaq', 'ledicia97', 'adriangarea', 'onaam8', 'zehuahe2', 'siemprewowthechami', 'justin.lariviere.25', 'tbryan', 'ludovick.begin', 'tss3', 'david2397', 'tmi211', 'kie180079', 'physquig', 'zakhwan7', 'mallen22', 'amr_ua07', 'pip29', 'fcfrancapra94', 'cristinacigarran', 'vanesagarcia', 'adnanyuceer', 'fathy1104', 'perezsarmar', 'al4995', 'melroy_caeiro', 'helenalecoq97', 'caglanlee', 'afeefz', 'jpmcgee98', 'ales.gajdacz', 'masitadonmez', 'eddin21', 'gemma', 'hmoulvi1', 'elad.d', 'xxlilmontysignxx', 'farah26', 'latecnologiameodia', 'abdulrahim2905', 'exjamil', 'vickytubio', 'lderemo', 'ankit6257', 'javierisma98', 'redzuan11', 'yeejou990318', 'david.garrido', 'adarsh123', 'rileyroca', 'movi205', 'acregodean', 'pablosaavedra', 'maramtarek53', 's_coriolis', 'kakmeera1999', 'josepazmartin', 'travisc2', 'electronica18', 'kie180702', 'bhliu97', 'ematson5897', 'ashutoshsinghhenry6', 'martin32', 'maniphysics09', 'eduard25252598', 'moh.ashraf105', 'pablobou4', 'khazanv2', 'ahchehyan', 'ramonruiz.infor', 'brannon44', 'scremin', 'aasifhameed99', 'wahidiah52', 'm939454', 'aboone06', 'bluelobster', 'gabrielyii99', 'veronica.mieites', 'jinwoo2', 'syin4', 'diamond92', 'bflores18', 'njgale01', 'mgk816', 'dkshelat']",13,"['melisozkarr', 'okanircann', 'fatiherdgn25', 'elifisparta38', 'ozgurdenizkozan', 'nihansulukoy', 'furkanturk1352', 'sudekoza', 'metalist_kaan', 'polat.gokberk', 'senanurcetin96', 'ronal_denho_931', 'oakbulut1997']",405,"['miri23', 'mohamedsameh', 'reemali99_', 'gc_1', 'kerryreto', 'zikrizaki88995', 'je_guilbert', 'jorgecastelo5', 'spazos7', 'soccadelic44', 'ahern0722', 'benoiturcotte', 'noureldin1999', 'alberfn', 'guttsfulltyagi', 'mavanzato0418', 'rkchapman', 'guibill10', 'ari6nd', 'michael2010814', 'happyleexin', 'omardeyaa', 'hong_gao', 'irenehb92', 'sandrabashara', 'nihatyavuz', 'akozych2', 'vikazvereva', 'danielfernandezcalo', 'anthonyroux', 'oakbulut1997', 'arrow823', 'aimansyaz99', 'annahaozheng0606', 'rocio', 'masonpb2', 'samashraf1', 'kirankumar94', 'prabuddha_888253127', 'carlosvigo1997', 'muvafikmelikkaya', 'amrebrahim', 'jtorres17', 'jzhan142', 'syedzakwan', 'samet1231234', 'kie180028', 'nadhnasorudin', 'avw2', 'ahmedsameh1698', 'acn562', 'moh.bahaa', 'arifjalani99', 'furkanturk1352', 'youssefsherif22', 'asyrafaqil', 'mjgebara14', 'camilolcastro97', 'bcperki2', 'azizijazam11', 'ahmedayman2370', 'rishu', 'ranasherif65', 'kyang37', 'nihansulukoy', 'nuanno97', 'smrdafdl', 'brknshn', 'jbaggie2019', 'youssef2042000', 'olivier.gilbert.paquet', 'saipraneett', 'prakharbhargava0', 'hf4', 'nadja1', 'teoster50', 'mohaballam', 'ryanorem', 'shradhap', 'va844', 'neuroque', 'seifhabib', 'anibarseghyan', 'williammitchell5818', 'metalist_kaan', 'pingan99', 'mjoza2', 'mariz', 'virajput299', 'bleuminuit', 'ffazul64', 'paul.aniruddha', 'melaniejkramer', 'oliviercharbonneau', 'ilou', 'chengweiheng', 'evrenyigit', 'emilechouinard', 'pythagoras2', 'kason.carroll', 'malgaca', 'kie180031', 'carlosvillar54', 'ckim123', 'kychui2', 'kanet1234', 'mohabayman', 'sanchjai', 'nbs691', 'oishikfaruque', 'lauragdevesa', 'nowapoca', 'ahagras13', 'akash140410107098', 'chithong', 'saharoaf', 'amni99', 'svo4321', 'lino13', 'vblanco.nico', 'aimanadnan', 'alidsjt', 'dlee145', 'stambo', 'lauramolinosmayo', 'mateocampos', 'hamidausat', 'yjenyiee155', 'retty8', 'sebasket14', 'marcmagdy98', 'janalorenzolumbreras', 'marianne.gratton.1', 'sudekoza', 'trkmengkay', 'shaf31', 'youxing0309', 'nourananwar123', 'puertarcd', 'felivitullo87', 'manuelsomoza94', 'alecorti.pardo', 'muteki', 'corredoira', 'gabrielyii', 'elifisparta38', 'jinsup2', 'staceyn2', 'kaitlinh', 'cbecker413', 'adam562', 'haclarke', 'xosegq16', 'e1150590', 'kalebhilde', 'adriancheah', 'jaimefookinlannister', 'tonybocadillosgrandes', 'rooban11', 'wowmuchchuck', 'xunyong', 'hishamzakaria20', 'rxtodd', 'sarapl', 'alimatama', 'jahnavikachhia', 'alexisdixon6', 'saegner2', 'pranjal3', 'berkaydean', 'baleko12345', 'sparshagarwal1009', 'xyz11', 'david.peral.moran', 'tingliang', 'isabelmaria.vazquez', 'aishu98', 'nadanasser1199', 'desmondsoon', 'keerthisv', 'musabmalek0717', 'mcruces.fz', 'tuberkargan_97', 'worldlineusaf', 'sealseal', 'bharath3', 'cloudyoverhead', 'dhvanil', 'ramy_maged4', 'lsleed', 'zhixin2', 'sriharshap', 'tyy233', 'njs035', 'ablahsaoud', 'nolmos96', 'shorouk_ossama', 'kaustubh.shirpurkar', 'polat.gokberk', 'pedrosiaba', 'coderko3', 'alifzulkifli99', 'alancantu57', 'baohl2', 'mengkem2', 'selena', 'tdubnansky6', 'ypp200', 'aengm', 'kartal', 'jacquelinethardin', 'mohameeddsamy', 'jipiccardi', 'amlibrahim', 'rahimnoorj', 'dcpang2', 'tamchouweng', 'elizametias12', 'efrenhub', 'mrefaat', 'ethanmorse', 'taymacnichols', 'ryanboucher', 'kirolosehab99', 'carlosbesadaromero', 'ericrobles', 'janeneil88', 'gxiao2', 'kimzihuang', 'anxovidal8', 'damlakubattt', 'andreadiazgar', 'lukunze1', 'joker632455', 'shuming2', 'j.haliburton', 'abieday1704', 'ozbunar01', 'ugur.cankaya.3718', 'nihaosawaddee', 'magic_ocean99', 'sinasigurpinar', 'tuberkargan', 'jarodm2', 'nabilah1403', 'amiruldanial99', 'yansi', 'cheokonn', 'ammaralaa516', 'juanmacano97', 'maxernest', 'marcosanllo', 'viratbhatt007', 'facundovia', 'michaelsaldana1', 'kie180073', 'bassamtarek', 'abbesalaeddine', 'restep2', 'estebanrial', 'martinzapata', '46harunakgul', 'talwren', 'leejq', 'mohammedemadeldin2000', 'jeanmichael.deschenes', 'miloaismanis', 'mmartinezsanchez', 'emrebuyukkose2', 'luciano.brignone', 'anwar909', 'ahmedamr', 'omarmagdy', 'abdurrahmn13', 'nikalyaamani', 'sdehoyos47', 'apascao', 'yubai', 'vincentpainchaud.vp', 'nagihankececi', 'nazimmath3', 'apb5472', 'fatiherdgn25', 'rikardberger', 'mr4425', 'jacobzeshleman', 'guoyao', 'kiruthikaabalu181996', 'ikhbal', 'michael.mechelay', 'khor', 'david_atef', 'yaseminablacandir', 'c.a.stupka', 'amparo.castro.96', 'dhodapp', 'fkl217', 'farahsamir978', 'kie180039', 'atharva98', 'kph2', 'hafizmokh99', 'hilisa', 'kowjiajin', 'fred_dion', 'harshini9962', 'pvalladaresfdez', 'dancastaneda', 'jn1404', 'atx203', 'ammareltalli', 'amani12345', 'aaq', 'ledicia97', 'adriangarea', 'ronal_denho_931', 'onaam8', 'zehuahe2', 'siemprewowthechami', 'justin.lariviere.25', 'tbryan', 'ludovick.begin', 'tss3', 'david2397', 'tmi211', 'kie180079', 'physquig', 'zakhwan7', 'mallen22', 'amr_ua07', 'melisozkarr', 'pip29', 'fcfrancapra94', 'cristinacigarran', 'vanesagarcia', 'adnanyuceer', 'ozgurdenizkozan', 'fathy1104', 'perezsarmar', 'al4995', 'melroy_caeiro', 'helenalecoq97', 'caglanlee', 'afeefz', 'jpmcgee98', 'ales.gajdacz', 'masitadonmez', 'eddin21', 'gemma', 'hmoulvi1', 'elad.d', 'xxlilmontysignxx', 'farah26', 'latecnologiameodia', 'abdulrahim2905', 'exjamil', 'vickytubio', 'ozgurkablan26', 'lderemo', 'ankit6257', 'javierisma98', 'redzuan11', 'yeejou990318', 'david.garrido', 'adarsh123', 'rileyroca', 'movi205', 'acregodean', 'pablosaavedra', 'maramtarek53', 's_coriolis', 'kakmeera1999', 'josepazmartin', 'travisc2', 'electronica18', 'kie180702', 'bhliu97', 'ematson5897', 'ashutoshsinghhenry6', 'senanurcetin96', 'martin32', 'maniphysics09', 'eduard25252598', 'moh.ashraf105', 'okanircann', 'pablobou4', 'khazanv2', 'ahchehyan', 'ramonruiz.infor', 'brannon44', 'scremin', 'aasifhameed99', 'wahidiah52', 'm939454', 'aboone06', 'bluelobster', 'gabrielyii99', 'veronica.mieites', 'jinwoo2', 'syin4', 'diamond92', 'bflores18', 'njgale01', 'mgk816', 'dkshelat']"
1,17,392,15,9,"['va844', 'tyy233', 'fkl217', 'jn1404', 'atx203', 'mr4425', 'tmi211', 'al4995', 'michael2010814']",383,"['miri23', 'mohamedsameh', 'reemali99_', 'gc_1', 'kerryreto', 'zikrizaki88995', 'je_guilbert', 'jorgecastelo5', 'spazos7', 'soccadelic44', 'ahern0722', 'benoiturcotte', 'noureldin1999', 'alberfn', 'guttsfulltyagi', 'mavanzato0418', 'rkchapman', 'guibill10', 'ari6nd', 'happyleexin', 'omardeyaa', 'hong_gao', 'irenehb92', 'sandrabashara', 'nihatyavuz', 'akozych2', 'vikazvereva', 'danielfernandezcalo', 'anthonyroux', 'arrow823', 'aimansyaz99', 'annahaozheng0606', 'rocio', 'masonpb2', 'samashraf1', 'kirankumar94', 'prabuddha_888253127', 'carlosvigo1997', 'muvafikmelikkaya', 'amrebrahim', 'jtorres17', 'jzhan142', 'syedzakwan', 'samet1231234', 'kie180028', 'nadhnasorudin', 'avw2', 'ahmedsameh1698', 'acn562', 'moh.bahaa', 'arifjalani99', 'youssefsherif22', 'asyrafaqil', 'mjgebara14', 'camilolcastro97', 'bcperki2', 'azizijazam11', 'ahmedayman2370', 'rishu', 'ranasherif65', 'kyang37', 'nuanno97', 'smrdafdl', 'brknshn', 'jbaggie2019', 'youssef2042000', 'olivier.gilbert.paquet', 'saipraneett', 'prakharbhargava0', 'hf4', 'nadja1', 'teoster50', 'mohaballam', 'ryanorem', 'shradhap', 'neuroque', 'seifhabib', 'anibarseghyan', 'williammitchell5818', 'pingan99', 'mjoza2', 'mariz', 'virajput299', 'bleuminuit', 'ffazul64', 'paul.aniruddha', 'melaniejkramer', 'oliviercharbonneau', 'ilou', 'chengweiheng', 'evrenyigit', 'emilechouinard', 'pythagoras2', 'kason.carroll', 'malgaca', 'kie180031', 'carlosvillar54', 'ckim123', 'kychui2', 'kanet1234', 'mohabayman', 'sanchjai', 'nbs691', 'oishikfaruque', 'lauragdevesa', 'nowapoca', 'ahagras13', 'akash140410107098', 'chithong', 'saharoaf', 'amni99', 'svo4321', 'lino13', 'vblanco.nico', 'aimanadnan', 'alidsjt', 'dlee145', 'stambo', 'lauramolinosmayo', 'mateocampos', 'hamidausat', 'yjenyiee155', 'retty8', 'sebasket14', 'marcmagdy98', 'janalorenzolumbreras', 'marianne.gratton.1', 'trkmengkay', 'shaf31', 'youxing0309', 'nourananwar123', 'puertarcd', 'felivitullo87', 'manuelsomoza94', 'alecorti.pardo', 'muteki', 'corredoira', 'gabrielyii', 'jinsup2', 'staceyn2', 'kaitlinh', 'cbecker413', 'adam562', 'haclarke', 'xosegq16', 'e1150590', 'kalebhilde', 'adriancheah', 'jaimefookinlannister', 'tonybocadillosgrandes', 'rooban11', 'wowmuchchuck', 'xunyong', 'hishamzakaria20', 'rxtodd', 'sarapl', 'alimatama', 'jahnavikachhia', 'alexisdixon6', 'saegner2', 'pranjal3', 'berkaydean', 'baleko12345', 'sparshagarwal1009', 'xyz11', 'david.peral.moran', 'tingliang', 'isabelmaria.vazquez', 'aishu98', 'nadanasser1199', 'desmondsoon', 'keerthisv', 'musabmalek0717', 'mcruces.fz', 'tuberkargan_97', 'worldlineusaf', 'sealseal', 'bharath3', 'cloudyoverhead', 'dhvanil', 'ramy_maged4', 'lsleed', 'zhixin2', 'sriharshap', 'njs035', 'ablahsaoud', 'nolmos96', 'shorouk_ossama', 'kaustubh.shirpurkar', 'pedrosiaba', 'coderko3', 'alifzulkifli99', 'alancantu57', 'baohl2', 'mengkem2', 'selena', 'tdubnansky6', 'ypp200', 'aengm', 'kartal', 'jacquelinethardin', 'mohameeddsamy', 'jipiccardi', 'amlibrahim', 'rahimnoorj', 'dcpang2', 'tamchouweng', 'elizametias12', 'efrenhub', 'mrefaat', 'ethanmorse', 'taymacnichols', 'ryanboucher', 'kirolosehab99', 'carlosbesadaromero', 'ericrobles', 'janeneil88', 'gxiao2', 'kimzihuang', 'anxovidal8', 'damlakubattt', 'andreadiazgar', 'lukunze1', 'joker632455', 'shuming2', 'j.haliburton', 'abieday1704', 'ozbunar01', 'ugur.cankaya.3718', 'nihaosawaddee', 'magic_ocean99', 'sinasigurpinar', 'tuberkargan', 'jarodm2', 'nabilah1403', 'amiruldanial99', 'yansi', 'cheokonn', 'ammaralaa516', 'juanmacano97', 'maxernest', 'marcosanllo', 'viratbhatt007', 'facundovia', 'michaelsaldana1', 'kie180073', 'bassamtarek', 'abbesalaeddine', 'restep2', 'estebanrial', 'martinzapata', '46harunakgul', 'talwren', 'leejq', 'mohammedemadeldin2000', 'jeanmichael.deschenes', 'miloaismanis', 'mmartinezsanchez', 'emrebuyukkose2', 'luciano.brignone', 'anwar909', 'ahmedamr', 'omarmagdy', 'abdurrahmn13', 'nikalyaamani', 'sdehoyos47', 'apascao', 'yubai', 'vincentpainchaud.vp', 'nagihankececi', 'nazimmath3', 'apb5472', 'rikardberger', 'jacobzeshleman', 'guoyao', 'kiruthikaabalu181996', 'ikhbal', 'michael.mechelay', 'khor', 'david_atef', 'yaseminablacandir', 'c.a.stupka', 'amparo.castro.96', 'dhodapp', 'farahsamir978', 'kie180039', 'atharva98', 'kph2', 'hafizmokh99', 'hilisa', 'kowjiajin', 'fred_dion', 'harshini9962', 'pvalladaresfdez', 'dancastaneda', 'ammareltalli', 'amani12345', 'aaq', 'ledicia97', 'adriangarea', 'onaam8', 'zehuahe2', 'siemprewowthechami', 'justin.lariviere.25', 'tbryan', 'ludovick.begin', 'tss3', 'david2397', 'kie180079', 'physquig', 'zakhwan7', 'mallen22', 'amr_ua07', 'pip29', 'fcfrancapra94', 'cristinacigarran', 'vanesagarcia', 'adnanyuceer', 'fathy1104', 'perezsarmar', 'melroy_caeiro', 'helenalecoq97', 'caglanlee', 'afeefz', 'jpmcgee98', 'ales.gajdacz', 'masitadonmez', 'eddin21', 'gemma', 'hmoulvi1', 'elad.d', 'xxlilmontysignxx', 'farah26', 'latecnologiameodia', 'abdulrahim2905', 'exjamil', 'vickytubio', 'ozgurkablan26', 'lderemo', 'ankit6257', 'javierisma98', 'redzuan11', 'yeejou990318', 'david.garrido', 'adarsh123', 'rileyroca', 'movi205', 'acregodean', 'pablosaavedra', 'maramtarek53', 's_coriolis', 'kakmeera1999', 'josepazmartin', 'travisc2', 'electronica18', 'kie180702', 'bhliu97', 'ematson5897', 'ashutoshsinghhenry6', 'martin32', 'maniphysics09', 'eduard25252598', 'moh.ashraf105', 'pablobou4', 'khazanv2', 'ahchehyan', 'ramonruiz.infor', 'brannon44', 'scremin', 'aasifhameed99', 'wahidiah52', 'm939454', 'aboone06', 'bluelobster', 'gabrielyii99', 'veronica.mieites', 'jinwoo2', 'syin4', 'diamond92', 'bflores18', 'njgale01', 'mgk816', 'dkshelat']",6,"['mh4208', 'ab6858', 'xc882', 'erincrowe', 'cki210', 'vmj226']",398,"['miri23', 'mohamedsameh', 'reemali99_', 'gc_1', 'kerryreto', 'zikrizaki88995', 'je_guilbert', 'jorgecastelo5', 'spazos7', 'soccadelic44', 'ahern0722', 'benoiturcotte', 'noureldin1999', 'alberfn', 'guttsfulltyagi', 'mavanzato0418', 'rkchapman', 'guibill10', 'ari6nd', 'michael2010814', 'happyleexin', 'omardeyaa', 'hong_gao', 'irenehb92', 'sandrabashara', 'nihatyavuz', 'akozych2', 'vikazvereva', 'danielfernandezcalo', 'anthonyroux', 'arrow823', 'aimansyaz99', 'annahaozheng0606', 'rocio', 'masonpb2', 'samashraf1', 'kirankumar94', 'prabuddha_888253127', 'carlosvigo1997', 'muvafikmelikkaya', 'amrebrahim', 'jtorres17', 'jzhan142', 'syedzakwan', 'samet1231234', 'kie180028', 'nadhnasorudin', 'avw2', 'ahmedsameh1698', 'acn562', 'moh.bahaa', 'arifjalani99', 'youssefsherif22', 'asyrafaqil', 'mjgebara14', 'camilolcastro97', 'bcperki2', 'azizijazam11', 'ahmedayman2370', 'rishu', 'ranasherif65', 'kyang37', 'nuanno97', 'smrdafdl', 'brknshn', 'jbaggie2019', 'youssef2042000', 'olivier.gilbert.paquet', 'saipraneett', 'prakharbhargava0', 'hf4', 'nadja1', 'teoster50', 'mohaballam', 'ryanorem', 'shradhap', 'va844', 'neuroque', 'seifhabib', 'anibarseghyan', 'williammitchell5818', 'pingan99', 'mjoza2', 'mariz', 'virajput299', 'bleuminuit', 'ffazul64', 'paul.aniruddha', 'melaniejkramer', 'oliviercharbonneau', 'ilou', 'chengweiheng', 'evrenyigit', 'emilechouinard', 'pythagoras2', 'kason.carroll', 'xc882', 'malgaca', 'kie180031', 'carlosvillar54', 'ckim123', 'kychui2', 'kanet1234', 'mohabayman', 'sanchjai', 'nbs691', 'oishikfaruque', 'lauragdevesa', 'nowapoca', 'ahagras13', 'akash140410107098', 'chithong', 'saharoaf', 'amni99', 'svo4321', 'lino13', 'vblanco.nico', 'aimanadnan', 'alidsjt', 'dlee145', 'stambo', 'lauramolinosmayo', 'mateocampos', 'hamidausat', 'yjenyiee155', 'retty8', 'sebasket14', 'marcmagdy98', 'janalorenzolumbreras', 'ab6858', 'marianne.gratton.1', 'trkmengkay', 'shaf31', 'youxing0309', 'nourananwar123', 'puertarcd', 'felivitullo87', 'manuelsomoza94', 'alecorti.pardo', 'muteki', 'corredoira', 'gabrielyii', 'jinsup2', 'staceyn2', 'kaitlinh', 'cbecker413', 'adam562', 'haclarke', 'xosegq16', 'e1150590', 'kalebhilde', 'adriancheah', 'jaimefookinlannister', 'tonybocadillosgrandes', 'rooban11', 'wowmuchchuck', 'xunyong', 'hishamzakaria20', 'rxtodd', 'sarapl', 'alimatama', 'jahnavikachhia', 'alexisdixon6', 'saegner2', 'pranjal3', 'berkaydean', 'baleko12345', 'sparshagarwal1009', 'xyz11', 'david.peral.moran', 'tingliang', 'isabelmaria.vazquez', 'aishu98', 'nadanasser1199', 'desmondsoon', 'keerthisv', 'musabmalek0717', 'mcruces.fz', 'tuberkargan_97', 'worldlineusaf', 'sealseal', 'bharath3', 'cloudyoverhead', 'dhvanil', 'ramy_maged4', 'lsleed', 'zhixin2', 'sriharshap', 'tyy233', 'njs035', 'ablahsaoud', 'nolmos96', 'shorouk_ossama', 'kaustubh.shirpurkar', 'erincrowe', 'pedrosiaba', 'coderko3', 'alifzulkifli99', 'alancantu57', 'baohl2', 'mengkem2', 'selena', 'tdubnansky6', 'ypp200', 'aengm', 'kartal', 'jacquelinethardin', 'mohameeddsamy', 'vmj226', 'jipiccardi', 'amlibrahim', 'rahimnoorj', 'dcpang2', 'tamchouweng', 'elizametias12', 'efrenhub', 'mrefaat', 'cki210', 'ethanmorse', 'taymacnichols', 'ryanboucher', 'kirolosehab99', 'carlosbesadaromero', 'ericrobles', 'janeneil88', 'gxiao2', 'kimzihuang', 'anxovidal8', 'damlakubattt', 'andreadiazgar', 'lukunze1', 'joker632455', 'shuming2', 'j.haliburton', 'abieday1704', 'ozbunar01', 'ugur.cankaya.3718', 'nihaosawaddee', 'magic_ocean99', 'sinasigurpinar', 'tuberkargan', 'jarodm2', 'nabilah1403', 'amiruldanial99', 'yansi', 'cheokonn', 'ammaralaa516', 'juanmacano97', 'maxernest', 'marcosanllo', 'viratbhatt007', 'facundovia', 'michaelsaldana1', 'kie180073', 'bassamtarek', 'abbesalaeddine', 'restep2', 'estebanrial', 'martinzapata', '46harunakgul', 'talwren', 'leejq', 'mohammedemadeldin2000', 'jeanmichael.deschenes', 'miloaismanis', 'mmartinezsanchez', 'emrebuyukkose2', 'luciano.brignone', 'anwar909', 'ahmedamr', 'omarmagdy', 'abdurrahmn13', 'nikalyaamani', 'sdehoyos47', 'apascao', 'yubai', 'vincentpainchaud.vp', 'nagihankececi', 'nazimmath3', 'apb5472', 'rikardberger', 'mr4425', 'jacobzeshleman', 'guoyao', 'kiruthikaabalu181996', 'ikhbal', 'michael.mechelay', 'khor', 'david_atef', 'yaseminablacandir', 'c.a.stupka', 'amparo.castro.96', 'dhodapp', 'fkl217', 'mh4208', 'farahsamir978', 'kie180039', 'atharva98', 'kph2', 'hafizmokh99', 'hilisa', 'kowjiajin', 'fred_dion', 'harshini9962', 'pvalladaresfdez', 'dancastaneda', 'jn1404', 'atx203', 'ammareltalli', 'amani12345', 'aaq', 'ledicia97', 'adriangarea', 'onaam8', 'zehuahe2', 'siemprewowthechami', 'justin.lariviere.25', 'tbryan', 'ludovick.begin', 'tss3', 'david2397', 'tmi211', 'kie180079', 'physquig', 'zakhwan7', 'mallen22', 'amr_ua07', 'pip29', 'fcfrancapra94', 'cristinacigarran', 'vanesagarcia', 'adnanyuceer', 'fathy1104', 'perezsarmar', 'al4995', 'melroy_caeiro', 'helenalecoq97', 'caglanlee', 'afeefz', 'jpmcgee98', 'ales.gajdacz', 'masitadonmez', 'eddin21', 'gemma', 'hmoulvi1', 'elad.d', 'xxlilmontysignxx', 'farah26', 'latecnologiameodia', 'abdulrahim2905', 'exjamil', 'vickytubio', 'ozgurkablan26', 'lderemo', 'ankit6257', 'javierisma98', 'redzuan11', 'yeejou990318', 'david.garrido', 'adarsh123', 'rileyroca', 'movi205', 'acregodean', 'pablosaavedra', 'maramtarek53', 's_coriolis', 'kakmeera1999', 'josepazmartin', 'travisc2', 'electronica18', 'kie180702', 'bhliu97', 'ematson5897', 'ashutoshsinghhenry6', 'martin32', 'maniphysics09', 'eduard25252598', 'moh.ashraf105', 'pablobou4', 'khazanv2', 'ahchehyan', 'ramonruiz.infor', 'brannon44', 'scremin', 'aasifhameed99', 'wahidiah52', 'm939454', 'aboone06', 'bluelobster', 'gabrielyii99', 'veronica.mieites', 'jinwoo2', 'syin4', 'diamond92', 'bflores18', 'njgale01', 'mgk816', 'dkshelat']"
1,21,392,15,12,"['electronica18', 'cristinacigarran', 'veronica.mieites', 'alimatama', 'janalorenzolumbreras', 'lino13', 'david2397', 'movi205', 'alidsjt', 'martin32', 'perezsarmar', 'lsleed']",380,"['miri23', 'mohamedsameh', 'reemali99_', 'gc_1', 'kerryreto', 'zikrizaki88995', 'je_guilbert', 'jorgecastelo5', 'spazos7', 'soccadelic44', 'ahern0722', 'benoiturcotte', 'noureldin1999', 'alberfn', 'guttsfulltyagi', 'mavanzato0418', 'rkchapman', 'guibill10', 'ari6nd', 'michael2010814', 'happyleexin', 'omardeyaa', 'hong_gao', 'irenehb92', 'sandrabashara', 'nihatyavuz', 'akozych2', 'vikazvereva', 'danielfernandezcalo', 'anthonyroux', 'arrow823', 'aimansyaz99', 'annahaozheng0606', 'rocio', 'masonpb2', 'samashraf1', 'kirankumar94', 'prabuddha_888253127', 'carlosvigo1997', 'muvafikmelikkaya', 'amrebrahim', 'jtorres17', 'jzhan142', 'syedzakwan', 'samet1231234', 'kie180028', 'nadhnasorudin', 'avw2', 'ahmedsameh1698', 'acn562', 'moh.bahaa', 'arifjalani99', 'youssefsherif22', 'asyrafaqil', 'mjgebara14', 'camilolcastro97', 'bcperki2', 'azizijazam11', 'ahmedayman2370', 'rishu', 'ranasherif65', 'kyang37', 'nuanno97', 'smrdafdl', 'brknshn', 'jbaggie2019', 'youssef2042000', 'olivier.gilbert.paquet', 'saipraneett', 'prakharbhargava0', 'hf4', 'nadja1', 'teoster50', 'mohaballam', 'ryanorem', 'shradhap', 'va844', 'neuroque', 'seifhabib', 'anibarseghyan', 'williammitchell5818', 'pingan99', 'mjoza2', 'mariz', 'virajput299', 'bleuminuit', 'ffazul64', 'paul.aniruddha', 'melaniejkramer', 'oliviercharbonneau', 'ilou', 'chengweiheng', 'evrenyigit', 'emilechouinard', 'pythagoras2', 'kason.carroll', 'malgaca', 'kie180031', 'carlosvillar54', 'ckim123', 'kychui2', 'kanet1234', 'mohabayman', 'sanchjai', 'nbs691', 'oishikfaruque', 'lauragdevesa', 'nowapoca', 'ahagras13', 'akash140410107098', 'chithong', 'saharoaf', 'amni99', 'svo4321', 'vblanco.nico', 'aimanadnan', 'dlee145', 'stambo', 'lauramolinosmayo', 'mateocampos', 'hamidausat', 'yjenyiee155', 'retty8', 'sebasket14', 'marcmagdy98', 'marianne.gratton.1', 'trkmengkay', 'shaf31', 'youxing0309', 'nourananwar123', 'puertarcd', 'felivitullo87', 'manuelsomoza94', 'alecorti.pardo', 'muteki', 'corredoira', 'gabrielyii', 'jinsup2', 'staceyn2', 'kaitlinh', 'cbecker413', 'adam562', 'haclarke', 'xosegq16', 'e1150590', 'kalebhilde', 'adriancheah', 'jaimefookinlannister', 'tonybocadillosgrandes', 'rooban11', 'wowmuchchuck', 'xunyong', 'hishamzakaria20', 'rxtodd', 'sarapl', 'jahnavikachhia', 'alexisdixon6', 'saegner2', 'pranjal3', 'berkaydean', 'baleko12345', 'sparshagarwal1009', 'xyz11', 'david.peral.moran', 'tingliang', 'isabelmaria.vazquez', 'aishu98', 'nadanasser1199', 'desmondsoon', 'keerthisv', 'musabmalek0717', 'mcruces.fz', 'tuberkargan_97', 'worldlineusaf', 'sealseal', 'bharath3', 'cloudyoverhead', 'dhvanil', 'ramy_maged4', 'zhixin2', 'sriharshap', 'tyy233', 'njs035', 'ablahsaoud', 'nolmos96', 'shorouk_ossama', 'kaustubh.shirpurkar', 'pedrosiaba', 'coderko3', 'alifzulkifli99', 'alancantu57', 'baohl2', 'mengkem2', 'selena', 'tdubnansky6', 'ypp200', 'aengm', 'kartal', 'jacquelinethardin', 'mohameeddsamy', 'jipiccardi', 'amlibrahim', 'rahimnoorj', 'dcpang2', 'tamchouweng', 'elizametias12', 'efrenhub', 'mrefaat', 'ethanmorse', 'taymacnichols', 'ryanboucher', 'kirolosehab99', 'carlosbesadaromero', 'ericrobles', 'janeneil88', 'gxiao2', 'kimzihuang', 'anxovidal8', 'damlakubattt', 'andreadiazgar', 'lukunze1', 'joker632455', 'shuming2', 'j.haliburton', 'abieday1704', 'ozbunar01', 'ugur.cankaya.3718', 'nihaosawaddee', 'magic_ocean99', 'sinasigurpinar', 'tuberkargan', 'jarodm2', 'nabilah1403', 'amiruldanial99', 'yansi', 'cheokonn', 'ammaralaa516', 'juanmacano97', 'maxernest', 'marcosanllo', 'viratbhatt007', 'facundovia', 'michaelsaldana1', 'kie180073', 'bassamtarek', 'abbesalaeddine', 'restep2', 'estebanrial', 'martinzapata', '46harunakgul', 'talwren', 'leejq', 'mohammedemadeldin2000', 'jeanmichael.deschenes', 'miloaismanis', 'mmartinezsanchez', 'emrebuyukkose2', 'luciano.brignone', 'anwar909', 'ahmedamr', 'omarmagdy', 'abdurrahmn13', 'nikalyaamani', 'sdehoyos47', 'apascao', 'yubai', 'vincentpainchaud.vp', 'nagihankececi', 'nazimmath3', 'apb5472', 'rikardberger', 'mr4425', 'jacobzeshleman', 'guoyao', 'kiruthikaabalu181996', 'ikhbal', 'michael.mechelay', 'khor', 'david_atef', 'yaseminablacandir', 'c.a.stupka', 'amparo.castro.96', 'dhodapp', 'fkl217', 'farahsamir978', 'kie180039', 'atharva98', 'kph2', 'hafizmokh99', 'hilisa', 'kowjiajin', 'fred_dion', 'harshini9962', 'pvalladaresfdez', 'dancastaneda', 'jn1404', 'atx203', 'ammareltalli', 'amani12345', 'aaq', 'ledicia97', 'adriangarea', 'onaam8', 'zehuahe2', 'siemprewowthechami', 'justin.lariviere.25', 'tbryan', 'ludovick.begin', 'tss3', 'tmi211', 'kie180079', 'physquig', 'zakhwan7', 'mallen22', 'amr_ua07', 'pip29', 'fcfrancapra94', 'vanesagarcia', 'adnanyuceer', 'fathy1104', 'al4995', 'melroy_caeiro', 'helenalecoq97', 'caglanlee', 'afeefz', 'jpmcgee98', 'ales.gajdacz', 'masitadonmez', 'eddin21', 'gemma', 'hmoulvi1', 'elad.d', 'xxlilmontysignxx', 'farah26', 'latecnologiameodia', 'abdulrahim2905', 'exjamil', 'vickytubio', 'ozgurkablan26', 'lderemo', 'ankit6257', 'javierisma98', 'redzuan11', 'yeejou990318', 'david.garrido', 'adarsh123', 'rileyroca', 'acregodean', 'pablosaavedra', 'maramtarek53', 's_coriolis', 'kakmeera1999', 'josepazmartin', 'travisc2', 'kie180702', 'bhliu97', 'ematson5897', 'ashutoshsinghhenry6', 'maniphysics09', 'eduard25252598', 'moh.ashraf105', 'pablobou4', 'khazanv2', 'ahchehyan', 'ramonruiz.infor', 'brannon44', 'scremin', 'aasifhameed99', 'wahidiah52', 'm939454', 'aboone06', 'bluelobster', 'gabrielyii99', 'jinwoo2', 'syin4', 'diamond92', 'bflores18', 'njgale01', 'mgk816', 'dkshelat']",3,"['dfl', 'dokun', 'gombut']",395,"['miri23', 'mohamedsameh', 'reemali99_', 'gc_1', 'kerryreto', 'zikrizaki88995', 'je_guilbert', 'jorgecastelo5', 'spazos7', 'soccadelic44', 'ahern0722', 'benoiturcotte', 'noureldin1999', 'alberfn', 'guttsfulltyagi', 'mavanzato0418', 'rkchapman', 'guibill10', 'ari6nd', 'michael2010814', 'happyleexin', 'omardeyaa', 'hong_gao', 'irenehb92', 'sandrabashara', 'nihatyavuz', 'akozych2', 'vikazvereva', 'danielfernandezcalo', 'anthonyroux', 'arrow823', 'aimansyaz99', 'annahaozheng0606', 'rocio', 'masonpb2', 'samashraf1', 'kirankumar94', 'prabuddha_888253127', 'carlosvigo1997', 'muvafikmelikkaya', 'amrebrahim', 'jtorres17', 'jzhan142', 'syedzakwan', 'samet1231234', 'kie180028', 'nadhnasorudin', 'avw2', 'ahmedsameh1698', 'acn562', 'moh.bahaa', 'arifjalani99', 'youssefsherif22', 'asyrafaqil', 'mjgebara14', 'camilolcastro97', 'bcperki2', 'azizijazam11', 'ahmedayman2370', 'rishu', 'ranasherif65', 'kyang37', 'nuanno97', 'smrdafdl', 'brknshn', 'jbaggie2019', 'youssef2042000', 'olivier.gilbert.paquet', 'saipraneett', 'prakharbhargava0', 'hf4', 'nadja1', 'teoster50', 'mohaballam', 'ryanorem', 'shradhap', 'va844', 'neuroque', 'seifhabib', 'anibarseghyan', 'williammitchell5818', 'pingan99', 'mjoza2', 'mariz', 'virajput299', 'bleuminuit', 'ffazul64', 'paul.aniruddha', 'melaniejkramer', 'oliviercharbonneau', 'ilou', 'chengweiheng', 'evrenyigit', 'emilechouinard', 'pythagoras2', 'kason.carroll', 'malgaca', 'kie180031', 'carlosvillar54', 'ckim123', 'kychui2', 'kanet1234', 'mohabayman', 'sanchjai', 'nbs691', 'oishikfaruque', 'lauragdevesa', 'nowapoca', 'ahagras13', 'akash140410107098', 'chithong', 'saharoaf', 'amni99', 'svo4321', 'lino13', 'vblanco.nico', 'aimanadnan', 'alidsjt', 'dlee145', 'stambo', 'lauramolinosmayo', 'mateocampos', 'hamidausat', 'yjenyiee155', 'retty8', 'sebasket14', 'marcmagdy98', 'janalorenzolumbreras', 'marianne.gratton.1', 'trkmengkay', 'shaf31', 'youxing0309', 'nourananwar123', 'puertarcd', 'felivitullo87', 'manuelsomoza94', 'alecorti.pardo', 'muteki', 'corredoira', 'gabrielyii', 'jinsup2', 'staceyn2', 'kaitlinh', 'cbecker413', 'adam562', 'haclarke', 'xosegq16', 'e1150590', 'kalebhilde', 'adriancheah', 'jaimefookinlannister', 'tonybocadillosgrandes', 'rooban11', 'wowmuchchuck', 'xunyong', 'hishamzakaria20', 'rxtodd', 'sarapl', 'alimatama', 'jahnavikachhia', 'alexisdixon6', 'saegner2', 'pranjal3', 'berkaydean', 'baleko12345', 'sparshagarwal1009', 'xyz11', 'david.peral.moran', 'tingliang', 'isabelmaria.vazquez', 'aishu98', 'nadanasser1199', 'desmondsoon', 'keerthisv', 'musabmalek0717', 'mcruces.fz', 'tuberkargan_97', 'worldlineusaf', 'sealseal', 'bharath3', 'dfl', 'cloudyoverhead', 'dhvanil', 'ramy_maged4', 'lsleed', 'zhixin2', 'sriharshap', 'tyy233', 'njs035', 'ablahsaoud', 'nolmos96', 'shorouk_ossama', 'kaustubh.shirpurkar', 'pedrosiaba', 'coderko3', 'alifzulkifli99', 'alancantu57', 'baohl2', 'mengkem2', 'selena', 'tdubnansky6', 'ypp200', 'aengm', 'kartal', 'jacquelinethardin', 'mohameeddsamy', 'jipiccardi', 'amlibrahim', 'rahimnoorj', 'dcpang2', 'tamchouweng', 'elizametias12', 'efrenhub', 'mrefaat', 'ethanmorse', 'taymacnichols', 'ryanboucher', 'kirolosehab99', 'carlosbesadaromero', 'ericrobles', 'janeneil88', 'gxiao2', 'kimzihuang', 'anxovidal8', 'damlakubattt', 'andreadiazgar', 'lukunze1', 'joker632455', 'shuming2', 'j.haliburton', 'abieday1704', 'ozbunar01', 'ugur.cankaya.3718', 'nihaosawaddee', 'magic_ocean99', 'sinasigurpinar', 'tuberkargan', 'jarodm2', 'nabilah1403', 'amiruldanial99', 'yansi', 'cheokonn', 'ammaralaa516', 'juanmacano97', 'maxernest', 'marcosanllo', 'viratbhatt007', 'facundovia', 'michaelsaldana1', 'kie180073', 'bassamtarek', 'abbesalaeddine', 'restep2', 'estebanrial', 'martinzapata', '46harunakgul', 'talwren', 'leejq', 'mohammedemadeldin2000', 'jeanmichael.deschenes', 'miloaismanis', 'mmartinezsanchez', 'emrebuyukkose2', 'luciano.brignone', 'anwar909', 'ahmedamr', 'omarmagdy', 'abdurrahmn13', 'nikalyaamani', 'sdehoyos47', 'apascao', 'yubai', 'vincentpainchaud.vp', 'nagihankececi', 'nazimmath3', 'apb5472', 'rikardberger', 'dokun', 'mr4425', 'jacobzeshleman', 'guoyao', 'kiruthikaabalu181996', 'ikhbal', 'michael.mechelay', 'khor', 'david_atef', 'yaseminablacandir', 'c.a.stupka', 'amparo.castro.96', 'dhodapp', 'fkl217', 'farahsamir978', 'kie180039', 'atharva98', 'kph2', 'hafizmokh99', 'hilisa', 'kowjiajin', 'fred_dion', 'harshini9962', 'pvalladaresfdez', 'dancastaneda', 'jn1404', 'atx203', 'ammareltalli', 'amani12345', 'aaq', 'ledicia97', 'adriangarea', 'onaam8', 'zehuahe2', 'siemprewowthechami', 'justin.lariviere.25', 'tbryan', 'ludovick.begin', 'tss3', 'david2397', 'tmi211', 'kie180079', 'physquig', 'zakhwan7', 'mallen22', 'amr_ua07', 'pip29', 'fcfrancapra94', 'cristinacigarran', 'vanesagarcia', 'adnanyuceer', 'fathy1104', 'perezsarmar', 'al4995', 'melroy_caeiro', 'helenalecoq97', 'caglanlee', 'afeefz', 'jpmcgee98', 'ales.gajdacz', 'masitadonmez', 'eddin21', 'gemma', 'hmoulvi1', 'gombut', 'elad.d', 'xxlilmontysignxx', 'farah26', 'latecnologiameodia', 'abdulrahim2905', 'exjamil', 'vickytubio', 'ozgurkablan26', 'lderemo', 'ankit6257', 'javierisma98', 'redzuan11', 'yeejou990318', 'david.garrido', 'adarsh123', 'rileyroca', 'movi205', 'acregodean', 'pablosaavedra', 'maramtarek53', 's_coriolis', 'kakmeera1999', 'josepazmartin', 'travisc2', 'electronica18', 'kie180702', 'bhliu97', 'ematson5897', 'ashutoshsinghhenry6', 'martin32', 'maniphysics09', 'eduard25252598', 'moh.ashraf105', 'pablobou4', 'khazanv2', 'ahchehyan', 'ramonruiz.infor', 'brannon44', 'scremin', 'aasifhameed99', 'wahidiah52', 'm939454', 'aboone06', 'bluelobster', 'gabrielyii99', 'veronica.mieites', 'jinwoo2', 'syin4', 'diamond92', 'bflores18', 'njgale01', 'mgk816', 'dkshelat']"
1,9,392,14,1,['mr4425'],391,"['miri23', 'mohamedsameh', 'reemali99_', 'gc_1', 'kerryreto', 'zikrizaki88995', 'je_guilbert', 'jorgecastelo5', 'spazos7', 'soccadelic44', 'ahern0722', 'benoiturcotte', 'noureldin1999', 'alberfn', 'guttsfulltyagi', 'mavanzato0418', 'rkchapman', 'guibill10', 'ari6nd', 'michael2010814', 'happyleexin', 'omardeyaa', 'hong_gao', 'irenehb92', 'sandrabashara', 'nihatyavuz', 'akozych2', 'vikazvereva', 'danielfernandezcalo', 'anthonyroux', 'arrow823', 'aimansyaz99', 'annahaozheng0606', 'rocio', 'masonpb2', 'samashraf1', 'kirankumar94', 'prabuddha_888253127', 'carlosvigo1997', 'muvafikmelikkaya', 'amrebrahim', 'jtorres17', 'jzhan142', 'syedzakwan', 'samet1231234', 'kie180028', 'nadhnasorudin', 'avw2', 'ahmedsameh1698', 'acn562', 'moh.bahaa', 'arifjalani99', 'youssefsherif22', 'asyrafaqil', 'mjgebara14', 'camilolcastro97', 'bcperki2', 'azizijazam11', 'ahmedayman2370', 'rishu', 'ranasherif65', 'kyang37', 'nuanno97', 'smrdafdl', 'brknshn', 'jbaggie2019', 'youssef2042000', 'olivier.gilbert.paquet', 'saipraneett', 'prakharbhargava0', 'hf4', 'nadja1', 'teoster50', 'mohaballam', 'ryanorem', 'shradhap', 'va844', 'neuroque', 'seifhabib', 'anibarseghyan', 'williammitchell5818', 'pingan99', 'mjoza2', 'mariz', 'virajput299', 'bleuminuit', 'ffazul64', 'paul.aniruddha', 'melaniejkramer', 'oliviercharbonneau', 'ilou', 'chengweiheng', 'evrenyigit', 'emilechouinard', 'pythagoras2', 'kason.carroll', 'malgaca', 'kie180031', 'carlosvillar54', 'ckim123', 'kychui2', 'kanet1234', 'mohabayman', 'sanchjai', 'nbs691', 'oishikfaruque', 'lauragdevesa', 'nowapoca', 'ahagras13', 'akash140410107098', 'chithong', 'saharoaf', 'amni99', 'svo4321', 'lino13', 'vblanco.nico', 'aimanadnan', 'alidsjt', 'dlee145', 'stambo', 'lauramolinosmayo', 'mateocampos', 'hamidausat', 'yjenyiee155', 'retty8', 'sebasket14', 'marcmagdy98', 'janalorenzolumbreras', 'marianne.gratton.1', 'trkmengkay', 'shaf31', 'youxing0309', 'nourananwar123', 'puertarcd', 'felivitullo87', 'manuelsomoza94', 'alecorti.pardo', 'muteki', 'corredoira', 'gabrielyii', 'jinsup2', 'staceyn2', 'kaitlinh', 'cbecker413', 'adam562', 'haclarke', 'xosegq16', 'e1150590', 'kalebhilde', 'adriancheah', 'jaimefookinlannister', 'tonybocadillosgrandes', 'rooban11', 'wowmuchchuck', 'xunyong', 'hishamzakaria20', 'rxtodd', 'sarapl', 'alimatama', 'jahnavikachhia', 'alexisdixon6', 'saegner2', 'pranjal3', 'berkaydean', 'baleko12345', 'sparshagarwal1009', 'xyz11', 'david.peral.moran', 'tingliang', 'isabelmaria.vazquez', 'aishu98', 'nadanasser1199', 'desmondsoon', 'keerthisv', 'musabmalek0717', 'mcruces.fz', 'tuberkargan_97', 'worldlineusaf', 'sealseal', 'bharath3', 'cloudyoverhead', 'dhvanil', 'ramy_maged4', 'lsleed', 'zhixin2', 'sriharshap', 'tyy233', 'njs035', 'ablahsaoud', 'nolmos96', 'shorouk_ossama', 'kaustubh.shirpurkar', 'pedrosiaba', 'coderko3', 'alifzulkifli99', 'alancantu57', 'baohl2', 'mengkem2', 'selena', 'tdubnansky6', 'ypp200', 'aengm', 'kartal', 'jacquelinethardin', 'mohameeddsamy', 'jipiccardi', 'amlibrahim', 'rahimnoorj', 'dcpang2', 'tamchouweng', 'elizametias12', 'efrenhub', 'mrefaat', 'ethanmorse', 'taymacnichols', 'ryanboucher', 'kirolosehab99', 'carlosbesadaromero', 'ericrobles', 'janeneil88', 'gxiao2', 'kimzihuang', 'anxovidal8', 'damlakubattt', 'andreadiazgar', 'lukunze1', 'joker632455', 'shuming2', 'j.haliburton', 'abieday1704', 'ozbunar01', 'ugur.cankaya.3718', 'nihaosawaddee', 'magic_ocean99', 'sinasigurpinar', 'tuberkargan', 'jarodm2', 'nabilah1403', 'amiruldanial99', 'yansi', 'cheokonn', 'ammaralaa516', 'juanmacano97', 'maxernest', 'marcosanllo', 'viratbhatt007', 'facundovia', 'michaelsaldana1', 'kie180073', 'bassamtarek', 'abbesalaeddine', 'restep2', 'estebanrial', 'martinzapata', '46harunakgul', 'talwren', 'leejq', 'mohammedemadeldin2000', 'jeanmichael.deschenes', 'miloaismanis', 'mmartinezsanchez', 'emrebuyukkose2', 'luciano.brignone', 'anwar909', 'ahmedamr', 'omarmagdy', 'abdurrahmn13', 'nikalyaamani', 'sdehoyos47', 'apascao', 'yubai', 'vincentpainchaud.vp', 'nagihankececi', 'nazimmath3', 'apb5472', 'rikardberger', 'jacobzeshleman', 'guoyao', 'kiruthikaabalu181996', 'ikhbal', 'michael.mechelay', 'khor', 'david_atef', 'yaseminablacandir', 'c.a.stupka', 'amparo.castro.96', 'dhodapp', 'fkl217', 'farahsamir978', 'kie180039', 'atharva98', 'kph2', 'hafizmokh99', 'hilisa', 'kowjiajin', 'fred_dion', 'harshini9962', 'pvalladaresfdez', 'dancastaneda', 'jn1404', 'atx203', 'ammareltalli', 'amani12345', 'aaq', 'ledicia97', 'adriangarea', 'onaam8', 'zehuahe2', 'siemprewowthechami', 'justin.lariviere.25', 'tbryan', 'ludovick.begin', 'tss3', 'david2397', 'tmi211', 'kie180079', 'physquig', 'zakhwan7', 'mallen22', 'amr_ua07', 'pip29', 'fcfrancapra94', 'cristinacigarran', 'vanesagarcia', 'adnanyuceer', 'fathy1104', 'perezsarmar', 'al4995', 'melroy_caeiro', 'helenalecoq97', 'caglanlee', 'afeefz', 'jpmcgee98', 'ales.gajdacz', 'masitadonmez', 'eddin21', 'gemma', 'hmoulvi1', 'elad.d', 'xxlilmontysignxx', 'farah26', 'latecnologiameodia', 'abdulrahim2905', 'exjamil', 'vickytubio', 'ozgurkablan26', 'lderemo', 'ankit6257', 'javierisma98', 'redzuan11', 'yeejou990318', 'david.garrido', 'adarsh123', 'rileyroca', 'movi205', 'acregodean', 'pablosaavedra', 'maramtarek53', 's_coriolis', 'kakmeera1999', 'josepazmartin', 'travisc2', 'electronica18', 'kie180702', 'bhliu97', 'ematson5897', 'ashutoshsinghhenry6', 'martin32', 'maniphysics09', 'eduard25252598', 'moh.ashraf105', 'pablobou4', 'khazanv2', 'ahchehyan', 'ramonruiz.infor', 'brannon44', 'scremin', 'aasifhameed99', 'wahidiah52', 'm939454', 'aboone06', 'bluelobster', 'gabrielyii99', 'veronica.mieites', 'jinwoo2', 'syin4', 'diamond92', 'bflores18', 'njgale01', 'mgk816', 'dkshelat']",13,"['weekmooz', 'arunparth', 'kmamaniya', 'lh2754', 'rc2975nyu', 'zh1246', 'sdyfbew', 'as12033', 'ytsong95', 'zl2513', 'shubham.mahalank', 'ac7431', 'siao']",405,"['miri23', 'mohamedsameh', 'reemali99_', 'gc_1', 'kerryreto', 'zikrizaki88995', 'je_guilbert', 'jorgecastelo5', 'spazos7', 'soccadelic44', 'ahern0722', 'benoiturcotte', 'noureldin1999', 'alberfn', 'rc2975nyu', 'guttsfulltyagi', 'mavanzato0418', 'rkchapman', 'guibill10', 'ari6nd', 'michael2010814', 'happyleexin', 'omardeyaa', 'hong_gao', 'irenehb92', 'sandrabashara', 'nihatyavuz', 'akozych2', 'vikazvereva', 'danielfernandezcalo', 'anthonyroux', 'arrow823', 'aimansyaz99', 'annahaozheng0606', 'ac7431', 'rocio', 'masonpb2', 'samashraf1', 'kirankumar94', 'prabuddha_888253127', 'carlosvigo1997', 'muvafikmelikkaya', 'amrebrahim', 'jtorres17', 'jzhan142', 'syedzakwan', 'samet1231234', 'kie180028', 'nadhnasorudin', 'avw2', 'ahmedsameh1698', 'acn562', 'moh.bahaa', 'arifjalani99', 'youssefsherif22', 'asyrafaqil', 'mjgebara14', 'camilolcastro97', 'bcperki2', 'azizijazam11', 'ahmedayman2370', 'rishu', 'ranasherif65', 'kyang37', 'nuanno97', 'smrdafdl', 'brknshn', 'jbaggie2019', 'youssef2042000', 'olivier.gilbert.paquet', 'saipraneett', 'prakharbhargava0', 'hf4', 'nadja1', 'teoster50', 'mohaballam', 'ryanorem', 'shradhap', 'va844', 'neuroque', 'seifhabib', 'anibarseghyan', 'williammitchell5818', 'pingan99', 'mjoza2', 'mariz', 'virajput299', 'bleuminuit', 'ffazul64', 'paul.aniruddha', 'melaniejkramer', 'oliviercharbonneau', 'ilou', 'chengweiheng', 'evrenyigit', 'emilechouinard', 'pythagoras2', 'kason.carroll', 'malgaca', 'kie180031', 'carlosvillar54', 'ckim123', 'kychui2', 'kanet1234', 'mohabayman', 'sanchjai', 'nbs691', 'oishikfaruque', 'lauragdevesa', 'nowapoca', 'ahagras13', 'akash140410107098', 'chithong', 'siao', 'saharoaf', 'amni99', 'arunparth', 'svo4321', 'lino13', 'vblanco.nico', 'aimanadnan', 'alidsjt', 'dlee145', 'stambo', 'lauramolinosmayo', 'mateocampos', 'hamidausat', 'yjenyiee155', 'retty8', 'sebasket14', 'marcmagdy98', 'janalorenzolumbreras', 'marianne.gratton.1', 'trkmengkay', 'shaf31', 'youxing0309', 'nourananwar123', 'puertarcd', 'felivitullo87', 'manuelsomoza94', 'alecorti.pardo', 'muteki', 'corredoira', 'gabrielyii', 'lh2754', 'jinsup2', 'staceyn2', 'kaitlinh', 'cbecker413', 'adam562', 'haclarke', 'xosegq16', 'shubham.mahalank', 'e1150590', 'weekmooz', 'kalebhilde', 'adriancheah', 'jaimefookinlannister', 'tonybocadillosgrandes', 'rooban11', 'wowmuchchuck', 'xunyong', 'hishamzakaria20', 'rxtodd', 'sarapl', 'alimatama', 'jahnavikachhia', 'alexisdixon6', 'saegner2', 'pranjal3', 'berkaydean', 'baleko12345', 'sparshagarwal1009', 'xyz11', 'david.peral.moran', 'tingliang', 'isabelmaria.vazquez', 'aishu98', 'nadanasser1199', 'desmondsoon', 'keerthisv', 'musabmalek0717', 'mcruces.fz', 'tuberkargan_97', 'worldlineusaf', 'sealseal', 'bharath3', 'cloudyoverhead', 'dhvanil', 'ramy_maged4', 'lsleed', 'zhixin2', 'sriharshap', 'tyy233', 'njs035', 'ablahsaoud', 'nolmos96', 'shorouk_ossama', 'kaustubh.shirpurkar', 'pedrosiaba', 'coderko3', 'alifzulkifli99', 'alancantu57', 'baohl2', 'mengkem2', 'selena', 'tdubnansky6', 'ypp200', 'aengm', 'kartal', 'jacquelinethardin', 'mohameeddsamy', 'jipiccardi', 'amlibrahim', 'rahimnoorj', 'dcpang2', 'tamchouweng', 'elizametias12', 'efrenhub', 'mrefaat', 'ethanmorse', 'taymacnichols', 'ryanboucher', 'kirolosehab99', 'carlosbesadaromero', 'ericrobles', 'janeneil88', 'gxiao2', 'kimzihuang', 'anxovidal8', 'damlakubattt', 'andreadiazgar', 'lukunze1', 'joker632455', 'shuming2', 'j.haliburton', 'abieday1704', 'ozbunar01', 'ugur.cankaya.3718', 'nihaosawaddee', 'magic_ocean99', 'sinasigurpinar', 'as12033', 'tuberkargan', 'jarodm2', 'nabilah1403', 'amiruldanial99', 'yansi', 'cheokonn', 'ammaralaa516', 'juanmacano97', 'maxernest', 'marcosanllo', 'kmamaniya', 'viratbhatt007', 'facundovia', 'michaelsaldana1', 'kie180073', 'bassamtarek', 'abbesalaeddine', 'restep2', 'estebanrial', 'martinzapata', '46harunakgul', 'talwren', 'leejq', 'mohammedemadeldin2000', 'jeanmichael.deschenes', 'miloaismanis', 'mmartinezsanchez', 'emrebuyukkose2', 'luciano.brignone', 'anwar909', 'ahmedamr', 'omarmagdy', 'abdurrahmn13', 'nikalyaamani', 'sdehoyos47', 'apascao', 'yubai', 'vincentpainchaud.vp', 'nagihankececi', 'zl2513', 'nazimmath3', 'apb5472', 'rikardberger', 'mr4425', 'jacobzeshleman', 'guoyao', 'kiruthikaabalu181996', 'ikhbal', 'michael.mechelay', 'khor', 'david_atef', 'yaseminablacandir', 'c.a.stupka', 'amparo.castro.96', 'dhodapp', 'fkl217', 'farahsamir978', 'kie180039', 'atharva98', 'kph2', 'sdyfbew', 'hafizmokh99', 'hilisa', 'kowjiajin', 'fred_dion', 'harshini9962', 'pvalladaresfdez', 'dancastaneda', 'jn1404', 'atx203', 'ammareltalli', 'amani12345', 'aaq', 'ledicia97', 'adriangarea', 'onaam8', 'zehuahe2', 'siemprewowthechami', 'justin.lariviere.25', 'tbryan', 'ludovick.begin', 'tss3', 'david2397', 'tmi211', 'kie180079', 'physquig', 'zakhwan7', 'mallen22', 'amr_ua07', 'pip29', 'fcfrancapra94', 'cristinacigarran', 'vanesagarcia', 'adnanyuceer', 'fathy1104', 'perezsarmar', 'al4995', 'melroy_caeiro', 'helenalecoq97', 'caglanlee', 'afeefz', 'jpmcgee98', 'ales.gajdacz', 'masitadonmez', 'eddin21', 'gemma', 'hmoulvi1', 'elad.d', 'xxlilmontysignxx', 'farah26', 'latecnologiameodia', 'abdulrahim2905', 'exjamil', 'vickytubio', 'ozgurkablan26', 'lderemo', 'ankit6257', 'javierisma98', 'redzuan11', 'yeejou990318', 'david.garrido', 'adarsh123', 'rileyroca', 'movi205', 'acregodean', 'pablosaavedra', 'maramtarek53', 's_coriolis', 'kakmeera1999', 'josepazmartin', 'travisc2', 'electronica18', 'kie180702', 'bhliu97', 'ematson5897', 'ashutoshsinghhenry6', 'martin32', 'maniphysics09', 'ytsong95', 'eduard25252598', 'moh.ashraf105', 'pablobou4', 'khazanv2', 'ahchehyan', 'ramonruiz.infor', 'brannon44', 'scremin', 'aasifhameed99', 'wahidiah52', 'm939454', 'aboone06', 'bluelobster', 'gabrielyii99', 'veronica.mieites', 'jinwoo2', 'syin4', 'diamond92', 'zh1246', 'bflores18', 'njgale01', 'mgk816', 'dkshelat']"
1,19,392,14,13,"['aengm', 'paul.aniruddha', 'rikardberger', 'kartal', 'adarsh123', 'nazimmath3', 'prakharbhargava0', 'nadja1', 'hilisa', 'scremin', 'lukunze1', 'annahaozheng0606', 'ilou']",379,"['miri23', 'mohamedsameh', 'reemali99_', 'gc_1', 'kerryreto', 'zikrizaki88995', 'je_guilbert', 'jorgecastelo5', 'spazos7', 'soccadelic44', 'ahern0722', 'benoiturcotte', 'noureldin1999', 'alberfn', 'guttsfulltyagi', 'mavanzato0418', 'rkchapman', 'guibill10', 'ari6nd', 'michael2010814', 'happyleexin', 'omardeyaa', 'hong_gao', 'irenehb92', 'sandrabashara', 'nihatyavuz', 'akozych2', 'vikazvereva', 'danielfernandezcalo', 'anthonyroux', 'arrow823', 'aimansyaz99', 'rocio', 'masonpb2', 'samashraf1', 'kirankumar94', 'prabuddha_888253127', 'carlosvigo1997', 'muvafikmelikkaya', 'amrebrahim', 'jtorres17', 'jzhan142', 'syedzakwan', 'samet1231234', 'kie180028', 'nadhnasorudin', 'avw2', 'ahmedsameh1698', 'acn562', 'moh.bahaa', 'arifjalani99', 'youssefsherif22', 'asyrafaqil', 'mjgebara14', 'camilolcastro97', 'bcperki2', 'azizijazam11', 'ahmedayman2370', 'rishu', 'ranasherif65', 'kyang37', 'nuanno97', 'smrdafdl', 'brknshn', 'jbaggie2019', 'youssef2042000', 'olivier.gilbert.paquet', 'saipraneett', 'hf4', 'teoster50', 'mohaballam', 'ryanorem', 'shradhap', 'va844', 'neuroque', 'seifhabib', 'anibarseghyan', 'williammitchell5818', 'pingan99', 'mjoza2', 'mariz', 'virajput299', 'bleuminuit', 'ffazul64', 'melaniejkramer', 'oliviercharbonneau', 'chengweiheng', 'evrenyigit', 'emilechouinard', 'pythagoras2', 'kason.carroll', 'malgaca', 'kie180031', 'carlosvillar54', 'ckim123', 'kychui2', 'kanet1234', 'mohabayman', 'sanchjai', 'nbs691', 'oishikfaruque', 'lauragdevesa', 'nowapoca', 'ahagras13', 'akash140410107098', 'chithong', 'saharoaf', 'amni99', 'svo4321', 'lino13', 'vblanco.nico', 'aimanadnan', 'alidsjt', 'dlee145', 'stambo', 'lauramolinosmayo', 'mateocampos', 'hamidausat', 'yjenyiee155', 'retty8', 'sebasket14', 'marcmagdy98', 'janalorenzolumbreras', 'marianne.gratton.1', 'trkmengkay', 'shaf31', 'youxing0309', 'nourananwar123', 'puertarcd', 'felivitullo87', 'manuelsomoza94', 'alecorti.pardo', 'muteki', 'corredoira', 'gabrielyii', 'jinsup2', 'staceyn2', 'kaitlinh', 'cbecker413', 'adam562', 'haclarke', 'xosegq16', 'e1150590', 'kalebhilde', 'adriancheah', 'jaimefookinlannister', 'tonybocadillosgrandes', 'rooban11', 'wowmuchchuck', 'xunyong', 'hishamzakaria20', 'rxtodd', 'sarapl', 'alimatama', 'jahnavikachhia', 'alexisdixon6', 'saegner2', 'pranjal3', 'berkaydean', 'baleko12345', 'sparshagarwal1009', 'xyz11', 'david.peral.moran', 'tingliang', 'isabelmaria.vazquez', 'aishu98', 'nadanasser1199', 'desmondsoon', 'keerthisv', 'musabmalek0717', 'mcruces.fz', 'tuberkargan_97', 'worldlineusaf', 'sealseal', 'bharath3', 'cloudyoverhead', 'dhvanil', 'ramy_maged4', 'lsleed', 'zhixin2', 'sriharshap', 'tyy233', 'njs035', 'ablahsaoud', 'nolmos96', 'shorouk_ossama', 'kaustubh.shirpurkar', 'pedrosiaba', 'coderko3', 'alifzulkifli99', 'alancantu57', 'baohl2', 'mengkem2', 'selena', 'tdubnansky6', 'ypp200', 'jacquelinethardin', 'mohameeddsamy', 'jipiccardi', 'amlibrahim', 'rahimnoorj', 'dcpang2', 'tamchouweng', 'elizametias12', 'efrenhub', 'mrefaat', 'ethanmorse', 'taymacnichols', 'ryanboucher', 'kirolosehab99', 'carlosbesadaromero', 'ericrobles', 'janeneil88', 'gxiao2', 'kimzihuang', 'anxovidal8', 'damlakubattt', 'andreadiazgar', 'joker632455', 'shuming2', 'j.haliburton', 'abieday1704', 'ozbunar01', 'ugur.cankaya.3718', 'nihaosawaddee', 'magic_ocean99', 'sinasigurpinar', 'tuberkargan', 'jarodm2', 'nabilah1403', 'amiruldanial99', 'yansi', 'cheokonn', 'ammaralaa516', 'juanmacano97', 'maxernest', 'marcosanllo', 'viratbhatt007', 'facundovia', 'michaelsaldana1', 'kie180073', 'bassamtarek', 'abbesalaeddine', 'restep2', 'estebanrial', 'martinzapata', '46harunakgul', 'talwren', 'leejq', 'mohammedemadeldin2000', 'jeanmichael.deschenes', 'miloaismanis', 'mmartinezsanchez', 'emrebuyukkose2', 'luciano.brignone', 'anwar909', 'ahmedamr', 'omarmagdy', 'abdurrahmn13', 'nikalyaamani', 'sdehoyos47', 'apascao', 'yubai', 'vincentpainchaud.vp', 'nagihankececi', 'apb5472', 'mr4425', 'jacobzeshleman', 'guoyao', 'kiruthikaabalu181996', 'ikhbal', 'michael.mechelay', 'khor', 'david_atef', 'yaseminablacandir', 'c.a.stupka', 'amparo.castro.96', 'dhodapp', 'fkl217', 'farahsamir978', 'kie180039', 'atharva98', 'kph2', 'hafizmokh99', 'kowjiajin', 'fred_dion', 'harshini9962', 'pvalladaresfdez', 'dancastaneda', 'jn1404', 'atx203', 'ammareltalli', 'amani12345', 'aaq', 'ledicia97', 'adriangarea', 'onaam8', 'zehuahe2', 'siemprewowthechami', 'justin.lariviere.25', 'tbryan', 'ludovick.begin', 'tss3', 'david2397', 'tmi211', 'kie180079', 'physquig', 'zakhwan7', 'mallen22', 'amr_ua07', 'pip29', 'fcfrancapra94', 'cristinacigarran', 'vanesagarcia', 'adnanyuceer', 'fathy1104', 'perezsarmar', 'al4995', 'melroy_caeiro', 'helenalecoq97', 'caglanlee', 'afeefz', 'jpmcgee98', 'ales.gajdacz', 'masitadonmez', 'eddin21', 'gemma', 'hmoulvi1', 'elad.d', 'xxlilmontysignxx', 'farah26', 'latecnologiameodia', 'abdulrahim2905', 'exjamil', 'vickytubio', 'ozgurkablan26', 'lderemo', 'ankit6257', 'javierisma98', 'redzuan11', 'yeejou990318', 'david.garrido', 'rileyroca', 'movi205', 'acregodean', 'pablosaavedra', 'maramtarek53', 's_coriolis', 'kakmeera1999', 'josepazmartin', 'travisc2', 'electronica18', 'kie180702', 'bhliu97', 'ematson5897', 'ashutoshsinghhenry6', 'martin32', 'maniphysics09', 'eduard25252598', 'moh.ashraf105', 'pablobou4', 'khazanv2', 'ahchehyan', 'ramonruiz.infor', 'brannon44', 'aasifhameed99', 'wahidiah52', 'm939454', 'aboone06', 'bluelobster', 'gabrielyii99', 'veronica.mieites', 'jinwoo2', 'syin4', 'diamond92', 'bflores18', 'njgale01', 'mgk816', 'dkshelat']",1,['davyn'],393,"['miri23', 'mohamedsameh', 'reemali99_', 'gc_1', 'kerryreto', 'zikrizaki88995', 'je_guilbert', 'jorgecastelo5', 'spazos7', 'soccadelic44', 'ahern0722', 'benoiturcotte', 'noureldin1999', 'alberfn', 'guttsfulltyagi', 'mavanzato0418', 'rkchapman', 'guibill10', 'ari6nd', 'michael2010814', 'happyleexin', 'omardeyaa', 'hong_gao', 'irenehb92', 'sandrabashara', 'nihatyavuz', 'akozych2', 'vikazvereva', 'danielfernandezcalo', 'anthonyroux', 'arrow823', 'aimansyaz99', 'annahaozheng0606', 'rocio', 'masonpb2', 'samashraf1', 'kirankumar94', 'prabuddha_888253127', 'carlosvigo1997', 'muvafikmelikkaya', 'amrebrahim', 'jtorres17', 'jzhan142', 'syedzakwan', 'samet1231234', 'kie180028', 'nadhnasorudin', 'avw2', 'ahmedsameh1698', 'acn562', 'moh.bahaa', 'arifjalani99', 'youssefsherif22', 'asyrafaqil', 'mjgebara14', 'camilolcastro97', 'bcperki2', 'azizijazam11', 'ahmedayman2370', 'rishu', 'ranasherif65', 'kyang37', 'nuanno97', 'smrdafdl', 'brknshn', 'jbaggie2019', 'youssef2042000', 'olivier.gilbert.paquet', 'saipraneett', 'prakharbhargava0', 'hf4', 'nadja1', 'teoster50', 'mohaballam', 'ryanorem', 'shradhap', 'va844', 'neuroque', 'seifhabib', 'anibarseghyan', 'williammitchell5818', 'pingan99', 'mjoza2', 'mariz', 'virajput299', 'bleuminuit', 'ffazul64', 'paul.aniruddha', 'melaniejkramer', 'oliviercharbonneau', 'ilou', 'chengweiheng', 'evrenyigit', 'emilechouinard', 'pythagoras2', 'kason.carroll', 'malgaca', 'kie180031', 'carlosvillar54', 'ckim123', 'kychui2', 'kanet1234', 'mohabayman', 'sanchjai', 'nbs691', 'oishikfaruque', 'lauragdevesa', 'nowapoca', 'ahagras13', 'akash140410107098', 'chithong', 'saharoaf', 'amni99', 'svo4321', 'lino13', 'vblanco.nico', 'aimanadnan', 'alidsjt', 'dlee145', 'stambo', 'lauramolinosmayo', 'mateocampos', 'hamidausat', 'yjenyiee155', 'retty8', 'sebasket14', 'marcmagdy98', 'janalorenzolumbreras', 'marianne.gratton.1', 'trkmengkay', 'shaf31', 'youxing0309', 'nourananwar123', 'puertarcd', 'felivitullo87', 'manuelsomoza94', 'alecorti.pardo', 'muteki', 'corredoira', 'gabrielyii', 'jinsup2', 'staceyn2', 'kaitlinh', 'cbecker413', 'adam562', 'haclarke', 'xosegq16', 'e1150590', 'kalebhilde', 'adriancheah', 'jaimefookinlannister', 'tonybocadillosgrandes', 'rooban11', 'wowmuchchuck', 'xunyong', 'hishamzakaria20', 'rxtodd', 'sarapl', 'alimatama', 'jahnavikachhia', 'alexisdixon6', 'saegner2', 'pranjal3', 'berkaydean', 'baleko12345', 'sparshagarwal1009', 'xyz11', 'david.peral.moran', 'tingliang', 'isabelmaria.vazquez', 'aishu98', 'nadanasser1199', 'desmondsoon', 'keerthisv', 'musabmalek0717', 'mcruces.fz', 'tuberkargan_97', 'worldlineusaf', 'sealseal', 'bharath3', 'cloudyoverhead', 'dhvanil', 'ramy_maged4', 'lsleed', 'zhixin2', 'sriharshap', 'tyy233', 'njs035', 'ablahsaoud', 'nolmos96', 'shorouk_ossama', 'kaustubh.shirpurkar', 'pedrosiaba', 'coderko3', 'alifzulkifli99', 'alancantu57', 'baohl2', 'mengkem2', 'selena', 'tdubnansky6', 'ypp200', 'aengm', 'kartal', 'jacquelinethardin', 'mohameeddsamy', 'jipiccardi', 'amlibrahim', 'rahimnoorj', 'dcpang2', 'tamchouweng', 'elizametias12', 'efrenhub', 'mrefaat', 'ethanmorse', 'taymacnichols', 'ryanboucher', 'kirolosehab99', 'carlosbesadaromero', 'ericrobles', 'janeneil88', 'gxiao2', 'kimzihuang', 'anxovidal8', 'damlakubattt', 'andreadiazgar', 'lukunze1', 'joker632455', 'shuming2', 'j.haliburton', 'abieday1704', 'ozbunar01', 'davyn', 'ugur.cankaya.3718', 'nihaosawaddee', 'magic_ocean99', 'sinasigurpinar', 'tuberkargan', 'jarodm2', 'nabilah1403', 'amiruldanial99', 'yansi', 'cheokonn', 'ammaralaa516', 'juanmacano97', 'maxernest', 'marcosanllo', 'viratbhatt007', 'facundovia', 'michaelsaldana1', 'kie180073', 'bassamtarek', 'abbesalaeddine', 'restep2', 'estebanrial', 'martinzapata', '46harunakgul', 'talwren', 'leejq', 'mohammedemadeldin2000', 'jeanmichael.deschenes', 'miloaismanis', 'mmartinezsanchez', 'emrebuyukkose2', 'luciano.brignone', 'anwar909', 'ahmedamr', 'omarmagdy', 'abdurrahmn13', 'nikalyaamani', 'sdehoyos47', 'apascao', 'yubai', 'vincentpainchaud.vp', 'nagihankececi', 'nazimmath3', 'apb5472', 'rikardberger', 'mr4425', 'jacobzeshleman', 'guoyao', 'kiruthikaabalu181996', 'ikhbal', 'michael.mechelay', 'khor', 'david_atef', 'yaseminablacandir', 'c.a.stupka', 'amparo.castro.96', 'dhodapp', 'fkl217', 'farahsamir978', 'kie180039', 'atharva98', 'kph2', 'hafizmokh99', 'hilisa', 'kowjiajin', 'fred_dion', 'harshini9962', 'pvalladaresfdez', 'dancastaneda', 'jn1404', 'atx203', 'ammareltalli', 'amani12345', 'aaq', 'ledicia97', 'adriangarea', 'onaam8', 'zehuahe2', 'siemprewowthechami', 'justin.lariviere.25', 'tbryan', 'ludovick.begin', 'tss3', 'david2397', 'tmi211', 'kie180079', 'physquig', 'zakhwan7', 'mallen22', 'amr_ua07', 'pip29', 'fcfrancapra94', 'cristinacigarran', 'vanesagarcia', 'adnanyuceer', 'fathy1104', 'perezsarmar', 'al4995', 'melroy_caeiro', 'helenalecoq97', 'caglanlee', 'afeefz', 'jpmcgee98', 'ales.gajdacz', 'masitadonmez', 'eddin21', 'gemma', 'hmoulvi1', 'elad.d', 'xxlilmontysignxx', 'farah26', 'latecnologiameodia', 'abdulrahim2905', 'exjamil', 'vickytubio', 'ozgurkablan26', 'lderemo', 'ankit6257', 'javierisma98', 'redzuan11', 'yeejou990318', 'david.garrido', 'adarsh123', 'rileyroca', 'movi205', 'acregodean', 'pablosaavedra', 'maramtarek53', 's_coriolis', 'kakmeera1999', 'josepazmartin', 'travisc2', 'electronica18', 'kie180702', 'bhliu97', 'ematson5897', 'ashutoshsinghhenry6', 'martin32', 'maniphysics09', 'eduard25252598', 'moh.ashraf105', 'pablobou4', 'khazanv2', 'ahchehyan', 'ramonruiz.infor', 'brannon44', 'scremin', 'aasifhameed99', 'wahidiah52', 'm939454', 'aboone06', 'bluelobster', 'gabrielyii99', 'veronica.mieites', 'jinwoo2', 'syin4', 'diamond92', 'bflores18', 'njgale01', 'mgk816', 'dkshelat']"
1,33,392,10,10,"['njs035', 'talwren', 'williammitchell5818', 'rileyroca', 'nbs691', 'kaitlinh', 'cbecker413', 'jacobzeshleman', 'smrdafdl', 'berkaydean']",382,"['miri23', 'mohamedsameh', 'reemali99_', 'gc_1', 'kerryreto', 'zikrizaki88995', 'je_guilbert', 'jorgecastelo5', 'spazos7', 'soccadelic44', 'ahern0722', 'benoiturcotte', 'noureldin1999', 'alberfn', 'guttsfulltyagi', 'mavanzato0418', 'rkchapman', 'guibill10', 'ari6nd', 'michael2010814', 'happyleexin', 'omardeyaa', 'hong_gao', 'irenehb92', 'sandrabashara', 'nihatyavuz', 'akozych2', 'vikazvereva', 'danielfernandezcalo', 'anthonyroux', 'arrow823', 'aimansyaz99', 'annahaozheng0606', 'rocio', 'masonpb2', 'samashraf1', 'kirankumar94', 'prabuddha_888253127', 'carlosvigo1997', 'muvafikmelikkaya', 'amrebrahim', 'jtorres17', 'jzhan142', 'syedzakwan', 'samet1231234', 'kie180028', 'nadhnasorudin', 'avw2', 'ahmedsameh1698', 'acn562', 'moh.bahaa', 'arifjalani99', 'youssefsherif22', 'asyrafaqil', 'mjgebara14', 'camilolcastro97', 'bcperki2', 'azizijazam11', 'ahmedayman2370', 'rishu', 'ranasherif65', 'kyang37', 'nuanno97', 'brknshn', 'jbaggie2019', 'youssef2042000', 'olivier.gilbert.paquet', 'saipraneett', 'prakharbhargava0', 'hf4', 'nadja1', 'teoster50', 'mohaballam', 'ryanorem', 'shradhap', 'va844', 'neuroque', 'seifhabib', 'anibarseghyan', 'pingan99', 'mjoza2', 'mariz', 'virajput299', 'bleuminuit', 'ffazul64', 'paul.aniruddha', 'melaniejkramer', 'oliviercharbonneau', 'ilou', 'chengweiheng', 'evrenyigit', 'emilechouinard', 'pythagoras2', 'kason.carroll', 'malgaca', 'kie180031', 'carlosvillar54', 'ckim123', 'kychui2', 'kanet1234', 'mohabayman', 'sanchjai', 'oishikfaruque', 'lauragdevesa', 'nowapoca', 'ahagras13', 'akash140410107098', 'chithong', 'saharoaf', 'amni99', 'svo4321', 'lino13', 'vblanco.nico', 'aimanadnan', 'alidsjt', 'dlee145', 'stambo', 'lauramolinosmayo', 'mateocampos', 'hamidausat', 'yjenyiee155', 'retty8', 'sebasket14', 'marcmagdy98', 'janalorenzolumbreras', 'marianne.gratton.1', 'trkmengkay', 'shaf31', 'youxing0309', 'nourananwar123', 'puertarcd', 'felivitullo87', 'manuelsomoza94', 'alecorti.pardo', 'muteki', 'corredoira', 'gabrielyii', 'jinsup2', 'staceyn2', 'adam562', 'haclarke', 'xosegq16', 'e1150590', 'kalebhilde', 'adriancheah', 'jaimefookinlannister', 'tonybocadillosgrandes', 'rooban11', 'wowmuchchuck', 'xunyong', 'hishamzakaria20', 'rxtodd', 'sarapl', 'alimatama', 'jahnavikachhia', 'alexisdixon6', 'saegner2', 'pranjal3', 'baleko12345', 'sparshagarwal1009', 'xyz11', 'david.peral.moran', 'tingliang', 'isabelmaria.vazquez', 'aishu98', 'nadanasser1199', 'desmondsoon', 'keerthisv', 'musabmalek0717', 'mcruces.fz', 'tuberkargan_97', 'worldlineusaf', 'sealseal', 'bharath3', 'cloudyoverhead', 'dhvanil', 'ramy_maged4', 'lsleed', 'zhixin2', 'sriharshap', 'tyy233', 'ablahsaoud', 'nolmos96', 'shorouk_ossama', 'kaustubh.shirpurkar', 'pedrosiaba', 'coderko3', 'alifzulkifli99', 'alancantu57', 'baohl2', 'mengkem2', 'selena', 'tdubnansky6', 'ypp200', 'aengm', 'kartal', 'jacquelinethardin', 'mohameeddsamy', 'jipiccardi', 'amlibrahim', 'rahimnoorj', 'dcpang2', 'tamchouweng', 'elizametias12', 'efrenhub', 'mrefaat', 'ethanmorse', 'taymacnichols', 'ryanboucher', 'kirolosehab99', 'carlosbesadaromero', 'ericrobles', 'janeneil88', 'gxiao2', 'kimzihuang', 'anxovidal8', 'damlakubattt', 'andreadiazgar', 'lukunze1', 'joker632455', 'shuming2', 'j.haliburton', 'abieday1704', 'ozbunar01', 'ugur.cankaya.3718', 'nihaosawaddee', 'magic_ocean99', 'sinasigurpinar', 'tuberkargan', 'jarodm2', 'nabilah1403', 'amiruldanial99', 'yansi', 'cheokonn', 'ammaralaa516', 'juanmacano97', 'maxernest', 'marcosanllo', 'viratbhatt007', 'facundovia', 'michaelsaldana1', 'kie180073', 'bassamtarek', 'abbesalaeddine', 'restep2', 'estebanrial', 'martinzapata', '46harunakgul', 'leejq', 'mohammedemadeldin2000', 'jeanmichael.deschenes', 'miloaismanis', 'mmartinezsanchez', 'emrebuyukkose2', 'luciano.brignone', 'anwar909', 'ahmedamr', 'omarmagdy', 'abdurrahmn13', 'nikalyaamani', 'sdehoyos47', 'apascao', 'yubai', 'vincentpainchaud.vp', 'nagihankececi', 'nazimmath3', 'apb5472', 'rikardberger', 'mr4425', 'guoyao', 'kiruthikaabalu181996', 'ikhbal', 'michael.mechelay', 'khor', 'david_atef', 'yaseminablacandir', 'c.a.stupka', 'amparo.castro.96', 'dhodapp', 'fkl217', 'farahsamir978', 'kie180039', 'atharva98', 'kph2', 'hafizmokh99', 'hilisa', 'kowjiajin', 'fred_dion', 'harshini9962', 'pvalladaresfdez', 'dancastaneda', 'jn1404', 'atx203', 'ammareltalli', 'amani12345', 'aaq', 'ledicia97', 'adriangarea', 'onaam8', 'zehuahe2', 'siemprewowthechami', 'justin.lariviere.25', 'tbryan', 'ludovick.begin', 'tss3', 'david2397', 'tmi211', 'kie180079', 'physquig', 'zakhwan7', 'mallen22', 'amr_ua07', 'pip29', 'fcfrancapra94', 'cristinacigarran', 'vanesagarcia', 'adnanyuceer', 'fathy1104', 'perezsarmar', 'al4995', 'melroy_caeiro', 'helenalecoq97', 'caglanlee', 'afeefz', 'jpmcgee98', 'ales.gajdacz', 'masitadonmez', 'eddin21', 'gemma', 'hmoulvi1', 'elad.d', 'xxlilmontysignxx', 'farah26', 'latecnologiameodia', 'abdulrahim2905', 'exjamil', 'vickytubio', 'ozgurkablan26', 'lderemo', 'ankit6257', 'javierisma98', 'redzuan11', 'yeejou990318', 'david.garrido', 'adarsh123', 'movi205', 'acregodean', 'pablosaavedra', 'maramtarek53', 's_coriolis', 'kakmeera1999', 'josepazmartin', 'travisc2', 'electronica18', 'kie180702', 'bhliu97', 'ematson5897', 'ashutoshsinghhenry6', 'martin32', 'maniphysics09', 'eduard25252598', 'moh.ashraf105', 'pablobou4', 'khazanv2', 'ahchehyan', 'ramonruiz.infor', 'brannon44', 'scremin', 'aasifhameed99', 'wahidiah52', 'm939454', 'aboone06', 'bluelobster', 'gabrielyii99', 'veronica.mieites', 'jinwoo2', 'syin4', 'diamond92', 'bflores18', 'njgale01', 'mgk816', 'dkshelat']",0,[],392,"['miri23', 'mohamedsameh', 'reemali99_', 'gc_1', 'kerryreto', 'zikrizaki88995', 'je_guilbert', 'jorgecastelo5', 'spazos7', 'soccadelic44', 'ahern0722', 'benoiturcotte', 'noureldin1999', 'alberfn', 'guttsfulltyagi', 'mavanzato0418', 'rkchapman', 'guibill10', 'ari6nd', 'michael2010814', 'happyleexin', 'omardeyaa', 'hong_gao', 'irenehb92', 'sandrabashara', 'nihatyavuz', 'akozych2', 'vikazvereva', 'danielfernandezcalo', 'anthonyroux', 'arrow823', 'aimansyaz99', 'annahaozheng0606', 'rocio', 'masonpb2', 'samashraf1', 'kirankumar94', 'prabuddha_888253127', 'carlosvigo1997', 'muvafikmelikkaya', 'amrebrahim', 'jtorres17', 'jzhan142', 'syedzakwan', 'samet1231234', 'kie180028', 'nadhnasorudin', 'avw2', 'ahmedsameh1698', 'acn562', 'moh.bahaa', 'arifjalani99', 'youssefsherif22', 'asyrafaqil', 'mjgebara14', 'camilolcastro97', 'bcperki2', 'azizijazam11', 'ahmedayman2370', 'rishu', 'ranasherif65', 'kyang37', 'nuanno97', 'smrdafdl', 'brknshn', 'jbaggie2019', 'youssef2042000', 'olivier.gilbert.paquet', 'saipraneett', 'prakharbhargava0', 'hf4', 'nadja1', 'teoster50', 'mohaballam', 'ryanorem', 'shradhap', 'va844', 'neuroque', 'seifhabib', 'anibarseghyan', 'williammitchell5818', 'pingan99', 'mjoza2', 'mariz', 'virajput299', 'bleuminuit', 'ffazul64', 'paul.aniruddha', 'melaniejkramer', 'oliviercharbonneau', 'ilou', 'chengweiheng', 'evrenyigit', 'emilechouinard', 'pythagoras2', 'kason.carroll', 'malgaca', 'kie180031', 'carlosvillar54', 'ckim123', 'kychui2', 'kanet1234', 'mohabayman', 'sanchjai', 'nbs691', 'oishikfaruque', 'lauragdevesa', 'nowapoca', 'ahagras13', 'akash140410107098', 'chithong', 'saharoaf', 'amni99', 'svo4321', 'lino13', 'vblanco.nico', 'aimanadnan', 'alidsjt', 'dlee145', 'stambo', 'lauramolinosmayo', 'mateocampos', 'hamidausat', 'yjenyiee155', 'retty8', 'sebasket14', 'marcmagdy98', 'janalorenzolumbreras', 'marianne.gratton.1', 'trkmengkay', 'shaf31', 'youxing0309', 'nourananwar123', 'puertarcd', 'felivitullo87', 'manuelsomoza94', 'alecorti.pardo', 'muteki', 'corredoira', 'gabrielyii', 'jinsup2', 'staceyn2', 'kaitlinh', 'cbecker413', 'adam562', 'haclarke', 'xosegq16', 'e1150590', 'kalebhilde', 'adriancheah', 'jaimefookinlannister', 'tonybocadillosgrandes', 'rooban11', 'wowmuchchuck', 'xunyong', 'hishamzakaria20', 'rxtodd', 'sarapl', 'alimatama', 'jahnavikachhia', 'alexisdixon6', 'saegner2', 'pranjal3', 'berkaydean', 'baleko12345', 'sparshagarwal1009', 'xyz11', 'david.peral.moran', 'tingliang', 'isabelmaria.vazquez', 'aishu98', 'nadanasser1199', 'desmondsoon', 'keerthisv', 'musabmalek0717', 'mcruces.fz', 'tuberkargan_97', 'worldlineusaf', 'sealseal', 'bharath3', 'cloudyoverhead', 'dhvanil', 'ramy_maged4', 'lsleed', 'zhixin2', 'sriharshap', 'tyy233', 'njs035', 'ablahsaoud', 'nolmos96', 'shorouk_ossama', 'kaustubh.shirpurkar', 'pedrosiaba', 'coderko3', 'alifzulkifli99', 'alancantu57', 'baohl2', 'mengkem2', 'selena', 'tdubnansky6', 'ypp200', 'aengm', 'kartal', 'jacquelinethardin', 'mohameeddsamy', 'jipiccardi', 'amlibrahim', 'rahimnoorj', 'dcpang2', 'tamchouweng', 'elizametias12', 'efrenhub', 'mrefaat', 'ethanmorse', 'taymacnichols', 'ryanboucher', 'kirolosehab99', 'carlosbesadaromero', 'ericrobles', 'janeneil88', 'gxiao2', 'kimzihuang', 'anxovidal8', 'damlakubattt', 'andreadiazgar', 'lukunze1', 'joker632455', 'shuming2', 'j.haliburton', 'abieday1704', 'ozbunar01', 'ugur.cankaya.3718', 'nihaosawaddee', 'magic_ocean99', 'sinasigurpinar', 'tuberkargan', 'jarodm2', 'nabilah1403', 'amiruldanial99', 'yansi', 'cheokonn', 'ammaralaa516', 'juanmacano97', 'maxernest', 'marcosanllo', 'viratbhatt007', 'facundovia', 'michaelsaldana1', 'kie180073', 'bassamtarek', 'abbesalaeddine', 'restep2', 'estebanrial', 'martinzapata', '46harunakgul', 'talwren', 'leejq', 'mohammedemadeldin2000', 'jeanmichael.deschenes', 'miloaismanis', 'mmartinezsanchez', 'emrebuyukkose2', 'luciano.brignone', 'anwar909', 'ahmedamr', 'omarmagdy', 'abdurrahmn13', 'nikalyaamani', 'sdehoyos47', 'apascao', 'yubai', 'vincentpainchaud.vp', 'nagihankececi', 'nazimmath3', 'apb5472', 'rikardberger', 'mr4425', 'jacobzeshleman', 'guoyao', 'kiruthikaabalu181996', 'ikhbal', 'michael.mechelay', 'khor', 'david_atef', 'yaseminablacandir', 'c.a.stupka', 'amparo.castro.96', 'dhodapp', 'fkl217', 'farahsamir978', 'kie180039', 'atharva98', 'kph2', 'hafizmokh99', 'hilisa', 'kowjiajin', 'fred_dion', 'harshini9962', 'pvalladaresfdez', 'dancastaneda', 'jn1404', 'atx203', 'ammareltalli', 'amani12345', 'aaq', 'ledicia97', 'adriangarea', 'onaam8', 'zehuahe2', 'siemprewowthechami', 'justin.lariviere.25', 'tbryan', 'ludovick.begin', 'tss3', 'david2397', 'tmi211', 'kie180079', 'physquig', 'zakhwan7', 'mallen22', 'amr_ua07', 'pip29', 'fcfrancapra94', 'cristinacigarran', 'vanesagarcia', 'adnanyuceer', 'fathy1104', 'perezsarmar', 'al4995', 'melroy_caeiro', 'helenalecoq97', 'caglanlee', 'afeefz', 'jpmcgee98', 'ales.gajdacz', 'masitadonmez', 'eddin21', 'gemma', 'hmoulvi1', 'elad.d', 'xxlilmontysignxx', 'farah26', 'latecnologiameodia', 'abdulrahim2905', 'exjamil', 'vickytubio', 'ozgurkablan26', 'lderemo', 'ankit6257', 'javierisma98', 'redzuan11', 'yeejou990318', 'david.garrido', 'adarsh123', 'rileyroca', 'movi205', 'acregodean', 'pablosaavedra', 'maramtarek53', 's_coriolis', 'kakmeera1999', 'josepazmartin', 'travisc2', 'electronica18', 'kie180702', 'bhliu97', 'ematson5897', 'ashutoshsinghhenry6', 'martin32', 'maniphysics09', 'eduard25252598', 'moh.ashraf105', 'pablobou4', 'khazanv2', 'ahchehyan', 'ramonruiz.infor', 'brannon44', 'scremin', 'aasifhameed99', 'wahidiah52', 'm939454', 'aboone06', 'bluelobster', 'gabrielyii99', 'veronica.mieites', 'jinwoo2', 'syin4', 'diamond92', 'bflores18', 'njgale01', 'mgk816', 'dkshelat']"
1,12,392,9,4,"['felivitullo87', 'nowapoca', 'pablosaavedra', 'jipiccardi']",388,"['miri23', 'mohamedsameh', 'reemali99_', 'gc_1', 'kerryreto', 'zikrizaki88995', 'je_guilbert', 'jorgecastelo5', 'spazos7', 'soccadelic44', 'ahern0722', 'benoiturcotte', 'noureldin1999', 'alberfn', 'guttsfulltyagi', 'mavanzato0418', 'rkchapman', 'guibill10', 'ari6nd', 'michael2010814', 'happyleexin', 'omardeyaa', 'hong_gao', 'irenehb92', 'sandrabashara', 'nihatyavuz', 'akozych2', 'vikazvereva', 'danielfernandezcalo', 'anthonyroux', 'arrow823', 'aimansyaz99', 'annahaozheng0606', 'rocio', 'masonpb2', 'samashraf1', 'kirankumar94', 'prabuddha_888253127', 'carlosvigo1997', 'muvafikmelikkaya', 'amrebrahim', 'jtorres17', 'jzhan142', 'syedzakwan', 'samet1231234', 'kie180028', 'nadhnasorudin', 'avw2', 'ahmedsameh1698', 'acn562', 'moh.bahaa', 'arifjalani99', 'youssefsherif22', 'asyrafaqil', 'mjgebara14', 'camilolcastro97', 'bcperki2', 'azizijazam11', 'ahmedayman2370', 'rishu', 'ranasherif65', 'kyang37', 'nuanno97', 'smrdafdl', 'brknshn', 'jbaggie2019', 'youssef2042000', 'olivier.gilbert.paquet', 'saipraneett', 'prakharbhargava0', 'hf4', 'nadja1', 'teoster50', 'mohaballam', 'ryanorem', 'shradhap', 'va844', 'neuroque', 'seifhabib', 'anibarseghyan', 'williammitchell5818', 'pingan99', 'mjoza2', 'mariz', 'virajput299', 'bleuminuit', 'ffazul64', 'paul.aniruddha', 'melaniejkramer', 'oliviercharbonneau', 'ilou', 'chengweiheng', 'evrenyigit', 'emilechouinard', 'pythagoras2', 'kason.carroll', 'malgaca', 'kie180031', 'carlosvillar54', 'ckim123', 'kychui2', 'kanet1234', 'mohabayman', 'sanchjai', 'nbs691', 'oishikfaruque', 'lauragdevesa', 'ahagras13', 'akash140410107098', 'chithong', 'saharoaf', 'amni99', 'svo4321', 'lino13', 'vblanco.nico', 'aimanadnan', 'alidsjt', 'dlee145', 'stambo', 'lauramolinosmayo', 'mateocampos', 'hamidausat', 'yjenyiee155', 'retty8', 'sebasket14', 'marcmagdy98', 'janalorenzolumbreras', 'marianne.gratton.1', 'trkmengkay', 'shaf31', 'youxing0309', 'nourananwar123', 'puertarcd', 'manuelsomoza94', 'alecorti.pardo', 'muteki', 'corredoira', 'gabrielyii', 'jinsup2', 'staceyn2', 'kaitlinh', 'cbecker413', 'adam562', 'haclarke', 'xosegq16', 'e1150590', 'kalebhilde', 'adriancheah', 'jaimefookinlannister', 'tonybocadillosgrandes', 'rooban11', 'wowmuchchuck', 'xunyong', 'hishamzakaria20', 'rxtodd', 'sarapl', 'alimatama', 'jahnavikachhia', 'alexisdixon6', 'saegner2', 'pranjal3', 'berkaydean', 'baleko12345', 'sparshagarwal1009', 'xyz11', 'david.peral.moran', 'tingliang', 'isabelmaria.vazquez', 'aishu98', 'nadanasser1199', 'desmondsoon', 'keerthisv', 'musabmalek0717', 'mcruces.fz', 'tuberkargan_97', 'worldlineusaf', 'sealseal', 'bharath3', 'cloudyoverhead', 'dhvanil', 'ramy_maged4', 'lsleed', 'zhixin2', 'sriharshap', 'tyy233', 'njs035', 'ablahsaoud', 'nolmos96', 'shorouk_ossama', 'kaustubh.shirpurkar', 'pedrosiaba', 'coderko3', 'alifzulkifli99', 'alancantu57', 'baohl2', 'mengkem2', 'selena', 'tdubnansky6', 'ypp200', 'aengm', 'kartal', 'jacquelinethardin', 'mohameeddsamy', 'amlibrahim', 'rahimnoorj', 'dcpang2', 'tamchouweng', 'elizametias12', 'efrenhub', 'mrefaat', 'ethanmorse', 'taymacnichols', 'ryanboucher', 'kirolosehab99', 'carlosbesadaromero', 'ericrobles', 'janeneil88', 'gxiao2', 'kimzihuang', 'anxovidal8', 'damlakubattt', 'andreadiazgar', 'lukunze1', 'joker632455', 'shuming2', 'j.haliburton', 'abieday1704', 'ozbunar01', 'ugur.cankaya.3718', 'nihaosawaddee', 'magic_ocean99', 'sinasigurpinar', 'tuberkargan', 'jarodm2', 'nabilah1403', 'amiruldanial99', 'yansi', 'cheokonn', 'ammaralaa516', 'juanmacano97', 'maxernest', 'marcosanllo', 'viratbhatt007', 'facundovia', 'michaelsaldana1', 'kie180073', 'bassamtarek', 'abbesalaeddine', 'restep2', 'estebanrial', 'martinzapata', '46harunakgul', 'talwren', 'leejq', 'mohammedemadeldin2000', 'jeanmichael.deschenes', 'miloaismanis', 'mmartinezsanchez', 'emrebuyukkose2', 'luciano.brignone', 'anwar909', 'ahmedamr', 'omarmagdy', 'abdurrahmn13', 'nikalyaamani', 'sdehoyos47', 'apascao', 'yubai', 'vincentpainchaud.vp', 'nagihankececi', 'nazimmath3', 'apb5472', 'rikardberger', 'mr4425', 'jacobzeshleman', 'guoyao', 'kiruthikaabalu181996', 'ikhbal', 'michael.mechelay', 'khor', 'david_atef', 'yaseminablacandir', 'c.a.stupka', 'amparo.castro.96', 'dhodapp', 'fkl217', 'farahsamir978', 'kie180039', 'atharva98', 'kph2', 'hafizmokh99', 'hilisa', 'kowjiajin', 'fred_dion', 'harshini9962', 'pvalladaresfdez', 'dancastaneda', 'jn1404', 'atx203', 'ammareltalli', 'amani12345', 'aaq', 'ledicia97', 'adriangarea', 'onaam8', 'zehuahe2', 'siemprewowthechami', 'justin.lariviere.25', 'tbryan', 'ludovick.begin', 'tss3', 'david2397', 'tmi211', 'kie180079', 'physquig', 'zakhwan7', 'mallen22', 'amr_ua07', 'pip29', 'fcfrancapra94', 'cristinacigarran', 'vanesagarcia', 'adnanyuceer', 'fathy1104', 'perezsarmar', 'al4995', 'melroy_caeiro', 'helenalecoq97', 'caglanlee', 'afeefz', 'jpmcgee98', 'ales.gajdacz', 'masitadonmez', 'eddin21', 'gemma', 'hmoulvi1', 'elad.d', 'xxlilmontysignxx', 'farah26', 'latecnologiameodia', 'abdulrahim2905', 'exjamil', 'vickytubio', 'ozgurkablan26', 'lderemo', 'ankit6257', 'javierisma98', 'redzuan11', 'yeejou990318', 'david.garrido', 'adarsh123', 'rileyroca', 'movi205', 'acregodean', 'maramtarek53', 's_coriolis', 'kakmeera1999', 'josepazmartin', 'travisc2', 'electronica18', 'kie180702', 'bhliu97', 'ematson5897', 'ashutoshsinghhenry6', 'martin32', 'maniphysics09', 'eduard25252598', 'moh.ashraf105', 'pablobou4', 'khazanv2', 'ahchehyan', 'ramonruiz.infor', 'brannon44', 'scremin', 'aasifhameed99', 'wahidiah52', 'm939454', 'aboone06', 'bluelobster', 'gabrielyii99', 'veronica.mieites', 'jinwoo2', 'syin4', 'diamond92', 'bflores18', 'njgale01', 'mgk816', 'dkshelat']",5,"['adh30', 'damitepl', 'garx', 'spazos', 'juliandocev15868']",397,"['miri23', 'mohamedsameh', 'reemali99_', 'gc_1', 'kerryreto', 'zikrizaki88995', 'je_guilbert', 'jorgecastelo5', 'spazos7', 'soccadelic44', 'ahern0722', 'benoiturcotte', 'noureldin1999', 'alberfn', 'guttsfulltyagi', 'mavanzato0418', 'rkchapman', 'guibill10', 'ari6nd', 'michael2010814', 'happyleexin', 'omardeyaa', 'hong_gao', 'irenehb92', 'sandrabashara', 'nihatyavuz', 'akozych2', 'vikazvereva', 'danielfernandezcalo', 'anthonyroux', 'arrow823', 'aimansyaz99', 'annahaozheng0606', 'rocio', 'masonpb2', 'samashraf1', 'kirankumar94', 'prabuddha_888253127', 'carlosvigo1997', 'muvafikmelikkaya', 'amrebrahim', 'jtorres17', 'jzhan142', 'syedzakwan', 'samet1231234', 'kie180028', 'nadhnasorudin', 'avw2', 'ahmedsameh1698', 'acn562', 'moh.bahaa', 'arifjalani99', 'youssefsherif22', 'asyrafaqil', 'mjgebara14', 'camilolcastro97', 'bcperki2', 'azizijazam11', 'ahmedayman2370', 'rishu', 'ranasherif65', 'kyang37', 'nuanno97', 'smrdafdl', 'brknshn', 'jbaggie2019', 'youssef2042000', 'olivier.gilbert.paquet', 'saipraneett', 'prakharbhargava0', 'hf4', 'nadja1', 'teoster50', 'mohaballam', 'ryanorem', 'shradhap', 'va844', 'neuroque', 'seifhabib', 'anibarseghyan', 'williammitchell5818', 'pingan99', 'mjoza2', 'mariz', 'virajput299', 'bleuminuit', 'ffazul64', 'paul.aniruddha', 'melaniejkramer', 'oliviercharbonneau', 'ilou', 'chengweiheng', 'evrenyigit', 'emilechouinard', 'pythagoras2', 'kason.carroll', 'malgaca', 'kie180031', 'carlosvillar54', 'ckim123', 'kychui2', 'kanet1234', 'mohabayman', 'sanchjai', 'nbs691', 'oishikfaruque', 'lauragdevesa', 'nowapoca', 'ahagras13', 'akash140410107098', 'chithong', 'saharoaf', 'amni99', 'svo4321', 'lino13', 'vblanco.nico', 'aimanadnan', 'alidsjt', 'dlee145', 'stambo', 'lauramolinosmayo', 'mateocampos', 'hamidausat', 'yjenyiee155', 'retty8', 'sebasket14', 'marcmagdy98', 'janalorenzolumbreras', 'marianne.gratton.1', 'trkmengkay', 'shaf31', 'youxing0309', 'nourananwar123', 'puertarcd', 'felivitullo87', 'manuelsomoza94', 'alecorti.pardo', 'muteki', 'corredoira', 'gabrielyii', 'jinsup2', 'staceyn2', 'kaitlinh', 'cbecker413', 'adam562', 'haclarke', 'xosegq16', 'e1150590', 'kalebhilde', 'adriancheah', 'jaimefookinlannister', 'tonybocadillosgrandes', 'rooban11', 'wowmuchchuck', 'xunyong', 'hishamzakaria20', 'rxtodd', 'sarapl', 'alimatama', 'jahnavikachhia', 'alexisdixon6', 'saegner2', 'pranjal3', 'berkaydean', 'baleko12345', 'spazos', 'sparshagarwal1009', 'xyz11', 'david.peral.moran', 'tingliang', 'isabelmaria.vazquez', 'aishu98', 'nadanasser1199', 'desmondsoon', 'keerthisv', 'musabmalek0717', 'mcruces.fz', 'tuberkargan_97', 'worldlineusaf', 'sealseal', 'bharath3', 'cloudyoverhead', 'dhvanil', 'ramy_maged4', 'lsleed', 'zhixin2', 'sriharshap', 'tyy233', 'njs035', 'ablahsaoud', 'nolmos96', 'shorouk_ossama', 'kaustubh.shirpurkar', 'pedrosiaba', 'coderko3', 'alifzulkifli99', 'alancantu57', 'baohl2', 'mengkem2', 'selena', 'tdubnansky6', 'ypp200', 'aengm', 'kartal', 'jacquelinethardin', 'mohameeddsamy', 'jipiccardi', 'amlibrahim', 'rahimnoorj', 'dcpang2', 'tamchouweng', 'elizametias12', 'efrenhub', 'mrefaat', 'ethanmorse', 'taymacnichols', 'ryanboucher', 'kirolosehab99', 'carlosbesadaromero', 'ericrobles', 'janeneil88', 'gxiao2', 'kimzihuang', 'anxovidal8', 'damlakubattt', 'andreadiazgar', 'lukunze1', 'joker632455', 'shuming2', 'j.haliburton', 'abieday1704', 'ozbunar01', 'ugur.cankaya.3718', 'nihaosawaddee', 'magic_ocean99', 'sinasigurpinar', 'tuberkargan', 'jarodm2', 'nabilah1403', 'amiruldanial99', 'yansi', 'cheokonn', 'ammaralaa516', 'juanmacano97', 'maxernest', 'marcosanllo', 'viratbhatt007', 'facundovia', 'michaelsaldana1', 'kie180073', 'bassamtarek', 'abbesalaeddine', 'restep2', 'estebanrial', 'martinzapata', '46harunakgul', 'talwren', 'leejq', 'mohammedemadeldin2000', 'jeanmichael.deschenes', 'miloaismanis', 'mmartinezsanchez', 'emrebuyukkose2', 'luciano.brignone', 'anwar909', 'ahmedamr', 'omarmagdy', 'abdurrahmn13', 'nikalyaamani', 'sdehoyos47', 'apascao', 'yubai', 'vincentpainchaud.vp', 'nagihankececi', 'nazimmath3', 'apb5472', 'rikardberger', 'mr4425', 'jacobzeshleman', 'guoyao', 'kiruthikaabalu181996', 'ikhbal', 'michael.mechelay', 'khor', 'david_atef', 'yaseminablacandir', 'c.a.stupka', 'amparo.castro.96', 'dhodapp', 'adh30', 'fkl217', 'damitepl', 'farahsamir978', 'kie180039', 'atharva98', 'kph2', 'hafizmokh99', 'hilisa', 'kowjiajin', 'fred_dion', 'harshini9962', 'pvalladaresfdez', 'dancastaneda', 'jn1404', 'atx203', 'ammareltalli', 'amani12345', 'aaq', 'ledicia97', 'adriangarea', 'onaam8', 'zehuahe2', 'siemprewowthechami', 'justin.lariviere.25', 'tbryan', 'ludovick.begin', 'tss3', 'david2397', 'tmi211', 'kie180079', 'physquig', 'zakhwan7', 'mallen22', 'amr_ua07', 'pip29', 'fcfrancapra94', 'cristinacigarran', 'vanesagarcia', 'adnanyuceer', 'fathy1104', 'perezsarmar', 'al4995', 'melroy_caeiro', 'helenalecoq97', 'caglanlee', 'afeefz', 'jpmcgee98', 'ales.gajdacz', 'masitadonmez', 'eddin21', 'gemma', 'hmoulvi1', 'elad.d', 'xxlilmontysignxx', 'farah26', 'latecnologiameodia', 'abdulrahim2905', 'exjamil', 'vickytubio', 'ozgurkablan26', 'lderemo', 'ankit6257', 'javierisma98', 'redzuan11', 'yeejou990318', 'david.garrido', 'adarsh123', 'rileyroca', 'movi205', 'acregodean', 'pablosaavedra', 'maramtarek53', 's_coriolis', 'kakmeera1999', 'josepazmartin', 'travisc2', 'electronica18', 'kie180702', 'bhliu97', 'ematson5897', 'ashutoshsinghhenry6', 'martin32', 'maniphysics09', 'eduard25252598', 'juliandocev15868', 'moh.ashraf105', 'pablobou4', 'khazanv2', 'ahchehyan', 'garx', 'ramonruiz.infor', 'brannon44', 'scremin', 'aasifhameed99', 'wahidiah52', 'm939454', 'aboone06', 'bluelobster', 'gabrielyii99', 'veronica.mieites', 'jinwoo2', 'syin4', 'diamond92', 'bflores18', 'njgale01', 'mgk816', 'dkshelat']"
1,14,392,9,5,"['elad.d', 'atharva98', 'alancantu57', 'alexisdixon6', 'luciano.brignone']",387,"['miri23', 'mohamedsameh', 'reemali99_', 'gc_1', 'kerryreto', 'zikrizaki88995', 'je_guilbert', 'jorgecastelo5', 'spazos7', 'soccadelic44', 'ahern0722', 'benoiturcotte', 'noureldin1999', 'alberfn', 'guttsfulltyagi', 'mavanzato0418', 'rkchapman', 'guibill10', 'ari6nd', 'michael2010814', 'happyleexin', 'omardeyaa', 'hong_gao', 'irenehb92', 'sandrabashara', 'nihatyavuz', 'akozych2', 'vikazvereva', 'danielfernandezcalo', 'anthonyroux', 'arrow823', 'aimansyaz99', 'annahaozheng0606', 'rocio', 'masonpb2', 'samashraf1', 'kirankumar94', 'prabuddha_888253127', 'carlosvigo1997', 'muvafikmelikkaya', 'amrebrahim', 'jtorres17', 'jzhan142', 'syedzakwan', 'samet1231234', 'kie180028', 'nadhnasorudin', 'avw2', 'ahmedsameh1698', 'acn562', 'moh.bahaa', 'arifjalani99', 'youssefsherif22', 'asyrafaqil', 'mjgebara14', 'camilolcastro97', 'bcperki2', 'azizijazam11', 'ahmedayman2370', 'rishu', 'ranasherif65', 'kyang37', 'nuanno97', 'smrdafdl', 'brknshn', 'jbaggie2019', 'youssef2042000', 'olivier.gilbert.paquet', 'saipraneett', 'prakharbhargava0', 'hf4', 'nadja1', 'teoster50', 'mohaballam', 'ryanorem', 'shradhap', 'va844', 'neuroque', 'seifhabib', 'anibarseghyan', 'williammitchell5818', 'pingan99', 'mjoza2', 'mariz', 'virajput299', 'bleuminuit', 'ffazul64', 'paul.aniruddha', 'melaniejkramer', 'oliviercharbonneau', 'ilou', 'chengweiheng', 'evrenyigit', 'emilechouinard', 'pythagoras2', 'kason.carroll', 'malgaca', 'kie180031', 'carlosvillar54', 'ckim123', 'kychui2', 'kanet1234', 'mohabayman', 'sanchjai', 'nbs691', 'oishikfaruque', 'lauragdevesa', 'nowapoca', 'ahagras13', 'akash140410107098', 'chithong', 'saharoaf', 'amni99', 'svo4321', 'lino13', 'vblanco.nico', 'aimanadnan', 'alidsjt', 'dlee145', 'stambo', 'lauramolinosmayo', 'mateocampos', 'hamidausat', 'yjenyiee155', 'retty8', 'sebasket14', 'marcmagdy98', 'janalorenzolumbreras', 'marianne.gratton.1', 'trkmengkay', 'shaf31', 'youxing0309', 'nourananwar123', 'puertarcd', 'felivitullo87', 'manuelsomoza94', 'alecorti.pardo', 'muteki', 'corredoira', 'gabrielyii', 'jinsup2', 'staceyn2', 'kaitlinh', 'cbecker413', 'adam562', 'haclarke', 'xosegq16', 'e1150590', 'kalebhilde', 'adriancheah', 'jaimefookinlannister', 'tonybocadillosgrandes', 'rooban11', 'wowmuchchuck', 'xunyong', 'hishamzakaria20', 'rxtodd', 'sarapl', 'alimatama', 'jahnavikachhia', 'saegner2', 'pranjal3', 'berkaydean', 'baleko12345', 'sparshagarwal1009', 'xyz11', 'david.peral.moran', 'tingliang', 'isabelmaria.vazquez', 'aishu98', 'nadanasser1199', 'desmondsoon', 'keerthisv', 'musabmalek0717', 'mcruces.fz', 'tuberkargan_97', 'worldlineusaf', 'sealseal', 'bharath3', 'cloudyoverhead', 'dhvanil', 'ramy_maged4', 'lsleed', 'zhixin2', 'sriharshap', 'tyy233', 'njs035', 'ablahsaoud', 'nolmos96', 'shorouk_ossama', 'kaustubh.shirpurkar', 'pedrosiaba', 'coderko3', 'alifzulkifli99', 'baohl2', 'mengkem2', 'selena', 'tdubnansky6', 'ypp200', 'aengm', 'kartal', 'jacquelinethardin', 'mohameeddsamy', 'jipiccardi', 'amlibrahim', 'rahimnoorj', 'dcpang2', 'tamchouweng', 'elizametias12', 'efrenhub', 'mrefaat', 'ethanmorse', 'taymacnichols', 'ryanboucher', 'kirolosehab99', 'carlosbesadaromero', 'ericrobles', 'janeneil88', 'gxiao2', 'kimzihuang', 'anxovidal8', 'damlakubattt', 'andreadiazgar', 'lukunze1', 'joker632455', 'shuming2', 'j.haliburton', 'abieday1704', 'ozbunar01', 'ugur.cankaya.3718', 'nihaosawaddee', 'magic_ocean99', 'sinasigurpinar', 'tuberkargan', 'jarodm2', 'nabilah1403', 'amiruldanial99', 'yansi', 'cheokonn', 'ammaralaa516', 'juanmacano97', 'maxernest', 'marcosanllo', 'viratbhatt007', 'facundovia', 'michaelsaldana1', 'kie180073', 'bassamtarek', 'abbesalaeddine', 'restep2', 'estebanrial', 'martinzapata', '46harunakgul', 'talwren', 'leejq', 'mohammedemadeldin2000', 'jeanmichael.deschenes', 'miloaismanis', 'mmartinezsanchez', 'emrebuyukkose2', 'anwar909', 'ahmedamr', 'omarmagdy', 'abdurrahmn13', 'nikalyaamani', 'sdehoyos47', 'apascao', 'yubai', 'vincentpainchaud.vp', 'nagihankececi', 'nazimmath3', 'apb5472', 'rikardberger', 'mr4425', 'jacobzeshleman', 'guoyao', 'kiruthikaabalu181996', 'ikhbal', 'michael.mechelay', 'khor', 'david_atef', 'yaseminablacandir', 'c.a.stupka', 'amparo.castro.96', 'dhodapp', 'fkl217', 'farahsamir978', 'kie180039', 'kph2', 'hafizmokh99', 'hilisa', 'kowjiajin', 'fred_dion', 'harshini9962', 'pvalladaresfdez', 'dancastaneda', 'jn1404', 'atx203', 'ammareltalli', 'amani12345', 'aaq', 'ledicia97', 'adriangarea', 'onaam8', 'zehuahe2', 'siemprewowthechami', 'justin.lariviere.25', 'tbryan', 'ludovick.begin', 'tss3', 'david2397', 'tmi211', 'kie180079', 'physquig', 'zakhwan7', 'mallen22', 'amr_ua07', 'pip29', 'fcfrancapra94', 'cristinacigarran', 'vanesagarcia', 'adnanyuceer', 'fathy1104', 'perezsarmar', 'al4995', 'melroy_caeiro', 'helenalecoq97', 'caglanlee', 'afeefz', 'jpmcgee98', 'ales.gajdacz', 'masitadonmez', 'eddin21', 'gemma', 'hmoulvi1', 'xxlilmontysignxx', 'farah26', 'latecnologiameodia', 'abdulrahim2905', 'exjamil', 'vickytubio', 'ozgurkablan26', 'lderemo', 'ankit6257', 'javierisma98', 'redzuan11', 'yeejou990318', 'david.garrido', 'adarsh123', 'rileyroca', 'movi205', 'acregodean', 'pablosaavedra', 'maramtarek53', 's_coriolis', 'kakmeera1999', 'josepazmartin', 'travisc2', 'electronica18', 'kie180702', 'bhliu97', 'ematson5897', 'ashutoshsinghhenry6', 'martin32', 'maniphysics09', 'eduard25252598', 'moh.ashraf105', 'pablobou4', 'khazanv2', 'ahchehyan', 'ramonruiz.infor', 'brannon44', 'scremin', 'aasifhameed99', 'wahidiah52', 'm939454', 'aboone06', 'bluelobster', 'gabrielyii99', 'veronica.mieites', 'jinwoo2', 'syin4', 'diamond92', 'bflores18', 'njgale01', 'mgk816', 'dkshelat']",4,"['adhityaven', 'nayanpatel98', 'valeria.delgadorusso', 'jairgnzlz1698']",396,"['miri23', 'mohamedsameh', 'reemali99_', 'gc_1', 'kerryreto', 'zikrizaki88995', 'je_guilbert', 'jorgecastelo5', 'spazos7', 'soccadelic44', 'ahern0722', 'benoiturcotte', 'noureldin1999', 'jairgnzlz1698', 'alberfn', 'guttsfulltyagi', 'mavanzato0418', 'rkchapman', 'nayanpatel98', 'guibill10', 'ari6nd', 'michael2010814', 'happyleexin', 'omardeyaa', 'hong_gao', 'irenehb92', 'sandrabashara', 'nihatyavuz', 'akozych2', 'vikazvereva', 'danielfernandezcalo', 'anthonyroux', 'arrow823', 'aimansyaz99', 'annahaozheng0606', 'rocio', 'masonpb2', 'samashraf1', 'kirankumar94', 'prabuddha_888253127', 'carlosvigo1997', 'muvafikmelikkaya', 'amrebrahim', 'jtorres17', 'jzhan142', 'syedzakwan', 'samet1231234', 'kie180028', 'nadhnasorudin', 'avw2', 'ahmedsameh1698', 'acn562', 'moh.bahaa', 'arifjalani99', 'adhityaven', 'youssefsherif22', 'asyrafaqil', 'mjgebara14', 'camilolcastro97', 'bcperki2', 'azizijazam11', 'ahmedayman2370', 'rishu', 'ranasherif65', 'kyang37', 'nuanno97', 'smrdafdl', 'brknshn', 'jbaggie2019', 'youssef2042000', 'olivier.gilbert.paquet', 'saipraneett', 'prakharbhargava0', 'hf4', 'nadja1', 'teoster50', 'mohaballam', 'ryanorem', 'shradhap', 'va844', 'neuroque', 'seifhabib', 'anibarseghyan', 'williammitchell5818', 'pingan99', 'mjoza2', 'mariz', 'virajput299', 'bleuminuit', 'ffazul64', 'paul.aniruddha', 'melaniejkramer', 'oliviercharbonneau', 'ilou', 'chengweiheng', 'evrenyigit', 'emilechouinard', 'pythagoras2', 'kason.carroll', 'malgaca', 'kie180031', 'carlosvillar54', 'ckim123', 'kychui2', 'kanet1234', 'mohabayman', 'sanchjai', 'nbs691', 'oishikfaruque', 'lauragdevesa', 'nowapoca', 'ahagras13', 'akash140410107098', 'chithong', 'saharoaf', 'amni99', 'svo4321', 'lino13', 'vblanco.nico', 'aimanadnan', 'alidsjt', 'dlee145', 'stambo', 'lauramolinosmayo', 'mateocampos', 'hamidausat', 'yjenyiee155', 'retty8', 'sebasket14', 'marcmagdy98', 'janalorenzolumbreras', 'marianne.gratton.1', 'trkmengkay', 'shaf31', 'youxing0309', 'nourananwar123', 'puertarcd', 'felivitullo87', 'manuelsomoza94', 'alecorti.pardo', 'muteki', 'corredoira', 'gabrielyii', 'jinsup2', 'staceyn2', 'kaitlinh', 'cbecker413', 'adam562', 'haclarke', 'xosegq16', 'e1150590', 'kalebhilde', 'adriancheah', 'jaimefookinlannister', 'tonybocadillosgrandes', 'rooban11', 'wowmuchchuck', 'xunyong', 'hishamzakaria20', 'rxtodd', 'sarapl', 'alimatama', 'jahnavikachhia', 'alexisdixon6', 'saegner2', 'pranjal3', 'berkaydean', 'baleko12345', 'sparshagarwal1009', 'xyz11', 'david.peral.moran', 'tingliang', 'isabelmaria.vazquez', 'aishu98', 'nadanasser1199', 'desmondsoon', 'keerthisv', 'musabmalek0717', 'mcruces.fz', 'tuberkargan_97', 'worldlineusaf', 'sealseal', 'bharath3', 'cloudyoverhead', 'dhvanil', 'ramy_maged4', 'lsleed', 'zhixin2', 'sriharshap', 'tyy233', 'njs035', 'ablahsaoud', 'nolmos96', 'shorouk_ossama', 'kaustubh.shirpurkar', 'pedrosiaba', 'coderko3', 'alifzulkifli99', 'alancantu57', 'baohl2', 'mengkem2', 'selena', 'tdubnansky6', 'ypp200', 'aengm', 'kartal', 'jacquelinethardin', 'valeria.delgadorusso', 'mohameeddsamy', 'jipiccardi', 'amlibrahim', 'rahimnoorj', 'dcpang2', 'tamchouweng', 'elizametias12', 'efrenhub', 'mrefaat', 'ethanmorse', 'taymacnichols', 'ryanboucher', 'kirolosehab99', 'carlosbesadaromero', 'ericrobles', 'janeneil88', 'gxiao2', 'kimzihuang', 'anxovidal8', 'damlakubattt', 'andreadiazgar', 'lukunze1', 'joker632455', 'shuming2', 'j.haliburton', 'abieday1704', 'ozbunar01', 'ugur.cankaya.3718', 'nihaosawaddee', 'magic_ocean99', 'sinasigurpinar', 'tuberkargan', 'jarodm2', 'nabilah1403', 'amiruldanial99', 'yansi', 'cheokonn', 'ammaralaa516', 'juanmacano97', 'maxernest', 'marcosanllo', 'viratbhatt007', 'facundovia', 'michaelsaldana1', 'kie180073', 'bassamtarek', 'abbesalaeddine', 'restep2', 'estebanrial', 'martinzapata', '46harunakgul', 'talwren', 'leejq', 'mohammedemadeldin2000', 'jeanmichael.deschenes', 'miloaismanis', 'mmartinezsanchez', 'emrebuyukkose2', 'luciano.brignone', 'anwar909', 'ahmedamr', 'omarmagdy', 'abdurrahmn13', 'nikalyaamani', 'sdehoyos47', 'apascao', 'yubai', 'vincentpainchaud.vp', 'nagihankececi', 'nazimmath3', 'apb5472', 'rikardberger', 'mr4425', 'jacobzeshleman', 'guoyao', 'kiruthikaabalu181996', 'ikhbal', 'michael.mechelay', 'khor', 'david_atef', 'yaseminablacandir', 'c.a.stupka', 'amparo.castro.96', 'dhodapp', 'fkl217', 'farahsamir978', 'kie180039', 'atharva98', 'kph2', 'hafizmokh99', 'hilisa', 'kowjiajin', 'fred_dion', 'harshini9962', 'pvalladaresfdez', 'dancastaneda', 'jn1404', 'atx203', 'ammareltalli', 'amani12345', 'aaq', 'ledicia97', 'adriangarea', 'onaam8', 'zehuahe2', 'siemprewowthechami', 'justin.lariviere.25', 'tbryan', 'ludovick.begin', 'tss3', 'david2397', 'tmi211', 'kie180079', 'physquig', 'zakhwan7', 'mallen22', 'amr_ua07', 'pip29', 'fcfrancapra94', 'cristinacigarran', 'vanesagarcia', 'adnanyuceer', 'fathy1104', 'perezsarmar', 'al4995', 'melroy_caeiro', 'helenalecoq97', 'caglanlee', 'afeefz', 'jpmcgee98', 'ales.gajdacz', 'masitadonmez', 'eddin21', 'gemma', 'hmoulvi1', 'elad.d', 'xxlilmontysignxx', 'farah26', 'latecnologiameodia', 'abdulrahim2905', 'exjamil', 'vickytubio', 'ozgurkablan26', 'lderemo', 'ankit6257', 'javierisma98', 'redzuan11', 'yeejou990318', 'david.garrido', 'adarsh123', 'rileyroca', 'movi205', 'acregodean', 'pablosaavedra', 'maramtarek53', 's_coriolis', 'kakmeera1999', 'josepazmartin', 'travisc2', 'electronica18', 'kie180702', 'bhliu97', 'ematson5897', 'ashutoshsinghhenry6', 'martin32', 'maniphysics09', 'eduard25252598', 'moh.ashraf105', 'pablobou4', 'khazanv2', 'ahchehyan', 'ramonruiz.infor', 'brannon44', 'scremin', 'aasifhameed99', 'wahidiah52', 'm939454', 'aboone06', 'bluelobster', 'gabrielyii99', 'veronica.mieites', 'jinwoo2', 'syin4', 'diamond92', 'bflores18', 'njgale01', 'mgk816', 'dkshelat']"
1,29,392,8,7,"['pip29', 'eddin21', 'kie180079', 'janeneil88', 'guoyao', 'youxing0309', 'aimansyaz99']",385,"['miri23', 'mohamedsameh', 'reemali99_', 'gc_1', 'kerryreto', 'zikrizaki88995', 'je_guilbert', 'jorgecastelo5', 'spazos7', 'soccadelic44', 'ahern0722', 'benoiturcotte', 'noureldin1999', 'alberfn', 'guttsfulltyagi', 'mavanzato0418', 'rkchapman', 'guibill10', 'ari6nd', 'michael2010814', 'happyleexin', 'omardeyaa', 'hong_gao', 'irenehb92', 'sandrabashara', 'nihatyavuz', 'akozych2', 'vikazvereva', 'danielfernandezcalo', 'anthonyroux', 'arrow823', 'annahaozheng0606', 'rocio', 'masonpb2', 'samashraf1', 'kirankumar94', 'prabuddha_888253127', 'carlosvigo1997', 'muvafikmelikkaya', 'amrebrahim', 'jtorres17', 'jzhan142', 'syedzakwan', 'samet1231234', 'kie180028', 'nadhnasorudin', 'avw2', 'ahmedsameh1698', 'acn562', 'moh.bahaa', 'arifjalani99', 'youssefsherif22', 'asyrafaqil', 'mjgebara14', 'camilolcastro97', 'bcperki2', 'azizijazam11', 'ahmedayman2370', 'rishu', 'ranasherif65', 'kyang37', 'nuanno97', 'smrdafdl', 'brknshn', 'jbaggie2019', 'youssef2042000', 'olivier.gilbert.paquet', 'saipraneett', 'prakharbhargava0', 'hf4', 'nadja1', 'teoster50', 'mohaballam', 'ryanorem', 'shradhap', 'va844', 'neuroque', 'seifhabib', 'anibarseghyan', 'williammitchell5818', 'pingan99', 'mjoza2', 'mariz', 'virajput299', 'bleuminuit', 'ffazul64', 'paul.aniruddha', 'melaniejkramer', 'oliviercharbonneau', 'ilou', 'chengweiheng', 'evrenyigit', 'emilechouinard', 'pythagoras2', 'kason.carroll', 'malgaca', 'kie180031', 'carlosvillar54', 'ckim123', 'kychui2', 'kanet1234', 'mohabayman', 'sanchjai', 'nbs691', 'oishikfaruque', 'lauragdevesa', 'nowapoca', 'ahagras13', 'akash140410107098', 'chithong', 'saharoaf', 'amni99', 'svo4321', 'lino13', 'vblanco.nico', 'aimanadnan', 'alidsjt', 'dlee145', 'stambo', 'lauramolinosmayo', 'mateocampos', 'hamidausat', 'yjenyiee155', 'retty8', 'sebasket14', 'marcmagdy98', 'janalorenzolumbreras', 'marianne.gratton.1', 'trkmengkay', 'shaf31', 'nourananwar123', 'puertarcd', 'felivitullo87', 'manuelsomoza94', 'alecorti.pardo', 'muteki', 'corredoira', 'gabrielyii', 'jinsup2', 'staceyn2', 'kaitlinh', 'cbecker413', 'adam562', 'haclarke', 'xosegq16', 'e1150590', 'kalebhilde', 'adriancheah', 'jaimefookinlannister', 'tonybocadillosgrandes', 'rooban11', 'wowmuchchuck', 'xunyong', 'hishamzakaria20', 'rxtodd', 'sarapl', 'alimatama', 'jahnavikachhia', 'alexisdixon6', 'saegner2', 'pranjal3', 'berkaydean', 'baleko12345', 'sparshagarwal1009', 'xyz11', 'david.peral.moran', 'tingliang', 'isabelmaria.vazquez', 'aishu98', 'nadanasser1199', 'desmondsoon', 'keerthisv', 'musabmalek0717', 'mcruces.fz', 'tuberkargan_97', 'worldlineusaf', 'sealseal', 'bharath3', 'cloudyoverhead', 'dhvanil', 'ramy_maged4', 'lsleed', 'zhixin2', 'sriharshap', 'tyy233', 'njs035', 'ablahsaoud', 'nolmos96', 'shorouk_ossama', 'kaustubh.shirpurkar', 'pedrosiaba', 'coderko3', 'alifzulkifli99', 'alancantu57', 'baohl2', 'mengkem2', 'selena', 'tdubnansky6', 'ypp200', 'aengm', 'kartal', 'jacquelinethardin', 'mohameeddsamy', 'jipiccardi', 'amlibrahim', 'rahimnoorj', 'dcpang2', 'tamchouweng', 'elizametias12', 'efrenhub', 'mrefaat', 'ethanmorse', 'taymacnichols', 'ryanboucher', 'kirolosehab99', 'carlosbesadaromero', 'ericrobles', 'gxiao2', 'kimzihuang', 'anxovidal8', 'damlakubattt', 'andreadiazgar', 'lukunze1', 'joker632455', 'shuming2', 'j.haliburton', 'abieday1704', 'ozbunar01', 'ugur.cankaya.3718', 'nihaosawaddee', 'magic_ocean99', 'sinasigurpinar', 'tuberkargan', 'jarodm2', 'nabilah1403', 'amiruldanial99', 'yansi', 'cheokonn', 'ammaralaa516', 'juanmacano97', 'maxernest', 'marcosanllo', 'viratbhatt007', 'facundovia', 'michaelsaldana1', 'kie180073', 'bassamtarek', 'abbesalaeddine', 'restep2', 'estebanrial', 'martinzapata', '46harunakgul', 'talwren', 'leejq', 'mohammedemadeldin2000', 'jeanmichael.deschenes', 'miloaismanis', 'mmartinezsanchez', 'emrebuyukkose2', 'luciano.brignone', 'anwar909', 'ahmedamr', 'omarmagdy', 'abdurrahmn13', 'nikalyaamani', 'sdehoyos47', 'apascao', 'yubai', 'vincentpainchaud.vp', 'nagihankececi', 'nazimmath3', 'apb5472', 'rikardberger', 'mr4425', 'jacobzeshleman', 'kiruthikaabalu181996', 'ikhbal', 'michael.mechelay', 'khor', 'david_atef', 'yaseminablacandir', 'c.a.stupka', 'amparo.castro.96', 'dhodapp', 'fkl217', 'farahsamir978', 'kie180039', 'atharva98', 'kph2', 'hafizmokh99', 'hilisa', 'kowjiajin', 'fred_dion', 'harshini9962', 'pvalladaresfdez', 'dancastaneda', 'jn1404', 'atx203', 'ammareltalli', 'amani12345', 'aaq', 'ledicia97', 'adriangarea', 'onaam8', 'zehuahe2', 'siemprewowthechami', 'justin.lariviere.25', 'tbryan', 'ludovick.begin', 'tss3', 'david2397', 'tmi211', 'physquig', 'zakhwan7', 'mallen22', 'amr_ua07', 'fcfrancapra94', 'cristinacigarran', 'vanesagarcia', 'adnanyuceer', 'fathy1104', 'perezsarmar', 'al4995', 'melroy_caeiro', 'helenalecoq97', 'caglanlee', 'afeefz', 'jpmcgee98', 'ales.gajdacz', 'masitadonmez', 'gemma', 'hmoulvi1', 'elad.d', 'xxlilmontysignxx', 'farah26', 'latecnologiameodia', 'abdulrahim2905', 'exjamil', 'vickytubio', 'ozgurkablan26', 'lderemo', 'ankit6257', 'javierisma98', 'redzuan11', 'yeejou990318', 'david.garrido', 'adarsh123', 'rileyroca', 'movi205', 'acregodean', 'pablosaavedra', 'maramtarek53', 's_coriolis', 'kakmeera1999', 'josepazmartin', 'travisc2', 'electronica18', 'kie180702', 'bhliu97', 'ematson5897', 'ashutoshsinghhenry6', 'martin32', 'maniphysics09', 'eduard25252598', 'moh.ashraf105', 'pablobou4', 'khazanv2', 'ahchehyan', 'ramonruiz.infor', 'brannon44', 'scremin', 'aasifhameed99', 'wahidiah52', 'm939454', 'aboone06', 'bluelobster', 'gabrielyii99', 'veronica.mieites', 'jinwoo2', 'syin4', 'diamond92', 'bflores18', 'njgale01', 'mgk816', 'dkshelat']",1,['wafikamarudin'],393,"['miri23', 'mohamedsameh', 'reemali99_', 'gc_1', 'kerryreto', 'zikrizaki88995', 'je_guilbert', 'jorgecastelo5', 'spazos7', 'soccadelic44', 'ahern0722', 'benoiturcotte', 'noureldin1999', 'alberfn', 'guttsfulltyagi', 'mavanzato0418', 'rkchapman', 'guibill10', 'ari6nd', 'michael2010814', 'happyleexin', 'omardeyaa', 'hong_gao', 'irenehb92', 'sandrabashara', 'nihatyavuz', 'akozych2', 'vikazvereva', 'danielfernandezcalo', 'anthonyroux', 'arrow823', 'aimansyaz99', 'annahaozheng0606', 'rocio', 'masonpb2', 'samashraf1', 'kirankumar94', 'prabuddha_888253127', 'carlosvigo1997', 'muvafikmelikkaya', 'amrebrahim', 'jtorres17', 'jzhan142', 'syedzakwan', 'samet1231234', 'kie180028', 'nadhnasorudin', 'avw2', 'ahmedsameh1698', 'acn562', 'moh.bahaa', 'arifjalani99', 'youssefsherif22', 'asyrafaqil', 'mjgebara14', 'camilolcastro97', 'bcperki2', 'azizijazam11', 'ahmedayman2370', 'rishu', 'ranasherif65', 'kyang37', 'nuanno97', 'smrdafdl', 'brknshn', 'jbaggie2019', 'youssef2042000', 'olivier.gilbert.paquet', 'saipraneett', 'prakharbhargava0', 'hf4', 'nadja1', 'teoster50', 'mohaballam', 'ryanorem', 'shradhap', 'va844', 'neuroque', 'seifhabib', 'anibarseghyan', 'williammitchell5818', 'pingan99', 'mjoza2', 'mariz', 'virajput299', 'bleuminuit', 'ffazul64', 'paul.aniruddha', 'melaniejkramer', 'oliviercharbonneau', 'ilou', 'chengweiheng', 'evrenyigit', 'emilechouinard', 'pythagoras2', 'kason.carroll', 'malgaca', 'kie180031', 'carlosvillar54', 'ckim123', 'kychui2', 'kanet1234', 'mohabayman', 'sanchjai', 'nbs691', 'oishikfaruque', 'lauragdevesa', 'nowapoca', 'ahagras13', 'akash140410107098', 'chithong', 'saharoaf', 'amni99', 'svo4321', 'lino13', 'vblanco.nico', 'aimanadnan', 'alidsjt', 'dlee145', 'stambo', 'lauramolinosmayo', 'mateocampos', 'hamidausat', 'yjenyiee155', 'retty8', 'sebasket14', 'marcmagdy98', 'janalorenzolumbreras', 'marianne.gratton.1', 'trkmengkay', 'shaf31', 'youxing0309', 'nourananwar123', 'puertarcd', 'felivitullo87', 'manuelsomoza94', 'alecorti.pardo', 'muteki', 'corredoira', 'gabrielyii', 'jinsup2', 'staceyn2', 'kaitlinh', 'cbecker413', 'adam562', 'haclarke', 'xosegq16', 'e1150590', 'kalebhilde', 'adriancheah', 'jaimefookinlannister', 'tonybocadillosgrandes', 'rooban11', 'wowmuchchuck', 'xunyong', 'hishamzakaria20', 'rxtodd', 'sarapl', 'alimatama', 'jahnavikachhia', 'alexisdixon6', 'saegner2', 'pranjal3', 'berkaydean', 'baleko12345', 'sparshagarwal1009', 'xyz11', 'david.peral.moran', 'tingliang', 'isabelmaria.vazquez', 'aishu98', 'nadanasser1199', 'desmondsoon', 'keerthisv', 'musabmalek0717', 'mcruces.fz', 'tuberkargan_97', 'worldlineusaf', 'sealseal', 'bharath3', 'cloudyoverhead', 'dhvanil', 'ramy_maged4', 'lsleed', 'zhixin2', 'sriharshap', 'tyy233', 'njs035', 'ablahsaoud', 'nolmos96', 'shorouk_ossama', 'kaustubh.shirpurkar', 'pedrosiaba', 'coderko3', 'alifzulkifli99', 'alancantu57', 'baohl2', 'mengkem2', 'selena', 'tdubnansky6', 'ypp200', 'aengm', 'kartal', 'jacquelinethardin', 'mohameeddsamy', 'jipiccardi', 'amlibrahim', 'rahimnoorj', 'dcpang2', 'tamchouweng', 'elizametias12', 'efrenhub', 'mrefaat', 'ethanmorse', 'taymacnichols', 'ryanboucher', 'kirolosehab99', 'carlosbesadaromero', 'ericrobles', 'janeneil88', 'gxiao2', 'kimzihuang', 'anxovidal8', 'damlakubattt', 'andreadiazgar', 'lukunze1', 'joker632455', 'shuming2', 'j.haliburton', 'abieday1704', 'ozbunar01', 'ugur.cankaya.3718', 'nihaosawaddee', 'magic_ocean99', 'sinasigurpinar', 'tuberkargan', 'jarodm2', 'nabilah1403', 'amiruldanial99', 'yansi', 'cheokonn', 'ammaralaa516', 'juanmacano97', 'maxernest', 'marcosanllo', 'viratbhatt007', 'facundovia', 'michaelsaldana1', 'kie180073', 'bassamtarek', 'abbesalaeddine', 'restep2', 'estebanrial', 'martinzapata', '46harunakgul', 'talwren', 'leejq', 'mohammedemadeldin2000', 'jeanmichael.deschenes', 'miloaismanis', 'mmartinezsanchez', 'emrebuyukkose2', 'luciano.brignone', 'anwar909', 'ahmedamr', 'omarmagdy', 'abdurrahmn13', 'nikalyaamani', 'sdehoyos47', 'apascao', 'yubai', 'vincentpainchaud.vp', 'nagihankececi', 'nazimmath3', 'apb5472', 'rikardberger', 'mr4425', 'jacobzeshleman', 'guoyao', 'kiruthikaabalu181996', 'ikhbal', 'michael.mechelay', 'khor', 'david_atef', 'yaseminablacandir', 'c.a.stupka', 'amparo.castro.96', 'dhodapp', 'fkl217', 'farahsamir978', 'kie180039', 'atharva98', 'kph2', 'hafizmokh99', 'hilisa', 'kowjiajin', 'fred_dion', 'harshini9962', 'pvalladaresfdez', 'dancastaneda', 'jn1404', 'atx203', 'ammareltalli', 'amani12345', 'aaq', 'ledicia97', 'adriangarea', 'onaam8', 'zehuahe2', 'siemprewowthechami', 'justin.lariviere.25', 'tbryan', 'ludovick.begin', 'tss3', 'david2397', 'tmi211', 'kie180079', 'physquig', 'zakhwan7', 'mallen22', 'amr_ua07', 'pip29', 'fcfrancapra94', 'cristinacigarran', 'vanesagarcia', 'adnanyuceer', 'fathy1104', 'perezsarmar', 'al4995', 'melroy_caeiro', 'helenalecoq97', 'caglanlee', 'afeefz', 'jpmcgee98', 'ales.gajdacz', 'masitadonmez', 'eddin21', 'gemma', 'hmoulvi1', 'elad.d', 'xxlilmontysignxx', 'farah26', 'latecnologiameodia', 'abdulrahim2905', 'exjamil', 'vickytubio', 'ozgurkablan26', 'lderemo', 'ankit6257', 'javierisma98', 'redzuan11', 'yeejou990318', 'david.garrido', 'adarsh123', 'rileyroca', 'movi205', 'acregodean', 'pablosaavedra', 'maramtarek53', 's_coriolis', 'kakmeera1999', 'josepazmartin', 'travisc2', 'electronica18', 'kie180702', 'bhliu97', 'ematson5897', 'ashutoshsinghhenry6', 'martin32', 'maniphysics09', 'eduard25252598', 'moh.ashraf105', 'pablobou4', 'khazanv2', 'wafikamarudin', 'ahchehyan', 'ramonruiz.infor', 'brannon44', 'scremin', 'aasifhameed99', 'wahidiah52', 'm939454', 'aboone06', 'bluelobster', 'gabrielyii99', 'veronica.mieites', 'jinwoo2', 'syin4', 'diamond92', 'bflores18', 'njgale01', 'mgk816', 'dkshelat']"
1,144,392,7,1,['nagihankececi'],391,"['miri23', 'mohamedsameh', 'reemali99_', 'gc_1', 'kerryreto', 'zikrizaki88995', 'je_guilbert', 'jorgecastelo5', 'spazos7', 'soccadelic44', 'ahern0722', 'benoiturcotte', 'noureldin1999', 'alberfn', 'guttsfulltyagi', 'mavanzato0418', 'rkchapman', 'guibill10', 'ari6nd', 'michael2010814', 'happyleexin', 'omardeyaa', 'hong_gao', 'irenehb92', 'sandrabashara', 'nihatyavuz', 'akozych2', 'vikazvereva', 'danielfernandezcalo', 'anthonyroux', 'arrow823', 'aimansyaz99', 'annahaozheng0606', 'rocio', 'masonpb2', 'samashraf1', 'kirankumar94', 'prabuddha_888253127', 'carlosvigo1997', 'muvafikmelikkaya', 'amrebrahim', 'jtorres17', 'jzhan142', 'syedzakwan', 'samet1231234', 'kie180028', 'nadhnasorudin', 'avw2', 'ahmedsameh1698', 'acn562', 'moh.bahaa', 'arifjalani99', 'youssefsherif22', 'asyrafaqil', 'mjgebara14', 'camilolcastro97', 'bcperki2', 'azizijazam11', 'ahmedayman2370', 'rishu', 'ranasherif65', 'kyang37', 'nuanno97', 'smrdafdl', 'brknshn', 'jbaggie2019', 'youssef2042000', 'olivier.gilbert.paquet', 'saipraneett', 'prakharbhargava0', 'hf4', 'nadja1', 'teoster50', 'mohaballam', 'ryanorem', 'shradhap', 'va844', 'neuroque', 'seifhabib', 'anibarseghyan', 'williammitchell5818', 'pingan99', 'mjoza2', 'mariz', 'virajput299', 'bleuminuit', 'ffazul64', 'paul.aniruddha', 'melaniejkramer', 'oliviercharbonneau', 'ilou', 'chengweiheng', 'evrenyigit', 'emilechouinard', 'pythagoras2', 'kason.carroll', 'malgaca', 'kie180031', 'carlosvillar54', 'ckim123', 'kychui2', 'kanet1234', 'mohabayman', 'sanchjai', 'nbs691', 'oishikfaruque', 'lauragdevesa', 'nowapoca', 'ahagras13', 'akash140410107098', 'chithong', 'saharoaf', 'amni99', 'svo4321', 'lino13', 'vblanco.nico', 'aimanadnan', 'alidsjt', 'dlee145', 'stambo', 'lauramolinosmayo', 'mateocampos', 'hamidausat', 'yjenyiee155', 'retty8', 'sebasket14', 'marcmagdy98', 'janalorenzolumbreras', 'marianne.gratton.1', 'trkmengkay', 'shaf31', 'youxing0309', 'nourananwar123', 'puertarcd', 'felivitullo87', 'manuelsomoza94', 'alecorti.pardo', 'muteki', 'corredoira', 'gabrielyii', 'jinsup2', 'staceyn2', 'kaitlinh', 'cbecker413', 'adam562', 'haclarke', 'xosegq16', 'e1150590', 'kalebhilde', 'adriancheah', 'jaimefookinlannister', 'tonybocadillosgrandes', 'rooban11', 'wowmuchchuck', 'xunyong', 'hishamzakaria20', 'rxtodd', 'sarapl', 'alimatama', 'jahnavikachhia', 'alexisdixon6', 'saegner2', 'pranjal3', 'berkaydean', 'baleko12345', 'sparshagarwal1009', 'xyz11', 'david.peral.moran', 'tingliang', 'isabelmaria.vazquez', 'aishu98', 'nadanasser1199', 'desmondsoon', 'keerthisv', 'musabmalek0717', 'mcruces.fz', 'tuberkargan_97', 'worldlineusaf', 'sealseal', 'bharath3', 'cloudyoverhead', 'dhvanil', 'ramy_maged4', 'lsleed', 'zhixin2', 'sriharshap', 'tyy233', 'njs035', 'ablahsaoud', 'nolmos96', 'shorouk_ossama', 'kaustubh.shirpurkar', 'pedrosiaba', 'coderko3', 'alifzulkifli99', 'alancantu57', 'baohl2', 'mengkem2', 'selena', 'tdubnansky6', 'ypp200', 'aengm', 'kartal', 'jacquelinethardin', 'mohameeddsamy', 'jipiccardi', 'amlibrahim', 'rahimnoorj', 'dcpang2', 'tamchouweng', 'elizametias12', 'efrenhub', 'mrefaat', 'ethanmorse', 'taymacnichols', 'ryanboucher', 'kirolosehab99', 'carlosbesadaromero', 'ericrobles', 'janeneil88', 'gxiao2', 'kimzihuang', 'anxovidal8', 'damlakubattt', 'andreadiazgar', 'lukunze1', 'joker632455', 'shuming2', 'j.haliburton', 'abieday1704', 'ozbunar01', 'ugur.cankaya.3718', 'nihaosawaddee', 'magic_ocean99', 'sinasigurpinar', 'tuberkargan', 'jarodm2', 'nabilah1403', 'amiruldanial99', 'yansi', 'cheokonn', 'ammaralaa516', 'juanmacano97', 'maxernest', 'marcosanllo', 'viratbhatt007', 'facundovia', 'michaelsaldana1', 'kie180073', 'bassamtarek', 'abbesalaeddine', 'restep2', 'estebanrial', 'martinzapata', '46harunakgul', 'talwren', 'leejq', 'mohammedemadeldin2000', 'jeanmichael.deschenes', 'miloaismanis', 'mmartinezsanchez', 'emrebuyukkose2', 'luciano.brignone', 'anwar909', 'ahmedamr', 'omarmagdy', 'abdurrahmn13', 'nikalyaamani', 'sdehoyos47', 'apascao', 'yubai', 'vincentpainchaud.vp', 'nazimmath3', 'apb5472', 'rikardberger', 'mr4425', 'jacobzeshleman', 'guoyao', 'kiruthikaabalu181996', 'ikhbal', 'michael.mechelay', 'khor', 'david_atef', 'yaseminablacandir', 'c.a.stupka', 'amparo.castro.96', 'dhodapp', 'fkl217', 'farahsamir978', 'kie180039', 'atharva98', 'kph2', 'hafizmokh99', 'hilisa', 'kowjiajin', 'fred_dion', 'harshini9962', 'pvalladaresfdez', 'dancastaneda', 'jn1404', 'atx203', 'ammareltalli', 'amani12345', 'aaq', 'ledicia97', 'adriangarea', 'onaam8', 'zehuahe2', 'siemprewowthechami', 'justin.lariviere.25', 'tbryan', 'ludovick.begin', 'tss3', 'david2397', 'tmi211', 'kie180079', 'physquig', 'zakhwan7', 'mallen22', 'amr_ua07', 'pip29', 'fcfrancapra94', 'cristinacigarran', 'vanesagarcia', 'adnanyuceer', 'fathy1104', 'perezsarmar', 'al4995', 'melroy_caeiro', 'helenalecoq97', 'caglanlee', 'afeefz', 'jpmcgee98', 'ales.gajdacz', 'masitadonmez', 'eddin21', 'gemma', 'hmoulvi1', 'elad.d', 'xxlilmontysignxx', 'farah26', 'latecnologiameodia', 'abdulrahim2905', 'exjamil', 'vickytubio', 'ozgurkablan26', 'lderemo', 'ankit6257', 'javierisma98', 'redzuan11', 'yeejou990318', 'david.garrido', 'adarsh123', 'rileyroca', 'movi205', 'acregodean', 'pablosaavedra', 'maramtarek53', 's_coriolis', 'kakmeera1999', 'josepazmartin', 'travisc2', 'electronica18', 'kie180702', 'bhliu97', 'ematson5897', 'ashutoshsinghhenry6', 'martin32', 'maniphysics09', 'eduard25252598', 'moh.ashraf105', 'pablobou4', 'khazanv2', 'ahchehyan', 'ramonruiz.infor', 'brannon44', 'scremin', 'aasifhameed99', 'wahidiah52', 'm939454', 'aboone06', 'bluelobster', 'gabrielyii99', 'veronica.mieites', 'jinwoo2', 'syin4', 'diamond92', 'bflores18', 'njgale01', 'mgk816', 'dkshelat']",6,"['mmert.bacak', 'elifisparta38', 'ulasgorcelioglu', 'nihansulukoy', 'yilmazberat1997', 'zubeydekal37']",398,"['miri23', 'mohamedsameh', 'reemali99_', 'gc_1', 'kerryreto', 'zikrizaki88995', 'je_guilbert', 'jorgecastelo5', 'spazos7', 'soccadelic44', 'ahern0722', 'benoiturcotte', 'noureldin1999', 'alberfn', 'guttsfulltyagi', 'mavanzato0418', 'rkchapman', 'guibill10', 'ari6nd', 'michael2010814', 'happyleexin', 'omardeyaa', 'hong_gao', 'irenehb92', 'sandrabashara', 'nihatyavuz', 'akozych2', 'vikazvereva', 'danielfernandezcalo', 'yilmazberat1997', 'anthonyroux', 'arrow823', 'aimansyaz99', 'annahaozheng0606', 'rocio', 'masonpb2', 'samashraf1', 'kirankumar94', 'prabuddha_888253127', 'carlosvigo1997', 'muvafikmelikkaya', 'amrebrahim', 'jtorres17', 'jzhan142', 'syedzakwan', 'samet1231234', 'kie180028', 'nadhnasorudin', 'avw2', 'ahmedsameh1698', 'acn562', 'moh.bahaa', 'arifjalani99', 'youssefsherif22', 'asyrafaqil', 'mjgebara14', 'camilolcastro97', 'bcperki2', 'azizijazam11', 'ahmedayman2370', 'rishu', 'ranasherif65', 'kyang37', 'nihansulukoy', 'nuanno97', 'smrdafdl', 'brknshn', 'jbaggie2019', 'youssef2042000', 'olivier.gilbert.paquet', 'saipraneett', 'prakharbhargava0', 'hf4', 'nadja1', 'teoster50', 'mohaballam', 'ryanorem', 'shradhap', 'va844', 'neuroque', 'ulasgorcelioglu', 'seifhabib', 'anibarseghyan', 'williammitchell5818', 'pingan99', 'mjoza2', 'mariz', 'virajput299', 'bleuminuit', 'ffazul64', 'paul.aniruddha', 'melaniejkramer', 'oliviercharbonneau', 'ilou', 'chengweiheng', 'evrenyigit', 'emilechouinard', 'pythagoras2', 'kason.carroll', 'zubeydekal37', 'malgaca', 'kie180031', 'carlosvillar54', 'ckim123', 'kychui2', 'kanet1234', 'mohabayman', 'sanchjai', 'nbs691', 'oishikfaruque', 'lauragdevesa', 'nowapoca', 'ahagras13', 'akash140410107098', 'chithong', 'saharoaf', 'amni99', 'svo4321', 'lino13', 'vblanco.nico', 'aimanadnan', 'alidsjt', 'dlee145', 'stambo', 'lauramolinosmayo', 'mateocampos', 'hamidausat', 'yjenyiee155', 'retty8', 'sebasket14', 'marcmagdy98', 'janalorenzolumbreras', 'marianne.gratton.1', 'trkmengkay', 'shaf31', 'youxing0309', 'nourananwar123', 'puertarcd', 'felivitullo87', 'manuelsomoza94', 'alecorti.pardo', 'muteki', 'corredoira', 'gabrielyii', 'elifisparta38', 'jinsup2', 'staceyn2', 'kaitlinh', 'cbecker413', 'adam562', 'haclarke', 'xosegq16', 'e1150590', 'kalebhilde', 'adriancheah', 'jaimefookinlannister', 'tonybocadillosgrandes', 'rooban11', 'wowmuchchuck', 'xunyong', 'hishamzakaria20', 'rxtodd', 'sarapl', 'alimatama', 'jahnavikachhia', 'alexisdixon6', 'saegner2', 'pranjal3', 'berkaydean', 'baleko12345', 'sparshagarwal1009', 'xyz11', 'david.peral.moran', 'tingliang', 'isabelmaria.vazquez', 'aishu98', 'nadanasser1199', 'desmondsoon', 'keerthisv', 'musabmalek0717', 'mcruces.fz', 'tuberkargan_97', 'worldlineusaf', 'sealseal', 'bharath3', 'cloudyoverhead', 'dhvanil', 'ramy_maged4', 'lsleed', 'zhixin2', 'sriharshap', 'tyy233', 'njs035', 'ablahsaoud', 'nolmos96', 'shorouk_ossama', 'kaustubh.shirpurkar', 'pedrosiaba', 'coderko3', 'alifzulkifli99', 'alancantu57', 'baohl2', 'mengkem2', 'selena', 'tdubnansky6', 'ypp200', 'aengm', 'kartal', 'jacquelinethardin', 'mohameeddsamy', 'jipiccardi', 'amlibrahim', 'rahimnoorj', 'dcpang2', 'tamchouweng', 'elizametias12', 'efrenhub', 'mrefaat', 'ethanmorse', 'taymacnichols', 'ryanboucher', 'kirolosehab99', 'carlosbesadaromero', 'ericrobles', 'janeneil88', 'gxiao2', 'kimzihuang', 'anxovidal8', 'damlakubattt', 'andreadiazgar', 'lukunze1', 'joker632455', 'shuming2', 'j.haliburton', 'abieday1704', 'ozbunar01', 'ugur.cankaya.3718', 'nihaosawaddee', 'magic_ocean99', 'sinasigurpinar', 'tuberkargan', 'jarodm2', 'nabilah1403', 'amiruldanial99', 'yansi', 'cheokonn', 'ammaralaa516', 'juanmacano97', 'maxernest', 'marcosanllo', 'viratbhatt007', 'facundovia', 'michaelsaldana1', 'kie180073', 'bassamtarek', 'abbesalaeddine', 'restep2', 'estebanrial', 'martinzapata', '46harunakgul', 'talwren', 'leejq', 'mohammedemadeldin2000', 'jeanmichael.deschenes', 'miloaismanis', 'mmartinezsanchez', 'emrebuyukkose2', 'luciano.brignone', 'anwar909', 'ahmedamr', 'omarmagdy', 'abdurrahmn13', 'nikalyaamani', 'sdehoyos47', 'apascao', 'yubai', 'vincentpainchaud.vp', 'nagihankececi', 'nazimmath3', 'apb5472', 'rikardberger', 'mr4425', 'jacobzeshleman', 'guoyao', 'kiruthikaabalu181996', 'ikhbal', 'michael.mechelay', 'khor', 'david_atef', 'yaseminablacandir', 'c.a.stupka', 'amparo.castro.96', 'dhodapp', 'fkl217', 'farahsamir978', 'kie180039', 'atharva98', 'kph2', 'hafizmokh99', 'hilisa', 'kowjiajin', 'fred_dion', 'harshini9962', 'pvalladaresfdez', 'dancastaneda', 'jn1404', 'atx203', 'ammareltalli', 'amani12345', 'aaq', 'ledicia97', 'adriangarea', 'onaam8', 'zehuahe2', 'siemprewowthechami', 'justin.lariviere.25', 'tbryan', 'ludovick.begin', 'tss3', 'david2397', 'tmi211', 'kie180079', 'physquig', 'zakhwan7', 'mallen22', 'amr_ua07', 'pip29', 'fcfrancapra94', 'mmert.bacak', 'cristinacigarran', 'vanesagarcia', 'adnanyuceer', 'fathy1104', 'perezsarmar', 'al4995', 'melroy_caeiro', 'helenalecoq97', 'caglanlee', 'afeefz', 'jpmcgee98', 'ales.gajdacz', 'masitadonmez', 'eddin21', 'gemma', 'hmoulvi1', 'elad.d', 'xxlilmontysignxx', 'farah26', 'latecnologiameodia', 'abdulrahim2905', 'exjamil', 'vickytubio', 'ozgurkablan26', 'lderemo', 'ankit6257', 'javierisma98', 'redzuan11', 'yeejou990318', 'david.garrido', 'adarsh123', 'rileyroca', 'movi205', 'acregodean', 'pablosaavedra', 'maramtarek53', 's_coriolis', 'kakmeera1999', 'josepazmartin', 'travisc2', 'electronica18', 'kie180702', 'bhliu97', 'ematson5897', 'ashutoshsinghhenry6', 'martin32', 'maniphysics09', 'eduard25252598', 'moh.ashraf105', 'pablobou4', 'khazanv2', 'ahchehyan', 'ramonruiz.infor', 'brannon44', 'scremin', 'aasifhameed99', 'wahidiah52', 'm939454', 'aboone06', 'bluelobster', 'gabrielyii99', 'veronica.mieites', 'jinwoo2', 'syin4', 'diamond92', 'bflores18', 'njgale01', 'mgk816', 'dkshelat']"
1,26,392,6,5,"['worldlineusaf', 'njgale01', 'rkchapman', 'stambo', 'taymacnichols']",387,"['miri23', 'mohamedsameh', 'reemali99_', 'gc_1', 'kerryreto', 'zikrizaki88995', 'je_guilbert', 'jorgecastelo5', 'spazos7', 'soccadelic44', 'ahern0722', 'benoiturcotte', 'noureldin1999', 'alberfn', 'guttsfulltyagi', 'mavanzato0418', 'guibill10', 'ari6nd', 'michael2010814', 'happyleexin', 'omardeyaa', 'hong_gao', 'irenehb92', 'sandrabashara', 'nihatyavuz', 'akozych2', 'vikazvereva', 'danielfernandezcalo', 'anthonyroux', 'arrow823', 'aimansyaz99', 'annahaozheng0606', 'rocio', 'masonpb2', 'samashraf1', 'kirankumar94', 'prabuddha_888253127', 'carlosvigo1997', 'muvafikmelikkaya', 'amrebrahim', 'jtorres17', 'jzhan142', 'syedzakwan', 'samet1231234', 'kie180028', 'nadhnasorudin', 'avw2', 'ahmedsameh1698', 'acn562', 'moh.bahaa', 'arifjalani99', 'youssefsherif22', 'asyrafaqil', 'mjgebara14', 'camilolcastro97', 'bcperki2', 'azizijazam11', 'ahmedayman2370', 'rishu', 'ranasherif65', 'kyang37', 'nuanno97', 'smrdafdl', 'brknshn', 'jbaggie2019', 'youssef2042000', 'olivier.gilbert.paquet', 'saipraneett', 'prakharbhargava0', 'hf4', 'nadja1', 'teoster50', 'mohaballam', 'ryanorem', 'shradhap', 'va844', 'neuroque', 'seifhabib', 'anibarseghyan', 'williammitchell5818', 'pingan99', 'mjoza2', 'mariz', 'virajput299', 'bleuminuit', 'ffazul64', 'paul.aniruddha', 'melaniejkramer', 'oliviercharbonneau', 'ilou', 'chengweiheng', 'evrenyigit', 'emilechouinard', 'pythagoras2', 'kason.carroll', 'malgaca', 'kie180031', 'carlosvillar54', 'ckim123', 'kychui2', 'kanet1234', 'mohabayman', 'sanchjai', 'nbs691', 'oishikfaruque', 'lauragdevesa', 'nowapoca', 'ahagras13', 'akash140410107098', 'chithong', 'saharoaf', 'amni99', 'svo4321', 'lino13', 'vblanco.nico', 'aimanadnan', 'alidsjt', 'dlee145', 'lauramolinosmayo', 'mateocampos', 'hamidausat', 'yjenyiee155', 'retty8', 'sebasket14', 'marcmagdy98', 'janalorenzolumbreras', 'marianne.gratton.1', 'trkmengkay', 'shaf31', 'youxing0309', 'nourananwar123', 'puertarcd', 'felivitullo87', 'manuelsomoza94', 'alecorti.pardo', 'muteki', 'corredoira', 'gabrielyii', 'jinsup2', 'staceyn2', 'kaitlinh', 'cbecker413', 'adam562', 'haclarke', 'xosegq16', 'e1150590', 'kalebhilde', 'adriancheah', 'jaimefookinlannister', 'tonybocadillosgrandes', 'rooban11', 'wowmuchchuck', 'xunyong', 'hishamzakaria20', 'rxtodd', 'sarapl', 'alimatama', 'jahnavikachhia', 'alexisdixon6', 'saegner2', 'pranjal3', 'berkaydean', 'baleko12345', 'sparshagarwal1009', 'xyz11', 'david.peral.moran', 'tingliang', 'isabelmaria.vazquez', 'aishu98', 'nadanasser1199', 'desmondsoon', 'keerthisv', 'musabmalek0717', 'mcruces.fz', 'tuberkargan_97', 'sealseal', 'bharath3', 'cloudyoverhead', 'dhvanil', 'ramy_maged4', 'lsleed', 'zhixin2', 'sriharshap', 'tyy233', 'njs035', 'ablahsaoud', 'nolmos96', 'shorouk_ossama', 'kaustubh.shirpurkar', 'pedrosiaba', 'coderko3', 'alifzulkifli99', 'alancantu57', 'baohl2', 'mengkem2', 'selena', 'tdubnansky6', 'ypp200', 'aengm', 'kartal', 'jacquelinethardin', 'mohameeddsamy', 'jipiccardi', 'amlibrahim', 'rahimnoorj', 'dcpang2', 'tamchouweng', 'elizametias12', 'efrenhub', 'mrefaat', 'ethanmorse', 'ryanboucher', 'kirolosehab99', 'carlosbesadaromero', 'ericrobles', 'janeneil88', 'gxiao2', 'kimzihuang', 'anxovidal8', 'damlakubattt', 'andreadiazgar', 'lukunze1', 'joker632455', 'shuming2', 'j.haliburton', 'abieday1704', 'ozbunar01', 'ugur.cankaya.3718', 'nihaosawaddee', 'magic_ocean99', 'sinasigurpinar', 'tuberkargan', 'jarodm2', 'nabilah1403', 'amiruldanial99', 'yansi', 'cheokonn', 'ammaralaa516', 'juanmacano97', 'maxernest', 'marcosanllo', 'viratbhatt007', 'facundovia', 'michaelsaldana1', 'kie180073', 'bassamtarek', 'abbesalaeddine', 'restep2', 'estebanrial', 'martinzapata', '46harunakgul', 'talwren', 'leejq', 'mohammedemadeldin2000', 'jeanmichael.deschenes', 'miloaismanis', 'mmartinezsanchez', 'emrebuyukkose2', 'luciano.brignone', 'anwar909', 'ahmedamr', 'omarmagdy', 'abdurrahmn13', 'nikalyaamani', 'sdehoyos47', 'apascao', 'yubai', 'vincentpainchaud.vp', 'nagihankececi', 'nazimmath3', 'apb5472', 'rikardberger', 'mr4425', 'jacobzeshleman', 'guoyao', 'kiruthikaabalu181996', 'ikhbal', 'michael.mechelay', 'khor', 'david_atef', 'yaseminablacandir', 'c.a.stupka', 'amparo.castro.96', 'dhodapp', 'fkl217', 'farahsamir978', 'kie180039', 'atharva98', 'kph2', 'hafizmokh99', 'hilisa', 'kowjiajin', 'fred_dion', 'harshini9962', 'pvalladaresfdez', 'dancastaneda', 'jn1404', 'atx203', 'ammareltalli', 'amani12345', 'aaq', 'ledicia97', 'adriangarea', 'onaam8', 'zehuahe2', 'siemprewowthechami', 'justin.lariviere.25', 'tbryan', 'ludovick.begin', 'tss3', 'david2397', 'tmi211', 'kie180079', 'physquig', 'zakhwan7', 'mallen22', 'amr_ua07', 'pip29', 'fcfrancapra94', 'cristinacigarran', 'vanesagarcia', 'adnanyuceer', 'fathy1104', 'perezsarmar', 'al4995', 'melroy_caeiro', 'helenalecoq97', 'caglanlee', 'afeefz', 'jpmcgee98', 'ales.gajdacz', 'masitadonmez', 'eddin21', 'gemma', 'hmoulvi1', 'elad.d', 'xxlilmontysignxx', 'farah26', 'latecnologiameodia', 'abdulrahim2905', 'exjamil', 'vickytubio', 'ozgurkablan26', 'lderemo', 'ankit6257', 'javierisma98', 'redzuan11', 'yeejou990318', 'david.garrido', 'adarsh123', 'rileyroca', 'movi205', 'acregodean', 'pablosaavedra', 'maramtarek53', 's_coriolis', 'kakmeera1999', 'josepazmartin', 'travisc2', 'electronica18', 'kie180702', 'bhliu97', 'ematson5897', 'ashutoshsinghhenry6', 'martin32', 'maniphysics09', 'eduard25252598', 'moh.ashraf105', 'pablobou4', 'khazanv2', 'ahchehyan', 'ramonruiz.infor', 'brannon44', 'scremin', 'aasifhameed99', 'wahidiah52', 'm939454', 'aboone06', 'bluelobster', 'gabrielyii99', 'veronica.mieites', 'jinwoo2', 'syin4', 'diamond92', 'bflores18', 'mgk816', 'dkshelat']",1,['jhendricks'],393,"['miri23', 'mohamedsameh', 'reemali99_', 'gc_1', 'kerryreto', 'zikrizaki88995', 'je_guilbert', 'jorgecastelo5', 'spazos7', 'soccadelic44', 'ahern0722', 'benoiturcotte', 'noureldin1999', 'alberfn', 'guttsfulltyagi', 'mavanzato0418', 'rkchapman', 'guibill10', 'ari6nd', 'michael2010814', 'happyleexin', 'omardeyaa', 'jhendricks', 'hong_gao', 'irenehb92', 'sandrabashara', 'nihatyavuz', 'akozych2', 'vikazvereva', 'danielfernandezcalo', 'anthonyroux', 'arrow823', 'aimansyaz99', 'annahaozheng0606', 'rocio', 'masonpb2', 'samashraf1', 'kirankumar94', 'prabuddha_888253127', 'carlosvigo1997', 'muvafikmelikkaya', 'amrebrahim', 'jtorres17', 'jzhan142', 'syedzakwan', 'samet1231234', 'kie180028', 'nadhnasorudin', 'avw2', 'ahmedsameh1698', 'acn562', 'moh.bahaa', 'arifjalani99', 'youssefsherif22', 'asyrafaqil', 'mjgebara14', 'camilolcastro97', 'bcperki2', 'azizijazam11', 'ahmedayman2370', 'rishu', 'ranasherif65', 'kyang37', 'nuanno97', 'smrdafdl', 'brknshn', 'jbaggie2019', 'youssef2042000', 'olivier.gilbert.paquet', 'saipraneett', 'prakharbhargava0', 'hf4', 'nadja1', 'teoster50', 'mohaballam', 'ryanorem', 'shradhap', 'va844', 'neuroque', 'seifhabib', 'anibarseghyan', 'williammitchell5818', 'pingan99', 'mjoza2', 'mariz', 'virajput299', 'bleuminuit', 'ffazul64', 'paul.aniruddha', 'melaniejkramer', 'oliviercharbonneau', 'ilou', 'chengweiheng', 'evrenyigit', 'emilechouinard', 'pythagoras2', 'kason.carroll', 'malgaca', 'kie180031', 'carlosvillar54', 'ckim123', 'kychui2', 'kanet1234', 'mohabayman', 'sanchjai', 'nbs691', 'oishikfaruque', 'lauragdevesa', 'nowapoca', 'ahagras13', 'akash140410107098', 'chithong', 'saharoaf', 'amni99', 'svo4321', 'lino13', 'vblanco.nico', 'aimanadnan', 'alidsjt', 'dlee145', 'stambo', 'lauramolinosmayo', 'mateocampos', 'hamidausat', 'yjenyiee155', 'retty8', 'sebasket14', 'marcmagdy98', 'janalorenzolumbreras', 'marianne.gratton.1', 'trkmengkay', 'shaf31', 'youxing0309', 'nourananwar123', 'puertarcd', 'felivitullo87', 'manuelsomoza94', 'alecorti.pardo', 'muteki', 'corredoira', 'gabrielyii', 'jinsup2', 'staceyn2', 'kaitlinh', 'cbecker413', 'adam562', 'haclarke', 'xosegq16', 'e1150590', 'kalebhilde', 'adriancheah', 'jaimefookinlannister', 'tonybocadillosgrandes', 'rooban11', 'wowmuchchuck', 'xunyong', 'hishamzakaria20', 'rxtodd', 'sarapl', 'alimatama', 'jahnavikachhia', 'alexisdixon6', 'saegner2', 'pranjal3', 'berkaydean', 'baleko12345', 'sparshagarwal1009', 'xyz11', 'david.peral.moran', 'tingliang', 'isabelmaria.vazquez', 'aishu98', 'nadanasser1199', 'desmondsoon', 'keerthisv', 'musabmalek0717', 'mcruces.fz', 'tuberkargan_97', 'worldlineusaf', 'sealseal', 'bharath3', 'cloudyoverhead', 'dhvanil', 'ramy_maged4', 'lsleed', 'zhixin2', 'sriharshap', 'tyy233', 'njs035', 'ablahsaoud', 'nolmos96', 'shorouk_ossama', 'kaustubh.shirpurkar', 'pedrosiaba', 'coderko3', 'alifzulkifli99', 'alancantu57', 'baohl2', 'mengkem2', 'selena', 'tdubnansky6', 'ypp200', 'aengm', 'kartal', 'jacquelinethardin', 'mohameeddsamy', 'jipiccardi', 'amlibrahim', 'rahimnoorj', 'dcpang2', 'tamchouweng', 'elizametias12', 'efrenhub', 'mrefaat', 'ethanmorse', 'taymacnichols', 'ryanboucher', 'kirolosehab99', 'carlosbesadaromero', 'ericrobles', 'janeneil88', 'gxiao2', 'kimzihuang', 'anxovidal8', 'damlakubattt', 'andreadiazgar', 'lukunze1', 'joker632455', 'shuming2', 'j.haliburton', 'abieday1704', 'ozbunar01', 'ugur.cankaya.3718', 'nihaosawaddee', 'magic_ocean99', 'sinasigurpinar', 'tuberkargan', 'jarodm2', 'nabilah1403', 'amiruldanial99', 'yansi', 'cheokonn', 'ammaralaa516', 'juanmacano97', 'maxernest', 'marcosanllo', 'viratbhatt007', 'facundovia', 'michaelsaldana1', 'kie180073', 'bassamtarek', 'abbesalaeddine', 'restep2', 'estebanrial', 'martinzapata', '46harunakgul', 'talwren', 'leejq', 'mohammedemadeldin2000', 'jeanmichael.deschenes', 'miloaismanis', 'mmartinezsanchez', 'emrebuyukkose2', 'luciano.brignone', 'anwar909', 'ahmedamr', 'omarmagdy', 'abdurrahmn13', 'nikalyaamani', 'sdehoyos47', 'apascao', 'yubai', 'vincentpainchaud.vp', 'nagihankececi', 'nazimmath3', 'apb5472', 'rikardberger', 'mr4425', 'jacobzeshleman', 'guoyao', 'kiruthikaabalu181996', 'ikhbal', 'michael.mechelay', 'khor', 'david_atef', 'yaseminablacandir', 'c.a.stupka', 'amparo.castro.96', 'dhodapp', 'fkl217', 'farahsamir978', 'kie180039', 'atharva98', 'kph2', 'hafizmokh99', 'hilisa', 'kowjiajin', 'fred_dion', 'harshini9962', 'pvalladaresfdez', 'dancastaneda', 'jn1404', 'atx203', 'ammareltalli', 'amani12345', 'aaq', 'ledicia97', 'adriangarea', 'onaam8', 'zehuahe2', 'siemprewowthechami', 'justin.lariviere.25', 'tbryan', 'ludovick.begin', 'tss3', 'david2397', 'tmi211', 'kie180079', 'physquig', 'zakhwan7', 'mallen22', 'amr_ua07', 'pip29', 'fcfrancapra94', 'cristinacigarran', 'vanesagarcia', 'adnanyuceer', 'fathy1104', 'perezsarmar', 'al4995', 'melroy_caeiro', 'helenalecoq97', 'caglanlee', 'afeefz', 'jpmcgee98', 'ales.gajdacz', 'masitadonmez', 'eddin21', 'gemma', 'hmoulvi1', 'elad.d', 'xxlilmontysignxx', 'farah26', 'latecnologiameodia', 'abdulrahim2905', 'exjamil', 'vickytubio', 'ozgurkablan26', 'lderemo', 'ankit6257', 'javierisma98', 'redzuan11', 'yeejou990318', 'david.garrido', 'adarsh123', 'rileyroca', 'movi205', 'acregodean', 'pablosaavedra', 'maramtarek53', 's_coriolis', 'kakmeera1999', 'josepazmartin', 'travisc2', 'electronica18', 'kie180702', 'bhliu97', 'ematson5897', 'ashutoshsinghhenry6', 'martin32', 'maniphysics09', 'eduard25252598', 'moh.ashraf105', 'pablobou4', 'khazanv2', 'ahchehyan', 'ramonruiz.infor', 'brannon44', 'scremin', 'aasifhameed99', 'wahidiah52', 'm939454', 'aboone06', 'bluelobster', 'gabrielyii99', 'veronica.mieites', 'jinwoo2', 'syin4', 'diamond92', 'bflores18', 'njgale01', 'mgk816', 'dkshelat']"
1,71,392,6,1,['zhixin2'],391,"['miri23', 'mohamedsameh', 'reemali99_', 'gc_1', 'kerryreto', 'zikrizaki88995', 'je_guilbert', 'jorgecastelo5', 'spazos7', 'soccadelic44', 'ahern0722', 'benoiturcotte', 'noureldin1999', 'alberfn', 'guttsfulltyagi', 'mavanzato0418', 'rkchapman', 'guibill10', 'ari6nd', 'michael2010814', 'happyleexin', 'omardeyaa', 'hong_gao', 'irenehb92', 'sandrabashara', 'nihatyavuz', 'akozych2', 'vikazvereva', 'danielfernandezcalo', 'anthonyroux', 'arrow823', 'aimansyaz99', 'annahaozheng0606', 'rocio', 'masonpb2', 'samashraf1', 'kirankumar94', 'prabuddha_888253127', 'carlosvigo1997', 'muvafikmelikkaya', 'amrebrahim', 'jtorres17', 'jzhan142', 'syedzakwan', 'samet1231234', 'kie180028', 'nadhnasorudin', 'avw2', 'ahmedsameh1698', 'acn562', 'moh.bahaa', 'arifjalani99', 'youssefsherif22', 'asyrafaqil', 'mjgebara14', 'camilolcastro97', 'bcperki2', 'azizijazam11', 'ahmedayman2370', 'rishu', 'ranasherif65', 'kyang37', 'nuanno97', 'smrdafdl', 'brknshn', 'jbaggie2019', 'youssef2042000', 'olivier.gilbert.paquet', 'saipraneett', 'prakharbhargava0', 'hf4', 'nadja1', 'teoster50', 'mohaballam', 'ryanorem', 'shradhap', 'va844', 'neuroque', 'seifhabib', 'anibarseghyan', 'williammitchell5818', 'pingan99', 'mjoza2', 'mariz', 'virajput299', 'bleuminuit', 'ffazul64', 'paul.aniruddha', 'melaniejkramer', 'oliviercharbonneau', 'ilou', 'chengweiheng', 'evrenyigit', 'emilechouinard', 'pythagoras2', 'kason.carroll', 'malgaca', 'kie180031', 'carlosvillar54', 'ckim123', 'kychui2', 'kanet1234', 'mohabayman', 'sanchjai', 'nbs691', 'oishikfaruque', 'lauragdevesa', 'nowapoca', 'ahagras13', 'akash140410107098', 'chithong', 'saharoaf', 'amni99', 'svo4321', 'lino13', 'vblanco.nico', 'aimanadnan', 'alidsjt', 'dlee145', 'stambo', 'lauramolinosmayo', 'mateocampos', 'hamidausat', 'yjenyiee155', 'retty8', 'sebasket14', 'marcmagdy98', 'janalorenzolumbreras', 'marianne.gratton.1', 'trkmengkay', 'shaf31', 'youxing0309', 'nourananwar123', 'puertarcd', 'felivitullo87', 'manuelsomoza94', 'alecorti.pardo', 'muteki', 'corredoira', 'gabrielyii', 'jinsup2', 'staceyn2', 'kaitlinh', 'cbecker413', 'adam562', 'haclarke', 'xosegq16', 'e1150590', 'kalebhilde', 'adriancheah', 'jaimefookinlannister', 'tonybocadillosgrandes', 'rooban11', 'wowmuchchuck', 'xunyong', 'hishamzakaria20', 'rxtodd', 'sarapl', 'alimatama', 'jahnavikachhia', 'alexisdixon6', 'saegner2', 'pranjal3', 'berkaydean', 'baleko12345', 'sparshagarwal1009', 'xyz11', 'david.peral.moran', 'tingliang', 'isabelmaria.vazquez', 'aishu98', 'nadanasser1199', 'desmondsoon', 'keerthisv', 'musabmalek0717', 'mcruces.fz', 'tuberkargan_97', 'worldlineusaf', 'sealseal', 'bharath3', 'cloudyoverhead', 'dhvanil', 'ramy_maged4', 'lsleed', 'sriharshap', 'tyy233', 'njs035', 'ablahsaoud', 'nolmos96', 'shorouk_ossama', 'kaustubh.shirpurkar', 'pedrosiaba', 'coderko3', 'alifzulkifli99', 'alancantu57', 'baohl2', 'mengkem2', 'selena', 'tdubnansky6', 'ypp200', 'aengm', 'kartal', 'jacquelinethardin', 'mohameeddsamy', 'jipiccardi', 'amlibrahim', 'rahimnoorj', 'dcpang2', 'tamchouweng', 'elizametias12', 'efrenhub', 'mrefaat', 'ethanmorse', 'taymacnichols', 'ryanboucher', 'kirolosehab99', 'carlosbesadaromero', 'ericrobles', 'janeneil88', 'gxiao2', 'kimzihuang', 'anxovidal8', 'damlakubattt', 'andreadiazgar', 'lukunze1', 'joker632455', 'shuming2', 'j.haliburton', 'abieday1704', 'ozbunar01', 'ugur.cankaya.3718', 'nihaosawaddee', 'magic_ocean99', 'sinasigurpinar', 'tuberkargan', 'jarodm2', 'nabilah1403', 'amiruldanial99', 'yansi', 'cheokonn', 'ammaralaa516', 'juanmacano97', 'maxernest', 'marcosanllo', 'viratbhatt007', 'facundovia', 'michaelsaldana1', 'kie180073', 'bassamtarek', 'abbesalaeddine', 'restep2', 'estebanrial', 'martinzapata', '46harunakgul', 'talwren', 'leejq', 'mohammedemadeldin2000', 'jeanmichael.deschenes', 'miloaismanis', 'mmartinezsanchez', 'emrebuyukkose2', 'luciano.brignone', 'anwar909', 'ahmedamr', 'omarmagdy', 'abdurrahmn13', 'nikalyaamani', 'sdehoyos47', 'apascao', 'yubai', 'vincentpainchaud.vp', 'nagihankececi', 'nazimmath3', 'apb5472', 'rikardberger', 'mr4425', 'jacobzeshleman', 'guoyao', 'kiruthikaabalu181996', 'ikhbal', 'michael.mechelay', 'khor', 'david_atef', 'yaseminablacandir', 'c.a.stupka', 'amparo.castro.96', 'dhodapp', 'fkl217', 'farahsamir978', 'kie180039', 'atharva98', 'kph2', 'hafizmokh99', 'hilisa', 'kowjiajin', 'fred_dion', 'harshini9962', 'pvalladaresfdez', 'dancastaneda', 'jn1404', 'atx203', 'ammareltalli', 'amani12345', 'aaq', 'ledicia97', 'adriangarea', 'onaam8', 'zehuahe2', 'siemprewowthechami', 'justin.lariviere.25', 'tbryan', 'ludovick.begin', 'tss3', 'david2397', 'tmi211', 'kie180079', 'physquig', 'zakhwan7', 'mallen22', 'amr_ua07', 'pip29', 'fcfrancapra94', 'cristinacigarran', 'vanesagarcia', 'adnanyuceer', 'fathy1104', 'perezsarmar', 'al4995', 'melroy_caeiro', 'helenalecoq97', 'caglanlee', 'afeefz', 'jpmcgee98', 'ales.gajdacz', 'masitadonmez', 'eddin21', 'gemma', 'hmoulvi1', 'elad.d', 'xxlilmontysignxx', 'farah26', 'latecnologiameodia', 'abdulrahim2905', 'exjamil', 'vickytubio', 'ozgurkablan26', 'lderemo', 'ankit6257', 'javierisma98', 'redzuan11', 'yeejou990318', 'david.garrido', 'adarsh123', 'rileyroca', 'movi205', 'acregodean', 'pablosaavedra', 'maramtarek53', 's_coriolis', 'kakmeera1999', 'josepazmartin', 'travisc2', 'electronica18', 'kie180702', 'bhliu97', 'ematson5897', 'ashutoshsinghhenry6', 'martin32', 'maniphysics09', 'eduard25252598', 'moh.ashraf105', 'pablobou4', 'khazanv2', 'ahchehyan', 'ramonruiz.infor', 'brannon44', 'scremin', 'aasifhameed99', 'wahidiah52', 'm939454', 'aboone06', 'bluelobster', 'gabrielyii99', 'veronica.mieites', 'jinwoo2', 'syin4', 'diamond92', 'bflores18', 'njgale01', 'mgk816', 'dkshelat']",5,"['ssengupta3', 'arehman4', 'chinmayanandadm', 'jaketh2', 'brokawat']",397,"['miri23', 'mohamedsameh', 'arehman4', 'reemali99_', 'gc_1', 'kerryreto', 'zikrizaki88995', 'je_guilbert', 'jorgecastelo5', 'spazos7', 'soccadelic44', 'ahern0722', 'benoiturcotte', 'noureldin1999', 'alberfn', 'guttsfulltyagi', 'mavanzato0418', 'rkchapman', 'guibill10', 'ari6nd', 'michael2010814', 'happyleexin', 'omardeyaa', 'hong_gao', 'irenehb92', 'sandrabashara', 'nihatyavuz', 'akozych2', 'vikazvereva', 'danielfernandezcalo', 'anthonyroux', 'arrow823', 'aimansyaz99', 'annahaozheng0606', 'rocio', 'masonpb2', 'samashraf1', 'kirankumar94', 'prabuddha_888253127', 'carlosvigo1997', 'muvafikmelikkaya', 'amrebrahim', 'jtorres17', 'jzhan142', 'syedzakwan', 'samet1231234', 'kie180028', 'nadhnasorudin', 'avw2', 'ahmedsameh1698', 'acn562', 'moh.bahaa', 'arifjalani99', 'youssefsherif22', 'asyrafaqil', 'mjgebara14', 'camilolcastro97', 'bcperki2', 'azizijazam11', 'ahmedayman2370', 'rishu', 'ranasherif65', 'kyang37', 'nuanno97', 'smrdafdl', 'brknshn', 'jbaggie2019', 'youssef2042000', 'olivier.gilbert.paquet', 'saipraneett', 'prakharbhargava0', 'hf4', 'nadja1', 'teoster50', 'mohaballam', 'ryanorem', 'shradhap', 'va844', 'neuroque', 'seifhabib', 'anibarseghyan', 'williammitchell5818', 'pingan99', 'mjoza2', 'mariz', 'virajput299', 'bleuminuit', 'ffazul64', 'paul.aniruddha', 'melaniejkramer', 'oliviercharbonneau', 'ilou', 'chengweiheng', 'evrenyigit', 'emilechouinard', 'pythagoras2', 'kason.carroll', 'malgaca', 'kie180031', 'carlosvillar54', 'ckim123', 'kychui2', 'kanet1234', 'mohabayman', 'sanchjai', 'nbs691', 'oishikfaruque', 'lauragdevesa', 'brokawat', 'nowapoca', 'ahagras13', 'akash140410107098', 'chithong', 'saharoaf', 'amni99', 'svo4321', 'lino13', 'vblanco.nico', 'aimanadnan', 'alidsjt', 'dlee145', 'stambo', 'lauramolinosmayo', 'mateocampos', 'hamidausat', 'yjenyiee155', 'retty8', 'sebasket14', 'marcmagdy98', 'janalorenzolumbreras', 'marianne.gratton.1', 'trkmengkay', 'shaf31', 'youxing0309', 'nourananwar123', 'puertarcd', 'felivitullo87', 'manuelsomoza94', 'alecorti.pardo', 'muteki', 'corredoira', 'gabrielyii', 'jinsup2', 'staceyn2', 'kaitlinh', 'cbecker413', 'adam562', 'haclarke', 'xosegq16', 'e1150590', 'kalebhilde', 'adriancheah', 'jaimefookinlannister', 'tonybocadillosgrandes', 'rooban11', 'wowmuchchuck', 'xunyong', 'hishamzakaria20', 'rxtodd', 'sarapl', 'alimatama', 'jahnavikachhia', 'alexisdixon6', 'saegner2', 'pranjal3', 'berkaydean', 'baleko12345', 'sparshagarwal1009', 'xyz11', 'david.peral.moran', 'tingliang', 'isabelmaria.vazquez', 'aishu98', 'nadanasser1199', 'desmondsoon', 'keerthisv', 'musabmalek0717', 'mcruces.fz', 'tuberkargan_97', 'worldlineusaf', 'sealseal', 'bharath3', 'cloudyoverhead', 'dhvanil', 'ramy_maged4', 'lsleed', 'zhixin2', 'sriharshap', 'tyy233', 'njs035', 'ablahsaoud', 'nolmos96', 'shorouk_ossama', 'kaustubh.shirpurkar', 'pedrosiaba', 'coderko3', 'alifzulkifli99', 'alancantu57', 'baohl2', 'mengkem2', 'selena', 'tdubnansky6', 'ypp200', 'aengm', 'kartal', 'jacquelinethardin', 'chinmayanandadm', 'mohameeddsamy', 'jipiccardi', 'amlibrahim', 'rahimnoorj', 'dcpang2', 'tamchouweng', 'elizametias12', 'efrenhub', 'mrefaat', 'ethanmorse', 'taymacnichols', 'ryanboucher', 'kirolosehab99', 'carlosbesadaromero', 'ericrobles', 'janeneil88', 'gxiao2', 'kimzihuang', 'anxovidal8', 'damlakubattt', 'andreadiazgar', 'lukunze1', 'joker632455', 'shuming2', 'j.haliburton', 'abieday1704', 'ozbunar01', 'ugur.cankaya.3718', 'nihaosawaddee', 'magic_ocean99', 'sinasigurpinar', 'tuberkargan', 'jarodm2', 'nabilah1403', 'amiruldanial99', 'yansi', 'cheokonn', 'ammaralaa516', 'juanmacano97', 'maxernest', 'marcosanllo', 'viratbhatt007', 'facundovia', 'michaelsaldana1', 'kie180073', 'ssengupta3', 'bassamtarek', 'abbesalaeddine', 'restep2', 'estebanrial', 'martinzapata', '46harunakgul', 'talwren', 'leejq', 'mohammedemadeldin2000', 'jeanmichael.deschenes', 'miloaismanis', 'mmartinezsanchez', 'emrebuyukkose2', 'luciano.brignone', 'anwar909', 'ahmedamr', 'omarmagdy', 'abdurrahmn13', 'nikalyaamani', 'sdehoyos47', 'apascao', 'yubai', 'vincentpainchaud.vp', 'nagihankececi', 'nazimmath3', 'apb5472', 'rikardberger', 'mr4425', 'jacobzeshleman', 'guoyao', 'kiruthikaabalu181996', 'ikhbal', 'michael.mechelay', 'khor', 'david_atef', 'yaseminablacandir', 'c.a.stupka', 'amparo.castro.96', 'dhodapp', 'fkl217', 'farahsamir978', 'kie180039', 'atharva98', 'kph2', 'hafizmokh99', 'hilisa', 'kowjiajin', 'fred_dion', 'harshini9962', 'pvalladaresfdez', 'dancastaneda', 'jn1404', 'atx203', 'ammareltalli', 'amani12345', 'aaq', 'ledicia97', 'adriangarea', 'onaam8', 'zehuahe2', 'siemprewowthechami', 'justin.lariviere.25', 'tbryan', 'ludovick.begin', 'tss3', 'david2397', 'tmi211', 'kie180079', 'physquig', 'zakhwan7', 'mallen22', 'amr_ua07', 'pip29', 'fcfrancapra94', 'cristinacigarran', 'vanesagarcia', 'adnanyuceer', 'jaketh2', 'fathy1104', 'perezsarmar', 'al4995', 'melroy_caeiro', 'helenalecoq97', 'caglanlee', 'afeefz', 'jpmcgee98', 'ales.gajdacz', 'masitadonmez', 'eddin21', 'gemma', 'hmoulvi1', 'elad.d', 'xxlilmontysignxx', 'farah26', 'latecnologiameodia', 'abdulrahim2905', 'exjamil', 'vickytubio', 'ozgurkablan26', 'lderemo', 'ankit6257', 'javierisma98', 'redzuan11', 'yeejou990318', 'david.garrido', 'adarsh123', 'rileyroca', 'movi205', 'acregodean', 'pablosaavedra', 'maramtarek53', 's_coriolis', 'kakmeera1999', 'josepazmartin', 'travisc2', 'electronica18', 'kie180702', 'bhliu97', 'ematson5897', 'ashutoshsinghhenry6', 'martin32', 'maniphysics09', 'eduard25252598', 'moh.ashraf105', 'pablobou4', 'khazanv2', 'ahchehyan', 'ramonruiz.infor', 'brannon44', 'scremin', 'aasifhameed99', 'wahidiah52', 'm939454', 'aboone06', 'bluelobster', 'gabrielyii99', 'veronica.mieites', 'jinwoo2', 'syin4', 'diamond92', 'bflores18', 'njgale01', 'mgk816', 'dkshelat']"
1,149,392,5,2,"['pvalladaresfdez', 'perezsarmar']",390,"['miri23', 'mohamedsameh', 'reemali99_', 'gc_1', 'kerryreto', 'zikrizaki88995', 'je_guilbert', 'jorgecastelo5', 'spazos7', 'soccadelic44', 'ahern0722', 'benoiturcotte', 'noureldin1999', 'alberfn', 'guttsfulltyagi', 'mavanzato0418', 'rkchapman', 'guibill10', 'ari6nd', 'michael2010814', 'happyleexin', 'omardeyaa', 'hong_gao', 'irenehb92', 'sandrabashara', 'nihatyavuz', 'akozych2', 'vikazvereva', 'danielfernandezcalo', 'anthonyroux', 'arrow823', 'aimansyaz99', 'annahaozheng0606', 'rocio', 'masonpb2', 'samashraf1', 'kirankumar94', 'prabuddha_888253127', 'carlosvigo1997', 'muvafikmelikkaya', 'amrebrahim', 'jtorres17', 'jzhan142', 'syedzakwan', 'samet1231234', 'kie180028', 'nadhnasorudin', 'avw2', 'ahmedsameh1698', 'acn562', 'moh.bahaa', 'arifjalani99', 'youssefsherif22', 'asyrafaqil', 'mjgebara14', 'camilolcastro97', 'bcperki2', 'azizijazam11', 'ahmedayman2370', 'rishu', 'ranasherif65', 'kyang37', 'nuanno97', 'smrdafdl', 'brknshn', 'jbaggie2019', 'youssef2042000', 'olivier.gilbert.paquet', 'saipraneett', 'prakharbhargava0', 'hf4', 'nadja1', 'teoster50', 'mohaballam', 'ryanorem', 'shradhap', 'va844', 'neuroque', 'seifhabib', 'anibarseghyan', 'williammitchell5818', 'pingan99', 'mjoza2', 'mariz', 'virajput299', 'bleuminuit', 'ffazul64', 'paul.aniruddha', 'melaniejkramer', 'oliviercharbonneau', 'ilou', 'chengweiheng', 'evrenyigit', 'emilechouinard', 'pythagoras2', 'kason.carroll', 'malgaca', 'kie180031', 'carlosvillar54', 'ckim123', 'kychui2', 'kanet1234', 'mohabayman', 'sanchjai', 'nbs691', 'oishikfaruque', 'lauragdevesa', 'nowapoca', 'ahagras13', 'akash140410107098', 'chithong', 'saharoaf', 'amni99', 'svo4321', 'lino13', 'vblanco.nico', 'aimanadnan', 'alidsjt', 'dlee145', 'stambo', 'lauramolinosmayo', 'mateocampos', 'hamidausat', 'yjenyiee155', 'retty8', 'sebasket14', 'marcmagdy98', 'janalorenzolumbreras', 'marianne.gratton.1', 'trkmengkay', 'shaf31', 'youxing0309', 'nourananwar123', 'puertarcd', 'felivitullo87', 'manuelsomoza94', 'alecorti.pardo', 'muteki', 'corredoira', 'gabrielyii', 'jinsup2', 'staceyn2', 'kaitlinh', 'cbecker413', 'adam562', 'haclarke', 'xosegq16', 'e1150590', 'kalebhilde', 'adriancheah', 'jaimefookinlannister', 'tonybocadillosgrandes', 'rooban11', 'wowmuchchuck', 'xunyong', 'hishamzakaria20', 'rxtodd', 'sarapl', 'alimatama', 'jahnavikachhia', 'alexisdixon6', 'saegner2', 'pranjal3', 'berkaydean', 'baleko12345', 'sparshagarwal1009', 'xyz11', 'david.peral.moran', 'tingliang', 'isabelmaria.vazquez', 'aishu98', 'nadanasser1199', 'desmondsoon', 'keerthisv', 'musabmalek0717', 'mcruces.fz', 'tuberkargan_97', 'worldlineusaf', 'sealseal', 'bharath3', 'cloudyoverhead', 'dhvanil', 'ramy_maged4', 'lsleed', 'zhixin2', 'sriharshap', 'tyy233', 'njs035', 'ablahsaoud', 'nolmos96', 'shorouk_ossama', 'kaustubh.shirpurkar', 'pedrosiaba', 'coderko3', 'alifzulkifli99', 'alancantu57', 'baohl2', 'mengkem2', 'selena', 'tdubnansky6', 'ypp200', 'aengm', 'kartal', 'jacquelinethardin', 'mohameeddsamy', 'jipiccardi', 'amlibrahim', 'rahimnoorj', 'dcpang2', 'tamchouweng', 'elizametias12', 'efrenhub', 'mrefaat', 'ethanmorse', 'taymacnichols', 'ryanboucher', 'kirolosehab99', 'carlosbesadaromero', 'ericrobles', 'janeneil88', 'gxiao2', 'kimzihuang', 'anxovidal8', 'damlakubattt', 'andreadiazgar', 'lukunze1', 'joker632455', 'shuming2', 'j.haliburton', 'abieday1704', 'ozbunar01', 'ugur.cankaya.3718', 'nihaosawaddee', 'magic_ocean99', 'sinasigurpinar', 'tuberkargan', 'jarodm2', 'nabilah1403', 'amiruldanial99', 'yansi', 'cheokonn', 'ammaralaa516', 'juanmacano97', 'maxernest', 'marcosanllo', 'viratbhatt007', 'facundovia', 'michaelsaldana1', 'kie180073', 'bassamtarek', 'abbesalaeddine', 'restep2', 'estebanrial', 'martinzapata', '46harunakgul', 'talwren', 'leejq', 'mohammedemadeldin2000', 'jeanmichael.deschenes', 'miloaismanis', 'mmartinezsanchez', 'emrebuyukkose2', 'luciano.brignone', 'anwar909', 'ahmedamr', 'omarmagdy', 'abdurrahmn13', 'nikalyaamani', 'sdehoyos47', 'apascao', 'yubai', 'vincentpainchaud.vp', 'nagihankececi', 'nazimmath3', 'apb5472', 'rikardberger', 'mr4425', 'jacobzeshleman', 'guoyao', 'kiruthikaabalu181996', 'ikhbal', 'michael.mechelay', 'khor', 'david_atef', 'yaseminablacandir', 'c.a.stupka', 'amparo.castro.96', 'dhodapp', 'fkl217', 'farahsamir978', 'kie180039', 'atharva98', 'kph2', 'hafizmokh99', 'hilisa', 'kowjiajin', 'fred_dion', 'harshini9962', 'dancastaneda', 'jn1404', 'atx203', 'ammareltalli', 'amani12345', 'aaq', 'ledicia97', 'adriangarea', 'onaam8', 'zehuahe2', 'siemprewowthechami', 'justin.lariviere.25', 'tbryan', 'ludovick.begin', 'tss3', 'david2397', 'tmi211', 'kie180079', 'physquig', 'zakhwan7', 'mallen22', 'amr_ua07', 'pip29', 'fcfrancapra94', 'cristinacigarran', 'vanesagarcia', 'adnanyuceer', 'fathy1104', 'al4995', 'melroy_caeiro', 'helenalecoq97', 'caglanlee', 'afeefz', 'jpmcgee98', 'ales.gajdacz', 'masitadonmez', 'eddin21', 'gemma', 'hmoulvi1', 'elad.d', 'xxlilmontysignxx', 'farah26', 'latecnologiameodia', 'abdulrahim2905', 'exjamil', 'vickytubio', 'ozgurkablan26', 'lderemo', 'ankit6257', 'javierisma98', 'redzuan11', 'yeejou990318', 'david.garrido', 'adarsh123', 'rileyroca', 'movi205', 'acregodean', 'pablosaavedra', 'maramtarek53', 's_coriolis', 'kakmeera1999', 'josepazmartin', 'travisc2', 'electronica18', 'kie180702', 'bhliu97', 'ematson5897', 'ashutoshsinghhenry6', 'martin32', 'maniphysics09', 'eduard25252598', 'moh.ashraf105', 'pablobou4', 'khazanv2', 'ahchehyan', 'ramonruiz.infor', 'brannon44', 'scremin', 'aasifhameed99', 'wahidiah52', 'm939454', 'aboone06', 'bluelobster', 'gabrielyii99', 'veronica.mieites', 'jinwoo2', 'syin4', 'diamond92', 'bflores18', 'njgale01', 'mgk816', 'dkshelat']",3,"['aronchino6', 'paularodriguez', 'gombut']",395,"['miri23', 'mohamedsameh', 'reemali99_', 'gc_1', 'kerryreto', 'zikrizaki88995', 'je_guilbert', 'jorgecastelo5', 'spazos7', 'soccadelic44', 'ahern0722', 'benoiturcotte', 'noureldin1999', 'alberfn', 'guttsfulltyagi', 'mavanzato0418', 'rkchapman', 'guibill10', 'ari6nd', 'michael2010814', 'happyleexin', 'omardeyaa', 'hong_gao', 'irenehb92', 'sandrabashara', 'nihatyavuz', 'akozych2', 'vikazvereva', 'danielfernandezcalo', 'anthonyroux', 'arrow823', 'aimansyaz99', 'annahaozheng0606', 'rocio', 'masonpb2', 'samashraf1', 'kirankumar94', 'prabuddha_888253127', 'carlosvigo1997', 'muvafikmelikkaya', 'amrebrahim', 'jtorres17', 'jzhan142', 'syedzakwan', 'samet1231234', 'kie180028', 'nadhnasorudin', 'avw2', 'ahmedsameh1698', 'acn562', 'moh.bahaa', 'arifjalani99', 'youssefsherif22', 'asyrafaqil', 'mjgebara14', 'camilolcastro97', 'bcperki2', 'azizijazam11', 'ahmedayman2370', 'rishu', 'ranasherif65', 'kyang37', 'nuanno97', 'smrdafdl', 'brknshn', 'jbaggie2019', 'youssef2042000', 'olivier.gilbert.paquet', 'saipraneett', 'prakharbhargava0', 'hf4', 'nadja1', 'teoster50', 'mohaballam', 'ryanorem', 'shradhap', 'va844', 'neuroque', 'seifhabib', 'anibarseghyan', 'williammitchell5818', 'pingan99', 'mjoza2', 'mariz', 'virajput299', 'bleuminuit', 'ffazul64', 'paul.aniruddha', 'melaniejkramer', 'oliviercharbonneau', 'ilou', 'chengweiheng', 'evrenyigit', 'emilechouinard', 'pythagoras2', 'kason.carroll', 'malgaca', 'kie180031', 'carlosvillar54', 'ckim123', 'kychui2', 'kanet1234', 'mohabayman', 'sanchjai', 'nbs691', 'oishikfaruque', 'lauragdevesa', 'nowapoca', 'ahagras13', 'akash140410107098', 'chithong', 'saharoaf', 'amni99', 'svo4321', 'lino13', 'vblanco.nico', 'aimanadnan', 'alidsjt', 'dlee145', 'stambo', 'lauramolinosmayo', 'mateocampos', 'hamidausat', 'yjenyiee155', 'retty8', 'sebasket14', 'marcmagdy98', 'janalorenzolumbreras', 'marianne.gratton.1', 'trkmengkay', 'shaf31', 'youxing0309', 'nourananwar123', 'puertarcd', 'felivitullo87', 'manuelsomoza94', 'alecorti.pardo', 'muteki', 'corredoira', 'gabrielyii', 'jinsup2', 'staceyn2', 'kaitlinh', 'cbecker413', 'adam562', 'haclarke', 'xosegq16', 'e1150590', 'kalebhilde', 'adriancheah', 'jaimefookinlannister', 'tonybocadillosgrandes', 'rooban11', 'wowmuchchuck', 'xunyong', 'hishamzakaria20', 'rxtodd', 'sarapl', 'alimatama', 'jahnavikachhia', 'alexisdixon6', 'saegner2', 'pranjal3', 'berkaydean', 'baleko12345', 'sparshagarwal1009', 'xyz11', 'david.peral.moran', 'tingliang', 'isabelmaria.vazquez', 'aishu98', 'nadanasser1199', 'desmondsoon', 'keerthisv', 'musabmalek0717', 'mcruces.fz', 'tuberkargan_97', 'worldlineusaf', 'sealseal', 'bharath3', 'cloudyoverhead', 'dhvanil', 'ramy_maged4', 'lsleed', 'zhixin2', 'sriharshap', 'tyy233', 'njs035', 'ablahsaoud', 'nolmos96', 'shorouk_ossama', 'kaustubh.shirpurkar', 'pedrosiaba', 'coderko3', 'alifzulkifli99', 'alancantu57', 'baohl2', 'mengkem2', 'paularodriguez', 'selena', 'tdubnansky6', 'ypp200', 'aengm', 'kartal', 'jacquelinethardin', 'mohameeddsamy', 'jipiccardi', 'amlibrahim', 'rahimnoorj', 'dcpang2', 'tamchouweng', 'elizametias12', 'efrenhub', 'mrefaat', 'ethanmorse', 'taymacnichols', 'ryanboucher', 'kirolosehab99', 'carlosbesadaromero', 'aronchino6', 'ericrobles', 'janeneil88', 'gxiao2', 'kimzihuang', 'anxovidal8', 'damlakubattt', 'andreadiazgar', 'lukunze1', 'joker632455', 'shuming2', 'j.haliburton', 'abieday1704', 'ozbunar01', 'ugur.cankaya.3718', 'nihaosawaddee', 'magic_ocean99', 'sinasigurpinar', 'tuberkargan', 'jarodm2', 'nabilah1403', 'amiruldanial99', 'yansi', 'cheokonn', 'ammaralaa516', 'juanmacano97', 'maxernest', 'marcosanllo', 'viratbhatt007', 'facundovia', 'michaelsaldana1', 'kie180073', 'bassamtarek', 'abbesalaeddine', 'restep2', 'estebanrial', 'martinzapata', '46harunakgul', 'talwren', 'leejq', 'mohammedemadeldin2000', 'jeanmichael.deschenes', 'miloaismanis', 'mmartinezsanchez', 'emrebuyukkose2', 'luciano.brignone', 'anwar909', 'ahmedamr', 'omarmagdy', 'abdurrahmn13', 'nikalyaamani', 'sdehoyos47', 'apascao', 'yubai', 'vincentpainchaud.vp', 'nagihankececi', 'nazimmath3', 'apb5472', 'rikardberger', 'mr4425', 'jacobzeshleman', 'guoyao', 'kiruthikaabalu181996', 'ikhbal', 'michael.mechelay', 'khor', 'david_atef', 'yaseminablacandir', 'c.a.stupka', 'amparo.castro.96', 'dhodapp', 'fkl217', 'farahsamir978', 'kie180039', 'atharva98', 'kph2', 'hafizmokh99', 'hilisa', 'kowjiajin', 'fred_dion', 'harshini9962', 'pvalladaresfdez', 'dancastaneda', 'jn1404', 'atx203', 'ammareltalli', 'amani12345', 'aaq', 'ledicia97', 'adriangarea', 'onaam8', 'zehuahe2', 'siemprewowthechami', 'justin.lariviere.25', 'tbryan', 'ludovick.begin', 'tss3', 'david2397', 'tmi211', 'kie180079', 'physquig', 'zakhwan7', 'mallen22', 'amr_ua07', 'pip29', 'fcfrancapra94', 'cristinacigarran', 'vanesagarcia', 'adnanyuceer', 'fathy1104', 'perezsarmar', 'al4995', 'melroy_caeiro', 'helenalecoq97', 'caglanlee', 'afeefz', 'jpmcgee98', 'ales.gajdacz', 'masitadonmez', 'eddin21', 'gemma', 'hmoulvi1', 'gombut', 'elad.d', 'xxlilmontysignxx', 'farah26', 'latecnologiameodia', 'abdulrahim2905', 'exjamil', 'vickytubio', 'ozgurkablan26', 'lderemo', 'ankit6257', 'javierisma98', 'redzuan11', 'yeejou990318', 'david.garrido', 'adarsh123', 'rileyroca', 'movi205', 'acregodean', 'pablosaavedra', 'maramtarek53', 's_coriolis', 'kakmeera1999', 'josepazmartin', 'travisc2', 'electronica18', 'kie180702', 'bhliu97', 'ematson5897', 'ashutoshsinghhenry6', 'martin32', 'maniphysics09', 'eduard25252598', 'moh.ashraf105', 'pablobou4', 'khazanv2', 'ahchehyan', 'ramonruiz.infor', 'brannon44', 'scremin', 'aasifhameed99', 'wahidiah52', 'm939454', 'aboone06', 'bluelobster', 'gabrielyii99', 'veronica.mieites', 'jinwoo2', 'syin4', 'diamond92', 'bflores18', 'njgale01', 'mgk816', 'dkshelat']"
2,52,177,125,83,"['ryry1644', 'evdaly', 'lee2370', 'mingusnate', 'hess35', 'cmelchin', 'nathanmoore', 'oliver67', 'akonopa', 'lmeehann', 'rileyedelaney', 'talon34567', 'khageman', 'ebehring', 'cartmaster007', 'kskripakaran0810', 'charlesma423', 'joshuajkporter', 'suhaira97', 'jacobglvn', 'dschull', 'bsmrdel', 'albrect', 'mcrees', 'acostab', 'rao53', 'dgreiwe', 'kknowlto', 'heinzt', 'kico', 'ggauthi', 'wstolz', 'george7elias', 'yang1206', 'vpope', 'nikhilcarneiro4', 'asartor', 'zjohnson834', 'yeager5', 'kruege14', 'jfolkers', 'btestin14', 'tilley0', 'itsmemario', 'fischermben', 'angbecker', 'kjh94425', 'rishiprasadha', 'singh378', 'maxwellfra16', 'goh5', 'shadow66666', 'chiranth7954', 'conner.swift8', 'boninim', 'ggolla', 'jdanek', 'rhellyer', 'rsusler', 'mccaul', 'jkekre', 'nhdorcy', 'garret28', 'anthonm', 'landon.glunt', 'ryanwest1040', 'ikobayas', 'kgmcginley', 'srasche', 'hyndmanjustin', 'justj', 'crhodine', 'tgiazzon', 'geyerg', 'jskeens', 'cclapham', 'akreuter', 'john1886', 'suran9712', 'sknecht', 'dsfgdsfg', 'mcclure8', 'nt230']",94,"['xy.sean.liu', 'munselltom', 'smanspencer', 'ebergqu', 'buck17', 'lsailor', 'taylo620', 'jmojazza', 'robo698', 'ellis71', 'cputt', 'reddy37', 'simekc', 'kirchhof', 'cameronfritts12', 'hkohart', 'ggoldate', 'lrussell71', 'thedhowithpants', 'jbartlin', 'mishra59', 'manjaekim96', 'dodge4', 'eiglehar', 'claszlo', 'enadler', 'bkiep', 'ling36', 'emcdonn', 'nbitner', 'lakmanligil', 'swttprsjtu', 'imran3', 'mart1226', 'benoit1', 'jmacklem', 'ayermemb', 'lesteryhz', 'jswetlik', 'jaggarw', 'snowh5696', 'jschorfh', 'hdeboer00', 'baker428', 'semond', 'scoan', 'mnishat', 'fahughes1999', 'peter411', 'herr13', 'cmeiste', 'evandaele3', 'guenthee2020', 'aratkov', 'wang4150', 'wbaioni', 'sahilshah16', 'mitchpohlman', 'rodri454', 'jklaben', 'vcotta', 'yhoashi', 'kentoneriksen', 'mlinsin', 'treyfinn98', 'alyssamcnarney', 'osborn45', 'nstreb', 'hungergame34', 'cho246', 'graha167', 'canadaman87', 'mengelh', 'tanderto', 'bean16', 'fvora', 'bihmike', 'finn5', 'isaaclandstoffer', 'sweis97', 'alexdobbins98', 'skantawa', 'ryan.wiebe', 'deyu23huang', 'rjleach', 'mikecpmonkey77', 'nggoodie98', 'alineelquist', 'jstalbaum', 'ashleydavis', 'tobitrack55', 'snead', 'hkaakeh', 'lise_lpz']",42,"['mcdona85', 'smit3180', 'radhakr3', 'purduechen2203', 'samm', 'caldwe29', 'cpiepen', 'sueprasad8214', 'dkilgor', 'afalkenb', 'rao75', 'nramli', 'arturotrevino', 'tthieles', 'rwiebe', 'starr21', 'huan1146', 'aguyre', 'jwoon', 'jkueche', 'vwallema', 'psumner', 'river132', 'athoman', 'eforti', 'wan52', 'xng', 'yizhizhang', 'kevinodonnell0878', 'nafandi', 'cbischof', 'shaw108', 'agalema1027', 'selawada', 'amckeska', 'davids19', 'muelle77', 'jrohman', 'akreilei', 'ehonebri', 'chanwoo.lee.17', 'ecronin']",219,"['xy.sean.liu', 'mcdona85', 'radhakr3', 'purduechen2203', 'ryry1644', 'samm', 'evdaly', 'dkilgor', 'munselltom', 'afalkenb', 'smanspencer', 'mingusnate', 'ebergqu', 'lee2370', 'buck17', 'hess35', 'lsailor', 'taylo620', 'cmelchin', 'nathanmoore', 'oliver67', 'lmeehann', 'akonopa', 'starr21', 'jwoon', 'jmojazza', 'ellis71', 'robo698', 'cputt', 'reddy37', 'rileyedelaney', 'talon34567', 'simekc', 'river132', 'wan52', 'kirchhof', 'kevinodonnell0878', 'cameronfritts12', 'khageman', 'hkohart', 'ebehring', 'cartmaster007', 'ggoldate', 'lrussell71', 'selawada', 'kskripakaran0810', 'thedhowithpants', 'jbartlin', 'charlesma423', 'joshuajkporter', 'mishra59', 'muelle77', 'manjaekim96', 'ehonebri', 'dodge4', 'eiglehar', 'suhaira97', 'jacobglvn', 'claszlo', 'enadler', 'dschull', 'bkiep', 'albrect', 'bsmrdel', 'nramli', 'ling36', 'mcrees', 'acostab', 'emcdonn', 'nbitner', 'rao53', 'tthieles', 'dgreiwe', 'kknowlto', 'lakmanligil', 'rwiebe', 'swttprsjtu', 'heinzt', 'imran3', 'kico', 'ggauthi', 'mart1226', 'benoit1', 'ayermemb', 'wstolz', 'george7elias', 'jmacklem', 'yang1206', 'jkueche', 'vwallema', 'nafandi', 'lesteryhz', 'vpope', 'jswetlik', 'jaggarw', 'nikhilcarneiro4', 'snowh5696', 'jschorfh', 'hdeboer00', 'baker428', 'asartor', 'semond', 'zjohnson834', 'scoan', 'davids19', 'mnishat', 'fahughes1999', 'akreilei', 'yeager5', 'kruege14', 'chanwoo.lee.17', 'jfolkers', 'peter411', 'btestin14', 'smit3180', 'herr13', 'tilley0', 'cmeiste', 'itsmemario', 'evandaele3', 'cpiepen', 'fischermben', 'guenthee2020', 'angbecker', 'arturotrevino', 'aratkov', 'wang4150', 'wbaioni', 'sahilshah16', 'mitchpohlman', 'rodri454', 'jklaben', 'vcotta', 'yhoashi', 'kjh94425', 'aguyre', 'kentoneriksen', 'rishiprasadha', 'singh378', 'maxwellfra16', 'treyfinn98', 'mlinsin', 'goh5', 'alyssamcnarney', 'athoman', 'shadow66666', 'chiranth7954', 'conner.swift8', 'boninim', 'xng', 'cbischof', 'ggolla', 'osborn45', 'nstreb', 'jdanek', 'hungergame34', 'cho246', 'graha167', 'shaw108', 'rhellyer', 'canadaman87', 'rsusler', 'agalema1027', 'mengelh', 'tanderto', 'jrohman', 'bean16', 'mccaul', 'jkekre', 'ecronin', 'nhdorcy', 'garret28', 'caldwe29', 'landon.glunt', 'anthonm', 'sueprasad8214', 'fvora', 'bihmike', 'rao75', 'finn5', 'ryanwest1040', 'ikobayas', 'isaaclandstoffer', 'sweis97', 'kgmcginley', 'srasche', 'hyndmanjustin', 'justj', 'crhodine', 'huan1146', 'alexdobbins98', 'skantawa', 'tgiazzon', 'psumner', 'ryan.wiebe', 'geyerg', 'deyu23huang', 'eforti', 'rjleach', 'jskeens', 'cclapham', 'mikecpmonkey77', 'yizhizhang', 'nggoodie98', 'alineelquist', 'akreuter', 'jstalbaum', 'ashleydavis', 'john1886', 'tobitrack55', 'suran9712', 'sknecht', 'amckeska', 'dsfgdsfg', 'snead', 'mcclure8', 'nt230', 'hkaakeh', 'lise_lpz']"
3,146,168,60,59,"['jscordero1', 'fvaldezroman', 'kirito', 'ivan0703', 'raquelz48', 'vflombrana', 'lrburgueno', 'dvillalva21', 'jisaucedo', 'infinity444phi', 'gisel.fregoso', 'drhodges', 'xbaca', 'eliot9700', 'hehasan', 'osacosta', 'usuarez11', 'fdo.glz', 'amarin2997', 'crojas7', 'mmedina340', 'jarrah_5011', 'asolis21', 'nsimla', 'reyesmiguel888', 'contiveros7', 'dragonswrath', 'cynthia.oaxaca3', 'willbouns', 'koagbita', 'diegoerickherrera', 'cmflores10', 'lmelend1', 'oscarelozano', 'jorge1799', 'ivan07guerrero', 'aguade03', 'jmckenzie', 'crysdbz.22', 'laarvizu', 'daniboy12', 'teck60osc', 'cesarin159', 'alanrayharr', 'jgonza4643', 'alexmartinezzero', 'meni72', 'aramirez64', 'dterrazas3', 'ponchitofam', 'minjares.jesus.ths', 'joejones143', 'anieto5', 'landa.esteban', 'jalujan8', 'ahmad.abdulraheem', 'carlosmata', 'icasper2', 'cgmartan']",109,"['melike_musal', 'quinnw115', 'teh', 'nimakondori96', 'yunusbaskan', 'hzlzyuan', 'chen.hugh1998', 'brunorodriguez1998', 'fernajes', 'zachfu97', 'baatarb', 'islam_hisham', 'norton.huang', 'jdcanlas7', 'elgohari95', 'djm1411', 'sophia00', 'lamho', 'geberia', 'oconnomi', 'caoboxuan1998', 'baili19', 'raib', 'kellymyers', 'chenlingjie38', 'afkali.120', 'keshavdidi', 'yuejiaqi1', 'furkanturk1352', 'dusty5683', 'samiha_hassan', 'odemc', 'cacost919', 'lusiyang93', 'metalist_kaan', 'mkrysicki', 'eren121313', 'iagord93', 'hm.am.da', 'fatplatypus69', 'bnanojeff', 'phonegamepc', 'edwardleelk123', 'gurindergarcha98', 'shaffert', 'zubeydekal37', 'josborne', 'megang1218', 'krusea', 'yiyusiyang', 'mrg31415926', 'cemkarts', 'ronal_denho_931', 'nyazdi', 'mattbalisky', 'jpjauw', 'tarek20501', 'furkanznkr', 'aralbevtt', 'wynvlntkd', 'lee.johnny.2014', 'felipeballesteros1', 'paulrakowicz', 'alek.konicki09', 'atuftee', 'mmert.bacak', 'chenxi9649', 'amevipin', 's.ganapathy.52', 'ilkaydost', 'mollyrathore.18', 'ankitubc', 'muldowneyc2019', 'mfrounchi3', 'varlamovand', 'fmyurtsever', 'bpbkaminski', 'parisa.esh', 'anoophundle', 'emre_citak_bil', 'omerfkazar22', 'omar.sosa.quimica', 'vandphil', 'walcottr', 'masoudmokht', 'davinb', 'gandersen26', 'dakota1268', 'kaya.emrah.26', 'waheed.ahmed12', 'felipedavidsp', 'edwardmartyr', 'jerryli0711', 'saminsss', 'kvziwc', 'adhikarr95', 'haticesari333333', 'kareem.men3em', 'shininamuthiora', 'nmalshammari', 'polat.gokberk', 'kweze118', 'barrsw3', 'heiknen', 'mohamedsaleh106', 'chazzles', 'ydeokar24', 'johngould1997', 'austalavistababy']",1,['parkita'],169,"['melike_musal', 'raquelz48', 'ivan0703', 'teh', 'quinnw115', 'nimakondori96', 'gisel.fregoso', 'yunusbaskan', 'hzlzyuan', 'hehasan', 'asolis21', 'fdo.glz', 'mmedina340', 'jarrah_5011', 'chen.hugh1998', 'brunorodriguez1998', 'fernajes', 'zachfu97', 'baatarb', 'islam_hisham', 'cmflores10', 'norton.huang', 'lmelend1', 'oscarelozano', 'jorge1799', 'jdcanlas7', 'jmckenzie', 'elgohari95', 'djm1411', 'sophia00', 'lamho', 'geberia', 'oconnomi', 'ponchitofam', 'caoboxuan1998', 'baili19', 'raib', 'chenlingjie38', 'kellymyers', 'carlosmata', 'afkali.120', 'keshavdidi', 'yuejiaqi1', 'furkanturk1352', 'dusty5683', 'infinity444phi', 'samiha_hassan', 'amarin2997', 'nsimla', 'odemc', 'cynthia.oaxaca3', 'cacost919', 'lusiyang93', 'willbouns', 'crysdbz.22', 'laarvizu', 'metalist_kaan', 'mkrysicki', 'cesarin159', 'iagord93', 'eren121313', 'hm.am.da', 'dterrazas3', 'fatplatypus69', 'aramirez64', 'bnanojeff', 'joejones143', 'anieto5', 'phonegamepc', 'edwardleelk123', 'gurindergarcha98', 'shaffert', 'zubeydekal37', 'josborne', 'reyesmiguel888', 'contiveros7', 'ahmad.abdulraheem', 'icasper2', 'megang1218', 'jscordero1', 'krusea', 'yiyusiyang', 'fvaldezroman', 'parkita', 'mrg31415926', 'cemkarts', 'ronal_denho_931', 'nyazdi', 'mattbalisky', 'dvillalva21', 'drhodges', 'jpjauw', 'xbaca', 'tarek20501', 'osacosta', 'crojas7', 'furkanznkr', 'aralbevtt', 'dragonswrath', 'wynvlntkd', 'lee.johnny.2014', 'felipeballesteros1', 'paulrakowicz', 'alek.konicki09', 'atuftee', 'mmert.bacak', 'chenxi9649', 'ivan07guerrero', 'amevipin', 's.ganapathy.52', 'ilkaydost', 'teck60osc', 'alexmartinezzero', 'mollyrathore.18', 'ankitubc', 'muldowneyc2019', 'mfrounchi3', 'jalujan8', 'varlamovand', 'fmyurtsever', 'bpbkaminski', 'parisa.esh', 'anoophundle', 'emre_citak_bil', 'omerfkazar22', 'omar.sosa.quimica', 'vandphil', 'kirito', 'vflombrana', 'walcottr', 'masoudmokht', 'davinb', 'gandersen26', 'jisaucedo', 'eliot9700', 'dakota1268', 'kaya.emrah.26', 'waheed.ahmed12', 'usuarez11', 'felipedavidsp', 'edwardmartyr', 'jerryli0711', 'saminsss', 'kvziwc', 'adhikarr95', 'haticesari333333', 'diegoerickherrera', 'koagbita', 'kareem.men3em', 'shininamuthiora', 'aguade03', 'nmalshammari', 'polat.gokberk', 'kweze118', 'barrsw3', 'heiknen', 'daniboy12', 'mohamedsaleh106', 'alanrayharr', 'jgonza4643', 'meni72', 'chazzles', 'minjares.jesus.ths', 'ydeokar24', 'johngould1997', 'landa.esteban', 'austalavistababy', 'lrburgueno', 'cgmartan']"
3,145,168,50,48,"['keshavdidi', 'yuejiaqi1', 'mrg31415926', 'quinnw115', 'nimakondori96', 'josborne', 'masoudmokht', 'davinb', 'nyazdi', 'mattbalisky', 'gandersen26', 'samiha_hassan', 'hzlzyuan', 'tarek20501', 'felipedavidsp', 'chen.hugh1998', 'brunorodriguez1998', 'zachfu97', 'saminsss', 'jerryli0711', 'kvziwc', 'lee.johnny.2014', 'lusiyang93', 'felipeballesteros1', 'shininamuthiora', 'norton.huang', 'chenxi9649', 'amevipin', 'jdcanlas7', 'djm1411', 's.ganapathy.52', 'sophia00', 'hm.am.da', 'fatplatypus69', 'mollyrathore.18', 'ankitubc', 'bnanojeff', 'caoboxuan1998', 'phonegamepc', 'edwardleelk123', 'varlamovand', 'baili19', 'gurindergarcha98', 'bpbkaminski', 'chenlingjie38', 'austalavistababy', 'parisa.esh', 'anoophundle']",120,"['melike_musal', 'raquelz48', 'ivan0703', 'teh', 'gisel.fregoso', 'yunusbaskan', 'hehasan', 'asolis21', 'fdo.glz', 'mmedina340', 'jarrah_5011', 'fernajes', 'baatarb', 'islam_hisham', 'cmflores10', 'lmelend1', 'oscarelozano', 'jorge1799', 'jmckenzie', 'elgohari95', 'lamho', 'geberia', 'oconnomi', 'ponchitofam', 'raib', 'kellymyers', 'afkali.120', 'carlosmata', 'furkanturk1352', 'dusty5683', 'infinity444phi', 'amarin2997', 'nsimla', 'odemc', 'cynthia.oaxaca3', 'cacost919', 'willbouns', 'crysdbz.22', 'laarvizu', 'metalist_kaan', 'mkrysicki', 'cesarin159', 'iagord93', 'eren121313', 'dterrazas3', 'aramirez64', 'anieto5', 'shaffert', 'zubeydekal37', 'contiveros7', 'ahmad.abdulraheem', 'icasper2', 'reyesmiguel888', 'megang1218', 'jscordero1', 'krusea', 'yiyusiyang', 'fvaldezroman', 'cemkarts', 'lrburgueno', 'ronal_denho_931', 'dvillalva21', 'drhodges', 'jpjauw', 'xbaca', 'osacosta', 'crojas7', 'furkanznkr', 'aralbevtt', 'dragonswrath', 'wynvlntkd', 'paulrakowicz', 'alek.konicki09', 'atuftee', 'mmert.bacak', 'ivan07guerrero', 'ilkaydost', 'teck60osc', 'alexmartinezzero', 'muldowneyc2019', 'mfrounchi3', 'jalujan8', 'fmyurtsever', 'emre_citak_bil', 'omerfkazar22', 'omar.sosa.quimica', 'vandphil', 'kirito', 'vflombrana', 'walcottr', 'jisaucedo', 'eliot9700', 'dakota1268', 'kaya.emrah.26', 'waheed.ahmed12', 'usuarez11', 'edwardmartyr', 'adhikarr95', 'haticesari333333', 'diegoerickherrera', 'koagbita', 'kareem.men3em', 'aguade03', 'nmalshammari', 'polat.gokberk', 'kweze118', 'barrsw3', 'heiknen', 'daniboy12', 'mohamedsaleh106', 'alanrayharr', 'jgonza4643', 'meni72', 'chazzles', 'minjares.jesus.ths', 'ydeokar24', 'johngould1997', 'landa.esteban', 'joejones143', 'cgmartan']",2,"['evelynguo0505', 'bjugraj']",170,"['melike_musal', 'raquelz48', 'ivan0703', 'teh', 'quinnw115', 'nimakondori96', 'gisel.fregoso', 'yunusbaskan', 'hzlzyuan', 'hehasan', 'asolis21', 'fdo.glz', 'mmedina340', 'jarrah_5011', 'chen.hugh1998', 'brunorodriguez1998', 'fernajes', 'zachfu97', 'baatarb', 'islam_hisham', 'cmflores10', 'norton.huang', 'lmelend1', 'oscarelozano', 'jorge1799', 'jdcanlas7', 'jmckenzie', 'elgohari95', 'djm1411', 'sophia00', 'lamho', 'geberia', 'oconnomi', 'ponchitofam', 'caoboxuan1998', 'baili19', 'raib', 'chenlingjie38', 'kellymyers', 'carlosmata', 'afkali.120', 'keshavdidi', 'yuejiaqi1', 'furkanturk1352', 'dusty5683', 'infinity444phi', 'samiha_hassan', 'amarin2997', 'nsimla', 'odemc', 'cynthia.oaxaca3', 'cacost919', 'lusiyang93', 'willbouns', 'crysdbz.22', 'laarvizu', 'metalist_kaan', 'mkrysicki', 'cesarin159', 'iagord93', 'eren121313', 'hm.am.da', 'dterrazas3', 'fatplatypus69', 'aramirez64', 'bnanojeff', 'joejones143', 'anieto5', 'phonegamepc', 'edwardleelk123', 'gurindergarcha98', 'shaffert', 'zubeydekal37', 'josborne', 'reyesmiguel888', 'contiveros7', 'ahmad.abdulraheem', 'icasper2', 'megang1218', 'jscordero1', 'krusea', 'yiyusiyang', 'fvaldezroman', 'mrg31415926', 'cemkarts', 'ronal_denho_931', 'nyazdi', 'mattbalisky', 'dvillalva21', 'drhodges', 'jpjauw', 'xbaca', 'bjugraj', 'tarek20501', 'osacosta', 'crojas7', 'furkanznkr', 'aralbevtt', 'dragonswrath', 'wynvlntkd', 'lee.johnny.2014', 'felipeballesteros1', 'paulrakowicz', 'alek.konicki09', 'atuftee', 'mmert.bacak', 'chenxi9649', 'ivan07guerrero', 'amevipin', 's.ganapathy.52', 'ilkaydost', 'teck60osc', 'alexmartinezzero', 'mollyrathore.18', 'ankitubc', 'muldowneyc2019', 'mfrounchi3', 'jalujan8', 'varlamovand', 'fmyurtsever', 'bpbkaminski', 'parisa.esh', 'anoophundle', 'emre_citak_bil', 'omerfkazar22', 'evelynguo0505', 'omar.sosa.quimica', 'vandphil', 'kirito', 'vflombrana', 'walcottr', 'masoudmokht', 'davinb', 'gandersen26', 'jisaucedo', 'eliot9700', 'dakota1268', 'kaya.emrah.26', 'waheed.ahmed12', 'usuarez11', 'felipedavidsp', 'edwardmartyr', 'jerryli0711', 'saminsss', 'kvziwc', 'adhikarr95', 'haticesari333333', 'diegoerickherrera', 'koagbita', 'kareem.men3em', 'shininamuthiora', 'aguade03', 'nmalshammari', 'polat.gokberk', 'kweze118', 'barrsw3', 'heiknen', 'daniboy12', 'mohamedsaleh106', 'alanrayharr', 'jgonza4643', 'meni72', 'chazzles', 'minjares.jesus.ths', 'ydeokar24', 'johngould1997', 'landa.esteban', 'austalavistababy', 'lrburgueno', 'cgmartan']"
3,20,168,36,10,"['yunusbaskan', 'emre_citak_bil', 'melike_musal', 'cemkarts', 'furkanturk1352', 'furkanznkr', 'ilkaydost', 'afkali.120', 'haticesari333333', 'omerfkazar22']",158,"['raquelz48', 'ivan0703', 'teh', 'quinnw115', 'nimakondori96', 'gisel.fregoso', 'hzlzyuan', 'hehasan', 'asolis21', 'fdo.glz', 'mmedina340', 'jarrah_5011', 'chen.hugh1998', 'brunorodriguez1998', 'fernajes', 'zachfu97', 'baatarb', 'islam_hisham', 'cmflores10', 'norton.huang', 'lmelend1', 'oscarelozano', 'jorge1799', 'jdcanlas7', 'jmckenzie', 'elgohari95', 'djm1411', 'sophia00', 'lamho', 'geberia', 'oconnomi', 'ponchitofam', 'caoboxuan1998', 'baili19', 'raib', 'chenlingjie38', 'kellymyers', 'carlosmata', 'keshavdidi', 'yuejiaqi1', 'dusty5683', 'infinity444phi', 'samiha_hassan', 'amarin2997', 'nsimla', 'odemc', 'cynthia.oaxaca3', 'cacost919', 'lusiyang93', 'willbouns', 'crysdbz.22', 'laarvizu', 'metalist_kaan', 'mkrysicki', 'cesarin159', 'iagord93', 'eren121313', 'hm.am.da', 'dterrazas3', 'fatplatypus69', 'aramirez64', 'bnanojeff', 'joejones143', 'anieto5', 'phonegamepc', 'edwardleelk123', 'gurindergarcha98', 'shaffert', 'zubeydekal37', 'josborne', 'reyesmiguel888', 'contiveros7', 'ahmad.abdulraheem', 'icasper2', 'megang1218', 'jscordero1', 'krusea', 'yiyusiyang', 'fvaldezroman', 'mrg31415926', 'ronal_denho_931', 'nyazdi', 'mattbalisky', 'dvillalva21', 'drhodges', 'jpjauw', 'xbaca', 'tarek20501', 'osacosta', 'crojas7', 'aralbevtt', 'dragonswrath', 'wynvlntkd', 'lee.johnny.2014', 'felipeballesteros1', 'paulrakowicz', 'alek.konicki09', 'atuftee', 'mmert.bacak', 'chenxi9649', 'ivan07guerrero', 'amevipin', 's.ganapathy.52', 'teck60osc', 'alexmartinezzero', 'mollyrathore.18', 'ankitubc', 'muldowneyc2019', 'mfrounchi3', 'jalujan8', 'varlamovand', 'fmyurtsever', 'bpbkaminski', 'parisa.esh', 'anoophundle', 'omar.sosa.quimica', 'vandphil', 'kirito', 'vflombrana', 'walcottr', 'masoudmokht', 'davinb', 'gandersen26', 'jisaucedo', 'eliot9700', 'dakota1268', 'kaya.emrah.26', 'waheed.ahmed12', 'usuarez11', 'felipedavidsp', 'edwardmartyr', 'jerryli0711', 'saminsss', 'kvziwc', 'adhikarr95', 'diegoerickherrera', 'koagbita', 'kareem.men3em', 'shininamuthiora', 'aguade03', 'nmalshammari', 'polat.gokberk', 'kweze118', 'barrsw3', 'heiknen', 'daniboy12', 'mohamedsaleh106', 'alanrayharr', 'jgonza4643', 'meni72', 'chazzles', 'minjares.jesus.ths', 'ydeokar24', 'johngould1997', 'landa.esteban', 'austalavistababy', 'lrburgueno', 'cgmartan']",26,"['emre_krtn97', '46harunakgul', 'kganozcan', 'esracolak.25', 'abdurrahmn15', 'melikemusal1', 'abcd5454', 'irfancan571', 'metehanmustafayalcin', 'brknshn', 'damlakubattt', 'ozbunar01', 'adnanyuceer', 'ugur.cankaya.3718', 'nihatyavuz', 'frknznkr', 'berkanaydn16', 'meltemsbreezes', 'oakbulut1997', 'onurcanozavci', 'mevradilanerten', 'evrenyigit', 'cihanbuyuknacar', 'muratlevent', 'muvafikmelikkaya', 'davuteee']",194,"['melike_musal', 'emre_krtn97', 'raquelz48', 'ivan0703', 'teh', 'quinnw115', 'nimakondori96', 'melikemusal1', 'gisel.fregoso', 'yunusbaskan', 'hzlzyuan', 'hehasan', 'asolis21', 'fdo.glz', 'mmedina340', 'jarrah_5011', 'chen.hugh1998', 'brunorodriguez1998', 'fernajes', 'zachfu97', 'damlakubattt', 'baatarb', 'islam_hisham', 'cmflores10', 'norton.huang', 'lmelend1', 'oscarelozano', 'jorge1799', 'jdcanlas7', 'jmckenzie', 'elgohari95', 'ozbunar01', 'djm1411', 'ugur.cankaya.3718', 'nihatyavuz', 'berkanaydn16', 'sophia00', 'oakbulut1997', 'lamho', 'mevradilanerten', 'geberia', 'oconnomi', 'cihanbuyuknacar', 'ponchitofam', 'caoboxuan1998', 'muvafikmelikkaya', 'baili19', 'raib', 'chenlingjie38', 'kellymyers', 'carlosmata', 'afkali.120', 'keshavdidi', 'yuejiaqi1', '46harunakgul', 'furkanturk1352', 'esracolak.25', 'dusty5683', 'infinity444phi', 'samiha_hassan', 'amarin2997', 'metehanmustafayalcin', 'brknshn', 'nsimla', 'odemc', 'cynthia.oaxaca3', 'cacost919', 'lusiyang93', 'willbouns', 'crysdbz.22', 'laarvizu', 'metalist_kaan', 'mkrysicki', 'meltemsbreezes', 'cesarin159', 'iagord93', 'eren121313', 'hm.am.da', 'dterrazas3', 'fatplatypus69', 'aramirez64', 'evrenyigit', 'bnanojeff', 'joejones143', 'anieto5', 'phonegamepc', 'edwardleelk123', 'davuteee', 'gurindergarcha98', 'shaffert', 'zubeydekal37', 'josborne', 'reyesmiguel888', 'contiveros7', 'ahmad.abdulraheem', 'icasper2', 'megang1218', 'jscordero1', 'krusea', 'yiyusiyang', 'fvaldezroman', 'mrg31415926', 'cemkarts', 'ronal_denho_931', 'nyazdi', 'mattbalisky', 'dvillalva21', 'drhodges', 'jpjauw', 'xbaca', 'abcd5454', 'tarek20501', 'irfancan571', 'osacosta', 'crojas7', 'furkanznkr', 'aralbevtt', 'dragonswrath', 'wynvlntkd', 'lee.johnny.2014', 'felipeballesteros1', 'paulrakowicz', 'alek.konicki09', 'atuftee', 'mmert.bacak', 'chenxi9649', 'ivan07guerrero', 'amevipin', 'adnanyuceer', 'frknznkr', 's.ganapathy.52', 'ilkaydost', 'teck60osc', 'onurcanozavci', 'alexmartinezzero', 'mollyrathore.18', 'ankitubc', 'muldowneyc2019', 'mfrounchi3', 'jalujan8', 'varlamovand', 'fmyurtsever', 'bpbkaminski', 'parisa.esh', 'anoophundle', 'emre_citak_bil', 'omerfkazar22', 'omar.sosa.quimica', 'vandphil', 'kirito', 'vflombrana', 'kganozcan', 'walcottr', 'masoudmokht', 'davinb', 'abdurrahmn15', 'gandersen26', 'jisaucedo', 'eliot9700', 'dakota1268', 'kaya.emrah.26', 'waheed.ahmed12', 'usuarez11', 'felipedavidsp', 'edwardmartyr', 'jerryli0711', 'saminsss', 'kvziwc', 'adhikarr95', 'haticesari333333', 'diegoerickherrera', 'koagbita', 'kareem.men3em', 'shininamuthiora', 'aguade03', 'nmalshammari', 'polat.gokberk', 'kweze118', 'barrsw3', 'heiknen', 'daniboy12', 'mohamedsaleh106', 'alanrayharr', 'jgonza4643', 'meni72', 'chazzles', 'minjares.jesus.ths', 'muratlevent', 'ydeokar24', 'johngould1997', 'landa.esteban', 'austalavistababy', 'lrburgueno', 'cgmartan']"
3,147,168,22,22,"['megang1218', 'krusea', 'vandphil', 'walcottr', 'jpjauw', 'dakota1268', 'fernajes', 'odemc', 'baatarb', 'wynvlntkd', 'cacost919', 'adhikarr95', 'paulrakowicz', 'kweze118', 'barrsw3', 'lamho', 'oconnomi', 'muldowneyc2019', 'johngould1997', 'shaffert', 'raib', 'kellymyers']",146,"['melike_musal', 'raquelz48', 'ivan0703', 'teh', 'quinnw115', 'nimakondori96', 'gisel.fregoso', 'yunusbaskan', 'hzlzyuan', 'hehasan', 'asolis21', 'fdo.glz', 'mmedina340', 'jarrah_5011', 'chen.hugh1998', 'brunorodriguez1998', 'zachfu97', 'islam_hisham', 'cmflores10', 'norton.huang', 'lmelend1', 'oscarelozano', 'jorge1799', 'jdcanlas7', 'jmckenzie', 'elgohari95', 'djm1411', 'sophia00', 'geberia', 'ponchitofam', 'caoboxuan1998', 'baili19', 'chenlingjie38', 'carlosmata', 'afkali.120', 'keshavdidi', 'yuejiaqi1', 'furkanturk1352', 'dusty5683', 'infinity444phi', 'samiha_hassan', 'amarin2997', 'nsimla', 'cynthia.oaxaca3', 'lusiyang93', 'willbouns', 'crysdbz.22', 'laarvizu', 'metalist_kaan', 'mkrysicki', 'cesarin159', 'iagord93', 'eren121313', 'hm.am.da', 'dterrazas3', 'fatplatypus69', 'aramirez64', 'bnanojeff', 'joejones143', 'anieto5', 'phonegamepc', 'edwardleelk123', 'gurindergarcha98', 'zubeydekal37', 'josborne', 'reyesmiguel888', 'contiveros7', 'ahmad.abdulraheem', 'icasper2', 'jscordero1', 'yiyusiyang', 'fvaldezroman', 'mrg31415926', 'cemkarts', 'ronal_denho_931', 'nyazdi', 'mattbalisky', 'dvillalva21', 'drhodges', 'xbaca', 'tarek20501', 'osacosta', 'crojas7', 'furkanznkr', 'aralbevtt', 'dragonswrath', 'lee.johnny.2014', 'felipeballesteros1', 'alek.konicki09', 'atuftee', 'mmert.bacak', 'chenxi9649', 'ivan07guerrero', 'amevipin', 's.ganapathy.52', 'ilkaydost', 'teck60osc', 'alexmartinezzero', 'mollyrathore.18', 'ankitubc', 'mfrounchi3', 'jalujan8', 'varlamovand', 'fmyurtsever', 'bpbkaminski', 'parisa.esh', 'anoophundle', 'emre_citak_bil', 'omerfkazar22', 'omar.sosa.quimica', 'kirito', 'vflombrana', 'masoudmokht', 'davinb', 'gandersen26', 'jisaucedo', 'eliot9700', 'kaya.emrah.26', 'waheed.ahmed12', 'usuarez11', 'felipedavidsp', 'edwardmartyr', 'jerryli0711', 'saminsss', 'kvziwc', 'haticesari333333', 'diegoerickherrera', 'koagbita', 'kareem.men3em', 'shininamuthiora', 'aguade03', 'nmalshammari', 'polat.gokberk', 'heiknen', 'daniboy12', 'mohamedsaleh106', 'alanrayharr', 'jgonza4643', 'meni72', 'chazzles', 'minjares.jesus.ths', 'ydeokar24', 'landa.esteban', 'austalavistababy', 'lrburgueno', 'cgmartan']",0,[],168,"['melike_musal', 'raquelz48', 'ivan0703', 'teh', 'quinnw115', 'nimakondori96', 'gisel.fregoso', 'yunusbaskan', 'hzlzyuan', 'hehasan', 'asolis21', 'fdo.glz', 'mmedina340', 'jarrah_5011', 'chen.hugh1998', 'brunorodriguez1998', 'fernajes', 'zachfu97', 'baatarb', 'islam_hisham', 'cmflores10', 'norton.huang', 'lmelend1', 'oscarelozano', 'jorge1799', 'jdcanlas7', 'jmckenzie', 'elgohari95', 'djm1411', 'sophia00', 'lamho', 'geberia', 'oconnomi', 'ponchitofam', 'caoboxuan1998', 'baili19', 'raib', 'chenlingjie38', 'kellymyers', 'carlosmata', 'afkali.120', 'keshavdidi', 'yuejiaqi1', 'furkanturk1352', 'dusty5683', 'infinity444phi', 'samiha_hassan', 'amarin2997', 'nsimla', 'odemc', 'cynthia.oaxaca3', 'cacost919', 'lusiyang93', 'willbouns', 'crysdbz.22', 'laarvizu', 'metalist_kaan', 'mkrysicki', 'cesarin159', 'iagord93', 'eren121313', 'hm.am.da', 'dterrazas3', 'fatplatypus69', 'aramirez64', 'bnanojeff', 'joejones143', 'anieto5', 'phonegamepc', 'edwardleelk123', 'gurindergarcha98', 'shaffert', 'zubeydekal37', 'josborne', 'reyesmiguel888', 'contiveros7', 'ahmad.abdulraheem', 'icasper2', 'megang1218', 'jscordero1', 'krusea', 'yiyusiyang', 'fvaldezroman', 'mrg31415926', 'cemkarts', 'ronal_denho_931', 'nyazdi', 'mattbalisky', 'dvillalva21', 'drhodges', 'jpjauw', 'xbaca', 'tarek20501', 'osacosta', 'crojas7', 'furkanznkr', 'aralbevtt', 'dragonswrath', 'wynvlntkd', 'lee.johnny.2014', 'felipeballesteros1', 'paulrakowicz', 'alek.konicki09', 'atuftee', 'mmert.bacak', 'chenxi9649', 'ivan07guerrero', 'amevipin', 's.ganapathy.52', 'ilkaydost', 'teck60osc', 'alexmartinezzero', 'mollyrathore.18', 'ankitubc', 'muldowneyc2019', 'mfrounchi3', 'jalujan8', 'varlamovand', 'fmyurtsever', 'bpbkaminski', 'parisa.esh', 'anoophundle', 'emre_citak_bil', 'omerfkazar22', 'omar.sosa.quimica', 'vandphil', 'kirito', 'vflombrana', 'walcottr', 'masoudmokht', 'davinb', 'gandersen26', 'jisaucedo', 'eliot9700', 'dakota1268', 'kaya.emrah.26', 'waheed.ahmed12', 'usuarez11', 'felipedavidsp', 'edwardmartyr', 'jerryli0711', 'saminsss', 'kvziwc', 'adhikarr95', 'haticesari333333', 'diegoerickherrera', 'koagbita', 'kareem.men3em', 'shininamuthiora', 'aguade03', 'nmalshammari', 'polat.gokberk', 'kweze118', 'barrsw3', 'heiknen', 'daniboy12', 'mohamedsaleh106', 'alanrayharr', 'jgonza4643', 'meni72', 'chazzles', 'minjares.jesus.ths', 'ydeokar24', 'johngould1997', 'landa.esteban', 'austalavistababy', 'lrburgueno', 'cgmartan']"
3,22,168,20,4,"['ronal_denho_931', 'furkanturk1352', 'polat.gokberk', 'metalist_kaan']",164,"['melike_musal', 'raquelz48', 'ivan0703', 'teh', 'quinnw115', 'nimakondori96', 'gisel.fregoso', 'yunusbaskan', 'hzlzyuan', 'hehasan', 'asolis21', 'fdo.glz', 'mmedina340', 'jarrah_5011', 'chen.hugh1998', 'brunorodriguez1998', 'fernajes', 'zachfu97', 'baatarb', 'islam_hisham', 'cmflores10', 'norton.huang', 'lmelend1', 'oscarelozano', 'jorge1799', 'jdcanlas7', 'jmckenzie', 'elgohari95', 'djm1411', 'sophia00', 'lamho', 'geberia', 'oconnomi', 'ponchitofam', 'caoboxuan1998', 'baili19', 'raib', 'chenlingjie38', 'kellymyers', 'carlosmata', 'afkali.120', 'keshavdidi', 'yuejiaqi1', 'dusty5683', 'infinity444phi', 'samiha_hassan', 'amarin2997', 'nsimla', 'odemc', 'cynthia.oaxaca3', 'cacost919', 'lusiyang93', 'willbouns', 'crysdbz.22', 'laarvizu', 'mkrysicki', 'cesarin159', 'iagord93', 'eren121313', 'hm.am.da', 'dterrazas3', 'fatplatypus69', 'aramirez64', 'bnanojeff', 'joejones143', 'anieto5', 'phonegamepc', 'edwardleelk123', 'gurindergarcha98', 'shaffert', 'zubeydekal37', 'josborne', 'reyesmiguel888', 'contiveros7', 'ahmad.abdulraheem', 'icasper2', 'megang1218', 'jscordero1', 'krusea', 'yiyusiyang', 'fvaldezroman', 'mrg31415926', 'cemkarts', 'nyazdi', 'mattbalisky', 'dvillalva21', 'drhodges', 'jpjauw', 'xbaca', 'tarek20501', 'osacosta', 'crojas7', 'furkanznkr', 'aralbevtt', 'dragonswrath', 'wynvlntkd', 'lee.johnny.2014', 'felipeballesteros1', 'paulrakowicz', 'alek.konicki09', 'atuftee', 'mmert.bacak', 'chenxi9649', 'ivan07guerrero', 'amevipin', 's.ganapathy.52', 'ilkaydost', 'teck60osc', 'alexmartinezzero', 'mollyrathore.18', 'ankitubc', 'muldowneyc2019', 'mfrounchi3', 'jalujan8', 'varlamovand', 'fmyurtsever', 'bpbkaminski', 'parisa.esh', 'anoophundle', 'emre_citak_bil', 'omerfkazar22', 'omar.sosa.quimica', 'vandphil', 'kirito', 'vflombrana', 'walcottr', 'masoudmokht', 'davinb', 'gandersen26', 'jisaucedo', 'eliot9700', 'dakota1268', 'kaya.emrah.26', 'waheed.ahmed12', 'usuarez11', 'felipedavidsp', 'edwardmartyr', 'jerryli0711', 'saminsss', 'kvziwc', 'adhikarr95', 'haticesari333333', 'diegoerickherrera', 'koagbita', 'kareem.men3em', 'shininamuthiora', 'aguade03', 'nmalshammari', 'kweze118', 'barrsw3', 'heiknen', 'daniboy12', 'mohamedsaleh106', 'alanrayharr', 'jgonza4643', 'meni72', 'chazzles', 'minjares.jesus.ths', 'ydeokar24', 'johngould1997', 'landa.esteban', 'austalavistababy', 'lrburgueno', 'cgmartan']",16,"['melisozkarr', 'okanircann', 'fatiherdgn25', 'elifisparta38', 'ozgurdenizkozan', 'nihansulukoy', 'sudekoza', 'tuberkargan_97', 'trkmengkay', 'senanurcetin96', 'brknshn', 'sinasigurpinar', 'ozgurkablan26', 'oakbulut1997', 'joker632455', 'emrebuyukkose2']",184,"['melike_musal', 'raquelz48', 'ivan0703', 'teh', 'quinnw115', 'nimakondori96', 'gisel.fregoso', 'yunusbaskan', 'hzlzyuan', 'hehasan', 'asolis21', 'fdo.glz', 'mmedina340', 'jarrah_5011', 'chen.hugh1998', 'brunorodriguez1998', 'fernajes', 'zachfu97', 'baatarb', 'islam_hisham', 'joker632455', 'cmflores10', 'norton.huang', 'lmelend1', 'oscarelozano', 'jorge1799', 'jdcanlas7', 'jmckenzie', 'elgohari95', 'djm1411', 'sinasigurpinar', 'sophia00', 'oakbulut1997', 'lamho', 'geberia', 'oconnomi', 'ponchitofam', 'caoboxuan1998', 'baili19', 'raib', 'chenlingjie38', 'kellymyers', 'carlosmata', 'afkali.120', 'keshavdidi', 'yuejiaqi1', 'furkanturk1352', 'dusty5683', 'infinity444phi', 'emrebuyukkose2', 'samiha_hassan', 'nihansulukoy', 'amarin2997', 'brknshn', 'nsimla', 'odemc', 'cynthia.oaxaca3', 'cacost919', 'lusiyang93', 'willbouns', 'fatiherdgn25', 'crysdbz.22', 'laarvizu', 'metalist_kaan', 'mkrysicki', 'cesarin159', 'iagord93', 'eren121313', 'hm.am.da', 'dterrazas3', 'fatplatypus69', 'aramirez64', 'bnanojeff', 'joejones143', 'anieto5', 'phonegamepc', 'edwardleelk123', 'gurindergarcha98', 'shaffert', 'zubeydekal37', 'josborne', 'reyesmiguel888', 'contiveros7', 'ahmad.abdulraheem', 'icasper2', 'megang1218', 'jscordero1', 'krusea', 'yiyusiyang', 'fvaldezroman', 'mrg31415926', 'cemkarts', 'ronal_denho_931', 'nyazdi', 'mattbalisky', 'dvillalva21', 'drhodges', 'jpjauw', 'xbaca', 'tarek20501', 'osacosta', 'crojas7', 'furkanznkr', 'aralbevtt', 'dragonswrath', 'wynvlntkd', 'lee.johnny.2014', 'felipeballesteros1', 'paulrakowicz', 'alek.konicki09', 'melisozkarr', 'atuftee', 'mmert.bacak', 'chenxi9649', 'ivan07guerrero', 'amevipin', 'ozgurdenizkozan', 'sudekoza', 's.ganapathy.52', 'trkmengkay', 'ilkaydost', 'teck60osc', 'alexmartinezzero', 'mollyrathore.18', 'ankitubc', 'elifisparta38', 'muldowneyc2019', 'mfrounchi3', 'jalujan8', 'varlamovand', 'fmyurtsever', 'ozgurkablan26', 'bpbkaminski', 'parisa.esh', 'anoophundle', 'emre_citak_bil', 'omerfkazar22', 'omar.sosa.quimica', 'vandphil', 'kirito', 'vflombrana', 'walcottr', 'masoudmokht', 'davinb', 'gandersen26', 'jisaucedo', 'eliot9700', 'dakota1268', 'kaya.emrah.26', 'waheed.ahmed12', 'usuarez11', 'felipedavidsp', 'tuberkargan_97', 'edwardmartyr', 'jerryli0711', 'saminsss', 'senanurcetin96', 'kvziwc', 'adhikarr95', 'haticesari333333', 'diegoerickherrera', 'koagbita', 'kareem.men3em', 'shininamuthiora', 'okanircann', 'aguade03', 'nmalshammari', 'polat.gokberk', 'kweze118', 'barrsw3', 'heiknen', 'daniboy12', 'mohamedsaleh106', 'alanrayharr', 'jgonza4643', 'meni72', 'chazzles', 'minjares.jesus.ths', 'ydeokar24', 'johngould1997', 'landa.esteban', 'austalavistababy', 'lrburgueno', 'cgmartan']"
3,109,168,13,5,"['elgohari95', 'waheed.ahmed12', 'islam_hisham', 'mohamedsaleh106', 'kareem.men3em']",163,"['melike_musal', 'raquelz48', 'ivan0703', 'teh', 'quinnw115', 'nimakondori96', 'gisel.fregoso', 'yunusbaskan', 'hzlzyuan', 'hehasan', 'asolis21', 'fdo.glz', 'mmedina340', 'jarrah_5011', 'chen.hugh1998', 'brunorodriguez1998', 'fernajes', 'zachfu97', 'baatarb', 'cmflores10', 'norton.huang', 'lmelend1', 'oscarelozano', 'jorge1799', 'jdcanlas7', 'jmckenzie', 'djm1411', 'sophia00', 'lamho', 'geberia', 'oconnomi', 'ponchitofam', 'caoboxuan1998', 'baili19', 'raib', 'chenlingjie38', 'kellymyers', 'carlosmata', 'afkali.120', 'keshavdidi', 'yuejiaqi1', 'furkanturk1352', 'dusty5683', 'infinity444phi', 'samiha_hassan', 'amarin2997', 'nsimla', 'odemc', 'cynthia.oaxaca3', 'cacost919', 'lusiyang93', 'willbouns', 'crysdbz.22', 'laarvizu', 'metalist_kaan', 'mkrysicki', 'cesarin159', 'iagord93', 'eren121313', 'hm.am.da', 'dterrazas3', 'fatplatypus69', 'aramirez64', 'bnanojeff', 'joejones143', 'anieto5', 'phonegamepc', 'edwardleelk123', 'gurindergarcha98', 'shaffert', 'zubeydekal37', 'josborne', 'reyesmiguel888', 'contiveros7', 'ahmad.abdulraheem', 'icasper2', 'megang1218', 'jscordero1', 'krusea', 'yiyusiyang', 'fvaldezroman', 'mrg31415926', 'cemkarts', 'ronal_denho_931', 'nyazdi', 'mattbalisky', 'dvillalva21', 'drhodges', 'jpjauw', 'xbaca', 'tarek20501', 'osacosta', 'crojas7', 'furkanznkr', 'aralbevtt', 'dragonswrath', 'wynvlntkd', 'lee.johnny.2014', 'felipeballesteros1', 'paulrakowicz', 'alek.konicki09', 'atuftee', 'mmert.bacak', 'chenxi9649', 'ivan07guerrero', 'amevipin', 's.ganapathy.52', 'ilkaydost', 'teck60osc', 'alexmartinezzero', 'mollyrathore.18', 'ankitubc', 'muldowneyc2019', 'mfrounchi3', 'jalujan8', 'varlamovand', 'fmyurtsever', 'bpbkaminski', 'parisa.esh', 'anoophundle', 'emre_citak_bil', 'omerfkazar22', 'omar.sosa.quimica', 'vandphil', 'kirito', 'vflombrana', 'walcottr', 'masoudmokht', 'davinb', 'gandersen26', 'jisaucedo', 'eliot9700', 'dakota1268', 'kaya.emrah.26', 'usuarez11', 'felipedavidsp', 'edwardmartyr', 'jerryli0711', 'saminsss', 'kvziwc', 'adhikarr95', 'haticesari333333', 'diegoerickherrera', 'koagbita', 'shininamuthiora', 'aguade03', 'nmalshammari', 'polat.gokberk', 'kweze118', 'barrsw3', 'heiknen', 'daniboy12', 'alanrayharr', 'jgonza4643', 'meni72', 'chazzles', 'minjares.jesus.ths', 'ydeokar24', 'johngould1997', 'landa.esteban', 'austalavistababy', 'lrburgueno', 'cgmartan']",8,"['mhesham2018', 'asmaa_abdelmegeed.', 'bakr', 'mohamedmsaad66', 'mohamed.ah.omran', 'mohamed.h.mamdouh', 'ahmedraouf', 'basem.ali95']",176,"['melike_musal', 'raquelz48', 'ivan0703', 'teh', 'quinnw115', 'nimakondori96', 'mohamedmsaad66', 'gisel.fregoso', 'yunusbaskan', 'hzlzyuan', 'hehasan', 'asolis21', 'fdo.glz', 'mmedina340', 'jarrah_5011', 'chen.hugh1998', 'brunorodriguez1998', 'fernajes', 'zachfu97', 'baatarb', 'islam_hisham', 'cmflores10', 'norton.huang', 'lmelend1', 'oscarelozano', 'jorge1799', 'jdcanlas7', 'jmckenzie', 'elgohari95', 'djm1411', 'mohamed.ah.omran', 'sophia00', 'lamho', 'geberia', 'oconnomi', 'ponchitofam', 'caoboxuan1998', 'baili19', 'raib', 'chenlingjie38', 'kellymyers', 'carlosmata', 'afkali.120', 'keshavdidi', 'yuejiaqi1', 'furkanturk1352', 'dusty5683', 'infinity444phi', 'samiha_hassan', 'amarin2997', 'nsimla', 'odemc', 'cynthia.oaxaca3', 'cacost919', 'lusiyang93', 'willbouns', 'crysdbz.22', 'laarvizu', 'metalist_kaan', 'mkrysicki', 'cesarin159', 'iagord93', 'eren121313', 'hm.am.da', 'dterrazas3', 'fatplatypus69', 'aramirez64', 'bnanojeff', 'joejones143', 'anieto5', 'phonegamepc', 'edwardleelk123', 'gurindergarcha98', 'shaffert', 'zubeydekal37', 'josborne', 'reyesmiguel888', 'contiveros7', 'ahmad.abdulraheem', 'icasper2', 'megang1218', 'jscordero1', 'krusea', 'yiyusiyang', 'fvaldezroman', 'mrg31415926', 'cemkarts', 'asmaa_abdelmegeed.', 'bakr', 'ronal_denho_931', 'nyazdi', 'mattbalisky', 'dvillalva21', 'drhodges', 'jpjauw', 'xbaca', 'tarek20501', 'osacosta', 'crojas7', 'furkanznkr', 'aralbevtt', 'dragonswrath', 'wynvlntkd', 'lee.johnny.2014', 'felipeballesteros1', 'paulrakowicz', 'alek.konicki09', 'atuftee', 'mmert.bacak', 'chenxi9649', 'ivan07guerrero', 'amevipin', 'mhesham2018', 's.ganapathy.52', 'ilkaydost', 'teck60osc', 'basem.ali95', 'alexmartinezzero', 'mollyrathore.18', 'ankitubc', 'muldowneyc2019', 'mfrounchi3', 'jalujan8', 'varlamovand', 'fmyurtsever', 'bpbkaminski', 'parisa.esh', 'anoophundle', 'emre_citak_bil', 'omerfkazar22', 'omar.sosa.quimica', 'vandphil', 'kirito', 'vflombrana', 'walcottr', 'masoudmokht', 'davinb', 'gandersen26', 'jisaucedo', 'eliot9700', 'dakota1268', 'kaya.emrah.26', 'waheed.ahmed12', 'usuarez11', 'felipedavidsp', 'edwardmartyr', 'jerryli0711', 'saminsss', 'mohamed.h.mamdouh', 'kvziwc', 'adhikarr95', 'haticesari333333', 'diegoerickherrera', 'koagbita', 'kareem.men3em', 'shininamuthiora', 'aguade03', 'nmalshammari', 'polat.gokberk', 'kweze118', 'barrsw3', 'heiknen', 'daniboy12', 'mohamedsaleh106', 'alanrayharr', 'jgonza4643', 'meni72', 'chazzles', 'minjares.jesus.ths', 'ydeokar24', 'johngould1997', 'landa.esteban', 'ahmedraouf', 'austalavistababy', 'lrburgueno', 'cgmartan']"
3,144,168,7,2,"['mmert.bacak', 'zubeydekal37']",166,"['melike_musal', 'raquelz48', 'ivan0703', 'teh', 'quinnw115', 'nimakondori96', 'gisel.fregoso', 'yunusbaskan', 'hzlzyuan', 'hehasan', 'asolis21', 'fdo.glz', 'mmedina340', 'jarrah_5011', 'chen.hugh1998', 'brunorodriguez1998', 'fernajes', 'zachfu97', 'baatarb', 'islam_hisham', 'cmflores10', 'norton.huang', 'lmelend1', 'oscarelozano', 'jorge1799', 'jdcanlas7', 'jmckenzie', 'elgohari95', 'djm1411', 'sophia00', 'lamho', 'geberia', 'oconnomi', 'ponchitofam', 'caoboxuan1998', 'baili19', 'raib', 'chenlingjie38', 'kellymyers', 'carlosmata', 'afkali.120', 'keshavdidi', 'yuejiaqi1', 'furkanturk1352', 'dusty5683', 'infinity444phi', 'samiha_hassan', 'amarin2997', 'nsimla', 'odemc', 'cynthia.oaxaca3', 'cacost919', 'lusiyang93', 'willbouns', 'crysdbz.22', 'laarvizu', 'metalist_kaan', 'mkrysicki', 'cesarin159', 'iagord93', 'eren121313', 'hm.am.da', 'dterrazas3', 'fatplatypus69', 'aramirez64', 'bnanojeff', 'joejones143', 'anieto5', 'phonegamepc', 'edwardleelk123', 'gurindergarcha98', 'shaffert', 'josborne', 'reyesmiguel888', 'contiveros7', 'ahmad.abdulraheem', 'icasper2', 'megang1218', 'jscordero1', 'krusea', 'yiyusiyang', 'fvaldezroman', 'mrg31415926', 'cemkarts', 'ronal_denho_931', 'nyazdi', 'mattbalisky', 'dvillalva21', 'drhodges', 'jpjauw', 'xbaca', 'tarek20501', 'osacosta', 'crojas7', 'furkanznkr', 'aralbevtt', 'dragonswrath', 'wynvlntkd', 'lee.johnny.2014', 'felipeballesteros1', 'paulrakowicz', 'alek.konicki09', 'atuftee', 'chenxi9649', 'ivan07guerrero', 'amevipin', 's.ganapathy.52', 'ilkaydost', 'teck60osc', 'alexmartinezzero', 'mollyrathore.18', 'ankitubc', 'muldowneyc2019', 'mfrounchi3', 'jalujan8', 'varlamovand', 'fmyurtsever', 'bpbkaminski', 'parisa.esh', 'anoophundle', 'emre_citak_bil', 'omerfkazar22', 'omar.sosa.quimica', 'vandphil', 'kirito', 'vflombrana', 'walcottr', 'masoudmokht', 'davinb', 'gandersen26', 'jisaucedo', 'eliot9700', 'dakota1268', 'kaya.emrah.26', 'waheed.ahmed12', 'usuarez11', 'felipedavidsp', 'edwardmartyr', 'jerryli0711', 'saminsss', 'kvziwc', 'adhikarr95', 'haticesari333333', 'diegoerickherrera', 'koagbita', 'kareem.men3em', 'shininamuthiora', 'aguade03', 'nmalshammari', 'polat.gokberk', 'kweze118', 'barrsw3', 'heiknen', 'daniboy12', 'mohamedsaleh106', 'alanrayharr', 'jgonza4643', 'meni72', 'chazzles', 'minjares.jesus.ths', 'ydeokar24', 'johngould1997', 'landa.esteban', 'austalavistababy', 'lrburgueno', 'cgmartan']",5,"['elifisparta38', 'ulasgorcelioglu', 'nihansulukoy', 'yilmazberat1997', 'nagihankececi']",173,"['melike_musal', 'raquelz48', 'ivan0703', 'teh', 'quinnw115', 'nimakondori96', 'gisel.fregoso', 'yunusbaskan', 'hzlzyuan', 'hehasan', 'asolis21', 'fdo.glz', 'mmedina340', 'jarrah_5011', 'chen.hugh1998', 'brunorodriguez1998', 'fernajes', 'zachfu97', 'baatarb', 'islam_hisham', 'cmflores10', 'norton.huang', 'lmelend1', 'oscarelozano', 'jorge1799', 'jdcanlas7', 'jmckenzie', 'elgohari95', 'djm1411', 'yilmazberat1997', 'sophia00', 'lamho', 'geberia', 'oconnomi', 'ponchitofam', 'caoboxuan1998', 'baili19', 'raib', 'chenlingjie38', 'kellymyers', 'carlosmata', 'afkali.120', 'keshavdidi', 'yuejiaqi1', 'furkanturk1352', 'dusty5683', 'infinity444phi', 'samiha_hassan', 'nihansulukoy', 'amarin2997', 'nsimla', 'odemc', 'cynthia.oaxaca3', 'cacost919', 'lusiyang93', 'willbouns', 'nagihankececi', 'ulasgorcelioglu', 'crysdbz.22', 'laarvizu', 'metalist_kaan', 'mkrysicki', 'cesarin159', 'iagord93', 'eren121313', 'hm.am.da', 'dterrazas3', 'fatplatypus69', 'aramirez64', 'bnanojeff', 'joejones143', 'anieto5', 'phonegamepc', 'edwardleelk123', 'gurindergarcha98', 'shaffert', 'zubeydekal37', 'josborne', 'reyesmiguel888', 'contiveros7', 'ahmad.abdulraheem', 'icasper2', 'megang1218', 'jscordero1', 'krusea', 'yiyusiyang', 'fvaldezroman', 'mrg31415926', 'cemkarts', 'ronal_denho_931', 'nyazdi', 'mattbalisky', 'dvillalva21', 'drhodges', 'jpjauw', 'xbaca', 'tarek20501', 'osacosta', 'crojas7', 'furkanznkr', 'aralbevtt', 'dragonswrath', 'wynvlntkd', 'lee.johnny.2014', 'felipeballesteros1', 'paulrakowicz', 'alek.konicki09', 'atuftee', 'mmert.bacak', 'chenxi9649', 'ivan07guerrero', 'amevipin', 's.ganapathy.52', 'ilkaydost', 'teck60osc', 'alexmartinezzero', 'mollyrathore.18', 'ankitubc', 'elifisparta38', 'muldowneyc2019', 'mfrounchi3', 'jalujan8', 'varlamovand', 'fmyurtsever', 'bpbkaminski', 'parisa.esh', 'anoophundle', 'emre_citak_bil', 'omerfkazar22', 'omar.sosa.quimica', 'vandphil', 'kirito', 'vflombrana', 'walcottr', 'masoudmokht', 'davinb', 'gandersen26', 'jisaucedo', 'eliot9700', 'dakota1268', 'kaya.emrah.26', 'waheed.ahmed12', 'usuarez11', 'felipedavidsp', 'edwardmartyr', 'jerryli0711', 'saminsss', 'kvziwc', 'adhikarr95', 'haticesari333333', 'diegoerickherrera', 'koagbita', 'kareem.men3em', 'shininamuthiora', 'aguade03', 'nmalshammari', 'polat.gokberk', 'kweze118', 'barrsw3', 'heiknen', 'daniboy12', 'mohamedsaleh106', 'alanrayharr', 'jgonza4643', 'meni72', 'chazzles', 'minjares.jesus.ths', 'ydeokar24', 'johngould1997', 'landa.esteban', 'austalavistababy', 'lrburgueno', 'cgmartan']"
3,106,168,6,1,['dusty5683'],167,"['melike_musal', 'raquelz48', 'ivan0703', 'teh', 'quinnw115', 'nimakondori96', 'gisel.fregoso', 'yunusbaskan', 'hzlzyuan', 'hehasan', 'asolis21', 'fdo.glz', 'mmedina340', 'jarrah_5011', 'chen.hugh1998', 'brunorodriguez1998', 'fernajes', 'zachfu97', 'baatarb', 'islam_hisham', 'cmflores10', 'norton.huang', 'lmelend1', 'oscarelozano', 'jorge1799', 'jdcanlas7', 'jmckenzie', 'elgohari95', 'djm1411', 'sophia00', 'lamho', 'geberia', 'oconnomi', 'ponchitofam', 'caoboxuan1998', 'baili19', 'raib', 'chenlingjie38', 'kellymyers', 'carlosmata', 'afkali.120', 'keshavdidi', 'yuejiaqi1', 'furkanturk1352', 'infinity444phi', 'samiha_hassan', 'amarin2997', 'nsimla', 'odemc', 'cynthia.oaxaca3', 'cacost919', 'lusiyang93', 'willbouns', 'crysdbz.22', 'laarvizu', 'metalist_kaan', 'mkrysicki', 'cesarin159', 'iagord93', 'eren121313', 'hm.am.da', 'dterrazas3', 'fatplatypus69', 'aramirez64', 'bnanojeff', 'joejones143', 'anieto5', 'phonegamepc', 'edwardleelk123', 'gurindergarcha98', 'shaffert', 'zubeydekal37', 'josborne', 'reyesmiguel888', 'contiveros7', 'ahmad.abdulraheem', 'icasper2', 'megang1218', 'jscordero1', 'krusea', 'yiyusiyang', 'fvaldezroman', 'mrg31415926', 'cemkarts', 'ronal_denho_931', 'nyazdi', 'mattbalisky', 'dvillalva21', 'drhodges', 'jpjauw', 'xbaca', 'tarek20501', 'osacosta', 'crojas7', 'furkanznkr', 'aralbevtt', 'dragonswrath', 'wynvlntkd', 'lee.johnny.2014', 'felipeballesteros1', 'paulrakowicz', 'alek.konicki09', 'atuftee', 'mmert.bacak', 'chenxi9649', 'ivan07guerrero', 'amevipin', 's.ganapathy.52', 'ilkaydost', 'teck60osc', 'alexmartinezzero', 'mollyrathore.18', 'ankitubc', 'muldowneyc2019', 'mfrounchi3', 'jalujan8', 'varlamovand', 'fmyurtsever', 'bpbkaminski', 'parisa.esh', 'anoophundle', 'emre_citak_bil', 'omerfkazar22', 'omar.sosa.quimica', 'vandphil', 'kirito', 'vflombrana', 'walcottr', 'masoudmokht', 'davinb', 'gandersen26', 'jisaucedo', 'eliot9700', 'dakota1268', 'kaya.emrah.26', 'waheed.ahmed12', 'usuarez11', 'felipedavidsp', 'edwardmartyr', 'jerryli0711', 'saminsss', 'kvziwc', 'adhikarr95', 'haticesari333333', 'diegoerickherrera', 'koagbita', 'kareem.men3em', 'shininamuthiora', 'aguade03', 'nmalshammari', 'polat.gokberk', 'kweze118', 'barrsw3', 'heiknen', 'daniboy12', 'mohamedsaleh106', 'alanrayharr', 'jgonza4643', 'meni72', 'chazzles', 'minjares.jesus.ths', 'ydeokar24', 'johngould1997', 'landa.esteban', 'austalavistababy', 'lrburgueno', 'cgmartan']",5,"['tarikk', 'denverlloyd', 'ahmedtaher', 'benetcheverry', 'aaronbrown1']",173,"['melike_musal', 'raquelz48', 'ivan0703', 'teh', 'quinnw115', 'nimakondori96', 'gisel.fregoso', 'yunusbaskan', 'hzlzyuan', 'hehasan', 'asolis21', 'fdo.glz', 'mmedina340', 'jarrah_5011', 'chen.hugh1998', 'brunorodriguez1998', 'fernajes', 'zachfu97', 'baatarb', 'islam_hisham', 'cmflores10', 'norton.huang', 'lmelend1', 'oscarelozano', 'jorge1799', 'jdcanlas7', 'jmckenzie', 'elgohari95', 'djm1411', 'ahmedtaher', 'sophia00', 'lamho', 'geberia', 'oconnomi', 'ponchitofam', 'caoboxuan1998', 'baili19', 'raib', 'chenlingjie38', 'kellymyers', 'carlosmata', 'afkali.120', 'keshavdidi', 'yuejiaqi1', 'furkanturk1352', 'dusty5683', 'infinity444phi', 'samiha_hassan', 'amarin2997', 'nsimla', 'odemc', 'cynthia.oaxaca3', 'cacost919', 'lusiyang93', 'willbouns', 'crysdbz.22', 'laarvizu', 'metalist_kaan', 'mkrysicki', 'cesarin159', 'iagord93', 'eren121313', 'hm.am.da', 'dterrazas3', 'fatplatypus69', 'aramirez64', 'bnanojeff', 'joejones143', 'anieto5', 'phonegamepc', 'edwardleelk123', 'gurindergarcha98', 'shaffert', 'zubeydekal37', 'josborne', 'reyesmiguel888', 'contiveros7', 'ahmad.abdulraheem', 'icasper2', 'megang1218', 'jscordero1', 'krusea', 'yiyusiyang', 'fvaldezroman', 'mrg31415926', 'cemkarts', 'ronal_denho_931', 'nyazdi', 'mattbalisky', 'dvillalva21', 'drhodges', 'jpjauw', 'xbaca', 'tarek20501', 'osacosta', 'crojas7', 'furkanznkr', 'aralbevtt', 'dragonswrath', 'wynvlntkd', 'lee.johnny.2014', 'felipeballesteros1', 'paulrakowicz', 'alek.konicki09', 'atuftee', 'mmert.bacak', 'chenxi9649', 'ivan07guerrero', 'amevipin', 's.ganapathy.52', 'ilkaydost', 'teck60osc', 'aaronbrown1', 'alexmartinezzero', 'mollyrathore.18', 'ankitubc', 'denverlloyd', 'muldowneyc2019', 'mfrounchi3', 'jalujan8', 'varlamovand', 'fmyurtsever', 'bpbkaminski', 'parisa.esh', 'anoophundle', 'emre_citak_bil', 'omerfkazar22', 'omar.sosa.quimica', 'vandphil', 'kirito', 'vflombrana', 'walcottr', 'masoudmokht', 'davinb', 'gandersen26', 'jisaucedo', 'tarikk', 'eliot9700', 'dakota1268', 'kaya.emrah.26', 'waheed.ahmed12', 'usuarez11', 'felipedavidsp', 'benetcheverry', 'edwardmartyr', 'jerryli0711', 'saminsss', 'kvziwc', 'adhikarr95', 'haticesari333333', 'diegoerickherrera', 'koagbita', 'kareem.men3em', 'shininamuthiora', 'aguade03', 'nmalshammari', 'polat.gokberk', 'kweze118', 'barrsw3', 'heiknen', 'daniboy12', 'mohamedsaleh106', 'alanrayharr', 'jgonza4643', 'meni72', 'chazzles', 'minjares.jesus.ths', 'ydeokar24', 'johngould1997', 'landa.esteban', 'austalavistababy', 'lrburgueno', 'cgmartan']"
4,73,167,64,57,"['llsloan55555', 'lrhamp', 'rrwilson', 'pinea', 'snahe', 'alexshaw', 'amandnic', 'malhark', 'brokawat', 'shirundo', 'krislew', 'kcrawf', 'haileymk', 'sayanr', 'apielack', 'grfedele', 'alexzimm', 'nikaren', 'scollard', 'jyhoff', 'deanjac99', 'ybeeker', 'cdonahu', 'optalmad', 'kmaxie', 'narceci', 'maymephilbrick', 'herrerag', 'healyjl', 'kenmp', 'dhruvtatke', 'ggracevr', 'apdoyle', 'cjbmi', 'zouhaox', 'katferg', 'claudsnd', 'dshah515', 'ldwillia', 'tbarang', 'ccafmeye', 'rishavc', 'reisnerd', 'jepi', 'vkov', 'liutif', 'mgratows', 'dmcpher', 'jbpeller', 'saxman25', 'asasa', 'danevans', 'jeilers', 'woodjosh', 'aapfel', 'rexkhan', 'lwight']",110,"['ehai1234', 'xzhan147', 'jhardi9', 'arehman4', 'fphender', 'ggmorrow', 'qzhang', 'cjmichae', 'wbumbaca', 'sebmuraru', 'mirandamiao', 'monisanchezblanco', 'liannaldo007', 'allendc', 'saurabhchem09', 'ehsi', 'frasheski', 'phamleminhthong', 'kobocc1994', 'ajhorvath', 'jerry0075566', 'werforgerf4life', 'hregner2', 'costalt', 'mlodriguito', 'myrta', 'dmartinfernandezvald', 'blanzyt', 'kartikghosh2008', 'ollinebg', 'ssengupta3', 'asadncepc', 'mreed11', 'bebling', 'lenling', 'ksallans', 'ssmate', 'brdemarc', 'dkatz4', 'shamilt3', 'higgin24', 'acleve', 'msross', 's.bikash', 'ahmadubuntu', 'ryougijc', 'davisloen', 'rotenmax', 'eescudermilian', 'anfetre', 'dieguez999', 'artrinity', 'dwangy', 'shawak', 'brenrice', 'hgaudin', 'mccartnt', 'solayinka', 'serenad', 'mviksne', 'komen', 'iamavash', 'ftadros', 'lmorrissey', 'dkfkadbs304', 'rlrob', 'yfchen87', 'pdstaubl', 'tdabney', 'jcobolopez', 'jaketh2', 'racotter', 'hteutsch', 'kjfrank2', 'cpassolano', 'cintroli', 'reedy', 'lmeddaugh', 'tmarkiew', 'kli47', 'mattfuentez10', 'nsk2', 'yzhou91', 'ychen261', 'clindn', 'stapleton3', 'stu', 'amroe', 'joseam2', 'ialonsogago', 'jkern3', 'mayank4551', 'umana2', 'ollorentemartija', 'tobias.m.egle', 'shea.costner', 'ojovinomarques', 'eraeker', 'tarnsangprad', 'barbaraldoriga5', 'yhu55', 'cdrewery', 'moralist', 'annakcha', 'leveill2', 'jojoco', 'chinmayanandadm', 'aalmohri', 'tecatetrav', 'avibreg']",7,"['lobbiam', 'stevexu', 'amamj', 'alillig', 'hoopesma', 'ralsmith', 'odonnelc']",174,"['ehai1234', 'llsloan55555', 'alexshaw', 'lrhamp', 'arehman4', 'jhardi9', 'fphender', 'ggmorrow', 'xzhan147', 'malhark', 'krislew', 'apielack', 'qzhang', 'alexzimm', 'cjmichae', 'wbumbaca', 'deanjac99', 'sebmuraru', 'mirandamiao', 'monisanchezblanco', 'maymephilbrick', 'liannaldo007', 'allendc', 'saurabhchem09', 'ehsi', 'ggracevr', 'amamj', 'frasheski', 'phamleminhthong', 'kobocc1994', 'ajhorvath', 'zouhaox', 'jerry0075566', 'ldwillia', 'werforgerf4life', 'hregner2', 'reisnerd', 'dmcpher', 'mlodriguito', 'jbpeller', 'myrta', 'costalt', 'dmartinfernandezvald', 'asasa', 'blanzyt', 'kartikghosh2008', 'aapfel', 'rexkhan', 'optalmad', 'ollinebg', 'ssengupta3', 'pinea', 'snahe', 'asadncepc', 'mreed11', 'bebling', 'lenling', 'shirundo', 'ksallans', 'kcrawf', 'ssmate', 'nikaren', 'jyhoff', 'brdemarc', 'dkatz4', 'shamilt3', 'ybeeker', 'higgin24', 'acleve', 'kmaxie', 'msross', 's.bikash', 'ahmadubuntu', 'herrerag', 'ryougijc', 'davisloen', 'dhruvtatke', 'rotenmax', 'claudsnd', 'hoopesma', 'eescudermilian', 'anfetre', 'stevexu', 'dieguez999', 'artrinity', 'rishavc', 'liutif', 'dwangy', 'shawak', 'saxman25', 'brenrice', 'hgaudin', 'mccartnt', 'solayinka', 'woodjosh', 'serenad', 'mviksne', 'komen', 'amandnic', 'brokawat', 'iamavash', 'ftadros', 'lmorrissey', 'dkfkadbs304', 'grfedele', 'rlrob', 'yfchen87', 'pdstaubl', 'tdabney', 'jcobolopez', 'healyjl', 'jaketh2', 'racotter', 'apdoyle', 'cjbmi', 'hteutsch', 'katferg', 'kjfrank2', 'dshah515', 'odonnelc', 'cpassolano', 'tbarang', 'cintroli', 'reedy', 'lmeddaugh', 'tmarkiew', 'kli47', 'mattfuentez10', 'danevans', 'jeilers', 'nsk2', 'yzhou91', 'ychen261', 'clindn', 'stapleton3', 'rrwilson', 'stu', 'amroe', 'joseam2', 'alillig', 'ialonsogago', 'jkern3', 'mayank4551', 'haileymk', 'sayanr', 'umana2', 'lobbiam', 'scollard', 'ollorentemartija', 'tobias.m.egle', 'shea.costner', 'ojovinomarques', 'cdonahu', 'eraeker', 'narceci', 'tarnsangprad', 'barbaraldoriga5', 'kenmp', 'yhu55', 'ralsmith', 'cdrewery', 'ccafmeye', 'moralist', 'mgratows', 'jepi', 'vkov', 'annakcha', 'leveill2', 'jojoco', 'chinmayanandadm', 'aalmohri', 'tecatetrav', 'avibreg', 'lwight']"
4,25,167,62,11,"['dkfkadbs304', 'werforgerf4life', 'xzhan147', 'jhardi9', 'hregner2', 'leveill2', 'yhu55', 'jaketh2', 'joseam2', 'nsk2', 'kjfrank2']",156,"['ehai1234', 'llsloan55555', 'lrhamp', 'alexshaw', 'arehman4', 'fphender', 'ggmorrow', 'malhark', 'krislew', 'apielack', 'qzhang', 'alexzimm', 'cjmichae', 'wbumbaca', 'deanjac99', 'sebmuraru', 'mirandamiao', 'monisanchezblanco', 'maymephilbrick', 'liannaldo007', 'allendc', 'saurabhchem09', 'ehsi', 'ggracevr', 'frasheski', 'phamleminhthong', 'kobocc1994', 'ajhorvath', 'zouhaox', 'jerry0075566', 'ldwillia', 'reisnerd', 'dmcpher', 'mlodriguito', 'jbpeller', 'myrta', 'costalt', 'dmartinfernandezvald', 'asasa', 'blanzyt', 'kartikghosh2008', 'aapfel', 'rexkhan', 'optalmad', 'ollinebg', 'ssengupta3', 'pinea', 'snahe', 'asadncepc', 'mreed11', 'bebling', 'lenling', 'shirundo', 'ksallans', 'kcrawf', 'ssmate', 'nikaren', 'jyhoff', 'brdemarc', 'dkatz4', 'shamilt3', 'ybeeker', 'higgin24', 'acleve', 'kmaxie', 'msross', 's.bikash', 'ahmadubuntu', 'herrerag', 'ryougijc', 'davisloen', 'dhruvtatke', 'rotenmax', 'claudsnd', 'eescudermilian', 'anfetre', 'dieguez999', 'artrinity', 'rishavc', 'liutif', 'dwangy', 'shawak', 'saxman25', 'brenrice', 'hgaudin', 'mccartnt', 'solayinka', 'woodjosh', 'serenad', 'mviksne', 'komen', 'amandnic', 'brokawat', 'iamavash', 'ftadros', 'lmorrissey', 'grfedele', 'rlrob', 'yfchen87', 'pdstaubl', 'tdabney', 'jcobolopez', 'healyjl', 'racotter', 'apdoyle', 'cjbmi', 'hteutsch', 'katferg', 'dshah515', 'cpassolano', 'tbarang', 'cintroli', 'reedy', 'lmeddaugh', 'tmarkiew', 'kli47', 'mattfuentez10', 'danevans', 'jeilers', 'yzhou91', 'ychen261', 'clindn', 'stapleton3', 'rrwilson', 'stu', 'amroe', 'ialonsogago', 'jkern3', 'mayank4551', 'haileymk', 'sayanr', 'umana2', 'scollard', 'ollorentemartija', 'tobias.m.egle', 'shea.costner', 'ojovinomarques', 'cdonahu', 'eraeker', 'narceci', 'tarnsangprad', 'barbaraldoriga5', 'kenmp', 'cdrewery', 'ccafmeye', 'moralist', 'mgratows', 'jepi', 'vkov', 'annakcha', 'jojoco', 'chinmayanandadm', 'aalmohri', 'tecatetrav', 'avibreg', 'lwight']",51,"['dcpang2', 'kv2', 'jingyiw3', 'jiwu2', 'ckim123', 'kychui2', 'restep2', 'juliaeb2', 'sili5', 'jmjin2', 'saegner2', 'bcperki2', 'pranjal3', 'juliajh2', 'travisc2', 'nahmoda2', 'dplata2', 'zehuahe2', 'rrmiriy2', 'bhliu97', 'rakam2', 'kyang37', 'tss3', 'kfurbee2', 'bharath3', 'dlee145', 'hf4', 'zhixin2', 'rsyuan2', 'shuming2', 'khazanv2', 'akozych2', 'coderko3', 'mjoza2', 'baohl2', 'joshua.leveillee', 'myl3', 'mengkem2', 'rll2', 'jarodm2', 'masonpb2', 'ellenrf2', 'mtobah2', 'jinsup2', 'isaxton2', 'jinwoo2', 'staceyn2', 'kph2', 'jzhan142', 'scc3', 'avw2']",218,"['dcpang2', 'ehai1234', 'llsloan55555', 'alexshaw', 'lrhamp', 'arehman4', 'jhardi9', 'fphender', 'ggmorrow', 'xzhan147', 'kv2', 'malhark', 'krislew', 'apielack', 'qzhang', 'alexzimm', 'cjmichae', 'wbumbaca', 'rrmiriy2', 'deanjac99', 'sebmuraru', 'mirandamiao', 'monisanchezblanco', 'maymephilbrick', 'liannaldo007', 'rsyuan2', 'shuming2', 'allendc', 'saurabhchem09', 'ehsi', 'akozych2', 'ggracevr', 'frasheski', 'myl3', 'phamleminhthong', 'kobocc1994', 'ajhorvath', 'zouhaox', 'jarodm2', 'jerry0075566', 'ldwillia', 'werforgerf4life', 'hregner2', 'masonpb2', 'reisnerd', 'mtobah2', 'dmcpher', 'mlodriguito', 'jbpeller', 'myrta', 'costalt', 'dmartinfernandezvald', 'asasa', 'blanzyt', 'jzhan142', 'kartikghosh2008', 'scc3', 'aapfel', 'rexkhan', 'avw2', 'optalmad', 'ollinebg', 'ssengupta3', 'pinea', 'snahe', 'restep2', 'asadncepc', 'mreed11', 'bebling', 'lenling', 'shirundo', 'ksallans', 'kcrawf', 'bcperki2', 'juliajh2', 'nahmoda2', 'ssmate', 'nikaren', 'jyhoff', 'brdemarc', 'rakam2', 'kyang37', 'dkatz4', 'shamilt3', 'ybeeker', 'higgin24', 'acleve', 'hf4', 'kmaxie', 'msross', 's.bikash', 'ahmadubuntu', 'herrerag', 'ryougijc', 'davisloen', 'dhruvtatke', 'mjoza2', 'rotenmax', 'claudsnd', 'rll2', 'eescudermilian', 'anfetre', 'dieguez999', 'artrinity', 'rishavc', 'liutif', 'dwangy', 'shawak', 'saxman25', 'brenrice', 'hgaudin', 'kph2', 'mccartnt', 'solayinka', 'woodjosh', 'jiwu2', 'jingyiw3', 'serenad', 'ckim123', 'kychui2', 'juliaeb2', 'mviksne', 'komen', 'amandnic', 'brokawat', 'iamavash', 'ftadros', 'lmorrissey', 'dkfkadbs304', 'grfedele', 'dplata2', 'zehuahe2', 'rlrob', 'yfchen87', 'pdstaubl', 'tdabney', 'tss3', 'dlee145', 'jcobolopez', 'healyjl', 'jaketh2', 'racotter', 'apdoyle', 'cjbmi', 'hteutsch', 'joshua.leveillee', 'katferg', 'kjfrank2', 'dshah515', 'cpassolano', 'tbarang', 'cintroli', 'ellenrf2', 'reedy', 'jinsup2', 'lmeddaugh', 'tmarkiew', 'kli47', 'isaxton2', 'mattfuentez10', 'staceyn2', 'danevans', 'jeilers', 'nsk2', 'yzhou91', 'ychen261', 'clindn', 'stapleton3', 'rrwilson', 'stu', 'sili5', 'jmjin2', 'amroe', 'joseam2', 'ialonsogago', 'jkern3', 'saegner2', 'mayank4551', 'haileymk', 'sayanr', 'umana2', 'pranjal3', 'travisc2', 'scollard', 'bhliu97', 'ollorentemartija', 'tobias.m.egle', 'kfurbee2', 'shea.costner', 'bharath3', 'ojovinomarques', 'cdonahu', 'eraeker', 'narceci', 'zhixin2', 'tarnsangprad', 'barbaraldoriga5', 'kenmp', 'khazanv2', 'yhu55', 'coderko3', 'baohl2', 'mengkem2', 'cdrewery', 'ccafmeye', 'moralist', 'mgratows', 'jepi', 'vkov', 'annakcha', 'leveill2', 'jojoco', 'jinwoo2', 'chinmayanandadm', 'aalmohri', 'tecatetrav', 'avibreg', 'lwight']"
4,70,167,31,29,"['clindn', 'pinea', 'serenad', 'malhark', 'ksallans', 'haileymk', 'apielack', 'brdemarc', 'ybeeker', 'eraeker', 'allendc', 'ehsi', 'ggracevr', 'hteutsch', 'rotenmax', 'zouhaox', 'cjbmi', 'rishavc', 'liutif', 'jepi', 'reedy', 'annakcha', 'mgratows', 'dwangy', 'jojoco', 'brenrice', 'hgaudin', 'blanzyt', 'avibreg']",138,"['ehai1234', 'llsloan55555', 'alexshaw', 'lrhamp', 'arehman4', 'jhardi9', 'fphender', 'ggmorrow', 'xzhan147', 'krislew', 'qzhang', 'alexzimm', 'cjmichae', 'wbumbaca', 'deanjac99', 'sebmuraru', 'mirandamiao', 'monisanchezblanco', 'maymephilbrick', 'liannaldo007', 'saurabhchem09', 'frasheski', 'phamleminhthong', 'kobocc1994', 'ajhorvath', 'jerry0075566', 'ldwillia', 'werforgerf4life', 'hregner2', 'reisnerd', 'dmcpher', 'mlodriguito', 'jbpeller', 'myrta', 'costalt', 'dmartinfernandezvald', 'asasa', 'kartikghosh2008', 'aapfel', 'rexkhan', 'optalmad', 'ollinebg', 'ssengupta3', 'snahe', 'asadncepc', 'mreed11', 'bebling', 'lenling', 'shirundo', 'kcrawf', 'ssmate', 'nikaren', 'jyhoff', 'dkatz4', 'shamilt3', 'higgin24', 'acleve', 'kmaxie', 'msross', 's.bikash', 'ahmadubuntu', 'herrerag', 'ryougijc', 'davisloen', 'dhruvtatke', 'claudsnd', 'eescudermilian', 'anfetre', 'dieguez999', 'artrinity', 'shawak', 'saxman25', 'mccartnt', 'solayinka', 'woodjosh', 'mviksne', 'komen', 'amandnic', 'brokawat', 'iamavash', 'ftadros', 'lmorrissey', 'dkfkadbs304', 'grfedele', 'rlrob', 'yfchen87', 'pdstaubl', 'tdabney', 'jcobolopez', 'healyjl', 'jaketh2', 'racotter', 'apdoyle', 'katferg', 'kjfrank2', 'dshah515', 'cpassolano', 'tbarang', 'cintroli', 'lmeddaugh', 'tmarkiew', 'kli47', 'mattfuentez10', 'danevans', 'jeilers', 'nsk2', 'yzhou91', 'ychen261', 'stapleton3', 'rrwilson', 'stu', 'amroe', 'joseam2', 'ialonsogago', 'jkern3', 'mayank4551', 'sayanr', 'umana2', 'scollard', 'ollorentemartija', 'tobias.m.egle', 'shea.costner', 'ojovinomarques', 'cdonahu', 'narceci', 'tarnsangprad', 'barbaraldoriga5', 'kenmp', 'yhu55', 'cdrewery', 'ccafmeye', 'moralist', 'vkov', 'leveill2', 'chinmayanandadm', 'aalmohri', 'tecatetrav', 'lwight']",2,"['leovall', 'mphilbri']",169,"['ehai1234', 'llsloan55555', 'alexshaw', 'lrhamp', 'arehman4', 'jhardi9', 'fphender', 'ggmorrow', 'xzhan147', 'malhark', 'mphilbri', 'krislew', 'apielack', 'qzhang', 'alexzimm', 'cjmichae', 'wbumbaca', 'deanjac99', 'sebmuraru', 'mirandamiao', 'monisanchezblanco', 'maymephilbrick', 'liannaldo007', 'allendc', 'saurabhchem09', 'ehsi', 'ggracevr', 'frasheski', 'phamleminhthong', 'kobocc1994', 'ajhorvath', 'zouhaox', 'jerry0075566', 'ldwillia', 'werforgerf4life', 'hregner2', 'reisnerd', 'dmcpher', 'mlodriguito', 'jbpeller', 'myrta', 'costalt', 'dmartinfernandezvald', 'asasa', 'blanzyt', 'kartikghosh2008', 'aapfel', 'rexkhan', 'optalmad', 'ollinebg', 'ssengupta3', 'pinea', 'snahe', 'asadncepc', 'mreed11', 'bebling', 'lenling', 'shirundo', 'ksallans', 'kcrawf', 'ssmate', 'nikaren', 'jyhoff', 'brdemarc', 'dkatz4', 'shamilt3', 'ybeeker', 'higgin24', 'acleve', 'kmaxie', 'msross', 's.bikash', 'ahmadubuntu', 'herrerag', 'ryougijc', 'davisloen', 'dhruvtatke', 'rotenmax', 'claudsnd', 'eescudermilian', 'anfetre', 'dieguez999', 'artrinity', 'rishavc', 'liutif', 'dwangy', 'leovall', 'shawak', 'saxman25', 'brenrice', 'hgaudin', 'mccartnt', 'solayinka', 'woodjosh', 'serenad', 'mviksne', 'komen', 'amandnic', 'brokawat', 'iamavash', 'ftadros', 'lmorrissey', 'dkfkadbs304', 'grfedele', 'rlrob', 'yfchen87', 'pdstaubl', 'tdabney', 'jcobolopez', 'healyjl', 'jaketh2', 'racotter', 'apdoyle', 'cjbmi', 'hteutsch', 'katferg', 'kjfrank2', 'dshah515', 'cpassolano', 'tbarang', 'cintroli', 'reedy', 'lmeddaugh', 'tmarkiew', 'kli47', 'mattfuentez10', 'danevans', 'jeilers', 'nsk2', 'yzhou91', 'ychen261', 'clindn', 'stapleton3', 'rrwilson', 'stu', 'amroe', 'joseam2', 'ialonsogago', 'jkern3', 'mayank4551', 'haileymk', 'sayanr', 'umana2', 'scollard', 'ollorentemartija', 'tobias.m.egle', 'shea.costner', 'ojovinomarques', 'cdonahu', 'eraeker', 'narceci', 'tarnsangprad', 'barbaraldoriga5', 'kenmp', 'yhu55', 'cdrewery', 'ccafmeye', 'moralist', 'mgratows', 'jepi', 'vkov', 'annakcha', 'leveill2', 'jojoco', 'chinmayanandadm', 'aalmohri', 'tecatetrav', 'avibreg', 'lwight']"
4,69,167,20,13,"['stapleton3', 'wbumbaca', 'tdabney', 'lmeddaugh', 'komen', 'dkatz4', 'lenling', 'frasheski', 'jkern3', 'ajhorvath', 'lmorrissey', 'umana2', 'tarnsangprad']",154,"['ehai1234', 'llsloan55555', 'alexshaw', 'lrhamp', 'arehman4', 'jhardi9', 'fphender', 'ggmorrow', 'xzhan147', 'malhark', 'krislew', 'apielack', 'qzhang', 'alexzimm', 'cjmichae', 'deanjac99', 'sebmuraru', 'mirandamiao', 'monisanchezblanco', 'maymephilbrick', 'liannaldo007', 'allendc', 'saurabhchem09', 'ehsi', 'ggracevr', 'phamleminhthong', 'kobocc1994', 'zouhaox', 'jerry0075566', 'ldwillia', 'werforgerf4life', 'hregner2', 'reisnerd', 'dmcpher', 'mlodriguito', 'jbpeller', 'myrta', 'costalt', 'dmartinfernandezvald', 'asasa', 'blanzyt', 'kartikghosh2008', 'aapfel', 'rexkhan', 'optalmad', 'ollinebg', 'ssengupta3', 'pinea', 'snahe', 'asadncepc', 'mreed11', 'bebling', 'shirundo', 'ksallans', 'kcrawf', 'ssmate', 'nikaren', 'jyhoff', 'brdemarc', 'shamilt3', 'ybeeker', 'higgin24', 'acleve', 'kmaxie', 'msross', 's.bikash', 'ahmadubuntu', 'herrerag', 'ryougijc', 'davisloen', 'dhruvtatke', 'rotenmax', 'claudsnd', 'eescudermilian', 'anfetre', 'dieguez999', 'artrinity', 'rishavc', 'liutif', 'dwangy', 'shawak', 'saxman25', 'brenrice', 'hgaudin', 'mccartnt', 'solayinka', 'woodjosh', 'serenad', 'mviksne', 'amandnic', 'brokawat', 'iamavash', 'ftadros', 'dkfkadbs304', 'grfedele', 'rlrob', 'yfchen87', 'pdstaubl', 'jcobolopez', 'healyjl', 'jaketh2', 'racotter', 'apdoyle', 'cjbmi', 'hteutsch', 'katferg', 'kjfrank2', 'dshah515', 'cpassolano', 'tbarang', 'cintroli', 'reedy', 'tmarkiew', 'kli47', 'mattfuentez10', 'danevans', 'jeilers', 'nsk2', 'yzhou91', 'ychen261', 'clindn', 'rrwilson', 'stu', 'amroe', 'joseam2', 'ialonsogago', 'mayank4551', 'haileymk', 'sayanr', 'scollard', 'ollorentemartija', 'tobias.m.egle', 'shea.costner', 'ojovinomarques', 'cdonahu', 'eraeker', 'narceci', 'barbaraldoriga5', 'kenmp', 'yhu55', 'cdrewery', 'ccafmeye', 'moralist', 'mgratows', 'jepi', 'vkov', 'annakcha', 'leveill2', 'jojoco', 'chinmayanandadm', 'aalmohri', 'tecatetrav', 'avibreg', 'lwight']",7,"['dcai22', 'zhr5513', 'moldrem', 'pathare2', 'silha2', 'gli92', 'ddmorgan']",174,"['ehai1234', 'llsloan55555', 'alexshaw', 'lrhamp', 'arehman4', 'jhardi9', 'fphender', 'ggmorrow', 'xzhan147', 'malhark', 'krislew', 'ddmorgan', 'apielack', 'qzhang', 'alexzimm', 'cjmichae', 'wbumbaca', 'deanjac99', 'moldrem', 'sebmuraru', 'mirandamiao', 'monisanchezblanco', 'maymephilbrick', 'liannaldo007', 'allendc', 'saurabhchem09', 'ehsi', 'ggracevr', 'frasheski', 'phamleminhthong', 'kobocc1994', 'ajhorvath', 'zouhaox', 'jerry0075566', 'ldwillia', 'werforgerf4life', 'hregner2', 'reisnerd', 'zhr5513', 'dmcpher', 'mlodriguito', 'jbpeller', 'myrta', 'costalt', 'dmartinfernandezvald', 'asasa', 'blanzyt', 'kartikghosh2008', 'aapfel', 'rexkhan', 'optalmad', 'ollinebg', 'ssengupta3', 'pinea', 'snahe', 'asadncepc', 'mreed11', 'bebling', 'lenling', 'shirundo', 'ksallans', 'kcrawf', 'ssmate', 'nikaren', 'jyhoff', 'brdemarc', 'dkatz4', 'shamilt3', 'ybeeker', 'higgin24', 'acleve', 'kmaxie', 'msross', 's.bikash', 'ahmadubuntu', 'herrerag', 'ryougijc', 'davisloen', 'dhruvtatke', 'rotenmax', 'claudsnd', 'eescudermilian', 'anfetre', 'dieguez999', 'artrinity', 'rishavc', 'liutif', 'dwangy', 'shawak', 'saxman25', 'brenrice', 'hgaudin', 'mccartnt', 'solayinka', 'woodjosh', 'serenad', 'dcai22', 'mviksne', 'komen', 'amandnic', 'brokawat', 'iamavash', 'ftadros', 'lmorrissey', 'dkfkadbs304', 'grfedele', 'rlrob', 'yfchen87', 'pdstaubl', 'tdabney', 'jcobolopez', 'healyjl', 'jaketh2', 'racotter', 'apdoyle', 'cjbmi', 'hteutsch', 'pathare2', 'katferg', 'silha2', 'kjfrank2', 'dshah515', 'cpassolano', 'tbarang', 'cintroli', 'reedy', 'lmeddaugh', 'tmarkiew', 'kli47', 'mattfuentez10', 'danevans', 'jeilers', 'nsk2', 'yzhou91', 'ychen261', 'clindn', 'stapleton3', 'rrwilson', 'stu', 'amroe', 'joseam2', 'ialonsogago', 'jkern3', 'mayank4551', 'haileymk', 'sayanr', 'umana2', 'scollard', 'ollorentemartija', 'tobias.m.egle', 'shea.costner', 'ojovinomarques', 'cdonahu', 'eraeker', 'narceci', 'tarnsangprad', 'barbaraldoriga5', 'kenmp', 'yhu55', 'gli92', 'cdrewery', 'ccafmeye', 'moralist', 'mgratows', 'jepi', 'vkov', 'annakcha', 'leveill2', 'jojoco', 'chinmayanandadm', 'aalmohri', 'tecatetrav', 'avibreg', 'lwight']"
4,74,167,11,3,"['davisloen', 'racotter', 'tecatetrav']",164,"['ehai1234', 'llsloan55555', 'alexshaw', 'lrhamp', 'arehman4', 'jhardi9', 'fphender', 'ggmorrow', 'xzhan147', 'malhark', 'krislew', 'apielack', 'qzhang', 'alexzimm', 'cjmichae', 'wbumbaca', 'deanjac99', 'sebmuraru', 'mirandamiao', 'monisanchezblanco', 'maymephilbrick', 'liannaldo007', 'allendc', 'saurabhchem09', 'ehsi', 'ggracevr', 'frasheski', 'phamleminhthong', 'kobocc1994', 'ajhorvath', 'zouhaox', 'jerry0075566', 'ldwillia', 'werforgerf4life', 'hregner2', 'reisnerd', 'dmcpher', 'mlodriguito', 'jbpeller', 'myrta', 'costalt', 'dmartinfernandezvald', 'asasa', 'blanzyt', 'kartikghosh2008', 'aapfel', 'rexkhan', 'optalmad', 'ollinebg', 'ssengupta3', 'pinea', 'snahe', 'asadncepc', 'mreed11', 'bebling', 'lenling', 'shirundo', 'ksallans', 'kcrawf', 'ssmate', 'nikaren', 'jyhoff', 'brdemarc', 'dkatz4', 'shamilt3', 'ybeeker', 'higgin24', 'acleve', 'kmaxie', 'msross', 's.bikash', 'ahmadubuntu', 'herrerag', 'ryougijc', 'dhruvtatke', 'rotenmax', 'claudsnd', 'eescudermilian', 'anfetre', 'dieguez999', 'artrinity', 'rishavc', 'liutif', 'dwangy', 'shawak', 'saxman25', 'brenrice', 'hgaudin', 'mccartnt', 'solayinka', 'woodjosh', 'serenad', 'mviksne', 'komen', 'amandnic', 'brokawat', 'iamavash', 'ftadros', 'lmorrissey', 'dkfkadbs304', 'grfedele', 'rlrob', 'yfchen87', 'pdstaubl', 'tdabney', 'jcobolopez', 'healyjl', 'jaketh2', 'apdoyle', 'cjbmi', 'hteutsch', 'katferg', 'kjfrank2', 'dshah515', 'cpassolano', 'tbarang', 'cintroli', 'reedy', 'lmeddaugh', 'tmarkiew', 'kli47', 'mattfuentez10', 'danevans', 'jeilers', 'nsk2', 'yzhou91', 'ychen261', 'clindn', 'stapleton3', 'rrwilson', 'stu', 'amroe', 'joseam2', 'ialonsogago', 'jkern3', 'mayank4551', 'haileymk', 'sayanr', 'umana2', 'scollard', 'ollorentemartija', 'tobias.m.egle', 'shea.costner', 'ojovinomarques', 'cdonahu', 'eraeker', 'narceci', 'tarnsangprad', 'barbaraldoriga5', 'kenmp', 'yhu55', 'cdrewery', 'ccafmeye', 'moralist', 'mgratows', 'jepi', 'vkov', 'annakcha', 'leveill2', 'jojoco', 'chinmayanandadm', 'aalmohri', 'avibreg', 'lwight']",8,"['iblackbu', 'jhulfach', 'eoreste', 'surfingslow', 'lbagbyy', 'mbkivy', 'benjaminvf', 'thomas.s.busse']",175,"['ehai1234', 'llsloan55555', 'alexshaw', 'lrhamp', 'arehman4', 'jhardi9', 'fphender', 'ggmorrow', 'xzhan147', 'iblackbu', 'malhark', 'krislew', 'apielack', 'qzhang', 'alexzimm', 'cjmichae', 'wbumbaca', 'surfingslow', 'deanjac99', 'sebmuraru', 'mirandamiao', 'monisanchezblanco', 'maymephilbrick', 'liannaldo007', 'allendc', 'saurabhchem09', 'ehsi', 'ggracevr', 'frasheski', 'phamleminhthong', 'kobocc1994', 'ajhorvath', 'zouhaox', 'jerry0075566', 'ldwillia', 'werforgerf4life', 'hregner2', 'reisnerd', 'dmcpher', 'mlodriguito', 'jbpeller', 'myrta', 'costalt', 'dmartinfernandezvald', 'asasa', 'blanzyt', 'kartikghosh2008', 'aapfel', 'rexkhan', 'optalmad', 'ollinebg', 'ssengupta3', 'pinea', 'snahe', 'asadncepc', 'mreed11', 'bebling', 'lenling', 'shirundo', 'ksallans', 'kcrawf', 'ssmate', 'nikaren', 'jyhoff', 'brdemarc', 'dkatz4', 'shamilt3', 'ybeeker', 'higgin24', 'acleve', 'kmaxie', 'msross', 's.bikash', 'ahmadubuntu', 'herrerag', 'ryougijc', 'davisloen', 'dhruvtatke', 'rotenmax', 'claudsnd', 'eescudermilian', 'anfetre', 'dieguez999', 'artrinity', 'rishavc', 'liutif', 'jhulfach', 'dwangy', 'shawak', 'saxman25', 'brenrice', 'hgaudin', 'mccartnt', 'solayinka', 'woodjosh', 'thomas.s.busse', 'serenad', 'mviksne', 'komen', 'amandnic', 'brokawat', 'benjaminvf', 'iamavash', 'ftadros', 'lmorrissey', 'dkfkadbs304', 'grfedele', 'rlrob', 'yfchen87', 'pdstaubl', 'tdabney', 'jcobolopez', 'healyjl', 'jaketh2', 'racotter', 'apdoyle', 'cjbmi', 'hteutsch', 'katferg', 'kjfrank2', 'dshah515', 'lbagbyy', 'cpassolano', 'tbarang', 'cintroli', 'reedy', 'lmeddaugh', 'tmarkiew', 'kli47', 'mattfuentez10', 'danevans', 'jeilers', 'nsk2', 'yzhou91', 'ychen261', 'clindn', 'stapleton3', 'rrwilson', 'stu', 'eoreste', 'amroe', 'joseam2', 'mbkivy', 'ialonsogago', 'jkern3', 'mayank4551', 'haileymk', 'sayanr', 'umana2', 'scollard', 'ollorentemartija', 'tobias.m.egle', 'shea.costner', 'ojovinomarques', 'cdonahu', 'eraeker', 'narceci', 'tarnsangprad', 'barbaraldoriga5', 'kenmp', 'yhu55', 'cdrewery', 'ccafmeye', 'moralist', 'mgratows', 'jepi', 'vkov', 'annakcha', 'leveill2', 'jojoco', 'chinmayanandadm', 'aalmohri', 'tecatetrav', 'avibreg', 'lwight']"
4,48,167,10,8,"['ggmorrow', 'jyhoff', 'acleve', 'shawak', 'bebling', 'amroe', 'aalmohri', 'mccartnt']",159,"['ehai1234', 'llsloan55555', 'alexshaw', 'lrhamp', 'arehman4', 'jhardi9', 'fphender', 'xzhan147', 'malhark', 'krislew', 'apielack', 'qzhang', 'alexzimm', 'cjmichae', 'wbumbaca', 'deanjac99', 'sebmuraru', 'mirandamiao', 'monisanchezblanco', 'maymephilbrick', 'liannaldo007', 'allendc', 'saurabhchem09', 'ehsi', 'ggracevr', 'frasheski', 'phamleminhthong', 'kobocc1994', 'ajhorvath', 'zouhaox', 'jerry0075566', 'ldwillia', 'werforgerf4life', 'hregner2', 'reisnerd', 'dmcpher', 'mlodriguito', 'jbpeller', 'myrta', 'costalt', 'dmartinfernandezvald', 'asasa', 'blanzyt', 'kartikghosh2008', 'aapfel', 'rexkhan', 'optalmad', 'ollinebg', 'ssengupta3', 'pinea', 'snahe', 'asadncepc', 'mreed11', 'lenling', 'shirundo', 'ksallans', 'kcrawf', 'ssmate', 'nikaren', 'brdemarc', 'dkatz4', 'shamilt3', 'ybeeker', 'higgin24', 'kmaxie', 'msross', 's.bikash', 'ahmadubuntu', 'herrerag', 'ryougijc', 'davisloen', 'dhruvtatke', 'rotenmax', 'claudsnd', 'eescudermilian', 'anfetre', 'dieguez999', 'artrinity', 'rishavc', 'liutif', 'dwangy', 'saxman25', 'brenrice', 'hgaudin', 'solayinka', 'woodjosh', 'serenad', 'mviksne', 'komen', 'amandnic', 'brokawat', 'iamavash', 'ftadros', 'lmorrissey', 'dkfkadbs304', 'grfedele', 'rlrob', 'yfchen87', 'pdstaubl', 'tdabney', 'jcobolopez', 'healyjl', 'jaketh2', 'racotter', 'apdoyle', 'cjbmi', 'hteutsch', 'katferg', 'kjfrank2', 'dshah515', 'cpassolano', 'tbarang', 'cintroli', 'reedy', 'lmeddaugh', 'tmarkiew', 'kli47', 'mattfuentez10', 'danevans', 'jeilers', 'nsk2', 'yzhou91', 'ychen261', 'clindn', 'stapleton3', 'rrwilson', 'stu', 'joseam2', 'ialonsogago', 'jkern3', 'mayank4551', 'haileymk', 'sayanr', 'umana2', 'scollard', 'ollorentemartija', 'tobias.m.egle', 'shea.costner', 'ojovinomarques', 'cdonahu', 'eraeker', 'narceci', 'tarnsangprad', 'barbaraldoriga5', 'kenmp', 'yhu55', 'cdrewery', 'ccafmeye', 'moralist', 'mgratows', 'jepi', 'vkov', 'annakcha', 'leveill2', 'jojoco', 'chinmayanandadm', 'tecatetrav', 'avibreg', 'lwight']",2,"['rebschro', 'kpgreenm']",169,"['ehai1234', 'llsloan55555', 'alexshaw', 'lrhamp', 'arehman4', 'jhardi9', 'fphender', 'ggmorrow', 'xzhan147', 'malhark', 'kpgreenm', 'krislew', 'apielack', 'qzhang', 'alexzimm', 'cjmichae', 'wbumbaca', 'deanjac99', 'sebmuraru', 'mirandamiao', 'monisanchezblanco', 'maymephilbrick', 'liannaldo007', 'allendc', 'saurabhchem09', 'rebschro', 'ehsi', 'ggracevr', 'frasheski', 'phamleminhthong', 'kobocc1994', 'ajhorvath', 'zouhaox', 'jerry0075566', 'ldwillia', 'werforgerf4life', 'hregner2', 'reisnerd', 'dmcpher', 'mlodriguito', 'jbpeller', 'myrta', 'costalt', 'dmartinfernandezvald', 'asasa', 'blanzyt', 'kartikghosh2008', 'aapfel', 'rexkhan', 'optalmad', 'ollinebg', 'ssengupta3', 'pinea', 'snahe', 'asadncepc', 'mreed11', 'bebling', 'lenling', 'shirundo', 'ksallans', 'kcrawf', 'ssmate', 'nikaren', 'jyhoff', 'brdemarc', 'dkatz4', 'shamilt3', 'ybeeker', 'higgin24', 'acleve', 'kmaxie', 'msross', 's.bikash', 'ahmadubuntu', 'herrerag', 'ryougijc', 'davisloen', 'dhruvtatke', 'rotenmax', 'claudsnd', 'eescudermilian', 'anfetre', 'dieguez999', 'artrinity', 'rishavc', 'liutif', 'dwangy', 'shawak', 'saxman25', 'brenrice', 'hgaudin', 'mccartnt', 'solayinka', 'woodjosh', 'serenad', 'mviksne', 'komen', 'amandnic', 'brokawat', 'iamavash', 'ftadros', 'lmorrissey', 'dkfkadbs304', 'grfedele', 'rlrob', 'yfchen87', 'pdstaubl', 'tdabney', 'jcobolopez', 'healyjl', 'jaketh2', 'racotter', 'apdoyle', 'cjbmi', 'hteutsch', 'katferg', 'kjfrank2', 'dshah515', 'cpassolano', 'tbarang', 'cintroli', 'reedy', 'lmeddaugh', 'tmarkiew', 'kli47', 'mattfuentez10', 'danevans', 'jeilers', 'nsk2', 'yzhou91', 'ychen261', 'clindn', 'stapleton3', 'rrwilson', 'stu', 'amroe', 'joseam2', 'ialonsogago', 'jkern3', 'mayank4551', 'haileymk', 'sayanr', 'umana2', 'scollard', 'ollorentemartija', 'tobias.m.egle', 'shea.costner', 'ojovinomarques', 'cdonahu', 'eraeker', 'narceci', 'tarnsangprad', 'barbaraldoriga5', 'kenmp', 'yhu55', 'cdrewery', 'ccafmeye', 'moralist', 'mgratows', 'jepi', 'vkov', 'annakcha', 'leveill2', 'jojoco', 'chinmayanandadm', 'aalmohri', 'tecatetrav', 'avibreg', 'lwight']"
4,75,167,10,9,"['anfetre', 'rlrob', 'jyhoff', 'acleve', 'shawak', 'bebling', 'amroe', 'aalmohri', 'mccartnt']",158,"['ehai1234', 'llsloan55555', 'alexshaw', 'lrhamp', 'arehman4', 'jhardi9', 'fphender', 'ggmorrow', 'xzhan147', 'malhark', 'krislew', 'apielack', 'qzhang', 'alexzimm', 'cjmichae', 'wbumbaca', 'deanjac99', 'sebmuraru', 'mirandamiao', 'monisanchezblanco', 'maymephilbrick', 'liannaldo007', 'allendc', 'saurabhchem09', 'ehsi', 'ggracevr', 'frasheski', 'phamleminhthong', 'kobocc1994', 'ajhorvath', 'zouhaox', 'jerry0075566', 'ldwillia', 'werforgerf4life', 'hregner2', 'reisnerd', 'dmcpher', 'mlodriguito', 'jbpeller', 'myrta', 'costalt', 'dmartinfernandezvald', 'asasa', 'blanzyt', 'kartikghosh2008', 'aapfel', 'rexkhan', 'optalmad', 'ollinebg', 'ssengupta3', 'pinea', 'snahe', 'asadncepc', 'mreed11', 'lenling', 'shirundo', 'ksallans', 'kcrawf', 'ssmate', 'nikaren', 'brdemarc', 'dkatz4', 'shamilt3', 'ybeeker', 'higgin24', 'kmaxie', 'msross', 's.bikash', 'ahmadubuntu', 'herrerag', 'ryougijc', 'davisloen', 'dhruvtatke', 'rotenmax', 'claudsnd', 'eescudermilian', 'dieguez999', 'artrinity', 'rishavc', 'liutif', 'dwangy', 'saxman25', 'brenrice', 'hgaudin', 'solayinka', 'woodjosh', 'serenad', 'mviksne', 'komen', 'amandnic', 'brokawat', 'iamavash', 'ftadros', 'lmorrissey', 'dkfkadbs304', 'grfedele', 'yfchen87', 'pdstaubl', 'tdabney', 'jcobolopez', 'healyjl', 'jaketh2', 'racotter', 'apdoyle', 'cjbmi', 'hteutsch', 'katferg', 'kjfrank2', 'dshah515', 'cpassolano', 'tbarang', 'cintroli', 'reedy', 'lmeddaugh', 'tmarkiew', 'kli47', 'mattfuentez10', 'danevans', 'jeilers', 'nsk2', 'yzhou91', 'ychen261', 'clindn', 'stapleton3', 'rrwilson', 'stu', 'joseam2', 'ialonsogago', 'jkern3', 'mayank4551', 'haileymk', 'sayanr', 'umana2', 'scollard', 'ollorentemartija', 'tobias.m.egle', 'shea.costner', 'ojovinomarques', 'cdonahu', 'eraeker', 'narceci', 'tarnsangprad', 'barbaraldoriga5', 'kenmp', 'yhu55', 'cdrewery', 'ccafmeye', 'moralist', 'mgratows', 'jepi', 'vkov', 'annakcha', 'leveill2', 'jojoco', 'chinmayanandadm', 'tecatetrav', 'avibreg', 'lwight']",1,['dsfrei'],168,"['ehai1234', 'llsloan55555', 'alexshaw', 'lrhamp', 'arehman4', 'jhardi9', 'fphender', 'ggmorrow', 'xzhan147', 'malhark', 'krislew', 'apielack', 'qzhang', 'alexzimm', 'cjmichae', 'wbumbaca', 'deanjac99', 'sebmuraru', 'mirandamiao', 'monisanchezblanco', 'maymephilbrick', 'liannaldo007', 'allendc', 'saurabhchem09', 'ehsi', 'ggracevr', 'frasheski', 'phamleminhthong', 'kobocc1994', 'ajhorvath', 'zouhaox', 'jerry0075566', 'ldwillia', 'werforgerf4life', 'hregner2', 'reisnerd', 'dmcpher', 'mlodriguito', 'jbpeller', 'myrta', 'costalt', 'dmartinfernandezvald', 'asasa', 'blanzyt', 'kartikghosh2008', 'aapfel', 'rexkhan', 'optalmad', 'ollinebg', 'ssengupta3', 'pinea', 'snahe', 'asadncepc', 'mreed11', 'bebling', 'lenling', 'shirundo', 'ksallans', 'kcrawf', 'ssmate', 'nikaren', 'jyhoff', 'brdemarc', 'dkatz4', 'shamilt3', 'ybeeker', 'higgin24', 'acleve', 'kmaxie', 'msross', 's.bikash', 'ahmadubuntu', 'herrerag', 'ryougijc', 'davisloen', 'dhruvtatke', 'rotenmax', 'claudsnd', 'eescudermilian', 'anfetre', 'dieguez999', 'artrinity', 'rishavc', 'liutif', 'dwangy', 'shawak', 'saxman25', 'brenrice', 'hgaudin', 'mccartnt', 'solayinka', 'woodjosh', 'serenad', 'mviksne', 'komen', 'amandnic', 'brokawat', 'iamavash', 'ftadros', 'lmorrissey', 'dkfkadbs304', 'grfedele', 'rlrob', 'yfchen87', 'pdstaubl', 'tdabney', 'dsfrei', 'jcobolopez', 'healyjl', 'jaketh2', 'racotter', 'apdoyle', 'cjbmi', 'hteutsch', 'katferg', 'kjfrank2', 'dshah515', 'cpassolano', 'tbarang', 'cintroli', 'reedy', 'lmeddaugh', 'tmarkiew', 'kli47', 'mattfuentez10', 'danevans', 'jeilers', 'nsk2', 'yzhou91', 'ychen261', 'clindn', 'stapleton3', 'rrwilson', 'stu', 'amroe', 'joseam2', 'ialonsogago', 'jkern3', 'mayank4551', 'haileymk', 'sayanr', 'umana2', 'scollard', 'ollorentemartija', 'tobias.m.egle', 'shea.costner', 'ojovinomarques', 'cdonahu', 'eraeker', 'narceci', 'tarnsangprad', 'barbaraldoriga5', 'kenmp', 'yhu55', 'cdrewery', 'ccafmeye', 'moralist', 'mgratows', 'jepi', 'vkov', 'annakcha', 'leveill2', 'jojoco', 'chinmayanandadm', 'aalmohri', 'tecatetrav', 'avibreg', 'lwight']"
4,68,167,6,1,['myrta'],166,"['ehai1234', 'llsloan55555', 'alexshaw', 'lrhamp', 'arehman4', 'jhardi9', 'fphender', 'ggmorrow', 'xzhan147', 'malhark', 'krislew', 'apielack', 'qzhang', 'alexzimm', 'cjmichae', 'wbumbaca', 'deanjac99', 'sebmuraru', 'mirandamiao', 'monisanchezblanco', 'maymephilbrick', 'liannaldo007', 'allendc', 'saurabhchem09', 'ehsi', 'ggracevr', 'frasheski', 'phamleminhthong', 'kobocc1994', 'ajhorvath', 'zouhaox', 'jerry0075566', 'ldwillia', 'werforgerf4life', 'hregner2', 'reisnerd', 'dmcpher', 'mlodriguito', 'jbpeller', 'costalt', 'dmartinfernandezvald', 'asasa', 'blanzyt', 'kartikghosh2008', 'aapfel', 'rexkhan', 'optalmad', 'ollinebg', 'ssengupta3', 'pinea', 'snahe', 'asadncepc', 'mreed11', 'bebling', 'lenling', 'shirundo', 'ksallans', 'kcrawf', 'ssmate', 'nikaren', 'jyhoff', 'brdemarc', 'dkatz4', 'shamilt3', 'ybeeker', 'higgin24', 'acleve', 'kmaxie', 'msross', 's.bikash', 'ahmadubuntu', 'herrerag', 'ryougijc', 'davisloen', 'dhruvtatke', 'rotenmax', 'claudsnd', 'eescudermilian', 'anfetre', 'dieguez999', 'artrinity', 'rishavc', 'liutif', 'dwangy', 'shawak', 'saxman25', 'brenrice', 'hgaudin', 'mccartnt', 'solayinka', 'woodjosh', 'serenad', 'mviksne', 'komen', 'amandnic', 'brokawat', 'iamavash', 'ftadros', 'lmorrissey', 'dkfkadbs304', 'grfedele', 'rlrob', 'yfchen87', 'pdstaubl', 'tdabney', 'jcobolopez', 'healyjl', 'jaketh2', 'racotter', 'apdoyle', 'cjbmi', 'hteutsch', 'katferg', 'kjfrank2', 'dshah515', 'cpassolano', 'tbarang', 'cintroli', 'reedy', 'lmeddaugh', 'tmarkiew', 'kli47', 'mattfuentez10', 'danevans', 'jeilers', 'nsk2', 'yzhou91', 'ychen261', 'clindn', 'stapleton3', 'rrwilson', 'stu', 'amroe', 'joseam2', 'ialonsogago', 'jkern3', 'mayank4551', 'haileymk', 'sayanr', 'umana2', 'scollard', 'ollorentemartija', 'tobias.m.egle', 'shea.costner', 'ojovinomarques', 'cdonahu', 'eraeker', 'narceci', 'tarnsangprad', 'barbaraldoriga5', 'kenmp', 'yhu55', 'cdrewery', 'ccafmeye', 'moralist', 'mgratows', 'jepi', 'vkov', 'annakcha', 'leveill2', 'jojoco', 'chinmayanandadm', 'aalmohri', 'tecatetrav', 'avibreg', 'lwight']",5,"['ggreenediniz18', 'robbiemorrison1995', 'paguado', 'echo570', 'nataliapinirtzi']",172,"['ehai1234', 'llsloan55555', 'alexshaw', 'lrhamp', 'arehman4', 'jhardi9', 'fphender', 'ggmorrow', 'xzhan147', 'malhark', 'krislew', 'apielack', 'qzhang', 'alexzimm', 'cjmichae', 'wbumbaca', 'deanjac99', 'sebmuraru', 'mirandamiao', 'monisanchezblanco', 'maymephilbrick', 'liannaldo007', 'allendc', 'saurabhchem09', 'ehsi', 'ggracevr', 'frasheski', 'phamleminhthong', 'kobocc1994', 'ajhorvath', 'zouhaox', 'jerry0075566', 'ldwillia', 'werforgerf4life', 'hregner2', 'reisnerd', 'dmcpher', 'mlodriguito', 'jbpeller', 'myrta', 'costalt', 'dmartinfernandezvald', 'asasa', 'blanzyt', 'kartikghosh2008', 'aapfel', 'rexkhan', 'optalmad', 'ollinebg', 'ssengupta3', 'pinea', 'snahe', 'asadncepc', 'mreed11', 'bebling', 'lenling', 'shirundo', 'paguado', 'ksallans', 'kcrawf', 'ssmate', 'nikaren', 'jyhoff', 'brdemarc', 'dkatz4', 'shamilt3', 'ybeeker', 'higgin24', 'acleve', 'kmaxie', 'msross', 's.bikash', 'ahmadubuntu', 'herrerag', 'ryougijc', 'davisloen', 'dhruvtatke', 'rotenmax', 'claudsnd', 'eescudermilian', 'anfetre', 'dieguez999', 'artrinity', 'rishavc', 'liutif', 'dwangy', 'shawak', 'saxman25', 'brenrice', 'hgaudin', 'mccartnt', 'solayinka', 'woodjosh', 'serenad', 'mviksne', 'komen', 'amandnic', 'brokawat', 'iamavash', 'ftadros', 'lmorrissey', 'dkfkadbs304', 'grfedele', 'rlrob', 'yfchen87', 'pdstaubl', 'tdabney', 'echo570', 'jcobolopez', 'healyjl', 'ggreenediniz18', 'jaketh2', 'racotter', 'apdoyle', 'cjbmi', 'hteutsch', 'katferg', 'kjfrank2', 'dshah515', 'cpassolano', 'tbarang', 'cintroli', 'reedy', 'lmeddaugh', 'tmarkiew', 'kli47', 'mattfuentez10', 'danevans', 'jeilers', 'nsk2', 'yzhou91', 'ychen261', 'clindn', 'stapleton3', 'rrwilson', 'stu', 'amroe', 'joseam2', 'ialonsogago', 'jkern3', 'mayank4551', 'haileymk', 'sayanr', 'umana2', 'scollard', 'ollorentemartija', 'tobias.m.egle', 'shea.costner', 'ojovinomarques', 'cdonahu', 'eraeker', 'narceci', 'tarnsangprad', 'barbaraldoriga5', 'kenmp', 'yhu55', 'robbiemorrison1995', 'nataliapinirtzi', 'cdrewery', 'ccafmeye', 'moralist', 'mgratows', 'jepi', 'vkov', 'annakcha', 'leveill2', 'jojoco', 'chinmayanandadm', 'aalmohri', 'tecatetrav', 'avibreg', 'lwight']"
4,71,167,6,5,"['ssengupta3', 'arehman4', 'chinmayanandadm', 'jaketh2', 'brokawat']",162,"['ehai1234', 'llsloan55555', 'alexshaw', 'lrhamp', 'jhardi9', 'fphender', 'ggmorrow', 'xzhan147', 'malhark', 'krislew', 'apielack', 'qzhang', 'alexzimm', 'cjmichae', 'wbumbaca', 'deanjac99', 'sebmuraru', 'mirandamiao', 'monisanchezblanco', 'maymephilbrick', 'liannaldo007', 'allendc', 'saurabhchem09', 'ehsi', 'ggracevr', 'frasheski', 'phamleminhthong', 'kobocc1994', 'ajhorvath', 'zouhaox', 'jerry0075566', 'ldwillia', 'werforgerf4life', 'hregner2', 'reisnerd', 'dmcpher', 'mlodriguito', 'jbpeller', 'myrta', 'costalt', 'dmartinfernandezvald', 'asasa', 'blanzyt', 'kartikghosh2008', 'aapfel', 'rexkhan', 'optalmad', 'ollinebg', 'pinea', 'snahe', 'asadncepc', 'mreed11', 'bebling', 'lenling', 'shirundo', 'ksallans', 'kcrawf', 'ssmate', 'nikaren', 'jyhoff', 'brdemarc', 'dkatz4', 'shamilt3', 'ybeeker', 'higgin24', 'acleve', 'kmaxie', 'msross', 's.bikash', 'ahmadubuntu', 'herrerag', 'ryougijc', 'davisloen', 'dhruvtatke', 'rotenmax', 'claudsnd', 'eescudermilian', 'anfetre', 'dieguez999', 'artrinity', 'rishavc', 'liutif', 'dwangy', 'shawak', 'saxman25', 'brenrice', 'hgaudin', 'mccartnt', 'solayinka', 'woodjosh', 'serenad', 'mviksne', 'komen', 'amandnic', 'iamavash', 'ftadros', 'lmorrissey', 'dkfkadbs304', 'grfedele', 'rlrob', 'yfchen87', 'pdstaubl', 'tdabney', 'jcobolopez', 'healyjl', 'racotter', 'apdoyle', 'cjbmi', 'hteutsch', 'katferg', 'kjfrank2', 'dshah515', 'cpassolano', 'tbarang', 'cintroli', 'reedy', 'lmeddaugh', 'tmarkiew', 'kli47', 'mattfuentez10', 'danevans', 'jeilers', 'nsk2', 'yzhou91', 'ychen261', 'clindn', 'stapleton3', 'rrwilson', 'stu', 'amroe', 'joseam2', 'ialonsogago', 'jkern3', 'mayank4551', 'haileymk', 'sayanr', 'umana2', 'scollard', 'ollorentemartija', 'tobias.m.egle', 'shea.costner', 'ojovinomarques', 'cdonahu', 'eraeker', 'narceci', 'tarnsangprad', 'barbaraldoriga5', 'kenmp', 'yhu55', 'cdrewery', 'ccafmeye', 'moralist', 'mgratows', 'jepi', 'vkov', 'annakcha', 'leveill2', 'jojoco', 'aalmohri', 'tecatetrav', 'avibreg', 'lwight']",1,['zhixin2'],168,"['ehai1234', 'llsloan55555', 'alexshaw', 'lrhamp', 'arehman4', 'jhardi9', 'fphender', 'ggmorrow', 'xzhan147', 'malhark', 'krislew', 'apielack', 'qzhang', 'alexzimm', 'cjmichae', 'wbumbaca', 'deanjac99', 'sebmuraru', 'mirandamiao', 'monisanchezblanco', 'maymephilbrick', 'liannaldo007', 'allendc', 'saurabhchem09', 'ehsi', 'ggracevr', 'frasheski', 'phamleminhthong', 'kobocc1994', 'ajhorvath', 'zouhaox', 'jerry0075566', 'ldwillia', 'werforgerf4life', 'hregner2', 'reisnerd', 'dmcpher', 'mlodriguito', 'jbpeller', 'myrta', 'costalt', 'dmartinfernandezvald', 'asasa', 'blanzyt', 'kartikghosh2008', 'aapfel', 'rexkhan', 'optalmad', 'ollinebg', 'ssengupta3', 'pinea', 'snahe', 'asadncepc', 'mreed11', 'bebling', 'lenling', 'shirundo', 'ksallans', 'kcrawf', 'ssmate', 'nikaren', 'jyhoff', 'brdemarc', 'dkatz4', 'shamilt3', 'ybeeker', 'higgin24', 'acleve', 'kmaxie', 'msross', 's.bikash', 'ahmadubuntu', 'herrerag', 'ryougijc', 'davisloen', 'dhruvtatke', 'rotenmax', 'claudsnd', 'eescudermilian', 'anfetre', 'dieguez999', 'artrinity', 'rishavc', 'liutif', 'dwangy', 'shawak', 'saxman25', 'brenrice', 'hgaudin', 'mccartnt', 'solayinka', 'woodjosh', 'serenad', 'mviksne', 'komen', 'amandnic', 'brokawat', 'iamavash', 'ftadros', 'lmorrissey', 'dkfkadbs304', 'grfedele', 'rlrob', 'yfchen87', 'pdstaubl', 'tdabney', 'jcobolopez', 'healyjl', 'jaketh2', 'racotter', 'apdoyle', 'cjbmi', 'hteutsch', 'katferg', 'kjfrank2', 'dshah515', 'cpassolano', 'tbarang', 'cintroli', 'reedy', 'lmeddaugh', 'tmarkiew', 'kli47', 'mattfuentez10', 'danevans', 'jeilers', 'nsk2', 'yzhou91', 'ychen261', 'clindn', 'stapleton3', 'rrwilson', 'stu', 'amroe', 'joseam2', 'ialonsogago', 'jkern3', 'mayank4551', 'haileymk', 'sayanr', 'umana2', 'scollard', 'ollorentemartija', 'tobias.m.egle', 'shea.costner', 'ojovinomarques', 'cdonahu', 'eraeker', 'narceci', 'zhixin2', 'tarnsangprad', 'barbaraldoriga5', 'kenmp', 'yhu55', 'cdrewery', 'ccafmeye', 'moralist', 'mgratows', 'jepi', 'vkov', 'annakcha', 'leveill2', 'jojoco', 'chinmayanandadm', 'aalmohri', 'tecatetrav', 'avibreg', 'lwight']"
4,72,167,6,6,"['snahe', 'jepi', 'annakcha', 'ehsi', 'brenrice', 'blanzyt']",161,"['ehai1234', 'llsloan55555', 'alexshaw', 'lrhamp', 'arehman4', 'jhardi9', 'fphender', 'ggmorrow', 'xzhan147', 'malhark', 'krislew', 'apielack', 'qzhang', 'alexzimm', 'cjmichae', 'wbumbaca', 'deanjac99', 'sebmuraru', 'mirandamiao', 'monisanchezblanco', 'maymephilbrick', 'liannaldo007', 'allendc', 'saurabhchem09', 'ggracevr', 'frasheski', 'phamleminhthong', 'kobocc1994', 'ajhorvath', 'zouhaox', 'jerry0075566', 'ldwillia', 'werforgerf4life', 'hregner2', 'reisnerd', 'dmcpher', 'mlodriguito', 'jbpeller', 'myrta', 'costalt', 'dmartinfernandezvald', 'asasa', 'kartikghosh2008', 'aapfel', 'rexkhan', 'optalmad', 'ollinebg', 'ssengupta3', 'pinea', 'asadncepc', 'mreed11', 'bebling', 'lenling', 'shirundo', 'ksallans', 'kcrawf', 'ssmate', 'nikaren', 'jyhoff', 'brdemarc', 'dkatz4', 'shamilt3', 'ybeeker', 'higgin24', 'acleve', 'kmaxie', 'msross', 's.bikash', 'ahmadubuntu', 'herrerag', 'ryougijc', 'davisloen', 'dhruvtatke', 'rotenmax', 'claudsnd', 'eescudermilian', 'anfetre', 'dieguez999', 'artrinity', 'rishavc', 'liutif', 'dwangy', 'shawak', 'saxman25', 'hgaudin', 'mccartnt', 'solayinka', 'woodjosh', 'serenad', 'mviksne', 'komen', 'amandnic', 'brokawat', 'iamavash', 'ftadros', 'lmorrissey', 'dkfkadbs304', 'grfedele', 'rlrob', 'yfchen87', 'pdstaubl', 'tdabney', 'jcobolopez', 'healyjl', 'jaketh2', 'racotter', 'apdoyle', 'cjbmi', 'hteutsch', 'katferg', 'kjfrank2', 'dshah515', 'cpassolano', 'tbarang', 'cintroli', 'reedy', 'lmeddaugh', 'tmarkiew', 'kli47', 'mattfuentez10', 'danevans', 'jeilers', 'nsk2', 'yzhou91', 'ychen261', 'clindn', 'stapleton3', 'rrwilson', 'stu', 'amroe', 'joseam2', 'ialonsogago', 'jkern3', 'mayank4551', 'haileymk', 'sayanr', 'umana2', 'scollard', 'ollorentemartija', 'tobias.m.egle', 'shea.costner', 'ojovinomarques', 'cdonahu', 'eraeker', 'narceci', 'tarnsangprad', 'barbaraldoriga5', 'kenmp', 'yhu55', 'cdrewery', 'ccafmeye', 'moralist', 'mgratows', 'vkov', 'leveill2', 'jojoco', 'chinmayanandadm', 'aalmohri', 'tecatetrav', 'avibreg', 'lwight']",0,[],167,"['ehai1234', 'llsloan55555', 'alexshaw', 'lrhamp', 'arehman4', 'jhardi9', 'fphender', 'ggmorrow', 'xzhan147', 'malhark', 'krislew', 'apielack', 'qzhang', 'alexzimm', 'cjmichae', 'wbumbaca', 'deanjac99', 'sebmuraru', 'mirandamiao', 'monisanchezblanco', 'maymephilbrick', 'liannaldo007', 'allendc', 'saurabhchem09', 'ehsi', 'ggracevr', 'frasheski', 'phamleminhthong', 'kobocc1994', 'ajhorvath', 'zouhaox', 'jerry0075566', 'ldwillia', 'werforgerf4life', 'hregner2', 'reisnerd', 'dmcpher', 'mlodriguito', 'jbpeller', 'myrta', 'costalt', 'dmartinfernandezvald', 'asasa', 'blanzyt', 'kartikghosh2008', 'aapfel', 'rexkhan', 'optalmad', 'ollinebg', 'ssengupta3', 'pinea', 'snahe', 'asadncepc', 'mreed11', 'bebling', 'lenling', 'shirundo', 'ksallans', 'kcrawf', 'ssmate', 'nikaren', 'jyhoff', 'brdemarc', 'dkatz4', 'shamilt3', 'ybeeker', 'higgin24', 'acleve', 'kmaxie', 'msross', 's.bikash', 'ahmadubuntu', 'herrerag', 'ryougijc', 'davisloen', 'dhruvtatke', 'rotenmax', 'claudsnd', 'eescudermilian', 'anfetre', 'dieguez999', 'artrinity', 'rishavc', 'liutif', 'dwangy', 'shawak', 'saxman25', 'brenrice', 'hgaudin', 'mccartnt', 'solayinka', 'woodjosh', 'serenad', 'mviksne', 'komen', 'amandnic', 'brokawat', 'iamavash', 'ftadros', 'lmorrissey', 'dkfkadbs304', 'grfedele', 'rlrob', 'yfchen87', 'pdstaubl', 'tdabney', 'jcobolopez', 'healyjl', 'jaketh2', 'racotter', 'apdoyle', 'cjbmi', 'hteutsch', 'katferg', 'kjfrank2', 'dshah515', 'cpassolano', 'tbarang', 'cintroli', 'reedy', 'lmeddaugh', 'tmarkiew', 'kli47', 'mattfuentez10', 'danevans', 'jeilers', 'nsk2', 'yzhou91', 'ychen261', 'clindn', 'stapleton3', 'rrwilson', 'stu', 'amroe', 'joseam2', 'ialonsogago', 'jkern3', 'mayank4551', 'haileymk', 'sayanr', 'umana2', 'scollard', 'ollorentemartija', 'tobias.m.egle', 'shea.costner', 'ojovinomarques', 'cdonahu', 'eraeker', 'narceci', 'tarnsangprad', 'barbaraldoriga5', 'kenmp', 'yhu55', 'cdrewery', 'ccafmeye', 'moralist', 'mgratows', 'jepi', 'vkov', 'annakcha', 'leveill2', 'jojoco', 'chinmayanandadm', 'aalmohri', 'tecatetrav', 'avibreg', 'lwight']"
5,50,112,12,1,['bubleedas06'],111,"['michaelkraft1512', 'ayushkr997', 'fahimvora12', 'jacobpeterson698', 'hannahdeboer0015', 'hanmoyuan1997', 'saiadityav', 'swift8', 'draosmail', 'limasallesdesouza', 'iseguano28', 'batram197', 'ananddrishyam', 'reshmithomas', 'kellhages37', 'rtsaimail', 'fenixarn7', 'trevinon', 'evd15i019', 'adungey2', 'ssbasim', 'arran.yuan', 'ashishkanojia50', 'askrobis', 'stewa263', 'libardo11chapal', 'white519', 'lfeltner', 'jnewman0', 'premkhot5', 'rashida31', 'sasapu', 'groy56450', 'bradsmrdel', 'rkwiatko', 'ikstealth', 'tasnim19', 'esoar2000', 'ja.burgos', 'jolene2', 'akriti', 'dbbt2015', 'lucasrodriguez', 'arnoudonnink', 'ext2a96', 'champauzas', 'sandeep4442', 'cnichol', 'nowshinsharmily', 'paarthparekh2824', 'ichouqm', 'geravilla', 'davidgraham357', 'camilopereztovar', 'richardfanchina', 'jacob_just', 'greid09', 'nkpuga', 'drnnmurty', 'sammyknecht', 'royriveraf', 'kewlkahtz', 'evyn_routh', 'wallac68', 'josephel534', 'miqdadraza', 'aboza', 'hattan.abuzaid', 'nmcphero', 'dokekearu', 'richardzhang', 'liamarasta', 'danielpc76', 'kkripaka', 'dakshi88', 'aniver', 'kamranahmed', 'maddiexox25', 'haroonnishat27', 'spring12', 'ckroger', 'bgh6', 'k.ico246', 'tylera2104', 'rquardok1', 'wbaioni40', 'eddierules001', 'savannahlutz', 'sophivcool', 'sfgdfgdfg', 'k38f273', 'libin17', 'amnaya', 'mbsmith18', 'gideon01', 'akreilein', 'agarw105', 'aswinshaji', 'iqrosaura', 'sai.234', 'bendavaji', 'memoir56', 'f2016588', 'kapoor1439', 'bilvin', 'wdrummon', 'sharmarahul1597', 'luisafuentes19', 'festum01', 'raofthesun', 'pgarciav']",11,"['misbah3229', 'abirmamunurrahman', 'mazharulislamshuvosikder', 'akazad42801', 'mahi97', 'tahsin2239', 'johayraprithula', 'fahim78645', 'farhana14eshal', 'rivnatmihaf', 'kabirsinthi']",123,"['misbah3229', 'michaelkraft1512', 'ayushkr997', 'fahimvora12', 'jacobpeterson698', 'hannahdeboer0015', 'hanmoyuan1997', 'saiadityav', 'swift8', 'draosmail', 'limasallesdesouza', 'rivnatmihaf', 'iseguano28', 'batram197', 'ananddrishyam', 'reshmithomas', 'kellhages37', 'rtsaimail', 'fenixarn7', 'trevinon', 'evd15i019', 'adungey2', 'ssbasim', 'arran.yuan', 'ashishkanojia50', 'askrobis', 'stewa263', 'libardo11chapal', 'white519', 'lfeltner', 'jnewman0', 'premkhot5', 'rashida31', 'sasapu', 'groy56450', 'bradsmrdel', 'rkwiatko', 'ikstealth', 'tasnim19', 'esoar2000', 'mahi97', 'ja.burgos', 'jolene2', 'kabirsinthi', 'akriti', 'dbbt2015', 'lucasrodriguez', 'arnoudonnink', 'ext2a96', 'champauzas', 'bubleedas06', 'sandeep4442', 'cnichol', 'nowshinsharmily', 'paarthparekh2824', 'ichouqm', 'geravilla', 'davidgraham357', 'camilopereztovar', 'mazharulislamshuvosikder', 'richardfanchina', 'akazad42801', 'jacob_just', 'tahsin2239', 'greid09', 'nkpuga', 'drnnmurty', 'sammyknecht', 'royriveraf', 'kewlkahtz', 'evyn_routh', 'wallac68', 'josephel534', 'miqdadraza', 'aboza', 'hattan.abuzaid', 'nmcphero', 'dokekearu', 'farhana14eshal', 'richardzhang', 'liamarasta', 'danielpc76', 'kkripaka', 'dakshi88', 'aniver', 'kamranahmed', 'maddiexox25', 'haroonnishat27', 'spring12', 'ckroger', 'bgh6', 'k.ico246', 'tylera2104', 'rquardok1', 'wbaioni40', 'eddierules001', 'fahim78645', 'savannahlutz', 'sophivcool', 'sfgdfgdfg', 'k38f273', 'libin17', 'amnaya', 'mbsmith18', 'gideon01', 'akreilein', 'agarw105', 'aswinshaji', 'iqrosaura', 'sai.234', 'bendavaji', 'memoir56', 'f2016588', 'kapoor1439', 'bilvin', 'wdrummon', 'sharmarahul1597', 'abirmamunurrahman', 'luisafuentes19', 'johayraprithula', 'festum01', 'raofthesun', 'pgarciav']"
6,90,75,69,67,"['sun314618', 'lichenwang993', 'zhongpc', 'wyz', 'ryanzhang', 'fxxku', 'abruefach', 'tangyf', 'jimin_kim', 'ymengmandy', 'jenniferdonohue', 'rundongli', 'yuxl0722', 'cbcb512', 'zhuokaix', 'mattmcd1', 'zhengyanlun', 'jordanpburns13', 'msiron', 'pceralde', 'sarahywang', 'xiaoxi_huang', 'acrutt', 'jdagdelen', 'liuzhenghao', 'zengguobo', 'aaronschwartz77', 'zijiancai', 'ariannamaj', 'dogancansari', 'chris_shan', 'lym7820', 'karafong', 'qixi_chen', 'mariacfolg', 'yingzhi_sun', 'chemnius1', 'wuxinchun', 'jinhua96', 'evargo', 'clarissa', 'alvinakam', 'xinya_niu', 'justinxzhong', 'zjadidi', 'normanzy98', 'jiwenbo', 'wangshu16', 'yxy960524', 'cestellos_blanco', 'ouyangce', 'jordanphillipburns', 'paulceralde', 'xiaozhao', 'dogancansari1', 'caglar.tamur', 'nisarg_barot', 'luyaozhang420', 'ellisrae', 'mpsherb', 'kfctoday1121', 'yuchen0418', 'bengisu.sari', 'zjc710696154', 'samir.hossainy', 'nwinner', 'djay_kamat']",8,"['km3400', 'afa2117', 'dgl2126', 'jianzhou', 'edjiang', 'espottesmith', 'jtvardner', 'rcm2184']",2,"['tonyli', 'lrd19990503']",77,"['edjiang', 'wyz', 'ryanzhang', 'jimin_kim', 'ymengmandy', 'jenniferdonohue', 'km3400', 'jordanpburns13', 'msiron', 'pceralde', 'zengguobo', 'aaronschwartz77', 'dogancansari', 'dgl2126', 'chris_shan', 'karafong', 'yingzhi_sun', 'mariacfolg', 'chemnius1', 'wuxinchun', 'jtvardner', 'rcm2184', 'cestellos_blanco', 'jiwenbo', 'wangshu16', 'yxy960524', 'afa2117', 'tonyli', 'ouyangce', 'xiaozhao', 'paulceralde', 'dogancansari1', 'luyaozhang420', 'nisarg_barot', 'jianzhou', 'bengisu.sari', 'zjc710696154', 'samir.hossainy', 'lrd19990503', 'sun314618', 'lichenwang993', 'zhongpc', 'fxxku', 'abruefach', 'tangyf', 'rundongli', 'yuxl0722', 'zhuokaix', 'cbcb512', 'mattmcd1', 'zhengyanlun', 'sarahywang', 'xiaoxi_huang', 'acrutt', 'jdagdelen', 'liuzhenghao', 'zijiancai', 'ariannamaj', 'lym7820', 'qixi_chen', 'jinhua96', 'evargo', 'clarissa', 'alvinakam', 'espottesmith', 'xinya_niu', 'justinxzhong', 'zjadidi', 'normanzy98', 'jordanphillipburns', 'kfctoday1121', 'yuchen0418', 'caglar.tamur', 'ellisrae', 'mpsherb', 'nwinner', 'djay_kamat']"
6,91,75,7,7,"['km3400', 'afa2117', 'jianzhou', 'edjiang', 'espottesmith', 'jtvardner', 'rcm2184']",68,"['wyz', 'ryanzhang', 'jimin_kim', 'ymengmandy', 'jenniferdonohue', 'jordanpburns13', 'msiron', 'pceralde', 'zengguobo', 'aaronschwartz77', 'dogancansari', 'dgl2126', 'chris_shan', 'karafong', 'yingzhi_sun', 'mariacfolg', 'chemnius1', 'wuxinchun', 'cestellos_blanco', 'jiwenbo', 'wangshu16', 'yxy960524', 'ouyangce', 'xiaozhao', 'paulceralde', 'dogancansari1', 'luyaozhang420', 'nisarg_barot', 'bengisu.sari', 'zjc710696154', 'samir.hossainy', 'sun314618', 'lichenwang993', 'zhongpc', 'fxxku', 'abruefach', 'tangyf', 'rundongli', 'yuxl0722', 'zhuokaix', 'cbcb512', 'mattmcd1', 'zhengyanlun', 'sarahywang', 'xiaoxi_huang', 'acrutt', 'jdagdelen', 'liuzhenghao', 'zijiancai', 'ariannamaj', 'lym7820', 'qixi_chen', 'jinhua96', 'evargo', 'clarissa', 'alvinakam', 'xinya_niu', 'justinxzhong', 'zjadidi', 'normanzy98', 'jordanphillipburns', 'kfctoday1121', 'yuchen0418', 'caglar.tamur', 'ellisrae', 'mpsherb', 'nwinner', 'djay_kamat']",0,[],75,"['edjiang', 'wyz', 'ryanzhang', 'jimin_kim', 'ymengmandy', 'jenniferdonohue', 'km3400', 'jordanpburns13', 'msiron', 'pceralde', 'zengguobo', 'aaronschwartz77', 'dogancansari', 'dgl2126', 'chris_shan', 'karafong', 'yingzhi_sun', 'mariacfolg', 'chemnius1', 'wuxinchun', 'jtvardner', 'rcm2184', 'cestellos_blanco', 'jiwenbo', 'wangshu16', 'yxy960524', 'afa2117', 'ouyangce', 'xiaozhao', 'paulceralde', 'dogancansari1', 'luyaozhang420', 'nisarg_barot', 'jianzhou', 'bengisu.sari', 'zjc710696154', 'samir.hossainy', 'sun314618', 'lichenwang993', 'zhongpc', 'fxxku', 'abruefach', 'tangyf', 'rundongli', 'yuxl0722', 'zhuokaix', 'cbcb512', 'mattmcd1', 'zhengyanlun', 'sarahywang', 'xiaoxi_huang', 'acrutt', 'jdagdelen', 'liuzhenghao', 'zijiancai', 'ariannamaj', 'lym7820', 'qixi_chen', 'jinhua96', 'evargo', 'clarissa', 'alvinakam', 'espottesmith', 'xinya_niu', 'justinxzhong', 'zjadidi', 'normanzy98', 'jordanphillipburns', 'kfctoday1121', 'yuchen0418', 'caglar.tamur', 'ellisrae', 'mpsherb', 'nwinner', 'djay_kamat']"
7,89,69,69,64,"['lauramaz', 'pedromf', 'mariofnavarro', 'crisalle', 'aloptor97', 'mozom96', 'jpnaviog', 'adrisantan25', 'paloma95', 'miguelangelgv', 'enrique97', 'eduardito', 'cristinitaa23', 'raulghuelma', 'ionemanuelmoralesrosales', 'danielserrano', 'lucigd96', 'juanalejandro.delatorre.gonzalez', 'joseantoniocuestareina', 'mariadelman96', 'nanopablo', 'tatifersanchez', 'jaigro97', 'carmengomezh16', 'lluis', 'claaudiaalvarez2', 'isabellopezcasas', 'nachoagrela', 'guidoah', 'kiarahervella', 'jesusestevez', 'ancap', 'pablolgoso', 'ricardodavid', 'alberto_leon_cecilla', 'lamberto', 'robee97', 'fabhuecas9', 'espi', 'ruben29', 'adiaz97', 'albertodellop', 'josebruq', 'gonzalogbb', 'karlosjusus', 'juanfran', 'joaquinhernandez', 'theresa5000', 'josesoto', 'rokitocri', 'mariatirado', 'carlosbarbero', 'rafaelleon', 'javier7', 'adavidsubires', 'fernandodiaz', 'malena23', 'pedrojjs97', 'franciscojaviern1997', 'davidgruano', 'hikaru', 'jmleyva', 'belen.moralesvega', 'eletorres']",5,"['juaniandujar', 'abignu', 'christian71291mercado', 'amontesplaza', 'carloscarac']",5,"['mcdyre', 'jotaeneeme', 'inmatt', 'nanojuanjo', 'ghostcodmw2']",74,"['lauramaz', 'pedromf', 'mariofnavarro', 'aloptor97', 'mozom96', 'adrisantan25', 'cristinitaa23', 'raulghuelma', 'amontesplaza', 'danielserrano', 'lucigd96', 'juanalejandro.delatorre.gonzalez', 'joseantoniocuestareina', 'nanopablo', 'ghostcodmw2', 'jaigro97', 'carmengomezh16', 'claaudiaalvarez2', 'nachoagrela', 'christian71291mercado', 'jesusestevez', 'lamberto', 'robee97', 'fabhuecas9', 'espi', 'adiaz97', 'josebruq', 'rokitocri', 'josesoto', 'mariatirado', 'rafaelleon', 'adavidsubires', 'fernandodiaz', 'malena23', 'pedrojjs97', 'davidgruano', 'jmleyva', 'belen.moralesvega', 'enrique97', 'crisalle', 'jpnaviog', 'paloma95', 'miguelangelgv', 'eduardito', 'ionemanuelmoralesrosales', 'mariadelman96', 'lluis', 'isabellopezcasas', 'tatifersanchez', 'guidoah', 'kiarahervella', 'jotaeneeme', 'ancap', 'ricardodavid', 'pablolgoso', 'alberto_leon_cecilla', 'juaniandujar', 'albertodellop', 'ruben29', 'gonzalogbb', 'karlosjusus', 'nanojuanjo', 'juanfran', 'joaquinhernandez', 'theresa5000', 'mcdyre', 'carlosbarbero', 'abignu', 'javier7', 'franciscojaviern1997', 'inmatt', 'hikaru', 'carloscarac', 'eletorres']"
8,139,66,24,21,"['jroar21', 'jang144', 'park736', 'bird4', 'mckenz12', 'cheng236', 'oojedara', 'smeriam', 'ndonorio', 'kjbolek0826', 'mhierlma', 'novak35', 'akirtley', 'sumamah', 'cmoneyro', 'hharjono', 'amaghare', 'brand9', 'haines18', 'rkitchin', 'patel357']",45,"['jemcmill', 'aardigo12', 'jcerimel', 'ddelaure', 'culver9', 'smit3426', 'amaheshw', 'zthai', 'wilso967', 'klieu', 'singh509', 'jschuhle', 'kgarret', 'mfeitosa', 'tverhoef', 'pwhitmor', 'jpothula', 'yaly', 'thewireddj', 'rainswor', 'green248', 'atramm', 'bjagielo', 'mchmielo', 'clark477', 'nfantasi', 'agrawa77', 'nseiber', 'seckart', 'tlemonds', 'meyer236', 'davis693', 'deshmur', 'ekachel', 'shannah2014', 'mgrande', 'sshivapr', 'saltamim', 'kalward', 'dcaples', 'rralston', 'jdewavri', 'davendra', 'john2272', 'jlebrun']",3,"['balasub9', 'jhartl', 'cguarini']",69,"['mckenz12', 'bird4', 'oojedara', 'smit3426', 'zthai', 'klieu', 'wilso967', 'singh509', 'smeriam', 'kgarret', 'tverhoef', 'mfeitosa', 'pwhitmor', 'jpothula', 'kjbolek0826', 'yaly', 'rainswor', 'green248', 'novak35', 'bjagielo', 'akirtley', 'clark477', 'nfantasi', 'sumamah', 'tlemonds', 'cmoneyro', 'ekachel', 'sshivapr', 'amaghare', 'brand9', 'dcaples', 'jdewavri', 'davendra', 'jroar21', 'jemcmill', 'jang144', 'jcerimel', 'culver9', 'park736', 'ddelaure', 'aardigo12', 'cheng236', 'amaheshw', 'jschuhle', 'balasub9', 'ndonorio', 'mhierlma', 'thewireddj', 'atramm', 'mchmielo', 'agrawa77', 'nseiber', 'cguarini', 'seckart', 'meyer236', 'davis693', 'deshmur', 'shannah2014', 'jhartl', 'mgrande', 'hharjono', 'saltamim', 'kalward', 'patel357', 'haines18', 'rkitchin', 'rralston', 'john2272', 'jlebrun']"
8,140,66,11,11,"['singh509', 'mchmielo', 'aardigo12', 'culver9', 'kalward', 'smit3426', 'dcaples', 'bjagielo', 'wilso967', 'john2272', 'jlebrun']",55,"['mckenz12', 'bird4', 'oojedara', 'zthai', 'klieu', 'smeriam', 'kgarret', 'tverhoef', 'mfeitosa', 'pwhitmor', 'jpothula', 'kjbolek0826', 'yaly', 'rainswor', 'green248', 'novak35', 'akirtley', 'clark477', 'nfantasi', 'sumamah', 'tlemonds', 'cmoneyro', 'ekachel', 'sshivapr', 'amaghare', 'brand9', 'jdewavri', 'davendra', 'jroar21', 'jemcmill', 'jang144', 'jcerimel', 'park736', 'ddelaure', 'cheng236', 'amaheshw', 'jschuhle', 'ndonorio', 'mhierlma', 'thewireddj', 'atramm', 'agrawa77', 'nseiber', 'seckart', 'meyer236', 'davis693', 'deshmur', 'shannah2014', 'mgrande', 'hharjono', 'saltamim', 'patel357', 'haines18', 'rkitchin', 'rralston']",0,[],66,"['mckenz12', 'bird4', 'oojedara', 'smit3426', 'zthai', 'klieu', 'wilso967', 'singh509', 'smeriam', 'kgarret', 'tverhoef', 'mfeitosa', 'pwhitmor', 'jpothula', 'kjbolek0826', 'yaly', 'rainswor', 'green248', 'novak35', 'bjagielo', 'akirtley', 'clark477', 'nfantasi', 'sumamah', 'tlemonds', 'cmoneyro', 'ekachel', 'sshivapr', 'amaghare', 'brand9', 'dcaples', 'jdewavri', 'davendra', 'jroar21', 'jemcmill', 'jang144', 'jcerimel', 'culver9', 'park736', 'ddelaure', 'aardigo12', 'cheng236', 'amaheshw', 'jschuhle', 'ndonorio', 'mhierlma', 'thewireddj', 'atramm', 'mchmielo', 'agrawa77', 'nseiber', 'seckart', 'meyer236', 'davis693', 'deshmur', 'shannah2014', 'mgrande', 'hharjono', 'saltamim', 'kalward', 'patel357', 'haines18', 'rkitchin', 'rralston', 'john2272', 'jlebrun']"
9,155,66,39,33,"['krishn75', 'rauche', 'bjendrus', 'ali85', 'sdhillo', 'jbarsima', 'hriddle', 'zyma', 'nfschadler', 'dast', 'cheeseballs99', 'mmoulin', 'marcusgunyon', 'klein61', 'mmulter', 'bfielde', 'batram', 'jboulayd', 'stewa207', 'cole141', 'knies0', 'zooks99', 'wscottharding', 'post10', 'kswiatk9581', 'azalar', 'sundara6', 'myers283', 'awassmer', 'aharbin', 'jlueck', 'ianbernander', 'xie317']",33,"['spear1234', 'dbai', 'nschlei', 'slagles', 'singh386', 'jtonges', 'sgudeman', 'ni45', 'kim426', 'jtwaddle', 'ybommire', 'vma2324', 'burnet19', 'matthewguido', 'kole.mcginn', 'vpatel', 'jmeneze', 'mmergent', 'brenna13', 'pererak', 'danphoenix', 'anthonyjameskramer', 'fmuehlem', 'atamvaki', 'hardisura', 'haoyangliu', 'lin814', 'kramer71', 'aaryanp', 'hali85', 'cho160', 'soni12', 'smit2805']",6,"['agalema1027', 'radhakr3', 'ffrank', 'kevinodonnell0878', 'afalkenb', 'rachel318318']",72,"['spear1234', 'dbai', 'radhakr3', 'nschlei', 'afalkenb', 'jtonges', 'bjendrus', 'sgudeman', 'ali85', 'sdhillo', 'kim426', 'ni45', 'jbarsima', 'hriddle', 'zyma', 'ybommire', 'vma2324', 'matthewguido', 'dast', 'vpatel', 'cheeseballs99', 'marcusgunyon', 'mmergent', 'mmulter', 'bfielde', 'danphoenix', 'batram', 'anthonyjameskramer', 'jboulayd', 'kevinodonnell0878', 'stewa207', 'fmuehlem', 'atamvaki', 'cole141', 'hardisura', 'rachel318318', 'haoyangliu', 'lin814', 'zooks99', 'aaryanp', 'hali85', 'kswiatk9581', 'agalema1027', 'sundara6', 'azalar', 'myers283', 'aharbin', 'soni12', 'xie317', 'smit2805', 'krishn75', 'slagles', 'rauche', 'singh386', 'jtwaddle', 'burnet19', 'nfschadler', 'kole.mcginn', 'jmeneze', 'mmoulin', 'klein61', 'brenna13', 'pererak', 'knies0', 'kramer71', 'post10', 'wscottharding', 'cho160', 'ffrank', 'awassmer', 'jlueck', 'ianbernander']"
10,103,61,66,52,"['manshi18207', 'puneet15159', 'aparna18196', 'mridul15149', 'paras15154', 'jasmine18202', 'subhadipporia', 'sambeet15168', 'sagar15167', 'kumari18221', 'ashish18157', 'saurav15174', 'maddineni18206', 'kunal15145', 'surabhi18217', 'avdesh15135', 'shubham18176', 'puneet16178', 'ehtesham18199', 'adityadiundi', 'sambhav14158', 'tushar18218', 'akshay18193', 'shivani18223', 'shivam15177', 'saumya15172', 'smartvedi', 'shivam18214', 'sarthak16190', 'arij18208', 'rajat15162', 'anubhav15128', 'vaishali18220', 'shaikh18213', 'abhinavg', 'ankur14019', 'shubhesh18216', 'anchal18155', 'sagar17115', 'neerupama18209', 'dhaval_1104', 'pankaj16176', 'hnspoorthy', 'aminah', 'gurpreet15140', 'feraj.husain', 'nowudontknowme', 'prateek18211', 'priyanka18169', 'tarun14168', 'aman18194', 'juilly']",9,"['liusyang641', 'lavanyanadarajan', 'michielin.alessandro', 'rafshezani', 'akoglutayyip', 'vedat969', 'emre1344', 'tttakoglu16000', 'elliott.rill']",14,"['parth15156', 'shivam18215', 'studsuper50', 'rajat16182', 'harsh161500', 'imrajat', 'subhadip17124', 'vishal16207', 'sahil16184', 'yogesh15193', 'aakash18191', 'harsh16150', 'shuchi18224', 'dheeraj15138']",75,"['manshi18207', 'aparna18196', 'sambeet15168', 'kumari18221', 'tttakoglu16000', 'saurav15174', 'maddineni18206', 'shivam18215', 'kunal15145', 'shubham18176', 'harsh161500', 'sambhav14158', 'shuchi18224', 'smartvedi', 'akoglutayyip', 'subhadip17124', 'anubhav15128', 'vaishali18220', 'abhinavg', 'shubhesh18216', 'dhaval_1104', 'hnspoorthy', 'studsuper50', 'gurpreet15140', 'nowudontknowme', 'priyanka18169', 'tarun14168', 'aman18194', 'sagar15167', 'elliott.rill', 'liusyang641', 'puneet15159', 'parth15156', 'mridul15149', 'paras15154', 'vishal16207', 'yogesh15193', 'jasmine18202', 'subhadipporia', 'ashish18157', 'lavanyanadarajan', 'michielin.alessandro', 'surabhi18217', 'avdesh15135', 'imrajat', 'puneet16178', 'ehtesham18199', 'vedat969', 'sahil16184', 'emre1344', 'adityadiundi', 'akshay18193', 'tushar18218', 'shivani18223', 'shivam15177', 'saumya15172', 'shivam18214', 'rafshezani', 'rajat16182', 'sarthak16190', 'arij18208', 'rajat15162', 'shaikh18213', 'harsh16150', 'ankur14019', 'anchal18155', 'sagar17115', 'dheeraj15138', 'pankaj16176', 'aminah', 'feraj.husain', 'aakash18191', 'prateek18211', 'neerupama18209', 'juilly']"
10,104,61,8,2,"['akoglutayyip', 'tttakoglu16000']",59,"['manshi18207', 'liusyang641', 'puneet15159', 'aparna18196', 'mridul15149', 'paras15154', 'jasmine18202', 'subhadipporia', 'sambeet15168', 'kumari18221', 'ashish18157', 'saurav15174', 'maddineni18206', 'lavanyanadarajan', 'michielin.alessandro', 'kunal15145', 'surabhi18217', 'avdesh15135', 'shubham18176', 'juilly', 'puneet16178', 'ehtesham18199', 'vedat969', 'emre1344', 'adityadiundi', 'sambhav14158', 'tushar18218', 'akshay18193', 'shivani18223', 'shivam15177', 'saumya15172', 'smartvedi', 'shivam18214', 'rafshezani', 'sarthak16190', 'arij18208', 'rajat15162', 'anubhav15128', 'vaishali18220', 'shaikh18213', 'abhinavg', 'tarun14168', 'ankur14019', 'shubhesh18216', 'anchal18155', 'sagar17115', 'dhaval_1104', 'pankaj16176', 'hnspoorthy', 'aminah', 'gurpreet15140', 'feraj.husain', 'nowudontknowme', 'prateek18211', 'priyanka18169', 'neerupama18209', 'aman18194', 'sagar15167', 'elliott.rill']",6,"['melisozkarr', 'okanircann', 'fatiherdgn25', 'ulasgorcelioglu', 'meltemsbreezes', 'ozgurdenizkz']",67,"['manshi18207', 'liusyang641', 'puneet15159', 'aparna18196', 'mridul15149', 'paras15154', 'jasmine18202', 'subhadipporia', 'sambeet15168', 'kumari18221', 'tttakoglu16000', 'ashish18157', 'saurav15174', 'maddineni18206', 'lavanyanadarajan', 'michielin.alessandro', 'kunal15145', 'surabhi18217', 'avdesh15135', 'shubham18176', 'juilly', 'puneet16178', 'ehtesham18199', 'vedat969', 'emre1344', 'adityadiundi', 'sambhav14158', 'tushar18218', 'akshay18193', 'shivani18223', 'shivam15177', 'ozgurdenizkz', 'melisozkarr', 'saumya15172', 'okanircann', 'smartvedi', 'fatiherdgn25', 'shivam18214', 'rafshezani', 'akoglutayyip', 'ulasgorcelioglu', 'sarthak16190', 'arij18208', 'rajat15162', 'anubhav15128', 'vaishali18220', 'shaikh18213', 'abhinavg', 'tarun14168', 'meltemsbreezes', 'ankur14019', 'shubhesh18216', 'anchal18155', 'sagar17115', 'dhaval_1104', 'pankaj16176', 'hnspoorthy', 'aminah', 'gurpreet15140', 'feraj.husain', 'nowudontknowme', 'prateek18211', 'priyanka18169', 'neerupama18209', 'aman18194', 'sagar15167', 'elliott.rill']"
11,28,56,53,2,"['loisonchambers', 'dfl']",54,"['weekmooz', 'hkz5032', 'mikeyu1997', 'tornado_u', 'sgu20131429', 'preet58', 'navjinder12', 'emilygroves18908496', 'jesus.lozano', 'tingbiao', 'grhu996', 'siao', 'arunparth', 'cesar.sanchez', 'rc2975nyu', 'tfs5093', 'navaneeth.tp', 'djb84', 'swagatam.chaitali', 'oogii1998', 'daniel.camacho', 'ytsong95', 'tsendee', 'luis.ascencio', 'manuel.guel', 'luz.valtierra', 'saa5966', 'fjj5032', 'armando.martinez', 'yaozu', 'wndgml3370', 'davyn', 'luzvani', 'erick.padilla', 'naharin10', 'cannansong', 'cjw5647', 'as12033', 'jaw6297', 'dsm5388', 'rsc5261', 'ac7431', 'kevinberwick', 'lh2754', 'mauricio.lopez', 'liamjthomson18948389', 'zh1246', 'sdyfbew', 'gizemkaraca', 'jose.trujillo', 'bgutierrez', 'adfoz', 'shubham.mahalank', 'nymkan756']",51,"['carlosvillar54', 'efrenhub', 'tonybocadillosgrandes', 'martinzapata', 'movi205', 'iago', 'ledicia97', 'lauragdevesa', 'acregodean', 'sarapl', 'alimatama', 'camilolcastro97', 'carlosbesadaromero', 'electronica18', 'svo4321', 'david.peral.moran', 'aronchino6', 'mcruces.fz', 'nuanno97', 'lino13', 'vblanco.nico', 'alidsjt', 'anxovidal8', 'martin32', 'mateocampos', 'retty8', 'pablobou4', 'vanesagarcia', 'cristinacigarran', 'janalorenzolumbreras', 'antonio25', 'hermidaitor', 'pedrosiaba', 'ramonruiz.infor', 'perezsarmar', 'helenalecoq97', 'puertarcd', 'gemma', 'alecorti.pardo', 'juanmacano97', 'amparo.castro.96', 'maxernest', 'gombut', 'veronica.mieites', 'corredoira', 'marcosanllo', 'latecnologiameodia', 'carlosvigo1997', 'vickytubio', 'xosegq16', 'malgaca']",107,"['carlosvillar54', 'efrenhub', 'mikeyu1997', 'tornado_u', 'iago', 'ledicia97', 'sgu20131429', 'lauragdevesa', 'navjinder12', 'emilygroves18908496', 'jesus.lozano', 'siao', 'arunparth', 'cesar.sanchez', 'carlosbesadaromero', 'svo4321', 'rc2975nyu', 'aronchino6', 'navaneeth.tp', 'lino13', 'loisonchambers', 'djb84', 'vblanco.nico', 'alidsjt', 'anxovidal8', 'daniel.camacho', 'mateocampos', 'saa5966', 'retty8', 'cristinacigarran', 'fjj5032', 'yaozu', 'vanesagarcia', 'davyn', 'janalorenzolumbreras', 'antonio25', 'naharin10', 'cannansong', 'cjw5647', 'as12033', 'jaw6297', 'perezsarmar', 'rsc5261', 'ac7431', 'helenalecoq97', 'puertarcd', 'gemma', 'alecorti.pardo', 'juanmacano97', 'maxernest', 'corredoira', 'lh2754', 'mauricio.lopez', 'gombut', 'marcosanllo', 'latecnologiameodia', 'carlosvigo1997', 'liamjthomson18948389', 'vickytubio', 'gizemkaraca', 'adfoz', 'xosegq16', 'shubham.mahalank', 'nymkan756', 'weekmooz', 'hkz5032', 'tonybocadillosgrandes', 'martinzapata', 'movi205', 'acregodean', 'preet58', 'sarapl', 'alimatama', 'camilolcastro97', 'tingbiao', 'grhu996', 'electronica18', 'david.peral.moran', 'mcruces.fz', 'nuanno97', 'swagatam.chaitali', 'oogii1998', 'dfl', 'ytsong95', 'tsendee', 'luis.ascencio', 'martin32', 'manuel.guel', 'luz.valtierra', 'pablobou4', 'armando.martinez', 'wndgml3370', 'luzvani', 'erick.padilla', 'hermidaitor', 'pedrosiaba', 'ramonruiz.infor', 'dsm5388', 'kevinberwick', 'amparo.castro.96', 'veronica.mieites', 'zh1246', 'sdyfbew', 'jose.trujillo', 'bgutierrez', 'malgaca', 'tfs5093']"
11,16,56,45,3,"['loisonchambers', 'adfoz', 'dfl']",53,"['weekmooz', 'hkz5032', 'mikeyu1997', 'tornado_u', 'sgu20131429', 'preet58', 'navjinder12', 'emilygroves18908496', 'jesus.lozano', 'tingbiao', 'grhu996', 'siao', 'arunparth', 'cesar.sanchez', 'rc2975nyu', 'tfs5093', 'navaneeth.tp', 'djb84', 'swagatam.chaitali', 'oogii1998', 'daniel.camacho', 'ytsong95', 'tsendee', 'luis.ascencio', 'manuel.guel', 'luz.valtierra', 'saa5966', 'fjj5032', 'armando.martinez', 'yaozu', 'wndgml3370', 'davyn', 'luzvani', 'erick.padilla', 'naharin10', 'cannansong', 'cjw5647', 'as12033', 'jaw6297', 'dsm5388', 'rsc5261', 'ac7431', 'kevinberwick', 'lh2754', 'mauricio.lopez', 'liamjthomson18948389', 'zh1246', 'sdyfbew', 'gizemkaraca', 'jose.trujillo', 'bgutierrez', 'shubham.mahalank', 'nymkan756']",42,"['miri23', 'david.garrido', 'efrenhub', 'tonybocadillosgrandes', 'martinzapata', 'movi205', 'iago', 'ledicia97', 'acregodean', 'adriangarea', 'sarapl', 'alimatama', 'camilolcastro97', 'mmartinezsanchez', 'josepazmartin', 'siemprewowthechami', 'carlosbesadaromero', 'electronica18', 'svo4321', 'isabelmaria.vazquez', 'alberfn', 'vblanco.nico', 'alidsjt', 'apascao', 'anxovidal8', 'mateocampos', 'cristinacigarran', 'vanesagarcia', 'janalorenzolumbreras', 'hermidaitor', 'pedrosiaba', 'danielfernandezcalo', 'helenalecoq97', 'puertarcd', 'gemma', 'alecorti.pardo', 'amparo.castro.96', 'maxernest', 'veronica.mieites', 'vickytubio', 'xosegq16', 'malgaca']",98,"['miri23', 'efrenhub', 'mikeyu1997', 'tornado_u', 'iago', 'ledicia97', 'sgu20131429', 'navjinder12', 'adriangarea', 'emilygroves18908496', 'jesus.lozano', 'siao', 'arunparth', 'cesar.sanchez', 'siemprewowthechami', 'carlosbesadaromero', 'svo4321', 'rc2975nyu', 'alberfn', 'navaneeth.tp', 'vblanco.nico', 'loisonchambers', 'djb84', 'alidsjt', 'anxovidal8', 'daniel.camacho', 'mateocampos', 'saa5966', 'cristinacigarran', 'fjj5032', 'yaozu', 'vanesagarcia', 'davyn', 'janalorenzolumbreras', 'naharin10', 'cannansong', 'cjw5647', 'danielfernandezcalo', 'as12033', 'jaw6297', 'rsc5261', 'ac7431', 'helenalecoq97', 'puertarcd', 'gemma', 'alecorti.pardo', 'maxernest', 'lh2754', 'mauricio.lopez', 'liamjthomson18948389', 'vickytubio', 'gizemkaraca', 'adfoz', 'xosegq16', 'shubham.mahalank', 'nymkan756', 'weekmooz', 'hkz5032', 'david.garrido', 'tonybocadillosgrandes', 'martinzapata', 'movi205', 'acregodean', 'preet58', 'sarapl', 'alimatama', 'camilolcastro97', 'mmartinezsanchez', 'tingbiao', 'grhu996', 'josepazmartin', 'electronica18', 'isabelmaria.vazquez', 'swagatam.chaitali', 'oogii1998', 'dfl', 'ytsong95', 'tsendee', 'luis.ascencio', 'apascao', 'manuel.guel', 'luz.valtierra', 'armando.martinez', 'wndgml3370', 'luzvani', 'erick.padilla', 'hermidaitor', 'pedrosiaba', 'dsm5388', 'kevinberwick', 'amparo.castro.96', 'veronica.mieites', 'zh1246', 'sdyfbew', 'jose.trujillo', 'bgutierrez', 'malgaca', 'tfs5093']"
11,27,56,37,2,"['loisonchambers', 'adfoz']",54,"['weekmooz', 'hkz5032', 'mikeyu1997', 'tornado_u', 'sgu20131429', 'preet58', 'navjinder12', 'emilygroves18908496', 'jesus.lozano', 'tingbiao', 'grhu996', 'siao', 'arunparth', 'cesar.sanchez', 'rc2975nyu', 'tfs5093', 'navaneeth.tp', 'djb84', 'swagatam.chaitali', 'oogii1998', 'daniel.camacho', 'ytsong95', 'tsendee', 'dfl', 'luis.ascencio', 'manuel.guel', 'luz.valtierra', 'saa5966', 'fjj5032', 'armando.martinez', 'yaozu', 'wndgml3370', 'davyn', 'luzvani', 'erick.padilla', 'naharin10', 'cannansong', 'cjw5647', 'as12033', 'jaw6297', 'dsm5388', 'rsc5261', 'ac7431', 'kevinberwick', 'lh2754', 'mauricio.lopez', 'liamjthomson18948389', 'zh1246', 'sdyfbew', 'gizemkaraca', 'jose.trujillo', 'bgutierrez', 'shubham.mahalank', 'nymkan756']",35,"['miri23', 'david.garrido', 'martinzapata', 'iago', 'ledicia97', 'acregodean', 'jorgecastelo5', 'sarapl', 'josepazmartin', 'siemprewowthechami', 'carlosbesadaromero', 'svo4321', 'isabelmaria.vazquez', 'alberfn', 'aronchino6', 'lino13', 'vblanco.nico', 'david2397', 'apascao', 'martin32', 'andreadiazgar', 'cristinacigarran', 'vanesagarcia', 'janalorenzolumbreras', 'hermidaitor', 'pedrosiaba', 'danielfernandezcalo', 'paularodriguez', 'helenalecoq97', 'gemma', 'alecorti.pardo', 'manuelsomoza94', 'corredoira', 'veronica.mieites', 'malgaca']",91,"['miri23', 'mikeyu1997', 'tornado_u', 'iago', 'ledicia97', 'sgu20131429', 'jorgecastelo5', 'navjinder12', 'emilygroves18908496', 'jesus.lozano', 'siao', 'arunparth', 'cesar.sanchez', 'siemprewowthechami', 'carlosbesadaromero', 'svo4321', 'rc2975nyu', 'alberfn', 'aronchino6', 'navaneeth.tp', 'lino13', 'loisonchambers', 'djb84', 'vblanco.nico', 'david2397', 'daniel.camacho', 'andreadiazgar', 'saa5966', 'cristinacigarran', 'fjj5032', 'yaozu', 'vanesagarcia', 'davyn', 'janalorenzolumbreras', 'naharin10', 'cannansong', 'cjw5647', 'danielfernandezcalo', 'as12033', 'jaw6297', 'rsc5261', 'ac7431', 'helenalecoq97', 'gemma', 'alecorti.pardo', 'manuelsomoza94', 'corredoira', 'lh2754', 'mauricio.lopez', 'liamjthomson18948389', 'gizemkaraca', 'adfoz', 'shubham.mahalank', 'nymkan756', 'weekmooz', 'hkz5032', 'david.garrido', 'martinzapata', 'acregodean', 'preet58', 'sarapl', 'tingbiao', 'grhu996', 'josepazmartin', 'isabelmaria.vazquez', 'swagatam.chaitali', 'oogii1998', 'dfl', 'ytsong95', 'tsendee', 'luis.ascencio', 'apascao', 'martin32', 'manuel.guel', 'luz.valtierra', 'armando.martinez', 'wndgml3370', 'luzvani', 'erick.padilla', 'hermidaitor', 'pedrosiaba', 'dsm5388', 'paularodriguez', 'kevinberwick', 'veronica.mieites', 'zh1246', 'sdyfbew', 'jose.trujillo', 'bgutierrez', 'malgaca', 'tfs5093']"
11,18,56,34,1,['dfl'],55,"['weekmooz', 'hkz5032', 'mikeyu1997', 'tornado_u', 'sgu20131429', 'preet58', 'navjinder12', 'emilygroves18908496', 'jesus.lozano', 'tingbiao', 'grhu996', 'siao', 'arunparth', 'cesar.sanchez', 'rc2975nyu', 'tfs5093', 'navaneeth.tp', 'loisonchambers', 'djb84', 'swagatam.chaitali', 'oogii1998', 'daniel.camacho', 'ytsong95', 'tsendee', 'luis.ascencio', 'manuel.guel', 'luz.valtierra', 'saa5966', 'fjj5032', 'armando.martinez', 'yaozu', 'wndgml3370', 'davyn', 'luzvani', 'erick.padilla', 'naharin10', 'cannansong', 'cjw5647', 'as12033', 'jaw6297', 'dsm5388', 'rsc5261', 'ac7431', 'kevinberwick', 'lh2754', 'mauricio.lopez', 'liamjthomson18948389', 'zh1246', 'sdyfbew', 'gizemkaraca', 'jose.trujillo', 'bgutierrez', 'adfoz', 'shubham.mahalank', 'nymkan756']",33,"['carlosvillar54', 'efrenhub', 'tonybocadillosgrandes', 'estebanrial', 'iago', 'lauragdevesa', 'acregodean', 'alimatama', 'carlosbesadaromero', 'electronica18', 'david.peral.moran', 'isabelmaria.vazquez', 'alberfn', 'mcruces.fz', 'nuanno97', 'vblanco.nico', 'alidsjt', 'martin32', 'cristinacigarran', 'dokun', 'antonio25', 'hermidaitor', 'pedrosiaba', 'ramonruiz.infor', 'selena', 'helenalecoq97', 'gemma', 'alecorti.pardo', 'juanmacano97', 'maxernest', 'carlosvigo1997', 'vickytubio', 'xosegq16']",89,"['carlosvillar54', 'efrenhub', 'mikeyu1997', 'tornado_u', 'iago', 'lauragdevesa', 'sgu20131429', 'navjinder12', 'emilygroves18908496', 'jesus.lozano', 'siao', 'arunparth', 'cesar.sanchez', 'carlosbesadaromero', 'rc2975nyu', 'alberfn', 'navaneeth.tp', 'vblanco.nico', 'loisonchambers', 'djb84', 'alidsjt', 'daniel.camacho', 'saa5966', 'cristinacigarran', 'fjj5032', 'yaozu', 'davyn', 'antonio25', 'naharin10', 'cannansong', 'cjw5647', 'as12033', 'jaw6297', 'rsc5261', 'ac7431', 'helenalecoq97', 'gemma', 'alecorti.pardo', 'juanmacano97', 'maxernest', 'lh2754', 'mauricio.lopez', 'carlosvigo1997', 'liamjthomson18948389', 'vickytubio', 'gizemkaraca', 'adfoz', 'xosegq16', 'shubham.mahalank', 'nymkan756', 'weekmooz', 'hkz5032', 'tonybocadillosgrandes', 'estebanrial', 'acregodean', 'preet58', 'alimatama', 'tingbiao', 'grhu996', 'electronica18', 'david.peral.moran', 'isabelmaria.vazquez', 'mcruces.fz', 'nuanno97', 'swagatam.chaitali', 'oogii1998', 'dfl', 'ytsong95', 'tsendee', 'luis.ascencio', 'martin32', 'manuel.guel', 'luz.valtierra', 'armando.martinez', 'wndgml3370', 'luzvani', 'dokun', 'erick.padilla', 'hermidaitor', 'pedrosiaba', 'ramonruiz.infor', 'dsm5388', 'kevinberwick', 'selena', 'zh1246', 'sdyfbew', 'jose.trujillo', 'bgutierrez', 'tfs5093']"
11,8,56,22,3,"['tsendee', 'nymkan756', 'oogii1998']",53,"['weekmooz', 'hkz5032', 'mikeyu1997', 'tornado_u', 'sgu20131429', 'preet58', 'navjinder12', 'emilygroves18908496', 'jesus.lozano', 'tingbiao', 'grhu996', 'siao', 'arunparth', 'cesar.sanchez', 'rc2975nyu', 'navaneeth.tp', 'loisonchambers', 'djb84', 'swagatam.chaitali', 'dfl', 'daniel.camacho', 'ytsong95', 'luis.ascencio', 'manuel.guel', 'luz.valtierra', 'saa5966', 'fjj5032', 'armando.martinez', 'yaozu', 'wndgml3370', 'davyn', 'luzvani', 'erick.padilla', 'naharin10', 'cannansong', 'cjw5647', 'as12033', 'jaw6297', 'dsm5388', 'rsc5261', 'ac7431', 'kevinberwick', 'lh2754', 'mauricio.lopez', 'liamjthomson18948389', 'zh1246', 'sdyfbew', 'gizemkaraca', 'jose.trujillo', 'bgutierrez', 'adfoz', 'shubham.mahalank', 'tfs5093']",19,"['puujeeulzii2', 'sdeegiimaa', 'bat0407', 't.byambadorj0282', 'munkherdene593', 'delgermaa', 'god4host0918', 'ulziibaatar0324', 'watashi.legion', 'ss0249571', 'ubatbilig99', 'bymbaa6789', 'dulguun1', 'dshinwes', 'sumyafire1', 'gundalai2000', 'anudarid6', 'battulga9192', 'bz_5657']",75,"['mikeyu1997', 'tornado_u', 'sdeegiimaa', 'bat0407', 'sgu20131429', 'navjinder12', 'emilygroves18908496', 'jesus.lozano', 'siao', 'arunparth', 'cesar.sanchez', 'rc2975nyu', 'god4host0918', 'navaneeth.tp', 'ulziibaatar0324', 'loisonchambers', 'djb84', 'watashi.legion', 'daniel.camacho', 'saa5966', 'fjj5032', 'yaozu', 'ubatbilig99', 'davyn', 'naharin10', 'cannansong', 'cjw5647', 'bymbaa6789', 'as12033', 'jaw6297', 'dulguun1', 'sumyafire1', 'rsc5261', 'ac7431', 'lh2754', 'mauricio.lopez', 'liamjthomson18948389', 'bz_5657', 'gizemkaraca', 'adfoz', 'shubham.mahalank', 'nymkan756', 'weekmooz', 'hkz5032', 'puujeeulzii2', 'preet58', 't.byambadorj0282', 'tingbiao', 'grhu996', 'munkherdene593', 'delgermaa', 'swagatam.chaitali', 'oogii1998', 'dfl', 'ytsong95', 'tsendee', 'luis.ascencio', 'manuel.guel', 'ss0249571', 'luz.valtierra', 'armando.martinez', 'wndgml3370', 'luzvani', 'erick.padilla', 'dshinwes', 'dsm5388', 'kevinberwick', 'gundalai2000', 'anudarid6', 'battulga9192', 'zh1246', 'sdyfbew', 'jose.trujillo', 'bgutierrez', 'tfs5093']"
11,21,56,15,1,['dfl'],55,"['weekmooz', 'hkz5032', 'mikeyu1997', 'tornado_u', 'sgu20131429', 'preet58', 'navjinder12', 'emilygroves18908496', 'jesus.lozano', 'tingbiao', 'grhu996', 'siao', 'arunparth', 'cesar.sanchez', 'rc2975nyu', 'tfs5093', 'navaneeth.tp', 'loisonchambers', 'djb84', 'swagatam.chaitali', 'oogii1998', 'daniel.camacho', 'ytsong95', 'tsendee', 'luis.ascencio', 'manuel.guel', 'luz.valtierra', 'saa5966', 'fjj5032', 'armando.martinez', 'yaozu', 'wndgml3370', 'davyn', 'luzvani', 'erick.padilla', 'naharin10', 'cannansong', 'cjw5647', 'as12033', 'jaw6297', 'dsm5388', 'rsc5261', 'ac7431', 'kevinberwick', 'lh2754', 'mauricio.lopez', 'liamjthomson18948389', 'zh1246', 'sdyfbew', 'gizemkaraca', 'jose.trujillo', 'bgutierrez', 'adfoz', 'shubham.mahalank', 'nymkan756']",14,"['electronica18', 'cristinacigarran', 'veronica.mieites', 'gombut', 'alimatama', 'janalorenzolumbreras', 'dokun', 'lino13', 'david2397', 'movi205', 'alidsjt', 'martin32', 'perezsarmar', 'lsleed']",70,"['weekmooz', 'hkz5032', 'mikeyu1997', 'tornado_u', 'movi205', 'sgu20131429', 'preet58', 'navjinder12', 'emilygroves18908496', 'alimatama', 'jesus.lozano', 'tingbiao', 'siao', 'grhu996', 'arunparth', 'cesar.sanchez', 'electronica18', 'rc2975nyu', 'navaneeth.tp', 'lino13', 'loisonchambers', 'djb84', 'swagatam.chaitali', 'david2397', 'alidsjt', 'oogii1998', 'daniel.camacho', 'ytsong95', 'tsendee', 'dfl', 'luis.ascencio', 'martin32', 'manuel.guel', 'lsleed', 'luz.valtierra', 'saa5966', 'cristinacigarran', 'fjj5032', 'armando.martinez', 'yaozu', 'wndgml3370', 'davyn', 'luzvani', 'janalorenzolumbreras', 'erick.padilla', 'naharin10', 'nymkan756', 'cjw5647', 'cannansong', 'dokun', 'as12033', 'jaw6297', 'perezsarmar', 'dsm5388', 'rsc5261', 'ac7431', 'kevinberwick', 'veronica.mieites', 'lh2754', 'mauricio.lopez', 'gombut', 'liamjthomson18948389', 'zh1246', 'sdyfbew', 'gizemkaraca', 'jose.trujillo', 'bgutierrez', 'adfoz', 'shubham.mahalank', 'tfs5093']"
11,9,56,14,11,"['weekmooz', 'arunparth', 'lh2754', 'rc2975nyu', 'zh1246', 'sdyfbew', 'as12033', 'ytsong95', 'shubham.mahalank', 'ac7431', 'siao']",45,"['hkz5032', 'mikeyu1997', 'tornado_u', 'sgu20131429', 'preet58', 'navjinder12', 'emilygroves18908496', 'jesus.lozano', 'tingbiao', 'grhu996', 'cesar.sanchez', 'tfs5093', 'navaneeth.tp', 'loisonchambers', 'djb84', 'swagatam.chaitali', 'dfl', 'daniel.camacho', 'oogii1998', 'tsendee', 'luis.ascencio', 'manuel.guel', 'luz.valtierra', 'saa5966', 'fjj5032', 'armando.martinez', 'yaozu', 'wndgml3370', 'davyn', 'luzvani', 'erick.padilla', 'naharin10', 'cannansong', 'cjw5647', 'jaw6297', 'dsm5388', 'rsc5261', 'kevinberwick', 'mauricio.lopez', 'liamjthomson18948389', 'gizemkaraca', 'jose.trujillo', 'bgutierrez', 'adfoz', 'nymkan756']",3,"['zl2513', 'kmamaniya', 'mr4425']",59,"['weekmooz', 'hkz5032', 'mikeyu1997', 'tornado_u', 'sgu20131429', 'preet58', 'navjinder12', 'emilygroves18908496', 'jesus.lozano', 'tingbiao', 'siao', 'grhu996', 'arunparth', 'cesar.sanchez', 'rc2975nyu', 'navaneeth.tp', 'loisonchambers', 'djb84', 'swagatam.chaitali', 'oogii1998', 'daniel.camacho', 'ytsong95', 'tsendee', 'dfl', 'luis.ascencio', 'zl2513', 'manuel.guel', 'luz.valtierra', 'saa5966', 'fjj5032', 'armando.martinez', 'yaozu', 'wndgml3370', 'davyn', 'luzvani', 'erick.padilla', 'naharin10', 'nymkan756', 'cjw5647', 'cannansong', 'mr4425', 'as12033', 'jaw6297', 'dsm5388', 'rsc5261', 'ac7431', 'kevinberwick', 'kmamaniya', 'lh2754', 'mauricio.lopez', 'liamjthomson18948389', 'zh1246', 'sdyfbew', 'gizemkaraca', 'jose.trujillo', 'bgutierrez', 'adfoz', 'shubham.mahalank', 'tfs5093']"
11,19,56,14,1,['davyn'],55,"['weekmooz', 'hkz5032', 'mikeyu1997', 'tornado_u', 'sgu20131429', 'preet58', 'navjinder12', 'emilygroves18908496', 'jesus.lozano', 'tingbiao', 'grhu996', 'siao', 'arunparth', 'cesar.sanchez', 'rc2975nyu', 'tfs5093', 'navaneeth.tp', 'loisonchambers', 'djb84', 'swagatam.chaitali', 'oogii1998', 'daniel.camacho', 'ytsong95', 'tsendee', 'dfl', 'luis.ascencio', 'manuel.guel', 'luz.valtierra', 'saa5966', 'fjj5032', 'armando.martinez', 'yaozu', 'wndgml3370', 'luzvani', 'erick.padilla', 'naharin10', 'cannansong', 'cjw5647', 'as12033', 'jaw6297', 'dsm5388', 'rsc5261', 'ac7431', 'kevinberwick', 'lh2754', 'mauricio.lopez', 'liamjthomson18948389', 'zh1246', 'sdyfbew', 'gizemkaraca', 'jose.trujillo', 'bgutierrez', 'adfoz', 'shubham.mahalank', 'nymkan756']",13,"['aengm', 'paul.aniruddha', 'rikardberger', 'kartal', 'adarsh123', 'nazimmath3', 'prakharbhargava0', 'nadja1', 'hilisa', 'scremin', 'lukunze1', 'annahaozheng0606', 'ilou']",69,"['weekmooz', 'hkz5032', 'mikeyu1997', 'tornado_u', 'adarsh123', 'sgu20131429', 'preet58', 'navjinder12', 'emilygroves18908496', 'jesus.lozano', 'tingbiao', 'siao', 'grhu996', 'arunparth', 'cesar.sanchez', 'rc2975nyu', 'navaneeth.tp', 'loisonchambers', 'djb84', 'swagatam.chaitali', 'prakharbhargava0', 'nadja1', 'oogii1998', 'daniel.camacho', 'ytsong95', 'tsendee', 'dfl', 'luis.ascencio', 'lukunze1', 'manuel.guel', 'nazimmath3', 'luz.valtierra', 'saa5966', 'rikardberger', 'fjj5032', 'armando.martinez', 'yaozu', 'wndgml3370', 'davyn', 'luzvani', 'erick.padilla', 'naharin10', 'nymkan756', 'cjw5647', 'cannansong', 'as12033', 'jaw6297', 'scremin', 'dsm5388', 'paul.aniruddha', 'rsc5261', 'ac7431', 'kevinberwick', 'annahaozheng0606', 'ilou', 'aengm', 'lh2754', 'mauricio.lopez', 'kartal', 'liamjthomson18948389', 'zh1246', 'sdyfbew', 'gizemkaraca', 'jose.trujillo', 'hilisa', 'bgutierrez', 'adfoz', 'shubham.mahalank', 'tfs5093']"
11,7,56,10,10,"['cesar.sanchez', 'daniel.camacho', 'armando.martinez', 'mauricio.lopez', 'luzvani', 'erick.padilla', 'jose.trujillo', 'luis.ascencio', 'jesus.lozano', 'manuel.guel']",46,"['weekmooz', 'hkz5032', 'mikeyu1997', 'tornado_u', 'sgu20131429', 'preet58', 'navjinder12', 'emilygroves18908496', 'tingbiao', 'siao', 'grhu996', 'arunparth', 'rc2975nyu', 'navaneeth.tp', 'loisonchambers', 'djb84', 'swagatam.chaitali', 'oogii1998', 'ytsong95', 'tsendee', 'dfl', 'luz.valtierra', 'saa5966', 'fjj5032', 'yaozu', 'wndgml3370', 'davyn', 'naharin10', 'nymkan756', 'cjw5647', 'cannansong', 'as12033', 'jaw6297', 'dsm5388', 'rsc5261', 'ac7431', 'kevinberwick', 'lh2754', 'liamjthomson18948389', 'zh1246', 'sdyfbew', 'gizemkaraca', 'bgutierrez', 'adfoz', 'shubham.mahalank', 'tfs5093']",0,[],56,"['weekmooz', 'hkz5032', 'mikeyu1997', 'tornado_u', 'sgu20131429', 'preet58', 'navjinder12', 'emilygroves18908496', 'jesus.lozano', 'tingbiao', 'siao', 'grhu996', 'arunparth', 'cesar.sanchez', 'rc2975nyu', 'navaneeth.tp', 'loisonchambers', 'djb84', 'swagatam.chaitali', 'oogii1998', 'daniel.camacho', 'ytsong95', 'tsendee', 'dfl', 'luis.ascencio', 'manuel.guel', 'luz.valtierra', 'saa5966', 'fjj5032', 'armando.martinez', 'yaozu', 'wndgml3370', 'davyn', 'luzvani', 'erick.padilla', 'naharin10', 'nymkan756', 'cjw5647', 'cannansong', 'as12033', 'jaw6297', 'dsm5388', 'rsc5261', 'ac7431', 'kevinberwick', 'lh2754', 'mauricio.lopez', 'liamjthomson18948389', 'zh1246', 'sdyfbew', 'gizemkaraca', 'jose.trujillo', 'bgutierrez', 'adfoz', 'shubham.mahalank', 'tfs5093']"
11,10,56,6,4,"['emilygroves18908496', 'preet58', 'liamjthomson18948389', 'navjinder12']",52,"['weekmooz', 'hkz5032', 'mikeyu1997', 'tornado_u', 'sgu20131429', 'jesus.lozano', 'tingbiao', 'siao', 'grhu996', 'arunparth', 'cesar.sanchez', 'rc2975nyu', 'navaneeth.tp', 'loisonchambers', 'djb84', 'swagatam.chaitali', 'oogii1998', 'daniel.camacho', 'ytsong95', 'tsendee', 'dfl', 'luis.ascencio', 'manuel.guel', 'luz.valtierra', 'saa5966', 'fjj5032', 'armando.martinez', 'yaozu', 'wndgml3370', 'davyn', 'luzvani', 'erick.padilla', 'naharin10', 'nymkan756', 'cjw5647', 'cannansong', 'as12033', 'jaw6297', 'dsm5388', 'rsc5261', 'ac7431', 'kevinberwick', 'lh2754', 'mauricio.lopez', 'zh1246', 'sdyfbew', 'gizemkaraca', 'jose.trujillo', 'bgutierrez', 'adfoz', 'shubham.mahalank', 'tfs5093']",2,"['seeyoong', 'ltu18935122']",58,"['weekmooz', 'hkz5032', 'mikeyu1997', 'tornado_u', 'sgu20131429', 'preet58', 'seeyoong', 'navjinder12', 'emilygroves18908496', 'jesus.lozano', 'tingbiao', 'siao', 'grhu996', 'arunparth', 'cesar.sanchez', 'rc2975nyu', 'navaneeth.tp', 'loisonchambers', 'djb84', 'swagatam.chaitali', 'oogii1998', 'daniel.camacho', 'ytsong95', 'tsendee', 'dfl', 'luis.ascencio', 'manuel.guel', 'luz.valtierra', 'saa5966', 'fjj5032', 'armando.martinez', 'yaozu', 'wndgml3370', 'davyn', 'luzvani', 'erick.padilla', 'naharin10', 'nymkan756', 'cjw5647', 'cannansong', 'ltu18935122', 'as12033', 'jaw6297', 'dsm5388', 'rsc5261', 'ac7431', 'kevinberwick', 'lh2754', 'mauricio.lopez', 'liamjthomson18948389', 'zh1246', 'sdyfbew', 'gizemkaraca', 'jose.trujillo', 'bgutierrez', 'adfoz', 'shubham.mahalank', 'tfs5093']"
11,82,56,6,4,"['emilygroves18908496', 'preet58', 'liamjthomson18948389', 'navjinder12']",52,"['weekmooz', 'hkz5032', 'mikeyu1997', 'tornado_u', 'sgu20131429', 'jesus.lozano', 'tingbiao', 'siao', 'grhu996', 'arunparth', 'cesar.sanchez', 'rc2975nyu', 'navaneeth.tp', 'loisonchambers', 'djb84', 'swagatam.chaitali', 'oogii1998', 'daniel.camacho', 'ytsong95', 'tsendee', 'dfl', 'luis.ascencio', 'manuel.guel', 'luz.valtierra', 'saa5966', 'fjj5032', 'armando.martinez', 'yaozu', 'wndgml3370', 'davyn', 'luzvani', 'erick.padilla', 'naharin10', 'nymkan756', 'cjw5647', 'cannansong', 'as12033', 'jaw6297', 'dsm5388', 'rsc5261', 'ac7431', 'kevinberwick', 'lh2754', 'mauricio.lopez', 'zh1246', 'sdyfbew', 'gizemkaraca', 'jose.trujillo', 'bgutierrez', 'adfoz', 'shubham.mahalank', 'tfs5093']",2,"['seeyoong', 'ltu18935122']",58,"['weekmooz', 'hkz5032', 'mikeyu1997', 'tornado_u', 'sgu20131429', 'preet58', 'seeyoong', 'navjinder12', 'emilygroves18908496', 'jesus.lozano', 'tingbiao', 'siao', 'grhu996', 'arunparth', 'cesar.sanchez', 'rc2975nyu', 'navaneeth.tp', 'loisonchambers', 'djb84', 'swagatam.chaitali', 'oogii1998', 'daniel.camacho', 'ytsong95', 'tsendee', 'dfl', 'luis.ascencio', 'manuel.guel', 'luz.valtierra', 'saa5966', 'fjj5032', 'armando.martinez', 'yaozu', 'wndgml3370', 'davyn', 'luzvani', 'erick.padilla', 'naharin10', 'nymkan756', 'cjw5647', 'cannansong', 'ltu18935122', 'as12033', 'jaw6297', 'dsm5388', 'rsc5261', 'ac7431', 'kevinberwick', 'lh2754', 'mauricio.lopez', 'liamjthomson18948389', 'zh1246', 'sdyfbew', 'gizemkaraca', 'jose.trujillo', 'bgutierrez', 'adfoz', 'shubham.mahalank', 'tfs5093']"
12,178,51,49,48,"['chavezaugusto2', 'andreaiadarola', 'cuiguiyang', 'beatrice96', 'martap95', 'nichrh_95', 'xiejin', 'maria.fazio', 'agustingiussani419', 'riccardom96', 'annapaolazingarelli96', 'cubo96on', 'mr.hejianlong', 'luigi1996', 'fabry180', 'alby.luzio', 'mariaclaradicesare14', 'michelemorani', 'saeed2428', 'giulialuparia', 'amirgrbn74', 'behzod1996.06', 'wangshixian922', 'frankcapone95', 'armankianirad', 'ilariabushati', 'abdujalol.usmanov', 'vittix96', 'xale95', 'amatodanilo95', 's264651', 'marco.rave.mr', 'a_giuliano', 'davide.fittipaldi', 'davide123', 'fefo.cardile', 'fabiopastorino.1993', 'zhangxiu000', 'gabriele.c396', 'mazzoni100', 'giacomosergi96', 'politecnico', 'flaminia95', 'eddodavalos', 'gasgas300', 'guochao', 'carmeladfr95', 'lorenzolaveneziana96']",3,"['luca.savigliano', 's266700', 'massimiliano1995']",1,['matteo.fasano'],52,"['cuiguiyang', 'martap95', 'nichrh_95', 'xiejin', 'maria.fazio', 's266700', 'cubo96on', 'fabry180', 'alby.luzio', 'mariaclaradicesare14', 'saeed2428', 'matteo.fasano', 'giulialuparia', 'wangshixian922', 'armankianirad', 'vittix96', 's264651', 'davide.fittipaldi', 'davide123', 'fefo.cardile', 'fabiopastorino.1993', 'zhangxiu000', 'mazzoni100', 'flaminia95', 'guochao', 'luca.savigliano', 'chavezaugusto2', 'andreaiadarola', 'beatrice96', 'agustingiussani419', 'riccardom96', 'annapaolazingarelli96', 'mr.hejianlong', 'luigi1996', 'michelemorani', 'amirgrbn74', 'behzod1996.06', 'frankcapone95', 'ilariabushati', 'abdujalol.usmanov', 'amatodanilo95', 'xale95', 'marco.rave.mr', 'a_giuliano', 'gabriele.c396', 'giacomosergi96', 'politecnico', 'eddodavalos', 'massimiliano1995', 'gasgas300', 'carmeladfr95', 'lorenzolaveneziana96']"
13,116,49,51,48,"['ethawsaw', 'jsputnam', 'cmsmudde', 'chiyuan97', 'bjamadagni', 'priya9598', 'mswin', 'saway', 'irphilli', 'ytaeyang', 'aleckschwartz', 'jiaminch', 'avignes31', 'shenghan19', 'jbuegel', 'itparson', 'coll428', 'bradyrob', 'ziraza', 'jms094', 'pgcarls', 'markwang', 'asdsgsg', 'raetaylor', 'alecr', 'birdboy', 'saffrondon', 'kaigoodman', 'adlwang', 'dmolivei', 'wgmoore', 'ericzz35', 'mdengquist', 'simba888', 'jewski', 'rjbalbin', 'louzhong', 'aflorman', 'malba', 'makoli', 'ohyli1997', 'dpsnider', 'jkmason', 'nshlesin', 'kganesan1', 'edstone', 'ehvicta', 'astrong']",1,['surfingslow'],3,"['dllivsch', 'ksilva', 'petercarlson05']",52,"['jsputnam', 'bjamadagni', 'priya9598', 'mswin', 'saway', 'ytaeyang', 'irphilli', 'avignes31', 'shenghan19', 'surfingslow', 'itparson', 'jms094', 'pgcarls', 'asdsgsg', 'raetaylor', 'alecr', 'birdboy', 'adlwang', 'dmolivei', 'wgmoore', 'mdengquist', 'simba888', 'aflorman', 'makoli', 'ohyli1997', 'jkmason', 'astrong', 'ethawsaw', 'cmsmudde', 'chiyuan97', 'petercarlson05', 'aleckschwartz', 'jiaminch', 'jbuegel', 'coll428', 'bradyrob', 'ziraza', 'markwang', 'dllivsch', 'saffrondon', 'kaigoodman', 'ksilva', 'ericzz35', 'jewski', 'rjbalbin', 'louzhong', 'malba', 'dpsnider', 'nshlesin', 'kganesan1', 'edstone', 'ehvicta']"
13,74,49,11,1,['surfingslow'],48,"['ethawsaw', 'jsputnam', 'cmsmudde', 'chiyuan97', 'bjamadagni', 'priya9598', 'mswin', 'saway', 'ytaeyang', 'irphilli', 'aleckschwartz', 'jiaminch', 'avignes31', 'shenghan19', 'jbuegel', 'itparson', 'coll428', 'bradyrob', 'ziraza', 'jms094', 'pgcarls', 'markwang', 'asdsgsg', 'raetaylor', 'alecr', 'birdboy', 'saffrondon', 'kaigoodman', 'adlwang', 'dmolivei', 'wgmoore', 'ericzz35', 'mdengquist', 'simba888', 'jewski', 'rjbalbin', 'louzhong', 'aflorman', 'malba', 'makoli', 'ohyli1997', 'dpsnider', 'jkmason', 'nshlesin', 'kganesan1', 'edstone', 'ehvicta', 'astrong']",10,"['iblackbu', 'jhulfach', 'eoreste', 'lbagbyy', 'davisloen', 'mbkivy', 'racotter', 'benjaminvf', 'tecatetrav', 'thomas.s.busse']",59,"['iblackbu', 'ethawsaw', 'eoreste', 'jsputnam', 'cmsmudde', 'chiyuan97', 'bjamadagni', 'priya9598', 'mbkivy', 'mswin', 'saway', 'benjaminvf', 'ytaeyang', 'irphilli', 'aleckschwartz', 'jiaminch', 'avignes31', 'shenghan19', 'surfingslow', 'jbuegel', 'itparson', 'coll428', 'bradyrob', 'ziraza', 'jms094', 'pgcarls', 'markwang', 'asdsgsg', 'raetaylor', 'alecr', 'birdboy', 'saffrondon', 'kaigoodman', 'adlwang', 'davisloen', 'dmolivei', 'racotter', 'wgmoore', 'ericzz35', 'mdengquist', 'lbagbyy', 'simba888', 'jewski', 'rjbalbin', 'louzhong', 'jhulfach', 'aflorman', 'malba', 'makoli', 'ohyli1997', 'dpsnider', 'jkmason', 'nshlesin', 'kganesan1', 'edstone', 'tecatetrav', 'ehvicta', 'thomas.s.busse', 'astrong']"
14,38,48,17,17,"['ryanprescott', 'smagpantay', 'amberhawthorne', 'abeld23', 'flyingcodfish', 'woodsnib', 'niturrioz', 'amb0516', 'gapittman', 'rafe45921', 'anthony7131998', 'genesisliang', 'rschrope', 'mfnaviag', 'mql', 'nbontems', 'ariheyd']",31,"['colleenweller', 'laurenlester', 'bbenzenberg', 'kevindestefano', 'paycinena', 'victoriawilliams1234', 'vonh8704', 'joshuajaime', 'argho7x7', 'zweisblatt', 'eric4707', 'carsonallen704', 'pedro.munoz003', 'aaronbar918', 'sgulguleu', 'tawalker16', 'lsigmund98', 'oliviabrandel36', 'kishanpateluf', 'abloftus', 'ria97alyssa', 'k.schmelzle', 'kitts4114', 'jbausch97', 'nmiller95', 'e.e.ladron', 'brandon_gould', 'jake2849', 'christauffer98', 'gandorofthewoods', 'ibean']",0,[],48,"['colleenweller', 'gandorofthewoods', 'laurenlester', 'bbenzenberg', 'abeld23', 'kevindestefano', 'genesisliang', 'paycinena', 'rschrope', 'smagpantay', 'vonh8704', 'amb0516', 'joshuajaime', 'anthony7131998', 'argho7x7', 'zweisblatt', 'eric4707', 'christauffer98', 'amberhawthorne', 'carsonallen704', 'pedro.munoz003', 'aaronbar918', 'woodsnib', 'gapittman', 'tawalker16', 'sgulguleu', 'lsigmund98', 'oliviabrandel36', 'kishanpateluf', 'abloftus', 'ria97alyssa', 'k.schmelzle', 'mql', 'ariheyd', 'ryanprescott', 'kitts4114', 'jbausch97', 'nbontems', 'flyingcodfish', 'nmiller95', 'niturrioz', 'mfnaviag', 'rafe45921', 'e.e.ladron', 'brandon_gould', 'jake2849', 'victoriawilliams1234', 'ibean']"
15,125,47,49,40,"['anunez38', 'rhalton2', 'pwalke9', 'kevinjl3', 'cbo3', 'danayun2', 'rvplank2', 'mw21', 'chguo2', 'ablee2', 'jgruber3', 'arhode2', 'wkeaty2', 'conanw2', 'vtagare2', 'tsehgal2', 'qiuhuic2', 'joshuas8', 'pittges2', 'gcangi2', 'domanus2', 'shirani', 'iflueck2', 'srb2', 'jtkach2', 'ssutyak2', 'edimare2', 'jkubota2', 'wsuk2', 'tz11', 'hjr2', 'lsienko2', 'anirula2', 'jjwilde2', 'chanmin2', 'txyang2', 'omarma2', 'jungeun5', 'naisong2', 'mblaauw2']",7,"['marcin.d.gajewski', 'wellyson', 'wtso2', 'astropino', 'darkzeroman', 'peerawattn', 'chatchai.meena']",9,"['dcpang2', 'zehuahe2', 'jinsup2', 'kyang37', 'tss3', 'jinwoo2', 'hf4', 'avw2', 'zhixin2']",56,"['dcpang2', 'cbo3', 'danayun2', 'mw21', 'chguo2', 'ablee2', 'jgruber3', 'arhode2', 'wkeaty2', 'conanw2', 'vtagare2', 'zehuahe2', 'marcin.d.gajewski', 'tsehgal2', 'tss3', 'joshuas8', 'pittges2', 'domanus2', 'shirani', 'srb2', 'jkubota2', 'tz11', 'wellyson', 'wtso2', 'jinsup2', 'astropino', 'naisong2', 'darkzeroman', 'mblaauw2', 'avw2', 'chatchai.meena', 'anunez38', 'rhalton2', 'pwalke9', 'kevinjl3', 'rvplank2', 'qiuhuic2', 'kyang37', 'gcangi2', 'hf4', 'zhixin2', 'iflueck2', 'jtkach2', 'ssutyak2', 'edimare2', 'wsuk2', 'hjr2', 'lsienko2', 'anirula2', 'jjwilde2', 'chanmin2', 'txyang2', 'jinwoo2', 'omarma2', 'jungeun5', 'peerawattn']"
16,50,42,12,10,"['misbah3229', 'abirmamunurrahman', 'mazharulislamshuvosikder', 'akazad42801', 'mahi97', 'tahsin2239', 'johayraprithula', 'fahim78645', 'kabirsinthi', 'rivnatmihaf']",32,"['granielharneabrenica', 'milan2019', 'santanutalukder', 'abeyer', 'boyang1724', 'shannak', 'riditarahman', 'dbsoni', 'f1hrishi.borate', 'frankccchin', 'slagernate', 'prasannajit', 'radahan', 'panchalamit270894', 'sanjay53', 'nishant27102', 'shrouk.e.zaki', 'ejskoge', 'emaminejad', 'swadhin12a', 'sreechakra', 'shitalnomi', 'no6', 'davod_nodet71', 'nancymaryrozario', 'ratul', 'smural23', 'kvpshastri', 'sebastiangurgul', 'aaro.lankinen', 'm_maks_s', 'kiran1997']",2,"['bubleedas06', 'farhana14eshal']",44,"['misbah3229', 'granielharneabrenica', 'milan2019', 'santanutalukder', 'abeyer', 'boyang1724', 'shannak', 'riditarahman', 'rivnatmihaf', 'dbsoni', 'farhana14eshal', 'f1hrishi.borate', 'frankccchin', 'slagernate', 'fahim78645', 'prasannajit', 'radahan', 'panchalamit270894', 'sanjay53', 'nishant27102', 'shrouk.e.zaki', 'mahi97', 'ejskoge', 'emaminejad', 'swadhin12a', 'sreechakra', 'shitalnomi', 'kabirsinthi', 'no6', 'davod_nodet71', 'nancymaryrozario', 'bubleedas06', 'abirmamunurrahman', 'mazharulislamshuvosikder', 'ratul', 'smural23', 'tahsin2239', 'akazad42801', 'johayraprithula', 'kvpshastri', 'sebastiangurgul', 'aaro.lankinen', 'm_maks_s', 'kiran1997']"
17,98,39,7,6,"['ee17btech11036', 'sumanthcherupally', 'ee17btech11014', 'ananth7121999', 'raktim', 'yash6499']",33,"['federicozg96', 'pranjalshiv123', 'ee17btech11025', 'loris_ee', 'knsiddharth', 'dheerajracha', 'maicol41093', 'taruntejreddych', 'ee17btech11013', 'rakshu.gade', 'lorenzo.mazzoli', 'ee17btech11040', 'alhawajri', 'karthikp', 'ee17btech11012', 'yury_matveyev', 'amritpal95', 'ee17btech11021', 'enricobaiano1', 'yogeshubbu', 'ee17btech11034', 'es16btech11026', 'siddharthmanu500', 'ee17btech11016', 'prag', 'falconrider10', 'k.vamshika', 'ee17btech11037', 'pradeepmoturi', 'parimiamrit', 'ee17btech11050', 'hassanmughal92', '124guna']",1,['ee17btech11006'],40,"['federicozg96', 'pranjalshiv123', 'ee17btech11025', 'loris_ee', 'knsiddharth', 'dheerajracha', 'maicol41093', 'ananth7121999', 'taruntejreddych', 'yash6499', 'ee17btech11013', 'rakshu.gade', 'lorenzo.mazzoli', 'ee17btech11006', 'ee17btech11040', 'alhawajri', 'karthikp', 'ee17btech11012', 'yury_matveyev', 'amritpal95', 'ee17btech11021', 'enricobaiano1', 'sumanthcherupally', 'ee17btech11014', 'yogeshubbu', 'ee17btech11034', 'es16btech11026', 'siddharthmanu500', 'ee17btech11016', 'prag', 'falconrider10', 'k.vamshika', 'ee17btech11036', 'ee17btech11037', 'pradeepmoturi', 'parimiamrit', 'raktim', 'ee17btech11050', 'hassanmughal92', '124guna']"
17,97,39,6,5,"['lorenzo.mazzoli', 'enricobaiano1', 'loris_ee', 'maicol41093', 'amritpal95']",34,"['federicozg96', 'pranjalshiv123', 'ee17btech11025', 'knsiddharth', 'dheerajracha', 'ananth7121999', 'taruntejreddych', 'yash6499', 'ee17btech11013', 'rakshu.gade', 'ee17btech11040', 'alhawajri', 'karthikp', 'ee17btech11012', 'yury_matveyev', 'ee17btech11021', 'sumanthcherupally', 'ee17btech11014', 'yogeshubbu', 'ee17btech11034', 'es16btech11026', 'siddharthmanu500', 'ee17btech11016', 'prag', 'falconrider10', 'k.vamshika', 'ee17btech11036', 'ee17btech11037', 'pradeepmoturi', 'parimiamrit', 'raktim', 'ee17btech11050', 'hassanmughal92', '124guna']",1,['mattiasaccaggi'],40,"['federicozg96', 'pranjalshiv123', 'ee17btech11025', 'loris_ee', 'knsiddharth', 'dheerajracha', 'maicol41093', 'mattiasaccaggi', 'ananth7121999', 'taruntejreddych', 'yash6499', 'ee17btech11013', 'rakshu.gade', 'lorenzo.mazzoli', 'ee17btech11040', 'alhawajri', 'karthikp', 'ee17btech11012', 'yury_matveyev', 'amritpal95', 'ee17btech11021', 'enricobaiano1', 'sumanthcherupally', 'ee17btech11014', 'yogeshubbu', 'ee17btech11034', 'es16btech11026', 'siddharthmanu500', 'ee17btech11016', 'prag', 'falconrider10', 'k.vamshika', 'ee17btech11036', 'ee17btech11037', 'pradeepmoturi', 'parimiamrit', 'raktim', 'ee17btech11050', 'hassanmughal92', '124guna']"
17,142,39,6,4,"['ee17btech11014', 'yogeshubbu', 'falconrider10', 'raktim']",35,"['federicozg96', 'pranjalshiv123', 'ee17btech11025', 'loris_ee', 'knsiddharth', 'dheerajracha', 'maicol41093', 'ananth7121999', 'taruntejreddych', 'yash6499', 'ee17btech11013', 'rakshu.gade', 'lorenzo.mazzoli', 'ee17btech11040', 'alhawajri', 'karthikp', 'ee17btech11012', 'yury_matveyev', 'amritpal95', 'ee17btech11021', 'enricobaiano1', 'sumanthcherupally', 'ee17btech11034', 'es16btech11026', 'siddharthmanu500', 'ee17btech11016', 'prag', 'k.vamshika', 'ee17btech11036', 'ee17btech11037', 'pradeepmoturi', 'parimiamrit', 'ee17btech11050', 'hassanmughal92', '124guna']",2,"['ee17btech11009', 'manideepvuppala']",41,"['federicozg96', 'ee17btech11009', 'pranjalshiv123', 'ee17btech11025', 'loris_ee', 'knsiddharth', 'dheerajracha', 'maicol41093', 'ananth7121999', 'taruntejreddych', 'yash6499', 'ee17btech11013', 'rakshu.gade', 'lorenzo.mazzoli', 'manideepvuppala', 'ee17btech11040', 'alhawajri', 'karthikp', 'ee17btech11012', 'yury_matveyev', 'amritpal95', 'ee17btech11021', 'enricobaiano1', 'sumanthcherupally', 'ee17btech11014', 'yogeshubbu', 'ee17btech11034', 'es16btech11026', 'siddharthmanu500', 'ee17btech11016', 'prag', 'falconrider10', 'k.vamshika', 'ee17btech11036', 'ee17btech11037', 'pradeepmoturi', 'parimiamrit', 'raktim', 'ee17btech11050', 'hassanmughal92', '124guna']"
18,46,38,52,38,"['asultan1996', 'shaikhah30121', 'hmdmyabb', 'saroom96', 'aishah', 'fatemah.aleid37', 'kabdulsayed', 'mackintosha7', 'fatemah96', 'hawraalsahhaf', 'sarahnano1', 'mjmutairi', 'fatemahkhaled1998', 'fatmaaalsarhan39', 'aahmadi71995', 'youq8_1', 'shaikhahboareki', 'moudhima', 'ahmadshamsaldeen96', 'akalothainah59', 'shahadalmotairi', 'anwarekhrais1', 'heba.30936.aum', 'nada96', 'hjyagout30936', 'nopha96', 'ritaj345', 'fabualhasan6', 'poyaka619', 'shaikha.alameer97', 'mariamrald.2169', 'rzouf', 'eng.nawafr', 'shaikhalameer97', 'alshammarih96', 'gooz1915', 'fajeralanzi56', 'atoooma18']",0,[],14,"['akarar', 'latifa', 'hadeel.lsoc', 'rtalturkomani', 'mjmutairi6', 'fajer92', 'cerebrus989', 'bilel.neji', 'ruqaya30aum', 'wafarag', 'abdullah.s.karar', 'teyrxq8', 'azizalshaban', 'farahaljasser97']",52,"['asultan1996', 'fatemah.aleid37', 'fatemah96', 'hawraalsahhaf', 'sarahnano1', 'teyrxq8', 'fatmaaalsarhan39', 'aahmadi71995', 'youq8_1', 'shaikhahboareki', 'latifa', 'akalothainah59', 'shahadalmotairi', 'anwarekhrais1', 'heba.30936.aum', 'ruqaya30aum', 'abdullah.s.karar', 'azizalshaban', 'mariamrald.2169', 'fajer92', 'rzouf', 'eng.nawafr', 'shaikhalameer97', 'nopha96', 'atoooma18', 'shaikhah30121', 'hmdmyabb', 'saroom96', 'aishah', 'kabdulsayed', 'mackintosha7', 'mjmutairi', 'fatemahkhaled1998', 'hadeel.lsoc', 'cerebrus989', 'bilel.neji', 'wafarag', 'moudhima', 'akarar', 'ahmadshamsaldeen96', 'rtalturkomani', 'farahaljasser97', 'mjmutairi6', 'nada96', 'hjyagout30936', 'ritaj345', 'fabualhasan6', 'poyaka619', 'shaikha.alameer97', 'alshammarih96', 'gooz1915', 'fajeralanzi56']"
18,162,38,9,3,"['nopha96', 'heba.30936.aum', 'aishah']",35,"['asultan1996', 'shaikhah30121', 'hmdmyabb', 'saroom96', 'fatemah.aleid37', 'kabdulsayed', 'mackintosha7', 'fatemah96', 'hawraalsahhaf', 'sarahnano1', 'mjmutairi', 'fatemahkhaled1998', 'fatmaaalsarhan39', 'aahmadi71995', 'youq8_1', 'shaikhahboareki', 'moudhima', 'ahmadshamsaldeen96', 'akalothainah59', 'shahadalmotairi', 'anwarekhrais1', 'nada96', 'hjyagout30936', 'ritaj345', 'fabualhasan6', 'poyaka619', 'shaikha.alameer97', 'mariamrald.2169', 'rzouf', 'eng.nawafr', 'shaikhalameer97', 'alshammarih96', 'gooz1915', 'fajeralanzi56', 'atoooma18']",6,"['anfal', 's41751', 'wafarag', 'alyaasm96', 'bilaljaba', 'abstraxt']",44,"['asultan1996', 'shaikhah30121', 'anfal', 'hmdmyabb', 'saroom96', 'aishah', 'fatemah.aleid37', 's41751', 'kabdulsayed', 'mackintosha7', 'fatemah96', 'hawraalsahhaf', 'mjmutairi', 'abstraxt', 'alshammarih96', 'fatemahkhaled1998', 'fatmaaalsarhan39', 'aahmadi71995', 'youq8_1', 'wafarag', 'bilaljaba', 'shaikhahboareki', 'moudhima', 'ahmadshamsaldeen96', 'akalothainah59', 'shahadalmotairi', 'anwarekhrais1', 'heba.30936.aum', 'nada96', 'hjyagout30936', 'nopha96', 'alyaasm96', 'ritaj345', 'fabualhasan6', 'poyaka619', 'shaikha.alameer97', 'mariamrald.2169', 'rzouf', 'eng.nawafr', 'shaikhalameer97', 'sarahnano1', 'gooz1915', 'fajeralanzi56', 'atoooma18']"
19,46,37,52,4,"['mjmutairi6', 'rtalturkomani', 'ruqaya30aum', 'hadeel.lsoc']",33,"['yousefalnafea', 'donthefalcon', 'malekderbas122', 'zahraaismail35928', 'ali996', 'alialjuma', 'ebrahim', 'mariam6697', 'shaheen_098', 'saud80', 'duha23', 'ms.alqotifi', 'esmarafi98', 'zahraa142aum', 'a7med0galaxy', 'nano_particle', 'boomboom3abod', 'rehamalrejeebah34', 'ghadeer', 'hasabelnaby92', 'abanoub_ibrahim', 'yousefalali_', 'kaboagiza', 'anfal55', 'mhd148', 'daiyooona', 'himepi96', 'huda98', 'taifsaleh22', 'sarah9966', 'webballen', 'alaa.ekaram', 'lujain26428']",48,"['asultan1996', 'shaikhah30121', 'hmdmyabb', 'saroom96', 'fatemah.aleid37', 'aishah', 'kabdulsayed', 'mackintosha7', 'fatemah96', 'hawraalsahhaf', 'teyrxq8', 'mjmutairi', 'alshammarih96', 'fatemahkhaled1998', 'fatmaaalsarhan39', 'cerebrus989', 'aahmadi71995', 'youq8_1', 'bilel.neji', 'wafarag', 'shaikhahboareki', 'moudhima', 'akarar', 'latifa', 'ahmadshamsaldeen96', 'shahadalmotairi', 'akalothainah59', 'farahaljasser97', 'anwarekhrais1', 'heba.30936.aum', 'nada96', 'hjyagout30936', 'nopha96', 'abdullah.s.karar', 'azizalshaban', 'ritaj345', 'fabualhasan6', 'poyaka619', 'shaikha.alameer97', 'mariamrald.2169', 'fajer92', 'rzouf', 'eng.nawafr', 'shaikhalameer97', 'sarahnano1', 'gooz1915', 'fajeralanzi56', 'atoooma18']",85,"['asultan1996', 'donthefalcon', 'malekderbas122', 'ali996', 'fatemah.aleid37', 'ebrahim', 'mariam6697', 'teyrxq8', 'shaheen_098', 'hawraalsahhaf', 'fatemah96', 'saud80', 'alshammarih96', 'ms.alqotifi', 'fatmaaalsarhan39', 'esmarafi98', 'zahraa142aum', 'a7med0galaxy', 'aahmadi71995', 'youq8_1', 'nano_particle', 'shaikhahboareki', 'rehamalrejeebah34', 'latifa', 'ghadeer', 'hasabelnaby92', 'shahadalmotairi', 'akalothainah59', 'anwarekhrais1', 'yousefalali_', 'kaboagiza', 'heba.30936.aum', 'anfal55', 'mhd148', 'ruqaya30aum', 'daiyooona', 'abdullah.s.karar', 'azizalshaban', 'mariamrald.2169', 'taifsaleh22', 'sarah9966', 'fajer92', 'rzouf', 'webballen', 'alaa.ekaram', 'eng.nawafr', 'shaikhalameer97', 'nopha96', 'atoooma18', 'shaikhah30121', 'yousefalnafea', 'hmdmyabb', 'zahraaismail35928', 'saroom96', 'alialjuma', 'aishah', 'kabdulsayed', 'mackintosha7', 'mjmutairi', 'duha23', 'fatemahkhaled1998', 'hadeel.lsoc', 'cerebrus989', 'bilel.neji', 'wafarag', 'moudhima', 'boomboom3abod', 'akarar', 'ahmadshamsaldeen96', 'abanoub_ibrahim', 'rtalturkomani', 'farahaljasser97', 'mjmutairi6', 'nada96', 'hjyagout30936', 'himepi96', 'ritaj345', 'fabualhasan6', 'poyaka619', 'shaikha.alameer97', 'huda98', 'sarahnano1', 'gooz1915', 'fajeralanzi56', 'lujain26428']"
19,101,37,37,31,"['yousefalnafea', 'donthefalcon', 'ali996', 'zahraaismail35928', 'malekderbas122', 'alialjuma', 'ebrahim', 'mariam6697', 'shaheen_098', 'duha23', 'saud80', 'ms.alqotifi', 'esmarafi98', 'zahraa142aum', 'a7med0galaxy', 'nano_particle', 'boomboom3abod', 'rehamalrejeebah34', 'ghadeer', 'abanoub_ibrahim', 'yousefalali_', 'mhd148', 'anfal55', 'ruqaya30aum', 'daiyooona', 'himepi96', 'huda98', 'taifsaleh22', 'sarah9966', 'alaa.ekaram', 'lujain26428']",6,"['hasabelnaby92', 'rtalturkomani', 'hadeel.lsoc', 'mjmutairi6', 'kaboagiza', 'webballen']",6,"['akarar', 'cerebrus989', 'abdullah.s.karar', 'reemaldalamah', 'teyrxq8', 'ssmmoo']",43,"['yousefalnafea', 'donthefalcon', 'malekderbas122', 'ali996', 'zahraaismail35928', 'alialjuma', 'ebrahim', 'mariam6697', 'teyrxq8', 'shaheen_098', 'ssmmoo', 'saud80', 'duha23', 'ms.alqotifi', 'hadeel.lsoc', 'esmarafi98', 'zahraa142aum', 'a7med0galaxy', 'cerebrus989', 'nano_particle', 'boomboom3abod', 'rehamalrejeebah34', 'akarar', 'ghadeer', 'hasabelnaby92', 'abanoub_ibrahim', 'rtalturkomani', 'mjmutairi6', 'yousefalali_', 'kaboagiza', 'anfal55', 'mhd148', 'ruqaya30aum', 'daiyooona', 'himepi96', 'abdullah.s.karar', 'huda98', 'taifsaleh22', 'sarah9966', 'webballen', 'alaa.ekaram', 'reemaldalamah', 'lujain26428']"
20,35,36,36,35,"['baberge', 'abertra1', 'jhern148', 'tienvo1', 'gaross2', 'jcpowel8', 'ealmesri', 'stweston', 'rgerbino', 'awirkusc', 'amjorge1', 'jdsmit60', 'ksenturk', 'jjgreen2', 'bsweekly', 'bhscobie', 'tethingt', 'kmangers', 'trsauer', 'gkim50', 'jdan2', 'maalkha1', 'bpsmit20', 'nsoderbe', 'nsandys', 'xzhan445', 'jesorian', 'kpuncha', 'jasanc28', 'ttmccart', 'dlirwin', 'coreymlh', 'jstewa20', 'mfelixca', 'sterry6']",1,['wtenniso'],1,['yhzhang99'],37,"['baberge', 'abertra1', 'jhern148', 'tienvo1', 'gaross2', 'jcpowel8', 'ealmesri', 'stweston', 'rgerbino', 'awirkusc', 'amjorge1', 'jdsmit60', 'ksenturk', 'jjgreen2', 'tethingt', 'bhscobie', 'kmangers', 'bsweekly', 'trsauer', 'gkim50', 'jdan2', 'maalkha1', 'bpsmit20', 'nsoderbe', 'mfelixca', 'nsandys', 'yhzhang99', 'xzhan445', 'jesorian', 'kpuncha', 'wtenniso', 'jasanc28', 'ttmccart', 'coreymlh', 'jstewa20', 'dlirwin', 'sterry6']"
21,189,35,41,35,"['iskatel42', 'stormermatthew', 'pmehta97', 'dang4213', 'victor.chen623', 'millerp97', 'apecoraro', 'kevindavis11', 'quartincz', 'mimiwilliams', 'willil13', 'ryleejc', 'tgrounds33', 'atablizo6', 'schasen97', 'keslern', 'm8porterfield', 'delorm', 'keblinski', 'kubicf', 'alianna.maguire', 'parthbhide314', 'yangd9', 'jnlloyd10', 'abhishandy', 'pena.carlos056', 'jmweinstein2', 'alexperkins828', 'hovhaa', 'hanchuan', 'madigc3', 'alicechiu1126', 'dkzr2015', 'les', 'yyf97']",0,[],6,"['feraca', 'wenzhuoqun', 'kondrb', 'tashit', 'macdoc', 'naomi.williams903']",41,"['iskatel42', 'kondrb', 'stormermatthew', 'pmehta97', 'dang4213', 'victor.chen623', 'millerp97', 'apecoraro', 'naomi.williams903', 'kevindavis11', 'quartincz', 'mimiwilliams', 'willil13', 'ryleejc', 'tgrounds33', 'atablizo6', 'schasen97', 'keslern', 'm8porterfield', 'feraca', 'delorm', 'keblinski', 'kubicf', 'alianna.maguire', 'tashit', 'parthbhide314', 'yangd9', 'macdoc', 'jnlloyd10', 'abhishandy', 'pena.carlos056', 'jmweinstein2', 'alexperkins828', 'hovhaa', 'wenzhuoqun', 'hanchuan', 'madigc3', 'alicechiu1126', 'dkzr2015', 'les', 'yyf97']"
23,181,32,27,23,"['chuang5679', 'murlocking', 'shikamaru0922', 'uclahuangxin', 'qianliu0120', 'jameskpenney', 'oleon95', 'yihong0807', 'frankpan96', 'osgarcia', 'ksanche32', 'yingjied', 'judywei0101', 'ruoxia', 'xinranz1216104', 'robin1221', 'curtis804', 'neelb96', 'yuchun7', 'viraatsh', 'aghazari', 'derekrsdhl', 'creichen']",9,"['arthurssu', 'mtmaccc', 'zy111693', 'gibbsfree', 'kfitzell29', 'pshir', 'davidkelly', 'boyao', 'jameslewang1994']",4,"['shaoyou', 'mariah741', 'hardikh94', 'gig26']",36,"['chuang5679', 'mtmaccc', 'murlocking', 'shikamaru0922', 'uclahuangxin', 'qianliu0120', 'jameskpenney', 'boyao', 'oleon95', 'yihong0807', 'mariah741', 'zy111693', 'jameslewang1994', 'gig26', 'frankpan96', 'pshir', 'osgarcia', 'davidkelly', 'ksanche32', 'yingjied', 'judywei0101', 'arthurssu', 'ruoxia', 'shaoyou', 'hardikh94', 'xinranz1216104', 'robin1221', 'curtis804', 'neelb96', 'gibbsfree', 'kfitzell29', 'yuchun7', 'viraatsh', 'aghazari', 'derekrsdhl', 'creichen']"
23,182,32,6,6,"['chuang5679', 'zy111693', 'mtmaccc', 'boyao', 'creichen', 'robin1221']",26,"['murlocking', 'shikamaru0922', 'uclahuangxin', 'qianliu0120', 'jameskpenney', 'oleon95', 'yihong0807', 'jameslewang1994', 'frankpan96', 'pshir', 'osgarcia', 'davidkelly', 'ksanche32', 'yingjied', 'judywei0101', 'arthurssu', 'ruoxia', 'xinranz1216104', 'curtis804', 'neelb96', 'gibbsfree', 'kfitzell29', 'yuchun7', 'viraatsh', 'aghazari', 'derekrsdhl']",0,[],32,"['chuang5679', 'mtmaccc', 'murlocking', 'shikamaru0922', 'uclahuangxin', 'qianliu0120', 'jameskpenney', 'boyao', 'oleon95', 'yihong0807', 'zy111693', 'jameslewang1994', 'frankpan96', 'pshir', 'osgarcia', 'davidkelly', 'ksanche32', 'yingjied', 'judywei0101', 'arthurssu', 'ruoxia', 'xinranz1216104', 'robin1221', 'curtis804', 'neelb96', 'gibbsfree', 'kfitzell29', 'yuchun7', 'viraatsh', 'aghazari', 'derekrsdhl', 'creichen']"
23,188,32,6,5,"['neelb96', 'mtmaccc', 'yuchun7', 'viraatsh', 'creichen']",27,"['chuang5679', 'murlocking', 'shikamaru0922', 'uclahuangxin', 'qianliu0120', 'jameskpenney', 'boyao', 'oleon95', 'yihong0807', 'zy111693', 'jameslewang1994', 'frankpan96', 'pshir', 'osgarcia', 'davidkelly', 'ksanche32', 'yingjied', 'judywei0101', 'arthurssu', 'ruoxia', 'xinranz1216104', 'robin1221', 'curtis804', 'gibbsfree', 'kfitzell29', 'aghazari', 'derekrsdhl']",1,['hardikh94'],33,"['chuang5679', 'mtmaccc', 'murlocking', 'shikamaru0922', 'uclahuangxin', 'qianliu0120', 'jameskpenney', 'boyao', 'oleon95', 'yihong0807', 'zy111693', 'jameslewang1994', 'frankpan96', 'pshir', 'osgarcia', 'davidkelly', 'ksanche32', 'yingjied', 'judywei0101', 'arthurssu', 'ruoxia', 'hardikh94', 'xinranz1216104', 'robin1221', 'curtis804', 'neelb96', 'gibbsfree', 'kfitzell29', 'yuchun7', 'viraatsh', 'aghazari', 'derekrsdhl', 'creichen']"
25,42,27,28,26,"['galboum', 'cjupina', 'kfriedel', 'ckotwic2', 'rfinerty54', 'nhabre', 'tfannin2', 'ecorazza', 'mgalvi11', 'sculloo', 'mbicknese', 'dwalsh23', 'nbuchwal', 'lmcdono6', 'bbode', 'gmodano', 'courtneyradz', 'akontrimas', 'tmurra21', 'graceembrey', 'aetim', 'mbrett4', 'mgreen32', 'dawson87', 'tzhang01', 'congji1999']",1,['mongkuwuratii'],2,"['ogreene2', 'samalfit']",29,"['galboum', 'cjupina', 'kfriedel', 'ckotwic2', 'rfinerty54', 'ogreene2', 'nhabre', 'tfannin2', 'ecorazza', 'mgalvi11', 'sculloo', 'mbicknese', 'dwalsh23', 'nbuchwal', 'lmcdono6', 'bbode', 'gmodano', 'courtneyradz', 'akontrimas', 'mongkuwuratii', 'tmurra21', 'graceembrey', 'aetim', 'mbrett4', 'mgreen32', 'samalfit', 'dawson87', 'tzhang01', 'congji1999']"
26,96,26,39,26,"['jaardila', 'nicolash025', 'sebas.villaba2002', 'uniandes1', 'gonzaloemr', 'julissa.vigoya', 'jufepas98', 'fabser7', 'jeisson1299', 'df.pena12', 'svitery', 'maria.a.solano.otero', 'niko_abril_cruz', 'kevinbernalru', 'cceballos1003', 'alesk1208', 'apqc1998', 'ma.mozo', 's.villamilp', 'ae.penagoss', 'solerjavier7', 'mugnier', 'felipehdz', 'juan98', 'nanoxzapata', 'v.cardonac1']",0,[],13,"['juliortegon', 'manolobetancur', 'michaelj00', 'jchaparrog10', 'josemajaramilloh', 'adrianapquijanoc', 'sn.vargas', 'mafeflorian7', 'carlos.cg.gomez', 'ale_1201', 'haroldsteven013', 'alejandra.tobo1', 'jhonseebb']",39,"['jaardila', 'nicolash025', 'jchaparrog10', 'josemajaramilloh', 'adrianapquijanoc', 'uniandes1', 'sebas.villaba2002', 'gonzaloemr', 'fabser7', 'jeisson1299', 'svitery', 'maria.a.solano.otero', 'alejandra.tobo1', 'niko_abril_cruz', 'michaelj00', 'apqc1998', 's.villamilp', 'ae.penagoss', 'ale_1201', 'solerjavier7', 'mugnier', 'mafeflorian7', 'juan98', 'nanoxzapata', 'julissa.vigoya', 'jufepas98', 'jhonseebb', 'sn.vargas', 'df.pena12', 'carlos.cg.gomez', 'juliortegon', 'manolobetancur', 'kevinbernalru', 'cceballos1003', 'alesk1208', 'ma.mozo', 'felipehdz', 'haroldsteven013', 'v.cardonac1']"
27,110,24,7,7,"['ipetrovecki', 'matej.cinderela', 'matijapucek', 'mihovilberam', 'ivansirovina', 'mica55', 'mmatic2010']",17,"['rohityadav7787', 'watson', 'az49711', 'vyasatnanohub2015', 'gohari95', 'mjakovc', 'djogot', 'lovro.markovic', 'mica5555', 'dariosirovina0', 'ahmed_moustafa_94', 'serag', 'sagun434', 'ani.s18', 'goap23', 'dominik76', 'skymasterrms']",0,[],24,"['az49711', 'vyasatnanohub2015', 'gohari95', 'ipetrovecki', 'matej.cinderela', 'mjakovc', 'lovro.markovic', 'matijapucek', 'dariosirovina0', 'mihovilberam', 'serag', 'ani.s18', 'sagun434', 'mica55', 'rohityadav7787', 'watson', 'djogot', 'mica5555', 'ahmed_moustafa_94', 'dominik76', 'ivansirovina', 'goap23', 'skymasterrms', 'mmatic2010']"
28,164,23,41,15,"['pranalikothekar5', 'akankshachandoskar1198', 'rahulbirwadkar123', 'bhai0045', 'pnrs.pratik', 'shripal17', 'prajaktathorat24', 'aditiramadwar', 'sourabhkothari16', 'pranjalijadhav0911', 'kajalbhoite04', 'gauribahatkar', 'prathamesh.shivmare1', 'joishersweta17695', 'hsnnalwala7']",8,"['juileebharate10797', 'pratikkul26', 'adityakini21', 'nicket9', 'piyamodhve', 'omimore24', 'pjkarmokar', 'rutujakamthe']",26,"['urmil1700', 'rakeshpatil9271', 'bendalneha', 'adisawant333', 'bhupeshpatil98', 'ashnavirdikar.av', 'rasikapednekar20', 'arfat_24', 'welingnamrata', 'divyassonawane', 'salvir481', 'arpitgodbole7', 'sonalikharade5', 'rohit.elawadekar333', '100vichare', 'aritramondal151', 'rakeshpatil3019', 'priyankakunde22', 'sanjit', 'prathameshpatle13', 'sukanyajadhav1997', 'jinku5454', 'owais11', 'anujmdeorukhkar', 'kedar.kulkarni12', 'aquibansari12377']",49,"['adityakini21', 'rahulbirwadkar123', 'bendalneha', 'gauribahatkar', 'hsnnalwala7', 'ashnavirdikar.av', 'bhai0045', 'pnrs.pratik', 'welingnamrata', 'pranjalijadhav0911', 'pranalikothekar5', 'salvir481', 'piyamodhve', 'prathamesh.shivmare1', 'sanjit', 'prathameshpatle13', 'sukanyajadhav1997', 'pratikkul26', 'jinku5454', 'sourabhkothari16', 'anujmdeorukhkar', 'joishersweta17695', 'rutujakamthe', 'urmil1700', 'rakeshpatil9271', 'shripal17', 'prajaktathorat24', 'adisawant333', 'kajalbhoite04', 'bhupeshpatil98', 'arfat_24', 'omimore24', 'pjkarmokar', 'juileebharate10797', 'divyassonawane', 'arpitgodbole7', 'nicket9', 'sonalikharade5', 'rohit.elawadekar333', '100vichare', 'aritramondal151', 'rakeshpatil3019', 'priyankakunde22', 'akankshachandoskar1198', 'owais11', 'aditiramadwar', 'rasikapednekar20', 'kedar.kulkarni12', 'aquibansari12377']"
28,165,23,18,4,"['pnrs.pratik', 'pranjalijadhav0911', 'shripal17', 'hsnnalwala7']",19,"['adityakini21', 'rahulbirwadkar123', 'prajaktathorat24', 'kajalbhoite04', 'gauribahatkar', 'bhai0045', 'omimore24', 'pjkarmokar', 'juileebharate10797', 'pranalikothekar5', 'nicket9', 'piyamodhve', 'prathamesh.shivmare1', 'pratikkul26', 'akankshachandoskar1198', 'aditiramadwar', 'sourabhkothari16', 'joishersweta17695', 'rutujakamthe']",14,"['susmeetsukte', 'divyassonawane', 'kaushiksawant93', 'prachi.mujawar', 'max_mercury', 'owais11', 'rms.maurya21', 'ardalvi85', 'bhandarepranay9208', 'adisawant333', 'priyankakunde22', 'siddhesh.soyane', 'rishimud', 'rajashree.pimputkar']",37,"['adityakini21', 'rahulbirwadkar123', 'shripal17', 'prajaktathorat24', 'ardalvi85', 'adisawant333', 'kajalbhoite04', 'gauribahatkar', 'susmeetsukte', 'hsnnalwala7', 'bhai0045', 'pnrs.pratik', 'rms.maurya21', 'pranjalijadhav0911', 'bhandarepranay9208', 'omimore24', 'pjkarmokar', 'juileebharate10797', 'pranalikothekar5', 'divyassonawane', 'kaushiksawant93', 'prachi.mujawar', 'nicket9', 'max_mercury', 'piyamodhve', 'prathamesh.shivmare1', 'priyankakunde22', 'rishimud', 'pratikkul26', 'akankshachandoskar1198', 'owais11', 'aditiramadwar', 'sourabhkothari16', 'siddhesh.soyane', 'joishersweta17695', 'rutujakamthe', 'rajashree.pimputkar']"
28,167,23,9,1,['rutujakamthe'],22,"['adityakini21', 'rahulbirwadkar123', 'shripal17', 'prajaktathorat24', 'kajalbhoite04', 'gauribahatkar', 'hsnnalwala7', 'bhai0045', 'pnrs.pratik', 'pranjalijadhav0911', 'omimore24', 'pjkarmokar', 'juileebharate10797', 'pranalikothekar5', 'nicket9', 'piyamodhve', 'prathamesh.shivmare1', 'pratikkul26', 'akankshachandoskar1198', 'aditiramadwar', 'sourabhkothari16', 'joishersweta17695']",8,"['sarika_bukkawar', 'pranav123', 'max_mercury', 'mayanksamar786', 'shantanupanigrahi98', 'aloksardesai97', 'akshatask', 'chetushirke']",31,"['juileebharate10797', 'pranalikothekar5', 'adityakini21', 'rahulbirwadkar123', 'pranav123', 'shripal17', 'nicket9', 'max_mercury', 'shantanupanigrahi98', 'prajaktathorat24', 'kajalbhoite04', 'piyamodhve', 'gauribahatkar', 'prathamesh.shivmare1', 'aloksardesai97', 'hsnnalwala7', 'akshatask', 'pratikkul26', 'akankshachandoskar1198', 'bhai0045', 'sarika_bukkawar', 'pnrs.pratik', 'mayanksamar786', 'aditiramadwar', 'sourabhkothari16', 'pranjalijadhav0911', 'omimore24', 'joishersweta17695', 'pjkarmokar', 'rutujakamthe', 'chetushirke']"
29,165,23,18,5,"['kaushiksawant93', 'rms.maurya21', 'ardalvi85', 'bhandarepranay9208', 'siddhesh.soyane']",18,"['nikwade.damini95', 'verma_34dh', 'zainabshah181997', 'aishwaryahiwale97', 'priyankasingh754', 'saritav.9600', 'seemasaini282', 'rushikeshrane27', 'durgeshthorat4', 'tanvipalande', 'ovrale', 'ajinkyasoman', 'runakshi97', 'urmilabachate20', 'nageshjaiswar11', 'sanket.r.makwana', 'shantanu123', 'kalyanisahib96']",13,"['divyassonawane', 'prachi.mujawar', 'pnrs.pratik', 'shripal17', 'max_mercury', 'owais11', 'adisawant333', 'pranjalijadhav0911', 'priyankakunde22', 'susmeetsukte', 'hsnnalwala7', 'rishimud', 'rajashree.pimputkar']",36,"['verma_34dh', 'priyankasingh754', 'shripal17', 'ardalvi85', 'adisawant333', 'ovrale', 'urmilabachate20', 'susmeetsukte', 'hsnnalwala7', 'kalyanisahib96', 'pnrs.pratik', 'seemasaini282', 'durgeshthorat4', 'rms.maurya21', 'bhandarepranay9208', 'ajinkyasoman', 'pranjalijadhav0911', 'sanket.r.makwana', 'shantanu123', 'nikwade.damini95', 'zainabshah181997', 'aishwaryahiwale97', 'divyassonawane', 'kaushiksawant93', 'prachi.mujawar', 'max_mercury', 'tanvipalande', 'runakshi97', 'priyankakunde22', 'rishimud', 'saritav.9600', 'rushikeshrane27', 'owais11', 'nageshjaiswar11', 'siddhesh.soyane', 'rajashree.pimputkar']"
29,163,23,6,3,"['verma_34dh', 'priyankasingh754', 'urmilabachate20']",20,"['ardalvi85', 'ovrale', 'kalyanisahib96', 'seemasaini282', 'durgeshthorat4', 'rms.maurya21', 'bhandarepranay9208', 'ajinkyasoman', 'sanket.r.makwana', 'shantanu123', 'nikwade.damini95', 'zainabshah181997', 'aishwaryahiwale97', 'kaushiksawant93', 'tanvipalande', 'runakshi97', 'saritav.9600', 'rushikeshrane27', 'nageshjaiswar11', 'siddhesh.soyane']",3,"['nanomems226', 'ady24k', 'kiranjagdale292']",26,"['nikwade.damini95', 'verma_34dh', 'zainabshah181997', 'aishwaryahiwale97', 'priyankasingh754', 'nanomems226', 'kaushiksawant93', 'ardalvi85', 'tanvipalande', 'ovrale', 'runakshi97', 'urmilabachate20', 'kalyanisahib96', 'saritav.9600', 'seemasaini282', 'rushikeshrane27', 'durgeshthorat4', 'ady24k', 'rms.maurya21', 'bhandarepranay9208', 'ajinkyasoman', 'nageshjaiswar11', 'siddhesh.soyane', 'sanket.r.makwana', 'shantanu123', 'kiranjagdale292']"
30,83,23,24,18,"['nic', 'shelbyjnk', 'mehdi.akeddar', 'anon5678', 'stevocan', 'marwanchehade1997', 'kalilio', 'savvad', 'durnanoliver', 'annemarie.zaccarin', 'jinl0723', 'quentin_norris', 'grier', 'yaqingxia18', 'omar23j', 'tristanrenondin', 'marwanchehade97', 'garethdpeters']",5,"['ksuman.d3', 'krishnamcgill', 'nizamdelhi25', 'mahmudul.hasan.aust.eee', 'tess.van.d123']",6,"['wjymontreal', 'sallychoi0222', 'catherine2019', 'kydlandgong', 'szkopek', 'winnienyakundi0']",29,"['sallychoi0222', 'anon5678', 'krishnamcgill', 'kalilio', 'quentin_norris', 'mahmudul.hasan.aust.eee', 'wjymontreal', 'mehdi.akeddar', 'durnanoliver', 'grier', 'yaqingxia18', 'omar23j', 'tristanrenondin', 'tess.van.d123', 'shelbyjnk', 'catherine2019', 'marwanchehade1997', 'savvad', 'jinl0723', 'garethdpeters', 'kydlandgong', 'nizamdelhi25', 'szkopek', 'winnienyakundi0', 'marwanchehade97', 'nic', 'stevocan', 'ksuman.d3', 'annemarie.zaccarin']"
31,44,23,21,18,"['sofiaarranz', 'wdze1001', 'ajfriedlan', 'turnergarrow', 'raanapooshimin', 'reing1ub', 'jakeerickson', 'toto_bssnt', 'laura.burchell', 'tmosh5', 'e.desroche', 'trix012', 'carmud', 'hadiyamadi', 'juanmanu04', 'will.salmon66', 'sandracheng', 'kiranpreet.birdee']",5,"['mohamed.balboul', 'takassa1986', 'cookiedabaker', '14ers4', 'lzuluckti']",3,"['wolkoff.97', 'waleed97', 'robknobel']",26,"['ajfriedlan', 'raanapooshimin', 'reing1ub', 'jakeerickson', 'carmud', 'kiranpreet.birdee', 'wdze1001', 'sofiaarranz', 'turnergarrow', 'e.desroche', 'hadiyamadi', '14ers4', 'juanmanu04', 'wolkoff.97', 'waleed97', 'laura.burchell', 'tmosh5', 'trix012', 'robknobel', 'will.salmon66', 'sandracheng', 'mohamed.balboul', 'takassa1986', 'cookiedabaker', 'lzuluckti', 'toto_bssnt']"
32,130,22,20,20,"['juji9496', 'cije3835', 'chva6514', 'jasc6140', 'sesh9366', 'tygo2823', 'erda6022', 'jajo8985', 'nuum0371', 'rico4091', 'seet2841', 'brki4304', 'mast4941', 'behe0119', 'dyho9085', 'vezh9312', 'miev4575', 'ruva8462', 'shwo0146', 'ryni0948']",2,"['jeongdiana', 'azevgolatis']",0,[],22,"['azevgolatis', 'juji9496', 'cije3835', 'chva6514', 'jasc6140', 'sesh9366', 'tygo2823', 'erda6022', 'jajo8985', 'nuum0371', 'rico4091', 'jeongdiana', 'seet2841', 'brki4304', 'mast4941', 'behe0119', 'dyho9085', 'vezh9312', 'miev4575', 'ruva8462', 'shwo0146', 'ryni0948']"
33,151,22,35,14,"['adamalfian__', 'chenyongchang', 'juneeee98', '18081357278hjh', 'izzat2774', 'ashsaifullizan97', 'mouxingyu121314', 'wanwan1103', 'yuchennn', 'wanchin', 'kie180029', 'aesaraismat', 'kishen260499', 'moontasirsoumik']",8,"['fairuzzamzak', 'karim7_albaghdady', 'amrelda7', 'ibrahimabdelrahman', 'aaronmanning1999', 'tsluk', 'ahmedgemmy123', 'aminnramli']",21,"['jazlilong', 'tamchouweng', 'redzuan11', 'zikrizaki88995', 'amni99', 'macbelieve', 'desmondsoon', 'musabmalek0717', 'hong_gao', 'yjenyiee155', 'alifzulkifli99', 'nabilah1403', 'youxing0309', 'khor', 'cheokonn', 'mahafizuddin', 'felice', 'exjamil', 'zahrajl124', 'syedzakwan', 'kie180028']",43,"['jazlilong', 'chenyongchang', 'tamchouweng', 'juneeee98', 'fairuzzamzak', 'redzuan11', 'ashsaifullizan97', 'wanwan1103', 'zikrizaki88995', 'ibrahimabdelrahman', 'kishen260499', 'amni99', 'macbelieve', 'desmondsoon', 'musabmalek0717', 'yuchennn', 'amrelda7', 'kie180029', 'aaronmanning1999', 'aesaraismat', 'mouxingyu121314', 'moontasirsoumik', 'adamalfian__', 'hong_gao', 'yjenyiee155', 'izzat2774', 'karim7_albaghdady', 'alifzulkifli99', 'wanchin', 'tsluk', 'nabilah1403', 'youxing0309', 'khor', 'cheokonn', '18081357278hjh', 'mahafizuddin', 'felice', 'exjamil', 'zahrajl124', 'aminnramli', 'syedzakwan', 'ahmedgemmy123', 'kie180028']"
34,160,22,22,21,"['rohit.sharma.17csc', 'nikita.arora.17csc', 'nkonsam', 'm.ananya.17cse', 'kurmala.vishnu.17ece', 'mharshakishan', 'anushk123', 'kakhil201', 'agarwallakshya', 'yaralahruthik', 'imkrishh3', 'mansi.malik.17cse', 'tumati.praneeth.17cse', 'rahul.kalapala', 'codexas', 'nikita.agarwala.17cse', 'naushik', 'jsiddhant12', 'pnarasimha', 'tanishqgarg', 'vishal.sharma.17csc']",1,['zbrzubair.akhter'],1,['omrahulchauhan'],23,"['rohit.sharma.17csc', 'zbrzubair.akhter', 'nikita.arora.17csc', 'nkonsam', 'm.ananya.17cse', 'kurmala.vishnu.17ece', 'mharshakishan', 'anushk123', 'kakhil201', 'agarwallakshya', 'yaralahruthik', 'imkrishh3', 'omrahulchauhan', 'mansi.malik.17cse', 'tumati.praneeth.17cse', 'rahul.kalapala', 'codexas', 'nikita.agarwala.17cse', 'naushik', 'jsiddhant12', 'pnarasimha', 'tanishqgarg', 'vishal.sharma.17csc']"
35,126,21,29,21,"['mario_fernando', 'alan.ramirez096', 'augustocesk2034', 'geflores343', 'salmacp7', 'glloperenah', 'sergio.alejandro.pg', 'luisv33985', 'karinamadrigal', 'esauar', 'orgp', 'dabuce31', 'frankie.hdzfig', 'cielo', 'pmuxea', 'rjimenez', 'adrianrakes', 'joseluis35', 'luismunoz', 'laylet.rterrazas', 'aida.mir.cor']",0,[],8,"['sebastianer', '21itzel.julio', 'amadormpphy', 'elizabeth_mendoza', 'redwing', 'yulissaevazquez', 'portillo90', 'euniceolay']",29,"['mario_fernando', 'alan.ramirez096', 'augustocesk2034', 'geflores343', 'salmacp7', 'glloperenah', 'portillo90', 'sergio.alejandro.pg', 'luisv33985', 'amadormpphy', 'karinamadrigal', 'elizabeth_mendoza', 'yulissaevazquez', 'esauar', 'orgp', 'dabuce31', 'frankie.hdzfig', 'cielo', 'pmuxea', 'euniceolay', 'rjimenez', 'sebastianer', 'adrianrakes', '21itzel.julio', 'redwing', 'joseluis35', 'luismunoz', 'laylet.rterrazas', 'aida.mir.cor']"
36,66,20,19,18,"['giozaffar', 'jackietung1219', 'sal133', 'qinzhao', 'palmore', 'markopeterkovic', 'genevieve.kunkel', 'gil.goviazin', 'alsallamin', 'tworonko', 'jonathan.tran.rmit', 'jab13877', 'akshaytexas88', 'kblandel', 'cli841', 'pguerette', 'giobarc', 'almuhib']",2,"['jkadoko', 'ianbakst']",1,['buehler'],21,"['sal133', 'qinzhao', 'jkadoko', 'cli841', 'pguerette', 'ianbakst', 'almuhib', 'markopeterkovic', 'kblandel', 'buehler', 'palmore', 'genevieve.kunkel', 'gil.goviazin', 'akshaytexas88', 'giobarc', 'jackietung1219', 'alsallamin', 'tworonko', 'jonathan.tran.rmit', 'giozaffar', 'jab13877']"
37,84,20,25,16,"['monetalberts', 'kevinsaythavy', 'jasonpowell1', 'oliviamaryon', 'hunterg54', 'chrisjones', 'henrikunold', 'kendranoneman', 'jameslamb', 'arielweltner', 'claireadams', 'nathantokarz', 'tylerwebb508', 'jesseschimpf', 'jiheonkwon', 'raiflyon']",4,"['alimustafa', 'tic_ticboom', 'gregorynoble27000', 'jadamsmiller']",9,"['michaeleppel', 'gregorynoble', 'cataanderson1103', 'samuelmcmurdie', 'scottbirks', 'johnpage', 'forestswanson', 'arvincunningham', 'bradygarringer']",29,"['gregorynoble', 'cataanderson1103', 'johnpage', 'arielweltner', 'monetalberts', 'kendranoneman', 'jameslamb', 'tylerwebb508', 'jiheonkwon', 'gregorynoble27000', 'bradygarringer', 'oliviamaryon', 'samuelmcmurdie', 'chrisjones', 'henrikunold', 'forestswanson', 'jesseschimpf', 'jasonpowell1', 'arvincunningham', 'michaeleppel', 'kevinsaythavy', 'hunterg54', 'jadamsmiller', 'alimustafa', 'tic_ticboom', 'scottbirks', 'claireadams', 'nathantokarz', 'raiflyon']"
37,179,20,15,2,"['gregorynoble27000', 'arielweltner']",18,"['monetalberts', 'kevinsaythavy', 'jasonpowell1', 'oliviamaryon', 'hunterg54', 'chrisjones', 'jadamsmiller', 'alimustafa', 'tic_ticboom', 'henrikunold', 'kendranoneman', 'jameslamb', 'claireadams', 'nathantokarz', 'tylerwebb508', 'jesseschimpf', 'jiheonkwon', 'raiflyon']",13,"['embersikorski', 'gregorynoble', 'sjriley', 'jordanvandegrift', 'stevejohns', 'mar4557', 'samuelpedersen', 'addielupercio', 'tragon', 'steve.r6531', 'timphero', 'andrewarmstrong858', 'lanlibsu']",33,"['gregorynoble', 'embersikorski', 'sjriley', 'oliviamaryon', 'stevejohns', 'chrisjones', 'henrikunold', 'arielweltner', 'addielupercio', 'tragon', 'jesseschimpf', 'steve.r6531', 'jasonpowell1', 'timphero', 'monetalberts', 'kevinsaythavy', 'hunterg54', 'jadamsmiller', 'jordanvandegrift', 'alimustafa', 'tic_ticboom', 'mar4557', 'kendranoneman', 'jameslamb', 'claireadams', 'nathantokarz', 'samuelpedersen', 'tylerwebb508', 'jiheonkwon', 'gregorynoble27000', 'andrewarmstrong858', 'raiflyon', 'lanlibsu']"
39,52,20,125,19,"['mcdona85', 'smit3180', 'caldwe29', 'cpiepen', 'rao75', 'nramli', 'tthieles', 'aguyre', 'jkueche', 'vwallema', 'eforti', 'wan52', 'xng', 'nafandi', 'cbischof', 'shaw108', 'davids19', 'muelle77', 'jrohman']",1,['gmclaugh'],106,"['jfolkers', 'btestin14', 'radhakr3', 'purduechen2203', 'tilley0', 'ryry1644', 'samm', 'itsmemario', 'evdaly', 'dkilgor', 'fischermben', 'afalkenb', 'lee2370', 'mingusnate', 'angbecker', 'arturotrevino', 'hess35', 'cmelchin', 'nathanmoore', 'oliver67', 'akonopa', 'lmeehann', 'starr21', 'kjh94425', 'jwoon', 'rishiprasadha', 'rileyedelaney', 'singh378', 'maxwellfra16', 'goh5', 'talon34567', 'river132', 'athoman', 'shadow66666', 'chiranth7954', 'conner.swift8', 'boninim', 'kevinodonnell0878', 'khageman', 'ggolla', 'jdanek', 'ebehring', 'cartmaster007', 'rhellyer', 'agalema1027', 'rsusler', 'chanwoo.lee.17', 'selawada', 'kskripakaran0810', 'charlesma423', 'joshuajkporter', 'ehonebri', 'ecronin', 'mccaul', 'jkekre', 'suhaira97', 'nhdorcy', 'garret28', 'jacobglvn', 'anthonm', 'landon.glunt', 'sueprasad8214', 'dschull', 'bsmrdel', 'albrect', 'ryanwest1040', 'ikobayas', 'mcrees', 'acostab', 'kgmcginley', 'srasche', 'hyndmanjustin', 'rao53', 'justj', 'dgreiwe', 'kknowlto', 'crhodine', 'rwiebe', 'huan1146', 'heinzt', 'tgiazzon', 'kico', 'ggauthi', 'wstolz', 'george7elias', 'yang1206', 'psumner', 'geyerg', 'jskeens', 'yizhizhang', 'cclapham', 'vpope', 'akreuter', 'nikhilcarneiro4', 'asartor', 'john1886', 'zjohnson834', 'suran9712', 'sknecht', 'amckeska', 'dsfgdsfg', 'mcclure8', 'nt230', 'akreilei', 'yeager5', 'kruege14']",126,"['mcdona85', 'radhakr3', 'purduechen2203', 'ryry1644', 'samm', 'evdaly', 'dkilgor', 'afalkenb', 'lee2370', 'mingusnate', 'hess35', 'cmelchin', 'nathanmoore', 'oliver67', 'akonopa', 'lmeehann', 'starr21', 'jwoon', 'rileyedelaney', 'talon34567', 'river132', 'wan52', 'kevinodonnell0878', 'khageman', 'ebehring', 'cartmaster007', 'selawada', 'kskripakaran0810', 'muelle77', 'charlesma423', 'joshuajkporter', 'ehonebri', 'suhaira97', 'jacobglvn', 'dschull', 'nramli', 'bsmrdel', 'albrect', 'mcrees', 'acostab', 'tthieles', 'rao53', 'dgreiwe', 'kknowlto', 'rwiebe', 'heinzt', 'kico', 'jkueche', 'ggauthi', 'wstolz', 'vwallema', 'george7elias', 'yang1206', 'nafandi', 'vpope', 'nikhilcarneiro4', 'asartor', 'zjohnson834', 'davids19', 'akreilei', 'yeager5', 'kruege14', 'chanwoo.lee.17', 'jfolkers', 'smit3180', 'btestin14', 'tilley0', 'itsmemario', 'cpiepen', 'fischermben', 'angbecker', 'arturotrevino', 'kjh94425', 'aguyre', 'rishiprasadha', 'singh378', 'maxwellfra16', 'goh5', 'athoman', 'shadow66666', 'chiranth7954', 'conner.swift8', 'boninim', 'xng', 'cbischof', 'ggolla', 'jdanek', 'shaw108', 'rhellyer', 'agalema1027', 'rsusler', 'gmclaugh', 'jrohman', 'ecronin', 'mccaul', 'jkekre', 'nhdorcy', 'garret28', 'caldwe29', 'anthonm', 'landon.glunt', 'sueprasad8214', 'rao75', 'ryanwest1040', 'ikobayas', 'kgmcginley', 'srasche', 'hyndmanjustin', 'justj', 'crhodine', 'huan1146', 'tgiazzon', 'psumner', 'geyerg', 'eforti', 'jskeens', 'yizhizhang', 'cclapham', 'akreuter', 'john1886', 'suran9712', 'sknecht', 'amckeska', 'dsfgdsfg', 'mcclure8', 'nt230']"
39,152,20,21,19,"['mcdona85', 'smit3180', 'caldwe29', 'cpiepen', 'rao75', 'nramli', 'tthieles', 'aguyre', 'jkueche', 'vwallema', 'wan52', 'xng', 'nafandi', 'cbischof', 'shaw108', 'gmclaugh', 'davids19', 'muelle77', 'jrohman']",1,['eforti'],2,"['starr21', 'mshisheh']",22,"['mcdona85', 'smit3180', 'caldwe29', 'cpiepen', 'rao75', 'nramli', 'mshisheh', 'tthieles', 'starr21', 'aguyre', 'jkueche', 'vwallema', 'eforti', 'wan52', 'xng', 'nafandi', 'cbischof', 'shaw108', 'gmclaugh', 'davids19', 'muelle77', 'jrohman']"
39,153,20,5,4,"['cbischof', 'shaw108', 'caldwe29', 'rao75']",16,"['vwallema', 'mcdona85', 'tthieles', 'smit3180', 'gmclaugh', 'eforti', 'wan52', 'xng', 'cpiepen', 'davids19', 'nafandi', 'muelle77', 'jrohman', 'aguyre', 'nramli', 'jkueche']",1,['chunyuli'],21,"['vwallema', 'mcdona85', 'smit3180', 'eforti', 'caldwe29', 'wan52', 'xng', 'cpiepen', 'nafandi', 'rao75', 'cbischof', 'nramli', 'shaw108', 'tthieles', 'chunyuli', 'gmclaugh', 'davids19', 'muelle77', 'jrohman', 'aguyre', 'jkueche']"
40,59,19,21,19,"['anujchhabra25', 'asifhb21', 'kartikkanchan95', 'swara37', '72parab', 'uppalrishabh35', 'shettyanish1294', 'sushantbabar2396', 'shruti1161997', 'khamkar.amar2016', 'aspal.rathod08', 'samir.kane143', 'thush123', 'rutuja15el', 'ridz21jan', 'vitthalkhatmode', 'anishsagvekar9847', 'nehashinde631', 'shishirp97']",0,[],2,"['patilprasad0123', 'zeevd19']",21,"['anujchhabra25', 'asifhb21', 'kartikkanchan95', 'swara37', 'zeevd19', '72parab', 'uppalrishabh35', 'shettyanish1294', 'sushantbabar2396', 'shruti1161997', 'patilprasad0123', 'khamkar.amar2016', 'aspal.rathod08', 'samir.kane143', 'thush123', 'rutuja15el', 'ridz21jan', 'vitthalkhatmode', 'anishsagvekar9847', 'nehashinde631', 'shishirp97']"
41,164,19,41,14,"['rasikapednekar20', 'divyassonawane', 'arpitgodbole7', 'rakeshpatil9271', 'salvir481', 'priyankakunde22', 'sonalikharade5', 'owais11', 'adisawant333', 'anujmdeorukhkar', 'sanjit', 'prathameshpatle13', 'sukanyajadhav1997', 'ashnavirdikar.av']",5,"['prachi.mujawar', 'max_mercury', 'akshatask', 'javedptl', 'rajashree.pimputkar']",27,"['urmil1700', 'rahulbirwadkar123', 'shripal17', 'bendalneha', 'prajaktathorat24', 'kajalbhoite04', 'bhupeshpatil98', 'gauribahatkar', 'hsnnalwala7', 'arfat_24', 'bhai0045', 'pnrs.pratik', 'welingnamrata', 'pranjalijadhav0911', 'pranalikothekar5', 'rohit.elawadekar333', '100vichare', 'aritramondal151', 'rakeshpatil3019', 'prathamesh.shivmare1', 'jinku5454', 'akankshachandoskar1198', 'aditiramadwar', 'sourabhkothari16', 'joishersweta17695', 'kedar.kulkarni12', 'aquibansari12377']",46,"['urmil1700', 'rakeshpatil9271', 'rahulbirwadkar123', 'shripal17', 'bendalneha', 'prajaktathorat24', 'adisawant333', 'kajalbhoite04', 'bhupeshpatil98', 'gauribahatkar', 'akshatask', 'hsnnalwala7', 'ashnavirdikar.av', 'arfat_24', 'anujmdeorukhkar', 'bhai0045', 'pnrs.pratik', 'welingnamrata', 'pranjalijadhav0911', 'javedptl', 'pranalikothekar5', 'divyassonawane', 'arpitgodbole7', 'salvir481', 'prachi.mujawar', 'max_mercury', 'sonalikharade5', 'rohit.elawadekar333', '100vichare', 'aritramondal151', 'rakeshpatil3019', 'prathamesh.shivmare1', 'priyankakunde22', 'aquibansari12377', 'sanjit', 'prathameshpatle13', 'sukanyajadhav1997', 'jinku5454', 'akankshachandoskar1198', 'owais11', 'aditiramadwar', 'sourabhkothari16', 'rasikapednekar20', 'joishersweta17695', 'kedar.kulkarni12', 'rajashree.pimputkar']"
41,165,19,18,7,"['divyassonawane', 'prachi.mujawar', 'max_mercury', 'owais11', 'adisawant333', 'priyankakunde22', 'rajashree.pimputkar']",12,"['rasikapednekar20', 'arpitgodbole7', 'rakeshpatil9271', 'salvir481', 'sanjit', 'akshatask', 'sonalikharade5', 'anujmdeorukhkar', 'javedptl', 'prathameshpatle13', 'sukanyajadhav1997', 'ashnavirdikar.av']",11,"['kaushiksawant93', 'pnrs.pratik', 'shripal17', 'rms.maurya21', 'ardalvi85', 'pranjalijadhav0911', 'bhandarepranay9208', 'siddhesh.soyane', 'susmeetsukte', 'hsnnalwala7', 'rishimud']",30,"['divyassonawane', 'arpitgodbole7', 'rakeshpatil9271', 'salvir481', 'kaushiksawant93', 'prachi.mujawar', 'shripal17', 'max_mercury', 'sonalikharade5', 'ardalvi85', 'adisawant333', 'priyankakunde22', 'siddhesh.soyane', 'susmeetsukte', 'akshatask', 'sanjit', 'prathameshpatle13', 'ashnavirdikar.av', 'sukanyajadhav1997', 'rasikapednekar20', 'rishimud', 'hsnnalwala7', 'pnrs.pratik', 'owais11', 'rms.maurya21', 'pranjalijadhav0911', 'bhandarepranay9208', 'anujmdeorukhkar', 'javedptl', 'rajashree.pimputkar']"
41,133,19,16,3,"['priyankakunde22', 'prathameshpatle13', 'owais11']",16,"['rasikapednekar20', 'javedptl', 'divyassonawane', 'arpitgodbole7', 'rakeshpatil9271', 'salvir481', 'sanjit', 'prachi.mujawar', 'rajashree.pimputkar', 'max_mercury', 'sonalikharade5', 'adisawant333', 'anujmdeorukhkar', 'akshatask', 'sukanyajadhav1997', 'ashnavirdikar.av']",13,"['msawant869', 'abhishektoraskar412', 'aloksardesai97', 'sohammhas', 'ankitagamare2218', 'ashu0497', 'siddhant8291', 'aritramondal151', 'priyankakamble', 'arshan.ansari002', 'saketnaik', 'mayur.manve4', 'shraddhagadankush1998']",32,"['msawant869', 'divyassonawane', 'arpitgodbole7', 'rakeshpatil9271', 'salvir481', 'prachi.mujawar', 'max_mercury', 'sonalikharade5', 'ankitagamare2218', 'ashu0497', 'adisawant333', 'aritramondal151', 'arshan.ansari002', 'priyankakunde22', 'aloksardesai97', 'priyankakamble', 'akshatask', 'sanjit', 'prathameshpatle13', 'ashnavirdikar.av', 'sukanyajadhav1997', 'rasikapednekar20', 'saketnaik', 'shraddhagadankush1998', 'abhishektoraskar412', 'sohammhas', 'owais11', 'siddhant8291', 'anujmdeorukhkar', 'mayur.manve4', 'javedptl', 'rajashree.pimputkar']"
41,132,19,11,6,"['salvir481', 'owais11', 'anujmdeorukhkar', 'javedptl', 'sukanyajadhav1997', 'rajashree.pimputkar']",13,"['rasikapednekar20', 'divyassonawane', 'arpitgodbole7', 'rakeshpatil9271', 'sanjit', 'prachi.mujawar', 'max_mercury', 'sonalikharade5', 'adisawant333', 'priyankakunde22', 'akshatask', 'prathameshpatle13', 'ashnavirdikar.av']",5,"['rohanotari21', 'rohit.elawadekar333', 'ankitagamare2218', 'arshan.ansari002', 'gabru1803']",24,"['divyassonawane', 'arpitgodbole7', 'rakeshpatil9271', 'salvir481', 'prachi.mujawar', 'rohanotari21', 'max_mercury', 'sonalikharade5', 'rohit.elawadekar333', 'ankitagamare2218', 'adisawant333', 'arshan.ansari002', 'priyankakunde22', 'akshatask', 'sanjit', 'prathameshpatle13', 'ashnavirdikar.av', 'sukanyajadhav1997', 'rasikapednekar20', 'owais11', 'gabru1803', 'anujmdeorukhkar', 'javedptl', 'rajashree.pimputkar']"
41,136,19,11,1,['max_mercury'],18,"['rasikapednekar20', 'javedptl', 'divyassonawane', 'arpitgodbole7', 'rakeshpatil9271', 'salvir481', 'priyankakunde22', 'prachi.mujawar', 'sanjit', 'rajashree.pimputkar', 'sonalikharade5', 'owais11', 'adisawant333', 'anujmdeorukhkar', 'akshatask', 'prathameshpatle13', 'sukanyajadhav1997', 'ashnavirdikar.av']",10,"['rahulkadam7055', 'shelar.chetan4', 'neha10patade', 'pranay.kesarkar1', 'kedar.kulkarni12', 'roshanpoojari31', 'kajaldevake30', 'dilipramgir', 'nandakale98', 'rishimud']",29,"['divyassonawane', 'arpitgodbole7', 'rakeshpatil9271', 'salvir481', 'prachi.mujawar', 'max_mercury', 'sonalikharade5', 'adisawant333', 'dilipramgir', 'priyankakunde22', 'akshatask', 'sanjit', 'prathameshpatle13', 'ashnavirdikar.av', 'sukanyajadhav1997', 'rasikapednekar20', 'rahulkadam7055', 'rishimud', 'shelar.chetan4', 'pranay.kesarkar1', 'neha10patade', 'owais11', 'roshanpoojari31', 'kajaldevake30', 'nandakale98', 'anujmdeorukhkar', 'javedptl', 'kedar.kulkarni12', 'rajashree.pimputkar']"
41,167,19,9,2,"['max_mercury', 'akshatask']",17,"['rasikapednekar20', 'divyassonawane', 'arpitgodbole7', 'rakeshpatil9271', 'salvir481', 'priyankakunde22', 'prachi.mujawar', 'sanjit', 'rajashree.pimputkar', 'sonalikharade5', 'owais11', 'adisawant333', 'anujmdeorukhkar', 'javedptl', 'prathameshpatle13', 'sukanyajadhav1997', 'ashnavirdikar.av']",7,"['sarika_bukkawar', 'pranav123', 'mayanksamar786', 'shantanupanigrahi98', 'aloksardesai97', 'rutujakamthe', 'chetushirke']",26,"['divyassonawane', 'arpitgodbole7', 'rakeshpatil9271', 'salvir481', 'prachi.mujawar', 'pranav123', 'max_mercury', 'sonalikharade5', 'shantanupanigrahi98', 'adisawant333', 'priyankakunde22', 'aloksardesai97', 'akshatask', 'sanjit', 'prathameshpatle13', 'ashnavirdikar.av', 'sukanyajadhav1997', 'rasikapednekar20', 'sarika_bukkawar', 'mayanksamar786', 'owais11', 'chetushirke', 'anujmdeorukhkar', 'javedptl', 'rutujakamthe', 'rajashree.pimputkar']"
41,138,19,8,5,"['arpitgodbole7', 'sonalikharade5', 'rasikapednekar20', 'akshatask', 'ashnavirdikar.av']",14,"['divyassonawane', 'salvir481', 'rakeshpatil9271', 'priyankakunde22', 'sanjit', 'prachi.mujawar', 'max_mercury', 'owais11', 'adisawant333', 'anujmdeorukhkar', 'javedptl', 'prathameshpatle13', 'sukanyajadhav1997', 'rajashree.pimputkar']",3,"['susmeetsukte', 'iammayuri3', 'dshantanu2902']",22,"['divyassonawane', 'arpitgodbole7', 'rakeshpatil9271', 'salvir481', 'prachi.mujawar', 'iammayuri3', 'max_mercury', 'sonalikharade5', 'dshantanu2902', 'adisawant333', 'priyankakunde22', 'susmeetsukte', 'akshatask', 'sanjit', 'prathameshpatle13', 'ashnavirdikar.av', 'sukanyajadhav1997', 'rasikapednekar20', 'owais11', 'anujmdeorukhkar', 'javedptl', 'rajashree.pimputkar']"
42,36,19,12,12,"['valentin1', 'flipgard', 'susi', 'nano_jack', 'tactyle', 'michael.gobald', 'jasmin.pfleger1997', 'yacine', 'michele2', 'elmar.aichberger', 'lia2708', 'katharinaaa']",7,"['evagasser', 'praram', 'nixmoke', 'millner89', 'martin92', 'kzojer', 't.chadzynski']",0,[],19,"['flipgard', 'evagasser', 'nano_jack', 'tactyle', 'michael.gobald', 'praram', 'nixmoke', 'jasmin.pfleger1997', 'martin92', 'kzojer', 'elmar.aichberger', 'lia2708', 'katharinaaa', 'valentin1', 'susi', 'millner89', 'yacine', 'michele2', 't.chadzynski']"
43,65,19,9,8,"['jklei', 'hujinding', 'xiaoyuwang', 'shushan1', 'jinmo', 'mhn0830', 'ljm79541', 'md0318']",11,"['zhaowenjuan', 'huijunz123', 'hmfei', 'gerrywong', 'qisha', 'cifer', 'yuziboziguang', 'xiaoyy', 'limengxin180493', 'yu123', 'liuweixun96']",1,['lifu.yan170457'],20,"['huijunz123', 'xiaoyuwang', 'hmfei', 'gerrywong', 'qisha', 'cifer', 'yu123', 'mhn0830', 'yuziboziguang', 'liuweixun96', 'ljm79541', 'jklei', 'hujinding', 'xiaoyy', 'lifu.yan170457', 'shushan1', 'limengxin180493', 'jinmo', 'zhaowenjuan', 'md0318']"
44,190,18,15,15,"['mehrwaqar786', 'onlineclass96', 'shahzaib75', 'arish.adil', 'reebaraza', 'rizwana', 'shahzad.rida.rs', 'kaynatalvi', 'aminah87', 'nbutt', 'sohailnagra127', 'hadia.fatima.ach', 'abs133', 'zeaghamkapco13', 'shujahrehman1']",3,"['sajid72hussain', 'samreennazeer', 'hywong2']",0,[],18,"['reebaraza', 'rizwana', 'shahzad.rida.rs', 'kaynatalvi', 'sohailnagra127', 'abs133', 'zeaghamkapco13', 'arish.adil', 'mehrwaqar786', 'onlineclass96', 'samreennazeer', 'shahzaib75', 'sajid72hussain', 'aminah87', 'nbutt', 'hywong2', 'hadia.fatima.ach', 'shujahrehman1']"
44,191,18,7,7,"['mehrwaqar786', 'shahzaib75', 'kaynatalvi', 'shahzad.rida.rs', 'nbutt', 'hadia.fatima.ach', 'abs133']",11,"['onlineclass96', 'samreennazeer', 'reebaraza', 'sajid72hussain', 'rizwana', 'aminah87', 'sohailnagra127', 'hywong2', 'shujahrehman1', 'zeaghamkapco13', 'arish.adil']",0,[],18,"['reebaraza', 'rizwana', 'shahzad.rida.rs', 'kaynatalvi', 'sohailnagra127', 'abs133', 'zeaghamkapco13', 'arish.adil', 'mehrwaqar786', 'onlineclass96', 'samreennazeer', 'shahzaib75', 'sajid72hussain', 'aminah87', 'nbutt', 'hywong2', 'hadia.fatima.ach', 'shujahrehman1']"
45,53,18,34,16,"['dr.sabogal', 'danrako', 'jasonvazdel', 'andresvm', 'jcbuitragoa1', 'isabellasalgadopin', 'vilmistirado', 'jhon', 'jpnaranjo20', 'dhcomas', 'nlozano611', 'salomon.ulloque', 'jcac0908', 'anfedepe', 'ja.hernandezr1', 'alvaro22martelo']",2,"['al.indavid10', 'ad.gregory']",18,"['juliana.jaimes.27', 'mchaparrobecerra', 'joshuakelev7', 'michaelj00', 'josemajaramilloh', 'adrianapquijanoc', 'da.ramirez14', 'alejagarzon', 'perez.l.carlos.a', 'danielamedina9937', 'marianak.holguinp', 'stephania_suarez', 'miltonesteban.reyes', 'ivanfsalgado', 'ale_1201', 'kevin_ceron', 'jf.cuevas', 'sv.rojas']",36,"['juliana.jaimes.27', 'josemajaramilloh', 'adrianapquijanoc', 'jhon', 'danielamedina9937', 'ad.gregory', 'jcac0908', 'andresvm', 'isabellasalgadopin', 'jpnaranjo20', 'dhcomas', 'perez.l.carlos.a', 'marianak.holguinp', 'salomon.ulloque', 'stephania_suarez', 'miltonesteban.reyes', 'jf.cuevas', 'alvaro22martelo', 'jasonvazdel', 'michaelj00', 'vilmistirado', 'da.ramirez14', 'al.indavid10', 'ivanfsalgado', 'nlozano611', 'ale_1201', 'anfedepe', 'dr.sabogal', 'danrako', 'mchaparrobecerra', 'joshuakelev7', 'jcbuitragoa1', 'alejagarzon', 'kevin_ceron', 'sv.rojas', 'ja.hernandezr1']"
47,2,17,18,15,"['basilefg', 'mark.s.mckee', 'jamesmkirk28', 'liptacj', 'noyesjf', 'boucheag', 'bballben417', 'critcha', 'zachshue98', 'rehraa5', 'andrew.albert', 'jamese3', 'ericshanahan', 'samuel.j.super', 'carlsam1']",2,"['gw014425', 'dana.bandi']",3,"['dougla1', 'macdonmk', 'eastinje']",20,"['liptacj', 'gw014425', 'bballben417', 'zachshue98', 'rehraa5', 'andrew.albert', 'dana.bandi', 'eastinje', 'dougla1', 'carlsam1', 'basilefg', 'mark.s.mckee', 'jamesmkirk28', 'noyesjf', 'boucheag', 'critcha', 'macdonmk', 'ericshanahan', 'jamese3', 'samuel.j.super']"
48,88,17,11,8,"['sourakkata', 'mohammed_drioueche', 'relmac', 'elrhomariy', 'skyzelda', 'zouhirs', 'youssef_el_kantri', 'driss.aabour']",9,"['houria', 'ismail_laissaoui', 'medoubella', 'younesghafiri2001', 'mohammedch', 'ayoubmardi', 'youssraderraz1998', 'rizkiyounes8991', 'rachidardouz']",3,"['hamidallahoussama622', 'anas_mansouri', 'ocama89']",20,"['sourakkata', 'houria', 'mohammed_drioueche', 'hamidallahoussama622', 'elrhomariy', 'medoubella', 'zouhirs', 'younesghafiri2001', 'driss.aabour', 'youssraderraz1998', 'ismail_laissaoui', 'ocama89', 'relmac', 'skyzelda', 'youssef_el_kantri', 'mohammedch', 'ayoubmardi', 'rizkiyounes8991', 'anas_mansouri', 'rachidardouz']"
49,158,17,12,12,"['vinaykumarreddy1221', 'ushah', 'varshil01', 'agnessanjana', 'yeshwanthbugata', 'raveenavijaya9', 'jlinxciv', 'btl', 'thanat.t', 'ajitesh', 'ruchibagwe', 'vasuramadurgam']",5,"['lokesh_mt2k17', 'tkm9255', 'nasimghadyani', 't.bhagyashri', 'bhagyashreejoshi']",0,[],17,"['vinaykumarreddy1221', 'lokesh_mt2k17', 'agnessanjana', 't.bhagyashri', 'jlinxciv', 'btl', 'thanat.t', 'ajitesh', 'bhagyashreejoshi', 'ushah', 'tkm9255', 'nasimghadyani', 'varshil01', 'yeshwanthbugata', 'raveenavijaya9', 'ruchibagwe', 'vasuramadurgam']"
50,56,16,16,4,"['2015sagar.baviskar', 'pravin_bagade123', 'pvk', 'vipra']",12,"['amruta.molawade', '2015rutuja.patil', 'sachinbavdane7', 'hemant29', '2015anvita.rai', 'abhay.kshirsagar', 'rakh9000', 'csangar', 'narayananiyer20', 'kaustubh5354', 'diptikarani', 'itsme']",12,"['2015dnyanal.berde', 'susmita1909', '2015samarpita.choudhuri', 'lairai9', 'sayli8898', 'adityagudal29', 'virendra', '2015rushikesh.baraskar', 'tejashree.khirawade', '2015nishant.hirlekar', '2015prachi.kothawade', '2015bhushan.jadhav']",28,"['2015dnyanal.berde', 'amruta.molawade', 'pvk', 'vipra', 'sachinbavdane7', '2015samarpita.choudhuri', 'lairai9', 'hemant29', 'sayli8898', 'adityagudal29', 'virendra', 'pravin_bagade123', '2015rushikesh.baraskar', '2015anvita.rai', 'rakh9000', 'kaustubh5354', 'tejashree.khirawade', '2015sagar.baviskar', 'itsme', '2015bhushan.jadhav', 'susmita1909', '2015rutuja.patil', 'diptikarani', 'abhay.kshirsagar', 'csangar', 'narayananiyer20', '2015nishant.hirlekar', '2015prachi.kothawade']"
50,57,16,15,5,"['amruta.molawade', '2015rutuja.patil', 'hemant29', '2015anvita.rai', 'itsme']",11,"['pvk', 'vipra', 'sachinbavdane7', 'pravin_bagade123', 'diptikarani', 'abhay.kshirsagar', 'rakh9000', 'csangar', 'narayananiyer20', 'kaustubh5354', '2015sagar.baviskar']",10,"['sahilberde', 'ej2013.ankit.panvalkar', 'aartimaurya5', 'tanviwagh', '2015anuj.pakhare', 'kaushal37', '2015mukul.sharma', 'ujwala.pol', '2015deepak', '2015nitish.nayak']",26,"['amruta.molawade', 'pvk', 'vipra', 'sachinbavdane7', 'ej2013.ankit.panvalkar', 'aartimaurya5', 'hemant29', 'tanviwagh', '2015anuj.pakhare', 'pravin_bagade123', '2015anvita.rai', 'rakh9000', 'kaustubh5354', '2015sagar.baviskar', 'ujwala.pol', 'itsme', '2015nitish.nayak', '2015rutuja.patil', 'sahilberde', 'kaushal37', 'diptikarani', 'abhay.kshirsagar', '2015mukul.sharma', 'csangar', 'narayananiyer20', '2015deepak']"
51,193,16,6,6,"['rc564', 'spk52', 'yd366', 'sg742', 'alh277', 'cl2563']",10,"['woal7949', 'prof3paul', 'aixuanas', 'vsroba', 'dz289', 'atif47', 'whjj1942', 'bsong25', 'zhuoyi92', 'ruiningcn']",0,[],16,"['woal7949', 'prof3paul', 'rc564', 'vsroba', 'dz289', 'alh277', 'cl2563', 'bsong25', 'zhuoyi92', 'aixuanas', 'spk52', 'yd366', 'sg742', 'atif47', 'whjj1942', 'ruiningcn']"
52,124,16,12,11,"['addkol', 'moisesvazquez', 'dadaniel', 'valentinlafondrive', 'agiordan', 'matmat', 'derlet', 'ymeier', 'bharathn', 'recep.kubilay', 'yigitkuscu']",5,"['atourk2', 'hit_zsj', 'elegoas', 'cprakash', 'adriengimonnet']",1,['rasoolahmad.a'],17,"['moisesvazquez', 'atourk2', 'valentinlafondrive', 'elegoas', 'bharathn', 'matmat', 'addkol', 'yigitkuscu', 'dadaniel', 'hit_zsj', 'agiordan', 'rasoolahmad.a', 'derlet', 'ymeier', 'cprakash', 'adriengimonnet', 'recep.kubilay']"
53,84,16,25,3,"['michaeleppel', 'scottbirks', 'cataanderson1103']",13,"['embersikorski', 'chemokine6', 'sjriley', 'jordanvandegrift', 'anupra.chandran', 'stevejohns', 'mar4557', 'samuelpedersen', 'tragon', 'yeetus_deletus', 'addielupercio', 'timphero', 'andrewarmstrong858']",22,"['gregorynoble', 'johnpage', 'arielweltner', 'monetalberts', 'jameslamb', 'kendranoneman', 'tylerwebb508', 'jiheonkwon', 'bradygarringer', 'oliviamaryon', 'samuelmcmurdie', 'chrisjones', 'henrikunold', 'forestswanson', 'jesseschimpf', 'jasonpowell1', 'arvincunningham', 'kevinsaythavy', 'hunterg54', 'claireadams', 'nathantokarz', 'raiflyon']",38,"['gregorynoble', 'cataanderson1103', 'chemokine6', 'anupra.chandran', 'stevejohns', 'johnpage', 'arielweltner', 'addielupercio', 'timphero', 'monetalberts', 'mar4557', 'jameslamb', 'kendranoneman', 'samuelpedersen', 'yeetus_deletus', 'tylerwebb508', 'jiheonkwon', 'andrewarmstrong858', 'bradygarringer', 'embersikorski', 'sjriley', 'oliviamaryon', 'samuelmcmurdie', 'chrisjones', 'henrikunold', 'forestswanson', 'tragon', 'jesseschimpf', 'jasonpowell1', 'arvincunningham', 'michaeleppel', 'kevinsaythavy', 'hunterg54', 'jordanvandegrift', 'scottbirks', 'claireadams', 'nathantokarz', 'raiflyon']"
53,180,16,21,2,"['michaeleppel', 'scottbirks']",14,"['embersikorski', 'cataanderson1103', 'chemokine6', 'sjriley', 'anupra.chandran', 'jordanvandegrift', 'stevejohns', 'mar4557', 'samuelpedersen', 'tragon', 'yeetus_deletus', 'addielupercio', 'timphero', 'andrewarmstrong858']",19,"['almastosius', 'johnpage', 'kyleelay', 'austinmello', 'lynnkarriem1', 'tylerjpoulsen', 'beckperrine', 'dallash', 'natefarris', 'paigeskinner', 'tanyalu', 'kievdixon', 'bradygarringer', 'samuelmcmurdie', 'steve.r6531', 'arvincunningham', 'michaelhansen95', 'egraugnard', 'lanlibsu']",35,"['embersikorski', 'cataanderson1103', 'chemokine6', 'sjriley', 'anupra.chandran', 'stevejohns', 'almastosius', 'samuelmcmurdie', 'johnpage', 'kyleelay', 'tragon', 'addielupercio', 'austinmello', 'steve.r6531', 'lynnkarriem1', 'timphero', 'arvincunningham', 'michaeleppel', 'tylerjpoulsen', 'jordanvandegrift', 'beckperrine', 'lanlibsu', 'scottbirks', 'michaelhansen95', 'dallash', 'mar4557', 'natefarris', 'egraugnard', 'samuelpedersen', 'yeetus_deletus', 'paigeskinner', 'tanyalu', 'kievdixon', 'andrewarmstrong858', 'bradygarringer']"
53,179,16,15,10,"['embersikorski', 'sjriley', 'jordanvandegrift', 'stevejohns', 'mar4557', 'samuelpedersen', 'addielupercio', 'tragon', 'timphero', 'andrewarmstrong858']",6,"['michaeleppel', 'cataanderson1103', 'chemokine6', 'anupra.chandran', 'scottbirks', 'yeetus_deletus']",5,"['gregorynoble', 'arielweltner', 'steve.r6531', 'gregorynoble27000', 'lanlibsu']",21,"['embersikorski', 'cataanderson1103', 'chemokine6', 'sjriley', 'anupra.chandran', 'gregorynoble', 'stevejohns', 'arielweltner', 'tragon', 'addielupercio', 'steve.r6531', 'timphero', 'michaeleppel', 'jordanvandegrift', 'scottbirks', 'mar4557', 'samuelpedersen', 'yeetus_deletus', 'gregorynoble27000', 'andrewarmstrong858', 'lanlibsu']"
54,84,16,25,2,"['bradygarringer', 'samuelmcmurdie']",14,"['tylerjpoulsen', 'jonathanshoemaker', 'beckperrine', 'almastosius', 'michaelhansen95', 'dallash', 'natefarris', 'kyleelay', 'paigeskinner', 'austinmello', 'steve.r6531', 'tanyalu', 'lynnkarriem1', 'kievdixon']",23,"['gregorynoble', 'cataanderson1103', 'johnpage', 'arielweltner', 'monetalberts', 'jameslamb', 'kendranoneman', 'tylerwebb508', 'jiheonkwon', 'oliviamaryon', 'chrisjones', 'henrikunold', 'forestswanson', 'jesseschimpf', 'jasonpowell1', 'arvincunningham', 'michaeleppel', 'kevinsaythavy', 'hunterg54', 'scottbirks', 'claireadams', 'nathantokarz', 'raiflyon']",39,"['gregorynoble', 'cataanderson1103', 'jonathanshoemaker', 'almastosius', 'johnpage', 'kyleelay', 'arielweltner', 'austinmello', 'lynnkarriem1', 'tylerjpoulsen', 'monetalberts', 'beckperrine', 'dallash', 'natefarris', 'jameslamb', 'kendranoneman', 'tylerwebb508', 'paigeskinner', 'tanyalu', 'kievdixon', 'jiheonkwon', 'bradygarringer', 'oliviamaryon', 'samuelmcmurdie', 'chrisjones', 'henrikunold', 'forestswanson', 'steve.r6531', 'jesseschimpf', 'jasonpowell1', 'arvincunningham', 'michaeleppel', 'kevinsaythavy', 'hunterg54', 'michaelhansen95', 'scottbirks', 'claireadams', 'nathantokarz', 'raiflyon']"
54,180,16,21,15,"['tylerjpoulsen', 'beckperrine', 'samuelmcmurdie', 'michaelhansen95', 'almastosius', 'dallash', 'natefarris', 'kyleelay', 'paigeskinner', 'austinmello', 'steve.r6531', 'tanyalu', 'lynnkarriem1', 'kievdixon', 'bradygarringer']",1,['jonathanshoemaker'],6,"['michaeleppel', 'scottbirks', 'egraugnard', 'johnpage', 'arvincunningham', 'lanlibsu']",22,"['jonathanshoemaker', 'almastosius', 'samuelmcmurdie', 'johnpage', 'kyleelay', 'austinmello', 'steve.r6531', 'lynnkarriem1', 'arvincunningham', 'tylerjpoulsen', 'michaeleppel', 'beckperrine', 'lanlibsu', 'michaelhansen95', 'scottbirks', 'dallash', 'natefarris', 'egraugnard', 'paigeskinner', 'tanyalu', 'kievdixon', 'bradygarringer']"
54,179,16,15,1,['steve.r6531'],15,"['tylerjpoulsen', 'jonathanshoemaker', 'beckperrine', 'samuelmcmurdie', 'almastosius', 'michaelhansen95', 'dallash', 'natefarris', 'kyleelay', 'paigeskinner', 'austinmello', 'tanyalu', 'lynnkarriem1', 'kievdixon', 'bradygarringer']",14,"['embersikorski', 'gregorynoble', 'sjriley', 'jordanvandegrift', 'stevejohns', 'mar4557', 'arielweltner', 'samuelpedersen', 'addielupercio', 'tragon', 'gregorynoble27000', 'andrewarmstrong858', 'lanlibsu', 'timphero']",30,"['gregorynoble', 'embersikorski', 'jonathanshoemaker', 'sjriley', 'almastosius', 'samuelmcmurdie', 'stevejohns', 'kyleelay', 'arielweltner', 'addielupercio', 'tragon', 'austinmello', 'steve.r6531', 'lynnkarriem1', 'timphero', 'tylerjpoulsen', 'beckperrine', 'jordanvandegrift', 'lanlibsu', 'michaelhansen95', 'dallash', 'mar4557', 'gregorynoble27000', 'natefarris', 'samuelpedersen', 'paigeskinner', 'tanyalu', 'kievdixon', 'andrewarmstrong858', 'bradygarringer']"
54,183,16,12,11,"['tylerjpoulsen', 'beckperrine', 'almastosius', 'michaelhansen95', 'dallash', 'natefarris', 'kyleelay', 'paigeskinner', 'tanyalu', 'lynnkarriem1', 'bradygarringer']",5,"['jonathanshoemaker', 'samuelmcmurdie', 'austinmello', 'steve.r6531', 'kievdixon']",1,['johnpage'],17,"['jonathanshoemaker', 'almastosius', 'samuelmcmurdie', 'johnpage', 'kyleelay', 'austinmello', 'steve.r6531', 'lynnkarriem1', 'tylerjpoulsen', 'beckperrine', 'michaelhansen95', 'dallash', 'natefarris', 'paigeskinner', 'tanyalu', 'kievdixon', 'bradygarringer']"
55,95,15,14,13,"['bravicor', 'tryeazel', 'xieyiabner', 'fanzhang0815', 'jepatte2', 'cforsythe', 'xixi.qin', 'turley.connor.j', 'sunbowen', 'neilwang', 'abigail.mrvos', 'williamzhang0821', 'azaleazheng']",2,"['raullaasner', 'throwthisaway1975']",1,['yongshinkim0216'],16,"['xieyiabner', 'throwthisaway1975', 'raullaasner', 'cforsythe', 'sunbowen', 'neilwang', 'yongshinkim0216', 'williamzhang0821', 'bravicor', 'tryeazel', 'fanzhang0815', 'xixi.qin', 'jepatte2', 'turley.connor.j', 'abigail.mrvos', 'azaleazheng']"
56,55,15,7,1,['ksie'],14,"['douw54', 'samiyajabbar', 'rubarasheed5678', 'galanlopez.oal', 'pbehera2', 'maxaplas', 'aneshkumar13', 's_huzaifa', 'rmax04', 'yhsia', 'ky', 'jaejin90', 'mr.x1375', 'jsunp2']",6,"['ppawelski', 'stabatabaei', 'mmei', 'jamesdoty', 'carleydavis', 'bplamondon']",21,"['ppawelski', 'stabatabaei', 'maxaplas', 'rmax04', 'carleydavis', 'bplamondon', 'mr.x1375', 'galanlopez.oal', 'douw54', 'samiyajabbar', 'mmei', 'rubarasheed5678', 'pbehera2', 'jamesdoty', 'aneshkumar13', 's_huzaifa', 'yhsia', 'ky', 'jaejin90', 'jsunp2', 'ksie']"
57,53,14,34,14,"['juliana.jaimes.27', 'mchaparrobecerra', 'joshuakelev7', 'da.ramirez14', 'alejagarzon', 'danielamedina9937', 'ivanfsalgado', 'stephania_suarez', 'perez.l.carlos.a', 'miltonesteban.reyes', 'marianak.holguinp', 'kevin_ceron', 'jf.cuevas', 'sv.rojas']",0,[],20,"['josemajaramilloh', 'adrianapquijanoc', 'jhon', 'jcac0908', 'andresvm', 'jpnaranjo20', 'isabellasalgadopin', 'dhcomas', 'salomon.ulloque', 'alvaro22martelo', 'jasonvazdel', 'michaelj00', 'vilmistirado', 'nlozano611', 'ale_1201', 'anfedepe', 'dr.sabogal', 'danrako', 'jcbuitragoa1', 'ja.hernandezr1']",34,"['juliana.jaimes.27', 'josemajaramilloh', 'adrianapquijanoc', 'jhon', 'danielamedina9937', 'jcac0908', 'andresvm', 'jpnaranjo20', 'isabellasalgadopin', 'dhcomas', 'perez.l.carlos.a', 'stephania_suarez', 'marianak.holguinp', 'miltonesteban.reyes', 'salomon.ulloque', 'jf.cuevas', 'alvaro22martelo', 'jasonvazdel', 'michaelj00', 'vilmistirado', 'da.ramirez14', 'ivanfsalgado', 'nlozano611', 'ale_1201', 'anfedepe', 'mchaparrobecerra', 'dr.sabogal', 'danrako', 'joshuakelev7', 'jcbuitragoa1', 'alejagarzon', 'kevin_ceron', 'sv.rojas', 'ja.hernandezr1']"
58,102,14,10,6,"['hakimiikmal4', 'juzairi08', 'syahmikml', 'thuvaskrishnan', 'wahideen_wbk', 'shahrul_iqmal']",8,"['peng123', 'syawalnaim2102', 'liya', 'tuanaiman', 'derekliew7', 'aqilazman', 'jaysaw3', 'shenvern1105']",4,"['thayyibathadmi', 'sarmila.krishnan', 'ccteh0196', 'adrtee']",18,"['hakimiikmal4', 'adrtee', 'peng123', 'syahmikml', 'thuvaskrishnan', 'liya', 'derekliew7', 'juzairi08', 'syawalnaim2102', 'wahideen_wbk', 'shenvern1105', 'sarmila.krishnan', 'ccteh0196', 'thayyibathadmi', 'tuanaiman', 'aqilazman', 'jaysaw3', 'shahrul_iqmal']"
60,127,14,6,4,"['mbrasil14', 'mschooljian', 'celinespathias', 'kylewang811']",10,"['librandt', 'dmurphy60', 'kilian.liss', 'vkurichenko', 'shreya.sonal20', 'tnportone', 'bmaranville', 'komogortsev_sergey', 'matasoyu9', 'olafvanterve']",2,"['maitegoiriena', 'hanumansingh']",16,"['librandt', 'dmurphy60', 'vkurichenko', 'shreya.sonal20', 'bmaranville', 'kylewang811', 'celinespathias', 'komogortsev_sergey', 'mbrasil14', 'mschooljian', 'matasoyu9', 'kilian.liss', 'tnportone', 'hanumansingh', 'maitegoiriena', 'olafvanterve']"
62,63,14,18,3,"['prajaktapatil', '2015prachi.kothawade', '2015nitish.nayak']",11,"['2015sudipta.dinda', '2015dnyanal.berde', '2015soumya.chinthalapudi', 'lairai9', 'aartimaurya5', 'tanviwagh', 'sayli8898', '2015anuj.pakhare', 'kaushal37', 'tejashree.khirawade', '2015bhushan.jadhav']",15,"['2015jayanti.jha', 'pravinbagade123', 'yash.bhatia', 'sankalp8055', 'ej2013.ankit.panvalkar', '2015rasika.wagh', '2015manas.kulkarni', 'abhi97', '2015vipra.arolkar', '2015radhika.angolkar', '2015riya.maheshwari', '2015sanika.pathare', 'neeiljain', 'jainamshah697', '2015deepak']",29,"['2015jayanti.jha', 'ej2013.ankit.panvalkar', '2015manas.kulkarni', '2015vipra.arolkar', 'prajaktapatil', 'tejashree.khirawade', 'jainamshah697', '2015nitish.nayak', '2015bhushan.jadhav', 'yash.bhatia', '2015riya.maheshwari', '2015sanika.pathare', '2015deepak', '2015dnyanal.berde', 'pravinbagade123', 'sankalp8055', 'lairai9', 'aartimaurya5', 'tanviwagh', 'sayli8898', '2015anuj.pakhare', 'neeiljain', '2015sudipta.dinda', '2015soumya.chinthalapudi', '2015rasika.wagh', 'abhi97', '2015radhika.angolkar', 'kaushal37', '2015prachi.kothawade']"
62,61,14,17,9,"['2015dnyanal.berde', 'lairai9', 'aartimaurya5', 'sayli8898', 'prajaktapatil', 'kaushal37', 'tejashree.khirawade', '2015prachi.kothawade', '2015bhushan.jadhav']",5,"['2015sudipta.dinda', '2015soumya.chinthalapudi', 'tanviwagh', '2015anuj.pakhare', '2015nitish.nayak']",8,"['shrutisneha.prasad', '2015rasika.wagh', '2015vipra.arolkar', '2015riya.maheshwari', '2015mugdha.sonwane', 'hemant.wakchaure', '2015varun.gokhale', '2015soham.sawant']",22,"['2015dnyanal.berde', 'lairai9', 'aartimaurya5', 'tanviwagh', 'sayli8898', '2015anuj.pakhare', 'prajaktapatil', '2015vipra.arolkar', '2015mugdha.sonwane', 'hemant.wakchaure', 'tejashree.khirawade', '2015nitish.nayak', '2015bhushan.jadhav', '2015sudipta.dinda', '2015soumya.chinthalapudi', 'shrutisneha.prasad', '2015rasika.wagh', '2015riya.maheshwari', 'kaushal37', '2015varun.gokhale', '2015prachi.kothawade', '2015soham.sawant']"
62,56,14,16,6,"['2015dnyanal.berde', 'lairai9', 'sayli8898', 'tejashree.khirawade', '2015prachi.kothawade', '2015bhushan.jadhav']",8,"['2015sudipta.dinda', '2015soumya.chinthalapudi', 'aartimaurya5', 'tanviwagh', '2015anuj.pakhare', 'prajaktapatil', 'kaushal37', '2015nitish.nayak']",10,"['pvk', 'vipra', 'susmita1909', '2015samarpita.choudhuri', 'adityagudal29', 'virendra', 'pravin_bagade123', '2015rushikesh.baraskar', '2015nishant.hirlekar', '2015sagar.baviskar']",24,"['2015dnyanal.berde', 'pvk', 'vipra', 'lairai9', 'aartimaurya5', '2015samarpita.choudhuri', 'tanviwagh', 'sayli8898', '2015anuj.pakhare', 'prajaktapatil', 'adityagudal29', 'virendra', 'pravin_bagade123', '2015rushikesh.baraskar', 'tejashree.khirawade', '2015sagar.baviskar', '2015nitish.nayak', '2015bhushan.jadhav', '2015sudipta.dinda', '2015soumya.chinthalapudi', 'susmita1909', 'kaushal37', '2015nishant.hirlekar', '2015prachi.kothawade']"
62,57,14,15,5,"['aartimaurya5', 'tanviwagh', '2015anuj.pakhare', 'kaushal37', '2015nitish.nayak']",9,"['2015sudipta.dinda', '2015dnyanal.berde', '2015soumya.chinthalapudi', 'lairai9', 'sayli8898', 'prajaktapatil', 'tejashree.khirawade', '2015prachi.kothawade', '2015bhushan.jadhav']",10,"['2015deepak', 'amruta.molawade', '2015rutuja.patil', 'sahilberde', 'ej2013.ankit.panvalkar', 'hemant29', '2015anvita.rai', '2015mukul.sharma', 'ujwala.pol', 'itsme']",24,"['2015dnyanal.berde', 'amruta.molawade', 'lairai9', 'aartimaurya5', 'ej2013.ankit.panvalkar', 'tanviwagh', 'sayli8898', '2015anuj.pakhare', 'prajaktapatil', 'hemant29', '2015anvita.rai', 'tejashree.khirawade', 'ujwala.pol', 'itsme', '2015nitish.nayak', '2015bhushan.jadhav', '2015sudipta.dinda', '2015soumya.chinthalapudi', '2015rutuja.patil', 'sahilberde', 'kaushal37', '2015mukul.sharma', '2015prachi.kothawade', '2015deepak']"
62,62,14,7,3,"['prajaktapatil', 'aartimaurya5', '2015anuj.pakhare']",11,"['2015sudipta.dinda', '2015dnyanal.berde', '2015soumya.chinthalapudi', 'lairai9', 'tanviwagh', 'sayli8898', '2015bhushan.jadhav', 'kaushal37', 'tejashree.khirawade', '2015prachi.kothawade', '2015nitish.nayak']",4,"['shubham.sutrakar', '2015rasika.wagh', '2015soham.sawant', '2015varun.gokhale']",18,"['2015dnyanal.berde', 'shubham.sutrakar', 'lairai9', 'aartimaurya5', 'tanviwagh', 'sayli8898', '2015anuj.pakhare', 'prajaktapatil', 'tejashree.khirawade', '2015nitish.nayak', '2015bhushan.jadhav', '2015sudipta.dinda', '2015soumya.chinthalapudi', '2015rasika.wagh', 'kaushal37', '2015varun.gokhale', '2015prachi.kothawade', '2015soham.sawant']"
62,60,14,6,2,"['lairai9', '2015soumya.chinthalapudi']",12,"['2015sudipta.dinda', '2015dnyanal.berde', 'aartimaurya5', 'tanviwagh', 'sayli8898', '2015anuj.pakhare', 'prajaktapatil', 'kaushal37', '2015bhushan.jadhav', 'tejashree.khirawade', '2015prachi.kothawade', '2015nitish.nayak']",4,"['2015riya.maheshwari', 'arthaya.koyande28', '2015vipra.arolkar', 'abhi97']",18,"['2015dnyanal.berde', 'arthaya.koyande28', 'lairai9', 'aartimaurya5', 'tanviwagh', 'sayli8898', '2015anuj.pakhare', 'prajaktapatil', '2015vipra.arolkar', 'tejashree.khirawade', '2015nitish.nayak', '2015bhushan.jadhav', '2015sudipta.dinda', '2015soumya.chinthalapudi', 'abhi97', '2015riya.maheshwari', 'kaushal37', '2015prachi.kothawade']"
63,3,13,6,3,"['stefano.righi1994', 'lorenzo.benatti', 'enrico876']",10,"['rcmyers78', 'abdulrahmangalal', 'lisha11chris', 'davidegallo20', 'tommasodegaetano', 'ettoremasetti', 'riccardotassi', 'dimuthuo', 'aymansaadhack', 'yyogi']",3,"['alessiobevilacqua', 'gi.ga212', 'rubenasa']",16,"['gi.ga212', 'enrico876', 'rubenasa', 'dimuthuo', 'stefano.righi1994', 'aymansaadhack', 'rcmyers78', 'abdulrahmangalal', 'lisha11chris', 'davidegallo20', 'lorenzo.benatti', 'ettoremasetti', 'tommasodegaetano', 'alessiobevilacqua', 'riccardotassi', 'yyogi']"
64,187,13,15,9,"['arisansol01', 'dgsandoval', 'feraya09', 'luisca1968', 'andrea.zu97', 'kelly.corella', 'dch_1018', 'arisandi97', 'josesanchezmoreno2797']",4,"['cganser', 'huihuangxia', 'msalerno', 'dwc200']",6,"['clauchv', 'jose.acuvida', 'sussitr8', 'alpizar.kevin1', 'yosjimz', 'laurojasch']",19,"['clauchv', 'jose.acuvida', 'dgsandoval', 'sussitr8', 'msalerno', 'alpizar.kevin1', 'kelly.corella', 'yosjimz', 'arisandi97', 'josesanchezmoreno2797', 'arisansol01', 'feraya09', 'luisca1968', 'andrea.zu97', 'dch_1018', 'cganser', 'huihuangxia', 'dwc200', 'laurojasch']"
64,186,13,7,3,"['andrea.zu97', 'feraya09', 'arisandi97']",10,"['arisansol01', 'dgsandoval', 'luisca1968', 'msalerno', 'dch_1018', 'kelly.corella', 'cganser', 'huihuangxia', 'dwc200', 'josesanchezmoreno2797']",4,"['luisca1925', 'marissacerdas', 'evyquiros.7', 'jbhernadez1004']",17,"['dgsandoval', 'luisca1925', 'msalerno', 'kelly.corella', 'jbhernadez1004', 'marissacerdas', 'arisandi97', 'josesanchezmoreno2797', 'arisansol01', 'evyquiros.7', 'feraya09', 'luisca1968', 'andrea.zu97', 'dch_1018', 'cganser', 'huihuangxia', 'dwc200']"
65,61,13,17,2,"['hemant.wakchaure', '2015soham.sawant']",11,"['aniketozarkar', 'jayesh.bhosale', 'singhshashank97', '2015harsha.kumar', 'rohit24k', 'pakshal.m.shah', 'tanuj.udani', 'shreyas.sshende', 'aakashmeshram', 'dhairyagada1997', 'varunswadia']",15,"['2015dnyanal.berde', 'shrutisneha.prasad', 'lairai9', 'aartimaurya5', '2015rasika.wagh', '2015vipra.arolkar', 'sayli8898', '2015riya.maheshwari', 'kaushal37', '2015mugdha.sonwane', 'prajaktapatil', 'tejashree.khirawade', '2015varun.gokhale', '2015prachi.kothawade', '2015bhushan.jadhav']",28,"['2015dnyanal.berde', 'lairai9', 'aniketozarkar', 'aartimaurya5', '2015vipra.arolkar', 'sayli8898', '2015harsha.kumar', 'rohit24k', 'hemant.wakchaure', 'tanuj.udani', 'pakshal.m.shah', '2015mugdha.sonwane', 'prajaktapatil', 'tejashree.khirawade', 'dhairyagada1997', '2015bhushan.jadhav', 'shrutisneha.prasad', 'jayesh.bhosale', '2015rasika.wagh', 'singhshashank97', '2015riya.maheshwari', 'kaushal37', 'shreyas.sshende', '2015varun.gokhale', 'aakashmeshram', '2015prachi.kothawade', 'varunswadia', '2015soham.sawant']"
65,62,13,7,1,['2015soham.sawant'],12,"['aniketozarkar', 'jayesh.bhosale', 'singhshashank97', '2015harsha.kumar', 'rohit24k', 'hemant.wakchaure', 'tanuj.udani', 'pakshal.m.shah', 'shreyas.sshende', 'aakashmeshram', 'dhairyagada1997', 'varunswadia']",6,"['shubham.sutrakar', 'aartimaurya5', '2015rasika.wagh', '2015anuj.pakhare', 'prajaktapatil', '2015varun.gokhale']",19,"['shubham.sutrakar', 'aniketozarkar', 'aartimaurya5', '2015anuj.pakhare', '2015harsha.kumar', 'rohit24k', 'hemant.wakchaure', 'tanuj.udani', 'pakshal.m.shah', 'prajaktapatil', 'dhairyagada1997', 'jayesh.bhosale', '2015rasika.wagh', 'singhshashank97', 'shreyas.sshende', '2015varun.gokhale', 'aakashmeshram', 'varunswadia', '2015soham.sawant']"
66,43,13,26,10,"['m.dawson', 'hassananwer1010', 'saqibkamal', 'shehzad_ahmed10', 'hamzaanwer', 'mamonarao01', 'syedzainrock8', 'habhutto2015', 'khurramahmed1997', 'hnihallani75']",3,"['daanyaal', 'hamzaq44', 'aliirtaza98']",16,"['hariskshah', 'afnan.mazhar', 'halamasood27', 'khadimashoor437', 'imtiazhira', 'shaheeradnankhan', 'm.naufil1', 'hakeemorangzeb710', 'mustafaarif12330', 'hariskaleemshah', 'ashna', 'farahperveen72', 'iqra.javed1591997', 'talatbng945', 'sabaq165', 'hamza.aslam3904']",29,"['m.naufil1', 'hakeemorangzeb710', 'hamzaq44', 'hamza.aslam3904', 'm.dawson', 'hassananwer1010', 'mustafaarif12330', 'aliirtaza98', 'habhutto2015', 'talatbng945', 'sabaq165', 'hariskshah', 'afnan.mazhar', 'shehzad_ahmed10', 'khadimashoor437', 'imtiazhira', 'hariskaleemshah', 'mamonarao01', 'khurramahmed1997', 'saqibkamal', 'hnihallani75', 'iqra.javed1591997', 'halamasood27', 'hamzaanwer', 'shaheeradnankhan', 'daanyaal', 'ashna', 'syedzainrock8', 'farahperveen72']"
67,119,12,11,11,"['a_4cash', 'adflanaganlfc', 'barat.abid', 'abarbour', 'angelaes', 'simranc', 'matthewhyder01', 'elliotthook', 'emilyg3110', 'kd3591115', 'ireland.gentile']",1,['hrkillian97'],0,[],12,"['a_4cash', 'adflanaganlfc', 'barat.abid', 'angelaes', 'hrkillian97', 'simranc', 'elliotthook', 'emilyg3110', 'kd3591115', 'ireland.gentile', 'abarbour', 'matthewhyder01']"
69,63,12,18,9,"['yash.bhatia', 'sankalp8055', '2015rasika.wagh', '2015manas.kulkarni', 'abhi97', '2015radhika.angolkar', '2015vipra.arolkar', '2015riya.maheshwari', '2015sanika.pathare']",3,"['zobe97', 'shivanianekar13', 'naval29']",9,"['2015jayanti.jha', 'pravinbagade123', 'ej2013.ankit.panvalkar', 'jainamshah697', 'prajaktapatil', 'neeiljain', '2015prachi.kothawade', '2015deepak', '2015nitish.nayak']",21,"['2015jayanti.jha', 'pravinbagade123', 'sankalp8055', 'zobe97', 'ej2013.ankit.panvalkar', 'naval29', '2015vipra.arolkar', '2015manas.kulkarni', 'prajaktapatil', 'neeiljain', 'jainamshah697', '2015nitish.nayak', 'shivanianekar13', 'yash.bhatia', '2015rasika.wagh', 'abhi97', '2015radhika.angolkar', '2015riya.maheshwari', '2015sanika.pathare', '2015prachi.kothawade', '2015deepak']"
69,61,12,17,3,"['2015riya.maheshwari', '2015rasika.wagh', '2015vipra.arolkar']",9,"['shivanianekar13', 'yash.bhatia', 'sankalp8055', 'zobe97', 'naval29', 'abhi97', '2015radhika.angolkar', '2015manas.kulkarni', '2015sanika.pathare']",14,"['2015dnyanal.berde', 'shrutisneha.prasad', 'lairai9', 'aartimaurya5', '2015soham.sawant', 'sayli8898', 'kaushal37', '2015mugdha.sonwane', 'hemant.wakchaure', 'prajaktapatil', 'tejashree.khirawade', '2015varun.gokhale', '2015prachi.kothawade', '2015bhushan.jadhav']",26,"['2015dnyanal.berde', 'sankalp8055', 'zobe97', 'lairai9', 'aartimaurya5', 'naval29', '2015vipra.arolkar', '2015manas.kulkarni', 'sayli8898', 'prajaktapatil', '2015mugdha.sonwane', 'hemant.wakchaure', 'tejashree.khirawade', '2015bhushan.jadhav', 'shivanianekar13', 'yash.bhatia', 'shrutisneha.prasad', '2015rasika.wagh', 'abhi97', '2015radhika.angolkar', '2015riya.maheshwari', 'kaushal37', '2015sanika.pathare', '2015varun.gokhale', '2015prachi.kothawade', '2015soham.sawant']"
69,62,12,7,1,['2015rasika.wagh'],11,"['shivanianekar13', 'yash.bhatia', 'sankalp8055', 'zobe97', 'naval29', 'abhi97', '2015radhika.angolkar', '2015vipra.arolkar', '2015manas.kulkarni', '2015riya.maheshwari', '2015sanika.pathare']",6,"['shubham.sutrakar', 'aartimaurya5', '2015anuj.pakhare', 'prajaktapatil', '2015varun.gokhale', '2015soham.sawant']",18,"['shubham.sutrakar', 'sankalp8055', 'zobe97', 'aartimaurya5', 'naval29', '2015vipra.arolkar', '2015manas.kulkarni', '2015anuj.pakhare', 'prajaktapatil', 'shivanianekar13', 'yash.bhatia', '2015rasika.wagh', 'abhi97', '2015radhika.angolkar', '2015riya.maheshwari', '2015sanika.pathare', '2015varun.gokhale', '2015soham.sawant']"
69,60,12,6,3,"['2015riya.maheshwari', '2015vipra.arolkar', 'abhi97']",9,"['shivanianekar13', 'yash.bhatia', 'sankalp8055', 'zobe97', '2015rasika.wagh', 'naval29', '2015manas.kulkarni', '2015radhika.angolkar', '2015sanika.pathare']",3,"['lairai9', 'arthaya.koyande28', '2015soumya.chinthalapudi']",15,"['arthaya.koyande28', 'shivanianekar13', '2015soumya.chinthalapudi', 'yash.bhatia', 'sankalp8055', 'zobe97', 'lairai9', '2015rasika.wagh', 'naval29', 'abhi97', '2015radhika.angolkar', '2015vipra.arolkar', '2015manas.kulkarni', '2015riya.maheshwari', '2015sanika.pathare']"
70,20,12,36,5,"['cihanbuyuknacar', 'emre_krtn97', 'kganozcan', 'berkanaydn16', 'onurcanozavci']",7,"['melisozkarr', 'fatiherdgn25', 'elifisparta38', 'ulasgorcelioglu', 'sudekoza', 'furkanefeyuceer', 'yilmazberat1997']",31,"['emre_citak_bil', 'melike_musal', 'cemkarts', '46harunakgul', 'furkanturk1352', 'esracolak.25', 'abdurrahmn15', 'melikemusal1', 'yunusbaskan', 'abcd5454', 'irfancan571', 'furkanznkr', 'metehanmustafayalcin', 'brknshn', 'damlakubattt', 'haticesari333333', 'ozbunar01', 'adnanyuceer', 'ugur.cankaya.3718', 'nihatyavuz', 'frknznkr', 'ilkaydost', 'meltemsbreezes', 'oakbulut1997', 'mevradilanerten', 'evrenyigit', 'muratlevent', 'muvafikmelikkaya', 'davuteee', 'afkali.120', 'omerfkazar22']",43,"['emre_citak_bil', 'melike_musal', 'emre_krtn97', 'cemkarts', '46harunakgul', 'furkanturk1352', 'kganozcan', 'furkanefeyuceer', 'esracolak.25', 'abdurrahmn15', 'melikemusal1', 'yunusbaskan', 'abcd5454', 'irfancan571', 'furkanznkr', 'metehanmustafayalcin', 'brknshn', 'damlakubattt', 'haticesari333333', 'melisozkarr', 'fatiherdgn25', 'ulasgorcelioglu', 'ozbunar01', 'adnanyuceer', 'ugur.cankaya.3718', 'nihatyavuz', 'sudekoza', 'frknznkr', 'berkanaydn16', 'yilmazberat1997', 'ilkaydost', 'meltemsbreezes', 'onurcanozavci', 'oakbulut1997', 'mevradilanerten', 'cihanbuyuknacar', 'elifisparta38', 'evrenyigit', 'muratlevent', 'muvafikmelikkaya', 'davuteee', 'afkali.120', 'omerfkazar22']"
70,22,12,20,4,"['melisozkarr', 'fatiherdgn25', 'elifisparta38', 'sudekoza']",8,"['cihanbuyuknacar', 'ulasgorcelioglu', 'emre_krtn97', 'kganozcan', 'berkanaydn16', 'furkanefeyuceer', 'yilmazberat1997', 'onurcanozavci']",16,"['okanircann', 'ozgurdenizkozan', 'nihansulukoy', 'furkanturk1352', 'metalist_kaan', 'polat.gokberk', 'tuberkargan_97', 'trkmengkay', 'senanurcetin96', 'brknshn', 'sinasigurpinar', 'ozgurkablan26', 'ronal_denho_931', 'oakbulut1997', 'joker632455', 'emrebuyukkose2']",28,"['emre_krtn97', 'furkanturk1352', 'kganozcan', 'furkanefeyuceer', 'ronal_denho_931', 'emrebuyukkose2', 'nihansulukoy', 'tuberkargan_97', 'senanurcetin96', 'brknshn', 'joker632455', 'melisozkarr', 'okanircann', 'fatiherdgn25', 'ulasgorcelioglu', 'ozgurdenizkozan', 'sudekoza', 'metalist_kaan', 'polat.gokberk', 'trkmengkay', 'berkanaydn16', 'sinasigurpinar', 'yilmazberat1997', 'onurcanozavci', 'oakbulut1997', 'cihanbuyuknacar', 'elifisparta38', 'ozgurkablan26']"
70,104,12,8,3,"['melisozkarr', 'fatiherdgn25', 'ulasgorcelioglu']",9,"['cihanbuyuknacar', 'elifisparta38', 'emre_krtn97', 'sudekoza', 'kganozcan', 'berkanaydn16', 'furkanefeyuceer', 'yilmazberat1997', 'onurcanozavci']",5,"['okanircann', 'akoglutayyip', 'meltemsbreezes', 'ozgurdenizkz', 'tttakoglu16000']",17,"['melisozkarr', 'okanircann', 'fatiherdgn25', 'ulasgorcelioglu', 'emre_krtn97', 'akoglutayyip', 'sudekoza', 'kganozcan', 'berkanaydn16', 'furkanefeyuceer', 'yilmazberat1997', 'meltemsbreezes', 'onurcanozavci', 'tttakoglu16000', 'cihanbuyuknacar', 'elifisparta38', 'ozgurdenizkz']"
70,144,12,7,3,"['yilmazberat1997', 'elifisparta38', 'ulasgorcelioglu']",9,"['melisozkarr', 'fatiherdgn25', 'cihanbuyuknacar', 'emre_krtn97', 'sudekoza', 'kganozcan', 'berkanaydn16', 'furkanefeyuceer', 'onurcanozavci']",4,"['mmert.bacak', 'nihansulukoy', 'nagihankececi', 'zubeydekal37']",16,"['melisozkarr', 'mmert.bacak', 'fatiherdgn25', 'ulasgorcelioglu', 'emre_krtn97', 'sudekoza', 'kganozcan', 'berkanaydn16', 'furkanefeyuceer', 'yilmazberat1997', 'onurcanozavci', 'cihanbuyuknacar', 'elifisparta38', 'nihansulukoy', 'zubeydekal37', 'nagihankececi']"
71,92,11,9,9,"['shabyashachi', 'shwethajayakumar97', 'biotechnologybatch.2015', 'manasashettys97', 'noorarfa09', 'meghasg898', 'chinmayi.kashyap28', 'sssmitha97', 'noorulainfatima15']",2,"['subra.aishwarya', 'bhavyabr2697']",0,[],11,"['shwethajayakumar97', 'shabyashachi', 'biotechnologybatch.2015', 'manasashettys97', 'noorarfa09', 'meghasg898', 'subra.aishwarya', 'bhavyabr2697', 'chinmayi.kashyap28', 'sssmitha97', 'noorulainfatima15']"
72,114,11,14,11,"['atugman', 'eliphil', 'youngs2', 'jkrzesni', 'soali', 'madfain', 'gcantor', 'ajwhelan', 'mshassan', 'maxgruen', 'jackclar']",0,[],3,"['nanoushe', 'fanbsun', 'rmneubau']",14,"['atugman', 'nanoushe', 'youngs2', 'madfain', 'gcantor', 'ajwhelan', 'mshassan', 'maxgruen', 'eliphil', 'soali', 'jkrzesni', 'rmneubau', 'fanbsun', 'jackclar']"
73,168,11,7,7,"['rahul.pradhan1997', 'manalighorpade1697', 'shriya.h.joshi', 'ckargutkar96', 'akshayrita20', 'mananshah30137', 'viraktdoshi19']",4,"['agarwal.gagan5101', 'nande.manasi16', '1jyotsna1', 'riddhis2411']",0,[],11,"['agarwal.gagan5101', 'rahul.pradhan1997', 'nande.manasi16', 'manalighorpade1697', 'shriya.h.joshi', 'ckargutkar96', 'akshayrita20', 'mananshah30137', '1jyotsna1', 'viraktdoshi19', 'riddhis2411']"
73,170,11,7,4,"['nande.manasi16', 'riddhis2411', '1jyotsna1', 'agarwal.gagan5101']",7,"['rahul.pradhan1997', 'manalighorpade1697', 'shriya.h.joshi', 'ckargutkar96', 'akshayrita20', 'mananshah30137', 'viraktdoshi19']",3,"['himanisheth98', 'ameysawant25597', 'yashsavle']",14,"['agarwal.gagan5101', 'rahul.pradhan1997', 'nande.manasi16', 'manalighorpade1697', 'yashsavle', 'shriya.h.joshi', 'ckargutkar96', 'akshayrita20', 'mananshah30137', '1jyotsna1', 'viraktdoshi19', 'ameysawant25597', 'himanisheth98', 'riddhis2411']"
74,185,11,7,6,"['tainaracescate', 'guilhermeazevedofis', 'gabrielmontoro', 'joaovictorlemes3', 'methz', 'dionizio']",5,"['bikash.patra', 'vaibhav.gupta.mst16', 'stefanyoofontes', 'menglingyuan.jlu', 'gabrielsousaez']",1,['brauliogabriel'],12,"['tainaracescate', 'bikash.patra', 'guilhermeazevedofis', 'vaibhav.gupta.mst16', 'stefanyoofontes', 'menglingyuan.jlu', 'gabrielsousaez', 'gabrielmontoro', 'brauliogabriel', 'joaovictorlemes3', 'dionizio', 'methz']"
76,37,11,8,6,"['ds1akbarbasha', 'suvankar94', 'saipriya.tummala2018', 'padmavlr01', 'elsa.george2018', 'monunith']",5,"['mdjunaid071', 'sreekanthsp', 'nivedhita123', 'divassingh.dagur2018', 'nikhilsai79']",2,"['kyathamharikrishna', 'padmavlr']",13,"['mdjunaid071', 'sreekanthsp', 'elsa.george2018', 'monunith', 'kyathamharikrishna', 'nivedhita123', 'divassingh.dagur2018', 'padmavlr', 'ds1akbarbasha', 'suvankar94', 'saipriya.tummala2018', 'padmavlr01', 'nikhilsai79']"
77,40,11,19,11,"['matthewdonne141', 'jinyoungpark', 'kgeorgadarel5', 'mbolognese', 'slamotte', 'astam', 'fengsun', 'zwoods', 'jpweber', 'rsepanek', 'pkulkarni']",0,[],8,"['nbonthala', 'srini999', 'pjaswal', 'ternencexiong', 'pfang', 'cjfoss', 'nshattuck', 'nlochner']",19,"['matthewdonne141', 'nbonthala', 'jinyoungpark', 'srini999', 'pjaswal', 'mbolognese', 'slamotte', 'ternencexiong', 'pfang', 'astam', 'cjfoss', 'zwoods', 'jpweber', 'pkulkarni', 'nlochner', 'kgeorgadarel5', 'fengsun', 'nshattuck', 'rsepanek']"
78,52,11,125,4,"['jwoon', 'sueprasad8214', 'dkilgor', 'amckeska']",7,"['hgasper', 'sburmesc', 'waters22', 'gessnergezzy', 'rice103', 'shaunak0304', 'rrahimi']",121,"['mcdona85', 'jfolkers', 'smit3180', 'btestin14', 'radhakr3', 'purduechen2203', 'tilley0', 'ryry1644', 'samm', 'itsmemario', 'cpiepen', 'evdaly', 'fischermben', 'afalkenb', 'lee2370', 'mingusnate', 'angbecker', 'arturotrevino', 'hess35', 'cmelchin', 'nathanmoore', 'oliver67', 'akonopa', 'lmeehann', 'starr21', 'kjh94425', 'aguyre', 'rishiprasadha', 'rileyedelaney', 'singh378', 'maxwellfra16', 'goh5', 'talon34567', 'river132', 'athoman', 'shadow66666', 'chiranth7954', 'conner.swift8', 'boninim', 'wan52', 'xng', 'kevinodonnell0878', 'khageman', 'cbischof', 'ggolla', 'jdanek', 'ebehring', 'shaw108', 'cartmaster007', 'rhellyer', 'agalema1027', 'rsusler', 'chanwoo.lee.17', 'selawada', 'kskripakaran0810', 'muelle77', 'charlesma423', 'joshuajkporter', 'jrohman', 'ehonebri', 'ecronin', 'mccaul', 'jkekre', 'suhaira97', 'nhdorcy', 'garret28', 'jacobglvn', 'caldwe29', 'anthonm', 'landon.glunt', 'dschull', 'rao75', 'bsmrdel', 'albrect', 'nramli', 'ryanwest1040', 'ikobayas', 'mcrees', 'acostab', 'kgmcginley', 'srasche', 'hyndmanjustin', 'rao53', 'tthieles', 'justj', 'dgreiwe', 'kknowlto', 'crhodine', 'rwiebe', 'huan1146', 'heinzt', 'tgiazzon', 'kico', 'ggauthi', 'jkueche', 'wstolz', 'vwallema', 'george7elias', 'yang1206', 'psumner', 'geyerg', 'eforti', 'jskeens', 'yizhizhang', 'cclapham', 'nafandi', 'vpope', 'akreuter', 'nikhilcarneiro4', 'asartor', 'john1886', 'zjohnson834', 'suran9712', 'sknecht', 'dsfgdsfg', 'davids19', 'mcclure8', 'nt230', 'akreilei', 'yeager5', 'kruege14']",132,"['mcdona85', 'radhakr3', 'purduechen2203', 'ryry1644', 'samm', 'evdaly', 'dkilgor', 'afalkenb', 'lee2370', 'mingusnate', 'hess35', 'cmelchin', 'nathanmoore', 'oliver67', 'akonopa', 'lmeehann', 'starr21', 'jwoon', 'rileyedelaney', 'talon34567', 'river132', 'wan52', 'kevinodonnell0878', 'khageman', 'ebehring', 'cartmaster007', 'selawada', 'kskripakaran0810', 'muelle77', 'charlesma423', 'joshuajkporter', 'ehonebri', 'suhaira97', 'jacobglvn', 'waters22', 'dschull', 'bsmrdel', 'albrect', 'nramli', 'mcrees', 'acostab', 'rao53', 'tthieles', 'dgreiwe', 'kknowlto', 'rwiebe', 'heinzt', 'kico', 'ggauthi', 'jkueche', 'wstolz', 'vwallema', 'george7elias', 'yang1206', 'nafandi', 'vpope', 'nikhilcarneiro4', 'asartor', 'zjohnson834', 'davids19', 'akreilei', 'yeager5', 'kruege14', 'chanwoo.lee.17', 'hgasper', 'jfolkers', 'smit3180', 'btestin14', 'tilley0', 'itsmemario', 'cpiepen', 'fischermben', 'angbecker', 'arturotrevino', 'sburmesc', 'kjh94425', 'aguyre', 'rishiprasadha', 'singh378', 'maxwellfra16', 'goh5', 'athoman', 'shadow66666', 'chiranth7954', 'conner.swift8', 'boninim', 'xng', 'gessnergezzy', 'cbischof', 'ggolla', 'jdanek', 'shaw108', 'rhellyer', 'agalema1027', 'rsusler', 'jrohman', 'ecronin', 'mccaul', 'jkekre', 'nhdorcy', 'garret28', 'caldwe29', 'anthonm', 'landon.glunt', 'sueprasad8214', 'rao75', 'ryanwest1040', 'shaunak0304', 'ikobayas', 'kgmcginley', 'srasche', 'hyndmanjustin', 'justj', 'crhodine', 'huan1146', 'tgiazzon', 'psumner', 'geyerg', 'eforti', 'jskeens', 'yizhizhang', 'cclapham', 'rice103', 'akreuter', 'john1886', 'amckeska', 'suran9712', 'sknecht', 'dsfgdsfg', 'mcclure8', 'nt230', 'rrahimi']"
79,77,11,11,9,"['oribibim', 'dayuff', 'tjdgusdbs8810', 'psqkr0283', 'bigstar0107', 'tochimailbox', 'backster7915', 'pjrinas', 'rnjstjdgus5']",2,"['giri', 'sinto8211']",2,"['kinny', 'drygchung']",13,"['giri', 'dayuff', 'tjdgusdbs8810', 'psqkr0283', 'sinto8211', 'pjrinas', 'oribibim', 'bigstar0107', 'tochimailbox', 'drygchung', 'backster7915', 'rnjstjdgus5', 'kinny']"
79,78,11,7,4,"['giri', 'sinto8211', 'psqkr0283', 'bigstar0107']",7,"['oribibim', 'dayuff', 'tjdgusdbs8810', 'tochimailbox', 'backster7915', 'pjrinas', 'rnjstjdgus5']",3,"['ssj7353', 'kinny', 'dbstjdgus8810']",14,"['oribibim', 'giri', 'dayuff', 'tjdgusdbs8810', 'psqkr0283', 'tochimailbox', 'sinto8211', 'rnjstjdgus5', 'dbstjdgus8810', 'ssj7353', 'backster7915', 'pjrinas', 'bigstar0107', 'kinny']"
79,184,11,5,4,"['giri', 'sinto8211', 'psqkr0283', 'bigstar0107']",7,"['oribibim', 'dayuff', 'tjdgusdbs8810', 'tochimailbox', 'backster7915', 'pjrinas', 'rnjstjdgus5']",1,['ssj7353'],12,"['oribibim', 'giri', 'dayuff', 'tjdgusdbs8810', 'psqkr0283', 'tochimailbox', 'sinto8211', 'rnjstjdgus5', 'ssj7353', 'backster7915', 'pjrinas', 'bigstar0107']"
80,55,11,7,1,['bplamondon'],10,"['afnanmazhar', 'chris.png25', 'kausarsaleem65', 'rg3brevverv', 'rsotadoy', 'camargome2013', 'faizanalibugti', 'kashasan15', 'bwilson', 'mabigirco']",6,"['ppawelski', 'stabatabaei', 'mmei', 'jamesdoty', 'carleydavis', 'ksie']",17,"['afnanmazhar', 'ppawelski', 'stabatabaei', 'chris.png25', 'mmei', 'kausarsaleem65', 'rg3brevverv', 'jamesdoty', 'rsotadoy', 'camargome2013', 'faizanalibugti', 'kashasan15', 'bwilson', 'bplamondon', 'carleydavis', 'mabigirco', 'ksie']"
81,164,10,41,4,"['welingnamrata', 'bhupeshpatil98', 'rakeshpatil3019', '100vichare']",6,"['joshinirmit', 'tapan.garge', 'supriyasingh1230', 'yashtanvipalande', 'ashish123_', 'vishaltalari.vt']",37,"['urmil1700', 'rakeshpatil9271', 'rahulbirwadkar123', 'shripal17', 'bendalneha', 'prajaktathorat24', 'adisawant333', 'kajalbhoite04', 'gauribahatkar', 'hsnnalwala7', 'ashnavirdikar.av', 'rasikapednekar20', 'arfat_24', 'bhai0045', 'pnrs.pratik', 'pranjalijadhav0911', 'pranalikothekar5', 'divyassonawane', 'salvir481', 'arpitgodbole7', 'sonalikharade5', 'rohit.elawadekar333', 'aritramondal151', 'prathamesh.shivmare1', 'priyankakunde22', 'sanjit', 'prathameshpatle13', 'sukanyajadhav1997', 'jinku5454', 'akankshachandoskar1198', 'owais11', 'aditiramadwar', 'sourabhkothari16', 'anujmdeorukhkar', 'joishersweta17695', 'kedar.kulkarni12', 'aquibansari12377']",47,"['joshinirmit', 'urmil1700', 'rakeshpatil9271', 'rahulbirwadkar123', 'shripal17', 'vishaltalari.vt', 'bendalneha', 'prajaktathorat24', 'adisawant333', 'bhupeshpatil98', 'kajalbhoite04', 'gauribahatkar', 'hsnnalwala7', 'ashnavirdikar.av', 'rasikapednekar20', 'arfat_24', 'bhai0045', 'pnrs.pratik', 'welingnamrata', 'ashish123_', 'pranjalijadhav0911', 'pranalikothekar5', 'supriyasingh1230', 'yashtanvipalande', 'divyassonawane', 'salvir481', 'arpitgodbole7', 'sonalikharade5', 'rohit.elawadekar333', '100vichare', 'aritramondal151', 'rakeshpatil3019', 'prathamesh.shivmare1', 'priyankakunde22', 'sanjit', 'prathameshpatle13', 'sukanyajadhav1997', 'tapan.garge', 'jinku5454', 'akankshachandoskar1198', 'owais11', 'aditiramadwar', 'sourabhkothari16', 'anujmdeorukhkar', 'joishersweta17695', 'kedar.kulkarni12', 'aquibansari12377']"
82,113,10,6,6,"['morechinmay123', 'omkarjoshi403', 'aqibkazi10', 'tanvi2881998', 'josephpatole23', 'megauripawar']",4,"['shivam10', 'gaurav.kolapate54', 'shivalisshah', 'rohitm13797']",0,[],10,"['morechinmay123', 'gaurav.kolapate54', 'omkarjoshi403', 'aqibkazi10', 'tanvi2881998', 'rohitm13797', 'shivam10', 'josephpatole23', 'megauripawar', 'shivalisshah']"
83,108,10,9,7,"['yul_20397', 'kosincevxx', 'yulia_20397', 'sasha61', 'celepharn', 'pereverzevaan17', 'artemivanov1']",3,"['silverbeats01', 'yobaniywaggon', 'nykytas']",2,"['katherynelperry', 'stas.gaev.98']",12,"['kosincevxx', 'sasha61', 'silverbeats01', 'nykytas', 'pereverzevaan17', 'yul_20397', 'yobaniywaggon', 'stas.gaev.98', 'katherynelperry', 'yulia_20397', 'celepharn', 'artemivanov1']"
83,105,10,7,7,"['yul_20397', 'kosincevxx', 'yulia_20397', 'sasha61', 'nykytas', 'pereverzevaan17', 'artemivanov1']",3,"['silverbeats01', 'yobaniywaggon', 'celepharn']",0,[],10,"['yul_20397', 'yobaniywaggon', 'yulia_20397', 'kosincevxx', 'sasha61', 'silverbeats01', 'celepharn', 'nykytas', 'pereverzevaan17', 'artemivanov1']"
85,107,10,11,8,"['jthakka2', 'hhonarv1', 'sshinde4', 'darshna1604', 'sudarsan1995', 'luvpreet', 'zxu45', 'shuaifeng']",2,"['yutingchen', 'xyzzhanggan']",3,"['jayyflores', 'soham947', 'szhan152']",13,"['jthakka2', 'hhonarv1', 'sudarsan1995', 'jayyflores', 'xyzzhanggan', 'yutingchen', 'soham947', 'shuaifeng', 'sshinde4', 'darshna1604', 'luvpreet', 'szhan152', 'zxu45']"
86,115,9,12,9,"['leonardokrleza', 'mfilipasic', 'metalian8', 'sabinadzafic1', 'andrejkontrec', 'pgazdek', 'avidov', 'aso', 'cindric19']",0,[],3,"['juraj.ovcar', 'goranka', 'josipadiklic']",12,"['goranka', 'metalian8', 'mfilipasic', 'sabinadzafic1', 'juraj.ovcar', 'pgazdek', 'aso', 'cindric19', 'leonardokrleza', 'josipadiklic', 'andrejkontrec', 'avidov']"
87,45,9,9,9,"['paranbarlak', 'dyagdi35', 'firatyalcin', 'fyalcin', 'hknucakg', 'naz', 'enessaitbesler', 'defnenazguler', 'senlen09']",0,[],0,[],9,"['paranbarlak', 'dyagdi35', 'firatyalcin', 'fyalcin', 'hknucakg', 'naz', 'enessaitbesler', 'defnenazguler', 'senlen09']"
88,164,9,41,4,"['bendalneha', 'jinku5454', 'urmil1700', 'arfat_24']",5,"['anushkumar', 'debosmita.b', 'neha.hg', 'aditya.aher', 'rajas.b']",37,"['rakeshpatil9271', 'rahulbirwadkar123', 'shripal17', 'prajaktathorat24', 'adisawant333', 'kajalbhoite04', 'bhupeshpatil98', 'gauribahatkar', 'hsnnalwala7', 'ashnavirdikar.av', 'anujmdeorukhkar', 'bhai0045', 'pnrs.pratik', 'welingnamrata', 'pranjalijadhav0911', 'pranalikothekar5', 'divyassonawane', 'salvir481', 'arpitgodbole7', 'sonalikharade5', 'rohit.elawadekar333', '100vichare', 'aritramondal151', 'rakeshpatil3019', 'prathamesh.shivmare1', 'priyankakunde22', 'sanjit', 'prathameshpatle13', 'sukanyajadhav1997', 'akankshachandoskar1198', 'owais11', 'aditiramadwar', 'sourabhkothari16', 'rasikapednekar20', 'joishersweta17695', 'kedar.kulkarni12', 'aquibansari12377']",46,"['urmil1700', 'rakeshpatil9271', 'rahulbirwadkar123', 'shripal17', 'bendalneha', 'prajaktathorat24', 'adisawant333', 'kajalbhoite04', 'bhupeshpatil98', 'gauribahatkar', 'hsnnalwala7', 'ashnavirdikar.av', 'rasikapednekar20', 'arfat_24', 'bhai0045', 'anushkumar', 'pnrs.pratik', 'welingnamrata', 'neha.hg', 'pranjalijadhav0911', 'pranalikothekar5', 'divyassonawane', 'salvir481', 'arpitgodbole7', 'debosmita.b', 'sonalikharade5', 'rohit.elawadekar333', '100vichare', 'aritramondal151', 'rakeshpatil3019', 'prathamesh.shivmare1', 'rajas.b', 'priyankakunde22', 'sanjit', 'prathameshpatle13', 'sukanyajadhav1997', 'jinku5454', 'akankshachandoskar1198', 'owais11', 'aditiramadwar', 'sourabhkothari16', 'aditya.aher', 'anujmdeorukhkar', 'joishersweta17695', 'kedar.kulkarni12', 'aquibansari12377']"
89,52,9,125,2,"['arturotrevino', 'rwiebe']",7,"['agrawa56', 'ailer', 'kfindley', 'oabegund', 'bbaskara', 'wu795', 'lehman25']",123,"['mcdona85', 'jfolkers', 'smit3180', 'btestin14', 'radhakr3', 'purduechen2203', 'tilley0', 'ryry1644', 'samm', 'itsmemario', 'cpiepen', 'evdaly', 'dkilgor', 'fischermben', 'afalkenb', 'lee2370', 'mingusnate', 'angbecker', 'hess35', 'cmelchin', 'nathanmoore', 'oliver67', 'akonopa', 'lmeehann', 'starr21', 'kjh94425', 'jwoon', 'aguyre', 'rishiprasadha', 'rileyedelaney', 'singh378', 'maxwellfra16', 'goh5', 'talon34567', 'river132', 'athoman', 'shadow66666', 'chiranth7954', 'conner.swift8', 'boninim', 'wan52', 'xng', 'kevinodonnell0878', 'khageman', 'cbischof', 'ggolla', 'jdanek', 'ebehring', 'shaw108', 'cartmaster007', 'rhellyer', 'agalema1027', 'rsusler', 'chanwoo.lee.17', 'selawada', 'kskripakaran0810', 'muelle77', 'charlesma423', 'joshuajkporter', 'jrohman', 'ehonebri', 'ecronin', 'mccaul', 'jkekre', 'suhaira97', 'nhdorcy', 'garret28', 'jacobglvn', 'caldwe29', 'anthonm', 'landon.glunt', 'sueprasad8214', 'dschull', 'rao75', 'bsmrdel', 'albrect', 'nramli', 'ryanwest1040', 'ikobayas', 'mcrees', 'acostab', 'kgmcginley', 'srasche', 'hyndmanjustin', 'rao53', 'tthieles', 'justj', 'dgreiwe', 'kknowlto', 'crhodine', 'huan1146', 'heinzt', 'tgiazzon', 'kico', 'ggauthi', 'jkueche', 'wstolz', 'vwallema', 'george7elias', 'yang1206', 'psumner', 'geyerg', 'eforti', 'jskeens', 'yizhizhang', 'cclapham', 'nafandi', 'vpope', 'akreuter', 'nikhilcarneiro4', 'asartor', 'john1886', 'zjohnson834', 'suran9712', 'sknecht', 'amckeska', 'dsfgdsfg', 'davids19', 'mcclure8', 'nt230', 'akreilei', 'yeager5', 'kruege14']",132,"['mcdona85', 'radhakr3', 'purduechen2203', 'ryry1644', 'samm', 'evdaly', 'dkilgor', 'afalkenb', 'lee2370', 'mingusnate', 'hess35', 'cmelchin', 'nathanmoore', 'oliver67', 'akonopa', 'lmeehann', 'starr21', 'jwoon', 'rileyedelaney', 'talon34567', 'river132', 'wan52', 'kevinodonnell0878', 'khageman', 'ebehring', 'cartmaster007', 'selawada', 'kskripakaran0810', 'muelle77', 'charlesma423', 'joshuajkporter', 'ehonebri', 'suhaira97', 'jacobglvn', 'wu795', 'dschull', 'bsmrdel', 'albrect', 'nramli', 'mcrees', 'acostab', 'rao53', 'tthieles', 'dgreiwe', 'kknowlto', 'rwiebe', 'heinzt', 'kico', 'ggauthi', 'jkueche', 'wstolz', 'vwallema', 'george7elias', 'yang1206', 'nafandi', 'vpope', 'nikhilcarneiro4', 'asartor', 'zjohnson834', 'davids19', 'akreilei', 'yeager5', 'kruege14', 'chanwoo.lee.17', 'jfolkers', 'smit3180', 'btestin14', 'tilley0', 'itsmemario', 'cpiepen', 'lehman25', 'fischermben', 'angbecker', 'arturotrevino', 'kjh94425', 'aguyre', 'rishiprasadha', 'singh378', 'maxwellfra16', 'goh5', 'athoman', 'shadow66666', 'chiranth7954', 'oabegund', 'conner.swift8', 'boninim', 'xng', 'cbischof', 'ggolla', 'jdanek', 'shaw108', 'rhellyer', 'agalema1027', 'rsusler', 'jrohman', 'ecronin', 'mccaul', 'jkekre', 'agrawa56', 'nhdorcy', 'garret28', 'caldwe29', 'anthonm', 'landon.glunt', 'sueprasad8214', 'rao75', 'ryanwest1040', 'ikobayas', 'kgmcginley', 'srasche', 'hyndmanjustin', 'justj', 'crhodine', 'huan1146', 'tgiazzon', 'psumner', 'ailer', 'geyerg', 'eforti', 'bbaskara', 'jskeens', 'yizhizhang', 'cclapham', 'akreuter', 'kfindley', 'john1886', 'suran9712', 'sknecht', 'amckeska', 'dsfgdsfg', 'mcclure8', 'nt230']"
91,136,9,11,6,"['shelar.chetan4', 'pranay.kesarkar1', 'neha10patade', 'roshanpoojari31', 'kajaldevake30', 'nandakale98']",3,"['a21shivam', 'vidushirazdan1308', 'ranajay1997']",5,"['rahulkadam7055', 'max_mercury', 'kedar.kulkarni12', 'dilipramgir', 'rishimud']",14,"['vidushirazdan1308', 'max_mercury', 'dilipramgir', 'rishimud', 'rahulkadam7055', 'shelar.chetan4', 'pranay.kesarkar1', 'neha10patade', 'roshanpoojari31', 'a21shivam', 'ranajay1997', 'kajaldevake30', 'nandakale98', 'kedar.kulkarni12']"
92,11,9,6,1,['carmenvelazquez6'],8,"['gines', 'angelg844', 'rociosg97', 'abalro75', 'henawho', 'marinac1997', 'pedrogs12', 'moreparaya']",5,"['carlosisgg97', 'elenarg', 'zacagonzalez96', 'jomaes1997', 'martin10p']",14,"['carmenvelazquez6', 'gines', 'angelg844', 'rociosg97', 'carlosisgg97', 'abalro75', 'henawho', 'marinac1997', 'elenarg', 'zacagonzalez96', 'pedrogs12', 'jomaes1997', 'martin10p', 'moreparaya']"
94,4,9,8,3,"['ruining2', 'ascherr', 'bpitcla']",6,"['ferrario.andrea', 'chakraborty.84', 'nsadowski', 'e78yui', 'earchambault', 'pvlams']",5,"['marcjaikissoon', 'reuben.mathew1995', 'yarbrough.josiah', 'solomontolu5', 'khhsu0724']",14,"['ferrario.andrea', 'solomontolu5', 'chakraborty.84', 'nsadowski', 'ascherr', 'marcjaikissoon', 'e78yui', 'yarbrough.josiah', 'ruining2', 'reuben.mathew1995', 'bpitcla', 'earchambault', 'pvlams', 'khhsu0724']"
95,79,9,6,5,"['mccoombs', 'fredhills', 'hamamines', 'ch630183', 'xibfeng']",4,"['rambrose', 'bauer96', 'franpastor', 'dressler.reid']",1,['albd'],10,"['mccoombs', 'bauer96', 'fredhills', 'albd', 'dressler.reid', 'ch630183', 'rambrose', 'hamamines', 'franpastor', 'xibfeng']"
96,161,8,8,7,"['bar.zamed', 'dimasin29.5', 'sapir', 'roby.zeevi', 'salea656', 'avirammm5', 'jennyb1130']",1,['lyle'],1,['heftsirag1982'],9,"['bar.zamed', 'lyle', 'dimasin29.5', 'heftsirag1982', 'sapir', 'roby.zeevi', 'salea656', 'avirammm5', 'jennyb1130']"
97,135,8,10,7,"['rajeev.moghe', 'sandesh.jain', 'rajvee.theultimate', 'prajaktakolekar', 'shreyagupta0807', 'darshana.mehta', 'amey.mahadik']",1,['prutha.atre'],3,"['sugandhanisrad1997', 'kapil1410', 'anchal.jaiswal']",11,"['rajeev.moghe', 'sandesh.jain', 'rajvee.theultimate', 'prutha.atre', 'prajaktakolekar', 'sugandhanisrad1997', 'shreyagupta0807', 'darshana.mehta', 'kapil1410', 'anchal.jaiswal', 'amey.mahadik']"
98,123,8,8,8,"['christyt', 'clark472', 'rodri576', 'sam.mattingly57', 'kramer73', 'vollstedtjoseph', 'crdieterlen', 'jake9903man']",0,[],0,[],8,"['christyt', 'crdieterlen', 'clark472', 'rodri576', 'sam.mattingly57', 'kramer73', 'vollstedtjoseph', 'jake9903man']"
99,58,8,21,8,"['ajayphroust.ay', 'mani.mandude', 'priyu0964', 'aadi', 'vixsnair', 'afsarkhan160', 'rohitnair77880', 'rockey.anths']",0,[],13,"['arthaya.koyande28', 'aa9858203050', 'umeshlohote', 'patilprasad0123', 'anishnair1996', 'mallickshrutik', 'kaustubhvaishampayan', 'zeevd19', 'shubham.yelange', 'shindedeepak129', 'shreyahonagekar04', 'smahamulkar1013', 'sheetalwings97']",21,"['arthaya.koyande28', 'sheetalwings97', 'priyu0964', 'patilprasad0123', 'mallickshrutik', 'zeevd19', 'vixsnair', 'afsarkhan160', 'smahamulkar1013', 'ajayphroust.ay', 'mani.mandude', 'aa9858203050', 'umeshlohote', 'anishnair1996', 'kaustubhvaishampayan', 'aadi', 'shubham.yelange', 'shindedeepak129', 'shreyahonagekar04', 'rohitnair77880', 'rockey.anths']"
100,165,8,18,1,['susmeetsukte'],7,"['rahulkadam7055', 'rohanotari21', 'sohammhas', 'ashu0497', 'dilipramgir', 'aloksardesai97', 'priyankakamble']",17,"['divyassonawane', 'kaushiksawant93', 'pnrs.pratik', 'prachi.mujawar', 'shripal17', 'max_mercury', 'owais11', 'rms.maurya21', 'ardalvi85', 'pranjalijadhav0911', 'bhandarepranay9208', 'adisawant333', 'priyankakunde22', 'siddhesh.soyane', 'hsnnalwala7', 'rishimud', 'rajashree.pimputkar']",25,"['divyassonawane', 'kaushiksawant93', 'rohanotari21', 'prachi.mujawar', 'shripal17', 'max_mercury', 'ashu0497', 'ardalvi85', 'adisawant333', 'dilipramgir', 'aloksardesai97', 'priyankakamble', 'susmeetsukte', 'priyankakunde22', 'hsnnalwala7', 'rishimud', 'rahulkadam7055', 'pnrs.pratik', 'sohammhas', 'owais11', 'rms.maurya21', 'pranjalijadhav0911', 'bhandarepranay9208', 'siddhesh.soyane', 'rajashree.pimputkar']"
100,133,8,16,4,"['aloksardesai97', 'priyankakamble', 'sohammhas', 'ashu0497']",4,"['rohanotari21', 'rahulkadam7055', 'dilipramgir', 'susmeetsukte']",12,"['msawant869', 'priyankakunde22', 'abhishektoraskar412', 'owais11', 'ankitagamare2218', 'siddhant8291', 'aritramondal151', 'arshan.ansari002', 'saketnaik', 'mayur.manve4', 'prathameshpatle13', 'shraddhagadankush1998']",20,"['msawant869', 'rohanotari21', 'ashu0497', 'ankitagamare2218', 'aritramondal151', 'dilipramgir', 'arshan.ansari002', 'aloksardesai97', 'priyankakamble', 'susmeetsukte', 'priyankakunde22', 'prathameshpatle13', 'shraddhagadankush1998', 'rahulkadam7055', 'abhishektoraskar412', 'sohammhas', 'owais11', 'siddhant8291', 'saketnaik', 'mayur.manve4']"
100,132,8,11,1,['rohanotari21'],7,"['rahulkadam7055', 'sohammhas', 'ashu0497', 'dilipramgir', 'aloksardesai97', 'priyankakamble', 'susmeetsukte']",10,"['javedptl', 'salvir481', 'owais11', 'rohit.elawadekar333', 'ankitagamare2218', 'arshan.ansari002', 'anujmdeorukhkar', 'gabru1803', 'sukanyajadhav1997', 'rajashree.pimputkar']",18,"['javedptl', 'salvir481', 'rohanotari21', 'ashu0497', 'rohit.elawadekar333', 'ankitagamare2218', 'dilipramgir', 'arshan.ansari002', 'aloksardesai97', 'priyankakamble', 'susmeetsukte', 'sukanyajadhav1997', 'rahulkadam7055', 'sohammhas', 'owais11', 'anujmdeorukhkar', 'gabru1803', 'rajashree.pimputkar']"
100,136,8,11,2,"['rahulkadam7055', 'dilipramgir']",6,"['rohanotari21', 'sohammhas', 'ashu0497', 'aloksardesai97', 'priyankakamble', 'susmeetsukte']",9,"['shelar.chetan4', 'pranay.kesarkar1', 'neha10patade', 'max_mercury', 'kedar.kulkarni12', 'roshanpoojari31', 'kajaldevake30', 'nandakale98', 'rishimud']",17,"['rohanotari21', 'max_mercury', 'ashu0497', 'dilipramgir', 'aloksardesai97', 'priyankakamble', 'susmeetsukte', 'rishimud', 'rahulkadam7055', 'shelar.chetan4', 'pranay.kesarkar1', 'neha10patade', 'sohammhas', 'roshanpoojari31', 'kajaldevake30', 'nandakale98', 'kedar.kulkarni12']"
100,167,8,9,1,['aloksardesai97'],7,"['rahulkadam7055', 'rohanotari21', 'sohammhas', 'ashu0497', 'dilipramgir', 'priyankakamble', 'susmeetsukte']",8,"['sarika_bukkawar', 'pranav123', 'max_mercury', 'mayanksamar786', 'shantanupanigrahi98', 'akshatask', 'rutujakamthe', 'chetushirke']",16,"['rahulkadam7055', 'sarika_bukkawar', 'rohanotari21', 'pranav123', 'sohammhas', 'mayanksamar786', 'max_mercury', 'ashu0497', 'shantanupanigrahi98', 'dilipramgir', 'aloksardesai97', 'priyankakamble', 'rutujakamthe', 'akshatask', 'susmeetsukte', 'chetushirke']"
100,138,8,8,1,['susmeetsukte'],7,"['rahulkadam7055', 'rohanotari21', 'sohammhas', 'ashu0497', 'dilipramgir', 'aloksardesai97', 'priyankakamble']",7,"['arpitgodbole7', 'iammayuri3', 'dshantanu2902', 'sonalikharade5', 'rasikapednekar20', 'akshatask', 'ashnavirdikar.av']",15,"['rasikapednekar20', 'rahulkadam7055', 'arpitgodbole7', 'rohanotari21', 'iammayuri3', 'sohammhas', 'dshantanu2902', 'sonalikharade5', 'ashu0497', 'dilipramgir', 'aloksardesai97', 'priyankakamble', 'akshatask', 'susmeetsukte', 'ashnavirdikar.av']"
102,55,8,7,2,"['ppawelski', 'carleydavis']",6,"['jjdemiguel', 'mcgiesoi', 'brunnagomess123', 'rjdavis0928', 'j1204jason', 'hermanakagla']",5,"['stabatabaei', 'mmei', 'jamesdoty', 'bplamondon', 'ksie']",13,"['jjdemiguel', 'ppawelski', 'mcgiesoi', 'stabatabaei', 'brunnagomess123', 'rjdavis0928', 'mmei', 'jamesdoty', 'carleydavis', 'bplamondon', 'j1204jason', 'hermanakagla', 'ksie']"
105,15,8,9,8,"['jesasa1', 'beatrizsp', 'francarpio96', 'anthongomez97', 'ireparsi', 'adrrommun', 'josecarlos', 'juanfran974']",0,[],1,['luiscamu'],9,"['beatrizsp', 'jesasa1', 'luiscamu', 'anthongomez97', 'juanfran974', 'ireparsi', 'adrrommun', 'josecarlos', 'francarpio96']"
106,150,8,6,4,"['jonah.mauxion', 'maximelemieuxtanguay', 'alexis.perez183', 'trevor.tartaglia']",4,"['arturocastro94', 'andrea.masili', 'dpayne7', 'lgnbdnr']",2,"['bianca11', 'elie_9742']",10,"['jonah.mauxion', 'bianca11', 'trevor.tartaglia', 'maximelemieuxtanguay', 'andrea.masili', 'alexis.perez183', 'lgnbdnr', 'arturocastro94', 'dpayne7', 'elie_9742']"
107,31,8,9,8,"['elenavilchez3', 'angelamgodoy7', 'elenams1997', 'marina17', 'irinamezquita', 'martaveegas', 'jesusvg97', 'olgajimenez.ojn']",0,[],1,['andrea.crod96'],9,"['elenavilchez3', 'angelamgodoy7', 'elenams1997', 'marina17', 'irinamezquita', 'andrea.crod96', 'martaveegas', 'jesusvg97', 'olgajimenez.ojn']"
110,133,8,16,7,"['msawant869', 'ankitagamare2218', 'siddhant8291', 'arshan.ansari002', 'saketnaik', 'mayur.manve4', 'shraddhagadankush1998']",1,['gabru1803'],9,"['priyankakunde22', 'abhishektoraskar412', 'sohammhas', 'owais11', 'ashu0497', 'aritramondal151', 'aloksardesai97', 'priyankakamble', 'prathameshpatle13']",17,"['msawant869', 'ankitagamare2218', 'ashu0497', 'aritramondal151', 'arshan.ansari002', 'aloksardesai97', 'priyankakunde22', 'priyankakamble', 'prathameshpatle13', 'shraddhagadankush1998', 'abhishektoraskar412', 'sohammhas', 'owais11', 'siddhant8291', 'saketnaik', 'mayur.manve4', 'gabru1803']"
110,132,8,11,3,"['gabru1803', 'ankitagamare2218', 'arshan.ansari002']",5,"['msawant869', 'siddhant8291', 'saketnaik', 'mayur.manve4', 'shraddhagadankush1998']",8,"['salvir481', 'rohanotari21', 'owais11', 'rohit.elawadekar333', 'anujmdeorukhkar', 'javedptl', 'sukanyajadhav1997', 'rajashree.pimputkar']",16,"['javedptl', 'msawant869', 'salvir481', 'rohanotari21', 'ankitagamare2218', 'rohit.elawadekar333', 'arshan.ansari002', 'sukanyajadhav1997', 'shraddhagadankush1998', 'anujmdeorukhkar', 'owais11', 'siddhant8291', 'saketnaik', 'mayur.manve4', 'gabru1803', 'rajashree.pimputkar']"
113,172,7,8,7,"['markfds0712', 'ayushibhtngr96', 'swapnaja73', 'mikhailppinto2828', 'yashivinz', 'adityachachad', 'dalvi.mahadev33']",0,[],1,['sebin.bc'],8,"['yashivinz', 'markfds0712', 'ayushibhtngr96', 'sebin.bc', 'mikhailppinto2828', 'swapnaja73', 'adityachachad', 'dalvi.mahadev33']"
114,141,7,7,3,"['siu853667486', 'craizk', 'erickg']",4,"['spencer.travis97', 'nathansadlab', 'maryesperancia', 'michaelroberto98']",4,"['mousaeid96', 'kramernolan4', 'guxci2019', 'ampm1223']",11,"['maryesperancia', 'mousaeid96', 'kramernolan4', 'guxci2019', 'erickg', 'siu853667486', 'nathansadlab', 'ampm1223', 'spencer.travis97', 'craizk', 'michaelroberto98']"
114,143,7,6,1,['michaelroberto98'],6,"['maryesperancia', 'erickg', 'siu853667486', 'nathansadlab', 'spencer.travis97', 'craizk']",5,"['zunaidur.rashid', 'guxci2019', 'ryleec23', 'natexdog9800', 'xrazepridex']",12,"['maryesperancia', 'zunaidur.rashid', 'guxci2019', 'erickg', 'ryleec23', 'natexdog9800', 'siu853667486', 'nathansadlab', 'spencer.travis97', 'xrazepridex', 'craizk', 'michaelroberto98']"
115,67,7,7,7,"['boyax', 'kg34', 'vincent.philip.fitzpatrick', 'fbackl01', 'juangimenez', 'quanquan5530', 'latha']",0,[],0,[],7,"['boyax', 'kg34', 'vincent.philip.fitzpatrick', 'fbackl01', 'juangimenez', 'quanquan5530', 'latha']"
116,112,7,8,4,"['nikita.us', 'sonali.gavkar', 'rahul.ys', 'smita.n']",3,"['sanjita.s', 'jagruti.patil', 'vaishnavimahukar28']",4,"['ashok.bp', 'pranav.ss', 'vatsal23', 'akshaykumar.ks']",11,"['sanjita.s', 'vaishnavimahukar28', 'akshaykumar.ks', 'nikita.us', 'sonali.gavkar', 'ashok.bp', 'rahul.ys', 'pranav.ss', 'jagruti.patil', 'smita.n', 'vatsal23']"
119,166,7,6,6,"['akshaybhore7', 'swastik2', 'mayurpashte97', 'arushi.yadav', 'sagar21', 'deep.patel']",1,['inamdarshreyas5'],0,[],7,"['akshaybhore7', 'inamdarshreyas5', 'swastik2', 'mayurpashte97', 'arushi.yadav', 'sagar21', 'deep.patel']"
122,103,7,66,7,"['parth15156', 'rajat16182', 'imrajat', 'vishal16207', 'sahil16184', 'harsh16150', 'dheeraj15138']",0,[],59,"['manshi18207', 'aparna18196', 'sambeet15168', 'kumari18221', 'saurav15174', 'shivam18215', 'maddineni18206', 'kunal15145', 'harsh161500', 'shubham18176', 'sambhav14158', 'shuchi18224', 'smartvedi', 'subhadip17124', 'anubhav15128', 'vaishali18220', 'abhinavg', 'shubhesh18216', 'dhaval_1104', 'hnspoorthy', 'studsuper50', 'gurpreet15140', 'nowudontknowme', 'priyanka18169', 'tarun14168', 'aman18194', 'sagar15167', 'puneet15159', 'mridul15149', 'paras15154', 'yogesh15193', 'jasmine18202', 'subhadipporia', 'ashish18157', 'surabhi18217', 'avdesh15135', 'puneet16178', 'ehtesham18199', 'adityadiundi', 'akshay18193', 'tushar18218', 'shivani18223', 'shivam15177', 'saumya15172', 'shivam18214', 'arij18208', 'sarthak16190', 'rajat15162', 'shaikh18213', 'ankur14019', 'anchal18155', 'sagar17115', 'pankaj16176', 'aminah', 'feraj.husain', 'aakash18191', 'prateek18211', 'neerupama18209', 'juilly']",66,"['manshi18207', 'aparna18196', 'sambeet15168', 'kumari18221', 'saurav15174', 'shivam18215', 'maddineni18206', 'kunal15145', 'harsh161500', 'shubham18176', 'sambhav14158', 'shuchi18224', 'smartvedi', 'subhadip17124', 'anubhav15128', 'vaishali18220', 'abhinavg', 'shubhesh18216', 'dhaval_1104', 'hnspoorthy', 'studsuper50', 'gurpreet15140', 'nowudontknowme', 'priyanka18169', 'tarun14168', 'aman18194', 'sagar15167', 'parth15156', 'puneet15159', 'mridul15149', 'paras15154', 'vishal16207', 'yogesh15193', 'jasmine18202', 'subhadipporia', 'ashish18157', 'imrajat', 'surabhi18217', 'avdesh15135', 'sahil16184', 'puneet16178', 'ehtesham18199', 'adityadiundi', 'akshay18193', 'tushar18218', 'shivani18223', 'shivam15177', 'saumya15172', 'rajat16182', 'shivam18214', 'arij18208', 'sarthak16190', 'rajat15162', 'shaikh18213', 'harsh16150', 'ankur14019', 'anchal18155', 'sagar17115', 'dheeraj15138', 'pankaj16176', 'aminah', 'feraj.husain', 'aakash18191', 'prateek18211', 'neerupama18209', 'juilly']"
122,111,7,10,7,"['parth15156', 'rajat16182', 'imrajat', 'vishal16207', 'sahil16184', 'harsh16150', 'dheeraj15138']",0,[],3,"['harsh161500', 'shivam18215', 'yogesh15193']",10,"['parth15156', 'rajat16182', 'vishal16207', 'yogesh15193', 'harsh16150', 'dheeraj15138', 'shivam18215', 'imrajat', 'harsh161500', 'sahil16184']"
124,81,6,6,3,"['alejandrorivelles21', 'saraquaini96', 'dguemes']",3,"['isabelgopa', 'elenalp', 'carlo176']",3,"['villalba.perez.miguel', 'jpedros100', 'brunodistefano8']",9,"['elenalp', 'villalba.perez.miguel', 'jpedros100', 'brunodistefano8', 'saraquaini96', 'alejandrorivelles21', 'carlo176', 'dguemes', 'isabelgopa']"
128,194,6,6,5,"['tcheng.gogo', 'wenzhao', 'czhao', 'duanyunruisdu', 'xiaokong91']",1,['aageo25'],1,['leining'],7,"['tcheng.gogo', 'wenzhao', 'czhao', 'duanyunruisdu', 'aageo25', 'xiaokong91', 'leining']"
129,137,6,8,6,"['ishayadavie21', 'pshindekov', 'ankitwolf14', 'nevilpooniwala', 'harshalisawant92', 'swastikadigha31']",0,[],2,"['sugandhanisrad1997', 'shettynisha131']",8,"['ishayadavie21', 'pshindekov', 'ankitwolf14', 'nevilpooniwala', 'sugandhanisrad1997', 'harshalisawant92', 'swastikadigha31', 'shettynisha131']"
131,117,6,8,6,"['rewiley', 'jarebstock', 'isstevens', 'hrichards42', 'pglynch', 'adahik']",0,[],2,"['hmelzer', 'ndfan97']",8,"['rewiley', 'jarebstock', 'ndfan97', 'isstevens', 'pglynch', 'hrichards42', 'hmelzer', 'adahik']"
133,58,6,21,6,"['shreyahonagekar04', 'umeshlohote', 'mallickshrutik', 'shindedeepak129', 'smahamulkar1013', 'sheetalwings97']",0,[],15,"['arthaya.koyande28', 'mani.mandude', 'rockey.anths', 'aa9858203050', 'priyu0964', 'anishnair1996', 'patilprasad0123', 'kaustubhvaishampayan', 'zeevd19', 'shubham.yelange', 'aadi', 'vixsnair', 'afsarkhan160', 'rohitnair77880', 'ajayphroust.ay']",21,"['arthaya.koyande28', 'rohitnair77880', 'priyu0964', 'patilprasad0123', 'mallickshrutik', 'zeevd19', 'vixsnair', 'afsarkhan160', 'smahamulkar1013', 'ajayphroust.ay', 'mani.mandude', 'aa9858203050', 'umeshlohote', 'anishnair1996', 'kaustubhvaishampayan', 'aadi', 'shubham.yelange', 'shindedeepak129', 'shreyahonagekar04', 'sheetalwings97', 'rockey.anths']"
134,76,6,12,6,"['graceml2', 'raphaeldu', 'nothando21', 'ichesser', 'sjtuzhanglei', 'vishwasg']",0,[],6,"['shushujie', 'kalan', 'tanni', 'mukherjeeatom', 'adavar2', 'freshfoodhuang']",12,"['ichesser', 'tanni', 'mukherjeeatom', 'graceml2', 'shushujie', 'raphaeldu', 'nothando21', 'kalan', 'sjtuzhanglei', 'vishwasg', 'adavar2', 'freshfoodhuang']"
135,79,6,6,1,['albd'],5,"['ender.forerunner', 'andervish', 'jesszlu', 'baszczu', 'eyupb.unlu']",5,"['mccoombs', 'fredhills', 'hamamines', 'ch630183', 'xibfeng']",11,"['ender.forerunner', 'mccoombs', 'hamamines', 'albd', 'andervish', 'jesszlu', 'fredhills', 'baszczu', 'ch630183', 'xibfeng', 'eyupb.unlu']"
137,68,6,6,4,"['echo570', 'robbiemorrison1995', 'nataliapinirtzi', 'paguado']",2,"['elham5661', 'wastefellowfollowsraji']",2,"['ggreenediniz18', 'myrta']",8,"['elham5661', 'ggreenediniz18', 'myrta', 'robbiemorrison1995', 'paguado', 'echo570', 'nataliapinirtzi', 'wastefellowfollowsraji']"
138,157,6,16,6,"['aadityapatil77', 'shubhamyadav', 'mrunalb1497', 'patilvd7511vd', 'sidved29', 'shubhangi6']",0,[],10,"['kirannirmal57', 'pavanmkodam', 'harkesayali19', 'utkarsha531998', 'sonalimiraje15', 'revadekarchetan', 'trishadesai1111', 'ameysabnis134', 'snehalavate3', 'priyupawar0797']",16,"['aadityapatil77', 'mrunalb1497', 'utkarsha531998', 'patilvd7511vd', 'sonalimiraje15', 'sidved29', 'revadekarchetan', 'shubhangi6', 'kirannirmal57', 'shubhamyadav', 'pavanmkodam', 'harkesayali19', 'trishadesai1111', 'ameysabnis134', 'snehalavate3', 'priyupawar0797']"
138,93,6,11,3,"['aadityapatil77', 'shubhangi6', 'patilvd7511vd']",3,"['sidved29', 'shubhamyadav', 'mrunalb1497']",8,"['kirannirmal57', 'sahilmagdum', 'suchitraravan77', 'harkesayali19', 'sonalimiraje15', 'trishadesai1111', 'ameysabnis134', 'snehalavate3']",14,"['aadityapatil77', 'sahilmagdum', 'mrunalb1497', 'patilvd7511vd', 'sonalimiraje15', 'sidved29', 'shubhangi6', 'kirannirmal57', 'shubhamyadav', 'harkesayali19', 'suchitraravan77', 'trishadesai1111', 'ameysabnis134', 'snehalavate3']"
138,94,6,7,3,"['sidved29', 'shubhamyadav', 'mrunalb1497']",3,"['aadityapatil77', 'shubhangi6', 'patilvd7511vd']",4,"['ameysabnis134', '2509patilkomal', 'revadekarchetan', 'harkesayali19']",10,"['aadityapatil77', 'shubhamyadav', 'mrunalb1497', 'harkesayali19', 'patilvd7511vd', 'revadekarchetan', 'sidved29', 'ameysabnis134', '2509patilkomal', 'shubhangi6']"
139,34,6,7,6,"['tell.your.world.2525', 'yusuke_hamanaka', 'saytt0923', 'moroikohei0529', 'skkohei1102', 'shuhei55']",0,[],1,['kshimizu'],7,"['tell.your.world.2525', 'yusuke_hamanaka', 'shuhei55', 'moroikohei0529', 'skkohei1102', 'kshimizu', 'saytt0923']"
140,52,6,125,3,"['psumner', 'ehonebri', 'ecronin']",3,"['ksjolund', 'lswentor', 'msakamot']",122,"['mcdona85', 'jfolkers', 'smit3180', 'btestin14', 'radhakr3', 'purduechen2203', 'tilley0', 'ryry1644', 'samm', 'itsmemario', 'cpiepen', 'evdaly', 'dkilgor', 'fischermben', 'afalkenb', 'lee2370', 'mingusnate', 'angbecker', 'arturotrevino', 'hess35', 'cmelchin', 'nathanmoore', 'oliver67', 'akonopa', 'lmeehann', 'starr21', 'kjh94425', 'jwoon', 'aguyre', 'rishiprasadha', 'rileyedelaney', 'singh378', 'maxwellfra16', 'goh5', 'talon34567', 'river132', 'athoman', 'shadow66666', 'chiranth7954', 'conner.swift8', 'boninim', 'wan52', 'xng', 'kevinodonnell0878', 'khageman', 'cbischof', 'ggolla', 'jdanek', 'ebehring', 'shaw108', 'cartmaster007', 'rhellyer', 'agalema1027', 'rsusler', 'chanwoo.lee.17', 'selawada', 'kskripakaran0810', 'muelle77', 'charlesma423', 'joshuajkporter', 'jrohman', 'mccaul', 'jkekre', 'suhaira97', 'nhdorcy', 'garret28', 'jacobglvn', 'caldwe29', 'anthonm', 'landon.glunt', 'sueprasad8214', 'dschull', 'rao75', 'bsmrdel', 'albrect', 'nramli', 'ryanwest1040', 'ikobayas', 'mcrees', 'acostab', 'kgmcginley', 'srasche', 'hyndmanjustin', 'rao53', 'tthieles', 'justj', 'dgreiwe', 'kknowlto', 'crhodine', 'rwiebe', 'huan1146', 'heinzt', 'tgiazzon', 'kico', 'ggauthi', 'jkueche', 'wstolz', 'vwallema', 'george7elias', 'yang1206', 'geyerg', 'eforti', 'jskeens', 'yizhizhang', 'cclapham', 'nafandi', 'vpope', 'akreuter', 'nikhilcarneiro4', 'asartor', 'john1886', 'zjohnson834', 'suran9712', 'sknecht', 'amckeska', 'dsfgdsfg', 'davids19', 'mcclure8', 'nt230', 'akreilei', 'yeager5', 'kruege14']",128,"['mcdona85', 'radhakr3', 'purduechen2203', 'ryry1644', 'samm', 'evdaly', 'dkilgor', 'afalkenb', 'lee2370', 'mingusnate', 'hess35', 'cmelchin', 'nathanmoore', 'oliver67', 'akonopa', 'lmeehann', 'starr21', 'jwoon', 'rileyedelaney', 'talon34567', 'river132', 'wan52', 'kevinodonnell0878', 'khageman', 'ebehring', 'cartmaster007', 'selawada', 'kskripakaran0810', 'muelle77', 'charlesma423', 'joshuajkporter', 'ehonebri', 'suhaira97', 'jacobglvn', 'dschull', 'bsmrdel', 'albrect', 'nramli', 'mcrees', 'acostab', 'rao53', 'tthieles', 'dgreiwe', 'kknowlto', 'rwiebe', 'heinzt', 'kico', 'ggauthi', 'jkueche', 'wstolz', 'vwallema', 'george7elias', 'yang1206', 'nafandi', 'vpope', 'nikhilcarneiro4', 'asartor', 'zjohnson834', 'davids19', 'akreilei', 'yeager5', 'kruege14', 'chanwoo.lee.17', 'jfolkers', 'smit3180', 'btestin14', 'tilley0', 'msakamot', 'itsmemario', 'cpiepen', 'fischermben', 'angbecker', 'arturotrevino', 'kjh94425', 'aguyre', 'rishiprasadha', 'singh378', 'maxwellfra16', 'goh5', 'athoman', 'shadow66666', 'chiranth7954', 'conner.swift8', 'boninim', 'xng', 'cbischof', 'ggolla', 'jdanek', 'shaw108', 'rhellyer', 'agalema1027', 'rsusler', 'jrohman', 'ecronin', 'mccaul', 'jkekre', 'nhdorcy', 'garret28', 'caldwe29', 'anthonm', 'landon.glunt', 'sueprasad8214', 'rao75', 'ryanwest1040', 'ikobayas', 'kgmcginley', 'srasche', 'hyndmanjustin', 'justj', 'crhodine', 'huan1146', 'tgiazzon', 'lswentor', 'psumner', 'geyerg', 'eforti', 'jskeens', 'yizhizhang', 'cclapham', 'ksjolund', 'akreuter', 'john1886', 'suran9712', 'sknecht', 'amckeska', 'dsfgdsfg', 'mcclure8', 'nt230']"
143,109,6,13,5,"['mhesham2018', 'mohamedmsaad66', 'mohamed.ah.omran', 'mohamed.h.mamdouh', 'basem.ali95']",1,['ahmeis'],8,"['elgohari95', 'asmaa_abdelmegeed.', 'waheed.ahmed12', 'bakr', 'ahmedraouf', 'islam_hisham', 'mohamedsaleh106', 'kareem.men3em']",14,"['mhesham2018', 'ahmeis', 'elgohari95', 'asmaa_abdelmegeed.', 'bakr', 'mohamedmsaad66', 'mohamed.ah.omran', 'basem.ali95', 'mohamedsaleh106', 'islam_hisham', 'waheed.ahmed12', 'mohamed.h.mamdouh', 'ahmedraouf', 'kareem.men3em']"
146,44,6,21,1,['waleed97'],5,"['alecgantar', 'atoghraee', 'zhufangjia941010', 'nsperger', 'hnobarani']",20,"['ajfriedlan', 'raanapooshimin', 'reing1ub', 'jakeerickson', 'carmud', 'kiranpreet.birdee', 'sofiaarranz', 'wdze1001', 'turnergarrow', 'e.desroche', 'hadiyamadi', 'juanmanu04', 'wolkoff.97', 'laura.burchell', 'tmosh5', 'trix012', 'robknobel', 'will.salmon66', 'sandracheng', 'toto_bssnt']",26,"['wolkoff.97', 'alecgantar', 'waleed97', 'ajfriedlan', 'raanapooshimin', 'reing1ub', 'jakeerickson', 'laura.burchell', 'tmosh5', 'trix012', 'carmud', 'nsperger', 'robknobel', 'hnobarani', 'will.salmon66', 'sandracheng', 'kiranpreet.birdee', 'sofiaarranz', 'wdze1001', 'turnergarrow', 'atoghraee', 'zhufangjia941010', 'e.desroche', 'hadiyamadi', 'juanmanu04', 'toto_bssnt']"
149,170,5,7,3,"['himanisheth98', 'ameysawant25597', 'yashsavle']",2,"['sachimalkan', 'jaineelnandu']",4,"['nande.manasi16', 'riddhis2411', '1jyotsna1', 'agarwal.gagan5101']",9,"['nande.manasi16', 'agarwal.gagan5101', 'jaineelnandu', '1jyotsna1', 'ameysawant25597', 'himanisheth98', 'sachimalkan', 'yashsavle', 'riddhis2411']"
158,6,5,5,5,"['yvy5250', 'rqm5425', 'sxn266', 'jmc7066', 'jmw6448']",0,[],0,[],5,"['yvy5250', 'rqm5425', 'sxn266', 'jmc7066', 'jmw6448']"
160,52,5,125,4,"['afalkenb', 'radhakr3', 'kevinodonnell0878', 'agalema1027']",1,['rachel318318'],121,"['mcdona85', 'jfolkers', 'smit3180', 'btestin14', 'purduechen2203', 'tilley0', 'ryry1644', 'samm', 'itsmemario', 'cpiepen', 'evdaly', 'dkilgor', 'fischermben', 'lee2370', 'mingusnate', 'angbecker', 'arturotrevino', 'hess35', 'cmelchin', 'nathanmoore', 'oliver67', 'akonopa', 'lmeehann', 'starr21', 'kjh94425', 'jwoon', 'aguyre', 'rishiprasadha', 'rileyedelaney', 'singh378', 'maxwellfra16', 'goh5', 'talon34567', 'river132', 'athoman', 'shadow66666', 'chiranth7954', 'conner.swift8', 'boninim', 'wan52', 'xng', 'khageman', 'cbischof', 'ggolla', 'jdanek', 'ebehring', 'shaw108', 'cartmaster007', 'rhellyer', 'rsusler', 'chanwoo.lee.17', 'selawada', 'kskripakaran0810', 'muelle77', 'charlesma423', 'joshuajkporter', 'jrohman', 'ehonebri', 'ecronin', 'mccaul', 'jkekre', 'suhaira97', 'nhdorcy', 'garret28', 'jacobglvn', 'caldwe29', 'anthonm', 'landon.glunt', 'sueprasad8214', 'dschull', 'rao75', 'bsmrdel', 'albrect', 'nramli', 'ryanwest1040', 'ikobayas', 'mcrees', 'acostab', 'kgmcginley', 'srasche', 'hyndmanjustin', 'rao53', 'tthieles', 'justj', 'dgreiwe', 'kknowlto', 'crhodine', 'rwiebe', 'huan1146', 'heinzt', 'tgiazzon', 'kico', 'ggauthi', 'jkueche', 'wstolz', 'vwallema', 'george7elias', 'yang1206', 'psumner', 'geyerg', 'eforti', 'jskeens', 'yizhizhang', 'cclapham', 'nafandi', 'vpope', 'akreuter', 'nikhilcarneiro4', 'asartor', 'john1886', 'zjohnson834', 'suran9712', 'sknecht', 'amckeska', 'dsfgdsfg', 'davids19', 'mcclure8', 'nt230', 'akreilei', 'yeager5', 'kruege14']",126,"['mcdona85', 'radhakr3', 'purduechen2203', 'ryry1644', 'samm', 'evdaly', 'dkilgor', 'afalkenb', 'lee2370', 'mingusnate', 'hess35', 'cmelchin', 'nathanmoore', 'oliver67', 'akonopa', 'lmeehann', 'starr21', 'jwoon', 'rileyedelaney', 'talon34567', 'river132', 'wan52', 'kevinodonnell0878', 'khageman', 'ebehring', 'cartmaster007', 'selawada', 'kskripakaran0810', 'muelle77', 'charlesma423', 'joshuajkporter', 'ehonebri', 'suhaira97', 'jacobglvn', 'dschull', 'bsmrdel', 'albrect', 'nramli', 'mcrees', 'acostab', 'rao53', 'tthieles', 'dgreiwe', 'kknowlto', 'rwiebe', 'heinzt', 'kico', 'ggauthi', 'jkueche', 'wstolz', 'vwallema', 'george7elias', 'yang1206', 'nafandi', 'vpope', 'nikhilcarneiro4', 'asartor', 'zjohnson834', 'davids19', 'akreilei', 'yeager5', 'kruege14', 'chanwoo.lee.17', 'jfolkers', 'smit3180', 'btestin14', 'tilley0', 'itsmemario', 'cpiepen', 'fischermben', 'angbecker', 'arturotrevino', 'kjh94425', 'aguyre', 'rishiprasadha', 'singh378', 'maxwellfra16', 'goh5', 'athoman', 'shadow66666', 'chiranth7954', 'conner.swift8', 'boninim', 'xng', 'cbischof', 'rachel318318', 'ggolla', 'jdanek', 'shaw108', 'rhellyer', 'agalema1027', 'rsusler', 'jrohman', 'ecronin', 'mccaul', 'jkekre', 'nhdorcy', 'garret28', 'caldwe29', 'anthonm', 'landon.glunt', 'sueprasad8214', 'rao75', 'ryanwest1040', 'ikobayas', 'kgmcginley', 'srasche', 'hyndmanjustin', 'justj', 'crhodine', 'huan1146', 'tgiazzon', 'psumner', 'geyerg', 'eforti', 'jskeens', 'yizhizhang', 'cclapham', 'akreuter', 'john1886', 'suran9712', 'sknecht', 'amckeska', 'dsfgdsfg', 'mcclure8', 'nt230']"
160,155,5,39,5,"['agalema1027', 'radhakr3', 'kevinodonnell0878', 'afalkenb', 'rachel318318']",0,[],34,"['krishn75', 'rauche', 'ali85', 'bjendrus', 'sdhillo', 'jbarsima', 'hriddle', 'zyma', 'nfschadler', 'dast', 'cheeseballs99', 'mmoulin', 'marcusgunyon', 'klein61', 'mmulter', 'bfielde', 'batram', 'jboulayd', 'stewa207', 'cole141', 'knies0', 'zooks99', 'wscottharding', 'post10', 'kswiatk9581', 'azalar', 'sundara6', 'ffrank', 'awassmer', 'myers283', 'aharbin', 'jlueck', 'ianbernander', 'xie317']",39,"['radhakr3', 'krishn75', 'afalkenb', 'rauche', 'ali85', 'bjendrus', 'sdhillo', 'jbarsima', 'hriddle', 'zyma', 'nfschadler', 'dast', 'cheeseballs99', 'mmoulin', 'marcusgunyon', 'klein61', 'mmulter', 'bfielde', 'batram', 'kevinodonnell0878', 'jboulayd', 'stewa207', 'cole141', 'knies0', 'rachel318318', 'zooks99', 'wscottharding', 'post10', 'agalema1027', 'kswiatk9581', 'azalar', 'sundara6', 'ffrank', 'awassmer', 'myers283', 'aharbin', 'jlueck', 'ianbernander', 'xie317']"
162,186,5,7,4,"['luisca1925', 'marissacerdas', 'evyquiros.7', 'jbhernadez1004']",1,['pwalke23'],3,"['andrea.zu97', 'feraya09', 'arisandi97']",8,"['luisca1925', 'evyquiros.7', 'feraya09', 'jbhernadez1004', 'andrea.zu97', 'pwalke23', 'marissacerdas', 'arisandi97']"
165,70,5,31,2,"['leovall', 'mphilbri']",3,"['agambi', 'spelliz', 'rajpatra']",29,"['clindn', 'allendc', 'serenad', 'pinea', 'ehsi', 'malhark', 'ggracevr', 'hteutsch', 'rotenmax', 'zouhaox', 'ksallans', 'cjbmi', 'haileymk', 'apielack', 'rishavc', 'liutif', 'jepi', 'reedy', 'annakcha', 'mgratows', 'brdemarc', 'dwangy', 'jojoco', 'brenrice', 'hgaudin', 'ybeeker', 'blanzyt', 'eraeker', 'avibreg']",34,"['clindn', 'serenad', 'pinea', 'malhark', 'mphilbri', 'ksallans', 'haileymk', 'apielack', 'brdemarc', 'ybeeker', 'eraeker', 'allendc', 'ehsi', 'ggracevr', 'hteutsch', 'rotenmax', 'zouhaox', 'cjbmi', 'rishavc', 'spelliz', 'liutif', 'jepi', 'reedy', 'annakcha', 'mgratows', 'leovall', 'dwangy', 'jojoco', 'brenrice', 'hgaudin', 'blanzyt', 'agambi', 'avibreg', 'rajpatra']"
167,148,5,6,5,"['sjr0031', 'snjohnson1', 'jamccauley', 'gpkelly', 'jphiggins']",0,[],1,['lefr95'],6,"['sjr0031', 'lefr95', 'snjohnson1', 'jamccauley', 'gpkelly', 'jphiggins']"
173,100,5,9,2,"['bchen026', 'tasmitasmi']",3,"['lc1d', 'xarkangelx', 'rostak1']",7,"['jpena017', 'heatinglemon', 'ddawg', 'sshan009', 'raymondnguyen51', 'nsciu001', 'seiginokishidan']",12,"['xarkangelx', 'lc1d', 'bchen026', 'jpena017', 'heatinglemon', 'ddawg', 'sshan009', 'raymondnguyen51', 'rostak1', 'nsciu001', 'tasmitasmi', 'seiginokishidan']"
